time,subj_course_id,sec_code,sec_id,prof,available,waitlist,total,enrolled_ct
1658048139614,COGS 9,A01,083615,Shannon; Kyle Michael,11,0,75,64
1658048145638,COGS 11,A01,083617,Boyle; Mary E. T.,23,0,48,25
1658048151669,COGS 13,A01,083071,Bastos; Amalia Pinkusfeld,12,0,71,59
1658048157693,COGS 14A,A01,092681,Semenuks; Arturs,5,1,100,95
1658048163722,COGS 14B,A01,083073,Cheng; Tzu-Han,7,0,63,56
1658048169746,COGS 17,A01,092677,Semenuks; Arturs,7,0,81,74
1658048175774,COGS 100,A01,083619,Allen; Michael Gordon,17,0,70,53
1658048181802,COGS 101A,A01,083621,Davis; Joshua Daniel,9,0,68,59
1658048187829,COGS 101B,A01,091572,Allen; Michael Gordon,14,0,65,51
1658048193856,COGS 101C,A01,083625,Delgado; Tania,17,0,35,18
1658048199884,COGS 107A,A01,083627,Boyle; Mary E. T.,14,0,60,46
1658048205908,COGS 118A,A01,083075,Gupta; Anjum,21,0,76,55
1658048211937,CSE 3,A50,083646,Miranda; Gregory Joseph,24,0,50,26
1658048217966,CSE 8A,A50,083650,Miranda; Gregory Joseph,17,1,56,39
1658048223991,CSE 11,A01,083080,Cao; Yingjun,7,15,40,33
1658048230015,CSE 12,A01,083652,Krause-Levy; Sophia Louisa,30,1,120,90
1658048236045,CSE 15L,A01,083654,Morris; Justin Loren,9,0,50,41
1658048236045,CSE 15L,A02,083655,Morris; Justin Loren,11,0,50,39
1658048242070,CSE 20,A01,083657,Tran; Khoa Dang,39,0,80,41
1658048248097,CSE 21,A01,095574,Bach; Quang Tran,23,0,48,25
1658048254122,CSE 30,A01,083084,Eldon; John,8,0,80,72
1658048254122,CSE 30,B01,095061,Bhaskar; Nishant,9,0,50,41
1658048260158,CSE 100,A01,083659,Cao; Yingjun,5,4,70,65
1658048266182,CSE 134B,A01,083661,Powell; Thomas Allan,25,0,100,75
1658048272209,CSE 140,A01,083663,Gungor; Onat,17,0,85,68
1658048278236,CSE 140L,A01,083088,Eldon; John,23,0,100,77
1658048284265,CSE 175,A01,083665,Kumar; Rakesh,3,0,25,22
1658048290289,CSE 190,A00,092507,Dubnov; Shlomo,8,0,20,12
1658048296318,ECE 45,A01,083139,Congero; Spencer William,7,0,75,68
1658048302348,ECE 65,A50,083695,Saad; Andrew S,12,0,30,18
1658048302348,ECE 65,A51,095125,Saad; Andrew S,24,0,26,2
1658048308374,ECE 109,A01,091882,Touri; Behrouz,21,0,70,49
1658048314398,ECE 180,A00,083140,Abi Samra; Nicholas Camill,1,0,30,29
1658048314398,ECE 180,B00,083141,Abi Samra; Nicholas Camill,0,0,30,30
1658048320425,MATH 10A,A01,083735,Patchell; Gregory David,2,0,30,28
1658048320425,MATH 10A,A02,083736,Patchell; Gregory David,20,0,30,10
1658048320425,MATH 10A,A03,083737,Patchell; Gregory David,16,0,30,14
1658048326458,MATH 10B,A01,083207,Lim; Seonhee,9,0,34,25
1658048326458,MATH 10B,A02,083208,Lim; Seonhee,10,0,35,25
1658048326458,MATH 10B,A03,093472,Lim; Seonhee,7,0,34,27
1658048326458,MATH 10B,B01,083739,Sinha; Shubham,14,0,30,16
1658048332486,MATH 18,A01,083743,Cinel; Cameron Alexander,9,0,30,21
1658048332486,MATH 18,A02,083744,Cinel; Cameron Alexander,18,0,30,12
1658048332486,MATH 18,A03,083745,Cinel; Cameron Alexander,10,0,30,20
1658048332486,MATH 18,B01,083748,Rideout; David Porter,5,0,37,32
1658048332486,MATH 18,B02,083749,Rideout; David Porter,5,0,36,31
1658048332486,MATH 18,B03,083750,Rideout; David Porter,3,0,37,34
1658048332486,MATH 18,B04,083751,Rideout; David Porter,7,0,36,29
1658048332486,MATH 18,B05,093473,Rideout; David Porter,7,0,36,29
1658048332486,MATH 18,B06,093474,Rideout; David Porter,6,0,36,30
1658048338515,MATH 20A,A01,083754,Zheng; Zequn,14,0,40,26
1658048344544,MATH 20B,A01,083756,Briones; Jor-el Thomas Caparas,4,0,36,32
1658048344544,MATH 20B,A02,083757,Briones; Jor-el Thomas Caparas,1,0,36,35
1658048344544,MATH 20B,A03,093475,Briones; Jor-el Thomas Caparas,3,0,36,33
1658048350568,MATH 20C,A01,083760,Briones; Jor-el Thomas Caparas,1,0,35,34
1658048350568,MATH 20C,A02,083761,Briones; Jor-el Thomas Caparas,8,0,35,27
1658048350568,MATH 20C,A03,093476,Briones; Jor-el Thomas Caparas,0,1,36,36
1658048350568,MATH 20C,B01,083762,Bach; Quang Tran,1,0,30,29
1658048356599,MATH 20D,A01,083765,Tran; Brian Kha,5,0,30,25
1658048356599,MATH 20D,A02,083766,Tran; Brian Kha,5,0,30,25
1658048356599,MATH 20D,A03,083767,Tran; Brian Kha,6,0,30,24
1658048362630,MATH 20E,A01,083771,Ganguly; Soumya,12,0,32,20
1658048362630,MATH 20E,A02,083772,Ganguly; Soumya,7,0,32,25
1658048362630,MATH 20E,B01,083773,Ciotti; Benjamin,20,0,35,15
1658048362630,MATH 20E,B02,083774,Ciotti; Benjamin,18,0,35,17
1658048368656,MATH 103A,A01,083777,Greenfeld; Be'Eri,6,0,36,30
1658048368656,MATH 103A,A02,083778,Greenfeld; Be'Eri,5,0,36,31
1658048368656,MATH 103A,A03,093561,Greenfeld; Be'Eri,7,0,36,29
1658048368656,MATH 103A,B01,083779,Greenfeld; Be'Eri,8,0,36,28
1658048368656,MATH 103A,B02,083780,Greenfeld; Be'Eri,4,0,36,32
1658048368656,MATH 103A,B03,093562,Greenfeld; Be'Eri,3,0,36,33
1658048374681,MATH 105,A01,085443,Carter; Anne Toulson,15,0,35,20
1658048374681,MATH 105,A02,093477,Carter; Anne Toulson,20,0,35,15
1658048380709,MATH 109,A01,083213,Ganzberger; Geoffrey Michael,3,0,34,31
1658048380709,MATH 109,A02,083214,Ganzberger; Geoffrey Michael,4,0,34,30
1658048380709,MATH 109,A03,093478,Ganzberger; Geoffrey Michael,2,0,34,32
1658048380709,MATH 109,B01,083215,Ganzberger; Geoffrey Michael,3,0,32,29
1658048380709,MATH 109,B02,083216,Ganzberger; Geoffrey Michael,3,0,32,29
1658048380709,MATH 109,B03,093479,Ganzberger; Geoffrey Michael,8,0,32,24
1658048386733,MATH 142A,A01,083219,Chow; Bennett,7,0,32,25
1658048386733,MATH 142A,A02,083220,Chow; Bennett,10,0,32,22
1658048386733,MATH 142A,A03,093480,Chow; Bennett,9,0,32,23
1658048386733,MATH 142A,B03,093481,Chow; Bennett,8,0,32,24
1658048386733,MATH 142A,B04,093558,Chow; Bennett,14,0,32,18
1658048386733,MATH 142A,B05,093559,Chow; Bennett,7,0,32,25
1658048392759,MATH 193A,A01,083224,Rotar; Vladimir,9,0,34,25
1658048392759,MATH 193A,A02,083225,Rotar; Vladimir,11,0,34,23
1658048392759,MATH 193A,A03,083781,Rotar; Vladimir,5,0,34,29
1658048392759,MATH 193A,A04,083782,Rotar; Vladimir,12,0,34,22
1658048392759,MATH 193A,A05,093482,Rotar; Vladimir,11,0,34,23
1658048398782,MATH 197,001,091859,McAuley; Julian John,9999,0,9999,0
1658048398782,MATH 197,002,095566,Kedlaya; Kiran S.,9997,0,9999,2
1658048398782,MATH 197,003,095567,Xiao; Ming,9999,0,9999,0
1658048398782,MATH 197,004,095571,Perols; Johan Lars,9998,0,9999,1
1658048405836,COGS 9,A01,083615,Shannon; Kyle Michael,11,0,75,64
1658048411864,COGS 11,A01,083617,Boyle; Mary E. T.,23,0,48,25
1658048417888,COGS 13,A01,083071,Bastos; Amalia Pinkusfeld,12,0,71,59
1658048424038,COGS 14A,A01,092681,Semenuks; Arturs,5,1,100,95
1658048430066,COGS 14B,A01,083073,Cheng; Tzu-Han,7,0,63,56
1658048436088,COGS 17,A01,092677,Semenuks; Arturs,7,0,81,74
1658048442113,COGS 100,A01,083619,Allen; Michael Gordon,17,0,70,53
1658048448137,COGS 101A,A01,083621,Davis; Joshua Daniel,9,0,68,59
1658048454168,COGS 101B,A01,091572,Allen; Michael Gordon,14,0,65,51
1658048460195,COGS 101C,A01,083625,Delgado; Tania,17,0,35,18
1658048466217,COGS 107A,A01,083627,Boyle; Mary E. T.,14,0,60,46
1658048472241,COGS 118A,A01,083075,Gupta; Anjum,21,0,76,55
1658048478266,CSE 3,A50,083646,Miranda; Gregory Joseph,24,0,50,26
1658048484295,CSE 8A,A50,083650,Miranda; Gregory Joseph,17,1,56,39
1658048490324,CSE 11,A01,083080,Cao; Yingjun,7,15,40,33
1658048496347,CSE 12,A01,083652,Krause-Levy; Sophia Louisa,30,1,120,90
1658048502370,CSE 15L,A01,083654,Morris; Justin Loren,9,0,50,41
1658048502370,CSE 15L,A02,083655,Morris; Justin Loren,11,0,50,39
1658048508398,CSE 20,A01,083657,Tran; Khoa Dang,39,0,80,41
1658048514420,CSE 21,A01,095574,Bach; Quang Tran,23,0,48,25
1658048520443,CSE 30,A01,083084,Eldon; John,8,0,80,72
1658048520443,CSE 30,B01,095061,Bhaskar; Nishant,9,0,50,41
1658048526472,CSE 100,A01,083659,Cao; Yingjun,5,4,70,65
1658048532500,CSE 134B,A01,083661,Powell; Thomas Allan,25,0,100,75
1658048538528,CSE 140,A01,083663,Gungor; Onat,17,0,85,68
1658048544553,CSE 140L,A01,083088,Eldon; John,23,0,100,77
1658048550581,CSE 175,A01,083665,Kumar; Rakesh,3,0,25,22
1658048556609,CSE 190,A00,092507,Dubnov; Shlomo,8,0,20,12
1658048562632,ECE 45,A01,083139,Congero; Spencer William,7,0,75,68
1658048568656,ECE 65,A50,083695,Saad; Andrew S,12,0,30,18
1658048568656,ECE 65,A51,095125,Saad; Andrew S,24,0,26,2
1658048574679,ECE 109,A01,091882,Touri; Behrouz,21,0,70,49
1658048580702,ECE 180,A00,083140,Abi Samra; Nicholas Camill,1,0,30,29
1658048580702,ECE 180,B00,083141,Abi Samra; Nicholas Camill,0,0,30,30
1658048586727,MATH 10A,A01,083735,Patchell; Gregory David,2,0,30,28
1658048586727,MATH 10A,A02,083736,Patchell; Gregory David,20,0,30,10
1658048586727,MATH 10A,A03,083737,Patchell; Gregory David,16,0,30,14
1658048592759,MATH 10B,A01,083207,Lim; Seonhee,9,0,34,25
1658048592759,MATH 10B,A02,083208,Lim; Seonhee,10,0,35,25
1658048592759,MATH 10B,A03,093472,Lim; Seonhee,7,0,34,27
1658048592759,MATH 10B,B01,083739,Sinha; Shubham,14,0,30,16
1658048598784,MATH 18,A01,083743,Cinel; Cameron Alexander,9,0,30,21
1658048598784,MATH 18,A02,083744,Cinel; Cameron Alexander,18,0,30,12
1658048598784,MATH 18,A03,083745,Cinel; Cameron Alexander,10,0,30,20
1658048598784,MATH 18,B01,083748,Rideout; David Porter,5,0,37,32
1658048598784,MATH 18,B02,083749,Rideout; David Porter,5,0,36,31
1658048598784,MATH 18,B03,083750,Rideout; David Porter,3,0,37,34
1658048598784,MATH 18,B04,083751,Rideout; David Porter,7,0,36,29
1658048598784,MATH 18,B05,093473,Rideout; David Porter,7,0,36,29
1658048598784,MATH 18,B06,093474,Rideout; David Porter,6,0,36,30
1658048604807,MATH 20A,A01,083754,Zheng; Zequn,14,0,40,26
1658048610838,MATH 20B,A01,083756,Briones; Jor-el Thomas Caparas,4,0,36,32
1658048610838,MATH 20B,A02,083757,Briones; Jor-el Thomas Caparas,1,0,36,35
1658048610838,MATH 20B,A03,093475,Briones; Jor-el Thomas Caparas,3,0,36,33
1658048616871,MATH 20C,A01,083760,Briones; Jor-el Thomas Caparas,1,0,35,34
1658048616871,MATH 20C,A02,083761,Briones; Jor-el Thomas Caparas,8,0,35,27
1658048616871,MATH 20C,A03,093476,Briones; Jor-el Thomas Caparas,0,1,36,36
1658048616871,MATH 20C,B01,083762,Bach; Quang Tran,1,0,30,29
1658048622901,MATH 20D,A01,083765,Tran; Brian Kha,5,0,30,25
1658048622901,MATH 20D,A02,083766,Tran; Brian Kha,5,0,30,25
1658048622901,MATH 20D,A03,083767,Tran; Brian Kha,6,0,30,24
1658048628926,MATH 20E,A01,083771,Ganguly; Soumya,12,0,32,20
1658048628926,MATH 20E,A02,083772,Ganguly; Soumya,7,0,32,25
1658048628926,MATH 20E,B01,083773,Ciotti; Benjamin,20,0,35,15
1658048628926,MATH 20E,B02,083774,Ciotti; Benjamin,18,0,35,17
1658048634955,MATH 103A,A01,083777,Greenfeld; Be'Eri,6,0,36,30
1658048634955,MATH 103A,A02,083778,Greenfeld; Be'Eri,5,0,36,31
1658048634955,MATH 103A,A03,093561,Greenfeld; Be'Eri,7,0,36,29
1658048634955,MATH 103A,B01,083779,Greenfeld; Be'Eri,8,0,36,28
1658048634955,MATH 103A,B02,083780,Greenfeld; Be'Eri,4,0,36,32
1658048634955,MATH 103A,B03,093562,Greenfeld; Be'Eri,3,0,36,33
1658048640978,MATH 105,A01,085443,Carter; Anne Toulson,15,0,35,20
1658048640978,MATH 105,A02,093477,Carter; Anne Toulson,20,0,35,15
1658048647022,MATH 109,A01,083213,Ganzberger; Geoffrey Michael,3,0,34,31
1658048647022,MATH 109,A02,083214,Ganzberger; Geoffrey Michael,4,0,34,30
1658048647022,MATH 109,A03,093478,Ganzberger; Geoffrey Michael,2,0,34,32
1658048647022,MATH 109,B01,083215,Ganzberger; Geoffrey Michael,3,0,32,29
1658048647022,MATH 109,B02,083216,Ganzberger; Geoffrey Michael,3,0,32,29
1658048647022,MATH 109,B03,093479,Ganzberger; Geoffrey Michael,8,0,32,24
1658048653045,MATH 142A,A01,083219,Chow; Bennett,7,0,32,25
1658048653045,MATH 142A,A02,083220,Chow; Bennett,10,0,32,22
1658048653045,MATH 142A,A03,093480,Chow; Bennett,9,0,32,23
1658048653045,MATH 142A,B03,093481,Chow; Bennett,8,0,32,24
1658048653045,MATH 142A,B04,093558,Chow; Bennett,14,0,32,18
1658048653045,MATH 142A,B05,093559,Chow; Bennett,7,0,32,25
1658048659069,MATH 193A,A01,083224,Rotar; Vladimir,9,0,34,25
1658048659069,MATH 193A,A02,083225,Rotar; Vladimir,11,0,34,23
1658048659069,MATH 193A,A03,083781,Rotar; Vladimir,5,0,34,29
1658048659069,MATH 193A,A04,083782,Rotar; Vladimir,12,0,34,22
1658048659069,MATH 193A,A05,093482,Rotar; Vladimir,11,0,34,23
1658048665098,MATH 197,001,091859,McAuley; Julian John,9999,0,9999,0
1658048665098,MATH 197,002,095566,Kedlaya; Kiran S.,9997,0,9999,2
1658048665098,MATH 197,003,095567,Xiao; Ming,9999,0,9999,0
1658048665098,MATH 197,004,095571,Perols; Johan Lars,9998,0,9999,1
1658048672169,COGS 9,A01,083615,Shannon; Kyle Michael,11,0,75,64
1658048678192,COGS 11,A01,083617,Boyle; Mary E. T.,23,0,48,25
1658048684216,COGS 13,A01,083071,Bastos; Amalia Pinkusfeld,12,0,71,59
1658048690245,COGS 14A,A01,092681,Semenuks; Arturs,5,1,100,95
1658048696272,COGS 14B,A01,083073,Cheng; Tzu-Han,7,0,63,56
1658048702311,COGS 17,A01,092677,Semenuks; Arturs,7,0,81,74
1658048708334,COGS 100,A01,083619,Allen; Michael Gordon,17,0,70,53
1658048714428,COGS 101A,A01,083621,Davis; Joshua Daniel,9,0,68,59
1658048720451,COGS 101B,A01,091572,Allen; Michael Gordon,14,0,65,51
1658048726478,COGS 101C,A01,083625,Delgado; Tania,17,0,35,18
1658048732505,COGS 107A,A01,083627,Boyle; Mary E. T.,14,0,60,46
1658048738529,COGS 118A,A01,083075,Gupta; Anjum,21,0,76,55
1658048744554,CSE 3,A50,083646,Miranda; Gregory Joseph,24,0,50,26
1658048750578,CSE 8A,A50,083650,Miranda; Gregory Joseph,17,1,56,39
1658048756601,CSE 11,A01,083080,Cao; Yingjun,7,15,40,33
1658048762626,CSE 12,A01,083652,Krause-Levy; Sophia Louisa,30,1,120,90
1658048768654,CSE 15L,A01,083654,Morris; Justin Loren,9,0,50,41
1658048768654,CSE 15L,A02,083655,Morris; Justin Loren,11,0,50,39
1658048774678,CSE 20,A01,083657,Tran; Khoa Dang,39,0,80,41
1658048780706,CSE 21,A01,095574,Bach; Quang Tran,23,0,48,25
1658048786731,CSE 30,A01,083084,Eldon; John,8,0,80,72
1658048786731,CSE 30,B01,095061,Bhaskar; Nishant,9,0,50,41
1658048792754,CSE 100,A01,083659,Cao; Yingjun,5,4,70,65
1658048798779,CSE 134B,A01,083661,Powell; Thomas Allan,25,0,100,75
1658048804802,CSE 140,A01,083663,Gungor; Onat,17,0,85,68
1658048810832,CSE 140L,A01,083088,Eldon; John,23,0,100,77
1658048816860,CSE 175,A01,083665,Kumar; Rakesh,3,0,25,22
1658048822886,CSE 190,A00,092507,Dubnov; Shlomo,8,0,20,12
1658048828912,ECE 45,A01,083139,Congero; Spencer William,7,0,75,68
1658048834942,ECE 65,A50,083695,Saad; Andrew S,12,0,30,18
1658048834942,ECE 65,A51,095125,Saad; Andrew S,24,0,26,2
1658048840971,ECE 109,A01,091882,Touri; Behrouz,21,0,70,49
1658048846996,ECE 180,A00,083140,Abi Samra; Nicholas Camill,1,0,30,29
1658048846996,ECE 180,B00,083141,Abi Samra; Nicholas Camill,0,0,30,30
1658048853025,MATH 10A,A01,083735,Patchell; Gregory David,2,0,30,28
1658048853025,MATH 10A,A02,083736,Patchell; Gregory David,20,0,30,10
1658048853025,MATH 10A,A03,083737,Patchell; Gregory David,16,0,30,14
1658048859050,MATH 10B,A01,083207,Lim; Seonhee,9,0,34,25
1658048859050,MATH 10B,A02,083208,Lim; Seonhee,10,0,35,25
1658048859050,MATH 10B,A03,093472,Lim; Seonhee,7,0,34,27
1658048859050,MATH 10B,B01,083739,Sinha; Shubham,14,0,30,16
1658048865085,MATH 18,A01,083743,Cinel; Cameron Alexander,9,0,30,21
1658048865085,MATH 18,A02,083744,Cinel; Cameron Alexander,18,0,30,12
1658048865085,MATH 18,A03,083745,Cinel; Cameron Alexander,10,0,30,20
1658048865085,MATH 18,B01,083748,Rideout; David Porter,5,0,37,32
1658048865085,MATH 18,B02,083749,Rideout; David Porter,5,0,36,31
1658048865085,MATH 18,B03,083750,Rideout; David Porter,3,0,37,34
1658048865085,MATH 18,B04,083751,Rideout; David Porter,7,0,36,29
1658048865085,MATH 18,B05,093473,Rideout; David Porter,7,0,36,29
1658048865085,MATH 18,B06,093474,Rideout; David Porter,6,0,36,30
1658048871109,MATH 20A,A01,083754,Zheng; Zequn,14,0,40,26
1658048877139,MATH 20B,A01,083756,Briones; Jor-el Thomas Caparas,4,0,36,32
1658048877139,MATH 20B,A02,083757,Briones; Jor-el Thomas Caparas,1,0,36,35
1658048877139,MATH 20B,A03,093475,Briones; Jor-el Thomas Caparas,3,0,36,33
1658048883171,MATH 20C,A01,083760,Briones; Jor-el Thomas Caparas,1,0,35,34
1658048883171,MATH 20C,A02,083761,Briones; Jor-el Thomas Caparas,8,0,35,27
1658048883171,MATH 20C,A03,093476,Briones; Jor-el Thomas Caparas,0,1,36,36
1658048883171,MATH 20C,B01,083762,Bach; Quang Tran,1,0,30,29
1658048889197,MATH 20D,A01,083765,Tran; Brian Kha,5,0,30,25
1658048889197,MATH 20D,A02,083766,Tran; Brian Kha,5,0,30,25
1658048889197,MATH 20D,A03,083767,Tran; Brian Kha,6,0,30,24
1658048895231,MATH 20E,A01,083771,Ganguly; Soumya,12,0,32,20
1658048895231,MATH 20E,A02,083772,Ganguly; Soumya,7,0,32,25
1658048895231,MATH 20E,B01,083773,Ciotti; Benjamin,20,0,35,15
1658048895231,MATH 20E,B02,083774,Ciotti; Benjamin,18,0,35,17
1658048901273,MATH 103A,A01,083777,Greenfeld; Be'Eri,6,0,36,30
1658048901273,MATH 103A,A02,083778,Greenfeld; Be'Eri,5,0,36,31
1658048901273,MATH 103A,A03,093561,Greenfeld; Be'Eri,7,0,36,29
1658048901273,MATH 103A,B01,083779,Greenfeld; Be'Eri,8,0,36,28
1658048901273,MATH 103A,B02,083780,Greenfeld; Be'Eri,4,0,36,32
1658048901273,MATH 103A,B03,093562,Greenfeld; Be'Eri,3,0,36,33
1658048907301,MATH 105,A01,085443,Carter; Anne Toulson,15,0,35,20
1658048907301,MATH 105,A02,093477,Carter; Anne Toulson,20,0,35,15
1658048913327,MATH 109,A01,083213,Ganzberger; Geoffrey Michael,3,0,34,31
1658048913327,MATH 109,A02,083214,Ganzberger; Geoffrey Michael,4,0,34,30
1658048913327,MATH 109,A03,093478,Ganzberger; Geoffrey Michael,2,0,34,32
1658048913327,MATH 109,B01,083215,Ganzberger; Geoffrey Michael,3,0,32,29
1658048913327,MATH 109,B02,083216,Ganzberger; Geoffrey Michael,3,0,32,29
1658048913327,MATH 109,B03,093479,Ganzberger; Geoffrey Michael,8,0,32,24
1658048919370,MATH 142A,A01,083219,Chow; Bennett,7,0,32,25
1658048919370,MATH 142A,A02,083220,Chow; Bennett,10,0,32,22
1658048919370,MATH 142A,A03,093480,Chow; Bennett,9,0,32,23
1658048919370,MATH 142A,B03,093481,Chow; Bennett,8,0,32,24
1658048919370,MATH 142A,B04,093558,Chow; Bennett,14,0,32,18
1658048919370,MATH 142A,B05,093559,Chow; Bennett,7,0,32,25
1658048925395,MATH 193A,A01,083224,Rotar; Vladimir,9,0,34,25
1658048925395,MATH 193A,A02,083225,Rotar; Vladimir,11,0,34,23
1658048925395,MATH 193A,A03,083781,Rotar; Vladimir,5,0,34,29
1658048925395,MATH 193A,A04,083782,Rotar; Vladimir,12,0,34,22
1658048925395,MATH 193A,A05,093482,Rotar; Vladimir,11,0,34,23
1658048931421,MATH 197,001,091859,McAuley; Julian John,9999,0,9999,0
1658048931421,MATH 197,002,095566,Kedlaya; Kiran S.,9997,0,9999,2
1658048931421,MATH 197,003,095567,Xiao; Ming,9999,0,9999,0
1658048931421,MATH 197,004,095571,Perols; Johan Lars,9998,0,9999,1
1658048938491,COGS 9,A01,083615,Shannon; Kyle Michael,11,0,75,64
1658048944521,COGS 11,A01,083617,Boyle; Mary E. T.,23,0,48,25
1658048950545,COGS 13,A01,083071,Bastos; Amalia Pinkusfeld,12,0,71,59
1658048956580,COGS 14A,A01,092681,Semenuks; Arturs,5,1,100,95
1658048962622,COGS 14B,A01,083073,Cheng; Tzu-Han,7,0,63,56
1658048968658,COGS 17,A01,092677,Semenuks; Arturs,7,0,81,74
1658048974687,COGS 100,A01,083619,Allen; Michael Gordon,17,0,70,53
1658048980710,COGS 101A,A01,083621,Davis; Joshua Daniel,9,0,68,59
1658048986734,COGS 101B,A01,091572,Allen; Michael Gordon,14,0,65,51
1658048992757,COGS 101C,A01,083625,Delgado; Tania,17,0,35,18
1658048998787,COGS 107A,A01,083627,Boyle; Mary E. T.,14,0,60,46
1658049004813,COGS 118A,A01,083075,Gupta; Anjum,21,0,76,55
1658049010837,CSE 3,A50,083646,Miranda; Gregory Joseph,24,0,50,26
1658049016866,CSE 8A,A50,083650,Miranda; Gregory Joseph,17,1,56,39
1658049022892,CSE 11,A01,083080,Cao; Yingjun,7,15,40,33
1658049028918,CSE 12,A01,083652,Krause-Levy; Sophia Louisa,30,1,120,90
1658049034947,CSE 15L,A01,083654,Morris; Justin Loren,9,0,50,41
1658049034947,CSE 15L,A02,083655,Morris; Justin Loren,11,0,50,39
1658049040972,CSE 20,A01,083657,Tran; Khoa Dang,39,0,80,41
1658049047011,CSE 21,A01,095574,Bach; Quang Tran,23,0,48,25
1658049053044,CSE 30,A01,083084,Eldon; John,8,0,80,72
1658049053044,CSE 30,B01,095061,Bhaskar; Nishant,9,0,50,41
1658049059070,CSE 100,A01,083659,Cao; Yingjun,5,4,70,65
1658049065094,CSE 134B,A01,083661,Powell; Thomas Allan,25,0,100,75
1658049071124,CSE 140,A01,083663,Gungor; Onat,17,0,85,68
1658049077148,CSE 140L,A01,083088,Eldon; John,23,0,100,77
1658049083179,CSE 175,A01,083665,Kumar; Rakesh,3,0,25,22
1658049089203,CSE 190,A00,092507,Dubnov; Shlomo,8,0,20,12
1658049095228,ECE 45,A01,083139,Congero; Spencer William,7,0,75,68
1658049101253,ECE 65,A50,083695,Saad; Andrew S,12,0,30,18
1658049101253,ECE 65,A51,095125,Saad; Andrew S,24,0,26,2
1658049107285,ECE 109,A01,091882,Touri; Behrouz,21,0,70,49
1658049113310,ECE 180,A00,083140,Abi Samra; Nicholas Camill,1,0,30,29
1658049113310,ECE 180,B00,083141,Abi Samra; Nicholas Camill,0,0,30,30
1658049119343,MATH 10A,A01,083735,Patchell; Gregory David,2,0,30,28
1658049119343,MATH 10A,A02,083736,Patchell; Gregory David,20,0,30,10
1658049119343,MATH 10A,A03,083737,Patchell; Gregory David,16,0,30,14
1658049125371,MATH 10B,A01,083207,Lim; Seonhee,9,0,34,25
1658049125371,MATH 10B,A02,083208,Lim; Seonhee,10,0,35,25
1658049125371,MATH 10B,A03,093472,Lim; Seonhee,7,0,34,27
1658049125371,MATH 10B,B01,083739,Sinha; Shubham,14,0,30,16
1658049131409,MATH 18,A01,083743,Cinel; Cameron Alexander,9,0,30,21
1658049131409,MATH 18,A02,083744,Cinel; Cameron Alexander,18,0,30,12
1658049131409,MATH 18,A03,083745,Cinel; Cameron Alexander,10,0,30,20
1658049131409,MATH 18,B01,083748,Rideout; David Porter,5,0,37,32
1658049131409,MATH 18,B02,083749,Rideout; David Porter,5,0,36,31
1658049131409,MATH 18,B03,083750,Rideout; David Porter,3,0,37,34
1658049131409,MATH 18,B04,083751,Rideout; David Porter,7,0,36,29
1658049131409,MATH 18,B05,093473,Rideout; David Porter,7,0,36,29
1658049131409,MATH 18,B06,093474,Rideout; David Porter,6,0,36,30
1658049137438,MATH 20A,A01,083754,Zheng; Zequn,14,0,40,26
1658049143474,MATH 20B,A01,083756,Briones; Jor-el Thomas Caparas,4,0,36,32
1658049143474,MATH 20B,A02,083757,Briones; Jor-el Thomas Caparas,1,0,36,35
1658049143474,MATH 20B,A03,093475,Briones; Jor-el Thomas Caparas,3,0,36,33
1658049149508,MATH 20C,A01,083760,Briones; Jor-el Thomas Caparas,1,0,35,34
1658049149508,MATH 20C,A02,083761,Briones; Jor-el Thomas Caparas,8,0,35,27
1658049149508,MATH 20C,A03,093476,Briones; Jor-el Thomas Caparas,0,1,36,36
1658049149508,MATH 20C,B01,083762,Bach; Quang Tran,1,0,30,29
1658049155538,MATH 20D,A01,083765,Tran; Brian Kha,5,0,30,25
1658049155538,MATH 20D,A02,083766,Tran; Brian Kha,5,0,30,25
1658049155538,MATH 20D,A03,083767,Tran; Brian Kha,6,0,30,24
1658049161564,MATH 20E,A01,083771,Ganguly; Soumya,12,0,32,20
1658049161564,MATH 20E,A02,083772,Ganguly; Soumya,7,0,32,25
1658049161564,MATH 20E,B01,083773,Ciotti; Benjamin,20,0,35,15
1658049161564,MATH 20E,B02,083774,Ciotti; Benjamin,18,0,35,17
1658049167601,MATH 103A,A01,083777,Greenfeld; Be'Eri,6,0,36,30
1658049167601,MATH 103A,A02,083778,Greenfeld; Be'Eri,5,0,36,31
1658049167601,MATH 103A,A03,093561,Greenfeld; Be'Eri,7,0,36,29
1658049167601,MATH 103A,B01,083779,Greenfeld; Be'Eri,8,0,36,28
1658049167601,MATH 103A,B02,083780,Greenfeld; Be'Eri,4,0,36,32
1658049167601,MATH 103A,B03,093562,Greenfeld; Be'Eri,3,0,36,33
1658049173628,MATH 105,A01,085443,Carter; Anne Toulson,15,0,35,20
1658049173628,MATH 105,A02,093477,Carter; Anne Toulson,20,0,35,15
1658049179656,MATH 109,A01,083213,Ganzberger; Geoffrey Michael,3,0,34,31
1658049179656,MATH 109,A02,083214,Ganzberger; Geoffrey Michael,4,0,34,30
1658049179656,MATH 109,A03,093478,Ganzberger; Geoffrey Michael,2,0,34,32
1658049179656,MATH 109,B01,083215,Ganzberger; Geoffrey Michael,3,0,32,29
1658049179656,MATH 109,B02,083216,Ganzberger; Geoffrey Michael,3,0,32,29
1658049179656,MATH 109,B03,093479,Ganzberger; Geoffrey Michael,8,0,32,24
1658049185683,MATH 142A,A01,083219,Chow; Bennett,7,0,32,25
1658049185683,MATH 142A,A02,083220,Chow; Bennett,10,0,32,22
1658049185683,MATH 142A,A03,093480,Chow; Bennett,9,0,32,23
1658049185683,MATH 142A,B03,093481,Chow; Bennett,8,0,32,24
1658049185683,MATH 142A,B04,093558,Chow; Bennett,14,0,32,18
1658049185683,MATH 142A,B05,093559,Chow; Bennett,7,0,32,25
1658049191709,MATH 193A,A01,083224,Rotar; Vladimir,9,0,34,25
1658049191709,MATH 193A,A02,083225,Rotar; Vladimir,11,0,34,23
1658049191709,MATH 193A,A03,083781,Rotar; Vladimir,5,0,34,29
1658049191709,MATH 193A,A04,083782,Rotar; Vladimir,12,0,34,22
1658049191709,MATH 193A,A05,093482,Rotar; Vladimir,11,0,34,23
1658049197733,MATH 197,001,091859,McAuley; Julian John,9999,0,9999,0
1658049197733,MATH 197,002,095566,Kedlaya; Kiran S.,9997,0,9999,2
1658049197733,MATH 197,003,095567,Xiao; Ming,9999,0,9999,0
1658049197733,MATH 197,004,095571,Perols; Johan Lars,9998,0,9999,1
1658049204804,COGS 9,A01,083615,Shannon; Kyle Michael,11,0,75,64
1658049210829,COGS 11,A01,083617,Boyle; Mary E. T.,23,0,48,25
1658049216853,COGS 13,A01,083071,Bastos; Amalia Pinkusfeld,12,0,71,59
1658049222878,COGS 14A,A01,092681,Semenuks; Arturs,5,1,100,95
1658049228903,COGS 14B,A01,083073,Cheng; Tzu-Han,7,0,63,56
1658049234931,COGS 17,A01,092677,Semenuks; Arturs,7,0,81,74
1658049240957,COGS 100,A01,083619,Allen; Michael Gordon,17,0,70,53
1658049246988,COGS 101A,A01,083621,Davis; Joshua Daniel,9,0,68,59
1658049253012,COGS 101B,A01,091572,Allen; Michael Gordon,14,0,65,51
1658049259043,COGS 101C,A01,083625,Delgado; Tania,17,0,35,18
1658049265068,COGS 107A,A01,083627,Boyle; Mary E. T.,14,0,60,46
1658049271094,COGS 118A,A01,083075,Gupta; Anjum,21,0,76,55
1658049277122,CSE 3,A50,083646,Miranda; Gregory Joseph,24,0,50,26
1658049283155,CSE 8A,A50,083650,Miranda; Gregory Joseph,17,1,56,39
1658049289189,CSE 11,A01,083080,Cao; Yingjun,7,15,40,33
1658049295219,CSE 12,A01,083652,Krause-Levy; Sophia Louisa,30,1,120,90
1658049301243,CSE 15L,A01,083654,Morris; Justin Loren,9,0,50,41
1658049301243,CSE 15L,A02,083655,Morris; Justin Loren,11,0,50,39
1658049307273,CSE 20,A01,083657,Tran; Khoa Dang,39,0,80,41
1658049313370,CSE 21,A01,095574,Bach; Quang Tran,23,0,48,25
1658049319401,CSE 30,A01,083084,Eldon; John,8,0,80,72
1658049319401,CSE 30,B01,095061,Bhaskar; Nishant,9,0,50,41
1658049325432,CSE 100,A01,083659,Cao; Yingjun,5,4,70,65
1658049331456,CSE 134B,A01,083661,Powell; Thomas Allan,25,0,100,75
1658049337495,CSE 140,A01,083663,Gungor; Onat,17,0,85,68
1658049343524,CSE 140L,A01,083088,Eldon; John,23,0,100,77
1658049349555,CSE 175,A01,083665,Kumar; Rakesh,3,0,25,22
1658049355592,CSE 190,A00,092507,Dubnov; Shlomo,8,0,20,12
1658049361618,ECE 45,A01,083139,Congero; Spencer William,7,0,75,68
1658049367653,ECE 65,A50,083695,Saad; Andrew S,12,0,30,18
1658049367653,ECE 65,A51,095125,Saad; Andrew S,24,0,26,2
1658049373678,ECE 109,A01,091882,Touri; Behrouz,21,0,70,49
1658049379702,ECE 180,A00,083140,Abi Samra; Nicholas Camill,1,0,30,29
1658049379702,ECE 180,B00,083141,Abi Samra; Nicholas Camill,0,0,30,30
1658049385736,MATH 10A,A01,083735,Patchell; Gregory David,2,0,30,28
1658049385736,MATH 10A,A02,083736,Patchell; Gregory David,20,0,30,10
1658049385736,MATH 10A,A03,083737,Patchell; Gregory David,16,0,30,14
1658049391763,MATH 10B,A01,083207,Lim; Seonhee,9,0,34,25
1658049391763,MATH 10B,A02,083208,Lim; Seonhee,10,0,35,25
1658049391763,MATH 10B,A03,093472,Lim; Seonhee,7,0,34,27
1658049391763,MATH 10B,B01,083739,Sinha; Shubham,14,0,30,16
1658049397804,MATH 18,A01,083743,Cinel; Cameron Alexander,9,0,30,21
1658049397804,MATH 18,A02,083744,Cinel; Cameron Alexander,18,0,30,12
1658049397804,MATH 18,A03,083745,Cinel; Cameron Alexander,10,0,30,20
1658049397804,MATH 18,B01,083748,Rideout; David Porter,5,0,37,32
1658049397804,MATH 18,B02,083749,Rideout; David Porter,5,0,36,31
1658049397804,MATH 18,B03,083750,Rideout; David Porter,3,0,37,34
1658049397804,MATH 18,B04,083751,Rideout; David Porter,7,0,36,29
1658049397804,MATH 18,B05,093473,Rideout; David Porter,7,0,36,29
1658049397804,MATH 18,B06,093474,Rideout; David Porter,6,0,36,30
1658049403830,MATH 20A,A01,083754,Zheng; Zequn,14,0,40,26
1658049409865,MATH 20B,A01,083756,Briones; Jor-el Thomas Caparas,4,0,36,32
1658049409865,MATH 20B,A02,083757,Briones; Jor-el Thomas Caparas,1,0,36,35
1658049409865,MATH 20B,A03,093475,Briones; Jor-el Thomas Caparas,3,0,36,33
1658049415893,MATH 20C,A01,083760,Briones; Jor-el Thomas Caparas,1,0,35,34
1658049415893,MATH 20C,A02,083761,Briones; Jor-el Thomas Caparas,8,0,35,27
1658049415893,MATH 20C,A03,093476,Briones; Jor-el Thomas Caparas,0,1,36,36
1658049415893,MATH 20C,B01,083762,Bach; Quang Tran,1,0,30,29
1658049421916,MATH 20D,A01,083765,Tran; Brian Kha,5,0,30,25
1658049421916,MATH 20D,A02,083766,Tran; Brian Kha,5,0,30,25
1658049421916,MATH 20D,A03,083767,Tran; Brian Kha,6,0,30,24
1658049427949,MATH 20E,A01,083771,Ganguly; Soumya,12,0,32,20
1658049427949,MATH 20E,A02,083772,Ganguly; Soumya,7,0,32,25
1658049427949,MATH 20E,B01,083773,Ciotti; Benjamin,20,0,35,15
1658049427949,MATH 20E,B02,083774,Ciotti; Benjamin,18,0,35,17
1658049433985,MATH 103A,A01,083777,Greenfeld; Be'Eri,6,0,36,30
1658049433985,MATH 103A,A02,083778,Greenfeld; Be'Eri,5,0,36,31
1658049433985,MATH 103A,A03,093561,Greenfeld; Be'Eri,7,0,36,29
1658049433985,MATH 103A,B01,083779,Greenfeld; Be'Eri,8,0,36,28
1658049433985,MATH 103A,B02,083780,Greenfeld; Be'Eri,4,0,36,32
1658049433985,MATH 103A,B03,093562,Greenfeld; Be'Eri,3,0,36,33
1658049440013,MATH 105,A01,085443,Carter; Anne Toulson,15,0,35,20
1658049440013,MATH 105,A02,093477,Carter; Anne Toulson,20,0,35,15
1658049446046,MATH 109,A01,083213,Ganzberger; Geoffrey Michael,3,0,34,31
1658049446046,MATH 109,A02,083214,Ganzberger; Geoffrey Michael,4,0,34,30
1658049446046,MATH 109,A03,093478,Ganzberger; Geoffrey Michael,2,0,34,32
1658049446046,MATH 109,B01,083215,Ganzberger; Geoffrey Michael,3,0,32,29
1658049446046,MATH 109,B02,083216,Ganzberger; Geoffrey Michael,3,0,32,29
1658049446046,MATH 109,B03,093479,Ganzberger; Geoffrey Michael,8,0,32,24
1658049452086,MATH 142A,A01,083219,Chow; Bennett,7,0,32,25
1658049452086,MATH 142A,A02,083220,Chow; Bennett,10,0,32,22
1658049452086,MATH 142A,A03,093480,Chow; Bennett,9,0,32,23
1658049452086,MATH 142A,B03,093481,Chow; Bennett,8,0,32,24
1658049452086,MATH 142A,B04,093558,Chow; Bennett,14,0,32,18
1658049452086,MATH 142A,B05,093559,Chow; Bennett,7,0,32,25
1658049458119,MATH 193A,A01,083224,Rotar; Vladimir,9,0,34,25
1658049458119,MATH 193A,A02,083225,Rotar; Vladimir,11,0,34,23
1658049458119,MATH 193A,A03,083781,Rotar; Vladimir,5,0,34,29
1658049458119,MATH 193A,A04,083782,Rotar; Vladimir,12,0,34,22
1658049458119,MATH 193A,A05,093482,Rotar; Vladimir,11,0,34,23
1658049464148,MATH 197,001,091859,McAuley; Julian John,9999,0,9999,0
1658049464148,MATH 197,002,095566,Kedlaya; Kiran S.,9997,0,9999,2
1658049464148,MATH 197,003,095567,Xiao; Ming,9999,0,9999,0
1658049464148,MATH 197,004,095571,Perols; Johan Lars,9998,0,9999,1
1658049471239,COGS 9,A01,083615,Shannon; Kyle Michael,11,0,75,64
1658049477265,COGS 11,A01,083617,Boyle; Mary E. T.,23,0,48,25
1658049483289,COGS 13,A01,083071,Bastos; Amalia Pinkusfeld,12,0,71,59
1658049489316,COGS 14A,A01,092681,Semenuks; Arturs,5,1,100,95
1658049495341,COGS 14B,A01,083073,Cheng; Tzu-Han,7,0,63,56
1658049501373,COGS 17,A01,092677,Semenuks; Arturs,7,0,81,74
1658049507404,COGS 100,A01,083619,Allen; Michael Gordon,17,0,70,53
1658049513433,COGS 101A,A01,083621,Davis; Joshua Daniel,9,0,68,59
1658049519459,COGS 101B,A01,091572,Allen; Michael Gordon,14,0,65,51
1658049525491,COGS 101C,A01,083625,Delgado; Tania,17,0,35,18
1658049531521,COGS 107A,A01,083627,Boyle; Mary E. T.,14,0,60,46
1658049537552,COGS 118A,A01,083075,Gupta; Anjum,21,0,76,55
1658049543581,CSE 3,A50,083646,Miranda; Gregory Joseph,24,0,50,26
1658049549607,CSE 8A,A50,083650,Miranda; Gregory Joseph,17,1,56,39
1658049555637,CSE 11,A01,083080,Cao; Yingjun,7,15,40,33
1658049561664,CSE 12,A01,083652,Krause-Levy; Sophia Louisa,30,1,120,90
1658049567696,CSE 15L,A01,083654,Morris; Justin Loren,9,0,50,41
1658049567696,CSE 15L,A02,083655,Morris; Justin Loren,11,0,50,39
1658049573723,CSE 20,A01,083657,Tran; Khoa Dang,39,0,80,41
1658049579756,CSE 21,A01,095574,Bach; Quang Tran,23,0,48,25
1658049585790,CSE 30,A01,083084,Eldon; John,8,0,80,72
1658049585790,CSE 30,B01,095061,Bhaskar; Nishant,9,0,50,41
1658049591816,CSE 100,A01,083659,Cao; Yingjun,5,4,70,65
1658049597841,CSE 134B,A01,083661,Powell; Thomas Allan,25,0,100,75
1658049603872,CSE 140,A01,083663,Gungor; Onat,17,0,85,68
1658049609900,CSE 140L,A01,083088,Eldon; John,23,0,100,77
1658049615930,CSE 175,A01,083665,Kumar; Rakesh,3,0,25,22
1658049621955,CSE 190,A00,092507,Dubnov; Shlomo,8,0,20,12
1658049628004,ECE 45,A01,083139,Congero; Spencer William,7,0,75,68
1658049634039,ECE 65,A50,083695,Saad; Andrew S,12,0,30,18
1658049634039,ECE 65,A51,095125,Saad; Andrew S,24,0,26,2
1658049640066,ECE 109,A01,091882,Touri; Behrouz,21,0,70,49
1658049646092,ECE 180,A00,083140,Abi Samra; Nicholas Camill,1,0,30,29
1658049646092,ECE 180,B00,083141,Abi Samra; Nicholas Camill,0,0,30,30
1658049652119,MATH 10A,A01,083735,Patchell; Gregory David,2,0,30,28
1658049652119,MATH 10A,A02,083736,Patchell; Gregory David,20,0,30,10
1658049652119,MATH 10A,A03,083737,Patchell; Gregory David,16,0,30,14
1658049658149,MATH 10B,A01,083207,Lim; Seonhee,9,0,34,25
1658049658149,MATH 10B,A02,083208,Lim; Seonhee,10,0,35,25
1658049658149,MATH 10B,A03,093472,Lim; Seonhee,7,0,34,27
1658049658149,MATH 10B,B01,083739,Sinha; Shubham,14,0,30,16
1658049664177,MATH 18,A01,083743,Cinel; Cameron Alexander,9,0,30,21
1658049664177,MATH 18,A02,083744,Cinel; Cameron Alexander,18,0,30,12
1658049664177,MATH 18,A03,083745,Cinel; Cameron Alexander,10,0,30,20
1658049664177,MATH 18,B01,083748,Rideout; David Porter,5,0,37,32
1658049664177,MATH 18,B02,083749,Rideout; David Porter,5,0,36,31
1658049664177,MATH 18,B03,083750,Rideout; David Porter,3,0,37,34
1658049664177,MATH 18,B04,083751,Rideout; David Porter,7,0,36,29
1658049664177,MATH 18,B05,093473,Rideout; David Porter,7,0,36,29
1658049664177,MATH 18,B06,093474,Rideout; David Porter,6,0,36,30
1658049670202,MATH 20A,A01,083754,Zheng; Zequn,14,0,40,26
1658049676240,MATH 20B,A01,083756,Briones; Jor-el Thomas Caparas,4,0,36,32
1658049676240,MATH 20B,A02,083757,Briones; Jor-el Thomas Caparas,1,0,36,35
1658049676240,MATH 20B,A03,093475,Briones; Jor-el Thomas Caparas,3,0,36,33
1658049682266,MATH 20C,A01,083760,Briones; Jor-el Thomas Caparas,1,0,35,34
1658049682266,MATH 20C,A02,083761,Briones; Jor-el Thomas Caparas,8,0,35,27
1658049682266,MATH 20C,A03,093476,Briones; Jor-el Thomas Caparas,0,1,36,36
1658049682266,MATH 20C,B01,083762,Bach; Quang Tran,1,0,30,29
1658049688290,MATH 20D,A01,083765,Tran; Brian Kha,5,0,30,25
1658049688290,MATH 20D,A02,083766,Tran; Brian Kha,5,0,30,25
1658049688290,MATH 20D,A03,083767,Tran; Brian Kha,6,0,30,24
1658049694325,MATH 20E,A01,083771,Ganguly; Soumya,12,0,32,20
1658049694325,MATH 20E,A02,083772,Ganguly; Soumya,7,0,32,25
1658049694325,MATH 20E,B01,083773,Ciotti; Benjamin,20,0,35,15
1658049694325,MATH 20E,B02,083774,Ciotti; Benjamin,18,0,35,17
1658049700354,MATH 103A,A01,083777,Greenfeld; Be'Eri,6,0,36,30
1658049700354,MATH 103A,A02,083778,Greenfeld; Be'Eri,5,0,36,31
1658049700354,MATH 103A,A03,093561,Greenfeld; Be'Eri,7,0,36,29
1658049700354,MATH 103A,B01,083779,Greenfeld; Be'Eri,8,0,36,28
1658049700354,MATH 103A,B02,083780,Greenfeld; Be'Eri,4,0,36,32
1658049700354,MATH 103A,B03,093562,Greenfeld; Be'Eri,3,0,36,33
1658049706388,MATH 105,A01,085443,Carter; Anne Toulson,15,0,35,20
1658049706388,MATH 105,A02,093477,Carter; Anne Toulson,20,0,35,15
1658049712422,MATH 109,A01,083213,Ganzberger; Geoffrey Michael,3,0,34,31
1658049712422,MATH 109,A02,083214,Ganzberger; Geoffrey Michael,4,0,34,30
1658049712422,MATH 109,A03,093478,Ganzberger; Geoffrey Michael,2,0,34,32
1658049712422,MATH 109,B01,083215,Ganzberger; Geoffrey Michael,3,0,32,29
1658049712422,MATH 109,B02,083216,Ganzberger; Geoffrey Michael,3,0,32,29
1658049712422,MATH 109,B03,093479,Ganzberger; Geoffrey Michael,8,0,32,24
1658049718471,MATH 142A,A01,083219,Chow; Bennett,7,0,32,25
1658049718471,MATH 142A,A02,083220,Chow; Bennett,10,0,32,22
1658049718471,MATH 142A,A03,093480,Chow; Bennett,9,0,32,23
1658049718471,MATH 142A,B03,093481,Chow; Bennett,8,0,32,24
1658049718471,MATH 142A,B04,093558,Chow; Bennett,14,0,32,18
1658049718471,MATH 142A,B05,093559,Chow; Bennett,7,0,32,25
1658049724498,MATH 193A,A01,083224,Rotar; Vladimir,9,0,34,25
1658049724498,MATH 193A,A02,083225,Rotar; Vladimir,11,0,34,23
1658049724498,MATH 193A,A03,083781,Rotar; Vladimir,5,0,34,29
1658049724498,MATH 193A,A04,083782,Rotar; Vladimir,12,0,34,22
1658049724498,MATH 193A,A05,093482,Rotar; Vladimir,11,0,34,23
1658049730526,MATH 197,001,091859,McAuley; Julian John,9999,0,9999,0
1658049730526,MATH 197,002,095566,Kedlaya; Kiran S.,9997,0,9999,2
1658049730526,MATH 197,003,095567,Xiao; Ming,9999,0,9999,0
1658049730526,MATH 197,004,095571,Perols; Johan Lars,9998,0,9999,1
1658049737607,COGS 9,A01,083615,Shannon; Kyle Michael,11,0,75,64
1658049743632,COGS 11,A01,083617,Boyle; Mary E. T.,23,0,48,25
1658049749658,COGS 13,A01,083071,Bastos; Amalia Pinkusfeld,12,0,71,59
1658049755691,COGS 14A,A01,092681,Semenuks; Arturs,5,1,100,95
1658049761719,COGS 14B,A01,083073,Cheng; Tzu-Han,7,0,63,56
1658049767748,COGS 17,A01,092677,Semenuks; Arturs,7,0,81,74
1658049773777,COGS 100,A01,083619,Allen; Michael Gordon,17,0,70,53
1658049779803,COGS 101A,A01,083621,Davis; Joshua Daniel,9,0,68,59
1658049785830,COGS 101B,A01,091572,Allen; Michael Gordon,14,0,65,51
1658049791857,COGS 101C,A01,083625,Delgado; Tania,17,0,35,18
1658049797883,COGS 107A,A01,083627,Boyle; Mary E. T.,14,0,60,46
1658049803912,COGS 118A,A01,083075,Gupta; Anjum,21,0,76,55
1658049809940,CSE 3,A50,083646,Miranda; Gregory Joseph,24,0,50,26
1658049815978,CSE 8A,A50,083650,Miranda; Gregory Joseph,17,1,56,39
1658049822008,CSE 11,A01,083080,Cao; Yingjun,7,15,40,33
1658049828034,CSE 12,A01,083652,Krause-Levy; Sophia Louisa,30,1,120,90
1658049834057,CSE 15L,A01,083654,Morris; Justin Loren,9,0,50,41
1658049834057,CSE 15L,A02,083655,Morris; Justin Loren,11,0,50,39
1658049840083,CSE 20,A01,083657,Tran; Khoa Dang,39,0,80,41
1658049846109,CSE 21,A01,095574,Bach; Quang Tran,23,0,48,25
1658049852145,CSE 30,A01,083084,Eldon; John,8,0,80,72
1658049852145,CSE 30,B01,095061,Bhaskar; Nishant,9,0,50,41
1658049858171,CSE 100,A01,083659,Cao; Yingjun,5,4,70,65
1658049864203,CSE 134B,A01,083661,Powell; Thomas Allan,25,0,100,75
1658049870227,CSE 140,A01,083663,Gungor; Onat,17,0,85,68
1658049876257,CSE 140L,A01,083088,Eldon; John,23,0,100,77
1658049882287,CSE 175,A01,083665,Kumar; Rakesh,3,0,25,22
1658049888321,CSE 190,A00,092507,Dubnov; Shlomo,8,0,20,12
1658049894362,ECE 45,A01,083139,Congero; Spencer William,7,0,75,68
1658049900399,ECE 65,A50,083695,Saad; Andrew S,12,0,30,18
1658049900399,ECE 65,A51,095125,Saad; Andrew S,24,0,26,2
1658049906425,ECE 109,A01,091882,Touri; Behrouz,21,0,70,49
1658049912532,ECE 180,A00,083140,Abi Samra; Nicholas Camill,1,0,30,29
1658049912532,ECE 180,B00,083141,Abi Samra; Nicholas Camill,0,0,30,30
1658049918563,MATH 10A,A01,083735,Patchell; Gregory David,2,0,30,28
1658049918563,MATH 10A,A02,083736,Patchell; Gregory David,20,0,30,10
1658049918563,MATH 10A,A03,083737,Patchell; Gregory David,16,0,30,14
1658049924593,MATH 10B,A01,083207,Lim; Seonhee,9,0,34,25
1658049924593,MATH 10B,A02,083208,Lim; Seonhee,10,0,35,25
1658049924593,MATH 10B,A03,093472,Lim; Seonhee,7,0,34,27
1658049924593,MATH 10B,B01,083739,Sinha; Shubham,14,0,30,16
1658049930622,MATH 18,A01,083743,Cinel; Cameron Alexander,9,0,30,21
1658049930622,MATH 18,A02,083744,Cinel; Cameron Alexander,18,0,30,12
1658049930622,MATH 18,A03,083745,Cinel; Cameron Alexander,10,0,30,20
1658049930622,MATH 18,B01,083748,Rideout; David Porter,5,0,37,32
1658049930622,MATH 18,B02,083749,Rideout; David Porter,5,0,36,31
1658049930622,MATH 18,B03,083750,Rideout; David Porter,3,0,37,34
1658049930622,MATH 18,B04,083751,Rideout; David Porter,7,0,36,29
1658049930622,MATH 18,B05,093473,Rideout; David Porter,7,0,36,29
1658049930622,MATH 18,B06,093474,Rideout; David Porter,6,0,36,30
1658049936653,MATH 20A,A01,083754,Zheng; Zequn,14,0,40,26
1658049942680,MATH 20B,A01,083756,Briones; Jor-el Thomas Caparas,4,0,36,32
1658049942680,MATH 20B,A02,083757,Briones; Jor-el Thomas Caparas,1,0,36,35
1658049942680,MATH 20B,A03,093475,Briones; Jor-el Thomas Caparas,3,0,36,33
1658049948709,MATH 20C,A01,083760,Briones; Jor-el Thomas Caparas,1,0,35,34
1658049948709,MATH 20C,A02,083761,Briones; Jor-el Thomas Caparas,8,0,35,27
1658049948709,MATH 20C,A03,093476,Briones; Jor-el Thomas Caparas,0,1,36,36
1658049948709,MATH 20C,B01,083762,Bach; Quang Tran,1,0,30,29
1658049954739,MATH 20D,A01,083765,Tran; Brian Kha,5,0,30,25
1658049954739,MATH 20D,A02,083766,Tran; Brian Kha,5,0,30,25
1658049954739,MATH 20D,A03,083767,Tran; Brian Kha,6,0,30,24
1658049960776,MATH 20E,A01,083771,Ganguly; Soumya,12,0,32,20
1658049960776,MATH 20E,A02,083772,Ganguly; Soumya,7,0,32,25
1658049960776,MATH 20E,B01,083773,Ciotti; Benjamin,20,0,35,15
1658049960776,MATH 20E,B02,083774,Ciotti; Benjamin,18,0,35,17
1658049966820,MATH 103A,A01,083777,Greenfeld; Be'Eri,6,0,36,30
1658049966820,MATH 103A,A02,083778,Greenfeld; Be'Eri,5,0,36,31
1658049966820,MATH 103A,A03,093561,Greenfeld; Be'Eri,7,0,36,29
1658049966820,MATH 103A,B01,083779,Greenfeld; Be'Eri,8,0,36,28
1658049966820,MATH 103A,B02,083780,Greenfeld; Be'Eri,4,0,36,32
1658049966820,MATH 103A,B03,093562,Greenfeld; Be'Eri,3,0,36,33
1658049972850,MATH 105,A01,085443,Carter; Anne Toulson,15,0,35,20
1658049972850,MATH 105,A02,093477,Carter; Anne Toulson,20,0,35,15
1658049978883,MATH 109,A01,083213,Ganzberger; Geoffrey Michael,3,0,34,31
1658049978883,MATH 109,A02,083214,Ganzberger; Geoffrey Michael,4,0,34,30
1658049978883,MATH 109,A03,093478,Ganzberger; Geoffrey Michael,2,0,34,32
1658049978883,MATH 109,B01,083215,Ganzberger; Geoffrey Michael,3,0,32,29
1658049978883,MATH 109,B02,083216,Ganzberger; Geoffrey Michael,3,0,32,29
1658049978883,MATH 109,B03,093479,Ganzberger; Geoffrey Michael,8,0,32,24
1658049984913,MATH 142A,A01,083219,Chow; Bennett,7,0,32,25
1658049984913,MATH 142A,A02,083220,Chow; Bennett,10,0,32,22
1658049984913,MATH 142A,A03,093480,Chow; Bennett,9,0,32,23
1658049984913,MATH 142A,B03,093481,Chow; Bennett,8,0,32,24
1658049984913,MATH 142A,B04,093558,Chow; Bennett,14,0,32,18
1658049984913,MATH 142A,B05,093559,Chow; Bennett,7,0,32,25
1658049990947,MATH 193A,A01,083224,Rotar; Vladimir,9,0,34,25
1658049990947,MATH 193A,A02,083225,Rotar; Vladimir,11,0,34,23
1658049990947,MATH 193A,A03,083781,Rotar; Vladimir,5,0,34,29
1658049990947,MATH 193A,A04,083782,Rotar; Vladimir,12,0,34,22
1658049990947,MATH 193A,A05,093482,Rotar; Vladimir,11,0,34,23
1658049996981,MATH 197,001,091859,McAuley; Julian John,9999,0,9999,0
1658049996981,MATH 197,002,095566,Kedlaya; Kiran S.,9997,0,9999,2
1658049996981,MATH 197,003,095567,Xiao; Ming,9999,0,9999,0
1658049996981,MATH 197,004,095571,Perols; Johan Lars,9998,0,9999,1
1658050004078,COGS 9,A01,083615,Shannon; Kyle Michael,11,0,75,64
1658050010104,COGS 11,A01,083617,Boyle; Mary E. T.,23,0,48,25
1658050016134,COGS 13,A01,083071,Bastos; Amalia Pinkusfeld,12,0,71,59
1658050022161,COGS 14A,A01,092681,Semenuks; Arturs,5,1,100,95
1658050028187,COGS 14B,A01,083073,Cheng; Tzu-Han,7,0,63,56
1658050034213,COGS 17,A01,092677,Semenuks; Arturs,7,0,81,74
1658050040240,COGS 100,A01,083619,Allen; Michael Gordon,17,0,70,53
1658050046271,COGS 101A,A01,083621,Davis; Joshua Daniel,9,0,68,59
1658050052303,COGS 101B,A01,091572,Allen; Michael Gordon,14,0,65,51
1658050058334,COGS 101C,A01,083625,Delgado; Tania,17,0,35,18
1658050064366,COGS 107A,A01,083627,Boyle; Mary E. T.,14,0,60,46
1658050070399,COGS 118A,A01,083075,Gupta; Anjum,21,0,76,55
1658050076434,CSE 3,A50,083646,Miranda; Gregory Joseph,24,0,50,26
1658050082460,CSE 8A,A50,083650,Miranda; Gregory Joseph,17,1,56,39
1658050088485,CSE 11,A01,083080,Cao; Yingjun,7,15,40,33
1658050094531,CSE 12,A01,083652,Krause-Levy; Sophia Louisa,30,1,120,90
1658050100556,CSE 15L,A01,083654,Morris; Justin Loren,9,0,50,41
1658050100556,CSE 15L,A02,083655,Morris; Justin Loren,11,0,50,39
1658050106582,CSE 20,A01,083657,Tran; Khoa Dang,39,0,80,41
1658050112612,CSE 21,A01,095574,Bach; Quang Tran,23,0,48,25
1658050118646,CSE 30,A01,083084,Eldon; John,8,0,80,72
1658050118646,CSE 30,B01,095061,Bhaskar; Nishant,9,0,50,41
1658050124673,CSE 100,A01,083659,Cao; Yingjun,5,4,70,65
1658050130702,CSE 134B,A01,083661,Powell; Thomas Allan,25,0,100,75
1658050136727,CSE 140,A01,083663,Gungor; Onat,17,0,85,68
1658050142757,CSE 140L,A01,083088,Eldon; John,23,0,100,77
1658050148783,CSE 175,A01,083665,Kumar; Rakesh,3,0,25,22
1658050154813,CSE 190,A00,092507,Dubnov; Shlomo,8,0,20,12
1658050160846,ECE 45,A01,083139,Congero; Spencer William,7,0,75,68
1658050166880,ECE 65,A50,083695,Saad; Andrew S,12,0,30,18
1658050166880,ECE 65,A51,095125,Saad; Andrew S,24,0,26,2
1658050172907,ECE 109,A01,091882,Touri; Behrouz,21,0,70,49
1658050178933,ECE 180,A00,083140,Abi Samra; Nicholas Camill,1,0,30,29
1658050178933,ECE 180,B00,083141,Abi Samra; Nicholas Camill,0,0,30,30
1658050184960,MATH 10A,A01,083735,Patchell; Gregory David,2,0,30,28
1658050184960,MATH 10A,A02,083736,Patchell; Gregory David,20,0,30,10
1658050184960,MATH 10A,A03,083737,Patchell; Gregory David,16,0,30,14
1658050190998,MATH 10B,A01,083207,Lim; Seonhee,9,0,34,25
1658050190998,MATH 10B,A02,083208,Lim; Seonhee,10,0,35,25
1658050190998,MATH 10B,A03,093472,Lim; Seonhee,7,0,34,27
1658050190998,MATH 10B,B01,083739,Sinha; Shubham,14,0,30,16
1658050197039,MATH 18,A01,083743,Cinel; Cameron Alexander,9,0,30,21
1658050197039,MATH 18,A02,083744,Cinel; Cameron Alexander,18,0,30,12
1658050197039,MATH 18,A03,083745,Cinel; Cameron Alexander,10,0,30,20
1658050197039,MATH 18,B01,083748,Rideout; David Porter,5,0,37,32
1658050197039,MATH 18,B02,083749,Rideout; David Porter,5,0,36,31
1658050197039,MATH 18,B03,083750,Rideout; David Porter,3,0,37,34
1658050197039,MATH 18,B04,083751,Rideout; David Porter,7,0,36,29
1658050197039,MATH 18,B05,093473,Rideout; David Porter,7,0,36,29
1658050197039,MATH 18,B06,093474,Rideout; David Porter,6,0,36,30
1658050203068,MATH 20A,A01,083754,Zheng; Zequn,14,0,40,26
1658050209096,MATH 20B,A01,083756,Briones; Jor-el Thomas Caparas,4,0,36,32
1658050209096,MATH 20B,A02,083757,Briones; Jor-el Thomas Caparas,1,0,36,35
1658050209096,MATH 20B,A03,093475,Briones; Jor-el Thomas Caparas,3,0,36,33
1658050215132,MATH 20C,A01,083760,Briones; Jor-el Thomas Caparas,1,0,35,34
1658050215132,MATH 20C,A02,083761,Briones; Jor-el Thomas Caparas,8,0,35,27
1658050215132,MATH 20C,A03,093476,Briones; Jor-el Thomas Caparas,0,1,36,36
1658050215132,MATH 20C,B01,083762,Bach; Quang Tran,1,0,30,29
1658050221159,MATH 20D,A01,083765,Tran; Brian Kha,5,0,30,25
1658050221159,MATH 20D,A02,083766,Tran; Brian Kha,5,0,30,25
1658050221159,MATH 20D,A03,083767,Tran; Brian Kha,6,0,30,24
1658050227187,MATH 20E,A01,083771,Ganguly; Soumya,12,0,32,20
1658050227187,MATH 20E,A02,083772,Ganguly; Soumya,7,0,32,25
1658050227187,MATH 20E,B01,083773,Ciotti; Benjamin,20,0,35,15
1658050227187,MATH 20E,B02,083774,Ciotti; Benjamin,18,0,35,17
1658050233232,MATH 103A,A01,083777,Greenfeld; Be'Eri,6,0,36,30
1658050233232,MATH 103A,A02,083778,Greenfeld; Be'Eri,5,0,36,31
1658050233232,MATH 103A,A03,093561,Greenfeld; Be'Eri,7,0,36,29
1658050233232,MATH 103A,B01,083779,Greenfeld; Be'Eri,8,0,36,28
1658050233232,MATH 103A,B02,083780,Greenfeld; Be'Eri,4,0,36,32
1658050233232,MATH 103A,B03,093562,Greenfeld; Be'Eri,3,0,36,33
1658050239260,MATH 105,A01,085443,Carter; Anne Toulson,15,0,35,20
1658050239260,MATH 105,A02,093477,Carter; Anne Toulson,20,0,35,15
1658050245289,MATH 109,A01,083213,Ganzberger; Geoffrey Michael,3,0,34,31
1658050245289,MATH 109,A02,083214,Ganzberger; Geoffrey Michael,4,0,34,30
1658050245289,MATH 109,A03,093478,Ganzberger; Geoffrey Michael,2,0,34,32
1658050245289,MATH 109,B01,083215,Ganzberger; Geoffrey Michael,3,0,32,29
1658050245289,MATH 109,B02,083216,Ganzberger; Geoffrey Michael,3,0,32,29
1658050245289,MATH 109,B03,093479,Ganzberger; Geoffrey Michael,8,0,32,24
1658050251328,MATH 142A,A01,083219,Chow; Bennett,7,0,32,25
1658050251328,MATH 142A,A02,083220,Chow; Bennett,10,0,32,22
1658050251328,MATH 142A,A03,093480,Chow; Bennett,9,0,32,23
1658050251328,MATH 142A,B03,093481,Chow; Bennett,8,0,32,24
1658050251328,MATH 142A,B04,093558,Chow; Bennett,14,0,32,18
1658050251328,MATH 142A,B05,093559,Chow; Bennett,7,0,32,25
1658050257362,MATH 193A,A01,083224,Rotar; Vladimir,9,0,34,25
1658050257362,MATH 193A,A02,083225,Rotar; Vladimir,11,0,34,23
1658050257362,MATH 193A,A03,083781,Rotar; Vladimir,5,0,34,29
1658050257362,MATH 193A,A04,083782,Rotar; Vladimir,12,0,34,22
1658050257362,MATH 193A,A05,093482,Rotar; Vladimir,11,0,34,23
1658050263387,MATH 197,001,091859,McAuley; Julian John,9999,0,9999,0
1658050263387,MATH 197,002,095566,Kedlaya; Kiran S.,9997,0,9999,2
1658050263387,MATH 197,003,095567,Xiao; Ming,9999,0,9999,0
1658050263387,MATH 197,004,095571,Perols; Johan Lars,9998,0,9999,1
1658050270466,COGS 9,A01,083615,Shannon; Kyle Michael,11,0,75,64
1658050276491,COGS 11,A01,083617,Boyle; Mary E. T.,23,0,48,25
1658050282521,COGS 13,A01,083071,Bastos; Amalia Pinkusfeld,12,0,71,59
1658050288552,COGS 14A,A01,092681,Semenuks; Arturs,5,1,100,95
1658050294581,COGS 14B,A01,083073,Cheng; Tzu-Han,7,0,63,56
1658050300611,COGS 17,A01,092677,Semenuks; Arturs,7,0,81,74
1658050306644,COGS 100,A01,083619,Allen; Michael Gordon,17,0,70,53
1658050312675,COGS 101A,A01,083621,Davis; Joshua Daniel,9,0,68,59
1658050318700,COGS 101B,A01,091572,Allen; Michael Gordon,14,0,65,51
1658050324725,COGS 101C,A01,083625,Delgado; Tania,17,0,35,18
1658050330754,COGS 107A,A01,083627,Boyle; Mary E. T.,14,0,60,46
1658050336778,COGS 118A,A01,083075,Gupta; Anjum,21,0,76,55
1658050342804,CSE 3,A50,083646,Miranda; Gregory Joseph,24,0,50,26
1658050348831,CSE 8A,A50,083650,Miranda; Gregory Joseph,17,1,56,39
1658050354854,CSE 11,A01,083080,Cao; Yingjun,7,15,40,33
1658050360883,CSE 12,A01,083652,Krause-Levy; Sophia Louisa,30,1,120,90
1658050366910,CSE 15L,A01,083654,Morris; Justin Loren,9,0,50,41
1658050366910,CSE 15L,A02,083655,Morris; Justin Loren,11,0,50,39
1658050372935,CSE 20,A01,083657,Tran; Khoa Dang,39,0,80,41
1658050378961,CSE 21,A01,095574,Bach; Quang Tran,23,0,48,25
1658050384989,CSE 30,A01,083084,Eldon; John,8,0,80,72
1658050384989,CSE 30,B01,095061,Bhaskar; Nishant,9,0,50,41
1658050391015,CSE 100,A01,083659,Cao; Yingjun,5,4,70,65
1658050397039,CSE 134B,A01,083661,Powell; Thomas Allan,25,0,100,75
1658050403064,CSE 140,A01,083663,Gungor; Onat,17,0,85,68
1658050409090,CSE 140L,A01,083088,Eldon; John,23,0,100,77
1658050415115,CSE 175,A01,083665,Kumar; Rakesh,3,0,25,22
1658050421143,CSE 190,A00,092507,Dubnov; Shlomo,8,0,20,12
1658050427170,ECE 45,A01,083139,Congero; Spencer William,7,0,75,68
1658050433197,ECE 65,A50,083695,Saad; Andrew S,12,0,30,18
1658050433197,ECE 65,A51,095125,Saad; Andrew S,24,0,26,2
1658050439222,ECE 109,A01,091882,Touri; Behrouz,21,0,70,49
1658050445256,ECE 180,A00,083140,Abi Samra; Nicholas Camill,1,0,30,29
1658050445256,ECE 180,B00,083141,Abi Samra; Nicholas Camill,0,0,30,30
1658050451283,MATH 10A,A01,083735,Patchell; Gregory David,2,0,30,28
1658050451283,MATH 10A,A02,083736,Patchell; Gregory David,20,0,30,10
1658050451283,MATH 10A,A03,083737,Patchell; Gregory David,16,0,30,14
1658050457314,MATH 10B,A01,083207,Lim; Seonhee,9,0,34,25
1658050457314,MATH 10B,A02,083208,Lim; Seonhee,10,0,35,25
1658050457314,MATH 10B,A03,093472,Lim; Seonhee,7,0,34,27
1658050457314,MATH 10B,B01,083739,Sinha; Shubham,14,0,30,16
1658050463341,MATH 18,A01,083743,Cinel; Cameron Alexander,9,0,30,21
1658050463341,MATH 18,A02,083744,Cinel; Cameron Alexander,18,0,30,12
1658050463341,MATH 18,A03,083745,Cinel; Cameron Alexander,10,0,30,20
1658050463341,MATH 18,B01,083748,Rideout; David Porter,5,0,37,32
1658050463341,MATH 18,B02,083749,Rideout; David Porter,5,0,36,31
1658050463341,MATH 18,B03,083750,Rideout; David Porter,3,0,37,34
1658050463341,MATH 18,B04,083751,Rideout; David Porter,7,0,36,29
1658050463341,MATH 18,B05,093473,Rideout; David Porter,7,0,36,29
1658050463341,MATH 18,B06,093474,Rideout; David Porter,6,0,36,30
1658050469366,MATH 20A,A01,083754,Zheng; Zequn,14,0,40,26
1658050475394,MATH 20B,A01,083756,Briones; Jor-el Thomas Caparas,4,0,36,32
1658050475394,MATH 20B,A02,083757,Briones; Jor-el Thomas Caparas,1,0,36,35
1658050475394,MATH 20B,A03,093475,Briones; Jor-el Thomas Caparas,3,0,36,33
1658050481427,MATH 20C,A01,083760,Briones; Jor-el Thomas Caparas,1,0,35,34
1658050481427,MATH 20C,A02,083761,Briones; Jor-el Thomas Caparas,8,0,35,27
1658050481427,MATH 20C,A03,093476,Briones; Jor-el Thomas Caparas,0,1,36,36
1658050481427,MATH 20C,B01,083762,Bach; Quang Tran,1,0,30,29
1658050487458,MATH 20D,A01,083765,Tran; Brian Kha,5,0,30,25
1658050487458,MATH 20D,A02,083766,Tran; Brian Kha,5,0,30,25
1658050487458,MATH 20D,A03,083767,Tran; Brian Kha,6,0,30,24
1658050493486,MATH 20E,A01,083771,Ganguly; Soumya,12,0,32,20
1658050493486,MATH 20E,A02,083772,Ganguly; Soumya,7,0,32,25
1658050493486,MATH 20E,B01,083773,Ciotti; Benjamin,20,0,35,15
1658050493486,MATH 20E,B02,083774,Ciotti; Benjamin,18,0,35,17
1658050499514,MATH 103A,A01,083777,Greenfeld; Be'Eri,6,0,36,30
1658050499514,MATH 103A,A02,083778,Greenfeld; Be'Eri,5,0,36,31
1658050499514,MATH 103A,A03,093561,Greenfeld; Be'Eri,7,0,36,29
1658050499514,MATH 103A,B01,083779,Greenfeld; Be'Eri,8,0,36,28
1658050499514,MATH 103A,B02,083780,Greenfeld; Be'Eri,4,0,36,32
1658050499514,MATH 103A,B03,093562,Greenfeld; Be'Eri,3,0,36,33
1658050505544,MATH 105,A01,085443,Carter; Anne Toulson,15,0,35,20
1658050505544,MATH 105,A02,093477,Carter; Anne Toulson,20,0,35,15
1658050511649,MATH 109,A01,083213,Ganzberger; Geoffrey Michael,3,0,34,31
1658050511649,MATH 109,A02,083214,Ganzberger; Geoffrey Michael,4,0,34,30
1658050511649,MATH 109,A03,093478,Ganzberger; Geoffrey Michael,2,0,34,32
1658050511649,MATH 109,B01,083215,Ganzberger; Geoffrey Michael,3,0,32,29
1658050511649,MATH 109,B02,083216,Ganzberger; Geoffrey Michael,3,0,32,29
1658050511649,MATH 109,B03,093479,Ganzberger; Geoffrey Michael,8,0,32,24
1658050517677,MATH 142A,A01,083219,Chow; Bennett,7,0,32,25
1658050517677,MATH 142A,A02,083220,Chow; Bennett,10,0,32,22
1658050517677,MATH 142A,A03,093480,Chow; Bennett,9,0,32,23
1658050517677,MATH 142A,B03,093481,Chow; Bennett,8,0,32,24
1658050517677,MATH 142A,B04,093558,Chow; Bennett,14,0,32,18
1658050517677,MATH 142A,B05,093559,Chow; Bennett,7,0,32,25
1658050523701,MATH 193A,A01,083224,Rotar; Vladimir,9,0,34,25
1658050523701,MATH 193A,A02,083225,Rotar; Vladimir,11,0,34,23
1658050523701,MATH 193A,A03,083781,Rotar; Vladimir,5,0,34,29
1658050523701,MATH 193A,A04,083782,Rotar; Vladimir,12,0,34,22
1658050523701,MATH 193A,A05,093482,Rotar; Vladimir,11,0,34,23
1658050529727,MATH 197,001,091859,McAuley; Julian John,9999,0,9999,0
1658050529727,MATH 197,002,095566,Kedlaya; Kiran S.,9997,0,9999,2
1658050529727,MATH 197,003,095567,Xiao; Ming,9999,0,9999,0
1658050529727,MATH 197,004,095571,Perols; Johan Lars,9998,0,9999,1
1658050536807,COGS 9,A01,083615,Shannon; Kyle Michael,11,0,75,64
1658050542836,COGS 11,A01,083617,Boyle; Mary E. T.,23,0,48,25
1658050548871,COGS 13,A01,083071,Bastos; Amalia Pinkusfeld,12,0,71,59
1658050554901,COGS 14A,A01,092681,Semenuks; Arturs,5,1,100,95
1658050560931,COGS 14B,A01,083073,Cheng; Tzu-Han,7,0,63,56
1658050566960,COGS 17,A01,092677,Semenuks; Arturs,7,0,81,74
1658050572988,COGS 100,A01,083619,Allen; Michael Gordon,17,0,70,53
1658050579018,COGS 101A,A01,083621,Davis; Joshua Daniel,9,0,68,59
1658050585042,COGS 101B,A01,091572,Allen; Michael Gordon,14,0,65,51
1658050591073,COGS 101C,A01,083625,Delgado; Tania,17,0,35,18
1658050597096,COGS 107A,A01,083627,Boyle; Mary E. T.,14,0,60,46
1658050603126,COGS 118A,A01,083075,Gupta; Anjum,21,0,76,55
1658050609151,CSE 3,A50,083646,Miranda; Gregory Joseph,24,0,50,26
1658050615176,CSE 8A,A50,083650,Miranda; Gregory Joseph,17,1,56,39
1658050621201,CSE 11,A01,083080,Cao; Yingjun,7,15,40,33
1658050627225,CSE 12,A01,083652,Krause-Levy; Sophia Louisa,30,1,120,90
1658050633251,CSE 15L,A01,083654,Morris; Justin Loren,9,0,50,41
1658050633251,CSE 15L,A02,083655,Morris; Justin Loren,11,0,50,39
1658050639282,CSE 20,A01,083657,Tran; Khoa Dang,39,0,80,41
1658050645310,CSE 21,A01,095574,Bach; Quang Tran,23,0,48,25
1658050651345,CSE 30,A01,083084,Eldon; John,8,0,80,72
1658050651345,CSE 30,B01,095061,Bhaskar; Nishant,9,0,50,41
1658050657370,CSE 100,A01,083659,Cao; Yingjun,5,4,70,65
1658050663396,CSE 134B,A01,083661,Powell; Thomas Allan,25,0,100,75
1658050669422,CSE 140,A01,083663,Gungor; Onat,17,0,85,68
1658050675447,CSE 140L,A01,083088,Eldon; John,23,0,100,77
1658050681475,CSE 175,A01,083665,Kumar; Rakesh,3,0,25,22
1658050687499,CSE 190,A00,092507,Dubnov; Shlomo,8,0,20,12
1658050693532,ECE 45,A01,083139,Congero; Spencer William,7,0,75,68
1658050699558,ECE 65,A50,083695,Saad; Andrew S,12,0,30,18
1658050699558,ECE 65,A51,095125,Saad; Andrew S,24,0,26,2
1658050705584,ECE 109,A01,091882,Touri; Behrouz,21,0,70,49
1658050711617,ECE 180,A00,083140,Abi Samra; Nicholas Camill,1,0,30,29
1658050711617,ECE 180,B00,083141,Abi Samra; Nicholas Camill,0,0,30,30
1658050717653,MATH 10A,A01,083735,Patchell; Gregory David,2,0,30,28
1658050717653,MATH 10A,A02,083736,Patchell; Gregory David,20,0,30,10
1658050717653,MATH 10A,A03,083737,Patchell; Gregory David,16,0,30,14
1658050723681,MATH 10B,A01,083207,Lim; Seonhee,9,0,34,25
1658050723681,MATH 10B,A02,083208,Lim; Seonhee,10,0,35,25
1658050723681,MATH 10B,A03,093472,Lim; Seonhee,7,0,34,27
1658050723681,MATH 10B,B01,083739,Sinha; Shubham,14,0,30,16
1658050742061,MATH 18,A01,083743,Cinel; Cameron Alexander,9,0,30,21
1658050742061,MATH 18,A02,083744,Cinel; Cameron Alexander,18,0,30,12
1658050742061,MATH 18,A03,083745,Cinel; Cameron Alexander,10,0,30,20
1658050742061,MATH 18,B01,083748,Rideout; David Porter,5,0,37,32
1658050742061,MATH 18,B02,083749,Rideout; David Porter,5,0,36,31
1658050742061,MATH 18,B03,083750,Rideout; David Porter,3,0,37,34
1658050742061,MATH 18,B04,083751,Rideout; David Porter,7,0,36,29
1658050742061,MATH 18,B05,093473,Rideout; David Porter,7,0,36,29
1658050742061,MATH 18,B06,093474,Rideout; David Porter,6,0,36,30
1658050748105,MATH 20A,A01,083754,Zheng; Zequn,14,0,40,26
1658050754170,MATH 20B,A01,083756,Briones; Jor-el Thomas Caparas,4,0,36,32
1658050754170,MATH 20B,A02,083757,Briones; Jor-el Thomas Caparas,1,0,36,35
1658050754170,MATH 20B,A03,093475,Briones; Jor-el Thomas Caparas,3,0,36,33
1658050760195,MATH 20C,A01,083760,Briones; Jor-el Thomas Caparas,1,0,35,34
1658050760195,MATH 20C,A02,083761,Briones; Jor-el Thomas Caparas,8,0,35,27
1658050760195,MATH 20C,A03,093476,Briones; Jor-el Thomas Caparas,0,1,36,36
1658050760195,MATH 20C,B01,083762,Bach; Quang Tran,1,0,30,29
1658050766241,MATH 20D,A01,083765,Tran; Brian Kha,5,0,30,25
1658050766241,MATH 20D,A02,083766,Tran; Brian Kha,5,0,30,25
1658050766241,MATH 20D,A03,083767,Tran; Brian Kha,6,0,30,24
1658050772270,MATH 20E,A01,083771,Ganguly; Soumya,12,0,32,20
1658050772270,MATH 20E,A02,083772,Ganguly; Soumya,7,0,32,25
1658050772270,MATH 20E,B01,083773,Ciotti; Benjamin,20,0,35,15
1658050772270,MATH 20E,B02,083774,Ciotti; Benjamin,18,0,35,17
1658050778298,MATH 103A,A01,083777,Greenfeld; Be'Eri,6,0,36,30
1658050778298,MATH 103A,A02,083778,Greenfeld; Be'Eri,5,0,36,31
1658050778298,MATH 103A,A03,093561,Greenfeld; Be'Eri,7,0,36,29
1658050778298,MATH 103A,B01,083779,Greenfeld; Be'Eri,8,0,36,28
1658050778298,MATH 103A,B02,083780,Greenfeld; Be'Eri,4,0,36,32
1658050778298,MATH 103A,B03,093562,Greenfeld; Be'Eri,3,0,36,33
1658050784324,MATH 105,A01,085443,Carter; Anne Toulson,15,0,35,20
1658050784324,MATH 105,A02,093477,Carter; Anne Toulson,20,0,35,15
1658050790365,MATH 109,A01,083213,Ganzberger; Geoffrey Michael,3,0,34,31
1658050790365,MATH 109,A02,083214,Ganzberger; Geoffrey Michael,4,0,34,30
1658050790365,MATH 109,A03,093478,Ganzberger; Geoffrey Michael,2,0,34,32
1658050790365,MATH 109,B01,083215,Ganzberger; Geoffrey Michael,3,0,32,29
1658050790365,MATH 109,B02,083216,Ganzberger; Geoffrey Michael,3,0,32,29
1658050790365,MATH 109,B03,093479,Ganzberger; Geoffrey Michael,8,0,32,24
1658050796411,MATH 142A,A01,083219,Chow; Bennett,7,0,32,25
1658050796411,MATH 142A,A02,083220,Chow; Bennett,10,0,32,22
1658050796411,MATH 142A,A03,093480,Chow; Bennett,9,0,32,23
1658050796411,MATH 142A,B03,093481,Chow; Bennett,8,0,32,24
1658050796411,MATH 142A,B04,093558,Chow; Bennett,14,0,32,18
1658050796411,MATH 142A,B05,093559,Chow; Bennett,7,0,32,25
1658050802437,MATH 193A,A01,083224,Rotar; Vladimir,9,0,34,25
1658050802437,MATH 193A,A02,083225,Rotar; Vladimir,11,0,34,23
1658050802437,MATH 193A,A03,083781,Rotar; Vladimir,5,0,34,29
1658050802437,MATH 193A,A04,083782,Rotar; Vladimir,12,0,34,22
1658050802437,MATH 193A,A05,093482,Rotar; Vladimir,11,0,34,23
1658050808464,MATH 197,001,091859,McAuley; Julian John,9999,0,9999,0
1658050808464,MATH 197,002,095566,Kedlaya; Kiran S.,9997,0,9999,2
1658050808464,MATH 197,003,095567,Xiao; Ming,9999,0,9999,0
1658050808464,MATH 197,004,095571,Perols; Johan Lars,9998,0,9999,1
1658050815547,COGS 9,A01,083615,Shannon; Kyle Michael,11,0,75,64
1658050821573,COGS 11,A01,083617,Boyle; Mary E. T.,23,0,48,25
1658050827599,COGS 13,A01,083071,Bastos; Amalia Pinkusfeld,12,0,71,59
1658050833624,COGS 14A,A01,092681,Semenuks; Arturs,5,1,100,95
1658050839650,COGS 14B,A01,083073,Cheng; Tzu-Han,7,0,63,56
1658050845676,COGS 17,A01,092677,Semenuks; Arturs,7,0,81,74
1658050851707,COGS 100,A01,083619,Allen; Michael Gordon,17,0,70,53
1658050857730,COGS 101A,A01,083621,Davis; Joshua Daniel,9,0,68,59
1658050863759,COGS 101B,A01,091572,Allen; Michael Gordon,14,0,65,51
1658050869784,COGS 101C,A01,083625,Delgado; Tania,17,0,35,18
1658050875810,COGS 107A,A01,083627,Boyle; Mary E. T.,14,0,60,46
1658050881837,COGS 118A,A01,083075,Gupta; Anjum,21,0,76,55
1658050887871,CSE 3,A50,083646,Miranda; Gregory Joseph,24,0,50,26
1658050893902,CSE 8A,A50,083650,Miranda; Gregory Joseph,17,1,56,39
1658050899928,CSE 11,A01,083080,Cao; Yingjun,7,15,40,33
1658050905958,CSE 12,A01,083652,Krause-Levy; Sophia Louisa,30,1,120,90
1658050911991,CSE 15L,A01,083654,Morris; Justin Loren,9,0,50,41
1658050911991,CSE 15L,A02,083655,Morris; Justin Loren,11,0,50,39
1658050918018,CSE 20,A01,083657,Tran; Khoa Dang,39,0,80,41
1658050924044,CSE 21,A01,095574,Bach; Quang Tran,23,0,48,25
1658050930072,CSE 30,A01,083084,Eldon; John,8,0,80,72
1658050930072,CSE 30,B01,095061,Bhaskar; Nishant,9,0,50,41
1658050936104,CSE 100,A01,083659,Cao; Yingjun,5,4,70,65
1658050942130,CSE 134B,A01,083661,Powell; Thomas Allan,25,0,100,75
1658050948159,CSE 140,A01,083663,Gungor; Onat,17,0,85,68
1658050954186,CSE 140L,A01,083088,Eldon; John,23,0,100,77
1658050960216,CSE 175,A01,083665,Kumar; Rakesh,3,0,25,22
1658050966246,CSE 190,A00,092507,Dubnov; Shlomo,8,0,20,12
1658050972284,ECE 45,A01,083139,Congero; Spencer William,7,0,75,68
1658050978319,ECE 65,A50,083695,Saad; Andrew S,12,0,30,18
1658050978319,ECE 65,A51,095125,Saad; Andrew S,24,0,26,2
1658050984349,ECE 109,A01,091882,Touri; Behrouz,21,0,70,49
1658050990375,ECE 180,A00,083140,Abi Samra; Nicholas Camill,1,0,30,29
1658050990375,ECE 180,B00,083141,Abi Samra; Nicholas Camill,0,0,30,30
1658050996408,MATH 10A,A01,083735,Patchell; Gregory David,2,0,30,28
1658050996408,MATH 10A,A02,083736,Patchell; Gregory David,20,0,30,10
1658050996408,MATH 10A,A03,083737,Patchell; Gregory David,16,0,30,14
1658051002445,MATH 10B,A01,083207,Lim; Seonhee,9,0,34,25
1658051002445,MATH 10B,A02,083208,Lim; Seonhee,10,0,35,25
1658051002445,MATH 10B,A03,093472,Lim; Seonhee,7,0,34,27
1658051002445,MATH 10B,B01,083739,Sinha; Shubham,14,0,30,16
1658051008472,MATH 18,A01,083743,Cinel; Cameron Alexander,9,0,30,21
1658051008472,MATH 18,A02,083744,Cinel; Cameron Alexander,18,0,30,12
1658051008472,MATH 18,A03,083745,Cinel; Cameron Alexander,10,0,30,20
1658051008472,MATH 18,B01,083748,Rideout; David Porter,5,0,37,32
1658051008472,MATH 18,B02,083749,Rideout; David Porter,5,0,36,31
1658051008472,MATH 18,B03,083750,Rideout; David Porter,3,0,37,34
1658051008472,MATH 18,B04,083751,Rideout; David Porter,7,0,36,29
1658051008472,MATH 18,B05,093473,Rideout; David Porter,7,0,36,29
1658051008472,MATH 18,B06,093474,Rideout; David Porter,6,0,36,30
1658051014506,MATH 20A,A01,083754,Zheng; Zequn,14,0,40,26
1658051020534,MATH 20B,A01,083756,Briones; Jor-el Thomas Caparas,4,0,36,32
1658051020534,MATH 20B,A02,083757,Briones; Jor-el Thomas Caparas,1,0,36,35
1658051020534,MATH 20B,A03,093475,Briones; Jor-el Thomas Caparas,3,0,36,33
1658051026560,MATH 20C,A01,083760,Briones; Jor-el Thomas Caparas,1,0,35,34
1658051026560,MATH 20C,A02,083761,Briones; Jor-el Thomas Caparas,8,0,35,27
1658051026560,MATH 20C,A03,093476,Briones; Jor-el Thomas Caparas,0,1,36,36
1658051026560,MATH 20C,B01,083762,Bach; Quang Tran,1,0,30,29
1658051032587,MATH 20D,A01,083765,Tran; Brian Kha,5,0,30,25
1658051032587,MATH 20D,A02,083766,Tran; Brian Kha,5,0,30,25
1658051032587,MATH 20D,A03,083767,Tran; Brian Kha,6,0,30,24
1658051038612,MATH 20E,A01,083771,Ganguly; Soumya,12,0,32,20
1658051038612,MATH 20E,A02,083772,Ganguly; Soumya,7,0,32,25
1658051038612,MATH 20E,B01,083773,Ciotti; Benjamin,20,0,35,15
1658051038612,MATH 20E,B02,083774,Ciotti; Benjamin,18,0,35,17
1658051044645,MATH 103A,A01,083777,Greenfeld; Be'Eri,6,0,36,30
1658051044645,MATH 103A,A02,083778,Greenfeld; Be'Eri,5,0,36,31
1658051044645,MATH 103A,A03,093561,Greenfeld; Be'Eri,7,0,36,29
1658051044645,MATH 103A,B01,083779,Greenfeld; Be'Eri,8,0,36,28
1658051044645,MATH 103A,B02,083780,Greenfeld; Be'Eri,4,0,36,32
1658051044645,MATH 103A,B03,093562,Greenfeld; Be'Eri,3,0,36,33
1658051050670,MATH 105,A01,085443,Carter; Anne Toulson,15,0,35,20
1658051050670,MATH 105,A02,093477,Carter; Anne Toulson,20,0,35,15
1658051056696,MATH 109,A01,083213,Ganzberger; Geoffrey Michael,3,0,34,31
1658051056696,MATH 109,A02,083214,Ganzberger; Geoffrey Michael,4,0,34,30
1658051056696,MATH 109,A03,093478,Ganzberger; Geoffrey Michael,2,0,34,32
1658051056696,MATH 109,B01,083215,Ganzberger; Geoffrey Michael,3,0,32,29
1658051056696,MATH 109,B02,083216,Ganzberger; Geoffrey Michael,3,0,32,29
1658051056696,MATH 109,B03,093479,Ganzberger; Geoffrey Michael,8,0,32,24
1658051062722,MATH 142A,A01,083219,Chow; Bennett,7,0,32,25
1658051062722,MATH 142A,A02,083220,Chow; Bennett,10,0,32,22
1658051062722,MATH 142A,A03,093480,Chow; Bennett,9,0,32,23
1658051062722,MATH 142A,B03,093481,Chow; Bennett,8,0,32,24
1658051062722,MATH 142A,B04,093558,Chow; Bennett,14,0,32,18
1658051062722,MATH 142A,B05,093559,Chow; Bennett,7,0,32,25
1658051068750,MATH 193A,A01,083224,Rotar; Vladimir,9,0,34,25
1658051068750,MATH 193A,A02,083225,Rotar; Vladimir,11,0,34,23
1658051068750,MATH 193A,A03,083781,Rotar; Vladimir,5,0,34,29
1658051068750,MATH 193A,A04,083782,Rotar; Vladimir,12,0,34,22
1658051068750,MATH 193A,A05,093482,Rotar; Vladimir,11,0,34,23
1658051074772,MATH 197,001,091859,McAuley; Julian John,9999,0,9999,0
1658051074772,MATH 197,002,095566,Kedlaya; Kiran S.,9997,0,9999,2
1658051074772,MATH 197,003,095567,Xiao; Ming,9999,0,9999,0
1658051074772,MATH 197,004,095571,Perols; Johan Lars,9998,0,9999,1
1658051081830,COGS 9,A01,083615,Shannon; Kyle Michael,11,0,75,64
1658051087856,COGS 11,A01,083617,Boyle; Mary E. T.,23,0,48,25
1658051093885,COGS 13,A01,083071,Bastos; Amalia Pinkusfeld,12,0,71,59
1658051099915,COGS 14A,A01,092681,Semenuks; Arturs,5,1,100,95
1658051105949,COGS 14B,A01,083073,Cheng; Tzu-Han,7,0,63,56
1658051111973,COGS 17,A01,092677,Semenuks; Arturs,7,0,81,74
1658051118068,COGS 100,A01,083619,Allen; Michael Gordon,17,0,70,53
1658051124094,COGS 101A,A01,083621,Davis; Joshua Daniel,9,0,68,59
1658051130120,COGS 101B,A01,091572,Allen; Michael Gordon,14,0,65,51
1658051136149,COGS 101C,A01,083625,Delgado; Tania,17,0,35,18
1658051142177,COGS 107A,A01,083627,Boyle; Mary E. T.,14,0,60,46
1658051148201,COGS 118A,A01,083075,Gupta; Anjum,21,0,76,55
1658051154229,CSE 3,A50,083646,Miranda; Gregory Joseph,24,0,50,26
1658051160266,CSE 8A,A50,083650,Miranda; Gregory Joseph,17,1,56,39
1658051166295,CSE 11,A01,083080,Cao; Yingjun,7,15,40,33
1658051172320,CSE 12,A01,083652,Krause-Levy; Sophia Louisa,30,1,120,90
1658051178352,CSE 15L,A01,083654,Morris; Justin Loren,9,0,50,41
1658051178352,CSE 15L,A02,083655,Morris; Justin Loren,11,0,50,39
1658051184376,CSE 20,A01,083657,Tran; Khoa Dang,39,0,80,41
1658051190400,CSE 21,A01,095574,Bach; Quang Tran,23,0,48,25
1658051196423,CSE 30,A01,083084,Eldon; John,8,0,80,72
1658051196423,CSE 30,B01,095061,Bhaskar; Nishant,9,0,50,41
1658051202453,CSE 100,A01,083659,Cao; Yingjun,5,4,70,65
1658051208483,CSE 134B,A01,083661,Powell; Thomas Allan,25,0,100,75
1658051214507,CSE 140,A01,083663,Gungor; Onat,17,0,85,68
1658051220531,CSE 140L,A01,083088,Eldon; John,23,0,100,77
1658051226571,CSE 175,A01,083665,Kumar; Rakesh,3,0,25,22
1658051232595,CSE 190,A00,092507,Dubnov; Shlomo,8,0,20,12
1658051238621,ECE 45,A01,083139,Congero; Spencer William,7,0,75,68
1658051244653,ECE 65,A50,083695,Saad; Andrew S,12,0,30,18
1658051244653,ECE 65,A51,095125,Saad; Andrew S,24,0,26,2
1658051250679,ECE 109,A01,091882,Touri; Behrouz,21,0,70,49
1658051256709,ECE 180,A00,083140,Abi Samra; Nicholas Camill,1,0,30,29
1658051256709,ECE 180,B00,083141,Abi Samra; Nicholas Camill,0,0,30,30
1658051262735,MATH 10A,A01,083735,Patchell; Gregory David,2,0,30,28
1658051262735,MATH 10A,A02,083736,Patchell; Gregory David,20,0,30,10
1658051262735,MATH 10A,A03,083737,Patchell; Gregory David,16,0,30,14
1658051268764,MATH 10B,A01,083207,Lim; Seonhee,9,0,34,25
1658051268764,MATH 10B,A02,083208,Lim; Seonhee,10,0,35,25
1658051268764,MATH 10B,A03,093472,Lim; Seonhee,7,0,34,27
1658051268764,MATH 10B,B01,083739,Sinha; Shubham,14,0,30,16
1658051274799,MATH 18,A01,083743,Cinel; Cameron Alexander,9,0,30,21
1658051274799,MATH 18,A02,083744,Cinel; Cameron Alexander,18,0,30,12
1658051274799,MATH 18,A03,083745,Cinel; Cameron Alexander,10,0,30,20
1658051274799,MATH 18,B01,083748,Rideout; David Porter,5,0,37,32
1658051274799,MATH 18,B02,083749,Rideout; David Porter,5,0,36,31
1658051274799,MATH 18,B03,083750,Rideout; David Porter,3,0,37,34
1658051274799,MATH 18,B04,083751,Rideout; David Porter,7,0,36,29
1658051274799,MATH 18,B05,093473,Rideout; David Porter,7,0,36,29
1658051274799,MATH 18,B06,093474,Rideout; David Porter,6,0,36,30
1658051280825,MATH 20A,A01,083754,Zheng; Zequn,14,0,40,26
1658051286851,MATH 20B,A01,083756,Briones; Jor-el Thomas Caparas,4,0,36,32
1658051286851,MATH 20B,A02,083757,Briones; Jor-el Thomas Caparas,1,0,36,35
1658051286851,MATH 20B,A03,093475,Briones; Jor-el Thomas Caparas,3,0,36,33
1658051292885,MATH 20C,A01,083760,Briones; Jor-el Thomas Caparas,1,0,35,34
1658051292885,MATH 20C,A02,083761,Briones; Jor-el Thomas Caparas,8,0,35,27
1658051292885,MATH 20C,A03,093476,Briones; Jor-el Thomas Caparas,0,1,36,36
1658051292885,MATH 20C,B01,083762,Bach; Quang Tran,1,0,30,29
1658051298911,MATH 20D,A01,083765,Tran; Brian Kha,5,0,30,25
1658051298911,MATH 20D,A02,083766,Tran; Brian Kha,5,0,30,25
1658051298911,MATH 20D,A03,083767,Tran; Brian Kha,6,0,30,24
1658051304937,MATH 20E,A01,083771,Ganguly; Soumya,12,0,32,20
1658051304937,MATH 20E,A02,083772,Ganguly; Soumya,7,0,32,25
1658051304937,MATH 20E,B01,083773,Ciotti; Benjamin,20,0,35,15
1658051304937,MATH 20E,B02,083774,Ciotti; Benjamin,18,0,35,17
1658051310966,MATH 103A,A01,083777,Greenfeld; Be'Eri,6,0,36,30
1658051310966,MATH 103A,A02,083778,Greenfeld; Be'Eri,5,0,36,31
1658051310966,MATH 103A,A03,093561,Greenfeld; Be'Eri,7,0,36,29
1658051310966,MATH 103A,B01,083779,Greenfeld; Be'Eri,8,0,36,28
1658051310966,MATH 103A,B02,083780,Greenfeld; Be'Eri,4,0,36,32
1658051310966,MATH 103A,B03,093562,Greenfeld; Be'Eri,3,0,36,33
1658051316991,MATH 105,A01,085443,Carter; Anne Toulson,15,0,35,20
1658051316991,MATH 105,A02,093477,Carter; Anne Toulson,20,0,35,15
1658051323025,MATH 109,A01,083213,Ganzberger; Geoffrey Michael,3,0,34,31
1658051323025,MATH 109,A02,083214,Ganzberger; Geoffrey Michael,4,0,34,30
1658051323025,MATH 109,A03,093478,Ganzberger; Geoffrey Michael,2,0,34,32
1658051323025,MATH 109,B01,083215,Ganzberger; Geoffrey Michael,3,0,32,29
1658051323025,MATH 109,B02,083216,Ganzberger; Geoffrey Michael,3,0,32,29
1658051323025,MATH 109,B03,093479,Ganzberger; Geoffrey Michael,8,0,32,24
1658051329056,MATH 142A,A01,083219,Chow; Bennett,7,0,32,25
1658051329056,MATH 142A,A02,083220,Chow; Bennett,10,0,32,22
1658051329056,MATH 142A,A03,093480,Chow; Bennett,9,0,32,23
1658051329056,MATH 142A,B03,093481,Chow; Bennett,8,0,32,24
1658051329056,MATH 142A,B04,093558,Chow; Bennett,14,0,32,18
1658051329056,MATH 142A,B05,093559,Chow; Bennett,7,0,32,25
1658051335095,MATH 193A,A01,083224,Rotar; Vladimir,9,0,34,25
1658051335095,MATH 193A,A02,083225,Rotar; Vladimir,11,0,34,23
1658051335095,MATH 193A,A03,083781,Rotar; Vladimir,5,0,34,29
1658051335095,MATH 193A,A04,083782,Rotar; Vladimir,12,0,34,22
1658051335095,MATH 193A,A05,093482,Rotar; Vladimir,11,0,34,23
1658051341120,MATH 197,001,091859,McAuley; Julian John,9999,0,9999,0
1658051341120,MATH 197,002,095566,Kedlaya; Kiran S.,9997,0,9999,2
1658051341120,MATH 197,003,095567,Xiao; Ming,9999,0,9999,0
1658051341120,MATH 197,004,095571,Perols; Johan Lars,9998,0,9999,1
1658051348198,COGS 9,A01,083615,Shannon; Kyle Michael,11,0,75,64
1658051354227,COGS 11,A01,083617,Boyle; Mary E. T.,23,0,48,25
1658051360260,COGS 13,A01,083071,Bastos; Amalia Pinkusfeld,12,0,71,59
1658051366293,COGS 14A,A01,092681,Semenuks; Arturs,5,1,100,95
1658051372317,COGS 14B,A01,083073,Cheng; Tzu-Han,7,0,63,56
1658051378342,COGS 17,A01,092677,Semenuks; Arturs,7,0,81,74
1658051384367,COGS 100,A01,083619,Allen; Michael Gordon,17,0,70,53
1658051390393,COGS 101A,A01,083621,Davis; Joshua Daniel,9,0,68,59
1658051396426,COGS 101B,A01,091572,Allen; Michael Gordon,14,0,65,51
1658051402780,COGS 101C,A01,083625,Delgado; Tania,17,0,35,18
1658051408817,COGS 107A,A01,083627,Boyle; Mary E. T.,14,0,60,46
1658051414848,COGS 118A,A01,083075,Gupta; Anjum,21,0,76,55
1658051420873,CSE 3,A50,083646,Miranda; Gregory Joseph,24,0,50,26
1658051426898,CSE 8A,A50,083650,Miranda; Gregory Joseph,17,1,56,39
1658051432972,CSE 11,A01,083080,Cao; Yingjun,7,15,40,33
1658051439003,CSE 12,A01,083652,Krause-Levy; Sophia Louisa,30,1,120,90
1658051445032,CSE 15L,A01,083654,Morris; Justin Loren,9,0,50,41
1658051445032,CSE 15L,A02,083655,Morris; Justin Loren,11,0,50,39
1658051451058,CSE 20,A01,083657,Tran; Khoa Dang,39,0,80,41
1658051457090,CSE 21,A01,095574,Bach; Quang Tran,23,0,48,25
1658051463121,CSE 30,A01,083084,Eldon; John,8,0,80,72
1658051463121,CSE 30,B01,095061,Bhaskar; Nishant,9,0,50,41
1658051469152,CSE 100,A01,083659,Cao; Yingjun,5,4,70,65
1658051475181,CSE 134B,A01,083661,Powell; Thomas Allan,25,0,100,75
1658051481210,CSE 140,A01,083663,Gungor; Onat,17,0,85,68
1658051487234,CSE 140L,A01,083088,Eldon; John,23,0,100,77
1658051493267,CSE 175,A01,083665,Kumar; Rakesh,3,0,25,22
1658051499292,CSE 190,A00,092507,Dubnov; Shlomo,8,0,20,12
1658051505318,ECE 45,A01,083139,Congero; Spencer William,7,0,75,68
1658051511346,ECE 65,A50,083695,Saad; Andrew S,12,0,30,18
1658051511346,ECE 65,A51,095125,Saad; Andrew S,24,0,26,2
1658051517426,ECE 109,A01,091882,Touri; Behrouz,21,0,70,49
1658051523450,ECE 180,A00,083140,Abi Samra; Nicholas Camill,1,0,30,29
1658051523450,ECE 180,B00,083141,Abi Samra; Nicholas Camill,0,0,30,30
1658051529478,MATH 10A,A01,083735,Patchell; Gregory David,2,0,30,28
1658051529478,MATH 10A,A02,083736,Patchell; Gregory David,20,0,30,10
1658051529478,MATH 10A,A03,083737,Patchell; Gregory David,16,0,30,14
1658051535507,MATH 10B,A01,083207,Lim; Seonhee,9,0,34,25
1658051535507,MATH 10B,A02,083208,Lim; Seonhee,10,0,35,25
1658051535507,MATH 10B,A03,093472,Lim; Seonhee,7,0,34,27
1658051535507,MATH 10B,B01,083739,Sinha; Shubham,14,0,30,16
1658051541537,MATH 18,A01,083743,Cinel; Cameron Alexander,9,0,30,21
1658051541537,MATH 18,A02,083744,Cinel; Cameron Alexander,18,0,30,12
1658051541537,MATH 18,A03,083745,Cinel; Cameron Alexander,10,0,30,20
1658051541537,MATH 18,B01,083748,Rideout; David Porter,5,0,37,32
1658051541537,MATH 18,B02,083749,Rideout; David Porter,5,0,36,31
1658051541537,MATH 18,B03,083750,Rideout; David Porter,3,0,37,34
1658051541537,MATH 18,B04,083751,Rideout; David Porter,7,0,36,29
1658051541537,MATH 18,B05,093473,Rideout; David Porter,7,0,36,29
1658051541537,MATH 18,B06,093474,Rideout; David Porter,6,0,36,30
1658051547562,MATH 20A,A01,083754,Zheng; Zequn,14,0,40,26
1658051553589,MATH 20B,A01,083756,Briones; Jor-el Thomas Caparas,4,0,36,32
1658051553589,MATH 20B,A02,083757,Briones; Jor-el Thomas Caparas,1,0,36,35
1658051553589,MATH 20B,A03,093475,Briones; Jor-el Thomas Caparas,3,0,36,33
1658051559612,MATH 20C,A01,083760,Briones; Jor-el Thomas Caparas,1,0,35,34
1658051559612,MATH 20C,A02,083761,Briones; Jor-el Thomas Caparas,8,0,35,27
1658051559612,MATH 20C,A03,093476,Briones; Jor-el Thomas Caparas,0,1,36,36
1658051559612,MATH 20C,B01,083762,Bach; Quang Tran,1,0,30,29
1658051565639,MATH 20D,A01,083765,Tran; Brian Kha,5,0,30,25
1658051565639,MATH 20D,A02,083766,Tran; Brian Kha,5,0,30,25
1658051565639,MATH 20D,A03,083767,Tran; Brian Kha,6,0,30,24
1658051571675,MATH 20E,A01,083771,Ganguly; Soumya,12,0,32,20
1658051571675,MATH 20E,A02,083772,Ganguly; Soumya,7,0,32,25
1658051571675,MATH 20E,B01,083773,Ciotti; Benjamin,20,0,35,15
1658051571675,MATH 20E,B02,083774,Ciotti; Benjamin,18,0,35,17
1658051577713,MATH 103A,A01,083777,Greenfeld; Be'Eri,6,0,36,30
1658051577713,MATH 103A,A02,083778,Greenfeld; Be'Eri,5,0,36,31
1658051577713,MATH 103A,A03,093561,Greenfeld; Be'Eri,7,0,36,29
1658051577713,MATH 103A,B01,083779,Greenfeld; Be'Eri,8,0,36,28
1658051577713,MATH 103A,B02,083780,Greenfeld; Be'Eri,4,0,36,32
1658051577713,MATH 103A,B03,093562,Greenfeld; Be'Eri,3,0,36,33
1658051583738,MATH 105,A01,085443,Carter; Anne Toulson,15,0,35,20
1658051583738,MATH 105,A02,093477,Carter; Anne Toulson,20,0,35,15
1658051589766,MATH 109,A01,083213,Ganzberger; Geoffrey Michael,3,0,34,31
1658051589766,MATH 109,A02,083214,Ganzberger; Geoffrey Michael,4,0,34,30
1658051589766,MATH 109,A03,093478,Ganzberger; Geoffrey Michael,2,0,34,32
1658051589766,MATH 109,B01,083215,Ganzberger; Geoffrey Michael,3,0,32,29
1658051589766,MATH 109,B02,083216,Ganzberger; Geoffrey Michael,3,0,32,29
1658051589766,MATH 109,B03,093479,Ganzberger; Geoffrey Michael,8,0,32,24
1658051595794,MATH 142A,A01,083219,Chow; Bennett,7,0,32,25
1658051595794,MATH 142A,A02,083220,Chow; Bennett,10,0,32,22
1658051595794,MATH 142A,A03,093480,Chow; Bennett,9,0,32,23
1658051595794,MATH 142A,B03,093481,Chow; Bennett,8,0,32,24
1658051595794,MATH 142A,B04,093558,Chow; Bennett,14,0,32,18
1658051595794,MATH 142A,B05,093559,Chow; Bennett,7,0,32,25
1658051601911,MATH 193A,A01,083224,Rotar; Vladimir,9,0,34,25
1658051601911,MATH 193A,A02,083225,Rotar; Vladimir,11,0,34,23
1658051601911,MATH 193A,A03,083781,Rotar; Vladimir,5,0,34,29
1658051601911,MATH 193A,A04,083782,Rotar; Vladimir,12,0,34,22
1658051601911,MATH 193A,A05,093482,Rotar; Vladimir,11,0,34,23
1658051607941,MATH 197,001,091859,McAuley; Julian John,9999,0,9999,0
1658051607941,MATH 197,002,095566,Kedlaya; Kiran S.,9997,0,9999,2
1658051607941,MATH 197,003,095567,Xiao; Ming,9999,0,9999,0
1658051607941,MATH 197,004,095571,Perols; Johan Lars,9998,0,9999,1
1658051615022,COGS 9,A01,083615,Shannon; Kyle Michael,11,0,75,64
1658051621051,COGS 11,A01,083617,Boyle; Mary E. T.,23,0,48,25
1658051627081,COGS 13,A01,083071,Bastos; Amalia Pinkusfeld,12,0,71,59
1658051633111,COGS 14A,A01,092681,Semenuks; Arturs,5,1,100,95
1658051639140,COGS 14B,A01,083073,Cheng; Tzu-Han,7,0,63,56
1658051645169,COGS 17,A01,092677,Semenuks; Arturs,7,0,81,74
1658051651196,COGS 100,A01,083619,Allen; Michael Gordon,17,0,70,53
1658051657220,COGS 101A,A01,083621,Davis; Joshua Daniel,9,0,68,59
1658051663243,COGS 101B,A01,091572,Allen; Michael Gordon,14,0,65,51
1658051669267,COGS 101C,A01,083625,Delgado; Tania,17,0,35,18
1658051675295,COGS 107A,A01,083627,Boyle; Mary E. T.,14,0,60,46
1658051681326,COGS 118A,A01,083075,Gupta; Anjum,21,0,76,55
1658051687352,CSE 3,A50,083646,Miranda; Gregory Joseph,24,0,50,26
1658051693382,CSE 8A,A50,083650,Miranda; Gregory Joseph,17,1,56,39
1658051699411,CSE 11,A01,083080,Cao; Yingjun,7,15,40,33
1658051705460,CSE 12,A01,083652,Krause-Levy; Sophia Louisa,30,1,120,90
1658051711489,CSE 15L,A01,083654,Morris; Justin Loren,9,0,50,41
1658051711489,CSE 15L,A02,083655,Morris; Justin Loren,11,0,50,39
1658051717603,CSE 20,A01,083657,Tran; Khoa Dang,39,0,80,41
1658051723629,CSE 21,A01,095574,Bach; Quang Tran,23,0,48,25
1658051729661,CSE 30,A01,083084,Eldon; John,8,0,80,72
1658051729661,CSE 30,B01,095061,Bhaskar; Nishant,9,0,50,41
1658051735691,CSE 100,A01,083659,Cao; Yingjun,5,4,70,65
1658051741720,CSE 134B,A01,083661,Powell; Thomas Allan,25,0,100,75
1658051747746,CSE 140,A01,083663,Gungor; Onat,17,0,85,68
1658051753775,CSE 140L,A01,083088,Eldon; John,23,0,100,77
1658051759806,CSE 175,A01,083665,Kumar; Rakesh,3,0,25,22
1658051765836,CSE 190,A00,092507,Dubnov; Shlomo,8,0,20,12
1658051771870,ECE 45,A01,083139,Congero; Spencer William,7,0,75,68
1658051777911,ECE 65,A50,083695,Saad; Andrew S,12,0,30,18
1658051777911,ECE 65,A51,095125,Saad; Andrew S,24,0,26,2
1658051783947,ECE 109,A01,091882,Touri; Behrouz,21,0,70,49
1658051789979,ECE 180,A00,083140,Abi Samra; Nicholas Camill,1,0,30,29
1658051789979,ECE 180,B00,083141,Abi Samra; Nicholas Camill,0,0,30,30
1658051796015,MATH 10A,A01,083735,Patchell; Gregory David,2,0,30,28
1658051796015,MATH 10A,A02,083736,Patchell; Gregory David,20,0,30,10
1658051796015,MATH 10A,A03,083737,Patchell; Gregory David,16,0,30,14
1658051802063,MATH 10B,A01,083207,Lim; Seonhee,9,0,34,25
1658051802063,MATH 10B,A02,083208,Lim; Seonhee,10,0,35,25
1658051802063,MATH 10B,A03,093472,Lim; Seonhee,7,0,34,27
1658051802063,MATH 10B,B01,083739,Sinha; Shubham,14,0,30,16
1658051808093,MATH 18,A01,083743,Cinel; Cameron Alexander,9,0,30,21
1658051808093,MATH 18,A02,083744,Cinel; Cameron Alexander,18,0,30,12
1658051808093,MATH 18,A03,083745,Cinel; Cameron Alexander,10,0,30,20
1658051808093,MATH 18,B01,083748,Rideout; David Porter,5,0,37,32
1658051808093,MATH 18,B02,083749,Rideout; David Porter,5,0,36,31
1658051808093,MATH 18,B03,083750,Rideout; David Porter,3,0,37,34
1658051808093,MATH 18,B04,083751,Rideout; David Porter,7,0,36,29
1658051808093,MATH 18,B05,093473,Rideout; David Porter,7,0,36,29
1658051808093,MATH 18,B06,093474,Rideout; David Porter,6,0,36,30
1658051814124,MATH 20A,A01,083754,Zheng; Zequn,14,0,40,26
1658051820153,MATH 20B,A01,083756,Briones; Jor-el Thomas Caparas,4,0,36,32
1658051820153,MATH 20B,A02,083757,Briones; Jor-el Thomas Caparas,1,0,36,35
1658051820153,MATH 20B,A03,093475,Briones; Jor-el Thomas Caparas,3,0,36,33
1658051826190,MATH 20C,A01,083760,Briones; Jor-el Thomas Caparas,1,0,35,34
1658051826190,MATH 20C,A02,083761,Briones; Jor-el Thomas Caparas,8,0,35,27
1658051826190,MATH 20C,A03,093476,Briones; Jor-el Thomas Caparas,0,1,36,36
1658051826190,MATH 20C,B01,083762,Bach; Quang Tran,1,0,30,29
1658051832217,MATH 20D,A01,083765,Tran; Brian Kha,5,0,30,25
1658051832217,MATH 20D,A02,083766,Tran; Brian Kha,5,0,30,25
1658051832217,MATH 20D,A03,083767,Tran; Brian Kha,6,0,30,24
1658051838248,MATH 20E,A01,083771,Ganguly; Soumya,12,0,32,20
1658051838248,MATH 20E,A02,083772,Ganguly; Soumya,7,0,32,25
1658051838248,MATH 20E,B01,083773,Ciotti; Benjamin,20,0,35,15
1658051838248,MATH 20E,B02,083774,Ciotti; Benjamin,18,0,35,17
1658051844278,MATH 103A,A01,083777,Greenfeld; Be'Eri,6,0,36,30
1658051844278,MATH 103A,A02,083778,Greenfeld; Be'Eri,5,0,36,31
1658051844278,MATH 103A,A03,093561,Greenfeld; Be'Eri,7,0,36,29
1658051844278,MATH 103A,B01,083779,Greenfeld; Be'Eri,8,0,36,28
1658051844278,MATH 103A,B02,083780,Greenfeld; Be'Eri,4,0,36,32
1658051844278,MATH 103A,B03,093562,Greenfeld; Be'Eri,3,0,36,33
1658051850304,MATH 105,A01,085443,Carter; Anne Toulson,15,0,35,20
1658051850304,MATH 105,A02,093477,Carter; Anne Toulson,20,0,35,15
1658051856333,MATH 109,A01,083213,Ganzberger; Geoffrey Michael,3,0,34,31
1658051856333,MATH 109,A02,083214,Ganzberger; Geoffrey Michael,4,0,34,30
1658051856333,MATH 109,A03,093478,Ganzberger; Geoffrey Michael,2,0,34,32
1658051856333,MATH 109,B01,083215,Ganzberger; Geoffrey Michael,3,0,32,29
1658051856333,MATH 109,B02,083216,Ganzberger; Geoffrey Michael,3,0,32,29
1658051856333,MATH 109,B03,093479,Ganzberger; Geoffrey Michael,8,0,32,24
1658051862384,MATH 142A,A01,083219,Chow; Bennett,7,0,32,25
1658051862384,MATH 142A,A02,083220,Chow; Bennett,10,0,32,22
1658051862384,MATH 142A,A03,093480,Chow; Bennett,9,0,32,23
1658051862384,MATH 142A,B03,093481,Chow; Bennett,8,0,32,24
1658051862384,MATH 142A,B04,093558,Chow; Bennett,14,0,32,18
1658051862384,MATH 142A,B05,093559,Chow; Bennett,7,0,32,25
1658051868411,MATH 193A,A01,083224,Rotar; Vladimir,9,0,34,25
1658051868411,MATH 193A,A02,083225,Rotar; Vladimir,11,0,34,23
1658051868411,MATH 193A,A03,083781,Rotar; Vladimir,5,0,34,29
1658051868411,MATH 193A,A04,083782,Rotar; Vladimir,12,0,34,22
1658051868411,MATH 193A,A05,093482,Rotar; Vladimir,11,0,34,23
1658051874443,MATH 197,001,091859,McAuley; Julian John,9999,0,9999,0
1658051874443,MATH 197,002,095566,Kedlaya; Kiran S.,9997,0,9999,2
1658051874443,MATH 197,003,095567,Xiao; Ming,9999,0,9999,0
1658051874443,MATH 197,004,095571,Perols; Johan Lars,9998,0,9999,1
1658051881619,COGS 9,A01,083615,Shannon; Kyle Michael,11,0,75,64
1658051887648,COGS 11,A01,083617,Boyle; Mary E. T.,23,0,48,25
1658051893674,COGS 13,A01,083071,Bastos; Amalia Pinkusfeld,12,0,71,59
1658051899699,COGS 14A,A01,092681,Semenuks; Arturs,5,1,100,95
1658051905730,COGS 14B,A01,083073,Cheng; Tzu-Han,7,0,63,56
1658051911755,COGS 17,A01,092677,Semenuks; Arturs,7,0,81,74
1658051917779,COGS 100,A01,083619,Allen; Michael Gordon,17,0,70,53
1658051923803,COGS 101A,A01,083621,Davis; Joshua Daniel,9,0,68,59
1658051929835,COGS 101B,A01,091572,Allen; Michael Gordon,14,0,65,51
1658051935868,COGS 101C,A01,083625,Delgado; Tania,17,0,35,18
1658051941894,COGS 107A,A01,083627,Boyle; Mary E. T.,14,0,60,46
1658051947924,COGS 118A,A01,083075,Gupta; Anjum,21,0,76,55
1658051953963,CSE 3,A50,083646,Miranda; Gregory Joseph,24,0,50,26
1658051959988,CSE 8A,A50,083650,Miranda; Gregory Joseph,17,1,56,39
1658051966012,CSE 11,A01,083080,Cao; Yingjun,7,15,40,33
1658051972038,CSE 12,A01,083652,Krause-Levy; Sophia Louisa,30,1,120,90
1658051978062,CSE 15L,A01,083654,Morris; Justin Loren,9,0,50,41
1658051978062,CSE 15L,A02,083655,Morris; Justin Loren,11,0,50,39
1658051984087,CSE 20,A01,083657,Tran; Khoa Dang,39,0,80,41
1658051990113,CSE 21,A01,095574,Bach; Quang Tran,23,0,48,25
1658051996138,CSE 30,A01,083084,Eldon; John,8,0,80,72
1658051996138,CSE 30,B01,095061,Bhaskar; Nishant,9,0,50,41
1658052002161,CSE 100,A01,083659,Cao; Yingjun,5,4,70,65
1658052008191,CSE 134B,A01,083661,Powell; Thomas Allan,25,0,100,75
1658052014216,CSE 140,A01,083663,Gungor; Onat,17,0,85,68
1658052020240,CSE 140L,A01,083088,Eldon; John,23,0,100,77
1658052026266,CSE 175,A01,083665,Kumar; Rakesh,3,0,25,22
1658052032291,CSE 190,A00,092507,Dubnov; Shlomo,8,0,20,12
1658052038323,ECE 45,A01,083139,Congero; Spencer William,7,0,75,68
1658052044351,ECE 65,A50,083695,Saad; Andrew S,12,0,30,18
1658052044351,ECE 65,A51,095125,Saad; Andrew S,24,0,26,2
1658052050379,ECE 109,A01,091882,Touri; Behrouz,21,0,70,49
1658052056405,ECE 180,A00,083140,Abi Samra; Nicholas Camill,1,0,30,29
1658052056405,ECE 180,B00,083141,Abi Samra; Nicholas Camill,0,0,30,30
1658052062430,MATH 10A,A01,083735,Patchell; Gregory David,2,0,30,28
1658052062430,MATH 10A,A02,083736,Patchell; Gregory David,20,0,30,10
1658052062430,MATH 10A,A03,083737,Patchell; Gregory David,16,0,30,14
1658052068475,MATH 10B,A01,083207,Lim; Seonhee,9,0,34,25
1658052068475,MATH 10B,A02,083208,Lim; Seonhee,10,0,35,25
1658052068475,MATH 10B,A03,093472,Lim; Seonhee,7,0,34,27
1658052068475,MATH 10B,B01,083739,Sinha; Shubham,14,0,30,16
1658052074502,MATH 18,A01,083743,Cinel; Cameron Alexander,9,0,30,21
1658052074502,MATH 18,A02,083744,Cinel; Cameron Alexander,18,0,30,12
1658052074502,MATH 18,A03,083745,Cinel; Cameron Alexander,10,0,30,20
1658052074502,MATH 18,B01,083748,Rideout; David Porter,5,0,37,32
1658052074502,MATH 18,B02,083749,Rideout; David Porter,5,0,36,31
1658052074502,MATH 18,B03,083750,Rideout; David Porter,3,0,37,34
1658052074502,MATH 18,B04,083751,Rideout; David Porter,7,0,36,29
1658052074502,MATH 18,B05,093473,Rideout; David Porter,7,0,36,29
1658052074502,MATH 18,B06,093474,Rideout; David Porter,6,0,36,30
1658052080529,MATH 20A,A01,083754,Zheng; Zequn,14,0,40,26
1658052086563,MATH 20B,A01,083756,Briones; Jor-el Thomas Caparas,4,0,36,32
1658052086563,MATH 20B,A02,083757,Briones; Jor-el Thomas Caparas,1,0,36,35
1658052086563,MATH 20B,A03,093475,Briones; Jor-el Thomas Caparas,3,0,36,33
1658052092593,MATH 20C,A01,083760,Briones; Jor-el Thomas Caparas,1,0,35,34
1658052092593,MATH 20C,A02,083761,Briones; Jor-el Thomas Caparas,8,0,35,27
1658052092593,MATH 20C,A03,093476,Briones; Jor-el Thomas Caparas,0,1,36,36
1658052092593,MATH 20C,B01,083762,Bach; Quang Tran,1,0,30,29
1658052098624,MATH 20D,A01,083765,Tran; Brian Kha,5,0,30,25
1658052098624,MATH 20D,A02,083766,Tran; Brian Kha,5,0,30,25
1658052098624,MATH 20D,A03,083767,Tran; Brian Kha,6,0,30,24
1658052104650,MATH 20E,A01,083771,Ganguly; Soumya,12,0,32,20
1658052104650,MATH 20E,A02,083772,Ganguly; Soumya,7,0,32,25
1658052104650,MATH 20E,B01,083773,Ciotti; Benjamin,20,0,35,15
1658052104650,MATH 20E,B02,083774,Ciotti; Benjamin,18,0,35,17
1658052110677,MATH 103A,A01,083777,Greenfeld; Be'Eri,6,0,36,30
1658052110677,MATH 103A,A02,083778,Greenfeld; Be'Eri,5,0,36,31
1658052110677,MATH 103A,A03,093561,Greenfeld; Be'Eri,7,0,36,29
1658052110677,MATH 103A,B01,083779,Greenfeld; Be'Eri,8,0,36,28
1658052110677,MATH 103A,B02,083780,Greenfeld; Be'Eri,4,0,36,32
1658052110677,MATH 103A,B03,093562,Greenfeld; Be'Eri,3,0,36,33
1658052116705,MATH 105,A01,085443,Carter; Anne Toulson,15,0,35,20
1658052116705,MATH 105,A02,093477,Carter; Anne Toulson,20,0,35,15
1658052122730,MATH 109,A01,083213,Ganzberger; Geoffrey Michael,3,0,34,31
1658052122730,MATH 109,A02,083214,Ganzberger; Geoffrey Michael,4,0,34,30
1658052122730,MATH 109,A03,093478,Ganzberger; Geoffrey Michael,2,0,34,32
1658052122730,MATH 109,B01,083215,Ganzberger; Geoffrey Michael,3,0,32,29
1658052122730,MATH 109,B02,083216,Ganzberger; Geoffrey Michael,3,0,32,29
1658052122730,MATH 109,B03,093479,Ganzberger; Geoffrey Michael,8,0,32,24
1658052128756,MATH 142A,A01,083219,Chow; Bennett,7,0,32,25
1658052128756,MATH 142A,A02,083220,Chow; Bennett,10,0,32,22
1658052128756,MATH 142A,A03,093480,Chow; Bennett,9,0,32,23
1658052128756,MATH 142A,B03,093481,Chow; Bennett,8,0,32,24
1658052128756,MATH 142A,B04,093558,Chow; Bennett,14,0,32,18
1658052128756,MATH 142A,B05,093559,Chow; Bennett,7,0,32,25
1658052134781,MATH 193A,A01,083224,Rotar; Vladimir,9,0,34,25
1658052134781,MATH 193A,A02,083225,Rotar; Vladimir,11,0,34,23
1658052134781,MATH 193A,A03,083781,Rotar; Vladimir,5,0,34,29
1658052134781,MATH 193A,A04,083782,Rotar; Vladimir,12,0,34,22
1658052134781,MATH 193A,A05,093482,Rotar; Vladimir,11,0,34,23
1658052140808,MATH 197,001,091859,McAuley; Julian John,9999,0,9999,0
1658052140808,MATH 197,002,095566,Kedlaya; Kiran S.,9997,0,9999,2
1658052140808,MATH 197,003,095567,Xiao; Ming,9999,0,9999,0
1658052140808,MATH 197,004,095571,Perols; Johan Lars,9998,0,9999,1
1658052147880,COGS 9,A01,083615,Shannon; Kyle Michael,11,0,75,64
1658052153906,COGS 11,A01,083617,Boyle; Mary E. T.,23,0,48,25
1658052159936,COGS 13,A01,083071,Bastos; Amalia Pinkusfeld,12,0,71,59
1658052165968,COGS 14A,A01,092681,Semenuks; Arturs,5,1,100,95
1658052171997,COGS 14B,A01,083073,Cheng; Tzu-Han,7,0,63,56
1658052178022,COGS 17,A01,092677,Semenuks; Arturs,7,0,81,74
1658052184051,COGS 100,A01,083619,Allen; Michael Gordon,17,0,70,53
1658052190082,COGS 101A,A01,083621,Davis; Joshua Daniel,9,0,68,59
1658052196111,COGS 101B,A01,091572,Allen; Michael Gordon,14,0,65,51
1658052202134,COGS 101C,A01,083625,Delgado; Tania,17,0,35,18
1658052208164,COGS 107A,A01,083627,Boyle; Mary E. T.,14,0,60,46
1658052214194,COGS 118A,A01,083075,Gupta; Anjum,21,0,76,55
1658052220220,CSE 3,A50,083646,Miranda; Gregory Joseph,24,0,50,26
1658052226248,CSE 8A,A50,083650,Miranda; Gregory Joseph,17,1,56,39
1658052232273,CSE 11,A01,083080,Cao; Yingjun,7,15,40,33
1658052238303,CSE 12,A01,083652,Krause-Levy; Sophia Louisa,30,1,120,90
1658052244328,CSE 15L,A01,083654,Morris; Justin Loren,9,0,50,41
1658052244328,CSE 15L,A02,083655,Morris; Justin Loren,11,0,50,39
1658052250351,CSE 20,A01,083657,Tran; Khoa Dang,39,0,80,41
1658052256381,CSE 21,A01,095574,Bach; Quang Tran,23,0,48,25
1658052262413,CSE 30,A01,083084,Eldon; John,8,0,80,72
1658052262413,CSE 30,B01,095061,Bhaskar; Nishant,9,0,50,41
1658052268436,CSE 100,A01,083659,Cao; Yingjun,5,4,70,65
1658052274460,CSE 134B,A01,083661,Powell; Thomas Allan,25,0,100,75
1658052280484,CSE 140,A01,083663,Gungor; Onat,17,0,85,68
1658052286506,CSE 140L,A01,083088,Eldon; John,23,0,100,77
1658052292539,CSE 175,A01,083665,Kumar; Rakesh,3,0,25,22
1658052298561,CSE 190,A00,092507,Dubnov; Shlomo,8,0,20,12
1658052304588,ECE 45,A01,083139,Congero; Spencer William,7,0,75,68
1658052310614,ECE 65,A50,083695,Saad; Andrew S,12,0,30,18
1658052310614,ECE 65,A51,095125,Saad; Andrew S,24,0,26,2
1658052316730,ECE 109,A01,091882,Touri; Behrouz,21,0,70,49
1658052322752,ECE 180,A00,083140,Abi Samra; Nicholas Camill,1,0,30,29
1658052322752,ECE 180,B00,083141,Abi Samra; Nicholas Camill,0,0,30,30
1658052328781,MATH 10A,A01,083735,Patchell; Gregory David,2,0,30,28
1658052328781,MATH 10A,A02,083736,Patchell; Gregory David,20,0,30,10
1658052328781,MATH 10A,A03,083737,Patchell; Gregory David,16,0,30,14
1658052334808,MATH 10B,A01,083207,Lim; Seonhee,9,0,34,25
1658052334808,MATH 10B,A02,083208,Lim; Seonhee,10,0,35,25
1658052334808,MATH 10B,A03,093472,Lim; Seonhee,7,0,34,27
1658052334808,MATH 10B,B01,083739,Sinha; Shubham,14,0,30,16
1658052340872,MATH 18,A01,083743,Cinel; Cameron Alexander,9,0,30,21
1658052340872,MATH 18,A02,083744,Cinel; Cameron Alexander,18,0,30,12
1658052340872,MATH 18,A03,083745,Cinel; Cameron Alexander,10,0,30,20
1658052340872,MATH 18,B01,083748,Rideout; David Porter,5,0,37,32
1658052340872,MATH 18,B02,083749,Rideout; David Porter,5,0,36,31
1658052340872,MATH 18,B03,083750,Rideout; David Porter,3,0,37,34
1658052340872,MATH 18,B04,083751,Rideout; David Porter,7,0,36,29
1658052340872,MATH 18,B05,093473,Rideout; David Porter,7,0,36,29
1658052340872,MATH 18,B06,093474,Rideout; David Porter,6,0,36,30
1658052346896,MATH 20A,A01,083754,Zheng; Zequn,14,0,40,26
1658052352927,MATH 20B,A01,083756,Briones; Jor-el Thomas Caparas,4,0,36,32
1658052352927,MATH 20B,A02,083757,Briones; Jor-el Thomas Caparas,1,0,36,35
1658052352927,MATH 20B,A03,093475,Briones; Jor-el Thomas Caparas,3,0,36,33
1658052358950,MATH 20C,A01,083760,Briones; Jor-el Thomas Caparas,1,0,35,34
1658052358950,MATH 20C,A02,083761,Briones; Jor-el Thomas Caparas,8,0,35,27
1658052358950,MATH 20C,A03,093476,Briones; Jor-el Thomas Caparas,0,1,36,36
1658052358950,MATH 20C,B01,083762,Bach; Quang Tran,1,0,30,29
1658052364981,MATH 20D,A01,083765,Tran; Brian Kha,5,0,30,25
1658052364981,MATH 20D,A02,083766,Tran; Brian Kha,5,0,30,25
1658052364981,MATH 20D,A03,083767,Tran; Brian Kha,6,0,30,24
1658052371007,MATH 20E,A01,083771,Ganguly; Soumya,12,0,32,20
1658052371007,MATH 20E,A02,083772,Ganguly; Soumya,7,0,32,25
1658052371007,MATH 20E,B01,083773,Ciotti; Benjamin,20,0,35,15
1658052371007,MATH 20E,B02,083774,Ciotti; Benjamin,18,0,35,17
1658052377046,MATH 103A,A01,083777,Greenfeld; Be'Eri,6,0,36,30
1658052377046,MATH 103A,A02,083778,Greenfeld; Be'Eri,5,0,36,31
1658052377046,MATH 103A,A03,093561,Greenfeld; Be'Eri,7,0,36,29
1658052377046,MATH 103A,B01,083779,Greenfeld; Be'Eri,8,0,36,28
1658052377046,MATH 103A,B02,083780,Greenfeld; Be'Eri,4,0,36,32
1658052377046,MATH 103A,B03,093562,Greenfeld; Be'Eri,3,0,36,33
1658052383073,MATH 105,A01,085443,Carter; Anne Toulson,15,0,35,20
1658052383073,MATH 105,A02,093477,Carter; Anne Toulson,20,0,35,15
1658052389104,MATH 109,A01,083213,Ganzberger; Geoffrey Michael,3,0,34,31
1658052389104,MATH 109,A02,083214,Ganzberger; Geoffrey Michael,4,0,34,30
1658052389104,MATH 109,A03,093478,Ganzberger; Geoffrey Michael,2,0,34,32
1658052389104,MATH 109,B01,083215,Ganzberger; Geoffrey Michael,3,0,32,29
1658052389104,MATH 109,B02,083216,Ganzberger; Geoffrey Michael,3,0,32,29
1658052389104,MATH 109,B03,093479,Ganzberger; Geoffrey Michael,8,0,32,24
1658052395133,MATH 142A,A01,083219,Chow; Bennett,7,0,32,25
1658052395133,MATH 142A,A02,083220,Chow; Bennett,10,0,32,22
1658052395133,MATH 142A,A03,093480,Chow; Bennett,9,0,32,23
1658052395133,MATH 142A,B03,093481,Chow; Bennett,8,0,32,24
1658052395133,MATH 142A,B04,093558,Chow; Bennett,14,0,32,18
1658052395133,MATH 142A,B05,093559,Chow; Bennett,7,0,32,25
1658052401168,MATH 193A,A01,083224,Rotar; Vladimir,9,0,34,25
1658052401168,MATH 193A,A02,083225,Rotar; Vladimir,11,0,34,23
1658052401168,MATH 193A,A03,083781,Rotar; Vladimir,5,0,34,29
1658052401168,MATH 193A,A04,083782,Rotar; Vladimir,12,0,34,22
1658052401168,MATH 193A,A05,093482,Rotar; Vladimir,11,0,34,23
1658052407201,MATH 197,001,091859,McAuley; Julian John,9999,0,9999,0
1658052407201,MATH 197,002,095566,Kedlaya; Kiran S.,9997,0,9999,2
1658052407201,MATH 197,003,095567,Xiao; Ming,9999,0,9999,0
1658052407201,MATH 197,004,095571,Perols; Johan Lars,9998,0,9999,1
1658052414265,COGS 9,A01,083615,Shannon; Kyle Michael,11,0,75,64
1658052420299,COGS 11,A01,083617,Boyle; Mary E. T.,23,0,48,25
1658052426331,COGS 13,A01,083071,Bastos; Amalia Pinkusfeld,12,0,71,59
1658052432357,COGS 14A,A01,092681,Semenuks; Arturs,5,1,100,95
1658052438381,COGS 14B,A01,083073,Cheng; Tzu-Han,7,0,63,56
1658052444412,COGS 17,A01,092677,Semenuks; Arturs,7,0,81,74
1658052450442,COGS 100,A01,083619,Allen; Michael Gordon,17,0,70,53
1658052456466,COGS 101A,A01,083621,Davis; Joshua Daniel,9,0,68,59
1658052462491,COGS 101B,A01,091572,Allen; Michael Gordon,14,0,65,51
1658052468521,COGS 101C,A01,083625,Delgado; Tania,17,0,35,18
1658052474545,COGS 107A,A01,083627,Boyle; Mary E. T.,14,0,60,46
1658052480582,COGS 118A,A01,083075,Gupta; Anjum,21,0,76,55
1658052486609,CSE 3,A50,083646,Miranda; Gregory Joseph,24,0,50,26
1658052492634,CSE 8A,A50,083650,Miranda; Gregory Joseph,17,1,56,39
1658052498664,CSE 11,A01,083080,Cao; Yingjun,7,15,40,33
1658052504690,CSE 12,A01,083652,Krause-Levy; Sophia Louisa,30,1,120,90
1658052510715,CSE 15L,A01,083654,Morris; Justin Loren,9,0,50,41
1658052510715,CSE 15L,A02,083655,Morris; Justin Loren,11,0,50,39
1658052516745,CSE 20,A01,083657,Tran; Khoa Dang,39,0,80,41
1658052522776,CSE 21,A01,095574,Bach; Quang Tran,23,0,48,25
1658052528802,CSE 30,A01,083084,Eldon; John,8,0,80,72
1658052528802,CSE 30,B01,095061,Bhaskar; Nishant,9,0,50,41
1658052534827,CSE 100,A01,083659,Cao; Yingjun,5,4,70,65
1658052540850,CSE 134B,A01,083661,Powell; Thomas Allan,25,0,100,75
1658052546889,CSE 140,A01,083663,Gungor; Onat,17,0,85,68
1658052552914,CSE 140L,A01,083088,Eldon; John,23,0,100,77
1658052558942,CSE 175,A01,083665,Kumar; Rakesh,3,0,25,22
1658052564970,CSE 190,A00,092507,Dubnov; Shlomo,8,0,20,12
1658052571003,ECE 45,A01,083139,Congero; Spencer William,7,0,75,68
1658052577030,ECE 65,A50,083695,Saad; Andrew S,12,0,30,18
1658052577030,ECE 65,A51,095125,Saad; Andrew S,24,0,26,2
1658052583059,ECE 109,A01,091882,Touri; Behrouz,21,0,70,49
1658052589090,ECE 180,A00,083140,Abi Samra; Nicholas Camill,1,0,30,29
1658052589090,ECE 180,B00,083141,Abi Samra; Nicholas Camill,0,0,30,30
1658052595124,MATH 10A,A01,083735,Patchell; Gregory David,2,0,30,28
1658052595124,MATH 10A,A02,083736,Patchell; Gregory David,20,0,30,10
1658052595124,MATH 10A,A03,083737,Patchell; Gregory David,16,0,30,14
1658052601152,MATH 10B,A01,083207,Lim; Seonhee,9,0,34,25
1658052601152,MATH 10B,A02,083208,Lim; Seonhee,10,0,35,25
1658052601152,MATH 10B,A03,093472,Lim; Seonhee,7,0,34,27
1658052601152,MATH 10B,B01,083739,Sinha; Shubham,14,0,30,16
1658052607180,MATH 18,A01,083743,Cinel; Cameron Alexander,9,0,30,21
1658052607180,MATH 18,A02,083744,Cinel; Cameron Alexander,18,0,30,12
1658052607180,MATH 18,A03,083745,Cinel; Cameron Alexander,10,0,30,20
1658052607180,MATH 18,B01,083748,Rideout; David Porter,5,0,37,32
1658052607180,MATH 18,B02,083749,Rideout; David Porter,5,0,36,31
1658052607180,MATH 18,B03,083750,Rideout; David Porter,3,0,37,34
1658052607180,MATH 18,B04,083751,Rideout; David Porter,7,0,36,29
1658052607180,MATH 18,B05,093473,Rideout; David Porter,7,0,36,29
1658052607180,MATH 18,B06,093474,Rideout; David Porter,6,0,36,30
1658052613204,MATH 20A,A01,083754,Zheng; Zequn,14,0,40,26
1658052619231,MATH 20B,A01,083756,Briones; Jor-el Thomas Caparas,4,0,36,32
1658052619231,MATH 20B,A02,083757,Briones; Jor-el Thomas Caparas,1,0,36,35
1658052619231,MATH 20B,A03,093475,Briones; Jor-el Thomas Caparas,3,0,36,33
1658052625265,MATH 20C,A01,083760,Briones; Jor-el Thomas Caparas,1,0,35,34
1658052625265,MATH 20C,A02,083761,Briones; Jor-el Thomas Caparas,8,0,35,27
1658052625265,MATH 20C,A03,093476,Briones; Jor-el Thomas Caparas,0,1,36,36
1658052625265,MATH 20C,B01,083762,Bach; Quang Tran,1,0,30,29
1658052631297,MATH 20D,A01,083765,Tran; Brian Kha,5,0,30,25
1658052631297,MATH 20D,A02,083766,Tran; Brian Kha,5,0,30,25
1658052631297,MATH 20D,A03,083767,Tran; Brian Kha,6,0,30,24
1658052637330,MATH 20E,A01,083771,Ganguly; Soumya,12,0,32,20
1658052637330,MATH 20E,A02,083772,Ganguly; Soumya,7,0,32,25
1658052637330,MATH 20E,B01,083773,Ciotti; Benjamin,20,0,35,15
1658052637330,MATH 20E,B02,083774,Ciotti; Benjamin,18,0,35,17
1658052643360,MATH 103A,A01,083777,Greenfeld; Be'Eri,6,0,36,30
1658052643360,MATH 103A,A02,083778,Greenfeld; Be'Eri,5,0,36,31
1658052643360,MATH 103A,A03,093561,Greenfeld; Be'Eri,7,0,36,29
1658052643360,MATH 103A,B01,083779,Greenfeld; Be'Eri,8,0,36,28
1658052643360,MATH 103A,B02,083780,Greenfeld; Be'Eri,4,0,36,32
1658052643360,MATH 103A,B03,093562,Greenfeld; Be'Eri,3,0,36,33
1658052649387,MATH 105,A01,085443,Carter; Anne Toulson,15,0,35,20
1658052649387,MATH 105,A02,093477,Carter; Anne Toulson,20,0,35,15
1658052655412,MATH 109,A01,083213,Ganzberger; Geoffrey Michael,3,0,34,31
1658052655412,MATH 109,A02,083214,Ganzberger; Geoffrey Michael,4,0,34,30
1658052655412,MATH 109,A03,093478,Ganzberger; Geoffrey Michael,2,0,34,32
1658052655412,MATH 109,B01,083215,Ganzberger; Geoffrey Michael,3,0,32,29
1658052655412,MATH 109,B02,083216,Ganzberger; Geoffrey Michael,3,0,32,29
1658052655412,MATH 109,B03,093479,Ganzberger; Geoffrey Michael,8,0,32,24
1658052661444,MATH 142A,A01,083219,Chow; Bennett,7,0,32,25
1658052661444,MATH 142A,A02,083220,Chow; Bennett,10,0,32,22
1658052661444,MATH 142A,A03,093480,Chow; Bennett,9,0,32,23
1658052661444,MATH 142A,B03,093481,Chow; Bennett,8,0,32,24
1658052661444,MATH 142A,B04,093558,Chow; Bennett,14,0,32,18
1658052661444,MATH 142A,B05,093559,Chow; Bennett,7,0,32,25
1658052667474,MATH 193A,A01,083224,Rotar; Vladimir,9,0,34,25
1658052667474,MATH 193A,A02,083225,Rotar; Vladimir,11,0,34,23
1658052667474,MATH 193A,A03,083781,Rotar; Vladimir,5,0,34,29
1658052667474,MATH 193A,A04,083782,Rotar; Vladimir,12,0,34,22
1658052667474,MATH 193A,A05,093482,Rotar; Vladimir,11,0,34,23
1658052673500,MATH 197,001,091859,McAuley; Julian John,9999,0,9999,0
1658052673500,MATH 197,002,095566,Kedlaya; Kiran S.,9997,0,9999,2
1658052673500,MATH 197,003,095567,Xiao; Ming,9999,0,9999,0
1658052673500,MATH 197,004,095571,Perols; Johan Lars,9998,0,9999,1
1658052680600,COGS 9,A01,083615,Shannon; Kyle Michael,11,0,75,64
1658052686628,COGS 11,A01,083617,Boyle; Mary E. T.,23,0,48,25
1658052692655,COGS 13,A01,083071,Bastos; Amalia Pinkusfeld,12,0,71,59
1658052698684,COGS 14A,A01,092681,Semenuks; Arturs,5,1,100,95
1658052704712,COGS 14B,A01,083073,Cheng; Tzu-Han,7,0,63,56
1658052710735,COGS 17,A01,092677,Semenuks; Arturs,7,0,81,74
1658052716765,COGS 100,A01,083619,Allen; Michael Gordon,17,0,70,53
1658052722789,COGS 101A,A01,083621,Davis; Joshua Daniel,9,0,68,59
1658052728813,COGS 101B,A01,091572,Allen; Michael Gordon,14,0,65,51
1658052734848,COGS 101C,A01,083625,Delgado; Tania,17,0,35,18
1658052740878,COGS 107A,A01,083627,Boyle; Mary E. T.,14,0,60,46
1658052746902,COGS 118A,A01,083075,Gupta; Anjum,21,0,76,55
1658052752928,CSE 3,A50,083646,Miranda; Gregory Joseph,24,0,50,26
1658052758959,CSE 8A,A50,083650,Miranda; Gregory Joseph,17,1,56,39
1658052764985,CSE 11,A01,083080,Cao; Yingjun,7,15,40,33
1658052771010,CSE 12,A01,083652,Krause-Levy; Sophia Louisa,30,1,120,90
1658052777036,CSE 15L,A01,083654,Morris; Justin Loren,9,0,50,41
1658052777036,CSE 15L,A02,083655,Morris; Justin Loren,11,0,50,39
1658052783060,CSE 20,A01,083657,Tran; Khoa Dang,39,0,80,41
1658052789086,CSE 21,A01,095574,Bach; Quang Tran,23,0,48,25
1658052795116,CSE 30,A01,083084,Eldon; John,8,0,80,72
1658052795116,CSE 30,B01,095061,Bhaskar; Nishant,9,0,50,41
1658052801143,CSE 100,A01,083659,Cao; Yingjun,5,4,70,65
1658052807167,CSE 134B,A01,083661,Powell; Thomas Allan,25,0,100,75
1658052813194,CSE 140,A01,083663,Gungor; Onat,17,0,85,68
1658052819223,CSE 140L,A01,083088,Eldon; John,23,0,100,77
1658052825248,CSE 175,A01,083665,Kumar; Rakesh,3,0,25,22
1658052831272,CSE 190,A00,092507,Dubnov; Shlomo,8,0,20,12
1658052837311,ECE 45,A01,083139,Congero; Spencer William,7,0,75,68
1658052843336,ECE 65,A50,083695,Saad; Andrew S,12,0,30,18
1658052843336,ECE 65,A51,095125,Saad; Andrew S,24,0,26,2
1658052849367,ECE 109,A01,091882,Touri; Behrouz,21,0,70,49
1658052855391,ECE 180,A00,083140,Abi Samra; Nicholas Camill,1,0,30,29
1658052855391,ECE 180,B00,083141,Abi Samra; Nicholas Camill,0,0,30,30
1658052861417,MATH 10A,A01,083735,Patchell; Gregory David,2,0,30,28
1658052861417,MATH 10A,A02,083736,Patchell; Gregory David,20,0,30,10
1658052861417,MATH 10A,A03,083737,Patchell; Gregory David,16,0,30,14
1658052867463,MATH 10B,A01,083207,Lim; Seonhee,9,0,34,25
1658052867463,MATH 10B,A02,083208,Lim; Seonhee,10,0,35,25
1658052867463,MATH 10B,A03,093472,Lim; Seonhee,7,0,34,27
1658052867463,MATH 10B,B01,083739,Sinha; Shubham,14,0,30,16
1658052873501,MATH 18,A01,083743,Cinel; Cameron Alexander,9,0,30,21
1658052873501,MATH 18,A02,083744,Cinel; Cameron Alexander,18,0,30,12
1658052873501,MATH 18,A03,083745,Cinel; Cameron Alexander,10,0,30,20
1658052873501,MATH 18,B01,083748,Rideout; David Porter,5,0,37,32
1658052873501,MATH 18,B02,083749,Rideout; David Porter,5,0,36,31
1658052873501,MATH 18,B03,083750,Rideout; David Porter,3,0,37,34
1658052873501,MATH 18,B04,083751,Rideout; David Porter,7,0,36,29
1658052873501,MATH 18,B05,093473,Rideout; David Porter,7,0,36,29
1658052873501,MATH 18,B06,093474,Rideout; David Porter,6,0,36,30
1658052879538,MATH 20A,A01,083754,Zheng; Zequn,14,0,40,26
1658052885563,MATH 20B,A01,083756,Briones; Jor-el Thomas Caparas,4,0,36,32
1658052885563,MATH 20B,A02,083757,Briones; Jor-el Thomas Caparas,1,0,36,35
1658052885563,MATH 20B,A03,093475,Briones; Jor-el Thomas Caparas,3,0,36,33
1658052891594,MATH 20C,A01,083760,Briones; Jor-el Thomas Caparas,1,0,35,34
1658052891594,MATH 20C,A02,083761,Briones; Jor-el Thomas Caparas,8,0,35,27
1658052891594,MATH 20C,A03,093476,Briones; Jor-el Thomas Caparas,0,1,36,36
1658052891594,MATH 20C,B01,083762,Bach; Quang Tran,1,0,30,29
1658052897620,MATH 20D,A01,083765,Tran; Brian Kha,5,0,30,25
1658052897620,MATH 20D,A02,083766,Tran; Brian Kha,5,0,30,25
1658052897620,MATH 20D,A03,083767,Tran; Brian Kha,6,0,30,24
1658052903646,MATH 20E,A01,083771,Ganguly; Soumya,12,0,32,20
1658052903646,MATH 20E,A02,083772,Ganguly; Soumya,7,0,32,25
1658052903646,MATH 20E,B01,083773,Ciotti; Benjamin,20,0,35,15
1658052903646,MATH 20E,B02,083774,Ciotti; Benjamin,18,0,35,17
1658052909673,MATH 103A,A01,083777,Greenfeld; Be'Eri,6,0,36,30
1658052909673,MATH 103A,A02,083778,Greenfeld; Be'Eri,5,0,36,31
1658052909673,MATH 103A,A03,093561,Greenfeld; Be'Eri,7,0,36,29
1658052909673,MATH 103A,B01,083779,Greenfeld; Be'Eri,8,0,36,28
1658052909673,MATH 103A,B02,083780,Greenfeld; Be'Eri,4,0,36,32
1658052909673,MATH 103A,B03,093562,Greenfeld; Be'Eri,3,0,36,33
1658052915767,MATH 105,A01,085443,Carter; Anne Toulson,15,0,35,20
1658052915767,MATH 105,A02,093477,Carter; Anne Toulson,20,0,35,15
1658052921792,MATH 109,A01,083213,Ganzberger; Geoffrey Michael,3,0,34,31
1658052921792,MATH 109,A02,083214,Ganzberger; Geoffrey Michael,4,0,34,30
1658052921792,MATH 109,A03,093478,Ganzberger; Geoffrey Michael,2,0,34,32
1658052921792,MATH 109,B01,083215,Ganzberger; Geoffrey Michael,3,0,32,29
1658052921792,MATH 109,B02,083216,Ganzberger; Geoffrey Michael,3,0,32,29
1658052921792,MATH 109,B03,093479,Ganzberger; Geoffrey Michael,8,0,32,24
1658052927817,MATH 142A,A01,083219,Chow; Bennett,7,0,32,25
1658052927817,MATH 142A,A02,083220,Chow; Bennett,10,0,32,22
1658052927817,MATH 142A,A03,093480,Chow; Bennett,9,0,32,23
1658052927817,MATH 142A,B03,093481,Chow; Bennett,8,0,32,24
1658052927817,MATH 142A,B04,093558,Chow; Bennett,14,0,32,18
1658052927817,MATH 142A,B05,093559,Chow; Bennett,7,0,32,25
1658052933844,MATH 193A,A01,083224,Rotar; Vladimir,9,0,34,25
1658052933844,MATH 193A,A02,083225,Rotar; Vladimir,11,0,34,23
1658052933844,MATH 193A,A03,083781,Rotar; Vladimir,5,0,34,29
1658052933844,MATH 193A,A04,083782,Rotar; Vladimir,12,0,34,22
1658052933844,MATH 193A,A05,093482,Rotar; Vladimir,11,0,34,23
1658052939869,MATH 197,001,091859,McAuley; Julian John,9999,0,9999,0
1658052939869,MATH 197,002,095566,Kedlaya; Kiran S.,9997,0,9999,2
1658052939869,MATH 197,003,095567,Xiao; Ming,9999,0,9999,0
1658052939869,MATH 197,004,095571,Perols; Johan Lars,9998,0,9999,1
1658052946960,COGS 9,A01,083615,Shannon; Kyle Michael,11,0,75,64
1658052952984,COGS 11,A01,083617,Boyle; Mary E. T.,23,0,48,25
1658052959013,COGS 13,A01,083071,Bastos; Amalia Pinkusfeld,12,0,71,59
1658052965039,COGS 14A,A01,092681,Semenuks; Arturs,5,1,100,95
1658052971066,COGS 14B,A01,083073,Cheng; Tzu-Han,7,0,63,56
1658052977090,COGS 17,A01,092677,Semenuks; Arturs,7,0,81,74
1658052983115,COGS 100,A01,083619,Allen; Michael Gordon,17,0,70,53
1658052989139,COGS 101A,A01,083621,Davis; Joshua Daniel,9,0,68,59
1658052995169,COGS 101B,A01,091572,Allen; Michael Gordon,14,0,65,51
1658053001192,COGS 101C,A01,083625,Delgado; Tania,17,0,35,18
1658053007218,COGS 107A,A01,083627,Boyle; Mary E. T.,14,0,60,46
1658053013242,COGS 118A,A01,083075,Gupta; Anjum,21,0,76,55
1658053019269,CSE 3,A50,083646,Miranda; Gregory Joseph,24,0,50,26
1658053025298,CSE 8A,A50,083650,Miranda; Gregory Joseph,17,1,56,39
1658053031322,CSE 11,A01,083080,Cao; Yingjun,7,15,40,33
1658053037347,CSE 12,A01,083652,Krause-Levy; Sophia Louisa,30,1,120,90
1658053043377,CSE 15L,A01,083654,Morris; Justin Loren,9,0,50,41
1658053043377,CSE 15L,A02,083655,Morris; Justin Loren,11,0,50,39
1658053049404,CSE 20,A01,083657,Tran; Khoa Dang,39,0,80,41
1658053055434,CSE 21,A01,095574,Bach; Quang Tran,23,0,48,25
1658053061461,CSE 30,A01,083084,Eldon; John,8,0,80,72
1658053061461,CSE 30,B01,095061,Bhaskar; Nishant,9,0,50,41
1658053067491,CSE 100,A01,083659,Cao; Yingjun,5,4,70,65
1658053073526,CSE 134B,A01,083661,Powell; Thomas Allan,25,0,100,75
1658053079551,CSE 140,A01,083663,Gungor; Onat,17,0,85,68
1658053085574,CSE 140L,A01,083088,Eldon; John,23,0,100,77
1658053091599,CSE 175,A01,083665,Kumar; Rakesh,3,0,25,22
1658053097631,CSE 190,A00,092507,Dubnov; Shlomo,8,0,20,12
1658053103656,ECE 45,A01,083139,Congero; Spencer William,7,0,75,68
1658053109684,ECE 65,A50,083695,Saad; Andrew S,12,0,30,18
1658053109684,ECE 65,A51,095125,Saad; Andrew S,24,0,26,2
1658053115708,ECE 109,A01,091882,Touri; Behrouz,21,0,70,49
1658053121733,ECE 180,A00,083140,Abi Samra; Nicholas Camill,1,0,30,29
1658053121733,ECE 180,B00,083141,Abi Samra; Nicholas Camill,0,0,30,30
1658053127774,MATH 10A,A01,083735,Patchell; Gregory David,2,0,30,28
1658053127774,MATH 10A,A02,083736,Patchell; Gregory David,20,0,30,10
1658053127774,MATH 10A,A03,083737,Patchell; Gregory David,16,0,30,14
1658053133811,MATH 10B,A01,083207,Lim; Seonhee,9,0,34,25
1658053133811,MATH 10B,A02,083208,Lim; Seonhee,10,0,35,25
1658053133811,MATH 10B,A03,093472,Lim; Seonhee,7,0,34,27
1658053133811,MATH 10B,B01,083739,Sinha; Shubham,14,0,30,16
1658053139843,MATH 18,A01,083743,Cinel; Cameron Alexander,9,0,30,21
1658053139843,MATH 18,A02,083744,Cinel; Cameron Alexander,18,0,30,12
1658053139843,MATH 18,A03,083745,Cinel; Cameron Alexander,10,0,30,20
1658053139843,MATH 18,B01,083748,Rideout; David Porter,5,0,37,32
1658053139843,MATH 18,B02,083749,Rideout; David Porter,5,0,36,31
1658053139843,MATH 18,B03,083750,Rideout; David Porter,3,0,37,34
1658053139843,MATH 18,B04,083751,Rideout; David Porter,7,0,36,29
1658053139843,MATH 18,B05,093473,Rideout; David Porter,7,0,36,29
1658053139843,MATH 18,B06,093474,Rideout; David Porter,6,0,36,30
1658053145868,MATH 20A,A01,083754,Zheng; Zequn,14,0,40,26
1658053151894,MATH 20B,A01,083756,Briones; Jor-el Thomas Caparas,4,0,36,32
1658053151894,MATH 20B,A02,083757,Briones; Jor-el Thomas Caparas,1,0,36,35
1658053151894,MATH 20B,A03,093475,Briones; Jor-el Thomas Caparas,3,0,36,33
1658053157919,MATH 20C,A01,083760,Briones; Jor-el Thomas Caparas,1,0,35,34
1658053157919,MATH 20C,A02,083761,Briones; Jor-el Thomas Caparas,8,0,35,27
1658053157919,MATH 20C,A03,093476,Briones; Jor-el Thomas Caparas,0,1,36,36
1658053157919,MATH 20C,B01,083762,Bach; Quang Tran,1,0,30,29
1658053163953,MATH 20D,A01,083765,Tran; Brian Kha,5,0,30,25
1658053163953,MATH 20D,A02,083766,Tran; Brian Kha,5,0,30,25
1658053163953,MATH 20D,A03,083767,Tran; Brian Kha,6,0,30,24
1658053169991,MATH 20E,A01,083771,Ganguly; Soumya,12,0,32,20
1658053169991,MATH 20E,A02,083772,Ganguly; Soumya,7,0,32,25
1658053169991,MATH 20E,B01,083773,Ciotti; Benjamin,20,0,35,15
1658053169991,MATH 20E,B02,083774,Ciotti; Benjamin,18,0,35,17
1658053176027,MATH 103A,A01,083777,Greenfeld; Be'Eri,6,0,36,30
1658053176027,MATH 103A,A02,083778,Greenfeld; Be'Eri,5,0,36,31
1658053176027,MATH 103A,A03,093561,Greenfeld; Be'Eri,7,0,36,29
1658053176027,MATH 103A,B01,083779,Greenfeld; Be'Eri,8,0,36,28
1658053176027,MATH 103A,B02,083780,Greenfeld; Be'Eri,4,0,36,32
1658053176027,MATH 103A,B03,093562,Greenfeld; Be'Eri,3,0,36,33
1658053182055,MATH 105,A01,085443,Carter; Anne Toulson,15,0,35,20
1658053182055,MATH 105,A02,093477,Carter; Anne Toulson,20,0,35,15
1658053188087,MATH 109,A01,083213,Ganzberger; Geoffrey Michael,3,0,34,31
1658053188087,MATH 109,A02,083214,Ganzberger; Geoffrey Michael,4,0,34,30
1658053188087,MATH 109,A03,093478,Ganzberger; Geoffrey Michael,2,0,34,32
1658053188087,MATH 109,B01,083215,Ganzberger; Geoffrey Michael,3,0,32,29
1658053188087,MATH 109,B02,083216,Ganzberger; Geoffrey Michael,3,0,32,29
1658053188087,MATH 109,B03,093479,Ganzberger; Geoffrey Michael,8,0,32,24
1658053194113,MATH 142A,A01,083219,Chow; Bennett,7,0,32,25
1658053194113,MATH 142A,A02,083220,Chow; Bennett,10,0,32,22
1658053194113,MATH 142A,A03,093480,Chow; Bennett,9,0,32,23
1658053194113,MATH 142A,B03,093481,Chow; Bennett,8,0,32,24
1658053194113,MATH 142A,B04,093558,Chow; Bennett,14,0,32,18
1658053194113,MATH 142A,B05,093559,Chow; Bennett,7,0,32,25
1658053200145,MATH 193A,A01,083224,Rotar; Vladimir,9,0,34,25
1658053200145,MATH 193A,A02,083225,Rotar; Vladimir,11,0,34,23
1658053200145,MATH 193A,A03,083781,Rotar; Vladimir,5,0,34,29
1658053200145,MATH 193A,A04,083782,Rotar; Vladimir,12,0,34,22
1658053200145,MATH 193A,A05,093482,Rotar; Vladimir,11,0,34,23
1658053206169,MATH 197,001,091859,McAuley; Julian John,9999,0,9999,0
1658053206169,MATH 197,002,095566,Kedlaya; Kiran S.,9997,0,9999,2
1658053206169,MATH 197,003,095567,Xiao; Ming,9999,0,9999,0
1658053206169,MATH 197,004,095571,Perols; Johan Lars,9998,0,9999,1
1658053213244,COGS 9,A01,083615,Shannon; Kyle Michael,11,0,75,64
1658053219271,COGS 11,A01,083617,Boyle; Mary E. T.,23,0,48,25
1658053225303,COGS 13,A01,083071,Bastos; Amalia Pinkusfeld,12,0,71,59
1658053231327,COGS 14A,A01,092681,Semenuks; Arturs,5,1,100,95
1658053237352,COGS 14B,A01,083073,Cheng; Tzu-Han,7,0,63,56
1658053243381,COGS 17,A01,092677,Semenuks; Arturs,7,0,81,74
1658053249407,COGS 100,A01,083619,Allen; Michael Gordon,17,0,70,53
1658053255432,COGS 101A,A01,083621,Davis; Joshua Daniel,9,0,68,59
1658053261462,COGS 101B,A01,091572,Allen; Michael Gordon,14,0,65,51
1658053267489,COGS 101C,A01,083625,Delgado; Tania,17,0,35,18
1658053273513,COGS 107A,A01,083627,Boyle; Mary E. T.,14,0,60,46
1658053279545,COGS 118A,A01,083075,Gupta; Anjum,21,0,76,55
1658053285573,CSE 3,A50,083646,Miranda; Gregory Joseph,24,0,50,26
1658053291597,CSE 8A,A50,083650,Miranda; Gregory Joseph,17,1,56,39
1658053297623,CSE 11,A01,083080,Cao; Yingjun,7,15,40,33
1658053303648,CSE 12,A01,083652,Krause-Levy; Sophia Louisa,30,1,120,90
1658053309677,CSE 15L,A01,083654,Morris; Justin Loren,9,0,50,41
1658053309677,CSE 15L,A02,083655,Morris; Justin Loren,11,0,50,39
1658053315701,CSE 20,A01,083657,Tran; Khoa Dang,39,0,80,41
1658053321732,CSE 21,A01,095574,Bach; Quang Tran,23,0,48,25
1658053327757,CSE 30,A01,083084,Eldon; John,8,0,80,72
1658053327757,CSE 30,B01,095061,Bhaskar; Nishant,9,0,50,41
1658053333785,CSE 100,A01,083659,Cao; Yingjun,5,4,70,65
1658053339811,CSE 134B,A01,083661,Powell; Thomas Allan,25,0,100,75
1658053345838,CSE 140,A01,083663,Gungor; Onat,17,0,85,68
1658053351871,CSE 140L,A01,083088,Eldon; John,23,0,100,77
1658053357920,CSE 175,A01,083665,Kumar; Rakesh,3,0,25,22
1658053363948,CSE 190,A00,092507,Dubnov; Shlomo,8,0,20,12
1658053369981,ECE 45,A01,083139,Congero; Spencer William,7,0,75,68
1658053376006,ECE 65,A50,083695,Saad; Andrew S,12,0,30,18
1658053376006,ECE 65,A51,095125,Saad; Andrew S,24,0,26,2
1658053382031,ECE 109,A01,091882,Touri; Behrouz,21,0,70,49
1658053388056,ECE 180,A00,083140,Abi Samra; Nicholas Camill,1,0,30,29
1658053388056,ECE 180,B00,083141,Abi Samra; Nicholas Camill,0,0,30,30
1658053394085,MATH 10A,A01,083735,Patchell; Gregory David,2,0,30,28
1658053394085,MATH 10A,A02,083736,Patchell; Gregory David,20,0,30,10
1658053394085,MATH 10A,A03,083737,Patchell; Gregory David,16,0,30,14
1658053400124,MATH 10B,A01,083207,Lim; Seonhee,9,0,34,25
1658053400124,MATH 10B,A02,083208,Lim; Seonhee,10,0,35,25
1658053400124,MATH 10B,A03,093472,Lim; Seonhee,7,0,34,27
1658053400124,MATH 10B,B01,083739,Sinha; Shubham,14,0,30,16
1658053406167,MATH 18,A01,083743,Cinel; Cameron Alexander,9,0,30,21
1658053406167,MATH 18,A02,083744,Cinel; Cameron Alexander,18,0,30,12
1658053406167,MATH 18,A03,083745,Cinel; Cameron Alexander,10,0,30,20
1658053406167,MATH 18,B01,083748,Rideout; David Porter,5,0,37,32
1658053406167,MATH 18,B02,083749,Rideout; David Porter,5,0,36,31
1658053406167,MATH 18,B03,083750,Rideout; David Porter,3,0,37,34
1658053406167,MATH 18,B04,083751,Rideout; David Porter,7,0,36,29
1658053406167,MATH 18,B05,093473,Rideout; David Porter,7,0,36,29
1658053406167,MATH 18,B06,093474,Rideout; David Porter,6,0,36,30
1658053412191,MATH 20A,A01,083754,Zheng; Zequn,14,0,40,26
1658053418223,MATH 20B,A01,083756,Briones; Jor-el Thomas Caparas,4,0,36,32
1658053418223,MATH 20B,A02,083757,Briones; Jor-el Thomas Caparas,1,0,36,35
1658053418223,MATH 20B,A03,093475,Briones; Jor-el Thomas Caparas,3,0,36,33
1658053424258,MATH 20C,A01,083760,Briones; Jor-el Thomas Caparas,1,0,35,34
1658053424258,MATH 20C,A02,083761,Briones; Jor-el Thomas Caparas,8,0,35,27
1658053424258,MATH 20C,A03,093476,Briones; Jor-el Thomas Caparas,0,1,36,36
1658053424258,MATH 20C,B01,083762,Bach; Quang Tran,1,0,30,29
1658053430283,MATH 20D,A01,083765,Tran; Brian Kha,5,0,30,25
1658053430283,MATH 20D,A02,083766,Tran; Brian Kha,5,0,30,25
1658053430283,MATH 20D,A03,083767,Tran; Brian Kha,6,0,30,24
1658053436317,MATH 20E,A01,083771,Ganguly; Soumya,12,0,32,20
1658053436317,MATH 20E,A02,083772,Ganguly; Soumya,7,0,32,25
1658053436317,MATH 20E,B01,083773,Ciotti; Benjamin,20,0,35,15
1658053436317,MATH 20E,B02,083774,Ciotti; Benjamin,18,0,35,17
1658053442345,MATH 103A,A01,083777,Greenfeld; Be'Eri,6,0,36,30
1658053442345,MATH 103A,A02,083778,Greenfeld; Be'Eri,5,0,36,31
1658053442345,MATH 103A,A03,093561,Greenfeld; Be'Eri,7,0,36,29
1658053442345,MATH 103A,B01,083779,Greenfeld; Be'Eri,8,0,36,28
1658053442345,MATH 103A,B02,083780,Greenfeld; Be'Eri,4,0,36,32
1658053442345,MATH 103A,B03,093562,Greenfeld; Be'Eri,3,0,36,33
1658053448378,MATH 105,A01,085443,Carter; Anne Toulson,15,0,35,20
1658053448378,MATH 105,A02,093477,Carter; Anne Toulson,20,0,35,15
1658053454404,MATH 109,A01,083213,Ganzberger; Geoffrey Michael,3,0,34,31
1658053454404,MATH 109,A02,083214,Ganzberger; Geoffrey Michael,4,0,34,30
1658053454404,MATH 109,A03,093478,Ganzberger; Geoffrey Michael,2,0,34,32
1658053454404,MATH 109,B01,083215,Ganzberger; Geoffrey Michael,3,0,32,29
1658053454404,MATH 109,B02,083216,Ganzberger; Geoffrey Michael,3,0,32,29
1658053454404,MATH 109,B03,093479,Ganzberger; Geoffrey Michael,8,0,32,24
1658053460431,MATH 142A,A01,083219,Chow; Bennett,7,0,32,25
1658053460431,MATH 142A,A02,083220,Chow; Bennett,10,0,32,22
1658053460431,MATH 142A,A03,093480,Chow; Bennett,9,0,32,23
1658053460431,MATH 142A,B03,093481,Chow; Bennett,8,0,32,24
1658053460431,MATH 142A,B04,093558,Chow; Bennett,14,0,32,18
1658053460431,MATH 142A,B05,093559,Chow; Bennett,7,0,32,25
1658053466464,MATH 193A,A01,083224,Rotar; Vladimir,9,0,34,25
1658053466464,MATH 193A,A02,083225,Rotar; Vladimir,11,0,34,23
1658053466464,MATH 193A,A03,083781,Rotar; Vladimir,5,0,34,29
1658053466464,MATH 193A,A04,083782,Rotar; Vladimir,12,0,34,22
1658053466464,MATH 193A,A05,093482,Rotar; Vladimir,11,0,34,23
1658053472498,MATH 197,001,091859,McAuley; Julian John,9999,0,9999,0
1658053472498,MATH 197,002,095566,Kedlaya; Kiran S.,9997,0,9999,2
1658053472498,MATH 197,003,095567,Xiao; Ming,9999,0,9999,0
1658053472498,MATH 197,004,095571,Perols; Johan Lars,9998,0,9999,1
1658053479585,COGS 9,A01,083615,Shannon; Kyle Michael,11,0,75,64
1658053485612,COGS 11,A01,083617,Boyle; Mary E. T.,23,0,48,25
1658053491637,COGS 13,A01,083071,Bastos; Amalia Pinkusfeld,12,0,71,59
1658053497662,COGS 14A,A01,092681,Semenuks; Arturs,5,1,100,95
1658053503686,COGS 14B,A01,083073,Cheng; Tzu-Han,7,0,63,56
1658053509804,COGS 17,A01,092677,Semenuks; Arturs,7,0,81,74
1658053515834,COGS 100,A01,083619,Allen; Michael Gordon,17,0,70,53
1658053521861,COGS 101A,A01,083621,Davis; Joshua Daniel,9,0,68,59
1658053527889,COGS 101B,A01,091572,Allen; Michael Gordon,14,0,65,51
1658053533915,COGS 101C,A01,083625,Delgado; Tania,17,0,35,18
1658053539938,COGS 107A,A01,083627,Boyle; Mary E. T.,14,0,60,46
1658053545965,COGS 118A,A01,083075,Gupta; Anjum,21,0,76,55
1658053551990,CSE 3,A50,083646,Miranda; Gregory Joseph,24,0,50,26
1658053558012,CSE 8A,A50,083650,Miranda; Gregory Joseph,17,1,56,39
1658053564035,CSE 11,A01,083080,Cao; Yingjun,7,15,40,33
1658053570063,CSE 12,A01,083652,Krause-Levy; Sophia Louisa,30,1,120,90
1658053576088,CSE 15L,A01,083654,Morris; Justin Loren,9,0,50,41
1658053576088,CSE 15L,A02,083655,Morris; Justin Loren,11,0,50,39
1658053582113,CSE 20,A01,083657,Tran; Khoa Dang,39,0,80,41
1658053588136,CSE 21,A01,095574,Bach; Quang Tran,23,0,48,25
1658053594162,CSE 30,A01,083084,Eldon; John,8,0,80,72
1658053594162,CSE 30,B01,095061,Bhaskar; Nishant,9,0,50,41
1658053600188,CSE 100,A01,083659,Cao; Yingjun,5,4,70,65
1658053606214,CSE 134B,A01,083661,Powell; Thomas Allan,25,0,100,75
1658053612241,CSE 140,A01,083663,Gungor; Onat,17,0,85,68
1658053618265,CSE 140L,A01,083088,Eldon; John,23,0,100,77
1658053624288,CSE 175,A01,083665,Kumar; Rakesh,3,0,25,22
1658053630320,CSE 190,A00,092507,Dubnov; Shlomo,8,0,20,12
1658053636347,ECE 45,A01,083139,Congero; Spencer William,7,0,75,68
1658053642372,ECE 65,A50,083695,Saad; Andrew S,12,0,30,18
1658053642372,ECE 65,A51,095125,Saad; Andrew S,24,0,26,2
1658053648403,ECE 109,A01,091882,Touri; Behrouz,21,0,70,49
1658053654431,ECE 180,A00,083140,Abi Samra; Nicholas Camill,1,0,30,29
1658053654431,ECE 180,B00,083141,Abi Samra; Nicholas Camill,0,0,30,30
1658053660456,MATH 10A,A01,083735,Patchell; Gregory David,2,0,30,28
1658053660456,MATH 10A,A02,083736,Patchell; Gregory David,20,0,30,10
1658053660456,MATH 10A,A03,083737,Patchell; Gregory David,16,0,30,14
1658053666490,MATH 10B,A01,083207,Lim; Seonhee,9,0,34,25
1658053666490,MATH 10B,A02,083208,Lim; Seonhee,10,0,35,25
1658053666490,MATH 10B,A03,093472,Lim; Seonhee,7,0,34,27
1658053666490,MATH 10B,B01,083739,Sinha; Shubham,14,0,30,16
1658053672516,MATH 18,A01,083743,Cinel; Cameron Alexander,9,0,30,21
1658053672516,MATH 18,A02,083744,Cinel; Cameron Alexander,18,0,30,12
1658053672516,MATH 18,A03,083745,Cinel; Cameron Alexander,10,0,30,20
1658053672516,MATH 18,B01,083748,Rideout; David Porter,5,0,37,32
1658053672516,MATH 18,B02,083749,Rideout; David Porter,5,0,36,31
1658053672516,MATH 18,B03,083750,Rideout; David Porter,3,0,37,34
1658053672516,MATH 18,B04,083751,Rideout; David Porter,7,0,36,29
1658053672516,MATH 18,B05,093473,Rideout; David Porter,7,0,36,29
1658053672516,MATH 18,B06,093474,Rideout; David Porter,6,0,36,30
1658053678547,MATH 20A,A01,083754,Zheng; Zequn,14,0,40,26
1658053684572,MATH 20B,A01,083756,Briones; Jor-el Thomas Caparas,4,0,36,32
1658053684572,MATH 20B,A02,083757,Briones; Jor-el Thomas Caparas,1,0,36,35
1658053684572,MATH 20B,A03,093475,Briones; Jor-el Thomas Caparas,3,0,36,33
1658053690597,MATH 20C,A01,083760,Briones; Jor-el Thomas Caparas,1,0,35,34
1658053690597,MATH 20C,A02,083761,Briones; Jor-el Thomas Caparas,8,0,35,27
1658053690597,MATH 20C,A03,093476,Briones; Jor-el Thomas Caparas,0,1,36,36
1658053690597,MATH 20C,B01,083762,Bach; Quang Tran,1,0,30,29
1658053696628,MATH 20D,A01,083765,Tran; Brian Kha,5,0,30,25
1658053696628,MATH 20D,A02,083766,Tran; Brian Kha,5,0,30,25
1658053696628,MATH 20D,A03,083767,Tran; Brian Kha,6,0,30,24
1658053702660,MATH 20E,A01,083771,Ganguly; Soumya,12,0,32,20
1658053702660,MATH 20E,A02,083772,Ganguly; Soumya,7,0,32,25
1658053702660,MATH 20E,B01,083773,Ciotti; Benjamin,20,0,35,15
1658053702660,MATH 20E,B02,083774,Ciotti; Benjamin,18,0,35,17
1658053708684,MATH 103A,A01,083777,Greenfeld; Be'Eri,6,0,36,30
1658053708684,MATH 103A,A02,083778,Greenfeld; Be'Eri,5,0,36,31
1658053708684,MATH 103A,A03,093561,Greenfeld; Be'Eri,7,0,36,29
1658053708684,MATH 103A,B01,083779,Greenfeld; Be'Eri,8,0,36,28
1658053708684,MATH 103A,B02,083780,Greenfeld; Be'Eri,4,0,36,32
1658053708684,MATH 103A,B03,093562,Greenfeld; Be'Eri,3,0,36,33
1658053714715,MATH 105,A01,085443,Carter; Anne Toulson,15,0,35,20
1658053714715,MATH 105,A02,093477,Carter; Anne Toulson,20,0,35,15
1658053720741,MATH 109,A01,083213,Ganzberger; Geoffrey Michael,3,0,34,31
1658053720741,MATH 109,A02,083214,Ganzberger; Geoffrey Michael,4,0,34,30
1658053720741,MATH 109,A03,093478,Ganzberger; Geoffrey Michael,2,0,34,32
1658053720741,MATH 109,B01,083215,Ganzberger; Geoffrey Michael,3,0,32,29
1658053720741,MATH 109,B02,083216,Ganzberger; Geoffrey Michael,3,0,32,29
1658053720741,MATH 109,B03,093479,Ganzberger; Geoffrey Michael,8,0,32,24
1658053726773,MATH 142A,A01,083219,Chow; Bennett,7,0,32,25
1658053726773,MATH 142A,A02,083220,Chow; Bennett,10,0,32,22
1658053726773,MATH 142A,A03,093480,Chow; Bennett,9,0,32,23
1658053726773,MATH 142A,B03,093481,Chow; Bennett,8,0,32,24
1658053726773,MATH 142A,B04,093558,Chow; Bennett,14,0,32,18
1658053726773,MATH 142A,B05,093559,Chow; Bennett,7,0,32,25
1658053732802,MATH 193A,A01,083224,Rotar; Vladimir,9,0,34,25
1658053732802,MATH 193A,A02,083225,Rotar; Vladimir,11,0,34,23
1658053732802,MATH 193A,A03,083781,Rotar; Vladimir,5,0,34,29
1658053732802,MATH 193A,A04,083782,Rotar; Vladimir,12,0,34,22
1658053732802,MATH 193A,A05,093482,Rotar; Vladimir,11,0,34,23
1658053738827,MATH 197,001,091859,McAuley; Julian John,9999,0,9999,0
1658053738827,MATH 197,002,095566,Kedlaya; Kiran S.,9997,0,9999,2
1658053738827,MATH 197,003,095567,Xiao; Ming,9999,0,9999,0
1658053738827,MATH 197,004,095571,Perols; Johan Lars,9998,0,9999,1
1658053745900,COGS 9,A01,083615,Shannon; Kyle Michael,11,0,75,64
1658053751928,COGS 11,A01,083617,Boyle; Mary E. T.,23,0,48,25
1658053757953,COGS 13,A01,083071,Bastos; Amalia Pinkusfeld,12,0,71,59
1658053763981,COGS 14A,A01,092681,Semenuks; Arturs,5,1,100,95
1658053770010,COGS 14B,A01,083073,Cheng; Tzu-Han,7,0,63,56
1658053776034,COGS 17,A01,092677,Semenuks; Arturs,7,0,81,74
1658053782063,COGS 100,A01,083619,Allen; Michael Gordon,17,0,70,53
1658053788092,COGS 101A,A01,083621,Davis; Joshua Daniel,9,0,68,59
1658053794119,COGS 101B,A01,091572,Allen; Michael Gordon,14,0,65,51
1658053800142,COGS 101C,A01,083625,Delgado; Tania,17,0,35,18
1658053806177,COGS 107A,A01,083627,Boyle; Mary E. T.,14,0,60,46
1658053812203,COGS 118A,A01,083075,Gupta; Anjum,21,0,76,55
1658053818233,CSE 3,A50,083646,Miranda; Gregory Joseph,24,0,50,26
1658053824256,CSE 8A,A50,083650,Miranda; Gregory Joseph,17,1,56,39
1658053830280,CSE 11,A01,083080,Cao; Yingjun,7,15,40,33
1658053836304,CSE 12,A01,083652,Krause-Levy; Sophia Louisa,30,1,120,90
1658053842327,CSE 15L,A01,083654,Morris; Justin Loren,9,0,50,41
1658053842327,CSE 15L,A02,083655,Morris; Justin Loren,11,0,50,39
1658053848350,CSE 20,A01,083657,Tran; Khoa Dang,39,0,80,41
1658053854376,CSE 21,A01,095574,Bach; Quang Tran,23,0,48,25
1658053860399,CSE 30,A01,083084,Eldon; John,8,0,80,72
1658053860399,CSE 30,B01,095061,Bhaskar; Nishant,9,0,50,41
1658053866423,CSE 100,A01,083659,Cao; Yingjun,5,4,70,65
1658053872448,CSE 134B,A01,083661,Powell; Thomas Allan,25,0,100,75
1658053878471,CSE 140,A01,083663,Gungor; Onat,17,0,85,68
1658053884502,CSE 140L,A01,083088,Eldon; John,23,0,100,77
1658053890530,CSE 175,A01,083665,Kumar; Rakesh,3,0,25,22
1658053896553,CSE 190,A00,092507,Dubnov; Shlomo,8,0,20,12
1658053902576,ECE 45,A01,083139,Congero; Spencer William,7,0,75,68
1658053908599,ECE 65,A50,083695,Saad; Andrew S,12,0,30,18
1658053908599,ECE 65,A51,095125,Saad; Andrew S,24,0,26,2
1658053914620,ECE 109,A01,091882,Touri; Behrouz,21,0,70,49
1658053920645,ECE 180,A00,083140,Abi Samra; Nicholas Camill,1,0,30,29
1658053920645,ECE 180,B00,083141,Abi Samra; Nicholas Camill,0,0,30,30
1658053926668,MATH 10A,A01,083735,Patchell; Gregory David,2,0,30,28
1658053926668,MATH 10A,A02,083736,Patchell; Gregory David,20,0,30,10
1658053926668,MATH 10A,A03,083737,Patchell; Gregory David,16,0,30,14
1658053932702,MATH 10B,A01,083207,Lim; Seonhee,9,0,34,25
1658053932702,MATH 10B,A02,083208,Lim; Seonhee,10,0,35,25
1658053932702,MATH 10B,A03,093472,Lim; Seonhee,7,0,34,27
1658053932702,MATH 10B,B01,083739,Sinha; Shubham,14,0,30,16
1658053938727,MATH 18,A01,083743,Cinel; Cameron Alexander,9,0,30,21
1658053938727,MATH 18,A02,083744,Cinel; Cameron Alexander,18,0,30,12
1658053938727,MATH 18,A03,083745,Cinel; Cameron Alexander,10,0,30,20
1658053938727,MATH 18,B01,083748,Rideout; David Porter,5,0,37,32
1658053938727,MATH 18,B02,083749,Rideout; David Porter,5,0,36,31
1658053938727,MATH 18,B03,083750,Rideout; David Porter,3,0,37,34
1658053938727,MATH 18,B04,083751,Rideout; David Porter,7,0,36,29
1658053938727,MATH 18,B05,093473,Rideout; David Porter,7,0,36,29
1658053938727,MATH 18,B06,093474,Rideout; David Porter,6,0,36,30
1658053944756,MATH 20A,A01,083754,Zheng; Zequn,14,0,40,26
1658053950780,MATH 20B,A01,083756,Briones; Jor-el Thomas Caparas,4,0,36,32
1658053950780,MATH 20B,A02,083757,Briones; Jor-el Thomas Caparas,1,0,36,35
1658053950780,MATH 20B,A03,093475,Briones; Jor-el Thomas Caparas,3,0,36,33
1658053956809,MATH 20C,A01,083760,Briones; Jor-el Thomas Caparas,1,0,35,34
1658053956809,MATH 20C,A02,083761,Briones; Jor-el Thomas Caparas,8,0,35,27
1658053956809,MATH 20C,A03,093476,Briones; Jor-el Thomas Caparas,0,1,36,36
1658053956809,MATH 20C,B01,083762,Bach; Quang Tran,1,0,30,29
1658053962835,MATH 20D,A01,083765,Tran; Brian Kha,5,0,30,25
1658053962835,MATH 20D,A02,083766,Tran; Brian Kha,5,0,30,25
1658053962835,MATH 20D,A03,083767,Tran; Brian Kha,6,0,30,24
1658053968869,MATH 20E,A01,083771,Ganguly; Soumya,12,0,32,20
1658053968869,MATH 20E,A02,083772,Ganguly; Soumya,7,0,32,25
1658053968869,MATH 20E,B01,083773,Ciotti; Benjamin,20,0,35,15
1658053968869,MATH 20E,B02,083774,Ciotti; Benjamin,18,0,35,17
1658053974892,MATH 103A,A01,083777,Greenfeld; Be'Eri,6,0,36,30
1658053974892,MATH 103A,A02,083778,Greenfeld; Be'Eri,5,0,36,31
1658053974892,MATH 103A,A03,093561,Greenfeld; Be'Eri,7,0,36,29
1658053974892,MATH 103A,B01,083779,Greenfeld; Be'Eri,8,0,36,28
1658053974892,MATH 103A,B02,083780,Greenfeld; Be'Eri,4,0,36,32
1658053974892,MATH 103A,B03,093562,Greenfeld; Be'Eri,3,0,36,33
1658053980916,MATH 105,A01,085443,Carter; Anne Toulson,15,0,35,20
1658053980916,MATH 105,A02,093477,Carter; Anne Toulson,20,0,35,15
1658053986949,MATH 109,A01,083213,Ganzberger; Geoffrey Michael,3,0,34,31
1658053986949,MATH 109,A02,083214,Ganzberger; Geoffrey Michael,4,0,34,30
1658053986949,MATH 109,A03,093478,Ganzberger; Geoffrey Michael,2,0,34,32
1658053986949,MATH 109,B01,083215,Ganzberger; Geoffrey Michael,3,0,32,29
1658053986949,MATH 109,B02,083216,Ganzberger; Geoffrey Michael,3,0,32,29
1658053986949,MATH 109,B03,093479,Ganzberger; Geoffrey Michael,8,0,32,24
1658053992974,MATH 142A,A01,083219,Chow; Bennett,7,0,32,25
1658053992974,MATH 142A,A02,083220,Chow; Bennett,10,0,32,22
1658053992974,MATH 142A,A03,093480,Chow; Bennett,9,0,32,23
1658053992974,MATH 142A,B03,093481,Chow; Bennett,8,0,32,24
1658053992974,MATH 142A,B04,093558,Chow; Bennett,14,0,32,18
1658053992974,MATH 142A,B05,093559,Chow; Bennett,7,0,32,25
1658053999000,MATH 193A,A01,083224,Rotar; Vladimir,9,0,34,25
1658053999000,MATH 193A,A02,083225,Rotar; Vladimir,11,0,34,23
1658053999000,MATH 193A,A03,083781,Rotar; Vladimir,5,0,34,29
1658053999000,MATH 193A,A04,083782,Rotar; Vladimir,12,0,34,22
1658053999000,MATH 193A,A05,093482,Rotar; Vladimir,11,0,34,23
1658054005023,MATH 197,001,091859,McAuley; Julian John,9999,0,9999,0
1658054005023,MATH 197,002,095566,Kedlaya; Kiran S.,9997,0,9999,2
1658054005023,MATH 197,003,095567,Xiao; Ming,9999,0,9999,0
1658054005023,MATH 197,004,095571,Perols; Johan Lars,9998,0,9999,1
1658054012090,COGS 9,A01,083615,Shannon; Kyle Michael,11,0,75,64
1658054018118,COGS 11,A01,083617,Boyle; Mary E. T.,23,0,48,25
1658054024141,COGS 13,A01,083071,Bastos; Amalia Pinkusfeld,12,0,71,59
1658054030174,COGS 14A,A01,092681,Semenuks; Arturs,5,1,100,95
1658054036197,COGS 14B,A01,083073,Cheng; Tzu-Han,7,0,63,56
1658054042225,COGS 17,A01,092677,Semenuks; Arturs,7,0,81,74
1658054048248,COGS 100,A01,083619,Allen; Michael Gordon,17,0,70,53
1658054054310,COGS 101A,A01,083621,Davis; Joshua Daniel,9,0,68,59
1658054060334,COGS 101B,A01,091572,Allen; Michael Gordon,14,0,65,51
1658054066360,COGS 101C,A01,083625,Delgado; Tania,17,0,35,18
1658054072385,COGS 107A,A01,083627,Boyle; Mary E. T.,14,0,60,46
1658054078411,COGS 118A,A01,083075,Gupta; Anjum,21,0,76,55
1658054084436,CSE 3,A50,083646,Miranda; Gregory Joseph,24,0,50,26
1658054090458,CSE 8A,A50,083650,Miranda; Gregory Joseph,17,1,56,39
1658054096481,CSE 11,A01,083080,Cao; Yingjun,7,15,40,33
1658054102504,CSE 12,A01,083652,Krause-Levy; Sophia Louisa,30,1,120,90
1658054108597,CSE 15L,A01,083654,Morris; Justin Loren,9,0,50,41
1658054108597,CSE 15L,A02,083655,Morris; Justin Loren,11,0,50,39
1658054114627,CSE 20,A01,083657,Tran; Khoa Dang,39,0,80,41
1658054120651,CSE 21,A01,095574,Bach; Quang Tran,23,0,48,25
1658054126675,CSE 30,A01,083084,Eldon; John,8,0,80,72
1658054126675,CSE 30,B01,095061,Bhaskar; Nishant,9,0,50,41
1658054132703,CSE 100,A01,083659,Cao; Yingjun,5,4,70,65
1658054138730,CSE 134B,A01,083661,Powell; Thomas Allan,25,0,100,75
1658054144753,CSE 140,A01,083663,Gungor; Onat,17,0,85,68
1658054150776,CSE 140L,A01,083088,Eldon; John,23,0,100,77
1658054156800,CSE 175,A01,083665,Kumar; Rakesh,3,0,25,22
1658054162824,CSE 190,A00,092507,Dubnov; Shlomo,8,0,20,12
1658054168853,ECE 45,A01,083139,Congero; Spencer William,7,0,75,68
1658054174889,ECE 65,A50,083695,Saad; Andrew S,12,0,30,18
1658054174889,ECE 65,A51,095125,Saad; Andrew S,24,0,26,2
1658054180913,ECE 109,A01,091882,Touri; Behrouz,21,0,70,49
1658054186940,ECE 180,A00,083140,Abi Samra; Nicholas Camill,1,0,30,29
1658054186940,ECE 180,B00,083141,Abi Samra; Nicholas Camill,0,0,30,30
1658054192973,MATH 10A,A01,083735,Patchell; Gregory David,2,0,30,28
1658054192973,MATH 10A,A02,083736,Patchell; Gregory David,20,0,30,10
1658054192973,MATH 10A,A03,083737,Patchell; Gregory David,16,0,30,14
1658054199001,MATH 10B,A01,083207,Lim; Seonhee,9,0,34,25
1658054199001,MATH 10B,A02,083208,Lim; Seonhee,10,0,35,25
1658054199001,MATH 10B,A03,093472,Lim; Seonhee,7,0,34,27
1658054199001,MATH 10B,B01,083739,Sinha; Shubham,14,0,30,16
1658054205029,MATH 18,A01,083743,Cinel; Cameron Alexander,9,0,30,21
1658054205029,MATH 18,A02,083744,Cinel; Cameron Alexander,18,0,30,12
1658054205029,MATH 18,A03,083745,Cinel; Cameron Alexander,10,0,30,20
1658054205029,MATH 18,B01,083748,Rideout; David Porter,5,0,37,32
1658054205029,MATH 18,B02,083749,Rideout; David Porter,5,0,36,31
1658054205029,MATH 18,B03,083750,Rideout; David Porter,3,0,37,34
1658054205029,MATH 18,B04,083751,Rideout; David Porter,7,0,36,29
1658054205029,MATH 18,B05,093473,Rideout; David Porter,7,0,36,29
1658054205029,MATH 18,B06,093474,Rideout; David Porter,6,0,36,30
1658054211054,MATH 20A,A01,083754,Zheng; Zequn,14,0,40,26
1658054217086,MATH 20B,A01,083756,Briones; Jor-el Thomas Caparas,4,0,36,32
1658054217086,MATH 20B,A02,083757,Briones; Jor-el Thomas Caparas,1,0,36,35
1658054217086,MATH 20B,A03,093475,Briones; Jor-el Thomas Caparas,3,0,36,33
1658054223111,MATH 20C,A01,083760,Briones; Jor-el Thomas Caparas,1,0,35,34
1658054223111,MATH 20C,A02,083761,Briones; Jor-el Thomas Caparas,8,0,35,27
1658054223111,MATH 20C,A03,093476,Briones; Jor-el Thomas Caparas,0,1,36,36
1658054223111,MATH 20C,B01,083762,Bach; Quang Tran,1,0,30,29
1658054229148,MATH 20D,A01,083765,Tran; Brian Kha,5,0,30,25
1658054229148,MATH 20D,A02,083766,Tran; Brian Kha,5,0,30,25
1658054229148,MATH 20D,A03,083767,Tran; Brian Kha,6,0,30,24
1658054235173,MATH 20E,A01,083771,Ganguly; Soumya,12,0,32,20
1658054235173,MATH 20E,A02,083772,Ganguly; Soumya,7,0,32,25
1658054235173,MATH 20E,B01,083773,Ciotti; Benjamin,20,0,35,15
1658054235173,MATH 20E,B02,083774,Ciotti; Benjamin,18,0,35,17
1658054241200,MATH 103A,A01,083777,Greenfeld; Be'Eri,6,0,36,30
1658054241200,MATH 103A,A02,083778,Greenfeld; Be'Eri,5,0,36,31
1658054241200,MATH 103A,A03,093561,Greenfeld; Be'Eri,7,0,36,29
1658054241200,MATH 103A,B01,083779,Greenfeld; Be'Eri,8,0,36,28
1658054241200,MATH 103A,B02,083780,Greenfeld; Be'Eri,4,0,36,32
1658054241200,MATH 103A,B03,093562,Greenfeld; Be'Eri,3,0,36,33
1658054247224,MATH 105,A01,085443,Carter; Anne Toulson,15,0,35,20
1658054247224,MATH 105,A02,093477,Carter; Anne Toulson,20,0,35,15
1658054253248,MATH 109,A01,083213,Ganzberger; Geoffrey Michael,3,0,34,31
1658054253248,MATH 109,A02,083214,Ganzberger; Geoffrey Michael,4,0,34,30
1658054253248,MATH 109,A03,093478,Ganzberger; Geoffrey Michael,2,0,34,32
1658054253248,MATH 109,B01,083215,Ganzberger; Geoffrey Michael,3,0,32,29
1658054253248,MATH 109,B02,083216,Ganzberger; Geoffrey Michael,3,0,32,29
1658054253248,MATH 109,B03,093479,Ganzberger; Geoffrey Michael,8,0,32,24
1658054259294,MATH 142A,A01,083219,Chow; Bennett,7,0,32,25
1658054259294,MATH 142A,A02,083220,Chow; Bennett,10,0,32,22
1658054259294,MATH 142A,A03,093480,Chow; Bennett,9,0,32,23
1658054259294,MATH 142A,B03,093481,Chow; Bennett,8,0,32,24
1658054259294,MATH 142A,B04,093558,Chow; Bennett,14,0,32,18
1658054259294,MATH 142A,B05,093559,Chow; Bennett,7,0,32,25
1658054265323,MATH 193A,A01,083224,Rotar; Vladimir,9,0,34,25
1658054265323,MATH 193A,A02,083225,Rotar; Vladimir,11,0,34,23
1658054265323,MATH 193A,A03,083781,Rotar; Vladimir,5,0,34,29
1658054265323,MATH 193A,A04,083782,Rotar; Vladimir,12,0,34,22
1658054265323,MATH 193A,A05,093482,Rotar; Vladimir,11,0,34,23
1658054271348,MATH 197,001,091859,McAuley; Julian John,9999,0,9999,0
1658054271348,MATH 197,002,095566,Kedlaya; Kiran S.,9997,0,9999,2
1658054271348,MATH 197,003,095567,Xiao; Ming,9999,0,9999,0
1658054271348,MATH 197,004,095571,Perols; Johan Lars,9998,0,9999,1
1658054278417,COGS 9,A01,083615,Shannon; Kyle Michael,11,0,75,64
1658054284446,COGS 11,A01,083617,Boyle; Mary E. T.,23,0,48,25
1658054290471,COGS 13,A01,083071,Bastos; Amalia Pinkusfeld,12,0,71,59
1658054296496,COGS 14A,A01,092681,Semenuks; Arturs,5,1,100,95
1658054302520,COGS 14B,A01,083073,Cheng; Tzu-Han,7,0,63,56
1658054308548,COGS 17,A01,092677,Semenuks; Arturs,7,0,81,74
1658054314572,COGS 100,A01,083619,Allen; Michael Gordon,17,0,70,53
1658054320596,COGS 101A,A01,083621,Davis; Joshua Daniel,9,0,68,59
1658054326624,COGS 101B,A01,091572,Allen; Michael Gordon,14,0,65,51
1658054332658,COGS 101C,A01,083625,Delgado; Tania,17,0,35,18
1658054338684,COGS 107A,A01,083627,Boyle; Mary E. T.,14,0,60,46
1658054344706,COGS 118A,A01,083075,Gupta; Anjum,21,0,76,55
1658054350731,CSE 3,A50,083646,Miranda; Gregory Joseph,24,0,50,26
1658054356759,CSE 8A,A50,083650,Miranda; Gregory Joseph,17,1,56,39
1658054362787,CSE 11,A01,083080,Cao; Yingjun,7,15,40,33
1658054368815,CSE 12,A01,083652,Krause-Levy; Sophia Louisa,30,1,120,90
1658054374842,CSE 15L,A01,083654,Morris; Justin Loren,9,0,50,41
1658054374842,CSE 15L,A02,083655,Morris; Justin Loren,11,0,50,39
1658054380871,CSE 20,A01,083657,Tran; Khoa Dang,39,0,80,41
1658054386905,CSE 21,A01,095574,Bach; Quang Tran,23,0,48,25
1658054392937,CSE 30,A01,083084,Eldon; John,8,0,80,72
1658054392937,CSE 30,B01,095061,Bhaskar; Nishant,9,0,50,41
1658054398971,CSE 100,A01,083659,Cao; Yingjun,5,4,70,65
1658054404999,CSE 134B,A01,083661,Powell; Thomas Allan,25,0,100,75
1658054411024,CSE 140,A01,083663,Gungor; Onat,17,0,85,68
1658054417046,CSE 140L,A01,083088,Eldon; John,23,0,100,77
1658054423074,CSE 175,A01,083665,Kumar; Rakesh,3,0,25,22
1658054429103,CSE 190,A00,092507,Dubnov; Shlomo,8,0,20,12
1658054435128,ECE 45,A01,083139,Congero; Spencer William,7,0,75,68
1658054441158,ECE 65,A50,083695,Saad; Andrew S,12,0,30,18
1658054441158,ECE 65,A51,095125,Saad; Andrew S,24,0,26,2
1658054447182,ECE 109,A01,091882,Touri; Behrouz,21,0,70,49
1658054453209,ECE 180,A00,083140,Abi Samra; Nicholas Camill,1,0,30,29
1658054453209,ECE 180,B00,083141,Abi Samra; Nicholas Camill,0,0,30,30
1658054459241,MATH 10A,A01,083735,Patchell; Gregory David,2,0,30,28
1658054459241,MATH 10A,A02,083736,Patchell; Gregory David,20,0,30,10
1658054459241,MATH 10A,A03,083737,Patchell; Gregory David,16,0,30,14
1658054465271,MATH 10B,A01,083207,Lim; Seonhee,9,0,34,25
1658054465271,MATH 10B,A02,083208,Lim; Seonhee,10,0,35,25
1658054465271,MATH 10B,A03,093472,Lim; Seonhee,7,0,34,27
1658054465271,MATH 10B,B01,083739,Sinha; Shubham,14,0,30,16
1658054471307,MATH 18,A01,083743,Cinel; Cameron Alexander,9,0,30,21
1658054471307,MATH 18,A02,083744,Cinel; Cameron Alexander,18,0,30,12
1658054471307,MATH 18,A03,083745,Cinel; Cameron Alexander,10,0,30,20
1658054471307,MATH 18,B01,083748,Rideout; David Porter,5,0,37,32
1658054471307,MATH 18,B02,083749,Rideout; David Porter,5,0,36,31
1658054471307,MATH 18,B03,083750,Rideout; David Porter,3,0,37,34
1658054471307,MATH 18,B04,083751,Rideout; David Porter,7,0,36,29
1658054471307,MATH 18,B05,093473,Rideout; David Porter,7,0,36,29
1658054471307,MATH 18,B06,093474,Rideout; David Porter,6,0,36,30
1658054477333,MATH 20A,A01,083754,Zheng; Zequn,14,0,40,26
1658054483365,MATH 20B,A01,083756,Briones; Jor-el Thomas Caparas,4,0,36,32
1658054483365,MATH 20B,A02,083757,Briones; Jor-el Thomas Caparas,1,0,36,35
1658054483365,MATH 20B,A03,093475,Briones; Jor-el Thomas Caparas,3,0,36,33
1658054489404,MATH 20C,A01,083760,Briones; Jor-el Thomas Caparas,1,0,35,34
1658054489404,MATH 20C,A02,083761,Briones; Jor-el Thomas Caparas,8,0,35,27
1658054489404,MATH 20C,A03,093476,Briones; Jor-el Thomas Caparas,0,1,36,36
1658054489404,MATH 20C,B01,083762,Bach; Quang Tran,1,0,30,29
1658054495434,MATH 20D,A01,083765,Tran; Brian Kha,5,0,30,25
1658054495434,MATH 20D,A02,083766,Tran; Brian Kha,5,0,30,25
1658054495434,MATH 20D,A03,083767,Tran; Brian Kha,6,0,30,24
1658054501466,MATH 20E,A01,083771,Ganguly; Soumya,12,0,32,20
1658054501466,MATH 20E,A02,083772,Ganguly; Soumya,7,0,32,25
1658054501466,MATH 20E,B01,083773,Ciotti; Benjamin,20,0,35,15
1658054501466,MATH 20E,B02,083774,Ciotti; Benjamin,18,0,35,17
1658054507501,MATH 103A,A01,083777,Greenfeld; Be'Eri,6,0,36,30
1658054507501,MATH 103A,A02,083778,Greenfeld; Be'Eri,5,0,36,31
1658054507501,MATH 103A,A03,093561,Greenfeld; Be'Eri,7,0,36,29
1658054507501,MATH 103A,B01,083779,Greenfeld; Be'Eri,8,0,36,28
1658054507501,MATH 103A,B02,083780,Greenfeld; Be'Eri,4,0,36,32
1658054507501,MATH 103A,B03,093562,Greenfeld; Be'Eri,3,0,36,33
1658054513525,MATH 105,A01,085443,Carter; Anne Toulson,15,0,35,20
1658054513525,MATH 105,A02,093477,Carter; Anne Toulson,20,0,35,15
1658054519552,MATH 109,A01,083213,Ganzberger; Geoffrey Michael,3,0,34,31
1658054519552,MATH 109,A02,083214,Ganzberger; Geoffrey Michael,4,0,34,30
1658054519552,MATH 109,A03,093478,Ganzberger; Geoffrey Michael,2,0,34,32
1658054519552,MATH 109,B01,083215,Ganzberger; Geoffrey Michael,3,0,32,29
1658054519552,MATH 109,B02,083216,Ganzberger; Geoffrey Michael,3,0,32,29
1658054519552,MATH 109,B03,093479,Ganzberger; Geoffrey Michael,8,0,32,24
1658054525579,MATH 142A,A01,083219,Chow; Bennett,7,0,32,25
1658054525579,MATH 142A,A02,083220,Chow; Bennett,10,0,32,22
1658054525579,MATH 142A,A03,093480,Chow; Bennett,9,0,32,23
1658054525579,MATH 142A,B03,093481,Chow; Bennett,8,0,32,24
1658054525579,MATH 142A,B04,093558,Chow; Bennett,14,0,32,18
1658054525579,MATH 142A,B05,093559,Chow; Bennett,7,0,32,25
1658054531607,MATH 193A,A01,083224,Rotar; Vladimir,9,0,34,25
1658054531607,MATH 193A,A02,083225,Rotar; Vladimir,11,0,34,23
1658054531607,MATH 193A,A03,083781,Rotar; Vladimir,5,0,34,29
1658054531607,MATH 193A,A04,083782,Rotar; Vladimir,12,0,34,22
1658054531607,MATH 193A,A05,093482,Rotar; Vladimir,11,0,34,23
1658054537641,MATH 197,001,091859,McAuley; Julian John,9999,0,9999,0
1658054537641,MATH 197,002,095566,Kedlaya; Kiran S.,9997,0,9999,2
1658054537641,MATH 197,003,095567,Xiao; Ming,9999,0,9999,0
1658054537641,MATH 197,004,095571,Perols; Johan Lars,9998,0,9999,1
1658054544707,COGS 9,A01,083615,Shannon; Kyle Michael,11,0,75,64
1658054550735,COGS 11,A01,083617,Boyle; Mary E. T.,23,0,48,25
1658054556760,COGS 13,A01,083071,Bastos; Amalia Pinkusfeld,12,0,71,59
1658054562785,COGS 14A,A01,092681,Semenuks; Arturs,5,1,100,95
1658054568815,COGS 14B,A01,083073,Cheng; Tzu-Han,7,0,63,56
1658054574842,COGS 17,A01,092677,Semenuks; Arturs,7,0,81,74
1658054580871,COGS 100,A01,083619,Allen; Michael Gordon,17,0,70,53
1658054586895,COGS 101A,A01,083621,Davis; Joshua Daniel,9,0,68,59
1658054592919,COGS 101B,A01,091572,Allen; Michael Gordon,14,0,65,51
1658054598944,COGS 101C,A01,083625,Delgado; Tania,17,0,35,18
1658054604969,COGS 107A,A01,083627,Boyle; Mary E. T.,14,0,60,46
1658054610994,COGS 118A,A01,083075,Gupta; Anjum,21,0,76,55
1658054617021,CSE 3,A50,083646,Miranda; Gregory Joseph,24,0,50,26
1658054623049,CSE 8A,A50,083650,Miranda; Gregory Joseph,17,1,56,39
1658054629078,CSE 11,A01,083080,Cao; Yingjun,7,15,40,33
1658054635102,CSE 12,A01,083652,Krause-Levy; Sophia Louisa,30,1,120,90
1658054641128,CSE 15L,A01,083654,Morris; Justin Loren,9,0,50,41
1658054641128,CSE 15L,A02,083655,Morris; Justin Loren,11,0,50,39
1658054647158,CSE 20,A01,083657,Tran; Khoa Dang,39,0,80,41
1658054653183,CSE 21,A01,095574,Bach; Quang Tran,23,0,48,25
1658054659209,CSE 30,A01,083084,Eldon; John,8,0,80,72
1658054659209,CSE 30,B01,095061,Bhaskar; Nishant,9,0,50,41
1658054665234,CSE 100,A01,083659,Cao; Yingjun,5,4,70,65
1658054671257,CSE 134B,A01,083661,Powell; Thomas Allan,25,0,100,75
1658054677283,CSE 140,A01,083663,Gungor; Onat,17,0,85,68
1658054683307,CSE 140L,A01,083088,Eldon; John,23,0,100,77
1658054689336,CSE 175,A01,083665,Kumar; Rakesh,3,0,25,22
1658054695364,CSE 190,A00,092507,Dubnov; Shlomo,8,0,20,12
1658054701390,ECE 45,A01,083139,Congero; Spencer William,7,0,75,68
1658054707493,ECE 65,A50,083695,Saad; Andrew S,12,0,30,18
1658054707493,ECE 65,A51,095125,Saad; Andrew S,24,0,26,2
1658054713517,ECE 109,A01,091882,Touri; Behrouz,21,0,70,49
1658054719545,ECE 180,A00,083140,Abi Samra; Nicholas Camill,1,0,30,29
1658054719545,ECE 180,B00,083141,Abi Samra; Nicholas Camill,0,0,30,30
1658054725576,MATH 10A,A01,083735,Patchell; Gregory David,2,0,30,28
1658054725576,MATH 10A,A02,083736,Patchell; Gregory David,20,0,30,10
1658054725576,MATH 10A,A03,083737,Patchell; Gregory David,16,0,30,14
1658054731611,MATH 10B,A01,083207,Lim; Seonhee,9,0,34,25
1658054731611,MATH 10B,A02,083208,Lim; Seonhee,10,0,35,25
1658054731611,MATH 10B,A03,093472,Lim; Seonhee,7,0,34,27
1658054731611,MATH 10B,B01,083739,Sinha; Shubham,14,0,30,16
1658054737642,MATH 18,A01,083743,Cinel; Cameron Alexander,9,0,30,21
1658054737642,MATH 18,A02,083744,Cinel; Cameron Alexander,18,0,30,12
1658054737642,MATH 18,A03,083745,Cinel; Cameron Alexander,10,0,30,20
1658054737642,MATH 18,B01,083748,Rideout; David Porter,5,0,37,32
1658054737642,MATH 18,B02,083749,Rideout; David Porter,5,0,36,31
1658054737642,MATH 18,B03,083750,Rideout; David Porter,3,0,37,34
1658054737642,MATH 18,B04,083751,Rideout; David Porter,7,0,36,29
1658054737642,MATH 18,B05,093473,Rideout; David Porter,7,0,36,29
1658054737642,MATH 18,B06,093474,Rideout; David Porter,6,0,36,30
1658054743670,MATH 20A,A01,083754,Zheng; Zequn,14,0,40,26
1658054749700,MATH 20B,A01,083756,Briones; Jor-el Thomas Caparas,4,0,36,32
1658054749700,MATH 20B,A02,083757,Briones; Jor-el Thomas Caparas,1,0,36,35
1658054749700,MATH 20B,A03,093475,Briones; Jor-el Thomas Caparas,3,0,36,33
1658054755729,MATH 20C,A01,083760,Briones; Jor-el Thomas Caparas,1,0,35,34
1658054755729,MATH 20C,A02,083761,Briones; Jor-el Thomas Caparas,8,0,35,27
1658054755729,MATH 20C,A03,093476,Briones; Jor-el Thomas Caparas,0,1,36,36
1658054755729,MATH 20C,B01,083762,Bach; Quang Tran,1,0,30,29
1658054761756,MATH 20D,A01,083765,Tran; Brian Kha,5,0,30,25
1658054761756,MATH 20D,A02,083766,Tran; Brian Kha,5,0,30,25
1658054761756,MATH 20D,A03,083767,Tran; Brian Kha,6,0,30,24
1658054767787,MATH 20E,A01,083771,Ganguly; Soumya,12,0,32,20
1658054767787,MATH 20E,A02,083772,Ganguly; Soumya,7,0,32,25
1658054767787,MATH 20E,B01,083773,Ciotti; Benjamin,20,0,35,15
1658054767787,MATH 20E,B02,083774,Ciotti; Benjamin,18,0,35,17
1658054773813,MATH 103A,A01,083777,Greenfeld; Be'Eri,6,0,36,30
1658054773813,MATH 103A,A02,083778,Greenfeld; Be'Eri,5,0,36,31
1658054773813,MATH 103A,A03,093561,Greenfeld; Be'Eri,7,0,36,29
1658054773813,MATH 103A,B01,083779,Greenfeld; Be'Eri,8,0,36,28
1658054773813,MATH 103A,B02,083780,Greenfeld; Be'Eri,4,0,36,32
1658054773813,MATH 103A,B03,093562,Greenfeld; Be'Eri,3,0,36,33
1658054779838,MATH 105,A01,085443,Carter; Anne Toulson,15,0,35,20
1658054779838,MATH 105,A02,093477,Carter; Anne Toulson,20,0,35,15
1658054785869,MATH 109,A01,083213,Ganzberger; Geoffrey Michael,3,0,34,31
1658054785869,MATH 109,A02,083214,Ganzberger; Geoffrey Michael,4,0,34,30
1658054785869,MATH 109,A03,093478,Ganzberger; Geoffrey Michael,2,0,34,32
1658054785869,MATH 109,B01,083215,Ganzberger; Geoffrey Michael,3,0,32,29
1658054785869,MATH 109,B02,083216,Ganzberger; Geoffrey Michael,3,0,32,29
1658054785869,MATH 109,B03,093479,Ganzberger; Geoffrey Michael,8,0,32,24
1658054791894,MATH 142A,A01,083219,Chow; Bennett,7,0,32,25
1658054791894,MATH 142A,A02,083220,Chow; Bennett,10,0,32,22
1658054791894,MATH 142A,A03,093480,Chow; Bennett,9,0,32,23
1658054791894,MATH 142A,B03,093481,Chow; Bennett,8,0,32,24
1658054791894,MATH 142A,B04,093558,Chow; Bennett,14,0,32,18
1658054791894,MATH 142A,B05,093559,Chow; Bennett,7,0,32,25
1658054797920,MATH 193A,A01,083224,Rotar; Vladimir,9,0,34,25
1658054797920,MATH 193A,A02,083225,Rotar; Vladimir,11,0,34,23
1658054797920,MATH 193A,A03,083781,Rotar; Vladimir,5,0,34,29
1658054797920,MATH 193A,A04,083782,Rotar; Vladimir,12,0,34,22
1658054797920,MATH 193A,A05,093482,Rotar; Vladimir,11,0,34,23
1658054803944,MATH 197,001,091859,McAuley; Julian John,9999,0,9999,0
1658054803944,MATH 197,002,095566,Kedlaya; Kiran S.,9997,0,9999,2
1658054803944,MATH 197,003,095567,Xiao; Ming,9999,0,9999,0
1658054803944,MATH 197,004,095571,Perols; Johan Lars,9998,0,9999,1
1658054811013,COGS 9,A01,083615,Shannon; Kyle Michael,11,0,75,64
1658054817043,COGS 11,A01,083617,Boyle; Mary E. T.,23,0,48,25
1658054823067,COGS 13,A01,083071,Bastos; Amalia Pinkusfeld,12,0,71,59
1658054829097,COGS 14A,A01,092681,Semenuks; Arturs,5,1,100,95
1658054835121,COGS 14B,A01,083073,Cheng; Tzu-Han,7,0,63,56
1658054841144,COGS 17,A01,092677,Semenuks; Arturs,7,0,81,74
1658054847172,COGS 100,A01,083619,Allen; Michael Gordon,17,0,70,53
1658054853197,COGS 101A,A01,083621,Davis; Joshua Daniel,9,0,68,59
1658054859224,COGS 101B,A01,091572,Allen; Michael Gordon,14,0,65,51
1658054865252,COGS 101C,A01,083625,Delgado; Tania,17,0,35,18
1658054871279,COGS 107A,A01,083627,Boyle; Mary E. T.,14,0,60,46
1658054877303,COGS 118A,A01,083075,Gupta; Anjum,21,0,76,55
1658054883328,CSE 3,A50,083646,Miranda; Gregory Joseph,24,0,50,26
1658054889358,CSE 8A,A50,083650,Miranda; Gregory Joseph,17,1,56,39
1658054895386,CSE 11,A01,083080,Cao; Yingjun,7,15,40,33
1658054901413,CSE 12,A01,083652,Krause-Levy; Sophia Louisa,30,1,120,90
1658054907444,CSE 15L,A01,083654,Morris; Justin Loren,9,0,50,41
1658054907444,CSE 15L,A02,083655,Morris; Justin Loren,11,0,50,39
1658054913467,CSE 20,A01,083657,Tran; Khoa Dang,39,0,80,41
1658054919496,CSE 21,A01,095574,Bach; Quang Tran,23,0,48,25
1658054925527,CSE 30,A01,083084,Eldon; John,8,0,80,72
1658054925527,CSE 30,B01,095061,Bhaskar; Nishant,9,0,50,41
1658054931554,CSE 100,A01,083659,Cao; Yingjun,5,4,70,65
1658054937581,CSE 134B,A01,083661,Powell; Thomas Allan,25,0,100,75
1658054943608,CSE 140,A01,083663,Gungor; Onat,17,0,85,68
1658054949635,CSE 140L,A01,083088,Eldon; John,23,0,100,77
1658054955658,CSE 175,A01,083665,Kumar; Rakesh,3,0,25,22
1658054961685,CSE 190,A00,092507,Dubnov; Shlomo,8,0,20,12
1658054967710,ECE 45,A01,083139,Congero; Spencer William,7,0,75,68
1658054973744,ECE 65,A50,083695,Saad; Andrew S,12,0,30,18
1658054973744,ECE 65,A51,095125,Saad; Andrew S,24,0,26,2
1658054979770,ECE 109,A01,091882,Touri; Behrouz,21,0,70,49
1658054985795,ECE 180,A00,083140,Abi Samra; Nicholas Camill,1,0,30,29
1658054985795,ECE 180,B00,083141,Abi Samra; Nicholas Camill,0,0,30,30
1658054991820,MATH 10A,A01,083735,Patchell; Gregory David,2,0,30,28
1658054991820,MATH 10A,A02,083736,Patchell; Gregory David,20,0,30,10
1658054991820,MATH 10A,A03,083737,Patchell; Gregory David,16,0,30,14
1658054997856,MATH 10B,A01,083207,Lim; Seonhee,9,0,34,25
1658054997856,MATH 10B,A02,083208,Lim; Seonhee,10,0,35,25
1658054997856,MATH 10B,A03,093472,Lim; Seonhee,7,0,34,27
1658054997856,MATH 10B,B01,083739,Sinha; Shubham,14,0,30,16
1658055003892,MATH 18,A01,083743,Cinel; Cameron Alexander,9,0,30,21
1658055003892,MATH 18,A02,083744,Cinel; Cameron Alexander,18,0,30,12
1658055003892,MATH 18,A03,083745,Cinel; Cameron Alexander,10,0,30,20
1658055003892,MATH 18,B01,083748,Rideout; David Porter,5,0,37,32
1658055003892,MATH 18,B02,083749,Rideout; David Porter,5,0,36,31
1658055003892,MATH 18,B03,083750,Rideout; David Porter,3,0,37,34
1658055003892,MATH 18,B04,083751,Rideout; David Porter,7,0,36,29
1658055003892,MATH 18,B05,093473,Rideout; David Porter,7,0,36,29
1658055003892,MATH 18,B06,093474,Rideout; David Porter,6,0,36,30
1658055009916,MATH 20A,A01,083754,Zheng; Zequn,14,0,40,26
1658055015949,MATH 20B,A01,083756,Briones; Jor-el Thomas Caparas,4,0,36,32
1658055015949,MATH 20B,A02,083757,Briones; Jor-el Thomas Caparas,1,0,36,35
1658055015949,MATH 20B,A03,093475,Briones; Jor-el Thomas Caparas,3,0,36,33
1658055021981,MATH 20C,A01,083760,Briones; Jor-el Thomas Caparas,1,0,35,34
1658055021981,MATH 20C,A02,083761,Briones; Jor-el Thomas Caparas,8,0,35,27
1658055021981,MATH 20C,A03,093476,Briones; Jor-el Thomas Caparas,0,1,36,36
1658055021981,MATH 20C,B01,083762,Bach; Quang Tran,1,0,30,29
1658055028005,MATH 20D,A01,083765,Tran; Brian Kha,5,0,30,25
1658055028005,MATH 20D,A02,083766,Tran; Brian Kha,5,0,30,25
1658055028005,MATH 20D,A03,083767,Tran; Brian Kha,6,0,30,24
1658055034032,MATH 20E,A01,083771,Ganguly; Soumya,12,0,32,20
1658055034032,MATH 20E,A02,083772,Ganguly; Soumya,7,0,32,25
1658055034032,MATH 20E,B01,083773,Ciotti; Benjamin,20,0,35,15
1658055034032,MATH 20E,B02,083774,Ciotti; Benjamin,18,0,35,17
1658055040066,MATH 103A,A01,083777,Greenfeld; Be'Eri,6,0,36,30
1658055040066,MATH 103A,A02,083778,Greenfeld; Be'Eri,5,0,36,31
1658055040066,MATH 103A,A03,093561,Greenfeld; Be'Eri,7,0,36,29
1658055040066,MATH 103A,B01,083779,Greenfeld; Be'Eri,8,0,36,28
1658055040066,MATH 103A,B02,083780,Greenfeld; Be'Eri,4,0,36,32
1658055040066,MATH 103A,B03,093562,Greenfeld; Be'Eri,3,0,36,33
1658055046097,MATH 105,A01,085443,Carter; Anne Toulson,15,0,35,20
1658055046097,MATH 105,A02,093477,Carter; Anne Toulson,20,0,35,15
1658055052123,MATH 109,A01,083213,Ganzberger; Geoffrey Michael,3,0,34,31
1658055052123,MATH 109,A02,083214,Ganzberger; Geoffrey Michael,4,0,34,30
1658055052123,MATH 109,A03,093478,Ganzberger; Geoffrey Michael,2,0,34,32
1658055052123,MATH 109,B01,083215,Ganzberger; Geoffrey Michael,3,0,32,29
1658055052123,MATH 109,B02,083216,Ganzberger; Geoffrey Michael,3,0,32,29
1658055052123,MATH 109,B03,093479,Ganzberger; Geoffrey Michael,8,0,32,24
1658055058155,MATH 142A,A01,083219,Chow; Bennett,7,0,32,25
1658055058155,MATH 142A,A02,083220,Chow; Bennett,10,0,32,22
1658055058155,MATH 142A,A03,093480,Chow; Bennett,9,0,32,23
1658055058155,MATH 142A,B03,093481,Chow; Bennett,8,0,32,24
1658055058155,MATH 142A,B04,093558,Chow; Bennett,14,0,32,18
1658055058155,MATH 142A,B05,093559,Chow; Bennett,7,0,32,25
1658055064180,MATH 193A,A01,083224,Rotar; Vladimir,9,0,34,25
1658055064180,MATH 193A,A02,083225,Rotar; Vladimir,11,0,34,23
1658055064180,MATH 193A,A03,083781,Rotar; Vladimir,5,0,34,29
1658055064180,MATH 193A,A04,083782,Rotar; Vladimir,12,0,34,22
1658055064180,MATH 193A,A05,093482,Rotar; Vladimir,11,0,34,23
1658055070205,MATH 197,001,091859,McAuley; Julian John,9999,0,9999,0
1658055070205,MATH 197,002,095566,Kedlaya; Kiran S.,9997,0,9999,2
1658055070205,MATH 197,003,095567,Xiao; Ming,9999,0,9999,0
1658055070205,MATH 197,004,095571,Perols; Johan Lars,9998,0,9999,1
1658055077282,COGS 9,A01,083615,Shannon; Kyle Michael,11,0,75,64
1658055083308,COGS 11,A01,083617,Boyle; Mary E. T.,23,0,48,25
1658055089332,COGS 13,A01,083071,Bastos; Amalia Pinkusfeld,12,0,71,59
1658055095357,COGS 14A,A01,092681,Semenuks; Arturs,5,1,100,95
1658055101381,COGS 14B,A01,083073,Cheng; Tzu-Han,7,0,63,56
1658055107408,COGS 17,A01,092677,Semenuks; Arturs,7,0,81,74
1658055113432,COGS 100,A01,083619,Allen; Michael Gordon,17,0,70,53
1658055119463,COGS 101A,A01,083621,Davis; Joshua Daniel,9,0,68,59
1658055125488,COGS 101B,A01,091572,Allen; Michael Gordon,14,0,65,51
1658055131513,COGS 101C,A01,083625,Delgado; Tania,17,0,35,18
1658055137535,COGS 107A,A01,083627,Boyle; Mary E. T.,14,0,60,46
1658055143563,COGS 118A,A01,083075,Gupta; Anjum,21,0,76,55
1658055149589,CSE 3,A50,083646,Miranda; Gregory Joseph,24,0,50,26
1658055155614,CSE 8A,A50,083650,Miranda; Gregory Joseph,17,1,56,39
1658055161644,CSE 11,A01,083080,Cao; Yingjun,7,15,40,33
1658055167673,CSE 12,A01,083652,Krause-Levy; Sophia Louisa,30,1,120,90
1658055173701,CSE 15L,A01,083654,Morris; Justin Loren,9,0,50,41
1658055173701,CSE 15L,A02,083655,Morris; Justin Loren,11,0,50,39
1658055179724,CSE 20,A01,083657,Tran; Khoa Dang,39,0,80,41
1658055185747,CSE 21,A01,095574,Bach; Quang Tran,23,0,48,25
1658055191787,CSE 30,A01,083084,Eldon; John,8,0,80,72
1658055191787,CSE 30,B01,095061,Bhaskar; Nishant,9,0,50,41
1658055197817,CSE 100,A01,083659,Cao; Yingjun,5,4,70,65
1658055203845,CSE 134B,A01,083661,Powell; Thomas Allan,25,0,100,75
1658055209870,CSE 140,A01,083663,Gungor; Onat,17,0,85,68
1658055215893,CSE 140L,A01,083088,Eldon; John,23,0,100,77
1658055221925,CSE 175,A01,083665,Kumar; Rakesh,3,0,25,22
1658055227963,CSE 190,A00,092507,Dubnov; Shlomo,8,0,20,12
1658055233988,ECE 45,A01,083139,Congero; Spencer William,7,0,75,68
1658055240014,ECE 65,A50,083695,Saad; Andrew S,12,0,30,18
1658055240014,ECE 65,A51,095125,Saad; Andrew S,24,0,26,2
1658055246051,ECE 109,A01,091882,Touri; Behrouz,21,0,70,49
1658055252076,ECE 180,A00,083140,Abi Samra; Nicholas Camill,1,0,30,29
1658055252076,ECE 180,B00,083141,Abi Samra; Nicholas Camill,0,0,30,30
1658055258110,MATH 10A,A01,083735,Patchell; Gregory David,2,0,30,28
1658055258110,MATH 10A,A02,083736,Patchell; Gregory David,20,0,30,10
1658055258110,MATH 10A,A03,083737,Patchell; Gregory David,16,0,30,14
1658055264157,MATH 10B,A01,083207,Lim; Seonhee,9,0,34,25
1658055264157,MATH 10B,A02,083208,Lim; Seonhee,10,0,35,25
1658055264157,MATH 10B,A03,093472,Lim; Seonhee,7,0,34,27
1658055264157,MATH 10B,B01,083739,Sinha; Shubham,14,0,30,16
1658055270184,MATH 18,A01,083743,Cinel; Cameron Alexander,9,0,30,21
1658055270184,MATH 18,A02,083744,Cinel; Cameron Alexander,18,0,30,12
1658055270184,MATH 18,A03,083745,Cinel; Cameron Alexander,10,0,30,20
1658055270184,MATH 18,B01,083748,Rideout; David Porter,5,0,37,32
1658055270184,MATH 18,B02,083749,Rideout; David Porter,5,0,36,31
1658055270184,MATH 18,B03,083750,Rideout; David Porter,3,0,37,34
1658055270184,MATH 18,B04,083751,Rideout; David Porter,7,0,36,29
1658055270184,MATH 18,B05,093473,Rideout; David Porter,7,0,36,29
1658055270184,MATH 18,B06,093474,Rideout; David Porter,6,0,36,30
1658055276209,MATH 20A,A01,083754,Zheng; Zequn,14,0,40,26
1658055282248,MATH 20B,A01,083756,Briones; Jor-el Thomas Caparas,4,0,36,32
1658055282248,MATH 20B,A02,083757,Briones; Jor-el Thomas Caparas,1,0,36,35
1658055282248,MATH 20B,A03,093475,Briones; Jor-el Thomas Caparas,3,0,36,33
1658055288273,MATH 20C,A01,083760,Briones; Jor-el Thomas Caparas,1,0,35,34
1658055288273,MATH 20C,A02,083761,Briones; Jor-el Thomas Caparas,8,0,35,27
1658055288273,MATH 20C,A03,093476,Briones; Jor-el Thomas Caparas,0,1,36,36
1658055288273,MATH 20C,B01,083762,Bach; Quang Tran,1,0,30,29
1658055294297,MATH 20D,A01,083765,Tran; Brian Kha,5,0,30,25
1658055294297,MATH 20D,A02,083766,Tran; Brian Kha,5,0,30,25
1658055294297,MATH 20D,A03,083767,Tran; Brian Kha,6,0,30,24
1658055300330,MATH 20E,A01,083771,Ganguly; Soumya,12,0,32,20
1658055300330,MATH 20E,A02,083772,Ganguly; Soumya,7,0,32,25
1658055300330,MATH 20E,B01,083773,Ciotti; Benjamin,20,0,35,15
1658055300330,MATH 20E,B02,083774,Ciotti; Benjamin,18,0,35,17
1658055306437,MATH 103A,A01,083777,Greenfeld; Be'Eri,6,0,36,30
1658055306437,MATH 103A,A02,083778,Greenfeld; Be'Eri,5,0,36,31
1658055306437,MATH 103A,A03,093561,Greenfeld; Be'Eri,7,0,36,29
1658055306437,MATH 103A,B01,083779,Greenfeld; Be'Eri,8,0,36,28
1658055306437,MATH 103A,B02,083780,Greenfeld; Be'Eri,4,0,36,32
1658055306437,MATH 103A,B03,093562,Greenfeld; Be'Eri,3,0,36,33
1658055312462,MATH 105,A01,085443,Carter; Anne Toulson,15,0,35,20
1658055312462,MATH 105,A02,093477,Carter; Anne Toulson,20,0,35,15
1658055318486,MATH 109,A01,083213,Ganzberger; Geoffrey Michael,3,0,34,31
1658055318486,MATH 109,A02,083214,Ganzberger; Geoffrey Michael,4,0,34,30
1658055318486,MATH 109,A03,093478,Ganzberger; Geoffrey Michael,2,0,34,32
1658055318486,MATH 109,B01,083215,Ganzberger; Geoffrey Michael,3,0,32,29
1658055318486,MATH 109,B02,083216,Ganzberger; Geoffrey Michael,3,0,32,29
1658055318486,MATH 109,B03,093479,Ganzberger; Geoffrey Michael,8,0,32,24
1658055324542,MATH 142A,A01,083219,Chow; Bennett,7,0,32,25
1658055324542,MATH 142A,A02,083220,Chow; Bennett,10,0,32,22
1658055324542,MATH 142A,A03,093480,Chow; Bennett,9,0,32,23
1658055324542,MATH 142A,B03,093481,Chow; Bennett,8,0,32,24
1658055324542,MATH 142A,B04,093558,Chow; Bennett,14,0,32,18
1658055324542,MATH 142A,B05,093559,Chow; Bennett,7,0,32,25
1658055330569,MATH 193A,A01,083224,Rotar; Vladimir,9,0,34,25
1658055330569,MATH 193A,A02,083225,Rotar; Vladimir,11,0,34,23
1658055330569,MATH 193A,A03,083781,Rotar; Vladimir,5,0,34,29
1658055330569,MATH 193A,A04,083782,Rotar; Vladimir,12,0,34,22
1658055330569,MATH 193A,A05,093482,Rotar; Vladimir,11,0,34,23
1658055336596,MATH 197,001,091859,McAuley; Julian John,9999,0,9999,0
1658055336596,MATH 197,002,095566,Kedlaya; Kiran S.,9997,0,9999,2
1658055336596,MATH 197,003,095567,Xiao; Ming,9999,0,9999,0
1658055336596,MATH 197,004,095571,Perols; Johan Lars,9998,0,9999,1
1658055343680,COGS 9,A01,083615,Shannon; Kyle Michael,11,0,75,64
1658055349705,COGS 11,A01,083617,Boyle; Mary E. T.,23,0,48,25
1658055355730,COGS 13,A01,083071,Bastos; Amalia Pinkusfeld,12,0,71,59
1658055361753,COGS 14A,A01,092681,Semenuks; Arturs,5,1,100,95
1658055367781,COGS 14B,A01,083073,Cheng; Tzu-Han,7,0,63,56
1658055373808,COGS 17,A01,092677,Semenuks; Arturs,7,0,81,74
1658055379838,COGS 100,A01,083619,Allen; Michael Gordon,17,0,70,53
1658055385866,COGS 101A,A01,083621,Davis; Joshua Daniel,9,0,68,59
1658055391890,COGS 101B,A01,091572,Allen; Michael Gordon,14,0,65,51
1658055397914,COGS 101C,A01,083625,Delgado; Tania,17,0,35,18
1658055403938,COGS 107A,A01,083627,Boyle; Mary E. T.,14,0,60,46
1658055409963,COGS 118A,A01,083075,Gupta; Anjum,21,0,76,55
1658055415990,CSE 3,A50,083646,Miranda; Gregory Joseph,24,0,50,26
1658055422014,CSE 8A,A50,083650,Miranda; Gregory Joseph,17,1,56,39
1658055428042,CSE 11,A01,083080,Cao; Yingjun,7,15,40,33
1658055434069,CSE 12,A01,083652,Krause-Levy; Sophia Louisa,30,1,120,90
1658055449412,CSE 15L,A01,083654,Morris; Justin Loren,9,0,50,41
1658055449412,CSE 15L,A02,083655,Morris; Justin Loren,11,0,50,39
1658055455441,CSE 20,A01,083657,Tran; Khoa Dang,39,0,80,41
1658055474136,CSE 21,A01,095574,Bach; Quang Tran,23,0,48,25
1658055480171,CSE 30,A01,083084,Eldon; John,8,0,80,72
1658055480171,CSE 30,B01,095061,Bhaskar; Nishant,9,0,50,41
1658055498698,CSE 100,A01,083659,Cao; Yingjun,5,4,70,65
1658055504722,CSE 134B,A01,083661,Powell; Thomas Allan,25,0,100,75
1658055523143,CSE 140,A01,083663,Gungor; Onat,17,0,85,68
1658055529169,CSE 140L,A01,083088,Eldon; John,23,0,100,77
1658055547740,CSE 175,A01,083665,Kumar; Rakesh,3,0,25,22
1658055553770,CSE 190,A00,092507,Dubnov; Shlomo,8,0,20,12
1658055572451,ECE 45,A01,083139,Congero; Spencer William,7,0,75,68
1658055578480,ECE 65,A50,083695,Saad; Andrew S,12,0,30,18
1658055578480,ECE 65,A51,095125,Saad; Andrew S,24,0,26,2
1658055597320,ECE 109,A01,091882,Touri; Behrouz,21,0,70,49
1658055603347,ECE 180,A00,083140,Abi Samra; Nicholas Camill,1,0,30,29
1658055603347,ECE 180,B00,083141,Abi Samra; Nicholas Camill,0,0,30,30
1658055622117,MATH 10A,A01,083735,Patchell; Gregory David,2,0,30,28
1658055622117,MATH 10A,A02,083736,Patchell; Gregory David,20,0,30,10
1658055622117,MATH 10A,A03,083737,Patchell; Gregory David,16,0,30,14
1658055628155,MATH 10B,A01,083207,Lim; Seonhee,9,0,34,25
1658055628155,MATH 10B,A02,083208,Lim; Seonhee,10,0,35,25
1658055628155,MATH 10B,A03,093472,Lim; Seonhee,7,0,34,27
1658055628155,MATH 10B,B01,083739,Sinha; Shubham,14,0,30,16
1658055646539,MATH 18,A01,083743,Cinel; Cameron Alexander,9,0,30,21
1658055646539,MATH 18,A02,083744,Cinel; Cameron Alexander,18,0,30,12
1658055646539,MATH 18,A03,083745,Cinel; Cameron Alexander,10,0,30,20
1658055646539,MATH 18,B01,083748,Rideout; David Porter,5,0,37,32
1658055646539,MATH 18,B02,083749,Rideout; David Porter,5,0,36,31
1658055646539,MATH 18,B03,083750,Rideout; David Porter,3,0,37,34
1658055646539,MATH 18,B04,083751,Rideout; David Porter,7,0,36,29
1658055646539,MATH 18,B05,093473,Rideout; David Porter,7,0,36,29
1658055646539,MATH 18,B06,093474,Rideout; David Porter,6,0,36,30
1658055652569,MATH 20A,A01,083754,Zheng; Zequn,14,0,40,26
1658055658593,MATH 20B,A01,083756,Briones; Jor-el Thomas Caparas,4,0,36,32
1658055658593,MATH 20B,A02,083757,Briones; Jor-el Thomas Caparas,1,0,36,35
1658055658593,MATH 20B,A03,093475,Briones; Jor-el Thomas Caparas,3,0,36,33
1658055664619,MATH 20C,A01,083760,Briones; Jor-el Thomas Caparas,1,0,35,34
1658055664619,MATH 20C,A02,083761,Briones; Jor-el Thomas Caparas,8,0,35,27
1658055664619,MATH 20C,A03,093476,Briones; Jor-el Thomas Caparas,0,1,36,36
1658055664619,MATH 20C,B01,083762,Bach; Quang Tran,1,0,30,29
1658055670648,MATH 20D,A01,083765,Tran; Brian Kha,5,0,30,25
1658055670648,MATH 20D,A02,083766,Tran; Brian Kha,5,0,30,25
1658055670648,MATH 20D,A03,083767,Tran; Brian Kha,6,0,30,24
1658055676674,MATH 20E,A01,083771,Ganguly; Soumya,12,0,32,20
1658055676674,MATH 20E,A02,083772,Ganguly; Soumya,7,0,32,25
1658055676674,MATH 20E,B01,083773,Ciotti; Benjamin,20,0,35,15
1658055676674,MATH 20E,B02,083774,Ciotti; Benjamin,18,0,35,17
1658055682711,MATH 103A,A01,083777,Greenfeld; Be'Eri,6,0,36,30
1658055682711,MATH 103A,A02,083778,Greenfeld; Be'Eri,5,0,36,31
1658055682711,MATH 103A,A03,093561,Greenfeld; Be'Eri,7,0,36,29
1658055682711,MATH 103A,B01,083779,Greenfeld; Be'Eri,8,0,36,28
1658055682711,MATH 103A,B02,083780,Greenfeld; Be'Eri,4,0,36,32
1658055682711,MATH 103A,B03,093562,Greenfeld; Be'Eri,3,0,36,33
1658055688736,MATH 105,A01,085443,Carter; Anne Toulson,15,0,35,20
1658055688736,MATH 105,A02,093477,Carter; Anne Toulson,20,0,35,15
1658055694760,MATH 109,A01,083213,Ganzberger; Geoffrey Michael,3,0,34,31
1658055694760,MATH 109,A02,083214,Ganzberger; Geoffrey Michael,4,0,34,30
1658055694760,MATH 109,A03,093478,Ganzberger; Geoffrey Michael,2,0,34,32
1658055694760,MATH 109,B01,083215,Ganzberger; Geoffrey Michael,3,0,32,29
1658055694760,MATH 109,B02,083216,Ganzberger; Geoffrey Michael,3,0,32,29
1658055694760,MATH 109,B03,093479,Ganzberger; Geoffrey Michael,8,0,32,24
1658055700797,MATH 142A,A01,083219,Chow; Bennett,7,0,32,25
1658055700797,MATH 142A,A02,083220,Chow; Bennett,10,0,32,22
1658055700797,MATH 142A,A03,093480,Chow; Bennett,9,0,32,23
1658055700797,MATH 142A,B03,093481,Chow; Bennett,8,0,32,24
1658055700797,MATH 142A,B04,093558,Chow; Bennett,14,0,32,18
1658055700797,MATH 142A,B05,093559,Chow; Bennett,7,0,32,25
1658055706822,MATH 193A,A01,083224,Rotar; Vladimir,9,0,34,25
1658055706822,MATH 193A,A02,083225,Rotar; Vladimir,11,0,34,23
1658055706822,MATH 193A,A03,083781,Rotar; Vladimir,5,0,34,29
1658055706822,MATH 193A,A04,083782,Rotar; Vladimir,12,0,34,22
1658055706822,MATH 193A,A05,093482,Rotar; Vladimir,11,0,34,23
1658055712849,MATH 197,001,091859,McAuley; Julian John,9999,0,9999,0
1658055712849,MATH 197,002,095566,Kedlaya; Kiran S.,9997,0,9999,2
1658055712849,MATH 197,003,095567,Xiao; Ming,9999,0,9999,0
1658055712849,MATH 197,004,095571,Perols; Johan Lars,9998,0,9999,1
1658055719924,COGS 9,A01,083615,Shannon; Kyle Michael,11,0,75,64
1658055725965,COGS 11,A01,083617,Boyle; Mary E. T.,23,0,48,25
1658055731996,COGS 13,A01,083071,Bastos; Amalia Pinkusfeld,12,0,71,59
1658055738024,COGS 14A,A01,092681,Semenuks; Arturs,5,1,100,95
1658055744055,COGS 14B,A01,083073,Cheng; Tzu-Han,7,0,63,56
1658055750078,COGS 17,A01,092677,Semenuks; Arturs,7,0,81,74
1658055756105,COGS 100,A01,083619,Allen; Michael Gordon,17,0,70,53
1658055762131,COGS 101A,A01,083621,Davis; Joshua Daniel,9,0,68,59
1658055768977,COGS 101B,A01,091572,Allen; Michael Gordon,14,0,65,51
1658055775011,COGS 101C,A01,083625,Delgado; Tania,17,0,35,18
1658055781048,COGS 107A,A01,083627,Boyle; Mary E. T.,14,0,60,46
1658055787076,COGS 118A,A01,083075,Gupta; Anjum,21,0,76,55
1658055793116,CSE 3,A50,083646,Miranda; Gregory Joseph,24,0,50,26
1658055799144,CSE 8A,A50,083650,Miranda; Gregory Joseph,17,1,56,39
1658055805170,CSE 11,A01,083080,Cao; Yingjun,7,15,40,33
1658055811216,CSE 12,A01,083652,Krause-Levy; Sophia Louisa,30,1,120,90
1658055817240,CSE 15L,A01,083654,Morris; Justin Loren,9,0,50,41
1658055817240,CSE 15L,A02,083655,Morris; Justin Loren,11,0,50,39
1658055823263,CSE 20,A01,083657,Tran; Khoa Dang,39,0,80,41
1658055829286,CSE 21,A01,095574,Bach; Quang Tran,23,0,48,25
1658055835315,CSE 30,A01,083084,Eldon; John,8,0,80,72
1658055835315,CSE 30,B01,095061,Bhaskar; Nishant,9,0,50,41
1658055841342,CSE 100,A01,083659,Cao; Yingjun,5,4,70,65
1658055847375,CSE 134B,A01,083661,Powell; Thomas Allan,25,0,100,75
1658055853401,CSE 140,A01,083663,Gungor; Onat,17,0,85,68
1658055859427,CSE 140L,A01,083088,Eldon; John,23,0,100,77
1658055865457,CSE 175,A01,083665,Kumar; Rakesh,3,0,25,22
1658055881033,CSE 190,A00,092507,Dubnov; Shlomo,8,0,20,12
1658055887065,ECE 45,A01,083139,Congero; Spencer William,7,0,75,68
1658055899366,ECE 65,A50,083695,Saad; Andrew S,12,0,30,18
1658055899366,ECE 65,A51,095125,Saad; Andrew S,24,0,26,2
1658055905392,ECE 109,A01,091882,Touri; Behrouz,21,0,70,49
1658055911418,ECE 180,A00,083140,Abi Samra; Nicholas Camill,1,0,30,29
1658055911418,ECE 180,B00,083141,Abi Samra; Nicholas Camill,0,0,30,30
1658055917444,MATH 10A,A01,083735,Patchell; Gregory David,2,0,30,28
1658055917444,MATH 10A,A02,083736,Patchell; Gregory David,20,0,30,10
1658055917444,MATH 10A,A03,083737,Patchell; Gregory David,16,0,30,14
1658055923486,MATH 10B,A01,083207,Lim; Seonhee,9,0,34,25
1658055923486,MATH 10B,A02,083208,Lim; Seonhee,10,0,35,25
1658055923486,MATH 10B,A03,093472,Lim; Seonhee,7,0,34,27
1658055923486,MATH 10B,B01,083739,Sinha; Shubham,14,0,30,16
1658055929519,MATH 18,A01,083743,Cinel; Cameron Alexander,9,0,30,21
1658055929519,MATH 18,A02,083744,Cinel; Cameron Alexander,18,0,30,12
1658055929519,MATH 18,A03,083745,Cinel; Cameron Alexander,10,0,30,20
1658055929519,MATH 18,B01,083748,Rideout; David Porter,5,0,37,32
1658055929519,MATH 18,B02,083749,Rideout; David Porter,5,0,36,31
1658055929519,MATH 18,B03,083750,Rideout; David Porter,3,0,37,34
1658055929519,MATH 18,B04,083751,Rideout; David Porter,7,0,36,29
1658055929519,MATH 18,B05,093473,Rideout; David Porter,7,0,36,29
1658055929519,MATH 18,B06,093474,Rideout; David Porter,6,0,36,30
1658055935549,MATH 20A,A01,083754,Zheng; Zequn,14,0,40,26
1658055941579,MATH 20B,A01,083756,Briones; Jor-el Thomas Caparas,4,0,36,32
1658055941579,MATH 20B,A02,083757,Briones; Jor-el Thomas Caparas,1,0,36,35
1658055941579,MATH 20B,A03,093475,Briones; Jor-el Thomas Caparas,3,0,36,33
1658055947612,MATH 20C,A01,083760,Briones; Jor-el Thomas Caparas,1,0,35,34
1658055947612,MATH 20C,A02,083761,Briones; Jor-el Thomas Caparas,8,0,35,27
1658055947612,MATH 20C,A03,093476,Briones; Jor-el Thomas Caparas,0,1,36,36
1658055947612,MATH 20C,B01,083762,Bach; Quang Tran,1,0,30,29
1658055953634,MATH 20D,A01,083765,Tran; Brian Kha,5,0,30,25
1658055953634,MATH 20D,A02,083766,Tran; Brian Kha,5,0,30,25
1658055953634,MATH 20D,A03,083767,Tran; Brian Kha,6,0,30,24
1658055959662,MATH 20E,A01,083771,Ganguly; Soumya,12,0,32,20
1658055959662,MATH 20E,A02,083772,Ganguly; Soumya,7,0,32,25
1658055959662,MATH 20E,B01,083773,Ciotti; Benjamin,20,0,35,15
1658055959662,MATH 20E,B02,083774,Ciotti; Benjamin,18,0,35,17
1658055965709,MATH 103A,A01,083777,Greenfeld; Be'Eri,6,0,36,30
1658055965709,MATH 103A,A02,083778,Greenfeld; Be'Eri,5,0,36,31
1658055965709,MATH 103A,A03,093561,Greenfeld; Be'Eri,7,0,36,29
1658055965709,MATH 103A,B01,083779,Greenfeld; Be'Eri,8,0,36,28
1658055965709,MATH 103A,B02,083780,Greenfeld; Be'Eri,4,0,36,32
1658055965709,MATH 103A,B03,093562,Greenfeld; Be'Eri,3,0,36,33
1658055971756,MATH 105,A01,085443,Carter; Anne Toulson,15,0,35,20
1658055971756,MATH 105,A02,093477,Carter; Anne Toulson,20,0,35,15
1658055977781,MATH 109,A01,083213,Ganzberger; Geoffrey Michael,3,0,34,31
1658055977781,MATH 109,A02,083214,Ganzberger; Geoffrey Michael,4,0,34,30
1658055977781,MATH 109,A03,093478,Ganzberger; Geoffrey Michael,2,0,34,32
1658055977781,MATH 109,B01,083215,Ganzberger; Geoffrey Michael,3,0,32,29
1658055977781,MATH 109,B02,083216,Ganzberger; Geoffrey Michael,3,0,32,29
1658055977781,MATH 109,B03,093479,Ganzberger; Geoffrey Michael,8,0,32,24
1658055983806,MATH 142A,A01,083219,Chow; Bennett,7,0,32,25
1658055983806,MATH 142A,A02,083220,Chow; Bennett,10,0,32,22
1658055983806,MATH 142A,A03,093480,Chow; Bennett,9,0,32,23
1658055983806,MATH 142A,B03,093481,Chow; Bennett,8,0,32,24
1658055983806,MATH 142A,B04,093558,Chow; Bennett,14,0,32,18
1658055983806,MATH 142A,B05,093559,Chow; Bennett,7,0,32,25
1658055989837,MATH 193A,A01,083224,Rotar; Vladimir,9,0,34,25
1658055989837,MATH 193A,A02,083225,Rotar; Vladimir,11,0,34,23
1658055989837,MATH 193A,A03,083781,Rotar; Vladimir,5,0,34,29
1658055989837,MATH 193A,A04,083782,Rotar; Vladimir,12,0,34,22
1658055989837,MATH 193A,A05,093482,Rotar; Vladimir,11,0,34,23
1658055995860,MATH 197,001,091859,McAuley; Julian John,9999,0,9999,0
1658055995860,MATH 197,002,095566,Kedlaya; Kiran S.,9997,0,9999,2
1658055995860,MATH 197,003,095567,Xiao; Ming,9999,0,9999,0
1658055995860,MATH 197,004,095571,Perols; Johan Lars,9998,0,9999,1
1658056002923,COGS 9,A01,083615,Shannon; Kyle Michael,11,0,75,64
1658056008947,COGS 11,A01,083617,Boyle; Mary E. T.,23,0,48,25
1658056014981,COGS 13,A01,083071,Bastos; Amalia Pinkusfeld,12,0,71,59
1658056021006,COGS 14A,A01,092681,Semenuks; Arturs,5,1,100,95
1658056027037,COGS 14B,A01,083073,Cheng; Tzu-Han,7,0,63,56
1658056033064,COGS 17,A01,092677,Semenuks; Arturs,7,0,81,74
1658056039088,COGS 100,A01,083619,Allen; Michael Gordon,17,0,70,53
1658056045111,COGS 101A,A01,083621,Davis; Joshua Daniel,9,0,68,59
1658056051139,COGS 101B,A01,091572,Allen; Michael Gordon,14,0,65,51
1658056057164,COGS 101C,A01,083625,Delgado; Tania,17,0,35,18
1658056063189,COGS 107A,A01,083627,Boyle; Mary E. T.,14,0,60,46
1658056069214,COGS 118A,A01,083075,Gupta; Anjum,21,0,76,55
1658056075239,CSE 3,A50,083646,Miranda; Gregory Joseph,24,0,50,26
1658056081265,CSE 8A,A50,083650,Miranda; Gregory Joseph,17,1,56,39
1658056087294,CSE 11,A01,083080,Cao; Yingjun,7,15,40,33
1658056093324,CSE 12,A01,083652,Krause-Levy; Sophia Louisa,30,1,120,90
1658056099353,CSE 15L,A01,083654,Morris; Justin Loren,9,0,50,41
1658056099353,CSE 15L,A02,083655,Morris; Justin Loren,11,0,50,39
1658056105385,CSE 20,A01,083657,Tran; Khoa Dang,39,0,80,41
1658056111415,CSE 21,A01,095574,Bach; Quang Tran,23,0,48,25
1658056117440,CSE 30,A01,083084,Eldon; John,8,0,80,72
1658056117440,CSE 30,B01,095061,Bhaskar; Nishant,9,0,50,41
1658056123465,CSE 100,A01,083659,Cao; Yingjun,5,4,70,65
1658056129494,CSE 134B,A01,083661,Powell; Thomas Allan,25,0,100,75
1658056135519,CSE 140,A01,083663,Gungor; Onat,17,0,85,68
1658056141543,CSE 140L,A01,083088,Eldon; John,23,0,100,77
1658056147568,CSE 175,A01,083665,Kumar; Rakesh,3,0,25,22
1658056153594,CSE 190,A00,092507,Dubnov; Shlomo,8,0,20,12
1658056159626,ECE 45,A01,083139,Congero; Spencer William,7,0,75,68
1658056165652,ECE 65,A50,083695,Saad; Andrew S,12,0,30,18
1658056165652,ECE 65,A51,095125,Saad; Andrew S,24,0,26,2
1658056171677,ECE 109,A01,091882,Touri; Behrouz,21,0,70,49
1658056177706,ECE 180,A00,083140,Abi Samra; Nicholas Camill,1,0,30,29
1658056177706,ECE 180,B00,083141,Abi Samra; Nicholas Camill,0,0,30,30
1658056183738,MATH 10A,A01,083735,Patchell; Gregory David,2,0,30,28
1658056183738,MATH 10A,A02,083736,Patchell; Gregory David,20,0,30,10
1658056183738,MATH 10A,A03,083737,Patchell; Gregory David,16,0,30,14
1658056189768,MATH 10B,A01,083207,Lim; Seonhee,9,0,34,25
1658056189768,MATH 10B,A02,083208,Lim; Seonhee,10,0,35,25
1658056189768,MATH 10B,A03,093472,Lim; Seonhee,7,0,34,27
1658056189768,MATH 10B,B01,083739,Sinha; Shubham,14,0,30,16
1658056195804,MATH 18,A01,083743,Cinel; Cameron Alexander,9,0,30,21
1658056195804,MATH 18,A02,083744,Cinel; Cameron Alexander,18,0,30,12
1658056195804,MATH 18,A03,083745,Cinel; Cameron Alexander,10,0,30,20
1658056195804,MATH 18,B01,083748,Rideout; David Porter,5,0,37,32
1658056195804,MATH 18,B02,083749,Rideout; David Porter,5,0,36,31
1658056195804,MATH 18,B03,083750,Rideout; David Porter,3,0,37,34
1658056195804,MATH 18,B04,083751,Rideout; David Porter,7,0,36,29
1658056195804,MATH 18,B05,093473,Rideout; David Porter,7,0,36,29
1658056195804,MATH 18,B06,093474,Rideout; David Porter,6,0,36,30
1658056201828,MATH 20A,A01,083754,Zheng; Zequn,14,0,40,26
1658056207861,MATH 20B,A01,083756,Briones; Jor-el Thomas Caparas,4,0,36,32
1658056207861,MATH 20B,A02,083757,Briones; Jor-el Thomas Caparas,1,0,36,35
1658056207861,MATH 20B,A03,093475,Briones; Jor-el Thomas Caparas,3,0,36,33
1658056213887,MATH 20C,A01,083760,Briones; Jor-el Thomas Caparas,1,0,35,34
1658056213887,MATH 20C,A02,083761,Briones; Jor-el Thomas Caparas,8,0,35,27
1658056213887,MATH 20C,A03,093476,Briones; Jor-el Thomas Caparas,0,1,36,36
1658056213887,MATH 20C,B01,083762,Bach; Quang Tran,1,0,30,29
1658056219912,MATH 20D,A01,083765,Tran; Brian Kha,5,0,30,25
1658056219912,MATH 20D,A02,083766,Tran; Brian Kha,5,0,30,25
1658056219912,MATH 20D,A03,083767,Tran; Brian Kha,6,0,30,24
1658056225947,MATH 20E,A01,083771,Ganguly; Soumya,12,0,32,20
1658056225947,MATH 20E,A02,083772,Ganguly; Soumya,7,0,32,25
1658056225947,MATH 20E,B01,083773,Ciotti; Benjamin,20,0,35,15
1658056225947,MATH 20E,B02,083774,Ciotti; Benjamin,18,0,35,17
1658056231983,MATH 103A,A01,083777,Greenfeld; Be'Eri,6,0,36,30
1658056231983,MATH 103A,A02,083778,Greenfeld; Be'Eri,5,0,36,31
1658056231983,MATH 103A,A03,093561,Greenfeld; Be'Eri,7,0,36,29
1658056231983,MATH 103A,B01,083779,Greenfeld; Be'Eri,8,0,36,28
1658056231983,MATH 103A,B02,083780,Greenfeld; Be'Eri,4,0,36,32
1658056231983,MATH 103A,B03,093562,Greenfeld; Be'Eri,3,0,36,33
1658056238008,MATH 105,A01,085443,Carter; Anne Toulson,15,0,35,20
1658056238008,MATH 105,A02,093477,Carter; Anne Toulson,20,0,35,15
1658056244039,MATH 109,A01,083213,Ganzberger; Geoffrey Michael,3,0,34,31
1658056244039,MATH 109,A02,083214,Ganzberger; Geoffrey Michael,4,0,34,30
1658056244039,MATH 109,A03,093478,Ganzberger; Geoffrey Michael,2,0,34,32
1658056244039,MATH 109,B01,083215,Ganzberger; Geoffrey Michael,3,0,32,29
1658056244039,MATH 109,B02,083216,Ganzberger; Geoffrey Michael,3,0,32,29
1658056244039,MATH 109,B03,093479,Ganzberger; Geoffrey Michael,8,0,32,24
1658056250072,MATH 142A,A01,083219,Chow; Bennett,7,0,32,25
1658056250072,MATH 142A,A02,083220,Chow; Bennett,10,0,32,22
1658056250072,MATH 142A,A03,093480,Chow; Bennett,9,0,32,23
1658056250072,MATH 142A,B03,093481,Chow; Bennett,8,0,32,24
1658056250072,MATH 142A,B04,093558,Chow; Bennett,14,0,32,18
1658056250072,MATH 142A,B05,093559,Chow; Bennett,7,0,32,25
1658056256106,MATH 193A,A01,083224,Rotar; Vladimir,9,0,34,25
1658056256106,MATH 193A,A02,083225,Rotar; Vladimir,11,0,34,23
1658056256106,MATH 193A,A03,083781,Rotar; Vladimir,5,0,34,29
1658056256106,MATH 193A,A04,083782,Rotar; Vladimir,12,0,34,22
1658056256106,MATH 193A,A05,093482,Rotar; Vladimir,11,0,34,23
1658056262140,MATH 197,001,091859,McAuley; Julian John,9999,0,9999,0
1658056262140,MATH 197,002,095566,Kedlaya; Kiran S.,9997,0,9999,2
1658056262140,MATH 197,003,095567,Xiao; Ming,9999,0,9999,0
1658056262140,MATH 197,004,095571,Perols; Johan Lars,9998,0,9999,1
1658056269222,COGS 9,A01,083615,Shannon; Kyle Michael,11,0,75,64
1658056275250,COGS 11,A01,083617,Boyle; Mary E. T.,23,0,48,25
1658056281276,COGS 13,A01,083071,Bastos; Amalia Pinkusfeld,12,0,71,59
1658056287305,COGS 14A,A01,092681,Semenuks; Arturs,5,1,100,95
1658056293340,COGS 14B,A01,083073,Cheng; Tzu-Han,7,0,63,56
1658056299363,COGS 17,A01,092677,Semenuks; Arturs,7,0,81,74
1658056305390,COGS 100,A01,083619,Allen; Michael Gordon,17,0,70,53
1658056311415,COGS 101A,A01,083621,Davis; Joshua Daniel,9,0,68,59
1658056317440,COGS 101B,A01,091572,Allen; Michael Gordon,14,0,65,51
1658056323469,COGS 101C,A01,083625,Delgado; Tania,17,0,35,18
1658056329499,COGS 107A,A01,083627,Boyle; Mary E. T.,14,0,60,46
1658056335527,COGS 118A,A01,083075,Gupta; Anjum,21,0,76,55
1658056341554,CSE 3,A50,083646,Miranda; Gregory Joseph,24,0,50,26
1658056347578,CSE 8A,A50,083650,Miranda; Gregory Joseph,17,1,56,39
1658056353607,CSE 11,A01,083080,Cao; Yingjun,7,15,40,33
1658056359633,CSE 12,A01,083652,Krause-Levy; Sophia Louisa,30,1,120,90
1658056365665,CSE 15L,A01,083654,Morris; Justin Loren,9,0,50,41
1658056365665,CSE 15L,A02,083655,Morris; Justin Loren,11,0,50,39
1658056371692,CSE 20,A01,083657,Tran; Khoa Dang,39,0,80,41
1658056377717,CSE 21,A01,095574,Bach; Quang Tran,23,0,48,25
1658056383827,CSE 30,A01,083084,Eldon; John,8,0,80,72
1658056383827,CSE 30,B01,095061,Bhaskar; Nishant,9,0,50,41
1658056389853,CSE 100,A01,083659,Cao; Yingjun,5,4,70,65
1658056395878,CSE 134B,A01,083661,Powell; Thomas Allan,25,0,100,75
1658056401910,CSE 140,A01,083663,Gungor; Onat,17,0,85,68
1658056407935,CSE 140L,A01,083088,Eldon; John,23,0,100,77
1658056413966,CSE 175,A01,083665,Kumar; Rakesh,3,0,25,22
1658056419997,CSE 190,A00,092507,Dubnov; Shlomo,8,0,20,12
1658056426025,ECE 45,A01,083139,Congero; Spencer William,7,0,75,68
1658056432059,ECE 65,A50,083695,Saad; Andrew S,12,0,30,18
1658056432059,ECE 65,A51,095125,Saad; Andrew S,24,0,26,2
1658056438086,ECE 109,A01,091882,Touri; Behrouz,21,0,70,49
1658056444110,ECE 180,A00,083140,Abi Samra; Nicholas Camill,1,0,30,29
1658056444110,ECE 180,B00,083141,Abi Samra; Nicholas Camill,0,0,30,30
1658056450140,MATH 10A,A01,083735,Patchell; Gregory David,2,0,30,28
1658056450140,MATH 10A,A02,083736,Patchell; Gregory David,20,0,30,10
1658056450140,MATH 10A,A03,083737,Patchell; Gregory David,16,0,30,14
1658056456191,MATH 10B,A01,083207,Lim; Seonhee,9,0,34,25
1658056456191,MATH 10B,A02,083208,Lim; Seonhee,10,0,35,25
1658056456191,MATH 10B,A03,093472,Lim; Seonhee,7,0,34,27
1658056456191,MATH 10B,B01,083739,Sinha; Shubham,14,0,30,16
1658056462221,MATH 18,A01,083743,Cinel; Cameron Alexander,9,0,30,21
1658056462221,MATH 18,A02,083744,Cinel; Cameron Alexander,18,0,30,12
1658056462221,MATH 18,A03,083745,Cinel; Cameron Alexander,10,0,30,20
1658056462221,MATH 18,B01,083748,Rideout; David Porter,5,0,37,32
1658056462221,MATH 18,B02,083749,Rideout; David Porter,5,0,36,31
1658056462221,MATH 18,B03,083750,Rideout; David Porter,3,0,37,34
1658056462221,MATH 18,B04,083751,Rideout; David Porter,7,0,36,29
1658056462221,MATH 18,B05,093473,Rideout; David Porter,7,0,36,29
1658056462221,MATH 18,B06,093474,Rideout; David Porter,6,0,36,30
1658056468246,MATH 20A,A01,083754,Zheng; Zequn,14,0,40,26
1658056474272,MATH 20B,A01,083756,Briones; Jor-el Thomas Caparas,4,0,36,32
1658056474272,MATH 20B,A02,083757,Briones; Jor-el Thomas Caparas,1,0,36,35
1658056474272,MATH 20B,A03,093475,Briones; Jor-el Thomas Caparas,3,0,36,33
1658056480300,MATH 20C,A01,083760,Briones; Jor-el Thomas Caparas,1,0,35,34
1658056480300,MATH 20C,A02,083761,Briones; Jor-el Thomas Caparas,8,0,35,27
1658056480300,MATH 20C,A03,093476,Briones; Jor-el Thomas Caparas,0,1,36,36
1658056480300,MATH 20C,B01,083762,Bach; Quang Tran,1,0,30,29
1658056486324,MATH 20D,A01,083765,Tran; Brian Kha,5,0,30,25
1658056486324,MATH 20D,A02,083766,Tran; Brian Kha,5,0,30,25
1658056486324,MATH 20D,A03,083767,Tran; Brian Kha,6,0,30,24
1658056492353,MATH 20E,A01,083771,Ganguly; Soumya,12,0,32,20
1658056492353,MATH 20E,A02,083772,Ganguly; Soumya,7,0,32,25
1658056492353,MATH 20E,B01,083773,Ciotti; Benjamin,20,0,35,15
1658056492353,MATH 20E,B02,083774,Ciotti; Benjamin,18,0,35,17
1658056498381,MATH 103A,A01,083777,Greenfeld; Be'Eri,6,0,36,30
1658056498381,MATH 103A,A02,083778,Greenfeld; Be'Eri,5,0,36,31
1658056498381,MATH 103A,A03,093561,Greenfeld; Be'Eri,7,0,36,29
1658056498381,MATH 103A,B01,083779,Greenfeld; Be'Eri,8,0,36,28
1658056498381,MATH 103A,B02,083780,Greenfeld; Be'Eri,4,0,36,32
1658056498381,MATH 103A,B03,093562,Greenfeld; Be'Eri,3,0,36,33
1658056504405,MATH 105,A01,085443,Carter; Anne Toulson,15,0,35,20
1658056504405,MATH 105,A02,093477,Carter; Anne Toulson,20,0,35,15
1658056510438,MATH 109,A01,083213,Ganzberger; Geoffrey Michael,3,0,34,31
1658056510438,MATH 109,A02,083214,Ganzberger; Geoffrey Michael,4,0,34,30
1658056510438,MATH 109,A03,093478,Ganzberger; Geoffrey Michael,2,0,34,32
1658056510438,MATH 109,B01,083215,Ganzberger; Geoffrey Michael,3,0,32,29
1658056510438,MATH 109,B02,083216,Ganzberger; Geoffrey Michael,3,0,32,29
1658056510438,MATH 109,B03,093479,Ganzberger; Geoffrey Michael,8,0,32,24
1658056516471,MATH 142A,A01,083219,Chow; Bennett,7,0,32,25
1658056516471,MATH 142A,A02,083220,Chow; Bennett,10,0,32,22
1658056516471,MATH 142A,A03,093480,Chow; Bennett,9,0,32,23
1658056516471,MATH 142A,B03,093481,Chow; Bennett,8,0,32,24
1658056516471,MATH 142A,B04,093558,Chow; Bennett,14,0,32,18
1658056516471,MATH 142A,B05,093559,Chow; Bennett,7,0,32,25
1658056522497,MATH 193A,A01,083224,Rotar; Vladimir,9,0,34,25
1658056522497,MATH 193A,A02,083225,Rotar; Vladimir,11,0,34,23
1658056522497,MATH 193A,A03,083781,Rotar; Vladimir,5,0,34,29
1658056522497,MATH 193A,A04,083782,Rotar; Vladimir,12,0,34,22
1658056522497,MATH 193A,A05,093482,Rotar; Vladimir,11,0,34,23
1658056528522,MATH 197,001,091859,McAuley; Julian John,9999,0,9999,0
1658056528522,MATH 197,002,095566,Kedlaya; Kiran S.,9997,0,9999,2
1658056528522,MATH 197,003,095567,Xiao; Ming,9999,0,9999,0
1658056528522,MATH 197,004,095571,Perols; Johan Lars,9998,0,9999,1
1658056535598,COGS 9,A01,083615,Shannon; Kyle Michael,11,0,75,64
1658056541628,COGS 11,A01,083617,Boyle; Mary E. T.,23,0,48,25
1658056547654,COGS 13,A01,083071,Bastos; Amalia Pinkusfeld,12,0,71,59
1658056553680,COGS 14A,A01,092681,Semenuks; Arturs,5,1,100,95
1658056559706,COGS 14B,A01,083073,Cheng; Tzu-Han,7,0,63,56
1658056565730,COGS 17,A01,092677,Semenuks; Arturs,7,0,81,74
1658056571759,COGS 100,A01,083619,Allen; Michael Gordon,17,0,70,53
1658056577789,COGS 101A,A01,083621,Davis; Joshua Daniel,9,0,68,59
1658056583814,COGS 101B,A01,091572,Allen; Michael Gordon,14,0,65,51
1658056589848,COGS 101C,A01,083625,Delgado; Tania,17,0,35,18
1658056595876,COGS 107A,A01,083627,Boyle; Mary E. T.,14,0,60,46
1658056601905,COGS 118A,A01,083075,Gupta; Anjum,21,0,76,55
1658056607932,CSE 3,A50,083646,Miranda; Gregory Joseph,24,0,50,26
1658056613961,CSE 8A,A50,083650,Miranda; Gregory Joseph,17,1,56,39
