time,subj_course_id,sec_code,sec_id,prof,available,waitlist,total,enrolled_ct
1656847127480,COGS 9,A01,083615,Shannon; Kyle Michael,6,0,75,69
1656847133515,COGS 11,A01,083617,Boyle; Mary E. T.,18,0,48,30
1656847139552,COGS 13,A01,083071,Bastos; Amalia Pinkusfeld,8,0,71,63
1656847145590,COGS 14A,A01,092681,Semenuks; Arturs,0,1,100,100
1656847151622,COGS 14B,A01,083073,Cheng; Tzu-Han,5,0,63,58
1656847157658,COGS 17,A01,092677,Semenuks; Arturs,4,0,81,77
1656847163696,COGS 100,A01,083619,Allen; Michael Gordon,15,0,70,55
1656847169730,COGS 101A,A01,083621,Davis; Joshua Daniel,9,0,68,59
1656847175766,COGS 101B,A01,091572,Allen; Michael Gordon,8,0,65,57
1656847181794,COGS 101C,A01,083625,Delgado; Tania,17,0,35,18
1656847187828,COGS 107A,A01,083627,Boyle; Mary E. T.,13,0,60,47
1656847193860,COGS 118A,A01,083075,Gupta; Anjum,15,0,76,61
1656847199898,CSE 3,A50,083646,Miranda; Gregory Joseph,22,0,50,28
1656847205931,CSE 8A,A50,083650,Miranda; Gregory Joseph,17,1,56,39
1656847211961,CSE 11,A01,083080,Cao; Yingjun,4,15,40,36
1656847218000,CSE 12,A01,083652,Krause-Levy; Sophia Louisa,20,1,120,100
1656847224032,CSE 15L,A01,083654,Morris; Justin Loren,8,0,50,42
1656847224032,CSE 15L,A02,083655,Morris; Justin Loren,8,0,50,42
1656847230067,CSE 20,A01,083657,Tran; Khoa Dang,37,0,80,43
1656847236105,CSE 21,A01,095574,Bach; Quang Tran,21,0,48,27
1656847242146,CSE 30,A01,083084,Eldon; John,4,0,80,76
1656847242146,CSE 30,B01,095061,Bhaskar; Nishant,6,0,50,44
1656847248179,CSE 100,A01,083659,Cao; Yingjun,2,4,70,68
1656847254210,CSE 134B,A01,083661,Powell; Thomas Allan,19,0,100,81
1656847260253,CSE 140,A01,083663,Gungor; Onat,14,0,85,71
1656847266279,CSE 140L,A01,083088,Eldon; John,16,0,100,84
1656847272317,CSE 175,A01,083665,Kumar; Rakesh,3,0,25,22
1656847278356,CSE 190,A00,092507,Dubnov; Shlomo,7,0,20,13
1656847284388,ECE 45,A01,083139,Congero; Spencer William,5,0,75,70
1656847290421,ECE 65,A50,083695,Saad; Andrew S,12,0,30,18
1656847290421,ECE 65,A51,095125,Saad; Andrew S,25,0,26,1
1656847296456,ECE 109,A01,091882,Touri; Behrouz,16,0,70,54
1656847302487,ECE 180,A00,083140,Abi Samra; Nicholas Camill,0,0,30,30
1656847302487,ECE 180,B00,083141,Abi Samra; Nicholas Camill,0,0,30,30
1656847308517,MATH 10A,A01,083735,Patchell; Gregory David,1,0,30,29
1656847308517,MATH 10A,A02,083736,Patchell; Gregory David,20,0,30,10
1656847308517,MATH 10A,A03,083737,Patchell; Gregory David,15,0,30,15
1656847314557,MATH 10B,A01,083207,Lim; Seonhee,7,0,34,27
1656847314557,MATH 10B,A02,083208,Lim; Seonhee,9,0,35,26
1656847314557,MATH 10B,A03,093472,Lim; Seonhee,4,0,34,30
1656847314557,MATH 10B,B01,083739,Sinha; Shubham,9,0,30,21
1656847320601,MATH 18,A01,083743,Cinel; Cameron Alexander,6,0,30,24
1656847320601,MATH 18,A02,083744,Cinel; Cameron Alexander,15,0,30,15
1656847320601,MATH 18,A03,083745,Cinel; Cameron Alexander,8,0,30,22
1656847320601,MATH 18,B01,083748,Rideout; David Porter,3,0,37,34
1656847320601,MATH 18,B02,083749,Rideout; David Porter,3,0,36,33
1656847320601,MATH 18,B03,083750,Rideout; David Porter,2,0,37,35
1656847320601,MATH 18,B04,083751,Rideout; David Porter,5,0,36,31
1656847320601,MATH 18,B05,093473,Rideout; David Porter,4,0,36,32
1656847320601,MATH 18,B06,093474,Rideout; David Porter,5,0,36,31
1656847326636,MATH 20A,A01,083754,Zheng; Zequn,12,0,40,28
1656847332669,MATH 20B,A01,083756,Briones; Jor-el Thomas Caparas,1,0,36,35
1656847332669,MATH 20B,A02,083757,Briones; Jor-el Thomas Caparas,1,0,36,35
1656847332669,MATH 20B,A03,093475,Briones; Jor-el Thomas Caparas,0,0,36,36
1656847338700,MATH 20C,A01,083760,Briones; Jor-el Thomas Caparas,1,0,35,34
1656847338700,MATH 20C,A02,083761,Briones; Jor-el Thomas Caparas,8,0,35,27
1656847338700,MATH 20C,A03,093476,Briones; Jor-el Thomas Caparas,0,1,36,36
1656847338700,MATH 20C,B01,083762,Bach; Quang Tran,0,0,30,30
1656847344729,MATH 20D,A01,083765,Tran; Brian Kha,4,0,30,26
1656847344729,MATH 20D,A02,083766,Tran; Brian Kha,4,0,30,26
1656847344729,MATH 20D,A03,083767,Tran; Brian Kha,2,0,30,28
1656847350763,MATH 20E,A01,083771,Ganguly; Soumya,5,0,32,27
1656847350763,MATH 20E,A02,083772,Ganguly; Soumya,6,0,32,26
1656847350763,MATH 20E,B01,083773,Ciotti; Benjamin,18,0,35,17
1656847350763,MATH 20E,B02,083774,Ciotti; Benjamin,17,0,35,18
1656847356796,MATH 103A,A01,083777,Greenfeld; Be'Eri,2,0,36,34
1656847356796,MATH 103A,A02,083778,Greenfeld; Be'Eri,5,0,36,31
1656847356796,MATH 103A,A03,093561,Greenfeld; Be'Eri,4,0,36,32
1656847356796,MATH 103A,B01,083779,Greenfeld; Be'Eri,6,0,36,30
1656847356796,MATH 103A,B02,083780,Greenfeld; Be'Eri,2,0,36,34
1656847356796,MATH 103A,B03,093562,Greenfeld; Be'Eri,2,0,36,34
1656847362832,MATH 105,A01,085443,Carter; Anne Toulson,13,0,35,22
1656847362832,MATH 105,A02,093477,Carter; Anne Toulson,20,0,35,15
1656847368867,MATH 109,A01,083213,Ganzberger; Geoffrey Michael,2,0,34,32
1656847368867,MATH 109,A02,083214,Ganzberger; Geoffrey Michael,2,0,34,32
1656847368867,MATH 109,A03,093478,Ganzberger; Geoffrey Michael,1,0,34,33
1656847368867,MATH 109,B01,083215,Ganzberger; Geoffrey Michael,1,0,32,31
1656847368867,MATH 109,B02,083216,Ganzberger; Geoffrey Michael,1,0,32,31
1656847368867,MATH 109,B03,093479,Ganzberger; Geoffrey Michael,6,0,32,26
1656847374899,MATH 142A,A01,083219,Chow; Bennett,6,0,32,26
1656847374899,MATH 142A,A02,083220,Chow; Bennett,9,0,32,23
1656847374899,MATH 142A,A03,093480,Chow; Bennett,7,0,32,25
1656847374899,MATH 142A,B03,093481,Chow; Bennett,7,0,32,25
1656847374899,MATH 142A,B04,093558,Chow; Bennett,10,0,32,22
1656847374899,MATH 142A,B05,093559,Chow; Bennett,6,0,32,26
1656847380928,MATH 193A,A01,083224,Rotar; Vladimir,6,0,34,28
1656847380928,MATH 193A,A02,083225,Rotar; Vladimir,3,0,34,31
1656847380928,MATH 193A,A03,083781,Rotar; Vladimir,1,0,34,33
1656847380928,MATH 193A,A04,083782,Rotar; Vladimir,6,0,34,28
1656847380928,MATH 193A,A05,093482,Rotar; Vladimir,6,0,34,28
1656847386964,MATH 197,001,091859,McAuley; Julian John,9999,0,9999,0
1656847386964,MATH 197,002,095566,Kedlaya; Kiran S.,9997,0,9999,2
1656847386964,MATH 197,003,095567,Xiao; Ming,9999,0,9999,0
1656847386964,MATH 197,004,095571,Perols; Johan Lars,9998,0,9999,1
1656847394039,COGS 9,A01,083615,Shannon; Kyle Michael,6,0,75,69
1656847400073,COGS 11,A01,083617,Boyle; Mary E. T.,18,0,48,30
1656847406102,COGS 13,A01,083071,Bastos; Amalia Pinkusfeld,8,0,71,63
1656847412135,COGS 14A,A01,092681,Semenuks; Arturs,0,1,100,100
1656847418165,COGS 14B,A01,083073,Cheng; Tzu-Han,5,0,63,58
1656847424193,COGS 17,A01,092677,Semenuks; Arturs,4,0,81,77
1656847430220,COGS 100,A01,083619,Allen; Michael Gordon,15,0,70,55
1656847436251,COGS 101A,A01,083621,Davis; Joshua Daniel,9,0,68,59
1656847442280,COGS 101B,A01,091572,Allen; Michael Gordon,8,0,65,57
1656847448316,COGS 101C,A01,083625,Delgado; Tania,17,0,35,18
1656847454345,COGS 107A,A01,083627,Boyle; Mary E. T.,13,0,60,47
1656847460371,COGS 118A,A01,083075,Gupta; Anjum,15,0,76,61
1656847466410,CSE 3,A50,083646,Miranda; Gregory Joseph,22,0,50,28
1656847472442,CSE 8A,A50,083650,Miranda; Gregory Joseph,17,1,56,39
1656847488152,CSE 11,A01,083080,Cao; Yingjun,4,15,40,36
1656847494178,CSE 12,A01,083652,Krause-Levy; Sophia Louisa,20,1,120,100
1656847503921,CSE 15L,A01,083654,Morris; Justin Loren,8,0,50,42
1656847503921,CSE 15L,A02,083655,Morris; Justin Loren,8,0,50,42
1656847509952,CSE 20,A01,083657,Tran; Khoa Dang,37,0,80,43
1656847515983,CSE 21,A01,095574,Bach; Quang Tran,21,0,48,27
1656847522014,CSE 30,A01,083084,Eldon; John,4,0,80,76
1656847522014,CSE 30,B01,095061,Bhaskar; Nishant,6,0,50,44
1656847528046,CSE 100,A01,083659,Cao; Yingjun,2,4,70,68
1656847534076,CSE 134B,A01,083661,Powell; Thomas Allan,19,0,100,81
1656847540106,CSE 140,A01,083663,Gungor; Onat,14,0,85,71
1656847546136,CSE 140L,A01,083088,Eldon; John,16,0,100,84
1656847552163,CSE 175,A01,083665,Kumar; Rakesh,3,0,25,22
1656847558192,CSE 190,A00,092507,Dubnov; Shlomo,7,0,20,13
1656847564222,ECE 45,A01,083139,Congero; Spencer William,5,0,75,70
1656847570251,ECE 65,A50,083695,Saad; Andrew S,12,0,30,18
1656847570251,ECE 65,A51,095125,Saad; Andrew S,25,0,26,1
1656847576277,ECE 109,A01,091882,Touri; Behrouz,16,0,70,54
1656847582306,ECE 180,A00,083140,Abi Samra; Nicholas Camill,0,0,30,30
1656847582306,ECE 180,B00,083141,Abi Samra; Nicholas Camill,0,0,30,30
1656847588348,MATH 10A,A01,083735,Patchell; Gregory David,1,0,30,29
1656847588348,MATH 10A,A02,083736,Patchell; Gregory David,20,0,30,10
1656847588348,MATH 10A,A03,083737,Patchell; Gregory David,15,0,30,15
1656847594381,MATH 10B,A01,083207,Lim; Seonhee,7,0,34,27
1656847594381,MATH 10B,A02,083208,Lim; Seonhee,9,0,35,26
1656847594381,MATH 10B,A03,093472,Lim; Seonhee,4,0,34,30
1656847594381,MATH 10B,B01,083739,Sinha; Shubham,9,0,30,21
1656847600413,MATH 18,A01,083743,Cinel; Cameron Alexander,6,0,30,24
1656847600413,MATH 18,A02,083744,Cinel; Cameron Alexander,15,0,30,15
1656847600413,MATH 18,A03,083745,Cinel; Cameron Alexander,8,0,30,22
1656847600413,MATH 18,B01,083748,Rideout; David Porter,3,0,37,34
1656847600413,MATH 18,B02,083749,Rideout; David Porter,3,0,36,33
1656847600413,MATH 18,B03,083750,Rideout; David Porter,2,0,37,35
1656847600413,MATH 18,B04,083751,Rideout; David Porter,5,0,36,31
1656847600413,MATH 18,B05,093473,Rideout; David Porter,4,0,36,32
1656847600413,MATH 18,B06,093474,Rideout; David Porter,5,0,36,31
1656847606449,MATH 20A,A01,083754,Zheng; Zequn,12,0,40,28
1656847612485,MATH 20B,A01,083756,Briones; Jor-el Thomas Caparas,1,0,36,35
1656847612485,MATH 20B,A02,083757,Briones; Jor-el Thomas Caparas,1,0,36,35
1656847612485,MATH 20B,A03,093475,Briones; Jor-el Thomas Caparas,0,0,36,36
1656847618513,MATH 20C,A01,083760,Briones; Jor-el Thomas Caparas,1,0,35,34
1656847618513,MATH 20C,A02,083761,Briones; Jor-el Thomas Caparas,8,0,35,27
1656847618513,MATH 20C,A03,093476,Briones; Jor-el Thomas Caparas,0,1,36,36
1656847618513,MATH 20C,B01,083762,Bach; Quang Tran,0,0,30,30
1656847624548,MATH 20D,A01,083765,Tran; Brian Kha,4,0,30,26
1656847624548,MATH 20D,A02,083766,Tran; Brian Kha,4,0,30,26
1656847624548,MATH 20D,A03,083767,Tran; Brian Kha,2,0,30,28
1656847630580,MATH 20E,A01,083771,Ganguly; Soumya,5,0,32,27
1656847630580,MATH 20E,A02,083772,Ganguly; Soumya,6,0,32,26
1656847630580,MATH 20E,B01,083773,Ciotti; Benjamin,18,0,35,17
1656847630580,MATH 20E,B02,083774,Ciotti; Benjamin,17,0,35,18
1656847636611,MATH 103A,A01,083777,Greenfeld; Be'Eri,2,0,36,34
1656847636611,MATH 103A,A02,083778,Greenfeld; Be'Eri,5,0,36,31
1656847636611,MATH 103A,A03,093561,Greenfeld; Be'Eri,4,0,36,32
1656847636611,MATH 103A,B01,083779,Greenfeld; Be'Eri,6,0,36,30
1656847636611,MATH 103A,B02,083780,Greenfeld; Be'Eri,2,0,36,34
1656847636611,MATH 103A,B03,093562,Greenfeld; Be'Eri,2,0,36,34
1656847642648,MATH 105,A01,085443,Carter; Anne Toulson,13,0,35,22
1656847642648,MATH 105,A02,093477,Carter; Anne Toulson,20,0,35,15
1656847648673,MATH 109,A01,083213,Ganzberger; Geoffrey Michael,2,0,34,32
1656847648673,MATH 109,A02,083214,Ganzberger; Geoffrey Michael,2,0,34,32
1656847648673,MATH 109,A03,093478,Ganzberger; Geoffrey Michael,1,0,34,33
1656847648673,MATH 109,B01,083215,Ganzberger; Geoffrey Michael,1,0,32,31
1656847648673,MATH 109,B02,083216,Ganzberger; Geoffrey Michael,1,0,32,31
1656847648673,MATH 109,B03,093479,Ganzberger; Geoffrey Michael,6,0,32,26
1656847654704,MATH 142A,A01,083219,Chow; Bennett,6,0,32,26
1656847654704,MATH 142A,A02,083220,Chow; Bennett,9,0,32,23
1656847654704,MATH 142A,A03,093480,Chow; Bennett,7,0,32,25
1656847654704,MATH 142A,B03,093481,Chow; Bennett,7,0,32,25
1656847654704,MATH 142A,B04,093558,Chow; Bennett,10,0,32,22
1656847654704,MATH 142A,B05,093559,Chow; Bennett,6,0,32,26
1656847660734,MATH 193A,A01,083224,Rotar; Vladimir,6,0,34,28
1656847660734,MATH 193A,A02,083225,Rotar; Vladimir,3,0,34,31
1656847660734,MATH 193A,A03,083781,Rotar; Vladimir,1,0,34,33
1656847660734,MATH 193A,A04,083782,Rotar; Vladimir,6,0,34,28
1656847660734,MATH 193A,A05,093482,Rotar; Vladimir,6,0,34,28
1656847666761,MATH 197,001,091859,McAuley; Julian John,9999,0,9999,0
1656847666761,MATH 197,002,095566,Kedlaya; Kiran S.,9997,0,9999,2
1656847666761,MATH 197,003,095567,Xiao; Ming,9999,0,9999,0
1656847666761,MATH 197,004,095571,Perols; Johan Lars,9998,0,9999,1
1656847673824,COGS 9,A01,083615,Shannon; Kyle Michael,6,0,75,69
1656847679858,COGS 11,A01,083617,Boyle; Mary E. T.,18,0,48,30
1656847685894,COGS 13,A01,083071,Bastos; Amalia Pinkusfeld,8,0,71,63
1656847691921,COGS 14A,A01,092681,Semenuks; Arturs,0,1,100,100
1656847697948,COGS 14B,A01,083073,Cheng; Tzu-Han,5,0,63,58
1656847703978,COGS 17,A01,092677,Semenuks; Arturs,4,0,81,77
1656847710008,COGS 100,A01,083619,Allen; Michael Gordon,15,0,70,55
1656847716115,COGS 101A,A01,083621,Davis; Joshua Daniel,9,0,68,59
1656847722156,COGS 101B,A01,091572,Allen; Michael Gordon,8,0,65,57
1656847728188,COGS 101C,A01,083625,Delgado; Tania,17,0,35,18
1656847734216,COGS 107A,A01,083627,Boyle; Mary E. T.,13,0,60,47
1656847740242,COGS 118A,A01,083075,Gupta; Anjum,15,0,76,61
1656847746272,CSE 3,A50,083646,Miranda; Gregory Joseph,22,0,50,28
1656847752299,CSE 8A,A50,083650,Miranda; Gregory Joseph,17,1,56,39
1656847758332,CSE 11,A01,083080,Cao; Yingjun,4,15,40,36
1656847764364,CSE 12,A01,083652,Krause-Levy; Sophia Louisa,20,1,120,100
1656847770391,CSE 15L,A01,083654,Morris; Justin Loren,8,0,50,42
1656847770391,CSE 15L,A02,083655,Morris; Justin Loren,8,0,50,42
1656847776420,CSE 20,A01,083657,Tran; Khoa Dang,37,0,80,43
1656847782450,CSE 21,A01,095574,Bach; Quang Tran,21,0,48,27
1656847788488,CSE 30,A01,083084,Eldon; John,4,0,80,76
1656847788488,CSE 30,B01,095061,Bhaskar; Nishant,6,0,50,44
1656847794517,CSE 100,A01,083659,Cao; Yingjun,2,4,70,68
1656847800553,CSE 134B,A01,083661,Powell; Thomas Allan,19,0,100,81
1656847806580,CSE 140,A01,083663,Gungor; Onat,14,0,85,71
1656847812610,CSE 140L,A01,083088,Eldon; John,16,0,100,84
1656847818636,CSE 175,A01,083665,Kumar; Rakesh,3,0,25,22
1656847824668,CSE 190,A00,092507,Dubnov; Shlomo,7,0,20,13
1656847830706,ECE 45,A01,083139,Congero; Spencer William,5,0,75,70
1656847836740,ECE 65,A50,083695,Saad; Andrew S,12,0,30,18
1656847836740,ECE 65,A51,095125,Saad; Andrew S,25,0,26,1
1656847842768,ECE 109,A01,091882,Touri; Behrouz,16,0,70,54
1656847848803,ECE 180,A00,083140,Abi Samra; Nicholas Camill,0,0,30,30
1656847848803,ECE 180,B00,083141,Abi Samra; Nicholas Camill,0,0,30,30
1656847854833,MATH 10A,A01,083735,Patchell; Gregory David,1,0,30,29
1656847854833,MATH 10A,A02,083736,Patchell; Gregory David,20,0,30,10
1656847854833,MATH 10A,A03,083737,Patchell; Gregory David,15,0,30,15
1656847860865,MATH 10B,A01,083207,Lim; Seonhee,7,0,34,27
1656847860865,MATH 10B,A02,083208,Lim; Seonhee,9,0,35,26
1656847860865,MATH 10B,A03,093472,Lim; Seonhee,4,0,34,30
1656847860865,MATH 10B,B01,083739,Sinha; Shubham,9,0,30,21
1656847866900,MATH 18,A01,083743,Cinel; Cameron Alexander,6,0,30,24
1656847866900,MATH 18,A02,083744,Cinel; Cameron Alexander,15,0,30,15
1656847866900,MATH 18,A03,083745,Cinel; Cameron Alexander,8,0,30,22
1656847866900,MATH 18,B01,083748,Rideout; David Porter,3,0,37,34
1656847866900,MATH 18,B02,083749,Rideout; David Porter,3,0,36,33
1656847866900,MATH 18,B03,083750,Rideout; David Porter,2,0,37,35
1656847866900,MATH 18,B04,083751,Rideout; David Porter,5,0,36,31
1656847866900,MATH 18,B05,093473,Rideout; David Porter,4,0,36,32
1656847866900,MATH 18,B06,093474,Rideout; David Porter,5,0,36,31
1656847872933,MATH 20A,A01,083754,Zheng; Zequn,12,0,40,28
1656847878963,MATH 20B,A01,083756,Briones; Jor-el Thomas Caparas,1,0,36,35
1656847878963,MATH 20B,A02,083757,Briones; Jor-el Thomas Caparas,1,0,36,35
1656847878963,MATH 20B,A03,093475,Briones; Jor-el Thomas Caparas,0,0,36,36
1656847884997,MATH 20C,A01,083760,Briones; Jor-el Thomas Caparas,1,0,35,34
1656847884997,MATH 20C,A02,083761,Briones; Jor-el Thomas Caparas,8,0,35,27
1656847884997,MATH 20C,A03,093476,Briones; Jor-el Thomas Caparas,0,1,36,36
1656847884997,MATH 20C,B01,083762,Bach; Quang Tran,0,0,30,30
1656847891027,MATH 20D,A01,083765,Tran; Brian Kha,4,0,30,26
1656847891027,MATH 20D,A02,083766,Tran; Brian Kha,4,0,30,26
1656847891027,MATH 20D,A03,083767,Tran; Brian Kha,2,0,30,28
1656847897063,MATH 20E,A01,083771,Ganguly; Soumya,5,0,32,27
1656847897063,MATH 20E,A02,083772,Ganguly; Soumya,6,0,32,26
1656847897063,MATH 20E,B01,083773,Ciotti; Benjamin,18,0,35,17
1656847897063,MATH 20E,B02,083774,Ciotti; Benjamin,17,0,35,18
1656847903094,MATH 103A,A01,083777,Greenfeld; Be'Eri,2,0,36,34
1656847903094,MATH 103A,A02,083778,Greenfeld; Be'Eri,5,0,36,31
1656847903094,MATH 103A,A03,093561,Greenfeld; Be'Eri,4,0,36,32
1656847903094,MATH 103A,B01,083779,Greenfeld; Be'Eri,6,0,36,30
1656847903094,MATH 103A,B02,083780,Greenfeld; Be'Eri,2,0,36,34
1656847903094,MATH 103A,B03,093562,Greenfeld; Be'Eri,2,0,36,34
1656847909140,MATH 105,A01,085443,Carter; Anne Toulson,13,0,35,22
1656847909140,MATH 105,A02,093477,Carter; Anne Toulson,20,0,35,15
1656847915174,MATH 109,A01,083213,Ganzberger; Geoffrey Michael,2,0,34,32
1656847915174,MATH 109,A02,083214,Ganzberger; Geoffrey Michael,2,0,34,32
1656847915174,MATH 109,A03,093478,Ganzberger; Geoffrey Michael,1,0,34,33
1656847915174,MATH 109,B01,083215,Ganzberger; Geoffrey Michael,1,0,32,31
1656847915174,MATH 109,B02,083216,Ganzberger; Geoffrey Michael,1,0,32,31
1656847915174,MATH 109,B03,093479,Ganzberger; Geoffrey Michael,6,0,32,26
1656847921210,MATH 142A,A01,083219,Chow; Bennett,6,0,32,26
1656847921210,MATH 142A,A02,083220,Chow; Bennett,9,0,32,23
1656847921210,MATH 142A,A03,093480,Chow; Bennett,7,0,32,25
1656847921210,MATH 142A,B03,093481,Chow; Bennett,7,0,32,25
1656847921210,MATH 142A,B04,093558,Chow; Bennett,10,0,32,22
1656847921210,MATH 142A,B05,093559,Chow; Bennett,6,0,32,26
1656847927246,MATH 193A,A01,083224,Rotar; Vladimir,6,0,34,28
1656847927246,MATH 193A,A02,083225,Rotar; Vladimir,3,0,34,31
1656847927246,MATH 193A,A03,083781,Rotar; Vladimir,1,0,34,33
1656847927246,MATH 193A,A04,083782,Rotar; Vladimir,6,0,34,28
1656847927246,MATH 193A,A05,093482,Rotar; Vladimir,6,0,34,28
1656847933276,MATH 197,001,091859,McAuley; Julian John,9999,0,9999,0
1656847933276,MATH 197,002,095566,Kedlaya; Kiran S.,9997,0,9999,2
1656847933276,MATH 197,003,095567,Xiao; Ming,9999,0,9999,0
1656847933276,MATH 197,004,095571,Perols; Johan Lars,9998,0,9999,1
1656847940359,COGS 9,A01,083615,Shannon; Kyle Michael,6,0,75,69
1656847946391,COGS 11,A01,083617,Boyle; Mary E. T.,18,0,48,30
1656847952420,COGS 13,A01,083071,Bastos; Amalia Pinkusfeld,8,0,71,63
1656847958455,COGS 14A,A01,092681,Semenuks; Arturs,0,1,100,100
1656847964491,COGS 14B,A01,083073,Cheng; Tzu-Han,5,0,63,58
1656847970516,COGS 17,A01,092677,Semenuks; Arturs,4,0,81,77
1656847976548,COGS 100,A01,083619,Allen; Michael Gordon,15,0,70,55
1656847982578,COGS 101A,A01,083621,Davis; Joshua Daniel,9,0,68,59
1656847988603,COGS 101B,A01,091572,Allen; Michael Gordon,8,0,65,57
1656847994636,COGS 101C,A01,083625,Delgado; Tania,17,0,35,18
1656848000667,COGS 107A,A01,083627,Boyle; Mary E. T.,13,0,60,47
1656848006697,COGS 118A,A01,083075,Gupta; Anjum,15,0,76,61
1656848012728,CSE 3,A50,083646,Miranda; Gregory Joseph,22,0,50,28
1656848018758,CSE 8A,A50,083650,Miranda; Gregory Joseph,17,1,56,39
1656848024790,CSE 11,A01,083080,Cao; Yingjun,4,15,40,36
1656848030819,CSE 12,A01,083652,Krause-Levy; Sophia Louisa,20,1,120,100
1656848036846,CSE 15L,A01,083654,Morris; Justin Loren,8,0,50,42
1656848036846,CSE 15L,A02,083655,Morris; Justin Loren,8,0,50,42
1656848042873,CSE 20,A01,083657,Tran; Khoa Dang,37,0,80,43
1656848048903,CSE 21,A01,095574,Bach; Quang Tran,21,0,48,27
1656848054938,CSE 30,A01,083084,Eldon; John,4,0,80,76
1656848054938,CSE 30,B01,095061,Bhaskar; Nishant,6,0,50,44
1656848060968,CSE 100,A01,083659,Cao; Yingjun,2,4,70,68
1656848066994,CSE 134B,A01,083661,Powell; Thomas Allan,19,0,100,81
1656848073023,CSE 140,A01,083663,Gungor; Onat,14,0,85,71
1656848079052,CSE 140L,A01,083088,Eldon; John,16,0,100,84
1656848085080,CSE 175,A01,083665,Kumar; Rakesh,3,0,25,22
1656848091107,CSE 190,A00,092507,Dubnov; Shlomo,7,0,20,13
1656848097133,ECE 45,A01,083139,Congero; Spencer William,5,0,75,70
1656848103161,ECE 65,A50,083695,Saad; Andrew S,12,0,30,18
1656848103161,ECE 65,A51,095125,Saad; Andrew S,25,0,26,1
1656848109188,ECE 109,A01,091882,Touri; Behrouz,16,0,70,54
1656848115221,ECE 180,A00,083140,Abi Samra; Nicholas Camill,0,0,30,30
1656848115221,ECE 180,B00,083141,Abi Samra; Nicholas Camill,0,0,30,30
1656848121249,MATH 10A,A01,083735,Patchell; Gregory David,1,0,30,29
1656848121249,MATH 10A,A02,083736,Patchell; Gregory David,20,0,30,10
1656848121249,MATH 10A,A03,083737,Patchell; Gregory David,15,0,30,15
1656848127280,MATH 10B,A01,083207,Lim; Seonhee,7,0,34,27
1656848127280,MATH 10B,A02,083208,Lim; Seonhee,9,0,35,26
1656848127280,MATH 10B,A03,093472,Lim; Seonhee,4,0,34,30
1656848127280,MATH 10B,B01,083739,Sinha; Shubham,9,0,30,21
1656848133321,MATH 18,A01,083743,Cinel; Cameron Alexander,6,0,30,24
1656848133321,MATH 18,A02,083744,Cinel; Cameron Alexander,15,0,30,15
1656848133321,MATH 18,A03,083745,Cinel; Cameron Alexander,8,0,30,22
1656848133321,MATH 18,B01,083748,Rideout; David Porter,3,0,37,34
1656848133321,MATH 18,B02,083749,Rideout; David Porter,3,0,36,33
1656848133321,MATH 18,B03,083750,Rideout; David Porter,2,0,37,35
1656848133321,MATH 18,B04,083751,Rideout; David Porter,5,0,36,31
1656848133321,MATH 18,B05,093473,Rideout; David Porter,4,0,36,32
1656848133321,MATH 18,B06,093474,Rideout; David Porter,5,0,36,31
1656848139352,MATH 20A,A01,083754,Zheng; Zequn,12,0,40,28
1656848145403,MATH 20B,A01,083756,Briones; Jor-el Thomas Caparas,1,0,36,35
1656848145403,MATH 20B,A02,083757,Briones; Jor-el Thomas Caparas,1,0,36,35
1656848145403,MATH 20B,A03,093475,Briones; Jor-el Thomas Caparas,0,0,36,36
1656848151431,MATH 20C,A01,083760,Briones; Jor-el Thomas Caparas,1,0,35,34
1656848151431,MATH 20C,A02,083761,Briones; Jor-el Thomas Caparas,8,0,35,27
1656848151431,MATH 20C,A03,093476,Briones; Jor-el Thomas Caparas,0,1,36,36
1656848151431,MATH 20C,B01,083762,Bach; Quang Tran,0,0,30,30
1656848157457,MATH 20D,A01,083765,Tran; Brian Kha,4,0,30,26
1656848157457,MATH 20D,A02,083766,Tran; Brian Kha,4,0,30,26
1656848157457,MATH 20D,A03,083767,Tran; Brian Kha,2,0,30,28
1656848163492,MATH 20E,A01,083771,Ganguly; Soumya,5,0,32,27
1656848163492,MATH 20E,A02,083772,Ganguly; Soumya,6,0,32,26
1656848163492,MATH 20E,B01,083773,Ciotti; Benjamin,18,0,35,17
1656848163492,MATH 20E,B02,083774,Ciotti; Benjamin,17,0,35,18
1656848169524,MATH 103A,A01,083777,Greenfeld; Be'Eri,2,0,36,34
1656848169524,MATH 103A,A02,083778,Greenfeld; Be'Eri,5,0,36,31
1656848169524,MATH 103A,A03,093561,Greenfeld; Be'Eri,4,0,36,32
1656848169524,MATH 103A,B01,083779,Greenfeld; Be'Eri,6,0,36,30
1656848169524,MATH 103A,B02,083780,Greenfeld; Be'Eri,2,0,36,34
1656848169524,MATH 103A,B03,093562,Greenfeld; Be'Eri,2,0,36,34
1656848175557,MATH 105,A01,085443,Carter; Anne Toulson,13,0,35,22
1656848175557,MATH 105,A02,093477,Carter; Anne Toulson,20,0,35,15
1656848181594,MATH 109,A01,083213,Ganzberger; Geoffrey Michael,2,0,34,32
1656848181594,MATH 109,A02,083214,Ganzberger; Geoffrey Michael,2,0,34,32
1656848181594,MATH 109,A03,093478,Ganzberger; Geoffrey Michael,1,0,34,33
1656848181594,MATH 109,B01,083215,Ganzberger; Geoffrey Michael,1,0,32,31
1656848181594,MATH 109,B02,083216,Ganzberger; Geoffrey Michael,1,0,32,31
1656848181594,MATH 109,B03,093479,Ganzberger; Geoffrey Michael,6,0,32,26
1656848187629,MATH 142A,A01,083219,Chow; Bennett,6,0,32,26
1656848187629,MATH 142A,A02,083220,Chow; Bennett,9,0,32,23
1656848187629,MATH 142A,A03,093480,Chow; Bennett,7,0,32,25
1656848187629,MATH 142A,B03,093481,Chow; Bennett,7,0,32,25
1656848187629,MATH 142A,B04,093558,Chow; Bennett,10,0,32,22
1656848187629,MATH 142A,B05,093559,Chow; Bennett,6,0,32,26
1656848193669,MATH 193A,A01,083224,Rotar; Vladimir,6,0,34,28
1656848193669,MATH 193A,A02,083225,Rotar; Vladimir,3,0,34,31
1656848193669,MATH 193A,A03,083781,Rotar; Vladimir,1,0,34,33
1656848193669,MATH 193A,A04,083782,Rotar; Vladimir,6,0,34,28
1656848193669,MATH 193A,A05,093482,Rotar; Vladimir,6,0,34,28
1656848199698,MATH 197,001,091859,McAuley; Julian John,9999,0,9999,0
1656848199698,MATH 197,002,095566,Kedlaya; Kiran S.,9997,0,9999,2
1656848199698,MATH 197,003,095567,Xiao; Ming,9999,0,9999,0
1656848199698,MATH 197,004,095571,Perols; Johan Lars,9998,0,9999,1
1656848206776,COGS 9,A01,083615,Shannon; Kyle Michael,6,0,75,69
1656848212808,COGS 11,A01,083617,Boyle; Mary E. T.,18,0,48,30
1656848218834,COGS 13,A01,083071,Bastos; Amalia Pinkusfeld,8,0,71,63
1656848224863,COGS 14A,A01,092681,Semenuks; Arturs,0,1,100,100
1656848230892,COGS 14B,A01,083073,Cheng; Tzu-Han,5,0,63,58
1656848236922,COGS 17,A01,092677,Semenuks; Arturs,4,0,81,77
1656848242955,COGS 100,A01,083619,Allen; Michael Gordon,15,0,70,55
1656848248982,COGS 101A,A01,083621,Davis; Joshua Daniel,9,0,68,59
1656848255015,COGS 101B,A01,091572,Allen; Michael Gordon,8,0,65,57
1656848261040,COGS 101C,A01,083625,Delgado; Tania,17,0,35,18
1656848267067,COGS 107A,A01,083627,Boyle; Mary E. T.,13,0,60,47
1656848273094,COGS 118A,A01,083075,Gupta; Anjum,15,0,76,61
1656848279128,CSE 3,A50,083646,Miranda; Gregory Joseph,22,0,50,28
1656848285158,CSE 8A,A50,083650,Miranda; Gregory Joseph,17,1,56,39
1656848291181,CSE 11,A01,083080,Cao; Yingjun,4,15,40,36
1656848297210,CSE 12,A01,083652,Krause-Levy; Sophia Louisa,20,1,120,100
1656848303237,CSE 15L,A01,083654,Morris; Justin Loren,8,0,50,42
1656848303237,CSE 15L,A02,083655,Morris; Justin Loren,8,0,50,42
1656848309266,CSE 20,A01,083657,Tran; Khoa Dang,37,0,80,43
1656848315370,CSE 21,A01,095574,Bach; Quang Tran,21,0,48,27
1656848321403,CSE 30,A01,083084,Eldon; John,4,0,80,76
1656848321403,CSE 30,B01,095061,Bhaskar; Nishant,6,0,50,44
1656848327435,CSE 100,A01,083659,Cao; Yingjun,2,4,70,68
1656848333461,CSE 134B,A01,083661,Powell; Thomas Allan,19,0,100,81
1656848339488,CSE 140,A01,083663,Gungor; Onat,14,0,85,71
1656848345515,CSE 140L,A01,083088,Eldon; John,16,0,100,84
1656848351544,CSE 175,A01,083665,Kumar; Rakesh,3,0,25,22
1656848357578,CSE 190,A00,092507,Dubnov; Shlomo,7,0,20,13
1656848363605,ECE 45,A01,083139,Congero; Spencer William,5,0,75,70
1656848369631,ECE 65,A50,083695,Saad; Andrew S,12,0,30,18
1656848369631,ECE 65,A51,095125,Saad; Andrew S,25,0,26,1
1656848375658,ECE 109,A01,091882,Touri; Behrouz,16,0,70,54
1656848381687,ECE 180,A00,083140,Abi Samra; Nicholas Camill,0,0,30,30
1656848381687,ECE 180,B00,083141,Abi Samra; Nicholas Camill,0,0,30,30
1656848387713,MATH 10A,A01,083735,Patchell; Gregory David,1,0,30,29
1656848387713,MATH 10A,A02,083736,Patchell; Gregory David,20,0,30,10
1656848387713,MATH 10A,A03,083737,Patchell; Gregory David,15,0,30,15
1656848393743,MATH 10B,A01,083207,Lim; Seonhee,7,0,34,27
1656848393743,MATH 10B,A02,083208,Lim; Seonhee,9,0,35,26
1656848393743,MATH 10B,A03,093472,Lim; Seonhee,4,0,34,30
1656848393743,MATH 10B,B01,083739,Sinha; Shubham,9,0,30,21
1656848399785,MATH 18,A01,083743,Cinel; Cameron Alexander,6,0,30,24
1656848399785,MATH 18,A02,083744,Cinel; Cameron Alexander,15,0,30,15
1656848399785,MATH 18,A03,083745,Cinel; Cameron Alexander,8,0,30,22
1656848399785,MATH 18,B01,083748,Rideout; David Porter,3,0,37,34
1656848399785,MATH 18,B02,083749,Rideout; David Porter,3,0,36,33
1656848399785,MATH 18,B03,083750,Rideout; David Porter,2,0,37,35
1656848399785,MATH 18,B04,083751,Rideout; David Porter,5,0,36,31
1656848399785,MATH 18,B05,093473,Rideout; David Porter,4,0,36,32
1656848399785,MATH 18,B06,093474,Rideout; David Porter,5,0,36,31
1656848405812,MATH 20A,A01,083754,Zheng; Zequn,12,0,40,28
1656848411840,MATH 20B,A01,083756,Briones; Jor-el Thomas Caparas,1,0,36,35
1656848411840,MATH 20B,A02,083757,Briones; Jor-el Thomas Caparas,1,0,36,35
1656848411840,MATH 20B,A03,093475,Briones; Jor-el Thomas Caparas,0,0,36,36
1656848417873,MATH 20C,A01,083760,Briones; Jor-el Thomas Caparas,1,0,35,34
1656848417873,MATH 20C,A02,083761,Briones; Jor-el Thomas Caparas,8,0,35,27
1656848417873,MATH 20C,A03,093476,Briones; Jor-el Thomas Caparas,0,1,36,36
1656848417873,MATH 20C,B01,083762,Bach; Quang Tran,0,0,30,30
1656848423907,MATH 20D,A01,083765,Tran; Brian Kha,4,0,30,26
1656848423907,MATH 20D,A02,083766,Tran; Brian Kha,4,0,30,26
1656848423907,MATH 20D,A03,083767,Tran; Brian Kha,2,0,30,28
1656848429934,MATH 20E,A01,083771,Ganguly; Soumya,5,0,32,27
1656848429934,MATH 20E,A02,083772,Ganguly; Soumya,6,0,32,26
1656848429934,MATH 20E,B01,083773,Ciotti; Benjamin,18,0,35,17
1656848429934,MATH 20E,B02,083774,Ciotti; Benjamin,17,0,35,18
1656848435962,MATH 103A,A01,083777,Greenfeld; Be'Eri,2,0,36,34
1656848435962,MATH 103A,A02,083778,Greenfeld; Be'Eri,5,0,36,31
1656848435962,MATH 103A,A03,093561,Greenfeld; Be'Eri,4,0,36,32
1656848435962,MATH 103A,B01,083779,Greenfeld; Be'Eri,6,0,36,30
1656848435962,MATH 103A,B02,083780,Greenfeld; Be'Eri,2,0,36,34
1656848435962,MATH 103A,B03,093562,Greenfeld; Be'Eri,2,0,36,34
1656848441994,MATH 105,A01,085443,Carter; Anne Toulson,13,0,35,22
1656848441994,MATH 105,A02,093477,Carter; Anne Toulson,20,0,35,15
1656848448023,MATH 109,A01,083213,Ganzberger; Geoffrey Michael,2,0,34,32
1656848448023,MATH 109,A02,083214,Ganzberger; Geoffrey Michael,2,0,34,32
1656848448023,MATH 109,A03,093478,Ganzberger; Geoffrey Michael,1,0,34,33
1656848448023,MATH 109,B01,083215,Ganzberger; Geoffrey Michael,1,0,32,31
1656848448023,MATH 109,B02,083216,Ganzberger; Geoffrey Michael,1,0,32,31
1656848448023,MATH 109,B03,093479,Ganzberger; Geoffrey Michael,6,0,32,26
1656848454048,MATH 142A,A01,083219,Chow; Bennett,6,0,32,26
1656848454048,MATH 142A,A02,083220,Chow; Bennett,9,0,32,23
1656848454048,MATH 142A,A03,093480,Chow; Bennett,7,0,32,25
1656848454048,MATH 142A,B03,093481,Chow; Bennett,7,0,32,25
1656848454048,MATH 142A,B04,093558,Chow; Bennett,10,0,32,22
1656848454048,MATH 142A,B05,093559,Chow; Bennett,6,0,32,26
1656848460077,MATH 193A,A01,083224,Rotar; Vladimir,6,0,34,28
1656848460077,MATH 193A,A02,083225,Rotar; Vladimir,3,0,34,31
1656848460077,MATH 193A,A03,083781,Rotar; Vladimir,1,0,34,33
1656848460077,MATH 193A,A04,083782,Rotar; Vladimir,6,0,34,28
1656848460077,MATH 193A,A05,093482,Rotar; Vladimir,6,0,34,28
1656848466103,MATH 197,001,091859,McAuley; Julian John,9999,0,9999,0
1656848466103,MATH 197,002,095566,Kedlaya; Kiran S.,9997,0,9999,2
1656848466103,MATH 197,003,095567,Xiao; Ming,9999,0,9999,0
1656848466103,MATH 197,004,095571,Perols; Johan Lars,9998,0,9999,1
1656848473167,COGS 9,A01,083615,Shannon; Kyle Michael,6,0,75,69
1656848479191,COGS 11,A01,083617,Boyle; Mary E. T.,18,0,48,30
1656848485215,COGS 13,A01,083071,Bastos; Amalia Pinkusfeld,8,0,71,63
1656848491256,COGS 14A,A01,092681,Semenuks; Arturs,0,1,100,100
1656848497282,COGS 14B,A01,083073,Cheng; Tzu-Han,5,0,63,58
1656848503308,COGS 17,A01,092677,Semenuks; Arturs,4,0,81,77
1656848509342,COGS 100,A01,083619,Allen; Michael Gordon,15,0,70,55
1656848515368,COGS 101A,A01,083621,Davis; Joshua Daniel,9,0,68,59
1656848521392,COGS 101B,A01,091572,Allen; Michael Gordon,8,0,65,57
1656848527419,COGS 101C,A01,083625,Delgado; Tania,17,0,35,18
1656848533442,COGS 107A,A01,083627,Boyle; Mary E. T.,13,0,60,47
1656848539471,COGS 118A,A01,083075,Gupta; Anjum,15,0,76,61
1656848545496,CSE 3,A50,083646,Miranda; Gregory Joseph,22,0,50,28
1656848551526,CSE 8A,A50,083650,Miranda; Gregory Joseph,17,1,56,39
1656848557552,CSE 11,A01,083080,Cao; Yingjun,4,15,40,36
1656848563579,CSE 12,A01,083652,Krause-Levy; Sophia Louisa,20,1,120,100
1656848569606,CSE 15L,A01,083654,Morris; Justin Loren,8,0,50,42
1656848569606,CSE 15L,A02,083655,Morris; Justin Loren,8,0,50,42
1656848575631,CSE 20,A01,083657,Tran; Khoa Dang,37,0,80,43
1656848581657,CSE 21,A01,095574,Bach; Quang Tran,21,0,48,27
1656848587683,CSE 30,A01,083084,Eldon; John,4,0,80,76
1656848587683,CSE 30,B01,095061,Bhaskar; Nishant,6,0,50,44
1656848593707,CSE 100,A01,083659,Cao; Yingjun,2,4,70,68
1656848599737,CSE 134B,A01,083661,Powell; Thomas Allan,19,0,100,81
1656848605769,CSE 140,A01,083663,Gungor; Onat,14,0,85,71
1656848611794,CSE 140L,A01,083088,Eldon; John,16,0,100,84
1656848617818,CSE 175,A01,083665,Kumar; Rakesh,3,0,25,22
1656848623843,CSE 190,A00,092507,Dubnov; Shlomo,7,0,20,13
1656848629874,ECE 45,A01,083139,Congero; Spencer William,5,0,75,70
1656848635903,ECE 65,A50,083695,Saad; Andrew S,12,0,30,18
1656848635903,ECE 65,A51,095125,Saad; Andrew S,25,0,26,1
1656848641929,ECE 109,A01,091882,Touri; Behrouz,16,0,70,54
1656848647954,ECE 180,A00,083140,Abi Samra; Nicholas Camill,0,0,30,30
1656848647954,ECE 180,B00,083141,Abi Samra; Nicholas Camill,0,0,30,30
1656848653993,MATH 10A,A01,083735,Patchell; Gregory David,1,0,30,29
1656848653993,MATH 10A,A02,083736,Patchell; Gregory David,20,0,30,10
1656848653993,MATH 10A,A03,083737,Patchell; Gregory David,15,0,30,15
1656848660023,MATH 10B,A01,083207,Lim; Seonhee,7,0,34,27
1656848660023,MATH 10B,A02,083208,Lim; Seonhee,9,0,35,26
1656848660023,MATH 10B,A03,093472,Lim; Seonhee,4,0,34,30
1656848660023,MATH 10B,B01,083739,Sinha; Shubham,9,0,30,21
1656848666054,MATH 18,A01,083743,Cinel; Cameron Alexander,6,0,30,24
1656848666054,MATH 18,A02,083744,Cinel; Cameron Alexander,15,0,30,15
1656848666054,MATH 18,A03,083745,Cinel; Cameron Alexander,8,0,30,22
1656848666054,MATH 18,B01,083748,Rideout; David Porter,3,0,37,34
1656848666054,MATH 18,B02,083749,Rideout; David Porter,3,0,36,33
1656848666054,MATH 18,B03,083750,Rideout; David Porter,2,0,37,35
1656848666054,MATH 18,B04,083751,Rideout; David Porter,5,0,36,31
1656848666054,MATH 18,B05,093473,Rideout; David Porter,4,0,36,32
1656848666054,MATH 18,B06,093474,Rideout; David Porter,5,0,36,31
1656848672080,MATH 20A,A01,083754,Zheng; Zequn,12,0,40,28
1656848678110,MATH 20B,A01,083756,Briones; Jor-el Thomas Caparas,1,0,36,35
1656848678110,MATH 20B,A02,083757,Briones; Jor-el Thomas Caparas,1,0,36,35
1656848678110,MATH 20B,A03,093475,Briones; Jor-el Thomas Caparas,0,0,36,36
1656848684143,MATH 20C,A01,083760,Briones; Jor-el Thomas Caparas,1,0,35,34
1656848684143,MATH 20C,A02,083761,Briones; Jor-el Thomas Caparas,8,0,35,27
1656848684143,MATH 20C,A03,093476,Briones; Jor-el Thomas Caparas,0,1,36,36
1656848684143,MATH 20C,B01,083762,Bach; Quang Tran,0,0,30,30
1656848690169,MATH 20D,A01,083765,Tran; Brian Kha,4,0,30,26
1656848690169,MATH 20D,A02,083766,Tran; Brian Kha,4,0,30,26
1656848690169,MATH 20D,A03,083767,Tran; Brian Kha,2,0,30,28
1656848696204,MATH 20E,A01,083771,Ganguly; Soumya,5,0,32,27
1656848696204,MATH 20E,A02,083772,Ganguly; Soumya,6,0,32,26
1656848696204,MATH 20E,B01,083773,Ciotti; Benjamin,18,0,35,17
1656848696204,MATH 20E,B02,083774,Ciotti; Benjamin,17,0,35,18
1656848702241,MATH 103A,A01,083777,Greenfeld; Be'Eri,2,0,36,34
1656848702241,MATH 103A,A02,083778,Greenfeld; Be'Eri,5,0,36,31
1656848702241,MATH 103A,A03,093561,Greenfeld; Be'Eri,4,0,36,32
1656848702241,MATH 103A,B01,083779,Greenfeld; Be'Eri,6,0,36,30
1656848702241,MATH 103A,B02,083780,Greenfeld; Be'Eri,2,0,36,34
1656848702241,MATH 103A,B03,093562,Greenfeld; Be'Eri,2,0,36,34
1656848708276,MATH 105,A01,085443,Carter; Anne Toulson,13,0,35,22
1656848708276,MATH 105,A02,093477,Carter; Anne Toulson,20,0,35,15
1656848714310,MATH 109,A01,083213,Ganzberger; Geoffrey Michael,2,0,34,32
1656848714310,MATH 109,A02,083214,Ganzberger; Geoffrey Michael,2,0,34,32
1656848714310,MATH 109,A03,093478,Ganzberger; Geoffrey Michael,1,0,34,33
1656848714310,MATH 109,B01,083215,Ganzberger; Geoffrey Michael,1,0,32,31
1656848714310,MATH 109,B02,083216,Ganzberger; Geoffrey Michael,1,0,32,31
1656848714310,MATH 109,B03,093479,Ganzberger; Geoffrey Michael,6,0,32,26
1656848720347,MATH 142A,A01,083219,Chow; Bennett,6,0,32,26
1656848720347,MATH 142A,A02,083220,Chow; Bennett,9,0,32,23
1656848720347,MATH 142A,A03,093480,Chow; Bennett,7,0,32,25
1656848720347,MATH 142A,B03,093481,Chow; Bennett,7,0,32,25
1656848720347,MATH 142A,B04,093558,Chow; Bennett,10,0,32,22
1656848720347,MATH 142A,B05,093559,Chow; Bennett,6,0,32,26
1656848726382,MATH 193A,A01,083224,Rotar; Vladimir,6,0,34,28
1656848726382,MATH 193A,A02,083225,Rotar; Vladimir,3,0,34,31
1656848726382,MATH 193A,A03,083781,Rotar; Vladimir,1,0,34,33
1656848726382,MATH 193A,A04,083782,Rotar; Vladimir,6,0,34,28
1656848726382,MATH 193A,A05,093482,Rotar; Vladimir,6,0,34,28
1656848732411,MATH 197,001,091859,McAuley; Julian John,9999,0,9999,0
1656848732411,MATH 197,002,095566,Kedlaya; Kiran S.,9997,0,9999,2
1656848732411,MATH 197,003,095567,Xiao; Ming,9999,0,9999,0
1656848732411,MATH 197,004,095571,Perols; Johan Lars,9998,0,9999,1
1656848739502,COGS 9,A01,083615,Shannon; Kyle Michael,6,0,75,69
1656848745532,COGS 11,A01,083617,Boyle; Mary E. T.,18,0,48,30
1656848751565,COGS 13,A01,083071,Bastos; Amalia Pinkusfeld,8,0,71,63
1656848757592,COGS 14A,A01,092681,Semenuks; Arturs,0,1,100,100
1656848763619,COGS 14B,A01,083073,Cheng; Tzu-Han,5,0,63,58
1656848769670,COGS 17,A01,092677,Semenuks; Arturs,4,0,81,77
1656848775698,COGS 100,A01,083619,Allen; Michael Gordon,15,0,70,55
1656848781725,COGS 101A,A01,083621,Davis; Joshua Daniel,9,0,68,59
1656848787775,COGS 101B,A01,091572,Allen; Michael Gordon,8,0,65,57
1656848793826,COGS 101C,A01,083625,Delgado; Tania,17,0,35,18
1656848799857,COGS 107A,A01,083627,Boyle; Mary E. T.,13,0,60,47
1656848805890,COGS 118A,A01,083075,Gupta; Anjum,15,0,76,61
1656848811926,CSE 3,A50,083646,Miranda; Gregory Joseph,22,0,50,28
1656848817957,CSE 8A,A50,083650,Miranda; Gregory Joseph,17,1,56,39
1656848823984,CSE 11,A01,083080,Cao; Yingjun,4,15,40,36
1656848830022,CSE 12,A01,083652,Krause-Levy; Sophia Louisa,20,1,120,100
1656848836048,CSE 15L,A01,083654,Morris; Justin Loren,8,0,50,42
1656848836048,CSE 15L,A02,083655,Morris; Justin Loren,8,0,50,42
1656848842079,CSE 20,A01,083657,Tran; Khoa Dang,37,0,80,43
1656848848114,CSE 21,A01,095574,Bach; Quang Tran,21,0,48,27
1656848854146,CSE 30,A01,083084,Eldon; John,4,0,80,76
1656848854146,CSE 30,B01,095061,Bhaskar; Nishant,6,0,50,44
1656848860173,CSE 100,A01,083659,Cao; Yingjun,2,4,70,68
1656848866199,CSE 134B,A01,083661,Powell; Thomas Allan,19,0,100,81
1656848872232,CSE 140,A01,083663,Gungor; Onat,14,0,85,71
1656848878264,CSE 140L,A01,083088,Eldon; John,16,0,100,84
1656848884291,CSE 175,A01,083665,Kumar; Rakesh,3,0,25,22
1656848890320,CSE 190,A00,092507,Dubnov; Shlomo,7,0,20,13
1656848896346,ECE 45,A01,083139,Congero; Spencer William,5,0,75,70
1656848902375,ECE 65,A50,083695,Saad; Andrew S,12,0,30,18
1656848902375,ECE 65,A51,095125,Saad; Andrew S,25,0,26,1
1656848908408,ECE 109,A01,091882,Touri; Behrouz,16,0,70,54
1656848914510,ECE 180,A00,083140,Abi Samra; Nicholas Camill,0,0,30,30
1656848914510,ECE 180,B00,083141,Abi Samra; Nicholas Camill,0,0,30,30
1656848920548,MATH 10A,A01,083735,Patchell; Gregory David,1,0,30,29
1656848920548,MATH 10A,A02,083736,Patchell; Gregory David,20,0,30,10
1656848920548,MATH 10A,A03,083737,Patchell; Gregory David,15,0,30,15
1656848926580,MATH 10B,A01,083207,Lim; Seonhee,7,0,34,27
1656848926580,MATH 10B,A02,083208,Lim; Seonhee,9,0,35,26
1656848926580,MATH 10B,A03,093472,Lim; Seonhee,4,0,34,30
1656848926580,MATH 10B,B01,083739,Sinha; Shubham,9,0,30,21
1656848932612,MATH 18,A01,083743,Cinel; Cameron Alexander,6,0,30,24
1656848932612,MATH 18,A02,083744,Cinel; Cameron Alexander,15,0,30,15
1656848932612,MATH 18,A03,083745,Cinel; Cameron Alexander,8,0,30,22
1656848932612,MATH 18,B01,083748,Rideout; David Porter,3,0,37,34
1656848932612,MATH 18,B02,083749,Rideout; David Porter,3,0,36,33
1656848932612,MATH 18,B03,083750,Rideout; David Porter,2,0,37,35
1656848932612,MATH 18,B04,083751,Rideout; David Porter,5,0,36,31
1656848932612,MATH 18,B05,093473,Rideout; David Porter,4,0,36,32
1656848932612,MATH 18,B06,093474,Rideout; David Porter,5,0,36,31
1656848938638,MATH 20A,A01,083754,Zheng; Zequn,12,0,40,28
1656848944672,MATH 20B,A01,083756,Briones; Jor-el Thomas Caparas,1,0,36,35
1656848944672,MATH 20B,A02,083757,Briones; Jor-el Thomas Caparas,1,0,36,35
1656848944672,MATH 20B,A03,093475,Briones; Jor-el Thomas Caparas,0,0,36,36
1656848950709,MATH 20C,A01,083760,Briones; Jor-el Thomas Caparas,1,0,35,34
1656848950709,MATH 20C,A02,083761,Briones; Jor-el Thomas Caparas,8,0,35,27
1656848950709,MATH 20C,A03,093476,Briones; Jor-el Thomas Caparas,0,1,36,36
1656848950709,MATH 20C,B01,083762,Bach; Quang Tran,0,0,30,30
1656848956735,MATH 20D,A01,083765,Tran; Brian Kha,4,0,30,26
1656848956735,MATH 20D,A02,083766,Tran; Brian Kha,4,0,30,26
1656848956735,MATH 20D,A03,083767,Tran; Brian Kha,2,0,30,28
1656848962765,MATH 20E,A01,083771,Ganguly; Soumya,5,0,32,27
1656848962765,MATH 20E,A02,083772,Ganguly; Soumya,6,0,32,26
1656848962765,MATH 20E,B01,083773,Ciotti; Benjamin,18,0,35,17
1656848962765,MATH 20E,B02,083774,Ciotti; Benjamin,17,0,35,18
1656848968794,MATH 103A,A01,083777,Greenfeld; Be'Eri,2,0,36,34
1656848968794,MATH 103A,A02,083778,Greenfeld; Be'Eri,5,0,36,31
1656848968794,MATH 103A,A03,093561,Greenfeld; Be'Eri,4,0,36,32
1656848968794,MATH 103A,B01,083779,Greenfeld; Be'Eri,6,0,36,30
1656848968794,MATH 103A,B02,083780,Greenfeld; Be'Eri,2,0,36,34
1656848968794,MATH 103A,B03,093562,Greenfeld; Be'Eri,2,0,36,34
1656848974825,MATH 105,A01,085443,Carter; Anne Toulson,13,0,35,22
1656848974825,MATH 105,A02,093477,Carter; Anne Toulson,20,0,35,15
1656848980858,MATH 109,A01,083213,Ganzberger; Geoffrey Michael,2,0,34,32
1656848980858,MATH 109,A02,083214,Ganzberger; Geoffrey Michael,2,0,34,32
1656848980858,MATH 109,A03,093478,Ganzberger; Geoffrey Michael,1,0,34,33
1656848980858,MATH 109,B01,083215,Ganzberger; Geoffrey Michael,1,0,32,31
1656848980858,MATH 109,B02,083216,Ganzberger; Geoffrey Michael,1,0,32,31
1656848980858,MATH 109,B03,093479,Ganzberger; Geoffrey Michael,6,0,32,26
1656848986892,MATH 142A,A01,083219,Chow; Bennett,6,0,32,26
1656848986892,MATH 142A,A02,083220,Chow; Bennett,9,0,32,23
1656848986892,MATH 142A,A03,093480,Chow; Bennett,7,0,32,25
1656848986892,MATH 142A,B03,093481,Chow; Bennett,7,0,32,25
1656848986892,MATH 142A,B04,093558,Chow; Bennett,10,0,32,22
1656848986892,MATH 142A,B05,093559,Chow; Bennett,6,0,32,26
1656848992917,MATH 193A,A01,083224,Rotar; Vladimir,6,0,34,28
1656848992917,MATH 193A,A02,083225,Rotar; Vladimir,3,0,34,31
1656848992917,MATH 193A,A03,083781,Rotar; Vladimir,1,0,34,33
1656848992917,MATH 193A,A04,083782,Rotar; Vladimir,6,0,34,28
1656848992917,MATH 193A,A05,093482,Rotar; Vladimir,6,0,34,28
1656848998945,MATH 197,001,091859,McAuley; Julian John,9999,0,9999,0
1656848998945,MATH 197,002,095566,Kedlaya; Kiran S.,9997,0,9999,2
1656848998945,MATH 197,003,095567,Xiao; Ming,9999,0,9999,0
1656848998945,MATH 197,004,095571,Perols; Johan Lars,9998,0,9999,1
1656849006024,COGS 9,A01,083615,Shannon; Kyle Michael,6,0,75,69
1656849012065,COGS 11,A01,083617,Boyle; Mary E. T.,18,0,48,30
1656849018099,COGS 13,A01,083071,Bastos; Amalia Pinkusfeld,8,0,71,63
1656849024132,COGS 14A,A01,092681,Semenuks; Arturs,0,1,100,100
1656849030163,COGS 14B,A01,083073,Cheng; Tzu-Han,5,0,63,58
1656849036222,COGS 17,A01,092677,Semenuks; Arturs,4,0,81,77
1656849042251,COGS 100,A01,083619,Allen; Michael Gordon,15,0,70,55
1656849048276,COGS 101A,A01,083621,Davis; Joshua Daniel,9,0,68,59
1656849054304,COGS 101B,A01,091572,Allen; Michael Gordon,8,0,65,57
1656849060330,COGS 101C,A01,083625,Delgado; Tania,17,0,35,18
1656849066359,COGS 107A,A01,083627,Boyle; Mary E. T.,13,0,60,47
1656849072388,COGS 118A,A01,083075,Gupta; Anjum,15,0,76,61
1656849078427,CSE 3,A50,083646,Miranda; Gregory Joseph,22,0,50,28
1656849084453,CSE 8A,A50,083650,Miranda; Gregory Joseph,17,1,56,39
1656849090481,CSE 11,A01,083080,Cao; Yingjun,4,15,40,36
1656849096509,CSE 12,A01,083652,Krause-Levy; Sophia Louisa,20,1,120,100
1656849102535,CSE 15L,A01,083654,Morris; Justin Loren,8,0,50,42
1656849102535,CSE 15L,A02,083655,Morris; Justin Loren,8,0,50,42
1656849108564,CSE 20,A01,083657,Tran; Khoa Dang,37,0,80,43
1656849114591,CSE 21,A01,095574,Bach; Quang Tran,21,0,48,27
1656849120621,CSE 30,A01,083084,Eldon; John,4,0,80,76
1656849120621,CSE 30,B01,095061,Bhaskar; Nishant,6,0,50,44
1656849126648,CSE 100,A01,083659,Cao; Yingjun,2,4,70,68
1656849132676,CSE 134B,A01,083661,Powell; Thomas Allan,19,0,100,81
1656849138702,CSE 140,A01,083663,Gungor; Onat,14,0,85,71
1656849144731,CSE 140L,A01,083088,Eldon; John,16,0,100,84
1656849150757,CSE 175,A01,083665,Kumar; Rakesh,3,0,25,22
1656849156784,CSE 190,A00,092507,Dubnov; Shlomo,7,0,20,13
1656849162808,ECE 45,A01,083139,Congero; Spencer William,5,0,75,70
1656849168837,ECE 65,A50,083695,Saad; Andrew S,12,0,30,18
1656849168837,ECE 65,A51,095125,Saad; Andrew S,25,0,26,1
1656849174866,ECE 109,A01,091882,Touri; Behrouz,16,0,70,54
1656849180896,ECE 180,A00,083140,Abi Samra; Nicholas Camill,0,0,30,30
1656849180896,ECE 180,B00,083141,Abi Samra; Nicholas Camill,0,0,30,30
1656849186927,MATH 10A,A01,083735,Patchell; Gregory David,1,0,30,29
1656849186927,MATH 10A,A02,083736,Patchell; Gregory David,20,0,30,10
1656849186927,MATH 10A,A03,083737,Patchell; Gregory David,15,0,30,15
1656849192956,MATH 10B,A01,083207,Lim; Seonhee,7,0,34,27
1656849192956,MATH 10B,A02,083208,Lim; Seonhee,9,0,35,26
1656849192956,MATH 10B,A03,093472,Lim; Seonhee,4,0,34,30
1656849192956,MATH 10B,B01,083739,Sinha; Shubham,9,0,30,21
1656849198986,MATH 18,A01,083743,Cinel; Cameron Alexander,6,0,30,24
1656849198986,MATH 18,A02,083744,Cinel; Cameron Alexander,15,0,30,15
1656849198986,MATH 18,A03,083745,Cinel; Cameron Alexander,8,0,30,22
1656849198986,MATH 18,B01,083748,Rideout; David Porter,3,0,37,34
1656849198986,MATH 18,B02,083749,Rideout; David Porter,3,0,36,33
1656849198986,MATH 18,B03,083750,Rideout; David Porter,2,0,37,35
1656849198986,MATH 18,B04,083751,Rideout; David Porter,5,0,36,31
1656849198986,MATH 18,B05,093473,Rideout; David Porter,4,0,36,32
1656849198986,MATH 18,B06,093474,Rideout; David Porter,5,0,36,31
1656849205016,MATH 20A,A01,083754,Zheng; Zequn,12,0,40,28
1656849211051,MATH 20B,A01,083756,Briones; Jor-el Thomas Caparas,1,0,36,35
1656849211051,MATH 20B,A02,083757,Briones; Jor-el Thomas Caparas,1,0,36,35
1656849211051,MATH 20B,A03,093475,Briones; Jor-el Thomas Caparas,0,0,36,36
1656849217079,MATH 20C,A01,083760,Briones; Jor-el Thomas Caparas,1,0,35,34
1656849217079,MATH 20C,A02,083761,Briones; Jor-el Thomas Caparas,8,0,35,27
1656849217079,MATH 20C,A03,093476,Briones; Jor-el Thomas Caparas,0,1,36,36
1656849217079,MATH 20C,B01,083762,Bach; Quang Tran,0,0,30,30
1656849223112,MATH 20D,A01,083765,Tran; Brian Kha,4,0,30,26
1656849223112,MATH 20D,A02,083766,Tran; Brian Kha,4,0,30,26
1656849223112,MATH 20D,A03,083767,Tran; Brian Kha,2,0,30,28
1656849229138,MATH 20E,A01,083771,Ganguly; Soumya,5,0,32,27
1656849229138,MATH 20E,A02,083772,Ganguly; Soumya,6,0,32,26
1656849229138,MATH 20E,B01,083773,Ciotti; Benjamin,18,0,35,17
1656849229138,MATH 20E,B02,083774,Ciotti; Benjamin,17,0,35,18
1656849235175,MATH 103A,A01,083777,Greenfeld; Be'Eri,2,0,36,34
1656849235175,MATH 103A,A02,083778,Greenfeld; Be'Eri,5,0,36,31
1656849235175,MATH 103A,A03,093561,Greenfeld; Be'Eri,4,0,36,32
1656849235175,MATH 103A,B01,083779,Greenfeld; Be'Eri,6,0,36,30
1656849235175,MATH 103A,B02,083780,Greenfeld; Be'Eri,2,0,36,34
1656849235175,MATH 103A,B03,093562,Greenfeld; Be'Eri,2,0,36,34
1656849241204,MATH 105,A01,085443,Carter; Anne Toulson,13,0,35,22
1656849241204,MATH 105,A02,093477,Carter; Anne Toulson,20,0,35,15
1656849247237,MATH 109,A01,083213,Ganzberger; Geoffrey Michael,2,0,34,32
1656849247237,MATH 109,A02,083214,Ganzberger; Geoffrey Michael,2,0,34,32
1656849247237,MATH 109,A03,093478,Ganzberger; Geoffrey Michael,1,0,34,33
1656849247237,MATH 109,B01,083215,Ganzberger; Geoffrey Michael,1,0,32,31
1656849247237,MATH 109,B02,083216,Ganzberger; Geoffrey Michael,1,0,32,31
1656849247237,MATH 109,B03,093479,Ganzberger; Geoffrey Michael,6,0,32,26
1656849253266,MATH 142A,A01,083219,Chow; Bennett,6,0,32,26
1656849253266,MATH 142A,A02,083220,Chow; Bennett,9,0,32,23
1656849253266,MATH 142A,A03,093480,Chow; Bennett,7,0,32,25
1656849253266,MATH 142A,B03,093481,Chow; Bennett,7,0,32,25
1656849253266,MATH 142A,B04,093558,Chow; Bennett,10,0,32,22
1656849253266,MATH 142A,B05,093559,Chow; Bennett,6,0,32,26
1656849259294,MATH 193A,A01,083224,Rotar; Vladimir,6,0,34,28
1656849259294,MATH 193A,A02,083225,Rotar; Vladimir,3,0,34,31
1656849259294,MATH 193A,A03,083781,Rotar; Vladimir,1,0,34,33
1656849259294,MATH 193A,A04,083782,Rotar; Vladimir,6,0,34,28
1656849259294,MATH 193A,A05,093482,Rotar; Vladimir,6,0,34,28
1656849265325,MATH 197,001,091859,McAuley; Julian John,9999,0,9999,0
1656849265325,MATH 197,002,095566,Kedlaya; Kiran S.,9997,0,9999,2
1656849265325,MATH 197,003,095567,Xiao; Ming,9999,0,9999,0
1656849265325,MATH 197,004,095571,Perols; Johan Lars,9998,0,9999,1
1656849272403,COGS 9,A01,083615,Shannon; Kyle Michael,6,0,75,69
1656849278429,COGS 11,A01,083617,Boyle; Mary E. T.,18,0,48,30
1656849284461,COGS 13,A01,083071,Bastos; Amalia Pinkusfeld,8,0,71,63
1656849290488,COGS 14A,A01,092681,Semenuks; Arturs,0,1,100,100
1656849296515,COGS 14B,A01,083073,Cheng; Tzu-Han,5,0,63,58
1656849302540,COGS 17,A01,092677,Semenuks; Arturs,4,0,81,77
1656849308568,COGS 100,A01,083619,Allen; Michael Gordon,15,0,70,55
1656849314595,COGS 101A,A01,083621,Davis; Joshua Daniel,9,0,68,59
1656849320624,COGS 101B,A01,091572,Allen; Michael Gordon,8,0,65,57
1656849326686,COGS 101C,A01,083625,Delgado; Tania,17,0,35,18
1656849332710,COGS 107A,A01,083627,Boyle; Mary E. T.,13,0,60,47
1656849338736,COGS 118A,A01,083075,Gupta; Anjum,15,0,76,61
1656849344762,CSE 3,A50,083646,Miranda; Gregory Joseph,22,0,50,28
1656849350793,CSE 8A,A50,083650,Miranda; Gregory Joseph,17,1,56,39
1656849356818,CSE 11,A01,083080,Cao; Yingjun,4,15,40,36
1656849362843,CSE 12,A01,083652,Krause-Levy; Sophia Louisa,20,1,120,100
1656849368870,CSE 15L,A01,083654,Morris; Justin Loren,8,0,50,42
1656849368870,CSE 15L,A02,083655,Morris; Justin Loren,8,0,50,42
1656849374903,CSE 20,A01,083657,Tran; Khoa Dang,37,0,80,43
1656849380929,CSE 21,A01,095574,Bach; Quang Tran,21,0,48,27
1656849386964,CSE 30,A01,083084,Eldon; John,4,0,80,76
1656849386964,CSE 30,B01,095061,Bhaskar; Nishant,6,0,50,44
1656849392990,CSE 100,A01,083659,Cao; Yingjun,2,4,70,68
1656849399017,CSE 134B,A01,083661,Powell; Thomas Allan,19,0,100,81
1656849405047,CSE 140,A01,083663,Gungor; Onat,14,0,85,71
1656849411072,CSE 140L,A01,083088,Eldon; John,16,0,100,84
1656849417097,CSE 175,A01,083665,Kumar; Rakesh,3,0,25,22
1656849423122,CSE 190,A00,092507,Dubnov; Shlomo,7,0,20,13
1656849429150,ECE 45,A01,083139,Congero; Spencer William,5,0,75,70
1656849435180,ECE 65,A50,083695,Saad; Andrew S,12,0,30,18
1656849435180,ECE 65,A51,095125,Saad; Andrew S,25,0,26,1
1656849441205,ECE 109,A01,091882,Touri; Behrouz,16,0,70,54
1656849447235,ECE 180,A00,083140,Abi Samra; Nicholas Camill,0,0,30,30
1656849447235,ECE 180,B00,083141,Abi Samra; Nicholas Camill,0,0,30,30
1656849453262,MATH 10A,A01,083735,Patchell; Gregory David,1,0,30,29
1656849453262,MATH 10A,A02,083736,Patchell; Gregory David,20,0,30,10
1656849453262,MATH 10A,A03,083737,Patchell; Gregory David,15,0,30,15
1656849459302,MATH 10B,A01,083207,Lim; Seonhee,7,0,34,27
1656849459302,MATH 10B,A02,083208,Lim; Seonhee,9,0,35,26
1656849459302,MATH 10B,A03,093472,Lim; Seonhee,4,0,34,30
1656849459302,MATH 10B,B01,083739,Sinha; Shubham,9,0,30,21
1656849465342,MATH 18,A01,083743,Cinel; Cameron Alexander,6,0,30,24
1656849465342,MATH 18,A02,083744,Cinel; Cameron Alexander,15,0,30,15
1656849465342,MATH 18,A03,083745,Cinel; Cameron Alexander,8,0,30,22
1656849465342,MATH 18,B01,083748,Rideout; David Porter,3,0,37,34
1656849465342,MATH 18,B02,083749,Rideout; David Porter,3,0,36,33
1656849465342,MATH 18,B03,083750,Rideout; David Porter,2,0,37,35
1656849465342,MATH 18,B04,083751,Rideout; David Porter,5,0,36,31
1656849465342,MATH 18,B05,093473,Rideout; David Porter,4,0,36,32
1656849465342,MATH 18,B06,093474,Rideout; David Porter,5,0,36,31
1656849471374,MATH 20A,A01,083754,Zheng; Zequn,12,0,40,28
1656849477402,MATH 20B,A01,083756,Briones; Jor-el Thomas Caparas,1,0,36,35
1656849477402,MATH 20B,A02,083757,Briones; Jor-el Thomas Caparas,1,0,36,35
1656849477402,MATH 20B,A03,093475,Briones; Jor-el Thomas Caparas,0,0,36,36
1656849483429,MATH 20C,A01,083760,Briones; Jor-el Thomas Caparas,1,0,35,34
1656849483429,MATH 20C,A02,083761,Briones; Jor-el Thomas Caparas,8,0,35,27
1656849483429,MATH 20C,A03,093476,Briones; Jor-el Thomas Caparas,0,1,36,36
1656849483429,MATH 20C,B01,083762,Bach; Quang Tran,0,0,30,30
1656849489457,MATH 20D,A01,083765,Tran; Brian Kha,4,0,30,26
1656849489457,MATH 20D,A02,083766,Tran; Brian Kha,4,0,30,26
1656849489457,MATH 20D,A03,083767,Tran; Brian Kha,2,0,30,28
1656849495491,MATH 20E,A01,083771,Ganguly; Soumya,5,0,32,27
1656849495491,MATH 20E,A02,083772,Ganguly; Soumya,6,0,32,26
1656849495491,MATH 20E,B01,083773,Ciotti; Benjamin,18,0,35,17
1656849495491,MATH 20E,B02,083774,Ciotti; Benjamin,17,0,35,18
1656849501536,MATH 103A,A01,083777,Greenfeld; Be'Eri,2,0,36,34
1656849501536,MATH 103A,A02,083778,Greenfeld; Be'Eri,5,0,36,31
1656849501536,MATH 103A,A03,093561,Greenfeld; Be'Eri,4,0,36,32
1656849501536,MATH 103A,B01,083779,Greenfeld; Be'Eri,6,0,36,30
1656849501536,MATH 103A,B02,083780,Greenfeld; Be'Eri,2,0,36,34
1656849501536,MATH 103A,B03,093562,Greenfeld; Be'Eri,2,0,36,34
1656849507567,MATH 105,A01,085443,Carter; Anne Toulson,13,0,35,22
1656849507567,MATH 105,A02,093477,Carter; Anne Toulson,20,0,35,15
1656849513690,MATH 109,A01,083213,Ganzberger; Geoffrey Michael,2,0,34,32
1656849513690,MATH 109,A02,083214,Ganzberger; Geoffrey Michael,2,0,34,32
1656849513690,MATH 109,A03,093478,Ganzberger; Geoffrey Michael,1,0,34,33
1656849513690,MATH 109,B01,083215,Ganzberger; Geoffrey Michael,1,0,32,31
1656849513690,MATH 109,B02,083216,Ganzberger; Geoffrey Michael,1,0,32,31
1656849513690,MATH 109,B03,093479,Ganzberger; Geoffrey Michael,6,0,32,26
1656849519717,MATH 142A,A01,083219,Chow; Bennett,6,0,32,26
1656849519717,MATH 142A,A02,083220,Chow; Bennett,9,0,32,23
1656849519717,MATH 142A,A03,093480,Chow; Bennett,7,0,32,25
1656849519717,MATH 142A,B03,093481,Chow; Bennett,7,0,32,25
1656849519717,MATH 142A,B04,093558,Chow; Bennett,10,0,32,22
1656849519717,MATH 142A,B05,093559,Chow; Bennett,6,0,32,26
1656849525744,MATH 193A,A01,083224,Rotar; Vladimir,6,0,34,28
1656849525744,MATH 193A,A02,083225,Rotar; Vladimir,3,0,34,31
1656849525744,MATH 193A,A03,083781,Rotar; Vladimir,1,0,34,33
1656849525744,MATH 193A,A04,083782,Rotar; Vladimir,6,0,34,28
1656849525744,MATH 193A,A05,093482,Rotar; Vladimir,6,0,34,28
1656849531783,MATH 197,001,091859,McAuley; Julian John,9999,0,9999,0
1656849531783,MATH 197,002,095566,Kedlaya; Kiran S.,9997,0,9999,2
1656849531783,MATH 197,003,095567,Xiao; Ming,9999,0,9999,0
1656849531783,MATH 197,004,095571,Perols; Johan Lars,9998,0,9999,1
1656849538845,COGS 9,A01,083615,Shannon; Kyle Michael,6,0,75,69
1656849544873,COGS 11,A01,083617,Boyle; Mary E. T.,18,0,48,30
1656849550897,COGS 13,A01,083071,Bastos; Amalia Pinkusfeld,8,0,71,63
1656849556924,COGS 14A,A01,092681,Semenuks; Arturs,0,1,100,100
1656849562950,COGS 14B,A01,083073,Cheng; Tzu-Han,5,0,63,58
1656849568980,COGS 17,A01,092677,Semenuks; Arturs,4,0,81,77
1656849575010,COGS 100,A01,083619,Allen; Michael Gordon,15,0,70,55
1656849581041,COGS 101A,A01,083621,Davis; Joshua Daniel,9,0,68,59
1656849587069,COGS 101B,A01,091572,Allen; Michael Gordon,8,0,65,57
1656849593102,COGS 101C,A01,083625,Delgado; Tania,17,0,35,18
1656849599127,COGS 107A,A01,083627,Boyle; Mary E. T.,13,0,60,47
1656849605150,COGS 118A,A01,083075,Gupta; Anjum,15,0,76,61
1656849611185,CSE 3,A50,083646,Miranda; Gregory Joseph,22,0,50,28
1656849617209,CSE 8A,A50,083650,Miranda; Gregory Joseph,17,1,56,39
1656849623236,CSE 11,A01,083080,Cao; Yingjun,4,15,40,36
1656849629263,CSE 12,A01,083652,Krause-Levy; Sophia Louisa,20,1,120,100
1656849635295,CSE 15L,A01,083654,Morris; Justin Loren,8,0,50,42
1656849635295,CSE 15L,A02,083655,Morris; Justin Loren,8,0,50,42
1656849641323,CSE 20,A01,083657,Tran; Khoa Dang,37,0,80,43
1656849647349,CSE 21,A01,095574,Bach; Quang Tran,21,0,48,27
1656849653375,CSE 30,A01,083084,Eldon; John,4,0,80,76
1656849653375,CSE 30,B01,095061,Bhaskar; Nishant,6,0,50,44
1656849659399,CSE 100,A01,083659,Cao; Yingjun,2,4,70,68
1656849665426,CSE 134B,A01,083661,Powell; Thomas Allan,19,0,100,81
1656849671454,CSE 140,A01,083663,Gungor; Onat,14,0,85,71
1656849677491,CSE 140L,A01,083088,Eldon; John,16,0,100,84
1656849683515,CSE 175,A01,083665,Kumar; Rakesh,3,0,25,22
1656849689541,CSE 190,A00,092507,Dubnov; Shlomo,7,0,20,13
1656849695567,ECE 45,A01,083139,Congero; Spencer William,5,0,75,70
1656849701600,ECE 65,A50,083695,Saad; Andrew S,12,0,30,18
1656849701600,ECE 65,A51,095125,Saad; Andrew S,25,0,26,1
1656849707626,ECE 109,A01,091882,Touri; Behrouz,16,0,70,54
1656849713655,ECE 180,A00,083140,Abi Samra; Nicholas Camill,0,0,30,30
1656849713655,ECE 180,B00,083141,Abi Samra; Nicholas Camill,0,0,30,30
1656849719685,MATH 10A,A01,083735,Patchell; Gregory David,1,0,30,29
1656849719685,MATH 10A,A02,083736,Patchell; Gregory David,20,0,30,10
1656849719685,MATH 10A,A03,083737,Patchell; Gregory David,15,0,30,15
1656849725709,MATH 10B,A01,083207,Lim; Seonhee,7,0,34,27
1656849725709,MATH 10B,A02,083208,Lim; Seonhee,9,0,35,26
1656849725709,MATH 10B,A03,093472,Lim; Seonhee,4,0,34,30
1656849725709,MATH 10B,B01,083739,Sinha; Shubham,9,0,30,21
1656849731748,MATH 18,A01,083743,Cinel; Cameron Alexander,6,0,30,24
1656849731748,MATH 18,A02,083744,Cinel; Cameron Alexander,15,0,30,15
1656849731748,MATH 18,A03,083745,Cinel; Cameron Alexander,8,0,30,22
1656849731748,MATH 18,B01,083748,Rideout; David Porter,3,0,37,34
1656849731748,MATH 18,B02,083749,Rideout; David Porter,3,0,36,33
1656849731748,MATH 18,B03,083750,Rideout; David Porter,2,0,37,35
1656849731748,MATH 18,B04,083751,Rideout; David Porter,5,0,36,31
1656849731748,MATH 18,B05,093473,Rideout; David Porter,4,0,36,32
1656849731748,MATH 18,B06,093474,Rideout; David Porter,5,0,36,31
1656849737776,MATH 20A,A01,083754,Zheng; Zequn,12,0,40,28
1656849743805,MATH 20B,A01,083756,Briones; Jor-el Thomas Caparas,1,0,36,35
1656849743805,MATH 20B,A02,083757,Briones; Jor-el Thomas Caparas,1,0,36,35
1656849743805,MATH 20B,A03,093475,Briones; Jor-el Thomas Caparas,0,0,36,36
1656849749834,MATH 20C,A01,083760,Briones; Jor-el Thomas Caparas,1,0,35,34
1656849749834,MATH 20C,A02,083761,Briones; Jor-el Thomas Caparas,8,0,35,27
1656849749834,MATH 20C,A03,093476,Briones; Jor-el Thomas Caparas,0,1,36,36
1656849749834,MATH 20C,B01,083762,Bach; Quang Tran,0,0,30,30
1656849755860,MATH 20D,A01,083765,Tran; Brian Kha,4,0,30,26
1656849755860,MATH 20D,A02,083766,Tran; Brian Kha,4,0,30,26
1656849755860,MATH 20D,A03,083767,Tran; Brian Kha,2,0,30,28
1656849761888,MATH 20E,A01,083771,Ganguly; Soumya,5,0,32,27
1656849761888,MATH 20E,A02,083772,Ganguly; Soumya,6,0,32,26
1656849761888,MATH 20E,B01,083773,Ciotti; Benjamin,18,0,35,17
1656849761888,MATH 20E,B02,083774,Ciotti; Benjamin,17,0,35,18
1656849767915,MATH 103A,A01,083777,Greenfeld; Be'Eri,2,0,36,34
1656849767915,MATH 103A,A02,083778,Greenfeld; Be'Eri,5,0,36,31
1656849767915,MATH 103A,A03,093561,Greenfeld; Be'Eri,4,0,36,32
1656849767915,MATH 103A,B01,083779,Greenfeld; Be'Eri,6,0,36,30
1656849767915,MATH 103A,B02,083780,Greenfeld; Be'Eri,2,0,36,34
1656849767915,MATH 103A,B03,093562,Greenfeld; Be'Eri,2,0,36,34
1656849773955,MATH 105,A01,085443,Carter; Anne Toulson,13,0,35,22
1656849773955,MATH 105,A02,093477,Carter; Anne Toulson,20,0,35,15
1656849779983,MATH 109,A01,083213,Ganzberger; Geoffrey Michael,2,0,34,32
1656849779983,MATH 109,A02,083214,Ganzberger; Geoffrey Michael,2,0,34,32
1656849779983,MATH 109,A03,093478,Ganzberger; Geoffrey Michael,1,0,34,33
1656849779983,MATH 109,B01,083215,Ganzberger; Geoffrey Michael,1,0,32,31
1656849779983,MATH 109,B02,083216,Ganzberger; Geoffrey Michael,1,0,32,31
1656849779983,MATH 109,B03,093479,Ganzberger; Geoffrey Michael,6,0,32,26
1656849786021,MATH 142A,A01,083219,Chow; Bennett,6,0,32,26
1656849786021,MATH 142A,A02,083220,Chow; Bennett,9,0,32,23
1656849786021,MATH 142A,A03,093480,Chow; Bennett,7,0,32,25
1656849786021,MATH 142A,B03,093481,Chow; Bennett,7,0,32,25
1656849786021,MATH 142A,B04,093558,Chow; Bennett,10,0,32,22
1656849786021,MATH 142A,B05,093559,Chow; Bennett,6,0,32,26
1656849792047,MATH 193A,A01,083224,Rotar; Vladimir,6,0,34,28
1656849792047,MATH 193A,A02,083225,Rotar; Vladimir,3,0,34,31
1656849792047,MATH 193A,A03,083781,Rotar; Vladimir,1,0,34,33
1656849792047,MATH 193A,A04,083782,Rotar; Vladimir,6,0,34,28
1656849792047,MATH 193A,A05,093482,Rotar; Vladimir,6,0,34,28
1656849798089,MATH 197,001,091859,McAuley; Julian John,9999,0,9999,0
1656849798089,MATH 197,002,095566,Kedlaya; Kiran S.,9997,0,9999,2
1656849798089,MATH 197,003,095567,Xiao; Ming,9999,0,9999,0
1656849798089,MATH 197,004,095571,Perols; Johan Lars,9998,0,9999,1
1656849805165,COGS 9,A01,083615,Shannon; Kyle Michael,6,0,75,69
1656849811197,COGS 11,A01,083617,Boyle; Mary E. T.,18,0,48,30
1656849817238,COGS 13,A01,083071,Bastos; Amalia Pinkusfeld,8,0,71,63
1656849823265,COGS 14A,A01,092681,Semenuks; Arturs,0,1,100,100
1656849829290,COGS 14B,A01,083073,Cheng; Tzu-Han,5,0,63,58
1656849835316,COGS 17,A01,092677,Semenuks; Arturs,4,0,81,77
1656849841348,COGS 100,A01,083619,Allen; Michael Gordon,15,0,70,55
1656849847375,COGS 101A,A01,083621,Davis; Joshua Daniel,9,0,68,59
1656849853399,COGS 101B,A01,091572,Allen; Michael Gordon,8,0,65,57
1656849859424,COGS 101C,A01,083625,Delgado; Tania,17,0,35,18
1656849865450,COGS 107A,A01,083627,Boyle; Mary E. T.,13,0,60,47
1656849871477,COGS 118A,A01,083075,Gupta; Anjum,15,0,76,61
1656849877506,CSE 3,A50,083646,Miranda; Gregory Joseph,22,0,50,28
1656849883536,CSE 8A,A50,083650,Miranda; Gregory Joseph,17,1,56,39
1656849889565,CSE 11,A01,083080,Cao; Yingjun,4,15,40,36
1656849895594,CSE 12,A01,083652,Krause-Levy; Sophia Louisa,20,1,120,100
1656849901617,CSE 15L,A01,083654,Morris; Justin Loren,8,0,50,42
1656849901617,CSE 15L,A02,083655,Morris; Justin Loren,8,0,50,42
1656849907645,CSE 20,A01,083657,Tran; Khoa Dang,37,0,80,43
1656849913673,CSE 21,A01,095574,Bach; Quang Tran,21,0,48,27
1656849919701,CSE 30,A01,083084,Eldon; John,4,0,80,76
1656849919701,CSE 30,B01,095061,Bhaskar; Nishant,6,0,50,44
1656849925726,CSE 100,A01,083659,Cao; Yingjun,2,4,70,68
1656849931754,CSE 134B,A01,083661,Powell; Thomas Allan,19,0,100,81
1656849937779,CSE 140,A01,083663,Gungor; Onat,14,0,85,71
1656849943805,CSE 140L,A01,083088,Eldon; John,16,0,100,84
1656849949831,CSE 175,A01,083665,Kumar; Rakesh,3,0,25,22
1656849955866,CSE 190,A00,092507,Dubnov; Shlomo,7,0,20,13
1656849961890,ECE 45,A01,083139,Congero; Spencer William,5,0,75,70
1656849967921,ECE 65,A50,083695,Saad; Andrew S,12,0,30,18
1656849967921,ECE 65,A51,095125,Saad; Andrew S,25,0,26,1
1656849973948,ECE 109,A01,091882,Touri; Behrouz,16,0,70,54
1656849979975,ECE 180,A00,083140,Abi Samra; Nicholas Camill,0,0,30,30
1656849979975,ECE 180,B00,083141,Abi Samra; Nicholas Camill,0,0,30,30
1656849986008,MATH 10A,A01,083735,Patchell; Gregory David,1,0,30,29
1656849986008,MATH 10A,A02,083736,Patchell; Gregory David,20,0,30,10
1656849986008,MATH 10A,A03,083737,Patchell; Gregory David,15,0,30,15
1656849992037,MATH 10B,A01,083207,Lim; Seonhee,7,0,34,27
1656849992037,MATH 10B,A02,083208,Lim; Seonhee,9,0,35,26
1656849992037,MATH 10B,A03,093472,Lim; Seonhee,4,0,34,30
1656849992037,MATH 10B,B01,083739,Sinha; Shubham,9,0,30,21
1656849998069,MATH 18,A01,083743,Cinel; Cameron Alexander,6,0,30,24
1656849998069,MATH 18,A02,083744,Cinel; Cameron Alexander,15,0,30,15
1656849998069,MATH 18,A03,083745,Cinel; Cameron Alexander,8,0,30,22
1656849998069,MATH 18,B01,083748,Rideout; David Porter,3,0,37,34
1656849998069,MATH 18,B02,083749,Rideout; David Porter,3,0,36,33
1656849998069,MATH 18,B03,083750,Rideout; David Porter,2,0,37,35
1656849998069,MATH 18,B04,083751,Rideout; David Porter,5,0,36,31
1656849998069,MATH 18,B05,093473,Rideout; David Porter,4,0,36,32
1656849998069,MATH 18,B06,093474,Rideout; David Porter,5,0,36,31
1656850004098,MATH 20A,A01,083754,Zheng; Zequn,12,0,40,28
1656850010124,MATH 20B,A01,083756,Briones; Jor-el Thomas Caparas,1,0,36,35
1656850010124,MATH 20B,A02,083757,Briones; Jor-el Thomas Caparas,1,0,36,35
1656850010124,MATH 20B,A03,093475,Briones; Jor-el Thomas Caparas,0,0,36,36
1656850016158,MATH 20C,A01,083760,Briones; Jor-el Thomas Caparas,1,0,35,34
1656850016158,MATH 20C,A02,083761,Briones; Jor-el Thomas Caparas,8,0,35,27
1656850016158,MATH 20C,A03,093476,Briones; Jor-el Thomas Caparas,0,1,36,36
1656850016158,MATH 20C,B01,083762,Bach; Quang Tran,0,0,30,30
1656850022194,MATH 20D,A01,083765,Tran; Brian Kha,4,0,30,26
1656850022194,MATH 20D,A02,083766,Tran; Brian Kha,4,0,30,26
1656850022194,MATH 20D,A03,083767,Tran; Brian Kha,2,0,30,28
1656850028228,MATH 20E,A01,083771,Ganguly; Soumya,5,0,32,27
1656850028228,MATH 20E,A02,083772,Ganguly; Soumya,6,0,32,26
1656850028228,MATH 20E,B01,083773,Ciotti; Benjamin,18,0,35,17
1656850028228,MATH 20E,B02,083774,Ciotti; Benjamin,17,0,35,18
1656850034267,MATH 103A,A01,083777,Greenfeld; Be'Eri,2,0,36,34
1656850034267,MATH 103A,A02,083778,Greenfeld; Be'Eri,5,0,36,31
1656850034267,MATH 103A,A03,093561,Greenfeld; Be'Eri,4,0,36,32
1656850034267,MATH 103A,B01,083779,Greenfeld; Be'Eri,6,0,36,30
1656850034267,MATH 103A,B02,083780,Greenfeld; Be'Eri,2,0,36,34
1656850034267,MATH 103A,B03,093562,Greenfeld; Be'Eri,2,0,36,34
1656850040295,MATH 105,A01,085443,Carter; Anne Toulson,13,0,35,22
1656850040295,MATH 105,A02,093477,Carter; Anne Toulson,20,0,35,15
1656850046328,MATH 109,A01,083213,Ganzberger; Geoffrey Michael,2,0,34,32
1656850046328,MATH 109,A02,083214,Ganzberger; Geoffrey Michael,2,0,34,32
1656850046328,MATH 109,A03,093478,Ganzberger; Geoffrey Michael,1,0,34,33
1656850046328,MATH 109,B01,083215,Ganzberger; Geoffrey Michael,1,0,32,31
1656850046328,MATH 109,B02,083216,Ganzberger; Geoffrey Michael,1,0,32,31
1656850046328,MATH 109,B03,093479,Ganzberger; Geoffrey Michael,6,0,32,26
1656850052358,MATH 142A,A01,083219,Chow; Bennett,6,0,32,26
1656850052358,MATH 142A,A02,083220,Chow; Bennett,9,0,32,23
1656850052358,MATH 142A,A03,093480,Chow; Bennett,7,0,32,25
1656850052358,MATH 142A,B03,093481,Chow; Bennett,7,0,32,25
1656850052358,MATH 142A,B04,093558,Chow; Bennett,10,0,32,22
1656850052358,MATH 142A,B05,093559,Chow; Bennett,6,0,32,26
1656850058385,MATH 193A,A01,083224,Rotar; Vladimir,6,0,34,28
1656850058385,MATH 193A,A02,083225,Rotar; Vladimir,3,0,34,31
1656850058385,MATH 193A,A03,083781,Rotar; Vladimir,1,0,34,33
1656850058385,MATH 193A,A04,083782,Rotar; Vladimir,6,0,34,28
1656850058385,MATH 193A,A05,093482,Rotar; Vladimir,6,0,34,28
1656850064414,MATH 197,001,091859,McAuley; Julian John,9999,0,9999,0
1656850064414,MATH 197,002,095566,Kedlaya; Kiran S.,9997,0,9999,2
1656850064414,MATH 197,003,095567,Xiao; Ming,9999,0,9999,0
1656850064414,MATH 197,004,095571,Perols; Johan Lars,9998,0,9999,1
1656850071503,COGS 9,A01,083615,Shannon; Kyle Michael,6,0,75,69
1656850077527,COGS 11,A01,083617,Boyle; Mary E. T.,18,0,48,30
1656850083558,COGS 13,A01,083071,Bastos; Amalia Pinkusfeld,8,0,71,63
1656850089584,COGS 14A,A01,092681,Semenuks; Arturs,0,1,100,100
1656850095614,COGS 14B,A01,083073,Cheng; Tzu-Han,5,0,63,58
1656850101639,COGS 17,A01,092677,Semenuks; Arturs,4,0,81,77
1656850107774,COGS 100,A01,083619,Allen; Michael Gordon,15,0,70,55
1656850113809,COGS 101A,A01,083621,Davis; Joshua Daniel,9,0,68,59
1656850119834,COGS 101B,A01,091572,Allen; Michael Gordon,8,0,65,57
1656850125861,COGS 101C,A01,083625,Delgado; Tania,17,0,35,18
1656850131892,COGS 107A,A01,083627,Boyle; Mary E. T.,13,0,60,47
1656850137917,COGS 118A,A01,083075,Gupta; Anjum,15,0,76,61
1656850143954,CSE 3,A50,083646,Miranda; Gregory Joseph,22,0,50,28
1656850149979,CSE 8A,A50,083650,Miranda; Gregory Joseph,17,1,56,39
1656850156004,CSE 11,A01,083080,Cao; Yingjun,4,15,40,36
1656850162029,CSE 12,A01,083652,Krause-Levy; Sophia Louisa,20,1,120,100
1656850168064,CSE 15L,A01,083654,Morris; Justin Loren,8,0,50,42
1656850168064,CSE 15L,A02,083655,Morris; Justin Loren,8,0,50,42
1656850174093,CSE 20,A01,083657,Tran; Khoa Dang,37,0,80,43
1656850180120,CSE 21,A01,095574,Bach; Quang Tran,21,0,48,27
1656850186145,CSE 30,A01,083084,Eldon; John,4,0,80,76
1656850186145,CSE 30,B01,095061,Bhaskar; Nishant,6,0,50,44
1656850192185,CSE 100,A01,083659,Cao; Yingjun,2,4,70,68
1656850198214,CSE 134B,A01,083661,Powell; Thomas Allan,19,0,100,81
1656850204241,CSE 140,A01,083663,Gungor; Onat,14,0,85,71
1656850210280,CSE 140L,A01,083088,Eldon; John,16,0,100,84
1656850216312,CSE 175,A01,083665,Kumar; Rakesh,3,0,25,22
1656850222341,CSE 190,A00,092507,Dubnov; Shlomo,7,0,20,13
1656850228369,ECE 45,A01,083139,Congero; Spencer William,5,0,75,70
1656850234395,ECE 65,A50,083695,Saad; Andrew S,12,0,30,18
1656850234395,ECE 65,A51,095125,Saad; Andrew S,25,0,26,1
1656850240421,ECE 109,A01,091882,Touri; Behrouz,16,0,70,54
1656850246447,ECE 180,A00,083140,Abi Samra; Nicholas Camill,0,0,30,30
1656850246447,ECE 180,B00,083141,Abi Samra; Nicholas Camill,0,0,30,30
1656850252475,MATH 10A,A01,083735,Patchell; Gregory David,1,0,30,29
1656850252475,MATH 10A,A02,083736,Patchell; Gregory David,20,0,30,10
1656850252475,MATH 10A,A03,083737,Patchell; Gregory David,15,0,30,15
1656850258504,MATH 10B,A01,083207,Lim; Seonhee,7,0,34,27
1656850258504,MATH 10B,A02,083208,Lim; Seonhee,9,0,35,26
1656850258504,MATH 10B,A03,093472,Lim; Seonhee,4,0,34,30
1656850258504,MATH 10B,B01,083739,Sinha; Shubham,9,0,30,21
1656850264538,MATH 18,A01,083743,Cinel; Cameron Alexander,6,0,30,24
1656850264538,MATH 18,A02,083744,Cinel; Cameron Alexander,15,0,30,15
1656850264538,MATH 18,A03,083745,Cinel; Cameron Alexander,8,0,30,22
1656850264538,MATH 18,B01,083748,Rideout; David Porter,3,0,37,34
1656850264538,MATH 18,B02,083749,Rideout; David Porter,3,0,36,33
1656850264538,MATH 18,B03,083750,Rideout; David Porter,2,0,37,35
1656850264538,MATH 18,B04,083751,Rideout; David Porter,5,0,36,31
1656850264538,MATH 18,B05,093473,Rideout; David Porter,4,0,36,32
1656850264538,MATH 18,B06,093474,Rideout; David Porter,5,0,36,31
1656850270562,MATH 20A,A01,083754,Zheng; Zequn,12,0,40,28
1656850276595,MATH 20B,A01,083756,Briones; Jor-el Thomas Caparas,1,0,36,35
1656850276595,MATH 20B,A02,083757,Briones; Jor-el Thomas Caparas,1,0,36,35
1656850276595,MATH 20B,A03,093475,Briones; Jor-el Thomas Caparas,0,0,36,36
1656850282630,MATH 20C,A01,083760,Briones; Jor-el Thomas Caparas,1,0,35,34
1656850282630,MATH 20C,A02,083761,Briones; Jor-el Thomas Caparas,8,0,35,27
1656850282630,MATH 20C,A03,093476,Briones; Jor-el Thomas Caparas,0,1,36,36
1656850282630,MATH 20C,B01,083762,Bach; Quang Tran,0,0,30,30
1656850288658,MATH 20D,A01,083765,Tran; Brian Kha,4,0,30,26
1656850288658,MATH 20D,A02,083766,Tran; Brian Kha,4,0,30,26
1656850288658,MATH 20D,A03,083767,Tran; Brian Kha,2,0,30,28
1656850294689,MATH 20E,A01,083771,Ganguly; Soumya,5,0,32,27
1656850294689,MATH 20E,A02,083772,Ganguly; Soumya,6,0,32,26
1656850294689,MATH 20E,B01,083773,Ciotti; Benjamin,18,0,35,17
1656850294689,MATH 20E,B02,083774,Ciotti; Benjamin,17,0,35,18
1656850300732,MATH 103A,A01,083777,Greenfeld; Be'Eri,2,0,36,34
1656850300732,MATH 103A,A02,083778,Greenfeld; Be'Eri,5,0,36,31
1656850300732,MATH 103A,A03,093561,Greenfeld; Be'Eri,4,0,36,32
1656850300732,MATH 103A,B01,083779,Greenfeld; Be'Eri,6,0,36,30
1656850300732,MATH 103A,B02,083780,Greenfeld; Be'Eri,2,0,36,34
1656850300732,MATH 103A,B03,093562,Greenfeld; Be'Eri,2,0,36,34
1656850306757,MATH 105,A01,085443,Carter; Anne Toulson,13,0,35,22
1656850306757,MATH 105,A02,093477,Carter; Anne Toulson,20,0,35,15
1656850312784,MATH 109,A01,083213,Ganzberger; Geoffrey Michael,2,0,34,32
1656850312784,MATH 109,A02,083214,Ganzberger; Geoffrey Michael,2,0,34,32
1656850312784,MATH 109,A03,093478,Ganzberger; Geoffrey Michael,1,0,34,33
1656850312784,MATH 109,B01,083215,Ganzberger; Geoffrey Michael,1,0,32,31
1656850312784,MATH 109,B02,083216,Ganzberger; Geoffrey Michael,1,0,32,31
1656850312784,MATH 109,B03,093479,Ganzberger; Geoffrey Michael,6,0,32,26
1656850318818,MATH 142A,A01,083219,Chow; Bennett,6,0,32,26
1656850318818,MATH 142A,A02,083220,Chow; Bennett,9,0,32,23
1656850318818,MATH 142A,A03,093480,Chow; Bennett,7,0,32,25
1656850318818,MATH 142A,B03,093481,Chow; Bennett,7,0,32,25
1656850318818,MATH 142A,B04,093558,Chow; Bennett,10,0,32,22
1656850318818,MATH 142A,B05,093559,Chow; Bennett,6,0,32,26
1656850324846,MATH 193A,A01,083224,Rotar; Vladimir,6,0,34,28
1656850324846,MATH 193A,A02,083225,Rotar; Vladimir,3,0,34,31
1656850324846,MATH 193A,A03,083781,Rotar; Vladimir,1,0,34,33
1656850324846,MATH 193A,A04,083782,Rotar; Vladimir,6,0,34,28
1656850324846,MATH 193A,A05,093482,Rotar; Vladimir,6,0,34,28
1656850330877,MATH 197,001,091859,McAuley; Julian John,9999,0,9999,0
1656850330877,MATH 197,002,095566,Kedlaya; Kiran S.,9997,0,9999,2
1656850330877,MATH 197,003,095567,Xiao; Ming,9999,0,9999,0
1656850330877,MATH 197,004,095571,Perols; Johan Lars,9998,0,9999,1
1656850337948,COGS 9,A01,083615,Shannon; Kyle Michael,6,0,75,69
1656850343981,COGS 11,A01,083617,Boyle; Mary E. T.,18,0,48,30
1656850350013,COGS 13,A01,083071,Bastos; Amalia Pinkusfeld,8,0,71,63
1656850356040,COGS 14A,A01,092681,Semenuks; Arturs,0,1,100,100
1656850362068,COGS 14B,A01,083073,Cheng; Tzu-Han,5,0,63,58
1656850368097,COGS 17,A01,092677,Semenuks; Arturs,4,0,81,77
1656850374124,COGS 100,A01,083619,Allen; Michael Gordon,15,0,70,55
1656850380156,COGS 101A,A01,083621,Davis; Joshua Daniel,9,0,68,59
1656850386189,COGS 101B,A01,091572,Allen; Michael Gordon,8,0,65,57
1656850392222,COGS 101C,A01,083625,Delgado; Tania,17,0,35,18
1656850398247,COGS 107A,A01,083627,Boyle; Mary E. T.,13,0,60,47
1656850404273,COGS 118A,A01,083075,Gupta; Anjum,15,0,76,61
1656850410305,CSE 3,A50,083646,Miranda; Gregory Joseph,22,0,50,28
1656850416330,CSE 8A,A50,083650,Miranda; Gregory Joseph,17,1,56,39
1656850422358,CSE 11,A01,083080,Cao; Yingjun,4,15,40,36
1656850428382,CSE 12,A01,083652,Krause-Levy; Sophia Louisa,20,1,120,100
1656850434406,CSE 15L,A01,083654,Morris; Justin Loren,8,0,50,42
1656850434406,CSE 15L,A02,083655,Morris; Justin Loren,8,0,50,42
1656850440430,CSE 20,A01,083657,Tran; Khoa Dang,37,0,80,43
1656850446458,CSE 21,A01,095574,Bach; Quang Tran,21,0,48,27
1656850452498,CSE 30,A01,083084,Eldon; John,4,0,80,76
1656850452498,CSE 30,B01,095061,Bhaskar; Nishant,6,0,50,44
1656850458525,CSE 100,A01,083659,Cao; Yingjun,2,4,70,68
1656850464550,CSE 134B,A01,083661,Powell; Thomas Allan,19,0,100,81
1656850470576,CSE 140,A01,083663,Gungor; Onat,14,0,85,71
1656850476617,CSE 140L,A01,083088,Eldon; John,16,0,100,84
1656850482645,CSE 175,A01,083665,Kumar; Rakesh,3,0,25,22
1656850488673,CSE 190,A00,092507,Dubnov; Shlomo,7,0,20,13
1656850494700,ECE 45,A01,083139,Congero; Spencer William,5,0,75,70
1656850500724,ECE 65,A50,083695,Saad; Andrew S,12,0,30,18
1656850500724,ECE 65,A51,095125,Saad; Andrew S,25,0,26,1
1656850506753,ECE 109,A01,091882,Touri; Behrouz,16,0,70,54
1656850512785,ECE 180,A00,083140,Abi Samra; Nicholas Camill,0,0,30,30
1656850512785,ECE 180,B00,083141,Abi Samra; Nicholas Camill,0,0,30,30
1656850518812,MATH 10A,A01,083735,Patchell; Gregory David,1,0,30,29
1656850518812,MATH 10A,A02,083736,Patchell; Gregory David,20,0,30,10
1656850518812,MATH 10A,A03,083737,Patchell; Gregory David,15,0,30,15
1656850524844,MATH 10B,A01,083207,Lim; Seonhee,7,0,34,27
1656850524844,MATH 10B,A02,083208,Lim; Seonhee,9,0,35,26
1656850524844,MATH 10B,A03,093472,Lim; Seonhee,4,0,34,30
1656850524844,MATH 10B,B01,083739,Sinha; Shubham,9,0,30,21
1656850530871,MATH 18,A01,083743,Cinel; Cameron Alexander,6,0,30,24
1656850530871,MATH 18,A02,083744,Cinel; Cameron Alexander,15,0,30,15
1656850530871,MATH 18,A03,083745,Cinel; Cameron Alexander,8,0,30,22
1656850530871,MATH 18,B01,083748,Rideout; David Porter,3,0,37,34
1656850530871,MATH 18,B02,083749,Rideout; David Porter,3,0,36,33
1656850530871,MATH 18,B03,083750,Rideout; David Porter,2,0,37,35
1656850530871,MATH 18,B04,083751,Rideout; David Porter,5,0,36,31
1656850530871,MATH 18,B05,093473,Rideout; David Porter,4,0,36,32
1656850530871,MATH 18,B06,093474,Rideout; David Porter,5,0,36,31
1656850536895,MATH 20A,A01,083754,Zheng; Zequn,12,0,40,28
1656850542925,MATH 20B,A01,083756,Briones; Jor-el Thomas Caparas,1,0,36,35
1656850542925,MATH 20B,A02,083757,Briones; Jor-el Thomas Caparas,1,0,36,35
1656850542925,MATH 20B,A03,093475,Briones; Jor-el Thomas Caparas,0,0,36,36
1656850548951,MATH 20C,A01,083760,Briones; Jor-el Thomas Caparas,1,0,35,34
1656850548951,MATH 20C,A02,083761,Briones; Jor-el Thomas Caparas,8,0,35,27
1656850548951,MATH 20C,A03,093476,Briones; Jor-el Thomas Caparas,0,1,36,36
1656850548951,MATH 20C,B01,083762,Bach; Quang Tran,0,0,30,30
1656850554976,MATH 20D,A01,083765,Tran; Brian Kha,4,0,30,26
1656850554976,MATH 20D,A02,083766,Tran; Brian Kha,4,0,30,26
1656850554976,MATH 20D,A03,083767,Tran; Brian Kha,2,0,30,28
1656850561009,MATH 20E,A01,083771,Ganguly; Soumya,5,0,32,27
1656850561009,MATH 20E,A02,083772,Ganguly; Soumya,6,0,32,26
1656850561009,MATH 20E,B01,083773,Ciotti; Benjamin,18,0,35,17
1656850561009,MATH 20E,B02,083774,Ciotti; Benjamin,17,0,35,18
1656850567040,MATH 103A,A01,083777,Greenfeld; Be'Eri,2,0,36,34
1656850567040,MATH 103A,A02,083778,Greenfeld; Be'Eri,5,0,36,31
1656850567040,MATH 103A,A03,093561,Greenfeld; Be'Eri,4,0,36,32
1656850567040,MATH 103A,B01,083779,Greenfeld; Be'Eri,6,0,36,30
1656850567040,MATH 103A,B02,083780,Greenfeld; Be'Eri,2,0,36,34
1656850567040,MATH 103A,B03,093562,Greenfeld; Be'Eri,2,0,36,34
1656850573069,MATH 105,A01,085443,Carter; Anne Toulson,13,0,35,22
1656850573069,MATH 105,A02,093477,Carter; Anne Toulson,20,0,35,15
1656850579101,MATH 109,A01,083213,Ganzberger; Geoffrey Michael,2,0,34,32
1656850579101,MATH 109,A02,083214,Ganzberger; Geoffrey Michael,2,0,34,32
1656850579101,MATH 109,A03,093478,Ganzberger; Geoffrey Michael,1,0,34,33
1656850579101,MATH 109,B01,083215,Ganzberger; Geoffrey Michael,1,0,32,31
1656850579101,MATH 109,B02,083216,Ganzberger; Geoffrey Michael,1,0,32,31
1656850579101,MATH 109,B03,093479,Ganzberger; Geoffrey Michael,6,0,32,26
1656850585126,MATH 142A,A01,083219,Chow; Bennett,6,0,32,26
1656850585126,MATH 142A,A02,083220,Chow; Bennett,9,0,32,23
1656850585126,MATH 142A,A03,093480,Chow; Bennett,7,0,32,25
1656850585126,MATH 142A,B03,093481,Chow; Bennett,7,0,32,25
1656850585126,MATH 142A,B04,093558,Chow; Bennett,10,0,32,22
1656850585126,MATH 142A,B05,093559,Chow; Bennett,6,0,32,26
1656850591156,MATH 193A,A01,083224,Rotar; Vladimir,6,0,34,28
1656850591156,MATH 193A,A02,083225,Rotar; Vladimir,3,0,34,31
1656850591156,MATH 193A,A03,083781,Rotar; Vladimir,1,0,34,33
1656850591156,MATH 193A,A04,083782,Rotar; Vladimir,6,0,34,28
1656850591156,MATH 193A,A05,093482,Rotar; Vladimir,6,0,34,28
1656850597187,MATH 197,001,091859,McAuley; Julian John,9999,0,9999,0
1656850597187,MATH 197,002,095566,Kedlaya; Kiran S.,9997,0,9999,2
1656850597187,MATH 197,003,095567,Xiao; Ming,9999,0,9999,0
1656850597187,MATH 197,004,095571,Perols; Johan Lars,9998,0,9999,1
1656850604241,COGS 9,A01,083615,Shannon; Kyle Michael,6,0,75,69
1656850610270,COGS 11,A01,083617,Boyle; Mary E. T.,18,0,48,30
1656850616299,COGS 13,A01,083071,Bastos; Amalia Pinkusfeld,8,0,71,63
1656850622329,COGS 14A,A01,092681,Semenuks; Arturs,0,1,100,100
1656850628354,COGS 14B,A01,083073,Cheng; Tzu-Han,5,0,63,58
1656850634379,COGS 17,A01,092677,Semenuks; Arturs,4,0,81,77
1656850640401,COGS 100,A01,083619,Allen; Michael Gordon,15,0,70,55
1656850646426,COGS 101A,A01,083621,Davis; Joshua Daniel,9,0,68,59
1656850652458,COGS 101B,A01,091572,Allen; Michael Gordon,8,0,65,57
1656850658486,COGS 101C,A01,083625,Delgado; Tania,17,0,35,18
1656850664510,COGS 107A,A01,083627,Boyle; Mary E. T.,13,0,60,47
1656850670535,COGS 118A,A01,083075,Gupta; Anjum,15,0,76,61
1656850676560,CSE 3,A50,083646,Miranda; Gregory Joseph,22,0,50,28
1656850682588,CSE 8A,A50,083650,Miranda; Gregory Joseph,17,1,56,39
1656850688622,CSE 11,A01,083080,Cao; Yingjun,4,15,40,36
1656850694663,CSE 12,A01,083652,Krause-Levy; Sophia Louisa,20,1,120,100
1656850700694,CSE 15L,A01,083654,Morris; Justin Loren,8,0,50,42
1656850700694,CSE 15L,A02,083655,Morris; Justin Loren,8,0,50,42
1656850706797,CSE 20,A01,083657,Tran; Khoa Dang,37,0,80,43
1656850712826,CSE 21,A01,095574,Bach; Quang Tran,21,0,48,27
1656850718859,CSE 30,A01,083084,Eldon; John,4,0,80,76
1656850718859,CSE 30,B01,095061,Bhaskar; Nishant,6,0,50,44
1656850724884,CSE 100,A01,083659,Cao; Yingjun,2,4,70,68
1656850730918,CSE 134B,A01,083661,Powell; Thomas Allan,19,0,100,81
1656850736950,CSE 140,A01,083663,Gungor; Onat,14,0,85,71
1656850742980,CSE 140L,A01,083088,Eldon; John,16,0,100,84
1656850749012,CSE 175,A01,083665,Kumar; Rakesh,3,0,25,22
1656850755033,CSE 190,A00,092507,Dubnov; Shlomo,7,0,20,13
1656850761058,ECE 45,A01,083139,Congero; Spencer William,5,0,75,70
1656850767088,ECE 65,A50,083695,Saad; Andrew S,12,0,30,18
1656850767088,ECE 65,A51,095125,Saad; Andrew S,25,0,26,1
1656850773118,ECE 109,A01,091882,Touri; Behrouz,16,0,70,54
1656850779141,ECE 180,A00,083140,Abi Samra; Nicholas Camill,0,0,30,30
1656850779141,ECE 180,B00,083141,Abi Samra; Nicholas Camill,0,0,30,30
1656850785174,MATH 10A,A01,083735,Patchell; Gregory David,1,0,30,29
1656850785174,MATH 10A,A02,083736,Patchell; Gregory David,20,0,30,10
1656850785174,MATH 10A,A03,083737,Patchell; Gregory David,15,0,30,15
1656850791202,MATH 10B,A01,083207,Lim; Seonhee,7,0,34,27
1656850791202,MATH 10B,A02,083208,Lim; Seonhee,9,0,35,26
1656850791202,MATH 10B,A03,093472,Lim; Seonhee,4,0,34,30
1656850791202,MATH 10B,B01,083739,Sinha; Shubham,9,0,30,21
1656850797233,MATH 18,A01,083743,Cinel; Cameron Alexander,6,0,30,24
1656850797233,MATH 18,A02,083744,Cinel; Cameron Alexander,15,0,30,15
1656850797233,MATH 18,A03,083745,Cinel; Cameron Alexander,8,0,30,22
1656850797233,MATH 18,B01,083748,Rideout; David Porter,3,0,37,34
1656850797233,MATH 18,B02,083749,Rideout; David Porter,3,0,36,33
1656850797233,MATH 18,B03,083750,Rideout; David Porter,2,0,37,35
1656850797233,MATH 18,B04,083751,Rideout; David Porter,5,0,36,31
1656850797233,MATH 18,B05,093473,Rideout; David Porter,4,0,36,32
1656850797233,MATH 18,B06,093474,Rideout; David Porter,5,0,36,31
1656850803264,MATH 20A,A01,083754,Zheng; Zequn,12,0,40,28
1656850809291,MATH 20B,A01,083756,Briones; Jor-el Thomas Caparas,1,0,36,35
1656850809291,MATH 20B,A02,083757,Briones; Jor-el Thomas Caparas,1,0,36,35
1656850809291,MATH 20B,A03,093475,Briones; Jor-el Thomas Caparas,0,0,36,36
1656850815316,MATH 20C,A01,083760,Briones; Jor-el Thomas Caparas,1,0,35,34
1656850815316,MATH 20C,A02,083761,Briones; Jor-el Thomas Caparas,8,0,35,27
1656850815316,MATH 20C,A03,093476,Briones; Jor-el Thomas Caparas,0,1,36,36
1656850815316,MATH 20C,B01,083762,Bach; Quang Tran,0,0,30,30
1656850821344,MATH 20D,A01,083765,Tran; Brian Kha,4,0,30,26
1656850821344,MATH 20D,A02,083766,Tran; Brian Kha,4,0,30,26
1656850821344,MATH 20D,A03,083767,Tran; Brian Kha,2,0,30,28
1656850827370,MATH 20E,A01,083771,Ganguly; Soumya,5,0,32,27
1656850827370,MATH 20E,A02,083772,Ganguly; Soumya,6,0,32,26
1656850827370,MATH 20E,B01,083773,Ciotti; Benjamin,18,0,35,17
1656850827370,MATH 20E,B02,083774,Ciotti; Benjamin,17,0,35,18
1656850833394,MATH 103A,A01,083777,Greenfeld; Be'Eri,2,0,36,34
1656850833394,MATH 103A,A02,083778,Greenfeld; Be'Eri,5,0,36,31
1656850833394,MATH 103A,A03,093561,Greenfeld; Be'Eri,4,0,36,32
1656850833394,MATH 103A,B01,083779,Greenfeld; Be'Eri,6,0,36,30
1656850833394,MATH 103A,B02,083780,Greenfeld; Be'Eri,2,0,36,34
1656850833394,MATH 103A,B03,093562,Greenfeld; Be'Eri,2,0,36,34
1656850839430,MATH 105,A01,085443,Carter; Anne Toulson,13,0,35,22
1656850839430,MATH 105,A02,093477,Carter; Anne Toulson,20,0,35,15
1656850845461,MATH 109,A01,083213,Ganzberger; Geoffrey Michael,2,0,34,32
1656850845461,MATH 109,A02,083214,Ganzberger; Geoffrey Michael,2,0,34,32
1656850845461,MATH 109,A03,093478,Ganzberger; Geoffrey Michael,1,0,34,33
1656850845461,MATH 109,B01,083215,Ganzberger; Geoffrey Michael,1,0,32,31
1656850845461,MATH 109,B02,083216,Ganzberger; Geoffrey Michael,1,0,32,31
1656850845461,MATH 109,B03,093479,Ganzberger; Geoffrey Michael,6,0,32,26
1656850851485,MATH 142A,A01,083219,Chow; Bennett,6,0,32,26
1656850851485,MATH 142A,A02,083220,Chow; Bennett,9,0,32,23
1656850851485,MATH 142A,A03,093480,Chow; Bennett,7,0,32,25
1656850851485,MATH 142A,B03,093481,Chow; Bennett,7,0,32,25
1656850851485,MATH 142A,B04,093558,Chow; Bennett,10,0,32,22
1656850851485,MATH 142A,B05,093559,Chow; Bennett,6,0,32,26
1656850857512,MATH 193A,A01,083224,Rotar; Vladimir,6,0,34,28
1656850857512,MATH 193A,A02,083225,Rotar; Vladimir,3,0,34,31
1656850857512,MATH 193A,A03,083781,Rotar; Vladimir,1,0,34,33
1656850857512,MATH 193A,A04,083782,Rotar; Vladimir,6,0,34,28
1656850857512,MATH 193A,A05,093482,Rotar; Vladimir,6,0,34,28
1656850863541,MATH 197,001,091859,McAuley; Julian John,9999,0,9999,0
1656850863541,MATH 197,002,095566,Kedlaya; Kiran S.,9997,0,9999,2
1656850863541,MATH 197,003,095567,Xiao; Ming,9999,0,9999,0
1656850863541,MATH 197,004,095571,Perols; Johan Lars,9998,0,9999,1
1656850870610,COGS 9,A01,083615,Shannon; Kyle Michael,6,0,75,69
1656850876632,COGS 11,A01,083617,Boyle; Mary E. T.,18,0,48,30
1656850882654,COGS 13,A01,083071,Bastos; Amalia Pinkusfeld,8,0,71,63
1656850888678,COGS 14A,A01,092681,Semenuks; Arturs,0,1,100,100
1656850894704,COGS 14B,A01,083073,Cheng; Tzu-Han,5,0,63,58
1656850900730,COGS 17,A01,092677,Semenuks; Arturs,4,0,81,77
1656850906752,COGS 100,A01,083619,Allen; Michael Gordon,15,0,70,55
1656850912777,COGS 101A,A01,083621,Davis; Joshua Daniel,9,0,68,59
1656850918803,COGS 101B,A01,091572,Allen; Michael Gordon,8,0,65,57
1656850924830,COGS 101C,A01,083625,Delgado; Tania,17,0,35,18
1656850930863,COGS 107A,A01,083627,Boyle; Mary E. T.,13,0,60,47
1656850936886,COGS 118A,A01,083075,Gupta; Anjum,15,0,76,61
1656850942915,CSE 3,A50,083646,Miranda; Gregory Joseph,22,0,50,28
1656850948943,CSE 8A,A50,083650,Miranda; Gregory Joseph,17,1,56,39
1656850954967,CSE 11,A01,083080,Cao; Yingjun,4,15,40,36
1656850960995,CSE 12,A01,083652,Krause-Levy; Sophia Louisa,20,1,120,100
1656850967018,CSE 15L,A01,083654,Morris; Justin Loren,8,0,50,42
1656850967018,CSE 15L,A02,083655,Morris; Justin Loren,8,0,50,42
1656850973044,CSE 20,A01,083657,Tran; Khoa Dang,37,0,80,43
1656850979071,CSE 21,A01,095574,Bach; Quang Tran,21,0,48,27
1656850985095,CSE 30,A01,083084,Eldon; John,4,0,80,76
1656850985095,CSE 30,B01,095061,Bhaskar; Nishant,6,0,50,44
1656850991121,CSE 100,A01,083659,Cao; Yingjun,2,4,70,68
1656850997147,CSE 134B,A01,083661,Powell; Thomas Allan,19,0,100,81
1656851003172,CSE 140,A01,083663,Gungor; Onat,14,0,85,71
1656851009196,CSE 140L,A01,083088,Eldon; John,16,0,100,84
1656851015220,CSE 175,A01,083665,Kumar; Rakesh,3,0,25,22
1656851021244,CSE 190,A00,092507,Dubnov; Shlomo,7,0,20,13
1656851027274,ECE 45,A01,083139,Congero; Spencer William,5,0,75,70
1656851033311,ECE 65,A50,083695,Saad; Andrew S,12,0,30,18
1656851033311,ECE 65,A51,095125,Saad; Andrew S,25,0,26,1
1656851039334,ECE 109,A01,091882,Touri; Behrouz,16,0,70,54
1656851045359,ECE 180,A00,083140,Abi Samra; Nicholas Camill,0,0,30,30
1656851045359,ECE 180,B00,083141,Abi Samra; Nicholas Camill,0,0,30,30
1656851051384,MATH 10A,A01,083735,Patchell; Gregory David,1,0,30,29
1656851051384,MATH 10A,A02,083736,Patchell; Gregory David,20,0,30,10
1656851051384,MATH 10A,A03,083737,Patchell; Gregory David,15,0,30,15
1656851057411,MATH 10B,A01,083207,Lim; Seonhee,7,0,34,27
1656851057411,MATH 10B,A02,083208,Lim; Seonhee,9,0,35,26
1656851057411,MATH 10B,A03,093472,Lim; Seonhee,4,0,34,30
1656851057411,MATH 10B,B01,083739,Sinha; Shubham,9,0,30,21
1656851063438,MATH 18,A01,083743,Cinel; Cameron Alexander,6,0,30,24
1656851063438,MATH 18,A02,083744,Cinel; Cameron Alexander,15,0,30,15
1656851063438,MATH 18,A03,083745,Cinel; Cameron Alexander,8,0,30,22
1656851063438,MATH 18,B01,083748,Rideout; David Porter,3,0,37,34
1656851063438,MATH 18,B02,083749,Rideout; David Porter,3,0,36,33
1656851063438,MATH 18,B03,083750,Rideout; David Porter,2,0,37,35
1656851063438,MATH 18,B04,083751,Rideout; David Porter,5,0,36,31
1656851063438,MATH 18,B05,093473,Rideout; David Porter,4,0,36,32
1656851063438,MATH 18,B06,093474,Rideout; David Porter,5,0,36,31
1656851069467,MATH 20A,A01,083754,Zheng; Zequn,12,0,40,28
1656851075503,MATH 20B,A01,083756,Briones; Jor-el Thomas Caparas,1,0,36,35
1656851075503,MATH 20B,A02,083757,Briones; Jor-el Thomas Caparas,1,0,36,35
1656851075503,MATH 20B,A03,093475,Briones; Jor-el Thomas Caparas,0,0,36,36
1656851081534,MATH 20C,A01,083760,Briones; Jor-el Thomas Caparas,1,0,35,34
1656851081534,MATH 20C,A02,083761,Briones; Jor-el Thomas Caparas,8,0,35,27
1656851081534,MATH 20C,A03,093476,Briones; Jor-el Thomas Caparas,0,1,36,36
1656851081534,MATH 20C,B01,083762,Bach; Quang Tran,0,0,30,30
1656851087559,MATH 20D,A01,083765,Tran; Brian Kha,4,0,30,26
1656851087559,MATH 20D,A02,083766,Tran; Brian Kha,4,0,30,26
1656851087559,MATH 20D,A03,083767,Tran; Brian Kha,2,0,30,28
1656851093590,MATH 20E,A01,083771,Ganguly; Soumya,5,0,32,27
1656851093590,MATH 20E,A02,083772,Ganguly; Soumya,6,0,32,26
1656851093590,MATH 20E,B01,083773,Ciotti; Benjamin,18,0,35,17
1656851093590,MATH 20E,B02,083774,Ciotti; Benjamin,17,0,35,18
1656851099616,MATH 103A,A01,083777,Greenfeld; Be'Eri,2,0,36,34
1656851099616,MATH 103A,A02,083778,Greenfeld; Be'Eri,5,0,36,31
1656851099616,MATH 103A,A03,093561,Greenfeld; Be'Eri,4,0,36,32
1656851099616,MATH 103A,B01,083779,Greenfeld; Be'Eri,6,0,36,30
1656851099616,MATH 103A,B02,083780,Greenfeld; Be'Eri,2,0,36,34
1656851099616,MATH 103A,B03,093562,Greenfeld; Be'Eri,2,0,36,34
1656851105642,MATH 105,A01,085443,Carter; Anne Toulson,13,0,35,22
1656851105642,MATH 105,A02,093477,Carter; Anne Toulson,20,0,35,15
1656851111667,MATH 109,A01,083213,Ganzberger; Geoffrey Michael,2,0,34,32
1656851111667,MATH 109,A02,083214,Ganzberger; Geoffrey Michael,2,0,34,32
1656851111667,MATH 109,A03,093478,Ganzberger; Geoffrey Michael,1,0,34,33
1656851111667,MATH 109,B01,083215,Ganzberger; Geoffrey Michael,1,0,32,31
1656851111667,MATH 109,B02,083216,Ganzberger; Geoffrey Michael,1,0,32,31
1656851111667,MATH 109,B03,093479,Ganzberger; Geoffrey Michael,6,0,32,26
1656851117699,MATH 142A,A01,083219,Chow; Bennett,6,0,32,26
1656851117699,MATH 142A,A02,083220,Chow; Bennett,9,0,32,23
1656851117699,MATH 142A,A03,093480,Chow; Bennett,7,0,32,25
1656851117699,MATH 142A,B03,093481,Chow; Bennett,7,0,32,25
1656851117699,MATH 142A,B04,093558,Chow; Bennett,10,0,32,22
1656851117699,MATH 142A,B05,093559,Chow; Bennett,6,0,32,26
1656851123732,MATH 193A,A01,083224,Rotar; Vladimir,6,0,34,28
1656851123732,MATH 193A,A02,083225,Rotar; Vladimir,3,0,34,31
1656851123732,MATH 193A,A03,083781,Rotar; Vladimir,1,0,34,33
1656851123732,MATH 193A,A04,083782,Rotar; Vladimir,6,0,34,28
1656851123732,MATH 193A,A05,093482,Rotar; Vladimir,6,0,34,28
1656851129759,MATH 197,001,091859,McAuley; Julian John,9999,0,9999,0
1656851129759,MATH 197,002,095566,Kedlaya; Kiran S.,9997,0,9999,2
1656851129759,MATH 197,003,095567,Xiao; Ming,9999,0,9999,0
1656851129759,MATH 197,004,095571,Perols; Johan Lars,9998,0,9999,1
1656851136848,COGS 9,A01,083615,Shannon; Kyle Michael,6,0,75,69
1656851142878,COGS 11,A01,083617,Boyle; Mary E. T.,18,0,48,30
1656851148907,COGS 13,A01,083071,Bastos; Amalia Pinkusfeld,8,0,71,63
1656851154937,COGS 14A,A01,092681,Semenuks; Arturs,0,1,100,100
1656851160969,COGS 14B,A01,083073,Cheng; Tzu-Han,5,0,63,58
1656851166994,COGS 17,A01,092677,Semenuks; Arturs,4,0,81,77
1656851173019,COGS 100,A01,083619,Allen; Michael Gordon,15,0,70,55
1656851179053,COGS 101A,A01,083621,Davis; Joshua Daniel,9,0,68,59
1656851185079,COGS 101B,A01,091572,Allen; Michael Gordon,8,0,65,57
1656851191105,COGS 101C,A01,083625,Delgado; Tania,17,0,35,18
1656851197132,COGS 107A,A01,083627,Boyle; Mary E. T.,13,0,60,47
1656851203155,COGS 118A,A01,083075,Gupta; Anjum,15,0,76,61
1656851209183,CSE 3,A50,083646,Miranda; Gregory Joseph,22,0,50,28
1656851215210,CSE 8A,A50,083650,Miranda; Gregory Joseph,17,1,56,39
1656851221238,CSE 11,A01,083080,Cao; Yingjun,4,15,40,36
1656851227268,CSE 12,A01,083652,Krause-Levy; Sophia Louisa,20,1,120,100
1656851233296,CSE 15L,A01,083654,Morris; Justin Loren,8,0,50,42
1656851233296,CSE 15L,A02,083655,Morris; Justin Loren,8,0,50,42
1656851239321,CSE 20,A01,083657,Tran; Khoa Dang,37,0,80,43
1656851245360,CSE 21,A01,095574,Bach; Quang Tran,21,0,48,27
1656851251384,CSE 30,A01,083084,Eldon; John,4,0,80,76
1656851251384,CSE 30,B01,095061,Bhaskar; Nishant,6,0,50,44
1656851257409,CSE 100,A01,083659,Cao; Yingjun,2,4,70,68
1656851263437,CSE 134B,A01,083661,Powell; Thomas Allan,19,0,100,81
1656851269462,CSE 140,A01,083663,Gungor; Onat,14,0,85,71
1656851275486,CSE 140L,A01,083088,Eldon; John,16,0,100,84
1656851281514,CSE 175,A01,083665,Kumar; Rakesh,3,0,25,22
1656851287536,CSE 190,A00,092507,Dubnov; Shlomo,7,0,20,13
1656851293563,ECE 45,A01,083139,Congero; Spencer William,5,0,75,70
1656851299592,ECE 65,A50,083695,Saad; Andrew S,12,0,30,18
1656851299592,ECE 65,A51,095125,Saad; Andrew S,25,0,26,1
1656851305687,ECE 109,A01,091882,Touri; Behrouz,16,0,70,54
1656851311713,ECE 180,A00,083140,Abi Samra; Nicholas Camill,0,0,30,30
1656851311713,ECE 180,B00,083141,Abi Samra; Nicholas Camill,0,0,30,30
1656851317745,MATH 10A,A01,083735,Patchell; Gregory David,1,0,30,29
1656851317745,MATH 10A,A02,083736,Patchell; Gregory David,20,0,30,10
1656851317745,MATH 10A,A03,083737,Patchell; Gregory David,15,0,30,15
1656851323770,MATH 10B,A01,083207,Lim; Seonhee,7,0,34,27
1656851323770,MATH 10B,A02,083208,Lim; Seonhee,9,0,35,26
1656851323770,MATH 10B,A03,093472,Lim; Seonhee,4,0,34,30
1656851323770,MATH 10B,B01,083739,Sinha; Shubham,9,0,30,21
1656851329801,MATH 18,A01,083743,Cinel; Cameron Alexander,6,0,30,24
1656851329801,MATH 18,A02,083744,Cinel; Cameron Alexander,15,0,30,15
1656851329801,MATH 18,A03,083745,Cinel; Cameron Alexander,8,0,30,22
1656851329801,MATH 18,B01,083748,Rideout; David Porter,3,0,37,34
1656851329801,MATH 18,B02,083749,Rideout; David Porter,3,0,36,33
1656851329801,MATH 18,B03,083750,Rideout; David Porter,2,0,37,35
1656851329801,MATH 18,B04,083751,Rideout; David Porter,5,0,36,31
1656851329801,MATH 18,B05,093473,Rideout; David Porter,4,0,36,32
1656851329801,MATH 18,B06,093474,Rideout; David Porter,5,0,36,31
1656851335829,MATH 20A,A01,083754,Zheng; Zequn,12,0,40,28
1656851341852,MATH 20B,A01,083756,Briones; Jor-el Thomas Caparas,1,0,36,35
1656851341852,MATH 20B,A02,083757,Briones; Jor-el Thomas Caparas,1,0,36,35
1656851341852,MATH 20B,A03,093475,Briones; Jor-el Thomas Caparas,0,0,36,36
1656851347874,MATH 20C,A01,083760,Briones; Jor-el Thomas Caparas,1,0,35,34
1656851347874,MATH 20C,A02,083761,Briones; Jor-el Thomas Caparas,8,0,35,27
1656851347874,MATH 20C,A03,093476,Briones; Jor-el Thomas Caparas,0,1,36,36
1656851347874,MATH 20C,B01,083762,Bach; Quang Tran,0,0,30,30
1656851353902,MATH 20D,A01,083765,Tran; Brian Kha,4,0,30,26
1656851353902,MATH 20D,A02,083766,Tran; Brian Kha,4,0,30,26
1656851353902,MATH 20D,A03,083767,Tran; Brian Kha,2,0,30,28
1656851359927,MATH 20E,A01,083771,Ganguly; Soumya,5,0,32,27
1656851359927,MATH 20E,A02,083772,Ganguly; Soumya,6,0,32,26
1656851359927,MATH 20E,B01,083773,Ciotti; Benjamin,18,0,35,17
1656851359927,MATH 20E,B02,083774,Ciotti; Benjamin,17,0,35,18
1656851365958,MATH 103A,A01,083777,Greenfeld; Be'Eri,2,0,36,34
1656851365958,MATH 103A,A02,083778,Greenfeld; Be'Eri,5,0,36,31
1656851365958,MATH 103A,A03,093561,Greenfeld; Be'Eri,4,0,36,32
1656851365958,MATH 103A,B01,083779,Greenfeld; Be'Eri,6,0,36,30
1656851365958,MATH 103A,B02,083780,Greenfeld; Be'Eri,2,0,36,34
1656851365958,MATH 103A,B03,093562,Greenfeld; Be'Eri,2,0,36,34
1656851371981,MATH 105,A01,085443,Carter; Anne Toulson,13,0,35,22
1656851371981,MATH 105,A02,093477,Carter; Anne Toulson,20,0,35,15
1656851378016,MATH 109,A01,083213,Ganzberger; Geoffrey Michael,2,0,34,32
1656851378016,MATH 109,A02,083214,Ganzberger; Geoffrey Michael,2,0,34,32
1656851378016,MATH 109,A03,093478,Ganzberger; Geoffrey Michael,1,0,34,33
1656851378016,MATH 109,B01,083215,Ganzberger; Geoffrey Michael,1,0,32,31
1656851378016,MATH 109,B02,083216,Ganzberger; Geoffrey Michael,1,0,32,31
1656851378016,MATH 109,B03,093479,Ganzberger; Geoffrey Michael,6,0,32,26
1656851384046,MATH 142A,A01,083219,Chow; Bennett,6,0,32,26
1656851384046,MATH 142A,A02,083220,Chow; Bennett,9,0,32,23
1656851384046,MATH 142A,A03,093480,Chow; Bennett,7,0,32,25
1656851384046,MATH 142A,B03,093481,Chow; Bennett,7,0,32,25
1656851384046,MATH 142A,B04,093558,Chow; Bennett,10,0,32,22
1656851384046,MATH 142A,B05,093559,Chow; Bennett,6,0,32,26
1656851390071,MATH 193A,A01,083224,Rotar; Vladimir,6,0,34,28
1656851390071,MATH 193A,A02,083225,Rotar; Vladimir,3,0,34,31
1656851390071,MATH 193A,A03,083781,Rotar; Vladimir,1,0,34,33
1656851390071,MATH 193A,A04,083782,Rotar; Vladimir,6,0,34,28
1656851390071,MATH 193A,A05,093482,Rotar; Vladimir,6,0,34,28
1656851396097,MATH 197,001,091859,McAuley; Julian John,9999,0,9999,0
1656851396097,MATH 197,002,095566,Kedlaya; Kiran S.,9997,0,9999,2
1656851396097,MATH 197,003,095567,Xiao; Ming,9999,0,9999,0
1656851396097,MATH 197,004,095571,Perols; Johan Lars,9998,0,9999,1
1656851403174,COGS 9,A01,083615,Shannon; Kyle Michael,6,0,75,69
1656851409198,COGS 11,A01,083617,Boyle; Mary E. T.,18,0,48,30
1656851415220,COGS 13,A01,083071,Bastos; Amalia Pinkusfeld,8,0,71,63
1656851421247,COGS 14A,A01,092681,Semenuks; Arturs,0,1,100,100
1656851427279,COGS 14B,A01,083073,Cheng; Tzu-Han,5,0,63,58
1656851433311,COGS 17,A01,092677,Semenuks; Arturs,4,0,81,77
1656851439340,COGS 100,A01,083619,Allen; Michael Gordon,15,0,70,55
1656851445366,COGS 101A,A01,083621,Davis; Joshua Daniel,9,0,68,59
1656851451389,COGS 101B,A01,091572,Allen; Michael Gordon,8,0,65,57
1656851457415,COGS 101C,A01,083625,Delgado; Tania,17,0,35,18
1656851463439,COGS 107A,A01,083627,Boyle; Mary E. T.,13,0,60,47
1656851469463,COGS 118A,A01,083075,Gupta; Anjum,15,0,76,61
1656851475493,CSE 3,A50,083646,Miranda; Gregory Joseph,22,0,50,28
1656851481516,CSE 8A,A50,083650,Miranda; Gregory Joseph,17,1,56,39
1656851487552,CSE 11,A01,083080,Cao; Yingjun,4,15,40,36
1656851493581,CSE 12,A01,083652,Krause-Levy; Sophia Louisa,20,1,120,100
1656851499606,CSE 15L,A01,083654,Morris; Justin Loren,8,0,50,42
1656851499606,CSE 15L,A02,083655,Morris; Justin Loren,8,0,50,42
1656851505635,CSE 20,A01,083657,Tran; Khoa Dang,37,0,80,43
1656851511663,CSE 21,A01,095574,Bach; Quang Tran,21,0,48,27
1656851517688,CSE 30,A01,083084,Eldon; John,4,0,80,76
1656851517688,CSE 30,B01,095061,Bhaskar; Nishant,6,0,50,44
1656851523712,CSE 100,A01,083659,Cao; Yingjun,2,4,70,68
1656851529742,CSE 134B,A01,083661,Powell; Thomas Allan,19,0,100,81
1656851535767,CSE 140,A01,083663,Gungor; Onat,14,0,85,71
1656851541791,CSE 140L,A01,083088,Eldon; John,16,0,100,84
1656851547821,CSE 175,A01,083665,Kumar; Rakesh,3,0,25,22
1656851553844,CSE 190,A00,092507,Dubnov; Shlomo,7,0,20,13
1656851559873,ECE 45,A01,083139,Congero; Spencer William,5,0,75,70
1656851565899,ECE 65,A50,083695,Saad; Andrew S,12,0,30,18
1656851565899,ECE 65,A51,095125,Saad; Andrew S,25,0,26,1
1656851571922,ECE 109,A01,091882,Touri; Behrouz,16,0,70,54
1656851577947,ECE 180,A00,083140,Abi Samra; Nicholas Camill,0,0,30,30
1656851577947,ECE 180,B00,083141,Abi Samra; Nicholas Camill,0,0,30,30
1656851583983,MATH 10A,A01,083735,Patchell; Gregory David,1,0,30,29
1656851583983,MATH 10A,A02,083736,Patchell; Gregory David,20,0,30,10
1656851583983,MATH 10A,A03,083737,Patchell; Gregory David,15,0,30,15
1656851590011,MATH 10B,A01,083207,Lim; Seonhee,7,0,34,27
1656851590011,MATH 10B,A02,083208,Lim; Seonhee,9,0,35,26
1656851590011,MATH 10B,A03,093472,Lim; Seonhee,4,0,34,30
1656851590011,MATH 10B,B01,083739,Sinha; Shubham,9,0,30,21
1656851596044,MATH 18,A01,083743,Cinel; Cameron Alexander,6,0,30,24
1656851596044,MATH 18,A02,083744,Cinel; Cameron Alexander,15,0,30,15
1656851596044,MATH 18,A03,083745,Cinel; Cameron Alexander,8,0,30,22
1656851596044,MATH 18,B01,083748,Rideout; David Porter,3,0,37,34
1656851596044,MATH 18,B02,083749,Rideout; David Porter,3,0,36,33
1656851596044,MATH 18,B03,083750,Rideout; David Porter,2,0,37,35
1656851596044,MATH 18,B04,083751,Rideout; David Porter,5,0,36,31
1656851596044,MATH 18,B05,093473,Rideout; David Porter,4,0,36,32
1656851596044,MATH 18,B06,093474,Rideout; David Porter,5,0,36,31
1656851602082,MATH 20A,A01,083754,Zheng; Zequn,12,0,40,28
1656851608112,MATH 20B,A01,083756,Briones; Jor-el Thomas Caparas,1,0,36,35
1656851608112,MATH 20B,A02,083757,Briones; Jor-el Thomas Caparas,1,0,36,35
1656851608112,MATH 20B,A03,093475,Briones; Jor-el Thomas Caparas,0,0,36,36
1656851614134,MATH 20C,A01,083760,Briones; Jor-el Thomas Caparas,1,0,35,34
1656851614134,MATH 20C,A02,083761,Briones; Jor-el Thomas Caparas,8,0,35,27
1656851614134,MATH 20C,A03,093476,Briones; Jor-el Thomas Caparas,0,1,36,36
1656851614134,MATH 20C,B01,083762,Bach; Quang Tran,0,0,30,30
1656851620183,MATH 20D,A01,083765,Tran; Brian Kha,4,0,30,26
1656851620183,MATH 20D,A02,083766,Tran; Brian Kha,4,0,30,26
1656851620183,MATH 20D,A03,083767,Tran; Brian Kha,2,0,30,28
1656851626208,MATH 20E,A01,083771,Ganguly; Soumya,5,0,32,27
1656851626208,MATH 20E,A02,083772,Ganguly; Soumya,6,0,32,26
1656851626208,MATH 20E,B01,083773,Ciotti; Benjamin,18,0,35,17
1656851626208,MATH 20E,B02,083774,Ciotti; Benjamin,17,0,35,18
1656851632239,MATH 103A,A01,083777,Greenfeld; Be'Eri,2,0,36,34
1656851632239,MATH 103A,A02,083778,Greenfeld; Be'Eri,5,0,36,31
1656851632239,MATH 103A,A03,093561,Greenfeld; Be'Eri,4,0,36,32
1656851632239,MATH 103A,B01,083779,Greenfeld; Be'Eri,6,0,36,30
1656851632239,MATH 103A,B02,083780,Greenfeld; Be'Eri,2,0,36,34
1656851632239,MATH 103A,B03,093562,Greenfeld; Be'Eri,2,0,36,34
1656851638265,MATH 105,A01,085443,Carter; Anne Toulson,13,0,35,22
1656851638265,MATH 105,A02,093477,Carter; Anne Toulson,20,0,35,15
1656851644289,MATH 109,A01,083213,Ganzberger; Geoffrey Michael,2,0,34,32
1656851644289,MATH 109,A02,083214,Ganzberger; Geoffrey Michael,2,0,34,32
1656851644289,MATH 109,A03,093478,Ganzberger; Geoffrey Michael,1,0,34,33
1656851644289,MATH 109,B01,083215,Ganzberger; Geoffrey Michael,1,0,32,31
1656851644289,MATH 109,B02,083216,Ganzberger; Geoffrey Michael,1,0,32,31
1656851644289,MATH 109,B03,093479,Ganzberger; Geoffrey Michael,6,0,32,26
1656851650332,MATH 142A,A01,083219,Chow; Bennett,6,0,32,26
1656851650332,MATH 142A,A02,083220,Chow; Bennett,9,0,32,23
1656851650332,MATH 142A,A03,093480,Chow; Bennett,7,0,32,25
1656851650332,MATH 142A,B03,093481,Chow; Bennett,7,0,32,25
1656851650332,MATH 142A,B04,093558,Chow; Bennett,10,0,32,22
1656851650332,MATH 142A,B05,093559,Chow; Bennett,6,0,32,26
1656851656361,MATH 193A,A01,083224,Rotar; Vladimir,6,0,34,28
1656851656361,MATH 193A,A02,083225,Rotar; Vladimir,3,0,34,31
1656851656361,MATH 193A,A03,083781,Rotar; Vladimir,1,0,34,33
1656851656361,MATH 193A,A04,083782,Rotar; Vladimir,6,0,34,28
1656851656361,MATH 193A,A05,093482,Rotar; Vladimir,6,0,34,28
1656851662385,MATH 197,001,091859,McAuley; Julian John,9999,0,9999,0
1656851662385,MATH 197,002,095566,Kedlaya; Kiran S.,9997,0,9999,2
1656851662385,MATH 197,003,095567,Xiao; Ming,9999,0,9999,0
1656851662385,MATH 197,004,095571,Perols; Johan Lars,9998,0,9999,1
1656851669468,COGS 9,A01,083615,Shannon; Kyle Michael,6,0,75,69
1656851675500,COGS 11,A01,083617,Boyle; Mary E. T.,18,0,48,30
1656851681525,COGS 13,A01,083071,Bastos; Amalia Pinkusfeld,8,0,71,63
1656851687550,COGS 14A,A01,092681,Semenuks; Arturs,0,1,100,100
1656851693578,COGS 14B,A01,083073,Cheng; Tzu-Han,5,0,63,58
1656851699603,COGS 17,A01,092677,Semenuks; Arturs,4,0,81,77
1656851705630,COGS 100,A01,083619,Allen; Michael Gordon,15,0,70,55
1656851711659,COGS 101A,A01,083621,Davis; Joshua Daniel,9,0,68,59
1656851717684,COGS 101B,A01,091572,Allen; Michael Gordon,8,0,65,57
1656851723709,COGS 101C,A01,083625,Delgado; Tania,17,0,35,18
1656851729736,COGS 107A,A01,083627,Boyle; Mary E. T.,13,0,60,47
1656851735759,COGS 118A,A01,083075,Gupta; Anjum,15,0,76,61
1656851741793,CSE 3,A50,083646,Miranda; Gregory Joseph,22,0,50,28
1656851747818,CSE 8A,A50,083650,Miranda; Gregory Joseph,17,1,56,39
1656851753842,CSE 11,A01,083080,Cao; Yingjun,4,15,40,36
1656851759871,CSE 12,A01,083652,Krause-Levy; Sophia Louisa,20,1,120,100
1656851765897,CSE 15L,A01,083654,Morris; Justin Loren,8,0,50,42
1656851765897,CSE 15L,A02,083655,Morris; Justin Loren,8,0,50,42
1656851771936,CSE 20,A01,083657,Tran; Khoa Dang,37,0,80,43
1656851777961,CSE 21,A01,095574,Bach; Quang Tran,21,0,48,27
1656851783988,CSE 30,A01,083084,Eldon; John,4,0,80,76
1656851783988,CSE 30,B01,095061,Bhaskar; Nishant,6,0,50,44
1656851790022,CSE 100,A01,083659,Cao; Yingjun,2,4,70,68
1656851796047,CSE 134B,A01,083661,Powell; Thomas Allan,19,0,100,81
1656851802069,CSE 140,A01,083663,Gungor; Onat,14,0,85,71
1656851808092,CSE 140L,A01,083088,Eldon; John,16,0,100,84
1656851814118,CSE 175,A01,083665,Kumar; Rakesh,3,0,25,22
1656851820145,CSE 190,A00,092507,Dubnov; Shlomo,7,0,20,13
1656851826168,ECE 45,A01,083139,Congero; Spencer William,5,0,75,70
1656851832199,ECE 65,A50,083695,Saad; Andrew S,12,0,30,18
1656851832199,ECE 65,A51,095125,Saad; Andrew S,25,0,26,1
1656851838228,ECE 109,A01,091882,Touri; Behrouz,16,0,70,54
1656851844254,ECE 180,A00,083140,Abi Samra; Nicholas Camill,0,0,30,30
1656851844254,ECE 180,B00,083141,Abi Samra; Nicholas Camill,0,0,30,30
1656851850277,MATH 10A,A01,083735,Patchell; Gregory David,1,0,30,29
1656851850277,MATH 10A,A02,083736,Patchell; Gregory David,20,0,30,10
1656851850277,MATH 10A,A03,083737,Patchell; Gregory David,15,0,30,15
1656851856304,MATH 10B,A01,083207,Lim; Seonhee,7,0,34,27
1656851856304,MATH 10B,A02,083208,Lim; Seonhee,9,0,35,26
1656851856304,MATH 10B,A03,093472,Lim; Seonhee,4,0,34,30
1656851856304,MATH 10B,B01,083739,Sinha; Shubham,9,0,30,21
1656851862336,MATH 18,A01,083743,Cinel; Cameron Alexander,6,0,30,24
1656851862336,MATH 18,A02,083744,Cinel; Cameron Alexander,15,0,30,15
1656851862336,MATH 18,A03,083745,Cinel; Cameron Alexander,8,0,30,22
1656851862336,MATH 18,B01,083748,Rideout; David Porter,3,0,37,34
1656851862336,MATH 18,B02,083749,Rideout; David Porter,3,0,36,33
1656851862336,MATH 18,B03,083750,Rideout; David Porter,2,0,37,35
1656851862336,MATH 18,B04,083751,Rideout; David Porter,5,0,36,31
1656851862336,MATH 18,B05,093473,Rideout; David Porter,4,0,36,32
1656851862336,MATH 18,B06,093474,Rideout; David Porter,5,0,36,31
1656851868364,MATH 20A,A01,083754,Zheng; Zequn,12,0,40,28
1656851874393,MATH 20B,A01,083756,Briones; Jor-el Thomas Caparas,1,0,36,35
1656851874393,MATH 20B,A02,083757,Briones; Jor-el Thomas Caparas,1,0,36,35
1656851874393,MATH 20B,A03,093475,Briones; Jor-el Thomas Caparas,0,0,36,36
1656851880421,MATH 20C,A01,083760,Briones; Jor-el Thomas Caparas,1,0,35,34
1656851880421,MATH 20C,A02,083761,Briones; Jor-el Thomas Caparas,8,0,35,27
1656851880421,MATH 20C,A03,093476,Briones; Jor-el Thomas Caparas,0,1,36,36
1656851880421,MATH 20C,B01,083762,Bach; Quang Tran,0,0,30,30
1656851886450,MATH 20D,A01,083765,Tran; Brian Kha,4,0,30,26
1656851886450,MATH 20D,A02,083766,Tran; Brian Kha,4,0,30,26
1656851886450,MATH 20D,A03,083767,Tran; Brian Kha,2,0,30,28
1656851892479,MATH 20E,A01,083771,Ganguly; Soumya,5,0,32,27
1656851892479,MATH 20E,A02,083772,Ganguly; Soumya,6,0,32,26
1656851892479,MATH 20E,B01,083773,Ciotti; Benjamin,18,0,35,17
1656851892479,MATH 20E,B02,083774,Ciotti; Benjamin,17,0,35,18
1656851898508,MATH 103A,A01,083777,Greenfeld; Be'Eri,2,0,36,34
1656851898508,MATH 103A,A02,083778,Greenfeld; Be'Eri,5,0,36,31
1656851898508,MATH 103A,A03,093561,Greenfeld; Be'Eri,4,0,36,32
1656851898508,MATH 103A,B01,083779,Greenfeld; Be'Eri,6,0,36,30
1656851898508,MATH 103A,B02,083780,Greenfeld; Be'Eri,2,0,36,34
1656851898508,MATH 103A,B03,093562,Greenfeld; Be'Eri,2,0,36,34
1656851904609,MATH 105,A01,085443,Carter; Anne Toulson,13,0,35,22
1656851904609,MATH 105,A02,093477,Carter; Anne Toulson,20,0,35,15
1656851910638,MATH 109,A01,083213,Ganzberger; Geoffrey Michael,2,0,34,32
1656851910638,MATH 109,A02,083214,Ganzberger; Geoffrey Michael,2,0,34,32
1656851910638,MATH 109,A03,093478,Ganzberger; Geoffrey Michael,1,0,34,33
1656851910638,MATH 109,B01,083215,Ganzberger; Geoffrey Michael,1,0,32,31
1656851910638,MATH 109,B02,083216,Ganzberger; Geoffrey Michael,1,0,32,31
1656851910638,MATH 109,B03,093479,Ganzberger; Geoffrey Michael,6,0,32,26
1656851916662,MATH 142A,A01,083219,Chow; Bennett,6,0,32,26
1656851916662,MATH 142A,A02,083220,Chow; Bennett,9,0,32,23
1656851916662,MATH 142A,A03,093480,Chow; Bennett,7,0,32,25
1656851916662,MATH 142A,B03,093481,Chow; Bennett,7,0,32,25
1656851916662,MATH 142A,B04,093558,Chow; Bennett,10,0,32,22
1656851916662,MATH 142A,B05,093559,Chow; Bennett,6,0,32,26
1656851922685,MATH 193A,A01,083224,Rotar; Vladimir,6,0,34,28
1656851922685,MATH 193A,A02,083225,Rotar; Vladimir,3,0,34,31
1656851922685,MATH 193A,A03,083781,Rotar; Vladimir,1,0,34,33
1656851922685,MATH 193A,A04,083782,Rotar; Vladimir,6,0,34,28
1656851922685,MATH 193A,A05,093482,Rotar; Vladimir,6,0,34,28
1656851928711,MATH 197,001,091859,McAuley; Julian John,9999,0,9999,0
1656851928711,MATH 197,002,095566,Kedlaya; Kiran S.,9997,0,9999,2
1656851928711,MATH 197,003,095567,Xiao; Ming,9999,0,9999,0
1656851928711,MATH 197,004,095571,Perols; Johan Lars,9998,0,9999,1
1656851935768,COGS 9,A01,083615,Shannon; Kyle Michael,6,0,75,69
1656851941791,COGS 11,A01,083617,Boyle; Mary E. T.,18,0,48,30
1656851947818,COGS 13,A01,083071,Bastos; Amalia Pinkusfeld,8,0,71,63
1656851953844,COGS 14A,A01,092681,Semenuks; Arturs,0,1,100,100
1656851959868,COGS 14B,A01,083073,Cheng; Tzu-Han,5,0,63,58
1656851965893,COGS 17,A01,092677,Semenuks; Arturs,4,0,81,77
1656851971916,COGS 100,A01,083619,Allen; Michael Gordon,15,0,70,55
1656851977942,COGS 101A,A01,083621,Davis; Joshua Daniel,9,0,68,59
1656851983965,COGS 101B,A01,091572,Allen; Michael Gordon,8,0,65,57
1656851990001,COGS 101C,A01,083625,Delgado; Tania,17,0,35,18
1656851996025,COGS 107A,A01,083627,Boyle; Mary E. T.,13,0,60,47
1656852002051,COGS 118A,A01,083075,Gupta; Anjum,15,0,76,61
1656852008074,CSE 3,A50,083646,Miranda; Gregory Joseph,22,0,50,28
1656852014102,CSE 8A,A50,083650,Miranda; Gregory Joseph,17,1,56,39
1656852020135,CSE 11,A01,083080,Cao; Yingjun,4,15,40,36
1656852026158,CSE 12,A01,083652,Krause-Levy; Sophia Louisa,20,1,120,100
1656852032180,CSE 15L,A01,083654,Morris; Justin Loren,8,0,50,42
1656852032180,CSE 15L,A02,083655,Morris; Justin Loren,8,0,50,42
1656852038205,CSE 20,A01,083657,Tran; Khoa Dang,37,0,80,43
1656852044233,CSE 21,A01,095574,Bach; Quang Tran,21,0,48,27
1656852050258,CSE 30,A01,083084,Eldon; John,4,0,80,76
1656852050258,CSE 30,B01,095061,Bhaskar; Nishant,6,0,50,44
1656852056287,CSE 100,A01,083659,Cao; Yingjun,2,4,70,68
1656852062312,CSE 134B,A01,083661,Powell; Thomas Allan,19,0,100,81
1656852068340,CSE 140,A01,083663,Gungor; Onat,14,0,85,71
1656852074365,CSE 140L,A01,083088,Eldon; John,16,0,100,84
1656852080389,CSE 175,A01,083665,Kumar; Rakesh,3,0,25,22
1656852086416,CSE 190,A00,092507,Dubnov; Shlomo,7,0,20,13
1656852092449,ECE 45,A01,083139,Congero; Spencer William,5,0,75,70
1656852098472,ECE 65,A50,083695,Saad; Andrew S,12,0,30,18
1656852098472,ECE 65,A51,095125,Saad; Andrew S,25,0,26,1
1656852104500,ECE 109,A01,091882,Touri; Behrouz,16,0,70,54
1656852110527,ECE 180,A00,083140,Abi Samra; Nicholas Camill,0,0,30,30
1656852110527,ECE 180,B00,083141,Abi Samra; Nicholas Camill,0,0,30,30
1656852116553,MATH 10A,A01,083735,Patchell; Gregory David,1,0,30,29
1656852116553,MATH 10A,A02,083736,Patchell; Gregory David,20,0,30,10
1656852116553,MATH 10A,A03,083737,Patchell; Gregory David,15,0,30,15
1656852122579,MATH 10B,A01,083207,Lim; Seonhee,7,0,34,27
1656852122579,MATH 10B,A02,083208,Lim; Seonhee,9,0,35,26
1656852122579,MATH 10B,A03,093472,Lim; Seonhee,4,0,34,30
1656852122579,MATH 10B,B01,083739,Sinha; Shubham,9,0,30,21
1656852128603,MATH 18,A01,083743,Cinel; Cameron Alexander,6,0,30,24
1656852128603,MATH 18,A02,083744,Cinel; Cameron Alexander,15,0,30,15
1656852128603,MATH 18,A03,083745,Cinel; Cameron Alexander,8,0,30,22
1656852128603,MATH 18,B01,083748,Rideout; David Porter,3,0,37,34
1656852128603,MATH 18,B02,083749,Rideout; David Porter,3,0,36,33
1656852128603,MATH 18,B03,083750,Rideout; David Porter,2,0,37,35
1656852128603,MATH 18,B04,083751,Rideout; David Porter,5,0,36,31
1656852128603,MATH 18,B05,093473,Rideout; David Porter,4,0,36,32
1656852128603,MATH 18,B06,093474,Rideout; David Porter,5,0,36,31
1656852134631,MATH 20A,A01,083754,Zheng; Zequn,12,0,40,28
1656852140656,MATH 20B,A01,083756,Briones; Jor-el Thomas Caparas,1,0,36,35
1656852140656,MATH 20B,A02,083757,Briones; Jor-el Thomas Caparas,1,0,36,35
1656852140656,MATH 20B,A03,093475,Briones; Jor-el Thomas Caparas,0,0,36,36
1656852146686,MATH 20C,A01,083760,Briones; Jor-el Thomas Caparas,1,0,35,34
1656852146686,MATH 20C,A02,083761,Briones; Jor-el Thomas Caparas,8,0,35,27
1656852146686,MATH 20C,A03,093476,Briones; Jor-el Thomas Caparas,0,1,36,36
1656852146686,MATH 20C,B01,083762,Bach; Quang Tran,0,0,30,30
1656852152713,MATH 20D,A01,083765,Tran; Brian Kha,4,0,30,26
1656852152713,MATH 20D,A02,083766,Tran; Brian Kha,4,0,30,26
1656852152713,MATH 20D,A03,083767,Tran; Brian Kha,2,0,30,28
1656852158741,MATH 20E,A01,083771,Ganguly; Soumya,5,0,32,27
1656852158741,MATH 20E,A02,083772,Ganguly; Soumya,6,0,32,26
1656852158741,MATH 20E,B01,083773,Ciotti; Benjamin,18,0,35,17
1656852158741,MATH 20E,B02,083774,Ciotti; Benjamin,17,0,35,18
1656852164767,MATH 103A,A01,083777,Greenfeld; Be'Eri,2,0,36,34
1656852164767,MATH 103A,A02,083778,Greenfeld; Be'Eri,5,0,36,31
1656852164767,MATH 103A,A03,093561,Greenfeld; Be'Eri,4,0,36,32
1656852164767,MATH 103A,B01,083779,Greenfeld; Be'Eri,6,0,36,30
1656852164767,MATH 103A,B02,083780,Greenfeld; Be'Eri,2,0,36,34
1656852164767,MATH 103A,B03,093562,Greenfeld; Be'Eri,2,0,36,34
1656852170794,MATH 105,A01,085443,Carter; Anne Toulson,13,0,35,22
1656852170794,MATH 105,A02,093477,Carter; Anne Toulson,20,0,35,15
1656852176825,MATH 109,A01,083213,Ganzberger; Geoffrey Michael,2,0,34,32
1656852176825,MATH 109,A02,083214,Ganzberger; Geoffrey Michael,2,0,34,32
1656852176825,MATH 109,A03,093478,Ganzberger; Geoffrey Michael,1,0,34,33
1656852176825,MATH 109,B01,083215,Ganzberger; Geoffrey Michael,1,0,32,31
1656852176825,MATH 109,B02,083216,Ganzberger; Geoffrey Michael,1,0,32,31
1656852176825,MATH 109,B03,093479,Ganzberger; Geoffrey Michael,6,0,32,26
1656852182849,MATH 142A,A01,083219,Chow; Bennett,6,0,32,26
1656852182849,MATH 142A,A02,083220,Chow; Bennett,9,0,32,23
1656852182849,MATH 142A,A03,093480,Chow; Bennett,7,0,32,25
1656852182849,MATH 142A,B03,093481,Chow; Bennett,7,0,32,25
1656852182849,MATH 142A,B04,093558,Chow; Bennett,10,0,32,22
1656852182849,MATH 142A,B05,093559,Chow; Bennett,6,0,32,26
1656852188873,MATH 193A,A01,083224,Rotar; Vladimir,6,0,34,28
1656852188873,MATH 193A,A02,083225,Rotar; Vladimir,3,0,34,31
1656852188873,MATH 193A,A03,083781,Rotar; Vladimir,1,0,34,33
1656852188873,MATH 193A,A04,083782,Rotar; Vladimir,6,0,34,28
1656852188873,MATH 193A,A05,093482,Rotar; Vladimir,6,0,34,28
1656852194896,MATH 197,001,091859,McAuley; Julian John,9999,0,9999,0
1656852194896,MATH 197,002,095566,Kedlaya; Kiran S.,9997,0,9999,2
1656852194896,MATH 197,003,095567,Xiao; Ming,9999,0,9999,0
1656852194896,MATH 197,004,095571,Perols; Johan Lars,9998,0,9999,1
1656852201959,COGS 9,A01,083615,Shannon; Kyle Michael,6,0,75,69
1656852207983,COGS 11,A01,083617,Boyle; Mary E. T.,18,0,48,30
1656852214008,COGS 13,A01,083071,Bastos; Amalia Pinkusfeld,8,0,71,63
1656852220032,COGS 14A,A01,092681,Semenuks; Arturs,0,1,100,100
1656852226057,COGS 14B,A01,083073,Cheng; Tzu-Han,5,0,63,58
1656852232080,COGS 17,A01,092677,Semenuks; Arturs,4,0,81,77
1656852238104,COGS 100,A01,083619,Allen; Michael Gordon,15,0,70,55
1656852244131,COGS 101A,A01,083621,Davis; Joshua Daniel,9,0,68,59
1656852250158,COGS 101B,A01,091572,Allen; Michael Gordon,8,0,65,57
1656852256181,COGS 101C,A01,083625,Delgado; Tania,17,0,35,18
1656852262209,COGS 107A,A01,083627,Boyle; Mary E. T.,13,0,60,47
1656852268233,COGS 118A,A01,083075,Gupta; Anjum,15,0,76,61
1656852274258,CSE 3,A50,083646,Miranda; Gregory Joseph,22,0,50,28
1656852280283,CSE 8A,A50,083650,Miranda; Gregory Joseph,17,1,56,39
1656852286308,CSE 11,A01,083080,Cao; Yingjun,4,15,40,36
1656852292330,CSE 12,A01,083652,Krause-Levy; Sophia Louisa,20,1,120,100
1656852298355,CSE 15L,A01,083654,Morris; Justin Loren,8,0,50,42
1656852298355,CSE 15L,A02,083655,Morris; Justin Loren,8,0,50,42
1656852304384,CSE 20,A01,083657,Tran; Khoa Dang,37,0,80,43
1656852310407,CSE 21,A01,095574,Bach; Quang Tran,21,0,48,27
1656852316431,CSE 30,A01,083084,Eldon; John,4,0,80,76
1656852316431,CSE 30,B01,095061,Bhaskar; Nishant,6,0,50,44
1656852322457,CSE 100,A01,083659,Cao; Yingjun,2,4,70,68
1656852328485,CSE 134B,A01,083661,Powell; Thomas Allan,19,0,100,81
1656852334512,CSE 140,A01,083663,Gungor; Onat,14,0,85,71
1656852340536,CSE 140L,A01,083088,Eldon; John,16,0,100,84
1656852346560,CSE 175,A01,083665,Kumar; Rakesh,3,0,25,22
1656852352586,CSE 190,A00,092507,Dubnov; Shlomo,7,0,20,13
1656852358611,ECE 45,A01,083139,Congero; Spencer William,5,0,75,70
1656852364641,ECE 65,A50,083695,Saad; Andrew S,12,0,30,18
1656852364641,ECE 65,A51,095125,Saad; Andrew S,25,0,26,1
1656852370666,ECE 109,A01,091882,Touri; Behrouz,16,0,70,54
1656852376696,ECE 180,A00,083140,Abi Samra; Nicholas Camill,0,0,30,30
1656852376696,ECE 180,B00,083141,Abi Samra; Nicholas Camill,0,0,30,30
1656852382721,MATH 10A,A01,083735,Patchell; Gregory David,1,0,30,29
1656852382721,MATH 10A,A02,083736,Patchell; Gregory David,20,0,30,10
1656852382721,MATH 10A,A03,083737,Patchell; Gregory David,15,0,30,15
1656852388744,MATH 10B,A01,083207,Lim; Seonhee,7,0,34,27
1656852388744,MATH 10B,A02,083208,Lim; Seonhee,9,0,35,26
1656852388744,MATH 10B,A03,093472,Lim; Seonhee,4,0,34,30
1656852388744,MATH 10B,B01,083739,Sinha; Shubham,9,0,30,21
1656852394769,MATH 18,A01,083743,Cinel; Cameron Alexander,6,0,30,24
1656852394769,MATH 18,A02,083744,Cinel; Cameron Alexander,15,0,30,15
1656852394769,MATH 18,A03,083745,Cinel; Cameron Alexander,8,0,30,22
1656852394769,MATH 18,B01,083748,Rideout; David Porter,3,0,37,34
1656852394769,MATH 18,B02,083749,Rideout; David Porter,3,0,36,33
1656852394769,MATH 18,B03,083750,Rideout; David Porter,2,0,37,35
1656852394769,MATH 18,B04,083751,Rideout; David Porter,5,0,36,31
1656852394769,MATH 18,B05,093473,Rideout; David Porter,4,0,36,32
1656852394769,MATH 18,B06,093474,Rideout; David Porter,5,0,36,31
1656852400800,MATH 20A,A01,083754,Zheng; Zequn,12,0,40,28
1656852406823,MATH 20B,A01,083756,Briones; Jor-el Thomas Caparas,1,0,36,35
1656852406823,MATH 20B,A02,083757,Briones; Jor-el Thomas Caparas,1,0,36,35
1656852406823,MATH 20B,A03,093475,Briones; Jor-el Thomas Caparas,0,0,36,36
1656852412849,MATH 20C,A01,083760,Briones; Jor-el Thomas Caparas,1,0,35,34
1656852412849,MATH 20C,A02,083761,Briones; Jor-el Thomas Caparas,8,0,35,27
1656852412849,MATH 20C,A03,093476,Briones; Jor-el Thomas Caparas,0,1,36,36
1656852412849,MATH 20C,B01,083762,Bach; Quang Tran,0,0,30,30
1656852418879,MATH 20D,A01,083765,Tran; Brian Kha,4,0,30,26
1656852418879,MATH 20D,A02,083766,Tran; Brian Kha,4,0,30,26
1656852418879,MATH 20D,A03,083767,Tran; Brian Kha,2,0,30,28
1656852424905,MATH 20E,A01,083771,Ganguly; Soumya,5,0,32,27
1656852424905,MATH 20E,A02,083772,Ganguly; Soumya,6,0,32,26
1656852424905,MATH 20E,B01,083773,Ciotti; Benjamin,18,0,35,17
1656852424905,MATH 20E,B02,083774,Ciotti; Benjamin,17,0,35,18
1656852430935,MATH 103A,A01,083777,Greenfeld; Be'Eri,2,0,36,34
1656852430935,MATH 103A,A02,083778,Greenfeld; Be'Eri,5,0,36,31
1656852430935,MATH 103A,A03,093561,Greenfeld; Be'Eri,4,0,36,32
1656852430935,MATH 103A,B01,083779,Greenfeld; Be'Eri,6,0,36,30
1656852430935,MATH 103A,B02,083780,Greenfeld; Be'Eri,2,0,36,34
1656852430935,MATH 103A,B03,093562,Greenfeld; Be'Eri,2,0,36,34
1656852436965,MATH 105,A01,085443,Carter; Anne Toulson,13,0,35,22
1656852436965,MATH 105,A02,093477,Carter; Anne Toulson,20,0,35,15
1656852442991,MATH 109,A01,083213,Ganzberger; Geoffrey Michael,2,0,34,32
1656852442991,MATH 109,A02,083214,Ganzberger; Geoffrey Michael,2,0,34,32
1656852442991,MATH 109,A03,093478,Ganzberger; Geoffrey Michael,1,0,34,33
1656852442991,MATH 109,B01,083215,Ganzberger; Geoffrey Michael,1,0,32,31
1656852442991,MATH 109,B02,083216,Ganzberger; Geoffrey Michael,1,0,32,31
1656852442991,MATH 109,B03,093479,Ganzberger; Geoffrey Michael,6,0,32,26
1656852449019,MATH 142A,A01,083219,Chow; Bennett,6,0,32,26
1656852449019,MATH 142A,A02,083220,Chow; Bennett,9,0,32,23
1656852449019,MATH 142A,A03,093480,Chow; Bennett,7,0,32,25
1656852449019,MATH 142A,B03,093481,Chow; Bennett,7,0,32,25
1656852449019,MATH 142A,B04,093558,Chow; Bennett,10,0,32,22
1656852449019,MATH 142A,B05,093559,Chow; Bennett,6,0,32,26
1656852455043,MATH 193A,A01,083224,Rotar; Vladimir,6,0,34,28
1656852455043,MATH 193A,A02,083225,Rotar; Vladimir,3,0,34,31
1656852455043,MATH 193A,A03,083781,Rotar; Vladimir,1,0,34,33
1656852455043,MATH 193A,A04,083782,Rotar; Vladimir,6,0,34,28
1656852455043,MATH 193A,A05,093482,Rotar; Vladimir,6,0,34,28
1656852461072,MATH 197,001,091859,McAuley; Julian John,9999,0,9999,0
1656852461072,MATH 197,002,095566,Kedlaya; Kiran S.,9997,0,9999,2
1656852461072,MATH 197,003,095567,Xiao; Ming,9999,0,9999,0
1656852461072,MATH 197,004,095571,Perols; Johan Lars,9998,0,9999,1
1656852468139,COGS 9,A01,083615,Shannon; Kyle Michael,6,0,75,69
1656852474165,COGS 11,A01,083617,Boyle; Mary E. T.,18,0,48,30
1656852480211,COGS 13,A01,083071,Bastos; Amalia Pinkusfeld,8,0,71,63
1656852486238,COGS 14A,A01,092681,Semenuks; Arturs,0,1,100,100
1656852492267,COGS 14B,A01,083073,Cheng; Tzu-Han,5,0,63,58
1656852498366,COGS 17,A01,092677,Semenuks; Arturs,4,0,81,77
1656852504392,COGS 100,A01,083619,Allen; Michael Gordon,15,0,70,55
1656852510423,COGS 101A,A01,083621,Davis; Joshua Daniel,9,0,68,59
1656852516446,COGS 101B,A01,091572,Allen; Michael Gordon,8,0,65,57
1656852522472,COGS 101C,A01,083625,Delgado; Tania,17,0,35,18
1656852528495,COGS 107A,A01,083627,Boyle; Mary E. T.,13,0,60,47
1656852534521,COGS 118A,A01,083075,Gupta; Anjum,15,0,76,61
1656852540548,CSE 3,A50,083646,Miranda; Gregory Joseph,22,0,50,28
1656852546574,CSE 8A,A50,083650,Miranda; Gregory Joseph,17,1,56,39
1656852552601,CSE 11,A01,083080,Cao; Yingjun,4,15,40,36
1656852558625,CSE 12,A01,083652,Krause-Levy; Sophia Louisa,20,1,120,100
1656852564654,CSE 15L,A01,083654,Morris; Justin Loren,8,0,50,42
1656852564654,CSE 15L,A02,083655,Morris; Justin Loren,8,0,50,42
1656852570678,CSE 20,A01,083657,Tran; Khoa Dang,37,0,80,43
1656852576706,CSE 21,A01,095574,Bach; Quang Tran,21,0,48,27
1656852582736,CSE 30,A01,083084,Eldon; John,4,0,80,76
1656852582736,CSE 30,B01,095061,Bhaskar; Nishant,6,0,50,44
1656852588762,CSE 100,A01,083659,Cao; Yingjun,2,4,70,68
1656852594787,CSE 134B,A01,083661,Powell; Thomas Allan,19,0,100,81
1656852600816,CSE 140,A01,083663,Gungor; Onat,14,0,85,71
1656852606844,CSE 140L,A01,083088,Eldon; John,16,0,100,84
1656852612873,CSE 175,A01,083665,Kumar; Rakesh,3,0,25,22
1656852618903,CSE 190,A00,092507,Dubnov; Shlomo,7,0,20,13
1656852624928,ECE 45,A01,083139,Congero; Spencer William,5,0,75,70
1656852630953,ECE 65,A50,083695,Saad; Andrew S,12,0,30,18
1656852630953,ECE 65,A51,095125,Saad; Andrew S,25,0,26,1
1656852636981,ECE 109,A01,091882,Touri; Behrouz,16,0,70,54
1656852643009,ECE 180,A00,083140,Abi Samra; Nicholas Camill,0,0,30,30
1656852643009,ECE 180,B00,083141,Abi Samra; Nicholas Camill,0,0,30,30
1656852649033,MATH 10A,A01,083735,Patchell; Gregory David,1,0,30,29
1656852649033,MATH 10A,A02,083736,Patchell; Gregory David,20,0,30,10
1656852649033,MATH 10A,A03,083737,Patchell; Gregory David,15,0,30,15
1656852655060,MATH 10B,A01,083207,Lim; Seonhee,7,0,34,27
1656852655060,MATH 10B,A02,083208,Lim; Seonhee,9,0,35,26
1656852655060,MATH 10B,A03,093472,Lim; Seonhee,4,0,34,30
1656852655060,MATH 10B,B01,083739,Sinha; Shubham,9,0,30,21
1656852661094,MATH 18,A01,083743,Cinel; Cameron Alexander,6,0,30,24
1656852661094,MATH 18,A02,083744,Cinel; Cameron Alexander,15,0,30,15
1656852661094,MATH 18,A03,083745,Cinel; Cameron Alexander,8,0,30,22
1656852661094,MATH 18,B01,083748,Rideout; David Porter,3,0,37,34
1656852661094,MATH 18,B02,083749,Rideout; David Porter,3,0,36,33
1656852661094,MATH 18,B03,083750,Rideout; David Porter,2,0,37,35
1656852661094,MATH 18,B04,083751,Rideout; David Porter,5,0,36,31
1656852661094,MATH 18,B05,093473,Rideout; David Porter,4,0,36,32
1656852661094,MATH 18,B06,093474,Rideout; David Porter,5,0,36,31
1656852667128,MATH 20A,A01,083754,Zheng; Zequn,12,0,40,28
1656852673152,MATH 20B,A01,083756,Briones; Jor-el Thomas Caparas,1,0,36,35
1656852673152,MATH 20B,A02,083757,Briones; Jor-el Thomas Caparas,1,0,36,35
1656852673152,MATH 20B,A03,093475,Briones; Jor-el Thomas Caparas,0,0,36,36
1656852679183,MATH 20C,A01,083760,Briones; Jor-el Thomas Caparas,1,0,35,34
1656852679183,MATH 20C,A02,083761,Briones; Jor-el Thomas Caparas,8,0,35,27
1656852679183,MATH 20C,A03,093476,Briones; Jor-el Thomas Caparas,0,1,36,36
1656852679183,MATH 20C,B01,083762,Bach; Quang Tran,0,0,30,30
1656852685210,MATH 20D,A01,083765,Tran; Brian Kha,4,0,30,26
1656852685210,MATH 20D,A02,083766,Tran; Brian Kha,4,0,30,26
1656852685210,MATH 20D,A03,083767,Tran; Brian Kha,2,0,30,28
1656852691243,MATH 20E,A01,083771,Ganguly; Soumya,5,0,32,27
1656852691243,MATH 20E,A02,083772,Ganguly; Soumya,6,0,32,26
1656852691243,MATH 20E,B01,083773,Ciotti; Benjamin,18,0,35,17
1656852691243,MATH 20E,B02,083774,Ciotti; Benjamin,17,0,35,18
1656852697276,MATH 103A,A01,083777,Greenfeld; Be'Eri,2,0,36,34
1656852697276,MATH 103A,A02,083778,Greenfeld; Be'Eri,5,0,36,31
1656852697276,MATH 103A,A03,093561,Greenfeld; Be'Eri,4,0,36,32
1656852697276,MATH 103A,B01,083779,Greenfeld; Be'Eri,6,0,36,30
1656852697276,MATH 103A,B02,083780,Greenfeld; Be'Eri,2,0,36,34
1656852697276,MATH 103A,B03,093562,Greenfeld; Be'Eri,2,0,36,34
1656852703306,MATH 105,A01,085443,Carter; Anne Toulson,13,0,35,22
1656852703306,MATH 105,A02,093477,Carter; Anne Toulson,20,0,35,15
1656852709330,MATH 109,A01,083213,Ganzberger; Geoffrey Michael,2,0,34,32
1656852709330,MATH 109,A02,083214,Ganzberger; Geoffrey Michael,2,0,34,32
1656852709330,MATH 109,A03,093478,Ganzberger; Geoffrey Michael,1,0,34,33
1656852709330,MATH 109,B01,083215,Ganzberger; Geoffrey Michael,1,0,32,31
1656852709330,MATH 109,B02,083216,Ganzberger; Geoffrey Michael,1,0,32,31
1656852709330,MATH 109,B03,093479,Ganzberger; Geoffrey Michael,6,0,32,26
1656852715356,MATH 142A,A01,083219,Chow; Bennett,6,0,32,26
1656852715356,MATH 142A,A02,083220,Chow; Bennett,9,0,32,23
1656852715356,MATH 142A,A03,093480,Chow; Bennett,7,0,32,25
1656852715356,MATH 142A,B03,093481,Chow; Bennett,7,0,32,25
1656852715356,MATH 142A,B04,093558,Chow; Bennett,10,0,32,22
1656852715356,MATH 142A,B05,093559,Chow; Bennett,6,0,32,26
1656852721387,MATH 193A,A01,083224,Rotar; Vladimir,6,0,34,28
1656852721387,MATH 193A,A02,083225,Rotar; Vladimir,3,0,34,31
1656852721387,MATH 193A,A03,083781,Rotar; Vladimir,1,0,34,33
1656852721387,MATH 193A,A04,083782,Rotar; Vladimir,6,0,34,28
1656852721387,MATH 193A,A05,093482,Rotar; Vladimir,6,0,34,28
1656852727414,MATH 197,001,091859,McAuley; Julian John,9999,0,9999,0
1656852727414,MATH 197,002,095566,Kedlaya; Kiran S.,9997,0,9999,2
1656852727414,MATH 197,003,095567,Xiao; Ming,9999,0,9999,0
1656852727414,MATH 197,004,095571,Perols; Johan Lars,9998,0,9999,1
1656852734489,COGS 9,A01,083615,Shannon; Kyle Michael,6,0,75,69
1656852740514,COGS 11,A01,083617,Boyle; Mary E. T.,18,0,48,30
1656852746539,COGS 13,A01,083071,Bastos; Amalia Pinkusfeld,8,0,71,63
1656852752567,COGS 14A,A01,092681,Semenuks; Arturs,0,1,100,100
1656852758592,COGS 14B,A01,083073,Cheng; Tzu-Han,5,0,63,58
1656852764623,COGS 17,A01,092677,Semenuks; Arturs,4,0,81,77
1656852770652,COGS 100,A01,083619,Allen; Michael Gordon,15,0,70,55
1656852776676,COGS 101A,A01,083621,Davis; Joshua Daniel,9,0,68,59
1656852782703,COGS 101B,A01,091572,Allen; Michael Gordon,8,0,65,57
1656852788729,COGS 101C,A01,083625,Delgado; Tania,17,0,35,18
1656852794753,COGS 107A,A01,083627,Boyle; Mary E. T.,13,0,60,47
1656852800780,COGS 118A,A01,083075,Gupta; Anjum,15,0,76,61
1656852806805,CSE 3,A50,083646,Miranda; Gregory Joseph,22,0,50,28
1656852812836,CSE 8A,A50,083650,Miranda; Gregory Joseph,17,1,56,39
1656852818862,CSE 11,A01,083080,Cao; Yingjun,4,15,40,36
1656852824890,CSE 12,A01,083652,Krause-Levy; Sophia Louisa,20,1,120,100
1656852830920,CSE 15L,A01,083654,Morris; Justin Loren,8,0,50,42
1656852830920,CSE 15L,A02,083655,Morris; Justin Loren,8,0,50,42
1656852836946,CSE 20,A01,083657,Tran; Khoa Dang,37,0,80,43
1656852842972,CSE 21,A01,095574,Bach; Quang Tran,21,0,48,27
1656852848998,CSE 30,A01,083084,Eldon; John,4,0,80,76
1656852848998,CSE 30,B01,095061,Bhaskar; Nishant,6,0,50,44
1656852855029,CSE 100,A01,083659,Cao; Yingjun,2,4,70,68
1656852861054,CSE 134B,A01,083661,Powell; Thomas Allan,19,0,100,81
1656852867080,CSE 140,A01,083663,Gungor; Onat,14,0,85,71
1656852873106,CSE 140L,A01,083088,Eldon; John,16,0,100,84
1656852879132,CSE 175,A01,083665,Kumar; Rakesh,3,0,25,22
1656852885157,CSE 190,A00,092507,Dubnov; Shlomo,7,0,20,13
1656852891182,ECE 45,A01,083139,Congero; Spencer William,5,0,75,70
1656852897206,ECE 65,A50,083695,Saad; Andrew S,12,0,30,18
1656852897206,ECE 65,A51,095125,Saad; Andrew S,25,0,26,1
1656852903239,ECE 109,A01,091882,Touri; Behrouz,16,0,70,54
1656852909270,ECE 180,A00,083140,Abi Samra; Nicholas Camill,0,0,30,30
1656852909270,ECE 180,B00,083141,Abi Samra; Nicholas Camill,0,0,30,30
1656852915301,MATH 10A,A01,083735,Patchell; Gregory David,1,0,30,29
1656852915301,MATH 10A,A02,083736,Patchell; Gregory David,20,0,30,10
1656852915301,MATH 10A,A03,083737,Patchell; Gregory David,15,0,30,15
1656852921327,MATH 10B,A01,083207,Lim; Seonhee,7,0,34,27
1656852921327,MATH 10B,A02,083208,Lim; Seonhee,9,0,35,26
1656852921327,MATH 10B,A03,093472,Lim; Seonhee,4,0,34,30
1656852921327,MATH 10B,B01,083739,Sinha; Shubham,9,0,30,21
1656852927364,MATH 18,A01,083743,Cinel; Cameron Alexander,6,0,30,24
1656852927364,MATH 18,A02,083744,Cinel; Cameron Alexander,15,0,30,15
1656852927364,MATH 18,A03,083745,Cinel; Cameron Alexander,8,0,30,22
1656852927364,MATH 18,B01,083748,Rideout; David Porter,3,0,37,34
1656852927364,MATH 18,B02,083749,Rideout; David Porter,3,0,36,33
1656852927364,MATH 18,B03,083750,Rideout; David Porter,2,0,37,35
1656852927364,MATH 18,B04,083751,Rideout; David Porter,5,0,36,31
1656852927364,MATH 18,B05,093473,Rideout; David Porter,4,0,36,32
1656852927364,MATH 18,B06,093474,Rideout; David Porter,5,0,36,31
1656852933388,MATH 20A,A01,083754,Zheng; Zequn,12,0,40,28
1656852939422,MATH 20B,A01,083756,Briones; Jor-el Thomas Caparas,1,0,36,35
1656852939422,MATH 20B,A02,083757,Briones; Jor-el Thomas Caparas,1,0,36,35
1656852939422,MATH 20B,A03,093475,Briones; Jor-el Thomas Caparas,0,0,36,36
1656852945493,MATH 20C,A01,083760,Briones; Jor-el Thomas Caparas,1,0,35,34
1656852945493,MATH 20C,A02,083761,Briones; Jor-el Thomas Caparas,8,0,35,27
1656852945493,MATH 20C,A03,093476,Briones; Jor-el Thomas Caparas,0,1,36,36
1656852945493,MATH 20C,B01,083762,Bach; Quang Tran,0,0,30,30
1656852951527,MATH 20D,A01,083765,Tran; Brian Kha,4,0,30,26
1656852951527,MATH 20D,A02,083766,Tran; Brian Kha,4,0,30,26
1656852951527,MATH 20D,A03,083767,Tran; Brian Kha,2,0,30,28
1656852957564,MATH 20E,A01,083771,Ganguly; Soumya,5,0,32,27
1656852957564,MATH 20E,A02,083772,Ganguly; Soumya,6,0,32,26
1656852957564,MATH 20E,B01,083773,Ciotti; Benjamin,18,0,35,17
1656852957564,MATH 20E,B02,083774,Ciotti; Benjamin,17,0,35,18
1656852963598,MATH 103A,A01,083777,Greenfeld; Be'Eri,2,0,36,34
1656852963598,MATH 103A,A02,083778,Greenfeld; Be'Eri,5,0,36,31
1656852963598,MATH 103A,A03,093561,Greenfeld; Be'Eri,4,0,36,32
1656852963598,MATH 103A,B01,083779,Greenfeld; Be'Eri,6,0,36,30
1656852963598,MATH 103A,B02,083780,Greenfeld; Be'Eri,2,0,36,34
1656852963598,MATH 103A,B03,093562,Greenfeld; Be'Eri,2,0,36,34
1656852969622,MATH 105,A01,085443,Carter; Anne Toulson,13,0,35,22
1656852969622,MATH 105,A02,093477,Carter; Anne Toulson,20,0,35,15
1656852975649,MATH 109,A01,083213,Ganzberger; Geoffrey Michael,2,0,34,32
1656852975649,MATH 109,A02,083214,Ganzberger; Geoffrey Michael,2,0,34,32
1656852975649,MATH 109,A03,093478,Ganzberger; Geoffrey Michael,1,0,34,33
1656852975649,MATH 109,B01,083215,Ganzberger; Geoffrey Michael,1,0,32,31
1656852975649,MATH 109,B02,083216,Ganzberger; Geoffrey Michael,1,0,32,31
1656852975649,MATH 109,B03,093479,Ganzberger; Geoffrey Michael,6,0,32,26
1656852981675,MATH 142A,A01,083219,Chow; Bennett,6,0,32,26
1656852981675,MATH 142A,A02,083220,Chow; Bennett,9,0,32,23
1656852981675,MATH 142A,A03,093480,Chow; Bennett,7,0,32,25
1656852981675,MATH 142A,B03,093481,Chow; Bennett,7,0,32,25
1656852981675,MATH 142A,B04,093558,Chow; Bennett,10,0,32,22
1656852981675,MATH 142A,B05,093559,Chow; Bennett,6,0,32,26
1656852987700,MATH 193A,A01,083224,Rotar; Vladimir,6,0,34,28
1656852987700,MATH 193A,A02,083225,Rotar; Vladimir,3,0,34,31
1656852987700,MATH 193A,A03,083781,Rotar; Vladimir,1,0,34,33
1656852987700,MATH 193A,A04,083782,Rotar; Vladimir,6,0,34,28
1656852987700,MATH 193A,A05,093482,Rotar; Vladimir,6,0,34,28
1656852993726,MATH 197,001,091859,McAuley; Julian John,9999,0,9999,0
1656852993726,MATH 197,002,095566,Kedlaya; Kiran S.,9997,0,9999,2
1656852993726,MATH 197,003,095567,Xiao; Ming,9999,0,9999,0
1656852993726,MATH 197,004,095571,Perols; Johan Lars,9998,0,9999,1
1656853000797,COGS 9,A01,083615,Shannon; Kyle Michael,6,0,75,69
1656853006820,COGS 11,A01,083617,Boyle; Mary E. T.,18,0,48,30
1656853012844,COGS 13,A01,083071,Bastos; Amalia Pinkusfeld,8,0,71,63
1656853018871,COGS 14A,A01,092681,Semenuks; Arturs,0,1,100,100
1656853024901,COGS 14B,A01,083073,Cheng; Tzu-Han,5,0,63,58
1656853030928,COGS 17,A01,092677,Semenuks; Arturs,4,0,81,77
1656853036955,COGS 100,A01,083619,Allen; Michael Gordon,15,0,70,55
1656853042980,COGS 101A,A01,083621,Davis; Joshua Daniel,9,0,68,59
1656853049009,COGS 101B,A01,091572,Allen; Michael Gordon,8,0,65,57
1656853055036,COGS 101C,A01,083625,Delgado; Tania,17,0,35,18
1656853061060,COGS 107A,A01,083627,Boyle; Mary E. T.,13,0,60,47
1656853067084,COGS 118A,A01,083075,Gupta; Anjum,15,0,76,61
1656853073106,CSE 3,A50,083646,Miranda; Gregory Joseph,22,0,50,28
1656853079134,CSE 8A,A50,083650,Miranda; Gregory Joseph,17,1,56,39
1656853085158,CSE 11,A01,083080,Cao; Yingjun,4,15,40,36
1656853091181,CSE 12,A01,083652,Krause-Levy; Sophia Louisa,20,1,120,100
1656853097286,CSE 15L,A01,083654,Morris; Justin Loren,8,0,50,42
1656853097286,CSE 15L,A02,083655,Morris; Justin Loren,8,0,50,42
1656853103309,CSE 20,A01,083657,Tran; Khoa Dang,37,0,80,43
1656853109337,CSE 21,A01,095574,Bach; Quang Tran,21,0,48,27
1656853115363,CSE 30,A01,083084,Eldon; John,4,0,80,76
1656853115363,CSE 30,B01,095061,Bhaskar; Nishant,6,0,50,44
1656853121388,CSE 100,A01,083659,Cao; Yingjun,2,4,70,68
1656853127416,CSE 134B,A01,083661,Powell; Thomas Allan,19,0,100,81
1656853133444,CSE 140,A01,083663,Gungor; Onat,14,0,85,71
1656853139470,CSE 140L,A01,083088,Eldon; John,16,0,100,84
1656853145496,CSE 175,A01,083665,Kumar; Rakesh,3,0,25,22
1656853151526,CSE 190,A00,092507,Dubnov; Shlomo,7,0,20,13
1656853157561,ECE 45,A01,083139,Congero; Spencer William,5,0,75,70
1656853163586,ECE 65,A50,083695,Saad; Andrew S,12,0,30,18
1656853163586,ECE 65,A51,095125,Saad; Andrew S,25,0,26,1
1656853169612,ECE 109,A01,091882,Touri; Behrouz,16,0,70,54
1656853175640,ECE 180,A00,083140,Abi Samra; Nicholas Camill,0,0,30,30
1656853175640,ECE 180,B00,083141,Abi Samra; Nicholas Camill,0,0,30,30
1656853181669,MATH 10A,A01,083735,Patchell; Gregory David,1,0,30,29
1656853181669,MATH 10A,A02,083736,Patchell; Gregory David,20,0,30,10
1656853181669,MATH 10A,A03,083737,Patchell; Gregory David,15,0,30,15
1656853187695,MATH 10B,A01,083207,Lim; Seonhee,7,0,34,27
1656853187695,MATH 10B,A02,083208,Lim; Seonhee,9,0,35,26
1656853187695,MATH 10B,A03,093472,Lim; Seonhee,4,0,34,30
1656853187695,MATH 10B,B01,083739,Sinha; Shubham,9,0,30,21
1656853193724,MATH 18,A01,083743,Cinel; Cameron Alexander,6,0,30,24
1656853193724,MATH 18,A02,083744,Cinel; Cameron Alexander,15,0,30,15
1656853193724,MATH 18,A03,083745,Cinel; Cameron Alexander,8,0,30,22
1656853193724,MATH 18,B01,083748,Rideout; David Porter,3,0,37,34
1656853193724,MATH 18,B02,083749,Rideout; David Porter,3,0,36,33
1656853193724,MATH 18,B03,083750,Rideout; David Porter,2,0,37,35
1656853193724,MATH 18,B04,083751,Rideout; David Porter,5,0,36,31
1656853193724,MATH 18,B05,093473,Rideout; David Porter,4,0,36,32
1656853193724,MATH 18,B06,093474,Rideout; David Porter,5,0,36,31
1656853199759,MATH 20A,A01,083754,Zheng; Zequn,12,0,40,28
1656853205785,MATH 20B,A01,083756,Briones; Jor-el Thomas Caparas,1,0,36,35
1656853205785,MATH 20B,A02,083757,Briones; Jor-el Thomas Caparas,1,0,36,35
1656853205785,MATH 20B,A03,093475,Briones; Jor-el Thomas Caparas,0,0,36,36
1656853211816,MATH 20C,A01,083760,Briones; Jor-el Thomas Caparas,1,0,35,34
1656853211816,MATH 20C,A02,083761,Briones; Jor-el Thomas Caparas,8,0,35,27
1656853211816,MATH 20C,A03,093476,Briones; Jor-el Thomas Caparas,0,1,36,36
1656853211816,MATH 20C,B01,083762,Bach; Quang Tran,0,0,30,30
1656853217848,MATH 20D,A01,083765,Tran; Brian Kha,4,0,30,26
1656853217848,MATH 20D,A02,083766,Tran; Brian Kha,4,0,30,26
1656853217848,MATH 20D,A03,083767,Tran; Brian Kha,2,0,30,28
1656853223913,MATH 20E,A01,083771,Ganguly; Soumya,5,0,32,27
1656853223913,MATH 20E,A02,083772,Ganguly; Soumya,6,0,32,26
1656853223913,MATH 20E,B01,083773,Ciotti; Benjamin,18,0,35,17
1656853223913,MATH 20E,B02,083774,Ciotti; Benjamin,17,0,35,18
1656853229940,MATH 103A,A01,083777,Greenfeld; Be'Eri,2,0,36,34
1656853229940,MATH 103A,A02,083778,Greenfeld; Be'Eri,5,0,36,31
1656853229940,MATH 103A,A03,093561,Greenfeld; Be'Eri,4,0,36,32
1656853229940,MATH 103A,B01,083779,Greenfeld; Be'Eri,6,0,36,30
1656853229940,MATH 103A,B02,083780,Greenfeld; Be'Eri,2,0,36,34
1656853229940,MATH 103A,B03,093562,Greenfeld; Be'Eri,2,0,36,34
1656853235965,MATH 105,A01,085443,Carter; Anne Toulson,13,0,35,22
1656853235965,MATH 105,A02,093477,Carter; Anne Toulson,20,0,35,15
1656853241991,MATH 109,A01,083213,Ganzberger; Geoffrey Michael,2,0,34,32
1656853241991,MATH 109,A02,083214,Ganzberger; Geoffrey Michael,2,0,34,32
1656853241991,MATH 109,A03,093478,Ganzberger; Geoffrey Michael,1,0,34,33
1656853241991,MATH 109,B01,083215,Ganzberger; Geoffrey Michael,1,0,32,31
1656853241991,MATH 109,B02,083216,Ganzberger; Geoffrey Michael,1,0,32,31
1656853241991,MATH 109,B03,093479,Ganzberger; Geoffrey Michael,6,0,32,26
1656853248025,MATH 142A,A01,083219,Chow; Bennett,6,0,32,26
1656853248025,MATH 142A,A02,083220,Chow; Bennett,9,0,32,23
1656853248025,MATH 142A,A03,093480,Chow; Bennett,7,0,32,25
1656853248025,MATH 142A,B03,093481,Chow; Bennett,7,0,32,25
1656853248025,MATH 142A,B04,093558,Chow; Bennett,10,0,32,22
1656853248025,MATH 142A,B05,093559,Chow; Bennett,6,0,32,26
1656853254052,MATH 193A,A01,083224,Rotar; Vladimir,6,0,34,28
1656853254052,MATH 193A,A02,083225,Rotar; Vladimir,3,0,34,31
1656853254052,MATH 193A,A03,083781,Rotar; Vladimir,1,0,34,33
1656853254052,MATH 193A,A04,083782,Rotar; Vladimir,6,0,34,28
1656853254052,MATH 193A,A05,093482,Rotar; Vladimir,6,0,34,28
1656853260079,MATH 197,001,091859,McAuley; Julian John,9999,0,9999,0
1656853260079,MATH 197,002,095566,Kedlaya; Kiran S.,9997,0,9999,2
1656853260079,MATH 197,003,095567,Xiao; Ming,9999,0,9999,0
1656853260079,MATH 197,004,095571,Perols; Johan Lars,9998,0,9999,1
1656853267187,COGS 9,A01,083615,Shannon; Kyle Michael,6,0,75,69
1656853273219,COGS 11,A01,083617,Boyle; Mary E. T.,18,0,48,30
1656853279249,COGS 13,A01,083071,Bastos; Amalia Pinkusfeld,8,0,71,63
1656853285280,COGS 14A,A01,092681,Semenuks; Arturs,0,1,100,100
1656853291311,COGS 14B,A01,083073,Cheng; Tzu-Han,5,0,63,58
1656853297342,COGS 17,A01,092677,Semenuks; Arturs,4,0,81,77
1656853303373,COGS 100,A01,083619,Allen; Michael Gordon,15,0,70,55
1656853309416,COGS 101A,A01,083621,Davis; Joshua Daniel,9,0,68,59
1656853315441,COGS 101B,A01,091572,Allen; Michael Gordon,8,0,65,57
1656853321468,COGS 101C,A01,083625,Delgado; Tania,17,0,35,18
1656853327499,COGS 107A,A01,083627,Boyle; Mary E. T.,13,0,60,47
1656853333522,COGS 118A,A01,083075,Gupta; Anjum,15,0,76,61
1656853339553,CSE 3,A50,083646,Miranda; Gregory Joseph,22,0,50,28
1656853345582,CSE 8A,A50,083650,Miranda; Gregory Joseph,17,1,56,39
1656853351607,CSE 11,A01,083080,Cao; Yingjun,4,15,40,36
1656853357632,CSE 12,A01,083652,Krause-Levy; Sophia Louisa,20,1,120,100
1656853363663,CSE 15L,A01,083654,Morris; Justin Loren,8,0,50,42
1656853363663,CSE 15L,A02,083655,Morris; Justin Loren,8,0,50,42
1656853369689,CSE 20,A01,083657,Tran; Khoa Dang,37,0,80,43
1656853375715,CSE 21,A01,095574,Bach; Quang Tran,21,0,48,27
1656853381741,CSE 30,A01,083084,Eldon; John,4,0,80,76
1656853381741,CSE 30,B01,095061,Bhaskar; Nishant,6,0,50,44
1656853387770,CSE 100,A01,083659,Cao; Yingjun,2,4,70,68
1656853393799,CSE 134B,A01,083661,Powell; Thomas Allan,19,0,100,81
1656853399823,CSE 140,A01,083663,Gungor; Onat,14,0,85,71
1656853405849,CSE 140L,A01,083088,Eldon; John,16,0,100,84
1656853411876,CSE 175,A01,083665,Kumar; Rakesh,3,0,25,22
1656853417903,CSE 190,A00,092507,Dubnov; Shlomo,7,0,20,13
1656853423934,ECE 45,A01,083139,Congero; Spencer William,5,0,75,70
1656853429963,ECE 65,A50,083695,Saad; Andrew S,12,0,30,18
1656853429963,ECE 65,A51,095125,Saad; Andrew S,25,0,26,1
1656853435989,ECE 109,A01,091882,Touri; Behrouz,16,0,70,54
1656853442015,ECE 180,A00,083140,Abi Samra; Nicholas Camill,0,0,30,30
1656853442015,ECE 180,B00,083141,Abi Samra; Nicholas Camill,0,0,30,30
1656853448049,MATH 10A,A01,083735,Patchell; Gregory David,1,0,30,29
1656853448049,MATH 10A,A02,083736,Patchell; Gregory David,20,0,30,10
1656853448049,MATH 10A,A03,083737,Patchell; Gregory David,15,0,30,15
1656853454083,MATH 10B,A01,083207,Lim; Seonhee,7,0,34,27
1656853454083,MATH 10B,A02,083208,Lim; Seonhee,9,0,35,26
1656853454083,MATH 10B,A03,093472,Lim; Seonhee,4,0,34,30
1656853454083,MATH 10B,B01,083739,Sinha; Shubham,9,0,30,21
1656853460114,MATH 18,A01,083743,Cinel; Cameron Alexander,6,0,30,24
1656853460114,MATH 18,A02,083744,Cinel; Cameron Alexander,15,0,30,15
1656853460114,MATH 18,A03,083745,Cinel; Cameron Alexander,8,0,30,22
1656853460114,MATH 18,B01,083748,Rideout; David Porter,3,0,37,34
1656853460114,MATH 18,B02,083749,Rideout; David Porter,3,0,36,33
1656853460114,MATH 18,B03,083750,Rideout; David Porter,2,0,37,35
1656853460114,MATH 18,B04,083751,Rideout; David Porter,5,0,36,31
1656853460114,MATH 18,B05,093473,Rideout; David Porter,4,0,36,32
1656853460114,MATH 18,B06,093474,Rideout; David Porter,5,0,36,31
1656853466138,MATH 20A,A01,083754,Zheng; Zequn,12,0,40,28
1656853472168,MATH 20B,A01,083756,Briones; Jor-el Thomas Caparas,1,0,36,35
1656853472168,MATH 20B,A02,083757,Briones; Jor-el Thomas Caparas,1,0,36,35
1656853472168,MATH 20B,A03,093475,Briones; Jor-el Thomas Caparas,0,0,36,36
1656853478192,MATH 20C,A01,083760,Briones; Jor-el Thomas Caparas,1,0,35,34
1656853478192,MATH 20C,A02,083761,Briones; Jor-el Thomas Caparas,8,0,35,27
1656853478192,MATH 20C,A03,093476,Briones; Jor-el Thomas Caparas,0,1,36,36
1656853478192,MATH 20C,B01,083762,Bach; Quang Tran,0,0,30,30
1656853484218,MATH 20D,A01,083765,Tran; Brian Kha,4,0,30,26
1656853484218,MATH 20D,A02,083766,Tran; Brian Kha,4,0,30,26
1656853484218,MATH 20D,A03,083767,Tran; Brian Kha,2,0,30,28
1656853490247,MATH 20E,A01,083771,Ganguly; Soumya,5,0,32,27
1656853490247,MATH 20E,A02,083772,Ganguly; Soumya,6,0,32,26
1656853490247,MATH 20E,B01,083773,Ciotti; Benjamin,18,0,35,17
1656853490247,MATH 20E,B02,083774,Ciotti; Benjamin,17,0,35,18
1656853496273,MATH 103A,A01,083777,Greenfeld; Be'Eri,2,0,36,34
1656853496273,MATH 103A,A02,083778,Greenfeld; Be'Eri,5,0,36,31
1656853496273,MATH 103A,A03,093561,Greenfeld; Be'Eri,4,0,36,32
1656853496273,MATH 103A,B01,083779,Greenfeld; Be'Eri,6,0,36,30
1656853496273,MATH 103A,B02,083780,Greenfeld; Be'Eri,2,0,36,34
1656853496273,MATH 103A,B03,093562,Greenfeld; Be'Eri,2,0,36,34
1656853502298,MATH 105,A01,085443,Carter; Anne Toulson,13,0,35,22
1656853502298,MATH 105,A02,093477,Carter; Anne Toulson,20,0,35,15
1656853508323,MATH 109,A01,083213,Ganzberger; Geoffrey Michael,2,0,34,32
1656853508323,MATH 109,A02,083214,Ganzberger; Geoffrey Michael,2,0,34,32
1656853508323,MATH 109,A03,093478,Ganzberger; Geoffrey Michael,1,0,34,33
1656853508323,MATH 109,B01,083215,Ganzberger; Geoffrey Michael,1,0,32,31
1656853508323,MATH 109,B02,083216,Ganzberger; Geoffrey Michael,1,0,32,31
1656853508323,MATH 109,B03,093479,Ganzberger; Geoffrey Michael,6,0,32,26
1656853514348,MATH 142A,A01,083219,Chow; Bennett,6,0,32,26
1656853514348,MATH 142A,A02,083220,Chow; Bennett,9,0,32,23
1656853514348,MATH 142A,A03,093480,Chow; Bennett,7,0,32,25
1656853514348,MATH 142A,B03,093481,Chow; Bennett,7,0,32,25
1656853514348,MATH 142A,B04,093558,Chow; Bennett,10,0,32,22
1656853514348,MATH 142A,B05,093559,Chow; Bennett,6,0,32,26
1656853520374,MATH 193A,A01,083224,Rotar; Vladimir,6,0,34,28
1656853520374,MATH 193A,A02,083225,Rotar; Vladimir,3,0,34,31
1656853520374,MATH 193A,A03,083781,Rotar; Vladimir,1,0,34,33
1656853520374,MATH 193A,A04,083782,Rotar; Vladimir,6,0,34,28
1656853520374,MATH 193A,A05,093482,Rotar; Vladimir,6,0,34,28
1656853526403,MATH 197,001,091859,McAuley; Julian John,9999,0,9999,0
1656853526403,MATH 197,002,095566,Kedlaya; Kiran S.,9997,0,9999,2
1656853526403,MATH 197,003,095567,Xiao; Ming,9999,0,9999,0
1656853526403,MATH 197,004,095571,Perols; Johan Lars,9998,0,9999,1
1656853533486,COGS 9,A01,083615,Shannon; Kyle Michael,6,0,75,69
1656853539515,COGS 11,A01,083617,Boyle; Mary E. T.,18,0,48,30
1656853545542,COGS 13,A01,083071,Bastos; Amalia Pinkusfeld,8,0,71,63
1656853551568,COGS 14A,A01,092681,Semenuks; Arturs,0,1,100,100
1656853557593,COGS 14B,A01,083073,Cheng; Tzu-Han,5,0,63,58
1656853563619,COGS 17,A01,092677,Semenuks; Arturs,4,0,81,77
1656853569644,COGS 100,A01,083619,Allen; Michael Gordon,15,0,70,55
1656853575672,COGS 101A,A01,083621,Davis; Joshua Daniel,9,0,68,59
1656853581697,COGS 101B,A01,091572,Allen; Michael Gordon,8,0,65,57
1656853587722,COGS 101C,A01,083625,Delgado; Tania,17,0,35,18
1656853593749,COGS 107A,A01,083627,Boyle; Mary E. T.,13,0,60,47
1656853599776,COGS 118A,A01,083075,Gupta; Anjum,15,0,76,61
1656853605803,CSE 3,A50,083646,Miranda; Gregory Joseph,22,0,50,28
1656853611827,CSE 8A,A50,083650,Miranda; Gregory Joseph,17,1,56,39
1656853617851,CSE 11,A01,083080,Cao; Yingjun,4,15,40,36
1656853623878,CSE 12,A01,083652,Krause-Levy; Sophia Louisa,20,1,120,100
1656853629907,CSE 15L,A01,083654,Morris; Justin Loren,8,0,50,42
1656853629907,CSE 15L,A02,083655,Morris; Justin Loren,8,0,50,42
1656853635941,CSE 20,A01,083657,Tran; Khoa Dang,37,0,80,43
1656853641967,CSE 21,A01,095574,Bach; Quang Tran,21,0,48,27
1656853647995,CSE 30,A01,083084,Eldon; John,4,0,80,76
1656853647995,CSE 30,B01,095061,Bhaskar; Nishant,6,0,50,44
1656853654021,CSE 100,A01,083659,Cao; Yingjun,2,4,70,68
1656853660047,CSE 134B,A01,083661,Powell; Thomas Allan,19,0,100,81
1656853666072,CSE 140,A01,083663,Gungor; Onat,14,0,85,71
1656853672104,CSE 140L,A01,083088,Eldon; John,16,0,100,84
1656853678136,CSE 175,A01,083665,Kumar; Rakesh,3,0,25,22
1656853684160,CSE 190,A00,092507,Dubnov; Shlomo,7,0,20,13
1656853690190,ECE 45,A01,083139,Congero; Spencer William,5,0,75,70
1656853696311,ECE 65,A50,083695,Saad; Andrew S,12,0,30,18
1656853696311,ECE 65,A51,095125,Saad; Andrew S,25,0,26,1
1656853702339,ECE 109,A01,091882,Touri; Behrouz,16,0,70,54
1656853708368,ECE 180,A00,083140,Abi Samra; Nicholas Camill,0,0,30,30
1656853708368,ECE 180,B00,083141,Abi Samra; Nicholas Camill,0,0,30,30
1656853714400,MATH 10A,A01,083735,Patchell; Gregory David,1,0,30,29
1656853714400,MATH 10A,A02,083736,Patchell; Gregory David,20,0,30,10
1656853714400,MATH 10A,A03,083737,Patchell; Gregory David,15,0,30,15
1656853720434,MATH 10B,A01,083207,Lim; Seonhee,7,0,34,27
1656853720434,MATH 10B,A02,083208,Lim; Seonhee,9,0,35,26
1656853720434,MATH 10B,A03,093472,Lim; Seonhee,4,0,34,30
1656853720434,MATH 10B,B01,083739,Sinha; Shubham,9,0,30,21
1656853726460,MATH 18,A01,083743,Cinel; Cameron Alexander,6,0,30,24
1656853726460,MATH 18,A02,083744,Cinel; Cameron Alexander,15,0,30,15
1656853726460,MATH 18,A03,083745,Cinel; Cameron Alexander,8,0,30,22
1656853726460,MATH 18,B01,083748,Rideout; David Porter,3,0,37,34
1656853726460,MATH 18,B02,083749,Rideout; David Porter,3,0,36,33
1656853726460,MATH 18,B03,083750,Rideout; David Porter,2,0,37,35
1656853726460,MATH 18,B04,083751,Rideout; David Porter,5,0,36,31
1656853726460,MATH 18,B05,093473,Rideout; David Porter,4,0,36,32
1656853726460,MATH 18,B06,093474,Rideout; David Porter,5,0,36,31
1656853732494,MATH 20A,A01,083754,Zheng; Zequn,12,0,40,28
1656853738519,MATH 20B,A01,083756,Briones; Jor-el Thomas Caparas,1,0,36,35
1656853738519,MATH 20B,A02,083757,Briones; Jor-el Thomas Caparas,1,0,36,35
1656853738519,MATH 20B,A03,093475,Briones; Jor-el Thomas Caparas,0,0,36,36
1656853744552,MATH 20C,A01,083760,Briones; Jor-el Thomas Caparas,1,0,35,34
1656853744552,MATH 20C,A02,083761,Briones; Jor-el Thomas Caparas,8,0,35,27
1656853744552,MATH 20C,A03,093476,Briones; Jor-el Thomas Caparas,0,1,36,36
1656853744552,MATH 20C,B01,083762,Bach; Quang Tran,0,0,30,30
1656853750578,MATH 20D,A01,083765,Tran; Brian Kha,4,0,30,26
1656853750578,MATH 20D,A02,083766,Tran; Brian Kha,4,0,30,26
1656853750578,MATH 20D,A03,083767,Tran; Brian Kha,2,0,30,28
1656853756605,MATH 20E,A01,083771,Ganguly; Soumya,5,0,32,27
1656853756605,MATH 20E,A02,083772,Ganguly; Soumya,6,0,32,26
1656853756605,MATH 20E,B01,083773,Ciotti; Benjamin,18,0,35,17
1656853756605,MATH 20E,B02,083774,Ciotti; Benjamin,17,0,35,18
1656853762638,MATH 103A,A01,083777,Greenfeld; Be'Eri,2,0,36,34
1656853762638,MATH 103A,A02,083778,Greenfeld; Be'Eri,5,0,36,31
1656853762638,MATH 103A,A03,093561,Greenfeld; Be'Eri,4,0,36,32
1656853762638,MATH 103A,B01,083779,Greenfeld; Be'Eri,6,0,36,30
1656853762638,MATH 103A,B02,083780,Greenfeld; Be'Eri,2,0,36,34
1656853762638,MATH 103A,B03,093562,Greenfeld; Be'Eri,2,0,36,34
1656853768671,MATH 105,A01,085443,Carter; Anne Toulson,13,0,35,22
1656853768671,MATH 105,A02,093477,Carter; Anne Toulson,20,0,35,15
1656853774703,MATH 109,A01,083213,Ganzberger; Geoffrey Michael,2,0,34,32
1656853774703,MATH 109,A02,083214,Ganzberger; Geoffrey Michael,2,0,34,32
1656853774703,MATH 109,A03,093478,Ganzberger; Geoffrey Michael,1,0,34,33
1656853774703,MATH 109,B01,083215,Ganzberger; Geoffrey Michael,1,0,32,31
1656853774703,MATH 109,B02,083216,Ganzberger; Geoffrey Michael,1,0,32,31
1656853774703,MATH 109,B03,093479,Ganzberger; Geoffrey Michael,6,0,32,26
1656853780730,MATH 142A,A01,083219,Chow; Bennett,6,0,32,26
1656853780730,MATH 142A,A02,083220,Chow; Bennett,9,0,32,23
1656853780730,MATH 142A,A03,093480,Chow; Bennett,7,0,32,25
1656853780730,MATH 142A,B03,093481,Chow; Bennett,7,0,32,25
1656853780730,MATH 142A,B04,093558,Chow; Bennett,10,0,32,22
1656853780730,MATH 142A,B05,093559,Chow; Bennett,6,0,32,26
1656853786760,MATH 193A,A01,083224,Rotar; Vladimir,6,0,34,28
1656853786760,MATH 193A,A02,083225,Rotar; Vladimir,3,0,34,31
1656853786760,MATH 193A,A03,083781,Rotar; Vladimir,1,0,34,33
1656853786760,MATH 193A,A04,083782,Rotar; Vladimir,6,0,34,28
1656853786760,MATH 193A,A05,093482,Rotar; Vladimir,6,0,34,28
1656853792785,MATH 197,001,091859,McAuley; Julian John,9999,0,9999,0
1656853792785,MATH 197,002,095566,Kedlaya; Kiran S.,9997,0,9999,2
1656853792785,MATH 197,003,095567,Xiao; Ming,9999,0,9999,0
1656853792785,MATH 197,004,095571,Perols; Johan Lars,9998,0,9999,1
1656853799859,COGS 9,A01,083615,Shannon; Kyle Michael,6,0,75,69
1656853805884,COGS 11,A01,083617,Boyle; Mary E. T.,18,0,48,30
1656853811910,COGS 13,A01,083071,Bastos; Amalia Pinkusfeld,8,0,71,63
1656853817935,COGS 14A,A01,092681,Semenuks; Arturs,0,1,100,100
1656853823962,COGS 14B,A01,083073,Cheng; Tzu-Han,5,0,63,58
1656853829989,COGS 17,A01,092677,Semenuks; Arturs,4,0,81,77
1656853836021,COGS 100,A01,083619,Allen; Michael Gordon,15,0,70,55
1656853842051,COGS 101A,A01,083621,Davis; Joshua Daniel,9,0,68,59
1656853848081,COGS 101B,A01,091572,Allen; Michael Gordon,8,0,65,57
1656853854111,COGS 101C,A01,083625,Delgado; Tania,17,0,35,18
1656853860138,COGS 107A,A01,083627,Boyle; Mary E. T.,13,0,60,47
1656853866164,COGS 118A,A01,083075,Gupta; Anjum,15,0,76,61
1656853872189,CSE 3,A50,083646,Miranda; Gregory Joseph,22,0,50,28
1656853878215,CSE 8A,A50,083650,Miranda; Gregory Joseph,17,1,56,39
1656853884238,CSE 11,A01,083080,Cao; Yingjun,4,15,40,36
1656853890267,CSE 12,A01,083652,Krause-Levy; Sophia Louisa,20,1,120,100
1656853896293,CSE 15L,A01,083654,Morris; Justin Loren,8,0,50,42
1656853896293,CSE 15L,A02,083655,Morris; Justin Loren,8,0,50,42
1656853902317,CSE 20,A01,083657,Tran; Khoa Dang,37,0,80,43
1656853908351,CSE 21,A01,095574,Bach; Quang Tran,21,0,48,27
1656853914377,CSE 30,A01,083084,Eldon; John,4,0,80,76
1656853914377,CSE 30,B01,095061,Bhaskar; Nishant,6,0,50,44
1656853920408,CSE 100,A01,083659,Cao; Yingjun,2,4,70,68
1656853926437,CSE 134B,A01,083661,Powell; Thomas Allan,19,0,100,81
1656853932475,CSE 140,A01,083663,Gungor; Onat,14,0,85,71
1656853938498,CSE 140L,A01,083088,Eldon; John,16,0,100,84
1656853944523,CSE 175,A01,083665,Kumar; Rakesh,3,0,25,22
1656853950547,CSE 190,A00,092507,Dubnov; Shlomo,7,0,20,13
1656853956574,ECE 45,A01,083139,Congero; Spencer William,5,0,75,70
1656853962601,ECE 65,A50,083695,Saad; Andrew S,12,0,30,18
1656853962601,ECE 65,A51,095125,Saad; Andrew S,25,0,26,1
1656853968625,ECE 109,A01,091882,Touri; Behrouz,16,0,70,54
1656853974650,ECE 180,A00,083140,Abi Samra; Nicholas Camill,0,0,30,30
1656853974650,ECE 180,B00,083141,Abi Samra; Nicholas Camill,0,0,30,30
1656853980682,MATH 10A,A01,083735,Patchell; Gregory David,1,0,30,29
1656853980682,MATH 10A,A02,083736,Patchell; Gregory David,20,0,30,10
1656853980682,MATH 10A,A03,083737,Patchell; Gregory David,15,0,30,15
1656853986710,MATH 10B,A01,083207,Lim; Seonhee,7,0,34,27
1656853986710,MATH 10B,A02,083208,Lim; Seonhee,9,0,35,26
1656853986710,MATH 10B,A03,093472,Lim; Seonhee,4,0,34,30
1656853986710,MATH 10B,B01,083739,Sinha; Shubham,9,0,30,21
1656853992737,MATH 18,A01,083743,Cinel; Cameron Alexander,6,0,30,24
1656853992737,MATH 18,A02,083744,Cinel; Cameron Alexander,15,0,30,15
1656853992737,MATH 18,A03,083745,Cinel; Cameron Alexander,8,0,30,22
1656853992737,MATH 18,B01,083748,Rideout; David Porter,3,0,37,34
1656853992737,MATH 18,B02,083749,Rideout; David Porter,3,0,36,33
1656853992737,MATH 18,B03,083750,Rideout; David Porter,2,0,37,35
1656853992737,MATH 18,B04,083751,Rideout; David Porter,5,0,36,31
1656853992737,MATH 18,B05,093473,Rideout; David Porter,4,0,36,32
1656853992737,MATH 18,B06,093474,Rideout; David Porter,5,0,36,31
1656853998767,MATH 20A,A01,083754,Zheng; Zequn,12,0,40,28
1656854004793,MATH 20B,A01,083756,Briones; Jor-el Thomas Caparas,1,0,36,35
1656854004793,MATH 20B,A02,083757,Briones; Jor-el Thomas Caparas,1,0,36,35
1656854004793,MATH 20B,A03,093475,Briones; Jor-el Thomas Caparas,0,0,36,36
1656854010819,MATH 20C,A01,083760,Briones; Jor-el Thomas Caparas,1,0,35,34
1656854010819,MATH 20C,A02,083761,Briones; Jor-el Thomas Caparas,8,0,35,27
1656854010819,MATH 20C,A03,093476,Briones; Jor-el Thomas Caparas,0,1,36,36
1656854010819,MATH 20C,B01,083762,Bach; Quang Tran,0,0,30,30
1656854016844,MATH 20D,A01,083765,Tran; Brian Kha,4,0,30,26
1656854016844,MATH 20D,A02,083766,Tran; Brian Kha,4,0,30,26
1656854016844,MATH 20D,A03,083767,Tran; Brian Kha,2,0,30,28
1656854022879,MATH 20E,A01,083771,Ganguly; Soumya,5,0,32,27
1656854022879,MATH 20E,A02,083772,Ganguly; Soumya,6,0,32,26
1656854022879,MATH 20E,B01,083773,Ciotti; Benjamin,18,0,35,17
1656854022879,MATH 20E,B02,083774,Ciotti; Benjamin,17,0,35,18
1656854028907,MATH 103A,A01,083777,Greenfeld; Be'Eri,2,0,36,34
1656854028907,MATH 103A,A02,083778,Greenfeld; Be'Eri,5,0,36,31
1656854028907,MATH 103A,A03,093561,Greenfeld; Be'Eri,4,0,36,32
1656854028907,MATH 103A,B01,083779,Greenfeld; Be'Eri,6,0,36,30
1656854028907,MATH 103A,B02,083780,Greenfeld; Be'Eri,2,0,36,34
1656854028907,MATH 103A,B03,093562,Greenfeld; Be'Eri,2,0,36,34
1656854034930,MATH 105,A01,085443,Carter; Anne Toulson,13,0,35,22
1656854034930,MATH 105,A02,093477,Carter; Anne Toulson,20,0,35,15
1656854040960,MATH 109,A01,083213,Ganzberger; Geoffrey Michael,2,0,34,32
1656854040960,MATH 109,A02,083214,Ganzberger; Geoffrey Michael,2,0,34,32
1656854040960,MATH 109,A03,093478,Ganzberger; Geoffrey Michael,1,0,34,33
1656854040960,MATH 109,B01,083215,Ganzberger; Geoffrey Michael,1,0,32,31
1656854040960,MATH 109,B02,083216,Ganzberger; Geoffrey Michael,1,0,32,31
1656854040960,MATH 109,B03,093479,Ganzberger; Geoffrey Michael,6,0,32,26
1656854046989,MATH 142A,A01,083219,Chow; Bennett,6,0,32,26
1656854046989,MATH 142A,A02,083220,Chow; Bennett,9,0,32,23
1656854046989,MATH 142A,A03,093480,Chow; Bennett,7,0,32,25
1656854046989,MATH 142A,B03,093481,Chow; Bennett,7,0,32,25
1656854046989,MATH 142A,B04,093558,Chow; Bennett,10,0,32,22
1656854046989,MATH 142A,B05,093559,Chow; Bennett,6,0,32,26
1656854053019,MATH 193A,A01,083224,Rotar; Vladimir,6,0,34,28
1656854053019,MATH 193A,A02,083225,Rotar; Vladimir,3,0,34,31
1656854053019,MATH 193A,A03,083781,Rotar; Vladimir,1,0,34,33
1656854053019,MATH 193A,A04,083782,Rotar; Vladimir,6,0,34,28
1656854053019,MATH 193A,A05,093482,Rotar; Vladimir,6,0,34,28
1656854059050,MATH 197,001,091859,McAuley; Julian John,9999,0,9999,0
1656854059050,MATH 197,002,095566,Kedlaya; Kiran S.,9997,0,9999,2
1656854059050,MATH 197,003,095567,Xiao; Ming,9999,0,9999,0
1656854059050,MATH 197,004,095571,Perols; Johan Lars,9998,0,9999,1
1656854066130,COGS 9,A01,083615,Shannon; Kyle Michael,6,0,75,69
1656854072156,COGS 11,A01,083617,Boyle; Mary E. T.,18,0,48,30
1656854078180,COGS 13,A01,083071,Bastos; Amalia Pinkusfeld,8,0,71,63
1656854084204,COGS 14A,A01,092681,Semenuks; Arturs,0,1,100,100
1656854090230,COGS 14B,A01,083073,Cheng; Tzu-Han,5,0,63,58
1656854096255,COGS 17,A01,092677,Semenuks; Arturs,4,0,81,77
1656854102280,COGS 100,A01,083619,Allen; Michael Gordon,15,0,70,55
1656854108304,COGS 101A,A01,083621,Davis; Joshua Daniel,9,0,68,59
1656854114331,COGS 101B,A01,091572,Allen; Michael Gordon,8,0,65,57
1656854120363,COGS 101C,A01,083625,Delgado; Tania,17,0,35,18
1656854126393,COGS 107A,A01,083627,Boyle; Mary E. T.,13,0,60,47
1656854132418,COGS 118A,A01,083075,Gupta; Anjum,15,0,76,61
1656854138443,CSE 3,A50,083646,Miranda; Gregory Joseph,22,0,50,28
1656854144472,CSE 8A,A50,083650,Miranda; Gregory Joseph,17,1,56,39
1656854150497,CSE 11,A01,083080,Cao; Yingjun,4,15,40,36
1656854156523,CSE 12,A01,083652,Krause-Levy; Sophia Louisa,20,1,120,100
1656854162554,CSE 15L,A01,083654,Morris; Justin Loren,8,0,50,42
1656854162554,CSE 15L,A02,083655,Morris; Justin Loren,8,0,50,42
1656854168577,CSE 20,A01,083657,Tran; Khoa Dang,37,0,80,43
1656854174601,CSE 21,A01,095574,Bach; Quang Tran,21,0,48,27
1656854180635,CSE 30,A01,083084,Eldon; John,4,0,80,76
1656854180635,CSE 30,B01,095061,Bhaskar; Nishant,6,0,50,44
1656854186667,CSE 100,A01,083659,Cao; Yingjun,2,4,70,68
1656854192692,CSE 134B,A01,083661,Powell; Thomas Allan,19,0,100,81
1656854198716,CSE 140,A01,083663,Gungor; Onat,14,0,85,71
1656854204744,CSE 140L,A01,083088,Eldon; John,16,0,100,84
1656854210772,CSE 175,A01,083665,Kumar; Rakesh,3,0,25,22
1656854216797,CSE 190,A00,092507,Dubnov; Shlomo,7,0,20,13
1656854222828,ECE 45,A01,083139,Congero; Spencer William,5,0,75,70
1656854228856,ECE 65,A50,083695,Saad; Andrew S,12,0,30,18
1656854228856,ECE 65,A51,095125,Saad; Andrew S,25,0,26,1
1656854234884,ECE 109,A01,091882,Touri; Behrouz,16,0,70,54
1656854240915,ECE 180,A00,083140,Abi Samra; Nicholas Camill,0,0,30,30
1656854240915,ECE 180,B00,083141,Abi Samra; Nicholas Camill,0,0,30,30
1656854246948,MATH 10A,A01,083735,Patchell; Gregory David,1,0,30,29
1656854246948,MATH 10A,A02,083736,Patchell; Gregory David,20,0,30,10
1656854246948,MATH 10A,A03,083737,Patchell; Gregory David,15,0,30,15
1656854252983,MATH 10B,A01,083207,Lim; Seonhee,7,0,34,27
1656854252983,MATH 10B,A02,083208,Lim; Seonhee,9,0,35,26
1656854252983,MATH 10B,A03,093472,Lim; Seonhee,4,0,34,30
1656854252983,MATH 10B,B01,083739,Sinha; Shubham,9,0,30,21
1656854259017,MATH 18,A01,083743,Cinel; Cameron Alexander,6,0,30,24
1656854259017,MATH 18,A02,083744,Cinel; Cameron Alexander,15,0,30,15
1656854259017,MATH 18,A03,083745,Cinel; Cameron Alexander,8,0,30,22
1656854259017,MATH 18,B01,083748,Rideout; David Porter,3,0,37,34
1656854259017,MATH 18,B02,083749,Rideout; David Porter,3,0,36,33
1656854259017,MATH 18,B03,083750,Rideout; David Porter,2,0,37,35
1656854259017,MATH 18,B04,083751,Rideout; David Porter,5,0,36,31
1656854259017,MATH 18,B05,093473,Rideout; David Porter,4,0,36,32
1656854259017,MATH 18,B06,093474,Rideout; David Porter,5,0,36,31
1656854265048,MATH 20A,A01,083754,Zheng; Zequn,12,0,40,28
1656854271074,MATH 20B,A01,083756,Briones; Jor-el Thomas Caparas,1,0,36,35
1656854271074,MATH 20B,A02,083757,Briones; Jor-el Thomas Caparas,1,0,36,35
1656854271074,MATH 20B,A03,093475,Briones; Jor-el Thomas Caparas,0,0,36,36
1656854277099,MATH 20C,A01,083760,Briones; Jor-el Thomas Caparas,1,0,35,34
1656854277099,MATH 20C,A02,083761,Briones; Jor-el Thomas Caparas,8,0,35,27
1656854277099,MATH 20C,A03,093476,Briones; Jor-el Thomas Caparas,0,1,36,36
1656854277099,MATH 20C,B01,083762,Bach; Quang Tran,0,0,30,30
1656854283125,MATH 20D,A01,083765,Tran; Brian Kha,4,0,30,26
1656854283125,MATH 20D,A02,083766,Tran; Brian Kha,4,0,30,26
1656854283125,MATH 20D,A03,083767,Tran; Brian Kha,2,0,30,28
1656854289153,MATH 20E,A01,083771,Ganguly; Soumya,5,0,32,27
1656854289153,MATH 20E,A02,083772,Ganguly; Soumya,6,0,32,26
1656854289153,MATH 20E,B01,083773,Ciotti; Benjamin,18,0,35,17
1656854289153,MATH 20E,B02,083774,Ciotti; Benjamin,17,0,35,18
1656854295273,MATH 103A,A01,083777,Greenfeld; Be'Eri,2,0,36,34
1656854295273,MATH 103A,A02,083778,Greenfeld; Be'Eri,5,0,36,31
1656854295273,MATH 103A,A03,093561,Greenfeld; Be'Eri,4,0,36,32
1656854295273,MATH 103A,B01,083779,Greenfeld; Be'Eri,6,0,36,30
1656854295273,MATH 103A,B02,083780,Greenfeld; Be'Eri,2,0,36,34
1656854295273,MATH 103A,B03,093562,Greenfeld; Be'Eri,2,0,36,34
1656854301302,MATH 105,A01,085443,Carter; Anne Toulson,13,0,35,22
1656854301302,MATH 105,A02,093477,Carter; Anne Toulson,20,0,35,15
1656854307329,MATH 109,A01,083213,Ganzberger; Geoffrey Michael,2,0,34,32
1656854307329,MATH 109,A02,083214,Ganzberger; Geoffrey Michael,2,0,34,32
1656854307329,MATH 109,A03,093478,Ganzberger; Geoffrey Michael,1,0,34,33
1656854307329,MATH 109,B01,083215,Ganzberger; Geoffrey Michael,1,0,32,31
1656854307329,MATH 109,B02,083216,Ganzberger; Geoffrey Michael,1,0,32,31
1656854307329,MATH 109,B03,093479,Ganzberger; Geoffrey Michael,6,0,32,26
1656854313362,MATH 142A,A01,083219,Chow; Bennett,6,0,32,26
1656854313362,MATH 142A,A02,083220,Chow; Bennett,9,0,32,23
1656854313362,MATH 142A,A03,093480,Chow; Bennett,7,0,32,25
1656854313362,MATH 142A,B03,093481,Chow; Bennett,7,0,32,25
1656854313362,MATH 142A,B04,093558,Chow; Bennett,10,0,32,22
1656854313362,MATH 142A,B05,093559,Chow; Bennett,6,0,32,26
1656854319388,MATH 193A,A01,083224,Rotar; Vladimir,6,0,34,28
1656854319388,MATH 193A,A02,083225,Rotar; Vladimir,3,0,34,31
1656854319388,MATH 193A,A03,083781,Rotar; Vladimir,1,0,34,33
1656854319388,MATH 193A,A04,083782,Rotar; Vladimir,6,0,34,28
1656854319388,MATH 193A,A05,093482,Rotar; Vladimir,6,0,34,28
1656854325423,MATH 197,001,091859,McAuley; Julian John,9999,0,9999,0
1656854325423,MATH 197,002,095566,Kedlaya; Kiran S.,9997,0,9999,2
1656854325423,MATH 197,003,095567,Xiao; Ming,9999,0,9999,0
1656854325423,MATH 197,004,095571,Perols; Johan Lars,9998,0,9999,1
1656854332486,COGS 9,A01,083615,Shannon; Kyle Michael,6,0,75,69
1656854338515,COGS 11,A01,083617,Boyle; Mary E. T.,18,0,48,30
1656854344553,COGS 13,A01,083071,Bastos; Amalia Pinkusfeld,8,0,71,63
1656854350584,COGS 14A,A01,092681,Semenuks; Arturs,0,1,100,100
1656854356614,COGS 14B,A01,083073,Cheng; Tzu-Han,5,0,63,58
1656854362636,COGS 17,A01,092677,Semenuks; Arturs,4,0,81,77
1656854368666,COGS 100,A01,083619,Allen; Michael Gordon,15,0,70,55
1656854374689,COGS 101A,A01,083621,Davis; Joshua Daniel,9,0,68,59
1656854380717,COGS 101B,A01,091572,Allen; Michael Gordon,8,0,65,57
1656854386746,COGS 101C,A01,083625,Delgado; Tania,17,0,35,18
1656854392771,COGS 107A,A01,083627,Boyle; Mary E. T.,13,0,60,47
1656854398794,COGS 118A,A01,083075,Gupta; Anjum,15,0,76,61
1656854404828,CSE 3,A50,083646,Miranda; Gregory Joseph,22,0,50,28
1656854410862,CSE 8A,A50,083650,Miranda; Gregory Joseph,17,1,56,39
1656854416893,CSE 11,A01,083080,Cao; Yingjun,4,15,40,36
1656854422919,CSE 12,A01,083652,Krause-Levy; Sophia Louisa,20,1,120,100
1656854428947,CSE 15L,A01,083654,Morris; Justin Loren,8,0,50,42
1656854428947,CSE 15L,A02,083655,Morris; Justin Loren,8,0,50,42
1656854434973,CSE 20,A01,083657,Tran; Khoa Dang,37,0,80,43
1656854440998,CSE 21,A01,095574,Bach; Quang Tran,21,0,48,27
1656854447030,CSE 30,A01,083084,Eldon; John,4,0,80,76
1656854447030,CSE 30,B01,095061,Bhaskar; Nishant,6,0,50,44
1656854453061,CSE 100,A01,083659,Cao; Yingjun,2,4,70,68
1656854459088,CSE 134B,A01,083661,Powell; Thomas Allan,19,0,100,81
1656854465119,CSE 140,A01,083663,Gungor; Onat,14,0,85,71
1656854471144,CSE 140L,A01,083088,Eldon; John,16,0,100,84
1656854477169,CSE 175,A01,083665,Kumar; Rakesh,3,0,25,22
1656854483192,CSE 190,A00,092507,Dubnov; Shlomo,7,0,20,13
1656854489219,ECE 45,A01,083139,Congero; Spencer William,5,0,75,70
1656854495247,ECE 65,A50,083695,Saad; Andrew S,12,0,30,18
1656854495247,ECE 65,A51,095125,Saad; Andrew S,25,0,26,1
1656854501276,ECE 109,A01,091882,Touri; Behrouz,16,0,70,54
1656854507303,ECE 180,A00,083140,Abi Samra; Nicholas Camill,0,0,30,30
1656854507303,ECE 180,B00,083141,Abi Samra; Nicholas Camill,0,0,30,30
1656854513327,MATH 10A,A01,083735,Patchell; Gregory David,1,0,30,29
1656854513327,MATH 10A,A02,083736,Patchell; Gregory David,20,0,30,10
1656854513327,MATH 10A,A03,083737,Patchell; Gregory David,15,0,30,15
1656854519354,MATH 10B,A01,083207,Lim; Seonhee,7,0,34,27
1656854519354,MATH 10B,A02,083208,Lim; Seonhee,9,0,35,26
1656854519354,MATH 10B,A03,093472,Lim; Seonhee,4,0,34,30
1656854519354,MATH 10B,B01,083739,Sinha; Shubham,9,0,30,21
1656854525379,MATH 18,A01,083743,Cinel; Cameron Alexander,6,0,30,24
1656854525379,MATH 18,A02,083744,Cinel; Cameron Alexander,15,0,30,15
1656854525379,MATH 18,A03,083745,Cinel; Cameron Alexander,8,0,30,22
1656854525379,MATH 18,B01,083748,Rideout; David Porter,3,0,37,34
1656854525379,MATH 18,B02,083749,Rideout; David Porter,3,0,36,33
1656854525379,MATH 18,B03,083750,Rideout; David Porter,2,0,37,35
1656854525379,MATH 18,B04,083751,Rideout; David Porter,5,0,36,31
1656854525379,MATH 18,B05,093473,Rideout; David Porter,4,0,36,32
1656854525379,MATH 18,B06,093474,Rideout; David Porter,5,0,36,31
1656854531405,MATH 20A,A01,083754,Zheng; Zequn,12,0,40,28
1656854537439,MATH 20B,A01,083756,Briones; Jor-el Thomas Caparas,1,0,36,35
1656854537439,MATH 20B,A02,083757,Briones; Jor-el Thomas Caparas,1,0,36,35
1656854537439,MATH 20B,A03,093475,Briones; Jor-el Thomas Caparas,0,0,36,36
1656854543465,MATH 20C,A01,083760,Briones; Jor-el Thomas Caparas,1,0,35,34
1656854543465,MATH 20C,A02,083761,Briones; Jor-el Thomas Caparas,8,0,35,27
1656854543465,MATH 20C,A03,093476,Briones; Jor-el Thomas Caparas,0,1,36,36
1656854543465,MATH 20C,B01,083762,Bach; Quang Tran,0,0,30,30
1656854549488,MATH 20D,A01,083765,Tran; Brian Kha,4,0,30,26
1656854549488,MATH 20D,A02,083766,Tran; Brian Kha,4,0,30,26
1656854549488,MATH 20D,A03,083767,Tran; Brian Kha,2,0,30,28
1656854555512,MATH 20E,A01,083771,Ganguly; Soumya,5,0,32,27
1656854555512,MATH 20E,A02,083772,Ganguly; Soumya,6,0,32,26
1656854555512,MATH 20E,B01,083773,Ciotti; Benjamin,18,0,35,17
1656854555512,MATH 20E,B02,083774,Ciotti; Benjamin,17,0,35,18
1656854561543,MATH 103A,A01,083777,Greenfeld; Be'Eri,2,0,36,34
1656854561543,MATH 103A,A02,083778,Greenfeld; Be'Eri,5,0,36,31
1656854561543,MATH 103A,A03,093561,Greenfeld; Be'Eri,4,0,36,32
1656854561543,MATH 103A,B01,083779,Greenfeld; Be'Eri,6,0,36,30
1656854561543,MATH 103A,B02,083780,Greenfeld; Be'Eri,2,0,36,34
1656854561543,MATH 103A,B03,093562,Greenfeld; Be'Eri,2,0,36,34
1656854567569,MATH 105,A01,085443,Carter; Anne Toulson,13,0,35,22
1656854567569,MATH 105,A02,093477,Carter; Anne Toulson,20,0,35,15
1656854573593,MATH 109,A01,083213,Ganzberger; Geoffrey Michael,2,0,34,32
1656854573593,MATH 109,A02,083214,Ganzberger; Geoffrey Michael,2,0,34,32
1656854573593,MATH 109,A03,093478,Ganzberger; Geoffrey Michael,1,0,34,33
1656854573593,MATH 109,B01,083215,Ganzberger; Geoffrey Michael,1,0,32,31
1656854573593,MATH 109,B02,083216,Ganzberger; Geoffrey Michael,1,0,32,31
1656854573593,MATH 109,B03,093479,Ganzberger; Geoffrey Michael,6,0,32,26
1656854579624,MATH 142A,A01,083219,Chow; Bennett,6,0,32,26
1656854579624,MATH 142A,A02,083220,Chow; Bennett,9,0,32,23
1656854579624,MATH 142A,A03,093480,Chow; Bennett,7,0,32,25
1656854579624,MATH 142A,B03,093481,Chow; Bennett,7,0,32,25
1656854579624,MATH 142A,B04,093558,Chow; Bennett,10,0,32,22
1656854579624,MATH 142A,B05,093559,Chow; Bennett,6,0,32,26
1656854585651,MATH 193A,A01,083224,Rotar; Vladimir,6,0,34,28
1656854585651,MATH 193A,A02,083225,Rotar; Vladimir,3,0,34,31
1656854585651,MATH 193A,A03,083781,Rotar; Vladimir,1,0,34,33
1656854585651,MATH 193A,A04,083782,Rotar; Vladimir,6,0,34,28
1656854585651,MATH 193A,A05,093482,Rotar; Vladimir,6,0,34,28
1656854591680,MATH 197,001,091859,McAuley; Julian John,9999,0,9999,0
1656854591680,MATH 197,002,095566,Kedlaya; Kiran S.,9997,0,9999,2
1656854591680,MATH 197,003,095567,Xiao; Ming,9999,0,9999,0
1656854591680,MATH 197,004,095571,Perols; Johan Lars,9998,0,9999,1
1656854598735,COGS 9,A01,083615,Shannon; Kyle Michael,6,0,75,69
1656854604759,COGS 11,A01,083617,Boyle; Mary E. T.,18,0,48,30
1656854610786,COGS 13,A01,083071,Bastos; Amalia Pinkusfeld,8,0,71,63
1656854616816,COGS 14A,A01,092681,Semenuks; Arturs,0,1,100,100
1656854622846,COGS 14B,A01,083073,Cheng; Tzu-Han,5,0,63,58
1656854628869,COGS 17,A01,092677,Semenuks; Arturs,4,0,81,77
1656854634891,COGS 100,A01,083619,Allen; Michael Gordon,15,0,70,55
1656854640916,COGS 101A,A01,083621,Davis; Joshua Daniel,9,0,68,59
1656854646947,COGS 101B,A01,091572,Allen; Michael Gordon,8,0,65,57
1656854652972,COGS 101C,A01,083625,Delgado; Tania,17,0,35,18
1656854658996,COGS 107A,A01,083627,Boyle; Mary E. T.,13,0,60,47
1656854665021,COGS 118A,A01,083075,Gupta; Anjum,15,0,76,61
1656854671059,CSE 3,A50,083646,Miranda; Gregory Joseph,22,0,50,28
1656854677088,CSE 8A,A50,083650,Miranda; Gregory Joseph,17,1,56,39
1656854683112,CSE 11,A01,083080,Cao; Yingjun,4,15,40,36
1656854689140,CSE 12,A01,083652,Krause-Levy; Sophia Louisa,20,1,120,100
1656854695164,CSE 15L,A01,083654,Morris; Justin Loren,8,0,50,42
1656854695164,CSE 15L,A02,083655,Morris; Justin Loren,8,0,50,42
1656854701190,CSE 20,A01,083657,Tran; Khoa Dang,37,0,80,43
1656854707213,CSE 21,A01,095574,Bach; Quang Tran,21,0,48,27
1656854713238,CSE 30,A01,083084,Eldon; John,4,0,80,76
1656854713238,CSE 30,B01,095061,Bhaskar; Nishant,6,0,50,44
1656854719262,CSE 100,A01,083659,Cao; Yingjun,2,4,70,68
1656854725288,CSE 134B,A01,083661,Powell; Thomas Allan,19,0,100,81
1656854731313,CSE 140,A01,083663,Gungor; Onat,14,0,85,71
1656854737341,CSE 140L,A01,083088,Eldon; John,16,0,100,84
1656854743370,CSE 175,A01,083665,Kumar; Rakesh,3,0,25,22
1656854749399,CSE 190,A00,092507,Dubnov; Shlomo,7,0,20,13
1656854755430,ECE 45,A01,083139,Congero; Spencer William,5,0,75,70
1656854761460,ECE 65,A50,083695,Saad; Andrew S,12,0,30,18
1656854761460,ECE 65,A51,095125,Saad; Andrew S,25,0,26,1
1656854767486,ECE 109,A01,091882,Touri; Behrouz,16,0,70,54
1656854773510,ECE 180,A00,083140,Abi Samra; Nicholas Camill,0,0,30,30
1656854773510,ECE 180,B00,083141,Abi Samra; Nicholas Camill,0,0,30,30
1656854779536,MATH 10A,A01,083735,Patchell; Gregory David,1,0,30,29
1656854779536,MATH 10A,A02,083736,Patchell; Gregory David,20,0,30,10
1656854779536,MATH 10A,A03,083737,Patchell; Gregory David,15,0,30,15
1656854785570,MATH 10B,A01,083207,Lim; Seonhee,7,0,34,27
1656854785570,MATH 10B,A02,083208,Lim; Seonhee,9,0,35,26
1656854785570,MATH 10B,A03,093472,Lim; Seonhee,4,0,34,30
1656854785570,MATH 10B,B01,083739,Sinha; Shubham,9,0,30,21
1656854791595,MATH 18,A01,083743,Cinel; Cameron Alexander,6,0,30,24
1656854791595,MATH 18,A02,083744,Cinel; Cameron Alexander,15,0,30,15
1656854791595,MATH 18,A03,083745,Cinel; Cameron Alexander,8,0,30,22
1656854791595,MATH 18,B01,083748,Rideout; David Porter,3,0,37,34
1656854791595,MATH 18,B02,083749,Rideout; David Porter,3,0,36,33
1656854791595,MATH 18,B03,083750,Rideout; David Porter,2,0,37,35
1656854791595,MATH 18,B04,083751,Rideout; David Porter,5,0,36,31
1656854791595,MATH 18,B05,093473,Rideout; David Porter,4,0,36,32
1656854791595,MATH 18,B06,093474,Rideout; David Porter,5,0,36,31
1656854797618,MATH 20A,A01,083754,Zheng; Zequn,12,0,40,28
1656854803641,MATH 20B,A01,083756,Briones; Jor-el Thomas Caparas,1,0,36,35
1656854803641,MATH 20B,A02,083757,Briones; Jor-el Thomas Caparas,1,0,36,35
1656854803641,MATH 20B,A03,093475,Briones; Jor-el Thomas Caparas,0,0,36,36
1656854809664,MATH 20C,A01,083760,Briones; Jor-el Thomas Caparas,1,0,35,34
1656854809664,MATH 20C,A02,083761,Briones; Jor-el Thomas Caparas,8,0,35,27
1656854809664,MATH 20C,A03,093476,Briones; Jor-el Thomas Caparas,0,1,36,36
1656854809664,MATH 20C,B01,083762,Bach; Quang Tran,0,0,30,30
1656854815693,MATH 20D,A01,083765,Tran; Brian Kha,4,0,30,26
1656854815693,MATH 20D,A02,083766,Tran; Brian Kha,4,0,30,26
1656854815693,MATH 20D,A03,083767,Tran; Brian Kha,2,0,30,28
1656854821724,MATH 20E,A01,083771,Ganguly; Soumya,5,0,32,27
1656854821724,MATH 20E,A02,083772,Ganguly; Soumya,6,0,32,26
1656854821724,MATH 20E,B01,083773,Ciotti; Benjamin,18,0,35,17
1656854821724,MATH 20E,B02,083774,Ciotti; Benjamin,17,0,35,18
1656854827753,MATH 103A,A01,083777,Greenfeld; Be'Eri,2,0,36,34
1656854827753,MATH 103A,A02,083778,Greenfeld; Be'Eri,5,0,36,31
1656854827753,MATH 103A,A03,093561,Greenfeld; Be'Eri,4,0,36,32
1656854827753,MATH 103A,B01,083779,Greenfeld; Be'Eri,6,0,36,30
1656854827753,MATH 103A,B02,083780,Greenfeld; Be'Eri,2,0,36,34
1656854827753,MATH 103A,B03,093562,Greenfeld; Be'Eri,2,0,36,34
1656854833779,MATH 105,A01,085443,Carter; Anne Toulson,13,0,35,22
1656854833779,MATH 105,A02,093477,Carter; Anne Toulson,20,0,35,15
1656854839803,MATH 109,A01,083213,Ganzberger; Geoffrey Michael,2,0,34,32
1656854839803,MATH 109,A02,083214,Ganzberger; Geoffrey Michael,2,0,34,32
1656854839803,MATH 109,A03,093478,Ganzberger; Geoffrey Michael,1,0,34,33
1656854839803,MATH 109,B01,083215,Ganzberger; Geoffrey Michael,1,0,32,31
1656854839803,MATH 109,B02,083216,Ganzberger; Geoffrey Michael,1,0,32,31
1656854839803,MATH 109,B03,093479,Ganzberger; Geoffrey Michael,6,0,32,26
1656854845827,MATH 142A,A01,083219,Chow; Bennett,6,0,32,26
1656854845827,MATH 142A,A02,083220,Chow; Bennett,9,0,32,23
1656854845827,MATH 142A,A03,093480,Chow; Bennett,7,0,32,25
1656854845827,MATH 142A,B03,093481,Chow; Bennett,7,0,32,25
1656854845827,MATH 142A,B04,093558,Chow; Bennett,10,0,32,22
1656854845827,MATH 142A,B05,093559,Chow; Bennett,6,0,32,26
1656854851853,MATH 193A,A01,083224,Rotar; Vladimir,6,0,34,28
1656854851853,MATH 193A,A02,083225,Rotar; Vladimir,3,0,34,31
1656854851853,MATH 193A,A03,083781,Rotar; Vladimir,1,0,34,33
1656854851853,MATH 193A,A04,083782,Rotar; Vladimir,6,0,34,28
1656854851853,MATH 193A,A05,093482,Rotar; Vladimir,6,0,34,28
1656854857886,MATH 197,001,091859,McAuley; Julian John,9999,0,9999,0
1656854857886,MATH 197,002,095566,Kedlaya; Kiran S.,9997,0,9999,2
1656854857886,MATH 197,003,095567,Xiao; Ming,9999,0,9999,0
1656854857886,MATH 197,004,095571,Perols; Johan Lars,9998,0,9999,1
1656854864959,COGS 9,A01,083615,Shannon; Kyle Michael,6,0,75,69
1656854870987,COGS 11,A01,083617,Boyle; Mary E. T.,18,0,48,30
1656854877016,COGS 13,A01,083071,Bastos; Amalia Pinkusfeld,8,0,71,63
1656854883044,COGS 14A,A01,092681,Semenuks; Arturs,0,1,100,100
1656854889141,COGS 14B,A01,083073,Cheng; Tzu-Han,5,0,63,58
1656854895165,COGS 17,A01,092677,Semenuks; Arturs,4,0,81,77
1656854901188,COGS 100,A01,083619,Allen; Michael Gordon,15,0,70,55
1656854907213,COGS 101A,A01,083621,Davis; Joshua Daniel,9,0,68,59
1656854913238,COGS 101B,A01,091572,Allen; Michael Gordon,8,0,65,57
1656854919266,COGS 101C,A01,083625,Delgado; Tania,17,0,35,18
1656854925292,COGS 107A,A01,083627,Boyle; Mary E. T.,13,0,60,47
1656854931316,COGS 118A,A01,083075,Gupta; Anjum,15,0,76,61
1656854937348,CSE 3,A50,083646,Miranda; Gregory Joseph,22,0,50,28
1656854943383,CSE 8A,A50,083650,Miranda; Gregory Joseph,17,1,56,39
1656854949406,CSE 11,A01,083080,Cao; Yingjun,4,15,40,36
1656854955431,CSE 12,A01,083652,Krause-Levy; Sophia Louisa,20,1,120,100
1656854961460,CSE 15L,A01,083654,Morris; Justin Loren,8,0,50,42
1656854961460,CSE 15L,A02,083655,Morris; Justin Loren,8,0,50,42
1656854967486,CSE 20,A01,083657,Tran; Khoa Dang,37,0,80,43
1656854973511,CSE 21,A01,095574,Bach; Quang Tran,21,0,48,27
1656854979540,CSE 30,A01,083084,Eldon; John,4,0,80,76
1656854979540,CSE 30,B01,095061,Bhaskar; Nishant,6,0,50,44
1656854985568,CSE 100,A01,083659,Cao; Yingjun,2,4,70,68
1656854991593,CSE 134B,A01,083661,Powell; Thomas Allan,19,0,100,81
1656854997621,CSE 140,A01,083663,Gungor; Onat,14,0,85,71
1656855003653,CSE 140L,A01,083088,Eldon; John,16,0,100,84
1656855009676,CSE 175,A01,083665,Kumar; Rakesh,3,0,25,22
1656855015700,CSE 190,A00,092507,Dubnov; Shlomo,7,0,20,13
1656855021726,ECE 45,A01,083139,Congero; Spencer William,5,0,75,70
1656855027756,ECE 65,A50,083695,Saad; Andrew S,12,0,30,18
1656855027756,ECE 65,A51,095125,Saad; Andrew S,25,0,26,1
1656855033781,ECE 109,A01,091882,Touri; Behrouz,16,0,70,54
1656855039807,ECE 180,A00,083140,Abi Samra; Nicholas Camill,0,0,30,30
1656855039807,ECE 180,B00,083141,Abi Samra; Nicholas Camill,0,0,30,30
1656855045837,MATH 10A,A01,083735,Patchell; Gregory David,1,0,30,29
1656855045837,MATH 10A,A02,083736,Patchell; Gregory David,20,0,30,10
1656855045837,MATH 10A,A03,083737,Patchell; Gregory David,15,0,30,15
1656855051863,MATH 10B,A01,083207,Lim; Seonhee,7,0,34,27
1656855051863,MATH 10B,A02,083208,Lim; Seonhee,9,0,35,26
1656855051863,MATH 10B,A03,093472,Lim; Seonhee,4,0,34,30
1656855051863,MATH 10B,B01,083739,Sinha; Shubham,9,0,30,21
1656855057889,MATH 18,A01,083743,Cinel; Cameron Alexander,6,0,30,24
1656855057889,MATH 18,A02,083744,Cinel; Cameron Alexander,15,0,30,15
1656855057889,MATH 18,A03,083745,Cinel; Cameron Alexander,8,0,30,22
1656855057889,MATH 18,B01,083748,Rideout; David Porter,3,0,37,34
1656855057889,MATH 18,B02,083749,Rideout; David Porter,3,0,36,33
1656855057889,MATH 18,B03,083750,Rideout; David Porter,2,0,37,35
1656855057889,MATH 18,B04,083751,Rideout; David Porter,5,0,36,31
1656855057889,MATH 18,B05,093473,Rideout; David Porter,4,0,36,32
1656855057889,MATH 18,B06,093474,Rideout; David Porter,5,0,36,31
1656855063913,MATH 20A,A01,083754,Zheng; Zequn,12,0,40,28
1656855069938,MATH 20B,A01,083756,Briones; Jor-el Thomas Caparas,1,0,36,35
1656855069938,MATH 20B,A02,083757,Briones; Jor-el Thomas Caparas,1,0,36,35
1656855069938,MATH 20B,A03,093475,Briones; Jor-el Thomas Caparas,0,0,36,36
1656855075967,MATH 20C,A01,083760,Briones; Jor-el Thomas Caparas,1,0,35,34
1656855075967,MATH 20C,A02,083761,Briones; Jor-el Thomas Caparas,8,0,35,27
1656855075967,MATH 20C,A03,093476,Briones; Jor-el Thomas Caparas,0,1,36,36
1656855075967,MATH 20C,B01,083762,Bach; Quang Tran,0,0,30,30
1656855082002,MATH 20D,A01,083765,Tran; Brian Kha,4,0,30,26
1656855082002,MATH 20D,A02,083766,Tran; Brian Kha,4,0,30,26
1656855082002,MATH 20D,A03,083767,Tran; Brian Kha,2,0,30,28
1656855088027,MATH 20E,A01,083771,Ganguly; Soumya,5,0,32,27
1656855088027,MATH 20E,A02,083772,Ganguly; Soumya,6,0,32,26
1656855088027,MATH 20E,B01,083773,Ciotti; Benjamin,18,0,35,17
1656855088027,MATH 20E,B02,083774,Ciotti; Benjamin,17,0,35,18
1656855094053,MATH 103A,A01,083777,Greenfeld; Be'Eri,2,0,36,34
1656855094053,MATH 103A,A02,083778,Greenfeld; Be'Eri,5,0,36,31
1656855094053,MATH 103A,A03,093561,Greenfeld; Be'Eri,4,0,36,32
1656855094053,MATH 103A,B01,083779,Greenfeld; Be'Eri,6,0,36,30
1656855094053,MATH 103A,B02,083780,Greenfeld; Be'Eri,2,0,36,34
1656855094053,MATH 103A,B03,093562,Greenfeld; Be'Eri,2,0,36,34
1656855100081,MATH 105,A01,085443,Carter; Anne Toulson,13,0,35,22
1656855100081,MATH 105,A02,093477,Carter; Anne Toulson,20,0,35,15
1656855106107,MATH 109,A01,083213,Ganzberger; Geoffrey Michael,2,0,34,32
1656855106107,MATH 109,A02,083214,Ganzberger; Geoffrey Michael,2,0,34,32
1656855106107,MATH 109,A03,093478,Ganzberger; Geoffrey Michael,1,0,34,33
1656855106107,MATH 109,B01,083215,Ganzberger; Geoffrey Michael,1,0,32,31
1656855106107,MATH 109,B02,083216,Ganzberger; Geoffrey Michael,1,0,32,31
1656855106107,MATH 109,B03,093479,Ganzberger; Geoffrey Michael,6,0,32,26
1656855112131,MATH 142A,A01,083219,Chow; Bennett,6,0,32,26
1656855112131,MATH 142A,A02,083220,Chow; Bennett,9,0,32,23
1656855112131,MATH 142A,A03,093480,Chow; Bennett,7,0,32,25
1656855112131,MATH 142A,B03,093481,Chow; Bennett,7,0,32,25
1656855112131,MATH 142A,B04,093558,Chow; Bennett,10,0,32,22
1656855112131,MATH 142A,B05,093559,Chow; Bennett,6,0,32,26
1656855118159,MATH 193A,A01,083224,Rotar; Vladimir,6,0,34,28
1656855118159,MATH 193A,A02,083225,Rotar; Vladimir,3,0,34,31
1656855118159,MATH 193A,A03,083781,Rotar; Vladimir,1,0,34,33
1656855118159,MATH 193A,A04,083782,Rotar; Vladimir,6,0,34,28
1656855118159,MATH 193A,A05,093482,Rotar; Vladimir,6,0,34,28
1656855124185,MATH 197,001,091859,McAuley; Julian John,9999,0,9999,0
1656855124185,MATH 197,002,095566,Kedlaya; Kiran S.,9997,0,9999,2
1656855124185,MATH 197,003,095567,Xiao; Ming,9999,0,9999,0
1656855124185,MATH 197,004,095571,Perols; Johan Lars,9998,0,9999,1
1656855131244,COGS 9,A01,083615,Shannon; Kyle Michael,6,0,75,69
1656855137269,COGS 11,A01,083617,Boyle; Mary E. T.,18,0,48,30
1656855143296,COGS 13,A01,083071,Bastos; Amalia Pinkusfeld,8,0,71,63
1656855149324,COGS 14A,A01,092681,Semenuks; Arturs,0,1,100,100
1656855155348,COGS 14B,A01,083073,Cheng; Tzu-Han,5,0,63,58
1656855161373,COGS 17,A01,092677,Semenuks; Arturs,4,0,81,77
1656855167397,COGS 100,A01,083619,Allen; Michael Gordon,15,0,70,55
1656855173421,COGS 101A,A01,083621,Davis; Joshua Daniel,9,0,68,59
1656855179449,COGS 101B,A01,091572,Allen; Michael Gordon,8,0,65,57
1656855185472,COGS 101C,A01,083625,Delgado; Tania,17,0,35,18
1656855191495,COGS 107A,A01,083627,Boyle; Mary E. T.,13,0,60,47
1656855197518,COGS 118A,A01,083075,Gupta; Anjum,15,0,76,61
1656855203542,CSE 3,A50,083646,Miranda; Gregory Joseph,22,0,50,28
1656855209565,CSE 8A,A50,083650,Miranda; Gregory Joseph,17,1,56,39
1656855215588,CSE 11,A01,083080,Cao; Yingjun,4,15,40,36
1656855221613,CSE 12,A01,083652,Krause-Levy; Sophia Louisa,20,1,120,100
1656855227645,CSE 15L,A01,083654,Morris; Justin Loren,8,0,50,42
1656855227645,CSE 15L,A02,083655,Morris; Justin Loren,8,0,50,42
1656855233669,CSE 20,A01,083657,Tran; Khoa Dang,37,0,80,43
1656855239692,CSE 21,A01,095574,Bach; Quang Tran,21,0,48,27
1656855245722,CSE 30,A01,083084,Eldon; John,4,0,80,76
1656855245722,CSE 30,B01,095061,Bhaskar; Nishant,6,0,50,44
1656855251757,CSE 100,A01,083659,Cao; Yingjun,2,4,70,68
1656855257784,CSE 134B,A01,083661,Powell; Thomas Allan,19,0,100,81
1656855263808,CSE 140,A01,083663,Gungor; Onat,14,0,85,71
1656855269832,CSE 140L,A01,083088,Eldon; John,16,0,100,84
1656855275855,CSE 175,A01,083665,Kumar; Rakesh,3,0,25,22
1656855281878,CSE 190,A00,092507,Dubnov; Shlomo,7,0,20,13
1656855287912,ECE 45,A01,083139,Congero; Spencer William,5,0,75,70
1656855293941,ECE 65,A50,083695,Saad; Andrew S,12,0,30,18
1656855293941,ECE 65,A51,095125,Saad; Andrew S,25,0,26,1
1656855299965,ECE 109,A01,091882,Touri; Behrouz,16,0,70,54
1656855305998,ECE 180,A00,083140,Abi Samra; Nicholas Camill,0,0,30,30
1656855305998,ECE 180,B00,083141,Abi Samra; Nicholas Camill,0,0,30,30
1656855312022,MATH 10A,A01,083735,Patchell; Gregory David,1,0,30,29
1656855312022,MATH 10A,A02,083736,Patchell; Gregory David,20,0,30,10
1656855312022,MATH 10A,A03,083737,Patchell; Gregory David,15,0,30,15
1656855318052,MATH 10B,A01,083207,Lim; Seonhee,7,0,34,27
1656855318052,MATH 10B,A02,083208,Lim; Seonhee,9,0,35,26
1656855318052,MATH 10B,A03,093472,Lim; Seonhee,4,0,34,30
1656855318052,MATH 10B,B01,083739,Sinha; Shubham,9,0,30,21
1656855324083,MATH 18,A01,083743,Cinel; Cameron Alexander,6,0,30,24
1656855324083,MATH 18,A02,083744,Cinel; Cameron Alexander,15,0,30,15
1656855324083,MATH 18,A03,083745,Cinel; Cameron Alexander,8,0,30,22
1656855324083,MATH 18,B01,083748,Rideout; David Porter,3,0,37,34
1656855324083,MATH 18,B02,083749,Rideout; David Porter,3,0,36,33
1656855324083,MATH 18,B03,083750,Rideout; David Porter,2,0,37,35
1656855324083,MATH 18,B04,083751,Rideout; David Porter,5,0,36,31
1656855324083,MATH 18,B05,093473,Rideout; David Porter,4,0,36,32
1656855324083,MATH 18,B06,093474,Rideout; David Porter,5,0,36,31
1656855330110,MATH 20A,A01,083754,Zheng; Zequn,12,0,40,28
1656855336139,MATH 20B,A01,083756,Briones; Jor-el Thomas Caparas,1,0,36,35
1656855336139,MATH 20B,A02,083757,Briones; Jor-el Thomas Caparas,1,0,36,35
1656855336139,MATH 20B,A03,093475,Briones; Jor-el Thomas Caparas,0,0,36,36
1656855342162,MATH 20C,A01,083760,Briones; Jor-el Thomas Caparas,1,0,35,34
1656855342162,MATH 20C,A02,083761,Briones; Jor-el Thomas Caparas,8,0,35,27
1656855342162,MATH 20C,A03,093476,Briones; Jor-el Thomas Caparas,0,1,36,36
1656855342162,MATH 20C,B01,083762,Bach; Quang Tran,0,0,30,30
1656855348192,MATH 20D,A01,083765,Tran; Brian Kha,4,0,30,26
1656855348192,MATH 20D,A02,083766,Tran; Brian Kha,4,0,30,26
1656855348192,MATH 20D,A03,083767,Tran; Brian Kha,2,0,30,28
1656855354216,MATH 20E,A01,083771,Ganguly; Soumya,5,0,32,27
1656855354216,MATH 20E,A02,083772,Ganguly; Soumya,6,0,32,26
1656855354216,MATH 20E,B01,083773,Ciotti; Benjamin,18,0,35,17
1656855354216,MATH 20E,B02,083774,Ciotti; Benjamin,17,0,35,18
1656855360242,MATH 103A,A01,083777,Greenfeld; Be'Eri,2,0,36,34
1656855360242,MATH 103A,A02,083778,Greenfeld; Be'Eri,5,0,36,31
1656855360242,MATH 103A,A03,093561,Greenfeld; Be'Eri,4,0,36,32
1656855360242,MATH 103A,B01,083779,Greenfeld; Be'Eri,6,0,36,30
1656855360242,MATH 103A,B02,083780,Greenfeld; Be'Eri,2,0,36,34
1656855360242,MATH 103A,B03,093562,Greenfeld; Be'Eri,2,0,36,34
1656855366279,MATH 105,A01,085443,Carter; Anne Toulson,13,0,35,22
1656855366279,MATH 105,A02,093477,Carter; Anne Toulson,20,0,35,15
1656855372310,MATH 109,A01,083213,Ganzberger; Geoffrey Michael,2,0,34,32
1656855372310,MATH 109,A02,083214,Ganzberger; Geoffrey Michael,2,0,34,32
1656855372310,MATH 109,A03,093478,Ganzberger; Geoffrey Michael,1,0,34,33
1656855372310,MATH 109,B01,083215,Ganzberger; Geoffrey Michael,1,0,32,31
1656855372310,MATH 109,B02,083216,Ganzberger; Geoffrey Michael,1,0,32,31
1656855372310,MATH 109,B03,093479,Ganzberger; Geoffrey Michael,6,0,32,26
1656855378336,MATH 142A,A01,083219,Chow; Bennett,6,0,32,26
1656855378336,MATH 142A,A02,083220,Chow; Bennett,9,0,32,23
1656855378336,MATH 142A,A03,093480,Chow; Bennett,7,0,32,25
1656855378336,MATH 142A,B03,093481,Chow; Bennett,7,0,32,25
1656855378336,MATH 142A,B04,093558,Chow; Bennett,10,0,32,22
1656855378336,MATH 142A,B05,093559,Chow; Bennett,6,0,32,26
1656855384360,MATH 193A,A01,083224,Rotar; Vladimir,6,0,34,28
1656855384360,MATH 193A,A02,083225,Rotar; Vladimir,3,0,34,31
1656855384360,MATH 193A,A03,083781,Rotar; Vladimir,1,0,34,33
1656855384360,MATH 193A,A04,083782,Rotar; Vladimir,6,0,34,28
1656855384360,MATH 193A,A05,093482,Rotar; Vladimir,6,0,34,28
1656855390386,MATH 197,001,091859,McAuley; Julian John,9999,0,9999,0
1656855390386,MATH 197,002,095566,Kedlaya; Kiran S.,9997,0,9999,2
1656855390386,MATH 197,003,095567,Xiao; Ming,9999,0,9999,0
1656855390386,MATH 197,004,095571,Perols; Johan Lars,9998,0,9999,1
1656855397464,COGS 9,A01,083615,Shannon; Kyle Michael,6,0,75,69
1656855403492,COGS 11,A01,083617,Boyle; Mary E. T.,18,0,48,30
1656855409520,COGS 13,A01,083071,Bastos; Amalia Pinkusfeld,8,0,71,63
1656855415541,COGS 14A,A01,092681,Semenuks; Arturs,0,1,100,100
1656855421566,COGS 14B,A01,083073,Cheng; Tzu-Han,5,0,63,58
1656855427591,COGS 17,A01,092677,Semenuks; Arturs,4,0,81,77
1656855433615,COGS 100,A01,083619,Allen; Michael Gordon,15,0,70,55
1656855439642,COGS 101A,A01,083621,Davis; Joshua Daniel,9,0,68,59
1656855445671,COGS 101B,A01,091572,Allen; Michael Gordon,8,0,65,57
1656855451696,COGS 101C,A01,083625,Delgado; Tania,17,0,35,18
1656855457719,COGS 107A,A01,083627,Boyle; Mary E. T.,13,0,60,47
1656855463742,COGS 118A,A01,083075,Gupta; Anjum,15,0,76,61
1656855469768,CSE 3,A50,083646,Miranda; Gregory Joseph,22,0,50,28
1656855475796,CSE 8A,A50,083650,Miranda; Gregory Joseph,17,1,56,39
1656855481820,CSE 11,A01,083080,Cao; Yingjun,4,15,40,36
1656855487940,CSE 12,A01,083652,Krause-Levy; Sophia Louisa,20,1,120,100
1656855493963,CSE 15L,A01,083654,Morris; Justin Loren,8,0,50,42
1656855493963,CSE 15L,A02,083655,Morris; Justin Loren,8,0,50,42
1656855499986,CSE 20,A01,083657,Tran; Khoa Dang,37,0,80,43
1656855506011,CSE 21,A01,095574,Bach; Quang Tran,21,0,48,27
1656855512075,CSE 30,A01,083084,Eldon; John,4,0,80,76
1656855512075,CSE 30,B01,095061,Bhaskar; Nishant,6,0,50,44
1656855518101,CSE 100,A01,083659,Cao; Yingjun,2,4,70,68
1656855524128,CSE 134B,A01,083661,Powell; Thomas Allan,19,0,100,81
1656855530159,CSE 140,A01,083663,Gungor; Onat,14,0,85,71
1656855536183,CSE 140L,A01,083088,Eldon; John,16,0,100,84
1656855542210,CSE 175,A01,083665,Kumar; Rakesh,3,0,25,22
1656855548235,CSE 190,A00,092507,Dubnov; Shlomo,7,0,20,13
1656855554264,ECE 45,A01,083139,Congero; Spencer William,5,0,75,70
1656855560287,ECE 65,A50,083695,Saad; Andrew S,12,0,30,18
1656855560287,ECE 65,A51,095125,Saad; Andrew S,25,0,26,1
1656855566311,ECE 109,A01,091882,Touri; Behrouz,16,0,70,54
1656855572334,ECE 180,A00,083140,Abi Samra; Nicholas Camill,0,0,30,30
1656855572334,ECE 180,B00,083141,Abi Samra; Nicholas Camill,0,0,30,30
1656855578358,MATH 10A,A01,083735,Patchell; Gregory David,1,0,30,29
1656855578358,MATH 10A,A02,083736,Patchell; Gregory David,20,0,30,10
1656855578358,MATH 10A,A03,083737,Patchell; Gregory David,15,0,30,15
1656855584387,MATH 10B,A01,083207,Lim; Seonhee,7,0,34,27
1656855584387,MATH 10B,A02,083208,Lim; Seonhee,9,0,35,26
1656855584387,MATH 10B,A03,093472,Lim; Seonhee,4,0,34,30
1656855584387,MATH 10B,B01,083739,Sinha; Shubham,9,0,30,21
1656855590412,MATH 18,A01,083743,Cinel; Cameron Alexander,6,0,30,24
1656855590412,MATH 18,A02,083744,Cinel; Cameron Alexander,15,0,30,15
1656855590412,MATH 18,A03,083745,Cinel; Cameron Alexander,8,0,30,22
1656855590412,MATH 18,B01,083748,Rideout; David Porter,3,0,37,34
1656855590412,MATH 18,B02,083749,Rideout; David Porter,3,0,36,33
1656855590412,MATH 18,B03,083750,Rideout; David Porter,2,0,37,35
1656855590412,MATH 18,B04,083751,Rideout; David Porter,5,0,36,31
1656855590412,MATH 18,B05,093473,Rideout; David Porter,4,0,36,32
1656855590412,MATH 18,B06,093474,Rideout; David Porter,5,0,36,31
1656855596435,MATH 20A,A01,083754,Zheng; Zequn,12,0,40,28
1656855602461,MATH 20B,A01,083756,Briones; Jor-el Thomas Caparas,1,0,36,35
1656855602461,MATH 20B,A02,083757,Briones; Jor-el Thomas Caparas,1,0,36,35
1656855602461,MATH 20B,A03,093475,Briones; Jor-el Thomas Caparas,0,0,36,36
1656855608488,MATH 20C,A01,083760,Briones; Jor-el Thomas Caparas,1,0,35,34
1656855608488,MATH 20C,A02,083761,Briones; Jor-el Thomas Caparas,8,0,35,27
1656855608488,MATH 20C,A03,093476,Briones; Jor-el Thomas Caparas,0,1,36,36
1656855608488,MATH 20C,B01,083762,Bach; Quang Tran,0,0,30,30
1656855614517,MATH 20D,A01,083765,Tran; Brian Kha,4,0,30,26
1656855614517,MATH 20D,A02,083766,Tran; Brian Kha,4,0,30,26
1656855614517,MATH 20D,A03,083767,Tran; Brian Kha,2,0,30,28
1656855620550,MATH 20E,A01,083771,Ganguly; Soumya,5,0,32,27
1656855620550,MATH 20E,A02,083772,Ganguly; Soumya,6,0,32,26
1656855620550,MATH 20E,B01,083773,Ciotti; Benjamin,18,0,35,17
1656855620550,MATH 20E,B02,083774,Ciotti; Benjamin,17,0,35,18
1656855626577,MATH 103A,A01,083777,Greenfeld; Be'Eri,2,0,36,34
1656855626577,MATH 103A,A02,083778,Greenfeld; Be'Eri,5,0,36,31
1656855626577,MATH 103A,A03,093561,Greenfeld; Be'Eri,4,0,36,32
1656855626577,MATH 103A,B01,083779,Greenfeld; Be'Eri,6,0,36,30
1656855626577,MATH 103A,B02,083780,Greenfeld; Be'Eri,2,0,36,34
1656855626577,MATH 103A,B03,093562,Greenfeld; Be'Eri,2,0,36,34
1656855632603,MATH 105,A01,085443,Carter; Anne Toulson,13,0,35,22
1656855632603,MATH 105,A02,093477,Carter; Anne Toulson,20,0,35,15
1656855638627,MATH 109,A01,083213,Ganzberger; Geoffrey Michael,2,0,34,32
1656855638627,MATH 109,A02,083214,Ganzberger; Geoffrey Michael,2,0,34,32
1656855638627,MATH 109,A03,093478,Ganzberger; Geoffrey Michael,1,0,34,33
1656855638627,MATH 109,B01,083215,Ganzberger; Geoffrey Michael,1,0,32,31
1656855638627,MATH 109,B02,083216,Ganzberger; Geoffrey Michael,1,0,32,31
1656855638627,MATH 109,B03,093479,Ganzberger; Geoffrey Michael,6,0,32,26
1656855644650,MATH 142A,A01,083219,Chow; Bennett,6,0,32,26
1656855644650,MATH 142A,A02,083220,Chow; Bennett,9,0,32,23
1656855644650,MATH 142A,A03,093480,Chow; Bennett,7,0,32,25
1656855644650,MATH 142A,B03,093481,Chow; Bennett,7,0,32,25
1656855644650,MATH 142A,B04,093558,Chow; Bennett,10,0,32,22
1656855644650,MATH 142A,B05,093559,Chow; Bennett,6,0,32,26
1656855650678,MATH 193A,A01,083224,Rotar; Vladimir,6,0,34,28
1656855650678,MATH 193A,A02,083225,Rotar; Vladimir,3,0,34,31
1656855650678,MATH 193A,A03,083781,Rotar; Vladimir,1,0,34,33
1656855650678,MATH 193A,A04,083782,Rotar; Vladimir,6,0,34,28
1656855650678,MATH 193A,A05,093482,Rotar; Vladimir,6,0,34,28
1656855656703,MATH 197,001,091859,McAuley; Julian John,9999,0,9999,0
1656855656703,MATH 197,002,095566,Kedlaya; Kiran S.,9997,0,9999,2
1656855656703,MATH 197,003,095567,Xiao; Ming,9999,0,9999,0
1656855656703,MATH 197,004,095571,Perols; Johan Lars,9998,0,9999,1
1656855663763,COGS 9,A01,083615,Shannon; Kyle Michael,6,0,75,69
1656855669790,COGS 11,A01,083617,Boyle; Mary E. T.,18,0,48,30
1656855675812,COGS 13,A01,083071,Bastos; Amalia Pinkusfeld,8,0,71,63
1656855681834,COGS 14A,A01,092681,Semenuks; Arturs,0,1,100,100
1656855687857,COGS 14B,A01,083073,Cheng; Tzu-Han,5,0,63,58
1656855693890,COGS 17,A01,092677,Semenuks; Arturs,4,0,81,77
1656855699918,COGS 100,A01,083619,Allen; Michael Gordon,15,0,70,55
1656855705941,COGS 101A,A01,083621,Davis; Joshua Daniel,9,0,68,59
1656855711964,COGS 101B,A01,091572,Allen; Michael Gordon,8,0,65,57
1656855717990,COGS 101C,A01,083625,Delgado; Tania,17,0,35,18
1656855724013,COGS 107A,A01,083627,Boyle; Mary E. T.,13,0,60,47
1656855730038,COGS 118A,A01,083075,Gupta; Anjum,15,0,76,61
1656855736061,CSE 3,A50,083646,Miranda; Gregory Joseph,22,0,50,28
1656855742087,CSE 8A,A50,083650,Miranda; Gregory Joseph,17,1,56,39
1656855748110,CSE 11,A01,083080,Cao; Yingjun,4,15,40,36
1656855754136,CSE 12,A01,083652,Krause-Levy; Sophia Louisa,20,1,120,100
1656855760162,CSE 15L,A01,083654,Morris; Justin Loren,8,0,50,42
1656855760162,CSE 15L,A02,083655,Morris; Justin Loren,8,0,50,42
1656855766188,CSE 20,A01,083657,Tran; Khoa Dang,37,0,80,43
1656855772215,CSE 21,A01,095574,Bach; Quang Tran,21,0,48,27
1656855778238,CSE 30,A01,083084,Eldon; John,4,0,80,76
1656855778238,CSE 30,B01,095061,Bhaskar; Nishant,6,0,50,44
1656855784265,CSE 100,A01,083659,Cao; Yingjun,2,4,70,68
1656855790286,CSE 134B,A01,083661,Powell; Thomas Allan,19,0,100,81
1656855796308,CSE 140,A01,083663,Gungor; Onat,14,0,85,71
1656855802332,CSE 140L,A01,083088,Eldon; John,16,0,100,84
1656855808354,CSE 175,A01,083665,Kumar; Rakesh,3,0,25,22
1656855814382,CSE 190,A00,092507,Dubnov; Shlomo,7,0,20,13
1656855820403,ECE 45,A01,083139,Congero; Spencer William,5,0,75,70
1656855826427,ECE 65,A50,083695,Saad; Andrew S,12,0,30,18
1656855826427,ECE 65,A51,095125,Saad; Andrew S,25,0,26,1
1656855832452,ECE 109,A01,091882,Touri; Behrouz,16,0,70,54
1656855838475,ECE 180,A00,083140,Abi Samra; Nicholas Camill,0,0,30,30
1656855838475,ECE 180,B00,083141,Abi Samra; Nicholas Camill,0,0,30,30
1656855844498,MATH 10A,A01,083735,Patchell; Gregory David,1,0,30,29
1656855844498,MATH 10A,A02,083736,Patchell; Gregory David,20,0,30,10
1656855844498,MATH 10A,A03,083737,Patchell; Gregory David,15,0,30,15
1656855850527,MATH 10B,A01,083207,Lim; Seonhee,7,0,34,27
1656855850527,MATH 10B,A02,083208,Lim; Seonhee,9,0,35,26
1656855850527,MATH 10B,A03,093472,Lim; Seonhee,4,0,34,30
1656855850527,MATH 10B,B01,083739,Sinha; Shubham,9,0,30,21
1656855856566,MATH 18,A01,083743,Cinel; Cameron Alexander,6,0,30,24
1656855856566,MATH 18,A02,083744,Cinel; Cameron Alexander,15,0,30,15
1656855856566,MATH 18,A03,083745,Cinel; Cameron Alexander,8,0,30,22
1656855856566,MATH 18,B01,083748,Rideout; David Porter,3,0,37,34
1656855856566,MATH 18,B02,083749,Rideout; David Porter,3,0,36,33
1656855856566,MATH 18,B03,083750,Rideout; David Porter,2,0,37,35
1656855856566,MATH 18,B04,083751,Rideout; David Porter,5,0,36,31
1656855856566,MATH 18,B05,093473,Rideout; David Porter,4,0,36,32
1656855856566,MATH 18,B06,093474,Rideout; David Porter,5,0,36,31
1656855862591,MATH 20A,A01,083754,Zheng; Zequn,12,0,40,28
1656855868619,MATH 20B,A01,083756,Briones; Jor-el Thomas Caparas,1,0,36,35
1656855868619,MATH 20B,A02,083757,Briones; Jor-el Thomas Caparas,1,0,36,35
1656855868619,MATH 20B,A03,093475,Briones; Jor-el Thomas Caparas,0,0,36,36
1656855874648,MATH 20C,A01,083760,Briones; Jor-el Thomas Caparas,1,0,35,34
1656855874648,MATH 20C,A02,083761,Briones; Jor-el Thomas Caparas,8,0,35,27
1656855874648,MATH 20C,A03,093476,Briones; Jor-el Thomas Caparas,0,1,36,36
1656855874648,MATH 20C,B01,083762,Bach; Quang Tran,0,0,30,30
1656855880676,MATH 20D,A01,083765,Tran; Brian Kha,4,0,30,26
1656855880676,MATH 20D,A02,083766,Tran; Brian Kha,4,0,30,26
1656855880676,MATH 20D,A03,083767,Tran; Brian Kha,2,0,30,28
1656855886706,MATH 20E,A01,083771,Ganguly; Soumya,5,0,32,27
1656855886706,MATH 20E,A02,083772,Ganguly; Soumya,6,0,32,26
1656855886706,MATH 20E,B01,083773,Ciotti; Benjamin,18,0,35,17
1656855886706,MATH 20E,B02,083774,Ciotti; Benjamin,17,0,35,18
1656855892729,MATH 103A,A01,083777,Greenfeld; Be'Eri,2,0,36,34
1656855892729,MATH 103A,A02,083778,Greenfeld; Be'Eri,5,0,36,31
1656855892729,MATH 103A,A03,093561,Greenfeld; Be'Eri,4,0,36,32
1656855892729,MATH 103A,B01,083779,Greenfeld; Be'Eri,6,0,36,30
1656855892729,MATH 103A,B02,083780,Greenfeld; Be'Eri,2,0,36,34
1656855892729,MATH 103A,B03,093562,Greenfeld; Be'Eri,2,0,36,34
1656855898752,MATH 105,A01,085443,Carter; Anne Toulson,13,0,35,22
1656855898752,MATH 105,A02,093477,Carter; Anne Toulson,20,0,35,15
1656855904782,MATH 109,A01,083213,Ganzberger; Geoffrey Michael,2,0,34,32
1656855904782,MATH 109,A02,083214,Ganzberger; Geoffrey Michael,2,0,34,32
1656855904782,MATH 109,A03,093478,Ganzberger; Geoffrey Michael,1,0,34,33
1656855904782,MATH 109,B01,083215,Ganzberger; Geoffrey Michael,1,0,32,31
1656855904782,MATH 109,B02,083216,Ganzberger; Geoffrey Michael,1,0,32,31
1656855904782,MATH 109,B03,093479,Ganzberger; Geoffrey Michael,6,0,32,26
1656855910810,MATH 142A,A01,083219,Chow; Bennett,6,0,32,26
1656855910810,MATH 142A,A02,083220,Chow; Bennett,9,0,32,23
1656855910810,MATH 142A,A03,093480,Chow; Bennett,7,0,32,25
1656855910810,MATH 142A,B03,093481,Chow; Bennett,7,0,32,25
1656855910810,MATH 142A,B04,093558,Chow; Bennett,10,0,32,22
1656855910810,MATH 142A,B05,093559,Chow; Bennett,6,0,32,26
1656855916835,MATH 193A,A01,083224,Rotar; Vladimir,6,0,34,28
1656855916835,MATH 193A,A02,083225,Rotar; Vladimir,3,0,34,31
1656855916835,MATH 193A,A03,083781,Rotar; Vladimir,1,0,34,33
1656855916835,MATH 193A,A04,083782,Rotar; Vladimir,6,0,34,28
1656855916835,MATH 193A,A05,093482,Rotar; Vladimir,6,0,34,28
1656855922861,MATH 197,001,091859,McAuley; Julian John,9999,0,9999,0
1656855922861,MATH 197,002,095566,Kedlaya; Kiran S.,9997,0,9999,2
1656855922861,MATH 197,003,095567,Xiao; Ming,9999,0,9999,0
1656855922861,MATH 197,004,095571,Perols; Johan Lars,9998,0,9999,1
1656855929931,COGS 9,A01,083615,Shannon; Kyle Michael,6,0,75,69
1656855935954,COGS 11,A01,083617,Boyle; Mary E. T.,18,0,48,30
1656855941980,COGS 13,A01,083071,Bastos; Amalia Pinkusfeld,8,0,71,63
1656855948005,COGS 14A,A01,092681,Semenuks; Arturs,0,1,100,100
1656855954028,COGS 14B,A01,083073,Cheng; Tzu-Han,5,0,63,58
1656855960049,COGS 17,A01,092677,Semenuks; Arturs,4,0,81,77
1656855966078,COGS 100,A01,083619,Allen; Michael Gordon,15,0,70,55
1656855972102,COGS 101A,A01,083621,Davis; Joshua Daniel,9,0,68,59
1656855978126,COGS 101B,A01,091572,Allen; Michael Gordon,8,0,65,57
1656855984148,COGS 101C,A01,083625,Delgado; Tania,17,0,35,18
1656855990171,COGS 107A,A01,083627,Boyle; Mary E. T.,13,0,60,47
1656855996199,COGS 118A,A01,083075,Gupta; Anjum,15,0,76,61
1656856002228,CSE 3,A50,083646,Miranda; Gregory Joseph,22,0,50,28
1656856008252,CSE 8A,A50,083650,Miranda; Gregory Joseph,17,1,56,39
1656856014274,CSE 11,A01,083080,Cao; Yingjun,4,15,40,36
1656856020305,CSE 12,A01,083652,Krause-Levy; Sophia Louisa,20,1,120,100
1656856026329,CSE 15L,A01,083654,Morris; Justin Loren,8,0,50,42
1656856026329,CSE 15L,A02,083655,Morris; Justin Loren,8,0,50,42
1656856032351,CSE 20,A01,083657,Tran; Khoa Dang,37,0,80,43
1656856038381,CSE 21,A01,095574,Bach; Quang Tran,21,0,48,27
1656856044412,CSE 30,A01,083084,Eldon; John,4,0,80,76
1656856044412,CSE 30,B01,095061,Bhaskar; Nishant,6,0,50,44
1656856050439,CSE 100,A01,083659,Cao; Yingjun,2,4,70,68
1656856056465,CSE 134B,A01,083661,Powell; Thomas Allan,19,0,100,81
1656856062490,CSE 140,A01,083663,Gungor; Onat,14,0,85,71
1656856068515,CSE 140L,A01,083088,Eldon; John,16,0,100,84
1656856074544,CSE 175,A01,083665,Kumar; Rakesh,3,0,25,22
1656856080578,CSE 190,A00,092507,Dubnov; Shlomo,7,0,20,13
1656856086678,ECE 45,A01,083139,Congero; Spencer William,5,0,75,70
1656856092704,ECE 65,A50,083695,Saad; Andrew S,12,0,30,18
1656856092704,ECE 65,A51,095125,Saad; Andrew S,25,0,26,1
1656856098728,ECE 109,A01,091882,Touri; Behrouz,16,0,70,54
1656856104750,ECE 180,A00,083140,Abi Samra; Nicholas Camill,0,0,30,30
1656856104750,ECE 180,B00,083141,Abi Samra; Nicholas Camill,0,0,30,30
1656856110775,MATH 10A,A01,083735,Patchell; Gregory David,1,0,30,29
1656856110775,MATH 10A,A02,083736,Patchell; Gregory David,20,0,30,10
1656856110775,MATH 10A,A03,083737,Patchell; Gregory David,15,0,30,15
1656856116805,MATH 10B,A01,083207,Lim; Seonhee,7,0,34,27
1656856116805,MATH 10B,A02,083208,Lim; Seonhee,9,0,35,26
1656856116805,MATH 10B,A03,093472,Lim; Seonhee,4,0,34,30
1656856116805,MATH 10B,B01,083739,Sinha; Shubham,9,0,30,21
1656856122835,MATH 18,A01,083743,Cinel; Cameron Alexander,6,0,30,24
1656856122835,MATH 18,A02,083744,Cinel; Cameron Alexander,15,0,30,15
1656856122835,MATH 18,A03,083745,Cinel; Cameron Alexander,8,0,30,22
1656856122835,MATH 18,B01,083748,Rideout; David Porter,3,0,37,34
1656856122835,MATH 18,B02,083749,Rideout; David Porter,3,0,36,33
1656856122835,MATH 18,B03,083750,Rideout; David Porter,2,0,37,35
1656856122835,MATH 18,B04,083751,Rideout; David Porter,5,0,36,31
1656856122835,MATH 18,B05,093473,Rideout; David Porter,4,0,36,32
1656856122835,MATH 18,B06,093474,Rideout; David Porter,5,0,36,31
1656856128859,MATH 20A,A01,083754,Zheng; Zequn,12,0,40,28
1656856134886,MATH 20B,A01,083756,Briones; Jor-el Thomas Caparas,1,0,36,35
1656856134886,MATH 20B,A02,083757,Briones; Jor-el Thomas Caparas,1,0,36,35
1656856134886,MATH 20B,A03,093475,Briones; Jor-el Thomas Caparas,0,0,36,36
1656856140910,MATH 20C,A01,083760,Briones; Jor-el Thomas Caparas,1,0,35,34
1656856140910,MATH 20C,A02,083761,Briones; Jor-el Thomas Caparas,8,0,35,27
1656856140910,MATH 20C,A03,093476,Briones; Jor-el Thomas Caparas,0,1,36,36
1656856140910,MATH 20C,B01,083762,Bach; Quang Tran,0,0,30,30
1656856146935,MATH 20D,A01,083765,Tran; Brian Kha,4,0,30,26
1656856146935,MATH 20D,A02,083766,Tran; Brian Kha,4,0,30,26
1656856146935,MATH 20D,A03,083767,Tran; Brian Kha,2,0,30,28
1656856152962,MATH 20E,A01,083771,Ganguly; Soumya,5,0,32,27
1656856152962,MATH 20E,A02,083772,Ganguly; Soumya,6,0,32,26
1656856152962,MATH 20E,B01,083773,Ciotti; Benjamin,18,0,35,17
1656856152962,MATH 20E,B02,083774,Ciotti; Benjamin,17,0,35,18
1656856159002,MATH 103A,A01,083777,Greenfeld; Be'Eri,2,0,36,34
1656856159002,MATH 103A,A02,083778,Greenfeld; Be'Eri,5,0,36,31
1656856159002,MATH 103A,A03,093561,Greenfeld; Be'Eri,4,0,36,32
1656856159002,MATH 103A,B01,083779,Greenfeld; Be'Eri,6,0,36,30
1656856159002,MATH 103A,B02,083780,Greenfeld; Be'Eri,2,0,36,34
1656856159002,MATH 103A,B03,093562,Greenfeld; Be'Eri,2,0,36,34
1656856165024,MATH 105,A01,085443,Carter; Anne Toulson,13,0,35,22
1656856165024,MATH 105,A02,093477,Carter; Anne Toulson,20,0,35,15
1656856171047,MATH 109,A01,083213,Ganzberger; Geoffrey Michael,2,0,34,32
1656856171047,MATH 109,A02,083214,Ganzberger; Geoffrey Michael,2,0,34,32
1656856171047,MATH 109,A03,093478,Ganzberger; Geoffrey Michael,1,0,34,33
1656856171047,MATH 109,B01,083215,Ganzberger; Geoffrey Michael,1,0,32,31
1656856171047,MATH 109,B02,083216,Ganzberger; Geoffrey Michael,1,0,32,31
1656856171047,MATH 109,B03,093479,Ganzberger; Geoffrey Michael,6,0,32,26
1656856177078,MATH 142A,A01,083219,Chow; Bennett,6,0,32,26
1656856177078,MATH 142A,A02,083220,Chow; Bennett,9,0,32,23
1656856177078,MATH 142A,A03,093480,Chow; Bennett,7,0,32,25
1656856177078,MATH 142A,B03,093481,Chow; Bennett,7,0,32,25
1656856177078,MATH 142A,B04,093558,Chow; Bennett,10,0,32,22
1656856177078,MATH 142A,B05,093559,Chow; Bennett,6,0,32,26
1656856183105,MATH 193A,A01,083224,Rotar; Vladimir,6,0,34,28
1656856183105,MATH 193A,A02,083225,Rotar; Vladimir,3,0,34,31
1656856183105,MATH 193A,A03,083781,Rotar; Vladimir,1,0,34,33
1656856183105,MATH 193A,A04,083782,Rotar; Vladimir,6,0,34,28
1656856183105,MATH 193A,A05,093482,Rotar; Vladimir,6,0,34,28
1656856189127,MATH 197,001,091859,McAuley; Julian John,9999,0,9999,0
1656856189127,MATH 197,002,095566,Kedlaya; Kiran S.,9997,0,9999,2
1656856189127,MATH 197,003,095567,Xiao; Ming,9999,0,9999,0
1656856189127,MATH 197,004,095571,Perols; Johan Lars,9998,0,9999,1
1656856196182,COGS 9,A01,083615,Shannon; Kyle Michael,6,0,75,69
1656856202208,COGS 11,A01,083617,Boyle; Mary E. T.,18,0,48,30
1656856208235,COGS 13,A01,083071,Bastos; Amalia Pinkusfeld,8,0,71,63
1656856214259,COGS 14A,A01,092681,Semenuks; Arturs,0,1,100,100
1656856220282,COGS 14B,A01,083073,Cheng; Tzu-Han,5,0,63,58
1656856226311,COGS 17,A01,092677,Semenuks; Arturs,4,0,81,77
1656856232337,COGS 100,A01,083619,Allen; Michael Gordon,15,0,70,55
1656856238368,COGS 101A,A01,083621,Davis; Joshua Daniel,9,0,68,59
1656856244402,COGS 101B,A01,091572,Allen; Michael Gordon,8,0,65,57
1656856250426,COGS 101C,A01,083625,Delgado; Tania,17,0,35,18
1656856256449,COGS 107A,A01,083627,Boyle; Mary E. T.,13,0,60,47
1656856262473,COGS 118A,A01,083075,Gupta; Anjum,15,0,76,61
1656856268498,CSE 3,A50,083646,Miranda; Gregory Joseph,22,0,50,28
1656856274523,CSE 8A,A50,083650,Miranda; Gregory Joseph,17,1,56,39
1656856280551,CSE 11,A01,083080,Cao; Yingjun,4,15,40,36
1656856286575,CSE 12,A01,083652,Krause-Levy; Sophia Louisa,20,1,120,100
1656856292600,CSE 15L,A01,083654,Morris; Justin Loren,8,0,50,42
1656856292600,CSE 15L,A02,083655,Morris; Justin Loren,8,0,50,42
1656856298625,CSE 20,A01,083657,Tran; Khoa Dang,37,0,80,43
1656856304649,CSE 21,A01,095574,Bach; Quang Tran,21,0,48,27
1656856310672,CSE 30,A01,083084,Eldon; John,4,0,80,76
1656856310672,CSE 30,B01,095061,Bhaskar; Nishant,6,0,50,44
1656856316700,CSE 100,A01,083659,Cao; Yingjun,2,4,70,68
1656856322728,CSE 134B,A01,083661,Powell; Thomas Allan,19,0,100,81
1656856328752,CSE 140,A01,083663,Gungor; Onat,14,0,85,71
1656856334781,CSE 140L,A01,083088,Eldon; John,16,0,100,84
1656856340807,CSE 175,A01,083665,Kumar; Rakesh,3,0,25,22
1656856346834,CSE 190,A00,092507,Dubnov; Shlomo,7,0,20,13
1656856352856,ECE 45,A01,083139,Congero; Spencer William,5,0,75,70
1656856358880,ECE 65,A50,083695,Saad; Andrew S,12,0,30,18
1656856358880,ECE 65,A51,095125,Saad; Andrew S,25,0,26,1
1656856364902,ECE 109,A01,091882,Touri; Behrouz,16,0,70,54
1656856370937,ECE 180,A00,083140,Abi Samra; Nicholas Camill,0,0,30,30
1656856370937,ECE 180,B00,083141,Abi Samra; Nicholas Camill,0,0,30,30
1656856376972,MATH 10A,A01,083735,Patchell; Gregory David,1,0,30,29
1656856376972,MATH 10A,A02,083736,Patchell; Gregory David,20,0,30,10
1656856376972,MATH 10A,A03,083737,Patchell; Gregory David,15,0,30,15
1656856382998,MATH 10B,A01,083207,Lim; Seonhee,7,0,34,27
1656856382998,MATH 10B,A02,083208,Lim; Seonhee,9,0,35,26
1656856382998,MATH 10B,A03,093472,Lim; Seonhee,4,0,34,30
1656856382998,MATH 10B,B01,083739,Sinha; Shubham,9,0,30,21
1656856389030,MATH 18,A01,083743,Cinel; Cameron Alexander,6,0,30,24
1656856389030,MATH 18,A02,083744,Cinel; Cameron Alexander,15,0,30,15
1656856389030,MATH 18,A03,083745,Cinel; Cameron Alexander,8,0,30,22
1656856389030,MATH 18,B01,083748,Rideout; David Porter,3,0,37,34
1656856389030,MATH 18,B02,083749,Rideout; David Porter,3,0,36,33
1656856389030,MATH 18,B03,083750,Rideout; David Porter,2,0,37,35
1656856389030,MATH 18,B04,083751,Rideout; David Porter,5,0,36,31
1656856389030,MATH 18,B05,093473,Rideout; David Porter,4,0,36,32
1656856389030,MATH 18,B06,093474,Rideout; David Porter,5,0,36,31
1656856395053,MATH 20A,A01,083754,Zheng; Zequn,12,0,40,28
1656856401078,MATH 20B,A01,083756,Briones; Jor-el Thomas Caparas,1,0,36,35
1656856401078,MATH 20B,A02,083757,Briones; Jor-el Thomas Caparas,1,0,36,35
1656856401078,MATH 20B,A03,093475,Briones; Jor-el Thomas Caparas,0,0,36,36
1656856407102,MATH 20C,A01,083760,Briones; Jor-el Thomas Caparas,1,0,35,34
1656856407102,MATH 20C,A02,083761,Briones; Jor-el Thomas Caparas,8,0,35,27
1656856407102,MATH 20C,A03,093476,Briones; Jor-el Thomas Caparas,0,1,36,36
1656856407102,MATH 20C,B01,083762,Bach; Quang Tran,0,0,30,30
1656856413138,MATH 20D,A01,083765,Tran; Brian Kha,4,0,30,26
1656856413138,MATH 20D,A02,083766,Tran; Brian Kha,4,0,30,26
1656856413138,MATH 20D,A03,083767,Tran; Brian Kha,2,0,30,28
1656856419167,MATH 20E,A01,083771,Ganguly; Soumya,5,0,32,27
1656856419167,MATH 20E,A02,083772,Ganguly; Soumya,6,0,32,26
1656856419167,MATH 20E,B01,083773,Ciotti; Benjamin,18,0,35,17
1656856419167,MATH 20E,B02,083774,Ciotti; Benjamin,17,0,35,18
1656856425198,MATH 103A,A01,083777,Greenfeld; Be'Eri,2,0,36,34
1656856425198,MATH 103A,A02,083778,Greenfeld; Be'Eri,5,0,36,31
1656856425198,MATH 103A,A03,093561,Greenfeld; Be'Eri,4,0,36,32
1656856425198,MATH 103A,B01,083779,Greenfeld; Be'Eri,6,0,36,30
1656856425198,MATH 103A,B02,083780,Greenfeld; Be'Eri,2,0,36,34
1656856425198,MATH 103A,B03,093562,Greenfeld; Be'Eri,2,0,36,34
1656856431223,MATH 105,A01,085443,Carter; Anne Toulson,13,0,35,22
1656856431223,MATH 105,A02,093477,Carter; Anne Toulson,20,0,35,15
1656856437264,MATH 109,A01,083213,Ganzberger; Geoffrey Michael,2,0,34,32
1656856437264,MATH 109,A02,083214,Ganzberger; Geoffrey Michael,2,0,34,32
1656856437264,MATH 109,A03,093478,Ganzberger; Geoffrey Michael,1,0,34,33
1656856437264,MATH 109,B01,083215,Ganzberger; Geoffrey Michael,1,0,32,31
1656856437264,MATH 109,B02,083216,Ganzberger; Geoffrey Michael,1,0,32,31
1656856437264,MATH 109,B03,093479,Ganzberger; Geoffrey Michael,6,0,32,26
1656856443293,MATH 142A,A01,083219,Chow; Bennett,6,0,32,26
1656856443293,MATH 142A,A02,083220,Chow; Bennett,9,0,32,23
1656856443293,MATH 142A,A03,093480,Chow; Bennett,7,0,32,25
1656856443293,MATH 142A,B03,093481,Chow; Bennett,7,0,32,25
1656856443293,MATH 142A,B04,093558,Chow; Bennett,10,0,32,22
1656856443293,MATH 142A,B05,093559,Chow; Bennett,6,0,32,26
1656856449317,MATH 193A,A01,083224,Rotar; Vladimir,6,0,34,28
1656856449317,MATH 193A,A02,083225,Rotar; Vladimir,3,0,34,31
1656856449317,MATH 193A,A03,083781,Rotar; Vladimir,1,0,34,33
1656856449317,MATH 193A,A04,083782,Rotar; Vladimir,6,0,34,28
1656856449317,MATH 193A,A05,093482,Rotar; Vladimir,6,0,34,28
1656856455357,MATH 197,001,091859,McAuley; Julian John,9999,0,9999,0
1656856455357,MATH 197,002,095566,Kedlaya; Kiran S.,9997,0,9999,2
1656856455357,MATH 197,003,095567,Xiao; Ming,9999,0,9999,0
1656856455357,MATH 197,004,095571,Perols; Johan Lars,9998,0,9999,1
1656856462427,COGS 9,A01,083615,Shannon; Kyle Michael,6,0,75,69
1656856468453,COGS 11,A01,083617,Boyle; Mary E. T.,18,0,48,30
1656856474476,COGS 13,A01,083071,Bastos; Amalia Pinkusfeld,8,0,71,63
1656856480503,COGS 14A,A01,092681,Semenuks; Arturs,0,1,100,100
1656856486531,COGS 14B,A01,083073,Cheng; Tzu-Han,5,0,63,58
1656856492555,COGS 17,A01,092677,Semenuks; Arturs,4,0,81,77
1656856498578,COGS 100,A01,083619,Allen; Michael Gordon,15,0,70,55
1656856504606,COGS 101A,A01,083621,Davis; Joshua Daniel,9,0,68,59
1656856510629,COGS 101B,A01,091572,Allen; Michael Gordon,8,0,65,57
1656856516657,COGS 101C,A01,083625,Delgado; Tania,17,0,35,18
1656856522683,COGS 107A,A01,083627,Boyle; Mary E. T.,13,0,60,47
1656856528705,COGS 118A,A01,083075,Gupta; Anjum,15,0,76,61
1656856534732,CSE 3,A50,083646,Miranda; Gregory Joseph,22,0,50,28
1656856540755,CSE 8A,A50,083650,Miranda; Gregory Joseph,17,1,56,39
1656856546777,CSE 11,A01,083080,Cao; Yingjun,4,15,40,36
1656856552799,CSE 12,A01,083652,Krause-Levy; Sophia Louisa,20,1,120,100
1656856558822,CSE 15L,A01,083654,Morris; Justin Loren,8,0,50,42
1656856558822,CSE 15L,A02,083655,Morris; Justin Loren,8,0,50,42
1656856564847,CSE 20,A01,083657,Tran; Khoa Dang,37,0,80,43
1656856570885,CSE 21,A01,095574,Bach; Quang Tran,21,0,48,27
1656856576912,CSE 30,A01,083084,Eldon; John,4,0,80,76
1656856576912,CSE 30,B01,095061,Bhaskar; Nishant,6,0,50,44
1656856582936,CSE 100,A01,083659,Cao; Yingjun,2,4,70,68
1656856588962,CSE 134B,A01,083661,Powell; Thomas Allan,19,0,100,81
1656856594995,CSE 140,A01,083663,Gungor; Onat,14,0,85,71
1656856601020,CSE 140L,A01,083088,Eldon; John,16,0,100,84
1656856607043,CSE 175,A01,083665,Kumar; Rakesh,3,0,25,22
1656856613067,CSE 190,A00,092507,Dubnov; Shlomo,7,0,20,13
1656856619090,ECE 45,A01,083139,Congero; Spencer William,5,0,75,70
1656856625114,ECE 65,A50,083695,Saad; Andrew S,12,0,30,18
1656856625114,ECE 65,A51,095125,Saad; Andrew S,25,0,26,1
1656856631139,ECE 109,A01,091882,Touri; Behrouz,16,0,70,54
1656856637163,ECE 180,A00,083140,Abi Samra; Nicholas Camill,0,0,30,30
1656856637163,ECE 180,B00,083141,Abi Samra; Nicholas Camill,0,0,30,30
1656856643194,MATH 10A,A01,083735,Patchell; Gregory David,1,0,30,29
1656856643194,MATH 10A,A02,083736,Patchell; Gregory David,20,0,30,10
1656856643194,MATH 10A,A03,083737,Patchell; Gregory David,15,0,30,15
1656856649225,MATH 10B,A01,083207,Lim; Seonhee,7,0,34,27
1656856649225,MATH 10B,A02,083208,Lim; Seonhee,9,0,35,26
1656856649225,MATH 10B,A03,093472,Lim; Seonhee,4,0,34,30
1656856649225,MATH 10B,B01,083739,Sinha; Shubham,9,0,30,21
1656856655252,MATH 18,A01,083743,Cinel; Cameron Alexander,6,0,30,24
1656856655252,MATH 18,A02,083744,Cinel; Cameron Alexander,15,0,30,15
1656856655252,MATH 18,A03,083745,Cinel; Cameron Alexander,8,0,30,22
1656856655252,MATH 18,B01,083748,Rideout; David Porter,3,0,37,34
1656856655252,MATH 18,B02,083749,Rideout; David Porter,3,0,36,33
1656856655252,MATH 18,B03,083750,Rideout; David Porter,2,0,37,35
1656856655252,MATH 18,B04,083751,Rideout; David Porter,5,0,36,31
1656856655252,MATH 18,B05,093473,Rideout; David Porter,4,0,36,32
1656856655252,MATH 18,B06,093474,Rideout; David Porter,5,0,36,31
1656856661275,MATH 20A,A01,083754,Zheng; Zequn,12,0,40,28
1656856667304,MATH 20B,A01,083756,Briones; Jor-el Thomas Caparas,1,0,36,35
1656856667304,MATH 20B,A02,083757,Briones; Jor-el Thomas Caparas,1,0,36,35
1656856667304,MATH 20B,A03,093475,Briones; Jor-el Thomas Caparas,0,0,36,36
1656856673330,MATH 20C,A01,083760,Briones; Jor-el Thomas Caparas,1,0,35,34
1656856673330,MATH 20C,A02,083761,Briones; Jor-el Thomas Caparas,8,0,35,27
1656856673330,MATH 20C,A03,093476,Briones; Jor-el Thomas Caparas,0,1,36,36
1656856673330,MATH 20C,B01,083762,Bach; Quang Tran,0,0,30,30
1656856679353,MATH 20D,A01,083765,Tran; Brian Kha,4,0,30,26
1656856679353,MATH 20D,A02,083766,Tran; Brian Kha,4,0,30,26
1656856679353,MATH 20D,A03,083767,Tran; Brian Kha,2,0,30,28
1656856685464,MATH 20E,A01,083771,Ganguly; Soumya,5,0,32,27
1656856685464,MATH 20E,A02,083772,Ganguly; Soumya,6,0,32,26
1656856685464,MATH 20E,B01,083773,Ciotti; Benjamin,18,0,35,17
1656856685464,MATH 20E,B02,083774,Ciotti; Benjamin,17,0,35,18
1656856691494,MATH 103A,A01,083777,Greenfeld; Be'Eri,2,0,36,34
1656856691494,MATH 103A,A02,083778,Greenfeld; Be'Eri,5,0,36,31
1656856691494,MATH 103A,A03,093561,Greenfeld; Be'Eri,4,0,36,32
1656856691494,MATH 103A,B01,083779,Greenfeld; Be'Eri,6,0,36,30
1656856691494,MATH 103A,B02,083780,Greenfeld; Be'Eri,2,0,36,34
1656856691494,MATH 103A,B03,093562,Greenfeld; Be'Eri,2,0,36,34
1656856697524,MATH 105,A01,085443,Carter; Anne Toulson,13,0,35,22
1656856697524,MATH 105,A02,093477,Carter; Anne Toulson,20,0,35,15
1656856703548,MATH 109,A01,083213,Ganzberger; Geoffrey Michael,2,0,34,32
1656856703548,MATH 109,A02,083214,Ganzberger; Geoffrey Michael,2,0,34,32
1656856703548,MATH 109,A03,093478,Ganzberger; Geoffrey Michael,1,0,34,33
1656856703548,MATH 109,B01,083215,Ganzberger; Geoffrey Michael,1,0,32,31
1656856703548,MATH 109,B02,083216,Ganzberger; Geoffrey Michael,1,0,32,31
1656856703548,MATH 109,B03,093479,Ganzberger; Geoffrey Michael,6,0,32,26
1656856709572,MATH 142A,A01,083219,Chow; Bennett,6,0,32,26
1656856709572,MATH 142A,A02,083220,Chow; Bennett,9,0,32,23
1656856709572,MATH 142A,A03,093480,Chow; Bennett,7,0,32,25
1656856709572,MATH 142A,B03,093481,Chow; Bennett,7,0,32,25
1656856709572,MATH 142A,B04,093558,Chow; Bennett,10,0,32,22
1656856709572,MATH 142A,B05,093559,Chow; Bennett,6,0,32,26
1656856715594,MATH 193A,A01,083224,Rotar; Vladimir,6,0,34,28
1656856715594,MATH 193A,A02,083225,Rotar; Vladimir,3,0,34,31
1656856715594,MATH 193A,A03,083781,Rotar; Vladimir,1,0,34,33
1656856715594,MATH 193A,A04,083782,Rotar; Vladimir,6,0,34,28
1656856715594,MATH 193A,A05,093482,Rotar; Vladimir,6,0,34,28
1656856721619,MATH 197,001,091859,McAuley; Julian John,9999,0,9999,0
1656856721619,MATH 197,002,095566,Kedlaya; Kiran S.,9997,0,9999,2
1656856721619,MATH 197,003,095567,Xiao; Ming,9999,0,9999,0
1656856721619,MATH 197,004,095571,Perols; Johan Lars,9998,0,9999,1
1656856728680,COGS 9,A01,083615,Shannon; Kyle Michael,6,0,75,69
1656856734708,COGS 11,A01,083617,Boyle; Mary E. T.,18,0,48,30
1656856740736,COGS 13,A01,083071,Bastos; Amalia Pinkusfeld,8,0,71,63
1656856746765,COGS 14A,A01,092681,Semenuks; Arturs,0,1,100,100
1656856752786,COGS 14B,A01,083073,Cheng; Tzu-Han,5,0,63,58
1656856758815,COGS 17,A01,092677,Semenuks; Arturs,4,0,81,77
1656856764838,COGS 100,A01,083619,Allen; Michael Gordon,15,0,70,55
1656856770863,COGS 101A,A01,083621,Davis; Joshua Daniel,9,0,68,59
1656856776887,COGS 101B,A01,091572,Allen; Michael Gordon,8,0,65,57
1656856782909,COGS 101C,A01,083625,Delgado; Tania,17,0,35,18
1656856788932,COGS 107A,A01,083627,Boyle; Mary E. T.,13,0,60,47
1656856794955,COGS 118A,A01,083075,Gupta; Anjum,15,0,76,61
1656856800985,CSE 3,A50,083646,Miranda; Gregory Joseph,22,0,50,28
1656856807008,CSE 8A,A50,083650,Miranda; Gregory Joseph,17,1,56,39
1656856813035,CSE 11,A01,083080,Cao; Yingjun,4,15,40,36
1656856819063,CSE 12,A01,083652,Krause-Levy; Sophia Louisa,20,1,120,100
1656856825089,CSE 15L,A01,083654,Morris; Justin Loren,8,0,50,42
1656856825089,CSE 15L,A02,083655,Morris; Justin Loren,8,0,50,42
1656856831118,CSE 20,A01,083657,Tran; Khoa Dang,37,0,80,43
1656856837142,CSE 21,A01,095574,Bach; Quang Tran,21,0,48,27
1656856843164,CSE 30,A01,083084,Eldon; John,4,0,80,76
1656856843164,CSE 30,B01,095061,Bhaskar; Nishant,6,0,50,44
1656856849189,CSE 100,A01,083659,Cao; Yingjun,2,4,70,68
1656856855218,CSE 134B,A01,083661,Powell; Thomas Allan,19,0,100,81
1656856861245,CSE 140,A01,083663,Gungor; Onat,14,0,85,71
1656856867272,CSE 140L,A01,083088,Eldon; John,16,0,100,84
1656856873301,CSE 175,A01,083665,Kumar; Rakesh,3,0,25,22
1656856879329,CSE 190,A00,092507,Dubnov; Shlomo,7,0,20,13
1656856885358,ECE 45,A01,083139,Congero; Spencer William,5,0,75,70
1656856891389,ECE 65,A50,083695,Saad; Andrew S,12,0,30,18
1656856891389,ECE 65,A51,095125,Saad; Andrew S,25,0,26,1
1656856897415,ECE 109,A01,091882,Touri; Behrouz,16,0,70,54
1656856903440,ECE 180,A00,083140,Abi Samra; Nicholas Camill,0,0,30,30
1656856903440,ECE 180,B00,083141,Abi Samra; Nicholas Camill,0,0,30,30
1656856909469,MATH 10A,A01,083735,Patchell; Gregory David,1,0,30,29
1656856909469,MATH 10A,A02,083736,Patchell; Gregory David,20,0,30,10
1656856909469,MATH 10A,A03,083737,Patchell; Gregory David,15,0,30,15
1656856915493,MATH 10B,A01,083207,Lim; Seonhee,7,0,34,27
1656856915493,MATH 10B,A02,083208,Lim; Seonhee,9,0,35,26
1656856915493,MATH 10B,A03,093472,Lim; Seonhee,4,0,34,30
1656856915493,MATH 10B,B01,083739,Sinha; Shubham,9,0,30,21
1656856921535,MATH 18,A01,083743,Cinel; Cameron Alexander,6,0,30,24
1656856921535,MATH 18,A02,083744,Cinel; Cameron Alexander,15,0,30,15
1656856921535,MATH 18,A03,083745,Cinel; Cameron Alexander,8,0,30,22
1656856921535,MATH 18,B01,083748,Rideout; David Porter,3,0,37,34
1656856921535,MATH 18,B02,083749,Rideout; David Porter,3,0,36,33
1656856921535,MATH 18,B03,083750,Rideout; David Porter,2,0,37,35
1656856921535,MATH 18,B04,083751,Rideout; David Porter,5,0,36,31
1656856921535,MATH 18,B05,093473,Rideout; David Porter,4,0,36,32
1656856921535,MATH 18,B06,093474,Rideout; David Porter,5,0,36,31
1656856927558,MATH 20A,A01,083754,Zheng; Zequn,12,0,40,28
1656856933584,MATH 20B,A01,083756,Briones; Jor-el Thomas Caparas,1,0,36,35
1656856933584,MATH 20B,A02,083757,Briones; Jor-el Thomas Caparas,1,0,36,35
1656856933584,MATH 20B,A03,093475,Briones; Jor-el Thomas Caparas,0,0,36,36
1656856939611,MATH 20C,A01,083760,Briones; Jor-el Thomas Caparas,1,0,35,34
1656856939611,MATH 20C,A02,083761,Briones; Jor-el Thomas Caparas,8,0,35,27
1656856939611,MATH 20C,A03,093476,Briones; Jor-el Thomas Caparas,0,1,36,36
1656856939611,MATH 20C,B01,083762,Bach; Quang Tran,0,0,30,30
1656856945639,MATH 20D,A01,083765,Tran; Brian Kha,4,0,30,26
1656856945639,MATH 20D,A02,083766,Tran; Brian Kha,4,0,30,26
1656856945639,MATH 20D,A03,083767,Tran; Brian Kha,2,0,30,28
1656856951670,MATH 20E,A01,083771,Ganguly; Soumya,5,0,32,27
1656856951670,MATH 20E,A02,083772,Ganguly; Soumya,6,0,32,26
1656856951670,MATH 20E,B01,083773,Ciotti; Benjamin,18,0,35,17
1656856951670,MATH 20E,B02,083774,Ciotti; Benjamin,17,0,35,18
1656856957693,MATH 103A,A01,083777,Greenfeld; Be'Eri,2,0,36,34
1656856957693,MATH 103A,A02,083778,Greenfeld; Be'Eri,5,0,36,31
1656856957693,MATH 103A,A03,093561,Greenfeld; Be'Eri,4,0,36,32
1656856957693,MATH 103A,B01,083779,Greenfeld; Be'Eri,6,0,36,30
1656856957693,MATH 103A,B02,083780,Greenfeld; Be'Eri,2,0,36,34
1656856957693,MATH 103A,B03,093562,Greenfeld; Be'Eri,2,0,36,34
1656856963727,MATH 105,A01,085443,Carter; Anne Toulson,13,0,35,22
1656856963727,MATH 105,A02,093477,Carter; Anne Toulson,20,0,35,15
1656856969754,MATH 109,A01,083213,Ganzberger; Geoffrey Michael,2,0,34,32
1656856969754,MATH 109,A02,083214,Ganzberger; Geoffrey Michael,2,0,34,32
1656856969754,MATH 109,A03,093478,Ganzberger; Geoffrey Michael,1,0,34,33
1656856969754,MATH 109,B01,083215,Ganzberger; Geoffrey Michael,1,0,32,31
1656856969754,MATH 109,B02,083216,Ganzberger; Geoffrey Michael,1,0,32,31
1656856969754,MATH 109,B03,093479,Ganzberger; Geoffrey Michael,6,0,32,26
1656856975777,MATH 142A,A01,083219,Chow; Bennett,6,0,32,26
1656856975777,MATH 142A,A02,083220,Chow; Bennett,9,0,32,23
1656856975777,MATH 142A,A03,093480,Chow; Bennett,7,0,32,25
1656856975777,MATH 142A,B03,093481,Chow; Bennett,7,0,32,25
1656856975777,MATH 142A,B04,093558,Chow; Bennett,10,0,32,22
1656856975777,MATH 142A,B05,093559,Chow; Bennett,6,0,32,26
1656856981807,MATH 193A,A01,083224,Rotar; Vladimir,6,0,34,28
1656856981807,MATH 193A,A02,083225,Rotar; Vladimir,3,0,34,31
1656856981807,MATH 193A,A03,083781,Rotar; Vladimir,1,0,34,33
1656856981807,MATH 193A,A04,083782,Rotar; Vladimir,6,0,34,28
1656856981807,MATH 193A,A05,093482,Rotar; Vladimir,6,0,34,28
1656856987831,MATH 197,001,091859,McAuley; Julian John,9999,0,9999,0
1656856987831,MATH 197,002,095566,Kedlaya; Kiran S.,9997,0,9999,2
1656856987831,MATH 197,003,095567,Xiao; Ming,9999,0,9999,0
1656856987831,MATH 197,004,095571,Perols; Johan Lars,9998,0,9999,1
1656856994893,COGS 9,A01,083615,Shannon; Kyle Michael,6,0,75,69
1656857000919,COGS 11,A01,083617,Boyle; Mary E. T.,18,0,48,30
1656857006955,COGS 13,A01,083071,Bastos; Amalia Pinkusfeld,8,0,71,63
1656857012976,COGS 14A,A01,092681,Semenuks; Arturs,0,1,100,100
1656857019001,COGS 14B,A01,083073,Cheng; Tzu-Han,5,0,63,58
1656857025034,COGS 17,A01,092677,Semenuks; Arturs,4,0,81,77
1656857031061,COGS 100,A01,083619,Allen; Michael Gordon,15,0,70,55
1656857037088,COGS 101A,A01,083621,Davis; Joshua Daniel,9,0,68,59
1656857043119,COGS 101B,A01,091572,Allen; Michael Gordon,8,0,65,57
1656857049145,COGS 101C,A01,083625,Delgado; Tania,17,0,35,18
1656857055172,COGS 107A,A01,083627,Boyle; Mary E. T.,13,0,60,47
1656857061194,COGS 118A,A01,083075,Gupta; Anjum,15,0,76,61
1656857067219,CSE 3,A50,083646,Miranda; Gregory Joseph,22,0,50,28
1656857073252,CSE 8A,A50,083650,Miranda; Gregory Joseph,17,1,56,39
1656857079278,CSE 11,A01,083080,Cao; Yingjun,4,15,40,36
1656857085308,CSE 12,A01,083652,Krause-Levy; Sophia Louisa,20,1,120,100
1656857091333,CSE 15L,A01,083654,Morris; Justin Loren,8,0,50,42
1656857091333,CSE 15L,A02,083655,Morris; Justin Loren,8,0,50,42
1656857097356,CSE 20,A01,083657,Tran; Khoa Dang,37,0,80,43
1656857103378,CSE 21,A01,095574,Bach; Quang Tran,21,0,48,27
1656857109402,CSE 30,A01,083084,Eldon; John,4,0,80,76
1656857109402,CSE 30,B01,095061,Bhaskar; Nishant,6,0,50,44
1656857115430,CSE 100,A01,083659,Cao; Yingjun,2,4,70,68
1656857121453,CSE 134B,A01,083661,Powell; Thomas Allan,19,0,100,81
1656857127480,CSE 140,A01,083663,Gungor; Onat,14,0,85,71
1656857133503,CSE 140L,A01,083088,Eldon; John,16,0,100,84
1656857139527,CSE 175,A01,083665,Kumar; Rakesh,3,0,25,22
1656857145553,CSE 190,A00,092507,Dubnov; Shlomo,7,0,20,13
1656857151576,ECE 45,A01,083139,Congero; Spencer William,5,0,75,70
1656857157600,ECE 65,A50,083695,Saad; Andrew S,12,0,30,18
1656857157600,ECE 65,A51,095125,Saad; Andrew S,25,0,26,1
1656857163627,ECE 109,A01,091882,Touri; Behrouz,16,0,70,54
1656857169650,ECE 180,A00,083140,Abi Samra; Nicholas Camill,0,0,30,30
1656857169650,ECE 180,B00,083141,Abi Samra; Nicholas Camill,0,0,30,30
1656857175679,MATH 10A,A01,083735,Patchell; Gregory David,1,0,30,29
1656857175679,MATH 10A,A02,083736,Patchell; Gregory David,20,0,30,10
1656857175679,MATH 10A,A03,083737,Patchell; Gregory David,15,0,30,15
1656857181704,MATH 10B,A01,083207,Lim; Seonhee,7,0,34,27
1656857181704,MATH 10B,A02,083208,Lim; Seonhee,9,0,35,26
1656857181704,MATH 10B,A03,093472,Lim; Seonhee,4,0,34,30
1656857181704,MATH 10B,B01,083739,Sinha; Shubham,9,0,30,21
1656857187736,MATH 18,A01,083743,Cinel; Cameron Alexander,6,0,30,24
1656857187736,MATH 18,A02,083744,Cinel; Cameron Alexander,15,0,30,15
1656857187736,MATH 18,A03,083745,Cinel; Cameron Alexander,8,0,30,22
1656857187736,MATH 18,B01,083748,Rideout; David Porter,3,0,37,34
1656857187736,MATH 18,B02,083749,Rideout; David Porter,3,0,36,33
1656857187736,MATH 18,B03,083750,Rideout; David Porter,2,0,37,35
1656857187736,MATH 18,B04,083751,Rideout; David Porter,5,0,36,31
1656857187736,MATH 18,B05,093473,Rideout; David Porter,4,0,36,32
1656857187736,MATH 18,B06,093474,Rideout; David Porter,5,0,36,31
1656857193760,MATH 20A,A01,083754,Zheng; Zequn,12,0,40,28
1656857199785,MATH 20B,A01,083756,Briones; Jor-el Thomas Caparas,1,0,36,35
1656857199785,MATH 20B,A02,083757,Briones; Jor-el Thomas Caparas,1,0,36,35
1656857199785,MATH 20B,A03,093475,Briones; Jor-el Thomas Caparas,0,0,36,36
1656857205817,MATH 20C,A01,083760,Briones; Jor-el Thomas Caparas,1,0,35,34
1656857205817,MATH 20C,A02,083761,Briones; Jor-el Thomas Caparas,8,0,35,27
1656857205817,MATH 20C,A03,093476,Briones; Jor-el Thomas Caparas,0,1,36,36
1656857205817,MATH 20C,B01,083762,Bach; Quang Tran,0,0,30,30
1656857211846,MATH 20D,A01,083765,Tran; Brian Kha,4,0,30,26
1656857211846,MATH 20D,A02,083766,Tran; Brian Kha,4,0,30,26
1656857211846,MATH 20D,A03,083767,Tran; Brian Kha,2,0,30,28
1656857217871,MATH 20E,A01,083771,Ganguly; Soumya,5,0,32,27
1656857217871,MATH 20E,A02,083772,Ganguly; Soumya,6,0,32,26
1656857217871,MATH 20E,B01,083773,Ciotti; Benjamin,18,0,35,17
1656857217871,MATH 20E,B02,083774,Ciotti; Benjamin,17,0,35,18
1656857223903,MATH 103A,A01,083777,Greenfeld; Be'Eri,2,0,36,34
1656857223903,MATH 103A,A02,083778,Greenfeld; Be'Eri,5,0,36,31
1656857223903,MATH 103A,A03,093561,Greenfeld; Be'Eri,4,0,36,32
1656857223903,MATH 103A,B01,083779,Greenfeld; Be'Eri,6,0,36,30
1656857223903,MATH 103A,B02,083780,Greenfeld; Be'Eri,2,0,36,34
1656857223903,MATH 103A,B03,093562,Greenfeld; Be'Eri,2,0,36,34
1656857229928,MATH 105,A01,085443,Carter; Anne Toulson,13,0,35,22
1656857229928,MATH 105,A02,093477,Carter; Anne Toulson,20,0,35,15
1656857235952,MATH 109,A01,083213,Ganzberger; Geoffrey Michael,2,0,34,32
1656857235952,MATH 109,A02,083214,Ganzberger; Geoffrey Michael,2,0,34,32
1656857235952,MATH 109,A03,093478,Ganzberger; Geoffrey Michael,1,0,34,33
1656857235952,MATH 109,B01,083215,Ganzberger; Geoffrey Michael,1,0,32,31
1656857235952,MATH 109,B02,083216,Ganzberger; Geoffrey Michael,1,0,32,31
1656857235952,MATH 109,B03,093479,Ganzberger; Geoffrey Michael,6,0,32,26
1656857241979,MATH 142A,A01,083219,Chow; Bennett,6,0,32,26
1656857241979,MATH 142A,A02,083220,Chow; Bennett,9,0,32,23
1656857241979,MATH 142A,A03,093480,Chow; Bennett,7,0,32,25
1656857241979,MATH 142A,B03,093481,Chow; Bennett,7,0,32,25
1656857241979,MATH 142A,B04,093558,Chow; Bennett,10,0,32,22
1656857241979,MATH 142A,B05,093559,Chow; Bennett,6,0,32,26
1656857248009,MATH 193A,A01,083224,Rotar; Vladimir,6,0,34,28
1656857248009,MATH 193A,A02,083225,Rotar; Vladimir,3,0,34,31
1656857248009,MATH 193A,A03,083781,Rotar; Vladimir,1,0,34,33
1656857248009,MATH 193A,A04,083782,Rotar; Vladimir,6,0,34,28
1656857248009,MATH 193A,A05,093482,Rotar; Vladimir,6,0,34,28
1656857254032,MATH 197,001,091859,McAuley; Julian John,9999,0,9999,0
1656857254032,MATH 197,002,095566,Kedlaya; Kiran S.,9997,0,9999,2
1656857254032,MATH 197,003,095567,Xiao; Ming,9999,0,9999,0
1656857254032,MATH 197,004,095571,Perols; Johan Lars,9998,0,9999,1
1656857261099,COGS 9,A01,083615,Shannon; Kyle Michael,6,0,75,69
1656857267127,COGS 11,A01,083617,Boyle; Mary E. T.,18,0,48,30
1656857273154,COGS 13,A01,083071,Bastos; Amalia Pinkusfeld,8,0,71,63
1656857279249,COGS 14A,A01,092681,Semenuks; Arturs,0,1,100,100
1656857285270,COGS 14B,A01,083073,Cheng; Tzu-Han,5,0,63,58
1656857291292,COGS 17,A01,092677,Semenuks; Arturs,4,0,81,77
1656857297315,COGS 100,A01,083619,Allen; Michael Gordon,15,0,70,55
1656857303372,COGS 101A,A01,083621,Davis; Joshua Daniel,9,0,68,59
1656857309395,COGS 101B,A01,091572,Allen; Michael Gordon,8,0,65,57
1656857315423,COGS 101C,A01,083625,Delgado; Tania,17,0,35,18
1656857321449,COGS 107A,A01,083627,Boyle; Mary E. T.,13,0,60,47
1656857327474,COGS 118A,A01,083075,Gupta; Anjum,15,0,76,61
1656857333498,CSE 3,A50,083646,Miranda; Gregory Joseph,22,0,50,28
1656857339520,CSE 8A,A50,083650,Miranda; Gregory Joseph,17,1,56,39
1656857345563,CSE 11,A01,083080,Cao; Yingjun,4,15,40,36
1656857351586,CSE 12,A01,083652,Krause-Levy; Sophia Louisa,20,1,120,100
1656857357608,CSE 15L,A01,083654,Morris; Justin Loren,8,0,50,42
1656857357608,CSE 15L,A02,083655,Morris; Justin Loren,8,0,50,42
1656857363640,CSE 20,A01,083657,Tran; Khoa Dang,37,0,80,43
1656857369664,CSE 21,A01,095574,Bach; Quang Tran,21,0,48,27
1656857375700,CSE 30,A01,083084,Eldon; John,4,0,80,76
1656857375700,CSE 30,B01,095061,Bhaskar; Nishant,6,0,50,44
1656857381726,CSE 100,A01,083659,Cao; Yingjun,2,4,70,68
1656857387755,CSE 134B,A01,083661,Powell; Thomas Allan,19,0,100,81
1656857393783,CSE 140,A01,083663,Gungor; Onat,14,0,85,71
1656857399805,CSE 140L,A01,083088,Eldon; John,16,0,100,84
1656857405827,CSE 175,A01,083665,Kumar; Rakesh,3,0,25,22
1656857411852,CSE 190,A00,092507,Dubnov; Shlomo,7,0,20,13
1656857417877,ECE 45,A01,083139,Congero; Spencer William,5,0,75,70
1656857423900,ECE 65,A50,083695,Saad; Andrew S,12,0,30,18
1656857423900,ECE 65,A51,095125,Saad; Andrew S,25,0,26,1
1656857429925,ECE 109,A01,091882,Touri; Behrouz,16,0,70,54
1656857435953,ECE 180,A00,083140,Abi Samra; Nicholas Camill,0,0,30,30
1656857435953,ECE 180,B00,083141,Abi Samra; Nicholas Camill,0,0,30,30
1656857441978,MATH 10A,A01,083735,Patchell; Gregory David,1,0,30,29
1656857441978,MATH 10A,A02,083736,Patchell; Gregory David,20,0,30,10
1656857441978,MATH 10A,A03,083737,Patchell; Gregory David,15,0,30,15
1656857448002,MATH 10B,A01,083207,Lim; Seonhee,7,0,34,27
1656857448002,MATH 10B,A02,083208,Lim; Seonhee,9,0,35,26
1656857448002,MATH 10B,A03,093472,Lim; Seonhee,4,0,34,30
1656857448002,MATH 10B,B01,083739,Sinha; Shubham,9,0,30,21
1656857454036,MATH 18,A01,083743,Cinel; Cameron Alexander,6,0,30,24
1656857454036,MATH 18,A02,083744,Cinel; Cameron Alexander,15,0,30,15
1656857454036,MATH 18,A03,083745,Cinel; Cameron Alexander,8,0,30,22
1656857454036,MATH 18,B01,083748,Rideout; David Porter,3,0,37,34
1656857454036,MATH 18,B02,083749,Rideout; David Porter,3,0,36,33
1656857454036,MATH 18,B03,083750,Rideout; David Porter,2,0,37,35
1656857454036,MATH 18,B04,083751,Rideout; David Porter,5,0,36,31
1656857454036,MATH 18,B05,093473,Rideout; David Porter,4,0,36,32
1656857454036,MATH 18,B06,093474,Rideout; David Porter,5,0,36,31
1656857460060,MATH 20A,A01,083754,Zheng; Zequn,12,0,40,28
1656857466089,MATH 20B,A01,083756,Briones; Jor-el Thomas Caparas,1,0,36,35
1656857466089,MATH 20B,A02,083757,Briones; Jor-el Thomas Caparas,1,0,36,35
1656857466089,MATH 20B,A03,093475,Briones; Jor-el Thomas Caparas,0,0,36,36
1656857472113,MATH 20C,A01,083760,Briones; Jor-el Thomas Caparas,1,0,35,34
1656857472113,MATH 20C,A02,083761,Briones; Jor-el Thomas Caparas,8,0,35,27
1656857472113,MATH 20C,A03,093476,Briones; Jor-el Thomas Caparas,0,1,36,36
1656857472113,MATH 20C,B01,083762,Bach; Quang Tran,0,0,30,30
1656857478141,MATH 20D,A01,083765,Tran; Brian Kha,4,0,30,26
1656857478141,MATH 20D,A02,083766,Tran; Brian Kha,4,0,30,26
1656857478141,MATH 20D,A03,083767,Tran; Brian Kha,2,0,30,28
1656857484165,MATH 20E,A01,083771,Ganguly; Soumya,5,0,32,27
1656857484165,MATH 20E,A02,083772,Ganguly; Soumya,6,0,32,26
1656857484165,MATH 20E,B01,083773,Ciotti; Benjamin,18,0,35,17
1656857484165,MATH 20E,B02,083774,Ciotti; Benjamin,17,0,35,18
1656857490189,MATH 103A,A01,083777,Greenfeld; Be'Eri,2,0,36,34
1656857490189,MATH 103A,A02,083778,Greenfeld; Be'Eri,5,0,36,31
1656857490189,MATH 103A,A03,093561,Greenfeld; Be'Eri,4,0,36,32
1656857490189,MATH 103A,B01,083779,Greenfeld; Be'Eri,6,0,36,30
1656857490189,MATH 103A,B02,083780,Greenfeld; Be'Eri,2,0,36,34
1656857490189,MATH 103A,B03,093562,Greenfeld; Be'Eri,2,0,36,34
1656857496218,MATH 105,A01,085443,Carter; Anne Toulson,13,0,35,22
1656857496218,MATH 105,A02,093477,Carter; Anne Toulson,20,0,35,15
1656857502243,MATH 109,A01,083213,Ganzberger; Geoffrey Michael,2,0,34,32
1656857502243,MATH 109,A02,083214,Ganzberger; Geoffrey Michael,2,0,34,32
1656857502243,MATH 109,A03,093478,Ganzberger; Geoffrey Michael,1,0,34,33
1656857502243,MATH 109,B01,083215,Ganzberger; Geoffrey Michael,1,0,32,31
1656857502243,MATH 109,B02,083216,Ganzberger; Geoffrey Michael,1,0,32,31
1656857502243,MATH 109,B03,093479,Ganzberger; Geoffrey Michael,6,0,32,26
1656857508267,MATH 142A,A01,083219,Chow; Bennett,6,0,32,26
1656857508267,MATH 142A,A02,083220,Chow; Bennett,9,0,32,23
1656857508267,MATH 142A,A03,093480,Chow; Bennett,7,0,32,25
1656857508267,MATH 142A,B03,093481,Chow; Bennett,7,0,32,25
1656857508267,MATH 142A,B04,093558,Chow; Bennett,10,0,32,22
1656857508267,MATH 142A,B05,093559,Chow; Bennett,6,0,32,26
1656857514304,MATH 193A,A01,083224,Rotar; Vladimir,6,0,34,28
1656857514304,MATH 193A,A02,083225,Rotar; Vladimir,3,0,34,31
1656857514304,MATH 193A,A03,083781,Rotar; Vladimir,1,0,34,33
1656857514304,MATH 193A,A04,083782,Rotar; Vladimir,6,0,34,28
1656857514304,MATH 193A,A05,093482,Rotar; Vladimir,6,0,34,28
1656857520328,MATH 197,001,091859,McAuley; Julian John,9999,0,9999,0
1656857520328,MATH 197,002,095566,Kedlaya; Kiran S.,9997,0,9999,2
1656857520328,MATH 197,003,095567,Xiao; Ming,9999,0,9999,0
1656857520328,MATH 197,004,095571,Perols; Johan Lars,9998,0,9999,1
1656857527379,COGS 9,A01,083615,Shannon; Kyle Michael,6,0,75,69
1656857533405,COGS 11,A01,083617,Boyle; Mary E. T.,18,0,48,30
1656857539433,COGS 13,A01,083071,Bastos; Amalia Pinkusfeld,8,0,71,63
1656857545460,COGS 14A,A01,092681,Semenuks; Arturs,0,1,100,100
1656857551484,COGS 14B,A01,083073,Cheng; Tzu-Han,5,0,63,58
1656857557512,COGS 17,A01,092677,Semenuks; Arturs,4,0,81,77
1656857563536,COGS 100,A01,083619,Allen; Michael Gordon,15,0,70,55
1656857569563,COGS 101A,A01,083621,Davis; Joshua Daniel,9,0,68,59
1656857575588,COGS 101B,A01,091572,Allen; Michael Gordon,8,0,65,57
1656857581615,COGS 101C,A01,083625,Delgado; Tania,17,0,35,18
1656857587644,COGS 107A,A01,083627,Boyle; Mary E. T.,13,0,60,47
1656857593669,COGS 118A,A01,083075,Gupta; Anjum,15,0,76,61
1656857599693,CSE 3,A50,083646,Miranda; Gregory Joseph,22,0,50,28
1656857605721,CSE 8A,A50,083650,Miranda; Gregory Joseph,17,1,56,39
1656857611746,CSE 11,A01,083080,Cao; Yingjun,4,15,40,36
1656857617768,CSE 12,A01,083652,Krause-Levy; Sophia Louisa,20,1,120,100
1656857623792,CSE 15L,A01,083654,Morris; Justin Loren,8,0,50,42
1656857623792,CSE 15L,A02,083655,Morris; Justin Loren,8,0,50,42
1656857629820,CSE 20,A01,083657,Tran; Khoa Dang,37,0,80,43
1656857635847,CSE 21,A01,095574,Bach; Quang Tran,21,0,48,27
1656857641874,CSE 30,A01,083084,Eldon; John,4,0,80,76
1656857641874,CSE 30,B01,095061,Bhaskar; Nishant,6,0,50,44
1656857647898,CSE 100,A01,083659,Cao; Yingjun,2,4,70,68
1656857653920,CSE 134B,A01,083661,Powell; Thomas Allan,19,0,100,81
1656857659943,CSE 140,A01,083663,Gungor; Onat,14,0,85,71
1656857665971,CSE 140L,A01,083088,Eldon; John,16,0,100,84
1656857672008,CSE 175,A01,083665,Kumar; Rakesh,3,0,25,22
1656857678032,CSE 190,A00,092507,Dubnov; Shlomo,7,0,20,13
1656857684059,ECE 45,A01,083139,Congero; Spencer William,5,0,75,70
1656857690083,ECE 65,A50,083695,Saad; Andrew S,12,0,30,18
1656857690083,ECE 65,A51,095125,Saad; Andrew S,25,0,26,1
1656857696108,ECE 109,A01,091882,Touri; Behrouz,16,0,70,54
1656857702132,ECE 180,A00,083140,Abi Samra; Nicholas Camill,0,0,30,30
1656857702132,ECE 180,B00,083141,Abi Samra; Nicholas Camill,0,0,30,30
1656857708168,MATH 10A,A01,083735,Patchell; Gregory David,1,0,30,29
1656857708168,MATH 10A,A02,083736,Patchell; Gregory David,20,0,30,10
1656857708168,MATH 10A,A03,083737,Patchell; Gregory David,15,0,30,15
1656857714201,MATH 10B,A01,083207,Lim; Seonhee,7,0,34,27
1656857714201,MATH 10B,A02,083208,Lim; Seonhee,9,0,35,26
1656857714201,MATH 10B,A03,093472,Lim; Seonhee,4,0,34,30
1656857714201,MATH 10B,B01,083739,Sinha; Shubham,9,0,30,21
1656857720226,MATH 18,A01,083743,Cinel; Cameron Alexander,6,0,30,24
1656857720226,MATH 18,A02,083744,Cinel; Cameron Alexander,15,0,30,15
1656857720226,MATH 18,A03,083745,Cinel; Cameron Alexander,8,0,30,22
1656857720226,MATH 18,B01,083748,Rideout; David Porter,3,0,37,34
1656857720226,MATH 18,B02,083749,Rideout; David Porter,3,0,36,33
1656857720226,MATH 18,B03,083750,Rideout; David Porter,2,0,37,35
1656857720226,MATH 18,B04,083751,Rideout; David Porter,5,0,36,31
1656857720226,MATH 18,B05,093473,Rideout; David Porter,4,0,36,32
1656857720226,MATH 18,B06,093474,Rideout; David Porter,5,0,36,31
1656857726253,MATH 20A,A01,083754,Zheng; Zequn,12,0,40,28
1656857732278,MATH 20B,A01,083756,Briones; Jor-el Thomas Caparas,1,0,36,35
1656857732278,MATH 20B,A02,083757,Briones; Jor-el Thomas Caparas,1,0,36,35
1656857732278,MATH 20B,A03,093475,Briones; Jor-el Thomas Caparas,0,0,36,36
1656857738302,MATH 20C,A01,083760,Briones; Jor-el Thomas Caparas,1,0,35,34
1656857738302,MATH 20C,A02,083761,Briones; Jor-el Thomas Caparas,8,0,35,27
1656857738302,MATH 20C,A03,093476,Briones; Jor-el Thomas Caparas,0,1,36,36
1656857738302,MATH 20C,B01,083762,Bach; Quang Tran,0,0,30,30
1656857744325,MATH 20D,A01,083765,Tran; Brian Kha,4,0,30,26
1656857744325,MATH 20D,A02,083766,Tran; Brian Kha,4,0,30,26
1656857744325,MATH 20D,A03,083767,Tran; Brian Kha,2,0,30,28
1656857750347,MATH 20E,A01,083771,Ganguly; Soumya,5,0,32,27
1656857750347,MATH 20E,A02,083772,Ganguly; Soumya,6,0,32,26
1656857750347,MATH 20E,B01,083773,Ciotti; Benjamin,18,0,35,17
1656857750347,MATH 20E,B02,083774,Ciotti; Benjamin,17,0,35,18
1656857756378,MATH 103A,A01,083777,Greenfeld; Be'Eri,2,0,36,34
1656857756378,MATH 103A,A02,083778,Greenfeld; Be'Eri,5,0,36,31
1656857756378,MATH 103A,A03,093561,Greenfeld; Be'Eri,4,0,36,32
1656857756378,MATH 103A,B01,083779,Greenfeld; Be'Eri,6,0,36,30
1656857756378,MATH 103A,B02,083780,Greenfeld; Be'Eri,2,0,36,34
1656857756378,MATH 103A,B03,093562,Greenfeld; Be'Eri,2,0,36,34
1656857762401,MATH 105,A01,085443,Carter; Anne Toulson,13,0,35,22
1656857762401,MATH 105,A02,093477,Carter; Anne Toulson,20,0,35,15
1656857768425,MATH 109,A01,083213,Ganzberger; Geoffrey Michael,2,0,34,32
1656857768425,MATH 109,A02,083214,Ganzberger; Geoffrey Michael,2,0,34,32
1656857768425,MATH 109,A03,093478,Ganzberger; Geoffrey Michael,1,0,34,33
1656857768425,MATH 109,B01,083215,Ganzberger; Geoffrey Michael,1,0,32,31
1656857768425,MATH 109,B02,083216,Ganzberger; Geoffrey Michael,1,0,32,31
1656857768425,MATH 109,B03,093479,Ganzberger; Geoffrey Michael,6,0,32,26
1656857774455,MATH 142A,A01,083219,Chow; Bennett,6,0,32,26
1656857774455,MATH 142A,A02,083220,Chow; Bennett,9,0,32,23
1656857774455,MATH 142A,A03,093480,Chow; Bennett,7,0,32,25
1656857774455,MATH 142A,B03,093481,Chow; Bennett,7,0,32,25
1656857774455,MATH 142A,B04,093558,Chow; Bennett,10,0,32,22
1656857774455,MATH 142A,B05,093559,Chow; Bennett,6,0,32,26
1656857780491,MATH 193A,A01,083224,Rotar; Vladimir,6,0,34,28
1656857780491,MATH 193A,A02,083225,Rotar; Vladimir,3,0,34,31
1656857780491,MATH 193A,A03,083781,Rotar; Vladimir,1,0,34,33
1656857780491,MATH 193A,A04,083782,Rotar; Vladimir,6,0,34,28
1656857780491,MATH 193A,A05,093482,Rotar; Vladimir,6,0,34,28
1656857786515,MATH 197,001,091859,McAuley; Julian John,9999,0,9999,0
1656857786515,MATH 197,002,095566,Kedlaya; Kiran S.,9997,0,9999,2
1656857786515,MATH 197,003,095567,Xiao; Ming,9999,0,9999,0
1656857786515,MATH 197,004,095571,Perols; Johan Lars,9998,0,9999,1
1656857793569,COGS 9,A01,083615,Shannon; Kyle Michael,6,0,75,69
1656857799594,COGS 11,A01,083617,Boyle; Mary E. T.,18,0,48,30
1656857805621,COGS 13,A01,083071,Bastos; Amalia Pinkusfeld,8,0,71,63
1656857811648,COGS 14A,A01,092681,Semenuks; Arturs,0,1,100,100
1656857817673,COGS 14B,A01,083073,Cheng; Tzu-Han,5,0,63,58
1656857823701,COGS 17,A01,092677,Semenuks; Arturs,4,0,81,77
1656857829729,COGS 100,A01,083619,Allen; Michael Gordon,15,0,70,55
1656857835756,COGS 101A,A01,083621,Davis; Joshua Daniel,9,0,68,59
1656857841780,COGS 101B,A01,091572,Allen; Michael Gordon,8,0,65,57
1656857847804,COGS 101C,A01,083625,Delgado; Tania,17,0,35,18
1656857853832,COGS 107A,A01,083627,Boyle; Mary E. T.,13,0,60,47
1656857859860,COGS 118A,A01,083075,Gupta; Anjum,15,0,76,61
1656857865883,CSE 3,A50,083646,Miranda; Gregory Joseph,22,0,50,28
1656857871910,CSE 8A,A50,083650,Miranda; Gregory Joseph,17,1,56,39
1656857878011,CSE 11,A01,083080,Cao; Yingjun,4,15,40,36
1656857884038,CSE 12,A01,083652,Krause-Levy; Sophia Louisa,20,1,120,100
1656857890068,CSE 15L,A01,083654,Morris; Justin Loren,8,0,50,42
1656857890068,CSE 15L,A02,083655,Morris; Justin Loren,8,0,50,42
1656857896107,CSE 20,A01,083657,Tran; Khoa Dang,37,0,80,43
1656857902132,CSE 21,A01,095574,Bach; Quang Tran,21,0,48,27
1656857908156,CSE 30,A01,083084,Eldon; John,4,0,80,76
1656857908156,CSE 30,B01,095061,Bhaskar; Nishant,6,0,50,44
1656857914179,CSE 100,A01,083659,Cao; Yingjun,2,4,70,68
1656857920207,CSE 134B,A01,083661,Powell; Thomas Allan,19,0,100,81
1656857926233,CSE 140,A01,083663,Gungor; Onat,14,0,85,71
1656857932260,CSE 140L,A01,083088,Eldon; John,16,0,100,84
1656857938286,CSE 175,A01,083665,Kumar; Rakesh,3,0,25,22
1656857944316,CSE 190,A00,092507,Dubnov; Shlomo,7,0,20,13
1656857950344,ECE 45,A01,083139,Congero; Spencer William,5,0,75,70
1656857956367,ECE 65,A50,083695,Saad; Andrew S,12,0,30,18
1656857956367,ECE 65,A51,095125,Saad; Andrew S,25,0,26,1
1656857962389,ECE 109,A01,091882,Touri; Behrouz,16,0,70,54
1656857968416,ECE 180,A00,083140,Abi Samra; Nicholas Camill,0,0,30,30
1656857968416,ECE 180,B00,083141,Abi Samra; Nicholas Camill,0,0,30,30
1656857974443,MATH 10A,A01,083735,Patchell; Gregory David,1,0,30,29
1656857974443,MATH 10A,A02,083736,Patchell; Gregory David,20,0,30,10
1656857974443,MATH 10A,A03,083737,Patchell; Gregory David,15,0,30,15
1656857980467,MATH 10B,A01,083207,Lim; Seonhee,7,0,34,27
1656857980467,MATH 10B,A02,083208,Lim; Seonhee,9,0,35,26
1656857980467,MATH 10B,A03,093472,Lim; Seonhee,4,0,34,30
1656857980467,MATH 10B,B01,083739,Sinha; Shubham,9,0,30,21
1656857986500,MATH 18,A01,083743,Cinel; Cameron Alexander,6,0,30,24
1656857986500,MATH 18,A02,083744,Cinel; Cameron Alexander,15,0,30,15
1656857986500,MATH 18,A03,083745,Cinel; Cameron Alexander,8,0,30,22
1656857986500,MATH 18,B01,083748,Rideout; David Porter,3,0,37,34
1656857986500,MATH 18,B02,083749,Rideout; David Porter,3,0,36,33
1656857986500,MATH 18,B03,083750,Rideout; David Porter,2,0,37,35
1656857986500,MATH 18,B04,083751,Rideout; David Porter,5,0,36,31
1656857986500,MATH 18,B05,093473,Rideout; David Porter,4,0,36,32
1656857986500,MATH 18,B06,093474,Rideout; David Porter,5,0,36,31
1656857992530,MATH 20A,A01,083754,Zheng; Zequn,12,0,40,28
1656857998562,MATH 20B,A01,083756,Briones; Jor-el Thomas Caparas,1,0,36,35
1656857998562,MATH 20B,A02,083757,Briones; Jor-el Thomas Caparas,1,0,36,35
1656857998562,MATH 20B,A03,093475,Briones; Jor-el Thomas Caparas,0,0,36,36
1656858004584,MATH 20C,A01,083760,Briones; Jor-el Thomas Caparas,1,0,35,34
1656858004584,MATH 20C,A02,083761,Briones; Jor-el Thomas Caparas,8,0,35,27
1656858004584,MATH 20C,A03,093476,Briones; Jor-el Thomas Caparas,0,1,36,36
1656858004584,MATH 20C,B01,083762,Bach; Quang Tran,0,0,30,30
1656858010609,MATH 20D,A01,083765,Tran; Brian Kha,4,0,30,26
1656858010609,MATH 20D,A02,083766,Tran; Brian Kha,4,0,30,26
1656858010609,MATH 20D,A03,083767,Tran; Brian Kha,2,0,30,28
1656858016637,MATH 20E,A01,083771,Ganguly; Soumya,5,0,32,27
1656858016637,MATH 20E,A02,083772,Ganguly; Soumya,6,0,32,26
1656858016637,MATH 20E,B01,083773,Ciotti; Benjamin,18,0,35,17
1656858016637,MATH 20E,B02,083774,Ciotti; Benjamin,17,0,35,18
1656858022661,MATH 103A,A01,083777,Greenfeld; Be'Eri,2,0,36,34
1656858022661,MATH 103A,A02,083778,Greenfeld; Be'Eri,5,0,36,31
1656858022661,MATH 103A,A03,093561,Greenfeld; Be'Eri,4,0,36,32
1656858022661,MATH 103A,B01,083779,Greenfeld; Be'Eri,6,0,36,30
1656858022661,MATH 103A,B02,083780,Greenfeld; Be'Eri,2,0,36,34
1656858022661,MATH 103A,B03,093562,Greenfeld; Be'Eri,2,0,36,34
1656858028684,MATH 105,A01,085443,Carter; Anne Toulson,13,0,35,22
1656858028684,MATH 105,A02,093477,Carter; Anne Toulson,20,0,35,15
1656858034713,MATH 109,A01,083213,Ganzberger; Geoffrey Michael,2,0,34,32
1656858034713,MATH 109,A02,083214,Ganzberger; Geoffrey Michael,2,0,34,32
1656858034713,MATH 109,A03,093478,Ganzberger; Geoffrey Michael,1,0,34,33
1656858034713,MATH 109,B01,083215,Ganzberger; Geoffrey Michael,1,0,32,31
1656858034713,MATH 109,B02,083216,Ganzberger; Geoffrey Michael,1,0,32,31
1656858034713,MATH 109,B03,093479,Ganzberger; Geoffrey Michael,6,0,32,26
1656858040743,MATH 142A,A01,083219,Chow; Bennett,6,0,32,26
1656858040743,MATH 142A,A02,083220,Chow; Bennett,9,0,32,23
1656858040743,MATH 142A,A03,093480,Chow; Bennett,7,0,32,25
1656858040743,MATH 142A,B03,093481,Chow; Bennett,7,0,32,25
1656858040743,MATH 142A,B04,093558,Chow; Bennett,10,0,32,22
1656858040743,MATH 142A,B05,093559,Chow; Bennett,6,0,32,26
1656858046770,MATH 193A,A01,083224,Rotar; Vladimir,6,0,34,28
1656858046770,MATH 193A,A02,083225,Rotar; Vladimir,3,0,34,31
1656858046770,MATH 193A,A03,083781,Rotar; Vladimir,1,0,34,33
1656858046770,MATH 193A,A04,083782,Rotar; Vladimir,6,0,34,28
1656858046770,MATH 193A,A05,093482,Rotar; Vladimir,6,0,34,28
1656858052800,MATH 197,001,091859,McAuley; Julian John,9999,0,9999,0
1656858052800,MATH 197,002,095566,Kedlaya; Kiran S.,9997,0,9999,2
1656858052800,MATH 197,003,095567,Xiao; Ming,9999,0,9999,0
1656858052800,MATH 197,004,095571,Perols; Johan Lars,9998,0,9999,1
1656858059870,COGS 9,A01,083615,Shannon; Kyle Michael,6,0,75,69
1656858065902,COGS 11,A01,083617,Boyle; Mary E. T.,18,0,48,30
1656858071928,COGS 13,A01,083071,Bastos; Amalia Pinkusfeld,8,0,71,63
1656858077958,COGS 14A,A01,092681,Semenuks; Arturs,0,1,100,100
1656858083982,COGS 14B,A01,083073,Cheng; Tzu-Han,5,0,63,58
1656858090009,COGS 17,A01,092677,Semenuks; Arturs,4,0,81,77
1656858096036,COGS 100,A01,083619,Allen; Michael Gordon,15,0,70,55
1656858102060,COGS 101A,A01,083621,Davis; Joshua Daniel,9,0,68,59
1656858108087,COGS 101B,A01,091572,Allen; Michael Gordon,8,0,65,57
1656858114116,COGS 101C,A01,083625,Delgado; Tania,17,0,35,18
1656858120139,COGS 107A,A01,083627,Boyle; Mary E. T.,13,0,60,47
1656858126165,COGS 118A,A01,083075,Gupta; Anjum,15,0,76,61
1656858132189,CSE 3,A50,083646,Miranda; Gregory Joseph,22,0,50,28
1656858138213,CSE 8A,A50,083650,Miranda; Gregory Joseph,17,1,56,39
1656858144240,CSE 11,A01,083080,Cao; Yingjun,4,15,40,36
1656858150268,CSE 12,A01,083652,Krause-Levy; Sophia Louisa,20,1,120,100
1656858156291,CSE 15L,A01,083654,Morris; Justin Loren,8,0,50,42
1656858156291,CSE 15L,A02,083655,Morris; Justin Loren,8,0,50,42
1656858162318,CSE 20,A01,083657,Tran; Khoa Dang,37,0,80,43
1656858168342,CSE 21,A01,095574,Bach; Quang Tran,21,0,48,27
1656858174365,CSE 30,A01,083084,Eldon; John,4,0,80,76
1656858174365,CSE 30,B01,095061,Bhaskar; Nishant,6,0,50,44
1656858180391,CSE 100,A01,083659,Cao; Yingjun,2,4,70,68
1656858186420,CSE 134B,A01,083661,Powell; Thomas Allan,19,0,100,81
1656858192444,CSE 140,A01,083663,Gungor; Onat,14,0,85,71
1656858198467,CSE 140L,A01,083088,Eldon; John,16,0,100,84
1656858204493,CSE 175,A01,083665,Kumar; Rakesh,3,0,25,22
1656858210519,CSE 190,A00,092507,Dubnov; Shlomo,7,0,20,13
1656858216547,ECE 45,A01,083139,Congero; Spencer William,5,0,75,70
1656858222575,ECE 65,A50,083695,Saad; Andrew S,12,0,30,18
1656858222575,ECE 65,A51,095125,Saad; Andrew S,25,0,26,1
1656858228600,ECE 109,A01,091882,Touri; Behrouz,16,0,70,54
1656858234627,ECE 180,A00,083140,Abi Samra; Nicholas Camill,0,0,30,30
1656858234627,ECE 180,B00,083141,Abi Samra; Nicholas Camill,0,0,30,30
1656858240657,MATH 10A,A01,083735,Patchell; Gregory David,1,0,30,29
1656858240657,MATH 10A,A02,083736,Patchell; Gregory David,20,0,30,10
1656858240657,MATH 10A,A03,083737,Patchell; Gregory David,15,0,30,15
1656858246694,MATH 10B,A01,083207,Lim; Seonhee,7,0,34,27
1656858246694,MATH 10B,A02,083208,Lim; Seonhee,9,0,35,26
1656858246694,MATH 10B,A03,093472,Lim; Seonhee,4,0,34,30
1656858246694,MATH 10B,B01,083739,Sinha; Shubham,9,0,30,21
1656858252718,MATH 18,A01,083743,Cinel; Cameron Alexander,6,0,30,24
1656858252718,MATH 18,A02,083744,Cinel; Cameron Alexander,15,0,30,15
1656858252718,MATH 18,A03,083745,Cinel; Cameron Alexander,8,0,30,22
1656858252718,MATH 18,B01,083748,Rideout; David Porter,3,0,37,34
1656858252718,MATH 18,B02,083749,Rideout; David Porter,3,0,36,33
1656858252718,MATH 18,B03,083750,Rideout; David Porter,2,0,37,35
1656858252718,MATH 18,B04,083751,Rideout; David Porter,5,0,36,31
1656858252718,MATH 18,B05,093473,Rideout; David Porter,4,0,36,32
1656858252718,MATH 18,B06,093474,Rideout; David Porter,5,0,36,31
1656858258744,MATH 20A,A01,083754,Zheng; Zequn,12,0,40,28
1656858264774,MATH 20B,A01,083756,Briones; Jor-el Thomas Caparas,1,0,36,35
1656858264774,MATH 20B,A02,083757,Briones; Jor-el Thomas Caparas,1,0,36,35
1656858264774,MATH 20B,A03,093475,Briones; Jor-el Thomas Caparas,0,0,36,36
1656858270808,MATH 20C,A01,083760,Briones; Jor-el Thomas Caparas,1,0,35,34
1656858270808,MATH 20C,A02,083761,Briones; Jor-el Thomas Caparas,8,0,35,27
1656858270808,MATH 20C,A03,093476,Briones; Jor-el Thomas Caparas,0,1,36,36
1656858270808,MATH 20C,B01,083762,Bach; Quang Tran,0,0,30,30
1656858276833,MATH 20D,A01,083765,Tran; Brian Kha,4,0,30,26
1656858276833,MATH 20D,A02,083766,Tran; Brian Kha,4,0,30,26
1656858276833,MATH 20D,A03,083767,Tran; Brian Kha,2,0,30,28
1656858282857,MATH 20E,A01,083771,Ganguly; Soumya,5,0,32,27
1656858282857,MATH 20E,A02,083772,Ganguly; Soumya,6,0,32,26
1656858282857,MATH 20E,B01,083773,Ciotti; Benjamin,18,0,35,17
1656858282857,MATH 20E,B02,083774,Ciotti; Benjamin,17,0,35,18
1656858288887,MATH 103A,A01,083777,Greenfeld; Be'Eri,2,0,36,34
1656858288887,MATH 103A,A02,083778,Greenfeld; Be'Eri,5,0,36,31
1656858288887,MATH 103A,A03,093561,Greenfeld; Be'Eri,4,0,36,32
1656858288887,MATH 103A,B01,083779,Greenfeld; Be'Eri,6,0,36,30
1656858288887,MATH 103A,B02,083780,Greenfeld; Be'Eri,2,0,36,34
1656858288887,MATH 103A,B03,093562,Greenfeld; Be'Eri,2,0,36,34
1656858294911,MATH 105,A01,085443,Carter; Anne Toulson,13,0,35,22
1656858294911,MATH 105,A02,093477,Carter; Anne Toulson,20,0,35,15
1656858300938,MATH 109,A01,083213,Ganzberger; Geoffrey Michael,2,0,34,32
1656858300938,MATH 109,A02,083214,Ganzberger; Geoffrey Michael,2,0,34,32
1656858300938,MATH 109,A03,093478,Ganzberger; Geoffrey Michael,1,0,34,33
1656858300938,MATH 109,B01,083215,Ganzberger; Geoffrey Michael,1,0,32,31
1656858300938,MATH 109,B02,083216,Ganzberger; Geoffrey Michael,1,0,32,31
1656858300938,MATH 109,B03,093479,Ganzberger; Geoffrey Michael,6,0,32,26
1656858306962,MATH 142A,A01,083219,Chow; Bennett,6,0,32,26
1656858306962,MATH 142A,A02,083220,Chow; Bennett,9,0,32,23
1656858306962,MATH 142A,A03,093480,Chow; Bennett,7,0,32,25
1656858306962,MATH 142A,B03,093481,Chow; Bennett,7,0,32,25
1656858306962,MATH 142A,B04,093558,Chow; Bennett,10,0,32,22
1656858306962,MATH 142A,B05,093559,Chow; Bennett,6,0,32,26
1656858312986,MATH 193A,A01,083224,Rotar; Vladimir,6,0,34,28
1656858312986,MATH 193A,A02,083225,Rotar; Vladimir,3,0,34,31
1656858312986,MATH 193A,A03,083781,Rotar; Vladimir,1,0,34,33
1656858312986,MATH 193A,A04,083782,Rotar; Vladimir,6,0,34,28
1656858312986,MATH 193A,A05,093482,Rotar; Vladimir,6,0,34,28
1656858319020,MATH 197,001,091859,McAuley; Julian John,9999,0,9999,0
1656858319020,MATH 197,002,095566,Kedlaya; Kiran S.,9997,0,9999,2
1656858319020,MATH 197,003,095567,Xiao; Ming,9999,0,9999,0
1656858319020,MATH 197,004,095571,Perols; Johan Lars,9998,0,9999,1
1656858326073,COGS 9,A01,083615,Shannon; Kyle Michael,6,0,75,69
1656858332097,COGS 11,A01,083617,Boyle; Mary E. T.,18,0,48,30
1656858338122,COGS 13,A01,083071,Bastos; Amalia Pinkusfeld,8,0,71,63
1656858344148,COGS 14A,A01,092681,Semenuks; Arturs,0,1,100,100
1656858350171,COGS 14B,A01,083073,Cheng; Tzu-Han,5,0,63,58
1656858356198,COGS 17,A01,092677,Semenuks; Arturs,4,0,81,77
1656858362221,COGS 100,A01,083619,Allen; Michael Gordon,15,0,70,55
1656858368244,COGS 101A,A01,083621,Davis; Joshua Daniel,9,0,68,59
1656858374271,COGS 101B,A01,091572,Allen; Michael Gordon,8,0,65,57
1656858380296,COGS 101C,A01,083625,Delgado; Tania,17,0,35,18
1656858386323,COGS 107A,A01,083627,Boyle; Mary E. T.,13,0,60,47
1656858392345,COGS 118A,A01,083075,Gupta; Anjum,15,0,76,61
1656858398373,CSE 3,A50,083646,Miranda; Gregory Joseph,22,0,50,28
1656858404397,CSE 8A,A50,083650,Miranda; Gregory Joseph,17,1,56,39
1656858410420,CSE 11,A01,083080,Cao; Yingjun,4,15,40,36
1656858416452,CSE 12,A01,083652,Krause-Levy; Sophia Louisa,20,1,120,100
1656858422481,CSE 15L,A01,083654,Morris; Justin Loren,8,0,50,42
1656858422481,CSE 15L,A02,083655,Morris; Justin Loren,8,0,50,42
1656858428506,CSE 20,A01,083657,Tran; Khoa Dang,37,0,80,43
1656858434529,CSE 21,A01,095574,Bach; Quang Tran,21,0,48,27
1656858440553,CSE 30,A01,083084,Eldon; John,4,0,80,76
1656858440553,CSE 30,B01,095061,Bhaskar; Nishant,6,0,50,44
1656858446582,CSE 100,A01,083659,Cao; Yingjun,2,4,70,68
1656858452612,CSE 134B,A01,083661,Powell; Thomas Allan,19,0,100,81
1656858458635,CSE 140,A01,083663,Gungor; Onat,14,0,85,71
1656858464661,CSE 140L,A01,083088,Eldon; John,16,0,100,84
1656858470685,CSE 175,A01,083665,Kumar; Rakesh,3,0,25,22
1656858476779,CSE 190,A00,092507,Dubnov; Shlomo,7,0,20,13
1656858482802,ECE 45,A01,083139,Congero; Spencer William,5,0,75,70
1656858488841,ECE 65,A50,083695,Saad; Andrew S,12,0,30,18
1656858488841,ECE 65,A51,095125,Saad; Andrew S,25,0,26,1
1656858494865,ECE 109,A01,091882,Touri; Behrouz,16,0,70,54
1656858500894,ECE 180,A00,083140,Abi Samra; Nicholas Camill,0,0,30,30
1656858500894,ECE 180,B00,083141,Abi Samra; Nicholas Camill,0,0,30,30
1656858506921,MATH 10A,A01,083735,Patchell; Gregory David,1,0,30,29
1656858506921,MATH 10A,A02,083736,Patchell; Gregory David,20,0,30,10
1656858506921,MATH 10A,A03,083737,Patchell; Gregory David,15,0,30,15
1656858512952,MATH 10B,A01,083207,Lim; Seonhee,7,0,34,27
1656858512952,MATH 10B,A02,083208,Lim; Seonhee,9,0,35,26
1656858512952,MATH 10B,A03,093472,Lim; Seonhee,4,0,34,30
1656858512952,MATH 10B,B01,083739,Sinha; Shubham,9,0,30,21
1656858518985,MATH 18,A01,083743,Cinel; Cameron Alexander,6,0,30,24
1656858518985,MATH 18,A02,083744,Cinel; Cameron Alexander,15,0,30,15
1656858518985,MATH 18,A03,083745,Cinel; Cameron Alexander,8,0,30,22
1656858518985,MATH 18,B01,083748,Rideout; David Porter,3,0,37,34
1656858518985,MATH 18,B02,083749,Rideout; David Porter,3,0,36,33
1656858518985,MATH 18,B03,083750,Rideout; David Porter,2,0,37,35
1656858518985,MATH 18,B04,083751,Rideout; David Porter,5,0,36,31
1656858518985,MATH 18,B05,093473,Rideout; David Porter,4,0,36,32
1656858518985,MATH 18,B06,093474,Rideout; David Porter,5,0,36,31
1656858525013,MATH 20A,A01,083754,Zheng; Zequn,12,0,40,28
1656858531036,MATH 20B,A01,083756,Briones; Jor-el Thomas Caparas,1,0,36,35
1656858531036,MATH 20B,A02,083757,Briones; Jor-el Thomas Caparas,1,0,36,35
1656858531036,MATH 20B,A03,093475,Briones; Jor-el Thomas Caparas,0,0,36,36
1656858537065,MATH 20C,A01,083760,Briones; Jor-el Thomas Caparas,1,0,35,34
1656858537065,MATH 20C,A02,083761,Briones; Jor-el Thomas Caparas,8,0,35,27
1656858537065,MATH 20C,A03,093476,Briones; Jor-el Thomas Caparas,0,1,36,36
1656858537065,MATH 20C,B01,083762,Bach; Quang Tran,0,0,30,30
1656858543088,MATH 20D,A01,083765,Tran; Brian Kha,4,0,30,26
1656858543088,MATH 20D,A02,083766,Tran; Brian Kha,4,0,30,26
1656858543088,MATH 20D,A03,083767,Tran; Brian Kha,2,0,30,28
1656858549116,MATH 20E,A01,083771,Ganguly; Soumya,5,0,32,27
1656858549116,MATH 20E,A02,083772,Ganguly; Soumya,6,0,32,26
1656858549116,MATH 20E,B01,083773,Ciotti; Benjamin,18,0,35,17
1656858549116,MATH 20E,B02,083774,Ciotti; Benjamin,17,0,35,18
1656858555165,MATH 103A,A01,083777,Greenfeld; Be'Eri,2,0,36,34
1656858555165,MATH 103A,A02,083778,Greenfeld; Be'Eri,5,0,36,31
1656858555165,MATH 103A,A03,093561,Greenfeld; Be'Eri,4,0,36,32
1656858555165,MATH 103A,B01,083779,Greenfeld; Be'Eri,6,0,36,30
1656858555165,MATH 103A,B02,083780,Greenfeld; Be'Eri,2,0,36,34
1656858555165,MATH 103A,B03,093562,Greenfeld; Be'Eri,2,0,36,34
1656858561187,MATH 105,A01,085443,Carter; Anne Toulson,13,0,35,22
1656858561187,MATH 105,A02,093477,Carter; Anne Toulson,20,0,35,15
1656858567218,MATH 109,A01,083213,Ganzberger; Geoffrey Michael,2,0,34,32
1656858567218,MATH 109,A02,083214,Ganzberger; Geoffrey Michael,2,0,34,32
1656858567218,MATH 109,A03,093478,Ganzberger; Geoffrey Michael,1,0,34,33
1656858567218,MATH 109,B01,083215,Ganzberger; Geoffrey Michael,1,0,32,31
1656858567218,MATH 109,B02,083216,Ganzberger; Geoffrey Michael,1,0,32,31
1656858567218,MATH 109,B03,093479,Ganzberger; Geoffrey Michael,6,0,32,26
1656858573242,MATH 142A,A01,083219,Chow; Bennett,6,0,32,26
1656858573242,MATH 142A,A02,083220,Chow; Bennett,9,0,32,23
1656858573242,MATH 142A,A03,093480,Chow; Bennett,7,0,32,25
1656858573242,MATH 142A,B03,093481,Chow; Bennett,7,0,32,25
1656858573242,MATH 142A,B04,093558,Chow; Bennett,10,0,32,22
1656858573242,MATH 142A,B05,093559,Chow; Bennett,6,0,32,26
1656858579264,MATH 193A,A01,083224,Rotar; Vladimir,6,0,34,28
1656858579264,MATH 193A,A02,083225,Rotar; Vladimir,3,0,34,31
1656858579264,MATH 193A,A03,083781,Rotar; Vladimir,1,0,34,33
1656858579264,MATH 193A,A04,083782,Rotar; Vladimir,6,0,34,28
1656858579264,MATH 193A,A05,093482,Rotar; Vladimir,6,0,34,28
1656858585287,MATH 197,001,091859,McAuley; Julian John,9999,0,9999,0
1656858585287,MATH 197,002,095566,Kedlaya; Kiran S.,9997,0,9999,2
1656858585287,MATH 197,003,095567,Xiao; Ming,9999,0,9999,0
1656858585287,MATH 197,004,095571,Perols; Johan Lars,9998,0,9999,1
1656858592357,COGS 9,A01,083615,Shannon; Kyle Michael,6,0,75,69
1656858598386,COGS 11,A01,083617,Boyle; Mary E. T.,18,0,48,30
1656858604418,COGS 13,A01,083071,Bastos; Amalia Pinkusfeld,8,0,71,63
1656858610445,COGS 14A,A01,092681,Semenuks; Arturs,0,1,100,100
1656858616472,COGS 14B,A01,083073,Cheng; Tzu-Han,5,0,63,58
1656858622495,COGS 17,A01,092677,Semenuks; Arturs,4,0,81,77
1656858628522,COGS 100,A01,083619,Allen; Michael Gordon,15,0,70,55
1656858634546,COGS 101A,A01,083621,Davis; Joshua Daniel,9,0,68,59
1656858640569,COGS 101B,A01,091572,Allen; Michael Gordon,8,0,65,57
1656858646595,COGS 101C,A01,083625,Delgado; Tania,17,0,35,18
1656858652627,COGS 107A,A01,083627,Boyle; Mary E. T.,13,0,60,47
1656858658655,COGS 118A,A01,083075,Gupta; Anjum,15,0,76,61
1656858664677,CSE 3,A50,083646,Miranda; Gregory Joseph,22,0,50,28
1656858670701,CSE 8A,A50,083650,Miranda; Gregory Joseph,17,1,56,39
1656858676724,CSE 11,A01,083080,Cao; Yingjun,4,15,40,36
1656858682748,CSE 12,A01,083652,Krause-Levy; Sophia Louisa,20,1,120,100
1656858688787,CSE 15L,A01,083654,Morris; Justin Loren,8,0,50,42
1656858688787,CSE 15L,A02,083655,Morris; Justin Loren,8,0,50,42
1656858694825,CSE 20,A01,083657,Tran; Khoa Dang,37,0,80,43
1656858700850,CSE 21,A01,095574,Bach; Quang Tran,21,0,48,27
1656858706881,CSE 30,A01,083084,Eldon; John,4,0,80,76
1656858706881,CSE 30,B01,095061,Bhaskar; Nishant,6,0,50,44
1656858712910,CSE 100,A01,083659,Cao; Yingjun,2,4,70,68
1656858718933,CSE 134B,A01,083661,Powell; Thomas Allan,19,0,100,81
1656858724965,CSE 140,A01,083663,Gungor; Onat,14,0,85,71
1656858730996,CSE 140L,A01,083088,Eldon; John,16,0,100,84
1656858737017,CSE 175,A01,083665,Kumar; Rakesh,3,0,25,22
1656858743044,CSE 190,A00,092507,Dubnov; Shlomo,7,0,20,13
1656858749073,ECE 45,A01,083139,Congero; Spencer William,5,0,75,70
1656858755099,ECE 65,A50,083695,Saad; Andrew S,12,0,30,18
1656858755099,ECE 65,A51,095125,Saad; Andrew S,25,0,26,1
1656858761189,ECE 109,A01,091882,Touri; Behrouz,16,0,70,54
1656858767221,ECE 180,A00,083140,Abi Samra; Nicholas Camill,0,0,30,30
1656858767221,ECE 180,B00,083141,Abi Samra; Nicholas Camill,0,0,30,30
1656858773249,MATH 10A,A01,083735,Patchell; Gregory David,1,0,30,29
1656858773249,MATH 10A,A02,083736,Patchell; Gregory David,20,0,30,10
1656858773249,MATH 10A,A03,083737,Patchell; Gregory David,15,0,30,15
1656858779280,MATH 10B,A01,083207,Lim; Seonhee,7,0,34,27
1656858779280,MATH 10B,A02,083208,Lim; Seonhee,9,0,35,26
1656858779280,MATH 10B,A03,093472,Lim; Seonhee,4,0,34,30
1656858779280,MATH 10B,B01,083739,Sinha; Shubham,9,0,30,21
1656858785309,MATH 18,A01,083743,Cinel; Cameron Alexander,6,0,30,24
1656858785309,MATH 18,A02,083744,Cinel; Cameron Alexander,15,0,30,15
1656858785309,MATH 18,A03,083745,Cinel; Cameron Alexander,8,0,30,22
1656858785309,MATH 18,B01,083748,Rideout; David Porter,3,0,37,34
1656858785309,MATH 18,B02,083749,Rideout; David Porter,3,0,36,33
1656858785309,MATH 18,B03,083750,Rideout; David Porter,2,0,37,35
1656858785309,MATH 18,B04,083751,Rideout; David Porter,5,0,36,31
1656858785309,MATH 18,B05,093473,Rideout; David Porter,4,0,36,32
1656858785309,MATH 18,B06,093474,Rideout; David Porter,5,0,36,31
1656858791334,MATH 20A,A01,083754,Zheng; Zequn,12,0,40,28
1656858797361,MATH 20B,A01,083756,Briones; Jor-el Thomas Caparas,1,0,36,35
1656858797361,MATH 20B,A02,083757,Briones; Jor-el Thomas Caparas,1,0,36,35
1656858797361,MATH 20B,A03,093475,Briones; Jor-el Thomas Caparas,0,0,36,36
1656858803391,MATH 20C,A01,083760,Briones; Jor-el Thomas Caparas,1,0,35,34
1656858803391,MATH 20C,A02,083761,Briones; Jor-el Thomas Caparas,8,0,35,27
1656858803391,MATH 20C,A03,093476,Briones; Jor-el Thomas Caparas,0,1,36,36
1656858803391,MATH 20C,B01,083762,Bach; Quang Tran,0,0,30,30
1656858809417,MATH 20D,A01,083765,Tran; Brian Kha,4,0,30,26
1656858809417,MATH 20D,A02,083766,Tran; Brian Kha,4,0,30,26
1656858809417,MATH 20D,A03,083767,Tran; Brian Kha,2,0,30,28
1656858815442,MATH 20E,A01,083771,Ganguly; Soumya,5,0,32,27
1656858815442,MATH 20E,A02,083772,Ganguly; Soumya,6,0,32,26
1656858815442,MATH 20E,B01,083773,Ciotti; Benjamin,18,0,35,17
1656858815442,MATH 20E,B02,083774,Ciotti; Benjamin,17,0,35,18
1656858821469,MATH 103A,A01,083777,Greenfeld; Be'Eri,2,0,36,34
1656858821469,MATH 103A,A02,083778,Greenfeld; Be'Eri,5,0,36,31
1656858821469,MATH 103A,A03,093561,Greenfeld; Be'Eri,4,0,36,32
1656858821469,MATH 103A,B01,083779,Greenfeld; Be'Eri,6,0,36,30
1656858821469,MATH 103A,B02,083780,Greenfeld; Be'Eri,2,0,36,34
1656858821469,MATH 103A,B03,093562,Greenfeld; Be'Eri,2,0,36,34
1656858827491,MATH 105,A01,085443,Carter; Anne Toulson,13,0,35,22
1656858827491,MATH 105,A02,093477,Carter; Anne Toulson,20,0,35,15
1656858833517,MATH 109,A01,083213,Ganzberger; Geoffrey Michael,2,0,34,32
1656858833517,MATH 109,A02,083214,Ganzberger; Geoffrey Michael,2,0,34,32
1656858833517,MATH 109,A03,093478,Ganzberger; Geoffrey Michael,1,0,34,33
1656858833517,MATH 109,B01,083215,Ganzberger; Geoffrey Michael,1,0,32,31
1656858833517,MATH 109,B02,083216,Ganzberger; Geoffrey Michael,1,0,32,31
1656858833517,MATH 109,B03,093479,Ganzberger; Geoffrey Michael,6,0,32,26
1656858839550,MATH 142A,A01,083219,Chow; Bennett,6,0,32,26
1656858839550,MATH 142A,A02,083220,Chow; Bennett,9,0,32,23
1656858839550,MATH 142A,A03,093480,Chow; Bennett,7,0,32,25
1656858839550,MATH 142A,B03,093481,Chow; Bennett,7,0,32,25
1656858839550,MATH 142A,B04,093558,Chow; Bennett,10,0,32,22
1656858839550,MATH 142A,B05,093559,Chow; Bennett,6,0,32,26
1656858845596,MATH 193A,A01,083224,Rotar; Vladimir,6,0,34,28
1656858845596,MATH 193A,A02,083225,Rotar; Vladimir,3,0,34,31
1656858845596,MATH 193A,A03,083781,Rotar; Vladimir,1,0,34,33
1656858845596,MATH 193A,A04,083782,Rotar; Vladimir,6,0,34,28
1656858845596,MATH 193A,A05,093482,Rotar; Vladimir,6,0,34,28
1656858851628,MATH 197,001,091859,McAuley; Julian John,9999,0,9999,0
1656858851628,MATH 197,002,095566,Kedlaya; Kiran S.,9997,0,9999,2
1656858851628,MATH 197,003,095567,Xiao; Ming,9999,0,9999,0
1656858851628,MATH 197,004,095571,Perols; Johan Lars,9998,0,9999,1
1656858858690,COGS 9,A01,083615,Shannon; Kyle Michael,6,0,75,69
1656858864716,COGS 11,A01,083617,Boyle; Mary E. T.,18,0,48,30
1656858870742,COGS 13,A01,083071,Bastos; Amalia Pinkusfeld,8,0,71,63
1656858876766,COGS 14A,A01,092681,Semenuks; Arturs,0,1,100,100
1656858882789,COGS 14B,A01,083073,Cheng; Tzu-Han,5,0,63,58
1656858888811,COGS 17,A01,092677,Semenuks; Arturs,4,0,81,77
1656858894839,COGS 100,A01,083619,Allen; Michael Gordon,15,0,70,55
1656858900867,COGS 101A,A01,083621,Davis; Joshua Daniel,9,0,68,59
1656858906890,COGS 101B,A01,091572,Allen; Michael Gordon,8,0,65,57
1656858912918,COGS 101C,A01,083625,Delgado; Tania,17,0,35,18
1656858918947,COGS 107A,A01,083627,Boyle; Mary E. T.,13,0,60,47
1656858924968,COGS 118A,A01,083075,Gupta; Anjum,15,0,76,61
1656858930993,CSE 3,A50,083646,Miranda; Gregory Joseph,22,0,50,28
1656858937016,CSE 8A,A50,083650,Miranda; Gregory Joseph,17,1,56,39
1656858943038,CSE 11,A01,083080,Cao; Yingjun,4,15,40,36
1656858949063,CSE 12,A01,083652,Krause-Levy; Sophia Louisa,20,1,120,100
1656858955092,CSE 15L,A01,083654,Morris; Justin Loren,8,0,50,42
1656858955092,CSE 15L,A02,083655,Morris; Justin Loren,8,0,50,42
1656858961115,CSE 20,A01,083657,Tran; Khoa Dang,37,0,80,43
1656858967145,CSE 21,A01,095574,Bach; Quang Tran,21,0,48,27
1656858973174,CSE 30,A01,083084,Eldon; John,4,0,80,76
1656858973174,CSE 30,B01,095061,Bhaskar; Nishant,6,0,50,44
1656858979205,CSE 100,A01,083659,Cao; Yingjun,2,4,70,68
1656858985228,CSE 134B,A01,083661,Powell; Thomas Allan,19,0,100,81
1656858991261,CSE 140,A01,083663,Gungor; Onat,14,0,85,71
1656858997285,CSE 140L,A01,083088,Eldon; John,16,0,100,84
1656859003310,CSE 175,A01,083665,Kumar; Rakesh,3,0,25,22
1656859009333,CSE 190,A00,092507,Dubnov; Shlomo,7,0,20,13
1656859015360,ECE 45,A01,083139,Congero; Spencer William,5,0,75,70
1656859021385,ECE 65,A50,083695,Saad; Andrew S,12,0,30,18
1656859021385,ECE 65,A51,095125,Saad; Andrew S,25,0,26,1
1656859027412,ECE 109,A01,091882,Touri; Behrouz,16,0,70,54
1656859033436,ECE 180,A00,083140,Abi Samra; Nicholas Camill,0,0,30,30
1656859033436,ECE 180,B00,083141,Abi Samra; Nicholas Camill,0,0,30,30
1656859039465,MATH 10A,A01,083735,Patchell; Gregory David,1,0,30,29
1656859039465,MATH 10A,A02,083736,Patchell; Gregory David,20,0,30,10
1656859039465,MATH 10A,A03,083737,Patchell; Gregory David,15,0,30,15
1656859045495,MATH 10B,A01,083207,Lim; Seonhee,7,0,34,27
1656859045495,MATH 10B,A02,083208,Lim; Seonhee,9,0,35,26
1656859045495,MATH 10B,A03,093472,Lim; Seonhee,4,0,34,30
1656859045495,MATH 10B,B01,083739,Sinha; Shubham,9,0,30,21
1656859051536,MATH 18,A01,083743,Cinel; Cameron Alexander,6,0,30,24
1656859051536,MATH 18,A02,083744,Cinel; Cameron Alexander,15,0,30,15
1656859051536,MATH 18,A03,083745,Cinel; Cameron Alexander,8,0,30,22
1656859051536,MATH 18,B01,083748,Rideout; David Porter,3,0,37,34
1656859051536,MATH 18,B02,083749,Rideout; David Porter,3,0,36,33
1656859051536,MATH 18,B03,083750,Rideout; David Porter,2,0,37,35
1656859051536,MATH 18,B04,083751,Rideout; David Porter,5,0,36,31
1656859051536,MATH 18,B05,093473,Rideout; David Porter,4,0,36,32
1656859051536,MATH 18,B06,093474,Rideout; David Porter,5,0,36,31
1656859057562,MATH 20A,A01,083754,Zheng; Zequn,12,0,40,28
1656859063596,MATH 20B,A01,083756,Briones; Jor-el Thomas Caparas,1,0,36,35
1656859063596,MATH 20B,A02,083757,Briones; Jor-el Thomas Caparas,1,0,36,35
1656859063596,MATH 20B,A03,093475,Briones; Jor-el Thomas Caparas,0,0,36,36
1656859069626,MATH 20C,A01,083760,Briones; Jor-el Thomas Caparas,1,0,35,34
1656859069626,MATH 20C,A02,083761,Briones; Jor-el Thomas Caparas,8,0,35,27
1656859069626,MATH 20C,A03,093476,Briones; Jor-el Thomas Caparas,0,1,36,36
1656859069626,MATH 20C,B01,083762,Bach; Quang Tran,0,0,30,30
1656859075740,MATH 20D,A01,083765,Tran; Brian Kha,4,0,30,26
1656859075740,MATH 20D,A02,083766,Tran; Brian Kha,4,0,30,26
1656859075740,MATH 20D,A03,083767,Tran; Brian Kha,2,0,30,28
1656859081763,MATH 20E,A01,083771,Ganguly; Soumya,5,0,32,27
1656859081763,MATH 20E,A02,083772,Ganguly; Soumya,6,0,32,26
1656859081763,MATH 20E,B01,083773,Ciotti; Benjamin,18,0,35,17
1656859081763,MATH 20E,B02,083774,Ciotti; Benjamin,17,0,35,18
1656859087785,MATH 103A,A01,083777,Greenfeld; Be'Eri,2,0,36,34
1656859087785,MATH 103A,A02,083778,Greenfeld; Be'Eri,5,0,36,31
1656859087785,MATH 103A,A03,093561,Greenfeld; Be'Eri,4,0,36,32
1656859087785,MATH 103A,B01,083779,Greenfeld; Be'Eri,6,0,36,30
1656859087785,MATH 103A,B02,083780,Greenfeld; Be'Eri,2,0,36,34
1656859087785,MATH 103A,B03,093562,Greenfeld; Be'Eri,2,0,36,34
1656859093812,MATH 105,A01,085443,Carter; Anne Toulson,13,0,35,22
1656859093812,MATH 105,A02,093477,Carter; Anne Toulson,20,0,35,15
1656859099835,MATH 109,A01,083213,Ganzberger; Geoffrey Michael,2,0,34,32
1656859099835,MATH 109,A02,083214,Ganzberger; Geoffrey Michael,2,0,34,32
1656859099835,MATH 109,A03,093478,Ganzberger; Geoffrey Michael,1,0,34,33
1656859099835,MATH 109,B01,083215,Ganzberger; Geoffrey Michael,1,0,32,31
1656859099835,MATH 109,B02,083216,Ganzberger; Geoffrey Michael,1,0,32,31
1656859099835,MATH 109,B03,093479,Ganzberger; Geoffrey Michael,6,0,32,26
1656859105859,MATH 142A,A01,083219,Chow; Bennett,6,0,32,26
1656859105859,MATH 142A,A02,083220,Chow; Bennett,9,0,32,23
1656859105859,MATH 142A,A03,093480,Chow; Bennett,7,0,32,25
1656859105859,MATH 142A,B03,093481,Chow; Bennett,7,0,32,25
1656859105859,MATH 142A,B04,093558,Chow; Bennett,10,0,32,22
1656859105859,MATH 142A,B05,093559,Chow; Bennett,6,0,32,26
1656859111882,MATH 193A,A01,083224,Rotar; Vladimir,6,0,34,28
1656859111882,MATH 193A,A02,083225,Rotar; Vladimir,3,0,34,31
1656859111882,MATH 193A,A03,083781,Rotar; Vladimir,1,0,34,33
1656859111882,MATH 193A,A04,083782,Rotar; Vladimir,6,0,34,28
1656859111882,MATH 193A,A05,093482,Rotar; Vladimir,6,0,34,28
1656859117913,MATH 197,001,091859,McAuley; Julian John,9999,0,9999,0
1656859117913,MATH 197,002,095566,Kedlaya; Kiran S.,9997,0,9999,2
1656859117913,MATH 197,003,095567,Xiao; Ming,9999,0,9999,0
1656859117913,MATH 197,004,095571,Perols; Johan Lars,9998,0,9999,1
1656859124974,COGS 9,A01,083615,Shannon; Kyle Michael,6,0,75,69
1656859131008,COGS 11,A01,083617,Boyle; Mary E. T.,18,0,48,30
1656859137032,COGS 13,A01,083071,Bastos; Amalia Pinkusfeld,8,0,71,63
1656859143055,COGS 14A,A01,092681,Semenuks; Arturs,0,1,100,100
1656859149077,COGS 14B,A01,083073,Cheng; Tzu-Han,5,0,63,58
1656859155113,COGS 17,A01,092677,Semenuks; Arturs,4,0,81,77
1656859161142,COGS 100,A01,083619,Allen; Michael Gordon,15,0,70,55
1656859167169,COGS 101A,A01,083621,Davis; Joshua Daniel,9,0,68,59
1656859173198,COGS 101B,A01,091572,Allen; Michael Gordon,8,0,65,57
1656859179220,COGS 101C,A01,083625,Delgado; Tania,17,0,35,18
1656859185255,COGS 107A,A01,083627,Boyle; Mary E. T.,13,0,60,47
1656859191281,COGS 118A,A01,083075,Gupta; Anjum,15,0,76,61
1656859197310,CSE 3,A50,083646,Miranda; Gregory Joseph,22,0,50,28
1656859203343,CSE 8A,A50,083650,Miranda; Gregory Joseph,17,1,56,39
1656859209370,CSE 11,A01,083080,Cao; Yingjun,4,15,40,36
1656859215396,CSE 12,A01,083652,Krause-Levy; Sophia Louisa,20,1,120,100
1656859221419,CSE 15L,A01,083654,Morris; Justin Loren,8,0,50,42
1656859221419,CSE 15L,A02,083655,Morris; Justin Loren,8,0,50,42
1656859227448,CSE 20,A01,083657,Tran; Khoa Dang,37,0,80,43
1656859233486,CSE 21,A01,095574,Bach; Quang Tran,21,0,48,27
1656859239509,CSE 30,A01,083084,Eldon; John,4,0,80,76
1656859239509,CSE 30,B01,095061,Bhaskar; Nishant,6,0,50,44
1656859245542,CSE 100,A01,083659,Cao; Yingjun,2,4,70,68
1656859251568,CSE 134B,A01,083661,Powell; Thomas Allan,19,0,100,81
1656859257590,CSE 140,A01,083663,Gungor; Onat,14,0,85,71
1656859263616,CSE 140L,A01,083088,Eldon; John,16,0,100,84
1656859269644,CSE 175,A01,083665,Kumar; Rakesh,3,0,25,22
1656859275673,CSE 190,A00,092507,Dubnov; Shlomo,7,0,20,13
1656859281697,ECE 45,A01,083139,Congero; Spencer William,5,0,75,70
1656859287722,ECE 65,A50,083695,Saad; Andrew S,12,0,30,18
1656859287722,ECE 65,A51,095125,Saad; Andrew S,25,0,26,1
1656859293746,ECE 109,A01,091882,Touri; Behrouz,16,0,70,54
1656859299773,ECE 180,A00,083140,Abi Samra; Nicholas Camill,0,0,30,30
1656859299773,ECE 180,B00,083141,Abi Samra; Nicholas Camill,0,0,30,30
1656859305796,MATH 10A,A01,083735,Patchell; Gregory David,1,0,30,29
1656859305796,MATH 10A,A02,083736,Patchell; Gregory David,20,0,30,10
1656859305796,MATH 10A,A03,083737,Patchell; Gregory David,15,0,30,15
1656859311839,MATH 10B,A01,083207,Lim; Seonhee,7,0,34,27
1656859311839,MATH 10B,A02,083208,Lim; Seonhee,9,0,35,26
1656859311839,MATH 10B,A03,093472,Lim; Seonhee,4,0,34,30
1656859311839,MATH 10B,B01,083739,Sinha; Shubham,9,0,30,21
1656859317864,MATH 18,A01,083743,Cinel; Cameron Alexander,6,0,30,24
1656859317864,MATH 18,A02,083744,Cinel; Cameron Alexander,15,0,30,15
1656859317864,MATH 18,A03,083745,Cinel; Cameron Alexander,8,0,30,22
1656859317864,MATH 18,B01,083748,Rideout; David Porter,3,0,37,34
1656859317864,MATH 18,B02,083749,Rideout; David Porter,3,0,36,33
1656859317864,MATH 18,B03,083750,Rideout; David Porter,2,0,37,35
1656859317864,MATH 18,B04,083751,Rideout; David Porter,5,0,36,31
1656859317864,MATH 18,B05,093473,Rideout; David Porter,4,0,36,32
1656859317864,MATH 18,B06,093474,Rideout; David Porter,5,0,36,31
1656859323888,MATH 20A,A01,083754,Zheng; Zequn,12,0,40,28
1656859329921,MATH 20B,A01,083756,Briones; Jor-el Thomas Caparas,1,0,36,35
1656859329921,MATH 20B,A02,083757,Briones; Jor-el Thomas Caparas,1,0,36,35
1656859329921,MATH 20B,A03,093475,Briones; Jor-el Thomas Caparas,0,0,36,36
1656859335945,MATH 20C,A01,083760,Briones; Jor-el Thomas Caparas,1,0,35,34
1656859335945,MATH 20C,A02,083761,Briones; Jor-el Thomas Caparas,8,0,35,27
1656859335945,MATH 20C,A03,093476,Briones; Jor-el Thomas Caparas,0,1,36,36
1656859335945,MATH 20C,B01,083762,Bach; Quang Tran,0,0,30,30
1656859341969,MATH 20D,A01,083765,Tran; Brian Kha,4,0,30,26
1656859341969,MATH 20D,A02,083766,Tran; Brian Kha,4,0,30,26
1656859341969,MATH 20D,A03,083767,Tran; Brian Kha,2,0,30,28
1656859347994,MATH 20E,A01,083771,Ganguly; Soumya,5,0,32,27
1656859347994,MATH 20E,A02,083772,Ganguly; Soumya,6,0,32,26
1656859347994,MATH 20E,B01,083773,Ciotti; Benjamin,18,0,35,17
1656859347994,MATH 20E,B02,083774,Ciotti; Benjamin,17,0,35,18
1656859354018,MATH 103A,A01,083777,Greenfeld; Be'Eri,2,0,36,34
1656859354018,MATH 103A,A02,083778,Greenfeld; Be'Eri,5,0,36,31
1656859354018,MATH 103A,A03,093561,Greenfeld; Be'Eri,4,0,36,32
1656859354018,MATH 103A,B01,083779,Greenfeld; Be'Eri,6,0,36,30
1656859354018,MATH 103A,B02,083780,Greenfeld; Be'Eri,2,0,36,34
1656859354018,MATH 103A,B03,093562,Greenfeld; Be'Eri,2,0,36,34
1656859360043,MATH 105,A01,085443,Carter; Anne Toulson,13,0,35,22
1656859360043,MATH 105,A02,093477,Carter; Anne Toulson,20,0,35,15
1656859366072,MATH 109,A01,083213,Ganzberger; Geoffrey Michael,2,0,34,32
1656859366072,MATH 109,A02,083214,Ganzberger; Geoffrey Michael,2,0,34,32
1656859366072,MATH 109,A03,093478,Ganzberger; Geoffrey Michael,1,0,34,33
1656859366072,MATH 109,B01,083215,Ganzberger; Geoffrey Michael,1,0,32,31
1656859366072,MATH 109,B02,083216,Ganzberger; Geoffrey Michael,1,0,32,31
1656859366072,MATH 109,B03,093479,Ganzberger; Geoffrey Michael,6,0,32,26
1656859372113,MATH 142A,A01,083219,Chow; Bennett,6,0,32,26
1656859372113,MATH 142A,A02,083220,Chow; Bennett,9,0,32,23
1656859372113,MATH 142A,A03,093480,Chow; Bennett,7,0,32,25
1656859372113,MATH 142A,B03,093481,Chow; Bennett,7,0,32,25
1656859372113,MATH 142A,B04,093558,Chow; Bennett,10,0,32,22
1656859372113,MATH 142A,B05,093559,Chow; Bennett,6,0,32,26
1656859378142,MATH 193A,A01,083224,Rotar; Vladimir,6,0,34,28
1656859378142,MATH 193A,A02,083225,Rotar; Vladimir,3,0,34,31
1656859378142,MATH 193A,A03,083781,Rotar; Vladimir,1,0,34,33
1656859378142,MATH 193A,A04,083782,Rotar; Vladimir,6,0,34,28
1656859378142,MATH 193A,A05,093482,Rotar; Vladimir,6,0,34,28
1656859384166,MATH 197,001,091859,McAuley; Julian John,9999,0,9999,0
1656859384166,MATH 197,002,095566,Kedlaya; Kiran S.,9997,0,9999,2
1656859384166,MATH 197,003,095567,Xiao; Ming,9999,0,9999,0
1656859384166,MATH 197,004,095571,Perols; Johan Lars,9998,0,9999,1
1656859391217,COGS 9,A01,083615,Shannon; Kyle Michael,6,0,75,69
1656859397243,COGS 11,A01,083617,Boyle; Mary E. T.,18,0,48,30
1656859403270,COGS 13,A01,083071,Bastos; Amalia Pinkusfeld,8,0,71,63
1656859409297,COGS 14A,A01,092681,Semenuks; Arturs,0,1,100,100
1656859415323,COGS 14B,A01,083073,Cheng; Tzu-Han,5,0,63,58
1656859421349,COGS 17,A01,092677,Semenuks; Arturs,4,0,81,77
1656859427386,COGS 100,A01,083619,Allen; Michael Gordon,15,0,70,55
1656859433410,COGS 101A,A01,083621,Davis; Joshua Daniel,9,0,68,59
1656859439434,COGS 101B,A01,091572,Allen; Michael Gordon,8,0,65,57
1656859445458,COGS 101C,A01,083625,Delgado; Tania,17,0,35,18
1656859451482,COGS 107A,A01,083627,Boyle; Mary E. T.,13,0,60,47
1656859457508,COGS 118A,A01,083075,Gupta; Anjum,15,0,76,61
1656859463534,CSE 3,A50,083646,Miranda; Gregory Joseph,22,0,50,28
1656859469566,CSE 8A,A50,083650,Miranda; Gregory Joseph,17,1,56,39
1656859475600,CSE 11,A01,083080,Cao; Yingjun,4,15,40,36
1656859481625,CSE 12,A01,083652,Krause-Levy; Sophia Louisa,20,1,120,100
1656859487654,CSE 15L,A01,083654,Morris; Justin Loren,8,0,50,42
1656859487654,CSE 15L,A02,083655,Morris; Justin Loren,8,0,50,42
1656859493681,CSE 20,A01,083657,Tran; Khoa Dang,37,0,80,43
1656859499706,CSE 21,A01,095574,Bach; Quang Tran,21,0,48,27
1656859505733,CSE 30,A01,083084,Eldon; John,4,0,80,76
1656859505733,CSE 30,B01,095061,Bhaskar; Nishant,6,0,50,44
1656859511759,CSE 100,A01,083659,Cao; Yingjun,2,4,70,68
1656859517783,CSE 134B,A01,083661,Powell; Thomas Allan,19,0,100,81
1656859523810,CSE 140,A01,083663,Gungor; Onat,14,0,85,71
1656859529839,CSE 140L,A01,083088,Eldon; John,16,0,100,84
1656859535867,CSE 175,A01,083665,Kumar; Rakesh,3,0,25,22
1656859541895,CSE 190,A00,092507,Dubnov; Shlomo,7,0,20,13
1656859547921,ECE 45,A01,083139,Congero; Spencer William,5,0,75,70
1656859553945,ECE 65,A50,083695,Saad; Andrew S,12,0,30,18
1656859553945,ECE 65,A51,095125,Saad; Andrew S,25,0,26,1
1656859559974,ECE 109,A01,091882,Touri; Behrouz,16,0,70,54
1656859566008,ECE 180,A00,083140,Abi Samra; Nicholas Camill,0,0,30,30
1656859566008,ECE 180,B00,083141,Abi Samra; Nicholas Camill,0,0,30,30
1656859572035,MATH 10A,A01,083735,Patchell; Gregory David,1,0,30,29
1656859572035,MATH 10A,A02,083736,Patchell; Gregory David,20,0,30,10
1656859572035,MATH 10A,A03,083737,Patchell; Gregory David,15,0,30,15
1656859578067,MATH 10B,A01,083207,Lim; Seonhee,7,0,34,27
1656859578067,MATH 10B,A02,083208,Lim; Seonhee,9,0,35,26
1656859578067,MATH 10B,A03,093472,Lim; Seonhee,4,0,34,30
1656859578067,MATH 10B,B01,083739,Sinha; Shubham,9,0,30,21
1656859584100,MATH 18,A01,083743,Cinel; Cameron Alexander,6,0,30,24
1656859584100,MATH 18,A02,083744,Cinel; Cameron Alexander,15,0,30,15
1656859584100,MATH 18,A03,083745,Cinel; Cameron Alexander,8,0,30,22
1656859584100,MATH 18,B01,083748,Rideout; David Porter,3,0,37,34
1656859584100,MATH 18,B02,083749,Rideout; David Porter,3,0,36,33
1656859584100,MATH 18,B03,083750,Rideout; David Porter,2,0,37,35
1656859584100,MATH 18,B04,083751,Rideout; David Porter,5,0,36,31
1656859584100,MATH 18,B05,093473,Rideout; David Porter,4,0,36,32
1656859584100,MATH 18,B06,093474,Rideout; David Porter,5,0,36,31
1656859590133,MATH 20A,A01,083754,Zheng; Zequn,12,0,40,28
1656859596197,MATH 20B,A01,083756,Briones; Jor-el Thomas Caparas,1,0,36,35
1656859596197,MATH 20B,A02,083757,Briones; Jor-el Thomas Caparas,1,0,36,35
1656859596197,MATH 20B,A03,093475,Briones; Jor-el Thomas Caparas,0,0,36,36
1656859602226,MATH 20C,A01,083760,Briones; Jor-el Thomas Caparas,1,0,35,34
1656859602226,MATH 20C,A02,083761,Briones; Jor-el Thomas Caparas,8,0,35,27
1656859602226,MATH 20C,A03,093476,Briones; Jor-el Thomas Caparas,0,1,36,36
1656859602226,MATH 20C,B01,083762,Bach; Quang Tran,0,0,30,30
1656859608251,MATH 20D,A01,083765,Tran; Brian Kha,4,0,30,26
1656859608251,MATH 20D,A02,083766,Tran; Brian Kha,4,0,30,26
1656859608251,MATH 20D,A03,083767,Tran; Brian Kha,2,0,30,28
1656859614276,MATH 20E,A01,083771,Ganguly; Soumya,5,0,32,27
1656859614276,MATH 20E,A02,083772,Ganguly; Soumya,6,0,32,26
1656859614276,MATH 20E,B01,083773,Ciotti; Benjamin,18,0,35,17
1656859614276,MATH 20E,B02,083774,Ciotti; Benjamin,17,0,35,18
1656859620304,MATH 103A,A01,083777,Greenfeld; Be'Eri,2,0,36,34
1656859620304,MATH 103A,A02,083778,Greenfeld; Be'Eri,5,0,36,31
1656859620304,MATH 103A,A03,093561,Greenfeld; Be'Eri,4,0,36,32
1656859620304,MATH 103A,B01,083779,Greenfeld; Be'Eri,6,0,36,30
1656859620304,MATH 103A,B02,083780,Greenfeld; Be'Eri,2,0,36,34
1656859620304,MATH 103A,B03,093562,Greenfeld; Be'Eri,2,0,36,34
1656859626328,MATH 105,A01,085443,Carter; Anne Toulson,13,0,35,22
1656859626328,MATH 105,A02,093477,Carter; Anne Toulson,20,0,35,15
1656859632358,MATH 109,A01,083213,Ganzberger; Geoffrey Michael,2,0,34,32
1656859632358,MATH 109,A02,083214,Ganzberger; Geoffrey Michael,2,0,34,32
1656859632358,MATH 109,A03,093478,Ganzberger; Geoffrey Michael,1,0,34,33
1656859632358,MATH 109,B01,083215,Ganzberger; Geoffrey Michael,1,0,32,31
1656859632358,MATH 109,B02,083216,Ganzberger; Geoffrey Michael,1,0,32,31
1656859632358,MATH 109,B03,093479,Ganzberger; Geoffrey Michael,6,0,32,26
1656859638384,MATH 142A,A01,083219,Chow; Bennett,6,0,32,26
1656859638384,MATH 142A,A02,083220,Chow; Bennett,9,0,32,23
1656859638384,MATH 142A,A03,093480,Chow; Bennett,7,0,32,25
1656859638384,MATH 142A,B03,093481,Chow; Bennett,7,0,32,25
1656859638384,MATH 142A,B04,093558,Chow; Bennett,10,0,32,22
1656859638384,MATH 142A,B05,093559,Chow; Bennett,6,0,32,26
1656859644412,MATH 193A,A01,083224,Rotar; Vladimir,6,0,34,28
1656859644412,MATH 193A,A02,083225,Rotar; Vladimir,3,0,34,31
1656859644412,MATH 193A,A03,083781,Rotar; Vladimir,1,0,34,33
1656859644412,MATH 193A,A04,083782,Rotar; Vladimir,6,0,34,28
1656859644412,MATH 193A,A05,093482,Rotar; Vladimir,6,0,34,28
1656859650437,MATH 197,001,091859,McAuley; Julian John,9999,0,9999,0
1656859650437,MATH 197,002,095566,Kedlaya; Kiran S.,9997,0,9999,2
1656859650437,MATH 197,003,095567,Xiao; Ming,9999,0,9999,0
1656859650437,MATH 197,004,095571,Perols; Johan Lars,9998,0,9999,1
1656859657494,COGS 9,A01,083615,Shannon; Kyle Michael,6,0,75,69
1656859663522,COGS 11,A01,083617,Boyle; Mary E. T.,18,0,48,30
1656859669636,COGS 13,A01,083071,Bastos; Amalia Pinkusfeld,8,0,71,63
1656859675658,COGS 14A,A01,092681,Semenuks; Arturs,0,1,100,100
1656859681680,COGS 14B,A01,083073,Cheng; Tzu-Han,5,0,63,58
1656859687709,COGS 17,A01,092677,Semenuks; Arturs,4,0,81,77
1656859693735,COGS 100,A01,083619,Allen; Michael Gordon,15,0,70,55
1656859699763,COGS 101A,A01,083621,Davis; Joshua Daniel,9,0,68,59
1656859705793,COGS 101B,A01,091572,Allen; Michael Gordon,8,0,65,57
1656859711816,COGS 101C,A01,083625,Delgado; Tania,17,0,35,18
1656859717841,COGS 107A,A01,083627,Boyle; Mary E. T.,13,0,60,47
1656859723869,COGS 118A,A01,083075,Gupta; Anjum,15,0,76,61
1656859729896,CSE 3,A50,083646,Miranda; Gregory Joseph,22,0,50,28
1656859735923,CSE 8A,A50,083650,Miranda; Gregory Joseph,17,1,56,39
1656859741946,CSE 11,A01,083080,Cao; Yingjun,4,15,40,36
1656859747971,CSE 12,A01,083652,Krause-Levy; Sophia Louisa,20,1,120,100
1656859753995,CSE 15L,A01,083654,Morris; Justin Loren,8,0,50,42
1656859753995,CSE 15L,A02,083655,Morris; Justin Loren,8,0,50,42
1656859760020,CSE 20,A01,083657,Tran; Khoa Dang,37,0,80,43
1656859766047,CSE 21,A01,095574,Bach; Quang Tran,21,0,48,27
1656859772071,CSE 30,A01,083084,Eldon; John,4,0,80,76
1656859772071,CSE 30,B01,095061,Bhaskar; Nishant,6,0,50,44
1656859778104,CSE 100,A01,083659,Cao; Yingjun,2,4,70,68
1656859784128,CSE 134B,A01,083661,Powell; Thomas Allan,19,0,100,81
1656859790151,CSE 140,A01,083663,Gungor; Onat,14,0,85,71
1656859796174,CSE 140L,A01,083088,Eldon; John,16,0,100,84
1656859802204,CSE 175,A01,083665,Kumar; Rakesh,3,0,25,22
1656859808230,CSE 190,A00,092507,Dubnov; Shlomo,7,0,20,13
1656859814262,ECE 45,A01,083139,Congero; Spencer William,5,0,75,70
1656859820284,ECE 65,A50,083695,Saad; Andrew S,12,0,30,18
1656859820284,ECE 65,A51,095125,Saad; Andrew S,25,0,26,1
1656859826310,ECE 109,A01,091882,Touri; Behrouz,16,0,70,54
1656859832337,ECE 180,A00,083140,Abi Samra; Nicholas Camill,0,0,30,30
1656859832337,ECE 180,B00,083141,Abi Samra; Nicholas Camill,0,0,30,30
1656859838362,MATH 10A,A01,083735,Patchell; Gregory David,1,0,30,29
1656859838362,MATH 10A,A02,083736,Patchell; Gregory David,20,0,30,10
1656859838362,MATH 10A,A03,083737,Patchell; Gregory David,15,0,30,15
1656859844394,MATH 10B,A01,083207,Lim; Seonhee,7,0,34,27
1656859844394,MATH 10B,A02,083208,Lim; Seonhee,9,0,35,26
1656859844394,MATH 10B,A03,093472,Lim; Seonhee,4,0,34,30
1656859844394,MATH 10B,B01,083739,Sinha; Shubham,9,0,30,21
1656859850418,MATH 18,A01,083743,Cinel; Cameron Alexander,6,0,30,24
1656859850418,MATH 18,A02,083744,Cinel; Cameron Alexander,15,0,30,15
1656859850418,MATH 18,A03,083745,Cinel; Cameron Alexander,8,0,30,22
1656859850418,MATH 18,B01,083748,Rideout; David Porter,3,0,37,34
1656859850418,MATH 18,B02,083749,Rideout; David Porter,3,0,36,33
1656859850418,MATH 18,B03,083750,Rideout; David Porter,2,0,37,35
1656859850418,MATH 18,B04,083751,Rideout; David Porter,5,0,36,31
1656859850418,MATH 18,B05,093473,Rideout; David Porter,4,0,36,32
1656859850418,MATH 18,B06,093474,Rideout; David Porter,5,0,36,31
1656859856445,MATH 20A,A01,083754,Zheng; Zequn,12,0,40,28
1656859862473,MATH 20B,A01,083756,Briones; Jor-el Thomas Caparas,1,0,36,35
1656859862473,MATH 20B,A02,083757,Briones; Jor-el Thomas Caparas,1,0,36,35
1656859862473,MATH 20B,A03,093475,Briones; Jor-el Thomas Caparas,0,0,36,36
1656859868498,MATH 20C,A01,083760,Briones; Jor-el Thomas Caparas,1,0,35,34
1656859868498,MATH 20C,A02,083761,Briones; Jor-el Thomas Caparas,8,0,35,27
1656859868498,MATH 20C,A03,093476,Briones; Jor-el Thomas Caparas,0,1,36,36
1656859868498,MATH 20C,B01,083762,Bach; Quang Tran,0,0,30,30
1656859874522,MATH 20D,A01,083765,Tran; Brian Kha,4,0,30,26
1656859874522,MATH 20D,A02,083766,Tran; Brian Kha,4,0,30,26
1656859874522,MATH 20D,A03,083767,Tran; Brian Kha,2,0,30,28
1656859880546,MATH 20E,A01,083771,Ganguly; Soumya,5,0,32,27
1656859880546,MATH 20E,A02,083772,Ganguly; Soumya,6,0,32,26
1656859880546,MATH 20E,B01,083773,Ciotti; Benjamin,18,0,35,17
1656859880546,MATH 20E,B02,083774,Ciotti; Benjamin,17,0,35,18
1656859886570,MATH 103A,A01,083777,Greenfeld; Be'Eri,2,0,36,34
1656859886570,MATH 103A,A02,083778,Greenfeld; Be'Eri,5,0,36,31
1656859886570,MATH 103A,A03,093561,Greenfeld; Be'Eri,4,0,36,32
1656859886570,MATH 103A,B01,083779,Greenfeld; Be'Eri,6,0,36,30
1656859886570,MATH 103A,B02,083780,Greenfeld; Be'Eri,2,0,36,34
1656859886570,MATH 103A,B03,093562,Greenfeld; Be'Eri,2,0,36,34
1656859892603,MATH 105,A01,085443,Carter; Anne Toulson,13,0,35,22
1656859892603,MATH 105,A02,093477,Carter; Anne Toulson,20,0,35,15
1656859898628,MATH 109,A01,083213,Ganzberger; Geoffrey Michael,2,0,34,32
1656859898628,MATH 109,A02,083214,Ganzberger; Geoffrey Michael,2,0,34,32
1656859898628,MATH 109,A03,093478,Ganzberger; Geoffrey Michael,1,0,34,33
1656859898628,MATH 109,B01,083215,Ganzberger; Geoffrey Michael,1,0,32,31
1656859898628,MATH 109,B02,083216,Ganzberger; Geoffrey Michael,1,0,32,31
1656859898628,MATH 109,B03,093479,Ganzberger; Geoffrey Michael,6,0,32,26
1656859904654,MATH 142A,A01,083219,Chow; Bennett,6,0,32,26
1656859904654,MATH 142A,A02,083220,Chow; Bennett,9,0,32,23
1656859904654,MATH 142A,A03,093480,Chow; Bennett,7,0,32,25
1656859904654,MATH 142A,B03,093481,Chow; Bennett,7,0,32,25
1656859904654,MATH 142A,B04,093558,Chow; Bennett,10,0,32,22
1656859904654,MATH 142A,B05,093559,Chow; Bennett,6,0,32,26
1656859910688,MATH 193A,A01,083224,Rotar; Vladimir,6,0,34,28
1656859910688,MATH 193A,A02,083225,Rotar; Vladimir,3,0,34,31
1656859910688,MATH 193A,A03,083781,Rotar; Vladimir,1,0,34,33
1656859910688,MATH 193A,A04,083782,Rotar; Vladimir,6,0,34,28
1656859910688,MATH 193A,A05,093482,Rotar; Vladimir,6,0,34,28
1656859916712,MATH 197,001,091859,McAuley; Julian John,9999,0,9999,0
1656859916712,MATH 197,002,095566,Kedlaya; Kiran S.,9997,0,9999,2
1656859916712,MATH 197,003,095567,Xiao; Ming,9999,0,9999,0
1656859916712,MATH 197,004,095571,Perols; Johan Lars,9998,0,9999,1
1656859923785,COGS 9,A01,083615,Shannon; Kyle Michael,6,0,75,69
1656859929809,COGS 11,A01,083617,Boyle; Mary E. T.,18,0,48,30
1656859935834,COGS 13,A01,083071,Bastos; Amalia Pinkusfeld,8,0,71,63
1656859941868,COGS 14A,A01,092681,Semenuks; Arturs,0,1,100,100
1656859947895,COGS 14B,A01,083073,Cheng; Tzu-Han,5,0,63,58
1656859953925,COGS 17,A01,092677,Semenuks; Arturs,4,0,81,77
1656859959953,COGS 100,A01,083619,Allen; Michael Gordon,15,0,70,55
1656859965981,COGS 101A,A01,083621,Davis; Joshua Daniel,9,0,68,59
1656859972010,COGS 101B,A01,091572,Allen; Michael Gordon,8,0,65,57
1656859978032,COGS 101C,A01,083625,Delgado; Tania,17,0,35,18
1656859984057,COGS 107A,A01,083627,Boyle; Mary E. T.,13,0,60,47
1656859990081,COGS 118A,A01,083075,Gupta; Anjum,15,0,76,61
1656859996104,CSE 3,A50,083646,Miranda; Gregory Joseph,22,0,50,28
1656860002131,CSE 8A,A50,083650,Miranda; Gregory Joseph,17,1,56,39
1656860008155,CSE 11,A01,083080,Cao; Yingjun,4,15,40,36
1656860014177,CSE 12,A01,083652,Krause-Levy; Sophia Louisa,20,1,120,100
1656860020206,CSE 15L,A01,083654,Morris; Justin Loren,8,0,50,42
1656860020206,CSE 15L,A02,083655,Morris; Justin Loren,8,0,50,42
1656860026241,CSE 20,A01,083657,Tran; Khoa Dang,37,0,80,43
1656860032268,CSE 21,A01,095574,Bach; Quang Tran,21,0,48,27
1656860038295,CSE 30,A01,083084,Eldon; John,4,0,80,76
1656860038295,CSE 30,B01,095061,Bhaskar; Nishant,6,0,50,44
1656860044318,CSE 100,A01,083659,Cao; Yingjun,2,4,70,68
1656860050345,CSE 134B,A01,083661,Powell; Thomas Allan,19,0,100,81
1656860056369,CSE 140,A01,083663,Gungor; Onat,14,0,85,71
1656860062391,CSE 140L,A01,083088,Eldon; John,16,0,100,84
1656860068416,CSE 175,A01,083665,Kumar; Rakesh,3,0,25,22
1656860074443,CSE 190,A00,092507,Dubnov; Shlomo,7,0,20,13
1656860080466,ECE 45,A01,083139,Congero; Spencer William,5,0,75,70
1656860086494,ECE 65,A50,083695,Saad; Andrew S,12,0,30,18
1656860086494,ECE 65,A51,095125,Saad; Andrew S,25,0,26,1
1656860092518,ECE 109,A01,091882,Touri; Behrouz,16,0,70,54
1656860098546,ECE 180,A00,083140,Abi Samra; Nicholas Camill,0,0,30,30
1656860098546,ECE 180,B00,083141,Abi Samra; Nicholas Camill,0,0,30,30
1656860104570,MATH 10A,A01,083735,Patchell; Gregory David,1,0,30,29
1656860104570,MATH 10A,A02,083736,Patchell; Gregory David,20,0,30,10
1656860104570,MATH 10A,A03,083737,Patchell; Gregory David,15,0,30,15
1656860110595,MATH 10B,A01,083207,Lim; Seonhee,7,0,34,27
1656860110595,MATH 10B,A02,083208,Lim; Seonhee,9,0,35,26
1656860110595,MATH 10B,A03,093472,Lim; Seonhee,4,0,34,30
1656860110595,MATH 10B,B01,083739,Sinha; Shubham,9,0,30,21
1656860116620,MATH 18,A01,083743,Cinel; Cameron Alexander,6,0,30,24
1656860116620,MATH 18,A02,083744,Cinel; Cameron Alexander,15,0,30,15
1656860116620,MATH 18,A03,083745,Cinel; Cameron Alexander,8,0,30,22
1656860116620,MATH 18,B01,083748,Rideout; David Porter,3,0,37,34
1656860116620,MATH 18,B02,083749,Rideout; David Porter,3,0,36,33
1656860116620,MATH 18,B03,083750,Rideout; David Porter,2,0,37,35
1656860116620,MATH 18,B04,083751,Rideout; David Porter,5,0,36,31
1656860116620,MATH 18,B05,093473,Rideout; David Porter,4,0,36,32
1656860116620,MATH 18,B06,093474,Rideout; David Porter,5,0,36,31
1656860122644,MATH 20A,A01,083754,Zheng; Zequn,12,0,40,28
1656860128666,MATH 20B,A01,083756,Briones; Jor-el Thomas Caparas,1,0,36,35
1656860128666,MATH 20B,A02,083757,Briones; Jor-el Thomas Caparas,1,0,36,35
1656860128666,MATH 20B,A03,093475,Briones; Jor-el Thomas Caparas,0,0,36,36
1656860134692,MATH 20C,A01,083760,Briones; Jor-el Thomas Caparas,1,0,35,34
1656860134692,MATH 20C,A02,083761,Briones; Jor-el Thomas Caparas,8,0,35,27
1656860134692,MATH 20C,A03,093476,Briones; Jor-el Thomas Caparas,0,1,36,36
1656860134692,MATH 20C,B01,083762,Bach; Quang Tran,0,0,30,30
1656860140720,MATH 20D,A01,083765,Tran; Brian Kha,4,0,30,26
1656860140720,MATH 20D,A02,083766,Tran; Brian Kha,4,0,30,26
1656860140720,MATH 20D,A03,083767,Tran; Brian Kha,2,0,30,28
1656860146744,MATH 20E,A01,083771,Ganguly; Soumya,5,0,32,27
1656860146744,MATH 20E,A02,083772,Ganguly; Soumya,6,0,32,26
1656860146744,MATH 20E,B01,083773,Ciotti; Benjamin,18,0,35,17
1656860146744,MATH 20E,B02,083774,Ciotti; Benjamin,17,0,35,18
1656860152771,MATH 103A,A01,083777,Greenfeld; Be'Eri,2,0,36,34
1656860152771,MATH 103A,A02,083778,Greenfeld; Be'Eri,5,0,36,31
1656860152771,MATH 103A,A03,093561,Greenfeld; Be'Eri,4,0,36,32
1656860152771,MATH 103A,B01,083779,Greenfeld; Be'Eri,6,0,36,30
1656860152771,MATH 103A,B02,083780,Greenfeld; Be'Eri,2,0,36,34
1656860152771,MATH 103A,B03,093562,Greenfeld; Be'Eri,2,0,36,34
1656860158821,MATH 105,A01,085443,Carter; Anne Toulson,13,0,35,22
1656860158821,MATH 105,A02,093477,Carter; Anne Toulson,20,0,35,15
1656860164846,MATH 109,A01,083213,Ganzberger; Geoffrey Michael,2,0,34,32
1656860164846,MATH 109,A02,083214,Ganzberger; Geoffrey Michael,2,0,34,32
1656860164846,MATH 109,A03,093478,Ganzberger; Geoffrey Michael,1,0,34,33
1656860164846,MATH 109,B01,083215,Ganzberger; Geoffrey Michael,1,0,32,31
1656860164846,MATH 109,B02,083216,Ganzberger; Geoffrey Michael,1,0,32,31
1656860164846,MATH 109,B03,093479,Ganzberger; Geoffrey Michael,6,0,32,26
1656860170870,MATH 142A,A01,083219,Chow; Bennett,6,0,32,26
1656860170870,MATH 142A,A02,083220,Chow; Bennett,9,0,32,23
1656860170870,MATH 142A,A03,093480,Chow; Bennett,7,0,32,25
1656860170870,MATH 142A,B03,093481,Chow; Bennett,7,0,32,25
1656860170870,MATH 142A,B04,093558,Chow; Bennett,10,0,32,22
1656860170870,MATH 142A,B05,093559,Chow; Bennett,6,0,32,26
1656860176900,MATH 193A,A01,083224,Rotar; Vladimir,6,0,34,28
1656860176900,MATH 193A,A02,083225,Rotar; Vladimir,3,0,34,31
1656860176900,MATH 193A,A03,083781,Rotar; Vladimir,1,0,34,33
1656860176900,MATH 193A,A04,083782,Rotar; Vladimir,6,0,34,28
1656860176900,MATH 193A,A05,093482,Rotar; Vladimir,6,0,34,28
1656860182926,MATH 197,001,091859,McAuley; Julian John,9999,0,9999,0
1656860182926,MATH 197,002,095566,Kedlaya; Kiran S.,9997,0,9999,2
1656860182926,MATH 197,003,095567,Xiao; Ming,9999,0,9999,0
1656860182926,MATH 197,004,095571,Perols; Johan Lars,9998,0,9999,1
1656860189998,COGS 9,A01,083615,Shannon; Kyle Michael,6,0,75,69
1656860196024,COGS 11,A01,083617,Boyle; Mary E. T.,18,0,48,30
1656860202048,COGS 13,A01,083071,Bastos; Amalia Pinkusfeld,8,0,71,63
1656860208071,COGS 14A,A01,092681,Semenuks; Arturs,0,1,100,100
1656860214097,COGS 14B,A01,083073,Cheng; Tzu-Han,5,0,63,58
1656860220120,COGS 17,A01,092677,Semenuks; Arturs,4,0,81,77
1656860226148,COGS 100,A01,083619,Allen; Michael Gordon,15,0,70,55
1656860232179,COGS 101A,A01,083621,Davis; Joshua Daniel,9,0,68,59
1656860238203,COGS 101B,A01,091572,Allen; Michael Gordon,8,0,65,57
1656860244240,COGS 101C,A01,083625,Delgado; Tania,17,0,35,18
1656860250264,COGS 107A,A01,083627,Boyle; Mary E. T.,13,0,60,47
1656860256286,COGS 118A,A01,083075,Gupta; Anjum,15,0,76,61
1656860262315,CSE 3,A50,083646,Miranda; Gregory Joseph,22,0,50,28
1656860268409,CSE 8A,A50,083650,Miranda; Gregory Joseph,17,1,56,39
1656860274439,CSE 11,A01,083080,Cao; Yingjun,4,15,40,36
1656860280464,CSE 12,A01,083652,Krause-Levy; Sophia Louisa,20,1,120,100
1656860286489,CSE 15L,A01,083654,Morris; Justin Loren,8,0,50,42
1656860286489,CSE 15L,A02,083655,Morris; Justin Loren,8,0,50,42
1656860292512,CSE 20,A01,083657,Tran; Khoa Dang,37,0,80,43
1656860298534,CSE 21,A01,095574,Bach; Quang Tran,21,0,48,27
1656860304561,CSE 30,A01,083084,Eldon; John,4,0,80,76
1656860304561,CSE 30,B01,095061,Bhaskar; Nishant,6,0,50,44
1656860310589,CSE 100,A01,083659,Cao; Yingjun,2,4,70,68
1656860316619,CSE 134B,A01,083661,Powell; Thomas Allan,19,0,100,81
1656860322642,CSE 140,A01,083663,Gungor; Onat,14,0,85,71
1656860328665,CSE 140L,A01,083088,Eldon; John,16,0,100,84
1656860334689,CSE 175,A01,083665,Kumar; Rakesh,3,0,25,22
1656860340729,CSE 190,A00,092507,Dubnov; Shlomo,7,0,20,13
1656860346757,ECE 45,A01,083139,Congero; Spencer William,5,0,75,70
1656860352784,ECE 65,A50,083695,Saad; Andrew S,12,0,30,18
1656860352784,ECE 65,A51,095125,Saad; Andrew S,25,0,26,1
1656860358812,ECE 109,A01,091882,Touri; Behrouz,16,0,70,54
1656860364846,ECE 180,A00,083140,Abi Samra; Nicholas Camill,0,0,30,30
1656860364846,ECE 180,B00,083141,Abi Samra; Nicholas Camill,0,0,30,30
1656860370869,MATH 10A,A01,083735,Patchell; Gregory David,1,0,30,29
1656860370869,MATH 10A,A02,083736,Patchell; Gregory David,20,0,30,10
1656860370869,MATH 10A,A03,083737,Patchell; Gregory David,15,0,30,15
1656860376900,MATH 10B,A01,083207,Lim; Seonhee,7,0,34,27
1656860376900,MATH 10B,A02,083208,Lim; Seonhee,9,0,35,26
1656860376900,MATH 10B,A03,093472,Lim; Seonhee,4,0,34,30
1656860376900,MATH 10B,B01,083739,Sinha; Shubham,9,0,30,21
1656860382926,MATH 18,A01,083743,Cinel; Cameron Alexander,6,0,30,24
1656860382926,MATH 18,A02,083744,Cinel; Cameron Alexander,15,0,30,15
1656860382926,MATH 18,A03,083745,Cinel; Cameron Alexander,8,0,30,22
1656860382926,MATH 18,B01,083748,Rideout; David Porter,3,0,37,34
1656860382926,MATH 18,B02,083749,Rideout; David Porter,3,0,36,33
1656860382926,MATH 18,B03,083750,Rideout; David Porter,2,0,37,35
1656860382926,MATH 18,B04,083751,Rideout; David Porter,5,0,36,31
1656860382926,MATH 18,B05,093473,Rideout; David Porter,4,0,36,32
1656860382926,MATH 18,B06,093474,Rideout; David Porter,5,0,36,31
1656860388952,MATH 20A,A01,083754,Zheng; Zequn,12,0,40,28
1656860394982,MATH 20B,A01,083756,Briones; Jor-el Thomas Caparas,1,0,36,35
1656860394982,MATH 20B,A02,083757,Briones; Jor-el Thomas Caparas,1,0,36,35
1656860394982,MATH 20B,A03,093475,Briones; Jor-el Thomas Caparas,0,0,36,36
1656860401006,MATH 20C,A01,083760,Briones; Jor-el Thomas Caparas,1,0,35,34
1656860401006,MATH 20C,A02,083761,Briones; Jor-el Thomas Caparas,8,0,35,27
1656860401006,MATH 20C,A03,093476,Briones; Jor-el Thomas Caparas,0,1,36,36
1656860401006,MATH 20C,B01,083762,Bach; Quang Tran,0,0,30,30
1656860407031,MATH 20D,A01,083765,Tran; Brian Kha,4,0,30,26
1656860407031,MATH 20D,A02,083766,Tran; Brian Kha,4,0,30,26
1656860407031,MATH 20D,A03,083767,Tran; Brian Kha,2,0,30,28
1656860413063,MATH 20E,A01,083771,Ganguly; Soumya,5,0,32,27
1656860413063,MATH 20E,A02,083772,Ganguly; Soumya,6,0,32,26
1656860413063,MATH 20E,B01,083773,Ciotti; Benjamin,18,0,35,17
1656860413063,MATH 20E,B02,083774,Ciotti; Benjamin,17,0,35,18
1656860419088,MATH 103A,A01,083777,Greenfeld; Be'Eri,2,0,36,34
1656860419088,MATH 103A,A02,083778,Greenfeld; Be'Eri,5,0,36,31
1656860419088,MATH 103A,A03,093561,Greenfeld; Be'Eri,4,0,36,32
1656860419088,MATH 103A,B01,083779,Greenfeld; Be'Eri,6,0,36,30
1656860419088,MATH 103A,B02,083780,Greenfeld; Be'Eri,2,0,36,34
1656860419088,MATH 103A,B03,093562,Greenfeld; Be'Eri,2,0,36,34
1656860425114,MATH 105,A01,085443,Carter; Anne Toulson,13,0,35,22
1656860425114,MATH 105,A02,093477,Carter; Anne Toulson,20,0,35,15
1656860431140,MATH 109,A01,083213,Ganzberger; Geoffrey Michael,2,0,34,32
1656860431140,MATH 109,A02,083214,Ganzberger; Geoffrey Michael,2,0,34,32
1656860431140,MATH 109,A03,093478,Ganzberger; Geoffrey Michael,1,0,34,33
1656860431140,MATH 109,B01,083215,Ganzberger; Geoffrey Michael,1,0,32,31
1656860431140,MATH 109,B02,083216,Ganzberger; Geoffrey Michael,1,0,32,31
1656860431140,MATH 109,B03,093479,Ganzberger; Geoffrey Michael,6,0,32,26
1656860437166,MATH 142A,A01,083219,Chow; Bennett,6,0,32,26
1656860437166,MATH 142A,A02,083220,Chow; Bennett,9,0,32,23
1656860437166,MATH 142A,A03,093480,Chow; Bennett,7,0,32,25
1656860437166,MATH 142A,B03,093481,Chow; Bennett,7,0,32,25
1656860437166,MATH 142A,B04,093558,Chow; Bennett,10,0,32,22
1656860437166,MATH 142A,B05,093559,Chow; Bennett,6,0,32,26
1656860443192,MATH 193A,A01,083224,Rotar; Vladimir,6,0,34,28
1656860443192,MATH 193A,A02,083225,Rotar; Vladimir,3,0,34,31
1656860443192,MATH 193A,A03,083781,Rotar; Vladimir,1,0,34,33
1656860443192,MATH 193A,A04,083782,Rotar; Vladimir,6,0,34,28
1656860443192,MATH 193A,A05,093482,Rotar; Vladimir,6,0,34,28
1656860449219,MATH 197,001,091859,McAuley; Julian John,9999,0,9999,0
1656860449219,MATH 197,002,095566,Kedlaya; Kiran S.,9997,0,9999,2
1656860449219,MATH 197,003,095567,Xiao; Ming,9999,0,9999,0
1656860449219,MATH 197,004,095571,Perols; Johan Lars,9998,0,9999,1
1656860456281,COGS 9,A01,083615,Shannon; Kyle Michael,6,0,75,69
1656860462309,COGS 11,A01,083617,Boyle; Mary E. T.,18,0,48,30
1656860468333,COGS 13,A01,083071,Bastos; Amalia Pinkusfeld,8,0,71,63
1656860474357,COGS 14A,A01,092681,Semenuks; Arturs,0,1,100,100
1656860480393,COGS 14B,A01,083073,Cheng; Tzu-Han,5,0,63,58
1656860486421,COGS 17,A01,092677,Semenuks; Arturs,4,0,81,77
1656860492445,COGS 100,A01,083619,Allen; Michael Gordon,15,0,70,55
1656860498472,COGS 101A,A01,083621,Davis; Joshua Daniel,9,0,68,59
1656860504500,COGS 101B,A01,091572,Allen; Michael Gordon,8,0,65,57
1656860510523,COGS 101C,A01,083625,Delgado; Tania,17,0,35,18
1656860516549,COGS 107A,A01,083627,Boyle; Mary E. T.,13,0,60,47
1656860522573,COGS 118A,A01,083075,Gupta; Anjum,15,0,76,61
1656860528600,CSE 3,A50,083646,Miranda; Gregory Joseph,22,0,50,28
1656860534627,CSE 8A,A50,083650,Miranda; Gregory Joseph,17,1,56,39
1656860540651,CSE 11,A01,083080,Cao; Yingjun,4,15,40,36
1656860546678,CSE 12,A01,083652,Krause-Levy; Sophia Louisa,20,1,120,100
1656860552706,CSE 15L,A01,083654,Morris; Justin Loren,8,0,50,42
1656860552706,CSE 15L,A02,083655,Morris; Justin Loren,8,0,50,42
1656860558733,CSE 20,A01,083657,Tran; Khoa Dang,37,0,80,43
1656860564757,CSE 21,A01,095574,Bach; Quang Tran,21,0,48,27
1656860570788,CSE 30,A01,083084,Eldon; John,4,0,80,76
1656860570788,CSE 30,B01,095061,Bhaskar; Nishant,6,0,50,44
1656860576815,CSE 100,A01,083659,Cao; Yingjun,2,4,70,68
1656860582837,CSE 134B,A01,083661,Powell; Thomas Allan,19,0,100,81
1656860588861,CSE 140,A01,083663,Gungor; Onat,14,0,85,71
1656860594887,CSE 140L,A01,083088,Eldon; John,16,0,100,84
1656860600914,CSE 175,A01,083665,Kumar; Rakesh,3,0,25,22
1656860606938,CSE 190,A00,092507,Dubnov; Shlomo,7,0,20,13
1656860612965,ECE 45,A01,083139,Congero; Spencer William,5,0,75,70
1656860618990,ECE 65,A50,083695,Saad; Andrew S,12,0,30,18
1656860618990,ECE 65,A51,095125,Saad; Andrew S,25,0,26,1
1656860625013,ECE 109,A01,091882,Touri; Behrouz,16,0,70,54
1656860631037,ECE 180,A00,083140,Abi Samra; Nicholas Camill,0,0,30,30
1656860631037,ECE 180,B00,083141,Abi Samra; Nicholas Camill,0,0,30,30
1656860637065,MATH 10A,A01,083735,Patchell; Gregory David,1,0,30,29
1656860637065,MATH 10A,A02,083736,Patchell; Gregory David,20,0,30,10
1656860637065,MATH 10A,A03,083737,Patchell; Gregory David,15,0,30,15
1656860643094,MATH 10B,A01,083207,Lim; Seonhee,7,0,34,27
1656860643094,MATH 10B,A02,083208,Lim; Seonhee,9,0,35,26
1656860643094,MATH 10B,A03,093472,Lim; Seonhee,4,0,34,30
1656860643094,MATH 10B,B01,083739,Sinha; Shubham,9,0,30,21
1656860649119,MATH 18,A01,083743,Cinel; Cameron Alexander,6,0,30,24
1656860649119,MATH 18,A02,083744,Cinel; Cameron Alexander,15,0,30,15
1656860649119,MATH 18,A03,083745,Cinel; Cameron Alexander,8,0,30,22
1656860649119,MATH 18,B01,083748,Rideout; David Porter,3,0,37,34
1656860649119,MATH 18,B02,083749,Rideout; David Porter,3,0,36,33
1656860649119,MATH 18,B03,083750,Rideout; David Porter,2,0,37,35
1656860649119,MATH 18,B04,083751,Rideout; David Porter,5,0,36,31
1656860649119,MATH 18,B05,093473,Rideout; David Porter,4,0,36,32
1656860649119,MATH 18,B06,093474,Rideout; David Porter,5,0,36,31
1656860655147,MATH 20A,A01,083754,Zheng; Zequn,12,0,40,28
1656860661169,MATH 20B,A01,083756,Briones; Jor-el Thomas Caparas,1,0,36,35
1656860661169,MATH 20B,A02,083757,Briones; Jor-el Thomas Caparas,1,0,36,35
1656860661169,MATH 20B,A03,093475,Briones; Jor-el Thomas Caparas,0,0,36,36
1656860667192,MATH 20C,A01,083760,Briones; Jor-el Thomas Caparas,1,0,35,34
1656860667192,MATH 20C,A02,083761,Briones; Jor-el Thomas Caparas,8,0,35,27
1656860667192,MATH 20C,A03,093476,Briones; Jor-el Thomas Caparas,0,1,36,36
1656860667192,MATH 20C,B01,083762,Bach; Quang Tran,0,0,30,30
1656860673220,MATH 20D,A01,083765,Tran; Brian Kha,4,0,30,26
1656860673220,MATH 20D,A02,083766,Tran; Brian Kha,4,0,30,26
1656860673220,MATH 20D,A03,083767,Tran; Brian Kha,2,0,30,28
1656860679250,MATH 20E,A01,083771,Ganguly; Soumya,5,0,32,27
1656860679250,MATH 20E,A02,083772,Ganguly; Soumya,6,0,32,26
1656860679250,MATH 20E,B01,083773,Ciotti; Benjamin,18,0,35,17
1656860679250,MATH 20E,B02,083774,Ciotti; Benjamin,17,0,35,18
1656860685283,MATH 103A,A01,083777,Greenfeld; Be'Eri,2,0,36,34
1656860685283,MATH 103A,A02,083778,Greenfeld; Be'Eri,5,0,36,31
1656860685283,MATH 103A,A03,093561,Greenfeld; Be'Eri,4,0,36,32
1656860685283,MATH 103A,B01,083779,Greenfeld; Be'Eri,6,0,36,30
1656860685283,MATH 103A,B02,083780,Greenfeld; Be'Eri,2,0,36,34
1656860685283,MATH 103A,B03,093562,Greenfeld; Be'Eri,2,0,36,34
1656860691307,MATH 105,A01,085443,Carter; Anne Toulson,13,0,35,22
1656860691307,MATH 105,A02,093477,Carter; Anne Toulson,20,0,35,15
1656860697335,MATH 109,A01,083213,Ganzberger; Geoffrey Michael,2,0,34,32
1656860697335,MATH 109,A02,083214,Ganzberger; Geoffrey Michael,2,0,34,32
1656860697335,MATH 109,A03,093478,Ganzberger; Geoffrey Michael,1,0,34,33
1656860697335,MATH 109,B01,083215,Ganzberger; Geoffrey Michael,1,0,32,31
1656860697335,MATH 109,B02,083216,Ganzberger; Geoffrey Michael,1,0,32,31
1656860697335,MATH 109,B03,093479,Ganzberger; Geoffrey Michael,6,0,32,26
1656860703360,MATH 142A,A01,083219,Chow; Bennett,6,0,32,26
1656860703360,MATH 142A,A02,083220,Chow; Bennett,9,0,32,23
1656860703360,MATH 142A,A03,093480,Chow; Bennett,7,0,32,25
1656860703360,MATH 142A,B03,093481,Chow; Bennett,7,0,32,25
1656860703360,MATH 142A,B04,093558,Chow; Bennett,10,0,32,22
1656860703360,MATH 142A,B05,093559,Chow; Bennett,6,0,32,26
1656860709385,MATH 193A,A01,083224,Rotar; Vladimir,6,0,34,28
1656860709385,MATH 193A,A02,083225,Rotar; Vladimir,3,0,34,31
1656860709385,MATH 193A,A03,083781,Rotar; Vladimir,1,0,34,33
1656860709385,MATH 193A,A04,083782,Rotar; Vladimir,6,0,34,28
1656860709385,MATH 193A,A05,093482,Rotar; Vladimir,6,0,34,28
1656860715409,MATH 197,001,091859,McAuley; Julian John,9999,0,9999,0
1656860715409,MATH 197,002,095566,Kedlaya; Kiran S.,9997,0,9999,2
1656860715409,MATH 197,003,095567,Xiao; Ming,9999,0,9999,0
1656860715409,MATH 197,004,095571,Perols; Johan Lars,9998,0,9999,1
1656860722464,COGS 9,A01,083615,Shannon; Kyle Michael,6,0,75,69
1656860728489,COGS 11,A01,083617,Boyle; Mary E. T.,18,0,48,30
1656860734529,COGS 13,A01,083071,Bastos; Amalia Pinkusfeld,8,0,71,63
1656860740551,COGS 14A,A01,092681,Semenuks; Arturs,0,1,100,100
1656860746574,COGS 14B,A01,083073,Cheng; Tzu-Han,5,0,63,58
1656860752607,COGS 17,A01,092677,Semenuks; Arturs,4,0,81,77
1656860758630,COGS 100,A01,083619,Allen; Michael Gordon,15,0,70,55
1656860764652,COGS 101A,A01,083621,Davis; Joshua Daniel,9,0,68,59
1656860770674,COGS 101B,A01,091572,Allen; Michael Gordon,8,0,65,57
1656860776700,COGS 101C,A01,083625,Delgado; Tania,17,0,35,18
1656860782725,COGS 107A,A01,083627,Boyle; Mary E. T.,13,0,60,47
1656860788763,COGS 118A,A01,083075,Gupta; Anjum,15,0,76,61
1656860794785,CSE 3,A50,083646,Miranda; Gregory Joseph,22,0,50,28
1656860800807,CSE 8A,A50,083650,Miranda; Gregory Joseph,17,1,56,39
1656860806860,CSE 11,A01,083080,Cao; Yingjun,4,15,40,36
1656860812887,CSE 12,A01,083652,Krause-Levy; Sophia Louisa,20,1,120,100
1656860818909,CSE 15L,A01,083654,Morris; Justin Loren,8,0,50,42
1656860818909,CSE 15L,A02,083655,Morris; Justin Loren,8,0,50,42
1656860824938,CSE 20,A01,083657,Tran; Khoa Dang,37,0,80,43
1656860830965,CSE 21,A01,095574,Bach; Quang Tran,21,0,48,27
1656860836991,CSE 30,A01,083084,Eldon; John,4,0,80,76
1656860836991,CSE 30,B01,095061,Bhaskar; Nishant,6,0,50,44
1656860843017,CSE 100,A01,083659,Cao; Yingjun,2,4,70,68
1656860849040,CSE 134B,A01,083661,Powell; Thomas Allan,19,0,100,81
1656860855065,CSE 140,A01,083663,Gungor; Onat,14,0,85,71
1656860861088,CSE 140L,A01,083088,Eldon; John,16,0,100,84
1656860867208,CSE 175,A01,083665,Kumar; Rakesh,3,0,25,22
1656860873238,CSE 190,A00,092507,Dubnov; Shlomo,7,0,20,13
1656860879264,ECE 45,A01,083139,Congero; Spencer William,5,0,75,70
1656860885313,ECE 65,A50,083695,Saad; Andrew S,12,0,30,18
1656860885313,ECE 65,A51,095125,Saad; Andrew S,25,0,26,1
1656860891337,ECE 109,A01,091882,Touri; Behrouz,16,0,70,54
1656860897362,ECE 180,A00,083140,Abi Samra; Nicholas Camill,0,0,30,30
1656860897362,ECE 180,B00,083141,Abi Samra; Nicholas Camill,0,0,30,30
1656860903386,MATH 10A,A01,083735,Patchell; Gregory David,1,0,30,29
1656860903386,MATH 10A,A02,083736,Patchell; Gregory David,20,0,30,10
1656860903386,MATH 10A,A03,083737,Patchell; Gregory David,15,0,30,15
1656860909413,MATH 10B,A01,083207,Lim; Seonhee,7,0,34,27
1656860909413,MATH 10B,A02,083208,Lim; Seonhee,9,0,35,26
1656860909413,MATH 10B,A03,093472,Lim; Seonhee,4,0,34,30
1656860909413,MATH 10B,B01,083739,Sinha; Shubham,9,0,30,21
1656860915439,MATH 18,A01,083743,Cinel; Cameron Alexander,6,0,30,24
1656860915439,MATH 18,A02,083744,Cinel; Cameron Alexander,15,0,30,15
1656860915439,MATH 18,A03,083745,Cinel; Cameron Alexander,8,0,30,22
1656860915439,MATH 18,B01,083748,Rideout; David Porter,3,0,37,34
1656860915439,MATH 18,B02,083749,Rideout; David Porter,3,0,36,33
1656860915439,MATH 18,B03,083750,Rideout; David Porter,2,0,37,35
1656860915439,MATH 18,B04,083751,Rideout; David Porter,5,0,36,31
1656860915439,MATH 18,B05,093473,Rideout; David Porter,4,0,36,32
1656860915439,MATH 18,B06,093474,Rideout; David Porter,5,0,36,31
1656860921472,MATH 20A,A01,083754,Zheng; Zequn,12,0,40,28
1656860927500,MATH 20B,A01,083756,Briones; Jor-el Thomas Caparas,1,0,36,35
1656860927500,MATH 20B,A02,083757,Briones; Jor-el Thomas Caparas,1,0,36,35
1656860927500,MATH 20B,A03,093475,Briones; Jor-el Thomas Caparas,0,0,36,36
1656860933524,MATH 20C,A01,083760,Briones; Jor-el Thomas Caparas,1,0,35,34
1656860933524,MATH 20C,A02,083761,Briones; Jor-el Thomas Caparas,8,0,35,27
1656860933524,MATH 20C,A03,093476,Briones; Jor-el Thomas Caparas,0,1,36,36
1656860933524,MATH 20C,B01,083762,Bach; Quang Tran,0,0,30,30
1656860939548,MATH 20D,A01,083765,Tran; Brian Kha,4,0,30,26
1656860939548,MATH 20D,A02,083766,Tran; Brian Kha,4,0,30,26
1656860939548,MATH 20D,A03,083767,Tran; Brian Kha,2,0,30,28
1656860945578,MATH 20E,A01,083771,Ganguly; Soumya,5,0,32,27
1656860945578,MATH 20E,A02,083772,Ganguly; Soumya,6,0,32,26
1656860945578,MATH 20E,B01,083773,Ciotti; Benjamin,18,0,35,17
1656860945578,MATH 20E,B02,083774,Ciotti; Benjamin,17,0,35,18
1656860951610,MATH 103A,A01,083777,Greenfeld; Be'Eri,2,0,36,34
1656860951610,MATH 103A,A02,083778,Greenfeld; Be'Eri,5,0,36,31
1656860951610,MATH 103A,A03,093561,Greenfeld; Be'Eri,4,0,36,32
1656860951610,MATH 103A,B01,083779,Greenfeld; Be'Eri,6,0,36,30
1656860951610,MATH 103A,B02,083780,Greenfeld; Be'Eri,2,0,36,34
1656860951610,MATH 103A,B03,093562,Greenfeld; Be'Eri,2,0,36,34
1656860957635,MATH 105,A01,085443,Carter; Anne Toulson,13,0,35,22
1656860957635,MATH 105,A02,093477,Carter; Anne Toulson,20,0,35,15
1656860963658,MATH 109,A01,083213,Ganzberger; Geoffrey Michael,2,0,34,32
1656860963658,MATH 109,A02,083214,Ganzberger; Geoffrey Michael,2,0,34,32
1656860963658,MATH 109,A03,093478,Ganzberger; Geoffrey Michael,1,0,34,33
1656860963658,MATH 109,B01,083215,Ganzberger; Geoffrey Michael,1,0,32,31
1656860963658,MATH 109,B02,083216,Ganzberger; Geoffrey Michael,1,0,32,31
1656860963658,MATH 109,B03,093479,Ganzberger; Geoffrey Michael,6,0,32,26
1656860969695,MATH 142A,A01,083219,Chow; Bennett,6,0,32,26
1656860969695,MATH 142A,A02,083220,Chow; Bennett,9,0,32,23
1656860969695,MATH 142A,A03,093480,Chow; Bennett,7,0,32,25
1656860969695,MATH 142A,B03,093481,Chow; Bennett,7,0,32,25
1656860969695,MATH 142A,B04,093558,Chow; Bennett,10,0,32,22
1656860969695,MATH 142A,B05,093559,Chow; Bennett,6,0,32,26
1656860975720,MATH 193A,A01,083224,Rotar; Vladimir,6,0,34,28
1656860975720,MATH 193A,A02,083225,Rotar; Vladimir,3,0,34,31
1656860975720,MATH 193A,A03,083781,Rotar; Vladimir,1,0,34,33
1656860975720,MATH 193A,A04,083782,Rotar; Vladimir,6,0,34,28
1656860975720,MATH 193A,A05,093482,Rotar; Vladimir,6,0,34,28
1656860981743,MATH 197,001,091859,McAuley; Julian John,9999,0,9999,0
1656860981743,MATH 197,002,095566,Kedlaya; Kiran S.,9997,0,9999,2
1656860981743,MATH 197,003,095567,Xiao; Ming,9999,0,9999,0
1656860981743,MATH 197,004,095571,Perols; Johan Lars,9998,0,9999,1
1656860988802,COGS 9,A01,083615,Shannon; Kyle Michael,6,0,75,69
1656860994830,COGS 11,A01,083617,Boyle; Mary E. T.,18,0,48,30
1656861000858,COGS 13,A01,083071,Bastos; Amalia Pinkusfeld,8,0,71,63
1656861006882,COGS 14A,A01,092681,Semenuks; Arturs,0,1,100,100
1656861012909,COGS 14B,A01,083073,Cheng; Tzu-Han,5,0,63,58
1656861018932,COGS 17,A01,092677,Semenuks; Arturs,4,0,81,77
1656861024960,COGS 100,A01,083619,Allen; Michael Gordon,15,0,70,55
1656861030987,COGS 101A,A01,083621,Davis; Joshua Daniel,9,0,68,59
1656861037017,COGS 101B,A01,091572,Allen; Michael Gordon,8,0,65,57
1656861043041,COGS 101C,A01,083625,Delgado; Tania,17,0,35,18
1656861049068,COGS 107A,A01,083627,Boyle; Mary E. T.,13,0,60,47
1656861055093,COGS 118A,A01,083075,Gupta; Anjum,15,0,76,61
1656861061116,CSE 3,A50,083646,Miranda; Gregory Joseph,22,0,50,28
1656861067139,CSE 8A,A50,083650,Miranda; Gregory Joseph,17,1,56,39
1656861073170,CSE 11,A01,083080,Cao; Yingjun,4,15,40,36
1656861079199,CSE 12,A01,083652,Krause-Levy; Sophia Louisa,20,1,120,100
1656861085226,CSE 15L,A01,083654,Morris; Justin Loren,8,0,50,42
1656861085226,CSE 15L,A02,083655,Morris; Justin Loren,8,0,50,42
1656861091249,CSE 20,A01,083657,Tran; Khoa Dang,37,0,80,43
1656861097280,CSE 21,A01,095574,Bach; Quang Tran,21,0,48,27
1656861103307,CSE 30,A01,083084,Eldon; John,4,0,80,76
1656861103307,CSE 30,B01,095061,Bhaskar; Nishant,6,0,50,44
1656861109338,CSE 100,A01,083659,Cao; Yingjun,2,4,70,68
1656861115367,CSE 134B,A01,083661,Powell; Thomas Allan,19,0,100,81
1656861121390,CSE 140,A01,083663,Gungor; Onat,14,0,85,71
1656861127414,CSE 140L,A01,083088,Eldon; John,16,0,100,84
1656861133437,CSE 175,A01,083665,Kumar; Rakesh,3,0,25,22
1656861139472,CSE 190,A00,092507,Dubnov; Shlomo,7,0,20,13
1656861145497,ECE 45,A01,083139,Congero; Spencer William,5,0,75,70
1656861151524,ECE 65,A50,083695,Saad; Andrew S,12,0,30,18
1656861151524,ECE 65,A51,095125,Saad; Andrew S,25,0,26,1
1656861157555,ECE 109,A01,091882,Touri; Behrouz,16,0,70,54
1656861163579,ECE 180,A00,083140,Abi Samra; Nicholas Camill,0,0,30,30
1656861163579,ECE 180,B00,083141,Abi Samra; Nicholas Camill,0,0,30,30
1656861169608,MATH 10A,A01,083735,Patchell; Gregory David,1,0,30,29
1656861169608,MATH 10A,A02,083736,Patchell; Gregory David,20,0,30,10
1656861169608,MATH 10A,A03,083737,Patchell; Gregory David,15,0,30,15
1656861175631,MATH 10B,A01,083207,Lim; Seonhee,7,0,34,27
1656861175631,MATH 10B,A02,083208,Lim; Seonhee,9,0,35,26
1656861175631,MATH 10B,A03,093472,Lim; Seonhee,4,0,34,30
1656861175631,MATH 10B,B01,083739,Sinha; Shubham,9,0,30,21
1656861181656,MATH 18,A01,083743,Cinel; Cameron Alexander,6,0,30,24
1656861181656,MATH 18,A02,083744,Cinel; Cameron Alexander,15,0,30,15
1656861181656,MATH 18,A03,083745,Cinel; Cameron Alexander,8,0,30,22
1656861181656,MATH 18,B01,083748,Rideout; David Porter,3,0,37,34
1656861181656,MATH 18,B02,083749,Rideout; David Porter,3,0,36,33
1656861181656,MATH 18,B03,083750,Rideout; David Porter,2,0,37,35
1656861181656,MATH 18,B04,083751,Rideout; David Porter,5,0,36,31
1656861181656,MATH 18,B05,093473,Rideout; David Porter,4,0,36,32
1656861181656,MATH 18,B06,093474,Rideout; David Porter,5,0,36,31
1656861187690,MATH 20A,A01,083754,Zheng; Zequn,12,0,40,28
1656861193713,MATH 20B,A01,083756,Briones; Jor-el Thomas Caparas,1,0,36,35
1656861193713,MATH 20B,A02,083757,Briones; Jor-el Thomas Caparas,1,0,36,35
1656861193713,MATH 20B,A03,093475,Briones; Jor-el Thomas Caparas,0,0,36,36
1656861199736,MATH 20C,A01,083760,Briones; Jor-el Thomas Caparas,1,0,35,34
1656861199736,MATH 20C,A02,083761,Briones; Jor-el Thomas Caparas,8,0,35,27
1656861199736,MATH 20C,A03,093476,Briones; Jor-el Thomas Caparas,0,1,36,36
1656861199736,MATH 20C,B01,083762,Bach; Quang Tran,0,0,30,30
1656861205758,MATH 20D,A01,083765,Tran; Brian Kha,4,0,30,26
1656861205758,MATH 20D,A02,083766,Tran; Brian Kha,4,0,30,26
1656861205758,MATH 20D,A03,083767,Tran; Brian Kha,2,0,30,28
1656861211780,MATH 20E,A01,083771,Ganguly; Soumya,5,0,32,27
1656861211780,MATH 20E,A02,083772,Ganguly; Soumya,6,0,32,26
1656861211780,MATH 20E,B01,083773,Ciotti; Benjamin,18,0,35,17
1656861211780,MATH 20E,B02,083774,Ciotti; Benjamin,17,0,35,18
1656861217802,MATH 103A,A01,083777,Greenfeld; Be'Eri,2,0,36,34
1656861217802,MATH 103A,A02,083778,Greenfeld; Be'Eri,5,0,36,31
1656861217802,MATH 103A,A03,093561,Greenfeld; Be'Eri,4,0,36,32
1656861217802,MATH 103A,B01,083779,Greenfeld; Be'Eri,6,0,36,30
1656861217802,MATH 103A,B02,083780,Greenfeld; Be'Eri,2,0,36,34
1656861217802,MATH 103A,B03,093562,Greenfeld; Be'Eri,2,0,36,34
1656861223827,MATH 105,A01,085443,Carter; Anne Toulson,13,0,35,22
1656861223827,MATH 105,A02,093477,Carter; Anne Toulson,20,0,35,15
1656861229849,MATH 109,A01,083213,Ganzberger; Geoffrey Michael,2,0,34,32
1656861229849,MATH 109,A02,083214,Ganzberger; Geoffrey Michael,2,0,34,32
1656861229849,MATH 109,A03,093478,Ganzberger; Geoffrey Michael,1,0,34,33
1656861229849,MATH 109,B01,083215,Ganzberger; Geoffrey Michael,1,0,32,31
1656861229849,MATH 109,B02,083216,Ganzberger; Geoffrey Michael,1,0,32,31
1656861229849,MATH 109,B03,093479,Ganzberger; Geoffrey Michael,6,0,32,26
1656861235881,MATH 142A,A01,083219,Chow; Bennett,6,0,32,26
1656861235881,MATH 142A,A02,083220,Chow; Bennett,9,0,32,23
1656861235881,MATH 142A,A03,093480,Chow; Bennett,7,0,32,25
1656861235881,MATH 142A,B03,093481,Chow; Bennett,7,0,32,25
1656861235881,MATH 142A,B04,093558,Chow; Bennett,10,0,32,22
1656861235881,MATH 142A,B05,093559,Chow; Bennett,6,0,32,26
1656861241921,MATH 193A,A01,083224,Rotar; Vladimir,6,0,34,28
1656861241921,MATH 193A,A02,083225,Rotar; Vladimir,3,0,34,31
1656861241921,MATH 193A,A03,083781,Rotar; Vladimir,1,0,34,33
1656861241921,MATH 193A,A04,083782,Rotar; Vladimir,6,0,34,28
1656861241921,MATH 193A,A05,093482,Rotar; Vladimir,6,0,34,28
1656861247951,MATH 197,001,091859,McAuley; Julian John,9999,0,9999,0
1656861247951,MATH 197,002,095566,Kedlaya; Kiran S.,9997,0,9999,2
1656861247951,MATH 197,003,095567,Xiao; Ming,9999,0,9999,0
1656861247951,MATH 197,004,095571,Perols; Johan Lars,9998,0,9999,1
1656861255026,COGS 9,A01,083615,Shannon; Kyle Michael,6,0,75,69
1656861261050,COGS 11,A01,083617,Boyle; Mary E. T.,18,0,48,30
1656861267077,COGS 13,A01,083071,Bastos; Amalia Pinkusfeld,8,0,71,63
1656861273103,COGS 14A,A01,092681,Semenuks; Arturs,0,1,100,100
1656861279126,COGS 14B,A01,083073,Cheng; Tzu-Han,5,0,63,58
1656861285148,COGS 17,A01,092677,Semenuks; Arturs,4,0,81,77
1656861291176,COGS 100,A01,083619,Allen; Michael Gordon,15,0,70,55
1656861297201,COGS 101A,A01,083621,Davis; Joshua Daniel,9,0,68,59
1656861303223,COGS 101B,A01,091572,Allen; Michael Gordon,8,0,65,57
1656861309249,COGS 101C,A01,083625,Delgado; Tania,17,0,35,18
1656861315285,COGS 107A,A01,083627,Boyle; Mary E. T.,13,0,60,47
1656861321308,COGS 118A,A01,083075,Gupta; Anjum,15,0,76,61
1656861327333,CSE 3,A50,083646,Miranda; Gregory Joseph,22,0,50,28
1656861333357,CSE 8A,A50,083650,Miranda; Gregory Joseph,17,1,56,39
1656861339381,CSE 11,A01,083080,Cao; Yingjun,4,15,40,36
1656861345404,CSE 12,A01,083652,Krause-Levy; Sophia Louisa,20,1,120,100
1656861351432,CSE 15L,A01,083654,Morris; Justin Loren,8,0,50,42
1656861351432,CSE 15L,A02,083655,Morris; Justin Loren,8,0,50,42
1656861357458,CSE 20,A01,083657,Tran; Khoa Dang,37,0,80,43
1656861363485,CSE 21,A01,095574,Bach; Quang Tran,21,0,48,27
1656861369512,CSE 30,A01,083084,Eldon; John,4,0,80,76
1656861369512,CSE 30,B01,095061,Bhaskar; Nishant,6,0,50,44
1656861375540,CSE 100,A01,083659,Cao; Yingjun,2,4,70,68
1656861381563,CSE 134B,A01,083661,Powell; Thomas Allan,19,0,100,81
1656861387588,CSE 140,A01,083663,Gungor; Onat,14,0,85,71
1656861393614,CSE 140L,A01,083088,Eldon; John,16,0,100,84
1656861399648,CSE 175,A01,083665,Kumar; Rakesh,3,0,25,22
1656861405672,CSE 190,A00,092507,Dubnov; Shlomo,7,0,20,13
1656861411697,ECE 45,A01,083139,Congero; Spencer William,5,0,75,70
1656861417722,ECE 65,A50,083695,Saad; Andrew S,12,0,30,18
1656861417722,ECE 65,A51,095125,Saad; Andrew S,25,0,26,1
1656861423750,ECE 109,A01,091882,Touri; Behrouz,16,0,70,54
1656861429778,ECE 180,A00,083140,Abi Samra; Nicholas Camill,0,0,30,30
1656861429778,ECE 180,B00,083141,Abi Samra; Nicholas Camill,0,0,30,30
1656861435801,MATH 10A,A01,083735,Patchell; Gregory David,1,0,30,29
1656861435801,MATH 10A,A02,083736,Patchell; Gregory David,20,0,30,10
1656861435801,MATH 10A,A03,083737,Patchell; Gregory David,15,0,30,15
1656861441830,MATH 10B,A01,083207,Lim; Seonhee,7,0,34,27
1656861441830,MATH 10B,A02,083208,Lim; Seonhee,9,0,35,26
1656861441830,MATH 10B,A03,093472,Lim; Seonhee,4,0,34,30
1656861441830,MATH 10B,B01,083739,Sinha; Shubham,9,0,30,21
1656861447855,MATH 18,A01,083743,Cinel; Cameron Alexander,6,0,30,24
1656861447855,MATH 18,A02,083744,Cinel; Cameron Alexander,15,0,30,15
1656861447855,MATH 18,A03,083745,Cinel; Cameron Alexander,8,0,30,22
1656861447855,MATH 18,B01,083748,Rideout; David Porter,3,0,37,34
1656861447855,MATH 18,B02,083749,Rideout; David Porter,3,0,36,33
1656861447855,MATH 18,B03,083750,Rideout; David Porter,2,0,37,35
1656861447855,MATH 18,B04,083751,Rideout; David Porter,5,0,36,31
1656861447855,MATH 18,B05,093473,Rideout; David Porter,4,0,36,32
1656861447855,MATH 18,B06,093474,Rideout; David Porter,5,0,36,31
1656861453877,MATH 20A,A01,083754,Zheng; Zequn,12,0,40,28
1656861459917,MATH 20B,A01,083756,Briones; Jor-el Thomas Caparas,1,0,36,35
1656861459917,MATH 20B,A02,083757,Briones; Jor-el Thomas Caparas,1,0,36,35
1656861459917,MATH 20B,A03,093475,Briones; Jor-el Thomas Caparas,0,0,36,36
1656861466036,MATH 20C,A01,083760,Briones; Jor-el Thomas Caparas,1,0,35,34
1656861466036,MATH 20C,A02,083761,Briones; Jor-el Thomas Caparas,8,0,35,27
1656861466036,MATH 20C,A03,093476,Briones; Jor-el Thomas Caparas,0,1,36,36
1656861466036,MATH 20C,B01,083762,Bach; Quang Tran,0,0,30,30
1656861472061,MATH 20D,A01,083765,Tran; Brian Kha,4,0,30,26
1656861472061,MATH 20D,A02,083766,Tran; Brian Kha,4,0,30,26
1656861472061,MATH 20D,A03,083767,Tran; Brian Kha,2,0,30,28
1656861478087,MATH 20E,A01,083771,Ganguly; Soumya,5,0,32,27
1656861478087,MATH 20E,A02,083772,Ganguly; Soumya,6,0,32,26
1656861478087,MATH 20E,B01,083773,Ciotti; Benjamin,18,0,35,17
1656861478087,MATH 20E,B02,083774,Ciotti; Benjamin,17,0,35,18
1656861484121,MATH 103A,A01,083777,Greenfeld; Be'Eri,2,0,36,34
1656861484121,MATH 103A,A02,083778,Greenfeld; Be'Eri,5,0,36,31
1656861484121,MATH 103A,A03,093561,Greenfeld; Be'Eri,4,0,36,32
1656861484121,MATH 103A,B01,083779,Greenfeld; Be'Eri,6,0,36,30
1656861484121,MATH 103A,B02,083780,Greenfeld; Be'Eri,2,0,36,34
1656861484121,MATH 103A,B03,093562,Greenfeld; Be'Eri,2,0,36,34
1656861490146,MATH 105,A01,085443,Carter; Anne Toulson,13,0,35,22
1656861490146,MATH 105,A02,093477,Carter; Anne Toulson,20,0,35,15
1656861496171,MATH 109,A01,083213,Ganzberger; Geoffrey Michael,2,0,34,32
1656861496171,MATH 109,A02,083214,Ganzberger; Geoffrey Michael,2,0,34,32
1656861496171,MATH 109,A03,093478,Ganzberger; Geoffrey Michael,1,0,34,33
1656861496171,MATH 109,B01,083215,Ganzberger; Geoffrey Michael,1,0,32,31
1656861496171,MATH 109,B02,083216,Ganzberger; Geoffrey Michael,1,0,32,31
1656861496171,MATH 109,B03,093479,Ganzberger; Geoffrey Michael,6,0,32,26
1656861502194,MATH 142A,A01,083219,Chow; Bennett,6,0,32,26
1656861502194,MATH 142A,A02,083220,Chow; Bennett,9,0,32,23
1656861502194,MATH 142A,A03,093480,Chow; Bennett,7,0,32,25
1656861502194,MATH 142A,B03,093481,Chow; Bennett,7,0,32,25
1656861502194,MATH 142A,B04,093558,Chow; Bennett,10,0,32,22
1656861502194,MATH 142A,B05,093559,Chow; Bennett,6,0,32,26
1656861508223,MATH 193A,A01,083224,Rotar; Vladimir,6,0,34,28
1656861508223,MATH 193A,A02,083225,Rotar; Vladimir,3,0,34,31
1656861508223,MATH 193A,A03,083781,Rotar; Vladimir,1,0,34,33
1656861508223,MATH 193A,A04,083782,Rotar; Vladimir,6,0,34,28
1656861508223,MATH 193A,A05,093482,Rotar; Vladimir,6,0,34,28
1656861514248,MATH 197,001,091859,McAuley; Julian John,9999,0,9999,0
1656861514248,MATH 197,002,095566,Kedlaya; Kiran S.,9997,0,9999,2
1656861514248,MATH 197,003,095567,Xiao; Ming,9999,0,9999,0
1656861514248,MATH 197,004,095571,Perols; Johan Lars,9998,0,9999,1
1656861521318,COGS 9,A01,083615,Shannon; Kyle Michael,6,0,75,69
1656861527342,COGS 11,A01,083617,Boyle; Mary E. T.,18,0,48,30
1656861533368,COGS 13,A01,083071,Bastos; Amalia Pinkusfeld,8,0,71,63
1656861539391,COGS 14A,A01,092681,Semenuks; Arturs,0,1,100,100
1656861545415,COGS 14B,A01,083073,Cheng; Tzu-Han,5,0,63,58
1656861551439,COGS 17,A01,092677,Semenuks; Arturs,4,0,81,77
1656861557463,COGS 100,A01,083619,Allen; Michael Gordon,15,0,70,55
1656861563491,COGS 101A,A01,083621,Davis; Joshua Daniel,9,0,68,59
1656861569515,COGS 101B,A01,091572,Allen; Michael Gordon,8,0,65,57
1656861575539,COGS 101C,A01,083625,Delgado; Tania,17,0,35,18
1656861581562,COGS 107A,A01,083627,Boyle; Mary E. T.,13,0,60,47
1656861587585,COGS 118A,A01,083075,Gupta; Anjum,15,0,76,61
1656861593609,CSE 3,A50,083646,Miranda; Gregory Joseph,22,0,50,28
1656861599636,CSE 8A,A50,083650,Miranda; Gregory Joseph,17,1,56,39
1656861605664,CSE 11,A01,083080,Cao; Yingjun,4,15,40,36
1656861611687,CSE 12,A01,083652,Krause-Levy; Sophia Louisa,20,1,120,100
1656861617717,CSE 15L,A01,083654,Morris; Justin Loren,8,0,50,42
1656861617717,CSE 15L,A02,083655,Morris; Justin Loren,8,0,50,42
1656861623744,CSE 20,A01,083657,Tran; Khoa Dang,37,0,80,43
1656861629776,CSE 21,A01,095574,Bach; Quang Tran,21,0,48,27
1656861635804,CSE 30,A01,083084,Eldon; John,4,0,80,76
1656861635804,CSE 30,B01,095061,Bhaskar; Nishant,6,0,50,44
1656861641828,CSE 100,A01,083659,Cao; Yingjun,2,4,70,68
1656861647851,CSE 134B,A01,083661,Powell; Thomas Allan,19,0,100,81
1656861653878,CSE 140,A01,083663,Gungor; Onat,14,0,85,71
1656861659903,CSE 140L,A01,083088,Eldon; John,16,0,100,84
1656861665924,CSE 175,A01,083665,Kumar; Rakesh,3,0,25,22
1656861671947,CSE 190,A00,092507,Dubnov; Shlomo,7,0,20,13
1656861677977,ECE 45,A01,083139,Congero; Spencer William,5,0,75,70
1656861684010,ECE 65,A50,083695,Saad; Andrew S,12,0,30,18
1656861684010,ECE 65,A51,095125,Saad; Andrew S,25,0,26,1
1656861690036,ECE 109,A01,091882,Touri; Behrouz,16,0,70,54
1656861696060,ECE 180,A00,083140,Abi Samra; Nicholas Camill,0,0,30,30
1656861696060,ECE 180,B00,083141,Abi Samra; Nicholas Camill,0,0,30,30
1656861702086,MATH 10A,A01,083735,Patchell; Gregory David,1,0,30,29
1656861702086,MATH 10A,A02,083736,Patchell; Gregory David,20,0,30,10
1656861702086,MATH 10A,A03,083737,Patchell; Gregory David,15,0,30,15
1656861708113,MATH 10B,A01,083207,Lim; Seonhee,7,0,34,27
1656861708113,MATH 10B,A02,083208,Lim; Seonhee,9,0,35,26
1656861708113,MATH 10B,A03,093472,Lim; Seonhee,4,0,34,30
1656861708113,MATH 10B,B01,083739,Sinha; Shubham,9,0,30,21
1656861714137,MATH 18,A01,083743,Cinel; Cameron Alexander,6,0,30,24
1656861714137,MATH 18,A02,083744,Cinel; Cameron Alexander,15,0,30,15
1656861714137,MATH 18,A03,083745,Cinel; Cameron Alexander,8,0,30,22
1656861714137,MATH 18,B01,083748,Rideout; David Porter,3,0,37,34
1656861714137,MATH 18,B02,083749,Rideout; David Porter,3,0,36,33
1656861714137,MATH 18,B03,083750,Rideout; David Porter,2,0,37,35
1656861714137,MATH 18,B04,083751,Rideout; David Porter,5,0,36,31
1656861714137,MATH 18,B05,093473,Rideout; David Porter,4,0,36,32
1656861714137,MATH 18,B06,093474,Rideout; David Porter,5,0,36,31
1656861720164,MATH 20A,A01,083754,Zheng; Zequn,12,0,40,28
1656861726189,MATH 20B,A01,083756,Briones; Jor-el Thomas Caparas,1,0,36,35
1656861726189,MATH 20B,A02,083757,Briones; Jor-el Thomas Caparas,1,0,36,35
1656861726189,MATH 20B,A03,093475,Briones; Jor-el Thomas Caparas,0,0,36,36
1656861732217,MATH 20C,A01,083760,Briones; Jor-el Thomas Caparas,1,0,35,34
1656861732217,MATH 20C,A02,083761,Briones; Jor-el Thomas Caparas,8,0,35,27
1656861732217,MATH 20C,A03,093476,Briones; Jor-el Thomas Caparas,0,1,36,36
1656861732217,MATH 20C,B01,083762,Bach; Quang Tran,0,0,30,30
1656861738247,MATH 20D,A01,083765,Tran; Brian Kha,4,0,30,26
1656861738247,MATH 20D,A02,083766,Tran; Brian Kha,4,0,30,26
1656861738247,MATH 20D,A03,083767,Tran; Brian Kha,2,0,30,28
1656861744275,MATH 20E,A01,083771,Ganguly; Soumya,5,0,32,27
1656861744275,MATH 20E,A02,083772,Ganguly; Soumya,6,0,32,26
1656861744275,MATH 20E,B01,083773,Ciotti; Benjamin,18,0,35,17
1656861744275,MATH 20E,B02,083774,Ciotti; Benjamin,17,0,35,18
1656861750302,MATH 103A,A01,083777,Greenfeld; Be'Eri,2,0,36,34
1656861750302,MATH 103A,A02,083778,Greenfeld; Be'Eri,5,0,36,31
1656861750302,MATH 103A,A03,093561,Greenfeld; Be'Eri,4,0,36,32
1656861750302,MATH 103A,B01,083779,Greenfeld; Be'Eri,6,0,36,30
1656861750302,MATH 103A,B02,083780,Greenfeld; Be'Eri,2,0,36,34
1656861750302,MATH 103A,B03,093562,Greenfeld; Be'Eri,2,0,36,34
1656861756332,MATH 105,A01,085443,Carter; Anne Toulson,13,0,35,22
1656861756332,MATH 105,A02,093477,Carter; Anne Toulson,20,0,35,15
1656861762356,MATH 109,A01,083213,Ganzberger; Geoffrey Michael,2,0,34,32
1656861762356,MATH 109,A02,083214,Ganzberger; Geoffrey Michael,2,0,34,32
1656861762356,MATH 109,A03,093478,Ganzberger; Geoffrey Michael,1,0,34,33
1656861762356,MATH 109,B01,083215,Ganzberger; Geoffrey Michael,1,0,32,31
1656861762356,MATH 109,B02,083216,Ganzberger; Geoffrey Michael,1,0,32,31
1656861762356,MATH 109,B03,093479,Ganzberger; Geoffrey Michael,6,0,32,26
1656861768381,MATH 142A,A01,083219,Chow; Bennett,6,0,32,26
1656861768381,MATH 142A,A02,083220,Chow; Bennett,9,0,32,23
1656861768381,MATH 142A,A03,093480,Chow; Bennett,7,0,32,25
1656861768381,MATH 142A,B03,093481,Chow; Bennett,7,0,32,25
1656861768381,MATH 142A,B04,093558,Chow; Bennett,10,0,32,22
1656861768381,MATH 142A,B05,093559,Chow; Bennett,6,0,32,26
1656861774406,MATH 193A,A01,083224,Rotar; Vladimir,6,0,34,28
1656861774406,MATH 193A,A02,083225,Rotar; Vladimir,3,0,34,31
1656861774406,MATH 193A,A03,083781,Rotar; Vladimir,1,0,34,33
1656861774406,MATH 193A,A04,083782,Rotar; Vladimir,6,0,34,28
1656861774406,MATH 193A,A05,093482,Rotar; Vladimir,6,0,34,28
1656861780429,MATH 197,001,091859,McAuley; Julian John,9999,0,9999,0
1656861780429,MATH 197,002,095566,Kedlaya; Kiran S.,9997,0,9999,2
1656861780429,MATH 197,003,095567,Xiao; Ming,9999,0,9999,0
1656861780429,MATH 197,004,095571,Perols; Johan Lars,9998,0,9999,1
1656861787491,COGS 9,A01,083615,Shannon; Kyle Michael,6,0,75,69
1656861793515,COGS 11,A01,083617,Boyle; Mary E. T.,18,0,48,30
1656861799544,COGS 13,A01,083071,Bastos; Amalia Pinkusfeld,8,0,71,63
1656861805572,COGS 14A,A01,092681,Semenuks; Arturs,0,1,100,100
1656861811613,COGS 14B,A01,083073,Cheng; Tzu-Han,5,0,63,58
1656861817650,COGS 17,A01,092677,Semenuks; Arturs,4,0,81,77
1656861823683,COGS 100,A01,083619,Allen; Michael Gordon,15,0,70,55
1656861829709,COGS 101A,A01,083621,Davis; Joshua Daniel,9,0,68,59
1656861835733,COGS 101B,A01,091572,Allen; Michael Gordon,8,0,65,57
1656861841755,COGS 101C,A01,083625,Delgado; Tania,17,0,35,18
1656861847778,COGS 107A,A01,083627,Boyle; Mary E. T.,13,0,60,47
1656861853801,COGS 118A,A01,083075,Gupta; Anjum,15,0,76,61
1656861859828,CSE 3,A50,083646,Miranda; Gregory Joseph,22,0,50,28
1656861865864,CSE 8A,A50,083650,Miranda; Gregory Joseph,17,1,56,39
1656861871892,CSE 11,A01,083080,Cao; Yingjun,4,15,40,36
1656861877924,CSE 12,A01,083652,Krause-Levy; Sophia Louisa,20,1,120,100
1656861883949,CSE 15L,A01,083654,Morris; Justin Loren,8,0,50,42
1656861883949,CSE 15L,A02,083655,Morris; Justin Loren,8,0,50,42
1656861889974,CSE 20,A01,083657,Tran; Khoa Dang,37,0,80,43
1656861896002,CSE 21,A01,095574,Bach; Quang Tran,21,0,48,27
1656861902039,CSE 30,A01,083084,Eldon; John,4,0,80,76
1656861902039,CSE 30,B01,095061,Bhaskar; Nishant,6,0,50,44
1656861908077,CSE 100,A01,083659,Cao; Yingjun,2,4,70,68
1656861914105,CSE 134B,A01,083661,Powell; Thomas Allan,19,0,100,81
1656861920128,CSE 140,A01,083663,Gungor; Onat,14,0,85,71
1656861926153,CSE 140L,A01,083088,Eldon; John,16,0,100,84
1656861932181,CSE 175,A01,083665,Kumar; Rakesh,3,0,25,22
1656861938209,CSE 190,A00,092507,Dubnov; Shlomo,7,0,20,13
1656861944247,ECE 45,A01,083139,Congero; Spencer William,5,0,75,70
1656861950275,ECE 65,A50,083695,Saad; Andrew S,12,0,30,18
1656861950275,ECE 65,A51,095125,Saad; Andrew S,25,0,26,1
1656861956301,ECE 109,A01,091882,Touri; Behrouz,16,0,70,54
1656861962331,ECE 180,A00,083140,Abi Samra; Nicholas Camill,0,0,30,30
1656861962331,ECE 180,B00,083141,Abi Samra; Nicholas Camill,0,0,30,30
1656861968356,MATH 10A,A01,083735,Patchell; Gregory David,1,0,30,29
1656861968356,MATH 10A,A02,083736,Patchell; Gregory David,20,0,30,10
1656861968356,MATH 10A,A03,083737,Patchell; Gregory David,15,0,30,15
1656861974383,MATH 10B,A01,083207,Lim; Seonhee,7,0,34,27
1656861974383,MATH 10B,A02,083208,Lim; Seonhee,9,0,35,26
1656861974383,MATH 10B,A03,093472,Lim; Seonhee,4,0,34,30
1656861974383,MATH 10B,B01,083739,Sinha; Shubham,9,0,30,21
1656861980412,MATH 18,A01,083743,Cinel; Cameron Alexander,6,0,30,24
1656861980412,MATH 18,A02,083744,Cinel; Cameron Alexander,15,0,30,15
1656861980412,MATH 18,A03,083745,Cinel; Cameron Alexander,8,0,30,22
1656861980412,MATH 18,B01,083748,Rideout; David Porter,3,0,37,34
1656861980412,MATH 18,B02,083749,Rideout; David Porter,3,0,36,33
1656861980412,MATH 18,B03,083750,Rideout; David Porter,2,0,37,35
1656861980412,MATH 18,B04,083751,Rideout; David Porter,5,0,36,31
1656861980412,MATH 18,B05,093473,Rideout; David Porter,4,0,36,32
1656861980412,MATH 18,B06,093474,Rideout; David Porter,5,0,36,31
1656861986440,MATH 20A,A01,083754,Zheng; Zequn,12,0,40,28
1656861992471,MATH 20B,A01,083756,Briones; Jor-el Thomas Caparas,1,0,36,35
1656861992471,MATH 20B,A02,083757,Briones; Jor-el Thomas Caparas,1,0,36,35
1656861992471,MATH 20B,A03,093475,Briones; Jor-el Thomas Caparas,0,0,36,36
1656861998496,MATH 20C,A01,083760,Briones; Jor-el Thomas Caparas,1,0,35,34
1656861998496,MATH 20C,A02,083761,Briones; Jor-el Thomas Caparas,8,0,35,27
1656861998496,MATH 20C,A03,093476,Briones; Jor-el Thomas Caparas,0,1,36,36
1656861998496,MATH 20C,B01,083762,Bach; Quang Tran,0,0,30,30
1656862004527,MATH 20D,A01,083765,Tran; Brian Kha,4,0,30,26
1656862004527,MATH 20D,A02,083766,Tran; Brian Kha,4,0,30,26
1656862004527,MATH 20D,A03,083767,Tran; Brian Kha,2,0,30,28
1656862010559,MATH 20E,A01,083771,Ganguly; Soumya,5,0,32,27
1656862010559,MATH 20E,A02,083772,Ganguly; Soumya,6,0,32,26
1656862010559,MATH 20E,B01,083773,Ciotti; Benjamin,18,0,35,17
1656862010559,MATH 20E,B02,083774,Ciotti; Benjamin,17,0,35,18
1656862016584,MATH 103A,A01,083777,Greenfeld; Be'Eri,2,0,36,34
1656862016584,MATH 103A,A02,083778,Greenfeld; Be'Eri,5,0,36,31
1656862016584,MATH 103A,A03,093561,Greenfeld; Be'Eri,4,0,36,32
1656862016584,MATH 103A,B01,083779,Greenfeld; Be'Eri,6,0,36,30
1656862016584,MATH 103A,B02,083780,Greenfeld; Be'Eri,2,0,36,34
1656862016584,MATH 103A,B03,093562,Greenfeld; Be'Eri,2,0,36,34
1656862022614,MATH 105,A01,085443,Carter; Anne Toulson,13,0,35,22
1656862022614,MATH 105,A02,093477,Carter; Anne Toulson,20,0,35,15
1656862028650,MATH 109,A01,083213,Ganzberger; Geoffrey Michael,2,0,34,32
1656862028650,MATH 109,A02,083214,Ganzberger; Geoffrey Michael,2,0,34,32
1656862028650,MATH 109,A03,093478,Ganzberger; Geoffrey Michael,1,0,34,33
1656862028650,MATH 109,B01,083215,Ganzberger; Geoffrey Michael,1,0,32,31
1656862028650,MATH 109,B02,083216,Ganzberger; Geoffrey Michael,1,0,32,31
1656862028650,MATH 109,B03,093479,Ganzberger; Geoffrey Michael,6,0,32,26
1656862034675,MATH 142A,A01,083219,Chow; Bennett,6,0,32,26
1656862034675,MATH 142A,A02,083220,Chow; Bennett,9,0,32,23
1656862034675,MATH 142A,A03,093480,Chow; Bennett,7,0,32,25
1656862034675,MATH 142A,B03,093481,Chow; Bennett,7,0,32,25
1656862034675,MATH 142A,B04,093558,Chow; Bennett,10,0,32,22
1656862034675,MATH 142A,B05,093559,Chow; Bennett,6,0,32,26
1656862040704,MATH 193A,A01,083224,Rotar; Vladimir,6,0,34,28
1656862040704,MATH 193A,A02,083225,Rotar; Vladimir,3,0,34,31
1656862040704,MATH 193A,A03,083781,Rotar; Vladimir,1,0,34,33
1656862040704,MATH 193A,A04,083782,Rotar; Vladimir,6,0,34,28
1656862040704,MATH 193A,A05,093482,Rotar; Vladimir,6,0,34,28
1656862046731,MATH 197,001,091859,McAuley; Julian John,9999,0,9999,0
1656862046731,MATH 197,002,095566,Kedlaya; Kiran S.,9997,0,9999,2
1656862046731,MATH 197,003,095567,Xiao; Ming,9999,0,9999,0
1656862046731,MATH 197,004,095571,Perols; Johan Lars,9998,0,9999,1
1656862053789,COGS 9,A01,083615,Shannon; Kyle Michael,6,0,75,69
1656862059885,COGS 11,A01,083617,Boyle; Mary E. T.,18,0,48,30
1656862065909,COGS 13,A01,083071,Bastos; Amalia Pinkusfeld,8,0,71,63
1656862071940,COGS 14A,A01,092681,Semenuks; Arturs,0,1,100,100
1656862077964,COGS 14B,A01,083073,Cheng; Tzu-Han,5,0,63,58
1656862083989,COGS 17,A01,092677,Semenuks; Arturs,4,0,81,77
1656862090020,COGS 100,A01,083619,Allen; Michael Gordon,15,0,70,55
1656862096073,COGS 101A,A01,083621,Davis; Joshua Daniel,9,0,68,59
1656862102100,COGS 101B,A01,091572,Allen; Michael Gordon,8,0,65,57
1656862108131,COGS 101C,A01,083625,Delgado; Tania,17,0,35,18
1656862114154,COGS 107A,A01,083627,Boyle; Mary E. T.,13,0,60,47
1656862120183,COGS 118A,A01,083075,Gupta; Anjum,15,0,76,61
1656862126206,CSE 3,A50,083646,Miranda; Gregory Joseph,22,0,50,28
1656862132230,CSE 8A,A50,083650,Miranda; Gregory Joseph,17,1,56,39
1656862138253,CSE 11,A01,083080,Cao; Yingjun,4,15,40,36
1656862144276,CSE 12,A01,083652,Krause-Levy; Sophia Louisa,20,1,120,100
1656862150304,CSE 15L,A01,083654,Morris; Justin Loren,8,0,50,42
1656862150304,CSE 15L,A02,083655,Morris; Justin Loren,8,0,50,42
1656862156327,CSE 20,A01,083657,Tran; Khoa Dang,37,0,80,43
1656862162350,CSE 21,A01,095574,Bach; Quang Tran,21,0,48,27
1656862168380,CSE 30,A01,083084,Eldon; John,4,0,80,76
1656862168380,CSE 30,B01,095061,Bhaskar; Nishant,6,0,50,44
1656862174404,CSE 100,A01,083659,Cao; Yingjun,2,4,70,68
1656862180431,CSE 134B,A01,083661,Powell; Thomas Allan,19,0,100,81
1656862186458,CSE 140,A01,083663,Gungor; Onat,14,0,85,71
1656862192480,CSE 140L,A01,083088,Eldon; John,16,0,100,84
1656862198505,CSE 175,A01,083665,Kumar; Rakesh,3,0,25,22
1656862204529,CSE 190,A00,092507,Dubnov; Shlomo,7,0,20,13
1656862210556,ECE 45,A01,083139,Congero; Spencer William,5,0,75,70
1656862216583,ECE 65,A50,083695,Saad; Andrew S,12,0,30,18
1656862216583,ECE 65,A51,095125,Saad; Andrew S,25,0,26,1
1656862222611,ECE 109,A01,091882,Touri; Behrouz,16,0,70,54
1656862228642,ECE 180,A00,083140,Abi Samra; Nicholas Camill,0,0,30,30
1656862228642,ECE 180,B00,083141,Abi Samra; Nicholas Camill,0,0,30,30
1656862234666,MATH 10A,A01,083735,Patchell; Gregory David,1,0,30,29
1656862234666,MATH 10A,A02,083736,Patchell; Gregory David,20,0,30,10
1656862234666,MATH 10A,A03,083737,Patchell; Gregory David,15,0,30,15
1656862240695,MATH 10B,A01,083207,Lim; Seonhee,7,0,34,27
1656862240695,MATH 10B,A02,083208,Lim; Seonhee,9,0,35,26
1656862240695,MATH 10B,A03,093472,Lim; Seonhee,4,0,34,30
1656862240695,MATH 10B,B01,083739,Sinha; Shubham,9,0,30,21
1656862246727,MATH 18,A01,083743,Cinel; Cameron Alexander,6,0,30,24
1656862246727,MATH 18,A02,083744,Cinel; Cameron Alexander,15,0,30,15
1656862246727,MATH 18,A03,083745,Cinel; Cameron Alexander,8,0,30,22
1656862246727,MATH 18,B01,083748,Rideout; David Porter,3,0,37,34
1656862246727,MATH 18,B02,083749,Rideout; David Porter,3,0,36,33
1656862246727,MATH 18,B03,083750,Rideout; David Porter,2,0,37,35
1656862246727,MATH 18,B04,083751,Rideout; David Porter,5,0,36,31
1656862246727,MATH 18,B05,093473,Rideout; David Porter,4,0,36,32
1656862246727,MATH 18,B06,093474,Rideout; David Porter,5,0,36,31
1656862252760,MATH 20A,A01,083754,Zheng; Zequn,12,0,40,28
1656862258787,MATH 20B,A01,083756,Briones; Jor-el Thomas Caparas,1,0,36,35
1656862258787,MATH 20B,A02,083757,Briones; Jor-el Thomas Caparas,1,0,36,35
1656862258787,MATH 20B,A03,093475,Briones; Jor-el Thomas Caparas,0,0,36,36
1656862264811,MATH 20C,A01,083760,Briones; Jor-el Thomas Caparas,1,0,35,34
1656862264811,MATH 20C,A02,083761,Briones; Jor-el Thomas Caparas,8,0,35,27
1656862264811,MATH 20C,A03,093476,Briones; Jor-el Thomas Caparas,0,1,36,36
1656862264811,MATH 20C,B01,083762,Bach; Quang Tran,0,0,30,30
1656862270848,MATH 20D,A01,083765,Tran; Brian Kha,4,0,30,26
1656862270848,MATH 20D,A02,083766,Tran; Brian Kha,4,0,30,26
1656862270848,MATH 20D,A03,083767,Tran; Brian Kha,2,0,30,28
1656862276875,MATH 20E,A01,083771,Ganguly; Soumya,5,0,32,27
1656862276875,MATH 20E,A02,083772,Ganguly; Soumya,6,0,32,26
1656862276875,MATH 20E,B01,083773,Ciotti; Benjamin,18,0,35,17
1656862276875,MATH 20E,B02,083774,Ciotti; Benjamin,17,0,35,18
1656862282899,MATH 103A,A01,083777,Greenfeld; Be'Eri,2,0,36,34
1656862282899,MATH 103A,A02,083778,Greenfeld; Be'Eri,5,0,36,31
1656862282899,MATH 103A,A03,093561,Greenfeld; Be'Eri,4,0,36,32
1656862282899,MATH 103A,B01,083779,Greenfeld; Be'Eri,6,0,36,30
1656862282899,MATH 103A,B02,083780,Greenfeld; Be'Eri,2,0,36,34
1656862282899,MATH 103A,B03,093562,Greenfeld; Be'Eri,2,0,36,34
1656862288937,MATH 105,A01,085443,Carter; Anne Toulson,13,0,35,22
1656862288937,MATH 105,A02,093477,Carter; Anne Toulson,20,0,35,15
1656862294961,MATH 109,A01,083213,Ganzberger; Geoffrey Michael,2,0,34,32
1656862294961,MATH 109,A02,083214,Ganzberger; Geoffrey Michael,2,0,34,32
1656862294961,MATH 109,A03,093478,Ganzberger; Geoffrey Michael,1,0,34,33
1656862294961,MATH 109,B01,083215,Ganzberger; Geoffrey Michael,1,0,32,31
1656862294961,MATH 109,B02,083216,Ganzberger; Geoffrey Michael,1,0,32,31
1656862294961,MATH 109,B03,093479,Ganzberger; Geoffrey Michael,6,0,32,26
1656862300992,MATH 142A,A01,083219,Chow; Bennett,6,0,32,26
1656862300992,MATH 142A,A02,083220,Chow; Bennett,9,0,32,23
1656862300992,MATH 142A,A03,093480,Chow; Bennett,7,0,32,25
1656862300992,MATH 142A,B03,093481,Chow; Bennett,7,0,32,25
1656862300992,MATH 142A,B04,093558,Chow; Bennett,10,0,32,22
1656862300992,MATH 142A,B05,093559,Chow; Bennett,6,0,32,26
1656862307022,MATH 193A,A01,083224,Rotar; Vladimir,6,0,34,28
1656862307022,MATH 193A,A02,083225,Rotar; Vladimir,3,0,34,31
1656862307022,MATH 193A,A03,083781,Rotar; Vladimir,1,0,34,33
1656862307022,MATH 193A,A04,083782,Rotar; Vladimir,6,0,34,28
1656862307022,MATH 193A,A05,093482,Rotar; Vladimir,6,0,34,28
1656862313050,MATH 197,001,091859,McAuley; Julian John,9999,0,9999,0
1656862313050,MATH 197,002,095566,Kedlaya; Kiran S.,9997,0,9999,2
1656862313050,MATH 197,003,095567,Xiao; Ming,9999,0,9999,0
1656862313050,MATH 197,004,095571,Perols; Johan Lars,9998,0,9999,1
1656862320106,COGS 9,A01,083615,Shannon; Kyle Michael,6,0,75,69
1656862326131,COGS 11,A01,083617,Boyle; Mary E. T.,18,0,48,30
1656862332160,COGS 13,A01,083071,Bastos; Amalia Pinkusfeld,8,0,71,63
1656862338184,COGS 14A,A01,092681,Semenuks; Arturs,0,1,100,100
1656862344208,COGS 14B,A01,083073,Cheng; Tzu-Han,5,0,63,58
1656862350238,COGS 17,A01,092677,Semenuks; Arturs,4,0,81,77
1656862356260,COGS 100,A01,083619,Allen; Michael Gordon,15,0,70,55
1656862362289,COGS 101A,A01,083621,Davis; Joshua Daniel,9,0,68,59
1656862368314,COGS 101B,A01,091572,Allen; Michael Gordon,8,0,65,57
1656862374340,COGS 101C,A01,083625,Delgado; Tania,17,0,35,18
1656862380365,COGS 107A,A01,083627,Boyle; Mary E. T.,13,0,60,47
1656862386393,COGS 118A,A01,083075,Gupta; Anjum,15,0,76,61
1656862392426,CSE 3,A50,083646,Miranda; Gregory Joseph,22,0,50,28
1656862398450,CSE 8A,A50,083650,Miranda; Gregory Joseph,17,1,56,39
1656862404474,CSE 11,A01,083080,Cao; Yingjun,4,15,40,36
1656862410502,CSE 12,A01,083652,Krause-Levy; Sophia Louisa,20,1,120,100
1656862416530,CSE 15L,A01,083654,Morris; Justin Loren,8,0,50,42
1656862416530,CSE 15L,A02,083655,Morris; Justin Loren,8,0,50,42
1656862422553,CSE 20,A01,083657,Tran; Khoa Dang,37,0,80,43
1656862428577,CSE 21,A01,095574,Bach; Quang Tran,21,0,48,27
1656862434600,CSE 30,A01,083084,Eldon; John,4,0,80,76
1656862434600,CSE 30,B01,095061,Bhaskar; Nishant,6,0,50,44
1656862440624,CSE 100,A01,083659,Cao; Yingjun,2,4,70,68
1656862446656,CSE 134B,A01,083661,Powell; Thomas Allan,19,0,100,81
1656862452683,CSE 140,A01,083663,Gungor; Onat,14,0,85,71
1656862458707,CSE 140L,A01,083088,Eldon; John,16,0,100,84
1656862464731,CSE 175,A01,083665,Kumar; Rakesh,3,0,25,22
1656862470764,CSE 190,A00,092507,Dubnov; Shlomo,7,0,20,13
1656862476788,ECE 45,A01,083139,Congero; Spencer William,5,0,75,70
1656862482816,ECE 65,A50,083695,Saad; Andrew S,12,0,30,18
1656862482816,ECE 65,A51,095125,Saad; Andrew S,25,0,26,1
1656862488840,ECE 109,A01,091882,Touri; Behrouz,16,0,70,54
1656862494874,ECE 180,A00,083140,Abi Samra; Nicholas Camill,0,0,30,30
1656862494874,ECE 180,B00,083141,Abi Samra; Nicholas Camill,0,0,30,30
1656862500908,MATH 10A,A01,083735,Patchell; Gregory David,1,0,30,29
1656862500908,MATH 10A,A02,083736,Patchell; Gregory David,20,0,30,10
1656862500908,MATH 10A,A03,083737,Patchell; Gregory David,15,0,30,15
1656862506939,MATH 10B,A01,083207,Lim; Seonhee,7,0,34,27
1656862506939,MATH 10B,A02,083208,Lim; Seonhee,9,0,35,26
1656862506939,MATH 10B,A03,093472,Lim; Seonhee,4,0,34,30
1656862506939,MATH 10B,B01,083739,Sinha; Shubham,9,0,30,21
1656862512970,MATH 18,A01,083743,Cinel; Cameron Alexander,6,0,30,24
1656862512970,MATH 18,A02,083744,Cinel; Cameron Alexander,15,0,30,15
1656862512970,MATH 18,A03,083745,Cinel; Cameron Alexander,8,0,30,22
1656862512970,MATH 18,B01,083748,Rideout; David Porter,3,0,37,34
1656862512970,MATH 18,B02,083749,Rideout; David Porter,3,0,36,33
1656862512970,MATH 18,B03,083750,Rideout; David Porter,2,0,37,35
1656862512970,MATH 18,B04,083751,Rideout; David Porter,5,0,36,31
1656862512970,MATH 18,B05,093473,Rideout; David Porter,4,0,36,32
1656862512970,MATH 18,B06,093474,Rideout; David Porter,5,0,36,31
1656862518995,MATH 20A,A01,083754,Zheng; Zequn,12,0,40,28
1656862525023,MATH 20B,A01,083756,Briones; Jor-el Thomas Caparas,1,0,36,35
1656862525023,MATH 20B,A02,083757,Briones; Jor-el Thomas Caparas,1,0,36,35
1656862525023,MATH 20B,A03,093475,Briones; Jor-el Thomas Caparas,0,0,36,36
1656862531053,MATH 20C,A01,083760,Briones; Jor-el Thomas Caparas,1,0,35,34
1656862531053,MATH 20C,A02,083761,Briones; Jor-el Thomas Caparas,8,0,35,27
1656862531053,MATH 20C,A03,093476,Briones; Jor-el Thomas Caparas,0,1,36,36
1656862531053,MATH 20C,B01,083762,Bach; Quang Tran,0,0,30,30
1656862537081,MATH 20D,A01,083765,Tran; Brian Kha,4,0,30,26
1656862537081,MATH 20D,A02,083766,Tran; Brian Kha,4,0,30,26
1656862537081,MATH 20D,A03,083767,Tran; Brian Kha,2,0,30,28
1656862543108,MATH 20E,A01,083771,Ganguly; Soumya,5,0,32,27
1656862543108,MATH 20E,A02,083772,Ganguly; Soumya,6,0,32,26
1656862543108,MATH 20E,B01,083773,Ciotti; Benjamin,18,0,35,17
1656862543108,MATH 20E,B02,083774,Ciotti; Benjamin,17,0,35,18
1656862549132,MATH 103A,A01,083777,Greenfeld; Be'Eri,2,0,36,34
1656862549132,MATH 103A,A02,083778,Greenfeld; Be'Eri,5,0,36,31
1656862549132,MATH 103A,A03,093561,Greenfeld; Be'Eri,4,0,36,32
1656862549132,MATH 103A,B01,083779,Greenfeld; Be'Eri,6,0,36,30
1656862549132,MATH 103A,B02,083780,Greenfeld; Be'Eri,2,0,36,34
1656862549132,MATH 103A,B03,093562,Greenfeld; Be'Eri,2,0,36,34
1656862555155,MATH 105,A01,085443,Carter; Anne Toulson,13,0,35,22
1656862555155,MATH 105,A02,093477,Carter; Anne Toulson,20,0,35,15
1656862561191,MATH 109,A01,083213,Ganzberger; Geoffrey Michael,2,0,34,32
1656862561191,MATH 109,A02,083214,Ganzberger; Geoffrey Michael,2,0,34,32
1656862561191,MATH 109,A03,093478,Ganzberger; Geoffrey Michael,1,0,34,33
1656862561191,MATH 109,B01,083215,Ganzberger; Geoffrey Michael,1,0,32,31
1656862561191,MATH 109,B02,083216,Ganzberger; Geoffrey Michael,1,0,32,31
1656862561191,MATH 109,B03,093479,Ganzberger; Geoffrey Michael,6,0,32,26
1656862567221,MATH 142A,A01,083219,Chow; Bennett,6,0,32,26
1656862567221,MATH 142A,A02,083220,Chow; Bennett,9,0,32,23
1656862567221,MATH 142A,A03,093480,Chow; Bennett,7,0,32,25
1656862567221,MATH 142A,B03,093481,Chow; Bennett,7,0,32,25
1656862567221,MATH 142A,B04,093558,Chow; Bennett,10,0,32,22
1656862567221,MATH 142A,B05,093559,Chow; Bennett,6,0,32,26
1656862573243,MATH 193A,A01,083224,Rotar; Vladimir,6,0,34,28
1656862573243,MATH 193A,A02,083225,Rotar; Vladimir,3,0,34,31
1656862573243,MATH 193A,A03,083781,Rotar; Vladimir,1,0,34,33
1656862573243,MATH 193A,A04,083782,Rotar; Vladimir,6,0,34,28
1656862573243,MATH 193A,A05,093482,Rotar; Vladimir,6,0,34,28
1656862579270,MATH 197,001,091859,McAuley; Julian John,9999,0,9999,0
1656862579270,MATH 197,002,095566,Kedlaya; Kiran S.,9997,0,9999,2
1656862579270,MATH 197,003,095567,Xiao; Ming,9999,0,9999,0
1656862579270,MATH 197,004,095571,Perols; Johan Lars,9998,0,9999,1
1656862586341,COGS 9,A01,083615,Shannon; Kyle Michael,6,0,75,69
1656862592378,COGS 11,A01,083617,Boyle; Mary E. T.,18,0,48,30
1656862598402,COGS 13,A01,083071,Bastos; Amalia Pinkusfeld,8,0,71,63
1656862604425,COGS 14A,A01,092681,Semenuks; Arturs,0,1,100,100
1656862610449,COGS 14B,A01,083073,Cheng; Tzu-Han,5,0,63,58
1656862616476,COGS 17,A01,092677,Semenuks; Arturs,4,0,81,77
1656862622500,COGS 100,A01,083619,Allen; Michael Gordon,15,0,70,55
1656862628523,COGS 101A,A01,083621,Davis; Joshua Daniel,9,0,68,59
1656862634545,COGS 101B,A01,091572,Allen; Michael Gordon,8,0,65,57
1656862640569,COGS 101C,A01,083625,Delgado; Tania,17,0,35,18
1656862646593,COGS 107A,A01,083627,Boyle; Mary E. T.,13,0,60,47
1656862652620,COGS 118A,A01,083075,Gupta; Anjum,15,0,76,61
1656862658722,CSE 3,A50,083646,Miranda; Gregory Joseph,22,0,50,28
1656862664754,CSE 8A,A50,083650,Miranda; Gregory Joseph,17,1,56,39
1656862670786,CSE 11,A01,083080,Cao; Yingjun,4,15,40,36
1656862676808,CSE 12,A01,083652,Krause-Levy; Sophia Louisa,20,1,120,100
1656862682844,CSE 15L,A01,083654,Morris; Justin Loren,8,0,50,42
1656862682844,CSE 15L,A02,083655,Morris; Justin Loren,8,0,50,42
1656862688869,CSE 20,A01,083657,Tran; Khoa Dang,37,0,80,43
1656862694904,CSE 21,A01,095574,Bach; Quang Tran,21,0,48,27
1656862700931,CSE 30,A01,083084,Eldon; John,4,0,80,76
1656862700931,CSE 30,B01,095061,Bhaskar; Nishant,6,0,50,44
1656862706957,CSE 100,A01,083659,Cao; Yingjun,2,4,70,68
1656862712984,CSE 134B,A01,083661,Powell; Thomas Allan,19,0,100,81
1656862719020,CSE 140,A01,083663,Gungor; Onat,14,0,85,71
1656862725042,CSE 140L,A01,083088,Eldon; John,16,0,100,84
1656862731072,CSE 175,A01,083665,Kumar; Rakesh,3,0,25,22
1656862737094,CSE 190,A00,092507,Dubnov; Shlomo,7,0,20,13
1656862743118,ECE 45,A01,083139,Congero; Spencer William,5,0,75,70
1656862749141,ECE 65,A50,083695,Saad; Andrew S,12,0,30,18
1656862749141,ECE 65,A51,095125,Saad; Andrew S,25,0,26,1
1656862755166,ECE 109,A01,091882,Touri; Behrouz,16,0,70,54
1656862761188,ECE 180,A00,083140,Abi Samra; Nicholas Camill,0,0,30,30
1656862761188,ECE 180,B00,083141,Abi Samra; Nicholas Camill,0,0,30,30
1656862767211,MATH 10A,A01,083735,Patchell; Gregory David,1,0,30,29
1656862767211,MATH 10A,A02,083736,Patchell; Gregory David,20,0,30,10
1656862767211,MATH 10A,A03,083737,Patchell; Gregory David,15,0,30,15
1656862773238,MATH 10B,A01,083207,Lim; Seonhee,7,0,34,27
1656862773238,MATH 10B,A02,083208,Lim; Seonhee,9,0,35,26
1656862773238,MATH 10B,A03,093472,Lim; Seonhee,4,0,34,30
1656862773238,MATH 10B,B01,083739,Sinha; Shubham,9,0,30,21
1656862779269,MATH 18,A01,083743,Cinel; Cameron Alexander,6,0,30,24
1656862779269,MATH 18,A02,083744,Cinel; Cameron Alexander,15,0,30,15
1656862779269,MATH 18,A03,083745,Cinel; Cameron Alexander,8,0,30,22
1656862779269,MATH 18,B01,083748,Rideout; David Porter,3,0,37,34
1656862779269,MATH 18,B02,083749,Rideout; David Porter,3,0,36,33
1656862779269,MATH 18,B03,083750,Rideout; David Porter,2,0,37,35
1656862779269,MATH 18,B04,083751,Rideout; David Porter,5,0,36,31
1656862779269,MATH 18,B05,093473,Rideout; David Porter,4,0,36,32
1656862779269,MATH 18,B06,093474,Rideout; David Porter,5,0,36,31
1656862785294,MATH 20A,A01,083754,Zheng; Zequn,12,0,40,28
1656862791321,MATH 20B,A01,083756,Briones; Jor-el Thomas Caparas,1,0,36,35
1656862791321,MATH 20B,A02,083757,Briones; Jor-el Thomas Caparas,1,0,36,35
1656862791321,MATH 20B,A03,093475,Briones; Jor-el Thomas Caparas,0,0,36,36
1656862797354,MATH 20C,A01,083760,Briones; Jor-el Thomas Caparas,1,0,35,34
1656862797354,MATH 20C,A02,083761,Briones; Jor-el Thomas Caparas,8,0,35,27
1656862797354,MATH 20C,A03,093476,Briones; Jor-el Thomas Caparas,0,1,36,36
1656862797354,MATH 20C,B01,083762,Bach; Quang Tran,0,0,30,30
1656862803378,MATH 20D,A01,083765,Tran; Brian Kha,4,0,30,26
1656862803378,MATH 20D,A02,083766,Tran; Brian Kha,4,0,30,26
1656862803378,MATH 20D,A03,083767,Tran; Brian Kha,2,0,30,28
1656862809407,MATH 20E,A01,083771,Ganguly; Soumya,5,0,32,27
1656862809407,MATH 20E,A02,083772,Ganguly; Soumya,6,0,32,26
1656862809407,MATH 20E,B01,083773,Ciotti; Benjamin,18,0,35,17
1656862809407,MATH 20E,B02,083774,Ciotti; Benjamin,17,0,35,18
1656862815441,MATH 103A,A01,083777,Greenfeld; Be'Eri,2,0,36,34
1656862815441,MATH 103A,A02,083778,Greenfeld; Be'Eri,5,0,36,31
1656862815441,MATH 103A,A03,093561,Greenfeld; Be'Eri,4,0,36,32
1656862815441,MATH 103A,B01,083779,Greenfeld; Be'Eri,6,0,36,30
1656862815441,MATH 103A,B02,083780,Greenfeld; Be'Eri,2,0,36,34
1656862815441,MATH 103A,B03,093562,Greenfeld; Be'Eri,2,0,36,34
1656862821466,MATH 105,A01,085443,Carter; Anne Toulson,13,0,35,22
1656862821466,MATH 105,A02,093477,Carter; Anne Toulson,20,0,35,15
1656862827491,MATH 109,A01,083213,Ganzberger; Geoffrey Michael,2,0,34,32
1656862827491,MATH 109,A02,083214,Ganzberger; Geoffrey Michael,2,0,34,32
1656862827491,MATH 109,A03,093478,Ganzberger; Geoffrey Michael,1,0,34,33
1656862827491,MATH 109,B01,083215,Ganzberger; Geoffrey Michael,1,0,32,31
1656862827491,MATH 109,B02,083216,Ganzberger; Geoffrey Michael,1,0,32,31
1656862827491,MATH 109,B03,093479,Ganzberger; Geoffrey Michael,6,0,32,26
1656862833518,MATH 142A,A01,083219,Chow; Bennett,6,0,32,26
1656862833518,MATH 142A,A02,083220,Chow; Bennett,9,0,32,23
1656862833518,MATH 142A,A03,093480,Chow; Bennett,7,0,32,25
1656862833518,MATH 142A,B03,093481,Chow; Bennett,7,0,32,25
1656862833518,MATH 142A,B04,093558,Chow; Bennett,10,0,32,22
1656862833518,MATH 142A,B05,093559,Chow; Bennett,6,0,32,26
1656862839540,MATH 193A,A01,083224,Rotar; Vladimir,6,0,34,28
1656862839540,MATH 193A,A02,083225,Rotar; Vladimir,3,0,34,31
1656862839540,MATH 193A,A03,083781,Rotar; Vladimir,1,0,34,33
1656862839540,MATH 193A,A04,083782,Rotar; Vladimir,6,0,34,28
1656862839540,MATH 193A,A05,093482,Rotar; Vladimir,6,0,34,28
1656862845563,MATH 197,001,091859,McAuley; Julian John,9999,0,9999,0
1656862845563,MATH 197,002,095566,Kedlaya; Kiran S.,9997,0,9999,2
1656862845563,MATH 197,003,095567,Xiao; Ming,9999,0,9999,0
1656862845563,MATH 197,004,095571,Perols; Johan Lars,9998,0,9999,1
1656862852623,COGS 9,A01,083615,Shannon; Kyle Michael,6,0,75,69
1656862858645,COGS 11,A01,083617,Boyle; Mary E. T.,18,0,48,30
1656862864670,COGS 13,A01,083071,Bastos; Amalia Pinkusfeld,8,0,71,63
1656862870693,COGS 14A,A01,092681,Semenuks; Arturs,0,1,100,100
1656862876717,COGS 14B,A01,083073,Cheng; Tzu-Han,5,0,63,58
1656862882741,COGS 17,A01,092677,Semenuks; Arturs,4,0,81,77
1656862888767,COGS 100,A01,083619,Allen; Michael Gordon,15,0,70,55
1656862894789,COGS 101A,A01,083621,Davis; Joshua Daniel,9,0,68,59
1656862900821,COGS 101B,A01,091572,Allen; Michael Gordon,8,0,65,57
1656862906844,COGS 101C,A01,083625,Delgado; Tania,17,0,35,18
1656862912865,COGS 107A,A01,083627,Boyle; Mary E. T.,13,0,60,47
1656862918896,COGS 118A,A01,083075,Gupta; Anjum,15,0,76,61
1656862924920,CSE 3,A50,083646,Miranda; Gregory Joseph,22,0,50,28
1656862930947,CSE 8A,A50,083650,Miranda; Gregory Joseph,17,1,56,39
1656862936975,CSE 11,A01,083080,Cao; Yingjun,4,15,40,36
1656862942998,CSE 12,A01,083652,Krause-Levy; Sophia Louisa,20,1,120,100
1656862949027,CSE 15L,A01,083654,Morris; Justin Loren,8,0,50,42
1656862949027,CSE 15L,A02,083655,Morris; Justin Loren,8,0,50,42
1656862955055,CSE 20,A01,083657,Tran; Khoa Dang,37,0,80,43
1656862961078,CSE 21,A01,095574,Bach; Quang Tran,21,0,48,27
1656862967103,CSE 30,A01,083084,Eldon; John,4,0,80,76
1656862967103,CSE 30,B01,095061,Bhaskar; Nishant,6,0,50,44
1656862973126,CSE 100,A01,083659,Cao; Yingjun,2,4,70,68
1656862979151,CSE 134B,A01,083661,Powell; Thomas Allan,19,0,100,81
1656862985174,CSE 140,A01,083663,Gungor; Onat,14,0,85,71
1656862991196,CSE 140L,A01,083088,Eldon; John,16,0,100,84
1656862997219,CSE 175,A01,083665,Kumar; Rakesh,3,0,25,22
1656863003241,CSE 190,A00,092507,Dubnov; Shlomo,7,0,20,13
1656863009268,ECE 45,A01,083139,Congero; Spencer William,5,0,75,70
1656863015361,ECE 65,A50,083695,Saad; Andrew S,12,0,30,18
1656863015361,ECE 65,A51,095125,Saad; Andrew S,25,0,26,1
1656863021387,ECE 109,A01,091882,Touri; Behrouz,16,0,70,54
1656863027409,ECE 180,A00,083140,Abi Samra; Nicholas Camill,0,0,30,30
1656863027409,ECE 180,B00,083141,Abi Samra; Nicholas Camill,0,0,30,30
1656863033431,MATH 10A,A01,083735,Patchell; Gregory David,1,0,30,29
1656863033431,MATH 10A,A02,083736,Patchell; Gregory David,20,0,30,10
1656863033431,MATH 10A,A03,083737,Patchell; Gregory David,15,0,30,15
1656863039461,MATH 10B,A01,083207,Lim; Seonhee,7,0,34,27
1656863039461,MATH 10B,A02,083208,Lim; Seonhee,9,0,35,26
1656863039461,MATH 10B,A03,093472,Lim; Seonhee,4,0,34,30
1656863039461,MATH 10B,B01,083739,Sinha; Shubham,9,0,30,21
1656863045495,MATH 18,A01,083743,Cinel; Cameron Alexander,6,0,30,24
1656863045495,MATH 18,A02,083744,Cinel; Cameron Alexander,15,0,30,15
1656863045495,MATH 18,A03,083745,Cinel; Cameron Alexander,8,0,30,22
1656863045495,MATH 18,B01,083748,Rideout; David Porter,3,0,37,34
1656863045495,MATH 18,B02,083749,Rideout; David Porter,3,0,36,33
1656863045495,MATH 18,B03,083750,Rideout; David Porter,2,0,37,35
1656863045495,MATH 18,B04,083751,Rideout; David Porter,5,0,36,31
1656863045495,MATH 18,B05,093473,Rideout; David Porter,4,0,36,32
1656863045495,MATH 18,B06,093474,Rideout; David Porter,5,0,36,31
1656863051519,MATH 20A,A01,083754,Zheng; Zequn,12,0,40,28
1656863057545,MATH 20B,A01,083756,Briones; Jor-el Thomas Caparas,1,0,36,35
1656863057545,MATH 20B,A02,083757,Briones; Jor-el Thomas Caparas,1,0,36,35
1656863057545,MATH 20B,A03,093475,Briones; Jor-el Thomas Caparas,0,0,36,36
1656863063570,MATH 20C,A01,083760,Briones; Jor-el Thomas Caparas,1,0,35,34
1656863063570,MATH 20C,A02,083761,Briones; Jor-el Thomas Caparas,8,0,35,27
1656863063570,MATH 20C,A03,093476,Briones; Jor-el Thomas Caparas,0,1,36,36
1656863063570,MATH 20C,B01,083762,Bach; Quang Tran,0,0,30,30
1656863069592,MATH 20D,A01,083765,Tran; Brian Kha,4,0,30,26
1656863069592,MATH 20D,A02,083766,Tran; Brian Kha,4,0,30,26
1656863069592,MATH 20D,A03,083767,Tran; Brian Kha,2,0,30,28
1656863075620,MATH 20E,A01,083771,Ganguly; Soumya,5,0,32,27
1656863075620,MATH 20E,A02,083772,Ganguly; Soumya,6,0,32,26
1656863075620,MATH 20E,B01,083773,Ciotti; Benjamin,18,0,35,17
1656863075620,MATH 20E,B02,083774,Ciotti; Benjamin,17,0,35,18
1656863081648,MATH 103A,A01,083777,Greenfeld; Be'Eri,2,0,36,34
1656863081648,MATH 103A,A02,083778,Greenfeld; Be'Eri,5,0,36,31
1656863081648,MATH 103A,A03,093561,Greenfeld; Be'Eri,4,0,36,32
1656863081648,MATH 103A,B01,083779,Greenfeld; Be'Eri,6,0,36,30
1656863081648,MATH 103A,B02,083780,Greenfeld; Be'Eri,2,0,36,34
1656863081648,MATH 103A,B03,093562,Greenfeld; Be'Eri,2,0,36,34
1656863087672,MATH 105,A01,085443,Carter; Anne Toulson,13,0,35,22
1656863087672,MATH 105,A02,093477,Carter; Anne Toulson,20,0,35,15
1656863093695,MATH 109,A01,083213,Ganzberger; Geoffrey Michael,2,0,34,32
1656863093695,MATH 109,A02,083214,Ganzberger; Geoffrey Michael,2,0,34,32
1656863093695,MATH 109,A03,093478,Ganzberger; Geoffrey Michael,1,0,34,33
1656863093695,MATH 109,B01,083215,Ganzberger; Geoffrey Michael,1,0,32,31
1656863093695,MATH 109,B02,083216,Ganzberger; Geoffrey Michael,1,0,32,31
1656863093695,MATH 109,B03,093479,Ganzberger; Geoffrey Michael,6,0,32,26
1656863099728,MATH 142A,A01,083219,Chow; Bennett,6,0,32,26
1656863099728,MATH 142A,A02,083220,Chow; Bennett,9,0,32,23
1656863099728,MATH 142A,A03,093480,Chow; Bennett,7,0,32,25
1656863099728,MATH 142A,B03,093481,Chow; Bennett,7,0,32,25
1656863099728,MATH 142A,B04,093558,Chow; Bennett,10,0,32,22
1656863099728,MATH 142A,B05,093559,Chow; Bennett,6,0,32,26
1656863105757,MATH 193A,A01,083224,Rotar; Vladimir,6,0,34,28
1656863105757,MATH 193A,A02,083225,Rotar; Vladimir,3,0,34,31
1656863105757,MATH 193A,A03,083781,Rotar; Vladimir,1,0,34,33
1656863105757,MATH 193A,A04,083782,Rotar; Vladimir,6,0,34,28
1656863105757,MATH 193A,A05,093482,Rotar; Vladimir,6,0,34,28
1656863111780,MATH 197,001,091859,McAuley; Julian John,9999,0,9999,0
1656863111780,MATH 197,002,095566,Kedlaya; Kiran S.,9997,0,9999,2
1656863111780,MATH 197,003,095567,Xiao; Ming,9999,0,9999,0
1656863111780,MATH 197,004,095571,Perols; Johan Lars,9998,0,9999,1
1656863118846,COGS 9,A01,083615,Shannon; Kyle Michael,6,0,75,69
1656863124871,COGS 11,A01,083617,Boyle; Mary E. T.,18,0,48,30
1656863130900,COGS 13,A01,083071,Bastos; Amalia Pinkusfeld,8,0,71,63
1656863136926,COGS 14A,A01,092681,Semenuks; Arturs,0,1,100,100
1656863142950,COGS 14B,A01,083073,Cheng; Tzu-Han,5,0,63,58
1656863148973,COGS 17,A01,092677,Semenuks; Arturs,4,0,81,77
1656863154997,COGS 100,A01,083619,Allen; Michael Gordon,15,0,70,55
1656863161021,COGS 101A,A01,083621,Davis; Joshua Daniel,9,0,68,59
1656863167051,COGS 101B,A01,091572,Allen; Michael Gordon,8,0,65,57
1656863173081,COGS 101C,A01,083625,Delgado; Tania,17,0,35,18
1656863179105,COGS 107A,A01,083627,Boyle; Mary E. T.,13,0,60,47
1656863185137,COGS 118A,A01,083075,Gupta; Anjum,15,0,76,61
1656863191171,CSE 3,A50,083646,Miranda; Gregory Joseph,22,0,50,28
1656863197196,CSE 8A,A50,083650,Miranda; Gregory Joseph,17,1,56,39
1656863203219,CSE 11,A01,083080,Cao; Yingjun,4,15,40,36
1656863209242,CSE 12,A01,083652,Krause-Levy; Sophia Louisa,20,1,120,100
1656863215266,CSE 15L,A01,083654,Morris; Justin Loren,8,0,50,42
1656863215266,CSE 15L,A02,083655,Morris; Justin Loren,8,0,50,42
1656863221297,CSE 20,A01,083657,Tran; Khoa Dang,37,0,80,43
1656863227321,CSE 21,A01,095574,Bach; Quang Tran,21,0,48,27
1656863233348,CSE 30,A01,083084,Eldon; John,4,0,80,76
1656863233348,CSE 30,B01,095061,Bhaskar; Nishant,6,0,50,44
1656863239376,CSE 100,A01,083659,Cao; Yingjun,2,4,70,68
1656863245400,CSE 134B,A01,083661,Powell; Thomas Allan,19,0,100,81
1656863251424,CSE 140,A01,083663,Gungor; Onat,14,0,85,71
1656863257518,CSE 140L,A01,083088,Eldon; John,16,0,100,84
1656863263555,CSE 175,A01,083665,Kumar; Rakesh,3,0,25,22
1656863269581,CSE 190,A00,092507,Dubnov; Shlomo,7,0,20,13
1656863275609,ECE 45,A01,083139,Congero; Spencer William,5,0,75,70
1656863281633,ECE 65,A50,083695,Saad; Andrew S,12,0,30,18
1656863281633,ECE 65,A51,095125,Saad; Andrew S,25,0,26,1
1656863287659,ECE 109,A01,091882,Touri; Behrouz,16,0,70,54
1656863293686,ECE 180,A00,083140,Abi Samra; Nicholas Camill,0,0,30,30
1656863293686,ECE 180,B00,083141,Abi Samra; Nicholas Camill,0,0,30,30
1656863299716,MATH 10A,A01,083735,Patchell; Gregory David,1,0,30,29
1656863299716,MATH 10A,A02,083736,Patchell; Gregory David,20,0,30,10
1656863299716,MATH 10A,A03,083737,Patchell; Gregory David,15,0,30,15
1656863305745,MATH 10B,A01,083207,Lim; Seonhee,7,0,34,27
1656863305745,MATH 10B,A02,083208,Lim; Seonhee,9,0,35,26
1656863305745,MATH 10B,A03,093472,Lim; Seonhee,4,0,34,30
1656863305745,MATH 10B,B01,083739,Sinha; Shubham,9,0,30,21
1656863311769,MATH 18,A01,083743,Cinel; Cameron Alexander,6,0,30,24
1656863311769,MATH 18,A02,083744,Cinel; Cameron Alexander,15,0,30,15
1656863311769,MATH 18,A03,083745,Cinel; Cameron Alexander,8,0,30,22
1656863311769,MATH 18,B01,083748,Rideout; David Porter,3,0,37,34
1656863311769,MATH 18,B02,083749,Rideout; David Porter,3,0,36,33
1656863311769,MATH 18,B03,083750,Rideout; David Porter,2,0,37,35
1656863311769,MATH 18,B04,083751,Rideout; David Porter,5,0,36,31
1656863311769,MATH 18,B05,093473,Rideout; David Porter,4,0,36,32
1656863311769,MATH 18,B06,093474,Rideout; David Porter,5,0,36,31
1656863317794,MATH 20A,A01,083754,Zheng; Zequn,12,0,40,28
1656863323822,MATH 20B,A01,083756,Briones; Jor-el Thomas Caparas,1,0,36,35
1656863323822,MATH 20B,A02,083757,Briones; Jor-el Thomas Caparas,1,0,36,35
1656863323822,MATH 20B,A03,093475,Briones; Jor-el Thomas Caparas,0,0,36,36
1656863329845,MATH 20C,A01,083760,Briones; Jor-el Thomas Caparas,1,0,35,34
1656863329845,MATH 20C,A02,083761,Briones; Jor-el Thomas Caparas,8,0,35,27
1656863329845,MATH 20C,A03,093476,Briones; Jor-el Thomas Caparas,0,1,36,36
1656863329845,MATH 20C,B01,083762,Bach; Quang Tran,0,0,30,30
1656863335870,MATH 20D,A01,083765,Tran; Brian Kha,4,0,30,26
1656863335870,MATH 20D,A02,083766,Tran; Brian Kha,4,0,30,26
1656863335870,MATH 20D,A03,083767,Tran; Brian Kha,2,0,30,28
1656863341895,MATH 20E,A01,083771,Ganguly; Soumya,5,0,32,27
1656863341895,MATH 20E,A02,083772,Ganguly; Soumya,6,0,32,26
1656863341895,MATH 20E,B01,083773,Ciotti; Benjamin,18,0,35,17
1656863341895,MATH 20E,B02,083774,Ciotti; Benjamin,17,0,35,18
1656863347918,MATH 103A,A01,083777,Greenfeld; Be'Eri,2,0,36,34
1656863347918,MATH 103A,A02,083778,Greenfeld; Be'Eri,5,0,36,31
1656863347918,MATH 103A,A03,093561,Greenfeld; Be'Eri,4,0,36,32
1656863347918,MATH 103A,B01,083779,Greenfeld; Be'Eri,6,0,36,30
1656863347918,MATH 103A,B02,083780,Greenfeld; Be'Eri,2,0,36,34
1656863347918,MATH 103A,B03,093562,Greenfeld; Be'Eri,2,0,36,34
1656863353945,MATH 105,A01,085443,Carter; Anne Toulson,13,0,35,22
1656863353945,MATH 105,A02,093477,Carter; Anne Toulson,20,0,35,15
1656863359970,MATH 109,A01,083213,Ganzberger; Geoffrey Michael,2,0,34,32
1656863359970,MATH 109,A02,083214,Ganzberger; Geoffrey Michael,2,0,34,32
1656863359970,MATH 109,A03,093478,Ganzberger; Geoffrey Michael,1,0,34,33
1656863359970,MATH 109,B01,083215,Ganzberger; Geoffrey Michael,1,0,32,31
1656863359970,MATH 109,B02,083216,Ganzberger; Geoffrey Michael,1,0,32,31
1656863359970,MATH 109,B03,093479,Ganzberger; Geoffrey Michael,6,0,32,26
1656863366001,MATH 142A,A01,083219,Chow; Bennett,6,0,32,26
1656863366001,MATH 142A,A02,083220,Chow; Bennett,9,0,32,23
1656863366001,MATH 142A,A03,093480,Chow; Bennett,7,0,32,25
1656863366001,MATH 142A,B03,093481,Chow; Bennett,7,0,32,25
1656863366001,MATH 142A,B04,093558,Chow; Bennett,10,0,32,22
1656863366001,MATH 142A,B05,093559,Chow; Bennett,6,0,32,26
1656863372023,MATH 193A,A01,083224,Rotar; Vladimir,6,0,34,28
1656863372023,MATH 193A,A02,083225,Rotar; Vladimir,3,0,34,31
1656863372023,MATH 193A,A03,083781,Rotar; Vladimir,1,0,34,33
1656863372023,MATH 193A,A04,083782,Rotar; Vladimir,6,0,34,28
1656863372023,MATH 193A,A05,093482,Rotar; Vladimir,6,0,34,28
1656863378049,MATH 197,001,091859,McAuley; Julian John,9999,0,9999,0
1656863378049,MATH 197,002,095566,Kedlaya; Kiran S.,9997,0,9999,2
1656863378049,MATH 197,003,095567,Xiao; Ming,9999,0,9999,0
1656863378049,MATH 197,004,095571,Perols; Johan Lars,9998,0,9999,1
1656863385123,COGS 9,A01,083615,Shannon; Kyle Michael,6,0,75,69
1656863391149,COGS 11,A01,083617,Boyle; Mary E. T.,18,0,48,30
1656863397179,COGS 13,A01,083071,Bastos; Amalia Pinkusfeld,8,0,71,63
1656863403211,COGS 14A,A01,092681,Semenuks; Arturs,0,1,100,100
1656863409236,COGS 14B,A01,083073,Cheng; Tzu-Han,5,0,63,58
1656863415263,COGS 17,A01,092677,Semenuks; Arturs,4,0,81,77
1656863421286,COGS 100,A01,083619,Allen; Michael Gordon,15,0,70,55
1656863427309,COGS 101A,A01,083621,Davis; Joshua Daniel,9,0,68,59
1656863433337,COGS 101B,A01,091572,Allen; Michael Gordon,8,0,65,57
1656863439360,COGS 101C,A01,083625,Delgado; Tania,17,0,35,18
1656863445384,COGS 107A,A01,083627,Boyle; Mary E. T.,13,0,60,47
1656863451407,COGS 118A,A01,083075,Gupta; Anjum,15,0,76,61
1656863457435,CSE 3,A50,083646,Miranda; Gregory Joseph,22,0,50,28
1656863463459,CSE 8A,A50,083650,Miranda; Gregory Joseph,17,1,56,39
1656863469484,CSE 11,A01,083080,Cao; Yingjun,4,15,40,36
1656863475511,CSE 12,A01,083652,Krause-Levy; Sophia Louisa,20,1,120,100
1656863481539,CSE 15L,A01,083654,Morris; Justin Loren,8,0,50,42
1656863481539,CSE 15L,A02,083655,Morris; Justin Loren,8,0,50,42
1656863487570,CSE 20,A01,083657,Tran; Khoa Dang,37,0,80,43
1656863493594,CSE 21,A01,095574,Bach; Quang Tran,21,0,48,27
1656863499631,CSE 30,A01,083084,Eldon; John,4,0,80,76
1656863499631,CSE 30,B01,095061,Bhaskar; Nishant,6,0,50,44
1656863505660,CSE 100,A01,083659,Cao; Yingjun,2,4,70,68
1656863511686,CSE 134B,A01,083661,Powell; Thomas Allan,19,0,100,81
1656863517710,CSE 140,A01,083663,Gungor; Onat,14,0,85,71
1656863523739,CSE 140L,A01,083088,Eldon; John,16,0,100,84
1656863529765,CSE 175,A01,083665,Kumar; Rakesh,3,0,25,22
1656863535788,CSE 190,A00,092507,Dubnov; Shlomo,7,0,20,13
1656863541815,ECE 45,A01,083139,Congero; Spencer William,5,0,75,70
1656863547846,ECE 65,A50,083695,Saad; Andrew S,12,0,30,18
1656863547846,ECE 65,A51,095125,Saad; Andrew S,25,0,26,1
1656863553869,ECE 109,A01,091882,Touri; Behrouz,16,0,70,54
1656863559899,ECE 180,A00,083140,Abi Samra; Nicholas Camill,0,0,30,30
1656863559899,ECE 180,B00,083141,Abi Samra; Nicholas Camill,0,0,30,30
1656863565922,MATH 10A,A01,083735,Patchell; Gregory David,1,0,30,29
1656863565922,MATH 10A,A02,083736,Patchell; Gregory David,20,0,30,10
1656863565922,MATH 10A,A03,083737,Patchell; Gregory David,15,0,30,15
1656863571948,MATH 10B,A01,083207,Lim; Seonhee,7,0,34,27
1656863571948,MATH 10B,A02,083208,Lim; Seonhee,9,0,35,26
1656863571948,MATH 10B,A03,093472,Lim; Seonhee,4,0,34,30
1656863571948,MATH 10B,B01,083739,Sinha; Shubham,9,0,30,21
1656863577974,MATH 18,A01,083743,Cinel; Cameron Alexander,6,0,30,24
1656863577974,MATH 18,A02,083744,Cinel; Cameron Alexander,15,0,30,15
1656863577974,MATH 18,A03,083745,Cinel; Cameron Alexander,8,0,30,22
1656863577974,MATH 18,B01,083748,Rideout; David Porter,3,0,37,34
1656863577974,MATH 18,B02,083749,Rideout; David Porter,3,0,36,33
1656863577974,MATH 18,B03,083750,Rideout; David Porter,2,0,37,35
1656863577974,MATH 18,B04,083751,Rideout; David Porter,5,0,36,31
1656863577974,MATH 18,B05,093473,Rideout; David Porter,4,0,36,32
1656863577974,MATH 18,B06,093474,Rideout; David Porter,5,0,36,31
1656863584006,MATH 20A,A01,083754,Zheng; Zequn,12,0,40,28
1656863590046,MATH 20B,A01,083756,Briones; Jor-el Thomas Caparas,1,0,36,35
1656863590046,MATH 20B,A02,083757,Briones; Jor-el Thomas Caparas,1,0,36,35
1656863590046,MATH 20B,A03,093475,Briones; Jor-el Thomas Caparas,0,0,36,36
1656863596077,MATH 20C,A01,083760,Briones; Jor-el Thomas Caparas,1,0,35,34
1656863596077,MATH 20C,A02,083761,Briones; Jor-el Thomas Caparas,8,0,35,27
1656863596077,MATH 20C,A03,093476,Briones; Jor-el Thomas Caparas,0,1,36,36
1656863596077,MATH 20C,B01,083762,Bach; Quang Tran,0,0,30,30
1656863602106,MATH 20D,A01,083765,Tran; Brian Kha,4,0,30,26
1656863602106,MATH 20D,A02,083766,Tran; Brian Kha,4,0,30,26
1656863602106,MATH 20D,A03,083767,Tran; Brian Kha,2,0,30,28
1656863608129,MATH 20E,A01,083771,Ganguly; Soumya,5,0,32,27
1656863608129,MATH 20E,A02,083772,Ganguly; Soumya,6,0,32,26
1656863608129,MATH 20E,B01,083773,Ciotti; Benjamin,18,0,35,17
1656863608129,MATH 20E,B02,083774,Ciotti; Benjamin,17,0,35,18
1656863614156,MATH 103A,A01,083777,Greenfeld; Be'Eri,2,0,36,34
1656863614156,MATH 103A,A02,083778,Greenfeld; Be'Eri,5,0,36,31
1656863614156,MATH 103A,A03,093561,Greenfeld; Be'Eri,4,0,36,32
1656863614156,MATH 103A,B01,083779,Greenfeld; Be'Eri,6,0,36,30
1656863614156,MATH 103A,B02,083780,Greenfeld; Be'Eri,2,0,36,34
1656863614156,MATH 103A,B03,093562,Greenfeld; Be'Eri,2,0,36,34
1656863620185,MATH 105,A01,085443,Carter; Anne Toulson,13,0,35,22
1656863620185,MATH 105,A02,093477,Carter; Anne Toulson,20,0,35,15
1656863626211,MATH 109,A01,083213,Ganzberger; Geoffrey Michael,2,0,34,32
1656863626211,MATH 109,A02,083214,Ganzberger; Geoffrey Michael,2,0,34,32
1656863626211,MATH 109,A03,093478,Ganzberger; Geoffrey Michael,1,0,34,33
1656863626211,MATH 109,B01,083215,Ganzberger; Geoffrey Michael,1,0,32,31
1656863626211,MATH 109,B02,083216,Ganzberger; Geoffrey Michael,1,0,32,31
1656863626211,MATH 109,B03,093479,Ganzberger; Geoffrey Michael,6,0,32,26
1656863632244,MATH 142A,A01,083219,Chow; Bennett,6,0,32,26
1656863632244,MATH 142A,A02,083220,Chow; Bennett,9,0,32,23
1656863632244,MATH 142A,A03,093480,Chow; Bennett,7,0,32,25
1656863632244,MATH 142A,B03,093481,Chow; Bennett,7,0,32,25
1656863632244,MATH 142A,B04,093558,Chow; Bennett,10,0,32,22
1656863632244,MATH 142A,B05,093559,Chow; Bennett,6,0,32,26
1656863638269,MATH 193A,A01,083224,Rotar; Vladimir,6,0,34,28
1656863638269,MATH 193A,A02,083225,Rotar; Vladimir,3,0,34,31
1656863638269,MATH 193A,A03,083781,Rotar; Vladimir,1,0,34,33
1656863638269,MATH 193A,A04,083782,Rotar; Vladimir,6,0,34,28
1656863638269,MATH 193A,A05,093482,Rotar; Vladimir,6,0,34,28
1656863644293,MATH 197,001,091859,McAuley; Julian John,9999,0,9999,0
1656863644293,MATH 197,002,095566,Kedlaya; Kiran S.,9997,0,9999,2
1656863644293,MATH 197,003,095567,Xiao; Ming,9999,0,9999,0
1656863644293,MATH 197,004,095571,Perols; Johan Lars,9998,0,9999,1
1656863651351,COGS 9,A01,083615,Shannon; Kyle Michael,6,0,75,69
1656863657374,COGS 11,A01,083617,Boyle; Mary E. T.,18,0,48,30
1656863663401,COGS 13,A01,083071,Bastos; Amalia Pinkusfeld,8,0,71,63
1656863669427,COGS 14A,A01,092681,Semenuks; Arturs,0,1,100,100
1656863675455,COGS 14B,A01,083073,Cheng; Tzu-Han,5,0,63,58
1656863681482,COGS 17,A01,092677,Semenuks; Arturs,4,0,81,77
1656863687506,COGS 100,A01,083619,Allen; Michael Gordon,15,0,70,55
1656863693533,COGS 101A,A01,083621,Davis; Joshua Daniel,9,0,68,59
1656863699561,COGS 101B,A01,091572,Allen; Michael Gordon,8,0,65,57
1656863705584,COGS 101C,A01,083625,Delgado; Tania,17,0,35,18
1656863711607,COGS 107A,A01,083627,Boyle; Mary E. T.,13,0,60,47
1656863717633,COGS 118A,A01,083075,Gupta; Anjum,15,0,76,61
1656863723660,CSE 3,A50,083646,Miranda; Gregory Joseph,22,0,50,28
1656863729684,CSE 8A,A50,083650,Miranda; Gregory Joseph,17,1,56,39
1656863735711,CSE 11,A01,083080,Cao; Yingjun,4,15,40,36
1656863741735,CSE 12,A01,083652,Krause-Levy; Sophia Louisa,20,1,120,100
1656863747761,CSE 15L,A01,083654,Morris; Justin Loren,8,0,50,42
1656863747761,CSE 15L,A02,083655,Morris; Justin Loren,8,0,50,42
1656863753788,CSE 20,A01,083657,Tran; Khoa Dang,37,0,80,43
1656863759813,CSE 21,A01,095574,Bach; Quang Tran,21,0,48,27
1656863765836,CSE 30,A01,083084,Eldon; John,4,0,80,76
1656863765836,CSE 30,B01,095061,Bhaskar; Nishant,6,0,50,44
1656863771860,CSE 100,A01,083659,Cao; Yingjun,2,4,70,68
1656863777882,CSE 134B,A01,083661,Powell; Thomas Allan,19,0,100,81
1656863783908,CSE 140,A01,083663,Gungor; Onat,14,0,85,71
1656863789931,CSE 140L,A01,083088,Eldon; John,16,0,100,84
1656863795963,CSE 175,A01,083665,Kumar; Rakesh,3,0,25,22
1656863801986,CSE 190,A00,092507,Dubnov; Shlomo,7,0,20,13
1656863808014,ECE 45,A01,083139,Congero; Spencer William,5,0,75,70
1656863814039,ECE 65,A50,083695,Saad; Andrew S,12,0,30,18
1656863814039,ECE 65,A51,095125,Saad; Andrew S,25,0,26,1
1656863820071,ECE 109,A01,091882,Touri; Behrouz,16,0,70,54
1656863826094,ECE 180,A00,083140,Abi Samra; Nicholas Camill,0,0,30,30
1656863826094,ECE 180,B00,083141,Abi Samra; Nicholas Camill,0,0,30,30
1656863832121,MATH 10A,A01,083735,Patchell; Gregory David,1,0,30,29
1656863832121,MATH 10A,A02,083736,Patchell; Gregory David,20,0,30,10
1656863832121,MATH 10A,A03,083737,Patchell; Gregory David,15,0,30,15
1656863838146,MATH 10B,A01,083207,Lim; Seonhee,7,0,34,27
1656863838146,MATH 10B,A02,083208,Lim; Seonhee,9,0,35,26
1656863838146,MATH 10B,A03,093472,Lim; Seonhee,4,0,34,30
1656863838146,MATH 10B,B01,083739,Sinha; Shubham,9,0,30,21
1656863844170,MATH 18,A01,083743,Cinel; Cameron Alexander,6,0,30,24
1656863844170,MATH 18,A02,083744,Cinel; Cameron Alexander,15,0,30,15
1656863844170,MATH 18,A03,083745,Cinel; Cameron Alexander,8,0,30,22
1656863844170,MATH 18,B01,083748,Rideout; David Porter,3,0,37,34
1656863844170,MATH 18,B02,083749,Rideout; David Porter,3,0,36,33
1656863844170,MATH 18,B03,083750,Rideout; David Porter,2,0,37,35
1656863844170,MATH 18,B04,083751,Rideout; David Porter,5,0,36,31
1656863844170,MATH 18,B05,093473,Rideout; David Porter,4,0,36,32
1656863844170,MATH 18,B06,093474,Rideout; David Porter,5,0,36,31
1656863850194,MATH 20A,A01,083754,Zheng; Zequn,12,0,40,28
1656863856297,MATH 20B,A01,083756,Briones; Jor-el Thomas Caparas,1,0,36,35
1656863856297,MATH 20B,A02,083757,Briones; Jor-el Thomas Caparas,1,0,36,35
1656863856297,MATH 20B,A03,093475,Briones; Jor-el Thomas Caparas,0,0,36,36
1656863862321,MATH 20C,A01,083760,Briones; Jor-el Thomas Caparas,1,0,35,34
1656863862321,MATH 20C,A02,083761,Briones; Jor-el Thomas Caparas,8,0,35,27
1656863862321,MATH 20C,A03,093476,Briones; Jor-el Thomas Caparas,0,1,36,36
1656863862321,MATH 20C,B01,083762,Bach; Quang Tran,0,0,30,30
1656863868349,MATH 20D,A01,083765,Tran; Brian Kha,4,0,30,26
1656863868349,MATH 20D,A02,083766,Tran; Brian Kha,4,0,30,26
1656863868349,MATH 20D,A03,083767,Tran; Brian Kha,2,0,30,28
1656863874391,MATH 20E,A01,083771,Ganguly; Soumya,5,0,32,27
1656863874391,MATH 20E,A02,083772,Ganguly; Soumya,6,0,32,26
1656863874391,MATH 20E,B01,083773,Ciotti; Benjamin,18,0,35,17
1656863874391,MATH 20E,B02,083774,Ciotti; Benjamin,17,0,35,18
1656863880420,MATH 103A,A01,083777,Greenfeld; Be'Eri,2,0,36,34
1656863880420,MATH 103A,A02,083778,Greenfeld; Be'Eri,5,0,36,31
1656863880420,MATH 103A,A03,093561,Greenfeld; Be'Eri,4,0,36,32
1656863880420,MATH 103A,B01,083779,Greenfeld; Be'Eri,6,0,36,30
1656863880420,MATH 103A,B02,083780,Greenfeld; Be'Eri,2,0,36,34
1656863880420,MATH 103A,B03,093562,Greenfeld; Be'Eri,2,0,36,34
1656863886444,MATH 105,A01,085443,Carter; Anne Toulson,13,0,35,22
1656863886444,MATH 105,A02,093477,Carter; Anne Toulson,20,0,35,15
1656863892469,MATH 109,A01,083213,Ganzberger; Geoffrey Michael,2,0,34,32
1656863892469,MATH 109,A02,083214,Ganzberger; Geoffrey Michael,2,0,34,32
1656863892469,MATH 109,A03,093478,Ganzberger; Geoffrey Michael,1,0,34,33
1656863892469,MATH 109,B01,083215,Ganzberger; Geoffrey Michael,1,0,32,31
1656863892469,MATH 109,B02,083216,Ganzberger; Geoffrey Michael,1,0,32,31
1656863892469,MATH 109,B03,093479,Ganzberger; Geoffrey Michael,6,0,32,26
1656863898497,MATH 142A,A01,083219,Chow; Bennett,6,0,32,26
1656863898497,MATH 142A,A02,083220,Chow; Bennett,9,0,32,23
1656863898497,MATH 142A,A03,093480,Chow; Bennett,7,0,32,25
1656863898497,MATH 142A,B03,093481,Chow; Bennett,7,0,32,25
1656863898497,MATH 142A,B04,093558,Chow; Bennett,10,0,32,22
1656863898497,MATH 142A,B05,093559,Chow; Bennett,6,0,32,26
1656863904523,MATH 193A,A01,083224,Rotar; Vladimir,6,0,34,28
1656863904523,MATH 193A,A02,083225,Rotar; Vladimir,3,0,34,31
1656863904523,MATH 193A,A03,083781,Rotar; Vladimir,1,0,34,33
1656863904523,MATH 193A,A04,083782,Rotar; Vladimir,6,0,34,28
1656863904523,MATH 193A,A05,093482,Rotar; Vladimir,6,0,34,28
1656863910554,MATH 197,001,091859,McAuley; Julian John,9999,0,9999,0
1656863910554,MATH 197,002,095566,Kedlaya; Kiran S.,9997,0,9999,2
1656863910554,MATH 197,003,095567,Xiao; Ming,9999,0,9999,0
1656863910554,MATH 197,004,095571,Perols; Johan Lars,9998,0,9999,1
1656863917608,COGS 9,A01,083615,Shannon; Kyle Michael,6,0,75,69
1656863923631,COGS 11,A01,083617,Boyle; Mary E. T.,18,0,48,30
1656863929658,COGS 13,A01,083071,Bastos; Amalia Pinkusfeld,8,0,71,63
1656863935684,COGS 14A,A01,092681,Semenuks; Arturs,0,1,100,100
1656863941715,COGS 14B,A01,083073,Cheng; Tzu-Han,5,0,63,58
1656863947740,COGS 17,A01,092677,Semenuks; Arturs,4,0,81,77
1656863953764,COGS 100,A01,083619,Allen; Michael Gordon,15,0,70,55
1656863959786,COGS 101A,A01,083621,Davis; Joshua Daniel,9,0,68,59
1656863965819,COGS 101B,A01,091572,Allen; Michael Gordon,8,0,65,57
1656863971845,COGS 101C,A01,083625,Delgado; Tania,17,0,35,18
1656863977868,COGS 107A,A01,083627,Boyle; Mary E. T.,13,0,60,47
1656863983890,COGS 118A,A01,083075,Gupta; Anjum,15,0,76,61
1656863989913,CSE 3,A50,083646,Miranda; Gregory Joseph,22,0,50,28
1656863995934,CSE 8A,A50,083650,Miranda; Gregory Joseph,17,1,56,39
1656864001957,CSE 11,A01,083080,Cao; Yingjun,4,15,40,36
1656864007995,CSE 12,A01,083652,Krause-Levy; Sophia Louisa,20,1,120,100
1656864014021,CSE 15L,A01,083654,Morris; Justin Loren,8,0,50,42
1656864014021,CSE 15L,A02,083655,Morris; Justin Loren,8,0,50,42
1656864020049,CSE 20,A01,083657,Tran; Khoa Dang,37,0,80,43
1656864026075,CSE 21,A01,095574,Bach; Quang Tran,21,0,48,27
1656864032099,CSE 30,A01,083084,Eldon; John,4,0,80,76
1656864032099,CSE 30,B01,095061,Bhaskar; Nishant,6,0,50,44
1656864038122,CSE 100,A01,083659,Cao; Yingjun,2,4,70,68
1656864044153,CSE 134B,A01,083661,Powell; Thomas Allan,19,0,100,81
1656864050187,CSE 140,A01,083663,Gungor; Onat,14,0,85,71
1656864056212,CSE 140L,A01,083088,Eldon; John,16,0,100,84
1656864062236,CSE 175,A01,083665,Kumar; Rakesh,3,0,25,22
1656864068262,CSE 190,A00,092507,Dubnov; Shlomo,7,0,20,13
1656864074288,ECE 45,A01,083139,Congero; Spencer William,5,0,75,70
1656864080314,ECE 65,A50,083695,Saad; Andrew S,12,0,30,18
1656864080314,ECE 65,A51,095125,Saad; Andrew S,25,0,26,1
1656864086337,ECE 109,A01,091882,Touri; Behrouz,16,0,70,54
1656864092364,ECE 180,A00,083140,Abi Samra; Nicholas Camill,0,0,30,30
1656864092364,ECE 180,B00,083141,Abi Samra; Nicholas Camill,0,0,30,30
1656864098393,MATH 10A,A01,083735,Patchell; Gregory David,1,0,30,29
1656864098393,MATH 10A,A02,083736,Patchell; Gregory David,20,0,30,10
1656864098393,MATH 10A,A03,083737,Patchell; Gregory David,15,0,30,15
1656864104418,MATH 10B,A01,083207,Lim; Seonhee,7,0,34,27
1656864104418,MATH 10B,A02,083208,Lim; Seonhee,9,0,35,26
1656864104418,MATH 10B,A03,093472,Lim; Seonhee,4,0,34,30
1656864104418,MATH 10B,B01,083739,Sinha; Shubham,9,0,30,21
1656864110443,MATH 18,A01,083743,Cinel; Cameron Alexander,6,0,30,24
1656864110443,MATH 18,A02,083744,Cinel; Cameron Alexander,15,0,30,15
1656864110443,MATH 18,A03,083745,Cinel; Cameron Alexander,8,0,30,22
1656864110443,MATH 18,B01,083748,Rideout; David Porter,3,0,37,34
1656864110443,MATH 18,B02,083749,Rideout; David Porter,3,0,36,33
1656864110443,MATH 18,B03,083750,Rideout; David Porter,2,0,37,35
1656864110443,MATH 18,B04,083751,Rideout; David Porter,5,0,36,31
1656864110443,MATH 18,B05,093473,Rideout; David Porter,4,0,36,32
1656864110443,MATH 18,B06,093474,Rideout; David Porter,5,0,36,31
1656864116478,MATH 20A,A01,083754,Zheng; Zequn,12,0,40,28
1656864122503,MATH 20B,A01,083756,Briones; Jor-el Thomas Caparas,1,0,36,35
1656864122503,MATH 20B,A02,083757,Briones; Jor-el Thomas Caparas,1,0,36,35
1656864122503,MATH 20B,A03,093475,Briones; Jor-el Thomas Caparas,0,0,36,36
1656864128547,MATH 20C,A01,083760,Briones; Jor-el Thomas Caparas,1,0,35,34
1656864128547,MATH 20C,A02,083761,Briones; Jor-el Thomas Caparas,8,0,35,27
1656864128547,MATH 20C,A03,093476,Briones; Jor-el Thomas Caparas,0,1,36,36
1656864128547,MATH 20C,B01,083762,Bach; Quang Tran,0,0,30,30
1656864134580,MATH 20D,A01,083765,Tran; Brian Kha,4,0,30,26
1656864134580,MATH 20D,A02,083766,Tran; Brian Kha,4,0,30,26
1656864134580,MATH 20D,A03,083767,Tran; Brian Kha,2,0,30,28
1656864140608,MATH 20E,A01,083771,Ganguly; Soumya,5,0,32,27
1656864140608,MATH 20E,A02,083772,Ganguly; Soumya,6,0,32,26
1656864140608,MATH 20E,B01,083773,Ciotti; Benjamin,18,0,35,17
1656864140608,MATH 20E,B02,083774,Ciotti; Benjamin,17,0,35,18
1656864146637,MATH 103A,A01,083777,Greenfeld; Be'Eri,2,0,36,34
1656864146637,MATH 103A,A02,083778,Greenfeld; Be'Eri,5,0,36,31
1656864146637,MATH 103A,A03,093561,Greenfeld; Be'Eri,4,0,36,32
1656864146637,MATH 103A,B01,083779,Greenfeld; Be'Eri,6,0,36,30
1656864146637,MATH 103A,B02,083780,Greenfeld; Be'Eri,2,0,36,34
1656864146637,MATH 103A,B03,093562,Greenfeld; Be'Eri,2,0,36,34
1656864152662,MATH 105,A01,085443,Carter; Anne Toulson,13,0,35,22
1656864152662,MATH 105,A02,093477,Carter; Anne Toulson,20,0,35,15
1656864158686,MATH 109,A01,083213,Ganzberger; Geoffrey Michael,2,0,34,32
1656864158686,MATH 109,A02,083214,Ganzberger; Geoffrey Michael,2,0,34,32
1656864158686,MATH 109,A03,093478,Ganzberger; Geoffrey Michael,1,0,34,33
1656864158686,MATH 109,B01,083215,Ganzberger; Geoffrey Michael,1,0,32,31
1656864158686,MATH 109,B02,083216,Ganzberger; Geoffrey Michael,1,0,32,31
1656864158686,MATH 109,B03,093479,Ganzberger; Geoffrey Michael,6,0,32,26
1656864164715,MATH 142A,A01,083219,Chow; Bennett,6,0,32,26
1656864164715,MATH 142A,A02,083220,Chow; Bennett,9,0,32,23
1656864164715,MATH 142A,A03,093480,Chow; Bennett,7,0,32,25
1656864164715,MATH 142A,B03,093481,Chow; Bennett,7,0,32,25
1656864164715,MATH 142A,B04,093558,Chow; Bennett,10,0,32,22
1656864164715,MATH 142A,B05,093559,Chow; Bennett,6,0,32,26
1656864170739,MATH 193A,A01,083224,Rotar; Vladimir,6,0,34,28
1656864170739,MATH 193A,A02,083225,Rotar; Vladimir,3,0,34,31
1656864170739,MATH 193A,A03,083781,Rotar; Vladimir,1,0,34,33
1656864170739,MATH 193A,A04,083782,Rotar; Vladimir,6,0,34,28
1656864170739,MATH 193A,A05,093482,Rotar; Vladimir,6,0,34,28
1656864176763,MATH 197,001,091859,McAuley; Julian John,9999,0,9999,0
1656864176763,MATH 197,002,095566,Kedlaya; Kiran S.,9997,0,9999,2
1656864176763,MATH 197,003,095567,Xiao; Ming,9999,0,9999,0
1656864176763,MATH 197,004,095571,Perols; Johan Lars,9998,0,9999,1
1656864183835,COGS 9,A01,083615,Shannon; Kyle Michael,6,0,75,69
1656864189859,COGS 11,A01,083617,Boyle; Mary E. T.,18,0,48,30
1656864195891,COGS 13,A01,083071,Bastos; Amalia Pinkusfeld,8,0,71,63
1656864201913,COGS 14A,A01,092681,Semenuks; Arturs,0,1,100,100
1656864207937,COGS 14B,A01,083073,Cheng; Tzu-Han,5,0,63,58
1656864213961,COGS 17,A01,092677,Semenuks; Arturs,4,0,81,77
1656864219991,COGS 100,A01,083619,Allen; Michael Gordon,15,0,70,55
1656864226013,COGS 101A,A01,083621,Davis; Joshua Daniel,9,0,68,59
1656864232041,COGS 101B,A01,091572,Allen; Michael Gordon,8,0,65,57
1656864238067,COGS 101C,A01,083625,Delgado; Tania,17,0,35,18
1656864244095,COGS 107A,A01,083627,Boyle; Mary E. T.,13,0,60,47
1656864250123,COGS 118A,A01,083075,Gupta; Anjum,15,0,76,61
1656864256156,CSE 3,A50,083646,Miranda; Gregory Joseph,22,0,50,28
1656864262189,CSE 8A,A50,083650,Miranda; Gregory Joseph,17,1,56,39
1656864268214,CSE 11,A01,083080,Cao; Yingjun,4,15,40,36
1656864274240,CSE 12,A01,083652,Krause-Levy; Sophia Louisa,20,1,120,100
1656864280267,CSE 15L,A01,083654,Morris; Justin Loren,8,0,50,42
1656864280267,CSE 15L,A02,083655,Morris; Justin Loren,8,0,50,42
1656864286291,CSE 20,A01,083657,Tran; Khoa Dang,37,0,80,43
1656864292319,CSE 21,A01,095574,Bach; Quang Tran,21,0,48,27
1656864298342,CSE 30,A01,083084,Eldon; John,4,0,80,76
1656864298342,CSE 30,B01,095061,Bhaskar; Nishant,6,0,50,44
1656864304369,CSE 100,A01,083659,Cao; Yingjun,2,4,70,68
1656864310398,CSE 134B,A01,083661,Powell; Thomas Allan,19,0,100,81
1656864316424,CSE 140,A01,083663,Gungor; Onat,14,0,85,71
1656864322449,CSE 140L,A01,083088,Eldon; John,16,0,100,84
1656864328477,CSE 175,A01,083665,Kumar; Rakesh,3,0,25,22
1656864334503,CSE 190,A00,092507,Dubnov; Shlomo,7,0,20,13
1656864340527,ECE 45,A01,083139,Congero; Spencer William,5,0,75,70
1656864346550,ECE 65,A50,083695,Saad; Andrew S,12,0,30,18
1656864346550,ECE 65,A51,095125,Saad; Andrew S,25,0,26,1
1656864352577,ECE 109,A01,091882,Touri; Behrouz,16,0,70,54
1656864358599,ECE 180,A00,083140,Abi Samra; Nicholas Camill,0,0,30,30
1656864358599,ECE 180,B00,083141,Abi Samra; Nicholas Camill,0,0,30,30
1656864364622,MATH 10A,A01,083735,Patchell; Gregory David,1,0,30,29
1656864364622,MATH 10A,A02,083736,Patchell; Gregory David,20,0,30,10
1656864364622,MATH 10A,A03,083737,Patchell; Gregory David,15,0,30,15
1656864370649,MATH 10B,A01,083207,Lim; Seonhee,7,0,34,27
1656864370649,MATH 10B,A02,083208,Lim; Seonhee,9,0,35,26
1656864370649,MATH 10B,A03,093472,Lim; Seonhee,4,0,34,30
1656864370649,MATH 10B,B01,083739,Sinha; Shubham,9,0,30,21
1656864376682,MATH 18,A01,083743,Cinel; Cameron Alexander,6,0,30,24
1656864376682,MATH 18,A02,083744,Cinel; Cameron Alexander,15,0,30,15
1656864376682,MATH 18,A03,083745,Cinel; Cameron Alexander,8,0,30,22
1656864376682,MATH 18,B01,083748,Rideout; David Porter,3,0,37,34
1656864376682,MATH 18,B02,083749,Rideout; David Porter,3,0,36,33
1656864376682,MATH 18,B03,083750,Rideout; David Porter,2,0,37,35
1656864376682,MATH 18,B04,083751,Rideout; David Porter,5,0,36,31
1656864376682,MATH 18,B05,093473,Rideout; David Porter,4,0,36,32
1656864376682,MATH 18,B06,093474,Rideout; David Porter,5,0,36,31
1656864382706,MATH 20A,A01,083754,Zheng; Zequn,12,0,40,28
1656864388728,MATH 20B,A01,083756,Briones; Jor-el Thomas Caparas,1,0,36,35
1656864388728,MATH 20B,A02,083757,Briones; Jor-el Thomas Caparas,1,0,36,35
1656864388728,MATH 20B,A03,093475,Briones; Jor-el Thomas Caparas,0,0,36,36
1656864394755,MATH 20C,A01,083760,Briones; Jor-el Thomas Caparas,1,0,35,34
1656864394755,MATH 20C,A02,083761,Briones; Jor-el Thomas Caparas,8,0,35,27
1656864394755,MATH 20C,A03,093476,Briones; Jor-el Thomas Caparas,0,1,36,36
1656864394755,MATH 20C,B01,083762,Bach; Quang Tran,0,0,30,30
1656864400787,MATH 20D,A01,083765,Tran; Brian Kha,4,0,30,26
1656864400787,MATH 20D,A02,083766,Tran; Brian Kha,4,0,30,26
1656864400787,MATH 20D,A03,083767,Tran; Brian Kha,2,0,30,28
1656864406808,MATH 20E,A01,083771,Ganguly; Soumya,5,0,32,27
1656864406808,MATH 20E,A02,083772,Ganguly; Soumya,6,0,32,26
1656864406808,MATH 20E,B01,083773,Ciotti; Benjamin,18,0,35,17
1656864406808,MATH 20E,B02,083774,Ciotti; Benjamin,17,0,35,18
1656864412834,MATH 103A,A01,083777,Greenfeld; Be'Eri,2,0,36,34
1656864412834,MATH 103A,A02,083778,Greenfeld; Be'Eri,5,0,36,31
1656864412834,MATH 103A,A03,093561,Greenfeld; Be'Eri,4,0,36,32
1656864412834,MATH 103A,B01,083779,Greenfeld; Be'Eri,6,0,36,30
1656864412834,MATH 103A,B02,083780,Greenfeld; Be'Eri,2,0,36,34
1656864412834,MATH 103A,B03,093562,Greenfeld; Be'Eri,2,0,36,34
1656864418862,MATH 105,A01,085443,Carter; Anne Toulson,13,0,35,22
1656864418862,MATH 105,A02,093477,Carter; Anne Toulson,20,0,35,15
1656864424891,MATH 109,A01,083213,Ganzberger; Geoffrey Michael,2,0,34,32
1656864424891,MATH 109,A02,083214,Ganzberger; Geoffrey Michael,2,0,34,32
1656864424891,MATH 109,A03,093478,Ganzberger; Geoffrey Michael,1,0,34,33
1656864424891,MATH 109,B01,083215,Ganzberger; Geoffrey Michael,1,0,32,31
1656864424891,MATH 109,B02,083216,Ganzberger; Geoffrey Michael,1,0,32,31
1656864424891,MATH 109,B03,093479,Ganzberger; Geoffrey Michael,6,0,32,26
1656864430918,MATH 142A,A01,083219,Chow; Bennett,6,0,32,26
1656864430918,MATH 142A,A02,083220,Chow; Bennett,9,0,32,23
1656864430918,MATH 142A,A03,093480,Chow; Bennett,7,0,32,25
1656864430918,MATH 142A,B03,093481,Chow; Bennett,7,0,32,25
1656864430918,MATH 142A,B04,093558,Chow; Bennett,10,0,32,22
1656864430918,MATH 142A,B05,093559,Chow; Bennett,6,0,32,26
1656864436945,MATH 193A,A01,083224,Rotar; Vladimir,6,0,34,28
1656864436945,MATH 193A,A02,083225,Rotar; Vladimir,3,0,34,31
1656864436945,MATH 193A,A03,083781,Rotar; Vladimir,1,0,34,33
1656864436945,MATH 193A,A04,083782,Rotar; Vladimir,6,0,34,28
1656864436945,MATH 193A,A05,093482,Rotar; Vladimir,6,0,34,28
1656864442971,MATH 197,001,091859,McAuley; Julian John,9999,0,9999,0
1656864442971,MATH 197,002,095566,Kedlaya; Kiran S.,9997,0,9999,2
1656864442971,MATH 197,003,095567,Xiao; Ming,9999,0,9999,0
1656864442971,MATH 197,004,095571,Perols; Johan Lars,9998,0,9999,1
1656864450128,COGS 9,A01,083615,Shannon; Kyle Michael,6,0,75,69
1656864456154,COGS 11,A01,083617,Boyle; Mary E. T.,18,0,48,30
1656864462182,COGS 13,A01,083071,Bastos; Amalia Pinkusfeld,8,0,71,63
1656864468205,COGS 14A,A01,092681,Semenuks; Arturs,0,1,100,100
1656864474230,COGS 14B,A01,083073,Cheng; Tzu-Han,5,0,63,58
1656864480256,COGS 17,A01,092677,Semenuks; Arturs,4,0,81,77
1656864486279,COGS 100,A01,083619,Allen; Michael Gordon,15,0,70,55
1656864492306,COGS 101A,A01,083621,Davis; Joshua Daniel,9,0,68,59
1656864498333,COGS 101B,A01,091572,Allen; Michael Gordon,8,0,65,57
1656864504369,COGS 101C,A01,083625,Delgado; Tania,17,0,35,18
1656864510403,COGS 107A,A01,083627,Boyle; Mary E. T.,13,0,60,47
1656864516436,COGS 118A,A01,083075,Gupta; Anjum,15,0,76,61
1656864522465,CSE 3,A50,083646,Miranda; Gregory Joseph,22,0,50,28
1656864528488,CSE 8A,A50,083650,Miranda; Gregory Joseph,17,1,56,39
1656864534512,CSE 11,A01,083080,Cao; Yingjun,4,15,40,36
1656864540540,CSE 12,A01,083652,Krause-Levy; Sophia Louisa,20,1,120,100
1656864546562,CSE 15L,A01,083654,Morris; Justin Loren,8,0,50,42
1656864546562,CSE 15L,A02,083655,Morris; Justin Loren,8,0,50,42
1656864552586,CSE 20,A01,083657,Tran; Khoa Dang,37,0,80,43
1656864558611,CSE 21,A01,095574,Bach; Quang Tran,21,0,48,27
1656864564640,CSE 30,A01,083084,Eldon; John,4,0,80,76
1656864564640,CSE 30,B01,095061,Bhaskar; Nishant,6,0,50,44
1656864570667,CSE 100,A01,083659,Cao; Yingjun,2,4,70,68
1656864576691,CSE 134B,A01,083661,Powell; Thomas Allan,19,0,100,81
1656864582718,CSE 140,A01,083663,Gungor; Onat,14,0,85,71
1656864588745,CSE 140L,A01,083088,Eldon; John,16,0,100,84
1656864594769,CSE 175,A01,083665,Kumar; Rakesh,3,0,25,22
1656864600791,CSE 190,A00,092507,Dubnov; Shlomo,7,0,20,13
1656864606819,ECE 45,A01,083139,Congero; Spencer William,5,0,75,70
1656864612842,ECE 65,A50,083695,Saad; Andrew S,12,0,30,18
1656864612842,ECE 65,A51,095125,Saad; Andrew S,25,0,26,1
1656864618869,ECE 109,A01,091882,Touri; Behrouz,16,0,70,54
1656864624893,ECE 180,A00,083140,Abi Samra; Nicholas Camill,0,0,30,30
1656864624893,ECE 180,B00,083141,Abi Samra; Nicholas Camill,0,0,30,30
1656864630917,MATH 10A,A01,083735,Patchell; Gregory David,1,0,30,29
1656864630917,MATH 10A,A02,083736,Patchell; Gregory David,20,0,30,10
1656864630917,MATH 10A,A03,083737,Patchell; Gregory David,15,0,30,15
1656864636940,MATH 10B,A01,083207,Lim; Seonhee,7,0,34,27
1656864636940,MATH 10B,A02,083208,Lim; Seonhee,9,0,35,26
1656864636940,MATH 10B,A03,093472,Lim; Seonhee,4,0,34,30
1656864636940,MATH 10B,B01,083739,Sinha; Shubham,9,0,30,21
1656864642966,MATH 18,A01,083743,Cinel; Cameron Alexander,6,0,30,24
1656864642966,MATH 18,A02,083744,Cinel; Cameron Alexander,15,0,30,15
1656864642966,MATH 18,A03,083745,Cinel; Cameron Alexander,8,0,30,22
1656864642966,MATH 18,B01,083748,Rideout; David Porter,3,0,37,34
1656864642966,MATH 18,B02,083749,Rideout; David Porter,3,0,36,33
1656864642966,MATH 18,B03,083750,Rideout; David Porter,2,0,37,35
1656864642966,MATH 18,B04,083751,Rideout; David Porter,5,0,36,31
1656864642966,MATH 18,B05,093473,Rideout; David Porter,4,0,36,32
1656864642966,MATH 18,B06,093474,Rideout; David Porter,5,0,36,31
1656864648989,MATH 20A,A01,083754,Zheng; Zequn,12,0,40,28
1656864655014,MATH 20B,A01,083756,Briones; Jor-el Thomas Caparas,1,0,36,35
1656864655014,MATH 20B,A02,083757,Briones; Jor-el Thomas Caparas,1,0,36,35
1656864655014,MATH 20B,A03,093475,Briones; Jor-el Thomas Caparas,0,0,36,36
1656864661040,MATH 20C,A01,083760,Briones; Jor-el Thomas Caparas,1,0,35,34
1656864661040,MATH 20C,A02,083761,Briones; Jor-el Thomas Caparas,8,0,35,27
1656864661040,MATH 20C,A03,093476,Briones; Jor-el Thomas Caparas,0,1,36,36
1656864661040,MATH 20C,B01,083762,Bach; Quang Tran,0,0,30,30
1656864667064,MATH 20D,A01,083765,Tran; Brian Kha,4,0,30,26
1656864667064,MATH 20D,A02,083766,Tran; Brian Kha,4,0,30,26
1656864667064,MATH 20D,A03,083767,Tran; Brian Kha,2,0,30,28
1656864673088,MATH 20E,A01,083771,Ganguly; Soumya,5,0,32,27
1656864673088,MATH 20E,A02,083772,Ganguly; Soumya,6,0,32,26
1656864673088,MATH 20E,B01,083773,Ciotti; Benjamin,18,0,35,17
1656864673088,MATH 20E,B02,083774,Ciotti; Benjamin,17,0,35,18
1656864679113,MATH 103A,A01,083777,Greenfeld; Be'Eri,2,0,36,34
1656864679113,MATH 103A,A02,083778,Greenfeld; Be'Eri,5,0,36,31
1656864679113,MATH 103A,A03,093561,Greenfeld; Be'Eri,4,0,36,32
1656864679113,MATH 103A,B01,083779,Greenfeld; Be'Eri,6,0,36,30
1656864679113,MATH 103A,B02,083780,Greenfeld; Be'Eri,2,0,36,34
1656864679113,MATH 103A,B03,093562,Greenfeld; Be'Eri,2,0,36,34
1656864685136,MATH 105,A01,085443,Carter; Anne Toulson,13,0,35,22
1656864685136,MATH 105,A02,093477,Carter; Anne Toulson,20,0,35,15
1656864691164,MATH 109,A01,083213,Ganzberger; Geoffrey Michael,2,0,34,32
1656864691164,MATH 109,A02,083214,Ganzberger; Geoffrey Michael,2,0,34,32
1656864691164,MATH 109,A03,093478,Ganzberger; Geoffrey Michael,1,0,34,33
1656864691164,MATH 109,B01,083215,Ganzberger; Geoffrey Michael,1,0,32,31
1656864691164,MATH 109,B02,083216,Ganzberger; Geoffrey Michael,1,0,32,31
1656864691164,MATH 109,B03,093479,Ganzberger; Geoffrey Michael,6,0,32,26
1656864697189,MATH 142A,A01,083219,Chow; Bennett,6,0,32,26
1656864697189,MATH 142A,A02,083220,Chow; Bennett,9,0,32,23
1656864697189,MATH 142A,A03,093480,Chow; Bennett,7,0,32,25
1656864697189,MATH 142A,B03,093481,Chow; Bennett,7,0,32,25
1656864697189,MATH 142A,B04,093558,Chow; Bennett,10,0,32,22
1656864697189,MATH 142A,B05,093559,Chow; Bennett,6,0,32,26
1656864703217,MATH 193A,A01,083224,Rotar; Vladimir,6,0,34,28
1656864703217,MATH 193A,A02,083225,Rotar; Vladimir,3,0,34,31
1656864703217,MATH 193A,A03,083781,Rotar; Vladimir,1,0,34,33
1656864703217,MATH 193A,A04,083782,Rotar; Vladimir,6,0,34,28
1656864703217,MATH 193A,A05,093482,Rotar; Vladimir,6,0,34,28
1656864709248,MATH 197,001,091859,McAuley; Julian John,9999,0,9999,0
1656864709248,MATH 197,002,095566,Kedlaya; Kiran S.,9997,0,9999,2
1656864709248,MATH 197,003,095567,Xiao; Ming,9999,0,9999,0
1656864709248,MATH 197,004,095571,Perols; Johan Lars,9998,0,9999,1
1656864716300,COGS 9,A01,083615,Shannon; Kyle Michael,6,0,75,69
1656864722333,COGS 11,A01,083617,Boyle; Mary E. T.,18,0,48,30
1656864728356,COGS 13,A01,083071,Bastos; Amalia Pinkusfeld,8,0,71,63
1656864734388,COGS 14A,A01,092681,Semenuks; Arturs,0,1,100,100
1656864740414,COGS 14B,A01,083073,Cheng; Tzu-Han,5,0,63,58
1656864746437,COGS 17,A01,092677,Semenuks; Arturs,4,0,81,77
1656864752461,COGS 100,A01,083619,Allen; Michael Gordon,15,0,70,55
1656864758489,COGS 101A,A01,083621,Davis; Joshua Daniel,9,0,68,59
1656864764516,COGS 101B,A01,091572,Allen; Michael Gordon,8,0,65,57
1656864770544,COGS 101C,A01,083625,Delgado; Tania,17,0,35,18
1656864776567,COGS 107A,A01,083627,Boyle; Mary E. T.,13,0,60,47
1656864782592,COGS 118A,A01,083075,Gupta; Anjum,15,0,76,61
1656864788617,CSE 3,A50,083646,Miranda; Gregory Joseph,22,0,50,28
1656864794644,CSE 8A,A50,083650,Miranda; Gregory Joseph,17,1,56,39
1656864800672,CSE 11,A01,083080,Cao; Yingjun,4,15,40,36
1656864806697,CSE 12,A01,083652,Krause-Levy; Sophia Louisa,20,1,120,100
1656864812721,CSE 15L,A01,083654,Morris; Justin Loren,8,0,50,42
1656864812721,CSE 15L,A02,083655,Morris; Justin Loren,8,0,50,42
1656864818747,CSE 20,A01,083657,Tran; Khoa Dang,37,0,80,43
1656864824771,CSE 21,A01,095574,Bach; Quang Tran,21,0,48,27
1656864830815,CSE 30,A01,083084,Eldon; John,4,0,80,76
1656864830815,CSE 30,B01,095061,Bhaskar; Nishant,6,0,50,44
1656864836838,CSE 100,A01,083659,Cao; Yingjun,2,4,70,68
1656864842862,CSE 134B,A01,083661,Powell; Thomas Allan,19,0,100,81
1656864848894,CSE 140,A01,083663,Gungor; Onat,14,0,85,71
1656864854917,CSE 140L,A01,083088,Eldon; John,16,0,100,84
1656864860943,CSE 175,A01,083665,Kumar; Rakesh,3,0,25,22
1656864866970,CSE 190,A00,092507,Dubnov; Shlomo,7,0,20,13
1656864872999,ECE 45,A01,083139,Congero; Spencer William,5,0,75,70
1656864879031,ECE 65,A50,083695,Saad; Andrew S,12,0,30,18
1656864879031,ECE 65,A51,095125,Saad; Andrew S,25,0,26,1
1656864885058,ECE 109,A01,091882,Touri; Behrouz,16,0,70,54
1656864891083,ECE 180,A00,083140,Abi Samra; Nicholas Camill,0,0,30,30
1656864891083,ECE 180,B00,083141,Abi Samra; Nicholas Camill,0,0,30,30
1656864897108,MATH 10A,A01,083735,Patchell; Gregory David,1,0,30,29
1656864897108,MATH 10A,A02,083736,Patchell; Gregory David,20,0,30,10
1656864897108,MATH 10A,A03,083737,Patchell; Gregory David,15,0,30,15
1656864903135,MATH 10B,A01,083207,Lim; Seonhee,7,0,34,27
1656864903135,MATH 10B,A02,083208,Lim; Seonhee,9,0,35,26
1656864903135,MATH 10B,A03,093472,Lim; Seonhee,4,0,34,30
1656864903135,MATH 10B,B01,083739,Sinha; Shubham,9,0,30,21
1656864909160,MATH 18,A01,083743,Cinel; Cameron Alexander,6,0,30,24
1656864909160,MATH 18,A02,083744,Cinel; Cameron Alexander,15,0,30,15
1656864909160,MATH 18,A03,083745,Cinel; Cameron Alexander,8,0,30,22
1656864909160,MATH 18,B01,083748,Rideout; David Porter,3,0,37,34
1656864909160,MATH 18,B02,083749,Rideout; David Porter,3,0,36,33
1656864909160,MATH 18,B03,083750,Rideout; David Porter,2,0,37,35
1656864909160,MATH 18,B04,083751,Rideout; David Porter,5,0,36,31
1656864909160,MATH 18,B05,093473,Rideout; David Porter,4,0,36,32
1656864909160,MATH 18,B06,093474,Rideout; David Porter,5,0,36,31
1656864915185,MATH 20A,A01,083754,Zheng; Zequn,12,0,40,28
1656864921213,MATH 20B,A01,083756,Briones; Jor-el Thomas Caparas,1,0,36,35
1656864921213,MATH 20B,A02,083757,Briones; Jor-el Thomas Caparas,1,0,36,35
1656864921213,MATH 20B,A03,093475,Briones; Jor-el Thomas Caparas,0,0,36,36
1656864927236,MATH 20C,A01,083760,Briones; Jor-el Thomas Caparas,1,0,35,34
1656864927236,MATH 20C,A02,083761,Briones; Jor-el Thomas Caparas,8,0,35,27
1656864927236,MATH 20C,A03,093476,Briones; Jor-el Thomas Caparas,0,1,36,36
1656864927236,MATH 20C,B01,083762,Bach; Quang Tran,0,0,30,30
1656864933261,MATH 20D,A01,083765,Tran; Brian Kha,4,0,30,26
1656864933261,MATH 20D,A02,083766,Tran; Brian Kha,4,0,30,26
1656864933261,MATH 20D,A03,083767,Tran; Brian Kha,2,0,30,28
1656864939286,MATH 20E,A01,083771,Ganguly; Soumya,5,0,32,27
1656864939286,MATH 20E,A02,083772,Ganguly; Soumya,6,0,32,26
1656864939286,MATH 20E,B01,083773,Ciotti; Benjamin,18,0,35,17
1656864939286,MATH 20E,B02,083774,Ciotti; Benjamin,17,0,35,18
1656864945310,MATH 103A,A01,083777,Greenfeld; Be'Eri,2,0,36,34
1656864945310,MATH 103A,A02,083778,Greenfeld; Be'Eri,5,0,36,31
1656864945310,MATH 103A,A03,093561,Greenfeld; Be'Eri,4,0,36,32
1656864945310,MATH 103A,B01,083779,Greenfeld; Be'Eri,6,0,36,30
1656864945310,MATH 103A,B02,083780,Greenfeld; Be'Eri,2,0,36,34
1656864945310,MATH 103A,B03,093562,Greenfeld; Be'Eri,2,0,36,34
1656864951336,MATH 105,A01,085443,Carter; Anne Toulson,13,0,35,22
1656864951336,MATH 105,A02,093477,Carter; Anne Toulson,20,0,35,15
1656864957367,MATH 109,A01,083213,Ganzberger; Geoffrey Michael,2,0,34,32
1656864957367,MATH 109,A02,083214,Ganzberger; Geoffrey Michael,2,0,34,32
1656864957367,MATH 109,A03,093478,Ganzberger; Geoffrey Michael,1,0,34,33
1656864957367,MATH 109,B01,083215,Ganzberger; Geoffrey Michael,1,0,32,31
1656864957367,MATH 109,B02,083216,Ganzberger; Geoffrey Michael,1,0,32,31
1656864957367,MATH 109,B03,093479,Ganzberger; Geoffrey Michael,6,0,32,26
1656864963392,MATH 142A,A01,083219,Chow; Bennett,6,0,32,26
1656864963392,MATH 142A,A02,083220,Chow; Bennett,9,0,32,23
1656864963392,MATH 142A,A03,093480,Chow; Bennett,7,0,32,25
1656864963392,MATH 142A,B03,093481,Chow; Bennett,7,0,32,25
1656864963392,MATH 142A,B04,093558,Chow; Bennett,10,0,32,22
1656864963392,MATH 142A,B05,093559,Chow; Bennett,6,0,32,26
1656864969417,MATH 193A,A01,083224,Rotar; Vladimir,6,0,34,28
1656864969417,MATH 193A,A02,083225,Rotar; Vladimir,3,0,34,31
1656864969417,MATH 193A,A03,083781,Rotar; Vladimir,1,0,34,33
1656864969417,MATH 193A,A04,083782,Rotar; Vladimir,6,0,34,28
1656864969417,MATH 193A,A05,093482,Rotar; Vladimir,6,0,34,28
1656864975452,MATH 197,001,091859,McAuley; Julian John,9999,0,9999,0
1656864975452,MATH 197,002,095566,Kedlaya; Kiran S.,9997,0,9999,2
1656864975452,MATH 197,003,095567,Xiao; Ming,9999,0,9999,0
1656864975452,MATH 197,004,095571,Perols; Johan Lars,9998,0,9999,1
1656864982514,COGS 9,A01,083615,Shannon; Kyle Michael,6,0,75,69
1656864988537,COGS 11,A01,083617,Boyle; Mary E. T.,18,0,48,30
1656864994561,COGS 13,A01,083071,Bastos; Amalia Pinkusfeld,8,0,71,63
1656865000588,COGS 14A,A01,092681,Semenuks; Arturs,0,1,100,100
1656865006613,COGS 14B,A01,083073,Cheng; Tzu-Han,5,0,63,58
1656865012637,COGS 17,A01,092677,Semenuks; Arturs,4,0,81,77
1656865018658,COGS 100,A01,083619,Allen; Michael Gordon,15,0,70,55
1656865024684,COGS 101A,A01,083621,Davis; Joshua Daniel,9,0,68,59
1656865030709,COGS 101B,A01,091572,Allen; Michael Gordon,8,0,65,57
1656865036753,COGS 101C,A01,083625,Delgado; Tania,17,0,35,18
1656865042782,COGS 107A,A01,083627,Boyle; Mary E. T.,13,0,60,47
1656865048878,COGS 118A,A01,083075,Gupta; Anjum,15,0,76,61
1656865054907,CSE 3,A50,083646,Miranda; Gregory Joseph,22,0,50,28
1656865060936,CSE 8A,A50,083650,Miranda; Gregory Joseph,17,1,56,39
1656865066963,CSE 11,A01,083080,Cao; Yingjun,4,15,40,36
1656865072988,CSE 12,A01,083652,Krause-Levy; Sophia Louisa,20,1,120,100
1656865079011,CSE 15L,A01,083654,Morris; Justin Loren,8,0,50,42
1656865079011,CSE 15L,A02,083655,Morris; Justin Loren,8,0,50,42
1656865085035,CSE 20,A01,083657,Tran; Khoa Dang,37,0,80,43
1656865091061,CSE 21,A01,095574,Bach; Quang Tran,21,0,48,27
1656865097088,CSE 30,A01,083084,Eldon; John,4,0,80,76
1656865097088,CSE 30,B01,095061,Bhaskar; Nishant,6,0,50,44
1656865103112,CSE 100,A01,083659,Cao; Yingjun,2,4,70,68
1656865109135,CSE 134B,A01,083661,Powell; Thomas Allan,19,0,100,81
1656865115159,CSE 140,A01,083663,Gungor; Onat,14,0,85,71
1656865121185,CSE 140L,A01,083088,Eldon; John,16,0,100,84
1656865127218,CSE 175,A01,083665,Kumar; Rakesh,3,0,25,22
1656865133242,CSE 190,A00,092507,Dubnov; Shlomo,7,0,20,13
1656865139266,ECE 45,A01,083139,Congero; Spencer William,5,0,75,70
1656865145290,ECE 65,A50,083695,Saad; Andrew S,12,0,30,18
1656865145290,ECE 65,A51,095125,Saad; Andrew S,25,0,26,1
1656865151313,ECE 109,A01,091882,Touri; Behrouz,16,0,70,54
1656865157339,ECE 180,A00,083140,Abi Samra; Nicholas Camill,0,0,30,30
1656865157339,ECE 180,B00,083141,Abi Samra; Nicholas Camill,0,0,30,30
1656865163368,MATH 10A,A01,083735,Patchell; Gregory David,1,0,30,29
1656865163368,MATH 10A,A02,083736,Patchell; Gregory David,20,0,30,10
1656865163368,MATH 10A,A03,083737,Patchell; Gregory David,15,0,30,15
1656865169393,MATH 10B,A01,083207,Lim; Seonhee,7,0,34,27
1656865169393,MATH 10B,A02,083208,Lim; Seonhee,9,0,35,26
1656865169393,MATH 10B,A03,093472,Lim; Seonhee,4,0,34,30
1656865169393,MATH 10B,B01,083739,Sinha; Shubham,9,0,30,21
1656865175416,MATH 18,A01,083743,Cinel; Cameron Alexander,6,0,30,24
1656865175416,MATH 18,A02,083744,Cinel; Cameron Alexander,15,0,30,15
1656865175416,MATH 18,A03,083745,Cinel; Cameron Alexander,8,0,30,22
1656865175416,MATH 18,B01,083748,Rideout; David Porter,3,0,37,34
1656865175416,MATH 18,B02,083749,Rideout; David Porter,3,0,36,33
1656865175416,MATH 18,B03,083750,Rideout; David Porter,2,0,37,35
1656865175416,MATH 18,B04,083751,Rideout; David Porter,5,0,36,31
1656865175416,MATH 18,B05,093473,Rideout; David Porter,4,0,36,32
1656865175416,MATH 18,B06,093474,Rideout; David Porter,5,0,36,31
1656865181445,MATH 20A,A01,083754,Zheng; Zequn,12,0,40,28
1656865187473,MATH 20B,A01,083756,Briones; Jor-el Thomas Caparas,1,0,36,35
1656865187473,MATH 20B,A02,083757,Briones; Jor-el Thomas Caparas,1,0,36,35
1656865187473,MATH 20B,A03,093475,Briones; Jor-el Thomas Caparas,0,0,36,36
1656865193496,MATH 20C,A01,083760,Briones; Jor-el Thomas Caparas,1,0,35,34
1656865193496,MATH 20C,A02,083761,Briones; Jor-el Thomas Caparas,8,0,35,27
1656865193496,MATH 20C,A03,093476,Briones; Jor-el Thomas Caparas,0,1,36,36
1656865193496,MATH 20C,B01,083762,Bach; Quang Tran,0,0,30,30
1656865199527,MATH 20D,A01,083765,Tran; Brian Kha,4,0,30,26
1656865199527,MATH 20D,A02,083766,Tran; Brian Kha,4,0,30,26
1656865199527,MATH 20D,A03,083767,Tran; Brian Kha,2,0,30,28
1656865205565,MATH 20E,A01,083771,Ganguly; Soumya,5,0,32,27
1656865205565,MATH 20E,A02,083772,Ganguly; Soumya,6,0,32,26
1656865205565,MATH 20E,B01,083773,Ciotti; Benjamin,18,0,35,17
1656865205565,MATH 20E,B02,083774,Ciotti; Benjamin,17,0,35,18
1656865211597,MATH 103A,A01,083777,Greenfeld; Be'Eri,2,0,36,34
1656865211597,MATH 103A,A02,083778,Greenfeld; Be'Eri,5,0,36,31
1656865211597,MATH 103A,A03,093561,Greenfeld; Be'Eri,4,0,36,32
1656865211597,MATH 103A,B01,083779,Greenfeld; Be'Eri,6,0,36,30
1656865211597,MATH 103A,B02,083780,Greenfeld; Be'Eri,2,0,36,34
1656865211597,MATH 103A,B03,093562,Greenfeld; Be'Eri,2,0,36,34
1656865217620,MATH 105,A01,085443,Carter; Anne Toulson,13,0,35,22
1656865217620,MATH 105,A02,093477,Carter; Anne Toulson,20,0,35,15
1656865223648,MATH 109,A01,083213,Ganzberger; Geoffrey Michael,2,0,34,32
1656865223648,MATH 109,A02,083214,Ganzberger; Geoffrey Michael,2,0,34,32
1656865223648,MATH 109,A03,093478,Ganzberger; Geoffrey Michael,1,0,34,33
1656865223648,MATH 109,B01,083215,Ganzberger; Geoffrey Michael,1,0,32,31
1656865223648,MATH 109,B02,083216,Ganzberger; Geoffrey Michael,1,0,32,31
1656865223648,MATH 109,B03,093479,Ganzberger; Geoffrey Michael,6,0,32,26
1656865229672,MATH 142A,A01,083219,Chow; Bennett,6,0,32,26
1656865229672,MATH 142A,A02,083220,Chow; Bennett,9,0,32,23
1656865229672,MATH 142A,A03,093480,Chow; Bennett,7,0,32,25
1656865229672,MATH 142A,B03,093481,Chow; Bennett,7,0,32,25
1656865229672,MATH 142A,B04,093558,Chow; Bennett,10,0,32,22
1656865229672,MATH 142A,B05,093559,Chow; Bennett,6,0,32,26
1656865235698,MATH 193A,A01,083224,Rotar; Vladimir,6,0,34,28
1656865235698,MATH 193A,A02,083225,Rotar; Vladimir,3,0,34,31
1656865235698,MATH 193A,A03,083781,Rotar; Vladimir,1,0,34,33
1656865235698,MATH 193A,A04,083782,Rotar; Vladimir,6,0,34,28
1656865235698,MATH 193A,A05,093482,Rotar; Vladimir,6,0,34,28
1656865252794,MATH 197,001,091859,McAuley; Julian John,9999,0,9999,0
1656865252794,MATH 197,002,095566,Kedlaya; Kiran S.,9997,0,9999,2
1656865252794,MATH 197,003,095567,Xiao; Ming,9999,0,9999,0
1656865252794,MATH 197,004,095571,Perols; Johan Lars,9998,0,9999,1
1656865259868,COGS 9,A01,083615,Shannon; Kyle Michael,6,0,75,69
1656865265892,COGS 11,A01,083617,Boyle; Mary E. T.,18,0,48,30
1656865271916,COGS 13,A01,083071,Bastos; Amalia Pinkusfeld,8,0,71,63
1656865277940,COGS 14A,A01,092681,Semenuks; Arturs,0,1,100,100
1656865283967,COGS 14B,A01,083073,Cheng; Tzu-Han,5,0,63,58
1656865289990,COGS 17,A01,092677,Semenuks; Arturs,4,0,81,77
1656865296017,COGS 100,A01,083619,Allen; Michael Gordon,15,0,70,55
1656865302041,COGS 101A,A01,083621,Davis; Joshua Daniel,9,0,68,59
1656865308086,COGS 101B,A01,091572,Allen; Michael Gordon,8,0,65,57
1656865314112,COGS 101C,A01,083625,Delgado; Tania,17,0,35,18
1656865320142,COGS 107A,A01,083627,Boyle; Mary E. T.,13,0,60,47
1656865326166,COGS 118A,A01,083075,Gupta; Anjum,15,0,76,61
1656865332193,CSE 3,A50,083646,Miranda; Gregory Joseph,22,0,50,28
1656865338221,CSE 8A,A50,083650,Miranda; Gregory Joseph,17,1,56,39
1656865344245,CSE 11,A01,083080,Cao; Yingjun,4,15,40,36
1656865350267,CSE 12,A01,083652,Krause-Levy; Sophia Louisa,20,1,120,100
1656865356291,CSE 15L,A01,083654,Morris; Justin Loren,8,0,50,42
1656865356291,CSE 15L,A02,083655,Morris; Justin Loren,8,0,50,42
1656865362320,CSE 20,A01,083657,Tran; Khoa Dang,37,0,80,43
1656865368346,CSE 21,A01,095574,Bach; Quang Tran,21,0,48,27
1656865374376,CSE 30,A01,083084,Eldon; John,4,0,80,76
1656865374376,CSE 30,B01,095061,Bhaskar; Nishant,6,0,50,44
1656865380399,CSE 100,A01,083659,Cao; Yingjun,2,4,70,68
1656865386423,CSE 134B,A01,083661,Powell; Thomas Allan,19,0,100,81
1656865392444,CSE 140,A01,083663,Gungor; Onat,14,0,85,71
1656865398467,CSE 140L,A01,083088,Eldon; John,16,0,100,84
1656865404491,CSE 175,A01,083665,Kumar; Rakesh,3,0,25,22
1656865410513,CSE 190,A00,092507,Dubnov; Shlomo,7,0,20,13
1656865416536,ECE 45,A01,083139,Congero; Spencer William,5,0,75,70
1656865422560,ECE 65,A50,083695,Saad; Andrew S,12,0,30,18
1656865422560,ECE 65,A51,095125,Saad; Andrew S,25,0,26,1
1656865428592,ECE 109,A01,091882,Touri; Behrouz,16,0,70,54
1656865434616,ECE 180,A00,083140,Abi Samra; Nicholas Camill,0,0,30,30
1656865434616,ECE 180,B00,083141,Abi Samra; Nicholas Camill,0,0,30,30
1656865440641,MATH 10A,A01,083735,Patchell; Gregory David,1,0,30,29
1656865440641,MATH 10A,A02,083736,Patchell; Gregory David,20,0,30,10
1656865440641,MATH 10A,A03,083737,Patchell; Gregory David,15,0,30,15
1656865446670,MATH 10B,A01,083207,Lim; Seonhee,7,0,34,27
1656865446670,MATH 10B,A02,083208,Lim; Seonhee,9,0,35,26
1656865446670,MATH 10B,A03,093472,Lim; Seonhee,4,0,34,30
1656865446670,MATH 10B,B01,083739,Sinha; Shubham,9,0,30,21
1656865452694,MATH 18,A01,083743,Cinel; Cameron Alexander,6,0,30,24
1656865452694,MATH 18,A02,083744,Cinel; Cameron Alexander,15,0,30,15
1656865452694,MATH 18,A03,083745,Cinel; Cameron Alexander,8,0,30,22
1656865452694,MATH 18,B01,083748,Rideout; David Porter,3,0,37,34
1656865452694,MATH 18,B02,083749,Rideout; David Porter,3,0,36,33
1656865452694,MATH 18,B03,083750,Rideout; David Porter,2,0,37,35
1656865452694,MATH 18,B04,083751,Rideout; David Porter,5,0,36,31
1656865452694,MATH 18,B05,093473,Rideout; David Porter,4,0,36,32
1656865452694,MATH 18,B06,093474,Rideout; David Porter,5,0,36,31
1656865458717,MATH 20A,A01,083754,Zheng; Zequn,12,0,40,28
1656865464742,MATH 20B,A01,083756,Briones; Jor-el Thomas Caparas,1,0,36,35
1656865464742,MATH 20B,A02,083757,Briones; Jor-el Thomas Caparas,1,0,36,35
1656865464742,MATH 20B,A03,093475,Briones; Jor-el Thomas Caparas,0,0,36,36
1656865470771,MATH 20C,A01,083760,Briones; Jor-el Thomas Caparas,1,0,35,34
1656865470771,MATH 20C,A02,083761,Briones; Jor-el Thomas Caparas,8,0,35,27
1656865470771,MATH 20C,A03,093476,Briones; Jor-el Thomas Caparas,0,1,36,36
1656865470771,MATH 20C,B01,083762,Bach; Quang Tran,0,0,30,30
1656865476800,MATH 20D,A01,083765,Tran; Brian Kha,4,0,30,26
1656865476800,MATH 20D,A02,083766,Tran; Brian Kha,4,0,30,26
1656865476800,MATH 20D,A03,083767,Tran; Brian Kha,2,0,30,28
1656865482837,MATH 20E,A01,083771,Ganguly; Soumya,5,0,32,27
1656865482837,MATH 20E,A02,083772,Ganguly; Soumya,6,0,32,26
1656865482837,MATH 20E,B01,083773,Ciotti; Benjamin,18,0,35,17
1656865482837,MATH 20E,B02,083774,Ciotti; Benjamin,17,0,35,18
1656865488861,MATH 103A,A01,083777,Greenfeld; Be'Eri,2,0,36,34
1656865488861,MATH 103A,A02,083778,Greenfeld; Be'Eri,5,0,36,31
1656865488861,MATH 103A,A03,093561,Greenfeld; Be'Eri,4,0,36,32
1656865488861,MATH 103A,B01,083779,Greenfeld; Be'Eri,6,0,36,30
1656865488861,MATH 103A,B02,083780,Greenfeld; Be'Eri,2,0,36,34
1656865488861,MATH 103A,B03,093562,Greenfeld; Be'Eri,2,0,36,34
1656865494887,MATH 105,A01,085443,Carter; Anne Toulson,13,0,35,22
1656865494887,MATH 105,A02,093477,Carter; Anne Toulson,20,0,35,15
1656865500917,MATH 109,A01,083213,Ganzberger; Geoffrey Michael,2,0,34,32
1656865500917,MATH 109,A02,083214,Ganzberger; Geoffrey Michael,2,0,34,32
1656865500917,MATH 109,A03,093478,Ganzberger; Geoffrey Michael,1,0,34,33
1656865500917,MATH 109,B01,083215,Ganzberger; Geoffrey Michael,1,0,32,31
1656865500917,MATH 109,B02,083216,Ganzberger; Geoffrey Michael,1,0,32,31
1656865500917,MATH 109,B03,093479,Ganzberger; Geoffrey Michael,6,0,32,26
1656865506941,MATH 142A,A01,083219,Chow; Bennett,6,0,32,26
1656865506941,MATH 142A,A02,083220,Chow; Bennett,9,0,32,23
1656865506941,MATH 142A,A03,093480,Chow; Bennett,7,0,32,25
1656865506941,MATH 142A,B03,093481,Chow; Bennett,7,0,32,25
1656865506941,MATH 142A,B04,093558,Chow; Bennett,10,0,32,22
1656865506941,MATH 142A,B05,093559,Chow; Bennett,6,0,32,26
1656865512965,MATH 193A,A01,083224,Rotar; Vladimir,6,0,34,28
1656865512965,MATH 193A,A02,083225,Rotar; Vladimir,3,0,34,31
1656865512965,MATH 193A,A03,083781,Rotar; Vladimir,1,0,34,33
1656865512965,MATH 193A,A04,083782,Rotar; Vladimir,6,0,34,28
1656865512965,MATH 193A,A05,093482,Rotar; Vladimir,6,0,34,28
1656865518989,MATH 197,001,091859,McAuley; Julian John,9999,0,9999,0
1656865518989,MATH 197,002,095566,Kedlaya; Kiran S.,9997,0,9999,2
1656865518989,MATH 197,003,095567,Xiao; Ming,9999,0,9999,0
1656865518989,MATH 197,004,095571,Perols; Johan Lars,9998,0,9999,1
1656865526052,COGS 9,A01,083615,Shannon; Kyle Michael,6,0,75,69
1656865532076,COGS 11,A01,083617,Boyle; Mary E. T.,18,0,48,30
1656865538105,COGS 13,A01,083071,Bastos; Amalia Pinkusfeld,8,0,71,63
1656865544128,COGS 14A,A01,092681,Semenuks; Arturs,0,1,100,100
1656865550153,COGS 14B,A01,083073,Cheng; Tzu-Han,5,0,63,58
1656865556180,COGS 17,A01,092677,Semenuks; Arturs,4,0,81,77
1656865562219,COGS 100,A01,083619,Allen; Michael Gordon,15,0,70,55
1656865568254,COGS 101A,A01,083621,Davis; Joshua Daniel,9,0,68,59
1656865574277,COGS 101B,A01,091572,Allen; Michael Gordon,8,0,65,57
1656865580302,COGS 101C,A01,083625,Delgado; Tania,17,0,35,18
1656865586330,COGS 107A,A01,083627,Boyle; Mary E. T.,13,0,60,47
1656865592359,COGS 118A,A01,083075,Gupta; Anjum,15,0,76,61
1656865598386,CSE 3,A50,083646,Miranda; Gregory Joseph,22,0,50,28
1656865604410,CSE 8A,A50,083650,Miranda; Gregory Joseph,17,1,56,39
1656865610440,CSE 11,A01,083080,Cao; Yingjun,4,15,40,36
1656865616464,CSE 12,A01,083652,Krause-Levy; Sophia Louisa,20,1,120,100
1656865622488,CSE 15L,A01,083654,Morris; Justin Loren,8,0,50,42
1656865622488,CSE 15L,A02,083655,Morris; Justin Loren,8,0,50,42
1656865628514,CSE 20,A01,083657,Tran; Khoa Dang,37,0,80,43
1656865634542,CSE 21,A01,095574,Bach; Quang Tran,21,0,48,27
1656865640566,CSE 30,A01,083084,Eldon; John,4,0,80,76
1656865640566,CSE 30,B01,095061,Bhaskar; Nishant,6,0,50,44
1656865646589,CSE 100,A01,083659,Cao; Yingjun,2,4,70,68
1656865652617,CSE 134B,A01,083661,Powell; Thomas Allan,19,0,100,81
1656865658725,CSE 140,A01,083663,Gungor; Onat,14,0,85,71
1656865664748,CSE 140L,A01,083088,Eldon; John,16,0,100,84
1656865670772,CSE 175,A01,083665,Kumar; Rakesh,3,0,25,22
1656865676798,CSE 190,A00,092507,Dubnov; Shlomo,7,0,20,13
1656865682825,ECE 45,A01,083139,Congero; Spencer William,5,0,75,70
1656865688852,ECE 65,A50,083695,Saad; Andrew S,12,0,30,18
1656865688852,ECE 65,A51,095125,Saad; Andrew S,25,0,26,1
1656865694875,ECE 109,A01,091882,Touri; Behrouz,16,0,70,54
1656865700897,ECE 180,A00,083140,Abi Samra; Nicholas Camill,0,0,30,30
1656865700897,ECE 180,B00,083141,Abi Samra; Nicholas Camill,0,0,30,30
1656865706922,MATH 10A,A01,083735,Patchell; Gregory David,1,0,30,29
1656865706922,MATH 10A,A02,083736,Patchell; Gregory David,20,0,30,10
1656865706922,MATH 10A,A03,083737,Patchell; Gregory David,15,0,30,15
1656865712946,MATH 10B,A01,083207,Lim; Seonhee,7,0,34,27
1656865712946,MATH 10B,A02,083208,Lim; Seonhee,9,0,35,26
1656865712946,MATH 10B,A03,093472,Lim; Seonhee,4,0,34,30
1656865712946,MATH 10B,B01,083739,Sinha; Shubham,9,0,30,21
1656865718973,MATH 18,A01,083743,Cinel; Cameron Alexander,6,0,30,24
1656865718973,MATH 18,A02,083744,Cinel; Cameron Alexander,15,0,30,15
1656865718973,MATH 18,A03,083745,Cinel; Cameron Alexander,8,0,30,22
1656865718973,MATH 18,B01,083748,Rideout; David Porter,3,0,37,34
1656865718973,MATH 18,B02,083749,Rideout; David Porter,3,0,36,33
1656865718973,MATH 18,B03,083750,Rideout; David Porter,2,0,37,35
1656865718973,MATH 18,B04,083751,Rideout; David Porter,5,0,36,31
1656865718973,MATH 18,B05,093473,Rideout; David Porter,4,0,36,32
1656865718973,MATH 18,B06,093474,Rideout; David Porter,5,0,36,31
1656865724998,MATH 20A,A01,083754,Zheng; Zequn,12,0,40,28
1656865731021,MATH 20B,A01,083756,Briones; Jor-el Thomas Caparas,1,0,36,35
1656865731021,MATH 20B,A02,083757,Briones; Jor-el Thomas Caparas,1,0,36,35
1656865731021,MATH 20B,A03,093475,Briones; Jor-el Thomas Caparas,0,0,36,36
1656865737047,MATH 20C,A01,083760,Briones; Jor-el Thomas Caparas,1,0,35,34
1656865737047,MATH 20C,A02,083761,Briones; Jor-el Thomas Caparas,8,0,35,27
1656865737047,MATH 20C,A03,093476,Briones; Jor-el Thomas Caparas,0,1,36,36
1656865737047,MATH 20C,B01,083762,Bach; Quang Tran,0,0,30,30
1656865743078,MATH 20D,A01,083765,Tran; Brian Kha,4,0,30,26
1656865743078,MATH 20D,A02,083766,Tran; Brian Kha,4,0,30,26
1656865743078,MATH 20D,A03,083767,Tran; Brian Kha,2,0,30,28
1656865749102,MATH 20E,A01,083771,Ganguly; Soumya,5,0,32,27
1656865749102,MATH 20E,A02,083772,Ganguly; Soumya,6,0,32,26
1656865749102,MATH 20E,B01,083773,Ciotti; Benjamin,18,0,35,17
1656865749102,MATH 20E,B02,083774,Ciotti; Benjamin,17,0,35,18
1656865755130,MATH 103A,A01,083777,Greenfeld; Be'Eri,2,0,36,34
1656865755130,MATH 103A,A02,083778,Greenfeld; Be'Eri,5,0,36,31
1656865755130,MATH 103A,A03,093561,Greenfeld; Be'Eri,4,0,36,32
1656865755130,MATH 103A,B01,083779,Greenfeld; Be'Eri,6,0,36,30
1656865755130,MATH 103A,B02,083780,Greenfeld; Be'Eri,2,0,36,34
1656865755130,MATH 103A,B03,093562,Greenfeld; Be'Eri,2,0,36,34
1656865761157,MATH 105,A01,085443,Carter; Anne Toulson,13,0,35,22
1656865761157,MATH 105,A02,093477,Carter; Anne Toulson,20,0,35,15
1656865767184,MATH 109,A01,083213,Ganzberger; Geoffrey Michael,2,0,34,32
1656865767184,MATH 109,A02,083214,Ganzberger; Geoffrey Michael,2,0,34,32
1656865767184,MATH 109,A03,093478,Ganzberger; Geoffrey Michael,1,0,34,33
1656865767184,MATH 109,B01,083215,Ganzberger; Geoffrey Michael,1,0,32,31
1656865767184,MATH 109,B02,083216,Ganzberger; Geoffrey Michael,1,0,32,31
1656865767184,MATH 109,B03,093479,Ganzberger; Geoffrey Michael,6,0,32,26
1656865773214,MATH 142A,A01,083219,Chow; Bennett,6,0,32,26
1656865773214,MATH 142A,A02,083220,Chow; Bennett,9,0,32,23
1656865773214,MATH 142A,A03,093480,Chow; Bennett,7,0,32,25
1656865773214,MATH 142A,B03,093481,Chow; Bennett,7,0,32,25
1656865773214,MATH 142A,B04,093558,Chow; Bennett,10,0,32,22
1656865773214,MATH 142A,B05,093559,Chow; Bennett,6,0,32,26
1656865779240,MATH 193A,A01,083224,Rotar; Vladimir,6,0,34,28
1656865779240,MATH 193A,A02,083225,Rotar; Vladimir,3,0,34,31
1656865779240,MATH 193A,A03,083781,Rotar; Vladimir,1,0,34,33
1656865779240,MATH 193A,A04,083782,Rotar; Vladimir,6,0,34,28
1656865779240,MATH 193A,A05,093482,Rotar; Vladimir,6,0,34,28
1656865785264,MATH 197,001,091859,McAuley; Julian John,9999,0,9999,0
1656865785264,MATH 197,002,095566,Kedlaya; Kiran S.,9997,0,9999,2
1656865785264,MATH 197,003,095567,Xiao; Ming,9999,0,9999,0
1656865785264,MATH 197,004,095571,Perols; Johan Lars,9998,0,9999,1
1656865792329,COGS 9,A01,083615,Shannon; Kyle Michael,6,0,75,69
1656865798354,COGS 11,A01,083617,Boyle; Mary E. T.,18,0,48,30
1656865804380,COGS 13,A01,083071,Bastos; Amalia Pinkusfeld,8,0,71,63
1656865810405,COGS 14A,A01,092681,Semenuks; Arturs,0,1,100,100
1656865816428,COGS 14B,A01,083073,Cheng; Tzu-Han,5,0,63,58
1656865822456,COGS 17,A01,092677,Semenuks; Arturs,4,0,81,77
1656865828479,COGS 100,A01,083619,Allen; Michael Gordon,15,0,70,55
1656865834507,COGS 101A,A01,083621,Davis; Joshua Daniel,9,0,68,59
1656865840533,COGS 101B,A01,091572,Allen; Michael Gordon,8,0,65,57
1656865846557,COGS 101C,A01,083625,Delgado; Tania,17,0,35,18
1656865852583,COGS 107A,A01,083627,Boyle; Mary E. T.,13,0,60,47
1656865858608,COGS 118A,A01,083075,Gupta; Anjum,15,0,76,61
1656865864630,CSE 3,A50,083646,Miranda; Gregory Joseph,22,0,50,28
1656865870652,CSE 8A,A50,083650,Miranda; Gregory Joseph,17,1,56,39
1656865876682,CSE 11,A01,083080,Cao; Yingjun,4,15,40,36
1656865882706,CSE 12,A01,083652,Krause-Levy; Sophia Louisa,20,1,120,100
1656865888732,CSE 15L,A01,083654,Morris; Justin Loren,8,0,50,42
1656865888732,CSE 15L,A02,083655,Morris; Justin Loren,8,0,50,42
1656865894755,CSE 20,A01,083657,Tran; Khoa Dang,37,0,80,43
1656865900777,CSE 21,A01,095574,Bach; Quang Tran,21,0,48,27
1656865906809,CSE 30,A01,083084,Eldon; John,4,0,80,76
1656865906809,CSE 30,B01,095061,Bhaskar; Nishant,6,0,50,44
1656865912834,CSE 100,A01,083659,Cao; Yingjun,2,4,70,68
1656865918857,CSE 134B,A01,083661,Powell; Thomas Allan,19,0,100,81
1656865924883,CSE 140,A01,083663,Gungor; Onat,14,0,85,71
1656865930907,CSE 140L,A01,083088,Eldon; John,16,0,100,84
1656865936928,CSE 175,A01,083665,Kumar; Rakesh,3,0,25,22
1656865942951,CSE 190,A00,092507,Dubnov; Shlomo,7,0,20,13
1656865948974,ECE 45,A01,083139,Congero; Spencer William,5,0,75,70
1656865955002,ECE 65,A50,083695,Saad; Andrew S,12,0,30,18
1656865955002,ECE 65,A51,095125,Saad; Andrew S,25,0,26,1
1656865961026,ECE 109,A01,091882,Touri; Behrouz,16,0,70,54
1656865967054,ECE 180,A00,083140,Abi Samra; Nicholas Camill,0,0,30,30
1656865967054,ECE 180,B00,083141,Abi Samra; Nicholas Camill,0,0,30,30
1656865973082,MATH 10A,A01,083735,Patchell; Gregory David,1,0,30,29
1656865973082,MATH 10A,A02,083736,Patchell; Gregory David,20,0,30,10
1656865973082,MATH 10A,A03,083737,Patchell; Gregory David,15,0,30,15
1656865979107,MATH 10B,A01,083207,Lim; Seonhee,7,0,34,27
1656865979107,MATH 10B,A02,083208,Lim; Seonhee,9,0,35,26
1656865979107,MATH 10B,A03,093472,Lim; Seonhee,4,0,34,30
1656865979107,MATH 10B,B01,083739,Sinha; Shubham,9,0,30,21
1656865985131,MATH 18,A01,083743,Cinel; Cameron Alexander,6,0,30,24
1656865985131,MATH 18,A02,083744,Cinel; Cameron Alexander,15,0,30,15
1656865985131,MATH 18,A03,083745,Cinel; Cameron Alexander,8,0,30,22
1656865985131,MATH 18,B01,083748,Rideout; David Porter,3,0,37,34
1656865985131,MATH 18,B02,083749,Rideout; David Porter,3,0,36,33
1656865985131,MATH 18,B03,083750,Rideout; David Porter,2,0,37,35
1656865985131,MATH 18,B04,083751,Rideout; David Porter,5,0,36,31
1656865985131,MATH 18,B05,093473,Rideout; David Porter,4,0,36,32
1656865985131,MATH 18,B06,093474,Rideout; David Porter,5,0,36,31
1656865991157,MATH 20A,A01,083754,Zheng; Zequn,12,0,40,28
1656865997182,MATH 20B,A01,083756,Briones; Jor-el Thomas Caparas,1,0,36,35
1656865997182,MATH 20B,A02,083757,Briones; Jor-el Thomas Caparas,1,0,36,35
1656865997182,MATH 20B,A03,093475,Briones; Jor-el Thomas Caparas,0,0,36,36
1656866003204,MATH 20C,A01,083760,Briones; Jor-el Thomas Caparas,1,0,35,34
1656866003204,MATH 20C,A02,083761,Briones; Jor-el Thomas Caparas,8,0,35,27
1656866003204,MATH 20C,A03,093476,Briones; Jor-el Thomas Caparas,0,1,36,36
1656866003204,MATH 20C,B01,083762,Bach; Quang Tran,0,0,30,30
1656866009228,MATH 20D,A01,083765,Tran; Brian Kha,4,0,30,26
1656866009228,MATH 20D,A02,083766,Tran; Brian Kha,4,0,30,26
1656866009228,MATH 20D,A03,083767,Tran; Brian Kha,2,0,30,28
1656866015255,MATH 20E,A01,083771,Ganguly; Soumya,5,0,32,27
1656866015255,MATH 20E,A02,083772,Ganguly; Soumya,6,0,32,26
1656866015255,MATH 20E,B01,083773,Ciotti; Benjamin,18,0,35,17
1656866015255,MATH 20E,B02,083774,Ciotti; Benjamin,17,0,35,18
1656866021286,MATH 103A,A01,083777,Greenfeld; Be'Eri,2,0,36,34
1656866021286,MATH 103A,A02,083778,Greenfeld; Be'Eri,5,0,36,31
1656866021286,MATH 103A,A03,093561,Greenfeld; Be'Eri,4,0,36,32
1656866021286,MATH 103A,B01,083779,Greenfeld; Be'Eri,6,0,36,30
1656866021286,MATH 103A,B02,083780,Greenfeld; Be'Eri,2,0,36,34
1656866021286,MATH 103A,B03,093562,Greenfeld; Be'Eri,2,0,36,34
1656866027311,MATH 105,A01,085443,Carter; Anne Toulson,13,0,35,22
1656866027311,MATH 105,A02,093477,Carter; Anne Toulson,20,0,35,15
1656866033336,MATH 109,A01,083213,Ganzberger; Geoffrey Michael,2,0,34,32
1656866033336,MATH 109,A02,083214,Ganzberger; Geoffrey Michael,2,0,34,32
1656866033336,MATH 109,A03,093478,Ganzberger; Geoffrey Michael,1,0,34,33
1656866033336,MATH 109,B01,083215,Ganzberger; Geoffrey Michael,1,0,32,31
1656866033336,MATH 109,B02,083216,Ganzberger; Geoffrey Michael,1,0,32,31
1656866033336,MATH 109,B03,093479,Ganzberger; Geoffrey Michael,6,0,32,26
1656866039375,MATH 142A,A01,083219,Chow; Bennett,6,0,32,26
1656866039375,MATH 142A,A02,083220,Chow; Bennett,9,0,32,23
1656866039375,MATH 142A,A03,093480,Chow; Bennett,7,0,32,25
1656866039375,MATH 142A,B03,093481,Chow; Bennett,7,0,32,25
1656866039375,MATH 142A,B04,093558,Chow; Bennett,10,0,32,22
1656866039375,MATH 142A,B05,093559,Chow; Bennett,6,0,32,26
1656866045404,MATH 193A,A01,083224,Rotar; Vladimir,6,0,34,28
1656866045404,MATH 193A,A02,083225,Rotar; Vladimir,3,0,34,31
1656866045404,MATH 193A,A03,083781,Rotar; Vladimir,1,0,34,33
1656866045404,MATH 193A,A04,083782,Rotar; Vladimir,6,0,34,28
1656866045404,MATH 193A,A05,093482,Rotar; Vladimir,6,0,34,28
1656866051425,MATH 197,001,091859,McAuley; Julian John,9999,0,9999,0
1656866051425,MATH 197,002,095566,Kedlaya; Kiran S.,9997,0,9999,2
1656866051425,MATH 197,003,095567,Xiao; Ming,9999,0,9999,0
1656866051425,MATH 197,004,095571,Perols; Johan Lars,9998,0,9999,1
1656866058482,COGS 9,A01,083615,Shannon; Kyle Michael,6,0,75,69
1656866064506,COGS 11,A01,083617,Boyle; Mary E. T.,18,0,48,30
1656866070534,COGS 13,A01,083071,Bastos; Amalia Pinkusfeld,8,0,71,63
1656866076559,COGS 14A,A01,092681,Semenuks; Arturs,0,1,100,100
1656866082581,COGS 14B,A01,083073,Cheng; Tzu-Han,5,0,63,58
1656866088614,COGS 17,A01,092677,Semenuks; Arturs,4,0,81,77
1656866094636,COGS 100,A01,083619,Allen; Michael Gordon,15,0,70,55
1656866100660,COGS 101A,A01,083621,Davis; Joshua Daniel,9,0,68,59
1656866106687,COGS 101B,A01,091572,Allen; Michael Gordon,8,0,65,57
1656866112715,COGS 101C,A01,083625,Delgado; Tania,17,0,35,18
1656866118743,COGS 107A,A01,083627,Boyle; Mary E. T.,13,0,60,47
1656866124775,COGS 118A,A01,083075,Gupta; Anjum,15,0,76,61
1656866130799,CSE 3,A50,083646,Miranda; Gregory Joseph,22,0,50,28
1656866136825,CSE 8A,A50,083650,Miranda; Gregory Joseph,17,1,56,39
1656866142849,CSE 11,A01,083080,Cao; Yingjun,4,15,40,36
1656866148873,CSE 12,A01,083652,Krause-Levy; Sophia Louisa,20,1,120,100
1656866154900,CSE 15L,A01,083654,Morris; Justin Loren,8,0,50,42
1656866154900,CSE 15L,A02,083655,Morris; Justin Loren,8,0,50,42
1656866160928,CSE 20,A01,083657,Tran; Khoa Dang,37,0,80,43
1656866166957,CSE 21,A01,095574,Bach; Quang Tran,21,0,48,27
1656866172980,CSE 30,A01,083084,Eldon; John,4,0,80,76
1656866172980,CSE 30,B01,095061,Bhaskar; Nishant,6,0,50,44
1656866179003,CSE 100,A01,083659,Cao; Yingjun,2,4,70,68
1656866185025,CSE 134B,A01,083661,Powell; Thomas Allan,19,0,100,81
1656866191056,CSE 140,A01,083663,Gungor; Onat,14,0,85,71
1656866197081,CSE 140L,A01,083088,Eldon; John,16,0,100,84
1656866203121,CSE 175,A01,083665,Kumar; Rakesh,3,0,25,22
1656866209144,CSE 190,A00,092507,Dubnov; Shlomo,7,0,20,13
1656866215167,ECE 45,A01,083139,Congero; Spencer William,5,0,75,70
1656866221198,ECE 65,A50,083695,Saad; Andrew S,12,0,30,18
1656866221198,ECE 65,A51,095125,Saad; Andrew S,25,0,26,1
1656866227235,ECE 109,A01,091882,Touri; Behrouz,16,0,70,54
1656866233260,ECE 180,A00,083140,Abi Samra; Nicholas Camill,0,0,30,30
1656866233260,ECE 180,B00,083141,Abi Samra; Nicholas Camill,0,0,30,30
1656866239284,MATH 10A,A01,083735,Patchell; Gregory David,1,0,30,29
1656866239284,MATH 10A,A02,083736,Patchell; Gregory David,20,0,30,10
1656866239284,MATH 10A,A03,083737,Patchell; Gregory David,15,0,30,15
1656866245308,MATH 10B,A01,083207,Lim; Seonhee,7,0,34,27
1656866245308,MATH 10B,A02,083208,Lim; Seonhee,9,0,35,26
1656866245308,MATH 10B,A03,093472,Lim; Seonhee,4,0,34,30
1656866245308,MATH 10B,B01,083739,Sinha; Shubham,9,0,30,21
1656866251333,MATH 18,A01,083743,Cinel; Cameron Alexander,6,0,30,24
1656866251333,MATH 18,A02,083744,Cinel; Cameron Alexander,15,0,30,15
1656866251333,MATH 18,A03,083745,Cinel; Cameron Alexander,8,0,30,22
1656866251333,MATH 18,B01,083748,Rideout; David Porter,3,0,37,34
1656866251333,MATH 18,B02,083749,Rideout; David Porter,3,0,36,33
1656866251333,MATH 18,B03,083750,Rideout; David Porter,2,0,37,35
1656866251333,MATH 18,B04,083751,Rideout; David Porter,5,0,36,31
1656866251333,MATH 18,B05,093473,Rideout; David Porter,4,0,36,32
1656866251333,MATH 18,B06,093474,Rideout; David Porter,5,0,36,31
1656866257455,MATH 20A,A01,083754,Zheng; Zequn,12,0,40,28
1656866263483,MATH 20B,A01,083756,Briones; Jor-el Thomas Caparas,1,0,36,35
1656866263483,MATH 20B,A02,083757,Briones; Jor-el Thomas Caparas,1,0,36,35
1656866263483,MATH 20B,A03,093475,Briones; Jor-el Thomas Caparas,0,0,36,36
1656866269505,MATH 20C,A01,083760,Briones; Jor-el Thomas Caparas,1,0,35,34
1656866269505,MATH 20C,A02,083761,Briones; Jor-el Thomas Caparas,8,0,35,27
1656866269505,MATH 20C,A03,093476,Briones; Jor-el Thomas Caparas,0,1,36,36
1656866269505,MATH 20C,B01,083762,Bach; Quang Tran,0,0,30,30
1656866275534,MATH 20D,A01,083765,Tran; Brian Kha,4,0,30,26
1656866275534,MATH 20D,A02,083766,Tran; Brian Kha,4,0,30,26
1656866275534,MATH 20D,A03,083767,Tran; Brian Kha,2,0,30,28
1656866281562,MATH 20E,A01,083771,Ganguly; Soumya,5,0,32,27
1656866281562,MATH 20E,A02,083772,Ganguly; Soumya,6,0,32,26
1656866281562,MATH 20E,B01,083773,Ciotti; Benjamin,18,0,35,17
1656866281562,MATH 20E,B02,083774,Ciotti; Benjamin,17,0,35,18
1656866287586,MATH 103A,A01,083777,Greenfeld; Be'Eri,2,0,36,34
1656866287586,MATH 103A,A02,083778,Greenfeld; Be'Eri,5,0,36,31
1656866287586,MATH 103A,A03,093561,Greenfeld; Be'Eri,4,0,36,32
1656866287586,MATH 103A,B01,083779,Greenfeld; Be'Eri,6,0,36,30
1656866287586,MATH 103A,B02,083780,Greenfeld; Be'Eri,2,0,36,34
1656866287586,MATH 103A,B03,093562,Greenfeld; Be'Eri,2,0,36,34
1656866293612,MATH 105,A01,085443,Carter; Anne Toulson,13,0,35,22
1656866293612,MATH 105,A02,093477,Carter; Anne Toulson,20,0,35,15
1656866299635,MATH 109,A01,083213,Ganzberger; Geoffrey Michael,2,0,34,32
1656866299635,MATH 109,A02,083214,Ganzberger; Geoffrey Michael,2,0,34,32
1656866299635,MATH 109,A03,093478,Ganzberger; Geoffrey Michael,1,0,34,33
1656866299635,MATH 109,B01,083215,Ganzberger; Geoffrey Michael,1,0,32,31
1656866299635,MATH 109,B02,083216,Ganzberger; Geoffrey Michael,1,0,32,31
1656866299635,MATH 109,B03,093479,Ganzberger; Geoffrey Michael,6,0,32,26
1656866305658,MATH 142A,A01,083219,Chow; Bennett,6,0,32,26
1656866305658,MATH 142A,A02,083220,Chow; Bennett,9,0,32,23
1656866305658,MATH 142A,A03,093480,Chow; Bennett,7,0,32,25
1656866305658,MATH 142A,B03,093481,Chow; Bennett,7,0,32,25
1656866305658,MATH 142A,B04,093558,Chow; Bennett,10,0,32,22
1656866305658,MATH 142A,B05,093559,Chow; Bennett,6,0,32,26
1656866311696,MATH 193A,A01,083224,Rotar; Vladimir,6,0,34,28
1656866311696,MATH 193A,A02,083225,Rotar; Vladimir,3,0,34,31
1656866311696,MATH 193A,A03,083781,Rotar; Vladimir,1,0,34,33
1656866311696,MATH 193A,A04,083782,Rotar; Vladimir,6,0,34,28
1656866311696,MATH 193A,A05,093482,Rotar; Vladimir,6,0,34,28
1656866317722,MATH 197,001,091859,McAuley; Julian John,9999,0,9999,0
1656866317722,MATH 197,002,095566,Kedlaya; Kiran S.,9997,0,9999,2
1656866317722,MATH 197,003,095567,Xiao; Ming,9999,0,9999,0
1656866317722,MATH 197,004,095571,Perols; Johan Lars,9998,0,9999,1
1656866324786,COGS 9,A01,083615,Shannon; Kyle Michael,6,0,75,69
1656866330812,COGS 11,A01,083617,Boyle; Mary E. T.,18,0,48,30
1656866336837,COGS 13,A01,083071,Bastos; Amalia Pinkusfeld,8,0,71,63
1656866342862,COGS 14A,A01,092681,Semenuks; Arturs,0,1,100,100
1656866348891,COGS 14B,A01,083073,Cheng; Tzu-Han,5,0,63,58
1656866354915,COGS 17,A01,092677,Semenuks; Arturs,4,0,81,77
1656866360942,COGS 100,A01,083619,Allen; Michael Gordon,15,0,70,55
1656866366970,COGS 101A,A01,083621,Davis; Joshua Daniel,9,0,68,59
1656866372995,COGS 101B,A01,091572,Allen; Michael Gordon,8,0,65,57
1656866379031,COGS 101C,A01,083625,Delgado; Tania,17,0,35,18
1656866385053,COGS 107A,A01,083627,Boyle; Mary E. T.,13,0,60,47
1656866391080,COGS 118A,A01,083075,Gupta; Anjum,15,0,76,61
1656866397104,CSE 3,A50,083646,Miranda; Gregory Joseph,22,0,50,28
1656866403130,CSE 8A,A50,083650,Miranda; Gregory Joseph,17,1,56,39
1656866409153,CSE 11,A01,083080,Cao; Yingjun,4,15,40,36
1656866415188,CSE 12,A01,083652,Krause-Levy; Sophia Louisa,20,1,120,100
1656866421211,CSE 15L,A01,083654,Morris; Justin Loren,8,0,50,42
1656866421211,CSE 15L,A02,083655,Morris; Justin Loren,8,0,50,42
1656866427235,CSE 20,A01,083657,Tran; Khoa Dang,37,0,80,43
1656866433258,CSE 21,A01,095574,Bach; Quang Tran,21,0,48,27
1656866439292,CSE 30,A01,083084,Eldon; John,4,0,80,76
1656866439292,CSE 30,B01,095061,Bhaskar; Nishant,6,0,50,44
1656866445314,CSE 100,A01,083659,Cao; Yingjun,2,4,70,68
1656866451339,CSE 134B,A01,083661,Powell; Thomas Allan,19,0,100,81
1656866457362,CSE 140,A01,083663,Gungor; Onat,14,0,85,71
1656866463386,CSE 140L,A01,083088,Eldon; John,16,0,100,84
1656866469409,CSE 175,A01,083665,Kumar; Rakesh,3,0,25,22
1656866475434,CSE 190,A00,092507,Dubnov; Shlomo,7,0,20,13
1656866481461,ECE 45,A01,083139,Congero; Spencer William,5,0,75,70
1656866487484,ECE 65,A50,083695,Saad; Andrew S,12,0,30,18
1656866487484,ECE 65,A51,095125,Saad; Andrew S,25,0,26,1
1656866493508,ECE 109,A01,091882,Touri; Behrouz,16,0,70,54
1656866499539,ECE 180,A00,083140,Abi Samra; Nicholas Camill,0,0,30,30
1656866499539,ECE 180,B00,083141,Abi Samra; Nicholas Camill,0,0,30,30
1656866505569,MATH 10A,A01,083735,Patchell; Gregory David,1,0,30,29
1656866505569,MATH 10A,A02,083736,Patchell; Gregory David,20,0,30,10
1656866505569,MATH 10A,A03,083737,Patchell; Gregory David,15,0,30,15
1656866511593,MATH 10B,A01,083207,Lim; Seonhee,7,0,34,27
1656866511593,MATH 10B,A02,083208,Lim; Seonhee,9,0,35,26
1656866511593,MATH 10B,A03,093472,Lim; Seonhee,4,0,34,30
1656866511593,MATH 10B,B01,083739,Sinha; Shubham,9,0,30,21
1656866517637,MATH 18,A01,083743,Cinel; Cameron Alexander,6,0,30,24
1656866517637,MATH 18,A02,083744,Cinel; Cameron Alexander,15,0,30,15
1656866517637,MATH 18,A03,083745,Cinel; Cameron Alexander,8,0,30,22
1656866517637,MATH 18,B01,083748,Rideout; David Porter,3,0,37,34
1656866517637,MATH 18,B02,083749,Rideout; David Porter,3,0,36,33
1656866517637,MATH 18,B03,083750,Rideout; David Porter,2,0,37,35
1656866517637,MATH 18,B04,083751,Rideout; David Porter,5,0,36,31
1656866517637,MATH 18,B05,093473,Rideout; David Porter,4,0,36,32
1656866517637,MATH 18,B06,093474,Rideout; David Porter,5,0,36,31
1656866523666,MATH 20A,A01,083754,Zheng; Zequn,12,0,40,28
1656866529695,MATH 20B,A01,083756,Briones; Jor-el Thomas Caparas,1,0,36,35
1656866529695,MATH 20B,A02,083757,Briones; Jor-el Thomas Caparas,1,0,36,35
1656866529695,MATH 20B,A03,093475,Briones; Jor-el Thomas Caparas,0,0,36,36
1656866535723,MATH 20C,A01,083760,Briones; Jor-el Thomas Caparas,1,0,35,34
1656866535723,MATH 20C,A02,083761,Briones; Jor-el Thomas Caparas,8,0,35,27
1656866535723,MATH 20C,A03,093476,Briones; Jor-el Thomas Caparas,0,1,36,36
1656866535723,MATH 20C,B01,083762,Bach; Quang Tran,0,0,30,30
1656866541748,MATH 20D,A01,083765,Tran; Brian Kha,4,0,30,26
1656866541748,MATH 20D,A02,083766,Tran; Brian Kha,4,0,30,26
1656866541748,MATH 20D,A03,083767,Tran; Brian Kha,2,0,30,28
1656866547771,MATH 20E,A01,083771,Ganguly; Soumya,5,0,32,27
1656866547771,MATH 20E,A02,083772,Ganguly; Soumya,6,0,32,26
1656866547771,MATH 20E,B01,083773,Ciotti; Benjamin,18,0,35,17
1656866547771,MATH 20E,B02,083774,Ciotti; Benjamin,17,0,35,18
1656866553799,MATH 103A,A01,083777,Greenfeld; Be'Eri,2,0,36,34
1656866553799,MATH 103A,A02,083778,Greenfeld; Be'Eri,5,0,36,31
1656866553799,MATH 103A,A03,093561,Greenfeld; Be'Eri,4,0,36,32
1656866553799,MATH 103A,B01,083779,Greenfeld; Be'Eri,6,0,36,30
1656866553799,MATH 103A,B02,083780,Greenfeld; Be'Eri,2,0,36,34
1656866553799,MATH 103A,B03,093562,Greenfeld; Be'Eri,2,0,36,34
1656866559823,MATH 105,A01,085443,Carter; Anne Toulson,13,0,35,22
1656866559823,MATH 105,A02,093477,Carter; Anne Toulson,20,0,35,15
1656866565852,MATH 109,A01,083213,Ganzberger; Geoffrey Michael,2,0,34,32
1656866565852,MATH 109,A02,083214,Ganzberger; Geoffrey Michael,2,0,34,32
1656866565852,MATH 109,A03,093478,Ganzberger; Geoffrey Michael,1,0,34,33
1656866565852,MATH 109,B01,083215,Ganzberger; Geoffrey Michael,1,0,32,31
1656866565852,MATH 109,B02,083216,Ganzberger; Geoffrey Michael,1,0,32,31
1656866565852,MATH 109,B03,093479,Ganzberger; Geoffrey Michael,6,0,32,26
1656866571881,MATH 142A,A01,083219,Chow; Bennett,6,0,32,26
1656866571881,MATH 142A,A02,083220,Chow; Bennett,9,0,32,23
1656866571881,MATH 142A,A03,093480,Chow; Bennett,7,0,32,25
1656866571881,MATH 142A,B03,093481,Chow; Bennett,7,0,32,25
1656866571881,MATH 142A,B04,093558,Chow; Bennett,10,0,32,22
1656866571881,MATH 142A,B05,093559,Chow; Bennett,6,0,32,26
1656866577906,MATH 193A,A01,083224,Rotar; Vladimir,6,0,34,28
1656866577906,MATH 193A,A02,083225,Rotar; Vladimir,3,0,34,31
1656866577906,MATH 193A,A03,083781,Rotar; Vladimir,1,0,34,33
1656866577906,MATH 193A,A04,083782,Rotar; Vladimir,6,0,34,28
1656866577906,MATH 193A,A05,093482,Rotar; Vladimir,6,0,34,28
1656866583933,MATH 197,001,091859,McAuley; Julian John,9999,0,9999,0
1656866583933,MATH 197,002,095566,Kedlaya; Kiran S.,9997,0,9999,2
1656866583933,MATH 197,003,095567,Xiao; Ming,9999,0,9999,0
1656866583933,MATH 197,004,095571,Perols; Johan Lars,9998,0,9999,1
1656866590981,COGS 9,A01,083615,Shannon; Kyle Michael,6,0,75,69
1656866597008,COGS 11,A01,083617,Boyle; Mary E. T.,18,0,48,30
1656866603035,COGS 13,A01,083071,Bastos; Amalia Pinkusfeld,8,0,71,63
1656866609067,COGS 14A,A01,092681,Semenuks; Arturs,0,1,100,100
1656866615096,COGS 14B,A01,083073,Cheng; Tzu-Han,5,0,63,58
1656866621119,COGS 17,A01,092677,Semenuks; Arturs,4,0,81,77
1656866627142,COGS 100,A01,083619,Allen; Michael Gordon,15,0,70,55
1656866633172,COGS 101A,A01,083621,Davis; Joshua Daniel,9,0,68,59
1656866639198,COGS 101B,A01,091572,Allen; Michael Gordon,8,0,65,57
1656866645224,COGS 101C,A01,083625,Delgado; Tania,17,0,35,18
1656866651246,COGS 107A,A01,083627,Boyle; Mary E. T.,13,0,60,47
1656866657267,COGS 118A,A01,083075,Gupta; Anjum,15,0,76,61
1656866663296,CSE 3,A50,083646,Miranda; Gregory Joseph,22,0,50,28
1656866669323,CSE 8A,A50,083650,Miranda; Gregory Joseph,17,1,56,39
1656866675347,CSE 11,A01,083080,Cao; Yingjun,4,15,40,36
1656866681370,CSE 12,A01,083652,Krause-Levy; Sophia Louisa,20,1,120,100
1656866687398,CSE 15L,A01,083654,Morris; Justin Loren,8,0,50,42
1656866687398,CSE 15L,A02,083655,Morris; Justin Loren,8,0,50,42
1656866693423,CSE 20,A01,083657,Tran; Khoa Dang,37,0,80,43
1656866699458,CSE 21,A01,095574,Bach; Quang Tran,21,0,48,27
1656866705488,CSE 30,A01,083084,Eldon; John,4,0,80,76
1656866705488,CSE 30,B01,095061,Bhaskar; Nishant,6,0,50,44
1656866711511,CSE 100,A01,083659,Cao; Yingjun,2,4,70,68
1656866717534,CSE 134B,A01,083661,Powell; Thomas Allan,19,0,100,81
1656866723563,CSE 140,A01,083663,Gungor; Onat,14,0,85,71
1656866729591,CSE 140L,A01,083088,Eldon; John,16,0,100,84
1656866735614,CSE 175,A01,083665,Kumar; Rakesh,3,0,25,22
1656866741640,CSE 190,A00,092507,Dubnov; Shlomo,7,0,20,13
1656866747665,ECE 45,A01,083139,Congero; Spencer William,5,0,75,70
1656866753693,ECE 65,A50,083695,Saad; Andrew S,12,0,30,18
1656866753693,ECE 65,A51,095125,Saad; Andrew S,25,0,26,1
1656866759723,ECE 109,A01,091882,Touri; Behrouz,16,0,70,54
1656866765747,ECE 180,A00,083140,Abi Samra; Nicholas Camill,0,0,30,30
1656866765747,ECE 180,B00,083141,Abi Samra; Nicholas Camill,0,0,30,30
1656866771771,MATH 10A,A01,083735,Patchell; Gregory David,1,0,30,29
1656866771771,MATH 10A,A02,083736,Patchell; Gregory David,20,0,30,10
1656866771771,MATH 10A,A03,083737,Patchell; Gregory David,15,0,30,15
1656866777799,MATH 10B,A01,083207,Lim; Seonhee,7,0,34,27
1656866777799,MATH 10B,A02,083208,Lim; Seonhee,9,0,35,26
1656866777799,MATH 10B,A03,093472,Lim; Seonhee,4,0,34,30
1656866777799,MATH 10B,B01,083739,Sinha; Shubham,9,0,30,21
1656866783825,MATH 18,A01,083743,Cinel; Cameron Alexander,6,0,30,24
1656866783825,MATH 18,A02,083744,Cinel; Cameron Alexander,15,0,30,15
1656866783825,MATH 18,A03,083745,Cinel; Cameron Alexander,8,0,30,22
1656866783825,MATH 18,B01,083748,Rideout; David Porter,3,0,37,34
1656866783825,MATH 18,B02,083749,Rideout; David Porter,3,0,36,33
1656866783825,MATH 18,B03,083750,Rideout; David Porter,2,0,37,35
1656866783825,MATH 18,B04,083751,Rideout; David Porter,5,0,36,31
1656866783825,MATH 18,B05,093473,Rideout; David Porter,4,0,36,32
1656866783825,MATH 18,B06,093474,Rideout; David Porter,5,0,36,31
1656866789848,MATH 20A,A01,083754,Zheng; Zequn,12,0,40,28
1656866795876,MATH 20B,A01,083756,Briones; Jor-el Thomas Caparas,1,0,36,35
1656866795876,MATH 20B,A02,083757,Briones; Jor-el Thomas Caparas,1,0,36,35
1656866795876,MATH 20B,A03,093475,Briones; Jor-el Thomas Caparas,0,0,36,36
1656866801901,MATH 20C,A01,083760,Briones; Jor-el Thomas Caparas,1,0,35,34
1656866801901,MATH 20C,A02,083761,Briones; Jor-el Thomas Caparas,8,0,35,27
1656866801901,MATH 20C,A03,093476,Briones; Jor-el Thomas Caparas,0,1,36,36
1656866801901,MATH 20C,B01,083762,Bach; Quang Tran,0,0,30,30
1656866807928,MATH 20D,A01,083765,Tran; Brian Kha,4,0,30,26
1656866807928,MATH 20D,A02,083766,Tran; Brian Kha,4,0,30,26
1656866807928,MATH 20D,A03,083767,Tran; Brian Kha,2,0,30,28
1656866813956,MATH 20E,A01,083771,Ganguly; Soumya,5,0,32,27
1656866813956,MATH 20E,A02,083772,Ganguly; Soumya,6,0,32,26
1656866813956,MATH 20E,B01,083773,Ciotti; Benjamin,18,0,35,17
1656866813956,MATH 20E,B02,083774,Ciotti; Benjamin,17,0,35,18
1656866819987,MATH 103A,A01,083777,Greenfeld; Be'Eri,2,0,36,34
1656866819987,MATH 103A,A02,083778,Greenfeld; Be'Eri,5,0,36,31
1656866819987,MATH 103A,A03,093561,Greenfeld; Be'Eri,4,0,36,32
1656866819987,MATH 103A,B01,083779,Greenfeld; Be'Eri,6,0,36,30
1656866819987,MATH 103A,B02,083780,Greenfeld; Be'Eri,2,0,36,34
1656866819987,MATH 103A,B03,093562,Greenfeld; Be'Eri,2,0,36,34
1656866826010,MATH 105,A01,085443,Carter; Anne Toulson,13,0,35,22
1656866826010,MATH 105,A02,093477,Carter; Anne Toulson,20,0,35,15
1656866832039,MATH 109,A01,083213,Ganzberger; Geoffrey Michael,2,0,34,32
1656866832039,MATH 109,A02,083214,Ganzberger; Geoffrey Michael,2,0,34,32
1656866832039,MATH 109,A03,093478,Ganzberger; Geoffrey Michael,1,0,34,33
1656866832039,MATH 109,B01,083215,Ganzberger; Geoffrey Michael,1,0,32,31
1656866832039,MATH 109,B02,083216,Ganzberger; Geoffrey Michael,1,0,32,31
1656866832039,MATH 109,B03,093479,Ganzberger; Geoffrey Michael,6,0,32,26
1656866838063,MATH 142A,A01,083219,Chow; Bennett,6,0,32,26
1656866838063,MATH 142A,A02,083220,Chow; Bennett,9,0,32,23
1656866838063,MATH 142A,A03,093480,Chow; Bennett,7,0,32,25
1656866838063,MATH 142A,B03,093481,Chow; Bennett,7,0,32,25
1656866838063,MATH 142A,B04,093558,Chow; Bennett,10,0,32,22
1656866838063,MATH 142A,B05,093559,Chow; Bennett,6,0,32,26
1656866844087,MATH 193A,A01,083224,Rotar; Vladimir,6,0,34,28
1656866844087,MATH 193A,A02,083225,Rotar; Vladimir,3,0,34,31
1656866844087,MATH 193A,A03,083781,Rotar; Vladimir,1,0,34,33
1656866844087,MATH 193A,A04,083782,Rotar; Vladimir,6,0,34,28
1656866844087,MATH 193A,A05,093482,Rotar; Vladimir,6,0,34,28
1656866850112,MATH 197,001,091859,McAuley; Julian John,9999,0,9999,0
1656866850112,MATH 197,002,095566,Kedlaya; Kiran S.,9997,0,9999,2
1656866850112,MATH 197,003,095567,Xiao; Ming,9999,0,9999,0
1656866850112,MATH 197,004,095571,Perols; Johan Lars,9998,0,9999,1
1656866857235,COGS 9,A01,083615,Shannon; Kyle Michael,6,0,75,69
1656866863258,COGS 11,A01,083617,Boyle; Mary E. T.,18,0,48,30
1656866869287,COGS 13,A01,083071,Bastos; Amalia Pinkusfeld,8,0,71,63
1656866875312,COGS 14A,A01,092681,Semenuks; Arturs,0,1,100,100
1656866881336,COGS 14B,A01,083073,Cheng; Tzu-Han,5,0,63,58
1656866887366,COGS 17,A01,092677,Semenuks; Arturs,4,0,81,77
1656866893388,COGS 100,A01,083619,Allen; Michael Gordon,15,0,70,55
1656866899410,COGS 101A,A01,083621,Davis; Joshua Daniel,9,0,68,59
1656866905432,COGS 101B,A01,091572,Allen; Michael Gordon,8,0,65,57
1656866911456,COGS 101C,A01,083625,Delgado; Tania,17,0,35,18
1656866917480,COGS 107A,A01,083627,Boyle; Mary E. T.,13,0,60,47
1656866923503,COGS 118A,A01,083075,Gupta; Anjum,15,0,76,61
1656866929529,CSE 3,A50,083646,Miranda; Gregory Joseph,22,0,50,28
1656866935553,CSE 8A,A50,083650,Miranda; Gregory Joseph,17,1,56,39
1656866941576,CSE 11,A01,083080,Cao; Yingjun,4,15,40,36
1656866947601,CSE 12,A01,083652,Krause-Levy; Sophia Louisa,20,1,120,100
1656866953623,CSE 15L,A01,083654,Morris; Justin Loren,8,0,50,42
1656866953623,CSE 15L,A02,083655,Morris; Justin Loren,8,0,50,42
1656866959654,CSE 20,A01,083657,Tran; Khoa Dang,37,0,80,43
1656866965676,CSE 21,A01,095574,Bach; Quang Tran,21,0,48,27
1656866971703,CSE 30,A01,083084,Eldon; John,4,0,80,76
1656866971703,CSE 30,B01,095061,Bhaskar; Nishant,6,0,50,44
1656866977725,CSE 100,A01,083659,Cao; Yingjun,2,4,70,68
1656866983752,CSE 134B,A01,083661,Powell; Thomas Allan,19,0,100,81
1656866989778,CSE 140,A01,083663,Gungor; Onat,14,0,85,71
1656866995804,CSE 140L,A01,083088,Eldon; John,16,0,100,84
1656867001831,CSE 175,A01,083665,Kumar; Rakesh,3,0,25,22
1656867007854,CSE 190,A00,092507,Dubnov; Shlomo,7,0,20,13
1656867013876,ECE 45,A01,083139,Congero; Spencer William,5,0,75,70
1656867019900,ECE 65,A50,083695,Saad; Andrew S,12,0,30,18
1656867019900,ECE 65,A51,095125,Saad; Andrew S,25,0,26,1
1656867025923,ECE 109,A01,091882,Touri; Behrouz,16,0,70,54
1656867031956,ECE 180,A00,083140,Abi Samra; Nicholas Camill,0,0,30,30
1656867031956,ECE 180,B00,083141,Abi Samra; Nicholas Camill,0,0,30,30
1656867037980,MATH 10A,A01,083735,Patchell; Gregory David,1,0,30,29
1656867037980,MATH 10A,A02,083736,Patchell; Gregory David,20,0,30,10
1656867037980,MATH 10A,A03,083737,Patchell; Gregory David,15,0,30,15
1656867044005,MATH 10B,A01,083207,Lim; Seonhee,7,0,34,27
1656867044005,MATH 10B,A02,083208,Lim; Seonhee,9,0,35,26
1656867044005,MATH 10B,A03,093472,Lim; Seonhee,4,0,34,30
1656867044005,MATH 10B,B01,083739,Sinha; Shubham,9,0,30,21
1656867050036,MATH 18,A01,083743,Cinel; Cameron Alexander,6,0,30,24
1656867050036,MATH 18,A02,083744,Cinel; Cameron Alexander,15,0,30,15
1656867050036,MATH 18,A03,083745,Cinel; Cameron Alexander,8,0,30,22
1656867050036,MATH 18,B01,083748,Rideout; David Porter,3,0,37,34
1656867050036,MATH 18,B02,083749,Rideout; David Porter,3,0,36,33
1656867050036,MATH 18,B03,083750,Rideout; David Porter,2,0,37,35
1656867050036,MATH 18,B04,083751,Rideout; David Porter,5,0,36,31
1656867050036,MATH 18,B05,093473,Rideout; David Porter,4,0,36,32
1656867050036,MATH 18,B06,093474,Rideout; David Porter,5,0,36,31
1656867056058,MATH 20A,A01,083754,Zheng; Zequn,12,0,40,28
1656867062083,MATH 20B,A01,083756,Briones; Jor-el Thomas Caparas,1,0,36,35
1656867062083,MATH 20B,A02,083757,Briones; Jor-el Thomas Caparas,1,0,36,35
1656867062083,MATH 20B,A03,093475,Briones; Jor-el Thomas Caparas,0,0,36,36
1656867068109,MATH 20C,A01,083760,Briones; Jor-el Thomas Caparas,1,0,35,34
1656867068109,MATH 20C,A02,083761,Briones; Jor-el Thomas Caparas,8,0,35,27
1656867068109,MATH 20C,A03,093476,Briones; Jor-el Thomas Caparas,0,1,36,36
1656867068109,MATH 20C,B01,083762,Bach; Quang Tran,0,0,30,30
1656867074139,MATH 20D,A01,083765,Tran; Brian Kha,4,0,30,26
1656867074139,MATH 20D,A02,083766,Tran; Brian Kha,4,0,30,26
1656867074139,MATH 20D,A03,083767,Tran; Brian Kha,2,0,30,28
1656867080164,MATH 20E,A01,083771,Ganguly; Soumya,5,0,32,27
1656867080164,MATH 20E,A02,083772,Ganguly; Soumya,6,0,32,26
1656867080164,MATH 20E,B01,083773,Ciotti; Benjamin,18,0,35,17
1656867080164,MATH 20E,B02,083774,Ciotti; Benjamin,17,0,35,18
1656867086188,MATH 103A,A01,083777,Greenfeld; Be'Eri,2,0,36,34
1656867086188,MATH 103A,A02,083778,Greenfeld; Be'Eri,5,0,36,31
1656867086188,MATH 103A,A03,093561,Greenfeld; Be'Eri,4,0,36,32
1656867086188,MATH 103A,B01,083779,Greenfeld; Be'Eri,6,0,36,30
1656867086188,MATH 103A,B02,083780,Greenfeld; Be'Eri,2,0,36,34
1656867086188,MATH 103A,B03,093562,Greenfeld; Be'Eri,2,0,36,34
1656867092222,MATH 105,A01,085443,Carter; Anne Toulson,13,0,35,22
1656867092222,MATH 105,A02,093477,Carter; Anne Toulson,20,0,35,15
1656867098246,MATH 109,A01,083213,Ganzberger; Geoffrey Michael,2,0,34,32
1656867098246,MATH 109,A02,083214,Ganzberger; Geoffrey Michael,2,0,34,32
1656867098246,MATH 109,A03,093478,Ganzberger; Geoffrey Michael,1,0,34,33
1656867098246,MATH 109,B01,083215,Ganzberger; Geoffrey Michael,1,0,32,31
1656867098246,MATH 109,B02,083216,Ganzberger; Geoffrey Michael,1,0,32,31
1656867098246,MATH 109,B03,093479,Ganzberger; Geoffrey Michael,6,0,32,26
1656867104276,MATH 142A,A01,083219,Chow; Bennett,6,0,32,26
1656867104276,MATH 142A,A02,083220,Chow; Bennett,9,0,32,23
1656867104276,MATH 142A,A03,093480,Chow; Bennett,7,0,32,25
1656867104276,MATH 142A,B03,093481,Chow; Bennett,7,0,32,25
1656867104276,MATH 142A,B04,093558,Chow; Bennett,10,0,32,22
1656867104276,MATH 142A,B05,093559,Chow; Bennett,6,0,32,26
1656867110306,MATH 193A,A01,083224,Rotar; Vladimir,6,0,34,28
1656867110306,MATH 193A,A02,083225,Rotar; Vladimir,3,0,34,31
1656867110306,MATH 193A,A03,083781,Rotar; Vladimir,1,0,34,33
1656867110306,MATH 193A,A04,083782,Rotar; Vladimir,6,0,34,28
1656867110306,MATH 193A,A05,093482,Rotar; Vladimir,6,0,34,28
1656867116331,MATH 197,001,091859,McAuley; Julian John,9999,0,9999,0
1656867116331,MATH 197,002,095566,Kedlaya; Kiran S.,9997,0,9999,2
1656867116331,MATH 197,003,095567,Xiao; Ming,9999,0,9999,0
1656867116331,MATH 197,004,095571,Perols; Johan Lars,9998,0,9999,1
1656867123384,COGS 9,A01,083615,Shannon; Kyle Michael,6,0,75,69
1656867129408,COGS 11,A01,083617,Boyle; Mary E. T.,18,0,48,30
1656867135437,COGS 13,A01,083071,Bastos; Amalia Pinkusfeld,8,0,71,63
1656867141466,COGS 14A,A01,092681,Semenuks; Arturs,0,1,100,100
1656867147489,COGS 14B,A01,083073,Cheng; Tzu-Han,5,0,63,58
1656867153517,COGS 17,A01,092677,Semenuks; Arturs,4,0,81,77
1656867159551,COGS 100,A01,083619,Allen; Michael Gordon,15,0,70,55
1656867165578,COGS 101A,A01,083621,Davis; Joshua Daniel,9,0,68,59
1656867171603,COGS 101B,A01,091572,Allen; Michael Gordon,8,0,65,57
1656867177626,COGS 101C,A01,083625,Delgado; Tania,17,0,35,18
1656867183652,COGS 107A,A01,083627,Boyle; Mary E. T.,13,0,60,47
1656867189679,COGS 118A,A01,083075,Gupta; Anjum,15,0,76,61
1656867195710,CSE 3,A50,083646,Miranda; Gregory Joseph,22,0,50,28
1656867201733,CSE 8A,A50,083650,Miranda; Gregory Joseph,17,1,56,39
1656867207759,CSE 11,A01,083080,Cao; Yingjun,4,15,40,36
1656867213796,CSE 12,A01,083652,Krause-Levy; Sophia Louisa,20,1,120,100
1656867219832,CSE 15L,A01,083654,Morris; Justin Loren,8,0,50,42
1656867219832,CSE 15L,A02,083655,Morris; Justin Loren,8,0,50,42
1656867225859,CSE 20,A01,083657,Tran; Khoa Dang,37,0,80,43
1656867231886,CSE 21,A01,095574,Bach; Quang Tran,21,0,48,27
1656867237909,CSE 30,A01,083084,Eldon; John,4,0,80,76
1656867237909,CSE 30,B01,095061,Bhaskar; Nishant,6,0,50,44
1656867243937,CSE 100,A01,083659,Cao; Yingjun,2,4,70,68
1656867249959,CSE 134B,A01,083661,Powell; Thomas Allan,19,0,100,81
1656867255983,CSE 140,A01,083663,Gungor; Onat,14,0,85,71
1656867262005,CSE 140L,A01,083088,Eldon; John,16,0,100,84
1656867268032,CSE 175,A01,083665,Kumar; Rakesh,3,0,25,22
1656867274060,CSE 190,A00,092507,Dubnov; Shlomo,7,0,20,13
1656867280086,ECE 45,A01,083139,Congero; Spencer William,5,0,75,70
1656867286117,ECE 65,A50,083695,Saad; Andrew S,12,0,30,18
1656867286117,ECE 65,A51,095125,Saad; Andrew S,25,0,26,1
1656867292140,ECE 109,A01,091882,Touri; Behrouz,16,0,70,54
1656867298163,ECE 180,A00,083140,Abi Samra; Nicholas Camill,0,0,30,30
1656867298163,ECE 180,B00,083141,Abi Samra; Nicholas Camill,0,0,30,30
1656867304194,MATH 10A,A01,083735,Patchell; Gregory David,1,0,30,29
1656867304194,MATH 10A,A02,083736,Patchell; Gregory David,20,0,30,10
1656867304194,MATH 10A,A03,083737,Patchell; Gregory David,15,0,30,15
1656867310217,MATH 10B,A01,083207,Lim; Seonhee,7,0,34,27
1656867310217,MATH 10B,A02,083208,Lim; Seonhee,9,0,35,26
1656867310217,MATH 10B,A03,093472,Lim; Seonhee,4,0,34,30
1656867310217,MATH 10B,B01,083739,Sinha; Shubham,9,0,30,21
1656867316247,MATH 18,A01,083743,Cinel; Cameron Alexander,6,0,30,24
1656867316247,MATH 18,A02,083744,Cinel; Cameron Alexander,15,0,30,15
1656867316247,MATH 18,A03,083745,Cinel; Cameron Alexander,8,0,30,22
1656867316247,MATH 18,B01,083748,Rideout; David Porter,3,0,37,34
1656867316247,MATH 18,B02,083749,Rideout; David Porter,3,0,36,33
1656867316247,MATH 18,B03,083750,Rideout; David Porter,2,0,37,35
1656867316247,MATH 18,B04,083751,Rideout; David Porter,5,0,36,31
1656867316247,MATH 18,B05,093473,Rideout; David Porter,4,0,36,32
1656867316247,MATH 18,B06,093474,Rideout; David Porter,5,0,36,31
1656867322272,MATH 20A,A01,083754,Zheng; Zequn,12,0,40,28
1656867328296,MATH 20B,A01,083756,Briones; Jor-el Thomas Caparas,1,0,36,35
1656867328296,MATH 20B,A02,083757,Briones; Jor-el Thomas Caparas,1,0,36,35
1656867328296,MATH 20B,A03,093475,Briones; Jor-el Thomas Caparas,0,0,36,36
1656867334325,MATH 20C,A01,083760,Briones; Jor-el Thomas Caparas,1,0,35,34
1656867334325,MATH 20C,A02,083761,Briones; Jor-el Thomas Caparas,8,0,35,27
1656867334325,MATH 20C,A03,093476,Briones; Jor-el Thomas Caparas,0,1,36,36
1656867334325,MATH 20C,B01,083762,Bach; Quang Tran,0,0,30,30
1656867340350,MATH 20D,A01,083765,Tran; Brian Kha,4,0,30,26
1656867340350,MATH 20D,A02,083766,Tran; Brian Kha,4,0,30,26
1656867340350,MATH 20D,A03,083767,Tran; Brian Kha,2,0,30,28
1656867346380,MATH 20E,A01,083771,Ganguly; Soumya,5,0,32,27
1656867346380,MATH 20E,A02,083772,Ganguly; Soumya,6,0,32,26
1656867346380,MATH 20E,B01,083773,Ciotti; Benjamin,18,0,35,17
1656867346380,MATH 20E,B02,083774,Ciotti; Benjamin,17,0,35,18
1656867352403,MATH 103A,A01,083777,Greenfeld; Be'Eri,2,0,36,34
1656867352403,MATH 103A,A02,083778,Greenfeld; Be'Eri,5,0,36,31
1656867352403,MATH 103A,A03,093561,Greenfeld; Be'Eri,4,0,36,32
1656867352403,MATH 103A,B01,083779,Greenfeld; Be'Eri,6,0,36,30
1656867352403,MATH 103A,B02,083780,Greenfeld; Be'Eri,2,0,36,34
1656867352403,MATH 103A,B03,093562,Greenfeld; Be'Eri,2,0,36,34
1656867358427,MATH 105,A01,085443,Carter; Anne Toulson,13,0,35,22
1656867358427,MATH 105,A02,093477,Carter; Anne Toulson,20,0,35,15
1656867364456,MATH 109,A01,083213,Ganzberger; Geoffrey Michael,2,0,34,32
1656867364456,MATH 109,A02,083214,Ganzberger; Geoffrey Michael,2,0,34,32
1656867364456,MATH 109,A03,093478,Ganzberger; Geoffrey Michael,1,0,34,33
1656867364456,MATH 109,B01,083215,Ganzberger; Geoffrey Michael,1,0,32,31
1656867364456,MATH 109,B02,083216,Ganzberger; Geoffrey Michael,1,0,32,31
1656867364456,MATH 109,B03,093479,Ganzberger; Geoffrey Michael,6,0,32,26
1656867370480,MATH 142A,A01,083219,Chow; Bennett,6,0,32,26
1656867370480,MATH 142A,A02,083220,Chow; Bennett,9,0,32,23
1656867370480,MATH 142A,A03,093480,Chow; Bennett,7,0,32,25
1656867370480,MATH 142A,B03,093481,Chow; Bennett,7,0,32,25
1656867370480,MATH 142A,B04,093558,Chow; Bennett,10,0,32,22
1656867370480,MATH 142A,B05,093559,Chow; Bennett,6,0,32,26
1656867376504,MATH 193A,A01,083224,Rotar; Vladimir,6,0,34,28
1656867376504,MATH 193A,A02,083225,Rotar; Vladimir,3,0,34,31
1656867376504,MATH 193A,A03,083781,Rotar; Vladimir,1,0,34,33
1656867376504,MATH 193A,A04,083782,Rotar; Vladimir,6,0,34,28
1656867376504,MATH 193A,A05,093482,Rotar; Vladimir,6,0,34,28
1656867382526,MATH 197,001,091859,McAuley; Julian John,9999,0,9999,0
1656867382526,MATH 197,002,095566,Kedlaya; Kiran S.,9997,0,9999,2
1656867382526,MATH 197,003,095567,Xiao; Ming,9999,0,9999,0
1656867382526,MATH 197,004,095571,Perols; Johan Lars,9998,0,9999,1
1656867389590,COGS 9,A01,083615,Shannon; Kyle Michael,6,0,75,69
1656867395614,COGS 11,A01,083617,Boyle; Mary E. T.,18,0,48,30
1656867401637,COGS 13,A01,083071,Bastos; Amalia Pinkusfeld,8,0,71,63
1656867407660,COGS 14A,A01,092681,Semenuks; Arturs,0,1,100,100
1656867413684,COGS 14B,A01,083073,Cheng; Tzu-Han,5,0,63,58
1656867419708,COGS 17,A01,092677,Semenuks; Arturs,4,0,81,77
1656867425736,COGS 100,A01,083619,Allen; Michael Gordon,15,0,70,55
1656867431763,COGS 101A,A01,083621,Davis; Joshua Daniel,9,0,68,59
1656867437787,COGS 101B,A01,091572,Allen; Michael Gordon,8,0,65,57
1656867443811,COGS 101C,A01,083625,Delgado; Tania,17,0,35,18
1656867449907,COGS 107A,A01,083627,Boyle; Mary E. T.,13,0,60,47
1656867455932,COGS 118A,A01,083075,Gupta; Anjum,15,0,76,61
1656867461955,CSE 3,A50,083646,Miranda; Gregory Joseph,22,0,50,28
1656867467980,CSE 8A,A50,083650,Miranda; Gregory Joseph,17,1,56,39
1656867474002,CSE 11,A01,083080,Cao; Yingjun,4,15,40,36
1656867480029,CSE 12,A01,083652,Krause-Levy; Sophia Louisa,20,1,120,100
1656867486052,CSE 15L,A01,083654,Morris; Justin Loren,8,0,50,42
1656867486052,CSE 15L,A02,083655,Morris; Justin Loren,8,0,50,42
1656867492080,CSE 20,A01,083657,Tran; Khoa Dang,37,0,80,43
1656867498106,CSE 21,A01,095574,Bach; Quang Tran,21,0,48,27
1656867504136,CSE 30,A01,083084,Eldon; John,4,0,80,76
1656867504136,CSE 30,B01,095061,Bhaskar; Nishant,6,0,50,44
1656867510159,CSE 100,A01,083659,Cao; Yingjun,2,4,70,68
1656867516186,CSE 134B,A01,083661,Powell; Thomas Allan,19,0,100,81
1656867522213,CSE 140,A01,083663,Gungor; Onat,14,0,85,71
1656867528235,CSE 140L,A01,083088,Eldon; John,16,0,100,84
1656867534261,CSE 175,A01,083665,Kumar; Rakesh,3,0,25,22
1656867540294,CSE 190,A00,092507,Dubnov; Shlomo,7,0,20,13
1656867546319,ECE 45,A01,083139,Congero; Spencer William,5,0,75,70
1656867552343,ECE 65,A50,083695,Saad; Andrew S,12,0,30,18
1656867552343,ECE 65,A51,095125,Saad; Andrew S,25,0,26,1
1656867558367,ECE 109,A01,091882,Touri; Behrouz,16,0,70,54
1656867564395,ECE 180,A00,083140,Abi Samra; Nicholas Camill,0,0,30,30
1656867564395,ECE 180,B00,083141,Abi Samra; Nicholas Camill,0,0,30,30
1656867570421,MATH 10A,A01,083735,Patchell; Gregory David,1,0,30,29
1656867570421,MATH 10A,A02,083736,Patchell; Gregory David,20,0,30,10
1656867570421,MATH 10A,A03,083737,Patchell; Gregory David,15,0,30,15
1656867576444,MATH 10B,A01,083207,Lim; Seonhee,7,0,34,27
1656867576444,MATH 10B,A02,083208,Lim; Seonhee,9,0,35,26
1656867576444,MATH 10B,A03,093472,Lim; Seonhee,4,0,34,30
1656867576444,MATH 10B,B01,083739,Sinha; Shubham,9,0,30,21
1656867582476,MATH 18,A01,083743,Cinel; Cameron Alexander,6,0,30,24
1656867582476,MATH 18,A02,083744,Cinel; Cameron Alexander,15,0,30,15
1656867582476,MATH 18,A03,083745,Cinel; Cameron Alexander,8,0,30,22
1656867582476,MATH 18,B01,083748,Rideout; David Porter,3,0,37,34
1656867582476,MATH 18,B02,083749,Rideout; David Porter,3,0,36,33
1656867582476,MATH 18,B03,083750,Rideout; David Porter,2,0,37,35
1656867582476,MATH 18,B04,083751,Rideout; David Porter,5,0,36,31
1656867582476,MATH 18,B05,093473,Rideout; David Porter,4,0,36,32
1656867582476,MATH 18,B06,093474,Rideout; David Porter,5,0,36,31
1656867588498,MATH 20A,A01,083754,Zheng; Zequn,12,0,40,28
1656867594522,MATH 20B,A01,083756,Briones; Jor-el Thomas Caparas,1,0,36,35
1656867594522,MATH 20B,A02,083757,Briones; Jor-el Thomas Caparas,1,0,36,35
1656867594522,MATH 20B,A03,093475,Briones; Jor-el Thomas Caparas,0,0,36,36
1656867600546,MATH 20C,A01,083760,Briones; Jor-el Thomas Caparas,1,0,35,34
1656867600546,MATH 20C,A02,083761,Briones; Jor-el Thomas Caparas,8,0,35,27
1656867600546,MATH 20C,A03,093476,Briones; Jor-el Thomas Caparas,0,1,36,36
1656867600546,MATH 20C,B01,083762,Bach; Quang Tran,0,0,30,30
1656867606568,MATH 20D,A01,083765,Tran; Brian Kha,4,0,30,26
1656867606568,MATH 20D,A02,083766,Tran; Brian Kha,4,0,30,26
1656867606568,MATH 20D,A03,083767,Tran; Brian Kha,2,0,30,28
1656867612596,MATH 20E,A01,083771,Ganguly; Soumya,5,0,32,27
1656867612596,MATH 20E,A02,083772,Ganguly; Soumya,6,0,32,26
1656867612596,MATH 20E,B01,083773,Ciotti; Benjamin,18,0,35,17
1656867612596,MATH 20E,B02,083774,Ciotti; Benjamin,17,0,35,18
1656867618623,MATH 103A,A01,083777,Greenfeld; Be'Eri,2,0,36,34
1656867618623,MATH 103A,A02,083778,Greenfeld; Be'Eri,5,0,36,31
1656867618623,MATH 103A,A03,093561,Greenfeld; Be'Eri,4,0,36,32
1656867618623,MATH 103A,B01,083779,Greenfeld; Be'Eri,6,0,36,30
1656867618623,MATH 103A,B02,083780,Greenfeld; Be'Eri,2,0,36,34
1656867618623,MATH 103A,B03,093562,Greenfeld; Be'Eri,2,0,36,34
1656867624651,MATH 105,A01,085443,Carter; Anne Toulson,13,0,35,22
1656867624651,MATH 105,A02,093477,Carter; Anne Toulson,20,0,35,15
1656867630675,MATH 109,A01,083213,Ganzberger; Geoffrey Michael,2,0,34,32
1656867630675,MATH 109,A02,083214,Ganzberger; Geoffrey Michael,2,0,34,32
1656867630675,MATH 109,A03,093478,Ganzberger; Geoffrey Michael,1,0,34,33
1656867630675,MATH 109,B01,083215,Ganzberger; Geoffrey Michael,1,0,32,31
1656867630675,MATH 109,B02,083216,Ganzberger; Geoffrey Michael,1,0,32,31
1656867630675,MATH 109,B03,093479,Ganzberger; Geoffrey Michael,6,0,32,26
1656867636699,MATH 142A,A01,083219,Chow; Bennett,6,0,32,26
1656867636699,MATH 142A,A02,083220,Chow; Bennett,9,0,32,23
1656867636699,MATH 142A,A03,093480,Chow; Bennett,7,0,32,25
1656867636699,MATH 142A,B03,093481,Chow; Bennett,7,0,32,25
1656867636699,MATH 142A,B04,093558,Chow; Bennett,10,0,32,22
1656867636699,MATH 142A,B05,093559,Chow; Bennett,6,0,32,26
1656867642725,MATH 193A,A01,083224,Rotar; Vladimir,6,0,34,28
1656867642725,MATH 193A,A02,083225,Rotar; Vladimir,3,0,34,31
1656867642725,MATH 193A,A03,083781,Rotar; Vladimir,1,0,34,33
1656867642725,MATH 193A,A04,083782,Rotar; Vladimir,6,0,34,28
1656867642725,MATH 193A,A05,093482,Rotar; Vladimir,6,0,34,28
1656867648753,MATH 197,001,091859,McAuley; Julian John,9999,0,9999,0
1656867648753,MATH 197,002,095566,Kedlaya; Kiran S.,9997,0,9999,2
1656867648753,MATH 197,003,095567,Xiao; Ming,9999,0,9999,0
1656867648753,MATH 197,004,095571,Perols; Johan Lars,9998,0,9999,1
1656867655818,COGS 9,A01,083615,Shannon; Kyle Michael,6,0,75,69
1656867661847,COGS 11,A01,083617,Boyle; Mary E. T.,18,0,48,30
1656867667869,COGS 13,A01,083071,Bastos; Amalia Pinkusfeld,8,0,71,63
1656867673892,COGS 14A,A01,092681,Semenuks; Arturs,0,1,100,100
1656867679918,COGS 14B,A01,083073,Cheng; Tzu-Han,5,0,63,58
1656867685944,COGS 17,A01,092677,Semenuks; Arturs,4,0,81,77
1656867691971,COGS 100,A01,083619,Allen; Michael Gordon,15,0,70,55
1656867697994,COGS 101A,A01,083621,Davis; Joshua Daniel,9,0,68,59
1656867704018,COGS 101B,A01,091572,Allen; Michael Gordon,8,0,65,57
1656867710042,COGS 101C,A01,083625,Delgado; Tania,17,0,35,18
1656867716066,COGS 107A,A01,083627,Boyle; Mary E. T.,13,0,60,47
1656867722091,COGS 118A,A01,083075,Gupta; Anjum,15,0,76,61
1656867728116,CSE 3,A50,083646,Miranda; Gregory Joseph,22,0,50,28
1656867734146,CSE 8A,A50,083650,Miranda; Gregory Joseph,17,1,56,39
1656867740169,CSE 11,A01,083080,Cao; Yingjun,4,15,40,36
1656867746193,CSE 12,A01,083652,Krause-Levy; Sophia Louisa,20,1,120,100
1656867752216,CSE 15L,A01,083654,Morris; Justin Loren,8,0,50,42
1656867752216,CSE 15L,A02,083655,Morris; Justin Loren,8,0,50,42
1656867758241,CSE 20,A01,083657,Tran; Khoa Dang,37,0,80,43
1656867764269,CSE 21,A01,095574,Bach; Quang Tran,21,0,48,27
1656867770298,CSE 30,A01,083084,Eldon; John,4,0,80,76
1656867770298,CSE 30,B01,095061,Bhaskar; Nishant,6,0,50,44
1656867776321,CSE 100,A01,083659,Cao; Yingjun,2,4,70,68
1656867782348,CSE 134B,A01,083661,Powell; Thomas Allan,19,0,100,81
1656867788374,CSE 140,A01,083663,Gungor; Onat,14,0,85,71
1656867794398,CSE 140L,A01,083088,Eldon; John,16,0,100,84
1656867800425,CSE 175,A01,083665,Kumar; Rakesh,3,0,25,22
1656867806454,CSE 190,A00,092507,Dubnov; Shlomo,7,0,20,13
1656867812482,ECE 45,A01,083139,Congero; Spencer William,5,0,75,70
1656867818522,ECE 65,A50,083695,Saad; Andrew S,12,0,30,18
1656867818522,ECE 65,A51,095125,Saad; Andrew S,25,0,26,1
1656867824548,ECE 109,A01,091882,Touri; Behrouz,16,0,70,54
1656867830574,ECE 180,A00,083140,Abi Samra; Nicholas Camill,0,0,30,30
1656867830574,ECE 180,B00,083141,Abi Samra; Nicholas Camill,0,0,30,30
1656867836604,MATH 10A,A01,083735,Patchell; Gregory David,1,0,30,29
1656867836604,MATH 10A,A02,083736,Patchell; Gregory David,20,0,30,10
1656867836604,MATH 10A,A03,083737,Patchell; Gregory David,15,0,30,15
1656867842628,MATH 10B,A01,083207,Lim; Seonhee,7,0,34,27
1656867842628,MATH 10B,A02,083208,Lim; Seonhee,9,0,35,26
1656867842628,MATH 10B,A03,093472,Lim; Seonhee,4,0,34,30
1656867842628,MATH 10B,B01,083739,Sinha; Shubham,9,0,30,21
1656867848654,MATH 18,A01,083743,Cinel; Cameron Alexander,6,0,30,24
1656867848654,MATH 18,A02,083744,Cinel; Cameron Alexander,15,0,30,15
1656867848654,MATH 18,A03,083745,Cinel; Cameron Alexander,8,0,30,22
1656867848654,MATH 18,B01,083748,Rideout; David Porter,3,0,37,34
1656867848654,MATH 18,B02,083749,Rideout; David Porter,3,0,36,33
1656867848654,MATH 18,B03,083750,Rideout; David Porter,2,0,37,35
1656867848654,MATH 18,B04,083751,Rideout; David Porter,5,0,36,31
1656867848654,MATH 18,B05,093473,Rideout; David Porter,4,0,36,32
1656867848654,MATH 18,B06,093474,Rideout; David Porter,5,0,36,31
1656867854680,MATH 20A,A01,083754,Zheng; Zequn,12,0,40,28
1656867860707,MATH 20B,A01,083756,Briones; Jor-el Thomas Caparas,1,0,36,35
1656867860707,MATH 20B,A02,083757,Briones; Jor-el Thomas Caparas,1,0,36,35
1656867860707,MATH 20B,A03,093475,Briones; Jor-el Thomas Caparas,0,0,36,36
1656867866735,MATH 20C,A01,083760,Briones; Jor-el Thomas Caparas,1,0,35,34
1656867866735,MATH 20C,A02,083761,Briones; Jor-el Thomas Caparas,8,0,35,27
1656867866735,MATH 20C,A03,093476,Briones; Jor-el Thomas Caparas,0,1,36,36
1656867866735,MATH 20C,B01,083762,Bach; Quang Tran,0,0,30,30
1656867872762,MATH 20D,A01,083765,Tran; Brian Kha,4,0,30,26
1656867872762,MATH 20D,A02,083766,Tran; Brian Kha,4,0,30,26
1656867872762,MATH 20D,A03,083767,Tran; Brian Kha,2,0,30,28
1656867878786,MATH 20E,A01,083771,Ganguly; Soumya,5,0,32,27
1656867878786,MATH 20E,A02,083772,Ganguly; Soumya,6,0,32,26
1656867878786,MATH 20E,B01,083773,Ciotti; Benjamin,18,0,35,17
1656867878786,MATH 20E,B02,083774,Ciotti; Benjamin,17,0,35,18
1656867884820,MATH 103A,A01,083777,Greenfeld; Be'Eri,2,0,36,34
1656867884820,MATH 103A,A02,083778,Greenfeld; Be'Eri,5,0,36,31
1656867884820,MATH 103A,A03,093561,Greenfeld; Be'Eri,4,0,36,32
1656867884820,MATH 103A,B01,083779,Greenfeld; Be'Eri,6,0,36,30
1656867884820,MATH 103A,B02,083780,Greenfeld; Be'Eri,2,0,36,34
1656867884820,MATH 103A,B03,093562,Greenfeld; Be'Eri,2,0,36,34
1656867890842,MATH 105,A01,085443,Carter; Anne Toulson,13,0,35,22
1656867890842,MATH 105,A02,093477,Carter; Anne Toulson,20,0,35,15
1656867896871,MATH 109,A01,083213,Ganzberger; Geoffrey Michael,2,0,34,32
1656867896871,MATH 109,A02,083214,Ganzberger; Geoffrey Michael,2,0,34,32
1656867896871,MATH 109,A03,093478,Ganzberger; Geoffrey Michael,1,0,34,33
1656867896871,MATH 109,B01,083215,Ganzberger; Geoffrey Michael,1,0,32,31
1656867896871,MATH 109,B02,083216,Ganzberger; Geoffrey Michael,1,0,32,31
1656867896871,MATH 109,B03,093479,Ganzberger; Geoffrey Michael,6,0,32,26
1656867902901,MATH 142A,A01,083219,Chow; Bennett,6,0,32,26
1656867902901,MATH 142A,A02,083220,Chow; Bennett,9,0,32,23
1656867902901,MATH 142A,A03,093480,Chow; Bennett,7,0,32,25
1656867902901,MATH 142A,B03,093481,Chow; Bennett,7,0,32,25
1656867902901,MATH 142A,B04,093558,Chow; Bennett,10,0,32,22
1656867902901,MATH 142A,B05,093559,Chow; Bennett,6,0,32,26
1656867908923,MATH 193A,A01,083224,Rotar; Vladimir,6,0,34,28
1656867908923,MATH 193A,A02,083225,Rotar; Vladimir,3,0,34,31
1656867908923,MATH 193A,A03,083781,Rotar; Vladimir,1,0,34,33
1656867908923,MATH 193A,A04,083782,Rotar; Vladimir,6,0,34,28
1656867908923,MATH 193A,A05,093482,Rotar; Vladimir,6,0,34,28
1656867914953,MATH 197,001,091859,McAuley; Julian John,9999,0,9999,0
1656867914953,MATH 197,002,095566,Kedlaya; Kiran S.,9997,0,9999,2
1656867914953,MATH 197,003,095567,Xiao; Ming,9999,0,9999,0
1656867914953,MATH 197,004,095571,Perols; Johan Lars,9998,0,9999,1
1656867922012,COGS 9,A01,083615,Shannon; Kyle Michael,6,0,75,69
1656867928038,COGS 11,A01,083617,Boyle; Mary E. T.,18,0,48,30
1656867934062,COGS 13,A01,083071,Bastos; Amalia Pinkusfeld,8,0,71,63
1656867940084,COGS 14A,A01,092681,Semenuks; Arturs,0,1,100,100
1656867946109,COGS 14B,A01,083073,Cheng; Tzu-Han,5,0,63,58
1656867952138,COGS 17,A01,092677,Semenuks; Arturs,4,0,81,77
1656867958164,COGS 100,A01,083619,Allen; Michael Gordon,15,0,70,55
1656867964188,COGS 101A,A01,083621,Davis; Joshua Daniel,9,0,68,59
1656867970211,COGS 101B,A01,091572,Allen; Michael Gordon,8,0,65,57
1656867976233,COGS 101C,A01,083625,Delgado; Tania,17,0,35,18
1656867982261,COGS 107A,A01,083627,Boyle; Mary E. T.,13,0,60,47
1656867988296,COGS 118A,A01,083075,Gupta; Anjum,15,0,76,61
1656867994321,CSE 3,A50,083646,Miranda; Gregory Joseph,22,0,50,28
1656868000349,CSE 8A,A50,083650,Miranda; Gregory Joseph,17,1,56,39
1656868006373,CSE 11,A01,083080,Cao; Yingjun,4,15,40,36
1656868012402,CSE 12,A01,083652,Krause-Levy; Sophia Louisa,20,1,120,100
1656868018431,CSE 15L,A01,083654,Morris; Justin Loren,8,0,50,42
1656868018431,CSE 15L,A02,083655,Morris; Justin Loren,8,0,50,42
1656868024455,CSE 20,A01,083657,Tran; Khoa Dang,37,0,80,43
1656868030489,CSE 21,A01,095574,Bach; Quang Tran,21,0,48,27
1656868036514,CSE 30,A01,083084,Eldon; John,4,0,80,76
1656868036514,CSE 30,B01,095061,Bhaskar; Nishant,6,0,50,44
1656868042537,CSE 100,A01,083659,Cao; Yingjun,2,4,70,68
1656868048651,CSE 134B,A01,083661,Powell; Thomas Allan,19,0,100,81
1656868054677,CSE 140,A01,083663,Gungor; Onat,14,0,85,71
1656868060702,CSE 140L,A01,083088,Eldon; John,16,0,100,84
1656868066725,CSE 175,A01,083665,Kumar; Rakesh,3,0,25,22
1656868072750,CSE 190,A00,092507,Dubnov; Shlomo,7,0,20,13
1656868078773,ECE 45,A01,083139,Congero; Spencer William,5,0,75,70
1656868084799,ECE 65,A50,083695,Saad; Andrew S,12,0,30,18
1656868084799,ECE 65,A51,095125,Saad; Andrew S,25,0,26,1
1656868090820,ECE 109,A01,091882,Touri; Behrouz,16,0,70,54
1656868096849,ECE 180,A00,083140,Abi Samra; Nicholas Camill,0,0,30,30
1656868096849,ECE 180,B00,083141,Abi Samra; Nicholas Camill,0,0,30,30
1656868102873,MATH 10A,A01,083735,Patchell; Gregory David,1,0,30,29
1656868102873,MATH 10A,A02,083736,Patchell; Gregory David,20,0,30,10
1656868102873,MATH 10A,A03,083737,Patchell; Gregory David,15,0,30,15
1656868108909,MATH 10B,A01,083207,Lim; Seonhee,7,0,34,27
1656868108909,MATH 10B,A02,083208,Lim; Seonhee,9,0,35,26
1656868108909,MATH 10B,A03,093472,Lim; Seonhee,4,0,34,30
1656868108909,MATH 10B,B01,083739,Sinha; Shubham,9,0,30,21
1656868114940,MATH 18,A01,083743,Cinel; Cameron Alexander,6,0,30,24
1656868114940,MATH 18,A02,083744,Cinel; Cameron Alexander,15,0,30,15
1656868114940,MATH 18,A03,083745,Cinel; Cameron Alexander,8,0,30,22
1656868114940,MATH 18,B01,083748,Rideout; David Porter,3,0,37,34
1656868114940,MATH 18,B02,083749,Rideout; David Porter,3,0,36,33
1656868114940,MATH 18,B03,083750,Rideout; David Porter,2,0,37,35
1656868114940,MATH 18,B04,083751,Rideout; David Porter,5,0,36,31
1656868114940,MATH 18,B05,093473,Rideout; David Porter,4,0,36,32
1656868114940,MATH 18,B06,093474,Rideout; David Porter,5,0,36,31
1656868120965,MATH 20A,A01,083754,Zheng; Zequn,12,0,40,28
1656868127000,MATH 20B,A01,083756,Briones; Jor-el Thomas Caparas,1,0,36,35
1656868127000,MATH 20B,A02,083757,Briones; Jor-el Thomas Caparas,1,0,36,35
1656868127000,MATH 20B,A03,093475,Briones; Jor-el Thomas Caparas,0,0,36,36
1656868133025,MATH 20C,A01,083760,Briones; Jor-el Thomas Caparas,1,0,35,34
1656868133025,MATH 20C,A02,083761,Briones; Jor-el Thomas Caparas,8,0,35,27
1656868133025,MATH 20C,A03,093476,Briones; Jor-el Thomas Caparas,0,1,36,36
1656868133025,MATH 20C,B01,083762,Bach; Quang Tran,0,0,30,30
1656868139062,MATH 20D,A01,083765,Tran; Brian Kha,4,0,30,26
1656868139062,MATH 20D,A02,083766,Tran; Brian Kha,4,0,30,26
1656868139062,MATH 20D,A03,083767,Tran; Brian Kha,2,0,30,28
1656868145094,MATH 20E,A01,083771,Ganguly; Soumya,5,0,32,27
1656868145094,MATH 20E,A02,083772,Ganguly; Soumya,6,0,32,26
1656868145094,MATH 20E,B01,083773,Ciotti; Benjamin,18,0,35,17
1656868145094,MATH 20E,B02,083774,Ciotti; Benjamin,17,0,35,18
1656868151122,MATH 103A,A01,083777,Greenfeld; Be'Eri,2,0,36,34
1656868151122,MATH 103A,A02,083778,Greenfeld; Be'Eri,5,0,36,31
1656868151122,MATH 103A,A03,093561,Greenfeld; Be'Eri,4,0,36,32
1656868151122,MATH 103A,B01,083779,Greenfeld; Be'Eri,6,0,36,30
1656868151122,MATH 103A,B02,083780,Greenfeld; Be'Eri,2,0,36,34
1656868151122,MATH 103A,B03,093562,Greenfeld; Be'Eri,2,0,36,34
1656868157152,MATH 105,A01,085443,Carter; Anne Toulson,13,0,35,22
1656868157152,MATH 105,A02,093477,Carter; Anne Toulson,20,0,35,15
1656868163182,MATH 109,A01,083213,Ganzberger; Geoffrey Michael,2,0,34,32
1656868163182,MATH 109,A02,083214,Ganzberger; Geoffrey Michael,2,0,34,32
1656868163182,MATH 109,A03,093478,Ganzberger; Geoffrey Michael,1,0,34,33
1656868163182,MATH 109,B01,083215,Ganzberger; Geoffrey Michael,1,0,32,31
1656868163182,MATH 109,B02,083216,Ganzberger; Geoffrey Michael,1,0,32,31
1656868163182,MATH 109,B03,093479,Ganzberger; Geoffrey Michael,6,0,32,26
1656868169207,MATH 142A,A01,083219,Chow; Bennett,6,0,32,26
1656868169207,MATH 142A,A02,083220,Chow; Bennett,9,0,32,23
1656868169207,MATH 142A,A03,093480,Chow; Bennett,7,0,32,25
1656868169207,MATH 142A,B03,093481,Chow; Bennett,7,0,32,25
1656868169207,MATH 142A,B04,093558,Chow; Bennett,10,0,32,22
1656868169207,MATH 142A,B05,093559,Chow; Bennett,6,0,32,26
1656868175239,MATH 193A,A01,083224,Rotar; Vladimir,6,0,34,28
1656868175239,MATH 193A,A02,083225,Rotar; Vladimir,3,0,34,31
1656868175239,MATH 193A,A03,083781,Rotar; Vladimir,1,0,34,33
1656868175239,MATH 193A,A04,083782,Rotar; Vladimir,6,0,34,28
1656868175239,MATH 193A,A05,093482,Rotar; Vladimir,6,0,34,28
1656868181262,MATH 197,001,091859,McAuley; Julian John,9999,0,9999,0
1656868181262,MATH 197,002,095566,Kedlaya; Kiran S.,9997,0,9999,2
1656868181262,MATH 197,003,095567,Xiao; Ming,9999,0,9999,0
1656868181262,MATH 197,004,095571,Perols; Johan Lars,9998,0,9999,1
1656868188323,COGS 9,A01,083615,Shannon; Kyle Michael,6,0,75,69
1656868194351,COGS 11,A01,083617,Boyle; Mary E. T.,18,0,48,30
1656868200376,COGS 13,A01,083071,Bastos; Amalia Pinkusfeld,8,0,71,63
1656868206398,COGS 14A,A01,092681,Semenuks; Arturs,0,1,100,100
1656868212434,COGS 14B,A01,083073,Cheng; Tzu-Han,5,0,63,58
1656868218466,COGS 17,A01,092677,Semenuks; Arturs,4,0,81,77
1656868224489,COGS 100,A01,083619,Allen; Michael Gordon,15,0,70,55
1656868230524,COGS 101A,A01,083621,Davis; Joshua Daniel,9,0,68,59
1656868236552,COGS 101B,A01,091572,Allen; Michael Gordon,8,0,65,57
1656868242589,COGS 101C,A01,083625,Delgado; Tania,17,0,35,18
1656868248616,COGS 107A,A01,083627,Boyle; Mary E. T.,13,0,60,47
1656868254643,COGS 118A,A01,083075,Gupta; Anjum,15,0,76,61
1656868260668,CSE 3,A50,083646,Miranda; Gregory Joseph,22,0,50,28
1656868266710,CSE 8A,A50,083650,Miranda; Gregory Joseph,17,1,56,39
1656868272736,CSE 11,A01,083080,Cao; Yingjun,4,15,40,36
1656868278762,CSE 12,A01,083652,Krause-Levy; Sophia Louisa,20,1,120,100
1656868284785,CSE 15L,A01,083654,Morris; Justin Loren,8,0,50,42
1656868284785,CSE 15L,A02,083655,Morris; Justin Loren,8,0,50,42
1656868290809,CSE 20,A01,083657,Tran; Khoa Dang,37,0,80,43
1656868296836,CSE 21,A01,095574,Bach; Quang Tran,21,0,48,27
1656868302864,CSE 30,A01,083084,Eldon; John,4,0,80,76
1656868302864,CSE 30,B01,095061,Bhaskar; Nishant,6,0,50,44
1656868308888,CSE 100,A01,083659,Cao; Yingjun,2,4,70,68
1656868314916,CSE 134B,A01,083661,Powell; Thomas Allan,19,0,100,81
1656868320944,CSE 140,A01,083663,Gungor; Onat,14,0,85,71
1656868326967,CSE 140L,A01,083088,Eldon; John,16,0,100,84
1656868332993,CSE 175,A01,083665,Kumar; Rakesh,3,0,25,22
1656868339016,CSE 190,A00,092507,Dubnov; Shlomo,7,0,20,13
1656868345045,ECE 45,A01,083139,Congero; Spencer William,5,0,75,70
1656868351068,ECE 65,A50,083695,Saad; Andrew S,12,0,30,18
1656868351068,ECE 65,A51,095125,Saad; Andrew S,25,0,26,1
1656868357091,ECE 109,A01,091882,Touri; Behrouz,16,0,70,54
1656868363115,ECE 180,A00,083140,Abi Samra; Nicholas Camill,0,0,30,30
1656868363115,ECE 180,B00,083141,Abi Samra; Nicholas Camill,0,0,30,30
1656868369142,MATH 10A,A01,083735,Patchell; Gregory David,1,0,30,29
1656868369142,MATH 10A,A02,083736,Patchell; Gregory David,20,0,30,10
1656868369142,MATH 10A,A03,083737,Patchell; Gregory David,15,0,30,15
1656868375166,MATH 10B,A01,083207,Lim; Seonhee,7,0,34,27
1656868375166,MATH 10B,A02,083208,Lim; Seonhee,9,0,35,26
1656868375166,MATH 10B,A03,093472,Lim; Seonhee,4,0,34,30
1656868375166,MATH 10B,B01,083739,Sinha; Shubham,9,0,30,21
1656868381198,MATH 18,A01,083743,Cinel; Cameron Alexander,6,0,30,24
1656868381198,MATH 18,A02,083744,Cinel; Cameron Alexander,15,0,30,15
1656868381198,MATH 18,A03,083745,Cinel; Cameron Alexander,8,0,30,22
1656868381198,MATH 18,B01,083748,Rideout; David Porter,3,0,37,34
1656868381198,MATH 18,B02,083749,Rideout; David Porter,3,0,36,33
1656868381198,MATH 18,B03,083750,Rideout; David Porter,2,0,37,35
1656868381198,MATH 18,B04,083751,Rideout; David Porter,5,0,36,31
1656868381198,MATH 18,B05,093473,Rideout; David Porter,4,0,36,32
1656868381198,MATH 18,B06,093474,Rideout; David Porter,5,0,36,31
1656868387222,MATH 20A,A01,083754,Zheng; Zequn,12,0,40,28
1656868393259,MATH 20B,A01,083756,Briones; Jor-el Thomas Caparas,1,0,36,35
1656868393259,MATH 20B,A02,083757,Briones; Jor-el Thomas Caparas,1,0,36,35
1656868393259,MATH 20B,A03,093475,Briones; Jor-el Thomas Caparas,0,0,36,36
1656868399296,MATH 20C,A01,083760,Briones; Jor-el Thomas Caparas,1,0,35,34
1656868399296,MATH 20C,A02,083761,Briones; Jor-el Thomas Caparas,8,0,35,27
1656868399296,MATH 20C,A03,093476,Briones; Jor-el Thomas Caparas,0,1,36,36
1656868399296,MATH 20C,B01,083762,Bach; Quang Tran,0,0,30,30
1656868405320,MATH 20D,A01,083765,Tran; Brian Kha,4,0,30,26
1656868405320,MATH 20D,A02,083766,Tran; Brian Kha,4,0,30,26
1656868405320,MATH 20D,A03,083767,Tran; Brian Kha,2,0,30,28
1656868411348,MATH 20E,A01,083771,Ganguly; Soumya,5,0,32,27
1656868411348,MATH 20E,A02,083772,Ganguly; Soumya,6,0,32,26
1656868411348,MATH 20E,B01,083773,Ciotti; Benjamin,18,0,35,17
1656868411348,MATH 20E,B02,083774,Ciotti; Benjamin,17,0,35,18
1656868417377,MATH 103A,A01,083777,Greenfeld; Be'Eri,2,0,36,34
1656868417377,MATH 103A,A02,083778,Greenfeld; Be'Eri,5,0,36,31
1656868417377,MATH 103A,A03,093561,Greenfeld; Be'Eri,4,0,36,32
1656868417377,MATH 103A,B01,083779,Greenfeld; Be'Eri,6,0,36,30
1656868417377,MATH 103A,B02,083780,Greenfeld; Be'Eri,2,0,36,34
1656868417377,MATH 103A,B03,093562,Greenfeld; Be'Eri,2,0,36,34
1656868423406,MATH 105,A01,085443,Carter; Anne Toulson,13,0,35,22
1656868423406,MATH 105,A02,093477,Carter; Anne Toulson,20,0,35,15
1656868429436,MATH 109,A01,083213,Ganzberger; Geoffrey Michael,2,0,34,32
1656868429436,MATH 109,A02,083214,Ganzberger; Geoffrey Michael,2,0,34,32
1656868429436,MATH 109,A03,093478,Ganzberger; Geoffrey Michael,1,0,34,33
1656868429436,MATH 109,B01,083215,Ganzberger; Geoffrey Michael,1,0,32,31
1656868429436,MATH 109,B02,083216,Ganzberger; Geoffrey Michael,1,0,32,31
1656868429436,MATH 109,B03,093479,Ganzberger; Geoffrey Michael,6,0,32,26
1656868435459,MATH 142A,A01,083219,Chow; Bennett,6,0,32,26
1656868435459,MATH 142A,A02,083220,Chow; Bennett,9,0,32,23
1656868435459,MATH 142A,A03,093480,Chow; Bennett,7,0,32,25
1656868435459,MATH 142A,B03,093481,Chow; Bennett,7,0,32,25
1656868435459,MATH 142A,B04,093558,Chow; Bennett,10,0,32,22
1656868435459,MATH 142A,B05,093559,Chow; Bennett,6,0,32,26
1656868441482,MATH 193A,A01,083224,Rotar; Vladimir,6,0,34,28
1656868441482,MATH 193A,A02,083225,Rotar; Vladimir,3,0,34,31
1656868441482,MATH 193A,A03,083781,Rotar; Vladimir,1,0,34,33
1656868441482,MATH 193A,A04,083782,Rotar; Vladimir,6,0,34,28
1656868441482,MATH 193A,A05,093482,Rotar; Vladimir,6,0,34,28
1656868447509,MATH 197,001,091859,McAuley; Julian John,9999,0,9999,0
1656868447509,MATH 197,002,095566,Kedlaya; Kiran S.,9997,0,9999,2
1656868447509,MATH 197,003,095567,Xiao; Ming,9999,0,9999,0
1656868447509,MATH 197,004,095571,Perols; Johan Lars,9998,0,9999,1
1656868454570,COGS 9,A01,083615,Shannon; Kyle Michael,6,0,75,69
1656868460598,COGS 11,A01,083617,Boyle; Mary E. T.,18,0,48,30
1656868466621,COGS 13,A01,083071,Bastos; Amalia Pinkusfeld,8,0,71,63
1656868472644,COGS 14A,A01,092681,Semenuks; Arturs,0,1,100,100
1656868478668,COGS 14B,A01,083073,Cheng; Tzu-Han,5,0,63,58
1656868484691,COGS 17,A01,092677,Semenuks; Arturs,4,0,81,77
1656868490714,COGS 100,A01,083619,Allen; Michael Gordon,15,0,70,55
1656868496738,COGS 101A,A01,083621,Davis; Joshua Daniel,9,0,68,59
1656868502763,COGS 101B,A01,091572,Allen; Michael Gordon,8,0,65,57
1656868508786,COGS 101C,A01,083625,Delgado; Tania,17,0,35,18
1656868514809,COGS 107A,A01,083627,Boyle; Mary E. T.,13,0,60,47
1656868520834,COGS 118A,A01,083075,Gupta; Anjum,15,0,76,61
1656868526861,CSE 3,A50,083646,Miranda; Gregory Joseph,22,0,50,28
1656868532884,CSE 8A,A50,083650,Miranda; Gregory Joseph,17,1,56,39
1656868538910,CSE 11,A01,083080,Cao; Yingjun,4,15,40,36
1656868544935,CSE 12,A01,083652,Krause-Levy; Sophia Louisa,20,1,120,100
1656868550963,CSE 15L,A01,083654,Morris; Justin Loren,8,0,50,42
1656868550963,CSE 15L,A02,083655,Morris; Justin Loren,8,0,50,42
1656868556988,CSE 20,A01,083657,Tran; Khoa Dang,37,0,80,43
1656868563010,CSE 21,A01,095574,Bach; Quang Tran,21,0,48,27
1656868569033,CSE 30,A01,083084,Eldon; John,4,0,80,76
1656868569033,CSE 30,B01,095061,Bhaskar; Nishant,6,0,50,44
1656868575056,CSE 100,A01,083659,Cao; Yingjun,2,4,70,68
1656868581080,CSE 134B,A01,083661,Powell; Thomas Allan,19,0,100,81
1656868587106,CSE 140,A01,083663,Gungor; Onat,14,0,85,71
1656868593130,CSE 140L,A01,083088,Eldon; John,16,0,100,84
1656868599154,CSE 175,A01,083665,Kumar; Rakesh,3,0,25,22
1656868605179,CSE 190,A00,092507,Dubnov; Shlomo,7,0,20,13
1656868611203,ECE 45,A01,083139,Congero; Spencer William,5,0,75,70
1656868617227,ECE 65,A50,083695,Saad; Andrew S,12,0,30,18
1656868617227,ECE 65,A51,095125,Saad; Andrew S,25,0,26,1
1656868623253,ECE 109,A01,091882,Touri; Behrouz,16,0,70,54
1656868629277,ECE 180,A00,083140,Abi Samra; Nicholas Camill,0,0,30,30
1656868629277,ECE 180,B00,083141,Abi Samra; Nicholas Camill,0,0,30,30
1656868635300,MATH 10A,A01,083735,Patchell; Gregory David,1,0,30,29
1656868635300,MATH 10A,A02,083736,Patchell; Gregory David,20,0,30,10
1656868635300,MATH 10A,A03,083737,Patchell; Gregory David,15,0,30,15
1656868641324,MATH 10B,A01,083207,Lim; Seonhee,7,0,34,27
1656868641324,MATH 10B,A02,083208,Lim; Seonhee,9,0,35,26
1656868641324,MATH 10B,A03,093472,Lim; Seonhee,4,0,34,30
1656868641324,MATH 10B,B01,083739,Sinha; Shubham,9,0,30,21
1656868647425,MATH 18,A01,083743,Cinel; Cameron Alexander,6,0,30,24
1656868647425,MATH 18,A02,083744,Cinel; Cameron Alexander,15,0,30,15
1656868647425,MATH 18,A03,083745,Cinel; Cameron Alexander,8,0,30,22
1656868647425,MATH 18,B01,083748,Rideout; David Porter,3,0,37,34
1656868647425,MATH 18,B02,083749,Rideout; David Porter,3,0,36,33
1656868647425,MATH 18,B03,083750,Rideout; David Porter,2,0,37,35
1656868647425,MATH 18,B04,083751,Rideout; David Porter,5,0,36,31
1656868647425,MATH 18,B05,093473,Rideout; David Porter,4,0,36,32
1656868647425,MATH 18,B06,093474,Rideout; David Porter,5,0,36,31
1656868653448,MATH 20A,A01,083754,Zheng; Zequn,12,0,40,28
1656868659476,MATH 20B,A01,083756,Briones; Jor-el Thomas Caparas,1,0,36,35
1656868659476,MATH 20B,A02,083757,Briones; Jor-el Thomas Caparas,1,0,36,35
1656868659476,MATH 20B,A03,093475,Briones; Jor-el Thomas Caparas,0,0,36,36
1656868665501,MATH 20C,A01,083760,Briones; Jor-el Thomas Caparas,1,0,35,34
1656868665501,MATH 20C,A02,083761,Briones; Jor-el Thomas Caparas,8,0,35,27
1656868665501,MATH 20C,A03,093476,Briones; Jor-el Thomas Caparas,0,1,36,36
1656868665501,MATH 20C,B01,083762,Bach; Quang Tran,0,0,30,30
1656868671530,MATH 20D,A01,083765,Tran; Brian Kha,4,0,30,26
1656868671530,MATH 20D,A02,083766,Tran; Brian Kha,4,0,30,26
1656868671530,MATH 20D,A03,083767,Tran; Brian Kha,2,0,30,28
1656868677554,MATH 20E,A01,083771,Ganguly; Soumya,5,0,32,27
1656868677554,MATH 20E,A02,083772,Ganguly; Soumya,6,0,32,26
1656868677554,MATH 20E,B01,083773,Ciotti; Benjamin,18,0,35,17
1656868677554,MATH 20E,B02,083774,Ciotti; Benjamin,17,0,35,18
1656868683586,MATH 103A,A01,083777,Greenfeld; Be'Eri,2,0,36,34
1656868683586,MATH 103A,A02,083778,Greenfeld; Be'Eri,5,0,36,31
1656868683586,MATH 103A,A03,093561,Greenfeld; Be'Eri,4,0,36,32
1656868683586,MATH 103A,B01,083779,Greenfeld; Be'Eri,6,0,36,30
1656868683586,MATH 103A,B02,083780,Greenfeld; Be'Eri,2,0,36,34
1656868683586,MATH 103A,B03,093562,Greenfeld; Be'Eri,2,0,36,34
1656868689615,MATH 105,A01,085443,Carter; Anne Toulson,13,0,35,22
1656868689615,MATH 105,A02,093477,Carter; Anne Toulson,20,0,35,15
1656868695639,MATH 109,A01,083213,Ganzberger; Geoffrey Michael,2,0,34,32
1656868695639,MATH 109,A02,083214,Ganzberger; Geoffrey Michael,2,0,34,32
1656868695639,MATH 109,A03,093478,Ganzberger; Geoffrey Michael,1,0,34,33
1656868695639,MATH 109,B01,083215,Ganzberger; Geoffrey Michael,1,0,32,31
1656868695639,MATH 109,B02,083216,Ganzberger; Geoffrey Michael,1,0,32,31
1656868695639,MATH 109,B03,093479,Ganzberger; Geoffrey Michael,6,0,32,26
1656868701675,MATH 142A,A01,083219,Chow; Bennett,6,0,32,26
1656868701675,MATH 142A,A02,083220,Chow; Bennett,9,0,32,23
1656868701675,MATH 142A,A03,093480,Chow; Bennett,7,0,32,25
1656868701675,MATH 142A,B03,093481,Chow; Bennett,7,0,32,25
1656868701675,MATH 142A,B04,093558,Chow; Bennett,10,0,32,22
1656868701675,MATH 142A,B05,093559,Chow; Bennett,6,0,32,26
1656868707698,MATH 193A,A01,083224,Rotar; Vladimir,6,0,34,28
1656868707698,MATH 193A,A02,083225,Rotar; Vladimir,3,0,34,31
1656868707698,MATH 193A,A03,083781,Rotar; Vladimir,1,0,34,33
1656868707698,MATH 193A,A04,083782,Rotar; Vladimir,6,0,34,28
1656868707698,MATH 193A,A05,093482,Rotar; Vladimir,6,0,34,28
1656868713724,MATH 197,001,091859,McAuley; Julian John,9999,0,9999,0
1656868713724,MATH 197,002,095566,Kedlaya; Kiran S.,9997,0,9999,2
1656868713724,MATH 197,003,095567,Xiao; Ming,9999,0,9999,0
1656868713724,MATH 197,004,095571,Perols; Johan Lars,9998,0,9999,1
1656868720785,COGS 9,A01,083615,Shannon; Kyle Michael,6,0,75,69
1656868726810,COGS 11,A01,083617,Boyle; Mary E. T.,18,0,48,30
1656868732835,COGS 13,A01,083071,Bastos; Amalia Pinkusfeld,8,0,71,63
1656868738864,COGS 14A,A01,092681,Semenuks; Arturs,0,1,100,100
1656868744889,COGS 14B,A01,083073,Cheng; Tzu-Han,5,0,63,58
1656868750916,COGS 17,A01,092677,Semenuks; Arturs,4,0,81,77
1656868756944,COGS 100,A01,083619,Allen; Michael Gordon,15,0,70,55
1656868762969,COGS 101A,A01,083621,Davis; Joshua Daniel,9,0,68,59
1656868768999,COGS 101B,A01,091572,Allen; Michael Gordon,8,0,65,57
1656868775024,COGS 101C,A01,083625,Delgado; Tania,17,0,35,18
1656868781049,COGS 107A,A01,083627,Boyle; Mary E. T.,13,0,60,47
1656868787073,COGS 118A,A01,083075,Gupta; Anjum,15,0,76,61
1656868793102,CSE 3,A50,083646,Miranda; Gregory Joseph,22,0,50,28
1656868799132,CSE 8A,A50,083650,Miranda; Gregory Joseph,17,1,56,39
1656868805160,CSE 11,A01,083080,Cao; Yingjun,4,15,40,36
1656868811186,CSE 12,A01,083652,Krause-Levy; Sophia Louisa,20,1,120,100
1656868817209,CSE 15L,A01,083654,Morris; Justin Loren,8,0,50,42
1656868817209,CSE 15L,A02,083655,Morris; Justin Loren,8,0,50,42
1656868823232,CSE 20,A01,083657,Tran; Khoa Dang,37,0,80,43
1656868829256,CSE 21,A01,095574,Bach; Quang Tran,21,0,48,27
1656868835284,CSE 30,A01,083084,Eldon; John,4,0,80,76
1656868835284,CSE 30,B01,095061,Bhaskar; Nishant,6,0,50,44
1656868841308,CSE 100,A01,083659,Cao; Yingjun,2,4,70,68
1656868847329,CSE 134B,A01,083661,Powell; Thomas Allan,19,0,100,81
1656868853351,CSE 140,A01,083663,Gungor; Onat,14,0,85,71
1656868859380,CSE 140L,A01,083088,Eldon; John,16,0,100,84
1656868865413,CSE 175,A01,083665,Kumar; Rakesh,3,0,25,22
1656868871435,CSE 190,A00,092507,Dubnov; Shlomo,7,0,20,13
1656868877463,ECE 45,A01,083139,Congero; Spencer William,5,0,75,70
1656868883490,ECE 65,A50,083695,Saad; Andrew S,12,0,30,18
1656868883490,ECE 65,A51,095125,Saad; Andrew S,25,0,26,1
1656868889526,ECE 109,A01,091882,Touri; Behrouz,16,0,70,54
1656868895553,ECE 180,A00,083140,Abi Samra; Nicholas Camill,0,0,30,30
1656868895553,ECE 180,B00,083141,Abi Samra; Nicholas Camill,0,0,30,30
1656868901577,MATH 10A,A01,083735,Patchell; Gregory David,1,0,30,29
1656868901577,MATH 10A,A02,083736,Patchell; Gregory David,20,0,30,10
1656868901577,MATH 10A,A03,083737,Patchell; Gregory David,15,0,30,15
1656868907602,MATH 10B,A01,083207,Lim; Seonhee,7,0,34,27
1656868907602,MATH 10B,A02,083208,Lim; Seonhee,9,0,35,26
1656868907602,MATH 10B,A03,093472,Lim; Seonhee,4,0,34,30
1656868907602,MATH 10B,B01,083739,Sinha; Shubham,9,0,30,21
1656868913634,MATH 18,A01,083743,Cinel; Cameron Alexander,6,0,30,24
1656868913634,MATH 18,A02,083744,Cinel; Cameron Alexander,15,0,30,15
1656868913634,MATH 18,A03,083745,Cinel; Cameron Alexander,8,0,30,22
1656868913634,MATH 18,B01,083748,Rideout; David Porter,3,0,37,34
1656868913634,MATH 18,B02,083749,Rideout; David Porter,3,0,36,33
1656868913634,MATH 18,B03,083750,Rideout; David Porter,2,0,37,35
1656868913634,MATH 18,B04,083751,Rideout; David Porter,5,0,36,31
1656868913634,MATH 18,B05,093473,Rideout; David Porter,4,0,36,32
1656868913634,MATH 18,B06,093474,Rideout; David Porter,5,0,36,31
1656868919657,MATH 20A,A01,083754,Zheng; Zequn,12,0,40,28
1656868925685,MATH 20B,A01,083756,Briones; Jor-el Thomas Caparas,1,0,36,35
1656868925685,MATH 20B,A02,083757,Briones; Jor-el Thomas Caparas,1,0,36,35
1656868925685,MATH 20B,A03,093475,Briones; Jor-el Thomas Caparas,0,0,36,36
1656868931711,MATH 20C,A01,083760,Briones; Jor-el Thomas Caparas,1,0,35,34
1656868931711,MATH 20C,A02,083761,Briones; Jor-el Thomas Caparas,8,0,35,27
1656868931711,MATH 20C,A03,093476,Briones; Jor-el Thomas Caparas,0,1,36,36
1656868931711,MATH 20C,B01,083762,Bach; Quang Tran,0,0,30,30
1656868937735,MATH 20D,A01,083765,Tran; Brian Kha,4,0,30,26
1656868937735,MATH 20D,A02,083766,Tran; Brian Kha,4,0,30,26
1656868937735,MATH 20D,A03,083767,Tran; Brian Kha,2,0,30,28
1656868943765,MATH 20E,A01,083771,Ganguly; Soumya,5,0,32,27
1656868943765,MATH 20E,A02,083772,Ganguly; Soumya,6,0,32,26
1656868943765,MATH 20E,B01,083773,Ciotti; Benjamin,18,0,35,17
1656868943765,MATH 20E,B02,083774,Ciotti; Benjamin,17,0,35,18
1656868949808,MATH 103A,A01,083777,Greenfeld; Be'Eri,2,0,36,34
1656868949808,MATH 103A,A02,083778,Greenfeld; Be'Eri,5,0,36,31
1656868949808,MATH 103A,A03,093561,Greenfeld; Be'Eri,4,0,36,32
1656868949808,MATH 103A,B01,083779,Greenfeld; Be'Eri,6,0,36,30
1656868949808,MATH 103A,B02,083780,Greenfeld; Be'Eri,2,0,36,34
1656868949808,MATH 103A,B03,093562,Greenfeld; Be'Eri,2,0,36,34
1656868955836,MATH 105,A01,085443,Carter; Anne Toulson,13,0,35,22
1656868955836,MATH 105,A02,093477,Carter; Anne Toulson,20,0,35,15
1656868961858,MATH 109,A01,083213,Ganzberger; Geoffrey Michael,2,0,34,32
1656868961858,MATH 109,A02,083214,Ganzberger; Geoffrey Michael,2,0,34,32
1656868961858,MATH 109,A03,093478,Ganzberger; Geoffrey Michael,1,0,34,33
1656868961858,MATH 109,B01,083215,Ganzberger; Geoffrey Michael,1,0,32,31
1656868961858,MATH 109,B02,083216,Ganzberger; Geoffrey Michael,1,0,32,31
1656868961858,MATH 109,B03,093479,Ganzberger; Geoffrey Michael,6,0,32,26
1656868967882,MATH 142A,A01,083219,Chow; Bennett,6,0,32,26
1656868967882,MATH 142A,A02,083220,Chow; Bennett,9,0,32,23
1656868967882,MATH 142A,A03,093480,Chow; Bennett,7,0,32,25
1656868967882,MATH 142A,B03,093481,Chow; Bennett,7,0,32,25
1656868967882,MATH 142A,B04,093558,Chow; Bennett,10,0,32,22
1656868967882,MATH 142A,B05,093559,Chow; Bennett,6,0,32,26
1656868973905,MATH 193A,A01,083224,Rotar; Vladimir,6,0,34,28
1656868973905,MATH 193A,A02,083225,Rotar; Vladimir,3,0,34,31
1656868973905,MATH 193A,A03,083781,Rotar; Vladimir,1,0,34,33
1656868973905,MATH 193A,A04,083782,Rotar; Vladimir,6,0,34,28
1656868973905,MATH 193A,A05,093482,Rotar; Vladimir,6,0,34,28
1656868979933,MATH 197,001,091859,McAuley; Julian John,9999,0,9999,0
1656868979933,MATH 197,002,095566,Kedlaya; Kiran S.,9997,0,9999,2
1656868979933,MATH 197,003,095567,Xiao; Ming,9999,0,9999,0
1656868979933,MATH 197,004,095571,Perols; Johan Lars,9998,0,9999,1
1656868986997,COGS 9,A01,083615,Shannon; Kyle Michael,6,0,75,69
1656868993025,COGS 11,A01,083617,Boyle; Mary E. T.,18,0,48,30
1656868999049,COGS 13,A01,083071,Bastos; Amalia Pinkusfeld,8,0,71,63
1656869005072,COGS 14A,A01,092681,Semenuks; Arturs,0,1,100,100
1656869011100,COGS 14B,A01,083073,Cheng; Tzu-Han,5,0,63,58
1656869017126,COGS 17,A01,092677,Semenuks; Arturs,4,0,81,77
1656869023151,COGS 100,A01,083619,Allen; Michael Gordon,15,0,70,55
1656869029176,COGS 101A,A01,083621,Davis; Joshua Daniel,9,0,68,59
1656869035202,COGS 101B,A01,091572,Allen; Michael Gordon,8,0,65,57
1656869041228,COGS 101C,A01,083625,Delgado; Tania,17,0,35,18
1656869047255,COGS 107A,A01,083627,Boyle; Mary E. T.,13,0,60,47
1656869053279,COGS 118A,A01,083075,Gupta; Anjum,15,0,76,61
1656869059302,CSE 3,A50,083646,Miranda; Gregory Joseph,22,0,50,28
1656869065326,CSE 8A,A50,083650,Miranda; Gregory Joseph,17,1,56,39
1656869071361,CSE 11,A01,083080,Cao; Yingjun,4,15,40,36
1656869077385,CSE 12,A01,083652,Krause-Levy; Sophia Louisa,20,1,120,100
1656869083410,CSE 15L,A01,083654,Morris; Justin Loren,8,0,50,42
1656869083410,CSE 15L,A02,083655,Morris; Justin Loren,8,0,50,42
1656869089433,CSE 20,A01,083657,Tran; Khoa Dang,37,0,80,43
1656869095457,CSE 21,A01,095574,Bach; Quang Tran,21,0,48,27
1656869101485,CSE 30,A01,083084,Eldon; John,4,0,80,76
1656869101485,CSE 30,B01,095061,Bhaskar; Nishant,6,0,50,44
1656869107508,CSE 100,A01,083659,Cao; Yingjun,2,4,70,68
1656869113538,CSE 134B,A01,083661,Powell; Thomas Allan,19,0,100,81
1656869119561,CSE 140,A01,083663,Gungor; Onat,14,0,85,71
1656869125587,CSE 140L,A01,083088,Eldon; John,16,0,100,84
1656869131611,CSE 175,A01,083665,Kumar; Rakesh,3,0,25,22
1656869137637,CSE 190,A00,092507,Dubnov; Shlomo,7,0,20,13
1656869143659,ECE 45,A01,083139,Congero; Spencer William,5,0,75,70
1656869149683,ECE 65,A50,083695,Saad; Andrew S,12,0,30,18
1656869149683,ECE 65,A51,095125,Saad; Andrew S,25,0,26,1
1656869155705,ECE 109,A01,091882,Touri; Behrouz,16,0,70,54
1656869161730,ECE 180,A00,083140,Abi Samra; Nicholas Camill,0,0,30,30
1656869161730,ECE 180,B00,083141,Abi Samra; Nicholas Camill,0,0,30,30
1656869167751,MATH 10A,A01,083735,Patchell; Gregory David,1,0,30,29
1656869167751,MATH 10A,A02,083736,Patchell; Gregory David,20,0,30,10
1656869167751,MATH 10A,A03,083737,Patchell; Gregory David,15,0,30,15
1656869173774,MATH 10B,A01,083207,Lim; Seonhee,7,0,34,27
1656869173774,MATH 10B,A02,083208,Lim; Seonhee,9,0,35,26
1656869173774,MATH 10B,A03,093472,Lim; Seonhee,4,0,34,30
1656869173774,MATH 10B,B01,083739,Sinha; Shubham,9,0,30,21
1656869179798,MATH 18,A01,083743,Cinel; Cameron Alexander,6,0,30,24
1656869179798,MATH 18,A02,083744,Cinel; Cameron Alexander,15,0,30,15
1656869179798,MATH 18,A03,083745,Cinel; Cameron Alexander,8,0,30,22
1656869179798,MATH 18,B01,083748,Rideout; David Porter,3,0,37,34
1656869179798,MATH 18,B02,083749,Rideout; David Porter,3,0,36,33
1656869179798,MATH 18,B03,083750,Rideout; David Porter,2,0,37,35
1656869179798,MATH 18,B04,083751,Rideout; David Porter,5,0,36,31
1656869179798,MATH 18,B05,093473,Rideout; David Porter,4,0,36,32
1656869179798,MATH 18,B06,093474,Rideout; David Porter,5,0,36,31
1656869185822,MATH 20A,A01,083754,Zheng; Zequn,12,0,40,28
1656869191849,MATH 20B,A01,083756,Briones; Jor-el Thomas Caparas,1,0,36,35
1656869191849,MATH 20B,A02,083757,Briones; Jor-el Thomas Caparas,1,0,36,35
1656869191849,MATH 20B,A03,093475,Briones; Jor-el Thomas Caparas,0,0,36,36
1656869197876,MATH 20C,A01,083760,Briones; Jor-el Thomas Caparas,1,0,35,34
1656869197876,MATH 20C,A02,083761,Briones; Jor-el Thomas Caparas,8,0,35,27
1656869197876,MATH 20C,A03,093476,Briones; Jor-el Thomas Caparas,0,1,36,36
1656869197876,MATH 20C,B01,083762,Bach; Quang Tran,0,0,30,30
1656869203901,MATH 20D,A01,083765,Tran; Brian Kha,4,0,30,26
1656869203901,MATH 20D,A02,083766,Tran; Brian Kha,4,0,30,26
1656869203901,MATH 20D,A03,083767,Tran; Brian Kha,2,0,30,28
1656869209939,MATH 20E,A01,083771,Ganguly; Soumya,5,0,32,27
1656869209939,MATH 20E,A02,083772,Ganguly; Soumya,6,0,32,26
1656869209939,MATH 20E,B01,083773,Ciotti; Benjamin,18,0,35,17
1656869209939,MATH 20E,B02,083774,Ciotti; Benjamin,17,0,35,18
1656869215964,MATH 103A,A01,083777,Greenfeld; Be'Eri,2,0,36,34
1656869215964,MATH 103A,A02,083778,Greenfeld; Be'Eri,5,0,36,31
1656869215964,MATH 103A,A03,093561,Greenfeld; Be'Eri,4,0,36,32
1656869215964,MATH 103A,B01,083779,Greenfeld; Be'Eri,6,0,36,30
1656869215964,MATH 103A,B02,083780,Greenfeld; Be'Eri,2,0,36,34
1656869215964,MATH 103A,B03,093562,Greenfeld; Be'Eri,2,0,36,34
1656869221992,MATH 105,A01,085443,Carter; Anne Toulson,13,0,35,22
1656869221992,MATH 105,A02,093477,Carter; Anne Toulson,20,0,35,15
1656869228018,MATH 109,A01,083213,Ganzberger; Geoffrey Michael,2,0,34,32
1656869228018,MATH 109,A02,083214,Ganzberger; Geoffrey Michael,2,0,34,32
1656869228018,MATH 109,A03,093478,Ganzberger; Geoffrey Michael,1,0,34,33
1656869228018,MATH 109,B01,083215,Ganzberger; Geoffrey Michael,1,0,32,31
1656869228018,MATH 109,B02,083216,Ganzberger; Geoffrey Michael,1,0,32,31
1656869228018,MATH 109,B03,093479,Ganzberger; Geoffrey Michael,6,0,32,26
1656869234054,MATH 142A,A01,083219,Chow; Bennett,6,0,32,26
1656869234054,MATH 142A,A02,083220,Chow; Bennett,9,0,32,23
1656869234054,MATH 142A,A03,093480,Chow; Bennett,7,0,32,25
1656869234054,MATH 142A,B03,093481,Chow; Bennett,7,0,32,25
1656869234054,MATH 142A,B04,093558,Chow; Bennett,10,0,32,22
1656869234054,MATH 142A,B05,093559,Chow; Bennett,6,0,32,26
1656869240090,MATH 193A,A01,083224,Rotar; Vladimir,6,0,34,28
1656869240090,MATH 193A,A02,083225,Rotar; Vladimir,3,0,34,31
1656869240090,MATH 193A,A03,083781,Rotar; Vladimir,1,0,34,33
1656869240090,MATH 193A,A04,083782,Rotar; Vladimir,6,0,34,28
1656869240090,MATH 193A,A05,093482,Rotar; Vladimir,6,0,34,28
1656869246185,MATH 197,001,091859,McAuley; Julian John,9999,0,9999,0
1656869246185,MATH 197,002,095566,Kedlaya; Kiran S.,9997,0,9999,2
1656869246185,MATH 197,003,095567,Xiao; Ming,9999,0,9999,0
1656869246185,MATH 197,004,095571,Perols; Johan Lars,9998,0,9999,1
1656869253251,COGS 9,A01,083615,Shannon; Kyle Michael,6,0,75,69
1656869259275,COGS 11,A01,083617,Boyle; Mary E. T.,19,0,48,29
1656869265298,COGS 13,A01,083071,Bastos; Amalia Pinkusfeld,8,0,71,63
1656869271320,COGS 14A,A01,092681,Semenuks; Arturs,0,1,100,100
1656869277349,COGS 14B,A01,083073,Cheng; Tzu-Han,5,0,63,58
1656869283378,COGS 17,A01,092677,Semenuks; Arturs,4,0,81,77
1656869289401,COGS 100,A01,083619,Allen; Michael Gordon,15,0,70,55
1656869295429,COGS 101A,A01,083621,Davis; Joshua Daniel,9,0,68,59
1656869301452,COGS 101B,A01,091572,Allen; Michael Gordon,8,0,65,57
1656869307479,COGS 101C,A01,083625,Delgado; Tania,17,0,35,18
1656869313505,COGS 107A,A01,083627,Boyle; Mary E. T.,13,0,60,47
1656869319542,COGS 118A,A01,083075,Gupta; Anjum,15,0,76,61
1656869325571,CSE 3,A50,083646,Miranda; Gregory Joseph,22,0,50,28
1656869331598,CSE 8A,A50,083650,Miranda; Gregory Joseph,17,1,56,39
1656869337621,CSE 11,A01,083080,Cao; Yingjun,4,15,40,36
1656869343648,CSE 12,A01,083652,Krause-Levy; Sophia Louisa,20,1,120,100
1656869349682,CSE 15L,A01,083654,Morris; Justin Loren,8,0,50,42
1656869349682,CSE 15L,A02,083655,Morris; Justin Loren,8,0,50,42
1656869355709,CSE 20,A01,083657,Tran; Khoa Dang,37,0,80,43
1656869361732,CSE 21,A01,095574,Bach; Quang Tran,21,0,48,27
1656869367772,CSE 30,A01,083084,Eldon; John,4,0,80,76
1656869367772,CSE 30,B01,095061,Bhaskar; Nishant,6,0,50,44
1656869373796,CSE 100,A01,083659,Cao; Yingjun,2,4,70,68
1656869379818,CSE 134B,A01,083661,Powell; Thomas Allan,19,0,100,81
1656869385860,CSE 140,A01,083663,Gungor; Onat,14,0,85,71
1656869391883,CSE 140L,A01,083088,Eldon; John,16,0,100,84
1656869397910,CSE 175,A01,083665,Kumar; Rakesh,3,0,25,22
1656869403937,CSE 190,A00,092507,Dubnov; Shlomo,7,0,20,13
1656869409964,ECE 45,A01,083139,Congero; Spencer William,5,0,75,70
1656869415999,ECE 65,A50,083695,Saad; Andrew S,12,0,30,18
1656869415999,ECE 65,A51,095125,Saad; Andrew S,25,0,26,1
1656869422021,ECE 109,A01,091882,Touri; Behrouz,16,0,70,54
1656869428045,ECE 180,A00,083140,Abi Samra; Nicholas Camill,0,0,30,30
1656869428045,ECE 180,B00,083141,Abi Samra; Nicholas Camill,0,0,30,30
1656869434069,MATH 10A,A01,083735,Patchell; Gregory David,1,0,30,29
1656869434069,MATH 10A,A02,083736,Patchell; Gregory David,20,0,30,10
1656869434069,MATH 10A,A03,083737,Patchell; Gregory David,15,0,30,15
1656869440102,MATH 10B,A01,083207,Lim; Seonhee,7,0,34,27
1656869440102,MATH 10B,A02,083208,Lim; Seonhee,9,0,35,26
1656869440102,MATH 10B,A03,093472,Lim; Seonhee,4,0,34,30
1656869440102,MATH 10B,B01,083739,Sinha; Shubham,9,0,30,21
1656869446132,MATH 18,A01,083743,Cinel; Cameron Alexander,6,0,30,24
1656869446132,MATH 18,A02,083744,Cinel; Cameron Alexander,15,0,30,15
1656869446132,MATH 18,A03,083745,Cinel; Cameron Alexander,8,0,30,22
1656869446132,MATH 18,B01,083748,Rideout; David Porter,3,0,37,34
1656869446132,MATH 18,B02,083749,Rideout; David Porter,3,0,36,33
1656869446132,MATH 18,B03,083750,Rideout; David Porter,2,0,37,35
1656869446132,MATH 18,B04,083751,Rideout; David Porter,5,0,36,31
1656869446132,MATH 18,B05,093473,Rideout; David Porter,4,0,36,32
1656869446132,MATH 18,B06,093474,Rideout; David Porter,5,0,36,31
1656869452155,MATH 20A,A01,083754,Zheng; Zequn,12,0,40,28
1656869458183,MATH 20B,A01,083756,Briones; Jor-el Thomas Caparas,1,0,36,35
1656869458183,MATH 20B,A02,083757,Briones; Jor-el Thomas Caparas,1,0,36,35
1656869458183,MATH 20B,A03,093475,Briones; Jor-el Thomas Caparas,0,0,36,36
1656869464208,MATH 20C,A01,083760,Briones; Jor-el Thomas Caparas,1,0,35,34
1656869464208,MATH 20C,A02,083761,Briones; Jor-el Thomas Caparas,8,0,35,27
1656869464208,MATH 20C,A03,093476,Briones; Jor-el Thomas Caparas,0,1,36,36
1656869464208,MATH 20C,B01,083762,Bach; Quang Tran,0,0,30,30
1656869470236,MATH 20D,A01,083765,Tran; Brian Kha,4,0,30,26
1656869470236,MATH 20D,A02,083766,Tran; Brian Kha,4,0,30,26
1656869470236,MATH 20D,A03,083767,Tran; Brian Kha,2,0,30,28
1656869476264,MATH 20E,A01,083771,Ganguly; Soumya,5,0,32,27
1656869476264,MATH 20E,A02,083772,Ganguly; Soumya,6,0,32,26
1656869476264,MATH 20E,B01,083773,Ciotti; Benjamin,18,0,35,17
1656869476264,MATH 20E,B02,083774,Ciotti; Benjamin,17,0,35,18
1656869482300,MATH 103A,A01,083777,Greenfeld; Be'Eri,2,0,36,34
1656869482300,MATH 103A,A02,083778,Greenfeld; Be'Eri,5,0,36,31
1656869482300,MATH 103A,A03,093561,Greenfeld; Be'Eri,4,0,36,32
1656869482300,MATH 103A,B01,083779,Greenfeld; Be'Eri,6,0,36,30
1656869482300,MATH 103A,B02,083780,Greenfeld; Be'Eri,2,0,36,34
1656869482300,MATH 103A,B03,093562,Greenfeld; Be'Eri,2,0,36,34
1656869488324,MATH 105,A01,085443,Carter; Anne Toulson,13,0,35,22
1656869488324,MATH 105,A02,093477,Carter; Anne Toulson,20,0,35,15
1656869494349,MATH 109,A01,083213,Ganzberger; Geoffrey Michael,2,0,34,32
1656869494349,MATH 109,A02,083214,Ganzberger; Geoffrey Michael,2,0,34,32
1656869494349,MATH 109,A03,093478,Ganzberger; Geoffrey Michael,1,0,34,33
1656869494349,MATH 109,B01,083215,Ganzberger; Geoffrey Michael,1,0,32,31
1656869494349,MATH 109,B02,083216,Ganzberger; Geoffrey Michael,1,0,32,31
1656869494349,MATH 109,B03,093479,Ganzberger; Geoffrey Michael,6,0,32,26
1656869500374,MATH 142A,A01,083219,Chow; Bennett,6,0,32,26
1656869500374,MATH 142A,A02,083220,Chow; Bennett,9,0,32,23
1656869500374,MATH 142A,A03,093480,Chow; Bennett,7,0,32,25
1656869500374,MATH 142A,B03,093481,Chow; Bennett,7,0,32,25
1656869500374,MATH 142A,B04,093558,Chow; Bennett,10,0,32,22
1656869500374,MATH 142A,B05,093559,Chow; Bennett,6,0,32,26
1656869506402,MATH 193A,A01,083224,Rotar; Vladimir,6,0,34,28
1656869506402,MATH 193A,A02,083225,Rotar; Vladimir,3,0,34,31
1656869506402,MATH 193A,A03,083781,Rotar; Vladimir,1,0,34,33
1656869506402,MATH 193A,A04,083782,Rotar; Vladimir,6,0,34,28
1656869506402,MATH 193A,A05,093482,Rotar; Vladimir,6,0,34,28
1656869512431,MATH 197,001,091859,McAuley; Julian John,9999,0,9999,0
1656869512431,MATH 197,002,095566,Kedlaya; Kiran S.,9997,0,9999,2
1656869512431,MATH 197,003,095567,Xiao; Ming,9999,0,9999,0
1656869512431,MATH 197,004,095571,Perols; Johan Lars,9998,0,9999,1
1656869519487,COGS 9,A01,083615,Shannon; Kyle Michael,6,0,75,69
1656869525513,COGS 11,A01,083617,Boyle; Mary E. T.,19,0,48,29
1656869531540,COGS 13,A01,083071,Bastos; Amalia Pinkusfeld,8,0,71,63
1656869537569,COGS 14A,A01,092681,Semenuks; Arturs,0,1,100,100
1656869543625,COGS 14B,A01,083073,Cheng; Tzu-Han,5,0,63,58
1656869549653,COGS 17,A01,092677,Semenuks; Arturs,4,0,81,77
1656869555676,COGS 100,A01,083619,Allen; Michael Gordon,15,0,70,55
1656869561698,COGS 101A,A01,083621,Davis; Joshua Daniel,9,0,68,59
1656869567727,COGS 101B,A01,091572,Allen; Michael Gordon,8,0,65,57
1656869573757,COGS 101C,A01,083625,Delgado; Tania,17,0,35,18
1656869579779,COGS 107A,A01,083627,Boyle; Mary E. T.,13,0,60,47
1656869585804,COGS 118A,A01,083075,Gupta; Anjum,15,0,76,61
1656869591826,CSE 3,A50,083646,Miranda; Gregory Joseph,22,0,50,28
1656869597853,CSE 8A,A50,083650,Miranda; Gregory Joseph,17,1,56,39
1656869603878,CSE 11,A01,083080,Cao; Yingjun,4,15,40,36
1656869609912,CSE 12,A01,083652,Krause-Levy; Sophia Louisa,20,1,120,100
1656869615933,CSE 15L,A01,083654,Morris; Justin Loren,8,0,50,42
1656869615933,CSE 15L,A02,083655,Morris; Justin Loren,8,0,50,42
1656869621955,CSE 20,A01,083657,Tran; Khoa Dang,37,0,80,43
1656869627982,CSE 21,A01,095574,Bach; Quang Tran,21,0,48,27
1656869634006,CSE 30,A01,083084,Eldon; John,4,0,80,76
1656869634006,CSE 30,B01,095061,Bhaskar; Nishant,6,0,50,44
1656869640027,CSE 100,A01,083659,Cao; Yingjun,2,4,70,68
1656869646053,CSE 134B,A01,083661,Powell; Thomas Allan,19,0,100,81
1656869652077,CSE 140,A01,083663,Gungor; Onat,14,0,85,71
1656869658109,CSE 140L,A01,083088,Eldon; John,16,0,100,84
1656869664135,CSE 175,A01,083665,Kumar; Rakesh,3,0,25,22
1656869670161,CSE 190,A00,092507,Dubnov; Shlomo,7,0,20,13
1656869676187,ECE 45,A01,083139,Congero; Spencer William,5,0,75,70
1656869682221,ECE 65,A50,083695,Saad; Andrew S,12,0,30,18
1656869682221,ECE 65,A51,095125,Saad; Andrew S,25,0,26,1
1656869688244,ECE 109,A01,091882,Touri; Behrouz,16,0,70,54
1656869694269,ECE 180,A00,083140,Abi Samra; Nicholas Camill,0,0,30,30
1656869694269,ECE 180,B00,083141,Abi Samra; Nicholas Camill,0,0,30,30
1656869700300,MATH 10A,A01,083735,Patchell; Gregory David,1,0,30,29
1656869700300,MATH 10A,A02,083736,Patchell; Gregory David,20,0,30,10
1656869700300,MATH 10A,A03,083737,Patchell; Gregory David,15,0,30,15
1656869706328,MATH 10B,A01,083207,Lim; Seonhee,7,0,34,27
1656869706328,MATH 10B,A02,083208,Lim; Seonhee,9,0,35,26
1656869706328,MATH 10B,A03,093472,Lim; Seonhee,4,0,34,30
1656869706328,MATH 10B,B01,083739,Sinha; Shubham,9,0,30,21
1656869712358,MATH 18,A01,083743,Cinel; Cameron Alexander,6,0,30,24
1656869712358,MATH 18,A02,083744,Cinel; Cameron Alexander,15,0,30,15
1656869712358,MATH 18,A03,083745,Cinel; Cameron Alexander,8,0,30,22
1656869712358,MATH 18,B01,083748,Rideout; David Porter,3,0,37,34
1656869712358,MATH 18,B02,083749,Rideout; David Porter,3,0,36,33
1656869712358,MATH 18,B03,083750,Rideout; David Porter,2,0,37,35
1656869712358,MATH 18,B04,083751,Rideout; David Porter,5,0,36,31
1656869712358,MATH 18,B05,093473,Rideout; David Porter,4,0,36,32
1656869712358,MATH 18,B06,093474,Rideout; David Porter,5,0,36,31
1656869718384,MATH 20A,A01,083754,Zheng; Zequn,12,0,40,28
1656869724412,MATH 20B,A01,083756,Briones; Jor-el Thomas Caparas,1,0,36,35
1656869724412,MATH 20B,A02,083757,Briones; Jor-el Thomas Caparas,1,0,36,35
1656869724412,MATH 20B,A03,093475,Briones; Jor-el Thomas Caparas,0,0,36,36
1656869730437,MATH 20C,A01,083760,Briones; Jor-el Thomas Caparas,1,0,35,34
1656869730437,MATH 20C,A02,083761,Briones; Jor-el Thomas Caparas,8,0,35,27
1656869730437,MATH 20C,A03,093476,Briones; Jor-el Thomas Caparas,0,1,36,36
1656869730437,MATH 20C,B01,083762,Bach; Quang Tran,0,0,30,30
1656869736459,MATH 20D,A01,083765,Tran; Brian Kha,4,0,30,26
1656869736459,MATH 20D,A02,083766,Tran; Brian Kha,4,0,30,26
1656869736459,MATH 20D,A03,083767,Tran; Brian Kha,2,0,30,28
1656869742486,MATH 20E,A01,083771,Ganguly; Soumya,5,0,32,27
1656869742486,MATH 20E,A02,083772,Ganguly; Soumya,6,0,32,26
1656869742486,MATH 20E,B01,083773,Ciotti; Benjamin,18,0,35,17
1656869742486,MATH 20E,B02,083774,Ciotti; Benjamin,17,0,35,18
1656869748527,MATH 103A,A01,083777,Greenfeld; Be'Eri,2,0,36,34
1656869748527,MATH 103A,A02,083778,Greenfeld; Be'Eri,5,0,36,31
1656869748527,MATH 103A,A03,093561,Greenfeld; Be'Eri,4,0,36,32
1656869748527,MATH 103A,B01,083779,Greenfeld; Be'Eri,6,0,36,30
1656869748527,MATH 103A,B02,083780,Greenfeld; Be'Eri,2,0,36,34
1656869748527,MATH 103A,B03,093562,Greenfeld; Be'Eri,2,0,36,34
1656869754557,MATH 105,A01,085443,Carter; Anne Toulson,13,0,35,22
1656869754557,MATH 105,A02,093477,Carter; Anne Toulson,20,0,35,15
1656869760585,MATH 109,A01,083213,Ganzberger; Geoffrey Michael,2,0,34,32
1656869760585,MATH 109,A02,083214,Ganzberger; Geoffrey Michael,2,0,34,32
1656869760585,MATH 109,A03,093478,Ganzberger; Geoffrey Michael,1,0,34,33
1656869760585,MATH 109,B01,083215,Ganzberger; Geoffrey Michael,1,0,32,31
1656869760585,MATH 109,B02,083216,Ganzberger; Geoffrey Michael,1,0,32,31
1656869760585,MATH 109,B03,093479,Ganzberger; Geoffrey Michael,6,0,32,26
1656869766610,MATH 142A,A01,083219,Chow; Bennett,6,0,32,26
1656869766610,MATH 142A,A02,083220,Chow; Bennett,9,0,32,23
1656869766610,MATH 142A,A03,093480,Chow; Bennett,7,0,32,25
1656869766610,MATH 142A,B03,093481,Chow; Bennett,7,0,32,25
1656869766610,MATH 142A,B04,093558,Chow; Bennett,10,0,32,22
1656869766610,MATH 142A,B05,093559,Chow; Bennett,6,0,32,26
1656869772638,MATH 193A,A01,083224,Rotar; Vladimir,6,0,34,28
1656869772638,MATH 193A,A02,083225,Rotar; Vladimir,3,0,34,31
1656869772638,MATH 193A,A03,083781,Rotar; Vladimir,1,0,34,33
1656869772638,MATH 193A,A04,083782,Rotar; Vladimir,6,0,34,28
1656869772638,MATH 193A,A05,093482,Rotar; Vladimir,6,0,34,28
1656869778660,MATH 197,001,091859,McAuley; Julian John,9999,0,9999,0
1656869778660,MATH 197,002,095566,Kedlaya; Kiran S.,9997,0,9999,2
1656869778660,MATH 197,003,095567,Xiao; Ming,9999,0,9999,0
1656869778660,MATH 197,004,095571,Perols; Johan Lars,9998,0,9999,1
1656869785727,COGS 9,A01,083615,Shannon; Kyle Michael,6,0,75,69
1656869791750,COGS 11,A01,083617,Boyle; Mary E. T.,19,0,48,29
1656869797771,COGS 13,A01,083071,Bastos; Amalia Pinkusfeld,8,0,71,63
1656869803794,COGS 14A,A01,092681,Semenuks; Arturs,0,1,100,100
1656869809817,COGS 14B,A01,083073,Cheng; Tzu-Han,5,0,63,58
1656869815840,COGS 17,A01,092677,Semenuks; Arturs,4,0,81,77
1656869821861,COGS 100,A01,083619,Allen; Michael Gordon,15,0,70,55
1656869827883,COGS 101A,A01,083621,Davis; Joshua Daniel,9,0,68,59
1656869833911,COGS 101B,A01,091572,Allen; Michael Gordon,8,0,65,57
1656869840010,COGS 101C,A01,083625,Delgado; Tania,17,0,35,18
1656869846033,COGS 107A,A01,083627,Boyle; Mary E. T.,13,0,60,47
1656869852055,COGS 118A,A01,083075,Gupta; Anjum,15,0,76,61
1656869858083,CSE 3,A50,083646,Miranda; Gregory Joseph,22,0,50,28
1656869864109,CSE 8A,A50,083650,Miranda; Gregory Joseph,17,1,56,39
1656869870131,CSE 11,A01,083080,Cao; Yingjun,4,15,40,36
1656869876156,CSE 12,A01,083652,Krause-Levy; Sophia Louisa,20,1,120,100
1656869882181,CSE 15L,A01,083654,Morris; Justin Loren,8,0,50,42
1656869882181,CSE 15L,A02,083655,Morris; Justin Loren,8,0,50,42
1656869888208,CSE 20,A01,083657,Tran; Khoa Dang,37,0,80,43
1656869894242,CSE 21,A01,095574,Bach; Quang Tran,21,0,48,27
1656869900268,CSE 30,A01,083084,Eldon; John,4,0,80,76
1656869900268,CSE 30,B01,095061,Bhaskar; Nishant,6,0,50,44
1656869906291,CSE 100,A01,083659,Cao; Yingjun,2,4,70,68
1656869912322,CSE 134B,A01,083661,Powell; Thomas Allan,19,0,100,81
1656869918346,CSE 140,A01,083663,Gungor; Onat,14,0,85,71
1656869924367,CSE 140L,A01,083088,Eldon; John,16,0,100,84
1656869930400,CSE 175,A01,083665,Kumar; Rakesh,3,0,25,22
1656869936449,CSE 190,A00,092507,Dubnov; Shlomo,7,0,20,13
1656869942485,ECE 45,A01,083139,Congero; Spencer William,5,0,75,70
1656869948515,ECE 65,A50,083695,Saad; Andrew S,12,0,30,18
1656869948515,ECE 65,A51,095125,Saad; Andrew S,25,0,26,1
1656869954540,ECE 109,A01,091882,Touri; Behrouz,16,0,70,54
1656869960566,ECE 180,A00,083140,Abi Samra; Nicholas Camill,0,0,30,30
1656869960566,ECE 180,B00,083141,Abi Samra; Nicholas Camill,0,0,30,30
1656869966589,MATH 10A,A01,083735,Patchell; Gregory David,1,0,30,29
1656869966589,MATH 10A,A02,083736,Patchell; Gregory David,20,0,30,10
1656869966589,MATH 10A,A03,083737,Patchell; Gregory David,15,0,30,15
1656869972618,MATH 10B,A01,083207,Lim; Seonhee,7,0,34,27
1656869972618,MATH 10B,A02,083208,Lim; Seonhee,9,0,35,26
1656869972618,MATH 10B,A03,093472,Lim; Seonhee,4,0,34,30
1656869972618,MATH 10B,B01,083739,Sinha; Shubham,9,0,30,21
1656869978648,MATH 18,A01,083743,Cinel; Cameron Alexander,6,0,30,24
1656869978648,MATH 18,A02,083744,Cinel; Cameron Alexander,15,0,30,15
1656869978648,MATH 18,A03,083745,Cinel; Cameron Alexander,8,0,30,22
1656869978648,MATH 18,B01,083748,Rideout; David Porter,3,0,37,34
1656869978648,MATH 18,B02,083749,Rideout; David Porter,3,0,36,33
1656869978648,MATH 18,B03,083750,Rideout; David Porter,2,0,37,35
1656869978648,MATH 18,B04,083751,Rideout; David Porter,5,0,36,31
1656869978648,MATH 18,B05,093473,Rideout; David Porter,4,0,36,32
1656869978648,MATH 18,B06,093474,Rideout; David Porter,5,0,36,31
1656869984675,MATH 20A,A01,083754,Zheng; Zequn,12,0,40,28
1656869990698,MATH 20B,A01,083756,Briones; Jor-el Thomas Caparas,1,0,36,35
1656869990698,MATH 20B,A02,083757,Briones; Jor-el Thomas Caparas,1,0,36,35
1656869990698,MATH 20B,A03,093475,Briones; Jor-el Thomas Caparas,0,0,36,36
1656869996721,MATH 20C,A01,083760,Briones; Jor-el Thomas Caparas,1,0,35,34
1656869996721,MATH 20C,A02,083761,Briones; Jor-el Thomas Caparas,8,0,35,27
1656869996721,MATH 20C,A03,093476,Briones; Jor-el Thomas Caparas,0,1,36,36
1656869996721,MATH 20C,B01,083762,Bach; Quang Tran,0,0,30,30
1656870002750,MATH 20D,A01,083765,Tran; Brian Kha,4,0,30,26
1656870002750,MATH 20D,A02,083766,Tran; Brian Kha,4,0,30,26
1656870002750,MATH 20D,A03,083767,Tran; Brian Kha,2,0,30,28
1656870008774,MATH 20E,A01,083771,Ganguly; Soumya,5,0,32,27
1656870008774,MATH 20E,A02,083772,Ganguly; Soumya,6,0,32,26
1656870008774,MATH 20E,B01,083773,Ciotti; Benjamin,18,0,35,17
1656870008774,MATH 20E,B02,083774,Ciotti; Benjamin,17,0,35,18
1656870014798,MATH 103A,A01,083777,Greenfeld; Be'Eri,2,0,36,34
1656870014798,MATH 103A,A02,083778,Greenfeld; Be'Eri,5,0,36,31
1656870014798,MATH 103A,A03,093561,Greenfeld; Be'Eri,4,0,36,32
1656870014798,MATH 103A,B01,083779,Greenfeld; Be'Eri,6,0,36,30
1656870014798,MATH 103A,B02,083780,Greenfeld; Be'Eri,2,0,36,34
1656870014798,MATH 103A,B03,093562,Greenfeld; Be'Eri,2,0,36,34
1656870020822,MATH 105,A01,085443,Carter; Anne Toulson,13,0,35,22
1656870020822,MATH 105,A02,093477,Carter; Anne Toulson,20,0,35,15
1656870026846,MATH 109,A01,083213,Ganzberger; Geoffrey Michael,2,0,34,32
1656870026846,MATH 109,A02,083214,Ganzberger; Geoffrey Michael,2,0,34,32
1656870026846,MATH 109,A03,093478,Ganzberger; Geoffrey Michael,1,0,34,33
1656870026846,MATH 109,B01,083215,Ganzberger; Geoffrey Michael,1,0,32,31
1656870026846,MATH 109,B02,083216,Ganzberger; Geoffrey Michael,1,0,32,31
1656870026846,MATH 109,B03,093479,Ganzberger; Geoffrey Michael,6,0,32,26
1656870032869,MATH 142A,A01,083219,Chow; Bennett,6,0,32,26
1656870032869,MATH 142A,A02,083220,Chow; Bennett,9,0,32,23
1656870032869,MATH 142A,A03,093480,Chow; Bennett,7,0,32,25
1656870032869,MATH 142A,B03,093481,Chow; Bennett,7,0,32,25
1656870032869,MATH 142A,B04,093558,Chow; Bennett,10,0,32,22
1656870032869,MATH 142A,B05,093559,Chow; Bennett,6,0,32,26
1656870038911,MATH 193A,A01,083224,Rotar; Vladimir,6,0,34,28
1656870038911,MATH 193A,A02,083225,Rotar; Vladimir,3,0,34,31
1656870038911,MATH 193A,A03,083781,Rotar; Vladimir,1,0,34,33
1656870038911,MATH 193A,A04,083782,Rotar; Vladimir,6,0,34,28
1656870038911,MATH 193A,A05,093482,Rotar; Vladimir,6,0,34,28
1656870044940,MATH 197,001,091859,McAuley; Julian John,9999,0,9999,0
1656870044940,MATH 197,002,095566,Kedlaya; Kiran S.,9997,0,9999,2
1656870044940,MATH 197,003,095567,Xiao; Ming,9999,0,9999,0
1656870044940,MATH 197,004,095571,Perols; Johan Lars,9998,0,9999,1
1656870051996,COGS 9,A01,083615,Shannon; Kyle Michael,6,0,75,69
1656870058019,COGS 11,A01,083617,Boyle; Mary E. T.,19,0,48,29
1656870064048,COGS 13,A01,083071,Bastos; Amalia Pinkusfeld,8,0,71,63
1656870070072,COGS 14A,A01,092681,Semenuks; Arturs,0,1,100,100
1656870076098,COGS 14B,A01,083073,Cheng; Tzu-Han,5,0,63,58
1656870082119,COGS 17,A01,092677,Semenuks; Arturs,4,0,81,77
1656870088144,COGS 100,A01,083619,Allen; Michael Gordon,15,0,70,55
1656870094169,COGS 101A,A01,083621,Davis; Joshua Daniel,9,0,68,59
1656870100193,COGS 101B,A01,091572,Allen; Michael Gordon,8,0,65,57
1656870106216,COGS 101C,A01,083625,Delgado; Tania,17,0,35,18
1656870112243,COGS 107A,A01,083627,Boyle; Mary E. T.,13,0,60,47
1656870118267,COGS 118A,A01,083075,Gupta; Anjum,15,0,76,61
1656870124291,CSE 3,A50,083646,Miranda; Gregory Joseph,22,0,50,28
1656870130317,CSE 8A,A50,083650,Miranda; Gregory Joseph,17,1,56,39
1656870136344,CSE 11,A01,083080,Cao; Yingjun,4,15,40,36
1656870142370,CSE 12,A01,083652,Krause-Levy; Sophia Louisa,20,1,120,100
1656870148392,CSE 15L,A01,083654,Morris; Justin Loren,8,0,50,42
1656870148392,CSE 15L,A02,083655,Morris; Justin Loren,8,0,50,42
1656870154416,CSE 20,A01,083657,Tran; Khoa Dang,37,0,80,43
1656870160442,CSE 21,A01,095574,Bach; Quang Tran,21,0,48,27
1656870166469,CSE 30,A01,083084,Eldon; John,4,0,80,76
1656870166469,CSE 30,B01,095061,Bhaskar; Nishant,6,0,50,44
1656870172499,CSE 100,A01,083659,Cao; Yingjun,2,4,70,68
1656870178523,CSE 134B,A01,083661,Powell; Thomas Allan,19,0,100,81
1656870184547,CSE 140,A01,083663,Gungor; Onat,14,0,85,71
1656870190574,CSE 140L,A01,083088,Eldon; John,16,0,100,84
1656870196603,CSE 175,A01,083665,Kumar; Rakesh,3,0,25,22
1656870202625,CSE 190,A00,092507,Dubnov; Shlomo,7,0,20,13
1656870208653,ECE 45,A01,083139,Congero; Spencer William,5,0,75,70
1656870214683,ECE 65,A50,083695,Saad; Andrew S,12,0,30,18
1656870214683,ECE 65,A51,095125,Saad; Andrew S,25,0,26,1
1656870220710,ECE 109,A01,091882,Touri; Behrouz,16,0,70,54
1656870226733,ECE 180,A00,083140,Abi Samra; Nicholas Camill,0,0,30,30
1656870226733,ECE 180,B00,083141,Abi Samra; Nicholas Camill,0,0,30,30
1656870232757,MATH 10A,A01,083735,Patchell; Gregory David,1,0,30,29
1656870232757,MATH 10A,A02,083736,Patchell; Gregory David,20,0,30,10
1656870232757,MATH 10A,A03,083737,Patchell; Gregory David,15,0,30,15
1656870238782,MATH 10B,A01,083207,Lim; Seonhee,7,0,34,27
1656870238782,MATH 10B,A02,083208,Lim; Seonhee,9,0,35,26
1656870238782,MATH 10B,A03,093472,Lim; Seonhee,4,0,34,30
1656870238782,MATH 10B,B01,083739,Sinha; Shubham,9,0,30,21
1656870244806,MATH 18,A01,083743,Cinel; Cameron Alexander,6,0,30,24
1656870244806,MATH 18,A02,083744,Cinel; Cameron Alexander,15,0,30,15
1656870244806,MATH 18,A03,083745,Cinel; Cameron Alexander,8,0,30,22
1656870244806,MATH 18,B01,083748,Rideout; David Porter,3,0,37,34
1656870244806,MATH 18,B02,083749,Rideout; David Porter,3,0,36,33
1656870244806,MATH 18,B03,083750,Rideout; David Porter,2,0,37,35
1656870244806,MATH 18,B04,083751,Rideout; David Porter,5,0,36,31
1656870244806,MATH 18,B05,093473,Rideout; David Porter,4,0,36,32
1656870244806,MATH 18,B06,093474,Rideout; David Porter,5,0,36,31
1656870250832,MATH 20A,A01,083754,Zheng; Zequn,12,0,40,28
1656870256856,MATH 20B,A01,083756,Briones; Jor-el Thomas Caparas,1,0,36,35
1656870256856,MATH 20B,A02,083757,Briones; Jor-el Thomas Caparas,1,0,36,35
1656870256856,MATH 20B,A03,093475,Briones; Jor-el Thomas Caparas,0,0,36,36
1656870262881,MATH 20C,A01,083760,Briones; Jor-el Thomas Caparas,1,0,35,34
1656870262881,MATH 20C,A02,083761,Briones; Jor-el Thomas Caparas,8,0,35,27
1656870262881,MATH 20C,A03,093476,Briones; Jor-el Thomas Caparas,0,1,36,36
1656870262881,MATH 20C,B01,083762,Bach; Quang Tran,0,0,30,30
1656870268908,MATH 20D,A01,083765,Tran; Brian Kha,4,0,30,26
1656870268908,MATH 20D,A02,083766,Tran; Brian Kha,4,0,30,26
1656870268908,MATH 20D,A03,083767,Tran; Brian Kha,2,0,30,28
1656870274934,MATH 20E,A01,083771,Ganguly; Soumya,5,0,32,27
1656870274934,MATH 20E,A02,083772,Ganguly; Soumya,6,0,32,26
1656870274934,MATH 20E,B01,083773,Ciotti; Benjamin,18,0,35,17
1656870274934,MATH 20E,B02,083774,Ciotti; Benjamin,17,0,35,18
1656870280968,MATH 103A,A01,083777,Greenfeld; Be'Eri,2,0,36,34
1656870280968,MATH 103A,A02,083778,Greenfeld; Be'Eri,5,0,36,31
1656870280968,MATH 103A,A03,093561,Greenfeld; Be'Eri,4,0,36,32
1656870280968,MATH 103A,B01,083779,Greenfeld; Be'Eri,6,0,36,30
1656870280968,MATH 103A,B02,083780,Greenfeld; Be'Eri,2,0,36,34
1656870280968,MATH 103A,B03,093562,Greenfeld; Be'Eri,2,0,36,34
1656870286995,MATH 105,A01,085443,Carter; Anne Toulson,13,0,35,22
1656870286995,MATH 105,A02,093477,Carter; Anne Toulson,20,0,35,15
1656870293019,MATH 109,A01,083213,Ganzberger; Geoffrey Michael,2,0,34,32
1656870293019,MATH 109,A02,083214,Ganzberger; Geoffrey Michael,2,0,34,32
1656870293019,MATH 109,A03,093478,Ganzberger; Geoffrey Michael,1,0,34,33
1656870293019,MATH 109,B01,083215,Ganzberger; Geoffrey Michael,1,0,32,31
1656870293019,MATH 109,B02,083216,Ganzberger; Geoffrey Michael,1,0,32,31
1656870293019,MATH 109,B03,093479,Ganzberger; Geoffrey Michael,6,0,32,26
1656870299043,MATH 142A,A01,083219,Chow; Bennett,6,0,32,26
1656870299043,MATH 142A,A02,083220,Chow; Bennett,9,0,32,23
1656870299043,MATH 142A,A03,093480,Chow; Bennett,7,0,32,25
1656870299043,MATH 142A,B03,093481,Chow; Bennett,7,0,32,25
1656870299043,MATH 142A,B04,093558,Chow; Bennett,10,0,32,22
1656870299043,MATH 142A,B05,093559,Chow; Bennett,6,0,32,26
1656870305065,MATH 193A,A01,083224,Rotar; Vladimir,6,0,34,28
1656870305065,MATH 193A,A02,083225,Rotar; Vladimir,3,0,34,31
1656870305065,MATH 193A,A03,083781,Rotar; Vladimir,1,0,34,33
1656870305065,MATH 193A,A04,083782,Rotar; Vladimir,6,0,34,28
1656870305065,MATH 193A,A05,093482,Rotar; Vladimir,6,0,34,28
1656870311089,MATH 197,001,091859,McAuley; Julian John,9999,0,9999,0
1656870311089,MATH 197,002,095566,Kedlaya; Kiran S.,9997,0,9999,2
1656870311089,MATH 197,003,095567,Xiao; Ming,9999,0,9999,0
1656870311089,MATH 197,004,095571,Perols; Johan Lars,9998,0,9999,1
1656870318151,COGS 9,A01,083615,Shannon; Kyle Michael,6,0,75,69
1656870324176,COGS 11,A01,083617,Boyle; Mary E. T.,19,0,48,29
1656870330200,COGS 13,A01,083071,Bastos; Amalia Pinkusfeld,8,0,71,63
1656870336227,COGS 14A,A01,092681,Semenuks; Arturs,0,1,100,100
1656870342251,COGS 14B,A01,083073,Cheng; Tzu-Han,5,0,63,58
1656870348274,COGS 17,A01,092677,Semenuks; Arturs,4,0,81,77
1656870354298,COGS 100,A01,083619,Allen; Michael Gordon,15,0,70,55
1656870360321,COGS 101A,A01,083621,Davis; Joshua Daniel,9,0,68,59
1656870366348,COGS 101B,A01,091572,Allen; Michael Gordon,8,0,65,57
1656870372373,COGS 101C,A01,083625,Delgado; Tania,17,0,35,18
1656870378397,COGS 107A,A01,083627,Boyle; Mary E. T.,13,0,60,47
1656870384426,COGS 118A,A01,083075,Gupta; Anjum,15,0,76,61
1656870390454,CSE 3,A50,083646,Miranda; Gregory Joseph,22,0,50,28
1656870396478,CSE 8A,A50,083650,Miranda; Gregory Joseph,17,1,56,39
1656870402504,CSE 11,A01,083080,Cao; Yingjun,4,15,40,36
1656870408529,CSE 12,A01,083652,Krause-Levy; Sophia Louisa,20,1,120,100
1656870414597,CSE 15L,A01,083654,Morris; Justin Loren,8,0,50,42
1656870414597,CSE 15L,A02,083655,Morris; Justin Loren,8,0,50,42
1656870420628,CSE 20,A01,083657,Tran; Khoa Dang,37,0,80,43
1656870426656,CSE 21,A01,095574,Bach; Quang Tran,21,0,48,27
1656870432683,CSE 30,A01,083084,Eldon; John,4,0,80,76
1656870432683,CSE 30,B01,095061,Bhaskar; Nishant,6,0,50,44
1656870438781,CSE 100,A01,083659,Cao; Yingjun,2,4,70,68
1656870444806,CSE 134B,A01,083661,Powell; Thomas Allan,19,0,100,81
1656870450829,CSE 140,A01,083663,Gungor; Onat,14,0,85,71
1656870456856,CSE 140L,A01,083088,Eldon; John,16,0,100,84
1656870462884,CSE 175,A01,083665,Kumar; Rakesh,3,0,25,22
1656870468910,CSE 190,A00,092507,Dubnov; Shlomo,7,0,20,13
1656870474933,ECE 45,A01,083139,Congero; Spencer William,5,0,75,70
1656870480955,ECE 65,A50,083695,Saad; Andrew S,12,0,30,18
1656870480955,ECE 65,A51,095125,Saad; Andrew S,25,0,26,1
1656870486979,ECE 109,A01,091882,Touri; Behrouz,16,0,70,54
1656870493003,ECE 180,A00,083140,Abi Samra; Nicholas Camill,0,0,30,30
1656870493003,ECE 180,B00,083141,Abi Samra; Nicholas Camill,0,0,30,30
1656870499027,MATH 10A,A01,083735,Patchell; Gregory David,1,0,30,29
1656870499027,MATH 10A,A02,083736,Patchell; Gregory David,20,0,30,10
1656870499027,MATH 10A,A03,083737,Patchell; Gregory David,15,0,30,15
1656870505049,MATH 10B,A01,083207,Lim; Seonhee,7,0,34,27
1656870505049,MATH 10B,A02,083208,Lim; Seonhee,9,0,35,26
1656870505049,MATH 10B,A03,093472,Lim; Seonhee,4,0,34,30
1656870505049,MATH 10B,B01,083739,Sinha; Shubham,9,0,30,21
1656870511082,MATH 18,A01,083743,Cinel; Cameron Alexander,6,0,30,24
1656870511082,MATH 18,A02,083744,Cinel; Cameron Alexander,15,0,30,15
1656870511082,MATH 18,A03,083745,Cinel; Cameron Alexander,8,0,30,22
1656870511082,MATH 18,B01,083748,Rideout; David Porter,3,0,37,34
1656870511082,MATH 18,B02,083749,Rideout; David Porter,3,0,36,33
1656870511082,MATH 18,B03,083750,Rideout; David Porter,2,0,37,35
1656870511082,MATH 18,B04,083751,Rideout; David Porter,5,0,36,31
1656870511082,MATH 18,B05,093473,Rideout; David Porter,4,0,36,32
1656870511082,MATH 18,B06,093474,Rideout; David Porter,5,0,36,31
1656870517106,MATH 20A,A01,083754,Zheng; Zequn,12,0,40,28
1656870523133,MATH 20B,A01,083756,Briones; Jor-el Thomas Caparas,1,0,36,35
1656870523133,MATH 20B,A02,083757,Briones; Jor-el Thomas Caparas,1,0,36,35
1656870523133,MATH 20B,A03,093475,Briones; Jor-el Thomas Caparas,0,0,36,36
1656870529156,MATH 20C,A01,083760,Briones; Jor-el Thomas Caparas,1,0,35,34
1656870529156,MATH 20C,A02,083761,Briones; Jor-el Thomas Caparas,8,0,35,27
1656870529156,MATH 20C,A03,093476,Briones; Jor-el Thomas Caparas,0,1,36,36
1656870529156,MATH 20C,B01,083762,Bach; Quang Tran,0,0,30,30
1656870535178,MATH 20D,A01,083765,Tran; Brian Kha,4,0,30,26
1656870535178,MATH 20D,A02,083766,Tran; Brian Kha,4,0,30,26
1656870535178,MATH 20D,A03,083767,Tran; Brian Kha,2,0,30,28
1656870541206,MATH 20E,A01,083771,Ganguly; Soumya,5,0,32,27
1656870541206,MATH 20E,A02,083772,Ganguly; Soumya,6,0,32,26
1656870541206,MATH 20E,B01,083773,Ciotti; Benjamin,18,0,35,17
1656870541206,MATH 20E,B02,083774,Ciotti; Benjamin,17,0,35,18
1656870547230,MATH 103A,A01,083777,Greenfeld; Be'Eri,2,0,36,34
1656870547230,MATH 103A,A02,083778,Greenfeld; Be'Eri,5,0,36,31
1656870547230,MATH 103A,A03,093561,Greenfeld; Be'Eri,4,0,36,32
1656870547230,MATH 103A,B01,083779,Greenfeld; Be'Eri,6,0,36,30
1656870547230,MATH 103A,B02,083780,Greenfeld; Be'Eri,2,0,36,34
1656870547230,MATH 103A,B03,093562,Greenfeld; Be'Eri,2,0,36,34
1656870553258,MATH 105,A01,085443,Carter; Anne Toulson,13,0,35,22
1656870553258,MATH 105,A02,093477,Carter; Anne Toulson,20,0,35,15
1656870559286,MATH 109,A01,083213,Ganzberger; Geoffrey Michael,2,0,34,32
1656870559286,MATH 109,A02,083214,Ganzberger; Geoffrey Michael,2,0,34,32
1656870559286,MATH 109,A03,093478,Ganzberger; Geoffrey Michael,1,0,34,33
1656870559286,MATH 109,B01,083215,Ganzberger; Geoffrey Michael,1,0,32,31
1656870559286,MATH 109,B02,083216,Ganzberger; Geoffrey Michael,1,0,32,31
1656870559286,MATH 109,B03,093479,Ganzberger; Geoffrey Michael,6,0,32,26
1656870565315,MATH 142A,A01,083219,Chow; Bennett,6,0,32,26
1656870565315,MATH 142A,A02,083220,Chow; Bennett,9,0,32,23
1656870565315,MATH 142A,A03,093480,Chow; Bennett,7,0,32,25
1656870565315,MATH 142A,B03,093481,Chow; Bennett,7,0,32,25
1656870565315,MATH 142A,B04,093558,Chow; Bennett,10,0,32,22
1656870565315,MATH 142A,B05,093559,Chow; Bennett,6,0,32,26
1656870571344,MATH 193A,A01,083224,Rotar; Vladimir,6,0,34,28
1656870571344,MATH 193A,A02,083225,Rotar; Vladimir,3,0,34,31
1656870571344,MATH 193A,A03,083781,Rotar; Vladimir,1,0,34,33
1656870571344,MATH 193A,A04,083782,Rotar; Vladimir,6,0,34,28
1656870571344,MATH 193A,A05,093482,Rotar; Vladimir,6,0,34,28
1656870577373,MATH 197,001,091859,McAuley; Julian John,9999,0,9999,0
1656870577373,MATH 197,002,095566,Kedlaya; Kiran S.,9997,0,9999,2
1656870577373,MATH 197,003,095567,Xiao; Ming,9999,0,9999,0
1656870577373,MATH 197,004,095571,Perols; Johan Lars,9998,0,9999,1
1656870584429,COGS 9,A01,083615,Shannon; Kyle Michael,6,0,75,69
1656870590475,COGS 11,A01,083617,Boyle; Mary E. T.,19,0,48,29
1656870596498,COGS 13,A01,083071,Bastos; Amalia Pinkusfeld,8,0,71,63
1656870602524,COGS 14A,A01,092681,Semenuks; Arturs,0,1,100,100
1656870608550,COGS 14B,A01,083073,Cheng; Tzu-Han,5,0,63,58
1656870614574,COGS 17,A01,092677,Semenuks; Arturs,4,0,81,77
1656870620600,COGS 100,A01,083619,Allen; Michael Gordon,15,0,70,55
1656870626628,COGS 101A,A01,083621,Davis; Joshua Daniel,9,0,68,59
1656870632654,COGS 101B,A01,091572,Allen; Michael Gordon,8,0,65,57
1656870638678,COGS 101C,A01,083625,Delgado; Tania,17,0,35,18
1656870644700,COGS 107A,A01,083627,Boyle; Mary E. T.,13,0,60,47
1656870650723,COGS 118A,A01,083075,Gupta; Anjum,15,0,76,61
1656870656754,CSE 3,A50,083646,Miranda; Gregory Joseph,22,0,50,28
1656870662776,CSE 8A,A50,083650,Miranda; Gregory Joseph,17,1,56,39
1656870668799,CSE 11,A01,083080,Cao; Yingjun,4,15,40,36
1656870674836,CSE 12,A01,083652,Krause-Levy; Sophia Louisa,20,1,120,100
1656870680857,CSE 15L,A01,083654,Morris; Justin Loren,8,0,50,42
1656870680857,CSE 15L,A02,083655,Morris; Justin Loren,8,0,50,42
1656870686879,CSE 20,A01,083657,Tran; Khoa Dang,37,0,80,43
1656870692906,CSE 21,A01,095574,Bach; Quang Tran,21,0,48,27
1656870698931,CSE 30,A01,083084,Eldon; John,4,0,80,76
1656870698931,CSE 30,B01,095061,Bhaskar; Nishant,6,0,50,44
1656870704955,CSE 100,A01,083659,Cao; Yingjun,2,4,70,68
1656870710979,CSE 134B,A01,083661,Powell; Thomas Allan,19,0,100,81
1656870717003,CSE 140,A01,083663,Gungor; Onat,14,0,85,71
1656870723025,CSE 140L,A01,083088,Eldon; John,16,0,100,84
1656870729053,CSE 175,A01,083665,Kumar; Rakesh,3,0,25,22
1656870735075,CSE 190,A00,092507,Dubnov; Shlomo,7,0,20,13
1656870741099,ECE 45,A01,083139,Congero; Spencer William,5,0,75,70
1656870747125,ECE 65,A50,083695,Saad; Andrew S,12,0,30,18
1656870747125,ECE 65,A51,095125,Saad; Andrew S,25,0,26,1
1656870753153,ECE 109,A01,091882,Touri; Behrouz,16,0,70,54
1656870759179,ECE 180,A00,083140,Abi Samra; Nicholas Camill,0,0,30,30
1656870759179,ECE 180,B00,083141,Abi Samra; Nicholas Camill,0,0,30,30
1656870765208,MATH 10A,A01,083735,Patchell; Gregory David,1,0,30,29
1656870765208,MATH 10A,A02,083736,Patchell; Gregory David,20,0,30,10
1656870765208,MATH 10A,A03,083737,Patchell; Gregory David,15,0,30,15
1656870771236,MATH 10B,A01,083207,Lim; Seonhee,7,0,34,27
1656870771236,MATH 10B,A02,083208,Lim; Seonhee,9,0,35,26
1656870771236,MATH 10B,A03,093472,Lim; Seonhee,4,0,34,30
1656870771236,MATH 10B,B01,083739,Sinha; Shubham,9,0,30,21
1656870777268,MATH 18,A01,083743,Cinel; Cameron Alexander,6,0,30,24
1656870777268,MATH 18,A02,083744,Cinel; Cameron Alexander,15,0,30,15
1656870777268,MATH 18,A03,083745,Cinel; Cameron Alexander,8,0,30,22
1656870777268,MATH 18,B01,083748,Rideout; David Porter,3,0,37,34
1656870777268,MATH 18,B02,083749,Rideout; David Porter,3,0,36,33
1656870777268,MATH 18,B03,083750,Rideout; David Porter,2,0,37,35
1656870777268,MATH 18,B04,083751,Rideout; David Porter,5,0,36,31
1656870777268,MATH 18,B05,093473,Rideout; David Porter,4,0,36,32
1656870777268,MATH 18,B06,093474,Rideout; David Porter,5,0,36,31
1656870783297,MATH 20A,A01,083754,Zheng; Zequn,12,0,40,28
1656870789322,MATH 20B,A01,083756,Briones; Jor-el Thomas Caparas,1,0,36,35
1656870789322,MATH 20B,A02,083757,Briones; Jor-el Thomas Caparas,1,0,36,35
1656870789322,MATH 20B,A03,093475,Briones; Jor-el Thomas Caparas,0,0,36,36
1656870795349,MATH 20C,A01,083760,Briones; Jor-el Thomas Caparas,1,0,35,34
1656870795349,MATH 20C,A02,083761,Briones; Jor-el Thomas Caparas,8,0,35,27
1656870795349,MATH 20C,A03,093476,Briones; Jor-el Thomas Caparas,0,1,36,36
1656870795349,MATH 20C,B01,083762,Bach; Quang Tran,0,0,30,30
1656870801371,MATH 20D,A01,083765,Tran; Brian Kha,4,0,30,26
1656870801371,MATH 20D,A02,083766,Tran; Brian Kha,4,0,30,26
1656870801371,MATH 20D,A03,083767,Tran; Brian Kha,2,0,30,28
1656870807393,MATH 20E,A01,083771,Ganguly; Soumya,5,0,32,27
1656870807393,MATH 20E,A02,083772,Ganguly; Soumya,6,0,32,26
1656870807393,MATH 20E,B01,083773,Ciotti; Benjamin,18,0,35,17
1656870807393,MATH 20E,B02,083774,Ciotti; Benjamin,17,0,35,18
1656870813416,MATH 103A,A01,083777,Greenfeld; Be'Eri,2,0,36,34
1656870813416,MATH 103A,A02,083778,Greenfeld; Be'Eri,5,0,36,31
1656870813416,MATH 103A,A03,093561,Greenfeld; Be'Eri,4,0,36,32
1656870813416,MATH 103A,B01,083779,Greenfeld; Be'Eri,6,0,36,30
1656870813416,MATH 103A,B02,083780,Greenfeld; Be'Eri,2,0,36,34
1656870813416,MATH 103A,B03,093562,Greenfeld; Be'Eri,2,0,36,34
1656870819439,MATH 105,A01,085443,Carter; Anne Toulson,13,0,35,22
1656870819439,MATH 105,A02,093477,Carter; Anne Toulson,20,0,35,15
1656870825467,MATH 109,A01,083213,Ganzberger; Geoffrey Michael,2,0,34,32
1656870825467,MATH 109,A02,083214,Ganzberger; Geoffrey Michael,2,0,34,32
1656870825467,MATH 109,A03,093478,Ganzberger; Geoffrey Michael,1,0,34,33
1656870825467,MATH 109,B01,083215,Ganzberger; Geoffrey Michael,1,0,32,31
1656870825467,MATH 109,B02,083216,Ganzberger; Geoffrey Michael,1,0,32,31
1656870825467,MATH 109,B03,093479,Ganzberger; Geoffrey Michael,6,0,32,26
1656870831502,MATH 142A,A01,083219,Chow; Bennett,6,0,32,26
1656870831502,MATH 142A,A02,083220,Chow; Bennett,9,0,32,23
1656870831502,MATH 142A,A03,093480,Chow; Bennett,7,0,32,25
1656870831502,MATH 142A,B03,093481,Chow; Bennett,7,0,32,25
1656870831502,MATH 142A,B04,093558,Chow; Bennett,10,0,32,22
1656870831502,MATH 142A,B05,093559,Chow; Bennett,6,0,32,26
1656870837525,MATH 193A,A01,083224,Rotar; Vladimir,6,0,34,28
1656870837525,MATH 193A,A02,083225,Rotar; Vladimir,3,0,34,31
1656870837525,MATH 193A,A03,083781,Rotar; Vladimir,1,0,34,33
1656870837525,MATH 193A,A04,083782,Rotar; Vladimir,6,0,34,28
1656870837525,MATH 193A,A05,093482,Rotar; Vladimir,6,0,34,28
1656870843552,MATH 197,001,091859,McAuley; Julian John,9999,0,9999,0
1656870843552,MATH 197,002,095566,Kedlaya; Kiran S.,9997,0,9999,2
1656870843552,MATH 197,003,095567,Xiao; Ming,9999,0,9999,0
1656870843552,MATH 197,004,095571,Perols; Johan Lars,9998,0,9999,1
1656870850620,COGS 9,A01,083615,Shannon; Kyle Michael,6,0,75,69
1656870856653,COGS 11,A01,083617,Boyle; Mary E. T.,19,0,48,29
1656870862677,COGS 13,A01,083071,Bastos; Amalia Pinkusfeld,8,0,71,63
1656870868703,COGS 14A,A01,092681,Semenuks; Arturs,0,1,100,100
1656870874726,COGS 14B,A01,083073,Cheng; Tzu-Han,5,0,63,58
1656870880756,COGS 17,A01,092677,Semenuks; Arturs,4,0,81,77
1656870886783,COGS 100,A01,083619,Allen; Michael Gordon,15,0,70,55
1656870892806,COGS 101A,A01,083621,Davis; Joshua Daniel,9,0,68,59
1656870898829,COGS 101B,A01,091572,Allen; Michael Gordon,8,0,65,57
1656870904852,COGS 101C,A01,083625,Delgado; Tania,17,0,35,18
1656870910875,COGS 107A,A01,083627,Boyle; Mary E. T.,13,0,60,47
1656870916904,COGS 118A,A01,083075,Gupta; Anjum,15,0,76,61
1656870922927,CSE 3,A50,083646,Miranda; Gregory Joseph,22,0,50,28
1656870928949,CSE 8A,A50,083650,Miranda; Gregory Joseph,17,1,56,39
1656870934972,CSE 11,A01,083080,Cao; Yingjun,4,15,40,36
1656870941005,CSE 12,A01,083652,Krause-Levy; Sophia Louisa,20,1,120,100
1656870947032,CSE 15L,A01,083654,Morris; Justin Loren,8,0,50,42
1656870947032,CSE 15L,A02,083655,Morris; Justin Loren,8,0,50,42
1656870953054,CSE 20,A01,083657,Tran; Khoa Dang,37,0,80,43
1656870959082,CSE 21,A01,095574,Bach; Quang Tran,21,0,48,27
1656870965105,CSE 30,A01,083084,Eldon; John,4,0,80,76
1656870965105,CSE 30,B01,095061,Bhaskar; Nishant,6,0,50,44
1656870971133,CSE 100,A01,083659,Cao; Yingjun,2,4,70,68
1656870977157,CSE 134B,A01,083661,Powell; Thomas Allan,19,0,100,81
1656870983180,CSE 140,A01,083663,Gungor; Onat,14,0,85,71
1656870989206,CSE 140L,A01,083088,Eldon; John,16,0,100,84
1656870995229,CSE 175,A01,083665,Kumar; Rakesh,3,0,25,22
1656871001253,CSE 190,A00,092507,Dubnov; Shlomo,7,0,20,13
1656871007277,ECE 45,A01,083139,Congero; Spencer William,5,0,75,70
1656871013305,ECE 65,A50,083695,Saad; Andrew S,12,0,30,18
1656871013305,ECE 65,A51,095125,Saad; Andrew S,25,0,26,1
1656871019332,ECE 109,A01,091882,Touri; Behrouz,16,0,70,54
1656871025355,ECE 180,A00,083140,Abi Samra; Nicholas Camill,0,0,30,30
1656871025355,ECE 180,B00,083141,Abi Samra; Nicholas Camill,0,0,30,30
1656871031380,MATH 10A,A01,083735,Patchell; Gregory David,1,0,30,29
1656871031380,MATH 10A,A02,083736,Patchell; Gregory David,20,0,30,10
1656871031380,MATH 10A,A03,083737,Patchell; Gregory David,15,0,30,15
1656871037486,MATH 10B,A01,083207,Lim; Seonhee,7,0,34,27
1656871037486,MATH 10B,A02,083208,Lim; Seonhee,9,0,35,26
1656871037486,MATH 10B,A03,093472,Lim; Seonhee,4,0,34,30
1656871037486,MATH 10B,B01,083739,Sinha; Shubham,9,0,30,21
1656871043510,MATH 18,A01,083743,Cinel; Cameron Alexander,6,0,30,24
1656871043510,MATH 18,A02,083744,Cinel; Cameron Alexander,15,0,30,15
1656871043510,MATH 18,A03,083745,Cinel; Cameron Alexander,8,0,30,22
1656871043510,MATH 18,B01,083748,Rideout; David Porter,3,0,37,34
1656871043510,MATH 18,B02,083749,Rideout; David Porter,3,0,36,33
1656871043510,MATH 18,B03,083750,Rideout; David Porter,2,0,37,35
1656871043510,MATH 18,B04,083751,Rideout; David Porter,5,0,36,31
1656871043510,MATH 18,B05,093473,Rideout; David Porter,4,0,36,32
1656871043510,MATH 18,B06,093474,Rideout; David Porter,5,0,36,31
1656871049533,MATH 20A,A01,083754,Zheng; Zequn,12,0,40,28
1656871055557,MATH 20B,A01,083756,Briones; Jor-el Thomas Caparas,1,0,36,35
1656871055557,MATH 20B,A02,083757,Briones; Jor-el Thomas Caparas,1,0,36,35
1656871055557,MATH 20B,A03,093475,Briones; Jor-el Thomas Caparas,0,0,36,36
1656871061583,MATH 20C,A01,083760,Briones; Jor-el Thomas Caparas,1,0,35,34
1656871061583,MATH 20C,A02,083761,Briones; Jor-el Thomas Caparas,8,0,35,27
1656871061583,MATH 20C,A03,093476,Briones; Jor-el Thomas Caparas,0,1,36,36
1656871061583,MATH 20C,B01,083762,Bach; Quang Tran,0,0,30,30
1656871067608,MATH 20D,A01,083765,Tran; Brian Kha,4,0,30,26
1656871067608,MATH 20D,A02,083766,Tran; Brian Kha,4,0,30,26
1656871067608,MATH 20D,A03,083767,Tran; Brian Kha,2,0,30,28
1656871073632,MATH 20E,A01,083771,Ganguly; Soumya,5,0,32,27
1656871073632,MATH 20E,A02,083772,Ganguly; Soumya,6,0,32,26
1656871073632,MATH 20E,B01,083773,Ciotti; Benjamin,18,0,35,17
1656871073632,MATH 20E,B02,083774,Ciotti; Benjamin,17,0,35,18
1656871079663,MATH 103A,A01,083777,Greenfeld; Be'Eri,2,0,36,34
1656871079663,MATH 103A,A02,083778,Greenfeld; Be'Eri,5,0,36,31
1656871079663,MATH 103A,A03,093561,Greenfeld; Be'Eri,4,0,36,32
1656871079663,MATH 103A,B01,083779,Greenfeld; Be'Eri,6,0,36,30
1656871079663,MATH 103A,B02,083780,Greenfeld; Be'Eri,2,0,36,34
1656871079663,MATH 103A,B03,093562,Greenfeld; Be'Eri,2,0,36,34
1656871085696,MATH 105,A01,085443,Carter; Anne Toulson,13,0,35,22
1656871085696,MATH 105,A02,093477,Carter; Anne Toulson,20,0,35,15
1656871091724,MATH 109,A01,083213,Ganzberger; Geoffrey Michael,2,0,34,32
1656871091724,MATH 109,A02,083214,Ganzberger; Geoffrey Michael,2,0,34,32
1656871091724,MATH 109,A03,093478,Ganzberger; Geoffrey Michael,1,0,34,33
1656871091724,MATH 109,B01,083215,Ganzberger; Geoffrey Michael,1,0,32,31
1656871091724,MATH 109,B02,083216,Ganzberger; Geoffrey Michael,1,0,32,31
1656871091724,MATH 109,B03,093479,Ganzberger; Geoffrey Michael,6,0,32,26
1656871097752,MATH 142A,A01,083219,Chow; Bennett,6,0,32,26
1656871097752,MATH 142A,A02,083220,Chow; Bennett,9,0,32,23
1656871097752,MATH 142A,A03,093480,Chow; Bennett,7,0,32,25
1656871097752,MATH 142A,B03,093481,Chow; Bennett,7,0,32,25
1656871097752,MATH 142A,B04,093558,Chow; Bennett,10,0,32,22
1656871097752,MATH 142A,B05,093559,Chow; Bennett,6,0,32,26
1656871103776,MATH 193A,A01,083224,Rotar; Vladimir,6,0,34,28
1656871103776,MATH 193A,A02,083225,Rotar; Vladimir,3,0,34,31
1656871103776,MATH 193A,A03,083781,Rotar; Vladimir,1,0,34,33
1656871103776,MATH 193A,A04,083782,Rotar; Vladimir,6,0,34,28
1656871103776,MATH 193A,A05,093482,Rotar; Vladimir,6,0,34,28
1656871109802,MATH 197,001,091859,McAuley; Julian John,9999,0,9999,0
1656871109802,MATH 197,002,095566,Kedlaya; Kiran S.,9997,0,9999,2
1656871109802,MATH 197,003,095567,Xiao; Ming,9999,0,9999,0
1656871109802,MATH 197,004,095571,Perols; Johan Lars,9998,0,9999,1
1656871116855,COGS 9,A01,083615,Shannon; Kyle Michael,6,0,75,69
1656871122878,COGS 11,A01,083617,Boyle; Mary E. T.,19,0,48,29
1656871128901,COGS 13,A01,083071,Bastos; Amalia Pinkusfeld,8,0,71,63
1656871134927,COGS 14A,A01,092681,Semenuks; Arturs,0,1,100,100
1656871140950,COGS 14B,A01,083073,Cheng; Tzu-Han,5,0,63,58
1656871146975,COGS 17,A01,092677,Semenuks; Arturs,4,0,81,77
1656871153004,COGS 100,A01,083619,Allen; Michael Gordon,15,0,70,55
1656871159033,COGS 101A,A01,083621,Davis; Joshua Daniel,9,0,68,59
1656871165060,COGS 101B,A01,091572,Allen; Michael Gordon,8,0,65,57
1656871171085,COGS 101C,A01,083625,Delgado; Tania,17,0,35,18
1656871177110,COGS 107A,A01,083627,Boyle; Mary E. T.,13,0,60,47
1656871183135,COGS 118A,A01,083075,Gupta; Anjum,15,0,76,61
1656871189159,CSE 3,A50,083646,Miranda; Gregory Joseph,22,0,50,28
1656871195181,CSE 8A,A50,083650,Miranda; Gregory Joseph,17,1,56,39
1656871201205,CSE 11,A01,083080,Cao; Yingjun,4,15,40,36
1656871207228,CSE 12,A01,083652,Krause-Levy; Sophia Louisa,20,1,120,100
1656871213254,CSE 15L,A01,083654,Morris; Justin Loren,8,0,50,42
1656871213254,CSE 15L,A02,083655,Morris; Justin Loren,8,0,50,42
1656871219279,CSE 20,A01,083657,Tran; Khoa Dang,37,0,80,43
1656871225306,CSE 21,A01,095574,Bach; Quang Tran,21,0,48,27
1656871231331,CSE 30,A01,083084,Eldon; John,4,0,80,76
1656871231331,CSE 30,B01,095061,Bhaskar; Nishant,6,0,50,44
1656871237357,CSE 100,A01,083659,Cao; Yingjun,2,4,70,68
1656871243381,CSE 134B,A01,083661,Powell; Thomas Allan,19,0,100,81
1656871249404,CSE 140,A01,083663,Gungor; Onat,14,0,85,71
1656871255428,CSE 140L,A01,083088,Eldon; John,16,0,100,84
1656871261450,CSE 175,A01,083665,Kumar; Rakesh,3,0,25,22
1656871267472,CSE 190,A00,092507,Dubnov; Shlomo,7,0,20,13
1656871273496,ECE 45,A01,083139,Congero; Spencer William,5,0,75,70
1656871279524,ECE 65,A50,083695,Saad; Andrew S,12,0,30,18
1656871279524,ECE 65,A51,095125,Saad; Andrew S,25,0,26,1
1656871285550,ECE 109,A01,091882,Touri; Behrouz,16,0,70,54
1656871291579,ECE 180,A00,083140,Abi Samra; Nicholas Camill,0,0,30,30
1656871291579,ECE 180,B00,083141,Abi Samra; Nicholas Camill,0,0,30,30
1656871297602,MATH 10A,A01,083735,Patchell; Gregory David,1,0,30,29
1656871297602,MATH 10A,A02,083736,Patchell; Gregory David,20,0,30,10
1656871297602,MATH 10A,A03,083737,Patchell; Gregory David,15,0,30,15
1656871303630,MATH 10B,A01,083207,Lim; Seonhee,7,0,34,27
1656871303630,MATH 10B,A02,083208,Lim; Seonhee,9,0,35,26
1656871303630,MATH 10B,A03,093472,Lim; Seonhee,4,0,34,30
1656871303630,MATH 10B,B01,083739,Sinha; Shubham,9,0,30,21
1656871309661,MATH 18,A01,083743,Cinel; Cameron Alexander,6,0,30,24
1656871309661,MATH 18,A02,083744,Cinel; Cameron Alexander,15,0,30,15
1656871309661,MATH 18,A03,083745,Cinel; Cameron Alexander,8,0,30,22
1656871309661,MATH 18,B01,083748,Rideout; David Porter,3,0,37,34
1656871309661,MATH 18,B02,083749,Rideout; David Porter,3,0,36,33
1656871309661,MATH 18,B03,083750,Rideout; David Porter,2,0,37,35
1656871309661,MATH 18,B04,083751,Rideout; David Porter,5,0,36,31
1656871309661,MATH 18,B05,093473,Rideout; David Porter,4,0,36,32
1656871309661,MATH 18,B06,093474,Rideout; David Porter,5,0,36,31
1656871315683,MATH 20A,A01,083754,Zheng; Zequn,12,0,40,28
1656871321710,MATH 20B,A01,083756,Briones; Jor-el Thomas Caparas,1,0,36,35
1656871321710,MATH 20B,A02,083757,Briones; Jor-el Thomas Caparas,1,0,36,35
1656871321710,MATH 20B,A03,093475,Briones; Jor-el Thomas Caparas,0,0,36,36
1656871327732,MATH 20C,A01,083760,Briones; Jor-el Thomas Caparas,1,0,35,34
1656871327732,MATH 20C,A02,083761,Briones; Jor-el Thomas Caparas,8,0,35,27
1656871327732,MATH 20C,A03,093476,Briones; Jor-el Thomas Caparas,0,1,36,36
1656871327732,MATH 20C,B01,083762,Bach; Quang Tran,0,0,30,30
1656871333759,MATH 20D,A01,083765,Tran; Brian Kha,4,0,30,26
1656871333759,MATH 20D,A02,083766,Tran; Brian Kha,4,0,30,26
1656871333759,MATH 20D,A03,083767,Tran; Brian Kha,2,0,30,28
1656871339806,MATH 20E,A01,083771,Ganguly; Soumya,5,0,32,27
1656871339806,MATH 20E,A02,083772,Ganguly; Soumya,6,0,32,26
1656871339806,MATH 20E,B01,083773,Ciotti; Benjamin,18,0,35,17
1656871339806,MATH 20E,B02,083774,Ciotti; Benjamin,17,0,35,18
1656871345831,MATH 103A,A01,083777,Greenfeld; Be'Eri,2,0,36,34
1656871345831,MATH 103A,A02,083778,Greenfeld; Be'Eri,5,0,36,31
1656871345831,MATH 103A,A03,093561,Greenfeld; Be'Eri,4,0,36,32
1656871345831,MATH 103A,B01,083779,Greenfeld; Be'Eri,6,0,36,30
1656871345831,MATH 103A,B02,083780,Greenfeld; Be'Eri,2,0,36,34
1656871345831,MATH 103A,B03,093562,Greenfeld; Be'Eri,2,0,36,34
1656871351854,MATH 105,A01,085443,Carter; Anne Toulson,13,0,35,22
1656871351854,MATH 105,A02,093477,Carter; Anne Toulson,20,0,35,15
1656871357877,MATH 109,A01,083213,Ganzberger; Geoffrey Michael,2,0,34,32
1656871357877,MATH 109,A02,083214,Ganzberger; Geoffrey Michael,2,0,34,32
1656871357877,MATH 109,A03,093478,Ganzberger; Geoffrey Michael,1,0,34,33
1656871357877,MATH 109,B01,083215,Ganzberger; Geoffrey Michael,1,0,32,31
1656871357877,MATH 109,B02,083216,Ganzberger; Geoffrey Michael,1,0,32,31
1656871357877,MATH 109,B03,093479,Ganzberger; Geoffrey Michael,6,0,32,26
1656871363904,MATH 142A,A01,083219,Chow; Bennett,6,0,32,26
1656871363904,MATH 142A,A02,083220,Chow; Bennett,9,0,32,23
1656871363904,MATH 142A,A03,093480,Chow; Bennett,7,0,32,25
1656871363904,MATH 142A,B03,093481,Chow; Bennett,7,0,32,25
1656871363904,MATH 142A,B04,093558,Chow; Bennett,10,0,32,22
1656871363904,MATH 142A,B05,093559,Chow; Bennett,6,0,32,26
1656871369930,MATH 193A,A01,083224,Rotar; Vladimir,6,0,34,28
1656871369930,MATH 193A,A02,083225,Rotar; Vladimir,3,0,34,31
1656871369930,MATH 193A,A03,083781,Rotar; Vladimir,1,0,34,33
1656871369930,MATH 193A,A04,083782,Rotar; Vladimir,6,0,34,28
1656871369930,MATH 193A,A05,093482,Rotar; Vladimir,6,0,34,28
1656871375955,MATH 197,001,091859,McAuley; Julian John,9999,0,9999,0
1656871375955,MATH 197,002,095566,Kedlaya; Kiran S.,9997,0,9999,2
1656871375955,MATH 197,003,095567,Xiao; Ming,9999,0,9999,0
1656871375955,MATH 197,004,095571,Perols; Johan Lars,9998,0,9999,1
1656871383023,COGS 9,A01,083615,Shannon; Kyle Michael,6,0,75,69
1656871389045,COGS 11,A01,083617,Boyle; Mary E. T.,19,0,48,29
1656871395069,COGS 13,A01,083071,Bastos; Amalia Pinkusfeld,8,0,71,63
1656871401093,COGS 14A,A01,092681,Semenuks; Arturs,0,1,100,100
1656871407120,COGS 14B,A01,083073,Cheng; Tzu-Han,5,0,63,58
1656871413143,COGS 17,A01,092677,Semenuks; Arturs,4,0,81,77
1656871419169,COGS 100,A01,083619,Allen; Michael Gordon,15,0,70,55
1656871425197,COGS 101A,A01,083621,Davis; Joshua Daniel,9,0,68,59
1656871431221,COGS 101B,A01,091572,Allen; Michael Gordon,8,0,65,57
1656871437243,COGS 101C,A01,083625,Delgado; Tania,17,0,35,18
1656871443267,COGS 107A,A01,083627,Boyle; Mary E. T.,13,0,60,47
1656871449290,COGS 118A,A01,083075,Gupta; Anjum,15,0,76,61
1656871455320,CSE 3,A50,083646,Miranda; Gregory Joseph,22,0,50,28
1656871461345,CSE 8A,A50,083650,Miranda; Gregory Joseph,17,1,56,39
1656871467371,CSE 11,A01,083080,Cao; Yingjun,4,15,40,36
1656871473398,CSE 12,A01,083652,Krause-Levy; Sophia Louisa,20,1,120,100
1656871479423,CSE 15L,A01,083654,Morris; Justin Loren,8,0,50,42
1656871479423,CSE 15L,A02,083655,Morris; Justin Loren,8,0,50,42
1656871485445,CSE 20,A01,083657,Tran; Khoa Dang,37,0,80,43
1656871491472,CSE 21,A01,095574,Bach; Quang Tran,21,0,48,27
1656871497501,CSE 30,A01,083084,Eldon; John,4,0,80,76
1656871497501,CSE 30,B01,095061,Bhaskar; Nishant,6,0,50,44
1656871503524,CSE 100,A01,083659,Cao; Yingjun,2,4,70,68
1656871509546,CSE 134B,A01,083661,Powell; Thomas Allan,19,0,100,81
1656871515574,CSE 140,A01,083663,Gungor; Onat,14,0,85,71
1656871521970,CSE 140L,A01,083088,Eldon; John,16,0,100,84
1656871527994,CSE 175,A01,083665,Kumar; Rakesh,3,0,25,22
1656871534018,CSE 190,A00,092507,Dubnov; Shlomo,7,0,20,13
1656871540044,ECE 45,A01,083139,Congero; Spencer William,5,0,75,70
1656871546073,ECE 65,A50,083695,Saad; Andrew S,12,0,30,18
1656871546073,ECE 65,A51,095125,Saad; Andrew S,25,0,26,1
1656871552097,ECE 109,A01,091882,Touri; Behrouz,16,0,70,54
1656871558125,ECE 180,A00,083140,Abi Samra; Nicholas Camill,0,0,30,30
1656871558125,ECE 180,B00,083141,Abi Samra; Nicholas Camill,0,0,30,30
1656871564149,MATH 10A,A01,083735,Patchell; Gregory David,1,0,30,29
1656871564149,MATH 10A,A02,083736,Patchell; Gregory David,20,0,30,10
1656871564149,MATH 10A,A03,083737,Patchell; Gregory David,15,0,30,15
1656871570179,MATH 10B,A01,083207,Lim; Seonhee,7,0,34,27
1656871570179,MATH 10B,A02,083208,Lim; Seonhee,9,0,35,26
1656871570179,MATH 10B,A03,093472,Lim; Seonhee,4,0,34,30
1656871570179,MATH 10B,B01,083739,Sinha; Shubham,9,0,30,21
1656871576203,MATH 18,A01,083743,Cinel; Cameron Alexander,6,0,30,24
1656871576203,MATH 18,A02,083744,Cinel; Cameron Alexander,15,0,30,15
1656871576203,MATH 18,A03,083745,Cinel; Cameron Alexander,8,0,30,22
1656871576203,MATH 18,B01,083748,Rideout; David Porter,3,0,37,34
1656871576203,MATH 18,B02,083749,Rideout; David Porter,3,0,36,33
1656871576203,MATH 18,B03,083750,Rideout; David Porter,2,0,37,35
1656871576203,MATH 18,B04,083751,Rideout; David Porter,5,0,36,31
1656871576203,MATH 18,B05,093473,Rideout; David Porter,4,0,36,32
1656871576203,MATH 18,B06,093474,Rideout; David Porter,5,0,36,31
1656871582225,MATH 20A,A01,083754,Zheng; Zequn,12,0,40,28
1656871588252,MATH 20B,A01,083756,Briones; Jor-el Thomas Caparas,1,0,36,35
1656871588252,MATH 20B,A02,083757,Briones; Jor-el Thomas Caparas,1,0,36,35
1656871588252,MATH 20B,A03,093475,Briones; Jor-el Thomas Caparas,0,0,36,36
1656871594280,MATH 20C,A01,083760,Briones; Jor-el Thomas Caparas,1,0,35,34
1656871594280,MATH 20C,A02,083761,Briones; Jor-el Thomas Caparas,8,0,35,27
1656871594280,MATH 20C,A03,093476,Briones; Jor-el Thomas Caparas,0,1,36,36
1656871594280,MATH 20C,B01,083762,Bach; Quang Tran,0,0,30,30
1656871600304,MATH 20D,A01,083765,Tran; Brian Kha,4,0,30,26
1656871600304,MATH 20D,A02,083766,Tran; Brian Kha,4,0,30,26
1656871600304,MATH 20D,A03,083767,Tran; Brian Kha,2,0,30,28
1656871606331,MATH 20E,A01,083771,Ganguly; Soumya,5,0,32,27
1656871606331,MATH 20E,A02,083772,Ganguly; Soumya,6,0,32,26
1656871606331,MATH 20E,B01,083773,Ciotti; Benjamin,18,0,35,17
1656871606331,MATH 20E,B02,083774,Ciotti; Benjamin,17,0,35,18
1656871612356,MATH 103A,A01,083777,Greenfeld; Be'Eri,2,0,36,34
1656871612356,MATH 103A,A02,083778,Greenfeld; Be'Eri,5,0,36,31
1656871612356,MATH 103A,A03,093561,Greenfeld; Be'Eri,4,0,36,32
1656871612356,MATH 103A,B01,083779,Greenfeld; Be'Eri,6,0,36,30
1656871612356,MATH 103A,B02,083780,Greenfeld; Be'Eri,2,0,36,34
1656871612356,MATH 103A,B03,093562,Greenfeld; Be'Eri,2,0,36,34
1656871618383,MATH 105,A01,085443,Carter; Anne Toulson,13,0,35,22
1656871618383,MATH 105,A02,093477,Carter; Anne Toulson,20,0,35,15
1656871624410,MATH 109,A01,083213,Ganzberger; Geoffrey Michael,2,0,34,32
1656871624410,MATH 109,A02,083214,Ganzberger; Geoffrey Michael,2,0,34,32
1656871624410,MATH 109,A03,093478,Ganzberger; Geoffrey Michael,1,0,34,33
1656871624410,MATH 109,B01,083215,Ganzberger; Geoffrey Michael,1,0,32,31
1656871624410,MATH 109,B02,083216,Ganzberger; Geoffrey Michael,1,0,32,31
1656871624410,MATH 109,B03,093479,Ganzberger; Geoffrey Michael,6,0,32,26
1656871630434,MATH 142A,A01,083219,Chow; Bennett,6,0,32,26
1656871630434,MATH 142A,A02,083220,Chow; Bennett,9,0,32,23
1656871630434,MATH 142A,A03,093480,Chow; Bennett,7,0,32,25
1656871630434,MATH 142A,B03,093481,Chow; Bennett,7,0,32,25
1656871630434,MATH 142A,B04,093558,Chow; Bennett,10,0,32,22
1656871630434,MATH 142A,B05,093559,Chow; Bennett,6,0,32,26
1656871636534,MATH 193A,A01,083224,Rotar; Vladimir,6,0,34,28
1656871636534,MATH 193A,A02,083225,Rotar; Vladimir,3,0,34,31
1656871636534,MATH 193A,A03,083781,Rotar; Vladimir,1,0,34,33
1656871636534,MATH 193A,A04,083782,Rotar; Vladimir,6,0,34,28
1656871636534,MATH 193A,A05,093482,Rotar; Vladimir,6,0,34,28
1656871642563,MATH 197,001,091859,McAuley; Julian John,9999,0,9999,0
1656871642563,MATH 197,002,095566,Kedlaya; Kiran S.,9997,0,9999,2
1656871642563,MATH 197,003,095567,Xiao; Ming,9999,0,9999,0
1656871642563,MATH 197,004,095571,Perols; Johan Lars,9998,0,9999,1
1656871649621,COGS 9,A01,083615,Shannon; Kyle Michael,6,0,75,69
1656871655649,COGS 11,A01,083617,Boyle; Mary E. T.,19,0,48,29
1656871661679,COGS 13,A01,083071,Bastos; Amalia Pinkusfeld,8,0,71,63
1656871667704,COGS 14A,A01,092681,Semenuks; Arturs,0,1,100,100
1656871673730,COGS 14B,A01,083073,Cheng; Tzu-Han,5,0,63,58
1656871679753,COGS 17,A01,092677,Semenuks; Arturs,4,0,81,77
1656871685776,COGS 100,A01,083619,Allen; Michael Gordon,15,0,70,55
1656871691798,COGS 101A,A01,083621,Davis; Joshua Daniel,9,0,68,59
1656871697820,COGS 101B,A01,091572,Allen; Michael Gordon,8,0,65,57
1656871703843,COGS 101C,A01,083625,Delgado; Tania,17,0,35,18
1656871709876,COGS 107A,A01,083627,Boyle; Mary E. T.,13,0,60,47
1656871715903,COGS 118A,A01,083075,Gupta; Anjum,15,0,76,61
1656871721927,CSE 3,A50,083646,Miranda; Gregory Joseph,22,0,50,28
1656871727953,CSE 8A,A50,083650,Miranda; Gregory Joseph,17,1,56,39
1656871733984,CSE 11,A01,083080,Cao; Yingjun,4,15,40,36
1656871740012,CSE 12,A01,083652,Krause-Levy; Sophia Louisa,20,1,120,100
1656871746041,CSE 15L,A01,083654,Morris; Justin Loren,8,0,50,42
1656871746041,CSE 15L,A02,083655,Morris; Justin Loren,8,0,50,42
1656871752064,CSE 20,A01,083657,Tran; Khoa Dang,37,0,80,43
1656871758089,CSE 21,A01,095574,Bach; Quang Tran,21,0,48,27
1656871764125,CSE 30,A01,083084,Eldon; John,4,0,80,76
1656871764125,CSE 30,B01,095061,Bhaskar; Nishant,6,0,50,44
1656871770153,CSE 100,A01,083659,Cao; Yingjun,2,4,70,68
1656871776179,CSE 134B,A01,083661,Powell; Thomas Allan,19,0,100,81
1656871782202,CSE 140,A01,083663,Gungor; Onat,14,0,85,71
1656871788235,CSE 140L,A01,083088,Eldon; John,16,0,100,84
1656871794259,CSE 175,A01,083665,Kumar; Rakesh,3,0,25,22
1656871800283,CSE 190,A00,092507,Dubnov; Shlomo,7,0,20,13
1656871806306,ECE 45,A01,083139,Congero; Spencer William,5,0,75,70
1656871812331,ECE 65,A50,083695,Saad; Andrew S,12,0,30,18
1656871812331,ECE 65,A51,095125,Saad; Andrew S,25,0,26,1
1656871818357,ECE 109,A01,091882,Touri; Behrouz,16,0,70,54
1656871824380,ECE 180,A00,083140,Abi Samra; Nicholas Camill,0,0,30,30
1656871824380,ECE 180,B00,083141,Abi Samra; Nicholas Camill,0,0,30,30
1656871830405,MATH 10A,A01,083735,Patchell; Gregory David,1,0,30,29
1656871830405,MATH 10A,A02,083736,Patchell; Gregory David,20,0,30,10
1656871830405,MATH 10A,A03,083737,Patchell; Gregory David,15,0,30,15
1656871836434,MATH 10B,A01,083207,Lim; Seonhee,7,0,34,27
1656871836434,MATH 10B,A02,083208,Lim; Seonhee,9,0,35,26
1656871836434,MATH 10B,A03,093472,Lim; Seonhee,4,0,34,30
1656871836434,MATH 10B,B01,083739,Sinha; Shubham,9,0,30,21
1656871842462,MATH 18,A01,083743,Cinel; Cameron Alexander,6,0,30,24
1656871842462,MATH 18,A02,083744,Cinel; Cameron Alexander,15,0,30,15
1656871842462,MATH 18,A03,083745,Cinel; Cameron Alexander,8,0,30,22
1656871842462,MATH 18,B01,083748,Rideout; David Porter,3,0,37,34
1656871842462,MATH 18,B02,083749,Rideout; David Porter,3,0,36,33
1656871842462,MATH 18,B03,083750,Rideout; David Porter,2,0,37,35
1656871842462,MATH 18,B04,083751,Rideout; David Porter,5,0,36,31
1656871842462,MATH 18,B05,093473,Rideout; David Porter,4,0,36,32
1656871842462,MATH 18,B06,093474,Rideout; David Porter,5,0,36,31
1656871848493,MATH 20A,A01,083754,Zheng; Zequn,12,0,40,28
1656871854521,MATH 20B,A01,083756,Briones; Jor-el Thomas Caparas,1,0,36,35
1656871854521,MATH 20B,A02,083757,Briones; Jor-el Thomas Caparas,1,0,36,35
1656871854521,MATH 20B,A03,093475,Briones; Jor-el Thomas Caparas,0,0,36,36
1656871860546,MATH 20C,A01,083760,Briones; Jor-el Thomas Caparas,1,0,35,34
1656871860546,MATH 20C,A02,083761,Briones; Jor-el Thomas Caparas,8,0,35,27
1656871860546,MATH 20C,A03,093476,Briones; Jor-el Thomas Caparas,0,1,36,36
1656871860546,MATH 20C,B01,083762,Bach; Quang Tran,0,0,30,30
1656871866569,MATH 20D,A01,083765,Tran; Brian Kha,4,0,30,26
1656871866569,MATH 20D,A02,083766,Tran; Brian Kha,4,0,30,26
1656871866569,MATH 20D,A03,083767,Tran; Brian Kha,2,0,30,28
1656871872596,MATH 20E,A01,083771,Ganguly; Soumya,5,0,32,27
1656871872596,MATH 20E,A02,083772,Ganguly; Soumya,6,0,32,26
1656871872596,MATH 20E,B01,083773,Ciotti; Benjamin,18,0,35,17
1656871872596,MATH 20E,B02,083774,Ciotti; Benjamin,17,0,35,18
1656871878620,MATH 103A,A01,083777,Greenfeld; Be'Eri,2,0,36,34
1656871878620,MATH 103A,A02,083778,Greenfeld; Be'Eri,5,0,36,31
1656871878620,MATH 103A,A03,093561,Greenfeld; Be'Eri,4,0,36,32
1656871878620,MATH 103A,B01,083779,Greenfeld; Be'Eri,6,0,36,30
1656871878620,MATH 103A,B02,083780,Greenfeld; Be'Eri,2,0,36,34
1656871878620,MATH 103A,B03,093562,Greenfeld; Be'Eri,2,0,36,34
1656871884661,MATH 105,A01,085443,Carter; Anne Toulson,13,0,35,22
1656871884661,MATH 105,A02,093477,Carter; Anne Toulson,20,0,35,15
1656871890683,MATH 109,A01,083213,Ganzberger; Geoffrey Michael,2,0,34,32
1656871890683,MATH 109,A02,083214,Ganzberger; Geoffrey Michael,2,0,34,32
1656871890683,MATH 109,A03,093478,Ganzberger; Geoffrey Michael,1,0,34,33
1656871890683,MATH 109,B01,083215,Ganzberger; Geoffrey Michael,1,0,32,31
1656871890683,MATH 109,B02,083216,Ganzberger; Geoffrey Michael,1,0,32,31
1656871890683,MATH 109,B03,093479,Ganzberger; Geoffrey Michael,6,0,32,26
1656871896708,MATH 142A,A01,083219,Chow; Bennett,6,0,32,26
1656871896708,MATH 142A,A02,083220,Chow; Bennett,9,0,32,23
1656871896708,MATH 142A,A03,093480,Chow; Bennett,7,0,32,25
1656871896708,MATH 142A,B03,093481,Chow; Bennett,7,0,32,25
1656871896708,MATH 142A,B04,093558,Chow; Bennett,10,0,32,22
1656871896708,MATH 142A,B05,093559,Chow; Bennett,6,0,32,26
1656871902735,MATH 193A,A01,083224,Rotar; Vladimir,6,0,34,28
1656871902735,MATH 193A,A02,083225,Rotar; Vladimir,3,0,34,31
1656871902735,MATH 193A,A03,083781,Rotar; Vladimir,1,0,34,33
1656871902735,MATH 193A,A04,083782,Rotar; Vladimir,6,0,34,28
1656871902735,MATH 193A,A05,093482,Rotar; Vladimir,6,0,34,28
1656871908758,MATH 197,001,091859,McAuley; Julian John,9999,0,9999,0
1656871908758,MATH 197,002,095566,Kedlaya; Kiran S.,9997,0,9999,2
1656871908758,MATH 197,003,095567,Xiao; Ming,9999,0,9999,0
1656871908758,MATH 197,004,095571,Perols; Johan Lars,9998,0,9999,1
1656871915817,COGS 9,A01,083615,Shannon; Kyle Michael,6,0,75,69
1656871921843,COGS 11,A01,083617,Boyle; Mary E. T.,19,0,48,29
1656871927865,COGS 13,A01,083071,Bastos; Amalia Pinkusfeld,8,0,71,63
1656871933892,COGS 14A,A01,092681,Semenuks; Arturs,0,1,100,100
1656871939929,COGS 14B,A01,083073,Cheng; Tzu-Han,5,0,63,58
1656871945952,COGS 17,A01,092677,Semenuks; Arturs,4,0,81,77
1656871951980,COGS 100,A01,083619,Allen; Michael Gordon,15,0,70,55
1656871958007,COGS 101A,A01,083621,Davis; Joshua Daniel,9,0,68,59
1656871964030,COGS 101B,A01,091572,Allen; Michael Gordon,8,0,65,57
1656871970053,COGS 101C,A01,083625,Delgado; Tania,17,0,35,18
1656871976082,COGS 107A,A01,083627,Boyle; Mary E. T.,13,0,60,47
1656871982105,COGS 118A,A01,083075,Gupta; Anjum,15,0,76,61
1656871988129,CSE 3,A50,083646,Miranda; Gregory Joseph,22,0,50,28
1656871994152,CSE 8A,A50,083650,Miranda; Gregory Joseph,17,1,56,39
1656872000175,CSE 11,A01,083080,Cao; Yingjun,4,15,40,36
1656872006198,CSE 12,A01,083652,Krause-Levy; Sophia Louisa,20,1,120,100
1656872012225,CSE 15L,A01,083654,Morris; Justin Loren,8,0,50,42
1656872012225,CSE 15L,A02,083655,Morris; Justin Loren,8,0,50,42
1656872018249,CSE 20,A01,083657,Tran; Khoa Dang,37,0,80,43
1656872024273,CSE 21,A01,095574,Bach; Quang Tran,21,0,48,27
1656872030301,CSE 30,A01,083084,Eldon; John,4,0,80,76
1656872030301,CSE 30,B01,095061,Bhaskar; Nishant,6,0,50,44
1656872036324,CSE 100,A01,083659,Cao; Yingjun,2,4,70,68
1656872042351,CSE 134B,A01,083661,Powell; Thomas Allan,19,0,100,81
1656872048375,CSE 140,A01,083663,Gungor; Onat,14,0,85,71
1656872054398,CSE 140L,A01,083088,Eldon; John,16,0,100,84
1656872060420,CSE 175,A01,083665,Kumar; Rakesh,3,0,25,22
1656872066444,CSE 190,A00,092507,Dubnov; Shlomo,7,0,20,13
1656872072470,ECE 45,A01,083139,Congero; Spencer William,5,0,75,70
1656872078497,ECE 65,A50,083695,Saad; Andrew S,12,0,30,18
1656872078497,ECE 65,A51,095125,Saad; Andrew S,25,0,26,1
1656872084521,ECE 109,A01,091882,Touri; Behrouz,16,0,70,54
1656872090549,ECE 180,A00,083140,Abi Samra; Nicholas Camill,0,0,30,30
1656872090549,ECE 180,B00,083141,Abi Samra; Nicholas Camill,0,0,30,30
1656872096571,MATH 10A,A01,083735,Patchell; Gregory David,1,0,30,29
1656872096571,MATH 10A,A02,083736,Patchell; Gregory David,20,0,30,10
1656872096571,MATH 10A,A03,083737,Patchell; Gregory David,15,0,30,15
1656872102600,MATH 10B,A01,083207,Lim; Seonhee,7,0,34,27
1656872102600,MATH 10B,A02,083208,Lim; Seonhee,9,0,35,26
1656872102600,MATH 10B,A03,093472,Lim; Seonhee,4,0,34,30
1656872102600,MATH 10B,B01,083739,Sinha; Shubham,9,0,30,21
1656872108624,MATH 18,A01,083743,Cinel; Cameron Alexander,6,0,30,24
1656872108624,MATH 18,A02,083744,Cinel; Cameron Alexander,15,0,30,15
1656872108624,MATH 18,A03,083745,Cinel; Cameron Alexander,8,0,30,22
1656872108624,MATH 18,B01,083748,Rideout; David Porter,3,0,37,34
1656872108624,MATH 18,B02,083749,Rideout; David Porter,3,0,36,33
1656872108624,MATH 18,B03,083750,Rideout; David Porter,2,0,37,35
1656872108624,MATH 18,B04,083751,Rideout; David Porter,5,0,36,31
1656872108624,MATH 18,B05,093473,Rideout; David Porter,4,0,36,32
1656872108624,MATH 18,B06,093474,Rideout; David Porter,5,0,36,31
1656872114650,MATH 20A,A01,083754,Zheng; Zequn,12,0,40,28
1656872120675,MATH 20B,A01,083756,Briones; Jor-el Thomas Caparas,1,0,36,35
1656872120675,MATH 20B,A02,083757,Briones; Jor-el Thomas Caparas,1,0,36,35
1656872120675,MATH 20B,A03,093475,Briones; Jor-el Thomas Caparas,0,0,36,36
1656872126704,MATH 20C,A01,083760,Briones; Jor-el Thomas Caparas,1,0,35,34
1656872126704,MATH 20C,A02,083761,Briones; Jor-el Thomas Caparas,8,0,35,27
1656872126704,MATH 20C,A03,093476,Briones; Jor-el Thomas Caparas,0,1,36,36
1656872126704,MATH 20C,B01,083762,Bach; Quang Tran,0,0,30,30
1656872132732,MATH 20D,A01,083765,Tran; Brian Kha,4,0,30,26
1656872132732,MATH 20D,A02,083766,Tran; Brian Kha,4,0,30,26
1656872132732,MATH 20D,A03,083767,Tran; Brian Kha,2,0,30,28
1656872138760,MATH 20E,A01,083771,Ganguly; Soumya,5,0,32,27
1656872138760,MATH 20E,A02,083772,Ganguly; Soumya,6,0,32,26
1656872138760,MATH 20E,B01,083773,Ciotti; Benjamin,18,0,35,17
1656872138760,MATH 20E,B02,083774,Ciotti; Benjamin,17,0,35,18
1656872144790,MATH 103A,A01,083777,Greenfeld; Be'Eri,2,0,36,34
1656872144790,MATH 103A,A02,083778,Greenfeld; Be'Eri,5,0,36,31
1656872144790,MATH 103A,A03,093561,Greenfeld; Be'Eri,4,0,36,32
1656872144790,MATH 103A,B01,083779,Greenfeld; Be'Eri,6,0,36,30
1656872144790,MATH 103A,B02,083780,Greenfeld; Be'Eri,2,0,36,34
1656872144790,MATH 103A,B03,093562,Greenfeld; Be'Eri,2,0,36,34
1656872150817,MATH 105,A01,085443,Carter; Anne Toulson,13,0,35,22
1656872150817,MATH 105,A02,093477,Carter; Anne Toulson,20,0,35,15
1656872156842,MATH 109,A01,083213,Ganzberger; Geoffrey Michael,2,0,34,32
1656872156842,MATH 109,A02,083214,Ganzberger; Geoffrey Michael,2,0,34,32
1656872156842,MATH 109,A03,093478,Ganzberger; Geoffrey Michael,1,0,34,33
1656872156842,MATH 109,B01,083215,Ganzberger; Geoffrey Michael,1,0,32,31
1656872156842,MATH 109,B02,083216,Ganzberger; Geoffrey Michael,1,0,32,31
1656872156842,MATH 109,B03,093479,Ganzberger; Geoffrey Michael,6,0,32,26
1656872162866,MATH 142A,A01,083219,Chow; Bennett,6,0,32,26
1656872162866,MATH 142A,A02,083220,Chow; Bennett,9,0,32,23
1656872162866,MATH 142A,A03,093480,Chow; Bennett,7,0,32,25
1656872162866,MATH 142A,B03,093481,Chow; Bennett,7,0,32,25
1656872162866,MATH 142A,B04,093558,Chow; Bennett,10,0,32,22
1656872162866,MATH 142A,B05,093559,Chow; Bennett,6,0,32,26
1656872168895,MATH 193A,A01,083224,Rotar; Vladimir,6,0,34,28
1656872168895,MATH 193A,A02,083225,Rotar; Vladimir,3,0,34,31
1656872168895,MATH 193A,A03,083781,Rotar; Vladimir,1,0,34,33
1656872168895,MATH 193A,A04,083782,Rotar; Vladimir,6,0,34,28
1656872168895,MATH 193A,A05,093482,Rotar; Vladimir,6,0,34,28
1656872174925,MATH 197,001,091859,McAuley; Julian John,9999,0,9999,0
1656872174925,MATH 197,002,095566,Kedlaya; Kiran S.,9997,0,9999,2
1656872174925,MATH 197,003,095567,Xiao; Ming,9999,0,9999,0
1656872174925,MATH 197,004,095571,Perols; Johan Lars,9998,0,9999,1
1656872181987,COGS 9,A01,083615,Shannon; Kyle Michael,6,0,75,69
1656872188010,COGS 11,A01,083617,Boyle; Mary E. T.,19,0,48,29
1656872194034,COGS 13,A01,083071,Bastos; Amalia Pinkusfeld,8,0,71,63
1656872200061,COGS 14A,A01,092681,Semenuks; Arturs,0,1,100,100
1656872206088,COGS 14B,A01,083073,Cheng; Tzu-Han,5,0,63,58
1656872212110,COGS 17,A01,092677,Semenuks; Arturs,4,0,81,77
1656872218134,COGS 100,A01,083619,Allen; Michael Gordon,15,0,70,55
1656872224161,COGS 101A,A01,083621,Davis; Joshua Daniel,9,0,68,59
1656872230253,COGS 101B,A01,091572,Allen; Michael Gordon,8,0,65,57
1656872236281,COGS 101C,A01,083625,Delgado; Tania,17,0,35,18
1656872242305,COGS 107A,A01,083627,Boyle; Mary E. T.,13,0,60,47
1656872248329,COGS 118A,A01,083075,Gupta; Anjum,15,0,76,61
1656872254352,CSE 3,A50,083646,Miranda; Gregory Joseph,22,0,50,28
1656872260375,CSE 8A,A50,083650,Miranda; Gregory Joseph,17,1,56,39
1656872266401,CSE 11,A01,083080,Cao; Yingjun,4,15,40,36
1656872272423,CSE 12,A01,083652,Krause-Levy; Sophia Louisa,20,1,120,100
1656872278445,CSE 15L,A01,083654,Morris; Justin Loren,8,0,50,42
1656872278445,CSE 15L,A02,083655,Morris; Justin Loren,8,0,50,42
1656872284476,CSE 20,A01,083657,Tran; Khoa Dang,37,0,80,43
1656872290498,CSE 21,A01,095574,Bach; Quang Tran,21,0,48,27
1656872296526,CSE 30,A01,083084,Eldon; John,4,0,80,76
1656872296526,CSE 30,B01,095061,Bhaskar; Nishant,6,0,50,44
1656872302549,CSE 100,A01,083659,Cao; Yingjun,2,4,70,68
1656872308573,CSE 134B,A01,083661,Powell; Thomas Allan,19,0,100,81
1656872314596,CSE 140,A01,083663,Gungor; Onat,14,0,85,71
1656872320624,CSE 140L,A01,083088,Eldon; John,16,0,100,84
1656872326648,CSE 175,A01,083665,Kumar; Rakesh,3,0,25,22
1656872332673,CSE 190,A00,092507,Dubnov; Shlomo,7,0,20,13
1656872338698,ECE 45,A01,083139,Congero; Spencer William,5,0,75,70
1656872344720,ECE 65,A50,083695,Saad; Andrew S,12,0,30,18
1656872344720,ECE 65,A51,095125,Saad; Andrew S,25,0,26,1
1656872350743,ECE 109,A01,091882,Touri; Behrouz,16,0,70,54
1656872356770,ECE 180,A00,083140,Abi Samra; Nicholas Camill,0,0,30,30
1656872356770,ECE 180,B00,083141,Abi Samra; Nicholas Camill,0,0,30,30
1656872362792,MATH 10A,A01,083735,Patchell; Gregory David,1,0,30,29
1656872362792,MATH 10A,A02,083736,Patchell; Gregory David,20,0,30,10
1656872362792,MATH 10A,A03,083737,Patchell; Gregory David,15,0,30,15
1656872368815,MATH 10B,A01,083207,Lim; Seonhee,7,0,34,27
1656872368815,MATH 10B,A02,083208,Lim; Seonhee,9,0,35,26
1656872368815,MATH 10B,A03,093472,Lim; Seonhee,4,0,34,30
1656872368815,MATH 10B,B01,083739,Sinha; Shubham,9,0,30,21
1656872374840,MATH 18,A01,083743,Cinel; Cameron Alexander,6,0,30,24
1656872374840,MATH 18,A02,083744,Cinel; Cameron Alexander,15,0,30,15
1656872374840,MATH 18,A03,083745,Cinel; Cameron Alexander,8,0,30,22
1656872374840,MATH 18,B01,083748,Rideout; David Porter,3,0,37,34
1656872374840,MATH 18,B02,083749,Rideout; David Porter,3,0,36,33
1656872374840,MATH 18,B03,083750,Rideout; David Porter,2,0,37,35
1656872374840,MATH 18,B04,083751,Rideout; David Porter,5,0,36,31
1656872374840,MATH 18,B05,093473,Rideout; David Porter,4,0,36,32
1656872374840,MATH 18,B06,093474,Rideout; David Porter,5,0,36,31
1656872380866,MATH 20A,A01,083754,Zheng; Zequn,12,0,40,28
1656872386899,MATH 20B,A01,083756,Briones; Jor-el Thomas Caparas,1,0,36,35
1656872386899,MATH 20B,A02,083757,Briones; Jor-el Thomas Caparas,1,0,36,35
1656872386899,MATH 20B,A03,093475,Briones; Jor-el Thomas Caparas,0,0,36,36
1656872392921,MATH 20C,A01,083760,Briones; Jor-el Thomas Caparas,1,0,35,34
1656872392921,MATH 20C,A02,083761,Briones; Jor-el Thomas Caparas,8,0,35,27
1656872392921,MATH 20C,A03,093476,Briones; Jor-el Thomas Caparas,0,1,36,36
1656872392921,MATH 20C,B01,083762,Bach; Quang Tran,0,0,30,30
1656872398949,MATH 20D,A01,083765,Tran; Brian Kha,4,0,30,26
1656872398949,MATH 20D,A02,083766,Tran; Brian Kha,4,0,30,26
1656872398949,MATH 20D,A03,083767,Tran; Brian Kha,2,0,30,28
1656872404978,MATH 20E,A01,083771,Ganguly; Soumya,5,0,32,27
1656872404978,MATH 20E,A02,083772,Ganguly; Soumya,6,0,32,26
1656872404978,MATH 20E,B01,083773,Ciotti; Benjamin,18,0,35,17
1656872404978,MATH 20E,B02,083774,Ciotti; Benjamin,17,0,35,18
1656872411008,MATH 103A,A01,083777,Greenfeld; Be'Eri,2,0,36,34
1656872411008,MATH 103A,A02,083778,Greenfeld; Be'Eri,5,0,36,31
1656872411008,MATH 103A,A03,093561,Greenfeld; Be'Eri,4,0,36,32
1656872411008,MATH 103A,B01,083779,Greenfeld; Be'Eri,6,0,36,30
1656872411008,MATH 103A,B02,083780,Greenfeld; Be'Eri,2,0,36,34
1656872411008,MATH 103A,B03,093562,Greenfeld; Be'Eri,2,0,36,34
1656872417030,MATH 105,A01,085443,Carter; Anne Toulson,13,0,35,22
1656872417030,MATH 105,A02,093477,Carter; Anne Toulson,20,0,35,15
1656872423053,MATH 109,A01,083213,Ganzberger; Geoffrey Michael,2,0,34,32
1656872423053,MATH 109,A02,083214,Ganzberger; Geoffrey Michael,2,0,34,32
1656872423053,MATH 109,A03,093478,Ganzberger; Geoffrey Michael,1,0,34,33
1656872423053,MATH 109,B01,083215,Ganzberger; Geoffrey Michael,1,0,32,31
1656872423053,MATH 109,B02,083216,Ganzberger; Geoffrey Michael,1,0,32,31
1656872423053,MATH 109,B03,093479,Ganzberger; Geoffrey Michael,6,0,32,26
1656872429078,MATH 142A,A01,083219,Chow; Bennett,6,0,32,26
1656872429078,MATH 142A,A02,083220,Chow; Bennett,9,0,32,23
1656872429078,MATH 142A,A03,093480,Chow; Bennett,7,0,32,25
1656872429078,MATH 142A,B03,093481,Chow; Bennett,7,0,32,25
1656872429078,MATH 142A,B04,093558,Chow; Bennett,10,0,32,22
1656872429078,MATH 142A,B05,093559,Chow; Bennett,6,0,32,26
1656872435102,MATH 193A,A01,083224,Rotar; Vladimir,6,0,34,28
1656872435102,MATH 193A,A02,083225,Rotar; Vladimir,3,0,34,31
1656872435102,MATH 193A,A03,083781,Rotar; Vladimir,1,0,34,33
1656872435102,MATH 193A,A04,083782,Rotar; Vladimir,6,0,34,28
1656872435102,MATH 193A,A05,093482,Rotar; Vladimir,6,0,34,28
1656872441128,MATH 197,001,091859,McAuley; Julian John,9999,0,9999,0
1656872441128,MATH 197,002,095566,Kedlaya; Kiran S.,9997,0,9999,2
1656872441128,MATH 197,003,095567,Xiao; Ming,9999,0,9999,0
1656872441128,MATH 197,004,095571,Perols; Johan Lars,9998,0,9999,1
1656872448198,COGS 9,A01,083615,Shannon; Kyle Michael,6,0,75,69
1656872454234,COGS 11,A01,083617,Boyle; Mary E. T.,19,0,48,29
1656872460256,COGS 13,A01,083071,Bastos; Amalia Pinkusfeld,8,0,71,63
1656872466288,COGS 14A,A01,092681,Semenuks; Arturs,0,1,100,100
1656872472315,COGS 14B,A01,083073,Cheng; Tzu-Han,5,0,63,58
1656872478341,COGS 17,A01,092677,Semenuks; Arturs,4,0,81,77
1656872484367,COGS 100,A01,083619,Allen; Michael Gordon,15,0,70,55
1656872490391,COGS 101A,A01,083621,Davis; Joshua Daniel,9,0,68,59
1656872496416,COGS 101B,A01,091572,Allen; Michael Gordon,8,0,65,57
1656872502443,COGS 101C,A01,083625,Delgado; Tania,17,0,35,18
1656872508465,COGS 107A,A01,083627,Boyle; Mary E. T.,13,0,60,47
1656872514494,COGS 118A,A01,083075,Gupta; Anjum,15,0,76,61
1656872520521,CSE 3,A50,083646,Miranda; Gregory Joseph,22,0,50,28
1656872526548,CSE 8A,A50,083650,Miranda; Gregory Joseph,17,1,56,39
1656872532570,CSE 11,A01,083080,Cao; Yingjun,4,15,40,36
1656872538596,CSE 12,A01,083652,Krause-Levy; Sophia Louisa,20,1,120,100
1656872544620,CSE 15L,A01,083654,Morris; Justin Loren,8,0,50,42
1656872544620,CSE 15L,A02,083655,Morris; Justin Loren,8,0,50,42
1656872550643,CSE 20,A01,083657,Tran; Khoa Dang,37,0,80,43
1656872556676,CSE 21,A01,095574,Bach; Quang Tran,21,0,48,27
1656872562699,CSE 30,A01,083084,Eldon; John,4,0,80,76
1656872562699,CSE 30,B01,095061,Bhaskar; Nishant,6,0,50,44
1656872568730,CSE 100,A01,083659,Cao; Yingjun,2,4,70,68
1656872574757,CSE 134B,A01,083661,Powell; Thomas Allan,19,0,100,81
1656872580781,CSE 140,A01,083663,Gungor; Onat,14,0,85,71
1656872586804,CSE 140L,A01,083088,Eldon; John,16,0,100,84
1656872592829,CSE 175,A01,083665,Kumar; Rakesh,3,0,25,22
1656872598855,CSE 190,A00,092507,Dubnov; Shlomo,7,0,20,13
1656872604877,ECE 45,A01,083139,Congero; Spencer William,5,0,75,70
1656872610905,ECE 65,A50,083695,Saad; Andrew S,12,0,30,18
1656872610905,ECE 65,A51,095125,Saad; Andrew S,25,0,26,1
1656872616934,ECE 109,A01,091882,Touri; Behrouz,16,0,70,54
1656872622958,ECE 180,A00,083140,Abi Samra; Nicholas Camill,0,0,30,30
1656872622958,ECE 180,B00,083141,Abi Samra; Nicholas Camill,0,0,30,30
1656872628985,MATH 10A,A01,083735,Patchell; Gregory David,1,0,30,29
1656872628985,MATH 10A,A02,083736,Patchell; Gregory David,20,0,30,10
1656872628985,MATH 10A,A03,083737,Patchell; Gregory David,15,0,30,15
1656872635013,MATH 10B,A01,083207,Lim; Seonhee,7,0,34,27
1656872635013,MATH 10B,A02,083208,Lim; Seonhee,9,0,35,26
1656872635013,MATH 10B,A03,093472,Lim; Seonhee,4,0,34,30
1656872635013,MATH 10B,B01,083739,Sinha; Shubham,9,0,30,21
1656872641045,MATH 18,A01,083743,Cinel; Cameron Alexander,6,0,30,24
1656872641045,MATH 18,A02,083744,Cinel; Cameron Alexander,15,0,30,15
1656872641045,MATH 18,A03,083745,Cinel; Cameron Alexander,8,0,30,22
1656872641045,MATH 18,B01,083748,Rideout; David Porter,3,0,37,34
1656872641045,MATH 18,B02,083749,Rideout; David Porter,3,0,36,33
1656872641045,MATH 18,B03,083750,Rideout; David Porter,2,0,37,35
1656872641045,MATH 18,B04,083751,Rideout; David Porter,5,0,36,31
1656872641045,MATH 18,B05,093473,Rideout; David Porter,4,0,36,32
1656872641045,MATH 18,B06,093474,Rideout; David Porter,5,0,36,31
1656872647068,MATH 20A,A01,083754,Zheng; Zequn,12,0,40,28
1656872653098,MATH 20B,A01,083756,Briones; Jor-el Thomas Caparas,1,0,36,35
1656872653098,MATH 20B,A02,083757,Briones; Jor-el Thomas Caparas,1,0,36,35
1656872653098,MATH 20B,A03,093475,Briones; Jor-el Thomas Caparas,0,0,36,36
1656872659121,MATH 20C,A01,083760,Briones; Jor-el Thomas Caparas,1,0,35,34
1656872659121,MATH 20C,A02,083761,Briones; Jor-el Thomas Caparas,8,0,35,27
1656872659121,MATH 20C,A03,093476,Briones; Jor-el Thomas Caparas,0,1,36,36
1656872659121,MATH 20C,B01,083762,Bach; Quang Tran,0,0,30,30
1656872665145,MATH 20D,A01,083765,Tran; Brian Kha,4,0,30,26
1656872665145,MATH 20D,A02,083766,Tran; Brian Kha,4,0,30,26
1656872665145,MATH 20D,A03,083767,Tran; Brian Kha,2,0,30,28
1656872671170,MATH 20E,A01,083771,Ganguly; Soumya,5,0,32,27
1656872671170,MATH 20E,A02,083772,Ganguly; Soumya,6,0,32,26
1656872671170,MATH 20E,B01,083773,Ciotti; Benjamin,18,0,35,17
1656872671170,MATH 20E,B02,083774,Ciotti; Benjamin,17,0,35,18
1656872677199,MATH 103A,A01,083777,Greenfeld; Be'Eri,2,0,36,34
1656872677199,MATH 103A,A02,083778,Greenfeld; Be'Eri,5,0,36,31
1656872677199,MATH 103A,A03,093561,Greenfeld; Be'Eri,4,0,36,32
1656872677199,MATH 103A,B01,083779,Greenfeld; Be'Eri,6,0,36,30
1656872677199,MATH 103A,B02,083780,Greenfeld; Be'Eri,2,0,36,34
1656872677199,MATH 103A,B03,093562,Greenfeld; Be'Eri,2,0,36,34
1656872683224,MATH 105,A01,085443,Carter; Anne Toulson,13,0,35,22
1656872683224,MATH 105,A02,093477,Carter; Anne Toulson,20,0,35,15
1656872689252,MATH 109,A01,083213,Ganzberger; Geoffrey Michael,2,0,34,32
1656872689252,MATH 109,A02,083214,Ganzberger; Geoffrey Michael,2,0,34,32
1656872689252,MATH 109,A03,093478,Ganzberger; Geoffrey Michael,1,0,34,33
1656872689252,MATH 109,B01,083215,Ganzberger; Geoffrey Michael,1,0,32,31
1656872689252,MATH 109,B02,083216,Ganzberger; Geoffrey Michael,1,0,32,31
1656872689252,MATH 109,B03,093479,Ganzberger; Geoffrey Michael,6,0,32,26
1656872695274,MATH 142A,A01,083219,Chow; Bennett,6,0,32,26
1656872695274,MATH 142A,A02,083220,Chow; Bennett,9,0,32,23
1656872695274,MATH 142A,A03,093480,Chow; Bennett,7,0,32,25
1656872695274,MATH 142A,B03,093481,Chow; Bennett,7,0,32,25
1656872695274,MATH 142A,B04,093558,Chow; Bennett,10,0,32,22
1656872695274,MATH 142A,B05,093559,Chow; Bennett,6,0,32,26
1656872701300,MATH 193A,A01,083224,Rotar; Vladimir,6,0,34,28
1656872701300,MATH 193A,A02,083225,Rotar; Vladimir,3,0,34,31
1656872701300,MATH 193A,A03,083781,Rotar; Vladimir,1,0,34,33
1656872701300,MATH 193A,A04,083782,Rotar; Vladimir,6,0,34,28
1656872701300,MATH 193A,A05,093482,Rotar; Vladimir,6,0,34,28
1656872707326,MATH 197,001,091859,McAuley; Julian John,9999,0,9999,0
1656872707326,MATH 197,002,095566,Kedlaya; Kiran S.,9997,0,9999,2
1656872707326,MATH 197,003,095567,Xiao; Ming,9999,0,9999,0
1656872707326,MATH 197,004,095571,Perols; Johan Lars,9998,0,9999,1
1656872714387,COGS 9,A01,083615,Shannon; Kyle Michael,6,0,75,69
1656872720418,COGS 11,A01,083617,Boyle; Mary E. T.,19,0,48,29
1656872726440,COGS 13,A01,083071,Bastos; Amalia Pinkusfeld,8,0,71,63
1656872732469,COGS 14A,A01,092681,Semenuks; Arturs,0,1,100,100
1656872738495,COGS 14B,A01,083073,Cheng; Tzu-Han,5,0,63,58
1656872744518,COGS 17,A01,092677,Semenuks; Arturs,4,0,81,77
1656872750541,COGS 100,A01,083619,Allen; Michael Gordon,15,0,70,55
1656872756565,COGS 101A,A01,083621,Davis; Joshua Daniel,9,0,68,59
1656872762596,COGS 101B,A01,091572,Allen; Michael Gordon,8,0,65,57
1656872768623,COGS 101C,A01,083625,Delgado; Tania,17,0,35,18
1656872774650,COGS 107A,A01,083627,Boyle; Mary E. T.,13,0,60,47
1656872780673,COGS 118A,A01,083075,Gupta; Anjum,15,0,76,61
1656872786695,CSE 3,A50,083646,Miranda; Gregory Joseph,22,0,50,28
1656872792724,CSE 8A,A50,083650,Miranda; Gregory Joseph,17,1,56,39
1656872798755,CSE 11,A01,083080,Cao; Yingjun,4,15,40,36
1656872804778,CSE 12,A01,083652,Krause-Levy; Sophia Louisa,20,1,120,100
1656872810803,CSE 15L,A01,083654,Morris; Justin Loren,8,0,50,42
1656872810803,CSE 15L,A02,083655,Morris; Justin Loren,8,0,50,42
1656872816834,CSE 20,A01,083657,Tran; Khoa Dang,37,0,80,43
1656872822857,CSE 21,A01,095574,Bach; Quang Tran,21,0,48,27
1656872828953,CSE 30,A01,083084,Eldon; John,4,0,80,76
1656872828953,CSE 30,B01,095061,Bhaskar; Nishant,6,0,50,44
1656872834976,CSE 100,A01,083659,Cao; Yingjun,2,4,70,68
1656872840999,CSE 134B,A01,083661,Powell; Thomas Allan,19,0,100,81
1656872847026,CSE 140,A01,083663,Gungor; Onat,14,0,85,71
1656872853053,CSE 140L,A01,083088,Eldon; John,16,0,100,84
1656872859077,CSE 175,A01,083665,Kumar; Rakesh,3,0,25,22
1656872865099,CSE 190,A00,092507,Dubnov; Shlomo,7,0,20,13
1656872871128,ECE 45,A01,083139,Congero; Spencer William,5,0,75,70
1656872877151,ECE 65,A50,083695,Saad; Andrew S,12,0,30,18
1656872877151,ECE 65,A51,095125,Saad; Andrew S,25,0,26,1
1656872883174,ECE 109,A01,091882,Touri; Behrouz,16,0,70,54
1656872889197,ECE 180,A00,083140,Abi Samra; Nicholas Camill,0,0,30,30
1656872889197,ECE 180,B00,083141,Abi Samra; Nicholas Camill,0,0,30,30
1656872895218,MATH 10A,A01,083735,Patchell; Gregory David,1,0,30,29
1656872895218,MATH 10A,A02,083736,Patchell; Gregory David,20,0,30,10
1656872895218,MATH 10A,A03,083737,Patchell; Gregory David,15,0,30,15
1656872901242,MATH 10B,A01,083207,Lim; Seonhee,7,0,34,27
1656872901242,MATH 10B,A02,083208,Lim; Seonhee,9,0,35,26
1656872901242,MATH 10B,A03,093472,Lim; Seonhee,4,0,34,30
1656872901242,MATH 10B,B01,083739,Sinha; Shubham,9,0,30,21
1656872907269,MATH 18,A01,083743,Cinel; Cameron Alexander,6,0,30,24
1656872907269,MATH 18,A02,083744,Cinel; Cameron Alexander,15,0,30,15
1656872907269,MATH 18,A03,083745,Cinel; Cameron Alexander,8,0,30,22
1656872907269,MATH 18,B01,083748,Rideout; David Porter,3,0,37,34
1656872907269,MATH 18,B02,083749,Rideout; David Porter,3,0,36,33
1656872907269,MATH 18,B03,083750,Rideout; David Porter,2,0,37,35
1656872907269,MATH 18,B04,083751,Rideout; David Porter,5,0,36,31
1656872907269,MATH 18,B05,093473,Rideout; David Porter,4,0,36,32
1656872907269,MATH 18,B06,093474,Rideout; David Porter,5,0,36,31
1656872913290,MATH 20A,A01,083754,Zheng; Zequn,12,0,40,28
1656872919317,MATH 20B,A01,083756,Briones; Jor-el Thomas Caparas,1,0,36,35
1656872919317,MATH 20B,A02,083757,Briones; Jor-el Thomas Caparas,1,0,36,35
1656872919317,MATH 20B,A03,093475,Briones; Jor-el Thomas Caparas,0,0,36,36
1656872925350,MATH 20C,A01,083760,Briones; Jor-el Thomas Caparas,1,0,35,34
1656872925350,MATH 20C,A02,083761,Briones; Jor-el Thomas Caparas,8,0,35,27
1656872925350,MATH 20C,A03,093476,Briones; Jor-el Thomas Caparas,0,1,36,36
1656872925350,MATH 20C,B01,083762,Bach; Quang Tran,0,0,30,30
1656872931379,MATH 20D,A01,083765,Tran; Brian Kha,4,0,30,26
1656872931379,MATH 20D,A02,083766,Tran; Brian Kha,4,0,30,26
1656872931379,MATH 20D,A03,083767,Tran; Brian Kha,2,0,30,28
1656872937403,MATH 20E,A01,083771,Ganguly; Soumya,5,0,32,27
1656872937403,MATH 20E,A02,083772,Ganguly; Soumya,6,0,32,26
1656872937403,MATH 20E,B01,083773,Ciotti; Benjamin,18,0,35,17
1656872937403,MATH 20E,B02,083774,Ciotti; Benjamin,17,0,35,18
1656872943431,MATH 103A,A01,083777,Greenfeld; Be'Eri,2,0,36,34
1656872943431,MATH 103A,A02,083778,Greenfeld; Be'Eri,5,0,36,31
1656872943431,MATH 103A,A03,093561,Greenfeld; Be'Eri,4,0,36,32
1656872943431,MATH 103A,B01,083779,Greenfeld; Be'Eri,6,0,36,30
1656872943431,MATH 103A,B02,083780,Greenfeld; Be'Eri,2,0,36,34
1656872943431,MATH 103A,B03,093562,Greenfeld; Be'Eri,2,0,36,34
1656872949453,MATH 105,A01,085443,Carter; Anne Toulson,13,0,35,22
1656872949453,MATH 105,A02,093477,Carter; Anne Toulson,20,0,35,15
1656872955477,MATH 109,A01,083213,Ganzberger; Geoffrey Michael,2,0,34,32
1656872955477,MATH 109,A02,083214,Ganzberger; Geoffrey Michael,2,0,34,32
1656872955477,MATH 109,A03,093478,Ganzberger; Geoffrey Michael,1,0,34,33
1656872955477,MATH 109,B01,083215,Ganzberger; Geoffrey Michael,1,0,32,31
1656872955477,MATH 109,B02,083216,Ganzberger; Geoffrey Michael,1,0,32,31
1656872955477,MATH 109,B03,093479,Ganzberger; Geoffrey Michael,6,0,32,26
1656872961507,MATH 142A,A01,083219,Chow; Bennett,6,0,32,26
1656872961507,MATH 142A,A02,083220,Chow; Bennett,9,0,32,23
1656872961507,MATH 142A,A03,093480,Chow; Bennett,7,0,32,25
1656872961507,MATH 142A,B03,093481,Chow; Bennett,7,0,32,25
1656872961507,MATH 142A,B04,093558,Chow; Bennett,10,0,32,22
1656872961507,MATH 142A,B05,093559,Chow; Bennett,6,0,32,26
1656872967541,MATH 193A,A01,083224,Rotar; Vladimir,6,0,34,28
1656872967541,MATH 193A,A02,083225,Rotar; Vladimir,3,0,34,31
1656872967541,MATH 193A,A03,083781,Rotar; Vladimir,1,0,34,33
1656872967541,MATH 193A,A04,083782,Rotar; Vladimir,6,0,34,28
1656872967541,MATH 193A,A05,093482,Rotar; Vladimir,6,0,34,28
1656872973564,MATH 197,001,091859,McAuley; Julian John,9999,0,9999,0
1656872973564,MATH 197,002,095566,Kedlaya; Kiran S.,9997,0,9999,2
1656872973564,MATH 197,003,095567,Xiao; Ming,9999,0,9999,0
1656872973564,MATH 197,004,095571,Perols; Johan Lars,9998,0,9999,1
1656872980618,COGS 9,A01,083615,Shannon; Kyle Michael,6,0,75,69
1656872986641,COGS 11,A01,083617,Boyle; Mary E. T.,19,0,48,29
1656872992663,COGS 13,A01,083071,Bastos; Amalia Pinkusfeld,8,0,71,63
1656872998684,COGS 14A,A01,092681,Semenuks; Arturs,0,1,100,100
1656873004710,COGS 14B,A01,083073,Cheng; Tzu-Han,5,0,63,58
1656873010731,COGS 17,A01,092677,Semenuks; Arturs,4,0,81,77
1656873016755,COGS 100,A01,083619,Allen; Michael Gordon,15,0,70,55
1656873022788,COGS 101A,A01,083621,Davis; Joshua Daniel,9,0,68,59
1656873028809,COGS 101B,A01,091572,Allen; Michael Gordon,8,0,65,57
1656873034836,COGS 101C,A01,083625,Delgado; Tania,17,0,35,18
1656873040856,COGS 107A,A01,083627,Boyle; Mary E. T.,13,0,60,47
1656873046883,COGS 118A,A01,083075,Gupta; Anjum,15,0,76,61
1656873052910,CSE 3,A50,083646,Miranda; Gregory Joseph,22,0,50,28
1656873058931,CSE 8A,A50,083650,Miranda; Gregory Joseph,17,1,56,39
1656873064955,CSE 11,A01,083080,Cao; Yingjun,4,15,40,36
1656873070977,CSE 12,A01,083652,Krause-Levy; Sophia Louisa,20,1,120,100
1656873077002,CSE 15L,A01,083654,Morris; Justin Loren,8,0,50,42
1656873077002,CSE 15L,A02,083655,Morris; Justin Loren,8,0,50,42
1656873083026,CSE 20,A01,083657,Tran; Khoa Dang,37,0,80,43
1656873089049,CSE 21,A01,095574,Bach; Quang Tran,21,0,48,27
1656873095072,CSE 30,A01,083084,Eldon; John,4,0,80,76
1656873095072,CSE 30,B01,095061,Bhaskar; Nishant,6,0,50,44
1656873101095,CSE 100,A01,083659,Cao; Yingjun,2,4,70,68
1656873107117,CSE 134B,A01,083661,Powell; Thomas Allan,19,0,100,81
1656873113143,CSE 140,A01,083663,Gungor; Onat,14,0,85,71
1656873119168,CSE 140L,A01,083088,Eldon; John,16,0,100,84
1656873125195,CSE 175,A01,083665,Kumar; Rakesh,3,0,25,22
1656873131220,CSE 190,A00,092507,Dubnov; Shlomo,7,0,20,13
1656873137241,ECE 45,A01,083139,Congero; Spencer William,5,0,75,70
1656873143268,ECE 65,A50,083695,Saad; Andrew S,12,0,30,18
1656873143268,ECE 65,A51,095125,Saad; Andrew S,25,0,26,1
1656873149291,ECE 109,A01,091882,Touri; Behrouz,16,0,70,54
1656873155318,ECE 180,A00,083140,Abi Samra; Nicholas Camill,0,0,30,30
1656873155318,ECE 180,B00,083141,Abi Samra; Nicholas Camill,0,0,30,30
1656873161345,MATH 10A,A01,083735,Patchell; Gregory David,1,0,30,29
1656873161345,MATH 10A,A02,083736,Patchell; Gregory David,20,0,30,10
1656873161345,MATH 10A,A03,083737,Patchell; Gregory David,15,0,30,15
1656873167369,MATH 10B,A01,083207,Lim; Seonhee,7,0,34,27
1656873167369,MATH 10B,A02,083208,Lim; Seonhee,9,0,35,26
1656873167369,MATH 10B,A03,093472,Lim; Seonhee,4,0,34,30
1656873167369,MATH 10B,B01,083739,Sinha; Shubham,9,0,30,21
1656873173394,MATH 18,A01,083743,Cinel; Cameron Alexander,6,0,30,24
1656873173394,MATH 18,A02,083744,Cinel; Cameron Alexander,15,0,30,15
1656873173394,MATH 18,A03,083745,Cinel; Cameron Alexander,8,0,30,22
1656873173394,MATH 18,B01,083748,Rideout; David Porter,3,0,37,34
1656873173394,MATH 18,B02,083749,Rideout; David Porter,3,0,36,33
1656873173394,MATH 18,B03,083750,Rideout; David Porter,2,0,37,35
1656873173394,MATH 18,B04,083751,Rideout; David Porter,5,0,36,31
1656873173394,MATH 18,B05,093473,Rideout; David Porter,4,0,36,32
1656873173394,MATH 18,B06,093474,Rideout; David Porter,5,0,36,31
1656873179416,MATH 20A,A01,083754,Zheng; Zequn,12,0,40,28
1656873185438,MATH 20B,A01,083756,Briones; Jor-el Thomas Caparas,1,0,36,35
1656873185438,MATH 20B,A02,083757,Briones; Jor-el Thomas Caparas,1,0,36,35
1656873185438,MATH 20B,A03,093475,Briones; Jor-el Thomas Caparas,0,0,36,36
1656873191460,MATH 20C,A01,083760,Briones; Jor-el Thomas Caparas,1,0,35,34
1656873191460,MATH 20C,A02,083761,Briones; Jor-el Thomas Caparas,8,0,35,27
1656873191460,MATH 20C,A03,093476,Briones; Jor-el Thomas Caparas,0,1,36,36
1656873191460,MATH 20C,B01,083762,Bach; Quang Tran,0,0,30,30
1656873197486,MATH 20D,A01,083765,Tran; Brian Kha,4,0,30,26
1656873197486,MATH 20D,A02,083766,Tran; Brian Kha,4,0,30,26
1656873197486,MATH 20D,A03,083767,Tran; Brian Kha,2,0,30,28
1656873203510,MATH 20E,A01,083771,Ganguly; Soumya,5,0,32,27
1656873203510,MATH 20E,A02,083772,Ganguly; Soumya,6,0,32,26
1656873203510,MATH 20E,B01,083773,Ciotti; Benjamin,18,0,35,17
1656873203510,MATH 20E,B02,083774,Ciotti; Benjamin,17,0,35,18
1656873209533,MATH 103A,A01,083777,Greenfeld; Be'Eri,2,0,36,34
1656873209533,MATH 103A,A02,083778,Greenfeld; Be'Eri,5,0,36,31
1656873209533,MATH 103A,A03,093561,Greenfeld; Be'Eri,4,0,36,32
1656873209533,MATH 103A,B01,083779,Greenfeld; Be'Eri,6,0,36,30
1656873209533,MATH 103A,B02,083780,Greenfeld; Be'Eri,2,0,36,34
1656873209533,MATH 103A,B03,093562,Greenfeld; Be'Eri,2,0,36,34
1656873215568,MATH 105,A01,085443,Carter; Anne Toulson,13,0,35,22
1656873215568,MATH 105,A02,093477,Carter; Anne Toulson,20,0,35,15
1656873221591,MATH 109,A01,083213,Ganzberger; Geoffrey Michael,2,0,34,32
1656873221591,MATH 109,A02,083214,Ganzberger; Geoffrey Michael,2,0,34,32
1656873221591,MATH 109,A03,093478,Ganzberger; Geoffrey Michael,1,0,34,33
1656873221591,MATH 109,B01,083215,Ganzberger; Geoffrey Michael,1,0,32,31
1656873221591,MATH 109,B02,083216,Ganzberger; Geoffrey Michael,1,0,32,31
1656873221591,MATH 109,B03,093479,Ganzberger; Geoffrey Michael,6,0,32,26
1656873227614,MATH 142A,A01,083219,Chow; Bennett,6,0,32,26
1656873227614,MATH 142A,A02,083220,Chow; Bennett,9,0,32,23
1656873227614,MATH 142A,A03,093480,Chow; Bennett,7,0,32,25
1656873227614,MATH 142A,B03,093481,Chow; Bennett,7,0,32,25
1656873227614,MATH 142A,B04,093558,Chow; Bennett,10,0,32,22
1656873227614,MATH 142A,B05,093559,Chow; Bennett,6,0,32,26
1656873233642,MATH 193A,A01,083224,Rotar; Vladimir,6,0,34,28
1656873233642,MATH 193A,A02,083225,Rotar; Vladimir,3,0,34,31
1656873233642,MATH 193A,A03,083781,Rotar; Vladimir,1,0,34,33
1656873233642,MATH 193A,A04,083782,Rotar; Vladimir,6,0,34,28
1656873233642,MATH 193A,A05,093482,Rotar; Vladimir,6,0,34,28
1656873239668,MATH 197,001,091859,McAuley; Julian John,9999,0,9999,0
1656873239668,MATH 197,002,095566,Kedlaya; Kiran S.,9997,0,9999,2
1656873239668,MATH 197,003,095567,Xiao; Ming,9999,0,9999,0
1656873239668,MATH 197,004,095571,Perols; Johan Lars,9998,0,9999,1
1656873246727,COGS 9,A01,083615,Shannon; Kyle Michael,6,0,75,69
1656873252755,COGS 11,A01,083617,Boyle; Mary E. T.,19,0,48,29
1656873258778,COGS 13,A01,083071,Bastos; Amalia Pinkusfeld,8,0,71,63
1656873264802,COGS 14A,A01,092681,Semenuks; Arturs,0,1,100,100
1656873270827,COGS 14B,A01,083073,Cheng; Tzu-Han,5,0,63,58
1656873276853,COGS 17,A01,092677,Semenuks; Arturs,4,0,81,77
1656873282877,COGS 100,A01,083619,Allen; Michael Gordon,15,0,70,55
1656873288901,COGS 101A,A01,083621,Davis; Joshua Daniel,9,0,68,59
1656873294925,COGS 101B,A01,091572,Allen; Michael Gordon,8,0,65,57
1656873300948,COGS 101C,A01,083625,Delgado; Tania,17,0,35,18
1656873306969,COGS 107A,A01,083627,Boyle; Mary E. T.,13,0,60,47
1656873312994,COGS 118A,A01,083075,Gupta; Anjum,15,0,76,61
1656873319020,CSE 3,A50,083646,Miranda; Gregory Joseph,22,0,50,28
1656873325048,CSE 8A,A50,083650,Miranda; Gregory Joseph,17,1,56,39
1656873331072,CSE 11,A01,083080,Cao; Yingjun,4,15,40,36
1656873337098,CSE 12,A01,083652,Krause-Levy; Sophia Louisa,20,1,120,100
1656873343124,CSE 15L,A01,083654,Morris; Justin Loren,8,0,50,42
1656873343124,CSE 15L,A02,083655,Morris; Justin Loren,8,0,50,42
1656873349146,CSE 20,A01,083657,Tran; Khoa Dang,37,0,80,43
1656873355169,CSE 21,A01,095574,Bach; Quang Tran,21,0,48,27
1656873361196,CSE 30,A01,083084,Eldon; John,4,0,80,76
1656873361196,CSE 30,B01,095061,Bhaskar; Nishant,6,0,50,44
1656873367223,CSE 100,A01,083659,Cao; Yingjun,2,4,70,68
1656873373255,CSE 134B,A01,083661,Powell; Thomas Allan,19,0,100,81
1656873379276,CSE 140,A01,083663,Gungor; Onat,14,0,85,71
1656873385311,CSE 140L,A01,083088,Eldon; John,16,0,100,84
1656873391335,CSE 175,A01,083665,Kumar; Rakesh,3,0,25,22
1656873397357,CSE 190,A00,092507,Dubnov; Shlomo,7,0,20,13
1656873403380,ECE 45,A01,083139,Congero; Spencer William,5,0,75,70
1656873409406,ECE 65,A50,083695,Saad; Andrew S,12,0,30,18
1656873409406,ECE 65,A51,095125,Saad; Andrew S,25,0,26,1
1656873415428,ECE 109,A01,091882,Touri; Behrouz,16,0,70,54
1656873421458,ECE 180,A00,083140,Abi Samra; Nicholas Camill,0,0,30,30
1656873421458,ECE 180,B00,083141,Abi Samra; Nicholas Camill,0,0,30,30
1656873427560,MATH 10A,A01,083735,Patchell; Gregory David,1,0,30,29
1656873427560,MATH 10A,A02,083736,Patchell; Gregory David,20,0,30,10
1656873427560,MATH 10A,A03,083737,Patchell; Gregory David,15,0,30,15
1656873433584,MATH 10B,A01,083207,Lim; Seonhee,7,0,34,27
1656873433584,MATH 10B,A02,083208,Lim; Seonhee,9,0,35,26
1656873433584,MATH 10B,A03,093472,Lim; Seonhee,4,0,34,30
1656873433584,MATH 10B,B01,083739,Sinha; Shubham,9,0,30,21
1656873439609,MATH 18,A01,083743,Cinel; Cameron Alexander,6,0,30,24
1656873439609,MATH 18,A02,083744,Cinel; Cameron Alexander,15,0,30,15
1656873439609,MATH 18,A03,083745,Cinel; Cameron Alexander,8,0,30,22
1656873439609,MATH 18,B01,083748,Rideout; David Porter,3,0,37,34
1656873439609,MATH 18,B02,083749,Rideout; David Porter,3,0,36,33
1656873439609,MATH 18,B03,083750,Rideout; David Porter,2,0,37,35
1656873439609,MATH 18,B04,083751,Rideout; David Porter,5,0,36,31
1656873439609,MATH 18,B05,093473,Rideout; David Porter,4,0,36,32
1656873439609,MATH 18,B06,093474,Rideout; David Porter,5,0,36,31
1656873445651,MATH 20A,A01,083754,Zheng; Zequn,12,0,40,28
1656873451674,MATH 20B,A01,083756,Briones; Jor-el Thomas Caparas,1,0,36,35
1656873451674,MATH 20B,A02,083757,Briones; Jor-el Thomas Caparas,1,0,36,35
1656873451674,MATH 20B,A03,093475,Briones; Jor-el Thomas Caparas,0,0,36,36
1656873457697,MATH 20C,A01,083760,Briones; Jor-el Thomas Caparas,1,0,35,34
1656873457697,MATH 20C,A02,083761,Briones; Jor-el Thomas Caparas,8,0,35,27
1656873457697,MATH 20C,A03,093476,Briones; Jor-el Thomas Caparas,0,1,36,36
1656873457697,MATH 20C,B01,083762,Bach; Quang Tran,0,0,30,30
1656873463726,MATH 20D,A01,083765,Tran; Brian Kha,4,0,30,26
1656873463726,MATH 20D,A02,083766,Tran; Brian Kha,4,0,30,26
1656873463726,MATH 20D,A03,083767,Tran; Brian Kha,2,0,30,28
1656873469747,MATH 20E,A01,083771,Ganguly; Soumya,5,0,32,27
1656873469747,MATH 20E,A02,083772,Ganguly; Soumya,6,0,32,26
1656873469747,MATH 20E,B01,083773,Ciotti; Benjamin,18,0,35,17
1656873469747,MATH 20E,B02,083774,Ciotti; Benjamin,17,0,35,18
1656873475772,MATH 103A,A01,083777,Greenfeld; Be'Eri,2,0,36,34
1656873475772,MATH 103A,A02,083778,Greenfeld; Be'Eri,5,0,36,31
1656873475772,MATH 103A,A03,093561,Greenfeld; Be'Eri,4,0,36,32
1656873475772,MATH 103A,B01,083779,Greenfeld; Be'Eri,6,0,36,30
1656873475772,MATH 103A,B02,083780,Greenfeld; Be'Eri,2,0,36,34
1656873475772,MATH 103A,B03,093562,Greenfeld; Be'Eri,2,0,36,34
1656873481794,MATH 105,A01,085443,Carter; Anne Toulson,13,0,35,22
1656873481794,MATH 105,A02,093477,Carter; Anne Toulson,20,0,35,15
1656873487821,MATH 109,A01,083213,Ganzberger; Geoffrey Michael,2,0,34,32
1656873487821,MATH 109,A02,083214,Ganzberger; Geoffrey Michael,2,0,34,32
1656873487821,MATH 109,A03,093478,Ganzberger; Geoffrey Michael,1,0,34,33
1656873487821,MATH 109,B01,083215,Ganzberger; Geoffrey Michael,1,0,32,31
1656873487821,MATH 109,B02,083216,Ganzberger; Geoffrey Michael,1,0,32,31
1656873487821,MATH 109,B03,093479,Ganzberger; Geoffrey Michael,6,0,32,26
1656873493844,MATH 142A,A01,083219,Chow; Bennett,6,0,32,26
1656873493844,MATH 142A,A02,083220,Chow; Bennett,9,0,32,23
1656873493844,MATH 142A,A03,093480,Chow; Bennett,7,0,32,25
1656873493844,MATH 142A,B03,093481,Chow; Bennett,7,0,32,25
1656873493844,MATH 142A,B04,093558,Chow; Bennett,10,0,32,22
1656873493844,MATH 142A,B05,093559,Chow; Bennett,6,0,32,26
1656873499866,MATH 193A,A01,083224,Rotar; Vladimir,6,0,34,28
1656873499866,MATH 193A,A02,083225,Rotar; Vladimir,3,0,34,31
1656873499866,MATH 193A,A03,083781,Rotar; Vladimir,1,0,34,33
1656873499866,MATH 193A,A04,083782,Rotar; Vladimir,6,0,34,28
1656873499866,MATH 193A,A05,093482,Rotar; Vladimir,6,0,34,28
1656873505892,MATH 197,001,091859,McAuley; Julian John,9999,0,9999,0
1656873505892,MATH 197,002,095566,Kedlaya; Kiran S.,9997,0,9999,2
1656873505892,MATH 197,003,095567,Xiao; Ming,9999,0,9999,0
1656873505892,MATH 197,004,095571,Perols; Johan Lars,9998,0,9999,1
1656873512957,COGS 9,A01,083615,Shannon; Kyle Michael,6,0,75,69
1656873518979,COGS 11,A01,083617,Boyle; Mary E. T.,19,0,48,29
1656873525006,COGS 13,A01,083071,Bastos; Amalia Pinkusfeld,8,0,71,63
1656873531032,COGS 14A,A01,092681,Semenuks; Arturs,0,1,100,100
1656873537060,COGS 14B,A01,083073,Cheng; Tzu-Han,5,0,63,58
1656873543082,COGS 17,A01,092677,Semenuks; Arturs,4,0,81,77
1656873549107,COGS 100,A01,083619,Allen; Michael Gordon,15,0,70,55
1656873555148,COGS 101A,A01,083621,Davis; Joshua Daniel,9,0,68,59
1656873561171,COGS 101B,A01,091572,Allen; Michael Gordon,8,0,65,57
1656873567195,COGS 101C,A01,083625,Delgado; Tania,17,0,35,18
1656873573223,COGS 107A,A01,083627,Boyle; Mary E. T.,13,0,60,47
1656873579250,COGS 118A,A01,083075,Gupta; Anjum,15,0,76,61
1656873585273,CSE 3,A50,083646,Miranda; Gregory Joseph,22,0,50,28
1656873591297,CSE 8A,A50,083650,Miranda; Gregory Joseph,17,1,56,39
1656873597320,CSE 11,A01,083080,Cao; Yingjun,4,15,40,36
1656873603347,CSE 12,A01,083652,Krause-Levy; Sophia Louisa,20,1,120,100
1656873609370,CSE 15L,A01,083654,Morris; Justin Loren,8,0,50,42
1656873609370,CSE 15L,A02,083655,Morris; Justin Loren,8,0,50,42
1656873615400,CSE 20,A01,083657,Tran; Khoa Dang,37,0,80,43
1656873621422,CSE 21,A01,095574,Bach; Quang Tran,21,0,48,27
1656873627456,CSE 30,A01,083084,Eldon; John,4,0,80,76
1656873627456,CSE 30,B01,095061,Bhaskar; Nishant,6,0,50,44
1656873633483,CSE 100,A01,083659,Cao; Yingjun,2,4,70,68
1656873639511,CSE 134B,A01,083661,Powell; Thomas Allan,19,0,100,81
1656873645535,CSE 140,A01,083663,Gungor; Onat,14,0,85,71
1656873651562,CSE 140L,A01,083088,Eldon; John,16,0,100,84
1656873657588,CSE 175,A01,083665,Kumar; Rakesh,3,0,25,22
1656873663615,CSE 190,A00,092507,Dubnov; Shlomo,7,0,20,13
1656873669642,ECE 45,A01,083139,Congero; Spencer William,5,0,75,70
1656873675669,ECE 65,A50,083695,Saad; Andrew S,12,0,30,18
1656873675669,ECE 65,A51,095125,Saad; Andrew S,25,0,26,1
1656873681692,ECE 109,A01,091882,Touri; Behrouz,16,0,70,54
1656873687719,ECE 180,A00,083140,Abi Samra; Nicholas Camill,0,0,30,30
1656873687719,ECE 180,B00,083141,Abi Samra; Nicholas Camill,0,0,30,30
1656873693743,MATH 10A,A01,083735,Patchell; Gregory David,1,0,30,29
1656873693743,MATH 10A,A02,083736,Patchell; Gregory David,20,0,30,10
1656873693743,MATH 10A,A03,083737,Patchell; Gregory David,15,0,30,15
1656873699772,MATH 10B,A01,083207,Lim; Seonhee,7,0,34,27
1656873699772,MATH 10B,A02,083208,Lim; Seonhee,9,0,35,26
1656873699772,MATH 10B,A03,093472,Lim; Seonhee,4,0,34,30
1656873699772,MATH 10B,B01,083739,Sinha; Shubham,9,0,30,21
1656873705804,MATH 18,A01,083743,Cinel; Cameron Alexander,6,0,30,24
1656873705804,MATH 18,A02,083744,Cinel; Cameron Alexander,15,0,30,15
1656873705804,MATH 18,A03,083745,Cinel; Cameron Alexander,8,0,30,22
1656873705804,MATH 18,B01,083748,Rideout; David Porter,3,0,37,34
1656873705804,MATH 18,B02,083749,Rideout; David Porter,3,0,36,33
1656873705804,MATH 18,B03,083750,Rideout; David Porter,2,0,37,35
1656873705804,MATH 18,B04,083751,Rideout; David Porter,5,0,36,31
1656873705804,MATH 18,B05,093473,Rideout; David Porter,4,0,36,32
1656873705804,MATH 18,B06,093474,Rideout; David Porter,5,0,36,31
1656873711826,MATH 20A,A01,083754,Zheng; Zequn,12,0,40,28
1656873717854,MATH 20B,A01,083756,Briones; Jor-el Thomas Caparas,1,0,36,35
1656873717854,MATH 20B,A02,083757,Briones; Jor-el Thomas Caparas,1,0,36,35
1656873717854,MATH 20B,A03,093475,Briones; Jor-el Thomas Caparas,0,0,36,36
1656873723883,MATH 20C,A01,083760,Briones; Jor-el Thomas Caparas,1,0,35,34
1656873723883,MATH 20C,A02,083761,Briones; Jor-el Thomas Caparas,8,0,35,27
1656873723883,MATH 20C,A03,093476,Briones; Jor-el Thomas Caparas,0,1,36,36
1656873723883,MATH 20C,B01,083762,Bach; Quang Tran,0,0,30,30
1656873729920,MATH 20D,A01,083765,Tran; Brian Kha,4,0,30,26
1656873729920,MATH 20D,A02,083766,Tran; Brian Kha,4,0,30,26
1656873729920,MATH 20D,A03,083767,Tran; Brian Kha,2,0,30,28
1656873735948,MATH 20E,A01,083771,Ganguly; Soumya,5,0,32,27
1656873735948,MATH 20E,A02,083772,Ganguly; Soumya,6,0,32,26
1656873735948,MATH 20E,B01,083773,Ciotti; Benjamin,18,0,35,17
1656873735948,MATH 20E,B02,083774,Ciotti; Benjamin,17,0,35,18
1656873741978,MATH 103A,A01,083777,Greenfeld; Be'Eri,2,0,36,34
1656873741978,MATH 103A,A02,083778,Greenfeld; Be'Eri,5,0,36,31
1656873741978,MATH 103A,A03,093561,Greenfeld; Be'Eri,4,0,36,32
1656873741978,MATH 103A,B01,083779,Greenfeld; Be'Eri,6,0,36,30
1656873741978,MATH 103A,B02,083780,Greenfeld; Be'Eri,2,0,36,34
1656873741978,MATH 103A,B03,093562,Greenfeld; Be'Eri,2,0,36,34
1656873748004,MATH 105,A01,085443,Carter; Anne Toulson,13,0,35,22
1656873748004,MATH 105,A02,093477,Carter; Anne Toulson,20,0,35,15
1656873754041,MATH 109,A01,083213,Ganzberger; Geoffrey Michael,2,0,34,32
1656873754041,MATH 109,A02,083214,Ganzberger; Geoffrey Michael,2,0,34,32
1656873754041,MATH 109,A03,093478,Ganzberger; Geoffrey Michael,1,0,34,33
1656873754041,MATH 109,B01,083215,Ganzberger; Geoffrey Michael,1,0,32,31
1656873754041,MATH 109,B02,083216,Ganzberger; Geoffrey Michael,1,0,32,31
1656873754041,MATH 109,B03,093479,Ganzberger; Geoffrey Michael,6,0,32,26
1656873760069,MATH 142A,A01,083219,Chow; Bennett,6,0,32,26
1656873760069,MATH 142A,A02,083220,Chow; Bennett,9,0,32,23
1656873760069,MATH 142A,A03,093480,Chow; Bennett,7,0,32,25
1656873760069,MATH 142A,B03,093481,Chow; Bennett,7,0,32,25
1656873760069,MATH 142A,B04,093558,Chow; Bennett,10,0,32,22
1656873760069,MATH 142A,B05,093559,Chow; Bennett,6,0,32,26
1656873766097,MATH 193A,A01,083224,Rotar; Vladimir,6,0,34,28
1656873766097,MATH 193A,A02,083225,Rotar; Vladimir,3,0,34,31
1656873766097,MATH 193A,A03,083781,Rotar; Vladimir,1,0,34,33
1656873766097,MATH 193A,A04,083782,Rotar; Vladimir,6,0,34,28
1656873766097,MATH 193A,A05,093482,Rotar; Vladimir,6,0,34,28
1656873772123,MATH 197,001,091859,McAuley; Julian John,9999,0,9999,0
1656873772123,MATH 197,002,095566,Kedlaya; Kiran S.,9997,0,9999,2
1656873772123,MATH 197,003,095567,Xiao; Ming,9999,0,9999,0
1656873772123,MATH 197,004,095571,Perols; Johan Lars,9998,0,9999,1
1656873779187,COGS 9,A01,083615,Shannon; Kyle Michael,6,0,75,69
1656873785213,COGS 11,A01,083617,Boyle; Mary E. T.,19,0,48,29
1656873791235,COGS 13,A01,083071,Bastos; Amalia Pinkusfeld,8,0,71,63
1656873797270,COGS 14A,A01,092681,Semenuks; Arturs,0,1,100,100
1656873803297,COGS 14B,A01,083073,Cheng; Tzu-Han,5,0,63,58
1656873809322,COGS 17,A01,092677,Semenuks; Arturs,4,0,81,77
1656873815352,COGS 100,A01,083619,Allen; Michael Gordon,15,0,70,55
1656873821375,COGS 101A,A01,083621,Davis; Joshua Daniel,9,0,68,59
1656873827398,COGS 101B,A01,091572,Allen; Michael Gordon,8,0,65,57
1656873833423,COGS 101C,A01,083625,Delgado; Tania,17,0,35,18
1656873839446,COGS 107A,A01,083627,Boyle; Mary E. T.,13,0,60,47
1656873845467,COGS 118A,A01,083075,Gupta; Anjum,15,0,76,61
1656873851495,CSE 3,A50,083646,Miranda; Gregory Joseph,22,0,50,28
1656873857516,CSE 8A,A50,083650,Miranda; Gregory Joseph,17,1,56,39
1656873863543,CSE 11,A01,083080,Cao; Yingjun,4,15,40,36
1656873869566,CSE 12,A01,083652,Krause-Levy; Sophia Louisa,20,1,120,100
1656873875589,CSE 15L,A01,083654,Morris; Justin Loren,8,0,50,42
1656873875589,CSE 15L,A02,083655,Morris; Justin Loren,8,0,50,42
1656873881612,CSE 20,A01,083657,Tran; Khoa Dang,37,0,80,43
1656873887639,CSE 21,A01,095574,Bach; Quang Tran,21,0,48,27
1656873893663,CSE 30,A01,083084,Eldon; John,4,0,80,76
1656873893663,CSE 30,B01,095061,Bhaskar; Nishant,6,0,50,44
1656873899686,CSE 100,A01,083659,Cao; Yingjun,2,4,70,68
1656873905709,CSE 134B,A01,083661,Powell; Thomas Allan,19,0,100,81
1656873911738,CSE 140,A01,083663,Gungor; Onat,14,0,85,71
1656873917760,CSE 140L,A01,083088,Eldon; John,16,0,100,84
1656873923783,CSE 175,A01,083665,Kumar; Rakesh,3,0,25,22
1656873929806,CSE 190,A00,092507,Dubnov; Shlomo,7,0,20,13
1656873935832,ECE 45,A01,083139,Congero; Spencer William,5,0,75,70
1656873941864,ECE 65,A50,083695,Saad; Andrew S,12,0,30,18
1656873941864,ECE 65,A51,095125,Saad; Andrew S,25,0,26,1
1656873947887,ECE 109,A01,091882,Touri; Behrouz,16,0,70,54
1656873953909,ECE 180,A00,083140,Abi Samra; Nicholas Camill,0,0,30,30
1656873953909,ECE 180,B00,083141,Abi Samra; Nicholas Camill,0,0,30,30
1656873959932,MATH 10A,A01,083735,Patchell; Gregory David,1,0,30,29
1656873959932,MATH 10A,A02,083736,Patchell; Gregory David,20,0,30,10
1656873959932,MATH 10A,A03,083737,Patchell; Gregory David,15,0,30,15
1656873965964,MATH 10B,A01,083207,Lim; Seonhee,7,0,34,27
1656873965964,MATH 10B,A02,083208,Lim; Seonhee,9,0,35,26
1656873965964,MATH 10B,A03,093472,Lim; Seonhee,4,0,34,30
1656873965964,MATH 10B,B01,083739,Sinha; Shubham,9,0,30,21
1656873971987,MATH 18,A01,083743,Cinel; Cameron Alexander,6,0,30,24
1656873971987,MATH 18,A02,083744,Cinel; Cameron Alexander,15,0,30,15
1656873971987,MATH 18,A03,083745,Cinel; Cameron Alexander,8,0,30,22
1656873971987,MATH 18,B01,083748,Rideout; David Porter,3,0,37,34
1656873971987,MATH 18,B02,083749,Rideout; David Porter,3,0,36,33
1656873971987,MATH 18,B03,083750,Rideout; David Porter,2,0,37,35
1656873971987,MATH 18,B04,083751,Rideout; David Porter,5,0,36,31
1656873971987,MATH 18,B05,093473,Rideout; David Porter,4,0,36,32
1656873971987,MATH 18,B06,093474,Rideout; David Porter,5,0,36,31
1656873978009,MATH 20A,A01,083754,Zheng; Zequn,12,0,40,28
1656873984031,MATH 20B,A01,083756,Briones; Jor-el Thomas Caparas,1,0,36,35
1656873984031,MATH 20B,A02,083757,Briones; Jor-el Thomas Caparas,1,0,36,35
1656873984031,MATH 20B,A03,093475,Briones; Jor-el Thomas Caparas,0,0,36,36
1656873990055,MATH 20C,A01,083760,Briones; Jor-el Thomas Caparas,1,0,35,34
1656873990055,MATH 20C,A02,083761,Briones; Jor-el Thomas Caparas,8,0,35,27
1656873990055,MATH 20C,A03,093476,Briones; Jor-el Thomas Caparas,0,1,36,36
1656873990055,MATH 20C,B01,083762,Bach; Quang Tran,0,0,30,30
1656873996080,MATH 20D,A01,083765,Tran; Brian Kha,4,0,30,26
1656873996080,MATH 20D,A02,083766,Tran; Brian Kha,4,0,30,26
1656873996080,MATH 20D,A03,083767,Tran; Brian Kha,2,0,30,28
1656874002102,MATH 20E,A01,083771,Ganguly; Soumya,5,0,32,27
1656874002102,MATH 20E,A02,083772,Ganguly; Soumya,6,0,32,26
1656874002102,MATH 20E,B01,083773,Ciotti; Benjamin,18,0,35,17
1656874002102,MATH 20E,B02,083774,Ciotti; Benjamin,17,0,35,18
1656874008126,MATH 103A,A01,083777,Greenfeld; Be'Eri,2,0,36,34
1656874008126,MATH 103A,A02,083778,Greenfeld; Be'Eri,5,0,36,31
1656874008126,MATH 103A,A03,093561,Greenfeld; Be'Eri,4,0,36,32
1656874008126,MATH 103A,B01,083779,Greenfeld; Be'Eri,6,0,36,30
1656874008126,MATH 103A,B02,083780,Greenfeld; Be'Eri,2,0,36,34
1656874008126,MATH 103A,B03,093562,Greenfeld; Be'Eri,2,0,36,34
1656874014149,MATH 105,A01,085443,Carter; Anne Toulson,13,0,35,22
1656874014149,MATH 105,A02,093477,Carter; Anne Toulson,20,0,35,15
1656874020186,MATH 109,A01,083213,Ganzberger; Geoffrey Michael,2,0,34,32
1656874020186,MATH 109,A02,083214,Ganzberger; Geoffrey Michael,2,0,34,32
1656874020186,MATH 109,A03,093478,Ganzberger; Geoffrey Michael,1,0,34,33
1656874020186,MATH 109,B01,083215,Ganzberger; Geoffrey Michael,1,0,32,31
1656874020186,MATH 109,B02,083216,Ganzberger; Geoffrey Michael,1,0,32,31
1656874020186,MATH 109,B03,093479,Ganzberger; Geoffrey Michael,6,0,32,26
1656874026291,MATH 142A,A01,083219,Chow; Bennett,6,0,32,26
1656874026291,MATH 142A,A02,083220,Chow; Bennett,9,0,32,23
1656874026291,MATH 142A,A03,093480,Chow; Bennett,7,0,32,25
1656874026291,MATH 142A,B03,093481,Chow; Bennett,7,0,32,25
1656874026291,MATH 142A,B04,093558,Chow; Bennett,10,0,32,22
1656874026291,MATH 142A,B05,093559,Chow; Bennett,6,0,32,26
1656874032320,MATH 193A,A01,083224,Rotar; Vladimir,6,0,34,28
1656874032320,MATH 193A,A02,083225,Rotar; Vladimir,3,0,34,31
1656874032320,MATH 193A,A03,083781,Rotar; Vladimir,1,0,34,33
1656874032320,MATH 193A,A04,083782,Rotar; Vladimir,6,0,34,28
1656874032320,MATH 193A,A05,093482,Rotar; Vladimir,6,0,34,28
1656874038343,MATH 197,001,091859,McAuley; Julian John,9999,0,9999,0
1656874038343,MATH 197,002,095566,Kedlaya; Kiran S.,9997,0,9999,2
1656874038343,MATH 197,003,095567,Xiao; Ming,9999,0,9999,0
1656874038343,MATH 197,004,095571,Perols; Johan Lars,9998,0,9999,1
1656874045405,COGS 9,A01,083615,Shannon; Kyle Michael,6,0,75,69
1656874051429,COGS 11,A01,083617,Boyle; Mary E. T.,19,0,48,29
1656874057456,COGS 13,A01,083071,Bastos; Amalia Pinkusfeld,8,0,71,63
1656874063479,COGS 14A,A01,092681,Semenuks; Arturs,0,1,100,100
1656874069506,COGS 14B,A01,083073,Cheng; Tzu-Han,5,0,63,58
1656874075532,COGS 17,A01,092677,Semenuks; Arturs,4,0,81,77
1656874081555,COGS 100,A01,083619,Allen; Michael Gordon,15,0,70,55
1656874087580,COGS 101A,A01,083621,Davis; Joshua Daniel,9,0,68,59
1656874093606,COGS 101B,A01,091572,Allen; Michael Gordon,8,0,65,57
1656874099631,COGS 101C,A01,083625,Delgado; Tania,17,0,35,18
1656874105657,COGS 107A,A01,083627,Boyle; Mary E. T.,13,0,60,47
1656874111684,COGS 118A,A01,083075,Gupta; Anjum,15,0,76,61
1656874117712,CSE 3,A50,083646,Miranda; Gregory Joseph,22,0,50,28
1656874123734,CSE 8A,A50,083650,Miranda; Gregory Joseph,17,1,56,39
1656874129759,CSE 11,A01,083080,Cao; Yingjun,4,15,40,36
1656874135781,CSE 12,A01,083652,Krause-Levy; Sophia Louisa,20,1,120,100
1656874141810,CSE 15L,A01,083654,Morris; Justin Loren,8,0,50,42
1656874141810,CSE 15L,A02,083655,Morris; Justin Loren,8,0,50,42
1656874147831,CSE 20,A01,083657,Tran; Khoa Dang,37,0,80,43
1656874153853,CSE 21,A01,095574,Bach; Quang Tran,21,0,48,27
1656874159878,CSE 30,A01,083084,Eldon; John,4,0,80,76
1656874159878,CSE 30,B01,095061,Bhaskar; Nishant,6,0,50,44
1656874165900,CSE 100,A01,083659,Cao; Yingjun,2,4,70,68
1656874171925,CSE 134B,A01,083661,Powell; Thomas Allan,19,0,100,81
1656874177950,CSE 140,A01,083663,Gungor; Onat,14,0,85,71
1656874183978,CSE 140L,A01,083088,Eldon; John,16,0,100,84
1656874190001,CSE 175,A01,083665,Kumar; Rakesh,3,0,25,22
1656874196024,CSE 190,A00,092507,Dubnov; Shlomo,7,0,20,13
1656874202051,ECE 45,A01,083139,Congero; Spencer William,5,0,75,70
1656874208073,ECE 65,A50,083695,Saad; Andrew S,12,0,30,18
1656874208073,ECE 65,A51,095125,Saad; Andrew S,25,0,26,1
1656874214095,ECE 109,A01,091882,Touri; Behrouz,16,0,70,54
1656874220123,ECE 180,A00,083140,Abi Samra; Nicholas Camill,0,0,30,30
1656874220123,ECE 180,B00,083141,Abi Samra; Nicholas Camill,0,0,30,30
1656874226145,MATH 10A,A01,083735,Patchell; Gregory David,1,0,30,29
1656874226145,MATH 10A,A02,083736,Patchell; Gregory David,20,0,30,10
1656874226145,MATH 10A,A03,083737,Patchell; Gregory David,15,0,30,15
1656874232167,MATH 10B,A01,083207,Lim; Seonhee,7,0,34,27
1656874232167,MATH 10B,A02,083208,Lim; Seonhee,9,0,35,26
1656874232167,MATH 10B,A03,093472,Lim; Seonhee,4,0,34,30
1656874232167,MATH 10B,B01,083739,Sinha; Shubham,9,0,30,21
1656874238190,MATH 18,A01,083743,Cinel; Cameron Alexander,6,0,30,24
1656874238190,MATH 18,A02,083744,Cinel; Cameron Alexander,15,0,30,15
1656874238190,MATH 18,A03,083745,Cinel; Cameron Alexander,8,0,30,22
1656874238190,MATH 18,B01,083748,Rideout; David Porter,3,0,37,34
1656874238190,MATH 18,B02,083749,Rideout; David Porter,3,0,36,33
1656874238190,MATH 18,B03,083750,Rideout; David Porter,2,0,37,35
1656874238190,MATH 18,B04,083751,Rideout; David Porter,5,0,36,31
1656874238190,MATH 18,B05,093473,Rideout; David Porter,4,0,36,32
1656874238190,MATH 18,B06,093474,Rideout; David Porter,5,0,36,31
1656874244216,MATH 20A,A01,083754,Zheng; Zequn,12,0,40,28
1656874250240,MATH 20B,A01,083756,Briones; Jor-el Thomas Caparas,1,0,36,35
1656874250240,MATH 20B,A02,083757,Briones; Jor-el Thomas Caparas,1,0,36,35
1656874250240,MATH 20B,A03,093475,Briones; Jor-el Thomas Caparas,0,0,36,36
1656874256263,MATH 20C,A01,083760,Briones; Jor-el Thomas Caparas,1,0,35,34
1656874256263,MATH 20C,A02,083761,Briones; Jor-el Thomas Caparas,8,0,35,27
1656874256263,MATH 20C,A03,093476,Briones; Jor-el Thomas Caparas,0,1,36,36
1656874256263,MATH 20C,B01,083762,Bach; Quang Tran,0,0,30,30
1656874262286,MATH 20D,A01,083765,Tran; Brian Kha,4,0,30,26
1656874262286,MATH 20D,A02,083766,Tran; Brian Kha,4,0,30,26
1656874262286,MATH 20D,A03,083767,Tran; Brian Kha,2,0,30,28
1656874268315,MATH 20E,A01,083771,Ganguly; Soumya,5,0,32,27
1656874268315,MATH 20E,A02,083772,Ganguly; Soumya,6,0,32,26
1656874268315,MATH 20E,B01,083773,Ciotti; Benjamin,18,0,35,17
1656874268315,MATH 20E,B02,083774,Ciotti; Benjamin,17,0,35,18
1656874274346,MATH 103A,A01,083777,Greenfeld; Be'Eri,2,0,36,34
1656874274346,MATH 103A,A02,083778,Greenfeld; Be'Eri,5,0,36,31
1656874274346,MATH 103A,A03,093561,Greenfeld; Be'Eri,4,0,36,32
1656874274346,MATH 103A,B01,083779,Greenfeld; Be'Eri,6,0,36,30
1656874274346,MATH 103A,B02,083780,Greenfeld; Be'Eri,2,0,36,34
1656874274346,MATH 103A,B03,093562,Greenfeld; Be'Eri,2,0,36,34
1656874280369,MATH 105,A01,085443,Carter; Anne Toulson,13,0,35,22
1656874280369,MATH 105,A02,093477,Carter; Anne Toulson,20,0,35,15
1656874286395,MATH 109,A01,083213,Ganzberger; Geoffrey Michael,2,0,34,32
1656874286395,MATH 109,A02,083214,Ganzberger; Geoffrey Michael,2,0,34,32
1656874286395,MATH 109,A03,093478,Ganzberger; Geoffrey Michael,1,0,34,33
1656874286395,MATH 109,B01,083215,Ganzberger; Geoffrey Michael,1,0,32,31
1656874286395,MATH 109,B02,083216,Ganzberger; Geoffrey Michael,1,0,32,31
1656874286395,MATH 109,B03,093479,Ganzberger; Geoffrey Michael,6,0,32,26
1656874292426,MATH 142A,A01,083219,Chow; Bennett,6,0,32,26
1656874292426,MATH 142A,A02,083220,Chow; Bennett,9,0,32,23
1656874292426,MATH 142A,A03,093480,Chow; Bennett,7,0,32,25
1656874292426,MATH 142A,B03,093481,Chow; Bennett,7,0,32,25
1656874292426,MATH 142A,B04,093558,Chow; Bennett,10,0,32,22
1656874292426,MATH 142A,B05,093559,Chow; Bennett,6,0,32,26
1656874298453,MATH 193A,A01,083224,Rotar; Vladimir,6,0,34,28
1656874298453,MATH 193A,A02,083225,Rotar; Vladimir,3,0,34,31
1656874298453,MATH 193A,A03,083781,Rotar; Vladimir,1,0,34,33
1656874298453,MATH 193A,A04,083782,Rotar; Vladimir,6,0,34,28
1656874298453,MATH 193A,A05,093482,Rotar; Vladimir,6,0,34,28
1656874304475,MATH 197,001,091859,McAuley; Julian John,9999,0,9999,0
1656874304475,MATH 197,002,095566,Kedlaya; Kiran S.,9997,0,9999,2
1656874304475,MATH 197,003,095567,Xiao; Ming,9999,0,9999,0
1656874304475,MATH 197,004,095571,Perols; Johan Lars,9998,0,9999,1
1656874311534,COGS 9,A01,083615,Shannon; Kyle Michael,6,0,75,69
1656874317557,COGS 11,A01,083617,Boyle; Mary E. T.,19,0,48,29
1656874323584,COGS 13,A01,083071,Bastos; Amalia Pinkusfeld,8,0,71,63
1656874329608,COGS 14A,A01,092681,Semenuks; Arturs,0,1,100,100
1656874335634,COGS 14B,A01,083073,Cheng; Tzu-Han,5,0,63,58
1656874341663,COGS 17,A01,092677,Semenuks; Arturs,4,0,81,77
1656874347691,COGS 100,A01,083619,Allen; Michael Gordon,15,0,70,55
1656874353719,COGS 101A,A01,083621,Davis; Joshua Daniel,9,0,68,59
1656874359744,COGS 101B,A01,091572,Allen; Michael Gordon,8,0,65,57
1656874365771,COGS 101C,A01,083625,Delgado; Tania,17,0,35,18
1656874371794,COGS 107A,A01,083627,Boyle; Mary E. T.,13,0,60,47
1656874377820,COGS 118A,A01,083075,Gupta; Anjum,15,0,76,61
1656874383843,CSE 3,A50,083646,Miranda; Gregory Joseph,22,0,50,28
1656874389869,CSE 8A,A50,083650,Miranda; Gregory Joseph,17,1,56,39
1656874395893,CSE 11,A01,083080,Cao; Yingjun,4,15,40,36
1656874401920,CSE 12,A01,083652,Krause-Levy; Sophia Louisa,20,1,120,100
1656874407955,CSE 15L,A01,083654,Morris; Justin Loren,8,0,50,42
1656874407955,CSE 15L,A02,083655,Morris; Justin Loren,8,0,50,42
1656874413978,CSE 20,A01,083657,Tran; Khoa Dang,37,0,80,43
1656874420004,CSE 21,A01,095574,Bach; Quang Tran,21,0,48,27
1656874426029,CSE 30,A01,083084,Eldon; John,4,0,80,76
1656874426029,CSE 30,B01,095061,Bhaskar; Nishant,6,0,50,44
1656874432052,CSE 100,A01,083659,Cao; Yingjun,2,4,70,68
1656874438075,CSE 134B,A01,083661,Powell; Thomas Allan,19,0,100,81
1656874444099,CSE 140,A01,083663,Gungor; Onat,14,0,85,71
1656874450123,CSE 140L,A01,083088,Eldon; John,16,0,100,84
1656874456145,CSE 175,A01,083665,Kumar; Rakesh,3,0,25,22
1656874462167,CSE 190,A00,092507,Dubnov; Shlomo,7,0,20,13
1656874468194,ECE 45,A01,083139,Congero; Spencer William,5,0,75,70
1656874474222,ECE 65,A50,083695,Saad; Andrew S,12,0,30,18
1656874474222,ECE 65,A51,095125,Saad; Andrew S,25,0,26,1
1656874480245,ECE 109,A01,091882,Touri; Behrouz,16,0,70,54
1656874486268,ECE 180,A00,083140,Abi Samra; Nicholas Camill,0,0,30,30
1656874486268,ECE 180,B00,083141,Abi Samra; Nicholas Camill,0,0,30,30
1656874492297,MATH 10A,A01,083735,Patchell; Gregory David,1,0,30,29
1656874492297,MATH 10A,A02,083736,Patchell; Gregory David,20,0,30,10
1656874492297,MATH 10A,A03,083737,Patchell; Gregory David,15,0,30,15
1656874498334,MATH 10B,A01,083207,Lim; Seonhee,7,0,34,27
1656874498334,MATH 10B,A02,083208,Lim; Seonhee,9,0,35,26
1656874498334,MATH 10B,A03,093472,Lim; Seonhee,4,0,34,30
1656874498334,MATH 10B,B01,083739,Sinha; Shubham,9,0,30,21
1656874504359,MATH 18,A01,083743,Cinel; Cameron Alexander,6,0,30,24
1656874504359,MATH 18,A02,083744,Cinel; Cameron Alexander,15,0,30,15
1656874504359,MATH 18,A03,083745,Cinel; Cameron Alexander,8,0,30,22
1656874504359,MATH 18,B01,083748,Rideout; David Porter,4,0,37,33
1656874504359,MATH 18,B02,083749,Rideout; David Porter,3,0,36,33
1656874504359,MATH 18,B03,083750,Rideout; David Porter,2,0,37,35
1656874504359,MATH 18,B04,083751,Rideout; David Porter,5,0,36,31
1656874504359,MATH 18,B05,093473,Rideout; David Porter,4,0,36,32
1656874504359,MATH 18,B06,093474,Rideout; David Porter,5,0,36,31
1656874510385,MATH 20A,A01,083754,Zheng; Zequn,12,0,40,28
1656874516409,MATH 20B,A01,083756,Briones; Jor-el Thomas Caparas,1,0,36,35
1656874516409,MATH 20B,A02,083757,Briones; Jor-el Thomas Caparas,1,0,36,35
1656874516409,MATH 20B,A03,093475,Briones; Jor-el Thomas Caparas,0,0,36,36
1656874522444,MATH 20C,A01,083760,Briones; Jor-el Thomas Caparas,1,0,35,34
1656874522444,MATH 20C,A02,083761,Briones; Jor-el Thomas Caparas,8,0,35,27
1656874522444,MATH 20C,A03,093476,Briones; Jor-el Thomas Caparas,0,1,36,36
1656874522444,MATH 20C,B01,083762,Bach; Quang Tran,0,0,30,30
1656874528471,MATH 20D,A01,083765,Tran; Brian Kha,4,0,30,26
1656874528471,MATH 20D,A02,083766,Tran; Brian Kha,4,0,30,26
1656874528471,MATH 20D,A03,083767,Tran; Brian Kha,2,0,30,28
1656874534497,MATH 20E,A01,083771,Ganguly; Soumya,5,0,32,27
1656874534497,MATH 20E,A02,083772,Ganguly; Soumya,6,0,32,26
1656874534497,MATH 20E,B01,083773,Ciotti; Benjamin,18,0,35,17
1656874534497,MATH 20E,B02,083774,Ciotti; Benjamin,17,0,35,18
1656874540524,MATH 103A,A01,083777,Greenfeld; Be'Eri,2,0,36,34
1656874540524,MATH 103A,A02,083778,Greenfeld; Be'Eri,5,0,36,31
1656874540524,MATH 103A,A03,093561,Greenfeld; Be'Eri,4,0,36,32
1656874540524,MATH 103A,B01,083779,Greenfeld; Be'Eri,6,0,36,30
1656874540524,MATH 103A,B02,083780,Greenfeld; Be'Eri,2,0,36,34
1656874540524,MATH 103A,B03,093562,Greenfeld; Be'Eri,2,0,36,34
1656874546555,MATH 105,A01,085443,Carter; Anne Toulson,13,0,35,22
1656874546555,MATH 105,A02,093477,Carter; Anne Toulson,20,0,35,15
1656874552586,MATH 109,A01,083213,Ganzberger; Geoffrey Michael,2,0,34,32
1656874552586,MATH 109,A02,083214,Ganzberger; Geoffrey Michael,2,0,34,32
1656874552586,MATH 109,A03,093478,Ganzberger; Geoffrey Michael,1,0,34,33
1656874552586,MATH 109,B01,083215,Ganzberger; Geoffrey Michael,1,0,32,31
1656874552586,MATH 109,B02,083216,Ganzberger; Geoffrey Michael,1,0,32,31
1656874552586,MATH 109,B03,093479,Ganzberger; Geoffrey Michael,6,0,32,26
1656874558615,MATH 142A,A01,083219,Chow; Bennett,6,0,32,26
1656874558615,MATH 142A,A02,083220,Chow; Bennett,9,0,32,23
1656874558615,MATH 142A,A03,093480,Chow; Bennett,7,0,32,25
1656874558615,MATH 142A,B03,093481,Chow; Bennett,7,0,32,25
1656874558615,MATH 142A,B04,093558,Chow; Bennett,10,0,32,22
1656874558615,MATH 142A,B05,093559,Chow; Bennett,6,0,32,26
1656874564638,MATH 193A,A01,083224,Rotar; Vladimir,6,0,34,28
1656874564638,MATH 193A,A02,083225,Rotar; Vladimir,3,0,34,31
1656874564638,MATH 193A,A03,083781,Rotar; Vladimir,1,0,34,33
1656874564638,MATH 193A,A04,083782,Rotar; Vladimir,6,0,34,28
1656874564638,MATH 193A,A05,093482,Rotar; Vladimir,6,0,34,28
1656874570663,MATH 197,001,091859,McAuley; Julian John,9999,0,9999,0
1656874570663,MATH 197,002,095566,Kedlaya; Kiran S.,9997,0,9999,2
1656874570663,MATH 197,003,095567,Xiao; Ming,9999,0,9999,0
1656874570663,MATH 197,004,095571,Perols; Johan Lars,9998,0,9999,1
1656874577717,COGS 9,A01,083615,Shannon; Kyle Michael,6,0,75,69
1656874583751,COGS 11,A01,083617,Boyle; Mary E. T.,19,0,48,29
1656874589788,COGS 13,A01,083071,Bastos; Amalia Pinkusfeld,8,0,71,63
1656874595831,COGS 14A,A01,092681,Semenuks; Arturs,0,1,100,100
1656874601857,COGS 14B,A01,083073,Cheng; Tzu-Han,5,0,63,58
1656874607885,COGS 17,A01,092677,Semenuks; Arturs,4,0,81,77
1656874613911,COGS 100,A01,083619,Allen; Michael Gordon,15,0,70,55
1656874620012,COGS 101A,A01,083621,Davis; Joshua Daniel,9,0,68,59
1656874626037,COGS 101B,A01,091572,Allen; Michael Gordon,8,0,65,57
1656874632064,COGS 101C,A01,083625,Delgado; Tania,17,0,35,18
1656874638088,COGS 107A,A01,083627,Boyle; Mary E. T.,13,0,60,47
1656874644112,COGS 118A,A01,083075,Gupta; Anjum,15,0,76,61
1656874650140,CSE 3,A50,083646,Miranda; Gregory Joseph,22,0,50,28
1656874656163,CSE 8A,A50,083650,Miranda; Gregory Joseph,17,1,56,39
1656874662187,CSE 11,A01,083080,Cao; Yingjun,4,15,40,36
1656874668215,CSE 12,A01,083652,Krause-Levy; Sophia Louisa,20,1,120,100
1656874674237,CSE 15L,A01,083654,Morris; Justin Loren,8,0,50,42
1656874674237,CSE 15L,A02,083655,Morris; Justin Loren,8,0,50,42
1656874680264,CSE 20,A01,083657,Tran; Khoa Dang,37,0,80,43
1656874686290,CSE 21,A01,095574,Bach; Quang Tran,21,0,48,27
1656874692315,CSE 30,A01,083084,Eldon; John,4,0,80,76
1656874692315,CSE 30,B01,095061,Bhaskar; Nishant,6,0,50,44
1656874698336,CSE 100,A01,083659,Cao; Yingjun,2,4,70,68
1656874704371,CSE 134B,A01,083661,Powell; Thomas Allan,19,0,100,81
1656874710398,CSE 140,A01,083663,Gungor; Onat,14,0,85,71
1656874716421,CSE 140L,A01,083088,Eldon; John,16,0,100,84
1656874722444,CSE 175,A01,083665,Kumar; Rakesh,3,0,25,22
1656874728468,CSE 190,A00,092507,Dubnov; Shlomo,7,0,20,13
1656874734491,ECE 45,A01,083139,Congero; Spencer William,5,0,75,70
1656874740520,ECE 65,A50,083695,Saad; Andrew S,12,0,30,18
1656874740520,ECE 65,A51,095125,Saad; Andrew S,25,0,26,1
1656874746553,ECE 109,A01,091882,Touri; Behrouz,16,0,70,54
1656874752576,ECE 180,A00,083140,Abi Samra; Nicholas Camill,0,0,30,30
1656874752576,ECE 180,B00,083141,Abi Samra; Nicholas Camill,0,0,30,30
1656874758603,MATH 10A,A01,083735,Patchell; Gregory David,1,0,30,29
1656874758603,MATH 10A,A02,083736,Patchell; Gregory David,20,0,30,10
1656874758603,MATH 10A,A03,083737,Patchell; Gregory David,15,0,30,15
1656874764630,MATH 10B,A01,083207,Lim; Seonhee,7,0,34,27
1656874764630,MATH 10B,A02,083208,Lim; Seonhee,9,0,35,26
1656874764630,MATH 10B,A03,093472,Lim; Seonhee,4,0,34,30
1656874764630,MATH 10B,B01,083739,Sinha; Shubham,9,0,30,21
1656874770670,MATH 18,A01,083743,Cinel; Cameron Alexander,6,0,30,24
1656874770670,MATH 18,A02,083744,Cinel; Cameron Alexander,15,0,30,15
1656874770670,MATH 18,A03,083745,Cinel; Cameron Alexander,8,0,30,22
1656874770670,MATH 18,B01,083748,Rideout; David Porter,4,0,37,33
1656874770670,MATH 18,B02,083749,Rideout; David Porter,3,0,36,33
1656874770670,MATH 18,B03,083750,Rideout; David Porter,2,0,37,35
1656874770670,MATH 18,B04,083751,Rideout; David Porter,5,0,36,31
1656874770670,MATH 18,B05,093473,Rideout; David Porter,4,0,36,32
1656874770670,MATH 18,B06,093474,Rideout; David Porter,5,0,36,31
1656874776699,MATH 20A,A01,083754,Zheng; Zequn,12,0,40,28
1656874782723,MATH 20B,A01,083756,Briones; Jor-el Thomas Caparas,1,0,36,35
1656874782723,MATH 20B,A02,083757,Briones; Jor-el Thomas Caparas,1,0,36,35
1656874782723,MATH 20B,A03,093475,Briones; Jor-el Thomas Caparas,0,0,36,36
1656874788760,MATH 20C,A01,083760,Briones; Jor-el Thomas Caparas,1,0,35,34
1656874788760,MATH 20C,A02,083761,Briones; Jor-el Thomas Caparas,8,0,35,27
1656874788760,MATH 20C,A03,093476,Briones; Jor-el Thomas Caparas,0,1,36,36
1656874788760,MATH 20C,B01,083762,Bach; Quang Tran,0,0,30,30
1656874794787,MATH 20D,A01,083765,Tran; Brian Kha,4,0,30,26
1656874794787,MATH 20D,A02,083766,Tran; Brian Kha,4,0,30,26
1656874794787,MATH 20D,A03,083767,Tran; Brian Kha,2,0,30,28
1656874800810,MATH 20E,A01,083771,Ganguly; Soumya,5,0,32,27
1656874800810,MATH 20E,A02,083772,Ganguly; Soumya,6,0,32,26
1656874800810,MATH 20E,B01,083773,Ciotti; Benjamin,18,0,35,17
1656874800810,MATH 20E,B02,083774,Ciotti; Benjamin,17,0,35,18
1656874806840,MATH 103A,A01,083777,Greenfeld; Be'Eri,2,0,36,34
1656874806840,MATH 103A,A02,083778,Greenfeld; Be'Eri,5,0,36,31
1656874806840,MATH 103A,A03,093561,Greenfeld; Be'Eri,4,0,36,32
1656874806840,MATH 103A,B01,083779,Greenfeld; Be'Eri,6,0,36,30
1656874806840,MATH 103A,B02,083780,Greenfeld; Be'Eri,2,0,36,34
1656874806840,MATH 103A,B03,093562,Greenfeld; Be'Eri,2,0,36,34
1656874812862,MATH 105,A01,085443,Carter; Anne Toulson,13,0,35,22
1656874812862,MATH 105,A02,093477,Carter; Anne Toulson,20,0,35,15
1656874818891,MATH 109,A01,083213,Ganzberger; Geoffrey Michael,2,0,34,32
1656874818891,MATH 109,A02,083214,Ganzberger; Geoffrey Michael,2,0,34,32
1656874818891,MATH 109,A03,093478,Ganzberger; Geoffrey Michael,1,0,34,33
1656874818891,MATH 109,B01,083215,Ganzberger; Geoffrey Michael,1,0,32,31
1656874818891,MATH 109,B02,083216,Ganzberger; Geoffrey Michael,1,0,32,31
1656874818891,MATH 109,B03,093479,Ganzberger; Geoffrey Michael,6,0,32,26
1656874824915,MATH 142A,A01,083219,Chow; Bennett,6,0,32,26
1656874824915,MATH 142A,A02,083220,Chow; Bennett,9,0,32,23
1656874824915,MATH 142A,A03,093480,Chow; Bennett,7,0,32,25
1656874824915,MATH 142A,B03,093481,Chow; Bennett,7,0,32,25
1656874824915,MATH 142A,B04,093558,Chow; Bennett,10,0,32,22
1656874824915,MATH 142A,B05,093559,Chow; Bennett,6,0,32,26
1656874830943,MATH 193A,A01,083224,Rotar; Vladimir,6,0,34,28
1656874830943,MATH 193A,A02,083225,Rotar; Vladimir,3,0,34,31
1656874830943,MATH 193A,A03,083781,Rotar; Vladimir,1,0,34,33
1656874830943,MATH 193A,A04,083782,Rotar; Vladimir,6,0,34,28
1656874830943,MATH 193A,A05,093482,Rotar; Vladimir,6,0,34,28
1656874836966,MATH 197,001,091859,McAuley; Julian John,9999,0,9999,0
1656874836966,MATH 197,002,095566,Kedlaya; Kiran S.,9997,0,9999,2
1656874836966,MATH 197,003,095567,Xiao; Ming,9999,0,9999,0
1656874836966,MATH 197,004,095571,Perols; Johan Lars,9998,0,9999,1
1656874844032,COGS 9,A01,083615,Shannon; Kyle Michael,6,0,75,69
1656874850059,COGS 11,A01,083617,Boyle; Mary E. T.,19,0,48,29
1656874856083,COGS 13,A01,083071,Bastos; Amalia Pinkusfeld,8,0,71,63
1656874862107,COGS 14A,A01,092681,Semenuks; Arturs,0,1,100,100
1656874868129,COGS 14B,A01,083073,Cheng; Tzu-Han,5,0,63,58
1656874874156,COGS 17,A01,092677,Semenuks; Arturs,4,0,81,77
1656874880182,COGS 100,A01,083619,Allen; Michael Gordon,15,0,70,55
1656874886204,COGS 101A,A01,083621,Davis; Joshua Daniel,9,0,68,59
1656874892242,COGS 101B,A01,091572,Allen; Michael Gordon,8,0,65,57
1656874898266,COGS 101C,A01,083625,Delgado; Tania,17,0,35,18
1656874904290,COGS 107A,A01,083627,Boyle; Mary E. T.,13,0,60,47
1656874910313,COGS 118A,A01,083075,Gupta; Anjum,15,0,76,61
1656874916346,CSE 3,A50,083646,Miranda; Gregory Joseph,22,0,50,28
1656874922374,CSE 8A,A50,083650,Miranda; Gregory Joseph,17,1,56,39
1656874928398,CSE 11,A01,083080,Cao; Yingjun,4,15,40,36
1656874934423,CSE 12,A01,083652,Krause-Levy; Sophia Louisa,20,1,120,100
1656874940451,CSE 15L,A01,083654,Morris; Justin Loren,8,0,50,42
1656874940451,CSE 15L,A02,083655,Morris; Justin Loren,8,0,50,42
1656874946474,CSE 20,A01,083657,Tran; Khoa Dang,37,0,80,43
1656874952498,CSE 21,A01,095574,Bach; Quang Tran,21,0,48,27
1656874958520,CSE 30,A01,083084,Eldon; John,4,0,80,76
1656874958520,CSE 30,B01,095061,Bhaskar; Nishant,6,0,50,44
1656874964542,CSE 100,A01,083659,Cao; Yingjun,2,4,70,68
1656874970565,CSE 134B,A01,083661,Powell; Thomas Allan,19,0,100,81
1656874976593,CSE 140,A01,083663,Gungor; Onat,14,0,85,71
1656874982616,CSE 140L,A01,083088,Eldon; John,16,0,100,84
1656874988640,CSE 175,A01,083665,Kumar; Rakesh,3,0,25,22
1656874994662,CSE 190,A00,092507,Dubnov; Shlomo,7,0,20,13
1656875000686,ECE 45,A01,083139,Congero; Spencer William,5,0,75,70
1656875006711,ECE 65,A50,083695,Saad; Andrew S,12,0,30,18
1656875006711,ECE 65,A51,095125,Saad; Andrew S,25,0,26,1
1656875012743,ECE 109,A01,091882,Touri; Behrouz,16,0,70,54
1656875018770,ECE 180,A00,083140,Abi Samra; Nicholas Camill,0,0,30,30
1656875018770,ECE 180,B00,083141,Abi Samra; Nicholas Camill,0,0,30,30
1656875024792,MATH 10A,A01,083735,Patchell; Gregory David,1,0,30,29
1656875024792,MATH 10A,A02,083736,Patchell; Gregory David,20,0,30,10
1656875024792,MATH 10A,A03,083737,Patchell; Gregory David,15,0,30,15
1656875030814,MATH 10B,A01,083207,Lim; Seonhee,7,0,34,27
1656875030814,MATH 10B,A02,083208,Lim; Seonhee,9,0,35,26
1656875030814,MATH 10B,A03,093472,Lim; Seonhee,4,0,34,30
1656875030814,MATH 10B,B01,083739,Sinha; Shubham,9,0,30,21
1656875036842,MATH 18,A01,083743,Cinel; Cameron Alexander,6,0,30,24
1656875036842,MATH 18,A02,083744,Cinel; Cameron Alexander,15,0,30,15
1656875036842,MATH 18,A03,083745,Cinel; Cameron Alexander,8,0,30,22
1656875036842,MATH 18,B01,083748,Rideout; David Porter,4,0,37,33
1656875036842,MATH 18,B02,083749,Rideout; David Porter,3,0,36,33
1656875036842,MATH 18,B03,083750,Rideout; David Porter,2,0,37,35
1656875036842,MATH 18,B04,083751,Rideout; David Porter,5,0,36,31
1656875036842,MATH 18,B05,093473,Rideout; David Porter,4,0,36,32
1656875036842,MATH 18,B06,093474,Rideout; David Porter,5,0,36,31
1656875042869,MATH 20A,A01,083754,Zheng; Zequn,12,0,40,28
1656875048891,MATH 20B,A01,083756,Briones; Jor-el Thomas Caparas,1,0,36,35
1656875048891,MATH 20B,A02,083757,Briones; Jor-el Thomas Caparas,1,0,36,35
1656875048891,MATH 20B,A03,093475,Briones; Jor-el Thomas Caparas,0,0,36,36
1656875054926,MATH 20C,A01,083760,Briones; Jor-el Thomas Caparas,1,0,35,34
1656875054926,MATH 20C,A02,083761,Briones; Jor-el Thomas Caparas,8,0,35,27
1656875054926,MATH 20C,A03,093476,Briones; Jor-el Thomas Caparas,0,1,36,36
1656875054926,MATH 20C,B01,083762,Bach; Quang Tran,0,0,30,30
1656875060950,MATH 20D,A01,083765,Tran; Brian Kha,4,0,30,26
1656875060950,MATH 20D,A02,083766,Tran; Brian Kha,4,0,30,26
1656875060950,MATH 20D,A03,083767,Tran; Brian Kha,2,0,30,28
1656875066983,MATH 20E,A01,083771,Ganguly; Soumya,5,0,32,27
1656875066983,MATH 20E,A02,083772,Ganguly; Soumya,6,0,32,26
1656875066983,MATH 20E,B01,083773,Ciotti; Benjamin,18,0,35,17
1656875066983,MATH 20E,B02,083774,Ciotti; Benjamin,17,0,35,18
1656875073008,MATH 103A,A01,083777,Greenfeld; Be'Eri,2,0,36,34
1656875073008,MATH 103A,A02,083778,Greenfeld; Be'Eri,5,0,36,31
1656875073008,MATH 103A,A03,093561,Greenfeld; Be'Eri,4,0,36,32
1656875073008,MATH 103A,B01,083779,Greenfeld; Be'Eri,6,0,36,30
1656875073008,MATH 103A,B02,083780,Greenfeld; Be'Eri,2,0,36,34
1656875073008,MATH 103A,B03,093562,Greenfeld; Be'Eri,2,0,36,34
1656875079041,MATH 105,A01,085443,Carter; Anne Toulson,13,0,35,22
1656875079041,MATH 105,A02,093477,Carter; Anne Toulson,20,0,35,15
1656875085064,MATH 109,A01,083213,Ganzberger; Geoffrey Michael,2,0,34,32
1656875085064,MATH 109,A02,083214,Ganzberger; Geoffrey Michael,2,0,34,32
1656875085064,MATH 109,A03,093478,Ganzberger; Geoffrey Michael,1,0,34,33
1656875085064,MATH 109,B01,083215,Ganzberger; Geoffrey Michael,1,0,32,31
1656875085064,MATH 109,B02,083216,Ganzberger; Geoffrey Michael,1,0,32,31
1656875085064,MATH 109,B03,093479,Ganzberger; Geoffrey Michael,6,0,32,26
1656875091089,MATH 142A,A01,083219,Chow; Bennett,6,0,32,26
1656875091089,MATH 142A,A02,083220,Chow; Bennett,9,0,32,23
1656875091089,MATH 142A,A03,093480,Chow; Bennett,7,0,32,25
1656875091089,MATH 142A,B03,093481,Chow; Bennett,7,0,32,25
1656875091089,MATH 142A,B04,093558,Chow; Bennett,10,0,32,22
1656875091089,MATH 142A,B05,093559,Chow; Bennett,6,0,32,26
1656875097114,MATH 193A,A01,083224,Rotar; Vladimir,6,0,34,28
1656875097114,MATH 193A,A02,083225,Rotar; Vladimir,3,0,34,31
1656875097114,MATH 193A,A03,083781,Rotar; Vladimir,1,0,34,33
1656875097114,MATH 193A,A04,083782,Rotar; Vladimir,6,0,34,28
1656875097114,MATH 193A,A05,093482,Rotar; Vladimir,6,0,34,28
1656875103140,MATH 197,001,091859,McAuley; Julian John,9999,0,9999,0
1656875103140,MATH 197,002,095566,Kedlaya; Kiran S.,9997,0,9999,2
1656875103140,MATH 197,003,095567,Xiao; Ming,9999,0,9999,0
1656875103140,MATH 197,004,095571,Perols; Johan Lars,9998,0,9999,1
1656875110197,COGS 9,A01,083615,Shannon; Kyle Michael,6,0,75,69
1656875116220,COGS 11,A01,083617,Boyle; Mary E. T.,19,0,48,29
1656875122246,COGS 13,A01,083071,Bastos; Amalia Pinkusfeld,8,0,71,63
1656875128273,COGS 14A,A01,092681,Semenuks; Arturs,0,1,100,100
1656875134300,COGS 14B,A01,083073,Cheng; Tzu-Han,5,0,63,58
1656875140323,COGS 17,A01,092677,Semenuks; Arturs,4,0,81,77
1656875146347,COGS 100,A01,083619,Allen; Michael Gordon,15,0,70,55
1656875152374,COGS 101A,A01,083621,Davis; Joshua Daniel,9,0,68,59
1656875158396,COGS 101B,A01,091572,Allen; Michael Gordon,8,0,65,57
1656875164421,COGS 101C,A01,083625,Delgado; Tania,17,0,35,18
1656875170444,COGS 107A,A01,083627,Boyle; Mary E. T.,13,0,60,47
1656875176470,COGS 118A,A01,083075,Gupta; Anjum,15,0,76,61
1656875182494,CSE 3,A50,083646,Miranda; Gregory Joseph,22,0,50,28
1656875188517,CSE 8A,A50,083650,Miranda; Gregory Joseph,17,1,56,39
1656875194541,CSE 11,A01,083080,Cao; Yingjun,4,15,40,36
1656875200566,CSE 12,A01,083652,Krause-Levy; Sophia Louisa,20,1,120,100
1656875206589,CSE 15L,A01,083654,Morris; Justin Loren,8,0,50,42
1656875206589,CSE 15L,A02,083655,Morris; Justin Loren,8,0,50,42
1656875212614,CSE 20,A01,083657,Tran; Khoa Dang,37,0,80,43
1656875218708,CSE 21,A01,095574,Bach; Quang Tran,21,0,48,27
1656875224732,CSE 30,A01,083084,Eldon; John,4,0,80,76
1656875224732,CSE 30,B01,095061,Bhaskar; Nishant,6,0,50,44
1656875230760,CSE 100,A01,083659,Cao; Yingjun,2,4,70,68
1656875236781,CSE 134B,A01,083661,Powell; Thomas Allan,19,0,100,81
1656875242803,CSE 140,A01,083663,Gungor; Onat,14,0,85,71
1656875248825,CSE 140L,A01,083088,Eldon; John,16,0,100,84
1656875254851,CSE 175,A01,083665,Kumar; Rakesh,3,0,25,22
1656875260882,CSE 190,A00,092507,Dubnov; Shlomo,7,0,20,13
1656875266915,ECE 45,A01,083139,Congero; Spencer William,5,0,75,70
1656875272937,ECE 65,A50,083695,Saad; Andrew S,12,0,30,18
1656875272937,ECE 65,A51,095125,Saad; Andrew S,25,0,26,1
1656875278960,ECE 109,A01,091882,Touri; Behrouz,16,0,70,54
1656875284982,ECE 180,A00,083140,Abi Samra; Nicholas Camill,0,0,30,30
1656875284982,ECE 180,B00,083141,Abi Samra; Nicholas Camill,0,0,30,30
1656875291004,MATH 10A,A01,083735,Patchell; Gregory David,1,0,30,29
1656875291004,MATH 10A,A02,083736,Patchell; Gregory David,20,0,30,10
1656875291004,MATH 10A,A03,083737,Patchell; Gregory David,15,0,30,15
1656875297027,MATH 10B,A01,083207,Lim; Seonhee,7,0,34,27
1656875297027,MATH 10B,A02,083208,Lim; Seonhee,9,0,35,26
1656875297027,MATH 10B,A03,093472,Lim; Seonhee,4,0,34,30
1656875297027,MATH 10B,B01,083739,Sinha; Shubham,9,0,30,21
1656875303053,MATH 18,A01,083743,Cinel; Cameron Alexander,6,0,30,24
1656875303053,MATH 18,A02,083744,Cinel; Cameron Alexander,15,0,30,15
1656875303053,MATH 18,A03,083745,Cinel; Cameron Alexander,8,0,30,22
1656875303053,MATH 18,B01,083748,Rideout; David Porter,4,0,37,33
1656875303053,MATH 18,B02,083749,Rideout; David Porter,3,0,36,33
1656875303053,MATH 18,B03,083750,Rideout; David Porter,2,0,37,35
1656875303053,MATH 18,B04,083751,Rideout; David Porter,5,0,36,31
1656875303053,MATH 18,B05,093473,Rideout; David Porter,4,0,36,32
1656875303053,MATH 18,B06,093474,Rideout; David Porter,5,0,36,31
1656875309076,MATH 20A,A01,083754,Zheng; Zequn,12,0,40,28
1656875315103,MATH 20B,A01,083756,Briones; Jor-el Thomas Caparas,1,0,36,35
1656875315103,MATH 20B,A02,083757,Briones; Jor-el Thomas Caparas,1,0,36,35
1656875315103,MATH 20B,A03,093475,Briones; Jor-el Thomas Caparas,0,0,36,36
1656875321127,MATH 20C,A01,083760,Briones; Jor-el Thomas Caparas,1,0,35,34
1656875321127,MATH 20C,A02,083761,Briones; Jor-el Thomas Caparas,8,0,35,27
1656875321127,MATH 20C,A03,093476,Briones; Jor-el Thomas Caparas,0,1,36,36
1656875321127,MATH 20C,B01,083762,Bach; Quang Tran,0,0,30,30
1656875327149,MATH 20D,A01,083765,Tran; Brian Kha,4,0,30,26
1656875327149,MATH 20D,A02,083766,Tran; Brian Kha,4,0,30,26
1656875327149,MATH 20D,A03,083767,Tran; Brian Kha,2,0,30,28
1656875333188,MATH 20E,A01,083771,Ganguly; Soumya,5,0,32,27
1656875333188,MATH 20E,A02,083772,Ganguly; Soumya,6,0,32,26
1656875333188,MATH 20E,B01,083773,Ciotti; Benjamin,18,0,35,17
1656875333188,MATH 20E,B02,083774,Ciotti; Benjamin,17,0,35,18
1656875339219,MATH 103A,A01,083777,Greenfeld; Be'Eri,2,0,36,34
1656875339219,MATH 103A,A02,083778,Greenfeld; Be'Eri,5,0,36,31
1656875339219,MATH 103A,A03,093561,Greenfeld; Be'Eri,4,0,36,32
1656875339219,MATH 103A,B01,083779,Greenfeld; Be'Eri,6,0,36,30
1656875339219,MATH 103A,B02,083780,Greenfeld; Be'Eri,2,0,36,34
1656875339219,MATH 103A,B03,093562,Greenfeld; Be'Eri,2,0,36,34
1656875345244,MATH 105,A01,085443,Carter; Anne Toulson,13,0,35,22
1656875345244,MATH 105,A02,093477,Carter; Anne Toulson,20,0,35,15
1656875351274,MATH 109,A01,083213,Ganzberger; Geoffrey Michael,2,0,34,32
1656875351274,MATH 109,A02,083214,Ganzberger; Geoffrey Michael,2,0,34,32
1656875351274,MATH 109,A03,093478,Ganzberger; Geoffrey Michael,1,0,34,33
1656875351274,MATH 109,B01,083215,Ganzberger; Geoffrey Michael,1,0,32,31
1656875351274,MATH 109,B02,083216,Ganzberger; Geoffrey Michael,1,0,32,31
1656875351274,MATH 109,B03,093479,Ganzberger; Geoffrey Michael,6,0,32,26
1656875357321,MATH 142A,A01,083219,Chow; Bennett,6,0,32,26
1656875357321,MATH 142A,A02,083220,Chow; Bennett,9,0,32,23
1656875357321,MATH 142A,A03,093480,Chow; Bennett,7,0,32,25
1656875357321,MATH 142A,B03,093481,Chow; Bennett,7,0,32,25
1656875357321,MATH 142A,B04,093558,Chow; Bennett,10,0,32,22
1656875357321,MATH 142A,B05,093559,Chow; Bennett,6,0,32,26
1656875363346,MATH 193A,A01,083224,Rotar; Vladimir,6,0,34,28
1656875363346,MATH 193A,A02,083225,Rotar; Vladimir,3,0,34,31
1656875363346,MATH 193A,A03,083781,Rotar; Vladimir,1,0,34,33
1656875363346,MATH 193A,A04,083782,Rotar; Vladimir,6,0,34,28
1656875363346,MATH 193A,A05,093482,Rotar; Vladimir,6,0,34,28
1656875369389,MATH 197,001,091859,McAuley; Julian John,9999,0,9999,0
1656875369389,MATH 197,002,095566,Kedlaya; Kiran S.,9997,0,9999,2
1656875369389,MATH 197,003,095567,Xiao; Ming,9999,0,9999,0
1656875369389,MATH 197,004,095571,Perols; Johan Lars,9998,0,9999,1
1656875376451,COGS 9,A01,083615,Shannon; Kyle Michael,6,0,75,69
1656875382477,COGS 11,A01,083617,Boyle; Mary E. T.,19,0,48,29
1656875388514,COGS 13,A01,083071,Bastos; Amalia Pinkusfeld,8,0,71,63
1656875394541,COGS 14A,A01,092681,Semenuks; Arturs,0,1,100,100
1656875400586,COGS 14B,A01,083073,Cheng; Tzu-Han,5,0,63,58
1656875406611,COGS 17,A01,092677,Semenuks; Arturs,4,0,81,77
1656875412650,COGS 100,A01,083619,Allen; Michael Gordon,15,0,70,55
1656875418676,COGS 101A,A01,083621,Davis; Joshua Daniel,9,0,68,59
1656875424704,COGS 101B,A01,091572,Allen; Michael Gordon,8,0,65,57
1656875430727,COGS 101C,A01,083625,Delgado; Tania,17,0,35,18
1656875436753,COGS 107A,A01,083627,Boyle; Mary E. T.,13,0,60,47
1656875442781,COGS 118A,A01,083075,Gupta; Anjum,15,0,76,61
1656875448804,CSE 3,A50,083646,Miranda; Gregory Joseph,22,0,50,28
1656875454831,CSE 8A,A50,083650,Miranda; Gregory Joseph,17,1,56,39
1656875460856,CSE 11,A01,083080,Cao; Yingjun,4,15,40,36
1656875466879,CSE 12,A01,083652,Krause-Levy; Sophia Louisa,20,1,120,100
1656875472903,CSE 15L,A01,083654,Morris; Justin Loren,8,0,50,42
1656875472903,CSE 15L,A02,083655,Morris; Justin Loren,8,0,50,42
1656875478931,CSE 20,A01,083657,Tran; Khoa Dang,37,0,80,43
1656875484953,CSE 21,A01,095574,Bach; Quang Tran,21,0,48,27
1656875490977,CSE 30,A01,083084,Eldon; John,4,0,80,76
1656875490977,CSE 30,B01,095061,Bhaskar; Nishant,6,0,50,44
1656875497001,CSE 100,A01,083659,Cao; Yingjun,2,4,70,68
1656875503029,CSE 134B,A01,083661,Powell; Thomas Allan,19,0,100,81
1656875509054,CSE 140,A01,083663,Gungor; Onat,14,0,85,71
1656875515088,CSE 140L,A01,083088,Eldon; John,16,0,100,84
1656875521111,CSE 175,A01,083665,Kumar; Rakesh,3,0,25,22
1656875527134,CSE 190,A00,092507,Dubnov; Shlomo,7,0,20,13
1656875533158,ECE 45,A01,083139,Congero; Spencer William,5,0,75,70
1656875539181,ECE 65,A50,083695,Saad; Andrew S,12,0,30,18
1656875539181,ECE 65,A51,095125,Saad; Andrew S,25,0,26,1
1656875545204,ECE 109,A01,091882,Touri; Behrouz,16,0,70,54
1656875551243,ECE 180,A00,083140,Abi Samra; Nicholas Camill,0,0,30,30
1656875551243,ECE 180,B00,083141,Abi Samra; Nicholas Camill,0,0,30,30
1656875557273,MATH 10A,A01,083735,Patchell; Gregory David,1,0,30,29
1656875557273,MATH 10A,A02,083736,Patchell; Gregory David,20,0,30,10
1656875557273,MATH 10A,A03,083737,Patchell; Gregory David,15,0,30,15
1656875563301,MATH 10B,A01,083207,Lim; Seonhee,7,0,34,27
1656875563301,MATH 10B,A02,083208,Lim; Seonhee,9,0,35,26
1656875563301,MATH 10B,A03,093472,Lim; Seonhee,4,0,34,30
1656875563301,MATH 10B,B01,083739,Sinha; Shubham,9,0,30,21
1656875569327,MATH 18,A01,083743,Cinel; Cameron Alexander,6,0,30,24
1656875569327,MATH 18,A02,083744,Cinel; Cameron Alexander,15,0,30,15
1656875569327,MATH 18,A03,083745,Cinel; Cameron Alexander,8,0,30,22
1656875569327,MATH 18,B01,083748,Rideout; David Porter,4,0,37,33
1656875569327,MATH 18,B02,083749,Rideout; David Porter,3,0,36,33
1656875569327,MATH 18,B03,083750,Rideout; David Porter,2,0,37,35
1656875569327,MATH 18,B04,083751,Rideout; David Porter,5,0,36,31
1656875569327,MATH 18,B05,093473,Rideout; David Porter,4,0,36,32
1656875569327,MATH 18,B06,093474,Rideout; David Porter,5,0,36,31
1656875575350,MATH 20A,A01,083754,Zheng; Zequn,12,0,40,28
1656875581379,MATH 20B,A01,083756,Briones; Jor-el Thomas Caparas,1,0,36,35
1656875581379,MATH 20B,A02,083757,Briones; Jor-el Thomas Caparas,1,0,36,35
1656875581379,MATH 20B,A03,093475,Briones; Jor-el Thomas Caparas,0,0,36,36
1656875587402,MATH 20C,A01,083760,Briones; Jor-el Thomas Caparas,1,0,35,34
1656875587402,MATH 20C,A02,083761,Briones; Jor-el Thomas Caparas,8,0,35,27
1656875587402,MATH 20C,A03,093476,Briones; Jor-el Thomas Caparas,0,1,36,36
1656875587402,MATH 20C,B01,083762,Bach; Quang Tran,0,0,30,30
1656875593426,MATH 20D,A01,083765,Tran; Brian Kha,4,0,30,26
1656875593426,MATH 20D,A02,083766,Tran; Brian Kha,4,0,30,26
1656875593426,MATH 20D,A03,083767,Tran; Brian Kha,2,0,30,28
1656875599448,MATH 20E,A01,083771,Ganguly; Soumya,5,0,32,27
1656875599448,MATH 20E,A02,083772,Ganguly; Soumya,6,0,32,26
1656875599448,MATH 20E,B01,083773,Ciotti; Benjamin,18,0,35,17
1656875599448,MATH 20E,B02,083774,Ciotti; Benjamin,17,0,35,18
1656875605471,MATH 103A,A01,083777,Greenfeld; Be'Eri,2,0,36,34
1656875605471,MATH 103A,A02,083778,Greenfeld; Be'Eri,5,0,36,31
1656875605471,MATH 103A,A03,093561,Greenfeld; Be'Eri,4,0,36,32
1656875605471,MATH 103A,B01,083779,Greenfeld; Be'Eri,6,0,36,30
1656875605471,MATH 103A,B02,083780,Greenfeld; Be'Eri,2,0,36,34
1656875605471,MATH 103A,B03,093562,Greenfeld; Be'Eri,2,0,36,34
1656875611495,MATH 105,A01,085443,Carter; Anne Toulson,13,0,35,22
1656875611495,MATH 105,A02,093477,Carter; Anne Toulson,20,0,35,15
1656875617519,MATH 109,A01,083213,Ganzberger; Geoffrey Michael,2,0,34,32
1656875617519,MATH 109,A02,083214,Ganzberger; Geoffrey Michael,2,0,34,32
1656875617519,MATH 109,A03,093478,Ganzberger; Geoffrey Michael,1,0,34,33
1656875617519,MATH 109,B01,083215,Ganzberger; Geoffrey Michael,1,0,32,31
1656875617519,MATH 109,B02,083216,Ganzberger; Geoffrey Michael,1,0,32,31
1656875617519,MATH 109,B03,093479,Ganzberger; Geoffrey Michael,6,0,32,26
1656875623544,MATH 142A,A01,083219,Chow; Bennett,6,0,32,26
1656875623544,MATH 142A,A02,083220,Chow; Bennett,9,0,32,23
1656875623544,MATH 142A,A03,093480,Chow; Bennett,7,0,32,25
1656875623544,MATH 142A,B03,093481,Chow; Bennett,7,0,32,25
1656875623544,MATH 142A,B04,093558,Chow; Bennett,10,0,32,22
1656875623544,MATH 142A,B05,093559,Chow; Bennett,6,0,32,26
1656875629572,MATH 193A,A01,083224,Rotar; Vladimir,6,0,34,28
1656875629572,MATH 193A,A02,083225,Rotar; Vladimir,3,0,34,31
1656875629572,MATH 193A,A03,083781,Rotar; Vladimir,1,0,34,33
1656875629572,MATH 193A,A04,083782,Rotar; Vladimir,6,0,34,28
1656875629572,MATH 193A,A05,093482,Rotar; Vladimir,6,0,34,28
1656875635596,MATH 197,001,091859,McAuley; Julian John,9999,0,9999,0
1656875635596,MATH 197,002,095566,Kedlaya; Kiran S.,9997,0,9999,2
1656875635596,MATH 197,003,095567,Xiao; Ming,9999,0,9999,0
1656875635596,MATH 197,004,095571,Perols; Johan Lars,9998,0,9999,1
1656875642656,COGS 9,A01,083615,Shannon; Kyle Michael,6,0,75,69
1656875648681,COGS 11,A01,083617,Boyle; Mary E. T.,19,0,48,29
1656875654704,COGS 13,A01,083071,Bastos; Amalia Pinkusfeld,8,0,71,63
1656875660728,COGS 14A,A01,092681,Semenuks; Arturs,0,1,100,100
1656875666755,COGS 14B,A01,083073,Cheng; Tzu-Han,5,0,63,58
1656875672780,COGS 17,A01,092677,Semenuks; Arturs,4,0,81,77
1656875678804,COGS 100,A01,083619,Allen; Michael Gordon,15,0,70,55
1656875684832,COGS 101A,A01,083621,Davis; Joshua Daniel,9,0,68,59
1656875690860,COGS 101B,A01,091572,Allen; Michael Gordon,8,0,65,57
1656875696888,COGS 101C,A01,083625,Delgado; Tania,17,0,35,18
1656875702916,COGS 107A,A01,083627,Boyle; Mary E. T.,13,0,60,47
1656875708954,COGS 118A,A01,083075,Gupta; Anjum,15,0,76,61
1656875714996,CSE 3,A50,083646,Miranda; Gregory Joseph,22,0,50,28
1656875721021,CSE 8A,A50,083650,Miranda; Gregory Joseph,17,1,56,39
1656875727048,CSE 11,A01,083080,Cao; Yingjun,4,15,40,36
1656875733075,CSE 12,A01,083652,Krause-Levy; Sophia Louisa,20,1,120,100
1656875739107,CSE 15L,A01,083654,Morris; Justin Loren,8,0,50,42
1656875739107,CSE 15L,A02,083655,Morris; Justin Loren,8,0,50,42
1656875745135,CSE 20,A01,083657,Tran; Khoa Dang,37,0,80,43
1656875751158,CSE 21,A01,095574,Bach; Quang Tran,21,0,48,27
1656875757183,CSE 30,A01,083084,Eldon; John,4,0,80,76
1656875757183,CSE 30,B01,095061,Bhaskar; Nishant,6,0,50,44
1656875763235,CSE 100,A01,083659,Cao; Yingjun,2,4,70,68
1656875769259,CSE 134B,A01,083661,Powell; Thomas Allan,19,0,100,81
1656875775284,CSE 140,A01,083663,Gungor; Onat,14,0,85,71
1656875781312,CSE 140L,A01,083088,Eldon; John,16,0,100,84
1656875787337,CSE 175,A01,083665,Kumar; Rakesh,3,0,25,22
1656875793371,CSE 190,A00,092507,Dubnov; Shlomo,7,0,20,13
1656875799395,ECE 45,A01,083139,Congero; Spencer William,5,0,75,70
1656875805424,ECE 65,A50,083695,Saad; Andrew S,12,0,30,18
1656875805424,ECE 65,A51,095125,Saad; Andrew S,25,0,26,1
1656875811450,ECE 109,A01,091882,Touri; Behrouz,16,0,70,54
1656875817551,ECE 180,A00,083140,Abi Samra; Nicholas Camill,0,0,30,30
1656875817551,ECE 180,B00,083141,Abi Samra; Nicholas Camill,0,0,30,30
1656875823574,MATH 10A,A01,083735,Patchell; Gregory David,1,0,30,29
1656875823574,MATH 10A,A02,083736,Patchell; Gregory David,20,0,30,10
1656875823574,MATH 10A,A03,083737,Patchell; Gregory David,15,0,30,15
1656875829597,MATH 10B,A01,083207,Lim; Seonhee,7,0,34,27
1656875829597,MATH 10B,A02,083208,Lim; Seonhee,9,0,35,26
1656875829597,MATH 10B,A03,093472,Lim; Seonhee,4,0,34,30
1656875829597,MATH 10B,B01,083739,Sinha; Shubham,9,0,30,21
1656875835630,MATH 18,A01,083743,Cinel; Cameron Alexander,6,0,30,24
1656875835630,MATH 18,A02,083744,Cinel; Cameron Alexander,15,0,30,15
1656875835630,MATH 18,A03,083745,Cinel; Cameron Alexander,8,0,30,22
1656875835630,MATH 18,B01,083748,Rideout; David Porter,4,0,37,33
1656875835630,MATH 18,B02,083749,Rideout; David Porter,3,0,36,33
1656875835630,MATH 18,B03,083750,Rideout; David Porter,2,0,37,35
1656875835630,MATH 18,B04,083751,Rideout; David Porter,5,0,36,31
1656875835630,MATH 18,B05,093473,Rideout; David Porter,4,0,36,32
1656875835630,MATH 18,B06,093474,Rideout; David Porter,5,0,36,31
1656875841653,MATH 20A,A01,083754,Zheng; Zequn,12,0,40,28
1656875847679,MATH 20B,A01,083756,Briones; Jor-el Thomas Caparas,1,0,36,35
1656875847679,MATH 20B,A02,083757,Briones; Jor-el Thomas Caparas,1,0,36,35
1656875847679,MATH 20B,A03,093475,Briones; Jor-el Thomas Caparas,0,0,36,36
1656875853702,MATH 20C,A01,083760,Briones; Jor-el Thomas Caparas,1,0,35,34
1656875853702,MATH 20C,A02,083761,Briones; Jor-el Thomas Caparas,8,0,35,27
1656875853702,MATH 20C,A03,093476,Briones; Jor-el Thomas Caparas,0,1,36,36
1656875853702,MATH 20C,B01,083762,Bach; Quang Tran,0,0,30,30
1656875859731,MATH 20D,A01,083765,Tran; Brian Kha,4,0,30,26
1656875859731,MATH 20D,A02,083766,Tran; Brian Kha,4,0,30,26
1656875859731,MATH 20D,A03,083767,Tran; Brian Kha,2,0,30,28
1656875865758,MATH 20E,A01,083771,Ganguly; Soumya,5,0,32,27
1656875865758,MATH 20E,A02,083772,Ganguly; Soumya,6,0,32,26
1656875865758,MATH 20E,B01,083773,Ciotti; Benjamin,18,0,35,17
1656875865758,MATH 20E,B02,083774,Ciotti; Benjamin,17,0,35,18
1656875871782,MATH 103A,A01,083777,Greenfeld; Be'Eri,2,0,36,34
1656875871782,MATH 103A,A02,083778,Greenfeld; Be'Eri,5,0,36,31
1656875871782,MATH 103A,A03,093561,Greenfeld; Be'Eri,4,0,36,32
1656875871782,MATH 103A,B01,083779,Greenfeld; Be'Eri,6,0,36,30
1656875871782,MATH 103A,B02,083780,Greenfeld; Be'Eri,2,0,36,34
1656875871782,MATH 103A,B03,093562,Greenfeld; Be'Eri,2,0,36,34
1656875877813,MATH 105,A01,085443,Carter; Anne Toulson,13,0,35,22
1656875877813,MATH 105,A02,093477,Carter; Anne Toulson,20,0,35,15
1656875883836,MATH 109,A01,083213,Ganzberger; Geoffrey Michael,2,0,34,32
1656875883836,MATH 109,A02,083214,Ganzberger; Geoffrey Michael,2,0,34,32
1656875883836,MATH 109,A03,093478,Ganzberger; Geoffrey Michael,1,0,34,33
1656875883836,MATH 109,B01,083215,Ganzberger; Geoffrey Michael,1,0,32,31
1656875883836,MATH 109,B02,083216,Ganzberger; Geoffrey Michael,1,0,32,31
1656875883836,MATH 109,B03,093479,Ganzberger; Geoffrey Michael,6,0,32,26
1656875889860,MATH 142A,A01,083219,Chow; Bennett,6,0,32,26
1656875889860,MATH 142A,A02,083220,Chow; Bennett,9,0,32,23
1656875889860,MATH 142A,A03,093480,Chow; Bennett,7,0,32,25
1656875889860,MATH 142A,B03,093481,Chow; Bennett,7,0,32,25
1656875889860,MATH 142A,B04,093558,Chow; Bennett,10,0,32,22
1656875889860,MATH 142A,B05,093559,Chow; Bennett,6,0,32,26
1656875895889,MATH 193A,A01,083224,Rotar; Vladimir,6,0,34,28
1656875895889,MATH 193A,A02,083225,Rotar; Vladimir,3,0,34,31
1656875895889,MATH 193A,A03,083781,Rotar; Vladimir,1,0,34,33
1656875895889,MATH 193A,A04,083782,Rotar; Vladimir,6,0,34,28
1656875895889,MATH 193A,A05,093482,Rotar; Vladimir,6,0,34,28
1656875901916,MATH 197,001,091859,McAuley; Julian John,9999,0,9999,0
1656875901916,MATH 197,002,095566,Kedlaya; Kiran S.,9997,0,9999,2
1656875901916,MATH 197,003,095567,Xiao; Ming,9999,0,9999,0
1656875901916,MATH 197,004,095571,Perols; Johan Lars,9998,0,9999,1
1656875908971,COGS 9,A01,083615,Shannon; Kyle Michael,6,0,75,69
1656875914995,COGS 11,A01,083617,Boyle; Mary E. T.,19,0,48,29
1656875921022,COGS 13,A01,083071,Bastos; Amalia Pinkusfeld,8,0,71,63
1656875927047,COGS 14A,A01,092681,Semenuks; Arturs,0,1,100,100
1656875933070,COGS 14B,A01,083073,Cheng; Tzu-Han,5,0,63,58
1656875939094,COGS 17,A01,092677,Semenuks; Arturs,4,0,81,77
1656875945123,COGS 100,A01,083619,Allen; Michael Gordon,15,0,70,55
1656875951148,COGS 101A,A01,083621,Davis; Joshua Daniel,9,0,68,59
1656875957170,COGS 101B,A01,091572,Allen; Michael Gordon,8,0,65,57
1656875963197,COGS 101C,A01,083625,Delgado; Tania,17,0,35,18
1656875969218,COGS 107A,A01,083627,Boyle; Mary E. T.,13,0,60,47
1656875975242,COGS 118A,A01,083075,Gupta; Anjum,15,0,76,61
1656875981266,CSE 3,A50,083646,Miranda; Gregory Joseph,22,0,50,28
1656875987293,CSE 8A,A50,083650,Miranda; Gregory Joseph,17,1,56,39
1656875993323,CSE 11,A01,083080,Cao; Yingjun,4,15,40,36
1656875999347,CSE 12,A01,083652,Krause-Levy; Sophia Louisa,20,1,120,100
1656876005370,CSE 15L,A01,083654,Morris; Justin Loren,8,0,50,42
1656876005370,CSE 15L,A02,083655,Morris; Justin Loren,8,0,50,42
1656876011392,CSE 20,A01,083657,Tran; Khoa Dang,37,0,80,43
1656876017415,CSE 21,A01,095574,Bach; Quang Tran,21,0,48,27
1656876023439,CSE 30,A01,083084,Eldon; John,4,0,80,76
1656876023439,CSE 30,B01,095061,Bhaskar; Nishant,6,0,50,44
1656876029466,CSE 100,A01,083659,Cao; Yingjun,2,4,70,68
1656876035493,CSE 134B,A01,083661,Powell; Thomas Allan,19,0,100,81
1656876041517,CSE 140,A01,083663,Gungor; Onat,14,0,85,71
1656876047541,CSE 140L,A01,083088,Eldon; John,16,0,100,84
1656876053563,CSE 175,A01,083665,Kumar; Rakesh,3,0,25,22
1656876059586,CSE 190,A00,092507,Dubnov; Shlomo,7,0,20,13
1656876065613,ECE 45,A01,083139,Congero; Spencer William,5,0,75,70
1656876071635,ECE 65,A50,083695,Saad; Andrew S,12,0,30,18
1656876071635,ECE 65,A51,095125,Saad; Andrew S,25,0,26,1
1656876077657,ECE 109,A01,091882,Touri; Behrouz,16,0,70,54
1656876083680,ECE 180,A00,083140,Abi Samra; Nicholas Camill,0,0,30,30
1656876083680,ECE 180,B00,083141,Abi Samra; Nicholas Camill,0,0,30,30
1656876089708,MATH 10A,A01,083735,Patchell; Gregory David,1,0,30,29
1656876089708,MATH 10A,A02,083736,Patchell; Gregory David,20,0,30,10
1656876089708,MATH 10A,A03,083737,Patchell; Gregory David,15,0,30,15
1656876095737,MATH 10B,A01,083207,Lim; Seonhee,7,0,34,27
1656876095737,MATH 10B,A02,083208,Lim; Seonhee,9,0,35,26
1656876095737,MATH 10B,A03,093472,Lim; Seonhee,4,0,34,30
1656876095737,MATH 10B,B01,083739,Sinha; Shubham,9,0,30,21
1656876101761,MATH 18,A01,083743,Cinel; Cameron Alexander,6,0,30,24
1656876101761,MATH 18,A02,083744,Cinel; Cameron Alexander,15,0,30,15
1656876101761,MATH 18,A03,083745,Cinel; Cameron Alexander,8,0,30,22
1656876101761,MATH 18,B01,083748,Rideout; David Porter,4,0,37,33
1656876101761,MATH 18,B02,083749,Rideout; David Porter,3,0,36,33
1656876101761,MATH 18,B03,083750,Rideout; David Porter,2,0,37,35
1656876101761,MATH 18,B04,083751,Rideout; David Porter,5,0,36,31
1656876101761,MATH 18,B05,093473,Rideout; David Porter,4,0,36,32
1656876101761,MATH 18,B06,093474,Rideout; David Porter,5,0,36,31
1656876107785,MATH 20A,A01,083754,Zheng; Zequn,12,0,40,28
1656876113810,MATH 20B,A01,083756,Briones; Jor-el Thomas Caparas,1,0,36,35
1656876113810,MATH 20B,A02,083757,Briones; Jor-el Thomas Caparas,1,0,36,35
1656876113810,MATH 20B,A03,093475,Briones; Jor-el Thomas Caparas,0,0,36,36
1656876119833,MATH 20C,A01,083760,Briones; Jor-el Thomas Caparas,1,0,35,34
1656876119833,MATH 20C,A02,083761,Briones; Jor-el Thomas Caparas,8,0,35,27
1656876119833,MATH 20C,A03,093476,Briones; Jor-el Thomas Caparas,0,1,36,36
1656876119833,MATH 20C,B01,083762,Bach; Quang Tran,0,0,30,30
1656876125860,MATH 20D,A01,083765,Tran; Brian Kha,4,0,30,26
1656876125860,MATH 20D,A02,083766,Tran; Brian Kha,4,0,30,26
1656876125860,MATH 20D,A03,083767,Tran; Brian Kha,2,0,30,28
1656876131884,MATH 20E,A01,083771,Ganguly; Soumya,5,0,32,27
1656876131884,MATH 20E,A02,083772,Ganguly; Soumya,6,0,32,26
1656876131884,MATH 20E,B01,083773,Ciotti; Benjamin,18,0,35,17
1656876131884,MATH 20E,B02,083774,Ciotti; Benjamin,17,0,35,18
1656876137908,MATH 103A,A01,083777,Greenfeld; Be'Eri,2,0,36,34
1656876137908,MATH 103A,A02,083778,Greenfeld; Be'Eri,5,0,36,31
1656876137908,MATH 103A,A03,093561,Greenfeld; Be'Eri,4,0,36,32
1656876137908,MATH 103A,B01,083779,Greenfeld; Be'Eri,6,0,36,30
1656876137908,MATH 103A,B02,083780,Greenfeld; Be'Eri,2,0,36,34
1656876137908,MATH 103A,B03,093562,Greenfeld; Be'Eri,2,0,36,34
1656876143933,MATH 105,A01,085443,Carter; Anne Toulson,13,0,35,22
1656876143933,MATH 105,A02,093477,Carter; Anne Toulson,20,0,35,15
1656876149956,MATH 109,A01,083213,Ganzberger; Geoffrey Michael,2,0,34,32
1656876149956,MATH 109,A02,083214,Ganzberger; Geoffrey Michael,2,0,34,32
1656876149956,MATH 109,A03,093478,Ganzberger; Geoffrey Michael,1,0,34,33
1656876149956,MATH 109,B01,083215,Ganzberger; Geoffrey Michael,1,0,32,31
1656876149956,MATH 109,B02,083216,Ganzberger; Geoffrey Michael,1,0,32,31
1656876149956,MATH 109,B03,093479,Ganzberger; Geoffrey Michael,6,0,32,26
1656876155986,MATH 142A,A01,083219,Chow; Bennett,6,0,32,26
1656876155986,MATH 142A,A02,083220,Chow; Bennett,9,0,32,23
1656876155986,MATH 142A,A03,093480,Chow; Bennett,7,0,32,25
1656876155986,MATH 142A,B03,093481,Chow; Bennett,7,0,32,25
1656876155986,MATH 142A,B04,093558,Chow; Bennett,10,0,32,22
1656876155986,MATH 142A,B05,093559,Chow; Bennett,6,0,32,26
1656876162010,MATH 193A,A01,083224,Rotar; Vladimir,6,0,34,28
1656876162010,MATH 193A,A02,083225,Rotar; Vladimir,3,0,34,31
1656876162010,MATH 193A,A03,083781,Rotar; Vladimir,1,0,34,33
1656876162010,MATH 193A,A04,083782,Rotar; Vladimir,6,0,34,28
1656876162010,MATH 193A,A05,093482,Rotar; Vladimir,6,0,34,28
1656876168036,MATH 197,001,091859,McAuley; Julian John,9999,0,9999,0
1656876168036,MATH 197,002,095566,Kedlaya; Kiran S.,9997,0,9999,2
1656876168036,MATH 197,003,095567,Xiao; Ming,9999,0,9999,0
1656876168036,MATH 197,004,095571,Perols; Johan Lars,9998,0,9999,1
1656876175103,COGS 9,A01,083615,Shannon; Kyle Michael,6,0,75,69
1656876181126,COGS 11,A01,083617,Boyle; Mary E. T.,19,0,48,29
1656876187148,COGS 13,A01,083071,Bastos; Amalia Pinkusfeld,8,0,71,63
1656876193171,COGS 14A,A01,092681,Semenuks; Arturs,0,1,100,100
1656876199194,COGS 14B,A01,083073,Cheng; Tzu-Han,5,0,63,58
1656876205217,COGS 17,A01,092677,Semenuks; Arturs,4,0,81,77
1656876211240,COGS 100,A01,083619,Allen; Michael Gordon,15,0,70,55
1656876217263,COGS 101A,A01,083621,Davis; Joshua Daniel,9,0,68,59
1656876223293,COGS 101B,A01,091572,Allen; Michael Gordon,8,0,65,57
1656876229315,COGS 101C,A01,083625,Delgado; Tania,17,0,35,18
1656876235338,COGS 107A,A01,083627,Boyle; Mary E. T.,13,0,60,47
1656876241360,COGS 118A,A01,083075,Gupta; Anjum,15,0,76,61
1656876247384,CSE 3,A50,083646,Miranda; Gregory Joseph,22,0,50,28
1656876253411,CSE 8A,A50,083650,Miranda; Gregory Joseph,17,1,56,39
1656876259438,CSE 11,A01,083080,Cao; Yingjun,4,15,40,36
1656876265464,CSE 12,A01,083652,Krause-Levy; Sophia Louisa,20,1,120,100
1656876271488,CSE 15L,A01,083654,Morris; Justin Loren,8,0,50,42
1656876271488,CSE 15L,A02,083655,Morris; Justin Loren,8,0,50,42
1656876277512,CSE 20,A01,083657,Tran; Khoa Dang,37,0,80,43
1656876283536,CSE 21,A01,095574,Bach; Quang Tran,21,0,48,27
1656876289560,CSE 30,A01,083084,Eldon; John,4,0,80,76
1656876289560,CSE 30,B01,095061,Bhaskar; Nishant,6,0,50,44
1656876295586,CSE 100,A01,083659,Cao; Yingjun,2,4,70,68
1656876301615,CSE 134B,A01,083661,Powell; Thomas Allan,19,0,100,81
1656876307637,CSE 140,A01,083663,Gungor; Onat,14,0,85,71
1656876313658,CSE 140L,A01,083088,Eldon; John,16,0,100,84
1656876319681,CSE 175,A01,083665,Kumar; Rakesh,3,0,25,22
1656876325703,CSE 190,A00,092507,Dubnov; Shlomo,7,0,20,13
1656876331728,ECE 45,A01,083139,Congero; Spencer William,5,0,75,70
1656876337765,ECE 65,A50,083695,Saad; Andrew S,12,0,30,18
1656876337765,ECE 65,A51,095125,Saad; Andrew S,25,0,26,1
1656876343793,ECE 109,A01,091882,Touri; Behrouz,16,0,70,54
1656876349816,ECE 180,A00,083140,Abi Samra; Nicholas Camill,0,0,30,30
1656876349816,ECE 180,B00,083141,Abi Samra; Nicholas Camill,0,0,30,30
1656876355839,MATH 10A,A01,083735,Patchell; Gregory David,1,0,30,29
1656876355839,MATH 10A,A02,083736,Patchell; Gregory David,20,0,30,10
1656876355839,MATH 10A,A03,083737,Patchell; Gregory David,15,0,30,15
1656876361861,MATH 10B,A01,083207,Lim; Seonhee,7,0,34,27
1656876361861,MATH 10B,A02,083208,Lim; Seonhee,9,0,35,26
1656876361861,MATH 10B,A03,093472,Lim; Seonhee,4,0,34,30
1656876361861,MATH 10B,B01,083739,Sinha; Shubham,9,0,30,21
1656876367891,MATH 18,A01,083743,Cinel; Cameron Alexander,6,0,30,24
1656876367891,MATH 18,A02,083744,Cinel; Cameron Alexander,15,0,30,15
1656876367891,MATH 18,A03,083745,Cinel; Cameron Alexander,8,0,30,22
1656876367891,MATH 18,B01,083748,Rideout; David Porter,4,0,37,33
1656876367891,MATH 18,B02,083749,Rideout; David Porter,3,0,36,33
1656876367891,MATH 18,B03,083750,Rideout; David Porter,2,0,37,35
1656876367891,MATH 18,B04,083751,Rideout; David Porter,5,0,36,31
1656876367891,MATH 18,B05,093473,Rideout; David Porter,4,0,36,32
1656876367891,MATH 18,B06,093474,Rideout; David Porter,5,0,36,31
1656876373913,MATH 20A,A01,083754,Zheng; Zequn,12,0,40,28
1656876379936,MATH 20B,A01,083756,Briones; Jor-el Thomas Caparas,1,0,36,35
1656876379936,MATH 20B,A02,083757,Briones; Jor-el Thomas Caparas,1,0,36,35
1656876379936,MATH 20B,A03,093475,Briones; Jor-el Thomas Caparas,0,0,36,36
1656876385965,MATH 20C,A01,083760,Briones; Jor-el Thomas Caparas,1,0,35,34
1656876385965,MATH 20C,A02,083761,Briones; Jor-el Thomas Caparas,8,0,35,27
1656876385965,MATH 20C,A03,093476,Briones; Jor-el Thomas Caparas,0,1,36,36
1656876385965,MATH 20C,B01,083762,Bach; Quang Tran,0,0,30,30
1656876391989,MATH 20D,A01,083765,Tran; Brian Kha,4,0,30,26
1656876391989,MATH 20D,A02,083766,Tran; Brian Kha,4,0,30,26
1656876391989,MATH 20D,A03,083767,Tran; Brian Kha,2,0,30,28
1656876398015,MATH 20E,A01,083771,Ganguly; Soumya,5,0,32,27
1656876398015,MATH 20E,A02,083772,Ganguly; Soumya,6,0,32,26
1656876398015,MATH 20E,B01,083773,Ciotti; Benjamin,18,0,35,17
1656876398015,MATH 20E,B02,083774,Ciotti; Benjamin,17,0,35,18
1656876404039,MATH 103A,A01,083777,Greenfeld; Be'Eri,2,0,36,34
1656876404039,MATH 103A,A02,083778,Greenfeld; Be'Eri,5,0,36,31
1656876404039,MATH 103A,A03,093561,Greenfeld; Be'Eri,4,0,36,32
1656876404039,MATH 103A,B01,083779,Greenfeld; Be'Eri,6,0,36,30
1656876404039,MATH 103A,B02,083780,Greenfeld; Be'Eri,2,0,36,34
1656876404039,MATH 103A,B03,093562,Greenfeld; Be'Eri,2,0,36,34
1656876410067,MATH 105,A01,085443,Carter; Anne Toulson,13,0,35,22
1656876410067,MATH 105,A02,093477,Carter; Anne Toulson,20,0,35,15
1656876416205,MATH 109,A01,083213,Ganzberger; Geoffrey Michael,2,0,34,32
1656876416205,MATH 109,A02,083214,Ganzberger; Geoffrey Michael,2,0,34,32
1656876416205,MATH 109,A03,093478,Ganzberger; Geoffrey Michael,1,0,34,33
1656876416205,MATH 109,B01,083215,Ganzberger; Geoffrey Michael,1,0,32,31
1656876416205,MATH 109,B02,083216,Ganzberger; Geoffrey Michael,1,0,32,31
1656876416205,MATH 109,B03,093479,Ganzberger; Geoffrey Michael,6,0,32,26
1656876422230,MATH 142A,A01,083219,Chow; Bennett,6,0,32,26
1656876422230,MATH 142A,A02,083220,Chow; Bennett,9,0,32,23
1656876422230,MATH 142A,A03,093480,Chow; Bennett,7,0,32,25
1656876422230,MATH 142A,B03,093481,Chow; Bennett,7,0,32,25
1656876422230,MATH 142A,B04,093558,Chow; Bennett,10,0,32,22
1656876422230,MATH 142A,B05,093559,Chow; Bennett,6,0,32,26
1656876428257,MATH 193A,A01,083224,Rotar; Vladimir,6,0,34,28
1656876428257,MATH 193A,A02,083225,Rotar; Vladimir,3,0,34,31
1656876428257,MATH 193A,A03,083781,Rotar; Vladimir,1,0,34,33
1656876428257,MATH 193A,A04,083782,Rotar; Vladimir,6,0,34,28
1656876428257,MATH 193A,A05,093482,Rotar; Vladimir,6,0,34,28
1656876434280,MATH 197,001,091859,McAuley; Julian John,9999,0,9999,0
1656876434280,MATH 197,002,095566,Kedlaya; Kiran S.,9997,0,9999,2
1656876434280,MATH 197,003,095567,Xiao; Ming,9999,0,9999,0
1656876434280,MATH 197,004,095571,Perols; Johan Lars,9998,0,9999,1
1656876441331,COGS 9,A01,083615,Shannon; Kyle Michael,6,0,75,69
1656876447355,COGS 11,A01,083617,Boyle; Mary E. T.,19,0,48,29
1656876453379,COGS 13,A01,083071,Bastos; Amalia Pinkusfeld,8,0,71,63
1656876459404,COGS 14A,A01,092681,Semenuks; Arturs,0,1,100,100
1656876465435,COGS 14B,A01,083073,Cheng; Tzu-Han,5,0,63,58
1656876471458,COGS 17,A01,092677,Semenuks; Arturs,4,0,81,77
1656876477502,COGS 100,A01,083619,Allen; Michael Gordon,15,0,70,55
1656876483527,COGS 101A,A01,083621,Davis; Joshua Daniel,9,0,68,59
1656876489550,COGS 101B,A01,091572,Allen; Michael Gordon,8,0,65,57
1656876495572,COGS 101C,A01,083625,Delgado; Tania,17,0,35,18
1656876501598,COGS 107A,A01,083627,Boyle; Mary E. T.,13,0,60,47
1656876507624,COGS 118A,A01,083075,Gupta; Anjum,15,0,76,61
1656876513650,CSE 3,A50,083646,Miranda; Gregory Joseph,22,0,50,28
1656876519676,CSE 8A,A50,083650,Miranda; Gregory Joseph,17,1,56,39
1656876525702,CSE 11,A01,083080,Cao; Yingjun,4,15,40,36
1656876531729,CSE 12,A01,083652,Krause-Levy; Sophia Louisa,20,1,120,100
1656876537754,CSE 15L,A01,083654,Morris; Justin Loren,8,0,50,42
1656876537754,CSE 15L,A02,083655,Morris; Justin Loren,8,0,50,42
1656876543780,CSE 20,A01,083657,Tran; Khoa Dang,37,0,80,43
1656876549808,CSE 21,A01,095574,Bach; Quang Tran,21,0,48,27
1656876555834,CSE 30,A01,083084,Eldon; John,4,0,80,76
1656876555834,CSE 30,B01,095061,Bhaskar; Nishant,6,0,50,44
1656876561860,CSE 100,A01,083659,Cao; Yingjun,2,4,70,68
1656876567885,CSE 134B,A01,083661,Powell; Thomas Allan,19,0,100,81
1656876573910,CSE 140,A01,083663,Gungor; Onat,14,0,85,71
1656876579935,CSE 140L,A01,083088,Eldon; John,16,0,100,84
1656876585958,CSE 175,A01,083665,Kumar; Rakesh,3,0,25,22
1656876591988,CSE 190,A00,092507,Dubnov; Shlomo,7,0,20,13
1656876598011,ECE 45,A01,083139,Congero; Spencer William,5,0,75,70
1656876604036,ECE 65,A50,083695,Saad; Andrew S,12,0,30,18
1656876604036,ECE 65,A51,095125,Saad; Andrew S,25,0,26,1
1656876610060,ECE 109,A01,091882,Touri; Behrouz,16,0,70,54
1656876616087,ECE 180,A00,083140,Abi Samra; Nicholas Camill,0,0,30,30
1656876616087,ECE 180,B00,083141,Abi Samra; Nicholas Camill,0,0,30,30
1656876622115,MATH 10A,A01,083735,Patchell; Gregory David,1,0,30,29
1656876622115,MATH 10A,A02,083736,Patchell; Gregory David,20,0,30,10
1656876622115,MATH 10A,A03,083737,Patchell; Gregory David,15,0,30,15
1656876628143,MATH 10B,A01,083207,Lim; Seonhee,7,0,34,27
1656876628143,MATH 10B,A02,083208,Lim; Seonhee,9,0,35,26
1656876628143,MATH 10B,A03,093472,Lim; Seonhee,4,0,34,30
1656876628143,MATH 10B,B01,083739,Sinha; Shubham,9,0,30,21
1656876634180,MATH 18,A01,083743,Cinel; Cameron Alexander,6,0,30,24
1656876634180,MATH 18,A02,083744,Cinel; Cameron Alexander,15,0,30,15
1656876634180,MATH 18,A03,083745,Cinel; Cameron Alexander,8,0,30,22
1656876634180,MATH 18,B01,083748,Rideout; David Porter,4,0,37,33
1656876634180,MATH 18,B02,083749,Rideout; David Porter,3,0,36,33
1656876634180,MATH 18,B03,083750,Rideout; David Porter,2,0,37,35
1656876634180,MATH 18,B04,083751,Rideout; David Porter,5,0,36,31
1656876634180,MATH 18,B05,093473,Rideout; David Porter,4,0,36,32
1656876634180,MATH 18,B06,093474,Rideout; David Porter,5,0,36,31
1656876640207,MATH 20A,A01,083754,Zheng; Zequn,12,0,40,28
1656876646235,MATH 20B,A01,083756,Briones; Jor-el Thomas Caparas,1,0,36,35
1656876646235,MATH 20B,A02,083757,Briones; Jor-el Thomas Caparas,1,0,36,35
1656876646235,MATH 20B,A03,093475,Briones; Jor-el Thomas Caparas,0,0,36,36
1656876652258,MATH 20C,A01,083760,Briones; Jor-el Thomas Caparas,1,0,35,34
1656876652258,MATH 20C,A02,083761,Briones; Jor-el Thomas Caparas,8,0,35,27
1656876652258,MATH 20C,A03,093476,Briones; Jor-el Thomas Caparas,0,1,36,36
1656876652258,MATH 20C,B01,083762,Bach; Quang Tran,0,0,30,30
1656876658281,MATH 20D,A01,083765,Tran; Brian Kha,4,0,30,26
1656876658281,MATH 20D,A02,083766,Tran; Brian Kha,4,0,30,26
1656876658281,MATH 20D,A03,083767,Tran; Brian Kha,2,0,30,28
1656876664305,MATH 20E,A01,083771,Ganguly; Soumya,5,0,32,27
1656876664305,MATH 20E,A02,083772,Ganguly; Soumya,6,0,32,26
1656876664305,MATH 20E,B01,083773,Ciotti; Benjamin,18,0,35,17
1656876664305,MATH 20E,B02,083774,Ciotti; Benjamin,17,0,35,18
1656876670330,MATH 103A,A01,083777,Greenfeld; Be'Eri,2,0,36,34
1656876670330,MATH 103A,A02,083778,Greenfeld; Be'Eri,5,0,36,31
1656876670330,MATH 103A,A03,093561,Greenfeld; Be'Eri,4,0,36,32
1656876670330,MATH 103A,B01,083779,Greenfeld; Be'Eri,6,0,36,30
1656876670330,MATH 103A,B02,083780,Greenfeld; Be'Eri,2,0,36,34
1656876670330,MATH 103A,B03,093562,Greenfeld; Be'Eri,2,0,36,34
1656876676353,MATH 105,A01,085443,Carter; Anne Toulson,13,0,35,22
1656876676353,MATH 105,A02,093477,Carter; Anne Toulson,20,0,35,15
1656876682387,MATH 109,A01,083213,Ganzberger; Geoffrey Michael,2,0,34,32
1656876682387,MATH 109,A02,083214,Ganzberger; Geoffrey Michael,2,0,34,32
1656876682387,MATH 109,A03,093478,Ganzberger; Geoffrey Michael,1,0,34,33
1656876682387,MATH 109,B01,083215,Ganzberger; Geoffrey Michael,1,0,32,31
1656876682387,MATH 109,B02,083216,Ganzberger; Geoffrey Michael,1,0,32,31
1656876682387,MATH 109,B03,093479,Ganzberger; Geoffrey Michael,6,0,32,26
1656876688417,MATH 142A,A01,083219,Chow; Bennett,6,0,32,26
1656876688417,MATH 142A,A02,083220,Chow; Bennett,9,0,32,23
1656876688417,MATH 142A,A03,093480,Chow; Bennett,7,0,32,25
1656876688417,MATH 142A,B03,093481,Chow; Bennett,7,0,32,25
1656876688417,MATH 142A,B04,093558,Chow; Bennett,10,0,32,22
1656876688417,MATH 142A,B05,093559,Chow; Bennett,6,0,32,26
1656876694444,MATH 193A,A01,083224,Rotar; Vladimir,6,0,34,28
1656876694444,MATH 193A,A02,083225,Rotar; Vladimir,3,0,34,31
1656876694444,MATH 193A,A03,083781,Rotar; Vladimir,1,0,34,33
1656876694444,MATH 193A,A04,083782,Rotar; Vladimir,6,0,34,28
1656876694444,MATH 193A,A05,093482,Rotar; Vladimir,6,0,34,28
1656876700471,MATH 197,001,091859,McAuley; Julian John,9999,0,9999,0
1656876700471,MATH 197,002,095566,Kedlaya; Kiran S.,9997,0,9999,2
1656876700471,MATH 197,003,095567,Xiao; Ming,9999,0,9999,0
1656876700471,MATH 197,004,095571,Perols; Johan Lars,9998,0,9999,1
1656876707539,COGS 9,A01,083615,Shannon; Kyle Michael,6,0,75,69
1656876713567,COGS 11,A01,083617,Boyle; Mary E. T.,19,0,48,29
1656876719591,COGS 13,A01,083071,Bastos; Amalia Pinkusfeld,8,0,71,63
1656876725614,COGS 14A,A01,092681,Semenuks; Arturs,0,1,100,100
1656876731639,COGS 14B,A01,083073,Cheng; Tzu-Han,5,0,63,58
1656876737662,COGS 17,A01,092677,Semenuks; Arturs,4,0,81,77
1656876743685,COGS 100,A01,083619,Allen; Michael Gordon,15,0,70,55
1656876749713,COGS 101A,A01,083621,Davis; Joshua Daniel,9,0,68,59
1656876755739,COGS 101B,A01,091572,Allen; Michael Gordon,8,0,65,57
1656876761772,COGS 101C,A01,083625,Delgado; Tania,17,0,35,18
1656876767798,COGS 107A,A01,083627,Boyle; Mary E. T.,13,0,60,47
1656876773822,COGS 118A,A01,083075,Gupta; Anjum,15,0,76,61
1656876779849,CSE 3,A50,083646,Miranda; Gregory Joseph,22,0,50,28
1656876785875,CSE 8A,A50,083650,Miranda; Gregory Joseph,17,1,56,39
1656876791904,CSE 11,A01,083080,Cao; Yingjun,4,15,40,36
1656876797929,CSE 12,A01,083652,Krause-Levy; Sophia Louisa,20,1,120,100
1656876803972,CSE 15L,A01,083654,Morris; Justin Loren,8,0,50,42
1656876803972,CSE 15L,A02,083655,Morris; Justin Loren,8,0,50,42
1656876810001,CSE 20,A01,083657,Tran; Khoa Dang,37,0,80,43
1656876816025,CSE 21,A01,095574,Bach; Quang Tran,21,0,48,27
1656876822049,CSE 30,A01,083084,Eldon; John,4,0,80,76
1656876822049,CSE 30,B01,095061,Bhaskar; Nishant,6,0,50,44
1656876828073,CSE 100,A01,083659,Cao; Yingjun,2,4,70,68
1656876834097,CSE 134B,A01,083661,Powell; Thomas Allan,19,0,100,81
1656876840120,CSE 140,A01,083663,Gungor; Onat,14,0,85,71
1656876846142,CSE 140L,A01,083088,Eldon; John,16,0,100,84
1656876852165,CSE 175,A01,083665,Kumar; Rakesh,3,0,25,22
1656876858192,CSE 190,A00,092507,Dubnov; Shlomo,7,0,20,13
1656876864216,ECE 45,A01,083139,Congero; Spencer William,5,0,75,70
1656876870239,ECE 65,A50,083695,Saad; Andrew S,12,0,30,18
1656876870239,ECE 65,A51,095125,Saad; Andrew S,25,0,26,1
1656876876261,ECE 109,A01,091882,Touri; Behrouz,16,0,70,54
1656876882284,ECE 180,A00,083140,Abi Samra; Nicholas Camill,0,0,30,30
1656876882284,ECE 180,B00,083141,Abi Samra; Nicholas Camill,0,0,30,30
1656876888313,MATH 10A,A01,083735,Patchell; Gregory David,1,0,30,29
1656876888313,MATH 10A,A02,083736,Patchell; Gregory David,20,0,30,10
1656876888313,MATH 10A,A03,083737,Patchell; Gregory David,15,0,30,15
1656876894342,MATH 10B,A01,083207,Lim; Seonhee,7,0,34,27
1656876894342,MATH 10B,A02,083208,Lim; Seonhee,9,0,35,26
1656876894342,MATH 10B,A03,093472,Lim; Seonhee,4,0,34,30
1656876894342,MATH 10B,B01,083739,Sinha; Shubham,9,0,30,21
1656876900373,MATH 18,A01,083743,Cinel; Cameron Alexander,6,0,30,24
1656876900373,MATH 18,A02,083744,Cinel; Cameron Alexander,15,0,30,15
1656876900373,MATH 18,A03,083745,Cinel; Cameron Alexander,8,0,30,22
1656876900373,MATH 18,B01,083748,Rideout; David Porter,4,0,37,33
1656876900373,MATH 18,B02,083749,Rideout; David Porter,3,0,36,33
1656876900373,MATH 18,B03,083750,Rideout; David Porter,2,0,37,35
1656876900373,MATH 18,B04,083751,Rideout; David Porter,5,0,36,31
1656876900373,MATH 18,B05,093473,Rideout; David Porter,4,0,36,32
1656876900373,MATH 18,B06,093474,Rideout; David Porter,5,0,36,31
1656876906399,MATH 20A,A01,083754,Zheng; Zequn,12,0,40,28
1656876912426,MATH 20B,A01,083756,Briones; Jor-el Thomas Caparas,1,0,36,35
1656876912426,MATH 20B,A02,083757,Briones; Jor-el Thomas Caparas,1,0,36,35
1656876912426,MATH 20B,A03,093475,Briones; Jor-el Thomas Caparas,0,0,36,36
1656876918451,MATH 20C,A01,083760,Briones; Jor-el Thomas Caparas,1,0,35,34
1656876918451,MATH 20C,A02,083761,Briones; Jor-el Thomas Caparas,8,0,35,27
1656876918451,MATH 20C,A03,093476,Briones; Jor-el Thomas Caparas,0,1,36,36
1656876918451,MATH 20C,B01,083762,Bach; Quang Tran,0,0,30,30
1656876924478,MATH 20D,A01,083765,Tran; Brian Kha,4,0,30,26
1656876924478,MATH 20D,A02,083766,Tran; Brian Kha,4,0,30,26
1656876924478,MATH 20D,A03,083767,Tran; Brian Kha,2,0,30,28
1656876930502,MATH 20E,A01,083771,Ganguly; Soumya,5,0,32,27
1656876930502,MATH 20E,A02,083772,Ganguly; Soumya,6,0,32,26
1656876930502,MATH 20E,B01,083773,Ciotti; Benjamin,18,0,35,17
1656876930502,MATH 20E,B02,083774,Ciotti; Benjamin,17,0,35,18
1656876936532,MATH 103A,A01,083777,Greenfeld; Be'Eri,2,0,36,34
1656876936532,MATH 103A,A02,083778,Greenfeld; Be'Eri,5,0,36,31
1656876936532,MATH 103A,A03,093561,Greenfeld; Be'Eri,4,0,36,32
1656876936532,MATH 103A,B01,083779,Greenfeld; Be'Eri,6,0,36,30
1656876936532,MATH 103A,B02,083780,Greenfeld; Be'Eri,2,0,36,34
1656876936532,MATH 103A,B03,093562,Greenfeld; Be'Eri,2,0,36,34
1656876942565,MATH 105,A01,085443,Carter; Anne Toulson,13,0,35,22
1656876942565,MATH 105,A02,093477,Carter; Anne Toulson,20,0,35,15
1656876948595,MATH 109,A01,083213,Ganzberger; Geoffrey Michael,2,0,34,32
1656876948595,MATH 109,A02,083214,Ganzberger; Geoffrey Michael,2,0,34,32
1656876948595,MATH 109,A03,093478,Ganzberger; Geoffrey Michael,1,0,34,33
1656876948595,MATH 109,B01,083215,Ganzberger; Geoffrey Michael,1,0,32,31
1656876948595,MATH 109,B02,083216,Ganzberger; Geoffrey Michael,1,0,32,31
1656876948595,MATH 109,B03,093479,Ganzberger; Geoffrey Michael,6,0,32,26
1656876954619,MATH 142A,A01,083219,Chow; Bennett,6,0,32,26
1656876954619,MATH 142A,A02,083220,Chow; Bennett,9,0,32,23
1656876954619,MATH 142A,A03,093480,Chow; Bennett,7,0,32,25
1656876954619,MATH 142A,B03,093481,Chow; Bennett,7,0,32,25
1656876954619,MATH 142A,B04,093558,Chow; Bennett,10,0,32,22
1656876954619,MATH 142A,B05,093559,Chow; Bennett,6,0,32,26
1656876960647,MATH 193A,A01,083224,Rotar; Vladimir,6,0,34,28
1656876960647,MATH 193A,A02,083225,Rotar; Vladimir,3,0,34,31
1656876960647,MATH 193A,A03,083781,Rotar; Vladimir,1,0,34,33
1656876960647,MATH 193A,A04,083782,Rotar; Vladimir,6,0,34,28
1656876960647,MATH 193A,A05,093482,Rotar; Vladimir,6,0,34,28
1656876966674,MATH 197,001,091859,McAuley; Julian John,9999,0,9999,0
1656876966674,MATH 197,002,095566,Kedlaya; Kiran S.,9997,0,9999,2
1656876966674,MATH 197,003,095567,Xiao; Ming,9999,0,9999,0
1656876966674,MATH 197,004,095571,Perols; Johan Lars,9998,0,9999,1
1656876973741,COGS 9,A01,083615,Shannon; Kyle Michael,6,0,75,69
1656876979767,COGS 11,A01,083617,Boyle; Mary E. T.,19,0,48,29
1656876985790,COGS 13,A01,083071,Bastos; Amalia Pinkusfeld,8,0,71,63
1656876991814,COGS 14A,A01,092681,Semenuks; Arturs,0,1,100,100
1656876997837,COGS 14B,A01,083073,Cheng; Tzu-Han,5,0,63,58
1656877003863,COGS 17,A01,092677,Semenuks; Arturs,4,0,81,77
1656877009978,COGS 100,A01,083619,Allen; Michael Gordon,15,0,70,55
1656877016001,COGS 101A,A01,083621,Davis; Joshua Daniel,9,0,68,59
1656877022028,COGS 101B,A01,091572,Allen; Michael Gordon,8,0,65,57
1656877028049,COGS 101C,A01,083625,Delgado; Tania,17,0,35,18
1656877034072,COGS 107A,A01,083627,Boyle; Mary E. T.,13,0,60,47
1656877040097,COGS 118A,A01,083075,Gupta; Anjum,15,0,76,61
1656877046129,CSE 3,A50,083646,Miranda; Gregory Joseph,22,0,50,28
1656877052157,CSE 8A,A50,083650,Miranda; Gregory Joseph,17,1,56,39
1656877058182,CSE 11,A01,083080,Cao; Yingjun,4,15,40,36
1656877064207,CSE 12,A01,083652,Krause-Levy; Sophia Louisa,20,1,120,100
1656877070229,CSE 15L,A01,083654,Morris; Justin Loren,8,0,50,42
1656877070229,CSE 15L,A02,083655,Morris; Justin Loren,8,0,50,42
1656877076257,CSE 20,A01,083657,Tran; Khoa Dang,37,0,80,43
1656877082279,CSE 21,A01,095574,Bach; Quang Tran,21,0,48,27
1656877088308,CSE 30,A01,083084,Eldon; John,4,0,80,76
1656877088308,CSE 30,B01,095061,Bhaskar; Nishant,6,0,50,44
1656877094331,CSE 100,A01,083659,Cao; Yingjun,2,4,70,68
1656877100358,CSE 134B,A01,083661,Powell; Thomas Allan,19,0,100,81
1656877106384,CSE 140,A01,083663,Gungor; Onat,14,0,85,71
1656877112407,CSE 140L,A01,083088,Eldon; John,16,0,100,84
1656877118430,CSE 175,A01,083665,Kumar; Rakesh,3,0,25,22
1656877124454,CSE 190,A00,092507,Dubnov; Shlomo,7,0,20,13
1656877130483,ECE 45,A01,083139,Congero; Spencer William,5,0,75,70
1656877136511,ECE 65,A50,083695,Saad; Andrew S,12,0,30,18
1656877136511,ECE 65,A51,095125,Saad; Andrew S,25,0,26,1
1656877142539,ECE 109,A01,091882,Touri; Behrouz,16,0,70,54
1656877148566,ECE 180,A00,083140,Abi Samra; Nicholas Camill,0,0,30,30
1656877148566,ECE 180,B00,083141,Abi Samra; Nicholas Camill,0,0,30,30
1656877154588,MATH 10A,A01,083735,Patchell; Gregory David,1,0,30,29
1656877154588,MATH 10A,A02,083736,Patchell; Gregory David,20,0,30,10
1656877154588,MATH 10A,A03,083737,Patchell; Gregory David,15,0,30,15
1656877160616,MATH 10B,A01,083207,Lim; Seonhee,7,0,34,27
1656877160616,MATH 10B,A02,083208,Lim; Seonhee,9,0,35,26
1656877160616,MATH 10B,A03,093472,Lim; Seonhee,4,0,34,30
1656877160616,MATH 10B,B01,083739,Sinha; Shubham,9,0,30,21
1656877166647,MATH 18,A01,083743,Cinel; Cameron Alexander,6,0,30,24
1656877166647,MATH 18,A02,083744,Cinel; Cameron Alexander,15,0,30,15
1656877166647,MATH 18,A03,083745,Cinel; Cameron Alexander,8,0,30,22
1656877166647,MATH 18,B01,083748,Rideout; David Porter,4,0,37,33
1656877166647,MATH 18,B02,083749,Rideout; David Porter,3,0,36,33
1656877166647,MATH 18,B03,083750,Rideout; David Porter,2,0,37,35
1656877166647,MATH 18,B04,083751,Rideout; David Porter,5,0,36,31
1656877166647,MATH 18,B05,093473,Rideout; David Porter,4,0,36,32
1656877166647,MATH 18,B06,093474,Rideout; David Porter,5,0,36,31
1656877172671,MATH 20A,A01,083754,Zheng; Zequn,12,0,40,28
1656877178695,MATH 20B,A01,083756,Briones; Jor-el Thomas Caparas,1,0,36,35
1656877178695,MATH 20B,A02,083757,Briones; Jor-el Thomas Caparas,1,0,36,35
1656877178695,MATH 20B,A03,093475,Briones; Jor-el Thomas Caparas,0,0,36,36
1656877184724,MATH 20C,A01,083760,Briones; Jor-el Thomas Caparas,1,0,35,34
1656877184724,MATH 20C,A02,083761,Briones; Jor-el Thomas Caparas,8,0,35,27
1656877184724,MATH 20C,A03,093476,Briones; Jor-el Thomas Caparas,0,1,36,36
1656877184724,MATH 20C,B01,083762,Bach; Quang Tran,0,0,30,30
1656877190749,MATH 20D,A01,083765,Tran; Brian Kha,4,0,30,26
1656877190749,MATH 20D,A02,083766,Tran; Brian Kha,4,0,30,26
1656877190749,MATH 20D,A03,083767,Tran; Brian Kha,2,0,30,28
1656877196776,MATH 20E,A01,083771,Ganguly; Soumya,5,0,32,27
1656877196776,MATH 20E,A02,083772,Ganguly; Soumya,6,0,32,26
1656877196776,MATH 20E,B01,083773,Ciotti; Benjamin,18,0,35,17
1656877196776,MATH 20E,B02,083774,Ciotti; Benjamin,17,0,35,18
1656877202801,MATH 103A,A01,083777,Greenfeld; Be'Eri,2,0,36,34
1656877202801,MATH 103A,A02,083778,Greenfeld; Be'Eri,5,0,36,31
1656877202801,MATH 103A,A03,093561,Greenfeld; Be'Eri,4,0,36,32
1656877202801,MATH 103A,B01,083779,Greenfeld; Be'Eri,6,0,36,30
1656877202801,MATH 103A,B02,083780,Greenfeld; Be'Eri,2,0,36,34
1656877202801,MATH 103A,B03,093562,Greenfeld; Be'Eri,2,0,36,34
1656877208825,MATH 105,A01,085443,Carter; Anne Toulson,13,0,35,22
1656877208825,MATH 105,A02,093477,Carter; Anne Toulson,20,0,35,15
1656877214855,MATH 109,A01,083213,Ganzberger; Geoffrey Michael,2,0,34,32
1656877214855,MATH 109,A02,083214,Ganzberger; Geoffrey Michael,2,0,34,32
1656877214855,MATH 109,A03,093478,Ganzberger; Geoffrey Michael,1,0,34,33
1656877214855,MATH 109,B01,083215,Ganzberger; Geoffrey Michael,1,0,32,31
1656877214855,MATH 109,B02,083216,Ganzberger; Geoffrey Michael,1,0,32,31
1656877214855,MATH 109,B03,093479,Ganzberger; Geoffrey Michael,6,0,32,26
1656877220878,MATH 142A,A01,083219,Chow; Bennett,6,0,32,26
1656877220878,MATH 142A,A02,083220,Chow; Bennett,9,0,32,23
1656877220878,MATH 142A,A03,093480,Chow; Bennett,7,0,32,25
1656877220878,MATH 142A,B03,093481,Chow; Bennett,7,0,32,25
1656877220878,MATH 142A,B04,093558,Chow; Bennett,10,0,32,22
1656877220878,MATH 142A,B05,093559,Chow; Bennett,6,0,32,26
1656877226906,MATH 193A,A01,083224,Rotar; Vladimir,6,0,34,28
1656877226906,MATH 193A,A02,083225,Rotar; Vladimir,3,0,34,31
1656877226906,MATH 193A,A03,083781,Rotar; Vladimir,1,0,34,33
1656877226906,MATH 193A,A04,083782,Rotar; Vladimir,6,0,34,28
1656877226906,MATH 193A,A05,093482,Rotar; Vladimir,6,0,34,28
1656877232933,MATH 197,001,091859,McAuley; Julian John,9999,0,9999,0
1656877232933,MATH 197,002,095566,Kedlaya; Kiran S.,9997,0,9999,2
1656877232933,MATH 197,003,095567,Xiao; Ming,9999,0,9999,0
1656877232933,MATH 197,004,095571,Perols; Johan Lars,9998,0,9999,1
1656877240004,COGS 9,A01,083615,Shannon; Kyle Michael,6,0,75,69
1656877246031,COGS 11,A01,083617,Boyle; Mary E. T.,19,0,48,29
1656877252062,COGS 13,A01,083071,Bastos; Amalia Pinkusfeld,8,0,71,63
1656877258085,COGS 14A,A01,092681,Semenuks; Arturs,0,1,100,100
1656877264114,COGS 14B,A01,083073,Cheng; Tzu-Han,5,0,63,58
1656877270139,COGS 17,A01,092677,Semenuks; Arturs,4,0,81,77
1656877276161,COGS 100,A01,083619,Allen; Michael Gordon,15,0,70,55
1656877282184,COGS 101A,A01,083621,Davis; Joshua Daniel,9,0,68,59
1656877288207,COGS 101B,A01,091572,Allen; Michael Gordon,8,0,65,57
1656877294231,COGS 101C,A01,083625,Delgado; Tania,17,0,35,18
1656877300256,COGS 107A,A01,083627,Boyle; Mary E. T.,13,0,60,47
1656877306282,COGS 118A,A01,083075,Gupta; Anjum,15,0,76,61
1656877312304,CSE 3,A50,083646,Miranda; Gregory Joseph,22,0,50,28
1656877318332,CSE 8A,A50,083650,Miranda; Gregory Joseph,17,1,56,39
1656877324357,CSE 11,A01,083080,Cao; Yingjun,4,15,40,36
1656877330378,CSE 12,A01,083652,Krause-Levy; Sophia Louisa,20,1,120,100
1656877336402,CSE 15L,A01,083654,Morris; Justin Loren,8,0,50,42
1656877336402,CSE 15L,A02,083655,Morris; Justin Loren,8,0,50,42
1656877342429,CSE 20,A01,083657,Tran; Khoa Dang,37,0,80,43
1656877348452,CSE 21,A01,095574,Bach; Quang Tran,21,0,48,27
1656877354479,CSE 30,A01,083084,Eldon; John,4,0,80,76
1656877354479,CSE 30,B01,095061,Bhaskar; Nishant,6,0,50,44
1656877360502,CSE 100,A01,083659,Cao; Yingjun,2,4,70,68
1656877366544,CSE 134B,A01,083661,Powell; Thomas Allan,19,0,100,81
1656877372571,CSE 140,A01,083663,Gungor; Onat,14,0,85,71
1656877378598,CSE 140L,A01,083088,Eldon; John,16,0,100,84
1656877384622,CSE 175,A01,083665,Kumar; Rakesh,3,0,25,22
1656877390648,CSE 190,A00,092507,Dubnov; Shlomo,7,0,20,13
1656877396672,ECE 45,A01,083139,Congero; Spencer William,5,0,75,70
1656877402697,ECE 65,A50,083695,Saad; Andrew S,12,0,30,18
1656877402697,ECE 65,A51,095125,Saad; Andrew S,25,0,26,1
1656877408720,ECE 109,A01,091882,Touri; Behrouz,16,0,70,54
1656877414742,ECE 180,A00,083140,Abi Samra; Nicholas Camill,0,0,30,30
1656877414742,ECE 180,B00,083141,Abi Samra; Nicholas Camill,0,0,30,30
1656877420765,MATH 10A,A01,083735,Patchell; Gregory David,1,0,30,29
1656877420765,MATH 10A,A02,083736,Patchell; Gregory David,20,0,30,10
1656877420765,MATH 10A,A03,083737,Patchell; Gregory David,15,0,30,15
1656877426789,MATH 10B,A01,083207,Lim; Seonhee,7,0,34,27
1656877426789,MATH 10B,A02,083208,Lim; Seonhee,9,0,35,26
1656877426789,MATH 10B,A03,093472,Lim; Seonhee,4,0,34,30
1656877426789,MATH 10B,B01,083739,Sinha; Shubham,9,0,30,21
1656877432821,MATH 18,A01,083743,Cinel; Cameron Alexander,6,0,30,24
1656877432821,MATH 18,A02,083744,Cinel; Cameron Alexander,15,0,30,15
1656877432821,MATH 18,A03,083745,Cinel; Cameron Alexander,8,0,30,22
1656877432821,MATH 18,B01,083748,Rideout; David Porter,4,0,37,33
1656877432821,MATH 18,B02,083749,Rideout; David Porter,3,0,36,33
1656877432821,MATH 18,B03,083750,Rideout; David Porter,2,0,37,35
1656877432821,MATH 18,B04,083751,Rideout; David Porter,5,0,36,31
1656877432821,MATH 18,B05,093473,Rideout; David Porter,4,0,36,32
1656877432821,MATH 18,B06,093474,Rideout; David Porter,5,0,36,31
1656877438849,MATH 20A,A01,083754,Zheng; Zequn,12,0,40,28
1656877444884,MATH 20B,A01,083756,Briones; Jor-el Thomas Caparas,1,0,36,35
1656877444884,MATH 20B,A02,083757,Briones; Jor-el Thomas Caparas,1,0,36,35
1656877444884,MATH 20B,A03,093475,Briones; Jor-el Thomas Caparas,0,0,36,36
1656877450907,MATH 20C,A01,083760,Briones; Jor-el Thomas Caparas,1,0,35,34
1656877450907,MATH 20C,A02,083761,Briones; Jor-el Thomas Caparas,8,0,35,27
1656877450907,MATH 20C,A03,093476,Briones; Jor-el Thomas Caparas,0,1,36,36
1656877450907,MATH 20C,B01,083762,Bach; Quang Tran,0,0,30,30
1656877456939,MATH 20D,A01,083765,Tran; Brian Kha,4,0,30,26
1656877456939,MATH 20D,A02,083766,Tran; Brian Kha,4,0,30,26
1656877456939,MATH 20D,A03,083767,Tran; Brian Kha,2,0,30,28
1656877462968,MATH 20E,A01,083771,Ganguly; Soumya,5,0,32,27
1656877462968,MATH 20E,A02,083772,Ganguly; Soumya,6,0,32,26
1656877462968,MATH 20E,B01,083773,Ciotti; Benjamin,18,0,35,17
1656877462968,MATH 20E,B02,083774,Ciotti; Benjamin,17,0,35,18
1656877468993,MATH 103A,A01,083777,Greenfeld; Be'Eri,2,0,36,34
1656877468993,MATH 103A,A02,083778,Greenfeld; Be'Eri,5,0,36,31
1656877468993,MATH 103A,A03,093561,Greenfeld; Be'Eri,4,0,36,32
1656877468993,MATH 103A,B01,083779,Greenfeld; Be'Eri,6,0,36,30
1656877468993,MATH 103A,B02,083780,Greenfeld; Be'Eri,2,0,36,34
1656877468993,MATH 103A,B03,093562,Greenfeld; Be'Eri,2,0,36,34
1656877475023,MATH 105,A01,085443,Carter; Anne Toulson,13,0,35,22
1656877475023,MATH 105,A02,093477,Carter; Anne Toulson,20,0,35,15
1656877481047,MATH 109,A01,083213,Ganzberger; Geoffrey Michael,2,0,34,32
1656877481047,MATH 109,A02,083214,Ganzberger; Geoffrey Michael,2,0,34,32
1656877481047,MATH 109,A03,093478,Ganzberger; Geoffrey Michael,1,0,34,33
1656877481047,MATH 109,B01,083215,Ganzberger; Geoffrey Michael,1,0,32,31
1656877481047,MATH 109,B02,083216,Ganzberger; Geoffrey Michael,1,0,32,31
1656877481047,MATH 109,B03,093479,Ganzberger; Geoffrey Michael,6,0,32,26
1656877487078,MATH 142A,A01,083219,Chow; Bennett,6,0,32,26
1656877487078,MATH 142A,A02,083220,Chow; Bennett,9,0,32,23
1656877487078,MATH 142A,A03,093480,Chow; Bennett,7,0,32,25
1656877487078,MATH 142A,B03,093481,Chow; Bennett,7,0,32,25
1656877487078,MATH 142A,B04,093558,Chow; Bennett,10,0,32,22
1656877487078,MATH 142A,B05,093559,Chow; Bennett,6,0,32,26
1656877493105,MATH 193A,A01,083224,Rotar; Vladimir,6,0,34,28
1656877493105,MATH 193A,A02,083225,Rotar; Vladimir,3,0,34,31
1656877493105,MATH 193A,A03,083781,Rotar; Vladimir,1,0,34,33
1656877493105,MATH 193A,A04,083782,Rotar; Vladimir,6,0,34,28
1656877493105,MATH 193A,A05,093482,Rotar; Vladimir,6,0,34,28
1656877499132,MATH 197,001,091859,McAuley; Julian John,9999,0,9999,0
1656877499132,MATH 197,002,095566,Kedlaya; Kiran S.,9997,0,9999,2
1656877499132,MATH 197,003,095567,Xiao; Ming,9999,0,9999,0
1656877499132,MATH 197,004,095571,Perols; Johan Lars,9998,0,9999,1
1656877506190,COGS 9,A01,083615,Shannon; Kyle Michael,6,0,75,69
1656877512213,COGS 11,A01,083617,Boyle; Mary E. T.,19,0,48,29
1656877518242,COGS 13,A01,083071,Bastos; Amalia Pinkusfeld,8,0,71,63
1656877524264,COGS 14A,A01,092681,Semenuks; Arturs,0,1,100,100
1656877530287,COGS 14B,A01,083073,Cheng; Tzu-Han,5,0,63,58
1656877536310,COGS 17,A01,092677,Semenuks; Arturs,4,0,81,77
1656877542333,COGS 100,A01,083619,Allen; Michael Gordon,15,0,70,55
1656877548357,COGS 101A,A01,083621,Davis; Joshua Daniel,9,0,68,59
1656877554380,COGS 101B,A01,091572,Allen; Michael Gordon,8,0,65,57
1656877560403,COGS 101C,A01,083625,Delgado; Tania,17,0,35,18
1656877566426,COGS 107A,A01,083627,Boyle; Mary E. T.,13,0,60,47
1656877572449,COGS 118A,A01,083075,Gupta; Anjum,15,0,76,61
1656877578472,CSE 3,A50,083646,Miranda; Gregory Joseph,22,0,50,28
1656877584495,CSE 8A,A50,083650,Miranda; Gregory Joseph,17,1,56,39
1656877590522,CSE 11,A01,083080,Cao; Yingjun,4,15,40,36
1656877596545,CSE 12,A01,083652,Krause-Levy; Sophia Louisa,20,1,120,100
1656877602572,CSE 15L,A01,083654,Morris; Justin Loren,8,0,50,42
1656877602572,CSE 15L,A02,083655,Morris; Justin Loren,8,0,50,42
1656877608691,CSE 20,A01,083657,Tran; Khoa Dang,37,0,80,43
1656877614714,CSE 21,A01,095574,Bach; Quang Tran,21,0,48,27
1656877620738,CSE 30,A01,083084,Eldon; John,4,0,80,76
1656877620738,CSE 30,B01,095061,Bhaskar; Nishant,6,0,50,44
1656877626762,CSE 100,A01,083659,Cao; Yingjun,2,4,70,68
1656877632788,CSE 134B,A01,083661,Powell; Thomas Allan,19,0,100,81
1656877638814,CSE 140,A01,083663,Gungor; Onat,14,0,85,71
1656877644840,CSE 140L,A01,083088,Eldon; John,16,0,100,84
1656877650863,CSE 175,A01,083665,Kumar; Rakesh,3,0,25,22
1656877656889,CSE 190,A00,092507,Dubnov; Shlomo,7,0,20,13
1656877662910,ECE 45,A01,083139,Congero; Spencer William,5,0,75,70
1656877668935,ECE 65,A50,083695,Saad; Andrew S,12,0,30,18
1656877668935,ECE 65,A51,095125,Saad; Andrew S,25,0,26,1
1656877674962,ECE 109,A01,091882,Touri; Behrouz,16,0,70,54
1656877680993,ECE 180,A00,083140,Abi Samra; Nicholas Camill,0,0,30,30
1656877680993,ECE 180,B00,083141,Abi Samra; Nicholas Camill,0,0,30,30
1656877687016,MATH 10A,A01,083735,Patchell; Gregory David,1,0,30,29
1656877687016,MATH 10A,A02,083736,Patchell; Gregory David,20,0,30,10
1656877687016,MATH 10A,A03,083737,Patchell; Gregory David,15,0,30,15
1656877693043,MATH 10B,A01,083207,Lim; Seonhee,7,0,34,27
1656877693043,MATH 10B,A02,083208,Lim; Seonhee,9,0,35,26
1656877693043,MATH 10B,A03,093472,Lim; Seonhee,4,0,34,30
1656877693043,MATH 10B,B01,083739,Sinha; Shubham,9,0,30,21
1656877699074,MATH 18,A01,083743,Cinel; Cameron Alexander,6,0,30,24
1656877699074,MATH 18,A02,083744,Cinel; Cameron Alexander,15,0,30,15
1656877699074,MATH 18,A03,083745,Cinel; Cameron Alexander,8,0,30,22
1656877699074,MATH 18,B01,083748,Rideout; David Porter,4,0,37,33
1656877699074,MATH 18,B02,083749,Rideout; David Porter,3,0,36,33
1656877699074,MATH 18,B03,083750,Rideout; David Porter,2,0,37,35
1656877699074,MATH 18,B04,083751,Rideout; David Porter,5,0,36,31
1656877699074,MATH 18,B05,093473,Rideout; David Porter,4,0,36,32
1656877699074,MATH 18,B06,093474,Rideout; David Porter,5,0,36,31
1656877705104,MATH 20A,A01,083754,Zheng; Zequn,12,0,40,28
1656877711132,MATH 20B,A01,083756,Briones; Jor-el Thomas Caparas,1,0,36,35
1656877711132,MATH 20B,A02,083757,Briones; Jor-el Thomas Caparas,1,0,36,35
1656877711132,MATH 20B,A03,093475,Briones; Jor-el Thomas Caparas,0,0,36,36
1656877717155,MATH 20C,A01,083760,Briones; Jor-el Thomas Caparas,1,0,35,34
1656877717155,MATH 20C,A02,083761,Briones; Jor-el Thomas Caparas,8,0,35,27
1656877717155,MATH 20C,A03,093476,Briones; Jor-el Thomas Caparas,0,1,36,36
1656877717155,MATH 20C,B01,083762,Bach; Quang Tran,0,0,30,30
1656877723183,MATH 20D,A01,083765,Tran; Brian Kha,4,0,30,26
1656877723183,MATH 20D,A02,083766,Tran; Brian Kha,4,0,30,26
1656877723183,MATH 20D,A03,083767,Tran; Brian Kha,2,0,30,28
1656877729211,MATH 20E,A01,083771,Ganguly; Soumya,5,0,32,27
1656877729211,MATH 20E,A02,083772,Ganguly; Soumya,6,0,32,26
1656877729211,MATH 20E,B01,083773,Ciotti; Benjamin,18,0,35,17
1656877729211,MATH 20E,B02,083774,Ciotti; Benjamin,17,0,35,18
1656877735235,MATH 103A,A01,083777,Greenfeld; Be'Eri,2,0,36,34
1656877735235,MATH 103A,A02,083778,Greenfeld; Be'Eri,5,0,36,31
1656877735235,MATH 103A,A03,093561,Greenfeld; Be'Eri,4,0,36,32
1656877735235,MATH 103A,B01,083779,Greenfeld; Be'Eri,6,0,36,30
1656877735235,MATH 103A,B02,083780,Greenfeld; Be'Eri,2,0,36,34
1656877735235,MATH 103A,B03,093562,Greenfeld; Be'Eri,2,0,36,34
1656877741258,MATH 105,A01,085443,Carter; Anne Toulson,13,0,35,22
1656877741258,MATH 105,A02,093477,Carter; Anne Toulson,20,0,35,15
1656877747290,MATH 109,A01,083213,Ganzberger; Geoffrey Michael,2,0,34,32
1656877747290,MATH 109,A02,083214,Ganzberger; Geoffrey Michael,2,0,34,32
1656877747290,MATH 109,A03,093478,Ganzberger; Geoffrey Michael,1,0,34,33
1656877747290,MATH 109,B01,083215,Ganzberger; Geoffrey Michael,1,0,32,31
1656877747290,MATH 109,B02,083216,Ganzberger; Geoffrey Michael,1,0,32,31
1656877747290,MATH 109,B03,093479,Ganzberger; Geoffrey Michael,6,0,32,26
1656877753319,MATH 142A,A01,083219,Chow; Bennett,6,0,32,26
1656877753319,MATH 142A,A02,083220,Chow; Bennett,9,0,32,23
1656877753319,MATH 142A,A03,093480,Chow; Bennett,7,0,32,25
1656877753319,MATH 142A,B03,093481,Chow; Bennett,7,0,32,25
1656877753319,MATH 142A,B04,093558,Chow; Bennett,10,0,32,22
1656877753319,MATH 142A,B05,093559,Chow; Bennett,6,0,32,26
1656877759354,MATH 193A,A01,083224,Rotar; Vladimir,6,0,34,28
1656877759354,MATH 193A,A02,083225,Rotar; Vladimir,3,0,34,31
1656877759354,MATH 193A,A03,083781,Rotar; Vladimir,1,0,34,33
1656877759354,MATH 193A,A04,083782,Rotar; Vladimir,6,0,34,28
1656877759354,MATH 193A,A05,093482,Rotar; Vladimir,6,0,34,28
1656877765378,MATH 197,001,091859,McAuley; Julian John,9999,0,9999,0
1656877765378,MATH 197,002,095566,Kedlaya; Kiran S.,9997,0,9999,2
1656877765378,MATH 197,003,095567,Xiao; Ming,9999,0,9999,0
1656877765378,MATH 197,004,095571,Perols; Johan Lars,9998,0,9999,1
1656877772444,COGS 9,A01,083615,Shannon; Kyle Michael,6,0,75,69
1656877778467,COGS 11,A01,083617,Boyle; Mary E. T.,19,0,48,29
1656877784495,COGS 13,A01,083071,Bastos; Amalia Pinkusfeld,8,0,71,63
1656877790523,COGS 14A,A01,092681,Semenuks; Arturs,0,1,100,100
1656877796546,COGS 14B,A01,083073,Cheng; Tzu-Han,5,0,63,58
1656877802574,COGS 17,A01,092677,Semenuks; Arturs,4,0,81,77
1656877808603,COGS 100,A01,083619,Allen; Michael Gordon,15,0,70,55
1656877814627,COGS 101A,A01,083621,Davis; Joshua Daniel,9,0,68,59
1656877820650,COGS 101B,A01,091572,Allen; Michael Gordon,8,0,65,57
1656877826678,COGS 101C,A01,083625,Delgado; Tania,17,0,35,18
1656877832699,COGS 107A,A01,083627,Boyle; Mary E. T.,13,0,60,47
1656877838727,COGS 118A,A01,083075,Gupta; Anjum,15,0,76,61
1656877844751,CSE 3,A50,083646,Miranda; Gregory Joseph,22,0,50,28
1656877850776,CSE 8A,A50,083650,Miranda; Gregory Joseph,17,1,56,39
1656877856798,CSE 11,A01,083080,Cao; Yingjun,4,15,40,36
1656877862822,CSE 12,A01,083652,Krause-Levy; Sophia Louisa,20,1,120,100
1656877868846,CSE 15L,A01,083654,Morris; Justin Loren,8,0,50,42
1656877868846,CSE 15L,A02,083655,Morris; Justin Loren,8,0,50,42
1656877874872,CSE 20,A01,083657,Tran; Khoa Dang,37,0,80,43
1656877880895,CSE 21,A01,095574,Bach; Quang Tran,21,0,48,27
1656877886917,CSE 30,A01,083084,Eldon; John,4,0,80,76
1656877886917,CSE 30,B01,095061,Bhaskar; Nishant,6,0,50,44
1656877892944,CSE 100,A01,083659,Cao; Yingjun,2,4,70,68
1656877898975,CSE 134B,A01,083661,Powell; Thomas Allan,19,0,100,81
1656877904998,CSE 140,A01,083663,Gungor; Onat,14,0,85,71
1656877911021,CSE 140L,A01,083088,Eldon; John,16,0,100,84
1656877917044,CSE 175,A01,083665,Kumar; Rakesh,3,0,25,22
1656877923067,CSE 190,A00,092507,Dubnov; Shlomo,7,0,20,13
1656877929094,ECE 45,A01,083139,Congero; Spencer William,5,0,75,70
1656877935117,ECE 65,A50,083695,Saad; Andrew S,12,0,30,18
1656877935117,ECE 65,A51,095125,Saad; Andrew S,25,0,26,1
1656877941143,ECE 109,A01,091882,Touri; Behrouz,16,0,70,54
1656877947166,ECE 180,A00,083140,Abi Samra; Nicholas Camill,0,0,30,30
1656877947166,ECE 180,B00,083141,Abi Samra; Nicholas Camill,0,0,30,30
1656877953192,MATH 10A,A01,083735,Patchell; Gregory David,1,0,30,29
1656877953192,MATH 10A,A02,083736,Patchell; Gregory David,20,0,30,10
1656877953192,MATH 10A,A03,083737,Patchell; Gregory David,15,0,30,15
1656877959216,MATH 10B,A01,083207,Lim; Seonhee,7,0,34,27
1656877959216,MATH 10B,A02,083208,Lim; Seonhee,9,0,35,26
1656877959216,MATH 10B,A03,093472,Lim; Seonhee,4,0,34,30
1656877959216,MATH 10B,B01,083739,Sinha; Shubham,9,0,30,21
1656877965247,MATH 18,A01,083743,Cinel; Cameron Alexander,6,0,30,24
1656877965247,MATH 18,A02,083744,Cinel; Cameron Alexander,15,0,30,15
1656877965247,MATH 18,A03,083745,Cinel; Cameron Alexander,8,0,30,22
1656877965247,MATH 18,B01,083748,Rideout; David Porter,4,0,37,33
1656877965247,MATH 18,B02,083749,Rideout; David Porter,3,0,36,33
1656877965247,MATH 18,B03,083750,Rideout; David Porter,2,0,37,35
1656877965247,MATH 18,B04,083751,Rideout; David Porter,5,0,36,31
1656877965247,MATH 18,B05,093473,Rideout; David Porter,4,0,36,32
1656877965247,MATH 18,B06,093474,Rideout; David Porter,5,0,36,31
1656877971275,MATH 20A,A01,083754,Zheng; Zequn,12,0,40,28
1656877977297,MATH 20B,A01,083756,Briones; Jor-el Thomas Caparas,1,0,36,35
1656877977297,MATH 20B,A02,083757,Briones; Jor-el Thomas Caparas,1,0,36,35
1656877977297,MATH 20B,A03,093475,Briones; Jor-el Thomas Caparas,0,0,36,36
1656877983322,MATH 20C,A01,083760,Briones; Jor-el Thomas Caparas,1,0,35,34
1656877983322,MATH 20C,A02,083761,Briones; Jor-el Thomas Caparas,8,0,35,27
1656877983322,MATH 20C,A03,093476,Briones; Jor-el Thomas Caparas,0,1,36,36
1656877983322,MATH 20C,B01,083762,Bach; Quang Tran,0,0,30,30
1656877989348,MATH 20D,A01,083765,Tran; Brian Kha,4,0,30,26
1656877989348,MATH 20D,A02,083766,Tran; Brian Kha,4,0,30,26
1656877989348,MATH 20D,A03,083767,Tran; Brian Kha,2,0,30,28
1656877995371,MATH 20E,A01,083771,Ganguly; Soumya,5,0,32,27
1656877995371,MATH 20E,A02,083772,Ganguly; Soumya,6,0,32,26
1656877995371,MATH 20E,B01,083773,Ciotti; Benjamin,18,0,35,17
1656877995371,MATH 20E,B02,083774,Ciotti; Benjamin,17,0,35,18
1656878001400,MATH 103A,A01,083777,Greenfeld; Be'Eri,2,0,36,34
1656878001400,MATH 103A,A02,083778,Greenfeld; Be'Eri,5,0,36,31
1656878001400,MATH 103A,A03,093561,Greenfeld; Be'Eri,4,0,36,32
1656878001400,MATH 103A,B01,083779,Greenfeld; Be'Eri,6,0,36,30
1656878001400,MATH 103A,B02,083780,Greenfeld; Be'Eri,2,0,36,34
1656878001400,MATH 103A,B03,093562,Greenfeld; Be'Eri,2,0,36,34
1656878007423,MATH 105,A01,085443,Carter; Anne Toulson,13,0,35,22
1656878007423,MATH 105,A02,093477,Carter; Anne Toulson,20,0,35,15
1656878013446,MATH 109,A01,083213,Ganzberger; Geoffrey Michael,2,0,34,32
1656878013446,MATH 109,A02,083214,Ganzberger; Geoffrey Michael,2,0,34,32
1656878013446,MATH 109,A03,093478,Ganzberger; Geoffrey Michael,1,0,34,33
1656878013446,MATH 109,B01,083215,Ganzberger; Geoffrey Michael,1,0,32,31
1656878013446,MATH 109,B02,083216,Ganzberger; Geoffrey Michael,1,0,32,31
1656878013446,MATH 109,B03,093479,Ganzberger; Geoffrey Michael,6,0,32,26
1656878019481,MATH 142A,A01,083219,Chow; Bennett,6,0,32,26
1656878019481,MATH 142A,A02,083220,Chow; Bennett,9,0,32,23
1656878019481,MATH 142A,A03,093480,Chow; Bennett,7,0,32,25
1656878019481,MATH 142A,B03,093481,Chow; Bennett,7,0,32,25
1656878019481,MATH 142A,B04,093558,Chow; Bennett,10,0,32,22
1656878019481,MATH 142A,B05,093559,Chow; Bennett,6,0,32,26
1656878025509,MATH 193A,A01,083224,Rotar; Vladimir,6,0,34,28
1656878025509,MATH 193A,A02,083225,Rotar; Vladimir,3,0,34,31
1656878025509,MATH 193A,A03,083781,Rotar; Vladimir,1,0,34,33
1656878025509,MATH 193A,A04,083782,Rotar; Vladimir,6,0,34,28
1656878025509,MATH 193A,A05,093482,Rotar; Vladimir,6,0,34,28
1656878031540,MATH 197,001,091859,McAuley; Julian John,9999,0,9999,0
1656878031540,MATH 197,002,095566,Kedlaya; Kiran S.,9997,0,9999,2
1656878031540,MATH 197,003,095567,Xiao; Ming,9999,0,9999,0
1656878031540,MATH 197,004,095571,Perols; Johan Lars,9998,0,9999,1
1656878038592,COGS 9,A01,083615,Shannon; Kyle Michael,6,0,75,69
1656878044622,COGS 11,A01,083617,Boyle; Mary E. T.,19,0,48,29
1656878050649,COGS 13,A01,083071,Bastos; Amalia Pinkusfeld,8,0,71,63
1656878056675,COGS 14A,A01,092681,Semenuks; Arturs,0,1,100,100
1656878062696,COGS 14B,A01,083073,Cheng; Tzu-Han,5,0,63,58
1656878068724,COGS 17,A01,092677,Semenuks; Arturs,4,0,81,77
1656878074750,COGS 100,A01,083619,Allen; Michael Gordon,15,0,70,55
1656878080773,COGS 101A,A01,083621,Davis; Joshua Daniel,9,0,68,59
1656878086800,COGS 101B,A01,091572,Allen; Michael Gordon,8,0,65,57
1656878092826,COGS 101C,A01,083625,Delgado; Tania,17,0,35,18
1656878098849,COGS 107A,A01,083627,Boyle; Mary E. T.,13,0,60,47
1656878104879,COGS 118A,A01,083075,Gupta; Anjum,15,0,76,61
1656878110902,CSE 3,A50,083646,Miranda; Gregory Joseph,22,0,50,28
1656878116927,CSE 8A,A50,083650,Miranda; Gregory Joseph,17,1,56,39
1656878122956,CSE 11,A01,083080,Cao; Yingjun,4,15,40,36
1656878128983,CSE 12,A01,083652,Krause-Levy; Sophia Louisa,20,1,120,100
1656878135011,CSE 15L,A01,083654,Morris; Justin Loren,8,0,50,42
1656878135011,CSE 15L,A02,083655,Morris; Justin Loren,8,0,50,42
1656878141037,CSE 20,A01,083657,Tran; Khoa Dang,37,0,80,43
1656878147063,CSE 21,A01,095574,Bach; Quang Tran,21,0,48,27
1656878153087,CSE 30,A01,083084,Eldon; John,4,0,80,76
1656878153087,CSE 30,B01,095061,Bhaskar; Nishant,6,0,50,44
1656878159114,CSE 100,A01,083659,Cao; Yingjun,2,4,70,68
1656878165138,CSE 134B,A01,083661,Powell; Thomas Allan,19,0,100,81
1656878171165,CSE 140,A01,083663,Gungor; Onat,14,0,85,71
1656878177192,CSE 140L,A01,083088,Eldon; John,16,0,100,84
1656878183215,CSE 175,A01,083665,Kumar; Rakesh,3,0,25,22
1656878189238,CSE 190,A00,092507,Dubnov; Shlomo,7,0,20,13
1656878195261,ECE 45,A01,083139,Congero; Spencer William,5,0,75,70
1656878201283,ECE 65,A50,083695,Saad; Andrew S,12,0,30,18
1656878201283,ECE 65,A51,095125,Saad; Andrew S,25,0,26,1
1656878207392,ECE 109,A01,091882,Touri; Behrouz,16,0,70,54
1656878213419,ECE 180,A00,083140,Abi Samra; Nicholas Camill,0,0,30,30
1656878213419,ECE 180,B00,083141,Abi Samra; Nicholas Camill,0,0,30,30
1656878219443,MATH 10A,A01,083735,Patchell; Gregory David,1,0,30,29
1656878219443,MATH 10A,A02,083736,Patchell; Gregory David,20,0,30,10
1656878219443,MATH 10A,A03,083737,Patchell; Gregory David,15,0,30,15
1656878225477,MATH 10B,A01,083207,Lim; Seonhee,7,0,34,27
1656878225477,MATH 10B,A02,083208,Lim; Seonhee,9,0,35,26
1656878225477,MATH 10B,A03,093472,Lim; Seonhee,4,0,34,30
1656878225477,MATH 10B,B01,083739,Sinha; Shubham,9,0,30,21
1656878231508,MATH 18,A01,083743,Cinel; Cameron Alexander,6,0,30,24
1656878231508,MATH 18,A02,083744,Cinel; Cameron Alexander,15,0,30,15
1656878231508,MATH 18,A03,083745,Cinel; Cameron Alexander,8,0,30,22
1656878231508,MATH 18,B01,083748,Rideout; David Porter,4,0,37,33
1656878231508,MATH 18,B02,083749,Rideout; David Porter,3,0,36,33
1656878231508,MATH 18,B03,083750,Rideout; David Porter,2,0,37,35
1656878231508,MATH 18,B04,083751,Rideout; David Porter,5,0,36,31
1656878231508,MATH 18,B05,093473,Rideout; David Porter,4,0,36,32
1656878231508,MATH 18,B06,093474,Rideout; David Porter,5,0,36,31
1656878237532,MATH 20A,A01,083754,Zheng; Zequn,12,0,40,28
1656878243559,MATH 20B,A01,083756,Briones; Jor-el Thomas Caparas,1,0,36,35
1656878243559,MATH 20B,A02,083757,Briones; Jor-el Thomas Caparas,1,0,36,35
1656878243559,MATH 20B,A03,093475,Briones; Jor-el Thomas Caparas,0,0,36,36
1656878249587,MATH 20C,A01,083760,Briones; Jor-el Thomas Caparas,1,0,35,34
1656878249587,MATH 20C,A02,083761,Briones; Jor-el Thomas Caparas,8,0,35,27
1656878249587,MATH 20C,A03,093476,Briones; Jor-el Thomas Caparas,0,1,36,36
1656878249587,MATH 20C,B01,083762,Bach; Quang Tran,0,0,30,30
1656878255615,MATH 20D,A01,083765,Tran; Brian Kha,4,0,30,26
1656878255615,MATH 20D,A02,083766,Tran; Brian Kha,4,0,30,26
1656878255615,MATH 20D,A03,083767,Tran; Brian Kha,2,0,30,28
1656878261645,MATH 20E,A01,083771,Ganguly; Soumya,5,0,32,27
1656878261645,MATH 20E,A02,083772,Ganguly; Soumya,6,0,32,26
1656878261645,MATH 20E,B01,083773,Ciotti; Benjamin,18,0,35,17
1656878261645,MATH 20E,B02,083774,Ciotti; Benjamin,17,0,35,18
1656878278935,MATH 103A,A01,083777,Greenfeld; Be'Eri,2,0,36,34
1656878278935,MATH 103A,A02,083778,Greenfeld; Be'Eri,5,0,36,31
1656878278935,MATH 103A,A03,093561,Greenfeld; Be'Eri,4,0,36,32
1656878278935,MATH 103A,B01,083779,Greenfeld; Be'Eri,6,0,36,30
1656878278935,MATH 103A,B02,083780,Greenfeld; Be'Eri,2,0,36,34
1656878278935,MATH 103A,B03,093562,Greenfeld; Be'Eri,2,0,36,34
1656878284964,MATH 105,A01,085443,Carter; Anne Toulson,13,0,35,22
1656878284964,MATH 105,A02,093477,Carter; Anne Toulson,20,0,35,15
1656878290999,MATH 109,A01,083213,Ganzberger; Geoffrey Michael,2,0,34,32
1656878290999,MATH 109,A02,083214,Ganzberger; Geoffrey Michael,2,0,34,32
1656878290999,MATH 109,A03,093478,Ganzberger; Geoffrey Michael,1,0,34,33
1656878290999,MATH 109,B01,083215,Ganzberger; Geoffrey Michael,1,0,32,31
1656878290999,MATH 109,B02,083216,Ganzberger; Geoffrey Michael,1,0,32,31
1656878290999,MATH 109,B03,093479,Ganzberger; Geoffrey Michael,6,0,32,26
1656878297024,MATH 142A,A01,083219,Chow; Bennett,6,0,32,26
1656878297024,MATH 142A,A02,083220,Chow; Bennett,9,0,32,23
1656878297024,MATH 142A,A03,093480,Chow; Bennett,7,0,32,25
1656878297024,MATH 142A,B03,093481,Chow; Bennett,7,0,32,25
1656878297024,MATH 142A,B04,093558,Chow; Bennett,10,0,32,22
1656878297024,MATH 142A,B05,093559,Chow; Bennett,6,0,32,26
1656878303048,MATH 193A,A01,083224,Rotar; Vladimir,6,0,34,28
1656878303048,MATH 193A,A02,083225,Rotar; Vladimir,3,0,34,31
1656878303048,MATH 193A,A03,083781,Rotar; Vladimir,1,0,34,33
1656878303048,MATH 193A,A04,083782,Rotar; Vladimir,6,0,34,28
1656878303048,MATH 193A,A05,093482,Rotar; Vladimir,6,0,34,28
1656878309072,MATH 197,001,091859,McAuley; Julian John,9999,0,9999,0
1656878309072,MATH 197,002,095566,Kedlaya; Kiran S.,9997,0,9999,2
1656878309072,MATH 197,003,095567,Xiao; Ming,9999,0,9999,0
1656878309072,MATH 197,004,095571,Perols; Johan Lars,9998,0,9999,1
1656878316128,COGS 9,A01,083615,Shannon; Kyle Michael,6,0,75,69
1656878322155,COGS 11,A01,083617,Boyle; Mary E. T.,19,0,48,29
1656878328181,COGS 13,A01,083071,Bastos; Amalia Pinkusfeld,8,0,71,63
1656878334202,COGS 14A,A01,092681,Semenuks; Arturs,0,1,100,100
1656878340229,COGS 14B,A01,083073,Cheng; Tzu-Han,5,0,63,58
1656878346251,COGS 17,A01,092677,Semenuks; Arturs,4,0,81,77
1656878352275,COGS 100,A01,083619,Allen; Michael Gordon,15,0,70,55
1656878358299,COGS 101A,A01,083621,Davis; Joshua Daniel,9,0,68,59
1656878364322,COGS 101B,A01,091572,Allen; Michael Gordon,8,0,65,57
1656878370345,COGS 101C,A01,083625,Delgado; Tania,17,0,35,18
1656878376373,COGS 107A,A01,083627,Boyle; Mary E. T.,13,0,60,47
1656878382396,COGS 118A,A01,083075,Gupta; Anjum,15,0,76,61
1656878388431,CSE 3,A50,083646,Miranda; Gregory Joseph,22,0,50,28
1656878394456,CSE 8A,A50,083650,Miranda; Gregory Joseph,17,1,56,39
1656878400479,CSE 11,A01,083080,Cao; Yingjun,4,15,40,36
1656878406507,CSE 12,A01,083652,Krause-Levy; Sophia Louisa,20,1,120,100
1656878412537,CSE 15L,A01,083654,Morris; Justin Loren,8,0,50,42
1656878412537,CSE 15L,A02,083655,Morris; Justin Loren,8,0,50,42
1656878418560,CSE 20,A01,083657,Tran; Khoa Dang,37,0,80,43
1656878424583,CSE 21,A01,095574,Bach; Quang Tran,21,0,48,27
1656878430611,CSE 30,A01,083084,Eldon; John,4,0,80,76
1656878430611,CSE 30,B01,095061,Bhaskar; Nishant,6,0,50,44
1656878436634,CSE 100,A01,083659,Cao; Yingjun,2,4,70,68
1656878442658,CSE 134B,A01,083661,Powell; Thomas Allan,19,0,100,81
1656878448684,CSE 140,A01,083663,Gungor; Onat,14,0,85,71
1656878454707,CSE 140L,A01,083088,Eldon; John,16,0,100,84
1656878460730,CSE 175,A01,083665,Kumar; Rakesh,3,0,25,22
1656878466755,CSE 190,A00,092507,Dubnov; Shlomo,7,0,20,13
1656878472784,ECE 45,A01,083139,Congero; Spencer William,5,0,75,70
1656878478811,ECE 65,A50,083695,Saad; Andrew S,12,0,30,18
1656878478811,ECE 65,A51,095125,Saad; Andrew S,25,0,26,1
1656878484840,ECE 109,A01,091882,Touri; Behrouz,16,0,70,54
1656878490863,ECE 180,A00,083140,Abi Samra; Nicholas Camill,0,0,30,30
1656878490863,ECE 180,B00,083141,Abi Samra; Nicholas Camill,0,0,30,30
1656878496888,MATH 10A,A01,083735,Patchell; Gregory David,1,0,30,29
1656878496888,MATH 10A,A02,083736,Patchell; Gregory David,20,0,30,10
1656878496888,MATH 10A,A03,083737,Patchell; Gregory David,15,0,30,15
1656878502913,MATH 10B,A01,083207,Lim; Seonhee,7,0,34,27
1656878502913,MATH 10B,A02,083208,Lim; Seonhee,9,0,35,26
1656878502913,MATH 10B,A03,093472,Lim; Seonhee,4,0,34,30
1656878502913,MATH 10B,B01,083739,Sinha; Shubham,9,0,30,21
1656878508944,MATH 18,A01,083743,Cinel; Cameron Alexander,6,0,30,24
1656878508944,MATH 18,A02,083744,Cinel; Cameron Alexander,15,0,30,15
1656878508944,MATH 18,A03,083745,Cinel; Cameron Alexander,8,0,30,22
1656878508944,MATH 18,B01,083748,Rideout; David Porter,4,0,37,33
1656878508944,MATH 18,B02,083749,Rideout; David Porter,3,0,36,33
1656878508944,MATH 18,B03,083750,Rideout; David Porter,2,0,37,35
1656878508944,MATH 18,B04,083751,Rideout; David Porter,5,0,36,31
1656878508944,MATH 18,B05,093473,Rideout; David Porter,4,0,36,32
1656878508944,MATH 18,B06,093474,Rideout; David Porter,5,0,36,31
1656878514971,MATH 20A,A01,083754,Zheng; Zequn,12,0,40,28
1656878520993,MATH 20B,A01,083756,Briones; Jor-el Thomas Caparas,1,0,36,35
1656878520993,MATH 20B,A02,083757,Briones; Jor-el Thomas Caparas,1,0,36,35
1656878520993,MATH 20B,A03,093475,Briones; Jor-el Thomas Caparas,0,0,36,36
1656878527017,MATH 20C,A01,083760,Briones; Jor-el Thomas Caparas,1,0,35,34
1656878527017,MATH 20C,A02,083761,Briones; Jor-el Thomas Caparas,8,0,35,27
1656878527017,MATH 20C,A03,093476,Briones; Jor-el Thomas Caparas,0,1,36,36
1656878527017,MATH 20C,B01,083762,Bach; Quang Tran,0,0,30,30
1656878533042,MATH 20D,A01,083765,Tran; Brian Kha,4,0,30,26
1656878533042,MATH 20D,A02,083766,Tran; Brian Kha,4,0,30,26
1656878533042,MATH 20D,A03,083767,Tran; Brian Kha,2,0,30,28
1656878539069,MATH 20E,A01,083771,Ganguly; Soumya,5,0,32,27
1656878539069,MATH 20E,A02,083772,Ganguly; Soumya,6,0,32,26
1656878539069,MATH 20E,B01,083773,Ciotti; Benjamin,18,0,35,17
1656878539069,MATH 20E,B02,083774,Ciotti; Benjamin,17,0,35,18
1656878545102,MATH 103A,A01,083777,Greenfeld; Be'Eri,2,0,36,34
1656878545102,MATH 103A,A02,083778,Greenfeld; Be'Eri,5,0,36,31
1656878545102,MATH 103A,A03,093561,Greenfeld; Be'Eri,4,0,36,32
1656878545102,MATH 103A,B01,083779,Greenfeld; Be'Eri,6,0,36,30
1656878545102,MATH 103A,B02,083780,Greenfeld; Be'Eri,2,0,36,34
1656878545102,MATH 103A,B03,093562,Greenfeld; Be'Eri,2,0,36,34
1656878551128,MATH 105,A01,085443,Carter; Anne Toulson,13,0,35,22
1656878551128,MATH 105,A02,093477,Carter; Anne Toulson,20,0,35,15
1656878557157,MATH 109,A01,083213,Ganzberger; Geoffrey Michael,2,0,34,32
1656878557157,MATH 109,A02,083214,Ganzberger; Geoffrey Michael,2,0,34,32
1656878557157,MATH 109,A03,093478,Ganzberger; Geoffrey Michael,1,0,34,33
1656878557157,MATH 109,B01,083215,Ganzberger; Geoffrey Michael,1,0,32,31
1656878557157,MATH 109,B02,083216,Ganzberger; Geoffrey Michael,1,0,32,31
1656878557157,MATH 109,B03,093479,Ganzberger; Geoffrey Michael,6,0,32,26
1656878563193,MATH 142A,A01,083219,Chow; Bennett,6,0,32,26
1656878563193,MATH 142A,A02,083220,Chow; Bennett,9,0,32,23
1656878563193,MATH 142A,A03,093480,Chow; Bennett,7,0,32,25
1656878563193,MATH 142A,B03,093481,Chow; Bennett,7,0,32,25
1656878563193,MATH 142A,B04,093558,Chow; Bennett,10,0,32,22
1656878563193,MATH 142A,B05,093559,Chow; Bennett,6,0,32,26
1656878569227,MATH 193A,A01,083224,Rotar; Vladimir,6,0,34,28
1656878569227,MATH 193A,A02,083225,Rotar; Vladimir,3,0,34,31
1656878569227,MATH 193A,A03,083781,Rotar; Vladimir,1,0,34,33
1656878569227,MATH 193A,A04,083782,Rotar; Vladimir,6,0,34,28
1656878569227,MATH 193A,A05,093482,Rotar; Vladimir,6,0,34,28
1656878575250,MATH 197,001,091859,McAuley; Julian John,9999,0,9999,0
1656878575250,MATH 197,002,095566,Kedlaya; Kiran S.,9997,0,9999,2
1656878575250,MATH 197,003,095567,Xiao; Ming,9999,0,9999,0
1656878575250,MATH 197,004,095571,Perols; Johan Lars,9998,0,9999,1
1656878582301,COGS 9,A01,083615,Shannon; Kyle Michael,6,0,75,69
1656878588329,COGS 11,A01,083617,Boyle; Mary E. T.,19,0,48,29
1656878594353,COGS 13,A01,083071,Bastos; Amalia Pinkusfeld,8,0,71,63
1656878600384,COGS 14A,A01,092681,Semenuks; Arturs,0,1,100,100
1656878606405,COGS 14B,A01,083073,Cheng; Tzu-Han,5,0,63,58
1656878612429,COGS 17,A01,092677,Semenuks; Arturs,4,0,81,77
1656878618455,COGS 100,A01,083619,Allen; Michael Gordon,15,0,70,55
1656878624481,COGS 101A,A01,083621,Davis; Joshua Daniel,9,0,68,59
1656878630504,COGS 101B,A01,091572,Allen; Michael Gordon,8,0,65,57
1656878636527,COGS 101C,A01,083625,Delgado; Tania,17,0,35,18
1656878642550,COGS 107A,A01,083627,Boyle; Mary E. T.,13,0,60,47
1656878648577,COGS 118A,A01,083075,Gupta; Anjum,15,0,76,61
1656878654605,CSE 3,A50,083646,Miranda; Gregory Joseph,22,0,50,28
1656878660627,CSE 8A,A50,083650,Miranda; Gregory Joseph,17,1,56,39
1656878666653,CSE 11,A01,083080,Cao; Yingjun,4,15,40,36
1656878672677,CSE 12,A01,083652,Krause-Levy; Sophia Louisa,20,1,120,100
1656878678710,CSE 15L,A01,083654,Morris; Justin Loren,8,0,50,42
1656878678710,CSE 15L,A02,083655,Morris; Justin Loren,8,0,50,42
1656878684733,CSE 20,A01,083657,Tran; Khoa Dang,37,0,80,43
1656878690755,CSE 21,A01,095574,Bach; Quang Tran,21,0,48,27
1656878696782,CSE 30,A01,083084,Eldon; John,4,0,80,76
1656878696782,CSE 30,B01,095061,Bhaskar; Nishant,6,0,50,44
1656878702806,CSE 100,A01,083659,Cao; Yingjun,2,4,70,68
1656878708829,CSE 134B,A01,083661,Powell; Thomas Allan,19,0,100,81
1656878714855,CSE 140,A01,083663,Gungor; Onat,14,0,85,71
1656878720882,CSE 140L,A01,083088,Eldon; John,16,0,100,84
1656878726906,CSE 175,A01,083665,Kumar; Rakesh,3,0,25,22
1656878732929,CSE 190,A00,092507,Dubnov; Shlomo,7,0,20,13
1656878738953,ECE 45,A01,083139,Congero; Spencer William,5,0,75,70
1656878744975,ECE 65,A50,083695,Saad; Andrew S,12,0,30,18
1656878744975,ECE 65,A51,095125,Saad; Andrew S,25,0,26,1
1656878751001,ECE 109,A01,091882,Touri; Behrouz,16,0,70,54
1656878757028,ECE 180,A00,083140,Abi Samra; Nicholas Camill,0,0,30,30
1656878757028,ECE 180,B00,083141,Abi Samra; Nicholas Camill,0,0,30,30
1656878763051,MATH 10A,A01,083735,Patchell; Gregory David,1,0,30,29
1656878763051,MATH 10A,A02,083736,Patchell; Gregory David,20,0,30,10
1656878763051,MATH 10A,A03,083737,Patchell; Gregory David,15,0,30,15
1656878769084,MATH 10B,A01,083207,Lim; Seonhee,7,0,34,27
1656878769084,MATH 10B,A02,083208,Lim; Seonhee,9,0,35,26
1656878769084,MATH 10B,A03,093472,Lim; Seonhee,4,0,34,30
1656878769084,MATH 10B,B01,083739,Sinha; Shubham,9,0,30,21
1656878775123,MATH 18,A01,083743,Cinel; Cameron Alexander,6,0,30,24
1656878775123,MATH 18,A02,083744,Cinel; Cameron Alexander,15,0,30,15
1656878775123,MATH 18,A03,083745,Cinel; Cameron Alexander,8,0,30,22
1656878775123,MATH 18,B01,083748,Rideout; David Porter,4,0,37,33
1656878775123,MATH 18,B02,083749,Rideout; David Porter,3,0,36,33
1656878775123,MATH 18,B03,083750,Rideout; David Porter,2,0,37,35
1656878775123,MATH 18,B04,083751,Rideout; David Porter,5,0,36,31
1656878775123,MATH 18,B05,093473,Rideout; David Porter,4,0,36,32
1656878775123,MATH 18,B06,093474,Rideout; David Porter,5,0,36,31
1656878781155,MATH 20A,A01,083754,Zheng; Zequn,12,0,40,28
1656878787178,MATH 20B,A01,083756,Briones; Jor-el Thomas Caparas,1,0,36,35
1656878787178,MATH 20B,A02,083757,Briones; Jor-el Thomas Caparas,1,0,36,35
1656878787178,MATH 20B,A03,093475,Briones; Jor-el Thomas Caparas,0,0,36,36
1656878793208,MATH 20C,A01,083760,Briones; Jor-el Thomas Caparas,1,0,35,34
1656878793208,MATH 20C,A02,083761,Briones; Jor-el Thomas Caparas,8,0,35,27
1656878793208,MATH 20C,A03,093476,Briones; Jor-el Thomas Caparas,0,1,36,36
1656878793208,MATH 20C,B01,083762,Bach; Quang Tran,0,0,30,30
1656878799240,MATH 20D,A01,083765,Tran; Brian Kha,4,0,30,26
1656878799240,MATH 20D,A02,083766,Tran; Brian Kha,4,0,30,26
1656878799240,MATH 20D,A03,083767,Tran; Brian Kha,2,0,30,28
1656878805272,MATH 20E,A01,083771,Ganguly; Soumya,5,0,32,27
1656878805272,MATH 20E,A02,083772,Ganguly; Soumya,6,0,32,26
1656878805272,MATH 20E,B01,083773,Ciotti; Benjamin,18,0,35,17
1656878805272,MATH 20E,B02,083774,Ciotti; Benjamin,17,0,35,18
1656878811303,MATH 103A,A01,083777,Greenfeld; Be'Eri,2,0,36,34
1656878811303,MATH 103A,A02,083778,Greenfeld; Be'Eri,5,0,36,31
1656878811303,MATH 103A,A03,093561,Greenfeld; Be'Eri,4,0,36,32
1656878811303,MATH 103A,B01,083779,Greenfeld; Be'Eri,6,0,36,30
1656878811303,MATH 103A,B02,083780,Greenfeld; Be'Eri,2,0,36,34
1656878811303,MATH 103A,B03,093562,Greenfeld; Be'Eri,2,0,36,34
1656878817438,MATH 105,A01,085443,Carter; Anne Toulson,13,0,35,22
1656878817438,MATH 105,A02,093477,Carter; Anne Toulson,20,0,35,15
1656878823476,MATH 109,A01,083213,Ganzberger; Geoffrey Michael,2,0,34,32
1656878823476,MATH 109,A02,083214,Ganzberger; Geoffrey Michael,2,0,34,32
1656878823476,MATH 109,A03,093478,Ganzberger; Geoffrey Michael,1,0,34,33
1656878823476,MATH 109,B01,083215,Ganzberger; Geoffrey Michael,1,0,32,31
1656878823476,MATH 109,B02,083216,Ganzberger; Geoffrey Michael,1,0,32,31
1656878823476,MATH 109,B03,093479,Ganzberger; Geoffrey Michael,6,0,32,26
1656878829500,MATH 142A,A01,083219,Chow; Bennett,6,0,32,26
1656878829500,MATH 142A,A02,083220,Chow; Bennett,9,0,32,23
1656878829500,MATH 142A,A03,093480,Chow; Bennett,7,0,32,25
1656878829500,MATH 142A,B03,093481,Chow; Bennett,7,0,32,25
1656878829500,MATH 142A,B04,093558,Chow; Bennett,10,0,32,22
1656878829500,MATH 142A,B05,093559,Chow; Bennett,6,0,32,26
1656878835522,MATH 193A,A01,083224,Rotar; Vladimir,6,0,34,28
1656878835522,MATH 193A,A02,083225,Rotar; Vladimir,3,0,34,31
1656878835522,MATH 193A,A03,083781,Rotar; Vladimir,1,0,34,33
1656878835522,MATH 193A,A04,083782,Rotar; Vladimir,6,0,34,28
1656878835522,MATH 193A,A05,093482,Rotar; Vladimir,6,0,34,28
1656878841548,MATH 197,001,091859,McAuley; Julian John,9999,0,9999,0
1656878841548,MATH 197,002,095566,Kedlaya; Kiran S.,9997,0,9999,2
1656878841548,MATH 197,003,095567,Xiao; Ming,9999,0,9999,0
1656878841548,MATH 197,004,095571,Perols; Johan Lars,9998,0,9999,1
1656878848623,COGS 9,A01,083615,Shannon; Kyle Michael,6,0,75,69
1656878854646,COGS 11,A01,083617,Boyle; Mary E. T.,19,0,48,29
1656878860680,COGS 13,A01,083071,Bastos; Amalia Pinkusfeld,8,0,71,63
1656878866719,COGS 14A,A01,092681,Semenuks; Arturs,0,1,100,100
1656878872750,COGS 14B,A01,083073,Cheng; Tzu-Han,5,0,63,58
1656878878776,COGS 17,A01,092677,Semenuks; Arturs,4,0,81,77
1656878884798,COGS 100,A01,083619,Allen; Michael Gordon,15,0,70,55
1656878890821,COGS 101A,A01,083621,Davis; Joshua Daniel,9,0,68,59
1656878896843,COGS 101B,A01,091572,Allen; Michael Gordon,8,0,65,57
1656878902869,COGS 101C,A01,083625,Delgado; Tania,17,0,35,18
1656878908896,COGS 107A,A01,083627,Boyle; Mary E. T.,13,0,60,47
1656878914923,COGS 118A,A01,083075,Gupta; Anjum,15,0,76,61
1656878920951,CSE 3,A50,083646,Miranda; Gregory Joseph,22,0,50,28
1656878926975,CSE 8A,A50,083650,Miranda; Gregory Joseph,17,1,56,39
1656878933003,CSE 11,A01,083080,Cao; Yingjun,4,15,40,36
1656878939029,CSE 12,A01,083652,Krause-Levy; Sophia Louisa,20,1,120,100
1656878945052,CSE 15L,A01,083654,Morris; Justin Loren,8,0,50,42
1656878945052,CSE 15L,A02,083655,Morris; Justin Loren,8,0,50,42
1656878951075,CSE 20,A01,083657,Tran; Khoa Dang,37,0,80,43
1656878957111,CSE 21,A01,095574,Bach; Quang Tran,21,0,48,27
1656878963134,CSE 30,A01,083084,Eldon; John,4,0,80,76
1656878963134,CSE 30,B01,095061,Bhaskar; Nishant,6,0,50,44
1656878969158,CSE 100,A01,083659,Cao; Yingjun,2,4,70,68
1656878975192,CSE 134B,A01,083661,Powell; Thomas Allan,19,0,100,81
1656878981214,CSE 140,A01,083663,Gungor; Onat,14,0,85,71
1656878987244,CSE 140L,A01,083088,Eldon; John,16,0,100,84
1656878993271,CSE 175,A01,083665,Kumar; Rakesh,3,0,25,22
1656878999294,CSE 190,A00,092507,Dubnov; Shlomo,7,0,20,13
1656879005317,ECE 45,A01,083139,Congero; Spencer William,5,0,75,70
1656879011347,ECE 65,A50,083695,Saad; Andrew S,12,0,30,18
1656879011347,ECE 65,A51,095125,Saad; Andrew S,25,0,26,1
1656879017370,ECE 109,A01,091882,Touri; Behrouz,16,0,70,54
1656879023392,ECE 180,A00,083140,Abi Samra; Nicholas Camill,0,0,30,30
1656879023392,ECE 180,B00,083141,Abi Samra; Nicholas Camill,0,0,30,30
1656879029416,MATH 10A,A01,083735,Patchell; Gregory David,1,0,30,29
1656879029416,MATH 10A,A02,083736,Patchell; Gregory David,20,0,30,10
1656879029416,MATH 10A,A03,083737,Patchell; Gregory David,15,0,30,15
1656879035445,MATH 10B,A01,083207,Lim; Seonhee,7,0,34,27
1656879035445,MATH 10B,A02,083208,Lim; Seonhee,9,0,35,26
1656879035445,MATH 10B,A03,093472,Lim; Seonhee,4,0,34,30
1656879035445,MATH 10B,B01,083739,Sinha; Shubham,9,0,30,21
1656879041475,MATH 18,A01,083743,Cinel; Cameron Alexander,6,0,30,24
1656879041475,MATH 18,A02,083744,Cinel; Cameron Alexander,15,0,30,15
1656879041475,MATH 18,A03,083745,Cinel; Cameron Alexander,8,0,30,22
1656879041475,MATH 18,B01,083748,Rideout; David Porter,4,0,37,33
1656879041475,MATH 18,B02,083749,Rideout; David Porter,3,0,36,33
1656879041475,MATH 18,B03,083750,Rideout; David Porter,2,0,37,35
1656879041475,MATH 18,B04,083751,Rideout; David Porter,5,0,36,31
1656879041475,MATH 18,B05,093473,Rideout; David Porter,4,0,36,32
1656879041475,MATH 18,B06,093474,Rideout; David Porter,5,0,36,31
1656879047498,MATH 20A,A01,083754,Zheng; Zequn,12,0,40,28
1656879053521,MATH 20B,A01,083756,Briones; Jor-el Thomas Caparas,1,0,36,35
1656879053521,MATH 20B,A02,083757,Briones; Jor-el Thomas Caparas,1,0,36,35
1656879053521,MATH 20B,A03,093475,Briones; Jor-el Thomas Caparas,0,0,36,36
1656879059545,MATH 20C,A01,083760,Briones; Jor-el Thomas Caparas,1,0,35,34
1656879059545,MATH 20C,A02,083761,Briones; Jor-el Thomas Caparas,8,0,35,27
1656879059545,MATH 20C,A03,093476,Briones; Jor-el Thomas Caparas,0,1,36,36
1656879059545,MATH 20C,B01,083762,Bach; Quang Tran,0,0,30,30
1656879065582,MATH 20D,A01,083765,Tran; Brian Kha,4,0,30,26
1656879065582,MATH 20D,A02,083766,Tran; Brian Kha,4,0,30,26
1656879065582,MATH 20D,A03,083767,Tran; Brian Kha,2,0,30,28
1656879071622,MATH 20E,A01,083771,Ganguly; Soumya,5,0,32,27
1656879071622,MATH 20E,A02,083772,Ganguly; Soumya,6,0,32,26
1656879071622,MATH 20E,B01,083773,Ciotti; Benjamin,18,0,35,17
1656879071622,MATH 20E,B02,083774,Ciotti; Benjamin,17,0,35,18
1656879077647,MATH 103A,A01,083777,Greenfeld; Be'Eri,2,0,36,34
1656879077647,MATH 103A,A02,083778,Greenfeld; Be'Eri,5,0,36,31
1656879077647,MATH 103A,A03,093561,Greenfeld; Be'Eri,4,0,36,32
1656879077647,MATH 103A,B01,083779,Greenfeld; Be'Eri,6,0,36,30
1656879077647,MATH 103A,B02,083780,Greenfeld; Be'Eri,2,0,36,34
1656879077647,MATH 103A,B03,093562,Greenfeld; Be'Eri,2,0,36,34
1656879083676,MATH 105,A01,085443,Carter; Anne Toulson,13,0,35,22
1656879083676,MATH 105,A02,093477,Carter; Anne Toulson,20,0,35,15
1656879089698,MATH 109,A01,083213,Ganzberger; Geoffrey Michael,2,0,34,32
1656879089698,MATH 109,A02,083214,Ganzberger; Geoffrey Michael,2,0,34,32
1656879089698,MATH 109,A03,093478,Ganzberger; Geoffrey Michael,1,0,34,33
1656879089698,MATH 109,B01,083215,Ganzberger; Geoffrey Michael,1,0,32,31
1656879089698,MATH 109,B02,083216,Ganzberger; Geoffrey Michael,1,0,32,31
1656879089698,MATH 109,B03,093479,Ganzberger; Geoffrey Michael,6,0,32,26
1656879095724,MATH 142A,A01,083219,Chow; Bennett,6,0,32,26
1656879095724,MATH 142A,A02,083220,Chow; Bennett,9,0,32,23
1656879095724,MATH 142A,A03,093480,Chow; Bennett,7,0,32,25
1656879095724,MATH 142A,B03,093481,Chow; Bennett,7,0,32,25
1656879095724,MATH 142A,B04,093558,Chow; Bennett,10,0,32,22
1656879095724,MATH 142A,B05,093559,Chow; Bennett,6,0,32,26
1656879101760,MATH 193A,A01,083224,Rotar; Vladimir,6,0,34,28
1656879101760,MATH 193A,A02,083225,Rotar; Vladimir,3,0,34,31
1656879101760,MATH 193A,A03,083781,Rotar; Vladimir,1,0,34,33
1656879101760,MATH 193A,A04,083782,Rotar; Vladimir,6,0,34,28
1656879101760,MATH 193A,A05,093482,Rotar; Vladimir,6,0,34,28
1656879107783,MATH 197,001,091859,McAuley; Julian John,9999,0,9999,0
1656879107783,MATH 197,002,095566,Kedlaya; Kiran S.,9997,0,9999,2
1656879107783,MATH 197,003,095567,Xiao; Ming,9999,0,9999,0
1656879107783,MATH 197,004,095571,Perols; Johan Lars,9998,0,9999,1
1656879114836,COGS 9,A01,083615,Shannon; Kyle Michael,6,0,75,69
1656879120859,COGS 11,A01,083617,Boyle; Mary E. T.,19,0,48,29
1656879126882,COGS 13,A01,083071,Bastos; Amalia Pinkusfeld,8,0,71,63
1656879132905,COGS 14A,A01,092681,Semenuks; Arturs,0,1,100,100
1656879138932,COGS 14B,A01,083073,Cheng; Tzu-Han,5,0,63,58
1656879144954,COGS 17,A01,092677,Semenuks; Arturs,4,0,81,77
1656879150981,COGS 100,A01,083619,Allen; Michael Gordon,15,0,70,55
1656879157005,COGS 101A,A01,083621,Davis; Joshua Daniel,9,0,68,59
1656879163032,COGS 101B,A01,091572,Allen; Michael Gordon,8,0,65,57
1656879169059,COGS 101C,A01,083625,Delgado; Tania,17,0,35,18
1656879175083,COGS 107A,A01,083627,Boyle; Mary E. T.,13,0,60,47
1656879181111,COGS 118A,A01,083075,Gupta; Anjum,15,0,76,61
1656879187135,CSE 3,A50,083646,Miranda; Gregory Joseph,22,0,50,28
1656879193161,CSE 8A,A50,083650,Miranda; Gregory Joseph,17,1,56,39
1656879199187,CSE 11,A01,083080,Cao; Yingjun,4,15,40,36
1656879205210,CSE 12,A01,083652,Krause-Levy; Sophia Louisa,20,1,120,100
1656879211238,CSE 15L,A01,083654,Morris; Justin Loren,8,0,50,42
1656879211238,CSE 15L,A02,083655,Morris; Justin Loren,8,0,50,42
1656879217262,CSE 20,A01,083657,Tran; Khoa Dang,37,0,80,43
1656879223290,CSE 21,A01,095574,Bach; Quang Tran,21,0,48,27
1656879229314,CSE 30,A01,083084,Eldon; John,4,0,80,76
1656879229314,CSE 30,B01,095061,Bhaskar; Nishant,6,0,50,44
1656879235368,CSE 100,A01,083659,Cao; Yingjun,2,4,70,68
1656879241392,CSE 134B,A01,083661,Powell; Thomas Allan,19,0,100,81
1656879247415,CSE 140,A01,083663,Gungor; Onat,14,0,85,71
1656879253439,CSE 140L,A01,083088,Eldon; John,16,0,100,84
1656879259463,CSE 175,A01,083665,Kumar; Rakesh,3,0,25,22
1656879265485,CSE 190,A00,092507,Dubnov; Shlomo,7,0,20,13
1656879271513,ECE 45,A01,083139,Congero; Spencer William,5,0,75,70
1656879277539,ECE 65,A50,083695,Saad; Andrew S,12,0,30,18
1656879277539,ECE 65,A51,095125,Saad; Andrew S,25,0,26,1
1656879283562,ECE 109,A01,091882,Touri; Behrouz,16,0,70,54
1656879289585,ECE 180,A00,083140,Abi Samra; Nicholas Camill,0,0,30,30
1656879289585,ECE 180,B00,083141,Abi Samra; Nicholas Camill,0,0,30,30
1656879295608,MATH 10A,A01,083735,Patchell; Gregory David,1,0,30,29
1656879295608,MATH 10A,A02,083736,Patchell; Gregory David,20,0,30,10
1656879295608,MATH 10A,A03,083737,Patchell; Gregory David,15,0,30,15
1656879301644,MATH 10B,A01,083207,Lim; Seonhee,7,0,34,27
1656879301644,MATH 10B,A02,083208,Lim; Seonhee,9,0,35,26
1656879301644,MATH 10B,A03,093472,Lim; Seonhee,4,0,34,30
1656879301644,MATH 10B,B01,083739,Sinha; Shubham,9,0,30,21
1656879307666,MATH 18,A01,083743,Cinel; Cameron Alexander,6,0,30,24
1656879307666,MATH 18,A02,083744,Cinel; Cameron Alexander,15,0,30,15
1656879307666,MATH 18,A03,083745,Cinel; Cameron Alexander,8,0,30,22
1656879307666,MATH 18,B01,083748,Rideout; David Porter,4,0,37,33
1656879307666,MATH 18,B02,083749,Rideout; David Porter,3,0,36,33
1656879307666,MATH 18,B03,083750,Rideout; David Porter,2,0,37,35
1656879307666,MATH 18,B04,083751,Rideout; David Porter,5,0,36,31
1656879307666,MATH 18,B05,093473,Rideout; David Porter,4,0,36,32
1656879307666,MATH 18,B06,093474,Rideout; David Porter,5,0,36,31
1656879313694,MATH 20A,A01,083754,Zheng; Zequn,12,0,40,28
1656879319718,MATH 20B,A01,083756,Briones; Jor-el Thomas Caparas,1,0,36,35
1656879319718,MATH 20B,A02,083757,Briones; Jor-el Thomas Caparas,1,0,36,35
1656879319718,MATH 20B,A03,093475,Briones; Jor-el Thomas Caparas,0,0,36,36
1656879325762,MATH 20C,A01,083760,Briones; Jor-el Thomas Caparas,1,0,35,34
1656879325762,MATH 20C,A02,083761,Briones; Jor-el Thomas Caparas,8,0,35,27
1656879325762,MATH 20C,A03,093476,Briones; Jor-el Thomas Caparas,0,1,36,36
1656879325762,MATH 20C,B01,083762,Bach; Quang Tran,0,0,30,30
1656879331785,MATH 20D,A01,083765,Tran; Brian Kha,4,0,30,26
1656879331785,MATH 20D,A02,083766,Tran; Brian Kha,4,0,30,26
1656879331785,MATH 20D,A03,083767,Tran; Brian Kha,2,0,30,28
1656879337807,MATH 20E,A01,083771,Ganguly; Soumya,5,0,32,27
1656879337807,MATH 20E,A02,083772,Ganguly; Soumya,6,0,32,26
1656879337807,MATH 20E,B01,083773,Ciotti; Benjamin,18,0,35,17
1656879337807,MATH 20E,B02,083774,Ciotti; Benjamin,17,0,35,18
1656879343835,MATH 103A,A01,083777,Greenfeld; Be'Eri,2,0,36,34
1656879343835,MATH 103A,A02,083778,Greenfeld; Be'Eri,5,0,36,31
1656879343835,MATH 103A,A03,093561,Greenfeld; Be'Eri,4,0,36,32
1656879343835,MATH 103A,B01,083779,Greenfeld; Be'Eri,6,0,36,30
1656879343835,MATH 103A,B02,083780,Greenfeld; Be'Eri,2,0,36,34
1656879343835,MATH 103A,B03,093562,Greenfeld; Be'Eri,2,0,36,34
1656879349858,MATH 105,A01,085443,Carter; Anne Toulson,13,0,35,22
1656879349858,MATH 105,A02,093477,Carter; Anne Toulson,20,0,35,15
1656879355882,MATH 109,A01,083213,Ganzberger; Geoffrey Michael,2,0,34,32
1656879355882,MATH 109,A02,083214,Ganzberger; Geoffrey Michael,2,0,34,32
1656879355882,MATH 109,A03,093478,Ganzberger; Geoffrey Michael,1,0,34,33
1656879355882,MATH 109,B01,083215,Ganzberger; Geoffrey Michael,1,0,32,31
1656879355882,MATH 109,B02,083216,Ganzberger; Geoffrey Michael,1,0,32,31
1656879355882,MATH 109,B03,093479,Ganzberger; Geoffrey Michael,6,0,32,26
1656879361906,MATH 142A,A01,083219,Chow; Bennett,6,0,32,26
1656879361906,MATH 142A,A02,083220,Chow; Bennett,9,0,32,23
1656879361906,MATH 142A,A03,093480,Chow; Bennett,7,0,32,25
1656879361906,MATH 142A,B03,093481,Chow; Bennett,7,0,32,25
1656879361906,MATH 142A,B04,093558,Chow; Bennett,10,0,32,22
1656879361906,MATH 142A,B05,093559,Chow; Bennett,6,0,32,26
1656879367930,MATH 193A,A01,083224,Rotar; Vladimir,6,0,34,28
1656879367930,MATH 193A,A02,083225,Rotar; Vladimir,3,0,34,31
1656879367930,MATH 193A,A03,083781,Rotar; Vladimir,1,0,34,33
1656879367930,MATH 193A,A04,083782,Rotar; Vladimir,6,0,34,28
1656879367930,MATH 193A,A05,093482,Rotar; Vladimir,6,0,34,28
1656879373960,MATH 197,001,091859,McAuley; Julian John,9999,0,9999,0
1656879373960,MATH 197,002,095566,Kedlaya; Kiran S.,9997,0,9999,2
1656879373960,MATH 197,003,095567,Xiao; Ming,9999,0,9999,0
1656879373960,MATH 197,004,095571,Perols; Johan Lars,9998,0,9999,1
1656879381028,COGS 9,A01,083615,Shannon; Kyle Michael,6,0,75,69
1656879387050,COGS 11,A01,083617,Boyle; Mary E. T.,19,0,48,29
1656879393076,COGS 13,A01,083071,Bastos; Amalia Pinkusfeld,8,0,71,63
1656879399100,COGS 14A,A01,092681,Semenuks; Arturs,0,1,100,100
1656879405124,COGS 14B,A01,083073,Cheng; Tzu-Han,5,0,63,58
1656879411229,COGS 17,A01,092677,Semenuks; Arturs,4,0,81,77
1656879417269,COGS 100,A01,083619,Allen; Michael Gordon,15,0,70,55
1656879423296,COGS 101A,A01,083621,Davis; Joshua Daniel,9,0,68,59
1656879429319,COGS 101B,A01,091572,Allen; Michael Gordon,8,0,65,57
1656879435348,COGS 101C,A01,083625,Delgado; Tania,17,0,35,18
1656879441377,COGS 107A,A01,083627,Boyle; Mary E. T.,13,0,60,47
1656879447399,COGS 118A,A01,083075,Gupta; Anjum,15,0,76,61
1656879453423,CSE 3,A50,083646,Miranda; Gregory Joseph,22,0,50,28
1656879459451,CSE 8A,A50,083650,Miranda; Gregory Joseph,17,1,56,39
1656879465474,CSE 11,A01,083080,Cao; Yingjun,4,15,40,36
1656879471498,CSE 12,A01,083652,Krause-Levy; Sophia Louisa,20,1,120,100
1656879477520,CSE 15L,A01,083654,Morris; Justin Loren,8,0,50,42
1656879477520,CSE 15L,A02,083655,Morris; Justin Loren,8,0,50,42
1656879483544,CSE 20,A01,083657,Tran; Khoa Dang,37,0,80,43
1656879489565,CSE 21,A01,095574,Bach; Quang Tran,21,0,48,27
1656879495598,CSE 30,A01,083084,Eldon; John,4,0,80,76
1656879495598,CSE 30,B01,095061,Bhaskar; Nishant,6,0,50,44
1656879501624,CSE 100,A01,083659,Cao; Yingjun,2,4,70,68
1656879507651,CSE 134B,A01,083661,Powell; Thomas Allan,19,0,100,81
1656879513675,CSE 140,A01,083663,Gungor; Onat,14,0,85,71
1656879519700,CSE 140L,A01,083088,Eldon; John,16,0,100,84
1656879525723,CSE 175,A01,083665,Kumar; Rakesh,3,0,25,22
1656879531745,CSE 190,A00,092507,Dubnov; Shlomo,7,0,20,13
1656879537789,ECE 45,A01,083139,Congero; Spencer William,5,0,75,70
1656879543817,ECE 65,A50,083695,Saad; Andrew S,12,0,30,18
1656879543817,ECE 65,A51,095125,Saad; Andrew S,25,0,26,1
1656879549842,ECE 109,A01,091882,Touri; Behrouz,16,0,70,54
1656879555868,ECE 180,A00,083140,Abi Samra; Nicholas Camill,0,0,30,30
1656879555868,ECE 180,B00,083141,Abi Samra; Nicholas Camill,0,0,30,30
1656879561891,MATH 10A,A01,083735,Patchell; Gregory David,1,0,30,29
1656879561891,MATH 10A,A02,083736,Patchell; Gregory David,20,0,30,10
1656879561891,MATH 10A,A03,083737,Patchell; Gregory David,15,0,30,15
1656879567914,MATH 10B,A01,083207,Lim; Seonhee,7,0,34,27
1656879567914,MATH 10B,A02,083208,Lim; Seonhee,9,0,35,26
1656879567914,MATH 10B,A03,093472,Lim; Seonhee,4,0,34,30
1656879567914,MATH 10B,B01,083739,Sinha; Shubham,9,0,30,21
1656879573947,MATH 18,A01,083743,Cinel; Cameron Alexander,6,0,30,24
1656879573947,MATH 18,A02,083744,Cinel; Cameron Alexander,15,0,30,15
1656879573947,MATH 18,A03,083745,Cinel; Cameron Alexander,8,0,30,22
1656879573947,MATH 18,B01,083748,Rideout; David Porter,4,0,37,33
1656879573947,MATH 18,B02,083749,Rideout; David Porter,3,0,36,33
1656879573947,MATH 18,B03,083750,Rideout; David Porter,2,0,37,35
1656879573947,MATH 18,B04,083751,Rideout; David Porter,5,0,36,31
1656879573947,MATH 18,B05,093473,Rideout; David Porter,4,0,36,32
1656879573947,MATH 18,B06,093474,Rideout; David Porter,5,0,36,31
1656879579972,MATH 20A,A01,083754,Zheng; Zequn,12,0,40,28
1656879585995,MATH 20B,A01,083756,Briones; Jor-el Thomas Caparas,1,0,36,35
1656879585995,MATH 20B,A02,083757,Briones; Jor-el Thomas Caparas,1,0,36,35
1656879585995,MATH 20B,A03,093475,Briones; Jor-el Thomas Caparas,0,0,36,36
1656879592019,MATH 20C,A01,083760,Briones; Jor-el Thomas Caparas,1,0,35,34
1656879592019,MATH 20C,A02,083761,Briones; Jor-el Thomas Caparas,8,0,35,27
1656879592019,MATH 20C,A03,093476,Briones; Jor-el Thomas Caparas,0,1,36,36
1656879592019,MATH 20C,B01,083762,Bach; Quang Tran,0,0,30,30
1656879598048,MATH 20D,A01,083765,Tran; Brian Kha,4,0,30,26
1656879598048,MATH 20D,A02,083766,Tran; Brian Kha,4,0,30,26
1656879598048,MATH 20D,A03,083767,Tran; Brian Kha,2,0,30,28
1656879604071,MATH 20E,A01,083771,Ganguly; Soumya,5,0,32,27
1656879604071,MATH 20E,A02,083772,Ganguly; Soumya,6,0,32,26
1656879604071,MATH 20E,B01,083773,Ciotti; Benjamin,18,0,35,17
1656879604071,MATH 20E,B02,083774,Ciotti; Benjamin,17,0,35,18
1656879610096,MATH 103A,A01,083777,Greenfeld; Be'Eri,2,0,36,34
1656879610096,MATH 103A,A02,083778,Greenfeld; Be'Eri,5,0,36,31
1656879610096,MATH 103A,A03,093561,Greenfeld; Be'Eri,4,0,36,32
1656879610096,MATH 103A,B01,083779,Greenfeld; Be'Eri,6,0,36,30
1656879610096,MATH 103A,B02,083780,Greenfeld; Be'Eri,2,0,36,34
1656879610096,MATH 103A,B03,093562,Greenfeld; Be'Eri,2,0,36,34
1656879616119,MATH 105,A01,085443,Carter; Anne Toulson,13,0,35,22
1656879616119,MATH 105,A02,093477,Carter; Anne Toulson,20,0,35,15
1656879622143,MATH 109,A01,083213,Ganzberger; Geoffrey Michael,2,0,34,32
1656879622143,MATH 109,A02,083214,Ganzberger; Geoffrey Michael,2,0,34,32
1656879622143,MATH 109,A03,093478,Ganzberger; Geoffrey Michael,1,0,34,33
1656879622143,MATH 109,B01,083215,Ganzberger; Geoffrey Michael,1,0,32,31
1656879622143,MATH 109,B02,083216,Ganzberger; Geoffrey Michael,1,0,32,31
1656879622143,MATH 109,B03,093479,Ganzberger; Geoffrey Michael,6,0,32,26
1656879628169,MATH 142A,A01,083219,Chow; Bennett,6,0,32,26
1656879628169,MATH 142A,A02,083220,Chow; Bennett,9,0,32,23
1656879628169,MATH 142A,A03,093480,Chow; Bennett,7,0,32,25
1656879628169,MATH 142A,B03,093481,Chow; Bennett,7,0,32,25
1656879628169,MATH 142A,B04,093558,Chow; Bennett,10,0,32,22
1656879628169,MATH 142A,B05,093559,Chow; Bennett,6,0,32,26
1656879634211,MATH 193A,A01,083224,Rotar; Vladimir,6,0,34,28
1656879634211,MATH 193A,A02,083225,Rotar; Vladimir,3,0,34,31
1656879634211,MATH 193A,A03,083781,Rotar; Vladimir,1,0,34,33
1656879634211,MATH 193A,A04,083782,Rotar; Vladimir,6,0,34,28
1656879634211,MATH 193A,A05,093482,Rotar; Vladimir,6,0,34,28
1656879640238,MATH 197,001,091859,McAuley; Julian John,9999,0,9999,0
1656879640238,MATH 197,002,095566,Kedlaya; Kiran S.,9997,0,9999,2
1656879640238,MATH 197,003,095567,Xiao; Ming,9999,0,9999,0
1656879640238,MATH 197,004,095571,Perols; Johan Lars,9998,0,9999,1
1656879647307,COGS 9,A01,083615,Shannon; Kyle Michael,6,0,75,69
1656879653329,COGS 11,A01,083617,Boyle; Mary E. T.,19,0,48,29
1656879659356,COGS 13,A01,083071,Bastos; Amalia Pinkusfeld,8,0,71,63
1656879665380,COGS 14A,A01,092681,Semenuks; Arturs,0,1,100,100
1656879671403,COGS 14B,A01,083073,Cheng; Tzu-Han,5,0,63,58
1656879677426,COGS 17,A01,092677,Semenuks; Arturs,4,0,81,77
1656879683447,COGS 100,A01,083619,Allen; Michael Gordon,15,0,70,55
1656879689471,COGS 101A,A01,083621,Davis; Joshua Daniel,9,0,68,59
1656879695494,COGS 101B,A01,091572,Allen; Michael Gordon,8,0,65,57
1656879701520,COGS 101C,A01,083625,Delgado; Tania,17,0,35,18
1656879707543,COGS 107A,A01,083627,Boyle; Mary E. T.,13,0,60,47
1656879713566,COGS 118A,A01,083075,Gupta; Anjum,15,0,76,61
1656879719590,CSE 3,A50,083646,Miranda; Gregory Joseph,22,0,50,28
1656879725616,CSE 8A,A50,083650,Miranda; Gregory Joseph,17,1,56,39
1656879731638,CSE 11,A01,083080,Cao; Yingjun,4,15,40,36
1656879737662,CSE 12,A01,083652,Krause-Levy; Sophia Louisa,20,1,120,100
1656879743685,CSE 15L,A01,083654,Morris; Justin Loren,8,0,50,42
1656879743685,CSE 15L,A02,083655,Morris; Justin Loren,8,0,50,42
1656879749707,CSE 20,A01,083657,Tran; Khoa Dang,37,0,80,43
1656879755734,CSE 21,A01,095574,Bach; Quang Tran,21,0,48,27
1656879761763,CSE 30,A01,083084,Eldon; John,4,0,80,76
1656879761763,CSE 30,B01,095061,Bhaskar; Nishant,6,0,50,44
1656879767789,CSE 100,A01,083659,Cao; Yingjun,2,4,70,68
1656879773816,CSE 134B,A01,083661,Powell; Thomas Allan,19,0,100,81
1656879779841,CSE 140,A01,083663,Gungor; Onat,14,0,85,71
1656879785864,CSE 140L,A01,083088,Eldon; John,16,0,100,84
1656879791888,CSE 175,A01,083665,Kumar; Rakesh,3,0,25,22
1656879797909,CSE 190,A00,092507,Dubnov; Shlomo,7,0,20,13
1656879803942,ECE 45,A01,083139,Congero; Spencer William,5,0,75,70
1656879809965,ECE 65,A50,083695,Saad; Andrew S,12,0,30,18
1656879809965,ECE 65,A51,095125,Saad; Andrew S,25,0,26,1
1656879815997,ECE 109,A01,091882,Touri; Behrouz,16,0,70,54
1656879822023,ECE 180,A00,083140,Abi Samra; Nicholas Camill,0,0,30,30
1656879822023,ECE 180,B00,083141,Abi Samra; Nicholas Camill,0,0,30,30
1656879828046,MATH 10A,A01,083735,Patchell; Gregory David,1,0,30,29
1656879828046,MATH 10A,A02,083736,Patchell; Gregory David,20,0,30,10
1656879828046,MATH 10A,A03,083737,Patchell; Gregory David,15,0,30,15
1656879834072,MATH 10B,A01,083207,Lim; Seonhee,7,0,34,27
1656879834072,MATH 10B,A02,083208,Lim; Seonhee,9,0,35,26
1656879834072,MATH 10B,A03,093472,Lim; Seonhee,4,0,34,30
1656879834072,MATH 10B,B01,083739,Sinha; Shubham,9,0,30,21
1656879840097,MATH 18,A01,083743,Cinel; Cameron Alexander,6,0,30,24
1656879840097,MATH 18,A02,083744,Cinel; Cameron Alexander,15,0,30,15
1656879840097,MATH 18,A03,083745,Cinel; Cameron Alexander,8,0,30,22
1656879840097,MATH 18,B01,083748,Rideout; David Porter,4,0,37,33
1656879840097,MATH 18,B02,083749,Rideout; David Porter,3,0,36,33
1656879840097,MATH 18,B03,083750,Rideout; David Porter,2,0,37,35
1656879840097,MATH 18,B04,083751,Rideout; David Porter,5,0,36,31
1656879840097,MATH 18,B05,093473,Rideout; David Porter,4,0,36,32
1656879840097,MATH 18,B06,093474,Rideout; David Porter,5,0,36,31
1656879846126,MATH 20A,A01,083754,Zheng; Zequn,12,0,40,28
1656879852150,MATH 20B,A01,083756,Briones; Jor-el Thomas Caparas,1,0,36,35
1656879852150,MATH 20B,A02,083757,Briones; Jor-el Thomas Caparas,1,0,36,35
1656879852150,MATH 20B,A03,093475,Briones; Jor-el Thomas Caparas,0,0,36,36
1656879858174,MATH 20C,A01,083760,Briones; Jor-el Thomas Caparas,1,0,35,34
1656879858174,MATH 20C,A02,083761,Briones; Jor-el Thomas Caparas,8,0,35,27
1656879858174,MATH 20C,A03,093476,Briones; Jor-el Thomas Caparas,0,1,36,36
1656879858174,MATH 20C,B01,083762,Bach; Quang Tran,0,0,30,30
1656879864197,MATH 20D,A01,083765,Tran; Brian Kha,4,0,30,26
1656879864197,MATH 20D,A02,083766,Tran; Brian Kha,4,0,30,26
1656879864197,MATH 20D,A03,083767,Tran; Brian Kha,2,0,30,28
1656879870253,MATH 20E,A01,083771,Ganguly; Soumya,5,0,32,27
1656879870253,MATH 20E,A02,083772,Ganguly; Soumya,6,0,32,26
1656879870253,MATH 20E,B01,083773,Ciotti; Benjamin,18,0,35,17
1656879870253,MATH 20E,B02,083774,Ciotti; Benjamin,17,0,35,18
1656879876278,MATH 103A,A01,083777,Greenfeld; Be'Eri,2,0,36,34
1656879876278,MATH 103A,A02,083778,Greenfeld; Be'Eri,5,0,36,31
1656879876278,MATH 103A,A03,093561,Greenfeld; Be'Eri,4,0,36,32
1656879876278,MATH 103A,B01,083779,Greenfeld; Be'Eri,6,0,36,30
1656879876278,MATH 103A,B02,083780,Greenfeld; Be'Eri,2,0,36,34
1656879876278,MATH 103A,B03,093562,Greenfeld; Be'Eri,2,0,36,34
1656879882305,MATH 105,A01,085443,Carter; Anne Toulson,13,0,35,22
1656879882305,MATH 105,A02,093477,Carter; Anne Toulson,20,0,35,15
1656879888329,MATH 109,A01,083213,Ganzberger; Geoffrey Michael,2,0,34,32
1656879888329,MATH 109,A02,083214,Ganzberger; Geoffrey Michael,2,0,34,32
1656879888329,MATH 109,A03,093478,Ganzberger; Geoffrey Michael,1,0,34,33
1656879888329,MATH 109,B01,083215,Ganzberger; Geoffrey Michael,1,0,32,31
1656879888329,MATH 109,B02,083216,Ganzberger; Geoffrey Michael,1,0,32,31
1656879888329,MATH 109,B03,093479,Ganzberger; Geoffrey Michael,6,0,32,26
1656879894366,MATH 142A,A01,083219,Chow; Bennett,6,0,32,26
1656879894366,MATH 142A,A02,083220,Chow; Bennett,9,0,32,23
1656879894366,MATH 142A,A03,093480,Chow; Bennett,7,0,32,25
1656879894366,MATH 142A,B03,093481,Chow; Bennett,7,0,32,25
1656879894366,MATH 142A,B04,093558,Chow; Bennett,10,0,32,22
1656879894366,MATH 142A,B05,093559,Chow; Bennett,6,0,32,26
1656879900396,MATH 193A,A01,083224,Rotar; Vladimir,6,0,34,28
1656879900396,MATH 193A,A02,083225,Rotar; Vladimir,3,0,34,31
1656879900396,MATH 193A,A03,083781,Rotar; Vladimir,1,0,34,33
1656879900396,MATH 193A,A04,083782,Rotar; Vladimir,6,0,34,28
1656879900396,MATH 193A,A05,093482,Rotar; Vladimir,6,0,34,28
1656879906423,MATH 197,001,091859,McAuley; Julian John,9999,0,9999,0
1656879906423,MATH 197,002,095566,Kedlaya; Kiran S.,9997,0,9999,2
1656879906423,MATH 197,003,095567,Xiao; Ming,9999,0,9999,0
1656879906423,MATH 197,004,095571,Perols; Johan Lars,9998,0,9999,1
1656879913478,COGS 9,A01,083615,Shannon; Kyle Michael,6,0,75,69
1656879919501,COGS 11,A01,083617,Boyle; Mary E. T.,19,0,48,29
1656879925529,COGS 13,A01,083071,Bastos; Amalia Pinkusfeld,8,0,71,63
1656879931556,COGS 14A,A01,092681,Semenuks; Arturs,0,1,100,100
1656879937583,COGS 14B,A01,083073,Cheng; Tzu-Han,5,0,63,58
1656879943607,COGS 17,A01,092677,Semenuks; Arturs,4,0,81,77
1656879949632,COGS 100,A01,083619,Allen; Michael Gordon,15,0,70,55
1656879955660,COGS 101A,A01,083621,Davis; Joshua Daniel,9,0,68,59
1656879961687,COGS 101B,A01,091572,Allen; Michael Gordon,8,0,65,57
1656879967708,COGS 101C,A01,083625,Delgado; Tania,17,0,35,18
1656879973739,COGS 107A,A01,083627,Boyle; Mary E. T.,13,0,60,47
1656879979764,COGS 118A,A01,083075,Gupta; Anjum,15,0,76,61
1656879985787,CSE 3,A50,083646,Miranda; Gregory Joseph,22,0,50,28
1656879991823,CSE 8A,A50,083650,Miranda; Gregory Joseph,17,1,56,39
1656879997844,CSE 11,A01,083080,Cao; Yingjun,4,15,40,36
1656880003868,CSE 12,A01,083652,Krause-Levy; Sophia Louisa,20,1,120,100
1656880009964,CSE 15L,A01,083654,Morris; Justin Loren,8,0,50,42
1656880009964,CSE 15L,A02,083655,Morris; Justin Loren,8,0,50,42
1656880015987,CSE 20,A01,083657,Tran; Khoa Dang,37,0,80,43
1656880022015,CSE 21,A01,095574,Bach; Quang Tran,21,0,48,27
1656880028042,CSE 30,A01,083084,Eldon; John,4,0,80,76
1656880028042,CSE 30,B01,095061,Bhaskar; Nishant,6,0,50,44
1656880034075,CSE 100,A01,083659,Cao; Yingjun,2,4,70,68
1656880040097,CSE 134B,A01,083661,Powell; Thomas Allan,19,0,100,81
1656880046125,CSE 140,A01,083663,Gungor; Onat,14,0,85,71
1656880052152,CSE 140L,A01,083088,Eldon; John,16,0,100,84
1656880058178,CSE 175,A01,083665,Kumar; Rakesh,3,0,25,22
1656880064206,CSE 190,A00,092507,Dubnov; Shlomo,7,0,20,13
1656880070243,ECE 45,A01,083139,Congero; Spencer William,5,0,75,70
1656880076269,ECE 65,A50,083695,Saad; Andrew S,12,0,30,18
1656880076269,ECE 65,A51,095125,Saad; Andrew S,25,0,26,1
1656880082292,ECE 109,A01,091882,Touri; Behrouz,16,0,70,54
1656880088317,ECE 180,A00,083140,Abi Samra; Nicholas Camill,0,0,30,30
1656880088317,ECE 180,B00,083141,Abi Samra; Nicholas Camill,0,0,30,30
1656880094344,MATH 10A,A01,083735,Patchell; Gregory David,1,0,30,29
1656880094344,MATH 10A,A02,083736,Patchell; Gregory David,20,0,30,10
1656880094344,MATH 10A,A03,083737,Patchell; Gregory David,15,0,30,15
1656880100368,MATH 10B,A01,083207,Lim; Seonhee,7,0,34,27
1656880100368,MATH 10B,A02,083208,Lim; Seonhee,9,0,35,26
1656880100368,MATH 10B,A03,093472,Lim; Seonhee,4,0,34,30
1656880100368,MATH 10B,B01,083739,Sinha; Shubham,9,0,30,21
1656880106392,MATH 18,A01,083743,Cinel; Cameron Alexander,6,0,30,24
1656880106392,MATH 18,A02,083744,Cinel; Cameron Alexander,15,0,30,15
1656880106392,MATH 18,A03,083745,Cinel; Cameron Alexander,8,0,30,22
1656880106392,MATH 18,B01,083748,Rideout; David Porter,4,0,37,33
1656880106392,MATH 18,B02,083749,Rideout; David Porter,3,0,36,33
1656880106392,MATH 18,B03,083750,Rideout; David Porter,2,0,37,35
1656880106392,MATH 18,B04,083751,Rideout; David Porter,5,0,36,31
1656880106392,MATH 18,B05,093473,Rideout; David Porter,4,0,36,32
1656880106392,MATH 18,B06,093474,Rideout; David Porter,5,0,36,31
1656880112415,MATH 20A,A01,083754,Zheng; Zequn,12,0,40,28
1656880118449,MATH 20B,A01,083756,Briones; Jor-el Thomas Caparas,1,0,36,35
1656880118449,MATH 20B,A02,083757,Briones; Jor-el Thomas Caparas,1,0,36,35
1656880118449,MATH 20B,A03,093475,Briones; Jor-el Thomas Caparas,0,0,36,36
1656880124474,MATH 20C,A01,083760,Briones; Jor-el Thomas Caparas,1,0,35,34
1656880124474,MATH 20C,A02,083761,Briones; Jor-el Thomas Caparas,8,0,35,27
1656880124474,MATH 20C,A03,093476,Briones; Jor-el Thomas Caparas,0,1,36,36
1656880124474,MATH 20C,B01,083762,Bach; Quang Tran,0,0,30,30
1656880130498,MATH 20D,A01,083765,Tran; Brian Kha,4,0,30,26
1656880130498,MATH 20D,A02,083766,Tran; Brian Kha,4,0,30,26
1656880130498,MATH 20D,A03,083767,Tran; Brian Kha,2,0,30,28
1656880136523,MATH 20E,A01,083771,Ganguly; Soumya,5,0,32,27
1656880136523,MATH 20E,A02,083772,Ganguly; Soumya,6,0,32,26
1656880136523,MATH 20E,B01,083773,Ciotti; Benjamin,18,0,35,17
1656880136523,MATH 20E,B02,083774,Ciotti; Benjamin,17,0,35,18
1656880142552,MATH 103A,A01,083777,Greenfeld; Be'Eri,2,0,36,34
1656880142552,MATH 103A,A02,083778,Greenfeld; Be'Eri,5,0,36,31
1656880142552,MATH 103A,A03,093561,Greenfeld; Be'Eri,4,0,36,32
1656880142552,MATH 103A,B01,083779,Greenfeld; Be'Eri,6,0,36,30
1656880142552,MATH 103A,B02,083780,Greenfeld; Be'Eri,2,0,36,34
1656880142552,MATH 103A,B03,093562,Greenfeld; Be'Eri,2,0,36,34
1656880148593,MATH 105,A01,085443,Carter; Anne Toulson,13,0,35,22
1656880148593,MATH 105,A02,093477,Carter; Anne Toulson,20,0,35,15
1656880154622,MATH 109,A01,083213,Ganzberger; Geoffrey Michael,2,0,34,32
1656880154622,MATH 109,A02,083214,Ganzberger; Geoffrey Michael,2,0,34,32
1656880154622,MATH 109,A03,093478,Ganzberger; Geoffrey Michael,1,0,34,33
1656880154622,MATH 109,B01,083215,Ganzberger; Geoffrey Michael,1,0,32,31
1656880154622,MATH 109,B02,083216,Ganzberger; Geoffrey Michael,1,0,32,31
1656880154622,MATH 109,B03,093479,Ganzberger; Geoffrey Michael,6,0,32,26
1656880160651,MATH 142A,A01,083219,Chow; Bennett,6,0,32,26
1656880160651,MATH 142A,A02,083220,Chow; Bennett,9,0,32,23
1656880160651,MATH 142A,A03,093480,Chow; Bennett,7,0,32,25
1656880160651,MATH 142A,B03,093481,Chow; Bennett,7,0,32,25
1656880160651,MATH 142A,B04,093558,Chow; Bennett,10,0,32,22
1656880160651,MATH 142A,B05,093559,Chow; Bennett,6,0,32,26
1656880166676,MATH 193A,A01,083224,Rotar; Vladimir,6,0,34,28
1656880166676,MATH 193A,A02,083225,Rotar; Vladimir,3,0,34,31
1656880166676,MATH 193A,A03,083781,Rotar; Vladimir,1,0,34,33
1656880166676,MATH 193A,A04,083782,Rotar; Vladimir,6,0,34,28
1656880166676,MATH 193A,A05,093482,Rotar; Vladimir,6,0,34,28
1656880172702,MATH 197,001,091859,McAuley; Julian John,9999,0,9999,0
1656880172702,MATH 197,002,095566,Kedlaya; Kiran S.,9997,0,9999,2
1656880172702,MATH 197,003,095567,Xiao; Ming,9999,0,9999,0
1656880172702,MATH 197,004,095571,Perols; Johan Lars,9998,0,9999,1
1656880179762,COGS 9,A01,083615,Shannon; Kyle Michael,6,0,75,69
1656880185785,COGS 11,A01,083617,Boyle; Mary E. T.,19,0,48,29
1656880191813,COGS 13,A01,083071,Bastos; Amalia Pinkusfeld,8,0,71,63
1656880197836,COGS 14A,A01,092681,Semenuks; Arturs,0,1,100,100
1656880203858,COGS 14B,A01,083073,Cheng; Tzu-Han,5,0,63,58
1656880209885,COGS 17,A01,092677,Semenuks; Arturs,4,0,81,77
1656880215914,COGS 100,A01,083619,Allen; Michael Gordon,15,0,70,55
1656880221939,COGS 101A,A01,083621,Davis; Joshua Daniel,9,0,68,59
1656880227963,COGS 101B,A01,091572,Allen; Michael Gordon,8,0,65,57
1656880233985,COGS 101C,A01,083625,Delgado; Tania,17,0,35,18
1656880240010,COGS 107A,A01,083627,Boyle; Mary E. T.,13,0,60,47
1656880246032,COGS 118A,A01,083075,Gupta; Anjum,15,0,76,61
1656880252056,CSE 3,A50,083646,Miranda; Gregory Joseph,22,0,50,28
1656880258078,CSE 8A,A50,083650,Miranda; Gregory Joseph,17,1,56,39
1656880264103,CSE 11,A01,083080,Cao; Yingjun,4,15,40,36
1656880270130,CSE 12,A01,083652,Krause-Levy; Sophia Louisa,20,1,120,100
1656880276155,CSE 15L,A01,083654,Morris; Justin Loren,8,0,50,42
1656880276155,CSE 15L,A02,083655,Morris; Justin Loren,8,0,50,42
1656880282178,CSE 20,A01,083657,Tran; Khoa Dang,37,0,80,43
1656880288203,CSE 21,A01,095574,Bach; Quang Tran,21,0,48,27
1656880294229,CSE 30,A01,083084,Eldon; John,4,0,80,76
1656880294229,CSE 30,B01,095061,Bhaskar; Nishant,6,0,50,44
1656880300251,CSE 100,A01,083659,Cao; Yingjun,2,4,70,68
1656880306275,CSE 134B,A01,083661,Powell; Thomas Allan,19,0,100,81
1656880312302,CSE 140,A01,083663,Gungor; Onat,14,0,85,71
1656880318327,CSE 140L,A01,083088,Eldon; John,16,0,100,84
1656880324349,CSE 175,A01,083665,Kumar; Rakesh,3,0,25,22
1656880330374,CSE 190,A00,092507,Dubnov; Shlomo,7,0,20,13
1656880336399,ECE 45,A01,083139,Congero; Spencer William,5,0,75,70
1656880342425,ECE 65,A50,083695,Saad; Andrew S,12,0,30,18
1656880342425,ECE 65,A51,095125,Saad; Andrew S,25,0,26,1
1656880348453,ECE 109,A01,091882,Touri; Behrouz,16,0,70,54
1656880354478,ECE 180,A00,083140,Abi Samra; Nicholas Camill,0,0,30,30
1656880354478,ECE 180,B00,083141,Abi Samra; Nicholas Camill,0,0,30,30
1656880360501,MATH 10A,A01,083735,Patchell; Gregory David,1,0,30,29
1656880360501,MATH 10A,A02,083736,Patchell; Gregory David,20,0,30,10
1656880360501,MATH 10A,A03,083737,Patchell; Gregory David,15,0,30,15
1656880366524,MATH 10B,A01,083207,Lim; Seonhee,7,0,34,27
1656880366524,MATH 10B,A02,083208,Lim; Seonhee,9,0,35,26
1656880366524,MATH 10B,A03,093472,Lim; Seonhee,4,0,34,30
1656880366524,MATH 10B,B01,083739,Sinha; Shubham,9,0,30,21
1656880372555,MATH 18,A01,083743,Cinel; Cameron Alexander,6,0,30,24
1656880372555,MATH 18,A02,083744,Cinel; Cameron Alexander,15,0,30,15
1656880372555,MATH 18,A03,083745,Cinel; Cameron Alexander,8,0,30,22
1656880372555,MATH 18,B01,083748,Rideout; David Porter,4,0,37,33
1656880372555,MATH 18,B02,083749,Rideout; David Porter,3,0,36,33
1656880372555,MATH 18,B03,083750,Rideout; David Porter,2,0,37,35
1656880372555,MATH 18,B04,083751,Rideout; David Porter,5,0,36,31
1656880372555,MATH 18,B05,093473,Rideout; David Porter,4,0,36,32
1656880372555,MATH 18,B06,093474,Rideout; David Porter,5,0,36,31
1656880378584,MATH 20A,A01,083754,Zheng; Zequn,12,0,40,28
1656880384611,MATH 20B,A01,083756,Briones; Jor-el Thomas Caparas,1,0,36,35
1656880384611,MATH 20B,A02,083757,Briones; Jor-el Thomas Caparas,1,0,36,35
1656880384611,MATH 20B,A03,093475,Briones; Jor-el Thomas Caparas,0,0,36,36
1656880390634,MATH 20C,A01,083760,Briones; Jor-el Thomas Caparas,1,0,35,34
1656880390634,MATH 20C,A02,083761,Briones; Jor-el Thomas Caparas,8,0,35,27
1656880390634,MATH 20C,A03,093476,Briones; Jor-el Thomas Caparas,0,1,36,36
1656880390634,MATH 20C,B01,083762,Bach; Quang Tran,0,0,30,30
1656880396658,MATH 20D,A01,083765,Tran; Brian Kha,4,0,30,26
1656880396658,MATH 20D,A02,083766,Tran; Brian Kha,4,0,30,26
1656880396658,MATH 20D,A03,083767,Tran; Brian Kha,2,0,30,28
1656880402693,MATH 20E,A01,083771,Ganguly; Soumya,5,0,32,27
1656880402693,MATH 20E,A02,083772,Ganguly; Soumya,6,0,32,26
1656880402693,MATH 20E,B01,083773,Ciotti; Benjamin,18,0,35,17
1656880402693,MATH 20E,B02,083774,Ciotti; Benjamin,17,0,35,18
1656880408721,MATH 103A,A01,083777,Greenfeld; Be'Eri,2,0,36,34
1656880408721,MATH 103A,A02,083778,Greenfeld; Be'Eri,5,0,36,31
1656880408721,MATH 103A,A03,093561,Greenfeld; Be'Eri,4,0,36,32
1656880408721,MATH 103A,B01,083779,Greenfeld; Be'Eri,6,0,36,30
1656880408721,MATH 103A,B02,083780,Greenfeld; Be'Eri,2,0,36,34
1656880408721,MATH 103A,B03,093562,Greenfeld; Be'Eri,2,0,36,34
1656880414744,MATH 105,A01,085443,Carter; Anne Toulson,13,0,35,22
1656880414744,MATH 105,A02,093477,Carter; Anne Toulson,20,0,35,15
1656880420767,MATH 109,A01,083213,Ganzberger; Geoffrey Michael,2,0,34,32
1656880420767,MATH 109,A02,083214,Ganzberger; Geoffrey Michael,2,0,34,32
1656880420767,MATH 109,A03,093478,Ganzberger; Geoffrey Michael,1,0,34,33
1656880420767,MATH 109,B01,083215,Ganzberger; Geoffrey Michael,1,0,32,31
1656880420767,MATH 109,B02,083216,Ganzberger; Geoffrey Michael,1,0,32,31
1656880420767,MATH 109,B03,093479,Ganzberger; Geoffrey Michael,6,0,32,26
1656880426790,MATH 142A,A01,083219,Chow; Bennett,6,0,32,26
1656880426790,MATH 142A,A02,083220,Chow; Bennett,9,0,32,23
1656880426790,MATH 142A,A03,093480,Chow; Bennett,7,0,32,25
1656880426790,MATH 142A,B03,093481,Chow; Bennett,7,0,32,25
1656880426790,MATH 142A,B04,093558,Chow; Bennett,10,0,32,22
1656880426790,MATH 142A,B05,093559,Chow; Bennett,6,0,32,26
1656880432869,MATH 193A,A01,083224,Rotar; Vladimir,6,0,34,28
1656880432869,MATH 193A,A02,083225,Rotar; Vladimir,3,0,34,31
1656880432869,MATH 193A,A03,083781,Rotar; Vladimir,1,0,34,33
1656880432869,MATH 193A,A04,083782,Rotar; Vladimir,6,0,34,28
1656880432869,MATH 193A,A05,093482,Rotar; Vladimir,6,0,34,28
1656880438894,MATH 197,001,091859,McAuley; Julian John,9999,0,9999,0
1656880438894,MATH 197,002,095566,Kedlaya; Kiran S.,9997,0,9999,2
1656880438894,MATH 197,003,095567,Xiao; Ming,9999,0,9999,0
1656880438894,MATH 197,004,095571,Perols; Johan Lars,9998,0,9999,1
1656880445952,COGS 9,A01,083615,Shannon; Kyle Michael,6,0,75,69
1656880451979,COGS 11,A01,083617,Boyle; Mary E. T.,19,0,48,29
1656880458010,COGS 13,A01,083071,Bastos; Amalia Pinkusfeld,8,0,71,63
1656880464036,COGS 14A,A01,092681,Semenuks; Arturs,0,1,100,100
1656880470062,COGS 14B,A01,083073,Cheng; Tzu-Han,5,0,63,58
1656880476102,COGS 17,A01,092677,Semenuks; Arturs,4,0,81,77
1656880482126,COGS 100,A01,083619,Allen; Michael Gordon,15,0,70,55
1656880488149,COGS 101A,A01,083621,Davis; Joshua Daniel,9,0,68,59
1656880494171,COGS 101B,A01,091572,Allen; Michael Gordon,8,0,65,57
1656880500195,COGS 101C,A01,083625,Delgado; Tania,17,0,35,18
1656880506218,COGS 107A,A01,083627,Boyle; Mary E. T.,13,0,60,47
1656880512240,COGS 118A,A01,083075,Gupta; Anjum,15,0,76,61
1656880518265,CSE 3,A50,083646,Miranda; Gregory Joseph,22,0,50,28
1656880524291,CSE 8A,A50,083650,Miranda; Gregory Joseph,17,1,56,39
1656880530314,CSE 11,A01,083080,Cao; Yingjun,4,15,40,36
1656880536342,CSE 12,A01,083652,Krause-Levy; Sophia Louisa,20,1,120,100
1656880542370,CSE 15L,A01,083654,Morris; Justin Loren,8,0,50,42
1656880542370,CSE 15L,A02,083655,Morris; Justin Loren,8,0,50,42
1656880548397,CSE 20,A01,083657,Tran; Khoa Dang,37,0,80,43
1656880554424,CSE 21,A01,095574,Bach; Quang Tran,21,0,48,27
1656880560452,CSE 30,A01,083084,Eldon; John,4,0,80,76
1656880560452,CSE 30,B01,095061,Bhaskar; Nishant,6,0,50,44
1656880566475,CSE 100,A01,083659,Cao; Yingjun,2,4,70,68
1656880572497,CSE 134B,A01,083661,Powell; Thomas Allan,19,0,100,81
1656880578519,CSE 140,A01,083663,Gungor; Onat,14,0,85,71
1656880584546,CSE 140L,A01,083088,Eldon; John,16,0,100,84
1656880590572,CSE 175,A01,083665,Kumar; Rakesh,3,0,25,22
1656880596595,CSE 190,A00,092507,Dubnov; Shlomo,7,0,20,13
1656880602631,ECE 45,A01,083139,Congero; Spencer William,5,0,75,70
1656880608747,ECE 65,A50,083695,Saad; Andrew S,12,0,30,18
1656880608747,ECE 65,A51,095125,Saad; Andrew S,25,0,26,1
1656880614773,ECE 109,A01,091882,Touri; Behrouz,16,0,70,54
1656880620799,ECE 180,A00,083140,Abi Samra; Nicholas Camill,0,0,30,30
1656880620799,ECE 180,B00,083141,Abi Samra; Nicholas Camill,0,0,30,30
1656880626826,MATH 10A,A01,083735,Patchell; Gregory David,1,0,30,29
1656880626826,MATH 10A,A02,083736,Patchell; Gregory David,20,0,30,10
1656880626826,MATH 10A,A03,083737,Patchell; Gregory David,15,0,30,15
1656880632857,MATH 10B,A01,083207,Lim; Seonhee,7,0,34,27
1656880632857,MATH 10B,A02,083208,Lim; Seonhee,9,0,35,26
1656880632857,MATH 10B,A03,093472,Lim; Seonhee,4,0,34,30
1656880632857,MATH 10B,B01,083739,Sinha; Shubham,9,0,30,21
1656880638883,MATH 18,A01,083743,Cinel; Cameron Alexander,6,0,30,24
1656880638883,MATH 18,A02,083744,Cinel; Cameron Alexander,15,0,30,15
1656880638883,MATH 18,A03,083745,Cinel; Cameron Alexander,8,0,30,22
1656880638883,MATH 18,B01,083748,Rideout; David Porter,4,0,37,33
1656880638883,MATH 18,B02,083749,Rideout; David Porter,3,0,36,33
1656880638883,MATH 18,B03,083750,Rideout; David Porter,2,0,37,35
1656880638883,MATH 18,B04,083751,Rideout; David Porter,5,0,36,31
1656880638883,MATH 18,B05,093473,Rideout; David Porter,4,0,36,32
1656880638883,MATH 18,B06,093474,Rideout; David Porter,5,0,36,31
1656880644924,MATH 20A,A01,083754,Zheng; Zequn,12,0,40,28
1656880650951,MATH 20B,A01,083756,Briones; Jor-el Thomas Caparas,1,0,36,35
1656880650951,MATH 20B,A02,083757,Briones; Jor-el Thomas Caparas,1,0,36,35
1656880650951,MATH 20B,A03,093475,Briones; Jor-el Thomas Caparas,0,0,36,36
1656880656974,MATH 20C,A01,083760,Briones; Jor-el Thomas Caparas,1,0,35,34
1656880656974,MATH 20C,A02,083761,Briones; Jor-el Thomas Caparas,8,0,35,27
1656880656974,MATH 20C,A03,093476,Briones; Jor-el Thomas Caparas,0,1,36,36
1656880656974,MATH 20C,B01,083762,Bach; Quang Tran,0,0,30,30
1656880663003,MATH 20D,A01,083765,Tran; Brian Kha,4,0,30,26
1656880663003,MATH 20D,A02,083766,Tran; Brian Kha,4,0,30,26
1656880663003,MATH 20D,A03,083767,Tran; Brian Kha,2,0,30,28
1656880669033,MATH 20E,A01,083771,Ganguly; Soumya,5,0,32,27
1656880669033,MATH 20E,A02,083772,Ganguly; Soumya,6,0,32,26
1656880669033,MATH 20E,B01,083773,Ciotti; Benjamin,18,0,35,17
1656880669033,MATH 20E,B02,083774,Ciotti; Benjamin,17,0,35,18
1656880675057,MATH 103A,A01,083777,Greenfeld; Be'Eri,2,0,36,34
1656880675057,MATH 103A,A02,083778,Greenfeld; Be'Eri,5,0,36,31
1656880675057,MATH 103A,A03,093561,Greenfeld; Be'Eri,4,0,36,32
1656880675057,MATH 103A,B01,083779,Greenfeld; Be'Eri,6,0,36,30
1656880675057,MATH 103A,B02,083780,Greenfeld; Be'Eri,2,0,36,34
1656880675057,MATH 103A,B03,093562,Greenfeld; Be'Eri,2,0,36,34
1656880681079,MATH 105,A01,085443,Carter; Anne Toulson,13,0,35,22
1656880681079,MATH 105,A02,093477,Carter; Anne Toulson,20,0,35,15
1656880687107,MATH 109,A01,083213,Ganzberger; Geoffrey Michael,2,0,34,32
1656880687107,MATH 109,A02,083214,Ganzberger; Geoffrey Michael,2,0,34,32
1656880687107,MATH 109,A03,093478,Ganzberger; Geoffrey Michael,1,0,34,33
1656880687107,MATH 109,B01,083215,Ganzberger; Geoffrey Michael,1,0,32,31
1656880687107,MATH 109,B02,083216,Ganzberger; Geoffrey Michael,1,0,32,31
1656880687107,MATH 109,B03,093479,Ganzberger; Geoffrey Michael,6,0,32,26
1656880693135,MATH 142A,A01,083219,Chow; Bennett,6,0,32,26
1656880693135,MATH 142A,A02,083220,Chow; Bennett,9,0,32,23
1656880693135,MATH 142A,A03,093480,Chow; Bennett,7,0,32,25
1656880693135,MATH 142A,B03,093481,Chow; Bennett,7,0,32,25
1656880693135,MATH 142A,B04,093558,Chow; Bennett,10,0,32,22
1656880693135,MATH 142A,B05,093559,Chow; Bennett,6,0,32,26
1656880699162,MATH 193A,A01,083224,Rotar; Vladimir,6,0,34,28
1656880699162,MATH 193A,A02,083225,Rotar; Vladimir,3,0,34,31
1656880699162,MATH 193A,A03,083781,Rotar; Vladimir,1,0,34,33
1656880699162,MATH 193A,A04,083782,Rotar; Vladimir,6,0,34,28
1656880699162,MATH 193A,A05,093482,Rotar; Vladimir,6,0,34,28
1656880705185,MATH 197,001,091859,McAuley; Julian John,9999,0,9999,0
1656880705185,MATH 197,002,095566,Kedlaya; Kiran S.,9997,0,9999,2
1656880705185,MATH 197,003,095567,Xiao; Ming,9999,0,9999,0
1656880705185,MATH 197,004,095571,Perols; Johan Lars,9998,0,9999,1
1656880712232,COGS 9,A01,083615,Shannon; Kyle Michael,6,0,75,69
1656880718256,COGS 11,A01,083617,Boyle; Mary E. T.,19,0,48,29
1656880724283,COGS 13,A01,083071,Bastos; Amalia Pinkusfeld,8,0,71,63
1656880730306,COGS 14A,A01,092681,Semenuks; Arturs,0,1,100,100
1656880736333,COGS 14B,A01,083073,Cheng; Tzu-Han,5,0,63,58
1656880742358,COGS 17,A01,092677,Semenuks; Arturs,4,0,81,77
1656880748382,COGS 100,A01,083619,Allen; Michael Gordon,15,0,70,55
1656880754410,COGS 101A,A01,083621,Davis; Joshua Daniel,9,0,68,59
1656880760433,COGS 101B,A01,091572,Allen; Michael Gordon,8,0,65,57
1656880766461,COGS 101C,A01,083625,Delgado; Tania,17,0,35,18
1656880772486,COGS 107A,A01,083627,Boyle; Mary E. T.,13,0,60,47
1656880778526,COGS 118A,A01,083075,Gupta; Anjum,15,0,76,61
1656880784552,CSE 3,A50,083646,Miranda; Gregory Joseph,22,0,50,28
1656880790574,CSE 8A,A50,083650,Miranda; Gregory Joseph,17,1,56,39
1656880796598,CSE 11,A01,083080,Cao; Yingjun,4,15,40,36
1656880802625,CSE 12,A01,083652,Krause-Levy; Sophia Louisa,20,1,120,100
1656880808648,CSE 15L,A01,083654,Morris; Justin Loren,8,0,50,42
1656880808648,CSE 15L,A02,083655,Morris; Justin Loren,8,0,50,42
1656880814683,CSE 20,A01,083657,Tran; Khoa Dang,37,0,80,43
1656880820707,CSE 21,A01,095574,Bach; Quang Tran,21,0,48,27
1656880826735,CSE 30,A01,083084,Eldon; John,4,0,80,76
1656880826735,CSE 30,B01,095061,Bhaskar; Nishant,6,0,50,44
1656880832758,CSE 100,A01,083659,Cao; Yingjun,2,4,70,68
1656880838788,CSE 134B,A01,083661,Powell; Thomas Allan,19,0,100,81
1656880844821,CSE 140,A01,083663,Gungor; Onat,14,0,85,71
1656880850845,CSE 140L,A01,083088,Eldon; John,16,0,100,84
1656880856868,CSE 175,A01,083665,Kumar; Rakesh,3,0,25,22
1656880862892,CSE 190,A00,092507,Dubnov; Shlomo,7,0,20,13
1656880868913,ECE 45,A01,083139,Congero; Spencer William,5,0,75,70
1656880874937,ECE 65,A50,083695,Saad; Andrew S,12,0,30,18
1656880874937,ECE 65,A51,095125,Saad; Andrew S,25,0,26,1
1656880880959,ECE 109,A01,091882,Touri; Behrouz,16,0,70,54
1656880886985,ECE 180,A00,083140,Abi Samra; Nicholas Camill,0,0,30,30
1656880886985,ECE 180,B00,083141,Abi Samra; Nicholas Camill,0,0,30,30
1656880893008,MATH 10A,A01,083735,Patchell; Gregory David,1,0,30,29
1656880893008,MATH 10A,A02,083736,Patchell; Gregory David,20,0,30,10
1656880893008,MATH 10A,A03,083737,Patchell; Gregory David,15,0,30,15
1656880899037,MATH 10B,A01,083207,Lim; Seonhee,7,0,34,27
1656880899037,MATH 10B,A02,083208,Lim; Seonhee,9,0,35,26
1656880899037,MATH 10B,A03,093472,Lim; Seonhee,4,0,34,30
1656880899037,MATH 10B,B01,083739,Sinha; Shubham,9,0,30,21
1656880905069,MATH 18,A01,083743,Cinel; Cameron Alexander,6,0,30,24
1656880905069,MATH 18,A02,083744,Cinel; Cameron Alexander,15,0,30,15
1656880905069,MATH 18,A03,083745,Cinel; Cameron Alexander,8,0,30,22
1656880905069,MATH 18,B01,083748,Rideout; David Porter,4,0,37,33
1656880905069,MATH 18,B02,083749,Rideout; David Porter,3,0,36,33
1656880905069,MATH 18,B03,083750,Rideout; David Porter,2,0,37,35
1656880905069,MATH 18,B04,083751,Rideout; David Porter,5,0,36,31
1656880905069,MATH 18,B05,093473,Rideout; David Porter,4,0,36,32
1656880905069,MATH 18,B06,093474,Rideout; David Porter,5,0,36,31
1656880911092,MATH 20A,A01,083754,Zheng; Zequn,12,0,40,28
1656880917116,MATH 20B,A01,083756,Briones; Jor-el Thomas Caparas,1,0,36,35
1656880917116,MATH 20B,A02,083757,Briones; Jor-el Thomas Caparas,1,0,36,35
1656880917116,MATH 20B,A03,093475,Briones; Jor-el Thomas Caparas,0,0,36,36
1656880923140,MATH 20C,A01,083760,Briones; Jor-el Thomas Caparas,1,0,35,34
1656880923140,MATH 20C,A02,083761,Briones; Jor-el Thomas Caparas,8,0,35,27
1656880923140,MATH 20C,A03,093476,Briones; Jor-el Thomas Caparas,0,1,36,36
1656880923140,MATH 20C,B01,083762,Bach; Quang Tran,0,0,30,30
1656880929162,MATH 20D,A01,083765,Tran; Brian Kha,4,0,30,26
1656880929162,MATH 20D,A02,083766,Tran; Brian Kha,4,0,30,26
1656880929162,MATH 20D,A03,083767,Tran; Brian Kha,2,0,30,28
1656880935192,MATH 20E,A01,083771,Ganguly; Soumya,5,0,32,27
1656880935192,MATH 20E,A02,083772,Ganguly; Soumya,6,0,32,26
1656880935192,MATH 20E,B01,083773,Ciotti; Benjamin,18,0,35,17
1656880935192,MATH 20E,B02,083774,Ciotti; Benjamin,17,0,35,18
1656880941221,MATH 103A,A01,083777,Greenfeld; Be'Eri,2,0,36,34
1656880941221,MATH 103A,A02,083778,Greenfeld; Be'Eri,5,0,36,31
1656880941221,MATH 103A,A03,093561,Greenfeld; Be'Eri,4,0,36,32
1656880941221,MATH 103A,B01,083779,Greenfeld; Be'Eri,6,0,36,30
1656880941221,MATH 103A,B02,083780,Greenfeld; Be'Eri,2,0,36,34
1656880941221,MATH 103A,B03,093562,Greenfeld; Be'Eri,2,0,36,34
1656880947245,MATH 105,A01,085443,Carter; Anne Toulson,13,0,35,22
1656880947245,MATH 105,A02,093477,Carter; Anne Toulson,20,0,35,15
1656880953273,MATH 109,A01,083213,Ganzberger; Geoffrey Michael,2,0,34,32
1656880953273,MATH 109,A02,083214,Ganzberger; Geoffrey Michael,2,0,34,32
1656880953273,MATH 109,A03,093478,Ganzberger; Geoffrey Michael,1,0,34,33
1656880953273,MATH 109,B01,083215,Ganzberger; Geoffrey Michael,1,0,32,31
1656880953273,MATH 109,B02,083216,Ganzberger; Geoffrey Michael,1,0,32,31
1656880953273,MATH 109,B03,093479,Ganzberger; Geoffrey Michael,6,0,32,26
1656880959303,MATH 142A,A01,083219,Chow; Bennett,6,0,32,26
1656880959303,MATH 142A,A02,083220,Chow; Bennett,9,0,32,23
1656880959303,MATH 142A,A03,093480,Chow; Bennett,7,0,32,25
1656880959303,MATH 142A,B03,093481,Chow; Bennett,7,0,32,25
1656880959303,MATH 142A,B04,093558,Chow; Bennett,10,0,32,22
1656880959303,MATH 142A,B05,093559,Chow; Bennett,6,0,32,26
1656880965334,MATH 193A,A01,083224,Rotar; Vladimir,6,0,34,28
1656880965334,MATH 193A,A02,083225,Rotar; Vladimir,3,0,34,31
1656880965334,MATH 193A,A03,083781,Rotar; Vladimir,1,0,34,33
1656880965334,MATH 193A,A04,083782,Rotar; Vladimir,6,0,34,28
1656880965334,MATH 193A,A05,093482,Rotar; Vladimir,6,0,34,28
1656880971357,MATH 197,001,091859,McAuley; Julian John,9999,0,9999,0
1656880971357,MATH 197,002,095566,Kedlaya; Kiran S.,9997,0,9999,2
1656880971357,MATH 197,003,095567,Xiao; Ming,9999,0,9999,0
1656880971357,MATH 197,004,095571,Perols; Johan Lars,9998,0,9999,1
1656880978416,COGS 9,A01,083615,Shannon; Kyle Michael,6,0,75,69
1656880984438,COGS 11,A01,083617,Boyle; Mary E. T.,19,0,48,29
1656880990463,COGS 13,A01,083071,Bastos; Amalia Pinkusfeld,8,0,71,63
1656880996488,COGS 14A,A01,092681,Semenuks; Arturs,0,1,100,100
1656881002511,COGS 14B,A01,083073,Cheng; Tzu-Han,5,0,63,58
1656881008534,COGS 17,A01,092677,Semenuks; Arturs,4,0,81,77
1656881014560,COGS 100,A01,083619,Allen; Michael Gordon,15,0,70,55
1656881020582,COGS 101A,A01,083621,Davis; Joshua Daniel,9,0,68,59
1656881026607,COGS 101B,A01,091572,Allen; Michael Gordon,8,0,65,57
1656881032629,COGS 101C,A01,083625,Delgado; Tania,17,0,35,18
1656881038651,COGS 107A,A01,083627,Boyle; Mary E. T.,13,0,60,47
1656881044675,COGS 118A,A01,083075,Gupta; Anjum,15,0,76,61
1656881050702,CSE 3,A50,083646,Miranda; Gregory Joseph,22,0,50,28
1656881056723,CSE 8A,A50,083650,Miranda; Gregory Joseph,17,1,56,39
1656881062745,CSE 11,A01,083080,Cao; Yingjun,4,15,40,36
1656881068778,CSE 12,A01,083652,Krause-Levy; Sophia Louisa,20,1,120,100
1656881074803,CSE 15L,A01,083654,Morris; Justin Loren,8,0,50,42
1656881074803,CSE 15L,A02,083655,Morris; Justin Loren,8,0,50,42
1656881080824,CSE 20,A01,083657,Tran; Khoa Dang,37,0,80,43
1656881086847,CSE 21,A01,095574,Bach; Quang Tran,21,0,48,27
1656881092873,CSE 30,A01,083084,Eldon; John,4,0,80,76
1656881092873,CSE 30,B01,095061,Bhaskar; Nishant,6,0,50,44
1656881098897,CSE 100,A01,083659,Cao; Yingjun,2,4,70,68
1656881104924,CSE 134B,A01,083661,Powell; Thomas Allan,19,0,100,81
1656881110948,CSE 140,A01,083663,Gungor; Onat,14,0,85,71
1656881116973,CSE 140L,A01,083088,Eldon; John,16,0,100,84
1656881122998,CSE 175,A01,083665,Kumar; Rakesh,3,0,25,22
1656881129025,CSE 190,A00,092507,Dubnov; Shlomo,7,0,20,13
1656881135048,ECE 45,A01,083139,Congero; Spencer William,5,0,75,70
1656881141071,ECE 65,A50,083695,Saad; Andrew S,12,0,30,18
1656881141071,ECE 65,A51,095125,Saad; Andrew S,25,0,26,1
1656881147095,ECE 109,A01,091882,Touri; Behrouz,16,0,70,54
1656881153121,ECE 180,A00,083140,Abi Samra; Nicholas Camill,0,0,30,30
1656881153121,ECE 180,B00,083141,Abi Samra; Nicholas Camill,0,0,30,30
1656881159146,MATH 10A,A01,083735,Patchell; Gregory David,1,0,30,29
1656881159146,MATH 10A,A02,083736,Patchell; Gregory David,20,0,30,10
1656881159146,MATH 10A,A03,083737,Patchell; Gregory David,15,0,30,15
1656881165170,MATH 10B,A01,083207,Lim; Seonhee,7,0,34,27
1656881165170,MATH 10B,A02,083208,Lim; Seonhee,9,0,35,26
1656881165170,MATH 10B,A03,093472,Lim; Seonhee,4,0,34,30
1656881165170,MATH 10B,B01,083739,Sinha; Shubham,9,0,30,21
1656881171196,MATH 18,A01,083743,Cinel; Cameron Alexander,6,0,30,24
1656881171196,MATH 18,A02,083744,Cinel; Cameron Alexander,15,0,30,15
1656881171196,MATH 18,A03,083745,Cinel; Cameron Alexander,8,0,30,22
1656881171196,MATH 18,B01,083748,Rideout; David Porter,4,0,37,33
1656881171196,MATH 18,B02,083749,Rideout; David Porter,3,0,36,33
1656881171196,MATH 18,B03,083750,Rideout; David Porter,2,0,37,35
1656881171196,MATH 18,B04,083751,Rideout; David Porter,5,0,36,31
1656881171196,MATH 18,B05,093473,Rideout; David Porter,4,0,36,32
1656881171196,MATH 18,B06,093474,Rideout; David Porter,5,0,36,31
1656881177218,MATH 20A,A01,083754,Zheng; Zequn,12,0,40,28
1656881183247,MATH 20B,A01,083756,Briones; Jor-el Thomas Caparas,1,0,36,35
1656881183247,MATH 20B,A02,083757,Briones; Jor-el Thomas Caparas,1,0,36,35
1656881183247,MATH 20B,A03,093475,Briones; Jor-el Thomas Caparas,0,0,36,36
1656881189272,MATH 20C,A01,083760,Briones; Jor-el Thomas Caparas,1,0,35,34
1656881189272,MATH 20C,A02,083761,Briones; Jor-el Thomas Caparas,8,0,35,27
1656881189272,MATH 20C,A03,093476,Briones; Jor-el Thomas Caparas,0,1,36,36
1656881189272,MATH 20C,B01,083762,Bach; Quang Tran,0,0,30,30
1656881195299,MATH 20D,A01,083765,Tran; Brian Kha,4,0,30,26
1656881195299,MATH 20D,A02,083766,Tran; Brian Kha,4,0,30,26
1656881195299,MATH 20D,A03,083767,Tran; Brian Kha,2,0,30,28
1656881201323,MATH 20E,A01,083771,Ganguly; Soumya,5,0,32,27
1656881201323,MATH 20E,A02,083772,Ganguly; Soumya,6,0,32,26
1656881201323,MATH 20E,B01,083773,Ciotti; Benjamin,18,0,35,17
1656881201323,MATH 20E,B02,083774,Ciotti; Benjamin,17,0,35,18
1656881207423,MATH 103A,A01,083777,Greenfeld; Be'Eri,2,0,36,34
1656881207423,MATH 103A,A02,083778,Greenfeld; Be'Eri,5,0,36,31
1656881207423,MATH 103A,A03,093561,Greenfeld; Be'Eri,4,0,36,32
1656881207423,MATH 103A,B01,083779,Greenfeld; Be'Eri,6,0,36,30
1656881207423,MATH 103A,B02,083780,Greenfeld; Be'Eri,2,0,36,34
1656881207423,MATH 103A,B03,093562,Greenfeld; Be'Eri,2,0,36,34
1656881213453,MATH 105,A01,085443,Carter; Anne Toulson,13,0,35,22
1656881213453,MATH 105,A02,093477,Carter; Anne Toulson,20,0,35,15
1656881219477,MATH 109,A01,083213,Ganzberger; Geoffrey Michael,2,0,34,32
1656881219477,MATH 109,A02,083214,Ganzberger; Geoffrey Michael,2,0,34,32
1656881219477,MATH 109,A03,093478,Ganzberger; Geoffrey Michael,1,0,34,33
1656881219477,MATH 109,B01,083215,Ganzberger; Geoffrey Michael,1,0,32,31
1656881219477,MATH 109,B02,083216,Ganzberger; Geoffrey Michael,1,0,32,31
1656881219477,MATH 109,B03,093479,Ganzberger; Geoffrey Michael,6,0,32,26
1656881225508,MATH 142A,A01,083219,Chow; Bennett,6,0,32,26
1656881225508,MATH 142A,A02,083220,Chow; Bennett,9,0,32,23
1656881225508,MATH 142A,A03,093480,Chow; Bennett,7,0,32,25
1656881225508,MATH 142A,B03,093481,Chow; Bennett,7,0,32,25
1656881225508,MATH 142A,B04,093558,Chow; Bennett,10,0,32,22
1656881225508,MATH 142A,B05,093559,Chow; Bennett,6,0,32,26
1656881231531,MATH 193A,A01,083224,Rotar; Vladimir,6,0,34,28
1656881231531,MATH 193A,A02,083225,Rotar; Vladimir,3,0,34,31
1656881231531,MATH 193A,A03,083781,Rotar; Vladimir,1,0,34,33
1656881231531,MATH 193A,A04,083782,Rotar; Vladimir,6,0,34,28
1656881231531,MATH 193A,A05,093482,Rotar; Vladimir,6,0,34,28
1656881237558,MATH 197,001,091859,McAuley; Julian John,9999,0,9999,0
1656881237558,MATH 197,002,095566,Kedlaya; Kiran S.,9997,0,9999,2
1656881237558,MATH 197,003,095567,Xiao; Ming,9999,0,9999,0
1656881237558,MATH 197,004,095571,Perols; Johan Lars,9998,0,9999,1
1656881244621,COGS 9,A01,083615,Shannon; Kyle Michael,6,0,75,69
1656881250647,COGS 11,A01,083617,Boyle; Mary E. T.,19,0,48,29
1656881256676,COGS 13,A01,083071,Bastos; Amalia Pinkusfeld,8,0,71,63
1656881262699,COGS 14A,A01,092681,Semenuks; Arturs,0,1,100,100
1656881268725,COGS 14B,A01,083073,Cheng; Tzu-Han,5,0,63,58
1656881274748,COGS 17,A01,092677,Semenuks; Arturs,4,0,81,77
1656881280773,COGS 100,A01,083619,Allen; Michael Gordon,15,0,70,55
1656881286800,COGS 101A,A01,083621,Davis; Joshua Daniel,9,0,68,59
1656881292825,COGS 101B,A01,091572,Allen; Michael Gordon,8,0,65,57
1656881298854,COGS 101C,A01,083625,Delgado; Tania,17,0,35,18
1656881304879,COGS 107A,A01,083627,Boyle; Mary E. T.,13,0,60,47
1656881310906,COGS 118A,A01,083075,Gupta; Anjum,15,0,76,61
1656881316930,CSE 3,A50,083646,Miranda; Gregory Joseph,22,0,50,28
1656881322958,CSE 8A,A50,083650,Miranda; Gregory Joseph,17,1,56,39
1656881328989,CSE 11,A01,083080,Cao; Yingjun,4,15,40,36
1656881335016,CSE 12,A01,083652,Krause-Levy; Sophia Louisa,20,1,120,100
1656881341042,CSE 15L,A01,083654,Morris; Justin Loren,8,0,50,42
1656881341042,CSE 15L,A02,083655,Morris; Justin Loren,8,0,50,42
1656881347067,CSE 20,A01,083657,Tran; Khoa Dang,37,0,80,43
1656881353091,CSE 21,A01,095574,Bach; Quang Tran,21,0,48,27
1656881359135,CSE 30,A01,083084,Eldon; John,4,0,80,76
1656881359135,CSE 30,B01,095061,Bhaskar; Nishant,6,0,50,44
1656881365161,CSE 100,A01,083659,Cao; Yingjun,2,4,70,68
1656881371195,CSE 134B,A01,083661,Powell; Thomas Allan,19,0,100,81
1656881377218,CSE 140,A01,083663,Gungor; Onat,14,0,85,71
1656881383245,CSE 140L,A01,083088,Eldon; John,16,0,100,84
1656881389269,CSE 175,A01,083665,Kumar; Rakesh,3,0,25,22
1656881395293,CSE 190,A00,092507,Dubnov; Shlomo,7,0,20,13
1656881401317,ECE 45,A01,083139,Congero; Spencer William,5,0,75,70
1656881407344,ECE 65,A50,083695,Saad; Andrew S,12,0,30,18
1656881407344,ECE 65,A51,095125,Saad; Andrew S,25,0,26,1
1656881413369,ECE 109,A01,091882,Touri; Behrouz,16,0,70,54
1656881419395,ECE 180,A00,083140,Abi Samra; Nicholas Camill,0,0,30,30
1656881419395,ECE 180,B00,083141,Abi Samra; Nicholas Camill,0,0,30,30
1656881425422,MATH 10A,A01,083735,Patchell; Gregory David,1,0,30,29
1656881425422,MATH 10A,A02,083736,Patchell; Gregory David,20,0,30,10
1656881425422,MATH 10A,A03,083737,Patchell; Gregory David,15,0,30,15
1656881431458,MATH 10B,A01,083207,Lim; Seonhee,7,0,34,27
1656881431458,MATH 10B,A02,083208,Lim; Seonhee,9,0,35,26
1656881431458,MATH 10B,A03,093472,Lim; Seonhee,4,0,34,30
1656881431458,MATH 10B,B01,083739,Sinha; Shubham,9,0,30,21
1656881437483,MATH 18,A01,083743,Cinel; Cameron Alexander,6,0,30,24
1656881437483,MATH 18,A02,083744,Cinel; Cameron Alexander,15,0,30,15
1656881437483,MATH 18,A03,083745,Cinel; Cameron Alexander,8,0,30,22
1656881437483,MATH 18,B01,083748,Rideout; David Porter,4,0,37,33
1656881437483,MATH 18,B02,083749,Rideout; David Porter,3,0,36,33
1656881437483,MATH 18,B03,083750,Rideout; David Porter,2,0,37,35
1656881437483,MATH 18,B04,083751,Rideout; David Porter,5,0,36,31
1656881437483,MATH 18,B05,093473,Rideout; David Porter,4,0,36,32
1656881437483,MATH 18,B06,093474,Rideout; David Porter,5,0,36,31
1656881443508,MATH 20A,A01,083754,Zheng; Zequn,12,0,40,28
1656881449530,MATH 20B,A01,083756,Briones; Jor-el Thomas Caparas,1,0,36,35
1656881449530,MATH 20B,A02,083757,Briones; Jor-el Thomas Caparas,1,0,36,35
1656881449530,MATH 20B,A03,093475,Briones; Jor-el Thomas Caparas,0,0,36,36
1656881455554,MATH 20C,A01,083760,Briones; Jor-el Thomas Caparas,1,0,35,34
1656881455554,MATH 20C,A02,083761,Briones; Jor-el Thomas Caparas,8,0,35,27
1656881455554,MATH 20C,A03,093476,Briones; Jor-el Thomas Caparas,0,1,36,36
1656881455554,MATH 20C,B01,083762,Bach; Quang Tran,0,0,30,30
1656881461578,MATH 20D,A01,083765,Tran; Brian Kha,4,0,30,26
1656881461578,MATH 20D,A02,083766,Tran; Brian Kha,4,0,30,26
1656881461578,MATH 20D,A03,083767,Tran; Brian Kha,2,0,30,28
1656881467605,MATH 20E,A01,083771,Ganguly; Soumya,5,0,32,27
1656881467605,MATH 20E,A02,083772,Ganguly; Soumya,6,0,32,26
1656881467605,MATH 20E,B01,083773,Ciotti; Benjamin,18,0,35,17
1656881467605,MATH 20E,B02,083774,Ciotti; Benjamin,17,0,35,18
1656881473627,MATH 103A,A01,083777,Greenfeld; Be'Eri,2,0,36,34
1656881473627,MATH 103A,A02,083778,Greenfeld; Be'Eri,5,0,36,31
1656881473627,MATH 103A,A03,093561,Greenfeld; Be'Eri,4,0,36,32
1656881473627,MATH 103A,B01,083779,Greenfeld; Be'Eri,6,0,36,30
1656881473627,MATH 103A,B02,083780,Greenfeld; Be'Eri,2,0,36,34
1656881473627,MATH 103A,B03,093562,Greenfeld; Be'Eri,2,0,36,34
1656881479649,MATH 105,A01,085443,Carter; Anne Toulson,13,0,35,22
1656881479649,MATH 105,A02,093477,Carter; Anne Toulson,20,0,35,15
1656881485678,MATH 109,A01,083213,Ganzberger; Geoffrey Michael,2,0,34,32
1656881485678,MATH 109,A02,083214,Ganzberger; Geoffrey Michael,2,0,34,32
1656881485678,MATH 109,A03,093478,Ganzberger; Geoffrey Michael,1,0,34,33
1656881485678,MATH 109,B01,083215,Ganzberger; Geoffrey Michael,1,0,32,31
1656881485678,MATH 109,B02,083216,Ganzberger; Geoffrey Michael,1,0,32,31
1656881485678,MATH 109,B03,093479,Ganzberger; Geoffrey Michael,6,0,32,26
1656881491705,MATH 142A,A01,083219,Chow; Bennett,6,0,32,26
1656881491705,MATH 142A,A02,083220,Chow; Bennett,9,0,32,23
1656881491705,MATH 142A,A03,093480,Chow; Bennett,7,0,32,25
1656881491705,MATH 142A,B03,093481,Chow; Bennett,7,0,32,25
1656881491705,MATH 142A,B04,093558,Chow; Bennett,10,0,32,22
1656881491705,MATH 142A,B05,093559,Chow; Bennett,6,0,32,26
1656881497732,MATH 193A,A01,083224,Rotar; Vladimir,6,0,34,28
1656881497732,MATH 193A,A02,083225,Rotar; Vladimir,3,0,34,31
1656881497732,MATH 193A,A03,083781,Rotar; Vladimir,1,0,34,33
1656881497732,MATH 193A,A04,083782,Rotar; Vladimir,6,0,34,28
1656881497732,MATH 193A,A05,093482,Rotar; Vladimir,6,0,34,28
1656881503758,MATH 197,001,091859,McAuley; Julian John,9999,0,9999,0
1656881503758,MATH 197,002,095566,Kedlaya; Kiran S.,9997,0,9999,2
1656881503758,MATH 197,003,095567,Xiao; Ming,9999,0,9999,0
1656881503758,MATH 197,004,095571,Perols; Johan Lars,9998,0,9999,1
1656881510823,COGS 9,A01,083615,Shannon; Kyle Michael,6,0,75,69
1656881516850,COGS 11,A01,083617,Boyle; Mary E. T.,19,0,48,29
1656881522877,COGS 13,A01,083071,Bastos; Amalia Pinkusfeld,8,0,71,63
1656881528901,COGS 14A,A01,092681,Semenuks; Arturs,0,1,100,100
1656881534927,COGS 14B,A01,083073,Cheng; Tzu-Han,5,0,63,58
1656881540955,COGS 17,A01,092677,Semenuks; Arturs,4,0,81,77
1656881546983,COGS 100,A01,083619,Allen; Michael Gordon,15,0,70,55
1656881553011,COGS 101A,A01,083621,Davis; Joshua Daniel,9,0,68,59
1656881559037,COGS 101B,A01,091572,Allen; Michael Gordon,8,0,65,57
1656881565061,COGS 101C,A01,083625,Delgado; Tania,17,0,35,18
1656881571092,COGS 107A,A01,083627,Boyle; Mary E. T.,13,0,60,47
1656881577114,COGS 118A,A01,083075,Gupta; Anjum,15,0,76,61
1656881583138,CSE 3,A50,083646,Miranda; Gregory Joseph,22,0,50,28
1656881589168,CSE 8A,A50,083650,Miranda; Gregory Joseph,17,1,56,39
1656881595190,CSE 11,A01,083080,Cao; Yingjun,4,15,40,36
1656881601214,CSE 12,A01,083652,Krause-Levy; Sophia Louisa,20,1,120,100
1656881607239,CSE 15L,A01,083654,Morris; Justin Loren,8,0,50,42
1656881607239,CSE 15L,A02,083655,Morris; Justin Loren,8,0,50,42
1656881613261,CSE 20,A01,083657,Tran; Khoa Dang,37,0,80,43
1656881619288,CSE 21,A01,095574,Bach; Quang Tran,21,0,48,27
1656881625311,CSE 30,A01,083084,Eldon; John,4,0,80,76
1656881625311,CSE 30,B01,095061,Bhaskar; Nishant,6,0,50,44
1656881631334,CSE 100,A01,083659,Cao; Yingjun,2,4,70,68
1656881637357,CSE 134B,A01,083661,Powell; Thomas Allan,19,0,100,81
1656881643380,CSE 140,A01,083663,Gungor; Onat,14,0,85,71
1656881649402,CSE 140L,A01,083088,Eldon; John,16,0,100,84
1656881655427,CSE 175,A01,083665,Kumar; Rakesh,3,0,25,22
1656881661451,CSE 190,A00,092507,Dubnov; Shlomo,7,0,20,13
1656881667474,ECE 45,A01,083139,Congero; Spencer William,5,0,75,70
1656881673499,ECE 65,A50,083695,Saad; Andrew S,12,0,30,18
1656881673499,ECE 65,A51,095125,Saad; Andrew S,25,0,26,1
1656881679520,ECE 109,A01,091882,Touri; Behrouz,16,0,70,54
1656881685545,ECE 180,A00,083140,Abi Samra; Nicholas Camill,0,0,30,30
1656881685545,ECE 180,B00,083141,Abi Samra; Nicholas Camill,0,0,30,30
1656881691568,MATH 10A,A01,083735,Patchell; Gregory David,1,0,30,29
1656881691568,MATH 10A,A02,083736,Patchell; Gregory David,20,0,30,10
1656881691568,MATH 10A,A03,083737,Patchell; Gregory David,15,0,30,15
1656881697593,MATH 10B,A01,083207,Lim; Seonhee,7,0,34,27
1656881697593,MATH 10B,A02,083208,Lim; Seonhee,9,0,35,26
1656881697593,MATH 10B,A03,093472,Lim; Seonhee,4,0,34,30
1656881697593,MATH 10B,B01,083739,Sinha; Shubham,9,0,30,21
1656881703626,MATH 18,A01,083743,Cinel; Cameron Alexander,6,0,30,24
1656881703626,MATH 18,A02,083744,Cinel; Cameron Alexander,15,0,30,15
1656881703626,MATH 18,A03,083745,Cinel; Cameron Alexander,8,0,30,22
1656881703626,MATH 18,B01,083748,Rideout; David Porter,4,0,37,33
1656881703626,MATH 18,B02,083749,Rideout; David Porter,3,0,36,33
1656881703626,MATH 18,B03,083750,Rideout; David Porter,2,0,37,35
1656881703626,MATH 18,B04,083751,Rideout; David Porter,5,0,36,31
1656881703626,MATH 18,B05,093473,Rideout; David Porter,4,0,36,32
1656881703626,MATH 18,B06,093474,Rideout; David Porter,5,0,36,31
1656881709652,MATH 20A,A01,083754,Zheng; Zequn,12,0,40,28
1656881715676,MATH 20B,A01,083756,Briones; Jor-el Thomas Caparas,1,0,36,35
1656881715676,MATH 20B,A02,083757,Briones; Jor-el Thomas Caparas,1,0,36,35
1656881715676,MATH 20B,A03,093475,Briones; Jor-el Thomas Caparas,0,0,36,36
1656881721704,MATH 20C,A01,083760,Briones; Jor-el Thomas Caparas,1,0,35,34
1656881721704,MATH 20C,A02,083761,Briones; Jor-el Thomas Caparas,8,0,35,27
1656881721704,MATH 20C,A03,093476,Briones; Jor-el Thomas Caparas,0,1,36,36
1656881721704,MATH 20C,B01,083762,Bach; Quang Tran,0,0,30,30
1656881727731,MATH 20D,A01,083765,Tran; Brian Kha,4,0,30,26
1656881727731,MATH 20D,A02,083766,Tran; Brian Kha,4,0,30,26
1656881727731,MATH 20D,A03,083767,Tran; Brian Kha,2,0,30,28
1656881733760,MATH 20E,A01,083771,Ganguly; Soumya,5,0,32,27
1656881733760,MATH 20E,A02,083772,Ganguly; Soumya,6,0,32,26
1656881733760,MATH 20E,B01,083773,Ciotti; Benjamin,18,0,35,17
1656881733760,MATH 20E,B02,083774,Ciotti; Benjamin,17,0,35,18
1656881739784,MATH 103A,A01,083777,Greenfeld; Be'Eri,2,0,36,34
1656881739784,MATH 103A,A02,083778,Greenfeld; Be'Eri,5,0,36,31
1656881739784,MATH 103A,A03,093561,Greenfeld; Be'Eri,4,0,36,32
1656881739784,MATH 103A,B01,083779,Greenfeld; Be'Eri,6,0,36,30
1656881739784,MATH 103A,B02,083780,Greenfeld; Be'Eri,2,0,36,34
1656881739784,MATH 103A,B03,093562,Greenfeld; Be'Eri,2,0,36,34
1656881745808,MATH 105,A01,085443,Carter; Anne Toulson,13,0,35,22
1656881745808,MATH 105,A02,093477,Carter; Anne Toulson,20,0,35,15
1656881751829,MATH 109,A01,083213,Ganzberger; Geoffrey Michael,2,0,34,32
1656881751829,MATH 109,A02,083214,Ganzberger; Geoffrey Michael,2,0,34,32
1656881751829,MATH 109,A03,093478,Ganzberger; Geoffrey Michael,1,0,34,33
1656881751829,MATH 109,B01,083215,Ganzberger; Geoffrey Michael,1,0,32,31
1656881751829,MATH 109,B02,083216,Ganzberger; Geoffrey Michael,1,0,32,31
1656881751829,MATH 109,B03,093479,Ganzberger; Geoffrey Michael,6,0,32,26
1656881757853,MATH 142A,A01,083219,Chow; Bennett,6,0,32,26
1656881757853,MATH 142A,A02,083220,Chow; Bennett,9,0,32,23
1656881757853,MATH 142A,A03,093480,Chow; Bennett,7,0,32,25
1656881757853,MATH 142A,B03,093481,Chow; Bennett,7,0,32,25
1656881757853,MATH 142A,B04,093558,Chow; Bennett,10,0,32,22
1656881757853,MATH 142A,B05,093559,Chow; Bennett,6,0,32,26
1656881763876,MATH 193A,A01,083224,Rotar; Vladimir,6,0,34,28
1656881763876,MATH 193A,A02,083225,Rotar; Vladimir,3,0,34,31
1656881763876,MATH 193A,A03,083781,Rotar; Vladimir,1,0,34,33
1656881763876,MATH 193A,A04,083782,Rotar; Vladimir,6,0,34,28
1656881763876,MATH 193A,A05,093482,Rotar; Vladimir,6,0,34,28
1656881769907,MATH 197,001,091859,McAuley; Julian John,9999,0,9999,0
1656881769907,MATH 197,002,095566,Kedlaya; Kiran S.,9997,0,9999,2
1656881769907,MATH 197,003,095567,Xiao; Ming,9999,0,9999,0
1656881769907,MATH 197,004,095571,Perols; Johan Lars,9998,0,9999,1
1656881776961,COGS 9,A01,083615,Shannon; Kyle Michael,6,0,75,69
1656881782988,COGS 11,A01,083617,Boyle; Mary E. T.,19,0,48,29
1656881789013,COGS 13,A01,083071,Bastos; Amalia Pinkusfeld,8,0,71,63
1656881795039,COGS 14A,A01,092681,Semenuks; Arturs,0,1,100,100
1656881801137,COGS 14B,A01,083073,Cheng; Tzu-Han,5,0,63,58
1656881807159,COGS 17,A01,092677,Semenuks; Arturs,4,0,81,77
1656881813182,COGS 100,A01,083619,Allen; Michael Gordon,15,0,70,55
1656881819205,COGS 101A,A01,083621,Davis; Joshua Daniel,9,0,68,59
1656881825232,COGS 101B,A01,091572,Allen; Michael Gordon,8,0,65,57
1656881831259,COGS 101C,A01,083625,Delgado; Tania,17,0,35,18
1656881837282,COGS 107A,A01,083627,Boyle; Mary E. T.,13,0,60,47
1656881843306,COGS 118A,A01,083075,Gupta; Anjum,15,0,76,61
1656881849330,CSE 3,A50,083646,Miranda; Gregory Joseph,22,0,50,28
1656881855359,CSE 8A,A50,083650,Miranda; Gregory Joseph,17,1,56,39
1656881861384,CSE 11,A01,083080,Cao; Yingjun,4,15,40,36
1656881867406,CSE 12,A01,083652,Krause-Levy; Sophia Louisa,20,1,120,100
1656881873434,CSE 15L,A01,083654,Morris; Justin Loren,8,0,50,42
1656881873434,CSE 15L,A02,083655,Morris; Justin Loren,8,0,50,42
1656881879457,CSE 20,A01,083657,Tran; Khoa Dang,37,0,80,43
1656881885480,CSE 21,A01,095574,Bach; Quang Tran,21,0,48,27
1656881891503,CSE 30,A01,083084,Eldon; John,4,0,80,76
1656881891503,CSE 30,B01,095061,Bhaskar; Nishant,6,0,50,44
1656881897529,CSE 100,A01,083659,Cao; Yingjun,2,4,70,68
1656881903550,CSE 134B,A01,083661,Powell; Thomas Allan,19,0,100,81
1656881909576,CSE 140,A01,083663,Gungor; Onat,14,0,85,71
1656881915599,CSE 140L,A01,083088,Eldon; John,16,0,100,84
1656881921628,CSE 175,A01,083665,Kumar; Rakesh,3,0,25,22
1656881927653,CSE 190,A00,092507,Dubnov; Shlomo,7,0,20,13
1656881933680,ECE 45,A01,083139,Congero; Spencer William,5,0,75,70
1656881939717,ECE 65,A50,083695,Saad; Andrew S,12,0,30,18
1656881939717,ECE 65,A51,095125,Saad; Andrew S,25,0,26,1
1656881945740,ECE 109,A01,091882,Touri; Behrouz,16,0,70,54
1656881951769,ECE 180,A00,083140,Abi Samra; Nicholas Camill,0,0,30,30
1656881951769,ECE 180,B00,083141,Abi Samra; Nicholas Camill,0,0,30,30
1656881957792,MATH 10A,A01,083735,Patchell; Gregory David,1,0,30,29
1656881957792,MATH 10A,A02,083736,Patchell; Gregory David,20,0,30,10
1656881957792,MATH 10A,A03,083737,Patchell; Gregory David,15,0,30,15
1656881963816,MATH 10B,A01,083207,Lim; Seonhee,7,0,34,27
1656881963816,MATH 10B,A02,083208,Lim; Seonhee,9,0,35,26
1656881963816,MATH 10B,A03,093472,Lim; Seonhee,4,0,34,30
1656881963816,MATH 10B,B01,083739,Sinha; Shubham,9,0,30,21
1656881969840,MATH 18,A01,083743,Cinel; Cameron Alexander,6,0,30,24
1656881969840,MATH 18,A02,083744,Cinel; Cameron Alexander,15,0,30,15
1656881969840,MATH 18,A03,083745,Cinel; Cameron Alexander,8,0,30,22
1656881969840,MATH 18,B01,083748,Rideout; David Porter,4,0,37,33
1656881969840,MATH 18,B02,083749,Rideout; David Porter,3,0,36,33
1656881969840,MATH 18,B03,083750,Rideout; David Porter,2,0,37,35
1656881969840,MATH 18,B04,083751,Rideout; David Porter,5,0,36,31
1656881969840,MATH 18,B05,093473,Rideout; David Porter,4,0,36,32
1656881969840,MATH 18,B06,093474,Rideout; David Porter,5,0,36,31
1656881975863,MATH 20A,A01,083754,Zheng; Zequn,12,0,40,28
1656881981887,MATH 20B,A01,083756,Briones; Jor-el Thomas Caparas,1,0,36,35
1656881981887,MATH 20B,A02,083757,Briones; Jor-el Thomas Caparas,1,0,36,35
1656881981887,MATH 20B,A03,093475,Briones; Jor-el Thomas Caparas,0,0,36,36
1656881987912,MATH 20C,A01,083760,Briones; Jor-el Thomas Caparas,1,0,35,34
1656881987912,MATH 20C,A02,083761,Briones; Jor-el Thomas Caparas,8,0,35,27
1656881987912,MATH 20C,A03,093476,Briones; Jor-el Thomas Caparas,0,1,36,36
1656881987912,MATH 20C,B01,083762,Bach; Quang Tran,0,0,30,30
1656881993939,MATH 20D,A01,083765,Tran; Brian Kha,4,0,30,26
1656881993939,MATH 20D,A02,083766,Tran; Brian Kha,4,0,30,26
1656881993939,MATH 20D,A03,083767,Tran; Brian Kha,2,0,30,28
1656881999964,MATH 20E,A01,083771,Ganguly; Soumya,5,0,32,27
1656881999964,MATH 20E,A02,083772,Ganguly; Soumya,6,0,32,26
1656881999964,MATH 20E,B01,083773,Ciotti; Benjamin,18,0,35,17
1656881999964,MATH 20E,B02,083774,Ciotti; Benjamin,17,0,35,18
1656882005995,MATH 103A,A01,083777,Greenfeld; Be'Eri,2,0,36,34
1656882005995,MATH 103A,A02,083778,Greenfeld; Be'Eri,5,0,36,31
1656882005995,MATH 103A,A03,093561,Greenfeld; Be'Eri,4,0,36,32
1656882005995,MATH 103A,B01,083779,Greenfeld; Be'Eri,6,0,36,30
1656882005995,MATH 103A,B02,083780,Greenfeld; Be'Eri,2,0,36,34
1656882005995,MATH 103A,B03,093562,Greenfeld; Be'Eri,2,0,36,34
1656882012017,MATH 105,A01,085443,Carter; Anne Toulson,13,0,35,22
1656882012017,MATH 105,A02,093477,Carter; Anne Toulson,20,0,35,15
1656882018054,MATH 109,A01,083213,Ganzberger; Geoffrey Michael,2,0,34,32
1656882018054,MATH 109,A02,083214,Ganzberger; Geoffrey Michael,2,0,34,32
1656882018054,MATH 109,A03,093478,Ganzberger; Geoffrey Michael,1,0,34,33
1656882018054,MATH 109,B01,083215,Ganzberger; Geoffrey Michael,1,0,32,31
1656882018054,MATH 109,B02,083216,Ganzberger; Geoffrey Michael,1,0,32,31
1656882018054,MATH 109,B03,093479,Ganzberger; Geoffrey Michael,6,0,32,26
1656882024084,MATH 142A,A01,083219,Chow; Bennett,6,0,32,26
1656882024084,MATH 142A,A02,083220,Chow; Bennett,9,0,32,23
1656882024084,MATH 142A,A03,093480,Chow; Bennett,7,0,32,25
1656882024084,MATH 142A,B03,093481,Chow; Bennett,7,0,32,25
1656882024084,MATH 142A,B04,093558,Chow; Bennett,10,0,32,22
1656882024084,MATH 142A,B05,093559,Chow; Bennett,6,0,32,26
1656882030109,MATH 193A,A01,083224,Rotar; Vladimir,6,0,34,28
1656882030109,MATH 193A,A02,083225,Rotar; Vladimir,3,0,34,31
1656882030109,MATH 193A,A03,083781,Rotar; Vladimir,1,0,34,33
1656882030109,MATH 193A,A04,083782,Rotar; Vladimir,6,0,34,28
1656882030109,MATH 193A,A05,093482,Rotar; Vladimir,6,0,34,28
1656882036136,MATH 197,001,091859,McAuley; Julian John,9999,0,9999,0
1656882036136,MATH 197,002,095566,Kedlaya; Kiran S.,9997,0,9999,2
1656882036136,MATH 197,003,095567,Xiao; Ming,9999,0,9999,0
1656882036136,MATH 197,004,095571,Perols; Johan Lars,9998,0,9999,1
1656882043192,COGS 9,A01,083615,Shannon; Kyle Michael,6,0,75,69
1656882049219,COGS 11,A01,083617,Boyle; Mary E. T.,19,0,48,29
1656882055242,COGS 13,A01,083071,Bastos; Amalia Pinkusfeld,8,0,71,63
1656882061267,COGS 14A,A01,092681,Semenuks; Arturs,0,1,100,100
1656882067297,COGS 14B,A01,083073,Cheng; Tzu-Han,5,0,63,58
1656882073322,COGS 17,A01,092677,Semenuks; Arturs,4,0,81,77
1656882079345,COGS 100,A01,083619,Allen; Michael Gordon,15,0,70,55
1656882085367,COGS 101A,A01,083621,Davis; Joshua Daniel,9,0,68,59
1656882091393,COGS 101B,A01,091572,Allen; Michael Gordon,8,0,65,57
1656882097431,COGS 101C,A01,083625,Delgado; Tania,17,0,35,18
1656882103456,COGS 107A,A01,083627,Boyle; Mary E. T.,13,0,60,47
1656882109488,COGS 118A,A01,083075,Gupta; Anjum,15,0,76,61
1656882115511,CSE 3,A50,083646,Miranda; Gregory Joseph,22,0,50,28
1656882121536,CSE 8A,A50,083650,Miranda; Gregory Joseph,17,1,56,39
1656882127560,CSE 11,A01,083080,Cao; Yingjun,4,15,40,36
1656882133586,CSE 12,A01,083652,Krause-Levy; Sophia Louisa,20,1,120,100
1656882139611,CSE 15L,A01,083654,Morris; Justin Loren,8,0,50,42
1656882139611,CSE 15L,A02,083655,Morris; Justin Loren,8,0,50,42
1656882145639,CSE 20,A01,083657,Tran; Khoa Dang,37,0,80,43
1656882151660,CSE 21,A01,095574,Bach; Quang Tran,21,0,48,27
1656882157682,CSE 30,A01,083084,Eldon; John,4,0,80,76
1656882157682,CSE 30,B01,095061,Bhaskar; Nishant,6,0,50,44
1656882163705,CSE 100,A01,083659,Cao; Yingjun,2,4,70,68
1656882169732,CSE 134B,A01,083661,Powell; Thomas Allan,19,0,100,81
1656882175766,CSE 140,A01,083663,Gungor; Onat,14,0,85,71
1656882181792,CSE 140L,A01,083088,Eldon; John,16,0,100,84
1656882187818,CSE 175,A01,083665,Kumar; Rakesh,3,0,25,22
1656882193845,CSE 190,A00,092507,Dubnov; Shlomo,7,0,20,13
1656882199869,ECE 45,A01,083139,Congero; Spencer William,5,0,75,70
1656882205892,ECE 65,A50,083695,Saad; Andrew S,12,0,30,18
1656882205892,ECE 65,A51,095125,Saad; Andrew S,25,0,26,1
1656882211916,ECE 109,A01,091882,Touri; Behrouz,16,0,70,54
1656882217940,ECE 180,A00,083140,Abi Samra; Nicholas Camill,0,0,30,30
1656882217940,ECE 180,B00,083141,Abi Samra; Nicholas Camill,0,0,30,30
1656882223968,MATH 10A,A01,083735,Patchell; Gregory David,1,0,30,29
1656882223968,MATH 10A,A02,083736,Patchell; Gregory David,20,0,30,10
1656882223968,MATH 10A,A03,083737,Patchell; Gregory David,15,0,30,15
1656882229992,MATH 10B,A01,083207,Lim; Seonhee,7,0,34,27
1656882229992,MATH 10B,A02,083208,Lim; Seonhee,9,0,35,26
1656882229992,MATH 10B,A03,093472,Lim; Seonhee,4,0,34,30
1656882229992,MATH 10B,B01,083739,Sinha; Shubham,9,0,30,21
1656882236016,MATH 18,A01,083743,Cinel; Cameron Alexander,6,0,30,24
1656882236016,MATH 18,A02,083744,Cinel; Cameron Alexander,15,0,30,15
1656882236016,MATH 18,A03,083745,Cinel; Cameron Alexander,8,0,30,22
1656882236016,MATH 18,B01,083748,Rideout; David Porter,4,0,37,33
1656882236016,MATH 18,B02,083749,Rideout; David Porter,3,0,36,33
1656882236016,MATH 18,B03,083750,Rideout; David Porter,2,0,37,35
1656882236016,MATH 18,B04,083751,Rideout; David Porter,5,0,36,31
1656882236016,MATH 18,B05,093473,Rideout; David Porter,4,0,36,32
1656882236016,MATH 18,B06,093474,Rideout; David Porter,5,0,36,31
1656882242041,MATH 20A,A01,083754,Zheng; Zequn,12,0,40,28
1656882248069,MATH 20B,A01,083756,Briones; Jor-el Thomas Caparas,1,0,36,35
1656882248069,MATH 20B,A02,083757,Briones; Jor-el Thomas Caparas,1,0,36,35
1656882248069,MATH 20B,A03,093475,Briones; Jor-el Thomas Caparas,0,0,36,36
1656882254099,MATH 20C,A01,083760,Briones; Jor-el Thomas Caparas,1,0,35,34
1656882254099,MATH 20C,A02,083761,Briones; Jor-el Thomas Caparas,8,0,35,27
1656882254099,MATH 20C,A03,093476,Briones; Jor-el Thomas Caparas,0,1,36,36
1656882254099,MATH 20C,B01,083762,Bach; Quang Tran,0,0,30,30
1656882260122,MATH 20D,A01,083765,Tran; Brian Kha,4,0,30,26
1656882260122,MATH 20D,A02,083766,Tran; Brian Kha,4,0,30,26
1656882260122,MATH 20D,A03,083767,Tran; Brian Kha,2,0,30,28
1656882266145,MATH 20E,A01,083771,Ganguly; Soumya,5,0,32,27
1656882266145,MATH 20E,A02,083772,Ganguly; Soumya,6,0,32,26
1656882266145,MATH 20E,B01,083773,Ciotti; Benjamin,18,0,35,17
1656882266145,MATH 20E,B02,083774,Ciotti; Benjamin,17,0,35,18
1656882272170,MATH 103A,A01,083777,Greenfeld; Be'Eri,2,0,36,34
1656882272170,MATH 103A,A02,083778,Greenfeld; Be'Eri,5,0,36,31
1656882272170,MATH 103A,A03,093561,Greenfeld; Be'Eri,4,0,36,32
1656882272170,MATH 103A,B01,083779,Greenfeld; Be'Eri,6,0,36,30
1656882272170,MATH 103A,B02,083780,Greenfeld; Be'Eri,2,0,36,34
1656882272170,MATH 103A,B03,093562,Greenfeld; Be'Eri,2,0,36,34
1656882278193,MATH 105,A01,085443,Carter; Anne Toulson,13,0,35,22
1656882278193,MATH 105,A02,093477,Carter; Anne Toulson,20,0,35,15
1656882284219,MATH 109,A01,083213,Ganzberger; Geoffrey Michael,2,0,34,32
1656882284219,MATH 109,A02,083214,Ganzberger; Geoffrey Michael,2,0,34,32
1656882284219,MATH 109,A03,093478,Ganzberger; Geoffrey Michael,1,0,34,33
1656882284219,MATH 109,B01,083215,Ganzberger; Geoffrey Michael,1,0,32,31
1656882284219,MATH 109,B02,083216,Ganzberger; Geoffrey Michael,1,0,32,31
1656882284219,MATH 109,B03,093479,Ganzberger; Geoffrey Michael,6,0,32,26
1656882290248,MATH 142A,A01,083219,Chow; Bennett,6,0,32,26
1656882290248,MATH 142A,A02,083220,Chow; Bennett,9,0,32,23
1656882290248,MATH 142A,A03,093480,Chow; Bennett,7,0,32,25
1656882290248,MATH 142A,B03,093481,Chow; Bennett,7,0,32,25
1656882290248,MATH 142A,B04,093558,Chow; Bennett,10,0,32,22
1656882290248,MATH 142A,B05,093559,Chow; Bennett,6,0,32,26
1656882296273,MATH 193A,A01,083224,Rotar; Vladimir,6,0,34,28
1656882296273,MATH 193A,A02,083225,Rotar; Vladimir,3,0,34,31
1656882296273,MATH 193A,A03,083781,Rotar; Vladimir,1,0,34,33
1656882296273,MATH 193A,A04,083782,Rotar; Vladimir,6,0,34,28
1656882296273,MATH 193A,A05,093482,Rotar; Vladimir,6,0,34,28
1656882302297,MATH 197,001,091859,McAuley; Julian John,9999,0,9999,0
1656882302297,MATH 197,002,095566,Kedlaya; Kiran S.,9997,0,9999,2
1656882302297,MATH 197,003,095567,Xiao; Ming,9999,0,9999,0
1656882302297,MATH 197,004,095571,Perols; Johan Lars,9998,0,9999,1
1656882309354,COGS 9,A01,083615,Shannon; Kyle Michael,6,0,75,69
1656882315377,COGS 11,A01,083617,Boyle; Mary E. T.,19,0,48,29
1656882321403,COGS 13,A01,083071,Bastos; Amalia Pinkusfeld,8,0,71,63
1656882327459,COGS 14A,A01,092681,Semenuks; Arturs,0,1,100,100
1656882333483,COGS 14B,A01,083073,Cheng; Tzu-Han,5,0,63,58
1656882339510,COGS 17,A01,092677,Semenuks; Arturs,4,0,81,77
1656882345534,COGS 100,A01,083619,Allen; Michael Gordon,15,0,70,55
1656882351564,COGS 101A,A01,083621,Davis; Joshua Daniel,9,0,68,59
1656882357584,COGS 101B,A01,091572,Allen; Michael Gordon,8,0,65,57
1656882363607,COGS 101C,A01,083625,Delgado; Tania,17,0,35,18
1656882369633,COGS 107A,A01,083627,Boyle; Mary E. T.,13,0,60,47
1656882375656,COGS 118A,A01,083075,Gupta; Anjum,15,0,76,61
1656882381679,CSE 3,A50,083646,Miranda; Gregory Joseph,22,0,50,28
1656882387705,CSE 8A,A50,083650,Miranda; Gregory Joseph,17,1,56,39
1656882393732,CSE 11,A01,083080,Cao; Yingjun,4,15,40,36
1656882399850,CSE 12,A01,083652,Krause-Levy; Sophia Louisa,20,1,120,100
1656882405881,CSE 15L,A01,083654,Morris; Justin Loren,8,0,50,42
1656882405881,CSE 15L,A02,083655,Morris; Justin Loren,8,0,50,42
1656882411907,CSE 20,A01,083657,Tran; Khoa Dang,37,0,80,43
1656882417929,CSE 21,A01,095574,Bach; Quang Tran,21,0,48,27
1656882423952,CSE 30,A01,083084,Eldon; John,4,0,80,76
1656882423952,CSE 30,B01,095061,Bhaskar; Nishant,6,0,50,44
1656882429975,CSE 100,A01,083659,Cao; Yingjun,2,4,70,68
1656882435999,CSE 134B,A01,083661,Powell; Thomas Allan,19,0,100,81
1656882442026,CSE 140,A01,083663,Gungor; Onat,14,0,85,71
1656882448057,CSE 140L,A01,083088,Eldon; John,16,0,100,84
1656882454082,CSE 175,A01,083665,Kumar; Rakesh,3,0,25,22
1656882460105,CSE 190,A00,092507,Dubnov; Shlomo,7,0,20,13
1656882466127,ECE 45,A01,083139,Congero; Spencer William,5,0,75,70
1656882472154,ECE 65,A50,083695,Saad; Andrew S,12,0,30,18
1656882472154,ECE 65,A51,095125,Saad; Andrew S,25,0,26,1
1656882478177,ECE 109,A01,091882,Touri; Behrouz,16,0,70,54
1656882484201,ECE 180,A00,083140,Abi Samra; Nicholas Camill,0,0,30,30
1656882484201,ECE 180,B00,083141,Abi Samra; Nicholas Camill,0,0,30,30
1656882490227,MATH 10A,A01,083735,Patchell; Gregory David,1,0,30,29
1656882490227,MATH 10A,A02,083736,Patchell; Gregory David,20,0,30,10
1656882490227,MATH 10A,A03,083737,Patchell; Gregory David,15,0,30,15
1656882496249,MATH 10B,A01,083207,Lim; Seonhee,7,0,34,27
1656882496249,MATH 10B,A02,083208,Lim; Seonhee,9,0,35,26
1656882496249,MATH 10B,A03,093472,Lim; Seonhee,4,0,34,30
1656882496249,MATH 10B,B01,083739,Sinha; Shubham,9,0,30,21
1656882502281,MATH 18,A01,083743,Cinel; Cameron Alexander,6,0,30,24
1656882502281,MATH 18,A02,083744,Cinel; Cameron Alexander,15,0,30,15
1656882502281,MATH 18,A03,083745,Cinel; Cameron Alexander,8,0,30,22
1656882502281,MATH 18,B01,083748,Rideout; David Porter,4,0,37,33
1656882502281,MATH 18,B02,083749,Rideout; David Porter,3,0,36,33
1656882502281,MATH 18,B03,083750,Rideout; David Porter,2,0,37,35
1656882502281,MATH 18,B04,083751,Rideout; David Porter,5,0,36,31
1656882502281,MATH 18,B05,093473,Rideout; David Porter,4,0,36,32
1656882502281,MATH 18,B06,093474,Rideout; David Porter,5,0,36,31
1656882508313,MATH 20A,A01,083754,Zheng; Zequn,12,0,40,28
1656882514335,MATH 20B,A01,083756,Briones; Jor-el Thomas Caparas,1,0,36,35
1656882514335,MATH 20B,A02,083757,Briones; Jor-el Thomas Caparas,1,0,36,35
1656882514335,MATH 20B,A03,093475,Briones; Jor-el Thomas Caparas,0,0,36,36
1656882520368,MATH 20C,A01,083760,Briones; Jor-el Thomas Caparas,1,0,35,34
1656882520368,MATH 20C,A02,083761,Briones; Jor-el Thomas Caparas,8,0,35,27
1656882520368,MATH 20C,A03,093476,Briones; Jor-el Thomas Caparas,0,1,36,36
1656882520368,MATH 20C,B01,083762,Bach; Quang Tran,0,0,30,30
1656882526394,MATH 20D,A01,083765,Tran; Brian Kha,4,0,30,26
1656882526394,MATH 20D,A02,083766,Tran; Brian Kha,4,0,30,26
1656882526394,MATH 20D,A03,083767,Tran; Brian Kha,2,0,30,28
1656882532421,MATH 20E,A01,083771,Ganguly; Soumya,5,0,32,27
1656882532421,MATH 20E,A02,083772,Ganguly; Soumya,6,0,32,26
1656882532421,MATH 20E,B01,083773,Ciotti; Benjamin,18,0,35,17
1656882532421,MATH 20E,B02,083774,Ciotti; Benjamin,17,0,35,18
1656882538446,MATH 103A,A01,083777,Greenfeld; Be'Eri,2,0,36,34
1656882538446,MATH 103A,A02,083778,Greenfeld; Be'Eri,5,0,36,31
1656882538446,MATH 103A,A03,093561,Greenfeld; Be'Eri,4,0,36,32
1656882538446,MATH 103A,B01,083779,Greenfeld; Be'Eri,6,0,36,30
1656882538446,MATH 103A,B02,083780,Greenfeld; Be'Eri,2,0,36,34
1656882538446,MATH 103A,B03,093562,Greenfeld; Be'Eri,2,0,36,34
1656882544484,MATH 105,A01,085443,Carter; Anne Toulson,13,0,35,22
1656882544484,MATH 105,A02,093477,Carter; Anne Toulson,20,0,35,15
1656882550508,MATH 109,A01,083213,Ganzberger; Geoffrey Michael,2,0,34,32
1656882550508,MATH 109,A02,083214,Ganzberger; Geoffrey Michael,2,0,34,32
1656882550508,MATH 109,A03,093478,Ganzberger; Geoffrey Michael,1,0,34,33
1656882550508,MATH 109,B01,083215,Ganzberger; Geoffrey Michael,1,0,32,31
1656882550508,MATH 109,B02,083216,Ganzberger; Geoffrey Michael,1,0,32,31
1656882550508,MATH 109,B03,093479,Ganzberger; Geoffrey Michael,6,0,32,26
1656882556533,MATH 142A,A01,083219,Chow; Bennett,6,0,32,26
1656882556533,MATH 142A,A02,083220,Chow; Bennett,9,0,32,23
1656882556533,MATH 142A,A03,093480,Chow; Bennett,7,0,32,25
1656882556533,MATH 142A,B03,093481,Chow; Bennett,7,0,32,25
1656882556533,MATH 142A,B04,093558,Chow; Bennett,10,0,32,22
1656882556533,MATH 142A,B05,093559,Chow; Bennett,6,0,32,26
1656882562556,MATH 193A,A01,083224,Rotar; Vladimir,6,0,34,28
1656882562556,MATH 193A,A02,083225,Rotar; Vladimir,3,0,34,31
1656882562556,MATH 193A,A03,083781,Rotar; Vladimir,1,0,34,33
1656882562556,MATH 193A,A04,083782,Rotar; Vladimir,6,0,34,28
1656882562556,MATH 193A,A05,093482,Rotar; Vladimir,6,0,34,28
1656882568583,MATH 197,001,091859,McAuley; Julian John,9999,0,9999,0
1656882568583,MATH 197,002,095566,Kedlaya; Kiran S.,9997,0,9999,2
1656882568583,MATH 197,003,095567,Xiao; Ming,9999,0,9999,0
1656882568583,MATH 197,004,095571,Perols; Johan Lars,9998,0,9999,1
1656882575641,COGS 9,A01,083615,Shannon; Kyle Michael,6,0,75,69
1656882581664,COGS 11,A01,083617,Boyle; Mary E. T.,19,0,48,29
1656882587688,COGS 13,A01,083071,Bastos; Amalia Pinkusfeld,8,0,71,63
1656882593717,COGS 14A,A01,092681,Semenuks; Arturs,0,1,100,100
1656882599740,COGS 14B,A01,083073,Cheng; Tzu-Han,5,0,63,58
1656882605764,COGS 17,A01,092677,Semenuks; Arturs,4,0,81,77
1656882611791,COGS 100,A01,083619,Allen; Michael Gordon,15,0,70,55
1656882617822,COGS 101A,A01,083621,Davis; Joshua Daniel,9,0,68,59
1656882623849,COGS 101B,A01,091572,Allen; Michael Gordon,8,0,65,57
1656882629879,COGS 101C,A01,083625,Delgado; Tania,17,0,35,18
1656882635906,COGS 107A,A01,083627,Boyle; Mary E. T.,13,0,60,47
1656882641937,COGS 118A,A01,083075,Gupta; Anjum,15,0,76,61
1656882647961,CSE 3,A50,083646,Miranda; Gregory Joseph,22,0,50,28
1656882653983,CSE 8A,A50,083650,Miranda; Gregory Joseph,17,1,56,39
1656882660010,CSE 11,A01,083080,Cao; Yingjun,4,15,40,36
1656882666035,CSE 12,A01,083652,Krause-Levy; Sophia Louisa,20,1,120,100
1656882672059,CSE 15L,A01,083654,Morris; Justin Loren,8,0,50,42
1656882672059,CSE 15L,A02,083655,Morris; Justin Loren,8,0,50,42
1656882678094,CSE 20,A01,083657,Tran; Khoa Dang,37,0,80,43
1656882684119,CSE 21,A01,095574,Bach; Quang Tran,21,0,48,27
1656882690147,CSE 30,A01,083084,Eldon; John,4,0,80,76
1656882690147,CSE 30,B01,095061,Bhaskar; Nishant,6,0,50,44
1656882696169,CSE 100,A01,083659,Cao; Yingjun,2,4,70,68
1656882702191,CSE 134B,A01,083661,Powell; Thomas Allan,19,0,100,81
1656882708215,CSE 140,A01,083663,Gungor; Onat,14,0,85,71
1656882714237,CSE 140L,A01,083088,Eldon; John,16,0,100,84
1656882720265,CSE 175,A01,083665,Kumar; Rakesh,3,0,25,22
1656882726290,CSE 190,A00,092507,Dubnov; Shlomo,7,0,20,13
1656882732317,ECE 45,A01,083139,Congero; Spencer William,5,0,75,70
1656882738344,ECE 65,A50,083695,Saad; Andrew S,12,0,30,18
1656882738344,ECE 65,A51,095125,Saad; Andrew S,25,0,26,1
1656882744366,ECE 109,A01,091882,Touri; Behrouz,16,0,70,54
1656882750389,ECE 180,A00,083140,Abi Samra; Nicholas Camill,0,0,30,30
1656882750389,ECE 180,B00,083141,Abi Samra; Nicholas Camill,0,0,30,30
1656882756411,MATH 10A,A01,083735,Patchell; Gregory David,1,0,30,29
1656882756411,MATH 10A,A02,083736,Patchell; Gregory David,20,0,30,10
1656882756411,MATH 10A,A03,083737,Patchell; Gregory David,15,0,30,15
1656882762435,MATH 10B,A01,083207,Lim; Seonhee,7,0,34,27
1656882762435,MATH 10B,A02,083208,Lim; Seonhee,9,0,35,26
1656882762435,MATH 10B,A03,093472,Lim; Seonhee,4,0,34,30
1656882762435,MATH 10B,B01,083739,Sinha; Shubham,9,0,30,21
1656882768460,MATH 18,A01,083743,Cinel; Cameron Alexander,6,0,30,24
1656882768460,MATH 18,A02,083744,Cinel; Cameron Alexander,15,0,30,15
1656882768460,MATH 18,A03,083745,Cinel; Cameron Alexander,8,0,30,22
1656882768460,MATH 18,B01,083748,Rideout; David Porter,4,0,37,33
1656882768460,MATH 18,B02,083749,Rideout; David Porter,3,0,36,33
1656882768460,MATH 18,B03,083750,Rideout; David Porter,2,0,37,35
1656882768460,MATH 18,B04,083751,Rideout; David Porter,5,0,36,31
1656882768460,MATH 18,B05,093473,Rideout; David Porter,4,0,36,32
1656882768460,MATH 18,B06,093474,Rideout; David Porter,5,0,36,31
1656882774482,MATH 20A,A01,083754,Zheng; Zequn,12,0,40,28
1656882780509,MATH 20B,A01,083756,Briones; Jor-el Thomas Caparas,1,0,36,35
1656882780509,MATH 20B,A02,083757,Briones; Jor-el Thomas Caparas,1,0,36,35
1656882780509,MATH 20B,A03,093475,Briones; Jor-el Thomas Caparas,0,0,36,36
1656882786532,MATH 20C,A01,083760,Briones; Jor-el Thomas Caparas,1,0,35,34
1656882786532,MATH 20C,A02,083761,Briones; Jor-el Thomas Caparas,8,0,35,27
1656882786532,MATH 20C,A03,093476,Briones; Jor-el Thomas Caparas,0,1,36,36
1656882786532,MATH 20C,B01,083762,Bach; Quang Tran,0,0,30,30
1656882792559,MATH 20D,A01,083765,Tran; Brian Kha,4,0,30,26
1656882792559,MATH 20D,A02,083766,Tran; Brian Kha,4,0,30,26
1656882792559,MATH 20D,A03,083767,Tran; Brian Kha,2,0,30,28
1656882798588,MATH 20E,A01,083771,Ganguly; Soumya,5,0,32,27
1656882798588,MATH 20E,A02,083772,Ganguly; Soumya,6,0,32,26
1656882798588,MATH 20E,B01,083773,Ciotti; Benjamin,18,0,35,17
1656882798588,MATH 20E,B02,083774,Ciotti; Benjamin,17,0,35,18
1656882804613,MATH 103A,A01,083777,Greenfeld; Be'Eri,2,0,36,34
1656882804613,MATH 103A,A02,083778,Greenfeld; Be'Eri,5,0,36,31
1656882804613,MATH 103A,A03,093561,Greenfeld; Be'Eri,4,0,36,32
1656882804613,MATH 103A,B01,083779,Greenfeld; Be'Eri,6,0,36,30
1656882804613,MATH 103A,B02,083780,Greenfeld; Be'Eri,2,0,36,34
1656882804613,MATH 103A,B03,093562,Greenfeld; Be'Eri,2,0,36,34
1656882810641,MATH 105,A01,085443,Carter; Anne Toulson,13,0,35,22
1656882810641,MATH 105,A02,093477,Carter; Anne Toulson,20,0,35,15
1656882816664,MATH 109,A01,083213,Ganzberger; Geoffrey Michael,2,0,34,32
1656882816664,MATH 109,A02,083214,Ganzberger; Geoffrey Michael,2,0,34,32
1656882816664,MATH 109,A03,093478,Ganzberger; Geoffrey Michael,1,0,34,33
1656882816664,MATH 109,B01,083215,Ganzberger; Geoffrey Michael,1,0,32,31
1656882816664,MATH 109,B02,083216,Ganzberger; Geoffrey Michael,1,0,32,31
1656882816664,MATH 109,B03,093479,Ganzberger; Geoffrey Michael,6,0,32,26
1656882822696,MATH 142A,A01,083219,Chow; Bennett,6,0,32,26
1656882822696,MATH 142A,A02,083220,Chow; Bennett,9,0,32,23
1656882822696,MATH 142A,A03,093480,Chow; Bennett,7,0,32,25
1656882822696,MATH 142A,B03,093481,Chow; Bennett,7,0,32,25
1656882822696,MATH 142A,B04,093558,Chow; Bennett,10,0,32,22
1656882822696,MATH 142A,B05,093559,Chow; Bennett,6,0,32,26
1656882828719,MATH 193A,A01,083224,Rotar; Vladimir,6,0,34,28
1656882828719,MATH 193A,A02,083225,Rotar; Vladimir,3,0,34,31
1656882828719,MATH 193A,A03,083781,Rotar; Vladimir,1,0,34,33
1656882828719,MATH 193A,A04,083782,Rotar; Vladimir,6,0,34,28
1656882828719,MATH 193A,A05,093482,Rotar; Vladimir,6,0,34,28
1656882834742,MATH 197,001,091859,McAuley; Julian John,9999,0,9999,0
1656882834742,MATH 197,002,095566,Kedlaya; Kiran S.,9997,0,9999,2
1656882834742,MATH 197,003,095567,Xiao; Ming,9999,0,9999,0
1656882834742,MATH 197,004,095571,Perols; Johan Lars,9998,0,9999,1
1656882841811,COGS 9,A01,083615,Shannon; Kyle Michael,6,0,75,69
1656882847832,COGS 11,A01,083617,Boyle; Mary E. T.,19,0,48,29
1656882853859,COGS 13,A01,083071,Bastos; Amalia Pinkusfeld,8,0,71,63
1656882859882,COGS 14A,A01,092681,Semenuks; Arturs,0,1,100,100
1656882865906,COGS 14B,A01,083073,Cheng; Tzu-Han,5,0,63,58
1656882871938,COGS 17,A01,092677,Semenuks; Arturs,4,0,81,77
1656882877960,COGS 100,A01,083619,Allen; Michael Gordon,15,0,70,55
1656882883988,COGS 101A,A01,083621,Davis; Joshua Daniel,9,0,68,59
1656882890012,COGS 101B,A01,091572,Allen; Michael Gordon,8,0,65,57
1656882896036,COGS 101C,A01,083625,Delgado; Tania,17,0,35,18
1656882902058,COGS 107A,A01,083627,Boyle; Mary E. T.,13,0,60,47
1656882908084,COGS 118A,A01,083075,Gupta; Anjum,15,0,76,61
1656882914109,CSE 3,A50,083646,Miranda; Gregory Joseph,22,0,50,28
1656882920131,CSE 8A,A50,083650,Miranda; Gregory Joseph,17,1,56,39
1656882926156,CSE 11,A01,083080,Cao; Yingjun,4,15,40,36
1656882932179,CSE 12,A01,083652,Krause-Levy; Sophia Louisa,20,1,120,100
1656882938211,CSE 15L,A01,083654,Morris; Justin Loren,8,0,50,42
1656882938211,CSE 15L,A02,083655,Morris; Justin Loren,8,0,50,42
1656882944238,CSE 20,A01,083657,Tran; Khoa Dang,37,0,80,43
1656882950264,CSE 21,A01,095574,Bach; Quang Tran,21,0,48,27
1656882956291,CSE 30,A01,083084,Eldon; John,4,0,80,76
1656882956291,CSE 30,B01,095061,Bhaskar; Nishant,6,0,50,44
1656882962315,CSE 100,A01,083659,Cao; Yingjun,2,4,70,68
1656882968348,CSE 134B,A01,083661,Powell; Thomas Allan,19,0,100,81
1656882974372,CSE 140,A01,083663,Gungor; Onat,14,0,85,71
1656882980398,CSE 140L,A01,083088,Eldon; John,16,0,100,84
1656882986422,CSE 175,A01,083665,Kumar; Rakesh,3,0,25,22
1656882992446,CSE 190,A00,092507,Dubnov; Shlomo,7,0,20,13
1656882998548,ECE 45,A01,083139,Congero; Spencer William,5,0,75,70
1656883004575,ECE 65,A50,083695,Saad; Andrew S,12,0,30,18
1656883004575,ECE 65,A51,095125,Saad; Andrew S,25,0,26,1
1656883010597,ECE 109,A01,091882,Touri; Behrouz,16,0,70,54
1656883016632,ECE 180,A00,083140,Abi Samra; Nicholas Camill,0,0,30,30
1656883016632,ECE 180,B00,083141,Abi Samra; Nicholas Camill,0,0,30,30
1656883022655,MATH 10A,A01,083735,Patchell; Gregory David,1,0,30,29
1656883022655,MATH 10A,A02,083736,Patchell; Gregory David,20,0,30,10
1656883022655,MATH 10A,A03,083737,Patchell; Gregory David,15,0,30,15
1656883028679,MATH 10B,A01,083207,Lim; Seonhee,7,0,34,27
1656883028679,MATH 10B,A02,083208,Lim; Seonhee,9,0,35,26
1656883028679,MATH 10B,A03,093472,Lim; Seonhee,4,0,34,30
1656883028679,MATH 10B,B01,083739,Sinha; Shubham,9,0,30,21
1656883034710,MATH 18,A01,083743,Cinel; Cameron Alexander,6,0,30,24
1656883034710,MATH 18,A02,083744,Cinel; Cameron Alexander,15,0,30,15
1656883034710,MATH 18,A03,083745,Cinel; Cameron Alexander,8,0,30,22
1656883034710,MATH 18,B01,083748,Rideout; David Porter,4,0,37,33
1656883034710,MATH 18,B02,083749,Rideout; David Porter,3,0,36,33
1656883034710,MATH 18,B03,083750,Rideout; David Porter,2,0,37,35
1656883034710,MATH 18,B04,083751,Rideout; David Porter,5,0,36,31
1656883034710,MATH 18,B05,093473,Rideout; David Porter,4,0,36,32
1656883034710,MATH 18,B06,093474,Rideout; David Porter,5,0,36,31
1656883040732,MATH 20A,A01,083754,Zheng; Zequn,12,0,40,28
1656883046756,MATH 20B,A01,083756,Briones; Jor-el Thomas Caparas,1,0,36,35
1656883046756,MATH 20B,A02,083757,Briones; Jor-el Thomas Caparas,1,0,36,35
1656883046756,MATH 20B,A03,093475,Briones; Jor-el Thomas Caparas,0,0,36,36
1656883052780,MATH 20C,A01,083760,Briones; Jor-el Thomas Caparas,1,0,35,34
1656883052780,MATH 20C,A02,083761,Briones; Jor-el Thomas Caparas,8,0,35,27
1656883052780,MATH 20C,A03,093476,Briones; Jor-el Thomas Caparas,0,1,36,36
1656883052780,MATH 20C,B01,083762,Bach; Quang Tran,0,0,30,30
1656883058807,MATH 20D,A01,083765,Tran; Brian Kha,4,0,30,26
1656883058807,MATH 20D,A02,083766,Tran; Brian Kha,4,0,30,26
1656883058807,MATH 20D,A03,083767,Tran; Brian Kha,2,0,30,28
1656883064830,MATH 20E,A01,083771,Ganguly; Soumya,5,0,32,27
1656883064830,MATH 20E,A02,083772,Ganguly; Soumya,6,0,32,26
1656883064830,MATH 20E,B01,083773,Ciotti; Benjamin,18,0,35,17
1656883064830,MATH 20E,B02,083774,Ciotti; Benjamin,17,0,35,18
1656883070854,MATH 103A,A01,083777,Greenfeld; Be'Eri,2,0,36,34
1656883070854,MATH 103A,A02,083778,Greenfeld; Be'Eri,5,0,36,31
1656883070854,MATH 103A,A03,093561,Greenfeld; Be'Eri,4,0,36,32
1656883070854,MATH 103A,B01,083779,Greenfeld; Be'Eri,6,0,36,30
1656883070854,MATH 103A,B02,083780,Greenfeld; Be'Eri,2,0,36,34
1656883070854,MATH 103A,B03,093562,Greenfeld; Be'Eri,2,0,36,34
1656883076880,MATH 105,A01,085443,Carter; Anne Toulson,13,0,35,22
1656883076880,MATH 105,A02,093477,Carter; Anne Toulson,20,0,35,15
1656883082912,MATH 109,A01,083213,Ganzberger; Geoffrey Michael,2,0,34,32
1656883082912,MATH 109,A02,083214,Ganzberger; Geoffrey Michael,2,0,34,32
1656883082912,MATH 109,A03,093478,Ganzberger; Geoffrey Michael,1,0,34,33
1656883082912,MATH 109,B01,083215,Ganzberger; Geoffrey Michael,1,0,32,31
1656883082912,MATH 109,B02,083216,Ganzberger; Geoffrey Michael,1,0,32,31
1656883082912,MATH 109,B03,093479,Ganzberger; Geoffrey Michael,6,0,32,26
1656883088935,MATH 142A,A01,083219,Chow; Bennett,6,0,32,26
1656883088935,MATH 142A,A02,083220,Chow; Bennett,9,0,32,23
1656883088935,MATH 142A,A03,093480,Chow; Bennett,7,0,32,25
1656883088935,MATH 142A,B03,093481,Chow; Bennett,7,0,32,25
1656883088935,MATH 142A,B04,093558,Chow; Bennett,10,0,32,22
1656883088935,MATH 142A,B05,093559,Chow; Bennett,6,0,32,26
1656883094957,MATH 193A,A01,083224,Rotar; Vladimir,6,0,34,28
1656883094957,MATH 193A,A02,083225,Rotar; Vladimir,3,0,34,31
1656883094957,MATH 193A,A03,083781,Rotar; Vladimir,1,0,34,33
1656883094957,MATH 193A,A04,083782,Rotar; Vladimir,6,0,34,28
1656883094957,MATH 193A,A05,093482,Rotar; Vladimir,6,0,34,28
1656883100981,MATH 197,001,091859,McAuley; Julian John,9999,0,9999,0
1656883100981,MATH 197,002,095566,Kedlaya; Kiran S.,9997,0,9999,2
1656883100981,MATH 197,003,095567,Xiao; Ming,9999,0,9999,0
1656883100981,MATH 197,004,095571,Perols; Johan Lars,9998,0,9999,1
1656883108052,COGS 9,A01,083615,Shannon; Kyle Michael,6,0,75,69
1656883114078,COGS 11,A01,083617,Boyle; Mary E. T.,19,0,48,29
1656883120102,COGS 13,A01,083071,Bastos; Amalia Pinkusfeld,8,0,71,63
1656883126127,COGS 14A,A01,092681,Semenuks; Arturs,0,1,100,100
1656883132152,COGS 14B,A01,083073,Cheng; Tzu-Han,5,0,63,58
1656883138174,COGS 17,A01,092677,Semenuks; Arturs,4,0,81,77
1656883144199,COGS 100,A01,083619,Allen; Michael Gordon,15,0,70,55
1656883150230,COGS 101A,A01,083621,Davis; Joshua Daniel,9,0,68,59
1656883156256,COGS 101B,A01,091572,Allen; Michael Gordon,8,0,65,57
1656883162283,COGS 101C,A01,083625,Delgado; Tania,17,0,35,18
1656883168307,COGS 107A,A01,083627,Boyle; Mary E. T.,13,0,60,47
1656883174334,COGS 118A,A01,083075,Gupta; Anjum,15,0,76,61
1656883180357,CSE 3,A50,083646,Miranda; Gregory Joseph,22,0,50,28
1656883186380,CSE 8A,A50,083650,Miranda; Gregory Joseph,17,1,56,39
1656883192403,CSE 11,A01,083080,Cao; Yingjun,4,15,40,36
1656883198429,CSE 12,A01,083652,Krause-Levy; Sophia Louisa,20,1,120,100
1656883204453,CSE 15L,A01,083654,Morris; Justin Loren,8,0,50,42
1656883204453,CSE 15L,A02,083655,Morris; Justin Loren,8,0,50,42
1656883210476,CSE 20,A01,083657,Tran; Khoa Dang,37,0,80,43
1656883216498,CSE 21,A01,095574,Bach; Quang Tran,21,0,48,27
1656883222521,CSE 30,A01,083084,Eldon; John,4,0,80,76
1656883222521,CSE 30,B01,095061,Bhaskar; Nishant,6,0,50,44
1656883228544,CSE 100,A01,083659,Cao; Yingjun,2,4,70,68
1656883234568,CSE 134B,A01,083661,Powell; Thomas Allan,19,0,100,81
1656883240593,CSE 140,A01,083663,Gungor; Onat,14,0,85,71
1656883246615,CSE 140L,A01,083088,Eldon; John,16,0,100,84
1656883252638,CSE 175,A01,083665,Kumar; Rakesh,3,0,25,22
1656883258661,CSE 190,A00,092507,Dubnov; Shlomo,7,0,20,13
1656883264684,ECE 45,A01,083139,Congero; Spencer William,5,0,75,70
1656883270710,ECE 65,A50,083695,Saad; Andrew S,12,0,30,18
1656883270710,ECE 65,A51,095125,Saad; Andrew S,25,0,26,1
1656883276733,ECE 109,A01,091882,Touri; Behrouz,16,0,70,54
1656883282760,ECE 180,A00,083140,Abi Samra; Nicholas Camill,0,0,30,30
1656883282760,ECE 180,B00,083141,Abi Samra; Nicholas Camill,0,0,30,30
1656883288781,MATH 10A,A01,083735,Patchell; Gregory David,1,0,30,29
1656883288781,MATH 10A,A02,083736,Patchell; Gregory David,20,0,30,10
1656883288781,MATH 10A,A03,083737,Patchell; Gregory David,15,0,30,15
1656883294812,MATH 10B,A01,083207,Lim; Seonhee,7,0,34,27
1656883294812,MATH 10B,A02,083208,Lim; Seonhee,9,0,35,26
1656883294812,MATH 10B,A03,093472,Lim; Seonhee,4,0,34,30
1656883294812,MATH 10B,B01,083739,Sinha; Shubham,9,0,30,21
1656883300842,MATH 18,A01,083743,Cinel; Cameron Alexander,6,0,30,24
1656883300842,MATH 18,A02,083744,Cinel; Cameron Alexander,15,0,30,15
1656883300842,MATH 18,A03,083745,Cinel; Cameron Alexander,8,0,30,22
1656883300842,MATH 18,B01,083748,Rideout; David Porter,4,0,37,33
1656883300842,MATH 18,B02,083749,Rideout; David Porter,3,0,36,33
1656883300842,MATH 18,B03,083750,Rideout; David Porter,2,0,37,35
1656883300842,MATH 18,B04,083751,Rideout; David Porter,5,0,36,31
1656883300842,MATH 18,B05,093473,Rideout; David Porter,4,0,36,32
1656883300842,MATH 18,B06,093474,Rideout; David Porter,5,0,36,31
1656883306869,MATH 20A,A01,083754,Zheng; Zequn,12,0,40,28
1656883312905,MATH 20B,A01,083756,Briones; Jor-el Thomas Caparas,1,0,36,35
1656883312905,MATH 20B,A02,083757,Briones; Jor-el Thomas Caparas,1,0,36,35
1656883312905,MATH 20B,A03,093475,Briones; Jor-el Thomas Caparas,0,0,36,36
1656883318930,MATH 20C,A01,083760,Briones; Jor-el Thomas Caparas,1,0,35,34
1656883318930,MATH 20C,A02,083761,Briones; Jor-el Thomas Caparas,8,0,35,27
1656883318930,MATH 20C,A03,093476,Briones; Jor-el Thomas Caparas,0,1,36,36
1656883318930,MATH 20C,B01,083762,Bach; Quang Tran,0,0,30,30
1656883324958,MATH 20D,A01,083765,Tran; Brian Kha,4,0,30,26
1656883324958,MATH 20D,A02,083766,Tran; Brian Kha,4,0,30,26
1656883324958,MATH 20D,A03,083767,Tran; Brian Kha,2,0,30,28
1656883330981,MATH 20E,A01,083771,Ganguly; Soumya,5,0,32,27
1656883330981,MATH 20E,A02,083772,Ganguly; Soumya,6,0,32,26
1656883330981,MATH 20E,B01,083773,Ciotti; Benjamin,18,0,35,17
1656883330981,MATH 20E,B02,083774,Ciotti; Benjamin,17,0,35,18
1656883337006,MATH 103A,A01,083777,Greenfeld; Be'Eri,2,0,36,34
1656883337006,MATH 103A,A02,083778,Greenfeld; Be'Eri,5,0,36,31
1656883337006,MATH 103A,A03,093561,Greenfeld; Be'Eri,4,0,36,32
1656883337006,MATH 103A,B01,083779,Greenfeld; Be'Eri,6,0,36,30
1656883337006,MATH 103A,B02,083780,Greenfeld; Be'Eri,2,0,36,34
1656883337006,MATH 103A,B03,093562,Greenfeld; Be'Eri,2,0,36,34
1656883343035,MATH 105,A01,085443,Carter; Anne Toulson,13,0,35,22
1656883343035,MATH 105,A02,093477,Carter; Anne Toulson,20,0,35,15
1656883349059,MATH 109,A01,083213,Ganzberger; Geoffrey Michael,2,0,34,32
1656883349059,MATH 109,A02,083214,Ganzberger; Geoffrey Michael,2,0,34,32
1656883349059,MATH 109,A03,093478,Ganzberger; Geoffrey Michael,1,0,34,33
1656883349059,MATH 109,B01,083215,Ganzberger; Geoffrey Michael,1,0,32,31
1656883349059,MATH 109,B02,083216,Ganzberger; Geoffrey Michael,1,0,32,31
1656883349059,MATH 109,B03,093479,Ganzberger; Geoffrey Michael,6,0,32,26
1656883355086,MATH 142A,A01,083219,Chow; Bennett,6,0,32,26
1656883355086,MATH 142A,A02,083220,Chow; Bennett,9,0,32,23
1656883355086,MATH 142A,A03,093480,Chow; Bennett,7,0,32,25
1656883355086,MATH 142A,B03,093481,Chow; Bennett,7,0,32,25
1656883355086,MATH 142A,B04,093558,Chow; Bennett,10,0,32,22
1656883355086,MATH 142A,B05,093559,Chow; Bennett,6,0,32,26
1656883361114,MATH 193A,A01,083224,Rotar; Vladimir,6,0,34,28
1656883361114,MATH 193A,A02,083225,Rotar; Vladimir,3,0,34,31
1656883361114,MATH 193A,A03,083781,Rotar; Vladimir,1,0,34,33
1656883361114,MATH 193A,A04,083782,Rotar; Vladimir,6,0,34,28
1656883361114,MATH 193A,A05,093482,Rotar; Vladimir,6,0,34,28
1656883367139,MATH 197,001,091859,McAuley; Julian John,9999,0,9999,0
1656883367139,MATH 197,002,095566,Kedlaya; Kiran S.,9997,0,9999,2
1656883367139,MATH 197,003,095567,Xiao; Ming,9999,0,9999,0
1656883367139,MATH 197,004,095571,Perols; Johan Lars,9998,0,9999,1
1656883374190,COGS 9,A01,083615,Shannon; Kyle Michael,6,0,75,69
1656883380226,COGS 11,A01,083617,Boyle; Mary E. T.,19,0,48,29
1656883386249,COGS 13,A01,083071,Bastos; Amalia Pinkusfeld,8,0,71,63
1656883392273,COGS 14A,A01,092681,Semenuks; Arturs,0,1,100,100
1656883398295,COGS 14B,A01,083073,Cheng; Tzu-Han,5,0,63,58
1656883404319,COGS 17,A01,092677,Semenuks; Arturs,4,0,81,77
1656883410342,COGS 100,A01,083619,Allen; Michael Gordon,15,0,70,55
1656883416365,COGS 101A,A01,083621,Davis; Joshua Daniel,9,0,68,59
1656883422399,COGS 101B,A01,091572,Allen; Michael Gordon,8,0,65,57
1656883428422,COGS 101C,A01,083625,Delgado; Tania,17,0,35,18
1656883434443,COGS 107A,A01,083627,Boyle; Mary E. T.,13,0,60,47
1656883440469,COGS 118A,A01,083075,Gupta; Anjum,15,0,76,61
1656883446490,CSE 3,A50,083646,Miranda; Gregory Joseph,22,0,50,28
1656883452526,CSE 8A,A50,083650,Miranda; Gregory Joseph,17,1,56,39
1656883458550,CSE 11,A01,083080,Cao; Yingjun,4,15,40,36
1656883464577,CSE 12,A01,083652,Krause-Levy; Sophia Louisa,20,1,120,100
1656883470612,CSE 15L,A01,083654,Morris; Justin Loren,8,0,50,42
1656883470612,CSE 15L,A02,083655,Morris; Justin Loren,8,0,50,42
1656883476636,CSE 20,A01,083657,Tran; Khoa Dang,37,0,80,43
1656883482658,CSE 21,A01,095574,Bach; Quang Tran,21,0,48,27
1656883488686,CSE 30,A01,083084,Eldon; John,4,0,80,76
1656883488686,CSE 30,B01,095061,Bhaskar; Nishant,6,0,50,44
1656883494712,CSE 100,A01,083659,Cao; Yingjun,2,4,70,68
1656883500737,CSE 134B,A01,083661,Powell; Thomas Allan,19,0,100,81
1656883506760,CSE 140,A01,083663,Gungor; Onat,14,0,85,71
1656883512787,CSE 140L,A01,083088,Eldon; John,16,0,100,84
1656883518809,CSE 175,A01,083665,Kumar; Rakesh,3,0,25,22
1656883524833,CSE 190,A00,092507,Dubnov; Shlomo,7,0,20,13
1656883530860,ECE 45,A01,083139,Congero; Spencer William,5,0,75,70
1656883536888,ECE 65,A50,083695,Saad; Andrew S,12,0,30,18
1656883536888,ECE 65,A51,095125,Saad; Andrew S,25,0,26,1
1656883542917,ECE 109,A01,091882,Touri; Behrouz,16,0,70,54
1656883548943,ECE 180,A00,083140,Abi Samra; Nicholas Camill,0,0,30,30
1656883548943,ECE 180,B00,083141,Abi Samra; Nicholas Camill,0,0,30,30
1656883554968,MATH 10A,A01,083735,Patchell; Gregory David,1,0,30,29
1656883554968,MATH 10A,A02,083736,Patchell; Gregory David,20,0,30,10
1656883554968,MATH 10A,A03,083737,Patchell; Gregory David,15,0,30,15
1656883560999,MATH 10B,A01,083207,Lim; Seonhee,7,0,34,27
1656883560999,MATH 10B,A02,083208,Lim; Seonhee,9,0,35,26
1656883560999,MATH 10B,A03,093472,Lim; Seonhee,4,0,34,30
1656883560999,MATH 10B,B01,083739,Sinha; Shubham,9,0,30,21
1656883567023,MATH 18,A01,083743,Cinel; Cameron Alexander,6,0,30,24
1656883567023,MATH 18,A02,083744,Cinel; Cameron Alexander,15,0,30,15
1656883567023,MATH 18,A03,083745,Cinel; Cameron Alexander,8,0,30,22
1656883567023,MATH 18,B01,083748,Rideout; David Porter,4,0,37,33
1656883567023,MATH 18,B02,083749,Rideout; David Porter,3,0,36,33
1656883567023,MATH 18,B03,083750,Rideout; David Porter,2,0,37,35
1656883567023,MATH 18,B04,083751,Rideout; David Porter,5,0,36,31
1656883567023,MATH 18,B05,093473,Rideout; David Porter,4,0,36,32
1656883567023,MATH 18,B06,093474,Rideout; David Porter,5,0,36,31
1656883573049,MATH 20A,A01,083754,Zheng; Zequn,12,0,40,28
1656883579076,MATH 20B,A01,083756,Briones; Jor-el Thomas Caparas,1,0,36,35
1656883579076,MATH 20B,A02,083757,Briones; Jor-el Thomas Caparas,1,0,36,35
1656883579076,MATH 20B,A03,093475,Briones; Jor-el Thomas Caparas,0,0,36,36
1656883585104,MATH 20C,A01,083760,Briones; Jor-el Thomas Caparas,1,0,35,34
1656883585104,MATH 20C,A02,083761,Briones; Jor-el Thomas Caparas,8,0,35,27
1656883585104,MATH 20C,A03,093476,Briones; Jor-el Thomas Caparas,0,1,36,36
1656883585104,MATH 20C,B01,083762,Bach; Quang Tran,0,0,30,30
1656883591128,MATH 20D,A01,083765,Tran; Brian Kha,4,0,30,26
1656883591128,MATH 20D,A02,083766,Tran; Brian Kha,4,0,30,26
1656883591128,MATH 20D,A03,083767,Tran; Brian Kha,2,0,30,28
1656883597234,MATH 20E,A01,083771,Ganguly; Soumya,5,0,32,27
1656883597234,MATH 20E,A02,083772,Ganguly; Soumya,6,0,32,26
1656883597234,MATH 20E,B01,083773,Ciotti; Benjamin,18,0,35,17
1656883597234,MATH 20E,B02,083774,Ciotti; Benjamin,17,0,35,18
1656883603264,MATH 103A,A01,083777,Greenfeld; Be'Eri,2,0,36,34
1656883603264,MATH 103A,A02,083778,Greenfeld; Be'Eri,5,0,36,31
1656883603264,MATH 103A,A03,093561,Greenfeld; Be'Eri,4,0,36,32
1656883603264,MATH 103A,B01,083779,Greenfeld; Be'Eri,6,0,36,30
1656883603264,MATH 103A,B02,083780,Greenfeld; Be'Eri,2,0,36,34
1656883603264,MATH 103A,B03,093562,Greenfeld; Be'Eri,2,0,36,34
1656883609287,MATH 105,A01,085443,Carter; Anne Toulson,13,0,35,22
1656883609287,MATH 105,A02,093477,Carter; Anne Toulson,20,0,35,15
1656883615311,MATH 109,A01,083213,Ganzberger; Geoffrey Michael,2,0,34,32
1656883615311,MATH 109,A02,083214,Ganzberger; Geoffrey Michael,2,0,34,32
1656883615311,MATH 109,A03,093478,Ganzberger; Geoffrey Michael,1,0,34,33
1656883615311,MATH 109,B01,083215,Ganzberger; Geoffrey Michael,1,0,32,31
1656883615311,MATH 109,B02,083216,Ganzberger; Geoffrey Michael,1,0,32,31
1656883615311,MATH 109,B03,093479,Ganzberger; Geoffrey Michael,6,0,32,26
1656883621336,MATH 142A,A01,083219,Chow; Bennett,6,0,32,26
1656883621336,MATH 142A,A02,083220,Chow; Bennett,9,0,32,23
1656883621336,MATH 142A,A03,093480,Chow; Bennett,7,0,32,25
1656883621336,MATH 142A,B03,093481,Chow; Bennett,7,0,32,25
1656883621336,MATH 142A,B04,093558,Chow; Bennett,10,0,32,22
1656883621336,MATH 142A,B05,093559,Chow; Bennett,6,0,32,26
1656883627361,MATH 193A,A01,083224,Rotar; Vladimir,6,0,34,28
1656883627361,MATH 193A,A02,083225,Rotar; Vladimir,3,0,34,31
1656883627361,MATH 193A,A03,083781,Rotar; Vladimir,1,0,34,33
1656883627361,MATH 193A,A04,083782,Rotar; Vladimir,6,0,34,28
1656883627361,MATH 193A,A05,093482,Rotar; Vladimir,6,0,34,28
1656883633383,MATH 197,001,091859,McAuley; Julian John,9999,0,9999,0
1656883633383,MATH 197,002,095566,Kedlaya; Kiran S.,9997,0,9999,2
1656883633383,MATH 197,003,095567,Xiao; Ming,9999,0,9999,0
1656883633383,MATH 197,004,095571,Perols; Johan Lars,9998,0,9999,1
1656883640435,COGS 9,A01,083615,Shannon; Kyle Michael,6,0,75,69
1656883646459,COGS 11,A01,083617,Boyle; Mary E. T.,19,0,48,29
1656883652483,COGS 13,A01,083071,Bastos; Amalia Pinkusfeld,8,0,71,63
1656883658508,COGS 14A,A01,092681,Semenuks; Arturs,0,1,100,100
1656883664535,COGS 14B,A01,083073,Cheng; Tzu-Han,5,0,63,58
1656883670558,COGS 17,A01,092677,Semenuks; Arturs,4,0,81,77
1656883676590,COGS 100,A01,083619,Allen; Michael Gordon,15,0,70,55
1656883682620,COGS 101A,A01,083621,Davis; Joshua Daniel,9,0,68,59
1656883688642,COGS 101B,A01,091572,Allen; Michael Gordon,8,0,65,57
1656883694666,COGS 101C,A01,083625,Delgado; Tania,17,0,35,18
1656883700690,COGS 107A,A01,083627,Boyle; Mary E. T.,13,0,60,47
1656883706711,COGS 118A,A01,083075,Gupta; Anjum,15,0,76,61
1656883712755,CSE 3,A50,083646,Miranda; Gregory Joseph,22,0,50,28
1656883718779,CSE 8A,A50,083650,Miranda; Gregory Joseph,17,1,56,39
1656883724814,CSE 11,A01,083080,Cao; Yingjun,4,15,40,36
1656883730836,CSE 12,A01,083652,Krause-Levy; Sophia Louisa,20,1,120,100
1656883736863,CSE 15L,A01,083654,Morris; Justin Loren,8,0,50,42
1656883736863,CSE 15L,A02,083655,Morris; Justin Loren,8,0,50,42
1656883742886,CSE 20,A01,083657,Tran; Khoa Dang,37,0,80,43
1656883748909,CSE 21,A01,095574,Bach; Quang Tran,21,0,48,27
1656883754936,CSE 30,A01,083084,Eldon; John,4,0,80,76
1656883754936,CSE 30,B01,095061,Bhaskar; Nishant,6,0,50,44
1656883760963,CSE 100,A01,083659,Cao; Yingjun,2,4,70,68
1656883766986,CSE 134B,A01,083661,Powell; Thomas Allan,19,0,100,81
1656883773009,CSE 140,A01,083663,Gungor; Onat,14,0,85,71
1656883779036,CSE 140L,A01,083088,Eldon; John,16,0,100,84
1656883785060,CSE 175,A01,083665,Kumar; Rakesh,3,0,25,22
1656883791091,CSE 190,A00,092507,Dubnov; Shlomo,7,0,20,13
1656883797122,ECE 45,A01,083139,Congero; Spencer William,5,0,75,70
1656883803156,ECE 65,A50,083695,Saad; Andrew S,12,0,30,18
1656883803156,ECE 65,A51,095125,Saad; Andrew S,25,0,26,1
1656883809184,ECE 109,A01,091882,Touri; Behrouz,16,0,70,54
1656883815215,ECE 180,A00,083140,Abi Samra; Nicholas Camill,0,0,30,30
1656883815215,ECE 180,B00,083141,Abi Samra; Nicholas Camill,0,0,30,30
1656883821242,MATH 10A,A01,083735,Patchell; Gregory David,1,0,30,29
1656883821242,MATH 10A,A02,083736,Patchell; Gregory David,20,0,30,10
1656883821242,MATH 10A,A03,083737,Patchell; Gregory David,15,0,30,15
1656883827266,MATH 10B,A01,083207,Lim; Seonhee,7,0,34,27
1656883827266,MATH 10B,A02,083208,Lim; Seonhee,9,0,35,26
1656883827266,MATH 10B,A03,093472,Lim; Seonhee,4,0,34,30
1656883827266,MATH 10B,B01,083739,Sinha; Shubham,9,0,30,21
1656883833299,MATH 18,A01,083743,Cinel; Cameron Alexander,6,0,30,24
1656883833299,MATH 18,A02,083744,Cinel; Cameron Alexander,15,0,30,15
1656883833299,MATH 18,A03,083745,Cinel; Cameron Alexander,8,0,30,22
1656883833299,MATH 18,B01,083748,Rideout; David Porter,4,0,37,33
1656883833299,MATH 18,B02,083749,Rideout; David Porter,3,0,36,33
1656883833299,MATH 18,B03,083750,Rideout; David Porter,2,0,37,35
1656883833299,MATH 18,B04,083751,Rideout; David Porter,5,0,36,31
1656883833299,MATH 18,B05,093473,Rideout; David Porter,4,0,36,32
1656883833299,MATH 18,B06,093474,Rideout; David Porter,5,0,36,31
1656883839332,MATH 20A,A01,083754,Zheng; Zequn,12,0,40,28
1656883845360,MATH 20B,A01,083756,Briones; Jor-el Thomas Caparas,1,0,36,35
1656883845360,MATH 20B,A02,083757,Briones; Jor-el Thomas Caparas,1,0,36,35
1656883845360,MATH 20B,A03,093475,Briones; Jor-el Thomas Caparas,0,0,36,36
1656883851390,MATH 20C,A01,083760,Briones; Jor-el Thomas Caparas,1,0,35,34
1656883851390,MATH 20C,A02,083761,Briones; Jor-el Thomas Caparas,8,0,35,27
1656883851390,MATH 20C,A03,093476,Briones; Jor-el Thomas Caparas,0,1,36,36
1656883851390,MATH 20C,B01,083762,Bach; Quang Tran,0,0,30,30
1656883857423,MATH 20D,A01,083765,Tran; Brian Kha,4,0,30,26
1656883857423,MATH 20D,A02,083766,Tran; Brian Kha,4,0,30,26
1656883857423,MATH 20D,A03,083767,Tran; Brian Kha,2,0,30,28
1656883863460,MATH 20E,A01,083771,Ganguly; Soumya,5,0,32,27
1656883863460,MATH 20E,A02,083772,Ganguly; Soumya,6,0,32,26
1656883863460,MATH 20E,B01,083773,Ciotti; Benjamin,18,0,35,17
1656883863460,MATH 20E,B02,083774,Ciotti; Benjamin,17,0,35,18
1656883869499,MATH 103A,A01,083777,Greenfeld; Be'Eri,2,0,36,34
1656883869499,MATH 103A,A02,083778,Greenfeld; Be'Eri,5,0,36,31
1656883869499,MATH 103A,A03,093561,Greenfeld; Be'Eri,4,0,36,32
1656883869499,MATH 103A,B01,083779,Greenfeld; Be'Eri,6,0,36,30
1656883869499,MATH 103A,B02,083780,Greenfeld; Be'Eri,2,0,36,34
1656883869499,MATH 103A,B03,093562,Greenfeld; Be'Eri,2,0,36,34
1656883875523,MATH 105,A01,085443,Carter; Anne Toulson,13,0,35,22
1656883875523,MATH 105,A02,093477,Carter; Anne Toulson,20,0,35,15
1656883881545,MATH 109,A01,083213,Ganzberger; Geoffrey Michael,2,0,34,32
1656883881545,MATH 109,A02,083214,Ganzberger; Geoffrey Michael,2,0,34,32
1656883881545,MATH 109,A03,093478,Ganzberger; Geoffrey Michael,1,0,34,33
1656883881545,MATH 109,B01,083215,Ganzberger; Geoffrey Michael,1,0,32,31
1656883881545,MATH 109,B02,083216,Ganzberger; Geoffrey Michael,1,0,32,31
1656883881545,MATH 109,B03,093479,Ganzberger; Geoffrey Michael,6,0,32,26
1656883887575,MATH 142A,A01,083219,Chow; Bennett,6,0,32,26
1656883887575,MATH 142A,A02,083220,Chow; Bennett,9,0,32,23
1656883887575,MATH 142A,A03,093480,Chow; Bennett,7,0,32,25
1656883887575,MATH 142A,B03,093481,Chow; Bennett,7,0,32,25
1656883887575,MATH 142A,B04,093558,Chow; Bennett,10,0,32,22
1656883887575,MATH 142A,B05,093559,Chow; Bennett,6,0,32,26
1656883893600,MATH 193A,A01,083224,Rotar; Vladimir,6,0,34,28
1656883893600,MATH 193A,A02,083225,Rotar; Vladimir,3,0,34,31
1656883893600,MATH 193A,A03,083781,Rotar; Vladimir,1,0,34,33
1656883893600,MATH 193A,A04,083782,Rotar; Vladimir,6,0,34,28
1656883893600,MATH 193A,A05,093482,Rotar; Vladimir,6,0,34,28
1656883899623,MATH 197,001,091859,McAuley; Julian John,9999,0,9999,0
1656883899623,MATH 197,002,095566,Kedlaya; Kiran S.,9997,0,9999,2
1656883899623,MATH 197,003,095567,Xiao; Ming,9999,0,9999,0
1656883899623,MATH 197,004,095571,Perols; Johan Lars,9998,0,9999,1
1656883906679,COGS 9,A01,083615,Shannon; Kyle Michael,6,0,75,69
1656883912700,COGS 11,A01,083617,Boyle; Mary E. T.,19,0,48,29
1656883918728,COGS 13,A01,083071,Bastos; Amalia Pinkusfeld,8,0,71,63
1656883924759,COGS 14A,A01,092681,Semenuks; Arturs,0,1,100,100
1656883930781,COGS 14B,A01,083073,Cheng; Tzu-Han,5,0,63,58
1656883936803,COGS 17,A01,092677,Semenuks; Arturs,4,0,81,77
1656883942833,COGS 100,A01,083619,Allen; Michael Gordon,15,0,70,55
1656883948860,COGS 101A,A01,083621,Davis; Joshua Daniel,9,0,68,59
1656883954884,COGS 101B,A01,091572,Allen; Michael Gordon,8,0,65,57
1656883960907,COGS 101C,A01,083625,Delgado; Tania,17,0,35,18
1656883966930,COGS 107A,A01,083627,Boyle; Mary E. T.,13,0,60,47
1656883972953,COGS 118A,A01,083075,Gupta; Anjum,15,0,76,61
1656883978980,CSE 3,A50,083646,Miranda; Gregory Joseph,22,0,50,28
1656883985004,CSE 8A,A50,083650,Miranda; Gregory Joseph,17,1,56,39
1656883991031,CSE 11,A01,083080,Cao; Yingjun,4,15,40,36
1656883997058,CSE 12,A01,083652,Krause-Levy; Sophia Louisa,20,1,120,100
1656884003083,CSE 15L,A01,083654,Morris; Justin Loren,8,0,50,42
1656884003083,CSE 15L,A02,083655,Morris; Justin Loren,8,0,50,42
1656884009107,CSE 20,A01,083657,Tran; Khoa Dang,37,0,80,43
1656884015135,CSE 21,A01,095574,Bach; Quang Tran,21,0,48,27
1656884021157,CSE 30,A01,083084,Eldon; John,4,0,80,76
1656884021157,CSE 30,B01,095061,Bhaskar; Nishant,6,0,50,44
1656884027191,CSE 100,A01,083659,Cao; Yingjun,2,4,70,68
1656884033217,CSE 134B,A01,083661,Powell; Thomas Allan,19,0,100,81
1656884039240,CSE 140,A01,083663,Gungor; Onat,14,0,85,71
1656884045263,CSE 140L,A01,083088,Eldon; John,16,0,100,84
1656884051287,CSE 175,A01,083665,Kumar; Rakesh,3,0,25,22
1656884057310,CSE 190,A00,092507,Dubnov; Shlomo,7,0,20,13
1656884063337,ECE 45,A01,083139,Congero; Spencer William,5,0,75,70
1656884069360,ECE 65,A50,083695,Saad; Andrew S,12,0,30,18
1656884069360,ECE 65,A51,095125,Saad; Andrew S,25,0,26,1
1656884075387,ECE 109,A01,091882,Touri; Behrouz,16,0,70,54
1656884081415,ECE 180,A00,083140,Abi Samra; Nicholas Camill,0,0,30,30
1656884081415,ECE 180,B00,083141,Abi Samra; Nicholas Camill,0,0,30,30
1656884087446,MATH 10A,A01,083735,Patchell; Gregory David,1,0,30,29
1656884087446,MATH 10A,A02,083736,Patchell; Gregory David,20,0,30,10
1656884087446,MATH 10A,A03,083737,Patchell; Gregory David,15,0,30,15
1656884093471,MATH 10B,A01,083207,Lim; Seonhee,7,0,34,27
1656884093471,MATH 10B,A02,083208,Lim; Seonhee,9,0,35,26
1656884093471,MATH 10B,A03,093472,Lim; Seonhee,4,0,34,30
1656884093471,MATH 10B,B01,083739,Sinha; Shubham,9,0,30,21
1656884099497,MATH 18,A01,083743,Cinel; Cameron Alexander,6,0,30,24
1656884099497,MATH 18,A02,083744,Cinel; Cameron Alexander,15,0,30,15
1656884099497,MATH 18,A03,083745,Cinel; Cameron Alexander,8,0,30,22
1656884099497,MATH 18,B01,083748,Rideout; David Porter,4,0,37,33
1656884099497,MATH 18,B02,083749,Rideout; David Porter,3,0,36,33
1656884099497,MATH 18,B03,083750,Rideout; David Porter,2,0,37,35
1656884099497,MATH 18,B04,083751,Rideout; David Porter,5,0,36,31
1656884099497,MATH 18,B05,093473,Rideout; David Porter,4,0,36,32
1656884099497,MATH 18,B06,093474,Rideout; David Porter,5,0,36,31
1656884105522,MATH 20A,A01,083754,Zheng; Zequn,12,0,40,28
1656884111546,MATH 20B,A01,083756,Briones; Jor-el Thomas Caparas,1,0,36,35
1656884111546,MATH 20B,A02,083757,Briones; Jor-el Thomas Caparas,1,0,36,35
1656884111546,MATH 20B,A03,093475,Briones; Jor-el Thomas Caparas,0,0,36,36
1656884117571,MATH 20C,A01,083760,Briones; Jor-el Thomas Caparas,1,0,35,34
1656884117571,MATH 20C,A02,083761,Briones; Jor-el Thomas Caparas,8,0,35,27
1656884117571,MATH 20C,A03,093476,Briones; Jor-el Thomas Caparas,0,1,36,36
1656884117571,MATH 20C,B01,083762,Bach; Quang Tran,0,0,30,30
1656884123596,MATH 20D,A01,083765,Tran; Brian Kha,4,0,30,26
1656884123596,MATH 20D,A02,083766,Tran; Brian Kha,4,0,30,26
1656884123596,MATH 20D,A03,083767,Tran; Brian Kha,2,0,30,28
1656884129620,MATH 20E,A01,083771,Ganguly; Soumya,5,0,32,27
1656884129620,MATH 20E,A02,083772,Ganguly; Soumya,6,0,32,26
1656884129620,MATH 20E,B01,083773,Ciotti; Benjamin,18,0,35,17
1656884129620,MATH 20E,B02,083774,Ciotti; Benjamin,17,0,35,18
1656884135645,MATH 103A,A01,083777,Greenfeld; Be'Eri,2,0,36,34
1656884135645,MATH 103A,A02,083778,Greenfeld; Be'Eri,5,0,36,31
1656884135645,MATH 103A,A03,093561,Greenfeld; Be'Eri,4,0,36,32
1656884135645,MATH 103A,B01,083779,Greenfeld; Be'Eri,6,0,36,30
1656884135645,MATH 103A,B02,083780,Greenfeld; Be'Eri,2,0,36,34
1656884135645,MATH 103A,B03,093562,Greenfeld; Be'Eri,2,0,36,34
1656884141671,MATH 105,A01,085443,Carter; Anne Toulson,13,0,35,22
1656884141671,MATH 105,A02,093477,Carter; Anne Toulson,20,0,35,15
1656884147694,MATH 109,A01,083213,Ganzberger; Geoffrey Michael,2,0,34,32
1656884147694,MATH 109,A02,083214,Ganzberger; Geoffrey Michael,2,0,34,32
1656884147694,MATH 109,A03,093478,Ganzberger; Geoffrey Michael,1,0,34,33
1656884147694,MATH 109,B01,083215,Ganzberger; Geoffrey Michael,1,0,32,31
1656884147694,MATH 109,B02,083216,Ganzberger; Geoffrey Michael,1,0,32,31
1656884147694,MATH 109,B03,093479,Ganzberger; Geoffrey Michael,6,0,32,26
1656884153723,MATH 142A,A01,083219,Chow; Bennett,6,0,32,26
1656884153723,MATH 142A,A02,083220,Chow; Bennett,9,0,32,23
1656884153723,MATH 142A,A03,093480,Chow; Bennett,7,0,32,25
1656884153723,MATH 142A,B03,093481,Chow; Bennett,7,0,32,25
1656884153723,MATH 142A,B04,093558,Chow; Bennett,10,0,32,22
1656884153723,MATH 142A,B05,093559,Chow; Bennett,6,0,32,26
1656884159757,MATH 193A,A01,083224,Rotar; Vladimir,6,0,34,28
1656884159757,MATH 193A,A02,083225,Rotar; Vladimir,3,0,34,31
1656884159757,MATH 193A,A03,083781,Rotar; Vladimir,1,0,34,33
1656884159757,MATH 193A,A04,083782,Rotar; Vladimir,6,0,34,28
1656884159757,MATH 193A,A05,093482,Rotar; Vladimir,6,0,34,28
1656884165781,MATH 197,001,091859,McAuley; Julian John,9999,0,9999,0
1656884165781,MATH 197,002,095566,Kedlaya; Kiran S.,9997,0,9999,2
1656884165781,MATH 197,003,095567,Xiao; Ming,9999,0,9999,0
1656884165781,MATH 197,004,095571,Perols; Johan Lars,9998,0,9999,1
1656884172843,COGS 9,A01,083615,Shannon; Kyle Michael,6,0,75,69
1656884178872,COGS 11,A01,083617,Boyle; Mary E. T.,19,0,48,29
1656884184895,COGS 13,A01,083071,Bastos; Amalia Pinkusfeld,8,0,71,63
1656884191005,COGS 14A,A01,092681,Semenuks; Arturs,0,1,100,100
1656884197029,COGS 14B,A01,083073,Cheng; Tzu-Han,5,0,63,58
1656884203052,COGS 17,A01,092677,Semenuks; Arturs,4,0,81,77
1656884209076,COGS 100,A01,083619,Allen; Michael Gordon,15,0,70,55
1656884215098,COGS 101A,A01,083621,Davis; Joshua Daniel,9,0,68,59
1656884221120,COGS 101B,A01,091572,Allen; Michael Gordon,8,0,65,57
1656884227143,COGS 101C,A01,083625,Delgado; Tania,17,0,35,18
1656884233166,COGS 107A,A01,083627,Boyle; Mary E. T.,13,0,60,47
1656884239193,COGS 118A,A01,083075,Gupta; Anjum,15,0,76,61
1656884245221,CSE 3,A50,083646,Miranda; Gregory Joseph,22,0,50,28
1656884251246,CSE 8A,A50,083650,Miranda; Gregory Joseph,17,1,56,39
1656884257273,CSE 11,A01,083080,Cao; Yingjun,4,15,40,36
1656884263295,CSE 12,A01,083652,Krause-Levy; Sophia Louisa,20,1,120,100
1656884269322,CSE 15L,A01,083654,Morris; Justin Loren,8,0,50,42
1656884269322,CSE 15L,A02,083655,Morris; Justin Loren,8,0,50,42
1656884275346,CSE 20,A01,083657,Tran; Khoa Dang,37,0,80,43
1656884281372,CSE 21,A01,095574,Bach; Quang Tran,21,0,48,27
1656884287399,CSE 30,A01,083084,Eldon; John,4,0,80,76
1656884287399,CSE 30,B01,095061,Bhaskar; Nishant,6,0,50,44
1656884293422,CSE 100,A01,083659,Cao; Yingjun,2,4,70,68
1656884299444,CSE 134B,A01,083661,Powell; Thomas Allan,19,0,100,81
1656884305469,CSE 140,A01,083663,Gungor; Onat,14,0,85,71
1656884311495,CSE 140L,A01,083088,Eldon; John,16,0,100,84
1656884317517,CSE 175,A01,083665,Kumar; Rakesh,3,0,25,22
1656884323541,CSE 190,A00,092507,Dubnov; Shlomo,7,0,20,13
1656884329566,ECE 45,A01,083139,Congero; Spencer William,5,0,75,70
1656884335592,ECE 65,A50,083695,Saad; Andrew S,12,0,30,18
1656884335592,ECE 65,A51,095125,Saad; Andrew S,25,0,26,1
1656884341615,ECE 109,A01,091882,Touri; Behrouz,16,0,70,54
1656884347664,ECE 180,A00,083140,Abi Samra; Nicholas Camill,0,0,30,30
1656884347664,ECE 180,B00,083141,Abi Samra; Nicholas Camill,0,0,30,30
1656884353688,MATH 10A,A01,083735,Patchell; Gregory David,1,0,30,29
1656884353688,MATH 10A,A02,083736,Patchell; Gregory David,20,0,30,10
1656884353688,MATH 10A,A03,083737,Patchell; Gregory David,15,0,30,15
1656884359713,MATH 10B,A01,083207,Lim; Seonhee,7,0,34,27
1656884359713,MATH 10B,A02,083208,Lim; Seonhee,9,0,35,26
1656884359713,MATH 10B,A03,093472,Lim; Seonhee,4,0,34,30
1656884359713,MATH 10B,B01,083739,Sinha; Shubham,9,0,30,21
1656884365736,MATH 18,A01,083743,Cinel; Cameron Alexander,6,0,30,24
1656884365736,MATH 18,A02,083744,Cinel; Cameron Alexander,15,0,30,15
1656884365736,MATH 18,A03,083745,Cinel; Cameron Alexander,8,0,30,22
1656884365736,MATH 18,B01,083748,Rideout; David Porter,4,0,37,33
1656884365736,MATH 18,B02,083749,Rideout; David Porter,3,0,36,33
1656884365736,MATH 18,B03,083750,Rideout; David Porter,2,0,37,35
1656884365736,MATH 18,B04,083751,Rideout; David Porter,5,0,36,31
1656884365736,MATH 18,B05,093473,Rideout; David Porter,4,0,36,32
1656884365736,MATH 18,B06,093474,Rideout; David Porter,5,0,36,31
1656884371759,MATH 20A,A01,083754,Zheng; Zequn,12,0,40,28
1656884377785,MATH 20B,A01,083756,Briones; Jor-el Thomas Caparas,1,0,36,35
1656884377785,MATH 20B,A02,083757,Briones; Jor-el Thomas Caparas,1,0,36,35
1656884377785,MATH 20B,A03,093475,Briones; Jor-el Thomas Caparas,0,0,36,36
1656884383808,MATH 20C,A01,083760,Briones; Jor-el Thomas Caparas,1,0,35,34
1656884383808,MATH 20C,A02,083761,Briones; Jor-el Thomas Caparas,8,0,35,27
1656884383808,MATH 20C,A03,093476,Briones; Jor-el Thomas Caparas,0,1,36,36
1656884383808,MATH 20C,B01,083762,Bach; Quang Tran,0,0,30,30
1656884389829,MATH 20D,A01,083765,Tran; Brian Kha,4,0,30,26
1656884389829,MATH 20D,A02,083766,Tran; Brian Kha,4,0,30,26
1656884389829,MATH 20D,A03,083767,Tran; Brian Kha,2,0,30,28
1656884395855,MATH 20E,A01,083771,Ganguly; Soumya,5,0,32,27
1656884395855,MATH 20E,A02,083772,Ganguly; Soumya,6,0,32,26
1656884395855,MATH 20E,B01,083773,Ciotti; Benjamin,18,0,35,17
1656884395855,MATH 20E,B02,083774,Ciotti; Benjamin,17,0,35,18
1656884401878,MATH 103A,A01,083777,Greenfeld; Be'Eri,2,0,36,34
1656884401878,MATH 103A,A02,083778,Greenfeld; Be'Eri,5,0,36,31
1656884401878,MATH 103A,A03,093561,Greenfeld; Be'Eri,4,0,36,32
1656884401878,MATH 103A,B01,083779,Greenfeld; Be'Eri,6,0,36,30
1656884401878,MATH 103A,B02,083780,Greenfeld; Be'Eri,2,0,36,34
1656884401878,MATH 103A,B03,093562,Greenfeld; Be'Eri,2,0,36,34
1656884407900,MATH 105,A01,085443,Carter; Anne Toulson,13,0,35,22
1656884407900,MATH 105,A02,093477,Carter; Anne Toulson,20,0,35,15
1656884413925,MATH 109,A01,083213,Ganzberger; Geoffrey Michael,2,0,34,32
1656884413925,MATH 109,A02,083214,Ganzberger; Geoffrey Michael,2,0,34,32
1656884413925,MATH 109,A03,093478,Ganzberger; Geoffrey Michael,1,0,34,33
1656884413925,MATH 109,B01,083215,Ganzberger; Geoffrey Michael,1,0,32,31
1656884413925,MATH 109,B02,083216,Ganzberger; Geoffrey Michael,1,0,32,31
1656884413925,MATH 109,B03,093479,Ganzberger; Geoffrey Michael,6,0,32,26
1656884419952,MATH 142A,A01,083219,Chow; Bennett,6,0,32,26
1656884419952,MATH 142A,A02,083220,Chow; Bennett,9,0,32,23
1656884419952,MATH 142A,A03,093480,Chow; Bennett,7,0,32,25
1656884419952,MATH 142A,B03,093481,Chow; Bennett,7,0,32,25
1656884419952,MATH 142A,B04,093558,Chow; Bennett,10,0,32,22
1656884419952,MATH 142A,B05,093559,Chow; Bennett,6,0,32,26
1656884425978,MATH 193A,A01,083224,Rotar; Vladimir,6,0,34,28
1656884425978,MATH 193A,A02,083225,Rotar; Vladimir,3,0,34,31
1656884425978,MATH 193A,A03,083781,Rotar; Vladimir,1,0,34,33
1656884425978,MATH 193A,A04,083782,Rotar; Vladimir,6,0,34,28
1656884425978,MATH 193A,A05,093482,Rotar; Vladimir,6,0,34,28
1656884432002,MATH 197,001,091859,McAuley; Julian John,9999,0,9999,0
1656884432002,MATH 197,002,095566,Kedlaya; Kiran S.,9997,0,9999,2
1656884432002,MATH 197,003,095567,Xiao; Ming,9999,0,9999,0
1656884432002,MATH 197,004,095571,Perols; Johan Lars,9998,0,9999,1
1656884439072,COGS 9,A01,083615,Shannon; Kyle Michael,6,0,75,69
1656884445099,COGS 11,A01,083617,Boyle; Mary E. T.,19,0,48,29
1656884451125,COGS 13,A01,083071,Bastos; Amalia Pinkusfeld,8,0,71,63
1656884457146,COGS 14A,A01,092681,Semenuks; Arturs,0,1,100,100
1656884463169,COGS 14B,A01,083073,Cheng; Tzu-Han,5,0,63,58
1656884469193,COGS 17,A01,092677,Semenuks; Arturs,4,0,81,77
1656884475217,COGS 100,A01,083619,Allen; Michael Gordon,15,0,70,55
1656884481241,COGS 101A,A01,083621,Davis; Joshua Daniel,9,0,68,59
1656884487274,COGS 101B,A01,091572,Allen; Michael Gordon,8,0,65,57
1656884493302,COGS 101C,A01,083625,Delgado; Tania,17,0,35,18
1656884499325,COGS 107A,A01,083627,Boyle; Mary E. T.,13,0,60,47
1656884505354,COGS 118A,A01,083075,Gupta; Anjum,15,0,76,61
1656884511383,CSE 3,A50,083646,Miranda; Gregory Joseph,22,0,50,28
1656884517410,CSE 8A,A50,083650,Miranda; Gregory Joseph,17,1,56,39
1656884523442,CSE 11,A01,083080,Cao; Yingjun,4,15,40,36
1656884529466,CSE 12,A01,083652,Krause-Levy; Sophia Louisa,20,1,120,100
1656884535490,CSE 15L,A01,083654,Morris; Justin Loren,8,0,50,42
1656884535490,CSE 15L,A02,083655,Morris; Justin Loren,8,0,50,42
1656884541522,CSE 20,A01,083657,Tran; Khoa Dang,37,0,80,43
1656884547548,CSE 21,A01,095574,Bach; Quang Tran,21,0,48,27
1656884553572,CSE 30,A01,083084,Eldon; John,4,0,80,76
1656884553572,CSE 30,B01,095061,Bhaskar; Nishant,6,0,50,44
1656884559596,CSE 100,A01,083659,Cao; Yingjun,2,4,70,68
1656884565619,CSE 134B,A01,083661,Powell; Thomas Allan,19,0,100,81
1656884571642,CSE 140,A01,083663,Gungor; Onat,14,0,85,71
1656884577666,CSE 140L,A01,083088,Eldon; John,16,0,100,84
1656884583692,CSE 175,A01,083665,Kumar; Rakesh,3,0,25,22
1656884589718,CSE 190,A00,092507,Dubnov; Shlomo,7,0,20,13
1656884595744,ECE 45,A01,083139,Congero; Spencer William,5,0,75,70
1656884601771,ECE 65,A50,083695,Saad; Andrew S,12,0,30,18
1656884601771,ECE 65,A51,095125,Saad; Andrew S,25,0,26,1
1656884607793,ECE 109,A01,091882,Touri; Behrouz,16,0,70,54
1656884613819,ECE 180,A00,083140,Abi Samra; Nicholas Camill,0,0,30,30
1656884613819,ECE 180,B00,083141,Abi Samra; Nicholas Camill,0,0,30,30
1656884619843,MATH 10A,A01,083735,Patchell; Gregory David,1,0,30,29
1656884619843,MATH 10A,A02,083736,Patchell; Gregory David,20,0,30,10
1656884619843,MATH 10A,A03,083737,Patchell; Gregory David,15,0,30,15
1656884625865,MATH 10B,A01,083207,Lim; Seonhee,7,0,34,27
1656884625865,MATH 10B,A02,083208,Lim; Seonhee,9,0,35,26
1656884625865,MATH 10B,A03,093472,Lim; Seonhee,4,0,34,30
1656884625865,MATH 10B,B01,083739,Sinha; Shubham,9,0,30,21
1656884631895,MATH 18,A01,083743,Cinel; Cameron Alexander,6,0,30,24
1656884631895,MATH 18,A02,083744,Cinel; Cameron Alexander,15,0,30,15
1656884631895,MATH 18,A03,083745,Cinel; Cameron Alexander,8,0,30,22
1656884631895,MATH 18,B01,083748,Rideout; David Porter,4,0,37,33
1656884631895,MATH 18,B02,083749,Rideout; David Porter,3,0,36,33
1656884631895,MATH 18,B03,083750,Rideout; David Porter,2,0,37,35
1656884631895,MATH 18,B04,083751,Rideout; David Porter,5,0,36,31
1656884631895,MATH 18,B05,093473,Rideout; David Porter,4,0,36,32
1656884631895,MATH 18,B06,093474,Rideout; David Porter,5,0,36,31
1656884637919,MATH 20A,A01,083754,Zheng; Zequn,12,0,40,28
1656884643946,MATH 20B,A01,083756,Briones; Jor-el Thomas Caparas,1,0,36,35
1656884643946,MATH 20B,A02,083757,Briones; Jor-el Thomas Caparas,1,0,36,35
1656884643946,MATH 20B,A03,093475,Briones; Jor-el Thomas Caparas,0,0,36,36
1656884649979,MATH 20C,A01,083760,Briones; Jor-el Thomas Caparas,1,0,35,34
1656884649979,MATH 20C,A02,083761,Briones; Jor-el Thomas Caparas,8,0,35,27
1656884649979,MATH 20C,A03,093476,Briones; Jor-el Thomas Caparas,0,1,36,36
1656884649979,MATH 20C,B01,083762,Bach; Quang Tran,0,0,30,30
1656884656003,MATH 20D,A01,083765,Tran; Brian Kha,4,0,30,26
1656884656003,MATH 20D,A02,083766,Tran; Brian Kha,4,0,30,26
1656884656003,MATH 20D,A03,083767,Tran; Brian Kha,2,0,30,28
1656884662027,MATH 20E,A01,083771,Ganguly; Soumya,5,0,32,27
1656884662027,MATH 20E,A02,083772,Ganguly; Soumya,6,0,32,26
1656884662027,MATH 20E,B01,083773,Ciotti; Benjamin,18,0,35,17
1656884662027,MATH 20E,B02,083774,Ciotti; Benjamin,17,0,35,18
1656884668057,MATH 103A,A01,083777,Greenfeld; Be'Eri,2,0,36,34
1656884668057,MATH 103A,A02,083778,Greenfeld; Be'Eri,5,0,36,31
1656884668057,MATH 103A,A03,093561,Greenfeld; Be'Eri,4,0,36,32
1656884668057,MATH 103A,B01,083779,Greenfeld; Be'Eri,6,0,36,30
1656884668057,MATH 103A,B02,083780,Greenfeld; Be'Eri,2,0,36,34
1656884668057,MATH 103A,B03,093562,Greenfeld; Be'Eri,2,0,36,34
1656884674085,MATH 105,A01,085443,Carter; Anne Toulson,13,0,35,22
1656884674085,MATH 105,A02,093477,Carter; Anne Toulson,20,0,35,15
1656884680109,MATH 109,A01,083213,Ganzberger; Geoffrey Michael,2,0,34,32
1656884680109,MATH 109,A02,083214,Ganzberger; Geoffrey Michael,2,0,34,32
1656884680109,MATH 109,A03,093478,Ganzberger; Geoffrey Michael,1,0,34,33
1656884680109,MATH 109,B01,083215,Ganzberger; Geoffrey Michael,1,0,32,31
1656884680109,MATH 109,B02,083216,Ganzberger; Geoffrey Michael,1,0,32,31
1656884680109,MATH 109,B03,093479,Ganzberger; Geoffrey Michael,6,0,32,26
1656884686132,MATH 142A,A01,083219,Chow; Bennett,6,0,32,26
1656884686132,MATH 142A,A02,083220,Chow; Bennett,9,0,32,23
1656884686132,MATH 142A,A03,093480,Chow; Bennett,7,0,32,25
1656884686132,MATH 142A,B03,093481,Chow; Bennett,7,0,32,25
1656884686132,MATH 142A,B04,093558,Chow; Bennett,10,0,32,22
1656884686132,MATH 142A,B05,093559,Chow; Bennett,6,0,32,26
1656884692154,MATH 193A,A01,083224,Rotar; Vladimir,6,0,34,28
1656884692154,MATH 193A,A02,083225,Rotar; Vladimir,3,0,34,31
1656884692154,MATH 193A,A03,083781,Rotar; Vladimir,1,0,34,33
1656884692154,MATH 193A,A04,083782,Rotar; Vladimir,6,0,34,28
1656884692154,MATH 193A,A05,093482,Rotar; Vladimir,6,0,34,28
1656884698178,MATH 197,001,091859,McAuley; Julian John,9999,0,9999,0
1656884698178,MATH 197,002,095566,Kedlaya; Kiran S.,9997,0,9999,2
1656884698178,MATH 197,003,095567,Xiao; Ming,9999,0,9999,0
1656884698178,MATH 197,004,095571,Perols; Johan Lars,9998,0,9999,1
1656884705237,COGS 9,A01,083615,Shannon; Kyle Michael,6,0,75,69
1656884711271,COGS 11,A01,083617,Boyle; Mary E. T.,19,0,48,29
1656884717304,COGS 13,A01,083071,Bastos; Amalia Pinkusfeld,8,0,71,63
1656884723327,COGS 14A,A01,092681,Semenuks; Arturs,0,1,100,100
1656884729352,COGS 14B,A01,083073,Cheng; Tzu-Han,5,0,63,58
1656884735379,COGS 17,A01,092677,Semenuks; Arturs,4,0,81,77
1656884741400,COGS 100,A01,083619,Allen; Michael Gordon,15,0,70,55
1656884747424,COGS 101A,A01,083621,Davis; Joshua Daniel,9,0,68,59
1656884753451,COGS 101B,A01,091572,Allen; Michael Gordon,8,0,65,57
1656884759474,COGS 101C,A01,083625,Delgado; Tania,17,0,35,18
1656884765497,COGS 107A,A01,083627,Boyle; Mary E. T.,13,0,60,47
1656884771521,COGS 118A,A01,083075,Gupta; Anjum,15,0,76,61
1656884777548,CSE 3,A50,083646,Miranda; Gregory Joseph,22,0,50,28
1656884783574,CSE 8A,A50,083650,Miranda; Gregory Joseph,17,1,56,39
1656884789670,CSE 11,A01,083080,Cao; Yingjun,4,15,40,36
1656884795694,CSE 12,A01,083652,Krause-Levy; Sophia Louisa,20,1,120,100
1656884801717,CSE 15L,A01,083654,Morris; Justin Loren,8,0,50,42
1656884801717,CSE 15L,A02,083655,Morris; Justin Loren,8,0,50,42
1656884807740,CSE 20,A01,083657,Tran; Khoa Dang,37,0,80,43
1656884813769,CSE 21,A01,095574,Bach; Quang Tran,21,0,48,27
1656884819790,CSE 30,A01,083084,Eldon; John,4,0,80,76
1656884819790,CSE 30,B01,095061,Bhaskar; Nishant,6,0,50,44
1656884825815,CSE 100,A01,083659,Cao; Yingjun,2,4,70,68
1656884831837,CSE 134B,A01,083661,Powell; Thomas Allan,19,0,100,81
1656884837859,CSE 140,A01,083663,Gungor; Onat,14,0,85,71
1656884843883,CSE 140L,A01,083088,Eldon; John,16,0,100,84
1656884849906,CSE 175,A01,083665,Kumar; Rakesh,3,0,25,22
1656884855929,CSE 190,A00,092507,Dubnov; Shlomo,7,0,20,13
1656884861959,ECE 45,A01,083139,Congero; Spencer William,5,0,75,70
1656884867983,ECE 65,A50,083695,Saad; Andrew S,12,0,30,18
1656884867983,ECE 65,A51,095125,Saad; Andrew S,25,0,26,1
1656884874006,ECE 109,A01,091882,Touri; Behrouz,16,0,70,54
1656884880044,ECE 180,A00,083140,Abi Samra; Nicholas Camill,0,0,30,30
1656884880044,ECE 180,B00,083141,Abi Samra; Nicholas Camill,0,0,30,30
1656884886066,MATH 10A,A01,083735,Patchell; Gregory David,1,0,30,29
1656884886066,MATH 10A,A02,083736,Patchell; Gregory David,20,0,30,10
1656884886066,MATH 10A,A03,083737,Patchell; Gregory David,15,0,30,15
1656884892090,MATH 10B,A01,083207,Lim; Seonhee,7,0,34,27
1656884892090,MATH 10B,A02,083208,Lim; Seonhee,9,0,35,26
1656884892090,MATH 10B,A03,093472,Lim; Seonhee,4,0,34,30
1656884892090,MATH 10B,B01,083739,Sinha; Shubham,9,0,30,21
1656884898112,MATH 18,A01,083743,Cinel; Cameron Alexander,6,0,30,24
1656884898112,MATH 18,A02,083744,Cinel; Cameron Alexander,15,0,30,15
1656884898112,MATH 18,A03,083745,Cinel; Cameron Alexander,8,0,30,22
1656884898112,MATH 18,B01,083748,Rideout; David Porter,4,0,37,33
1656884898112,MATH 18,B02,083749,Rideout; David Porter,3,0,36,33
1656884898112,MATH 18,B03,083750,Rideout; David Porter,2,0,37,35
1656884898112,MATH 18,B04,083751,Rideout; David Porter,5,0,36,31
1656884898112,MATH 18,B05,093473,Rideout; David Porter,4,0,36,32
1656884898112,MATH 18,B06,093474,Rideout; David Porter,5,0,36,31
1656884904138,MATH 20A,A01,083754,Zheng; Zequn,12,0,40,28
1656884910164,MATH 20B,A01,083756,Briones; Jor-el Thomas Caparas,1,0,36,35
1656884910164,MATH 20B,A02,083757,Briones; Jor-el Thomas Caparas,1,0,36,35
1656884910164,MATH 20B,A03,093475,Briones; Jor-el Thomas Caparas,0,0,36,36
1656884916192,MATH 20C,A01,083760,Briones; Jor-el Thomas Caparas,1,0,35,34
1656884916192,MATH 20C,A02,083761,Briones; Jor-el Thomas Caparas,8,0,35,27
1656884916192,MATH 20C,A03,093476,Briones; Jor-el Thomas Caparas,0,1,36,36
1656884916192,MATH 20C,B01,083762,Bach; Quang Tran,0,0,30,30
1656884922215,MATH 20D,A01,083765,Tran; Brian Kha,4,0,30,26
1656884922215,MATH 20D,A02,083766,Tran; Brian Kha,4,0,30,26
1656884922215,MATH 20D,A03,083767,Tran; Brian Kha,2,0,30,28
1656884928245,MATH 20E,A01,083771,Ganguly; Soumya,5,0,32,27
1656884928245,MATH 20E,A02,083772,Ganguly; Soumya,6,0,32,26
1656884928245,MATH 20E,B01,083773,Ciotti; Benjamin,18,0,35,17
1656884928245,MATH 20E,B02,083774,Ciotti; Benjamin,17,0,35,18
1656884934274,MATH 103A,A01,083777,Greenfeld; Be'Eri,2,0,36,34
1656884934274,MATH 103A,A02,083778,Greenfeld; Be'Eri,5,0,36,31
1656884934274,MATH 103A,A03,093561,Greenfeld; Be'Eri,4,0,36,32
1656884934274,MATH 103A,B01,083779,Greenfeld; Be'Eri,6,0,36,30
1656884934274,MATH 103A,B02,083780,Greenfeld; Be'Eri,2,0,36,34
1656884934274,MATH 103A,B03,093562,Greenfeld; Be'Eri,2,0,36,34
1656884940298,MATH 105,A01,085443,Carter; Anne Toulson,13,0,35,22
1656884940298,MATH 105,A02,093477,Carter; Anne Toulson,20,0,35,15
1656884946320,MATH 109,A01,083213,Ganzberger; Geoffrey Michael,2,0,34,32
1656884946320,MATH 109,A02,083214,Ganzberger; Geoffrey Michael,2,0,34,32
1656884946320,MATH 109,A03,093478,Ganzberger; Geoffrey Michael,1,0,34,33
1656884946320,MATH 109,B01,083215,Ganzberger; Geoffrey Michael,1,0,32,31
1656884946320,MATH 109,B02,083216,Ganzberger; Geoffrey Michael,1,0,32,31
1656884946320,MATH 109,B03,093479,Ganzberger; Geoffrey Michael,6,0,32,26
1656884952347,MATH 142A,A01,083219,Chow; Bennett,6,0,32,26
1656884952347,MATH 142A,A02,083220,Chow; Bennett,9,0,32,23
1656884952347,MATH 142A,A03,093480,Chow; Bennett,7,0,32,25
1656884952347,MATH 142A,B03,093481,Chow; Bennett,7,0,32,25
1656884952347,MATH 142A,B04,093558,Chow; Bennett,10,0,32,22
1656884952347,MATH 142A,B05,093559,Chow; Bennett,6,0,32,26
1656884958371,MATH 193A,A01,083224,Rotar; Vladimir,6,0,34,28
1656884958371,MATH 193A,A02,083225,Rotar; Vladimir,3,0,34,31
1656884958371,MATH 193A,A03,083781,Rotar; Vladimir,1,0,34,33
1656884958371,MATH 193A,A04,083782,Rotar; Vladimir,6,0,34,28
1656884958371,MATH 193A,A05,093482,Rotar; Vladimir,6,0,34,28
1656884964396,MATH 197,001,091859,McAuley; Julian John,9999,0,9999,0
1656884964396,MATH 197,002,095566,Kedlaya; Kiran S.,9997,0,9999,2
1656884964396,MATH 197,003,095567,Xiao; Ming,9999,0,9999,0
1656884964396,MATH 197,004,095571,Perols; Johan Lars,9998,0,9999,1
1656884971453,COGS 9,A01,083615,Shannon; Kyle Michael,6,0,75,69
1656884977475,COGS 11,A01,083617,Boyle; Mary E. T.,19,0,48,29
1656884983498,COGS 13,A01,083071,Bastos; Amalia Pinkusfeld,8,0,71,63
1656884989521,COGS 14A,A01,092681,Semenuks; Arturs,0,1,100,100
1656884995550,COGS 14B,A01,083073,Cheng; Tzu-Han,5,0,63,58
1656885001574,COGS 17,A01,092677,Semenuks; Arturs,4,0,81,77
1656885007599,COGS 100,A01,083619,Allen; Michael Gordon,15,0,70,55
1656885013621,COGS 101A,A01,083621,Davis; Joshua Daniel,9,0,68,59
1656885019645,COGS 101B,A01,091572,Allen; Michael Gordon,8,0,65,57
1656885025670,COGS 101C,A01,083625,Delgado; Tania,17,0,35,18
1656885031691,COGS 107A,A01,083627,Boyle; Mary E. T.,13,0,60,47
1656885037714,COGS 118A,A01,083075,Gupta; Anjum,15,0,76,61
1656885043739,CSE 3,A50,083646,Miranda; Gregory Joseph,22,0,50,28
1656885049762,CSE 8A,A50,083650,Miranda; Gregory Joseph,17,1,56,39
1656885055787,CSE 11,A01,083080,Cao; Yingjun,4,15,40,36
1656885061810,CSE 12,A01,083652,Krause-Levy; Sophia Louisa,20,1,120,100
1656885067832,CSE 15L,A01,083654,Morris; Justin Loren,8,0,50,42
1656885067832,CSE 15L,A02,083655,Morris; Justin Loren,8,0,50,42
1656885073858,CSE 20,A01,083657,Tran; Khoa Dang,37,0,80,43
1656885079886,CSE 21,A01,095574,Bach; Quang Tran,21,0,48,27
1656885085912,CSE 30,A01,083084,Eldon; John,4,0,80,76
1656885085912,CSE 30,B01,095061,Bhaskar; Nishant,6,0,50,44
1656885091943,CSE 100,A01,083659,Cao; Yingjun,2,4,70,68
1656885097970,CSE 134B,A01,083661,Powell; Thomas Allan,19,0,100,81
1656885103998,CSE 140,A01,083663,Gungor; Onat,14,0,85,71
1656885110023,CSE 140L,A01,083088,Eldon; John,16,0,100,84
1656885116046,CSE 175,A01,083665,Kumar; Rakesh,3,0,25,22
1656885122070,CSE 190,A00,092507,Dubnov; Shlomo,7,0,20,13
1656885128092,ECE 45,A01,083139,Congero; Spencer William,5,0,75,70
1656885134114,ECE 65,A50,083695,Saad; Andrew S,12,0,30,18
1656885134114,ECE 65,A51,095125,Saad; Andrew S,25,0,26,1
1656885140140,ECE 109,A01,091882,Touri; Behrouz,16,0,70,54
1656885146162,ECE 180,A00,083140,Abi Samra; Nicholas Camill,0,0,30,30
1656885146162,ECE 180,B00,083141,Abi Samra; Nicholas Camill,0,0,30,30
1656885152190,MATH 10A,A01,083735,Patchell; Gregory David,1,0,30,29
1656885152190,MATH 10A,A02,083736,Patchell; Gregory David,20,0,30,10
1656885152190,MATH 10A,A03,083737,Patchell; Gregory David,15,0,30,15
1656885158213,MATH 10B,A01,083207,Lim; Seonhee,7,0,34,27
1656885158213,MATH 10B,A02,083208,Lim; Seonhee,9,0,35,26
1656885158213,MATH 10B,A03,093472,Lim; Seonhee,4,0,34,30
1656885158213,MATH 10B,B01,083739,Sinha; Shubham,9,0,30,21
1656885164237,MATH 18,A01,083743,Cinel; Cameron Alexander,6,0,30,24
1656885164237,MATH 18,A02,083744,Cinel; Cameron Alexander,15,0,30,15
1656885164237,MATH 18,A03,083745,Cinel; Cameron Alexander,8,0,30,22
1656885164237,MATH 18,B01,083748,Rideout; David Porter,4,0,37,33
1656885164237,MATH 18,B02,083749,Rideout; David Porter,3,0,36,33
1656885164237,MATH 18,B03,083750,Rideout; David Porter,2,0,37,35
1656885164237,MATH 18,B04,083751,Rideout; David Porter,5,0,36,31
1656885164237,MATH 18,B05,093473,Rideout; David Porter,4,0,36,32
1656885164237,MATH 18,B06,093474,Rideout; David Porter,5,0,36,31
1656885170261,MATH 20A,A01,083754,Zheng; Zequn,12,0,40,28
1656885176290,MATH 20B,A01,083756,Briones; Jor-el Thomas Caparas,1,0,36,35
1656885176290,MATH 20B,A02,083757,Briones; Jor-el Thomas Caparas,1,0,36,35
1656885176290,MATH 20B,A03,093475,Briones; Jor-el Thomas Caparas,0,0,36,36
1656885182313,MATH 20C,A01,083760,Briones; Jor-el Thomas Caparas,1,0,35,34
1656885182313,MATH 20C,A02,083761,Briones; Jor-el Thomas Caparas,8,0,35,27
1656885182313,MATH 20C,A03,093476,Briones; Jor-el Thomas Caparas,0,1,36,36
1656885182313,MATH 20C,B01,083762,Bach; Quang Tran,0,0,30,30
1656885188336,MATH 20D,A01,083765,Tran; Brian Kha,4,0,30,26
1656885188336,MATH 20D,A02,083766,Tran; Brian Kha,4,0,30,26
1656885188336,MATH 20D,A03,083767,Tran; Brian Kha,2,0,30,28
1656885194366,MATH 20E,A01,083771,Ganguly; Soumya,5,0,32,27
1656885194366,MATH 20E,A02,083772,Ganguly; Soumya,6,0,32,26
1656885194366,MATH 20E,B01,083773,Ciotti; Benjamin,18,0,35,17
1656885194366,MATH 20E,B02,083774,Ciotti; Benjamin,17,0,35,18
1656885200389,MATH 103A,A01,083777,Greenfeld; Be'Eri,2,0,36,34
1656885200389,MATH 103A,A02,083778,Greenfeld; Be'Eri,5,0,36,31
1656885200389,MATH 103A,A03,093561,Greenfeld; Be'Eri,4,0,36,32
1656885200389,MATH 103A,B01,083779,Greenfeld; Be'Eri,6,0,36,30
1656885200389,MATH 103A,B02,083780,Greenfeld; Be'Eri,2,0,36,34
1656885200389,MATH 103A,B03,093562,Greenfeld; Be'Eri,2,0,36,34
1656885206412,MATH 105,A01,085443,Carter; Anne Toulson,13,0,35,22
1656885206412,MATH 105,A02,093477,Carter; Anne Toulson,20,0,35,15
1656885212441,MATH 109,A01,083213,Ganzberger; Geoffrey Michael,2,0,34,32
1656885212441,MATH 109,A02,083214,Ganzberger; Geoffrey Michael,2,0,34,32
1656885212441,MATH 109,A03,093478,Ganzberger; Geoffrey Michael,1,0,34,33
1656885212441,MATH 109,B01,083215,Ganzberger; Geoffrey Michael,1,0,32,31
1656885212441,MATH 109,B02,083216,Ganzberger; Geoffrey Michael,1,0,32,31
1656885212441,MATH 109,B03,093479,Ganzberger; Geoffrey Michael,6,0,32,26
1656885218469,MATH 142A,A01,083219,Chow; Bennett,6,0,32,26
1656885218469,MATH 142A,A02,083220,Chow; Bennett,9,0,32,23
1656885218469,MATH 142A,A03,093480,Chow; Bennett,7,0,32,25
1656885218469,MATH 142A,B03,093481,Chow; Bennett,7,0,32,25
1656885218469,MATH 142A,B04,093558,Chow; Bennett,10,0,32,22
1656885218469,MATH 142A,B05,093559,Chow; Bennett,6,0,32,26
1656885224493,MATH 193A,A01,083224,Rotar; Vladimir,6,0,34,28
1656885224493,MATH 193A,A02,083225,Rotar; Vladimir,3,0,34,31
1656885224493,MATH 193A,A03,083781,Rotar; Vladimir,1,0,34,33
1656885224493,MATH 193A,A04,083782,Rotar; Vladimir,6,0,34,28
1656885224493,MATH 193A,A05,093482,Rotar; Vladimir,6,0,34,28
1656885230515,MATH 197,001,091859,McAuley; Julian John,9999,0,9999,0
1656885230515,MATH 197,002,095566,Kedlaya; Kiran S.,9997,0,9999,2
1656885230515,MATH 197,003,095567,Xiao; Ming,9999,0,9999,0
1656885230515,MATH 197,004,095571,Perols; Johan Lars,9998,0,9999,1
1656885237578,COGS 9,A01,083615,Shannon; Kyle Michael,6,0,75,69
1656885243600,COGS 11,A01,083617,Boyle; Mary E. T.,19,0,48,29
1656885249625,COGS 13,A01,083071,Bastos; Amalia Pinkusfeld,8,0,71,63
1656885255658,COGS 14A,A01,092681,Semenuks; Arturs,0,1,100,100
1656885261682,COGS 14B,A01,083073,Cheng; Tzu-Han,5,0,63,58
1656885267709,COGS 17,A01,092677,Semenuks; Arturs,4,0,81,77
1656885273732,COGS 100,A01,083619,Allen; Michael Gordon,15,0,70,55
1656885279760,COGS 101A,A01,083621,Davis; Joshua Daniel,9,0,68,59
1656885285782,COGS 101B,A01,091572,Allen; Michael Gordon,8,0,65,57
1656885291806,COGS 101C,A01,083625,Delgado; Tania,17,0,35,18
1656885297829,COGS 107A,A01,083627,Boyle; Mary E. T.,13,0,60,47
1656885303851,COGS 118A,A01,083075,Gupta; Anjum,15,0,76,61
1656885309876,CSE 3,A50,083646,Miranda; Gregory Joseph,22,0,50,28
1656885315900,CSE 8A,A50,083650,Miranda; Gregory Joseph,17,1,56,39
1656885321923,CSE 11,A01,083080,Cao; Yingjun,4,15,40,36
1656885327945,CSE 12,A01,083652,Krause-Levy; Sophia Louisa,20,1,120,100
1656885333969,CSE 15L,A01,083654,Morris; Justin Loren,8,0,50,42
1656885333969,CSE 15L,A02,083655,Morris; Justin Loren,8,0,50,42
1656885339993,CSE 20,A01,083657,Tran; Khoa Dang,37,0,80,43
1656885346027,CSE 21,A01,095574,Bach; Quang Tran,21,0,48,27
1656885352078,CSE 30,A01,083084,Eldon; John,4,0,80,76
1656885352078,CSE 30,B01,095061,Bhaskar; Nishant,6,0,50,44
1656885358104,CSE 100,A01,083659,Cao; Yingjun,2,4,70,68
1656885364128,CSE 134B,A01,083661,Powell; Thomas Allan,19,0,100,81
1656885370150,CSE 140,A01,083663,Gungor; Onat,14,0,85,71
1656885376172,CSE 140L,A01,083088,Eldon; John,16,0,100,84
1656885382194,CSE 175,A01,083665,Kumar; Rakesh,3,0,25,22
1656885388292,CSE 190,A00,092507,Dubnov; Shlomo,7,0,20,13
1656885394320,ECE 45,A01,083139,Congero; Spencer William,5,0,75,70
1656885400351,ECE 65,A50,083695,Saad; Andrew S,12,0,30,18
1656885400351,ECE 65,A51,095125,Saad; Andrew S,25,0,26,1
1656885406377,ECE 109,A01,091882,Touri; Behrouz,16,0,70,54
1656885412408,ECE 180,A00,083140,Abi Samra; Nicholas Camill,0,0,30,30
1656885412408,ECE 180,B00,083141,Abi Samra; Nicholas Camill,0,0,30,30
1656885418435,MATH 10A,A01,083735,Patchell; Gregory David,1,0,30,29
1656885418435,MATH 10A,A02,083736,Patchell; Gregory David,20,0,30,10
1656885418435,MATH 10A,A03,083737,Patchell; Gregory David,15,0,30,15
1656885424464,MATH 10B,A01,083207,Lim; Seonhee,7,0,34,27
1656885424464,MATH 10B,A02,083208,Lim; Seonhee,9,0,35,26
1656885424464,MATH 10B,A03,093472,Lim; Seonhee,4,0,34,30
1656885424464,MATH 10B,B01,083739,Sinha; Shubham,9,0,30,21
1656885430488,MATH 18,A01,083743,Cinel; Cameron Alexander,6,0,30,24
1656885430488,MATH 18,A02,083744,Cinel; Cameron Alexander,15,0,30,15
1656885430488,MATH 18,A03,083745,Cinel; Cameron Alexander,8,0,30,22
1656885430488,MATH 18,B01,083748,Rideout; David Porter,4,0,37,33
1656885430488,MATH 18,B02,083749,Rideout; David Porter,3,0,36,33
1656885430488,MATH 18,B03,083750,Rideout; David Porter,2,0,37,35
1656885430488,MATH 18,B04,083751,Rideout; David Porter,5,0,36,31
1656885430488,MATH 18,B05,093473,Rideout; David Porter,4,0,36,32
1656885430488,MATH 18,B06,093474,Rideout; David Porter,5,0,36,31
1656885436512,MATH 20A,A01,083754,Zheng; Zequn,12,0,40,28
1656885442538,MATH 20B,A01,083756,Briones; Jor-el Thomas Caparas,1,0,36,35
1656885442538,MATH 20B,A02,083757,Briones; Jor-el Thomas Caparas,1,0,36,35
1656885442538,MATH 20B,A03,093475,Briones; Jor-el Thomas Caparas,0,0,36,36
1656885448567,MATH 20C,A01,083760,Briones; Jor-el Thomas Caparas,1,0,35,34
1656885448567,MATH 20C,A02,083761,Briones; Jor-el Thomas Caparas,8,0,35,27
1656885448567,MATH 20C,A03,093476,Briones; Jor-el Thomas Caparas,0,1,36,36
1656885448567,MATH 20C,B01,083762,Bach; Quang Tran,0,0,30,30
1656885454594,MATH 20D,A01,083765,Tran; Brian Kha,4,0,30,26
1656885454594,MATH 20D,A02,083766,Tran; Brian Kha,4,0,30,26
1656885454594,MATH 20D,A03,083767,Tran; Brian Kha,2,0,30,28
1656885460619,MATH 20E,A01,083771,Ganguly; Soumya,5,0,32,27
1656885460619,MATH 20E,A02,083772,Ganguly; Soumya,6,0,32,26
1656885460619,MATH 20E,B01,083773,Ciotti; Benjamin,18,0,35,17
1656885460619,MATH 20E,B02,083774,Ciotti; Benjamin,17,0,35,18
1656885466643,MATH 103A,A01,083777,Greenfeld; Be'Eri,2,0,36,34
1656885466643,MATH 103A,A02,083778,Greenfeld; Be'Eri,5,0,36,31
1656885466643,MATH 103A,A03,093561,Greenfeld; Be'Eri,4,0,36,32
1656885466643,MATH 103A,B01,083779,Greenfeld; Be'Eri,6,0,36,30
1656885466643,MATH 103A,B02,083780,Greenfeld; Be'Eri,2,0,36,34
1656885466643,MATH 103A,B03,093562,Greenfeld; Be'Eri,2,0,36,34
1656885472666,MATH 105,A01,085443,Carter; Anne Toulson,13,0,35,22
1656885472666,MATH 105,A02,093477,Carter; Anne Toulson,20,0,35,15
1656885478690,MATH 109,A01,083213,Ganzberger; Geoffrey Michael,2,0,34,32
1656885478690,MATH 109,A02,083214,Ganzberger; Geoffrey Michael,2,0,34,32
1656885478690,MATH 109,A03,093478,Ganzberger; Geoffrey Michael,1,0,34,33
1656885478690,MATH 109,B01,083215,Ganzberger; Geoffrey Michael,1,0,32,31
1656885478690,MATH 109,B02,083216,Ganzberger; Geoffrey Michael,1,0,32,31
1656885478690,MATH 109,B03,093479,Ganzberger; Geoffrey Michael,6,0,32,26
1656885484714,MATH 142A,A01,083219,Chow; Bennett,6,0,32,26
1656885484714,MATH 142A,A02,083220,Chow; Bennett,9,0,32,23
1656885484714,MATH 142A,A03,093480,Chow; Bennett,7,0,32,25
1656885484714,MATH 142A,B03,093481,Chow; Bennett,7,0,32,25
1656885484714,MATH 142A,B04,093558,Chow; Bennett,10,0,32,22
1656885484714,MATH 142A,B05,093559,Chow; Bennett,6,0,32,26
1656885490740,MATH 193A,A01,083224,Rotar; Vladimir,6,0,34,28
1656885490740,MATH 193A,A02,083225,Rotar; Vladimir,3,0,34,31
1656885490740,MATH 193A,A03,083781,Rotar; Vladimir,1,0,34,33
1656885490740,MATH 193A,A04,083782,Rotar; Vladimir,6,0,34,28
1656885490740,MATH 193A,A05,093482,Rotar; Vladimir,6,0,34,28
1656885496767,MATH 197,001,091859,McAuley; Julian John,9999,0,9999,0
1656885496767,MATH 197,002,095566,Kedlaya; Kiran S.,9997,0,9999,2
1656885496767,MATH 197,003,095567,Xiao; Ming,9999,0,9999,0
1656885496767,MATH 197,004,095571,Perols; Johan Lars,9998,0,9999,1
1656885503821,COGS 9,A01,083615,Shannon; Kyle Michael,6,0,75,69
1656885509848,COGS 11,A01,083617,Boyle; Mary E. T.,19,0,48,29
1656885515872,COGS 13,A01,083071,Bastos; Amalia Pinkusfeld,8,0,71,63
1656885521894,COGS 14A,A01,092681,Semenuks; Arturs,0,1,100,100
1656885527917,COGS 14B,A01,083073,Cheng; Tzu-Han,5,0,63,58
1656885533940,COGS 17,A01,092677,Semenuks; Arturs,4,0,81,77
1656885539963,COGS 100,A01,083619,Allen; Michael Gordon,15,0,70,55
1656885545989,COGS 101A,A01,083621,Davis; Joshua Daniel,9,0,68,59
1656885552023,COGS 101B,A01,091572,Allen; Michael Gordon,8,0,65,57
1656885558046,COGS 101C,A01,083625,Delgado; Tania,17,0,35,18
1656885564073,COGS 107A,A01,083627,Boyle; Mary E. T.,13,0,60,47
1656885570100,COGS 118A,A01,083075,Gupta; Anjum,15,0,76,61
1656885576123,CSE 3,A50,083646,Miranda; Gregory Joseph,22,0,50,28
1656885582145,CSE 8A,A50,083650,Miranda; Gregory Joseph,17,1,56,39
1656885588171,CSE 11,A01,083080,Cao; Yingjun,4,15,40,36
1656885594194,CSE 12,A01,083652,Krause-Levy; Sophia Louisa,20,1,120,100
1656885600217,CSE 15L,A01,083654,Morris; Justin Loren,8,0,50,42
1656885600217,CSE 15L,A02,083655,Morris; Justin Loren,8,0,50,42
1656885606239,CSE 20,A01,083657,Tran; Khoa Dang,37,0,80,43
1656885612266,CSE 21,A01,095574,Bach; Quang Tran,21,0,48,27
1656885618297,CSE 30,A01,083084,Eldon; John,4,0,80,76
1656885618297,CSE 30,B01,095061,Bhaskar; Nishant,6,0,50,44
1656885624323,CSE 100,A01,083659,Cao; Yingjun,2,4,70,68
1656885630349,CSE 134B,A01,083661,Powell; Thomas Allan,19,0,100,81
1656885636382,CSE 140,A01,083663,Gungor; Onat,14,0,85,71
1656885642409,CSE 140L,A01,083088,Eldon; John,16,0,100,84
1656885648431,CSE 175,A01,083665,Kumar; Rakesh,3,0,25,22
1656885654455,CSE 190,A00,092507,Dubnov; Shlomo,7,0,20,13
1656885660477,ECE 45,A01,083139,Congero; Spencer William,5,0,75,70
1656885666498,ECE 65,A50,083695,Saad; Andrew S,12,0,30,18
1656885666498,ECE 65,A51,095125,Saad; Andrew S,25,0,26,1
1656885672523,ECE 109,A01,091882,Touri; Behrouz,16,0,70,54
1656885678547,ECE 180,A00,083140,Abi Samra; Nicholas Camill,0,0,30,30
1656885678547,ECE 180,B00,083141,Abi Samra; Nicholas Camill,0,0,30,30
1656885684574,MATH 10A,A01,083735,Patchell; Gregory David,1,0,30,29
1656885684574,MATH 10A,A02,083736,Patchell; Gregory David,20,0,30,10
1656885684574,MATH 10A,A03,083737,Patchell; Gregory David,15,0,30,15
1656885690604,MATH 10B,A01,083207,Lim; Seonhee,7,0,34,27
1656885690604,MATH 10B,A02,083208,Lim; Seonhee,9,0,35,26
1656885690604,MATH 10B,A03,093472,Lim; Seonhee,4,0,34,30
1656885690604,MATH 10B,B01,083739,Sinha; Shubham,9,0,30,21
1656885696629,MATH 18,A01,083743,Cinel; Cameron Alexander,6,0,30,24
1656885696629,MATH 18,A02,083744,Cinel; Cameron Alexander,15,0,30,15
1656885696629,MATH 18,A03,083745,Cinel; Cameron Alexander,8,0,30,22
1656885696629,MATH 18,B01,083748,Rideout; David Porter,4,0,37,33
1656885696629,MATH 18,B02,083749,Rideout; David Porter,3,0,36,33
1656885696629,MATH 18,B03,083750,Rideout; David Porter,2,0,37,35
1656885696629,MATH 18,B04,083751,Rideout; David Porter,5,0,36,31
1656885696629,MATH 18,B05,093473,Rideout; David Porter,4,0,36,32
1656885696629,MATH 18,B06,093474,Rideout; David Porter,5,0,36,31
1656885702653,MATH 20A,A01,083754,Zheng; Zequn,12,0,40,28
1656885708677,MATH 20B,A01,083756,Briones; Jor-el Thomas Caparas,1,0,36,35
1656885708677,MATH 20B,A02,083757,Briones; Jor-el Thomas Caparas,1,0,36,35
1656885708677,MATH 20B,A03,093475,Briones; Jor-el Thomas Caparas,0,0,36,36
1656885714707,MATH 20C,A01,083760,Briones; Jor-el Thomas Caparas,1,0,35,34
1656885714707,MATH 20C,A02,083761,Briones; Jor-el Thomas Caparas,8,0,35,27
1656885714707,MATH 20C,A03,093476,Briones; Jor-el Thomas Caparas,0,1,36,36
1656885714707,MATH 20C,B01,083762,Bach; Quang Tran,0,0,30,30
1656885720734,MATH 20D,A01,083765,Tran; Brian Kha,4,0,30,26
1656885720734,MATH 20D,A02,083766,Tran; Brian Kha,4,0,30,26
1656885720734,MATH 20D,A03,083767,Tran; Brian Kha,2,0,30,28
1656885726757,MATH 20E,A01,083771,Ganguly; Soumya,5,0,32,27
1656885726757,MATH 20E,A02,083772,Ganguly; Soumya,6,0,32,26
1656885726757,MATH 20E,B01,083773,Ciotti; Benjamin,18,0,35,17
1656885726757,MATH 20E,B02,083774,Ciotti; Benjamin,17,0,35,18
1656885732788,MATH 103A,A01,083777,Greenfeld; Be'Eri,2,0,36,34
1656885732788,MATH 103A,A02,083778,Greenfeld; Be'Eri,5,0,36,31
1656885732788,MATH 103A,A03,093561,Greenfeld; Be'Eri,4,0,36,32
1656885732788,MATH 103A,B01,083779,Greenfeld; Be'Eri,6,0,36,30
1656885732788,MATH 103A,B02,083780,Greenfeld; Be'Eri,2,0,36,34
1656885732788,MATH 103A,B03,093562,Greenfeld; Be'Eri,2,0,36,34
1656885738815,MATH 105,A01,085443,Carter; Anne Toulson,13,0,35,22
1656885738815,MATH 105,A02,093477,Carter; Anne Toulson,20,0,35,15
1656885744841,MATH 109,A01,083213,Ganzberger; Geoffrey Michael,2,0,34,32
1656885744841,MATH 109,A02,083214,Ganzberger; Geoffrey Michael,2,0,34,32
1656885744841,MATH 109,A03,093478,Ganzberger; Geoffrey Michael,1,0,34,33
1656885744841,MATH 109,B01,083215,Ganzberger; Geoffrey Michael,1,0,32,31
1656885744841,MATH 109,B02,083216,Ganzberger; Geoffrey Michael,1,0,32,31
1656885744841,MATH 109,B03,093479,Ganzberger; Geoffrey Michael,6,0,32,26
1656885750870,MATH 142A,A01,083219,Chow; Bennett,6,0,32,26
1656885750870,MATH 142A,A02,083220,Chow; Bennett,9,0,32,23
1656885750870,MATH 142A,A03,093480,Chow; Bennett,7,0,32,25
1656885750870,MATH 142A,B03,093481,Chow; Bennett,7,0,32,25
1656885750870,MATH 142A,B04,093558,Chow; Bennett,10,0,32,22
1656885750870,MATH 142A,B05,093559,Chow; Bennett,6,0,32,26
1656885756895,MATH 193A,A01,083224,Rotar; Vladimir,6,0,34,28
1656885756895,MATH 193A,A02,083225,Rotar; Vladimir,3,0,34,31
1656885756895,MATH 193A,A03,083781,Rotar; Vladimir,1,0,34,33
1656885756895,MATH 193A,A04,083782,Rotar; Vladimir,6,0,34,28
1656885756895,MATH 193A,A05,093482,Rotar; Vladimir,6,0,34,28
1656885762919,MATH 197,001,091859,McAuley; Julian John,9999,0,9999,0
1656885762919,MATH 197,002,095566,Kedlaya; Kiran S.,9997,0,9999,2
1656885762919,MATH 197,003,095567,Xiao; Ming,9999,0,9999,0
1656885762919,MATH 197,004,095571,Perols; Johan Lars,9998,0,9999,1
1656885769993,COGS 9,A01,083615,Shannon; Kyle Michael,6,0,75,69
1656885776017,COGS 11,A01,083617,Boyle; Mary E. T.,19,0,48,29
1656885782044,COGS 13,A01,083071,Bastos; Amalia Pinkusfeld,8,0,71,63
1656885788072,COGS 14A,A01,092681,Semenuks; Arturs,0,1,100,100
1656885794094,COGS 14B,A01,083073,Cheng; Tzu-Han,5,0,63,58
1656885800121,COGS 17,A01,092677,Semenuks; Arturs,4,0,81,77
1656885806145,COGS 100,A01,083619,Allen; Michael Gordon,15,0,70,55
1656885812171,COGS 101A,A01,083621,Davis; Joshua Daniel,9,0,68,59
1656885818199,COGS 101B,A01,091572,Allen; Michael Gordon,8,0,65,57
1656885824222,COGS 101C,A01,083625,Delgado; Tania,17,0,35,18
1656885830246,COGS 107A,A01,083627,Boyle; Mary E. T.,13,0,60,47
1656885836273,COGS 118A,A01,083075,Gupta; Anjum,15,0,76,61
1656885842297,CSE 3,A50,083646,Miranda; Gregory Joseph,22,0,50,28
1656885848321,CSE 8A,A50,083650,Miranda; Gregory Joseph,17,1,56,39
1656885854346,CSE 11,A01,083080,Cao; Yingjun,4,15,40,36
1656885860369,CSE 12,A01,083652,Krause-Levy; Sophia Louisa,20,1,120,100
1656885866393,CSE 15L,A01,083654,Morris; Justin Loren,8,0,50,42
1656885866393,CSE 15L,A02,083655,Morris; Justin Loren,8,0,50,42
1656885872420,CSE 20,A01,083657,Tran; Khoa Dang,37,0,80,43
1656885878443,CSE 21,A01,095574,Bach; Quang Tran,21,0,48,27
1656885884467,CSE 30,A01,083084,Eldon; John,4,0,80,76
1656885884467,CSE 30,B01,095061,Bhaskar; Nishant,6,0,50,44
1656885890494,CSE 100,A01,083659,Cao; Yingjun,2,4,70,68
1656885896520,CSE 134B,A01,083661,Powell; Thomas Allan,19,0,100,81
1656885902544,CSE 140,A01,083663,Gungor; Onat,14,0,85,71
1656885908565,CSE 140L,A01,083088,Eldon; John,16,0,100,84
1656885914589,CSE 175,A01,083665,Kumar; Rakesh,3,0,25,22
1656885920612,CSE 190,A00,092507,Dubnov; Shlomo,7,0,20,13
1656885926641,ECE 45,A01,083139,Congero; Spencer William,5,0,75,70
1656885932664,ECE 65,A50,083695,Saad; Andrew S,12,0,30,18
1656885932664,ECE 65,A51,095125,Saad; Andrew S,25,0,26,1
1656885938697,ECE 109,A01,091882,Touri; Behrouz,16,0,70,54
1656885944724,ECE 180,A00,083140,Abi Samra; Nicholas Camill,0,0,30,30
1656885944724,ECE 180,B00,083141,Abi Samra; Nicholas Camill,0,0,30,30
1656885950748,MATH 10A,A01,083735,Patchell; Gregory David,1,0,30,29
1656885950748,MATH 10A,A02,083736,Patchell; Gregory David,20,0,30,10
1656885950748,MATH 10A,A03,083737,Patchell; Gregory David,15,0,30,15
1656885956773,MATH 10B,A01,083207,Lim; Seonhee,7,0,34,27
1656885956773,MATH 10B,A02,083208,Lim; Seonhee,9,0,35,26
1656885956773,MATH 10B,A03,093472,Lim; Seonhee,4,0,34,30
1656885956773,MATH 10B,B01,083739,Sinha; Shubham,9,0,30,21
1656885962805,MATH 18,A01,083743,Cinel; Cameron Alexander,6,0,30,24
1656885962805,MATH 18,A02,083744,Cinel; Cameron Alexander,15,0,30,15
1656885962805,MATH 18,A03,083745,Cinel; Cameron Alexander,8,0,30,22
1656885962805,MATH 18,B01,083748,Rideout; David Porter,4,0,37,33
1656885962805,MATH 18,B02,083749,Rideout; David Porter,3,0,36,33
1656885962805,MATH 18,B03,083750,Rideout; David Porter,2,0,37,35
1656885962805,MATH 18,B04,083751,Rideout; David Porter,5,0,36,31
1656885962805,MATH 18,B05,093473,Rideout; David Porter,4,0,36,32
1656885962805,MATH 18,B06,093474,Rideout; David Porter,5,0,36,31
1656885968826,MATH 20A,A01,083754,Zheng; Zequn,12,0,40,28
1656885974860,MATH 20B,A01,083756,Briones; Jor-el Thomas Caparas,1,0,36,35
1656885974860,MATH 20B,A02,083757,Briones; Jor-el Thomas Caparas,1,0,36,35
1656885974860,MATH 20B,A03,093475,Briones; Jor-el Thomas Caparas,0,0,36,36
1656885980884,MATH 20C,A01,083760,Briones; Jor-el Thomas Caparas,1,0,35,34
1656885980884,MATH 20C,A02,083761,Briones; Jor-el Thomas Caparas,8,0,35,27
1656885980884,MATH 20C,A03,093476,Briones; Jor-el Thomas Caparas,0,1,36,36
1656885980884,MATH 20C,B01,083762,Bach; Quang Tran,0,0,30,30
1656885986995,MATH 20D,A01,083765,Tran; Brian Kha,4,0,30,26
1656885986995,MATH 20D,A02,083766,Tran; Brian Kha,4,0,30,26
1656885986995,MATH 20D,A03,083767,Tran; Brian Kha,2,0,30,28
1656885993021,MATH 20E,A01,083771,Ganguly; Soumya,5,0,32,27
1656885993021,MATH 20E,A02,083772,Ganguly; Soumya,6,0,32,26
1656885993021,MATH 20E,B01,083773,Ciotti; Benjamin,18,0,35,17
1656885993021,MATH 20E,B02,083774,Ciotti; Benjamin,17,0,35,18
1656885999052,MATH 103A,A01,083777,Greenfeld; Be'Eri,2,0,36,34
1656885999052,MATH 103A,A02,083778,Greenfeld; Be'Eri,5,0,36,31
1656885999052,MATH 103A,A03,093561,Greenfeld; Be'Eri,4,0,36,32
1656885999052,MATH 103A,B01,083779,Greenfeld; Be'Eri,6,0,36,30
1656885999052,MATH 103A,B02,083780,Greenfeld; Be'Eri,2,0,36,34
1656885999052,MATH 103A,B03,093562,Greenfeld; Be'Eri,2,0,36,34
1656886005075,MATH 105,A01,085443,Carter; Anne Toulson,13,0,35,22
1656886005075,MATH 105,A02,093477,Carter; Anne Toulson,20,0,35,15
1656886011113,MATH 109,A01,083213,Ganzberger; Geoffrey Michael,2,0,34,32
1656886011113,MATH 109,A02,083214,Ganzberger; Geoffrey Michael,2,0,34,32
1656886011113,MATH 109,A03,093478,Ganzberger; Geoffrey Michael,1,0,34,33
1656886011113,MATH 109,B01,083215,Ganzberger; Geoffrey Michael,1,0,32,31
1656886011113,MATH 109,B02,083216,Ganzberger; Geoffrey Michael,1,0,32,31
1656886011113,MATH 109,B03,093479,Ganzberger; Geoffrey Michael,6,0,32,26
1656886017137,MATH 142A,A01,083219,Chow; Bennett,6,0,32,26
1656886017137,MATH 142A,A02,083220,Chow; Bennett,9,0,32,23
1656886017137,MATH 142A,A03,093480,Chow; Bennett,7,0,32,25
1656886017137,MATH 142A,B03,093481,Chow; Bennett,7,0,32,25
1656886017137,MATH 142A,B04,093558,Chow; Bennett,10,0,32,22
1656886017137,MATH 142A,B05,093559,Chow; Bennett,6,0,32,26
1656886023159,MATH 193A,A01,083224,Rotar; Vladimir,6,0,34,28
1656886023159,MATH 193A,A02,083225,Rotar; Vladimir,3,0,34,31
1656886023159,MATH 193A,A03,083781,Rotar; Vladimir,1,0,34,33
1656886023159,MATH 193A,A04,083782,Rotar; Vladimir,6,0,34,28
1656886023159,MATH 193A,A05,093482,Rotar; Vladimir,6,0,34,28
1656886029194,MATH 197,001,091859,McAuley; Julian John,9999,0,9999,0
1656886029194,MATH 197,002,095566,Kedlaya; Kiran S.,9997,0,9999,2
1656886029194,MATH 197,003,095567,Xiao; Ming,9999,0,9999,0
1656886029194,MATH 197,004,095571,Perols; Johan Lars,9998,0,9999,1
1656886036249,COGS 9,A01,083615,Shannon; Kyle Michael,6,0,75,69
1656886042276,COGS 11,A01,083617,Boyle; Mary E. T.,19,0,48,29
1656886048303,COGS 13,A01,083071,Bastos; Amalia Pinkusfeld,8,0,71,63
1656886054327,COGS 14A,A01,092681,Semenuks; Arturs,0,1,100,100
1656886060355,COGS 14B,A01,083073,Cheng; Tzu-Han,5,0,63,58
1656886066391,COGS 17,A01,092677,Semenuks; Arturs,4,0,81,77
1656886072421,COGS 100,A01,083619,Allen; Michael Gordon,15,0,70,55
1656886078444,COGS 101A,A01,083621,Davis; Joshua Daniel,9,0,68,59
1656886084477,COGS 101B,A01,091572,Allen; Michael Gordon,8,0,65,57
1656886090509,COGS 101C,A01,083625,Delgado; Tania,17,0,35,18
1656886096530,COGS 107A,A01,083627,Boyle; Mary E. T.,13,0,60,47
1656886102553,COGS 118A,A01,083075,Gupta; Anjum,15,0,76,61
1656886108575,CSE 3,A50,083646,Miranda; Gregory Joseph,22,0,50,28
1656886114598,CSE 8A,A50,083650,Miranda; Gregory Joseph,17,1,56,39
1656886120623,CSE 11,A01,083080,Cao; Yingjun,4,15,40,36
1656886126652,CSE 12,A01,083652,Krause-Levy; Sophia Louisa,20,1,120,100
1656886132675,CSE 15L,A01,083654,Morris; Justin Loren,8,0,50,42
1656886132675,CSE 15L,A02,083655,Morris; Justin Loren,8,0,50,42
1656886138697,CSE 20,A01,083657,Tran; Khoa Dang,37,0,80,43
1656886144720,CSE 21,A01,095574,Bach; Quang Tran,21,0,48,27
1656886150743,CSE 30,A01,083084,Eldon; John,4,0,80,76
1656886150743,CSE 30,B01,095061,Bhaskar; Nishant,6,0,50,44
1656886156765,CSE 100,A01,083659,Cao; Yingjun,2,4,70,68
1656886162788,CSE 134B,A01,083661,Powell; Thomas Allan,19,0,100,81
1656886168812,CSE 140,A01,083663,Gungor; Onat,14,0,85,71
1656886174837,CSE 140L,A01,083088,Eldon; John,16,0,100,84
1656886180860,CSE 175,A01,083665,Kumar; Rakesh,3,0,25,22
1656886186883,CSE 190,A00,092507,Dubnov; Shlomo,7,0,20,13
1656886192910,ECE 45,A01,083139,Congero; Spencer William,5,0,75,70
1656886198933,ECE 65,A50,083695,Saad; Andrew S,12,0,30,18
1656886198933,ECE 65,A51,095125,Saad; Andrew S,25,0,26,1
1656886204955,ECE 109,A01,091882,Touri; Behrouz,16,0,70,54
1656886210979,ECE 180,A00,083140,Abi Samra; Nicholas Camill,0,0,30,30
1656886210979,ECE 180,B00,083141,Abi Samra; Nicholas Camill,0,0,30,30
1656886217004,MATH 10A,A01,083735,Patchell; Gregory David,1,0,30,29
1656886217004,MATH 10A,A02,083736,Patchell; Gregory David,20,0,30,10
1656886217004,MATH 10A,A03,083737,Patchell; Gregory David,15,0,30,15
1656886223027,MATH 10B,A01,083207,Lim; Seonhee,7,0,34,27
1656886223027,MATH 10B,A02,083208,Lim; Seonhee,9,0,35,26
1656886223027,MATH 10B,A03,093472,Lim; Seonhee,4,0,34,30
1656886223027,MATH 10B,B01,083739,Sinha; Shubham,9,0,30,21
1656886229057,MATH 18,A01,083743,Cinel; Cameron Alexander,6,0,30,24
1656886229057,MATH 18,A02,083744,Cinel; Cameron Alexander,15,0,30,15
1656886229057,MATH 18,A03,083745,Cinel; Cameron Alexander,8,0,30,22
1656886229057,MATH 18,B01,083748,Rideout; David Porter,4,0,37,33
1656886229057,MATH 18,B02,083749,Rideout; David Porter,3,0,36,33
1656886229057,MATH 18,B03,083750,Rideout; David Porter,2,0,37,35
1656886229057,MATH 18,B04,083751,Rideout; David Porter,5,0,36,31
1656886229057,MATH 18,B05,093473,Rideout; David Porter,4,0,36,32
1656886229057,MATH 18,B06,093474,Rideout; David Porter,5,0,36,31
1656886235080,MATH 20A,A01,083754,Zheng; Zequn,12,0,40,28
1656886241109,MATH 20B,A01,083756,Briones; Jor-el Thomas Caparas,1,0,36,35
1656886241109,MATH 20B,A02,083757,Briones; Jor-el Thomas Caparas,1,0,36,35
1656886241109,MATH 20B,A03,093475,Briones; Jor-el Thomas Caparas,0,0,36,36
1656886247139,MATH 20C,A01,083760,Briones; Jor-el Thomas Caparas,1,0,35,34
1656886247139,MATH 20C,A02,083761,Briones; Jor-el Thomas Caparas,8,0,35,27
1656886247139,MATH 20C,A03,093476,Briones; Jor-el Thomas Caparas,0,1,36,36
1656886247139,MATH 20C,B01,083762,Bach; Quang Tran,0,0,30,30
1656886253168,MATH 20D,A01,083765,Tran; Brian Kha,4,0,30,26
1656886253168,MATH 20D,A02,083766,Tran; Brian Kha,4,0,30,26
1656886253168,MATH 20D,A03,083767,Tran; Brian Kha,2,0,30,28
1656886259204,MATH 20E,A01,083771,Ganguly; Soumya,5,0,32,27
1656886259204,MATH 20E,A02,083772,Ganguly; Soumya,6,0,32,26
1656886259204,MATH 20E,B01,083773,Ciotti; Benjamin,18,0,35,17
1656886259204,MATH 20E,B02,083774,Ciotti; Benjamin,17,0,35,18
1656886265228,MATH 103A,A01,083777,Greenfeld; Be'Eri,2,0,36,34
1656886265228,MATH 103A,A02,083778,Greenfeld; Be'Eri,5,0,36,31
1656886265228,MATH 103A,A03,093561,Greenfeld; Be'Eri,4,0,36,32
1656886265228,MATH 103A,B01,083779,Greenfeld; Be'Eri,6,0,36,30
1656886265228,MATH 103A,B02,083780,Greenfeld; Be'Eri,2,0,36,34
1656886265228,MATH 103A,B03,093562,Greenfeld; Be'Eri,2,0,36,34
1656886271256,MATH 105,A01,085443,Carter; Anne Toulson,13,0,35,22
1656886271256,MATH 105,A02,093477,Carter; Anne Toulson,20,0,35,15
1656886277295,MATH 109,A01,083213,Ganzberger; Geoffrey Michael,2,0,34,32
1656886277295,MATH 109,A02,083214,Ganzberger; Geoffrey Michael,2,0,34,32
1656886277295,MATH 109,A03,093478,Ganzberger; Geoffrey Michael,1,0,34,33
1656886277295,MATH 109,B01,083215,Ganzberger; Geoffrey Michael,1,0,32,31
1656886277295,MATH 109,B02,083216,Ganzberger; Geoffrey Michael,1,0,32,31
1656886277295,MATH 109,B03,093479,Ganzberger; Geoffrey Michael,6,0,32,26
1656886283317,MATH 142A,A01,083219,Chow; Bennett,6,0,32,26
1656886283317,MATH 142A,A02,083220,Chow; Bennett,9,0,32,23
1656886283317,MATH 142A,A03,093480,Chow; Bennett,7,0,32,25
1656886283317,MATH 142A,B03,093481,Chow; Bennett,7,0,32,25
1656886283317,MATH 142A,B04,093558,Chow; Bennett,10,0,32,22
1656886283317,MATH 142A,B05,093559,Chow; Bennett,6,0,32,26
1656886289342,MATH 193A,A01,083224,Rotar; Vladimir,6,0,34,28
1656886289342,MATH 193A,A02,083225,Rotar; Vladimir,3,0,34,31
1656886289342,MATH 193A,A03,083781,Rotar; Vladimir,1,0,34,33
1656886289342,MATH 193A,A04,083782,Rotar; Vladimir,6,0,34,28
1656886289342,MATH 193A,A05,093482,Rotar; Vladimir,6,0,34,28
1656886295370,MATH 197,001,091859,McAuley; Julian John,9999,0,9999,0
1656886295370,MATH 197,002,095566,Kedlaya; Kiran S.,9997,0,9999,2
1656886295370,MATH 197,003,095567,Xiao; Ming,9999,0,9999,0
1656886295370,MATH 197,004,095571,Perols; Johan Lars,9998,0,9999,1
1656886302436,COGS 9,A01,083615,Shannon; Kyle Michael,6,0,75,69
1656886308459,COGS 11,A01,083617,Boyle; Mary E. T.,19,0,48,29
1656886314481,COGS 13,A01,083071,Bastos; Amalia Pinkusfeld,8,0,71,63
1656886320506,COGS 14A,A01,092681,Semenuks; Arturs,0,1,100,100
1656886326529,COGS 14B,A01,083073,Cheng; Tzu-Han,5,0,63,58
1656886332552,COGS 17,A01,092677,Semenuks; Arturs,4,0,81,77
1656886338575,COGS 100,A01,083619,Allen; Michael Gordon,15,0,70,55
1656886344602,COGS 101A,A01,083621,Davis; Joshua Daniel,9,0,68,59
1656886350626,COGS 101B,A01,091572,Allen; Michael Gordon,8,0,65,57
1656886356651,COGS 101C,A01,083625,Delgado; Tania,17,0,35,18
1656886362673,COGS 107A,A01,083627,Boyle; Mary E. T.,13,0,60,47
1656886368703,COGS 118A,A01,083075,Gupta; Anjum,15,0,76,61
1656886374726,CSE 3,A50,083646,Miranda; Gregory Joseph,22,0,50,28
1656886380748,CSE 8A,A50,083650,Miranda; Gregory Joseph,17,1,56,39
1656886386774,CSE 11,A01,083080,Cao; Yingjun,4,15,40,36
1656886392803,CSE 12,A01,083652,Krause-Levy; Sophia Louisa,20,1,120,100
1656886398829,CSE 15L,A01,083654,Morris; Justin Loren,8,0,50,42
1656886398829,CSE 15L,A02,083655,Morris; Justin Loren,8,0,50,42
1656886404853,CSE 20,A01,083657,Tran; Khoa Dang,37,0,80,43
1656886410874,CSE 21,A01,095574,Bach; Quang Tran,21,0,48,27
1656886416897,CSE 30,A01,083084,Eldon; John,4,0,80,76
1656886416897,CSE 30,B01,095061,Bhaskar; Nishant,6,0,50,44
1656886422919,CSE 100,A01,083659,Cao; Yingjun,2,4,70,68
1656886428941,CSE 134B,A01,083661,Powell; Thomas Allan,19,0,100,81
1656886434966,CSE 140,A01,083663,Gungor; Onat,14,0,85,71
1656886440987,CSE 140L,A01,083088,Eldon; John,16,0,100,84
1656886447009,CSE 175,A01,083665,Kumar; Rakesh,3,0,25,22
1656886453035,CSE 190,A00,092507,Dubnov; Shlomo,7,0,20,13
1656886459072,ECE 45,A01,083139,Congero; Spencer William,5,0,75,70
1656886465095,ECE 65,A50,083695,Saad; Andrew S,12,0,30,18
1656886465095,ECE 65,A51,095125,Saad; Andrew S,25,0,26,1
1656886471129,ECE 109,A01,091882,Touri; Behrouz,16,0,70,54
1656886477155,ECE 180,A00,083140,Abi Samra; Nicholas Camill,0,0,30,30
1656886477155,ECE 180,B00,083141,Abi Samra; Nicholas Camill,0,0,30,30
1656886483178,MATH 10A,A01,083735,Patchell; Gregory David,1,0,30,29
1656886483178,MATH 10A,A02,083736,Patchell; Gregory David,20,0,30,10
1656886483178,MATH 10A,A03,083737,Patchell; Gregory David,15,0,30,15
1656886489209,MATH 10B,A01,083207,Lim; Seonhee,7,0,34,27
1656886489209,MATH 10B,A02,083208,Lim; Seonhee,9,0,35,26
1656886489209,MATH 10B,A03,093472,Lim; Seonhee,4,0,34,30
1656886489209,MATH 10B,B01,083739,Sinha; Shubham,9,0,30,21
1656886495240,MATH 18,A01,083743,Cinel; Cameron Alexander,6,0,30,24
1656886495240,MATH 18,A02,083744,Cinel; Cameron Alexander,15,0,30,15
1656886495240,MATH 18,A03,083745,Cinel; Cameron Alexander,8,0,30,22
1656886495240,MATH 18,B01,083748,Rideout; David Porter,4,0,37,33
1656886495240,MATH 18,B02,083749,Rideout; David Porter,3,0,36,33
1656886495240,MATH 18,B03,083750,Rideout; David Porter,2,0,37,35
1656886495240,MATH 18,B04,083751,Rideout; David Porter,5,0,36,31
1656886495240,MATH 18,B05,093473,Rideout; David Porter,4,0,36,32
1656886495240,MATH 18,B06,093474,Rideout; David Porter,5,0,36,31
1656886501266,MATH 20A,A01,083754,Zheng; Zequn,12,0,40,28
1656886507290,MATH 20B,A01,083756,Briones; Jor-el Thomas Caparas,1,0,36,35
1656886507290,MATH 20B,A02,083757,Briones; Jor-el Thomas Caparas,1,0,36,35
1656886507290,MATH 20B,A03,093475,Briones; Jor-el Thomas Caparas,0,0,36,36
1656886513313,MATH 20C,A01,083760,Briones; Jor-el Thomas Caparas,1,0,35,34
1656886513313,MATH 20C,A02,083761,Briones; Jor-el Thomas Caparas,8,0,35,27
1656886513313,MATH 20C,A03,093476,Briones; Jor-el Thomas Caparas,0,1,36,36
1656886513313,MATH 20C,B01,083762,Bach; Quang Tran,0,0,30,30
1656886519340,MATH 20D,A01,083765,Tran; Brian Kha,4,0,30,26
1656886519340,MATH 20D,A02,083766,Tran; Brian Kha,4,0,30,26
1656886519340,MATH 20D,A03,083767,Tran; Brian Kha,2,0,30,28
1656886525365,MATH 20E,A01,083771,Ganguly; Soumya,5,0,32,27
1656886525365,MATH 20E,A02,083772,Ganguly; Soumya,6,0,32,26
1656886525365,MATH 20E,B01,083773,Ciotti; Benjamin,18,0,35,17
1656886525365,MATH 20E,B02,083774,Ciotti; Benjamin,17,0,35,18
1656886531389,MATH 103A,A01,083777,Greenfeld; Be'Eri,2,0,36,34
1656886531389,MATH 103A,A02,083778,Greenfeld; Be'Eri,5,0,36,31
1656886531389,MATH 103A,A03,093561,Greenfeld; Be'Eri,4,0,36,32
1656886531389,MATH 103A,B01,083779,Greenfeld; Be'Eri,6,0,36,30
1656886531389,MATH 103A,B02,083780,Greenfeld; Be'Eri,2,0,36,34
1656886531389,MATH 103A,B03,093562,Greenfeld; Be'Eri,2,0,36,34
1656886537418,MATH 105,A01,085443,Carter; Anne Toulson,13,0,35,22
1656886537418,MATH 105,A02,093477,Carter; Anne Toulson,20,0,35,15
1656886543446,MATH 109,A01,083213,Ganzberger; Geoffrey Michael,2,0,34,32
1656886543446,MATH 109,A02,083214,Ganzberger; Geoffrey Michael,2,0,34,32
1656886543446,MATH 109,A03,093478,Ganzberger; Geoffrey Michael,1,0,34,33
1656886543446,MATH 109,B01,083215,Ganzberger; Geoffrey Michael,1,0,32,31
1656886543446,MATH 109,B02,083216,Ganzberger; Geoffrey Michael,1,0,32,31
1656886543446,MATH 109,B03,093479,Ganzberger; Geoffrey Michael,6,0,32,26
1656886549469,MATH 142A,A01,083219,Chow; Bennett,6,0,32,26
1656886549469,MATH 142A,A02,083220,Chow; Bennett,9,0,32,23
1656886549469,MATH 142A,A03,093480,Chow; Bennett,7,0,32,25
1656886549469,MATH 142A,B03,093481,Chow; Bennett,7,0,32,25
1656886549469,MATH 142A,B04,093558,Chow; Bennett,10,0,32,22
1656886549469,MATH 142A,B05,093559,Chow; Bennett,6,0,32,26
1656886555511,MATH 193A,A01,083224,Rotar; Vladimir,6,0,34,28
1656886555511,MATH 193A,A02,083225,Rotar; Vladimir,3,0,34,31
1656886555511,MATH 193A,A03,083781,Rotar; Vladimir,1,0,34,33
1656886555511,MATH 193A,A04,083782,Rotar; Vladimir,6,0,34,28
1656886555511,MATH 193A,A05,093482,Rotar; Vladimir,6,0,34,28
1656886561541,MATH 197,001,091859,McAuley; Julian John,9999,0,9999,0
1656886561541,MATH 197,002,095566,Kedlaya; Kiran S.,9997,0,9999,2
1656886561541,MATH 197,003,095567,Xiao; Ming,9999,0,9999,0
1656886561541,MATH 197,004,095571,Perols; Johan Lars,9998,0,9999,1
1656886568597,COGS 9,A01,083615,Shannon; Kyle Michael,6,0,75,69
1656886574629,COGS 11,A01,083617,Boyle; Mary E. T.,19,0,48,29
1656886580743,COGS 13,A01,083071,Bastos; Amalia Pinkusfeld,8,0,71,63
1656886586765,COGS 14A,A01,092681,Semenuks; Arturs,0,1,100,100
1656886592790,COGS 14B,A01,083073,Cheng; Tzu-Han,5,0,63,58
1656886598815,COGS 17,A01,092677,Semenuks; Arturs,4,0,81,77
1656886604846,COGS 100,A01,083619,Allen; Michael Gordon,15,0,70,55
1656886610870,COGS 101A,A01,083621,Davis; Joshua Daniel,9,0,68,59
1656886616893,COGS 101B,A01,091572,Allen; Michael Gordon,8,0,65,57
1656886622926,COGS 101C,A01,083625,Delgado; Tania,17,0,35,18
1656886628949,COGS 107A,A01,083627,Boyle; Mary E. T.,13,0,60,47
1656886634975,COGS 118A,A01,083075,Gupta; Anjum,15,0,76,61
1656886640998,CSE 3,A50,083646,Miranda; Gregory Joseph,22,0,50,28
1656886647020,CSE 8A,A50,083650,Miranda; Gregory Joseph,17,1,56,39
1656886653044,CSE 11,A01,083080,Cao; Yingjun,4,15,40,36
1656886659071,CSE 12,A01,083652,Krause-Levy; Sophia Louisa,20,1,120,100
1656886665104,CSE 15L,A01,083654,Morris; Justin Loren,8,0,50,42
1656886665104,CSE 15L,A02,083655,Morris; Justin Loren,8,0,50,42
1656886671129,CSE 20,A01,083657,Tran; Khoa Dang,37,0,80,43
1656886677155,CSE 21,A01,095574,Bach; Quang Tran,21,0,48,27
1656886683182,CSE 30,A01,083084,Eldon; John,4,0,80,76
1656886683182,CSE 30,B01,095061,Bhaskar; Nishant,6,0,50,44
1656886689205,CSE 100,A01,083659,Cao; Yingjun,2,4,70,68
1656886695236,CSE 134B,A01,083661,Powell; Thomas Allan,19,0,100,81
1656886701261,CSE 140,A01,083663,Gungor; Onat,14,0,85,71
1656886707283,CSE 140L,A01,083088,Eldon; John,16,0,100,84
1656886713306,CSE 175,A01,083665,Kumar; Rakesh,3,0,25,22
1656886719329,CSE 190,A00,092507,Dubnov; Shlomo,7,0,20,13
1656886725352,ECE 45,A01,083139,Congero; Spencer William,5,0,75,70
1656886731385,ECE 65,A50,083695,Saad; Andrew S,12,0,30,18
1656886731385,ECE 65,A51,095125,Saad; Andrew S,25,0,26,1
1656886737410,ECE 109,A01,091882,Touri; Behrouz,16,0,70,54
1656886743439,ECE 180,A00,083140,Abi Samra; Nicholas Camill,0,0,30,30
1656886743439,ECE 180,B00,083141,Abi Samra; Nicholas Camill,0,0,30,30
1656886749467,MATH 10A,A01,083735,Patchell; Gregory David,1,0,30,29
1656886749467,MATH 10A,A02,083736,Patchell; Gregory David,20,0,30,10
1656886749467,MATH 10A,A03,083737,Patchell; Gregory David,15,0,30,15
1656886755496,MATH 10B,A01,083207,Lim; Seonhee,7,0,34,27
1656886755496,MATH 10B,A02,083208,Lim; Seonhee,9,0,35,26
1656886755496,MATH 10B,A03,093472,Lim; Seonhee,4,0,34,30
1656886755496,MATH 10B,B01,083739,Sinha; Shubham,9,0,30,21
1656886761526,MATH 18,A01,083743,Cinel; Cameron Alexander,6,0,30,24
1656886761526,MATH 18,A02,083744,Cinel; Cameron Alexander,15,0,30,15
1656886761526,MATH 18,A03,083745,Cinel; Cameron Alexander,8,0,30,22
1656886761526,MATH 18,B01,083748,Rideout; David Porter,4,0,37,33
1656886761526,MATH 18,B02,083749,Rideout; David Porter,3,0,36,33
1656886761526,MATH 18,B03,083750,Rideout; David Porter,2,0,37,35
1656886761526,MATH 18,B04,083751,Rideout; David Porter,5,0,36,31
1656886761526,MATH 18,B05,093473,Rideout; David Porter,4,0,36,32
1656886761526,MATH 18,B06,093474,Rideout; David Porter,5,0,36,31
1656886767553,MATH 20A,A01,083754,Zheng; Zequn,12,0,40,28
1656886773580,MATH 20B,A01,083756,Briones; Jor-el Thomas Caparas,1,0,36,35
1656886773580,MATH 20B,A02,083757,Briones; Jor-el Thomas Caparas,1,0,36,35
1656886773580,MATH 20B,A03,093475,Briones; Jor-el Thomas Caparas,0,0,36,36
1656886779609,MATH 20C,A01,083760,Briones; Jor-el Thomas Caparas,1,0,35,34
1656886779609,MATH 20C,A02,083761,Briones; Jor-el Thomas Caparas,8,0,35,27
1656886779609,MATH 20C,A03,093476,Briones; Jor-el Thomas Caparas,0,1,36,36
1656886779609,MATH 20C,B01,083762,Bach; Quang Tran,0,0,30,30
1656886785633,MATH 20D,A01,083765,Tran; Brian Kha,4,0,30,26
1656886785633,MATH 20D,A02,083766,Tran; Brian Kha,4,0,30,26
1656886785633,MATH 20D,A03,083767,Tran; Brian Kha,2,0,30,28
1656886791658,MATH 20E,A01,083771,Ganguly; Soumya,5,0,32,27
1656886791658,MATH 20E,A02,083772,Ganguly; Soumya,6,0,32,26
1656886791658,MATH 20E,B01,083773,Ciotti; Benjamin,18,0,35,17
1656886791658,MATH 20E,B02,083774,Ciotti; Benjamin,17,0,35,18
1656886797683,MATH 103A,A01,083777,Greenfeld; Be'Eri,2,0,36,34
1656886797683,MATH 103A,A02,083778,Greenfeld; Be'Eri,5,0,36,31
1656886797683,MATH 103A,A03,093561,Greenfeld; Be'Eri,4,0,36,32
1656886797683,MATH 103A,B01,083779,Greenfeld; Be'Eri,6,0,36,30
1656886797683,MATH 103A,B02,083780,Greenfeld; Be'Eri,2,0,36,34
1656886797683,MATH 103A,B03,093562,Greenfeld; Be'Eri,2,0,36,34
1656886803710,MATH 105,A01,085443,Carter; Anne Toulson,13,0,35,22
1656886803710,MATH 105,A02,093477,Carter; Anne Toulson,20,0,35,15
1656886809734,MATH 109,A01,083213,Ganzberger; Geoffrey Michael,2,0,34,32
1656886809734,MATH 109,A02,083214,Ganzberger; Geoffrey Michael,2,0,34,32
1656886809734,MATH 109,A03,093478,Ganzberger; Geoffrey Michael,1,0,34,33
1656886809734,MATH 109,B01,083215,Ganzberger; Geoffrey Michael,1,0,32,31
1656886809734,MATH 109,B02,083216,Ganzberger; Geoffrey Michael,1,0,32,31
1656886809734,MATH 109,B03,093479,Ganzberger; Geoffrey Michael,6,0,32,26
1656886815759,MATH 142A,A01,083219,Chow; Bennett,6,0,32,26
1656886815759,MATH 142A,A02,083220,Chow; Bennett,9,0,32,23
1656886815759,MATH 142A,A03,093480,Chow; Bennett,7,0,32,25
1656886815759,MATH 142A,B03,093481,Chow; Bennett,7,0,32,25
1656886815759,MATH 142A,B04,093558,Chow; Bennett,10,0,32,22
1656886815759,MATH 142A,B05,093559,Chow; Bennett,6,0,32,26
1656886821786,MATH 193A,A01,083224,Rotar; Vladimir,6,0,34,28
1656886821786,MATH 193A,A02,083225,Rotar; Vladimir,3,0,34,31
1656886821786,MATH 193A,A03,083781,Rotar; Vladimir,1,0,34,33
1656886821786,MATH 193A,A04,083782,Rotar; Vladimir,6,0,34,28
1656886821786,MATH 193A,A05,093482,Rotar; Vladimir,6,0,34,28
1656886827814,MATH 197,001,091859,McAuley; Julian John,9999,0,9999,0
1656886827814,MATH 197,002,095566,Kedlaya; Kiran S.,9997,0,9999,2
1656886827814,MATH 197,003,095567,Xiao; Ming,9999,0,9999,0
1656886827814,MATH 197,004,095571,Perols; Johan Lars,9998,0,9999,1
1656886834872,COGS 9,A01,083615,Shannon; Kyle Michael,6,0,75,69
1656886840894,COGS 11,A01,083617,Boyle; Mary E. T.,19,0,48,29
1656886846922,COGS 13,A01,083071,Bastos; Amalia Pinkusfeld,8,0,71,63
1656886852945,COGS 14A,A01,092681,Semenuks; Arturs,0,1,100,100
1656886858968,COGS 14B,A01,083073,Cheng; Tzu-Han,5,0,63,58
1656886864989,COGS 17,A01,092677,Semenuks; Arturs,4,0,81,77
1656886871012,COGS 100,A01,083619,Allen; Michael Gordon,15,0,70,55
1656886877033,COGS 101A,A01,083621,Davis; Joshua Daniel,9,0,68,59
1656886883056,COGS 101B,A01,091572,Allen; Michael Gordon,8,0,65,57
1656886889082,COGS 101C,A01,083625,Delgado; Tania,17,0,35,18
1656886895107,COGS 107A,A01,083627,Boyle; Mary E. T.,13,0,60,47
1656886901129,COGS 118A,A01,083075,Gupta; Anjum,15,0,76,61
1656886907151,CSE 3,A50,083646,Miranda; Gregory Joseph,22,0,50,28
1656886913180,CSE 8A,A50,083650,Miranda; Gregory Joseph,17,1,56,39
1656886919218,CSE 11,A01,083080,Cao; Yingjun,4,15,40,36
1656886939108,CSE 12,A01,083652,Krause-Levy; Sophia Louisa,20,1,120,100
1656886945137,CSE 15L,A01,083654,Morris; Justin Loren,8,0,50,42
1656886945137,CSE 15L,A02,083655,Morris; Justin Loren,8,0,50,42
1656886951167,CSE 20,A01,083657,Tran; Khoa Dang,37,0,80,43
1656886957194,CSE 21,A01,095574,Bach; Quang Tran,21,0,48,27
1656886963229,CSE 30,A01,083084,Eldon; John,4,0,80,76
1656886963229,CSE 30,B01,095061,Bhaskar; Nishant,6,0,50,44
1656886969256,CSE 100,A01,083659,Cao; Yingjun,2,4,70,68
1656886975303,CSE 134B,A01,083661,Powell; Thomas Allan,19,0,100,81
1656886981334,CSE 140,A01,083663,Gungor; Onat,14,0,85,71
1656886987360,CSE 140L,A01,083088,Eldon; John,16,0,100,84
1656886993383,CSE 175,A01,083665,Kumar; Rakesh,3,0,25,22
1656886999408,CSE 190,A00,092507,Dubnov; Shlomo,7,0,20,13
1656887005434,ECE 45,A01,083139,Congero; Spencer William,5,0,75,70
1656887011463,ECE 65,A50,083695,Saad; Andrew S,12,0,30,18
1656887011463,ECE 65,A51,095125,Saad; Andrew S,25,0,26,1
1656887017487,ECE 109,A01,091882,Touri; Behrouz,16,0,70,54
1656887023509,ECE 180,A00,083140,Abi Samra; Nicholas Camill,0,0,30,30
1656887023509,ECE 180,B00,083141,Abi Samra; Nicholas Camill,0,0,30,30
1656887029537,MATH 10A,A01,083735,Patchell; Gregory David,1,0,30,29
1656887029537,MATH 10A,A02,083736,Patchell; Gregory David,20,0,30,10
1656887029537,MATH 10A,A03,083737,Patchell; Gregory David,15,0,30,15
1656887035567,MATH 10B,A01,083207,Lim; Seonhee,7,0,34,27
1656887035567,MATH 10B,A02,083208,Lim; Seonhee,9,0,35,26
1656887035567,MATH 10B,A03,093472,Lim; Seonhee,4,0,34,30
1656887035567,MATH 10B,B01,083739,Sinha; Shubham,9,0,30,21
1656887041592,MATH 18,A01,083743,Cinel; Cameron Alexander,6,0,30,24
1656887041592,MATH 18,A02,083744,Cinel; Cameron Alexander,15,0,30,15
1656887041592,MATH 18,A03,083745,Cinel; Cameron Alexander,8,0,30,22
1656887041592,MATH 18,B01,083748,Rideout; David Porter,4,0,37,33
1656887041592,MATH 18,B02,083749,Rideout; David Porter,3,0,36,33
1656887041592,MATH 18,B03,083750,Rideout; David Porter,2,0,37,35
1656887041592,MATH 18,B04,083751,Rideout; David Porter,5,0,36,31
1656887041592,MATH 18,B05,093473,Rideout; David Porter,4,0,36,32
1656887041592,MATH 18,B06,093474,Rideout; David Porter,5,0,36,31
1656887047620,MATH 20A,A01,083754,Zheng; Zequn,12,0,40,28
1656887053647,MATH 20B,A01,083756,Briones; Jor-el Thomas Caparas,1,0,36,35
1656887053647,MATH 20B,A02,083757,Briones; Jor-el Thomas Caparas,1,0,36,35
1656887053647,MATH 20B,A03,093475,Briones; Jor-el Thomas Caparas,0,0,36,36
1656887059675,MATH 20C,A01,083760,Briones; Jor-el Thomas Caparas,1,0,35,34
1656887059675,MATH 20C,A02,083761,Briones; Jor-el Thomas Caparas,8,0,35,27
1656887059675,MATH 20C,A03,093476,Briones; Jor-el Thomas Caparas,0,1,36,36
1656887059675,MATH 20C,B01,083762,Bach; Quang Tran,0,0,30,30
1656887065707,MATH 20D,A01,083765,Tran; Brian Kha,4,0,30,26
1656887065707,MATH 20D,A02,083766,Tran; Brian Kha,4,0,30,26
1656887065707,MATH 20D,A03,083767,Tran; Brian Kha,2,0,30,28
1656887071735,MATH 20E,A01,083771,Ganguly; Soumya,5,0,32,27
1656887071735,MATH 20E,A02,083772,Ganguly; Soumya,6,0,32,26
1656887071735,MATH 20E,B01,083773,Ciotti; Benjamin,18,0,35,17
1656887071735,MATH 20E,B02,083774,Ciotti; Benjamin,17,0,35,18
1656887077757,MATH 103A,A01,083777,Greenfeld; Be'Eri,2,0,36,34
1656887077757,MATH 103A,A02,083778,Greenfeld; Be'Eri,5,0,36,31
1656887077757,MATH 103A,A03,093561,Greenfeld; Be'Eri,4,0,36,32
1656887077757,MATH 103A,B01,083779,Greenfeld; Be'Eri,6,0,36,30
1656887077757,MATH 103A,B02,083780,Greenfeld; Be'Eri,2,0,36,34
1656887077757,MATH 103A,B03,093562,Greenfeld; Be'Eri,2,0,36,34
1656887083779,MATH 105,A01,085443,Carter; Anne Toulson,13,0,35,22
1656887083779,MATH 105,A02,093477,Carter; Anne Toulson,20,0,35,15
1656887089800,MATH 109,A01,083213,Ganzberger; Geoffrey Michael,2,0,34,32
1656887089800,MATH 109,A02,083214,Ganzberger; Geoffrey Michael,2,0,34,32
1656887089800,MATH 109,A03,093478,Ganzberger; Geoffrey Michael,1,0,34,33
1656887089800,MATH 109,B01,083215,Ganzberger; Geoffrey Michael,1,0,32,31
1656887089800,MATH 109,B02,083216,Ganzberger; Geoffrey Michael,1,0,32,31
1656887089800,MATH 109,B03,093479,Ganzberger; Geoffrey Michael,6,0,32,26
1656887095828,MATH 142A,A01,083219,Chow; Bennett,6,0,32,26
1656887095828,MATH 142A,A02,083220,Chow; Bennett,9,0,32,23
1656887095828,MATH 142A,A03,093480,Chow; Bennett,7,0,32,25
1656887095828,MATH 142A,B03,093481,Chow; Bennett,7,0,32,25
1656887095828,MATH 142A,B04,093558,Chow; Bennett,10,0,32,22
1656887095828,MATH 142A,B05,093559,Chow; Bennett,6,0,32,26
1656887101867,MATH 193A,A01,083224,Rotar; Vladimir,6,0,34,28
1656887101867,MATH 193A,A02,083225,Rotar; Vladimir,3,0,34,31
1656887101867,MATH 193A,A03,083781,Rotar; Vladimir,1,0,34,33
1656887101867,MATH 193A,A04,083782,Rotar; Vladimir,6,0,34,28
1656887101867,MATH 193A,A05,093482,Rotar; Vladimir,6,0,34,28
1656887107889,MATH 197,001,091859,McAuley; Julian John,9999,0,9999,0
1656887107889,MATH 197,002,095566,Kedlaya; Kiran S.,9997,0,9999,2
1656887107889,MATH 197,003,095567,Xiao; Ming,9999,0,9999,0
1656887107889,MATH 197,004,095571,Perols; Johan Lars,9998,0,9999,1
1656887114942,COGS 9,A01,083615,Shannon; Kyle Michael,6,0,75,69
1656887120985,COGS 11,A01,083617,Boyle; Mary E. T.,19,0,48,29
1656887127017,COGS 13,A01,083071,Bastos; Amalia Pinkusfeld,8,0,71,63
1656887133044,COGS 14A,A01,092681,Semenuks; Arturs,0,1,100,100
1656887139068,COGS 14B,A01,083073,Cheng; Tzu-Han,5,0,63,58
1656887145090,COGS 17,A01,092677,Semenuks; Arturs,4,0,81,77
1656887151113,COGS 100,A01,083619,Allen; Michael Gordon,15,0,70,55
1656887157137,COGS 101A,A01,083621,Davis; Joshua Daniel,9,0,68,59
1656887163163,COGS 101B,A01,091572,Allen; Michael Gordon,8,0,65,57
1656887169190,COGS 101C,A01,083625,Delgado; Tania,17,0,35,18
1656887175216,COGS 107A,A01,083627,Boyle; Mary E. T.,13,0,60,47
1656887181252,COGS 118A,A01,083075,Gupta; Anjum,15,0,76,61
1656887187284,CSE 3,A50,083646,Miranda; Gregory Joseph,22,0,50,28
1656887193409,CSE 8A,A50,083650,Miranda; Gregory Joseph,17,1,56,39
1656887199433,CSE 11,A01,083080,Cao; Yingjun,4,15,40,36
1656887205457,CSE 12,A01,083652,Krause-Levy; Sophia Louisa,20,1,120,100
1656887211480,CSE 15L,A01,083654,Morris; Justin Loren,8,0,50,42
1656887211480,CSE 15L,A02,083655,Morris; Justin Loren,8,0,50,42
1656887217504,CSE 20,A01,083657,Tran; Khoa Dang,37,0,80,43
1656887223527,CSE 21,A01,095574,Bach; Quang Tran,21,0,48,27
1656887229565,CSE 30,A01,083084,Eldon; John,4,0,80,76
1656887229565,CSE 30,B01,095061,Bhaskar; Nishant,6,0,50,44
1656887235587,CSE 100,A01,083659,Cao; Yingjun,2,4,70,68
1656887241615,CSE 134B,A01,083661,Powell; Thomas Allan,19,0,100,81
1656887247638,CSE 140,A01,083663,Gungor; Onat,14,0,85,71
1656887253666,CSE 140L,A01,083088,Eldon; John,16,0,100,84
1656887259707,CSE 175,A01,083665,Kumar; Rakesh,3,0,25,22
1656887265732,CSE 190,A00,092507,Dubnov; Shlomo,7,0,20,13
1656887271757,ECE 45,A01,083139,Congero; Spencer William,5,0,75,70
1656887277783,ECE 65,A50,083695,Saad; Andrew S,12,0,30,18
1656887277783,ECE 65,A51,095125,Saad; Andrew S,25,0,26,1
1656887283809,ECE 109,A01,091882,Touri; Behrouz,16,0,70,54
1656887289836,ECE 180,A00,083140,Abi Samra; Nicholas Camill,0,0,30,30
1656887289836,ECE 180,B00,083141,Abi Samra; Nicholas Camill,0,0,30,30
1656887295859,MATH 10A,A01,083735,Patchell; Gregory David,1,0,30,29
1656887295859,MATH 10A,A02,083736,Patchell; Gregory David,20,0,30,10
1656887295859,MATH 10A,A03,083737,Patchell; Gregory David,15,0,30,15
1656887301881,MATH 10B,A01,083207,Lim; Seonhee,7,0,34,27
1656887301881,MATH 10B,A02,083208,Lim; Seonhee,9,0,35,26
1656887301881,MATH 10B,A03,093472,Lim; Seonhee,4,0,34,30
1656887301881,MATH 10B,B01,083739,Sinha; Shubham,9,0,30,21
1656887307907,MATH 18,A01,083743,Cinel; Cameron Alexander,6,0,30,24
1656887307907,MATH 18,A02,083744,Cinel; Cameron Alexander,15,0,30,15
1656887307907,MATH 18,A03,083745,Cinel; Cameron Alexander,8,0,30,22
1656887307907,MATH 18,B01,083748,Rideout; David Porter,4,0,37,33
1656887307907,MATH 18,B02,083749,Rideout; David Porter,3,0,36,33
1656887307907,MATH 18,B03,083750,Rideout; David Porter,2,0,37,35
1656887307907,MATH 18,B04,083751,Rideout; David Porter,5,0,36,31
1656887307907,MATH 18,B05,093473,Rideout; David Porter,4,0,36,32
1656887307907,MATH 18,B06,093474,Rideout; David Porter,5,0,36,31
1656887313955,MATH 20A,A01,083754,Zheng; Zequn,12,0,40,28
1656887319985,MATH 20B,A01,083756,Briones; Jor-el Thomas Caparas,1,0,36,35
1656887319985,MATH 20B,A02,083757,Briones; Jor-el Thomas Caparas,1,0,36,35
1656887319985,MATH 20B,A03,093475,Briones; Jor-el Thomas Caparas,0,0,36,36
1656887326022,MATH 20C,A01,083760,Briones; Jor-el Thomas Caparas,1,0,35,34
1656887326022,MATH 20C,A02,083761,Briones; Jor-el Thomas Caparas,8,0,35,27
1656887326022,MATH 20C,A03,093476,Briones; Jor-el Thomas Caparas,0,1,36,36
1656887326022,MATH 20C,B01,083762,Bach; Quang Tran,0,0,30,30
1656887332045,MATH 20D,A01,083765,Tran; Brian Kha,4,0,30,26
1656887332045,MATH 20D,A02,083766,Tran; Brian Kha,4,0,30,26
1656887332045,MATH 20D,A03,083767,Tran; Brian Kha,2,0,30,28
1656887338068,MATH 20E,A01,083771,Ganguly; Soumya,5,0,32,27
1656887338068,MATH 20E,A02,083772,Ganguly; Soumya,6,0,32,26
1656887338068,MATH 20E,B01,083773,Ciotti; Benjamin,18,0,35,17
1656887338068,MATH 20E,B02,083774,Ciotti; Benjamin,17,0,35,18
1656887344091,MATH 103A,A01,083777,Greenfeld; Be'Eri,2,0,36,34
1656887344091,MATH 103A,A02,083778,Greenfeld; Be'Eri,5,0,36,31
1656887344091,MATH 103A,A03,093561,Greenfeld; Be'Eri,4,0,36,32
1656887344091,MATH 103A,B01,083779,Greenfeld; Be'Eri,6,0,36,30
1656887344091,MATH 103A,B02,083780,Greenfeld; Be'Eri,2,0,36,34
1656887344091,MATH 103A,B03,093562,Greenfeld; Be'Eri,2,0,36,34
1656887350120,MATH 105,A01,085443,Carter; Anne Toulson,13,0,35,22
1656887350120,MATH 105,A02,093477,Carter; Anne Toulson,20,0,35,15
1656887356142,MATH 109,A01,083213,Ganzberger; Geoffrey Michael,2,0,34,32
1656887356142,MATH 109,A02,083214,Ganzberger; Geoffrey Michael,2,0,34,32
1656887356142,MATH 109,A03,093478,Ganzberger; Geoffrey Michael,1,0,34,33
1656887356142,MATH 109,B01,083215,Ganzberger; Geoffrey Michael,1,0,32,31
1656887356142,MATH 109,B02,083216,Ganzberger; Geoffrey Michael,1,0,32,31
1656887356142,MATH 109,B03,093479,Ganzberger; Geoffrey Michael,6,0,32,26
1656887362169,MATH 142A,A01,083219,Chow; Bennett,6,0,32,26
1656887362169,MATH 142A,A02,083220,Chow; Bennett,9,0,32,23
1656887362169,MATH 142A,A03,093480,Chow; Bennett,7,0,32,25
1656887362169,MATH 142A,B03,093481,Chow; Bennett,7,0,32,25
1656887362169,MATH 142A,B04,093558,Chow; Bennett,10,0,32,22
1656887362169,MATH 142A,B05,093559,Chow; Bennett,6,0,32,26
1656887368196,MATH 193A,A01,083224,Rotar; Vladimir,6,0,34,28
1656887368196,MATH 193A,A02,083225,Rotar; Vladimir,3,0,34,31
1656887368196,MATH 193A,A03,083781,Rotar; Vladimir,1,0,34,33
1656887368196,MATH 193A,A04,083782,Rotar; Vladimir,6,0,34,28
1656887368196,MATH 193A,A05,093482,Rotar; Vladimir,6,0,34,28
1656887374241,MATH 197,001,091859,McAuley; Julian John,9999,0,9999,0
1656887374241,MATH 197,002,095566,Kedlaya; Kiran S.,9997,0,9999,2
1656887374241,MATH 197,003,095567,Xiao; Ming,9999,0,9999,0
1656887374241,MATH 197,004,095571,Perols; Johan Lars,9998,0,9999,1
1656887381295,COGS 9,A01,083615,Shannon; Kyle Michael,6,0,75,69
1656887387318,COGS 11,A01,083617,Boyle; Mary E. T.,19,0,48,29
1656887393345,COGS 13,A01,083071,Bastos; Amalia Pinkusfeld,8,0,71,63
1656887399371,COGS 14A,A01,092681,Semenuks; Arturs,0,1,100,100
1656887405398,COGS 14B,A01,083073,Cheng; Tzu-Han,5,0,63,58
1656887411424,COGS 17,A01,092677,Semenuks; Arturs,4,0,81,77
1656887417456,COGS 100,A01,083619,Allen; Michael Gordon,15,0,70,55
1656887423480,COGS 101A,A01,083621,Davis; Joshua Daniel,9,0,68,59
1656887429503,COGS 101B,A01,091572,Allen; Michael Gordon,8,0,65,57
1656887435525,COGS 101C,A01,083625,Delgado; Tania,17,0,35,18
1656887441552,COGS 107A,A01,083627,Boyle; Mary E. T.,13,0,60,47
1656887447575,COGS 118A,A01,083075,Gupta; Anjum,15,0,76,61
1656887453614,CSE 3,A50,083646,Miranda; Gregory Joseph,22,0,50,28
1656887459648,CSE 8A,A50,083650,Miranda; Gregory Joseph,17,1,56,39
1656887465672,CSE 11,A01,083080,Cao; Yingjun,4,15,40,36
1656887471695,CSE 12,A01,083652,Krause-Levy; Sophia Louisa,20,1,120,100
1656887477722,CSE 15L,A01,083654,Morris; Justin Loren,8,0,50,42
1656887477722,CSE 15L,A02,083655,Morris; Justin Loren,8,0,50,42
1656887483749,CSE 20,A01,083657,Tran; Khoa Dang,37,0,80,43
1656887489781,CSE 21,A01,095574,Bach; Quang Tran,21,0,48,27
1656887495805,CSE 30,A01,083084,Eldon; John,4,0,80,76
1656887495805,CSE 30,B01,095061,Bhaskar; Nishant,6,0,50,44
1656887501832,CSE 100,A01,083659,Cao; Yingjun,2,4,70,68
1656887507855,CSE 134B,A01,083661,Powell; Thomas Allan,19,0,100,81
1656887513882,CSE 140,A01,083663,Gungor; Onat,14,0,85,71
1656887519910,CSE 140L,A01,083088,Eldon; John,16,0,100,84
1656887525936,CSE 175,A01,083665,Kumar; Rakesh,3,0,25,22
1656887531961,CSE 190,A00,092507,Dubnov; Shlomo,7,0,20,13
1656887537988,ECE 45,A01,083139,Congero; Spencer William,5,0,75,70
1656887544015,ECE 65,A50,083695,Saad; Andrew S,12,0,30,18
1656887544015,ECE 65,A51,095125,Saad; Andrew S,25,0,26,1
1656887550042,ECE 109,A01,091882,Touri; Behrouz,16,0,70,54
1656887556066,ECE 180,A00,083140,Abi Samra; Nicholas Camill,0,0,30,30
1656887556066,ECE 180,B00,083141,Abi Samra; Nicholas Camill,0,0,30,30
1656887562094,MATH 10A,A01,083735,Patchell; Gregory David,1,0,30,29
1656887562094,MATH 10A,A02,083736,Patchell; Gregory David,20,0,30,10
1656887562094,MATH 10A,A03,083737,Patchell; Gregory David,15,0,30,15
1656887568122,MATH 10B,A01,083207,Lim; Seonhee,7,0,34,27
1656887568122,MATH 10B,A02,083208,Lim; Seonhee,9,0,35,26
1656887568122,MATH 10B,A03,093472,Lim; Seonhee,4,0,34,30
1656887568122,MATH 10B,B01,083739,Sinha; Shubham,9,0,30,21
1656887574152,MATH 18,A01,083743,Cinel; Cameron Alexander,6,0,30,24
1656887574152,MATH 18,A02,083744,Cinel; Cameron Alexander,15,0,30,15
1656887574152,MATH 18,A03,083745,Cinel; Cameron Alexander,8,0,30,22
1656887574152,MATH 18,B01,083748,Rideout; David Porter,4,0,37,33
1656887574152,MATH 18,B02,083749,Rideout; David Porter,3,0,36,33
1656887574152,MATH 18,B03,083750,Rideout; David Porter,2,0,37,35
1656887574152,MATH 18,B04,083751,Rideout; David Porter,5,0,36,31
1656887574152,MATH 18,B05,093473,Rideout; David Porter,4,0,36,32
1656887574152,MATH 18,B06,093474,Rideout; David Porter,5,0,36,31
1656887580188,MATH 20A,A01,083754,Zheng; Zequn,12,0,40,28
1656887586228,MATH 20B,A01,083756,Briones; Jor-el Thomas Caparas,1,0,36,35
1656887586228,MATH 20B,A02,083757,Briones; Jor-el Thomas Caparas,1,0,36,35
1656887586228,MATH 20B,A03,093475,Briones; Jor-el Thomas Caparas,0,0,36,36
1656887592251,MATH 20C,A01,083760,Briones; Jor-el Thomas Caparas,1,0,35,34
1656887592251,MATH 20C,A02,083761,Briones; Jor-el Thomas Caparas,8,0,35,27
1656887592251,MATH 20C,A03,093476,Briones; Jor-el Thomas Caparas,0,1,36,36
1656887592251,MATH 20C,B01,083762,Bach; Quang Tran,0,0,30,30
1656887598277,MATH 20D,A01,083765,Tran; Brian Kha,4,0,30,26
1656887598277,MATH 20D,A02,083766,Tran; Brian Kha,4,0,30,26
1656887598277,MATH 20D,A03,083767,Tran; Brian Kha,2,0,30,28
1656887604312,MATH 20E,A01,083771,Ganguly; Soumya,5,0,32,27
1656887604312,MATH 20E,A02,083772,Ganguly; Soumya,6,0,32,26
1656887604312,MATH 20E,B01,083773,Ciotti; Benjamin,18,0,35,17
1656887604312,MATH 20E,B02,083774,Ciotti; Benjamin,17,0,35,18
1656887610344,MATH 103A,A01,083777,Greenfeld; Be'Eri,2,0,36,34
1656887610344,MATH 103A,A02,083778,Greenfeld; Be'Eri,5,0,36,31
1656887610344,MATH 103A,A03,093561,Greenfeld; Be'Eri,4,0,36,32
1656887610344,MATH 103A,B01,083779,Greenfeld; Be'Eri,6,0,36,30
1656887610344,MATH 103A,B02,083780,Greenfeld; Be'Eri,2,0,36,34
1656887610344,MATH 103A,B03,093562,Greenfeld; Be'Eri,2,0,36,34
1656887616367,MATH 105,A01,085443,Carter; Anne Toulson,13,0,35,22
1656887616367,MATH 105,A02,093477,Carter; Anne Toulson,20,0,35,15
1656887622395,MATH 109,A01,083213,Ganzberger; Geoffrey Michael,2,0,34,32
1656887622395,MATH 109,A02,083214,Ganzberger; Geoffrey Michael,2,0,34,32
1656887622395,MATH 109,A03,093478,Ganzberger; Geoffrey Michael,1,0,34,33
1656887622395,MATH 109,B01,083215,Ganzberger; Geoffrey Michael,1,0,32,31
1656887622395,MATH 109,B02,083216,Ganzberger; Geoffrey Michael,1,0,32,31
1656887622395,MATH 109,B03,093479,Ganzberger; Geoffrey Michael,6,0,32,26
1656887628425,MATH 142A,A01,083219,Chow; Bennett,6,0,32,26
1656887628425,MATH 142A,A02,083220,Chow; Bennett,9,0,32,23
1656887628425,MATH 142A,A03,093480,Chow; Bennett,7,0,32,25
1656887628425,MATH 142A,B03,093481,Chow; Bennett,7,0,32,25
1656887628425,MATH 142A,B04,093558,Chow; Bennett,10,0,32,22
1656887628425,MATH 142A,B05,093559,Chow; Bennett,6,0,32,26
1656887634454,MATH 193A,A01,083224,Rotar; Vladimir,6,0,34,28
1656887634454,MATH 193A,A02,083225,Rotar; Vladimir,3,0,34,31
1656887634454,MATH 193A,A03,083781,Rotar; Vladimir,1,0,34,33
1656887634454,MATH 193A,A04,083782,Rotar; Vladimir,6,0,34,28
1656887634454,MATH 193A,A05,093482,Rotar; Vladimir,6,0,34,28
1656887640482,MATH 197,001,091859,McAuley; Julian John,9999,0,9999,0
1656887640482,MATH 197,002,095566,Kedlaya; Kiran S.,9997,0,9999,2
1656887640482,MATH 197,003,095567,Xiao; Ming,9999,0,9999,0
1656887640482,MATH 197,004,095571,Perols; Johan Lars,9998,0,9999,1
1656887647537,COGS 9,A01,083615,Shannon; Kyle Michael,6,0,75,69
1656887653560,COGS 11,A01,083617,Boyle; Mary E. T.,19,0,48,29
1656887659584,COGS 13,A01,083071,Bastos; Amalia Pinkusfeld,8,0,71,63
1656887665609,COGS 14A,A01,092681,Semenuks; Arturs,0,1,100,100
1656887671632,COGS 14B,A01,083073,Cheng; Tzu-Han,5,0,63,58
1656887677661,COGS 17,A01,092677,Semenuks; Arturs,4,0,81,77
1656887683684,COGS 100,A01,083619,Allen; Michael Gordon,15,0,70,55
1656887689707,COGS 101A,A01,083621,Davis; Joshua Daniel,9,0,68,59
1656887695733,COGS 101B,A01,091572,Allen; Michael Gordon,8,0,65,57
1656887701759,COGS 101C,A01,083625,Delgado; Tania,17,0,35,18
1656887707781,COGS 107A,A01,083627,Boyle; Mary E. T.,13,0,60,47
1656887713815,COGS 118A,A01,083075,Gupta; Anjum,15,0,76,61
1656887719842,CSE 3,A50,083646,Miranda; Gregory Joseph,22,0,50,28
1656887725866,CSE 8A,A50,083650,Miranda; Gregory Joseph,17,1,56,39
1656887731889,CSE 11,A01,083080,Cao; Yingjun,4,15,40,36
1656887737913,CSE 12,A01,083652,Krause-Levy; Sophia Louisa,20,1,120,100
1656887743935,CSE 15L,A01,083654,Morris; Justin Loren,8,0,50,42
1656887743935,CSE 15L,A02,083655,Morris; Justin Loren,8,0,50,42
1656887749962,CSE 20,A01,083657,Tran; Khoa Dang,37,0,80,43
1656887755985,CSE 21,A01,095574,Bach; Quang Tran,21,0,48,27
1656887762007,CSE 30,A01,083084,Eldon; John,4,0,80,76
1656887762007,CSE 30,B01,095061,Bhaskar; Nishant,6,0,50,44
1656887768030,CSE 100,A01,083659,Cao; Yingjun,2,4,70,68
1656887774057,CSE 134B,A01,083661,Powell; Thomas Allan,19,0,100,81
1656887780082,CSE 140,A01,083663,Gungor; Onat,14,0,85,71
1656887786106,CSE 140L,A01,083088,Eldon; John,16,0,100,84
1656887792218,CSE 175,A01,083665,Kumar; Rakesh,3,0,25,22
1656887798240,CSE 190,A00,092507,Dubnov; Shlomo,7,0,20,13
1656887804263,ECE 45,A01,083139,Congero; Spencer William,5,0,75,70
1656887810291,ECE 65,A50,083695,Saad; Andrew S,12,0,30,18
1656887810291,ECE 65,A51,095125,Saad; Andrew S,25,0,26,1
1656887816314,ECE 109,A01,091882,Touri; Behrouz,16,0,70,54
1656887822340,ECE 180,A00,083140,Abi Samra; Nicholas Camill,0,0,30,30
1656887822340,ECE 180,B00,083141,Abi Samra; Nicholas Camill,0,0,30,30
1656887828365,MATH 10A,A01,083735,Patchell; Gregory David,1,0,30,29
1656887828365,MATH 10A,A02,083736,Patchell; Gregory David,20,0,30,10
1656887828365,MATH 10A,A03,083737,Patchell; Gregory David,15,0,30,15
1656887834393,MATH 10B,A01,083207,Lim; Seonhee,7,0,34,27
1656887834393,MATH 10B,A02,083208,Lim; Seonhee,9,0,35,26
1656887834393,MATH 10B,A03,093472,Lim; Seonhee,4,0,34,30
1656887834393,MATH 10B,B01,083739,Sinha; Shubham,9,0,30,21
1656887840418,MATH 18,A01,083743,Cinel; Cameron Alexander,6,0,30,24
1656887840418,MATH 18,A02,083744,Cinel; Cameron Alexander,15,0,30,15
1656887840418,MATH 18,A03,083745,Cinel; Cameron Alexander,8,0,30,22
1656887840418,MATH 18,B01,083748,Rideout; David Porter,4,0,37,33
1656887840418,MATH 18,B02,083749,Rideout; David Porter,3,0,36,33
1656887840418,MATH 18,B03,083750,Rideout; David Porter,2,0,37,35
1656887840418,MATH 18,B04,083751,Rideout; David Porter,5,0,36,31
1656887840418,MATH 18,B05,093473,Rideout; David Porter,4,0,36,32
1656887840418,MATH 18,B06,093474,Rideout; David Porter,5,0,36,31
1656887846442,MATH 20A,A01,083754,Zheng; Zequn,12,0,40,28
1656887852466,MATH 20B,A01,083756,Briones; Jor-el Thomas Caparas,1,0,36,35
1656887852466,MATH 20B,A02,083757,Briones; Jor-el Thomas Caparas,1,0,36,35
1656887852466,MATH 20B,A03,093475,Briones; Jor-el Thomas Caparas,0,0,36,36
1656887858498,MATH 20C,A01,083760,Briones; Jor-el Thomas Caparas,1,0,35,34
1656887858498,MATH 20C,A02,083761,Briones; Jor-el Thomas Caparas,8,0,35,27
1656887858498,MATH 20C,A03,093476,Briones; Jor-el Thomas Caparas,0,1,36,36
1656887858498,MATH 20C,B01,083762,Bach; Quang Tran,0,0,30,30
1656887864522,MATH 20D,A01,083765,Tran; Brian Kha,4,0,30,26
1656887864522,MATH 20D,A02,083766,Tran; Brian Kha,4,0,30,26
1656887864522,MATH 20D,A03,083767,Tran; Brian Kha,2,0,30,28
1656887870565,MATH 20E,A01,083771,Ganguly; Soumya,5,0,32,27
1656887870565,MATH 20E,A02,083772,Ganguly; Soumya,6,0,32,26
1656887870565,MATH 20E,B01,083773,Ciotti; Benjamin,18,0,35,17
1656887870565,MATH 20E,B02,083774,Ciotti; Benjamin,17,0,35,18
1656887876589,MATH 103A,A01,083777,Greenfeld; Be'Eri,2,0,36,34
1656887876589,MATH 103A,A02,083778,Greenfeld; Be'Eri,5,0,36,31
1656887876589,MATH 103A,A03,093561,Greenfeld; Be'Eri,4,0,36,32
1656887876589,MATH 103A,B01,083779,Greenfeld; Be'Eri,6,0,36,30
1656887876589,MATH 103A,B02,083780,Greenfeld; Be'Eri,2,0,36,34
1656887876589,MATH 103A,B03,093562,Greenfeld; Be'Eri,2,0,36,34
1656887882613,MATH 105,A01,085443,Carter; Anne Toulson,13,0,35,22
1656887882613,MATH 105,A02,093477,Carter; Anne Toulson,20,0,35,15
1656887888643,MATH 109,A01,083213,Ganzberger; Geoffrey Michael,2,0,34,32
1656887888643,MATH 109,A02,083214,Ganzberger; Geoffrey Michael,2,0,34,32
1656887888643,MATH 109,A03,093478,Ganzberger; Geoffrey Michael,1,0,34,33
1656887888643,MATH 109,B01,083215,Ganzberger; Geoffrey Michael,1,0,32,31
1656887888643,MATH 109,B02,083216,Ganzberger; Geoffrey Michael,1,0,32,31
1656887888643,MATH 109,B03,093479,Ganzberger; Geoffrey Michael,6,0,32,26
1656887894667,MATH 142A,A01,083219,Chow; Bennett,6,0,32,26
1656887894667,MATH 142A,A02,083220,Chow; Bennett,9,0,32,23
1656887894667,MATH 142A,A03,093480,Chow; Bennett,7,0,32,25
1656887894667,MATH 142A,B03,093481,Chow; Bennett,7,0,32,25
1656887894667,MATH 142A,B04,093558,Chow; Bennett,10,0,32,22
1656887894667,MATH 142A,B05,093559,Chow; Bennett,6,0,32,26
1656887900690,MATH 193A,A01,083224,Rotar; Vladimir,6,0,34,28
1656887900690,MATH 193A,A02,083225,Rotar; Vladimir,3,0,34,31
1656887900690,MATH 193A,A03,083781,Rotar; Vladimir,1,0,34,33
1656887900690,MATH 193A,A04,083782,Rotar; Vladimir,6,0,34,28
1656887900690,MATH 193A,A05,093482,Rotar; Vladimir,6,0,34,28
1656887906718,MATH 197,001,091859,McAuley; Julian John,9999,0,9999,0
1656887906718,MATH 197,002,095566,Kedlaya; Kiran S.,9997,0,9999,2
1656887906718,MATH 197,003,095567,Xiao; Ming,9999,0,9999,0
1656887906718,MATH 197,004,095571,Perols; Johan Lars,9998,0,9999,1
1656887913779,COGS 9,A01,083615,Shannon; Kyle Michael,6,0,75,69
1656887919808,COGS 11,A01,083617,Boyle; Mary E. T.,19,0,48,29
1656887925831,COGS 13,A01,083071,Bastos; Amalia Pinkusfeld,8,0,71,63
1656887931857,COGS 14A,A01,092681,Semenuks; Arturs,0,1,100,100
1656887937890,COGS 14B,A01,083073,Cheng; Tzu-Han,5,0,63,58
1656887943912,COGS 17,A01,092677,Semenuks; Arturs,4,0,81,77
1656887949936,COGS 100,A01,083619,Allen; Michael Gordon,15,0,70,55
1656887955962,COGS 101A,A01,083621,Davis; Joshua Daniel,9,0,68,59
1656887961988,COGS 101B,A01,091572,Allen; Michael Gordon,8,0,65,57
1656887968014,COGS 101C,A01,083625,Delgado; Tania,17,0,35,18
1656887974041,COGS 107A,A01,083627,Boyle; Mary E. T.,13,0,60,47
1656887980081,COGS 118A,A01,083075,Gupta; Anjum,15,0,76,61
1656887986108,CSE 3,A50,083646,Miranda; Gregory Joseph,22,0,50,28
1656887992135,CSE 8A,A50,083650,Miranda; Gregory Joseph,17,1,56,39
1656887998157,CSE 11,A01,083080,Cao; Yingjun,4,15,40,36
1656888004180,CSE 12,A01,083652,Krause-Levy; Sophia Louisa,20,1,120,100
1656888010212,CSE 15L,A01,083654,Morris; Justin Loren,8,0,50,42
1656888010212,CSE 15L,A02,083655,Morris; Justin Loren,8,0,50,42
1656888016235,CSE 20,A01,083657,Tran; Khoa Dang,37,0,80,43
1656888022259,CSE 21,A01,095574,Bach; Quang Tran,21,0,48,27
1656888028284,CSE 30,A01,083084,Eldon; John,4,0,80,76
1656888028284,CSE 30,B01,095061,Bhaskar; Nishant,6,0,50,44
1656888034307,CSE 100,A01,083659,Cao; Yingjun,2,4,70,68
1656888040331,CSE 134B,A01,083661,Powell; Thomas Allan,19,0,100,81
1656888046355,CSE 140,A01,083663,Gungor; Onat,14,0,85,71
1656888052387,CSE 140L,A01,083088,Eldon; John,16,0,100,84
1656888058413,CSE 175,A01,083665,Kumar; Rakesh,3,0,25,22
1656888064436,CSE 190,A00,092507,Dubnov; Shlomo,7,0,20,13
1656888070462,ECE 45,A01,083139,Congero; Spencer William,5,0,75,70
1656888076485,ECE 65,A50,083695,Saad; Andrew S,12,0,30,18
1656888076485,ECE 65,A51,095125,Saad; Andrew S,25,0,26,1
1656888082508,ECE 109,A01,091882,Touri; Behrouz,16,0,70,54
1656888088533,ECE 180,A00,083140,Abi Samra; Nicholas Camill,0,0,30,30
1656888088533,ECE 180,B00,083141,Abi Samra; Nicholas Camill,0,0,30,30
1656888094562,MATH 10A,A01,083735,Patchell; Gregory David,1,0,30,29
1656888094562,MATH 10A,A02,083736,Patchell; Gregory David,20,0,30,10
1656888094562,MATH 10A,A03,083737,Patchell; Gregory David,15,0,30,15
1656888100585,MATH 10B,A01,083207,Lim; Seonhee,7,0,34,27
1656888100585,MATH 10B,A02,083208,Lim; Seonhee,9,0,35,26
1656888100585,MATH 10B,A03,093472,Lim; Seonhee,4,0,34,30
1656888100585,MATH 10B,B01,083739,Sinha; Shubham,9,0,30,21
1656888106617,MATH 18,A01,083743,Cinel; Cameron Alexander,6,0,30,24
1656888106617,MATH 18,A02,083744,Cinel; Cameron Alexander,15,0,30,15
1656888106617,MATH 18,A03,083745,Cinel; Cameron Alexander,8,0,30,22
1656888106617,MATH 18,B01,083748,Rideout; David Porter,4,0,37,33
1656888106617,MATH 18,B02,083749,Rideout; David Porter,3,0,36,33
1656888106617,MATH 18,B03,083750,Rideout; David Porter,2,0,37,35
1656888106617,MATH 18,B04,083751,Rideout; David Porter,5,0,36,31
1656888106617,MATH 18,B05,093473,Rideout; David Porter,4,0,36,32
1656888106617,MATH 18,B06,093474,Rideout; David Porter,5,0,36,31
1656888112643,MATH 20A,A01,083754,Zheng; Zequn,12,0,40,28
1656888118669,MATH 20B,A01,083756,Briones; Jor-el Thomas Caparas,1,0,36,35
1656888118669,MATH 20B,A02,083757,Briones; Jor-el Thomas Caparas,1,0,36,35
1656888118669,MATH 20B,A03,093475,Briones; Jor-el Thomas Caparas,0,0,36,36
1656888124692,MATH 20C,A01,083760,Briones; Jor-el Thomas Caparas,1,0,35,34
1656888124692,MATH 20C,A02,083761,Briones; Jor-el Thomas Caparas,8,0,35,27
1656888124692,MATH 20C,A03,093476,Briones; Jor-el Thomas Caparas,0,1,36,36
1656888124692,MATH 20C,B01,083762,Bach; Quang Tran,0,0,30,30
1656888130727,MATH 20D,A01,083765,Tran; Brian Kha,4,0,30,26
1656888130727,MATH 20D,A02,083766,Tran; Brian Kha,4,0,30,26
1656888130727,MATH 20D,A03,083767,Tran; Brian Kha,2,0,30,28
1656888136757,MATH 20E,A01,083771,Ganguly; Soumya,5,0,32,27
1656888136757,MATH 20E,A02,083772,Ganguly; Soumya,6,0,32,26
1656888136757,MATH 20E,B01,083773,Ciotti; Benjamin,18,0,35,17
1656888136757,MATH 20E,B02,083774,Ciotti; Benjamin,17,0,35,18
1656888142782,MATH 103A,A01,083777,Greenfeld; Be'Eri,2,0,36,34
1656888142782,MATH 103A,A02,083778,Greenfeld; Be'Eri,5,0,36,31
1656888142782,MATH 103A,A03,093561,Greenfeld; Be'Eri,4,0,36,32
1656888142782,MATH 103A,B01,083779,Greenfeld; Be'Eri,6,0,36,30
1656888142782,MATH 103A,B02,083780,Greenfeld; Be'Eri,2,0,36,34
1656888142782,MATH 103A,B03,093562,Greenfeld; Be'Eri,2,0,36,34
1656888148811,MATH 105,A01,085443,Carter; Anne Toulson,13,0,35,22
1656888148811,MATH 105,A02,093477,Carter; Anne Toulson,20,0,35,15
1656888154842,MATH 109,A01,083213,Ganzberger; Geoffrey Michael,2,0,34,32
1656888154842,MATH 109,A02,083214,Ganzberger; Geoffrey Michael,2,0,34,32
1656888154842,MATH 109,A03,093478,Ganzberger; Geoffrey Michael,1,0,34,33
1656888154842,MATH 109,B01,083215,Ganzberger; Geoffrey Michael,1,0,32,31
1656888154842,MATH 109,B02,083216,Ganzberger; Geoffrey Michael,1,0,32,31
1656888154842,MATH 109,B03,093479,Ganzberger; Geoffrey Michael,6,0,32,26
1656888160870,MATH 142A,A01,083219,Chow; Bennett,6,0,32,26
1656888160870,MATH 142A,A02,083220,Chow; Bennett,9,0,32,23
1656888160870,MATH 142A,A03,093480,Chow; Bennett,7,0,32,25
1656888160870,MATH 142A,B03,093481,Chow; Bennett,7,0,32,25
1656888160870,MATH 142A,B04,093558,Chow; Bennett,10,0,32,22
1656888160870,MATH 142A,B05,093559,Chow; Bennett,6,0,32,26
1656888166898,MATH 193A,A01,083224,Rotar; Vladimir,6,0,34,28
1656888166898,MATH 193A,A02,083225,Rotar; Vladimir,3,0,34,31
1656888166898,MATH 193A,A03,083781,Rotar; Vladimir,1,0,34,33
1656888166898,MATH 193A,A04,083782,Rotar; Vladimir,6,0,34,28
1656888166898,MATH 193A,A05,093482,Rotar; Vladimir,6,0,34,28
1656888172924,MATH 197,001,091859,McAuley; Julian John,9999,0,9999,0
1656888172924,MATH 197,002,095566,Kedlaya; Kiran S.,9997,0,9999,2
1656888172924,MATH 197,003,095567,Xiao; Ming,9999,0,9999,0
1656888172924,MATH 197,004,095571,Perols; Johan Lars,9998,0,9999,1
1656888179997,COGS 9,A01,083615,Shannon; Kyle Michael,6,0,75,69
1656888186025,COGS 11,A01,083617,Boyle; Mary E. T.,19,0,48,29
1656888192048,COGS 13,A01,083071,Bastos; Amalia Pinkusfeld,8,0,71,63
1656888198071,COGS 14A,A01,092681,Semenuks; Arturs,0,1,100,100
1656888204093,COGS 14B,A01,083073,Cheng; Tzu-Han,5,0,63,58
1656888210119,COGS 17,A01,092677,Semenuks; Arturs,4,0,81,77
1656888216144,COGS 100,A01,083619,Allen; Michael Gordon,15,0,70,55
1656888222166,COGS 101A,A01,083621,Davis; Joshua Daniel,9,0,68,59
1656888228201,COGS 101B,A01,091572,Allen; Michael Gordon,8,0,65,57
1656888234229,COGS 101C,A01,083625,Delgado; Tania,17,0,35,18
1656888240260,COGS 107A,A01,083627,Boyle; Mary E. T.,13,0,60,47
1656888246286,COGS 118A,A01,083075,Gupta; Anjum,15,0,76,61
1656888252310,CSE 3,A50,083646,Miranda; Gregory Joseph,22,0,50,28
1656888258336,CSE 8A,A50,083650,Miranda; Gregory Joseph,17,1,56,39
1656888264359,CSE 11,A01,083080,Cao; Yingjun,4,15,40,36
1656888270382,CSE 12,A01,083652,Krause-Levy; Sophia Louisa,20,1,120,100
1656888276405,CSE 15L,A01,083654,Morris; Justin Loren,8,0,50,42
1656888276405,CSE 15L,A02,083655,Morris; Justin Loren,8,0,50,42
1656888282430,CSE 20,A01,083657,Tran; Khoa Dang,37,0,80,43
1656888288454,CSE 21,A01,095574,Bach; Quang Tran,21,0,48,27
1656888294480,CSE 30,A01,083084,Eldon; John,4,0,80,76
1656888294480,CSE 30,B01,095061,Bhaskar; Nishant,6,0,50,44
1656888300503,CSE 100,A01,083659,Cao; Yingjun,2,4,70,68
1656888306538,CSE 134B,A01,083661,Powell; Thomas Allan,19,0,100,81
1656888312560,CSE 140,A01,083663,Gungor; Onat,14,0,85,71
1656888318584,CSE 140L,A01,083088,Eldon; John,16,0,100,84
1656888324606,CSE 175,A01,083665,Kumar; Rakesh,3,0,25,22
1656888330633,CSE 190,A00,092507,Dubnov; Shlomo,7,0,20,13
1656888336656,ECE 45,A01,083139,Congero; Spencer William,5,0,75,70
1656888342679,ECE 65,A50,083695,Saad; Andrew S,12,0,30,18
1656888342679,ECE 65,A51,095125,Saad; Andrew S,25,0,26,1
1656888348707,ECE 109,A01,091882,Touri; Behrouz,16,0,70,54
1656888354730,ECE 180,A00,083140,Abi Samra; Nicholas Camill,0,0,30,30
1656888354730,ECE 180,B00,083141,Abi Samra; Nicholas Camill,0,0,30,30
1656888360758,MATH 10A,A01,083735,Patchell; Gregory David,1,0,30,29
1656888360758,MATH 10A,A02,083736,Patchell; Gregory David,20,0,30,10
1656888360758,MATH 10A,A03,083737,Patchell; Gregory David,15,0,30,15
1656888366782,MATH 10B,A01,083207,Lim; Seonhee,7,0,34,27
1656888366782,MATH 10B,A02,083208,Lim; Seonhee,9,0,35,26
1656888366782,MATH 10B,A03,093472,Lim; Seonhee,4,0,34,30
1656888366782,MATH 10B,B01,083739,Sinha; Shubham,9,0,30,21
1656888372827,MATH 18,A01,083743,Cinel; Cameron Alexander,6,0,30,24
1656888372827,MATH 18,A02,083744,Cinel; Cameron Alexander,15,0,30,15
1656888372827,MATH 18,A03,083745,Cinel; Cameron Alexander,8,0,30,22
1656888372827,MATH 18,B01,083748,Rideout; David Porter,4,0,37,33
1656888372827,MATH 18,B02,083749,Rideout; David Porter,3,0,36,33
1656888372827,MATH 18,B03,083750,Rideout; David Porter,2,0,37,35
1656888372827,MATH 18,B04,083751,Rideout; David Porter,5,0,36,31
1656888372827,MATH 18,B05,093473,Rideout; David Porter,4,0,36,32
1656888372827,MATH 18,B06,093474,Rideout; David Porter,5,0,36,31
1656888378854,MATH 20A,A01,083754,Zheng; Zequn,12,0,40,28
1656888384883,MATH 20B,A01,083756,Briones; Jor-el Thomas Caparas,1,0,36,35
1656888384883,MATH 20B,A02,083757,Briones; Jor-el Thomas Caparas,1,0,36,35
1656888384883,MATH 20B,A03,093475,Briones; Jor-el Thomas Caparas,0,0,36,36
1656888390984,MATH 20C,A01,083760,Briones; Jor-el Thomas Caparas,1,0,35,34
1656888390984,MATH 20C,A02,083761,Briones; Jor-el Thomas Caparas,8,0,35,27
1656888390984,MATH 20C,A03,093476,Briones; Jor-el Thomas Caparas,0,1,36,36
1656888390984,MATH 20C,B01,083762,Bach; Quang Tran,0,0,30,30
1656888397012,MATH 20D,A01,083765,Tran; Brian Kha,4,0,30,26
1656888397012,MATH 20D,A02,083766,Tran; Brian Kha,4,0,30,26
1656888397012,MATH 20D,A03,083767,Tran; Brian Kha,3,0,30,27
1656888403041,MATH 20E,A01,083771,Ganguly; Soumya,5,0,32,27
1656888403041,MATH 20E,A02,083772,Ganguly; Soumya,6,0,32,26
1656888403041,MATH 20E,B01,083773,Ciotti; Benjamin,18,0,35,17
1656888403041,MATH 20E,B02,083774,Ciotti; Benjamin,17,0,35,18
1656888409071,MATH 103A,A01,083777,Greenfeld; Be'Eri,2,0,36,34
1656888409071,MATH 103A,A02,083778,Greenfeld; Be'Eri,5,0,36,31
1656888409071,MATH 103A,A03,093561,Greenfeld; Be'Eri,4,0,36,32
1656888409071,MATH 103A,B01,083779,Greenfeld; Be'Eri,6,0,36,30
1656888409071,MATH 103A,B02,083780,Greenfeld; Be'Eri,2,0,36,34
1656888409071,MATH 103A,B03,093562,Greenfeld; Be'Eri,2,0,36,34
1656888415095,MATH 105,A01,085443,Carter; Anne Toulson,13,0,35,22
1656888415095,MATH 105,A02,093477,Carter; Anne Toulson,20,0,35,15
1656888421123,MATH 109,A01,083213,Ganzberger; Geoffrey Michael,2,0,34,32
1656888421123,MATH 109,A02,083214,Ganzberger; Geoffrey Michael,2,0,34,32
1656888421123,MATH 109,A03,093478,Ganzberger; Geoffrey Michael,1,0,34,33
1656888421123,MATH 109,B01,083215,Ganzberger; Geoffrey Michael,1,0,32,31
1656888421123,MATH 109,B02,083216,Ganzberger; Geoffrey Michael,1,0,32,31
1656888421123,MATH 109,B03,093479,Ganzberger; Geoffrey Michael,6,0,32,26
1656888427151,MATH 142A,A01,083219,Chow; Bennett,6,0,32,26
1656888427151,MATH 142A,A02,083220,Chow; Bennett,9,0,32,23
1656888427151,MATH 142A,A03,093480,Chow; Bennett,7,0,32,25
1656888427151,MATH 142A,B03,093481,Chow; Bennett,7,0,32,25
1656888427151,MATH 142A,B04,093558,Chow; Bennett,10,0,32,22
1656888427151,MATH 142A,B05,093559,Chow; Bennett,6,0,32,26
1656888433179,MATH 193A,A01,083224,Rotar; Vladimir,6,0,34,28
1656888433179,MATH 193A,A02,083225,Rotar; Vladimir,3,0,34,31
1656888433179,MATH 193A,A03,083781,Rotar; Vladimir,1,0,34,33
1656888433179,MATH 193A,A04,083782,Rotar; Vladimir,6,0,34,28
1656888433179,MATH 193A,A05,093482,Rotar; Vladimir,6,0,34,28
1656888439205,MATH 197,001,091859,McAuley; Julian John,9999,0,9999,0
1656888439205,MATH 197,002,095566,Kedlaya; Kiran S.,9997,0,9999,2
1656888439205,MATH 197,003,095567,Xiao; Ming,9999,0,9999,0
1656888439205,MATH 197,004,095571,Perols; Johan Lars,9998,0,9999,1
1656888446268,COGS 9,A01,083615,Shannon; Kyle Michael,6,0,75,69
1656888452296,COGS 11,A01,083617,Boyle; Mary E. T.,19,0,48,29
1656888458323,COGS 13,A01,083071,Bastos; Amalia Pinkusfeld,8,0,71,63
1656888464347,COGS 14A,A01,092681,Semenuks; Arturs,0,1,100,100
1656888470369,COGS 14B,A01,083073,Cheng; Tzu-Han,5,0,63,58
1656888476393,COGS 17,A01,092677,Semenuks; Arturs,4,0,81,77
1656888482420,COGS 100,A01,083619,Allen; Michael Gordon,15,0,70,55
1656888488444,COGS 101A,A01,083621,Davis; Joshua Daniel,9,0,68,59
1656888494465,COGS 101B,A01,091572,Allen; Michael Gordon,8,0,65,57
1656888500492,COGS 101C,A01,083625,Delgado; Tania,17,0,35,18
1656888506527,COGS 107A,A01,083627,Boyle; Mary E. T.,13,0,60,47
1656888512553,COGS 118A,A01,083075,Gupta; Anjum,15,0,76,61
1656888518576,CSE 3,A50,083646,Miranda; Gregory Joseph,22,0,50,28
1656888524598,CSE 8A,A50,083650,Miranda; Gregory Joseph,17,1,56,39
1656888530622,CSE 11,A01,083080,Cao; Yingjun,4,15,40,36
1656888536646,CSE 12,A01,083652,Krause-Levy; Sophia Louisa,20,1,120,100
1656888542671,CSE 15L,A01,083654,Morris; Justin Loren,8,0,50,42
1656888542671,CSE 15L,A02,083655,Morris; Justin Loren,8,0,50,42
1656888548694,CSE 20,A01,083657,Tran; Khoa Dang,37,0,80,43
1656888554717,CSE 21,A01,095574,Bach; Quang Tran,21,0,48,27
1656888560742,CSE 30,A01,083084,Eldon; John,4,0,80,76
1656888560742,CSE 30,B01,095061,Bhaskar; Nishant,6,0,50,44
1656888566778,CSE 100,A01,083659,Cao; Yingjun,2,4,70,68
1656888572801,CSE 134B,A01,083661,Powell; Thomas Allan,19,0,100,81
1656888578830,CSE 140,A01,083663,Gungor; Onat,14,0,85,71
1656888584854,CSE 140L,A01,083088,Eldon; John,16,0,100,84
1656888590883,CSE 175,A01,083665,Kumar; Rakesh,3,0,25,22
1656888596910,CSE 190,A00,092507,Dubnov; Shlomo,7,0,20,13
1656888602941,ECE 45,A01,083139,Congero; Spencer William,5,0,75,70
1656888608963,ECE 65,A50,083695,Saad; Andrew S,12,0,30,18
1656888608963,ECE 65,A51,095125,Saad; Andrew S,25,0,26,1
1656888614987,ECE 109,A01,091882,Touri; Behrouz,16,0,70,54
1656888621013,ECE 180,A00,083140,Abi Samra; Nicholas Camill,0,0,30,30
1656888621013,ECE 180,B00,083141,Abi Samra; Nicholas Camill,0,0,30,30
1656888627038,MATH 10A,A01,083735,Patchell; Gregory David,1,0,30,29
1656888627038,MATH 10A,A02,083736,Patchell; Gregory David,20,0,30,10
1656888627038,MATH 10A,A03,083737,Patchell; Gregory David,15,0,30,15
1656888633061,MATH 10B,A01,083207,Lim; Seonhee,7,0,34,27
1656888633061,MATH 10B,A02,083208,Lim; Seonhee,9,0,35,26
1656888633061,MATH 10B,A03,093472,Lim; Seonhee,4,0,34,30
1656888633061,MATH 10B,B01,083739,Sinha; Shubham,9,0,30,21
1656888639085,MATH 18,A01,083743,Cinel; Cameron Alexander,6,0,30,24
1656888639085,MATH 18,A02,083744,Cinel; Cameron Alexander,15,0,30,15
1656888639085,MATH 18,A03,083745,Cinel; Cameron Alexander,8,0,30,22
1656888639085,MATH 18,B01,083748,Rideout; David Porter,4,0,37,33
1656888639085,MATH 18,B02,083749,Rideout; David Porter,3,0,36,33
1656888639085,MATH 18,B03,083750,Rideout; David Porter,2,0,37,35
1656888639085,MATH 18,B04,083751,Rideout; David Porter,5,0,36,31
1656888639085,MATH 18,B05,093473,Rideout; David Porter,4,0,36,32
1656888639085,MATH 18,B06,093474,Rideout; David Porter,5,0,36,31
1656888645111,MATH 20A,A01,083754,Zheng; Zequn,12,0,40,28
1656888651137,MATH 20B,A01,083756,Briones; Jor-el Thomas Caparas,1,0,36,35
1656888651137,MATH 20B,A02,083757,Briones; Jor-el Thomas Caparas,1,0,36,35
1656888651137,MATH 20B,A03,093475,Briones; Jor-el Thomas Caparas,0,0,36,36
1656888657159,MATH 20C,A01,083760,Briones; Jor-el Thomas Caparas,1,0,35,34
1656888657159,MATH 20C,A02,083761,Briones; Jor-el Thomas Caparas,8,0,35,27
1656888657159,MATH 20C,A03,093476,Briones; Jor-el Thomas Caparas,0,1,36,36
1656888657159,MATH 20C,B01,083762,Bach; Quang Tran,0,0,30,30
1656888663184,MATH 20D,A01,083765,Tran; Brian Kha,4,0,30,26
1656888663184,MATH 20D,A02,083766,Tran; Brian Kha,4,0,30,26
1656888663184,MATH 20D,A03,083767,Tran; Brian Kha,3,0,30,27
1656888669212,MATH 20E,A01,083771,Ganguly; Soumya,5,0,32,27
1656888669212,MATH 20E,A02,083772,Ganguly; Soumya,6,0,32,26
1656888669212,MATH 20E,B01,083773,Ciotti; Benjamin,18,0,35,17
1656888669212,MATH 20E,B02,083774,Ciotti; Benjamin,17,0,35,18
1656888675243,MATH 103A,A01,083777,Greenfeld; Be'Eri,2,0,36,34
1656888675243,MATH 103A,A02,083778,Greenfeld; Be'Eri,5,0,36,31
1656888675243,MATH 103A,A03,093561,Greenfeld; Be'Eri,4,0,36,32
1656888675243,MATH 103A,B01,083779,Greenfeld; Be'Eri,6,0,36,30
1656888675243,MATH 103A,B02,083780,Greenfeld; Be'Eri,2,0,36,34
1656888675243,MATH 103A,B03,093562,Greenfeld; Be'Eri,2,0,36,34
1656888681269,MATH 105,A01,085443,Carter; Anne Toulson,13,0,35,22
1656888681269,MATH 105,A02,093477,Carter; Anne Toulson,20,0,35,15
1656888687293,MATH 109,A01,083213,Ganzberger; Geoffrey Michael,2,0,34,32
1656888687293,MATH 109,A02,083214,Ganzberger; Geoffrey Michael,2,0,34,32
1656888687293,MATH 109,A03,093478,Ganzberger; Geoffrey Michael,1,0,34,33
1656888687293,MATH 109,B01,083215,Ganzberger; Geoffrey Michael,1,0,32,31
1656888687293,MATH 109,B02,083216,Ganzberger; Geoffrey Michael,1,0,32,31
1656888687293,MATH 109,B03,093479,Ganzberger; Geoffrey Michael,6,0,32,26
1656888693318,MATH 142A,A01,083219,Chow; Bennett,6,0,32,26
1656888693318,MATH 142A,A02,083220,Chow; Bennett,9,0,32,23
1656888693318,MATH 142A,A03,093480,Chow; Bennett,7,0,32,25
1656888693318,MATH 142A,B03,093481,Chow; Bennett,7,0,32,25
1656888693318,MATH 142A,B04,093558,Chow; Bennett,10,0,32,22
1656888693318,MATH 142A,B05,093559,Chow; Bennett,6,0,32,26
1656888699346,MATH 193A,A01,083224,Rotar; Vladimir,6,0,34,28
1656888699346,MATH 193A,A02,083225,Rotar; Vladimir,3,0,34,31
1656888699346,MATH 193A,A03,083781,Rotar; Vladimir,1,0,34,33
1656888699346,MATH 193A,A04,083782,Rotar; Vladimir,6,0,34,28
1656888699346,MATH 193A,A05,093482,Rotar; Vladimir,6,0,34,28
1656888705372,MATH 197,001,091859,McAuley; Julian John,9999,0,9999,0
1656888705372,MATH 197,002,095566,Kedlaya; Kiran S.,9997,0,9999,2
1656888705372,MATH 197,003,095567,Xiao; Ming,9999,0,9999,0
1656888705372,MATH 197,004,095571,Perols; Johan Lars,9998,0,9999,1
1656888712439,COGS 9,A01,083615,Shannon; Kyle Michael,6,0,75,69
1656888718462,COGS 11,A01,083617,Boyle; Mary E. T.,19,0,48,29
1656888724504,COGS 13,A01,083071,Bastos; Amalia Pinkusfeld,8,0,71,63
1656888730528,COGS 14A,A01,092681,Semenuks; Arturs,0,1,100,100
1656888736556,COGS 14B,A01,083073,Cheng; Tzu-Han,5,0,63,58
1656888742581,COGS 17,A01,092677,Semenuks; Arturs,4,0,81,77
1656888748602,COGS 100,A01,083619,Allen; Michael Gordon,15,0,70,55
1656888754628,COGS 101A,A01,083621,Davis; Joshua Daniel,9,0,68,59
1656888760652,COGS 101B,A01,091572,Allen; Michael Gordon,8,0,65,57
1656888766680,COGS 101C,A01,083625,Delgado; Tania,17,0,35,18
1656888772702,COGS 107A,A01,083627,Boyle; Mary E. T.,13,0,60,47
1656888778723,COGS 118A,A01,083075,Gupta; Anjum,15,0,76,61
1656888784745,CSE 3,A50,083646,Miranda; Gregory Joseph,22,0,50,28
1656888790772,CSE 8A,A50,083650,Miranda; Gregory Joseph,17,1,56,39
1656888796799,CSE 11,A01,083080,Cao; Yingjun,4,15,40,36
1656888802823,CSE 12,A01,083652,Krause-Levy; Sophia Louisa,20,1,120,100
1656888808848,CSE 15L,A01,083654,Morris; Justin Loren,8,0,50,42
1656888808848,CSE 15L,A02,083655,Morris; Justin Loren,8,0,50,42
1656888814870,CSE 20,A01,083657,Tran; Khoa Dang,37,0,80,43
1656888820894,CSE 21,A01,095574,Bach; Quang Tran,21,0,48,27
1656888826945,CSE 30,A01,083084,Eldon; John,4,0,80,76
1656888826945,CSE 30,B01,095061,Bhaskar; Nishant,6,0,50,44
1656888832970,CSE 100,A01,083659,Cao; Yingjun,2,4,70,68
1656888838993,CSE 134B,A01,083661,Powell; Thomas Allan,19,0,100,81
1656888845016,CSE 140,A01,083663,Gungor; Onat,14,0,85,71
1656888851043,CSE 140L,A01,083088,Eldon; John,16,0,100,84
1656888857073,CSE 175,A01,083665,Kumar; Rakesh,3,0,25,22
1656888863096,CSE 190,A00,092507,Dubnov; Shlomo,7,0,20,13
1656888869121,ECE 45,A01,083139,Congero; Spencer William,5,0,75,70
1656888875157,ECE 65,A50,083695,Saad; Andrew S,12,0,30,18
1656888875157,ECE 65,A51,095125,Saad; Andrew S,25,0,26,1
1656888881179,ECE 109,A01,091882,Touri; Behrouz,16,0,70,54
1656888887201,ECE 180,A00,083140,Abi Samra; Nicholas Camill,0,0,30,30
1656888887201,ECE 180,B00,083141,Abi Samra; Nicholas Camill,0,0,30,30
1656888893228,MATH 10A,A01,083735,Patchell; Gregory David,1,0,30,29
1656888893228,MATH 10A,A02,083736,Patchell; Gregory David,20,0,30,10
1656888893228,MATH 10A,A03,083737,Patchell; Gregory David,15,0,30,15
1656888899256,MATH 10B,A01,083207,Lim; Seonhee,7,0,34,27
1656888899256,MATH 10B,A02,083208,Lim; Seonhee,9,0,35,26
1656888899256,MATH 10B,A03,093472,Lim; Seonhee,4,0,34,30
1656888899256,MATH 10B,B01,083739,Sinha; Shubham,9,0,30,21
1656888905281,MATH 18,A01,083743,Cinel; Cameron Alexander,6,0,30,24
1656888905281,MATH 18,A02,083744,Cinel; Cameron Alexander,15,0,30,15
1656888905281,MATH 18,A03,083745,Cinel; Cameron Alexander,8,0,30,22
1656888905281,MATH 18,B01,083748,Rideout; David Porter,4,0,37,33
1656888905281,MATH 18,B02,083749,Rideout; David Porter,3,0,36,33
1656888905281,MATH 18,B03,083750,Rideout; David Porter,2,0,37,35
1656888905281,MATH 18,B04,083751,Rideout; David Porter,5,0,36,31
1656888905281,MATH 18,B05,093473,Rideout; David Porter,4,0,36,32
1656888905281,MATH 18,B06,093474,Rideout; David Porter,5,0,36,31
1656888911308,MATH 20A,A01,083754,Zheng; Zequn,12,0,40,28
1656888917331,MATH 20B,A01,083756,Briones; Jor-el Thomas Caparas,1,0,36,35
1656888917331,MATH 20B,A02,083757,Briones; Jor-el Thomas Caparas,1,0,36,35
1656888917331,MATH 20B,A03,093475,Briones; Jor-el Thomas Caparas,0,0,36,36
1656888923355,MATH 20C,A01,083760,Briones; Jor-el Thomas Caparas,1,0,35,34
1656888923355,MATH 20C,A02,083761,Briones; Jor-el Thomas Caparas,8,0,35,27
1656888923355,MATH 20C,A03,093476,Briones; Jor-el Thomas Caparas,0,1,36,36
1656888923355,MATH 20C,B01,083762,Bach; Quang Tran,0,0,30,30
1656888929377,MATH 20D,A01,083765,Tran; Brian Kha,4,0,30,26
1656888929377,MATH 20D,A02,083766,Tran; Brian Kha,4,0,30,26
1656888929377,MATH 20D,A03,083767,Tran; Brian Kha,3,0,30,27
1656888935406,MATH 20E,A01,083771,Ganguly; Soumya,5,0,32,27
1656888935406,MATH 20E,A02,083772,Ganguly; Soumya,6,0,32,26
1656888935406,MATH 20E,B01,083773,Ciotti; Benjamin,18,0,35,17
1656888935406,MATH 20E,B02,083774,Ciotti; Benjamin,17,0,35,18
1656888941429,MATH 103A,A01,083777,Greenfeld; Be'Eri,2,0,36,34
1656888941429,MATH 103A,A02,083778,Greenfeld; Be'Eri,5,0,36,31
1656888941429,MATH 103A,A03,093561,Greenfeld; Be'Eri,4,0,36,32
1656888941429,MATH 103A,B01,083779,Greenfeld; Be'Eri,6,0,36,30
1656888941429,MATH 103A,B02,083780,Greenfeld; Be'Eri,2,0,36,34
1656888941429,MATH 103A,B03,093562,Greenfeld; Be'Eri,2,0,36,34
1656888947457,MATH 105,A01,085443,Carter; Anne Toulson,13,0,35,22
1656888947457,MATH 105,A02,093477,Carter; Anne Toulson,20,0,35,15
1656888953490,MATH 109,A01,083213,Ganzberger; Geoffrey Michael,2,0,34,32
1656888953490,MATH 109,A02,083214,Ganzberger; Geoffrey Michael,2,0,34,32
1656888953490,MATH 109,A03,093478,Ganzberger; Geoffrey Michael,1,0,34,33
1656888953490,MATH 109,B01,083215,Ganzberger; Geoffrey Michael,1,0,32,31
1656888953490,MATH 109,B02,083216,Ganzberger; Geoffrey Michael,1,0,32,31
1656888953490,MATH 109,B03,093479,Ganzberger; Geoffrey Michael,6,0,32,26
1656888959519,MATH 142A,A01,083219,Chow; Bennett,6,0,32,26
1656888959519,MATH 142A,A02,083220,Chow; Bennett,9,0,32,23
1656888959519,MATH 142A,A03,093480,Chow; Bennett,7,0,32,25
1656888959519,MATH 142A,B03,093481,Chow; Bennett,7,0,32,25
1656888959519,MATH 142A,B04,093558,Chow; Bennett,10,0,32,22
1656888959519,MATH 142A,B05,093559,Chow; Bennett,6,0,32,26
1656888965548,MATH 193A,A01,083224,Rotar; Vladimir,6,0,34,28
1656888965548,MATH 193A,A02,083225,Rotar; Vladimir,3,0,34,31
1656888965548,MATH 193A,A03,083781,Rotar; Vladimir,1,0,34,33
1656888965548,MATH 193A,A04,083782,Rotar; Vladimir,6,0,34,28
1656888965548,MATH 193A,A05,093482,Rotar; Vladimir,6,0,34,28
1656888971570,MATH 197,001,091859,McAuley; Julian John,9999,0,9999,0
1656888971570,MATH 197,002,095566,Kedlaya; Kiran S.,9997,0,9999,2
1656888971570,MATH 197,003,095567,Xiao; Ming,9999,0,9999,0
1656888971570,MATH 197,004,095571,Perols; Johan Lars,9998,0,9999,1
1656888978635,COGS 9,A01,083615,Shannon; Kyle Michael,6,0,75,69
1656888984779,COGS 11,A01,083617,Boyle; Mary E. T.,19,0,48,29
1656888990803,COGS 13,A01,083071,Bastos; Amalia Pinkusfeld,8,0,71,63
1656888996832,COGS 14A,A01,092681,Semenuks; Arturs,0,1,100,100
1656889002858,COGS 14B,A01,083073,Cheng; Tzu-Han,5,0,63,58
1656889008881,COGS 17,A01,092677,Semenuks; Arturs,4,0,81,77
1656889014905,COGS 100,A01,083619,Allen; Michael Gordon,15,0,70,55
1656889020928,COGS 101A,A01,083621,Davis; Joshua Daniel,9,0,68,59
1656889026950,COGS 101B,A01,091572,Allen; Michael Gordon,8,0,65,57
1656889032973,COGS 101C,A01,083625,Delgado; Tania,17,0,35,18
1656889038996,COGS 107A,A01,083627,Boyle; Mary E. T.,13,0,60,47
1656889045020,COGS 118A,A01,083075,Gupta; Anjum,15,0,76,61
1656889051046,CSE 3,A50,083646,Miranda; Gregory Joseph,22,0,50,28
1656889057073,CSE 8A,A50,083650,Miranda; Gregory Joseph,17,1,56,39
1656889063099,CSE 11,A01,083080,Cao; Yingjun,4,15,40,36
1656889069124,CSE 12,A01,083652,Krause-Levy; Sophia Louisa,20,1,120,100
1656889075149,CSE 15L,A01,083654,Morris; Justin Loren,8,0,50,42
1656889075149,CSE 15L,A02,083655,Morris; Justin Loren,8,0,50,42
1656889081190,CSE 20,A01,083657,Tran; Khoa Dang,37,0,80,43
1656889087214,CSE 21,A01,095574,Bach; Quang Tran,21,0,48,27
1656889093241,CSE 30,A01,083084,Eldon; John,4,0,80,76
1656889093241,CSE 30,B01,095061,Bhaskar; Nishant,6,0,50,44
1656889099266,CSE 100,A01,083659,Cao; Yingjun,2,4,70,68
1656889105290,CSE 134B,A01,083661,Powell; Thomas Allan,19,0,100,81
1656889111314,CSE 140,A01,083663,Gungor; Onat,14,0,85,71
1656889117343,CSE 140L,A01,083088,Eldon; John,16,0,100,84
1656889123366,CSE 175,A01,083665,Kumar; Rakesh,3,0,25,22
1656889129394,CSE 190,A00,092507,Dubnov; Shlomo,7,0,20,13
1656889135417,ECE 45,A01,083139,Congero; Spencer William,5,0,75,70
1656889141439,ECE 65,A50,083695,Saad; Andrew S,12,0,30,18
1656889141439,ECE 65,A51,095125,Saad; Andrew S,25,0,26,1
1656889147465,ECE 109,A01,091882,Touri; Behrouz,16,0,70,54
1656889153486,ECE 180,A00,083140,Abi Samra; Nicholas Camill,0,0,30,30
1656889153486,ECE 180,B00,083141,Abi Samra; Nicholas Camill,0,0,30,30
1656889159509,MATH 10A,A01,083735,Patchell; Gregory David,1,0,30,29
1656889159509,MATH 10A,A02,083736,Patchell; Gregory David,20,0,30,10
1656889159509,MATH 10A,A03,083737,Patchell; Gregory David,15,0,30,15
1656889165540,MATH 10B,A01,083207,Lim; Seonhee,7,0,34,27
1656889165540,MATH 10B,A02,083208,Lim; Seonhee,9,0,35,26
1656889165540,MATH 10B,A03,093472,Lim; Seonhee,4,0,34,30
1656889165540,MATH 10B,B01,083739,Sinha; Shubham,9,0,30,21
1656889171564,MATH 18,A01,083743,Cinel; Cameron Alexander,6,0,30,24
1656889171564,MATH 18,A02,083744,Cinel; Cameron Alexander,15,0,30,15
1656889171564,MATH 18,A03,083745,Cinel; Cameron Alexander,8,0,30,22
1656889171564,MATH 18,B01,083748,Rideout; David Porter,4,0,37,33
1656889171564,MATH 18,B02,083749,Rideout; David Porter,3,0,36,33
1656889171564,MATH 18,B03,083750,Rideout; David Porter,2,0,37,35
1656889171564,MATH 18,B04,083751,Rideout; David Porter,5,0,36,31
1656889171564,MATH 18,B05,093473,Rideout; David Porter,4,0,36,32
1656889171564,MATH 18,B06,093474,Rideout; David Porter,5,0,36,31
1656889177587,MATH 20A,A01,083754,Zheng; Zequn,12,0,40,28
1656889183614,MATH 20B,A01,083756,Briones; Jor-el Thomas Caparas,1,0,36,35
1656889183614,MATH 20B,A02,083757,Briones; Jor-el Thomas Caparas,1,0,36,35
1656889183614,MATH 20B,A03,093475,Briones; Jor-el Thomas Caparas,0,0,36,36
1656889189638,MATH 20C,A01,083760,Briones; Jor-el Thomas Caparas,1,0,35,34
1656889189638,MATH 20C,A02,083761,Briones; Jor-el Thomas Caparas,8,0,35,27
1656889189638,MATH 20C,A03,093476,Briones; Jor-el Thomas Caparas,0,1,36,36
1656889189638,MATH 20C,B01,083762,Bach; Quang Tran,0,0,30,30
1656889195660,MATH 20D,A01,083765,Tran; Brian Kha,4,0,30,26
1656889195660,MATH 20D,A02,083766,Tran; Brian Kha,4,0,30,26
1656889195660,MATH 20D,A03,083767,Tran; Brian Kha,3,0,30,27
1656889201683,MATH 20E,A01,083771,Ganguly; Soumya,5,0,32,27
1656889201683,MATH 20E,A02,083772,Ganguly; Soumya,6,0,32,26
1656889201683,MATH 20E,B01,083773,Ciotti; Benjamin,18,0,35,17
1656889201683,MATH 20E,B02,083774,Ciotti; Benjamin,17,0,35,18
1656889207712,MATH 103A,A01,083777,Greenfeld; Be'Eri,2,0,36,34
1656889207712,MATH 103A,A02,083778,Greenfeld; Be'Eri,5,0,36,31
1656889207712,MATH 103A,A03,093561,Greenfeld; Be'Eri,4,0,36,32
1656889207712,MATH 103A,B01,083779,Greenfeld; Be'Eri,6,0,36,30
1656889207712,MATH 103A,B02,083780,Greenfeld; Be'Eri,2,0,36,34
1656889207712,MATH 103A,B03,093562,Greenfeld; Be'Eri,2,0,36,34
1656889213734,MATH 105,A01,085443,Carter; Anne Toulson,13,0,35,22
1656889213734,MATH 105,A02,093477,Carter; Anne Toulson,20,0,35,15
1656889219764,MATH 109,A01,083213,Ganzberger; Geoffrey Michael,2,0,34,32
1656889219764,MATH 109,A02,083214,Ganzberger; Geoffrey Michael,2,0,34,32
1656889219764,MATH 109,A03,093478,Ganzberger; Geoffrey Michael,1,0,34,33
1656889219764,MATH 109,B01,083215,Ganzberger; Geoffrey Michael,1,0,32,31
1656889219764,MATH 109,B02,083216,Ganzberger; Geoffrey Michael,1,0,32,31
1656889219764,MATH 109,B03,093479,Ganzberger; Geoffrey Michael,6,0,32,26
1656889225792,MATH 142A,A01,083219,Chow; Bennett,6,0,32,26
1656889225792,MATH 142A,A02,083220,Chow; Bennett,9,0,32,23
1656889225792,MATH 142A,A03,093480,Chow; Bennett,7,0,32,25
1656889225792,MATH 142A,B03,093481,Chow; Bennett,7,0,32,25
1656889225792,MATH 142A,B04,093558,Chow; Bennett,10,0,32,22
1656889225792,MATH 142A,B05,093559,Chow; Bennett,6,0,32,26
1656889231819,MATH 193A,A01,083224,Rotar; Vladimir,6,0,34,28
1656889231819,MATH 193A,A02,083225,Rotar; Vladimir,3,0,34,31
1656889231819,MATH 193A,A03,083781,Rotar; Vladimir,1,0,34,33
1656889231819,MATH 193A,A04,083782,Rotar; Vladimir,6,0,34,28
1656889231819,MATH 193A,A05,093482,Rotar; Vladimir,6,0,34,28
1656889237844,MATH 197,001,091859,McAuley; Julian John,9999,0,9999,0
1656889237844,MATH 197,002,095566,Kedlaya; Kiran S.,9997,0,9999,2
1656889237844,MATH 197,003,095567,Xiao; Ming,9999,0,9999,0
1656889237844,MATH 197,004,095571,Perols; Johan Lars,9998,0,9999,1
1656889244904,COGS 9,A01,083615,Shannon; Kyle Michael,6,0,75,69
1656889250927,COGS 11,A01,083617,Boyle; Mary E. T.,19,0,48,29
1656889256950,COGS 13,A01,083071,Bastos; Amalia Pinkusfeld,8,0,71,63
1656889262973,COGS 14A,A01,092681,Semenuks; Arturs,0,1,100,100
1656889268996,COGS 14B,A01,083073,Cheng; Tzu-Han,5,0,63,58
1656889275023,COGS 17,A01,092677,Semenuks; Arturs,4,0,81,77
1656889281056,COGS 100,A01,083619,Allen; Michael Gordon,15,0,70,55
1656889287080,COGS 101A,A01,083621,Davis; Joshua Daniel,9,0,68,59
1656889293106,COGS 101B,A01,091572,Allen; Michael Gordon,8,0,65,57
1656889299134,COGS 101C,A01,083625,Delgado; Tania,17,0,35,18
1656889305156,COGS 107A,A01,083627,Boyle; Mary E. T.,13,0,60,47
1656889311181,COGS 118A,A01,083075,Gupta; Anjum,15,0,76,61
1656889317203,CSE 3,A50,083646,Miranda; Gregory Joseph,22,0,50,28
1656889323227,CSE 8A,A50,083650,Miranda; Gregory Joseph,17,1,56,39
1656889329250,CSE 11,A01,083080,Cao; Yingjun,4,15,40,36
1656889335278,CSE 12,A01,083652,Krause-Levy; Sophia Louisa,20,1,120,100
1656889341307,CSE 15L,A01,083654,Morris; Justin Loren,8,0,50,42
1656889341307,CSE 15L,A02,083655,Morris; Justin Loren,8,0,50,42
1656889347330,CSE 20,A01,083657,Tran; Khoa Dang,37,0,80,43
1656889353354,CSE 21,A01,095574,Bach; Quang Tran,21,0,48,27
1656889359378,CSE 30,A01,083084,Eldon; John,4,0,80,76
1656889359378,CSE 30,B01,095061,Bhaskar; Nishant,6,0,50,44
1656889365401,CSE 100,A01,083659,Cao; Yingjun,2,4,70,68
1656889371425,CSE 134B,A01,083661,Powell; Thomas Allan,19,0,100,81
1656889377448,CSE 140,A01,083663,Gungor; Onat,14,0,85,71
1656889383475,CSE 140L,A01,083088,Eldon; John,16,0,100,84
1656889389502,CSE 175,A01,083665,Kumar; Rakesh,3,0,25,22
1656889395526,CSE 190,A00,092507,Dubnov; Shlomo,7,0,20,13
1656889401549,ECE 45,A01,083139,Congero; Spencer William,5,0,75,70
1656889407573,ECE 65,A50,083695,Saad; Andrew S,12,0,30,18
1656889407573,ECE 65,A51,095125,Saad; Andrew S,25,0,26,1
1656889413609,ECE 109,A01,091882,Touri; Behrouz,16,0,70,54
1656889419635,ECE 180,A00,083140,Abi Samra; Nicholas Camill,0,0,30,30
1656889419635,ECE 180,B00,083141,Abi Samra; Nicholas Camill,0,0,30,30
1656889425663,MATH 10A,A01,083735,Patchell; Gregory David,1,0,30,29
1656889425663,MATH 10A,A02,083736,Patchell; Gregory David,20,0,30,10
1656889425663,MATH 10A,A03,083737,Patchell; Gregory David,15,0,30,15
1656889431696,MATH 10B,A01,083207,Lim; Seonhee,7,0,34,27
1656889431696,MATH 10B,A02,083208,Lim; Seonhee,9,0,35,26
1656889431696,MATH 10B,A03,093472,Lim; Seonhee,4,0,34,30
1656889431696,MATH 10B,B01,083739,Sinha; Shubham,9,0,30,21
1656889437721,MATH 18,A01,083743,Cinel; Cameron Alexander,6,0,30,24
1656889437721,MATH 18,A02,083744,Cinel; Cameron Alexander,15,0,30,15
1656889437721,MATH 18,A03,083745,Cinel; Cameron Alexander,8,0,30,22
1656889437721,MATH 18,B01,083748,Rideout; David Porter,4,0,37,33
1656889437721,MATH 18,B02,083749,Rideout; David Porter,3,0,36,33
1656889437721,MATH 18,B03,083750,Rideout; David Porter,2,0,37,35
1656889437721,MATH 18,B04,083751,Rideout; David Porter,5,0,36,31
1656889437721,MATH 18,B05,093473,Rideout; David Porter,4,0,36,32
1656889437721,MATH 18,B06,093474,Rideout; David Porter,5,0,36,31
1656889443744,MATH 20A,A01,083754,Zheng; Zequn,12,0,40,28
1656889449768,MATH 20B,A01,083756,Briones; Jor-el Thomas Caparas,1,0,36,35
1656889449768,MATH 20B,A02,083757,Briones; Jor-el Thomas Caparas,1,0,36,35
1656889449768,MATH 20B,A03,093475,Briones; Jor-el Thomas Caparas,0,0,36,36
1656889455796,MATH 20C,A01,083760,Briones; Jor-el Thomas Caparas,1,0,35,34
1656889455796,MATH 20C,A02,083761,Briones; Jor-el Thomas Caparas,8,0,35,27
1656889455796,MATH 20C,A03,093476,Briones; Jor-el Thomas Caparas,0,1,36,36
1656889455796,MATH 20C,B01,083762,Bach; Quang Tran,0,0,30,30
1656889461821,MATH 20D,A01,083765,Tran; Brian Kha,4,0,30,26
1656889461821,MATH 20D,A02,083766,Tran; Brian Kha,4,0,30,26
1656889461821,MATH 20D,A03,083767,Tran; Brian Kha,3,0,30,27
1656889467852,MATH 20E,A01,083771,Ganguly; Soumya,5,0,32,27
1656889467852,MATH 20E,A02,083772,Ganguly; Soumya,6,0,32,26
1656889467852,MATH 20E,B01,083773,Ciotti; Benjamin,18,0,35,17
1656889467852,MATH 20E,B02,083774,Ciotti; Benjamin,17,0,35,18
1656889473886,MATH 103A,A01,083777,Greenfeld; Be'Eri,2,0,36,34
1656889473886,MATH 103A,A02,083778,Greenfeld; Be'Eri,5,0,36,31
1656889473886,MATH 103A,A03,093561,Greenfeld; Be'Eri,4,0,36,32
1656889473886,MATH 103A,B01,083779,Greenfeld; Be'Eri,6,0,36,30
1656889473886,MATH 103A,B02,083780,Greenfeld; Be'Eri,2,0,36,34
1656889473886,MATH 103A,B03,093562,Greenfeld; Be'Eri,2,0,36,34
1656889479915,MATH 105,A01,085443,Carter; Anne Toulson,13,0,35,22
1656889479915,MATH 105,A02,093477,Carter; Anne Toulson,20,0,35,15
1656889485944,MATH 109,A01,083213,Ganzberger; Geoffrey Michael,2,0,34,32
1656889485944,MATH 109,A02,083214,Ganzberger; Geoffrey Michael,2,0,34,32
1656889485944,MATH 109,A03,093478,Ganzberger; Geoffrey Michael,1,0,34,33
1656889485944,MATH 109,B01,083215,Ganzberger; Geoffrey Michael,1,0,32,31
1656889485944,MATH 109,B02,083216,Ganzberger; Geoffrey Michael,1,0,32,31
1656889485944,MATH 109,B03,093479,Ganzberger; Geoffrey Michael,6,0,32,26
1656889491974,MATH 142A,A01,083219,Chow; Bennett,6,0,32,26
1656889491974,MATH 142A,A02,083220,Chow; Bennett,9,0,32,23
1656889491974,MATH 142A,A03,093480,Chow; Bennett,7,0,32,25
1656889491974,MATH 142A,B03,093481,Chow; Bennett,7,0,32,25
1656889491974,MATH 142A,B04,093558,Chow; Bennett,10,0,32,22
1656889491974,MATH 142A,B05,093559,Chow; Bennett,6,0,32,26
1656889498001,MATH 193A,A01,083224,Rotar; Vladimir,6,0,34,28
1656889498001,MATH 193A,A02,083225,Rotar; Vladimir,3,0,34,31
1656889498001,MATH 193A,A03,083781,Rotar; Vladimir,1,0,34,33
1656889498001,MATH 193A,A04,083782,Rotar; Vladimir,6,0,34,28
1656889498001,MATH 193A,A05,093482,Rotar; Vladimir,6,0,34,28
1656889504025,MATH 197,001,091859,McAuley; Julian John,9999,0,9999,0
1656889504025,MATH 197,002,095566,Kedlaya; Kiran S.,9997,0,9999,2
1656889504025,MATH 197,003,095567,Xiao; Ming,9999,0,9999,0
1656889504025,MATH 197,004,095571,Perols; Johan Lars,9998,0,9999,1
1656889511082,COGS 9,A01,083615,Shannon; Kyle Michael,6,0,75,69
1656889517106,COGS 11,A01,083617,Boyle; Mary E. T.,19,0,48,29
1656889523129,COGS 13,A01,083071,Bastos; Amalia Pinkusfeld,8,0,71,63
1656889529151,COGS 14A,A01,092681,Semenuks; Arturs,0,1,100,100
1656889535174,COGS 14B,A01,083073,Cheng; Tzu-Han,5,0,63,58
1656889541196,COGS 17,A01,092677,Semenuks; Arturs,4,0,81,77
1656889547223,COGS 100,A01,083619,Allen; Michael Gordon,15,0,70,55
1656889553252,COGS 101A,A01,083621,Davis; Joshua Daniel,9,0,68,59
1656889559277,COGS 101B,A01,091572,Allen; Michael Gordon,8,0,65,57
1656889565300,COGS 101C,A01,083625,Delgado; Tania,17,0,35,18
1656889571328,COGS 107A,A01,083627,Boyle; Mary E. T.,13,0,60,47
1656889577351,COGS 118A,A01,083075,Gupta; Anjum,15,0,76,61
1656889583450,CSE 3,A50,083646,Miranda; Gregory Joseph,22,0,50,28
1656889589472,CSE 8A,A50,083650,Miranda; Gregory Joseph,17,1,56,39
1656889595498,CSE 11,A01,083080,Cao; Yingjun,4,15,40,36
1656889601524,CSE 12,A01,083652,Krause-Levy; Sophia Louisa,20,1,120,100
1656889607547,CSE 15L,A01,083654,Morris; Justin Loren,8,0,50,42
1656889607547,CSE 15L,A02,083655,Morris; Justin Loren,8,0,50,42
1656889613575,CSE 20,A01,083657,Tran; Khoa Dang,37,0,80,43
1656889619603,CSE 21,A01,095574,Bach; Quang Tran,21,0,48,27
1656889625632,CSE 30,A01,083084,Eldon; John,4,0,80,76
1656889625632,CSE 30,B01,095061,Bhaskar; Nishant,6,0,50,44
1656889631667,CSE 100,A01,083659,Cao; Yingjun,2,4,70,68
1656889637694,CSE 134B,A01,083661,Powell; Thomas Allan,19,0,100,81
1656889643717,CSE 140,A01,083663,Gungor; Onat,14,0,85,71
1656889649739,CSE 140L,A01,083088,Eldon; John,16,0,100,84
1656889655763,CSE 175,A01,083665,Kumar; Rakesh,3,0,25,22
1656889661788,CSE 190,A00,092507,Dubnov; Shlomo,7,0,20,13
1656889667815,ECE 45,A01,083139,Congero; Spencer William,5,0,75,70
1656889673843,ECE 65,A50,083695,Saad; Andrew S,12,0,30,18
1656889673843,ECE 65,A51,095125,Saad; Andrew S,25,0,26,1
1656889679871,ECE 109,A01,091882,Touri; Behrouz,16,0,70,54
1656889685899,ECE 180,A00,083140,Abi Samra; Nicholas Camill,0,0,30,30
1656889685899,ECE 180,B00,083141,Abi Samra; Nicholas Camill,0,0,30,30
1656889691923,MATH 10A,A01,083735,Patchell; Gregory David,1,0,30,29
1656889691923,MATH 10A,A02,083736,Patchell; Gregory David,20,0,30,10
1656889691923,MATH 10A,A03,083737,Patchell; Gregory David,15,0,30,15
1656889697949,MATH 10B,A01,083207,Lim; Seonhee,7,0,34,27
1656889697949,MATH 10B,A02,083208,Lim; Seonhee,9,0,35,26
1656889697949,MATH 10B,A03,093472,Lim; Seonhee,4,0,34,30
1656889697949,MATH 10B,B01,083739,Sinha; Shubham,9,0,30,21
1656889703972,MATH 18,A01,083743,Cinel; Cameron Alexander,6,0,30,24
1656889703972,MATH 18,A02,083744,Cinel; Cameron Alexander,15,0,30,15
1656889703972,MATH 18,A03,083745,Cinel; Cameron Alexander,8,0,30,22
1656889703972,MATH 18,B01,083748,Rideout; David Porter,4,0,37,33
1656889703972,MATH 18,B02,083749,Rideout; David Porter,3,0,36,33
1656889703972,MATH 18,B03,083750,Rideout; David Porter,2,0,37,35
1656889703972,MATH 18,B04,083751,Rideout; David Porter,5,0,36,31
1656889703972,MATH 18,B05,093473,Rideout; David Porter,4,0,36,32
1656889703972,MATH 18,B06,093474,Rideout; David Porter,5,0,36,31
1656889709998,MATH 20A,A01,083754,Zheng; Zequn,12,0,40,28
1656889716021,MATH 20B,A01,083756,Briones; Jor-el Thomas Caparas,1,0,36,35
1656889716021,MATH 20B,A02,083757,Briones; Jor-el Thomas Caparas,1,0,36,35
1656889716021,MATH 20B,A03,093475,Briones; Jor-el Thomas Caparas,0,0,36,36
1656889722046,MATH 20C,A01,083760,Briones; Jor-el Thomas Caparas,1,0,35,34
1656889722046,MATH 20C,A02,083761,Briones; Jor-el Thomas Caparas,8,0,35,27
1656889722046,MATH 20C,A03,093476,Briones; Jor-el Thomas Caparas,0,1,36,36
1656889722046,MATH 20C,B01,083762,Bach; Quang Tran,0,0,30,30
1656889728070,MATH 20D,A01,083765,Tran; Brian Kha,4,0,30,26
1656889728070,MATH 20D,A02,083766,Tran; Brian Kha,4,0,30,26
1656889728070,MATH 20D,A03,083767,Tran; Brian Kha,3,0,30,27
1656889734093,MATH 20E,A01,083771,Ganguly; Soumya,5,0,32,27
1656889734093,MATH 20E,A02,083772,Ganguly; Soumya,6,0,32,26
1656889734093,MATH 20E,B01,083773,Ciotti; Benjamin,18,0,35,17
1656889734093,MATH 20E,B02,083774,Ciotti; Benjamin,17,0,35,18
1656889740118,MATH 103A,A01,083777,Greenfeld; Be'Eri,2,0,36,34
1656889740118,MATH 103A,A02,083778,Greenfeld; Be'Eri,5,0,36,31
1656889740118,MATH 103A,A03,093561,Greenfeld; Be'Eri,4,0,36,32
1656889740118,MATH 103A,B01,083779,Greenfeld; Be'Eri,6,0,36,30
1656889740118,MATH 103A,B02,083780,Greenfeld; Be'Eri,2,0,36,34
1656889740118,MATH 103A,B03,093562,Greenfeld; Be'Eri,2,0,36,34
1656889746144,MATH 105,A01,085443,Carter; Anne Toulson,13,0,35,22
1656889746144,MATH 105,A02,093477,Carter; Anne Toulson,20,0,35,15
1656889752168,MATH 109,A01,083213,Ganzberger; Geoffrey Michael,2,0,34,32
1656889752168,MATH 109,A02,083214,Ganzberger; Geoffrey Michael,2,0,34,32
1656889752168,MATH 109,A03,093478,Ganzberger; Geoffrey Michael,1,0,34,33
1656889752168,MATH 109,B01,083215,Ganzberger; Geoffrey Michael,1,0,32,31
1656889752168,MATH 109,B02,083216,Ganzberger; Geoffrey Michael,1,0,32,31
1656889752168,MATH 109,B03,093479,Ganzberger; Geoffrey Michael,6,0,32,26
1656889758196,MATH 142A,A01,083219,Chow; Bennett,6,0,32,26
1656889758196,MATH 142A,A02,083220,Chow; Bennett,9,0,32,23
1656889758196,MATH 142A,A03,093480,Chow; Bennett,7,0,32,25
1656889758196,MATH 142A,B03,093481,Chow; Bennett,7,0,32,25
1656889758196,MATH 142A,B04,093558,Chow; Bennett,10,0,32,22
1656889758196,MATH 142A,B05,093559,Chow; Bennett,6,0,32,26
1656889764234,MATH 193A,A01,083224,Rotar; Vladimir,6,0,34,28
1656889764234,MATH 193A,A02,083225,Rotar; Vladimir,3,0,34,31
1656889764234,MATH 193A,A03,083781,Rotar; Vladimir,1,0,34,33
1656889764234,MATH 193A,A04,083782,Rotar; Vladimir,6,0,34,28
1656889764234,MATH 193A,A05,093482,Rotar; Vladimir,6,0,34,28
1656889770257,MATH 197,001,091859,McAuley; Julian John,9999,0,9999,0
1656889770257,MATH 197,002,095566,Kedlaya; Kiran S.,9997,0,9999,2
1656889770257,MATH 197,003,095567,Xiao; Ming,9999,0,9999,0
1656889770257,MATH 197,004,095571,Perols; Johan Lars,9998,0,9999,1
1656889777308,COGS 9,A01,083615,Shannon; Kyle Michael,6,0,75,69
1656889783336,COGS 11,A01,083617,Boyle; Mary E. T.,19,0,48,29
1656889789361,COGS 13,A01,083071,Bastos; Amalia Pinkusfeld,8,0,71,63
1656889795383,COGS 14A,A01,092681,Semenuks; Arturs,0,1,100,100
1656889801408,COGS 14B,A01,083073,Cheng; Tzu-Han,5,0,63,58
1656889807436,COGS 17,A01,092677,Semenuks; Arturs,4,0,81,77
1656889813459,COGS 100,A01,083619,Allen; Michael Gordon,15,0,70,55
1656889819485,COGS 101A,A01,083621,Davis; Joshua Daniel,9,0,68,59
1656889825512,COGS 101B,A01,091572,Allen; Michael Gordon,8,0,65,57
1656889831537,COGS 101C,A01,083625,Delgado; Tania,17,0,35,18
1656889837568,COGS 107A,A01,083627,Boyle; Mary E. T.,13,0,60,47
1656889843590,COGS 118A,A01,083075,Gupta; Anjum,15,0,76,61
1656889849618,CSE 3,A50,083646,Miranda; Gregory Joseph,22,0,50,28
1656889855640,CSE 8A,A50,083650,Miranda; Gregory Joseph,17,1,56,39
1656889861663,CSE 11,A01,083080,Cao; Yingjun,4,15,40,36
1656889867685,CSE 12,A01,083652,Krause-Levy; Sophia Louisa,20,1,120,100
1656889873713,CSE 15L,A01,083654,Morris; Justin Loren,8,0,50,42
1656889873713,CSE 15L,A02,083655,Morris; Justin Loren,8,0,50,42
1656889879739,CSE 20,A01,083657,Tran; Khoa Dang,37,0,80,43
1656889885763,CSE 21,A01,095574,Bach; Quang Tran,21,0,48,27
1656889891786,CSE 30,A01,083084,Eldon; John,4,0,80,76
1656889891786,CSE 30,B01,095061,Bhaskar; Nishant,6,0,50,44
1656889897807,CSE 100,A01,083659,Cao; Yingjun,2,4,70,68
1656889903833,CSE 134B,A01,083661,Powell; Thomas Allan,19,0,100,81
1656889909860,CSE 140,A01,083663,Gungor; Onat,14,0,85,71
1656889915883,CSE 140L,A01,083088,Eldon; John,16,0,100,84
1656889921909,CSE 175,A01,083665,Kumar; Rakesh,3,0,25,22
1656889927935,CSE 190,A00,092507,Dubnov; Shlomo,7,0,20,13
1656889933961,ECE 45,A01,083139,Congero; Spencer William,5,0,75,70
1656889939985,ECE 65,A50,083695,Saad; Andrew S,12,0,30,18
1656889939985,ECE 65,A51,095125,Saad; Andrew S,25,0,26,1
1656889946011,ECE 109,A01,091882,Touri; Behrouz,16,0,70,54
1656889952038,ECE 180,A00,083140,Abi Samra; Nicholas Camill,0,0,30,30
1656889952038,ECE 180,B00,083141,Abi Samra; Nicholas Camill,0,0,30,30
1656889958062,MATH 10A,A01,083735,Patchell; Gregory David,1,0,30,29
1656889958062,MATH 10A,A02,083736,Patchell; Gregory David,20,0,30,10
1656889958062,MATH 10A,A03,083737,Patchell; Gregory David,15,0,30,15
1656889964087,MATH 10B,A01,083207,Lim; Seonhee,7,0,34,27
1656889964087,MATH 10B,A02,083208,Lim; Seonhee,9,0,35,26
1656889964087,MATH 10B,A03,093472,Lim; Seonhee,4,0,34,30
1656889964087,MATH 10B,B01,083739,Sinha; Shubham,9,0,30,21
1656889970113,MATH 18,A01,083743,Cinel; Cameron Alexander,6,0,30,24
1656889970113,MATH 18,A02,083744,Cinel; Cameron Alexander,15,0,30,15
1656889970113,MATH 18,A03,083745,Cinel; Cameron Alexander,8,0,30,22
1656889970113,MATH 18,B01,083748,Rideout; David Porter,4,0,37,33
1656889970113,MATH 18,B02,083749,Rideout; David Porter,3,0,36,33
1656889970113,MATH 18,B03,083750,Rideout; David Porter,2,0,37,35
1656889970113,MATH 18,B04,083751,Rideout; David Porter,5,0,36,31
1656889970113,MATH 18,B05,093473,Rideout; David Porter,4,0,36,32
1656889970113,MATH 18,B06,093474,Rideout; David Porter,5,0,36,31
1656889976138,MATH 20A,A01,083754,Zheng; Zequn,12,0,40,28
1656889982162,MATH 20B,A01,083756,Briones; Jor-el Thomas Caparas,1,0,36,35
1656889982162,MATH 20B,A02,083757,Briones; Jor-el Thomas Caparas,1,0,36,35
1656889982162,MATH 20B,A03,093475,Briones; Jor-el Thomas Caparas,0,0,36,36
1656889988186,MATH 20C,A01,083760,Briones; Jor-el Thomas Caparas,1,0,35,34
1656889988186,MATH 20C,A02,083761,Briones; Jor-el Thomas Caparas,8,0,35,27
1656889988186,MATH 20C,A03,093476,Briones; Jor-el Thomas Caparas,0,1,36,36
1656889988186,MATH 20C,B01,083762,Bach; Quang Tran,0,0,30,30
1656889994208,MATH 20D,A01,083765,Tran; Brian Kha,4,0,30,26
1656889994208,MATH 20D,A02,083766,Tran; Brian Kha,4,0,30,26
1656889994208,MATH 20D,A03,083767,Tran; Brian Kha,3,0,30,27
1656890000231,MATH 20E,A01,083771,Ganguly; Soumya,5,0,32,27
1656890000231,MATH 20E,A02,083772,Ganguly; Soumya,6,0,32,26
1656890000231,MATH 20E,B01,083773,Ciotti; Benjamin,18,0,35,17
1656890000231,MATH 20E,B02,083774,Ciotti; Benjamin,17,0,35,18
1656890006270,MATH 103A,A01,083777,Greenfeld; Be'Eri,2,0,36,34
1656890006270,MATH 103A,A02,083778,Greenfeld; Be'Eri,5,0,36,31
1656890006270,MATH 103A,A03,093561,Greenfeld; Be'Eri,4,0,36,32
1656890006270,MATH 103A,B01,083779,Greenfeld; Be'Eri,6,0,36,30
1656890006270,MATH 103A,B02,083780,Greenfeld; Be'Eri,2,0,36,34
1656890006270,MATH 103A,B03,093562,Greenfeld; Be'Eri,2,0,36,34
1656890012297,MATH 105,A01,085443,Carter; Anne Toulson,13,0,35,22
1656890012297,MATH 105,A02,093477,Carter; Anne Toulson,20,0,35,15
1656890018321,MATH 109,A01,083213,Ganzberger; Geoffrey Michael,2,0,34,32
1656890018321,MATH 109,A02,083214,Ganzberger; Geoffrey Michael,2,0,34,32
1656890018321,MATH 109,A03,093478,Ganzberger; Geoffrey Michael,1,0,34,33
1656890018321,MATH 109,B01,083215,Ganzberger; Geoffrey Michael,1,0,32,31
1656890018321,MATH 109,B02,083216,Ganzberger; Geoffrey Michael,1,0,32,31
1656890018321,MATH 109,B03,093479,Ganzberger; Geoffrey Michael,6,0,32,26
1656890024350,MATH 142A,A01,083219,Chow; Bennett,6,0,32,26
1656890024350,MATH 142A,A02,083220,Chow; Bennett,9,0,32,23
1656890024350,MATH 142A,A03,093480,Chow; Bennett,7,0,32,25
1656890024350,MATH 142A,B03,093481,Chow; Bennett,7,0,32,25
1656890024350,MATH 142A,B04,093558,Chow; Bennett,10,0,32,22
1656890024350,MATH 142A,B05,093559,Chow; Bennett,6,0,32,26
1656890030385,MATH 193A,A01,083224,Rotar; Vladimir,6,0,34,28
1656890030385,MATH 193A,A02,083225,Rotar; Vladimir,3,0,34,31
1656890030385,MATH 193A,A03,083781,Rotar; Vladimir,1,0,34,33
1656890030385,MATH 193A,A04,083782,Rotar; Vladimir,6,0,34,28
1656890030385,MATH 193A,A05,093482,Rotar; Vladimir,6,0,34,28
1656890036411,MATH 197,001,091859,McAuley; Julian John,9999,0,9999,0
1656890036411,MATH 197,002,095566,Kedlaya; Kiran S.,9997,0,9999,2
1656890036411,MATH 197,003,095567,Xiao; Ming,9999,0,9999,0
1656890036411,MATH 197,004,095571,Perols; Johan Lars,9998,0,9999,1
1656890043466,COGS 9,A01,083615,Shannon; Kyle Michael,6,0,75,69
1656890049490,COGS 11,A01,083617,Boyle; Mary E. T.,19,0,48,29
1656890055514,COGS 13,A01,083071,Bastos; Amalia Pinkusfeld,8,0,71,63
1656890061539,COGS 14A,A01,092681,Semenuks; Arturs,0,1,100,100
1656890067566,COGS 14B,A01,083073,Cheng; Tzu-Han,5,0,63,58
1656890073590,COGS 17,A01,092677,Semenuks; Arturs,4,0,81,77
1656890079613,COGS 100,A01,083619,Allen; Michael Gordon,15,0,70,55
1656890085666,COGS 101A,A01,083621,Davis; Joshua Daniel,9,0,68,59
1656890091690,COGS 101B,A01,091572,Allen; Michael Gordon,8,0,65,57
1656890097715,COGS 101C,A01,083625,Delgado; Tania,17,0,35,18
1656890103738,COGS 107A,A01,083627,Boyle; Mary E. T.,13,0,60,47
1656890109763,COGS 118A,A01,083075,Gupta; Anjum,15,0,76,61
1656890115788,CSE 3,A50,083646,Miranda; Gregory Joseph,22,0,50,28
1656890121815,CSE 8A,A50,083650,Miranda; Gregory Joseph,17,1,56,39
1656890127839,CSE 11,A01,083080,Cao; Yingjun,4,15,40,36
1656890133862,CSE 12,A01,083652,Krause-Levy; Sophia Louisa,20,1,120,100
1656890139889,CSE 15L,A01,083654,Morris; Justin Loren,8,0,50,42
1656890139889,CSE 15L,A02,083655,Morris; Justin Loren,8,0,50,42
1656890145913,CSE 20,A01,083657,Tran; Khoa Dang,37,0,80,43
1656890151940,CSE 21,A01,095574,Bach; Quang Tran,21,0,48,27
1656890157972,CSE 30,A01,083084,Eldon; John,4,0,80,76
1656890157972,CSE 30,B01,095061,Bhaskar; Nishant,6,0,50,44
1656890163998,CSE 100,A01,083659,Cao; Yingjun,2,4,70,68
1656890170025,CSE 134B,A01,083661,Powell; Thomas Allan,19,0,100,81
1656890176051,CSE 140,A01,083663,Gungor; Onat,14,0,85,71
1656890182167,CSE 140L,A01,083088,Eldon; John,16,0,100,84
1656890188190,CSE 175,A01,083665,Kumar; Rakesh,3,0,25,22
1656890194213,CSE 190,A00,092507,Dubnov; Shlomo,7,0,20,13
1656890200239,ECE 45,A01,083139,Congero; Spencer William,5,0,75,70
1656890206267,ECE 65,A50,083695,Saad; Andrew S,12,0,30,18
1656890206267,ECE 65,A51,095125,Saad; Andrew S,25,0,26,1
1656890212291,ECE 109,A01,091882,Touri; Behrouz,16,0,70,54
1656890218319,ECE 180,A00,083140,Abi Samra; Nicholas Camill,0,0,30,30
1656890218319,ECE 180,B00,083141,Abi Samra; Nicholas Camill,0,0,30,30
1656890224347,MATH 10A,A01,083735,Patchell; Gregory David,1,0,30,29
1656890224347,MATH 10A,A02,083736,Patchell; Gregory David,20,0,30,10
1656890224347,MATH 10A,A03,083737,Patchell; Gregory David,15,0,30,15
1656890230372,MATH 10B,A01,083207,Lim; Seonhee,7,0,34,27
1656890230372,MATH 10B,A02,083208,Lim; Seonhee,9,0,35,26
1656890230372,MATH 10B,A03,093472,Lim; Seonhee,4,0,34,30
1656890230372,MATH 10B,B01,083739,Sinha; Shubham,9,0,30,21
1656890236398,MATH 18,A01,083743,Cinel; Cameron Alexander,6,0,30,24
1656890236398,MATH 18,A02,083744,Cinel; Cameron Alexander,15,0,30,15
1656890236398,MATH 18,A03,083745,Cinel; Cameron Alexander,8,0,30,22
1656890236398,MATH 18,B01,083748,Rideout; David Porter,4,0,37,33
1656890236398,MATH 18,B02,083749,Rideout; David Porter,3,0,36,33
1656890236398,MATH 18,B03,083750,Rideout; David Porter,2,0,37,35
1656890236398,MATH 18,B04,083751,Rideout; David Porter,5,0,36,31
1656890236398,MATH 18,B05,093473,Rideout; David Porter,4,0,36,32
1656890236398,MATH 18,B06,093474,Rideout; David Porter,5,0,36,31
1656890242426,MATH 20A,A01,083754,Zheng; Zequn,12,0,40,28
1656890248451,MATH 20B,A01,083756,Briones; Jor-el Thomas Caparas,1,0,36,35
1656890248451,MATH 20B,A02,083757,Briones; Jor-el Thomas Caparas,1,0,36,35
1656890248451,MATH 20B,A03,093475,Briones; Jor-el Thomas Caparas,0,0,36,36
1656890254475,MATH 20C,A01,083760,Briones; Jor-el Thomas Caparas,1,0,35,34
1656890254475,MATH 20C,A02,083761,Briones; Jor-el Thomas Caparas,8,0,35,27
1656890254475,MATH 20C,A03,093476,Briones; Jor-el Thomas Caparas,0,1,36,36
1656890254475,MATH 20C,B01,083762,Bach; Quang Tran,0,0,30,30
1656890260507,MATH 20D,A01,083765,Tran; Brian Kha,4,0,30,26
1656890260507,MATH 20D,A02,083766,Tran; Brian Kha,4,0,30,26
1656890260507,MATH 20D,A03,083767,Tran; Brian Kha,3,0,30,27
1656890266535,MATH 20E,A01,083771,Ganguly; Soumya,5,0,32,27
1656890266535,MATH 20E,A02,083772,Ganguly; Soumya,6,0,32,26
1656890266535,MATH 20E,B01,083773,Ciotti; Benjamin,18,0,35,17
1656890266535,MATH 20E,B02,083774,Ciotti; Benjamin,17,0,35,18
1656890272556,MATH 103A,A01,083777,Greenfeld; Be'Eri,2,0,36,34
1656890272556,MATH 103A,A02,083778,Greenfeld; Be'Eri,5,0,36,31
1656890272556,MATH 103A,A03,093561,Greenfeld; Be'Eri,4,0,36,32
1656890272556,MATH 103A,B01,083779,Greenfeld; Be'Eri,6,0,36,30
1656890272556,MATH 103A,B02,083780,Greenfeld; Be'Eri,2,0,36,34
1656890272556,MATH 103A,B03,093562,Greenfeld; Be'Eri,2,0,36,34
1656890278582,MATH 105,A01,085443,Carter; Anne Toulson,13,0,35,22
1656890278582,MATH 105,A02,093477,Carter; Anne Toulson,20,0,35,15
1656890284607,MATH 109,A01,083213,Ganzberger; Geoffrey Michael,2,0,34,32
1656890284607,MATH 109,A02,083214,Ganzberger; Geoffrey Michael,2,0,34,32
1656890284607,MATH 109,A03,093478,Ganzberger; Geoffrey Michael,1,0,34,33
1656890284607,MATH 109,B01,083215,Ganzberger; Geoffrey Michael,1,0,32,31
1656890284607,MATH 109,B02,083216,Ganzberger; Geoffrey Michael,1,0,32,31
1656890284607,MATH 109,B03,093479,Ganzberger; Geoffrey Michael,6,0,32,26
1656890290636,MATH 142A,A01,083219,Chow; Bennett,6,0,32,26
1656890290636,MATH 142A,A02,083220,Chow; Bennett,9,0,32,23
1656890290636,MATH 142A,A03,093480,Chow; Bennett,7,0,32,25
1656890290636,MATH 142A,B03,093481,Chow; Bennett,7,0,32,25
1656890290636,MATH 142A,B04,093558,Chow; Bennett,10,0,32,22
1656890290636,MATH 142A,B05,093559,Chow; Bennett,6,0,32,26
1656890296658,MATH 193A,A01,083224,Rotar; Vladimir,6,0,34,28
1656890296658,MATH 193A,A02,083225,Rotar; Vladimir,3,0,34,31
1656890296658,MATH 193A,A03,083781,Rotar; Vladimir,1,0,34,33
1656890296658,MATH 193A,A04,083782,Rotar; Vladimir,6,0,34,28
1656890296658,MATH 193A,A05,093482,Rotar; Vladimir,6,0,34,28
1656890302681,MATH 197,001,091859,McAuley; Julian John,9999,0,9999,0
1656890302681,MATH 197,002,095566,Kedlaya; Kiran S.,9997,0,9999,2
1656890302681,MATH 197,003,095567,Xiao; Ming,9999,0,9999,0
1656890302681,MATH 197,004,095571,Perols; Johan Lars,9998,0,9999,1
1656890309738,COGS 9,A01,083615,Shannon; Kyle Michael,6,0,75,69
1656890315763,COGS 11,A01,083617,Boyle; Mary E. T.,19,0,48,29
1656890321790,COGS 13,A01,083071,Bastos; Amalia Pinkusfeld,8,0,71,63
1656890327815,COGS 14A,A01,092681,Semenuks; Arturs,0,1,100,100
1656890333844,COGS 14B,A01,083073,Cheng; Tzu-Han,5,0,63,58
1656890339866,COGS 17,A01,092677,Semenuks; Arturs,4,0,81,77
1656890345889,COGS 100,A01,083619,Allen; Michael Gordon,15,0,70,55
1656890351912,COGS 101A,A01,083621,Davis; Joshua Daniel,9,0,68,59
1656890357939,COGS 101B,A01,091572,Allen; Michael Gordon,8,0,65,57
1656890363967,COGS 101C,A01,083625,Delgado; Tania,17,0,35,18
1656890369990,COGS 107A,A01,083627,Boyle; Mary E. T.,13,0,60,47
1656890376012,COGS 118A,A01,083075,Gupta; Anjum,15,0,76,61
1656890382035,CSE 3,A50,083646,Miranda; Gregory Joseph,22,0,50,28
1656890388059,CSE 8A,A50,083650,Miranda; Gregory Joseph,17,1,56,39
1656890394086,CSE 11,A01,083080,Cao; Yingjun,4,15,40,36
1656890400109,CSE 12,A01,083652,Krause-Levy; Sophia Louisa,20,1,120,100
1656890406136,CSE 15L,A01,083654,Morris; Justin Loren,8,0,50,42
1656890406136,CSE 15L,A02,083655,Morris; Justin Loren,8,0,50,42
1656890412162,CSE 20,A01,083657,Tran; Khoa Dang,37,0,80,43
1656890418188,CSE 21,A01,095574,Bach; Quang Tran,21,0,48,27
1656890424213,CSE 30,A01,083084,Eldon; John,4,0,80,76
1656890424213,CSE 30,B01,095061,Bhaskar; Nishant,6,0,50,44
1656890430236,CSE 100,A01,083659,Cao; Yingjun,2,4,70,68
1656890436260,CSE 134B,A01,083661,Powell; Thomas Allan,19,0,100,81
1656890442283,CSE 140,A01,083663,Gungor; Onat,14,0,85,71
1656890448317,CSE 140L,A01,083088,Eldon; John,16,0,100,84
1656890454339,CSE 175,A01,083665,Kumar; Rakesh,3,0,25,22
1656890460364,CSE 190,A00,092507,Dubnov; Shlomo,7,0,20,13
1656890466387,ECE 45,A01,083139,Congero; Spencer William,5,0,75,70
1656890472408,ECE 65,A50,083695,Saad; Andrew S,12,0,30,18
1656890472408,ECE 65,A51,095125,Saad; Andrew S,25,0,26,1
1656890478436,ECE 109,A01,091882,Touri; Behrouz,16,0,70,54
1656890484465,ECE 180,A00,083140,Abi Samra; Nicholas Camill,0,0,30,30
1656890484465,ECE 180,B00,083141,Abi Samra; Nicholas Camill,0,0,30,30
1656890490492,MATH 10A,A01,083735,Patchell; Gregory David,1,0,30,29
1656890490492,MATH 10A,A02,083736,Patchell; Gregory David,20,0,30,10
1656890490492,MATH 10A,A03,083737,Patchell; Gregory David,15,0,30,15
1656890496517,MATH 10B,A01,083207,Lim; Seonhee,7,0,34,27
1656890496517,MATH 10B,A02,083208,Lim; Seonhee,9,0,35,26
1656890496517,MATH 10B,A03,093472,Lim; Seonhee,4,0,34,30
1656890496517,MATH 10B,B01,083739,Sinha; Shubham,9,0,30,21
1656890502540,MATH 18,A01,083743,Cinel; Cameron Alexander,6,0,30,24
1656890502540,MATH 18,A02,083744,Cinel; Cameron Alexander,15,0,30,15
1656890502540,MATH 18,A03,083745,Cinel; Cameron Alexander,8,0,30,22
1656890502540,MATH 18,B01,083748,Rideout; David Porter,4,0,37,33
1656890502540,MATH 18,B02,083749,Rideout; David Porter,3,0,36,33
1656890502540,MATH 18,B03,083750,Rideout; David Porter,2,0,37,35
1656890502540,MATH 18,B04,083751,Rideout; David Porter,5,0,36,31
1656890502540,MATH 18,B05,093473,Rideout; David Porter,4,0,36,32
1656890502540,MATH 18,B06,093474,Rideout; David Porter,5,0,36,31
1656890508563,MATH 20A,A01,083754,Zheng; Zequn,12,0,40,28
1656890514586,MATH 20B,A01,083756,Briones; Jor-el Thomas Caparas,1,0,36,35
1656890514586,MATH 20B,A02,083757,Briones; Jor-el Thomas Caparas,1,0,36,35
1656890514586,MATH 20B,A03,093475,Briones; Jor-el Thomas Caparas,0,0,36,36
1656890520615,MATH 20C,A01,083760,Briones; Jor-el Thomas Caparas,1,0,35,34
1656890520615,MATH 20C,A02,083761,Briones; Jor-el Thomas Caparas,8,0,35,27
1656890520615,MATH 20C,A03,093476,Briones; Jor-el Thomas Caparas,0,1,36,36
1656890520615,MATH 20C,B01,083762,Bach; Quang Tran,0,0,30,30
1656890526642,MATH 20D,A01,083765,Tran; Brian Kha,4,0,30,26
1656890526642,MATH 20D,A02,083766,Tran; Brian Kha,4,0,30,26
1656890526642,MATH 20D,A03,083767,Tran; Brian Kha,3,0,30,27
1656890532665,MATH 20E,A01,083771,Ganguly; Soumya,5,0,32,27
1656890532665,MATH 20E,A02,083772,Ganguly; Soumya,6,0,32,26
1656890532665,MATH 20E,B01,083773,Ciotti; Benjamin,18,0,35,17
1656890532665,MATH 20E,B02,083774,Ciotti; Benjamin,17,0,35,18
1656890538689,MATH 103A,A01,083777,Greenfeld; Be'Eri,2,0,36,34
1656890538689,MATH 103A,A02,083778,Greenfeld; Be'Eri,5,0,36,31
1656890538689,MATH 103A,A03,093561,Greenfeld; Be'Eri,4,0,36,32
1656890538689,MATH 103A,B01,083779,Greenfeld; Be'Eri,6,0,36,30
1656890538689,MATH 103A,B02,083780,Greenfeld; Be'Eri,2,0,36,34
1656890538689,MATH 103A,B03,093562,Greenfeld; Be'Eri,2,0,36,34
1656890544718,MATH 105,A01,085443,Carter; Anne Toulson,13,0,35,22
1656890544718,MATH 105,A02,093477,Carter; Anne Toulson,20,0,35,15
1656890550741,MATH 109,A01,083213,Ganzberger; Geoffrey Michael,2,0,34,32
1656890550741,MATH 109,A02,083214,Ganzberger; Geoffrey Michael,2,0,34,32
1656890550741,MATH 109,A03,093478,Ganzberger; Geoffrey Michael,1,0,34,33
1656890550741,MATH 109,B01,083215,Ganzberger; Geoffrey Michael,1,0,32,31
1656890550741,MATH 109,B02,083216,Ganzberger; Geoffrey Michael,1,0,32,31
1656890550741,MATH 109,B03,093479,Ganzberger; Geoffrey Michael,6,0,32,26
1656890556765,MATH 142A,A01,083219,Chow; Bennett,6,0,32,26
1656890556765,MATH 142A,A02,083220,Chow; Bennett,9,0,32,23
1656890556765,MATH 142A,A03,093480,Chow; Bennett,7,0,32,25
1656890556765,MATH 142A,B03,093481,Chow; Bennett,7,0,32,25
1656890556765,MATH 142A,B04,093558,Chow; Bennett,10,0,32,22
1656890556765,MATH 142A,B05,093559,Chow; Bennett,6,0,32,26
1656890562795,MATH 193A,A01,083224,Rotar; Vladimir,6,0,34,28
1656890562795,MATH 193A,A02,083225,Rotar; Vladimir,3,0,34,31
1656890562795,MATH 193A,A03,083781,Rotar; Vladimir,1,0,34,33
1656890562795,MATH 193A,A04,083782,Rotar; Vladimir,6,0,34,28
1656890562795,MATH 193A,A05,093482,Rotar; Vladimir,6,0,34,28
1656890568816,MATH 197,001,091859,McAuley; Julian John,9999,0,9999,0
1656890568816,MATH 197,002,095566,Kedlaya; Kiran S.,9997,0,9999,2
1656890568816,MATH 197,003,095567,Xiao; Ming,9999,0,9999,0
1656890568816,MATH 197,004,095571,Perols; Johan Lars,9998,0,9999,1
1656890575874,COGS 9,A01,083615,Shannon; Kyle Michael,6,0,75,69
1656890581901,COGS 11,A01,083617,Boyle; Mary E. T.,19,0,48,29
1656890587928,COGS 13,A01,083071,Bastos; Amalia Pinkusfeld,8,0,71,63
1656890593952,COGS 14A,A01,092681,Semenuks; Arturs,0,1,100,100
1656890599985,COGS 14B,A01,083073,Cheng; Tzu-Han,5,0,63,58
1656890606009,COGS 17,A01,092677,Semenuks; Arturs,4,0,81,77
1656890612032,COGS 100,A01,083619,Allen; Michael Gordon,15,0,70,55
1656890618060,COGS 101A,A01,083621,Davis; Joshua Daniel,9,0,68,59
1656890624082,COGS 101B,A01,091572,Allen; Michael Gordon,8,0,65,57
1656890630111,COGS 101C,A01,083625,Delgado; Tania,17,0,35,18
1656890636143,COGS 107A,A01,083627,Boyle; Mary E. T.,13,0,60,47
1656890642167,COGS 118A,A01,083075,Gupta; Anjum,15,0,76,61
1656890648192,CSE 3,A50,083646,Miranda; Gregory Joseph,22,0,50,28
1656890654217,CSE 8A,A50,083650,Miranda; Gregory Joseph,17,1,56,39
1656890660241,CSE 11,A01,083080,Cao; Yingjun,4,15,40,36
1656890666265,CSE 12,A01,083652,Krause-Levy; Sophia Louisa,20,1,120,100
1656890672290,CSE 15L,A01,083654,Morris; Justin Loren,8,0,50,42
1656890672290,CSE 15L,A02,083655,Morris; Justin Loren,8,0,50,42
1656890678316,CSE 20,A01,083657,Tran; Khoa Dang,37,0,80,43
1656890684339,CSE 21,A01,095574,Bach; Quang Tran,21,0,48,27
1656890690367,CSE 30,A01,083084,Eldon; John,4,0,80,76
1656890690367,CSE 30,B01,095061,Bhaskar; Nishant,6,0,50,44
1656890696389,CSE 100,A01,083659,Cao; Yingjun,2,4,70,68
1656890702414,CSE 134B,A01,083661,Powell; Thomas Allan,19,0,100,81
1656890708437,CSE 140,A01,083663,Gungor; Onat,14,0,85,71
1656890714460,CSE 140L,A01,083088,Eldon; John,16,0,100,84
1656890720483,CSE 175,A01,083665,Kumar; Rakesh,3,0,25,22
1656890726517,CSE 190,A00,092507,Dubnov; Shlomo,7,0,20,13
1656890732543,ECE 45,A01,083139,Congero; Spencer William,5,0,75,70
1656890738571,ECE 65,A50,083695,Saad; Andrew S,12,0,30,18
1656890738571,ECE 65,A51,095125,Saad; Andrew S,25,0,26,1
1656890744596,ECE 109,A01,091882,Touri; Behrouz,16,0,70,54
1656890750620,ECE 180,A00,083140,Abi Samra; Nicholas Camill,0,0,30,30
1656890750620,ECE 180,B00,083141,Abi Samra; Nicholas Camill,0,0,30,30
1656890756647,MATH 10A,A01,083735,Patchell; Gregory David,1,0,30,29
1656890756647,MATH 10A,A02,083736,Patchell; Gregory David,20,0,30,10
1656890756647,MATH 10A,A03,083737,Patchell; Gregory David,15,0,30,15
1656890762671,MATH 10B,A01,083207,Lim; Seonhee,7,0,34,27
1656890762671,MATH 10B,A02,083208,Lim; Seonhee,9,0,35,26
1656890762671,MATH 10B,A03,093472,Lim; Seonhee,4,0,34,30
1656890762671,MATH 10B,B01,083739,Sinha; Shubham,9,0,30,21
1656890768702,MATH 18,A01,083743,Cinel; Cameron Alexander,6,0,30,24
1656890768702,MATH 18,A02,083744,Cinel; Cameron Alexander,15,0,30,15
1656890768702,MATH 18,A03,083745,Cinel; Cameron Alexander,8,0,30,22
1656890768702,MATH 18,B01,083748,Rideout; David Porter,4,0,37,33
1656890768702,MATH 18,B02,083749,Rideout; David Porter,3,0,36,33
1656890768702,MATH 18,B03,083750,Rideout; David Porter,2,0,37,35
1656890768702,MATH 18,B04,083751,Rideout; David Porter,5,0,36,31
1656890768702,MATH 18,B05,093473,Rideout; David Porter,4,0,36,32
1656890768702,MATH 18,B06,093474,Rideout; David Porter,5,0,36,31
1656890774729,MATH 20A,A01,083754,Zheng; Zequn,12,0,40,28
1656890780831,MATH 20B,A01,083756,Briones; Jor-el Thomas Caparas,1,0,36,35
1656890780831,MATH 20B,A02,083757,Briones; Jor-el Thomas Caparas,1,0,36,35
1656890780831,MATH 20B,A03,093475,Briones; Jor-el Thomas Caparas,0,0,36,36
1656890786859,MATH 20C,A01,083760,Briones; Jor-el Thomas Caparas,1,0,35,34
1656890786859,MATH 20C,A02,083761,Briones; Jor-el Thomas Caparas,8,0,35,27
1656890786859,MATH 20C,A03,093476,Briones; Jor-el Thomas Caparas,0,1,36,36
1656890786859,MATH 20C,B01,083762,Bach; Quang Tran,0,0,30,30
1656890792883,MATH 20D,A01,083765,Tran; Brian Kha,4,0,30,26
1656890792883,MATH 20D,A02,083766,Tran; Brian Kha,4,0,30,26
1656890792883,MATH 20D,A03,083767,Tran; Brian Kha,3,0,30,27
1656890798907,MATH 20E,A01,083771,Ganguly; Soumya,5,0,32,27
1656890798907,MATH 20E,A02,083772,Ganguly; Soumya,6,0,32,26
1656890798907,MATH 20E,B01,083773,Ciotti; Benjamin,18,0,35,17
1656890798907,MATH 20E,B02,083774,Ciotti; Benjamin,17,0,35,18
1656890804931,MATH 103A,A01,083777,Greenfeld; Be'Eri,2,0,36,34
1656890804931,MATH 103A,A02,083778,Greenfeld; Be'Eri,5,0,36,31
1656890804931,MATH 103A,A03,093561,Greenfeld; Be'Eri,4,0,36,32
1656890804931,MATH 103A,B01,083779,Greenfeld; Be'Eri,6,0,36,30
1656890804931,MATH 103A,B02,083780,Greenfeld; Be'Eri,2,0,36,34
1656890804931,MATH 103A,B03,093562,Greenfeld; Be'Eri,2,0,36,34
1656890810971,MATH 105,A01,085443,Carter; Anne Toulson,13,0,35,22
1656890810971,MATH 105,A02,093477,Carter; Anne Toulson,20,0,35,15
1656890816992,MATH 109,A01,083213,Ganzberger; Geoffrey Michael,2,0,34,32
1656890816992,MATH 109,A02,083214,Ganzberger; Geoffrey Michael,2,0,34,32
1656890816992,MATH 109,A03,093478,Ganzberger; Geoffrey Michael,1,0,34,33
1656890816992,MATH 109,B01,083215,Ganzberger; Geoffrey Michael,1,0,32,31
1656890816992,MATH 109,B02,083216,Ganzberger; Geoffrey Michael,1,0,32,31
1656890816992,MATH 109,B03,093479,Ganzberger; Geoffrey Michael,6,0,32,26
1656890823021,MATH 142A,A01,083219,Chow; Bennett,6,0,32,26
1656890823021,MATH 142A,A02,083220,Chow; Bennett,9,0,32,23
1656890823021,MATH 142A,A03,093480,Chow; Bennett,7,0,32,25
1656890823021,MATH 142A,B03,093481,Chow; Bennett,7,0,32,25
1656890823021,MATH 142A,B04,093558,Chow; Bennett,10,0,32,22
1656890823021,MATH 142A,B05,093559,Chow; Bennett,6,0,32,26
1656890829044,MATH 193A,A01,083224,Rotar; Vladimir,6,0,34,28
1656890829044,MATH 193A,A02,083225,Rotar; Vladimir,3,0,34,31
1656890829044,MATH 193A,A03,083781,Rotar; Vladimir,1,0,34,33
1656890829044,MATH 193A,A04,083782,Rotar; Vladimir,6,0,34,28
1656890829044,MATH 193A,A05,093482,Rotar; Vladimir,6,0,34,28
1656890835070,MATH 197,001,091859,McAuley; Julian John,9999,0,9999,0
1656890835070,MATH 197,002,095566,Kedlaya; Kiran S.,9997,0,9999,2
1656890835070,MATH 197,003,095567,Xiao; Ming,9999,0,9999,0
1656890835070,MATH 197,004,095571,Perols; Johan Lars,9998,0,9999,1
1656890842126,COGS 9,A01,083615,Shannon; Kyle Michael,6,0,75,69
1656890848148,COGS 11,A01,083617,Boyle; Mary E. T.,19,0,48,29
1656890854173,COGS 13,A01,083071,Bastos; Amalia Pinkusfeld,8,0,71,63
1656890860200,COGS 14A,A01,092681,Semenuks; Arturs,0,1,100,100
1656890866226,COGS 14B,A01,083073,Cheng; Tzu-Han,5,0,63,58
1656890872252,COGS 17,A01,092677,Semenuks; Arturs,4,0,81,77
1656890878285,COGS 100,A01,083619,Allen; Michael Gordon,15,0,70,55
1656890884307,COGS 101A,A01,083621,Davis; Joshua Daniel,9,0,68,59
1656890890332,COGS 101B,A01,091572,Allen; Michael Gordon,8,0,65,57
1656890896354,COGS 101C,A01,083625,Delgado; Tania,17,0,35,18
1656890902382,COGS 107A,A01,083627,Boyle; Mary E. T.,13,0,60,47
1656890908410,COGS 118A,A01,083075,Gupta; Anjum,15,0,76,61
1656890914437,CSE 3,A50,083646,Miranda; Gregory Joseph,22,0,50,28
1656890920466,CSE 8A,A50,083650,Miranda; Gregory Joseph,17,1,56,39
1656890926487,CSE 11,A01,083080,Cao; Yingjun,4,15,40,36
1656890932515,CSE 12,A01,083652,Krause-Levy; Sophia Louisa,20,1,120,100
1656890938538,CSE 15L,A01,083654,Morris; Justin Loren,8,0,50,42
1656890938538,CSE 15L,A02,083655,Morris; Justin Loren,8,0,50,42
1656890944562,CSE 20,A01,083657,Tran; Khoa Dang,37,0,80,43
1656890950589,CSE 21,A01,095574,Bach; Quang Tran,21,0,48,27
1656890956616,CSE 30,A01,083084,Eldon; John,4,0,80,76
1656890956616,CSE 30,B01,095061,Bhaskar; Nishant,6,0,50,44
1656890962637,CSE 100,A01,083659,Cao; Yingjun,2,4,70,68
1656890968660,CSE 134B,A01,083661,Powell; Thomas Allan,19,0,100,81
1656890974680,CSE 140,A01,083663,Gungor; Onat,14,0,85,71
1656890980707,CSE 140L,A01,083088,Eldon; John,16,0,100,84
1656890986730,CSE 175,A01,083665,Kumar; Rakesh,3,0,25,22
1656890992756,CSE 190,A00,092507,Dubnov; Shlomo,7,0,20,13
1656890998781,ECE 45,A01,083139,Congero; Spencer William,5,0,75,70
1656891004802,ECE 65,A50,083695,Saad; Andrew S,12,0,30,18
1656891004802,ECE 65,A51,095125,Saad; Andrew S,25,0,26,1
1656891010828,ECE 109,A01,091882,Touri; Behrouz,16,0,70,54
1656891016853,ECE 180,A00,083140,Abi Samra; Nicholas Camill,0,0,30,30
1656891016853,ECE 180,B00,083141,Abi Samra; Nicholas Camill,0,0,30,30
1656891022878,MATH 10A,A01,083735,Patchell; Gregory David,1,0,30,29
1656891022878,MATH 10A,A02,083736,Patchell; Gregory David,20,0,30,10
1656891022878,MATH 10A,A03,083737,Patchell; Gregory David,15,0,30,15
1656891028902,MATH 10B,A01,083207,Lim; Seonhee,7,0,34,27
1656891028902,MATH 10B,A02,083208,Lim; Seonhee,9,0,35,26
1656891028902,MATH 10B,A03,093472,Lim; Seonhee,4,0,34,30
1656891028902,MATH 10B,B01,083739,Sinha; Shubham,9,0,30,21
1656891034927,MATH 18,A01,083743,Cinel; Cameron Alexander,6,0,30,24
1656891034927,MATH 18,A02,083744,Cinel; Cameron Alexander,15,0,30,15
1656891034927,MATH 18,A03,083745,Cinel; Cameron Alexander,8,0,30,22
1656891034927,MATH 18,B01,083748,Rideout; David Porter,4,0,37,33
1656891034927,MATH 18,B02,083749,Rideout; David Porter,3,0,36,33
1656891034927,MATH 18,B03,083750,Rideout; David Porter,2,0,37,35
1656891034927,MATH 18,B04,083751,Rideout; David Porter,5,0,36,31
1656891034927,MATH 18,B05,093473,Rideout; David Porter,4,0,36,32
1656891034927,MATH 18,B06,093474,Rideout; David Porter,5,0,36,31
1656891040954,MATH 20A,A01,083754,Zheng; Zequn,12,0,40,28
1656891046982,MATH 20B,A01,083756,Briones; Jor-el Thomas Caparas,1,0,36,35
1656891046982,MATH 20B,A02,083757,Briones; Jor-el Thomas Caparas,1,0,36,35
1656891046982,MATH 20B,A03,093475,Briones; Jor-el Thomas Caparas,0,0,36,36
1656891053011,MATH 20C,A01,083760,Briones; Jor-el Thomas Caparas,1,0,35,34
1656891053011,MATH 20C,A02,083761,Briones; Jor-el Thomas Caparas,8,0,35,27
1656891053011,MATH 20C,A03,093476,Briones; Jor-el Thomas Caparas,0,1,36,36
1656891053011,MATH 20C,B01,083762,Bach; Quang Tran,0,0,30,30
1656891059046,MATH 20D,A01,083765,Tran; Brian Kha,4,0,30,26
1656891059046,MATH 20D,A02,083766,Tran; Brian Kha,4,0,30,26
1656891059046,MATH 20D,A03,083767,Tran; Brian Kha,3,0,30,27
1656891065075,MATH 20E,A01,083771,Ganguly; Soumya,5,0,32,27
1656891065075,MATH 20E,A02,083772,Ganguly; Soumya,6,0,32,26
1656891065075,MATH 20E,B01,083773,Ciotti; Benjamin,18,0,35,17
1656891065075,MATH 20E,B02,083774,Ciotti; Benjamin,17,0,35,18
1656891071105,MATH 103A,A01,083777,Greenfeld; Be'Eri,2,0,36,34
1656891071105,MATH 103A,A02,083778,Greenfeld; Be'Eri,5,0,36,31
1656891071105,MATH 103A,A03,093561,Greenfeld; Be'Eri,4,0,36,32
1656891071105,MATH 103A,B01,083779,Greenfeld; Be'Eri,6,0,36,30
1656891071105,MATH 103A,B02,083780,Greenfeld; Be'Eri,2,0,36,34
1656891071105,MATH 103A,B03,093562,Greenfeld; Be'Eri,2,0,36,34
1656891077130,MATH 105,A01,085443,Carter; Anne Toulson,13,0,35,22
1656891077130,MATH 105,A02,093477,Carter; Anne Toulson,20,0,35,15
1656891083157,MATH 109,A01,083213,Ganzberger; Geoffrey Michael,2,0,34,32
1656891083157,MATH 109,A02,083214,Ganzberger; Geoffrey Michael,2,0,34,32
1656891083157,MATH 109,A03,093478,Ganzberger; Geoffrey Michael,1,0,34,33
1656891083157,MATH 109,B01,083215,Ganzberger; Geoffrey Michael,1,0,32,31
1656891083157,MATH 109,B02,083216,Ganzberger; Geoffrey Michael,1,0,32,31
1656891083157,MATH 109,B03,093479,Ganzberger; Geoffrey Michael,6,0,32,26
1656891089182,MATH 142A,A01,083219,Chow; Bennett,6,0,32,26
1656891089182,MATH 142A,A02,083220,Chow; Bennett,9,0,32,23
1656891089182,MATH 142A,A03,093480,Chow; Bennett,7,0,32,25
1656891089182,MATH 142A,B03,093481,Chow; Bennett,7,0,32,25
1656891089182,MATH 142A,B04,093558,Chow; Bennett,10,0,32,22
1656891089182,MATH 142A,B05,093559,Chow; Bennett,6,0,32,26
1656891095212,MATH 193A,A01,083224,Rotar; Vladimir,6,0,34,28
1656891095212,MATH 193A,A02,083225,Rotar; Vladimir,3,0,34,31
1656891095212,MATH 193A,A03,083781,Rotar; Vladimir,1,0,34,33
1656891095212,MATH 193A,A04,083782,Rotar; Vladimir,6,0,34,28
1656891095212,MATH 193A,A05,093482,Rotar; Vladimir,6,0,34,28
1656891101241,MATH 197,001,091859,McAuley; Julian John,9999,0,9999,0
1656891101241,MATH 197,002,095566,Kedlaya; Kiran S.,9997,0,9999,2
1656891101241,MATH 197,003,095567,Xiao; Ming,9999,0,9999,0
1656891101241,MATH 197,004,095571,Perols; Johan Lars,9998,0,9999,1
1656891108293,COGS 9,A01,083615,Shannon; Kyle Michael,6,0,75,69
1656891114318,COGS 11,A01,083617,Boyle; Mary E. T.,19,0,48,29
1656891120341,COGS 13,A01,083071,Bastos; Amalia Pinkusfeld,8,0,71,63
1656891126363,COGS 14A,A01,092681,Semenuks; Arturs,0,1,100,100
1656891132390,COGS 14B,A01,083073,Cheng; Tzu-Han,5,0,63,58
1656891138417,COGS 17,A01,092677,Semenuks; Arturs,4,0,81,77
1656891144441,COGS 100,A01,083619,Allen; Michael Gordon,15,0,70,55
1656891150464,COGS 101A,A01,083621,Davis; Joshua Daniel,9,0,68,59
1656891156487,COGS 101B,A01,091572,Allen; Michael Gordon,8,0,65,57
1656891162512,COGS 101C,A01,083625,Delgado; Tania,17,0,35,18
1656891168536,COGS 107A,A01,083627,Boyle; Mary E. T.,13,0,60,47
1656891174574,COGS 118A,A01,083075,Gupta; Anjum,15,0,76,61
1656891180597,CSE 3,A50,083646,Miranda; Gregory Joseph,22,0,50,28
1656891186619,CSE 8A,A50,083650,Miranda; Gregory Joseph,17,1,56,39
1656891192641,CSE 11,A01,083080,Cao; Yingjun,4,15,40,36
1656891198665,CSE 12,A01,083652,Krause-Levy; Sophia Louisa,20,1,120,100
1656891204688,CSE 15L,A01,083654,Morris; Justin Loren,8,0,50,42
1656891204688,CSE 15L,A02,083655,Morris; Justin Loren,8,0,50,42
1656891210712,CSE 20,A01,083657,Tran; Khoa Dang,37,0,80,43
1656891216739,CSE 21,A01,095574,Bach; Quang Tran,21,0,48,27
1656891222768,CSE 30,A01,083084,Eldon; John,4,0,80,76
1656891222768,CSE 30,B01,095061,Bhaskar; Nishant,6,0,50,44
1656891228791,CSE 100,A01,083659,Cao; Yingjun,2,4,70,68
1656891234814,CSE 134B,A01,083661,Powell; Thomas Allan,19,0,100,81
1656891240840,CSE 140,A01,083663,Gungor; Onat,14,0,85,71
1656891246867,CSE 140L,A01,083088,Eldon; John,16,0,100,84
1656891252888,CSE 175,A01,083665,Kumar; Rakesh,3,0,25,22
1656891258911,CSE 190,A00,092507,Dubnov; Shlomo,7,0,20,13
1656891264934,ECE 45,A01,083139,Congero; Spencer William,5,0,75,70
1656891270966,ECE 65,A50,083695,Saad; Andrew S,12,0,30,18
1656891270966,ECE 65,A51,095125,Saad; Andrew S,25,0,26,1
1656891276992,ECE 109,A01,091882,Touri; Behrouz,16,0,70,54
1656891283022,ECE 180,A00,083140,Abi Samra; Nicholas Camill,0,0,30,30
1656891283022,ECE 180,B00,083141,Abi Samra; Nicholas Camill,0,0,30,30
1656891289046,MATH 10A,A01,083735,Patchell; Gregory David,1,0,30,29
1656891289046,MATH 10A,A02,083736,Patchell; Gregory David,20,0,30,10
1656891289046,MATH 10A,A03,083737,Patchell; Gregory David,15,0,30,15
1656891295069,MATH 10B,A01,083207,Lim; Seonhee,7,0,34,27
1656891295069,MATH 10B,A02,083208,Lim; Seonhee,9,0,35,26
1656891295069,MATH 10B,A03,093472,Lim; Seonhee,4,0,34,30
1656891295069,MATH 10B,B01,083739,Sinha; Shubham,9,0,30,21
1656891301101,MATH 18,A01,083743,Cinel; Cameron Alexander,6,0,30,24
1656891301101,MATH 18,A02,083744,Cinel; Cameron Alexander,15,0,30,15
1656891301101,MATH 18,A03,083745,Cinel; Cameron Alexander,8,0,30,22
1656891301101,MATH 18,B01,083748,Rideout; David Porter,4,0,37,33
1656891301101,MATH 18,B02,083749,Rideout; David Porter,3,0,36,33
1656891301101,MATH 18,B03,083750,Rideout; David Porter,2,0,37,35
1656891301101,MATH 18,B04,083751,Rideout; David Porter,5,0,36,31
1656891301101,MATH 18,B05,093473,Rideout; David Porter,4,0,36,32
1656891301101,MATH 18,B06,093474,Rideout; David Porter,5,0,36,31
1656891307127,MATH 20A,A01,083754,Zheng; Zequn,12,0,40,28
1656891313149,MATH 20B,A01,083756,Briones; Jor-el Thomas Caparas,1,0,36,35
1656891313149,MATH 20B,A02,083757,Briones; Jor-el Thomas Caparas,1,0,36,35
1656891313149,MATH 20B,A03,093475,Briones; Jor-el Thomas Caparas,0,0,36,36
1656891319173,MATH 20C,A01,083760,Briones; Jor-el Thomas Caparas,1,0,35,34
1656891319173,MATH 20C,A02,083761,Briones; Jor-el Thomas Caparas,8,0,35,27
1656891319173,MATH 20C,A03,093476,Briones; Jor-el Thomas Caparas,0,1,36,36
1656891319173,MATH 20C,B01,083762,Bach; Quang Tran,0,0,30,30
1656891325195,MATH 20D,A01,083765,Tran; Brian Kha,4,0,30,26
1656891325195,MATH 20D,A02,083766,Tran; Brian Kha,4,0,30,26
1656891325195,MATH 20D,A03,083767,Tran; Brian Kha,3,0,30,27
1656891331239,MATH 20E,A01,083771,Ganguly; Soumya,5,0,32,27
1656891331239,MATH 20E,A02,083772,Ganguly; Soumya,6,0,32,26
1656891331239,MATH 20E,B01,083773,Ciotti; Benjamin,18,0,35,17
1656891331239,MATH 20E,B02,083774,Ciotti; Benjamin,17,0,35,18
1656891337267,MATH 103A,A01,083777,Greenfeld; Be'Eri,2,0,36,34
1656891337267,MATH 103A,A02,083778,Greenfeld; Be'Eri,5,0,36,31
1656891337267,MATH 103A,A03,093561,Greenfeld; Be'Eri,4,0,36,32
1656891337267,MATH 103A,B01,083779,Greenfeld; Be'Eri,6,0,36,30
1656891337267,MATH 103A,B02,083780,Greenfeld; Be'Eri,2,0,36,34
1656891337267,MATH 103A,B03,093562,Greenfeld; Be'Eri,2,0,36,34
1656891343293,MATH 105,A01,085443,Carter; Anne Toulson,13,0,35,22
1656891343293,MATH 105,A02,093477,Carter; Anne Toulson,20,0,35,15
1656891349324,MATH 109,A01,083213,Ganzberger; Geoffrey Michael,2,0,34,32
1656891349324,MATH 109,A02,083214,Ganzberger; Geoffrey Michael,2,0,34,32
1656891349324,MATH 109,A03,093478,Ganzberger; Geoffrey Michael,1,0,34,33
1656891349324,MATH 109,B01,083215,Ganzberger; Geoffrey Michael,1,0,32,31
1656891349324,MATH 109,B02,083216,Ganzberger; Geoffrey Michael,1,0,32,31
1656891349324,MATH 109,B03,093479,Ganzberger; Geoffrey Michael,6,0,32,26
1656891355349,MATH 142A,A01,083219,Chow; Bennett,6,0,32,26
1656891355349,MATH 142A,A02,083220,Chow; Bennett,9,0,32,23
1656891355349,MATH 142A,A03,093480,Chow; Bennett,7,0,32,25
1656891355349,MATH 142A,B03,093481,Chow; Bennett,7,0,32,25
1656891355349,MATH 142A,B04,093558,Chow; Bennett,10,0,32,22
1656891355349,MATH 142A,B05,093559,Chow; Bennett,6,0,32,26
1656891361374,MATH 193A,A01,083224,Rotar; Vladimir,6,0,34,28
1656891361374,MATH 193A,A02,083225,Rotar; Vladimir,3,0,34,31
1656891361374,MATH 193A,A03,083781,Rotar; Vladimir,1,0,34,33
1656891361374,MATH 193A,A04,083782,Rotar; Vladimir,6,0,34,28
1656891361374,MATH 193A,A05,093482,Rotar; Vladimir,6,0,34,28
1656891367404,MATH 197,001,091859,McAuley; Julian John,9999,0,9999,0
1656891367404,MATH 197,002,095566,Kedlaya; Kiran S.,9997,0,9999,2
1656891367404,MATH 197,003,095567,Xiao; Ming,9999,0,9999,0
1656891367404,MATH 197,004,095571,Perols; Johan Lars,9998,0,9999,1
1656891374531,COGS 9,A01,083615,Shannon; Kyle Michael,6,0,75,69
1656891380555,COGS 11,A01,083617,Boyle; Mary E. T.,19,0,48,29
1656891386590,COGS 13,A01,083071,Bastos; Amalia Pinkusfeld,8,0,71,63
1656891392614,COGS 14A,A01,092681,Semenuks; Arturs,0,1,100,100
1656891398636,COGS 14B,A01,083073,Cheng; Tzu-Han,5,0,63,58
1656891404662,COGS 17,A01,092677,Semenuks; Arturs,4,0,81,77
1656891410689,COGS 100,A01,083619,Allen; Michael Gordon,15,0,70,55
1656891416717,COGS 101A,A01,083621,Davis; Joshua Daniel,9,0,68,59
1656891422741,COGS 101B,A01,091572,Allen; Michael Gordon,8,0,65,57
1656891428763,COGS 101C,A01,083625,Delgado; Tania,17,0,35,18
1656891434784,COGS 107A,A01,083627,Boyle; Mary E. T.,13,0,60,47
1656891440805,COGS 118A,A01,083075,Gupta; Anjum,15,0,76,61
1656891446828,CSE 3,A50,083646,Miranda; Gregory Joseph,22,0,50,28
1656891452851,CSE 8A,A50,083650,Miranda; Gregory Joseph,17,1,56,39
1656891458879,CSE 11,A01,083080,Cao; Yingjun,4,15,40,36
1656891464903,CSE 12,A01,083652,Krause-Levy; Sophia Louisa,20,1,120,100
1656891470925,CSE 15L,A01,083654,Morris; Justin Loren,8,0,50,42
1656891470925,CSE 15L,A02,083655,Morris; Justin Loren,8,0,50,42
1656891476952,CSE 20,A01,083657,Tran; Khoa Dang,37,0,80,43
1656891482975,CSE 21,A01,095574,Bach; Quang Tran,21,0,48,27
1656891488999,CSE 30,A01,083084,Eldon; John,4,0,80,76
1656891488999,CSE 30,B01,095061,Bhaskar; Nishant,6,0,50,44
1656891495025,CSE 100,A01,083659,Cao; Yingjun,2,4,70,68
1656891501048,CSE 134B,A01,083661,Powell; Thomas Allan,19,0,100,81
1656891507070,CSE 140,A01,083663,Gungor; Onat,14,0,85,71
1656891513092,CSE 140L,A01,083088,Eldon; John,16,0,100,84
1656891519125,CSE 175,A01,083665,Kumar; Rakesh,3,0,25,22
1656891525155,CSE 190,A00,092507,Dubnov; Shlomo,7,0,20,13
1656891531180,ECE 45,A01,083139,Congero; Spencer William,5,0,75,70
1656891537208,ECE 65,A50,083695,Saad; Andrew S,12,0,30,18
1656891537208,ECE 65,A51,095125,Saad; Andrew S,25,0,26,1
1656891543231,ECE 109,A01,091882,Touri; Behrouz,16,0,70,54
1656891549254,ECE 180,A00,083140,Abi Samra; Nicholas Camill,0,0,30,30
1656891549254,ECE 180,B00,083141,Abi Samra; Nicholas Camill,0,0,30,30
1656891555282,MATH 10A,A01,083735,Patchell; Gregory David,1,0,30,29
1656891555282,MATH 10A,A02,083736,Patchell; Gregory David,20,0,30,10
1656891555282,MATH 10A,A03,083737,Patchell; Gregory David,15,0,30,15
1656891561309,MATH 10B,A01,083207,Lim; Seonhee,7,0,34,27
1656891561309,MATH 10B,A02,083208,Lim; Seonhee,9,0,35,26
1656891561309,MATH 10B,A03,093472,Lim; Seonhee,4,0,34,30
1656891561309,MATH 10B,B01,083739,Sinha; Shubham,9,0,30,21
1656891567335,MATH 18,A01,083743,Cinel; Cameron Alexander,6,0,30,24
1656891567335,MATH 18,A02,083744,Cinel; Cameron Alexander,15,0,30,15
1656891567335,MATH 18,A03,083745,Cinel; Cameron Alexander,8,0,30,22
1656891567335,MATH 18,B01,083748,Rideout; David Porter,4,0,37,33
1656891567335,MATH 18,B02,083749,Rideout; David Porter,3,0,36,33
1656891567335,MATH 18,B03,083750,Rideout; David Porter,2,0,37,35
1656891567335,MATH 18,B04,083751,Rideout; David Porter,5,0,36,31
1656891567335,MATH 18,B05,093473,Rideout; David Porter,4,0,36,32
1656891567335,MATH 18,B06,093474,Rideout; David Porter,5,0,36,31
1656891573361,MATH 20A,A01,083754,Zheng; Zequn,12,0,40,28
1656891579388,MATH 20B,A01,083756,Briones; Jor-el Thomas Caparas,1,0,36,35
1656891579388,MATH 20B,A02,083757,Briones; Jor-el Thomas Caparas,1,0,36,35
1656891579388,MATH 20B,A03,093475,Briones; Jor-el Thomas Caparas,0,0,36,36
1656891585410,MATH 20C,A01,083760,Briones; Jor-el Thomas Caparas,1,0,35,34
1656891585410,MATH 20C,A02,083761,Briones; Jor-el Thomas Caparas,8,0,35,27
1656891585410,MATH 20C,A03,093476,Briones; Jor-el Thomas Caparas,0,1,36,36
1656891585410,MATH 20C,B01,083762,Bach; Quang Tran,0,0,30,30
1656891591438,MATH 20D,A01,083765,Tran; Brian Kha,4,0,30,26
1656891591438,MATH 20D,A02,083766,Tran; Brian Kha,4,0,30,26
1656891591438,MATH 20D,A03,083767,Tran; Brian Kha,3,0,30,27
1656891597463,MATH 20E,A01,083771,Ganguly; Soumya,5,0,32,27
1656891597463,MATH 20E,A02,083772,Ganguly; Soumya,6,0,32,26
1656891597463,MATH 20E,B01,083773,Ciotti; Benjamin,18,0,35,17
1656891597463,MATH 20E,B02,083774,Ciotti; Benjamin,17,0,35,18
1656891603486,MATH 103A,A01,083777,Greenfeld; Be'Eri,2,0,36,34
1656891603486,MATH 103A,A02,083778,Greenfeld; Be'Eri,5,0,36,31
1656891603486,MATH 103A,A03,093561,Greenfeld; Be'Eri,4,0,36,32
1656891603486,MATH 103A,B01,083779,Greenfeld; Be'Eri,6,0,36,30
1656891603486,MATH 103A,B02,083780,Greenfeld; Be'Eri,2,0,36,34
1656891603486,MATH 103A,B03,093562,Greenfeld; Be'Eri,2,0,36,34
1656891609513,MATH 105,A01,085443,Carter; Anne Toulson,13,0,35,22
1656891609513,MATH 105,A02,093477,Carter; Anne Toulson,20,0,35,15
1656891615542,MATH 109,A01,083213,Ganzberger; Geoffrey Michael,2,0,34,32
1656891615542,MATH 109,A02,083214,Ganzberger; Geoffrey Michael,2,0,34,32
1656891615542,MATH 109,A03,093478,Ganzberger; Geoffrey Michael,1,0,34,33
1656891615542,MATH 109,B01,083215,Ganzberger; Geoffrey Michael,1,0,32,31
1656891615542,MATH 109,B02,083216,Ganzberger; Geoffrey Michael,1,0,32,31
1656891615542,MATH 109,B03,093479,Ganzberger; Geoffrey Michael,6,0,32,26
1656891621569,MATH 142A,A01,083219,Chow; Bennett,6,0,32,26
1656891621569,MATH 142A,A02,083220,Chow; Bennett,9,0,32,23
1656891621569,MATH 142A,A03,093480,Chow; Bennett,7,0,32,25
1656891621569,MATH 142A,B03,093481,Chow; Bennett,7,0,32,25
1656891621569,MATH 142A,B04,093558,Chow; Bennett,10,0,32,22
1656891621569,MATH 142A,B05,093559,Chow; Bennett,6,0,32,26
1656891627599,MATH 193A,A01,083224,Rotar; Vladimir,6,0,34,28
1656891627599,MATH 193A,A02,083225,Rotar; Vladimir,3,0,34,31
1656891627599,MATH 193A,A03,083781,Rotar; Vladimir,1,0,34,33
1656891627599,MATH 193A,A04,083782,Rotar; Vladimir,6,0,34,28
1656891627599,MATH 193A,A05,093482,Rotar; Vladimir,6,0,34,28
1656891633622,MATH 197,001,091859,McAuley; Julian John,9999,0,9999,0
1656891633622,MATH 197,002,095566,Kedlaya; Kiran S.,9997,0,9999,2
1656891633622,MATH 197,003,095567,Xiao; Ming,9999,0,9999,0
1656891633622,MATH 197,004,095571,Perols; Johan Lars,9998,0,9999,1
1656891640682,COGS 9,A01,083615,Shannon; Kyle Michael,6,0,75,69
1656891646704,COGS 11,A01,083617,Boyle; Mary E. T.,19,0,48,29
1656891652726,COGS 13,A01,083071,Bastos; Amalia Pinkusfeld,8,0,71,63
1656891658746,COGS 14A,A01,092681,Semenuks; Arturs,0,1,100,100
1656891664769,COGS 14B,A01,083073,Cheng; Tzu-Han,5,0,63,58
1656891670791,COGS 17,A01,092677,Semenuks; Arturs,4,0,81,77
1656891676817,COGS 100,A01,083619,Allen; Michael Gordon,15,0,70,55
1656891682840,COGS 101A,A01,083621,Davis; Joshua Daniel,9,0,68,59
1656891688862,COGS 101B,A01,091572,Allen; Michael Gordon,8,0,65,57
1656891694888,COGS 101C,A01,083625,Delgado; Tania,17,0,35,18
1656891700913,COGS 107A,A01,083627,Boyle; Mary E. T.,13,0,60,47
1656891706937,COGS 118A,A01,083075,Gupta; Anjum,15,0,76,61
1656891712960,CSE 3,A50,083646,Miranda; Gregory Joseph,22,0,50,28
1656891718989,CSE 8A,A50,083650,Miranda; Gregory Joseph,17,1,56,39
1656891725012,CSE 11,A01,083080,Cao; Yingjun,4,15,40,36
1656891731037,CSE 12,A01,083652,Krause-Levy; Sophia Louisa,20,1,120,100
1656891737064,CSE 15L,A01,083654,Morris; Justin Loren,8,0,50,42
1656891737064,CSE 15L,A02,083655,Morris; Justin Loren,8,0,50,42
1656891743087,CSE 20,A01,083657,Tran; Khoa Dang,37,0,80,43
1656891749109,CSE 21,A01,095574,Bach; Quang Tran,21,0,48,27
1656891755132,CSE 30,A01,083084,Eldon; John,4,0,80,76
1656891755132,CSE 30,B01,095061,Bhaskar; Nishant,6,0,50,44
1656891761158,CSE 100,A01,083659,Cao; Yingjun,2,4,70,68
1656891767184,CSE 134B,A01,083661,Powell; Thomas Allan,19,0,100,81
1656891773206,CSE 140,A01,083663,Gungor; Onat,14,0,85,71
1656891779233,CSE 140L,A01,083088,Eldon; John,16,0,100,84
1656891785255,CSE 175,A01,083665,Kumar; Rakesh,3,0,25,22
1656891791276,CSE 190,A00,092507,Dubnov; Shlomo,7,0,20,13
1656891797299,ECE 45,A01,083139,Congero; Spencer William,5,0,75,70
1656891803323,ECE 65,A50,083695,Saad; Andrew S,12,0,30,18
1656891803323,ECE 65,A51,095125,Saad; Andrew S,25,0,26,1
1656891809352,ECE 109,A01,091882,Touri; Behrouz,16,0,70,54
1656891815374,ECE 180,A00,083140,Abi Samra; Nicholas Camill,0,0,30,30
1656891815374,ECE 180,B00,083141,Abi Samra; Nicholas Camill,0,0,30,30
1656891821397,MATH 10A,A01,083735,Patchell; Gregory David,1,0,30,29
1656891821397,MATH 10A,A02,083736,Patchell; Gregory David,20,0,30,10
1656891821397,MATH 10A,A03,083737,Patchell; Gregory David,15,0,30,15
1656891827422,MATH 10B,A01,083207,Lim; Seonhee,7,0,34,27
1656891827422,MATH 10B,A02,083208,Lim; Seonhee,9,0,35,26
1656891827422,MATH 10B,A03,093472,Lim; Seonhee,4,0,34,30
1656891827422,MATH 10B,B01,083739,Sinha; Shubham,9,0,30,21
1656891833447,MATH 18,A01,083743,Cinel; Cameron Alexander,6,0,30,24
1656891833447,MATH 18,A02,083744,Cinel; Cameron Alexander,15,0,30,15
1656891833447,MATH 18,A03,083745,Cinel; Cameron Alexander,8,0,30,22
1656891833447,MATH 18,B01,083748,Rideout; David Porter,4,0,37,33
1656891833447,MATH 18,B02,083749,Rideout; David Porter,3,0,36,33
1656891833447,MATH 18,B03,083750,Rideout; David Porter,2,0,37,35
1656891833447,MATH 18,B04,083751,Rideout; David Porter,5,0,36,31
1656891833447,MATH 18,B05,093473,Rideout; David Porter,4,0,36,32
1656891833447,MATH 18,B06,093474,Rideout; David Porter,5,0,36,31
1656891839472,MATH 20A,A01,083754,Zheng; Zequn,12,0,40,28
1656891845507,MATH 20B,A01,083756,Briones; Jor-el Thomas Caparas,1,0,36,35
1656891845507,MATH 20B,A02,083757,Briones; Jor-el Thomas Caparas,1,0,36,35
1656891845507,MATH 20B,A03,093475,Briones; Jor-el Thomas Caparas,0,0,36,36
1656891851530,MATH 20C,A01,083760,Briones; Jor-el Thomas Caparas,1,0,35,34
1656891851530,MATH 20C,A02,083761,Briones; Jor-el Thomas Caparas,8,0,35,27
1656891851530,MATH 20C,A03,093476,Briones; Jor-el Thomas Caparas,0,1,36,36
1656891851530,MATH 20C,B01,083762,Bach; Quang Tran,0,0,30,30
1656891857553,MATH 20D,A01,083765,Tran; Brian Kha,4,0,30,26
1656891857553,MATH 20D,A02,083766,Tran; Brian Kha,4,0,30,26
1656891857553,MATH 20D,A03,083767,Tran; Brian Kha,3,0,30,27
1656891863581,MATH 20E,A01,083771,Ganguly; Soumya,5,0,32,27
1656891863581,MATH 20E,A02,083772,Ganguly; Soumya,6,0,32,26
1656891863581,MATH 20E,B01,083773,Ciotti; Benjamin,18,0,35,17
1656891863581,MATH 20E,B02,083774,Ciotti; Benjamin,17,0,35,18
1656891869603,MATH 103A,A01,083777,Greenfeld; Be'Eri,2,0,36,34
1656891869603,MATH 103A,A02,083778,Greenfeld; Be'Eri,5,0,36,31
1656891869603,MATH 103A,A03,093561,Greenfeld; Be'Eri,4,0,36,32
1656891869603,MATH 103A,B01,083779,Greenfeld; Be'Eri,6,0,36,30
1656891869603,MATH 103A,B02,083780,Greenfeld; Be'Eri,2,0,36,34
1656891869603,MATH 103A,B03,093562,Greenfeld; Be'Eri,2,0,36,34
1656891875628,MATH 105,A01,085443,Carter; Anne Toulson,13,0,35,22
1656891875628,MATH 105,A02,093477,Carter; Anne Toulson,20,0,35,15
1656891881655,MATH 109,A01,083213,Ganzberger; Geoffrey Michael,2,0,34,32
1656891881655,MATH 109,A02,083214,Ganzberger; Geoffrey Michael,2,0,34,32
1656891881655,MATH 109,A03,093478,Ganzberger; Geoffrey Michael,1,0,34,33
1656891881655,MATH 109,B01,083215,Ganzberger; Geoffrey Michael,1,0,32,31
1656891881655,MATH 109,B02,083216,Ganzberger; Geoffrey Michael,1,0,32,31
1656891881655,MATH 109,B03,093479,Ganzberger; Geoffrey Michael,6,0,32,26
1656891887686,MATH 142A,A01,083219,Chow; Bennett,6,0,32,26
1656891887686,MATH 142A,A02,083220,Chow; Bennett,9,0,32,23
1656891887686,MATH 142A,A03,093480,Chow; Bennett,7,0,32,25
1656891887686,MATH 142A,B03,093481,Chow; Bennett,7,0,32,25
1656891887686,MATH 142A,B04,093558,Chow; Bennett,10,0,32,22
1656891887686,MATH 142A,B05,093559,Chow; Bennett,6,0,32,26
1656891893713,MATH 193A,A01,083224,Rotar; Vladimir,6,0,34,28
1656891893713,MATH 193A,A02,083225,Rotar; Vladimir,3,0,34,31
1656891893713,MATH 193A,A03,083781,Rotar; Vladimir,1,0,34,33
1656891893713,MATH 193A,A04,083782,Rotar; Vladimir,6,0,34,28
1656891893713,MATH 193A,A05,093482,Rotar; Vladimir,6,0,34,28
1656891899740,MATH 197,001,091859,McAuley; Julian John,9999,0,9999,0
1656891899740,MATH 197,002,095566,Kedlaya; Kiran S.,9997,0,9999,2
1656891899740,MATH 197,003,095567,Xiao; Ming,9999,0,9999,0
1656891899740,MATH 197,004,095571,Perols; Johan Lars,9998,0,9999,1
1656891906805,COGS 9,A01,083615,Shannon; Kyle Michael,6,0,75,69
1656891912830,COGS 11,A01,083617,Boyle; Mary E. T.,19,0,48,29
1656891918853,COGS 13,A01,083071,Bastos; Amalia Pinkusfeld,8,0,71,63
1656891924880,COGS 14A,A01,092681,Semenuks; Arturs,0,1,100,100
1656891930904,COGS 14B,A01,083073,Cheng; Tzu-Han,5,0,63,58
1656891936928,COGS 17,A01,092677,Semenuks; Arturs,4,0,81,77
1656891942957,COGS 100,A01,083619,Allen; Michael Gordon,15,0,70,55
1656891948980,COGS 101A,A01,083621,Davis; Joshua Daniel,9,0,68,59
1656891955006,COGS 101B,A01,091572,Allen; Michael Gordon,8,0,65,57
1656891961034,COGS 101C,A01,083625,Delgado; Tania,17,0,35,18
1656891967058,COGS 107A,A01,083627,Boyle; Mary E. T.,13,0,60,47
1656891973175,COGS 118A,A01,083075,Gupta; Anjum,15,0,76,61
1656891979198,CSE 3,A50,083646,Miranda; Gregory Joseph,22,0,50,28
1656891985225,CSE 8A,A50,083650,Miranda; Gregory Joseph,17,1,56,39
1656891991251,CSE 11,A01,083080,Cao; Yingjun,4,15,40,36
1656891997281,CSE 12,A01,083652,Krause-Levy; Sophia Louisa,20,1,120,100
1656892003304,CSE 15L,A01,083654,Morris; Justin Loren,8,0,50,42
1656892003304,CSE 15L,A02,083655,Morris; Justin Loren,8,0,50,42
1656892009334,CSE 20,A01,083657,Tran; Khoa Dang,37,0,80,43
1656892015358,CSE 21,A01,095574,Bach; Quang Tran,21,0,48,27
1656892021382,CSE 30,A01,083084,Eldon; John,4,0,80,76
1656892021382,CSE 30,B01,095061,Bhaskar; Nishant,6,0,50,44
1656892027404,CSE 100,A01,083659,Cao; Yingjun,2,4,70,68
1656892033426,CSE 134B,A01,083661,Powell; Thomas Allan,19,0,100,81
1656892039450,CSE 140,A01,083663,Gungor; Onat,14,0,85,71
1656892045475,CSE 140L,A01,083088,Eldon; John,16,0,100,84
1656892051499,CSE 175,A01,083665,Kumar; Rakesh,3,0,25,22
1656892057525,CSE 190,A00,092507,Dubnov; Shlomo,7,0,20,13
1656892063549,ECE 45,A01,083139,Congero; Spencer William,5,0,75,70
1656892069576,ECE 65,A50,083695,Saad; Andrew S,12,0,30,18
1656892069576,ECE 65,A51,095125,Saad; Andrew S,25,0,26,1
1656892075606,ECE 109,A01,091882,Touri; Behrouz,16,0,70,54
1656892081627,ECE 180,A00,083140,Abi Samra; Nicholas Camill,0,0,30,30
1656892081627,ECE 180,B00,083141,Abi Samra; Nicholas Camill,0,0,30,30
1656892087655,MATH 10A,A01,083735,Patchell; Gregory David,1,0,30,29
1656892087655,MATH 10A,A02,083736,Patchell; Gregory David,20,0,30,10
1656892087655,MATH 10A,A03,083737,Patchell; Gregory David,15,0,30,15
1656892093688,MATH 10B,A01,083207,Lim; Seonhee,7,0,34,27
1656892093688,MATH 10B,A02,083208,Lim; Seonhee,9,0,35,26
1656892093688,MATH 10B,A03,093472,Lim; Seonhee,4,0,34,30
1656892093688,MATH 10B,B01,083739,Sinha; Shubham,9,0,30,21
1656892099718,MATH 18,A01,083743,Cinel; Cameron Alexander,6,0,30,24
1656892099718,MATH 18,A02,083744,Cinel; Cameron Alexander,15,0,30,15
1656892099718,MATH 18,A03,083745,Cinel; Cameron Alexander,8,0,30,22
1656892099718,MATH 18,B01,083748,Rideout; David Porter,4,0,37,33
1656892099718,MATH 18,B02,083749,Rideout; David Porter,3,0,36,33
1656892099718,MATH 18,B03,083750,Rideout; David Porter,2,0,37,35
1656892099718,MATH 18,B04,083751,Rideout; David Porter,5,0,36,31
1656892099718,MATH 18,B05,093473,Rideout; David Porter,4,0,36,32
1656892099718,MATH 18,B06,093474,Rideout; David Porter,5,0,36,31
1656892105765,MATH 20A,A01,083754,Zheng; Zequn,12,0,40,28
1656892111792,MATH 20B,A01,083756,Briones; Jor-el Thomas Caparas,1,0,36,35
1656892111792,MATH 20B,A02,083757,Briones; Jor-el Thomas Caparas,1,0,36,35
1656892111792,MATH 20B,A03,093475,Briones; Jor-el Thomas Caparas,0,0,36,36
1656892117816,MATH 20C,A01,083760,Briones; Jor-el Thomas Caparas,1,0,35,34
1656892117816,MATH 20C,A02,083761,Briones; Jor-el Thomas Caparas,8,0,35,27
1656892117816,MATH 20C,A03,093476,Briones; Jor-el Thomas Caparas,0,1,36,36
1656892117816,MATH 20C,B01,083762,Bach; Quang Tran,0,0,30,30
1656892123842,MATH 20D,A01,083765,Tran; Brian Kha,4,0,30,26
1656892123842,MATH 20D,A02,083766,Tran; Brian Kha,4,0,30,26
1656892123842,MATH 20D,A03,083767,Tran; Brian Kha,3,0,30,27
1656892129866,MATH 20E,A01,083771,Ganguly; Soumya,5,0,32,27
1656892129866,MATH 20E,A02,083772,Ganguly; Soumya,6,0,32,26
1656892129866,MATH 20E,B01,083773,Ciotti; Benjamin,18,0,35,17
1656892129866,MATH 20E,B02,083774,Ciotti; Benjamin,17,0,35,18
1656892135894,MATH 103A,A01,083777,Greenfeld; Be'Eri,2,0,36,34
1656892135894,MATH 103A,A02,083778,Greenfeld; Be'Eri,5,0,36,31
1656892135894,MATH 103A,A03,093561,Greenfeld; Be'Eri,4,0,36,32
1656892135894,MATH 103A,B01,083779,Greenfeld; Be'Eri,6,0,36,30
1656892135894,MATH 103A,B02,083780,Greenfeld; Be'Eri,2,0,36,34
1656892135894,MATH 103A,B03,093562,Greenfeld; Be'Eri,2,0,36,34
1656892141920,MATH 105,A01,085443,Carter; Anne Toulson,13,0,35,22
1656892141920,MATH 105,A02,093477,Carter; Anne Toulson,20,0,35,15
1656892147948,MATH 109,A01,083213,Ganzberger; Geoffrey Michael,2,0,34,32
1656892147948,MATH 109,A02,083214,Ganzberger; Geoffrey Michael,2,0,34,32
1656892147948,MATH 109,A03,093478,Ganzberger; Geoffrey Michael,1,0,34,33
1656892147948,MATH 109,B01,083215,Ganzberger; Geoffrey Michael,1,0,32,31
1656892147948,MATH 109,B02,083216,Ganzberger; Geoffrey Michael,1,0,32,31
1656892147948,MATH 109,B03,093479,Ganzberger; Geoffrey Michael,6,0,32,26
1656892153971,MATH 142A,A01,083219,Chow; Bennett,6,0,32,26
1656892153971,MATH 142A,A02,083220,Chow; Bennett,9,0,32,23
1656892153971,MATH 142A,A03,093480,Chow; Bennett,7,0,32,25
1656892153971,MATH 142A,B03,093481,Chow; Bennett,7,0,32,25
1656892153971,MATH 142A,B04,093558,Chow; Bennett,10,0,32,22
1656892153971,MATH 142A,B05,093559,Chow; Bennett,6,0,32,26
1656892159998,MATH 193A,A01,083224,Rotar; Vladimir,6,0,34,28
1656892159998,MATH 193A,A02,083225,Rotar; Vladimir,3,0,34,31
1656892159998,MATH 193A,A03,083781,Rotar; Vladimir,1,0,34,33
1656892159998,MATH 193A,A04,083782,Rotar; Vladimir,6,0,34,28
1656892159998,MATH 193A,A05,093482,Rotar; Vladimir,6,0,34,28
1656892166023,MATH 197,001,091859,McAuley; Julian John,9999,0,9999,0
1656892166023,MATH 197,002,095566,Kedlaya; Kiran S.,9997,0,9999,2
1656892166023,MATH 197,003,095567,Xiao; Ming,9999,0,9999,0
1656892166023,MATH 197,004,095571,Perols; Johan Lars,9998,0,9999,1
1656892173081,COGS 9,A01,083615,Shannon; Kyle Michael,6,0,75,69
1656892179107,COGS 11,A01,083617,Boyle; Mary E. T.,19,0,48,29
1656892185135,COGS 13,A01,083071,Bastos; Amalia Pinkusfeld,8,0,71,63
1656892191160,COGS 14A,A01,092681,Semenuks; Arturs,0,1,100,100
1656892197194,COGS 14B,A01,083073,Cheng; Tzu-Han,5,0,63,58
1656892203224,COGS 17,A01,092677,Semenuks; Arturs,4,0,81,77
1656892209252,COGS 100,A01,083619,Allen; Michael Gordon,15,0,70,55
1656892215285,COGS 101A,A01,083621,Davis; Joshua Daniel,9,0,68,59
1656892221307,COGS 101B,A01,091572,Allen; Michael Gordon,8,0,65,57
1656892227332,COGS 101C,A01,083625,Delgado; Tania,17,0,35,18
1656892233358,COGS 107A,A01,083627,Boyle; Mary E. T.,13,0,60,47
1656892239383,COGS 118A,A01,083075,Gupta; Anjum,15,0,76,61
1656892245408,CSE 3,A50,083646,Miranda; Gregory Joseph,22,0,50,28
1656892251432,CSE 8A,A50,083650,Miranda; Gregory Joseph,17,1,56,39
1656892257455,CSE 11,A01,083080,Cao; Yingjun,4,15,40,36
1656892263478,CSE 12,A01,083652,Krause-Levy; Sophia Louisa,20,1,120,100
1656892269505,CSE 15L,A01,083654,Morris; Justin Loren,8,0,50,42
1656892269505,CSE 15L,A02,083655,Morris; Justin Loren,8,0,50,42
1656892275529,CSE 20,A01,083657,Tran; Khoa Dang,37,0,80,43
1656892281552,CSE 21,A01,095574,Bach; Quang Tran,21,0,48,27
1656892287579,CSE 30,A01,083084,Eldon; John,4,0,80,76
1656892287579,CSE 30,B01,095061,Bhaskar; Nishant,6,0,50,44
1656892293600,CSE 100,A01,083659,Cao; Yingjun,2,4,70,68
1656892299639,CSE 134B,A01,083661,Powell; Thomas Allan,19,0,100,81
1656892305671,CSE 140,A01,083663,Gungor; Onat,14,0,85,71
1656892311698,CSE 140L,A01,083088,Eldon; John,16,0,100,84
1656892317724,CSE 175,A01,083665,Kumar; Rakesh,3,0,25,22
1656892323751,CSE 190,A00,092507,Dubnov; Shlomo,7,0,20,13
1656892329774,ECE 45,A01,083139,Congero; Spencer William,5,0,75,70
1656892335812,ECE 65,A50,083695,Saad; Andrew S,12,0,30,18
1656892335812,ECE 65,A51,095125,Saad; Andrew S,25,0,26,1
1656892341836,ECE 109,A01,091882,Touri; Behrouz,16,0,70,54
1656892347869,ECE 180,A00,083140,Abi Samra; Nicholas Camill,0,0,30,30
1656892347869,ECE 180,B00,083141,Abi Samra; Nicholas Camill,0,0,30,30
1656892353893,MATH 10A,A01,083735,Patchell; Gregory David,1,0,30,29
1656892353893,MATH 10A,A02,083736,Patchell; Gregory David,20,0,30,10
1656892353893,MATH 10A,A03,083737,Patchell; Gregory David,15,0,30,15
1656892359916,MATH 10B,A01,083207,Lim; Seonhee,7,0,34,27
1656892359916,MATH 10B,A02,083208,Lim; Seonhee,9,0,35,26
1656892359916,MATH 10B,A03,093472,Lim; Seonhee,4,0,34,30
1656892359916,MATH 10B,B01,083739,Sinha; Shubham,9,0,30,21
1656892365942,MATH 18,A01,083743,Cinel; Cameron Alexander,6,0,30,24
1656892365942,MATH 18,A02,083744,Cinel; Cameron Alexander,15,0,30,15
1656892365942,MATH 18,A03,083745,Cinel; Cameron Alexander,8,0,30,22
1656892365942,MATH 18,B01,083748,Rideout; David Porter,4,0,37,33
1656892365942,MATH 18,B02,083749,Rideout; David Porter,3,0,36,33
1656892365942,MATH 18,B03,083750,Rideout; David Porter,2,0,37,35
1656892365942,MATH 18,B04,083751,Rideout; David Porter,5,0,36,31
1656892365942,MATH 18,B05,093473,Rideout; David Porter,4,0,36,32
1656892365942,MATH 18,B06,093474,Rideout; David Porter,5,0,36,31
1656892371964,MATH 20A,A01,083754,Zheng; Zequn,12,0,40,28
1656892377988,MATH 20B,A01,083756,Briones; Jor-el Thomas Caparas,1,0,36,35
1656892377988,MATH 20B,A02,083757,Briones; Jor-el Thomas Caparas,1,0,36,35
1656892377988,MATH 20B,A03,093475,Briones; Jor-el Thomas Caparas,0,0,36,36
1656892384016,MATH 20C,A01,083760,Briones; Jor-el Thomas Caparas,1,0,35,34
1656892384016,MATH 20C,A02,083761,Briones; Jor-el Thomas Caparas,8,0,35,27
1656892384016,MATH 20C,A03,093476,Briones; Jor-el Thomas Caparas,0,1,36,36
1656892384016,MATH 20C,B01,083762,Bach; Quang Tran,0,0,30,30
1656892390055,MATH 20D,A01,083765,Tran; Brian Kha,4,0,30,26
1656892390055,MATH 20D,A02,083766,Tran; Brian Kha,4,0,30,26
1656892390055,MATH 20D,A03,083767,Tran; Brian Kha,3,0,30,27
1656892396078,MATH 20E,A01,083771,Ganguly; Soumya,5,0,32,27
1656892396078,MATH 20E,A02,083772,Ganguly; Soumya,6,0,32,26
1656892396078,MATH 20E,B01,083773,Ciotti; Benjamin,18,0,35,17
1656892396078,MATH 20E,B02,083774,Ciotti; Benjamin,17,0,35,18
1656892402107,MATH 103A,A01,083777,Greenfeld; Be'Eri,2,0,36,34
1656892402107,MATH 103A,A02,083778,Greenfeld; Be'Eri,5,0,36,31
1656892402107,MATH 103A,A03,093561,Greenfeld; Be'Eri,4,0,36,32
1656892402107,MATH 103A,B01,083779,Greenfeld; Be'Eri,6,0,36,30
1656892402107,MATH 103A,B02,083780,Greenfeld; Be'Eri,2,0,36,34
1656892402107,MATH 103A,B03,093562,Greenfeld; Be'Eri,2,0,36,34
1656892408134,MATH 105,A01,085443,Carter; Anne Toulson,13,0,35,22
1656892408134,MATH 105,A02,093477,Carter; Anne Toulson,20,0,35,15
1656892414162,MATH 109,A01,083213,Ganzberger; Geoffrey Michael,2,0,34,32
1656892414162,MATH 109,A02,083214,Ganzberger; Geoffrey Michael,2,0,34,32
1656892414162,MATH 109,A03,093478,Ganzberger; Geoffrey Michael,1,0,34,33
1656892414162,MATH 109,B01,083215,Ganzberger; Geoffrey Michael,1,0,32,31
1656892414162,MATH 109,B02,083216,Ganzberger; Geoffrey Michael,1,0,32,31
1656892414162,MATH 109,B03,093479,Ganzberger; Geoffrey Michael,6,0,32,26
1656892420185,MATH 142A,A01,083219,Chow; Bennett,6,0,32,26
1656892420185,MATH 142A,A02,083220,Chow; Bennett,10,0,32,22
1656892420185,MATH 142A,A03,093480,Chow; Bennett,7,0,32,25
1656892420185,MATH 142A,B03,093481,Chow; Bennett,7,0,32,25
1656892420185,MATH 142A,B04,093558,Chow; Bennett,10,0,32,22
1656892420185,MATH 142A,B05,093559,Chow; Bennett,6,0,32,26
1656892426208,MATH 193A,A01,083224,Rotar; Vladimir,6,0,34,28
1656892426208,MATH 193A,A02,083225,Rotar; Vladimir,3,0,34,31
1656892426208,MATH 193A,A03,083781,Rotar; Vladimir,1,0,34,33
1656892426208,MATH 193A,A04,083782,Rotar; Vladimir,6,0,34,28
1656892426208,MATH 193A,A05,093482,Rotar; Vladimir,6,0,34,28
1656892432240,MATH 197,001,091859,McAuley; Julian John,9999,0,9999,0
1656892432240,MATH 197,002,095566,Kedlaya; Kiran S.,9997,0,9999,2
1656892432240,MATH 197,003,095567,Xiao; Ming,9999,0,9999,0
1656892432240,MATH 197,004,095571,Perols; Johan Lars,9998,0,9999,1
1656892439290,COGS 9,A01,083615,Shannon; Kyle Michael,6,0,75,69
1656892445313,COGS 11,A01,083617,Boyle; Mary E. T.,19,0,48,29
1656892451338,COGS 13,A01,083071,Bastos; Amalia Pinkusfeld,8,0,71,63
1656892457362,COGS 14A,A01,092681,Semenuks; Arturs,0,1,100,100
1656892463386,COGS 14B,A01,083073,Cheng; Tzu-Han,5,0,63,58
1656892469409,COGS 17,A01,092677,Semenuks; Arturs,4,0,81,77
1656892475433,COGS 100,A01,083619,Allen; Michael Gordon,15,0,70,55
1656892481459,COGS 101A,A01,083621,Davis; Joshua Daniel,9,0,68,59
1656892487482,COGS 101B,A01,091572,Allen; Michael Gordon,8,0,65,57
1656892493509,COGS 101C,A01,083625,Delgado; Tania,17,0,35,18
1656892499533,COGS 107A,A01,083627,Boyle; Mary E. T.,13,0,60,47
1656892505559,COGS 118A,A01,083075,Gupta; Anjum,15,0,76,61
1656892511583,CSE 3,A50,083646,Miranda; Gregory Joseph,22,0,50,28
1656892517606,CSE 8A,A50,083650,Miranda; Gregory Joseph,17,1,56,39
1656892523637,CSE 11,A01,083080,Cao; Yingjun,4,15,40,36
1656892529660,CSE 12,A01,083652,Krause-Levy; Sophia Louisa,20,1,120,100
1656892535699,CSE 15L,A01,083654,Morris; Justin Loren,8,0,50,42
1656892535699,CSE 15L,A02,083655,Morris; Justin Loren,8,0,50,42
1656892541725,CSE 20,A01,083657,Tran; Khoa Dang,37,0,80,43
1656892547750,CSE 21,A01,095574,Bach; Quang Tran,21,0,48,27
1656892553776,CSE 30,A01,083084,Eldon; John,4,0,80,76
1656892553776,CSE 30,B01,095061,Bhaskar; Nishant,6,0,50,44
1656892559800,CSE 100,A01,083659,Cao; Yingjun,2,4,70,68
1656892565823,CSE 134B,A01,083661,Powell; Thomas Allan,19,0,100,81
1656892571920,CSE 140,A01,083663,Gungor; Onat,14,0,85,71
1656892577942,CSE 140L,A01,083088,Eldon; John,16,0,100,84
1656892583967,CSE 175,A01,083665,Kumar; Rakesh,3,0,25,22
1656892589993,CSE 190,A00,092507,Dubnov; Shlomo,7,0,20,13
1656892596019,ECE 45,A01,083139,Congero; Spencer William,5,0,75,70
1656892602044,ECE 65,A50,083695,Saad; Andrew S,12,0,30,18
1656892602044,ECE 65,A51,095125,Saad; Andrew S,25,0,26,1
1656892608087,ECE 109,A01,091882,Touri; Behrouz,16,0,70,54
1656892614111,ECE 180,A00,083140,Abi Samra; Nicholas Camill,0,0,30,30
1656892614111,ECE 180,B00,083141,Abi Samra; Nicholas Camill,0,0,30,30
1656892620143,MATH 10A,A01,083735,Patchell; Gregory David,1,0,30,29
1656892620143,MATH 10A,A02,083736,Patchell; Gregory David,20,0,30,10
1656892620143,MATH 10A,A03,083737,Patchell; Gregory David,15,0,30,15
1656892626165,MATH 10B,A01,083207,Lim; Seonhee,7,0,34,27
1656892626165,MATH 10B,A02,083208,Lim; Seonhee,9,0,35,26
1656892626165,MATH 10B,A03,093472,Lim; Seonhee,4,0,34,30
1656892626165,MATH 10B,B01,083739,Sinha; Shubham,9,0,30,21
1656892632190,MATH 18,A01,083743,Cinel; Cameron Alexander,6,0,30,24
1656892632190,MATH 18,A02,083744,Cinel; Cameron Alexander,15,0,30,15
1656892632190,MATH 18,A03,083745,Cinel; Cameron Alexander,8,0,30,22
1656892632190,MATH 18,B01,083748,Rideout; David Porter,4,0,37,33
1656892632190,MATH 18,B02,083749,Rideout; David Porter,3,0,36,33
1656892632190,MATH 18,B03,083750,Rideout; David Porter,2,0,37,35
1656892632190,MATH 18,B04,083751,Rideout; David Porter,5,0,36,31
1656892632190,MATH 18,B05,093473,Rideout; David Porter,4,0,36,32
1656892632190,MATH 18,B06,093474,Rideout; David Porter,5,0,36,31
1656892638214,MATH 20A,A01,083754,Zheng; Zequn,12,0,40,28
1656892644245,MATH 20B,A01,083756,Briones; Jor-el Thomas Caparas,1,0,36,35
1656892644245,MATH 20B,A02,083757,Briones; Jor-el Thomas Caparas,1,0,36,35
1656892644245,MATH 20B,A03,093475,Briones; Jor-el Thomas Caparas,0,0,36,36
1656892650275,MATH 20C,A01,083760,Briones; Jor-el Thomas Caparas,1,0,35,34
1656892650275,MATH 20C,A02,083761,Briones; Jor-el Thomas Caparas,8,0,35,27
1656892650275,MATH 20C,A03,093476,Briones; Jor-el Thomas Caparas,0,1,36,36
1656892650275,MATH 20C,B01,083762,Bach; Quang Tran,0,0,30,30
1656892656305,MATH 20D,A01,083765,Tran; Brian Kha,4,0,30,26
1656892656305,MATH 20D,A02,083766,Tran; Brian Kha,4,0,30,26
1656892656305,MATH 20D,A03,083767,Tran; Brian Kha,3,0,30,27
1656892662334,MATH 20E,A01,083771,Ganguly; Soumya,5,0,32,27
1656892662334,MATH 20E,A02,083772,Ganguly; Soumya,6,0,32,26
1656892662334,MATH 20E,B01,083773,Ciotti; Benjamin,18,0,35,17
1656892662334,MATH 20E,B02,083774,Ciotti; Benjamin,17,0,35,18
1656892668359,MATH 103A,A01,083777,Greenfeld; Be'Eri,2,0,36,34
1656892668359,MATH 103A,A02,083778,Greenfeld; Be'Eri,5,0,36,31
1656892668359,MATH 103A,A03,093561,Greenfeld; Be'Eri,4,0,36,32
1656892668359,MATH 103A,B01,083779,Greenfeld; Be'Eri,6,0,36,30
1656892668359,MATH 103A,B02,083780,Greenfeld; Be'Eri,2,0,36,34
1656892668359,MATH 103A,B03,093562,Greenfeld; Be'Eri,2,0,36,34
1656892674385,MATH 105,A01,085443,Carter; Anne Toulson,13,0,35,22
1656892674385,MATH 105,A02,093477,Carter; Anne Toulson,20,0,35,15
1656892680408,MATH 109,A01,083213,Ganzberger; Geoffrey Michael,2,0,34,32
1656892680408,MATH 109,A02,083214,Ganzberger; Geoffrey Michael,2,0,34,32
1656892680408,MATH 109,A03,093478,Ganzberger; Geoffrey Michael,1,0,34,33
1656892680408,MATH 109,B01,083215,Ganzberger; Geoffrey Michael,1,0,32,31
1656892680408,MATH 109,B02,083216,Ganzberger; Geoffrey Michael,1,0,32,31
1656892680408,MATH 109,B03,093479,Ganzberger; Geoffrey Michael,6,0,32,26
1656892686438,MATH 142A,A01,083219,Chow; Bennett,6,0,32,26
1656892686438,MATH 142A,A02,083220,Chow; Bennett,10,0,32,22
1656892686438,MATH 142A,A03,093480,Chow; Bennett,7,0,32,25
1656892686438,MATH 142A,B03,093481,Chow; Bennett,7,0,32,25
1656892686438,MATH 142A,B04,093558,Chow; Bennett,10,0,32,22
1656892686438,MATH 142A,B05,093559,Chow; Bennett,6,0,32,26
1656892692459,MATH 193A,A01,083224,Rotar; Vladimir,6,0,34,28
1656892692459,MATH 193A,A02,083225,Rotar; Vladimir,3,0,34,31
1656892692459,MATH 193A,A03,083781,Rotar; Vladimir,1,0,34,33
1656892692459,MATH 193A,A04,083782,Rotar; Vladimir,6,0,34,28
1656892692459,MATH 193A,A05,093482,Rotar; Vladimir,6,0,34,28
1656892698483,MATH 197,001,091859,McAuley; Julian John,9999,0,9999,0
1656892698483,MATH 197,002,095566,Kedlaya; Kiran S.,9997,0,9999,2
1656892698483,MATH 197,003,095567,Xiao; Ming,9999,0,9999,0
1656892698483,MATH 197,004,095571,Perols; Johan Lars,9998,0,9999,1
1656892705536,COGS 9,A01,083615,Shannon; Kyle Michael,6,0,75,69
1656892711557,COGS 11,A01,083617,Boyle; Mary E. T.,19,0,48,29
1656892717581,COGS 13,A01,083071,Bastos; Amalia Pinkusfeld,8,0,71,63
1656892723605,COGS 14A,A01,092681,Semenuks; Arturs,0,1,100,100
1656892729629,COGS 14B,A01,083073,Cheng; Tzu-Han,5,0,63,58
1656892735652,COGS 17,A01,092677,Semenuks; Arturs,4,0,81,77
1656892741676,COGS 100,A01,083619,Allen; Michael Gordon,15,0,70,55
1656892747698,COGS 101A,A01,083621,Davis; Joshua Daniel,9,0,68,59
1656892753722,COGS 101B,A01,091572,Allen; Michael Gordon,8,0,65,57
1656892759748,COGS 101C,A01,083625,Delgado; Tania,17,0,35,18
1656892765777,COGS 107A,A01,083627,Boyle; Mary E. T.,13,0,60,47
1656892771803,COGS 118A,A01,083075,Gupta; Anjum,15,0,76,61
1656892777825,CSE 3,A50,083646,Miranda; Gregory Joseph,22,0,50,28
1656892783848,CSE 8A,A50,083650,Miranda; Gregory Joseph,17,1,56,39
1656892789871,CSE 11,A01,083080,Cao; Yingjun,4,15,40,36
1656892795893,CSE 12,A01,083652,Krause-Levy; Sophia Louisa,20,1,120,100
1656892801916,CSE 15L,A01,083654,Morris; Justin Loren,8,0,50,42
1656892801916,CSE 15L,A02,083655,Morris; Justin Loren,8,0,50,42
1656892807940,CSE 20,A01,083657,Tran; Khoa Dang,37,0,80,43
1656892813963,CSE 21,A01,095574,Bach; Quang Tran,21,0,48,27
1656892819992,CSE 30,A01,083084,Eldon; John,4,0,80,76
1656892819992,CSE 30,B01,095061,Bhaskar; Nishant,6,0,50,44
1656892826019,CSE 100,A01,083659,Cao; Yingjun,2,4,70,68
1656892832042,CSE 134B,A01,083661,Powell; Thomas Allan,19,0,100,81
1656892838065,CSE 140,A01,083663,Gungor; Onat,14,0,85,71
1656892844088,CSE 140L,A01,083088,Eldon; John,16,0,100,84
1656892850111,CSE 175,A01,083665,Kumar; Rakesh,3,0,25,22
1656892856134,CSE 190,A00,092507,Dubnov; Shlomo,7,0,20,13
1656892862168,ECE 45,A01,083139,Congero; Spencer William,5,0,75,70
1656892868190,ECE 65,A50,083695,Saad; Andrew S,12,0,30,18
1656892868190,ECE 65,A51,095125,Saad; Andrew S,25,0,26,1
1656892874212,ECE 109,A01,091882,Touri; Behrouz,16,0,70,54
1656892880236,ECE 180,A00,083140,Abi Samra; Nicholas Camill,0,0,30,30
1656892880236,ECE 180,B00,083141,Abi Samra; Nicholas Camill,0,0,30,30
1656892886262,MATH 10A,A01,083735,Patchell; Gregory David,1,0,30,29
1656892886262,MATH 10A,A02,083736,Patchell; Gregory David,20,0,30,10
1656892886262,MATH 10A,A03,083737,Patchell; Gregory David,15,0,30,15
1656892892292,MATH 10B,A01,083207,Lim; Seonhee,7,0,34,27
1656892892292,MATH 10B,A02,083208,Lim; Seonhee,9,0,35,26
1656892892292,MATH 10B,A03,093472,Lim; Seonhee,4,0,34,30
1656892892292,MATH 10B,B01,083739,Sinha; Shubham,9,0,30,21
1656892898316,MATH 18,A01,083743,Cinel; Cameron Alexander,6,0,30,24
1656892898316,MATH 18,A02,083744,Cinel; Cameron Alexander,15,0,30,15
1656892898316,MATH 18,A03,083745,Cinel; Cameron Alexander,8,0,30,22
1656892898316,MATH 18,B01,083748,Rideout; David Porter,4,0,37,33
1656892898316,MATH 18,B02,083749,Rideout; David Porter,3,0,36,33
1656892898316,MATH 18,B03,083750,Rideout; David Porter,2,0,37,35
1656892898316,MATH 18,B04,083751,Rideout; David Porter,5,0,36,31
1656892898316,MATH 18,B05,093473,Rideout; David Porter,4,0,36,32
1656892898316,MATH 18,B06,093474,Rideout; David Porter,5,0,36,31
1656892904339,MATH 20A,A01,083754,Zheng; Zequn,12,0,40,28
1656892910362,MATH 20B,A01,083756,Briones; Jor-el Thomas Caparas,1,0,36,35
1656892910362,MATH 20B,A02,083757,Briones; Jor-el Thomas Caparas,1,0,36,35
1656892910362,MATH 20B,A03,093475,Briones; Jor-el Thomas Caparas,0,0,36,36
1656892916389,MATH 20C,A01,083760,Briones; Jor-el Thomas Caparas,1,0,35,34
1656892916389,MATH 20C,A02,083761,Briones; Jor-el Thomas Caparas,8,0,35,27
1656892916389,MATH 20C,A03,093476,Briones; Jor-el Thomas Caparas,0,1,36,36
1656892916389,MATH 20C,B01,083762,Bach; Quang Tran,0,0,30,30
1656892922417,MATH 20D,A01,083765,Tran; Brian Kha,4,0,30,26
1656892922417,MATH 20D,A02,083766,Tran; Brian Kha,4,0,30,26
1656892922417,MATH 20D,A03,083767,Tran; Brian Kha,3,0,30,27
1656892928440,MATH 20E,A01,083771,Ganguly; Soumya,5,0,32,27
1656892928440,MATH 20E,A02,083772,Ganguly; Soumya,6,0,32,26
1656892928440,MATH 20E,B01,083773,Ciotti; Benjamin,18,0,35,17
1656892928440,MATH 20E,B02,083774,Ciotti; Benjamin,17,0,35,18
1656892934466,MATH 103A,A01,083777,Greenfeld; Be'Eri,2,0,36,34
1656892934466,MATH 103A,A02,083778,Greenfeld; Be'Eri,5,0,36,31
1656892934466,MATH 103A,A03,093561,Greenfeld; Be'Eri,4,0,36,32
1656892934466,MATH 103A,B01,083779,Greenfeld; Be'Eri,6,0,36,30
1656892934466,MATH 103A,B02,083780,Greenfeld; Be'Eri,2,0,36,34
1656892934466,MATH 103A,B03,093562,Greenfeld; Be'Eri,2,0,36,34
1656892940490,MATH 105,A01,085443,Carter; Anne Toulson,13,0,35,22
1656892940490,MATH 105,A02,093477,Carter; Anne Toulson,20,0,35,15
1656892946527,MATH 109,A01,083213,Ganzberger; Geoffrey Michael,2,0,34,32
1656892946527,MATH 109,A02,083214,Ganzberger; Geoffrey Michael,2,0,34,32
1656892946527,MATH 109,A03,093478,Ganzberger; Geoffrey Michael,1,0,34,33
1656892946527,MATH 109,B01,083215,Ganzberger; Geoffrey Michael,1,0,32,31
1656892946527,MATH 109,B02,083216,Ganzberger; Geoffrey Michael,1,0,32,31
1656892946527,MATH 109,B03,093479,Ganzberger; Geoffrey Michael,6,0,32,26
1656892952563,MATH 142A,A01,083219,Chow; Bennett,6,0,32,26
1656892952563,MATH 142A,A02,083220,Chow; Bennett,10,0,32,22
1656892952563,MATH 142A,A03,093480,Chow; Bennett,7,0,32,25
1656892952563,MATH 142A,B03,093481,Chow; Bennett,7,0,32,25
1656892952563,MATH 142A,B04,093558,Chow; Bennett,10,0,32,22
1656892952563,MATH 142A,B05,093559,Chow; Bennett,6,0,32,26
1656892958586,MATH 193A,A01,083224,Rotar; Vladimir,6,0,34,28
1656892958586,MATH 193A,A02,083225,Rotar; Vladimir,3,0,34,31
1656892958586,MATH 193A,A03,083781,Rotar; Vladimir,1,0,34,33
1656892958586,MATH 193A,A04,083782,Rotar; Vladimir,6,0,34,28
1656892958586,MATH 193A,A05,093482,Rotar; Vladimir,6,0,34,28
1656892964614,MATH 197,001,091859,McAuley; Julian John,9999,0,9999,0
1656892964614,MATH 197,002,095566,Kedlaya; Kiran S.,9997,0,9999,2
1656892964614,MATH 197,003,095567,Xiao; Ming,9999,0,9999,0
1656892964614,MATH 197,004,095571,Perols; Johan Lars,9998,0,9999,1
1656892971668,COGS 9,A01,083615,Shannon; Kyle Michael,6,0,75,69
1656892977691,COGS 11,A01,083617,Boyle; Mary E. T.,19,0,48,29
1656892983717,COGS 13,A01,083071,Bastos; Amalia Pinkusfeld,8,0,71,63
1656892989741,COGS 14A,A01,092681,Semenuks; Arturs,0,1,100,100
1656892995767,COGS 14B,A01,083073,Cheng; Tzu-Han,5,0,63,58
1656893001792,COGS 17,A01,092677,Semenuks; Arturs,4,0,81,77
1656893007815,COGS 100,A01,083619,Allen; Michael Gordon,15,0,70,55
1656893013837,COGS 101A,A01,083621,Davis; Joshua Daniel,9,0,68,59
1656893019862,COGS 101B,A01,091572,Allen; Michael Gordon,8,0,65,57
1656893025892,COGS 101C,A01,083625,Delgado; Tania,17,0,35,18
1656893031914,COGS 107A,A01,083627,Boyle; Mary E. T.,13,0,60,47
1656893037937,COGS 118A,A01,083075,Gupta; Anjum,15,0,76,61
1656893043961,CSE 3,A50,083646,Miranda; Gregory Joseph,22,0,50,28
1656893049986,CSE 8A,A50,083650,Miranda; Gregory Joseph,17,1,56,39
1656893056010,CSE 11,A01,083080,Cao; Yingjun,4,15,40,36
1656893062037,CSE 12,A01,083652,Krause-Levy; Sophia Louisa,20,1,120,100
1656893068063,CSE 15L,A01,083654,Morris; Justin Loren,8,0,50,42
1656893068063,CSE 15L,A02,083655,Morris; Justin Loren,8,0,50,42
1656893074087,CSE 20,A01,083657,Tran; Khoa Dang,37,0,80,43
1656893080113,CSE 21,A01,095574,Bach; Quang Tran,21,0,48,27
1656893086135,CSE 30,A01,083084,Eldon; John,4,0,80,76
1656893086135,CSE 30,B01,095061,Bhaskar; Nishant,6,0,50,44
1656893092157,CSE 100,A01,083659,Cao; Yingjun,2,4,70,68
1656893098185,CSE 134B,A01,083661,Powell; Thomas Allan,19,0,100,81
1656893104208,CSE 140,A01,083663,Gungor; Onat,14,0,85,71
1656893110236,CSE 140L,A01,083088,Eldon; John,16,0,100,84
1656893116261,CSE 175,A01,083665,Kumar; Rakesh,3,0,25,22
1656893122289,CSE 190,A00,092507,Dubnov; Shlomo,7,0,20,13
1656893128311,ECE 45,A01,083139,Congero; Spencer William,5,0,75,70
1656893134344,ECE 65,A50,083695,Saad; Andrew S,12,0,30,18
1656893134344,ECE 65,A51,095125,Saad; Andrew S,25,0,26,1
1656893140371,ECE 109,A01,091882,Touri; Behrouz,16,0,70,54
1656893146395,ECE 180,A00,083140,Abi Samra; Nicholas Camill,0,0,30,30
1656893146395,ECE 180,B00,083141,Abi Samra; Nicholas Camill,0,0,30,30
1656893152422,MATH 10A,A01,083735,Patchell; Gregory David,1,0,30,29
1656893152422,MATH 10A,A02,083736,Patchell; Gregory David,20,0,30,10
1656893152422,MATH 10A,A03,083737,Patchell; Gregory David,15,0,30,15
1656893158445,MATH 10B,A01,083207,Lim; Seonhee,7,0,34,27
1656893158445,MATH 10B,A02,083208,Lim; Seonhee,9,0,35,26
1656893158445,MATH 10B,A03,093472,Lim; Seonhee,4,0,34,30
1656893158445,MATH 10B,B01,083739,Sinha; Shubham,9,0,30,21
1656893164492,MATH 18,A01,083743,Cinel; Cameron Alexander,6,0,30,24
1656893164492,MATH 18,A02,083744,Cinel; Cameron Alexander,15,0,30,15
1656893164492,MATH 18,A03,083745,Cinel; Cameron Alexander,8,0,30,22
1656893164492,MATH 18,B01,083748,Rideout; David Porter,4,0,37,33
1656893164492,MATH 18,B02,083749,Rideout; David Porter,3,0,36,33
1656893164492,MATH 18,B03,083750,Rideout; David Porter,2,0,37,35
1656893164492,MATH 18,B04,083751,Rideout; David Porter,5,0,36,31
1656893164492,MATH 18,B05,093473,Rideout; David Porter,4,0,36,32
1656893164492,MATH 18,B06,093474,Rideout; David Porter,5,0,36,31
1656893170594,MATH 20A,A01,083754,Zheng; Zequn,12,0,40,28
1656893176624,MATH 20B,A01,083756,Briones; Jor-el Thomas Caparas,1,0,36,35
1656893176624,MATH 20B,A02,083757,Briones; Jor-el Thomas Caparas,1,0,36,35
1656893176624,MATH 20B,A03,093475,Briones; Jor-el Thomas Caparas,0,0,36,36
1656893182651,MATH 20C,A01,083760,Briones; Jor-el Thomas Caparas,1,0,35,34
1656893182651,MATH 20C,A02,083761,Briones; Jor-el Thomas Caparas,8,0,35,27
1656893182651,MATH 20C,A03,093476,Briones; Jor-el Thomas Caparas,0,1,36,36
1656893182651,MATH 20C,B01,083762,Bach; Quang Tran,0,0,30,30
1656893188678,MATH 20D,A01,083765,Tran; Brian Kha,4,0,30,26
1656893188678,MATH 20D,A02,083766,Tran; Brian Kha,4,0,30,26
1656893188678,MATH 20D,A03,083767,Tran; Brian Kha,3,0,30,27
1656893194707,MATH 20E,A01,083771,Ganguly; Soumya,5,0,32,27
1656893194707,MATH 20E,A02,083772,Ganguly; Soumya,6,0,32,26
1656893194707,MATH 20E,B01,083773,Ciotti; Benjamin,18,0,35,17
1656893194707,MATH 20E,B02,083774,Ciotti; Benjamin,17,0,35,18
1656893200730,MATH 103A,A01,083777,Greenfeld; Be'Eri,2,0,36,34
1656893200730,MATH 103A,A02,083778,Greenfeld; Be'Eri,5,0,36,31
1656893200730,MATH 103A,A03,093561,Greenfeld; Be'Eri,4,0,36,32
1656893200730,MATH 103A,B01,083779,Greenfeld; Be'Eri,6,0,36,30
1656893200730,MATH 103A,B02,083780,Greenfeld; Be'Eri,2,0,36,34
1656893200730,MATH 103A,B03,093562,Greenfeld; Be'Eri,2,0,36,34
1656893206755,MATH 105,A01,085443,Carter; Anne Toulson,13,0,35,22
1656893206755,MATH 105,A02,093477,Carter; Anne Toulson,20,0,35,15
1656893212777,MATH 109,A01,083213,Ganzberger; Geoffrey Michael,2,0,34,32
1656893212777,MATH 109,A02,083214,Ganzberger; Geoffrey Michael,2,0,34,32
1656893212777,MATH 109,A03,093478,Ganzberger; Geoffrey Michael,1,0,34,33
1656893212777,MATH 109,B01,083215,Ganzberger; Geoffrey Michael,1,0,32,31
1656893212777,MATH 109,B02,083216,Ganzberger; Geoffrey Michael,1,0,32,31
1656893212777,MATH 109,B03,093479,Ganzberger; Geoffrey Michael,6,0,32,26
1656893218801,MATH 142A,A01,083219,Chow; Bennett,6,0,32,26
1656893218801,MATH 142A,A02,083220,Chow; Bennett,10,0,32,22
1656893218801,MATH 142A,A03,093480,Chow; Bennett,7,0,32,25
1656893218801,MATH 142A,B03,093481,Chow; Bennett,7,0,32,25
1656893218801,MATH 142A,B04,093558,Chow; Bennett,10,0,32,22
1656893218801,MATH 142A,B05,093559,Chow; Bennett,6,0,32,26
1656893224833,MATH 193A,A01,083224,Rotar; Vladimir,6,0,34,28
1656893224833,MATH 193A,A02,083225,Rotar; Vladimir,3,0,34,31
1656893224833,MATH 193A,A03,083781,Rotar; Vladimir,1,0,34,33
1656893224833,MATH 193A,A04,083782,Rotar; Vladimir,6,0,34,28
1656893224833,MATH 193A,A05,093482,Rotar; Vladimir,6,0,34,28
1656893230857,MATH 197,001,091859,McAuley; Julian John,9999,0,9999,0
1656893230857,MATH 197,002,095566,Kedlaya; Kiran S.,9997,0,9999,2
1656893230857,MATH 197,003,095567,Xiao; Ming,9999,0,9999,0
1656893230857,MATH 197,004,095571,Perols; Johan Lars,9998,0,9999,1
1656893237916,COGS 9,A01,083615,Shannon; Kyle Michael,6,0,75,69
1656893243940,COGS 11,A01,083617,Boyle; Mary E. T.,19,0,48,29
1656893249963,COGS 13,A01,083071,Bastos; Amalia Pinkusfeld,8,0,71,63
1656893255987,COGS 14A,A01,092681,Semenuks; Arturs,0,1,100,100
1656893262014,COGS 14B,A01,083073,Cheng; Tzu-Han,5,0,63,58
1656893268041,COGS 17,A01,092677,Semenuks; Arturs,4,0,81,77
1656893274066,COGS 100,A01,083619,Allen; Michael Gordon,15,0,70,55
1656893280093,COGS 101A,A01,083621,Davis; Joshua Daniel,9,0,68,59
1656893286116,COGS 101B,A01,091572,Allen; Michael Gordon,8,0,65,57
1656893292140,COGS 101C,A01,083625,Delgado; Tania,17,0,35,18
1656893298166,COGS 107A,A01,083627,Boyle; Mary E. T.,13,0,60,47
1656893304190,COGS 118A,A01,083075,Gupta; Anjum,15,0,76,61
1656893310213,CSE 3,A50,083646,Miranda; Gregory Joseph,22,0,50,28
1656893316240,CSE 8A,A50,083650,Miranda; Gregory Joseph,17,1,56,39
1656893322267,CSE 11,A01,083080,Cao; Yingjun,4,15,40,36
1656893328290,CSE 12,A01,083652,Krause-Levy; Sophia Louisa,20,1,120,100
1656893334318,CSE 15L,A01,083654,Morris; Justin Loren,8,0,50,42
1656893334318,CSE 15L,A02,083655,Morris; Justin Loren,8,0,50,42
1656893340341,CSE 20,A01,083657,Tran; Khoa Dang,37,0,80,43
1656893346371,CSE 21,A01,095574,Bach; Quang Tran,21,0,48,27
1656893352401,CSE 30,A01,083084,Eldon; John,4,0,80,76
1656893352401,CSE 30,B01,095061,Bhaskar; Nishant,6,0,50,44
1656893358431,CSE 100,A01,083659,Cao; Yingjun,2,4,70,68
1656893364456,CSE 134B,A01,083661,Powell; Thomas Allan,19,0,100,81
1656893370480,CSE 140,A01,083663,Gungor; Onat,14,0,85,71
1656893376509,CSE 140L,A01,083088,Eldon; John,16,0,100,84
1656893382533,CSE 175,A01,083665,Kumar; Rakesh,3,0,25,22
1656893388558,CSE 190,A00,092507,Dubnov; Shlomo,7,0,20,13
1656893394582,ECE 45,A01,083139,Congero; Spencer William,5,0,75,70
1656893400610,ECE 65,A50,083695,Saad; Andrew S,12,0,30,18
1656893400610,ECE 65,A51,095125,Saad; Andrew S,25,0,26,1
1656893406638,ECE 109,A01,091882,Touri; Behrouz,16,0,70,54
1656893412661,ECE 180,A00,083140,Abi Samra; Nicholas Camill,0,0,30,30
1656893412661,ECE 180,B00,083141,Abi Samra; Nicholas Camill,0,0,30,30
1656893418686,MATH 10A,A01,083735,Patchell; Gregory David,1,0,30,29
1656893418686,MATH 10A,A02,083736,Patchell; Gregory David,20,0,30,10
1656893418686,MATH 10A,A03,083737,Patchell; Gregory David,15,0,30,15
1656893424712,MATH 10B,A01,083207,Lim; Seonhee,7,0,34,27
1656893424712,MATH 10B,A02,083208,Lim; Seonhee,9,0,35,26
1656893424712,MATH 10B,A03,093472,Lim; Seonhee,4,0,34,30
1656893424712,MATH 10B,B01,083739,Sinha; Shubham,9,0,30,21
1656893430735,MATH 18,A01,083743,Cinel; Cameron Alexander,6,0,30,24
1656893430735,MATH 18,A02,083744,Cinel; Cameron Alexander,15,0,30,15
1656893430735,MATH 18,A03,083745,Cinel; Cameron Alexander,8,0,30,22
1656893430735,MATH 18,B01,083748,Rideout; David Porter,4,0,37,33
1656893430735,MATH 18,B02,083749,Rideout; David Porter,3,0,36,33
1656893430735,MATH 18,B03,083750,Rideout; David Porter,2,0,37,35
1656893430735,MATH 18,B04,083751,Rideout; David Porter,5,0,36,31
1656893430735,MATH 18,B05,093473,Rideout; David Porter,4,0,36,32
1656893430735,MATH 18,B06,093474,Rideout; David Porter,5,0,36,31
1656893436768,MATH 20A,A01,083754,Zheng; Zequn,12,0,40,28
1656893442797,MATH 20B,A01,083756,Briones; Jor-el Thomas Caparas,1,0,36,35
1656893442797,MATH 20B,A02,083757,Briones; Jor-el Thomas Caparas,1,0,36,35
1656893442797,MATH 20B,A03,093475,Briones; Jor-el Thomas Caparas,0,0,36,36
1656893448819,MATH 20C,A01,083760,Briones; Jor-el Thomas Caparas,1,0,35,34
1656893448819,MATH 20C,A02,083761,Briones; Jor-el Thomas Caparas,8,0,35,27
1656893448819,MATH 20C,A03,093476,Briones; Jor-el Thomas Caparas,0,1,36,36
1656893448819,MATH 20C,B01,083762,Bach; Quang Tran,0,0,30,30
1656893454852,MATH 20D,A01,083765,Tran; Brian Kha,4,0,30,26
1656893454852,MATH 20D,A02,083766,Tran; Brian Kha,4,0,30,26
1656893454852,MATH 20D,A03,083767,Tran; Brian Kha,3,0,30,27
1656893460880,MATH 20E,A01,083771,Ganguly; Soumya,5,0,32,27
1656893460880,MATH 20E,A02,083772,Ganguly; Soumya,6,0,32,26
1656893460880,MATH 20E,B01,083773,Ciotti; Benjamin,18,0,35,17
1656893460880,MATH 20E,B02,083774,Ciotti; Benjamin,17,0,35,18
1656893466912,MATH 103A,A01,083777,Greenfeld; Be'Eri,2,0,36,34
1656893466912,MATH 103A,A02,083778,Greenfeld; Be'Eri,5,0,36,31
1656893466912,MATH 103A,A03,093561,Greenfeld; Be'Eri,4,0,36,32
1656893466912,MATH 103A,B01,083779,Greenfeld; Be'Eri,6,0,36,30
1656893466912,MATH 103A,B02,083780,Greenfeld; Be'Eri,2,0,36,34
1656893466912,MATH 103A,B03,093562,Greenfeld; Be'Eri,2,0,36,34
1656893472936,MATH 105,A01,085443,Carter; Anne Toulson,13,0,35,22
1656893472936,MATH 105,A02,093477,Carter; Anne Toulson,20,0,35,15
1656893478960,MATH 109,A01,083213,Ganzberger; Geoffrey Michael,2,0,34,32
1656893478960,MATH 109,A02,083214,Ganzberger; Geoffrey Michael,2,0,34,32
1656893478960,MATH 109,A03,093478,Ganzberger; Geoffrey Michael,1,0,34,33
1656893478960,MATH 109,B01,083215,Ganzberger; Geoffrey Michael,1,0,32,31
1656893478960,MATH 109,B02,083216,Ganzberger; Geoffrey Michael,1,0,32,31
1656893478960,MATH 109,B03,093479,Ganzberger; Geoffrey Michael,6,0,32,26
1656893484991,MATH 142A,A01,083219,Chow; Bennett,6,0,32,26
1656893484991,MATH 142A,A02,083220,Chow; Bennett,10,0,32,22
1656893484991,MATH 142A,A03,093480,Chow; Bennett,7,0,32,25
1656893484991,MATH 142A,B03,093481,Chow; Bennett,7,0,32,25
1656893484991,MATH 142A,B04,093558,Chow; Bennett,10,0,32,22
1656893484991,MATH 142A,B05,093559,Chow; Bennett,6,0,32,26
1656893491021,MATH 193A,A01,083224,Rotar; Vladimir,6,0,34,28
1656893491021,MATH 193A,A02,083225,Rotar; Vladimir,3,0,34,31
1656893491021,MATH 193A,A03,083781,Rotar; Vladimir,1,0,34,33
1656893491021,MATH 193A,A04,083782,Rotar; Vladimir,6,0,34,28
1656893491021,MATH 193A,A05,093482,Rotar; Vladimir,6,0,34,28
1656893497047,MATH 197,001,091859,McAuley; Julian John,9999,0,9999,0
1656893497047,MATH 197,002,095566,Kedlaya; Kiran S.,9997,0,9999,2
1656893497047,MATH 197,003,095567,Xiao; Ming,9999,0,9999,0
1656893497047,MATH 197,004,095571,Perols; Johan Lars,9998,0,9999,1
1656893504102,COGS 9,A01,083615,Shannon; Kyle Michael,6,0,75,69
1656893510131,COGS 11,A01,083617,Boyle; Mary E. T.,19,0,48,29
1656893516157,COGS 13,A01,083071,Bastos; Amalia Pinkusfeld,8,0,71,63
1656893522181,COGS 14A,A01,092681,Semenuks; Arturs,0,1,100,100
1656893528209,COGS 14B,A01,083073,Cheng; Tzu-Han,5,0,63,58
1656893534236,COGS 17,A01,092677,Semenuks; Arturs,4,0,81,77
1656893540260,COGS 100,A01,083619,Allen; Michael Gordon,15,0,70,55
1656893546289,COGS 101A,A01,083621,Davis; Joshua Daniel,9,0,68,59
1656893552315,COGS 101B,A01,091572,Allen; Michael Gordon,8,0,65,57
1656893558344,COGS 101C,A01,083625,Delgado; Tania,17,0,35,18
1656893564375,COGS 107A,A01,083627,Boyle; Mary E. T.,13,0,60,47
1656893570402,COGS 118A,A01,083075,Gupta; Anjum,15,0,76,61
1656893576432,CSE 3,A50,083646,Miranda; Gregory Joseph,22,0,50,28
1656893582456,CSE 8A,A50,083650,Miranda; Gregory Joseph,17,1,56,39
1656893588485,CSE 11,A01,083080,Cao; Yingjun,4,15,40,36
1656893594509,CSE 12,A01,083652,Krause-Levy; Sophia Louisa,20,1,120,100
1656893600538,CSE 15L,A01,083654,Morris; Justin Loren,8,0,50,42
1656893600538,CSE 15L,A02,083655,Morris; Justin Loren,8,0,50,42
1656893606566,CSE 20,A01,083657,Tran; Khoa Dang,37,0,80,43
1656893612590,CSE 21,A01,095574,Bach; Quang Tran,21,0,48,27
1656893618621,CSE 30,A01,083084,Eldon; John,4,0,80,76
1656893618621,CSE 30,B01,095061,Bhaskar; Nishant,6,0,50,44
1656893624644,CSE 100,A01,083659,Cao; Yingjun,2,4,70,68
1656893630670,CSE 134B,A01,083661,Powell; Thomas Allan,19,0,100,81
1656893636695,CSE 140,A01,083663,Gungor; Onat,14,0,85,71
1656893642719,CSE 140L,A01,083088,Eldon; John,16,0,100,84
1656893648744,CSE 175,A01,083665,Kumar; Rakesh,3,0,25,22
1656893654769,CSE 190,A00,092507,Dubnov; Shlomo,7,0,20,13
1656893660794,ECE 45,A01,083139,Congero; Spencer William,5,0,75,70
1656893666822,ECE 65,A50,083695,Saad; Andrew S,12,0,30,18
1656893666822,ECE 65,A51,095125,Saad; Andrew S,25,0,26,1
1656893672845,ECE 109,A01,091882,Touri; Behrouz,16,0,70,54
1656893678881,ECE 180,A00,083140,Abi Samra; Nicholas Camill,0,0,30,30
1656893678881,ECE 180,B00,083141,Abi Samra; Nicholas Camill,0,0,30,30
1656893684904,MATH 10A,A01,083735,Patchell; Gregory David,1,0,30,29
1656893684904,MATH 10A,A02,083736,Patchell; Gregory David,20,0,30,10
1656893684904,MATH 10A,A03,083737,Patchell; Gregory David,15,0,30,15
1656893690930,MATH 10B,A01,083207,Lim; Seonhee,7,0,34,27
1656893690930,MATH 10B,A02,083208,Lim; Seonhee,9,0,35,26
1656893690930,MATH 10B,A03,093472,Lim; Seonhee,4,0,34,30
1656893690930,MATH 10B,B01,083739,Sinha; Shubham,9,0,30,21
1656893696962,MATH 18,A01,083743,Cinel; Cameron Alexander,6,0,30,24
1656893696962,MATH 18,A02,083744,Cinel; Cameron Alexander,15,0,30,15
1656893696962,MATH 18,A03,083745,Cinel; Cameron Alexander,8,0,30,22
1656893696962,MATH 18,B01,083748,Rideout; David Porter,4,0,37,33
1656893696962,MATH 18,B02,083749,Rideout; David Porter,3,0,36,33
1656893696962,MATH 18,B03,083750,Rideout; David Porter,2,0,37,35
1656893696962,MATH 18,B04,083751,Rideout; David Porter,5,0,36,31
1656893696962,MATH 18,B05,093473,Rideout; David Porter,4,0,36,32
1656893696962,MATH 18,B06,093474,Rideout; David Porter,5,0,36,31
1656893702990,MATH 20A,A01,083754,Zheng; Zequn,12,0,40,28
1656893709013,MATH 20B,A01,083756,Briones; Jor-el Thomas Caparas,1,0,36,35
1656893709013,MATH 20B,A02,083757,Briones; Jor-el Thomas Caparas,1,0,36,35
1656893709013,MATH 20B,A03,093475,Briones; Jor-el Thomas Caparas,0,0,36,36
1656893715036,MATH 20C,A01,083760,Briones; Jor-el Thomas Caparas,1,0,35,34
1656893715036,MATH 20C,A02,083761,Briones; Jor-el Thomas Caparas,8,0,35,27
1656893715036,MATH 20C,A03,093476,Briones; Jor-el Thomas Caparas,0,1,36,36
1656893715036,MATH 20C,B01,083762,Bach; Quang Tran,0,0,30,30
1656893721062,MATH 20D,A01,083765,Tran; Brian Kha,4,0,30,26
1656893721062,MATH 20D,A02,083766,Tran; Brian Kha,4,0,30,26
1656893721062,MATH 20D,A03,083767,Tran; Brian Kha,3,0,30,27
1656893727090,MATH 20E,A01,083771,Ganguly; Soumya,5,0,32,27
1656893727090,MATH 20E,A02,083772,Ganguly; Soumya,6,0,32,26
1656893727090,MATH 20E,B01,083773,Ciotti; Benjamin,18,0,35,17
1656893727090,MATH 20E,B02,083774,Ciotti; Benjamin,17,0,35,18
1656893733117,MATH 103A,A01,083777,Greenfeld; Be'Eri,2,0,36,34
1656893733117,MATH 103A,A02,083778,Greenfeld; Be'Eri,5,0,36,31
1656893733117,MATH 103A,A03,093561,Greenfeld; Be'Eri,4,0,36,32
1656893733117,MATH 103A,B01,083779,Greenfeld; Be'Eri,6,0,36,30
1656893733117,MATH 103A,B02,083780,Greenfeld; Be'Eri,2,0,36,34
1656893733117,MATH 103A,B03,093562,Greenfeld; Be'Eri,2,0,36,34
1656893739141,MATH 105,A01,085443,Carter; Anne Toulson,13,0,35,22
1656893739141,MATH 105,A02,093477,Carter; Anne Toulson,20,0,35,15
1656893745177,MATH 109,A01,083213,Ganzberger; Geoffrey Michael,2,0,34,32
1656893745177,MATH 109,A02,083214,Ganzberger; Geoffrey Michael,2,0,34,32
1656893745177,MATH 109,A03,093478,Ganzberger; Geoffrey Michael,1,0,34,33
1656893745177,MATH 109,B01,083215,Ganzberger; Geoffrey Michael,1,0,32,31
1656893745177,MATH 109,B02,083216,Ganzberger; Geoffrey Michael,1,0,32,31
1656893745177,MATH 109,B03,093479,Ganzberger; Geoffrey Michael,6,0,32,26
1656893751202,MATH 142A,A01,083219,Chow; Bennett,6,0,32,26
1656893751202,MATH 142A,A02,083220,Chow; Bennett,10,0,32,22
1656893751202,MATH 142A,A03,093480,Chow; Bennett,7,0,32,25
1656893751202,MATH 142A,B03,093481,Chow; Bennett,7,0,32,25
1656893751202,MATH 142A,B04,093558,Chow; Bennett,10,0,32,22
1656893751202,MATH 142A,B05,093559,Chow; Bennett,6,0,32,26
1656893757225,MATH 193A,A01,083224,Rotar; Vladimir,6,0,34,28
1656893757225,MATH 193A,A02,083225,Rotar; Vladimir,3,0,34,31
1656893757225,MATH 193A,A03,083781,Rotar; Vladimir,1,0,34,33
1656893757225,MATH 193A,A04,083782,Rotar; Vladimir,6,0,34,28
1656893757225,MATH 193A,A05,093482,Rotar; Vladimir,6,0,34,28
1656893763258,MATH 197,001,091859,McAuley; Julian John,9999,0,9999,0
1656893763258,MATH 197,002,095566,Kedlaya; Kiran S.,9997,0,9999,2
1656893763258,MATH 197,003,095567,Xiao; Ming,9999,0,9999,0
1656893763258,MATH 197,004,095571,Perols; Johan Lars,9998,0,9999,1
1656893770396,COGS 9,A01,083615,Shannon; Kyle Michael,6,0,75,69
1656893776421,COGS 11,A01,083617,Boyle; Mary E. T.,19,0,48,29
1656893782456,COGS 13,A01,083071,Bastos; Amalia Pinkusfeld,8,0,71,63
1656893788483,COGS 14A,A01,092681,Semenuks; Arturs,0,1,100,100
1656893794508,COGS 14B,A01,083073,Cheng; Tzu-Han,5,0,63,58
1656893800532,COGS 17,A01,092677,Semenuks; Arturs,4,0,81,77
1656893806561,COGS 100,A01,083619,Allen; Michael Gordon,15,0,70,55
1656893812583,COGS 101A,A01,083621,Davis; Joshua Daniel,9,0,68,59
1656893818611,COGS 101B,A01,091572,Allen; Michael Gordon,8,0,65,57
1656893824639,COGS 101C,A01,083625,Delgado; Tania,17,0,35,18
1656893830660,COGS 107A,A01,083627,Boyle; Mary E. T.,13,0,60,47
1656893836682,COGS 118A,A01,083075,Gupta; Anjum,15,0,76,61
1656893842705,CSE 3,A50,083646,Miranda; Gregory Joseph,22,0,50,28
1656893848727,CSE 8A,A50,083650,Miranda; Gregory Joseph,17,1,56,39
1656893854753,CSE 11,A01,083080,Cao; Yingjun,4,15,40,36
1656893860779,CSE 12,A01,083652,Krause-Levy; Sophia Louisa,20,1,120,100
1656893866805,CSE 15L,A01,083654,Morris; Justin Loren,8,0,50,42
1656893866805,CSE 15L,A02,083655,Morris; Justin Loren,8,0,50,42
1656893872826,CSE 20,A01,083657,Tran; Khoa Dang,37,0,80,43
1656893878850,CSE 21,A01,095574,Bach; Quang Tran,21,0,48,27
1656893884874,CSE 30,A01,083084,Eldon; John,4,0,80,76
1656893884874,CSE 30,B01,095061,Bhaskar; Nishant,6,0,50,44
1656893890896,CSE 100,A01,083659,Cao; Yingjun,2,4,70,68
1656893896920,CSE 134B,A01,083661,Powell; Thomas Allan,19,0,100,81
1656893902943,CSE 140,A01,083663,Gungor; Onat,14,0,85,71
1656893908966,CSE 140L,A01,083088,Eldon; John,16,0,100,84
1656893914990,CSE 175,A01,083665,Kumar; Rakesh,3,0,25,22
1656893921014,CSE 190,A00,092507,Dubnov; Shlomo,7,0,20,13
1656893927039,ECE 45,A01,083139,Congero; Spencer William,5,0,75,70
1656893933062,ECE 65,A50,083695,Saad; Andrew S,12,0,30,18
1656893933062,ECE 65,A51,095125,Saad; Andrew S,25,0,26,1
1656893939085,ECE 109,A01,091882,Touri; Behrouz,16,0,70,54
1656893945123,ECE 180,A00,083140,Abi Samra; Nicholas Camill,0,0,30,30
1656893945123,ECE 180,B00,083141,Abi Samra; Nicholas Camill,0,0,30,30
1656893951150,MATH 10A,A01,083735,Patchell; Gregory David,1,0,30,29
1656893951150,MATH 10A,A02,083736,Patchell; Gregory David,20,0,30,10
1656893951150,MATH 10A,A03,083737,Patchell; Gregory David,15,0,30,15
1656893957173,MATH 10B,A01,083207,Lim; Seonhee,7,0,34,27
1656893957173,MATH 10B,A02,083208,Lim; Seonhee,9,0,35,26
1656893957173,MATH 10B,A03,093472,Lim; Seonhee,4,0,34,30
1656893957173,MATH 10B,B01,083739,Sinha; Shubham,9,0,30,21
1656893963203,MATH 18,A01,083743,Cinel; Cameron Alexander,6,0,30,24
1656893963203,MATH 18,A02,083744,Cinel; Cameron Alexander,15,0,30,15
1656893963203,MATH 18,A03,083745,Cinel; Cameron Alexander,8,0,30,22
1656893963203,MATH 18,B01,083748,Rideout; David Porter,4,0,37,33
1656893963203,MATH 18,B02,083749,Rideout; David Porter,3,0,36,33
1656893963203,MATH 18,B03,083750,Rideout; David Porter,2,0,37,35
1656893963203,MATH 18,B04,083751,Rideout; David Porter,5,0,36,31
1656893963203,MATH 18,B05,093473,Rideout; David Porter,4,0,36,32
1656893963203,MATH 18,B06,093474,Rideout; David Porter,5,0,36,31
1656893969228,MATH 20A,A01,083754,Zheng; Zequn,12,0,40,28
1656893975250,MATH 20B,A01,083756,Briones; Jor-el Thomas Caparas,1,0,36,35
1656893975250,MATH 20B,A02,083757,Briones; Jor-el Thomas Caparas,1,0,36,35
1656893975250,MATH 20B,A03,093475,Briones; Jor-el Thomas Caparas,0,0,36,36
1656893981276,MATH 20C,A01,083760,Briones; Jor-el Thomas Caparas,1,0,35,34
1656893981276,MATH 20C,A02,083761,Briones; Jor-el Thomas Caparas,8,0,35,27
1656893981276,MATH 20C,A03,093476,Briones; Jor-el Thomas Caparas,0,1,36,36
1656893981276,MATH 20C,B01,083762,Bach; Quang Tran,0,0,30,30
1656893987300,MATH 20D,A01,083765,Tran; Brian Kha,4,0,30,26
1656893987300,MATH 20D,A02,083766,Tran; Brian Kha,4,0,30,26
1656893987300,MATH 20D,A03,083767,Tran; Brian Kha,3,0,30,27
1656893993323,MATH 20E,A01,083771,Ganguly; Soumya,5,0,32,27
1656893993323,MATH 20E,A02,083772,Ganguly; Soumya,6,0,32,26
1656893993323,MATH 20E,B01,083773,Ciotti; Benjamin,18,0,35,17
1656893993323,MATH 20E,B02,083774,Ciotti; Benjamin,17,0,35,18
1656893999348,MATH 103A,A01,083777,Greenfeld; Be'Eri,2,0,36,34
1656893999348,MATH 103A,A02,083778,Greenfeld; Be'Eri,5,0,36,31
1656893999348,MATH 103A,A03,093561,Greenfeld; Be'Eri,4,0,36,32
1656893999348,MATH 103A,B01,083779,Greenfeld; Be'Eri,6,0,36,30
1656893999348,MATH 103A,B02,083780,Greenfeld; Be'Eri,2,0,36,34
1656893999348,MATH 103A,B03,093562,Greenfeld; Be'Eri,2,0,36,34
1656894005375,MATH 105,A01,085443,Carter; Anne Toulson,13,0,35,22
1656894005375,MATH 105,A02,093477,Carter; Anne Toulson,20,0,35,15
1656894011399,MATH 109,A01,083213,Ganzberger; Geoffrey Michael,2,0,34,32
1656894011399,MATH 109,A02,083214,Ganzberger; Geoffrey Michael,2,0,34,32
1656894011399,MATH 109,A03,093478,Ganzberger; Geoffrey Michael,1,0,34,33
1656894011399,MATH 109,B01,083215,Ganzberger; Geoffrey Michael,1,0,32,31
1656894011399,MATH 109,B02,083216,Ganzberger; Geoffrey Michael,1,0,32,31
1656894011399,MATH 109,B03,093479,Ganzberger; Geoffrey Michael,6,0,32,26
1656894017424,MATH 142A,A01,083219,Chow; Bennett,6,0,32,26
1656894017424,MATH 142A,A02,083220,Chow; Bennett,10,0,32,22
1656894017424,MATH 142A,A03,093480,Chow; Bennett,7,0,32,25
1656894017424,MATH 142A,B03,093481,Chow; Bennett,7,0,32,25
1656894017424,MATH 142A,B04,093558,Chow; Bennett,10,0,32,22
1656894017424,MATH 142A,B05,093559,Chow; Bennett,6,0,32,26
1656894023452,MATH 193A,A01,083224,Rotar; Vladimir,6,0,34,28
1656894023452,MATH 193A,A02,083225,Rotar; Vladimir,3,0,34,31
1656894023452,MATH 193A,A03,083781,Rotar; Vladimir,1,0,34,33
1656894023452,MATH 193A,A04,083782,Rotar; Vladimir,6,0,34,28
1656894023452,MATH 193A,A05,093482,Rotar; Vladimir,6,0,34,28
1656894029479,MATH 197,001,091859,McAuley; Julian John,9999,0,9999,0
1656894029479,MATH 197,002,095566,Kedlaya; Kiran S.,9997,0,9999,2
1656894029479,MATH 197,003,095567,Xiao; Ming,9999,0,9999,0
1656894029479,MATH 197,004,095571,Perols; Johan Lars,9998,0,9999,1
1656894036552,COGS 9,A01,083615,Shannon; Kyle Michael,6,0,75,69
1656894042579,COGS 11,A01,083617,Boyle; Mary E. T.,19,0,48,29
1656894048603,COGS 13,A01,083071,Bastos; Amalia Pinkusfeld,8,0,71,63
1656894054630,COGS 14A,A01,092681,Semenuks; Arturs,0,1,100,100
1656894060657,COGS 14B,A01,083073,Cheng; Tzu-Han,5,0,63,58
1656894066685,COGS 17,A01,092677,Semenuks; Arturs,4,0,81,77
1656894072709,COGS 100,A01,083619,Allen; Michael Gordon,15,0,70,55
1656894078733,COGS 101A,A01,083621,Davis; Joshua Daniel,9,0,68,59
1656894084760,COGS 101B,A01,091572,Allen; Michael Gordon,8,0,65,57
1656894090783,COGS 101C,A01,083625,Delgado; Tania,17,0,35,18
1656894096811,COGS 107A,A01,083627,Boyle; Mary E. T.,13,0,60,47
1656894102833,COGS 118A,A01,083075,Gupta; Anjum,15,0,76,61
1656894108857,CSE 3,A50,083646,Miranda; Gregory Joseph,22,0,50,28
1656894114886,CSE 8A,A50,083650,Miranda; Gregory Joseph,17,1,56,39
1656894120915,CSE 11,A01,083080,Cao; Yingjun,4,15,40,36
1656894126938,CSE 12,A01,083652,Krause-Levy; Sophia Louisa,20,1,120,100
1656894132966,CSE 15L,A01,083654,Morris; Justin Loren,8,0,50,42
1656894132966,CSE 15L,A02,083655,Morris; Justin Loren,8,0,50,42
1656894138992,CSE 20,A01,083657,Tran; Khoa Dang,37,0,80,43
1656894145016,CSE 21,A01,095574,Bach; Quang Tran,21,0,48,27
1656894151040,CSE 30,A01,083084,Eldon; John,4,0,80,76
1656894151040,CSE 30,B01,095061,Bhaskar; Nishant,6,0,50,44
1656894157066,CSE 100,A01,083659,Cao; Yingjun,2,4,70,68
1656894163090,CSE 134B,A01,083661,Powell; Thomas Allan,19,0,100,81
1656894169115,CSE 140,A01,083663,Gungor; Onat,14,0,85,71
1656894175142,CSE 140L,A01,083088,Eldon; John,16,0,100,84
1656894181167,CSE 175,A01,083665,Kumar; Rakesh,3,0,25,22
1656894187199,CSE 190,A00,092507,Dubnov; Shlomo,7,0,20,13
1656894193222,ECE 45,A01,083139,Congero; Spencer William,5,0,75,70
1656894199253,ECE 65,A50,083695,Saad; Andrew S,12,0,30,18
1656894199253,ECE 65,A51,095125,Saad; Andrew S,25,0,26,1
1656894205280,ECE 109,A01,091882,Touri; Behrouz,16,0,70,54
1656894211303,ECE 180,A00,083140,Abi Samra; Nicholas Camill,0,0,30,30
1656894211303,ECE 180,B00,083141,Abi Samra; Nicholas Camill,0,0,30,30
1656894217330,MATH 10A,A01,083735,Patchell; Gregory David,1,0,30,29
1656894217330,MATH 10A,A02,083736,Patchell; Gregory David,20,0,30,10
1656894217330,MATH 10A,A03,083737,Patchell; Gregory David,15,0,30,15
1656894223357,MATH 10B,A01,083207,Lim; Seonhee,7,0,34,27
1656894223357,MATH 10B,A02,083208,Lim; Seonhee,9,0,35,26
1656894223357,MATH 10B,A03,093472,Lim; Seonhee,4,0,34,30
1656894223357,MATH 10B,B01,083739,Sinha; Shubham,9,0,30,21
1656894229380,MATH 18,A01,083743,Cinel; Cameron Alexander,6,0,30,24
1656894229380,MATH 18,A02,083744,Cinel; Cameron Alexander,15,0,30,15
1656894229380,MATH 18,A03,083745,Cinel; Cameron Alexander,8,0,30,22
1656894229380,MATH 18,B01,083748,Rideout; David Porter,4,0,37,33
1656894229380,MATH 18,B02,083749,Rideout; David Porter,3,0,36,33
1656894229380,MATH 18,B03,083750,Rideout; David Porter,2,0,37,35
1656894229380,MATH 18,B04,083751,Rideout; David Porter,5,0,36,31
1656894229380,MATH 18,B05,093473,Rideout; David Porter,4,0,36,32
1656894229380,MATH 18,B06,093474,Rideout; David Porter,5,0,36,31
1656894235403,MATH 20A,A01,083754,Zheng; Zequn,12,0,40,28
1656894241427,MATH 20B,A01,083756,Briones; Jor-el Thomas Caparas,1,0,36,35
1656894241427,MATH 20B,A02,083757,Briones; Jor-el Thomas Caparas,1,0,36,35
1656894241427,MATH 20B,A03,093475,Briones; Jor-el Thomas Caparas,0,0,36,36
1656894247449,MATH 20C,A01,083760,Briones; Jor-el Thomas Caparas,1,0,35,34
1656894247449,MATH 20C,A02,083761,Briones; Jor-el Thomas Caparas,8,0,35,27
1656894247449,MATH 20C,A03,093476,Briones; Jor-el Thomas Caparas,0,1,36,36
1656894247449,MATH 20C,B01,083762,Bach; Quang Tran,0,0,30,30
1656894253481,MATH 20D,A01,083765,Tran; Brian Kha,4,0,30,26
1656894253481,MATH 20D,A02,083766,Tran; Brian Kha,4,0,30,26
1656894253481,MATH 20D,A03,083767,Tran; Brian Kha,3,0,30,27
1656894259510,MATH 20E,A01,083771,Ganguly; Soumya,5,0,32,27
1656894259510,MATH 20E,A02,083772,Ganguly; Soumya,6,0,32,26
1656894259510,MATH 20E,B01,083773,Ciotti; Benjamin,18,0,35,17
1656894259510,MATH 20E,B02,083774,Ciotti; Benjamin,17,0,35,18
1656894265534,MATH 103A,A01,083777,Greenfeld; Be'Eri,2,0,36,34
1656894265534,MATH 103A,A02,083778,Greenfeld; Be'Eri,5,0,36,31
1656894265534,MATH 103A,A03,093561,Greenfeld; Be'Eri,4,0,36,32
1656894265534,MATH 103A,B01,083779,Greenfeld; Be'Eri,6,0,36,30
1656894265534,MATH 103A,B02,083780,Greenfeld; Be'Eri,2,0,36,34
1656894265534,MATH 103A,B03,093562,Greenfeld; Be'Eri,2,0,36,34
1656894271559,MATH 105,A01,085443,Carter; Anne Toulson,13,0,35,22
1656894271559,MATH 105,A02,093477,Carter; Anne Toulson,20,0,35,15
1656894277582,MATH 109,A01,083213,Ganzberger; Geoffrey Michael,2,0,34,32
1656894277582,MATH 109,A02,083214,Ganzberger; Geoffrey Michael,2,0,34,32
1656894277582,MATH 109,A03,093478,Ganzberger; Geoffrey Michael,1,0,34,33
1656894277582,MATH 109,B01,083215,Ganzberger; Geoffrey Michael,1,0,32,31
1656894277582,MATH 109,B02,083216,Ganzberger; Geoffrey Michael,1,0,32,31
1656894277582,MATH 109,B03,093479,Ganzberger; Geoffrey Michael,6,0,32,26
1656894283607,MATH 142A,A01,083219,Chow; Bennett,6,0,32,26
1656894283607,MATH 142A,A02,083220,Chow; Bennett,10,0,32,22
1656894283607,MATH 142A,A03,093480,Chow; Bennett,7,0,32,25
1656894283607,MATH 142A,B03,093481,Chow; Bennett,7,0,32,25
1656894283607,MATH 142A,B04,093558,Chow; Bennett,10,0,32,22
1656894283607,MATH 142A,B05,093559,Chow; Bennett,6,0,32,26
1656894289634,MATH 193A,A01,083224,Rotar; Vladimir,6,0,34,28
1656894289634,MATH 193A,A02,083225,Rotar; Vladimir,3,0,34,31
1656894289634,MATH 193A,A03,083781,Rotar; Vladimir,1,0,34,33
1656894289634,MATH 193A,A04,083782,Rotar; Vladimir,6,0,34,28
1656894289634,MATH 193A,A05,093482,Rotar; Vladimir,6,0,34,28
1656894295658,MATH 197,001,091859,McAuley; Julian John,9999,0,9999,0
1656894295658,MATH 197,002,095566,Kedlaya; Kiran S.,9997,0,9999,2
1656894295658,MATH 197,003,095567,Xiao; Ming,9999,0,9999,0
1656894295658,MATH 197,004,095571,Perols; Johan Lars,9998,0,9999,1
1656894302708,COGS 9,A01,083615,Shannon; Kyle Michael,6,0,75,69
1656894308732,COGS 11,A01,083617,Boyle; Mary E. T.,19,0,48,29
1656894314756,COGS 13,A01,083071,Bastos; Amalia Pinkusfeld,8,0,71,63
1656894320783,COGS 14A,A01,092681,Semenuks; Arturs,0,1,100,100
1656894326810,COGS 14B,A01,083073,Cheng; Tzu-Han,5,0,63,58
1656894332834,COGS 17,A01,092677,Semenuks; Arturs,4,0,81,77
1656894338861,COGS 100,A01,083619,Allen; Michael Gordon,15,0,70,55
1656894344885,COGS 101A,A01,083621,Davis; Joshua Daniel,9,0,68,59
1656894350907,COGS 101B,A01,091572,Allen; Michael Gordon,8,0,65,57
1656894356930,COGS 101C,A01,083625,Delgado; Tania,17,0,35,18
1656894363027,COGS 107A,A01,083627,Boyle; Mary E. T.,13,0,60,47
1656894369051,COGS 118A,A01,083075,Gupta; Anjum,15,0,76,61
1656894375075,CSE 3,A50,083646,Miranda; Gregory Joseph,22,0,50,28
1656894381108,CSE 8A,A50,083650,Miranda; Gregory Joseph,17,1,56,39
1656894387131,CSE 11,A01,083080,Cao; Yingjun,4,15,40,36
1656894393158,CSE 12,A01,083652,Krause-Levy; Sophia Louisa,20,1,120,100
1656894399198,CSE 15L,A01,083654,Morris; Justin Loren,8,0,50,42
1656894399198,CSE 15L,A02,083655,Morris; Justin Loren,8,0,50,42
1656894405227,CSE 20,A01,083657,Tran; Khoa Dang,37,0,80,43
1656894411251,CSE 21,A01,095574,Bach; Quang Tran,21,0,48,27
1656894417278,CSE 30,A01,083084,Eldon; John,4,0,80,76
1656894417278,CSE 30,B01,095061,Bhaskar; Nishant,6,0,50,44
1656894423315,CSE 100,A01,083659,Cao; Yingjun,2,4,70,68
1656894429342,CSE 134B,A01,083661,Powell; Thomas Allan,19,0,100,81
1656894435367,CSE 140,A01,083663,Gungor; Onat,14,0,85,71
1656894441393,CSE 140L,A01,083088,Eldon; John,16,0,100,84
1656894447425,CSE 175,A01,083665,Kumar; Rakesh,3,0,25,22
1656894453449,CSE 190,A00,092507,Dubnov; Shlomo,7,0,20,13
1656894459476,ECE 45,A01,083139,Congero; Spencer William,5,0,75,70
1656894465504,ECE 65,A50,083695,Saad; Andrew S,12,0,30,18
1656894465504,ECE 65,A51,095125,Saad; Andrew S,25,0,26,1
1656894471528,ECE 109,A01,091882,Touri; Behrouz,16,0,70,54
1656894477557,ECE 180,A00,083140,Abi Samra; Nicholas Camill,0,0,30,30
1656894477557,ECE 180,B00,083141,Abi Samra; Nicholas Camill,0,0,30,30
1656894483588,MATH 10A,A01,083735,Patchell; Gregory David,1,0,30,29
1656894483588,MATH 10A,A02,083736,Patchell; Gregory David,20,0,30,10
1656894483588,MATH 10A,A03,083737,Patchell; Gregory David,15,0,30,15
1656894489610,MATH 10B,A01,083207,Lim; Seonhee,7,0,34,27
1656894489610,MATH 10B,A02,083208,Lim; Seonhee,9,0,35,26
1656894489610,MATH 10B,A03,093472,Lim; Seonhee,4,0,34,30
1656894489610,MATH 10B,B01,083739,Sinha; Shubham,9,0,30,21
1656894495646,MATH 18,A01,083743,Cinel; Cameron Alexander,6,0,30,24
1656894495646,MATH 18,A02,083744,Cinel; Cameron Alexander,15,0,30,15
1656894495646,MATH 18,A03,083745,Cinel; Cameron Alexander,8,0,30,22
1656894495646,MATH 18,B01,083748,Rideout; David Porter,4,0,37,33
1656894495646,MATH 18,B02,083749,Rideout; David Porter,3,0,36,33
1656894495646,MATH 18,B03,083750,Rideout; David Porter,2,0,37,35
1656894495646,MATH 18,B04,083751,Rideout; David Porter,5,0,36,31
1656894495646,MATH 18,B05,093473,Rideout; David Porter,4,0,36,32
1656894495646,MATH 18,B06,093474,Rideout; David Porter,5,0,36,31
1656894501672,MATH 20A,A01,083754,Zheng; Zequn,12,0,40,28
1656894507696,MATH 20B,A01,083756,Briones; Jor-el Thomas Caparas,1,0,36,35
1656894507696,MATH 20B,A02,083757,Briones; Jor-el Thomas Caparas,1,0,36,35
1656894507696,MATH 20B,A03,093475,Briones; Jor-el Thomas Caparas,0,0,36,36
1656894513726,MATH 20C,A01,083760,Briones; Jor-el Thomas Caparas,1,0,35,34
1656894513726,MATH 20C,A02,083761,Briones; Jor-el Thomas Caparas,8,0,35,27
1656894513726,MATH 20C,A03,093476,Briones; Jor-el Thomas Caparas,0,1,36,36
1656894513726,MATH 20C,B01,083762,Bach; Quang Tran,0,0,30,30
1656894519754,MATH 20D,A01,083765,Tran; Brian Kha,4,0,30,26
1656894519754,MATH 20D,A02,083766,Tran; Brian Kha,4,0,30,26
1656894519754,MATH 20D,A03,083767,Tran; Brian Kha,3,0,30,27
1656894525783,MATH 20E,A01,083771,Ganguly; Soumya,5,0,32,27
1656894525783,MATH 20E,A02,083772,Ganguly; Soumya,6,0,32,26
1656894525783,MATH 20E,B01,083773,Ciotti; Benjamin,18,0,35,17
1656894525783,MATH 20E,B02,083774,Ciotti; Benjamin,17,0,35,18
1656894531821,MATH 103A,A01,083777,Greenfeld; Be'Eri,2,0,36,34
1656894531821,MATH 103A,A02,083778,Greenfeld; Be'Eri,5,0,36,31
1656894531821,MATH 103A,A03,093561,Greenfeld; Be'Eri,4,0,36,32
1656894531821,MATH 103A,B01,083779,Greenfeld; Be'Eri,6,0,36,30
1656894531821,MATH 103A,B02,083780,Greenfeld; Be'Eri,2,0,36,34
1656894531821,MATH 103A,B03,093562,Greenfeld; Be'Eri,2,0,36,34
1656894537847,MATH 105,A01,085443,Carter; Anne Toulson,13,0,35,22
1656894537847,MATH 105,A02,093477,Carter; Anne Toulson,20,0,35,15
1656894543876,MATH 109,A01,083213,Ganzberger; Geoffrey Michael,2,0,34,32
1656894543876,MATH 109,A02,083214,Ganzberger; Geoffrey Michael,2,0,34,32
1656894543876,MATH 109,A03,093478,Ganzberger; Geoffrey Michael,1,0,34,33
1656894543876,MATH 109,B01,083215,Ganzberger; Geoffrey Michael,1,0,32,31
1656894543876,MATH 109,B02,083216,Ganzberger; Geoffrey Michael,1,0,32,31
1656894543876,MATH 109,B03,093479,Ganzberger; Geoffrey Michael,6,0,32,26
1656894549907,MATH 142A,A01,083219,Chow; Bennett,6,0,32,26
1656894549907,MATH 142A,A02,083220,Chow; Bennett,10,0,32,22
1656894549907,MATH 142A,A03,093480,Chow; Bennett,7,0,32,25
1656894549907,MATH 142A,B03,093481,Chow; Bennett,7,0,32,25
1656894549907,MATH 142A,B04,093558,Chow; Bennett,10,0,32,22
1656894549907,MATH 142A,B05,093559,Chow; Bennett,6,0,32,26
1656894555930,MATH 193A,A01,083224,Rotar; Vladimir,6,0,34,28
1656894555930,MATH 193A,A02,083225,Rotar; Vladimir,3,0,34,31
1656894555930,MATH 193A,A03,083781,Rotar; Vladimir,1,0,34,33
1656894555930,MATH 193A,A04,083782,Rotar; Vladimir,6,0,34,28
1656894555930,MATH 193A,A05,093482,Rotar; Vladimir,6,0,34,28
1656894561953,MATH 197,001,091859,McAuley; Julian John,9999,0,9999,0
1656894561953,MATH 197,002,095566,Kedlaya; Kiran S.,9997,0,9999,2
1656894561953,MATH 197,003,095567,Xiao; Ming,9999,0,9999,0
1656894561953,MATH 197,004,095571,Perols; Johan Lars,9998,0,9999,1
1656894569022,COGS 9,A01,083615,Shannon; Kyle Michael,6,0,75,69
1656894575045,COGS 11,A01,083617,Boyle; Mary E. T.,19,0,48,29
1656894581077,COGS 13,A01,083071,Bastos; Amalia Pinkusfeld,8,0,71,63
1656894587099,COGS 14A,A01,092681,Semenuks; Arturs,0,1,100,100
1656894593123,COGS 14B,A01,083073,Cheng; Tzu-Han,5,0,63,58
1656894599148,COGS 17,A01,092677,Semenuks; Arturs,4,0,81,77
1656894605179,COGS 100,A01,083619,Allen; Michael Gordon,15,0,70,55
1656894611201,COGS 101A,A01,083621,Davis; Joshua Daniel,9,0,68,59
1656894617228,COGS 101B,A01,091572,Allen; Michael Gordon,8,0,65,57
1656894623252,COGS 101C,A01,083625,Delgado; Tania,17,0,35,18
1656894629279,COGS 107A,A01,083627,Boyle; Mary E. T.,13,0,60,47
1656894635304,COGS 118A,A01,083075,Gupta; Anjum,15,0,76,61
1656894641330,CSE 3,A50,083646,Miranda; Gregory Joseph,22,0,50,28
1656894647352,CSE 8A,A50,083650,Miranda; Gregory Joseph,17,1,56,39
1656894653383,CSE 11,A01,083080,Cao; Yingjun,4,15,40,36
1656894659407,CSE 12,A01,083652,Krause-Levy; Sophia Louisa,20,1,120,100
1656894665431,CSE 15L,A01,083654,Morris; Justin Loren,8,0,50,42
1656894665431,CSE 15L,A02,083655,Morris; Justin Loren,8,0,50,42
1656894671458,CSE 20,A01,083657,Tran; Khoa Dang,37,0,80,43
1656894677481,CSE 21,A01,095574,Bach; Quang Tran,21,0,48,27
1656894683503,CSE 30,A01,083084,Eldon; John,4,0,80,76
1656894683503,CSE 30,B01,095061,Bhaskar; Nishant,6,0,50,44
1656894689529,CSE 100,A01,083659,Cao; Yingjun,2,4,70,68
1656894695556,CSE 134B,A01,083661,Powell; Thomas Allan,19,0,100,81
1656894701583,CSE 140,A01,083663,Gungor; Onat,14,0,85,71
1656894707609,CSE 140L,A01,083088,Eldon; John,16,0,100,84
1656894713635,CSE 175,A01,083665,Kumar; Rakesh,3,0,25,22
1656894719660,CSE 190,A00,092507,Dubnov; Shlomo,7,0,20,13
1656894725682,ECE 45,A01,083139,Congero; Spencer William,5,0,75,70
1656894731707,ECE 65,A50,083695,Saad; Andrew S,12,0,30,18
1656894731707,ECE 65,A51,095125,Saad; Andrew S,25,0,26,1
1656894737731,ECE 109,A01,091882,Touri; Behrouz,16,0,70,54
1656894743759,ECE 180,A00,083140,Abi Samra; Nicholas Camill,0,0,30,30
1656894743759,ECE 180,B00,083141,Abi Samra; Nicholas Camill,0,0,30,30
1656894749795,MATH 10A,A01,083735,Patchell; Gregory David,1,0,30,29
1656894749795,MATH 10A,A02,083736,Patchell; Gregory David,20,0,30,10
1656894749795,MATH 10A,A03,083737,Patchell; Gregory David,15,0,30,15
1656894755823,MATH 10B,A01,083207,Lim; Seonhee,7,0,34,27
1656894755823,MATH 10B,A02,083208,Lim; Seonhee,9,0,35,26
1656894755823,MATH 10B,A03,093472,Lim; Seonhee,4,0,34,30
1656894755823,MATH 10B,B01,083739,Sinha; Shubham,9,0,30,21
1656894761856,MATH 18,A01,083743,Cinel; Cameron Alexander,6,0,30,24
1656894761856,MATH 18,A02,083744,Cinel; Cameron Alexander,15,0,30,15
1656894761856,MATH 18,A03,083745,Cinel; Cameron Alexander,8,0,30,22
1656894761856,MATH 18,B01,083748,Rideout; David Porter,4,0,37,33
1656894761856,MATH 18,B02,083749,Rideout; David Porter,3,0,36,33
1656894761856,MATH 18,B03,083750,Rideout; David Porter,2,0,37,35
1656894761856,MATH 18,B04,083751,Rideout; David Porter,5,0,36,31
1656894761856,MATH 18,B05,093473,Rideout; David Porter,4,0,36,32
1656894761856,MATH 18,B06,093474,Rideout; David Porter,5,0,36,31
1656894767883,MATH 20A,A01,083754,Zheng; Zequn,12,0,40,28
1656894773908,MATH 20B,A01,083756,Briones; Jor-el Thomas Caparas,1,0,36,35
1656894773908,MATH 20B,A02,083757,Briones; Jor-el Thomas Caparas,1,0,36,35
1656894773908,MATH 20B,A03,093475,Briones; Jor-el Thomas Caparas,0,0,36,36
1656894779932,MATH 20C,A01,083760,Briones; Jor-el Thomas Caparas,1,0,35,34
1656894779932,MATH 20C,A02,083761,Briones; Jor-el Thomas Caparas,8,0,35,27
1656894779932,MATH 20C,A03,093476,Briones; Jor-el Thomas Caparas,0,1,36,36
1656894779932,MATH 20C,B01,083762,Bach; Quang Tran,0,0,30,30
1656894785961,MATH 20D,A01,083765,Tran; Brian Kha,4,0,30,26
1656894785961,MATH 20D,A02,083766,Tran; Brian Kha,4,0,30,26
1656894785961,MATH 20D,A03,083767,Tran; Brian Kha,3,0,30,27
1656894791983,MATH 20E,A01,083771,Ganguly; Soumya,5,0,32,27
1656894791983,MATH 20E,A02,083772,Ganguly; Soumya,6,0,32,26
1656894791983,MATH 20E,B01,083773,Ciotti; Benjamin,18,0,35,17
1656894791983,MATH 20E,B02,083774,Ciotti; Benjamin,17,0,35,18
1656894798016,MATH 103A,A01,083777,Greenfeld; Be'Eri,2,0,36,34
1656894798016,MATH 103A,A02,083778,Greenfeld; Be'Eri,5,0,36,31
1656894798016,MATH 103A,A03,093561,Greenfeld; Be'Eri,4,0,36,32
1656894798016,MATH 103A,B01,083779,Greenfeld; Be'Eri,6,0,36,30
1656894798016,MATH 103A,B02,083780,Greenfeld; Be'Eri,2,0,36,34
1656894798016,MATH 103A,B03,093562,Greenfeld; Be'Eri,2,0,36,34
1656894804040,MATH 105,A01,085443,Carter; Anne Toulson,13,0,35,22
1656894804040,MATH 105,A02,093477,Carter; Anne Toulson,20,0,35,15
1656894810071,MATH 109,A01,083213,Ganzberger; Geoffrey Michael,2,0,34,32
1656894810071,MATH 109,A02,083214,Ganzberger; Geoffrey Michael,2,0,34,32
1656894810071,MATH 109,A03,093478,Ganzberger; Geoffrey Michael,1,0,34,33
1656894810071,MATH 109,B01,083215,Ganzberger; Geoffrey Michael,1,0,32,31
1656894810071,MATH 109,B02,083216,Ganzberger; Geoffrey Michael,1,0,32,31
1656894810071,MATH 109,B03,093479,Ganzberger; Geoffrey Michael,6,0,32,26
1656894816100,MATH 142A,A01,083219,Chow; Bennett,6,0,32,26
1656894816100,MATH 142A,A02,083220,Chow; Bennett,10,0,32,22
1656894816100,MATH 142A,A03,093480,Chow; Bennett,7,0,32,25
1656894816100,MATH 142A,B03,093481,Chow; Bennett,7,0,32,25
1656894816100,MATH 142A,B04,093558,Chow; Bennett,10,0,32,22
1656894816100,MATH 142A,B05,093559,Chow; Bennett,6,0,32,26
1656894822128,MATH 193A,A01,083224,Rotar; Vladimir,7,0,34,27
1656894822128,MATH 193A,A02,083225,Rotar; Vladimir,3,0,34,31
1656894822128,MATH 193A,A03,083781,Rotar; Vladimir,1,0,34,33
1656894822128,MATH 193A,A04,083782,Rotar; Vladimir,6,0,34,28
1656894822128,MATH 193A,A05,093482,Rotar; Vladimir,6,0,34,28
1656894828152,MATH 197,001,091859,McAuley; Julian John,9999,0,9999,0
1656894828152,MATH 197,002,095566,Kedlaya; Kiran S.,9997,0,9999,2
1656894828152,MATH 197,003,095567,Xiao; Ming,9999,0,9999,0
1656894828152,MATH 197,004,095571,Perols; Johan Lars,9998,0,9999,1
1656894835202,COGS 9,A01,083615,Shannon; Kyle Michael,6,0,75,69
1656894841225,COGS 11,A01,083617,Boyle; Mary E. T.,19,0,48,29
1656894847251,COGS 13,A01,083071,Bastos; Amalia Pinkusfeld,8,0,71,63
1656894853281,COGS 14A,A01,092681,Semenuks; Arturs,0,1,100,100
1656894859311,COGS 14B,A01,083073,Cheng; Tzu-Han,5,0,63,58
1656894865337,COGS 17,A01,092677,Semenuks; Arturs,4,0,81,77
1656894871364,COGS 100,A01,083619,Allen; Michael Gordon,15,0,70,55
1656894877392,COGS 101A,A01,083621,Davis; Joshua Daniel,9,0,68,59
1656894883420,COGS 101B,A01,091572,Allen; Michael Gordon,8,0,65,57
1656894889447,COGS 101C,A01,083625,Delgado; Tania,17,0,35,18
1656894895469,COGS 107A,A01,083627,Boyle; Mary E. T.,13,0,60,47
1656894901497,COGS 118A,A01,083075,Gupta; Anjum,15,0,76,61
1656894907520,CSE 3,A50,083646,Miranda; Gregory Joseph,22,0,50,28
1656894913548,CSE 8A,A50,083650,Miranda; Gregory Joseph,17,1,56,39
1656894919577,CSE 11,A01,083080,Cao; Yingjun,4,15,40,36
1656894925600,CSE 12,A01,083652,Krause-Levy; Sophia Louisa,20,1,120,100
1656894931623,CSE 15L,A01,083654,Morris; Justin Loren,8,0,50,42
1656894931623,CSE 15L,A02,083655,Morris; Justin Loren,8,0,50,42
1656894937650,CSE 20,A01,083657,Tran; Khoa Dang,37,0,80,43
1656894943672,CSE 21,A01,095574,Bach; Quang Tran,21,0,48,27
1656894949699,CSE 30,A01,083084,Eldon; John,4,0,80,76
1656894949699,CSE 30,B01,095061,Bhaskar; Nishant,6,0,50,44
1656894955721,CSE 100,A01,083659,Cao; Yingjun,2,4,70,68
1656894961824,CSE 134B,A01,083661,Powell; Thomas Allan,19,0,100,81
1656894967850,CSE 140,A01,083663,Gungor; Onat,14,0,85,71
1656894973874,CSE 140L,A01,083088,Eldon; John,16,0,100,84
1656894979900,CSE 175,A01,083665,Kumar; Rakesh,3,0,25,22
1656894985926,CSE 190,A00,092507,Dubnov; Shlomo,7,0,20,13
1656894991952,ECE 45,A01,083139,Congero; Spencer William,5,0,75,70
1656894997992,ECE 65,A50,083695,Saad; Andrew S,12,0,30,18
1656894997992,ECE 65,A51,095125,Saad; Andrew S,25,0,26,1
1656895004016,ECE 109,A01,091882,Touri; Behrouz,16,0,70,54
1656895010040,ECE 180,A00,083140,Abi Samra; Nicholas Camill,0,0,30,30
1656895010040,ECE 180,B00,083141,Abi Samra; Nicholas Camill,0,0,30,30
1656895016068,MATH 10A,A01,083735,Patchell; Gregory David,1,0,30,29
1656895016068,MATH 10A,A02,083736,Patchell; Gregory David,20,0,30,10
1656895016068,MATH 10A,A03,083737,Patchell; Gregory David,15,0,30,15
1656895022093,MATH 10B,A01,083207,Lim; Seonhee,7,0,34,27
1656895022093,MATH 10B,A02,083208,Lim; Seonhee,9,0,35,26
1656895022093,MATH 10B,A03,093472,Lim; Seonhee,4,0,34,30
1656895022093,MATH 10B,B01,083739,Sinha; Shubham,9,0,30,21
1656895028122,MATH 18,A01,083743,Cinel; Cameron Alexander,6,0,30,24
1656895028122,MATH 18,A02,083744,Cinel; Cameron Alexander,15,0,30,15
1656895028122,MATH 18,A03,083745,Cinel; Cameron Alexander,8,0,30,22
1656895028122,MATH 18,B01,083748,Rideout; David Porter,4,0,37,33
1656895028122,MATH 18,B02,083749,Rideout; David Porter,3,0,36,33
1656895028122,MATH 18,B03,083750,Rideout; David Porter,2,0,37,35
1656895028122,MATH 18,B04,083751,Rideout; David Porter,5,0,36,31
1656895028122,MATH 18,B05,093473,Rideout; David Porter,4,0,36,32
1656895028122,MATH 18,B06,093474,Rideout; David Porter,5,0,36,31
1656895034143,MATH 20A,A01,083754,Zheng; Zequn,12,0,40,28
1656895040165,MATH 20B,A01,083756,Briones; Jor-el Thomas Caparas,1,0,36,35
1656895040165,MATH 20B,A02,083757,Briones; Jor-el Thomas Caparas,1,0,36,35
1656895040165,MATH 20B,A03,093475,Briones; Jor-el Thomas Caparas,0,0,36,36
1656895046199,MATH 20C,A01,083760,Briones; Jor-el Thomas Caparas,1,0,35,34
1656895046199,MATH 20C,A02,083761,Briones; Jor-el Thomas Caparas,8,0,35,27
1656895046199,MATH 20C,A03,093476,Briones; Jor-el Thomas Caparas,0,1,36,36
1656895046199,MATH 20C,B01,083762,Bach; Quang Tran,0,0,30,30
1656895052222,MATH 20D,A01,083765,Tran; Brian Kha,4,0,30,26
1656895052222,MATH 20D,A02,083766,Tran; Brian Kha,4,0,30,26
1656895052222,MATH 20D,A03,083767,Tran; Brian Kha,3,0,30,27
1656895058244,MATH 20E,A01,083771,Ganguly; Soumya,5,0,32,27
1656895058244,MATH 20E,A02,083772,Ganguly; Soumya,6,0,32,26
1656895058244,MATH 20E,B01,083773,Ciotti; Benjamin,18,0,35,17
1656895058244,MATH 20E,B02,083774,Ciotti; Benjamin,17,0,35,18
1656895064273,MATH 103A,A01,083777,Greenfeld; Be'Eri,2,0,36,34
1656895064273,MATH 103A,A02,083778,Greenfeld; Be'Eri,5,0,36,31
1656895064273,MATH 103A,A03,093561,Greenfeld; Be'Eri,4,0,36,32
1656895064273,MATH 103A,B01,083779,Greenfeld; Be'Eri,6,0,36,30
1656895064273,MATH 103A,B02,083780,Greenfeld; Be'Eri,2,0,36,34
1656895064273,MATH 103A,B03,093562,Greenfeld; Be'Eri,2,0,36,34
1656895070300,MATH 105,A01,085443,Carter; Anne Toulson,13,0,35,22
1656895070300,MATH 105,A02,093477,Carter; Anne Toulson,20,0,35,15
1656895076325,MATH 109,A01,083213,Ganzberger; Geoffrey Michael,2,0,34,32
1656895076325,MATH 109,A02,083214,Ganzberger; Geoffrey Michael,2,0,34,32
1656895076325,MATH 109,A03,093478,Ganzberger; Geoffrey Michael,1,0,34,33
1656895076325,MATH 109,B01,083215,Ganzberger; Geoffrey Michael,1,0,32,31
1656895076325,MATH 109,B02,083216,Ganzberger; Geoffrey Michael,1,0,32,31
1656895076325,MATH 109,B03,093479,Ganzberger; Geoffrey Michael,6,0,32,26
1656895082349,MATH 142A,A01,083219,Chow; Bennett,6,0,32,26
1656895082349,MATH 142A,A02,083220,Chow; Bennett,10,0,32,22
1656895082349,MATH 142A,A03,093480,Chow; Bennett,7,0,32,25
1656895082349,MATH 142A,B03,093481,Chow; Bennett,7,0,32,25
1656895082349,MATH 142A,B04,093558,Chow; Bennett,10,0,32,22
1656895082349,MATH 142A,B05,093559,Chow; Bennett,6,0,32,26
1656895088375,MATH 193A,A01,083224,Rotar; Vladimir,7,0,34,27
1656895088375,MATH 193A,A02,083225,Rotar; Vladimir,3,0,34,31
1656895088375,MATH 193A,A03,083781,Rotar; Vladimir,1,0,34,33
1656895088375,MATH 193A,A04,083782,Rotar; Vladimir,6,0,34,28
1656895088375,MATH 193A,A05,093482,Rotar; Vladimir,6,0,34,28
1656895094396,MATH 197,001,091859,McAuley; Julian John,9999,0,9999,0
1656895094396,MATH 197,002,095566,Kedlaya; Kiran S.,9997,0,9999,2
1656895094396,MATH 197,003,095567,Xiao; Ming,9999,0,9999,0
1656895094396,MATH 197,004,095571,Perols; Johan Lars,9998,0,9999,1
1656895101460,COGS 9,A01,083615,Shannon; Kyle Michael,6,0,75,69
1656895107484,COGS 11,A01,083617,Boyle; Mary E. T.,19,0,48,29
1656895113510,COGS 13,A01,083071,Bastos; Amalia Pinkusfeld,8,0,71,63
1656895119532,COGS 14A,A01,092681,Semenuks; Arturs,0,1,100,100
1656895125563,COGS 14B,A01,083073,Cheng; Tzu-Han,5,0,63,58
1656895131586,COGS 17,A01,092677,Semenuks; Arturs,4,0,81,77
1656895137608,COGS 100,A01,083619,Allen; Michael Gordon,15,0,70,55
1656895143636,COGS 101A,A01,083621,Davis; Joshua Daniel,9,0,68,59
1656895149659,COGS 101B,A01,091572,Allen; Michael Gordon,8,0,65,57
1656895155683,COGS 101C,A01,083625,Delgado; Tania,17,0,35,18
1656895161712,COGS 107A,A01,083627,Boyle; Mary E. T.,13,0,60,47
1656895167738,COGS 118A,A01,083075,Gupta; Anjum,15,0,76,61
1656895173766,CSE 3,A50,083646,Miranda; Gregory Joseph,22,0,50,28
1656895179798,CSE 8A,A50,083650,Miranda; Gregory Joseph,17,1,56,39
1656895185821,CSE 11,A01,083080,Cao; Yingjun,4,15,40,36
1656895191850,CSE 12,A01,083652,Krause-Levy; Sophia Louisa,20,1,120,100
1656895197877,CSE 15L,A01,083654,Morris; Justin Loren,8,0,50,42
1656895197877,CSE 15L,A02,083655,Morris; Justin Loren,8,0,50,42
1656895203903,CSE 20,A01,083657,Tran; Khoa Dang,37,0,80,43
1656895209927,CSE 21,A01,095574,Bach; Quang Tran,21,0,48,27
1656895215954,CSE 30,A01,083084,Eldon; John,4,0,80,76
1656895215954,CSE 30,B01,095061,Bhaskar; Nishant,6,0,50,44
1656895221979,CSE 100,A01,083659,Cao; Yingjun,2,4,70,68
1656895228002,CSE 134B,A01,083661,Powell; Thomas Allan,19,0,100,81
1656895234025,CSE 140,A01,083663,Gungor; Onat,14,0,85,71
1656895240048,CSE 140L,A01,083088,Eldon; John,16,0,100,84
1656895246074,CSE 175,A01,083665,Kumar; Rakesh,3,0,25,22
1656895252102,CSE 190,A00,092507,Dubnov; Shlomo,7,0,20,13
1656895258128,ECE 45,A01,083139,Congero; Spencer William,5,0,75,70
1656895264152,ECE 65,A50,083695,Saad; Andrew S,12,0,30,18
1656895264152,ECE 65,A51,095125,Saad; Andrew S,25,0,26,1
1656895270174,ECE 109,A01,091882,Touri; Behrouz,16,0,70,54
1656895276196,ECE 180,A00,083140,Abi Samra; Nicholas Camill,0,0,30,30
1656895276196,ECE 180,B00,083141,Abi Samra; Nicholas Camill,0,0,30,30
1656895282224,MATH 10A,A01,083735,Patchell; Gregory David,1,0,30,29
1656895282224,MATH 10A,A02,083736,Patchell; Gregory David,20,0,30,10
1656895282224,MATH 10A,A03,083737,Patchell; Gregory David,15,0,30,15
1656895288249,MATH 10B,A01,083207,Lim; Seonhee,7,0,34,27
1656895288249,MATH 10B,A02,083208,Lim; Seonhee,9,0,35,26
1656895288249,MATH 10B,A03,093472,Lim; Seonhee,4,0,34,30
1656895288249,MATH 10B,B01,083739,Sinha; Shubham,9,0,30,21
1656895294273,MATH 18,A01,083743,Cinel; Cameron Alexander,6,0,30,24
1656895294273,MATH 18,A02,083744,Cinel; Cameron Alexander,15,0,30,15
1656895294273,MATH 18,A03,083745,Cinel; Cameron Alexander,8,0,30,22
1656895294273,MATH 18,B01,083748,Rideout; David Porter,4,0,37,33
1656895294273,MATH 18,B02,083749,Rideout; David Porter,3,0,36,33
1656895294273,MATH 18,B03,083750,Rideout; David Porter,2,0,37,35
1656895294273,MATH 18,B04,083751,Rideout; David Porter,5,0,36,31
1656895294273,MATH 18,B05,093473,Rideout; David Porter,4,0,36,32
1656895294273,MATH 18,B06,093474,Rideout; David Porter,5,0,36,31
1656895300298,MATH 20A,A01,083754,Zheng; Zequn,12,0,40,28
1656895306322,MATH 20B,A01,083756,Briones; Jor-el Thomas Caparas,1,0,36,35
1656895306322,MATH 20B,A02,083757,Briones; Jor-el Thomas Caparas,1,0,36,35
1656895306322,MATH 20B,A03,093475,Briones; Jor-el Thomas Caparas,0,0,36,36
1656895312354,MATH 20C,A01,083760,Briones; Jor-el Thomas Caparas,1,0,35,34
1656895312354,MATH 20C,A02,083761,Briones; Jor-el Thomas Caparas,8,0,35,27
1656895312354,MATH 20C,A03,093476,Briones; Jor-el Thomas Caparas,0,1,36,36
1656895312354,MATH 20C,B01,083762,Bach; Quang Tran,0,0,30,30
1656895318378,MATH 20D,A01,083765,Tran; Brian Kha,4,0,30,26
1656895318378,MATH 20D,A02,083766,Tran; Brian Kha,4,0,30,26
1656895318378,MATH 20D,A03,083767,Tran; Brian Kha,3,0,30,27
1656895324402,MATH 20E,A01,083771,Ganguly; Soumya,5,0,32,27
1656895324402,MATH 20E,A02,083772,Ganguly; Soumya,6,0,32,26
1656895324402,MATH 20E,B01,083773,Ciotti; Benjamin,18,0,35,17
1656895324402,MATH 20E,B02,083774,Ciotti; Benjamin,17,0,35,18
1656895330433,MATH 103A,A01,083777,Greenfeld; Be'Eri,2,0,36,34
1656895330433,MATH 103A,A02,083778,Greenfeld; Be'Eri,5,0,36,31
1656895330433,MATH 103A,A03,093561,Greenfeld; Be'Eri,4,0,36,32
1656895330433,MATH 103A,B01,083779,Greenfeld; Be'Eri,6,0,36,30
1656895330433,MATH 103A,B02,083780,Greenfeld; Be'Eri,2,0,36,34
1656895330433,MATH 103A,B03,093562,Greenfeld; Be'Eri,2,0,36,34
1656895336460,MATH 105,A01,085443,Carter; Anne Toulson,13,0,35,22
1656895336460,MATH 105,A02,093477,Carter; Anne Toulson,20,0,35,15
1656895342485,MATH 109,A01,083213,Ganzberger; Geoffrey Michael,2,0,34,32
1656895342485,MATH 109,A02,083214,Ganzberger; Geoffrey Michael,2,0,34,32
1656895342485,MATH 109,A03,093478,Ganzberger; Geoffrey Michael,1,0,34,33
1656895342485,MATH 109,B01,083215,Ganzberger; Geoffrey Michael,1,0,32,31
1656895342485,MATH 109,B02,083216,Ganzberger; Geoffrey Michael,1,0,32,31
1656895342485,MATH 109,B03,093479,Ganzberger; Geoffrey Michael,6,0,32,26
1656895348510,MATH 142A,A01,083219,Chow; Bennett,6,0,32,26
1656895348510,MATH 142A,A02,083220,Chow; Bennett,10,0,32,22
1656895348510,MATH 142A,A03,093480,Chow; Bennett,7,0,32,25
1656895348510,MATH 142A,B03,093481,Chow; Bennett,7,0,32,25
1656895348510,MATH 142A,B04,093558,Chow; Bennett,10,0,32,22
1656895348510,MATH 142A,B05,093559,Chow; Bennett,6,0,32,26
1656895354537,MATH 193A,A01,083224,Rotar; Vladimir,7,0,34,27
1656895354537,MATH 193A,A02,083225,Rotar; Vladimir,3,0,34,31
1656895354537,MATH 193A,A03,083781,Rotar; Vladimir,1,0,34,33
1656895354537,MATH 193A,A04,083782,Rotar; Vladimir,6,0,34,28
1656895354537,MATH 193A,A05,093482,Rotar; Vladimir,6,0,34,28
1656895360561,MATH 197,001,091859,McAuley; Julian John,9999,0,9999,0
1656895360561,MATH 197,002,095566,Kedlaya; Kiran S.,9997,0,9999,2
1656895360561,MATH 197,003,095567,Xiao; Ming,9999,0,9999,0
1656895360561,MATH 197,004,095571,Perols; Johan Lars,9998,0,9999,1
1656895367626,COGS 9,A01,083615,Shannon; Kyle Michael,6,0,75,69
1656895373648,COGS 11,A01,083617,Boyle; Mary E. T.,19,0,48,29
1656895379672,COGS 13,A01,083071,Bastos; Amalia Pinkusfeld,8,0,71,63
1656895385699,COGS 14A,A01,092681,Semenuks; Arturs,0,1,100,100
1656895391727,COGS 14B,A01,083073,Cheng; Tzu-Han,5,0,63,58
1656895397748,COGS 17,A01,092677,Semenuks; Arturs,4,0,81,77
1656895403773,COGS 100,A01,083619,Allen; Michael Gordon,15,0,70,55
1656895409796,COGS 101A,A01,083621,Davis; Joshua Daniel,9,0,68,59
1656895415822,COGS 101B,A01,091572,Allen; Michael Gordon,8,0,65,57
1656895421847,COGS 101C,A01,083625,Delgado; Tania,17,0,35,18
1656895427875,COGS 107A,A01,083627,Boyle; Mary E. T.,13,0,60,47
1656895433896,COGS 118A,A01,083075,Gupta; Anjum,15,0,76,61
1656895439923,CSE 3,A50,083646,Miranda; Gregory Joseph,22,0,50,28
1656895445947,CSE 8A,A50,083650,Miranda; Gregory Joseph,17,1,56,39
1656895451973,CSE 11,A01,083080,Cao; Yingjun,4,15,40,36
1656895458001,CSE 12,A01,083652,Krause-Levy; Sophia Louisa,20,1,120,100
1656895464025,CSE 15L,A01,083654,Morris; Justin Loren,8,0,50,42
1656895464025,CSE 15L,A02,083655,Morris; Justin Loren,8,0,50,42
1656895470053,CSE 20,A01,083657,Tran; Khoa Dang,37,0,80,43
1656895476076,CSE 21,A01,095574,Bach; Quang Tran,21,0,48,27
1656895482102,CSE 30,A01,083084,Eldon; John,4,0,80,76
1656895482102,CSE 30,B01,095061,Bhaskar; Nishant,6,0,50,44
1656895488128,CSE 100,A01,083659,Cao; Yingjun,2,4,70,68
1656895494152,CSE 134B,A01,083661,Powell; Thomas Allan,19,0,100,81
1656895500175,CSE 140,A01,083663,Gungor; Onat,14,0,85,71
1656895506198,CSE 140L,A01,083088,Eldon; John,16,0,100,84
1656895512228,CSE 175,A01,083665,Kumar; Rakesh,3,0,25,22
1656895518250,CSE 190,A00,092507,Dubnov; Shlomo,7,0,20,13
1656895524277,ECE 45,A01,083139,Congero; Spencer William,5,0,75,70
1656895530303,ECE 65,A50,083695,Saad; Andrew S,12,0,30,18
1656895530303,ECE 65,A51,095125,Saad; Andrew S,25,0,26,1
1656895536326,ECE 109,A01,091882,Touri; Behrouz,16,0,70,54
1656895542350,ECE 180,A00,083140,Abi Samra; Nicholas Camill,0,0,30,30
1656895542350,ECE 180,B00,083141,Abi Samra; Nicholas Camill,0,0,30,30
1656895548373,MATH 10A,A01,083735,Patchell; Gregory David,1,0,30,29
1656895548373,MATH 10A,A02,083736,Patchell; Gregory David,20,0,30,10
1656895548373,MATH 10A,A03,083737,Patchell; Gregory David,15,0,30,15
1656895554397,MATH 10B,A01,083207,Lim; Seonhee,7,0,34,27
1656895554397,MATH 10B,A02,083208,Lim; Seonhee,9,0,35,26
1656895554397,MATH 10B,A03,093472,Lim; Seonhee,4,0,34,30
1656895554397,MATH 10B,B01,083739,Sinha; Shubham,9,0,30,21
1656895560492,MATH 18,A01,083743,Cinel; Cameron Alexander,6,0,30,24
1656895560492,MATH 18,A02,083744,Cinel; Cameron Alexander,15,0,30,15
1656895560492,MATH 18,A03,083745,Cinel; Cameron Alexander,8,0,30,22
1656895560492,MATH 18,B01,083748,Rideout; David Porter,4,0,37,33
1656895560492,MATH 18,B02,083749,Rideout; David Porter,3,0,36,33
1656895560492,MATH 18,B03,083750,Rideout; David Porter,2,0,37,35
1656895560492,MATH 18,B04,083751,Rideout; David Porter,5,0,36,31
1656895560492,MATH 18,B05,093473,Rideout; David Porter,4,0,36,32
1656895560492,MATH 18,B06,093474,Rideout; David Porter,5,0,36,31
1656895566516,MATH 20A,A01,083754,Zheng; Zequn,12,0,40,28
1656895572540,MATH 20B,A01,083756,Briones; Jor-el Thomas Caparas,1,0,36,35
1656895572540,MATH 20B,A02,083757,Briones; Jor-el Thomas Caparas,1,0,36,35
1656895572540,MATH 20B,A03,093475,Briones; Jor-el Thomas Caparas,0,0,36,36
1656895578570,MATH 20C,A01,083760,Briones; Jor-el Thomas Caparas,1,0,35,34
1656895578570,MATH 20C,A02,083761,Briones; Jor-el Thomas Caparas,8,0,35,27
1656895578570,MATH 20C,A03,093476,Briones; Jor-el Thomas Caparas,0,1,36,36
1656895578570,MATH 20C,B01,083762,Bach; Quang Tran,0,0,30,30
1656895584599,MATH 20D,A01,083765,Tran; Brian Kha,4,0,30,26
1656895584599,MATH 20D,A02,083766,Tran; Brian Kha,4,0,30,26
1656895584599,MATH 20D,A03,083767,Tran; Brian Kha,3,0,30,27
1656895590625,MATH 20E,A01,083771,Ganguly; Soumya,5,0,32,27
1656895590625,MATH 20E,A02,083772,Ganguly; Soumya,6,0,32,26
1656895590625,MATH 20E,B01,083773,Ciotti; Benjamin,18,0,35,17
1656895590625,MATH 20E,B02,083774,Ciotti; Benjamin,17,0,35,18
1656895596648,MATH 103A,A01,083777,Greenfeld; Be'Eri,2,0,36,34
1656895596648,MATH 103A,A02,083778,Greenfeld; Be'Eri,5,0,36,31
1656895596648,MATH 103A,A03,093561,Greenfeld; Be'Eri,4,0,36,32
1656895596648,MATH 103A,B01,083779,Greenfeld; Be'Eri,6,0,36,30
1656895596648,MATH 103A,B02,083780,Greenfeld; Be'Eri,2,0,36,34
1656895596648,MATH 103A,B03,093562,Greenfeld; Be'Eri,2,0,36,34
1656895602685,MATH 105,A01,085443,Carter; Anne Toulson,13,0,35,22
1656895602685,MATH 105,A02,093477,Carter; Anne Toulson,20,0,35,15
1656895608709,MATH 109,A01,083213,Ganzberger; Geoffrey Michael,2,0,34,32
1656895608709,MATH 109,A02,083214,Ganzberger; Geoffrey Michael,2,0,34,32
1656895608709,MATH 109,A03,093478,Ganzberger; Geoffrey Michael,1,0,34,33
1656895608709,MATH 109,B01,083215,Ganzberger; Geoffrey Michael,1,0,32,31
1656895608709,MATH 109,B02,083216,Ganzberger; Geoffrey Michael,1,0,32,31
1656895608709,MATH 109,B03,093479,Ganzberger; Geoffrey Michael,6,0,32,26
1656895614730,MATH 142A,A01,083219,Chow; Bennett,6,0,32,26
1656895614730,MATH 142A,A02,083220,Chow; Bennett,10,0,32,22
1656895614730,MATH 142A,A03,093480,Chow; Bennett,7,0,32,25
1656895614730,MATH 142A,B03,093481,Chow; Bennett,7,0,32,25
1656895614730,MATH 142A,B04,093558,Chow; Bennett,10,0,32,22
1656895614730,MATH 142A,B05,093559,Chow; Bennett,6,0,32,26
1656895620754,MATH 193A,A01,083224,Rotar; Vladimir,7,0,34,27
1656895620754,MATH 193A,A02,083225,Rotar; Vladimir,3,0,34,31
1656895620754,MATH 193A,A03,083781,Rotar; Vladimir,1,0,34,33
1656895620754,MATH 193A,A04,083782,Rotar; Vladimir,6,0,34,28
1656895620754,MATH 193A,A05,093482,Rotar; Vladimir,6,0,34,28
1656895626776,MATH 197,001,091859,McAuley; Julian John,9999,0,9999,0
1656895626776,MATH 197,002,095566,Kedlaya; Kiran S.,9997,0,9999,2
1656895626776,MATH 197,003,095567,Xiao; Ming,9999,0,9999,0
1656895626776,MATH 197,004,095571,Perols; Johan Lars,9998,0,9999,1
1656895633844,COGS 9,A01,083615,Shannon; Kyle Michael,6,0,75,69
1656895639867,COGS 11,A01,083617,Boyle; Mary E. T.,19,0,48,29
1656895645891,COGS 13,A01,083071,Bastos; Amalia Pinkusfeld,8,0,71,63
1656895651915,COGS 14A,A01,092681,Semenuks; Arturs,0,1,100,100
1656895657941,COGS 14B,A01,083073,Cheng; Tzu-Han,5,0,63,58
1656895663963,COGS 17,A01,092677,Semenuks; Arturs,4,0,81,77
1656895669989,COGS 100,A01,083619,Allen; Michael Gordon,15,0,70,55
1656895676013,COGS 101A,A01,083621,Davis; Joshua Daniel,9,0,68,59
1656895682036,COGS 101B,A01,091572,Allen; Michael Gordon,8,0,65,57
1656895688063,COGS 101C,A01,083625,Delgado; Tania,17,0,35,18
1656895694092,COGS 107A,A01,083627,Boyle; Mary E. T.,13,0,60,47
1656895700115,COGS 118A,A01,083075,Gupta; Anjum,15,0,76,61
1656895706142,CSE 3,A50,083646,Miranda; Gregory Joseph,22,0,50,28
1656895712167,CSE 8A,A50,083650,Miranda; Gregory Joseph,17,1,56,39
1656895718191,CSE 11,A01,083080,Cao; Yingjun,4,15,40,36
1656895724212,CSE 12,A01,083652,Krause-Levy; Sophia Louisa,20,1,120,100
1656895730235,CSE 15L,A01,083654,Morris; Justin Loren,8,0,50,42
1656895730235,CSE 15L,A02,083655,Morris; Justin Loren,8,0,50,42
1656895736261,CSE 20,A01,083657,Tran; Khoa Dang,37,0,80,43
1656895742284,CSE 21,A01,095574,Bach; Quang Tran,21,0,48,27
1656895748308,CSE 30,A01,083084,Eldon; John,4,0,80,76
1656895748308,CSE 30,B01,095061,Bhaskar; Nishant,6,0,50,44
1656895754338,CSE 100,A01,083659,Cao; Yingjun,2,4,70,68
1656895760360,CSE 134B,A01,083661,Powell; Thomas Allan,19,0,100,81
1656895766392,CSE 140,A01,083663,Gungor; Onat,14,0,85,71
1656895772415,CSE 140L,A01,083088,Eldon; John,16,0,100,84
1656895778445,CSE 175,A01,083665,Kumar; Rakesh,3,0,25,22
1656895784471,CSE 190,A00,092507,Dubnov; Shlomo,7,0,20,13
1656895790493,ECE 45,A01,083139,Congero; Spencer William,5,0,75,70
1656895796518,ECE 65,A50,083695,Saad; Andrew S,12,0,30,18
1656895796518,ECE 65,A51,095125,Saad; Andrew S,25,0,26,1
1656895802542,ECE 109,A01,091882,Touri; Behrouz,16,0,70,54
1656895808564,ECE 180,A00,083140,Abi Samra; Nicholas Camill,0,0,30,30
1656895808564,ECE 180,B00,083141,Abi Samra; Nicholas Camill,0,0,30,30
1656895814592,MATH 10A,A01,083735,Patchell; Gregory David,1,0,30,29
1656895814592,MATH 10A,A02,083736,Patchell; Gregory David,20,0,30,10
1656895814592,MATH 10A,A03,083737,Patchell; Gregory David,15,0,30,15
1656895820622,MATH 10B,A01,083207,Lim; Seonhee,7,0,34,27
1656895820622,MATH 10B,A02,083208,Lim; Seonhee,9,0,35,26
1656895820622,MATH 10B,A03,093472,Lim; Seonhee,4,0,34,30
1656895820622,MATH 10B,B01,083739,Sinha; Shubham,9,0,30,21
1656895826654,MATH 18,A01,083743,Cinel; Cameron Alexander,6,0,30,24
1656895826654,MATH 18,A02,083744,Cinel; Cameron Alexander,15,0,30,15
1656895826654,MATH 18,A03,083745,Cinel; Cameron Alexander,8,0,30,22
1656895826654,MATH 18,B01,083748,Rideout; David Porter,4,0,37,33
1656895826654,MATH 18,B02,083749,Rideout; David Porter,3,0,36,33
1656895826654,MATH 18,B03,083750,Rideout; David Porter,2,0,37,35
1656895826654,MATH 18,B04,083751,Rideout; David Porter,5,0,36,31
1656895826654,MATH 18,B05,093473,Rideout; David Porter,4,0,36,32
1656895826654,MATH 18,B06,093474,Rideout; David Porter,5,0,36,31
1656895832676,MATH 20A,A01,083754,Zheng; Zequn,12,0,40,28
1656895838705,MATH 20B,A01,083756,Briones; Jor-el Thomas Caparas,1,0,36,35
1656895838705,MATH 20B,A02,083757,Briones; Jor-el Thomas Caparas,1,0,36,35
1656895838705,MATH 20B,A03,093475,Briones; Jor-el Thomas Caparas,0,0,36,36
1656895844733,MATH 20C,A01,083760,Briones; Jor-el Thomas Caparas,1,0,35,34
1656895844733,MATH 20C,A02,083761,Briones; Jor-el Thomas Caparas,8,0,35,27
1656895844733,MATH 20C,A03,093476,Briones; Jor-el Thomas Caparas,0,1,36,36
1656895844733,MATH 20C,B01,083762,Bach; Quang Tran,0,0,30,30
1656895850762,MATH 20D,A01,083765,Tran; Brian Kha,4,0,30,26
1656895850762,MATH 20D,A02,083766,Tran; Brian Kha,4,0,30,26
1656895850762,MATH 20D,A03,083767,Tran; Brian Kha,3,0,30,27
1656895856791,MATH 20E,A01,083771,Ganguly; Soumya,5,0,32,27
1656895856791,MATH 20E,A02,083772,Ganguly; Soumya,6,0,32,26
1656895856791,MATH 20E,B01,083773,Ciotti; Benjamin,18,0,35,17
1656895856791,MATH 20E,B02,083774,Ciotti; Benjamin,17,0,35,18
1656895862816,MATH 103A,A01,083777,Greenfeld; Be'Eri,2,0,36,34
1656895862816,MATH 103A,A02,083778,Greenfeld; Be'Eri,5,0,36,31
1656895862816,MATH 103A,A03,093561,Greenfeld; Be'Eri,4,0,36,32
1656895862816,MATH 103A,B01,083779,Greenfeld; Be'Eri,6,0,36,30
1656895862816,MATH 103A,B02,083780,Greenfeld; Be'Eri,2,0,36,34
1656895862816,MATH 103A,B03,093562,Greenfeld; Be'Eri,2,0,36,34
1656895868846,MATH 105,A01,085443,Carter; Anne Toulson,13,0,35,22
1656895868846,MATH 105,A02,093477,Carter; Anne Toulson,20,0,35,15
1656895874874,MATH 109,A01,083213,Ganzberger; Geoffrey Michael,2,0,34,32
1656895874874,MATH 109,A02,083214,Ganzberger; Geoffrey Michael,2,0,34,32
1656895874874,MATH 109,A03,093478,Ganzberger; Geoffrey Michael,1,0,34,33
1656895874874,MATH 109,B01,083215,Ganzberger; Geoffrey Michael,1,0,32,31
1656895874874,MATH 109,B02,083216,Ganzberger; Geoffrey Michael,1,0,32,31
1656895874874,MATH 109,B03,093479,Ganzberger; Geoffrey Michael,6,0,32,26
1656895880904,MATH 142A,A01,083219,Chow; Bennett,6,0,32,26
1656895880904,MATH 142A,A02,083220,Chow; Bennett,10,0,32,22
1656895880904,MATH 142A,A03,093480,Chow; Bennett,7,0,32,25
1656895880904,MATH 142A,B03,093481,Chow; Bennett,7,0,32,25
1656895880904,MATH 142A,B04,093558,Chow; Bennett,10,0,32,22
1656895880904,MATH 142A,B05,093559,Chow; Bennett,6,0,32,26
1656895886934,MATH 193A,A01,083224,Rotar; Vladimir,7,0,34,27
1656895886934,MATH 193A,A02,083225,Rotar; Vladimir,3,0,34,31
1656895886934,MATH 193A,A03,083781,Rotar; Vladimir,1,0,34,33
1656895886934,MATH 193A,A04,083782,Rotar; Vladimir,6,0,34,28
1656895886934,MATH 193A,A05,093482,Rotar; Vladimir,6,0,34,28
1656895892956,MATH 197,001,091859,McAuley; Julian John,9999,0,9999,0
1656895892956,MATH 197,002,095566,Kedlaya; Kiran S.,9997,0,9999,2
1656895892956,MATH 197,003,095567,Xiao; Ming,9999,0,9999,0
1656895892956,MATH 197,004,095571,Perols; Johan Lars,9998,0,9999,1
1656895900012,COGS 9,A01,083615,Shannon; Kyle Michael,6,0,75,69
1656895906038,COGS 11,A01,083617,Boyle; Mary E. T.,19,0,48,29
1656895912061,COGS 13,A01,083071,Bastos; Amalia Pinkusfeld,8,0,71,63
1656895918085,COGS 14A,A01,092681,Semenuks; Arturs,0,1,100,100
1656895924108,COGS 14B,A01,083073,Cheng; Tzu-Han,5,0,63,58
1656895930135,COGS 17,A01,092677,Semenuks; Arturs,4,0,81,77
1656895936157,COGS 100,A01,083619,Allen; Michael Gordon,15,0,70,55
1656895942179,COGS 101A,A01,083621,Davis; Joshua Daniel,9,0,68,59
1656895948203,COGS 101B,A01,091572,Allen; Michael Gordon,8,0,65,57
1656895954231,COGS 101C,A01,083625,Delgado; Tania,17,0,35,18
1656895960252,COGS 107A,A01,083627,Boyle; Mary E. T.,13,0,60,47
1656895966277,COGS 118A,A01,083075,Gupta; Anjum,15,0,76,61
1656895972303,CSE 3,A50,083646,Miranda; Gregory Joseph,22,0,50,28
1656895978327,CSE 8A,A50,083650,Miranda; Gregory Joseph,17,1,56,39
1656895984354,CSE 11,A01,083080,Cao; Yingjun,4,15,40,36
1656895990380,CSE 12,A01,083652,Krause-Levy; Sophia Louisa,20,1,120,100
1656895996406,CSE 15L,A01,083654,Morris; Justin Loren,8,0,50,42
1656895996406,CSE 15L,A02,083655,Morris; Justin Loren,8,0,50,42
1656896002433,CSE 20,A01,083657,Tran; Khoa Dang,37,0,80,43
1656896008458,CSE 21,A01,095574,Bach; Quang Tran,21,0,48,27
1656896014494,CSE 30,A01,083084,Eldon; John,4,0,80,76
1656896014494,CSE 30,B01,095061,Bhaskar; Nishant,6,0,50,44
1656896020518,CSE 100,A01,083659,Cao; Yingjun,2,4,70,68
1656896026545,CSE 134B,A01,083661,Powell; Thomas Allan,19,0,100,81
1656896032575,CSE 140,A01,083663,Gungor; Onat,14,0,85,71
1656896038600,CSE 140L,A01,083088,Eldon; John,16,0,100,84
1656896044627,CSE 175,A01,083665,Kumar; Rakesh,3,0,25,22
1656896050650,CSE 190,A00,092507,Dubnov; Shlomo,7,0,20,13
1656896056676,ECE 45,A01,083139,Congero; Spencer William,5,0,75,70
1656896062702,ECE 65,A50,083695,Saad; Andrew S,12,0,30,18
1656896062702,ECE 65,A51,095125,Saad; Andrew S,25,0,26,1
1656896068723,ECE 109,A01,091882,Touri; Behrouz,16,0,70,54
1656896074751,ECE 180,A00,083140,Abi Samra; Nicholas Camill,0,0,30,30
1656896074751,ECE 180,B00,083141,Abi Samra; Nicholas Camill,0,0,30,30
1656896080772,MATH 10A,A01,083735,Patchell; Gregory David,1,0,30,29
1656896080772,MATH 10A,A02,083736,Patchell; Gregory David,20,0,30,10
1656896080772,MATH 10A,A03,083737,Patchell; Gregory David,15,0,30,15
1656896086803,MATH 10B,A01,083207,Lim; Seonhee,7,0,34,27
1656896086803,MATH 10B,A02,083208,Lim; Seonhee,9,0,35,26
1656896086803,MATH 10B,A03,093472,Lim; Seonhee,4,0,34,30
1656896086803,MATH 10B,B01,083739,Sinha; Shubham,9,0,30,21
1656896092835,MATH 18,A01,083743,Cinel; Cameron Alexander,6,0,30,24
1656896092835,MATH 18,A02,083744,Cinel; Cameron Alexander,15,0,30,15
1656896092835,MATH 18,A03,083745,Cinel; Cameron Alexander,8,0,30,22
1656896092835,MATH 18,B01,083748,Rideout; David Porter,4,0,37,33
1656896092835,MATH 18,B02,083749,Rideout; David Porter,3,0,36,33
1656896092835,MATH 18,B03,083750,Rideout; David Porter,2,0,37,35
1656896092835,MATH 18,B04,083751,Rideout; David Porter,5,0,36,31
1656896092835,MATH 18,B05,093473,Rideout; David Porter,4,0,36,32
1656896092835,MATH 18,B06,093474,Rideout; David Porter,5,0,36,31
1656896098861,MATH 20A,A01,083754,Zheng; Zequn,12,0,40,28
1656896104882,MATH 20B,A01,083756,Briones; Jor-el Thomas Caparas,1,0,36,35
1656896104882,MATH 20B,A02,083757,Briones; Jor-el Thomas Caparas,1,0,36,35
1656896104882,MATH 20B,A03,093475,Briones; Jor-el Thomas Caparas,0,0,36,36
1656896110906,MATH 20C,A01,083760,Briones; Jor-el Thomas Caparas,1,0,35,34
1656896110906,MATH 20C,A02,083761,Briones; Jor-el Thomas Caparas,8,0,35,27
1656896110906,MATH 20C,A03,093476,Briones; Jor-el Thomas Caparas,0,1,36,36
1656896110906,MATH 20C,B01,083762,Bach; Quang Tran,0,0,30,30
1656896116930,MATH 20D,A01,083765,Tran; Brian Kha,4,0,30,26
1656896116930,MATH 20D,A02,083766,Tran; Brian Kha,4,0,30,26
1656896116930,MATH 20D,A03,083767,Tran; Brian Kha,3,0,30,27
1656896122954,MATH 20E,A01,083771,Ganguly; Soumya,5,0,32,27
1656896122954,MATH 20E,A02,083772,Ganguly; Soumya,6,0,32,26
1656896122954,MATH 20E,B01,083773,Ciotti; Benjamin,18,0,35,17
1656896122954,MATH 20E,B02,083774,Ciotti; Benjamin,17,0,35,18
1656896128979,MATH 103A,A01,083777,Greenfeld; Be'Eri,2,0,36,34
1656896128979,MATH 103A,A02,083778,Greenfeld; Be'Eri,5,0,36,31
1656896128979,MATH 103A,A03,093561,Greenfeld; Be'Eri,4,0,36,32
1656896128979,MATH 103A,B01,083779,Greenfeld; Be'Eri,6,0,36,30
1656896128979,MATH 103A,B02,083780,Greenfeld; Be'Eri,2,0,36,34
1656896128979,MATH 103A,B03,093562,Greenfeld; Be'Eri,2,0,36,34
1656896135005,MATH 105,A01,085443,Carter; Anne Toulson,13,0,35,22
1656896135005,MATH 105,A02,093477,Carter; Anne Toulson,20,0,35,15
1656896141031,MATH 109,A01,083213,Ganzberger; Geoffrey Michael,2,0,34,32
1656896141031,MATH 109,A02,083214,Ganzberger; Geoffrey Michael,2,0,34,32
1656896141031,MATH 109,A03,093478,Ganzberger; Geoffrey Michael,1,0,34,33
1656896141031,MATH 109,B01,083215,Ganzberger; Geoffrey Michael,1,0,32,31
1656896141031,MATH 109,B02,083216,Ganzberger; Geoffrey Michael,1,0,32,31
1656896141031,MATH 109,B03,093479,Ganzberger; Geoffrey Michael,6,0,32,26
1656896147060,MATH 142A,A01,083219,Chow; Bennett,6,0,32,26
1656896147060,MATH 142A,A02,083220,Chow; Bennett,10,0,32,22
1656896147060,MATH 142A,A03,093480,Chow; Bennett,7,0,32,25
1656896147060,MATH 142A,B03,093481,Chow; Bennett,7,0,32,25
1656896147060,MATH 142A,B04,093558,Chow; Bennett,10,0,32,22
1656896147060,MATH 142A,B05,093559,Chow; Bennett,6,0,32,26
1656896153089,MATH 193A,A01,083224,Rotar; Vladimir,7,0,34,27
1656896153089,MATH 193A,A02,083225,Rotar; Vladimir,3,0,34,31
1656896153089,MATH 193A,A03,083781,Rotar; Vladimir,1,0,34,33
1656896153089,MATH 193A,A04,083782,Rotar; Vladimir,6,0,34,28
1656896153089,MATH 193A,A05,093482,Rotar; Vladimir,6,0,34,28
1656896159193,MATH 197,001,091859,McAuley; Julian John,9999,0,9999,0
1656896159193,MATH 197,002,095566,Kedlaya; Kiran S.,9997,0,9999,2
1656896159193,MATH 197,003,095567,Xiao; Ming,9999,0,9999,0
1656896159193,MATH 197,004,095571,Perols; Johan Lars,9998,0,9999,1
1656896166255,COGS 9,A01,083615,Shannon; Kyle Michael,6,0,75,69
1656896172278,COGS 11,A01,083617,Boyle; Mary E. T.,19,0,48,29
1656896178304,COGS 13,A01,083071,Bastos; Amalia Pinkusfeld,8,0,71,63
1656896184331,COGS 14A,A01,092681,Semenuks; Arturs,0,1,100,100
1656896190353,COGS 14B,A01,083073,Cheng; Tzu-Han,5,0,63,58
1656896196379,COGS 17,A01,092677,Semenuks; Arturs,4,0,81,77
1656896202402,COGS 100,A01,083619,Allen; Michael Gordon,15,0,70,55
1656896208426,COGS 101A,A01,083621,Davis; Joshua Daniel,9,0,68,59
1656896214448,COGS 101B,A01,091572,Allen; Michael Gordon,8,0,65,57
1656896220471,COGS 101C,A01,083625,Delgado; Tania,17,0,35,18
1656896226498,COGS 107A,A01,083627,Boyle; Mary E. T.,13,0,60,47
1656896232522,COGS 118A,A01,083075,Gupta; Anjum,15,0,76,61
1656896238543,CSE 3,A50,083646,Miranda; Gregory Joseph,22,0,50,28
1656896244570,CSE 8A,A50,083650,Miranda; Gregory Joseph,17,1,56,39
1656896250597,CSE 11,A01,083080,Cao; Yingjun,4,15,40,36
1656896256624,CSE 12,A01,083652,Krause-Levy; Sophia Louisa,20,1,120,100
1656896262653,CSE 15L,A01,083654,Morris; Justin Loren,8,0,50,42
1656896262653,CSE 15L,A02,083655,Morris; Justin Loren,8,0,50,42
1656896268675,CSE 20,A01,083657,Tran; Khoa Dang,37,0,80,43
1656896274702,CSE 21,A01,095574,Bach; Quang Tran,21,0,48,27
1656896280724,CSE 30,A01,083084,Eldon; John,4,0,80,76
1656896280724,CSE 30,B01,095061,Bhaskar; Nishant,6,0,50,44
1656896286750,CSE 100,A01,083659,Cao; Yingjun,2,4,70,68
1656896292773,CSE 134B,A01,083661,Powell; Thomas Allan,19,0,100,81
1656896298798,CSE 140,A01,083663,Gungor; Onat,14,0,85,71
1656896304819,CSE 140L,A01,083088,Eldon; John,16,0,100,84
1656896310842,CSE 175,A01,083665,Kumar; Rakesh,3,0,25,22
1656896316865,CSE 190,A00,092507,Dubnov; Shlomo,7,0,20,13
1656896322889,ECE 45,A01,083139,Congero; Spencer William,5,0,75,70
1656896328920,ECE 65,A50,083695,Saad; Andrew S,12,0,30,18
1656896328920,ECE 65,A51,095125,Saad; Andrew S,25,0,26,1
1656896334946,ECE 109,A01,091882,Touri; Behrouz,16,0,70,54
1656896340970,ECE 180,A00,083140,Abi Samra; Nicholas Camill,0,0,30,30
1656896340970,ECE 180,B00,083141,Abi Samra; Nicholas Camill,0,0,30,30
1656896346997,MATH 10A,A01,083735,Patchell; Gregory David,1,0,30,29
1656896346997,MATH 10A,A02,083736,Patchell; Gregory David,20,0,30,10
1656896346997,MATH 10A,A03,083737,Patchell; Gregory David,15,0,30,15
1656896353019,MATH 10B,A01,083207,Lim; Seonhee,7,0,34,27
1656896353019,MATH 10B,A02,083208,Lim; Seonhee,9,0,35,26
1656896353019,MATH 10B,A03,093472,Lim; Seonhee,4,0,34,30
1656896353019,MATH 10B,B01,083739,Sinha; Shubham,9,0,30,21
1656896359054,MATH 18,A01,083743,Cinel; Cameron Alexander,6,0,30,24
1656896359054,MATH 18,A02,083744,Cinel; Cameron Alexander,15,0,30,15
1656896359054,MATH 18,A03,083745,Cinel; Cameron Alexander,8,0,30,22
1656896359054,MATH 18,B01,083748,Rideout; David Porter,4,0,37,33
1656896359054,MATH 18,B02,083749,Rideout; David Porter,3,0,36,33
1656896359054,MATH 18,B03,083750,Rideout; David Porter,2,0,37,35
1656896359054,MATH 18,B04,083751,Rideout; David Porter,5,0,36,31
1656896359054,MATH 18,B05,093473,Rideout; David Porter,4,0,36,32
1656896359054,MATH 18,B06,093474,Rideout; David Porter,5,0,36,31
1656896365078,MATH 20A,A01,083754,Zheng; Zequn,12,0,40,28
1656896371105,MATH 20B,A01,083756,Briones; Jor-el Thomas Caparas,1,0,36,35
1656896371105,MATH 20B,A02,083757,Briones; Jor-el Thomas Caparas,1,0,36,35
1656896371105,MATH 20B,A03,093475,Briones; Jor-el Thomas Caparas,0,0,36,36
1656896377129,MATH 20C,A01,083760,Briones; Jor-el Thomas Caparas,1,0,35,34
1656896377129,MATH 20C,A02,083761,Briones; Jor-el Thomas Caparas,8,0,35,27
1656896377129,MATH 20C,A03,093476,Briones; Jor-el Thomas Caparas,0,1,36,36
1656896377129,MATH 20C,B01,083762,Bach; Quang Tran,0,0,30,30
1656896383157,MATH 20D,A01,083765,Tran; Brian Kha,4,0,30,26
1656896383157,MATH 20D,A02,083766,Tran; Brian Kha,4,0,30,26
1656896383157,MATH 20D,A03,083767,Tran; Brian Kha,3,0,30,27
1656896389181,MATH 20E,A01,083771,Ganguly; Soumya,5,0,32,27
1656896389181,MATH 20E,A02,083772,Ganguly; Soumya,6,0,32,26
1656896389181,MATH 20E,B01,083773,Ciotti; Benjamin,18,0,35,17
1656896389181,MATH 20E,B02,083774,Ciotti; Benjamin,17,0,35,18
1656896395208,MATH 103A,A01,083777,Greenfeld; Be'Eri,2,0,36,34
1656896395208,MATH 103A,A02,083778,Greenfeld; Be'Eri,5,0,36,31
1656896395208,MATH 103A,A03,093561,Greenfeld; Be'Eri,4,0,36,32
1656896395208,MATH 103A,B01,083779,Greenfeld; Be'Eri,6,0,36,30
1656896395208,MATH 103A,B02,083780,Greenfeld; Be'Eri,2,0,36,34
1656896395208,MATH 103A,B03,093562,Greenfeld; Be'Eri,2,0,36,34
1656896401238,MATH 105,A01,085443,Carter; Anne Toulson,13,0,35,22
1656896401238,MATH 105,A02,093477,Carter; Anne Toulson,20,0,35,15
1656896407261,MATH 109,A01,083213,Ganzberger; Geoffrey Michael,2,0,34,32
1656896407261,MATH 109,A02,083214,Ganzberger; Geoffrey Michael,2,0,34,32
1656896407261,MATH 109,A03,093478,Ganzberger; Geoffrey Michael,1,0,34,33
1656896407261,MATH 109,B01,083215,Ganzberger; Geoffrey Michael,1,0,32,31
1656896407261,MATH 109,B02,083216,Ganzberger; Geoffrey Michael,1,0,32,31
1656896407261,MATH 109,B03,093479,Ganzberger; Geoffrey Michael,6,0,32,26
1656896413289,MATH 142A,A01,083219,Chow; Bennett,6,0,32,26
1656896413289,MATH 142A,A02,083220,Chow; Bennett,10,0,32,22
1656896413289,MATH 142A,A03,093480,Chow; Bennett,7,0,32,25
1656896413289,MATH 142A,B03,093481,Chow; Bennett,7,0,32,25
1656896413289,MATH 142A,B04,093558,Chow; Bennett,10,0,32,22
1656896413289,MATH 142A,B05,093559,Chow; Bennett,6,0,32,26
1656896419315,MATH 193A,A01,083224,Rotar; Vladimir,7,0,34,27
1656896419315,MATH 193A,A02,083225,Rotar; Vladimir,3,0,34,31
1656896419315,MATH 193A,A03,083781,Rotar; Vladimir,1,0,34,33
1656896419315,MATH 193A,A04,083782,Rotar; Vladimir,6,0,34,28
1656896419315,MATH 193A,A05,093482,Rotar; Vladimir,6,0,34,28
1656896425338,MATH 197,001,091859,McAuley; Julian John,9999,0,9999,0
1656896425338,MATH 197,002,095566,Kedlaya; Kiran S.,9997,0,9999,2
1656896425338,MATH 197,003,095567,Xiao; Ming,9999,0,9999,0
1656896425338,MATH 197,004,095571,Perols; Johan Lars,9998,0,9999,1
1656896432393,COGS 9,A01,083615,Shannon; Kyle Michael,6,0,75,69
1656896438420,COGS 11,A01,083617,Boyle; Mary E. T.,19,0,48,29
1656896444446,COGS 13,A01,083071,Bastos; Amalia Pinkusfeld,8,0,71,63
1656896450473,COGS 14A,A01,092681,Semenuks; Arturs,0,1,100,100
1656896456500,COGS 14B,A01,083073,Cheng; Tzu-Han,5,0,63,58
1656896462524,COGS 17,A01,092677,Semenuks; Arturs,4,0,81,77
1656896468551,COGS 100,A01,083619,Allen; Michael Gordon,15,0,70,55
1656896474583,COGS 101A,A01,083621,Davis; Joshua Daniel,9,0,68,59
1656896480608,COGS 101B,A01,091572,Allen; Michael Gordon,8,0,65,57
1656896486635,COGS 101C,A01,083625,Delgado; Tania,17,0,35,18
1656896492657,COGS 107A,A01,083627,Boyle; Mary E. T.,13,0,60,47
1656896498689,COGS 118A,A01,083075,Gupta; Anjum,15,0,76,61
1656896504717,CSE 3,A50,083646,Miranda; Gregory Joseph,22,0,50,28
1656896510811,CSE 8A,A50,083650,Miranda; Gregory Joseph,17,1,56,39
1656896516833,CSE 11,A01,083080,Cao; Yingjun,4,15,40,36
1656896522857,CSE 12,A01,083652,Krause-Levy; Sophia Louisa,20,1,120,100
1656896528885,CSE 15L,A01,083654,Morris; Justin Loren,8,0,50,42
1656896528885,CSE 15L,A02,083655,Morris; Justin Loren,8,0,50,42
1656896534909,CSE 20,A01,083657,Tran; Khoa Dang,37,0,80,43
1656896540936,CSE 21,A01,095574,Bach; Quang Tran,21,0,48,27
1656896546961,CSE 30,A01,083084,Eldon; John,4,0,80,76
1656896546961,CSE 30,B01,095061,Bhaskar; Nishant,6,0,50,44
1656896552985,CSE 100,A01,083659,Cao; Yingjun,2,4,70,68
1656896559008,CSE 134B,A01,083661,Powell; Thomas Allan,19,0,100,81
1656896565035,CSE 140,A01,083663,Gungor; Onat,14,0,85,71
1656896571063,CSE 140L,A01,083088,Eldon; John,16,0,100,84
1656896577090,CSE 175,A01,083665,Kumar; Rakesh,3,0,25,22
1656896583113,CSE 190,A00,092507,Dubnov; Shlomo,7,0,20,13
1656896589140,ECE 45,A01,083139,Congero; Spencer William,5,0,75,70
1656896595171,ECE 65,A50,083695,Saad; Andrew S,12,0,30,18
1656896595171,ECE 65,A51,095125,Saad; Andrew S,25,0,26,1
1656896601204,ECE 109,A01,091882,Touri; Behrouz,16,0,70,54
1656896607228,ECE 180,A00,083140,Abi Samra; Nicholas Camill,0,0,30,30
1656896607228,ECE 180,B00,083141,Abi Samra; Nicholas Camill,0,0,30,30
1656896613252,MATH 10A,A01,083735,Patchell; Gregory David,1,0,30,29
1656896613252,MATH 10A,A02,083736,Patchell; Gregory David,20,0,30,10
1656896613252,MATH 10A,A03,083737,Patchell; Gregory David,15,0,30,15
1656896619281,MATH 10B,A01,083207,Lim; Seonhee,7,0,34,27
1656896619281,MATH 10B,A02,083208,Lim; Seonhee,9,0,35,26
1656896619281,MATH 10B,A03,093472,Lim; Seonhee,4,0,34,30
1656896619281,MATH 10B,B01,083739,Sinha; Shubham,9,0,30,21
1656896625306,MATH 18,A01,083743,Cinel; Cameron Alexander,6,0,30,24
1656896625306,MATH 18,A02,083744,Cinel; Cameron Alexander,15,0,30,15
1656896625306,MATH 18,A03,083745,Cinel; Cameron Alexander,8,0,30,22
1656896625306,MATH 18,B01,083748,Rideout; David Porter,4,0,37,33
1656896625306,MATH 18,B02,083749,Rideout; David Porter,3,0,36,33
1656896625306,MATH 18,B03,083750,Rideout; David Porter,2,0,37,35
1656896625306,MATH 18,B04,083751,Rideout; David Porter,5,0,36,31
1656896625306,MATH 18,B05,093473,Rideout; David Porter,4,0,36,32
1656896625306,MATH 18,B06,093474,Rideout; David Porter,5,0,36,31
1656896631335,MATH 20A,A01,083754,Zheng; Zequn,12,0,40,28
1656896637363,MATH 20B,A01,083756,Briones; Jor-el Thomas Caparas,1,0,36,35
1656896637363,MATH 20B,A02,083757,Briones; Jor-el Thomas Caparas,1,0,36,35
1656896637363,MATH 20B,A03,093475,Briones; Jor-el Thomas Caparas,0,0,36,36
1656896643392,MATH 20C,A01,083760,Briones; Jor-el Thomas Caparas,1,0,35,34
1656896643392,MATH 20C,A02,083761,Briones; Jor-el Thomas Caparas,8,0,35,27
1656896643392,MATH 20C,A03,093476,Briones; Jor-el Thomas Caparas,0,1,36,36
1656896643392,MATH 20C,B01,083762,Bach; Quang Tran,0,0,30,30
1656896649416,MATH 20D,A01,083765,Tran; Brian Kha,4,0,30,26
1656896649416,MATH 20D,A02,083766,Tran; Brian Kha,4,0,30,26
1656896649416,MATH 20D,A03,083767,Tran; Brian Kha,3,0,30,27
1656896655441,MATH 20E,A01,083771,Ganguly; Soumya,5,0,32,27
1656896655441,MATH 20E,A02,083772,Ganguly; Soumya,6,0,32,26
1656896655441,MATH 20E,B01,083773,Ciotti; Benjamin,18,0,35,17
1656896655441,MATH 20E,B02,083774,Ciotti; Benjamin,17,0,35,18
1656896661463,MATH 103A,A01,083777,Greenfeld; Be'Eri,2,0,36,34
1656896661463,MATH 103A,A02,083778,Greenfeld; Be'Eri,5,0,36,31
1656896661463,MATH 103A,A03,093561,Greenfeld; Be'Eri,4,0,36,32
1656896661463,MATH 103A,B01,083779,Greenfeld; Be'Eri,6,0,36,30
1656896661463,MATH 103A,B02,083780,Greenfeld; Be'Eri,2,0,36,34
1656896661463,MATH 103A,B03,093562,Greenfeld; Be'Eri,2,0,36,34
1656896667492,MATH 105,A01,085443,Carter; Anne Toulson,13,0,35,22
1656896667492,MATH 105,A02,093477,Carter; Anne Toulson,20,0,35,15
1656896673514,MATH 109,A01,083213,Ganzberger; Geoffrey Michael,2,0,34,32
1656896673514,MATH 109,A02,083214,Ganzberger; Geoffrey Michael,2,0,34,32
1656896673514,MATH 109,A03,093478,Ganzberger; Geoffrey Michael,1,0,34,33
1656896673514,MATH 109,B01,083215,Ganzberger; Geoffrey Michael,1,0,32,31
1656896673514,MATH 109,B02,083216,Ganzberger; Geoffrey Michael,1,0,32,31
1656896673514,MATH 109,B03,093479,Ganzberger; Geoffrey Michael,6,0,32,26
1656896679553,MATH 142A,A01,083219,Chow; Bennett,6,0,32,26
1656896679553,MATH 142A,A02,083220,Chow; Bennett,10,0,32,22
1656896679553,MATH 142A,A03,093480,Chow; Bennett,7,0,32,25
1656896679553,MATH 142A,B03,093481,Chow; Bennett,7,0,32,25
1656896679553,MATH 142A,B04,093558,Chow; Bennett,10,0,32,22
1656896679553,MATH 142A,B05,093559,Chow; Bennett,6,0,32,26
1656896685583,MATH 193A,A01,083224,Rotar; Vladimir,7,0,34,27
1656896685583,MATH 193A,A02,083225,Rotar; Vladimir,3,0,34,31
1656896685583,MATH 193A,A03,083781,Rotar; Vladimir,1,0,34,33
1656896685583,MATH 193A,A04,083782,Rotar; Vladimir,6,0,34,28
1656896685583,MATH 193A,A05,093482,Rotar; Vladimir,6,0,34,28
1656896691606,MATH 197,001,091859,McAuley; Julian John,9999,0,9999,0
1656896691606,MATH 197,002,095566,Kedlaya; Kiran S.,9997,0,9999,2
1656896691606,MATH 197,003,095567,Xiao; Ming,9999,0,9999,0
1656896691606,MATH 197,004,095571,Perols; Johan Lars,9998,0,9999,1
1656896698670,COGS 9,A01,083615,Shannon; Kyle Michael,6,0,75,69
1656896704698,COGS 11,A01,083617,Boyle; Mary E. T.,19,0,48,29
1656896710723,COGS 13,A01,083071,Bastos; Amalia Pinkusfeld,8,0,71,63
1656896716748,COGS 14A,A01,092681,Semenuks; Arturs,0,1,100,100
1656896722774,COGS 14B,A01,083073,Cheng; Tzu-Han,5,0,63,58
1656896728798,COGS 17,A01,092677,Semenuks; Arturs,4,0,81,77
1656896734821,COGS 100,A01,083619,Allen; Michael Gordon,15,0,70,55
1656896740844,COGS 101A,A01,083621,Davis; Joshua Daniel,9,0,68,59
1656896746867,COGS 101B,A01,091572,Allen; Michael Gordon,8,0,65,57
1656896752968,COGS 101C,A01,083625,Delgado; Tania,17,0,35,18
1656896758999,COGS 107A,A01,083627,Boyle; Mary E. T.,13,0,60,47
1656896765025,COGS 118A,A01,083075,Gupta; Anjum,15,0,76,61
1656896771049,CSE 3,A50,083646,Miranda; Gregory Joseph,22,0,50,28
1656896777073,CSE 8A,A50,083650,Miranda; Gregory Joseph,17,1,56,39
1656896783095,CSE 11,A01,083080,Cao; Yingjun,4,15,40,36
1656896789118,CSE 12,A01,083652,Krause-Levy; Sophia Louisa,20,1,120,100
1656896795144,CSE 15L,A01,083654,Morris; Justin Loren,8,0,50,42
1656896795144,CSE 15L,A02,083655,Morris; Justin Loren,8,0,50,42
1656896801165,CSE 20,A01,083657,Tran; Khoa Dang,37,0,80,43
1656896807188,CSE 21,A01,095574,Bach; Quang Tran,21,0,48,27
1656896813212,CSE 30,A01,083084,Eldon; John,4,0,80,76
1656896813212,CSE 30,B01,095061,Bhaskar; Nishant,6,0,50,44
1656896819239,CSE 100,A01,083659,Cao; Yingjun,2,4,70,68
1656896825263,CSE 134B,A01,083661,Powell; Thomas Allan,19,0,100,81
1656896831287,CSE 140,A01,083663,Gungor; Onat,14,0,85,71
1656896837314,CSE 140L,A01,083088,Eldon; John,16,0,100,84
1656896843338,CSE 175,A01,083665,Kumar; Rakesh,3,0,25,22
1656896849362,CSE 190,A00,092507,Dubnov; Shlomo,7,0,20,13
1656896855388,ECE 45,A01,083139,Congero; Spencer William,5,0,75,70
1656896861412,ECE 65,A50,083695,Saad; Andrew S,12,0,30,18
1656896861412,ECE 65,A51,095125,Saad; Andrew S,25,0,26,1
1656896867440,ECE 109,A01,091882,Touri; Behrouz,16,0,70,54
1656896873466,ECE 180,A00,083140,Abi Samra; Nicholas Camill,0,0,30,30
1656896873466,ECE 180,B00,083141,Abi Samra; Nicholas Camill,0,0,30,30
1656896879500,MATH 10A,A01,083735,Patchell; Gregory David,1,0,30,29
1656896879500,MATH 10A,A02,083736,Patchell; Gregory David,20,0,30,10
1656896879500,MATH 10A,A03,083737,Patchell; Gregory David,15,0,30,15
1656896885526,MATH 10B,A01,083207,Lim; Seonhee,7,0,34,27
1656896885526,MATH 10B,A02,083208,Lim; Seonhee,9,0,35,26
1656896885526,MATH 10B,A03,093472,Lim; Seonhee,4,0,34,30
1656896885526,MATH 10B,B01,083739,Sinha; Shubham,9,0,30,21
1656896891556,MATH 18,A01,083743,Cinel; Cameron Alexander,6,0,30,24
1656896891556,MATH 18,A02,083744,Cinel; Cameron Alexander,15,0,30,15
1656896891556,MATH 18,A03,083745,Cinel; Cameron Alexander,8,0,30,22
1656896891556,MATH 18,B01,083748,Rideout; David Porter,4,0,37,33
1656896891556,MATH 18,B02,083749,Rideout; David Porter,3,0,36,33
1656896891556,MATH 18,B03,083750,Rideout; David Porter,2,0,37,35
1656896891556,MATH 18,B04,083751,Rideout; David Porter,5,0,36,31
1656896891556,MATH 18,B05,093473,Rideout; David Porter,4,0,36,32
1656896891556,MATH 18,B06,093474,Rideout; David Porter,5,0,36,31
1656896897582,MATH 20A,A01,083754,Zheng; Zequn,12,0,40,28
1656896903606,MATH 20B,A01,083756,Briones; Jor-el Thomas Caparas,1,0,36,35
1656896903606,MATH 20B,A02,083757,Briones; Jor-el Thomas Caparas,1,0,36,35
1656896903606,MATH 20B,A03,093475,Briones; Jor-el Thomas Caparas,0,0,36,36
1656896909633,MATH 20C,A01,083760,Briones; Jor-el Thomas Caparas,1,0,35,34
1656896909633,MATH 20C,A02,083761,Briones; Jor-el Thomas Caparas,8,0,35,27
1656896909633,MATH 20C,A03,093476,Briones; Jor-el Thomas Caparas,0,1,36,36
1656896909633,MATH 20C,B01,083762,Bach; Quang Tran,0,0,30,30
1656896915660,MATH 20D,A01,083765,Tran; Brian Kha,4,0,30,26
1656896915660,MATH 20D,A02,083766,Tran; Brian Kha,4,0,30,26
1656896915660,MATH 20D,A03,083767,Tran; Brian Kha,3,0,30,27
1656896921683,MATH 20E,A01,083771,Ganguly; Soumya,5,0,32,27
1656896921683,MATH 20E,A02,083772,Ganguly; Soumya,6,0,32,26
1656896921683,MATH 20E,B01,083773,Ciotti; Benjamin,18,0,35,17
1656896921683,MATH 20E,B02,083774,Ciotti; Benjamin,17,0,35,18
1656896927712,MATH 103A,A01,083777,Greenfeld; Be'Eri,2,0,36,34
1656896927712,MATH 103A,A02,083778,Greenfeld; Be'Eri,5,0,36,31
1656896927712,MATH 103A,A03,093561,Greenfeld; Be'Eri,4,0,36,32
1656896927712,MATH 103A,B01,083779,Greenfeld; Be'Eri,6,0,36,30
1656896927712,MATH 103A,B02,083780,Greenfeld; Be'Eri,2,0,36,34
1656896927712,MATH 103A,B03,093562,Greenfeld; Be'Eri,2,0,36,34
1656896933738,MATH 105,A01,085443,Carter; Anne Toulson,13,0,35,22
1656896933738,MATH 105,A02,093477,Carter; Anne Toulson,20,0,35,15
1656896939762,MATH 109,A01,083213,Ganzberger; Geoffrey Michael,2,0,34,32
1656896939762,MATH 109,A02,083214,Ganzberger; Geoffrey Michael,2,0,34,32
1656896939762,MATH 109,A03,093478,Ganzberger; Geoffrey Michael,1,0,34,33
1656896939762,MATH 109,B01,083215,Ganzberger; Geoffrey Michael,1,0,32,31
1656896939762,MATH 109,B02,083216,Ganzberger; Geoffrey Michael,1,0,32,31
1656896939762,MATH 109,B03,093479,Ganzberger; Geoffrey Michael,6,0,32,26
1656896945789,MATH 142A,A01,083219,Chow; Bennett,6,0,32,26
1656896945789,MATH 142A,A02,083220,Chow; Bennett,10,0,32,22
1656896945789,MATH 142A,A03,093480,Chow; Bennett,7,0,32,25
1656896945789,MATH 142A,B03,093481,Chow; Bennett,7,0,32,25
1656896945789,MATH 142A,B04,093558,Chow; Bennett,10,0,32,22
1656896945789,MATH 142A,B05,093559,Chow; Bennett,6,0,32,26
1656896951812,MATH 193A,A01,083224,Rotar; Vladimir,7,0,34,27
1656896951812,MATH 193A,A02,083225,Rotar; Vladimir,3,0,34,31
1656896951812,MATH 193A,A03,083781,Rotar; Vladimir,1,0,34,33
1656896951812,MATH 193A,A04,083782,Rotar; Vladimir,6,0,34,28
1656896951812,MATH 193A,A05,093482,Rotar; Vladimir,6,0,34,28
1656896957834,MATH 197,001,091859,McAuley; Julian John,9999,0,9999,0
1656896957834,MATH 197,002,095566,Kedlaya; Kiran S.,9997,0,9999,2
1656896957834,MATH 197,003,095567,Xiao; Ming,9999,0,9999,0
1656896957834,MATH 197,004,095571,Perols; Johan Lars,9998,0,9999,1
1656896964895,COGS 9,A01,083615,Shannon; Kyle Michael,6,0,75,69
1656896970924,COGS 11,A01,083617,Boyle; Mary E. T.,19,0,48,29
1656896976947,COGS 13,A01,083071,Bastos; Amalia Pinkusfeld,8,0,71,63
1656896982974,COGS 14A,A01,092681,Semenuks; Arturs,0,1,100,100
1656896988996,COGS 14B,A01,083073,Cheng; Tzu-Han,5,0,63,58
1656896995023,COGS 17,A01,092677,Semenuks; Arturs,4,0,81,77
1656897001047,COGS 100,A01,083619,Allen; Michael Gordon,15,0,70,55
1656897007078,COGS 101A,A01,083621,Davis; Joshua Daniel,9,0,68,59
1656897013105,COGS 101B,A01,091572,Allen; Michael Gordon,8,0,65,57
1656897019127,COGS 101C,A01,083625,Delgado; Tania,17,0,35,18
1656897025153,COGS 107A,A01,083627,Boyle; Mary E. T.,13,0,60,47
1656897031181,COGS 118A,A01,083075,Gupta; Anjum,15,0,76,61
1656897037209,CSE 3,A50,083646,Miranda; Gregory Joseph,22,0,50,28
1656897043233,CSE 8A,A50,083650,Miranda; Gregory Joseph,17,1,56,39
1656897049256,CSE 11,A01,083080,Cao; Yingjun,4,15,40,36
1656897055285,CSE 12,A01,083652,Krause-Levy; Sophia Louisa,20,1,120,100
1656897061325,CSE 15L,A01,083654,Morris; Justin Loren,8,0,50,42
1656897061325,CSE 15L,A02,083655,Morris; Justin Loren,8,0,50,42
1656897067352,CSE 20,A01,083657,Tran; Khoa Dang,37,0,80,43
1656897073384,CSE 21,A01,095574,Bach; Quang Tran,21,0,48,27
1656897079407,CSE 30,A01,083084,Eldon; John,4,0,80,76
1656897079407,CSE 30,B01,095061,Bhaskar; Nishant,6,0,50,44
1656897085434,CSE 100,A01,083659,Cao; Yingjun,2,4,70,68
1656897091462,CSE 134B,A01,083661,Powell; Thomas Allan,19,0,100,81
1656897097493,CSE 140,A01,083663,Gungor; Onat,14,0,85,71
1656897103520,CSE 140L,A01,083088,Eldon; John,16,0,100,84
1656897109551,CSE 175,A01,083665,Kumar; Rakesh,3,0,25,22
1656897115585,CSE 190,A00,092507,Dubnov; Shlomo,7,0,20,13
1656897121610,ECE 45,A01,083139,Congero; Spencer William,5,0,75,70
1656897127639,ECE 65,A50,083695,Saad; Andrew S,12,0,30,18
1656897127639,ECE 65,A51,095125,Saad; Andrew S,25,0,26,1
1656897133666,ECE 109,A01,091882,Touri; Behrouz,16,0,70,54
1656897139692,ECE 180,A00,083140,Abi Samra; Nicholas Camill,0,0,30,30
1656897139692,ECE 180,B00,083141,Abi Samra; Nicholas Camill,0,0,30,30
1656897145714,MATH 10A,A01,083735,Patchell; Gregory David,1,0,30,29
1656897145714,MATH 10A,A02,083736,Patchell; Gregory David,20,0,30,10
1656897145714,MATH 10A,A03,083737,Patchell; Gregory David,15,0,30,15
1656897151737,MATH 10B,A01,083207,Lim; Seonhee,7,0,34,27
1656897151737,MATH 10B,A02,083208,Lim; Seonhee,9,0,35,26
1656897151737,MATH 10B,A03,093472,Lim; Seonhee,4,0,34,30
1656897151737,MATH 10B,B01,083739,Sinha; Shubham,9,0,30,21
1656897157759,MATH 18,A01,083743,Cinel; Cameron Alexander,6,0,30,24
1656897157759,MATH 18,A02,083744,Cinel; Cameron Alexander,15,0,30,15
1656897157759,MATH 18,A03,083745,Cinel; Cameron Alexander,8,0,30,22
1656897157759,MATH 18,B01,083748,Rideout; David Porter,4,0,37,33
1656897157759,MATH 18,B02,083749,Rideout; David Porter,3,0,36,33
1656897157759,MATH 18,B03,083750,Rideout; David Porter,2,0,37,35
1656897157759,MATH 18,B04,083751,Rideout; David Porter,5,0,36,31
1656897157759,MATH 18,B05,093473,Rideout; David Porter,4,0,36,32
1656897157759,MATH 18,B06,093474,Rideout; David Porter,5,0,36,31
1656897163782,MATH 20A,A01,083754,Zheng; Zequn,12,0,40,28
1656897169805,MATH 20B,A01,083756,Briones; Jor-el Thomas Caparas,1,0,36,35
1656897169805,MATH 20B,A02,083757,Briones; Jor-el Thomas Caparas,1,0,36,35
1656897169805,MATH 20B,A03,093475,Briones; Jor-el Thomas Caparas,0,0,36,36
1656897175832,MATH 20C,A01,083760,Briones; Jor-el Thomas Caparas,1,0,35,34
1656897175832,MATH 20C,A02,083761,Briones; Jor-el Thomas Caparas,8,0,35,27
1656897175832,MATH 20C,A03,093476,Briones; Jor-el Thomas Caparas,0,1,36,36
1656897175832,MATH 20C,B01,083762,Bach; Quang Tran,0,0,30,30
1656897181855,MATH 20D,A01,083765,Tran; Brian Kha,4,0,30,26
1656897181855,MATH 20D,A02,083766,Tran; Brian Kha,4,0,30,26
1656897181855,MATH 20D,A03,083767,Tran; Brian Kha,3,0,30,27
1656897187883,MATH 20E,A01,083771,Ganguly; Soumya,5,0,32,27
1656897187883,MATH 20E,A02,083772,Ganguly; Soumya,6,0,32,26
1656897187883,MATH 20E,B01,083773,Ciotti; Benjamin,18,0,35,17
1656897187883,MATH 20E,B02,083774,Ciotti; Benjamin,17,0,35,18
1656897193906,MATH 103A,A01,083777,Greenfeld; Be'Eri,2,0,36,34
1656897193906,MATH 103A,A02,083778,Greenfeld; Be'Eri,5,0,36,31
1656897193906,MATH 103A,A03,093561,Greenfeld; Be'Eri,4,0,36,32
1656897193906,MATH 103A,B01,083779,Greenfeld; Be'Eri,6,0,36,30
1656897193906,MATH 103A,B02,083780,Greenfeld; Be'Eri,2,0,36,34
1656897193906,MATH 103A,B03,093562,Greenfeld; Be'Eri,2,0,36,34
1656897199929,MATH 105,A01,085443,Carter; Anne Toulson,13,0,35,22
1656897199929,MATH 105,A02,093477,Carter; Anne Toulson,20,0,35,15
1656897205958,MATH 109,A01,083213,Ganzberger; Geoffrey Michael,2,0,34,32
1656897205958,MATH 109,A02,083214,Ganzberger; Geoffrey Michael,2,0,34,32
1656897205958,MATH 109,A03,093478,Ganzberger; Geoffrey Michael,1,0,34,33
1656897205958,MATH 109,B01,083215,Ganzberger; Geoffrey Michael,1,0,32,31
1656897205958,MATH 109,B02,083216,Ganzberger; Geoffrey Michael,1,0,32,31
1656897205958,MATH 109,B03,093479,Ganzberger; Geoffrey Michael,6,0,32,26
1656897211983,MATH 142A,A01,083219,Chow; Bennett,6,0,32,26
1656897211983,MATH 142A,A02,083220,Chow; Bennett,10,0,32,22
1656897211983,MATH 142A,A03,093480,Chow; Bennett,7,0,32,25
1656897211983,MATH 142A,B03,093481,Chow; Bennett,7,0,32,25
1656897211983,MATH 142A,B04,093558,Chow; Bennett,10,0,32,22
1656897211983,MATH 142A,B05,093559,Chow; Bennett,6,0,32,26
1656897218010,MATH 193A,A01,083224,Rotar; Vladimir,7,0,34,27
1656897218010,MATH 193A,A02,083225,Rotar; Vladimir,3,0,34,31
1656897218010,MATH 193A,A03,083781,Rotar; Vladimir,1,0,34,33
1656897218010,MATH 193A,A04,083782,Rotar; Vladimir,6,0,34,28
1656897218010,MATH 193A,A05,093482,Rotar; Vladimir,6,0,34,28
1656897224033,MATH 197,001,091859,McAuley; Julian John,9999,0,9999,0
1656897224033,MATH 197,002,095566,Kedlaya; Kiran S.,9997,0,9999,2
1656897224033,MATH 197,003,095567,Xiao; Ming,9999,0,9999,0
1656897224033,MATH 197,004,095571,Perols; Johan Lars,9998,0,9999,1
1656897231084,COGS 9,A01,083615,Shannon; Kyle Michael,6,0,75,69
1656897237110,COGS 11,A01,083617,Boyle; Mary E. T.,19,0,48,29
1656897243134,COGS 13,A01,083071,Bastos; Amalia Pinkusfeld,8,0,71,63
1656897249159,COGS 14A,A01,092681,Semenuks; Arturs,0,1,100,100
1656897255185,COGS 14B,A01,083073,Cheng; Tzu-Han,5,0,63,58
1656897261207,COGS 17,A01,092677,Semenuks; Arturs,4,0,81,77
1656897267231,COGS 100,A01,083619,Allen; Michael Gordon,15,0,70,55
1656897273255,COGS 101A,A01,083621,Davis; Joshua Daniel,9,0,68,59
1656897279279,COGS 101B,A01,091572,Allen; Michael Gordon,8,0,65,57
1656897285304,COGS 101C,A01,083625,Delgado; Tania,17,0,35,18
1656897291330,COGS 107A,A01,083627,Boyle; Mary E. T.,13,0,60,47
1656897297360,COGS 118A,A01,083075,Gupta; Anjum,15,0,76,61
1656897303383,CSE 3,A50,083646,Miranda; Gregory Joseph,22,0,50,28
1656897309406,CSE 8A,A50,083650,Miranda; Gregory Joseph,17,1,56,39
1656897315429,CSE 11,A01,083080,Cao; Yingjun,4,15,40,36
1656897321452,CSE 12,A01,083652,Krause-Levy; Sophia Louisa,20,1,120,100
1656897327476,CSE 15L,A01,083654,Morris; Justin Loren,8,0,50,42
1656897327476,CSE 15L,A02,083655,Morris; Justin Loren,8,0,50,42
1656897333502,CSE 20,A01,083657,Tran; Khoa Dang,37,0,80,43
1656897339528,CSE 21,A01,095574,Bach; Quang Tran,21,0,48,27
1656897345553,CSE 30,A01,083084,Eldon; John,4,0,80,76
1656897345553,CSE 30,B01,095061,Bhaskar; Nishant,6,0,50,44
1656897351653,CSE 100,A01,083659,Cao; Yingjun,2,4,70,68
1656897357679,CSE 134B,A01,083661,Powell; Thomas Allan,19,0,100,81
1656897363701,CSE 140,A01,083663,Gungor; Onat,14,0,85,71
1656897369727,CSE 140L,A01,083088,Eldon; John,16,0,100,84
1656897375749,CSE 175,A01,083665,Kumar; Rakesh,3,0,25,22
1656897381788,CSE 190,A00,092507,Dubnov; Shlomo,7,0,20,13
1656897387810,ECE 45,A01,083139,Congero; Spencer William,5,0,75,70
1656897393838,ECE 65,A50,083695,Saad; Andrew S,12,0,30,18
1656897393838,ECE 65,A51,095125,Saad; Andrew S,25,0,26,1
1656897399862,ECE 109,A01,091882,Touri; Behrouz,16,0,70,54
1656897405887,ECE 180,A00,083140,Abi Samra; Nicholas Camill,0,0,30,30
1656897405887,ECE 180,B00,083141,Abi Samra; Nicholas Camill,0,0,30,30
1656897411910,MATH 10A,A01,083735,Patchell; Gregory David,1,0,30,29
1656897411910,MATH 10A,A02,083736,Patchell; Gregory David,20,0,30,10
1656897411910,MATH 10A,A03,083737,Patchell; Gregory David,15,0,30,15
1656897417934,MATH 10B,A01,083207,Lim; Seonhee,7,0,34,27
1656897417934,MATH 10B,A02,083208,Lim; Seonhee,9,0,35,26
1656897417934,MATH 10B,A03,093472,Lim; Seonhee,4,0,34,30
1656897417934,MATH 10B,B01,083739,Sinha; Shubham,9,0,30,21
1656897423963,MATH 18,A01,083743,Cinel; Cameron Alexander,6,0,30,24
1656897423963,MATH 18,A02,083744,Cinel; Cameron Alexander,15,0,30,15
1656897423963,MATH 18,A03,083745,Cinel; Cameron Alexander,8,0,30,22
1656897423963,MATH 18,B01,083748,Rideout; David Porter,4,0,37,33
1656897423963,MATH 18,B02,083749,Rideout; David Porter,3,0,36,33
1656897423963,MATH 18,B03,083750,Rideout; David Porter,2,0,37,35
1656897423963,MATH 18,B04,083751,Rideout; David Porter,5,0,36,31
1656897423963,MATH 18,B05,093473,Rideout; David Porter,4,0,36,32
1656897423963,MATH 18,B06,093474,Rideout; David Porter,5,0,36,31
1656897429985,MATH 20A,A01,083754,Zheng; Zequn,12,0,40,28
1656897436013,MATH 20B,A01,083756,Briones; Jor-el Thomas Caparas,1,0,36,35
1656897436013,MATH 20B,A02,083757,Briones; Jor-el Thomas Caparas,1,0,36,35
1656897436013,MATH 20B,A03,093475,Briones; Jor-el Thomas Caparas,0,0,36,36
1656897442037,MATH 20C,A01,083760,Briones; Jor-el Thomas Caparas,1,0,35,34
1656897442037,MATH 20C,A02,083761,Briones; Jor-el Thomas Caparas,8,0,35,27
1656897442037,MATH 20C,A03,093476,Briones; Jor-el Thomas Caparas,0,1,36,36
1656897442037,MATH 20C,B01,083762,Bach; Quang Tran,0,0,30,30
1656897448061,MATH 20D,A01,083765,Tran; Brian Kha,4,0,30,26
1656897448061,MATH 20D,A02,083766,Tran; Brian Kha,4,0,30,26
1656897448061,MATH 20D,A03,083767,Tran; Brian Kha,3,0,30,27
1656897454089,MATH 20E,A01,083771,Ganguly; Soumya,5,0,32,27
1656897454089,MATH 20E,A02,083772,Ganguly; Soumya,6,0,32,26
1656897454089,MATH 20E,B01,083773,Ciotti; Benjamin,18,0,35,17
1656897454089,MATH 20E,B02,083774,Ciotti; Benjamin,17,0,35,18
1656897460114,MATH 103A,A01,083777,Greenfeld; Be'Eri,2,0,36,34
1656897460114,MATH 103A,A02,083778,Greenfeld; Be'Eri,5,0,36,31
1656897460114,MATH 103A,A03,093561,Greenfeld; Be'Eri,4,0,36,32
1656897460114,MATH 103A,B01,083779,Greenfeld; Be'Eri,6,0,36,30
1656897460114,MATH 103A,B02,083780,Greenfeld; Be'Eri,2,0,36,34
1656897460114,MATH 103A,B03,093562,Greenfeld; Be'Eri,2,0,36,34
1656897466140,MATH 105,A01,085443,Carter; Anne Toulson,13,0,35,22
1656897466140,MATH 105,A02,093477,Carter; Anne Toulson,20,0,35,15
1656897472171,MATH 109,A01,083213,Ganzberger; Geoffrey Michael,2,0,34,32
1656897472171,MATH 109,A02,083214,Ganzberger; Geoffrey Michael,2,0,34,32
1656897472171,MATH 109,A03,093478,Ganzberger; Geoffrey Michael,1,0,34,33
1656897472171,MATH 109,B01,083215,Ganzberger; Geoffrey Michael,1,0,32,31
1656897472171,MATH 109,B02,083216,Ganzberger; Geoffrey Michael,1,0,32,31
1656897472171,MATH 109,B03,093479,Ganzberger; Geoffrey Michael,6,0,32,26
1656897478194,MATH 142A,A01,083219,Chow; Bennett,6,0,32,26
1656897478194,MATH 142A,A02,083220,Chow; Bennett,10,0,32,22
1656897478194,MATH 142A,A03,093480,Chow; Bennett,7,0,32,25
1656897478194,MATH 142A,B03,093481,Chow; Bennett,7,0,32,25
1656897478194,MATH 142A,B04,093558,Chow; Bennett,10,0,32,22
1656897478194,MATH 142A,B05,093559,Chow; Bennett,6,0,32,26
1656897484222,MATH 193A,A01,083224,Rotar; Vladimir,7,0,34,27
1656897484222,MATH 193A,A02,083225,Rotar; Vladimir,3,0,34,31
1656897484222,MATH 193A,A03,083781,Rotar; Vladimir,1,0,34,33
1656897484222,MATH 193A,A04,083782,Rotar; Vladimir,6,0,34,28
1656897484222,MATH 193A,A05,093482,Rotar; Vladimir,6,0,34,28
1656897490246,MATH 197,001,091859,McAuley; Julian John,9999,0,9999,0
1656897490246,MATH 197,002,095566,Kedlaya; Kiran S.,9997,0,9999,2
1656897490246,MATH 197,003,095567,Xiao; Ming,9999,0,9999,0
1656897490246,MATH 197,004,095571,Perols; Johan Lars,9998,0,9999,1
1656897497304,COGS 9,A01,083615,Shannon; Kyle Michael,6,0,75,69
1656897503329,COGS 11,A01,083617,Boyle; Mary E. T.,19,0,48,29
1656897509352,COGS 13,A01,083071,Bastos; Amalia Pinkusfeld,8,0,71,63
1656897515378,COGS 14A,A01,092681,Semenuks; Arturs,0,1,100,100
1656897521405,COGS 14B,A01,083073,Cheng; Tzu-Han,5,0,63,58
1656897527428,COGS 17,A01,092677,Semenuks; Arturs,4,0,81,77
1656897533451,COGS 100,A01,083619,Allen; Michael Gordon,15,0,70,55
1656897539477,COGS 101A,A01,083621,Davis; Joshua Daniel,9,0,68,59
1656897545501,COGS 101B,A01,091572,Allen; Michael Gordon,8,0,65,57
1656897551537,COGS 101C,A01,083625,Delgado; Tania,17,0,35,18
1656897557564,COGS 107A,A01,083627,Boyle; Mary E. T.,13,0,60,47
1656897563586,COGS 118A,A01,083075,Gupta; Anjum,15,0,76,61
1656897569610,CSE 3,A50,083646,Miranda; Gregory Joseph,22,0,50,28
1656897575637,CSE 8A,A50,083650,Miranda; Gregory Joseph,17,1,56,39
1656897581667,CSE 11,A01,083080,Cao; Yingjun,4,15,40,36
1656897587693,CSE 12,A01,083652,Krause-Levy; Sophia Louisa,20,1,120,100
1656897593720,CSE 15L,A01,083654,Morris; Justin Loren,8,0,50,42
1656897593720,CSE 15L,A02,083655,Morris; Justin Loren,8,0,50,42
1656897599744,CSE 20,A01,083657,Tran; Khoa Dang,37,0,80,43
1656897605766,CSE 21,A01,095574,Bach; Quang Tran,21,0,48,27
1656897611796,CSE 30,A01,083084,Eldon; John,4,0,80,76
1656897611796,CSE 30,B01,095061,Bhaskar; Nishant,6,0,50,44
1656897617824,CSE 100,A01,083659,Cao; Yingjun,2,4,70,68
1656897623850,CSE 134B,A01,083661,Powell; Thomas Allan,19,0,100,81
1656897629873,CSE 140,A01,083663,Gungor; Onat,14,0,85,71
1656897635896,CSE 140L,A01,083088,Eldon; John,16,0,100,84
1656897641921,CSE 175,A01,083665,Kumar; Rakesh,3,0,25,22
1656897647943,CSE 190,A00,092507,Dubnov; Shlomo,7,0,20,13
1656897653973,ECE 45,A01,083139,Congero; Spencer William,5,0,75,70
1656897659998,ECE 65,A50,083695,Saad; Andrew S,12,0,30,18
1656897659998,ECE 65,A51,095125,Saad; Andrew S,25,0,26,1
1656897666021,ECE 109,A01,091882,Touri; Behrouz,16,0,70,54
1656897672046,ECE 180,A00,083140,Abi Samra; Nicholas Camill,0,0,30,30
1656897672046,ECE 180,B00,083141,Abi Samra; Nicholas Camill,0,0,30,30
1656897678069,MATH 10A,A01,083735,Patchell; Gregory David,1,0,30,29
1656897678069,MATH 10A,A02,083736,Patchell; Gregory David,20,0,30,10
1656897678069,MATH 10A,A03,083737,Patchell; Gregory David,15,0,30,15
1656897684093,MATH 10B,A01,083207,Lim; Seonhee,7,0,34,27
1656897684093,MATH 10B,A02,083208,Lim; Seonhee,9,0,35,26
1656897684093,MATH 10B,A03,093472,Lim; Seonhee,4,0,34,30
1656897684093,MATH 10B,B01,083739,Sinha; Shubham,9,0,30,21
1656897690117,MATH 18,A01,083743,Cinel; Cameron Alexander,6,0,30,24
1656897690117,MATH 18,A02,083744,Cinel; Cameron Alexander,15,0,30,15
1656897690117,MATH 18,A03,083745,Cinel; Cameron Alexander,8,0,30,22
1656897690117,MATH 18,B01,083748,Rideout; David Porter,4,0,37,33
1656897690117,MATH 18,B02,083749,Rideout; David Porter,3,0,36,33
1656897690117,MATH 18,B03,083750,Rideout; David Porter,2,0,37,35
1656897690117,MATH 18,B04,083751,Rideout; David Porter,5,0,36,31
1656897690117,MATH 18,B05,093473,Rideout; David Porter,4,0,36,32
1656897690117,MATH 18,B06,093474,Rideout; David Porter,5,0,36,31
1656897696140,MATH 20A,A01,083754,Zheng; Zequn,12,0,40,28
1656897702168,MATH 20B,A01,083756,Briones; Jor-el Thomas Caparas,1,0,36,35
1656897702168,MATH 20B,A02,083757,Briones; Jor-el Thomas Caparas,1,0,36,35
1656897702168,MATH 20B,A03,093475,Briones; Jor-el Thomas Caparas,0,0,36,36
1656897708192,MATH 20C,A01,083760,Briones; Jor-el Thomas Caparas,1,0,35,34
1656897708192,MATH 20C,A02,083761,Briones; Jor-el Thomas Caparas,8,0,35,27
1656897708192,MATH 20C,A03,093476,Briones; Jor-el Thomas Caparas,0,1,36,36
1656897708192,MATH 20C,B01,083762,Bach; Quang Tran,0,0,30,30
1656897714219,MATH 20D,A01,083765,Tran; Brian Kha,4,0,30,26
1656897714219,MATH 20D,A02,083766,Tran; Brian Kha,4,0,30,26
1656897714219,MATH 20D,A03,083767,Tran; Brian Kha,3,0,30,27
1656897720251,MATH 20E,A01,083771,Ganguly; Soumya,5,0,32,27
1656897720251,MATH 20E,A02,083772,Ganguly; Soumya,6,0,32,26
1656897720251,MATH 20E,B01,083773,Ciotti; Benjamin,18,0,35,17
1656897720251,MATH 20E,B02,083774,Ciotti; Benjamin,17,0,35,18
1656897726287,MATH 103A,A01,083777,Greenfeld; Be'Eri,2,0,36,34
1656897726287,MATH 103A,A02,083778,Greenfeld; Be'Eri,5,0,36,31
1656897726287,MATH 103A,A03,093561,Greenfeld; Be'Eri,4,0,36,32
1656897726287,MATH 103A,B01,083779,Greenfeld; Be'Eri,6,0,36,30
1656897726287,MATH 103A,B02,083780,Greenfeld; Be'Eri,2,0,36,34
1656897726287,MATH 103A,B03,093562,Greenfeld; Be'Eri,2,0,36,34
1656897732320,MATH 105,A01,085443,Carter; Anne Toulson,13,0,35,22
1656897732320,MATH 105,A02,093477,Carter; Anne Toulson,20,0,35,15
1656897738349,MATH 109,A01,083213,Ganzberger; Geoffrey Michael,2,0,34,32
1656897738349,MATH 109,A02,083214,Ganzberger; Geoffrey Michael,2,0,34,32
1656897738349,MATH 109,A03,093478,Ganzberger; Geoffrey Michael,1,0,34,33
1656897738349,MATH 109,B01,083215,Ganzberger; Geoffrey Michael,1,0,32,31
1656897738349,MATH 109,B02,083216,Ganzberger; Geoffrey Michael,1,0,32,31
1656897738349,MATH 109,B03,093479,Ganzberger; Geoffrey Michael,6,0,32,26
1656897744379,MATH 142A,A01,083219,Chow; Bennett,6,0,32,26
1656897744379,MATH 142A,A02,083220,Chow; Bennett,10,0,32,22
1656897744379,MATH 142A,A03,093480,Chow; Bennett,7,0,32,25
1656897744379,MATH 142A,B03,093481,Chow; Bennett,7,0,32,25
1656897744379,MATH 142A,B04,093558,Chow; Bennett,10,0,32,22
1656897744379,MATH 142A,B05,093559,Chow; Bennett,6,0,32,26
1656897750402,MATH 193A,A01,083224,Rotar; Vladimir,7,0,34,27
1656897750402,MATH 193A,A02,083225,Rotar; Vladimir,3,0,34,31
1656897750402,MATH 193A,A03,083781,Rotar; Vladimir,1,0,34,33
1656897750402,MATH 193A,A04,083782,Rotar; Vladimir,6,0,34,28
1656897750402,MATH 193A,A05,093482,Rotar; Vladimir,6,0,34,28
1656897756429,MATH 197,001,091859,McAuley; Julian John,9999,0,9999,0
1656897756429,MATH 197,002,095566,Kedlaya; Kiran S.,9997,0,9999,2
1656897756429,MATH 197,003,095567,Xiao; Ming,9999,0,9999,0
1656897756429,MATH 197,004,095571,Perols; Johan Lars,9998,0,9999,1
1656897763485,COGS 9,A01,083615,Shannon; Kyle Michael,6,0,75,69
1656897769512,COGS 11,A01,083617,Boyle; Mary E. T.,19,0,48,29
1656897775534,COGS 13,A01,083071,Bastos; Amalia Pinkusfeld,8,0,71,63
1656897781558,COGS 14A,A01,092681,Semenuks; Arturs,0,1,100,100
1656897787579,COGS 14B,A01,083073,Cheng; Tzu-Han,5,0,63,58
1656897793604,COGS 17,A01,092677,Semenuks; Arturs,4,0,81,77
1656897799628,COGS 100,A01,083619,Allen; Michael Gordon,15,0,70,55
1656897805649,COGS 101A,A01,083621,Davis; Joshua Daniel,9,0,68,59
1656897811672,COGS 101B,A01,091572,Allen; Michael Gordon,8,0,65,57
1656897817696,COGS 101C,A01,083625,Delgado; Tania,17,0,35,18
1656897823721,COGS 107A,A01,083627,Boyle; Mary E. T.,13,0,60,47
1656897829744,COGS 118A,A01,083075,Gupta; Anjum,15,0,76,61
1656897835771,CSE 3,A50,083646,Miranda; Gregory Joseph,22,0,50,28
1656897841794,CSE 8A,A50,083650,Miranda; Gregory Joseph,17,1,56,39
1656897847817,CSE 11,A01,083080,Cao; Yingjun,4,15,40,36
1656897853844,CSE 12,A01,083652,Krause-Levy; Sophia Louisa,20,1,120,100
1656897859868,CSE 15L,A01,083654,Morris; Justin Loren,8,0,50,42
1656897859868,CSE 15L,A02,083655,Morris; Justin Loren,8,0,50,42
1656897865896,CSE 20,A01,083657,Tran; Khoa Dang,37,0,80,43
1656897871920,CSE 21,A01,095574,Bach; Quang Tran,21,0,48,27
1656897877943,CSE 30,A01,083084,Eldon; John,4,0,80,76
1656897877943,CSE 30,B01,095061,Bhaskar; Nishant,6,0,50,44
1656897883969,CSE 100,A01,083659,Cao; Yingjun,2,4,70,68
1656897889995,CSE 134B,A01,083661,Powell; Thomas Allan,19,0,100,81
1656897896021,CSE 140,A01,083663,Gungor; Onat,14,0,85,71
1656897902046,CSE 140L,A01,083088,Eldon; John,16,0,100,84
1656897908069,CSE 175,A01,083665,Kumar; Rakesh,3,0,25,22
1656897914094,CSE 190,A00,092507,Dubnov; Shlomo,7,0,20,13
1656897920121,ECE 45,A01,083139,Congero; Spencer William,5,0,75,70
1656897926158,ECE 65,A50,083695,Saad; Andrew S,12,0,30,18
1656897926158,ECE 65,A51,095125,Saad; Andrew S,25,0,26,1
1656897932187,ECE 109,A01,091882,Touri; Behrouz,16,0,70,54
1656897938215,ECE 180,A00,083140,Abi Samra; Nicholas Camill,0,0,30,30
1656897938215,ECE 180,B00,083141,Abi Samra; Nicholas Camill,0,0,30,30
1656897944242,MATH 10A,A01,083735,Patchell; Gregory David,1,0,30,29
1656897944242,MATH 10A,A02,083736,Patchell; Gregory David,20,0,30,10
1656897944242,MATH 10A,A03,083737,Patchell; Gregory David,15,0,30,15
1656897950341,MATH 10B,A01,083207,Lim; Seonhee,7,0,34,27
1656897950341,MATH 10B,A02,083208,Lim; Seonhee,9,0,35,26
1656897950341,MATH 10B,A03,093472,Lim; Seonhee,4,0,34,30
1656897950341,MATH 10B,B01,083739,Sinha; Shubham,9,0,30,21
1656897956369,MATH 18,A01,083743,Cinel; Cameron Alexander,6,0,30,24
1656897956369,MATH 18,A02,083744,Cinel; Cameron Alexander,15,0,30,15
1656897956369,MATH 18,A03,083745,Cinel; Cameron Alexander,8,0,30,22
1656897956369,MATH 18,B01,083748,Rideout; David Porter,4,0,37,33
1656897956369,MATH 18,B02,083749,Rideout; David Porter,3,0,36,33
1656897956369,MATH 18,B03,083750,Rideout; David Porter,2,0,37,35
1656897956369,MATH 18,B04,083751,Rideout; David Porter,5,0,36,31
1656897956369,MATH 18,B05,093473,Rideout; David Porter,4,0,36,32
1656897956369,MATH 18,B06,093474,Rideout; David Porter,5,0,36,31
1656897962393,MATH 20A,A01,083754,Zheng; Zequn,12,0,40,28
1656897968415,MATH 20B,A01,083756,Briones; Jor-el Thomas Caparas,1,0,36,35
1656897968415,MATH 20B,A02,083757,Briones; Jor-el Thomas Caparas,1,0,36,35
1656897968415,MATH 20B,A03,093475,Briones; Jor-el Thomas Caparas,0,0,36,36
1656897974444,MATH 20C,A01,083760,Briones; Jor-el Thomas Caparas,1,0,35,34
1656897974444,MATH 20C,A02,083761,Briones; Jor-el Thomas Caparas,8,0,35,27
1656897974444,MATH 20C,A03,093476,Briones; Jor-el Thomas Caparas,0,1,36,36
1656897974444,MATH 20C,B01,083762,Bach; Quang Tran,0,0,30,30
1656897980470,MATH 20D,A01,083765,Tran; Brian Kha,4,0,30,26
1656897980470,MATH 20D,A02,083766,Tran; Brian Kha,4,0,30,26
1656897980470,MATH 20D,A03,083767,Tran; Brian Kha,3,0,30,27
1656897986494,MATH 20E,A01,083771,Ganguly; Soumya,5,0,32,27
1656897986494,MATH 20E,A02,083772,Ganguly; Soumya,6,0,32,26
1656897986494,MATH 20E,B01,083773,Ciotti; Benjamin,18,0,35,17
1656897986494,MATH 20E,B02,083774,Ciotti; Benjamin,17,0,35,18
1656897992519,MATH 103A,A01,083777,Greenfeld; Be'Eri,2,0,36,34
1656897992519,MATH 103A,A02,083778,Greenfeld; Be'Eri,5,0,36,31
1656897992519,MATH 103A,A03,093561,Greenfeld; Be'Eri,4,0,36,32
1656897992519,MATH 103A,B01,083779,Greenfeld; Be'Eri,6,0,36,30
1656897992519,MATH 103A,B02,083780,Greenfeld; Be'Eri,2,0,36,34
1656897992519,MATH 103A,B03,093562,Greenfeld; Be'Eri,2,0,36,34
1656897998541,MATH 105,A01,085443,Carter; Anne Toulson,13,0,35,22
1656897998541,MATH 105,A02,093477,Carter; Anne Toulson,20,0,35,15
1656898004570,MATH 109,A01,083213,Ganzberger; Geoffrey Michael,2,0,34,32
1656898004570,MATH 109,A02,083214,Ganzberger; Geoffrey Michael,2,0,34,32
1656898004570,MATH 109,A03,093478,Ganzberger; Geoffrey Michael,1,0,34,33
1656898004570,MATH 109,B01,083215,Ganzberger; Geoffrey Michael,1,0,32,31
1656898004570,MATH 109,B02,083216,Ganzberger; Geoffrey Michael,1,0,32,31
1656898004570,MATH 109,B03,093479,Ganzberger; Geoffrey Michael,6,0,32,26
1656898010594,MATH 142A,A01,083219,Chow; Bennett,6,0,32,26
1656898010594,MATH 142A,A02,083220,Chow; Bennett,10,0,32,22
1656898010594,MATH 142A,A03,093480,Chow; Bennett,7,0,32,25
1656898010594,MATH 142A,B03,093481,Chow; Bennett,7,0,32,25
1656898010594,MATH 142A,B04,093558,Chow; Bennett,10,0,32,22
1656898010594,MATH 142A,B05,093559,Chow; Bennett,6,0,32,26
1656898016617,MATH 193A,A01,083224,Rotar; Vladimir,7,0,34,27
1656898016617,MATH 193A,A02,083225,Rotar; Vladimir,3,0,34,31
1656898016617,MATH 193A,A03,083781,Rotar; Vladimir,1,0,34,33
1656898016617,MATH 193A,A04,083782,Rotar; Vladimir,6,0,34,28
1656898016617,MATH 193A,A05,093482,Rotar; Vladimir,6,0,34,28
1656898022644,MATH 197,001,091859,McAuley; Julian John,9999,0,9999,0
1656898022644,MATH 197,002,095566,Kedlaya; Kiran S.,9997,0,9999,2
1656898022644,MATH 197,003,095567,Xiao; Ming,9999,0,9999,0
1656898022644,MATH 197,004,095571,Perols; Johan Lars,9998,0,9999,1
1656898029710,COGS 9,A01,083615,Shannon; Kyle Michael,6,0,75,69
1656898035734,COGS 11,A01,083617,Boyle; Mary E. T.,19,0,48,29
1656898041766,COGS 13,A01,083071,Bastos; Amalia Pinkusfeld,8,0,71,63
1656898047789,COGS 14A,A01,092681,Semenuks; Arturs,0,1,100,100
1656898053818,COGS 14B,A01,083073,Cheng; Tzu-Han,5,0,63,58
1656898059841,COGS 17,A01,092677,Semenuks; Arturs,4,0,81,77
1656898065863,COGS 100,A01,083619,Allen; Michael Gordon,15,0,70,55
1656898071890,COGS 101A,A01,083621,Davis; Joshua Daniel,9,0,68,59
1656898077913,COGS 101B,A01,091572,Allen; Michael Gordon,8,0,65,57
1656898083939,COGS 101C,A01,083625,Delgado; Tania,17,0,35,18
1656898089962,COGS 107A,A01,083627,Boyle; Mary E. T.,13,0,60,47
1656898095984,COGS 118A,A01,083075,Gupta; Anjum,15,0,76,61
1656898102021,CSE 3,A50,083646,Miranda; Gregory Joseph,22,0,50,28
1656898108043,CSE 8A,A50,083650,Miranda; Gregory Joseph,17,1,56,39
1656898114071,CSE 11,A01,083080,Cao; Yingjun,4,15,40,36
1656898120094,CSE 12,A01,083652,Krause-Levy; Sophia Louisa,20,1,120,100
1656898126120,CSE 15L,A01,083654,Morris; Justin Loren,8,0,50,42
1656898126120,CSE 15L,A02,083655,Morris; Justin Loren,8,0,50,42
1656898132144,CSE 20,A01,083657,Tran; Khoa Dang,37,0,80,43
1656898138167,CSE 21,A01,095574,Bach; Quang Tran,21,0,48,27
1656898144191,CSE 30,A01,083084,Eldon; John,4,0,80,76
1656898144191,CSE 30,B01,095061,Bhaskar; Nishant,6,0,50,44
1656898150214,CSE 100,A01,083659,Cao; Yingjun,2,4,70,68
1656898156245,CSE 134B,A01,083661,Powell; Thomas Allan,19,0,100,81
1656898162278,CSE 140,A01,083663,Gungor; Onat,14,0,85,71
1656898168306,CSE 140L,A01,083088,Eldon; John,16,0,100,84
1656898174328,CSE 175,A01,083665,Kumar; Rakesh,3,0,25,22
1656898180352,CSE 190,A00,092507,Dubnov; Shlomo,7,0,20,13
1656898186377,ECE 45,A01,083139,Congero; Spencer William,5,0,75,70
1656898192403,ECE 65,A50,083695,Saad; Andrew S,12,0,30,18
1656898192403,ECE 65,A51,095125,Saad; Andrew S,25,0,26,1
1656898198426,ECE 109,A01,091882,Touri; Behrouz,16,0,70,54
1656898204448,ECE 180,A00,083140,Abi Samra; Nicholas Camill,0,0,30,30
1656898204448,ECE 180,B00,083141,Abi Samra; Nicholas Camill,0,0,30,30
1656898210476,MATH 10A,A01,083735,Patchell; Gregory David,1,0,30,29
1656898210476,MATH 10A,A02,083736,Patchell; Gregory David,20,0,30,10
1656898210476,MATH 10A,A03,083737,Patchell; Gregory David,15,0,30,15
1656898216498,MATH 10B,A01,083207,Lim; Seonhee,7,0,34,27
1656898216498,MATH 10B,A02,083208,Lim; Seonhee,9,0,35,26
1656898216498,MATH 10B,A03,093472,Lim; Seonhee,4,0,34,30
1656898216498,MATH 10B,B01,083739,Sinha; Shubham,9,0,30,21
1656898222522,MATH 18,A01,083743,Cinel; Cameron Alexander,6,0,30,24
1656898222522,MATH 18,A02,083744,Cinel; Cameron Alexander,15,0,30,15
1656898222522,MATH 18,A03,083745,Cinel; Cameron Alexander,8,0,30,22
1656898222522,MATH 18,B01,083748,Rideout; David Porter,4,0,37,33
1656898222522,MATH 18,B02,083749,Rideout; David Porter,3,0,36,33
1656898222522,MATH 18,B03,083750,Rideout; David Porter,2,0,37,35
1656898222522,MATH 18,B04,083751,Rideout; David Porter,5,0,36,31
1656898222522,MATH 18,B05,093473,Rideout; David Porter,4,0,36,32
1656898222522,MATH 18,B06,093474,Rideout; David Porter,5,0,36,31
1656898228558,MATH 20A,A01,083754,Zheng; Zequn,12,0,40,28
1656898234586,MATH 20B,A01,083756,Briones; Jor-el Thomas Caparas,1,0,36,35
1656898234586,MATH 20B,A02,083757,Briones; Jor-el Thomas Caparas,1,0,36,35
1656898234586,MATH 20B,A03,093475,Briones; Jor-el Thomas Caparas,0,0,36,36
1656898240611,MATH 20C,A01,083760,Briones; Jor-el Thomas Caparas,1,0,35,34
1656898240611,MATH 20C,A02,083761,Briones; Jor-el Thomas Caparas,8,0,35,27
1656898240611,MATH 20C,A03,093476,Briones; Jor-el Thomas Caparas,0,1,36,36
1656898240611,MATH 20C,B01,083762,Bach; Quang Tran,0,0,30,30
1656898246646,MATH 20D,A01,083765,Tran; Brian Kha,4,0,30,26
1656898246646,MATH 20D,A02,083766,Tran; Brian Kha,4,0,30,26
1656898246646,MATH 20D,A03,083767,Tran; Brian Kha,3,0,30,27
1656898252671,MATH 20E,A01,083771,Ganguly; Soumya,5,0,32,27
1656898252671,MATH 20E,A02,083772,Ganguly; Soumya,6,0,32,26
1656898252671,MATH 20E,B01,083773,Ciotti; Benjamin,18,0,35,17
1656898252671,MATH 20E,B02,083774,Ciotti; Benjamin,17,0,35,18
1656898258700,MATH 103A,A01,083777,Greenfeld; Be'Eri,2,0,36,34
1656898258700,MATH 103A,A02,083778,Greenfeld; Be'Eri,5,0,36,31
1656898258700,MATH 103A,A03,093561,Greenfeld; Be'Eri,4,0,36,32
1656898258700,MATH 103A,B01,083779,Greenfeld; Be'Eri,6,0,36,30
1656898258700,MATH 103A,B02,083780,Greenfeld; Be'Eri,2,0,36,34
1656898258700,MATH 103A,B03,093562,Greenfeld; Be'Eri,2,0,36,34
1656898264731,MATH 105,A01,085443,Carter; Anne Toulson,13,0,35,22
1656898264731,MATH 105,A02,093477,Carter; Anne Toulson,20,0,35,15
1656898270753,MATH 109,A01,083213,Ganzberger; Geoffrey Michael,2,0,34,32
1656898270753,MATH 109,A02,083214,Ganzberger; Geoffrey Michael,2,0,34,32
1656898270753,MATH 109,A03,093478,Ganzberger; Geoffrey Michael,1,0,34,33
1656898270753,MATH 109,B01,083215,Ganzberger; Geoffrey Michael,1,0,32,31
1656898270753,MATH 109,B02,083216,Ganzberger; Geoffrey Michael,1,0,32,31
1656898270753,MATH 109,B03,093479,Ganzberger; Geoffrey Michael,6,0,32,26
1656898276776,MATH 142A,A01,083219,Chow; Bennett,6,0,32,26
1656898276776,MATH 142A,A02,083220,Chow; Bennett,10,0,32,22
1656898276776,MATH 142A,A03,093480,Chow; Bennett,7,0,32,25
1656898276776,MATH 142A,B03,093481,Chow; Bennett,7,0,32,25
1656898276776,MATH 142A,B04,093558,Chow; Bennett,10,0,32,22
1656898276776,MATH 142A,B05,093559,Chow; Bennett,6,0,32,26
1656898282800,MATH 193A,A01,083224,Rotar; Vladimir,7,0,34,27
1656898282800,MATH 193A,A02,083225,Rotar; Vladimir,3,0,34,31
1656898282800,MATH 193A,A03,083781,Rotar; Vladimir,1,0,34,33
1656898282800,MATH 193A,A04,083782,Rotar; Vladimir,6,0,34,28
1656898282800,MATH 193A,A05,093482,Rotar; Vladimir,6,0,34,28
1656898288822,MATH 197,001,091859,McAuley; Julian John,9999,0,9999,0
1656898288822,MATH 197,002,095566,Kedlaya; Kiran S.,9997,0,9999,2
1656898288822,MATH 197,003,095567,Xiao; Ming,9999,0,9999,0
1656898288822,MATH 197,004,095571,Perols; Johan Lars,9998,0,9999,1
1656898295885,COGS 9,A01,083615,Shannon; Kyle Michael,6,0,75,69
1656898301908,COGS 11,A01,083617,Boyle; Mary E. T.,19,0,48,29
1656898307930,COGS 13,A01,083071,Bastos; Amalia Pinkusfeld,8,0,71,63
1656898313955,COGS 14A,A01,092681,Semenuks; Arturs,0,1,100,100
1656898319978,COGS 14B,A01,083073,Cheng; Tzu-Han,5,0,63,58
1656898326003,COGS 17,A01,092677,Semenuks; Arturs,4,0,81,77
1656898332028,COGS 100,A01,083619,Allen; Michael Gordon,15,0,70,55
1656898338054,COGS 101A,A01,083621,Davis; Joshua Daniel,9,0,68,59
1656898344081,COGS 101B,A01,091572,Allen; Michael Gordon,8,0,65,57
1656898350112,COGS 101C,A01,083625,Delgado; Tania,17,0,35,18
1656898356138,COGS 107A,A01,083627,Boyle; Mary E. T.,13,0,60,47
1656898362159,COGS 118A,A01,083075,Gupta; Anjum,15,0,76,61
1656898368186,CSE 3,A50,083646,Miranda; Gregory Joseph,22,0,50,28
1656898374214,CSE 8A,A50,083650,Miranda; Gregory Joseph,17,1,56,39
1656898380241,CSE 11,A01,083080,Cao; Yingjun,4,15,40,36
1656898386279,CSE 12,A01,083652,Krause-Levy; Sophia Louisa,20,1,120,100
1656898392302,CSE 15L,A01,083654,Morris; Justin Loren,8,0,50,42
1656898392302,CSE 15L,A02,083655,Morris; Justin Loren,8,0,50,42
1656898398325,CSE 20,A01,083657,Tran; Khoa Dang,37,0,80,43
1656898404347,CSE 21,A01,095574,Bach; Quang Tran,21,0,48,27
1656898410375,CSE 30,A01,083084,Eldon; John,4,0,80,76
1656898410375,CSE 30,B01,095061,Bhaskar; Nishant,6,0,50,44
1656898416401,CSE 100,A01,083659,Cao; Yingjun,2,4,70,68
1656898422423,CSE 134B,A01,083661,Powell; Thomas Allan,19,0,100,81
1656898428447,CSE 140,A01,083663,Gungor; Onat,14,0,85,71
1656898434471,CSE 140L,A01,083088,Eldon; John,16,0,100,84
1656898440493,CSE 175,A01,083665,Kumar; Rakesh,3,0,25,22
1656898446519,CSE 190,A00,092507,Dubnov; Shlomo,7,0,20,13
1656898452542,ECE 45,A01,083139,Congero; Spencer William,5,0,75,70
1656898458572,ECE 65,A50,083695,Saad; Andrew S,12,0,30,18
1656898458572,ECE 65,A51,095125,Saad; Andrew S,25,0,26,1
1656898464596,ECE 109,A01,091882,Touri; Behrouz,16,0,70,54
1656898470621,ECE 180,A00,083140,Abi Samra; Nicholas Camill,0,0,30,30
1656898470621,ECE 180,B00,083141,Abi Samra; Nicholas Camill,0,0,30,30
1656898476655,MATH 10A,A01,083735,Patchell; Gregory David,1,0,30,29
1656898476655,MATH 10A,A02,083736,Patchell; Gregory David,20,0,30,10
1656898476655,MATH 10A,A03,083737,Patchell; Gregory David,15,0,30,15
1656898482680,MATH 10B,A01,083207,Lim; Seonhee,7,0,34,27
1656898482680,MATH 10B,A02,083208,Lim; Seonhee,9,0,35,26
1656898482680,MATH 10B,A03,093472,Lim; Seonhee,4,0,34,30
1656898482680,MATH 10B,B01,083739,Sinha; Shubham,9,0,30,21
1656898488706,MATH 18,A01,083743,Cinel; Cameron Alexander,6,0,30,24
1656898488706,MATH 18,A02,083744,Cinel; Cameron Alexander,15,0,30,15
1656898488706,MATH 18,A03,083745,Cinel; Cameron Alexander,8,0,30,22
1656898488706,MATH 18,B01,083748,Rideout; David Porter,4,0,37,33
1656898488706,MATH 18,B02,083749,Rideout; David Porter,3,0,36,33
1656898488706,MATH 18,B03,083750,Rideout; David Porter,2,0,37,35
1656898488706,MATH 18,B04,083751,Rideout; David Porter,5,0,36,31
1656898488706,MATH 18,B05,093473,Rideout; David Porter,4,0,36,32
1656898488706,MATH 18,B06,093474,Rideout; David Porter,5,0,36,31
1656898494727,MATH 20A,A01,083754,Zheng; Zequn,12,0,40,28
1656898500750,MATH 20B,A01,083756,Briones; Jor-el Thomas Caparas,1,0,36,35
1656898500750,MATH 20B,A02,083757,Briones; Jor-el Thomas Caparas,1,0,36,35
1656898500750,MATH 20B,A03,093475,Briones; Jor-el Thomas Caparas,0,0,36,36
1656898506772,MATH 20C,A01,083760,Briones; Jor-el Thomas Caparas,1,0,35,34
1656898506772,MATH 20C,A02,083761,Briones; Jor-el Thomas Caparas,8,0,35,27
1656898506772,MATH 20C,A03,093476,Briones; Jor-el Thomas Caparas,0,1,36,36
1656898506772,MATH 20C,B01,083762,Bach; Quang Tran,0,0,30,30
1656898512799,MATH 20D,A01,083765,Tran; Brian Kha,4,0,30,26
1656898512799,MATH 20D,A02,083766,Tran; Brian Kha,4,0,30,26
1656898512799,MATH 20D,A03,083767,Tran; Brian Kha,3,0,30,27
1656898518828,MATH 20E,A01,083771,Ganguly; Soumya,5,0,32,27
1656898518828,MATH 20E,A02,083772,Ganguly; Soumya,6,0,32,26
1656898518828,MATH 20E,B01,083773,Ciotti; Benjamin,18,0,35,17
1656898518828,MATH 20E,B02,083774,Ciotti; Benjamin,17,0,35,18
1656898524852,MATH 103A,A01,083777,Greenfeld; Be'Eri,2,0,36,34
1656898524852,MATH 103A,A02,083778,Greenfeld; Be'Eri,5,0,36,31
1656898524852,MATH 103A,A03,093561,Greenfeld; Be'Eri,4,0,36,32
1656898524852,MATH 103A,B01,083779,Greenfeld; Be'Eri,6,0,36,30
1656898524852,MATH 103A,B02,083780,Greenfeld; Be'Eri,2,0,36,34
1656898524852,MATH 103A,B03,093562,Greenfeld; Be'Eri,2,0,36,34
1656898530874,MATH 105,A01,085443,Carter; Anne Toulson,13,0,35,22
1656898530874,MATH 105,A02,093477,Carter; Anne Toulson,20,0,35,15
1656898536903,MATH 109,A01,083213,Ganzberger; Geoffrey Michael,2,0,34,32
1656898536903,MATH 109,A02,083214,Ganzberger; Geoffrey Michael,2,0,34,32
1656898536903,MATH 109,A03,093478,Ganzberger; Geoffrey Michael,1,0,34,33
1656898536903,MATH 109,B01,083215,Ganzberger; Geoffrey Michael,1,0,32,31
1656898536903,MATH 109,B02,083216,Ganzberger; Geoffrey Michael,1,0,32,31
1656898536903,MATH 109,B03,093479,Ganzberger; Geoffrey Michael,6,0,32,26
1656898542929,MATH 142A,A01,083219,Chow; Bennett,6,0,32,26
1656898542929,MATH 142A,A02,083220,Chow; Bennett,10,0,32,22
1656898542929,MATH 142A,A03,093480,Chow; Bennett,7,0,32,25
1656898542929,MATH 142A,B03,093481,Chow; Bennett,7,0,32,25
1656898542929,MATH 142A,B04,093558,Chow; Bennett,10,0,32,22
1656898542929,MATH 142A,B05,093559,Chow; Bennett,6,0,32,26
1656898549027,MATH 193A,A01,083224,Rotar; Vladimir,7,0,34,27
1656898549027,MATH 193A,A02,083225,Rotar; Vladimir,3,0,34,31
1656898549027,MATH 193A,A03,083781,Rotar; Vladimir,1,0,34,33
1656898549027,MATH 193A,A04,083782,Rotar; Vladimir,6,0,34,28
1656898549027,MATH 193A,A05,093482,Rotar; Vladimir,6,0,34,28
1656898555051,MATH 197,001,091859,McAuley; Julian John,9999,0,9999,0
1656898555051,MATH 197,002,095566,Kedlaya; Kiran S.,9997,0,9999,2
1656898555051,MATH 197,003,095567,Xiao; Ming,9999,0,9999,0
1656898555051,MATH 197,004,095571,Perols; Johan Lars,9998,0,9999,1
1656898562118,COGS 9,A01,083615,Shannon; Kyle Michael,6,0,75,69
1656898568144,COGS 11,A01,083617,Boyle; Mary E. T.,19,0,48,29
1656898574166,COGS 13,A01,083071,Bastos; Amalia Pinkusfeld,8,0,71,63
1656898580189,COGS 14A,A01,092681,Semenuks; Arturs,0,1,100,100
1656898586217,COGS 14B,A01,083073,Cheng; Tzu-Han,5,0,63,58
1656898592243,COGS 17,A01,092677,Semenuks; Arturs,4,0,81,77
1656898598267,COGS 100,A01,083619,Allen; Michael Gordon,15,0,70,55
1656898604290,COGS 101A,A01,083621,Davis; Joshua Daniel,9,0,68,59
1656898610317,COGS 101B,A01,091572,Allen; Michael Gordon,8,0,65,57
1656898616352,COGS 101C,A01,083625,Delgado; Tania,17,0,35,18
1656898622374,COGS 107A,A01,083627,Boyle; Mary E. T.,13,0,60,47
1656898628401,COGS 118A,A01,083075,Gupta; Anjum,15,0,76,61
1656898634426,CSE 3,A50,083646,Miranda; Gregory Joseph,22,0,50,28
1656898640453,CSE 8A,A50,083650,Miranda; Gregory Joseph,17,1,56,39
1656898646476,CSE 11,A01,083080,Cao; Yingjun,4,15,40,36
1656898652499,CSE 12,A01,083652,Krause-Levy; Sophia Louisa,20,1,120,100
1656898658526,CSE 15L,A01,083654,Morris; Justin Loren,8,0,50,42
1656898658526,CSE 15L,A02,083655,Morris; Justin Loren,8,0,50,42
1656898664551,CSE 20,A01,083657,Tran; Khoa Dang,37,0,80,43
1656898670573,CSE 21,A01,095574,Bach; Quang Tran,21,0,48,27
1656898676601,CSE 30,A01,083084,Eldon; John,4,0,80,76
1656898676601,CSE 30,B01,095061,Bhaskar; Nishant,6,0,50,44
1656898682629,CSE 100,A01,083659,Cao; Yingjun,2,4,70,68
1656898688657,CSE 134B,A01,083661,Powell; Thomas Allan,19,0,100,81
1656898694680,CSE 140,A01,083663,Gungor; Onat,14,0,85,71
1656898700705,CSE 140L,A01,083088,Eldon; John,16,0,100,84
1656898706743,CSE 175,A01,083665,Kumar; Rakesh,3,0,25,22
1656898712768,CSE 190,A00,092507,Dubnov; Shlomo,7,0,20,13
1656898718793,ECE 45,A01,083139,Congero; Spencer William,5,0,75,70
1656898724824,ECE 65,A50,083695,Saad; Andrew S,12,0,30,18
1656898724824,ECE 65,A51,095125,Saad; Andrew S,25,0,26,1
1656898730847,ECE 109,A01,091882,Touri; Behrouz,16,0,70,54
1656898736871,ECE 180,A00,083140,Abi Samra; Nicholas Camill,0,0,30,30
1656898736871,ECE 180,B00,083141,Abi Samra; Nicholas Camill,0,0,30,30
1656898742895,MATH 10A,A01,083735,Patchell; Gregory David,1,0,30,29
1656898742895,MATH 10A,A02,083736,Patchell; Gregory David,20,0,30,10
1656898742895,MATH 10A,A03,083737,Patchell; Gregory David,15,0,30,15
1656898748919,MATH 10B,A01,083207,Lim; Seonhee,7,0,34,27
1656898748919,MATH 10B,A02,083208,Lim; Seonhee,9,0,35,26
1656898748919,MATH 10B,A03,093472,Lim; Seonhee,4,0,34,30
1656898748919,MATH 10B,B01,083739,Sinha; Shubham,9,0,30,21
1656898754943,MATH 18,A01,083743,Cinel; Cameron Alexander,6,0,30,24
1656898754943,MATH 18,A02,083744,Cinel; Cameron Alexander,15,0,30,15
1656898754943,MATH 18,A03,083745,Cinel; Cameron Alexander,8,0,30,22
1656898754943,MATH 18,B01,083748,Rideout; David Porter,4,0,37,33
1656898754943,MATH 18,B02,083749,Rideout; David Porter,3,0,36,33
1656898754943,MATH 18,B03,083750,Rideout; David Porter,2,0,37,35
1656898754943,MATH 18,B04,083751,Rideout; David Porter,5,0,36,31
1656898754943,MATH 18,B05,093473,Rideout; David Porter,4,0,36,32
1656898754943,MATH 18,B06,093474,Rideout; David Porter,5,0,36,31
1656898760966,MATH 20A,A01,083754,Zheng; Zequn,12,0,40,28
1656898766993,MATH 20B,A01,083756,Briones; Jor-el Thomas Caparas,1,0,36,35
1656898766993,MATH 20B,A02,083757,Briones; Jor-el Thomas Caparas,1,0,36,35
1656898766993,MATH 20B,A03,093475,Briones; Jor-el Thomas Caparas,0,0,36,36
1656898773023,MATH 20C,A01,083760,Briones; Jor-el Thomas Caparas,1,0,35,34
1656898773023,MATH 20C,A02,083761,Briones; Jor-el Thomas Caparas,8,0,35,27
1656898773023,MATH 20C,A03,093476,Briones; Jor-el Thomas Caparas,0,1,36,36
1656898773023,MATH 20C,B01,083762,Bach; Quang Tran,0,0,30,30
1656898779048,MATH 20D,A01,083765,Tran; Brian Kha,4,0,30,26
1656898779048,MATH 20D,A02,083766,Tran; Brian Kha,4,0,30,26
1656898779048,MATH 20D,A03,083767,Tran; Brian Kha,3,0,30,27
1656898785073,MATH 20E,A01,083771,Ganguly; Soumya,5,0,32,27
1656898785073,MATH 20E,A02,083772,Ganguly; Soumya,6,0,32,26
1656898785073,MATH 20E,B01,083773,Ciotti; Benjamin,18,0,35,17
1656898785073,MATH 20E,B02,083774,Ciotti; Benjamin,17,0,35,18
1656898791098,MATH 103A,A01,083777,Greenfeld; Be'Eri,2,0,36,34
1656898791098,MATH 103A,A02,083778,Greenfeld; Be'Eri,5,0,36,31
1656898791098,MATH 103A,A03,093561,Greenfeld; Be'Eri,4,0,36,32
1656898791098,MATH 103A,B01,083779,Greenfeld; Be'Eri,6,0,36,30
1656898791098,MATH 103A,B02,083780,Greenfeld; Be'Eri,2,0,36,34
1656898791098,MATH 103A,B03,093562,Greenfeld; Be'Eri,2,0,36,34
1656898797126,MATH 105,A01,085443,Carter; Anne Toulson,13,0,35,22
1656898797126,MATH 105,A02,093477,Carter; Anne Toulson,20,0,35,15
1656898803149,MATH 109,A01,083213,Ganzberger; Geoffrey Michael,2,0,34,32
1656898803149,MATH 109,A02,083214,Ganzberger; Geoffrey Michael,2,0,34,32
1656898803149,MATH 109,A03,093478,Ganzberger; Geoffrey Michael,1,0,34,33
1656898803149,MATH 109,B01,083215,Ganzberger; Geoffrey Michael,1,0,32,31
1656898803149,MATH 109,B02,083216,Ganzberger; Geoffrey Michael,1,0,32,31
1656898803149,MATH 109,B03,093479,Ganzberger; Geoffrey Michael,6,0,32,26
1656898809172,MATH 142A,A01,083219,Chow; Bennett,6,0,32,26
1656898809172,MATH 142A,A02,083220,Chow; Bennett,10,0,32,22
1656898809172,MATH 142A,A03,093480,Chow; Bennett,7,0,32,25
1656898809172,MATH 142A,B03,093481,Chow; Bennett,7,0,32,25
1656898809172,MATH 142A,B04,093558,Chow; Bennett,10,0,32,22
1656898809172,MATH 142A,B05,093559,Chow; Bennett,6,0,32,26
1656898823798,MATH 193A,A01,083224,Rotar; Vladimir,7,0,34,27
1656898823798,MATH 193A,A02,083225,Rotar; Vladimir,3,0,34,31
1656898823798,MATH 193A,A03,083781,Rotar; Vladimir,1,0,34,33
1656898823798,MATH 193A,A04,083782,Rotar; Vladimir,6,0,34,28
1656898823798,MATH 193A,A05,093482,Rotar; Vladimir,6,0,34,28
1656898829821,MATH 197,001,091859,McAuley; Julian John,9999,0,9999,0
1656898829821,MATH 197,002,095566,Kedlaya; Kiran S.,9997,0,9999,2
1656898829821,MATH 197,003,095567,Xiao; Ming,9999,0,9999,0
1656898829821,MATH 197,004,095571,Perols; Johan Lars,9998,0,9999,1
1656898836880,COGS 9,A01,083615,Shannon; Kyle Michael,6,0,75,69
1656898842904,COGS 11,A01,083617,Boyle; Mary E. T.,19,0,48,29
1656898848928,COGS 13,A01,083071,Bastos; Amalia Pinkusfeld,8,0,71,63
1656898854963,COGS 14A,A01,092681,Semenuks; Arturs,0,1,100,100
1656898861004,COGS 14B,A01,083073,Cheng; Tzu-Han,5,0,63,58
1656898867027,COGS 17,A01,092677,Semenuks; Arturs,4,0,81,77
1656898873061,COGS 100,A01,083619,Allen; Michael Gordon,15,0,70,55
1656898879088,COGS 101A,A01,083621,Davis; Joshua Daniel,9,0,68,59
1656898885121,COGS 101B,A01,091572,Allen; Michael Gordon,8,0,65,57
1656898891149,COGS 101C,A01,083625,Delgado; Tania,17,0,35,18
1656898897175,COGS 107A,A01,083627,Boyle; Mary E. T.,13,0,60,47
1656898903198,COGS 118A,A01,083075,Gupta; Anjum,15,0,76,61
1656898909221,CSE 3,A50,083646,Miranda; Gregory Joseph,22,0,50,28
1656898915245,CSE 8A,A50,083650,Miranda; Gregory Joseph,17,1,56,39
1656898921268,CSE 11,A01,083080,Cao; Yingjun,4,15,40,36
1656898927291,CSE 12,A01,083652,Krause-Levy; Sophia Louisa,20,1,120,100
1656898933315,CSE 15L,A01,083654,Morris; Justin Loren,8,0,50,42
1656898933315,CSE 15L,A02,083655,Morris; Justin Loren,8,0,50,42
1656898939339,CSE 20,A01,083657,Tran; Khoa Dang,37,0,80,43
1656898945366,CSE 21,A01,095574,Bach; Quang Tran,21,0,48,27
1656898951395,CSE 30,A01,083084,Eldon; John,4,0,80,76
1656898951395,CSE 30,B01,095061,Bhaskar; Nishant,6,0,50,44
1656898957422,CSE 100,A01,083659,Cao; Yingjun,2,4,70,68
1656898963449,CSE 134B,A01,083661,Powell; Thomas Allan,19,0,100,81
1656898969474,CSE 140,A01,083663,Gungor; Onat,14,0,85,71
1656898975506,CSE 140L,A01,083088,Eldon; John,16,0,100,84
1656898981531,CSE 175,A01,083665,Kumar; Rakesh,3,0,25,22
1656898987554,CSE 190,A00,092507,Dubnov; Shlomo,7,0,20,13
1656898993580,ECE 45,A01,083139,Congero; Spencer William,5,0,75,70
1656898999604,ECE 65,A50,083695,Saad; Andrew S,12,0,30,18
1656898999604,ECE 65,A51,095125,Saad; Andrew S,25,0,26,1
1656899005626,ECE 109,A01,091882,Touri; Behrouz,16,0,70,54
1656899011653,ECE 180,A00,083140,Abi Samra; Nicholas Camill,0,0,30,30
1656899011653,ECE 180,B00,083141,Abi Samra; Nicholas Camill,0,0,30,30
1656899017679,MATH 10A,A01,083735,Patchell; Gregory David,1,0,30,29
1656899017679,MATH 10A,A02,083736,Patchell; Gregory David,20,0,30,10
1656899017679,MATH 10A,A03,083737,Patchell; Gregory David,15,0,30,15
1656899023710,MATH 10B,A01,083207,Lim; Seonhee,7,0,34,27
1656899023710,MATH 10B,A02,083208,Lim; Seonhee,9,0,35,26
1656899023710,MATH 10B,A03,093472,Lim; Seonhee,4,0,34,30
1656899023710,MATH 10B,B01,083739,Sinha; Shubham,9,0,30,21
1656899029733,MATH 18,A01,083743,Cinel; Cameron Alexander,6,0,30,24
1656899029733,MATH 18,A02,083744,Cinel; Cameron Alexander,15,0,30,15
1656899029733,MATH 18,A03,083745,Cinel; Cameron Alexander,8,0,30,22
1656899029733,MATH 18,B01,083748,Rideout; David Porter,4,0,37,33
1656899029733,MATH 18,B02,083749,Rideout; David Porter,3,0,36,33
1656899029733,MATH 18,B03,083750,Rideout; David Porter,2,0,37,35
1656899029733,MATH 18,B04,083751,Rideout; David Porter,5,0,36,31
1656899029733,MATH 18,B05,093473,Rideout; David Porter,4,0,36,32
1656899029733,MATH 18,B06,093474,Rideout; David Porter,5,0,36,31
1656899035758,MATH 20A,A01,083754,Zheng; Zequn,12,0,40,28
1656899041781,MATH 20B,A01,083756,Briones; Jor-el Thomas Caparas,1,0,36,35
1656899041781,MATH 20B,A02,083757,Briones; Jor-el Thomas Caparas,1,0,36,35
1656899041781,MATH 20B,A03,093475,Briones; Jor-el Thomas Caparas,0,0,36,36
1656899047809,MATH 20C,A01,083760,Briones; Jor-el Thomas Caparas,1,0,35,34
1656899047809,MATH 20C,A02,083761,Briones; Jor-el Thomas Caparas,8,0,35,27
1656899047809,MATH 20C,A03,093476,Briones; Jor-el Thomas Caparas,0,1,36,36
1656899047809,MATH 20C,B01,083762,Bach; Quang Tran,0,0,30,30
1656899053836,MATH 20D,A01,083765,Tran; Brian Kha,4,0,30,26
1656899053836,MATH 20D,A02,083766,Tran; Brian Kha,4,0,30,26
1656899053836,MATH 20D,A03,083767,Tran; Brian Kha,3,0,30,27
1656899059865,MATH 20E,A01,083771,Ganguly; Soumya,5,0,32,27
1656899059865,MATH 20E,A02,083772,Ganguly; Soumya,6,0,32,26
1656899059865,MATH 20E,B01,083773,Ciotti; Benjamin,18,0,35,17
1656899059865,MATH 20E,B02,083774,Ciotti; Benjamin,17,0,35,18
1656899065887,MATH 103A,A01,083777,Greenfeld; Be'Eri,2,0,36,34
1656899065887,MATH 103A,A02,083778,Greenfeld; Be'Eri,5,0,36,31
1656899065887,MATH 103A,A03,093561,Greenfeld; Be'Eri,4,0,36,32
1656899065887,MATH 103A,B01,083779,Greenfeld; Be'Eri,6,0,36,30
1656899065887,MATH 103A,B02,083780,Greenfeld; Be'Eri,2,0,36,34
1656899065887,MATH 103A,B03,093562,Greenfeld; Be'Eri,2,0,36,34
1656899071911,MATH 105,A01,085443,Carter; Anne Toulson,13,0,35,22
1656899071911,MATH 105,A02,093477,Carter; Anne Toulson,20,0,35,15
1656899077938,MATH 109,A01,083213,Ganzberger; Geoffrey Michael,2,0,34,32
1656899077938,MATH 109,A02,083214,Ganzberger; Geoffrey Michael,2,0,34,32
1656899077938,MATH 109,A03,093478,Ganzberger; Geoffrey Michael,1,0,34,33
1656899077938,MATH 109,B01,083215,Ganzberger; Geoffrey Michael,1,0,32,31
1656899077938,MATH 109,B02,083216,Ganzberger; Geoffrey Michael,1,0,32,31
1656899077938,MATH 109,B03,093479,Ganzberger; Geoffrey Michael,6,0,32,26
1656899083963,MATH 142A,A01,083219,Chow; Bennett,6,0,32,26
1656899083963,MATH 142A,A02,083220,Chow; Bennett,10,0,32,22
1656899083963,MATH 142A,A03,093480,Chow; Bennett,7,0,32,25
1656899083963,MATH 142A,B03,093481,Chow; Bennett,7,0,32,25
1656899083963,MATH 142A,B04,093558,Chow; Bennett,10,0,32,22
1656899083963,MATH 142A,B05,093559,Chow; Bennett,6,0,32,26
1656899089987,MATH 193A,A01,083224,Rotar; Vladimir,7,0,34,27
1656899089987,MATH 193A,A02,083225,Rotar; Vladimir,3,0,34,31
1656899089987,MATH 193A,A03,083781,Rotar; Vladimir,1,0,34,33
1656899089987,MATH 193A,A04,083782,Rotar; Vladimir,6,0,34,28
1656899089987,MATH 193A,A05,093482,Rotar; Vladimir,6,0,34,28
1656899096014,MATH 197,001,091859,McAuley; Julian John,9999,0,9999,0
1656899096014,MATH 197,002,095566,Kedlaya; Kiran S.,9997,0,9999,2
1656899096014,MATH 197,003,095567,Xiao; Ming,9999,0,9999,0
1656899096014,MATH 197,004,095571,Perols; Johan Lars,9998,0,9999,1
1656899103069,COGS 9,A01,083615,Shannon; Kyle Michael,6,0,75,69
1656899109093,COGS 11,A01,083617,Boyle; Mary E. T.,19,0,48,29
1656899115116,COGS 13,A01,083071,Bastos; Amalia Pinkusfeld,8,0,71,63
1656899121139,COGS 14A,A01,092681,Semenuks; Arturs,0,1,100,100
1656899127167,COGS 14B,A01,083073,Cheng; Tzu-Han,5,0,63,58
1656899133189,COGS 17,A01,092677,Semenuks; Arturs,4,0,81,77
1656899139215,COGS 100,A01,083619,Allen; Michael Gordon,15,0,70,55
1656899145242,COGS 101A,A01,083621,Davis; Joshua Daniel,9,0,68,59
1656899151340,COGS 101B,A01,091572,Allen; Michael Gordon,8,0,65,57
1656899157364,COGS 101C,A01,083625,Delgado; Tania,17,0,35,18
1656899163386,COGS 107A,A01,083627,Boyle; Mary E. T.,13,0,60,47
1656899169413,COGS 118A,A01,083075,Gupta; Anjum,15,0,76,61
1656899175436,CSE 3,A50,083646,Miranda; Gregory Joseph,22,0,50,28
1656899181463,CSE 8A,A50,083650,Miranda; Gregory Joseph,17,1,56,39
1656899187486,CSE 11,A01,083080,Cao; Yingjun,4,15,40,36
1656899193508,CSE 12,A01,083652,Krause-Levy; Sophia Louisa,20,1,120,100
1656899199532,CSE 15L,A01,083654,Morris; Justin Loren,8,0,50,42
1656899199532,CSE 15L,A02,083655,Morris; Justin Loren,8,0,50,42
1656899205556,CSE 20,A01,083657,Tran; Khoa Dang,37,0,80,43
1656899211583,CSE 21,A01,095574,Bach; Quang Tran,21,0,48,27
1656899217611,CSE 30,A01,083084,Eldon; John,4,0,80,76
1656899217611,CSE 30,B01,095061,Bhaskar; Nishant,6,0,50,44
1656899223636,CSE 100,A01,083659,Cao; Yingjun,2,4,70,68
1656899229662,CSE 134B,A01,083661,Powell; Thomas Allan,19,0,100,81
1656899235685,CSE 140,A01,083663,Gungor; Onat,14,0,85,71
1656899241710,CSE 140L,A01,083088,Eldon; John,16,0,100,84
1656899247746,CSE 175,A01,083665,Kumar; Rakesh,3,0,25,22
1656899253769,CSE 190,A00,092507,Dubnov; Shlomo,7,0,20,13
1656899259792,ECE 45,A01,083139,Congero; Spencer William,5,0,75,70
1656899265818,ECE 65,A50,083695,Saad; Andrew S,12,0,30,18
1656899265818,ECE 65,A51,095125,Saad; Andrew S,25,0,26,1
1656899271844,ECE 109,A01,091882,Touri; Behrouz,16,0,70,54
1656899277871,ECE 180,A00,083140,Abi Samra; Nicholas Camill,0,0,30,30
1656899277871,ECE 180,B00,083141,Abi Samra; Nicholas Camill,0,0,30,30
1656899283895,MATH 10A,A01,083735,Patchell; Gregory David,1,0,30,29
1656899283895,MATH 10A,A02,083736,Patchell; Gregory David,20,0,30,10
1656899283895,MATH 10A,A03,083737,Patchell; Gregory David,15,0,30,15
1656899289920,MATH 10B,A01,083207,Lim; Seonhee,7,0,34,27
1656899289920,MATH 10B,A02,083208,Lim; Seonhee,9,0,35,26
1656899289920,MATH 10B,A03,093472,Lim; Seonhee,4,0,34,30
1656899289920,MATH 10B,B01,083739,Sinha; Shubham,9,0,30,21
1656899295944,MATH 18,A01,083743,Cinel; Cameron Alexander,6,0,30,24
1656899295944,MATH 18,A02,083744,Cinel; Cameron Alexander,15,0,30,15
1656899295944,MATH 18,A03,083745,Cinel; Cameron Alexander,8,0,30,22
1656899295944,MATH 18,B01,083748,Rideout; David Porter,4,0,37,33
1656899295944,MATH 18,B02,083749,Rideout; David Porter,3,0,36,33
1656899295944,MATH 18,B03,083750,Rideout; David Porter,2,0,37,35
1656899295944,MATH 18,B04,083751,Rideout; David Porter,5,0,36,31
1656899295944,MATH 18,B05,093473,Rideout; David Porter,4,0,36,32
1656899295944,MATH 18,B06,093474,Rideout; David Porter,5,0,36,31
1656899301967,MATH 20A,A01,083754,Zheng; Zequn,12,0,40,28
1656899308004,MATH 20B,A01,083756,Briones; Jor-el Thomas Caparas,1,0,36,35
1656899308004,MATH 20B,A02,083757,Briones; Jor-el Thomas Caparas,1,0,36,35
1656899308004,MATH 20B,A03,093475,Briones; Jor-el Thomas Caparas,0,0,36,36
1656899314033,MATH 20C,A01,083760,Briones; Jor-el Thomas Caparas,1,0,35,34
1656899314033,MATH 20C,A02,083761,Briones; Jor-el Thomas Caparas,8,0,35,27
1656899314033,MATH 20C,A03,093476,Briones; Jor-el Thomas Caparas,0,1,36,36
1656899314033,MATH 20C,B01,083762,Bach; Quang Tran,0,0,30,30
1656899320061,MATH 20D,A01,083765,Tran; Brian Kha,4,0,30,26
1656899320061,MATH 20D,A02,083766,Tran; Brian Kha,4,0,30,26
1656899320061,MATH 20D,A03,083767,Tran; Brian Kha,3,0,30,27
1656899326085,MATH 20E,A01,083771,Ganguly; Soumya,5,0,32,27
1656899326085,MATH 20E,A02,083772,Ganguly; Soumya,6,0,32,26
1656899326085,MATH 20E,B01,083773,Ciotti; Benjamin,18,0,35,17
1656899326085,MATH 20E,B02,083774,Ciotti; Benjamin,17,0,35,18
1656899332109,MATH 103A,A01,083777,Greenfeld; Be'Eri,2,0,36,34
1656899332109,MATH 103A,A02,083778,Greenfeld; Be'Eri,5,0,36,31
1656899332109,MATH 103A,A03,093561,Greenfeld; Be'Eri,4,0,36,32
1656899332109,MATH 103A,B01,083779,Greenfeld; Be'Eri,6,0,36,30
1656899332109,MATH 103A,B02,083780,Greenfeld; Be'Eri,2,0,36,34
1656899332109,MATH 103A,B03,093562,Greenfeld; Be'Eri,2,0,36,34
1656899338148,MATH 105,A01,085443,Carter; Anne Toulson,13,0,35,22
1656899338148,MATH 105,A02,093477,Carter; Anne Toulson,20,0,35,15
1656899344176,MATH 109,A01,083213,Ganzberger; Geoffrey Michael,2,0,34,32
1656899344176,MATH 109,A02,083214,Ganzberger; Geoffrey Michael,2,0,34,32
1656899344176,MATH 109,A03,093478,Ganzberger; Geoffrey Michael,1,0,34,33
1656899344176,MATH 109,B01,083215,Ganzberger; Geoffrey Michael,1,0,32,31
1656899344176,MATH 109,B02,083216,Ganzberger; Geoffrey Michael,1,0,32,31
1656899344176,MATH 109,B03,093479,Ganzberger; Geoffrey Michael,6,0,32,26
1656899350200,MATH 142A,A01,083219,Chow; Bennett,6,0,32,26
1656899350200,MATH 142A,A02,083220,Chow; Bennett,10,0,32,22
1656899350200,MATH 142A,A03,093480,Chow; Bennett,7,0,32,25
1656899350200,MATH 142A,B03,093481,Chow; Bennett,7,0,32,25
1656899350200,MATH 142A,B04,093558,Chow; Bennett,10,0,32,22
1656899350200,MATH 142A,B05,093559,Chow; Bennett,6,0,32,26
1656899356228,MATH 193A,A01,083224,Rotar; Vladimir,7,0,34,27
1656899356228,MATH 193A,A02,083225,Rotar; Vladimir,3,0,34,31
1656899356228,MATH 193A,A03,083781,Rotar; Vladimir,1,0,34,33
1656899356228,MATH 193A,A04,083782,Rotar; Vladimir,6,0,34,28
1656899356228,MATH 193A,A05,093482,Rotar; Vladimir,6,0,34,28
1656899362251,MATH 197,001,091859,McAuley; Julian John,9999,0,9999,0
1656899362251,MATH 197,002,095566,Kedlaya; Kiran S.,9997,0,9999,2
1656899362251,MATH 197,003,095567,Xiao; Ming,9999,0,9999,0
1656899362251,MATH 197,004,095571,Perols; Johan Lars,9998,0,9999,1
1656899369302,COGS 9,A01,083615,Shannon; Kyle Michael,6,0,75,69
1656899375325,COGS 11,A01,083617,Boyle; Mary E. T.,19,0,48,29
1656899381353,COGS 13,A01,083071,Bastos; Amalia Pinkusfeld,8,0,71,63
1656899387386,COGS 14A,A01,092681,Semenuks; Arturs,0,1,100,100
1656899393408,COGS 14B,A01,083073,Cheng; Tzu-Han,5,0,63,58
1656899399435,COGS 17,A01,092677,Semenuks; Arturs,4,0,81,77
1656899405460,COGS 100,A01,083619,Allen; Michael Gordon,15,0,70,55
1656899411486,COGS 101A,A01,083621,Davis; Joshua Daniel,9,0,68,59
1656899417507,COGS 101B,A01,091572,Allen; Michael Gordon,8,0,65,57
1656899423534,COGS 101C,A01,083625,Delgado; Tania,17,0,35,18
1656899429560,COGS 107A,A01,083627,Boyle; Mary E. T.,13,0,60,47
1656899435583,COGS 118A,A01,083075,Gupta; Anjum,15,0,76,61
1656899441606,CSE 3,A50,083646,Miranda; Gregory Joseph,22,0,50,28
1656899447634,CSE 8A,A50,083650,Miranda; Gregory Joseph,17,1,56,39
1656899453660,CSE 11,A01,083080,Cao; Yingjun,4,15,40,36
1656899459682,CSE 12,A01,083652,Krause-Levy; Sophia Louisa,20,1,120,100
1656899465709,CSE 15L,A01,083654,Morris; Justin Loren,8,0,50,42
1656899465709,CSE 15L,A02,083655,Morris; Justin Loren,8,0,50,42
1656899471732,CSE 20,A01,083657,Tran; Khoa Dang,37,0,80,43
1656899477755,CSE 21,A01,095574,Bach; Quang Tran,21,0,48,27
1656899483786,CSE 30,A01,083084,Eldon; John,4,0,80,76
1656899483786,CSE 30,B01,095061,Bhaskar; Nishant,6,0,50,44
1656899489809,CSE 100,A01,083659,Cao; Yingjun,2,4,70,68
1656899495836,CSE 134B,A01,083661,Powell; Thomas Allan,19,0,100,81
1656899501859,CSE 140,A01,083663,Gungor; Onat,14,0,85,71
1656899507883,CSE 140L,A01,083088,Eldon; John,16,0,100,84
1656899513906,CSE 175,A01,083665,Kumar; Rakesh,3,0,25,22
1656899519933,CSE 190,A00,092507,Dubnov; Shlomo,7,0,20,13
1656899525954,ECE 45,A01,083139,Congero; Spencer William,5,0,75,70
1656899531977,ECE 65,A50,083695,Saad; Andrew S,12,0,30,18
1656899531977,ECE 65,A51,095125,Saad; Andrew S,25,0,26,1
1656899538000,ECE 109,A01,091882,Touri; Behrouz,16,0,70,54
1656899544024,ECE 180,A00,083140,Abi Samra; Nicholas Camill,0,0,30,30
1656899544024,ECE 180,B00,083141,Abi Samra; Nicholas Camill,0,0,30,30
1656899550046,MATH 10A,A01,083735,Patchell; Gregory David,1,0,30,29
1656899550046,MATH 10A,A02,083736,Patchell; Gregory David,20,0,30,10
1656899550046,MATH 10A,A03,083737,Patchell; Gregory David,15,0,30,15
1656899556081,MATH 10B,A01,083207,Lim; Seonhee,7,0,34,27
1656899556081,MATH 10B,A02,083208,Lim; Seonhee,9,0,35,26
1656899556081,MATH 10B,A03,093472,Lim; Seonhee,4,0,34,30
1656899556081,MATH 10B,B01,083739,Sinha; Shubham,9,0,30,21
1656899562113,MATH 18,A01,083743,Cinel; Cameron Alexander,6,0,30,24
1656899562113,MATH 18,A02,083744,Cinel; Cameron Alexander,15,0,30,15
1656899562113,MATH 18,A03,083745,Cinel; Cameron Alexander,8,0,30,22
1656899562113,MATH 18,B01,083748,Rideout; David Porter,4,0,37,33
1656899562113,MATH 18,B02,083749,Rideout; David Porter,3,0,36,33
1656899562113,MATH 18,B03,083750,Rideout; David Porter,2,0,37,35
1656899562113,MATH 18,B04,083751,Rideout; David Porter,5,0,36,31
1656899562113,MATH 18,B05,093473,Rideout; David Porter,4,0,36,32
1656899562113,MATH 18,B06,093474,Rideout; David Porter,5,0,36,31
1656899568138,MATH 20A,A01,083754,Zheng; Zequn,12,0,40,28
1656899574161,MATH 20B,A01,083756,Briones; Jor-el Thomas Caparas,1,0,36,35
1656899574161,MATH 20B,A02,083757,Briones; Jor-el Thomas Caparas,1,0,36,35
1656899574161,MATH 20B,A03,093475,Briones; Jor-el Thomas Caparas,0,0,36,36
1656899580183,MATH 20C,A01,083760,Briones; Jor-el Thomas Caparas,1,0,35,34
1656899580183,MATH 20C,A02,083761,Briones; Jor-el Thomas Caparas,8,0,35,27
1656899580183,MATH 20C,A03,093476,Briones; Jor-el Thomas Caparas,0,1,36,36
1656899580183,MATH 20C,B01,083762,Bach; Quang Tran,0,0,30,30
1656899586215,MATH 20D,A01,083765,Tran; Brian Kha,4,0,30,26
1656899586215,MATH 20D,A02,083766,Tran; Brian Kha,4,0,30,26
1656899586215,MATH 20D,A03,083767,Tran; Brian Kha,3,0,30,27
1656899592243,MATH 20E,A01,083771,Ganguly; Soumya,5,0,32,27
1656899592243,MATH 20E,A02,083772,Ganguly; Soumya,6,0,32,26
1656899592243,MATH 20E,B01,083773,Ciotti; Benjamin,18,0,35,17
1656899592243,MATH 20E,B02,083774,Ciotti; Benjamin,17,0,35,18
1656899598270,MATH 103A,A01,083777,Greenfeld; Be'Eri,2,0,36,34
1656899598270,MATH 103A,A02,083778,Greenfeld; Be'Eri,5,0,36,31
1656899598270,MATH 103A,A03,093561,Greenfeld; Be'Eri,4,0,36,32
1656899598270,MATH 103A,B01,083779,Greenfeld; Be'Eri,6,0,36,30
1656899598270,MATH 103A,B02,083780,Greenfeld; Be'Eri,2,0,36,34
1656899598270,MATH 103A,B03,093562,Greenfeld; Be'Eri,2,0,36,34
1656899604297,MATH 105,A01,085443,Carter; Anne Toulson,13,0,35,22
1656899604297,MATH 105,A02,093477,Carter; Anne Toulson,20,0,35,15
1656899610325,MATH 109,A01,083213,Ganzberger; Geoffrey Michael,2,0,34,32
1656899610325,MATH 109,A02,083214,Ganzberger; Geoffrey Michael,2,0,34,32
1656899610325,MATH 109,A03,093478,Ganzberger; Geoffrey Michael,1,0,34,33
1656899610325,MATH 109,B01,083215,Ganzberger; Geoffrey Michael,1,0,32,31
1656899610325,MATH 109,B02,083216,Ganzberger; Geoffrey Michael,1,0,32,31
1656899610325,MATH 109,B03,093479,Ganzberger; Geoffrey Michael,6,0,32,26
1656899616350,MATH 142A,A01,083219,Chow; Bennett,6,0,32,26
1656899616350,MATH 142A,A02,083220,Chow; Bennett,10,0,32,22
1656899616350,MATH 142A,A03,093480,Chow; Bennett,7,0,32,25
1656899616350,MATH 142A,B03,093481,Chow; Bennett,7,0,32,25
1656899616350,MATH 142A,B04,093558,Chow; Bennett,10,0,32,22
1656899616350,MATH 142A,B05,093559,Chow; Bennett,6,0,32,26
1656899622378,MATH 193A,A01,083224,Rotar; Vladimir,7,0,34,27
1656899622378,MATH 193A,A02,083225,Rotar; Vladimir,3,0,34,31
1656899622378,MATH 193A,A03,083781,Rotar; Vladimir,1,0,34,33
1656899622378,MATH 193A,A04,083782,Rotar; Vladimir,6,0,34,28
1656899622378,MATH 193A,A05,093482,Rotar; Vladimir,6,0,34,28
1656899628412,MATH 197,001,091859,McAuley; Julian John,9999,0,9999,0
1656899628412,MATH 197,002,095566,Kedlaya; Kiran S.,9997,0,9999,2
1656899628412,MATH 197,003,095567,Xiao; Ming,9999,0,9999,0
1656899628412,MATH 197,004,095571,Perols; Johan Lars,9998,0,9999,1
1656899635473,COGS 9,A01,083615,Shannon; Kyle Michael,6,0,75,69
1656899641501,COGS 11,A01,083617,Boyle; Mary E. T.,19,0,48,29
1656899647524,COGS 13,A01,083071,Bastos; Amalia Pinkusfeld,8,0,71,63
1656899653552,COGS 14A,A01,092681,Semenuks; Arturs,0,1,100,100
1656899659579,COGS 14B,A01,083073,Cheng; Tzu-Han,5,0,63,58
1656899665601,COGS 17,A01,092677,Semenuks; Arturs,4,0,81,77
1656899671625,COGS 100,A01,083619,Allen; Michael Gordon,15,0,70,55
1656899677652,COGS 101A,A01,083621,Davis; Joshua Daniel,9,0,68,59
1656899683675,COGS 101B,A01,091572,Allen; Michael Gordon,8,0,65,57
1656899689699,COGS 101C,A01,083625,Delgado; Tania,17,0,35,18
1656899695721,COGS 107A,A01,083627,Boyle; Mary E. T.,13,0,60,47
1656899701743,COGS 118A,A01,083075,Gupta; Anjum,15,0,76,61
1656899707765,CSE 3,A50,083646,Miranda; Gregory Joseph,22,0,50,28
1656899713791,CSE 8A,A50,083650,Miranda; Gregory Joseph,17,1,56,39
1656899719813,CSE 11,A01,083080,Cao; Yingjun,4,15,40,36
1656899725840,CSE 12,A01,083652,Krause-Levy; Sophia Louisa,20,1,120,100
1656899731862,CSE 15L,A01,083654,Morris; Justin Loren,8,0,50,42
1656899731862,CSE 15L,A02,083655,Morris; Justin Loren,8,0,50,42
1656899737884,CSE 20,A01,083657,Tran; Khoa Dang,37,0,80,43
1656899743908,CSE 21,A01,095574,Bach; Quang Tran,21,0,48,27
1656899750004,CSE 30,A01,083084,Eldon; John,4,0,80,76
1656899750004,CSE 30,B01,095061,Bhaskar; Nishant,6,0,50,44
1656899756028,CSE 100,A01,083659,Cao; Yingjun,2,4,70,68
1656899762052,CSE 134B,A01,083661,Powell; Thomas Allan,19,0,100,81
1656899768076,CSE 140,A01,083663,Gungor; Onat,14,0,85,71
1656899774103,CSE 140L,A01,083088,Eldon; John,16,0,100,84
1656899780126,CSE 175,A01,083665,Kumar; Rakesh,3,0,25,22
1656899786152,CSE 190,A00,092507,Dubnov; Shlomo,7,0,20,13
1656899792175,ECE 45,A01,083139,Congero; Spencer William,5,0,75,70
1656899798198,ECE 65,A50,083695,Saad; Andrew S,12,0,30,18
1656899798198,ECE 65,A51,095125,Saad; Andrew S,25,0,26,1
1656899804224,ECE 109,A01,091882,Touri; Behrouz,16,0,70,54
1656899810250,ECE 180,A00,083140,Abi Samra; Nicholas Camill,0,0,30,30
1656899810250,ECE 180,B00,083141,Abi Samra; Nicholas Camill,0,0,30,30
1656899816273,MATH 10A,A01,083735,Patchell; Gregory David,1,0,30,29
1656899816273,MATH 10A,A02,083736,Patchell; Gregory David,20,0,30,10
1656899816273,MATH 10A,A03,083737,Patchell; Gregory David,15,0,30,15
1656899822297,MATH 10B,A01,083207,Lim; Seonhee,7,0,34,27
1656899822297,MATH 10B,A02,083208,Lim; Seonhee,9,0,35,26
1656899822297,MATH 10B,A03,093472,Lim; Seonhee,4,0,34,30
1656899822297,MATH 10B,B01,083739,Sinha; Shubham,9,0,30,21
1656899828328,MATH 18,A01,083743,Cinel; Cameron Alexander,6,0,30,24
1656899828328,MATH 18,A02,083744,Cinel; Cameron Alexander,15,0,30,15
1656899828328,MATH 18,A03,083745,Cinel; Cameron Alexander,8,0,30,22
1656899828328,MATH 18,B01,083748,Rideout; David Porter,4,0,37,33
1656899828328,MATH 18,B02,083749,Rideout; David Porter,3,0,36,33
1656899828328,MATH 18,B03,083750,Rideout; David Porter,2,0,37,35
1656899828328,MATH 18,B04,083751,Rideout; David Porter,5,0,36,31
1656899828328,MATH 18,B05,093473,Rideout; David Porter,4,0,36,32
1656899828328,MATH 18,B06,093474,Rideout; David Porter,5,0,36,31
1656899834355,MATH 20A,A01,083754,Zheng; Zequn,12,0,40,28
1656899840377,MATH 20B,A01,083756,Briones; Jor-el Thomas Caparas,1,0,36,35
1656899840377,MATH 20B,A02,083757,Briones; Jor-el Thomas Caparas,1,0,36,35
1656899840377,MATH 20B,A03,093475,Briones; Jor-el Thomas Caparas,0,0,36,36
1656899846400,MATH 20C,A01,083760,Briones; Jor-el Thomas Caparas,1,0,35,34
1656899846400,MATH 20C,A02,083761,Briones; Jor-el Thomas Caparas,8,0,35,27
1656899846400,MATH 20C,A03,093476,Briones; Jor-el Thomas Caparas,0,1,36,36
1656899846400,MATH 20C,B01,083762,Bach; Quang Tran,0,0,30,30
1656899852423,MATH 20D,A01,083765,Tran; Brian Kha,4,0,30,26
1656899852423,MATH 20D,A02,083766,Tran; Brian Kha,4,0,30,26
1656899852423,MATH 20D,A03,083767,Tran; Brian Kha,3,0,30,27
1656899858447,MATH 20E,A01,083771,Ganguly; Soumya,5,0,32,27
1656899858447,MATH 20E,A02,083772,Ganguly; Soumya,6,0,32,26
1656899858447,MATH 20E,B01,083773,Ciotti; Benjamin,18,0,35,17
1656899858447,MATH 20E,B02,083774,Ciotti; Benjamin,17,0,35,18
1656899864478,MATH 103A,A01,083777,Greenfeld; Be'Eri,2,0,36,34
1656899864478,MATH 103A,A02,083778,Greenfeld; Be'Eri,5,0,36,31
1656899864478,MATH 103A,A03,093561,Greenfeld; Be'Eri,4,0,36,32
1656899864478,MATH 103A,B01,083779,Greenfeld; Be'Eri,6,0,36,30
1656899864478,MATH 103A,B02,083780,Greenfeld; Be'Eri,2,0,36,34
1656899864478,MATH 103A,B03,093562,Greenfeld; Be'Eri,2,0,36,34
1656899870511,MATH 105,A01,085443,Carter; Anne Toulson,13,0,35,22
1656899870511,MATH 105,A02,093477,Carter; Anne Toulson,20,0,35,15
1656899876540,MATH 109,A01,083213,Ganzberger; Geoffrey Michael,2,0,34,32
1656899876540,MATH 109,A02,083214,Ganzberger; Geoffrey Michael,2,0,34,32
1656899876540,MATH 109,A03,093478,Ganzberger; Geoffrey Michael,1,0,34,33
1656899876540,MATH 109,B01,083215,Ganzberger; Geoffrey Michael,1,0,32,31
1656899876540,MATH 109,B02,083216,Ganzberger; Geoffrey Michael,1,0,32,31
1656899876540,MATH 109,B03,093479,Ganzberger; Geoffrey Michael,6,0,32,26
1656899882573,MATH 142A,A01,083219,Chow; Bennett,6,0,32,26
1656899882573,MATH 142A,A02,083220,Chow; Bennett,10,0,32,22
1656899882573,MATH 142A,A03,093480,Chow; Bennett,7,0,32,25
1656899882573,MATH 142A,B03,093481,Chow; Bennett,7,0,32,25
1656899882573,MATH 142A,B04,093558,Chow; Bennett,10,0,32,22
1656899882573,MATH 142A,B05,093559,Chow; Bennett,6,0,32,26
1656899888601,MATH 193A,A01,083224,Rotar; Vladimir,7,0,34,27
1656899888601,MATH 193A,A02,083225,Rotar; Vladimir,3,0,34,31
1656899888601,MATH 193A,A03,083781,Rotar; Vladimir,1,0,34,33
1656899888601,MATH 193A,A04,083782,Rotar; Vladimir,6,0,34,28
1656899888601,MATH 193A,A05,093482,Rotar; Vladimir,6,0,34,28
1656899894627,MATH 197,001,091859,McAuley; Julian John,9999,0,9999,0
1656899894627,MATH 197,002,095566,Kedlaya; Kiran S.,9997,0,9999,2
1656899894627,MATH 197,003,095567,Xiao; Ming,9999,0,9999,0
1656899894627,MATH 197,004,095571,Perols; Johan Lars,9998,0,9999,1
1656899901691,COGS 9,A01,083615,Shannon; Kyle Michael,6,0,75,69
1656899907713,COGS 11,A01,083617,Boyle; Mary E. T.,19,0,48,29
1656899913737,COGS 13,A01,083071,Bastos; Amalia Pinkusfeld,8,0,71,63
1656899919763,COGS 14A,A01,092681,Semenuks; Arturs,0,1,100,100
1656899925785,COGS 14B,A01,083073,Cheng; Tzu-Han,5,0,63,58
1656899931808,COGS 17,A01,092677,Semenuks; Arturs,4,0,81,77
1656899937832,COGS 100,A01,083619,Allen; Michael Gordon,15,0,70,55
1656899943859,COGS 101A,A01,083621,Davis; Joshua Daniel,9,0,68,59
1656899949887,COGS 101B,A01,091572,Allen; Michael Gordon,8,0,65,57
1656899955908,COGS 101C,A01,083625,Delgado; Tania,17,0,35,18
1656899961934,COGS 107A,A01,083627,Boyle; Mary E. T.,13,0,60,47
1656899967956,COGS 118A,A01,083075,Gupta; Anjum,15,0,76,61
1656899973979,CSE 3,A50,083646,Miranda; Gregory Joseph,22,0,50,28
1656899980002,CSE 8A,A50,083650,Miranda; Gregory Joseph,17,1,56,39
1656899986035,CSE 11,A01,083080,Cao; Yingjun,4,15,40,36
1656899992059,CSE 12,A01,083652,Krause-Levy; Sophia Louisa,20,1,120,100
1656899998086,CSE 15L,A01,083654,Morris; Justin Loren,8,0,50,42
1656899998086,CSE 15L,A02,083655,Morris; Justin Loren,8,0,50,42
1656900004117,CSE 20,A01,083657,Tran; Khoa Dang,37,0,80,43
1656900010139,CSE 21,A01,095574,Bach; Quang Tran,21,0,48,27
1656900016162,CSE 30,A01,083084,Eldon; John,4,0,80,76
1656900016162,CSE 30,B01,095061,Bhaskar; Nishant,6,0,50,44
1656900022189,CSE 100,A01,083659,Cao; Yingjun,2,4,70,68
1656900028217,CSE 134B,A01,083661,Powell; Thomas Allan,19,0,100,81
1656900034242,CSE 140,A01,083663,Gungor; Onat,14,0,85,71
1656900040265,CSE 140L,A01,083088,Eldon; John,16,0,100,84
1656900046290,CSE 175,A01,083665,Kumar; Rakesh,3,0,25,22
1656900052314,CSE 190,A00,092507,Dubnov; Shlomo,7,0,20,13
1656900058340,ECE 45,A01,083139,Congero; Spencer William,5,0,75,70
1656900064362,ECE 65,A50,083695,Saad; Andrew S,12,0,30,18
1656900064362,ECE 65,A51,095125,Saad; Andrew S,25,0,26,1
1656900070388,ECE 109,A01,091882,Touri; Behrouz,16,0,70,54
1656900076416,ECE 180,A00,083140,Abi Samra; Nicholas Camill,0,0,30,30
1656900076416,ECE 180,B00,083141,Abi Samra; Nicholas Camill,0,0,30,30
1656900082439,MATH 10A,A01,083735,Patchell; Gregory David,1,0,30,29
1656900082439,MATH 10A,A02,083736,Patchell; Gregory David,20,0,30,10
1656900082439,MATH 10A,A03,083737,Patchell; Gregory David,15,0,30,15
1656900088469,MATH 10B,A01,083207,Lim; Seonhee,7,0,34,27
1656900088469,MATH 10B,A02,083208,Lim; Seonhee,9,0,35,26
1656900088469,MATH 10B,A03,093472,Lim; Seonhee,4,0,34,30
1656900088469,MATH 10B,B01,083739,Sinha; Shubham,9,0,30,21
1656900094502,MATH 18,A01,083743,Cinel; Cameron Alexander,6,0,30,24
1656900094502,MATH 18,A02,083744,Cinel; Cameron Alexander,15,0,30,15
1656900094502,MATH 18,A03,083745,Cinel; Cameron Alexander,8,0,30,22
1656900094502,MATH 18,B01,083748,Rideout; David Porter,4,0,37,33
1656900094502,MATH 18,B02,083749,Rideout; David Porter,3,0,36,33
1656900094502,MATH 18,B03,083750,Rideout; David Porter,2,0,37,35
1656900094502,MATH 18,B04,083751,Rideout; David Porter,5,0,36,31
1656900094502,MATH 18,B05,093473,Rideout; David Porter,4,0,36,32
1656900094502,MATH 18,B06,093474,Rideout; David Porter,5,0,36,31
1656900100525,MATH 20A,A01,083754,Zheng; Zequn,12,0,40,28
1656900106554,MATH 20B,A01,083756,Briones; Jor-el Thomas Caparas,1,0,36,35
1656900106554,MATH 20B,A02,083757,Briones; Jor-el Thomas Caparas,1,0,36,35
1656900106554,MATH 20B,A03,093475,Briones; Jor-el Thomas Caparas,0,0,36,36
1656900112580,MATH 20C,A01,083760,Briones; Jor-el Thomas Caparas,1,0,35,34
1656900112580,MATH 20C,A02,083761,Briones; Jor-el Thomas Caparas,8,0,35,27
1656900112580,MATH 20C,A03,093476,Briones; Jor-el Thomas Caparas,0,1,36,36
1656900112580,MATH 20C,B01,083762,Bach; Quang Tran,0,0,30,30
1656900118603,MATH 20D,A01,083765,Tran; Brian Kha,4,0,30,26
1656900118603,MATH 20D,A02,083766,Tran; Brian Kha,4,0,30,26
1656900118603,MATH 20D,A03,083767,Tran; Brian Kha,3,0,30,27
1656900124629,MATH 20E,A01,083771,Ganguly; Soumya,5,0,32,27
1656900124629,MATH 20E,A02,083772,Ganguly; Soumya,6,0,32,26
1656900124629,MATH 20E,B01,083773,Ciotti; Benjamin,18,0,35,17
1656900124629,MATH 20E,B02,083774,Ciotti; Benjamin,17,0,35,18
1656900130651,MATH 103A,A01,083777,Greenfeld; Be'Eri,2,0,36,34
1656900130651,MATH 103A,A02,083778,Greenfeld; Be'Eri,5,0,36,31
1656900130651,MATH 103A,A03,093561,Greenfeld; Be'Eri,4,0,36,32
1656900130651,MATH 103A,B01,083779,Greenfeld; Be'Eri,6,0,36,30
1656900130651,MATH 103A,B02,083780,Greenfeld; Be'Eri,2,0,36,34
1656900130651,MATH 103A,B03,093562,Greenfeld; Be'Eri,2,0,36,34
1656900136679,MATH 105,A01,085443,Carter; Anne Toulson,13,0,35,22
1656900136679,MATH 105,A02,093477,Carter; Anne Toulson,20,0,35,15
1656900142707,MATH 109,A01,083213,Ganzberger; Geoffrey Michael,2,0,34,32
1656900142707,MATH 109,A02,083214,Ganzberger; Geoffrey Michael,2,0,34,32
1656900142707,MATH 109,A03,093478,Ganzberger; Geoffrey Michael,1,0,34,33
1656900142707,MATH 109,B01,083215,Ganzberger; Geoffrey Michael,1,0,32,31
1656900142707,MATH 109,B02,083216,Ganzberger; Geoffrey Michael,1,0,32,31
1656900142707,MATH 109,B03,093479,Ganzberger; Geoffrey Michael,6,0,32,26
1656900148735,MATH 142A,A01,083219,Chow; Bennett,6,0,32,26
1656900148735,MATH 142A,A02,083220,Chow; Bennett,10,0,32,22
1656900148735,MATH 142A,A03,093480,Chow; Bennett,7,0,32,25
1656900148735,MATH 142A,B03,093481,Chow; Bennett,7,0,32,25
1656900148735,MATH 142A,B04,093558,Chow; Bennett,10,0,32,22
1656900148735,MATH 142A,B05,093559,Chow; Bennett,6,0,32,26
1656900154757,MATH 193A,A01,083224,Rotar; Vladimir,7,0,34,27
1656900154757,MATH 193A,A02,083225,Rotar; Vladimir,3,0,34,31
1656900154757,MATH 193A,A03,083781,Rotar; Vladimir,1,0,34,33
1656900154757,MATH 193A,A04,083782,Rotar; Vladimir,6,0,34,28
1656900154757,MATH 193A,A05,093482,Rotar; Vladimir,6,0,34,28
1656900160785,MATH 197,001,091859,McAuley; Julian John,9999,0,9999,0
1656900160785,MATH 197,002,095566,Kedlaya; Kiran S.,9997,0,9999,2
1656900160785,MATH 197,003,095567,Xiao; Ming,9999,0,9999,0
1656900160785,MATH 197,004,095571,Perols; Johan Lars,9998,0,9999,1
1656900167836,COGS 9,A01,083615,Shannon; Kyle Michael,6,0,75,69
1656900173860,COGS 11,A01,083617,Boyle; Mary E. T.,19,0,48,29
1656900179881,COGS 13,A01,083071,Bastos; Amalia Pinkusfeld,8,0,71,63
1656900185905,COGS 14A,A01,092681,Semenuks; Arturs,0,1,100,100
1656900191928,COGS 14B,A01,083073,Cheng; Tzu-Han,5,0,63,58
1656900197950,COGS 17,A01,092677,Semenuks; Arturs,4,0,81,77
1656900203974,COGS 100,A01,083619,Allen; Michael Gordon,15,0,70,55
1656900209998,COGS 101A,A01,083621,Davis; Joshua Daniel,9,0,68,59
1656900216021,COGS 101B,A01,091572,Allen; Michael Gordon,8,0,65,57
1656900222043,COGS 101C,A01,083625,Delgado; Tania,17,0,35,18
1656900228069,COGS 107A,A01,083627,Boyle; Mary E. T.,13,0,60,47
1656900234095,COGS 118A,A01,083075,Gupta; Anjum,15,0,76,61
1656900240123,CSE 3,A50,083646,Miranda; Gregory Joseph,22,0,50,28
1656900246150,CSE 8A,A50,083650,Miranda; Gregory Joseph,17,1,56,39
1656900252177,CSE 11,A01,083080,Cao; Yingjun,4,15,40,36
1656900258203,CSE 12,A01,083652,Krause-Levy; Sophia Louisa,20,1,120,100
1656900264229,CSE 15L,A01,083654,Morris; Justin Loren,8,0,50,42
1656900264229,CSE 15L,A02,083655,Morris; Justin Loren,8,0,50,42
1656900270253,CSE 20,A01,083657,Tran; Khoa Dang,37,0,80,43
1656900276280,CSE 21,A01,095574,Bach; Quang Tran,21,0,48,27
1656900282307,CSE 30,A01,083084,Eldon; John,4,0,80,76
1656900282307,CSE 30,B01,095061,Bhaskar; Nishant,6,0,50,44
1656900288331,CSE 100,A01,083659,Cao; Yingjun,2,4,70,68
1656900294357,CSE 134B,A01,083661,Powell; Thomas Allan,19,0,100,81
1656900300383,CSE 140,A01,083663,Gungor; Onat,14,0,85,71
1656900306406,CSE 140L,A01,083088,Eldon; John,16,0,100,84
1656900312431,CSE 175,A01,083665,Kumar; Rakesh,3,0,25,22
1656900318453,CSE 190,A00,092507,Dubnov; Shlomo,7,0,20,13
1656900324476,ECE 45,A01,083139,Congero; Spencer William,5,0,75,70
1656900330498,ECE 65,A50,083695,Saad; Andrew S,12,0,30,18
1656900330498,ECE 65,A51,095125,Saad; Andrew S,25,0,26,1
1656900336525,ECE 109,A01,091882,Touri; Behrouz,16,0,70,54
1656900342549,ECE 180,A00,083140,Abi Samra; Nicholas Camill,0,0,30,30
1656900342549,ECE 180,B00,083141,Abi Samra; Nicholas Camill,0,0,30,30
1656900348641,MATH 10A,A01,083735,Patchell; Gregory David,1,0,30,29
1656900348641,MATH 10A,A02,083736,Patchell; Gregory David,20,0,30,10
1656900348641,MATH 10A,A03,083737,Patchell; Gregory David,15,0,30,15
1656900354669,MATH 10B,A01,083207,Lim; Seonhee,7,0,34,27
1656900354669,MATH 10B,A02,083208,Lim; Seonhee,9,0,35,26
1656900354669,MATH 10B,A03,093472,Lim; Seonhee,4,0,34,30
1656900354669,MATH 10B,B01,083739,Sinha; Shubham,9,0,30,21
1656900360700,MATH 18,A01,083743,Cinel; Cameron Alexander,6,0,30,24
1656900360700,MATH 18,A02,083744,Cinel; Cameron Alexander,15,0,30,15
1656900360700,MATH 18,A03,083745,Cinel; Cameron Alexander,8,0,30,22
1656900360700,MATH 18,B01,083748,Rideout; David Porter,4,0,37,33
1656900360700,MATH 18,B02,083749,Rideout; David Porter,3,0,36,33
1656900360700,MATH 18,B03,083750,Rideout; David Porter,2,0,37,35
1656900360700,MATH 18,B04,083751,Rideout; David Porter,5,0,36,31
1656900360700,MATH 18,B05,093473,Rideout; David Porter,4,0,36,32
1656900360700,MATH 18,B06,093474,Rideout; David Porter,5,0,36,31
1656900366724,MATH 20A,A01,083754,Zheng; Zequn,12,0,40,28
1656900372747,MATH 20B,A01,083756,Briones; Jor-el Thomas Caparas,1,0,36,35
1656900372747,MATH 20B,A02,083757,Briones; Jor-el Thomas Caparas,1,0,36,35
1656900372747,MATH 20B,A03,093475,Briones; Jor-el Thomas Caparas,0,0,36,36
1656900378785,MATH 20C,A01,083760,Briones; Jor-el Thomas Caparas,1,0,35,34
1656900378785,MATH 20C,A02,083761,Briones; Jor-el Thomas Caparas,8,0,35,27
1656900378785,MATH 20C,A03,093476,Briones; Jor-el Thomas Caparas,0,1,36,36
1656900378785,MATH 20C,B01,083762,Bach; Quang Tran,0,0,30,30
1656900384809,MATH 20D,A01,083765,Tran; Brian Kha,4,0,30,26
1656900384809,MATH 20D,A02,083766,Tran; Brian Kha,4,0,30,26
1656900384809,MATH 20D,A03,083767,Tran; Brian Kha,3,0,30,27
1656900390836,MATH 20E,A01,083771,Ganguly; Soumya,5,0,32,27
1656900390836,MATH 20E,A02,083772,Ganguly; Soumya,6,0,32,26
1656900390836,MATH 20E,B01,083773,Ciotti; Benjamin,18,0,35,17
1656900390836,MATH 20E,B02,083774,Ciotti; Benjamin,17,0,35,18
1656900396866,MATH 103A,A01,083777,Greenfeld; Be'Eri,2,0,36,34
1656900396866,MATH 103A,A02,083778,Greenfeld; Be'Eri,5,0,36,31
1656900396866,MATH 103A,A03,093561,Greenfeld; Be'Eri,4,0,36,32
1656900396866,MATH 103A,B01,083779,Greenfeld; Be'Eri,6,0,36,30
1656900396866,MATH 103A,B02,083780,Greenfeld; Be'Eri,2,0,36,34
1656900396866,MATH 103A,B03,093562,Greenfeld; Be'Eri,2,0,36,34
1656900402889,MATH 105,A01,085443,Carter; Anne Toulson,13,0,35,22
1656900402889,MATH 105,A02,093477,Carter; Anne Toulson,20,0,35,15
1656900408918,MATH 109,A01,083213,Ganzberger; Geoffrey Michael,2,0,34,32
1656900408918,MATH 109,A02,083214,Ganzberger; Geoffrey Michael,2,0,34,32
1656900408918,MATH 109,A03,093478,Ganzberger; Geoffrey Michael,1,0,34,33
1656900408918,MATH 109,B01,083215,Ganzberger; Geoffrey Michael,1,0,32,31
1656900408918,MATH 109,B02,083216,Ganzberger; Geoffrey Michael,1,0,32,31
1656900408918,MATH 109,B03,093479,Ganzberger; Geoffrey Michael,6,0,32,26
1656900414945,MATH 142A,A01,083219,Chow; Bennett,6,0,32,26
1656900414945,MATH 142A,A02,083220,Chow; Bennett,10,0,32,22
1656900414945,MATH 142A,A03,093480,Chow; Bennett,7,0,32,25
1656900414945,MATH 142A,B03,093481,Chow; Bennett,7,0,32,25
1656900414945,MATH 142A,B04,093558,Chow; Bennett,10,0,32,22
1656900414945,MATH 142A,B05,093559,Chow; Bennett,6,0,32,26
1656900420969,MATH 193A,A01,083224,Rotar; Vladimir,7,0,34,27
1656900420969,MATH 193A,A02,083225,Rotar; Vladimir,3,0,34,31
1656900420969,MATH 193A,A03,083781,Rotar; Vladimir,1,0,34,33
1656900420969,MATH 193A,A04,083782,Rotar; Vladimir,6,0,34,28
1656900420969,MATH 193A,A05,093482,Rotar; Vladimir,6,0,34,28
1656900426999,MATH 197,001,091859,McAuley; Julian John,9999,0,9999,0
1656900426999,MATH 197,002,095566,Kedlaya; Kiran S.,9997,0,9999,2
1656900426999,MATH 197,003,095567,Xiao; Ming,9999,0,9999,0
1656900426999,MATH 197,004,095571,Perols; Johan Lars,9998,0,9999,1
1656900434053,COGS 9,A01,083615,Shannon; Kyle Michael,6,0,75,69
1656900440080,COGS 11,A01,083617,Boyle; Mary E. T.,19,0,48,29
1656900446102,COGS 13,A01,083071,Bastos; Amalia Pinkusfeld,8,0,71,63
1656900452141,COGS 14A,A01,092681,Semenuks; Arturs,0,1,100,100
1656900458171,COGS 14B,A01,083073,Cheng; Tzu-Han,5,0,63,58
1656900464222,COGS 17,A01,092677,Semenuks; Arturs,4,0,81,77
1656900470247,COGS 100,A01,083619,Allen; Michael Gordon,15,0,70,55
1656900476295,COGS 101A,A01,083621,Davis; Joshua Daniel,9,0,68,59
1656900482322,COGS 101B,A01,091572,Allen; Michael Gordon,8,0,65,57
1656900488349,COGS 101C,A01,083625,Delgado; Tania,17,0,35,18
1656900494374,COGS 107A,A01,083627,Boyle; Mary E. T.,13,0,60,47
1656900500410,COGS 118A,A01,083075,Gupta; Anjum,15,0,76,61
1656900506433,CSE 3,A50,083646,Miranda; Gregory Joseph,22,0,50,28
1656900512459,CSE 8A,A50,083650,Miranda; Gregory Joseph,17,1,56,39
1656900518486,CSE 11,A01,083080,Cao; Yingjun,4,15,40,36
1656900524509,CSE 12,A01,083652,Krause-Levy; Sophia Louisa,20,1,120,100
1656900530536,CSE 15L,A01,083654,Morris; Justin Loren,8,0,50,42
1656900530536,CSE 15L,A02,083655,Morris; Justin Loren,8,0,50,42
1656900536572,CSE 20,A01,083657,Tran; Khoa Dang,37,0,80,43
1656900542595,CSE 21,A01,095574,Bach; Quang Tran,21,0,48,27
1656900548617,CSE 30,A01,083084,Eldon; John,4,0,80,76
1656900548617,CSE 30,B01,095061,Bhaskar; Nishant,6,0,50,44
1656900554639,CSE 100,A01,083659,Cao; Yingjun,2,4,70,68
1656900560666,CSE 134B,A01,083661,Powell; Thomas Allan,19,0,100,81
1656900566691,CSE 140,A01,083663,Gungor; Onat,14,0,85,71
1656900572725,CSE 140L,A01,083088,Eldon; John,16,0,100,84
1656900578753,CSE 175,A01,083665,Kumar; Rakesh,3,0,25,22
1656900584778,CSE 190,A00,092507,Dubnov; Shlomo,7,0,20,13
1656900590806,ECE 45,A01,083139,Congero; Spencer William,5,0,75,70
1656900596828,ECE 65,A50,083695,Saad; Andrew S,12,0,30,18
1656900596828,ECE 65,A51,095125,Saad; Andrew S,25,0,26,1
1656900602863,ECE 109,A01,091882,Touri; Behrouz,16,0,70,54
1656900608886,ECE 180,A00,083140,Abi Samra; Nicholas Camill,0,0,30,30
1656900608886,ECE 180,B00,083141,Abi Samra; Nicholas Camill,0,0,30,30
1656900614914,MATH 10A,A01,083735,Patchell; Gregory David,1,0,30,29
1656900614914,MATH 10A,A02,083736,Patchell; Gregory David,20,0,30,10
1656900614914,MATH 10A,A03,083737,Patchell; Gregory David,15,0,30,15
1656900620943,MATH 10B,A01,083207,Lim; Seonhee,7,0,34,27
1656900620943,MATH 10B,A02,083208,Lim; Seonhee,9,0,35,26
1656900620943,MATH 10B,A03,093472,Lim; Seonhee,4,0,34,30
1656900620943,MATH 10B,B01,083739,Sinha; Shubham,9,0,30,21
1656900626967,MATH 18,A01,083743,Cinel; Cameron Alexander,6,0,30,24
1656900626967,MATH 18,A02,083744,Cinel; Cameron Alexander,15,0,30,15
1656900626967,MATH 18,A03,083745,Cinel; Cameron Alexander,8,0,30,22
1656900626967,MATH 18,B01,083748,Rideout; David Porter,4,0,37,33
1656900626967,MATH 18,B02,083749,Rideout; David Porter,3,0,36,33
1656900626967,MATH 18,B03,083750,Rideout; David Porter,2,0,37,35
1656900626967,MATH 18,B04,083751,Rideout; David Porter,5,0,36,31
1656900626967,MATH 18,B05,093473,Rideout; David Porter,4,0,36,32
1656900626967,MATH 18,B06,093474,Rideout; David Porter,5,0,36,31
1656900632989,MATH 20A,A01,083754,Zheng; Zequn,12,0,40,28
1656900639018,MATH 20B,A01,083756,Briones; Jor-el Thomas Caparas,1,0,36,35
1656900639018,MATH 20B,A02,083757,Briones; Jor-el Thomas Caparas,1,0,36,35
1656900639018,MATH 20B,A03,093475,Briones; Jor-el Thomas Caparas,0,0,36,36
1656900645054,MATH 20C,A01,083760,Briones; Jor-el Thomas Caparas,1,0,35,34
1656900645054,MATH 20C,A02,083761,Briones; Jor-el Thomas Caparas,8,0,35,27
1656900645054,MATH 20C,A03,093476,Briones; Jor-el Thomas Caparas,0,1,36,36
1656900645054,MATH 20C,B01,083762,Bach; Quang Tran,0,0,30,30
1656900651083,MATH 20D,A01,083765,Tran; Brian Kha,4,0,30,26
1656900651083,MATH 20D,A02,083766,Tran; Brian Kha,4,0,30,26
1656900651083,MATH 20D,A03,083767,Tran; Brian Kha,3,0,30,27
1656900657107,MATH 20E,A01,083771,Ganguly; Soumya,5,0,32,27
1656900657107,MATH 20E,A02,083772,Ganguly; Soumya,6,0,32,26
1656900657107,MATH 20E,B01,083773,Ciotti; Benjamin,18,0,35,17
1656900657107,MATH 20E,B02,083774,Ciotti; Benjamin,17,0,35,18
1656900663135,MATH 103A,A01,083777,Greenfeld; Be'Eri,2,0,36,34
1656900663135,MATH 103A,A02,083778,Greenfeld; Be'Eri,5,0,36,31
1656900663135,MATH 103A,A03,093561,Greenfeld; Be'Eri,4,0,36,32
1656900663135,MATH 103A,B01,083779,Greenfeld; Be'Eri,6,0,36,30
1656900663135,MATH 103A,B02,083780,Greenfeld; Be'Eri,2,0,36,34
1656900663135,MATH 103A,B03,093562,Greenfeld; Be'Eri,2,0,36,34
1656900669159,MATH 105,A01,085443,Carter; Anne Toulson,13,0,35,22
1656900669159,MATH 105,A02,093477,Carter; Anne Toulson,20,0,35,15
1656900675191,MATH 109,A01,083213,Ganzberger; Geoffrey Michael,2,0,34,32
1656900675191,MATH 109,A02,083214,Ganzberger; Geoffrey Michael,2,0,34,32
1656900675191,MATH 109,A03,093478,Ganzberger; Geoffrey Michael,1,0,34,33
1656900675191,MATH 109,B01,083215,Ganzberger; Geoffrey Michael,1,0,32,31
1656900675191,MATH 109,B02,083216,Ganzberger; Geoffrey Michael,1,0,32,31
1656900675191,MATH 109,B03,093479,Ganzberger; Geoffrey Michael,6,0,32,26
1656900681213,MATH 142A,A01,083219,Chow; Bennett,6,0,32,26
1656900681213,MATH 142A,A02,083220,Chow; Bennett,10,0,32,22
1656900681213,MATH 142A,A03,093480,Chow; Bennett,7,0,32,25
1656900681213,MATH 142A,B03,093481,Chow; Bennett,7,0,32,25
1656900681213,MATH 142A,B04,093558,Chow; Bennett,10,0,32,22
1656900681213,MATH 142A,B05,093559,Chow; Bennett,6,0,32,26
1656900687236,MATH 193A,A01,083224,Rotar; Vladimir,7,0,34,27
1656900687236,MATH 193A,A02,083225,Rotar; Vladimir,3,0,34,31
1656900687236,MATH 193A,A03,083781,Rotar; Vladimir,1,0,34,33
1656900687236,MATH 193A,A04,083782,Rotar; Vladimir,6,0,34,28
1656900687236,MATH 193A,A05,093482,Rotar; Vladimir,6,0,34,28
1656900693260,MATH 197,001,091859,McAuley; Julian John,9999,0,9999,0
1656900693260,MATH 197,002,095566,Kedlaya; Kiran S.,9997,0,9999,2
1656900693260,MATH 197,003,095567,Xiao; Ming,9999,0,9999,0
1656900693260,MATH 197,004,095571,Perols; Johan Lars,9998,0,9999,1
1656900700325,COGS 9,A01,083615,Shannon; Kyle Michael,6,0,75,69
1656900706353,COGS 11,A01,083617,Boyle; Mary E. T.,19,0,48,29
1656900712393,COGS 13,A01,083071,Bastos; Amalia Pinkusfeld,8,0,71,63
1656900718419,COGS 14A,A01,092681,Semenuks; Arturs,0,1,100,100
1656900724446,COGS 14B,A01,083073,Cheng; Tzu-Han,5,0,63,58
1656900730471,COGS 17,A01,092677,Semenuks; Arturs,4,0,81,77
1656900736494,COGS 100,A01,083619,Allen; Michael Gordon,15,0,70,55
1656900742529,COGS 101A,A01,083621,Davis; Joshua Daniel,9,0,68,59
1656900748557,COGS 101B,A01,091572,Allen; Michael Gordon,8,0,65,57
1656900754591,COGS 101C,A01,083625,Delgado; Tania,17,0,35,18
1656900760615,COGS 107A,A01,083627,Boyle; Mary E. T.,13,0,60,47
1656900766639,COGS 118A,A01,083075,Gupta; Anjum,15,0,76,61
1656900772663,CSE 3,A50,083646,Miranda; Gregory Joseph,22,0,50,28
1656900778691,CSE 8A,A50,083650,Miranda; Gregory Joseph,17,1,56,39
1656900784715,CSE 11,A01,083080,Cao; Yingjun,4,15,40,36
1656900790737,CSE 12,A01,083652,Krause-Levy; Sophia Louisa,20,1,120,100
1656900796760,CSE 15L,A01,083654,Morris; Justin Loren,8,0,50,42
1656900796760,CSE 15L,A02,083655,Morris; Justin Loren,8,0,50,42
1656900802785,CSE 20,A01,083657,Tran; Khoa Dang,37,0,80,43
1656900808811,CSE 21,A01,095574,Bach; Quang Tran,21,0,48,27
1656900814834,CSE 30,A01,083084,Eldon; John,4,0,80,76
1656900814834,CSE 30,B01,095061,Bhaskar; Nishant,6,0,50,44
1656900820863,CSE 100,A01,083659,Cao; Yingjun,2,4,70,68
1656900826888,CSE 134B,A01,083661,Powell; Thomas Allan,19,0,100,81
1656900832917,CSE 140,A01,083663,Gungor; Onat,14,0,85,71
1656900838938,CSE 140L,A01,083088,Eldon; John,16,0,100,84
1656900844966,CSE 175,A01,083665,Kumar; Rakesh,3,0,25,22
1656900850988,CSE 190,A00,092507,Dubnov; Shlomo,7,0,20,13
1656900857021,ECE 45,A01,083139,Congero; Spencer William,5,0,75,70
1656900863045,ECE 65,A50,083695,Saad; Andrew S,12,0,30,18
1656900863045,ECE 65,A51,095125,Saad; Andrew S,25,0,26,1
1656900869067,ECE 109,A01,091882,Touri; Behrouz,16,0,70,54
1656900875094,ECE 180,A00,083140,Abi Samra; Nicholas Camill,0,0,30,30
1656900875094,ECE 180,B00,083141,Abi Samra; Nicholas Camill,0,0,30,30
1656900881124,MATH 10A,A01,083735,Patchell; Gregory David,1,0,30,29
1656900881124,MATH 10A,A02,083736,Patchell; Gregory David,20,0,30,10
1656900881124,MATH 10A,A03,083737,Patchell; Gregory David,15,0,30,15
1656900887152,MATH 10B,A01,083207,Lim; Seonhee,7,0,34,27
1656900887152,MATH 10B,A02,083208,Lim; Seonhee,9,0,35,26
1656900887152,MATH 10B,A03,093472,Lim; Seonhee,4,0,34,30
1656900887152,MATH 10B,B01,083739,Sinha; Shubham,9,0,30,21
1656900893190,MATH 18,A01,083743,Cinel; Cameron Alexander,6,0,30,24
1656900893190,MATH 18,A02,083744,Cinel; Cameron Alexander,15,0,30,15
1656900893190,MATH 18,A03,083745,Cinel; Cameron Alexander,8,0,30,22
1656900893190,MATH 18,B01,083748,Rideout; David Porter,4,0,37,33
1656900893190,MATH 18,B02,083749,Rideout; David Porter,3,0,36,33
1656900893190,MATH 18,B03,083750,Rideout; David Porter,2,0,37,35
1656900893190,MATH 18,B04,083751,Rideout; David Porter,5,0,36,31
1656900893190,MATH 18,B05,093473,Rideout; David Porter,4,0,36,32
1656900893190,MATH 18,B06,093474,Rideout; David Porter,5,0,36,31
1656900899216,MATH 20A,A01,083754,Zheng; Zequn,12,0,40,28
1656900905242,MATH 20B,A01,083756,Briones; Jor-el Thomas Caparas,1,0,36,35
1656900905242,MATH 20B,A02,083757,Briones; Jor-el Thomas Caparas,1,0,36,35
1656900905242,MATH 20B,A03,093475,Briones; Jor-el Thomas Caparas,0,0,36,36
1656900911270,MATH 20C,A01,083760,Briones; Jor-el Thomas Caparas,1,0,35,34
1656900911270,MATH 20C,A02,083761,Briones; Jor-el Thomas Caparas,8,0,35,27
1656900911270,MATH 20C,A03,093476,Briones; Jor-el Thomas Caparas,0,1,36,36
1656900911270,MATH 20C,B01,083762,Bach; Quang Tran,0,0,30,30
1656900917298,MATH 20D,A01,083765,Tran; Brian Kha,4,0,30,26
1656900917298,MATH 20D,A02,083766,Tran; Brian Kha,4,0,30,26
1656900917298,MATH 20D,A03,083767,Tran; Brian Kha,3,0,30,27
1656900923339,MATH 20E,A01,083771,Ganguly; Soumya,5,0,32,27
1656900923339,MATH 20E,A02,083772,Ganguly; Soumya,6,0,32,26
1656900923339,MATH 20E,B01,083773,Ciotti; Benjamin,18,0,35,17
1656900923339,MATH 20E,B02,083774,Ciotti; Benjamin,17,0,35,18
1656900929365,MATH 103A,A01,083777,Greenfeld; Be'Eri,2,0,36,34
1656900929365,MATH 103A,A02,083778,Greenfeld; Be'Eri,5,0,36,31
1656900929365,MATH 103A,A03,093561,Greenfeld; Be'Eri,4,0,36,32
1656900929365,MATH 103A,B01,083779,Greenfeld; Be'Eri,6,0,36,30
1656900929365,MATH 103A,B02,083780,Greenfeld; Be'Eri,2,0,36,34
1656900929365,MATH 103A,B03,093562,Greenfeld; Be'Eri,2,0,36,34
1656900935395,MATH 105,A01,085443,Carter; Anne Toulson,13,0,35,22
1656900935395,MATH 105,A02,093477,Carter; Anne Toulson,20,0,35,15
1656900941418,MATH 109,A01,083213,Ganzberger; Geoffrey Michael,2,0,34,32
1656900941418,MATH 109,A02,083214,Ganzberger; Geoffrey Michael,2,0,34,32
1656900941418,MATH 109,A03,093478,Ganzberger; Geoffrey Michael,1,0,34,33
1656900941418,MATH 109,B01,083215,Ganzberger; Geoffrey Michael,1,0,32,31
1656900941418,MATH 109,B02,083216,Ganzberger; Geoffrey Michael,1,0,32,31
1656900941418,MATH 109,B03,093479,Ganzberger; Geoffrey Michael,6,0,32,26
1656900947513,MATH 142A,A01,083219,Chow; Bennett,6,0,32,26
1656900947513,MATH 142A,A02,083220,Chow; Bennett,10,0,32,22
1656900947513,MATH 142A,A03,093480,Chow; Bennett,7,0,32,25
1656900947513,MATH 142A,B03,093481,Chow; Bennett,7,0,32,25
1656900947513,MATH 142A,B04,093558,Chow; Bennett,10,0,32,22
1656900947513,MATH 142A,B05,093559,Chow; Bennett,6,0,32,26
1656900953536,MATH 193A,A01,083224,Rotar; Vladimir,7,0,34,27
1656900953536,MATH 193A,A02,083225,Rotar; Vladimir,3,0,34,31
1656900953536,MATH 193A,A03,083781,Rotar; Vladimir,1,0,34,33
1656900953536,MATH 193A,A04,083782,Rotar; Vladimir,6,0,34,28
1656900953536,MATH 193A,A05,093482,Rotar; Vladimir,6,0,34,28
1656900959560,MATH 197,001,091859,McAuley; Julian John,9999,0,9999,0
1656900959560,MATH 197,002,095566,Kedlaya; Kiran S.,9997,0,9999,2
1656900959560,MATH 197,003,095567,Xiao; Ming,9999,0,9999,0
1656900959560,MATH 197,004,095571,Perols; Johan Lars,9998,0,9999,1
1656900966638,COGS 9,A01,083615,Shannon; Kyle Michael,6,0,75,69
1656900972662,COGS 11,A01,083617,Boyle; Mary E. T.,19,0,48,29
1656900978707,COGS 13,A01,083071,Bastos; Amalia Pinkusfeld,8,0,71,63
1656900984731,COGS 14A,A01,092681,Semenuks; Arturs,0,1,100,100
1656900990754,COGS 14B,A01,083073,Cheng; Tzu-Han,5,0,63,58
1656900996779,COGS 17,A01,092677,Semenuks; Arturs,4,0,81,77
1656901002804,COGS 100,A01,083619,Allen; Michael Gordon,15,0,70,55
1656901008827,COGS 101A,A01,083621,Davis; Joshua Daniel,9,0,68,59
1656901014850,COGS 101B,A01,091572,Allen; Michael Gordon,8,0,65,57
1656901020877,COGS 101C,A01,083625,Delgado; Tania,17,0,35,18
1656901026912,COGS 107A,A01,083627,Boyle; Mary E. T.,13,0,60,47
1656901032934,COGS 118A,A01,083075,Gupta; Anjum,15,0,76,61
1656901038957,CSE 3,A50,083646,Miranda; Gregory Joseph,22,0,50,28
1656901044981,CSE 8A,A50,083650,Miranda; Gregory Joseph,17,1,56,39
1656901051004,CSE 11,A01,083080,Cao; Yingjun,4,15,40,36
1656901057027,CSE 12,A01,083652,Krause-Levy; Sophia Louisa,20,1,120,100
1656901063050,CSE 15L,A01,083654,Morris; Justin Loren,8,0,50,42
1656901063050,CSE 15L,A02,083655,Morris; Justin Loren,8,0,50,42
1656901069076,CSE 20,A01,083657,Tran; Khoa Dang,37,0,80,43
1656901075100,CSE 21,A01,095574,Bach; Quang Tran,21,0,48,27
1656901081124,CSE 30,A01,083084,Eldon; John,4,0,80,76
1656901081124,CSE 30,B01,095061,Bhaskar; Nishant,6,0,50,44
1656901087146,CSE 100,A01,083659,Cao; Yingjun,2,4,70,68
1656901093173,CSE 134B,A01,083661,Powell; Thomas Allan,19,0,100,81
1656901099198,CSE 140,A01,083663,Gungor; Onat,14,0,85,71
1656901105221,CSE 140L,A01,083088,Eldon; John,16,0,100,84
1656901111243,CSE 175,A01,083665,Kumar; Rakesh,3,0,25,22
1656901117266,CSE 190,A00,092507,Dubnov; Shlomo,7,0,20,13
1656901123289,ECE 45,A01,083139,Congero; Spencer William,5,0,75,70
1656901129327,ECE 65,A50,083695,Saad; Andrew S,12,0,30,18
1656901129327,ECE 65,A51,095125,Saad; Andrew S,25,0,26,1
1656901135350,ECE 109,A01,091882,Touri; Behrouz,16,0,70,54
1656901141381,ECE 180,A00,083140,Abi Samra; Nicholas Camill,0,0,30,30
1656901141381,ECE 180,B00,083141,Abi Samra; Nicholas Camill,0,0,30,30
1656901147405,MATH 10A,A01,083735,Patchell; Gregory David,1,0,30,29
1656901147405,MATH 10A,A02,083736,Patchell; Gregory David,20,0,30,10
1656901147405,MATH 10A,A03,083737,Patchell; Gregory David,15,0,30,15
1656901153464,MATH 10B,A01,083207,Lim; Seonhee,7,0,34,27
1656901153464,MATH 10B,A02,083208,Lim; Seonhee,9,0,35,26
1656901153464,MATH 10B,A03,093472,Lim; Seonhee,4,0,34,30
1656901153464,MATH 10B,B01,083739,Sinha; Shubham,9,0,30,21
1656901159494,MATH 18,A01,083743,Cinel; Cameron Alexander,6,0,30,24
1656901159494,MATH 18,A02,083744,Cinel; Cameron Alexander,15,0,30,15
1656901159494,MATH 18,A03,083745,Cinel; Cameron Alexander,8,0,30,22
1656901159494,MATH 18,B01,083748,Rideout; David Porter,4,0,37,33
1656901159494,MATH 18,B02,083749,Rideout; David Porter,3,0,36,33
1656901159494,MATH 18,B03,083750,Rideout; David Porter,2,0,37,35
1656901159494,MATH 18,B04,083751,Rideout; David Porter,5,0,36,31
1656901159494,MATH 18,B05,093473,Rideout; David Porter,4,0,36,32
1656901159494,MATH 18,B06,093474,Rideout; David Porter,5,0,36,31
1656901165533,MATH 20A,A01,083754,Zheng; Zequn,12,0,40,28
1656901171555,MATH 20B,A01,083756,Briones; Jor-el Thomas Caparas,1,0,36,35
1656901171555,MATH 20B,A02,083757,Briones; Jor-el Thomas Caparas,1,0,36,35
1656901171555,MATH 20B,A03,093475,Briones; Jor-el Thomas Caparas,0,0,36,36
1656901177580,MATH 20C,A01,083760,Briones; Jor-el Thomas Caparas,1,0,35,34
1656901177580,MATH 20C,A02,083761,Briones; Jor-el Thomas Caparas,8,0,35,27
1656901177580,MATH 20C,A03,093476,Briones; Jor-el Thomas Caparas,0,1,36,36
1656901177580,MATH 20C,B01,083762,Bach; Quang Tran,0,0,30,30
1656901183608,MATH 20D,A01,083765,Tran; Brian Kha,4,0,30,26
1656901183608,MATH 20D,A02,083766,Tran; Brian Kha,4,0,30,26
1656901183608,MATH 20D,A03,083767,Tran; Brian Kha,3,0,30,27
1656901189637,MATH 20E,A01,083771,Ganguly; Soumya,5,0,32,27
1656901189637,MATH 20E,A02,083772,Ganguly; Soumya,6,0,32,26
1656901189637,MATH 20E,B01,083773,Ciotti; Benjamin,18,0,35,17
1656901189637,MATH 20E,B02,083774,Ciotti; Benjamin,17,0,35,18
1656901195662,MATH 103A,A01,083777,Greenfeld; Be'Eri,2,0,36,34
1656901195662,MATH 103A,A02,083778,Greenfeld; Be'Eri,5,0,36,31
1656901195662,MATH 103A,A03,093561,Greenfeld; Be'Eri,4,0,36,32
1656901195662,MATH 103A,B01,083779,Greenfeld; Be'Eri,6,0,36,30
1656901195662,MATH 103A,B02,083780,Greenfeld; Be'Eri,2,0,36,34
1656901195662,MATH 103A,B03,093562,Greenfeld; Be'Eri,2,0,36,34
1656901201690,MATH 105,A01,085443,Carter; Anne Toulson,13,0,35,22
1656901201690,MATH 105,A02,093477,Carter; Anne Toulson,20,0,35,15
1656901207717,MATH 109,A01,083213,Ganzberger; Geoffrey Michael,2,0,34,32
1656901207717,MATH 109,A02,083214,Ganzberger; Geoffrey Michael,2,0,34,32
1656901207717,MATH 109,A03,093478,Ganzberger; Geoffrey Michael,1,0,34,33
1656901207717,MATH 109,B01,083215,Ganzberger; Geoffrey Michael,1,0,32,31
1656901207717,MATH 109,B02,083216,Ganzberger; Geoffrey Michael,1,0,32,31
1656901207717,MATH 109,B03,093479,Ganzberger; Geoffrey Michael,6,0,32,26
1656901213744,MATH 142A,A01,083219,Chow; Bennett,6,0,32,26
1656901213744,MATH 142A,A02,083220,Chow; Bennett,10,0,32,22
1656901213744,MATH 142A,A03,093480,Chow; Bennett,7,0,32,25
1656901213744,MATH 142A,B03,093481,Chow; Bennett,7,0,32,25
1656901213744,MATH 142A,B04,093558,Chow; Bennett,10,0,32,22
1656901213744,MATH 142A,B05,093559,Chow; Bennett,6,0,32,26
1656901219773,MATH 193A,A01,083224,Rotar; Vladimir,7,0,34,27
1656901219773,MATH 193A,A02,083225,Rotar; Vladimir,3,0,34,31
1656901219773,MATH 193A,A03,083781,Rotar; Vladimir,1,0,34,33
1656901219773,MATH 193A,A04,083782,Rotar; Vladimir,6,0,34,28
1656901219773,MATH 193A,A05,093482,Rotar; Vladimir,6,0,34,28
1656901225798,MATH 197,001,091859,McAuley; Julian John,9999,0,9999,0
1656901225798,MATH 197,002,095566,Kedlaya; Kiran S.,9997,0,9999,2
1656901225798,MATH 197,003,095567,Xiao; Ming,9999,0,9999,0
1656901225798,MATH 197,004,095571,Perols; Johan Lars,9998,0,9999,1
1656901232882,COGS 9,A01,083615,Shannon; Kyle Michael,6,0,75,69
1656901238905,COGS 11,A01,083617,Boyle; Mary E. T.,19,0,48,29
1656901244929,COGS 13,A01,083071,Bastos; Amalia Pinkusfeld,8,0,71,63
1656901250955,COGS 14A,A01,092681,Semenuks; Arturs,0,1,100,100
1656901256979,COGS 14B,A01,083073,Cheng; Tzu-Han,5,0,63,58
1656901263005,COGS 17,A01,092677,Semenuks; Arturs,4,0,81,77
1656901269028,COGS 100,A01,083619,Allen; Michael Gordon,15,0,70,55
1656901275050,COGS 101A,A01,083621,Davis; Joshua Daniel,9,0,68,59
1656901281073,COGS 101B,A01,091572,Allen; Michael Gordon,8,0,65,57
1656901287096,COGS 101C,A01,083625,Delgado; Tania,17,0,35,18
1656901293132,COGS 107A,A01,083627,Boyle; Mary E. T.,13,0,60,47
1656901299157,COGS 118A,A01,083075,Gupta; Anjum,15,0,76,61
1656901305180,CSE 3,A50,083646,Miranda; Gregory Joseph,22,0,50,28
1656901311202,CSE 8A,A50,083650,Miranda; Gregory Joseph,17,1,56,39
1656901317229,CSE 11,A01,083080,Cao; Yingjun,4,15,40,36
1656901323253,CSE 12,A01,083652,Krause-Levy; Sophia Louisa,20,1,120,100
1656901329279,CSE 15L,A01,083654,Morris; Justin Loren,8,0,50,42
1656901329279,CSE 15L,A02,083655,Morris; Justin Loren,8,0,50,42
1656901335301,CSE 20,A01,083657,Tran; Khoa Dang,37,0,80,43
1656901341324,CSE 21,A01,095574,Bach; Quang Tran,21,0,48,27
1656901347350,CSE 30,A01,083084,Eldon; John,4,0,80,76
1656901347350,CSE 30,B01,095061,Bhaskar; Nishant,6,0,50,44
1656901353373,CSE 100,A01,083659,Cao; Yingjun,2,4,70,68
1656901359397,CSE 134B,A01,083661,Powell; Thomas Allan,19,0,100,81
1656901365424,CSE 140,A01,083663,Gungor; Onat,14,0,85,71
1656901371450,CSE 140L,A01,083088,Eldon; John,16,0,100,84
1656901377473,CSE 175,A01,083665,Kumar; Rakesh,3,0,25,22
1656901383499,CSE 190,A00,092507,Dubnov; Shlomo,7,0,20,13
1656901389522,ECE 45,A01,083139,Congero; Spencer William,5,0,75,70
1656901395545,ECE 65,A50,083695,Saad; Andrew S,12,0,30,18
1656901395545,ECE 65,A51,095125,Saad; Andrew S,25,0,26,1
1656901401570,ECE 109,A01,091882,Touri; Behrouz,16,0,70,54
1656901407593,ECE 180,A00,083140,Abi Samra; Nicholas Camill,0,0,30,30
1656901407593,ECE 180,B00,083141,Abi Samra; Nicholas Camill,0,0,30,30
1656901413623,MATH 10A,A01,083735,Patchell; Gregory David,1,0,30,29
1656901413623,MATH 10A,A02,083736,Patchell; Gregory David,20,0,30,10
1656901413623,MATH 10A,A03,083737,Patchell; Gregory David,15,0,30,15
1656901419646,MATH 10B,A01,083207,Lim; Seonhee,7,0,34,27
1656901419646,MATH 10B,A02,083208,Lim; Seonhee,9,0,35,26
1656901419646,MATH 10B,A03,093472,Lim; Seonhee,4,0,34,30
1656901419646,MATH 10B,B01,083739,Sinha; Shubham,9,0,30,21
1656901425671,MATH 18,A01,083743,Cinel; Cameron Alexander,6,0,30,24
1656901425671,MATH 18,A02,083744,Cinel; Cameron Alexander,15,0,30,15
1656901425671,MATH 18,A03,083745,Cinel; Cameron Alexander,8,0,30,22
1656901425671,MATH 18,B01,083748,Rideout; David Porter,4,0,37,33
1656901425671,MATH 18,B02,083749,Rideout; David Porter,3,0,36,33
1656901425671,MATH 18,B03,083750,Rideout; David Porter,2,0,37,35
1656901425671,MATH 18,B04,083751,Rideout; David Porter,5,0,36,31
1656901425671,MATH 18,B05,093473,Rideout; David Porter,4,0,36,32
1656901425671,MATH 18,B06,093474,Rideout; David Porter,5,0,36,31
1656901431706,MATH 20A,A01,083754,Zheng; Zequn,12,0,40,28
1656901437734,MATH 20B,A01,083756,Briones; Jor-el Thomas Caparas,1,0,36,35
1656901437734,MATH 20B,A02,083757,Briones; Jor-el Thomas Caparas,1,0,36,35
1656901437734,MATH 20B,A03,093475,Briones; Jor-el Thomas Caparas,0,0,36,36
1656901443758,MATH 20C,A01,083760,Briones; Jor-el Thomas Caparas,1,0,35,34
1656901443758,MATH 20C,A02,083761,Briones; Jor-el Thomas Caparas,8,0,35,27
1656901443758,MATH 20C,A03,093476,Briones; Jor-el Thomas Caparas,0,1,36,36
1656901443758,MATH 20C,B01,083762,Bach; Quang Tran,0,0,30,30
1656901449786,MATH 20D,A01,083765,Tran; Brian Kha,4,0,30,26
1656901449786,MATH 20D,A02,083766,Tran; Brian Kha,4,0,30,26
1656901449786,MATH 20D,A03,083767,Tran; Brian Kha,3,0,30,27
1656901455809,MATH 20E,A01,083771,Ganguly; Soumya,5,0,32,27
1656901455809,MATH 20E,A02,083772,Ganguly; Soumya,6,0,32,26
1656901455809,MATH 20E,B01,083773,Ciotti; Benjamin,18,0,35,17
1656901455809,MATH 20E,B02,083774,Ciotti; Benjamin,17,0,35,18
1656901461838,MATH 103A,A01,083777,Greenfeld; Be'Eri,2,0,36,34
1656901461838,MATH 103A,A02,083778,Greenfeld; Be'Eri,5,0,36,31
1656901461838,MATH 103A,A03,093561,Greenfeld; Be'Eri,4,0,36,32
1656901461838,MATH 103A,B01,083779,Greenfeld; Be'Eri,6,0,36,30
1656901461838,MATH 103A,B02,083780,Greenfeld; Be'Eri,2,0,36,34
1656901461838,MATH 103A,B03,093562,Greenfeld; Be'Eri,2,0,36,34
1656901467861,MATH 105,A01,085443,Carter; Anne Toulson,13,0,35,22
1656901467861,MATH 105,A02,093477,Carter; Anne Toulson,20,0,35,15
1656901473903,MATH 109,A01,083213,Ganzberger; Geoffrey Michael,2,0,34,32
1656901473903,MATH 109,A02,083214,Ganzberger; Geoffrey Michael,2,0,34,32
1656901473903,MATH 109,A03,093478,Ganzberger; Geoffrey Michael,1,0,34,33
1656901473903,MATH 109,B01,083215,Ganzberger; Geoffrey Michael,1,0,32,31
1656901473903,MATH 109,B02,083216,Ganzberger; Geoffrey Michael,1,0,32,31
1656901473903,MATH 109,B03,093479,Ganzberger; Geoffrey Michael,6,0,32,26
1656901479926,MATH 142A,A01,083219,Chow; Bennett,6,0,32,26
1656901479926,MATH 142A,A02,083220,Chow; Bennett,10,0,32,22
1656901479926,MATH 142A,A03,093480,Chow; Bennett,7,0,32,25
1656901479926,MATH 142A,B03,093481,Chow; Bennett,7,0,32,25
1656901479926,MATH 142A,B04,093558,Chow; Bennett,10,0,32,22
1656901479926,MATH 142A,B05,093559,Chow; Bennett,6,0,32,26
1656901485959,MATH 193A,A01,083224,Rotar; Vladimir,7,0,34,27
1656901485959,MATH 193A,A02,083225,Rotar; Vladimir,3,0,34,31
1656901485959,MATH 193A,A03,083781,Rotar; Vladimir,1,0,34,33
1656901485959,MATH 193A,A04,083782,Rotar; Vladimir,6,0,34,28
1656901485959,MATH 193A,A05,093482,Rotar; Vladimir,6,0,34,28
1656901491985,MATH 197,001,091859,McAuley; Julian John,9999,0,9999,0
1656901491985,MATH 197,002,095566,Kedlaya; Kiran S.,9997,0,9999,2
1656901491985,MATH 197,003,095567,Xiao; Ming,9999,0,9999,0
1656901491985,MATH 197,004,095571,Perols; Johan Lars,9998,0,9999,1
1656901499047,COGS 9,A01,083615,Shannon; Kyle Michael,6,0,75,69
1656901505069,COGS 11,A01,083617,Boyle; Mary E. T.,19,0,48,29
1656901511093,COGS 13,A01,083071,Bastos; Amalia Pinkusfeld,8,0,71,63
1656901517118,COGS 14A,A01,092681,Semenuks; Arturs,0,1,100,100
1656901523143,COGS 14B,A01,083073,Cheng; Tzu-Han,5,0,63,58
1656901529170,COGS 17,A01,092677,Semenuks; Arturs,4,0,81,77
1656901535194,COGS 100,A01,083619,Allen; Michael Gordon,15,0,70,55
1656901541304,COGS 101A,A01,083621,Davis; Joshua Daniel,9,0,68,59
1656901547330,COGS 101B,A01,091572,Allen; Michael Gordon,8,0,65,57
1656901553353,COGS 101C,A01,083625,Delgado; Tania,17,0,35,18
1656901559380,COGS 107A,A01,083627,Boyle; Mary E. T.,13,0,60,47
1656901565404,COGS 118A,A01,083075,Gupta; Anjum,15,0,76,61
1656901571429,CSE 3,A50,083646,Miranda; Gregory Joseph,22,0,50,28
1656901577454,CSE 8A,A50,083650,Miranda; Gregory Joseph,17,1,56,39
1656901583484,CSE 11,A01,083080,Cao; Yingjun,4,15,40,36
1656901589507,CSE 12,A01,083652,Krause-Levy; Sophia Louisa,20,1,120,100
1656901595529,CSE 15L,A01,083654,Morris; Justin Loren,8,0,50,42
1656901595529,CSE 15L,A02,083655,Morris; Justin Loren,8,0,50,42
1656901601552,CSE 20,A01,083657,Tran; Khoa Dang,37,0,80,43
1656901607577,CSE 21,A01,095574,Bach; Quang Tran,21,0,48,27
1656901613606,CSE 30,A01,083084,Eldon; John,4,0,80,76
1656901613606,CSE 30,B01,095061,Bhaskar; Nishant,6,0,50,44
1656901619629,CSE 100,A01,083659,Cao; Yingjun,2,4,70,68
1656901625655,CSE 134B,A01,083661,Powell; Thomas Allan,19,0,100,81
1656901631682,CSE 140,A01,083663,Gungor; Onat,14,0,85,71
1656901637705,CSE 140L,A01,083088,Eldon; John,16,0,100,84
1656901643729,CSE 175,A01,083665,Kumar; Rakesh,3,0,25,22
1656901649753,CSE 190,A00,092507,Dubnov; Shlomo,7,0,20,13
1656901655779,ECE 45,A01,083139,Congero; Spencer William,5,0,75,70
1656901661818,ECE 65,A50,083695,Saad; Andrew S,12,0,30,18
1656901661818,ECE 65,A51,095125,Saad; Andrew S,25,0,26,1
1656901667841,ECE 109,A01,091882,Touri; Behrouz,16,0,70,54
1656901673867,ECE 180,A00,083140,Abi Samra; Nicholas Camill,0,0,30,30
1656901673867,ECE 180,B00,083141,Abi Samra; Nicholas Camill,0,0,30,30
1656901679891,MATH 10A,A01,083735,Patchell; Gregory David,1,0,30,29
1656901679891,MATH 10A,A02,083736,Patchell; Gregory David,20,0,30,10
1656901679891,MATH 10A,A03,083737,Patchell; Gregory David,15,0,30,15
1656901685920,MATH 10B,A01,083207,Lim; Seonhee,7,0,34,27
1656901685920,MATH 10B,A02,083208,Lim; Seonhee,9,0,35,26
1656901685920,MATH 10B,A03,093472,Lim; Seonhee,4,0,34,30
1656901685920,MATH 10B,B01,083739,Sinha; Shubham,9,0,30,21
1656901691947,MATH 18,A01,083743,Cinel; Cameron Alexander,6,0,30,24
1656901691947,MATH 18,A02,083744,Cinel; Cameron Alexander,15,0,30,15
1656901691947,MATH 18,A03,083745,Cinel; Cameron Alexander,8,0,30,22
1656901691947,MATH 18,B01,083748,Rideout; David Porter,4,0,37,33
1656901691947,MATH 18,B02,083749,Rideout; David Porter,3,0,36,33
1656901691947,MATH 18,B03,083750,Rideout; David Porter,2,0,37,35
1656901691947,MATH 18,B04,083751,Rideout; David Porter,5,0,36,31
1656901691947,MATH 18,B05,093473,Rideout; David Porter,4,0,36,32
1656901691947,MATH 18,B06,093474,Rideout; David Porter,5,0,36,31
1656901697969,MATH 20A,A01,083754,Zheng; Zequn,12,0,40,28
1656901703993,MATH 20B,A01,083756,Briones; Jor-el Thomas Caparas,1,0,36,35
1656901703993,MATH 20B,A02,083757,Briones; Jor-el Thomas Caparas,1,0,36,35
1656901703993,MATH 20B,A03,093475,Briones; Jor-el Thomas Caparas,0,0,36,36
1656901710016,MATH 20C,A01,083760,Briones; Jor-el Thomas Caparas,1,0,35,34
1656901710016,MATH 20C,A02,083761,Briones; Jor-el Thomas Caparas,8,0,35,27
1656901710016,MATH 20C,A03,093476,Briones; Jor-el Thomas Caparas,0,1,36,36
1656901710016,MATH 20C,B01,083762,Bach; Quang Tran,0,0,30,30
1656901716040,MATH 20D,A01,083765,Tran; Brian Kha,4,0,30,26
1656901716040,MATH 20D,A02,083766,Tran; Brian Kha,4,0,30,26
1656901716040,MATH 20D,A03,083767,Tran; Brian Kha,3,0,30,27
1656901722067,MATH 20E,A01,083771,Ganguly; Soumya,5,0,32,27
1656901722067,MATH 20E,A02,083772,Ganguly; Soumya,6,0,32,26
1656901722067,MATH 20E,B01,083773,Ciotti; Benjamin,18,0,35,17
1656901722067,MATH 20E,B02,083774,Ciotti; Benjamin,17,0,35,18
1656901728089,MATH 103A,A01,083777,Greenfeld; Be'Eri,2,0,36,34
1656901728089,MATH 103A,A02,083778,Greenfeld; Be'Eri,5,0,36,31
1656901728089,MATH 103A,A03,093561,Greenfeld; Be'Eri,4,0,36,32
1656901728089,MATH 103A,B01,083779,Greenfeld; Be'Eri,6,0,36,30
1656901728089,MATH 103A,B02,083780,Greenfeld; Be'Eri,2,0,36,34
1656901728089,MATH 103A,B03,093562,Greenfeld; Be'Eri,2,0,36,34
1656901734113,MATH 105,A01,085443,Carter; Anne Toulson,13,0,35,22
1656901734113,MATH 105,A02,093477,Carter; Anne Toulson,20,0,35,15
1656901740141,MATH 109,A01,083213,Ganzberger; Geoffrey Michael,2,0,34,32
1656901740141,MATH 109,A02,083214,Ganzberger; Geoffrey Michael,2,0,34,32
1656901740141,MATH 109,A03,093478,Ganzberger; Geoffrey Michael,1,0,34,33
1656901740141,MATH 109,B01,083215,Ganzberger; Geoffrey Michael,1,0,32,31
1656901740141,MATH 109,B02,083216,Ganzberger; Geoffrey Michael,1,0,32,31
1656901740141,MATH 109,B03,093479,Ganzberger; Geoffrey Michael,6,0,32,26
1656901746163,MATH 142A,A01,083219,Chow; Bennett,6,0,32,26
1656901746163,MATH 142A,A02,083220,Chow; Bennett,10,0,32,22
1656901746163,MATH 142A,A03,093480,Chow; Bennett,7,0,32,25
1656901746163,MATH 142A,B03,093481,Chow; Bennett,7,0,32,25
1656901746163,MATH 142A,B04,093558,Chow; Bennett,10,0,32,22
1656901746163,MATH 142A,B05,093559,Chow; Bennett,6,0,32,26
1656901752198,MATH 193A,A01,083224,Rotar; Vladimir,7,0,34,27
1656901752198,MATH 193A,A02,083225,Rotar; Vladimir,3,0,34,31
1656901752198,MATH 193A,A03,083781,Rotar; Vladimir,1,0,34,33
1656901752198,MATH 193A,A04,083782,Rotar; Vladimir,6,0,34,28
1656901752198,MATH 193A,A05,093482,Rotar; Vladimir,6,0,34,28
1656901758224,MATH 197,001,091859,McAuley; Julian John,9999,0,9999,0
1656901758224,MATH 197,002,095566,Kedlaya; Kiran S.,9997,0,9999,2
1656901758224,MATH 197,003,095567,Xiao; Ming,9999,0,9999,0
1656901758224,MATH 197,004,095571,Perols; Johan Lars,9998,0,9999,1
1656901765301,COGS 9,A01,083615,Shannon; Kyle Michael,6,0,75,69
1656901771325,COGS 11,A01,083617,Boyle; Mary E. T.,19,0,48,29
1656901777351,COGS 13,A01,083071,Bastos; Amalia Pinkusfeld,8,0,71,63
1656901783381,COGS 14A,A01,092681,Semenuks; Arturs,0,1,100,100
1656901789407,COGS 14B,A01,083073,Cheng; Tzu-Han,5,0,63,58
1656901795434,COGS 17,A01,092677,Semenuks; Arturs,4,0,81,77
1656901801457,COGS 100,A01,083619,Allen; Michael Gordon,15,0,70,55
1656901807486,COGS 101A,A01,083621,Davis; Joshua Daniel,9,0,68,59
1656901813508,COGS 101B,A01,091572,Allen; Michael Gordon,8,0,65,57
1656901819531,COGS 101C,A01,083625,Delgado; Tania,17,0,35,18
1656901825554,COGS 107A,A01,083627,Boyle; Mary E. T.,13,0,60,47
1656901831577,COGS 118A,A01,083075,Gupta; Anjum,15,0,76,61
1656901837602,CSE 3,A50,083646,Miranda; Gregory Joseph,22,0,50,28
1656901843629,CSE 8A,A50,083650,Miranda; Gregory Joseph,17,1,56,39
1656901849650,CSE 11,A01,083080,Cao; Yingjun,4,15,40,36
1656901855675,CSE 12,A01,083652,Krause-Levy; Sophia Louisa,20,1,120,100
1656901861699,CSE 15L,A01,083654,Morris; Justin Loren,8,0,50,42
1656901861699,CSE 15L,A02,083655,Morris; Justin Loren,8,0,50,42
1656901867721,CSE 20,A01,083657,Tran; Khoa Dang,37,0,80,43
1656901873755,CSE 21,A01,095574,Bach; Quang Tran,21,0,48,27
1656901879777,CSE 30,A01,083084,Eldon; John,4,0,80,76
1656901879777,CSE 30,B01,095061,Bhaskar; Nishant,6,0,50,44
1656901885804,CSE 100,A01,083659,Cao; Yingjun,2,4,70,68
1656901891827,CSE 134B,A01,083661,Powell; Thomas Allan,19,0,100,81
1656901897849,CSE 140,A01,083663,Gungor; Onat,14,0,85,71
1656901903874,CSE 140L,A01,083088,Eldon; John,16,0,100,84
1656901909900,CSE 175,A01,083665,Kumar; Rakesh,3,0,25,22
1656901915925,CSE 190,A00,092507,Dubnov; Shlomo,7,0,20,13
1656901921950,ECE 45,A01,083139,Congero; Spencer William,5,0,75,70
1656901927974,ECE 65,A50,083695,Saad; Andrew S,12,0,30,18
1656901927974,ECE 65,A51,095125,Saad; Andrew S,25,0,26,1
1656901934000,ECE 109,A01,091882,Touri; Behrouz,16,0,70,54
1656901940023,ECE 180,A00,083140,Abi Samra; Nicholas Camill,0,0,30,30
1656901940023,ECE 180,B00,083141,Abi Samra; Nicholas Camill,0,0,30,30
1656901946051,MATH 10A,A01,083735,Patchell; Gregory David,1,0,30,29
1656901946051,MATH 10A,A02,083736,Patchell; Gregory David,20,0,30,10
1656901946051,MATH 10A,A03,083737,Patchell; Gregory David,15,0,30,15
1656901952076,MATH 10B,A01,083207,Lim; Seonhee,7,0,34,27
1656901952076,MATH 10B,A02,083208,Lim; Seonhee,9,0,35,26
1656901952076,MATH 10B,A03,093472,Lim; Seonhee,4,0,34,30
1656901952076,MATH 10B,B01,083739,Sinha; Shubham,9,0,30,21
1656901958105,MATH 18,A01,083743,Cinel; Cameron Alexander,6,0,30,24
1656901958105,MATH 18,A02,083744,Cinel; Cameron Alexander,15,0,30,15
1656901958105,MATH 18,A03,083745,Cinel; Cameron Alexander,8,0,30,22
1656901958105,MATH 18,B01,083748,Rideout; David Porter,4,0,37,33
1656901958105,MATH 18,B02,083749,Rideout; David Porter,3,0,36,33
1656901958105,MATH 18,B03,083750,Rideout; David Porter,2,0,37,35
1656901958105,MATH 18,B04,083751,Rideout; David Porter,5,0,36,31
1656901958105,MATH 18,B05,093473,Rideout; David Porter,4,0,36,32
1656901958105,MATH 18,B06,093474,Rideout; David Porter,5,0,36,31
1656901964129,MATH 20A,A01,083754,Zheng; Zequn,12,0,40,28
1656901970154,MATH 20B,A01,083756,Briones; Jor-el Thomas Caparas,1,0,36,35
1656901970154,MATH 20B,A02,083757,Briones; Jor-el Thomas Caparas,1,0,36,35
1656901970154,MATH 20B,A03,093475,Briones; Jor-el Thomas Caparas,0,0,36,36
1656901976177,MATH 20C,A01,083760,Briones; Jor-el Thomas Caparas,1,0,35,34
1656901976177,MATH 20C,A02,083761,Briones; Jor-el Thomas Caparas,8,0,35,27
1656901976177,MATH 20C,A03,093476,Briones; Jor-el Thomas Caparas,0,1,36,36
1656901976177,MATH 20C,B01,083762,Bach; Quang Tran,0,0,30,30
1656901982207,MATH 20D,A01,083765,Tran; Brian Kha,4,0,30,26
1656901982207,MATH 20D,A02,083766,Tran; Brian Kha,4,0,30,26
1656901982207,MATH 20D,A03,083767,Tran; Brian Kha,3,0,30,27
1656901988235,MATH 20E,A01,083771,Ganguly; Soumya,5,0,32,27
1656901988235,MATH 20E,A02,083772,Ganguly; Soumya,6,0,32,26
1656901988235,MATH 20E,B01,083773,Ciotti; Benjamin,18,0,35,17
1656901988235,MATH 20E,B02,083774,Ciotti; Benjamin,17,0,35,18
1656901994262,MATH 103A,A01,083777,Greenfeld; Be'Eri,2,0,36,34
1656901994262,MATH 103A,A02,083778,Greenfeld; Be'Eri,5,0,36,31
1656901994262,MATH 103A,A03,093561,Greenfeld; Be'Eri,4,0,36,32
1656901994262,MATH 103A,B01,083779,Greenfeld; Be'Eri,6,0,36,30
1656901994262,MATH 103A,B02,083780,Greenfeld; Be'Eri,2,0,36,34
1656901994262,MATH 103A,B03,093562,Greenfeld; Be'Eri,2,0,36,34
1656902000284,MATH 105,A01,085443,Carter; Anne Toulson,13,0,35,22
1656902000284,MATH 105,A02,093477,Carter; Anne Toulson,20,0,35,15
1656902006318,MATH 109,A01,083213,Ganzberger; Geoffrey Michael,2,0,34,32
1656902006318,MATH 109,A02,083214,Ganzberger; Geoffrey Michael,2,0,34,32
1656902006318,MATH 109,A03,093478,Ganzberger; Geoffrey Michael,1,0,34,33
1656902006318,MATH 109,B01,083215,Ganzberger; Geoffrey Michael,1,0,32,31
1656902006318,MATH 109,B02,083216,Ganzberger; Geoffrey Michael,1,0,32,31
1656902006318,MATH 109,B03,093479,Ganzberger; Geoffrey Michael,6,0,32,26
1656902012344,MATH 142A,A01,083219,Chow; Bennett,6,0,32,26
1656902012344,MATH 142A,A02,083220,Chow; Bennett,10,0,32,22
1656902012344,MATH 142A,A03,093480,Chow; Bennett,7,0,32,25
1656902012344,MATH 142A,B03,093481,Chow; Bennett,7,0,32,25
1656902012344,MATH 142A,B04,093558,Chow; Bennett,10,0,32,22
1656902012344,MATH 142A,B05,093559,Chow; Bennett,6,0,32,26
1656902018372,MATH 193A,A01,083224,Rotar; Vladimir,7,0,34,27
1656902018372,MATH 193A,A02,083225,Rotar; Vladimir,3,0,34,31
1656902018372,MATH 193A,A03,083781,Rotar; Vladimir,1,0,34,33
1656902018372,MATH 193A,A04,083782,Rotar; Vladimir,6,0,34,28
1656902018372,MATH 193A,A05,093482,Rotar; Vladimir,6,0,34,28
1656902024403,MATH 197,001,091859,McAuley; Julian John,9999,0,9999,0
1656902024403,MATH 197,002,095566,Kedlaya; Kiran S.,9997,0,9999,2
1656902024403,MATH 197,003,095567,Xiao; Ming,9999,0,9999,0
1656902024403,MATH 197,004,095571,Perols; Johan Lars,9998,0,9999,1
1656902031455,COGS 9,A01,083615,Shannon; Kyle Michael,6,0,75,69
1656902037482,COGS 11,A01,083617,Boyle; Mary E. T.,19,0,48,29
1656902043508,COGS 13,A01,083071,Bastos; Amalia Pinkusfeld,8,0,71,63
1656902049534,COGS 14A,A01,092681,Semenuks; Arturs,0,1,100,100
1656902055558,COGS 14B,A01,083073,Cheng; Tzu-Han,5,0,63,58
1656902061582,COGS 17,A01,092677,Semenuks; Arturs,4,0,81,77
1656902067608,COGS 100,A01,083619,Allen; Michael Gordon,15,0,70,55
1656902073639,COGS 101A,A01,083621,Davis; Joshua Daniel,9,0,68,59
1656902079662,COGS 101B,A01,091572,Allen; Michael Gordon,8,0,65,57
1656902085688,COGS 101C,A01,083625,Delgado; Tania,17,0,35,18
1656902091726,COGS 107A,A01,083627,Boyle; Mary E. T.,13,0,60,47
1656902097758,COGS 118A,A01,083075,Gupta; Anjum,15,0,76,61
1656902103780,CSE 3,A50,083646,Miranda; Gregory Joseph,22,0,50,28
1656902109831,CSE 8A,A50,083650,Miranda; Gregory Joseph,17,1,56,39
1656902115854,CSE 11,A01,083080,Cao; Yingjun,4,15,40,36
1656902121881,CSE 12,A01,083652,Krause-Levy; Sophia Louisa,20,1,120,100
1656902127929,CSE 15L,A01,083654,Morris; Justin Loren,8,0,50,42
1656902127929,CSE 15L,A02,083655,Morris; Justin Loren,8,0,50,42
1656902133951,CSE 20,A01,083657,Tran; Khoa Dang,37,0,80,43
1656902140048,CSE 21,A01,095574,Bach; Quang Tran,21,0,48,27
1656902146074,CSE 30,A01,083084,Eldon; John,4,0,80,76
1656902146074,CSE 30,B01,095061,Bhaskar; Nishant,6,0,50,44
1656902152101,CSE 100,A01,083659,Cao; Yingjun,2,4,70,68
1656902158144,CSE 134B,A01,083661,Powell; Thomas Allan,19,0,100,81
1656902164190,CSE 140,A01,083663,Gungor; Onat,14,0,85,71
1656902170227,CSE 140L,A01,083088,Eldon; John,16,0,100,84
1656902176249,CSE 175,A01,083665,Kumar; Rakesh,3,0,25,22
1656902182291,CSE 190,A00,092507,Dubnov; Shlomo,7,0,20,13
1656902188325,ECE 45,A01,083139,Congero; Spencer William,5,0,75,70
1656902194352,ECE 65,A50,083695,Saad; Andrew S,12,0,30,18
1656902194352,ECE 65,A51,095125,Saad; Andrew S,25,0,26,1
1656902200379,ECE 109,A01,091882,Touri; Behrouz,16,0,70,54
1656902206403,ECE 180,A00,083140,Abi Samra; Nicholas Camill,0,0,30,30
1656902206403,ECE 180,B00,083141,Abi Samra; Nicholas Camill,0,0,30,30
1656902212438,MATH 10A,A01,083735,Patchell; Gregory David,1,0,30,29
1656902212438,MATH 10A,A02,083736,Patchell; Gregory David,20,0,30,10
1656902212438,MATH 10A,A03,083737,Patchell; Gregory David,15,0,30,15
1656902218463,MATH 10B,A01,083207,Lim; Seonhee,7,0,34,27
1656902218463,MATH 10B,A02,083208,Lim; Seonhee,9,0,35,26
1656902218463,MATH 10B,A03,093472,Lim; Seonhee,4,0,34,30
1656902218463,MATH 10B,B01,083739,Sinha; Shubham,9,0,30,21
1656902224495,MATH 18,A01,083743,Cinel; Cameron Alexander,6,0,30,24
1656902224495,MATH 18,A02,083744,Cinel; Cameron Alexander,15,0,30,15
1656902224495,MATH 18,A03,083745,Cinel; Cameron Alexander,8,0,30,22
1656902224495,MATH 18,B01,083748,Rideout; David Porter,4,0,37,33
1656902224495,MATH 18,B02,083749,Rideout; David Porter,3,0,36,33
1656902224495,MATH 18,B03,083750,Rideout; David Porter,2,0,37,35
1656902224495,MATH 18,B04,083751,Rideout; David Porter,5,0,36,31
1656902224495,MATH 18,B05,093473,Rideout; David Porter,4,0,36,32
1656902224495,MATH 18,B06,093474,Rideout; David Porter,5,0,36,31
1656902230519,MATH 20A,A01,083754,Zheng; Zequn,12,0,40,28
1656902236565,MATH 20B,A01,083756,Briones; Jor-el Thomas Caparas,1,0,36,35
1656902236565,MATH 20B,A02,083757,Briones; Jor-el Thomas Caparas,1,0,36,35
1656902236565,MATH 20B,A03,093475,Briones; Jor-el Thomas Caparas,0,0,36,36
1656902242589,MATH 20C,A01,083760,Briones; Jor-el Thomas Caparas,1,0,35,34
1656902242589,MATH 20C,A02,083761,Briones; Jor-el Thomas Caparas,8,0,35,27
1656902242589,MATH 20C,A03,093476,Briones; Jor-el Thomas Caparas,0,1,36,36
1656902242589,MATH 20C,B01,083762,Bach; Quang Tran,0,0,30,30
1656902248610,MATH 20D,A01,083765,Tran; Brian Kha,4,0,30,26
1656902248610,MATH 20D,A02,083766,Tran; Brian Kha,4,0,30,26
1656902248610,MATH 20D,A03,083767,Tran; Brian Kha,3,0,30,27
1656902254649,MATH 20E,A01,083771,Ganguly; Soumya,5,0,32,27
1656902254649,MATH 20E,A02,083772,Ganguly; Soumya,6,0,32,26
1656902254649,MATH 20E,B01,083773,Ciotti; Benjamin,18,0,35,17
1656902254649,MATH 20E,B02,083774,Ciotti; Benjamin,17,0,35,18
1656902260686,MATH 103A,A01,083777,Greenfeld; Be'Eri,2,0,36,34
1656902260686,MATH 103A,A02,083778,Greenfeld; Be'Eri,5,0,36,31
1656902260686,MATH 103A,A03,093561,Greenfeld; Be'Eri,4,0,36,32
1656902260686,MATH 103A,B01,083779,Greenfeld; Be'Eri,6,0,36,30
1656902260686,MATH 103A,B02,083780,Greenfeld; Be'Eri,2,0,36,34
1656902260686,MATH 103A,B03,093562,Greenfeld; Be'Eri,2,0,36,34
1656902266707,MATH 105,A01,085443,Carter; Anne Toulson,13,0,35,22
1656902266707,MATH 105,A02,093477,Carter; Anne Toulson,20,0,35,15
1656902272733,MATH 109,A01,083213,Ganzberger; Geoffrey Michael,2,0,34,32
1656902272733,MATH 109,A02,083214,Ganzberger; Geoffrey Michael,2,0,34,32
1656902272733,MATH 109,A03,093478,Ganzberger; Geoffrey Michael,1,0,34,33
1656902272733,MATH 109,B01,083215,Ganzberger; Geoffrey Michael,1,0,32,31
1656902272733,MATH 109,B02,083216,Ganzberger; Geoffrey Michael,1,0,32,31
1656902272733,MATH 109,B03,093479,Ganzberger; Geoffrey Michael,6,0,32,26
1656902278755,MATH 142A,A01,083219,Chow; Bennett,6,0,32,26
1656902278755,MATH 142A,A02,083220,Chow; Bennett,10,0,32,22
1656902278755,MATH 142A,A03,093480,Chow; Bennett,7,0,32,25
1656902278755,MATH 142A,B03,093481,Chow; Bennett,7,0,32,25
1656902278755,MATH 142A,B04,093558,Chow; Bennett,10,0,32,22
1656902278755,MATH 142A,B05,093559,Chow; Bennett,6,0,32,26
1656902284778,MATH 193A,A01,083224,Rotar; Vladimir,7,0,34,27
1656902284778,MATH 193A,A02,083225,Rotar; Vladimir,3,0,34,31
1656902284778,MATH 193A,A03,083781,Rotar; Vladimir,1,0,34,33
1656902284778,MATH 193A,A04,083782,Rotar; Vladimir,6,0,34,28
1656902284778,MATH 193A,A05,093482,Rotar; Vladimir,6,0,34,28
1656902290810,MATH 197,001,091859,McAuley; Julian John,9999,0,9999,0
1656902290810,MATH 197,002,095566,Kedlaya; Kiran S.,9997,0,9999,2
1656902290810,MATH 197,003,095567,Xiao; Ming,9999,0,9999,0
1656902290810,MATH 197,004,095571,Perols; Johan Lars,9998,0,9999,1
1656902297887,COGS 9,A01,083615,Shannon; Kyle Michael,6,0,75,69
1656902303922,COGS 11,A01,083617,Boyle; Mary E. T.,19,0,48,29
1656902309953,COGS 13,A01,083071,Bastos; Amalia Pinkusfeld,8,0,71,63
1656902315975,COGS 14A,A01,092681,Semenuks; Arturs,0,1,100,100
1656902321997,COGS 14B,A01,083073,Cheng; Tzu-Han,5,0,63,58
1656902328020,COGS 17,A01,092677,Semenuks; Arturs,4,0,81,77
1656902334069,COGS 100,A01,083619,Allen; Michael Gordon,15,0,70,55
1656902340105,COGS 101A,A01,083621,Davis; Joshua Daniel,9,0,68,59
1656902346156,COGS 101B,A01,091572,Allen; Michael Gordon,8,0,65,57
1656902352206,COGS 101C,A01,083625,Delgado; Tania,17,0,35,18
1656902358230,COGS 107A,A01,083627,Boyle; Mary E. T.,13,0,60,47
1656902364272,COGS 118A,A01,083075,Gupta; Anjum,15,0,76,61
1656902370296,CSE 3,A50,083646,Miranda; Gregory Joseph,22,0,50,28
1656902376320,CSE 8A,A50,083650,Miranda; Gregory Joseph,17,1,56,39
1656902382349,CSE 11,A01,083080,Cao; Yingjun,4,15,40,36
1656902388404,CSE 12,A01,083652,Krause-Levy; Sophia Louisa,20,1,120,100
1656902394426,CSE 15L,A01,083654,Morris; Justin Loren,8,0,50,42
1656902394426,CSE 15L,A02,083655,Morris; Justin Loren,8,0,50,42
1656902400466,CSE 20,A01,083657,Tran; Khoa Dang,37,0,80,43
1656902406489,CSE 21,A01,095574,Bach; Quang Tran,21,0,48,27
1656902412528,CSE 30,A01,083084,Eldon; John,4,0,80,76
1656902412528,CSE 30,B01,095061,Bhaskar; Nishant,6,0,50,44
1656902418555,CSE 100,A01,083659,Cao; Yingjun,2,4,70,68
1656902424578,CSE 134B,A01,083661,Powell; Thomas Allan,19,0,100,81
1656902430604,CSE 140,A01,083663,Gungor; Onat,14,0,85,71
1656902436637,CSE 140L,A01,083088,Eldon; John,16,0,100,84
1656902442661,CSE 175,A01,083665,Kumar; Rakesh,3,0,25,22
1656902448687,CSE 190,A00,092507,Dubnov; Shlomo,7,0,20,13
1656902454715,ECE 45,A01,083139,Congero; Spencer William,5,0,75,70
1656902460736,ECE 65,A50,083695,Saad; Andrew S,12,0,30,18
1656902460736,ECE 65,A51,095125,Saad; Andrew S,25,0,26,1
1656902466764,ECE 109,A01,091882,Touri; Behrouz,16,0,70,54
1656902472792,ECE 180,A00,083140,Abi Samra; Nicholas Camill,0,0,30,30
1656902472792,ECE 180,B00,083141,Abi Samra; Nicholas Camill,0,0,30,30
1656902478820,MATH 10A,A01,083735,Patchell; Gregory David,1,0,30,29
1656902478820,MATH 10A,A02,083736,Patchell; Gregory David,20,0,30,10
1656902478820,MATH 10A,A03,083737,Patchell; Gregory David,15,0,30,15
1656902484854,MATH 10B,A01,083207,Lim; Seonhee,7,0,34,27
1656902484854,MATH 10B,A02,083208,Lim; Seonhee,9,0,35,26
1656902484854,MATH 10B,A03,093472,Lim; Seonhee,4,0,34,30
1656902484854,MATH 10B,B01,083739,Sinha; Shubham,9,0,30,21
1656902490889,MATH 18,A01,083743,Cinel; Cameron Alexander,6,0,30,24
1656902490889,MATH 18,A02,083744,Cinel; Cameron Alexander,15,0,30,15
1656902490889,MATH 18,A03,083745,Cinel; Cameron Alexander,8,0,30,22
1656902490889,MATH 18,B01,083748,Rideout; David Porter,4,0,37,33
1656902490889,MATH 18,B02,083749,Rideout; David Porter,3,0,36,33
1656902490889,MATH 18,B03,083750,Rideout; David Porter,2,0,37,35
1656902490889,MATH 18,B04,083751,Rideout; David Porter,5,0,36,31
1656902490889,MATH 18,B05,093473,Rideout; David Porter,4,0,36,32
1656902490889,MATH 18,B06,093474,Rideout; David Porter,5,0,36,31
1656902496911,MATH 20A,A01,083754,Zheng; Zequn,12,0,40,28
1656902502934,MATH 20B,A01,083756,Briones; Jor-el Thomas Caparas,1,0,36,35
1656902502934,MATH 20B,A02,083757,Briones; Jor-el Thomas Caparas,1,0,36,35
1656902502934,MATH 20B,A03,093475,Briones; Jor-el Thomas Caparas,0,0,36,36
1656902508958,MATH 20C,A01,083760,Briones; Jor-el Thomas Caparas,1,0,35,34
1656902508958,MATH 20C,A02,083761,Briones; Jor-el Thomas Caparas,8,0,35,27
1656902508958,MATH 20C,A03,093476,Briones; Jor-el Thomas Caparas,0,1,36,36
1656902508958,MATH 20C,B01,083762,Bach; Quang Tran,0,0,30,30
1656902514980,MATH 20D,A01,083765,Tran; Brian Kha,4,0,30,26
1656902514980,MATH 20D,A02,083766,Tran; Brian Kha,4,0,30,26
1656902514980,MATH 20D,A03,083767,Tran; Brian Kha,3,0,30,27
1656902521033,MATH 20E,A01,083771,Ganguly; Soumya,5,0,32,27
1656902521033,MATH 20E,A02,083772,Ganguly; Soumya,6,0,32,26
1656902521033,MATH 20E,B01,083773,Ciotti; Benjamin,18,0,35,17
1656902521033,MATH 20E,B02,083774,Ciotti; Benjamin,17,0,35,18
1656902527057,MATH 103A,A01,083777,Greenfeld; Be'Eri,2,0,36,34
1656902527057,MATH 103A,A02,083778,Greenfeld; Be'Eri,5,0,36,31
1656902527057,MATH 103A,A03,093561,Greenfeld; Be'Eri,4,0,36,32
1656902527057,MATH 103A,B01,083779,Greenfeld; Be'Eri,6,0,36,30
1656902527057,MATH 103A,B02,083780,Greenfeld; Be'Eri,2,0,36,34
1656902527057,MATH 103A,B03,093562,Greenfeld; Be'Eri,2,0,36,34
1656902533096,MATH 105,A01,085443,Carter; Anne Toulson,13,0,35,22
1656902533096,MATH 105,A02,093477,Carter; Anne Toulson,20,0,35,15
1656902539117,MATH 109,A01,083213,Ganzberger; Geoffrey Michael,2,0,34,32
1656902539117,MATH 109,A02,083214,Ganzberger; Geoffrey Michael,2,0,34,32
1656902539117,MATH 109,A03,093478,Ganzberger; Geoffrey Michael,1,0,34,33
1656902539117,MATH 109,B01,083215,Ganzberger; Geoffrey Michael,1,0,32,31
1656902539117,MATH 109,B02,083216,Ganzberger; Geoffrey Michael,1,0,32,31
1656902539117,MATH 109,B03,093479,Ganzberger; Geoffrey Michael,6,0,32,26
1656902545153,MATH 142A,A01,083219,Chow; Bennett,6,0,32,26
1656902545153,MATH 142A,A02,083220,Chow; Bennett,10,0,32,22
1656902545153,MATH 142A,A03,093480,Chow; Bennett,7,0,32,25
1656902545153,MATH 142A,B03,093481,Chow; Bennett,7,0,32,25
1656902545153,MATH 142A,B04,093558,Chow; Bennett,10,0,32,22
1656902545153,MATH 142A,B05,093559,Chow; Bennett,6,0,32,26
1656902551184,MATH 193A,A01,083224,Rotar; Vladimir,7,0,34,27
1656902551184,MATH 193A,A02,083225,Rotar; Vladimir,3,0,34,31
1656902551184,MATH 193A,A03,083781,Rotar; Vladimir,1,0,34,33
1656902551184,MATH 193A,A04,083782,Rotar; Vladimir,6,0,34,28
1656902551184,MATH 193A,A05,093482,Rotar; Vladimir,6,0,34,28
1656902557213,MATH 197,001,091859,McAuley; Julian John,9999,0,9999,0
1656902557213,MATH 197,002,095566,Kedlaya; Kiran S.,9997,0,9999,2
1656902557213,MATH 197,003,095567,Xiao; Ming,9999,0,9999,0
1656902557213,MATH 197,004,095571,Perols; Johan Lars,9998,0,9999,1
1656902564269,COGS 9,A01,083615,Shannon; Kyle Michael,6,0,75,69
1656902570292,COGS 11,A01,083617,Boyle; Mary E. T.,19,0,48,29
1656902576321,COGS 13,A01,083071,Bastos; Amalia Pinkusfeld,8,0,71,63
1656902582344,COGS 14A,A01,092681,Semenuks; Arturs,0,1,100,100
1656902588373,COGS 14B,A01,083073,Cheng; Tzu-Han,5,0,63,58
1656902594427,COGS 17,A01,092677,Semenuks; Arturs,4,0,81,77
1656902600461,COGS 100,A01,083619,Allen; Michael Gordon,15,0,70,55
1656902606485,COGS 101A,A01,083621,Davis; Joshua Daniel,9,0,68,59
1656902612517,COGS 101B,A01,091572,Allen; Michael Gordon,8,0,65,57
1656902618549,COGS 101C,A01,083625,Delgado; Tania,17,0,35,18
1656902624573,COGS 107A,A01,083627,Boyle; Mary E. T.,13,0,60,47
1656902630596,COGS 118A,A01,083075,Gupta; Anjum,15,0,76,61
1656902636625,CSE 3,A50,083646,Miranda; Gregory Joseph,22,0,50,28
1656902642649,CSE 8A,A50,083650,Miranda; Gregory Joseph,17,1,56,39
1656902648674,CSE 11,A01,083080,Cao; Yingjun,4,15,40,36
1656902654700,CSE 12,A01,083652,Krause-Levy; Sophia Louisa,20,1,120,100
1656902660728,CSE 15L,A01,083654,Morris; Justin Loren,8,0,50,42
1656902660728,CSE 15L,A02,083655,Morris; Justin Loren,8,0,50,42
1656902666752,CSE 20,A01,083657,Tran; Khoa Dang,37,0,80,43
1656902672776,CSE 21,A01,095574,Bach; Quang Tran,21,0,48,27
1656902678810,CSE 30,A01,083084,Eldon; John,4,0,80,76
1656902678810,CSE 30,B01,095061,Bhaskar; Nishant,6,0,50,44
1656902684834,CSE 100,A01,083659,Cao; Yingjun,2,4,70,68
1656902690868,CSE 134B,A01,083661,Powell; Thomas Allan,19,0,100,81
1656902696891,CSE 140,A01,083663,Gungor; Onat,14,0,85,71
1656902702914,CSE 140L,A01,083088,Eldon; John,16,0,100,84
1656902708939,CSE 175,A01,083665,Kumar; Rakesh,3,0,25,22
1656902714963,CSE 190,A00,092507,Dubnov; Shlomo,7,0,20,13
1656902720986,ECE 45,A01,083139,Congero; Spencer William,5,0,75,70
1656902727009,ECE 65,A50,083695,Saad; Andrew S,12,0,30,18
1656902727009,ECE 65,A51,095125,Saad; Andrew S,25,0,26,1
1656902733046,ECE 109,A01,091882,Touri; Behrouz,16,0,70,54
1656902739175,ECE 180,A00,083140,Abi Samra; Nicholas Camill,0,0,30,30
1656902739175,ECE 180,B00,083141,Abi Samra; Nicholas Camill,0,0,30,30
1656902745205,MATH 10A,A01,083735,Patchell; Gregory David,1,0,30,29
1656902745205,MATH 10A,A02,083736,Patchell; Gregory David,20,0,30,10
1656902745205,MATH 10A,A03,083737,Patchell; Gregory David,15,0,30,15
1656902751234,MATH 10B,A01,083207,Lim; Seonhee,7,0,34,27
1656902751234,MATH 10B,A02,083208,Lim; Seonhee,9,0,35,26
1656902751234,MATH 10B,A03,093472,Lim; Seonhee,4,0,34,30
1656902751234,MATH 10B,B01,083739,Sinha; Shubham,9,0,30,21
1656902757260,MATH 18,A01,083743,Cinel; Cameron Alexander,6,0,30,24
1656902757260,MATH 18,A02,083744,Cinel; Cameron Alexander,15,0,30,15
1656902757260,MATH 18,A03,083745,Cinel; Cameron Alexander,8,0,30,22
1656902757260,MATH 18,B01,083748,Rideout; David Porter,4,0,37,33
1656902757260,MATH 18,B02,083749,Rideout; David Porter,3,0,36,33
1656902757260,MATH 18,B03,083750,Rideout; David Porter,2,0,37,35
1656902757260,MATH 18,B04,083751,Rideout; David Porter,5,0,36,31
1656902757260,MATH 18,B05,093473,Rideout; David Porter,4,0,36,32
1656902757260,MATH 18,B06,093474,Rideout; David Porter,5,0,36,31
1656902763312,MATH 20A,A01,083754,Zheng; Zequn,12,0,40,28
1656902769354,MATH 20B,A01,083756,Briones; Jor-el Thomas Caparas,1,0,36,35
1656902769354,MATH 20B,A02,083757,Briones; Jor-el Thomas Caparas,1,0,36,35
1656902769354,MATH 20B,A03,093475,Briones; Jor-el Thomas Caparas,0,0,36,36
1656902775385,MATH 20C,A01,083760,Briones; Jor-el Thomas Caparas,1,0,35,34
1656902775385,MATH 20C,A02,083761,Briones; Jor-el Thomas Caparas,8,0,35,27
1656902775385,MATH 20C,A03,093476,Briones; Jor-el Thomas Caparas,0,1,36,36
1656902775385,MATH 20C,B01,083762,Bach; Quang Tran,0,0,30,30
1656902781410,MATH 20D,A01,083765,Tran; Brian Kha,4,0,30,26
1656902781410,MATH 20D,A02,083766,Tran; Brian Kha,4,0,30,26
1656902781410,MATH 20D,A03,083767,Tran; Brian Kha,3,0,30,27
1656902787445,MATH 20E,A01,083771,Ganguly; Soumya,5,0,32,27
1656902787445,MATH 20E,A02,083772,Ganguly; Soumya,6,0,32,26
1656902787445,MATH 20E,B01,083773,Ciotti; Benjamin,18,0,35,17
1656902787445,MATH 20E,B02,083774,Ciotti; Benjamin,17,0,35,18
1656902793495,MATH 103A,A01,083777,Greenfeld; Be'Eri,2,0,36,34
1656902793495,MATH 103A,A02,083778,Greenfeld; Be'Eri,5,0,36,31
1656902793495,MATH 103A,A03,093561,Greenfeld; Be'Eri,4,0,36,32
1656902793495,MATH 103A,B01,083779,Greenfeld; Be'Eri,6,0,36,30
1656902793495,MATH 103A,B02,083780,Greenfeld; Be'Eri,2,0,36,34
1656902793495,MATH 103A,B03,093562,Greenfeld; Be'Eri,2,0,36,34
1656902799523,MATH 105,A01,085443,Carter; Anne Toulson,13,0,35,22
1656902799523,MATH 105,A02,093477,Carter; Anne Toulson,20,0,35,15
1656902805547,MATH 109,A01,083213,Ganzberger; Geoffrey Michael,2,0,34,32
1656902805547,MATH 109,A02,083214,Ganzberger; Geoffrey Michael,2,0,34,32
1656902805547,MATH 109,A03,093478,Ganzberger; Geoffrey Michael,1,0,34,33
1656902805547,MATH 109,B01,083215,Ganzberger; Geoffrey Michael,1,0,32,31
1656902805547,MATH 109,B02,083216,Ganzberger; Geoffrey Michael,1,0,32,31
1656902805547,MATH 109,B03,093479,Ganzberger; Geoffrey Michael,6,0,32,26
1656902811572,MATH 142A,A01,083219,Chow; Bennett,6,0,32,26
1656902811572,MATH 142A,A02,083220,Chow; Bennett,10,0,32,22
1656902811572,MATH 142A,A03,093480,Chow; Bennett,7,0,32,25
1656902811572,MATH 142A,B03,093481,Chow; Bennett,7,0,32,25
1656902811572,MATH 142A,B04,093558,Chow; Bennett,10,0,32,22
1656902811572,MATH 142A,B05,093559,Chow; Bennett,6,0,32,26
1656902817610,MATH 193A,A01,083224,Rotar; Vladimir,7,0,34,27
1656902817610,MATH 193A,A02,083225,Rotar; Vladimir,3,0,34,31
1656902817610,MATH 193A,A03,083781,Rotar; Vladimir,1,0,34,33
1656902817610,MATH 193A,A04,083782,Rotar; Vladimir,6,0,34,28
1656902817610,MATH 193A,A05,093482,Rotar; Vladimir,6,0,34,28
1656902823644,MATH 197,001,091859,McAuley; Julian John,9999,0,9999,0
1656902823644,MATH 197,002,095566,Kedlaya; Kiran S.,9997,0,9999,2
1656902823644,MATH 197,003,095567,Xiao; Ming,9999,0,9999,0
1656902823644,MATH 197,004,095571,Perols; Johan Lars,9998,0,9999,1
1656902830696,COGS 9,A01,083615,Shannon; Kyle Michael,6,0,75,69
1656902836722,COGS 11,A01,083617,Boyle; Mary E. T.,19,0,48,29
1656902842751,COGS 13,A01,083071,Bastos; Amalia Pinkusfeld,8,0,71,63
1656902848775,COGS 14A,A01,092681,Semenuks; Arturs,0,1,100,100
1656902854798,COGS 14B,A01,083073,Cheng; Tzu-Han,5,0,63,58
1656902860821,COGS 17,A01,092677,Semenuks; Arturs,4,0,81,77
1656902866844,COGS 100,A01,083619,Allen; Michael Gordon,15,0,70,55
1656902872882,COGS 101A,A01,083621,Davis; Joshua Daniel,9,0,68,59
1656902878910,COGS 101B,A01,091572,Allen; Michael Gordon,8,0,65,57
1656902884936,COGS 101C,A01,083625,Delgado; Tania,17,0,35,18
1656902890970,COGS 107A,A01,083627,Boyle; Mary E. T.,13,0,60,47
1656902897016,COGS 118A,A01,083075,Gupta; Anjum,15,0,76,61
1656902903064,CSE 3,A50,083646,Miranda; Gregory Joseph,22,0,50,28
1656902909087,CSE 8A,A50,083650,Miranda; Gregory Joseph,17,1,56,39
1656902915116,CSE 11,A01,083080,Cao; Yingjun,4,15,40,36
1656902921139,CSE 12,A01,083652,Krause-Levy; Sophia Louisa,20,1,120,100
1656902927171,CSE 15L,A01,083654,Morris; Justin Loren,8,0,50,42
1656902927171,CSE 15L,A02,083655,Morris; Justin Loren,8,0,50,42
1656902933225,CSE 20,A01,083657,Tran; Khoa Dang,37,0,80,43
1656902939273,CSE 21,A01,095574,Bach; Quang Tran,21,0,48,27
1656902945328,CSE 30,A01,083084,Eldon; John,4,0,80,76
1656902945328,CSE 30,B01,095061,Bhaskar; Nishant,6,0,50,44
1656902951355,CSE 100,A01,083659,Cao; Yingjun,2,4,70,68
1656902957380,CSE 134B,A01,083661,Powell; Thomas Allan,19,0,100,81
1656902963407,CSE 140,A01,083663,Gungor; Onat,14,0,85,71
1656902969431,CSE 140L,A01,083088,Eldon; John,16,0,100,84
1656902975454,CSE 175,A01,083665,Kumar; Rakesh,3,0,25,22
1656902981477,CSE 190,A00,092507,Dubnov; Shlomo,7,0,20,13
1656902987500,ECE 45,A01,083139,Congero; Spencer William,5,0,75,70
1656902993524,ECE 65,A50,083695,Saad; Andrew S,12,0,30,18
1656902993524,ECE 65,A51,095125,Saad; Andrew S,25,0,26,1
1656902999548,ECE 109,A01,091882,Touri; Behrouz,16,0,70,54
1656903005574,ECE 180,A00,083140,Abi Samra; Nicholas Camill,0,0,30,30
1656903005574,ECE 180,B00,083141,Abi Samra; Nicholas Camill,0,0,30,30
1656903011610,MATH 10A,A01,083735,Patchell; Gregory David,1,0,30,29
1656903011610,MATH 10A,A02,083736,Patchell; Gregory David,20,0,30,10
1656903011610,MATH 10A,A03,083737,Patchell; Gregory David,15,0,30,15
1656903017635,MATH 10B,A01,083207,Lim; Seonhee,7,0,34,27
1656903017635,MATH 10B,A02,083208,Lim; Seonhee,9,0,35,26
1656903017635,MATH 10B,A03,093472,Lim; Seonhee,4,0,34,30
1656903017635,MATH 10B,B01,083739,Sinha; Shubham,9,0,30,21
1656903023668,MATH 18,A01,083743,Cinel; Cameron Alexander,6,0,30,24
1656903023668,MATH 18,A02,083744,Cinel; Cameron Alexander,15,0,30,15
1656903023668,MATH 18,A03,083745,Cinel; Cameron Alexander,8,0,30,22
1656903023668,MATH 18,B01,083748,Rideout; David Porter,4,0,37,33
1656903023668,MATH 18,B02,083749,Rideout; David Porter,3,0,36,33
1656903023668,MATH 18,B03,083750,Rideout; David Porter,2,0,37,35
1656903023668,MATH 18,B04,083751,Rideout; David Porter,5,0,36,31
1656903023668,MATH 18,B05,093473,Rideout; David Porter,4,0,36,32
1656903023668,MATH 18,B06,093474,Rideout; David Porter,5,0,36,31
1656903029700,MATH 20A,A01,083754,Zheng; Zequn,12,0,40,28
1656903035727,MATH 20B,A01,083756,Briones; Jor-el Thomas Caparas,1,0,36,35
1656903035727,MATH 20B,A02,083757,Briones; Jor-el Thomas Caparas,1,0,36,35
1656903035727,MATH 20B,A03,093475,Briones; Jor-el Thomas Caparas,0,0,36,36
1656903041759,MATH 20C,A01,083760,Briones; Jor-el Thomas Caparas,1,0,35,34
1656903041759,MATH 20C,A02,083761,Briones; Jor-el Thomas Caparas,8,0,35,27
1656903041759,MATH 20C,A03,093476,Briones; Jor-el Thomas Caparas,0,1,36,36
1656903041759,MATH 20C,B01,083762,Bach; Quang Tran,0,0,30,30
1656903047786,MATH 20D,A01,083765,Tran; Brian Kha,4,0,30,26
1656903047786,MATH 20D,A02,083766,Tran; Brian Kha,4,0,30,26
1656903047786,MATH 20D,A03,083767,Tran; Brian Kha,3,0,30,27
1656903053824,MATH 20E,A01,083771,Ganguly; Soumya,5,0,32,27
1656903053824,MATH 20E,A02,083772,Ganguly; Soumya,6,0,32,26
1656903053824,MATH 20E,B01,083773,Ciotti; Benjamin,18,0,35,17
1656903053824,MATH 20E,B02,083774,Ciotti; Benjamin,17,0,35,18
1656903059851,MATH 103A,A01,083777,Greenfeld; Be'Eri,2,0,36,34
1656903059851,MATH 103A,A02,083778,Greenfeld; Be'Eri,5,0,36,31
1656903059851,MATH 103A,A03,093561,Greenfeld; Be'Eri,4,0,36,32
1656903059851,MATH 103A,B01,083779,Greenfeld; Be'Eri,6,0,36,30
1656903059851,MATH 103A,B02,083780,Greenfeld; Be'Eri,2,0,36,34
1656903059851,MATH 103A,B03,093562,Greenfeld; Be'Eri,2,0,36,34
1656903065878,MATH 105,A01,085443,Carter; Anne Toulson,13,0,35,22
1656903065878,MATH 105,A02,093477,Carter; Anne Toulson,20,0,35,15
1656903071913,MATH 109,A01,083213,Ganzberger; Geoffrey Michael,2,0,34,32
1656903071913,MATH 109,A02,083214,Ganzberger; Geoffrey Michael,2,0,34,32
1656903071913,MATH 109,A03,093478,Ganzberger; Geoffrey Michael,1,0,34,33
1656903071913,MATH 109,B01,083215,Ganzberger; Geoffrey Michael,1,0,32,31
1656903071913,MATH 109,B02,083216,Ganzberger; Geoffrey Michael,1,0,32,31
1656903071913,MATH 109,B03,093479,Ganzberger; Geoffrey Michael,6,0,32,26
1656903077938,MATH 142A,A01,083219,Chow; Bennett,6,0,32,26
1656903077938,MATH 142A,A02,083220,Chow; Bennett,10,0,32,22
1656903077938,MATH 142A,A03,093480,Chow; Bennett,7,0,32,25
1656903077938,MATH 142A,B03,093481,Chow; Bennett,7,0,32,25
1656903077938,MATH 142A,B04,093558,Chow; Bennett,10,0,32,22
1656903077938,MATH 142A,B05,093559,Chow; Bennett,6,0,32,26
1656903083961,MATH 193A,A01,083224,Rotar; Vladimir,7,0,34,27
1656903083961,MATH 193A,A02,083225,Rotar; Vladimir,3,0,34,31
1656903083961,MATH 193A,A03,083781,Rotar; Vladimir,1,0,34,33
1656903083961,MATH 193A,A04,083782,Rotar; Vladimir,6,0,34,28
1656903083961,MATH 193A,A05,093482,Rotar; Vladimir,6,0,34,28
1656903089983,MATH 197,001,091859,McAuley; Julian John,9999,0,9999,0
1656903089983,MATH 197,002,095566,Kedlaya; Kiran S.,9997,0,9999,2
1656903089983,MATH 197,003,095567,Xiao; Ming,9999,0,9999,0
1656903089983,MATH 197,004,095571,Perols; Johan Lars,9998,0,9999,1
1656903097046,COGS 9,A01,083615,Shannon; Kyle Michael,6,0,75,69
1656903103101,COGS 11,A01,083617,Boyle; Mary E. T.,19,0,48,29
1656903109124,COGS 13,A01,083071,Bastos; Amalia Pinkusfeld,8,0,71,63
1656903115146,COGS 14A,A01,092681,Semenuks; Arturs,0,1,100,100
1656903121191,COGS 14B,A01,083073,Cheng; Tzu-Han,5,0,63,58
1656903127213,COGS 17,A01,092677,Semenuks; Arturs,4,0,81,77
1656903133240,COGS 100,A01,083619,Allen; Michael Gordon,15,0,70,55
1656903139263,COGS 101A,A01,083621,Davis; Joshua Daniel,9,0,68,59
1656903145288,COGS 101B,A01,091572,Allen; Michael Gordon,8,0,65,57
1656903151312,COGS 101C,A01,083625,Delgado; Tania,17,0,35,18
1656903157336,COGS 107A,A01,083627,Boyle; Mary E. T.,13,0,60,47
1656903163380,COGS 118A,A01,083075,Gupta; Anjum,15,0,76,61
1656903169415,CSE 3,A50,083646,Miranda; Gregory Joseph,22,0,50,28
1656903175458,CSE 8A,A50,083650,Miranda; Gregory Joseph,17,1,56,39
1656903181483,CSE 11,A01,083080,Cao; Yingjun,4,15,40,36
1656903187508,CSE 12,A01,083652,Krause-Levy; Sophia Louisa,20,1,120,100
1656903193548,CSE 15L,A01,083654,Morris; Justin Loren,8,0,50,42
1656903193548,CSE 15L,A02,083655,Morris; Justin Loren,8,0,50,42
1656903199570,CSE 20,A01,083657,Tran; Khoa Dang,37,0,80,43
1656903205597,CSE 21,A01,095574,Bach; Quang Tran,21,0,48,27
1656903211638,CSE 30,A01,083084,Eldon; John,4,0,80,76
1656903211638,CSE 30,B01,095061,Bhaskar; Nishant,6,0,50,44
1656903217659,CSE 100,A01,083659,Cao; Yingjun,2,4,70,68
1656903223682,CSE 134B,A01,083661,Powell; Thomas Allan,19,0,100,81
1656903229714,CSE 140,A01,083663,Gungor; Onat,14,0,85,71
1656903235753,CSE 140L,A01,083088,Eldon; John,16,0,100,84
1656903241775,CSE 175,A01,083665,Kumar; Rakesh,3,0,25,22
1656903247800,CSE 190,A00,092507,Dubnov; Shlomo,7,0,20,13
1656903253827,ECE 45,A01,083139,Congero; Spencer William,5,0,75,70
1656903259851,ECE 65,A50,083695,Saad; Andrew S,12,0,30,18
1656903259851,ECE 65,A51,095125,Saad; Andrew S,25,0,26,1
1656903265876,ECE 109,A01,091882,Touri; Behrouz,16,0,70,54
1656903271910,ECE 180,A00,083140,Abi Samra; Nicholas Camill,0,0,30,30
1656903271910,ECE 180,B00,083141,Abi Samra; Nicholas Camill,0,0,30,30
1656903277936,MATH 10A,A01,083735,Patchell; Gregory David,1,0,30,29
1656903277936,MATH 10A,A02,083736,Patchell; Gregory David,20,0,30,10
1656903277936,MATH 10A,A03,083737,Patchell; Gregory David,15,0,30,15
1656903283964,MATH 10B,A01,083207,Lim; Seonhee,7,0,34,27
1656903283964,MATH 10B,A02,083208,Lim; Seonhee,9,0,35,26
1656903283964,MATH 10B,A03,093472,Lim; Seonhee,4,0,34,30
1656903283964,MATH 10B,B01,083739,Sinha; Shubham,9,0,30,21
1656903289988,MATH 18,A01,083743,Cinel; Cameron Alexander,6,0,30,24
1656903289988,MATH 18,A02,083744,Cinel; Cameron Alexander,15,0,30,15
1656903289988,MATH 18,A03,083745,Cinel; Cameron Alexander,8,0,30,22
1656903289988,MATH 18,B01,083748,Rideout; David Porter,4,0,37,33
1656903289988,MATH 18,B02,083749,Rideout; David Porter,3,0,36,33
1656903289988,MATH 18,B03,083750,Rideout; David Porter,2,0,37,35
1656903289988,MATH 18,B04,083751,Rideout; David Porter,5,0,36,31
1656903289988,MATH 18,B05,093473,Rideout; David Porter,4,0,36,32
1656903289988,MATH 18,B06,093474,Rideout; David Porter,5,0,36,31
1656903296012,MATH 20A,A01,083754,Zheng; Zequn,12,0,40,28
1656903302040,MATH 20B,A01,083756,Briones; Jor-el Thomas Caparas,1,0,36,35
1656903302040,MATH 20B,A02,083757,Briones; Jor-el Thomas Caparas,1,0,36,35
1656903302040,MATH 20B,A03,093475,Briones; Jor-el Thomas Caparas,0,0,36,36
1656903308064,MATH 20C,A01,083760,Briones; Jor-el Thomas Caparas,1,0,35,34
1656903308064,MATH 20C,A02,083761,Briones; Jor-el Thomas Caparas,8,0,35,27
1656903308064,MATH 20C,A03,093476,Briones; Jor-el Thomas Caparas,0,1,36,36
1656903308064,MATH 20C,B01,083762,Bach; Quang Tran,0,0,30,30
1656903314092,MATH 20D,A01,083765,Tran; Brian Kha,4,0,30,26
1656903314092,MATH 20D,A02,083766,Tran; Brian Kha,4,0,30,26
1656903314092,MATH 20D,A03,083767,Tran; Brian Kha,3,0,30,27
1656903320122,MATH 20E,A01,083771,Ganguly; Soumya,5,0,32,27
1656903320122,MATH 20E,A02,083772,Ganguly; Soumya,6,0,32,26
1656903320122,MATH 20E,B01,083773,Ciotti; Benjamin,18,0,35,17
1656903320122,MATH 20E,B02,083774,Ciotti; Benjamin,17,0,35,18
1656903326150,MATH 103A,A01,083777,Greenfeld; Be'Eri,2,0,36,34
1656903326150,MATH 103A,A02,083778,Greenfeld; Be'Eri,5,0,36,31
1656903326150,MATH 103A,A03,093561,Greenfeld; Be'Eri,4,0,36,32
1656903326150,MATH 103A,B01,083779,Greenfeld; Be'Eri,6,0,36,30
1656903326150,MATH 103A,B02,083780,Greenfeld; Be'Eri,2,0,36,34
1656903326150,MATH 103A,B03,093562,Greenfeld; Be'Eri,2,0,36,34
1656903332174,MATH 105,A01,085443,Carter; Anne Toulson,13,0,35,22
1656903332174,MATH 105,A02,093477,Carter; Anne Toulson,20,0,35,15
1656903338285,MATH 109,A01,083213,Ganzberger; Geoffrey Michael,2,0,34,32
1656903338285,MATH 109,A02,083214,Ganzberger; Geoffrey Michael,2,0,34,32
1656903338285,MATH 109,A03,093478,Ganzberger; Geoffrey Michael,1,0,34,33
1656903338285,MATH 109,B01,083215,Ganzberger; Geoffrey Michael,1,0,32,31
1656903338285,MATH 109,B02,083216,Ganzberger; Geoffrey Michael,1,0,32,31
1656903338285,MATH 109,B03,093479,Ganzberger; Geoffrey Michael,6,0,32,26
1656903344326,MATH 142A,A01,083219,Chow; Bennett,6,0,32,26
1656903344326,MATH 142A,A02,083220,Chow; Bennett,10,0,32,22
1656903344326,MATH 142A,A03,093480,Chow; Bennett,7,0,32,25
1656903344326,MATH 142A,B03,093481,Chow; Bennett,7,0,32,25
1656903344326,MATH 142A,B04,093558,Chow; Bennett,10,0,32,22
1656903344326,MATH 142A,B05,093559,Chow; Bennett,6,0,32,26
1656903350355,MATH 193A,A01,083224,Rotar; Vladimir,7,0,34,27
1656903350355,MATH 193A,A02,083225,Rotar; Vladimir,3,0,34,31
1656903350355,MATH 193A,A03,083781,Rotar; Vladimir,1,0,34,33
1656903350355,MATH 193A,A04,083782,Rotar; Vladimir,6,0,34,28
1656903350355,MATH 193A,A05,093482,Rotar; Vladimir,6,0,34,28
1656903356383,MATH 197,001,091859,McAuley; Julian John,9999,0,9999,0
1656903356383,MATH 197,002,095566,Kedlaya; Kiran S.,9997,0,9999,2
1656903356383,MATH 197,003,095567,Xiao; Ming,9999,0,9999,0
1656903356383,MATH 197,004,095571,Perols; Johan Lars,9998,0,9999,1
1656903363445,COGS 9,A01,083615,Shannon; Kyle Michael,6,0,75,69
1656903369469,COGS 11,A01,083617,Boyle; Mary E. T.,19,0,48,29
1656903375496,COGS 13,A01,083071,Bastos; Amalia Pinkusfeld,8,0,71,63
1656903381521,COGS 14A,A01,092681,Semenuks; Arturs,0,1,100,100
1656903387548,COGS 14B,A01,083073,Cheng; Tzu-Han,5,0,63,58
1656903393574,COGS 17,A01,092677,Semenuks; Arturs,4,0,81,77
1656903399599,COGS 100,A01,083619,Allen; Michael Gordon,15,0,70,55
1656903405621,COGS 101A,A01,083621,Davis; Joshua Daniel,9,0,68,59
1656903411644,COGS 101B,A01,091572,Allen; Michael Gordon,8,0,65,57
1656903417670,COGS 101C,A01,083625,Delgado; Tania,17,0,35,18
1656903423693,COGS 107A,A01,083627,Boyle; Mary E. T.,13,0,60,47
1656903429721,COGS 118A,A01,083075,Gupta; Anjum,15,0,76,61
1656903435753,CSE 3,A50,083646,Miranda; Gregory Joseph,22,0,50,28
1656903441777,CSE 8A,A50,083650,Miranda; Gregory Joseph,17,1,56,39
1656903447800,CSE 11,A01,083080,Cao; Yingjun,4,15,40,36
1656903453827,CSE 12,A01,083652,Krause-Levy; Sophia Louisa,20,1,120,100
1656903459855,CSE 15L,A01,083654,Morris; Justin Loren,8,0,50,42
1656903459855,CSE 15L,A02,083655,Morris; Justin Loren,8,0,50,42
1656903465882,CSE 20,A01,083657,Tran; Khoa Dang,37,0,80,43
1656903471908,CSE 21,A01,095574,Bach; Quang Tran,21,0,48,27
1656903477932,CSE 30,A01,083084,Eldon; John,4,0,80,76
1656903477932,CSE 30,B01,095061,Bhaskar; Nishant,6,0,50,44
1656903483958,CSE 100,A01,083659,Cao; Yingjun,2,4,70,68
1656903489984,CSE 134B,A01,083661,Powell; Thomas Allan,19,0,100,81
1656903496006,CSE 140,A01,083663,Gungor; Onat,14,0,85,71
1656903502037,CSE 140L,A01,083088,Eldon; John,16,0,100,84
1656903508064,CSE 175,A01,083665,Kumar; Rakesh,3,0,25,22
1656903514086,CSE 190,A00,092507,Dubnov; Shlomo,7,0,20,13
1656903520108,ECE 45,A01,083139,Congero; Spencer William,5,0,75,70
1656903526134,ECE 65,A50,083695,Saad; Andrew S,12,0,30,18
1656903526134,ECE 65,A51,095125,Saad; Andrew S,25,0,26,1
1656903532156,ECE 109,A01,091882,Touri; Behrouz,16,0,70,54
1656903538182,ECE 180,A00,083140,Abi Samra; Nicholas Camill,0,0,30,30
1656903538182,ECE 180,B00,083141,Abi Samra; Nicholas Camill,0,0,30,30
1656903544207,MATH 10A,A01,083735,Patchell; Gregory David,1,0,30,29
1656903544207,MATH 10A,A02,083736,Patchell; Gregory David,20,0,30,10
1656903544207,MATH 10A,A03,083737,Patchell; Gregory David,15,0,30,15
1656903550241,MATH 10B,A01,083207,Lim; Seonhee,7,0,34,27
1656903550241,MATH 10B,A02,083208,Lim; Seonhee,9,0,35,26
1656903550241,MATH 10B,A03,093472,Lim; Seonhee,4,0,34,30
1656903550241,MATH 10B,B01,083739,Sinha; Shubham,9,0,30,21
1656903556266,MATH 18,A01,083743,Cinel; Cameron Alexander,6,0,30,24
1656903556266,MATH 18,A02,083744,Cinel; Cameron Alexander,15,0,30,15
1656903556266,MATH 18,A03,083745,Cinel; Cameron Alexander,8,0,30,22
1656903556266,MATH 18,B01,083748,Rideout; David Porter,4,0,37,33
1656903556266,MATH 18,B02,083749,Rideout; David Porter,3,0,36,33
1656903556266,MATH 18,B03,083750,Rideout; David Porter,2,0,37,35
1656903556266,MATH 18,B04,083751,Rideout; David Porter,5,0,36,31
1656903556266,MATH 18,B05,093473,Rideout; David Porter,4,0,36,32
1656903556266,MATH 18,B06,093474,Rideout; David Porter,5,0,36,31
1656903562291,MATH 20A,A01,083754,Zheng; Zequn,12,0,40,28
1656903568321,MATH 20B,A01,083756,Briones; Jor-el Thomas Caparas,1,0,36,35
1656903568321,MATH 20B,A02,083757,Briones; Jor-el Thomas Caparas,1,0,36,35
1656903568321,MATH 20B,A03,093475,Briones; Jor-el Thomas Caparas,0,0,36,36
1656903574349,MATH 20C,A01,083760,Briones; Jor-el Thomas Caparas,1,0,35,34
1656903574349,MATH 20C,A02,083761,Briones; Jor-el Thomas Caparas,8,0,35,27
1656903574349,MATH 20C,A03,093476,Briones; Jor-el Thomas Caparas,0,1,36,36
1656903574349,MATH 20C,B01,083762,Bach; Quang Tran,0,0,30,30
1656903580373,MATH 20D,A01,083765,Tran; Brian Kha,4,0,30,26
1656903580373,MATH 20D,A02,083766,Tran; Brian Kha,4,0,30,26
1656903580373,MATH 20D,A03,083767,Tran; Brian Kha,3,0,30,27
1656903586397,MATH 20E,A01,083771,Ganguly; Soumya,5,0,32,27
1656903586397,MATH 20E,A02,083772,Ganguly; Soumya,6,0,32,26
1656903586397,MATH 20E,B01,083773,Ciotti; Benjamin,18,0,35,17
1656903586397,MATH 20E,B02,083774,Ciotti; Benjamin,17,0,35,18
1656903592420,MATH 103A,A01,083777,Greenfeld; Be'Eri,2,0,36,34
1656903592420,MATH 103A,A02,083778,Greenfeld; Be'Eri,5,0,36,31
1656903592420,MATH 103A,A03,093561,Greenfeld; Be'Eri,4,0,36,32
1656903592420,MATH 103A,B01,083779,Greenfeld; Be'Eri,6,0,36,30
1656903592420,MATH 103A,B02,083780,Greenfeld; Be'Eri,2,0,36,34
1656903592420,MATH 103A,B03,093562,Greenfeld; Be'Eri,2,0,36,34
1656903598453,MATH 105,A01,085443,Carter; Anne Toulson,13,0,35,22
1656903598453,MATH 105,A02,093477,Carter; Anne Toulson,20,0,35,15
1656903604478,MATH 109,A01,083213,Ganzberger; Geoffrey Michael,2,0,34,32
1656903604478,MATH 109,A02,083214,Ganzberger; Geoffrey Michael,2,0,34,32
1656903604478,MATH 109,A03,093478,Ganzberger; Geoffrey Michael,1,0,34,33
1656903604478,MATH 109,B01,083215,Ganzberger; Geoffrey Michael,1,0,32,31
1656903604478,MATH 109,B02,083216,Ganzberger; Geoffrey Michael,1,0,32,31
1656903604478,MATH 109,B03,093479,Ganzberger; Geoffrey Michael,6,0,32,26
1656903610508,MATH 142A,A01,083219,Chow; Bennett,6,0,32,26
1656903610508,MATH 142A,A02,083220,Chow; Bennett,10,0,32,22
1656903610508,MATH 142A,A03,093480,Chow; Bennett,7,0,32,25
1656903610508,MATH 142A,B03,093481,Chow; Bennett,7,0,32,25
1656903610508,MATH 142A,B04,093558,Chow; Bennett,10,0,32,22
1656903610508,MATH 142A,B05,093559,Chow; Bennett,6,0,32,26
1656903616531,MATH 193A,A01,083224,Rotar; Vladimir,7,0,34,27
1656903616531,MATH 193A,A02,083225,Rotar; Vladimir,3,0,34,31
1656903616531,MATH 193A,A03,083781,Rotar; Vladimir,1,0,34,33
1656903616531,MATH 193A,A04,083782,Rotar; Vladimir,6,0,34,28
1656903616531,MATH 193A,A05,093482,Rotar; Vladimir,6,0,34,28
1656903622557,MATH 197,001,091859,McAuley; Julian John,9999,0,9999,0
1656903622557,MATH 197,002,095566,Kedlaya; Kiran S.,9997,0,9999,2
1656903622557,MATH 197,003,095567,Xiao; Ming,9999,0,9999,0
1656903622557,MATH 197,004,095571,Perols; Johan Lars,9998,0,9999,1
1656903629608,COGS 9,A01,083615,Shannon; Kyle Michael,6,0,75,69
1656903635651,COGS 11,A01,083617,Boyle; Mary E. T.,19,0,48,29
1656903641679,COGS 13,A01,083071,Bastos; Amalia Pinkusfeld,8,0,71,63
1656903647700,COGS 14A,A01,092681,Semenuks; Arturs,0,1,100,100
1656903653724,COGS 14B,A01,083073,Cheng; Tzu-Han,5,0,63,58
1656903659750,COGS 17,A01,092677,Semenuks; Arturs,4,0,81,77
1656903665774,COGS 100,A01,083619,Allen; Michael Gordon,15,0,70,55
1656903671797,COGS 101A,A01,083621,Davis; Joshua Daniel,9,0,68,59
1656903677820,COGS 101B,A01,091572,Allen; Michael Gordon,8,0,65,57
1656903683846,COGS 101C,A01,083625,Delgado; Tania,17,0,35,18
1656903689872,COGS 107A,A01,083627,Boyle; Mary E. T.,13,0,60,47
1656903695895,COGS 118A,A01,083075,Gupta; Anjum,15,0,76,61
1656903701919,CSE 3,A50,083646,Miranda; Gregory Joseph,22,0,50,28
1656903707947,CSE 8A,A50,083650,Miranda; Gregory Joseph,17,1,56,39
1656903713969,CSE 11,A01,083080,Cao; Yingjun,4,15,40,36
1656903719991,CSE 12,A01,083652,Krause-Levy; Sophia Louisa,20,1,120,100
1656903726014,CSE 15L,A01,083654,Morris; Justin Loren,8,0,50,42
1656903726014,CSE 15L,A02,083655,Morris; Justin Loren,8,0,50,42
1656903732044,CSE 20,A01,083657,Tran; Khoa Dang,37,0,80,43
1656903738071,CSE 21,A01,095574,Bach; Quang Tran,21,0,48,27
1656903744097,CSE 30,A01,083084,Eldon; John,4,0,80,76
1656903744097,CSE 30,B01,095061,Bhaskar; Nishant,6,0,50,44
1656903750122,CSE 100,A01,083659,Cao; Yingjun,2,4,70,68
1656903756148,CSE 134B,A01,083661,Powell; Thomas Allan,19,0,100,81
1656903762174,CSE 140,A01,083663,Gungor; Onat,14,0,85,71
1656903768205,CSE 140L,A01,083088,Eldon; John,16,0,100,84
1656903774228,CSE 175,A01,083665,Kumar; Rakesh,3,0,25,22
1656903780259,CSE 190,A00,092507,Dubnov; Shlomo,7,0,20,13
1656903786284,ECE 45,A01,083139,Congero; Spencer William,5,0,75,70
1656903792306,ECE 65,A50,083695,Saad; Andrew S,12,0,30,18
1656903792306,ECE 65,A51,095125,Saad; Andrew S,25,0,26,1
1656903798332,ECE 109,A01,091882,Touri; Behrouz,16,0,70,54
1656903804355,ECE 180,A00,083140,Abi Samra; Nicholas Camill,0,0,30,30
1656903804355,ECE 180,B00,083141,Abi Samra; Nicholas Camill,0,0,30,30
1656903810379,MATH 10A,A01,083735,Patchell; Gregory David,1,0,30,29
1656903810379,MATH 10A,A02,083736,Patchell; Gregory David,20,0,30,10
1656903810379,MATH 10A,A03,083737,Patchell; Gregory David,15,0,30,15
1656903816410,MATH 10B,A01,083207,Lim; Seonhee,7,0,34,27
1656903816410,MATH 10B,A02,083208,Lim; Seonhee,9,0,35,26
1656903816410,MATH 10B,A03,093472,Lim; Seonhee,4,0,34,30
1656903816410,MATH 10B,B01,083739,Sinha; Shubham,9,0,30,21
1656903822442,MATH 18,A01,083743,Cinel; Cameron Alexander,6,0,30,24
1656903822442,MATH 18,A02,083744,Cinel; Cameron Alexander,15,0,30,15
1656903822442,MATH 18,A03,083745,Cinel; Cameron Alexander,8,0,30,22
1656903822442,MATH 18,B01,083748,Rideout; David Porter,4,0,37,33
1656903822442,MATH 18,B02,083749,Rideout; David Porter,3,0,36,33
1656903822442,MATH 18,B03,083750,Rideout; David Porter,2,0,37,35
1656903822442,MATH 18,B04,083751,Rideout; David Porter,5,0,36,31
1656903822442,MATH 18,B05,093473,Rideout; David Porter,4,0,36,32
1656903822442,MATH 18,B06,093474,Rideout; David Porter,5,0,36,31
1656903828464,MATH 20A,A01,083754,Zheng; Zequn,12,0,40,28
1656903834492,MATH 20B,A01,083756,Briones; Jor-el Thomas Caparas,1,0,36,35
1656903834492,MATH 20B,A02,083757,Briones; Jor-el Thomas Caparas,1,0,36,35
1656903834492,MATH 20B,A03,093475,Briones; Jor-el Thomas Caparas,0,0,36,36
1656903840520,MATH 20C,A01,083760,Briones; Jor-el Thomas Caparas,1,0,35,34
1656903840520,MATH 20C,A02,083761,Briones; Jor-el Thomas Caparas,8,0,35,27
1656903840520,MATH 20C,A03,093476,Briones; Jor-el Thomas Caparas,0,1,36,36
1656903840520,MATH 20C,B01,083762,Bach; Quang Tran,0,0,30,30
1656903846542,MATH 20D,A01,083765,Tran; Brian Kha,4,0,30,26
1656903846542,MATH 20D,A02,083766,Tran; Brian Kha,4,0,30,26
1656903846542,MATH 20D,A03,083767,Tran; Brian Kha,3,0,30,27
1656903852566,MATH 20E,A01,083771,Ganguly; Soumya,5,0,32,27
1656903852566,MATH 20E,A02,083772,Ganguly; Soumya,6,0,32,26
1656903852566,MATH 20E,B01,083773,Ciotti; Benjamin,18,0,35,17
1656903852566,MATH 20E,B02,083774,Ciotti; Benjamin,17,0,35,18
1656903858589,MATH 103A,A01,083777,Greenfeld; Be'Eri,2,0,36,34
1656903858589,MATH 103A,A02,083778,Greenfeld; Be'Eri,5,0,36,31
1656903858589,MATH 103A,A03,093561,Greenfeld; Be'Eri,4,0,36,32
1656903858589,MATH 103A,B01,083779,Greenfeld; Be'Eri,6,0,36,30
1656903858589,MATH 103A,B02,083780,Greenfeld; Be'Eri,2,0,36,34
1656903858589,MATH 103A,B03,093562,Greenfeld; Be'Eri,2,0,36,34
1656903864613,MATH 105,A01,085443,Carter; Anne Toulson,13,0,35,22
1656903864613,MATH 105,A02,093477,Carter; Anne Toulson,20,0,35,15
1656903870641,MATH 109,A01,083213,Ganzberger; Geoffrey Michael,2,0,34,32
1656903870641,MATH 109,A02,083214,Ganzberger; Geoffrey Michael,2,0,34,32
1656903870641,MATH 109,A03,093478,Ganzberger; Geoffrey Michael,1,0,34,33
1656903870641,MATH 109,B01,083215,Ganzberger; Geoffrey Michael,1,0,32,31
1656903870641,MATH 109,B02,083216,Ganzberger; Geoffrey Michael,1,0,32,31
1656903870641,MATH 109,B03,093479,Ganzberger; Geoffrey Michael,6,0,32,26
1656903876670,MATH 142A,A01,083219,Chow; Bennett,6,0,32,26
1656903876670,MATH 142A,A02,083220,Chow; Bennett,10,0,32,22
1656903876670,MATH 142A,A03,093480,Chow; Bennett,7,0,32,25
1656903876670,MATH 142A,B03,093481,Chow; Bennett,7,0,32,25
1656903876670,MATH 142A,B04,093558,Chow; Bennett,10,0,32,22
1656903876670,MATH 142A,B05,093559,Chow; Bennett,6,0,32,26
1656903882698,MATH 193A,A01,083224,Rotar; Vladimir,7,0,34,27
1656903882698,MATH 193A,A02,083225,Rotar; Vladimir,3,0,34,31
1656903882698,MATH 193A,A03,083781,Rotar; Vladimir,1,0,34,33
1656903882698,MATH 193A,A04,083782,Rotar; Vladimir,6,0,34,28
1656903882698,MATH 193A,A05,093482,Rotar; Vladimir,6,0,34,28
1656903888722,MATH 197,001,091859,McAuley; Julian John,9999,0,9999,0
1656903888722,MATH 197,002,095566,Kedlaya; Kiran S.,9997,0,9999,2
1656903888722,MATH 197,003,095567,Xiao; Ming,9999,0,9999,0
1656903888722,MATH 197,004,095571,Perols; Johan Lars,9998,0,9999,1
1656903895786,COGS 9,A01,083615,Shannon; Kyle Michael,6,0,75,69
1656903901813,COGS 11,A01,083617,Boyle; Mary E. T.,19,0,48,29
1656903907840,COGS 13,A01,083071,Bastos; Amalia Pinkusfeld,8,0,71,63
1656903913864,COGS 14A,A01,092681,Semenuks; Arturs,0,1,100,100
1656903919890,COGS 14B,A01,083073,Cheng; Tzu-Han,5,0,63,58
1656903925917,COGS 17,A01,092677,Semenuks; Arturs,4,0,81,77
1656903932031,COGS 100,A01,083619,Allen; Michael Gordon,15,0,70,55
1656903938054,COGS 101A,A01,083621,Davis; Joshua Daniel,9,0,68,59
1656903944082,COGS 101B,A01,091572,Allen; Michael Gordon,8,0,65,57
1656903950106,COGS 101C,A01,083625,Delgado; Tania,17,0,35,18
1656903956133,COGS 107A,A01,083627,Boyle; Mary E. T.,13,0,60,47
1656903962163,COGS 118A,A01,083075,Gupta; Anjum,15,0,76,61
1656903968186,CSE 3,A50,083646,Miranda; Gregory Joseph,22,0,50,28
1656903974209,CSE 8A,A50,083650,Miranda; Gregory Joseph,17,1,56,39
1656903980234,CSE 11,A01,083080,Cao; Yingjun,4,15,40,36
1656903986259,CSE 12,A01,083652,Krause-Levy; Sophia Louisa,20,1,120,100
1656903992301,CSE 15L,A01,083654,Morris; Justin Loren,8,0,50,42
1656903992301,CSE 15L,A02,083655,Morris; Justin Loren,8,0,50,42
1656903998324,CSE 20,A01,083657,Tran; Khoa Dang,37,0,80,43
1656904004347,CSE 21,A01,095574,Bach; Quang Tran,21,0,48,27
1656904010372,CSE 30,A01,083084,Eldon; John,4,0,80,76
1656904010372,CSE 30,B01,095061,Bhaskar; Nishant,6,0,50,44
1656904016394,CSE 100,A01,083659,Cao; Yingjun,2,4,70,68
1656904022422,CSE 134B,A01,083661,Powell; Thomas Allan,19,0,100,81
1656904028446,CSE 140,A01,083663,Gungor; Onat,14,0,85,71
1656904034479,CSE 140L,A01,083088,Eldon; John,16,0,100,84
1656904040510,CSE 175,A01,083665,Kumar; Rakesh,3,0,25,22
1656904046536,CSE 190,A00,092507,Dubnov; Shlomo,7,0,20,13
1656904052563,ECE 45,A01,083139,Congero; Spencer William,5,0,75,70
1656904058590,ECE 65,A50,083695,Saad; Andrew S,12,0,30,18
1656904058590,ECE 65,A51,095125,Saad; Andrew S,25,0,26,1
1656904064618,ECE 109,A01,091882,Touri; Behrouz,16,0,70,54
1656904070646,ECE 180,A00,083140,Abi Samra; Nicholas Camill,0,0,30,30
1656904070646,ECE 180,B00,083141,Abi Samra; Nicholas Camill,0,0,30,30
1656904076669,MATH 10A,A01,083735,Patchell; Gregory David,1,0,30,29
1656904076669,MATH 10A,A02,083736,Patchell; Gregory David,20,0,30,10
1656904076669,MATH 10A,A03,083737,Patchell; Gregory David,15,0,30,15
1656904082692,MATH 10B,A01,083207,Lim; Seonhee,7,0,34,27
1656904082692,MATH 10B,A02,083208,Lim; Seonhee,9,0,35,26
1656904082692,MATH 10B,A03,093472,Lim; Seonhee,4,0,34,30
1656904082692,MATH 10B,B01,083739,Sinha; Shubham,9,0,30,21
1656904088723,MATH 18,A01,083743,Cinel; Cameron Alexander,6,0,30,24
1656904088723,MATH 18,A02,083744,Cinel; Cameron Alexander,15,0,30,15
1656904088723,MATH 18,A03,083745,Cinel; Cameron Alexander,8,0,30,22
1656904088723,MATH 18,B01,083748,Rideout; David Porter,4,0,37,33
1656904088723,MATH 18,B02,083749,Rideout; David Porter,3,0,36,33
1656904088723,MATH 18,B03,083750,Rideout; David Porter,2,0,37,35
1656904088723,MATH 18,B04,083751,Rideout; David Porter,5,0,36,31
1656904088723,MATH 18,B05,093473,Rideout; David Porter,4,0,36,32
1656904088723,MATH 18,B06,093474,Rideout; David Porter,5,0,36,31
1656904094744,MATH 20A,A01,083754,Zheng; Zequn,12,0,40,28
1656904100765,MATH 20B,A01,083756,Briones; Jor-el Thomas Caparas,1,0,36,35
1656904100765,MATH 20B,A02,083757,Briones; Jor-el Thomas Caparas,1,0,36,35
1656904100765,MATH 20B,A03,093475,Briones; Jor-el Thomas Caparas,0,0,36,36
1656904106794,MATH 20C,A01,083760,Briones; Jor-el Thomas Caparas,1,0,35,34
1656904106794,MATH 20C,A02,083761,Briones; Jor-el Thomas Caparas,8,0,35,27
1656904106794,MATH 20C,A03,093476,Briones; Jor-el Thomas Caparas,0,1,36,36
1656904106794,MATH 20C,B01,083762,Bach; Quang Tran,0,0,30,30
1656904112816,MATH 20D,A01,083765,Tran; Brian Kha,4,0,30,26
1656904112816,MATH 20D,A02,083766,Tran; Brian Kha,4,0,30,26
1656904112816,MATH 20D,A03,083767,Tran; Brian Kha,3,0,30,27
1656904118838,MATH 20E,A01,083771,Ganguly; Soumya,5,0,32,27
1656904118838,MATH 20E,A02,083772,Ganguly; Soumya,6,0,32,26
1656904118838,MATH 20E,B01,083773,Ciotti; Benjamin,18,0,35,17
1656904118838,MATH 20E,B02,083774,Ciotti; Benjamin,17,0,35,18
1656904124862,MATH 103A,A01,083777,Greenfeld; Be'Eri,2,0,36,34
1656904124862,MATH 103A,A02,083778,Greenfeld; Be'Eri,5,0,36,31
1656904124862,MATH 103A,A03,093561,Greenfeld; Be'Eri,4,0,36,32
1656904124862,MATH 103A,B01,083779,Greenfeld; Be'Eri,6,0,36,30
1656904124862,MATH 103A,B02,083780,Greenfeld; Be'Eri,2,0,36,34
1656904124862,MATH 103A,B03,093562,Greenfeld; Be'Eri,2,0,36,34
1656904130886,MATH 105,A01,085443,Carter; Anne Toulson,13,0,35,22
1656904130886,MATH 105,A02,093477,Carter; Anne Toulson,20,0,35,15
1656904136913,MATH 109,A01,083213,Ganzberger; Geoffrey Michael,2,0,34,32
1656904136913,MATH 109,A02,083214,Ganzberger; Geoffrey Michael,2,0,34,32
1656904136913,MATH 109,A03,093478,Ganzberger; Geoffrey Michael,1,0,34,33
1656904136913,MATH 109,B01,083215,Ganzberger; Geoffrey Michael,1,0,32,31
1656904136913,MATH 109,B02,083216,Ganzberger; Geoffrey Michael,1,0,32,31
1656904136913,MATH 109,B03,093479,Ganzberger; Geoffrey Michael,6,0,32,26
1656904142936,MATH 142A,A01,083219,Chow; Bennett,6,0,32,26
1656904142936,MATH 142A,A02,083220,Chow; Bennett,10,0,32,22
1656904142936,MATH 142A,A03,093480,Chow; Bennett,7,0,32,25
1656904142936,MATH 142A,B03,093481,Chow; Bennett,7,0,32,25
1656904142936,MATH 142A,B04,093558,Chow; Bennett,10,0,32,22
1656904142936,MATH 142A,B05,093559,Chow; Bennett,6,0,32,26
1656904148960,MATH 193A,A01,083224,Rotar; Vladimir,7,0,34,27
1656904148960,MATH 193A,A02,083225,Rotar; Vladimir,3,0,34,31
1656904148960,MATH 193A,A03,083781,Rotar; Vladimir,1,0,34,33
1656904148960,MATH 193A,A04,083782,Rotar; Vladimir,6,0,34,28
1656904148960,MATH 193A,A05,093482,Rotar; Vladimir,6,0,34,28
1656904154990,MATH 197,001,091859,McAuley; Julian John,9999,0,9999,0
1656904154990,MATH 197,002,095566,Kedlaya; Kiran S.,9997,0,9999,2
1656904154990,MATH 197,003,095567,Xiao; Ming,9999,0,9999,0
1656904154990,MATH 197,004,095571,Perols; Johan Lars,9998,0,9999,1
1656904162044,COGS 9,A01,083615,Shannon; Kyle Michael,6,0,75,69
1656904168069,COGS 11,A01,083617,Boyle; Mary E. T.,19,0,48,29
1656904174095,COGS 13,A01,083071,Bastos; Amalia Pinkusfeld,8,0,71,63
1656904180120,COGS 14A,A01,092681,Semenuks; Arturs,0,1,100,100
1656904186148,COGS 14B,A01,083073,Cheng; Tzu-Han,5,0,63,58
1656904192174,COGS 17,A01,092677,Semenuks; Arturs,4,0,81,77
1656904198201,COGS 100,A01,083619,Allen; Michael Gordon,15,0,70,55
1656904204222,COGS 101A,A01,083621,Davis; Joshua Daniel,9,0,68,59
1656904210250,COGS 101B,A01,091572,Allen; Michael Gordon,8,0,65,57
1656904216274,COGS 101C,A01,083625,Delgado; Tania,17,0,35,18
1656904222300,COGS 107A,A01,083627,Boyle; Mary E. T.,13,0,60,47
1656904228322,COGS 118A,A01,083075,Gupta; Anjum,15,0,76,61
1656904234346,CSE 3,A50,083646,Miranda; Gregory Joseph,22,0,50,28
1656904240374,CSE 8A,A50,083650,Miranda; Gregory Joseph,17,1,56,39
1656904246399,CSE 11,A01,083080,Cao; Yingjun,4,15,40,36
1656904252426,CSE 12,A01,083652,Krause-Levy; Sophia Louisa,20,1,120,100
1656904258450,CSE 15L,A01,083654,Morris; Justin Loren,8,0,50,42
1656904258450,CSE 15L,A02,083655,Morris; Justin Loren,8,0,50,42
1656904264477,CSE 20,A01,083657,Tran; Khoa Dang,37,0,80,43
1656904270505,CSE 21,A01,095574,Bach; Quang Tran,21,0,48,27
1656904276529,CSE 30,A01,083084,Eldon; John,4,0,80,76
1656904276529,CSE 30,B01,095061,Bhaskar; Nishant,6,0,50,44
1656904282566,CSE 100,A01,083659,Cao; Yingjun,2,4,70,68
1656904288589,CSE 134B,A01,083661,Powell; Thomas Allan,19,0,100,81
1656904294614,CSE 140,A01,083663,Gungor; Onat,14,0,85,71
1656904300638,CSE 140L,A01,083088,Eldon; John,16,0,100,84
1656904306668,CSE 175,A01,083665,Kumar; Rakesh,3,0,25,22
1656904312692,CSE 190,A00,092507,Dubnov; Shlomo,7,0,20,13
1656904318715,ECE 45,A01,083139,Congero; Spencer William,5,0,75,70
1656904324738,ECE 65,A50,083695,Saad; Andrew S,12,0,30,18
1656904324738,ECE 65,A51,095125,Saad; Andrew S,25,0,26,1
1656904330762,ECE 109,A01,091882,Touri; Behrouz,16,0,70,54
1656904336785,ECE 180,A00,083140,Abi Samra; Nicholas Camill,0,0,30,30
1656904336785,ECE 180,B00,083141,Abi Samra; Nicholas Camill,0,0,30,30
1656904342809,MATH 10A,A01,083735,Patchell; Gregory David,1,0,30,29
1656904342809,MATH 10A,A02,083736,Patchell; Gregory David,20,0,30,10
1656904342809,MATH 10A,A03,083737,Patchell; Gregory David,15,0,30,15
1656904348836,MATH 10B,A01,083207,Lim; Seonhee,7,0,34,27
1656904348836,MATH 10B,A02,083208,Lim; Seonhee,9,0,35,26
1656904348836,MATH 10B,A03,093472,Lim; Seonhee,4,0,34,30
1656904348836,MATH 10B,B01,083739,Sinha; Shubham,9,0,30,21
1656904354871,MATH 18,A01,083743,Cinel; Cameron Alexander,6,0,30,24
1656904354871,MATH 18,A02,083744,Cinel; Cameron Alexander,15,0,30,15
1656904354871,MATH 18,A03,083745,Cinel; Cameron Alexander,8,0,30,22
1656904354871,MATH 18,B01,083748,Rideout; David Porter,4,0,37,33
1656904354871,MATH 18,B02,083749,Rideout; David Porter,3,0,36,33
1656904354871,MATH 18,B03,083750,Rideout; David Porter,2,0,37,35
1656904354871,MATH 18,B04,083751,Rideout; David Porter,5,0,36,31
1656904354871,MATH 18,B05,093473,Rideout; David Porter,4,0,36,32
1656904354871,MATH 18,B06,093474,Rideout; David Porter,5,0,36,31
1656904360894,MATH 20A,A01,083754,Zheng; Zequn,12,0,40,28
1656904366917,MATH 20B,A01,083756,Briones; Jor-el Thomas Caparas,1,0,36,35
1656904366917,MATH 20B,A02,083757,Briones; Jor-el Thomas Caparas,1,0,36,35
1656904366917,MATH 20B,A03,093475,Briones; Jor-el Thomas Caparas,0,0,36,36
1656904372940,MATH 20C,A01,083760,Briones; Jor-el Thomas Caparas,1,0,35,34
1656904372940,MATH 20C,A02,083761,Briones; Jor-el Thomas Caparas,8,0,35,27
1656904372940,MATH 20C,A03,093476,Briones; Jor-el Thomas Caparas,0,1,36,36
1656904372940,MATH 20C,B01,083762,Bach; Quang Tran,0,0,30,30
1656904378969,MATH 20D,A01,083765,Tran; Brian Kha,4,0,30,26
1656904378969,MATH 20D,A02,083766,Tran; Brian Kha,4,0,30,26
1656904378969,MATH 20D,A03,083767,Tran; Brian Kha,3,0,30,27
1656904385000,MATH 20E,A01,083771,Ganguly; Soumya,5,0,32,27
1656904385000,MATH 20E,A02,083772,Ganguly; Soumya,6,0,32,26
1656904385000,MATH 20E,B01,083773,Ciotti; Benjamin,18,0,35,17
1656904385000,MATH 20E,B02,083774,Ciotti; Benjamin,17,0,35,18
1656904391023,MATH 103A,A01,083777,Greenfeld; Be'Eri,2,0,36,34
1656904391023,MATH 103A,A02,083778,Greenfeld; Be'Eri,5,0,36,31
1656904391023,MATH 103A,A03,093561,Greenfeld; Be'Eri,4,0,36,32
1656904391023,MATH 103A,B01,083779,Greenfeld; Be'Eri,6,0,36,30
1656904391023,MATH 103A,B02,083780,Greenfeld; Be'Eri,2,0,36,34
1656904391023,MATH 103A,B03,093562,Greenfeld; Be'Eri,2,0,36,34
1656904397052,MATH 105,A01,085443,Carter; Anne Toulson,13,0,35,22
1656904397052,MATH 105,A02,093477,Carter; Anne Toulson,20,0,35,15
1656904403080,MATH 109,A01,083213,Ganzberger; Geoffrey Michael,2,0,34,32
1656904403080,MATH 109,A02,083214,Ganzberger; Geoffrey Michael,2,0,34,32
1656904403080,MATH 109,A03,093478,Ganzberger; Geoffrey Michael,1,0,34,33
1656904403080,MATH 109,B01,083215,Ganzberger; Geoffrey Michael,1,0,32,31
1656904403080,MATH 109,B02,083216,Ganzberger; Geoffrey Michael,1,0,32,31
1656904403080,MATH 109,B03,093479,Ganzberger; Geoffrey Michael,6,0,32,26
1656904409110,MATH 142A,A01,083219,Chow; Bennett,6,0,32,26
1656904409110,MATH 142A,A02,083220,Chow; Bennett,10,0,32,22
1656904409110,MATH 142A,A03,093480,Chow; Bennett,7,0,32,25
1656904409110,MATH 142A,B03,093481,Chow; Bennett,7,0,32,25
1656904409110,MATH 142A,B04,093558,Chow; Bennett,10,0,32,22
1656904409110,MATH 142A,B05,093559,Chow; Bennett,6,0,32,26
1656904415137,MATH 193A,A01,083224,Rotar; Vladimir,7,0,34,27
1656904415137,MATH 193A,A02,083225,Rotar; Vladimir,3,0,34,31
1656904415137,MATH 193A,A03,083781,Rotar; Vladimir,1,0,34,33
1656904415137,MATH 193A,A04,083782,Rotar; Vladimir,6,0,34,28
1656904415137,MATH 193A,A05,093482,Rotar; Vladimir,6,0,34,28
1656904421158,MATH 197,001,091859,McAuley; Julian John,9999,0,9999,0
1656904421158,MATH 197,002,095566,Kedlaya; Kiran S.,9997,0,9999,2
1656904421158,MATH 197,003,095567,Xiao; Ming,9999,0,9999,0
1656904421158,MATH 197,004,095571,Perols; Johan Lars,9998,0,9999,1
1656904428216,COGS 9,A01,083615,Shannon; Kyle Michael,6,0,75,69
1656904434240,COGS 11,A01,083617,Boyle; Mary E. T.,19,0,48,29
1656904440268,COGS 13,A01,083071,Bastos; Amalia Pinkusfeld,8,0,71,63
1656904446296,COGS 14A,A01,092681,Semenuks; Arturs,0,1,100,100
1656904452318,COGS 14B,A01,083073,Cheng; Tzu-Han,5,0,63,58
1656904458341,COGS 17,A01,092677,Semenuks; Arturs,4,0,81,77
1656904464367,COGS 100,A01,083619,Allen; Michael Gordon,15,0,70,55
1656904470395,COGS 101A,A01,083621,Davis; Joshua Daniel,9,0,68,59
1656904476418,COGS 101B,A01,091572,Allen; Michael Gordon,8,0,65,57
1656904482445,COGS 101C,A01,083625,Delgado; Tania,17,0,35,18
1656904488471,COGS 107A,A01,083627,Boyle; Mary E. T.,13,0,60,47
1656904494498,COGS 118A,A01,083075,Gupta; Anjum,15,0,76,61
1656904500523,CSE 3,A50,083646,Miranda; Gregory Joseph,22,0,50,28
1656904506545,CSE 8A,A50,083650,Miranda; Gregory Joseph,17,1,56,39
1656904512571,CSE 11,A01,083080,Cao; Yingjun,4,15,40,36
1656904518596,CSE 12,A01,083652,Krause-Levy; Sophia Louisa,20,1,120,100
1656904524622,CSE 15L,A01,083654,Morris; Justin Loren,8,0,50,42
1656904524622,CSE 15L,A02,083655,Morris; Justin Loren,8,0,50,42
1656904530717,CSE 20,A01,083657,Tran; Khoa Dang,37,0,80,43
1656904536742,CSE 21,A01,095574,Bach; Quang Tran,21,0,48,27
1656904542764,CSE 30,A01,083084,Eldon; John,4,0,80,76
1656904542764,CSE 30,B01,095061,Bhaskar; Nishant,6,0,50,44
1656904548790,CSE 100,A01,083659,Cao; Yingjun,2,4,70,68
1656904554814,CSE 134B,A01,083661,Powell; Thomas Allan,19,0,100,81
1656904560851,CSE 140,A01,083663,Gungor; Onat,14,0,85,71
1656904566873,CSE 140L,A01,083088,Eldon; John,16,0,100,84
1656904572900,CSE 175,A01,083665,Kumar; Rakesh,3,0,25,22
1656904578925,CSE 190,A00,092507,Dubnov; Shlomo,7,0,20,13
1656904584948,ECE 45,A01,083139,Congero; Spencer William,5,0,75,70
1656904590976,ECE 65,A50,083695,Saad; Andrew S,12,0,30,18
1656904590976,ECE 65,A51,095125,Saad; Andrew S,25,0,26,1
1656904597001,ECE 109,A01,091882,Touri; Behrouz,16,0,70,54
1656904603024,ECE 180,A00,083140,Abi Samra; Nicholas Camill,0,0,30,30
1656904603024,ECE 180,B00,083141,Abi Samra; Nicholas Camill,0,0,30,30
1656904609051,MATH 10A,A01,083735,Patchell; Gregory David,1,0,30,29
1656904609051,MATH 10A,A02,083736,Patchell; Gregory David,20,0,30,10
1656904609051,MATH 10A,A03,083737,Patchell; Gregory David,15,0,30,15
1656904615078,MATH 10B,A01,083207,Lim; Seonhee,7,0,34,27
1656904615078,MATH 10B,A02,083208,Lim; Seonhee,9,0,35,26
1656904615078,MATH 10B,A03,093472,Lim; Seonhee,4,0,34,30
1656904615078,MATH 10B,B01,083739,Sinha; Shubham,9,0,30,21
1656904621103,MATH 18,A01,083743,Cinel; Cameron Alexander,6,0,30,24
1656904621103,MATH 18,A02,083744,Cinel; Cameron Alexander,15,0,30,15
1656904621103,MATH 18,A03,083745,Cinel; Cameron Alexander,8,0,30,22
1656904621103,MATH 18,B01,083748,Rideout; David Porter,4,0,37,33
1656904621103,MATH 18,B02,083749,Rideout; David Porter,3,0,36,33
1656904621103,MATH 18,B03,083750,Rideout; David Porter,2,0,37,35
1656904621103,MATH 18,B04,083751,Rideout; David Porter,5,0,36,31
1656904621103,MATH 18,B05,093473,Rideout; David Porter,4,0,36,32
1656904621103,MATH 18,B06,093474,Rideout; David Porter,5,0,36,31
1656904627130,MATH 20A,A01,083754,Zheng; Zequn,12,0,40,28
1656904633153,MATH 20B,A01,083756,Briones; Jor-el Thomas Caparas,1,0,36,35
1656904633153,MATH 20B,A02,083757,Briones; Jor-el Thomas Caparas,1,0,36,35
1656904633153,MATH 20B,A03,093475,Briones; Jor-el Thomas Caparas,0,0,36,36
1656904639176,MATH 20C,A01,083760,Briones; Jor-el Thomas Caparas,1,0,35,34
1656904639176,MATH 20C,A02,083761,Briones; Jor-el Thomas Caparas,8,0,35,27
1656904639176,MATH 20C,A03,093476,Briones; Jor-el Thomas Caparas,0,1,36,36
1656904639176,MATH 20C,B01,083762,Bach; Quang Tran,0,0,30,30
1656904645199,MATH 20D,A01,083765,Tran; Brian Kha,4,0,30,26
1656904645199,MATH 20D,A02,083766,Tran; Brian Kha,4,0,30,26
1656904645199,MATH 20D,A03,083767,Tran; Brian Kha,3,0,30,27
1656904651238,MATH 20E,A01,083771,Ganguly; Soumya,5,0,32,27
1656904651238,MATH 20E,A02,083772,Ganguly; Soumya,6,0,32,26
1656904651238,MATH 20E,B01,083773,Ciotti; Benjamin,18,0,35,17
1656904651238,MATH 20E,B02,083774,Ciotti; Benjamin,17,0,35,18
1656904657263,MATH 103A,A01,083777,Greenfeld; Be'Eri,2,0,36,34
1656904657263,MATH 103A,A02,083778,Greenfeld; Be'Eri,5,0,36,31
1656904657263,MATH 103A,A03,093561,Greenfeld; Be'Eri,4,0,36,32
1656904657263,MATH 103A,B01,083779,Greenfeld; Be'Eri,6,0,36,30
1656904657263,MATH 103A,B02,083780,Greenfeld; Be'Eri,2,0,36,34
1656904657263,MATH 103A,B03,093562,Greenfeld; Be'Eri,2,0,36,34
1656904663291,MATH 105,A01,085443,Carter; Anne Toulson,13,0,35,22
1656904663291,MATH 105,A02,093477,Carter; Anne Toulson,20,0,35,15
1656904669315,MATH 109,A01,083213,Ganzberger; Geoffrey Michael,2,0,34,32
1656904669315,MATH 109,A02,083214,Ganzberger; Geoffrey Michael,2,0,34,32
1656904669315,MATH 109,A03,093478,Ganzberger; Geoffrey Michael,1,0,34,33
1656904669315,MATH 109,B01,083215,Ganzberger; Geoffrey Michael,1,0,32,31
1656904669315,MATH 109,B02,083216,Ganzberger; Geoffrey Michael,1,0,32,31
1656904669315,MATH 109,B03,093479,Ganzberger; Geoffrey Michael,6,0,32,26
1656904675349,MATH 142A,A01,083219,Chow; Bennett,6,0,32,26
1656904675349,MATH 142A,A02,083220,Chow; Bennett,10,0,32,22
1656904675349,MATH 142A,A03,093480,Chow; Bennett,7,0,32,25
1656904675349,MATH 142A,B03,093481,Chow; Bennett,7,0,32,25
1656904675349,MATH 142A,B04,093558,Chow; Bennett,10,0,32,22
1656904675349,MATH 142A,B05,093559,Chow; Bennett,6,0,32,26
1656904681373,MATH 193A,A01,083224,Rotar; Vladimir,7,0,34,27
1656904681373,MATH 193A,A02,083225,Rotar; Vladimir,3,0,34,31
1656904681373,MATH 193A,A03,083781,Rotar; Vladimir,1,0,34,33
1656904681373,MATH 193A,A04,083782,Rotar; Vladimir,6,0,34,28
1656904681373,MATH 193A,A05,093482,Rotar; Vladimir,6,0,34,28
1656904687396,MATH 197,001,091859,McAuley; Julian John,9999,0,9999,0
1656904687396,MATH 197,002,095566,Kedlaya; Kiran S.,9997,0,9999,2
1656904687396,MATH 197,003,095567,Xiao; Ming,9999,0,9999,0
1656904687396,MATH 197,004,095571,Perols; Johan Lars,9998,0,9999,1
1656904694459,COGS 9,A01,083615,Shannon; Kyle Michael,6,0,75,69
1656904700484,COGS 11,A01,083617,Boyle; Mary E. T.,19,0,48,29
1656904706516,COGS 13,A01,083071,Bastos; Amalia Pinkusfeld,8,0,71,63
1656904712538,COGS 14A,A01,092681,Semenuks; Arturs,0,1,100,100
1656904718563,COGS 14B,A01,083073,Cheng; Tzu-Han,5,0,63,58
1656904724587,COGS 17,A01,092677,Semenuks; Arturs,4,0,81,77
1656904730614,COGS 100,A01,083619,Allen; Michael Gordon,15,0,70,55
1656904736640,COGS 101A,A01,083621,Davis; Joshua Daniel,9,0,68,59
1656904742669,COGS 101B,A01,091572,Allen; Michael Gordon,8,0,65,57
1656904748700,COGS 101C,A01,083625,Delgado; Tania,17,0,35,18
1656904754726,COGS 107A,A01,083627,Boyle; Mary E. T.,13,0,60,47
1656904760749,COGS 118A,A01,083075,Gupta; Anjum,15,0,76,61
1656904766770,CSE 3,A50,083646,Miranda; Gregory Joseph,22,0,50,28
1656904772793,CSE 8A,A50,083650,Miranda; Gregory Joseph,17,1,56,39
1656904778818,CSE 11,A01,083080,Cao; Yingjun,4,15,40,36
1656904784840,CSE 12,A01,083652,Krause-Levy; Sophia Louisa,20,1,120,100
1656904790863,CSE 15L,A01,083654,Morris; Justin Loren,8,0,50,42
1656904790863,CSE 15L,A02,083655,Morris; Justin Loren,8,0,50,42
1656904796890,CSE 20,A01,083657,Tran; Khoa Dang,37,0,80,43
1656904802913,CSE 21,A01,095574,Bach; Quang Tran,21,0,48,27
1656904808942,CSE 30,A01,083084,Eldon; John,4,0,80,76
1656904808942,CSE 30,B01,095061,Bhaskar; Nishant,6,0,50,44
1656904814968,CSE 100,A01,083659,Cao; Yingjun,2,4,70,68
1656904820999,CSE 134B,A01,083661,Powell; Thomas Allan,19,0,100,81
1656904827023,CSE 140,A01,083663,Gungor; Onat,14,0,85,71
1656904833054,CSE 140L,A01,083088,Eldon; John,16,0,100,84
1656904839077,CSE 175,A01,083665,Kumar; Rakesh,3,0,25,22
1656904845101,CSE 190,A00,092507,Dubnov; Shlomo,7,0,20,13
1656904851125,ECE 45,A01,083139,Congero; Spencer William,5,0,75,70
1656904857152,ECE 65,A50,083695,Saad; Andrew S,12,0,30,18
1656904857152,ECE 65,A51,095125,Saad; Andrew S,25,0,26,1
1656904863176,ECE 109,A01,091882,Touri; Behrouz,16,0,70,54
1656904869203,ECE 180,A00,083140,Abi Samra; Nicholas Camill,0,0,30,30
1656904869203,ECE 180,B00,083141,Abi Samra; Nicholas Camill,0,0,30,30
1656904875228,MATH 10A,A01,083735,Patchell; Gregory David,1,0,30,29
1656904875228,MATH 10A,A02,083736,Patchell; Gregory David,20,0,30,10
1656904875228,MATH 10A,A03,083737,Patchell; Gregory David,15,0,30,15
1656904881264,MATH 10B,A01,083207,Lim; Seonhee,7,0,34,27
1656904881264,MATH 10B,A02,083208,Lim; Seonhee,9,0,35,26
1656904881264,MATH 10B,A03,093472,Lim; Seonhee,4,0,34,30
1656904881264,MATH 10B,B01,083739,Sinha; Shubham,9,0,30,21
1656904887293,MATH 18,A01,083743,Cinel; Cameron Alexander,6,0,30,24
1656904887293,MATH 18,A02,083744,Cinel; Cameron Alexander,15,0,30,15
1656904887293,MATH 18,A03,083745,Cinel; Cameron Alexander,8,0,30,22
1656904887293,MATH 18,B01,083748,Rideout; David Porter,4,0,37,33
1656904887293,MATH 18,B02,083749,Rideout; David Porter,3,0,36,33
1656904887293,MATH 18,B03,083750,Rideout; David Porter,2,0,37,35
1656904887293,MATH 18,B04,083751,Rideout; David Porter,5,0,36,31
1656904887293,MATH 18,B05,093473,Rideout; David Porter,4,0,36,32
1656904887293,MATH 18,B06,093474,Rideout; David Porter,5,0,36,31
1656904893317,MATH 20A,A01,083754,Zheng; Zequn,12,0,40,28
1656904899346,MATH 20B,A01,083756,Briones; Jor-el Thomas Caparas,1,0,36,35
1656904899346,MATH 20B,A02,083757,Briones; Jor-el Thomas Caparas,1,0,36,35
1656904899346,MATH 20B,A03,093475,Briones; Jor-el Thomas Caparas,0,0,36,36
1656904905374,MATH 20C,A01,083760,Briones; Jor-el Thomas Caparas,1,0,35,34
1656904905374,MATH 20C,A02,083761,Briones; Jor-el Thomas Caparas,8,0,35,27
1656904905374,MATH 20C,A03,093476,Briones; Jor-el Thomas Caparas,0,1,36,36
1656904905374,MATH 20C,B01,083762,Bach; Quang Tran,0,0,30,30
1656904911399,MATH 20D,A01,083765,Tran; Brian Kha,4,0,30,26
1656904911399,MATH 20D,A02,083766,Tran; Brian Kha,4,0,30,26
1656904911399,MATH 20D,A03,083767,Tran; Brian Kha,3,0,30,27
1656904917427,MATH 20E,A01,083771,Ganguly; Soumya,5,0,32,27
1656904917427,MATH 20E,A02,083772,Ganguly; Soumya,6,0,32,26
1656904917427,MATH 20E,B01,083773,Ciotti; Benjamin,18,0,35,17
1656904917427,MATH 20E,B02,083774,Ciotti; Benjamin,17,0,35,18
1656904923453,MATH 103A,A01,083777,Greenfeld; Be'Eri,2,0,36,34
1656904923453,MATH 103A,A02,083778,Greenfeld; Be'Eri,5,0,36,31
1656904923453,MATH 103A,A03,093561,Greenfeld; Be'Eri,4,0,36,32
1656904923453,MATH 103A,B01,083779,Greenfeld; Be'Eri,6,0,36,30
1656904923453,MATH 103A,B02,083780,Greenfeld; Be'Eri,2,0,36,34
1656904923453,MATH 103A,B03,093562,Greenfeld; Be'Eri,2,0,36,34
1656904929474,MATH 105,A01,085443,Carter; Anne Toulson,13,0,35,22
1656904929474,MATH 105,A02,093477,Carter; Anne Toulson,20,0,35,15
1656904935502,MATH 109,A01,083213,Ganzberger; Geoffrey Michael,2,0,34,32
1656904935502,MATH 109,A02,083214,Ganzberger; Geoffrey Michael,2,0,34,32
1656904935502,MATH 109,A03,093478,Ganzberger; Geoffrey Michael,1,0,34,33
1656904935502,MATH 109,B01,083215,Ganzberger; Geoffrey Michael,1,0,32,31
1656904935502,MATH 109,B02,083216,Ganzberger; Geoffrey Michael,1,0,32,31
1656904935502,MATH 109,B03,093479,Ganzberger; Geoffrey Michael,6,0,32,26
1656904941531,MATH 142A,A01,083219,Chow; Bennett,6,0,32,26
1656904941531,MATH 142A,A02,083220,Chow; Bennett,10,0,32,22
1656904941531,MATH 142A,A03,093480,Chow; Bennett,7,0,32,25
1656904941531,MATH 142A,B03,093481,Chow; Bennett,7,0,32,25
1656904941531,MATH 142A,B04,093558,Chow; Bennett,10,0,32,22
1656904941531,MATH 142A,B05,093559,Chow; Bennett,6,0,32,26
1656904947563,MATH 193A,A01,083224,Rotar; Vladimir,7,0,34,27
1656904947563,MATH 193A,A02,083225,Rotar; Vladimir,3,0,34,31
1656904947563,MATH 193A,A03,083781,Rotar; Vladimir,1,0,34,33
1656904947563,MATH 193A,A04,083782,Rotar; Vladimir,6,0,34,28
1656904947563,MATH 193A,A05,093482,Rotar; Vladimir,6,0,34,28
1656904953587,MATH 197,001,091859,McAuley; Julian John,9999,0,9999,0
1656904953587,MATH 197,002,095566,Kedlaya; Kiran S.,9997,0,9999,2
1656904953587,MATH 197,003,095567,Xiao; Ming,9999,0,9999,0
1656904953587,MATH 197,004,095571,Perols; Johan Lars,9998,0,9999,1
1656904960649,COGS 9,A01,083615,Shannon; Kyle Michael,6,0,75,69
1656904966676,COGS 11,A01,083617,Boyle; Mary E. T.,19,0,48,29
1656904972700,COGS 13,A01,083071,Bastos; Amalia Pinkusfeld,8,0,71,63
1656904978726,COGS 14A,A01,092681,Semenuks; Arturs,0,1,100,100
1656904984748,COGS 14B,A01,083073,Cheng; Tzu-Han,5,0,63,58
1656904990771,COGS 17,A01,092677,Semenuks; Arturs,4,0,81,77
1656904996794,COGS 100,A01,083619,Allen; Michael Gordon,15,0,70,55
1656905002820,COGS 101A,A01,083621,Davis; Joshua Daniel,9,0,68,59
1656905008844,COGS 101B,A01,091572,Allen; Michael Gordon,8,0,65,57
1656905014866,COGS 101C,A01,083625,Delgado; Tania,17,0,35,18
1656905020889,COGS 107A,A01,083627,Boyle; Mary E. T.,13,0,60,47
1656905026914,COGS 118A,A01,083075,Gupta; Anjum,15,0,76,61
1656905032941,CSE 3,A50,083646,Miranda; Gregory Joseph,22,0,50,28
1656905038967,CSE 8A,A50,083650,Miranda; Gregory Joseph,17,1,56,39
1656905044989,CSE 11,A01,083080,Cao; Yingjun,4,15,40,36
1656905051016,CSE 12,A01,083652,Krause-Levy; Sophia Louisa,20,1,120,100
1656905057038,CSE 15L,A01,083654,Morris; Justin Loren,8,0,50,42
1656905057038,CSE 15L,A02,083655,Morris; Justin Loren,8,0,50,42
1656905063061,CSE 20,A01,083657,Tran; Khoa Dang,37,0,80,43
1656905069085,CSE 21,A01,095574,Bach; Quang Tran,21,0,48,27
1656905075109,CSE 30,A01,083084,Eldon; John,4,0,80,76
1656905075109,CSE 30,B01,095061,Bhaskar; Nishant,6,0,50,44
1656905081132,CSE 100,A01,083659,Cao; Yingjun,2,4,70,68
1656905087161,CSE 134B,A01,083661,Powell; Thomas Allan,19,0,100,81
1656905093187,CSE 140,A01,083663,Gungor; Onat,14,0,85,71
1656905099211,CSE 140L,A01,083088,Eldon; John,16,0,100,84
1656905105234,CSE 175,A01,083665,Kumar; Rakesh,3,0,25,22
1656905111260,CSE 190,A00,092507,Dubnov; Shlomo,7,0,20,13
1656905117283,ECE 45,A01,083139,Congero; Spencer William,5,0,75,70
1656905123308,ECE 65,A50,083695,Saad; Andrew S,12,0,30,18
1656905123308,ECE 65,A51,095125,Saad; Andrew S,25,0,26,1
1656905129436,ECE 109,A01,091882,Touri; Behrouz,16,0,70,54
1656905135458,ECE 180,A00,083140,Abi Samra; Nicholas Camill,0,0,30,30
1656905135458,ECE 180,B00,083141,Abi Samra; Nicholas Camill,0,0,30,30
1656905141495,MATH 10A,A01,083735,Patchell; Gregory David,1,0,30,29
1656905141495,MATH 10A,A02,083736,Patchell; Gregory David,20,0,30,10
1656905141495,MATH 10A,A03,083737,Patchell; Gregory David,15,0,30,15
1656905147525,MATH 10B,A01,083207,Lim; Seonhee,7,0,34,27
1656905147525,MATH 10B,A02,083208,Lim; Seonhee,9,0,35,26
1656905147525,MATH 10B,A03,093472,Lim; Seonhee,4,0,34,30
1656905147525,MATH 10B,B01,083739,Sinha; Shubham,9,0,30,21
1656905153551,MATH 18,A01,083743,Cinel; Cameron Alexander,6,0,30,24
1656905153551,MATH 18,A02,083744,Cinel; Cameron Alexander,15,0,30,15
1656905153551,MATH 18,A03,083745,Cinel; Cameron Alexander,8,0,30,22
1656905153551,MATH 18,B01,083748,Rideout; David Porter,4,0,37,33
1656905153551,MATH 18,B02,083749,Rideout; David Porter,3,0,36,33
1656905153551,MATH 18,B03,083750,Rideout; David Porter,2,0,37,35
1656905153551,MATH 18,B04,083751,Rideout; David Porter,5,0,36,31
1656905153551,MATH 18,B05,093473,Rideout; David Porter,4,0,36,32
1656905153551,MATH 18,B06,093474,Rideout; David Porter,5,0,36,31
1656905159573,MATH 20A,A01,083754,Zheng; Zequn,12,0,40,28
1656905165605,MATH 20B,A01,083756,Briones; Jor-el Thomas Caparas,1,0,36,35
1656905165605,MATH 20B,A02,083757,Briones; Jor-el Thomas Caparas,1,0,36,35
1656905165605,MATH 20B,A03,093475,Briones; Jor-el Thomas Caparas,0,0,36,36
1656905171634,MATH 20C,A01,083760,Briones; Jor-el Thomas Caparas,1,0,35,34
1656905171634,MATH 20C,A02,083761,Briones; Jor-el Thomas Caparas,8,0,35,27
1656905171634,MATH 20C,A03,093476,Briones; Jor-el Thomas Caparas,0,1,36,36
1656905171634,MATH 20C,B01,083762,Bach; Quang Tran,0,0,30,30
1656905177663,MATH 20D,A01,083765,Tran; Brian Kha,4,0,30,26
1656905177663,MATH 20D,A02,083766,Tran; Brian Kha,4,0,30,26
1656905177663,MATH 20D,A03,083767,Tran; Brian Kha,3,0,30,27
1656905183688,MATH 20E,A01,083771,Ganguly; Soumya,5,0,32,27
1656905183688,MATH 20E,A02,083772,Ganguly; Soumya,6,0,32,26
1656905183688,MATH 20E,B01,083773,Ciotti; Benjamin,18,0,35,17
1656905183688,MATH 20E,B02,083774,Ciotti; Benjamin,17,0,35,18
1656905189713,MATH 103A,A01,083777,Greenfeld; Be'Eri,2,0,36,34
1656905189713,MATH 103A,A02,083778,Greenfeld; Be'Eri,5,0,36,31
1656905189713,MATH 103A,A03,093561,Greenfeld; Be'Eri,4,0,36,32
1656905189713,MATH 103A,B01,083779,Greenfeld; Be'Eri,6,0,36,30
1656905189713,MATH 103A,B02,083780,Greenfeld; Be'Eri,2,0,36,34
1656905189713,MATH 103A,B03,093562,Greenfeld; Be'Eri,2,0,36,34
1656905195734,MATH 105,A01,085443,Carter; Anne Toulson,13,0,35,22
1656905195734,MATH 105,A02,093477,Carter; Anne Toulson,20,0,35,15
1656905201757,MATH 109,A01,083213,Ganzberger; Geoffrey Michael,2,0,34,32
1656905201757,MATH 109,A02,083214,Ganzberger; Geoffrey Michael,2,0,34,32
1656905201757,MATH 109,A03,093478,Ganzberger; Geoffrey Michael,1,0,34,33
1656905201757,MATH 109,B01,083215,Ganzberger; Geoffrey Michael,1,0,32,31
1656905201757,MATH 109,B02,083216,Ganzberger; Geoffrey Michael,1,0,32,31
1656905201757,MATH 109,B03,093479,Ganzberger; Geoffrey Michael,6,0,32,26
1656905207781,MATH 142A,A01,083219,Chow; Bennett,6,0,32,26
1656905207781,MATH 142A,A02,083220,Chow; Bennett,10,0,32,22
1656905207781,MATH 142A,A03,093480,Chow; Bennett,7,0,32,25
1656905207781,MATH 142A,B03,093481,Chow; Bennett,7,0,32,25
1656905207781,MATH 142A,B04,093558,Chow; Bennett,10,0,32,22
1656905207781,MATH 142A,B05,093559,Chow; Bennett,6,0,32,26
1656905213809,MATH 193A,A01,083224,Rotar; Vladimir,7,0,34,27
1656905213809,MATH 193A,A02,083225,Rotar; Vladimir,3,0,34,31
1656905213809,MATH 193A,A03,083781,Rotar; Vladimir,1,0,34,33
1656905213809,MATH 193A,A04,083782,Rotar; Vladimir,6,0,34,28
1656905213809,MATH 193A,A05,093482,Rotar; Vladimir,6,0,34,28
1656905219832,MATH 197,001,091859,McAuley; Julian John,9999,0,9999,0
1656905219832,MATH 197,002,095566,Kedlaya; Kiran S.,9997,0,9999,2
1656905219832,MATH 197,003,095567,Xiao; Ming,9999,0,9999,0
1656905219832,MATH 197,004,095571,Perols; Johan Lars,9998,0,9999,1
1656905226892,COGS 9,A01,083615,Shannon; Kyle Michael,6,0,75,69
1656905232915,COGS 11,A01,083617,Boyle; Mary E. T.,19,0,48,29
1656905238939,COGS 13,A01,083071,Bastos; Amalia Pinkusfeld,8,0,71,63
1656905244964,COGS 14A,A01,092681,Semenuks; Arturs,0,1,100,100
1656905250986,COGS 14B,A01,083073,Cheng; Tzu-Han,5,0,63,58
1656905257013,COGS 17,A01,092677,Semenuks; Arturs,4,0,81,77
1656905263038,COGS 100,A01,083619,Allen; Michael Gordon,15,0,70,55
1656905269062,COGS 101A,A01,083621,Davis; Joshua Daniel,9,0,68,59
1656905275085,COGS 101B,A01,091572,Allen; Michael Gordon,8,0,65,57
1656905281108,COGS 101C,A01,083625,Delgado; Tania,17,0,35,18
1656905287130,COGS 107A,A01,083627,Boyle; Mary E. T.,13,0,60,47
1656905293155,COGS 118A,A01,083075,Gupta; Anjum,15,0,76,61
1656905299181,CSE 3,A50,083646,Miranda; Gregory Joseph,22,0,50,28
1656905305202,CSE 8A,A50,083650,Miranda; Gregory Joseph,17,1,56,39
1656905311232,CSE 11,A01,083080,Cao; Yingjun,4,15,40,36
1656905317257,CSE 12,A01,083652,Krause-Levy; Sophia Louisa,20,1,120,100
1656905323279,CSE 15L,A01,083654,Morris; Justin Loren,8,0,50,42
1656905323279,CSE 15L,A02,083655,Morris; Justin Loren,8,0,50,42
1656905329303,CSE 20,A01,083657,Tran; Khoa Dang,37,0,80,43
1656905335329,CSE 21,A01,095574,Bach; Quang Tran,21,0,48,27
1656905341360,CSE 30,A01,083084,Eldon; John,4,0,80,76
1656905341360,CSE 30,B01,095061,Bhaskar; Nishant,6,0,50,44
1656905347383,CSE 100,A01,083659,Cao; Yingjun,2,4,70,68
1656905353413,CSE 134B,A01,083661,Powell; Thomas Allan,19,0,100,81
1656905359436,CSE 140,A01,083663,Gungor; Onat,14,0,85,71
1656905365470,CSE 140L,A01,083088,Eldon; John,16,0,100,84
1656905371494,CSE 175,A01,083665,Kumar; Rakesh,3,0,25,22
1656905377518,CSE 190,A00,092507,Dubnov; Shlomo,7,0,20,13
1656905383540,ECE 45,A01,083139,Congero; Spencer William,5,0,75,70
1656905389564,ECE 65,A50,083695,Saad; Andrew S,12,0,30,18
1656905389564,ECE 65,A51,095125,Saad; Andrew S,25,0,26,1
1656905395588,ECE 109,A01,091882,Touri; Behrouz,16,0,70,54
1656905401614,ECE 180,A00,083140,Abi Samra; Nicholas Camill,0,0,30,30
1656905401614,ECE 180,B00,083141,Abi Samra; Nicholas Camill,0,0,30,30
1656905407642,MATH 10A,A01,083735,Patchell; Gregory David,1,0,30,29
1656905407642,MATH 10A,A02,083736,Patchell; Gregory David,20,0,30,10
1656905407642,MATH 10A,A03,083737,Patchell; Gregory David,15,0,30,15
1656905413666,MATH 10B,A01,083207,Lim; Seonhee,7,0,34,27
1656905413666,MATH 10B,A02,083208,Lim; Seonhee,9,0,35,26
1656905413666,MATH 10B,A03,093472,Lim; Seonhee,4,0,34,30
1656905413666,MATH 10B,B01,083739,Sinha; Shubham,9,0,30,21
1656905419691,MATH 18,A01,083743,Cinel; Cameron Alexander,6,0,30,24
1656905419691,MATH 18,A02,083744,Cinel; Cameron Alexander,15,0,30,15
1656905419691,MATH 18,A03,083745,Cinel; Cameron Alexander,8,0,30,22
1656905419691,MATH 18,B01,083748,Rideout; David Porter,4,0,37,33
1656905419691,MATH 18,B02,083749,Rideout; David Porter,3,0,36,33
1656905419691,MATH 18,B03,083750,Rideout; David Porter,2,0,37,35
1656905419691,MATH 18,B04,083751,Rideout; David Porter,5,0,36,31
1656905419691,MATH 18,B05,093473,Rideout; David Porter,4,0,36,32
1656905419691,MATH 18,B06,093474,Rideout; David Porter,5,0,36,31
1656905425714,MATH 20A,A01,083754,Zheng; Zequn,12,0,40,28
1656905431743,MATH 20B,A01,083756,Briones; Jor-el Thomas Caparas,1,0,36,35
1656905431743,MATH 20B,A02,083757,Briones; Jor-el Thomas Caparas,1,0,36,35
1656905431743,MATH 20B,A03,093475,Briones; Jor-el Thomas Caparas,0,0,36,36
1656905437768,MATH 20C,A01,083760,Briones; Jor-el Thomas Caparas,1,0,35,34
1656905437768,MATH 20C,A02,083761,Briones; Jor-el Thomas Caparas,8,0,35,27
1656905437768,MATH 20C,A03,093476,Briones; Jor-el Thomas Caparas,0,1,36,36
1656905437768,MATH 20C,B01,083762,Bach; Quang Tran,0,0,30,30
1656905443794,MATH 20D,A01,083765,Tran; Brian Kha,4,0,30,26
1656905443794,MATH 20D,A02,083766,Tran; Brian Kha,4,0,30,26
1656905443794,MATH 20D,A03,083767,Tran; Brian Kha,3,0,30,27
1656905449815,MATH 20E,A01,083771,Ganguly; Soumya,5,0,32,27
1656905449815,MATH 20E,A02,083772,Ganguly; Soumya,6,0,32,26
1656905449815,MATH 20E,B01,083773,Ciotti; Benjamin,18,0,35,17
1656905449815,MATH 20E,B02,083774,Ciotti; Benjamin,17,0,35,18
1656905455839,MATH 103A,A01,083777,Greenfeld; Be'Eri,2,0,36,34
1656905455839,MATH 103A,A02,083778,Greenfeld; Be'Eri,5,0,36,31
1656905455839,MATH 103A,A03,093561,Greenfeld; Be'Eri,4,0,36,32
1656905455839,MATH 103A,B01,083779,Greenfeld; Be'Eri,6,0,36,30
1656905455839,MATH 103A,B02,083780,Greenfeld; Be'Eri,2,0,36,34
1656905455839,MATH 103A,B03,093562,Greenfeld; Be'Eri,2,0,36,34
1656905461901,MATH 105,A01,085443,Carter; Anne Toulson,13,0,35,22
1656905461901,MATH 105,A02,093477,Carter; Anne Toulson,20,0,35,15
1656905467927,MATH 109,A01,083213,Ganzberger; Geoffrey Michael,2,0,34,32
1656905467927,MATH 109,A02,083214,Ganzberger; Geoffrey Michael,2,0,34,32
1656905467927,MATH 109,A03,093478,Ganzberger; Geoffrey Michael,1,0,34,33
1656905467927,MATH 109,B01,083215,Ganzberger; Geoffrey Michael,1,0,32,31
1656905467927,MATH 109,B02,083216,Ganzberger; Geoffrey Michael,1,0,32,31
1656905467927,MATH 109,B03,093479,Ganzberger; Geoffrey Michael,6,0,32,26
1656905473949,MATH 142A,A01,083219,Chow; Bennett,6,0,32,26
1656905473949,MATH 142A,A02,083220,Chow; Bennett,10,0,32,22
1656905473949,MATH 142A,A03,093480,Chow; Bennett,7,0,32,25
1656905473949,MATH 142A,B03,093481,Chow; Bennett,7,0,32,25
1656905473949,MATH 142A,B04,093558,Chow; Bennett,10,0,32,22
1656905473949,MATH 142A,B05,093559,Chow; Bennett,6,0,32,26
1656905479971,MATH 193A,A01,083224,Rotar; Vladimir,7,0,34,27
1656905479971,MATH 193A,A02,083225,Rotar; Vladimir,3,0,34,31
1656905479971,MATH 193A,A03,083781,Rotar; Vladimir,1,0,34,33
1656905479971,MATH 193A,A04,083782,Rotar; Vladimir,6,0,34,28
1656905479971,MATH 193A,A05,093482,Rotar; Vladimir,6,0,34,28
1656905485998,MATH 197,001,091859,McAuley; Julian John,9999,0,9999,0
1656905485998,MATH 197,002,095566,Kedlaya; Kiran S.,9997,0,9999,2
1656905485998,MATH 197,003,095567,Xiao; Ming,9999,0,9999,0
1656905485998,MATH 197,004,095571,Perols; Johan Lars,9998,0,9999,1
1656905493044,COGS 9,A01,083615,Shannon; Kyle Michael,6,0,75,69
1656905499067,COGS 11,A01,083617,Boyle; Mary E. T.,19,0,48,29
1656905505091,COGS 13,A01,083071,Bastos; Amalia Pinkusfeld,8,0,71,63
1656905511114,COGS 14A,A01,092681,Semenuks; Arturs,0,1,100,100
1656905517137,COGS 14B,A01,083073,Cheng; Tzu-Han,5,0,63,58
1656905523168,COGS 17,A01,092677,Semenuks; Arturs,4,0,81,77
1656905529190,COGS 100,A01,083619,Allen; Michael Gordon,15,0,70,55
1656905535213,COGS 101A,A01,083621,Davis; Joshua Daniel,9,0,68,59
1656905541238,COGS 101B,A01,091572,Allen; Michael Gordon,8,0,65,57
1656905547263,COGS 101C,A01,083625,Delgado; Tania,17,0,35,18
1656905553285,COGS 107A,A01,083627,Boyle; Mary E. T.,13,0,60,47
1656905559309,COGS 118A,A01,083075,Gupta; Anjum,15,0,76,61
1656905565337,CSE 3,A50,083646,Miranda; Gregory Joseph,22,0,50,28
1656905571362,CSE 8A,A50,083650,Miranda; Gregory Joseph,17,1,56,39
1656905577388,CSE 11,A01,083080,Cao; Yingjun,4,15,40,36
1656905583411,CSE 12,A01,083652,Krause-Levy; Sophia Louisa,20,1,120,100
1656905589438,CSE 15L,A01,083654,Morris; Justin Loren,8,0,50,42
1656905589438,CSE 15L,A02,083655,Morris; Justin Loren,8,0,50,42
1656905595465,CSE 20,A01,083657,Tran; Khoa Dang,37,0,80,43
1656905601493,CSE 21,A01,095574,Bach; Quang Tran,21,0,48,27
1656905607525,CSE 30,A01,083084,Eldon; John,4,0,80,76
1656905607525,CSE 30,B01,095061,Bhaskar; Nishant,6,0,50,44
1656905613546,CSE 100,A01,083659,Cao; Yingjun,2,4,70,68
1656905619574,CSE 134B,A01,083661,Powell; Thomas Allan,19,0,100,81
1656905625601,CSE 140,A01,083663,Gungor; Onat,14,0,85,71
1656905631626,CSE 140L,A01,083088,Eldon; John,16,0,100,84
1656905637649,CSE 175,A01,083665,Kumar; Rakesh,3,0,25,22
1656905643671,CSE 190,A00,092507,Dubnov; Shlomo,7,0,20,13
1656905649696,ECE 45,A01,083139,Congero; Spencer William,5,0,75,70
1656905655717,ECE 65,A50,083695,Saad; Andrew S,12,0,30,18
1656905655717,ECE 65,A51,095125,Saad; Andrew S,25,0,26,1
1656905661739,ECE 109,A01,091882,Touri; Behrouz,16,0,70,54
1656905667762,ECE 180,A00,083140,Abi Samra; Nicholas Camill,0,0,30,30
1656905667762,ECE 180,B00,083141,Abi Samra; Nicholas Camill,0,0,30,30
1656905673784,MATH 10A,A01,083735,Patchell; Gregory David,1,0,30,29
1656905673784,MATH 10A,A02,083736,Patchell; Gregory David,20,0,30,10
1656905673784,MATH 10A,A03,083737,Patchell; Gregory David,15,0,30,15
1656905679819,MATH 10B,A01,083207,Lim; Seonhee,7,0,34,27
1656905679819,MATH 10B,A02,083208,Lim; Seonhee,9,0,35,26
1656905679819,MATH 10B,A03,093472,Lim; Seonhee,4,0,34,30
1656905679819,MATH 10B,B01,083739,Sinha; Shubham,9,0,30,21
1656905685842,MATH 18,A01,083743,Cinel; Cameron Alexander,6,0,30,24
1656905685842,MATH 18,A02,083744,Cinel; Cameron Alexander,15,0,30,15
1656905685842,MATH 18,A03,083745,Cinel; Cameron Alexander,8,0,30,22
1656905685842,MATH 18,B01,083748,Rideout; David Porter,4,0,37,33
1656905685842,MATH 18,B02,083749,Rideout; David Porter,3,0,36,33
1656905685842,MATH 18,B03,083750,Rideout; David Porter,2,0,37,35
1656905685842,MATH 18,B04,083751,Rideout; David Porter,5,0,36,31
1656905685842,MATH 18,B05,093473,Rideout; David Porter,4,0,36,32
1656905685842,MATH 18,B06,093474,Rideout; David Porter,5,0,36,31
1656905691866,MATH 20A,A01,083754,Zheng; Zequn,12,0,40,28
1656905697890,MATH 20B,A01,083756,Briones; Jor-el Thomas Caparas,1,0,36,35
1656905697890,MATH 20B,A02,083757,Briones; Jor-el Thomas Caparas,1,0,36,35
1656905697890,MATH 20B,A03,093475,Briones; Jor-el Thomas Caparas,0,0,36,36
1656905703916,MATH 20C,A01,083760,Briones; Jor-el Thomas Caparas,1,0,35,34
1656905703916,MATH 20C,A02,083761,Briones; Jor-el Thomas Caparas,8,0,35,27
1656905703916,MATH 20C,A03,093476,Briones; Jor-el Thomas Caparas,0,1,36,36
1656905703916,MATH 20C,B01,083762,Bach; Quang Tran,0,0,30,30
1656905709943,MATH 20D,A01,083765,Tran; Brian Kha,4,0,30,26
1656905709943,MATH 20D,A02,083766,Tran; Brian Kha,4,0,30,26
1656905709943,MATH 20D,A03,083767,Tran; Brian Kha,3,0,30,27
1656905715966,MATH 20E,A01,083771,Ganguly; Soumya,5,0,32,27
1656905715966,MATH 20E,A02,083772,Ganguly; Soumya,6,0,32,26
1656905715966,MATH 20E,B01,083773,Ciotti; Benjamin,18,0,35,17
1656905715966,MATH 20E,B02,083774,Ciotti; Benjamin,17,0,35,18
1656905721995,MATH 103A,A01,083777,Greenfeld; Be'Eri,2,0,36,34
1656905721995,MATH 103A,A02,083778,Greenfeld; Be'Eri,5,0,36,31
1656905721995,MATH 103A,A03,093561,Greenfeld; Be'Eri,4,0,36,32
1656905721995,MATH 103A,B01,083779,Greenfeld; Be'Eri,6,0,36,30
1656905721995,MATH 103A,B02,083780,Greenfeld; Be'Eri,2,0,36,34
1656905721995,MATH 103A,B03,093562,Greenfeld; Be'Eri,2,0,36,34
1656905728115,MATH 105,A01,085443,Carter; Anne Toulson,13,0,35,22
1656905728115,MATH 105,A02,093477,Carter; Anne Toulson,20,0,35,15
1656905734138,MATH 109,A01,083213,Ganzberger; Geoffrey Michael,2,0,34,32
1656905734138,MATH 109,A02,083214,Ganzberger; Geoffrey Michael,2,0,34,32
1656905734138,MATH 109,A03,093478,Ganzberger; Geoffrey Michael,1,0,34,33
1656905734138,MATH 109,B01,083215,Ganzberger; Geoffrey Michael,1,0,32,31
1656905734138,MATH 109,B02,083216,Ganzberger; Geoffrey Michael,1,0,32,31
1656905734138,MATH 109,B03,093479,Ganzberger; Geoffrey Michael,6,0,32,26
1656905740166,MATH 142A,A01,083219,Chow; Bennett,6,0,32,26
1656905740166,MATH 142A,A02,083220,Chow; Bennett,10,0,32,22
1656905740166,MATH 142A,A03,093480,Chow; Bennett,7,0,32,25
1656905740166,MATH 142A,B03,093481,Chow; Bennett,7,0,32,25
1656905740166,MATH 142A,B04,093558,Chow; Bennett,10,0,32,22
1656905740166,MATH 142A,B05,093559,Chow; Bennett,6,0,32,26
1656905746188,MATH 193A,A01,083224,Rotar; Vladimir,7,0,34,27
1656905746188,MATH 193A,A02,083225,Rotar; Vladimir,3,0,34,31
1656905746188,MATH 193A,A03,083781,Rotar; Vladimir,1,0,34,33
1656905746188,MATH 193A,A04,083782,Rotar; Vladimir,6,0,34,28
1656905746188,MATH 193A,A05,093482,Rotar; Vladimir,6,0,34,28
1656905752212,MATH 197,001,091859,McAuley; Julian John,9999,0,9999,0
1656905752212,MATH 197,002,095566,Kedlaya; Kiran S.,9997,0,9999,2
1656905752212,MATH 197,003,095567,Xiao; Ming,9999,0,9999,0
1656905752212,MATH 197,004,095571,Perols; Johan Lars,9998,0,9999,1
1656905759263,COGS 9,A01,083615,Shannon; Kyle Michael,6,0,75,69
1656905765286,COGS 11,A01,083617,Boyle; Mary E. T.,19,0,48,29
1656905771310,COGS 13,A01,083071,Bastos; Amalia Pinkusfeld,8,0,71,63
1656905777334,COGS 14A,A01,092681,Semenuks; Arturs,0,1,100,100
1656905783358,COGS 14B,A01,083073,Cheng; Tzu-Han,5,0,63,58
1656905789381,COGS 17,A01,092677,Semenuks; Arturs,4,0,81,77
1656905795404,COGS 100,A01,083619,Allen; Michael Gordon,15,0,70,55
1656905801427,COGS 101A,A01,083621,Davis; Joshua Daniel,9,0,68,59
1656905807453,COGS 101B,A01,091572,Allen; Michael Gordon,8,0,65,57
1656905813480,COGS 101C,A01,083625,Delgado; Tania,17,0,35,18
1656905819502,COGS 107A,A01,083627,Boyle; Mary E. T.,13,0,60,47
1656905825526,COGS 118A,A01,083075,Gupta; Anjum,15,0,76,61
1656905831554,CSE 3,A50,083646,Miranda; Gregory Joseph,22,0,50,28
1656905837581,CSE 8A,A50,083650,Miranda; Gregory Joseph,17,1,56,39
1656905843612,CSE 11,A01,083080,Cao; Yingjun,4,15,40,36
1656905849634,CSE 12,A01,083652,Krause-Levy; Sophia Louisa,20,1,120,100
1656905855658,CSE 15L,A01,083654,Morris; Justin Loren,8,0,50,42
1656905855658,CSE 15L,A02,083655,Morris; Justin Loren,8,0,50,42
1656905861686,CSE 20,A01,083657,Tran; Khoa Dang,37,0,80,43
1656905867708,CSE 21,A01,095574,Bach; Quang Tran,21,0,48,27
1656905873735,CSE 30,A01,083084,Eldon; John,4,0,80,76
1656905873735,CSE 30,B01,095061,Bhaskar; Nishant,6,0,50,44
1656905879765,CSE 100,A01,083659,Cao; Yingjun,2,4,70,68
1656905885800,CSE 134B,A01,083661,Powell; Thomas Allan,19,0,100,81
1656905891823,CSE 140,A01,083663,Gungor; Onat,14,0,85,71
1656905897849,CSE 140L,A01,083088,Eldon; John,16,0,100,84
1656905903872,CSE 175,A01,083665,Kumar; Rakesh,3,0,25,22
1656905909895,CSE 190,A00,092507,Dubnov; Shlomo,7,0,20,13
1656905915918,ECE 45,A01,083139,Congero; Spencer William,5,0,75,70
1656905921945,ECE 65,A50,083695,Saad; Andrew S,12,0,30,18
1656905921945,ECE 65,A51,095125,Saad; Andrew S,25,0,26,1
1656905927981,ECE 109,A01,091882,Touri; Behrouz,16,0,70,54
1656905934005,ECE 180,A00,083140,Abi Samra; Nicholas Camill,0,0,30,30
1656905934005,ECE 180,B00,083141,Abi Samra; Nicholas Camill,0,0,30,30
1656905940034,MATH 10A,A01,083735,Patchell; Gregory David,1,0,30,29
1656905940034,MATH 10A,A02,083736,Patchell; Gregory David,20,0,30,10
1656905940034,MATH 10A,A03,083737,Patchell; Gregory David,15,0,30,15
1656905946057,MATH 10B,A01,083207,Lim; Seonhee,7,0,34,27
1656905946057,MATH 10B,A02,083208,Lim; Seonhee,9,0,35,26
1656905946057,MATH 10B,A03,093472,Lim; Seonhee,4,0,34,30
1656905946057,MATH 10B,B01,083739,Sinha; Shubham,9,0,30,21
1656905952087,MATH 18,A01,083743,Cinel; Cameron Alexander,6,0,30,24
1656905952087,MATH 18,A02,083744,Cinel; Cameron Alexander,15,0,30,15
1656905952087,MATH 18,A03,083745,Cinel; Cameron Alexander,8,0,30,22
1656905952087,MATH 18,B01,083748,Rideout; David Porter,4,0,37,33
1656905952087,MATH 18,B02,083749,Rideout; David Porter,3,0,36,33
1656905952087,MATH 18,B03,083750,Rideout; David Porter,2,0,37,35
1656905952087,MATH 18,B04,083751,Rideout; David Porter,5,0,36,31
1656905952087,MATH 18,B05,093473,Rideout; David Porter,4,0,36,32
1656905952087,MATH 18,B06,093474,Rideout; David Porter,5,0,36,31
1656905958111,MATH 20A,A01,083754,Zheng; Zequn,12,0,40,28
1656905964141,MATH 20B,A01,083756,Briones; Jor-el Thomas Caparas,1,0,36,35
1656905964141,MATH 20B,A02,083757,Briones; Jor-el Thomas Caparas,1,0,36,35
1656905964141,MATH 20B,A03,093475,Briones; Jor-el Thomas Caparas,0,0,36,36
1656905970164,MATH 20C,A01,083760,Briones; Jor-el Thomas Caparas,1,0,35,34
1656905970164,MATH 20C,A02,083761,Briones; Jor-el Thomas Caparas,8,0,35,27
1656905970164,MATH 20C,A03,093476,Briones; Jor-el Thomas Caparas,0,1,36,36
1656905970164,MATH 20C,B01,083762,Bach; Quang Tran,0,0,30,30
1656905976187,MATH 20D,A01,083765,Tran; Brian Kha,4,0,30,26
1656905976187,MATH 20D,A02,083766,Tran; Brian Kha,4,0,30,26
1656905976187,MATH 20D,A03,083767,Tran; Brian Kha,3,0,30,27
1656905982211,MATH 20E,A01,083771,Ganguly; Soumya,5,0,32,27
1656905982211,MATH 20E,A02,083772,Ganguly; Soumya,6,0,32,26
1656905982211,MATH 20E,B01,083773,Ciotti; Benjamin,18,0,35,17
1656905982211,MATH 20E,B02,083774,Ciotti; Benjamin,17,0,35,18
1656905988233,MATH 103A,A01,083777,Greenfeld; Be'Eri,2,0,36,34
1656905988233,MATH 103A,A02,083778,Greenfeld; Be'Eri,5,0,36,31
1656905988233,MATH 103A,A03,093561,Greenfeld; Be'Eri,4,0,36,32
1656905988233,MATH 103A,B01,083779,Greenfeld; Be'Eri,6,0,36,30
1656905988233,MATH 103A,B02,083780,Greenfeld; Be'Eri,2,0,36,34
1656905988233,MATH 103A,B03,093562,Greenfeld; Be'Eri,2,0,36,34
1656905994257,MATH 105,A01,085443,Carter; Anne Toulson,13,0,35,22
1656905994257,MATH 105,A02,093477,Carter; Anne Toulson,20,0,35,15
1656906000280,MATH 109,A01,083213,Ganzberger; Geoffrey Michael,2,0,34,32
1656906000280,MATH 109,A02,083214,Ganzberger; Geoffrey Michael,2,0,34,32
1656906000280,MATH 109,A03,093478,Ganzberger; Geoffrey Michael,1,0,34,33
1656906000280,MATH 109,B01,083215,Ganzberger; Geoffrey Michael,1,0,32,31
1656906000280,MATH 109,B02,083216,Ganzberger; Geoffrey Michael,1,0,32,31
1656906000280,MATH 109,B03,093479,Ganzberger; Geoffrey Michael,6,0,32,26
1656906006303,MATH 142A,A01,083219,Chow; Bennett,6,0,32,26
1656906006303,MATH 142A,A02,083220,Chow; Bennett,10,0,32,22
1656906006303,MATH 142A,A03,093480,Chow; Bennett,7,0,32,25
1656906006303,MATH 142A,B03,093481,Chow; Bennett,7,0,32,25
1656906006303,MATH 142A,B04,093558,Chow; Bennett,10,0,32,22
1656906006303,MATH 142A,B05,093559,Chow; Bennett,6,0,32,26
1656906012327,MATH 193A,A01,083224,Rotar; Vladimir,7,0,34,27
1656906012327,MATH 193A,A02,083225,Rotar; Vladimir,3,0,34,31
1656906012327,MATH 193A,A03,083781,Rotar; Vladimir,1,0,34,33
1656906012327,MATH 193A,A04,083782,Rotar; Vladimir,6,0,34,28
1656906012327,MATH 193A,A05,093482,Rotar; Vladimir,6,0,34,28
1656906018355,MATH 197,001,091859,McAuley; Julian John,9999,0,9999,0
1656906018355,MATH 197,002,095566,Kedlaya; Kiran S.,9997,0,9999,2
1656906018355,MATH 197,003,095567,Xiao; Ming,9999,0,9999,0
1656906018355,MATH 197,004,095571,Perols; Johan Lars,9998,0,9999,1
1656906025429,COGS 9,A01,083615,Shannon; Kyle Michael,7,0,75,68
1656906031453,COGS 11,A01,083617,Boyle; Mary E. T.,19,0,48,29
1656906037477,COGS 13,A01,083071,Bastos; Amalia Pinkusfeld,8,0,71,63
1656906043515,COGS 14A,A01,092681,Semenuks; Arturs,0,1,100,100
1656906049538,COGS 14B,A01,083073,Cheng; Tzu-Han,5,0,63,58
1656906055562,COGS 17,A01,092677,Semenuks; Arturs,4,0,81,77
1656906061590,COGS 100,A01,083619,Allen; Michael Gordon,15,0,70,55
1656906067614,COGS 101A,A01,083621,Davis; Joshua Daniel,9,0,68,59
1656906073636,COGS 101B,A01,091572,Allen; Michael Gordon,8,0,65,57
1656906079661,COGS 101C,A01,083625,Delgado; Tania,17,0,35,18
1656906085684,COGS 107A,A01,083627,Boyle; Mary E. T.,13,0,60,47
1656906091716,COGS 118A,A01,083075,Gupta; Anjum,15,0,76,61
1656906097754,CSE 3,A50,083646,Miranda; Gregory Joseph,22,0,50,28
1656906103777,CSE 8A,A50,083650,Miranda; Gregory Joseph,17,1,56,39
1656906109799,CSE 11,A01,083080,Cao; Yingjun,4,15,40,36
1656906115821,CSE 12,A01,083652,Krause-Levy; Sophia Louisa,20,1,120,100
1656906121845,CSE 15L,A01,083654,Morris; Justin Loren,8,0,50,42
1656906121845,CSE 15L,A02,083655,Morris; Justin Loren,8,0,50,42
1656906127867,CSE 20,A01,083657,Tran; Khoa Dang,37,0,80,43
1656906133895,CSE 21,A01,095574,Bach; Quang Tran,21,0,48,27
1656906139922,CSE 30,A01,083084,Eldon; John,4,0,80,76
1656906139922,CSE 30,B01,095061,Bhaskar; Nishant,6,0,50,44
1656906145946,CSE 100,A01,083659,Cao; Yingjun,2,4,70,68
1656906151973,CSE 134B,A01,083661,Powell; Thomas Allan,19,0,100,81
1656906157996,CSE 140,A01,083663,Gungor; Onat,14,0,85,71
1656906164019,CSE 140L,A01,083088,Eldon; John,16,0,100,84
1656906170044,CSE 175,A01,083665,Kumar; Rakesh,3,0,25,22
1656906176067,CSE 190,A00,092507,Dubnov; Shlomo,7,0,20,13
1656906182091,ECE 45,A01,083139,Congero; Spencer William,5,0,75,70
1656906188117,ECE 65,A50,083695,Saad; Andrew S,12,0,30,18
1656906188117,ECE 65,A51,095125,Saad; Andrew S,25,0,26,1
1656906194141,ECE 109,A01,091882,Touri; Behrouz,16,0,70,54
1656906200167,ECE 180,A00,083140,Abi Samra; Nicholas Camill,0,0,30,30
1656906200167,ECE 180,B00,083141,Abi Samra; Nicholas Camill,0,0,30,30
1656906206193,MATH 10A,A01,083735,Patchell; Gregory David,1,0,30,29
1656906206193,MATH 10A,A02,083736,Patchell; Gregory David,20,0,30,10
1656906206193,MATH 10A,A03,083737,Patchell; Gregory David,15,0,30,15
1656906212221,MATH 10B,A01,083207,Lim; Seonhee,7,0,34,27
1656906212221,MATH 10B,A02,083208,Lim; Seonhee,9,0,35,26
1656906212221,MATH 10B,A03,093472,Lim; Seonhee,4,0,34,30
1656906212221,MATH 10B,B01,083739,Sinha; Shubham,9,0,30,21
1656906218252,MATH 18,A01,083743,Cinel; Cameron Alexander,6,0,30,24
1656906218252,MATH 18,A02,083744,Cinel; Cameron Alexander,15,0,30,15
1656906218252,MATH 18,A03,083745,Cinel; Cameron Alexander,8,0,30,22
1656906218252,MATH 18,B01,083748,Rideout; David Porter,4,0,37,33
1656906218252,MATH 18,B02,083749,Rideout; David Porter,3,0,36,33
1656906218252,MATH 18,B03,083750,Rideout; David Porter,2,0,37,35
1656906218252,MATH 18,B04,083751,Rideout; David Porter,5,0,36,31
1656906218252,MATH 18,B05,093473,Rideout; David Porter,4,0,36,32
1656906218252,MATH 18,B06,093474,Rideout; David Porter,5,0,36,31
1656906224279,MATH 20A,A01,083754,Zheng; Zequn,12,0,40,28
1656906230302,MATH 20B,A01,083756,Briones; Jor-el Thomas Caparas,1,0,36,35
1656906230302,MATH 20B,A02,083757,Briones; Jor-el Thomas Caparas,1,0,36,35
1656906230302,MATH 20B,A03,093475,Briones; Jor-el Thomas Caparas,0,0,36,36
1656906236329,MATH 20C,A01,083760,Briones; Jor-el Thomas Caparas,1,0,35,34
1656906236329,MATH 20C,A02,083761,Briones; Jor-el Thomas Caparas,8,0,35,27
1656906236329,MATH 20C,A03,093476,Briones; Jor-el Thomas Caparas,0,1,36,36
1656906236329,MATH 20C,B01,083762,Bach; Quang Tran,0,0,30,30
1656906242358,MATH 20D,A01,083765,Tran; Brian Kha,4,0,30,26
1656906242358,MATH 20D,A02,083766,Tran; Brian Kha,4,0,30,26
1656906242358,MATH 20D,A03,083767,Tran; Brian Kha,3,0,30,27
1656906248381,MATH 20E,A01,083771,Ganguly; Soumya,5,0,32,27
1656906248381,MATH 20E,A02,083772,Ganguly; Soumya,6,0,32,26
1656906248381,MATH 20E,B01,083773,Ciotti; Benjamin,18,0,35,17
1656906248381,MATH 20E,B02,083774,Ciotti; Benjamin,17,0,35,18
1656906254411,MATH 103A,A01,083777,Greenfeld; Be'Eri,2,0,36,34
1656906254411,MATH 103A,A02,083778,Greenfeld; Be'Eri,5,0,36,31
1656906254411,MATH 103A,A03,093561,Greenfeld; Be'Eri,4,0,36,32
1656906254411,MATH 103A,B01,083779,Greenfeld; Be'Eri,6,0,36,30
1656906254411,MATH 103A,B02,083780,Greenfeld; Be'Eri,2,0,36,34
1656906254411,MATH 103A,B03,093562,Greenfeld; Be'Eri,2,0,36,34
1656906260446,MATH 105,A01,085443,Carter; Anne Toulson,13,0,35,22
1656906260446,MATH 105,A02,093477,Carter; Anne Toulson,20,0,35,15
1656906266471,MATH 109,A01,083213,Ganzberger; Geoffrey Michael,2,0,34,32
1656906266471,MATH 109,A02,083214,Ganzberger; Geoffrey Michael,2,0,34,32
1656906266471,MATH 109,A03,093478,Ganzberger; Geoffrey Michael,1,0,34,33
1656906266471,MATH 109,B01,083215,Ganzberger; Geoffrey Michael,1,0,32,31
1656906266471,MATH 109,B02,083216,Ganzberger; Geoffrey Michael,1,0,32,31
1656906266471,MATH 109,B03,093479,Ganzberger; Geoffrey Michael,6,0,32,26
1656906272494,MATH 142A,A01,083219,Chow; Bennett,6,0,32,26
1656906272494,MATH 142A,A02,083220,Chow; Bennett,10,0,32,22
1656906272494,MATH 142A,A03,093480,Chow; Bennett,7,0,32,25
1656906272494,MATH 142A,B03,093481,Chow; Bennett,7,0,32,25
1656906272494,MATH 142A,B04,093558,Chow; Bennett,10,0,32,22
1656906272494,MATH 142A,B05,093559,Chow; Bennett,6,0,32,26
1656906278518,MATH 193A,A01,083224,Rotar; Vladimir,7,0,34,27
1656906278518,MATH 193A,A02,083225,Rotar; Vladimir,3,0,34,31
1656906278518,MATH 193A,A03,083781,Rotar; Vladimir,1,0,34,33
1656906278518,MATH 193A,A04,083782,Rotar; Vladimir,6,0,34,28
1656906278518,MATH 193A,A05,093482,Rotar; Vladimir,6,0,34,28
1656906284541,MATH 197,001,091859,McAuley; Julian John,9999,0,9999,0
1656906284541,MATH 197,002,095566,Kedlaya; Kiran S.,9997,0,9999,2
1656906284541,MATH 197,003,095567,Xiao; Ming,9999,0,9999,0
1656906284541,MATH 197,004,095571,Perols; Johan Lars,9998,0,9999,1
1656906291610,COGS 9,A01,083615,Shannon; Kyle Michael,7,0,75,68
1656906297637,COGS 11,A01,083617,Boyle; Mary E. T.,19,0,48,29
1656906303660,COGS 13,A01,083071,Bastos; Amalia Pinkusfeld,8,0,71,63
1656906309683,COGS 14A,A01,092681,Semenuks; Arturs,0,1,100,100
1656906315713,COGS 14B,A01,083073,Cheng; Tzu-Han,5,0,63,58
1656906321808,COGS 17,A01,092677,Semenuks; Arturs,4,0,81,77
1656906327832,COGS 100,A01,083619,Allen; Michael Gordon,15,0,70,55
1656906333855,COGS 101A,A01,083621,Davis; Joshua Daniel,9,0,68,59
1656906339879,COGS 101B,A01,091572,Allen; Michael Gordon,8,0,65,57
1656906345906,COGS 101C,A01,083625,Delgado; Tania,17,0,35,18
1656906351931,COGS 107A,A01,083627,Boyle; Mary E. T.,13,0,60,47
1656906357958,COGS 118A,A01,083075,Gupta; Anjum,15,0,76,61
1656906363982,CSE 3,A50,083646,Miranda; Gregory Joseph,22,0,50,28
1656906370009,CSE 8A,A50,083650,Miranda; Gregory Joseph,17,1,56,39
1656906376035,CSE 11,A01,083080,Cao; Yingjun,4,15,40,36
1656906382059,CSE 12,A01,083652,Krause-Levy; Sophia Louisa,20,1,120,100
1656906388080,CSE 15L,A01,083654,Morris; Justin Loren,8,0,50,42
1656906388080,CSE 15L,A02,083655,Morris; Justin Loren,8,0,50,42
1656906394104,CSE 20,A01,083657,Tran; Khoa Dang,37,0,80,43
1656906400134,CSE 21,A01,095574,Bach; Quang Tran,21,0,48,27
1656906406158,CSE 30,A01,083084,Eldon; John,4,0,80,76
1656906406158,CSE 30,B01,095061,Bhaskar; Nishant,6,0,50,44
1656906412182,CSE 100,A01,083659,Cao; Yingjun,2,4,70,68
1656906418210,CSE 134B,A01,083661,Powell; Thomas Allan,19,0,100,81
1656906424234,CSE 140,A01,083663,Gungor; Onat,14,0,85,71
1656906430258,CSE 140L,A01,083088,Eldon; John,16,0,100,84
1656906436288,CSE 175,A01,083665,Kumar; Rakesh,3,0,25,22
1656906442317,CSE 190,A00,092507,Dubnov; Shlomo,7,0,20,13
1656906448342,ECE 45,A01,083139,Congero; Spencer William,5,0,75,70
1656906454364,ECE 65,A50,083695,Saad; Andrew S,12,0,30,18
1656906454364,ECE 65,A51,095125,Saad; Andrew S,25,0,26,1
1656906460393,ECE 109,A01,091882,Touri; Behrouz,16,0,70,54
1656906466420,ECE 180,A00,083140,Abi Samra; Nicholas Camill,0,0,30,30
1656906466420,ECE 180,B00,083141,Abi Samra; Nicholas Camill,0,0,30,30
1656906472444,MATH 10A,A01,083735,Patchell; Gregory David,1,0,30,29
1656906472444,MATH 10A,A02,083736,Patchell; Gregory David,20,0,30,10
1656906472444,MATH 10A,A03,083737,Patchell; Gregory David,15,0,30,15
1656906478470,MATH 10B,A01,083207,Lim; Seonhee,7,0,34,27
1656906478470,MATH 10B,A02,083208,Lim; Seonhee,9,0,35,26
1656906478470,MATH 10B,A03,093472,Lim; Seonhee,4,0,34,30
1656906478470,MATH 10B,B01,083739,Sinha; Shubham,9,0,30,21
1656906484502,MATH 18,A01,083743,Cinel; Cameron Alexander,6,0,30,24
1656906484502,MATH 18,A02,083744,Cinel; Cameron Alexander,15,0,30,15
1656906484502,MATH 18,A03,083745,Cinel; Cameron Alexander,8,0,30,22
1656906484502,MATH 18,B01,083748,Rideout; David Porter,4,0,37,33
1656906484502,MATH 18,B02,083749,Rideout; David Porter,3,0,36,33
1656906484502,MATH 18,B03,083750,Rideout; David Porter,2,0,37,35
1656906484502,MATH 18,B04,083751,Rideout; David Porter,5,0,36,31
1656906484502,MATH 18,B05,093473,Rideout; David Porter,4,0,36,32
1656906484502,MATH 18,B06,093474,Rideout; David Porter,5,0,36,31
1656906490526,MATH 20A,A01,083754,Zheng; Zequn,12,0,40,28
1656906496564,MATH 20B,A01,083756,Briones; Jor-el Thomas Caparas,1,0,36,35
1656906496564,MATH 20B,A02,083757,Briones; Jor-el Thomas Caparas,1,0,36,35
1656906496564,MATH 20B,A03,093475,Briones; Jor-el Thomas Caparas,0,0,36,36
1656906502588,MATH 20C,A01,083760,Briones; Jor-el Thomas Caparas,1,0,35,34
1656906502588,MATH 20C,A02,083761,Briones; Jor-el Thomas Caparas,8,0,35,27
1656906502588,MATH 20C,A03,093476,Briones; Jor-el Thomas Caparas,0,1,36,36
1656906502588,MATH 20C,B01,083762,Bach; Quang Tran,0,0,30,30
1656906508617,MATH 20D,A01,083765,Tran; Brian Kha,4,0,30,26
1656906508617,MATH 20D,A02,083766,Tran; Brian Kha,4,0,30,26
1656906508617,MATH 20D,A03,083767,Tran; Brian Kha,3,0,30,27
1656906514638,MATH 20E,A01,083771,Ganguly; Soumya,5,0,32,27
1656906514638,MATH 20E,A02,083772,Ganguly; Soumya,6,0,32,26
1656906514638,MATH 20E,B01,083773,Ciotti; Benjamin,18,0,35,17
1656906514638,MATH 20E,B02,083774,Ciotti; Benjamin,17,0,35,18
1656906520667,MATH 103A,A01,083777,Greenfeld; Be'Eri,2,0,36,34
1656906520667,MATH 103A,A02,083778,Greenfeld; Be'Eri,5,0,36,31
1656906520667,MATH 103A,A03,093561,Greenfeld; Be'Eri,4,0,36,32
1656906520667,MATH 103A,B01,083779,Greenfeld; Be'Eri,6,0,36,30
1656906520667,MATH 103A,B02,083780,Greenfeld; Be'Eri,2,0,36,34
1656906520667,MATH 103A,B03,093562,Greenfeld; Be'Eri,2,0,36,34
1656906526689,MATH 105,A01,085443,Carter; Anne Toulson,13,0,35,22
1656906526689,MATH 105,A02,093477,Carter; Anne Toulson,20,0,35,15
1656906532713,MATH 109,A01,083213,Ganzberger; Geoffrey Michael,2,0,34,32
1656906532713,MATH 109,A02,083214,Ganzberger; Geoffrey Michael,2,0,34,32
1656906532713,MATH 109,A03,093478,Ganzberger; Geoffrey Michael,1,0,34,33
1656906532713,MATH 109,B01,083215,Ganzberger; Geoffrey Michael,1,0,32,31
1656906532713,MATH 109,B02,083216,Ganzberger; Geoffrey Michael,1,0,32,31
1656906532713,MATH 109,B03,093479,Ganzberger; Geoffrey Michael,6,0,32,26
1656906538737,MATH 142A,A01,083219,Chow; Bennett,6,0,32,26
1656906538737,MATH 142A,A02,083220,Chow; Bennett,10,0,32,22
1656906538737,MATH 142A,A03,093480,Chow; Bennett,7,0,32,25
1656906538737,MATH 142A,B03,093481,Chow; Bennett,7,0,32,25
1656906538737,MATH 142A,B04,093558,Chow; Bennett,10,0,32,22
1656906538737,MATH 142A,B05,093559,Chow; Bennett,6,0,32,26
1656906544760,MATH 193A,A01,083224,Rotar; Vladimir,7,0,34,27
1656906544760,MATH 193A,A02,083225,Rotar; Vladimir,3,0,34,31
1656906544760,MATH 193A,A03,083781,Rotar; Vladimir,1,0,34,33
1656906544760,MATH 193A,A04,083782,Rotar; Vladimir,6,0,34,28
1656906544760,MATH 193A,A05,093482,Rotar; Vladimir,6,0,34,28
1656906550782,MATH 197,001,091859,McAuley; Julian John,9999,0,9999,0
1656906550782,MATH 197,002,095566,Kedlaya; Kiran S.,9997,0,9999,2
1656906550782,MATH 197,003,095567,Xiao; Ming,9999,0,9999,0
1656906550782,MATH 197,004,095571,Perols; Johan Lars,9998,0,9999,1
1656906557844,COGS 9,A01,083615,Shannon; Kyle Michael,7,0,75,68
1656906563872,COGS 11,A01,083617,Boyle; Mary E. T.,19,0,48,29
1656906569895,COGS 13,A01,083071,Bastos; Amalia Pinkusfeld,8,0,71,63
1656906575922,COGS 14A,A01,092681,Semenuks; Arturs,0,1,100,100
1656906581945,COGS 14B,A01,083073,Cheng; Tzu-Han,5,0,63,58
1656906587969,COGS 17,A01,092677,Semenuks; Arturs,4,0,81,77
1656906593994,COGS 100,A01,083619,Allen; Michael Gordon,15,0,70,55
1656906600020,COGS 101A,A01,083621,Davis; Joshua Daniel,9,0,68,59
1656906606052,COGS 101B,A01,091572,Allen; Michael Gordon,8,0,65,57
1656906612076,COGS 101C,A01,083625,Delgado; Tania,17,0,35,18
1656906618102,COGS 107A,A01,083627,Boyle; Mary E. T.,13,0,60,47
1656906624127,COGS 118A,A01,083075,Gupta; Anjum,15,0,76,61
1656906630156,CSE 3,A50,083646,Miranda; Gregory Joseph,22,0,50,28
1656906636183,CSE 8A,A50,083650,Miranda; Gregory Joseph,17,1,56,39
1656906642207,CSE 11,A01,083080,Cao; Yingjun,4,15,40,36
1656906648241,CSE 12,A01,083652,Krause-Levy; Sophia Louisa,20,1,120,100
1656906654270,CSE 15L,A01,083654,Morris; Justin Loren,8,0,50,42
1656906654270,CSE 15L,A02,083655,Morris; Justin Loren,8,0,50,42
1656906660301,CSE 20,A01,083657,Tran; Khoa Dang,37,0,80,43
1656906666331,CSE 21,A01,095574,Bach; Quang Tran,21,0,48,27
1656906672358,CSE 30,A01,083084,Eldon; John,4,0,80,76
1656906672358,CSE 30,B01,095061,Bhaskar; Nishant,6,0,50,44
1656906678382,CSE 100,A01,083659,Cao; Yingjun,2,4,70,68
1656906684410,CSE 134B,A01,083661,Powell; Thomas Allan,19,0,100,81
1656906690433,CSE 140,A01,083663,Gungor; Onat,14,0,85,71
1656906696460,CSE 140L,A01,083088,Eldon; John,16,0,100,84
1656906702486,CSE 175,A01,083665,Kumar; Rakesh,3,0,25,22
1656906708507,CSE 190,A00,092507,Dubnov; Shlomo,7,0,20,13
1656906714538,ECE 45,A01,083139,Congero; Spencer William,5,0,75,70
1656906720596,ECE 65,A50,083695,Saad; Andrew S,12,0,30,18
1656906720596,ECE 65,A51,095125,Saad; Andrew S,25,0,26,1
1656906726623,ECE 109,A01,091882,Touri; Behrouz,16,0,70,54
1656906732647,ECE 180,A00,083140,Abi Samra; Nicholas Camill,0,0,30,30
1656906732647,ECE 180,B00,083141,Abi Samra; Nicholas Camill,0,0,30,30
1656906738670,MATH 10A,A01,083735,Patchell; Gregory David,1,0,30,29
1656906738670,MATH 10A,A02,083736,Patchell; Gregory David,20,0,30,10
1656906738670,MATH 10A,A03,083737,Patchell; Gregory David,15,0,30,15
1656906744707,MATH 10B,A01,083207,Lim; Seonhee,7,0,34,27
1656906744707,MATH 10B,A02,083208,Lim; Seonhee,9,0,35,26
1656906744707,MATH 10B,A03,093472,Lim; Seonhee,4,0,34,30
1656906744707,MATH 10B,B01,083739,Sinha; Shubham,9,0,30,21
1656906750731,MATH 18,A01,083743,Cinel; Cameron Alexander,6,0,30,24
1656906750731,MATH 18,A02,083744,Cinel; Cameron Alexander,15,0,30,15
1656906750731,MATH 18,A03,083745,Cinel; Cameron Alexander,8,0,30,22
1656906750731,MATH 18,B01,083748,Rideout; David Porter,4,0,37,33
1656906750731,MATH 18,B02,083749,Rideout; David Porter,3,0,36,33
1656906750731,MATH 18,B03,083750,Rideout; David Porter,2,0,37,35
1656906750731,MATH 18,B04,083751,Rideout; David Porter,5,0,36,31
1656906750731,MATH 18,B05,093473,Rideout; David Porter,4,0,36,32
1656906750731,MATH 18,B06,093474,Rideout; David Porter,5,0,36,31
1656906756754,MATH 20A,A01,083754,Zheng; Zequn,12,0,40,28
1656906762781,MATH 20B,A01,083756,Briones; Jor-el Thomas Caparas,1,0,36,35
1656906762781,MATH 20B,A02,083757,Briones; Jor-el Thomas Caparas,1,0,36,35
1656906762781,MATH 20B,A03,093475,Briones; Jor-el Thomas Caparas,0,0,36,36
1656906768804,MATH 20C,A01,083760,Briones; Jor-el Thomas Caparas,1,0,35,34
1656906768804,MATH 20C,A02,083761,Briones; Jor-el Thomas Caparas,8,0,35,27
1656906768804,MATH 20C,A03,093476,Briones; Jor-el Thomas Caparas,0,1,36,36
1656906768804,MATH 20C,B01,083762,Bach; Quang Tran,0,0,30,30
1656906774832,MATH 20D,A01,083765,Tran; Brian Kha,4,0,30,26
1656906774832,MATH 20D,A02,083766,Tran; Brian Kha,4,0,30,26
1656906774832,MATH 20D,A03,083767,Tran; Brian Kha,3,0,30,27
1656906780858,MATH 20E,A01,083771,Ganguly; Soumya,5,0,32,27
1656906780858,MATH 20E,A02,083772,Ganguly; Soumya,6,0,32,26
1656906780858,MATH 20E,B01,083773,Ciotti; Benjamin,18,0,35,17
1656906780858,MATH 20E,B02,083774,Ciotti; Benjamin,17,0,35,18
1656906786883,MATH 103A,A01,083777,Greenfeld; Be'Eri,2,0,36,34
1656906786883,MATH 103A,A02,083778,Greenfeld; Be'Eri,5,0,36,31
1656906786883,MATH 103A,A03,093561,Greenfeld; Be'Eri,4,0,36,32
1656906786883,MATH 103A,B01,083779,Greenfeld; Be'Eri,6,0,36,30
1656906786883,MATH 103A,B02,083780,Greenfeld; Be'Eri,2,0,36,34
1656906786883,MATH 103A,B03,093562,Greenfeld; Be'Eri,2,0,36,34
1656906792911,MATH 105,A01,085443,Carter; Anne Toulson,13,0,35,22
1656906792911,MATH 105,A02,093477,Carter; Anne Toulson,20,0,35,15
1656906798939,MATH 109,A01,083213,Ganzberger; Geoffrey Michael,2,0,34,32
1656906798939,MATH 109,A02,083214,Ganzberger; Geoffrey Michael,2,0,34,32
1656906798939,MATH 109,A03,093478,Ganzberger; Geoffrey Michael,1,0,34,33
1656906798939,MATH 109,B01,083215,Ganzberger; Geoffrey Michael,1,0,32,31
1656906798939,MATH 109,B02,083216,Ganzberger; Geoffrey Michael,1,0,32,31
1656906798939,MATH 109,B03,093479,Ganzberger; Geoffrey Michael,6,0,32,26
1656906804966,MATH 142A,A01,083219,Chow; Bennett,6,0,32,26
1656906804966,MATH 142A,A02,083220,Chow; Bennett,10,0,32,22
1656906804966,MATH 142A,A03,093480,Chow; Bennett,7,0,32,25
1656906804966,MATH 142A,B03,093481,Chow; Bennett,7,0,32,25
1656906804966,MATH 142A,B04,093558,Chow; Bennett,10,0,32,22
1656906804966,MATH 142A,B05,093559,Chow; Bennett,6,0,32,26
1656906810994,MATH 193A,A01,083224,Rotar; Vladimir,7,0,34,27
1656906810994,MATH 193A,A02,083225,Rotar; Vladimir,3,0,34,31
1656906810994,MATH 193A,A03,083781,Rotar; Vladimir,1,0,34,33
1656906810994,MATH 193A,A04,083782,Rotar; Vladimir,6,0,34,28
1656906810994,MATH 193A,A05,093482,Rotar; Vladimir,6,0,34,28
1656906817016,MATH 197,001,091859,McAuley; Julian John,9999,0,9999,0
1656906817016,MATH 197,002,095566,Kedlaya; Kiran S.,9997,0,9999,2
1656906817016,MATH 197,003,095567,Xiao; Ming,9999,0,9999,0
1656906817016,MATH 197,004,095571,Perols; Johan Lars,9998,0,9999,1
1656906824088,COGS 9,A01,083615,Shannon; Kyle Michael,7,0,75,68
1656906830113,COGS 11,A01,083617,Boyle; Mary E. T.,19,0,48,29
1656906836138,COGS 13,A01,083071,Bastos; Amalia Pinkusfeld,8,0,71,63
1656906842162,COGS 14A,A01,092681,Semenuks; Arturs,0,1,100,100
1656906848184,COGS 14B,A01,083073,Cheng; Tzu-Han,5,0,63,58
1656906854212,COGS 17,A01,092677,Semenuks; Arturs,4,0,81,77
1656906860238,COGS 100,A01,083619,Allen; Michael Gordon,15,0,70,55
1656906866261,COGS 101A,A01,083621,Davis; Joshua Daniel,9,0,68,59
1656906872288,COGS 101B,A01,091572,Allen; Michael Gordon,8,0,65,57
1656906878312,COGS 101C,A01,083625,Delgado; Tania,17,0,35,18
1656906884348,COGS 107A,A01,083627,Boyle; Mary E. T.,13,0,60,47
1656906890374,COGS 118A,A01,083075,Gupta; Anjum,15,0,76,61
1656906896402,CSE 3,A50,083646,Miranda; Gregory Joseph,22,0,50,28
1656906902435,CSE 8A,A50,083650,Miranda; Gregory Joseph,17,1,56,39
1656906908458,CSE 11,A01,083080,Cao; Yingjun,4,15,40,36
1656906914482,CSE 12,A01,083652,Krause-Levy; Sophia Louisa,20,1,120,100
1656906920594,CSE 15L,A01,083654,Morris; Justin Loren,8,0,50,42
1656906920594,CSE 15L,A02,083655,Morris; Justin Loren,8,0,50,42
1656906926618,CSE 20,A01,083657,Tran; Khoa Dang,37,0,80,43
1656906932642,CSE 21,A01,095574,Bach; Quang Tran,21,0,48,27
1656906938670,CSE 30,A01,083084,Eldon; John,4,0,80,76
1656906938670,CSE 30,B01,095061,Bhaskar; Nishant,6,0,50,44
1656906944693,CSE 100,A01,083659,Cao; Yingjun,2,4,70,68
1656906950715,CSE 134B,A01,083661,Powell; Thomas Allan,19,0,100,81
1656906956742,CSE 140,A01,083663,Gungor; Onat,14,0,85,71
1656906962769,CSE 140L,A01,083088,Eldon; John,16,0,100,84
1656906968792,CSE 175,A01,083665,Kumar; Rakesh,3,0,25,22
1656906974822,CSE 190,A00,092507,Dubnov; Shlomo,7,0,20,13
1656906980848,ECE 45,A01,083139,Congero; Spencer William,5,0,75,70
1656906986872,ECE 65,A50,083695,Saad; Andrew S,12,0,30,18
1656906986872,ECE 65,A51,095125,Saad; Andrew S,25,0,26,1
1656906992893,ECE 109,A01,091882,Touri; Behrouz,16,0,70,54
1656906998915,ECE 180,A00,083140,Abi Samra; Nicholas Camill,0,0,30,30
1656906998915,ECE 180,B00,083141,Abi Samra; Nicholas Camill,0,0,30,30
1656907004939,MATH 10A,A01,083735,Patchell; Gregory David,1,0,30,29
1656907004939,MATH 10A,A02,083736,Patchell; Gregory David,20,0,30,10
1656907004939,MATH 10A,A03,083737,Patchell; Gregory David,15,0,30,15
1656907010964,MATH 10B,A01,083207,Lim; Seonhee,7,0,34,27
1656907010964,MATH 10B,A02,083208,Lim; Seonhee,9,0,35,26
1656907010964,MATH 10B,A03,093472,Lim; Seonhee,4,0,34,30
1656907010964,MATH 10B,B01,083739,Sinha; Shubham,9,0,30,21
1656907016994,MATH 18,A01,083743,Cinel; Cameron Alexander,6,0,30,24
1656907016994,MATH 18,A02,083744,Cinel; Cameron Alexander,15,0,30,15
1656907016994,MATH 18,A03,083745,Cinel; Cameron Alexander,8,0,30,22
1656907016994,MATH 18,B01,083748,Rideout; David Porter,4,0,37,33
1656907016994,MATH 18,B02,083749,Rideout; David Porter,3,0,36,33
1656907016994,MATH 18,B03,083750,Rideout; David Porter,2,0,37,35
1656907016994,MATH 18,B04,083751,Rideout; David Porter,5,0,36,31
1656907016994,MATH 18,B05,093473,Rideout; David Porter,4,0,36,32
1656907016994,MATH 18,B06,093474,Rideout; David Porter,5,0,36,31
1656907023015,MATH 20A,A01,083754,Zheng; Zequn,12,0,40,28
1656907029039,MATH 20B,A01,083756,Briones; Jor-el Thomas Caparas,1,0,36,35
1656907029039,MATH 20B,A02,083757,Briones; Jor-el Thomas Caparas,1,0,36,35
1656907029039,MATH 20B,A03,093475,Briones; Jor-el Thomas Caparas,0,0,36,36
1656907035063,MATH 20C,A01,083760,Briones; Jor-el Thomas Caparas,1,0,35,34
1656907035063,MATH 20C,A02,083761,Briones; Jor-el Thomas Caparas,8,0,35,27
1656907035063,MATH 20C,A03,093476,Briones; Jor-el Thomas Caparas,0,1,36,36
1656907035063,MATH 20C,B01,083762,Bach; Quang Tran,0,0,30,30
1656907041087,MATH 20D,A01,083765,Tran; Brian Kha,4,0,30,26
1656907041087,MATH 20D,A02,083766,Tran; Brian Kha,4,0,30,26
1656907041087,MATH 20D,A03,083767,Tran; Brian Kha,3,0,30,27
1656907047111,MATH 20E,A01,083771,Ganguly; Soumya,5,0,32,27
1656907047111,MATH 20E,A02,083772,Ganguly; Soumya,6,0,32,26
1656907047111,MATH 20E,B01,083773,Ciotti; Benjamin,18,0,35,17
1656907047111,MATH 20E,B02,083774,Ciotti; Benjamin,17,0,35,18
1656907053139,MATH 103A,A01,083777,Greenfeld; Be'Eri,2,0,36,34
1656907053139,MATH 103A,A02,083778,Greenfeld; Be'Eri,5,0,36,31
1656907053139,MATH 103A,A03,093561,Greenfeld; Be'Eri,4,0,36,32
1656907053139,MATH 103A,B01,083779,Greenfeld; Be'Eri,6,0,36,30
1656907053139,MATH 103A,B02,083780,Greenfeld; Be'Eri,2,0,36,34
1656907053139,MATH 103A,B03,093562,Greenfeld; Be'Eri,2,0,36,34
1656907059166,MATH 105,A01,085443,Carter; Anne Toulson,13,0,35,22
1656907059166,MATH 105,A02,093477,Carter; Anne Toulson,20,0,35,15
1656907065189,MATH 109,A01,083213,Ganzberger; Geoffrey Michael,2,0,34,32
1656907065189,MATH 109,A02,083214,Ganzberger; Geoffrey Michael,2,0,34,32
1656907065189,MATH 109,A03,093478,Ganzberger; Geoffrey Michael,1,0,34,33
1656907065189,MATH 109,B01,083215,Ganzberger; Geoffrey Michael,1,0,32,31
1656907065189,MATH 109,B02,083216,Ganzberger; Geoffrey Michael,1,0,32,31
1656907065189,MATH 109,B03,093479,Ganzberger; Geoffrey Michael,6,0,32,26
1656907071215,MATH 142A,A01,083219,Chow; Bennett,6,0,32,26
1656907071215,MATH 142A,A02,083220,Chow; Bennett,10,0,32,22
1656907071215,MATH 142A,A03,093480,Chow; Bennett,7,0,32,25
1656907071215,MATH 142A,B03,093481,Chow; Bennett,7,0,32,25
1656907071215,MATH 142A,B04,093558,Chow; Bennett,10,0,32,22
1656907071215,MATH 142A,B05,093559,Chow; Bennett,6,0,32,26
1656907077239,MATH 193A,A01,083224,Rotar; Vladimir,7,0,34,27
1656907077239,MATH 193A,A02,083225,Rotar; Vladimir,3,0,34,31
1656907077239,MATH 193A,A03,083781,Rotar; Vladimir,1,0,34,33
1656907077239,MATH 193A,A04,083782,Rotar; Vladimir,6,0,34,28
1656907077239,MATH 193A,A05,093482,Rotar; Vladimir,6,0,34,28
1656907083263,MATH 197,001,091859,McAuley; Julian John,9999,0,9999,0
1656907083263,MATH 197,002,095566,Kedlaya; Kiran S.,9997,0,9999,2
1656907083263,MATH 197,003,095567,Xiao; Ming,9999,0,9999,0
1656907083263,MATH 197,004,095571,Perols; Johan Lars,9998,0,9999,1
1656907090312,COGS 9,A01,083615,Shannon; Kyle Michael,7,0,75,68
1656907096335,COGS 11,A01,083617,Boyle; Mary E. T.,19,0,48,29
1656907102371,COGS 13,A01,083071,Bastos; Amalia Pinkusfeld,8,0,71,63
1656907108395,COGS 14A,A01,092681,Semenuks; Arturs,0,1,100,100
1656907114419,COGS 14B,A01,083073,Cheng; Tzu-Han,5,0,63,58
1656907120445,COGS 17,A01,092677,Semenuks; Arturs,4,0,81,77
1656907126469,COGS 100,A01,083619,Allen; Michael Gordon,15,0,70,55
1656907132496,COGS 101A,A01,083621,Davis; Joshua Daniel,9,0,68,59
1656907138520,COGS 101B,A01,091572,Allen; Michael Gordon,8,0,65,57
1656907144544,COGS 101C,A01,083625,Delgado; Tania,17,0,35,18
1656907150570,COGS 107A,A01,083627,Boyle; Mary E. T.,13,0,60,47
1656907156595,COGS 118A,A01,083075,Gupta; Anjum,15,0,76,61
1656907162622,CSE 3,A50,083646,Miranda; Gregory Joseph,22,0,50,28
1656907168646,CSE 8A,A50,083650,Miranda; Gregory Joseph,17,1,56,39
1656907174681,CSE 11,A01,083080,Cao; Yingjun,4,15,40,36
1656907180705,CSE 12,A01,083652,Krause-Levy; Sophia Louisa,20,1,120,100
1656907186727,CSE 15L,A01,083654,Morris; Justin Loren,8,0,50,42
1656907186727,CSE 15L,A02,083655,Morris; Justin Loren,8,0,50,42
1656907192748,CSE 20,A01,083657,Tran; Khoa Dang,37,0,80,43
1656907198775,CSE 21,A01,095574,Bach; Quang Tran,21,0,48,27
1656907204798,CSE 30,A01,083084,Eldon; John,4,0,80,76
1656907204798,CSE 30,B01,095061,Bhaskar; Nishant,6,0,50,44
1656907210822,CSE 100,A01,083659,Cao; Yingjun,2,4,70,68
1656907216845,CSE 134B,A01,083661,Powell; Thomas Allan,19,0,100,81
1656907222871,CSE 140,A01,083663,Gungor; Onat,14,0,85,71
1656907228898,CSE 140L,A01,083088,Eldon; John,16,0,100,84
1656907234930,CSE 175,A01,083665,Kumar; Rakesh,3,0,25,22
1656907240956,CSE 190,A00,092507,Dubnov; Shlomo,7,0,20,13
1656907246983,ECE 45,A01,083139,Congero; Spencer William,5,0,75,70
1656907253012,ECE 65,A50,083695,Saad; Andrew S,12,0,30,18
1656907253012,ECE 65,A51,095125,Saad; Andrew S,25,0,26,1
1656907259033,ECE 109,A01,091882,Touri; Behrouz,16,0,70,54
1656907265058,ECE 180,A00,083140,Abi Samra; Nicholas Camill,0,0,30,30
1656907265058,ECE 180,B00,083141,Abi Samra; Nicholas Camill,0,0,30,30
1656907271086,MATH 10A,A01,083735,Patchell; Gregory David,1,0,30,29
1656907271086,MATH 10A,A02,083736,Patchell; Gregory David,20,0,30,10
1656907271086,MATH 10A,A03,083737,Patchell; Gregory David,15,0,30,15
1656907277110,MATH 10B,A01,083207,Lim; Seonhee,7,0,34,27
1656907277110,MATH 10B,A02,083208,Lim; Seonhee,9,0,35,26
1656907277110,MATH 10B,A03,093472,Lim; Seonhee,4,0,34,30
1656907277110,MATH 10B,B01,083739,Sinha; Shubham,9,0,30,21
1656907283141,MATH 18,A01,083743,Cinel; Cameron Alexander,6,0,30,24
1656907283141,MATH 18,A02,083744,Cinel; Cameron Alexander,15,0,30,15
1656907283141,MATH 18,A03,083745,Cinel; Cameron Alexander,8,0,30,22
1656907283141,MATH 18,B01,083748,Rideout; David Porter,4,0,37,33
1656907283141,MATH 18,B02,083749,Rideout; David Porter,3,0,36,33
1656907283141,MATH 18,B03,083750,Rideout; David Porter,2,0,37,35
1656907283141,MATH 18,B04,083751,Rideout; David Porter,5,0,36,31
1656907283141,MATH 18,B05,093473,Rideout; David Porter,4,0,36,32
1656907283141,MATH 18,B06,093474,Rideout; David Porter,5,0,36,31
1656907289162,MATH 20A,A01,083754,Zheng; Zequn,12,0,40,28
1656907295185,MATH 20B,A01,083756,Briones; Jor-el Thomas Caparas,1,0,36,35
1656907295185,MATH 20B,A02,083757,Briones; Jor-el Thomas Caparas,1,0,36,35
1656907295185,MATH 20B,A03,093475,Briones; Jor-el Thomas Caparas,0,0,36,36
1656907301208,MATH 20C,A01,083760,Briones; Jor-el Thomas Caparas,1,0,35,34
1656907301208,MATH 20C,A02,083761,Briones; Jor-el Thomas Caparas,8,0,35,27
1656907301208,MATH 20C,A03,093476,Briones; Jor-el Thomas Caparas,0,1,36,36
1656907301208,MATH 20C,B01,083762,Bach; Quang Tran,0,0,30,30
1656907307236,MATH 20D,A01,083765,Tran; Brian Kha,4,0,30,26
1656907307236,MATH 20D,A02,083766,Tran; Brian Kha,4,0,30,26
1656907307236,MATH 20D,A03,083767,Tran; Brian Kha,3,0,30,27
1656907313264,MATH 20E,A01,083771,Ganguly; Soumya,5,0,32,27
1656907313264,MATH 20E,A02,083772,Ganguly; Soumya,6,0,32,26
1656907313264,MATH 20E,B01,083773,Ciotti; Benjamin,18,0,35,17
1656907313264,MATH 20E,B02,083774,Ciotti; Benjamin,17,0,35,18
1656907319293,MATH 103A,A01,083777,Greenfeld; Be'Eri,2,0,36,34
1656907319293,MATH 103A,A02,083778,Greenfeld; Be'Eri,5,0,36,31
1656907319293,MATH 103A,A03,093561,Greenfeld; Be'Eri,4,0,36,32
1656907319293,MATH 103A,B01,083779,Greenfeld; Be'Eri,6,0,36,30
1656907319293,MATH 103A,B02,083780,Greenfeld; Be'Eri,2,0,36,34
1656907319293,MATH 103A,B03,093562,Greenfeld; Be'Eri,2,0,36,34
1656907325316,MATH 105,A01,085443,Carter; Anne Toulson,13,0,35,22
1656907325316,MATH 105,A02,093477,Carter; Anne Toulson,20,0,35,15
1656907331349,MATH 109,A01,083213,Ganzberger; Geoffrey Michael,2,0,34,32
1656907331349,MATH 109,A02,083214,Ganzberger; Geoffrey Michael,2,0,34,32
1656907331349,MATH 109,A03,093478,Ganzberger; Geoffrey Michael,1,0,34,33
1656907331349,MATH 109,B01,083215,Ganzberger; Geoffrey Michael,1,0,32,31
1656907331349,MATH 109,B02,083216,Ganzberger; Geoffrey Michael,1,0,32,31
1656907331349,MATH 109,B03,093479,Ganzberger; Geoffrey Michael,6,0,32,26
1656907337378,MATH 142A,A01,083219,Chow; Bennett,6,0,32,26
1656907337378,MATH 142A,A02,083220,Chow; Bennett,10,0,32,22
1656907337378,MATH 142A,A03,093480,Chow; Bennett,7,0,32,25
1656907337378,MATH 142A,B03,093481,Chow; Bennett,7,0,32,25
1656907337378,MATH 142A,B04,093558,Chow; Bennett,10,0,32,22
1656907337378,MATH 142A,B05,093559,Chow; Bennett,6,0,32,26
1656907343414,MATH 193A,A01,083224,Rotar; Vladimir,7,0,34,27
1656907343414,MATH 193A,A02,083225,Rotar; Vladimir,3,0,34,31
1656907343414,MATH 193A,A03,083781,Rotar; Vladimir,1,0,34,33
1656907343414,MATH 193A,A04,083782,Rotar; Vladimir,6,0,34,28
1656907343414,MATH 193A,A05,093482,Rotar; Vladimir,6,0,34,28
1656907349439,MATH 197,001,091859,McAuley; Julian John,9999,0,9999,0
1656907349439,MATH 197,002,095566,Kedlaya; Kiran S.,9997,0,9999,2
1656907349439,MATH 197,003,095567,Xiao; Ming,9999,0,9999,0
1656907349439,MATH 197,004,095571,Perols; Johan Lars,9998,0,9999,1
1656907356496,COGS 9,A01,083615,Shannon; Kyle Michael,7,0,75,68
1656907362537,COGS 11,A01,083617,Boyle; Mary E. T.,19,0,48,29
1656907368563,COGS 13,A01,083071,Bastos; Amalia Pinkusfeld,8,0,71,63
1656907374587,COGS 14A,A01,092681,Semenuks; Arturs,0,1,100,100
1656907380613,COGS 14B,A01,083073,Cheng; Tzu-Han,5,0,63,58
1656907386640,COGS 17,A01,092677,Semenuks; Arturs,4,0,81,77
1656907392665,COGS 100,A01,083619,Allen; Michael Gordon,15,0,70,55
1656907398687,COGS 101A,A01,083621,Davis; Joshua Daniel,9,0,68,59
1656907404711,COGS 101B,A01,091572,Allen; Michael Gordon,8,0,65,57
1656907410736,COGS 101C,A01,083625,Delgado; Tania,17,0,35,18
1656907416759,COGS 107A,A01,083627,Boyle; Mary E. T.,13,0,60,47
1656907422787,COGS 118A,A01,083075,Gupta; Anjum,15,0,76,61
1656907428816,CSE 3,A50,083646,Miranda; Gregory Joseph,22,0,50,28
1656907434854,CSE 8A,A50,083650,Miranda; Gregory Joseph,17,1,56,39
1656907440877,CSE 11,A01,083080,Cao; Yingjun,4,15,40,36
1656907446904,CSE 12,A01,083652,Krause-Levy; Sophia Louisa,20,1,120,100
1656907452939,CSE 15L,A01,083654,Morris; Justin Loren,8,0,50,42
1656907452939,CSE 15L,A02,083655,Morris; Justin Loren,8,0,50,42
1656907458967,CSE 20,A01,083657,Tran; Khoa Dang,37,0,80,43
1656907464991,CSE 21,A01,095574,Bach; Quang Tran,21,0,48,27
1656907471014,CSE 30,A01,083084,Eldon; John,4,0,80,76
1656907471014,CSE 30,B01,095061,Bhaskar; Nishant,6,0,50,44
1656907477037,CSE 100,A01,083659,Cao; Yingjun,2,4,70,68
1656907483063,CSE 134B,A01,083661,Powell; Thomas Allan,19,0,100,81
1656907489085,CSE 140,A01,083663,Gungor; Onat,14,0,85,71
1656907495116,CSE 140L,A01,083088,Eldon; John,16,0,100,84
1656907501140,CSE 175,A01,083665,Kumar; Rakesh,3,0,25,22
1656907507166,CSE 190,A00,092507,Dubnov; Shlomo,7,0,20,13
1656907513189,ECE 45,A01,083139,Congero; Spencer William,5,0,75,70
1656907519308,ECE 65,A50,083695,Saad; Andrew S,12,0,30,18
1656907519308,ECE 65,A51,095125,Saad; Andrew S,25,0,26,1
1656907525331,ECE 109,A01,091882,Touri; Behrouz,16,0,70,54
1656907531353,ECE 180,A00,083140,Abi Samra; Nicholas Camill,0,0,30,30
1656907531353,ECE 180,B00,083141,Abi Samra; Nicholas Camill,0,0,30,30
1656907537381,MATH 10A,A01,083735,Patchell; Gregory David,1,0,30,29
1656907537381,MATH 10A,A02,083736,Patchell; Gregory David,20,0,30,10
1656907537381,MATH 10A,A03,083737,Patchell; Gregory David,15,0,30,15
1656907543409,MATH 10B,A01,083207,Lim; Seonhee,7,0,34,27
1656907543409,MATH 10B,A02,083208,Lim; Seonhee,9,0,35,26
1656907543409,MATH 10B,A03,093472,Lim; Seonhee,4,0,34,30
1656907543409,MATH 10B,B01,083739,Sinha; Shubham,9,0,30,21
1656907549440,MATH 18,A01,083743,Cinel; Cameron Alexander,6,0,30,24
1656907549440,MATH 18,A02,083744,Cinel; Cameron Alexander,15,0,30,15
1656907549440,MATH 18,A03,083745,Cinel; Cameron Alexander,8,0,30,22
1656907549440,MATH 18,B01,083748,Rideout; David Porter,4,0,37,33
1656907549440,MATH 18,B02,083749,Rideout; David Porter,3,0,36,33
1656907549440,MATH 18,B03,083750,Rideout; David Porter,2,0,37,35
1656907549440,MATH 18,B04,083751,Rideout; David Porter,5,0,36,31
1656907549440,MATH 18,B05,093473,Rideout; David Porter,4,0,36,32
1656907549440,MATH 18,B06,093474,Rideout; David Porter,5,0,36,31
1656907555467,MATH 20A,A01,083754,Zheng; Zequn,12,0,40,28
1656907561489,MATH 20B,A01,083756,Briones; Jor-el Thomas Caparas,1,0,36,35
1656907561489,MATH 20B,A02,083757,Briones; Jor-el Thomas Caparas,1,0,36,35
1656907561489,MATH 20B,A03,093475,Briones; Jor-el Thomas Caparas,0,0,36,36
1656907567518,MATH 20C,A01,083760,Briones; Jor-el Thomas Caparas,1,0,35,34
1656907567518,MATH 20C,A02,083761,Briones; Jor-el Thomas Caparas,8,0,35,27
1656907567518,MATH 20C,A03,093476,Briones; Jor-el Thomas Caparas,0,1,36,36
1656907567518,MATH 20C,B01,083762,Bach; Quang Tran,0,0,30,30
1656907573544,MATH 20D,A01,083765,Tran; Brian Kha,4,0,30,26
1656907573544,MATH 20D,A02,083766,Tran; Brian Kha,4,0,30,26
1656907573544,MATH 20D,A03,083767,Tran; Brian Kha,3,0,30,27
1656907579572,MATH 20E,A01,083771,Ganguly; Soumya,5,0,32,27
1656907579572,MATH 20E,A02,083772,Ganguly; Soumya,6,0,32,26
1656907579572,MATH 20E,B01,083773,Ciotti; Benjamin,18,0,35,17
1656907579572,MATH 20E,B02,083774,Ciotti; Benjamin,17,0,35,18
1656907585616,MATH 103A,A01,083777,Greenfeld; Be'Eri,2,0,36,34
1656907585616,MATH 103A,A02,083778,Greenfeld; Be'Eri,5,0,36,31
1656907585616,MATH 103A,A03,093561,Greenfeld; Be'Eri,4,0,36,32
1656907585616,MATH 103A,B01,083779,Greenfeld; Be'Eri,6,0,36,30
1656907585616,MATH 103A,B02,083780,Greenfeld; Be'Eri,2,0,36,34
1656907585616,MATH 103A,B03,093562,Greenfeld; Be'Eri,2,0,36,34
1656907591641,MATH 105,A01,085443,Carter; Anne Toulson,13,0,35,22
1656907591641,MATH 105,A02,093477,Carter; Anne Toulson,20,0,35,15
1656907597662,MATH 109,A01,083213,Ganzberger; Geoffrey Michael,2,0,34,32
1656907597662,MATH 109,A02,083214,Ganzberger; Geoffrey Michael,2,0,34,32
1656907597662,MATH 109,A03,093478,Ganzberger; Geoffrey Michael,1,0,34,33
1656907597662,MATH 109,B01,083215,Ganzberger; Geoffrey Michael,1,0,32,31
1656907597662,MATH 109,B02,083216,Ganzberger; Geoffrey Michael,1,0,32,31
1656907597662,MATH 109,B03,093479,Ganzberger; Geoffrey Michael,6,0,32,26
1656907603702,MATH 142A,A01,083219,Chow; Bennett,6,0,32,26
1656907603702,MATH 142A,A02,083220,Chow; Bennett,10,0,32,22
1656907603702,MATH 142A,A03,093480,Chow; Bennett,7,0,32,25
1656907603702,MATH 142A,B03,093481,Chow; Bennett,7,0,32,25
1656907603702,MATH 142A,B04,093558,Chow; Bennett,10,0,32,22
1656907603702,MATH 142A,B05,093559,Chow; Bennett,6,0,32,26
1656907609724,MATH 193A,A01,083224,Rotar; Vladimir,7,0,34,27
1656907609724,MATH 193A,A02,083225,Rotar; Vladimir,3,0,34,31
1656907609724,MATH 193A,A03,083781,Rotar; Vladimir,1,0,34,33
1656907609724,MATH 193A,A04,083782,Rotar; Vladimir,6,0,34,28
1656907609724,MATH 193A,A05,093482,Rotar; Vladimir,6,0,34,28
1656907615749,MATH 197,001,091859,McAuley; Julian John,9999,0,9999,0
1656907615749,MATH 197,002,095566,Kedlaya; Kiran S.,9997,0,9999,2
1656907615749,MATH 197,003,095567,Xiao; Ming,9999,0,9999,0
1656907615749,MATH 197,004,095571,Perols; Johan Lars,9998,0,9999,1
1656907622829,COGS 9,A01,083615,Shannon; Kyle Michael,7,0,75,68
1656907628864,COGS 11,A01,083617,Boyle; Mary E. T.,19,0,48,29
1656907634887,COGS 13,A01,083071,Bastos; Amalia Pinkusfeld,8,0,71,63
1656907640913,COGS 14A,A01,092681,Semenuks; Arturs,0,1,100,100
1656907646946,COGS 14B,A01,083073,Cheng; Tzu-Han,5,0,63,58
1656907652970,COGS 17,A01,092677,Semenuks; Arturs,4,0,81,77
1656907658997,COGS 100,A01,083619,Allen; Michael Gordon,15,0,70,55
1656907665022,COGS 101A,A01,083621,Davis; Joshua Daniel,9,0,68,59
1656907671046,COGS 101B,A01,091572,Allen; Michael Gordon,8,0,65,57
1656907677069,COGS 101C,A01,083625,Delgado; Tania,17,0,35,18
1656907683097,COGS 107A,A01,083627,Boyle; Mary E. T.,13,0,60,47
1656907689119,COGS 118A,A01,083075,Gupta; Anjum,15,0,76,61
1656907695153,CSE 3,A50,083646,Miranda; Gregory Joseph,22,0,50,28
1656907701178,CSE 8A,A50,083650,Miranda; Gregory Joseph,17,1,56,39
1656907707204,CSE 11,A01,083080,Cao; Yingjun,4,15,40,36
1656907713230,CSE 12,A01,083652,Krause-Levy; Sophia Louisa,20,1,120,100
1656907719264,CSE 15L,A01,083654,Morris; Justin Loren,8,0,50,42
1656907719264,CSE 15L,A02,083655,Morris; Justin Loren,8,0,50,42
1656907725288,CSE 20,A01,083657,Tran; Khoa Dang,37,0,80,43
1656907731314,CSE 21,A01,095574,Bach; Quang Tran,21,0,48,27
1656907737337,CSE 30,A01,083084,Eldon; John,4,0,80,76
1656907737337,CSE 30,B01,095061,Bhaskar; Nishant,6,0,50,44
1656907743361,CSE 100,A01,083659,Cao; Yingjun,2,4,70,68
1656907749382,CSE 134B,A01,083661,Powell; Thomas Allan,19,0,100,81
1656907755414,CSE 140,A01,083663,Gungor; Onat,14,0,85,71
1656907761436,CSE 140L,A01,083088,Eldon; John,16,0,100,84
1656907767460,CSE 175,A01,083665,Kumar; Rakesh,3,0,25,22
1656907773483,CSE 190,A00,092507,Dubnov; Shlomo,7,0,20,13
1656907779514,ECE 45,A01,083139,Congero; Spencer William,5,0,75,70
1656907785538,ECE 65,A50,083695,Saad; Andrew S,12,0,30,18
1656907785538,ECE 65,A51,095125,Saad; Andrew S,25,0,26,1
1656907791567,ECE 109,A01,091882,Touri; Behrouz,16,0,70,54
1656907797591,ECE 180,A00,083140,Abi Samra; Nicholas Camill,0,0,30,30
1656907797591,ECE 180,B00,083141,Abi Samra; Nicholas Camill,0,0,30,30
1656907803614,MATH 10A,A01,083735,Patchell; Gregory David,1,0,30,29
1656907803614,MATH 10A,A02,083736,Patchell; Gregory David,20,0,30,10
1656907803614,MATH 10A,A03,083737,Patchell; Gregory David,15,0,30,15
1656907809647,MATH 10B,A01,083207,Lim; Seonhee,7,0,34,27
1656907809647,MATH 10B,A02,083208,Lim; Seonhee,9,0,35,26
1656907809647,MATH 10B,A03,093472,Lim; Seonhee,4,0,34,30
1656907809647,MATH 10B,B01,083739,Sinha; Shubham,9,0,30,21
1656907815671,MATH 18,A01,083743,Cinel; Cameron Alexander,6,0,30,24
1656907815671,MATH 18,A02,083744,Cinel; Cameron Alexander,15,0,30,15
1656907815671,MATH 18,A03,083745,Cinel; Cameron Alexander,8,0,30,22
1656907815671,MATH 18,B01,083748,Rideout; David Porter,4,0,37,33
1656907815671,MATH 18,B02,083749,Rideout; David Porter,3,0,36,33
1656907815671,MATH 18,B03,083750,Rideout; David Porter,2,0,37,35
1656907815671,MATH 18,B04,083751,Rideout; David Porter,5,0,36,31
1656907815671,MATH 18,B05,093473,Rideout; David Porter,4,0,36,32
1656907815671,MATH 18,B06,093474,Rideout; David Porter,5,0,36,31
1656907821695,MATH 20A,A01,083754,Zheng; Zequn,12,0,40,28
1656907827719,MATH 20B,A01,083756,Briones; Jor-el Thomas Caparas,1,0,36,35
1656907827719,MATH 20B,A02,083757,Briones; Jor-el Thomas Caparas,1,0,36,35
1656907827719,MATH 20B,A03,093475,Briones; Jor-el Thomas Caparas,0,0,36,36
1656907833750,MATH 20C,A01,083760,Briones; Jor-el Thomas Caparas,1,0,35,34
1656907833750,MATH 20C,A02,083761,Briones; Jor-el Thomas Caparas,8,0,35,27
1656907833750,MATH 20C,A03,093476,Briones; Jor-el Thomas Caparas,0,1,36,36
1656907833750,MATH 20C,B01,083762,Bach; Quang Tran,0,0,30,30
1656907839778,MATH 20D,A01,083765,Tran; Brian Kha,4,0,30,26
1656907839778,MATH 20D,A02,083766,Tran; Brian Kha,4,0,30,26
1656907839778,MATH 20D,A03,083767,Tran; Brian Kha,3,0,30,27
1656907845822,MATH 20E,A01,083771,Ganguly; Soumya,5,0,32,27
1656907845822,MATH 20E,A02,083772,Ganguly; Soumya,6,0,32,26
1656907845822,MATH 20E,B01,083773,Ciotti; Benjamin,18,0,35,17
1656907845822,MATH 20E,B02,083774,Ciotti; Benjamin,17,0,35,18
1656907851850,MATH 103A,A01,083777,Greenfeld; Be'Eri,2,0,36,34
1656907851850,MATH 103A,A02,083778,Greenfeld; Be'Eri,5,0,36,31
1656907851850,MATH 103A,A03,093561,Greenfeld; Be'Eri,4,0,36,32
1656907851850,MATH 103A,B01,083779,Greenfeld; Be'Eri,6,0,36,30
1656907851850,MATH 103A,B02,083780,Greenfeld; Be'Eri,2,0,36,34
1656907851850,MATH 103A,B03,093562,Greenfeld; Be'Eri,2,0,36,34
1656907857880,MATH 105,A01,085443,Carter; Anne Toulson,13,0,35,22
1656907857880,MATH 105,A02,093477,Carter; Anne Toulson,20,0,35,15
1656907863905,MATH 109,A01,083213,Ganzberger; Geoffrey Michael,2,0,34,32
1656907863905,MATH 109,A02,083214,Ganzberger; Geoffrey Michael,2,0,34,32
1656907863905,MATH 109,A03,093478,Ganzberger; Geoffrey Michael,1,0,34,33
1656907863905,MATH 109,B01,083215,Ganzberger; Geoffrey Michael,1,0,32,31
1656907863905,MATH 109,B02,083216,Ganzberger; Geoffrey Michael,1,0,32,31
1656907863905,MATH 109,B03,093479,Ganzberger; Geoffrey Michael,6,0,32,26
1656907869938,MATH 142A,A01,083219,Chow; Bennett,6,0,32,26
1656907869938,MATH 142A,A02,083220,Chow; Bennett,10,0,32,22
1656907869938,MATH 142A,A03,093480,Chow; Bennett,7,0,32,25
1656907869938,MATH 142A,B03,093481,Chow; Bennett,7,0,32,25
1656907869938,MATH 142A,B04,093558,Chow; Bennett,10,0,32,22
1656907869938,MATH 142A,B05,093559,Chow; Bennett,6,0,32,26
1656907875962,MATH 193A,A01,083224,Rotar; Vladimir,7,0,34,27
1656907875962,MATH 193A,A02,083225,Rotar; Vladimir,3,0,34,31
1656907875962,MATH 193A,A03,083781,Rotar; Vladimir,1,0,34,33
1656907875962,MATH 193A,A04,083782,Rotar; Vladimir,6,0,34,28
1656907875962,MATH 193A,A05,093482,Rotar; Vladimir,6,0,34,28
1656907881988,MATH 197,001,091859,McAuley; Julian John,9999,0,9999,0
1656907881988,MATH 197,002,095566,Kedlaya; Kiran S.,9997,0,9999,2
1656907881988,MATH 197,003,095567,Xiao; Ming,9999,0,9999,0
1656907881988,MATH 197,004,095571,Perols; Johan Lars,9998,0,9999,1
1656907889054,COGS 9,A01,083615,Shannon; Kyle Michael,7,0,75,68
1656907895082,COGS 11,A01,083617,Boyle; Mary E. T.,19,0,48,29
1656907901111,COGS 13,A01,083071,Bastos; Amalia Pinkusfeld,8,0,71,63
1656907907134,COGS 14A,A01,092681,Semenuks; Arturs,0,1,100,100
1656907913161,COGS 14B,A01,083073,Cheng; Tzu-Han,5,0,63,58
1656907919185,COGS 17,A01,092677,Semenuks; Arturs,4,0,81,77
1656907925208,COGS 100,A01,083619,Allen; Michael Gordon,15,0,70,55
1656907931232,COGS 101A,A01,083621,Davis; Joshua Daniel,9,0,68,59
1656907937256,COGS 101B,A01,091572,Allen; Michael Gordon,8,0,65,57
1656907943279,COGS 101C,A01,083625,Delgado; Tania,17,0,35,18
1656907949303,COGS 107A,A01,083627,Boyle; Mary E. T.,13,0,60,47
1656907955327,COGS 118A,A01,083075,Gupta; Anjum,15,0,76,61
1656907961358,CSE 3,A50,083646,Miranda; Gregory Joseph,22,0,50,28
1656907967381,CSE 8A,A50,083650,Miranda; Gregory Joseph,17,1,56,39
1656907973411,CSE 11,A01,083080,Cao; Yingjun,4,15,40,36
1656907979439,CSE 12,A01,083652,Krause-Levy; Sophia Louisa,20,1,120,100
1656907985465,CSE 15L,A01,083654,Morris; Justin Loren,8,0,50,42
1656907985465,CSE 15L,A02,083655,Morris; Justin Loren,8,0,50,42
1656907991499,CSE 20,A01,083657,Tran; Khoa Dang,37,0,80,43
1656907997521,CSE 21,A01,095574,Bach; Quang Tran,21,0,48,27
1656908003549,CSE 30,A01,083084,Eldon; John,4,0,80,76
1656908003549,CSE 30,B01,095061,Bhaskar; Nishant,6,0,50,44
1656908009575,CSE 100,A01,083659,Cao; Yingjun,2,4,70,68
1656908015603,CSE 134B,A01,083661,Powell; Thomas Allan,19,0,100,81
1656908021625,CSE 140,A01,083663,Gungor; Onat,14,0,85,71
1656908027648,CSE 140L,A01,083088,Eldon; John,16,0,100,84
1656908033674,CSE 175,A01,083665,Kumar; Rakesh,3,0,25,22
1656908039695,CSE 190,A00,092507,Dubnov; Shlomo,7,0,20,13
1656908045719,ECE 45,A01,083139,Congero; Spencer William,5,0,75,70
1656908051740,ECE 65,A50,083695,Saad; Andrew S,12,0,30,18
1656908051740,ECE 65,A51,095125,Saad; Andrew S,25,0,26,1
1656908057764,ECE 109,A01,091882,Touri; Behrouz,16,0,70,54
1656908063787,ECE 180,A00,083140,Abi Samra; Nicholas Camill,0,0,30,30
1656908063787,ECE 180,B00,083141,Abi Samra; Nicholas Camill,0,0,30,30
1656908069811,MATH 10A,A01,083735,Patchell; Gregory David,1,0,30,29
1656908069811,MATH 10A,A02,083736,Patchell; Gregory David,20,0,30,10
1656908069811,MATH 10A,A03,083737,Patchell; Gregory David,15,0,30,15
1656908075834,MATH 10B,A01,083207,Lim; Seonhee,7,0,34,27
1656908075834,MATH 10B,A02,083208,Lim; Seonhee,9,0,35,26
1656908075834,MATH 10B,A03,093472,Lim; Seonhee,4,0,34,30
1656908075834,MATH 10B,B01,083739,Sinha; Shubham,9,0,30,21
1656908081864,MATH 18,A01,083743,Cinel; Cameron Alexander,6,0,30,24
1656908081864,MATH 18,A02,083744,Cinel; Cameron Alexander,15,0,30,15
1656908081864,MATH 18,A03,083745,Cinel; Cameron Alexander,8,0,30,22
1656908081864,MATH 18,B01,083748,Rideout; David Porter,4,0,37,33
1656908081864,MATH 18,B02,083749,Rideout; David Porter,3,0,36,33
1656908081864,MATH 18,B03,083750,Rideout; David Porter,2,0,37,35
1656908081864,MATH 18,B04,083751,Rideout; David Porter,5,0,36,31
1656908081864,MATH 18,B05,093473,Rideout; David Porter,4,0,36,32
1656908081864,MATH 18,B06,093474,Rideout; David Porter,5,0,36,31
1656908087888,MATH 20A,A01,083754,Zheng; Zequn,12,0,40,28
1656908093916,MATH 20B,A01,083756,Briones; Jor-el Thomas Caparas,1,0,36,35
1656908093916,MATH 20B,A02,083757,Briones; Jor-el Thomas Caparas,1,0,36,35
1656908093916,MATH 20B,A03,093475,Briones; Jor-el Thomas Caparas,0,0,36,36
1656908099939,MATH 20C,A01,083760,Briones; Jor-el Thomas Caparas,1,0,35,34
1656908099939,MATH 20C,A02,083761,Briones; Jor-el Thomas Caparas,8,0,35,27
1656908099939,MATH 20C,A03,093476,Briones; Jor-el Thomas Caparas,0,1,36,36
1656908099939,MATH 20C,B01,083762,Bach; Quang Tran,0,0,30,30
1656908105968,MATH 20D,A01,083765,Tran; Brian Kha,4,0,30,26
1656908105968,MATH 20D,A02,083766,Tran; Brian Kha,4,0,30,26
1656908105968,MATH 20D,A03,083767,Tran; Brian Kha,3,0,30,27
1656908111997,MATH 20E,A01,083771,Ganguly; Soumya,5,0,32,27
1656908111997,MATH 20E,A02,083772,Ganguly; Soumya,6,0,32,26
1656908111997,MATH 20E,B01,083773,Ciotti; Benjamin,18,0,35,17
1656908111997,MATH 20E,B02,083774,Ciotti; Benjamin,17,0,35,18
1656908118093,MATH 103A,A01,083777,Greenfeld; Be'Eri,2,0,36,34
1656908118093,MATH 103A,A02,083778,Greenfeld; Be'Eri,5,0,36,31
1656908118093,MATH 103A,A03,093561,Greenfeld; Be'Eri,4,0,36,32
1656908118093,MATH 103A,B01,083779,Greenfeld; Be'Eri,6,0,36,30
1656908118093,MATH 103A,B02,083780,Greenfeld; Be'Eri,2,0,36,34
1656908118093,MATH 103A,B03,093562,Greenfeld; Be'Eri,2,0,36,34
1656908124116,MATH 105,A01,085443,Carter; Anne Toulson,13,0,35,22
1656908124116,MATH 105,A02,093477,Carter; Anne Toulson,20,0,35,15
1656908130150,MATH 109,A01,083213,Ganzberger; Geoffrey Michael,2,0,34,32
1656908130150,MATH 109,A02,083214,Ganzberger; Geoffrey Michael,2,0,34,32
1656908130150,MATH 109,A03,093478,Ganzberger; Geoffrey Michael,1,0,34,33
1656908130150,MATH 109,B01,083215,Ganzberger; Geoffrey Michael,1,0,32,31
1656908130150,MATH 109,B02,083216,Ganzberger; Geoffrey Michael,1,0,32,31
1656908130150,MATH 109,B03,093479,Ganzberger; Geoffrey Michael,6,0,32,26
1656908136182,MATH 142A,A01,083219,Chow; Bennett,6,0,32,26
1656908136182,MATH 142A,A02,083220,Chow; Bennett,10,0,32,22
1656908136182,MATH 142A,A03,093480,Chow; Bennett,7,0,32,25
1656908136182,MATH 142A,B03,093481,Chow; Bennett,7,0,32,25
1656908136182,MATH 142A,B04,093558,Chow; Bennett,10,0,32,22
1656908136182,MATH 142A,B05,093559,Chow; Bennett,6,0,32,26
1656908142205,MATH 193A,A01,083224,Rotar; Vladimir,7,0,34,27
1656908142205,MATH 193A,A02,083225,Rotar; Vladimir,3,0,34,31
1656908142205,MATH 193A,A03,083781,Rotar; Vladimir,1,0,34,33
1656908142205,MATH 193A,A04,083782,Rotar; Vladimir,6,0,34,28
1656908142205,MATH 193A,A05,093482,Rotar; Vladimir,6,0,34,28
1656908148231,MATH 197,001,091859,McAuley; Julian John,9999,0,9999,0
1656908148231,MATH 197,002,095566,Kedlaya; Kiran S.,9997,0,9999,2
1656908148231,MATH 197,003,095567,Xiao; Ming,9999,0,9999,0
1656908148231,MATH 197,004,095571,Perols; Johan Lars,9998,0,9999,1
1656908155293,COGS 9,A01,083615,Shannon; Kyle Michael,7,0,75,68
1656908161316,COGS 11,A01,083617,Boyle; Mary E. T.,19,0,48,29
1656908167340,COGS 13,A01,083071,Bastos; Amalia Pinkusfeld,8,0,71,63
1656908173363,COGS 14A,A01,092681,Semenuks; Arturs,0,1,100,100
1656908179386,COGS 14B,A01,083073,Cheng; Tzu-Han,5,0,63,58
1656908185426,COGS 17,A01,092677,Semenuks; Arturs,4,0,81,77
1656908191450,COGS 100,A01,083619,Allen; Michael Gordon,15,0,70,55
1656908197477,COGS 101A,A01,083621,Davis; Joshua Daniel,9,0,68,59
1656908203503,COGS 101B,A01,091572,Allen; Michael Gordon,8,0,65,57
1656908209530,COGS 101C,A01,083625,Delgado; Tania,17,0,35,18
1656908215551,COGS 107A,A01,083627,Boyle; Mary E. T.,13,0,60,47
1656908221576,COGS 118A,A01,083075,Gupta; Anjum,15,0,76,61
1656908227599,CSE 3,A50,083646,Miranda; Gregory Joseph,22,0,50,28
1656908233622,CSE 8A,A50,083650,Miranda; Gregory Joseph,17,1,56,39
1656908239646,CSE 11,A01,083080,Cao; Yingjun,4,15,40,36
1656908245672,CSE 12,A01,083652,Krause-Levy; Sophia Louisa,20,1,120,100
1656908251696,CSE 15L,A01,083654,Morris; Justin Loren,8,0,50,42
1656908251696,CSE 15L,A02,083655,Morris; Justin Loren,8,0,50,42
1656908257718,CSE 20,A01,083657,Tran; Khoa Dang,37,0,80,43
1656908263740,CSE 21,A01,095574,Bach; Quang Tran,21,0,48,27
1656908269767,CSE 30,A01,083084,Eldon; John,4,0,80,76
1656908269767,CSE 30,B01,095061,Bhaskar; Nishant,6,0,50,44
1656908275793,CSE 100,A01,083659,Cao; Yingjun,2,4,70,68
1656908281822,CSE 134B,A01,083661,Powell; Thomas Allan,19,0,100,81
1656908287844,CSE 140,A01,083663,Gungor; Onat,14,0,85,71
1656908293868,CSE 140L,A01,083088,Eldon; John,16,0,100,84
1656908299894,CSE 175,A01,083665,Kumar; Rakesh,3,0,25,22
1656908305919,CSE 190,A00,092507,Dubnov; Shlomo,7,0,20,13
1656908311946,ECE 45,A01,083139,Congero; Spencer William,5,0,75,70
1656908317974,ECE 65,A50,083695,Saad; Andrew S,12,0,30,18
1656908317974,ECE 65,A51,095125,Saad; Andrew S,25,0,26,1
1656908324001,ECE 109,A01,091882,Touri; Behrouz,16,0,70,54
1656908330026,ECE 180,A00,083140,Abi Samra; Nicholas Camill,0,0,30,30
1656908330026,ECE 180,B00,083141,Abi Samra; Nicholas Camill,0,0,30,30
1656908336050,MATH 10A,A01,083735,Patchell; Gregory David,1,0,30,29
1656908336050,MATH 10A,A02,083736,Patchell; Gregory David,20,0,30,10
1656908336050,MATH 10A,A03,083737,Patchell; Gregory David,15,0,30,15
1656908342073,MATH 10B,A01,083207,Lim; Seonhee,7,0,34,27
1656908342073,MATH 10B,A02,083208,Lim; Seonhee,9,0,35,26
1656908342073,MATH 10B,A03,093472,Lim; Seonhee,4,0,34,30
1656908342073,MATH 10B,B01,083739,Sinha; Shubham,9,0,30,21
1656908348098,MATH 18,A01,083743,Cinel; Cameron Alexander,6,0,30,24
1656908348098,MATH 18,A02,083744,Cinel; Cameron Alexander,15,0,30,15
1656908348098,MATH 18,A03,083745,Cinel; Cameron Alexander,8,0,30,22
1656908348098,MATH 18,B01,083748,Rideout; David Porter,4,0,37,33
1656908348098,MATH 18,B02,083749,Rideout; David Porter,3,0,36,33
1656908348098,MATH 18,B03,083750,Rideout; David Porter,2,0,37,35
1656908348098,MATH 18,B04,083751,Rideout; David Porter,5,0,36,31
1656908348098,MATH 18,B05,093473,Rideout; David Porter,4,0,36,32
1656908348098,MATH 18,B06,093474,Rideout; David Porter,5,0,36,31
1656908354126,MATH 20A,A01,083754,Zheng; Zequn,12,0,40,28
1656908360153,MATH 20B,A01,083756,Briones; Jor-el Thomas Caparas,1,0,36,35
1656908360153,MATH 20B,A02,083757,Briones; Jor-el Thomas Caparas,1,0,36,35
1656908360153,MATH 20B,A03,093475,Briones; Jor-el Thomas Caparas,0,0,36,36
1656908366174,MATH 20C,A01,083760,Briones; Jor-el Thomas Caparas,1,0,35,34
1656908366174,MATH 20C,A02,083761,Briones; Jor-el Thomas Caparas,8,0,35,27
1656908366174,MATH 20C,A03,093476,Briones; Jor-el Thomas Caparas,0,1,36,36
1656908366174,MATH 20C,B01,083762,Bach; Quang Tran,0,0,30,30
1656908372198,MATH 20D,A01,083765,Tran; Brian Kha,4,0,30,26
1656908372198,MATH 20D,A02,083766,Tran; Brian Kha,4,0,30,26
1656908372198,MATH 20D,A03,083767,Tran; Brian Kha,3,0,30,27
1656908378219,MATH 20E,A01,083771,Ganguly; Soumya,5,0,32,27
1656908378219,MATH 20E,A02,083772,Ganguly; Soumya,6,0,32,26
1656908378219,MATH 20E,B01,083773,Ciotti; Benjamin,18,0,35,17
1656908378219,MATH 20E,B02,083774,Ciotti; Benjamin,17,0,35,18
1656908384249,MATH 103A,A01,083777,Greenfeld; Be'Eri,2,0,36,34
1656908384249,MATH 103A,A02,083778,Greenfeld; Be'Eri,5,0,36,31
1656908384249,MATH 103A,A03,093561,Greenfeld; Be'Eri,4,0,36,32
1656908384249,MATH 103A,B01,083779,Greenfeld; Be'Eri,6,0,36,30
1656908384249,MATH 103A,B02,083780,Greenfeld; Be'Eri,2,0,36,34
1656908384249,MATH 103A,B03,093562,Greenfeld; Be'Eri,2,0,36,34
1656908390277,MATH 105,A01,085443,Carter; Anne Toulson,13,0,35,22
1656908390277,MATH 105,A02,093477,Carter; Anne Toulson,20,0,35,15
1656908396306,MATH 109,A01,083213,Ganzberger; Geoffrey Michael,2,0,34,32
1656908396306,MATH 109,A02,083214,Ganzberger; Geoffrey Michael,2,0,34,32
1656908396306,MATH 109,A03,093478,Ganzberger; Geoffrey Michael,1,0,34,33
1656908396306,MATH 109,B01,083215,Ganzberger; Geoffrey Michael,1,0,32,31
1656908396306,MATH 109,B02,083216,Ganzberger; Geoffrey Michael,1,0,32,31
1656908396306,MATH 109,B03,093479,Ganzberger; Geoffrey Michael,6,0,32,26
1656908402329,MATH 142A,A01,083219,Chow; Bennett,6,0,32,26
1656908402329,MATH 142A,A02,083220,Chow; Bennett,10,0,32,22
1656908402329,MATH 142A,A03,093480,Chow; Bennett,7,0,32,25
1656908402329,MATH 142A,B03,093481,Chow; Bennett,7,0,32,25
1656908402329,MATH 142A,B04,093558,Chow; Bennett,10,0,32,22
1656908402329,MATH 142A,B05,093559,Chow; Bennett,6,0,32,26
1656908408358,MATH 193A,A01,083224,Rotar; Vladimir,7,0,34,27
1656908408358,MATH 193A,A02,083225,Rotar; Vladimir,3,0,34,31
1656908408358,MATH 193A,A03,083781,Rotar; Vladimir,1,0,34,33
1656908408358,MATH 193A,A04,083782,Rotar; Vladimir,6,0,34,28
1656908408358,MATH 193A,A05,093482,Rotar; Vladimir,6,0,34,28
1656908414382,MATH 197,001,091859,McAuley; Julian John,9999,0,9999,0
1656908414382,MATH 197,002,095566,Kedlaya; Kiran S.,9997,0,9999,2
1656908414382,MATH 197,003,095567,Xiao; Ming,9999,0,9999,0
1656908414382,MATH 197,004,095571,Perols; Johan Lars,9998,0,9999,1
1656908421434,COGS 9,A01,083615,Shannon; Kyle Michael,7,0,75,68
1656908427459,COGS 11,A01,083617,Boyle; Mary E. T.,19,0,48,29
1656908433485,COGS 13,A01,083071,Bastos; Amalia Pinkusfeld,8,0,71,63
1656908439511,COGS 14A,A01,092681,Semenuks; Arturs,0,1,100,100
1656908445534,COGS 14B,A01,083073,Cheng; Tzu-Han,5,0,63,58
1656908451557,COGS 17,A01,092677,Semenuks; Arturs,4,0,81,77
1656908457580,COGS 100,A01,083619,Allen; Michael Gordon,15,0,70,55
1656908463611,COGS 101A,A01,083621,Davis; Joshua Daniel,9,0,68,59
1656908469634,COGS 101B,A01,091572,Allen; Michael Gordon,8,0,65,57
1656908475657,COGS 101C,A01,083625,Delgado; Tania,17,0,35,18
1656908481683,COGS 107A,A01,083627,Boyle; Mary E. T.,13,0,60,47
1656908487712,COGS 118A,A01,083075,Gupta; Anjum,15,0,76,61
1656908493737,CSE 3,A50,083646,Miranda; Gregory Joseph,22,0,50,28
1656908499759,CSE 8A,A50,083650,Miranda; Gregory Joseph,17,1,56,39
1656908505782,CSE 11,A01,083080,Cao; Yingjun,4,15,40,36
1656908511807,CSE 12,A01,083652,Krause-Levy; Sophia Louisa,20,1,120,100
1656908517832,CSE 15L,A01,083654,Morris; Justin Loren,8,0,50,42
1656908517832,CSE 15L,A02,083655,Morris; Justin Loren,8,0,50,42
1656908523857,CSE 20,A01,083657,Tran; Khoa Dang,37,0,80,43
1656908529879,CSE 21,A01,095574,Bach; Quang Tran,21,0,48,27
1656908535903,CSE 30,A01,083084,Eldon; John,4,0,80,76
1656908535903,CSE 30,B01,095061,Bhaskar; Nishant,6,0,50,44
1656908541925,CSE 100,A01,083659,Cao; Yingjun,2,4,70,68
1656908547949,CSE 134B,A01,083661,Powell; Thomas Allan,19,0,100,81
1656908553973,CSE 140,A01,083663,Gungor; Onat,14,0,85,71
1656908560004,CSE 140L,A01,083088,Eldon; John,16,0,100,84
1656908566028,CSE 175,A01,083665,Kumar; Rakesh,3,0,25,22
1656908572054,CSE 190,A00,092507,Dubnov; Shlomo,7,0,20,13
1656908578077,ECE 45,A01,083139,Congero; Spencer William,5,0,75,70
1656908584102,ECE 65,A50,083695,Saad; Andrew S,12,0,30,18
1656908584102,ECE 65,A51,095125,Saad; Andrew S,25,0,26,1
1656908590128,ECE 109,A01,091882,Touri; Behrouz,16,0,70,54
1656908596152,ECE 180,A00,083140,Abi Samra; Nicholas Camill,0,0,30,30
1656908596152,ECE 180,B00,083141,Abi Samra; Nicholas Camill,0,0,30,30
1656908602180,MATH 10A,A01,083735,Patchell; Gregory David,1,0,30,29
1656908602180,MATH 10A,A02,083736,Patchell; Gregory David,20,0,30,10
1656908602180,MATH 10A,A03,083737,Patchell; Gregory David,15,0,30,15
1656908608209,MATH 10B,A01,083207,Lim; Seonhee,7,0,34,27
1656908608209,MATH 10B,A02,083208,Lim; Seonhee,9,0,35,26
1656908608209,MATH 10B,A03,093472,Lim; Seonhee,4,0,34,30
1656908608209,MATH 10B,B01,083739,Sinha; Shubham,9,0,30,21
1656908614237,MATH 18,A01,083743,Cinel; Cameron Alexander,6,0,30,24
1656908614237,MATH 18,A02,083744,Cinel; Cameron Alexander,15,0,30,15
1656908614237,MATH 18,A03,083745,Cinel; Cameron Alexander,8,0,30,22
1656908614237,MATH 18,B01,083748,Rideout; David Porter,4,0,37,33
1656908614237,MATH 18,B02,083749,Rideout; David Porter,3,0,36,33
1656908614237,MATH 18,B03,083750,Rideout; David Porter,2,0,37,35
1656908614237,MATH 18,B04,083751,Rideout; David Porter,5,0,36,31
1656908614237,MATH 18,B05,093473,Rideout; David Porter,4,0,36,32
1656908614237,MATH 18,B06,093474,Rideout; David Porter,5,0,36,31
1656908620274,MATH 20A,A01,083754,Zheng; Zequn,12,0,40,28
1656908626298,MATH 20B,A01,083756,Briones; Jor-el Thomas Caparas,1,0,36,35
1656908626298,MATH 20B,A02,083757,Briones; Jor-el Thomas Caparas,1,0,36,35
1656908626298,MATH 20B,A03,093475,Briones; Jor-el Thomas Caparas,0,0,36,36
1656908632326,MATH 20C,A01,083760,Briones; Jor-el Thomas Caparas,1,0,35,34
1656908632326,MATH 20C,A02,083761,Briones; Jor-el Thomas Caparas,8,0,35,27
1656908632326,MATH 20C,A03,093476,Briones; Jor-el Thomas Caparas,0,1,36,36
1656908632326,MATH 20C,B01,083762,Bach; Quang Tran,0,0,30,30
1656908638354,MATH 20D,A01,083765,Tran; Brian Kha,4,0,30,26
1656908638354,MATH 20D,A02,083766,Tran; Brian Kha,4,0,30,26
1656908638354,MATH 20D,A03,083767,Tran; Brian Kha,3,0,30,27
1656908644388,MATH 20E,A01,083771,Ganguly; Soumya,5,0,32,27
1656908644388,MATH 20E,A02,083772,Ganguly; Soumya,6,0,32,26
1656908644388,MATH 20E,B01,083773,Ciotti; Benjamin,18,0,35,17
1656908644388,MATH 20E,B02,083774,Ciotti; Benjamin,17,0,35,18
1656908650412,MATH 103A,A01,083777,Greenfeld; Be'Eri,2,0,36,34
1656908650412,MATH 103A,A02,083778,Greenfeld; Be'Eri,5,0,36,31
1656908650412,MATH 103A,A03,093561,Greenfeld; Be'Eri,4,0,36,32
1656908650412,MATH 103A,B01,083779,Greenfeld; Be'Eri,6,0,36,30
1656908650412,MATH 103A,B02,083780,Greenfeld; Be'Eri,2,0,36,34
1656908650412,MATH 103A,B03,093562,Greenfeld; Be'Eri,2,0,36,34
1656908656437,MATH 105,A01,085443,Carter; Anne Toulson,13,0,35,22
1656908656437,MATH 105,A02,093477,Carter; Anne Toulson,20,0,35,15
1656908662465,MATH 109,A01,083213,Ganzberger; Geoffrey Michael,2,0,34,32
1656908662465,MATH 109,A02,083214,Ganzberger; Geoffrey Michael,2,0,34,32
1656908662465,MATH 109,A03,093478,Ganzberger; Geoffrey Michael,1,0,34,33
1656908662465,MATH 109,B01,083215,Ganzberger; Geoffrey Michael,1,0,32,31
1656908662465,MATH 109,B02,083216,Ganzberger; Geoffrey Michael,1,0,32,31
1656908662465,MATH 109,B03,093479,Ganzberger; Geoffrey Michael,6,0,32,26
1656908668491,MATH 142A,A01,083219,Chow; Bennett,6,0,32,26
1656908668491,MATH 142A,A02,083220,Chow; Bennett,10,0,32,22
1656908668491,MATH 142A,A03,093480,Chow; Bennett,7,0,32,25
1656908668491,MATH 142A,B03,093481,Chow; Bennett,7,0,32,25
1656908668491,MATH 142A,B04,093558,Chow; Bennett,10,0,32,22
1656908668491,MATH 142A,B05,093559,Chow; Bennett,6,0,32,26
1656908674528,MATH 193A,A01,083224,Rotar; Vladimir,7,0,34,27
1656908674528,MATH 193A,A02,083225,Rotar; Vladimir,3,0,34,31
1656908674528,MATH 193A,A03,083781,Rotar; Vladimir,1,0,34,33
1656908674528,MATH 193A,A04,083782,Rotar; Vladimir,6,0,34,28
1656908674528,MATH 193A,A05,093482,Rotar; Vladimir,6,0,34,28
1656908680561,MATH 197,001,091859,McAuley; Julian John,9999,0,9999,0
1656908680561,MATH 197,002,095566,Kedlaya; Kiran S.,9997,0,9999,2
1656908680561,MATH 197,003,095567,Xiao; Ming,9999,0,9999,0
1656908680561,MATH 197,004,095571,Perols; Johan Lars,9998,0,9999,1
1656908687616,COGS 9,A01,083615,Shannon; Kyle Michael,7,0,75,68
1656908693640,COGS 11,A01,083617,Boyle; Mary E. T.,19,0,48,29
1656908699664,COGS 13,A01,083071,Bastos; Amalia Pinkusfeld,8,0,71,63
1656908705696,COGS 14A,A01,092681,Semenuks; Arturs,0,1,100,100
1656908711795,COGS 14B,A01,083073,Cheng; Tzu-Han,5,0,63,58
1656908717830,COGS 17,A01,092677,Semenuks; Arturs,4,0,81,77
1656908723853,COGS 100,A01,083619,Allen; Michael Gordon,15,0,70,55
1656908729882,COGS 101A,A01,083621,Davis; Joshua Daniel,9,0,68,59
1656908735905,COGS 101B,A01,091572,Allen; Michael Gordon,8,0,65,57
1656908741929,COGS 101C,A01,083625,Delgado; Tania,17,0,35,18
1656908747952,COGS 107A,A01,083627,Boyle; Mary E. T.,13,0,60,47
1656908753976,COGS 118A,A01,083075,Gupta; Anjum,15,0,76,61
1656908760007,CSE 3,A50,083646,Miranda; Gregory Joseph,22,0,50,28
1656908766031,CSE 8A,A50,083650,Miranda; Gregory Joseph,17,1,56,39
1656908772055,CSE 11,A01,083080,Cao; Yingjun,4,15,40,36
1656908778078,CSE 12,A01,083652,Krause-Levy; Sophia Louisa,20,1,120,100
1656908784103,CSE 15L,A01,083654,Morris; Justin Loren,8,0,50,42
1656908784103,CSE 15L,A02,083655,Morris; Justin Loren,8,0,50,42
1656908790131,CSE 20,A01,083657,Tran; Khoa Dang,37,0,80,43
1656908796154,CSE 21,A01,095574,Bach; Quang Tran,21,0,48,27
1656908802176,CSE 30,A01,083084,Eldon; John,4,0,80,76
1656908802176,CSE 30,B01,095061,Bhaskar; Nishant,6,0,50,44
1656908808198,CSE 100,A01,083659,Cao; Yingjun,2,4,70,68
1656908814224,CSE 134B,A01,083661,Powell; Thomas Allan,19,0,100,81
1656908820247,CSE 140,A01,083663,Gungor; Onat,14,0,85,71
1656908826271,CSE 140L,A01,083088,Eldon; John,16,0,100,84
1656908832296,CSE 175,A01,083665,Kumar; Rakesh,3,0,25,22
1656908838322,CSE 190,A00,092507,Dubnov; Shlomo,7,0,20,13
1656908844350,ECE 45,A01,083139,Congero; Spencer William,5,0,75,70
1656908850376,ECE 65,A50,083695,Saad; Andrew S,12,0,30,18
1656908850376,ECE 65,A51,095125,Saad; Andrew S,25,0,26,1
1656908856404,ECE 109,A01,091882,Touri; Behrouz,16,0,70,54
1656908862427,ECE 180,A00,083140,Abi Samra; Nicholas Camill,0,0,30,30
1656908862427,ECE 180,B00,083141,Abi Samra; Nicholas Camill,0,0,30,30
1656908868450,MATH 10A,A01,083735,Patchell; Gregory David,1,0,30,29
1656908868450,MATH 10A,A02,083736,Patchell; Gregory David,20,0,30,10
1656908868450,MATH 10A,A03,083737,Patchell; Gregory David,15,0,30,15
1656908874479,MATH 10B,A01,083207,Lim; Seonhee,7,0,34,27
1656908874479,MATH 10B,A02,083208,Lim; Seonhee,9,0,35,26
1656908874479,MATH 10B,A03,093472,Lim; Seonhee,4,0,34,30
1656908874479,MATH 10B,B01,083739,Sinha; Shubham,9,0,30,21
1656908880505,MATH 18,A01,083743,Cinel; Cameron Alexander,6,0,30,24
1656908880505,MATH 18,A02,083744,Cinel; Cameron Alexander,15,0,30,15
1656908880505,MATH 18,A03,083745,Cinel; Cameron Alexander,8,0,30,22
1656908880505,MATH 18,B01,083748,Rideout; David Porter,4,0,37,33
1656908880505,MATH 18,B02,083749,Rideout; David Porter,3,0,36,33
1656908880505,MATH 18,B03,083750,Rideout; David Porter,2,0,37,35
1656908880505,MATH 18,B04,083751,Rideout; David Porter,5,0,36,31
1656908880505,MATH 18,B05,093473,Rideout; David Porter,4,0,36,32
1656908880505,MATH 18,B06,093474,Rideout; David Porter,5,0,36,31
1656908886531,MATH 20A,A01,083754,Zheng; Zequn,12,0,40,28
1656908892555,MATH 20B,A01,083756,Briones; Jor-el Thomas Caparas,1,0,36,35
1656908892555,MATH 20B,A02,083757,Briones; Jor-el Thomas Caparas,1,0,36,35
1656908892555,MATH 20B,A03,093475,Briones; Jor-el Thomas Caparas,0,0,36,36
1656908898584,MATH 20C,A01,083760,Briones; Jor-el Thomas Caparas,1,0,35,34
1656908898584,MATH 20C,A02,083761,Briones; Jor-el Thomas Caparas,8,0,35,27
1656908898584,MATH 20C,A03,093476,Briones; Jor-el Thomas Caparas,0,1,36,36
1656908898584,MATH 20C,B01,083762,Bach; Quang Tran,0,0,30,30
1656908904607,MATH 20D,A01,083765,Tran; Brian Kha,4,0,30,26
1656908904607,MATH 20D,A02,083766,Tran; Brian Kha,4,0,30,26
1656908904607,MATH 20D,A03,083767,Tran; Brian Kha,3,0,30,27
1656908910634,MATH 20E,A01,083771,Ganguly; Soumya,5,0,32,27
1656908910634,MATH 20E,A02,083772,Ganguly; Soumya,6,0,32,26
1656908910634,MATH 20E,B01,083773,Ciotti; Benjamin,18,0,35,17
1656908910634,MATH 20E,B02,083774,Ciotti; Benjamin,17,0,35,18
1656908916658,MATH 103A,A01,083777,Greenfeld; Be'Eri,2,0,36,34
1656908916658,MATH 103A,A02,083778,Greenfeld; Be'Eri,5,0,36,31
1656908916658,MATH 103A,A03,093561,Greenfeld; Be'Eri,4,0,36,32
1656908916658,MATH 103A,B01,083779,Greenfeld; Be'Eri,6,0,36,30
1656908916658,MATH 103A,B02,083780,Greenfeld; Be'Eri,2,0,36,34
1656908916658,MATH 103A,B03,093562,Greenfeld; Be'Eri,2,0,36,34
1656908922686,MATH 105,A01,085443,Carter; Anne Toulson,13,0,35,22
1656908922686,MATH 105,A02,093477,Carter; Anne Toulson,20,0,35,15
1656908928710,MATH 109,A01,083213,Ganzberger; Geoffrey Michael,2,0,34,32
1656908928710,MATH 109,A02,083214,Ganzberger; Geoffrey Michael,2,0,34,32
1656908928710,MATH 109,A03,093478,Ganzberger; Geoffrey Michael,1,0,34,33
1656908928710,MATH 109,B01,083215,Ganzberger; Geoffrey Michael,1,0,32,31
1656908928710,MATH 109,B02,083216,Ganzberger; Geoffrey Michael,1,0,32,31
1656908928710,MATH 109,B03,093479,Ganzberger; Geoffrey Michael,6,0,32,26
1656908934735,MATH 142A,A01,083219,Chow; Bennett,6,0,32,26
1656908934735,MATH 142A,A02,083220,Chow; Bennett,10,0,32,22
1656908934735,MATH 142A,A03,093480,Chow; Bennett,7,0,32,25
1656908934735,MATH 142A,B03,093481,Chow; Bennett,7,0,32,25
1656908934735,MATH 142A,B04,093558,Chow; Bennett,10,0,32,22
1656908934735,MATH 142A,B05,093559,Chow; Bennett,6,0,32,26
1656908940758,MATH 193A,A01,083224,Rotar; Vladimir,7,0,34,27
1656908940758,MATH 193A,A02,083225,Rotar; Vladimir,3,0,34,31
1656908940758,MATH 193A,A03,083781,Rotar; Vladimir,1,0,34,33
1656908940758,MATH 193A,A04,083782,Rotar; Vladimir,6,0,34,28
1656908940758,MATH 193A,A05,093482,Rotar; Vladimir,6,0,34,28
1656908946785,MATH 197,001,091859,McAuley; Julian John,9999,0,9999,0
1656908946785,MATH 197,002,095566,Kedlaya; Kiran S.,9997,0,9999,2
1656908946785,MATH 197,003,095567,Xiao; Ming,9999,0,9999,0
1656908946785,MATH 197,004,095571,Perols; Johan Lars,9998,0,9999,1
1656908953842,COGS 9,A01,083615,Shannon; Kyle Michael,7,0,75,68
1656908959866,COGS 11,A01,083617,Boyle; Mary E. T.,19,0,48,29
1656908965895,COGS 13,A01,083071,Bastos; Amalia Pinkusfeld,8,0,71,63
1656908971917,COGS 14A,A01,092681,Semenuks; Arturs,0,1,100,100
1656908977943,COGS 14B,A01,083073,Cheng; Tzu-Han,5,0,63,58
1656908983967,COGS 17,A01,092677,Semenuks; Arturs,4,0,81,77
1656908989993,COGS 100,A01,083619,Allen; Michael Gordon,15,0,70,55
1656908996017,COGS 101A,A01,083621,Davis; Joshua Daniel,9,0,68,59
1656909002041,COGS 101B,A01,091572,Allen; Michael Gordon,8,0,65,57
1656909008067,COGS 101C,A01,083625,Delgado; Tania,17,0,35,18
1656909014091,COGS 107A,A01,083627,Boyle; Mary E. T.,13,0,60,47
1656909020120,COGS 118A,A01,083075,Gupta; Anjum,15,0,76,61
1656909026147,CSE 3,A50,083646,Miranda; Gregory Joseph,22,0,50,28
1656909032175,CSE 8A,A50,083650,Miranda; Gregory Joseph,17,1,56,39
1656909038200,CSE 11,A01,083080,Cao; Yingjun,4,15,40,36
1656909044223,CSE 12,A01,083652,Krause-Levy; Sophia Louisa,20,1,120,100
1656909050245,CSE 15L,A01,083654,Morris; Justin Loren,8,0,50,42
1656909050245,CSE 15L,A02,083655,Morris; Justin Loren,8,0,50,42
1656909056268,CSE 20,A01,083657,Tran; Khoa Dang,37,0,80,43
1656909062290,CSE 21,A01,095574,Bach; Quang Tran,21,0,48,27
1656909068314,CSE 30,A01,083084,Eldon; John,4,0,80,76
1656909068314,CSE 30,B01,095061,Bhaskar; Nishant,6,0,50,44
1656909074338,CSE 100,A01,083659,Cao; Yingjun,2,4,70,68
1656909080360,CSE 134B,A01,083661,Powell; Thomas Allan,19,0,100,81
1656909086383,CSE 140,A01,083663,Gungor; Onat,14,0,85,71
1656909092408,CSE 140L,A01,083088,Eldon; John,16,0,100,84
1656909098435,CSE 175,A01,083665,Kumar; Rakesh,3,0,25,22
1656909104462,CSE 190,A00,092507,Dubnov; Shlomo,7,0,20,13
1656909110485,ECE 45,A01,083139,Congero; Spencer William,5,0,75,70
1656909116514,ECE 65,A50,083695,Saad; Andrew S,12,0,30,18
1656909116514,ECE 65,A51,095125,Saad; Andrew S,25,0,26,1
1656909122551,ECE 109,A01,091882,Touri; Behrouz,16,0,70,54
1656909128573,ECE 180,A00,083140,Abi Samra; Nicholas Camill,0,0,30,30
1656909128573,ECE 180,B00,083141,Abi Samra; Nicholas Camill,0,0,30,30
1656909134597,MATH 10A,A01,083735,Patchell; Gregory David,1,0,30,29
1656909134597,MATH 10A,A02,083736,Patchell; Gregory David,20,0,30,10
1656909134597,MATH 10A,A03,083737,Patchell; Gregory David,15,0,30,15
1656909140622,MATH 10B,A01,083207,Lim; Seonhee,7,0,34,27
1656909140622,MATH 10B,A02,083208,Lim; Seonhee,9,0,35,26
1656909140622,MATH 10B,A03,093472,Lim; Seonhee,4,0,34,30
1656909140622,MATH 10B,B01,083739,Sinha; Shubham,9,0,30,21
1656909146655,MATH 18,A01,083743,Cinel; Cameron Alexander,6,0,30,24
1656909146655,MATH 18,A02,083744,Cinel; Cameron Alexander,15,0,30,15
1656909146655,MATH 18,A03,083745,Cinel; Cameron Alexander,8,0,30,22
1656909146655,MATH 18,B01,083748,Rideout; David Porter,4,0,37,33
1656909146655,MATH 18,B02,083749,Rideout; David Porter,3,0,36,33
1656909146655,MATH 18,B03,083750,Rideout; David Porter,2,0,37,35
1656909146655,MATH 18,B04,083751,Rideout; David Porter,5,0,36,31
1656909146655,MATH 18,B05,093473,Rideout; David Porter,4,0,36,32
1656909146655,MATH 18,B06,093474,Rideout; David Porter,5,0,36,31
1656909152681,MATH 20A,A01,083754,Zheng; Zequn,12,0,40,28
1656909158709,MATH 20B,A01,083756,Briones; Jor-el Thomas Caparas,1,0,36,35
1656909158709,MATH 20B,A02,083757,Briones; Jor-el Thomas Caparas,1,0,36,35
1656909158709,MATH 20B,A03,093475,Briones; Jor-el Thomas Caparas,0,0,36,36
1656909164732,MATH 20C,A01,083760,Briones; Jor-el Thomas Caparas,1,0,35,34
1656909164732,MATH 20C,A02,083761,Briones; Jor-el Thomas Caparas,8,0,35,27
1656909164732,MATH 20C,A03,093476,Briones; Jor-el Thomas Caparas,0,1,36,36
1656909164732,MATH 20C,B01,083762,Bach; Quang Tran,0,0,30,30
1656909170756,MATH 20D,A01,083765,Tran; Brian Kha,4,0,30,26
1656909170756,MATH 20D,A02,083766,Tran; Brian Kha,4,0,30,26
1656909170756,MATH 20D,A03,083767,Tran; Brian Kha,3,0,30,27
1656909176780,MATH 20E,A01,083771,Ganguly; Soumya,5,0,32,27
1656909176780,MATH 20E,A02,083772,Ganguly; Soumya,6,0,32,26
1656909176780,MATH 20E,B01,083773,Ciotti; Benjamin,18,0,35,17
1656909176780,MATH 20E,B02,083774,Ciotti; Benjamin,17,0,35,18
1656909182810,MATH 103A,A01,083777,Greenfeld; Be'Eri,2,0,36,34
1656909182810,MATH 103A,A02,083778,Greenfeld; Be'Eri,5,0,36,31
1656909182810,MATH 103A,A03,093561,Greenfeld; Be'Eri,4,0,36,32
1656909182810,MATH 103A,B01,083779,Greenfeld; Be'Eri,6,0,36,30
1656909182810,MATH 103A,B02,083780,Greenfeld; Be'Eri,2,0,36,34
1656909182810,MATH 103A,B03,093562,Greenfeld; Be'Eri,2,0,36,34
1656909188835,MATH 105,A01,085443,Carter; Anne Toulson,13,0,35,22
1656909188835,MATH 105,A02,093477,Carter; Anne Toulson,20,0,35,15
1656909194857,MATH 109,A01,083213,Ganzberger; Geoffrey Michael,2,0,34,32
1656909194857,MATH 109,A02,083214,Ganzberger; Geoffrey Michael,2,0,34,32
1656909194857,MATH 109,A03,093478,Ganzberger; Geoffrey Michael,1,0,34,33
1656909194857,MATH 109,B01,083215,Ganzberger; Geoffrey Michael,1,0,32,31
1656909194857,MATH 109,B02,083216,Ganzberger; Geoffrey Michael,1,0,32,31
1656909194857,MATH 109,B03,093479,Ganzberger; Geoffrey Michael,6,0,32,26
1656909200880,MATH 142A,A01,083219,Chow; Bennett,6,0,32,26
1656909200880,MATH 142A,A02,083220,Chow; Bennett,10,0,32,22
1656909200880,MATH 142A,A03,093480,Chow; Bennett,7,0,32,25
1656909200880,MATH 142A,B03,093481,Chow; Bennett,7,0,32,25
1656909200880,MATH 142A,B04,093558,Chow; Bennett,10,0,32,22
1656909200880,MATH 142A,B05,093559,Chow; Bennett,6,0,32,26
1656909206916,MATH 193A,A01,083224,Rotar; Vladimir,7,0,34,27
1656909206916,MATH 193A,A02,083225,Rotar; Vladimir,3,0,34,31
1656909206916,MATH 193A,A03,083781,Rotar; Vladimir,1,0,34,33
1656909206916,MATH 193A,A04,083782,Rotar; Vladimir,6,0,34,28
1656909206916,MATH 193A,A05,093482,Rotar; Vladimir,6,0,34,28
1656909212942,MATH 197,001,091859,McAuley; Julian John,9999,0,9999,0
1656909212942,MATH 197,002,095566,Kedlaya; Kiran S.,9997,0,9999,2
1656909212942,MATH 197,003,095567,Xiao; Ming,9999,0,9999,0
1656909212942,MATH 197,004,095571,Perols; Johan Lars,9998,0,9999,1
1656909219997,COGS 9,A01,083615,Shannon; Kyle Michael,7,0,75,68
1656909226020,COGS 11,A01,083617,Boyle; Mary E. T.,19,0,48,29
1656909232043,COGS 13,A01,083071,Bastos; Amalia Pinkusfeld,8,0,71,63
1656909238065,COGS 14A,A01,092681,Semenuks; Arturs,0,1,100,100
1656909244095,COGS 14B,A01,083073,Cheng; Tzu-Han,5,0,63,58
1656909250121,COGS 17,A01,092677,Semenuks; Arturs,4,0,81,77
1656909256142,COGS 100,A01,083619,Allen; Michael Gordon,15,0,70,55
1656909262163,COGS 101A,A01,083621,Davis; Joshua Daniel,9,0,68,59
1656909268186,COGS 101B,A01,091572,Allen; Michael Gordon,8,0,65,57
1656909274214,COGS 101C,A01,083625,Delgado; Tania,17,0,35,18
1656909280237,COGS 107A,A01,083627,Boyle; Mary E. T.,13,0,60,47
1656909286260,COGS 118A,A01,083075,Gupta; Anjum,15,0,76,61
1656909292287,CSE 3,A50,083646,Miranda; Gregory Joseph,22,0,50,28
1656909298309,CSE 8A,A50,083650,Miranda; Gregory Joseph,17,1,56,39
1656909304336,CSE 11,A01,083080,Cao; Yingjun,4,15,40,36
1656909310432,CSE 12,A01,083652,Krause-Levy; Sophia Louisa,20,1,120,100
1656909316455,CSE 15L,A01,083654,Morris; Justin Loren,8,0,50,42
1656909316455,CSE 15L,A02,083655,Morris; Justin Loren,8,0,50,42
1656909322495,CSE 20,A01,083657,Tran; Khoa Dang,37,0,80,43
1656909328518,CSE 21,A01,095574,Bach; Quang Tran,21,0,48,27
1656909334541,CSE 30,A01,083084,Eldon; John,4,0,80,76
1656909334541,CSE 30,B01,095061,Bhaskar; Nishant,6,0,50,44
1656909340570,CSE 100,A01,083659,Cao; Yingjun,2,4,70,68
1656909346596,CSE 134B,A01,083661,Powell; Thomas Allan,19,0,100,81
1656909352621,CSE 140,A01,083663,Gungor; Onat,14,0,85,71
1656909358647,CSE 140L,A01,083088,Eldon; John,16,0,100,84
1656909364675,CSE 175,A01,083665,Kumar; Rakesh,3,0,25,22
1656909370697,CSE 190,A00,092507,Dubnov; Shlomo,7,0,20,13
1656909376725,ECE 45,A01,083139,Congero; Spencer William,5,0,75,70
1656909382751,ECE 65,A50,083695,Saad; Andrew S,12,0,30,18
1656909382751,ECE 65,A51,095125,Saad; Andrew S,25,0,26,1
1656909388787,ECE 109,A01,091882,Touri; Behrouz,16,0,70,54
1656909394813,ECE 180,A00,083140,Abi Samra; Nicholas Camill,0,0,30,30
1656909394813,ECE 180,B00,083141,Abi Samra; Nicholas Camill,0,0,30,30
1656909400842,MATH 10A,A01,083735,Patchell; Gregory David,1,0,30,29
1656909400842,MATH 10A,A02,083736,Patchell; Gregory David,20,0,30,10
1656909400842,MATH 10A,A03,083737,Patchell; Gregory David,15,0,30,15
1656909406866,MATH 10B,A01,083207,Lim; Seonhee,7,0,34,27
1656909406866,MATH 10B,A02,083208,Lim; Seonhee,9,0,35,26
1656909406866,MATH 10B,A03,093472,Lim; Seonhee,4,0,34,30
1656909406866,MATH 10B,B01,083739,Sinha; Shubham,9,0,30,21
1656909412894,MATH 18,A01,083743,Cinel; Cameron Alexander,6,0,30,24
1656909412894,MATH 18,A02,083744,Cinel; Cameron Alexander,15,0,30,15
1656909412894,MATH 18,A03,083745,Cinel; Cameron Alexander,8,0,30,22
1656909412894,MATH 18,B01,083748,Rideout; David Porter,4,0,37,33
1656909412894,MATH 18,B02,083749,Rideout; David Porter,3,0,36,33
1656909412894,MATH 18,B03,083750,Rideout; David Porter,2,0,37,35
1656909412894,MATH 18,B04,083751,Rideout; David Porter,5,0,36,31
1656909412894,MATH 18,B05,093473,Rideout; David Porter,4,0,36,32
1656909412894,MATH 18,B06,093474,Rideout; David Porter,5,0,36,31
1656909418921,MATH 20A,A01,083754,Zheng; Zequn,12,0,40,28
1656909424949,MATH 20B,A01,083756,Briones; Jor-el Thomas Caparas,1,0,36,35
1656909424949,MATH 20B,A02,083757,Briones; Jor-el Thomas Caparas,1,0,36,35
1656909424949,MATH 20B,A03,093475,Briones; Jor-el Thomas Caparas,0,0,36,36
1656909430972,MATH 20C,A01,083760,Briones; Jor-el Thomas Caparas,1,0,35,34
1656909430972,MATH 20C,A02,083761,Briones; Jor-el Thomas Caparas,8,0,35,27
1656909430972,MATH 20C,A03,093476,Briones; Jor-el Thomas Caparas,0,1,36,36
1656909430972,MATH 20C,B01,083762,Bach; Quang Tran,0,0,30,30
1656909436996,MATH 20D,A01,083765,Tran; Brian Kha,4,0,30,26
1656909436996,MATH 20D,A02,083766,Tran; Brian Kha,4,0,30,26
1656909436996,MATH 20D,A03,083767,Tran; Brian Kha,3,0,30,27
1656909443020,MATH 20E,A01,083771,Ganguly; Soumya,5,0,32,27
1656909443020,MATH 20E,A02,083772,Ganguly; Soumya,6,0,32,26
1656909443020,MATH 20E,B01,083773,Ciotti; Benjamin,18,0,35,17
1656909443020,MATH 20E,B02,083774,Ciotti; Benjamin,17,0,35,18
1656909463040,MATH 103A,A01,083777,Greenfeld; Be'Eri,2,0,36,34
1656909463040,MATH 103A,A02,083778,Greenfeld; Be'Eri,5,0,36,31
1656909463040,MATH 103A,A03,093561,Greenfeld; Be'Eri,4,0,36,32
1656909463040,MATH 103A,B01,083779,Greenfeld; Be'Eri,6,0,36,30
1656909463040,MATH 103A,B02,083780,Greenfeld; Be'Eri,2,0,36,34
1656909463040,MATH 103A,B03,093562,Greenfeld; Be'Eri,2,0,36,34
1656909469062,MATH 105,A01,085443,Carter; Anne Toulson,13,0,35,22
1656909469062,MATH 105,A02,093477,Carter; Anne Toulson,20,0,35,15
1656909475092,MATH 109,A01,083213,Ganzberger; Geoffrey Michael,2,0,34,32
1656909475092,MATH 109,A02,083214,Ganzberger; Geoffrey Michael,2,0,34,32
1656909475092,MATH 109,A03,093478,Ganzberger; Geoffrey Michael,1,0,34,33
1656909475092,MATH 109,B01,083215,Ganzberger; Geoffrey Michael,1,0,32,31
1656909475092,MATH 109,B02,083216,Ganzberger; Geoffrey Michael,1,0,32,31
1656909475092,MATH 109,B03,093479,Ganzberger; Geoffrey Michael,6,0,32,26
1656909481122,MATH 142A,A01,083219,Chow; Bennett,6,0,32,26
1656909481122,MATH 142A,A02,083220,Chow; Bennett,10,0,32,22
1656909481122,MATH 142A,A03,093480,Chow; Bennett,7,0,32,25
1656909481122,MATH 142A,B03,093481,Chow; Bennett,7,0,32,25
1656909481122,MATH 142A,B04,093558,Chow; Bennett,10,0,32,22
1656909481122,MATH 142A,B05,093559,Chow; Bennett,6,0,32,26
1656909487160,MATH 193A,A01,083224,Rotar; Vladimir,7,0,34,27
1656909487160,MATH 193A,A02,083225,Rotar; Vladimir,3,0,34,31
1656909487160,MATH 193A,A03,083781,Rotar; Vladimir,1,0,34,33
1656909487160,MATH 193A,A04,083782,Rotar; Vladimir,6,0,34,28
1656909487160,MATH 193A,A05,093482,Rotar; Vladimir,6,0,34,28
1656909493183,MATH 197,001,091859,McAuley; Julian John,9999,0,9999,0
1656909493183,MATH 197,002,095566,Kedlaya; Kiran S.,9997,0,9999,2
1656909493183,MATH 197,003,095567,Xiao; Ming,9999,0,9999,0
1656909493183,MATH 197,004,095571,Perols; Johan Lars,9998,0,9999,1
1656909500246,COGS 9,A01,083615,Shannon; Kyle Michael,7,0,75,68
1656909506268,COGS 11,A01,083617,Boyle; Mary E. T.,19,0,48,29
1656909512295,COGS 13,A01,083071,Bastos; Amalia Pinkusfeld,9,0,71,62
1656909518318,COGS 14A,A01,092681,Semenuks; Arturs,0,1,100,100
1656909524340,COGS 14B,A01,083073,Cheng; Tzu-Han,5,0,63,58
1656909530363,COGS 17,A01,092677,Semenuks; Arturs,4,0,81,77
1656909536390,COGS 100,A01,083619,Allen; Michael Gordon,15,0,70,55
1656909542419,COGS 101A,A01,083621,Davis; Joshua Daniel,9,0,68,59
1656909548444,COGS 101B,A01,091572,Allen; Michael Gordon,8,0,65,57
1656909554468,COGS 101C,A01,083625,Delgado; Tania,17,0,35,18
1656909560495,COGS 107A,A01,083627,Boyle; Mary E. T.,13,0,60,47
1656909566522,COGS 118A,A01,083075,Gupta; Anjum,15,0,76,61
1656909572544,CSE 3,A50,083646,Miranda; Gregory Joseph,22,0,50,28
1656909578566,CSE 8A,A50,083650,Miranda; Gregory Joseph,17,1,56,39
1656909584591,CSE 11,A01,083080,Cao; Yingjun,4,15,40,36
1656909590613,CSE 12,A01,083652,Krause-Levy; Sophia Louisa,20,1,120,100
1656909596635,CSE 15L,A01,083654,Morris; Justin Loren,8,0,50,42
1656909596635,CSE 15L,A02,083655,Morris; Justin Loren,8,0,50,42
1656909602664,CSE 20,A01,083657,Tran; Khoa Dang,37,0,80,43
1656909608690,CSE 21,A01,095574,Bach; Quang Tran,21,0,48,27
1656909614717,CSE 30,A01,083084,Eldon; John,4,0,80,76
1656909614717,CSE 30,B01,095061,Bhaskar; Nishant,6,0,50,44
1656909620739,CSE 100,A01,083659,Cao; Yingjun,2,4,70,68
1656909626762,CSE 134B,A01,083661,Powell; Thomas Allan,19,0,100,81
1656909632789,CSE 140,A01,083663,Gungor; Onat,14,0,85,71
1656909638816,CSE 140L,A01,083088,Eldon; John,16,0,100,84
1656909644841,CSE 175,A01,083665,Kumar; Rakesh,3,0,25,22
1656909650866,CSE 190,A00,092507,Dubnov; Shlomo,7,0,20,13
1656909656893,ECE 45,A01,083139,Congero; Spencer William,5,0,75,70
1656909662916,ECE 65,A50,083695,Saad; Andrew S,12,0,30,18
1656909662916,ECE 65,A51,095125,Saad; Andrew S,25,0,26,1
1656909668940,ECE 109,A01,091882,Touri; Behrouz,16,0,70,54
1656909674966,ECE 180,A00,083140,Abi Samra; Nicholas Camill,0,0,30,30
1656909674966,ECE 180,B00,083141,Abi Samra; Nicholas Camill,0,0,30,30
1656909680988,MATH 10A,A01,083735,Patchell; Gregory David,1,0,30,29
1656909680988,MATH 10A,A02,083736,Patchell; Gregory David,20,0,30,10
1656909680988,MATH 10A,A03,083737,Patchell; Gregory David,15,0,30,15
1656909687012,MATH 10B,A01,083207,Lim; Seonhee,7,0,34,27
1656909687012,MATH 10B,A02,083208,Lim; Seonhee,9,0,35,26
1656909687012,MATH 10B,A03,093472,Lim; Seonhee,4,0,34,30
1656909687012,MATH 10B,B01,083739,Sinha; Shubham,9,0,30,21
1656909693036,MATH 18,A01,083743,Cinel; Cameron Alexander,6,0,30,24
1656909693036,MATH 18,A02,083744,Cinel; Cameron Alexander,15,0,30,15
1656909693036,MATH 18,A03,083745,Cinel; Cameron Alexander,8,0,30,22
1656909693036,MATH 18,B01,083748,Rideout; David Porter,4,0,37,33
1656909693036,MATH 18,B02,083749,Rideout; David Porter,3,0,36,33
1656909693036,MATH 18,B03,083750,Rideout; David Porter,2,0,37,35
1656909693036,MATH 18,B04,083751,Rideout; David Porter,5,0,36,31
1656909693036,MATH 18,B05,093473,Rideout; David Porter,4,0,36,32
1656909693036,MATH 18,B06,093474,Rideout; David Porter,5,0,36,31
1656909699061,MATH 20A,A01,083754,Zheng; Zequn,12,0,40,28
1656909705085,MATH 20B,A01,083756,Briones; Jor-el Thomas Caparas,1,0,36,35
1656909705085,MATH 20B,A02,083757,Briones; Jor-el Thomas Caparas,1,0,36,35
1656909705085,MATH 20B,A03,093475,Briones; Jor-el Thomas Caparas,0,0,36,36
1656909711110,MATH 20C,A01,083760,Briones; Jor-el Thomas Caparas,1,0,35,34
1656909711110,MATH 20C,A02,083761,Briones; Jor-el Thomas Caparas,8,0,35,27
1656909711110,MATH 20C,A03,093476,Briones; Jor-el Thomas Caparas,0,1,36,36
1656909711110,MATH 20C,B01,083762,Bach; Quang Tran,0,0,30,30
1656909717134,MATH 20D,A01,083765,Tran; Brian Kha,4,0,30,26
1656909717134,MATH 20D,A02,083766,Tran; Brian Kha,4,0,30,26
1656909717134,MATH 20D,A03,083767,Tran; Brian Kha,3,0,30,27
1656909723157,MATH 20E,A01,083771,Ganguly; Soumya,5,0,32,27
1656909723157,MATH 20E,A02,083772,Ganguly; Soumya,6,0,32,26
1656909723157,MATH 20E,B01,083773,Ciotti; Benjamin,18,0,35,17
1656909723157,MATH 20E,B02,083774,Ciotti; Benjamin,17,0,35,18
1656909729190,MATH 103A,A01,083777,Greenfeld; Be'Eri,2,0,36,34
1656909729190,MATH 103A,A02,083778,Greenfeld; Be'Eri,5,0,36,31
1656909729190,MATH 103A,A03,093561,Greenfeld; Be'Eri,4,0,36,32
1656909729190,MATH 103A,B01,083779,Greenfeld; Be'Eri,6,0,36,30
1656909729190,MATH 103A,B02,083780,Greenfeld; Be'Eri,2,0,36,34
1656909729190,MATH 103A,B03,093562,Greenfeld; Be'Eri,2,0,36,34
1656909735213,MATH 105,A01,085443,Carter; Anne Toulson,13,0,35,22
1656909735213,MATH 105,A02,093477,Carter; Anne Toulson,20,0,35,15
1656909741242,MATH 109,A01,083213,Ganzberger; Geoffrey Michael,2,0,34,32
1656909741242,MATH 109,A02,083214,Ganzberger; Geoffrey Michael,2,0,34,32
1656909741242,MATH 109,A03,093478,Ganzberger; Geoffrey Michael,1,0,34,33
1656909741242,MATH 109,B01,083215,Ganzberger; Geoffrey Michael,1,0,32,31
1656909741242,MATH 109,B02,083216,Ganzberger; Geoffrey Michael,1,0,32,31
1656909741242,MATH 109,B03,093479,Ganzberger; Geoffrey Michael,6,0,32,26
1656909747272,MATH 142A,A01,083219,Chow; Bennett,6,0,32,26
1656909747272,MATH 142A,A02,083220,Chow; Bennett,10,0,32,22
1656909747272,MATH 142A,A03,093480,Chow; Bennett,7,0,32,25
1656909747272,MATH 142A,B03,093481,Chow; Bennett,7,0,32,25
1656909747272,MATH 142A,B04,093558,Chow; Bennett,10,0,32,22
1656909747272,MATH 142A,B05,093559,Chow; Bennett,6,0,32,26
1656909753301,MATH 193A,A01,083224,Rotar; Vladimir,7,0,34,27
1656909753301,MATH 193A,A02,083225,Rotar; Vladimir,3,0,34,31
1656909753301,MATH 193A,A03,083781,Rotar; Vladimir,1,0,34,33
1656909753301,MATH 193A,A04,083782,Rotar; Vladimir,6,0,34,28
1656909753301,MATH 193A,A05,093482,Rotar; Vladimir,6,0,34,28
1656909759326,MATH 197,001,091859,McAuley; Julian John,9999,0,9999,0
1656909759326,MATH 197,002,095566,Kedlaya; Kiran S.,9997,0,9999,2
1656909759326,MATH 197,003,095567,Xiao; Ming,9999,0,9999,0
1656909759326,MATH 197,004,095571,Perols; Johan Lars,9998,0,9999,1
1656909766378,COGS 9,A01,083615,Shannon; Kyle Michael,7,0,75,68
1656909772401,COGS 11,A01,083617,Boyle; Mary E. T.,19,0,48,29
1656909778426,COGS 13,A01,083071,Bastos; Amalia Pinkusfeld,9,0,71,62
1656909784450,COGS 14A,A01,092681,Semenuks; Arturs,0,1,100,100
1656909790477,COGS 14B,A01,083073,Cheng; Tzu-Han,5,0,63,58
1656909796500,COGS 17,A01,092677,Semenuks; Arturs,4,0,81,77
1656909802521,COGS 100,A01,083619,Allen; Michael Gordon,15,0,70,55
1656909808545,COGS 101A,A01,083621,Davis; Joshua Daniel,9,0,68,59
1656909814572,COGS 101B,A01,091572,Allen; Michael Gordon,8,0,65,57
1656909820594,COGS 101C,A01,083625,Delgado; Tania,17,0,35,18
1656909826620,COGS 107A,A01,083627,Boyle; Mary E. T.,13,0,60,47
1656909832644,COGS 118A,A01,083075,Gupta; Anjum,15,0,76,61
1656909838668,CSE 3,A50,083646,Miranda; Gregory Joseph,22,0,50,28
1656909844700,CSE 8A,A50,083650,Miranda; Gregory Joseph,17,1,56,39
1656909850724,CSE 11,A01,083080,Cao; Yingjun,4,15,40,36
1656909856747,CSE 12,A01,083652,Krause-Levy; Sophia Louisa,20,1,120,100
1656909862774,CSE 15L,A01,083654,Morris; Justin Loren,8,0,50,42
1656909862774,CSE 15L,A02,083655,Morris; Justin Loren,8,0,50,42
1656909868796,CSE 20,A01,083657,Tran; Khoa Dang,37,0,80,43
1656909874822,CSE 21,A01,095574,Bach; Quang Tran,21,0,48,27
1656909880850,CSE 30,A01,083084,Eldon; John,4,0,80,76
1656909880850,CSE 30,B01,095061,Bhaskar; Nishant,6,0,50,44
1656909886883,CSE 100,A01,083659,Cao; Yingjun,2,4,70,68
1656909892910,CSE 134B,A01,083661,Powell; Thomas Allan,19,0,100,81
1656909898936,CSE 140,A01,083663,Gungor; Onat,14,0,85,71
1656909904962,CSE 140L,A01,083088,Eldon; John,16,0,100,84
1656909910986,CSE 175,A01,083665,Kumar; Rakesh,3,0,25,22
1656909917011,CSE 190,A00,092507,Dubnov; Shlomo,7,0,20,13
1656909923104,ECE 45,A01,083139,Congero; Spencer William,5,0,75,70
1656909929134,ECE 65,A50,083695,Saad; Andrew S,12,0,30,18
1656909929134,ECE 65,A51,095125,Saad; Andrew S,25,0,26,1
1656909935161,ECE 109,A01,091882,Touri; Behrouz,16,0,70,54
1656909941185,ECE 180,A00,083140,Abi Samra; Nicholas Camill,0,0,30,30
1656909941185,ECE 180,B00,083141,Abi Samra; Nicholas Camill,0,0,30,30
1656909947208,MATH 10A,A01,083735,Patchell; Gregory David,1,0,30,29
1656909947208,MATH 10A,A02,083736,Patchell; Gregory David,20,0,30,10
1656909947208,MATH 10A,A03,083737,Patchell; Gregory David,15,0,30,15
1656909953233,MATH 10B,A01,083207,Lim; Seonhee,7,0,34,27
1656909953233,MATH 10B,A02,083208,Lim; Seonhee,9,0,35,26
1656909953233,MATH 10B,A03,093472,Lim; Seonhee,4,0,34,30
1656909953233,MATH 10B,B01,083739,Sinha; Shubham,9,0,30,21
1656909959265,MATH 18,A01,083743,Cinel; Cameron Alexander,6,0,30,24
1656909959265,MATH 18,A02,083744,Cinel; Cameron Alexander,15,0,30,15
1656909959265,MATH 18,A03,083745,Cinel; Cameron Alexander,8,0,30,22
1656909959265,MATH 18,B01,083748,Rideout; David Porter,4,0,37,33
1656909959265,MATH 18,B02,083749,Rideout; David Porter,3,0,36,33
1656909959265,MATH 18,B03,083750,Rideout; David Porter,2,0,37,35
1656909959265,MATH 18,B04,083751,Rideout; David Porter,5,0,36,31
1656909959265,MATH 18,B05,093473,Rideout; David Porter,4,0,36,32
1656909959265,MATH 18,B06,093474,Rideout; David Porter,5,0,36,31
1656909965299,MATH 20A,A01,083754,Zheng; Zequn,12,0,40,28
1656909971324,MATH 20B,A01,083756,Briones; Jor-el Thomas Caparas,1,0,36,35
1656909971324,MATH 20B,A02,083757,Briones; Jor-el Thomas Caparas,1,0,36,35
1656909971324,MATH 20B,A03,093475,Briones; Jor-el Thomas Caparas,0,0,36,36
1656909977353,MATH 20C,A01,083760,Briones; Jor-el Thomas Caparas,1,0,35,34
1656909977353,MATH 20C,A02,083761,Briones; Jor-el Thomas Caparas,8,0,35,27
1656909977353,MATH 20C,A03,093476,Briones; Jor-el Thomas Caparas,0,1,36,36
1656909977353,MATH 20C,B01,083762,Bach; Quang Tran,0,0,30,30
1656909983392,MATH 20D,A01,083765,Tran; Brian Kha,4,0,30,26
1656909983392,MATH 20D,A02,083766,Tran; Brian Kha,4,0,30,26
1656909983392,MATH 20D,A03,083767,Tran; Brian Kha,3,0,30,27
1656909989420,MATH 20E,A01,083771,Ganguly; Soumya,5,0,32,27
1656909989420,MATH 20E,A02,083772,Ganguly; Soumya,6,0,32,26
1656909989420,MATH 20E,B01,083773,Ciotti; Benjamin,18,0,35,17
1656909989420,MATH 20E,B02,083774,Ciotti; Benjamin,17,0,35,18
1656909995443,MATH 103A,A01,083777,Greenfeld; Be'Eri,2,0,36,34
1656909995443,MATH 103A,A02,083778,Greenfeld; Be'Eri,5,0,36,31
1656909995443,MATH 103A,A03,093561,Greenfeld; Be'Eri,4,0,36,32
1656909995443,MATH 103A,B01,083779,Greenfeld; Be'Eri,6,0,36,30
1656909995443,MATH 103A,B02,083780,Greenfeld; Be'Eri,2,0,36,34
1656909995443,MATH 103A,B03,093562,Greenfeld; Be'Eri,2,0,36,34
1656910001474,MATH 105,A01,085443,Carter; Anne Toulson,13,0,35,22
1656910001474,MATH 105,A02,093477,Carter; Anne Toulson,20,0,35,15
1656910007501,MATH 109,A01,083213,Ganzberger; Geoffrey Michael,2,0,34,32
1656910007501,MATH 109,A02,083214,Ganzberger; Geoffrey Michael,2,0,34,32
1656910007501,MATH 109,A03,093478,Ganzberger; Geoffrey Michael,1,0,34,33
1656910007501,MATH 109,B01,083215,Ganzberger; Geoffrey Michael,1,0,32,31
1656910007501,MATH 109,B02,083216,Ganzberger; Geoffrey Michael,1,0,32,31
1656910007501,MATH 109,B03,093479,Ganzberger; Geoffrey Michael,6,0,32,26
1656910013524,MATH 142A,A01,083219,Chow; Bennett,6,0,32,26
1656910013524,MATH 142A,A02,083220,Chow; Bennett,10,0,32,22
1656910013524,MATH 142A,A03,093480,Chow; Bennett,7,0,32,25
1656910013524,MATH 142A,B03,093481,Chow; Bennett,7,0,32,25
1656910013524,MATH 142A,B04,093558,Chow; Bennett,10,0,32,22
1656910013524,MATH 142A,B05,093559,Chow; Bennett,6,0,32,26
1656910019550,MATH 193A,A01,083224,Rotar; Vladimir,7,0,34,27
1656910019550,MATH 193A,A02,083225,Rotar; Vladimir,3,0,34,31
1656910019550,MATH 193A,A03,083781,Rotar; Vladimir,1,0,34,33
1656910019550,MATH 193A,A04,083782,Rotar; Vladimir,6,0,34,28
1656910019550,MATH 193A,A05,093482,Rotar; Vladimir,6,0,34,28
1656910025574,MATH 197,001,091859,McAuley; Julian John,9999,0,9999,0
1656910025574,MATH 197,002,095566,Kedlaya; Kiran S.,9997,0,9999,2
1656910025574,MATH 197,003,095567,Xiao; Ming,9999,0,9999,0
1656910025574,MATH 197,004,095571,Perols; Johan Lars,9998,0,9999,1
1656910032638,COGS 9,A01,083615,Shannon; Kyle Michael,7,0,75,68
1656910038661,COGS 11,A01,083617,Boyle; Mary E. T.,19,0,48,29
1656910044686,COGS 13,A01,083071,Bastos; Amalia Pinkusfeld,9,0,71,62
1656910050708,COGS 14A,A01,092681,Semenuks; Arturs,0,1,100,100
1656910056735,COGS 14B,A01,083073,Cheng; Tzu-Han,5,0,63,58
1656910062760,COGS 17,A01,092677,Semenuks; Arturs,4,0,81,77
1656910068788,COGS 100,A01,083619,Allen; Michael Gordon,15,0,70,55
1656910074825,COGS 101A,A01,083621,Davis; Joshua Daniel,9,0,68,59
1656910080851,COGS 101B,A01,091572,Allen; Michael Gordon,8,0,65,57
1656910086880,COGS 101C,A01,083625,Delgado; Tania,17,0,35,18
1656910092910,COGS 107A,A01,083627,Boyle; Mary E. T.,13,0,60,47
1656910098936,COGS 118A,A01,083075,Gupta; Anjum,15,0,76,61
1656910104963,CSE 3,A50,083646,Miranda; Gregory Joseph,22,0,50,28
1656910110990,CSE 8A,A50,083650,Miranda; Gregory Joseph,17,1,56,39
1656910117013,CSE 11,A01,083080,Cao; Yingjun,4,15,40,36
1656910123036,CSE 12,A01,083652,Krause-Levy; Sophia Louisa,20,1,120,100
1656910129064,CSE 15L,A01,083654,Morris; Justin Loren,8,0,50,42
1656910129064,CSE 15L,A02,083655,Morris; Justin Loren,8,0,50,42
1656910135088,CSE 20,A01,083657,Tran; Khoa Dang,37,0,80,43
1656910141115,CSE 21,A01,095574,Bach; Quang Tran,21,0,48,27
1656910147143,CSE 30,A01,083084,Eldon; John,4,0,80,76
1656910147143,CSE 30,B01,095061,Bhaskar; Nishant,6,0,50,44
1656910153166,CSE 100,A01,083659,Cao; Yingjun,2,4,70,68
1656910159189,CSE 134B,A01,083661,Powell; Thomas Allan,19,0,100,81
1656910165211,CSE 140,A01,083663,Gungor; Onat,14,0,85,71
1656910171235,CSE 140L,A01,083088,Eldon; John,16,0,100,84
1656910177260,CSE 175,A01,083665,Kumar; Rakesh,3,0,25,22
1656910183286,CSE 190,A00,092507,Dubnov; Shlomo,7,0,20,13
1656910189313,ECE 45,A01,083139,Congero; Spencer William,5,0,75,70
1656910195339,ECE 65,A50,083695,Saad; Andrew S,12,0,30,18
1656910195339,ECE 65,A51,095125,Saad; Andrew S,25,0,26,1
1656910201372,ECE 109,A01,091882,Touri; Behrouz,16,0,70,54
1656910207395,ECE 180,A00,083140,Abi Samra; Nicholas Camill,0,0,30,30
1656910207395,ECE 180,B00,083141,Abi Samra; Nicholas Camill,0,0,30,30
1656910213419,MATH 10A,A01,083735,Patchell; Gregory David,1,0,30,29
1656910213419,MATH 10A,A02,083736,Patchell; Gregory David,20,0,30,10
1656910213419,MATH 10A,A03,083737,Patchell; Gregory David,15,0,30,15
1656910219443,MATH 10B,A01,083207,Lim; Seonhee,7,0,34,27
1656910219443,MATH 10B,A02,083208,Lim; Seonhee,9,0,35,26
1656910219443,MATH 10B,A03,093472,Lim; Seonhee,4,0,34,30
1656910219443,MATH 10B,B01,083739,Sinha; Shubham,9,0,30,21
1656910225468,MATH 18,A01,083743,Cinel; Cameron Alexander,6,0,30,24
1656910225468,MATH 18,A02,083744,Cinel; Cameron Alexander,15,0,30,15
1656910225468,MATH 18,A03,083745,Cinel; Cameron Alexander,8,0,30,22
1656910225468,MATH 18,B01,083748,Rideout; David Porter,4,0,37,33
1656910225468,MATH 18,B02,083749,Rideout; David Porter,3,0,36,33
1656910225468,MATH 18,B03,083750,Rideout; David Porter,2,0,37,35
1656910225468,MATH 18,B04,083751,Rideout; David Porter,5,0,36,31
1656910225468,MATH 18,B05,093473,Rideout; David Porter,4,0,36,32
1656910225468,MATH 18,B06,093474,Rideout; David Porter,5,0,36,31
1656910231490,MATH 20A,A01,083754,Zheng; Zequn,12,0,40,28
1656910237512,MATH 20B,A01,083756,Briones; Jor-el Thomas Caparas,1,0,36,35
1656910237512,MATH 20B,A02,083757,Briones; Jor-el Thomas Caparas,1,0,36,35
1656910237512,MATH 20B,A03,093475,Briones; Jor-el Thomas Caparas,0,0,36,36
1656910243538,MATH 20C,A01,083760,Briones; Jor-el Thomas Caparas,1,0,35,34
1656910243538,MATH 20C,A02,083761,Briones; Jor-el Thomas Caparas,8,0,35,27
1656910243538,MATH 20C,A03,093476,Briones; Jor-el Thomas Caparas,0,1,36,36
1656910243538,MATH 20C,B01,083762,Bach; Quang Tran,0,0,30,30
1656910249562,MATH 20D,A01,083765,Tran; Brian Kha,4,0,30,26
1656910249562,MATH 20D,A02,083766,Tran; Brian Kha,4,0,30,26
1656910249562,MATH 20D,A03,083767,Tran; Brian Kha,3,0,30,27
1656910255591,MATH 20E,A01,083771,Ganguly; Soumya,5,0,32,27
1656910255591,MATH 20E,A02,083772,Ganguly; Soumya,6,0,32,26
1656910255591,MATH 20E,B01,083773,Ciotti; Benjamin,18,0,35,17
1656910255591,MATH 20E,B02,083774,Ciotti; Benjamin,17,0,35,18
1656910261616,MATH 103A,A01,083777,Greenfeld; Be'Eri,2,0,36,34
1656910261616,MATH 103A,A02,083778,Greenfeld; Be'Eri,5,0,36,31
1656910261616,MATH 103A,A03,093561,Greenfeld; Be'Eri,4,0,36,32
1656910261616,MATH 103A,B01,083779,Greenfeld; Be'Eri,6,0,36,30
1656910261616,MATH 103A,B02,083780,Greenfeld; Be'Eri,2,0,36,34
1656910261616,MATH 103A,B03,093562,Greenfeld; Be'Eri,2,0,36,34
1656910267638,MATH 105,A01,085443,Carter; Anne Toulson,13,0,35,22
1656910267638,MATH 105,A02,093477,Carter; Anne Toulson,20,0,35,15
1656910273666,MATH 109,A01,083213,Ganzberger; Geoffrey Michael,2,0,34,32
1656910273666,MATH 109,A02,083214,Ganzberger; Geoffrey Michael,2,0,34,32
1656910273666,MATH 109,A03,093478,Ganzberger; Geoffrey Michael,1,0,34,33
1656910273666,MATH 109,B01,083215,Ganzberger; Geoffrey Michael,1,0,32,31
1656910273666,MATH 109,B02,083216,Ganzberger; Geoffrey Michael,1,0,32,31
1656910273666,MATH 109,B03,093479,Ganzberger; Geoffrey Michael,6,0,32,26
1656910279696,MATH 142A,A01,083219,Chow; Bennett,6,0,32,26
1656910279696,MATH 142A,A02,083220,Chow; Bennett,10,0,32,22
1656910279696,MATH 142A,A03,093480,Chow; Bennett,7,0,32,25
1656910279696,MATH 142A,B03,093481,Chow; Bennett,7,0,32,25
1656910279696,MATH 142A,B04,093558,Chow; Bennett,10,0,32,22
1656910279696,MATH 142A,B05,093559,Chow; Bennett,6,0,32,26
1656910285724,MATH 193A,A01,083224,Rotar; Vladimir,7,0,34,27
1656910285724,MATH 193A,A02,083225,Rotar; Vladimir,3,0,34,31
1656910285724,MATH 193A,A03,083781,Rotar; Vladimir,1,0,34,33
1656910285724,MATH 193A,A04,083782,Rotar; Vladimir,6,0,34,28
1656910285724,MATH 193A,A05,093482,Rotar; Vladimir,6,0,34,28
1656910291744,MATH 197,001,091859,McAuley; Julian John,9999,0,9999,0
1656910291744,MATH 197,002,095566,Kedlaya; Kiran S.,9997,0,9999,2
1656910291744,MATH 197,003,095567,Xiao; Ming,9999,0,9999,0
1656910291744,MATH 197,004,095571,Perols; Johan Lars,9998,0,9999,1
1656910298802,COGS 9,A01,083615,Shannon; Kyle Michael,7,0,75,68
1656910304828,COGS 11,A01,083617,Boyle; Mary E. T.,19,0,48,29
1656910310851,COGS 13,A01,083071,Bastos; Amalia Pinkusfeld,9,0,71,62
1656910316876,COGS 14A,A01,092681,Semenuks; Arturs,0,1,100,100
1656910322899,COGS 14B,A01,083073,Cheng; Tzu-Han,5,0,63,58
1656910328921,COGS 17,A01,092677,Semenuks; Arturs,4,0,81,77
1656910334943,COGS 100,A01,083619,Allen; Michael Gordon,15,0,70,55
1656910340967,COGS 101A,A01,083621,Davis; Joshua Daniel,9,0,68,59
1656910346994,COGS 101B,A01,091572,Allen; Michael Gordon,8,0,65,57
1656910353017,COGS 101C,A01,083625,Delgado; Tania,17,0,35,18
1656910359039,COGS 107A,A01,083627,Boyle; Mary E. T.,13,0,60,47
1656910365068,COGS 118A,A01,083075,Gupta; Anjum,15,0,76,61
1656910371094,CSE 3,A50,083646,Miranda; Gregory Joseph,22,0,50,28
1656910377121,CSE 8A,A50,083650,Miranda; Gregory Joseph,17,1,56,39
1656910383142,CSE 11,A01,083080,Cao; Yingjun,4,15,40,36
1656910389168,CSE 12,A01,083652,Krause-Levy; Sophia Louisa,20,1,120,100
1656910395191,CSE 15L,A01,083654,Morris; Justin Loren,8,0,50,42
1656910395191,CSE 15L,A02,083655,Morris; Justin Loren,8,0,50,42
1656910401216,CSE 20,A01,083657,Tran; Khoa Dang,37,0,80,43
1656910407244,CSE 21,A01,095574,Bach; Quang Tran,21,0,48,27
1656910413267,CSE 30,A01,083084,Eldon; John,4,0,80,76
1656910413267,CSE 30,B01,095061,Bhaskar; Nishant,6,0,50,44
1656910419290,CSE 100,A01,083659,Cao; Yingjun,2,4,70,68
1656910425317,CSE 134B,A01,083661,Powell; Thomas Allan,19,0,100,81
1656910431342,CSE 140,A01,083663,Gungor; Onat,14,0,85,71
1656910437367,CSE 140L,A01,083088,Eldon; John,16,0,100,84
1656910443393,CSE 175,A01,083665,Kumar; Rakesh,3,0,25,22
1656910449416,CSE 190,A00,092507,Dubnov; Shlomo,7,0,20,13
1656910455438,ECE 45,A01,083139,Congero; Spencer William,5,0,75,70
1656910461468,ECE 65,A50,083695,Saad; Andrew S,12,0,30,18
1656910461468,ECE 65,A51,095125,Saad; Andrew S,25,0,26,1
1656910467495,ECE 109,A01,091882,Touri; Behrouz,16,0,70,54
1656910473519,ECE 180,A00,083140,Abi Samra; Nicholas Camill,0,0,30,30
1656910473519,ECE 180,B00,083141,Abi Samra; Nicholas Camill,0,0,30,30
1656910479542,MATH 10A,A01,083735,Patchell; Gregory David,1,0,30,29
1656910479542,MATH 10A,A02,083736,Patchell; Gregory David,20,0,30,10
1656910479542,MATH 10A,A03,083737,Patchell; Gregory David,15,0,30,15
1656910485572,MATH 10B,A01,083207,Lim; Seonhee,7,0,34,27
1656910485572,MATH 10B,A02,083208,Lim; Seonhee,9,0,35,26
1656910485572,MATH 10B,A03,093472,Lim; Seonhee,4,0,34,30
1656910485572,MATH 10B,B01,083739,Sinha; Shubham,9,0,30,21
1656910491597,MATH 18,A01,083743,Cinel; Cameron Alexander,6,0,30,24
1656910491597,MATH 18,A02,083744,Cinel; Cameron Alexander,15,0,30,15
1656910491597,MATH 18,A03,083745,Cinel; Cameron Alexander,8,0,30,22
1656910491597,MATH 18,B01,083748,Rideout; David Porter,4,0,37,33
1656910491597,MATH 18,B02,083749,Rideout; David Porter,3,0,36,33
1656910491597,MATH 18,B03,083750,Rideout; David Porter,2,0,37,35
1656910491597,MATH 18,B04,083751,Rideout; David Porter,5,0,36,31
1656910491597,MATH 18,B05,093473,Rideout; David Porter,4,0,36,32
1656910491597,MATH 18,B06,093474,Rideout; David Porter,5,0,36,31
1656910497634,MATH 20A,A01,083754,Zheng; Zequn,12,0,40,28
1656910503661,MATH 20B,A01,083756,Briones; Jor-el Thomas Caparas,1,0,36,35
1656910503661,MATH 20B,A02,083757,Briones; Jor-el Thomas Caparas,1,0,36,35
1656910503661,MATH 20B,A03,093475,Briones; Jor-el Thomas Caparas,0,0,36,36
1656910509685,MATH 20C,A01,083760,Briones; Jor-el Thomas Caparas,1,0,35,34
1656910509685,MATH 20C,A02,083761,Briones; Jor-el Thomas Caparas,8,0,35,27
1656910509685,MATH 20C,A03,093476,Briones; Jor-el Thomas Caparas,0,1,36,36
1656910509685,MATH 20C,B01,083762,Bach; Quang Tran,0,0,30,30
1656910515712,MATH 20D,A01,083765,Tran; Brian Kha,4,0,30,26
1656910515712,MATH 20D,A02,083766,Tran; Brian Kha,4,0,30,26
1656910515712,MATH 20D,A03,083767,Tran; Brian Kha,3,0,30,27
1656910521821,MATH 20E,A01,083771,Ganguly; Soumya,5,0,32,27
1656910521821,MATH 20E,A02,083772,Ganguly; Soumya,6,0,32,26
1656910521821,MATH 20E,B01,083773,Ciotti; Benjamin,18,0,35,17
1656910521821,MATH 20E,B02,083774,Ciotti; Benjamin,17,0,35,18
1656910527846,MATH 103A,A01,083777,Greenfeld; Be'Eri,2,0,36,34
1656910527846,MATH 103A,A02,083778,Greenfeld; Be'Eri,5,0,36,31
1656910527846,MATH 103A,A03,093561,Greenfeld; Be'Eri,4,0,36,32
1656910527846,MATH 103A,B01,083779,Greenfeld; Be'Eri,6,0,36,30
1656910527846,MATH 103A,B02,083780,Greenfeld; Be'Eri,2,0,36,34
1656910527846,MATH 103A,B03,093562,Greenfeld; Be'Eri,2,0,36,34
1656910533873,MATH 105,A01,085443,Carter; Anne Toulson,13,0,35,22
1656910533873,MATH 105,A02,093477,Carter; Anne Toulson,20,0,35,15
1656910539902,MATH 109,A01,083213,Ganzberger; Geoffrey Michael,2,0,34,32
1656910539902,MATH 109,A02,083214,Ganzberger; Geoffrey Michael,2,0,34,32
1656910539902,MATH 109,A03,093478,Ganzberger; Geoffrey Michael,1,0,34,33
1656910539902,MATH 109,B01,083215,Ganzberger; Geoffrey Michael,1,0,32,31
1656910539902,MATH 109,B02,083216,Ganzberger; Geoffrey Michael,1,0,32,31
1656910539902,MATH 109,B03,093479,Ganzberger; Geoffrey Michael,6,0,32,26
1656910545929,MATH 142A,A01,083219,Chow; Bennett,6,0,32,26
1656910545929,MATH 142A,A02,083220,Chow; Bennett,10,0,32,22
1656910545929,MATH 142A,A03,093480,Chow; Bennett,7,0,32,25
1656910545929,MATH 142A,B03,093481,Chow; Bennett,7,0,32,25
1656910545929,MATH 142A,B04,093558,Chow; Bennett,10,0,32,22
1656910545929,MATH 142A,B05,093559,Chow; Bennett,6,0,32,26
1656910551959,MATH 193A,A01,083224,Rotar; Vladimir,7,0,34,27
1656910551959,MATH 193A,A02,083225,Rotar; Vladimir,3,0,34,31
1656910551959,MATH 193A,A03,083781,Rotar; Vladimir,1,0,34,33
1656910551959,MATH 193A,A04,083782,Rotar; Vladimir,6,0,34,28
1656910551959,MATH 193A,A05,093482,Rotar; Vladimir,6,0,34,28
1656910557982,MATH 197,001,091859,McAuley; Julian John,9999,0,9999,0
1656910557982,MATH 197,002,095566,Kedlaya; Kiran S.,9997,0,9999,2
1656910557982,MATH 197,003,095567,Xiao; Ming,9999,0,9999,0
1656910557982,MATH 197,004,095571,Perols; Johan Lars,9998,0,9999,1
1656910565044,COGS 9,A01,083615,Shannon; Kyle Michael,7,0,75,68
1656910571067,COGS 11,A01,083617,Boyle; Mary E. T.,19,0,48,29
1656910577091,COGS 13,A01,083071,Bastos; Amalia Pinkusfeld,9,0,71,62
1656910583117,COGS 14A,A01,092681,Semenuks; Arturs,0,1,100,100
1656910589139,COGS 14B,A01,083073,Cheng; Tzu-Han,5,0,63,58
1656910595167,COGS 17,A01,092677,Semenuks; Arturs,4,0,81,77
1656910601193,COGS 100,A01,083619,Allen; Michael Gordon,15,0,70,55
1656910607217,COGS 101A,A01,083621,Davis; Joshua Daniel,9,0,68,59
1656910613243,COGS 101B,A01,091572,Allen; Michael Gordon,8,0,65,57
1656910619266,COGS 101C,A01,083625,Delgado; Tania,17,0,35,18
1656910625293,COGS 107A,A01,083627,Boyle; Mary E. T.,13,0,60,47
1656910631317,COGS 118A,A01,083075,Gupta; Anjum,15,0,76,61
1656910637344,CSE 3,A50,083646,Miranda; Gregory Joseph,22,0,50,28
1656910643368,CSE 8A,A50,083650,Miranda; Gregory Joseph,17,1,56,39
1656910649392,CSE 11,A01,083080,Cao; Yingjun,4,15,40,36
1656910655417,CSE 12,A01,083652,Krause-Levy; Sophia Louisa,20,1,120,100
1656910661444,CSE 15L,A01,083654,Morris; Justin Loren,8,0,50,42
1656910661444,CSE 15L,A02,083655,Morris; Justin Loren,8,0,50,42
1656910667470,CSE 20,A01,083657,Tran; Khoa Dang,37,0,80,43
1656910673498,CSE 21,A01,095574,Bach; Quang Tran,21,0,48,27
1656910679524,CSE 30,A01,083084,Eldon; John,4,0,80,76
1656910679524,CSE 30,B01,095061,Bhaskar; Nishant,6,0,50,44
1656910685553,CSE 100,A01,083659,Cao; Yingjun,2,4,70,68
1656910691576,CSE 134B,A01,083661,Powell; Thomas Allan,19,0,100,81
1656910697602,CSE 140,A01,083663,Gungor; Onat,14,0,85,71
1656910703626,CSE 140L,A01,083088,Eldon; John,16,0,100,84
1656910709649,CSE 175,A01,083665,Kumar; Rakesh,3,0,25,22
1656910715672,CSE 190,A00,092507,Dubnov; Shlomo,7,0,20,13
1656910721713,ECE 45,A01,083139,Congero; Spencer William,5,0,75,70
1656910727752,ECE 65,A50,083695,Saad; Andrew S,12,0,30,18
1656910727752,ECE 65,A51,095125,Saad; Andrew S,25,0,26,1
1656910733779,ECE 109,A01,091882,Touri; Behrouz,16,0,70,54
1656910739801,ECE 180,A00,083140,Abi Samra; Nicholas Camill,0,0,30,30
1656910739801,ECE 180,B00,083141,Abi Samra; Nicholas Camill,0,0,30,30
1656910745837,MATH 10A,A01,083735,Patchell; Gregory David,1,0,30,29
1656910745837,MATH 10A,A02,083736,Patchell; Gregory David,20,0,30,10
1656910745837,MATH 10A,A03,083737,Patchell; Gregory David,15,0,30,15
1656910751861,MATH 10B,A01,083207,Lim; Seonhee,7,0,34,27
1656910751861,MATH 10B,A02,083208,Lim; Seonhee,9,0,35,26
1656910751861,MATH 10B,A03,093472,Lim; Seonhee,4,0,34,30
1656910751861,MATH 10B,B01,083739,Sinha; Shubham,9,0,30,21
1656910757885,MATH 18,A01,083743,Cinel; Cameron Alexander,6,0,30,24
1656910757885,MATH 18,A02,083744,Cinel; Cameron Alexander,15,0,30,15
1656910757885,MATH 18,A03,083745,Cinel; Cameron Alexander,8,0,30,22
1656910757885,MATH 18,B01,083748,Rideout; David Porter,4,0,37,33
1656910757885,MATH 18,B02,083749,Rideout; David Porter,3,0,36,33
1656910757885,MATH 18,B03,083750,Rideout; David Porter,2,0,37,35
1656910757885,MATH 18,B04,083751,Rideout; David Porter,5,0,36,31
1656910757885,MATH 18,B05,093473,Rideout; David Porter,4,0,36,32
1656910757885,MATH 18,B06,093474,Rideout; David Porter,5,0,36,31
1656910763908,MATH 20A,A01,083754,Zheng; Zequn,12,0,40,28
1656910769930,MATH 20B,A01,083756,Briones; Jor-el Thomas Caparas,1,0,36,35
1656910769930,MATH 20B,A02,083757,Briones; Jor-el Thomas Caparas,1,0,36,35
1656910769930,MATH 20B,A03,093475,Briones; Jor-el Thomas Caparas,0,0,36,36
1656910775952,MATH 20C,A01,083760,Briones; Jor-el Thomas Caparas,1,0,35,34
1656910775952,MATH 20C,A02,083761,Briones; Jor-el Thomas Caparas,8,0,35,27
1656910775952,MATH 20C,A03,093476,Briones; Jor-el Thomas Caparas,0,1,36,36
1656910775952,MATH 20C,B01,083762,Bach; Quang Tran,0,0,30,30
1656910781977,MATH 20D,A01,083765,Tran; Brian Kha,4,0,30,26
1656910781977,MATH 20D,A02,083766,Tran; Brian Kha,4,0,30,26
1656910781977,MATH 20D,A03,083767,Tran; Brian Kha,3,0,30,27
1656910788005,MATH 20E,A01,083771,Ganguly; Soumya,5,0,32,27
1656910788005,MATH 20E,A02,083772,Ganguly; Soumya,6,0,32,26
1656910788005,MATH 20E,B01,083773,Ciotti; Benjamin,18,0,35,17
1656910788005,MATH 20E,B02,083774,Ciotti; Benjamin,17,0,35,18
1656910794034,MATH 103A,A01,083777,Greenfeld; Be'Eri,2,0,36,34
1656910794034,MATH 103A,A02,083778,Greenfeld; Be'Eri,5,0,36,31
1656910794034,MATH 103A,A03,093561,Greenfeld; Be'Eri,4,0,36,32
1656910794034,MATH 103A,B01,083779,Greenfeld; Be'Eri,6,0,36,30
1656910794034,MATH 103A,B02,083780,Greenfeld; Be'Eri,2,0,36,34
1656910794034,MATH 103A,B03,093562,Greenfeld; Be'Eri,2,0,36,34
1656910800057,MATH 105,A01,085443,Carter; Anne Toulson,13,0,35,22
1656910800057,MATH 105,A02,093477,Carter; Anne Toulson,20,0,35,15
1656910806079,MATH 109,A01,083213,Ganzberger; Geoffrey Michael,2,0,34,32
1656910806079,MATH 109,A02,083214,Ganzberger; Geoffrey Michael,2,0,34,32
1656910806079,MATH 109,A03,093478,Ganzberger; Geoffrey Michael,1,0,34,33
1656910806079,MATH 109,B01,083215,Ganzberger; Geoffrey Michael,1,0,32,31
1656910806079,MATH 109,B02,083216,Ganzberger; Geoffrey Michael,1,0,32,31
1656910806079,MATH 109,B03,093479,Ganzberger; Geoffrey Michael,6,0,32,26
1656910812102,MATH 142A,A01,083219,Chow; Bennett,6,0,32,26
1656910812102,MATH 142A,A02,083220,Chow; Bennett,10,0,32,22
1656910812102,MATH 142A,A03,093480,Chow; Bennett,7,0,32,25
1656910812102,MATH 142A,B03,093481,Chow; Bennett,7,0,32,25
1656910812102,MATH 142A,B04,093558,Chow; Bennett,10,0,32,22
1656910812102,MATH 142A,B05,093559,Chow; Bennett,6,0,32,26
1656910818124,MATH 193A,A01,083224,Rotar; Vladimir,7,0,34,27
1656910818124,MATH 193A,A02,083225,Rotar; Vladimir,3,0,34,31
1656910818124,MATH 193A,A03,083781,Rotar; Vladimir,1,0,34,33
1656910818124,MATH 193A,A04,083782,Rotar; Vladimir,6,0,34,28
1656910818124,MATH 193A,A05,093482,Rotar; Vladimir,6,0,34,28
1656910824147,MATH 197,001,091859,McAuley; Julian John,9999,0,9999,0
1656910824147,MATH 197,002,095566,Kedlaya; Kiran S.,9997,0,9999,2
1656910824147,MATH 197,003,095567,Xiao; Ming,9999,0,9999,0
1656910824147,MATH 197,004,095571,Perols; Johan Lars,9998,0,9999,1
1656910831200,COGS 9,A01,083615,Shannon; Kyle Michael,7,0,75,68
1656910837223,COGS 11,A01,083617,Boyle; Mary E. T.,19,0,48,29
1656910843246,COGS 13,A01,083071,Bastos; Amalia Pinkusfeld,9,0,71,62
1656910849272,COGS 14A,A01,092681,Semenuks; Arturs,0,1,100,100
1656910855297,COGS 14B,A01,083073,Cheng; Tzu-Han,5,0,63,58
1656910861323,COGS 17,A01,092677,Semenuks; Arturs,4,0,81,77
1656910867346,COGS 100,A01,083619,Allen; Michael Gordon,15,0,70,55
1656910873372,COGS 101A,A01,083621,Davis; Joshua Daniel,9,0,68,59
1656910879395,COGS 101B,A01,091572,Allen; Michael Gordon,8,0,65,57
1656910885416,COGS 101C,A01,083625,Delgado; Tania,17,0,35,18
1656910891442,COGS 107A,A01,083627,Boyle; Mary E. T.,13,0,60,47
1656910897468,COGS 118A,A01,083075,Gupta; Anjum,15,0,76,61
1656910903495,CSE 3,A50,083646,Miranda; Gregory Joseph,22,0,50,28
1656910909519,CSE 8A,A50,083650,Miranda; Gregory Joseph,17,1,56,39
1656910915549,CSE 11,A01,083080,Cao; Yingjun,4,15,40,36
1656910921577,CSE 12,A01,083652,Krause-Levy; Sophia Louisa,20,1,120,100
1656910927599,CSE 15L,A01,083654,Morris; Justin Loren,8,0,50,42
1656910927599,CSE 15L,A02,083655,Morris; Justin Loren,8,0,50,42
1656910933623,CSE 20,A01,083657,Tran; Khoa Dang,37,0,80,43
1656910939651,CSE 21,A01,095574,Bach; Quang Tran,21,0,48,27
1656910945679,CSE 30,A01,083084,Eldon; John,4,0,80,76
1656910945679,CSE 30,B01,095061,Bhaskar; Nishant,6,0,50,44
1656910951704,CSE 100,A01,083659,Cao; Yingjun,2,4,70,68
1656910957726,CSE 134B,A01,083661,Powell; Thomas Allan,19,0,100,81
1656910963753,CSE 140,A01,083663,Gungor; Onat,14,0,85,71
1656910969777,CSE 140L,A01,083088,Eldon; John,16,0,100,84
1656910975802,CSE 175,A01,083665,Kumar; Rakesh,3,0,25,22
1656910981826,CSE 190,A00,092507,Dubnov; Shlomo,7,0,20,13
1656910987851,ECE 45,A01,083139,Congero; Spencer William,5,0,75,70
1656910993874,ECE 65,A50,083695,Saad; Andrew S,12,0,30,18
1656910993874,ECE 65,A51,095125,Saad; Andrew S,25,0,26,1
1656910999902,ECE 109,A01,091882,Touri; Behrouz,16,0,70,54
1656911005924,ECE 180,A00,083140,Abi Samra; Nicholas Camill,0,0,30,30
1656911005924,ECE 180,B00,083141,Abi Samra; Nicholas Camill,0,0,30,30
1656911011949,MATH 10A,A01,083735,Patchell; Gregory David,1,0,30,29
1656911011949,MATH 10A,A02,083736,Patchell; Gregory David,20,0,30,10
1656911011949,MATH 10A,A03,083737,Patchell; Gregory David,15,0,30,15
1656911017978,MATH 10B,A01,083207,Lim; Seonhee,7,0,34,27
1656911017978,MATH 10B,A02,083208,Lim; Seonhee,9,0,35,26
1656911017978,MATH 10B,A03,093472,Lim; Seonhee,4,0,34,30
1656911017978,MATH 10B,B01,083739,Sinha; Shubham,9,0,30,21
1656911024002,MATH 18,A01,083743,Cinel; Cameron Alexander,6,0,30,24
1656911024002,MATH 18,A02,083744,Cinel; Cameron Alexander,15,0,30,15
1656911024002,MATH 18,A03,083745,Cinel; Cameron Alexander,8,0,30,22
1656911024002,MATH 18,B01,083748,Rideout; David Porter,4,0,37,33
1656911024002,MATH 18,B02,083749,Rideout; David Porter,3,0,36,33
1656911024002,MATH 18,B03,083750,Rideout; David Porter,2,0,37,35
1656911024002,MATH 18,B04,083751,Rideout; David Porter,5,0,36,31
1656911024002,MATH 18,B05,093473,Rideout; David Porter,4,0,36,32
1656911024002,MATH 18,B06,093474,Rideout; David Porter,5,0,36,31
1656911030027,MATH 20A,A01,083754,Zheng; Zequn,12,0,40,28
1656911036055,MATH 20B,A01,083756,Briones; Jor-el Thomas Caparas,1,0,36,35
1656911036055,MATH 20B,A02,083757,Briones; Jor-el Thomas Caparas,1,0,36,35
1656911036055,MATH 20B,A03,093475,Briones; Jor-el Thomas Caparas,0,0,36,36
1656911042083,MATH 20C,A01,083760,Briones; Jor-el Thomas Caparas,1,0,35,34
1656911042083,MATH 20C,A02,083761,Briones; Jor-el Thomas Caparas,8,0,35,27
1656911042083,MATH 20C,A03,093476,Briones; Jor-el Thomas Caparas,0,1,36,36
1656911042083,MATH 20C,B01,083762,Bach; Quang Tran,0,0,30,30
1656911048117,MATH 20D,A01,083765,Tran; Brian Kha,4,0,30,26
1656911048117,MATH 20D,A02,083766,Tran; Brian Kha,4,0,30,26
1656911048117,MATH 20D,A03,083767,Tran; Brian Kha,3,0,30,27
1656911054159,MATH 20E,A01,083771,Ganguly; Soumya,5,0,32,27
1656911054159,MATH 20E,A02,083772,Ganguly; Soumya,6,0,32,26
1656911054159,MATH 20E,B01,083773,Ciotti; Benjamin,18,0,35,17
1656911054159,MATH 20E,B02,083774,Ciotti; Benjamin,17,0,35,18
1656911060188,MATH 103A,A01,083777,Greenfeld; Be'Eri,2,0,36,34
1656911060188,MATH 103A,A02,083778,Greenfeld; Be'Eri,5,0,36,31
1656911060188,MATH 103A,A03,093561,Greenfeld; Be'Eri,4,0,36,32
1656911060188,MATH 103A,B01,083779,Greenfeld; Be'Eri,6,0,36,30
1656911060188,MATH 103A,B02,083780,Greenfeld; Be'Eri,2,0,36,34
1656911060188,MATH 103A,B03,093562,Greenfeld; Be'Eri,2,0,36,34
1656911066212,MATH 105,A01,085443,Carter; Anne Toulson,13,0,35,22
1656911066212,MATH 105,A02,093477,Carter; Anne Toulson,20,0,35,15
1656911072236,MATH 109,A01,083213,Ganzberger; Geoffrey Michael,2,0,34,32
1656911072236,MATH 109,A02,083214,Ganzberger; Geoffrey Michael,2,0,34,32
1656911072236,MATH 109,A03,093478,Ganzberger; Geoffrey Michael,1,0,34,33
1656911072236,MATH 109,B01,083215,Ganzberger; Geoffrey Michael,1,0,32,31
1656911072236,MATH 109,B02,083216,Ganzberger; Geoffrey Michael,1,0,32,31
1656911072236,MATH 109,B03,093479,Ganzberger; Geoffrey Michael,6,0,32,26
1656911078260,MATH 142A,A01,083219,Chow; Bennett,6,0,32,26
1656911078260,MATH 142A,A02,083220,Chow; Bennett,10,0,32,22
1656911078260,MATH 142A,A03,093480,Chow; Bennett,7,0,32,25
1656911078260,MATH 142A,B03,093481,Chow; Bennett,7,0,32,25
1656911078260,MATH 142A,B04,093558,Chow; Bennett,10,0,32,22
1656911078260,MATH 142A,B05,093559,Chow; Bennett,6,0,32,26
1656911084284,MATH 193A,A01,083224,Rotar; Vladimir,7,0,34,27
1656911084284,MATH 193A,A02,083225,Rotar; Vladimir,3,0,34,31
1656911084284,MATH 193A,A03,083781,Rotar; Vladimir,1,0,34,33
1656911084284,MATH 193A,A04,083782,Rotar; Vladimir,6,0,34,28
1656911084284,MATH 193A,A05,093482,Rotar; Vladimir,6,0,34,28
1656911090308,MATH 197,001,091859,McAuley; Julian John,9999,0,9999,0
1656911090308,MATH 197,002,095566,Kedlaya; Kiran S.,9997,0,9999,2
1656911090308,MATH 197,003,095567,Xiao; Ming,9999,0,9999,0
1656911090308,MATH 197,004,095571,Perols; Johan Lars,9998,0,9999,1
1656911097371,COGS 9,A01,083615,Shannon; Kyle Michael,7,0,75,68
1656911103411,COGS 11,A01,083617,Boyle; Mary E. T.,19,0,48,29
1656911109450,COGS 13,A01,083071,Bastos; Amalia Pinkusfeld,9,0,71,62
1656911115560,COGS 14A,A01,092681,Semenuks; Arturs,0,1,100,100
1656911121586,COGS 14B,A01,083073,Cheng; Tzu-Han,5,0,63,58
1656911127609,COGS 17,A01,092677,Semenuks; Arturs,4,0,81,77
1656911133635,COGS 100,A01,083619,Allen; Michael Gordon,15,0,70,55
1656911139657,COGS 101A,A01,083621,Davis; Joshua Daniel,9,0,68,59
1656911145682,COGS 101B,A01,091572,Allen; Michael Gordon,8,0,65,57
1656911151709,COGS 101C,A01,083625,Delgado; Tania,17,0,35,18
1656911157733,COGS 107A,A01,083627,Boyle; Mary E. T.,13,0,60,47
1656911163755,COGS 118A,A01,083075,Gupta; Anjum,15,0,76,61
1656911169780,CSE 3,A50,083646,Miranda; Gregory Joseph,22,0,50,28
1656911175808,CSE 8A,A50,083650,Miranda; Gregory Joseph,17,1,56,39
1656911181837,CSE 11,A01,083080,Cao; Yingjun,4,15,40,36
1656911187865,CSE 12,A01,083652,Krause-Levy; Sophia Louisa,20,1,120,100
1656911193890,CSE 15L,A01,083654,Morris; Justin Loren,8,0,50,42
1656911193890,CSE 15L,A02,083655,Morris; Justin Loren,8,0,50,42
1656911199914,CSE 20,A01,083657,Tran; Khoa Dang,37,0,80,43
1656911205942,CSE 21,A01,095574,Bach; Quang Tran,21,0,48,27
1656911211966,CSE 30,A01,083084,Eldon; John,4,0,80,76
1656911211966,CSE 30,B01,095061,Bhaskar; Nishant,6,0,50,44
1656911217988,CSE 100,A01,083659,Cao; Yingjun,2,4,70,68
1656911224012,CSE 134B,A01,083661,Powell; Thomas Allan,19,0,100,81
1656911230039,CSE 140,A01,083663,Gungor; Onat,14,0,85,71
1656911236061,CSE 140L,A01,083088,Eldon; John,16,0,100,84
1656911242085,CSE 175,A01,083665,Kumar; Rakesh,3,0,25,22
1656911248109,CSE 190,A00,092507,Dubnov; Shlomo,7,0,20,13
1656911254133,ECE 45,A01,083139,Congero; Spencer William,5,0,75,70
1656911260156,ECE 65,A50,083695,Saad; Andrew S,12,0,30,18
1656911260156,ECE 65,A51,095125,Saad; Andrew S,25,0,26,1
1656911266192,ECE 109,A01,091882,Touri; Behrouz,16,0,70,54
1656911272220,ECE 180,A00,083140,Abi Samra; Nicholas Camill,0,0,30,30
1656911272220,ECE 180,B00,083141,Abi Samra; Nicholas Camill,0,0,30,30
1656911278247,MATH 10A,A01,083735,Patchell; Gregory David,1,0,30,29
1656911278247,MATH 10A,A02,083736,Patchell; Gregory David,20,0,30,10
1656911278247,MATH 10A,A03,083737,Patchell; Gregory David,15,0,30,15
1656911284271,MATH 10B,A01,083207,Lim; Seonhee,7,0,34,27
1656911284271,MATH 10B,A02,083208,Lim; Seonhee,9,0,35,26
1656911284271,MATH 10B,A03,093472,Lim; Seonhee,4,0,34,30
1656911284271,MATH 10B,B01,083739,Sinha; Shubham,9,0,30,21
1656911290294,MATH 18,A01,083743,Cinel; Cameron Alexander,6,0,30,24
1656911290294,MATH 18,A02,083744,Cinel; Cameron Alexander,15,0,30,15
1656911290294,MATH 18,A03,083745,Cinel; Cameron Alexander,8,0,30,22
1656911290294,MATH 18,B01,083748,Rideout; David Porter,4,0,37,33
1656911290294,MATH 18,B02,083749,Rideout; David Porter,3,0,36,33
1656911290294,MATH 18,B03,083750,Rideout; David Porter,2,0,37,35
1656911290294,MATH 18,B04,083751,Rideout; David Porter,5,0,36,31
1656911290294,MATH 18,B05,093473,Rideout; David Porter,4,0,36,32
1656911290294,MATH 18,B06,093474,Rideout; David Porter,5,0,36,31
1656911296317,MATH 20A,A01,083754,Zheng; Zequn,12,0,40,28
1656911302339,MATH 20B,A01,083756,Briones; Jor-el Thomas Caparas,1,0,36,35
1656911302339,MATH 20B,A02,083757,Briones; Jor-el Thomas Caparas,1,0,36,35
1656911302339,MATH 20B,A03,093475,Briones; Jor-el Thomas Caparas,0,0,36,36
1656911308367,MATH 20C,A01,083760,Briones; Jor-el Thomas Caparas,1,0,35,34
1656911308367,MATH 20C,A02,083761,Briones; Jor-el Thomas Caparas,8,0,35,27
1656911308367,MATH 20C,A03,093476,Briones; Jor-el Thomas Caparas,0,1,36,36
1656911308367,MATH 20C,B01,083762,Bach; Quang Tran,0,0,30,30
1656911314396,MATH 20D,A01,083765,Tran; Brian Kha,4,0,30,26
1656911314396,MATH 20D,A02,083766,Tran; Brian Kha,4,0,30,26
1656911314396,MATH 20D,A03,083767,Tran; Brian Kha,3,0,30,27
1656911320435,MATH 20E,A01,083771,Ganguly; Soumya,5,0,32,27
1656911320435,MATH 20E,A02,083772,Ganguly; Soumya,6,0,32,26
1656911320435,MATH 20E,B01,083773,Ciotti; Benjamin,18,0,35,17
1656911320435,MATH 20E,B02,083774,Ciotti; Benjamin,17,0,35,18
1656911326460,MATH 103A,A01,083777,Greenfeld; Be'Eri,2,0,36,34
1656911326460,MATH 103A,A02,083778,Greenfeld; Be'Eri,5,0,36,31
1656911326460,MATH 103A,A03,093561,Greenfeld; Be'Eri,4,0,36,32
1656911326460,MATH 103A,B01,083779,Greenfeld; Be'Eri,6,0,36,30
1656911326460,MATH 103A,B02,083780,Greenfeld; Be'Eri,2,0,36,34
1656911326460,MATH 103A,B03,093562,Greenfeld; Be'Eri,2,0,36,34
1656911332487,MATH 105,A01,085443,Carter; Anne Toulson,13,0,35,22
1656911332487,MATH 105,A02,093477,Carter; Anne Toulson,20,0,35,15
1656911338515,MATH 109,A01,083213,Ganzberger; Geoffrey Michael,2,0,34,32
1656911338515,MATH 109,A02,083214,Ganzberger; Geoffrey Michael,2,0,34,32
1656911338515,MATH 109,A03,093478,Ganzberger; Geoffrey Michael,1,0,34,33
1656911338515,MATH 109,B01,083215,Ganzberger; Geoffrey Michael,1,0,32,31
1656911338515,MATH 109,B02,083216,Ganzberger; Geoffrey Michael,1,0,32,31
1656911338515,MATH 109,B03,093479,Ganzberger; Geoffrey Michael,6,0,32,26
1656911344545,MATH 142A,A01,083219,Chow; Bennett,6,0,32,26
1656911344545,MATH 142A,A02,083220,Chow; Bennett,10,0,32,22
1656911344545,MATH 142A,A03,093480,Chow; Bennett,7,0,32,25
1656911344545,MATH 142A,B03,093481,Chow; Bennett,7,0,32,25
1656911344545,MATH 142A,B04,093558,Chow; Bennett,10,0,32,22
1656911344545,MATH 142A,B05,093559,Chow; Bennett,6,0,32,26
1656911350569,MATH 193A,A01,083224,Rotar; Vladimir,7,0,34,27
1656911350569,MATH 193A,A02,083225,Rotar; Vladimir,3,0,34,31
1656911350569,MATH 193A,A03,083781,Rotar; Vladimir,1,0,34,33
1656911350569,MATH 193A,A04,083782,Rotar; Vladimir,6,0,34,28
1656911350569,MATH 193A,A05,093482,Rotar; Vladimir,6,0,34,28
1656911356595,MATH 197,001,091859,McAuley; Julian John,9999,0,9999,0
1656911356595,MATH 197,002,095566,Kedlaya; Kiran S.,9997,0,9999,2
1656911356595,MATH 197,003,095567,Xiao; Ming,9999,0,9999,0
1656911356595,MATH 197,004,095571,Perols; Johan Lars,9998,0,9999,1
1656911363657,COGS 9,A01,083615,Shannon; Kyle Michael,7,0,75,68
1656911369680,COGS 11,A01,083617,Boyle; Mary E. T.,19,0,48,29
1656911375711,COGS 13,A01,083071,Bastos; Amalia Pinkusfeld,9,0,71,62
1656911381734,COGS 14A,A01,092681,Semenuks; Arturs,0,1,100,100
1656911387758,COGS 14B,A01,083073,Cheng; Tzu-Han,5,0,63,58
1656911393786,COGS 17,A01,092677,Semenuks; Arturs,4,0,81,77
1656911399809,COGS 100,A01,083619,Allen; Michael Gordon,15,0,70,55
1656911405835,COGS 101A,A01,083621,Davis; Joshua Daniel,9,0,68,59
1656911411859,COGS 101B,A01,091572,Allen; Michael Gordon,8,0,65,57
1656911417881,COGS 101C,A01,083625,Delgado; Tania,17,0,35,18
1656911423905,COGS 107A,A01,083627,Boyle; Mary E. T.,13,0,60,47
1656911429933,COGS 118A,A01,083075,Gupta; Anjum,15,0,76,61
1656911435961,CSE 3,A50,083646,Miranda; Gregory Joseph,22,0,50,28
1656911441988,CSE 8A,A50,083650,Miranda; Gregory Joseph,17,1,56,39
1656911448014,CSE 11,A01,083080,Cao; Yingjun,4,15,40,36
1656911454042,CSE 12,A01,083652,Krause-Levy; Sophia Louisa,20,1,120,100
1656911460064,CSE 15L,A01,083654,Morris; Justin Loren,8,0,50,42
1656911460064,CSE 15L,A02,083655,Morris; Justin Loren,8,0,50,42
1656911466094,CSE 20,A01,083657,Tran; Khoa Dang,37,0,80,43
1656911472121,CSE 21,A01,095574,Bach; Quang Tran,21,0,48,27
1656911478148,CSE 30,A01,083084,Eldon; John,4,0,80,76
1656911478148,CSE 30,B01,095061,Bhaskar; Nishant,6,0,50,44
1656911484171,CSE 100,A01,083659,Cao; Yingjun,2,4,70,68
1656911490194,CSE 134B,A01,083661,Powell; Thomas Allan,19,0,100,81
1656911496219,CSE 140,A01,083663,Gungor; Onat,14,0,85,71
1656911502247,CSE 140L,A01,083088,Eldon; John,16,0,100,84
1656911508273,CSE 175,A01,083665,Kumar; Rakesh,3,0,25,22
1656911514300,CSE 190,A00,092507,Dubnov; Shlomo,7,0,20,13
1656911520329,ECE 45,A01,083139,Congero; Spencer William,5,0,75,70
1656911526350,ECE 65,A50,083695,Saad; Andrew S,12,0,30,18
1656911526350,ECE 65,A51,095125,Saad; Andrew S,25,0,26,1
1656911532378,ECE 109,A01,091882,Touri; Behrouz,16,0,70,54
1656911538402,ECE 180,A00,083140,Abi Samra; Nicholas Camill,0,0,30,30
1656911538402,ECE 180,B00,083141,Abi Samra; Nicholas Camill,0,0,30,30
1656911544429,MATH 10A,A01,083735,Patchell; Gregory David,1,0,30,29
1656911544429,MATH 10A,A02,083736,Patchell; Gregory David,20,0,30,10
1656911544429,MATH 10A,A03,083737,Patchell; Gregory David,15,0,30,15
1656911550453,MATH 10B,A01,083207,Lim; Seonhee,7,0,34,27
1656911550453,MATH 10B,A02,083208,Lim; Seonhee,9,0,35,26
1656911550453,MATH 10B,A03,093472,Lim; Seonhee,4,0,34,30
1656911550453,MATH 10B,B01,083739,Sinha; Shubham,9,0,30,21
1656911556484,MATH 18,A01,083743,Cinel; Cameron Alexander,6,0,30,24
1656911556484,MATH 18,A02,083744,Cinel; Cameron Alexander,15,0,30,15
1656911556484,MATH 18,A03,083745,Cinel; Cameron Alexander,8,0,30,22
1656911556484,MATH 18,B01,083748,Rideout; David Porter,4,0,37,33
1656911556484,MATH 18,B02,083749,Rideout; David Porter,3,0,36,33
1656911556484,MATH 18,B03,083750,Rideout; David Porter,2,0,37,35
1656911556484,MATH 18,B04,083751,Rideout; David Porter,5,0,36,31
1656911556484,MATH 18,B05,093473,Rideout; David Porter,4,0,36,32
1656911556484,MATH 18,B06,093474,Rideout; David Porter,5,0,36,31
1656911562512,MATH 20A,A01,083754,Zheng; Zequn,12,0,40,28
1656911568552,MATH 20B,A01,083756,Briones; Jor-el Thomas Caparas,1,0,36,35
1656911568552,MATH 20B,A02,083757,Briones; Jor-el Thomas Caparas,1,0,36,35
1656911568552,MATH 20B,A03,093475,Briones; Jor-el Thomas Caparas,0,0,36,36
1656911574576,MATH 20C,A01,083760,Briones; Jor-el Thomas Caparas,1,0,35,34
1656911574576,MATH 20C,A02,083761,Briones; Jor-el Thomas Caparas,8,0,35,27
1656911574576,MATH 20C,A03,093476,Briones; Jor-el Thomas Caparas,0,1,36,36
1656911574576,MATH 20C,B01,083762,Bach; Quang Tran,0,0,30,30
1656911580604,MATH 20D,A01,083765,Tran; Brian Kha,4,0,30,26
1656911580604,MATH 20D,A02,083766,Tran; Brian Kha,4,0,30,26
1656911580604,MATH 20D,A03,083767,Tran; Brian Kha,3,0,30,27
1656911586626,MATH 20E,A01,083771,Ganguly; Soumya,5,0,32,27
1656911586626,MATH 20E,A02,083772,Ganguly; Soumya,6,0,32,26
1656911586626,MATH 20E,B01,083773,Ciotti; Benjamin,18,0,35,17
1656911586626,MATH 20E,B02,083774,Ciotti; Benjamin,17,0,35,18
1656911592648,MATH 103A,A01,083777,Greenfeld; Be'Eri,2,0,36,34
1656911592648,MATH 103A,A02,083778,Greenfeld; Be'Eri,5,0,36,31
1656911592648,MATH 103A,A03,093561,Greenfeld; Be'Eri,4,0,36,32
1656911592648,MATH 103A,B01,083779,Greenfeld; Be'Eri,6,0,36,30
1656911592648,MATH 103A,B02,083780,Greenfeld; Be'Eri,2,0,36,34
1656911592648,MATH 103A,B03,093562,Greenfeld; Be'Eri,2,0,36,34
1656911598670,MATH 105,A01,085443,Carter; Anne Toulson,13,0,35,22
1656911598670,MATH 105,A02,093477,Carter; Anne Toulson,20,0,35,15
1656911604702,MATH 109,A01,083213,Ganzberger; Geoffrey Michael,2,0,34,32
1656911604702,MATH 109,A02,083214,Ganzberger; Geoffrey Michael,2,0,34,32
1656911604702,MATH 109,A03,093478,Ganzberger; Geoffrey Michael,1,0,34,33
1656911604702,MATH 109,B01,083215,Ganzberger; Geoffrey Michael,1,0,32,31
1656911604702,MATH 109,B02,083216,Ganzberger; Geoffrey Michael,1,0,32,31
1656911604702,MATH 109,B03,093479,Ganzberger; Geoffrey Michael,6,0,32,26
1656911610730,MATH 142A,A01,083219,Chow; Bennett,6,0,32,26
1656911610730,MATH 142A,A02,083220,Chow; Bennett,10,0,32,22
1656911610730,MATH 142A,A03,093480,Chow; Bennett,7,0,32,25
1656911610730,MATH 142A,B03,093481,Chow; Bennett,7,0,32,25
1656911610730,MATH 142A,B04,093558,Chow; Bennett,10,0,32,22
1656911610730,MATH 142A,B05,093559,Chow; Bennett,6,0,32,26
1656911616755,MATH 193A,A01,083224,Rotar; Vladimir,7,0,34,27
1656911616755,MATH 193A,A02,083225,Rotar; Vladimir,3,0,34,31
1656911616755,MATH 193A,A03,083781,Rotar; Vladimir,1,0,34,33
1656911616755,MATH 193A,A04,083782,Rotar; Vladimir,6,0,34,28
1656911616755,MATH 193A,A05,093482,Rotar; Vladimir,6,0,34,28
1656911622780,MATH 197,001,091859,McAuley; Julian John,9999,0,9999,0
1656911622780,MATH 197,002,095566,Kedlaya; Kiran S.,9997,0,9999,2
1656911622780,MATH 197,003,095567,Xiao; Ming,9999,0,9999,0
1656911622780,MATH 197,004,095571,Perols; Johan Lars,9998,0,9999,1
1656911629841,COGS 9,A01,083615,Shannon; Kyle Michael,7,0,75,68
1656911635867,COGS 11,A01,083617,Boyle; Mary E. T.,19,0,48,29
1656911641894,COGS 13,A01,083071,Bastos; Amalia Pinkusfeld,9,0,71,62
1656911647920,COGS 14A,A01,092681,Semenuks; Arturs,0,1,100,100
1656911653943,COGS 14B,A01,083073,Cheng; Tzu-Han,5,0,63,58
1656911659970,COGS 17,A01,092677,Semenuks; Arturs,4,0,81,77
1656911665991,COGS 100,A01,083619,Allen; Michael Gordon,15,0,70,55
1656911672016,COGS 101A,A01,083621,Davis; Joshua Daniel,9,0,68,59
1656911678038,COGS 101B,A01,091572,Allen; Michael Gordon,8,0,65,57
1656911684062,COGS 101C,A01,083625,Delgado; Tania,17,0,35,18
1656911690085,COGS 107A,A01,083627,Boyle; Mary E. T.,13,0,60,47
1656911696108,COGS 118A,A01,083075,Gupta; Anjum,15,0,76,61
1656911702136,CSE 3,A50,083646,Miranda; Gregory Joseph,22,0,50,28
1656911708164,CSE 8A,A50,083650,Miranda; Gregory Joseph,17,1,56,39
1656911714280,CSE 11,A01,083080,Cao; Yingjun,4,15,40,36
1656911720307,CSE 12,A01,083652,Krause-Levy; Sophia Louisa,20,1,120,100
1656911726330,CSE 15L,A01,083654,Morris; Justin Loren,8,0,50,42
1656911726330,CSE 15L,A02,083655,Morris; Justin Loren,8,0,50,42
1656911732353,CSE 20,A01,083657,Tran; Khoa Dang,37,0,80,43
1656911738375,CSE 21,A01,095574,Bach; Quang Tran,21,0,48,27
1656911744399,CSE 30,A01,083084,Eldon; John,4,0,80,76
1656911744399,CSE 30,B01,095061,Bhaskar; Nishant,6,0,50,44
1656911750427,CSE 100,A01,083659,Cao; Yingjun,2,4,70,68
1656911756453,CSE 134B,A01,083661,Powell; Thomas Allan,19,0,100,81
1656911762477,CSE 140,A01,083663,Gungor; Onat,14,0,85,71
1656911768505,CSE 140L,A01,083088,Eldon; John,16,0,100,84
1656911774537,CSE 175,A01,083665,Kumar; Rakesh,3,0,25,22
1656911780561,CSE 190,A00,092507,Dubnov; Shlomo,7,0,20,13
1656911786584,ECE 45,A01,083139,Congero; Spencer William,5,0,75,70
1656911792610,ECE 65,A50,083695,Saad; Andrew S,12,0,30,18
1656911792610,ECE 65,A51,095125,Saad; Andrew S,25,0,26,1
1656911798636,ECE 109,A01,091882,Touri; Behrouz,16,0,70,54
1656911804658,ECE 180,A00,083140,Abi Samra; Nicholas Camill,0,0,30,30
1656911804658,ECE 180,B00,083141,Abi Samra; Nicholas Camill,0,0,30,30
1656911810682,MATH 10A,A01,083735,Patchell; Gregory David,1,0,30,29
1656911810682,MATH 10A,A02,083736,Patchell; Gregory David,20,0,30,10
1656911810682,MATH 10A,A03,083737,Patchell; Gregory David,15,0,30,15
1656911816707,MATH 10B,A01,083207,Lim; Seonhee,7,0,34,27
1656911816707,MATH 10B,A02,083208,Lim; Seonhee,9,0,35,26
1656911816707,MATH 10B,A03,093472,Lim; Seonhee,4,0,34,30
1656911816707,MATH 10B,B01,083739,Sinha; Shubham,9,0,30,21
1656911822732,MATH 18,A01,083743,Cinel; Cameron Alexander,6,0,30,24
1656911822732,MATH 18,A02,083744,Cinel; Cameron Alexander,15,0,30,15
1656911822732,MATH 18,A03,083745,Cinel; Cameron Alexander,8,0,30,22
1656911822732,MATH 18,B01,083748,Rideout; David Porter,4,0,37,33
1656911822732,MATH 18,B02,083749,Rideout; David Porter,3,0,36,33
1656911822732,MATH 18,B03,083750,Rideout; David Porter,2,0,37,35
1656911822732,MATH 18,B04,083751,Rideout; David Porter,5,0,36,31
1656911822732,MATH 18,B05,093473,Rideout; David Porter,4,0,36,32
1656911822732,MATH 18,B06,093474,Rideout; David Porter,5,0,36,31
1656911828755,MATH 20A,A01,083754,Zheng; Zequn,12,0,40,28
1656911834780,MATH 20B,A01,083756,Briones; Jor-el Thomas Caparas,1,0,36,35
1656911834780,MATH 20B,A02,083757,Briones; Jor-el Thomas Caparas,1,0,36,35
1656911834780,MATH 20B,A03,093475,Briones; Jor-el Thomas Caparas,0,0,36,36
1656911840811,MATH 20C,A01,083760,Briones; Jor-el Thomas Caparas,1,0,35,34
1656911840811,MATH 20C,A02,083761,Briones; Jor-el Thomas Caparas,8,0,35,27
1656911840811,MATH 20C,A03,093476,Briones; Jor-el Thomas Caparas,0,1,36,36
1656911840811,MATH 20C,B01,083762,Bach; Quang Tran,0,0,30,30
1656911846839,MATH 20D,A01,083765,Tran; Brian Kha,4,0,30,26
1656911846839,MATH 20D,A02,083766,Tran; Brian Kha,4,0,30,26
1656911846839,MATH 20D,A03,083767,Tran; Brian Kha,3,0,30,27
1656911852863,MATH 20E,A01,083771,Ganguly; Soumya,5,0,32,27
1656911852863,MATH 20E,A02,083772,Ganguly; Soumya,6,0,32,26
1656911852863,MATH 20E,B01,083773,Ciotti; Benjamin,18,0,35,17
1656911852863,MATH 20E,B02,083774,Ciotti; Benjamin,17,0,35,18
1656911858887,MATH 103A,A01,083777,Greenfeld; Be'Eri,2,0,36,34
1656911858887,MATH 103A,A02,083778,Greenfeld; Be'Eri,5,0,36,31
1656911858887,MATH 103A,A03,093561,Greenfeld; Be'Eri,4,0,36,32
1656911858887,MATH 103A,B01,083779,Greenfeld; Be'Eri,6,0,36,30
1656911858887,MATH 103A,B02,083780,Greenfeld; Be'Eri,2,0,36,34
1656911858887,MATH 103A,B03,093562,Greenfeld; Be'Eri,2,0,36,34
1656911864916,MATH 105,A01,085443,Carter; Anne Toulson,13,0,35,22
1656911864916,MATH 105,A02,093477,Carter; Anne Toulson,20,0,35,15
1656911870939,MATH 109,A01,083213,Ganzberger; Geoffrey Michael,2,0,34,32
1656911870939,MATH 109,A02,083214,Ganzberger; Geoffrey Michael,2,0,34,32
1656911870939,MATH 109,A03,093478,Ganzberger; Geoffrey Michael,1,0,34,33
1656911870939,MATH 109,B01,083215,Ganzberger; Geoffrey Michael,1,0,32,31
1656911870939,MATH 109,B02,083216,Ganzberger; Geoffrey Michael,1,0,32,31
1656911870939,MATH 109,B03,093479,Ganzberger; Geoffrey Michael,6,0,32,26
1656911876968,MATH 142A,A01,083219,Chow; Bennett,6,0,32,26
1656911876968,MATH 142A,A02,083220,Chow; Bennett,10,0,32,22
1656911876968,MATH 142A,A03,093480,Chow; Bennett,7,0,32,25
1656911876968,MATH 142A,B03,093481,Chow; Bennett,7,0,32,25
1656911876968,MATH 142A,B04,093558,Chow; Bennett,10,0,32,22
1656911876968,MATH 142A,B05,093559,Chow; Bennett,6,0,32,26
1656911882996,MATH 193A,A01,083224,Rotar; Vladimir,7,0,34,27
1656911882996,MATH 193A,A02,083225,Rotar; Vladimir,3,0,34,31
1656911882996,MATH 193A,A03,083781,Rotar; Vladimir,1,0,34,33
1656911882996,MATH 193A,A04,083782,Rotar; Vladimir,6,0,34,28
1656911882996,MATH 193A,A05,093482,Rotar; Vladimir,6,0,34,28
1656911889027,MATH 197,001,091859,McAuley; Julian John,9999,0,9999,0
1656911889027,MATH 197,002,095566,Kedlaya; Kiran S.,9997,0,9999,2
1656911889027,MATH 197,003,095567,Xiao; Ming,9999,0,9999,0
1656911889027,MATH 197,004,095571,Perols; Johan Lars,9998,0,9999,1
1656911896086,COGS 9,A01,083615,Shannon; Kyle Michael,7,0,75,68
1656911902116,COGS 11,A01,083617,Boyle; Mary E. T.,19,0,48,29
1656911908143,COGS 13,A01,083071,Bastos; Amalia Pinkusfeld,9,0,71,62
1656911914166,COGS 14A,A01,092681,Semenuks; Arturs,0,1,100,100
1656911920193,COGS 14B,A01,083073,Cheng; Tzu-Han,5,0,63,58
1656911926219,COGS 17,A01,092677,Semenuks; Arturs,4,0,81,77
1656911932246,COGS 100,A01,083619,Allen; Michael Gordon,15,0,70,55
1656911938273,COGS 101A,A01,083621,Davis; Joshua Daniel,9,0,68,59
1656911944297,COGS 101B,A01,091572,Allen; Michael Gordon,8,0,65,57
1656911950318,COGS 101C,A01,083625,Delgado; Tania,17,0,35,18
1656911956340,COGS 107A,A01,083627,Boyle; Mary E. T.,13,0,60,47
1656911962379,COGS 118A,A01,083075,Gupta; Anjum,15,0,76,61
1656911968403,CSE 3,A50,083646,Miranda; Gregory Joseph,22,0,50,28
1656911974435,CSE 8A,A50,083650,Miranda; Gregory Joseph,17,1,56,39
1656911980458,CSE 11,A01,083080,Cao; Yingjun,4,15,40,36
1656911986484,CSE 12,A01,083652,Krause-Levy; Sophia Louisa,20,1,120,100
1656911992511,CSE 15L,A01,083654,Morris; Justin Loren,8,0,50,42
1656911992511,CSE 15L,A02,083655,Morris; Justin Loren,8,0,50,42
1656911998535,CSE 20,A01,083657,Tran; Khoa Dang,37,0,80,43
1656912004559,CSE 21,A01,095574,Bach; Quang Tran,21,0,48,27
1656912010584,CSE 30,A01,083084,Eldon; John,4,0,80,76
1656912010584,CSE 30,B01,095061,Bhaskar; Nishant,6,0,50,44
1656912016607,CSE 100,A01,083659,Cao; Yingjun,2,4,70,68
1656912022631,CSE 134B,A01,083661,Powell; Thomas Allan,19,0,100,81
1656912028656,CSE 140,A01,083663,Gungor; Onat,14,0,85,71
1656912034682,CSE 140L,A01,083088,Eldon; John,16,0,100,84
1656912040704,CSE 175,A01,083665,Kumar; Rakesh,3,0,25,22
1656912046729,CSE 190,A00,092507,Dubnov; Shlomo,7,0,20,13
1656912052753,ECE 45,A01,083139,Congero; Spencer William,5,0,75,70
1656912058776,ECE 65,A50,083695,Saad; Andrew S,12,0,30,18
1656912058776,ECE 65,A51,095125,Saad; Andrew S,25,0,26,1
1656912064803,ECE 109,A01,091882,Touri; Behrouz,16,0,70,54
1656912070826,ECE 180,A00,083140,Abi Samra; Nicholas Camill,0,0,30,30
1656912070826,ECE 180,B00,083141,Abi Samra; Nicholas Camill,0,0,30,30
1656912076850,MATH 10A,A01,083735,Patchell; Gregory David,1,0,30,29
1656912076850,MATH 10A,A02,083736,Patchell; Gregory David,20,0,30,10
1656912076850,MATH 10A,A03,083737,Patchell; Gregory David,15,0,30,15
1656912082873,MATH 10B,A01,083207,Lim; Seonhee,7,0,34,27
1656912082873,MATH 10B,A02,083208,Lim; Seonhee,9,0,35,26
1656912082873,MATH 10B,A03,093472,Lim; Seonhee,4,0,34,30
1656912082873,MATH 10B,B01,083739,Sinha; Shubham,9,0,30,21
1656912088898,MATH 18,A01,083743,Cinel; Cameron Alexander,6,0,30,24
1656912088898,MATH 18,A02,083744,Cinel; Cameron Alexander,15,0,30,15
1656912088898,MATH 18,A03,083745,Cinel; Cameron Alexander,8,0,30,22
1656912088898,MATH 18,B01,083748,Rideout; David Porter,4,0,37,33
1656912088898,MATH 18,B02,083749,Rideout; David Porter,3,0,36,33
1656912088898,MATH 18,B03,083750,Rideout; David Porter,2,0,37,35
1656912088898,MATH 18,B04,083751,Rideout; David Porter,5,0,36,31
1656912088898,MATH 18,B05,093473,Rideout; David Porter,4,0,36,32
1656912088898,MATH 18,B06,093474,Rideout; David Porter,5,0,36,31
1656912094950,MATH 20A,A01,083754,Zheng; Zequn,12,0,40,28
1656912100973,MATH 20B,A01,083756,Briones; Jor-el Thomas Caparas,1,0,36,35
1656912100973,MATH 20B,A02,083757,Briones; Jor-el Thomas Caparas,1,0,36,35
1656912100973,MATH 20B,A03,093475,Briones; Jor-el Thomas Caparas,0,0,36,36
1656912106997,MATH 20C,A01,083760,Briones; Jor-el Thomas Caparas,1,0,35,34
1656912106997,MATH 20C,A02,083761,Briones; Jor-el Thomas Caparas,8,0,35,27
1656912106997,MATH 20C,A03,093476,Briones; Jor-el Thomas Caparas,0,1,36,36
1656912106997,MATH 20C,B01,083762,Bach; Quang Tran,0,0,30,30
1656912113022,MATH 20D,A01,083765,Tran; Brian Kha,4,0,30,26
1656912113022,MATH 20D,A02,083766,Tran; Brian Kha,4,0,30,26
1656912113022,MATH 20D,A03,083767,Tran; Brian Kha,3,0,30,27
1656912119045,MATH 20E,A01,083771,Ganguly; Soumya,5,0,32,27
1656912119045,MATH 20E,A02,083772,Ganguly; Soumya,6,0,32,26
1656912119045,MATH 20E,B01,083773,Ciotti; Benjamin,18,0,35,17
1656912119045,MATH 20E,B02,083774,Ciotti; Benjamin,17,0,35,18
1656912125068,MATH 103A,A01,083777,Greenfeld; Be'Eri,2,0,36,34
1656912125068,MATH 103A,A02,083778,Greenfeld; Be'Eri,5,0,36,31
1656912125068,MATH 103A,A03,093561,Greenfeld; Be'Eri,4,0,36,32
1656912125068,MATH 103A,B01,083779,Greenfeld; Be'Eri,6,0,36,30
1656912125068,MATH 103A,B02,083780,Greenfeld; Be'Eri,2,0,36,34
1656912125068,MATH 103A,B03,093562,Greenfeld; Be'Eri,2,0,36,34
1656912131097,MATH 105,A01,085443,Carter; Anne Toulson,13,0,35,22
1656912131097,MATH 105,A02,093477,Carter; Anne Toulson,20,0,35,15
1656912137121,MATH 109,A01,083213,Ganzberger; Geoffrey Michael,2,0,34,32
1656912137121,MATH 109,A02,083214,Ganzberger; Geoffrey Michael,2,0,34,32
1656912137121,MATH 109,A03,093478,Ganzberger; Geoffrey Michael,1,0,34,33
1656912137121,MATH 109,B01,083215,Ganzberger; Geoffrey Michael,1,0,32,31
1656912137121,MATH 109,B02,083216,Ganzberger; Geoffrey Michael,1,0,32,31
1656912137121,MATH 109,B03,093479,Ganzberger; Geoffrey Michael,6,0,32,26
1656912143145,MATH 142A,A01,083219,Chow; Bennett,6,0,32,26
1656912143145,MATH 142A,A02,083220,Chow; Bennett,10,0,32,22
1656912143145,MATH 142A,A03,093480,Chow; Bennett,7,0,32,25
1656912143145,MATH 142A,B03,093481,Chow; Bennett,7,0,32,25
1656912143145,MATH 142A,B04,093558,Chow; Bennett,10,0,32,22
1656912143145,MATH 142A,B05,093559,Chow; Bennett,6,0,32,26
1656912149173,MATH 193A,A01,083224,Rotar; Vladimir,7,0,34,27
1656912149173,MATH 193A,A02,083225,Rotar; Vladimir,3,0,34,31
1656912149173,MATH 193A,A03,083781,Rotar; Vladimir,1,0,34,33
1656912149173,MATH 193A,A04,083782,Rotar; Vladimir,6,0,34,28
1656912149173,MATH 193A,A05,093482,Rotar; Vladimir,6,0,34,28
1656912155205,MATH 197,001,091859,McAuley; Julian John,9999,0,9999,0
1656912155205,MATH 197,002,095566,Kedlaya; Kiran S.,9997,0,9999,2
1656912155205,MATH 197,003,095567,Xiao; Ming,9999,0,9999,0
1656912155205,MATH 197,004,095571,Perols; Johan Lars,9998,0,9999,1
1656912162259,COGS 9,A01,083615,Shannon; Kyle Michael,7,0,75,68
1656912168286,COGS 11,A01,083617,Boyle; Mary E. T.,19,0,48,29
1656912174309,COGS 13,A01,083071,Bastos; Amalia Pinkusfeld,9,0,71,62
1656912180335,COGS 14A,A01,092681,Semenuks; Arturs,0,1,100,100
1656912186361,COGS 14B,A01,083073,Cheng; Tzu-Han,5,0,63,58
1656912192383,COGS 17,A01,092677,Semenuks; Arturs,4,0,81,77
1656912198404,COGS 100,A01,083619,Allen; Michael Gordon,15,0,70,55
1656912204426,COGS 101A,A01,083621,Davis; Joshua Daniel,9,0,68,59
1656912210448,COGS 101B,A01,091572,Allen; Michael Gordon,8,0,65,57
1656912216472,COGS 101C,A01,083625,Delgado; Tania,17,0,35,18
1656912222494,COGS 107A,A01,083627,Boyle; Mary E. T.,13,0,60,47
1656912228518,COGS 118A,A01,083075,Gupta; Anjum,15,0,76,61
1656912234540,CSE 3,A50,083646,Miranda; Gregory Joseph,22,0,50,28
1656912240569,CSE 8A,A50,083650,Miranda; Gregory Joseph,17,1,56,39
1656912246595,CSE 11,A01,083080,Cao; Yingjun,4,15,40,36
1656912252617,CSE 12,A01,083652,Krause-Levy; Sophia Louisa,20,1,120,100
1656912258641,CSE 15L,A01,083654,Morris; Justin Loren,8,0,50,42
1656912258641,CSE 15L,A02,083655,Morris; Justin Loren,8,0,50,42
1656912264665,CSE 20,A01,083657,Tran; Khoa Dang,37,0,80,43
1656912270692,CSE 21,A01,095574,Bach; Quang Tran,21,0,48,27
1656912276716,CSE 30,A01,083084,Eldon; John,4,0,80,76
1656912276716,CSE 30,B01,095061,Bhaskar; Nishant,6,0,50,44
1656912282740,CSE 100,A01,083659,Cao; Yingjun,2,4,70,68
1656912288762,CSE 134B,A01,083661,Powell; Thomas Allan,19,0,100,81
1656912294786,CSE 140,A01,083663,Gungor; Onat,14,0,85,71
1656912300809,CSE 140L,A01,083088,Eldon; John,16,0,100,84
1656912306846,CSE 175,A01,083665,Kumar; Rakesh,3,0,25,22
1656912312945,CSE 190,A00,092507,Dubnov; Shlomo,7,0,20,13
1656912318968,ECE 45,A01,083139,Congero; Spencer William,5,0,75,70
1656912324991,ECE 65,A50,083695,Saad; Andrew S,12,0,30,18
1656912324991,ECE 65,A51,095125,Saad; Andrew S,25,0,26,1
1656912331018,ECE 109,A01,091882,Touri; Behrouz,16,0,70,54
1656912337045,ECE 180,A00,083140,Abi Samra; Nicholas Camill,0,0,30,30
1656912337045,ECE 180,B00,083141,Abi Samra; Nicholas Camill,0,0,30,30
1656912343070,MATH 10A,A01,083735,Patchell; Gregory David,1,0,30,29
1656912343070,MATH 10A,A02,083736,Patchell; Gregory David,20,0,30,10
1656912343070,MATH 10A,A03,083737,Patchell; Gregory David,15,0,30,15
1656912349092,MATH 10B,A01,083207,Lim; Seonhee,7,0,34,27
1656912349092,MATH 10B,A02,083208,Lim; Seonhee,9,0,35,26
1656912349092,MATH 10B,A03,093472,Lim; Seonhee,4,0,34,30
1656912349092,MATH 10B,B01,083739,Sinha; Shubham,9,0,30,21
1656912355122,MATH 18,A01,083743,Cinel; Cameron Alexander,6,0,30,24
1656912355122,MATH 18,A02,083744,Cinel; Cameron Alexander,15,0,30,15
1656912355122,MATH 18,A03,083745,Cinel; Cameron Alexander,8,0,30,22
1656912355122,MATH 18,B01,083748,Rideout; David Porter,4,0,37,33
1656912355122,MATH 18,B02,083749,Rideout; David Porter,3,0,36,33
1656912355122,MATH 18,B03,083750,Rideout; David Porter,2,0,37,35
1656912355122,MATH 18,B04,083751,Rideout; David Porter,5,0,36,31
1656912355122,MATH 18,B05,093473,Rideout; David Porter,4,0,36,32
1656912355122,MATH 18,B06,093474,Rideout; David Porter,5,0,36,31
1656912361147,MATH 20A,A01,083754,Zheng; Zequn,12,0,40,28
1656912367170,MATH 20B,A01,083756,Briones; Jor-el Thomas Caparas,1,0,36,35
1656912367170,MATH 20B,A02,083757,Briones; Jor-el Thomas Caparas,1,0,36,35
1656912367170,MATH 20B,A03,093475,Briones; Jor-el Thomas Caparas,0,0,36,36
1656912373198,MATH 20C,A01,083760,Briones; Jor-el Thomas Caparas,1,0,35,34
1656912373198,MATH 20C,A02,083761,Briones; Jor-el Thomas Caparas,8,0,35,27
1656912373198,MATH 20C,A03,093476,Briones; Jor-el Thomas Caparas,0,1,36,36
1656912373198,MATH 20C,B01,083762,Bach; Quang Tran,0,0,30,30
1656912379225,MATH 20D,A01,083765,Tran; Brian Kha,4,0,30,26
1656912379225,MATH 20D,A02,083766,Tran; Brian Kha,4,0,30,26
1656912379225,MATH 20D,A03,083767,Tran; Brian Kha,3,0,30,27
1656912385248,MATH 20E,A01,083771,Ganguly; Soumya,5,0,32,27
1656912385248,MATH 20E,A02,083772,Ganguly; Soumya,6,0,32,26
1656912385248,MATH 20E,B01,083773,Ciotti; Benjamin,18,0,35,17
1656912385248,MATH 20E,B02,083774,Ciotti; Benjamin,17,0,35,18
1656912391287,MATH 103A,A01,083777,Greenfeld; Be'Eri,2,0,36,34
1656912391287,MATH 103A,A02,083778,Greenfeld; Be'Eri,5,0,36,31
1656912391287,MATH 103A,A03,093561,Greenfeld; Be'Eri,4,0,36,32
1656912391287,MATH 103A,B01,083779,Greenfeld; Be'Eri,6,0,36,30
1656912391287,MATH 103A,B02,083780,Greenfeld; Be'Eri,2,0,36,34
1656912391287,MATH 103A,B03,093562,Greenfeld; Be'Eri,2,0,36,34
1656912397311,MATH 105,A01,085443,Carter; Anne Toulson,13,0,35,22
1656912397311,MATH 105,A02,093477,Carter; Anne Toulson,20,0,35,15
1656912403335,MATH 109,A01,083213,Ganzberger; Geoffrey Michael,2,0,34,32
1656912403335,MATH 109,A02,083214,Ganzberger; Geoffrey Michael,2,0,34,32
1656912403335,MATH 109,A03,093478,Ganzberger; Geoffrey Michael,1,0,34,33
1656912403335,MATH 109,B01,083215,Ganzberger; Geoffrey Michael,1,0,32,31
1656912403335,MATH 109,B02,083216,Ganzberger; Geoffrey Michael,1,0,32,31
1656912403335,MATH 109,B03,093479,Ganzberger; Geoffrey Michael,6,0,32,26
1656912409372,MATH 142A,A01,083219,Chow; Bennett,6,0,32,26
1656912409372,MATH 142A,A02,083220,Chow; Bennett,10,0,32,22
1656912409372,MATH 142A,A03,093480,Chow; Bennett,7,0,32,25
1656912409372,MATH 142A,B03,093481,Chow; Bennett,7,0,32,25
1656912409372,MATH 142A,B04,093558,Chow; Bennett,10,0,32,22
1656912409372,MATH 142A,B05,093559,Chow; Bennett,6,0,32,26
1656912415395,MATH 193A,A01,083224,Rotar; Vladimir,7,0,34,27
1656912415395,MATH 193A,A02,083225,Rotar; Vladimir,3,0,34,31
1656912415395,MATH 193A,A03,083781,Rotar; Vladimir,1,0,34,33
1656912415395,MATH 193A,A04,083782,Rotar; Vladimir,6,0,34,28
1656912415395,MATH 193A,A05,093482,Rotar; Vladimir,6,0,34,28
1656912421421,MATH 197,001,091859,McAuley; Julian John,9999,0,9999,0
1656912421421,MATH 197,002,095566,Kedlaya; Kiran S.,9997,0,9999,2
1656912421421,MATH 197,003,095567,Xiao; Ming,9999,0,9999,0
1656912421421,MATH 197,004,095571,Perols; Johan Lars,9998,0,9999,1
1656912428484,COGS 9,A01,083615,Shannon; Kyle Michael,7,0,75,68
1656912434506,COGS 11,A01,083617,Boyle; Mary E. T.,19,0,48,29
1656912440535,COGS 13,A01,083071,Bastos; Amalia Pinkusfeld,9,0,71,62
1656912446561,COGS 14A,A01,092681,Semenuks; Arturs,0,1,100,100
1656912452584,COGS 14B,A01,083073,Cheng; Tzu-Han,5,0,63,58
1656912458608,COGS 17,A01,092677,Semenuks; Arturs,4,0,81,77
1656912464631,COGS 100,A01,083619,Allen; Michael Gordon,15,0,70,55
1656912470654,COGS 101A,A01,083621,Davis; Joshua Daniel,9,0,68,59
1656912476677,COGS 101B,A01,091572,Allen; Michael Gordon,8,0,65,57
1656912482702,COGS 101C,A01,083625,Delgado; Tania,17,0,35,18
1656912488726,COGS 107A,A01,083627,Boyle; Mary E. T.,13,0,60,47
1656912494761,COGS 118A,A01,083075,Gupta; Anjum,15,0,76,61
1656912500785,CSE 3,A50,083646,Miranda; Gregory Joseph,22,0,50,28
1656912506810,CSE 8A,A50,083650,Miranda; Gregory Joseph,17,1,56,39
1656912512833,CSE 11,A01,083080,Cao; Yingjun,4,15,40,36
1656912518857,CSE 12,A01,083652,Krause-Levy; Sophia Louisa,20,1,120,100
1656912524878,CSE 15L,A01,083654,Morris; Justin Loren,8,0,50,42
1656912524878,CSE 15L,A02,083655,Morris; Justin Loren,8,0,50,42
1656912530903,CSE 20,A01,083657,Tran; Khoa Dang,37,0,80,43
1656912536928,CSE 21,A01,095574,Bach; Quang Tran,21,0,48,27
1656912542955,CSE 30,A01,083084,Eldon; John,4,0,80,76
1656912542955,CSE 30,B01,095061,Bhaskar; Nishant,6,0,50,44
1656912548981,CSE 100,A01,083659,Cao; Yingjun,2,4,70,68
1656912555003,CSE 134B,A01,083661,Powell; Thomas Allan,19,0,100,81
1656912561026,CSE 140,A01,083663,Gungor; Onat,14,0,85,71
1656912567048,CSE 140L,A01,083088,Eldon; John,16,0,100,84
1656912573071,CSE 175,A01,083665,Kumar; Rakesh,3,0,25,22
1656912579092,CSE 190,A00,092507,Dubnov; Shlomo,7,0,20,13
1656912585116,ECE 45,A01,083139,Congero; Spencer William,5,0,75,70
1656912591144,ECE 65,A50,083695,Saad; Andrew S,12,0,30,18
1656912591144,ECE 65,A51,095125,Saad; Andrew S,25,0,26,1
1656912597170,ECE 109,A01,091882,Touri; Behrouz,16,0,70,54
1656912603196,ECE 180,A00,083140,Abi Samra; Nicholas Camill,0,0,30,30
1656912603196,ECE 180,B00,083141,Abi Samra; Nicholas Camill,0,0,30,30
1656912609218,MATH 10A,A01,083735,Patchell; Gregory David,1,0,30,29
1656912609218,MATH 10A,A02,083736,Patchell; Gregory David,20,0,30,10
1656912609218,MATH 10A,A03,083737,Patchell; Gregory David,15,0,30,15
1656912615248,MATH 10B,A01,083207,Lim; Seonhee,7,0,34,27
1656912615248,MATH 10B,A02,083208,Lim; Seonhee,9,0,35,26
1656912615248,MATH 10B,A03,093472,Lim; Seonhee,4,0,34,30
1656912615248,MATH 10B,B01,083739,Sinha; Shubham,9,0,30,21
1656912621281,MATH 18,A01,083743,Cinel; Cameron Alexander,6,0,30,24
1656912621281,MATH 18,A02,083744,Cinel; Cameron Alexander,15,0,30,15
1656912621281,MATH 18,A03,083745,Cinel; Cameron Alexander,8,0,30,22
1656912621281,MATH 18,B01,083748,Rideout; David Porter,4,0,37,33
1656912621281,MATH 18,B02,083749,Rideout; David Porter,3,0,36,33
1656912621281,MATH 18,B03,083750,Rideout; David Porter,2,0,37,35
1656912621281,MATH 18,B04,083751,Rideout; David Porter,5,0,36,31
1656912621281,MATH 18,B05,093473,Rideout; David Porter,4,0,36,32
1656912621281,MATH 18,B06,093474,Rideout; David Porter,5,0,36,31
1656912627304,MATH 20A,A01,083754,Zheng; Zequn,12,0,40,28
1656912633328,MATH 20B,A01,083756,Briones; Jor-el Thomas Caparas,1,0,36,35
1656912633328,MATH 20B,A02,083757,Briones; Jor-el Thomas Caparas,1,0,36,35
1656912633328,MATH 20B,A03,093475,Briones; Jor-el Thomas Caparas,0,0,36,36
1656912639357,MATH 20C,A01,083760,Briones; Jor-el Thomas Caparas,1,0,35,34
1656912639357,MATH 20C,A02,083761,Briones; Jor-el Thomas Caparas,8,0,35,27
1656912639357,MATH 20C,A03,093476,Briones; Jor-el Thomas Caparas,0,1,36,36
1656912639357,MATH 20C,B01,083762,Bach; Quang Tran,0,0,30,30
1656912645385,MATH 20D,A01,083765,Tran; Brian Kha,4,0,30,26
1656912645385,MATH 20D,A02,083766,Tran; Brian Kha,4,0,30,26
1656912645385,MATH 20D,A03,083767,Tran; Brian Kha,3,0,30,27
1656912651407,MATH 20E,A01,083771,Ganguly; Soumya,5,0,32,27
1656912651407,MATH 20E,A02,083772,Ganguly; Soumya,6,0,32,26
1656912651407,MATH 20E,B01,083773,Ciotti; Benjamin,18,0,35,17
1656912651407,MATH 20E,B02,083774,Ciotti; Benjamin,17,0,35,18
1656912657432,MATH 103A,A01,083777,Greenfeld; Be'Eri,2,0,36,34
1656912657432,MATH 103A,A02,083778,Greenfeld; Be'Eri,5,0,36,31
1656912657432,MATH 103A,A03,093561,Greenfeld; Be'Eri,4,0,36,32
1656912657432,MATH 103A,B01,083779,Greenfeld; Be'Eri,6,0,36,30
1656912657432,MATH 103A,B02,083780,Greenfeld; Be'Eri,2,0,36,34
1656912657432,MATH 103A,B03,093562,Greenfeld; Be'Eri,2,0,36,34
1656912663456,MATH 105,A01,085443,Carter; Anne Toulson,13,0,35,22
1656912663456,MATH 105,A02,093477,Carter; Anne Toulson,20,0,35,15
1656912669485,MATH 109,A01,083213,Ganzberger; Geoffrey Michael,2,0,34,32
1656912669485,MATH 109,A02,083214,Ganzberger; Geoffrey Michael,2,0,34,32
1656912669485,MATH 109,A03,093478,Ganzberger; Geoffrey Michael,1,0,34,33
1656912669485,MATH 109,B01,083215,Ganzberger; Geoffrey Michael,1,0,32,31
1656912669485,MATH 109,B02,083216,Ganzberger; Geoffrey Michael,1,0,32,31
1656912669485,MATH 109,B03,093479,Ganzberger; Geoffrey Michael,6,0,32,26
1656912675512,MATH 142A,A01,083219,Chow; Bennett,6,0,32,26
1656912675512,MATH 142A,A02,083220,Chow; Bennett,10,0,32,22
1656912675512,MATH 142A,A03,093480,Chow; Bennett,7,0,32,25
1656912675512,MATH 142A,B03,093481,Chow; Bennett,7,0,32,25
1656912675512,MATH 142A,B04,093558,Chow; Bennett,10,0,32,22
1656912675512,MATH 142A,B05,093559,Chow; Bennett,6,0,32,26
1656912681535,MATH 193A,A01,083224,Rotar; Vladimir,7,0,34,27
1656912681535,MATH 193A,A02,083225,Rotar; Vladimir,3,0,34,31
1656912681535,MATH 193A,A03,083781,Rotar; Vladimir,1,0,34,33
1656912681535,MATH 193A,A04,083782,Rotar; Vladimir,6,0,34,28
1656912681535,MATH 193A,A05,093482,Rotar; Vladimir,6,0,34,28
1656912687558,MATH 197,001,091859,McAuley; Julian John,9999,0,9999,0
1656912687558,MATH 197,002,095566,Kedlaya; Kiran S.,9997,0,9999,2
1656912687558,MATH 197,003,095567,Xiao; Ming,9999,0,9999,0
1656912687558,MATH 197,004,095571,Perols; Johan Lars,9998,0,9999,1
1656912694626,COGS 9,A01,083615,Shannon; Kyle Michael,7,0,75,68
1656912700647,COGS 11,A01,083617,Boyle; Mary E. T.,19,0,48,29
1656912706670,COGS 13,A01,083071,Bastos; Amalia Pinkusfeld,9,0,71,62
1656912712693,COGS 14A,A01,092681,Semenuks; Arturs,0,1,100,100
1656912718719,COGS 14B,A01,083073,Cheng; Tzu-Han,5,0,63,58
1656912724744,COGS 17,A01,092677,Semenuks; Arturs,4,0,81,77
1656912730764,COGS 100,A01,083619,Allen; Michael Gordon,15,0,70,55
1656912736787,COGS 101A,A01,083621,Davis; Joshua Daniel,9,0,68,59
1656912742813,COGS 101B,A01,091572,Allen; Michael Gordon,8,0,65,57
1656912748836,COGS 101C,A01,083625,Delgado; Tania,17,0,35,18
1656912754859,COGS 107A,A01,083627,Boyle; Mary E. T.,13,0,60,47
1656912760884,COGS 118A,A01,083075,Gupta; Anjum,15,0,76,61
1656912766908,CSE 3,A50,083646,Miranda; Gregory Joseph,22,0,50,28
1656912772933,CSE 8A,A50,083650,Miranda; Gregory Joseph,17,1,56,39
1656912778959,CSE 11,A01,083080,Cao; Yingjun,4,15,40,36
1656912784988,CSE 12,A01,083652,Krause-Levy; Sophia Louisa,20,1,120,100
1656912791014,CSE 15L,A01,083654,Morris; Justin Loren,8,0,50,42
1656912791014,CSE 15L,A02,083655,Morris; Justin Loren,8,0,50,42
1656912797036,CSE 20,A01,083657,Tran; Khoa Dang,37,0,80,43
1656912803068,CSE 21,A01,095574,Bach; Quang Tran,21,0,48,27
1656912809091,CSE 30,A01,083084,Eldon; John,4,0,80,76
1656912809091,CSE 30,B01,095061,Bhaskar; Nishant,6,0,50,44
1656912815113,CSE 100,A01,083659,Cao; Yingjun,2,4,70,68
1656912821136,CSE 134B,A01,083661,Powell; Thomas Allan,19,0,100,81
1656912827159,CSE 140,A01,083663,Gungor; Onat,14,0,85,71
1656912833194,CSE 140L,A01,083088,Eldon; John,16,0,100,84
1656912839216,CSE 175,A01,083665,Kumar; Rakesh,3,0,25,22
1656912845245,CSE 190,A00,092507,Dubnov; Shlomo,7,0,20,13
1656912851272,ECE 45,A01,083139,Congero; Spencer William,5,0,75,70
1656912857303,ECE 65,A50,083695,Saad; Andrew S,12,0,30,18
1656912857303,ECE 65,A51,095125,Saad; Andrew S,25,0,26,1
1656912863334,ECE 109,A01,091882,Touri; Behrouz,16,0,70,54
1656912869379,ECE 180,A00,083140,Abi Samra; Nicholas Camill,0,0,30,30
1656912869379,ECE 180,B00,083141,Abi Samra; Nicholas Camill,0,0,30,30
1656912875403,MATH 10A,A01,083735,Patchell; Gregory David,1,0,30,29
1656912875403,MATH 10A,A02,083736,Patchell; Gregory David,20,0,30,10
1656912875403,MATH 10A,A03,083737,Patchell; Gregory David,15,0,30,15
1656912881427,MATH 10B,A01,083207,Lim; Seonhee,7,0,34,27
1656912881427,MATH 10B,A02,083208,Lim; Seonhee,9,0,35,26
1656912881427,MATH 10B,A03,093472,Lim; Seonhee,4,0,34,30
1656912881427,MATH 10B,B01,083739,Sinha; Shubham,9,0,30,21
1656912887456,MATH 18,A01,083743,Cinel; Cameron Alexander,6,0,30,24
1656912887456,MATH 18,A02,083744,Cinel; Cameron Alexander,15,0,30,15
1656912887456,MATH 18,A03,083745,Cinel; Cameron Alexander,8,0,30,22
1656912887456,MATH 18,B01,083748,Rideout; David Porter,4,0,37,33
1656912887456,MATH 18,B02,083749,Rideout; David Porter,3,0,36,33
1656912887456,MATH 18,B03,083750,Rideout; David Porter,2,0,37,35
1656912887456,MATH 18,B04,083751,Rideout; David Porter,5,0,36,31
1656912887456,MATH 18,B05,093473,Rideout; David Porter,4,0,36,32
1656912887456,MATH 18,B06,093474,Rideout; David Porter,5,0,36,31
1656912893478,MATH 20A,A01,083754,Zheng; Zequn,12,0,40,28
1656912899502,MATH 20B,A01,083756,Briones; Jor-el Thomas Caparas,1,0,36,35
1656912899502,MATH 20B,A02,083757,Briones; Jor-el Thomas Caparas,1,0,36,35
1656912899502,MATH 20B,A03,093475,Briones; Jor-el Thomas Caparas,0,0,36,36
1656912905530,MATH 20C,A01,083760,Briones; Jor-el Thomas Caparas,1,0,35,34
1656912905530,MATH 20C,A02,083761,Briones; Jor-el Thomas Caparas,8,0,35,27
1656912905530,MATH 20C,A03,093476,Briones; Jor-el Thomas Caparas,0,1,36,36
1656912905530,MATH 20C,B01,083762,Bach; Quang Tran,0,0,30,30
1656912911627,MATH 20D,A01,083765,Tran; Brian Kha,4,0,30,26
1656912911627,MATH 20D,A02,083766,Tran; Brian Kha,4,0,30,26
1656912911627,MATH 20D,A03,083767,Tran; Brian Kha,3,0,30,27
1656912917650,MATH 20E,A01,083771,Ganguly; Soumya,5,0,32,27
1656912917650,MATH 20E,A02,083772,Ganguly; Soumya,6,0,32,26
1656912917650,MATH 20E,B01,083773,Ciotti; Benjamin,18,0,35,17
1656912917650,MATH 20E,B02,083774,Ciotti; Benjamin,17,0,35,18
1656912923674,MATH 103A,A01,083777,Greenfeld; Be'Eri,2,0,36,34
1656912923674,MATH 103A,A02,083778,Greenfeld; Be'Eri,5,0,36,31
1656912923674,MATH 103A,A03,093561,Greenfeld; Be'Eri,4,0,36,32
1656912923674,MATH 103A,B01,083779,Greenfeld; Be'Eri,6,0,36,30
1656912923674,MATH 103A,B02,083780,Greenfeld; Be'Eri,2,0,36,34
1656912923674,MATH 103A,B03,093562,Greenfeld; Be'Eri,2,0,36,34
1656912929698,MATH 105,A01,085443,Carter; Anne Toulson,13,0,35,22
1656912929698,MATH 105,A02,093477,Carter; Anne Toulson,20,0,35,15
1656912935727,MATH 109,A01,083213,Ganzberger; Geoffrey Michael,2,0,34,32
1656912935727,MATH 109,A02,083214,Ganzberger; Geoffrey Michael,2,0,34,32
1656912935727,MATH 109,A03,093478,Ganzberger; Geoffrey Michael,1,0,34,33
1656912935727,MATH 109,B01,083215,Ganzberger; Geoffrey Michael,1,0,32,31
1656912935727,MATH 109,B02,083216,Ganzberger; Geoffrey Michael,1,0,32,31
1656912935727,MATH 109,B03,093479,Ganzberger; Geoffrey Michael,6,0,32,26
1656912941755,MATH 142A,A01,083219,Chow; Bennett,6,0,32,26
1656912941755,MATH 142A,A02,083220,Chow; Bennett,10,0,32,22
1656912941755,MATH 142A,A03,093480,Chow; Bennett,7,0,32,25
1656912941755,MATH 142A,B03,093481,Chow; Bennett,7,0,32,25
1656912941755,MATH 142A,B04,093558,Chow; Bennett,10,0,32,22
1656912941755,MATH 142A,B05,093559,Chow; Bennett,6,0,32,26
1656912947780,MATH 193A,A01,083224,Rotar; Vladimir,7,0,34,27
1656912947780,MATH 193A,A02,083225,Rotar; Vladimir,3,0,34,31
1656912947780,MATH 193A,A03,083781,Rotar; Vladimir,1,0,34,33
1656912947780,MATH 193A,A04,083782,Rotar; Vladimir,6,0,34,28
1656912947780,MATH 193A,A05,093482,Rotar; Vladimir,6,0,34,28
1656912953806,MATH 197,001,091859,McAuley; Julian John,9999,0,9999,0
1656912953806,MATH 197,002,095566,Kedlaya; Kiran S.,9997,0,9999,2
1656912953806,MATH 197,003,095567,Xiao; Ming,9999,0,9999,0
1656912953806,MATH 197,004,095571,Perols; Johan Lars,9998,0,9999,1
1656912960872,COGS 9,A01,083615,Shannon; Kyle Michael,7,0,75,68
1656912966899,COGS 11,A01,083617,Boyle; Mary E. T.,19,0,48,29
1656912972923,COGS 13,A01,083071,Bastos; Amalia Pinkusfeld,9,0,71,62
1656912978946,COGS 14A,A01,092681,Semenuks; Arturs,0,1,100,100
1656912984973,COGS 14B,A01,083073,Cheng; Tzu-Han,5,0,63,58
1656912991004,COGS 17,A01,092677,Semenuks; Arturs,4,0,81,77
1656912997030,COGS 100,A01,083619,Allen; Michael Gordon,15,0,70,55
1656913003057,COGS 101A,A01,083621,Davis; Joshua Daniel,9,0,68,59
1656913009080,COGS 101B,A01,091572,Allen; Michael Gordon,8,0,65,57
1656913015108,COGS 101C,A01,083625,Delgado; Tania,17,0,35,18
1656913021131,COGS 107A,A01,083627,Boyle; Mary E. T.,13,0,60,47
1656913027154,COGS 118A,A01,083075,Gupta; Anjum,15,0,76,61
1656913033184,CSE 3,A50,083646,Miranda; Gregory Joseph,22,0,50,28
1656913039206,CSE 8A,A50,083650,Miranda; Gregory Joseph,17,1,56,39
1656913045229,CSE 11,A01,083080,Cao; Yingjun,4,15,40,36
1656913051254,CSE 12,A01,083652,Krause-Levy; Sophia Louisa,20,1,120,100
1656913057279,CSE 15L,A01,083654,Morris; Justin Loren,8,0,50,42
1656913057279,CSE 15L,A02,083655,Morris; Justin Loren,8,0,50,42
1656913063306,CSE 20,A01,083657,Tran; Khoa Dang,37,0,80,43
1656913069328,CSE 21,A01,095574,Bach; Quang Tran,21,0,48,27
1656913075352,CSE 30,A01,083084,Eldon; John,4,0,80,76
1656913075352,CSE 30,B01,095061,Bhaskar; Nishant,6,0,50,44
1656913081383,CSE 100,A01,083659,Cao; Yingjun,2,4,70,68
1656913087407,CSE 134B,A01,083661,Powell; Thomas Allan,19,0,100,81
1656913093430,CSE 140,A01,083663,Gungor; Onat,14,0,85,71
1656913099454,CSE 140L,A01,083088,Eldon; John,16,0,100,84
1656913105479,CSE 175,A01,083665,Kumar; Rakesh,3,0,25,22
1656913111502,CSE 190,A00,092507,Dubnov; Shlomo,7,0,20,13
1656913117528,ECE 45,A01,083139,Congero; Spencer William,5,0,75,70
1656913123552,ECE 65,A50,083695,Saad; Andrew S,12,0,30,18
1656913123552,ECE 65,A51,095125,Saad; Andrew S,25,0,26,1
1656913129577,ECE 109,A01,091882,Touri; Behrouz,16,0,70,54
1656913135601,ECE 180,A00,083140,Abi Samra; Nicholas Camill,0,0,30,30
1656913135601,ECE 180,B00,083141,Abi Samra; Nicholas Camill,0,0,30,30
1656913141623,MATH 10A,A01,083735,Patchell; Gregory David,1,0,30,29
1656913141623,MATH 10A,A02,083736,Patchell; Gregory David,20,0,30,10
1656913141623,MATH 10A,A03,083737,Patchell; Gregory David,15,0,30,15
1656913147651,MATH 10B,A01,083207,Lim; Seonhee,7,0,34,27
1656913147651,MATH 10B,A02,083208,Lim; Seonhee,9,0,35,26
1656913147651,MATH 10B,A03,093472,Lim; Seonhee,4,0,34,30
1656913147651,MATH 10B,B01,083739,Sinha; Shubham,9,0,30,21
1656913153675,MATH 18,A01,083743,Cinel; Cameron Alexander,6,0,30,24
1656913153675,MATH 18,A02,083744,Cinel; Cameron Alexander,15,0,30,15
1656913153675,MATH 18,A03,083745,Cinel; Cameron Alexander,8,0,30,22
1656913153675,MATH 18,B01,083748,Rideout; David Porter,4,0,37,33
1656913153675,MATH 18,B02,083749,Rideout; David Porter,3,0,36,33
1656913153675,MATH 18,B03,083750,Rideout; David Porter,2,0,37,35
1656913153675,MATH 18,B04,083751,Rideout; David Porter,5,0,36,31
1656913153675,MATH 18,B05,093473,Rideout; David Porter,4,0,36,32
1656913153675,MATH 18,B06,093474,Rideout; David Porter,5,0,36,31
1656913159700,MATH 20A,A01,083754,Zheng; Zequn,12,0,40,28
1656913165723,MATH 20B,A01,083756,Briones; Jor-el Thomas Caparas,1,0,36,35
1656913165723,MATH 20B,A02,083757,Briones; Jor-el Thomas Caparas,1,0,36,35
1656913165723,MATH 20B,A03,093475,Briones; Jor-el Thomas Caparas,0,0,36,36
1656913171746,MATH 20C,A01,083760,Briones; Jor-el Thomas Caparas,1,0,35,34
1656913171746,MATH 20C,A02,083761,Briones; Jor-el Thomas Caparas,8,0,35,27
1656913171746,MATH 20C,A03,093476,Briones; Jor-el Thomas Caparas,0,1,36,36
1656913171746,MATH 20C,B01,083762,Bach; Quang Tran,0,0,30,30
1656913177772,MATH 20D,A01,083765,Tran; Brian Kha,4,0,30,26
1656913177772,MATH 20D,A02,083766,Tran; Brian Kha,4,0,30,26
1656913177772,MATH 20D,A03,083767,Tran; Brian Kha,3,0,30,27
1656913183795,MATH 20E,A01,083771,Ganguly; Soumya,5,0,32,27
1656913183795,MATH 20E,A02,083772,Ganguly; Soumya,6,0,32,26
1656913183795,MATH 20E,B01,083773,Ciotti; Benjamin,18,0,35,17
1656913183795,MATH 20E,B02,083774,Ciotti; Benjamin,17,0,35,18
1656913189818,MATH 103A,A01,083777,Greenfeld; Be'Eri,2,0,36,34
1656913189818,MATH 103A,A02,083778,Greenfeld; Be'Eri,5,0,36,31
1656913189818,MATH 103A,A03,093561,Greenfeld; Be'Eri,4,0,36,32
1656913189818,MATH 103A,B01,083779,Greenfeld; Be'Eri,6,0,36,30
1656913189818,MATH 103A,B02,083780,Greenfeld; Be'Eri,2,0,36,34
1656913189818,MATH 103A,B03,093562,Greenfeld; Be'Eri,2,0,36,34
1656913195845,MATH 105,A01,085443,Carter; Anne Toulson,13,0,35,22
1656913195845,MATH 105,A02,093477,Carter; Anne Toulson,20,0,35,15
1656913201869,MATH 109,A01,083213,Ganzberger; Geoffrey Michael,2,0,34,32
1656913201869,MATH 109,A02,083214,Ganzberger; Geoffrey Michael,2,0,34,32
1656913201869,MATH 109,A03,093478,Ganzberger; Geoffrey Michael,1,0,34,33
1656913201869,MATH 109,B01,083215,Ganzberger; Geoffrey Michael,1,0,32,31
1656913201869,MATH 109,B02,083216,Ganzberger; Geoffrey Michael,1,0,32,31
1656913201869,MATH 109,B03,093479,Ganzberger; Geoffrey Michael,6,0,32,26
1656913207892,MATH 142A,A01,083219,Chow; Bennett,6,0,32,26
1656913207892,MATH 142A,A02,083220,Chow; Bennett,10,0,32,22
1656913207892,MATH 142A,A03,093480,Chow; Bennett,7,0,32,25
1656913207892,MATH 142A,B03,093481,Chow; Bennett,7,0,32,25
1656913207892,MATH 142A,B04,093558,Chow; Bennett,10,0,32,22
1656913207892,MATH 142A,B05,093559,Chow; Bennett,6,0,32,26
1656913213920,MATH 193A,A01,083224,Rotar; Vladimir,7,0,34,27
1656913213920,MATH 193A,A02,083225,Rotar; Vladimir,3,0,34,31
1656913213920,MATH 193A,A03,083781,Rotar; Vladimir,1,0,34,33
1656913213920,MATH 193A,A04,083782,Rotar; Vladimir,6,0,34,28
1656913213920,MATH 193A,A05,093482,Rotar; Vladimir,6,0,34,28
1656913219945,MATH 197,001,091859,McAuley; Julian John,9999,0,9999,0
1656913219945,MATH 197,002,095566,Kedlaya; Kiran S.,9997,0,9999,2
1656913219945,MATH 197,003,095567,Xiao; Ming,9999,0,9999,0
1656913219945,MATH 197,004,095571,Perols; Johan Lars,9998,0,9999,1
1656913227010,COGS 9,A01,083615,Shannon; Kyle Michael,7,0,75,68
1656913233033,COGS 11,A01,083617,Boyle; Mary E. T.,19,0,48,29
1656913239060,COGS 13,A01,083071,Bastos; Amalia Pinkusfeld,9,0,71,62
1656913245087,COGS 14A,A01,092681,Semenuks; Arturs,0,1,100,100
1656913251110,COGS 14B,A01,083073,Cheng; Tzu-Han,5,0,63,58
1656913257142,COGS 17,A01,092677,Semenuks; Arturs,4,0,81,77
1656913263165,COGS 100,A01,083619,Allen; Michael Gordon,15,0,70,55
1656913269190,COGS 101A,A01,083621,Davis; Joshua Daniel,9,0,68,59
1656913275216,COGS 101B,A01,091572,Allen; Michael Gordon,8,0,65,57
1656913281238,COGS 101C,A01,083625,Delgado; Tania,17,0,35,18
1656913287261,COGS 107A,A01,083627,Boyle; Mary E. T.,13,0,60,47
1656913293298,COGS 118A,A01,083075,Gupta; Anjum,15,0,76,61
1656913299322,CSE 3,A50,083646,Miranda; Gregory Joseph,22,0,50,28
1656913305347,CSE 8A,A50,083650,Miranda; Gregory Joseph,17,1,56,39
1656913311371,CSE 11,A01,083080,Cao; Yingjun,4,15,40,36
1656913317395,CSE 12,A01,083652,Krause-Levy; Sophia Louisa,20,1,120,100
1656913323419,CSE 15L,A01,083654,Morris; Justin Loren,8,0,50,42
1656913323419,CSE 15L,A02,083655,Morris; Justin Loren,8,0,50,42
1656913329448,CSE 20,A01,083657,Tran; Khoa Dang,37,0,80,43
1656913335475,CSE 21,A01,095574,Bach; Quang Tran,21,0,48,27
1656913341498,CSE 30,A01,083084,Eldon; John,4,0,80,76
1656913341498,CSE 30,B01,095061,Bhaskar; Nishant,6,0,50,44
1656913347525,CSE 100,A01,083659,Cao; Yingjun,2,4,70,68
1656913353551,CSE 134B,A01,083661,Powell; Thomas Allan,19,0,100,81
1656913359578,CSE 140,A01,083663,Gungor; Onat,14,0,85,71
1656913365600,CSE 140L,A01,083088,Eldon; John,16,0,100,84
1656913371625,CSE 175,A01,083665,Kumar; Rakesh,3,0,25,22
1656913377648,CSE 190,A00,092507,Dubnov; Shlomo,7,0,20,13
1656913383685,ECE 45,A01,083139,Congero; Spencer William,5,0,75,70
1656913389711,ECE 65,A50,083695,Saad; Andrew S,12,0,30,18
1656913389711,ECE 65,A51,095125,Saad; Andrew S,25,0,26,1
1656913395744,ECE 109,A01,091882,Touri; Behrouz,16,0,70,54
1656913401770,ECE 180,A00,083140,Abi Samra; Nicholas Camill,0,0,30,30
1656913401770,ECE 180,B00,083141,Abi Samra; Nicholas Camill,0,0,30,30
1656913407791,MATH 10A,A01,083735,Patchell; Gregory David,1,0,30,29
1656913407791,MATH 10A,A02,083736,Patchell; Gregory David,20,0,30,10
1656913407791,MATH 10A,A03,083737,Patchell; Gregory David,15,0,30,15
1656913413821,MATH 10B,A01,083207,Lim; Seonhee,7,0,34,27
1656913413821,MATH 10B,A02,083208,Lim; Seonhee,9,0,35,26
1656913413821,MATH 10B,A03,093472,Lim; Seonhee,4,0,34,30
1656913413821,MATH 10B,B01,083739,Sinha; Shubham,9,0,30,21
1656913419850,MATH 18,A01,083743,Cinel; Cameron Alexander,6,0,30,24
1656913419850,MATH 18,A02,083744,Cinel; Cameron Alexander,15,0,30,15
1656913419850,MATH 18,A03,083745,Cinel; Cameron Alexander,8,0,30,22
1656913419850,MATH 18,B01,083748,Rideout; David Porter,4,0,37,33
1656913419850,MATH 18,B02,083749,Rideout; David Porter,3,0,36,33
1656913419850,MATH 18,B03,083750,Rideout; David Porter,2,0,37,35
1656913419850,MATH 18,B04,083751,Rideout; David Porter,5,0,36,31
1656913419850,MATH 18,B05,093473,Rideout; David Porter,4,0,36,32
1656913419850,MATH 18,B06,093474,Rideout; David Porter,5,0,36,31
1656913425885,MATH 20A,A01,083754,Zheng; Zequn,12,0,40,28
1656913431912,MATH 20B,A01,083756,Briones; Jor-el Thomas Caparas,1,0,36,35
1656913431912,MATH 20B,A02,083757,Briones; Jor-el Thomas Caparas,1,0,36,35
1656913431912,MATH 20B,A03,093475,Briones; Jor-el Thomas Caparas,0,0,36,36
1656913437935,MATH 20C,A01,083760,Briones; Jor-el Thomas Caparas,1,0,35,34
1656913437935,MATH 20C,A02,083761,Briones; Jor-el Thomas Caparas,8,0,35,27
1656913437935,MATH 20C,A03,093476,Briones; Jor-el Thomas Caparas,0,1,36,36
1656913437935,MATH 20C,B01,083762,Bach; Quang Tran,0,0,30,30
1656913443972,MATH 20D,A01,083765,Tran; Brian Kha,4,0,30,26
1656913443972,MATH 20D,A02,083766,Tran; Brian Kha,4,0,30,26
1656913443972,MATH 20D,A03,083767,Tran; Brian Kha,3,0,30,27
1656913449996,MATH 20E,A01,083771,Ganguly; Soumya,5,0,32,27
1656913449996,MATH 20E,A02,083772,Ganguly; Soumya,6,0,32,26
1656913449996,MATH 20E,B01,083773,Ciotti; Benjamin,18,0,35,17
1656913449996,MATH 20E,B02,083774,Ciotti; Benjamin,17,0,35,18
1656913456030,MATH 103A,A01,083777,Greenfeld; Be'Eri,2,0,36,34
1656913456030,MATH 103A,A02,083778,Greenfeld; Be'Eri,5,0,36,31
1656913456030,MATH 103A,A03,093561,Greenfeld; Be'Eri,4,0,36,32
1656913456030,MATH 103A,B01,083779,Greenfeld; Be'Eri,6,0,36,30
1656913456030,MATH 103A,B02,083780,Greenfeld; Be'Eri,2,0,36,34
1656913456030,MATH 103A,B03,093562,Greenfeld; Be'Eri,2,0,36,34
1656913462054,MATH 105,A01,085443,Carter; Anne Toulson,13,0,35,22
1656913462054,MATH 105,A02,093477,Carter; Anne Toulson,20,0,35,15
1656913468080,MATH 109,A01,083213,Ganzberger; Geoffrey Michael,2,0,34,32
1656913468080,MATH 109,A02,083214,Ganzberger; Geoffrey Michael,2,0,34,32
1656913468080,MATH 109,A03,093478,Ganzberger; Geoffrey Michael,1,0,34,33
1656913468080,MATH 109,B01,083215,Ganzberger; Geoffrey Michael,1,0,32,31
1656913468080,MATH 109,B02,083216,Ganzberger; Geoffrey Michael,1,0,32,31
1656913468080,MATH 109,B03,093479,Ganzberger; Geoffrey Michael,6,0,32,26
1656913474103,MATH 142A,A01,083219,Chow; Bennett,6,0,32,26
1656913474103,MATH 142A,A02,083220,Chow; Bennett,10,0,32,22
1656913474103,MATH 142A,A03,093480,Chow; Bennett,7,0,32,25
1656913474103,MATH 142A,B03,093481,Chow; Bennett,7,0,32,25
1656913474103,MATH 142A,B04,093558,Chow; Bennett,10,0,32,22
1656913474103,MATH 142A,B05,093559,Chow; Bennett,6,0,32,26
1656913480131,MATH 193A,A01,083224,Rotar; Vladimir,7,0,34,27
1656913480131,MATH 193A,A02,083225,Rotar; Vladimir,3,0,34,31
1656913480131,MATH 193A,A03,083781,Rotar; Vladimir,1,0,34,33
1656913480131,MATH 193A,A04,083782,Rotar; Vladimir,6,0,34,28
1656913480131,MATH 193A,A05,093482,Rotar; Vladimir,6,0,34,28
1656913486154,MATH 197,001,091859,McAuley; Julian John,9999,0,9999,0
1656913486154,MATH 197,002,095566,Kedlaya; Kiran S.,9997,0,9999,2
1656913486154,MATH 197,003,095567,Xiao; Ming,9999,0,9999,0
1656913486154,MATH 197,004,095571,Perols; Johan Lars,9998,0,9999,1
1656913493212,COGS 9,A01,083615,Shannon; Kyle Michael,7,0,75,68
1656913499234,COGS 11,A01,083617,Boyle; Mary E. T.,19,0,48,29
1656913505331,COGS 13,A01,083071,Bastos; Amalia Pinkusfeld,9,0,71,62
1656913511356,COGS 14A,A01,092681,Semenuks; Arturs,0,1,100,100
1656913517379,COGS 14B,A01,083073,Cheng; Tzu-Han,5,0,63,58
1656913523402,COGS 17,A01,092677,Semenuks; Arturs,4,0,81,77
1656913529431,COGS 100,A01,083619,Allen; Michael Gordon,15,0,70,55
1656913535453,COGS 101A,A01,083621,Davis; Joshua Daniel,9,0,68,59
1656913541475,COGS 101B,A01,091572,Allen; Michael Gordon,8,0,65,57
1656913547497,COGS 101C,A01,083625,Delgado; Tania,17,0,35,18
1656913553520,COGS 107A,A01,083627,Boyle; Mary E. T.,13,0,60,47
1656913559547,COGS 118A,A01,083075,Gupta; Anjum,15,0,76,61
1656913565571,CSE 3,A50,083646,Miranda; Gregory Joseph,22,0,50,28
1656913571597,CSE 8A,A50,083650,Miranda; Gregory Joseph,17,1,56,39
1656913577623,CSE 11,A01,083080,Cao; Yingjun,4,15,40,36
1656913583651,CSE 12,A01,083652,Krause-Levy; Sophia Louisa,20,1,120,100
1656913589677,CSE 15L,A01,083654,Morris; Justin Loren,8,0,50,42
1656913589677,CSE 15L,A02,083655,Morris; Justin Loren,8,0,50,42
1656913595707,CSE 20,A01,083657,Tran; Khoa Dang,37,0,80,43
1656913601731,CSE 21,A01,095574,Bach; Quang Tran,21,0,48,27
1656913607754,CSE 30,A01,083084,Eldon; John,4,0,80,76
1656913607754,CSE 30,B01,095061,Bhaskar; Nishant,6,0,50,44
1656913613776,CSE 100,A01,083659,Cao; Yingjun,2,4,70,68
1656913619800,CSE 134B,A01,083661,Powell; Thomas Allan,19,0,100,81
1656913625825,CSE 140,A01,083663,Gungor; Onat,14,0,85,71
1656913631851,CSE 140L,A01,083088,Eldon; John,16,0,100,84
1656913637877,CSE 175,A01,083665,Kumar; Rakesh,3,0,25,22
1656913643901,CSE 190,A00,092507,Dubnov; Shlomo,7,0,20,13
1656913649925,ECE 45,A01,083139,Congero; Spencer William,5,0,75,70
1656913655948,ECE 65,A50,083695,Saad; Andrew S,12,0,30,18
1656913655948,ECE 65,A51,095125,Saad; Andrew S,25,0,26,1
1656913661974,ECE 109,A01,091882,Touri; Behrouz,16,0,70,54
1656913668009,ECE 180,A00,083140,Abi Samra; Nicholas Camill,0,0,30,30
1656913668009,ECE 180,B00,083141,Abi Samra; Nicholas Camill,0,0,30,30
1656913674047,MATH 10A,A01,083735,Patchell; Gregory David,1,0,30,29
1656913674047,MATH 10A,A02,083736,Patchell; Gregory David,20,0,30,10
1656913674047,MATH 10A,A03,083737,Patchell; Gregory David,15,0,30,15
1656913680074,MATH 10B,A01,083207,Lim; Seonhee,7,0,34,27
1656913680074,MATH 10B,A02,083208,Lim; Seonhee,9,0,35,26
1656913680074,MATH 10B,A03,093472,Lim; Seonhee,4,0,34,30
1656913680074,MATH 10B,B01,083739,Sinha; Shubham,9,0,30,21
1656913686097,MATH 18,A01,083743,Cinel; Cameron Alexander,6,0,30,24
1656913686097,MATH 18,A02,083744,Cinel; Cameron Alexander,15,0,30,15
1656913686097,MATH 18,A03,083745,Cinel; Cameron Alexander,8,0,30,22
1656913686097,MATH 18,B01,083748,Rideout; David Porter,4,0,37,33
1656913686097,MATH 18,B02,083749,Rideout; David Porter,3,0,36,33
1656913686097,MATH 18,B03,083750,Rideout; David Porter,2,0,37,35
1656913686097,MATH 18,B04,083751,Rideout; David Porter,5,0,36,31
1656913686097,MATH 18,B05,093473,Rideout; David Porter,4,0,36,32
1656913686097,MATH 18,B06,093474,Rideout; David Porter,5,0,36,31
1656913692120,MATH 20A,A01,083754,Zheng; Zequn,12,0,40,28
1656913698143,MATH 20B,A01,083756,Briones; Jor-el Thomas Caparas,1,0,36,35
1656913698143,MATH 20B,A02,083757,Briones; Jor-el Thomas Caparas,1,0,36,35
1656913698143,MATH 20B,A03,093475,Briones; Jor-el Thomas Caparas,0,0,36,36
1656913704169,MATH 20C,A01,083760,Briones; Jor-el Thomas Caparas,1,0,35,34
1656913704169,MATH 20C,A02,083761,Briones; Jor-el Thomas Caparas,8,0,35,27
1656913704169,MATH 20C,A03,093476,Briones; Jor-el Thomas Caparas,0,1,36,36
1656913704169,MATH 20C,B01,083762,Bach; Quang Tran,0,0,30,30
1656913710194,MATH 20D,A01,083765,Tran; Brian Kha,4,0,30,26
1656913710194,MATH 20D,A02,083766,Tran; Brian Kha,4,0,30,26
1656913710194,MATH 20D,A03,083767,Tran; Brian Kha,3,0,30,27
1656913716222,MATH 20E,A01,083771,Ganguly; Soumya,5,0,32,27
1656913716222,MATH 20E,A02,083772,Ganguly; Soumya,6,0,32,26
1656913716222,MATH 20E,B01,083773,Ciotti; Benjamin,18,0,35,17
1656913716222,MATH 20E,B02,083774,Ciotti; Benjamin,17,0,35,18
1656913722243,MATH 103A,A01,083777,Greenfeld; Be'Eri,2,0,36,34
1656913722243,MATH 103A,A02,083778,Greenfeld; Be'Eri,5,0,36,31
1656913722243,MATH 103A,A03,093561,Greenfeld; Be'Eri,4,0,36,32
1656913722243,MATH 103A,B01,083779,Greenfeld; Be'Eri,6,0,36,30
1656913722243,MATH 103A,B02,083780,Greenfeld; Be'Eri,2,0,36,34
1656913722243,MATH 103A,B03,093562,Greenfeld; Be'Eri,2,0,36,34
1656913728268,MATH 105,A01,085443,Carter; Anne Toulson,13,0,35,22
1656913728268,MATH 105,A02,093477,Carter; Anne Toulson,20,0,35,15
1656913734293,MATH 109,A01,083213,Ganzberger; Geoffrey Michael,2,0,34,32
1656913734293,MATH 109,A02,083214,Ganzberger; Geoffrey Michael,2,0,34,32
1656913734293,MATH 109,A03,093478,Ganzberger; Geoffrey Michael,1,0,34,33
1656913734293,MATH 109,B01,083215,Ganzberger; Geoffrey Michael,1,0,32,31
1656913734293,MATH 109,B02,083216,Ganzberger; Geoffrey Michael,1,0,32,31
1656913734293,MATH 109,B03,093479,Ganzberger; Geoffrey Michael,6,0,32,26
1656913740328,MATH 142A,A01,083219,Chow; Bennett,6,0,32,26
1656913740328,MATH 142A,A02,083220,Chow; Bennett,10,0,32,22
1656913740328,MATH 142A,A03,093480,Chow; Bennett,7,0,32,25
1656913740328,MATH 142A,B03,093481,Chow; Bennett,7,0,32,25
1656913740328,MATH 142A,B04,093558,Chow; Bennett,10,0,32,22
1656913740328,MATH 142A,B05,093559,Chow; Bennett,6,0,32,26
1656913746350,MATH 193A,A01,083224,Rotar; Vladimir,7,0,34,27
1656913746350,MATH 193A,A02,083225,Rotar; Vladimir,3,0,34,31
1656913746350,MATH 193A,A03,083781,Rotar; Vladimir,1,0,34,33
1656913746350,MATH 193A,A04,083782,Rotar; Vladimir,6,0,34,28
1656913746350,MATH 193A,A05,093482,Rotar; Vladimir,6,0,34,28
1656913752373,MATH 197,001,091859,McAuley; Julian John,9999,0,9999,0
1656913752373,MATH 197,002,095566,Kedlaya; Kiran S.,9997,0,9999,2
1656913752373,MATH 197,003,095567,Xiao; Ming,9999,0,9999,0
1656913752373,MATH 197,004,095571,Perols; Johan Lars,9998,0,9999,1
1656913759430,COGS 9,A01,083615,Shannon; Kyle Michael,7,0,75,68
1656913765461,COGS 11,A01,083617,Boyle; Mary E. T.,19,0,48,29
1656913771488,COGS 13,A01,083071,Bastos; Amalia Pinkusfeld,9,0,71,62
1656913777509,COGS 14A,A01,092681,Semenuks; Arturs,0,1,100,100
1656913783534,COGS 14B,A01,083073,Cheng; Tzu-Han,5,0,63,58
1656913789557,COGS 17,A01,092677,Semenuks; Arturs,4,0,81,77
1656913795580,COGS 100,A01,083619,Allen; Michael Gordon,15,0,70,55
1656913801603,COGS 101A,A01,083621,Davis; Joshua Daniel,9,0,68,59
1656913807628,COGS 101B,A01,091572,Allen; Michael Gordon,8,0,65,57
1656913813650,COGS 101C,A01,083625,Delgado; Tania,17,0,35,18
1656913819675,COGS 107A,A01,083627,Boyle; Mary E. T.,13,0,60,47
1656913825698,COGS 118A,A01,083075,Gupta; Anjum,15,0,76,61
1656913831721,CSE 3,A50,083646,Miranda; Gregory Joseph,22,0,50,28
1656913837743,CSE 8A,A50,083650,Miranda; Gregory Joseph,17,1,56,39
1656913843767,CSE 11,A01,083080,Cao; Yingjun,4,15,40,36
1656913849789,CSE 12,A01,083652,Krause-Levy; Sophia Louisa,20,1,120,100
1656913855827,CSE 15L,A01,083654,Morris; Justin Loren,8,0,50,42
1656913855827,CSE 15L,A02,083655,Morris; Justin Loren,8,0,50,42
1656913861854,CSE 20,A01,083657,Tran; Khoa Dang,37,0,80,43
1656913867882,CSE 21,A01,095574,Bach; Quang Tran,21,0,48,27
1656913873914,CSE 30,A01,083084,Eldon; John,4,0,80,76
1656913873914,CSE 30,B01,095061,Bhaskar; Nishant,6,0,50,44
1656913879936,CSE 100,A01,083659,Cao; Yingjun,2,4,70,68
1656913885963,CSE 134B,A01,083661,Powell; Thomas Allan,19,0,100,81
1656913891986,CSE 140,A01,083663,Gungor; Onat,14,0,85,71
1656913898015,CSE 140L,A01,083088,Eldon; John,16,0,100,84
1656913904038,CSE 175,A01,083665,Kumar; Rakesh,3,0,25,22
1656913910063,CSE 190,A00,092507,Dubnov; Shlomo,7,0,20,13
1656913916089,ECE 45,A01,083139,Congero; Spencer William,5,0,75,70
1656913922114,ECE 65,A50,083695,Saad; Andrew S,12,0,30,18
1656913922114,ECE 65,A51,095125,Saad; Andrew S,25,0,26,1
1656913928140,ECE 109,A01,091882,Touri; Behrouz,16,0,70,54
1656913934164,ECE 180,A00,083140,Abi Samra; Nicholas Camill,0,0,30,30
1656913934164,ECE 180,B00,083141,Abi Samra; Nicholas Camill,0,0,30,30
1656913940186,MATH 10A,A01,083735,Patchell; Gregory David,1,0,30,29
1656913940186,MATH 10A,A02,083736,Patchell; Gregory David,20,0,30,10
1656913940186,MATH 10A,A03,083737,Patchell; Gregory David,15,0,30,15
1656913946213,MATH 10B,A01,083207,Lim; Seonhee,7,0,34,27
1656913946213,MATH 10B,A02,083208,Lim; Seonhee,9,0,35,26
1656913946213,MATH 10B,A03,093472,Lim; Seonhee,4,0,34,30
1656913946213,MATH 10B,B01,083739,Sinha; Shubham,9,0,30,21
1656913952239,MATH 18,A01,083743,Cinel; Cameron Alexander,6,0,30,24
1656913952239,MATH 18,A02,083744,Cinel; Cameron Alexander,15,0,30,15
1656913952239,MATH 18,A03,083745,Cinel; Cameron Alexander,8,0,30,22
1656913952239,MATH 18,B01,083748,Rideout; David Porter,4,0,37,33
1656913952239,MATH 18,B02,083749,Rideout; David Porter,3,0,36,33
1656913952239,MATH 18,B03,083750,Rideout; David Porter,2,0,37,35
1656913952239,MATH 18,B04,083751,Rideout; David Porter,5,0,36,31
1656913952239,MATH 18,B05,093473,Rideout; David Porter,4,0,36,32
1656913952239,MATH 18,B06,093474,Rideout; David Porter,5,0,36,31
1656913958261,MATH 20A,A01,083754,Zheng; Zequn,12,0,40,28
1656913964290,MATH 20B,A01,083756,Briones; Jor-el Thomas Caparas,1,0,36,35
1656913964290,MATH 20B,A02,083757,Briones; Jor-el Thomas Caparas,1,0,36,35
1656913964290,MATH 20B,A03,093475,Briones; Jor-el Thomas Caparas,0,0,36,36
1656913970315,MATH 20C,A01,083760,Briones; Jor-el Thomas Caparas,1,0,35,34
1656913970315,MATH 20C,A02,083761,Briones; Jor-el Thomas Caparas,8,0,35,27
1656913970315,MATH 20C,A03,093476,Briones; Jor-el Thomas Caparas,0,1,36,36
1656913970315,MATH 20C,B01,083762,Bach; Quang Tran,0,0,30,30
1656913976344,MATH 20D,A01,083765,Tran; Brian Kha,4,0,30,26
1656913976344,MATH 20D,A02,083766,Tran; Brian Kha,4,0,30,26
1656913976344,MATH 20D,A03,083767,Tran; Brian Kha,3,0,30,27
1656913982368,MATH 20E,A01,083771,Ganguly; Soumya,5,0,32,27
1656913982368,MATH 20E,A02,083772,Ganguly; Soumya,6,0,32,26
1656913982368,MATH 20E,B01,083773,Ciotti; Benjamin,18,0,35,17
1656913982368,MATH 20E,B02,083774,Ciotti; Benjamin,17,0,35,18
1656913988398,MATH 103A,A01,083777,Greenfeld; Be'Eri,2,0,36,34
1656913988398,MATH 103A,A02,083778,Greenfeld; Be'Eri,5,0,36,31
1656913988398,MATH 103A,A03,093561,Greenfeld; Be'Eri,4,0,36,32
1656913988398,MATH 103A,B01,083779,Greenfeld; Be'Eri,6,0,36,30
1656913988398,MATH 103A,B02,083780,Greenfeld; Be'Eri,2,0,36,34
1656913988398,MATH 103A,B03,093562,Greenfeld; Be'Eri,2,0,36,34
1656913994425,MATH 105,A01,085443,Carter; Anne Toulson,13,0,35,22
1656913994425,MATH 105,A02,093477,Carter; Anne Toulson,20,0,35,15
1656914000454,MATH 109,A01,083213,Ganzberger; Geoffrey Michael,2,0,34,32
1656914000454,MATH 109,A02,083214,Ganzberger; Geoffrey Michael,2,0,34,32
1656914000454,MATH 109,A03,093478,Ganzberger; Geoffrey Michael,1,0,34,33
1656914000454,MATH 109,B01,083215,Ganzberger; Geoffrey Michael,1,0,32,31
1656914000454,MATH 109,B02,083216,Ganzberger; Geoffrey Michael,1,0,32,31
1656914000454,MATH 109,B03,093479,Ganzberger; Geoffrey Michael,6,0,32,26
1656914006477,MATH 142A,A01,083219,Chow; Bennett,6,0,32,26
1656914006477,MATH 142A,A02,083220,Chow; Bennett,10,0,32,22
1656914006477,MATH 142A,A03,093480,Chow; Bennett,7,0,32,25
1656914006477,MATH 142A,B03,093481,Chow; Bennett,7,0,32,25
1656914006477,MATH 142A,B04,093558,Chow; Bennett,10,0,32,22
1656914006477,MATH 142A,B05,093559,Chow; Bennett,6,0,32,26
1656914012508,MATH 193A,A01,083224,Rotar; Vladimir,7,0,34,27
1656914012508,MATH 193A,A02,083225,Rotar; Vladimir,3,0,34,31
1656914012508,MATH 193A,A03,083781,Rotar; Vladimir,1,0,34,33
1656914012508,MATH 193A,A04,083782,Rotar; Vladimir,6,0,34,28
1656914012508,MATH 193A,A05,093482,Rotar; Vladimir,6,0,34,28
1656914018531,MATH 197,001,091859,McAuley; Julian John,9999,0,9999,0
1656914018531,MATH 197,002,095566,Kedlaya; Kiran S.,9997,0,9999,2
1656914018531,MATH 197,003,095567,Xiao; Ming,9999,0,9999,0
1656914018531,MATH 197,004,095571,Perols; Johan Lars,9998,0,9999,1
1656914025590,COGS 9,A01,083615,Shannon; Kyle Michael,7,0,75,68
1656914031613,COGS 11,A01,083617,Boyle; Mary E. T.,19,0,48,29
1656914037638,COGS 13,A01,083071,Bastos; Amalia Pinkusfeld,9,0,71,62
1656914043662,COGS 14A,A01,092681,Semenuks; Arturs,0,1,100,100
1656914049688,COGS 14B,A01,083073,Cheng; Tzu-Han,5,0,63,58
1656914055712,COGS 17,A01,092677,Semenuks; Arturs,4,0,81,77
1656914061734,COGS 100,A01,083619,Allen; Michael Gordon,15,0,70,55
1656914067757,COGS 101A,A01,083621,Davis; Joshua Daniel,9,0,68,59
1656914073792,COGS 101B,A01,091572,Allen; Michael Gordon,8,0,65,57
1656914079816,COGS 101C,A01,083625,Delgado; Tania,17,0,35,18
1656914085839,COGS 107A,A01,083627,Boyle; Mary E. T.,13,0,60,47
1656914091869,COGS 118A,A01,083075,Gupta; Anjum,15,0,76,61
1656914097893,CSE 3,A50,083646,Miranda; Gregory Joseph,22,0,50,28
1656914103987,CSE 8A,A50,083650,Miranda; Gregory Joseph,17,1,56,39
1656914110014,CSE 11,A01,083080,Cao; Yingjun,4,15,40,36
1656914116037,CSE 12,A01,083652,Krause-Levy; Sophia Louisa,20,1,120,100
1656914122059,CSE 15L,A01,083654,Morris; Justin Loren,8,0,50,42
1656914122059,CSE 15L,A02,083655,Morris; Justin Loren,8,0,50,42
1656914128080,CSE 20,A01,083657,Tran; Khoa Dang,37,0,80,43
1656914134104,CSE 21,A01,095574,Bach; Quang Tran,21,0,48,27
1656914140127,CSE 30,A01,083084,Eldon; John,4,0,80,76
1656914140127,CSE 30,B01,095061,Bhaskar; Nishant,6,0,50,44
1656914146151,CSE 100,A01,083659,Cao; Yingjun,2,4,70,68
1656914152172,CSE 134B,A01,083661,Powell; Thomas Allan,19,0,100,81
1656914158196,CSE 140,A01,083663,Gungor; Onat,14,0,85,71
1656914164223,CSE 140L,A01,083088,Eldon; John,16,0,100,84
1656914170247,CSE 175,A01,083665,Kumar; Rakesh,3,0,25,22
1656914176275,CSE 190,A00,092507,Dubnov; Shlomo,7,0,20,13
1656914182302,ECE 45,A01,083139,Congero; Spencer William,5,0,75,70
1656914188325,ECE 65,A50,083695,Saad; Andrew S,12,0,30,18
1656914188325,ECE 65,A51,095125,Saad; Andrew S,25,0,26,1
1656914194348,ECE 109,A01,091882,Touri; Behrouz,16,0,70,54
1656914200374,ECE 180,A00,083140,Abi Samra; Nicholas Camill,0,0,30,30
1656914200374,ECE 180,B00,083141,Abi Samra; Nicholas Camill,0,0,30,30
1656914206406,MATH 10A,A01,083735,Patchell; Gregory David,1,0,30,29
1656914206406,MATH 10A,A02,083736,Patchell; Gregory David,20,0,30,10
1656914206406,MATH 10A,A03,083737,Patchell; Gregory David,15,0,30,15
1656914212428,MATH 10B,A01,083207,Lim; Seonhee,7,0,34,27
1656914212428,MATH 10B,A02,083208,Lim; Seonhee,9,0,35,26
1656914212428,MATH 10B,A03,093472,Lim; Seonhee,4,0,34,30
1656914212428,MATH 10B,B01,083739,Sinha; Shubham,9,0,30,21
1656914218462,MATH 18,A01,083743,Cinel; Cameron Alexander,6,0,30,24
1656914218462,MATH 18,A02,083744,Cinel; Cameron Alexander,15,0,30,15
1656914218462,MATH 18,A03,083745,Cinel; Cameron Alexander,8,0,30,22
1656914218462,MATH 18,B01,083748,Rideout; David Porter,4,0,37,33
1656914218462,MATH 18,B02,083749,Rideout; David Porter,3,0,36,33
1656914218462,MATH 18,B03,083750,Rideout; David Porter,2,0,37,35
1656914218462,MATH 18,B04,083751,Rideout; David Porter,5,0,36,31
1656914218462,MATH 18,B05,093473,Rideout; David Porter,4,0,36,32
1656914218462,MATH 18,B06,093474,Rideout; David Porter,5,0,36,31
1656914224487,MATH 20A,A01,083754,Zheng; Zequn,12,0,40,28
1656914230510,MATH 20B,A01,083756,Briones; Jor-el Thomas Caparas,1,0,36,35
1656914230510,MATH 20B,A02,083757,Briones; Jor-el Thomas Caparas,1,0,36,35
1656914230510,MATH 20B,A03,093475,Briones; Jor-el Thomas Caparas,0,0,36,36
1656914236538,MATH 20C,A01,083760,Briones; Jor-el Thomas Caparas,1,0,35,34
1656914236538,MATH 20C,A02,083761,Briones; Jor-el Thomas Caparas,8,0,35,27
1656914236538,MATH 20C,A03,093476,Briones; Jor-el Thomas Caparas,0,1,36,36
1656914236538,MATH 20C,B01,083762,Bach; Quang Tran,0,0,30,30
1656914242566,MATH 20D,A01,083765,Tran; Brian Kha,4,0,30,26
1656914242566,MATH 20D,A02,083766,Tran; Brian Kha,4,0,30,26
1656914242566,MATH 20D,A03,083767,Tran; Brian Kha,3,0,30,27
1656914248594,MATH 20E,A01,083771,Ganguly; Soumya,5,0,32,27
1656914248594,MATH 20E,A02,083772,Ganguly; Soumya,6,0,32,26
1656914248594,MATH 20E,B01,083773,Ciotti; Benjamin,18,0,35,17
1656914248594,MATH 20E,B02,083774,Ciotti; Benjamin,17,0,35,18
1656914254619,MATH 103A,A01,083777,Greenfeld; Be'Eri,2,0,36,34
1656914254619,MATH 103A,A02,083778,Greenfeld; Be'Eri,5,0,36,31
1656914254619,MATH 103A,A03,093561,Greenfeld; Be'Eri,4,0,36,32
1656914254619,MATH 103A,B01,083779,Greenfeld; Be'Eri,6,0,36,30
1656914254619,MATH 103A,B02,083780,Greenfeld; Be'Eri,2,0,36,34
1656914254619,MATH 103A,B03,093562,Greenfeld; Be'Eri,2,0,36,34
1656914260643,MATH 105,A01,085443,Carter; Anne Toulson,13,0,35,22
1656914260643,MATH 105,A02,093477,Carter; Anne Toulson,20,0,35,15
1656914266667,MATH 109,A01,083213,Ganzberger; Geoffrey Michael,2,0,34,32
1656914266667,MATH 109,A02,083214,Ganzberger; Geoffrey Michael,2,0,34,32
1656914266667,MATH 109,A03,093478,Ganzberger; Geoffrey Michael,1,0,34,33
1656914266667,MATH 109,B01,083215,Ganzberger; Geoffrey Michael,1,0,32,31
1656914266667,MATH 109,B02,083216,Ganzberger; Geoffrey Michael,1,0,32,31
1656914266667,MATH 109,B03,093479,Ganzberger; Geoffrey Michael,6,0,32,26
1656914272691,MATH 142A,A01,083219,Chow; Bennett,6,0,32,26
1656914272691,MATH 142A,A02,083220,Chow; Bennett,10,0,32,22
1656914272691,MATH 142A,A03,093480,Chow; Bennett,7,0,32,25
1656914272691,MATH 142A,B03,093481,Chow; Bennett,7,0,32,25
1656914272691,MATH 142A,B04,093558,Chow; Bennett,10,0,32,22
1656914272691,MATH 142A,B05,093559,Chow; Bennett,6,0,32,26
1656914278720,MATH 193A,A01,083224,Rotar; Vladimir,7,0,34,27
1656914278720,MATH 193A,A02,083225,Rotar; Vladimir,3,0,34,31
1656914278720,MATH 193A,A03,083781,Rotar; Vladimir,1,0,34,33
1656914278720,MATH 193A,A04,083782,Rotar; Vladimir,6,0,34,28
1656914278720,MATH 193A,A05,093482,Rotar; Vladimir,6,0,34,28
1656914284755,MATH 197,001,091859,McAuley; Julian John,9999,0,9999,0
1656914284755,MATH 197,002,095566,Kedlaya; Kiran S.,9997,0,9999,2
1656914284755,MATH 197,003,095567,Xiao; Ming,9999,0,9999,0
1656914284755,MATH 197,004,095571,Perols; Johan Lars,9998,0,9999,1
1656914291813,COGS 9,A01,083615,Shannon; Kyle Michael,7,0,75,68
1656914297835,COGS 11,A01,083617,Boyle; Mary E. T.,19,0,48,29
1656914303857,COGS 13,A01,083071,Bastos; Amalia Pinkusfeld,9,0,71,62
1656914309882,COGS 14A,A01,092681,Semenuks; Arturs,0,1,100,100
1656914315912,COGS 14B,A01,083073,Cheng; Tzu-Han,5,0,63,58
1656914321938,COGS 17,A01,092677,Semenuks; Arturs,4,0,81,77
1656914327960,COGS 100,A01,083619,Allen; Michael Gordon,15,0,70,55
1656914333984,COGS 101A,A01,083621,Davis; Joshua Daniel,9,0,68,59
1656914340006,COGS 101B,A01,091572,Allen; Michael Gordon,8,0,65,57
1656914346032,COGS 101C,A01,083625,Delgado; Tania,17,0,35,18
1656914352054,COGS 107A,A01,083627,Boyle; Mary E. T.,13,0,60,47
1656914358077,COGS 118A,A01,083075,Gupta; Anjum,15,0,76,61
1656914364105,CSE 3,A50,083646,Miranda; Gregory Joseph,22,0,50,28
1656914370131,CSE 8A,A50,083650,Miranda; Gregory Joseph,17,1,56,39
1656914376155,CSE 11,A01,083080,Cao; Yingjun,4,15,40,36
1656914382179,CSE 12,A01,083652,Krause-Levy; Sophia Louisa,20,1,120,100
1656914388220,CSE 15L,A01,083654,Morris; Justin Loren,8,0,50,42
1656914388220,CSE 15L,A02,083655,Morris; Justin Loren,8,0,50,42
1656914394244,CSE 20,A01,083657,Tran; Khoa Dang,37,0,80,43
1656914400276,CSE 21,A01,095574,Bach; Quang Tran,21,0,48,27
1656914406303,CSE 30,A01,083084,Eldon; John,4,0,80,76
1656914406303,CSE 30,B01,095061,Bhaskar; Nishant,6,0,50,44
1656914412325,CSE 100,A01,083659,Cao; Yingjun,2,4,70,68
1656914418348,CSE 134B,A01,083661,Powell; Thomas Allan,19,0,100,81
1656914424371,CSE 140,A01,083663,Gungor; Onat,14,0,85,71
1656914430393,CSE 140L,A01,083088,Eldon; John,16,0,100,84
1656914436417,CSE 175,A01,083665,Kumar; Rakesh,3,0,25,22
1656914442441,CSE 190,A00,092507,Dubnov; Shlomo,7,0,20,13
1656914448465,ECE 45,A01,083139,Congero; Spencer William,5,0,75,70
1656914454488,ECE 65,A50,083695,Saad; Andrew S,12,0,30,18
1656914454488,ECE 65,A51,095125,Saad; Andrew S,25,0,26,1
1656914460513,ECE 109,A01,091882,Touri; Behrouz,16,0,70,54
1656914466539,ECE 180,A00,083140,Abi Samra; Nicholas Camill,0,0,30,30
1656914466539,ECE 180,B00,083141,Abi Samra; Nicholas Camill,0,0,30,30
1656914472562,MATH 10A,A01,083735,Patchell; Gregory David,1,0,30,29
1656914472562,MATH 10A,A02,083736,Patchell; Gregory David,20,0,30,10
1656914472562,MATH 10A,A03,083737,Patchell; Gregory David,15,0,30,15
1656914478591,MATH 10B,A01,083207,Lim; Seonhee,7,0,34,27
1656914478591,MATH 10B,A02,083208,Lim; Seonhee,9,0,35,26
1656914478591,MATH 10B,A03,093472,Lim; Seonhee,4,0,34,30
1656914478591,MATH 10B,B01,083739,Sinha; Shubham,9,0,30,21
1656914484625,MATH 18,A01,083743,Cinel; Cameron Alexander,6,0,30,24
1656914484625,MATH 18,A02,083744,Cinel; Cameron Alexander,15,0,30,15
1656914484625,MATH 18,A03,083745,Cinel; Cameron Alexander,8,0,30,22
1656914484625,MATH 18,B01,083748,Rideout; David Porter,4,0,37,33
1656914484625,MATH 18,B02,083749,Rideout; David Porter,3,0,36,33
1656914484625,MATH 18,B03,083750,Rideout; David Porter,2,0,37,35
1656914484625,MATH 18,B04,083751,Rideout; David Porter,5,0,36,31
1656914484625,MATH 18,B05,093473,Rideout; David Porter,4,0,36,32
1656914484625,MATH 18,B06,093474,Rideout; David Porter,5,0,36,31
1656914490649,MATH 20A,A01,083754,Zheng; Zequn,12,0,40,28
1656914496703,MATH 20B,A01,083756,Briones; Jor-el Thomas Caparas,1,0,36,35
1656914496703,MATH 20B,A02,083757,Briones; Jor-el Thomas Caparas,1,0,36,35
1656914496703,MATH 20B,A03,093475,Briones; Jor-el Thomas Caparas,0,0,36,36
1656914502739,MATH 20C,A01,083760,Briones; Jor-el Thomas Caparas,1,0,35,34
1656914502739,MATH 20C,A02,083761,Briones; Jor-el Thomas Caparas,8,0,35,27
1656914502739,MATH 20C,A03,093476,Briones; Jor-el Thomas Caparas,0,1,36,36
1656914502739,MATH 20C,B01,083762,Bach; Quang Tran,0,0,30,30
1656914508763,MATH 20D,A01,083765,Tran; Brian Kha,4,0,30,26
1656914508763,MATH 20D,A02,083766,Tran; Brian Kha,4,0,30,26
1656914508763,MATH 20D,A03,083767,Tran; Brian Kha,3,0,30,27
1656914514797,MATH 20E,A01,083771,Ganguly; Soumya,5,0,32,27
1656914514797,MATH 20E,A02,083772,Ganguly; Soumya,6,0,32,26
1656914514797,MATH 20E,B01,083773,Ciotti; Benjamin,18,0,35,17
1656914514797,MATH 20E,B02,083774,Ciotti; Benjamin,17,0,35,18
1656914520828,MATH 103A,A01,083777,Greenfeld; Be'Eri,2,0,36,34
1656914520828,MATH 103A,A02,083778,Greenfeld; Be'Eri,5,0,36,31
1656914520828,MATH 103A,A03,093561,Greenfeld; Be'Eri,4,0,36,32
1656914520828,MATH 103A,B01,083779,Greenfeld; Be'Eri,6,0,36,30
1656914520828,MATH 103A,B02,083780,Greenfeld; Be'Eri,2,0,36,34
1656914520828,MATH 103A,B03,093562,Greenfeld; Be'Eri,2,0,36,34
1656914526853,MATH 105,A01,085443,Carter; Anne Toulson,13,0,35,22
1656914526853,MATH 105,A02,093477,Carter; Anne Toulson,20,0,35,15
1656914532879,MATH 109,A01,083213,Ganzberger; Geoffrey Michael,2,0,34,32
1656914532879,MATH 109,A02,083214,Ganzberger; Geoffrey Michael,2,0,34,32
1656914532879,MATH 109,A03,093478,Ganzberger; Geoffrey Michael,1,0,34,33
1656914532879,MATH 109,B01,083215,Ganzberger; Geoffrey Michael,1,0,32,31
1656914532879,MATH 109,B02,083216,Ganzberger; Geoffrey Michael,1,0,32,31
1656914532879,MATH 109,B03,093479,Ganzberger; Geoffrey Michael,6,0,32,26
1656914538910,MATH 142A,A01,083219,Chow; Bennett,6,0,32,26
1656914538910,MATH 142A,A02,083220,Chow; Bennett,10,0,32,22
1656914538910,MATH 142A,A03,093480,Chow; Bennett,7,0,32,25
1656914538910,MATH 142A,B03,093481,Chow; Bennett,7,0,32,25
1656914538910,MATH 142A,B04,093558,Chow; Bennett,10,0,32,22
1656914538910,MATH 142A,B05,093559,Chow; Bennett,6,0,32,26
1656914544936,MATH 193A,A01,083224,Rotar; Vladimir,7,0,34,27
1656914544936,MATH 193A,A02,083225,Rotar; Vladimir,3,0,34,31
1656914544936,MATH 193A,A03,083781,Rotar; Vladimir,1,0,34,33
1656914544936,MATH 193A,A04,083782,Rotar; Vladimir,6,0,34,28
1656914544936,MATH 193A,A05,093482,Rotar; Vladimir,6,0,34,28
1656914550958,MATH 197,001,091859,McAuley; Julian John,9999,0,9999,0
1656914550958,MATH 197,002,095566,Kedlaya; Kiran S.,9997,0,9999,2
1656914550958,MATH 197,003,095567,Xiao; Ming,9999,0,9999,0
1656914550958,MATH 197,004,095571,Perols; Johan Lars,9998,0,9999,1
1656914558017,COGS 9,A01,083615,Shannon; Kyle Michael,7,0,75,68
1656914564045,COGS 11,A01,083617,Boyle; Mary E. T.,19,0,48,29
1656914570069,COGS 13,A01,083071,Bastos; Amalia Pinkusfeld,9,0,71,62
1656914576104,COGS 14A,A01,092681,Semenuks; Arturs,0,1,100,100
1656914582136,COGS 14B,A01,083073,Cheng; Tzu-Han,5,0,63,58
1656914588167,COGS 17,A01,092677,Semenuks; Arturs,4,0,81,77
1656914594193,COGS 100,A01,083619,Allen; Michael Gordon,15,0,70,55
1656914600216,COGS 101A,A01,083621,Davis; Joshua Daniel,9,0,68,59
1656914606243,COGS 101B,A01,091572,Allen; Michael Gordon,8,0,65,57
1656914612270,COGS 101C,A01,083625,Delgado; Tania,17,0,35,18
1656914618295,COGS 107A,A01,083627,Boyle; Mary E. T.,13,0,60,47
1656914624322,COGS 118A,A01,083075,Gupta; Anjum,15,0,76,61
1656914630348,CSE 3,A50,083646,Miranda; Gregory Joseph,22,0,50,28
1656914636379,CSE 8A,A50,083650,Miranda; Gregory Joseph,17,1,56,39
1656914642402,CSE 11,A01,083080,Cao; Yingjun,4,15,40,36
1656914648429,CSE 12,A01,083652,Krause-Levy; Sophia Louisa,20,1,120,100
1656914654455,CSE 15L,A01,083654,Morris; Justin Loren,8,0,50,42
1656914654455,CSE 15L,A02,083655,Morris; Justin Loren,8,0,50,42
1656914660482,CSE 20,A01,083657,Tran; Khoa Dang,37,0,80,43
1656914666513,CSE 21,A01,095574,Bach; Quang Tran,21,0,48,27
1656914672539,CSE 30,A01,083084,Eldon; John,4,0,80,76
1656914672539,CSE 30,B01,095061,Bhaskar; Nishant,6,0,50,44
1656914678564,CSE 100,A01,083659,Cao; Yingjun,2,4,70,68
1656914684588,CSE 134B,A01,083661,Powell; Thomas Allan,19,0,100,81
1656914690612,CSE 140,A01,083663,Gungor; Onat,14,0,85,71
1656914696635,CSE 140L,A01,083088,Eldon; John,16,0,100,84
1656914702799,CSE 175,A01,083665,Kumar; Rakesh,3,0,25,22
1656914708823,CSE 190,A00,092507,Dubnov; Shlomo,7,0,20,13
1656914714848,ECE 45,A01,083139,Congero; Spencer William,5,0,75,70
1656914720877,ECE 65,A50,083695,Saad; Andrew S,12,0,30,18
1656914720877,ECE 65,A51,095125,Saad; Andrew S,25,0,26,1
1656914726908,ECE 109,A01,091882,Touri; Behrouz,16,0,70,54
1656914732932,ECE 180,A00,083140,Abi Samra; Nicholas Camill,0,0,30,30
1656914732932,ECE 180,B00,083141,Abi Samra; Nicholas Camill,0,0,30,30
1656914738956,MATH 10A,A01,083735,Patchell; Gregory David,1,0,30,29
1656914738956,MATH 10A,A02,083736,Patchell; Gregory David,20,0,30,10
1656914738956,MATH 10A,A03,083737,Patchell; Gregory David,15,0,30,15
1656914744982,MATH 10B,A01,083207,Lim; Seonhee,7,0,34,27
1656914744982,MATH 10B,A02,083208,Lim; Seonhee,9,0,35,26
1656914744982,MATH 10B,A03,093472,Lim; Seonhee,4,0,34,30
1656914744982,MATH 10B,B01,083739,Sinha; Shubham,9,0,30,21
1656914751009,MATH 18,A01,083743,Cinel; Cameron Alexander,6,0,30,24
1656914751009,MATH 18,A02,083744,Cinel; Cameron Alexander,15,0,30,15
1656914751009,MATH 18,A03,083745,Cinel; Cameron Alexander,8,0,30,22
1656914751009,MATH 18,B01,083748,Rideout; David Porter,4,0,37,33
1656914751009,MATH 18,B02,083749,Rideout; David Porter,3,0,36,33
1656914751009,MATH 18,B03,083750,Rideout; David Porter,2,0,37,35
1656914751009,MATH 18,B04,083751,Rideout; David Porter,5,0,36,31
1656914751009,MATH 18,B05,093473,Rideout; David Porter,4,0,36,32
1656914751009,MATH 18,B06,093474,Rideout; David Porter,5,0,36,31
1656914757039,MATH 20A,A01,083754,Zheng; Zequn,12,0,40,28
1656914763062,MATH 20B,A01,083756,Briones; Jor-el Thomas Caparas,1,0,36,35
1656914763062,MATH 20B,A02,083757,Briones; Jor-el Thomas Caparas,1,0,36,35
1656914763062,MATH 20B,A03,093475,Briones; Jor-el Thomas Caparas,0,0,36,36
1656914769084,MATH 20C,A01,083760,Briones; Jor-el Thomas Caparas,1,0,35,34
1656914769084,MATH 20C,A02,083761,Briones; Jor-el Thomas Caparas,8,0,35,27
1656914769084,MATH 20C,A03,093476,Briones; Jor-el Thomas Caparas,0,1,36,36
1656914769084,MATH 20C,B01,083762,Bach; Quang Tran,0,0,30,30
1656914775115,MATH 20D,A01,083765,Tran; Brian Kha,4,0,30,26
1656914775115,MATH 20D,A02,083766,Tran; Brian Kha,4,0,30,26
1656914775115,MATH 20D,A03,083767,Tran; Brian Kha,3,0,30,27
1656914781140,MATH 20E,A01,083771,Ganguly; Soumya,5,0,32,27
1656914781140,MATH 20E,A02,083772,Ganguly; Soumya,6,0,32,26
1656914781140,MATH 20E,B01,083773,Ciotti; Benjamin,18,0,35,17
1656914781140,MATH 20E,B02,083774,Ciotti; Benjamin,17,0,35,18
1656914787165,MATH 103A,A01,083777,Greenfeld; Be'Eri,2,0,36,34
1656914787165,MATH 103A,A02,083778,Greenfeld; Be'Eri,5,0,36,31
1656914787165,MATH 103A,A03,093561,Greenfeld; Be'Eri,4,0,36,32
1656914787165,MATH 103A,B01,083779,Greenfeld; Be'Eri,6,0,36,30
1656914787165,MATH 103A,B02,083780,Greenfeld; Be'Eri,2,0,36,34
1656914787165,MATH 103A,B03,093562,Greenfeld; Be'Eri,2,0,36,34
1656914793187,MATH 105,A01,085443,Carter; Anne Toulson,13,0,35,22
1656914793187,MATH 105,A02,093477,Carter; Anne Toulson,20,0,35,15
1656914799217,MATH 109,A01,083213,Ganzberger; Geoffrey Michael,2,0,34,32
1656914799217,MATH 109,A02,083214,Ganzberger; Geoffrey Michael,2,0,34,32
1656914799217,MATH 109,A03,093478,Ganzberger; Geoffrey Michael,1,0,34,33
1656914799217,MATH 109,B01,083215,Ganzberger; Geoffrey Michael,1,0,32,31
1656914799217,MATH 109,B02,083216,Ganzberger; Geoffrey Michael,1,0,32,31
1656914799217,MATH 109,B03,093479,Ganzberger; Geoffrey Michael,6,0,32,26
1656914805243,MATH 142A,A01,083219,Chow; Bennett,6,0,32,26
1656914805243,MATH 142A,A02,083220,Chow; Bennett,10,0,32,22
1656914805243,MATH 142A,A03,093480,Chow; Bennett,7,0,32,25
1656914805243,MATH 142A,B03,093481,Chow; Bennett,7,0,32,25
1656914805243,MATH 142A,B04,093558,Chow; Bennett,10,0,32,22
1656914805243,MATH 142A,B05,093559,Chow; Bennett,6,0,32,26
1656914811274,MATH 193A,A01,083224,Rotar; Vladimir,7,0,34,27
1656914811274,MATH 193A,A02,083225,Rotar; Vladimir,3,0,34,31
1656914811274,MATH 193A,A03,083781,Rotar; Vladimir,1,0,34,33
1656914811274,MATH 193A,A04,083782,Rotar; Vladimir,6,0,34,28
1656914811274,MATH 193A,A05,093482,Rotar; Vladimir,6,0,34,28
1656914817297,MATH 197,001,091859,McAuley; Julian John,9999,0,9999,0
1656914817297,MATH 197,002,095566,Kedlaya; Kiran S.,9997,0,9999,2
1656914817297,MATH 197,003,095567,Xiao; Ming,9999,0,9999,0
1656914817297,MATH 197,004,095571,Perols; Johan Lars,9998,0,9999,1
1656914824370,COGS 9,A01,083615,Shannon; Kyle Michael,7,0,75,68
1656914830400,COGS 11,A01,083617,Boyle; Mary E. T.,19,0,48,29
1656914836425,COGS 13,A01,083071,Bastos; Amalia Pinkusfeld,9,0,71,62
1656914842458,COGS 14A,A01,092681,Semenuks; Arturs,0,1,100,100
1656914848487,COGS 14B,A01,083073,Cheng; Tzu-Han,5,0,63,58
1656914854513,COGS 17,A01,092677,Semenuks; Arturs,4,0,81,77
1656914860548,COGS 100,A01,083619,Allen; Michael Gordon,15,0,70,55
1656914866576,COGS 101A,A01,083621,Davis; Joshua Daniel,9,0,68,59
1656914872604,COGS 101B,A01,091572,Allen; Michael Gordon,8,0,65,57
1656914878631,COGS 101C,A01,083625,Delgado; Tania,17,0,35,18
1656914884658,COGS 107A,A01,083627,Boyle; Mary E. T.,13,0,60,47
1656914890681,COGS 118A,A01,083075,Gupta; Anjum,15,0,76,61
1656914896709,CSE 3,A50,083646,Miranda; Gregory Joseph,22,0,50,28
1656914902731,CSE 8A,A50,083650,Miranda; Gregory Joseph,17,1,56,39
1656914908753,CSE 11,A01,083080,Cao; Yingjun,4,15,40,36
1656914914779,CSE 12,A01,083652,Krause-Levy; Sophia Louisa,20,1,120,100
1656914920802,CSE 15L,A01,083654,Morris; Justin Loren,8,0,50,42
1656914920802,CSE 15L,A02,083655,Morris; Justin Loren,8,0,50,42
1656914926830,CSE 20,A01,083657,Tran; Khoa Dang,37,0,80,43
1656914932852,CSE 21,A01,095574,Bach; Quang Tran,21,0,48,27
1656914938879,CSE 30,A01,083084,Eldon; John,4,0,80,76
1656914938879,CSE 30,B01,095061,Bhaskar; Nishant,6,0,50,44
1656914944912,CSE 100,A01,083659,Cao; Yingjun,2,4,70,68
1656914950935,CSE 134B,A01,083661,Powell; Thomas Allan,19,0,100,81
1656914956970,CSE 140,A01,083663,Gungor; Onat,14,0,85,71
1656914962996,CSE 140L,A01,083088,Eldon; John,16,0,100,84
1656914969023,CSE 175,A01,083665,Kumar; Rakesh,3,0,25,22
1656914975051,CSE 190,A00,092507,Dubnov; Shlomo,7,0,20,13
1656914981078,ECE 45,A01,083139,Congero; Spencer William,5,0,75,70
1656914987101,ECE 65,A50,083695,Saad; Andrew S,12,0,30,18
1656914987101,ECE 65,A51,095125,Saad; Andrew S,25,0,26,1
1656914993128,ECE 109,A01,091882,Touri; Behrouz,16,0,70,54
1656914999155,ECE 180,A00,083140,Abi Samra; Nicholas Camill,0,0,30,30
1656914999155,ECE 180,B00,083141,Abi Samra; Nicholas Camill,0,0,30,30
1656915005184,MATH 10A,A01,083735,Patchell; Gregory David,1,0,30,29
1656915005184,MATH 10A,A02,083736,Patchell; Gregory David,20,0,30,10
1656915005184,MATH 10A,A03,083737,Patchell; Gregory David,15,0,30,15
1656915011212,MATH 10B,A01,083207,Lim; Seonhee,7,0,34,27
1656915011212,MATH 10B,A02,083208,Lim; Seonhee,9,0,35,26
1656915011212,MATH 10B,A03,093472,Lim; Seonhee,4,0,34,30
1656915011212,MATH 10B,B01,083739,Sinha; Shubham,9,0,30,21
1656915017244,MATH 18,A01,083743,Cinel; Cameron Alexander,6,0,30,24
1656915017244,MATH 18,A02,083744,Cinel; Cameron Alexander,15,0,30,15
1656915017244,MATH 18,A03,083745,Cinel; Cameron Alexander,8,0,30,22
1656915017244,MATH 18,B01,083748,Rideout; David Porter,4,0,37,33
1656915017244,MATH 18,B02,083749,Rideout; David Porter,3,0,36,33
1656915017244,MATH 18,B03,083750,Rideout; David Porter,2,0,37,35
1656915017244,MATH 18,B04,083751,Rideout; David Porter,5,0,36,31
1656915017244,MATH 18,B05,093473,Rideout; David Porter,4,0,36,32
1656915017244,MATH 18,B06,093474,Rideout; David Porter,5,0,36,31
1656915023277,MATH 20A,A01,083754,Zheng; Zequn,12,0,40,28
1656915029301,MATH 20B,A01,083756,Briones; Jor-el Thomas Caparas,1,0,36,35
1656915029301,MATH 20B,A02,083757,Briones; Jor-el Thomas Caparas,1,0,36,35
1656915029301,MATH 20B,A03,093475,Briones; Jor-el Thomas Caparas,0,0,36,36
1656915035324,MATH 20C,A01,083760,Briones; Jor-el Thomas Caparas,1,0,35,34
1656915035324,MATH 20C,A02,083761,Briones; Jor-el Thomas Caparas,8,0,35,27
1656915035324,MATH 20C,A03,093476,Briones; Jor-el Thomas Caparas,0,1,36,36
1656915035324,MATH 20C,B01,083762,Bach; Quang Tran,0,0,30,30
1656915041353,MATH 20D,A01,083765,Tran; Brian Kha,4,0,30,26
1656915041353,MATH 20D,A02,083766,Tran; Brian Kha,4,0,30,26
1656915041353,MATH 20D,A03,083767,Tran; Brian Kha,3,0,30,27
1656915047383,MATH 20E,A01,083771,Ganguly; Soumya,5,0,32,27
1656915047383,MATH 20E,A02,083772,Ganguly; Soumya,6,0,32,26
1656915047383,MATH 20E,B01,083773,Ciotti; Benjamin,18,0,35,17
1656915047383,MATH 20E,B02,083774,Ciotti; Benjamin,17,0,35,18
1656915053412,MATH 103A,A01,083777,Greenfeld; Be'Eri,2,0,36,34
1656915053412,MATH 103A,A02,083778,Greenfeld; Be'Eri,5,0,36,31
1656915053412,MATH 103A,A03,093561,Greenfeld; Be'Eri,4,0,36,32
1656915053412,MATH 103A,B01,083779,Greenfeld; Be'Eri,6,0,36,30
1656915053412,MATH 103A,B02,083780,Greenfeld; Be'Eri,2,0,36,34
1656915053412,MATH 103A,B03,093562,Greenfeld; Be'Eri,2,0,36,34
1656915059436,MATH 105,A01,085443,Carter; Anne Toulson,13,0,35,22
1656915059436,MATH 105,A02,093477,Carter; Anne Toulson,20,0,35,15
1656915065467,MATH 109,A01,083213,Ganzberger; Geoffrey Michael,2,0,34,32
1656915065467,MATH 109,A02,083214,Ganzberger; Geoffrey Michael,2,0,34,32
1656915065467,MATH 109,A03,093478,Ganzberger; Geoffrey Michael,1,0,34,33
1656915065467,MATH 109,B01,083215,Ganzberger; Geoffrey Michael,1,0,32,31
1656915065467,MATH 109,B02,083216,Ganzberger; Geoffrey Michael,1,0,32,31
1656915065467,MATH 109,B03,093479,Ganzberger; Geoffrey Michael,6,0,32,26
1656915071497,MATH 142A,A01,083219,Chow; Bennett,6,0,32,26
1656915071497,MATH 142A,A02,083220,Chow; Bennett,10,0,32,22
1656915071497,MATH 142A,A03,093480,Chow; Bennett,7,0,32,25
1656915071497,MATH 142A,B03,093481,Chow; Bennett,7,0,32,25
1656915071497,MATH 142A,B04,093558,Chow; Bennett,10,0,32,22
1656915071497,MATH 142A,B05,093559,Chow; Bennett,6,0,32,26
1656915077519,MATH 193A,A01,083224,Rotar; Vladimir,7,0,34,27
1656915077519,MATH 193A,A02,083225,Rotar; Vladimir,3,0,34,31
1656915077519,MATH 193A,A03,083781,Rotar; Vladimir,1,0,34,33
1656915077519,MATH 193A,A04,083782,Rotar; Vladimir,6,0,34,28
1656915077519,MATH 193A,A05,093482,Rotar; Vladimir,6,0,34,28
1656915083543,MATH 197,001,091859,McAuley; Julian John,9999,0,9999,0
1656915083543,MATH 197,002,095566,Kedlaya; Kiran S.,9997,0,9999,2
1656915083543,MATH 197,003,095567,Xiao; Ming,9999,0,9999,0
1656915083543,MATH 197,004,095571,Perols; Johan Lars,9998,0,9999,1
1656915090605,COGS 9,A01,083615,Shannon; Kyle Michael,7,0,75,68
1656915096634,COGS 11,A01,083617,Boyle; Mary E. T.,19,0,48,29
1656915102660,COGS 13,A01,083071,Bastos; Amalia Pinkusfeld,9,0,71,62
1656915108688,COGS 14A,A01,092681,Semenuks; Arturs,0,1,100,100
1656915114711,COGS 14B,A01,083073,Cheng; Tzu-Han,5,0,63,58
1656915120739,COGS 17,A01,092677,Semenuks; Arturs,4,0,81,77
1656915126769,COGS 100,A01,083619,Allen; Michael Gordon,15,0,70,55
1656915132792,COGS 101A,A01,083621,Davis; Joshua Daniel,9,0,68,59
1656915138815,COGS 101B,A01,091572,Allen; Michael Gordon,8,0,65,57
1656915144842,COGS 101C,A01,083625,Delgado; Tania,17,0,35,18
1656915150872,COGS 107A,A01,083627,Boyle; Mary E. T.,13,0,60,47
1656915156897,COGS 118A,A01,083075,Gupta; Anjum,15,0,76,61
1656915162925,CSE 3,A50,083646,Miranda; Gregory Joseph,22,0,50,28
1656915168949,CSE 8A,A50,083650,Miranda; Gregory Joseph,17,1,56,39
1656915174972,CSE 11,A01,083080,Cao; Yingjun,4,15,40,36
1656915180995,CSE 12,A01,083652,Krause-Levy; Sophia Louisa,20,1,120,100
1656915187021,CSE 15L,A01,083654,Morris; Justin Loren,8,0,50,42
1656915187021,CSE 15L,A02,083655,Morris; Justin Loren,8,0,50,42
1656915193051,CSE 20,A01,083657,Tran; Khoa Dang,37,0,80,43
1656915199078,CSE 21,A01,095574,Bach; Quang Tran,21,0,48,27
1656915205106,CSE 30,A01,083084,Eldon; John,4,0,80,76
1656915205106,CSE 30,B01,095061,Bhaskar; Nishant,6,0,50,44
1656915211131,CSE 100,A01,083659,Cao; Yingjun,2,4,70,68
1656915217157,CSE 134B,A01,083661,Powell; Thomas Allan,19,0,100,81
1656915223180,CSE 140,A01,083663,Gungor; Onat,14,0,85,71
1656915229202,CSE 140L,A01,083088,Eldon; John,16,0,100,84
1656915235225,CSE 175,A01,083665,Kumar; Rakesh,3,0,25,22
1656915241250,CSE 190,A00,092507,Dubnov; Shlomo,7,0,20,13
1656915247272,ECE 45,A01,083139,Congero; Spencer William,5,0,75,70
1656915253308,ECE 65,A50,083695,Saad; Andrew S,12,0,30,18
1656915253308,ECE 65,A51,095125,Saad; Andrew S,25,0,26,1
1656915259333,ECE 109,A01,091882,Touri; Behrouz,16,0,70,54
1656915265360,ECE 180,A00,083140,Abi Samra; Nicholas Camill,0,0,30,30
1656915265360,ECE 180,B00,083141,Abi Samra; Nicholas Camill,0,0,30,30
1656915271384,MATH 10A,A01,083735,Patchell; Gregory David,1,0,30,29
1656915271384,MATH 10A,A02,083736,Patchell; Gregory David,20,0,30,10
1656915271384,MATH 10A,A03,083737,Patchell; Gregory David,15,0,30,15
1656915277414,MATH 10B,A01,083207,Lim; Seonhee,7,0,34,27
1656915277414,MATH 10B,A02,083208,Lim; Seonhee,9,0,35,26
1656915277414,MATH 10B,A03,093472,Lim; Seonhee,4,0,34,30
1656915277414,MATH 10B,B01,083739,Sinha; Shubham,9,0,30,21
1656915283439,MATH 18,A01,083743,Cinel; Cameron Alexander,6,0,30,24
1656915283439,MATH 18,A02,083744,Cinel; Cameron Alexander,15,0,30,15
1656915283439,MATH 18,A03,083745,Cinel; Cameron Alexander,8,0,30,22
1656915283439,MATH 18,B01,083748,Rideout; David Porter,4,0,37,33
1656915283439,MATH 18,B02,083749,Rideout; David Porter,3,0,36,33
1656915283439,MATH 18,B03,083750,Rideout; David Porter,2,0,37,35
1656915283439,MATH 18,B04,083751,Rideout; David Porter,5,0,36,31
1656915283439,MATH 18,B05,093473,Rideout; David Porter,4,0,36,32
1656915283439,MATH 18,B06,093474,Rideout; David Porter,5,0,36,31
1656915289462,MATH 20A,A01,083754,Zheng; Zequn,12,0,40,28
1656915295489,MATH 20B,A01,083756,Briones; Jor-el Thomas Caparas,1,0,36,35
1656915295489,MATH 20B,A02,083757,Briones; Jor-el Thomas Caparas,1,0,36,35
1656915295489,MATH 20B,A03,093475,Briones; Jor-el Thomas Caparas,0,0,36,36
1656915301606,MATH 20C,A01,083760,Briones; Jor-el Thomas Caparas,1,0,35,34
1656915301606,MATH 20C,A02,083761,Briones; Jor-el Thomas Caparas,8,0,35,27
1656915301606,MATH 20C,A03,093476,Briones; Jor-el Thomas Caparas,0,1,36,36
1656915301606,MATH 20C,B01,083762,Bach; Quang Tran,0,0,30,30
1656915307629,MATH 20D,A01,083765,Tran; Brian Kha,4,0,30,26
1656915307629,MATH 20D,A02,083766,Tran; Brian Kha,4,0,30,26
1656915307629,MATH 20D,A03,083767,Tran; Brian Kha,3,0,30,27
1656915313659,MATH 20E,A01,083771,Ganguly; Soumya,5,0,32,27
1656915313659,MATH 20E,A02,083772,Ganguly; Soumya,6,0,32,26
1656915313659,MATH 20E,B01,083773,Ciotti; Benjamin,18,0,35,17
1656915313659,MATH 20E,B02,083774,Ciotti; Benjamin,17,0,35,18
1656915319689,MATH 103A,A01,083777,Greenfeld; Be'Eri,2,0,36,34
1656915319689,MATH 103A,A02,083778,Greenfeld; Be'Eri,5,0,36,31
1656915319689,MATH 103A,A03,093561,Greenfeld; Be'Eri,4,0,36,32
1656915319689,MATH 103A,B01,083779,Greenfeld; Be'Eri,6,0,36,30
1656915319689,MATH 103A,B02,083780,Greenfeld; Be'Eri,2,0,36,34
1656915319689,MATH 103A,B03,093562,Greenfeld; Be'Eri,2,0,36,34
1656915325712,MATH 105,A01,085443,Carter; Anne Toulson,13,0,35,22
1656915325712,MATH 105,A02,093477,Carter; Anne Toulson,20,0,35,15
1656915331735,MATH 109,A01,083213,Ganzberger; Geoffrey Michael,2,0,34,32
1656915331735,MATH 109,A02,083214,Ganzberger; Geoffrey Michael,2,0,34,32
1656915331735,MATH 109,A03,093478,Ganzberger; Geoffrey Michael,1,0,34,33
1656915331735,MATH 109,B01,083215,Ganzberger; Geoffrey Michael,1,0,32,31
1656915331735,MATH 109,B02,083216,Ganzberger; Geoffrey Michael,1,0,32,31
1656915331735,MATH 109,B03,093479,Ganzberger; Geoffrey Michael,6,0,32,26
1656915337762,MATH 142A,A01,083219,Chow; Bennett,6,0,32,26
1656915337762,MATH 142A,A02,083220,Chow; Bennett,10,0,32,22
1656915337762,MATH 142A,A03,093480,Chow; Bennett,7,0,32,25
1656915337762,MATH 142A,B03,093481,Chow; Bennett,7,0,32,25
1656915337762,MATH 142A,B04,093558,Chow; Bennett,10,0,32,22
1656915337762,MATH 142A,B05,093559,Chow; Bennett,6,0,32,26
1656915343788,MATH 193A,A01,083224,Rotar; Vladimir,7,0,34,27
1656915343788,MATH 193A,A02,083225,Rotar; Vladimir,3,0,34,31
1656915343788,MATH 193A,A03,083781,Rotar; Vladimir,1,0,34,33
1656915343788,MATH 193A,A04,083782,Rotar; Vladimir,6,0,34,28
1656915343788,MATH 193A,A05,093482,Rotar; Vladimir,6,0,34,28
1656915349810,MATH 197,001,091859,McAuley; Julian John,9999,0,9999,0
1656915349810,MATH 197,002,095566,Kedlaya; Kiran S.,9997,0,9999,2
1656915349810,MATH 197,003,095567,Xiao; Ming,9999,0,9999,0
1656915349810,MATH 197,004,095571,Perols; Johan Lars,9998,0,9999,1
1656915356883,COGS 9,A01,083615,Shannon; Kyle Michael,7,0,75,68
1656915362911,COGS 11,A01,083617,Boyle; Mary E. T.,19,0,48,29
1656915368938,COGS 13,A01,083071,Bastos; Amalia Pinkusfeld,9,0,71,62
1656915374962,COGS 14A,A01,092681,Semenuks; Arturs,0,1,100,100
1656915380985,COGS 14B,A01,083073,Cheng; Tzu-Han,5,0,63,58
1656915387022,COGS 17,A01,092677,Semenuks; Arturs,4,0,81,77
1656915393055,COGS 100,A01,083619,Allen; Michael Gordon,15,0,70,55
1656915399084,COGS 101A,A01,083621,Davis; Joshua Daniel,9,0,68,59
1656915405117,COGS 101B,A01,091572,Allen; Michael Gordon,8,0,65,57
1656915411141,COGS 101C,A01,083625,Delgado; Tania,17,0,35,18
1656915417166,COGS 107A,A01,083627,Boyle; Mary E. T.,13,0,60,47
1656915423189,COGS 118A,A01,083075,Gupta; Anjum,15,0,76,61
1656915429221,CSE 3,A50,083646,Miranda; Gregory Joseph,22,0,50,28
1656915435245,CSE 8A,A50,083650,Miranda; Gregory Joseph,17,1,56,39
1656915441269,CSE 11,A01,083080,Cao; Yingjun,4,15,40,36
1656915447293,CSE 12,A01,083652,Krause-Levy; Sophia Louisa,20,1,120,100
1656915453321,CSE 15L,A01,083654,Morris; Justin Loren,8,0,50,42
1656915453321,CSE 15L,A02,083655,Morris; Justin Loren,8,0,50,42
1656915459348,CSE 20,A01,083657,Tran; Khoa Dang,37,0,80,43
1656915465374,CSE 21,A01,095574,Bach; Quang Tran,21,0,48,27
1656915471399,CSE 30,A01,083084,Eldon; John,4,0,80,76
1656915471399,CSE 30,B01,095061,Bhaskar; Nishant,6,0,50,44
1656915477427,CSE 100,A01,083659,Cao; Yingjun,2,4,70,68
1656915483450,CSE 134B,A01,083661,Powell; Thomas Allan,19,0,100,81
1656915489472,CSE 140,A01,083663,Gungor; Onat,14,0,85,71
1656915495496,CSE 140L,A01,083088,Eldon; John,16,0,100,84
1656915501520,CSE 175,A01,083665,Kumar; Rakesh,3,0,25,22
1656915507546,CSE 190,A00,092507,Dubnov; Shlomo,7,0,20,13
1656915513575,ECE 45,A01,083139,Congero; Spencer William,5,0,75,70
1656915519604,ECE 65,A50,083695,Saad; Andrew S,12,0,30,18
1656915519604,ECE 65,A51,095125,Saad; Andrew S,25,0,26,1
1656915525627,ECE 109,A01,091882,Touri; Behrouz,16,0,70,54
1656915531651,ECE 180,A00,083140,Abi Samra; Nicholas Camill,0,0,30,30
1656915531651,ECE 180,B00,083141,Abi Samra; Nicholas Camill,0,0,30,30
1656915537677,MATH 10A,A01,083735,Patchell; Gregory David,1,0,30,29
1656915537677,MATH 10A,A02,083736,Patchell; Gregory David,20,0,30,10
1656915537677,MATH 10A,A03,083737,Patchell; Gregory David,15,0,30,15
1656915543702,MATH 10B,A01,083207,Lim; Seonhee,7,0,34,27
1656915543702,MATH 10B,A02,083208,Lim; Seonhee,9,0,35,26
1656915543702,MATH 10B,A03,093472,Lim; Seonhee,4,0,34,30
1656915543702,MATH 10B,B01,083739,Sinha; Shubham,9,0,30,21
1656915549727,MATH 18,A01,083743,Cinel; Cameron Alexander,6,0,30,24
1656915549727,MATH 18,A02,083744,Cinel; Cameron Alexander,15,0,30,15
1656915549727,MATH 18,A03,083745,Cinel; Cameron Alexander,8,0,30,22
1656915549727,MATH 18,B01,083748,Rideout; David Porter,4,0,37,33
1656915549727,MATH 18,B02,083749,Rideout; David Porter,3,0,36,33
1656915549727,MATH 18,B03,083750,Rideout; David Porter,2,0,37,35
1656915549727,MATH 18,B04,083751,Rideout; David Porter,5,0,36,31
1656915549727,MATH 18,B05,093473,Rideout; David Porter,4,0,36,32
1656915549727,MATH 18,B06,093474,Rideout; David Porter,5,0,36,31
1656915555751,MATH 20A,A01,083754,Zheng; Zequn,12,0,40,28
1656915561775,MATH 20B,A01,083756,Briones; Jor-el Thomas Caparas,1,0,36,35
1656915561775,MATH 20B,A02,083757,Briones; Jor-el Thomas Caparas,1,0,36,35
1656915561775,MATH 20B,A03,093475,Briones; Jor-el Thomas Caparas,0,0,36,36
1656915567800,MATH 20C,A01,083760,Briones; Jor-el Thomas Caparas,1,0,35,34
1656915567800,MATH 20C,A02,083761,Briones; Jor-el Thomas Caparas,8,0,35,27
1656915567800,MATH 20C,A03,093476,Briones; Jor-el Thomas Caparas,0,1,36,36
1656915567800,MATH 20C,B01,083762,Bach; Quang Tran,0,0,30,30
1656915573840,MATH 20D,A01,083765,Tran; Brian Kha,4,0,30,26
1656915573840,MATH 20D,A02,083766,Tran; Brian Kha,4,0,30,26
1656915573840,MATH 20D,A03,083767,Tran; Brian Kha,3,0,30,27
1656915579871,MATH 20E,A01,083771,Ganguly; Soumya,5,0,32,27
1656915579871,MATH 20E,A02,083772,Ganguly; Soumya,6,0,32,26
1656915579871,MATH 20E,B01,083773,Ciotti; Benjamin,18,0,35,17
1656915579871,MATH 20E,B02,083774,Ciotti; Benjamin,17,0,35,18
1656915585894,MATH 103A,A01,083777,Greenfeld; Be'Eri,2,0,36,34
1656915585894,MATH 103A,A02,083778,Greenfeld; Be'Eri,5,0,36,31
1656915585894,MATH 103A,A03,093561,Greenfeld; Be'Eri,4,0,36,32
1656915585894,MATH 103A,B01,083779,Greenfeld; Be'Eri,6,0,36,30
1656915585894,MATH 103A,B02,083780,Greenfeld; Be'Eri,2,0,36,34
1656915585894,MATH 103A,B03,093562,Greenfeld; Be'Eri,2,0,36,34
1656915591924,MATH 105,A01,085443,Carter; Anne Toulson,13,0,35,22
1656915591924,MATH 105,A02,093477,Carter; Anne Toulson,20,0,35,15
1656915597955,MATH 109,A01,083213,Ganzberger; Geoffrey Michael,2,0,34,32
1656915597955,MATH 109,A02,083214,Ganzberger; Geoffrey Michael,2,0,34,32
1656915597955,MATH 109,A03,093478,Ganzberger; Geoffrey Michael,1,0,34,33
1656915597955,MATH 109,B01,083215,Ganzberger; Geoffrey Michael,1,0,32,31
1656915597955,MATH 109,B02,083216,Ganzberger; Geoffrey Michael,1,0,32,31
1656915597955,MATH 109,B03,093479,Ganzberger; Geoffrey Michael,6,0,32,26
1656915603977,MATH 142A,A01,083219,Chow; Bennett,6,0,32,26
1656915603977,MATH 142A,A02,083220,Chow; Bennett,10,0,32,22
1656915603977,MATH 142A,A03,093480,Chow; Bennett,7,0,32,25
1656915603977,MATH 142A,B03,093481,Chow; Bennett,7,0,32,25
1656915603977,MATH 142A,B04,093558,Chow; Bennett,10,0,32,22
1656915603977,MATH 142A,B05,093559,Chow; Bennett,6,0,32,26
1656915610013,MATH 193A,A01,083224,Rotar; Vladimir,7,0,34,27
1656915610013,MATH 193A,A02,083225,Rotar; Vladimir,3,0,34,31
1656915610013,MATH 193A,A03,083781,Rotar; Vladimir,1,0,34,33
1656915610013,MATH 193A,A04,083782,Rotar; Vladimir,6,0,34,28
1656915610013,MATH 193A,A05,093482,Rotar; Vladimir,6,0,34,28
1656915616036,MATH 197,001,091859,McAuley; Julian John,9999,0,9999,0
1656915616036,MATH 197,002,095566,Kedlaya; Kiran S.,9997,0,9999,2
1656915616036,MATH 197,003,095567,Xiao; Ming,9999,0,9999,0
1656915616036,MATH 197,004,095571,Perols; Johan Lars,9998,0,9999,1
1656915623097,COGS 9,A01,083615,Shannon; Kyle Michael,7,0,75,68
1656915629122,COGS 11,A01,083617,Boyle; Mary E. T.,19,0,48,29
1656915635150,COGS 13,A01,083071,Bastos; Amalia Pinkusfeld,9,0,71,62
1656915641175,COGS 14A,A01,092681,Semenuks; Arturs,0,1,100,100
1656915647200,COGS 14B,A01,083073,Cheng; Tzu-Han,5,0,63,58
1656915653225,COGS 17,A01,092677,Semenuks; Arturs,4,0,81,77
1656915659248,COGS 100,A01,083619,Allen; Michael Gordon,15,0,70,55
1656915665283,COGS 101A,A01,083621,Davis; Joshua Daniel,9,0,68,59
1656915671308,COGS 101B,A01,091572,Allen; Michael Gordon,8,0,65,57
1656915677340,COGS 101C,A01,083625,Delgado; Tania,17,0,35,18
1656915683362,COGS 107A,A01,083627,Boyle; Mary E. T.,13,0,60,47
1656915689389,COGS 118A,A01,083075,Gupta; Anjum,15,0,76,61
1656915695413,CSE 3,A50,083646,Miranda; Gregory Joseph,22,0,50,28
1656915701437,CSE 8A,A50,083650,Miranda; Gregory Joseph,17,1,56,39
1656915707461,CSE 11,A01,083080,Cao; Yingjun,4,15,40,36
1656915713489,CSE 12,A01,083652,Krause-Levy; Sophia Louisa,20,1,120,100
1656915719516,CSE 15L,A01,083654,Morris; Justin Loren,8,0,50,42
1656915719516,CSE 15L,A02,083655,Morris; Justin Loren,8,0,50,42
1656915725541,CSE 20,A01,083657,Tran; Khoa Dang,37,0,80,43
1656915731568,CSE 21,A01,095574,Bach; Quang Tran,21,0,48,27
1656915737596,CSE 30,A01,083084,Eldon; John,4,0,80,76
1656915737596,CSE 30,B01,095061,Bhaskar; Nishant,6,0,50,44
1656915743624,CSE 100,A01,083659,Cao; Yingjun,3,4,70,67
1656915749653,CSE 134B,A01,083661,Powell; Thomas Allan,19,0,100,81
1656915755680,CSE 140,A01,083663,Gungor; Onat,14,0,85,71
1656915761707,CSE 140L,A01,083088,Eldon; John,16,0,100,84
1656915767735,CSE 175,A01,083665,Kumar; Rakesh,3,0,25,22
1656915773759,CSE 190,A00,092507,Dubnov; Shlomo,7,0,20,13
1656915779787,ECE 45,A01,083139,Congero; Spencer William,5,0,75,70
1656915785817,ECE 65,A50,083695,Saad; Andrew S,12,0,30,18
1656915785817,ECE 65,A51,095125,Saad; Andrew S,25,0,26,1
1656915791859,ECE 109,A01,091882,Touri; Behrouz,16,0,70,54
1656915797896,ECE 180,A00,083140,Abi Samra; Nicholas Camill,0,0,30,30
1656915797896,ECE 180,B00,083141,Abi Samra; Nicholas Camill,0,0,30,30
1656915803925,MATH 10A,A01,083735,Patchell; Gregory David,1,0,30,29
1656915803925,MATH 10A,A02,083736,Patchell; Gregory David,20,0,30,10
1656915803925,MATH 10A,A03,083737,Patchell; Gregory David,15,0,30,15
1656915809957,MATH 10B,A01,083207,Lim; Seonhee,7,0,34,27
1656915809957,MATH 10B,A02,083208,Lim; Seonhee,9,0,35,26
1656915809957,MATH 10B,A03,093472,Lim; Seonhee,4,0,34,30
1656915809957,MATH 10B,B01,083739,Sinha; Shubham,9,0,30,21
1656915815981,MATH 18,A01,083743,Cinel; Cameron Alexander,6,0,30,24
1656915815981,MATH 18,A02,083744,Cinel; Cameron Alexander,15,0,30,15
1656915815981,MATH 18,A03,083745,Cinel; Cameron Alexander,8,0,30,22
1656915815981,MATH 18,B01,083748,Rideout; David Porter,4,0,37,33
1656915815981,MATH 18,B02,083749,Rideout; David Porter,3,0,36,33
1656915815981,MATH 18,B03,083750,Rideout; David Porter,2,0,37,35
1656915815981,MATH 18,B04,083751,Rideout; David Porter,5,0,36,31
1656915815981,MATH 18,B05,093473,Rideout; David Porter,4,0,36,32
1656915815981,MATH 18,B06,093474,Rideout; David Porter,5,0,36,31
1656915822004,MATH 20A,A01,083754,Zheng; Zequn,12,0,40,28
1656915828034,MATH 20B,A01,083756,Briones; Jor-el Thomas Caparas,1,0,36,35
1656915828034,MATH 20B,A02,083757,Briones; Jor-el Thomas Caparas,1,0,36,35
1656915828034,MATH 20B,A03,093475,Briones; Jor-el Thomas Caparas,0,0,36,36
1656915834068,MATH 20C,A01,083760,Briones; Jor-el Thomas Caparas,1,0,35,34
1656915834068,MATH 20C,A02,083761,Briones; Jor-el Thomas Caparas,8,0,35,27
1656915834068,MATH 20C,A03,093476,Briones; Jor-el Thomas Caparas,0,1,36,36
1656915834068,MATH 20C,B01,083762,Bach; Quang Tran,0,0,30,30
1656915840098,MATH 20D,A01,083765,Tran; Brian Kha,4,0,30,26
1656915840098,MATH 20D,A02,083766,Tran; Brian Kha,4,0,30,26
1656915840098,MATH 20D,A03,083767,Tran; Brian Kha,3,0,30,27
1656915846127,MATH 20E,A01,083771,Ganguly; Soumya,5,0,32,27
1656915846127,MATH 20E,A02,083772,Ganguly; Soumya,6,0,32,26
1656915846127,MATH 20E,B01,083773,Ciotti; Benjamin,18,0,35,17
1656915846127,MATH 20E,B02,083774,Ciotti; Benjamin,17,0,35,18
1656915852166,MATH 103A,A01,083777,Greenfeld; Be'Eri,2,0,36,34
1656915852166,MATH 103A,A02,083778,Greenfeld; Be'Eri,5,0,36,31
1656915852166,MATH 103A,A03,093561,Greenfeld; Be'Eri,4,0,36,32
1656915852166,MATH 103A,B01,083779,Greenfeld; Be'Eri,6,0,36,30
1656915852166,MATH 103A,B02,083780,Greenfeld; Be'Eri,2,0,36,34
1656915852166,MATH 103A,B03,093562,Greenfeld; Be'Eri,2,0,36,34
1656915858197,MATH 105,A01,085443,Carter; Anne Toulson,13,0,35,22
1656915858197,MATH 105,A02,093477,Carter; Anne Toulson,20,0,35,15
1656915864222,MATH 109,A01,083213,Ganzberger; Geoffrey Michael,2,0,34,32
1656915864222,MATH 109,A02,083214,Ganzberger; Geoffrey Michael,2,0,34,32
1656915864222,MATH 109,A03,093478,Ganzberger; Geoffrey Michael,1,0,34,33
1656915864222,MATH 109,B01,083215,Ganzberger; Geoffrey Michael,1,0,32,31
1656915864222,MATH 109,B02,083216,Ganzberger; Geoffrey Michael,1,0,32,31
1656915864222,MATH 109,B03,093479,Ganzberger; Geoffrey Michael,6,0,32,26
1656915870253,MATH 142A,A01,083219,Chow; Bennett,6,0,32,26
1656915870253,MATH 142A,A02,083220,Chow; Bennett,10,0,32,22
1656915870253,MATH 142A,A03,093480,Chow; Bennett,7,0,32,25
1656915870253,MATH 142A,B03,093481,Chow; Bennett,7,0,32,25
1656915870253,MATH 142A,B04,093558,Chow; Bennett,10,0,32,22
1656915870253,MATH 142A,B05,093559,Chow; Bennett,6,0,32,26
1656915876277,MATH 193A,A01,083224,Rotar; Vladimir,7,0,34,27
1656915876277,MATH 193A,A02,083225,Rotar; Vladimir,3,0,34,31
1656915876277,MATH 193A,A03,083781,Rotar; Vladimir,1,0,34,33
1656915876277,MATH 193A,A04,083782,Rotar; Vladimir,6,0,34,28
1656915876277,MATH 193A,A05,093482,Rotar; Vladimir,6,0,34,28
1656915882302,MATH 197,001,091859,McAuley; Julian John,9999,0,9999,0
1656915882302,MATH 197,002,095566,Kedlaya; Kiran S.,9997,0,9999,2
1656915882302,MATH 197,003,095567,Xiao; Ming,9999,0,9999,0
1656915882302,MATH 197,004,095571,Perols; Johan Lars,9998,0,9999,1
1656915889360,COGS 9,A01,083615,Shannon; Kyle Michael,7,0,75,68
1656915895488,COGS 11,A01,083617,Boyle; Mary E. T.,19,0,48,29
1656915901518,COGS 13,A01,083071,Bastos; Amalia Pinkusfeld,9,0,71,62
1656915907563,COGS 14A,A01,092681,Semenuks; Arturs,0,1,100,100
1656915913588,COGS 14B,A01,083073,Cheng; Tzu-Han,5,0,63,58
1656915919612,COGS 17,A01,092677,Semenuks; Arturs,4,0,81,77
1656915925638,COGS 100,A01,083619,Allen; Michael Gordon,15,0,70,55
1656915931661,COGS 101A,A01,083621,Davis; Joshua Daniel,9,0,68,59
1656915937685,COGS 101B,A01,091572,Allen; Michael Gordon,8,0,65,57
1656915943709,COGS 101C,A01,083625,Delgado; Tania,17,0,35,18
1656915949741,COGS 107A,A01,083627,Boyle; Mary E. T.,13,0,60,47
1656915955773,COGS 118A,A01,083075,Gupta; Anjum,15,0,76,61
1656915961800,CSE 3,A50,083646,Miranda; Gregory Joseph,22,0,50,28
1656915967830,CSE 8A,A50,083650,Miranda; Gregory Joseph,17,1,56,39
1656915973853,CSE 11,A01,083080,Cao; Yingjun,4,15,40,36
1656915979875,CSE 12,A01,083652,Krause-Levy; Sophia Louisa,20,1,120,100
1656915985913,CSE 15L,A01,083654,Morris; Justin Loren,8,0,50,42
1656915985913,CSE 15L,A02,083655,Morris; Justin Loren,8,0,50,42
1656915991937,CSE 20,A01,083657,Tran; Khoa Dang,37,0,80,43
1656915997962,CSE 21,A01,095574,Bach; Quang Tran,21,0,48,27
1656916003986,CSE 30,A01,083084,Eldon; John,4,0,80,76
1656916003986,CSE 30,B01,095061,Bhaskar; Nishant,6,0,50,44
1656916010014,CSE 100,A01,083659,Cao; Yingjun,3,4,70,67
1656916016043,CSE 134B,A01,083661,Powell; Thomas Allan,19,0,100,81
1656916022069,CSE 140,A01,083663,Gungor; Onat,14,0,85,71
1656916028096,CSE 140L,A01,083088,Eldon; John,16,0,100,84
1656916034124,CSE 175,A01,083665,Kumar; Rakesh,3,0,25,22
1656916040150,CSE 190,A00,092507,Dubnov; Shlomo,7,0,20,13
1656916046177,ECE 45,A01,083139,Congero; Spencer William,5,0,75,70
1656916052201,ECE 65,A50,083695,Saad; Andrew S,12,0,30,18
1656916052201,ECE 65,A51,095125,Saad; Andrew S,25,0,26,1
1656916058228,ECE 109,A01,091882,Touri; Behrouz,16,0,70,54
1656916064251,ECE 180,A00,083140,Abi Samra; Nicholas Camill,0,0,30,30
1656916064251,ECE 180,B00,083141,Abi Samra; Nicholas Camill,0,0,30,30
1656916070275,MATH 10A,A01,083735,Patchell; Gregory David,1,0,30,29
1656916070275,MATH 10A,A02,083736,Patchell; Gregory David,20,0,30,10
1656916070275,MATH 10A,A03,083737,Patchell; Gregory David,15,0,30,15
1656916076300,MATH 10B,A01,083207,Lim; Seonhee,7,0,34,27
1656916076300,MATH 10B,A02,083208,Lim; Seonhee,9,0,35,26
1656916076300,MATH 10B,A03,093472,Lim; Seonhee,4,0,34,30
1656916076300,MATH 10B,B01,083739,Sinha; Shubham,9,0,30,21
1656916082325,MATH 18,A01,083743,Cinel; Cameron Alexander,6,0,30,24
1656916082325,MATH 18,A02,083744,Cinel; Cameron Alexander,15,0,30,15
1656916082325,MATH 18,A03,083745,Cinel; Cameron Alexander,8,0,30,22
1656916082325,MATH 18,B01,083748,Rideout; David Porter,4,0,37,33
1656916082325,MATH 18,B02,083749,Rideout; David Porter,3,0,36,33
1656916082325,MATH 18,B03,083750,Rideout; David Porter,2,0,37,35
1656916082325,MATH 18,B04,083751,Rideout; David Porter,5,0,36,31
1656916082325,MATH 18,B05,093473,Rideout; David Porter,4,0,36,32
1656916082325,MATH 18,B06,093474,Rideout; David Porter,5,0,36,31
1656916088353,MATH 20A,A01,083754,Zheng; Zequn,12,0,40,28
1656916094377,MATH 20B,A01,083756,Briones; Jor-el Thomas Caparas,1,0,36,35
1656916094377,MATH 20B,A02,083757,Briones; Jor-el Thomas Caparas,1,0,36,35
1656916094377,MATH 20B,A03,093475,Briones; Jor-el Thomas Caparas,0,0,36,36
1656916100401,MATH 20C,A01,083760,Briones; Jor-el Thomas Caparas,1,0,35,34
1656916100401,MATH 20C,A02,083761,Briones; Jor-el Thomas Caparas,8,0,35,27
1656916100401,MATH 20C,A03,093476,Briones; Jor-el Thomas Caparas,0,1,36,36
1656916100401,MATH 20C,B01,083762,Bach; Quang Tran,0,0,30,30
1656916106428,MATH 20D,A01,083765,Tran; Brian Kha,4,0,30,26
1656916106428,MATH 20D,A02,083766,Tran; Brian Kha,4,0,30,26
1656916106428,MATH 20D,A03,083767,Tran; Brian Kha,3,0,30,27
1656916112457,MATH 20E,A01,083771,Ganguly; Soumya,5,0,32,27
1656916112457,MATH 20E,A02,083772,Ganguly; Soumya,6,0,32,26
1656916112457,MATH 20E,B01,083773,Ciotti; Benjamin,18,0,35,17
1656916112457,MATH 20E,B02,083774,Ciotti; Benjamin,17,0,35,18
1656916118489,MATH 103A,A01,083777,Greenfeld; Be'Eri,2,0,36,34
1656916118489,MATH 103A,A02,083778,Greenfeld; Be'Eri,5,0,36,31
1656916118489,MATH 103A,A03,093561,Greenfeld; Be'Eri,4,0,36,32
1656916118489,MATH 103A,B01,083779,Greenfeld; Be'Eri,6,0,36,30
1656916118489,MATH 103A,B02,083780,Greenfeld; Be'Eri,2,0,36,34
1656916118489,MATH 103A,B03,093562,Greenfeld; Be'Eri,2,0,36,34
1656916124514,MATH 105,A01,085443,Carter; Anne Toulson,13,0,35,22
1656916124514,MATH 105,A02,093477,Carter; Anne Toulson,20,0,35,15
1656916130545,MATH 109,A01,083213,Ganzberger; Geoffrey Michael,2,0,34,32
1656916130545,MATH 109,A02,083214,Ganzberger; Geoffrey Michael,2,0,34,32
1656916130545,MATH 109,A03,093478,Ganzberger; Geoffrey Michael,1,0,34,33
1656916130545,MATH 109,B01,083215,Ganzberger; Geoffrey Michael,1,0,32,31
1656916130545,MATH 109,B02,083216,Ganzberger; Geoffrey Michael,1,0,32,31
1656916130545,MATH 109,B03,093479,Ganzberger; Geoffrey Michael,6,0,32,26
1656916136576,MATH 142A,A01,083219,Chow; Bennett,6,0,32,26
1656916136576,MATH 142A,A02,083220,Chow; Bennett,10,0,32,22
1656916136576,MATH 142A,A03,093480,Chow; Bennett,7,0,32,25
1656916136576,MATH 142A,B03,093481,Chow; Bennett,7,0,32,25
1656916136576,MATH 142A,B04,093558,Chow; Bennett,10,0,32,22
1656916136576,MATH 142A,B05,093559,Chow; Bennett,6,0,32,26
1656916142605,MATH 193A,A01,083224,Rotar; Vladimir,7,0,34,27
1656916142605,MATH 193A,A02,083225,Rotar; Vladimir,3,0,34,31
1656916142605,MATH 193A,A03,083781,Rotar; Vladimir,1,0,34,33
1656916142605,MATH 193A,A04,083782,Rotar; Vladimir,6,0,34,28
1656916142605,MATH 193A,A05,093482,Rotar; Vladimir,6,0,34,28
1656916148633,MATH 197,001,091859,McAuley; Julian John,9999,0,9999,0
1656916148633,MATH 197,002,095566,Kedlaya; Kiran S.,9997,0,9999,2
1656916148633,MATH 197,003,095567,Xiao; Ming,9999,0,9999,0
1656916148633,MATH 197,004,095571,Perols; Johan Lars,9998,0,9999,1
1656916155712,COGS 9,A01,083615,Shannon; Kyle Michael,7,0,75,68
1656916161737,COGS 11,A01,083617,Boyle; Mary E. T.,19,0,48,29
1656916167760,COGS 13,A01,083071,Bastos; Amalia Pinkusfeld,9,0,71,62
1656916173787,COGS 14A,A01,092681,Semenuks; Arturs,0,1,100,100
1656916179811,COGS 14B,A01,083073,Cheng; Tzu-Han,5,0,63,58
1656916185834,COGS 17,A01,092677,Semenuks; Arturs,4,0,81,77
1656916191857,COGS 100,A01,083619,Allen; Michael Gordon,15,0,70,55
1656916197881,COGS 101A,A01,083621,Davis; Joshua Daniel,9,0,68,59
1656916203907,COGS 101B,A01,091572,Allen; Michael Gordon,8,0,65,57
1656916209929,COGS 101C,A01,083625,Delgado; Tania,17,0,35,18
1656916215952,COGS 107A,A01,083627,Boyle; Mary E. T.,13,0,60,47
1656916221976,COGS 118A,A01,083075,Gupta; Anjum,15,0,76,61
1656916228000,CSE 3,A50,083646,Miranda; Gregory Joseph,22,0,50,28
1656916234024,CSE 8A,A50,083650,Miranda; Gregory Joseph,17,1,56,39
1656916240047,CSE 11,A01,083080,Cao; Yingjun,4,15,40,36
1656916246073,CSE 12,A01,083652,Krause-Levy; Sophia Louisa,20,1,120,100
1656916252094,CSE 15L,A01,083654,Morris; Justin Loren,8,0,50,42
1656916252094,CSE 15L,A02,083655,Morris; Justin Loren,8,0,50,42
1656916258118,CSE 20,A01,083657,Tran; Khoa Dang,37,0,80,43
1656916264144,CSE 21,A01,095574,Bach; Quang Tran,21,0,48,27
1656916270172,CSE 30,A01,083084,Eldon; John,4,0,80,76
1656916270172,CSE 30,B01,095061,Bhaskar; Nishant,6,0,50,44
1656916276196,CSE 100,A01,083659,Cao; Yingjun,3,4,70,67
1656916282220,CSE 134B,A01,083661,Powell; Thomas Allan,19,0,100,81
1656916288242,CSE 140,A01,083663,Gungor; Onat,14,0,85,71
1656916294266,CSE 140L,A01,083088,Eldon; John,16,0,100,84
1656916300299,CSE 175,A01,083665,Kumar; Rakesh,3,0,25,22
1656916306330,CSE 190,A00,092507,Dubnov; Shlomo,7,0,20,13
1656916312358,ECE 45,A01,083139,Congero; Spencer William,5,0,75,70
1656916318382,ECE 65,A50,083695,Saad; Andrew S,12,0,30,18
1656916318382,ECE 65,A51,095125,Saad; Andrew S,25,0,26,1
1656916324412,ECE 109,A01,091882,Touri; Behrouz,16,0,70,54
1656916330434,ECE 180,A00,083140,Abi Samra; Nicholas Camill,0,0,30,30
1656916330434,ECE 180,B00,083141,Abi Samra; Nicholas Camill,0,0,30,30
1656916336458,MATH 10A,A01,083735,Patchell; Gregory David,1,0,30,29
1656916336458,MATH 10A,A02,083736,Patchell; Gregory David,20,0,30,10
1656916336458,MATH 10A,A03,083737,Patchell; Gregory David,15,0,30,15
1656916342483,MATH 10B,A01,083207,Lim; Seonhee,7,0,34,27
1656916342483,MATH 10B,A02,083208,Lim; Seonhee,9,0,35,26
1656916342483,MATH 10B,A03,093472,Lim; Seonhee,4,0,34,30
1656916342483,MATH 10B,B01,083739,Sinha; Shubham,9,0,30,21
1656916348507,MATH 18,A01,083743,Cinel; Cameron Alexander,6,0,30,24
1656916348507,MATH 18,A02,083744,Cinel; Cameron Alexander,15,0,30,15
1656916348507,MATH 18,A03,083745,Cinel; Cameron Alexander,8,0,30,22
1656916348507,MATH 18,B01,083748,Rideout; David Porter,4,0,37,33
1656916348507,MATH 18,B02,083749,Rideout; David Porter,3,0,36,33
1656916348507,MATH 18,B03,083750,Rideout; David Porter,2,0,37,35
1656916348507,MATH 18,B04,083751,Rideout; David Porter,5,0,36,31
1656916348507,MATH 18,B05,093473,Rideout; David Porter,4,0,36,32
1656916348507,MATH 18,B06,093474,Rideout; David Porter,5,0,36,31
1656916354534,MATH 20A,A01,083754,Zheng; Zequn,12,0,40,28
1656916360558,MATH 20B,A01,083756,Briones; Jor-el Thomas Caparas,1,0,36,35
1656916360558,MATH 20B,A02,083757,Briones; Jor-el Thomas Caparas,1,0,36,35
1656916360558,MATH 20B,A03,093475,Briones; Jor-el Thomas Caparas,0,0,36,36
1656916366583,MATH 20C,A01,083760,Briones; Jor-el Thomas Caparas,1,0,35,34
1656916366583,MATH 20C,A02,083761,Briones; Jor-el Thomas Caparas,8,0,35,27
1656916366583,MATH 20C,A03,093476,Briones; Jor-el Thomas Caparas,0,1,36,36
1656916366583,MATH 20C,B01,083762,Bach; Quang Tran,0,0,30,30
1656916372612,MATH 20D,A01,083765,Tran; Brian Kha,4,0,30,26
1656916372612,MATH 20D,A02,083766,Tran; Brian Kha,4,0,30,26
1656916372612,MATH 20D,A03,083767,Tran; Brian Kha,3,0,30,27
1656916378642,MATH 20E,A01,083771,Ganguly; Soumya,5,0,32,27
1656916378642,MATH 20E,A02,083772,Ganguly; Soumya,6,0,32,26
1656916378642,MATH 20E,B01,083773,Ciotti; Benjamin,18,0,35,17
1656916378642,MATH 20E,B02,083774,Ciotti; Benjamin,17,0,35,18
1656916384673,MATH 103A,A01,083777,Greenfeld; Be'Eri,2,0,36,34
1656916384673,MATH 103A,A02,083778,Greenfeld; Be'Eri,5,0,36,31
1656916384673,MATH 103A,A03,093561,Greenfeld; Be'Eri,4,0,36,32
1656916384673,MATH 103A,B01,083779,Greenfeld; Be'Eri,6,0,36,30
1656916384673,MATH 103A,B02,083780,Greenfeld; Be'Eri,2,0,36,34
1656916384673,MATH 103A,B03,093562,Greenfeld; Be'Eri,2,0,36,34
1656916390700,MATH 105,A01,085443,Carter; Anne Toulson,13,0,35,22
1656916390700,MATH 105,A02,093477,Carter; Anne Toulson,20,0,35,15
1656916396722,MATH 109,A01,083213,Ganzberger; Geoffrey Michael,2,0,34,32
1656916396722,MATH 109,A02,083214,Ganzberger; Geoffrey Michael,2,0,34,32
1656916396722,MATH 109,A03,093478,Ganzberger; Geoffrey Michael,1,0,34,33
1656916396722,MATH 109,B01,083215,Ganzberger; Geoffrey Michael,1,0,32,31
1656916396722,MATH 109,B02,083216,Ganzberger; Geoffrey Michael,1,0,32,31
1656916396722,MATH 109,B03,093479,Ganzberger; Geoffrey Michael,6,0,32,26
1656916402746,MATH 142A,A01,083219,Chow; Bennett,6,0,32,26
1656916402746,MATH 142A,A02,083220,Chow; Bennett,10,0,32,22
1656916402746,MATH 142A,A03,093480,Chow; Bennett,7,0,32,25
1656916402746,MATH 142A,B03,093481,Chow; Bennett,7,0,32,25
1656916402746,MATH 142A,B04,093558,Chow; Bennett,10,0,32,22
1656916402746,MATH 142A,B05,093559,Chow; Bennett,6,0,32,26
1656916408774,MATH 193A,A01,083224,Rotar; Vladimir,7,0,34,27
1656916408774,MATH 193A,A02,083225,Rotar; Vladimir,3,0,34,31
1656916408774,MATH 193A,A03,083781,Rotar; Vladimir,1,0,34,33
1656916408774,MATH 193A,A04,083782,Rotar; Vladimir,6,0,34,28
1656916408774,MATH 193A,A05,093482,Rotar; Vladimir,6,0,34,28
1656916414798,MATH 197,001,091859,McAuley; Julian John,9999,0,9999,0
1656916414798,MATH 197,002,095566,Kedlaya; Kiran S.,9997,0,9999,2
1656916414798,MATH 197,003,095567,Xiao; Ming,9999,0,9999,0
1656916414798,MATH 197,004,095571,Perols; Johan Lars,9998,0,9999,1
1656916421850,COGS 9,A01,083615,Shannon; Kyle Michael,7,0,75,68
1656916427882,COGS 11,A01,083617,Boyle; Mary E. T.,19,0,48,29
1656916433905,COGS 13,A01,083071,Bastos; Amalia Pinkusfeld,9,0,71,62
1656916439939,COGS 14A,A01,092681,Semenuks; Arturs,0,1,100,100
1656916445961,COGS 14B,A01,083073,Cheng; Tzu-Han,5,0,63,58
1656916451991,COGS 17,A01,092677,Semenuks; Arturs,4,0,81,77
1656916458016,COGS 100,A01,083619,Allen; Michael Gordon,15,0,70,55
1656916464044,COGS 101A,A01,083621,Davis; Joshua Daniel,9,0,68,59
1656916470067,COGS 101B,A01,091572,Allen; Michael Gordon,8,0,65,57
1656916476091,COGS 101C,A01,083625,Delgado; Tania,17,0,35,18
1656916482120,COGS 107A,A01,083627,Boyle; Mary E. T.,13,0,60,47
1656916488144,COGS 118A,A01,083075,Gupta; Anjum,15,0,76,61
1656916494247,CSE 3,A50,083646,Miranda; Gregory Joseph,22,0,50,28
1656916500271,CSE 8A,A50,083650,Miranda; Gregory Joseph,17,1,56,39
1656916506297,CSE 11,A01,083080,Cao; Yingjun,4,15,40,36
1656916512321,CSE 12,A01,083652,Krause-Levy; Sophia Louisa,20,1,120,100
1656916518347,CSE 15L,A01,083654,Morris; Justin Loren,8,0,50,42
1656916518347,CSE 15L,A02,083655,Morris; Justin Loren,8,0,50,42
1656916524371,CSE 20,A01,083657,Tran; Khoa Dang,37,0,80,43
1656916530399,CSE 21,A01,095574,Bach; Quang Tran,21,0,48,27
1656916536425,CSE 30,A01,083084,Eldon; John,4,0,80,76
1656916536425,CSE 30,B01,095061,Bhaskar; Nishant,6,0,50,44
1656916542453,CSE 100,A01,083659,Cao; Yingjun,3,4,70,67
1656916548476,CSE 134B,A01,083661,Powell; Thomas Allan,19,0,100,81
1656916554509,CSE 140,A01,083663,Gungor; Onat,14,0,85,71
1656916560533,CSE 140L,A01,083088,Eldon; John,16,0,100,84
1656916566557,CSE 175,A01,083665,Kumar; Rakesh,3,0,25,22
1656916572580,CSE 190,A00,092507,Dubnov; Shlomo,7,0,20,13
1656916578606,ECE 45,A01,083139,Congero; Spencer William,5,0,75,70
1656916584631,ECE 65,A50,083695,Saad; Andrew S,12,0,30,18
1656916584631,ECE 65,A51,095125,Saad; Andrew S,25,0,26,1
1656916590659,ECE 109,A01,091882,Touri; Behrouz,16,0,70,54
1656916596682,ECE 180,A00,083140,Abi Samra; Nicholas Camill,0,0,30,30
1656916596682,ECE 180,B00,083141,Abi Samra; Nicholas Camill,0,0,30,30
1656916602705,MATH 10A,A01,083735,Patchell; Gregory David,1,0,30,29
1656916602705,MATH 10A,A02,083736,Patchell; Gregory David,20,0,30,10
1656916602705,MATH 10A,A03,083737,Patchell; Gregory David,15,0,30,15
1656916608730,MATH 10B,A01,083207,Lim; Seonhee,7,0,34,27
1656916608730,MATH 10B,A02,083208,Lim; Seonhee,9,0,35,26
1656916608730,MATH 10B,A03,093472,Lim; Seonhee,4,0,34,30
1656916608730,MATH 10B,B01,083739,Sinha; Shubham,9,0,30,21
1656916614761,MATH 18,A01,083743,Cinel; Cameron Alexander,6,0,30,24
1656916614761,MATH 18,A02,083744,Cinel; Cameron Alexander,15,0,30,15
1656916614761,MATH 18,A03,083745,Cinel; Cameron Alexander,8,0,30,22
1656916614761,MATH 18,B01,083748,Rideout; David Porter,4,0,37,33
1656916614761,MATH 18,B02,083749,Rideout; David Porter,3,0,36,33
1656916614761,MATH 18,B03,083750,Rideout; David Porter,2,0,37,35
1656916614761,MATH 18,B04,083751,Rideout; David Porter,5,0,36,31
1656916614761,MATH 18,B05,093473,Rideout; David Porter,4,0,36,32
1656916614761,MATH 18,B06,093474,Rideout; David Porter,5,0,36,31
1656916620798,MATH 20A,A01,083754,Zheng; Zequn,12,0,40,28
1656916626825,MATH 20B,A01,083756,Briones; Jor-el Thomas Caparas,1,0,36,35
1656916626825,MATH 20B,A02,083757,Briones; Jor-el Thomas Caparas,1,0,36,35
1656916626825,MATH 20B,A03,093475,Briones; Jor-el Thomas Caparas,0,0,36,36
1656916632853,MATH 20C,A01,083760,Briones; Jor-el Thomas Caparas,1,0,35,34
1656916632853,MATH 20C,A02,083761,Briones; Jor-el Thomas Caparas,8,0,35,27
1656916632853,MATH 20C,A03,093476,Briones; Jor-el Thomas Caparas,0,1,36,36
1656916632853,MATH 20C,B01,083762,Bach; Quang Tran,0,0,30,30
1656916638882,MATH 20D,A01,083765,Tran; Brian Kha,4,0,30,26
1656916638882,MATH 20D,A02,083766,Tran; Brian Kha,4,0,30,26
1656916638882,MATH 20D,A03,083767,Tran; Brian Kha,3,0,30,27
1656916644917,MATH 20E,A01,083771,Ganguly; Soumya,5,0,32,27
1656916644917,MATH 20E,A02,083772,Ganguly; Soumya,6,0,32,26
1656916644917,MATH 20E,B01,083773,Ciotti; Benjamin,18,0,35,17
1656916644917,MATH 20E,B02,083774,Ciotti; Benjamin,17,0,35,18
1656916650943,MATH 103A,A01,083777,Greenfeld; Be'Eri,2,0,36,34
1656916650943,MATH 103A,A02,083778,Greenfeld; Be'Eri,5,0,36,31
1656916650943,MATH 103A,A03,093561,Greenfeld; Be'Eri,4,0,36,32
1656916650943,MATH 103A,B01,083779,Greenfeld; Be'Eri,6,0,36,30
1656916650943,MATH 103A,B02,083780,Greenfeld; Be'Eri,2,0,36,34
1656916650943,MATH 103A,B03,093562,Greenfeld; Be'Eri,2,0,36,34
1656916656969,MATH 105,A01,085443,Carter; Anne Toulson,13,0,35,22
1656916656969,MATH 105,A02,093477,Carter; Anne Toulson,20,0,35,15
1656916662995,MATH 109,A01,083213,Ganzberger; Geoffrey Michael,2,0,34,32
1656916662995,MATH 109,A02,083214,Ganzberger; Geoffrey Michael,2,0,34,32
1656916662995,MATH 109,A03,093478,Ganzberger; Geoffrey Michael,1,0,34,33
1656916662995,MATH 109,B01,083215,Ganzberger; Geoffrey Michael,1,0,32,31
1656916662995,MATH 109,B02,083216,Ganzberger; Geoffrey Michael,1,0,32,31
1656916662995,MATH 109,B03,093479,Ganzberger; Geoffrey Michael,6,0,32,26
1656916669022,MATH 142A,A01,083219,Chow; Bennett,6,0,32,26
1656916669022,MATH 142A,A02,083220,Chow; Bennett,10,0,32,22
1656916669022,MATH 142A,A03,093480,Chow; Bennett,7,0,32,25
1656916669022,MATH 142A,B03,093481,Chow; Bennett,7,0,32,25
1656916669022,MATH 142A,B04,093558,Chow; Bennett,10,0,32,22
1656916669022,MATH 142A,B05,093559,Chow; Bennett,6,0,32,26
1656916675048,MATH 193A,A01,083224,Rotar; Vladimir,7,0,34,27
1656916675048,MATH 193A,A02,083225,Rotar; Vladimir,3,0,34,31
1656916675048,MATH 193A,A03,083781,Rotar; Vladimir,1,0,34,33
1656916675048,MATH 193A,A04,083782,Rotar; Vladimir,6,0,34,28
1656916675048,MATH 193A,A05,093482,Rotar; Vladimir,6,0,34,28
1656916681070,MATH 197,001,091859,McAuley; Julian John,9999,0,9999,0
1656916681070,MATH 197,002,095566,Kedlaya; Kiran S.,9997,0,9999,2
1656916681070,MATH 197,003,095567,Xiao; Ming,9999,0,9999,0
1656916681070,MATH 197,004,095571,Perols; Johan Lars,9998,0,9999,1
1656916688130,COGS 9,A01,083615,Shannon; Kyle Michael,7,0,75,68
1656916694154,COGS 11,A01,083617,Boyle; Mary E. T.,19,0,48,29
1656916700182,COGS 13,A01,083071,Bastos; Amalia Pinkusfeld,9,0,71,62
1656916706206,COGS 14A,A01,092681,Semenuks; Arturs,0,1,100,100
1656916712234,COGS 14B,A01,083073,Cheng; Tzu-Han,5,0,63,58
1656916718262,COGS 17,A01,092677,Semenuks; Arturs,4,0,81,77
1656916724289,COGS 100,A01,083619,Allen; Michael Gordon,15,0,70,55
1656916730317,COGS 101A,A01,083621,Davis; Joshua Daniel,9,0,68,59
1656916736343,COGS 101B,A01,091572,Allen; Michael Gordon,8,0,65,57
1656916742368,COGS 101C,A01,083625,Delgado; Tania,17,0,35,18
1656916748397,COGS 107A,A01,083627,Boyle; Mary E. T.,13,0,60,47
1656916754420,COGS 118A,A01,083075,Gupta; Anjum,15,0,76,61
1656916760450,CSE 3,A50,083646,Miranda; Gregory Joseph,22,0,50,28
1656916766475,CSE 8A,A50,083650,Miranda; Gregory Joseph,17,1,56,39
1656916772497,CSE 11,A01,083080,Cao; Yingjun,4,15,40,36
1656916778519,CSE 12,A01,083652,Krause-Levy; Sophia Louisa,20,1,120,100
1656916784547,CSE 15L,A01,083654,Morris; Justin Loren,8,0,50,42
1656916784547,CSE 15L,A02,083655,Morris; Justin Loren,8,0,50,42
1656916790575,CSE 20,A01,083657,Tran; Khoa Dang,37,0,80,43
1656916796598,CSE 21,A01,095574,Bach; Quang Tran,21,0,48,27
1656916802624,CSE 30,A01,083084,Eldon; John,4,0,80,76
1656916802624,CSE 30,B01,095061,Bhaskar; Nishant,6,0,50,44
1656916808654,CSE 100,A01,083659,Cao; Yingjun,3,4,70,67
1656916814682,CSE 134B,A01,083661,Powell; Thomas Allan,19,0,100,81
1656916820713,CSE 140,A01,083663,Gungor; Onat,14,0,85,71
1656916826736,CSE 140L,A01,083088,Eldon; John,16,0,100,84
1656916832760,CSE 175,A01,083665,Kumar; Rakesh,3,0,25,22
1656916838788,CSE 190,A00,092507,Dubnov; Shlomo,7,0,20,13
1656916844823,ECE 45,A01,083139,Congero; Spencer William,5,0,75,70
1656916850846,ECE 65,A50,083695,Saad; Andrew S,12,0,30,18
1656916850846,ECE 65,A51,095125,Saad; Andrew S,25,0,26,1
1656916856869,ECE 109,A01,091882,Touri; Behrouz,16,0,70,54
1656916862898,ECE 180,A00,083140,Abi Samra; Nicholas Camill,0,0,30,30
1656916862898,ECE 180,B00,083141,Abi Samra; Nicholas Camill,0,0,30,30
1656916868925,MATH 10A,A01,083735,Patchell; Gregory David,1,0,30,29
1656916868925,MATH 10A,A02,083736,Patchell; Gregory David,20,0,30,10
1656916868925,MATH 10A,A03,083737,Patchell; Gregory David,15,0,30,15
1656916874950,MATH 10B,A01,083207,Lim; Seonhee,7,0,34,27
1656916874950,MATH 10B,A02,083208,Lim; Seonhee,9,0,35,26
1656916874950,MATH 10B,A03,093472,Lim; Seonhee,4,0,34,30
1656916874950,MATH 10B,B01,083739,Sinha; Shubham,9,0,30,21
1656916880985,MATH 18,A01,083743,Cinel; Cameron Alexander,6,0,30,24
1656916880985,MATH 18,A02,083744,Cinel; Cameron Alexander,15,0,30,15
1656916880985,MATH 18,A03,083745,Cinel; Cameron Alexander,8,0,30,22
1656916880985,MATH 18,B01,083748,Rideout; David Porter,4,0,37,33
1656916880985,MATH 18,B02,083749,Rideout; David Porter,3,0,36,33
1656916880985,MATH 18,B03,083750,Rideout; David Porter,2,0,37,35
1656916880985,MATH 18,B04,083751,Rideout; David Porter,5,0,36,31
1656916880985,MATH 18,B05,093473,Rideout; David Porter,4,0,36,32
1656916880985,MATH 18,B06,093474,Rideout; David Porter,5,0,36,31
1656916887008,MATH 20A,A01,083754,Zheng; Zequn,12,0,40,28
1656916893033,MATH 20B,A01,083756,Briones; Jor-el Thomas Caparas,1,0,36,35
1656916893033,MATH 20B,A02,083757,Briones; Jor-el Thomas Caparas,1,0,36,35
1656916893033,MATH 20B,A03,093475,Briones; Jor-el Thomas Caparas,0,0,36,36
1656916899056,MATH 20C,A01,083760,Briones; Jor-el Thomas Caparas,1,0,35,34
1656916899056,MATH 20C,A02,083761,Briones; Jor-el Thomas Caparas,8,0,35,27
1656916899056,MATH 20C,A03,093476,Briones; Jor-el Thomas Caparas,0,1,36,36
1656916899056,MATH 20C,B01,083762,Bach; Quang Tran,0,0,30,30
1656916905081,MATH 20D,A01,083765,Tran; Brian Kha,4,0,30,26
1656916905081,MATH 20D,A02,083766,Tran; Brian Kha,4,0,30,26
1656916905081,MATH 20D,A03,083767,Tran; Brian Kha,3,0,30,27
1656916911107,MATH 20E,A01,083771,Ganguly; Soumya,5,0,32,27
1656916911107,MATH 20E,A02,083772,Ganguly; Soumya,6,0,32,26
1656916911107,MATH 20E,B01,083773,Ciotti; Benjamin,18,0,35,17
1656916911107,MATH 20E,B02,083774,Ciotti; Benjamin,17,0,35,18
1656916917132,MATH 103A,A01,083777,Greenfeld; Be'Eri,2,0,36,34
1656916917132,MATH 103A,A02,083778,Greenfeld; Be'Eri,5,0,36,31
1656916917132,MATH 103A,A03,093561,Greenfeld; Be'Eri,4,0,36,32
1656916917132,MATH 103A,B01,083779,Greenfeld; Be'Eri,6,0,36,30
1656916917132,MATH 103A,B02,083780,Greenfeld; Be'Eri,2,0,36,34
1656916917132,MATH 103A,B03,093562,Greenfeld; Be'Eri,2,0,36,34
1656916923159,MATH 105,A01,085443,Carter; Anne Toulson,13,0,35,22
1656916923159,MATH 105,A02,093477,Carter; Anne Toulson,20,0,35,15
1656916929184,MATH 109,A01,083213,Ganzberger; Geoffrey Michael,2,0,34,32
1656916929184,MATH 109,A02,083214,Ganzberger; Geoffrey Michael,2,0,34,32
1656916929184,MATH 109,A03,093478,Ganzberger; Geoffrey Michael,1,0,34,33
1656916929184,MATH 109,B01,083215,Ganzberger; Geoffrey Michael,1,0,32,31
1656916929184,MATH 109,B02,083216,Ganzberger; Geoffrey Michael,1,0,32,31
1656916929184,MATH 109,B03,093479,Ganzberger; Geoffrey Michael,6,0,32,26
1656916935214,MATH 142A,A01,083219,Chow; Bennett,6,0,32,26
1656916935214,MATH 142A,A02,083220,Chow; Bennett,10,0,32,22
1656916935214,MATH 142A,A03,093480,Chow; Bennett,7,0,32,25
1656916935214,MATH 142A,B03,093481,Chow; Bennett,7,0,32,25
1656916935214,MATH 142A,B04,093558,Chow; Bennett,10,0,32,22
1656916935214,MATH 142A,B05,093559,Chow; Bennett,6,0,32,26
1656916941243,MATH 193A,A01,083224,Rotar; Vladimir,7,0,34,27
1656916941243,MATH 193A,A02,083225,Rotar; Vladimir,3,0,34,31
1656916941243,MATH 193A,A03,083781,Rotar; Vladimir,1,0,34,33
1656916941243,MATH 193A,A04,083782,Rotar; Vladimir,6,0,34,28
1656916941243,MATH 193A,A05,093482,Rotar; Vladimir,6,0,34,28
1656916947274,MATH 197,001,091859,McAuley; Julian John,9999,0,9999,0
1656916947274,MATH 197,002,095566,Kedlaya; Kiran S.,9997,0,9999,2
1656916947274,MATH 197,003,095567,Xiao; Ming,9999,0,9999,0
1656916947274,MATH 197,004,095571,Perols; Johan Lars,9998,0,9999,1
1656916954338,COGS 9,A01,083615,Shannon; Kyle Michael,7,0,75,68
1656916960373,COGS 11,A01,083617,Boyle; Mary E. T.,19,0,48,29
1656916966396,COGS 13,A01,083071,Bastos; Amalia Pinkusfeld,9,0,71,62
1656916972423,COGS 14A,A01,092681,Semenuks; Arturs,0,1,100,100
1656916978445,COGS 14B,A01,083073,Cheng; Tzu-Han,5,0,63,58
1656916984472,COGS 17,A01,092677,Semenuks; Arturs,4,0,81,77
1656916990500,COGS 100,A01,083619,Allen; Michael Gordon,15,0,70,55
1656916996531,COGS 101A,A01,083621,Davis; Joshua Daniel,9,0,68,59
1656917002555,COGS 101B,A01,091572,Allen; Michael Gordon,8,0,65,57
1656917008576,COGS 101C,A01,083625,Delgado; Tania,17,0,35,18
1656917014599,COGS 107A,A01,083627,Boyle; Mary E. T.,13,0,60,47
1656917020637,COGS 118A,A01,083075,Gupta; Anjum,15,0,76,61
1656917026666,CSE 3,A50,083646,Miranda; Gregory Joseph,22,0,50,28
1656917032690,CSE 8A,A50,083650,Miranda; Gregory Joseph,17,1,56,39
1656917038716,CSE 11,A01,083080,Cao; Yingjun,4,15,40,36
1656917044741,CSE 12,A01,083652,Krause-Levy; Sophia Louisa,20,1,120,100
1656917050763,CSE 15L,A01,083654,Morris; Justin Loren,8,0,50,42
1656917050763,CSE 15L,A02,083655,Morris; Justin Loren,8,0,50,42
1656917056786,CSE 20,A01,083657,Tran; Khoa Dang,37,0,80,43
1656917062808,CSE 21,A01,095574,Bach; Quang Tran,21,0,48,27
1656917068833,CSE 30,A01,083084,Eldon; John,4,0,80,76
1656917068833,CSE 30,B01,095061,Bhaskar; Nishant,6,0,50,44
1656917074874,CSE 100,A01,083659,Cao; Yingjun,3,4,70,67
1656917080897,CSE 134B,A01,083661,Powell; Thomas Allan,19,0,100,81
1656917086920,CSE 140,A01,083663,Gungor; Onat,14,0,85,71
1656917093015,CSE 140L,A01,083088,Eldon; John,16,0,100,84
1656917099039,CSE 175,A01,083665,Kumar; Rakesh,3,0,25,22
1656917105060,CSE 190,A00,092507,Dubnov; Shlomo,7,0,20,13
1656917111086,ECE 45,A01,083139,Congero; Spencer William,5,0,75,70
1656917117111,ECE 65,A50,083695,Saad; Andrew S,12,0,30,18
1656917117111,ECE 65,A51,095125,Saad; Andrew S,25,0,26,1
1656917123134,ECE 109,A01,091882,Touri; Behrouz,16,0,70,54
1656917129156,ECE 180,A00,083140,Abi Samra; Nicholas Camill,0,0,30,30
1656917129156,ECE 180,B00,083141,Abi Samra; Nicholas Camill,0,0,30,30
1656917135179,MATH 10A,A01,083735,Patchell; Gregory David,1,0,30,29
1656917135179,MATH 10A,A02,083736,Patchell; Gregory David,20,0,30,10
1656917135179,MATH 10A,A03,083737,Patchell; Gregory David,15,0,30,15
1656917141220,MATH 10B,A01,083207,Lim; Seonhee,7,0,34,27
1656917141220,MATH 10B,A02,083208,Lim; Seonhee,9,0,35,26
1656917141220,MATH 10B,A03,093472,Lim; Seonhee,4,0,34,30
1656917141220,MATH 10B,B01,083739,Sinha; Shubham,9,0,30,21
1656917147245,MATH 18,A01,083743,Cinel; Cameron Alexander,6,0,30,24
1656917147245,MATH 18,A02,083744,Cinel; Cameron Alexander,15,0,30,15
1656917147245,MATH 18,A03,083745,Cinel; Cameron Alexander,8,0,30,22
1656917147245,MATH 18,B01,083748,Rideout; David Porter,4,0,37,33
1656917147245,MATH 18,B02,083749,Rideout; David Porter,3,0,36,33
1656917147245,MATH 18,B03,083750,Rideout; David Porter,2,0,37,35
1656917147245,MATH 18,B04,083751,Rideout; David Porter,5,0,36,31
1656917147245,MATH 18,B05,093473,Rideout; David Porter,4,0,36,32
1656917147245,MATH 18,B06,093474,Rideout; David Porter,5,0,36,31
1656917153269,MATH 20A,A01,083754,Zheng; Zequn,12,0,40,28
1656917159295,MATH 20B,A01,083756,Briones; Jor-el Thomas Caparas,1,0,36,35
1656917159295,MATH 20B,A02,083757,Briones; Jor-el Thomas Caparas,1,0,36,35
1656917159295,MATH 20B,A03,093475,Briones; Jor-el Thomas Caparas,0,0,36,36
1656917165324,MATH 20C,A01,083760,Briones; Jor-el Thomas Caparas,1,0,35,34
1656917165324,MATH 20C,A02,083761,Briones; Jor-el Thomas Caparas,8,0,35,27
1656917165324,MATH 20C,A03,093476,Briones; Jor-el Thomas Caparas,0,1,36,36
1656917165324,MATH 20C,B01,083762,Bach; Quang Tran,0,0,30,30
1656917171349,MATH 20D,A01,083765,Tran; Brian Kha,4,0,30,26
1656917171349,MATH 20D,A02,083766,Tran; Brian Kha,4,0,30,26
1656917171349,MATH 20D,A03,083767,Tran; Brian Kha,3,0,30,27
1656917177373,MATH 20E,A01,083771,Ganguly; Soumya,5,0,32,27
1656917177373,MATH 20E,A02,083772,Ganguly; Soumya,6,0,32,26
1656917177373,MATH 20E,B01,083773,Ciotti; Benjamin,18,0,35,17
1656917177373,MATH 20E,B02,083774,Ciotti; Benjamin,17,0,35,18
1656917183403,MATH 103A,A01,083777,Greenfeld; Be'Eri,2,0,36,34
1656917183403,MATH 103A,A02,083778,Greenfeld; Be'Eri,5,0,36,31
1656917183403,MATH 103A,A03,093561,Greenfeld; Be'Eri,4,0,36,32
1656917183403,MATH 103A,B01,083779,Greenfeld; Be'Eri,6,0,36,30
1656917183403,MATH 103A,B02,083780,Greenfeld; Be'Eri,2,0,36,34
1656917183403,MATH 103A,B03,093562,Greenfeld; Be'Eri,2,0,36,34
1656917189436,MATH 105,A01,085443,Carter; Anne Toulson,13,0,35,22
1656917189436,MATH 105,A02,093477,Carter; Anne Toulson,20,0,35,15
1656917195465,MATH 109,A01,083213,Ganzberger; Geoffrey Michael,2,0,34,32
1656917195465,MATH 109,A02,083214,Ganzberger; Geoffrey Michael,2,0,34,32
1656917195465,MATH 109,A03,093478,Ganzberger; Geoffrey Michael,1,0,34,33
1656917195465,MATH 109,B01,083215,Ganzberger; Geoffrey Michael,1,0,32,31
1656917195465,MATH 109,B02,083216,Ganzberger; Geoffrey Michael,1,0,32,31
1656917195465,MATH 109,B03,093479,Ganzberger; Geoffrey Michael,6,0,32,26
1656917201489,MATH 142A,A01,083219,Chow; Bennett,6,0,32,26
1656917201489,MATH 142A,A02,083220,Chow; Bennett,10,0,32,22
1656917201489,MATH 142A,A03,093480,Chow; Bennett,7,0,32,25
1656917201489,MATH 142A,B03,093481,Chow; Bennett,7,0,32,25
1656917201489,MATH 142A,B04,093558,Chow; Bennett,10,0,32,22
1656917201489,MATH 142A,B05,093559,Chow; Bennett,6,0,32,26
1656917207517,MATH 193A,A01,083224,Rotar; Vladimir,7,0,34,27
1656917207517,MATH 193A,A02,083225,Rotar; Vladimir,3,0,34,31
1656917207517,MATH 193A,A03,083781,Rotar; Vladimir,1,0,34,33
1656917207517,MATH 193A,A04,083782,Rotar; Vladimir,6,0,34,28
1656917207517,MATH 193A,A05,093482,Rotar; Vladimir,6,0,34,28
1656917213540,MATH 197,001,091859,McAuley; Julian John,9999,0,9999,0
1656917213540,MATH 197,002,095566,Kedlaya; Kiran S.,9997,0,9999,2
1656917213540,MATH 197,003,095567,Xiao; Ming,9999,0,9999,0
1656917213540,MATH 197,004,095571,Perols; Johan Lars,9998,0,9999,1
1656917220589,COGS 9,A01,083615,Shannon; Kyle Michael,7,0,75,68
1656917226613,COGS 11,A01,083617,Boyle; Mary E. T.,19,0,48,29
1656917232638,COGS 13,A01,083071,Bastos; Amalia Pinkusfeld,9,0,71,62
1656917238661,COGS 14A,A01,092681,Semenuks; Arturs,0,1,100,100
1656917244693,COGS 14B,A01,083073,Cheng; Tzu-Han,5,0,63,58
1656917250718,COGS 17,A01,092677,Semenuks; Arturs,4,0,81,77
1656917256742,COGS 100,A01,083619,Allen; Michael Gordon,15,0,70,55
1656917262770,COGS 101A,A01,083621,Davis; Joshua Daniel,9,0,68,59
1656917268796,COGS 101B,A01,091572,Allen; Michael Gordon,8,0,65,57
1656917274820,COGS 101C,A01,083625,Delgado; Tania,17,0,35,18
1656917280845,COGS 107A,A01,083627,Boyle; Mary E. T.,13,0,60,47
1656917286874,COGS 118A,A01,083075,Gupta; Anjum,15,0,76,61
1656917292901,CSE 3,A50,083646,Miranda; Gregory Joseph,22,0,50,28
1656917298925,CSE 8A,A50,083650,Miranda; Gregory Joseph,17,1,56,39
1656917304959,CSE 11,A01,083080,Cao; Yingjun,4,15,40,36
1656917310982,CSE 12,A01,083652,Krause-Levy; Sophia Louisa,20,1,120,100
1656917317005,CSE 15L,A01,083654,Morris; Justin Loren,8,0,50,42
1656917317005,CSE 15L,A02,083655,Morris; Justin Loren,8,0,50,42
1656917323033,CSE 20,A01,083657,Tran; Khoa Dang,37,0,80,43
1656917329055,CSE 21,A01,095574,Bach; Quang Tran,21,0,48,27
1656917335084,CSE 30,A01,083084,Eldon; John,4,0,80,76
1656917335084,CSE 30,B01,095061,Bhaskar; Nishant,6,0,50,44
1656917341113,CSE 100,A01,083659,Cao; Yingjun,3,4,70,67
1656917347137,CSE 134B,A01,083661,Powell; Thomas Allan,19,0,100,81
1656917353160,CSE 140,A01,083663,Gungor; Onat,14,0,85,71
1656917359185,CSE 140L,A01,083088,Eldon; John,16,0,100,84
1656917365211,CSE 175,A01,083665,Kumar; Rakesh,3,0,25,22
1656917371237,CSE 190,A00,092507,Dubnov; Shlomo,7,0,20,13
1656917377264,ECE 45,A01,083139,Congero; Spencer William,5,0,75,70
1656917383291,ECE 65,A50,083695,Saad; Andrew S,12,0,30,18
1656917383291,ECE 65,A51,095125,Saad; Andrew S,25,0,26,1
1656917389315,ECE 109,A01,091882,Touri; Behrouz,16,0,70,54
1656917395339,ECE 180,A00,083140,Abi Samra; Nicholas Camill,0,0,30,30
1656917395339,ECE 180,B00,083141,Abi Samra; Nicholas Camill,0,0,30,30
1656917401362,MATH 10A,A01,083735,Patchell; Gregory David,1,0,30,29
1656917401362,MATH 10A,A02,083736,Patchell; Gregory David,20,0,30,10
1656917401362,MATH 10A,A03,083737,Patchell; Gregory David,15,0,30,15
1656917407397,MATH 10B,A01,083207,Lim; Seonhee,7,0,34,27
1656917407397,MATH 10B,A02,083208,Lim; Seonhee,9,0,35,26
1656917407397,MATH 10B,A03,093472,Lim; Seonhee,4,0,34,30
1656917407397,MATH 10B,B01,083739,Sinha; Shubham,9,0,30,21
1656917413425,MATH 18,A01,083743,Cinel; Cameron Alexander,6,0,30,24
1656917413425,MATH 18,A02,083744,Cinel; Cameron Alexander,15,0,30,15
1656917413425,MATH 18,A03,083745,Cinel; Cameron Alexander,8,0,30,22
1656917413425,MATH 18,B01,083748,Rideout; David Porter,4,0,37,33
1656917413425,MATH 18,B02,083749,Rideout; David Porter,3,0,36,33
1656917413425,MATH 18,B03,083750,Rideout; David Porter,2,0,37,35
1656917413425,MATH 18,B04,083751,Rideout; David Porter,5,0,36,31
1656917413425,MATH 18,B05,093473,Rideout; David Porter,4,0,36,32
1656917413425,MATH 18,B06,093474,Rideout; David Porter,5,0,36,31
1656917419452,MATH 20A,A01,083754,Zheng; Zequn,12,0,40,28
1656917425475,MATH 20B,A01,083756,Briones; Jor-el Thomas Caparas,1,0,36,35
1656917425475,MATH 20B,A02,083757,Briones; Jor-el Thomas Caparas,1,0,36,35
1656917425475,MATH 20B,A03,093475,Briones; Jor-el Thomas Caparas,0,0,36,36
1656917431505,MATH 20C,A01,083760,Briones; Jor-el Thomas Caparas,1,0,35,34
1656917431505,MATH 20C,A02,083761,Briones; Jor-el Thomas Caparas,8,0,35,27
1656917431505,MATH 20C,A03,093476,Briones; Jor-el Thomas Caparas,0,1,36,36
1656917431505,MATH 20C,B01,083762,Bach; Quang Tran,0,0,30,30
1656917437540,MATH 20D,A01,083765,Tran; Brian Kha,4,0,30,26
1656917437540,MATH 20D,A02,083766,Tran; Brian Kha,4,0,30,26
1656917437540,MATH 20D,A03,083767,Tran; Brian Kha,3,0,30,27
1656917443563,MATH 20E,A01,083771,Ganguly; Soumya,5,0,32,27
1656917443563,MATH 20E,A02,083772,Ganguly; Soumya,6,0,32,26
1656917443563,MATH 20E,B01,083773,Ciotti; Benjamin,18,0,35,17
1656917443563,MATH 20E,B02,083774,Ciotti; Benjamin,17,0,35,18
1656917449587,MATH 103A,A01,083777,Greenfeld; Be'Eri,2,0,36,34
1656917449587,MATH 103A,A02,083778,Greenfeld; Be'Eri,5,0,36,31
1656917449587,MATH 103A,A03,093561,Greenfeld; Be'Eri,4,0,36,32
1656917449587,MATH 103A,B01,083779,Greenfeld; Be'Eri,6,0,36,30
1656917449587,MATH 103A,B02,083780,Greenfeld; Be'Eri,2,0,36,34
1656917449587,MATH 103A,B03,093562,Greenfeld; Be'Eri,2,0,36,34
1656917455614,MATH 105,A01,085443,Carter; Anne Toulson,13,0,35,22
1656917455614,MATH 105,A02,093477,Carter; Anne Toulson,20,0,35,15
1656917461642,MATH 109,A01,083213,Ganzberger; Geoffrey Michael,2,0,34,32
1656917461642,MATH 109,A02,083214,Ganzberger; Geoffrey Michael,2,0,34,32
1656917461642,MATH 109,A03,093478,Ganzberger; Geoffrey Michael,1,0,34,33
1656917461642,MATH 109,B01,083215,Ganzberger; Geoffrey Michael,1,0,32,31
1656917461642,MATH 109,B02,083216,Ganzberger; Geoffrey Michael,1,0,32,31
1656917461642,MATH 109,B03,093479,Ganzberger; Geoffrey Michael,6,0,32,26
1656917467664,MATH 142A,A01,083219,Chow; Bennett,6,0,32,26
1656917467664,MATH 142A,A02,083220,Chow; Bennett,10,0,32,22
1656917467664,MATH 142A,A03,093480,Chow; Bennett,7,0,32,25
1656917467664,MATH 142A,B03,093481,Chow; Bennett,7,0,32,25
1656917467664,MATH 142A,B04,093558,Chow; Bennett,10,0,32,22
1656917467664,MATH 142A,B05,093559,Chow; Bennett,6,0,32,26
1656917473685,MATH 193A,A01,083224,Rotar; Vladimir,7,0,34,27
1656917473685,MATH 193A,A02,083225,Rotar; Vladimir,3,0,34,31
1656917473685,MATH 193A,A03,083781,Rotar; Vladimir,1,0,34,33
1656917473685,MATH 193A,A04,083782,Rotar; Vladimir,6,0,34,28
1656917473685,MATH 193A,A05,093482,Rotar; Vladimir,6,0,34,28
1656917479708,MATH 197,001,091859,McAuley; Julian John,9999,0,9999,0
1656917479708,MATH 197,002,095566,Kedlaya; Kiran S.,9997,0,9999,2
1656917479708,MATH 197,003,095567,Xiao; Ming,9999,0,9999,0
1656917479708,MATH 197,004,095571,Perols; Johan Lars,9998,0,9999,1
1656917486770,COGS 9,A01,083615,Shannon; Kyle Michael,7,0,75,68
1656917492793,COGS 11,A01,083617,Boyle; Mary E. T.,19,0,48,29
1656917498816,COGS 13,A01,083071,Bastos; Amalia Pinkusfeld,9,0,71,62
1656917504848,COGS 14A,A01,092681,Semenuks; Arturs,0,1,100,100
1656917510871,COGS 14B,A01,083073,Cheng; Tzu-Han,5,0,63,58
1656917516898,COGS 17,A01,092677,Semenuks; Arturs,4,0,81,77
1656917522922,COGS 100,A01,083619,Allen; Michael Gordon,15,0,70,55
1656917528945,COGS 101A,A01,083621,Davis; Joshua Daniel,9,0,68,59
1656917534972,COGS 101B,A01,091572,Allen; Michael Gordon,8,0,65,57
1656917541000,COGS 101C,A01,083625,Delgado; Tania,17,0,35,18
1656917547025,COGS 107A,A01,083627,Boyle; Mary E. T.,13,0,60,47
1656917553049,COGS 118A,A01,083075,Gupta; Anjum,15,0,76,61
1656917559076,CSE 3,A50,083646,Miranda; Gregory Joseph,22,0,50,28
1656917565103,CSE 8A,A50,083650,Miranda; Gregory Joseph,17,1,56,39
1656917571125,CSE 11,A01,083080,Cao; Yingjun,4,15,40,36
1656917577163,CSE 12,A01,083652,Krause-Levy; Sophia Louisa,20,1,120,100
1656917583187,CSE 15L,A01,083654,Morris; Justin Loren,8,0,50,42
1656917583187,CSE 15L,A02,083655,Morris; Justin Loren,8,0,50,42
1656917589212,CSE 20,A01,083657,Tran; Khoa Dang,37,0,80,43
1656917595236,CSE 21,A01,095574,Bach; Quang Tran,21,0,48,27
1656917601259,CSE 30,A01,083084,Eldon; John,4,0,80,76
1656917601259,CSE 30,B01,095061,Bhaskar; Nishant,6,0,50,44
1656917607283,CSE 100,A01,083659,Cao; Yingjun,3,4,70,67
1656917613305,CSE 134B,A01,083661,Powell; Thomas Allan,19,0,100,81
1656917619329,CSE 140,A01,083663,Gungor; Onat,14,0,85,71
1656917625358,CSE 140L,A01,083088,Eldon; John,16,0,100,84
1656917631380,CSE 175,A01,083665,Kumar; Rakesh,3,0,25,22
1656917637413,CSE 190,A00,092507,Dubnov; Shlomo,7,0,20,13
1656917643435,ECE 45,A01,083139,Congero; Spencer William,5,0,75,70
1656917649458,ECE 65,A50,083695,Saad; Andrew S,12,0,30,18
1656917649458,ECE 65,A51,095125,Saad; Andrew S,25,0,26,1
1656917655484,ECE 109,A01,091882,Touri; Behrouz,16,0,70,54
1656917661520,ECE 180,A00,083140,Abi Samra; Nicholas Camill,0,0,30,30
1656917661520,ECE 180,B00,083141,Abi Samra; Nicholas Camill,0,0,30,30
1656917667547,MATH 10A,A01,083735,Patchell; Gregory David,1,0,30,29
1656917667547,MATH 10A,A02,083736,Patchell; Gregory David,20,0,30,10
1656917667547,MATH 10A,A03,083737,Patchell; Gregory David,15,0,30,15
1656917673571,MATH 10B,A01,083207,Lim; Seonhee,7,0,34,27
1656917673571,MATH 10B,A02,083208,Lim; Seonhee,9,0,35,26
1656917673571,MATH 10B,A03,093472,Lim; Seonhee,4,0,34,30
1656917673571,MATH 10B,B01,083739,Sinha; Shubham,9,0,30,21
1656917679605,MATH 18,A01,083743,Cinel; Cameron Alexander,6,0,30,24
1656917679605,MATH 18,A02,083744,Cinel; Cameron Alexander,15,0,30,15
1656917679605,MATH 18,A03,083745,Cinel; Cameron Alexander,8,0,30,22
1656917679605,MATH 18,B01,083748,Rideout; David Porter,4,0,37,33
1656917679605,MATH 18,B02,083749,Rideout; David Porter,3,0,36,33
1656917679605,MATH 18,B03,083750,Rideout; David Porter,2,0,37,35
1656917679605,MATH 18,B04,083751,Rideout; David Porter,5,0,36,31
1656917679605,MATH 18,B05,093473,Rideout; David Porter,4,0,36,32
1656917679605,MATH 18,B06,093474,Rideout; David Porter,5,0,36,31
1656917685628,MATH 20A,A01,083754,Zheng; Zequn,12,0,40,28
1656917691741,MATH 20B,A01,083756,Briones; Jor-el Thomas Caparas,1,0,36,35
1656917691741,MATH 20B,A02,083757,Briones; Jor-el Thomas Caparas,1,0,36,35
1656917691741,MATH 20B,A03,093475,Briones; Jor-el Thomas Caparas,0,0,36,36
1656917697763,MATH 20C,A01,083760,Briones; Jor-el Thomas Caparas,1,0,35,34
1656917697763,MATH 20C,A02,083761,Briones; Jor-el Thomas Caparas,8,0,35,27
1656917697763,MATH 20C,A03,093476,Briones; Jor-el Thomas Caparas,0,1,36,36
1656917697763,MATH 20C,B01,083762,Bach; Quang Tran,0,0,30,30
1656917703786,MATH 20D,A01,083765,Tran; Brian Kha,4,0,30,26
1656917703786,MATH 20D,A02,083766,Tran; Brian Kha,4,0,30,26
1656917703786,MATH 20D,A03,083767,Tran; Brian Kha,3,0,30,27
1656917709814,MATH 20E,A01,083771,Ganguly; Soumya,5,0,32,27
1656917709814,MATH 20E,A02,083772,Ganguly; Soumya,6,0,32,26
1656917709814,MATH 20E,B01,083773,Ciotti; Benjamin,18,0,35,17
1656917709814,MATH 20E,B02,083774,Ciotti; Benjamin,17,0,35,18
1656917715844,MATH 103A,A01,083777,Greenfeld; Be'Eri,2,0,36,34
1656917715844,MATH 103A,A02,083778,Greenfeld; Be'Eri,5,0,36,31
1656917715844,MATH 103A,A03,093561,Greenfeld; Be'Eri,4,0,36,32
1656917715844,MATH 103A,B01,083779,Greenfeld; Be'Eri,6,0,36,30
1656917715844,MATH 103A,B02,083780,Greenfeld; Be'Eri,2,0,36,34
1656917715844,MATH 103A,B03,093562,Greenfeld; Be'Eri,2,0,36,34
1656917721868,MATH 105,A01,085443,Carter; Anne Toulson,13,0,35,22
1656917721868,MATH 105,A02,093477,Carter; Anne Toulson,20,0,35,15
1656917727891,MATH 109,A01,083213,Ganzberger; Geoffrey Michael,2,0,34,32
1656917727891,MATH 109,A02,083214,Ganzberger; Geoffrey Michael,2,0,34,32
1656917727891,MATH 109,A03,093478,Ganzberger; Geoffrey Michael,1,0,34,33
1656917727891,MATH 109,B01,083215,Ganzberger; Geoffrey Michael,1,0,32,31
1656917727891,MATH 109,B02,083216,Ganzberger; Geoffrey Michael,1,0,32,31
1656917727891,MATH 109,B03,093479,Ganzberger; Geoffrey Michael,6,0,32,26
1656917733916,MATH 142A,A01,083219,Chow; Bennett,6,0,32,26
1656917733916,MATH 142A,A02,083220,Chow; Bennett,10,0,32,22
1656917733916,MATH 142A,A03,093480,Chow; Bennett,7,0,32,25
1656917733916,MATH 142A,B03,093481,Chow; Bennett,7,0,32,25
1656917733916,MATH 142A,B04,093558,Chow; Bennett,10,0,32,22
1656917733916,MATH 142A,B05,093559,Chow; Bennett,6,0,32,26
1656917739944,MATH 193A,A01,083224,Rotar; Vladimir,7,0,34,27
1656917739944,MATH 193A,A02,083225,Rotar; Vladimir,3,0,34,31
1656917739944,MATH 193A,A03,083781,Rotar; Vladimir,1,0,34,33
1656917739944,MATH 193A,A04,083782,Rotar; Vladimir,6,0,34,28
1656917739944,MATH 193A,A05,093482,Rotar; Vladimir,6,0,34,28
1656917745966,MATH 197,001,091859,McAuley; Julian John,9999,0,9999,0
1656917745966,MATH 197,002,095566,Kedlaya; Kiran S.,9997,0,9999,2
1656917745966,MATH 197,003,095567,Xiao; Ming,9999,0,9999,0
1656917745966,MATH 197,004,095571,Perols; Johan Lars,9998,0,9999,1
1656917753018,COGS 9,A01,083615,Shannon; Kyle Michael,7,0,75,68
1656917759044,COGS 11,A01,083617,Boyle; Mary E. T.,19,0,48,29
1656917765067,COGS 13,A01,083071,Bastos; Amalia Pinkusfeld,9,0,71,62
1656917771093,COGS 14A,A01,092681,Semenuks; Arturs,0,1,100,100
1656917777116,COGS 14B,A01,083073,Cheng; Tzu-Han,5,0,63,58
1656917783138,COGS 17,A01,092677,Semenuks; Arturs,4,0,81,77
1656917789165,COGS 100,A01,083619,Allen; Michael Gordon,15,0,70,55
1656917795188,COGS 101A,A01,083621,Davis; Joshua Daniel,9,0,68,59
1656917801215,COGS 101B,A01,091572,Allen; Michael Gordon,8,0,65,57
1656917807240,COGS 101C,A01,083625,Delgado; Tania,17,0,35,18
1656917813266,COGS 107A,A01,083627,Boyle; Mary E. T.,13,0,60,47
1656917819290,COGS 118A,A01,083075,Gupta; Anjum,15,0,76,61
1656917825314,CSE 3,A50,083646,Miranda; Gregory Joseph,22,0,50,28
1656917831338,CSE 8A,A50,083650,Miranda; Gregory Joseph,17,1,56,39
1656917837373,CSE 11,A01,083080,Cao; Yingjun,4,15,40,36
1656917843397,CSE 12,A01,083652,Krause-Levy; Sophia Louisa,20,1,120,100
1656917849424,CSE 15L,A01,083654,Morris; Justin Loren,8,0,50,42
1656917849424,CSE 15L,A02,083655,Morris; Justin Loren,8,0,50,42
1656917855452,CSE 20,A01,083657,Tran; Khoa Dang,37,0,80,43
1656917861480,CSE 21,A01,095574,Bach; Quang Tran,21,0,48,27
1656917867506,CSE 30,A01,083084,Eldon; John,4,0,80,76
1656917867506,CSE 30,B01,095061,Bhaskar; Nishant,6,0,50,44
1656917873530,CSE 100,A01,083659,Cao; Yingjun,3,4,70,67
1656917879569,CSE 134B,A01,083661,Powell; Thomas Allan,19,0,100,81
1656917885592,CSE 140,A01,083663,Gungor; Onat,14,0,85,71
1656917891614,CSE 140L,A01,083088,Eldon; John,16,0,100,84
1656917897638,CSE 175,A01,083665,Kumar; Rakesh,3,0,25,22
1656917903659,CSE 190,A00,092507,Dubnov; Shlomo,7,0,20,13
1656917909680,ECE 45,A01,083139,Congero; Spencer William,5,0,75,70
1656917915715,ECE 65,A50,083695,Saad; Andrew S,12,0,30,18
1656917915715,ECE 65,A51,095125,Saad; Andrew S,25,0,26,1
1656917921742,ECE 109,A01,091882,Touri; Behrouz,16,0,70,54
1656917927765,ECE 180,A00,083140,Abi Samra; Nicholas Camill,0,0,30,30
1656917927765,ECE 180,B00,083141,Abi Samra; Nicholas Camill,0,0,30,30
1656917933791,MATH 10A,A01,083735,Patchell; Gregory David,1,0,30,29
1656917933791,MATH 10A,A02,083736,Patchell; Gregory David,20,0,30,10
1656917933791,MATH 10A,A03,083737,Patchell; Gregory David,15,0,30,15
1656917939816,MATH 10B,A01,083207,Lim; Seonhee,7,0,34,27
1656917939816,MATH 10B,A02,083208,Lim; Seonhee,9,0,35,26
1656917939816,MATH 10B,A03,093472,Lim; Seonhee,4,0,34,30
1656917939816,MATH 10B,B01,083739,Sinha; Shubham,9,0,30,21
1656917945841,MATH 18,A01,083743,Cinel; Cameron Alexander,6,0,30,24
1656917945841,MATH 18,A02,083744,Cinel; Cameron Alexander,15,0,30,15
1656917945841,MATH 18,A03,083745,Cinel; Cameron Alexander,8,0,30,22
1656917945841,MATH 18,B01,083748,Rideout; David Porter,4,0,37,33
1656917945841,MATH 18,B02,083749,Rideout; David Porter,3,0,36,33
1656917945841,MATH 18,B03,083750,Rideout; David Porter,2,0,37,35
1656917945841,MATH 18,B04,083751,Rideout; David Porter,5,0,36,31
1656917945841,MATH 18,B05,093473,Rideout; David Porter,4,0,36,32
1656917945841,MATH 18,B06,093474,Rideout; David Porter,5,0,36,31
1656917951867,MATH 20A,A01,083754,Zheng; Zequn,12,0,40,28
1656917957896,MATH 20B,A01,083756,Briones; Jor-el Thomas Caparas,1,0,36,35
1656917957896,MATH 20B,A02,083757,Briones; Jor-el Thomas Caparas,1,0,36,35
1656917957896,MATH 20B,A03,093475,Briones; Jor-el Thomas Caparas,0,0,36,36
1656917963924,MATH 20C,A01,083760,Briones; Jor-el Thomas Caparas,1,0,35,34
1656917963924,MATH 20C,A02,083761,Briones; Jor-el Thomas Caparas,8,0,35,27
1656917963924,MATH 20C,A03,093476,Briones; Jor-el Thomas Caparas,0,1,36,36
1656917963924,MATH 20C,B01,083762,Bach; Quang Tran,0,0,30,30
1656917969946,MATH 20D,A01,083765,Tran; Brian Kha,4,0,30,26
1656917969946,MATH 20D,A02,083766,Tran; Brian Kha,4,0,30,26
1656917969946,MATH 20D,A03,083767,Tran; Brian Kha,3,0,30,27
1656917975981,MATH 20E,A01,083771,Ganguly; Soumya,5,0,32,27
1656917975981,MATH 20E,A02,083772,Ganguly; Soumya,6,0,32,26
1656917975981,MATH 20E,B01,083773,Ciotti; Benjamin,18,0,35,17
1656917975981,MATH 20E,B02,083774,Ciotti; Benjamin,17,0,35,18
1656917982007,MATH 103A,A01,083777,Greenfeld; Be'Eri,2,0,36,34
1656917982007,MATH 103A,A02,083778,Greenfeld; Be'Eri,5,0,36,31
1656917982007,MATH 103A,A03,093561,Greenfeld; Be'Eri,4,0,36,32
1656917982007,MATH 103A,B01,083779,Greenfeld; Be'Eri,6,0,36,30
1656917982007,MATH 103A,B02,083780,Greenfeld; Be'Eri,2,0,36,34
1656917982007,MATH 103A,B03,093562,Greenfeld; Be'Eri,2,0,36,34
1656917988032,MATH 105,A01,085443,Carter; Anne Toulson,13,0,35,22
1656917988032,MATH 105,A02,093477,Carter; Anne Toulson,20,0,35,15
1656917994060,MATH 109,A01,083213,Ganzberger; Geoffrey Michael,2,0,34,32
1656917994060,MATH 109,A02,083214,Ganzberger; Geoffrey Michael,2,0,34,32
1656917994060,MATH 109,A03,093478,Ganzberger; Geoffrey Michael,1,0,34,33
1656917994060,MATH 109,B01,083215,Ganzberger; Geoffrey Michael,1,0,32,31
1656917994060,MATH 109,B02,083216,Ganzberger; Geoffrey Michael,1,0,32,31
1656917994060,MATH 109,B03,093479,Ganzberger; Geoffrey Michael,6,0,32,26
1656918000084,MATH 142A,A01,083219,Chow; Bennett,6,0,32,26
1656918000084,MATH 142A,A02,083220,Chow; Bennett,10,0,32,22
1656918000084,MATH 142A,A03,093480,Chow; Bennett,7,0,32,25
1656918000084,MATH 142A,B03,093481,Chow; Bennett,7,0,32,25
1656918000084,MATH 142A,B04,093558,Chow; Bennett,10,0,32,22
1656918000084,MATH 142A,B05,093559,Chow; Bennett,6,0,32,26
1656918006112,MATH 193A,A01,083224,Rotar; Vladimir,7,0,34,27
1656918006112,MATH 193A,A02,083225,Rotar; Vladimir,3,0,34,31
1656918006112,MATH 193A,A03,083781,Rotar; Vladimir,1,0,34,33
1656918006112,MATH 193A,A04,083782,Rotar; Vladimir,6,0,34,28
1656918006112,MATH 193A,A05,093482,Rotar; Vladimir,6,0,34,28
1656918012134,MATH 197,001,091859,McAuley; Julian John,9999,0,9999,0
1656918012134,MATH 197,002,095566,Kedlaya; Kiran S.,9997,0,9999,2
1656918012134,MATH 197,003,095567,Xiao; Ming,9999,0,9999,0
1656918012134,MATH 197,004,095571,Perols; Johan Lars,9998,0,9999,1
1656918019195,COGS 9,A01,083615,Shannon; Kyle Michael,7,0,75,68
1656918025218,COGS 11,A01,083617,Boyle; Mary E. T.,19,0,48,29
1656918031243,COGS 13,A01,083071,Bastos; Amalia Pinkusfeld,9,0,71,62
1656918037268,COGS 14A,A01,092681,Semenuks; Arturs,0,1,100,100
1656918043294,COGS 14B,A01,083073,Cheng; Tzu-Han,5,0,63,58
1656918049316,COGS 17,A01,092677,Semenuks; Arturs,4,0,81,77
1656918055340,COGS 100,A01,083619,Allen; Michael Gordon,15,0,70,55
1656918061362,COGS 101A,A01,083621,Davis; Joshua Daniel,9,0,68,59
1656918067386,COGS 101B,A01,091572,Allen; Michael Gordon,8,0,65,57
1656918073414,COGS 101C,A01,083625,Delgado; Tania,17,0,35,18
1656918079441,COGS 107A,A01,083627,Boyle; Mary E. T.,13,0,60,47
1656918085471,COGS 118A,A01,083075,Gupta; Anjum,15,0,76,61
1656918091499,CSE 3,A50,083646,Miranda; Gregory Joseph,22,0,50,28
1656918097524,CSE 8A,A50,083650,Miranda; Gregory Joseph,17,1,56,39
1656918103551,CSE 11,A01,083080,Cao; Yingjun,4,15,40,36
1656918109573,CSE 12,A01,083652,Krause-Levy; Sophia Louisa,20,1,120,100
1656918115596,CSE 15L,A01,083654,Morris; Justin Loren,8,0,50,42
1656918115596,CSE 15L,A02,083655,Morris; Justin Loren,8,0,50,42
1656918121620,CSE 20,A01,083657,Tran; Khoa Dang,37,0,80,43
1656918127642,CSE 21,A01,095574,Bach; Quang Tran,21,0,48,27
1656918133666,CSE 30,A01,083084,Eldon; John,4,0,80,76
1656918133666,CSE 30,B01,095061,Bhaskar; Nishant,6,0,50,44
1656918139689,CSE 100,A01,083659,Cao; Yingjun,3,4,70,67
1656918145713,CSE 134B,A01,083661,Powell; Thomas Allan,19,0,100,81
1656918151740,CSE 140,A01,083663,Gungor; Onat,14,0,85,71
1656918157766,CSE 140L,A01,083088,Eldon; John,16,0,100,84
1656918163789,CSE 175,A01,083665,Kumar; Rakesh,3,0,25,22
1656918169812,CSE 190,A00,092507,Dubnov; Shlomo,7,0,20,13
1656918175835,ECE 45,A01,083139,Congero; Spencer William,5,0,75,70
1656918181880,ECE 65,A50,083695,Saad; Andrew S,12,0,30,18
1656918181880,ECE 65,A51,095125,Saad; Andrew S,25,0,26,1
1656918187905,ECE 109,A01,091882,Touri; Behrouz,16,0,70,54
1656918193931,ECE 180,A00,083140,Abi Samra; Nicholas Camill,0,0,30,30
1656918193931,ECE 180,B00,083141,Abi Samra; Nicholas Camill,0,0,30,30
1656918199956,MATH 10A,A01,083735,Patchell; Gregory David,1,0,30,29
1656918199956,MATH 10A,A02,083736,Patchell; Gregory David,20,0,30,10
1656918199956,MATH 10A,A03,083737,Patchell; Gregory David,15,0,30,15
1656918205986,MATH 10B,A01,083207,Lim; Seonhee,7,0,34,27
1656918205986,MATH 10B,A02,083208,Lim; Seonhee,9,0,35,26
1656918205986,MATH 10B,A03,093472,Lim; Seonhee,4,0,34,30
1656918205986,MATH 10B,B01,083739,Sinha; Shubham,9,0,30,21
1656918212010,MATH 18,A01,083743,Cinel; Cameron Alexander,6,0,30,24
1656918212010,MATH 18,A02,083744,Cinel; Cameron Alexander,15,0,30,15
1656918212010,MATH 18,A03,083745,Cinel; Cameron Alexander,8,0,30,22
1656918212010,MATH 18,B01,083748,Rideout; David Porter,4,0,37,33
1656918212010,MATH 18,B02,083749,Rideout; David Porter,3,0,36,33
1656918212010,MATH 18,B03,083750,Rideout; David Porter,2,0,37,35
1656918212010,MATH 18,B04,083751,Rideout; David Porter,5,0,36,31
1656918212010,MATH 18,B05,093473,Rideout; David Porter,4,0,36,32
1656918212010,MATH 18,B06,093474,Rideout; David Porter,5,0,36,31
1656918218033,MATH 20A,A01,083754,Zheng; Zequn,12,0,40,28
1656918224057,MATH 20B,A01,083756,Briones; Jor-el Thomas Caparas,1,0,36,35
1656918224057,MATH 20B,A02,083757,Briones; Jor-el Thomas Caparas,1,0,36,35
1656918224057,MATH 20B,A03,093475,Briones; Jor-el Thomas Caparas,0,0,36,36
1656918230083,MATH 20C,A01,083760,Briones; Jor-el Thomas Caparas,1,0,35,34
1656918230083,MATH 20C,A02,083761,Briones; Jor-el Thomas Caparas,8,0,35,27
1656918230083,MATH 20C,A03,093476,Briones; Jor-el Thomas Caparas,0,1,36,36
1656918230083,MATH 20C,B01,083762,Bach; Quang Tran,0,0,30,30
1656918236106,MATH 20D,A01,083765,Tran; Brian Kha,4,0,30,26
1656918236106,MATH 20D,A02,083766,Tran; Brian Kha,4,0,30,26
1656918236106,MATH 20D,A03,083767,Tran; Brian Kha,3,0,30,27
1656918242132,MATH 20E,A01,083771,Ganguly; Soumya,5,0,32,27
1656918242132,MATH 20E,A02,083772,Ganguly; Soumya,6,0,32,26
1656918242132,MATH 20E,B01,083773,Ciotti; Benjamin,18,0,35,17
1656918242132,MATH 20E,B02,083774,Ciotti; Benjamin,17,0,35,18
1656918248156,MATH 103A,A01,083777,Greenfeld; Be'Eri,2,0,36,34
1656918248156,MATH 103A,A02,083778,Greenfeld; Be'Eri,5,0,36,31
1656918248156,MATH 103A,A03,093561,Greenfeld; Be'Eri,4,0,36,32
1656918248156,MATH 103A,B01,083779,Greenfeld; Be'Eri,6,0,36,30
1656918248156,MATH 103A,B02,083780,Greenfeld; Be'Eri,2,0,36,34
1656918248156,MATH 103A,B03,093562,Greenfeld; Be'Eri,2,0,36,34
1656918254181,MATH 105,A01,085443,Carter; Anne Toulson,13,0,35,22
1656918254181,MATH 105,A02,093477,Carter; Anne Toulson,20,0,35,15
1656918260211,MATH 109,A01,083213,Ganzberger; Geoffrey Michael,2,0,34,32
1656918260211,MATH 109,A02,083214,Ganzberger; Geoffrey Michael,2,0,34,32
1656918260211,MATH 109,A03,093478,Ganzberger; Geoffrey Michael,1,0,34,33
1656918260211,MATH 109,B01,083215,Ganzberger; Geoffrey Michael,1,0,32,31
1656918260211,MATH 109,B02,083216,Ganzberger; Geoffrey Michael,1,0,32,31
1656918260211,MATH 109,B03,093479,Ganzberger; Geoffrey Michael,6,0,32,26
1656918266236,MATH 142A,A01,083219,Chow; Bennett,6,0,32,26
1656918266236,MATH 142A,A02,083220,Chow; Bennett,10,0,32,22
1656918266236,MATH 142A,A03,093480,Chow; Bennett,7,0,32,25
1656918266236,MATH 142A,B03,093481,Chow; Bennett,7,0,32,25
1656918266236,MATH 142A,B04,093558,Chow; Bennett,10,0,32,22
1656918266236,MATH 142A,B05,093559,Chow; Bennett,6,0,32,26
1656918272261,MATH 193A,A01,083224,Rotar; Vladimir,7,0,34,27
1656918272261,MATH 193A,A02,083225,Rotar; Vladimir,3,0,34,31
1656918272261,MATH 193A,A03,083781,Rotar; Vladimir,1,0,34,33
1656918272261,MATH 193A,A04,083782,Rotar; Vladimir,6,0,34,28
1656918272261,MATH 193A,A05,093482,Rotar; Vladimir,6,0,34,28
1656918278285,MATH 197,001,091859,McAuley; Julian John,9999,0,9999,0
1656918278285,MATH 197,002,095566,Kedlaya; Kiran S.,9997,0,9999,2
1656918278285,MATH 197,003,095567,Xiao; Ming,9999,0,9999,0
1656918278285,MATH 197,004,095571,Perols; Johan Lars,9998,0,9999,1
1656918285434,COGS 9,A01,083615,Shannon; Kyle Michael,7,0,75,68
1656918291457,COGS 11,A01,083617,Boyle; Mary E. T.,19,0,48,29
1656918297482,COGS 13,A01,083071,Bastos; Amalia Pinkusfeld,9,0,71,62
1656918303508,COGS 14A,A01,092681,Semenuks; Arturs,0,1,100,100
1656918309531,COGS 14B,A01,083073,Cheng; Tzu-Han,5,0,63,58
1656918315553,COGS 17,A01,092677,Semenuks; Arturs,4,0,81,77
1656918321576,COGS 100,A01,083619,Allen; Michael Gordon,15,0,70,55
1656918327603,COGS 101A,A01,083621,Davis; Joshua Daniel,9,0,68,59
1656918333630,COGS 101B,A01,091572,Allen; Michael Gordon,8,0,65,57
1656918339655,COGS 101C,A01,083625,Delgado; Tania,17,0,35,18
1656918345686,COGS 107A,A01,083627,Boyle; Mary E. T.,13,0,60,47
1656918351709,COGS 118A,A01,083075,Gupta; Anjum,15,0,76,61
1656918357731,CSE 3,A50,083646,Miranda; Gregory Joseph,22,0,50,28
1656918363754,CSE 8A,A50,083650,Miranda; Gregory Joseph,17,1,56,39
1656918369780,CSE 11,A01,083080,Cao; Yingjun,4,15,40,36
1656918375813,CSE 12,A01,083652,Krause-Levy; Sophia Louisa,20,1,120,100
1656918381836,CSE 15L,A01,083654,Morris; Justin Loren,8,0,50,42
1656918381836,CSE 15L,A02,083655,Morris; Justin Loren,8,0,50,42
1656918387862,CSE 20,A01,083657,Tran; Khoa Dang,37,0,80,43
1656918393889,CSE 21,A01,095574,Bach; Quang Tran,21,0,48,27
1656918399917,CSE 30,A01,083084,Eldon; John,4,0,80,76
1656918399917,CSE 30,B01,095061,Bhaskar; Nishant,6,0,50,44
1656918405940,CSE 100,A01,083659,Cao; Yingjun,3,4,70,67
1656918411965,CSE 134B,A01,083661,Powell; Thomas Allan,19,0,100,81
1656918417989,CSE 140,A01,083663,Gungor; Onat,14,0,85,71
1656918424019,CSE 140L,A01,083088,Eldon; John,16,0,100,84
1656918430041,CSE 175,A01,083665,Kumar; Rakesh,3,0,25,22
1656918436067,CSE 190,A00,092507,Dubnov; Shlomo,7,0,20,13
1656918442095,ECE 45,A01,083139,Congero; Spencer William,5,0,75,70
1656918448134,ECE 65,A50,083695,Saad; Andrew S,12,0,30,18
1656918448134,ECE 65,A51,095125,Saad; Andrew S,25,0,26,1
1656918454158,ECE 109,A01,091882,Touri; Behrouz,16,0,70,54
1656918460187,ECE 180,A00,083140,Abi Samra; Nicholas Camill,0,0,30,30
1656918460187,ECE 180,B00,083141,Abi Samra; Nicholas Camill,0,0,30,30
1656918466214,MATH 10A,A01,083735,Patchell; Gregory David,1,0,30,29
1656918466214,MATH 10A,A02,083736,Patchell; Gregory David,20,0,30,10
1656918466214,MATH 10A,A03,083737,Patchell; Gregory David,15,0,30,15
1656918472242,MATH 10B,A01,083207,Lim; Seonhee,7,0,34,27
1656918472242,MATH 10B,A02,083208,Lim; Seonhee,9,0,35,26
1656918472242,MATH 10B,A03,093472,Lim; Seonhee,4,0,34,30
1656918472242,MATH 10B,B01,083739,Sinha; Shubham,9,0,30,21
1656918478271,MATH 18,A01,083743,Cinel; Cameron Alexander,6,0,30,24
1656918478271,MATH 18,A02,083744,Cinel; Cameron Alexander,15,0,30,15
1656918478271,MATH 18,A03,083745,Cinel; Cameron Alexander,8,0,30,22
1656918478271,MATH 18,B01,083748,Rideout; David Porter,4,0,37,33
1656918478271,MATH 18,B02,083749,Rideout; David Porter,3,0,36,33
1656918478271,MATH 18,B03,083750,Rideout; David Porter,2,0,37,35
1656918478271,MATH 18,B04,083751,Rideout; David Porter,5,0,36,31
1656918478271,MATH 18,B05,093473,Rideout; David Porter,4,0,36,32
1656918478271,MATH 18,B06,093474,Rideout; David Porter,5,0,36,31
1656918484300,MATH 20A,A01,083754,Zheng; Zequn,12,0,40,28
1656918490328,MATH 20B,A01,083756,Briones; Jor-el Thomas Caparas,1,0,36,35
1656918490328,MATH 20B,A02,083757,Briones; Jor-el Thomas Caparas,1,0,36,35
1656918490328,MATH 20B,A03,093475,Briones; Jor-el Thomas Caparas,0,0,36,36
1656918496352,MATH 20C,A01,083760,Briones; Jor-el Thomas Caparas,1,0,35,34
1656918496352,MATH 20C,A02,083761,Briones; Jor-el Thomas Caparas,8,0,35,27
1656918496352,MATH 20C,A03,093476,Briones; Jor-el Thomas Caparas,0,1,36,36
1656918496352,MATH 20C,B01,083762,Bach; Quang Tran,0,0,30,30
1656918502378,MATH 20D,A01,083765,Tran; Brian Kha,4,0,30,26
1656918502378,MATH 20D,A02,083766,Tran; Brian Kha,4,0,30,26
1656918502378,MATH 20D,A03,083767,Tran; Brian Kha,3,0,30,27
1656918508411,MATH 20E,A01,083771,Ganguly; Soumya,5,0,32,27
1656918508411,MATH 20E,A02,083772,Ganguly; Soumya,6,0,32,26
1656918508411,MATH 20E,B01,083773,Ciotti; Benjamin,18,0,35,17
1656918508411,MATH 20E,B02,083774,Ciotti; Benjamin,17,0,35,18
1656918514434,MATH 103A,A01,083777,Greenfeld; Be'Eri,2,0,36,34
1656918514434,MATH 103A,A02,083778,Greenfeld; Be'Eri,5,0,36,31
1656918514434,MATH 103A,A03,093561,Greenfeld; Be'Eri,4,0,36,32
1656918514434,MATH 103A,B01,083779,Greenfeld; Be'Eri,6,0,36,30
1656918514434,MATH 103A,B02,083780,Greenfeld; Be'Eri,2,0,36,34
1656918514434,MATH 103A,B03,093562,Greenfeld; Be'Eri,2,0,36,34
1656918520473,MATH 105,A01,085443,Carter; Anne Toulson,13,0,35,22
1656918520473,MATH 105,A02,093477,Carter; Anne Toulson,20,0,35,15
1656918526505,MATH 109,A01,083213,Ganzberger; Geoffrey Michael,2,0,34,32
1656918526505,MATH 109,A02,083214,Ganzberger; Geoffrey Michael,2,0,34,32
1656918526505,MATH 109,A03,093478,Ganzberger; Geoffrey Michael,1,0,34,33
1656918526505,MATH 109,B01,083215,Ganzberger; Geoffrey Michael,1,0,32,31
1656918526505,MATH 109,B02,083216,Ganzberger; Geoffrey Michael,1,0,32,31
1656918526505,MATH 109,B03,093479,Ganzberger; Geoffrey Michael,6,0,32,26
1656918532537,MATH 142A,A01,083219,Chow; Bennett,6,0,32,26
1656918532537,MATH 142A,A02,083220,Chow; Bennett,10,0,32,22
1656918532537,MATH 142A,A03,093480,Chow; Bennett,7,0,32,25
1656918532537,MATH 142A,B03,093481,Chow; Bennett,7,0,32,25
1656918532537,MATH 142A,B04,093558,Chow; Bennett,10,0,32,22
1656918532537,MATH 142A,B05,093559,Chow; Bennett,6,0,32,26
1656918538561,MATH 193A,A01,083224,Rotar; Vladimir,7,0,34,27
1656918538561,MATH 193A,A02,083225,Rotar; Vladimir,3,0,34,31
1656918538561,MATH 193A,A03,083781,Rotar; Vladimir,1,0,34,33
1656918538561,MATH 193A,A04,083782,Rotar; Vladimir,6,0,34,28
1656918538561,MATH 193A,A05,093482,Rotar; Vladimir,6,0,34,28
1656918544585,MATH 197,001,091859,McAuley; Julian John,9999,0,9999,0
1656918544585,MATH 197,002,095566,Kedlaya; Kiran S.,9997,0,9999,2
1656918544585,MATH 197,003,095567,Xiao; Ming,9999,0,9999,0
1656918544585,MATH 197,004,095571,Perols; Johan Lars,9998,0,9999,1
1656918551651,COGS 9,A01,083615,Shannon; Kyle Michael,7,0,75,68
1656918557679,COGS 11,A01,083617,Boyle; Mary E. T.,19,0,48,29
1656918563703,COGS 13,A01,083071,Bastos; Amalia Pinkusfeld,9,0,71,62
1656918569803,COGS 14A,A01,092681,Semenuks; Arturs,0,1,100,100
1656918575826,COGS 14B,A01,083073,Cheng; Tzu-Han,5,0,63,58
1656918581852,COGS 17,A01,092677,Semenuks; Arturs,4,0,81,77
1656918587875,COGS 100,A01,083619,Allen; Michael Gordon,15,0,70,55
1656918593900,COGS 101A,A01,083621,Davis; Joshua Daniel,9,0,68,59
1656918599926,COGS 101B,A01,091572,Allen; Michael Gordon,8,0,65,57
1656918605950,COGS 101C,A01,083625,Delgado; Tania,17,0,35,18
1656918611971,COGS 107A,A01,083627,Boyle; Mary E. T.,13,0,60,47
1656918617997,COGS 118A,A01,083075,Gupta; Anjum,15,0,76,61
1656918624026,CSE 3,A50,083646,Miranda; Gregory Joseph,22,0,50,28
1656918630050,CSE 8A,A50,083650,Miranda; Gregory Joseph,17,1,56,39
1656918636079,CSE 11,A01,083080,Cao; Yingjun,4,15,40,36
1656918642106,CSE 12,A01,083652,Krause-Levy; Sophia Louisa,20,1,120,100
1656918648141,CSE 15L,A01,083654,Morris; Justin Loren,8,0,50,42
1656918648141,CSE 15L,A02,083655,Morris; Justin Loren,8,0,50,42
1656918654168,CSE 20,A01,083657,Tran; Khoa Dang,37,0,80,43
1656918660196,CSE 21,A01,095574,Bach; Quang Tran,21,0,48,27
1656918666229,CSE 30,A01,083084,Eldon; John,4,0,80,76
1656918666229,CSE 30,B01,095061,Bhaskar; Nishant,6,0,50,44
1656918672259,CSE 100,A01,083659,Cao; Yingjun,3,4,70,67
1656918678291,CSE 134B,A01,083661,Powell; Thomas Allan,19,0,100,81
1656918684319,CSE 140,A01,083663,Gungor; Onat,14,0,85,71
1656918690344,CSE 140L,A01,083088,Eldon; John,16,0,100,84
1656918696369,CSE 175,A01,083665,Kumar; Rakesh,3,0,25,22
1656918702391,CSE 190,A00,092507,Dubnov; Shlomo,7,0,20,13
1656918708427,ECE 45,A01,083139,Congero; Spencer William,5,0,75,70
1656918714456,ECE 65,A50,083695,Saad; Andrew S,12,0,30,18
1656918714456,ECE 65,A51,095125,Saad; Andrew S,25,0,26,1
1656918720481,ECE 109,A01,091882,Touri; Behrouz,16,0,70,54
1656918726582,ECE 180,A00,083140,Abi Samra; Nicholas Camill,0,0,30,30
1656918726582,ECE 180,B00,083141,Abi Samra; Nicholas Camill,0,0,30,30
1656918732617,MATH 10A,A01,083735,Patchell; Gregory David,1,0,30,29
1656918732617,MATH 10A,A02,083736,Patchell; Gregory David,20,0,30,10
1656918732617,MATH 10A,A03,083737,Patchell; Gregory David,15,0,30,15
1656918738653,MATH 10B,A01,083207,Lim; Seonhee,7,0,34,27
1656918738653,MATH 10B,A02,083208,Lim; Seonhee,9,0,35,26
1656918738653,MATH 10B,A03,093472,Lim; Seonhee,4,0,34,30
1656918738653,MATH 10B,B01,083739,Sinha; Shubham,9,0,30,21
1656918744684,MATH 18,A01,083743,Cinel; Cameron Alexander,6,0,30,24
1656918744684,MATH 18,A02,083744,Cinel; Cameron Alexander,15,0,30,15
1656918744684,MATH 18,A03,083745,Cinel; Cameron Alexander,8,0,30,22
1656918744684,MATH 18,B01,083748,Rideout; David Porter,4,0,37,33
1656918744684,MATH 18,B02,083749,Rideout; David Porter,3,0,36,33
1656918744684,MATH 18,B03,083750,Rideout; David Porter,2,0,37,35
1656918744684,MATH 18,B04,083751,Rideout; David Porter,5,0,36,31
1656918744684,MATH 18,B05,093473,Rideout; David Porter,4,0,36,32
1656918744684,MATH 18,B06,093474,Rideout; David Porter,5,0,36,31
1656918750707,MATH 20A,A01,083754,Zheng; Zequn,12,0,40,28
1656918756735,MATH 20B,A01,083756,Briones; Jor-el Thomas Caparas,1,0,36,35
1656918756735,MATH 20B,A02,083757,Briones; Jor-el Thomas Caparas,1,0,36,35
1656918756735,MATH 20B,A03,093475,Briones; Jor-el Thomas Caparas,0,0,36,36
1656918762760,MATH 20C,A01,083760,Briones; Jor-el Thomas Caparas,1,0,35,34
1656918762760,MATH 20C,A02,083761,Briones; Jor-el Thomas Caparas,8,0,35,27
1656918762760,MATH 20C,A03,093476,Briones; Jor-el Thomas Caparas,0,1,36,36
1656918762760,MATH 20C,B01,083762,Bach; Quang Tran,0,0,30,30
1656918768796,MATH 20D,A01,083765,Tran; Brian Kha,4,0,30,26
1656918768796,MATH 20D,A02,083766,Tran; Brian Kha,4,0,30,26
1656918768796,MATH 20D,A03,083767,Tran; Brian Kha,3,0,30,27
1656918774827,MATH 20E,A01,083771,Ganguly; Soumya,5,0,32,27
1656918774827,MATH 20E,A02,083772,Ganguly; Soumya,6,0,32,26
1656918774827,MATH 20E,B01,083773,Ciotti; Benjamin,18,0,35,17
1656918774827,MATH 20E,B02,083774,Ciotti; Benjamin,17,0,35,18
1656918780859,MATH 103A,A01,083777,Greenfeld; Be'Eri,2,0,36,34
1656918780859,MATH 103A,A02,083778,Greenfeld; Be'Eri,5,0,36,31
1656918780859,MATH 103A,A03,093561,Greenfeld; Be'Eri,4,0,36,32
1656918780859,MATH 103A,B01,083779,Greenfeld; Be'Eri,6,0,36,30
1656918780859,MATH 103A,B02,083780,Greenfeld; Be'Eri,2,0,36,34
1656918780859,MATH 103A,B03,093562,Greenfeld; Be'Eri,2,0,36,34
1656918786887,MATH 105,A01,085443,Carter; Anne Toulson,13,0,35,22
1656918786887,MATH 105,A02,093477,Carter; Anne Toulson,20,0,35,15
1656918792918,MATH 109,A01,083213,Ganzberger; Geoffrey Michael,2,0,34,32
1656918792918,MATH 109,A02,083214,Ganzberger; Geoffrey Michael,2,0,34,32
1656918792918,MATH 109,A03,093478,Ganzberger; Geoffrey Michael,1,0,34,33
1656918792918,MATH 109,B01,083215,Ganzberger; Geoffrey Michael,1,0,32,31
1656918792918,MATH 109,B02,083216,Ganzberger; Geoffrey Michael,1,0,32,31
1656918792918,MATH 109,B03,093479,Ganzberger; Geoffrey Michael,6,0,32,26
1656918798948,MATH 142A,A01,083219,Chow; Bennett,6,0,32,26
1656918798948,MATH 142A,A02,083220,Chow; Bennett,10,0,32,22
1656918798948,MATH 142A,A03,093480,Chow; Bennett,7,0,32,25
1656918798948,MATH 142A,B03,093481,Chow; Bennett,7,0,32,25
1656918798948,MATH 142A,B04,093558,Chow; Bennett,10,0,32,22
1656918798948,MATH 142A,B05,093559,Chow; Bennett,6,0,32,26
1656918804979,MATH 193A,A01,083224,Rotar; Vladimir,7,0,34,27
1656918804979,MATH 193A,A02,083225,Rotar; Vladimir,3,0,34,31
1656918804979,MATH 193A,A03,083781,Rotar; Vladimir,1,0,34,33
1656918804979,MATH 193A,A04,083782,Rotar; Vladimir,6,0,34,28
1656918804979,MATH 193A,A05,093482,Rotar; Vladimir,6,0,34,28
1656918811007,MATH 197,001,091859,McAuley; Julian John,9999,0,9999,0
1656918811007,MATH 197,002,095566,Kedlaya; Kiran S.,9997,0,9999,2
1656918811007,MATH 197,003,095567,Xiao; Ming,9999,0,9999,0
1656918811007,MATH 197,004,095571,Perols; Johan Lars,9998,0,9999,1
1656918818074,COGS 9,A01,083615,Shannon; Kyle Michael,7,0,75,68
1656918824099,COGS 11,A01,083617,Boyle; Mary E. T.,19,0,48,29
1656918830126,COGS 13,A01,083071,Bastos; Amalia Pinkusfeld,9,0,71,62
1656918836158,COGS 14A,A01,092681,Semenuks; Arturs,0,1,100,100
1656918842201,COGS 14B,A01,083073,Cheng; Tzu-Han,5,0,63,58
1656918848233,COGS 17,A01,092677,Semenuks; Arturs,4,0,81,77
1656918854257,COGS 100,A01,083619,Allen; Michael Gordon,15,0,70,55
1656918860289,COGS 101A,A01,083621,Davis; Joshua Daniel,9,0,68,59
1656918866317,COGS 101B,A01,091572,Allen; Michael Gordon,8,0,65,57
1656918872346,COGS 101C,A01,083625,Delgado; Tania,17,0,35,18
1656918878371,COGS 107A,A01,083627,Boyle; Mary E. T.,13,0,60,47
1656918884466,COGS 118A,A01,083075,Gupta; Anjum,15,0,76,61
1656918890493,CSE 3,A50,083646,Miranda; Gregory Joseph,22,0,50,28
1656918896521,CSE 8A,A50,083650,Miranda; Gregory Joseph,17,1,56,39
1656918902544,CSE 11,A01,083080,Cao; Yingjun,4,15,40,36
1656918908572,CSE 12,A01,083652,Krause-Levy; Sophia Louisa,20,1,120,100
1656918914594,CSE 15L,A01,083654,Morris; Justin Loren,8,0,50,42
1656918914594,CSE 15L,A02,083655,Morris; Justin Loren,8,0,50,42
1656918920621,CSE 20,A01,083657,Tran; Khoa Dang,37,0,80,43
1656918926656,CSE 21,A01,095574,Bach; Quang Tran,21,0,48,27
1656918932679,CSE 30,A01,083084,Eldon; John,4,0,80,76
1656918932679,CSE 30,B01,095061,Bhaskar; Nishant,6,0,50,44
1656918938704,CSE 100,A01,083659,Cao; Yingjun,3,4,70,67
1656918944733,CSE 134B,A01,083661,Powell; Thomas Allan,19,0,100,81
1656918950756,CSE 140,A01,083663,Gungor; Onat,14,0,85,71
1656918956785,CSE 140L,A01,083088,Eldon; John,16,0,100,84
1656918962809,CSE 175,A01,083665,Kumar; Rakesh,3,0,25,22
1656918968839,CSE 190,A00,092507,Dubnov; Shlomo,7,0,20,13
1656918974868,ECE 45,A01,083139,Congero; Spencer William,5,0,75,70
1656918980898,ECE 65,A50,083695,Saad; Andrew S,12,0,30,18
1656918980898,ECE 65,A51,095125,Saad; Andrew S,25,0,26,1
1656918986923,ECE 109,A01,091882,Touri; Behrouz,16,0,70,54
1656918992948,ECE 180,A00,083140,Abi Samra; Nicholas Camill,0,0,30,30
1656918992948,ECE 180,B00,083141,Abi Samra; Nicholas Camill,0,0,30,30
1656918998973,MATH 10A,A01,083735,Patchell; Gregory David,1,0,30,29
1656918998973,MATH 10A,A02,083736,Patchell; Gregory David,20,0,30,10
1656918998973,MATH 10A,A03,083737,Patchell; Gregory David,15,0,30,15
1656919005004,MATH 10B,A01,083207,Lim; Seonhee,7,0,34,27
1656919005004,MATH 10B,A02,083208,Lim; Seonhee,9,0,35,26
1656919005004,MATH 10B,A03,093472,Lim; Seonhee,4,0,34,30
1656919005004,MATH 10B,B01,083739,Sinha; Shubham,9,0,30,21
1656919011033,MATH 18,A01,083743,Cinel; Cameron Alexander,6,0,30,24
1656919011033,MATH 18,A02,083744,Cinel; Cameron Alexander,15,0,30,15
1656919011033,MATH 18,A03,083745,Cinel; Cameron Alexander,8,0,30,22
1656919011033,MATH 18,B01,083748,Rideout; David Porter,4,0,37,33
1656919011033,MATH 18,B02,083749,Rideout; David Porter,3,0,36,33
1656919011033,MATH 18,B03,083750,Rideout; David Porter,2,0,37,35
1656919011033,MATH 18,B04,083751,Rideout; David Porter,5,0,36,31
1656919011033,MATH 18,B05,093473,Rideout; David Porter,4,0,36,32
1656919011033,MATH 18,B06,093474,Rideout; David Porter,5,0,36,31
1656919017061,MATH 20A,A01,083754,Zheng; Zequn,12,0,40,28
1656919023083,MATH 20B,A01,083756,Briones; Jor-el Thomas Caparas,1,0,36,35
1656919023083,MATH 20B,A02,083757,Briones; Jor-el Thomas Caparas,1,0,36,35
1656919023083,MATH 20B,A03,093475,Briones; Jor-el Thomas Caparas,0,0,36,36
1656919029113,MATH 20C,A01,083760,Briones; Jor-el Thomas Caparas,1,0,35,34
1656919029113,MATH 20C,A02,083761,Briones; Jor-el Thomas Caparas,8,0,35,27
1656919029113,MATH 20C,A03,093476,Briones; Jor-el Thomas Caparas,0,1,36,36
1656919029113,MATH 20C,B01,083762,Bach; Quang Tran,0,0,30,30
1656919035143,MATH 20D,A01,083765,Tran; Brian Kha,4,0,30,26
1656919035143,MATH 20D,A02,083766,Tran; Brian Kha,4,0,30,26
1656919035143,MATH 20D,A03,083767,Tran; Brian Kha,3,0,30,27
1656919041174,MATH 20E,A01,083771,Ganguly; Soumya,5,0,32,27
1656919041174,MATH 20E,A02,083772,Ganguly; Soumya,6,0,32,26
1656919041174,MATH 20E,B01,083773,Ciotti; Benjamin,18,0,35,17
1656919041174,MATH 20E,B02,083774,Ciotti; Benjamin,17,0,35,18
1656919047199,MATH 103A,A01,083777,Greenfeld; Be'Eri,2,0,36,34
1656919047199,MATH 103A,A02,083778,Greenfeld; Be'Eri,5,0,36,31
1656919047199,MATH 103A,A03,093561,Greenfeld; Be'Eri,4,0,36,32
1656919047199,MATH 103A,B01,083779,Greenfeld; Be'Eri,6,0,36,30
1656919047199,MATH 103A,B02,083780,Greenfeld; Be'Eri,2,0,36,34
1656919047199,MATH 103A,B03,093562,Greenfeld; Be'Eri,2,0,36,34
1656919053224,MATH 105,A01,085443,Carter; Anne Toulson,13,0,35,22
1656919053224,MATH 105,A02,093477,Carter; Anne Toulson,20,0,35,15
1656919059250,MATH 109,A01,083213,Ganzberger; Geoffrey Michael,2,0,34,32
1656919059250,MATH 109,A02,083214,Ganzberger; Geoffrey Michael,2,0,34,32
1656919059250,MATH 109,A03,093478,Ganzberger; Geoffrey Michael,1,0,34,33
1656919059250,MATH 109,B01,083215,Ganzberger; Geoffrey Michael,1,0,32,31
1656919059250,MATH 109,B02,083216,Ganzberger; Geoffrey Michael,1,0,32,31
1656919059250,MATH 109,B03,093479,Ganzberger; Geoffrey Michael,6,0,32,26
1656919065274,MATH 142A,A01,083219,Chow; Bennett,6,0,32,26
1656919065274,MATH 142A,A02,083220,Chow; Bennett,10,0,32,22
1656919065274,MATH 142A,A03,093480,Chow; Bennett,7,0,32,25
1656919065274,MATH 142A,B03,093481,Chow; Bennett,7,0,32,25
1656919065274,MATH 142A,B04,093558,Chow; Bennett,10,0,32,22
1656919065274,MATH 142A,B05,093559,Chow; Bennett,6,0,32,26
1656919071303,MATH 193A,A01,083224,Rotar; Vladimir,7,0,34,27
1656919071303,MATH 193A,A02,083225,Rotar; Vladimir,3,0,34,31
1656919071303,MATH 193A,A03,083781,Rotar; Vladimir,1,0,34,33
1656919071303,MATH 193A,A04,083782,Rotar; Vladimir,6,0,34,28
1656919071303,MATH 193A,A05,093482,Rotar; Vladimir,6,0,34,28
1656919077326,MATH 197,001,091859,McAuley; Julian John,9999,0,9999,0
1656919077326,MATH 197,002,095566,Kedlaya; Kiran S.,9997,0,9999,2
1656919077326,MATH 197,003,095567,Xiao; Ming,9999,0,9999,0
1656919077326,MATH 197,004,095571,Perols; Johan Lars,9998,0,9999,1
1656919084388,COGS 9,A01,083615,Shannon; Kyle Michael,7,0,75,68
1656919090414,COGS 11,A01,083617,Boyle; Mary E. T.,19,0,48,29
1656919096442,COGS 13,A01,083071,Bastos; Amalia Pinkusfeld,9,0,71,62
1656919102464,COGS 14A,A01,092681,Semenuks; Arturs,0,1,100,100
1656919108491,COGS 14B,A01,083073,Cheng; Tzu-Han,5,0,63,58
1656919114521,COGS 17,A01,092677,Semenuks; Arturs,4,0,81,77
1656919120544,COGS 100,A01,083619,Allen; Michael Gordon,15,0,70,55
1656919126567,COGS 101A,A01,083621,Davis; Joshua Daniel,9,0,68,59
1656919132590,COGS 101B,A01,091572,Allen; Michael Gordon,8,0,65,57
1656919138613,COGS 101C,A01,083625,Delgado; Tania,17,0,35,18
1656919144640,COGS 107A,A01,083627,Boyle; Mary E. T.,13,0,60,47
1656919150667,COGS 118A,A01,083075,Gupta; Anjum,15,0,76,61
1656919156698,CSE 3,A50,083646,Miranda; Gregory Joseph,22,0,50,28
1656919162721,CSE 8A,A50,083650,Miranda; Gregory Joseph,17,1,56,39
1656919168743,CSE 11,A01,083080,Cao; Yingjun,4,15,40,36
1656919174771,CSE 12,A01,083652,Krause-Levy; Sophia Louisa,20,1,120,100
1656919180797,CSE 15L,A01,083654,Morris; Justin Loren,8,0,50,42
1656919180797,CSE 15L,A02,083655,Morris; Justin Loren,8,0,50,42
1656919186820,CSE 20,A01,083657,Tran; Khoa Dang,37,0,80,43
1656919192844,CSE 21,A01,095574,Bach; Quang Tran,21,0,48,27
1656919198872,CSE 30,A01,083084,Eldon; John,4,0,80,76
1656919198872,CSE 30,B01,095061,Bhaskar; Nishant,6,0,50,44
1656919204897,CSE 100,A01,083659,Cao; Yingjun,3,4,70,67
1656919210921,CSE 134B,A01,083661,Powell; Thomas Allan,19,0,100,81
1656919216948,CSE 140,A01,083663,Gungor; Onat,14,0,85,71
1656919222974,CSE 140L,A01,083088,Eldon; John,16,0,100,84
1656919229001,CSE 175,A01,083665,Kumar; Rakesh,3,0,25,22
1656919235031,CSE 190,A00,092507,Dubnov; Shlomo,7,0,20,13
1656919241059,ECE 45,A01,083139,Congero; Spencer William,5,0,75,70
1656919247093,ECE 65,A50,083695,Saad; Andrew S,12,0,30,18
1656919247093,ECE 65,A51,095125,Saad; Andrew S,25,0,26,1
1656919253118,ECE 109,A01,091882,Touri; Behrouz,16,0,70,54
1656919259142,ECE 180,A00,083140,Abi Samra; Nicholas Camill,0,0,30,30
1656919259142,ECE 180,B00,083141,Abi Samra; Nicholas Camill,0,0,30,30
1656919265166,MATH 10A,A01,083735,Patchell; Gregory David,1,0,30,29
1656919265166,MATH 10A,A02,083736,Patchell; Gregory David,20,0,30,10
1656919265166,MATH 10A,A03,083737,Patchell; Gregory David,15,0,30,15
1656919271193,MATH 10B,A01,083207,Lim; Seonhee,7,0,34,27
1656919271193,MATH 10B,A02,083208,Lim; Seonhee,9,0,35,26
1656919271193,MATH 10B,A03,093472,Lim; Seonhee,4,0,34,30
1656919271193,MATH 10B,B01,083739,Sinha; Shubham,9,0,30,21
1656919277219,MATH 18,A01,083743,Cinel; Cameron Alexander,6,0,30,24
1656919277219,MATH 18,A02,083744,Cinel; Cameron Alexander,15,0,30,15
1656919277219,MATH 18,A03,083745,Cinel; Cameron Alexander,8,0,30,22
1656919277219,MATH 18,B01,083748,Rideout; David Porter,4,0,37,33
1656919277219,MATH 18,B02,083749,Rideout; David Porter,3,0,36,33
1656919277219,MATH 18,B03,083750,Rideout; David Porter,2,0,37,35
1656919277219,MATH 18,B04,083751,Rideout; David Porter,5,0,36,31
1656919277219,MATH 18,B05,093473,Rideout; David Porter,4,0,36,32
1656919277219,MATH 18,B06,093474,Rideout; David Porter,5,0,36,31
1656919283242,MATH 20A,A01,083754,Zheng; Zequn,12,0,40,28
1656919289269,MATH 20B,A01,083756,Briones; Jor-el Thomas Caparas,1,0,36,35
1656919289269,MATH 20B,A02,083757,Briones; Jor-el Thomas Caparas,1,0,36,35
1656919289269,MATH 20B,A03,093475,Briones; Jor-el Thomas Caparas,0,0,36,36
1656919295292,MATH 20C,A01,083760,Briones; Jor-el Thomas Caparas,1,0,35,34
1656919295292,MATH 20C,A02,083761,Briones; Jor-el Thomas Caparas,8,0,35,27
1656919295292,MATH 20C,A03,093476,Briones; Jor-el Thomas Caparas,0,1,36,36
1656919295292,MATH 20C,B01,083762,Bach; Quang Tran,0,0,30,30
1656919301316,MATH 20D,A01,083765,Tran; Brian Kha,4,0,30,26
1656919301316,MATH 20D,A02,083766,Tran; Brian Kha,4,0,30,26
1656919301316,MATH 20D,A03,083767,Tran; Brian Kha,3,0,30,27
1656919307344,MATH 20E,A01,083771,Ganguly; Soumya,5,0,32,27
1656919307344,MATH 20E,A02,083772,Ganguly; Soumya,6,0,32,26
1656919307344,MATH 20E,B01,083773,Ciotti; Benjamin,18,0,35,17
1656919307344,MATH 20E,B02,083774,Ciotti; Benjamin,17,0,35,18
1656919313371,MATH 103A,A01,083777,Greenfeld; Be'Eri,2,0,36,34
1656919313371,MATH 103A,A02,083778,Greenfeld; Be'Eri,5,0,36,31
1656919313371,MATH 103A,A03,093561,Greenfeld; Be'Eri,4,0,36,32
1656919313371,MATH 103A,B01,083779,Greenfeld; Be'Eri,6,0,36,30
1656919313371,MATH 103A,B02,083780,Greenfeld; Be'Eri,2,0,36,34
1656919313371,MATH 103A,B03,093562,Greenfeld; Be'Eri,2,0,36,34
1656919319398,MATH 105,A01,085443,Carter; Anne Toulson,13,0,35,22
1656919319398,MATH 105,A02,093477,Carter; Anne Toulson,20,0,35,15
1656919325428,MATH 109,A01,083213,Ganzberger; Geoffrey Michael,2,0,34,32
1656919325428,MATH 109,A02,083214,Ganzberger; Geoffrey Michael,2,0,34,32
1656919325428,MATH 109,A03,093478,Ganzberger; Geoffrey Michael,1,0,34,33
1656919325428,MATH 109,B01,083215,Ganzberger; Geoffrey Michael,1,0,32,31
1656919325428,MATH 109,B02,083216,Ganzberger; Geoffrey Michael,1,0,32,31
1656919325428,MATH 109,B03,093479,Ganzberger; Geoffrey Michael,6,0,32,26
1656919331457,MATH 142A,A01,083219,Chow; Bennett,6,0,32,26
1656919331457,MATH 142A,A02,083220,Chow; Bennett,10,0,32,22
1656919331457,MATH 142A,A03,093480,Chow; Bennett,7,0,32,25
1656919331457,MATH 142A,B03,093481,Chow; Bennett,7,0,32,25
1656919331457,MATH 142A,B04,093558,Chow; Bennett,10,0,32,22
1656919331457,MATH 142A,B05,093559,Chow; Bennett,6,0,32,26
1656919337486,MATH 193A,A01,083224,Rotar; Vladimir,7,0,34,27
1656919337486,MATH 193A,A02,083225,Rotar; Vladimir,3,0,34,31
1656919337486,MATH 193A,A03,083781,Rotar; Vladimir,1,0,34,33
1656919337486,MATH 193A,A04,083782,Rotar; Vladimir,6,0,34,28
1656919337486,MATH 193A,A05,093482,Rotar; Vladimir,6,0,34,28
1656919343509,MATH 197,001,091859,McAuley; Julian John,9999,0,9999,0
1656919343509,MATH 197,002,095566,Kedlaya; Kiran S.,9997,0,9999,2
1656919343509,MATH 197,003,095567,Xiao; Ming,9999,0,9999,0
1656919343509,MATH 197,004,095571,Perols; Johan Lars,9998,0,9999,1
1656919350565,COGS 9,A01,083615,Shannon; Kyle Michael,7,0,75,68
1656919356591,COGS 11,A01,083617,Boyle; Mary E. T.,19,0,48,29
1656919362615,COGS 13,A01,083071,Bastos; Amalia Pinkusfeld,9,0,71,62
1656919368639,COGS 14A,A01,092681,Semenuks; Arturs,0,1,100,100
1656919374673,COGS 14B,A01,083073,Cheng; Tzu-Han,5,0,63,58
1656919380698,COGS 17,A01,092677,Semenuks; Arturs,4,0,81,77
1656919386724,COGS 100,A01,083619,Allen; Michael Gordon,15,0,70,55
1656919392750,COGS 101A,A01,083621,Davis; Joshua Daniel,9,0,68,59
1656919398773,COGS 101B,A01,091572,Allen; Michael Gordon,8,0,65,57
1656919404797,COGS 101C,A01,083625,Delgado; Tania,17,0,35,18
1656919410822,COGS 107A,A01,083627,Boyle; Mary E. T.,13,0,60,47
1656919416844,COGS 118A,A01,083075,Gupta; Anjum,15,0,76,61
1656919422867,CSE 3,A50,083646,Miranda; Gregory Joseph,22,0,50,28
1656919428891,CSE 8A,A50,083650,Miranda; Gregory Joseph,17,1,56,39
1656919434917,CSE 11,A01,083080,Cao; Yingjun,4,15,40,36
1656919440941,CSE 12,A01,083652,Krause-Levy; Sophia Louisa,20,1,120,100
1656919446970,CSE 15L,A01,083654,Morris; Justin Loren,8,0,50,42
1656919446970,CSE 15L,A02,083655,Morris; Justin Loren,8,0,50,42
1656919452994,CSE 20,A01,083657,Tran; Khoa Dang,37,0,80,43
1656919459021,CSE 21,A01,095574,Bach; Quang Tran,21,0,48,27
1656919465047,CSE 30,A01,083084,Eldon; John,4,0,80,76
1656919465047,CSE 30,B01,095061,Bhaskar; Nishant,6,0,50,44
1656919471073,CSE 100,A01,083659,Cao; Yingjun,3,4,70,67
1656919477096,CSE 134B,A01,083661,Powell; Thomas Allan,19,0,100,81
1656919483208,CSE 140,A01,083663,Gungor; Onat,14,0,85,71
1656919489232,CSE 140L,A01,083088,Eldon; John,16,0,100,84
1656919495260,CSE 175,A01,083665,Kumar; Rakesh,3,0,25,22
1656919501288,CSE 190,A00,092507,Dubnov; Shlomo,7,0,20,13
1656919507314,ECE 45,A01,083139,Congero; Spencer William,5,0,75,70
1656919513337,ECE 65,A50,083695,Saad; Andrew S,12,0,30,18
1656919513337,ECE 65,A51,095125,Saad; Andrew S,25,0,26,1
1656919519361,ECE 109,A01,091882,Touri; Behrouz,16,0,70,54
1656919525393,ECE 180,A00,083140,Abi Samra; Nicholas Camill,0,0,30,30
1656919525393,ECE 180,B00,083141,Abi Samra; Nicholas Camill,0,0,30,30
1656919531420,MATH 10A,A01,083735,Patchell; Gregory David,1,0,30,29
1656919531420,MATH 10A,A02,083736,Patchell; Gregory David,20,0,30,10
1656919531420,MATH 10A,A03,083737,Patchell; Gregory David,15,0,30,15
1656919537450,MATH 10B,A01,083207,Lim; Seonhee,7,0,34,27
1656919537450,MATH 10B,A02,083208,Lim; Seonhee,9,0,35,26
1656919537450,MATH 10B,A03,093472,Lim; Seonhee,4,0,34,30
1656919537450,MATH 10B,B01,083739,Sinha; Shubham,9,0,30,21
1656919543482,MATH 18,A01,083743,Cinel; Cameron Alexander,6,0,30,24
1656919543482,MATH 18,A02,083744,Cinel; Cameron Alexander,15,0,30,15
1656919543482,MATH 18,A03,083745,Cinel; Cameron Alexander,8,0,30,22
1656919543482,MATH 18,B01,083748,Rideout; David Porter,4,0,37,33
1656919543482,MATH 18,B02,083749,Rideout; David Porter,3,0,36,33
1656919543482,MATH 18,B03,083750,Rideout; David Porter,2,0,37,35
1656919543482,MATH 18,B04,083751,Rideout; David Porter,5,0,36,31
1656919543482,MATH 18,B05,093473,Rideout; David Porter,4,0,36,32
1656919543482,MATH 18,B06,093474,Rideout; David Porter,5,0,36,31
1656919549508,MATH 20A,A01,083754,Zheng; Zequn,12,0,40,28
1656919555530,MATH 20B,A01,083756,Briones; Jor-el Thomas Caparas,1,0,36,35
1656919555530,MATH 20B,A02,083757,Briones; Jor-el Thomas Caparas,1,0,36,35
1656919555530,MATH 20B,A03,093475,Briones; Jor-el Thomas Caparas,0,0,36,36
1656919561556,MATH 20C,A01,083760,Briones; Jor-el Thomas Caparas,1,0,35,34
1656919561556,MATH 20C,A02,083761,Briones; Jor-el Thomas Caparas,8,0,35,27
1656919561556,MATH 20C,A03,093476,Briones; Jor-el Thomas Caparas,0,1,36,36
1656919561556,MATH 20C,B01,083762,Bach; Quang Tran,0,0,30,30
1656919567584,MATH 20D,A01,083765,Tran; Brian Kha,4,0,30,26
1656919567584,MATH 20D,A02,083766,Tran; Brian Kha,4,0,30,26
1656919567584,MATH 20D,A03,083767,Tran; Brian Kha,3,0,30,27
1656919573611,MATH 20E,A01,083771,Ganguly; Soumya,5,0,32,27
1656919573611,MATH 20E,A02,083772,Ganguly; Soumya,6,0,32,26
1656919573611,MATH 20E,B01,083773,Ciotti; Benjamin,18,0,35,17
1656919573611,MATH 20E,B02,083774,Ciotti; Benjamin,17,0,35,18
1656919579644,MATH 103A,A01,083777,Greenfeld; Be'Eri,2,0,36,34
1656919579644,MATH 103A,A02,083778,Greenfeld; Be'Eri,5,0,36,31
1656919579644,MATH 103A,A03,093561,Greenfeld; Be'Eri,4,0,36,32
1656919579644,MATH 103A,B01,083779,Greenfeld; Be'Eri,6,0,36,30
1656919579644,MATH 103A,B02,083780,Greenfeld; Be'Eri,2,0,36,34
1656919579644,MATH 103A,B03,093562,Greenfeld; Be'Eri,2,0,36,34
1656919585669,MATH 105,A01,085443,Carter; Anne Toulson,13,0,35,22
1656919585669,MATH 105,A02,093477,Carter; Anne Toulson,20,0,35,15
1656919591694,MATH 109,A01,083213,Ganzberger; Geoffrey Michael,2,0,34,32
1656919591694,MATH 109,A02,083214,Ganzberger; Geoffrey Michael,2,0,34,32
1656919591694,MATH 109,A03,093478,Ganzberger; Geoffrey Michael,1,0,34,33
1656919591694,MATH 109,B01,083215,Ganzberger; Geoffrey Michael,1,0,32,31
1656919591694,MATH 109,B02,083216,Ganzberger; Geoffrey Michael,1,0,32,31
1656919591694,MATH 109,B03,093479,Ganzberger; Geoffrey Michael,6,0,32,26
1656919597717,MATH 142A,A01,083219,Chow; Bennett,6,0,32,26
1656919597717,MATH 142A,A02,083220,Chow; Bennett,10,0,32,22
1656919597717,MATH 142A,A03,093480,Chow; Bennett,7,0,32,25
1656919597717,MATH 142A,B03,093481,Chow; Bennett,7,0,32,25
1656919597717,MATH 142A,B04,093558,Chow; Bennett,10,0,32,22
1656919597717,MATH 142A,B05,093559,Chow; Bennett,6,0,32,26
1656919603743,MATH 193A,A01,083224,Rotar; Vladimir,7,0,34,27
1656919603743,MATH 193A,A02,083225,Rotar; Vladimir,3,0,34,31
1656919603743,MATH 193A,A03,083781,Rotar; Vladimir,1,0,34,33
1656919603743,MATH 193A,A04,083782,Rotar; Vladimir,6,0,34,28
1656919603743,MATH 193A,A05,093482,Rotar; Vladimir,6,0,34,28
1656919609766,MATH 197,001,091859,McAuley; Julian John,9999,0,9999,0
1656919609766,MATH 197,002,095566,Kedlaya; Kiran S.,9997,0,9999,2
1656919609766,MATH 197,003,095567,Xiao; Ming,9999,0,9999,0
1656919609766,MATH 197,004,095571,Perols; Johan Lars,9998,0,9999,1
1656919616841,COGS 9,A01,083615,Shannon; Kyle Michael,7,0,75,68
1656919622872,COGS 11,A01,083617,Boyle; Mary E. T.,19,0,48,29
1656919628900,COGS 13,A01,083071,Bastos; Amalia Pinkusfeld,9,0,71,62
1656919634927,COGS 14A,A01,092681,Semenuks; Arturs,0,1,100,100
1656919640950,COGS 14B,A01,083073,Cheng; Tzu-Han,5,0,63,58
1656919646979,COGS 17,A01,092677,Semenuks; Arturs,4,0,81,77
1656919653007,COGS 100,A01,083619,Allen; Michael Gordon,15,0,70,55
1656919659033,COGS 101A,A01,083621,Davis; Joshua Daniel,9,0,68,59
1656919665056,COGS 101B,A01,091572,Allen; Michael Gordon,8,0,65,57
1656919671081,COGS 101C,A01,083625,Delgado; Tania,17,0,35,18
1656919677106,COGS 107A,A01,083627,Boyle; Mary E. T.,13,0,60,47
1656919683135,COGS 118A,A01,083075,Gupta; Anjum,15,0,76,61
1656919689158,CSE 3,A50,083646,Miranda; Gregory Joseph,22,0,50,28
1656919695187,CSE 8A,A50,083650,Miranda; Gregory Joseph,17,1,56,39
1656919701210,CSE 11,A01,083080,Cao; Yingjun,4,15,40,36
1656919707246,CSE 12,A01,083652,Krause-Levy; Sophia Louisa,20,1,120,100
1656919713274,CSE 15L,A01,083654,Morris; Justin Loren,8,0,50,42
1656919713274,CSE 15L,A02,083655,Morris; Justin Loren,8,0,50,42
1656919719309,CSE 20,A01,083657,Tran; Khoa Dang,37,0,80,43
1656919725335,CSE 21,A01,095574,Bach; Quang Tran,21,0,48,27
1656919731359,CSE 30,A01,083084,Eldon; John,4,0,80,76
1656919731359,CSE 30,B01,095061,Bhaskar; Nishant,6,0,50,44
1656919737382,CSE 100,A01,083659,Cao; Yingjun,3,4,70,67
1656919743409,CSE 134B,A01,083661,Powell; Thomas Allan,19,0,100,81
1656919749436,CSE 140,A01,083663,Gungor; Onat,14,0,85,71
1656919755462,CSE 140L,A01,083088,Eldon; John,16,0,100,84
1656919761485,CSE 175,A01,083665,Kumar; Rakesh,3,0,25,22
1656919767509,CSE 190,A00,092507,Dubnov; Shlomo,7,0,20,13
1656919773534,ECE 45,A01,083139,Congero; Spencer William,5,0,75,70
1656919779563,ECE 65,A50,083695,Saad; Andrew S,12,0,30,18
1656919779563,ECE 65,A51,095125,Saad; Andrew S,25,0,26,1
1656919785599,ECE 109,A01,091882,Touri; Behrouz,16,0,70,54
1656919791627,ECE 180,A00,083140,Abi Samra; Nicholas Camill,0,0,30,30
1656919791627,ECE 180,B00,083141,Abi Samra; Nicholas Camill,0,0,30,30
1656919797651,MATH 10A,A01,083735,Patchell; Gregory David,1,0,30,29
1656919797651,MATH 10A,A02,083736,Patchell; Gregory David,20,0,30,10
1656919797651,MATH 10A,A03,083737,Patchell; Gregory David,15,0,30,15
1656919803680,MATH 10B,A01,083207,Lim; Seonhee,7,0,34,27
1656919803680,MATH 10B,A02,083208,Lim; Seonhee,9,0,35,26
1656919803680,MATH 10B,A03,093472,Lim; Seonhee,4,0,34,30
1656919803680,MATH 10B,B01,083739,Sinha; Shubham,9,0,30,21
1656919809711,MATH 18,A01,083743,Cinel; Cameron Alexander,6,0,30,24
1656919809711,MATH 18,A02,083744,Cinel; Cameron Alexander,15,0,30,15
1656919809711,MATH 18,A03,083745,Cinel; Cameron Alexander,8,0,30,22
1656919809711,MATH 18,B01,083748,Rideout; David Porter,4,0,37,33
1656919809711,MATH 18,B02,083749,Rideout; David Porter,3,0,36,33
1656919809711,MATH 18,B03,083750,Rideout; David Porter,2,0,37,35
1656919809711,MATH 18,B04,083751,Rideout; David Porter,5,0,36,31
1656919809711,MATH 18,B05,093473,Rideout; David Porter,4,0,36,32
1656919809711,MATH 18,B06,093474,Rideout; David Porter,5,0,36,31
1656919815734,MATH 20A,A01,083754,Zheng; Zequn,12,0,40,28
1656919821761,MATH 20B,A01,083756,Briones; Jor-el Thomas Caparas,1,0,36,35
1656919821761,MATH 20B,A02,083757,Briones; Jor-el Thomas Caparas,1,0,36,35
1656919821761,MATH 20B,A03,093475,Briones; Jor-el Thomas Caparas,0,0,36,36
1656919827799,MATH 20C,A01,083760,Briones; Jor-el Thomas Caparas,1,0,35,34
1656919827799,MATH 20C,A02,083761,Briones; Jor-el Thomas Caparas,8,0,35,27
1656919827799,MATH 20C,A03,093476,Briones; Jor-el Thomas Caparas,0,1,36,36
1656919827799,MATH 20C,B01,083762,Bach; Quang Tran,0,0,30,30
1656919833829,MATH 20D,A01,083765,Tran; Brian Kha,4,0,30,26
1656919833829,MATH 20D,A02,083766,Tran; Brian Kha,4,0,30,26
1656919833829,MATH 20D,A03,083767,Tran; Brian Kha,3,0,30,27
1656919839855,MATH 20E,A01,083771,Ganguly; Soumya,5,0,32,27
1656919839855,MATH 20E,A02,083772,Ganguly; Soumya,6,0,32,26
1656919839855,MATH 20E,B01,083773,Ciotti; Benjamin,18,0,35,17
1656919839855,MATH 20E,B02,083774,Ciotti; Benjamin,17,0,35,18
1656919845880,MATH 103A,A01,083777,Greenfeld; Be'Eri,2,0,36,34
1656919845880,MATH 103A,A02,083778,Greenfeld; Be'Eri,5,0,36,31
1656919845880,MATH 103A,A03,093561,Greenfeld; Be'Eri,4,0,36,32
1656919845880,MATH 103A,B01,083779,Greenfeld; Be'Eri,6,0,36,30
1656919845880,MATH 103A,B02,083780,Greenfeld; Be'Eri,2,0,36,34
1656919845880,MATH 103A,B03,093562,Greenfeld; Be'Eri,2,0,36,34
1656919851903,MATH 105,A01,085443,Carter; Anne Toulson,13,0,35,22
1656919851903,MATH 105,A02,093477,Carter; Anne Toulson,20,0,35,15
1656919857926,MATH 109,A01,083213,Ganzberger; Geoffrey Michael,2,0,34,32
1656919857926,MATH 109,A02,083214,Ganzberger; Geoffrey Michael,2,0,34,32
1656919857926,MATH 109,A03,093478,Ganzberger; Geoffrey Michael,1,0,34,33
1656919857926,MATH 109,B01,083215,Ganzberger; Geoffrey Michael,1,0,32,31
1656919857926,MATH 109,B02,083216,Ganzberger; Geoffrey Michael,1,0,32,31
1656919857926,MATH 109,B03,093479,Ganzberger; Geoffrey Michael,6,0,32,26
1656919863957,MATH 142A,A01,083219,Chow; Bennett,6,0,32,26
1656919863957,MATH 142A,A02,083220,Chow; Bennett,10,0,32,22
1656919863957,MATH 142A,A03,093480,Chow; Bennett,7,0,32,25
1656919863957,MATH 142A,B03,093481,Chow; Bennett,7,0,32,25
1656919863957,MATH 142A,B04,093558,Chow; Bennett,10,0,32,22
1656919863957,MATH 142A,B05,093559,Chow; Bennett,6,0,32,26
1656919869989,MATH 193A,A01,083224,Rotar; Vladimir,7,0,34,27
1656919869989,MATH 193A,A02,083225,Rotar; Vladimir,3,0,34,31
1656919869989,MATH 193A,A03,083781,Rotar; Vladimir,1,0,34,33
1656919869989,MATH 193A,A04,083782,Rotar; Vladimir,6,0,34,28
1656919869989,MATH 193A,A05,093482,Rotar; Vladimir,6,0,34,28
1656919876015,MATH 197,001,091859,McAuley; Julian John,9999,0,9999,0
1656919876015,MATH 197,002,095566,Kedlaya; Kiran S.,9997,0,9999,2
1656919876015,MATH 197,003,095567,Xiao; Ming,9999,0,9999,0
1656919876015,MATH 197,004,095571,Perols; Johan Lars,9998,0,9999,1
1656919883077,COGS 9,A01,083615,Shannon; Kyle Michael,7,0,75,68
1656919889100,COGS 11,A01,083617,Boyle; Mary E. T.,19,0,48,29
1656919895127,COGS 13,A01,083071,Bastos; Amalia Pinkusfeld,9,0,71,62
1656919901150,COGS 14A,A01,092681,Semenuks; Arturs,0,1,100,100
1656919907173,COGS 14B,A01,083073,Cheng; Tzu-Han,5,0,63,58
1656919913196,COGS 17,A01,092677,Semenuks; Arturs,4,0,81,77
1656919919221,COGS 100,A01,083619,Allen; Michael Gordon,15,0,70,55
1656919925249,COGS 101A,A01,083621,Davis; Joshua Daniel,9,0,68,59
1656919931273,COGS 101B,A01,091572,Allen; Michael Gordon,8,0,65,57
1656919937297,COGS 101C,A01,083625,Delgado; Tania,17,0,35,18
1656919943323,COGS 107A,A01,083627,Boyle; Mary E. T.,13,0,60,47
1656919949347,COGS 118A,A01,083075,Gupta; Anjum,15,0,76,61
1656919955373,CSE 3,A50,083646,Miranda; Gregory Joseph,22,0,50,28
1656919961398,CSE 8A,A50,083650,Miranda; Gregory Joseph,17,1,56,39
1656919967419,CSE 11,A01,083080,Cao; Yingjun,4,15,40,36
1656919973444,CSE 12,A01,083652,Krause-Levy; Sophia Louisa,20,1,120,100
1656919979468,CSE 15L,A01,083654,Morris; Justin Loren,8,0,50,42
1656919979468,CSE 15L,A02,083655,Morris; Justin Loren,8,0,50,42
1656919985492,CSE 20,A01,083657,Tran; Khoa Dang,37,0,80,43
1656919991515,CSE 21,A01,095574,Bach; Quang Tran,21,0,48,27
1656919997540,CSE 30,A01,083084,Eldon; John,4,0,80,76
1656919997540,CSE 30,B01,095061,Bhaskar; Nishant,6,0,50,44
1656920003563,CSE 100,A01,083659,Cao; Yingjun,3,4,70,67
1656920009586,CSE 134B,A01,083661,Powell; Thomas Allan,19,0,100,81
1656920015609,CSE 140,A01,083663,Gungor; Onat,14,0,85,71
1656920021633,CSE 140L,A01,083088,Eldon; John,16,0,100,84
1656920027659,CSE 175,A01,083665,Kumar; Rakesh,3,0,25,22
1656920033685,CSE 190,A00,092507,Dubnov; Shlomo,7,0,20,13
1656920039712,ECE 45,A01,083139,Congero; Spencer William,5,0,75,70
1656920045739,ECE 65,A50,083695,Saad; Andrew S,12,0,30,18
1656920045739,ECE 65,A51,095125,Saad; Andrew S,25,0,26,1
1656920051764,ECE 109,A01,091882,Touri; Behrouz,16,0,70,54
1656920057790,ECE 180,A00,083140,Abi Samra; Nicholas Camill,0,0,30,30
1656920057790,ECE 180,B00,083141,Abi Samra; Nicholas Camill,0,0,30,30
1656920063819,MATH 10A,A01,083735,Patchell; Gregory David,1,0,30,29
1656920063819,MATH 10A,A02,083736,Patchell; Gregory David,20,0,30,10
1656920063819,MATH 10A,A03,083737,Patchell; Gregory David,15,0,30,15
1656920069848,MATH 10B,A01,083207,Lim; Seonhee,7,0,34,27
1656920069848,MATH 10B,A02,083208,Lim; Seonhee,9,0,35,26
1656920069848,MATH 10B,A03,093472,Lim; Seonhee,4,0,34,30
1656920069848,MATH 10B,B01,083739,Sinha; Shubham,9,0,30,21
1656920075879,MATH 18,A01,083743,Cinel; Cameron Alexander,6,0,30,24
1656920075879,MATH 18,A02,083744,Cinel; Cameron Alexander,15,0,30,15
1656920075879,MATH 18,A03,083745,Cinel; Cameron Alexander,8,0,30,22
1656920075879,MATH 18,B01,083748,Rideout; David Porter,4,0,37,33
1656920075879,MATH 18,B02,083749,Rideout; David Porter,3,0,36,33
1656920075879,MATH 18,B03,083750,Rideout; David Porter,2,0,37,35
1656920075879,MATH 18,B04,083751,Rideout; David Porter,5,0,36,31
1656920075879,MATH 18,B05,093473,Rideout; David Porter,4,0,36,32
1656920075879,MATH 18,B06,093474,Rideout; David Porter,5,0,36,31
1656920081992,MATH 20A,A01,083754,Zheng; Zequn,12,0,40,28
1656920088014,MATH 20B,A01,083756,Briones; Jor-el Thomas Caparas,1,0,36,35
1656920088014,MATH 20B,A02,083757,Briones; Jor-el Thomas Caparas,1,0,36,35
1656920088014,MATH 20B,A03,093475,Briones; Jor-el Thomas Caparas,0,0,36,36
1656920094037,MATH 20C,A01,083760,Briones; Jor-el Thomas Caparas,1,0,35,34
1656920094037,MATH 20C,A02,083761,Briones; Jor-el Thomas Caparas,8,0,35,27
1656920094037,MATH 20C,A03,093476,Briones; Jor-el Thomas Caparas,0,1,36,36
1656920094037,MATH 20C,B01,083762,Bach; Quang Tran,0,0,30,30
1656920100060,MATH 20D,A01,083765,Tran; Brian Kha,4,0,30,26
1656920100060,MATH 20D,A02,083766,Tran; Brian Kha,4,0,30,26
1656920100060,MATH 20D,A03,083767,Tran; Brian Kha,3,0,30,27
1656920106098,MATH 20E,A01,083771,Ganguly; Soumya,5,0,32,27
1656920106098,MATH 20E,A02,083772,Ganguly; Soumya,6,0,32,26
1656920106098,MATH 20E,B01,083773,Ciotti; Benjamin,18,0,35,17
1656920106098,MATH 20E,B02,083774,Ciotti; Benjamin,17,0,35,18
1656920112127,MATH 103A,A01,083777,Greenfeld; Be'Eri,2,0,36,34
1656920112127,MATH 103A,A02,083778,Greenfeld; Be'Eri,5,0,36,31
1656920112127,MATH 103A,A03,093561,Greenfeld; Be'Eri,4,0,36,32
1656920112127,MATH 103A,B01,083779,Greenfeld; Be'Eri,6,0,36,30
1656920112127,MATH 103A,B02,083780,Greenfeld; Be'Eri,2,0,36,34
1656920112127,MATH 103A,B03,093562,Greenfeld; Be'Eri,2,0,36,34
1656920118150,MATH 105,A01,085443,Carter; Anne Toulson,13,0,35,22
1656920118150,MATH 105,A02,093477,Carter; Anne Toulson,20,0,35,15
1656920124174,MATH 109,A01,083213,Ganzberger; Geoffrey Michael,2,0,34,32
1656920124174,MATH 109,A02,083214,Ganzberger; Geoffrey Michael,2,0,34,32
1656920124174,MATH 109,A03,093478,Ganzberger; Geoffrey Michael,1,0,34,33
1656920124174,MATH 109,B01,083215,Ganzberger; Geoffrey Michael,1,0,32,31
1656920124174,MATH 109,B02,083216,Ganzberger; Geoffrey Michael,1,0,32,31
1656920124174,MATH 109,B03,093479,Ganzberger; Geoffrey Michael,6,0,32,26
1656920130200,MATH 142A,A01,083219,Chow; Bennett,6,0,32,26
1656920130200,MATH 142A,A02,083220,Chow; Bennett,10,0,32,22
1656920130200,MATH 142A,A03,093480,Chow; Bennett,7,0,32,25
1656920130200,MATH 142A,B03,093481,Chow; Bennett,7,0,32,25
1656920130200,MATH 142A,B04,093558,Chow; Bennett,10,0,32,22
1656920130200,MATH 142A,B05,093559,Chow; Bennett,6,0,32,26
1656920136228,MATH 193A,A01,083224,Rotar; Vladimir,7,0,34,27
1656920136228,MATH 193A,A02,083225,Rotar; Vladimir,3,0,34,31
1656920136228,MATH 193A,A03,083781,Rotar; Vladimir,1,0,34,33
1656920136228,MATH 193A,A04,083782,Rotar; Vladimir,6,0,34,28
1656920136228,MATH 193A,A05,093482,Rotar; Vladimir,6,0,34,28
1656920142253,MATH 197,001,091859,McAuley; Julian John,9999,0,9999,0
1656920142253,MATH 197,002,095566,Kedlaya; Kiran S.,9997,0,9999,2
1656920142253,MATH 197,003,095567,Xiao; Ming,9999,0,9999,0
1656920142253,MATH 197,004,095571,Perols; Johan Lars,9998,0,9999,1
1656920149318,COGS 9,A01,083615,Shannon; Kyle Michael,7,0,75,68
1656920155344,COGS 11,A01,083617,Boyle; Mary E. T.,19,0,48,29
1656920161373,COGS 13,A01,083071,Bastos; Amalia Pinkusfeld,9,0,71,62
1656920167396,COGS 14A,A01,092681,Semenuks; Arturs,0,1,100,100
1656920173417,COGS 14B,A01,083073,Cheng; Tzu-Han,5,0,63,58
1656920179441,COGS 17,A01,092677,Semenuks; Arturs,4,0,81,77
1656920185464,COGS 100,A01,083619,Allen; Michael Gordon,15,0,70,55
1656920191490,COGS 101A,A01,083621,Davis; Joshua Daniel,9,0,68,59
1656920197512,COGS 101B,A01,091572,Allen; Michael Gordon,8,0,65,57
1656920203538,COGS 101C,A01,083625,Delgado; Tania,17,0,35,18
1656920209561,COGS 107A,A01,083627,Boyle; Mary E. T.,13,0,60,47
1656920215588,COGS 118A,A01,083075,Gupta; Anjum,15,0,76,61
1656920221613,CSE 3,A50,083646,Miranda; Gregory Joseph,22,0,50,28
1656920227636,CSE 8A,A50,083650,Miranda; Gregory Joseph,17,1,56,39
1656920233661,CSE 11,A01,083080,Cao; Yingjun,4,15,40,36
1656920239686,CSE 12,A01,083652,Krause-Levy; Sophia Louisa,20,1,120,100
1656920245709,CSE 15L,A01,083654,Morris; Justin Loren,8,0,50,42
1656920245709,CSE 15L,A02,083655,Morris; Justin Loren,8,0,50,42
1656920251738,CSE 20,A01,083657,Tran; Khoa Dang,37,0,80,43
1656920257764,CSE 21,A01,095574,Bach; Quang Tran,21,0,48,27
1656920263790,CSE 30,A01,083084,Eldon; John,4,0,80,76
1656920263790,CSE 30,B01,095061,Bhaskar; Nishant,6,0,50,44
1656920269815,CSE 100,A01,083659,Cao; Yingjun,3,4,70,67
1656920275840,CSE 134B,A01,083661,Powell; Thomas Allan,19,0,100,81
1656920281873,CSE 140,A01,083663,Gungor; Onat,14,0,85,71
1656920287897,CSE 140L,A01,083088,Eldon; John,16,0,100,84
1656920293930,CSE 175,A01,083665,Kumar; Rakesh,3,0,25,22
1656920299955,CSE 190,A00,092507,Dubnov; Shlomo,7,0,20,13
1656920305977,ECE 45,A01,083139,Congero; Spencer William,5,0,75,70
1656920312004,ECE 65,A50,083695,Saad; Andrew S,12,0,30,18
1656920312004,ECE 65,A51,095125,Saad; Andrew S,25,0,26,1
1656920318029,ECE 109,A01,091882,Touri; Behrouz,16,0,70,54
1656920324050,ECE 180,A00,083140,Abi Samra; Nicholas Camill,0,0,30,30
1656920324050,ECE 180,B00,083141,Abi Samra; Nicholas Camill,0,0,30,30
1656920330076,MATH 10A,A01,083735,Patchell; Gregory David,1,0,30,29
1656920330076,MATH 10A,A02,083736,Patchell; Gregory David,20,0,30,10
1656920330076,MATH 10A,A03,083737,Patchell; Gregory David,15,0,30,15
1656920336098,MATH 10B,A01,083207,Lim; Seonhee,7,0,34,27
1656920336098,MATH 10B,A02,083208,Lim; Seonhee,9,0,35,26
1656920336098,MATH 10B,A03,093472,Lim; Seonhee,4,0,34,30
1656920336098,MATH 10B,B01,083739,Sinha; Shubham,9,0,30,21
1656920342136,MATH 18,A01,083743,Cinel; Cameron Alexander,6,0,30,24
1656920342136,MATH 18,A02,083744,Cinel; Cameron Alexander,15,0,30,15
1656920342136,MATH 18,A03,083745,Cinel; Cameron Alexander,8,0,30,22
1656920342136,MATH 18,B01,083748,Rideout; David Porter,4,0,37,33
1656920342136,MATH 18,B02,083749,Rideout; David Porter,3,0,36,33
1656920342136,MATH 18,B03,083750,Rideout; David Porter,2,0,37,35
1656920342136,MATH 18,B04,083751,Rideout; David Porter,5,0,36,31
1656920342136,MATH 18,B05,093473,Rideout; David Porter,4,0,36,32
1656920342136,MATH 18,B06,093474,Rideout; David Porter,5,0,36,31
1656920348160,MATH 20A,A01,083754,Zheng; Zequn,12,0,40,28
1656920354189,MATH 20B,A01,083756,Briones; Jor-el Thomas Caparas,1,0,36,35
1656920354189,MATH 20B,A02,083757,Briones; Jor-el Thomas Caparas,1,0,36,35
1656920354189,MATH 20B,A03,093475,Briones; Jor-el Thomas Caparas,0,0,36,36
1656920360223,MATH 20C,A01,083760,Briones; Jor-el Thomas Caparas,1,0,35,34
1656920360223,MATH 20C,A02,083761,Briones; Jor-el Thomas Caparas,8,0,35,27
1656920360223,MATH 20C,A03,093476,Briones; Jor-el Thomas Caparas,0,1,36,36
1656920360223,MATH 20C,B01,083762,Bach; Quang Tran,0,0,30,30
1656920366249,MATH 20D,A01,083765,Tran; Brian Kha,4,0,30,26
1656920366249,MATH 20D,A02,083766,Tran; Brian Kha,4,0,30,26
1656920366249,MATH 20D,A03,083767,Tran; Brian Kha,3,0,30,27
1656920372282,MATH 20E,A01,083771,Ganguly; Soumya,5,0,32,27
1656920372282,MATH 20E,A02,083772,Ganguly; Soumya,6,0,32,26
1656920372282,MATH 20E,B01,083773,Ciotti; Benjamin,18,0,35,17
1656920372282,MATH 20E,B02,083774,Ciotti; Benjamin,17,0,35,18
1656920378305,MATH 103A,A01,083777,Greenfeld; Be'Eri,2,0,36,34
1656920378305,MATH 103A,A02,083778,Greenfeld; Be'Eri,5,0,36,31
1656920378305,MATH 103A,A03,093561,Greenfeld; Be'Eri,4,0,36,32
1656920378305,MATH 103A,B01,083779,Greenfeld; Be'Eri,6,0,36,30
1656920378305,MATH 103A,B02,083780,Greenfeld; Be'Eri,2,0,36,34
1656920378305,MATH 103A,B03,093562,Greenfeld; Be'Eri,2,0,36,34
1656920384348,MATH 105,A01,085443,Carter; Anne Toulson,13,0,35,22
1656920384348,MATH 105,A02,093477,Carter; Anne Toulson,20,0,35,15
1656920390375,MATH 109,A01,083213,Ganzberger; Geoffrey Michael,2,0,34,32
1656920390375,MATH 109,A02,083214,Ganzberger; Geoffrey Michael,2,0,34,32
1656920390375,MATH 109,A03,093478,Ganzberger; Geoffrey Michael,1,0,34,33
1656920390375,MATH 109,B01,083215,Ganzberger; Geoffrey Michael,1,0,32,31
1656920390375,MATH 109,B02,083216,Ganzberger; Geoffrey Michael,1,0,32,31
1656920390375,MATH 109,B03,093479,Ganzberger; Geoffrey Michael,6,0,32,26
1656920396398,MATH 142A,A01,083219,Chow; Bennett,6,0,32,26
1656920396398,MATH 142A,A02,083220,Chow; Bennett,10,0,32,22
1656920396398,MATH 142A,A03,093480,Chow; Bennett,7,0,32,25
1656920396398,MATH 142A,B03,093481,Chow; Bennett,7,0,32,25
1656920396398,MATH 142A,B04,093558,Chow; Bennett,10,0,32,22
1656920396398,MATH 142A,B05,093559,Chow; Bennett,6,0,32,26
1656920402422,MATH 193A,A01,083224,Rotar; Vladimir,7,0,34,27
1656920402422,MATH 193A,A02,083225,Rotar; Vladimir,3,0,34,31
1656920402422,MATH 193A,A03,083781,Rotar; Vladimir,1,0,34,33
1656920402422,MATH 193A,A04,083782,Rotar; Vladimir,6,0,34,28
1656920402422,MATH 193A,A05,093482,Rotar; Vladimir,6,0,34,28
1656920408474,MATH 197,001,091859,McAuley; Julian John,9999,0,9999,0
1656920408474,MATH 197,002,095566,Kedlaya; Kiran S.,9997,0,9999,2
1656920408474,MATH 197,003,095567,Xiao; Ming,9999,0,9999,0
1656920408474,MATH 197,004,095571,Perols; Johan Lars,9998,0,9999,1
1656920415525,COGS 9,A01,083615,Shannon; Kyle Michael,7,0,75,68
1656920421549,COGS 11,A01,083617,Boyle; Mary E. T.,19,0,48,29
1656920427576,COGS 13,A01,083071,Bastos; Amalia Pinkusfeld,9,0,71,62
1656920433598,COGS 14A,A01,092681,Semenuks; Arturs,0,1,100,100
1656920439626,COGS 14B,A01,083073,Cheng; Tzu-Han,5,0,63,58
1656920445653,COGS 17,A01,092677,Semenuks; Arturs,4,0,81,77
1656920451680,COGS 100,A01,083619,Allen; Michael Gordon,15,0,70,55
1656920457704,COGS 101A,A01,083621,Davis; Joshua Daniel,9,0,68,59
1656920463733,COGS 101B,A01,091572,Allen; Michael Gordon,8,0,65,57
1656920469761,COGS 101C,A01,083625,Delgado; Tania,17,0,35,18
1656920475788,COGS 107A,A01,083627,Boyle; Mary E. T.,13,0,60,47
1656920481816,COGS 118A,A01,083075,Gupta; Anjum,15,0,76,61
1656920487845,CSE 3,A50,083646,Miranda; Gregory Joseph,22,0,50,28
1656920493875,CSE 8A,A50,083650,Miranda; Gregory Joseph,17,1,56,39
1656920499901,CSE 11,A01,083080,Cao; Yingjun,4,15,40,36
1656920505928,CSE 12,A01,083652,Krause-Levy; Sophia Louisa,20,1,120,100
1656920511951,CSE 15L,A01,083654,Morris; Justin Loren,8,0,50,42
1656920511951,CSE 15L,A02,083655,Morris; Justin Loren,8,0,50,42
1656920517980,CSE 20,A01,083657,Tran; Khoa Dang,37,0,80,43
1656920524002,CSE 21,A01,095574,Bach; Quang Tran,21,0,48,27
1656920530027,CSE 30,A01,083084,Eldon; John,4,0,80,76
1656920530027,CSE 30,B01,095061,Bhaskar; Nishant,6,0,50,44
1656920536053,CSE 100,A01,083659,Cao; Yingjun,3,4,70,67
1656920542079,CSE 134B,A01,083661,Powell; Thomas Allan,19,0,100,81
1656920548105,CSE 140,A01,083663,Gungor; Onat,14,0,85,71
1656920554129,CSE 140L,A01,083088,Eldon; John,16,0,100,84
1656920560155,CSE 175,A01,083665,Kumar; Rakesh,3,0,25,22
1656920566179,CSE 190,A00,092507,Dubnov; Shlomo,7,0,20,13
1656920572202,ECE 45,A01,083139,Congero; Spencer William,5,0,75,70
1656920578228,ECE 65,A50,083695,Saad; Andrew S,12,0,30,18
1656920578228,ECE 65,A51,095125,Saad; Andrew S,25,0,26,1
1656920584251,ECE 109,A01,091882,Touri; Behrouz,16,0,70,54
1656920590273,ECE 180,A00,083140,Abi Samra; Nicholas Camill,0,0,30,30
1656920590273,ECE 180,B00,083141,Abi Samra; Nicholas Camill,0,0,30,30
1656920596297,MATH 10A,A01,083735,Patchell; Gregory David,1,0,30,29
1656920596297,MATH 10A,A02,083736,Patchell; Gregory David,20,0,30,10
1656920596297,MATH 10A,A03,083737,Patchell; Gregory David,15,0,30,15
1656920602327,MATH 10B,A01,083207,Lim; Seonhee,7,0,34,27
1656920602327,MATH 10B,A02,083208,Lim; Seonhee,9,0,35,26
1656920602327,MATH 10B,A03,093472,Lim; Seonhee,4,0,34,30
1656920602327,MATH 10B,B01,083739,Sinha; Shubham,9,0,30,21
1656920608369,MATH 18,A01,083743,Cinel; Cameron Alexander,6,0,30,24
1656920608369,MATH 18,A02,083744,Cinel; Cameron Alexander,15,0,30,15
1656920608369,MATH 18,A03,083745,Cinel; Cameron Alexander,8,0,30,22
1656920608369,MATH 18,B01,083748,Rideout; David Porter,4,0,37,33
1656920608369,MATH 18,B02,083749,Rideout; David Porter,3,0,36,33
1656920608369,MATH 18,B03,083750,Rideout; David Porter,2,0,37,35
1656920608369,MATH 18,B04,083751,Rideout; David Porter,5,0,36,31
1656920608369,MATH 18,B05,093473,Rideout; David Porter,4,0,36,32
1656920608369,MATH 18,B06,093474,Rideout; David Porter,5,0,36,31
1656920614406,MATH 20A,A01,083754,Zheng; Zequn,12,0,40,28
1656920620428,MATH 20B,A01,083756,Briones; Jor-el Thomas Caparas,1,0,36,35
1656920620428,MATH 20B,A02,083757,Briones; Jor-el Thomas Caparas,1,0,36,35
1656920620428,MATH 20B,A03,093475,Briones; Jor-el Thomas Caparas,0,0,36,36
1656920626452,MATH 20C,A01,083760,Briones; Jor-el Thomas Caparas,1,0,35,34
1656920626452,MATH 20C,A02,083761,Briones; Jor-el Thomas Caparas,8,0,35,27
1656920626452,MATH 20C,A03,093476,Briones; Jor-el Thomas Caparas,0,1,36,36
1656920626452,MATH 20C,B01,083762,Bach; Quang Tran,0,0,30,30
1656920632478,MATH 20D,A01,083765,Tran; Brian Kha,4,0,30,26
1656920632478,MATH 20D,A02,083766,Tran; Brian Kha,4,0,30,26
1656920632478,MATH 20D,A03,083767,Tran; Brian Kha,3,0,30,27
1656920638503,MATH 20E,A01,083771,Ganguly; Soumya,5,0,32,27
1656920638503,MATH 20E,A02,083772,Ganguly; Soumya,6,0,32,26
1656920638503,MATH 20E,B01,083773,Ciotti; Benjamin,18,0,35,17
1656920638503,MATH 20E,B02,083774,Ciotti; Benjamin,17,0,35,18
1656920644531,MATH 103A,A01,083777,Greenfeld; Be'Eri,2,0,36,34
1656920644531,MATH 103A,A02,083778,Greenfeld; Be'Eri,5,0,36,31
1656920644531,MATH 103A,A03,093561,Greenfeld; Be'Eri,4,0,36,32
1656920644531,MATH 103A,B01,083779,Greenfeld; Be'Eri,6,0,36,30
1656920644531,MATH 103A,B02,083780,Greenfeld; Be'Eri,2,0,36,34
1656920644531,MATH 103A,B03,093562,Greenfeld; Be'Eri,2,0,36,34
1656920650554,MATH 105,A01,085443,Carter; Anne Toulson,13,0,35,22
1656920650554,MATH 105,A02,093477,Carter; Anne Toulson,20,0,35,15
1656920656578,MATH 109,A01,083213,Ganzberger; Geoffrey Michael,2,0,34,32
1656920656578,MATH 109,A02,083214,Ganzberger; Geoffrey Michael,2,0,34,32
1656920656578,MATH 109,A03,093478,Ganzberger; Geoffrey Michael,1,0,34,33
1656920656578,MATH 109,B01,083215,Ganzberger; Geoffrey Michael,1,0,32,31
1656920656578,MATH 109,B02,083216,Ganzberger; Geoffrey Michael,1,0,32,31
1656920656578,MATH 109,B03,093479,Ganzberger; Geoffrey Michael,6,0,32,26
1656920662601,MATH 142A,A01,083219,Chow; Bennett,6,0,32,26
1656920662601,MATH 142A,A02,083220,Chow; Bennett,10,0,32,22
1656920662601,MATH 142A,A03,093480,Chow; Bennett,7,0,32,25
1656920662601,MATH 142A,B03,093481,Chow; Bennett,7,0,32,25
1656920662601,MATH 142A,B04,093558,Chow; Bennett,10,0,32,22
1656920662601,MATH 142A,B05,093559,Chow; Bennett,6,0,32,26
1656920668624,MATH 193A,A01,083224,Rotar; Vladimir,7,0,34,27
1656920668624,MATH 193A,A02,083225,Rotar; Vladimir,3,0,34,31
1656920668624,MATH 193A,A03,083781,Rotar; Vladimir,1,0,34,33
1656920668624,MATH 193A,A04,083782,Rotar; Vladimir,6,0,34,28
1656920668624,MATH 193A,A05,093482,Rotar; Vladimir,6,0,34,28
1656920674647,MATH 197,001,091859,McAuley; Julian John,9999,0,9999,0
1656920674647,MATH 197,002,095566,Kedlaya; Kiran S.,9997,0,9999,2
1656920674647,MATH 197,003,095567,Xiao; Ming,9999,0,9999,0
1656920674647,MATH 197,004,095571,Perols; Johan Lars,9998,0,9999,1
1656920681792,COGS 9,A01,083615,Shannon; Kyle Michael,7,0,75,68
1656920687818,COGS 11,A01,083617,Boyle; Mary E. T.,19,0,48,29
1656920693850,COGS 13,A01,083071,Bastos; Amalia Pinkusfeld,9,0,71,62
1656920699876,COGS 14A,A01,092681,Semenuks; Arturs,0,1,100,100
1656920705899,COGS 14B,A01,083073,Cheng; Tzu-Han,5,0,63,58
1656920711926,COGS 17,A01,092677,Semenuks; Arturs,4,0,81,77
1656920717956,COGS 100,A01,083619,Allen; Michael Gordon,15,0,70,55
1656920723984,COGS 101A,A01,083621,Davis; Joshua Daniel,9,0,68,59
1656920730008,COGS 101B,A01,091572,Allen; Michael Gordon,8,0,65,57
1656920736032,COGS 101C,A01,083625,Delgado; Tania,17,0,35,18
1656920742057,COGS 107A,A01,083627,Boyle; Mary E. T.,13,0,60,47
1656920748085,COGS 118A,A01,083075,Gupta; Anjum,15,0,76,61
1656920754109,CSE 3,A50,083646,Miranda; Gregory Joseph,22,0,50,28
1656920760138,CSE 8A,A50,083650,Miranda; Gregory Joseph,17,1,56,39
1656920766178,CSE 11,A01,083080,Cao; Yingjun,4,15,40,36
1656920772205,CSE 12,A01,083652,Krause-Levy; Sophia Louisa,20,1,120,100
1656920778229,CSE 15L,A01,083654,Morris; Justin Loren,8,0,50,42
1656920778229,CSE 15L,A02,083655,Morris; Justin Loren,8,0,50,42
1656920784255,CSE 20,A01,083657,Tran; Khoa Dang,37,0,80,43
1656920790279,CSE 21,A01,095574,Bach; Quang Tran,21,0,48,27
1656920796305,CSE 30,A01,083084,Eldon; John,4,0,80,76
1656920796305,CSE 30,B01,095061,Bhaskar; Nishant,6,0,50,44
1656920802332,CSE 100,A01,083659,Cao; Yingjun,3,4,70,67
1656920808354,CSE 134B,A01,083661,Powell; Thomas Allan,19,0,100,81
1656920814376,CSE 140,A01,083663,Gungor; Onat,14,0,85,71
1656920820404,CSE 140L,A01,083088,Eldon; John,16,0,100,84
1656920826426,CSE 175,A01,083665,Kumar; Rakesh,3,0,25,22
1656920832449,CSE 190,A00,092507,Dubnov; Shlomo,7,0,20,13
1656920838474,ECE 45,A01,083139,Congero; Spencer William,5,0,75,70
1656920844498,ECE 65,A50,083695,Saad; Andrew S,12,0,30,18
1656920844498,ECE 65,A51,095125,Saad; Andrew S,25,0,26,1
1656920850525,ECE 109,A01,091882,Touri; Behrouz,16,0,70,54
1656920856548,ECE 180,A00,083140,Abi Samra; Nicholas Camill,0,0,30,30
1656920856548,ECE 180,B00,083141,Abi Samra; Nicholas Camill,0,0,30,30
1656920862574,MATH 10A,A01,083735,Patchell; Gregory David,1,0,30,29
1656920862574,MATH 10A,A02,083736,Patchell; Gregory David,20,0,30,10
1656920862574,MATH 10A,A03,083737,Patchell; Gregory David,15,0,30,15
1656920868598,MATH 10B,A01,083207,Lim; Seonhee,7,0,34,27
1656920868598,MATH 10B,A02,083208,Lim; Seonhee,9,0,35,26
1656920868598,MATH 10B,A03,093472,Lim; Seonhee,4,0,34,30
1656920868598,MATH 10B,B01,083739,Sinha; Shubham,9,0,30,21
1656920874624,MATH 18,A01,083743,Cinel; Cameron Alexander,6,0,30,24
1656920874624,MATH 18,A02,083744,Cinel; Cameron Alexander,15,0,30,15
1656920874624,MATH 18,A03,083745,Cinel; Cameron Alexander,8,0,30,22
1656920874624,MATH 18,B01,083748,Rideout; David Porter,4,0,37,33
1656920874624,MATH 18,B02,083749,Rideout; David Porter,3,0,36,33
1656920874624,MATH 18,B03,083750,Rideout; David Porter,2,0,37,35
1656920874624,MATH 18,B04,083751,Rideout; David Porter,5,0,36,31
1656920874624,MATH 18,B05,093473,Rideout; David Porter,4,0,36,32
1656920874624,MATH 18,B06,093474,Rideout; David Porter,5,0,36,31
1656920880650,MATH 20A,A01,083754,Zheng; Zequn,12,0,40,28
1656920886676,MATH 20B,A01,083756,Briones; Jor-el Thomas Caparas,1,0,36,35
1656920886676,MATH 20B,A02,083757,Briones; Jor-el Thomas Caparas,1,0,36,35
1656920886676,MATH 20B,A03,093475,Briones; Jor-el Thomas Caparas,0,0,36,36
1656920892699,MATH 20C,A01,083760,Briones; Jor-el Thomas Caparas,1,0,35,34
1656920892699,MATH 20C,A02,083761,Briones; Jor-el Thomas Caparas,8,0,35,27
1656920892699,MATH 20C,A03,093476,Briones; Jor-el Thomas Caparas,0,1,36,36
1656920892699,MATH 20C,B01,083762,Bach; Quang Tran,0,0,30,30
1656920898746,MATH 20D,A01,083765,Tran; Brian Kha,4,0,30,26
1656920898746,MATH 20D,A02,083766,Tran; Brian Kha,4,0,30,26
1656920898746,MATH 20D,A03,083767,Tran; Brian Kha,3,0,30,27
1656920904775,MATH 20E,A01,083771,Ganguly; Soumya,5,0,32,27
1656920904775,MATH 20E,A02,083772,Ganguly; Soumya,6,0,32,26
1656920904775,MATH 20E,B01,083773,Ciotti; Benjamin,18,0,35,17
1656920904775,MATH 20E,B02,083774,Ciotti; Benjamin,17,0,35,18
1656920910804,MATH 103A,A01,083777,Greenfeld; Be'Eri,2,0,36,34
1656920910804,MATH 103A,A02,083778,Greenfeld; Be'Eri,5,0,36,31
1656920910804,MATH 103A,A03,093561,Greenfeld; Be'Eri,4,0,36,32
1656920910804,MATH 103A,B01,083779,Greenfeld; Be'Eri,6,0,36,30
1656920910804,MATH 103A,B02,083780,Greenfeld; Be'Eri,2,0,36,34
1656920910804,MATH 103A,B03,093562,Greenfeld; Be'Eri,2,0,36,34
1656920916828,MATH 105,A01,085443,Carter; Anne Toulson,13,0,35,22
1656920916828,MATH 105,A02,093477,Carter; Anne Toulson,20,0,35,15
1656920922854,MATH 109,A01,083213,Ganzberger; Geoffrey Michael,2,0,34,32
1656920922854,MATH 109,A02,083214,Ganzberger; Geoffrey Michael,2,0,34,32
1656920922854,MATH 109,A03,093478,Ganzberger; Geoffrey Michael,1,0,34,33
1656920922854,MATH 109,B01,083215,Ganzberger; Geoffrey Michael,1,0,32,31
1656920922854,MATH 109,B02,083216,Ganzberger; Geoffrey Michael,1,0,32,31
1656920922854,MATH 109,B03,093479,Ganzberger; Geoffrey Michael,6,0,32,26
1656920928884,MATH 142A,A01,083219,Chow; Bennett,6,0,32,26
1656920928884,MATH 142A,A02,083220,Chow; Bennett,10,0,32,22
1656920928884,MATH 142A,A03,093480,Chow; Bennett,7,0,32,25
1656920928884,MATH 142A,B03,093481,Chow; Bennett,7,0,32,25
1656920928884,MATH 142A,B04,093558,Chow; Bennett,10,0,32,22
1656920928884,MATH 142A,B05,093559,Chow; Bennett,6,0,32,26
1656920934913,MATH 193A,A01,083224,Rotar; Vladimir,7,0,34,27
1656920934913,MATH 193A,A02,083225,Rotar; Vladimir,3,0,34,31
1656920934913,MATH 193A,A03,083781,Rotar; Vladimir,1,0,34,33
1656920934913,MATH 193A,A04,083782,Rotar; Vladimir,6,0,34,28
1656920934913,MATH 193A,A05,093482,Rotar; Vladimir,6,0,34,28
1656920940941,MATH 197,001,091859,McAuley; Julian John,9999,0,9999,0
1656920940941,MATH 197,002,095566,Kedlaya; Kiran S.,9997,0,9999,2
1656920940941,MATH 197,003,095567,Xiao; Ming,9999,0,9999,0
1656920940941,MATH 197,004,095571,Perols; Johan Lars,9998,0,9999,1
1656920947994,COGS 9,A01,083615,Shannon; Kyle Michael,7,0,75,68
1656920954020,COGS 11,A01,083617,Boyle; Mary E. T.,19,0,48,29
1656920960044,COGS 13,A01,083071,Bastos; Amalia Pinkusfeld,9,0,71,62
1656920966077,COGS 14A,A01,092681,Semenuks; Arturs,0,1,100,100
1656920972101,COGS 14B,A01,083073,Cheng; Tzu-Han,5,0,63,58
1656920978127,COGS 17,A01,092677,Semenuks; Arturs,4,0,81,77
1656920984152,COGS 100,A01,083619,Allen; Michael Gordon,15,0,70,55
1656920990177,COGS 101A,A01,083621,Davis; Joshua Daniel,9,0,68,59
1656920996201,COGS 101B,A01,091572,Allen; Michael Gordon,8,0,65,57
1656921002226,COGS 101C,A01,083625,Delgado; Tania,17,0,35,18
1656921008253,COGS 107A,A01,083627,Boyle; Mary E. T.,13,0,60,47
1656921014280,COGS 118A,A01,083075,Gupta; Anjum,15,0,76,61
1656921020305,CSE 3,A50,083646,Miranda; Gregory Joseph,22,0,50,28
1656921026326,CSE 8A,A50,083650,Miranda; Gregory Joseph,17,1,56,39
1656921032351,CSE 11,A01,083080,Cao; Yingjun,4,15,40,36
1656921038386,CSE 12,A01,083652,Krause-Levy; Sophia Louisa,20,1,120,100
1656921044419,CSE 15L,A01,083654,Morris; Justin Loren,8,0,50,42
1656921044419,CSE 15L,A02,083655,Morris; Justin Loren,8,0,50,42
1656921050444,CSE 20,A01,083657,Tran; Khoa Dang,37,0,80,43
1656921056473,CSE 21,A01,095574,Bach; Quang Tran,21,0,48,27
1656921062501,CSE 30,A01,083084,Eldon; John,4,0,80,76
1656921062501,CSE 30,B01,095061,Bhaskar; Nishant,6,0,50,44
1656921068525,CSE 100,A01,083659,Cao; Yingjun,3,4,70,67
1656921074554,CSE 134B,A01,083661,Powell; Thomas Allan,19,0,100,81
1656921080586,CSE 140,A01,083663,Gungor; Onat,14,0,85,71
1656921086613,CSE 140L,A01,083088,Eldon; John,16,0,100,84
1656921092641,CSE 175,A01,083665,Kumar; Rakesh,3,0,25,22
1656921098672,CSE 190,A00,092507,Dubnov; Shlomo,7,0,20,13
1656921104702,ECE 45,A01,083139,Congero; Spencer William,5,0,75,70
1656921110731,ECE 65,A50,083695,Saad; Andrew S,12,0,30,18
1656921110731,ECE 65,A51,095125,Saad; Andrew S,25,0,26,1
1656921116754,ECE 109,A01,091882,Touri; Behrouz,16,0,70,54
1656921122784,ECE 180,A00,083140,Abi Samra; Nicholas Camill,0,0,30,30
1656921122784,ECE 180,B00,083141,Abi Samra; Nicholas Camill,0,0,30,30
1656921128813,MATH 10A,A01,083735,Patchell; Gregory David,1,0,30,29
1656921128813,MATH 10A,A02,083736,Patchell; Gregory David,20,0,30,10
1656921128813,MATH 10A,A03,083737,Patchell; Gregory David,15,0,30,15
1656921134838,MATH 10B,A01,083207,Lim; Seonhee,7,0,34,27
1656921134838,MATH 10B,A02,083208,Lim; Seonhee,9,0,35,26
1656921134838,MATH 10B,A03,093472,Lim; Seonhee,4,0,34,30
1656921134838,MATH 10B,B01,083739,Sinha; Shubham,9,0,30,21
1656921140877,MATH 18,A01,083743,Cinel; Cameron Alexander,6,0,30,24
1656921140877,MATH 18,A02,083744,Cinel; Cameron Alexander,15,0,30,15
1656921140877,MATH 18,A03,083745,Cinel; Cameron Alexander,8,0,30,22
1656921140877,MATH 18,B01,083748,Rideout; David Porter,4,0,37,33
1656921140877,MATH 18,B02,083749,Rideout; David Porter,3,0,36,33
1656921140877,MATH 18,B03,083750,Rideout; David Porter,2,0,37,35
1656921140877,MATH 18,B04,083751,Rideout; David Porter,5,0,36,31
1656921140877,MATH 18,B05,093473,Rideout; David Porter,4,0,36,32
1656921140877,MATH 18,B06,093474,Rideout; David Porter,5,0,36,31
1656921146904,MATH 20A,A01,083754,Zheng; Zequn,12,0,40,28
1656921152929,MATH 20B,A01,083756,Briones; Jor-el Thomas Caparas,1,0,36,35
1656921152929,MATH 20B,A02,083757,Briones; Jor-el Thomas Caparas,1,0,36,35
1656921152929,MATH 20B,A03,093475,Briones; Jor-el Thomas Caparas,0,0,36,36
1656921158958,MATH 20C,A01,083760,Briones; Jor-el Thomas Caparas,1,0,35,34
1656921158958,MATH 20C,A02,083761,Briones; Jor-el Thomas Caparas,8,0,35,27
1656921158958,MATH 20C,A03,093476,Briones; Jor-el Thomas Caparas,0,1,36,36
1656921158958,MATH 20C,B01,083762,Bach; Quang Tran,0,0,30,30
1656921164988,MATH 20D,A01,083765,Tran; Brian Kha,4,0,30,26
1656921164988,MATH 20D,A02,083766,Tran; Brian Kha,4,0,30,26
1656921164988,MATH 20D,A03,083767,Tran; Brian Kha,3,0,30,27
1656921171014,MATH 20E,A01,083771,Ganguly; Soumya,5,0,32,27
1656921171014,MATH 20E,A02,083772,Ganguly; Soumya,6,0,32,26
1656921171014,MATH 20E,B01,083773,Ciotti; Benjamin,18,0,35,17
1656921171014,MATH 20E,B02,083774,Ciotti; Benjamin,17,0,35,18
1656921177048,MATH 103A,A01,083777,Greenfeld; Be'Eri,2,0,36,34
1656921177048,MATH 103A,A02,083778,Greenfeld; Be'Eri,5,0,36,31
1656921177048,MATH 103A,A03,093561,Greenfeld; Be'Eri,4,0,36,32
1656921177048,MATH 103A,B01,083779,Greenfeld; Be'Eri,6,0,36,30
1656921177048,MATH 103A,B02,083780,Greenfeld; Be'Eri,2,0,36,34
1656921177048,MATH 103A,B03,093562,Greenfeld; Be'Eri,2,0,36,34
1656921183077,MATH 105,A01,085443,Carter; Anne Toulson,13,0,35,22
1656921183077,MATH 105,A02,093477,Carter; Anne Toulson,20,0,35,15
1656921189107,MATH 109,A01,083213,Ganzberger; Geoffrey Michael,2,0,34,32
1656921189107,MATH 109,A02,083214,Ganzberger; Geoffrey Michael,2,0,34,32
1656921189107,MATH 109,A03,093478,Ganzberger; Geoffrey Michael,1,0,34,33
1656921189107,MATH 109,B01,083215,Ganzberger; Geoffrey Michael,1,0,32,31
1656921189107,MATH 109,B02,083216,Ganzberger; Geoffrey Michael,1,0,32,31
1656921189107,MATH 109,B03,093479,Ganzberger; Geoffrey Michael,6,0,32,26
1656921195137,MATH 142A,A01,083219,Chow; Bennett,6,0,32,26
1656921195137,MATH 142A,A02,083220,Chow; Bennett,10,0,32,22
1656921195137,MATH 142A,A03,093480,Chow; Bennett,7,0,32,25
1656921195137,MATH 142A,B03,093481,Chow; Bennett,7,0,32,25
1656921195137,MATH 142A,B04,093558,Chow; Bennett,10,0,32,22
1656921195137,MATH 142A,B05,093559,Chow; Bennett,6,0,32,26
1656921201164,MATH 193A,A01,083224,Rotar; Vladimir,7,0,34,27
1656921201164,MATH 193A,A02,083225,Rotar; Vladimir,3,0,34,31
1656921201164,MATH 193A,A03,083781,Rotar; Vladimir,1,0,34,33
1656921201164,MATH 193A,A04,083782,Rotar; Vladimir,6,0,34,28
1656921201164,MATH 193A,A05,093482,Rotar; Vladimir,6,0,34,28
1656921207189,MATH 197,001,091859,McAuley; Julian John,9999,0,9999,0
1656921207189,MATH 197,002,095566,Kedlaya; Kiran S.,9997,0,9999,2
1656921207189,MATH 197,003,095567,Xiao; Ming,9999,0,9999,0
1656921207189,MATH 197,004,095571,Perols; Johan Lars,9998,0,9999,1
1656921214243,COGS 9,A01,083615,Shannon; Kyle Michael,7,0,75,68
1656921220272,COGS 11,A01,083617,Boyle; Mary E. T.,19,0,48,29
1656921226300,COGS 13,A01,083071,Bastos; Amalia Pinkusfeld,9,0,71,62
1656921232324,COGS 14A,A01,092681,Semenuks; Arturs,0,1,100,100
1656921238352,COGS 14B,A01,083073,Cheng; Tzu-Han,5,0,63,58
1656921244375,COGS 17,A01,092677,Semenuks; Arturs,4,0,81,77
1656921250397,COGS 100,A01,083619,Allen; Michael Gordon,15,0,70,55
1656921256428,COGS 101A,A01,083621,Davis; Joshua Daniel,9,0,68,59
1656921262452,COGS 101B,A01,091572,Allen; Michael Gordon,8,0,65,57
1656921268476,COGS 101C,A01,083625,Delgado; Tania,17,0,35,18
1656921274589,COGS 107A,A01,083627,Boyle; Mary E. T.,13,0,60,47
1656921280614,COGS 118A,A01,083075,Gupta; Anjum,15,0,76,61
1656921286639,CSE 3,A50,083646,Miranda; Gregory Joseph,22,0,50,28
1656921292666,CSE 8A,A50,083650,Miranda; Gregory Joseph,17,1,56,39
1656921298692,CSE 11,A01,083080,Cao; Yingjun,4,15,40,36
1656921304715,CSE 12,A01,083652,Krause-Levy; Sophia Louisa,20,1,120,100
1656921310740,CSE 15L,A01,083654,Morris; Justin Loren,8,0,50,42
1656921310740,CSE 15L,A02,083655,Morris; Justin Loren,8,0,50,42
1656921316767,CSE 20,A01,083657,Tran; Khoa Dang,37,0,80,43
1656921322790,CSE 21,A01,095574,Bach; Quang Tran,21,0,48,27
1656921328813,CSE 30,A01,083084,Eldon; John,4,0,80,76
1656921328813,CSE 30,B01,095061,Bhaskar; Nishant,6,0,50,44
1656921334835,CSE 100,A01,083659,Cao; Yingjun,3,4,70,67
1656921340857,CSE 134B,A01,083661,Powell; Thomas Allan,19,0,100,81
1656921346885,CSE 140,A01,083663,Gungor; Onat,14,0,85,71
1656921352907,CSE 140L,A01,083088,Eldon; John,16,0,100,84
1656921358931,CSE 175,A01,083665,Kumar; Rakesh,3,0,25,22
1656921364957,CSE 190,A00,092507,Dubnov; Shlomo,7,0,20,13
1656921370981,ECE 45,A01,083139,Congero; Spencer William,5,0,75,70
1656921377007,ECE 65,A50,083695,Saad; Andrew S,12,0,30,18
1656921377007,ECE 65,A51,095125,Saad; Andrew S,25,0,26,1
1656921383030,ECE 109,A01,091882,Touri; Behrouz,16,0,70,54
1656921389053,ECE 180,A00,083140,Abi Samra; Nicholas Camill,0,0,30,30
1656921389053,ECE 180,B00,083141,Abi Samra; Nicholas Camill,0,0,30,30
1656921395081,MATH 10A,A01,083735,Patchell; Gregory David,1,0,30,29
1656921395081,MATH 10A,A02,083736,Patchell; Gregory David,20,0,30,10
1656921395081,MATH 10A,A03,083737,Patchell; Gregory David,15,0,30,15
1656921401104,MATH 10B,A01,083207,Lim; Seonhee,7,0,34,27
1656921401104,MATH 10B,A02,083208,Lim; Seonhee,9,0,35,26
1656921401104,MATH 10B,A03,093472,Lim; Seonhee,4,0,34,30
1656921401104,MATH 10B,B01,083739,Sinha; Shubham,9,0,30,21
1656921407136,MATH 18,A01,083743,Cinel; Cameron Alexander,6,0,30,24
1656921407136,MATH 18,A02,083744,Cinel; Cameron Alexander,15,0,30,15
1656921407136,MATH 18,A03,083745,Cinel; Cameron Alexander,8,0,30,22
1656921407136,MATH 18,B01,083748,Rideout; David Porter,4,0,37,33
1656921407136,MATH 18,B02,083749,Rideout; David Porter,3,0,36,33
1656921407136,MATH 18,B03,083750,Rideout; David Porter,2,0,37,35
1656921407136,MATH 18,B04,083751,Rideout; David Porter,5,0,36,31
1656921407136,MATH 18,B05,093473,Rideout; David Porter,4,0,36,32
1656921407136,MATH 18,B06,093474,Rideout; David Porter,5,0,36,31
1656921413159,MATH 20A,A01,083754,Zheng; Zequn,12,0,40,28
1656921419185,MATH 20B,A01,083756,Briones; Jor-el Thomas Caparas,1,0,36,35
1656921419185,MATH 20B,A02,083757,Briones; Jor-el Thomas Caparas,1,0,36,35
1656921419185,MATH 20B,A03,093475,Briones; Jor-el Thomas Caparas,0,0,36,36
1656921425211,MATH 20C,A01,083760,Briones; Jor-el Thomas Caparas,1,0,35,34
1656921425211,MATH 20C,A02,083761,Briones; Jor-el Thomas Caparas,8,0,35,27
1656921425211,MATH 20C,A03,093476,Briones; Jor-el Thomas Caparas,0,1,36,36
1656921425211,MATH 20C,B01,083762,Bach; Quang Tran,0,0,30,30
1656921431236,MATH 20D,A01,083765,Tran; Brian Kha,4,0,30,26
1656921431236,MATH 20D,A02,083766,Tran; Brian Kha,4,0,30,26
1656921431236,MATH 20D,A03,083767,Tran; Brian Kha,3,0,30,27
1656921437260,MATH 20E,A01,083771,Ganguly; Soumya,5,0,32,27
1656921437260,MATH 20E,A02,083772,Ganguly; Soumya,6,0,32,26
1656921437260,MATH 20E,B01,083773,Ciotti; Benjamin,18,0,35,17
1656921437260,MATH 20E,B02,083774,Ciotti; Benjamin,17,0,35,18
1656921443289,MATH 103A,A01,083777,Greenfeld; Be'Eri,2,0,36,34
1656921443289,MATH 103A,A02,083778,Greenfeld; Be'Eri,5,0,36,31
1656921443289,MATH 103A,A03,093561,Greenfeld; Be'Eri,4,0,36,32
1656921443289,MATH 103A,B01,083779,Greenfeld; Be'Eri,6,0,36,30
1656921443289,MATH 103A,B02,083780,Greenfeld; Be'Eri,2,0,36,34
1656921443289,MATH 103A,B03,093562,Greenfeld; Be'Eri,2,0,36,34
1656921449313,MATH 105,A01,085443,Carter; Anne Toulson,13,0,35,22
1656921449313,MATH 105,A02,093477,Carter; Anne Toulson,20,0,35,15
1656921455337,MATH 109,A01,083213,Ganzberger; Geoffrey Michael,2,0,34,32
1656921455337,MATH 109,A02,083214,Ganzberger; Geoffrey Michael,2,0,34,32
1656921455337,MATH 109,A03,093478,Ganzberger; Geoffrey Michael,1,0,34,33
1656921455337,MATH 109,B01,083215,Ganzberger; Geoffrey Michael,1,0,32,31
1656921455337,MATH 109,B02,083216,Ganzberger; Geoffrey Michael,1,0,32,31
1656921455337,MATH 109,B03,093479,Ganzberger; Geoffrey Michael,6,0,32,26
1656921461365,MATH 142A,A01,083219,Chow; Bennett,6,0,32,26
1656921461365,MATH 142A,A02,083220,Chow; Bennett,10,0,32,22
1656921461365,MATH 142A,A03,093480,Chow; Bennett,7,0,32,25
1656921461365,MATH 142A,B03,093481,Chow; Bennett,7,0,32,25
1656921461365,MATH 142A,B04,093558,Chow; Bennett,10,0,32,22
1656921461365,MATH 142A,B05,093559,Chow; Bennett,6,0,32,26
1656921467394,MATH 193A,A01,083224,Rotar; Vladimir,7,0,34,27
1656921467394,MATH 193A,A02,083225,Rotar; Vladimir,3,0,34,31
1656921467394,MATH 193A,A03,083781,Rotar; Vladimir,1,0,34,33
1656921467394,MATH 193A,A04,083782,Rotar; Vladimir,6,0,34,28
1656921467394,MATH 193A,A05,093482,Rotar; Vladimir,6,0,34,28
1656921473420,MATH 197,001,091859,McAuley; Julian John,9999,0,9999,0
1656921473420,MATH 197,002,095566,Kedlaya; Kiran S.,9997,0,9999,2
1656921473420,MATH 197,003,095567,Xiao; Ming,9999,0,9999,0
1656921473420,MATH 197,004,095571,Perols; Johan Lars,9998,0,9999,1
1656921480487,COGS 9,A01,083615,Shannon; Kyle Michael,7,0,75,68
1656921486510,COGS 11,A01,083617,Boyle; Mary E. T.,19,0,48,29
1656921492536,COGS 13,A01,083071,Bastos; Amalia Pinkusfeld,9,0,71,62
1656921498557,COGS 14A,A01,092681,Semenuks; Arturs,0,1,100,100
1656921504585,COGS 14B,A01,083073,Cheng; Tzu-Han,5,0,63,58
1656921510613,COGS 17,A01,092677,Semenuks; Arturs,4,0,81,77
1656921516634,COGS 100,A01,083619,Allen; Michael Gordon,15,0,70,55
1656921522668,COGS 101A,A01,083621,Davis; Joshua Daniel,9,0,68,59
1656921528710,COGS 101B,A01,091572,Allen; Michael Gordon,8,0,65,57
1656921534732,COGS 101C,A01,083625,Delgado; Tania,17,0,35,18
1656921540756,COGS 107A,A01,083627,Boyle; Mary E. T.,13,0,60,47
1656921546788,COGS 118A,A01,083075,Gupta; Anjum,15,0,76,61
1656921552817,CSE 3,A50,083646,Miranda; Gregory Joseph,22,0,50,28
1656921558840,CSE 8A,A50,083650,Miranda; Gregory Joseph,17,1,56,39
1656921564863,CSE 11,A01,083080,Cao; Yingjun,4,15,40,36
1656921570887,CSE 12,A01,083652,Krause-Levy; Sophia Louisa,20,1,120,100
1656921576914,CSE 15L,A01,083654,Morris; Justin Loren,8,0,50,42
1656921576914,CSE 15L,A02,083655,Morris; Justin Loren,8,0,50,42
1656921582942,CSE 20,A01,083657,Tran; Khoa Dang,37,0,80,43
1656921588965,CSE 21,A01,095574,Bach; Quang Tran,21,0,48,27
1656921594990,CSE 30,A01,083084,Eldon; John,4,0,80,76
1656921594990,CSE 30,B01,095061,Bhaskar; Nishant,6,0,50,44
1656921601014,CSE 100,A01,083659,Cao; Yingjun,3,4,70,67
1656921607037,CSE 134B,A01,083661,Powell; Thomas Allan,19,0,100,81
1656921613059,CSE 140,A01,083663,Gungor; Onat,14,0,85,71
1656921619089,CSE 140L,A01,083088,Eldon; John,16,0,100,84
1656921625112,CSE 175,A01,083665,Kumar; Rakesh,3,0,25,22
1656921631138,CSE 190,A00,092507,Dubnov; Shlomo,7,0,20,13
1656921637160,ECE 45,A01,083139,Congero; Spencer William,5,0,75,70
1656921643183,ECE 65,A50,083695,Saad; Andrew S,12,0,30,18
1656921643183,ECE 65,A51,095125,Saad; Andrew S,25,0,26,1
1656921649206,ECE 109,A01,091882,Touri; Behrouz,16,0,70,54
1656921655232,ECE 180,A00,083140,Abi Samra; Nicholas Camill,0,0,30,30
1656921655232,ECE 180,B00,083141,Abi Samra; Nicholas Camill,0,0,30,30
1656921661258,MATH 10A,A01,083735,Patchell; Gregory David,1,0,30,29
1656921661258,MATH 10A,A02,083736,Patchell; Gregory David,20,0,30,10
1656921661258,MATH 10A,A03,083737,Patchell; Gregory David,15,0,30,15
1656921667282,MATH 10B,A01,083207,Lim; Seonhee,7,0,34,27
1656921667282,MATH 10B,A02,083208,Lim; Seonhee,9,0,35,26
1656921667282,MATH 10B,A03,093472,Lim; Seonhee,4,0,34,30
1656921667282,MATH 10B,B01,083739,Sinha; Shubham,9,0,30,21
1656921673307,MATH 18,A01,083743,Cinel; Cameron Alexander,6,0,30,24
1656921673307,MATH 18,A02,083744,Cinel; Cameron Alexander,15,0,30,15
1656921673307,MATH 18,A03,083745,Cinel; Cameron Alexander,8,0,30,22
1656921673307,MATH 18,B01,083748,Rideout; David Porter,4,0,37,33
1656921673307,MATH 18,B02,083749,Rideout; David Porter,3,0,36,33
1656921673307,MATH 18,B03,083750,Rideout; David Porter,2,0,37,35
1656921673307,MATH 18,B04,083751,Rideout; David Porter,5,0,36,31
1656921673307,MATH 18,B05,093473,Rideout; David Porter,4,0,36,32
1656921673307,MATH 18,B06,093474,Rideout; David Porter,5,0,36,31
1656921679335,MATH 20A,A01,083754,Zheng; Zequn,12,0,40,28
1656921685362,MATH 20B,A01,083756,Briones; Jor-el Thomas Caparas,1,0,36,35
1656921685362,MATH 20B,A02,083757,Briones; Jor-el Thomas Caparas,1,0,36,35
1656921685362,MATH 20B,A03,093475,Briones; Jor-el Thomas Caparas,0,0,36,36
1656921691390,MATH 20C,A01,083760,Briones; Jor-el Thomas Caparas,1,0,35,34
1656921691390,MATH 20C,A02,083761,Briones; Jor-el Thomas Caparas,8,0,35,27
1656921691390,MATH 20C,A03,093476,Briones; Jor-el Thomas Caparas,0,1,36,36
1656921691390,MATH 20C,B01,083762,Bach; Quang Tran,0,0,30,30
1656921697414,MATH 20D,A01,083765,Tran; Brian Kha,4,0,30,26
1656921697414,MATH 20D,A02,083766,Tran; Brian Kha,4,0,30,26
1656921697414,MATH 20D,A03,083767,Tran; Brian Kha,3,0,30,27
1656921703441,MATH 20E,A01,083771,Ganguly; Soumya,5,0,32,27
1656921703441,MATH 20E,A02,083772,Ganguly; Soumya,6,0,32,26
1656921703441,MATH 20E,B01,083773,Ciotti; Benjamin,18,0,35,17
1656921703441,MATH 20E,B02,083774,Ciotti; Benjamin,17,0,35,18
1656921709465,MATH 103A,A01,083777,Greenfeld; Be'Eri,2,0,36,34
1656921709465,MATH 103A,A02,083778,Greenfeld; Be'Eri,5,0,36,31
1656921709465,MATH 103A,A03,093561,Greenfeld; Be'Eri,4,0,36,32
1656921709465,MATH 103A,B01,083779,Greenfeld; Be'Eri,6,0,36,30
1656921709465,MATH 103A,B02,083780,Greenfeld; Be'Eri,2,0,36,34
1656921709465,MATH 103A,B03,093562,Greenfeld; Be'Eri,2,0,36,34
1656921715493,MATH 105,A01,085443,Carter; Anne Toulson,13,0,35,22
1656921715493,MATH 105,A02,093477,Carter; Anne Toulson,20,0,35,15
1656921721520,MATH 109,A01,083213,Ganzberger; Geoffrey Michael,2,0,34,32
1656921721520,MATH 109,A02,083214,Ganzberger; Geoffrey Michael,2,0,34,32
1656921721520,MATH 109,A03,093478,Ganzberger; Geoffrey Michael,1,0,34,33
1656921721520,MATH 109,B01,083215,Ganzberger; Geoffrey Michael,1,0,32,31
1656921721520,MATH 109,B02,083216,Ganzberger; Geoffrey Michael,1,0,32,31
1656921721520,MATH 109,B03,093479,Ganzberger; Geoffrey Michael,6,0,32,26
1656921727543,MATH 142A,A01,083219,Chow; Bennett,6,0,32,26
1656921727543,MATH 142A,A02,083220,Chow; Bennett,10,0,32,22
1656921727543,MATH 142A,A03,093480,Chow; Bennett,7,0,32,25
1656921727543,MATH 142A,B03,093481,Chow; Bennett,7,0,32,25
1656921727543,MATH 142A,B04,093558,Chow; Bennett,11,0,32,21
1656921727543,MATH 142A,B05,093559,Chow; Bennett,6,0,32,26
1656921733571,MATH 193A,A01,083224,Rotar; Vladimir,7,0,34,27
1656921733571,MATH 193A,A02,083225,Rotar; Vladimir,3,0,34,31
1656921733571,MATH 193A,A03,083781,Rotar; Vladimir,1,0,34,33
1656921733571,MATH 193A,A04,083782,Rotar; Vladimir,6,0,34,28
1656921733571,MATH 193A,A05,093482,Rotar; Vladimir,6,0,34,28
1656921739599,MATH 197,001,091859,McAuley; Julian John,9999,0,9999,0
1656921739599,MATH 197,002,095566,Kedlaya; Kiran S.,9997,0,9999,2
1656921739599,MATH 197,003,095567,Xiao; Ming,9999,0,9999,0
1656921739599,MATH 197,004,095571,Perols; Johan Lars,9998,0,9999,1
1656921746655,COGS 9,A01,083615,Shannon; Kyle Michael,7,0,75,68
1656921752679,COGS 11,A01,083617,Boyle; Mary E. T.,19,0,48,29
1656921758701,COGS 13,A01,083071,Bastos; Amalia Pinkusfeld,9,0,71,62
1656921764727,COGS 14A,A01,092681,Semenuks; Arturs,0,1,100,100
1656921770753,COGS 14B,A01,083073,Cheng; Tzu-Han,5,0,63,58
1656921776778,COGS 17,A01,092677,Semenuks; Arturs,4,0,81,77
1656921782802,COGS 100,A01,083619,Allen; Michael Gordon,15,0,70,55
1656921788825,COGS 101A,A01,083621,Davis; Joshua Daniel,9,0,68,59
1656921794847,COGS 101B,A01,091572,Allen; Michael Gordon,8,0,65,57
1656921800874,COGS 101C,A01,083625,Delgado; Tania,17,0,35,18
1656921806897,COGS 107A,A01,083627,Boyle; Mary E. T.,13,0,60,47
1656921812924,COGS 118A,A01,083075,Gupta; Anjum,15,0,76,61
1656921818949,CSE 3,A50,083646,Miranda; Gregory Joseph,22,0,50,28
1656921824977,CSE 8A,A50,083650,Miranda; Gregory Joseph,17,1,56,39
1656921831002,CSE 11,A01,083080,Cao; Yingjun,4,15,40,36
1656921837027,CSE 12,A01,083652,Krause-Levy; Sophia Louisa,20,1,120,100
1656921843049,CSE 15L,A01,083654,Morris; Justin Loren,8,0,50,42
1656921843049,CSE 15L,A02,083655,Morris; Justin Loren,8,0,50,42
1656921849073,CSE 20,A01,083657,Tran; Khoa Dang,37,0,80,43
1656921855097,CSE 21,A01,095574,Bach; Quang Tran,21,0,48,27
1656921861121,CSE 30,A01,083084,Eldon; John,4,0,80,76
1656921861121,CSE 30,B01,095061,Bhaskar; Nishant,6,0,50,44
1656921867148,CSE 100,A01,083659,Cao; Yingjun,3,4,70,67
1656921873250,CSE 134B,A01,083661,Powell; Thomas Allan,19,0,100,81
1656921879273,CSE 140,A01,083663,Gungor; Onat,14,0,85,71
1656921885298,CSE 140L,A01,083088,Eldon; John,16,0,100,84
1656921891326,CSE 175,A01,083665,Kumar; Rakesh,3,0,25,22
1656921897359,CSE 190,A00,092507,Dubnov; Shlomo,7,0,20,13
1656921903388,ECE 45,A01,083139,Congero; Spencer William,5,0,75,70
1656921909411,ECE 65,A50,083695,Saad; Andrew S,12,0,30,18
1656921909411,ECE 65,A51,095125,Saad; Andrew S,25,0,26,1
1656921915451,ECE 109,A01,091882,Touri; Behrouz,16,0,70,54
1656921921475,ECE 180,A00,083140,Abi Samra; Nicholas Camill,0,0,30,30
1656921921475,ECE 180,B00,083141,Abi Samra; Nicholas Camill,0,0,30,30
1656921927507,MATH 10A,A01,083735,Patchell; Gregory David,1,0,30,29
1656921927507,MATH 10A,A02,083736,Patchell; Gregory David,20,0,30,10
1656921927507,MATH 10A,A03,083737,Patchell; Gregory David,15,0,30,15
1656921933533,MATH 10B,A01,083207,Lim; Seonhee,7,0,34,27
1656921933533,MATH 10B,A02,083208,Lim; Seonhee,9,0,35,26
1656921933533,MATH 10B,A03,093472,Lim; Seonhee,4,0,34,30
1656921933533,MATH 10B,B01,083739,Sinha; Shubham,9,0,30,21
1656921939557,MATH 18,A01,083743,Cinel; Cameron Alexander,6,0,30,24
1656921939557,MATH 18,A02,083744,Cinel; Cameron Alexander,15,0,30,15
1656921939557,MATH 18,A03,083745,Cinel; Cameron Alexander,8,0,30,22
1656921939557,MATH 18,B01,083748,Rideout; David Porter,4,0,37,33
1656921939557,MATH 18,B02,083749,Rideout; David Porter,3,0,36,33
1656921939557,MATH 18,B03,083750,Rideout; David Porter,2,0,37,35
1656921939557,MATH 18,B04,083751,Rideout; David Porter,5,0,36,31
1656921939557,MATH 18,B05,093473,Rideout; David Porter,4,0,36,32
1656921939557,MATH 18,B06,093474,Rideout; David Porter,5,0,36,31
1656921945582,MATH 20A,A01,083754,Zheng; Zequn,12,0,40,28
1656921951607,MATH 20B,A01,083756,Briones; Jor-el Thomas Caparas,1,0,36,35
1656921951607,MATH 20B,A02,083757,Briones; Jor-el Thomas Caparas,1,0,36,35
1656921951607,MATH 20B,A03,093475,Briones; Jor-el Thomas Caparas,0,0,36,36
1656921957639,MATH 20C,A01,083760,Briones; Jor-el Thomas Caparas,1,0,35,34
1656921957639,MATH 20C,A02,083761,Briones; Jor-el Thomas Caparas,8,0,35,27
1656921957639,MATH 20C,A03,093476,Briones; Jor-el Thomas Caparas,0,1,36,36
1656921957639,MATH 20C,B01,083762,Bach; Quang Tran,0,0,30,30
1656921963668,MATH 20D,A01,083765,Tran; Brian Kha,4,0,30,26
1656921963668,MATH 20D,A02,083766,Tran; Brian Kha,4,0,30,26
1656921963668,MATH 20D,A03,083767,Tran; Brian Kha,3,0,30,27
1656921969695,MATH 20E,A01,083771,Ganguly; Soumya,5,0,32,27
1656921969695,MATH 20E,A02,083772,Ganguly; Soumya,6,0,32,26
1656921969695,MATH 20E,B01,083773,Ciotti; Benjamin,18,0,35,17
1656921969695,MATH 20E,B02,083774,Ciotti; Benjamin,17,0,35,18
1656921975719,MATH 103A,A01,083777,Greenfeld; Be'Eri,2,0,36,34
1656921975719,MATH 103A,A02,083778,Greenfeld; Be'Eri,5,0,36,31
1656921975719,MATH 103A,A03,093561,Greenfeld; Be'Eri,4,0,36,32
1656921975719,MATH 103A,B01,083779,Greenfeld; Be'Eri,6,0,36,30
1656921975719,MATH 103A,B02,083780,Greenfeld; Be'Eri,2,0,36,34
1656921975719,MATH 103A,B03,093562,Greenfeld; Be'Eri,2,0,36,34
1656921981750,MATH 105,A01,085443,Carter; Anne Toulson,13,0,35,22
1656921981750,MATH 105,A02,093477,Carter; Anne Toulson,20,0,35,15
1656921987776,MATH 109,A01,083213,Ganzberger; Geoffrey Michael,2,0,34,32
1656921987776,MATH 109,A02,083214,Ganzberger; Geoffrey Michael,2,0,34,32
1656921987776,MATH 109,A03,093478,Ganzberger; Geoffrey Michael,1,0,34,33
1656921987776,MATH 109,B01,083215,Ganzberger; Geoffrey Michael,1,0,32,31
1656921987776,MATH 109,B02,083216,Ganzberger; Geoffrey Michael,1,0,32,31
1656921987776,MATH 109,B03,093479,Ganzberger; Geoffrey Michael,6,0,32,26
1656921993812,MATH 142A,A01,083219,Chow; Bennett,6,0,32,26
1656921993812,MATH 142A,A02,083220,Chow; Bennett,10,0,32,22
1656921993812,MATH 142A,A03,093480,Chow; Bennett,7,0,32,25
1656921993812,MATH 142A,B03,093481,Chow; Bennett,7,0,32,25
1656921993812,MATH 142A,B04,093558,Chow; Bennett,11,0,32,21
1656921993812,MATH 142A,B05,093559,Chow; Bennett,6,0,32,26
1656921999850,MATH 193A,A01,083224,Rotar; Vladimir,7,0,34,27
1656921999850,MATH 193A,A02,083225,Rotar; Vladimir,3,0,34,31
1656921999850,MATH 193A,A03,083781,Rotar; Vladimir,1,0,34,33
1656921999850,MATH 193A,A04,083782,Rotar; Vladimir,6,0,34,28
1656921999850,MATH 193A,A05,093482,Rotar; Vladimir,6,0,34,28
1656922005891,MATH 197,001,091859,McAuley; Julian John,9999,0,9999,0
1656922005891,MATH 197,002,095566,Kedlaya; Kiran S.,9997,0,9999,2
1656922005891,MATH 197,003,095567,Xiao; Ming,9999,0,9999,0
1656922005891,MATH 197,004,095571,Perols; Johan Lars,9998,0,9999,1
1656922013034,COGS 9,A01,083615,Shannon; Kyle Michael,7,0,75,68
1656922019064,COGS 11,A01,083617,Boyle; Mary E. T.,19,0,48,29
1656922025095,COGS 13,A01,083071,Bastos; Amalia Pinkusfeld,9,0,71,62
1656922031125,COGS 14A,A01,092681,Semenuks; Arturs,0,1,100,100
1656922037150,COGS 14B,A01,083073,Cheng; Tzu-Han,5,0,63,58
1656922043185,COGS 17,A01,092677,Semenuks; Arturs,4,0,81,77
1656922049212,COGS 100,A01,083619,Allen; Michael Gordon,15,0,70,55
1656922055247,COGS 101A,A01,083621,Davis; Joshua Daniel,9,0,68,59
1656922061276,COGS 101B,A01,091572,Allen; Michael Gordon,8,0,65,57
1656922067302,COGS 101C,A01,083625,Delgado; Tania,17,0,35,18
1656922073328,COGS 107A,A01,083627,Boyle; Mary E. T.,13,0,60,47
1656922079354,COGS 118A,A01,083075,Gupta; Anjum,15,0,76,61
1656922085394,CSE 3,A50,083646,Miranda; Gregory Joseph,22,0,50,28
1656922091422,CSE 8A,A50,083650,Miranda; Gregory Joseph,17,1,56,39
1656922097449,CSE 11,A01,083080,Cao; Yingjun,4,15,40,36
1656922103477,CSE 12,A01,083652,Krause-Levy; Sophia Louisa,20,1,120,100
1656922109509,CSE 15L,A01,083654,Morris; Justin Loren,8,0,50,42
1656922109509,CSE 15L,A02,083655,Morris; Justin Loren,8,0,50,42
1656922115546,CSE 20,A01,083657,Tran; Khoa Dang,37,0,80,43
1656922121570,CSE 21,A01,095574,Bach; Quang Tran,21,0,48,27
1656922127598,CSE 30,A01,083084,Eldon; John,4,0,80,76
1656922127598,CSE 30,B01,095061,Bhaskar; Nishant,6,0,50,44
1656922133630,CSE 100,A01,083659,Cao; Yingjun,3,4,70,67
1656922139659,CSE 134B,A01,083661,Powell; Thomas Allan,19,0,100,81
1656922145682,CSE 140,A01,083663,Gungor; Onat,14,0,85,71
1656922151714,CSE 140L,A01,083088,Eldon; John,16,0,100,84
1656922157782,CSE 175,A01,083665,Kumar; Rakesh,3,0,25,22
1656922163821,CSE 190,A00,092507,Dubnov; Shlomo,7,0,20,13
1656922169847,ECE 45,A01,083139,Congero; Spencer William,5,0,75,70
1656922175880,ECE 65,A50,083695,Saad; Andrew S,12,0,30,18
1656922175880,ECE 65,A51,095125,Saad; Andrew S,25,0,26,1
1656922181911,ECE 109,A01,091882,Touri; Behrouz,16,0,70,54
1656922188023,ECE 180,A00,083140,Abi Samra; Nicholas Camill,0,0,30,30
1656922188023,ECE 180,B00,083141,Abi Samra; Nicholas Camill,0,0,30,30
1656922194082,MATH 10A,A01,083735,Patchell; Gregory David,1,0,30,29
1656922194082,MATH 10A,A02,083736,Patchell; Gregory David,20,0,30,10
1656922194082,MATH 10A,A03,083737,Patchell; Gregory David,15,0,30,15
1656922200133,MATH 10B,A01,083207,Lim; Seonhee,7,0,34,27
1656922200133,MATH 10B,A02,083208,Lim; Seonhee,9,0,35,26
1656922200133,MATH 10B,A03,093472,Lim; Seonhee,4,0,34,30
1656922200133,MATH 10B,B01,083739,Sinha; Shubham,9,0,30,21
1656922206172,MATH 18,A01,083743,Cinel; Cameron Alexander,6,0,30,24
1656922206172,MATH 18,A02,083744,Cinel; Cameron Alexander,15,0,30,15
1656922206172,MATH 18,A03,083745,Cinel; Cameron Alexander,8,0,30,22
1656922206172,MATH 18,B01,083748,Rideout; David Porter,4,0,37,33
1656922206172,MATH 18,B02,083749,Rideout; David Porter,3,0,36,33
1656922206172,MATH 18,B03,083750,Rideout; David Porter,2,0,37,35
1656922206172,MATH 18,B04,083751,Rideout; David Porter,5,0,36,31
1656922206172,MATH 18,B05,093473,Rideout; David Porter,4,0,36,32
1656922206172,MATH 18,B06,093474,Rideout; David Porter,5,0,36,31
1656922212198,MATH 20A,A01,083754,Zheng; Zequn,12,0,40,28
1656922218238,MATH 20B,A01,083756,Briones; Jor-el Thomas Caparas,1,0,36,35
1656922218238,MATH 20B,A02,083757,Briones; Jor-el Thomas Caparas,1,0,36,35
1656922218238,MATH 20B,A03,093475,Briones; Jor-el Thomas Caparas,0,0,36,36
1656922224265,MATH 20C,A01,083760,Briones; Jor-el Thomas Caparas,1,0,35,34
1656922224265,MATH 20C,A02,083761,Briones; Jor-el Thomas Caparas,8,0,35,27
1656922224265,MATH 20C,A03,093476,Briones; Jor-el Thomas Caparas,0,1,36,36
1656922224265,MATH 20C,B01,083762,Bach; Quang Tran,0,0,30,30
1656922230293,MATH 20D,A01,083765,Tran; Brian Kha,4,0,30,26
1656922230293,MATH 20D,A02,083766,Tran; Brian Kha,4,0,30,26
1656922230293,MATH 20D,A03,083767,Tran; Brian Kha,3,0,30,27
1656922236330,MATH 20E,A01,083771,Ganguly; Soumya,5,0,32,27
1656922236330,MATH 20E,A02,083772,Ganguly; Soumya,6,0,32,26
1656922236330,MATH 20E,B01,083773,Ciotti; Benjamin,18,0,35,17
1656922236330,MATH 20E,B02,083774,Ciotti; Benjamin,17,0,35,18
1656922242358,MATH 103A,A01,083777,Greenfeld; Be'Eri,2,0,36,34
1656922242358,MATH 103A,A02,083778,Greenfeld; Be'Eri,5,0,36,31
1656922242358,MATH 103A,A03,093561,Greenfeld; Be'Eri,4,0,36,32
1656922242358,MATH 103A,B01,083779,Greenfeld; Be'Eri,6,0,36,30
1656922242358,MATH 103A,B02,083780,Greenfeld; Be'Eri,2,0,36,34
1656922242358,MATH 103A,B03,093562,Greenfeld; Be'Eri,2,0,36,34
1656922248383,MATH 105,A01,085443,Carter; Anne Toulson,13,0,35,22
1656922248383,MATH 105,A02,093477,Carter; Anne Toulson,20,0,35,15
1656922254410,MATH 109,A01,083213,Ganzberger; Geoffrey Michael,2,0,34,32
1656922254410,MATH 109,A02,083214,Ganzberger; Geoffrey Michael,2,0,34,32
1656922254410,MATH 109,A03,093478,Ganzberger; Geoffrey Michael,1,0,34,33
1656922254410,MATH 109,B01,083215,Ganzberger; Geoffrey Michael,1,0,32,31
1656922254410,MATH 109,B02,083216,Ganzberger; Geoffrey Michael,1,0,32,31
1656922254410,MATH 109,B03,093479,Ganzberger; Geoffrey Michael,6,0,32,26
1656922260442,MATH 142A,A01,083219,Chow; Bennett,6,0,32,26
1656922260442,MATH 142A,A02,083220,Chow; Bennett,10,0,32,22
1656922260442,MATH 142A,A03,093480,Chow; Bennett,7,0,32,25
1656922260442,MATH 142A,B03,093481,Chow; Bennett,7,0,32,25
1656922260442,MATH 142A,B04,093558,Chow; Bennett,11,0,32,21
1656922260442,MATH 142A,B05,093559,Chow; Bennett,6,0,32,26
1656922266474,MATH 193A,A01,083224,Rotar; Vladimir,7,0,34,27
1656922266474,MATH 193A,A02,083225,Rotar; Vladimir,3,0,34,31
1656922266474,MATH 193A,A03,083781,Rotar; Vladimir,1,0,34,33
1656922266474,MATH 193A,A04,083782,Rotar; Vladimir,6,0,34,28
1656922266474,MATH 193A,A05,093482,Rotar; Vladimir,6,0,34,28
1656922272498,MATH 197,001,091859,McAuley; Julian John,9999,0,9999,0
1656922272498,MATH 197,002,095566,Kedlaya; Kiran S.,9997,0,9999,2
1656922272498,MATH 197,003,095567,Xiao; Ming,9999,0,9999,0
1656922272498,MATH 197,004,095571,Perols; Johan Lars,9998,0,9999,1
1656922279567,COGS 9,A01,083615,Shannon; Kyle Michael,7,0,75,68
1656922285596,COGS 11,A01,083617,Boyle; Mary E. T.,19,0,48,29
1656922291631,COGS 13,A01,083071,Bastos; Amalia Pinkusfeld,9,0,71,62
1656922297658,COGS 14A,A01,092681,Semenuks; Arturs,0,1,100,100
1656922303684,COGS 14B,A01,083073,Cheng; Tzu-Han,5,0,63,58
1656922309712,COGS 17,A01,092677,Semenuks; Arturs,4,0,81,77
1656922315735,COGS 100,A01,083619,Allen; Michael Gordon,15,0,70,55
1656922321760,COGS 101A,A01,083621,Davis; Joshua Daniel,9,0,68,59
1656922327784,COGS 101B,A01,091572,Allen; Michael Gordon,8,0,65,57
1656922333809,COGS 101C,A01,083625,Delgado; Tania,17,0,35,18
1656922339833,COGS 107A,A01,083627,Boyle; Mary E. T.,13,0,60,47
1656922345859,COGS 118A,A01,083075,Gupta; Anjum,15,0,76,61
1656922351888,CSE 3,A50,083646,Miranda; Gregory Joseph,22,0,50,28
1656922357915,CSE 8A,A50,083650,Miranda; Gregory Joseph,17,1,56,39
1656922363946,CSE 11,A01,083080,Cao; Yingjun,4,15,40,36
1656922369972,CSE 12,A01,083652,Krause-Levy; Sophia Louisa,20,1,120,100
1656922376003,CSE 15L,A01,083654,Morris; Justin Loren,8,0,50,42
1656922376003,CSE 15L,A02,083655,Morris; Justin Loren,8,0,50,42
1656922382028,CSE 20,A01,083657,Tran; Khoa Dang,37,0,80,43
1656922388056,CSE 21,A01,095574,Bach; Quang Tran,21,0,48,27
1656922394090,CSE 30,A01,083084,Eldon; John,4,0,80,76
1656922394090,CSE 30,B01,095061,Bhaskar; Nishant,6,0,50,44
1656922400120,CSE 100,A01,083659,Cao; Yingjun,3,4,70,67
1656922406149,CSE 134B,A01,083661,Powell; Thomas Allan,19,0,100,81
1656922412175,CSE 140,A01,083663,Gungor; Onat,14,0,85,71
1656922418206,CSE 140L,A01,083088,Eldon; John,16,0,100,84
1656922424239,CSE 175,A01,083665,Kumar; Rakesh,3,0,25,22
1656922430265,CSE 190,A00,092507,Dubnov; Shlomo,7,0,20,13
1656922436299,ECE 45,A01,083139,Congero; Spencer William,5,0,75,70
1656922442327,ECE 65,A50,083695,Saad; Andrew S,12,0,30,18
1656922442327,ECE 65,A51,095125,Saad; Andrew S,25,0,26,1
1656922448359,ECE 109,A01,091882,Touri; Behrouz,16,0,70,54
1656922454386,ECE 180,A00,083140,Abi Samra; Nicholas Camill,0,0,30,30
1656922454386,ECE 180,B00,083141,Abi Samra; Nicholas Camill,0,0,30,30
1656922460416,MATH 10A,A01,083735,Patchell; Gregory David,1,0,30,29
1656922460416,MATH 10A,A02,083736,Patchell; Gregory David,20,0,30,10
1656922460416,MATH 10A,A03,083737,Patchell; Gregory David,15,0,30,15
1656922466456,MATH 10B,A01,083207,Lim; Seonhee,7,0,34,27
1656922466456,MATH 10B,A02,083208,Lim; Seonhee,9,0,35,26
1656922466456,MATH 10B,A03,093472,Lim; Seonhee,4,0,34,30
1656922466456,MATH 10B,B01,083739,Sinha; Shubham,9,0,30,21
1656922472588,MATH 18,A01,083743,Cinel; Cameron Alexander,6,0,30,24
1656922472588,MATH 18,A02,083744,Cinel; Cameron Alexander,15,0,30,15
1656922472588,MATH 18,A03,083745,Cinel; Cameron Alexander,8,0,30,22
1656922472588,MATH 18,B01,083748,Rideout; David Porter,4,0,37,33
1656922472588,MATH 18,B02,083749,Rideout; David Porter,3,0,36,33
1656922472588,MATH 18,B03,083750,Rideout; David Porter,2,0,37,35
1656922472588,MATH 18,B04,083751,Rideout; David Porter,5,0,36,31
1656922472588,MATH 18,B05,093473,Rideout; David Porter,4,0,36,32
1656922472588,MATH 18,B06,093474,Rideout; David Porter,5,0,36,31
1656922478611,MATH 20A,A01,083754,Zheng; Zequn,12,0,40,28
1656922484638,MATH 20B,A01,083756,Briones; Jor-el Thomas Caparas,1,0,36,35
1656922484638,MATH 20B,A02,083757,Briones; Jor-el Thomas Caparas,1,0,36,35
1656922484638,MATH 20B,A03,093475,Briones; Jor-el Thomas Caparas,0,0,36,36
1656922490664,MATH 20C,A01,083760,Briones; Jor-el Thomas Caparas,1,0,35,34
1656922490664,MATH 20C,A02,083761,Briones; Jor-el Thomas Caparas,8,0,35,27
1656922490664,MATH 20C,A03,093476,Briones; Jor-el Thomas Caparas,0,1,36,36
1656922490664,MATH 20C,B01,083762,Bach; Quang Tran,0,0,30,30
1656922496686,MATH 20D,A01,083765,Tran; Brian Kha,4,0,30,26
1656922496686,MATH 20D,A02,083766,Tran; Brian Kha,4,0,30,26
1656922496686,MATH 20D,A03,083767,Tran; Brian Kha,3,0,30,27
1656922502711,MATH 20E,A01,083771,Ganguly; Soumya,5,0,32,27
1656922502711,MATH 20E,A02,083772,Ganguly; Soumya,6,0,32,26
1656922502711,MATH 20E,B01,083773,Ciotti; Benjamin,18,0,35,17
1656922502711,MATH 20E,B02,083774,Ciotti; Benjamin,17,0,35,18
1656922508749,MATH 103A,A01,083777,Greenfeld; Be'Eri,2,0,36,34
1656922508749,MATH 103A,A02,083778,Greenfeld; Be'Eri,5,0,36,31
1656922508749,MATH 103A,A03,093561,Greenfeld; Be'Eri,4,0,36,32
1656922508749,MATH 103A,B01,083779,Greenfeld; Be'Eri,6,0,36,30
1656922508749,MATH 103A,B02,083780,Greenfeld; Be'Eri,2,0,36,34
1656922508749,MATH 103A,B03,093562,Greenfeld; Be'Eri,2,0,36,34
1656922514775,MATH 105,A01,085443,Carter; Anne Toulson,13,0,35,22
1656922514775,MATH 105,A02,093477,Carter; Anne Toulson,20,0,35,15
1656922520810,MATH 109,A01,083213,Ganzberger; Geoffrey Michael,2,0,34,32
1656922520810,MATH 109,A02,083214,Ganzberger; Geoffrey Michael,2,0,34,32
1656922520810,MATH 109,A03,093478,Ganzberger; Geoffrey Michael,1,0,34,33
1656922520810,MATH 109,B01,083215,Ganzberger; Geoffrey Michael,1,0,32,31
1656922520810,MATH 109,B02,083216,Ganzberger; Geoffrey Michael,1,0,32,31
1656922520810,MATH 109,B03,093479,Ganzberger; Geoffrey Michael,6,0,32,26
1656922526850,MATH 142A,A01,083219,Chow; Bennett,6,0,32,26
1656922526850,MATH 142A,A02,083220,Chow; Bennett,10,0,32,22
1656922526850,MATH 142A,A03,093480,Chow; Bennett,7,0,32,25
1656922526850,MATH 142A,B03,093481,Chow; Bennett,7,0,32,25
1656922526850,MATH 142A,B04,093558,Chow; Bennett,11,0,32,21
1656922526850,MATH 142A,B05,093559,Chow; Bennett,6,0,32,26
1656922532879,MATH 193A,A01,083224,Rotar; Vladimir,7,0,34,27
1656922532879,MATH 193A,A02,083225,Rotar; Vladimir,3,0,34,31
1656922532879,MATH 193A,A03,083781,Rotar; Vladimir,1,0,34,33
1656922532879,MATH 193A,A04,083782,Rotar; Vladimir,6,0,34,28
1656922532879,MATH 193A,A05,093482,Rotar; Vladimir,6,0,34,28
1656922538904,MATH 197,001,091859,McAuley; Julian John,9999,0,9999,0
1656922538904,MATH 197,002,095566,Kedlaya; Kiran S.,9997,0,9999,2
1656922538904,MATH 197,003,095567,Xiao; Ming,9999,0,9999,0
1656922538904,MATH 197,004,095571,Perols; Johan Lars,9998,0,9999,1
1656922545992,COGS 9,A01,083615,Shannon; Kyle Michael,7,0,75,68
1656922552027,COGS 11,A01,083617,Boyle; Mary E. T.,19,0,48,29
1656922558052,COGS 13,A01,083071,Bastos; Amalia Pinkusfeld,9,0,71,62
1656922564086,COGS 14A,A01,092681,Semenuks; Arturs,0,1,100,100
1656922570112,COGS 14B,A01,083073,Cheng; Tzu-Han,5,0,63,58
1656922576134,COGS 17,A01,092677,Semenuks; Arturs,4,0,81,77
1656922582165,COGS 100,A01,083619,Allen; Michael Gordon,15,0,70,55
1656922588191,COGS 101A,A01,083621,Davis; Joshua Daniel,9,0,68,59
1656922594226,COGS 101B,A01,091572,Allen; Michael Gordon,8,0,65,57
1656922600252,COGS 101C,A01,083625,Delgado; Tania,17,0,35,18
1656922606276,COGS 107A,A01,083627,Boyle; Mary E. T.,13,0,60,47
1656922612307,COGS 118A,A01,083075,Gupta; Anjum,15,0,76,61
1656922618337,CSE 3,A50,083646,Miranda; Gregory Joseph,22,0,50,28
1656922624362,CSE 8A,A50,083650,Miranda; Gregory Joseph,17,1,56,39
1656922630386,CSE 11,A01,083080,Cao; Yingjun,4,15,40,36
1656922636412,CSE 12,A01,083652,Krause-Levy; Sophia Louisa,20,1,120,100
1656922642442,CSE 15L,A01,083654,Morris; Justin Loren,8,0,50,42
1656922642442,CSE 15L,A02,083655,Morris; Justin Loren,8,0,50,42
1656922648476,CSE 20,A01,083657,Tran; Khoa Dang,37,0,80,43
1656922654505,CSE 21,A01,095574,Bach; Quang Tran,21,0,48,27
1656922660531,CSE 30,A01,083084,Eldon; John,4,0,80,76
1656922660531,CSE 30,B01,095061,Bhaskar; Nishant,6,0,50,44
1656922666561,CSE 100,A01,083659,Cao; Yingjun,3,4,70,67
1656922672591,CSE 134B,A01,083661,Powell; Thomas Allan,19,0,100,81
1656922678616,CSE 140,A01,083663,Gungor; Onat,14,0,85,71
1656922684640,CSE 140L,A01,083088,Eldon; John,16,0,100,84
1656922690667,CSE 175,A01,083665,Kumar; Rakesh,3,0,25,22
1656922696691,CSE 190,A00,092507,Dubnov; Shlomo,7,0,20,13
1656922702720,ECE 45,A01,083139,Congero; Spencer William,5,0,75,70
1656922708755,ECE 65,A50,083695,Saad; Andrew S,12,0,30,18
1656922708755,ECE 65,A51,095125,Saad; Andrew S,25,0,26,1
1656922714779,ECE 109,A01,091882,Touri; Behrouz,16,0,70,54
1656922720802,ECE 180,A00,083140,Abi Samra; Nicholas Camill,0,0,30,30
1656922720802,ECE 180,B00,083141,Abi Samra; Nicholas Camill,0,0,30,30
1656922726828,MATH 10A,A01,083735,Patchell; Gregory David,1,0,30,29
1656922726828,MATH 10A,A02,083736,Patchell; Gregory David,20,0,30,10
1656922726828,MATH 10A,A03,083737,Patchell; Gregory David,15,0,30,15
1656922732860,MATH 10B,A01,083207,Lim; Seonhee,7,0,34,27
1656922732860,MATH 10B,A02,083208,Lim; Seonhee,9,0,35,26
1656922732860,MATH 10B,A03,093472,Lim; Seonhee,4,0,34,30
1656922732860,MATH 10B,B01,083739,Sinha; Shubham,9,0,30,21
1656922738888,MATH 18,A01,083743,Cinel; Cameron Alexander,6,0,30,24
1656922738888,MATH 18,A02,083744,Cinel; Cameron Alexander,15,0,30,15
1656922738888,MATH 18,A03,083745,Cinel; Cameron Alexander,8,0,30,22
1656922738888,MATH 18,B01,083748,Rideout; David Porter,4,0,37,33
1656922738888,MATH 18,B02,083749,Rideout; David Porter,3,0,36,33
1656922738888,MATH 18,B03,083750,Rideout; David Porter,2,0,37,35
1656922738888,MATH 18,B04,083751,Rideout; David Porter,5,0,36,31
1656922738888,MATH 18,B05,093473,Rideout; David Porter,4,0,36,32
1656922738888,MATH 18,B06,093474,Rideout; David Porter,5,0,36,31
1656922744917,MATH 20A,A01,083754,Zheng; Zequn,12,0,40,28
1656922750951,MATH 20B,A01,083756,Briones; Jor-el Thomas Caparas,1,0,36,35
1656922750951,MATH 20B,A02,083757,Briones; Jor-el Thomas Caparas,1,0,36,35
1656922750951,MATH 20B,A03,093475,Briones; Jor-el Thomas Caparas,0,0,36,36
1656922756984,MATH 20C,A01,083760,Briones; Jor-el Thomas Caparas,1,0,35,34
1656922756984,MATH 20C,A02,083761,Briones; Jor-el Thomas Caparas,8,0,35,27
1656922756984,MATH 20C,A03,093476,Briones; Jor-el Thomas Caparas,0,1,36,36
1656922756984,MATH 20C,B01,083762,Bach; Quang Tran,0,0,30,30
1656922763009,MATH 20D,A01,083765,Tran; Brian Kha,4,0,30,26
1656922763009,MATH 20D,A02,083766,Tran; Brian Kha,4,0,30,26
1656922763009,MATH 20D,A03,083767,Tran; Brian Kha,3,0,30,27
1656922769038,MATH 20E,A01,083771,Ganguly; Soumya,5,0,32,27
1656922769038,MATH 20E,A02,083772,Ganguly; Soumya,6,0,32,26
1656922769038,MATH 20E,B01,083773,Ciotti; Benjamin,18,0,35,17
1656922769038,MATH 20E,B02,083774,Ciotti; Benjamin,17,0,35,18
1656922775066,MATH 103A,A01,083777,Greenfeld; Be'Eri,2,0,36,34
1656922775066,MATH 103A,A02,083778,Greenfeld; Be'Eri,5,0,36,31
1656922775066,MATH 103A,A03,093561,Greenfeld; Be'Eri,4,0,36,32
1656922775066,MATH 103A,B01,083779,Greenfeld; Be'Eri,6,0,36,30
1656922775066,MATH 103A,B02,083780,Greenfeld; Be'Eri,2,0,36,34
1656922775066,MATH 103A,B03,093562,Greenfeld; Be'Eri,2,0,36,34
1656922781093,MATH 105,A01,085443,Carter; Anne Toulson,13,0,35,22
1656922781093,MATH 105,A02,093477,Carter; Anne Toulson,20,0,35,15
1656922787122,MATH 109,A01,083213,Ganzberger; Geoffrey Michael,2,0,34,32
1656922787122,MATH 109,A02,083214,Ganzberger; Geoffrey Michael,2,0,34,32
1656922787122,MATH 109,A03,093478,Ganzberger; Geoffrey Michael,1,0,34,33
1656922787122,MATH 109,B01,083215,Ganzberger; Geoffrey Michael,1,0,32,31
1656922787122,MATH 109,B02,083216,Ganzberger; Geoffrey Michael,1,0,32,31
1656922787122,MATH 109,B03,093479,Ganzberger; Geoffrey Michael,6,0,32,26
1656922793159,MATH 142A,A01,083219,Chow; Bennett,6,0,32,26
1656922793159,MATH 142A,A02,083220,Chow; Bennett,10,0,32,22
1656922793159,MATH 142A,A03,093480,Chow; Bennett,7,0,32,25
1656922793159,MATH 142A,B03,093481,Chow; Bennett,7,0,32,25
1656922793159,MATH 142A,B04,093558,Chow; Bennett,11,0,32,21
1656922793159,MATH 142A,B05,093559,Chow; Bennett,6,0,32,26
1656922799186,MATH 193A,A01,083224,Rotar; Vladimir,7,0,34,27
1656922799186,MATH 193A,A02,083225,Rotar; Vladimir,3,0,34,31
1656922799186,MATH 193A,A03,083781,Rotar; Vladimir,1,0,34,33
1656922799186,MATH 193A,A04,083782,Rotar; Vladimir,6,0,34,28
1656922799186,MATH 193A,A05,093482,Rotar; Vladimir,6,0,34,28
1656922805213,MATH 197,001,091859,McAuley; Julian John,9999,0,9999,0
1656922805213,MATH 197,002,095566,Kedlaya; Kiran S.,9997,0,9999,2
1656922805213,MATH 197,003,095567,Xiao; Ming,9999,0,9999,0
1656922805213,MATH 197,004,095571,Perols; Johan Lars,9998,0,9999,1
1656922812307,COGS 9,A01,083615,Shannon; Kyle Michael,7,0,75,68
1656922818333,COGS 11,A01,083617,Boyle; Mary E. T.,19,0,48,29
1656922824370,COGS 13,A01,083071,Bastos; Amalia Pinkusfeld,9,0,71,62
1656922830400,COGS 14A,A01,092681,Semenuks; Arturs,0,1,100,100
1656922836432,COGS 14B,A01,083073,Cheng; Tzu-Han,5,0,63,58
1656922842456,COGS 17,A01,092677,Semenuks; Arturs,4,0,81,77
1656922848486,COGS 100,A01,083619,Allen; Michael Gordon,15,0,70,55
1656922854517,COGS 101A,A01,083621,Davis; Joshua Daniel,9,0,68,59
1656922860552,COGS 101B,A01,091572,Allen; Michael Gordon,8,0,65,57
1656922866582,COGS 101C,A01,083625,Delgado; Tania,17,0,35,18
1656922872611,COGS 107A,A01,083627,Boyle; Mary E. T.,13,0,60,47
1656922878641,COGS 118A,A01,083075,Gupta; Anjum,15,0,76,61
1656922884678,CSE 3,A50,083646,Miranda; Gregory Joseph,22,0,50,28
1656922890707,CSE 8A,A50,083650,Miranda; Gregory Joseph,17,1,56,39
1656922896732,CSE 11,A01,083080,Cao; Yingjun,4,15,40,36
1656922902764,CSE 12,A01,083652,Krause-Levy; Sophia Louisa,20,1,120,100
1656922908801,CSE 15L,A01,083654,Morris; Justin Loren,8,0,50,42
1656922908801,CSE 15L,A02,083655,Morris; Justin Loren,8,0,50,42
1656922914848,CSE 20,A01,083657,Tran; Khoa Dang,37,0,80,43
1656922920872,CSE 21,A01,095574,Bach; Quang Tran,21,0,48,27
1656922926904,CSE 30,A01,083084,Eldon; John,4,0,80,76
1656922926904,CSE 30,B01,095061,Bhaskar; Nishant,6,0,50,44
1656922932936,CSE 100,A01,083659,Cao; Yingjun,3,4,70,67
1656922938966,CSE 134B,A01,083661,Powell; Thomas Allan,19,0,100,81
1656922944994,CSE 140,A01,083663,Gungor; Onat,14,0,85,71
1656922951019,CSE 140L,A01,083088,Eldon; John,16,0,100,84
1656922957048,CSE 175,A01,083665,Kumar; Rakesh,3,0,25,22
1656922963071,CSE 190,A00,092507,Dubnov; Shlomo,7,0,20,13
1656922969099,ECE 45,A01,083139,Congero; Spencer William,5,0,75,70
1656922975127,ECE 65,A50,083695,Saad; Andrew S,12,0,30,18
1656922975127,ECE 65,A51,095125,Saad; Andrew S,25,0,26,1
1656922981152,ECE 109,A01,091882,Touri; Behrouz,16,0,70,54
1656922987188,ECE 180,A00,083140,Abi Samra; Nicholas Camill,0,0,30,30
1656922987188,ECE 180,B00,083141,Abi Samra; Nicholas Camill,0,0,30,30
1656922993225,MATH 10A,A01,083735,Patchell; Gregory David,1,0,30,29
1656922993225,MATH 10A,A02,083736,Patchell; Gregory David,20,0,30,10
1656922993225,MATH 10A,A03,083737,Patchell; Gregory David,15,0,30,15
1656922999271,MATH 10B,A01,083207,Lim; Seonhee,7,0,34,27
1656922999271,MATH 10B,A02,083208,Lim; Seonhee,9,0,35,26
1656922999271,MATH 10B,A03,093472,Lim; Seonhee,4,0,34,30
1656922999271,MATH 10B,B01,083739,Sinha; Shubham,9,0,30,21
1656923005300,MATH 18,A01,083743,Cinel; Cameron Alexander,6,0,30,24
1656923005300,MATH 18,A02,083744,Cinel; Cameron Alexander,15,0,30,15
1656923005300,MATH 18,A03,083745,Cinel; Cameron Alexander,8,0,30,22
1656923005300,MATH 18,B01,083748,Rideout; David Porter,4,0,37,33
1656923005300,MATH 18,B02,083749,Rideout; David Porter,3,0,36,33
1656923005300,MATH 18,B03,083750,Rideout; David Porter,2,0,37,35
1656923005300,MATH 18,B04,083751,Rideout; David Porter,5,0,36,31
1656923005300,MATH 18,B05,093473,Rideout; David Porter,4,0,36,32
1656923005300,MATH 18,B06,093474,Rideout; David Porter,5,0,36,31
1656923011338,MATH 20A,A01,083754,Zheng; Zequn,12,0,40,28
1656923017372,MATH 20B,A01,083756,Briones; Jor-el Thomas Caparas,1,0,36,35
1656923017372,MATH 20B,A02,083757,Briones; Jor-el Thomas Caparas,1,0,36,35
1656923017372,MATH 20B,A03,093475,Briones; Jor-el Thomas Caparas,0,0,36,36
1656923023408,MATH 20C,A01,083760,Briones; Jor-el Thomas Caparas,1,0,35,34
1656923023408,MATH 20C,A02,083761,Briones; Jor-el Thomas Caparas,8,0,35,27
1656923023408,MATH 20C,A03,093476,Briones; Jor-el Thomas Caparas,0,1,36,36
1656923023408,MATH 20C,B01,083762,Bach; Quang Tran,0,0,30,30
1656923029455,MATH 20D,A01,083765,Tran; Brian Kha,4,0,30,26
1656923029455,MATH 20D,A02,083766,Tran; Brian Kha,4,0,30,26
1656923029455,MATH 20D,A03,083767,Tran; Brian Kha,3,0,30,27
1656923035492,MATH 20E,A01,083771,Ganguly; Soumya,5,0,32,27
1656923035492,MATH 20E,A02,083772,Ganguly; Soumya,6,0,32,26
1656923035492,MATH 20E,B01,083773,Ciotti; Benjamin,18,0,35,17
1656923035492,MATH 20E,B02,083774,Ciotti; Benjamin,17,0,35,18
1656923041530,MATH 103A,A01,083777,Greenfeld; Be'Eri,2,0,36,34
1656923041530,MATH 103A,A02,083778,Greenfeld; Be'Eri,5,0,36,31
1656923041530,MATH 103A,A03,093561,Greenfeld; Be'Eri,4,0,36,32
1656923041530,MATH 103A,B01,083779,Greenfeld; Be'Eri,6,0,36,30
1656923041530,MATH 103A,B02,083780,Greenfeld; Be'Eri,2,0,36,34
1656923041530,MATH 103A,B03,093562,Greenfeld; Be'Eri,2,0,36,34
1656923047560,MATH 105,A01,085443,Carter; Anne Toulson,13,0,35,22
1656923047560,MATH 105,A02,093477,Carter; Anne Toulson,20,0,35,15
1656923053596,MATH 109,A01,083213,Ganzberger; Geoffrey Michael,2,0,34,32
1656923053596,MATH 109,A02,083214,Ganzberger; Geoffrey Michael,2,0,34,32
1656923053596,MATH 109,A03,093478,Ganzberger; Geoffrey Michael,1,0,34,33
1656923053596,MATH 109,B01,083215,Ganzberger; Geoffrey Michael,1,0,32,31
1656923053596,MATH 109,B02,083216,Ganzberger; Geoffrey Michael,1,0,32,31
1656923053596,MATH 109,B03,093479,Ganzberger; Geoffrey Michael,6,0,32,26
1656923059621,MATH 142A,A01,083219,Chow; Bennett,6,0,32,26
1656923059621,MATH 142A,A02,083220,Chow; Bennett,10,0,32,22
1656923059621,MATH 142A,A03,093480,Chow; Bennett,7,0,32,25
1656923059621,MATH 142A,B03,093481,Chow; Bennett,7,0,32,25
1656923059621,MATH 142A,B04,093558,Chow; Bennett,11,0,32,21
1656923059621,MATH 142A,B05,093559,Chow; Bennett,6,0,32,26
1656923065653,MATH 193A,A01,083224,Rotar; Vladimir,7,0,34,27
1656923065653,MATH 193A,A02,083225,Rotar; Vladimir,3,0,34,31
1656923065653,MATH 193A,A03,083781,Rotar; Vladimir,1,0,34,33
1656923065653,MATH 193A,A04,083782,Rotar; Vladimir,6,0,34,28
1656923065653,MATH 193A,A05,093482,Rotar; Vladimir,6,0,34,28
1656923071777,MATH 197,001,091859,McAuley; Julian John,9999,0,9999,0
1656923071777,MATH 197,002,095566,Kedlaya; Kiran S.,9997,0,9999,2
1656923071777,MATH 197,003,095567,Xiao; Ming,9999,0,9999,0
1656923071777,MATH 197,004,095571,Perols; Johan Lars,9998,0,9999,1
1656923078849,COGS 9,A01,083615,Shannon; Kyle Michael,7,0,75,68
1656923084879,COGS 11,A01,083617,Boyle; Mary E. T.,19,0,48,29
1656923090907,COGS 13,A01,083071,Bastos; Amalia Pinkusfeld,9,0,71,62
1656923096937,COGS 14A,A01,092681,Semenuks; Arturs,0,1,100,100
1656923102967,COGS 14B,A01,083073,Cheng; Tzu-Han,5,0,63,58
1656923108995,COGS 17,A01,092677,Semenuks; Arturs,4,0,81,77
1656923115022,COGS 100,A01,083619,Allen; Michael Gordon,15,0,70,55
1656923121057,COGS 101A,A01,083621,Davis; Joshua Daniel,9,0,68,59
1656923127082,COGS 101B,A01,091572,Allen; Michael Gordon,8,0,65,57
1656923133106,COGS 101C,A01,083625,Delgado; Tania,17,0,35,18
1656923139135,COGS 107A,A01,083627,Boyle; Mary E. T.,13,0,60,47
1656923145162,COGS 118A,A01,083075,Gupta; Anjum,15,0,76,61
1656923151210,CSE 3,A50,083646,Miranda; Gregory Joseph,22,0,50,28
1656923157236,CSE 8A,A50,083650,Miranda; Gregory Joseph,17,1,56,39
1656923163265,CSE 11,A01,083080,Cao; Yingjun,4,15,40,36
1656923169290,CSE 12,A01,083652,Krause-Levy; Sophia Louisa,20,1,120,100
1656923175320,CSE 15L,A01,083654,Morris; Justin Loren,8,0,50,42
1656923175320,CSE 15L,A02,083655,Morris; Justin Loren,8,0,50,42
1656923181345,CSE 20,A01,083657,Tran; Khoa Dang,37,0,80,43
1656923187371,CSE 21,A01,095574,Bach; Quang Tran,21,0,48,27
1656923193410,CSE 30,A01,083084,Eldon; John,4,0,80,76
1656923193410,CSE 30,B01,095061,Bhaskar; Nishant,6,0,50,44
1656923199445,CSE 100,A01,083659,Cao; Yingjun,3,4,70,67
1656923205477,CSE 134B,A01,083661,Powell; Thomas Allan,19,0,100,81
1656923211503,CSE 140,A01,083663,Gungor; Onat,14,0,85,71
1656923217536,CSE 140L,A01,083088,Eldon; John,16,0,100,84
1656923223567,CSE 175,A01,083665,Kumar; Rakesh,3,0,25,22
1656923229593,CSE 190,A00,092507,Dubnov; Shlomo,7,0,20,13
1656923235631,ECE 45,A01,083139,Congero; Spencer William,5,0,75,70
1656923241667,ECE 65,A50,083695,Saad; Andrew S,12,0,30,18
1656923241667,ECE 65,A51,095125,Saad; Andrew S,25,0,26,1
1656923247694,ECE 109,A01,091882,Touri; Behrouz,16,0,70,54
1656923253722,ECE 180,A00,083140,Abi Samra; Nicholas Camill,0,0,30,30
1656923253722,ECE 180,B00,083141,Abi Samra; Nicholas Camill,0,0,30,30
1656923259761,MATH 10A,A01,083735,Patchell; Gregory David,1,0,30,29
1656923259761,MATH 10A,A02,083736,Patchell; Gregory David,20,0,30,10
1656923259761,MATH 10A,A03,083737,Patchell; Gregory David,15,0,30,15
1656923265790,MATH 10B,A01,083207,Lim; Seonhee,7,0,34,27
1656923265790,MATH 10B,A02,083208,Lim; Seonhee,9,0,35,26
1656923265790,MATH 10B,A03,093472,Lim; Seonhee,4,0,34,30
1656923265790,MATH 10B,B01,083739,Sinha; Shubham,9,0,30,21
1656923271827,MATH 18,A01,083743,Cinel; Cameron Alexander,6,0,30,24
1656923271827,MATH 18,A02,083744,Cinel; Cameron Alexander,15,0,30,15
1656923271827,MATH 18,A03,083745,Cinel; Cameron Alexander,8,0,30,22
1656923271827,MATH 18,B01,083748,Rideout; David Porter,4,0,37,33
1656923271827,MATH 18,B02,083749,Rideout; David Porter,3,0,36,33
1656923271827,MATH 18,B03,083750,Rideout; David Porter,2,0,37,35
1656923271827,MATH 18,B04,083751,Rideout; David Porter,5,0,36,31
1656923271827,MATH 18,B05,093473,Rideout; David Porter,4,0,36,32
1656923271827,MATH 18,B06,093474,Rideout; David Porter,5,0,36,31
1656923277855,MATH 20A,A01,083754,Zheng; Zequn,12,0,40,28
1656923283894,MATH 20B,A01,083756,Briones; Jor-el Thomas Caparas,1,0,36,35
1656923283894,MATH 20B,A02,083757,Briones; Jor-el Thomas Caparas,1,0,36,35
1656923283894,MATH 20B,A03,093475,Briones; Jor-el Thomas Caparas,0,0,36,36
1656923289923,MATH 20C,A01,083760,Briones; Jor-el Thomas Caparas,1,0,35,34
1656923289923,MATH 20C,A02,083761,Briones; Jor-el Thomas Caparas,8,0,35,27
1656923289923,MATH 20C,A03,093476,Briones; Jor-el Thomas Caparas,0,1,36,36
1656923289923,MATH 20C,B01,083762,Bach; Quang Tran,0,0,30,30
1656923295947,MATH 20D,A01,083765,Tran; Brian Kha,4,0,30,26
1656923295947,MATH 20D,A02,083766,Tran; Brian Kha,4,0,30,26
1656923295947,MATH 20D,A03,083767,Tran; Brian Kha,3,0,30,27
1656923301985,MATH 20E,A01,083771,Ganguly; Soumya,5,0,32,27
1656923301985,MATH 20E,A02,083772,Ganguly; Soumya,6,0,32,26
1656923301985,MATH 20E,B01,083773,Ciotti; Benjamin,18,0,35,17
1656923301985,MATH 20E,B02,083774,Ciotti; Benjamin,17,0,35,18
1656923308031,MATH 103A,A01,083777,Greenfeld; Be'Eri,2,0,36,34
1656923308031,MATH 103A,A02,083778,Greenfeld; Be'Eri,5,0,36,31
1656923308031,MATH 103A,A03,093561,Greenfeld; Be'Eri,4,0,36,32
1656923308031,MATH 103A,B01,083779,Greenfeld; Be'Eri,6,0,36,30
1656923308031,MATH 103A,B02,083780,Greenfeld; Be'Eri,2,0,36,34
1656923308031,MATH 103A,B03,093562,Greenfeld; Be'Eri,2,0,36,34
1656923314068,MATH 105,A01,085443,Carter; Anne Toulson,13,0,35,22
1656923314068,MATH 105,A02,093477,Carter; Anne Toulson,20,0,35,15
1656923320106,MATH 109,A01,083213,Ganzberger; Geoffrey Michael,2,0,34,32
1656923320106,MATH 109,A02,083214,Ganzberger; Geoffrey Michael,2,0,34,32
1656923320106,MATH 109,A03,093478,Ganzberger; Geoffrey Michael,1,0,34,33
1656923320106,MATH 109,B01,083215,Ganzberger; Geoffrey Michael,1,0,32,31
1656923320106,MATH 109,B02,083216,Ganzberger; Geoffrey Michael,1,0,32,31
1656923320106,MATH 109,B03,093479,Ganzberger; Geoffrey Michael,6,0,32,26
1656923326133,MATH 142A,A01,083219,Chow; Bennett,6,0,32,26
1656923326133,MATH 142A,A02,083220,Chow; Bennett,10,0,32,22
1656923326133,MATH 142A,A03,093480,Chow; Bennett,7,0,32,25
1656923326133,MATH 142A,B03,093481,Chow; Bennett,7,0,32,25
1656923326133,MATH 142A,B04,093558,Chow; Bennett,11,0,32,21
1656923326133,MATH 142A,B05,093559,Chow; Bennett,6,0,32,26
1656923332160,MATH 193A,A01,083224,Rotar; Vladimir,7,0,34,27
1656923332160,MATH 193A,A02,083225,Rotar; Vladimir,3,0,34,31
1656923332160,MATH 193A,A03,083781,Rotar; Vladimir,1,0,34,33
1656923332160,MATH 193A,A04,083782,Rotar; Vladimir,6,0,34,28
1656923332160,MATH 193A,A05,093482,Rotar; Vladimir,6,0,34,28
1656923338188,MATH 197,001,091859,McAuley; Julian John,9999,0,9999,0
1656923338188,MATH 197,002,095566,Kedlaya; Kiran S.,9997,0,9999,2
1656923338188,MATH 197,003,095567,Xiao; Ming,9999,0,9999,0
1656923338188,MATH 197,004,095571,Perols; Johan Lars,9998,0,9999,1
1656923345267,COGS 9,A01,083615,Shannon; Kyle Michael,7,0,75,68
1656923351299,COGS 11,A01,083617,Boyle; Mary E. T.,19,0,48,29
1656923357325,COGS 13,A01,083071,Bastos; Amalia Pinkusfeld,9,0,71,62
1656923363355,COGS 14A,A01,092681,Semenuks; Arturs,0,1,100,100
1656923369381,COGS 14B,A01,083073,Cheng; Tzu-Han,5,0,63,58
1656923375405,COGS 17,A01,092677,Semenuks; Arturs,4,0,81,77
1656923381440,COGS 100,A01,083619,Allen; Michael Gordon,15,0,70,55
1656923387473,COGS 101A,A01,083621,Davis; Joshua Daniel,9,0,68,59
1656923393495,COGS 101B,A01,091572,Allen; Michael Gordon,8,0,65,57
1656923399521,COGS 101C,A01,083625,Delgado; Tania,17,0,35,18
1656923405549,COGS 107A,A01,083627,Boyle; Mary E. T.,13,0,60,47
1656923411578,COGS 118A,A01,083075,Gupta; Anjum,15,0,76,61
1656923417606,CSE 3,A50,083646,Miranda; Gregory Joseph,22,0,50,28
1656923423631,CSE 8A,A50,083650,Miranda; Gregory Joseph,17,1,56,39
1656923429656,CSE 11,A01,083080,Cao; Yingjun,4,15,40,36
1656923435702,CSE 12,A01,083652,Krause-Levy; Sophia Louisa,20,1,120,100
1656923441734,CSE 15L,A01,083654,Morris; Justin Loren,8,0,50,42
1656923441734,CSE 15L,A02,083655,Morris; Justin Loren,8,0,50,42
1656923447759,CSE 20,A01,083657,Tran; Khoa Dang,37,0,80,43
1656923453804,CSE 21,A01,095574,Bach; Quang Tran,21,0,48,27
1656923459841,CSE 30,A01,083084,Eldon; John,4,0,80,76
1656923459841,CSE 30,B01,095061,Bhaskar; Nishant,6,0,50,44
1656923465874,CSE 100,A01,083659,Cao; Yingjun,3,4,70,67
1656923471904,CSE 134B,A01,083661,Powell; Thomas Allan,19,0,100,81
1656923477933,CSE 140,A01,083663,Gungor; Onat,14,0,85,71
1656923483957,CSE 140L,A01,083088,Eldon; John,16,0,100,84
1656923489987,CSE 175,A01,083665,Kumar; Rakesh,3,0,25,22
1656923496019,CSE 190,A00,092507,Dubnov; Shlomo,7,0,20,13
1656923502050,ECE 45,A01,083139,Congero; Spencer William,5,0,75,70
1656923508084,ECE 65,A50,083695,Saad; Andrew S,12,0,30,18
1656923508084,ECE 65,A51,095125,Saad; Andrew S,25,0,26,1
1656923514110,ECE 109,A01,091882,Touri; Behrouz,16,0,70,54
1656923520137,ECE 180,A00,083140,Abi Samra; Nicholas Camill,0,0,30,30
1656923520137,ECE 180,B00,083141,Abi Samra; Nicholas Camill,0,0,30,30
1656923526163,MATH 10A,A01,083735,Patchell; Gregory David,1,0,30,29
1656923526163,MATH 10A,A02,083736,Patchell; Gregory David,20,0,30,10
1656923526163,MATH 10A,A03,083737,Patchell; Gregory David,15,0,30,15
1656923532204,MATH 10B,A01,083207,Lim; Seonhee,7,0,34,27
1656923532204,MATH 10B,A02,083208,Lim; Seonhee,9,0,35,26
1656923532204,MATH 10B,A03,093472,Lim; Seonhee,4,0,34,30
1656923532204,MATH 10B,B01,083739,Sinha; Shubham,9,0,30,21
1656923538233,MATH 18,A01,083743,Cinel; Cameron Alexander,6,0,30,24
1656923538233,MATH 18,A02,083744,Cinel; Cameron Alexander,15,0,30,15
1656923538233,MATH 18,A03,083745,Cinel; Cameron Alexander,8,0,30,22
1656923538233,MATH 18,B01,083748,Rideout; David Porter,4,0,37,33
1656923538233,MATH 18,B02,083749,Rideout; David Porter,3,0,36,33
1656923538233,MATH 18,B03,083750,Rideout; David Porter,2,0,37,35
1656923538233,MATH 18,B04,083751,Rideout; David Porter,5,0,36,31
1656923538233,MATH 18,B05,093473,Rideout; David Porter,4,0,36,32
1656923538233,MATH 18,B06,093474,Rideout; David Porter,5,0,36,31
1656923544271,MATH 20A,A01,083754,Zheng; Zequn,12,0,40,28
1656923550313,MATH 20B,A01,083756,Briones; Jor-el Thomas Caparas,1,0,36,35
1656923550313,MATH 20B,A02,083757,Briones; Jor-el Thomas Caparas,1,0,36,35
1656923550313,MATH 20B,A03,093475,Briones; Jor-el Thomas Caparas,0,0,36,36
1656923556349,MATH 20C,A01,083760,Briones; Jor-el Thomas Caparas,1,0,35,34
1656923556349,MATH 20C,A02,083761,Briones; Jor-el Thomas Caparas,8,0,35,27
1656923556349,MATH 20C,A03,093476,Briones; Jor-el Thomas Caparas,0,1,36,36
1656923556349,MATH 20C,B01,083762,Bach; Quang Tran,0,0,30,30
1656923562377,MATH 20D,A01,083765,Tran; Brian Kha,4,0,30,26
1656923562377,MATH 20D,A02,083766,Tran; Brian Kha,4,0,30,26
1656923562377,MATH 20D,A03,083767,Tran; Brian Kha,3,0,30,27
1656923568413,MATH 20E,A01,083771,Ganguly; Soumya,5,0,32,27
1656923568413,MATH 20E,A02,083772,Ganguly; Soumya,6,0,32,26
1656923568413,MATH 20E,B01,083773,Ciotti; Benjamin,18,0,35,17
1656923568413,MATH 20E,B02,083774,Ciotti; Benjamin,17,0,35,18
1656923574441,MATH 103A,A01,083777,Greenfeld; Be'Eri,2,0,36,34
1656923574441,MATH 103A,A02,083778,Greenfeld; Be'Eri,5,0,36,31
1656923574441,MATH 103A,A03,093561,Greenfeld; Be'Eri,4,0,36,32
1656923574441,MATH 103A,B01,083779,Greenfeld; Be'Eri,6,0,36,30
1656923574441,MATH 103A,B02,083780,Greenfeld; Be'Eri,2,0,36,34
1656923574441,MATH 103A,B03,093562,Greenfeld; Be'Eri,2,0,36,34
1656923580468,MATH 105,A01,085443,Carter; Anne Toulson,13,0,35,22
1656923580468,MATH 105,A02,093477,Carter; Anne Toulson,20,0,35,15
1656923586500,MATH 109,A01,083213,Ganzberger; Geoffrey Michael,2,0,34,32
1656923586500,MATH 109,A02,083214,Ganzberger; Geoffrey Michael,2,0,34,32
1656923586500,MATH 109,A03,093478,Ganzberger; Geoffrey Michael,1,0,34,33
1656923586500,MATH 109,B01,083215,Ganzberger; Geoffrey Michael,1,0,32,31
1656923586500,MATH 109,B02,083216,Ganzberger; Geoffrey Michael,1,0,32,31
1656923586500,MATH 109,B03,093479,Ganzberger; Geoffrey Michael,6,0,32,26
1656923592526,MATH 142A,A01,083219,Chow; Bennett,6,0,32,26
1656923592526,MATH 142A,A02,083220,Chow; Bennett,10,0,32,22
1656923592526,MATH 142A,A03,093480,Chow; Bennett,7,0,32,25
1656923592526,MATH 142A,B03,093481,Chow; Bennett,7,0,32,25
1656923592526,MATH 142A,B04,093558,Chow; Bennett,11,0,32,21
1656923592526,MATH 142A,B05,093559,Chow; Bennett,6,0,32,26
1656923598559,MATH 193A,A01,083224,Rotar; Vladimir,7,0,34,27
1656923598559,MATH 193A,A02,083225,Rotar; Vladimir,3,0,34,31
1656923598559,MATH 193A,A03,083781,Rotar; Vladimir,1,0,34,33
1656923598559,MATH 193A,A04,083782,Rotar; Vladimir,6,0,34,28
1656923598559,MATH 193A,A05,093482,Rotar; Vladimir,6,0,34,28
1656923604586,MATH 197,001,091859,McAuley; Julian John,9999,0,9999,0
1656923604586,MATH 197,002,095566,Kedlaya; Kiran S.,9997,0,9999,2
1656923604586,MATH 197,003,095567,Xiao; Ming,9999,0,9999,0
1656923604586,MATH 197,004,095571,Perols; Johan Lars,9998,0,9999,1
1656923611667,COGS 9,A01,083615,Shannon; Kyle Michael,7,0,75,68
1656923617697,COGS 11,A01,083617,Boyle; Mary E. T.,19,0,48,29
1656923623722,COGS 13,A01,083071,Bastos; Amalia Pinkusfeld,9,0,71,62
1656923629747,COGS 14A,A01,092681,Semenuks; Arturs,0,1,100,100
1656923635770,COGS 14B,A01,083073,Cheng; Tzu-Han,5,0,63,58
1656923641799,COGS 17,A01,092677,Semenuks; Arturs,4,0,81,77
1656923647823,COGS 100,A01,083619,Allen; Michael Gordon,15,0,70,55
1656923653846,COGS 101A,A01,083621,Davis; Joshua Daniel,9,0,68,59
1656923659876,COGS 101B,A01,091572,Allen; Michael Gordon,8,0,65,57
1656923665994,COGS 101C,A01,083625,Delgado; Tania,17,0,35,18
1656923672024,COGS 107A,A01,083627,Boyle; Mary E. T.,13,0,60,47
1656923678052,COGS 118A,A01,083075,Gupta; Anjum,15,0,76,61
1656923684089,CSE 3,A50,083646,Miranda; Gregory Joseph,22,0,50,28
1656923690115,CSE 8A,A50,083650,Miranda; Gregory Joseph,17,1,56,39
1656923696146,CSE 11,A01,083080,Cao; Yingjun,4,15,40,36
1656923702171,CSE 12,A01,083652,Krause-Levy; Sophia Louisa,20,1,120,100
1656923708194,CSE 15L,A01,083654,Morris; Justin Loren,8,0,50,42
1656923708194,CSE 15L,A02,083655,Morris; Justin Loren,8,0,50,42
1656923714220,CSE 20,A01,083657,Tran; Khoa Dang,37,0,80,43
1656923720250,CSE 21,A01,095574,Bach; Quang Tran,21,0,48,27
1656923726276,CSE 30,A01,083084,Eldon; John,4,0,80,76
1656923726276,CSE 30,B01,095061,Bhaskar; Nishant,6,0,50,44
1656923732301,CSE 100,A01,083659,Cao; Yingjun,3,4,70,67
1656923738325,CSE 134B,A01,083661,Powell; Thomas Allan,19,0,100,81
1656923744350,CSE 140,A01,083663,Gungor; Onat,14,0,85,71
1656923750376,CSE 140L,A01,083088,Eldon; John,16,0,100,84
1656923756402,CSE 175,A01,083665,Kumar; Rakesh,3,0,25,22
1656923762432,CSE 190,A00,092507,Dubnov; Shlomo,7,0,20,13
1656923768457,ECE 45,A01,083139,Congero; Spencer William,5,0,75,70
1656923774483,ECE 65,A50,083695,Saad; Andrew S,12,0,30,18
1656923774483,ECE 65,A51,095125,Saad; Andrew S,25,0,26,1
1656923780507,ECE 109,A01,091882,Touri; Behrouz,16,0,70,54
1656923786540,ECE 180,A00,083140,Abi Samra; Nicholas Camill,0,0,30,30
1656923786540,ECE 180,B00,083141,Abi Samra; Nicholas Camill,0,0,30,30
1656923792575,MATH 10A,A01,083735,Patchell; Gregory David,1,0,30,29
1656923792575,MATH 10A,A02,083736,Patchell; Gregory David,20,0,30,10
1656923792575,MATH 10A,A03,083737,Patchell; Gregory David,15,0,30,15
1656923798618,MATH 10B,A01,083207,Lim; Seonhee,7,0,34,27
1656923798618,MATH 10B,A02,083208,Lim; Seonhee,9,0,35,26
1656923798618,MATH 10B,A03,093472,Lim; Seonhee,4,0,34,30
1656923798618,MATH 10B,B01,083739,Sinha; Shubham,9,0,30,21
1656923804644,MATH 18,A01,083743,Cinel; Cameron Alexander,6,0,30,24
1656923804644,MATH 18,A02,083744,Cinel; Cameron Alexander,15,0,30,15
1656923804644,MATH 18,A03,083745,Cinel; Cameron Alexander,8,0,30,22
1656923804644,MATH 18,B01,083748,Rideout; David Porter,4,0,37,33
1656923804644,MATH 18,B02,083749,Rideout; David Porter,3,0,36,33
1656923804644,MATH 18,B03,083750,Rideout; David Porter,2,0,37,35
1656923804644,MATH 18,B04,083751,Rideout; David Porter,5,0,36,31
1656923804644,MATH 18,B05,093473,Rideout; David Porter,4,0,36,32
1656923804644,MATH 18,B06,093474,Rideout; David Porter,5,0,36,31
1656923810670,MATH 20A,A01,083754,Zheng; Zequn,12,0,40,28
1656923816697,MATH 20B,A01,083756,Briones; Jor-el Thomas Caparas,1,0,36,35
1656923816697,MATH 20B,A02,083757,Briones; Jor-el Thomas Caparas,1,0,36,35
1656923816697,MATH 20B,A03,093475,Briones; Jor-el Thomas Caparas,0,0,36,36
1656923822722,MATH 20C,A01,083760,Briones; Jor-el Thomas Caparas,1,0,35,34
1656923822722,MATH 20C,A02,083761,Briones; Jor-el Thomas Caparas,8,0,35,27
1656923822722,MATH 20C,A03,093476,Briones; Jor-el Thomas Caparas,0,1,36,36
1656923822722,MATH 20C,B01,083762,Bach; Quang Tran,0,0,30,30
1656923828746,MATH 20D,A01,083765,Tran; Brian Kha,4,0,30,26
1656923828746,MATH 20D,A02,083766,Tran; Brian Kha,4,0,30,26
1656923828746,MATH 20D,A03,083767,Tran; Brian Kha,3,0,30,27
1656923834773,MATH 20E,A01,083771,Ganguly; Soumya,5,0,32,27
1656923834773,MATH 20E,A02,083772,Ganguly; Soumya,6,0,32,26
1656923834773,MATH 20E,B01,083773,Ciotti; Benjamin,18,0,35,17
1656923834773,MATH 20E,B02,083774,Ciotti; Benjamin,17,0,35,18
1656923840818,MATH 103A,A01,083777,Greenfeld; Be'Eri,2,0,36,34
1656923840818,MATH 103A,A02,083778,Greenfeld; Be'Eri,5,0,36,31
1656923840818,MATH 103A,A03,093561,Greenfeld; Be'Eri,4,0,36,32
1656923840818,MATH 103A,B01,083779,Greenfeld; Be'Eri,6,0,36,30
1656923840818,MATH 103A,B02,083780,Greenfeld; Be'Eri,2,0,36,34
1656923840818,MATH 103A,B03,093562,Greenfeld; Be'Eri,2,0,36,34
1656923846852,MATH 105,A01,085443,Carter; Anne Toulson,13,0,35,22
1656923846852,MATH 105,A02,093477,Carter; Anne Toulson,20,0,35,15
1656923852876,MATH 109,A01,083213,Ganzberger; Geoffrey Michael,2,0,34,32
1656923852876,MATH 109,A02,083214,Ganzberger; Geoffrey Michael,2,0,34,32
1656923852876,MATH 109,A03,093478,Ganzberger; Geoffrey Michael,1,0,34,33
1656923852876,MATH 109,B01,083215,Ganzberger; Geoffrey Michael,1,0,32,31
1656923852876,MATH 109,B02,083216,Ganzberger; Geoffrey Michael,1,0,32,31
1656923852876,MATH 109,B03,093479,Ganzberger; Geoffrey Michael,6,0,32,26
1656923858909,MATH 142A,A01,083219,Chow; Bennett,6,0,32,26
1656923858909,MATH 142A,A02,083220,Chow; Bennett,10,0,32,22
1656923858909,MATH 142A,A03,093480,Chow; Bennett,7,0,32,25
1656923858909,MATH 142A,B03,093481,Chow; Bennett,7,0,32,25
1656923858909,MATH 142A,B04,093558,Chow; Bennett,11,0,32,21
1656923858909,MATH 142A,B05,093559,Chow; Bennett,6,0,32,26
1656923864938,MATH 193A,A01,083224,Rotar; Vladimir,7,0,34,27
1656923864938,MATH 193A,A02,083225,Rotar; Vladimir,3,0,34,31
1656923864938,MATH 193A,A03,083781,Rotar; Vladimir,1,0,34,33
1656923864938,MATH 193A,A04,083782,Rotar; Vladimir,6,0,34,28
1656923864938,MATH 193A,A05,093482,Rotar; Vladimir,6,0,34,28
1656923870966,MATH 197,001,091859,McAuley; Julian John,9999,0,9999,0
1656923870966,MATH 197,002,095566,Kedlaya; Kiran S.,9997,0,9999,2
1656923870966,MATH 197,003,095567,Xiao; Ming,9999,0,9999,0
1656923870966,MATH 197,004,095571,Perols; Johan Lars,9998,0,9999,1
1656923878033,COGS 9,A01,083615,Shannon; Kyle Michael,7,0,75,68
1656923884060,COGS 11,A01,083617,Boyle; Mary E. T.,19,0,48,29
1656923890088,COGS 13,A01,083071,Bastos; Amalia Pinkusfeld,9,0,71,62
1656923896120,COGS 14A,A01,092681,Semenuks; Arturs,0,1,100,100
1656923902145,COGS 14B,A01,083073,Cheng; Tzu-Han,5,0,63,58
1656923908170,COGS 17,A01,092677,Semenuks; Arturs,4,0,81,77
1656923914195,COGS 100,A01,083619,Allen; Michael Gordon,15,0,70,55
1656923920220,COGS 101A,A01,083621,Davis; Joshua Daniel,9,0,68,59
1656923926247,COGS 101B,A01,091572,Allen; Michael Gordon,8,0,65,57
1656923932272,COGS 101C,A01,083625,Delgado; Tania,17,0,35,18
1656923938302,COGS 107A,A01,083627,Boyle; Mary E. T.,13,0,60,47
1656923944326,COGS 118A,A01,083075,Gupta; Anjum,15,0,76,61
1656923950353,CSE 3,A50,083646,Miranda; Gregory Joseph,22,0,50,28
1656923956376,CSE 8A,A50,083650,Miranda; Gregory Joseph,17,1,56,39
1656923962401,CSE 11,A01,083080,Cao; Yingjun,4,15,40,36
1656923968431,CSE 12,A01,083652,Krause-Levy; Sophia Louisa,20,1,120,100
1656923974456,CSE 15L,A01,083654,Morris; Justin Loren,8,0,50,42
1656923974456,CSE 15L,A02,083655,Morris; Justin Loren,8,0,50,42
1656923980484,CSE 20,A01,083657,Tran; Khoa Dang,37,0,80,43
1656923986510,CSE 21,A01,095574,Bach; Quang Tran,21,0,48,27
1656923992548,CSE 30,A01,083084,Eldon; John,4,0,80,76
1656923992548,CSE 30,B01,095061,Bhaskar; Nishant,6,0,50,44
1656923998572,CSE 100,A01,083659,Cao; Yingjun,3,4,70,67
1656924004599,CSE 134B,A01,083661,Powell; Thomas Allan,19,0,100,81
1656924010628,CSE 140,A01,083663,Gungor; Onat,14,0,85,71
1656924016652,CSE 140L,A01,083088,Eldon; John,16,0,100,84
1656924022675,CSE 175,A01,083665,Kumar; Rakesh,3,0,25,22
1656924028699,CSE 190,A00,092507,Dubnov; Shlomo,7,0,20,13
1656924034722,ECE 45,A01,083139,Congero; Spencer William,5,0,75,70
1656924040752,ECE 65,A50,083695,Saad; Andrew S,12,0,30,18
1656924040752,ECE 65,A51,095125,Saad; Andrew S,25,0,26,1
1656924046777,ECE 109,A01,091882,Touri; Behrouz,16,0,70,54
1656924052798,ECE 180,A00,083140,Abi Samra; Nicholas Camill,0,0,30,30
1656924052798,ECE 180,B00,083141,Abi Samra; Nicholas Camill,0,0,30,30
1656924058824,MATH 10A,A01,083735,Patchell; Gregory David,1,0,30,29
1656924058824,MATH 10A,A02,083736,Patchell; Gregory David,20,0,30,10
1656924058824,MATH 10A,A03,083737,Patchell; Gregory David,15,0,30,15
1656924064850,MATH 10B,A01,083207,Lim; Seonhee,7,0,34,27
1656924064850,MATH 10B,A02,083208,Lim; Seonhee,9,0,35,26
1656924064850,MATH 10B,A03,093472,Lim; Seonhee,4,0,34,30
1656924064850,MATH 10B,B01,083739,Sinha; Shubham,9,0,30,21
1656924070878,MATH 18,A01,083743,Cinel; Cameron Alexander,6,0,30,24
1656924070878,MATH 18,A02,083744,Cinel; Cameron Alexander,15,0,30,15
1656924070878,MATH 18,A03,083745,Cinel; Cameron Alexander,8,0,30,22
1656924070878,MATH 18,B01,083748,Rideout; David Porter,4,0,37,33
1656924070878,MATH 18,B02,083749,Rideout; David Porter,3,0,36,33
1656924070878,MATH 18,B03,083750,Rideout; David Porter,2,0,37,35
1656924070878,MATH 18,B04,083751,Rideout; David Porter,5,0,36,31
1656924070878,MATH 18,B05,093473,Rideout; David Porter,4,0,36,32
1656924070878,MATH 18,B06,093474,Rideout; David Porter,5,0,36,31
1656924076903,MATH 20A,A01,083754,Zheng; Zequn,12,0,40,28
1656924082928,MATH 20B,A01,083756,Briones; Jor-el Thomas Caparas,1,0,36,35
1656924082928,MATH 20B,A02,083757,Briones; Jor-el Thomas Caparas,1,0,36,35
1656924082928,MATH 20B,A03,093475,Briones; Jor-el Thomas Caparas,0,0,36,36
1656924088953,MATH 20C,A01,083760,Briones; Jor-el Thomas Caparas,1,0,35,34
1656924088953,MATH 20C,A02,083761,Briones; Jor-el Thomas Caparas,8,0,35,27
1656924088953,MATH 20C,A03,093476,Briones; Jor-el Thomas Caparas,0,1,36,36
1656924088953,MATH 20C,B01,083762,Bach; Quang Tran,0,0,30,30
1656924094978,MATH 20D,A01,083765,Tran; Brian Kha,4,0,30,26
1656924094978,MATH 20D,A02,083766,Tran; Brian Kha,4,0,30,26
1656924094978,MATH 20D,A03,083767,Tran; Brian Kha,3,0,30,27
1656924101005,MATH 20E,A01,083771,Ganguly; Soumya,5,0,32,27
1656924101005,MATH 20E,A02,083772,Ganguly; Soumya,6,0,32,26
1656924101005,MATH 20E,B01,083773,Ciotti; Benjamin,18,0,35,17
1656924101005,MATH 20E,B02,083774,Ciotti; Benjamin,17,0,35,18
1656924107032,MATH 103A,A01,083777,Greenfeld; Be'Eri,2,0,36,34
1656924107032,MATH 103A,A02,083778,Greenfeld; Be'Eri,5,0,36,31
1656924107032,MATH 103A,A03,093561,Greenfeld; Be'Eri,4,0,36,32
1656924107032,MATH 103A,B01,083779,Greenfeld; Be'Eri,6,0,36,30
1656924107032,MATH 103A,B02,083780,Greenfeld; Be'Eri,2,0,36,34
1656924107032,MATH 103A,B03,093562,Greenfeld; Be'Eri,2,0,36,34
1656924113063,MATH 105,A01,085443,Carter; Anne Toulson,13,0,35,22
1656924113063,MATH 105,A02,093477,Carter; Anne Toulson,20,0,35,15
1656924119089,MATH 109,A01,083213,Ganzberger; Geoffrey Michael,2,0,34,32
1656924119089,MATH 109,A02,083214,Ganzberger; Geoffrey Michael,2,0,34,32
1656924119089,MATH 109,A03,093478,Ganzberger; Geoffrey Michael,1,0,34,33
1656924119089,MATH 109,B01,083215,Ganzberger; Geoffrey Michael,1,0,32,31
1656924119089,MATH 109,B02,083216,Ganzberger; Geoffrey Michael,1,0,32,31
1656924119089,MATH 109,B03,093479,Ganzberger; Geoffrey Michael,6,0,32,26
1656924125122,MATH 142A,A01,083219,Chow; Bennett,6,0,32,26
1656924125122,MATH 142A,A02,083220,Chow; Bennett,10,0,32,22
1656924125122,MATH 142A,A03,093480,Chow; Bennett,7,0,32,25
1656924125122,MATH 142A,B03,093481,Chow; Bennett,7,0,32,25
1656924125122,MATH 142A,B04,093558,Chow; Bennett,11,0,32,21
1656924125122,MATH 142A,B05,093559,Chow; Bennett,6,0,32,26
1656924131157,MATH 193A,A01,083224,Rotar; Vladimir,7,0,34,27
1656924131157,MATH 193A,A02,083225,Rotar; Vladimir,3,0,34,31
1656924131157,MATH 193A,A03,083781,Rotar; Vladimir,1,0,34,33
1656924131157,MATH 193A,A04,083782,Rotar; Vladimir,6,0,34,28
1656924131157,MATH 193A,A05,093482,Rotar; Vladimir,6,0,34,28
1656924137180,MATH 197,001,091859,McAuley; Julian John,9999,0,9999,0
1656924137180,MATH 197,002,095566,Kedlaya; Kiran S.,9997,0,9999,2
1656924137180,MATH 197,003,095567,Xiao; Ming,9999,0,9999,0
1656924137180,MATH 197,004,095571,Perols; Johan Lars,9998,0,9999,1
1656924144248,COGS 9,A01,083615,Shannon; Kyle Michael,7,0,75,68
1656924150272,COGS 11,A01,083617,Boyle; Mary E. T.,19,0,48,29
1656924156297,COGS 13,A01,083071,Bastos; Amalia Pinkusfeld,9,0,71,62
1656924162321,COGS 14A,A01,092681,Semenuks; Arturs,0,1,100,100
1656924168345,COGS 14B,A01,083073,Cheng; Tzu-Han,5,0,63,58
1656924174368,COGS 17,A01,092677,Semenuks; Arturs,4,0,81,77
1656924180392,COGS 100,A01,083619,Allen; Michael Gordon,15,0,70,55
1656924186416,COGS 101A,A01,083621,Davis; Joshua Daniel,9,0,68,59
1656924192446,COGS 101B,A01,091572,Allen; Michael Gordon,8,0,65,57
1656924198475,COGS 101C,A01,083625,Delgado; Tania,17,0,35,18
1656924204499,COGS 107A,A01,083627,Boyle; Mary E. T.,13,0,60,47
1656924210523,COGS 118A,A01,083075,Gupta; Anjum,15,0,76,61
1656924216549,CSE 3,A50,083646,Miranda; Gregory Joseph,22,0,50,28
1656924222578,CSE 8A,A50,083650,Miranda; Gregory Joseph,17,1,56,39
1656924228602,CSE 11,A01,083080,Cao; Yingjun,4,15,40,36
1656924234626,CSE 12,A01,083652,Krause-Levy; Sophia Louisa,20,1,120,100
1656924240650,CSE 15L,A01,083654,Morris; Justin Loren,8,0,50,42
1656924240650,CSE 15L,A02,083655,Morris; Justin Loren,8,0,50,42
1656924246677,CSE 20,A01,083657,Tran; Khoa Dang,37,0,80,43
1656924252700,CSE 21,A01,095574,Bach; Quang Tran,21,0,48,27
1656924258724,CSE 30,A01,083084,Eldon; John,4,0,80,76
1656924258724,CSE 30,B01,095061,Bhaskar; Nishant,6,0,50,44
1656924264837,CSE 100,A01,083659,Cao; Yingjun,3,4,70,67
1656924270864,CSE 134B,A01,083661,Powell; Thomas Allan,19,0,100,81
1656924276891,CSE 140,A01,083663,Gungor; Onat,14,0,85,71
1656924282914,CSE 140L,A01,083088,Eldon; John,16,0,100,84
1656924288937,CSE 175,A01,083665,Kumar; Rakesh,3,0,25,22
1656924294958,CSE 190,A00,092507,Dubnov; Shlomo,7,0,20,13
1656924300982,ECE 45,A01,083139,Congero; Spencer William,5,0,75,70
1656924307007,ECE 65,A50,083695,Saad; Andrew S,12,0,30,18
1656924307007,ECE 65,A51,095125,Saad; Andrew S,25,0,26,1
1656924313034,ECE 109,A01,091882,Touri; Behrouz,16,0,70,54
1656924319056,ECE 180,A00,083140,Abi Samra; Nicholas Camill,0,0,30,30
1656924319056,ECE 180,B00,083141,Abi Samra; Nicholas Camill,0,0,30,30
1656924325080,MATH 10A,A01,083735,Patchell; Gregory David,1,0,30,29
1656924325080,MATH 10A,A02,083736,Patchell; Gregory David,20,0,30,10
1656924325080,MATH 10A,A03,083737,Patchell; Gregory David,15,0,30,15
1656924331114,MATH 10B,A01,083207,Lim; Seonhee,7,0,34,27
1656924331114,MATH 10B,A02,083208,Lim; Seonhee,9,0,35,26
1656924331114,MATH 10B,A03,093472,Lim; Seonhee,4,0,34,30
1656924331114,MATH 10B,B01,083739,Sinha; Shubham,9,0,30,21
1656924337144,MATH 18,A01,083743,Cinel; Cameron Alexander,6,0,30,24
1656924337144,MATH 18,A02,083744,Cinel; Cameron Alexander,15,0,30,15
1656924337144,MATH 18,A03,083745,Cinel; Cameron Alexander,8,0,30,22
1656924337144,MATH 18,B01,083748,Rideout; David Porter,4,0,37,33
1656924337144,MATH 18,B02,083749,Rideout; David Porter,3,0,36,33
1656924337144,MATH 18,B03,083750,Rideout; David Porter,2,0,37,35
1656924337144,MATH 18,B04,083751,Rideout; David Porter,5,0,36,31
1656924337144,MATH 18,B05,093473,Rideout; David Porter,4,0,36,32
1656924337144,MATH 18,B06,093474,Rideout; David Porter,5,0,36,31
1656924343166,MATH 20A,A01,083754,Zheng; Zequn,12,0,40,28
1656924349190,MATH 20B,A01,083756,Briones; Jor-el Thomas Caparas,1,0,36,35
1656924349190,MATH 20B,A02,083757,Briones; Jor-el Thomas Caparas,1,0,36,35
1656924349190,MATH 20B,A03,093475,Briones; Jor-el Thomas Caparas,0,0,36,36
1656924355214,MATH 20C,A01,083760,Briones; Jor-el Thomas Caparas,1,0,35,34
1656924355214,MATH 20C,A02,083761,Briones; Jor-el Thomas Caparas,8,0,35,27
1656924355214,MATH 20C,A03,093476,Briones; Jor-el Thomas Caparas,0,1,36,36
1656924355214,MATH 20C,B01,083762,Bach; Quang Tran,0,0,30,30
1656924361243,MATH 20D,A01,083765,Tran; Brian Kha,4,0,30,26
1656924361243,MATH 20D,A02,083766,Tran; Brian Kha,4,0,30,26
1656924361243,MATH 20D,A03,083767,Tran; Brian Kha,3,0,30,27
1656924367271,MATH 20E,A01,083771,Ganguly; Soumya,5,0,32,27
1656924367271,MATH 20E,A02,083772,Ganguly; Soumya,6,0,32,26
1656924367271,MATH 20E,B01,083773,Ciotti; Benjamin,18,0,35,17
1656924367271,MATH 20E,B02,083774,Ciotti; Benjamin,17,0,35,18
1656924373298,MATH 103A,A01,083777,Greenfeld; Be'Eri,2,0,36,34
1656924373298,MATH 103A,A02,083778,Greenfeld; Be'Eri,5,0,36,31
1656924373298,MATH 103A,A03,093561,Greenfeld; Be'Eri,4,0,36,32
1656924373298,MATH 103A,B01,083779,Greenfeld; Be'Eri,6,0,36,30
1656924373298,MATH 103A,B02,083780,Greenfeld; Be'Eri,2,0,36,34
1656924373298,MATH 103A,B03,093562,Greenfeld; Be'Eri,2,0,36,34
1656924379328,MATH 105,A01,085443,Carter; Anne Toulson,13,0,35,22
1656924379328,MATH 105,A02,093477,Carter; Anne Toulson,20,0,35,15
1656924385358,MATH 109,A01,083213,Ganzberger; Geoffrey Michael,2,0,34,32
1656924385358,MATH 109,A02,083214,Ganzberger; Geoffrey Michael,2,0,34,32
1656924385358,MATH 109,A03,093478,Ganzberger; Geoffrey Michael,1,0,34,33
1656924385358,MATH 109,B01,083215,Ganzberger; Geoffrey Michael,1,0,32,31
1656924385358,MATH 109,B02,083216,Ganzberger; Geoffrey Michael,1,0,32,31
1656924385358,MATH 109,B03,093479,Ganzberger; Geoffrey Michael,6,0,32,26
1656924391388,MATH 142A,A01,083219,Chow; Bennett,6,0,32,26
1656924391388,MATH 142A,A02,083220,Chow; Bennett,10,0,32,22
1656924391388,MATH 142A,A03,093480,Chow; Bennett,7,0,32,25
1656924391388,MATH 142A,B03,093481,Chow; Bennett,7,0,32,25
1656924391388,MATH 142A,B04,093558,Chow; Bennett,11,0,32,21
1656924391388,MATH 142A,B05,093559,Chow; Bennett,6,0,32,26
1656924397410,MATH 193A,A01,083224,Rotar; Vladimir,7,0,34,27
1656924397410,MATH 193A,A02,083225,Rotar; Vladimir,3,0,34,31
1656924397410,MATH 193A,A03,083781,Rotar; Vladimir,1,0,34,33
1656924397410,MATH 193A,A04,083782,Rotar; Vladimir,6,0,34,28
1656924397410,MATH 193A,A05,093482,Rotar; Vladimir,6,0,34,28
1656924403436,MATH 197,001,091859,McAuley; Julian John,9999,0,9999,0
1656924403436,MATH 197,002,095566,Kedlaya; Kiran S.,9997,0,9999,2
1656924403436,MATH 197,003,095567,Xiao; Ming,9999,0,9999,0
1656924403436,MATH 197,004,095571,Perols; Johan Lars,9998,0,9999,1
1656924410500,COGS 9,A01,083615,Shannon; Kyle Michael,7,0,75,68
1656924416531,COGS 11,A01,083617,Boyle; Mary E. T.,19,0,48,29
1656924422560,COGS 13,A01,083071,Bastos; Amalia Pinkusfeld,9,0,71,62
1656924428589,COGS 14A,A01,092681,Semenuks; Arturs,0,1,100,100
1656924434612,COGS 14B,A01,083073,Cheng; Tzu-Han,5,0,63,58
1656924440636,COGS 17,A01,092677,Semenuks; Arturs,4,0,81,77
1656924446658,COGS 100,A01,083619,Allen; Michael Gordon,15,0,70,55
1656924452682,COGS 101A,A01,083621,Davis; Joshua Daniel,9,0,68,59
1656924458709,COGS 101B,A01,091572,Allen; Michael Gordon,8,0,65,57
1656924464733,COGS 101C,A01,083625,Delgado; Tania,17,0,35,18
1656924470756,COGS 107A,A01,083627,Boyle; Mary E. T.,13,0,60,47
1656924476779,COGS 118A,A01,083075,Gupta; Anjum,15,0,76,61
1656924482803,CSE 3,A50,083646,Miranda; Gregory Joseph,22,0,50,28
1656924488828,CSE 8A,A50,083650,Miranda; Gregory Joseph,17,1,56,39
1656924494851,CSE 11,A01,083080,Cao; Yingjun,4,15,40,36
1656924500873,CSE 12,A01,083652,Krause-Levy; Sophia Louisa,20,1,120,100
1656924506911,CSE 15L,A01,083654,Morris; Justin Loren,8,0,50,42
1656924506911,CSE 15L,A02,083655,Morris; Justin Loren,8,0,50,42
1656924512938,CSE 20,A01,083657,Tran; Khoa Dang,37,0,80,43
1656924518960,CSE 21,A01,095574,Bach; Quang Tran,21,0,48,27
1656924524984,CSE 30,A01,083084,Eldon; John,4,0,80,76
1656924524984,CSE 30,B01,095061,Bhaskar; Nishant,6,0,50,44
1656924531011,CSE 100,A01,083659,Cao; Yingjun,3,4,70,67
1656924537037,CSE 134B,A01,083661,Powell; Thomas Allan,19,0,100,81
1656924543064,CSE 140,A01,083663,Gungor; Onat,14,0,85,71
1656924549090,CSE 140L,A01,083088,Eldon; John,16,0,100,84
1656924555125,CSE 175,A01,083665,Kumar; Rakesh,3,0,25,22
1656924561147,CSE 190,A00,092507,Dubnov; Shlomo,7,0,20,13
1656924567174,ECE 45,A01,083139,Congero; Spencer William,5,0,75,70
1656924573203,ECE 65,A50,083695,Saad; Andrew S,12,0,30,18
1656924573203,ECE 65,A51,095125,Saad; Andrew S,25,0,26,1
1656924579226,ECE 109,A01,091882,Touri; Behrouz,16,0,70,54
1656924585250,ECE 180,A00,083140,Abi Samra; Nicholas Camill,0,0,30,30
1656924585250,ECE 180,B00,083141,Abi Samra; Nicholas Camill,0,0,30,30
1656924591273,MATH 10A,A01,083735,Patchell; Gregory David,1,0,30,29
1656924591273,MATH 10A,A02,083736,Patchell; Gregory David,20,0,30,10
1656924591273,MATH 10A,A03,083737,Patchell; Gregory David,15,0,30,15
1656924597296,MATH 10B,A01,083207,Lim; Seonhee,7,0,34,27
1656924597296,MATH 10B,A02,083208,Lim; Seonhee,9,0,35,26
1656924597296,MATH 10B,A03,093472,Lim; Seonhee,4,0,34,30
1656924597296,MATH 10B,B01,083739,Sinha; Shubham,9,0,30,21
1656924603322,MATH 18,A01,083743,Cinel; Cameron Alexander,6,0,30,24
1656924603322,MATH 18,A02,083744,Cinel; Cameron Alexander,15,0,30,15
1656924603322,MATH 18,A03,083745,Cinel; Cameron Alexander,8,0,30,22
1656924603322,MATH 18,B01,083748,Rideout; David Porter,4,0,37,33
1656924603322,MATH 18,B02,083749,Rideout; David Porter,3,0,36,33
1656924603322,MATH 18,B03,083750,Rideout; David Porter,2,0,37,35
1656924603322,MATH 18,B04,083751,Rideout; David Porter,5,0,36,31
1656924603322,MATH 18,B05,093473,Rideout; David Porter,4,0,36,32
1656924603322,MATH 18,B06,093474,Rideout; David Porter,5,0,36,31
1656924609345,MATH 20A,A01,083754,Zheng; Zequn,12,0,40,28
1656924615369,MATH 20B,A01,083756,Briones; Jor-el Thomas Caparas,1,0,36,35
1656924615369,MATH 20B,A02,083757,Briones; Jor-el Thomas Caparas,1,0,36,35
1656924615369,MATH 20B,A03,093475,Briones; Jor-el Thomas Caparas,0,0,36,36
1656924621394,MATH 20C,A01,083760,Briones; Jor-el Thomas Caparas,1,0,35,34
1656924621394,MATH 20C,A02,083761,Briones; Jor-el Thomas Caparas,8,0,35,27
1656924621394,MATH 20C,A03,093476,Briones; Jor-el Thomas Caparas,0,1,36,36
1656924621394,MATH 20C,B01,083762,Bach; Quang Tran,0,0,30,30
1656924627422,MATH 20D,A01,083765,Tran; Brian Kha,4,0,30,26
1656924627422,MATH 20D,A02,083766,Tran; Brian Kha,4,0,30,26
1656924627422,MATH 20D,A03,083767,Tran; Brian Kha,3,0,30,27
1656924633447,MATH 20E,A01,083771,Ganguly; Soumya,5,0,32,27
1656924633447,MATH 20E,A02,083772,Ganguly; Soumya,6,0,32,26
1656924633447,MATH 20E,B01,083773,Ciotti; Benjamin,18,0,35,17
1656924633447,MATH 20E,B02,083774,Ciotti; Benjamin,17,0,35,18
1656924639472,MATH 103A,A01,083777,Greenfeld; Be'Eri,2,0,36,34
1656924639472,MATH 103A,A02,083778,Greenfeld; Be'Eri,5,0,36,31
1656924639472,MATH 103A,A03,093561,Greenfeld; Be'Eri,4,0,36,32
1656924639472,MATH 103A,B01,083779,Greenfeld; Be'Eri,6,0,36,30
1656924639472,MATH 103A,B02,083780,Greenfeld; Be'Eri,2,0,36,34
1656924639472,MATH 103A,B03,093562,Greenfeld; Be'Eri,2,0,36,34
1656924645496,MATH 105,A01,085443,Carter; Anne Toulson,13,0,35,22
1656924645496,MATH 105,A02,093477,Carter; Anne Toulson,20,0,35,15
1656924651523,MATH 109,A01,083213,Ganzberger; Geoffrey Michael,2,0,34,32
1656924651523,MATH 109,A02,083214,Ganzberger; Geoffrey Michael,2,0,34,32
1656924651523,MATH 109,A03,093478,Ganzberger; Geoffrey Michael,1,0,34,33
1656924651523,MATH 109,B01,083215,Ganzberger; Geoffrey Michael,1,0,32,31
1656924651523,MATH 109,B02,083216,Ganzberger; Geoffrey Michael,1,0,32,31
1656924651523,MATH 109,B03,093479,Ganzberger; Geoffrey Michael,6,0,32,26
1656924657551,MATH 142A,A01,083219,Chow; Bennett,6,0,32,26
1656924657551,MATH 142A,A02,083220,Chow; Bennett,10,0,32,22
1656924657551,MATH 142A,A03,093480,Chow; Bennett,7,0,32,25
1656924657551,MATH 142A,B03,093481,Chow; Bennett,7,0,32,25
1656924657551,MATH 142A,B04,093558,Chow; Bennett,11,0,32,21
1656924657551,MATH 142A,B05,093559,Chow; Bennett,6,0,32,26
1656924663573,MATH 193A,A01,083224,Rotar; Vladimir,7,0,34,27
1656924663573,MATH 193A,A02,083225,Rotar; Vladimir,3,0,34,31
1656924663573,MATH 193A,A03,083781,Rotar; Vladimir,1,0,34,33
1656924663573,MATH 193A,A04,083782,Rotar; Vladimir,6,0,34,28
1656924663573,MATH 193A,A05,093482,Rotar; Vladimir,6,0,34,28
1656924669597,MATH 197,001,091859,McAuley; Julian John,9999,0,9999,0
1656924669597,MATH 197,002,095566,Kedlaya; Kiran S.,9997,0,9999,2
1656924669597,MATH 197,003,095567,Xiao; Ming,9999,0,9999,0
1656924669597,MATH 197,004,095571,Perols; Johan Lars,9998,0,9999,1
1656924676652,COGS 9,A01,083615,Shannon; Kyle Michael,7,0,75,68
1656924682676,COGS 11,A01,083617,Boyle; Mary E. T.,19,0,48,29
1656924688705,COGS 13,A01,083071,Bastos; Amalia Pinkusfeld,9,0,71,62
1656924694728,COGS 14A,A01,092681,Semenuks; Arturs,0,1,100,100
1656924700754,COGS 14B,A01,083073,Cheng; Tzu-Han,5,0,63,58
1656924706781,COGS 17,A01,092677,Semenuks; Arturs,4,0,81,77
1656924712808,COGS 100,A01,083619,Allen; Michael Gordon,15,0,70,55
1656924718830,COGS 101A,A01,083621,Davis; Joshua Daniel,9,0,68,59
1656924724853,COGS 101B,A01,091572,Allen; Michael Gordon,8,0,65,57
1656924730880,COGS 101C,A01,083625,Delgado; Tania,17,0,35,18
1656924736904,COGS 107A,A01,083627,Boyle; Mary E. T.,13,0,60,47
1656924742927,COGS 118A,A01,083075,Gupta; Anjum,15,0,76,61
1656924748954,CSE 3,A50,083646,Miranda; Gregory Joseph,22,0,50,28
1656924754976,CSE 8A,A50,083650,Miranda; Gregory Joseph,17,1,56,39
1656924761000,CSE 11,A01,083080,Cao; Yingjun,4,15,40,36
1656924767024,CSE 12,A01,083652,Krause-Levy; Sophia Louisa,20,1,120,100
1656924773049,CSE 15L,A01,083654,Morris; Justin Loren,8,0,50,42
1656924773049,CSE 15L,A02,083655,Morris; Justin Loren,8,0,50,42
1656924779075,CSE 20,A01,083657,Tran; Khoa Dang,37,0,80,43
1656924785101,CSE 21,A01,095574,Bach; Quang Tran,21,0,48,27
1656924791129,CSE 30,A01,083084,Eldon; John,4,0,80,76
1656924791129,CSE 30,B01,095061,Bhaskar; Nishant,6,0,50,44
1656924797155,CSE 100,A01,083659,Cao; Yingjun,3,4,70,67
1656924803182,CSE 134B,A01,083661,Powell; Thomas Allan,19,0,100,81
1656924809206,CSE 140,A01,083663,Gungor; Onat,14,0,85,71
1656924815229,CSE 140L,A01,083088,Eldon; John,16,0,100,84
1656924821255,CSE 175,A01,083665,Kumar; Rakesh,3,0,25,22
1656924827282,CSE 190,A00,092507,Dubnov; Shlomo,7,0,20,13
1656924833308,ECE 45,A01,083139,Congero; Spencer William,5,0,75,70
1656924839336,ECE 65,A50,083695,Saad; Andrew S,12,0,30,18
1656924839336,ECE 65,A51,095125,Saad; Andrew S,25,0,26,1
1656924845362,ECE 109,A01,091882,Touri; Behrouz,16,0,70,54
1656924851385,ECE 180,A00,083140,Abi Samra; Nicholas Camill,0,0,30,30
1656924851385,ECE 180,B00,083141,Abi Samra; Nicholas Camill,0,0,30,30
1656924857410,MATH 10A,A01,083735,Patchell; Gregory David,1,0,30,29
1656924857410,MATH 10A,A02,083736,Patchell; Gregory David,20,0,30,10
1656924857410,MATH 10A,A03,083737,Patchell; Gregory David,15,0,30,15
1656924863526,MATH 10B,A01,083207,Lim; Seonhee,7,0,34,27
1656924863526,MATH 10B,A02,083208,Lim; Seonhee,9,0,35,26
1656924863526,MATH 10B,A03,093472,Lim; Seonhee,4,0,34,30
1656924863526,MATH 10B,B01,083739,Sinha; Shubham,9,0,30,21
1656924869554,MATH 18,A01,083743,Cinel; Cameron Alexander,6,0,30,24
1656924869554,MATH 18,A02,083744,Cinel; Cameron Alexander,15,0,30,15
1656924869554,MATH 18,A03,083745,Cinel; Cameron Alexander,8,0,30,22
1656924869554,MATH 18,B01,083748,Rideout; David Porter,4,0,37,33
1656924869554,MATH 18,B02,083749,Rideout; David Porter,3,0,36,33
1656924869554,MATH 18,B03,083750,Rideout; David Porter,2,0,37,35
1656924869554,MATH 18,B04,083751,Rideout; David Porter,5,0,36,31
1656924869554,MATH 18,B05,093473,Rideout; David Porter,4,0,36,32
1656924869554,MATH 18,B06,093474,Rideout; David Porter,5,0,36,31
1656924875583,MATH 20A,A01,083754,Zheng; Zequn,12,0,40,28
1656924881612,MATH 20B,A01,083756,Briones; Jor-el Thomas Caparas,1,0,36,35
1656924881612,MATH 20B,A02,083757,Briones; Jor-el Thomas Caparas,1,0,36,35
1656924881612,MATH 20B,A03,093475,Briones; Jor-el Thomas Caparas,0,0,36,36
1656924887639,MATH 20C,A01,083760,Briones; Jor-el Thomas Caparas,1,0,35,34
1656924887639,MATH 20C,A02,083761,Briones; Jor-el Thomas Caparas,8,0,35,27
1656924887639,MATH 20C,A03,093476,Briones; Jor-el Thomas Caparas,0,1,36,36
1656924887639,MATH 20C,B01,083762,Bach; Quang Tran,0,0,30,30
1656924893670,MATH 20D,A01,083765,Tran; Brian Kha,4,0,30,26
1656924893670,MATH 20D,A02,083766,Tran; Brian Kha,4,0,30,26
1656924893670,MATH 20D,A03,083767,Tran; Brian Kha,3,0,30,27
1656924899698,MATH 20E,A01,083771,Ganguly; Soumya,5,0,32,27
1656924899698,MATH 20E,A02,083772,Ganguly; Soumya,6,0,32,26
1656924899698,MATH 20E,B01,083773,Ciotti; Benjamin,18,0,35,17
1656924899698,MATH 20E,B02,083774,Ciotti; Benjamin,17,0,35,18
1656924905730,MATH 103A,A01,083777,Greenfeld; Be'Eri,2,0,36,34
1656924905730,MATH 103A,A02,083778,Greenfeld; Be'Eri,5,0,36,31
1656924905730,MATH 103A,A03,093561,Greenfeld; Be'Eri,4,0,36,32
1656924905730,MATH 103A,B01,083779,Greenfeld; Be'Eri,6,0,36,30
1656924905730,MATH 103A,B02,083780,Greenfeld; Be'Eri,2,0,36,34
1656924905730,MATH 103A,B03,093562,Greenfeld; Be'Eri,2,0,36,34
1656924911760,MATH 105,A01,085443,Carter; Anne Toulson,13,0,35,22
1656924911760,MATH 105,A02,093477,Carter; Anne Toulson,20,0,35,15
1656924917783,MATH 109,A01,083213,Ganzberger; Geoffrey Michael,2,0,34,32
1656924917783,MATH 109,A02,083214,Ganzberger; Geoffrey Michael,2,0,34,32
1656924917783,MATH 109,A03,093478,Ganzberger; Geoffrey Michael,1,0,34,33
1656924917783,MATH 109,B01,083215,Ganzberger; Geoffrey Michael,1,0,32,31
1656924917783,MATH 109,B02,083216,Ganzberger; Geoffrey Michael,1,0,32,31
1656924917783,MATH 109,B03,093479,Ganzberger; Geoffrey Michael,6,0,32,26
1656924923817,MATH 142A,A01,083219,Chow; Bennett,6,0,32,26
1656924923817,MATH 142A,A02,083220,Chow; Bennett,10,0,32,22
1656924923817,MATH 142A,A03,093480,Chow; Bennett,7,0,32,25
1656924923817,MATH 142A,B03,093481,Chow; Bennett,7,0,32,25
1656924923817,MATH 142A,B04,093558,Chow; Bennett,11,0,32,21
1656924923817,MATH 142A,B05,093559,Chow; Bennett,6,0,32,26
1656924929849,MATH 193A,A01,083224,Rotar; Vladimir,7,0,34,27
1656924929849,MATH 193A,A02,083225,Rotar; Vladimir,3,0,34,31
1656924929849,MATH 193A,A03,083781,Rotar; Vladimir,1,0,34,33
1656924929849,MATH 193A,A04,083782,Rotar; Vladimir,6,0,34,28
1656924929849,MATH 193A,A05,093482,Rotar; Vladimir,6,0,34,28
1656924935882,MATH 197,001,091859,McAuley; Julian John,9999,0,9999,0
1656924935882,MATH 197,002,095566,Kedlaya; Kiran S.,9997,0,9999,2
1656924935882,MATH 197,003,095567,Xiao; Ming,9999,0,9999,0
1656924935882,MATH 197,004,095571,Perols; Johan Lars,9998,0,9999,1
1656924942993,COGS 9,A01,083615,Shannon; Kyle Michael,7,0,75,68
1656924949025,COGS 11,A01,083617,Boyle; Mary E. T.,19,0,48,29
1656924955049,COGS 13,A01,083071,Bastos; Amalia Pinkusfeld,9,0,71,62
1656924961074,COGS 14A,A01,092681,Semenuks; Arturs,0,1,100,100
1656924967099,COGS 14B,A01,083073,Cheng; Tzu-Han,5,0,63,58
1656924973122,COGS 17,A01,092677,Semenuks; Arturs,4,0,81,77
1656924979153,COGS 100,A01,083619,Allen; Michael Gordon,15,0,70,55
1656924985184,COGS 101A,A01,083621,Davis; Joshua Daniel,9,0,68,59
1656924991219,COGS 101B,A01,091572,Allen; Michael Gordon,8,0,65,57
1656924997244,COGS 101C,A01,083625,Delgado; Tania,17,0,35,18
1656925003273,COGS 107A,A01,083627,Boyle; Mary E. T.,13,0,60,47
1656925009303,COGS 118A,A01,083075,Gupta; Anjum,15,0,76,61
1656925015335,CSE 3,A50,083646,Miranda; Gregory Joseph,22,0,50,28
1656925021364,CSE 8A,A50,083650,Miranda; Gregory Joseph,17,1,56,39
1656925027389,CSE 11,A01,083080,Cao; Yingjun,4,15,40,36
1656925033419,CSE 12,A01,083652,Krause-Levy; Sophia Louisa,20,1,120,100
1656925039448,CSE 15L,A01,083654,Morris; Justin Loren,8,0,50,42
1656925039448,CSE 15L,A02,083655,Morris; Justin Loren,8,0,50,42
1656925045478,CSE 20,A01,083657,Tran; Khoa Dang,37,0,80,43
1656925051510,CSE 21,A01,095574,Bach; Quang Tran,21,0,48,27
1656925057537,CSE 30,A01,083084,Eldon; John,4,0,80,76
1656925057537,CSE 30,B01,095061,Bhaskar; Nishant,6,0,50,44
1656925063562,CSE 100,A01,083659,Cao; Yingjun,3,4,70,67
1656925069589,CSE 134B,A01,083661,Powell; Thomas Allan,19,0,100,81
1656925075614,CSE 140,A01,083663,Gungor; Onat,14,0,85,71
1656925081644,CSE 140L,A01,083088,Eldon; John,16,0,100,84
1656925087674,CSE 175,A01,083665,Kumar; Rakesh,3,0,25,22
1656925093698,CSE 190,A00,092507,Dubnov; Shlomo,7,0,20,13
1656925099728,ECE 45,A01,083139,Congero; Spencer William,5,0,75,70
1656925105761,ECE 65,A50,083695,Saad; Andrew S,12,0,30,18
1656925105761,ECE 65,A51,095125,Saad; Andrew S,25,0,26,1
1656925111792,ECE 109,A01,091882,Touri; Behrouz,16,0,70,54
1656925117819,ECE 180,A00,083140,Abi Samra; Nicholas Camill,0,0,30,30
1656925117819,ECE 180,B00,083141,Abi Samra; Nicholas Camill,0,0,30,30
1656925123847,MATH 10A,A01,083735,Patchell; Gregory David,1,0,30,29
1656925123847,MATH 10A,A02,083736,Patchell; Gregory David,20,0,30,10
1656925123847,MATH 10A,A03,083737,Patchell; Gregory David,15,0,30,15
1656925129876,MATH 10B,A01,083207,Lim; Seonhee,7,0,34,27
1656925129876,MATH 10B,A02,083208,Lim; Seonhee,9,0,35,26
1656925129876,MATH 10B,A03,093472,Lim; Seonhee,4,0,34,30
1656925129876,MATH 10B,B01,083739,Sinha; Shubham,9,0,30,21
1656925135904,MATH 18,A01,083743,Cinel; Cameron Alexander,6,0,30,24
1656925135904,MATH 18,A02,083744,Cinel; Cameron Alexander,15,0,30,15
1656925135904,MATH 18,A03,083745,Cinel; Cameron Alexander,8,0,30,22
1656925135904,MATH 18,B01,083748,Rideout; David Porter,4,0,37,33
1656925135904,MATH 18,B02,083749,Rideout; David Porter,3,0,36,33
1656925135904,MATH 18,B03,083750,Rideout; David Porter,2,0,37,35
1656925135904,MATH 18,B04,083751,Rideout; David Porter,5,0,36,31
1656925135904,MATH 18,B05,093473,Rideout; David Porter,4,0,36,32
1656925135904,MATH 18,B06,093474,Rideout; David Porter,5,0,36,31
1656925141932,MATH 20A,A01,083754,Zheng; Zequn,12,0,40,28
1656925147965,MATH 20B,A01,083756,Briones; Jor-el Thomas Caparas,1,0,36,35
1656925147965,MATH 20B,A02,083757,Briones; Jor-el Thomas Caparas,1,0,36,35
1656925147965,MATH 20B,A03,093475,Briones; Jor-el Thomas Caparas,0,0,36,36
1656925153999,MATH 20C,A01,083760,Briones; Jor-el Thomas Caparas,1,0,35,34
1656925153999,MATH 20C,A02,083761,Briones; Jor-el Thomas Caparas,8,0,35,27
1656925153999,MATH 20C,A03,093476,Briones; Jor-el Thomas Caparas,0,1,36,36
1656925153999,MATH 20C,B01,083762,Bach; Quang Tran,0,0,30,30
1656925160025,MATH 20D,A01,083765,Tran; Brian Kha,4,0,30,26
1656925160025,MATH 20D,A02,083766,Tran; Brian Kha,4,0,30,26
1656925160025,MATH 20D,A03,083767,Tran; Brian Kha,3,0,30,27
1656925166057,MATH 20E,A01,083771,Ganguly; Soumya,5,0,32,27
1656925166057,MATH 20E,A02,083772,Ganguly; Soumya,6,0,32,26
1656925166057,MATH 20E,B01,083773,Ciotti; Benjamin,18,0,35,17
1656925166057,MATH 20E,B02,083774,Ciotti; Benjamin,17,0,35,18
1656925172082,MATH 103A,A01,083777,Greenfeld; Be'Eri,2,0,36,34
1656925172082,MATH 103A,A02,083778,Greenfeld; Be'Eri,5,0,36,31
1656925172082,MATH 103A,A03,093561,Greenfeld; Be'Eri,4,0,36,32
1656925172082,MATH 103A,B01,083779,Greenfeld; Be'Eri,6,0,36,30
1656925172082,MATH 103A,B02,083780,Greenfeld; Be'Eri,2,0,36,34
1656925172082,MATH 103A,B03,093562,Greenfeld; Be'Eri,2,0,36,34
1656925178113,MATH 105,A01,085443,Carter; Anne Toulson,13,0,35,22
1656925178113,MATH 105,A02,093477,Carter; Anne Toulson,20,0,35,15
1656925184147,MATH 109,A01,083213,Ganzberger; Geoffrey Michael,2,0,34,32
1656925184147,MATH 109,A02,083214,Ganzberger; Geoffrey Michael,2,0,34,32
1656925184147,MATH 109,A03,093478,Ganzberger; Geoffrey Michael,1,0,34,33
1656925184147,MATH 109,B01,083215,Ganzberger; Geoffrey Michael,1,0,32,31
1656925184147,MATH 109,B02,083216,Ganzberger; Geoffrey Michael,1,0,32,31
1656925184147,MATH 109,B03,093479,Ganzberger; Geoffrey Michael,6,0,32,26
1656925190174,MATH 142A,A01,083219,Chow; Bennett,6,0,32,26
1656925190174,MATH 142A,A02,083220,Chow; Bennett,10,0,32,22
1656925190174,MATH 142A,A03,093480,Chow; Bennett,7,0,32,25
1656925190174,MATH 142A,B03,093481,Chow; Bennett,7,0,32,25
1656925190174,MATH 142A,B04,093558,Chow; Bennett,11,0,32,21
1656925190174,MATH 142A,B05,093559,Chow; Bennett,6,0,32,26
1656925196206,MATH 193A,A01,083224,Rotar; Vladimir,7,0,34,27
1656925196206,MATH 193A,A02,083225,Rotar; Vladimir,3,0,34,31
1656925196206,MATH 193A,A03,083781,Rotar; Vladimir,1,0,34,33
1656925196206,MATH 193A,A04,083782,Rotar; Vladimir,6,0,34,28
1656925196206,MATH 193A,A05,093482,Rotar; Vladimir,6,0,34,28
1656925202238,MATH 197,001,091859,McAuley; Julian John,9999,0,9999,0
1656925202238,MATH 197,002,095566,Kedlaya; Kiran S.,9997,0,9999,2
1656925202238,MATH 197,003,095567,Xiao; Ming,9999,0,9999,0
1656925202238,MATH 197,004,095571,Perols; Johan Lars,9998,0,9999,1
1656925209328,COGS 9,A01,083615,Shannon; Kyle Michael,7,0,75,68
1656925215352,COGS 11,A01,083617,Boyle; Mary E. T.,19,0,48,29
1656925221387,COGS 13,A01,083071,Bastos; Amalia Pinkusfeld,9,0,71,62
1656925227412,COGS 14A,A01,092681,Semenuks; Arturs,0,1,100,100
1656925233437,COGS 14B,A01,083073,Cheng; Tzu-Han,5,0,63,58
1656925239462,COGS 17,A01,092677,Semenuks; Arturs,4,0,81,77
1656925245489,COGS 100,A01,083619,Allen; Michael Gordon,15,0,70,55
1656925251528,COGS 101A,A01,083621,Davis; Joshua Daniel,9,0,68,59
1656925257553,COGS 101B,A01,091572,Allen; Michael Gordon,8,0,65,57
1656925263578,COGS 101C,A01,083625,Delgado; Tania,17,0,35,18
1656925269611,COGS 107A,A01,083627,Boyle; Mary E. T.,13,0,60,47
1656925275636,COGS 118A,A01,083075,Gupta; Anjum,15,0,76,61
1656925281679,CSE 3,A50,083646,Miranda; Gregory Joseph,22,0,50,28
1656925287701,CSE 8A,A50,083650,Miranda; Gregory Joseph,17,1,56,39
1656925293725,CSE 11,A01,083080,Cao; Yingjun,4,15,40,36
1656925299753,CSE 12,A01,083652,Krause-Levy; Sophia Louisa,20,1,120,100
1656925305776,CSE 15L,A01,083654,Morris; Justin Loren,8,0,50,42
1656925305776,CSE 15L,A02,083655,Morris; Justin Loren,8,0,50,42
1656925311811,CSE 20,A01,083657,Tran; Khoa Dang,37,0,80,43
1656925317839,CSE 21,A01,095574,Bach; Quang Tran,21,0,48,27
1656925323879,CSE 30,A01,083084,Eldon; John,4,0,80,76
1656925323879,CSE 30,B01,095061,Bhaskar; Nishant,6,0,50,44
1656925329903,CSE 100,A01,083659,Cao; Yingjun,3,4,70,67
1656925335934,CSE 134B,A01,083661,Powell; Thomas Allan,19,0,100,81
1656925341958,CSE 140,A01,083663,Gungor; Onat,14,0,85,71
1656925347981,CSE 140L,A01,083088,Eldon; John,16,0,100,84
1656925354005,CSE 175,A01,083665,Kumar; Rakesh,3,0,25,22
1656925360034,CSE 190,A00,092507,Dubnov; Shlomo,7,0,20,13
1656925366061,ECE 45,A01,083139,Congero; Spencer William,5,0,75,70
1656925372088,ECE 65,A50,083695,Saad; Andrew S,12,0,30,18
1656925372088,ECE 65,A51,095125,Saad; Andrew S,25,0,26,1
1656925378112,ECE 109,A01,091882,Touri; Behrouz,16,0,70,54
1656925384141,ECE 180,A00,083140,Abi Samra; Nicholas Camill,0,0,30,30
1656925384141,ECE 180,B00,083141,Abi Samra; Nicholas Camill,0,0,30,30
1656925390174,MATH 10A,A01,083735,Patchell; Gregory David,1,0,30,29
1656925390174,MATH 10A,A02,083736,Patchell; Gregory David,20,0,30,10
1656925390174,MATH 10A,A03,083737,Patchell; Gregory David,15,0,30,15
1656925396197,MATH 10B,A01,083207,Lim; Seonhee,7,0,34,27
1656925396197,MATH 10B,A02,083208,Lim; Seonhee,9,0,35,26
1656925396197,MATH 10B,A03,093472,Lim; Seonhee,4,0,34,30
1656925396197,MATH 10B,B01,083739,Sinha; Shubham,9,0,30,21
1656925402225,MATH 18,A01,083743,Cinel; Cameron Alexander,6,0,30,24
1656925402225,MATH 18,A02,083744,Cinel; Cameron Alexander,15,0,30,15
1656925402225,MATH 18,A03,083745,Cinel; Cameron Alexander,8,0,30,22
1656925402225,MATH 18,B01,083748,Rideout; David Porter,4,0,37,33
1656925402225,MATH 18,B02,083749,Rideout; David Porter,3,0,36,33
1656925402225,MATH 18,B03,083750,Rideout; David Porter,2,0,37,35
1656925402225,MATH 18,B04,083751,Rideout; David Porter,5,0,36,31
1656925402225,MATH 18,B05,093473,Rideout; David Porter,4,0,36,32
1656925402225,MATH 18,B06,093474,Rideout; David Porter,5,0,36,31
1656925408249,MATH 20A,A01,083754,Zheng; Zequn,12,0,40,28
1656925414289,MATH 20B,A01,083756,Briones; Jor-el Thomas Caparas,1,0,36,35
1656925414289,MATH 20B,A02,083757,Briones; Jor-el Thomas Caparas,1,0,36,35
1656925414289,MATH 20B,A03,093475,Briones; Jor-el Thomas Caparas,0,0,36,36
1656925420319,MATH 20C,A01,083760,Briones; Jor-el Thomas Caparas,1,0,35,34
1656925420319,MATH 20C,A02,083761,Briones; Jor-el Thomas Caparas,8,0,35,27
1656925420319,MATH 20C,A03,093476,Briones; Jor-el Thomas Caparas,0,1,36,36
1656925420319,MATH 20C,B01,083762,Bach; Quang Tran,0,0,30,30
1656925426348,MATH 20D,A01,083765,Tran; Brian Kha,4,0,30,26
1656925426348,MATH 20D,A02,083766,Tran; Brian Kha,4,0,30,26
1656925426348,MATH 20D,A03,083767,Tran; Brian Kha,3,0,30,27
1656925432374,MATH 20E,A01,083771,Ganguly; Soumya,5,0,32,27
1656925432374,MATH 20E,A02,083772,Ganguly; Soumya,6,0,32,26
1656925432374,MATH 20E,B01,083773,Ciotti; Benjamin,18,0,35,17
1656925432374,MATH 20E,B02,083774,Ciotti; Benjamin,17,0,35,18
1656925438409,MATH 103A,A01,083777,Greenfeld; Be'Eri,2,0,36,34
1656925438409,MATH 103A,A02,083778,Greenfeld; Be'Eri,5,0,36,31
1656925438409,MATH 103A,A03,093561,Greenfeld; Be'Eri,4,0,36,32
1656925438409,MATH 103A,B01,083779,Greenfeld; Be'Eri,6,0,36,30
1656925438409,MATH 103A,B02,083780,Greenfeld; Be'Eri,2,0,36,34
1656925438409,MATH 103A,B03,093562,Greenfeld; Be'Eri,2,0,36,34
1656925444439,MATH 105,A01,085443,Carter; Anne Toulson,13,0,35,22
1656925444439,MATH 105,A02,093477,Carter; Anne Toulson,20,0,35,15
1656925450466,MATH 109,A01,083213,Ganzberger; Geoffrey Michael,2,0,34,32
1656925450466,MATH 109,A02,083214,Ganzberger; Geoffrey Michael,2,0,34,32
1656925450466,MATH 109,A03,093478,Ganzberger; Geoffrey Michael,1,0,34,33
1656925450466,MATH 109,B01,083215,Ganzberger; Geoffrey Michael,1,0,32,31
1656925450466,MATH 109,B02,083216,Ganzberger; Geoffrey Michael,1,0,32,31
1656925450466,MATH 109,B03,093479,Ganzberger; Geoffrey Michael,6,0,32,26
1656925456492,MATH 142A,A01,083219,Chow; Bennett,6,0,32,26
1656925456492,MATH 142A,A02,083220,Chow; Bennett,10,0,32,22
1656925456492,MATH 142A,A03,093480,Chow; Bennett,7,0,32,25
1656925456492,MATH 142A,B03,093481,Chow; Bennett,7,0,32,25
1656925456492,MATH 142A,B04,093558,Chow; Bennett,11,0,32,21
1656925456492,MATH 142A,B05,093559,Chow; Bennett,6,0,32,26
1656925462603,MATH 193A,A01,083224,Rotar; Vladimir,7,0,34,27
1656925462603,MATH 193A,A02,083225,Rotar; Vladimir,3,0,34,31
1656925462603,MATH 193A,A03,083781,Rotar; Vladimir,1,0,34,33
1656925462603,MATH 193A,A04,083782,Rotar; Vladimir,6,0,34,28
1656925462603,MATH 193A,A05,093482,Rotar; Vladimir,6,0,34,28
1656925468630,MATH 197,001,091859,McAuley; Julian John,9999,0,9999,0
1656925468630,MATH 197,002,095566,Kedlaya; Kiran S.,9997,0,9999,2
1656925468630,MATH 197,003,095567,Xiao; Ming,9999,0,9999,0
1656925468630,MATH 197,004,095571,Perols; Johan Lars,9998,0,9999,1
1656925475706,COGS 9,A01,083615,Shannon; Kyle Michael,7,0,75,68
1656925481732,COGS 11,A01,083617,Boyle; Mary E. T.,19,0,48,29
1656925487757,COGS 13,A01,083071,Bastos; Amalia Pinkusfeld,9,0,71,62
1656925493784,COGS 14A,A01,092681,Semenuks; Arturs,0,1,100,100
1656925499810,COGS 14B,A01,083073,Cheng; Tzu-Han,5,0,63,58
1656925505832,COGS 17,A01,092677,Semenuks; Arturs,4,0,81,77
1656925511863,COGS 100,A01,083619,Allen; Michael Gordon,15,0,70,55
1656925517889,COGS 101A,A01,083621,Davis; Joshua Daniel,9,0,68,59
1656925523919,COGS 101B,A01,091572,Allen; Michael Gordon,8,0,65,57
1656925529945,COGS 101C,A01,083625,Delgado; Tania,17,0,35,18
1656925535971,COGS 107A,A01,083627,Boyle; Mary E. T.,13,0,60,47
1656925542002,COGS 118A,A01,083075,Gupta; Anjum,15,0,76,61
1656925548029,CSE 3,A50,083646,Miranda; Gregory Joseph,22,0,50,28
1656925554053,CSE 8A,A50,083650,Miranda; Gregory Joseph,17,1,56,39
1656925560078,CSE 11,A01,083080,Cao; Yingjun,4,15,40,36
1656925566104,CSE 12,A01,083652,Krause-Levy; Sophia Louisa,20,1,120,100
1656925572131,CSE 15L,A01,083654,Morris; Justin Loren,8,0,50,42
1656925572131,CSE 15L,A02,083655,Morris; Justin Loren,8,0,50,42
1656925578360,CSE 20,A01,083657,Tran; Khoa Dang,37,0,80,43
1656925584384,CSE 21,A01,095574,Bach; Quang Tran,21,0,48,27
1656925590409,CSE 30,A01,083084,Eldon; John,4,0,80,76
1656925590409,CSE 30,B01,095061,Bhaskar; Nishant,6,0,50,44
1656925596443,CSE 100,A01,083659,Cao; Yingjun,3,4,70,67
1656925602471,CSE 134B,A01,083661,Powell; Thomas Allan,19,0,100,81
1656925608498,CSE 140,A01,083663,Gungor; Onat,14,0,85,71
1656925614522,CSE 140L,A01,083088,Eldon; John,16,0,100,84
1656925620553,CSE 175,A01,083665,Kumar; Rakesh,3,0,25,22
1656925626582,CSE 190,A00,092507,Dubnov; Shlomo,7,0,20,13
1656925632612,ECE 45,A01,083139,Congero; Spencer William,5,0,75,70
1656925638639,ECE 65,A50,083695,Saad; Andrew S,12,0,30,18
1656925638639,ECE 65,A51,095125,Saad; Andrew S,25,0,26,1
1656925644668,ECE 109,A01,091882,Touri; Behrouz,16,0,70,54
1656925650697,ECE 180,A00,083140,Abi Samra; Nicholas Camill,0,0,30,30
1656925650697,ECE 180,B00,083141,Abi Samra; Nicholas Camill,0,0,30,30
1656925656727,MATH 10A,A01,083735,Patchell; Gregory David,1,0,30,29
1656925656727,MATH 10A,A02,083736,Patchell; Gregory David,20,0,30,10
1656925656727,MATH 10A,A03,083737,Patchell; Gregory David,15,0,30,15
1656925662768,MATH 10B,A01,083207,Lim; Seonhee,7,0,34,27
1656925662768,MATH 10B,A02,083208,Lim; Seonhee,9,0,35,26
1656925662768,MATH 10B,A03,093472,Lim; Seonhee,4,0,34,30
1656925662768,MATH 10B,B01,083739,Sinha; Shubham,9,0,30,21
1656925668798,MATH 18,A01,083743,Cinel; Cameron Alexander,6,0,30,24
1656925668798,MATH 18,A02,083744,Cinel; Cameron Alexander,15,0,30,15
1656925668798,MATH 18,A03,083745,Cinel; Cameron Alexander,8,0,30,22
1656925668798,MATH 18,B01,083748,Rideout; David Porter,4,0,37,33
1656925668798,MATH 18,B02,083749,Rideout; David Porter,3,0,36,33
1656925668798,MATH 18,B03,083750,Rideout; David Porter,2,0,37,35
1656925668798,MATH 18,B04,083751,Rideout; David Porter,5,0,36,31
1656925668798,MATH 18,B05,093473,Rideout; David Porter,4,0,36,32
1656925668798,MATH 18,B06,093474,Rideout; David Porter,5,0,36,31
1656925674830,MATH 20A,A01,083754,Zheng; Zequn,12,0,40,28
1656925680859,MATH 20B,A01,083756,Briones; Jor-el Thomas Caparas,1,0,36,35
1656925680859,MATH 20B,A02,083757,Briones; Jor-el Thomas Caparas,1,0,36,35
1656925680859,MATH 20B,A03,093475,Briones; Jor-el Thomas Caparas,0,0,36,36
1656925686886,MATH 20C,A01,083760,Briones; Jor-el Thomas Caparas,1,0,35,34
1656925686886,MATH 20C,A02,083761,Briones; Jor-el Thomas Caparas,8,0,35,27
1656925686886,MATH 20C,A03,093476,Briones; Jor-el Thomas Caparas,0,1,36,36
1656925686886,MATH 20C,B01,083762,Bach; Quang Tran,0,0,30,30
1656925692910,MATH 20D,A01,083765,Tran; Brian Kha,4,0,30,26
1656925692910,MATH 20D,A02,083766,Tran; Brian Kha,4,0,30,26
1656925692910,MATH 20D,A03,083767,Tran; Brian Kha,3,0,30,27
1656925698937,MATH 20E,A01,083771,Ganguly; Soumya,5,0,32,27
1656925698937,MATH 20E,A02,083772,Ganguly; Soumya,6,0,32,26
1656925698937,MATH 20E,B01,083773,Ciotti; Benjamin,18,0,35,17
1656925698937,MATH 20E,B02,083774,Ciotti; Benjamin,17,0,35,18
1656925704970,MATH 103A,A01,083777,Greenfeld; Be'Eri,2,0,36,34
1656925704970,MATH 103A,A02,083778,Greenfeld; Be'Eri,5,0,36,31
1656925704970,MATH 103A,A03,093561,Greenfeld; Be'Eri,4,0,36,32
1656925704970,MATH 103A,B01,083779,Greenfeld; Be'Eri,6,0,36,30
1656925704970,MATH 103A,B02,083780,Greenfeld; Be'Eri,2,0,36,34
1656925704970,MATH 103A,B03,093562,Greenfeld; Be'Eri,2,0,36,34
1656925710996,MATH 105,A01,085443,Carter; Anne Toulson,13,0,35,22
1656925710996,MATH 105,A02,093477,Carter; Anne Toulson,20,0,35,15
1656925717028,MATH 109,A01,083213,Ganzberger; Geoffrey Michael,2,0,34,32
1656925717028,MATH 109,A02,083214,Ganzberger; Geoffrey Michael,2,0,34,32
1656925717028,MATH 109,A03,093478,Ganzberger; Geoffrey Michael,1,0,34,33
1656925717028,MATH 109,B01,083215,Ganzberger; Geoffrey Michael,1,0,32,31
1656925717028,MATH 109,B02,083216,Ganzberger; Geoffrey Michael,1,0,32,31
1656925717028,MATH 109,B03,093479,Ganzberger; Geoffrey Michael,6,0,32,26
1656925723058,MATH 142A,A01,083219,Chow; Bennett,6,0,32,26
1656925723058,MATH 142A,A02,083220,Chow; Bennett,10,0,32,22
1656925723058,MATH 142A,A03,093480,Chow; Bennett,7,0,32,25
1656925723058,MATH 142A,B03,093481,Chow; Bennett,7,0,32,25
1656925723058,MATH 142A,B04,093558,Chow; Bennett,11,0,32,21
1656925723058,MATH 142A,B05,093559,Chow; Bennett,6,0,32,26
1656925729093,MATH 193A,A01,083224,Rotar; Vladimir,7,0,34,27
1656925729093,MATH 193A,A02,083225,Rotar; Vladimir,3,0,34,31
1656925729093,MATH 193A,A03,083781,Rotar; Vladimir,1,0,34,33
1656925729093,MATH 193A,A04,083782,Rotar; Vladimir,6,0,34,28
1656925729093,MATH 193A,A05,093482,Rotar; Vladimir,6,0,34,28
1656925735119,MATH 197,001,091859,McAuley; Julian John,9999,0,9999,0
1656925735119,MATH 197,002,095566,Kedlaya; Kiran S.,9997,0,9999,2
1656925735119,MATH 197,003,095567,Xiao; Ming,9999,0,9999,0
1656925735119,MATH 197,004,095571,Perols; Johan Lars,9998,0,9999,1
1656925742215,COGS 9,A01,083615,Shannon; Kyle Michael,7,0,75,68
1656925748240,COGS 11,A01,083617,Boyle; Mary E. T.,19,0,48,29
1656925754267,COGS 13,A01,083071,Bastos; Amalia Pinkusfeld,9,0,71,62
1656925760291,COGS 14A,A01,092681,Semenuks; Arturs,0,1,100,100
1656925766322,COGS 14B,A01,083073,Cheng; Tzu-Han,5,0,63,58
1656925772345,COGS 17,A01,092677,Semenuks; Arturs,4,0,81,77
1656925778380,COGS 100,A01,083619,Allen; Michael Gordon,15,0,70,55
1656925784411,COGS 101A,A01,083621,Davis; Joshua Daniel,9,0,68,59
1656925790443,COGS 101B,A01,091572,Allen; Michael Gordon,8,0,65,57
1656925796469,COGS 101C,A01,083625,Delgado; Tania,17,0,35,18
1656925802492,COGS 107A,A01,083627,Boyle; Mary E. T.,13,0,60,47
1656925808516,COGS 118A,A01,083075,Gupta; Anjum,15,0,76,61
1656925814558,CSE 3,A50,083646,Miranda; Gregory Joseph,22,0,50,28
1656925820583,CSE 8A,A50,083650,Miranda; Gregory Joseph,17,1,56,39
1656925826611,CSE 11,A01,083080,Cao; Yingjun,4,15,40,36
1656925832637,CSE 12,A01,083652,Krause-Levy; Sophia Louisa,20,1,120,100
1656925838669,CSE 15L,A01,083654,Morris; Justin Loren,8,0,50,42
1656925838669,CSE 15L,A02,083655,Morris; Justin Loren,8,0,50,42
1656925844693,CSE 20,A01,083657,Tran; Khoa Dang,37,0,80,43
1656925850717,CSE 21,A01,095574,Bach; Quang Tran,21,0,48,27
1656925856757,CSE 30,A01,083084,Eldon; John,4,0,80,76
1656925856757,CSE 30,B01,095061,Bhaskar; Nishant,6,0,50,44
1656925862786,CSE 100,A01,083659,Cao; Yingjun,3,4,70,67
1656925868812,CSE 134B,A01,083661,Powell; Thomas Allan,19,0,100,81
1656925874835,CSE 140,A01,083663,Gungor; Onat,14,0,85,71
1656925880868,CSE 140L,A01,083088,Eldon; John,16,0,100,84
1656925886899,CSE 175,A01,083665,Kumar; Rakesh,3,0,25,22
1656925892923,CSE 190,A00,092507,Dubnov; Shlomo,7,0,20,13
1656925898949,ECE 45,A01,083139,Congero; Spencer William,5,0,75,70
1656925904974,ECE 65,A50,083695,Saad; Andrew S,12,0,30,18
1656925904974,ECE 65,A51,095125,Saad; Andrew S,25,0,26,1
1656925910999,ECE 109,A01,091882,Touri; Behrouz,16,0,70,54
1656925917029,ECE 180,A00,083140,Abi Samra; Nicholas Camill,0,0,30,30
1656925917029,ECE 180,B00,083141,Abi Samra; Nicholas Camill,0,0,30,30
1656925923065,MATH 10A,A01,083735,Patchell; Gregory David,1,0,30,29
1656925923065,MATH 10A,A02,083736,Patchell; Gregory David,20,0,30,10
1656925923065,MATH 10A,A03,083737,Patchell; Gregory David,15,0,30,15
1656925929091,MATH 10B,A01,083207,Lim; Seonhee,7,0,34,27
1656925929091,MATH 10B,A02,083208,Lim; Seonhee,9,0,35,26
1656925929091,MATH 10B,A03,093472,Lim; Seonhee,4,0,34,30
1656925929091,MATH 10B,B01,083739,Sinha; Shubham,9,0,30,21
1656925935130,MATH 18,A01,083743,Cinel; Cameron Alexander,6,0,30,24
1656925935130,MATH 18,A02,083744,Cinel; Cameron Alexander,15,0,30,15
1656925935130,MATH 18,A03,083745,Cinel; Cameron Alexander,8,0,30,22
1656925935130,MATH 18,B01,083748,Rideout; David Porter,4,0,37,33
1656925935130,MATH 18,B02,083749,Rideout; David Porter,3,0,36,33
1656925935130,MATH 18,B03,083750,Rideout; David Porter,2,0,37,35
1656925935130,MATH 18,B04,083751,Rideout; David Porter,5,0,36,31
1656925935130,MATH 18,B05,093473,Rideout; David Porter,4,0,36,32
1656925935130,MATH 18,B06,093474,Rideout; David Porter,5,0,36,31
1656925941155,MATH 20A,A01,083754,Zheng; Zequn,12,0,40,28
1656925947179,MATH 20B,A01,083756,Briones; Jor-el Thomas Caparas,1,0,36,35
1656925947179,MATH 20B,A02,083757,Briones; Jor-el Thomas Caparas,1,0,36,35
1656925947179,MATH 20B,A03,093475,Briones; Jor-el Thomas Caparas,0,0,36,36
1656925953210,MATH 20C,A01,083760,Briones; Jor-el Thomas Caparas,1,0,35,34
1656925953210,MATH 20C,A02,083761,Briones; Jor-el Thomas Caparas,8,0,35,27
1656925953210,MATH 20C,A03,093476,Briones; Jor-el Thomas Caparas,0,1,36,36
1656925953210,MATH 20C,B01,083762,Bach; Quang Tran,0,0,30,30
1656925959235,MATH 20D,A01,083765,Tran; Brian Kha,4,0,30,26
1656925959235,MATH 20D,A02,083766,Tran; Brian Kha,4,0,30,26
1656925959235,MATH 20D,A03,083767,Tran; Brian Kha,3,0,30,27
1656925965261,MATH 20E,A01,083771,Ganguly; Soumya,5,0,32,27
1656925965261,MATH 20E,A02,083772,Ganguly; Soumya,6,0,32,26
1656925965261,MATH 20E,B01,083773,Ciotti; Benjamin,18,0,35,17
1656925965261,MATH 20E,B02,083774,Ciotti; Benjamin,17,0,35,18
1656925971299,MATH 103A,A01,083777,Greenfeld; Be'Eri,2,0,36,34
1656925971299,MATH 103A,A02,083778,Greenfeld; Be'Eri,5,0,36,31
1656925971299,MATH 103A,A03,093561,Greenfeld; Be'Eri,4,0,36,32
1656925971299,MATH 103A,B01,083779,Greenfeld; Be'Eri,6,0,36,30
1656925971299,MATH 103A,B02,083780,Greenfeld; Be'Eri,2,0,36,34
1656925971299,MATH 103A,B03,093562,Greenfeld; Be'Eri,2,0,36,34
1656925977325,MATH 105,A01,085443,Carter; Anne Toulson,13,0,35,22
1656925977325,MATH 105,A02,093477,Carter; Anne Toulson,20,0,35,15
1656925983352,MATH 109,A01,083213,Ganzberger; Geoffrey Michael,2,0,34,32
1656925983352,MATH 109,A02,083214,Ganzberger; Geoffrey Michael,2,0,34,32
1656925983352,MATH 109,A03,093478,Ganzberger; Geoffrey Michael,1,0,34,33
1656925983352,MATH 109,B01,083215,Ganzberger; Geoffrey Michael,1,0,32,31
1656925983352,MATH 109,B02,083216,Ganzberger; Geoffrey Michael,1,0,32,31
1656925983352,MATH 109,B03,093479,Ganzberger; Geoffrey Michael,6,0,32,26
1656925989378,MATH 142A,A01,083219,Chow; Bennett,6,0,32,26
1656925989378,MATH 142A,A02,083220,Chow; Bennett,10,0,32,22
1656925989378,MATH 142A,A03,093480,Chow; Bennett,7,0,32,25
1656925989378,MATH 142A,B03,093481,Chow; Bennett,7,0,32,25
1656925989378,MATH 142A,B04,093558,Chow; Bennett,11,0,32,21
1656925989378,MATH 142A,B05,093559,Chow; Bennett,6,0,32,26
1656925995403,MATH 193A,A01,083224,Rotar; Vladimir,7,0,34,27
1656925995403,MATH 193A,A02,083225,Rotar; Vladimir,3,0,34,31
1656925995403,MATH 193A,A03,083781,Rotar; Vladimir,1,0,34,33
1656925995403,MATH 193A,A04,083782,Rotar; Vladimir,6,0,34,28
1656925995403,MATH 193A,A05,093482,Rotar; Vladimir,6,0,34,28
1656926001427,MATH 197,001,091859,McAuley; Julian John,9999,0,9999,0
1656926001427,MATH 197,002,095566,Kedlaya; Kiran S.,9997,0,9999,2
1656926001427,MATH 197,003,095567,Xiao; Ming,9999,0,9999,0
1656926001427,MATH 197,004,095571,Perols; Johan Lars,9998,0,9999,1
1656926008502,COGS 9,A01,083615,Shannon; Kyle Michael,7,0,75,68
1656926014526,COGS 11,A01,083617,Boyle; Mary E. T.,19,0,48,29
1656926020564,COGS 13,A01,083071,Bastos; Amalia Pinkusfeld,9,0,71,62
1656926026591,COGS 14A,A01,092681,Semenuks; Arturs,0,1,100,100
1656926032620,COGS 14B,A01,083073,Cheng; Tzu-Han,5,0,63,58
1656926038643,COGS 17,A01,092677,Semenuks; Arturs,4,0,81,77
1656926044670,COGS 100,A01,083619,Allen; Michael Gordon,15,0,70,55
1656926050698,COGS 101A,A01,083621,Davis; Joshua Daniel,9,0,68,59
1656926056817,COGS 101B,A01,091572,Allen; Michael Gordon,8,0,65,57
1656926062849,COGS 101C,A01,083625,Delgado; Tania,17,0,35,18
1656926068878,COGS 107A,A01,083627,Boyle; Mary E. T.,13,0,60,47
1656926074904,COGS 118A,A01,083075,Gupta; Anjum,15,0,76,61
1656926080936,CSE 3,A50,083646,Miranda; Gregory Joseph,22,0,50,28
1656926086963,CSE 8A,A50,083650,Miranda; Gregory Joseph,17,1,56,39
1656926092993,CSE 11,A01,083080,Cao; Yingjun,4,15,40,36
1656926099019,CSE 12,A01,083652,Krause-Levy; Sophia Louisa,20,1,120,100
1656926105043,CSE 15L,A01,083654,Morris; Justin Loren,8,0,50,42
1656926105043,CSE 15L,A02,083655,Morris; Justin Loren,8,0,50,42
1656926111073,CSE 20,A01,083657,Tran; Khoa Dang,37,0,80,43
1656926117101,CSE 21,A01,095574,Bach; Quang Tran,21,0,48,27
1656926123127,CSE 30,A01,083084,Eldon; John,4,0,80,76
1656926123127,CSE 30,B01,095061,Bhaskar; Nishant,6,0,50,44
1656926129152,CSE 100,A01,083659,Cao; Yingjun,3,4,70,67
1656926135183,CSE 134B,A01,083661,Powell; Thomas Allan,19,0,100,81
1656926141208,CSE 140,A01,083663,Gungor; Onat,14,0,85,71
1656926147233,CSE 140L,A01,083088,Eldon; John,16,0,100,84
1656926153263,CSE 175,A01,083665,Kumar; Rakesh,3,0,25,22
1656926159288,CSE 190,A00,092507,Dubnov; Shlomo,7,0,20,13
1656926165327,ECE 45,A01,083139,Congero; Spencer William,5,0,75,70
1656926171359,ECE 65,A50,083695,Saad; Andrew S,12,0,30,18
1656926171359,ECE 65,A51,095125,Saad; Andrew S,25,0,26,1
1656926177384,ECE 109,A01,091882,Touri; Behrouz,16,0,70,54
1656926183409,ECE 180,A00,083140,Abi Samra; Nicholas Camill,0,0,30,30
1656926183409,ECE 180,B00,083141,Abi Samra; Nicholas Camill,0,0,30,30
1656926189437,MATH 10A,A01,083735,Patchell; Gregory David,1,0,30,29
1656926189437,MATH 10A,A02,083736,Patchell; Gregory David,20,0,30,10
1656926189437,MATH 10A,A03,083737,Patchell; Gregory David,15,0,30,15
1656926195473,MATH 10B,A01,083207,Lim; Seonhee,7,0,34,27
1656926195473,MATH 10B,A02,083208,Lim; Seonhee,9,0,35,26
1656926195473,MATH 10B,A03,093472,Lim; Seonhee,4,0,34,30
1656926195473,MATH 10B,B01,083739,Sinha; Shubham,9,0,30,21
1656926201499,MATH 18,A01,083743,Cinel; Cameron Alexander,6,0,30,24
1656926201499,MATH 18,A02,083744,Cinel; Cameron Alexander,15,0,30,15
1656926201499,MATH 18,A03,083745,Cinel; Cameron Alexander,8,0,30,22
1656926201499,MATH 18,B01,083748,Rideout; David Porter,4,0,37,33
1656926201499,MATH 18,B02,083749,Rideout; David Porter,3,0,36,33
1656926201499,MATH 18,B03,083750,Rideout; David Porter,2,0,37,35
1656926201499,MATH 18,B04,083751,Rideout; David Porter,5,0,36,31
1656926201499,MATH 18,B05,093473,Rideout; David Porter,4,0,36,32
1656926201499,MATH 18,B06,093474,Rideout; David Porter,5,0,36,31
1656926207525,MATH 20A,A01,083754,Zheng; Zequn,12,0,40,28
1656926213549,MATH 20B,A01,083756,Briones; Jor-el Thomas Caparas,1,0,36,35
1656926213549,MATH 20B,A02,083757,Briones; Jor-el Thomas Caparas,1,0,36,35
1656926213549,MATH 20B,A03,093475,Briones; Jor-el Thomas Caparas,0,0,36,36
1656926219582,MATH 20C,A01,083760,Briones; Jor-el Thomas Caparas,1,0,35,34
1656926219582,MATH 20C,A02,083761,Briones; Jor-el Thomas Caparas,8,0,35,27
1656926219582,MATH 20C,A03,093476,Briones; Jor-el Thomas Caparas,0,1,36,36
1656926219582,MATH 20C,B01,083762,Bach; Quang Tran,0,0,30,30
1656926225608,MATH 20D,A01,083765,Tran; Brian Kha,4,0,30,26
1656926225608,MATH 20D,A02,083766,Tran; Brian Kha,4,0,30,26
1656926225608,MATH 20D,A03,083767,Tran; Brian Kha,3,0,30,27
1656926231641,MATH 20E,A01,083771,Ganguly; Soumya,5,0,32,27
1656926231641,MATH 20E,A02,083772,Ganguly; Soumya,6,0,32,26
1656926231641,MATH 20E,B01,083773,Ciotti; Benjamin,18,0,35,17
1656926231641,MATH 20E,B02,083774,Ciotti; Benjamin,17,0,35,18
1656926237670,MATH 103A,A01,083777,Greenfeld; Be'Eri,2,0,36,34
1656926237670,MATH 103A,A02,083778,Greenfeld; Be'Eri,5,0,36,31
1656926237670,MATH 103A,A03,093561,Greenfeld; Be'Eri,4,0,36,32
1656926237670,MATH 103A,B01,083779,Greenfeld; Be'Eri,6,0,36,30
1656926237670,MATH 103A,B02,083780,Greenfeld; Be'Eri,2,0,36,34
1656926237670,MATH 103A,B03,093562,Greenfeld; Be'Eri,2,0,36,34
1656926243696,MATH 105,A01,085443,Carter; Anne Toulson,13,0,35,22
1656926243696,MATH 105,A02,093477,Carter; Anne Toulson,20,0,35,15
1656926249728,MATH 109,A01,083213,Ganzberger; Geoffrey Michael,2,0,34,32
1656926249728,MATH 109,A02,083214,Ganzberger; Geoffrey Michael,2,0,34,32
1656926249728,MATH 109,A03,093478,Ganzberger; Geoffrey Michael,1,0,34,33
1656926249728,MATH 109,B01,083215,Ganzberger; Geoffrey Michael,1,0,32,31
1656926249728,MATH 109,B02,083216,Ganzberger; Geoffrey Michael,1,0,32,31
1656926249728,MATH 109,B03,093479,Ganzberger; Geoffrey Michael,6,0,32,26
1656926255753,MATH 142A,A01,083219,Chow; Bennett,6,0,32,26
1656926255753,MATH 142A,A02,083220,Chow; Bennett,10,0,32,22
1656926255753,MATH 142A,A03,093480,Chow; Bennett,7,0,32,25
1656926255753,MATH 142A,B03,093481,Chow; Bennett,7,0,32,25
1656926255753,MATH 142A,B04,093558,Chow; Bennett,11,0,32,21
1656926255753,MATH 142A,B05,093559,Chow; Bennett,6,0,32,26
1656926261777,MATH 193A,A01,083224,Rotar; Vladimir,7,0,34,27
1656926261777,MATH 193A,A02,083225,Rotar; Vladimir,3,0,34,31
1656926261777,MATH 193A,A03,083781,Rotar; Vladimir,1,0,34,33
1656926261777,MATH 193A,A04,083782,Rotar; Vladimir,6,0,34,28
1656926261777,MATH 193A,A05,093482,Rotar; Vladimir,6,0,34,28
1656926267804,MATH 197,001,091859,McAuley; Julian John,9999,0,9999,0
1656926267804,MATH 197,002,095566,Kedlaya; Kiran S.,9997,0,9999,2
1656926267804,MATH 197,003,095567,Xiao; Ming,9999,0,9999,0
1656926267804,MATH 197,004,095571,Perols; Johan Lars,9998,0,9999,1
1656926274867,COGS 9,A01,083615,Shannon; Kyle Michael,7,0,75,68
1656926280897,COGS 11,A01,083617,Boyle; Mary E. T.,19,0,48,29
1656926286921,COGS 13,A01,083071,Bastos; Amalia Pinkusfeld,9,0,71,62
1656926292952,COGS 14A,A01,092681,Semenuks; Arturs,0,1,100,100
1656926298981,COGS 14B,A01,083073,Cheng; Tzu-Han,5,0,63,58
1656926305003,COGS 17,A01,092677,Semenuks; Arturs,4,0,81,77
1656926311028,COGS 100,A01,083619,Allen; Michael Gordon,15,0,70,55
1656926317052,COGS 101A,A01,083621,Davis; Joshua Daniel,9,0,68,59
1656926323084,COGS 101B,A01,091572,Allen; Michael Gordon,8,0,65,57
1656926329114,COGS 101C,A01,083625,Delgado; Tania,17,0,35,18
1656926335137,COGS 107A,A01,083627,Boyle; Mary E. T.,13,0,60,47
1656926341160,COGS 118A,A01,083075,Gupta; Anjum,15,0,76,61
1656926347192,CSE 3,A50,083646,Miranda; Gregory Joseph,22,0,50,28
1656926353227,CSE 8A,A50,083650,Miranda; Gregory Joseph,17,1,56,39
1656926359254,CSE 11,A01,083080,Cao; Yingjun,4,15,40,36
1656926365284,CSE 12,A01,083652,Krause-Levy; Sophia Louisa,20,1,120,100
1656926371306,CSE 15L,A01,083654,Morris; Justin Loren,8,0,50,42
1656926371306,CSE 15L,A02,083655,Morris; Justin Loren,8,0,50,42
1656926377330,CSE 20,A01,083657,Tran; Khoa Dang,37,0,80,43
1656926383354,CSE 21,A01,095574,Bach; Quang Tran,21,0,48,27
1656926389386,CSE 30,A01,083084,Eldon; John,4,0,80,76
1656926389386,CSE 30,B01,095061,Bhaskar; Nishant,6,0,50,44
1656926395410,CSE 100,A01,083659,Cao; Yingjun,3,4,70,67
1656926401438,CSE 134B,A01,083661,Powell; Thomas Allan,19,0,100,81
1656926407466,CSE 140,A01,083663,Gungor; Onat,14,0,85,71
1656926413494,CSE 140L,A01,083088,Eldon; John,16,0,100,84
1656926419521,CSE 175,A01,083665,Kumar; Rakesh,3,0,25,22
1656926425547,CSE 190,A00,092507,Dubnov; Shlomo,7,0,20,13
1656926431569,ECE 45,A01,083139,Congero; Spencer William,5,0,75,70
1656926437600,ECE 65,A50,083695,Saad; Andrew S,12,0,30,18
1656926437600,ECE 65,A51,095125,Saad; Andrew S,25,0,26,1
1656926443627,ECE 109,A01,091882,Touri; Behrouz,16,0,70,54
1656926449650,ECE 180,A00,083140,Abi Samra; Nicholas Camill,0,0,30,30
1656926449650,ECE 180,B00,083141,Abi Samra; Nicholas Camill,0,0,30,30
1656926455678,MATH 10A,A01,083735,Patchell; Gregory David,1,0,30,29
1656926455678,MATH 10A,A02,083736,Patchell; Gregory David,20,0,30,10
1656926455678,MATH 10A,A03,083737,Patchell; Gregory David,15,0,30,15
1656926461702,MATH 10B,A01,083207,Lim; Seonhee,7,0,34,27
1656926461702,MATH 10B,A02,083208,Lim; Seonhee,9,0,35,26
1656926461702,MATH 10B,A03,093472,Lim; Seonhee,4,0,34,30
1656926461702,MATH 10B,B01,083739,Sinha; Shubham,9,0,30,21
1656926467728,MATH 18,A01,083743,Cinel; Cameron Alexander,6,0,30,24
1656926467728,MATH 18,A02,083744,Cinel; Cameron Alexander,15,0,30,15
1656926467728,MATH 18,A03,083745,Cinel; Cameron Alexander,8,0,30,22
1656926467728,MATH 18,B01,083748,Rideout; David Porter,4,0,37,33
1656926467728,MATH 18,B02,083749,Rideout; David Porter,3,0,36,33
1656926467728,MATH 18,B03,083750,Rideout; David Porter,2,0,37,35
1656926467728,MATH 18,B04,083751,Rideout; David Porter,5,0,36,31
1656926467728,MATH 18,B05,093473,Rideout; David Porter,4,0,36,32
1656926467728,MATH 18,B06,093474,Rideout; David Porter,5,0,36,31
1656926473751,MATH 20A,A01,083754,Zheng; Zequn,12,0,40,28
1656926479776,MATH 20B,A01,083756,Briones; Jor-el Thomas Caparas,1,0,36,35
1656926479776,MATH 20B,A02,083757,Briones; Jor-el Thomas Caparas,1,0,36,35
1656926479776,MATH 20B,A03,093475,Briones; Jor-el Thomas Caparas,0,0,36,36
1656926485816,MATH 20C,A01,083760,Briones; Jor-el Thomas Caparas,1,0,35,34
1656926485816,MATH 20C,A02,083761,Briones; Jor-el Thomas Caparas,8,0,35,27
1656926485816,MATH 20C,A03,093476,Briones; Jor-el Thomas Caparas,0,1,36,36
1656926485816,MATH 20C,B01,083762,Bach; Quang Tran,0,0,30,30
1656926491839,MATH 20D,A01,083765,Tran; Brian Kha,4,0,30,26
1656926491839,MATH 20D,A02,083766,Tran; Brian Kha,4,0,30,26
1656926491839,MATH 20D,A03,083767,Tran; Brian Kha,3,0,30,27
1656926497864,MATH 20E,A01,083771,Ganguly; Soumya,5,0,32,27
1656926497864,MATH 20E,A02,083772,Ganguly; Soumya,6,0,32,26
1656926497864,MATH 20E,B01,083773,Ciotti; Benjamin,18,0,35,17
1656926497864,MATH 20E,B02,083774,Ciotti; Benjamin,17,0,35,18
1656926503894,MATH 103A,A01,083777,Greenfeld; Be'Eri,2,0,36,34
1656926503894,MATH 103A,A02,083778,Greenfeld; Be'Eri,5,0,36,31
1656926503894,MATH 103A,A03,093561,Greenfeld; Be'Eri,4,0,36,32
1656926503894,MATH 103A,B01,083779,Greenfeld; Be'Eri,6,0,36,30
1656926503894,MATH 103A,B02,083780,Greenfeld; Be'Eri,2,0,36,34
1656926503894,MATH 103A,B03,093562,Greenfeld; Be'Eri,2,0,36,34
1656926509918,MATH 105,A01,085443,Carter; Anne Toulson,13,0,35,22
1656926509918,MATH 105,A02,093477,Carter; Anne Toulson,20,0,35,15
1656926515948,MATH 109,A01,083213,Ganzberger; Geoffrey Michael,2,0,34,32
1656926515948,MATH 109,A02,083214,Ganzberger; Geoffrey Michael,2,0,34,32
1656926515948,MATH 109,A03,093478,Ganzberger; Geoffrey Michael,1,0,34,33
1656926515948,MATH 109,B01,083215,Ganzberger; Geoffrey Michael,1,0,32,31
1656926515948,MATH 109,B02,083216,Ganzberger; Geoffrey Michael,1,0,32,31
1656926515948,MATH 109,B03,093479,Ganzberger; Geoffrey Michael,6,0,32,26
1656926521979,MATH 142A,A01,083219,Chow; Bennett,6,0,32,26
1656926521979,MATH 142A,A02,083220,Chow; Bennett,10,0,32,22
1656926521979,MATH 142A,A03,093480,Chow; Bennett,7,0,32,25
1656926521979,MATH 142A,B03,093481,Chow; Bennett,7,0,32,25
1656926521979,MATH 142A,B04,093558,Chow; Bennett,11,0,32,21
1656926521979,MATH 142A,B05,093559,Chow; Bennett,6,0,32,26
1656926528002,MATH 193A,A01,083224,Rotar; Vladimir,7,0,34,27
1656926528002,MATH 193A,A02,083225,Rotar; Vladimir,3,0,34,31
1656926528002,MATH 193A,A03,083781,Rotar; Vladimir,1,0,34,33
1656926528002,MATH 193A,A04,083782,Rotar; Vladimir,6,0,34,28
1656926528002,MATH 193A,A05,093482,Rotar; Vladimir,6,0,34,28
1656926534030,MATH 197,001,091859,McAuley; Julian John,9999,0,9999,0
1656926534030,MATH 197,002,095566,Kedlaya; Kiran S.,9997,0,9999,2
1656926534030,MATH 197,003,095567,Xiao; Ming,9999,0,9999,0
1656926534030,MATH 197,004,095571,Perols; Johan Lars,9998,0,9999,1
1656926541087,COGS 9,A01,083615,Shannon; Kyle Michael,7,0,75,68
1656926547116,COGS 11,A01,083617,Boyle; Mary E. T.,19,0,48,29
1656926553141,COGS 13,A01,083071,Bastos; Amalia Pinkusfeld,9,0,71,62
1656926559165,COGS 14A,A01,092681,Semenuks; Arturs,0,1,100,100
1656926571283,COGS 14B,A01,083073,Cheng; Tzu-Han,5,0,63,58
1656926577306,COGS 17,A01,092677,Semenuks; Arturs,4,0,81,77
1656926583335,COGS 100,A01,083619,Allen; Michael Gordon,15,0,70,55
1656926589361,COGS 101A,A01,083621,Davis; Joshua Daniel,9,0,68,59
1656926595385,COGS 101B,A01,091572,Allen; Michael Gordon,8,0,65,57
1656926601409,COGS 101C,A01,083625,Delgado; Tania,17,0,35,18
1656926607436,COGS 107A,A01,083627,Boyle; Mary E. T.,13,0,60,47
1656926613460,COGS 118A,A01,083075,Gupta; Anjum,15,0,76,61
1656926619484,CSE 3,A50,083646,Miranda; Gregory Joseph,22,0,50,28
1656926625522,CSE 8A,A50,083650,Miranda; Gregory Joseph,17,1,56,39
1656926631546,CSE 11,A01,083080,Cao; Yingjun,4,15,40,36
1656926637570,CSE 12,A01,083652,Krause-Levy; Sophia Louisa,20,1,120,100
1656926643594,CSE 15L,A01,083654,Morris; Justin Loren,8,0,50,42
1656926643594,CSE 15L,A02,083655,Morris; Justin Loren,8,0,50,42
1656926649618,CSE 20,A01,083657,Tran; Khoa Dang,37,0,80,43
1656926655644,CSE 21,A01,095574,Bach; Quang Tran,21,0,48,27
1656926661740,CSE 30,A01,083084,Eldon; John,4,0,80,76
1656926661740,CSE 30,B01,095061,Bhaskar; Nishant,6,0,50,44
1656926667772,CSE 100,A01,083659,Cao; Yingjun,3,4,70,67
1656926673798,CSE 134B,A01,083661,Powell; Thomas Allan,19,0,100,81
1656926679822,CSE 140,A01,083663,Gungor; Onat,14,0,85,71
1656926685847,CSE 140L,A01,083088,Eldon; John,16,0,100,84
1656926691870,CSE 175,A01,083665,Kumar; Rakesh,3,0,25,22
1656926697896,CSE 190,A00,092507,Dubnov; Shlomo,7,0,20,13
1656926703921,ECE 45,A01,083139,Congero; Spencer William,5,0,75,70
1656926709949,ECE 65,A50,083695,Saad; Andrew S,12,0,30,18
1656926709949,ECE 65,A51,095125,Saad; Andrew S,25,0,26,1
1656926715973,ECE 109,A01,091882,Touri; Behrouz,16,0,70,54
1656926722001,ECE 180,A00,083140,Abi Samra; Nicholas Camill,0,0,30,30
1656926722001,ECE 180,B00,083141,Abi Samra; Nicholas Camill,0,0,30,30
1656926728026,MATH 10A,A01,083735,Patchell; Gregory David,1,0,30,29
1656926728026,MATH 10A,A02,083736,Patchell; Gregory David,20,0,30,10
1656926728026,MATH 10A,A03,083737,Patchell; Gregory David,15,0,30,15
1656926734050,MATH 10B,A01,083207,Lim; Seonhee,7,0,34,27
1656926734050,MATH 10B,A02,083208,Lim; Seonhee,9,0,35,26
1656926734050,MATH 10B,A03,093472,Lim; Seonhee,4,0,34,30
1656926734050,MATH 10B,B01,083739,Sinha; Shubham,9,0,30,21
1656926740092,MATH 18,A01,083743,Cinel; Cameron Alexander,6,0,30,24
1656926740092,MATH 18,A02,083744,Cinel; Cameron Alexander,15,0,30,15
1656926740092,MATH 18,A03,083745,Cinel; Cameron Alexander,8,0,30,22
1656926740092,MATH 18,B01,083748,Rideout; David Porter,4,0,37,33
1656926740092,MATH 18,B02,083749,Rideout; David Porter,3,0,36,33
1656926740092,MATH 18,B03,083750,Rideout; David Porter,2,0,37,35
1656926740092,MATH 18,B04,083751,Rideout; David Porter,5,0,36,31
1656926740092,MATH 18,B05,093473,Rideout; David Porter,4,0,36,32
1656926740092,MATH 18,B06,093474,Rideout; David Porter,5,0,36,31
1656926746126,MATH 20A,A01,083754,Zheng; Zequn,12,0,40,28
1656926752150,MATH 20B,A01,083756,Briones; Jor-el Thomas Caparas,1,0,36,35
1656926752150,MATH 20B,A02,083757,Briones; Jor-el Thomas Caparas,1,0,36,35
1656926752150,MATH 20B,A03,093475,Briones; Jor-el Thomas Caparas,0,0,36,36
1656926758173,MATH 20C,A01,083760,Briones; Jor-el Thomas Caparas,1,0,35,34
1656926758173,MATH 20C,A02,083761,Briones; Jor-el Thomas Caparas,8,0,35,27
1656926758173,MATH 20C,A03,093476,Briones; Jor-el Thomas Caparas,0,1,36,36
1656926758173,MATH 20C,B01,083762,Bach; Quang Tran,0,0,30,30
1656926764198,MATH 20D,A01,083765,Tran; Brian Kha,4,0,30,26
1656926764198,MATH 20D,A02,083766,Tran; Brian Kha,4,0,30,26
1656926764198,MATH 20D,A03,083767,Tran; Brian Kha,3,0,30,27
1656926770228,MATH 20E,A01,083771,Ganguly; Soumya,5,0,32,27
1656926770228,MATH 20E,A02,083772,Ganguly; Soumya,6,0,32,26
1656926770228,MATH 20E,B01,083773,Ciotti; Benjamin,18,0,35,17
1656926770228,MATH 20E,B02,083774,Ciotti; Benjamin,17,0,35,18
1656926776260,MATH 103A,A01,083777,Greenfeld; Be'Eri,2,0,36,34
1656926776260,MATH 103A,A02,083778,Greenfeld; Be'Eri,5,0,36,31
1656926776260,MATH 103A,A03,093561,Greenfeld; Be'Eri,4,0,36,32
1656926776260,MATH 103A,B01,083779,Greenfeld; Be'Eri,6,0,36,30
1656926776260,MATH 103A,B02,083780,Greenfeld; Be'Eri,2,0,36,34
1656926776260,MATH 103A,B03,093562,Greenfeld; Be'Eri,2,0,36,34
1656926782284,MATH 105,A01,085443,Carter; Anne Toulson,13,0,35,22
1656926782284,MATH 105,A02,093477,Carter; Anne Toulson,20,0,35,15
1656926788314,MATH 109,A01,083213,Ganzberger; Geoffrey Michael,2,0,34,32
1656926788314,MATH 109,A02,083214,Ganzberger; Geoffrey Michael,2,0,34,32
1656926788314,MATH 109,A03,093478,Ganzberger; Geoffrey Michael,1,0,34,33
1656926788314,MATH 109,B01,083215,Ganzberger; Geoffrey Michael,1,0,32,31
1656926788314,MATH 109,B02,083216,Ganzberger; Geoffrey Michael,1,0,32,31
1656926788314,MATH 109,B03,093479,Ganzberger; Geoffrey Michael,6,0,32,26
1656926794350,MATH 142A,A01,083219,Chow; Bennett,6,0,32,26
1656926794350,MATH 142A,A02,083220,Chow; Bennett,10,0,32,22
1656926794350,MATH 142A,A03,093480,Chow; Bennett,7,0,32,25
1656926794350,MATH 142A,B03,093481,Chow; Bennett,7,0,32,25
1656926794350,MATH 142A,B04,093558,Chow; Bennett,11,0,32,21
1656926794350,MATH 142A,B05,093559,Chow; Bennett,6,0,32,26
1656926800375,MATH 193A,A01,083224,Rotar; Vladimir,7,0,34,27
1656926800375,MATH 193A,A02,083225,Rotar; Vladimir,3,0,34,31
1656926800375,MATH 193A,A03,083781,Rotar; Vladimir,1,0,34,33
1656926800375,MATH 193A,A04,083782,Rotar; Vladimir,6,0,34,28
1656926800375,MATH 193A,A05,093482,Rotar; Vladimir,6,0,34,28
1656926806397,MATH 197,001,091859,McAuley; Julian John,9999,0,9999,0
1656926806397,MATH 197,002,095566,Kedlaya; Kiran S.,9997,0,9999,2
1656926806397,MATH 197,003,095567,Xiao; Ming,9999,0,9999,0
1656926806397,MATH 197,004,095571,Perols; Johan Lars,9998,0,9999,1
1656926813454,COGS 9,A01,083615,Shannon; Kyle Michael,7,0,75,68
1656926819477,COGS 11,A01,083617,Boyle; Mary E. T.,19,0,48,29
1656926825500,COGS 13,A01,083071,Bastos; Amalia Pinkusfeld,9,0,71,62
1656926831524,COGS 14A,A01,092681,Semenuks; Arturs,0,1,100,100
1656926837554,COGS 14B,A01,083073,Cheng; Tzu-Han,5,0,63,58
1656926843582,COGS 17,A01,092677,Semenuks; Arturs,4,0,81,77
1656926849605,COGS 100,A01,083619,Allen; Michael Gordon,15,0,70,55
1656926855631,COGS 101A,A01,083621,Davis; Joshua Daniel,9,0,68,59
1656926861656,COGS 101B,A01,091572,Allen; Michael Gordon,8,0,65,57
1656926867681,COGS 101C,A01,083625,Delgado; Tania,17,0,35,18
1656926873706,COGS 107A,A01,083627,Boyle; Mary E. T.,13,0,60,47
1656926879729,COGS 118A,A01,083075,Gupta; Anjum,15,0,76,61
1656926885758,CSE 3,A50,083646,Miranda; Gregory Joseph,22,0,50,28
1656926891781,CSE 8A,A50,083650,Miranda; Gregory Joseph,17,1,56,39
1656926897832,CSE 11,A01,083080,Cao; Yingjun,4,15,40,36
1656926903854,CSE 12,A01,083652,Krause-Levy; Sophia Louisa,20,1,120,100
1656926909879,CSE 15L,A01,083654,Morris; Justin Loren,8,0,50,42
1656926909879,CSE 15L,A02,083655,Morris; Justin Loren,8,0,50,42
1656926915900,CSE 20,A01,083657,Tran; Khoa Dang,37,0,80,43
1656926921925,CSE 21,A01,095574,Bach; Quang Tran,21,0,48,27
1656926927950,CSE 30,A01,083084,Eldon; John,4,0,80,76
1656926927950,CSE 30,B01,095061,Bhaskar; Nishant,6,0,50,44
1656926933977,CSE 100,A01,083659,Cao; Yingjun,3,4,70,67
1656926940004,CSE 134B,A01,083661,Powell; Thomas Allan,19,0,100,81
1656926946029,CSE 140,A01,083663,Gungor; Onat,14,0,85,71
1656926952051,CSE 140L,A01,083088,Eldon; John,16,0,100,84
1656926958077,CSE 175,A01,083665,Kumar; Rakesh,3,0,25,22
1656926964106,CSE 190,A00,092507,Dubnov; Shlomo,7,0,20,13
1656926970135,ECE 45,A01,083139,Congero; Spencer William,5,0,75,70
1656926976161,ECE 65,A50,083695,Saad; Andrew S,12,0,30,18
1656926976161,ECE 65,A51,095125,Saad; Andrew S,25,0,26,1
1656926982197,ECE 109,A01,091882,Touri; Behrouz,16,0,70,54
1656926988221,ECE 180,A00,083140,Abi Samra; Nicholas Camill,0,0,30,30
1656926988221,ECE 180,B00,083141,Abi Samra; Nicholas Camill,0,0,30,30
1656926994246,MATH 10A,A01,083735,Patchell; Gregory David,1,0,30,29
1656926994246,MATH 10A,A02,083736,Patchell; Gregory David,20,0,30,10
1656926994246,MATH 10A,A03,083737,Patchell; Gregory David,15,0,30,15
1656927000272,MATH 10B,A01,083207,Lim; Seonhee,7,0,34,27
1656927000272,MATH 10B,A02,083208,Lim; Seonhee,9,0,35,26
1656927000272,MATH 10B,A03,093472,Lim; Seonhee,4,0,34,30
1656927000272,MATH 10B,B01,083739,Sinha; Shubham,9,0,30,21
1656927006299,MATH 18,A01,083743,Cinel; Cameron Alexander,6,0,30,24
1656927006299,MATH 18,A02,083744,Cinel; Cameron Alexander,15,0,30,15
1656927006299,MATH 18,A03,083745,Cinel; Cameron Alexander,8,0,30,22
1656927006299,MATH 18,B01,083748,Rideout; David Porter,4,0,37,33
1656927006299,MATH 18,B02,083749,Rideout; David Porter,3,0,36,33
1656927006299,MATH 18,B03,083750,Rideout; David Porter,2,0,37,35
1656927006299,MATH 18,B04,083751,Rideout; David Porter,5,0,36,31
1656927006299,MATH 18,B05,093473,Rideout; David Porter,4,0,36,32
1656927006299,MATH 18,B06,093474,Rideout; David Porter,5,0,36,31
1656927012322,MATH 20A,A01,083754,Zheng; Zequn,12,0,40,28
1656927018347,MATH 20B,A01,083756,Briones; Jor-el Thomas Caparas,1,0,36,35
1656927018347,MATH 20B,A02,083757,Briones; Jor-el Thomas Caparas,1,0,36,35
1656927018347,MATH 20B,A03,093475,Briones; Jor-el Thomas Caparas,0,0,36,36
1656927024373,MATH 20C,A01,083760,Briones; Jor-el Thomas Caparas,1,0,35,34
1656927024373,MATH 20C,A02,083761,Briones; Jor-el Thomas Caparas,8,0,35,27
1656927024373,MATH 20C,A03,093476,Briones; Jor-el Thomas Caparas,0,1,36,36
1656927024373,MATH 20C,B01,083762,Bach; Quang Tran,0,0,30,30
1656927030406,MATH 20D,A01,083765,Tran; Brian Kha,4,0,30,26
1656927030406,MATH 20D,A02,083766,Tran; Brian Kha,4,0,30,26
1656927030406,MATH 20D,A03,083767,Tran; Brian Kha,3,0,30,27
1656927036432,MATH 20E,A01,083771,Ganguly; Soumya,5,0,32,27
1656927036432,MATH 20E,A02,083772,Ganguly; Soumya,6,0,32,26
1656927036432,MATH 20E,B01,083773,Ciotti; Benjamin,18,0,35,17
1656927036432,MATH 20E,B02,083774,Ciotti; Benjamin,17,0,35,18
1656927042468,MATH 103A,A01,083777,Greenfeld; Be'Eri,2,0,36,34
1656927042468,MATH 103A,A02,083778,Greenfeld; Be'Eri,5,0,36,31
1656927042468,MATH 103A,A03,093561,Greenfeld; Be'Eri,4,0,36,32
1656927042468,MATH 103A,B01,083779,Greenfeld; Be'Eri,6,0,36,30
1656927042468,MATH 103A,B02,083780,Greenfeld; Be'Eri,2,0,36,34
1656927042468,MATH 103A,B03,093562,Greenfeld; Be'Eri,2,0,36,34
1656927048494,MATH 105,A01,085443,Carter; Anne Toulson,13,0,35,22
1656927048494,MATH 105,A02,093477,Carter; Anne Toulson,20,0,35,15
1656927054519,MATH 109,A01,083213,Ganzberger; Geoffrey Michael,2,0,34,32
1656927054519,MATH 109,A02,083214,Ganzberger; Geoffrey Michael,2,0,34,32
1656927054519,MATH 109,A03,093478,Ganzberger; Geoffrey Michael,1,0,34,33
1656927054519,MATH 109,B01,083215,Ganzberger; Geoffrey Michael,1,0,32,31
1656927054519,MATH 109,B02,083216,Ganzberger; Geoffrey Michael,1,0,32,31
1656927054519,MATH 109,B03,093479,Ganzberger; Geoffrey Michael,6,0,32,26
1656927060551,MATH 142A,A01,083219,Chow; Bennett,6,0,32,26
1656927060551,MATH 142A,A02,083220,Chow; Bennett,10,0,32,22
1656927060551,MATH 142A,A03,093480,Chow; Bennett,7,0,32,25
1656927060551,MATH 142A,B03,093481,Chow; Bennett,7,0,32,25
1656927060551,MATH 142A,B04,093558,Chow; Bennett,11,0,32,21
1656927060551,MATH 142A,B05,093559,Chow; Bennett,6,0,32,26
1656927066583,MATH 193A,A01,083224,Rotar; Vladimir,7,0,34,27
1656927066583,MATH 193A,A02,083225,Rotar; Vladimir,3,0,34,31
1656927066583,MATH 193A,A03,083781,Rotar; Vladimir,1,0,34,33
1656927066583,MATH 193A,A04,083782,Rotar; Vladimir,6,0,34,28
1656927066583,MATH 193A,A05,093482,Rotar; Vladimir,6,0,34,28
1656927072607,MATH 197,001,091859,McAuley; Julian John,9999,0,9999,0
1656927072607,MATH 197,002,095566,Kedlaya; Kiran S.,9997,0,9999,2
1656927072607,MATH 197,003,095567,Xiao; Ming,9999,0,9999,0
1656927072607,MATH 197,004,095571,Perols; Johan Lars,9998,0,9999,1
1656927079682,COGS 9,A01,083615,Shannon; Kyle Michael,7,0,75,68
1656927085706,COGS 11,A01,083617,Boyle; Mary E. T.,19,0,48,29
1656927091730,COGS 13,A01,083071,Bastos; Amalia Pinkusfeld,9,0,71,62
1656927097754,COGS 14A,A01,092681,Semenuks; Arturs,0,1,100,100
1656927103782,COGS 14B,A01,083073,Cheng; Tzu-Han,5,0,63,58
1656927109806,COGS 17,A01,092677,Semenuks; Arturs,4,0,81,77
1656927115838,COGS 100,A01,083619,Allen; Michael Gordon,15,0,70,55
1656927121862,COGS 101A,A01,083621,Davis; Joshua Daniel,9,0,68,59
1656927127894,COGS 101B,A01,091572,Allen; Michael Gordon,8,0,65,57
1656927133921,COGS 101C,A01,083625,Delgado; Tania,17,0,35,18
1656927139945,COGS 107A,A01,083627,Boyle; Mary E. T.,13,0,60,47
1656927145974,COGS 118A,A01,083075,Gupta; Anjum,15,0,76,61
1656927152001,CSE 3,A50,083646,Miranda; Gregory Joseph,22,0,50,28
1656927158031,CSE 8A,A50,083650,Miranda; Gregory Joseph,17,1,56,39
1656927164055,CSE 11,A01,083080,Cao; Yingjun,4,15,40,36
1656927170083,CSE 12,A01,083652,Krause-Levy; Sophia Louisa,20,1,120,100
1656927176108,CSE 15L,A01,083654,Morris; Justin Loren,8,0,50,42
1656927176108,CSE 15L,A02,083655,Morris; Justin Loren,8,0,50,42
1656927182132,CSE 20,A01,083657,Tran; Khoa Dang,37,0,80,43
1656927188160,CSE 21,A01,095574,Bach; Quang Tran,21,0,48,27
1656927194185,CSE 30,A01,083084,Eldon; John,4,0,80,76
1656927194185,CSE 30,B01,095061,Bhaskar; Nishant,6,0,50,44
1656927200213,CSE 100,A01,083659,Cao; Yingjun,3,4,70,67
1656927206236,CSE 134B,A01,083661,Powell; Thomas Allan,19,0,100,81
1656927212260,CSE 140,A01,083663,Gungor; Onat,14,0,85,71
1656927218288,CSE 140L,A01,083088,Eldon; John,16,0,100,84
1656927224318,CSE 175,A01,083665,Kumar; Rakesh,3,0,25,22
1656927230344,CSE 190,A00,092507,Dubnov; Shlomo,7,0,20,13
1656927236370,ECE 45,A01,083139,Congero; Spencer William,5,0,75,70
1656927242407,ECE 65,A50,083695,Saad; Andrew S,12,0,30,18
1656927242407,ECE 65,A51,095125,Saad; Andrew S,25,0,26,1
1656927248432,ECE 109,A01,091882,Touri; Behrouz,16,0,70,54
1656927254456,ECE 180,A00,083140,Abi Samra; Nicholas Camill,0,0,30,30
1656927254456,ECE 180,B00,083141,Abi Samra; Nicholas Camill,0,0,30,30
1656927260569,MATH 10A,A01,083735,Patchell; Gregory David,1,0,30,29
1656927260569,MATH 10A,A02,083736,Patchell; Gregory David,20,0,30,10
1656927260569,MATH 10A,A03,083737,Patchell; Gregory David,15,0,30,15
1656927266603,MATH 10B,A01,083207,Lim; Seonhee,7,0,34,27
1656927266603,MATH 10B,A02,083208,Lim; Seonhee,9,0,35,26
1656927266603,MATH 10B,A03,093472,Lim; Seonhee,4,0,34,30
1656927266603,MATH 10B,B01,083739,Sinha; Shubham,9,0,30,21
1656927272641,MATH 18,A01,083743,Cinel; Cameron Alexander,6,0,30,24
1656927272641,MATH 18,A02,083744,Cinel; Cameron Alexander,15,0,30,15
1656927272641,MATH 18,A03,083745,Cinel; Cameron Alexander,8,0,30,22
1656927272641,MATH 18,B01,083748,Rideout; David Porter,4,0,37,33
1656927272641,MATH 18,B02,083749,Rideout; David Porter,3,0,36,33
1656927272641,MATH 18,B03,083750,Rideout; David Porter,2,0,37,35
1656927272641,MATH 18,B04,083751,Rideout; David Porter,5,0,36,31
1656927272641,MATH 18,B05,093473,Rideout; David Porter,4,0,36,32
1656927272641,MATH 18,B06,093474,Rideout; David Porter,5,0,36,31
1656927278664,MATH 20A,A01,083754,Zheng; Zequn,12,0,40,28
1656927284693,MATH 20B,A01,083756,Briones; Jor-el Thomas Caparas,1,0,36,35
1656927284693,MATH 20B,A02,083757,Briones; Jor-el Thomas Caparas,1,0,36,35
1656927284693,MATH 20B,A03,093475,Briones; Jor-el Thomas Caparas,0,0,36,36
1656927290717,MATH 20C,A01,083760,Briones; Jor-el Thomas Caparas,1,0,35,34
1656927290717,MATH 20C,A02,083761,Briones; Jor-el Thomas Caparas,8,0,35,27
1656927290717,MATH 20C,A03,093476,Briones; Jor-el Thomas Caparas,0,1,36,36
1656927290717,MATH 20C,B01,083762,Bach; Quang Tran,0,0,30,30
1656927296742,MATH 20D,A01,083765,Tran; Brian Kha,4,0,30,26
1656927296742,MATH 20D,A02,083766,Tran; Brian Kha,4,0,30,26
1656927296742,MATH 20D,A03,083767,Tran; Brian Kha,3,0,30,27
1656927302773,MATH 20E,A01,083771,Ganguly; Soumya,5,0,32,27
1656927302773,MATH 20E,A02,083772,Ganguly; Soumya,6,0,32,26
1656927302773,MATH 20E,B01,083773,Ciotti; Benjamin,18,0,35,17
1656927302773,MATH 20E,B02,083774,Ciotti; Benjamin,17,0,35,18
1656927308797,MATH 103A,A01,083777,Greenfeld; Be'Eri,2,0,36,34
1656927308797,MATH 103A,A02,083778,Greenfeld; Be'Eri,5,0,36,31
1656927308797,MATH 103A,A03,093561,Greenfeld; Be'Eri,4,0,36,32
1656927308797,MATH 103A,B01,083779,Greenfeld; Be'Eri,6,0,36,30
1656927308797,MATH 103A,B02,083780,Greenfeld; Be'Eri,2,0,36,34
1656927308797,MATH 103A,B03,093562,Greenfeld; Be'Eri,2,0,36,34
1656927314823,MATH 105,A01,085443,Carter; Anne Toulson,13,0,35,22
1656927314823,MATH 105,A02,093477,Carter; Anne Toulson,20,0,35,15
1656927320847,MATH 109,A01,083213,Ganzberger; Geoffrey Michael,2,0,34,32
1656927320847,MATH 109,A02,083214,Ganzberger; Geoffrey Michael,2,0,34,32
1656927320847,MATH 109,A03,093478,Ganzberger; Geoffrey Michael,1,0,34,33
1656927320847,MATH 109,B01,083215,Ganzberger; Geoffrey Michael,1,0,32,31
1656927320847,MATH 109,B02,083216,Ganzberger; Geoffrey Michael,1,0,32,31
1656927320847,MATH 109,B03,093479,Ganzberger; Geoffrey Michael,6,0,32,26
1656927326872,MATH 142A,A01,083219,Chow; Bennett,6,0,32,26
1656927326872,MATH 142A,A02,083220,Chow; Bennett,10,0,32,22
1656927326872,MATH 142A,A03,093480,Chow; Bennett,7,0,32,25
1656927326872,MATH 142A,B03,093481,Chow; Bennett,7,0,32,25
1656927326872,MATH 142A,B04,093558,Chow; Bennett,11,0,32,21
1656927326872,MATH 142A,B05,093559,Chow; Bennett,6,0,32,26
1656927332900,MATH 193A,A01,083224,Rotar; Vladimir,7,0,34,27
1656927332900,MATH 193A,A02,083225,Rotar; Vladimir,3,0,34,31
1656927332900,MATH 193A,A03,083781,Rotar; Vladimir,1,0,34,33
1656927332900,MATH 193A,A04,083782,Rotar; Vladimir,6,0,34,28
1656927332900,MATH 193A,A05,093482,Rotar; Vladimir,6,0,34,28
1656927338927,MATH 197,001,091859,McAuley; Julian John,9999,0,9999,0
1656927338927,MATH 197,002,095566,Kedlaya; Kiran S.,9997,0,9999,2
1656927338927,MATH 197,003,095567,Xiao; Ming,9999,0,9999,0
1656927338927,MATH 197,004,095571,Perols; Johan Lars,9998,0,9999,1
1656927345994,COGS 9,A01,083615,Shannon; Kyle Michael,7,0,75,68
1656927352020,COGS 11,A01,083617,Boyle; Mary E. T.,19,0,48,29
1656927358048,COGS 13,A01,083071,Bastos; Amalia Pinkusfeld,9,0,71,62
1656927364071,COGS 14A,A01,092681,Semenuks; Arturs,0,1,100,100
1656927370096,COGS 14B,A01,083073,Cheng; Tzu-Han,5,0,63,58
1656927376122,COGS 17,A01,092677,Semenuks; Arturs,4,0,81,77
1656927382150,COGS 100,A01,083619,Allen; Michael Gordon,15,0,70,55
1656927388180,COGS 101A,A01,083621,Davis; Joshua Daniel,9,0,68,59
1656927394208,COGS 101B,A01,091572,Allen; Michael Gordon,8,0,65,57
1656927400238,COGS 101C,A01,083625,Delgado; Tania,17,0,35,18
1656927406261,COGS 107A,A01,083627,Boyle; Mary E. T.,13,0,60,47
1656927412292,COGS 118A,A01,083075,Gupta; Anjum,15,0,76,61
1656927418318,CSE 3,A50,083646,Miranda; Gregory Joseph,22,0,50,28
1656927424345,CSE 8A,A50,083650,Miranda; Gregory Joseph,17,1,56,39
1656927430369,CSE 11,A01,083080,Cao; Yingjun,4,15,40,36
1656927436394,CSE 12,A01,083652,Krause-Levy; Sophia Louisa,20,1,120,100
1656927442419,CSE 15L,A01,083654,Morris; Justin Loren,8,0,50,42
1656927442419,CSE 15L,A02,083655,Morris; Justin Loren,8,0,50,42
1656927448447,CSE 20,A01,083657,Tran; Khoa Dang,37,0,80,43
1656927454470,CSE 21,A01,095574,Bach; Quang Tran,21,0,48,27
1656927460496,CSE 30,A01,083084,Eldon; John,4,0,80,76
1656927460496,CSE 30,B01,095061,Bhaskar; Nishant,6,0,50,44
1656927466522,CSE 100,A01,083659,Cao; Yingjun,3,4,70,67
1656927472544,CSE 134B,A01,083661,Powell; Thomas Allan,19,0,100,81
1656927478573,CSE 140,A01,083663,Gungor; Onat,14,0,85,71
1656927484598,CSE 140L,A01,083088,Eldon; John,16,0,100,84
1656927490626,CSE 175,A01,083665,Kumar; Rakesh,3,0,25,22
1656927496649,CSE 190,A00,092507,Dubnov; Shlomo,7,0,20,13
1656927502672,ECE 45,A01,083139,Congero; Spencer William,5,0,75,70
1656927508697,ECE 65,A50,083695,Saad; Andrew S,12,0,30,18
1656927508697,ECE 65,A51,095125,Saad; Andrew S,25,0,26,1
1656927514727,ECE 109,A01,091882,Touri; Behrouz,16,0,70,54
1656927520749,ECE 180,A00,083140,Abi Samra; Nicholas Camill,0,0,30,30
1656927520749,ECE 180,B00,083141,Abi Samra; Nicholas Camill,0,0,30,30
1656927526780,MATH 10A,A01,083735,Patchell; Gregory David,1,0,30,29
1656927526780,MATH 10A,A02,083736,Patchell; Gregory David,20,0,30,10
1656927526780,MATH 10A,A03,083737,Patchell; Gregory David,15,0,30,15
1656927532804,MATH 10B,A01,083207,Lim; Seonhee,7,0,34,27
1656927532804,MATH 10B,A02,083208,Lim; Seonhee,9,0,35,26
1656927532804,MATH 10B,A03,093472,Lim; Seonhee,4,0,34,30
1656927532804,MATH 10B,B01,083739,Sinha; Shubham,9,0,30,21
1656927538830,MATH 18,A01,083743,Cinel; Cameron Alexander,6,0,30,24
1656927538830,MATH 18,A02,083744,Cinel; Cameron Alexander,15,0,30,15
1656927538830,MATH 18,A03,083745,Cinel; Cameron Alexander,8,0,30,22
1656927538830,MATH 18,B01,083748,Rideout; David Porter,4,0,37,33
1656927538830,MATH 18,B02,083749,Rideout; David Porter,3,0,36,33
1656927538830,MATH 18,B03,083750,Rideout; David Porter,2,0,37,35
1656927538830,MATH 18,B04,083751,Rideout; David Porter,5,0,36,31
1656927538830,MATH 18,B05,093473,Rideout; David Porter,4,0,36,32
1656927538830,MATH 18,B06,093474,Rideout; David Porter,5,0,36,31
1656927544859,MATH 20A,A01,083754,Zheng; Zequn,12,0,40,28
1656927550882,MATH 20B,A01,083756,Briones; Jor-el Thomas Caparas,1,0,36,35
1656927550882,MATH 20B,A02,083757,Briones; Jor-el Thomas Caparas,1,0,36,35
1656927550882,MATH 20B,A03,093475,Briones; Jor-el Thomas Caparas,0,0,36,36
1656927556912,MATH 20C,A01,083760,Briones; Jor-el Thomas Caparas,1,0,35,34
1656927556912,MATH 20C,A02,083761,Briones; Jor-el Thomas Caparas,8,0,35,27
1656927556912,MATH 20C,A03,093476,Briones; Jor-el Thomas Caparas,0,1,36,36
1656927556912,MATH 20C,B01,083762,Bach; Quang Tran,0,0,30,30
1656927562936,MATH 20D,A01,083765,Tran; Brian Kha,4,0,30,26
1656927562936,MATH 20D,A02,083766,Tran; Brian Kha,4,0,30,26
1656927562936,MATH 20D,A03,083767,Tran; Brian Kha,3,0,30,27
1656927568968,MATH 20E,A01,083771,Ganguly; Soumya,5,0,32,27
1656927568968,MATH 20E,A02,083772,Ganguly; Soumya,6,0,32,26
1656927568968,MATH 20E,B01,083773,Ciotti; Benjamin,18,0,35,17
1656927568968,MATH 20E,B02,083774,Ciotti; Benjamin,17,0,35,18
1656927574998,MATH 103A,A01,083777,Greenfeld; Be'Eri,2,0,36,34
1656927574998,MATH 103A,A02,083778,Greenfeld; Be'Eri,5,0,36,31
1656927574998,MATH 103A,A03,093561,Greenfeld; Be'Eri,4,0,36,32
1656927574998,MATH 103A,B01,083779,Greenfeld; Be'Eri,6,0,36,30
1656927574998,MATH 103A,B02,083780,Greenfeld; Be'Eri,2,0,36,34
1656927574998,MATH 103A,B03,093562,Greenfeld; Be'Eri,2,0,36,34
1656927581025,MATH 105,A01,085443,Carter; Anne Toulson,13,0,35,22
1656927581025,MATH 105,A02,093477,Carter; Anne Toulson,20,0,35,15
1656927587051,MATH 109,A01,083213,Ganzberger; Geoffrey Michael,2,0,34,32
1656927587051,MATH 109,A02,083214,Ganzberger; Geoffrey Michael,2,0,34,32
1656927587051,MATH 109,A03,093478,Ganzberger; Geoffrey Michael,1,0,34,33
1656927587051,MATH 109,B01,083215,Ganzberger; Geoffrey Michael,1,0,32,31
1656927587051,MATH 109,B02,083216,Ganzberger; Geoffrey Michael,1,0,32,31
1656927587051,MATH 109,B03,093479,Ganzberger; Geoffrey Michael,6,0,32,26
1656927593076,MATH 142A,A01,083219,Chow; Bennett,6,0,32,26
1656927593076,MATH 142A,A02,083220,Chow; Bennett,10,0,32,22
1656927593076,MATH 142A,A03,093480,Chow; Bennett,7,0,32,25
1656927593076,MATH 142A,B03,093481,Chow; Bennett,7,0,32,25
1656927593076,MATH 142A,B04,093558,Chow; Bennett,11,0,32,21
1656927593076,MATH 142A,B05,093559,Chow; Bennett,6,0,32,26
1656927599108,MATH 193A,A01,083224,Rotar; Vladimir,7,0,34,27
1656927599108,MATH 193A,A02,083225,Rotar; Vladimir,3,0,34,31
1656927599108,MATH 193A,A03,083781,Rotar; Vladimir,1,0,34,33
1656927599108,MATH 193A,A04,083782,Rotar; Vladimir,6,0,34,28
1656927599108,MATH 193A,A05,093482,Rotar; Vladimir,6,0,34,28
1656927605135,MATH 197,001,091859,McAuley; Julian John,9999,0,9999,0
1656927605135,MATH 197,002,095566,Kedlaya; Kiran S.,9997,0,9999,2
1656927605135,MATH 197,003,095567,Xiao; Ming,9999,0,9999,0
1656927605135,MATH 197,004,095571,Perols; Johan Lars,9998,0,9999,1
1656927612197,COGS 9,A01,083615,Shannon; Kyle Michael,7,0,75,68
1656927618222,COGS 11,A01,083617,Boyle; Mary E. T.,19,0,48,29
1656927624259,COGS 13,A01,083071,Bastos; Amalia Pinkusfeld,9,0,71,62
1656927630285,COGS 14A,A01,092681,Semenuks; Arturs,0,1,100,100
1656927636308,COGS 14B,A01,083073,Cheng; Tzu-Han,5,0,63,58
1656927642330,COGS 17,A01,092677,Semenuks; Arturs,4,0,81,77
1656927648354,COGS 100,A01,083619,Allen; Michael Gordon,15,0,70,55
1656927654381,COGS 101A,A01,083621,Davis; Joshua Daniel,9,0,68,59
1656927660406,COGS 101B,A01,091572,Allen; Michael Gordon,8,0,65,57
1656927666429,COGS 101C,A01,083625,Delgado; Tania,17,0,35,18
1656927672457,COGS 107A,A01,083627,Boyle; Mary E. T.,13,0,60,47
1656927678480,COGS 118A,A01,083075,Gupta; Anjum,15,0,76,61
1656927684511,CSE 3,A50,083646,Miranda; Gregory Joseph,22,0,50,28
1656927690535,CSE 8A,A50,083650,Miranda; Gregory Joseph,17,1,56,39
1656927696558,CSE 11,A01,083080,Cao; Yingjun,4,15,40,36
1656927702586,CSE 12,A01,083652,Krause-Levy; Sophia Louisa,20,1,120,100
1656927708610,CSE 15L,A01,083654,Morris; Justin Loren,8,0,50,42
1656927708610,CSE 15L,A02,083655,Morris; Justin Loren,8,0,50,42
1656927714637,CSE 20,A01,083657,Tran; Khoa Dang,37,0,80,43
1656927720660,CSE 21,A01,095574,Bach; Quang Tran,21,0,48,27
1656927726685,CSE 30,A01,083084,Eldon; John,4,0,80,76
1656927726685,CSE 30,B01,095061,Bhaskar; Nishant,6,0,50,44
1656927732711,CSE 100,A01,083659,Cao; Yingjun,3,4,70,67
1656927738734,CSE 134B,A01,083661,Powell; Thomas Allan,19,0,100,81
1656927744758,CSE 140,A01,083663,Gungor; Onat,14,0,85,71
1656927750782,CSE 140L,A01,083088,Eldon; John,16,0,100,84
1656927756805,CSE 175,A01,083665,Kumar; Rakesh,3,0,25,22
1656927762835,CSE 190,A00,092507,Dubnov; Shlomo,7,0,20,13
1656927768860,ECE 45,A01,083139,Congero; Spencer William,5,0,75,70
1656927774888,ECE 65,A50,083695,Saad; Andrew S,12,0,30,18
1656927774888,ECE 65,A51,095125,Saad; Andrew S,25,0,26,1
1656927780912,ECE 109,A01,091882,Touri; Behrouz,16,0,70,54
1656927786940,ECE 180,A00,083140,Abi Samra; Nicholas Camill,0,0,30,30
1656927786940,ECE 180,B00,083141,Abi Samra; Nicholas Camill,0,0,30,30
1656927792969,MATH 10A,A01,083735,Patchell; Gregory David,1,0,30,29
1656927792969,MATH 10A,A02,083736,Patchell; Gregory David,20,0,30,10
1656927792969,MATH 10A,A03,083737,Patchell; Gregory David,15,0,30,15
1656927798995,MATH 10B,A01,083207,Lim; Seonhee,7,0,34,27
1656927798995,MATH 10B,A02,083208,Lim; Seonhee,9,0,35,26
1656927798995,MATH 10B,A03,093472,Lim; Seonhee,4,0,34,30
1656927798995,MATH 10B,B01,083739,Sinha; Shubham,9,0,30,21
1656927805022,MATH 18,A01,083743,Cinel; Cameron Alexander,6,0,30,24
1656927805022,MATH 18,A02,083744,Cinel; Cameron Alexander,15,0,30,15
1656927805022,MATH 18,A03,083745,Cinel; Cameron Alexander,8,0,30,22
1656927805022,MATH 18,B01,083748,Rideout; David Porter,4,0,37,33
1656927805022,MATH 18,B02,083749,Rideout; David Porter,3,0,36,33
1656927805022,MATH 18,B03,083750,Rideout; David Porter,2,0,37,35
1656927805022,MATH 18,B04,083751,Rideout; David Porter,5,0,36,31
1656927805022,MATH 18,B05,093473,Rideout; David Porter,4,0,36,32
1656927805022,MATH 18,B06,093474,Rideout; David Porter,5,0,36,31
1656927811043,MATH 20A,A01,083754,Zheng; Zequn,12,0,40,28
1656927817066,MATH 20B,A01,083756,Briones; Jor-el Thomas Caparas,1,0,36,35
1656927817066,MATH 20B,A02,083757,Briones; Jor-el Thomas Caparas,1,0,36,35
1656927817066,MATH 20B,A03,093475,Briones; Jor-el Thomas Caparas,0,0,36,36
1656927823093,MATH 20C,A01,083760,Briones; Jor-el Thomas Caparas,1,0,35,34
1656927823093,MATH 20C,A02,083761,Briones; Jor-el Thomas Caparas,8,0,35,27
1656927823093,MATH 20C,A03,093476,Briones; Jor-el Thomas Caparas,0,1,36,36
1656927823093,MATH 20C,B01,083762,Bach; Quang Tran,0,0,30,30
1656927829121,MATH 20D,A01,083765,Tran; Brian Kha,4,0,30,26
1656927829121,MATH 20D,A02,083766,Tran; Brian Kha,4,0,30,26
1656927829121,MATH 20D,A03,083767,Tran; Brian Kha,3,0,30,27
1656927835146,MATH 20E,A01,083771,Ganguly; Soumya,5,0,32,27
1656927835146,MATH 20E,A02,083772,Ganguly; Soumya,6,0,32,26
1656927835146,MATH 20E,B01,083773,Ciotti; Benjamin,18,0,35,17
1656927835146,MATH 20E,B02,083774,Ciotti; Benjamin,17,0,35,18
1656927841174,MATH 103A,A01,083777,Greenfeld; Be'Eri,2,0,36,34
1656927841174,MATH 103A,A02,083778,Greenfeld; Be'Eri,5,0,36,31
1656927841174,MATH 103A,A03,093561,Greenfeld; Be'Eri,4,0,36,32
1656927841174,MATH 103A,B01,083779,Greenfeld; Be'Eri,6,0,36,30
1656927841174,MATH 103A,B02,083780,Greenfeld; Be'Eri,2,0,36,34
1656927841174,MATH 103A,B03,093562,Greenfeld; Be'Eri,2,0,36,34
1656927847198,MATH 105,A01,085443,Carter; Anne Toulson,13,0,35,22
1656927847198,MATH 105,A02,093477,Carter; Anne Toulson,20,0,35,15
1656927853228,MATH 109,A01,083213,Ganzberger; Geoffrey Michael,2,0,34,32
1656927853228,MATH 109,A02,083214,Ganzberger; Geoffrey Michael,2,0,34,32
1656927853228,MATH 109,A03,093478,Ganzberger; Geoffrey Michael,1,0,34,33
1656927853228,MATH 109,B01,083215,Ganzberger; Geoffrey Michael,1,0,32,31
1656927853228,MATH 109,B02,083216,Ganzberger; Geoffrey Michael,1,0,32,31
1656927853228,MATH 109,B03,093479,Ganzberger; Geoffrey Michael,6,0,32,26
1656927859338,MATH 142A,A01,083219,Chow; Bennett,6,0,32,26
1656927859338,MATH 142A,A02,083220,Chow; Bennett,10,0,32,22
1656927859338,MATH 142A,A03,093480,Chow; Bennett,7,0,32,25
1656927859338,MATH 142A,B03,093481,Chow; Bennett,7,0,32,25
1656927859338,MATH 142A,B04,093558,Chow; Bennett,11,0,32,21
1656927859338,MATH 142A,B05,093559,Chow; Bennett,6,0,32,26
1656927865363,MATH 193A,A01,083224,Rotar; Vladimir,7,0,34,27
1656927865363,MATH 193A,A02,083225,Rotar; Vladimir,3,0,34,31
1656927865363,MATH 193A,A03,083781,Rotar; Vladimir,1,0,34,33
1656927865363,MATH 193A,A04,083782,Rotar; Vladimir,6,0,34,28
1656927865363,MATH 193A,A05,093482,Rotar; Vladimir,6,0,34,28
1656927871388,MATH 197,001,091859,McAuley; Julian John,9999,0,9999,0
1656927871388,MATH 197,002,095566,Kedlaya; Kiran S.,9997,0,9999,2
1656927871388,MATH 197,003,095567,Xiao; Ming,9999,0,9999,0
1656927871388,MATH 197,004,095571,Perols; Johan Lars,9998,0,9999,1
1656927878461,COGS 9,A01,083615,Shannon; Kyle Michael,7,0,75,68
1656927884489,COGS 11,A01,083617,Boyle; Mary E. T.,19,0,48,29
1656927890516,COGS 13,A01,083071,Bastos; Amalia Pinkusfeld,9,0,71,62
1656927896540,COGS 14A,A01,092681,Semenuks; Arturs,0,1,100,100
1656927902564,COGS 14B,A01,083073,Cheng; Tzu-Han,5,0,63,58
1656927908587,COGS 17,A01,092677,Semenuks; Arturs,4,0,81,77
1656927914615,COGS 100,A01,083619,Allen; Michael Gordon,15,0,70,55
1656927920641,COGS 101A,A01,083621,Davis; Joshua Daniel,9,0,68,59
1656927926665,COGS 101B,A01,091572,Allen; Michael Gordon,8,0,65,57
1656927932693,COGS 101C,A01,083625,Delgado; Tania,17,0,35,18
1656927938716,COGS 107A,A01,083627,Boyle; Mary E. T.,13,0,60,47
1656927944740,COGS 118A,A01,083075,Gupta; Anjum,15,0,76,61
1656927950769,CSE 3,A50,083646,Miranda; Gregory Joseph,22,0,50,28
1656927956794,CSE 8A,A50,083650,Miranda; Gregory Joseph,17,1,56,39
1656927962818,CSE 11,A01,083080,Cao; Yingjun,4,15,40,36
1656927968840,CSE 12,A01,083652,Krause-Levy; Sophia Louisa,20,1,120,100
1656927974867,CSE 15L,A01,083654,Morris; Justin Loren,8,0,50,42
1656927974867,CSE 15L,A02,083655,Morris; Justin Loren,8,0,50,42
1656927980889,CSE 20,A01,083657,Tran; Khoa Dang,37,0,80,43
1656927986912,CSE 21,A01,095574,Bach; Quang Tran,21,0,48,27
1656927992936,CSE 30,A01,083084,Eldon; John,4,0,80,76
1656927992936,CSE 30,B01,095061,Bhaskar; Nishant,6,0,50,44
1656927998962,CSE 100,A01,083659,Cao; Yingjun,3,4,70,67
1656928004985,CSE 134B,A01,083661,Powell; Thomas Allan,19,0,100,81
1656928011012,CSE 140,A01,083663,Gungor; Onat,14,0,85,71
1656928017034,CSE 140L,A01,083088,Eldon; John,16,0,100,84
1656928023059,CSE 175,A01,083665,Kumar; Rakesh,3,0,25,22
1656928029081,CSE 190,A00,092507,Dubnov; Shlomo,7,0,20,13
1656928035103,ECE 45,A01,083139,Congero; Spencer William,5,0,75,70
1656928041129,ECE 65,A50,083695,Saad; Andrew S,12,0,30,18
1656928041129,ECE 65,A51,095125,Saad; Andrew S,25,0,26,1
1656928047153,ECE 109,A01,091882,Touri; Behrouz,16,0,70,54
1656928053176,ECE 180,A00,083140,Abi Samra; Nicholas Camill,0,0,30,30
1656928053176,ECE 180,B00,083141,Abi Samra; Nicholas Camill,0,0,30,30
1656928059211,MATH 10A,A01,083735,Patchell; Gregory David,1,0,30,29
1656928059211,MATH 10A,A02,083736,Patchell; Gregory David,20,0,30,10
1656928059211,MATH 10A,A03,083737,Patchell; Gregory David,15,0,30,15
1656928065235,MATH 10B,A01,083207,Lim; Seonhee,7,0,34,27
1656928065235,MATH 10B,A02,083208,Lim; Seonhee,9,0,35,26
1656928065235,MATH 10B,A03,093472,Lim; Seonhee,4,0,34,30
1656928065235,MATH 10B,B01,083739,Sinha; Shubham,9,0,30,21
1656928071260,MATH 18,A01,083743,Cinel; Cameron Alexander,6,0,30,24
1656928071260,MATH 18,A02,083744,Cinel; Cameron Alexander,15,0,30,15
1656928071260,MATH 18,A03,083745,Cinel; Cameron Alexander,8,0,30,22
1656928071260,MATH 18,B01,083748,Rideout; David Porter,4,0,37,33
1656928071260,MATH 18,B02,083749,Rideout; David Porter,3,0,36,33
1656928071260,MATH 18,B03,083750,Rideout; David Porter,2,0,37,35
1656928071260,MATH 18,B04,083751,Rideout; David Porter,5,0,36,31
1656928071260,MATH 18,B05,093473,Rideout; David Porter,4,0,36,32
1656928071260,MATH 18,B06,093474,Rideout; David Porter,5,0,36,31
1656928077288,MATH 20A,A01,083754,Zheng; Zequn,12,0,40,28
1656928083312,MATH 20B,A01,083756,Briones; Jor-el Thomas Caparas,1,0,36,35
1656928083312,MATH 20B,A02,083757,Briones; Jor-el Thomas Caparas,1,0,36,35
1656928083312,MATH 20B,A03,093475,Briones; Jor-el Thomas Caparas,0,0,36,36
1656928089340,MATH 20C,A01,083760,Briones; Jor-el Thomas Caparas,1,0,35,34
1656928089340,MATH 20C,A02,083761,Briones; Jor-el Thomas Caparas,8,0,35,27
1656928089340,MATH 20C,A03,093476,Briones; Jor-el Thomas Caparas,0,1,36,36
1656928089340,MATH 20C,B01,083762,Bach; Quang Tran,0,0,30,30
1656928095365,MATH 20D,A01,083765,Tran; Brian Kha,4,0,30,26
1656928095365,MATH 20D,A02,083766,Tran; Brian Kha,4,0,30,26
1656928095365,MATH 20D,A03,083767,Tran; Brian Kha,3,0,30,27
1656928101390,MATH 20E,A01,083771,Ganguly; Soumya,5,0,32,27
1656928101390,MATH 20E,A02,083772,Ganguly; Soumya,6,0,32,26
1656928101390,MATH 20E,B01,083773,Ciotti; Benjamin,18,0,35,17
1656928101390,MATH 20E,B02,083774,Ciotti; Benjamin,17,0,35,18
1656928107415,MATH 103A,A01,083777,Greenfeld; Be'Eri,2,0,36,34
1656928107415,MATH 103A,A02,083778,Greenfeld; Be'Eri,5,0,36,31
1656928107415,MATH 103A,A03,093561,Greenfeld; Be'Eri,4,0,36,32
1656928107415,MATH 103A,B01,083779,Greenfeld; Be'Eri,6,0,36,30
1656928107415,MATH 103A,B02,083780,Greenfeld; Be'Eri,2,0,36,34
1656928107415,MATH 103A,B03,093562,Greenfeld; Be'Eri,2,0,36,34
1656928113443,MATH 105,A01,085443,Carter; Anne Toulson,13,0,35,22
1656928113443,MATH 105,A02,093477,Carter; Anne Toulson,20,0,35,15
1656928119472,MATH 109,A01,083213,Ganzberger; Geoffrey Michael,2,0,34,32
1656928119472,MATH 109,A02,083214,Ganzberger; Geoffrey Michael,2,0,34,32
1656928119472,MATH 109,A03,093478,Ganzberger; Geoffrey Michael,1,0,34,33
1656928119472,MATH 109,B01,083215,Ganzberger; Geoffrey Michael,1,0,32,31
1656928119472,MATH 109,B02,083216,Ganzberger; Geoffrey Michael,1,0,32,31
1656928119472,MATH 109,B03,093479,Ganzberger; Geoffrey Michael,6,0,32,26
1656928125495,MATH 142A,A01,083219,Chow; Bennett,6,0,32,26
1656928125495,MATH 142A,A02,083220,Chow; Bennett,10,0,32,22
1656928125495,MATH 142A,A03,093480,Chow; Bennett,7,0,32,25
1656928125495,MATH 142A,B03,093481,Chow; Bennett,7,0,32,25
1656928125495,MATH 142A,B04,093558,Chow; Bennett,11,0,32,21
1656928125495,MATH 142A,B05,093559,Chow; Bennett,6,0,32,26
1656928131519,MATH 193A,A01,083224,Rotar; Vladimir,7,0,34,27
1656928131519,MATH 193A,A02,083225,Rotar; Vladimir,3,0,34,31
1656928131519,MATH 193A,A03,083781,Rotar; Vladimir,1,0,34,33
1656928131519,MATH 193A,A04,083782,Rotar; Vladimir,6,0,34,28
1656928131519,MATH 193A,A05,093482,Rotar; Vladimir,6,0,34,28
1656928137545,MATH 197,001,091859,McAuley; Julian John,9999,0,9999,0
1656928137545,MATH 197,002,095566,Kedlaya; Kiran S.,9997,0,9999,2
1656928137545,MATH 197,003,095567,Xiao; Ming,9999,0,9999,0
1656928137545,MATH 197,004,095571,Perols; Johan Lars,9998,0,9999,1
1656928144618,COGS 9,A01,083615,Shannon; Kyle Michael,7,0,75,68
1656928150646,COGS 11,A01,083617,Boyle; Mary E. T.,19,0,48,29
1656928156670,COGS 13,A01,083071,Bastos; Amalia Pinkusfeld,9,0,71,62
1656928162695,COGS 14A,A01,092681,Semenuks; Arturs,0,1,100,100
1656928168718,COGS 14B,A01,083073,Cheng; Tzu-Han,5,0,63,58
1656928174753,COGS 17,A01,092677,Semenuks; Arturs,4,0,81,77
1656928180780,COGS 100,A01,083619,Allen; Michael Gordon,15,0,70,55
1656928186804,COGS 101A,A01,083621,Davis; Joshua Daniel,9,0,68,59
1656928192827,COGS 101B,A01,091572,Allen; Michael Gordon,8,0,65,57
1656928198852,COGS 101C,A01,083625,Delgado; Tania,17,0,35,18
1656928204875,COGS 107A,A01,083627,Boyle; Mary E. T.,13,0,60,47
1656928210899,COGS 118A,A01,083075,Gupta; Anjum,15,0,76,61
1656928216926,CSE 3,A50,083646,Miranda; Gregory Joseph,22,0,50,28
1656928222951,CSE 8A,A50,083650,Miranda; Gregory Joseph,17,1,56,39
1656928228983,CSE 11,A01,083080,Cao; Yingjun,4,15,40,36
1656928235011,CSE 12,A01,083652,Krause-Levy; Sophia Louisa,20,1,120,100
1656928241039,CSE 15L,A01,083654,Morris; Justin Loren,8,0,50,42
1656928241039,CSE 15L,A02,083655,Morris; Justin Loren,8,0,50,42
1656928247066,CSE 20,A01,083657,Tran; Khoa Dang,37,0,80,43
1656928253088,CSE 21,A01,095574,Bach; Quang Tran,21,0,48,27
1656928259110,CSE 30,A01,083084,Eldon; John,4,0,80,76
1656928259110,CSE 30,B01,095061,Bhaskar; Nishant,6,0,50,44
1656928265133,CSE 100,A01,083659,Cao; Yingjun,3,4,70,67
1656928271159,CSE 134B,A01,083661,Powell; Thomas Allan,19,0,100,81
1656928277181,CSE 140,A01,083663,Gungor; Onat,14,0,85,71
1656928283209,CSE 140L,A01,083088,Eldon; John,16,0,100,84
1656928289234,CSE 175,A01,083665,Kumar; Rakesh,3,0,25,22
1656928295258,CSE 190,A00,092507,Dubnov; Shlomo,7,0,20,13
1656928301283,ECE 45,A01,083139,Congero; Spencer William,5,0,75,70
1656928307307,ECE 65,A50,083695,Saad; Andrew S,12,0,30,18
1656928307307,ECE 65,A51,095125,Saad; Andrew S,25,0,26,1
1656928313334,ECE 109,A01,091882,Touri; Behrouz,16,0,70,54
1656928319359,ECE 180,A00,083140,Abi Samra; Nicholas Camill,0,0,30,30
1656928319359,ECE 180,B00,083141,Abi Samra; Nicholas Camill,0,0,30,30
1656928325382,MATH 10A,A01,083735,Patchell; Gregory David,1,0,30,29
1656928325382,MATH 10A,A02,083736,Patchell; Gregory David,20,0,30,10
1656928325382,MATH 10A,A03,083737,Patchell; Gregory David,15,0,30,15
1656928331406,MATH 10B,A01,083207,Lim; Seonhee,7,0,34,27
1656928331406,MATH 10B,A02,083208,Lim; Seonhee,9,0,35,26
1656928331406,MATH 10B,A03,093472,Lim; Seonhee,4,0,34,30
1656928331406,MATH 10B,B01,083739,Sinha; Shubham,9,0,30,21
1656928337430,MATH 18,A01,083743,Cinel; Cameron Alexander,6,0,30,24
1656928337430,MATH 18,A02,083744,Cinel; Cameron Alexander,15,0,30,15
1656928337430,MATH 18,A03,083745,Cinel; Cameron Alexander,8,0,30,22
1656928337430,MATH 18,B01,083748,Rideout; David Porter,4,0,37,33
1656928337430,MATH 18,B02,083749,Rideout; David Porter,3,0,36,33
1656928337430,MATH 18,B03,083750,Rideout; David Porter,2,0,37,35
1656928337430,MATH 18,B04,083751,Rideout; David Porter,5,0,36,31
1656928337430,MATH 18,B05,093473,Rideout; David Porter,4,0,36,32
1656928337430,MATH 18,B06,093474,Rideout; David Porter,5,0,36,31
1656928343455,MATH 20A,A01,083754,Zheng; Zequn,12,0,40,28
1656928349478,MATH 20B,A01,083756,Briones; Jor-el Thomas Caparas,1,0,36,35
1656928349478,MATH 20B,A02,083757,Briones; Jor-el Thomas Caparas,1,0,36,35
1656928349478,MATH 20B,A03,093475,Briones; Jor-el Thomas Caparas,0,0,36,36
1656928355503,MATH 20C,A01,083760,Briones; Jor-el Thomas Caparas,1,0,35,34
1656928355503,MATH 20C,A02,083761,Briones; Jor-el Thomas Caparas,8,0,35,27
1656928355503,MATH 20C,A03,093476,Briones; Jor-el Thomas Caparas,0,1,36,36
1656928355503,MATH 20C,B01,083762,Bach; Quang Tran,0,0,30,30
1656928361529,MATH 20D,A01,083765,Tran; Brian Kha,4,0,30,26
1656928361529,MATH 20D,A02,083766,Tran; Brian Kha,4,0,30,26
1656928361529,MATH 20D,A03,083767,Tran; Brian Kha,3,0,30,27
1656928367559,MATH 20E,A01,083771,Ganguly; Soumya,5,0,32,27
1656928367559,MATH 20E,A02,083772,Ganguly; Soumya,6,0,32,26
1656928367559,MATH 20E,B01,083773,Ciotti; Benjamin,18,0,35,17
1656928367559,MATH 20E,B02,083774,Ciotti; Benjamin,17,0,35,18
1656928373582,MATH 103A,A01,083777,Greenfeld; Be'Eri,2,0,36,34
1656928373582,MATH 103A,A02,083778,Greenfeld; Be'Eri,5,0,36,31
1656928373582,MATH 103A,A03,093561,Greenfeld; Be'Eri,4,0,36,32
1656928373582,MATH 103A,B01,083779,Greenfeld; Be'Eri,6,0,36,30
1656928373582,MATH 103A,B02,083780,Greenfeld; Be'Eri,2,0,36,34
1656928373582,MATH 103A,B03,093562,Greenfeld; Be'Eri,2,0,36,34
1656928379605,MATH 105,A01,085443,Carter; Anne Toulson,13,0,35,22
1656928379605,MATH 105,A02,093477,Carter; Anne Toulson,20,0,35,15
1656928385630,MATH 109,A01,083213,Ganzberger; Geoffrey Michael,2,0,34,32
1656928385630,MATH 109,A02,083214,Ganzberger; Geoffrey Michael,2,0,34,32
1656928385630,MATH 109,A03,093478,Ganzberger; Geoffrey Michael,1,0,34,33
1656928385630,MATH 109,B01,083215,Ganzberger; Geoffrey Michael,1,0,32,31
1656928385630,MATH 109,B02,083216,Ganzberger; Geoffrey Michael,1,0,32,31
1656928385630,MATH 109,B03,093479,Ganzberger; Geoffrey Michael,6,0,32,26
1656928391654,MATH 142A,A01,083219,Chow; Bennett,6,0,32,26
1656928391654,MATH 142A,A02,083220,Chow; Bennett,10,0,32,22
1656928391654,MATH 142A,A03,093480,Chow; Bennett,7,0,32,25
1656928391654,MATH 142A,B03,093481,Chow; Bennett,7,0,32,25
1656928391654,MATH 142A,B04,093558,Chow; Bennett,11,0,32,21
1656928391654,MATH 142A,B05,093559,Chow; Bennett,6,0,32,26
1656928397682,MATH 193A,A01,083224,Rotar; Vladimir,7,0,34,27
1656928397682,MATH 193A,A02,083225,Rotar; Vladimir,3,0,34,31
1656928397682,MATH 193A,A03,083781,Rotar; Vladimir,1,0,34,33
1656928397682,MATH 193A,A04,083782,Rotar; Vladimir,6,0,34,28
1656928397682,MATH 193A,A05,093482,Rotar; Vladimir,6,0,34,28
1656928403706,MATH 197,001,091859,McAuley; Julian John,9999,0,9999,0
1656928403706,MATH 197,002,095566,Kedlaya; Kiran S.,9997,0,9999,2
1656928403706,MATH 197,003,095567,Xiao; Ming,9999,0,9999,0
1656928403706,MATH 197,004,095571,Perols; Johan Lars,9998,0,9999,1
1656928410767,COGS 9,A01,083615,Shannon; Kyle Michael,7,0,75,68
1656928416790,COGS 11,A01,083617,Boyle; Mary E. T.,19,0,48,29
1656928422816,COGS 13,A01,083071,Bastos; Amalia Pinkusfeld,9,0,71,62
1656928428842,COGS 14A,A01,092681,Semenuks; Arturs,0,1,100,100
1656928434870,COGS 14B,A01,083073,Cheng; Tzu-Han,5,0,63,58
1656928440893,COGS 17,A01,092677,Semenuks; Arturs,4,0,81,77
1656928446916,COGS 100,A01,083619,Allen; Michael Gordon,15,0,70,55
1656928453013,COGS 101A,A01,083621,Davis; Joshua Daniel,9,0,68,59
1656928459040,COGS 101B,A01,091572,Allen; Michael Gordon,8,0,65,57
1656928465063,COGS 101C,A01,083625,Delgado; Tania,17,0,35,18
1656928471087,COGS 107A,A01,083627,Boyle; Mary E. T.,13,0,60,47
1656928477114,COGS 118A,A01,083075,Gupta; Anjum,15,0,76,61
1656928483138,CSE 3,A50,083646,Miranda; Gregory Joseph,22,0,50,28
1656928489166,CSE 8A,A50,083650,Miranda; Gregory Joseph,17,1,56,39
1656928495190,CSE 11,A01,083080,Cao; Yingjun,4,15,40,36
1656928501215,CSE 12,A01,083652,Krause-Levy; Sophia Louisa,20,1,120,100
1656928507237,CSE 15L,A01,083654,Morris; Justin Loren,8,0,50,42
1656928507237,CSE 15L,A02,083655,Morris; Justin Loren,8,0,50,42
1656928513261,CSE 20,A01,083657,Tran; Khoa Dang,37,0,80,43
1656928519287,CSE 21,A01,095574,Bach; Quang Tran,21,0,48,27
1656928525316,CSE 30,A01,083084,Eldon; John,4,0,80,76
1656928525316,CSE 30,B01,095061,Bhaskar; Nishant,6,0,50,44
1656928531340,CSE 100,A01,083659,Cao; Yingjun,3,4,70,67
1656928537364,CSE 134B,A01,083661,Powell; Thomas Allan,19,0,100,81
1656928543387,CSE 140,A01,083663,Gungor; Onat,14,0,85,71
1656928549411,CSE 140L,A01,083088,Eldon; John,16,0,100,84
1656928555437,CSE 175,A01,083665,Kumar; Rakesh,3,0,25,22
1656928561467,CSE 190,A00,092507,Dubnov; Shlomo,7,0,20,13
1656928567492,ECE 45,A01,083139,Congero; Spencer William,5,0,75,70
1656928573516,ECE 65,A50,083695,Saad; Andrew S,12,0,30,18
1656928573516,ECE 65,A51,095125,Saad; Andrew S,25,0,26,1
1656928579544,ECE 109,A01,091882,Touri; Behrouz,16,0,70,54
1656928585572,ECE 180,A00,083140,Abi Samra; Nicholas Camill,0,0,30,30
1656928585572,ECE 180,B00,083141,Abi Samra; Nicholas Camill,0,0,30,30
1656928591598,MATH 10A,A01,083735,Patchell; Gregory David,1,0,30,29
1656928591598,MATH 10A,A02,083736,Patchell; Gregory David,20,0,30,10
1656928591598,MATH 10A,A03,083737,Patchell; Gregory David,15,0,30,15
1656928597628,MATH 10B,A01,083207,Lim; Seonhee,7,0,34,27
1656928597628,MATH 10B,A02,083208,Lim; Seonhee,9,0,35,26
1656928597628,MATH 10B,A03,093472,Lim; Seonhee,4,0,34,30
1656928597628,MATH 10B,B01,083739,Sinha; Shubham,9,0,30,21
1656928603661,MATH 18,A01,083743,Cinel; Cameron Alexander,6,0,30,24
1656928603661,MATH 18,A02,083744,Cinel; Cameron Alexander,15,0,30,15
1656928603661,MATH 18,A03,083745,Cinel; Cameron Alexander,8,0,30,22
1656928603661,MATH 18,B01,083748,Rideout; David Porter,4,0,37,33
1656928603661,MATH 18,B02,083749,Rideout; David Porter,3,0,36,33
1656928603661,MATH 18,B03,083750,Rideout; David Porter,2,0,37,35
1656928603661,MATH 18,B04,083751,Rideout; David Porter,5,0,36,31
1656928603661,MATH 18,B05,093473,Rideout; David Porter,4,0,36,32
1656928603661,MATH 18,B06,093474,Rideout; David Porter,5,0,36,31
1656928609691,MATH 20A,A01,083754,Zheng; Zequn,12,0,40,28
1656928615713,MATH 20B,A01,083756,Briones; Jor-el Thomas Caparas,1,0,36,35
1656928615713,MATH 20B,A02,083757,Briones; Jor-el Thomas Caparas,1,0,36,35
1656928615713,MATH 20B,A03,093475,Briones; Jor-el Thomas Caparas,0,0,36,36
1656928621758,MATH 20C,A01,083760,Briones; Jor-el Thomas Caparas,1,0,35,34
1656928621758,MATH 20C,A02,083761,Briones; Jor-el Thomas Caparas,8,0,35,27
1656928621758,MATH 20C,A03,093476,Briones; Jor-el Thomas Caparas,0,1,36,36
1656928621758,MATH 20C,B01,083762,Bach; Quang Tran,0,0,30,30
1656928627780,MATH 20D,A01,083765,Tran; Brian Kha,4,0,30,26
1656928627780,MATH 20D,A02,083766,Tran; Brian Kha,4,0,30,26
1656928627780,MATH 20D,A03,083767,Tran; Brian Kha,3,0,30,27
1656928633808,MATH 20E,A01,083771,Ganguly; Soumya,5,0,32,27
1656928633808,MATH 20E,A02,083772,Ganguly; Soumya,6,0,32,26
1656928633808,MATH 20E,B01,083773,Ciotti; Benjamin,18,0,35,17
1656928633808,MATH 20E,B02,083774,Ciotti; Benjamin,17,0,35,18
1656928639832,MATH 103A,A01,083777,Greenfeld; Be'Eri,2,0,36,34
1656928639832,MATH 103A,A02,083778,Greenfeld; Be'Eri,5,0,36,31
1656928639832,MATH 103A,A03,093561,Greenfeld; Be'Eri,4,0,36,32
1656928639832,MATH 103A,B01,083779,Greenfeld; Be'Eri,6,0,36,30
1656928639832,MATH 103A,B02,083780,Greenfeld; Be'Eri,2,0,36,34
1656928639832,MATH 103A,B03,093562,Greenfeld; Be'Eri,2,0,36,34
1656928645856,MATH 105,A01,085443,Carter; Anne Toulson,13,0,35,22
1656928645856,MATH 105,A02,093477,Carter; Anne Toulson,20,0,35,15
1656928651885,MATH 109,A01,083213,Ganzberger; Geoffrey Michael,2,0,34,32
1656928651885,MATH 109,A02,083214,Ganzberger; Geoffrey Michael,2,0,34,32
1656928651885,MATH 109,A03,093478,Ganzberger; Geoffrey Michael,1,0,34,33
1656928651885,MATH 109,B01,083215,Ganzberger; Geoffrey Michael,1,0,32,31
1656928651885,MATH 109,B02,083216,Ganzberger; Geoffrey Michael,1,0,32,31
1656928651885,MATH 109,B03,093479,Ganzberger; Geoffrey Michael,6,0,32,26
1656928657909,MATH 142A,A01,083219,Chow; Bennett,6,0,32,26
1656928657909,MATH 142A,A02,083220,Chow; Bennett,10,0,32,22
1656928657909,MATH 142A,A03,093480,Chow; Bennett,7,0,32,25
1656928657909,MATH 142A,B03,093481,Chow; Bennett,7,0,32,25
1656928657909,MATH 142A,B04,093558,Chow; Bennett,11,0,32,21
1656928657909,MATH 142A,B05,093559,Chow; Bennett,6,0,32,26
1656928663933,MATH 193A,A01,083224,Rotar; Vladimir,7,0,34,27
1656928663933,MATH 193A,A02,083225,Rotar; Vladimir,3,0,34,31
1656928663933,MATH 193A,A03,083781,Rotar; Vladimir,1,0,34,33
1656928663933,MATH 193A,A04,083782,Rotar; Vladimir,6,0,34,28
1656928663933,MATH 193A,A05,093482,Rotar; Vladimir,6,0,34,28
1656928669959,MATH 197,001,091859,McAuley; Julian John,9999,0,9999,0
1656928669959,MATH 197,002,095566,Kedlaya; Kiran S.,9997,0,9999,2
1656928669959,MATH 197,003,095567,Xiao; Ming,9999,0,9999,0
1656928669959,MATH 197,004,095571,Perols; Johan Lars,9998,0,9999,1
1656928677034,COGS 9,A01,083615,Shannon; Kyle Michael,7,0,75,68
1656928683056,COGS 11,A01,083617,Boyle; Mary E. T.,19,0,48,29
1656928689081,COGS 13,A01,083071,Bastos; Amalia Pinkusfeld,9,0,71,62
1656928695105,COGS 14A,A01,092681,Semenuks; Arturs,0,1,100,100
1656928701129,COGS 14B,A01,083073,Cheng; Tzu-Han,5,0,63,58
1656928707152,COGS 17,A01,092677,Semenuks; Arturs,4,0,81,77
1656928713179,COGS 100,A01,083619,Allen; Michael Gordon,15,0,70,55
1656928719206,COGS 101A,A01,083621,Davis; Joshua Daniel,9,0,68,59
1656928725230,COGS 101B,A01,091572,Allen; Michael Gordon,8,0,65,57
1656928731252,COGS 101C,A01,083625,Delgado; Tania,17,0,35,18
1656928737278,COGS 107A,A01,083627,Boyle; Mary E. T.,13,0,60,47
1656928743303,COGS 118A,A01,083075,Gupta; Anjum,15,0,76,61
1656928749326,CSE 3,A50,083646,Miranda; Gregory Joseph,22,0,50,28
1656928755358,CSE 8A,A50,083650,Miranda; Gregory Joseph,17,1,56,39
1656928761382,CSE 11,A01,083080,Cao; Yingjun,4,15,40,36
1656928767410,CSE 12,A01,083652,Krause-Levy; Sophia Louisa,20,1,120,100
1656928773438,CSE 15L,A01,083654,Morris; Justin Loren,8,0,50,42
1656928773438,CSE 15L,A02,083655,Morris; Justin Loren,8,0,50,42
1656928779461,CSE 20,A01,083657,Tran; Khoa Dang,37,0,80,43
1656928785483,CSE 21,A01,095574,Bach; Quang Tran,21,0,48,27
1656928791507,CSE 30,A01,083084,Eldon; John,4,0,80,76
1656928791507,CSE 30,B01,095061,Bhaskar; Nishant,6,0,50,44
1656928797538,CSE 100,A01,083659,Cao; Yingjun,3,4,70,67
1656928803561,CSE 134B,A01,083661,Powell; Thomas Allan,19,0,100,81
1656928809590,CSE 140,A01,083663,Gungor; Onat,14,0,85,71
1656928815613,CSE 140L,A01,083088,Eldon; John,16,0,100,84
1656928821637,CSE 175,A01,083665,Kumar; Rakesh,3,0,25,22
1656928827663,CSE 190,A00,092507,Dubnov; Shlomo,7,0,20,13
1656928833692,ECE 45,A01,083139,Congero; Spencer William,5,0,75,70
1656928839718,ECE 65,A50,083695,Saad; Andrew S,12,0,30,18
1656928839718,ECE 65,A51,095125,Saad; Andrew S,25,0,26,1
1656928845744,ECE 109,A01,091882,Touri; Behrouz,16,0,70,54
1656928851773,ECE 180,A00,083140,Abi Samra; Nicholas Camill,0,0,30,30
1656928851773,ECE 180,B00,083141,Abi Samra; Nicholas Camill,0,0,30,30
1656928857797,MATH 10A,A01,083735,Patchell; Gregory David,1,0,30,29
1656928857797,MATH 10A,A02,083736,Patchell; Gregory David,20,0,30,10
1656928857797,MATH 10A,A03,083737,Patchell; Gregory David,15,0,30,15
1656928863827,MATH 10B,A01,083207,Lim; Seonhee,7,0,34,27
1656928863827,MATH 10B,A02,083208,Lim; Seonhee,9,0,35,26
1656928863827,MATH 10B,A03,093472,Lim; Seonhee,4,0,34,30
1656928863827,MATH 10B,B01,083739,Sinha; Shubham,9,0,30,21
1656928869851,MATH 18,A01,083743,Cinel; Cameron Alexander,6,0,30,24
1656928869851,MATH 18,A02,083744,Cinel; Cameron Alexander,15,0,30,15
1656928869851,MATH 18,A03,083745,Cinel; Cameron Alexander,8,0,30,22
1656928869851,MATH 18,B01,083748,Rideout; David Porter,4,0,37,33
1656928869851,MATH 18,B02,083749,Rideout; David Porter,3,0,36,33
1656928869851,MATH 18,B03,083750,Rideout; David Porter,2,0,37,35
1656928869851,MATH 18,B04,083751,Rideout; David Porter,5,0,36,31
1656928869851,MATH 18,B05,093473,Rideout; David Porter,4,0,36,32
1656928869851,MATH 18,B06,093474,Rideout; David Porter,5,0,36,31
1656928875875,MATH 20A,A01,083754,Zheng; Zequn,12,0,40,28
1656928881901,MATH 20B,A01,083756,Briones; Jor-el Thomas Caparas,1,0,36,35
1656928881901,MATH 20B,A02,083757,Briones; Jor-el Thomas Caparas,1,0,36,35
1656928881901,MATH 20B,A03,093475,Briones; Jor-el Thomas Caparas,0,0,36,36
1656928887925,MATH 20C,A01,083760,Briones; Jor-el Thomas Caparas,1,0,35,34
1656928887925,MATH 20C,A02,083761,Briones; Jor-el Thomas Caparas,8,0,35,27
1656928887925,MATH 20C,A03,093476,Briones; Jor-el Thomas Caparas,0,1,36,36
1656928887925,MATH 20C,B01,083762,Bach; Quang Tran,0,0,30,30
1656928893955,MATH 20D,A01,083765,Tran; Brian Kha,4,0,30,26
1656928893955,MATH 20D,A02,083766,Tran; Brian Kha,4,0,30,26
1656928893955,MATH 20D,A03,083767,Tran; Brian Kha,3,0,30,27
1656928899980,MATH 20E,A01,083771,Ganguly; Soumya,5,0,32,27
1656928899980,MATH 20E,A02,083772,Ganguly; Soumya,6,0,32,26
1656928899980,MATH 20E,B01,083773,Ciotti; Benjamin,18,0,35,17
1656928899980,MATH 20E,B02,083774,Ciotti; Benjamin,17,0,35,18
1656928906004,MATH 103A,A01,083777,Greenfeld; Be'Eri,2,0,36,34
1656928906004,MATH 103A,A02,083778,Greenfeld; Be'Eri,5,0,36,31
1656928906004,MATH 103A,A03,093561,Greenfeld; Be'Eri,4,0,36,32
1656928906004,MATH 103A,B01,083779,Greenfeld; Be'Eri,6,0,36,30
1656928906004,MATH 103A,B02,083780,Greenfeld; Be'Eri,2,0,36,34
1656928906004,MATH 103A,B03,093562,Greenfeld; Be'Eri,2,0,36,34
1656928912027,MATH 105,A01,085443,Carter; Anne Toulson,13,0,35,22
1656928912027,MATH 105,A02,093477,Carter; Anne Toulson,20,0,35,15
1656928918052,MATH 109,A01,083213,Ganzberger; Geoffrey Michael,2,0,34,32
1656928918052,MATH 109,A02,083214,Ganzberger; Geoffrey Michael,2,0,34,32
1656928918052,MATH 109,A03,093478,Ganzberger; Geoffrey Michael,1,0,34,33
1656928918052,MATH 109,B01,083215,Ganzberger; Geoffrey Michael,1,0,32,31
1656928918052,MATH 109,B02,083216,Ganzberger; Geoffrey Michael,1,0,32,31
1656928918052,MATH 109,B03,093479,Ganzberger; Geoffrey Michael,6,0,32,26
1656928924081,MATH 142A,A01,083219,Chow; Bennett,6,0,32,26
1656928924081,MATH 142A,A02,083220,Chow; Bennett,10,0,32,22
1656928924081,MATH 142A,A03,093480,Chow; Bennett,7,0,32,25
1656928924081,MATH 142A,B03,093481,Chow; Bennett,7,0,32,25
1656928924081,MATH 142A,B04,093558,Chow; Bennett,11,0,32,21
1656928924081,MATH 142A,B05,093559,Chow; Bennett,6,0,32,26
1656928930110,MATH 193A,A01,083224,Rotar; Vladimir,7,0,34,27
1656928930110,MATH 193A,A02,083225,Rotar; Vladimir,3,0,34,31
1656928930110,MATH 193A,A03,083781,Rotar; Vladimir,1,0,34,33
1656928930110,MATH 193A,A04,083782,Rotar; Vladimir,6,0,34,28
1656928930110,MATH 193A,A05,093482,Rotar; Vladimir,6,0,34,28
1656928936151,MATH 197,001,091859,McAuley; Julian John,9999,0,9999,0
1656928936151,MATH 197,002,095566,Kedlaya; Kiran S.,9997,0,9999,2
1656928936151,MATH 197,003,095567,Xiao; Ming,9999,0,9999,0
1656928936151,MATH 197,004,095571,Perols; Johan Lars,9998,0,9999,1
1656928943215,COGS 9,A01,083615,Shannon; Kyle Michael,7,0,75,68
1656928949239,COGS 11,A01,083617,Boyle; Mary E. T.,19,0,48,29
1656928955266,COGS 13,A01,083071,Bastos; Amalia Pinkusfeld,9,0,71,62
1656928961294,COGS 14A,A01,092681,Semenuks; Arturs,0,1,100,100
1656928967321,COGS 14B,A01,083073,Cheng; Tzu-Han,5,0,63,58
1656928973344,COGS 17,A01,092677,Semenuks; Arturs,4,0,81,77
1656928979366,COGS 100,A01,083619,Allen; Michael Gordon,15,0,70,55
1656928985397,COGS 101A,A01,083621,Davis; Joshua Daniel,9,0,68,59
1656928991418,COGS 101B,A01,091572,Allen; Michael Gordon,8,0,65,57
1656928997441,COGS 101C,A01,083625,Delgado; Tania,17,0,35,18
1656929003465,COGS 107A,A01,083627,Boyle; Mary E. T.,13,0,60,47
1656929009493,COGS 118A,A01,083075,Gupta; Anjum,15,0,76,61
1656929015516,CSE 3,A50,083646,Miranda; Gregory Joseph,22,0,50,28
1656929021548,CSE 8A,A50,083650,Miranda; Gregory Joseph,17,1,56,39
1656929027571,CSE 11,A01,083080,Cao; Yingjun,4,15,40,36
1656929033593,CSE 12,A01,083652,Krause-Levy; Sophia Louisa,20,1,120,100
1656929039621,CSE 15L,A01,083654,Morris; Justin Loren,8,0,50,42
1656929039621,CSE 15L,A02,083655,Morris; Justin Loren,8,0,50,42
1656929045647,CSE 20,A01,083657,Tran; Khoa Dang,37,0,80,43
1656929051777,CSE 21,A01,095574,Bach; Quang Tran,21,0,48,27
1656929057802,CSE 30,A01,083084,Eldon; John,4,0,80,76
1656929057802,CSE 30,B01,095061,Bhaskar; Nishant,6,0,50,44
1656929063825,CSE 100,A01,083659,Cao; Yingjun,3,4,70,67
1656929069847,CSE 134B,A01,083661,Powell; Thomas Allan,19,0,100,81
1656929075870,CSE 140,A01,083663,Gungor; Onat,14,0,85,71
1656929081895,CSE 140L,A01,083088,Eldon; John,16,0,100,84
1656929087927,CSE 175,A01,083665,Kumar; Rakesh,3,0,25,22
1656929093949,CSE 190,A00,092507,Dubnov; Shlomo,7,0,20,13
1656929099972,ECE 45,A01,083139,Congero; Spencer William,5,0,75,70
1656929105996,ECE 65,A50,083695,Saad; Andrew S,12,0,30,18
1656929105996,ECE 65,A51,095125,Saad; Andrew S,25,0,26,1
1656929112019,ECE 109,A01,091882,Touri; Behrouz,16,0,70,54
1656929118043,ECE 180,A00,083140,Abi Samra; Nicholas Camill,0,0,30,30
1656929118043,ECE 180,B00,083141,Abi Samra; Nicholas Camill,0,0,30,30
1656929124066,MATH 10A,A01,083735,Patchell; Gregory David,1,0,30,29
1656929124066,MATH 10A,A02,083736,Patchell; Gregory David,20,0,30,10
1656929124066,MATH 10A,A03,083737,Patchell; Gregory David,15,0,30,15
1656929130097,MATH 10B,A01,083207,Lim; Seonhee,7,0,34,27
1656929130097,MATH 10B,A02,083208,Lim; Seonhee,9,0,35,26
1656929130097,MATH 10B,A03,093472,Lim; Seonhee,4,0,34,30
1656929130097,MATH 10B,B01,083739,Sinha; Shubham,9,0,30,21
1656929136121,MATH 18,A01,083743,Cinel; Cameron Alexander,6,0,30,24
1656929136121,MATH 18,A02,083744,Cinel; Cameron Alexander,15,0,30,15
1656929136121,MATH 18,A03,083745,Cinel; Cameron Alexander,8,0,30,22
1656929136121,MATH 18,B01,083748,Rideout; David Porter,4,0,37,33
1656929136121,MATH 18,B02,083749,Rideout; David Porter,3,0,36,33
1656929136121,MATH 18,B03,083750,Rideout; David Porter,2,0,37,35
1656929136121,MATH 18,B04,083751,Rideout; David Porter,5,0,36,31
1656929136121,MATH 18,B05,093473,Rideout; David Porter,4,0,36,32
1656929136121,MATH 18,B06,093474,Rideout; David Porter,5,0,36,31
1656929142149,MATH 20A,A01,083754,Zheng; Zequn,12,0,40,28
1656929148181,MATH 20B,A01,083756,Briones; Jor-el Thomas Caparas,1,0,36,35
1656929148181,MATH 20B,A02,083757,Briones; Jor-el Thomas Caparas,1,0,36,35
1656929148181,MATH 20B,A03,093475,Briones; Jor-el Thomas Caparas,0,0,36,36
1656929154204,MATH 20C,A01,083760,Briones; Jor-el Thomas Caparas,1,0,35,34
1656929154204,MATH 20C,A02,083761,Briones; Jor-el Thomas Caparas,8,0,35,27
1656929154204,MATH 20C,A03,093476,Briones; Jor-el Thomas Caparas,0,1,36,36
1656929154204,MATH 20C,B01,083762,Bach; Quang Tran,0,0,30,30
1656929160229,MATH 20D,A01,083765,Tran; Brian Kha,4,0,30,26
1656929160229,MATH 20D,A02,083766,Tran; Brian Kha,4,0,30,26
1656929160229,MATH 20D,A03,083767,Tran; Brian Kha,3,0,30,27
1656929166255,MATH 20E,A01,083771,Ganguly; Soumya,5,0,32,27
1656929166255,MATH 20E,A02,083772,Ganguly; Soumya,6,0,32,26
1656929166255,MATH 20E,B01,083773,Ciotti; Benjamin,18,0,35,17
1656929166255,MATH 20E,B02,083774,Ciotti; Benjamin,17,0,35,18
1656929172285,MATH 103A,A01,083777,Greenfeld; Be'Eri,2,0,36,34
1656929172285,MATH 103A,A02,083778,Greenfeld; Be'Eri,5,0,36,31
1656929172285,MATH 103A,A03,093561,Greenfeld; Be'Eri,4,0,36,32
1656929172285,MATH 103A,B01,083779,Greenfeld; Be'Eri,6,0,36,30
1656929172285,MATH 103A,B02,083780,Greenfeld; Be'Eri,2,0,36,34
1656929172285,MATH 103A,B03,093562,Greenfeld; Be'Eri,2,0,36,34
1656929178313,MATH 105,A01,085443,Carter; Anne Toulson,13,0,35,22
1656929178313,MATH 105,A02,093477,Carter; Anne Toulson,20,0,35,15
1656929184337,MATH 109,A01,083213,Ganzberger; Geoffrey Michael,2,0,34,32
1656929184337,MATH 109,A02,083214,Ganzberger; Geoffrey Michael,2,0,34,32
1656929184337,MATH 109,A03,093478,Ganzberger; Geoffrey Michael,1,0,34,33
1656929184337,MATH 109,B01,083215,Ganzberger; Geoffrey Michael,1,0,32,31
1656929184337,MATH 109,B02,083216,Ganzberger; Geoffrey Michael,1,0,32,31
1656929184337,MATH 109,B03,093479,Ganzberger; Geoffrey Michael,6,0,32,26
1656929190368,MATH 142A,A01,083219,Chow; Bennett,6,0,32,26
1656929190368,MATH 142A,A02,083220,Chow; Bennett,10,0,32,22
1656929190368,MATH 142A,A03,093480,Chow; Bennett,7,0,32,25
1656929190368,MATH 142A,B03,093481,Chow; Bennett,7,0,32,25
1656929190368,MATH 142A,B04,093558,Chow; Bennett,11,0,32,21
1656929190368,MATH 142A,B05,093559,Chow; Bennett,6,0,32,26
1656929196395,MATH 193A,A01,083224,Rotar; Vladimir,7,0,34,27
1656929196395,MATH 193A,A02,083225,Rotar; Vladimir,3,0,34,31
1656929196395,MATH 193A,A03,083781,Rotar; Vladimir,1,0,34,33
1656929196395,MATH 193A,A04,083782,Rotar; Vladimir,6,0,34,28
1656929196395,MATH 193A,A05,093482,Rotar; Vladimir,6,0,34,28
1656929202416,MATH 197,001,091859,McAuley; Julian John,9999,0,9999,0
1656929202416,MATH 197,002,095566,Kedlaya; Kiran S.,9997,0,9999,2
1656929202416,MATH 197,003,095567,Xiao; Ming,9999,0,9999,0
1656929202416,MATH 197,004,095571,Perols; Johan Lars,9998,0,9999,1
1656929209482,COGS 9,A01,083615,Shannon; Kyle Michael,7,0,75,68
1656929215504,COGS 11,A01,083617,Boyle; Mary E. T.,19,0,48,29
1656929221532,COGS 13,A01,083071,Bastos; Amalia Pinkusfeld,9,0,71,62
1656929227556,COGS 14A,A01,092681,Semenuks; Arturs,0,1,100,100
1656929233582,COGS 14B,A01,083073,Cheng; Tzu-Han,5,0,63,58
1656929239609,COGS 17,A01,092677,Semenuks; Arturs,4,0,81,77
1656929245634,COGS 100,A01,083619,Allen; Michael Gordon,15,0,70,55
1656929251660,COGS 101A,A01,083621,Davis; Joshua Daniel,9,0,68,59
1656929257686,COGS 101B,A01,091572,Allen; Michael Gordon,8,0,65,57
1656929263711,COGS 101C,A01,083625,Delgado; Tania,17,0,35,18
1656929269732,COGS 107A,A01,083627,Boyle; Mary E. T.,13,0,60,47
1656929275758,COGS 118A,A01,083075,Gupta; Anjum,15,0,76,61
1656929281784,CSE 3,A50,083646,Miranda; Gregory Joseph,22,0,50,28
1656929287810,CSE 8A,A50,083650,Miranda; Gregory Joseph,17,1,56,39
1656929293834,CSE 11,A01,083080,Cao; Yingjun,4,15,40,36
1656929299859,CSE 12,A01,083652,Krause-Levy; Sophia Louisa,20,1,120,100
1656929305885,CSE 15L,A01,083654,Morris; Justin Loren,8,0,50,42
1656929305885,CSE 15L,A02,083655,Morris; Justin Loren,8,0,50,42
1656929311909,CSE 20,A01,083657,Tran; Khoa Dang,37,0,80,43
1656929317935,CSE 21,A01,095574,Bach; Quang Tran,21,0,48,27
1656929323959,CSE 30,A01,083084,Eldon; John,4,0,80,76
1656929323959,CSE 30,B01,095061,Bhaskar; Nishant,6,0,50,44
1656929329984,CSE 100,A01,083659,Cao; Yingjun,3,4,70,67
1656929336006,CSE 134B,A01,083661,Powell; Thomas Allan,19,0,100,81
1656929342031,CSE 140,A01,083663,Gungor; Onat,14,0,85,71
1656929348063,CSE 140L,A01,083088,Eldon; John,16,0,100,84
1656929354090,CSE 175,A01,083665,Kumar; Rakesh,3,0,25,22
1656929360113,CSE 190,A00,092507,Dubnov; Shlomo,7,0,20,13
1656929366141,ECE 45,A01,083139,Congero; Spencer William,5,0,75,70
1656929372168,ECE 65,A50,083695,Saad; Andrew S,12,0,30,18
1656929372168,ECE 65,A51,095125,Saad; Andrew S,25,0,26,1
1656929378194,ECE 109,A01,091882,Touri; Behrouz,16,0,70,54
1656929384222,ECE 180,A00,083140,Abi Samra; Nicholas Camill,0,0,30,30
1656929384222,ECE 180,B00,083141,Abi Samra; Nicholas Camill,0,0,30,30
1656929390248,MATH 10A,A01,083735,Patchell; Gregory David,1,0,30,29
1656929390248,MATH 10A,A02,083736,Patchell; Gregory David,20,0,30,10
1656929390248,MATH 10A,A03,083737,Patchell; Gregory David,15,0,30,15
1656929396278,MATH 10B,A01,083207,Lim; Seonhee,7,0,34,27
1656929396278,MATH 10B,A02,083208,Lim; Seonhee,9,0,35,26
1656929396278,MATH 10B,A03,093472,Lim; Seonhee,4,0,34,30
1656929396278,MATH 10B,B01,083739,Sinha; Shubham,9,0,30,21
1656929402312,MATH 18,A01,083743,Cinel; Cameron Alexander,6,0,30,24
1656929402312,MATH 18,A02,083744,Cinel; Cameron Alexander,15,0,30,15
1656929402312,MATH 18,A03,083745,Cinel; Cameron Alexander,8,0,30,22
1656929402312,MATH 18,B01,083748,Rideout; David Porter,4,0,37,33
1656929402312,MATH 18,B02,083749,Rideout; David Porter,3,0,36,33
1656929402312,MATH 18,B03,083750,Rideout; David Porter,2,0,37,35
1656929402312,MATH 18,B04,083751,Rideout; David Porter,5,0,36,31
1656929402312,MATH 18,B05,093473,Rideout; David Porter,4,0,36,32
1656929402312,MATH 18,B06,093474,Rideout; David Porter,5,0,36,31
1656929408335,MATH 20A,A01,083754,Zheng; Zequn,12,0,40,28
1656929414358,MATH 20B,A01,083756,Briones; Jor-el Thomas Caparas,1,0,36,35
1656929414358,MATH 20B,A02,083757,Briones; Jor-el Thomas Caparas,1,0,36,35
1656929414358,MATH 20B,A03,093475,Briones; Jor-el Thomas Caparas,0,0,36,36
1656929420382,MATH 20C,A01,083760,Briones; Jor-el Thomas Caparas,1,0,35,34
1656929420382,MATH 20C,A02,083761,Briones; Jor-el Thomas Caparas,8,0,35,27
1656929420382,MATH 20C,A03,093476,Briones; Jor-el Thomas Caparas,0,1,36,36
1656929420382,MATH 20C,B01,083762,Bach; Quang Tran,0,0,30,30
1656929426407,MATH 20D,A01,083765,Tran; Brian Kha,4,0,30,26
1656929426407,MATH 20D,A02,083766,Tran; Brian Kha,4,0,30,26
1656929426407,MATH 20D,A03,083767,Tran; Brian Kha,3,0,30,27
1656929432429,MATH 20E,A01,083771,Ganguly; Soumya,5,0,32,27
1656929432429,MATH 20E,A02,083772,Ganguly; Soumya,6,0,32,26
1656929432429,MATH 20E,B01,083773,Ciotti; Benjamin,18,0,35,17
1656929432429,MATH 20E,B02,083774,Ciotti; Benjamin,17,0,35,18
1656929438460,MATH 103A,A01,083777,Greenfeld; Be'Eri,2,0,36,34
1656929438460,MATH 103A,A02,083778,Greenfeld; Be'Eri,5,0,36,31
1656929438460,MATH 103A,A03,093561,Greenfeld; Be'Eri,4,0,36,32
1656929438460,MATH 103A,B01,083779,Greenfeld; Be'Eri,6,0,36,30
1656929438460,MATH 103A,B02,083780,Greenfeld; Be'Eri,2,0,36,34
1656929438460,MATH 103A,B03,093562,Greenfeld; Be'Eri,2,0,36,34
1656929444482,MATH 105,A01,085443,Carter; Anne Toulson,13,0,35,22
1656929444482,MATH 105,A02,093477,Carter; Anne Toulson,20,0,35,15
1656929450516,MATH 109,A01,083213,Ganzberger; Geoffrey Michael,2,0,34,32
1656929450516,MATH 109,A02,083214,Ganzberger; Geoffrey Michael,2,0,34,32
1656929450516,MATH 109,A03,093478,Ganzberger; Geoffrey Michael,1,0,34,33
1656929450516,MATH 109,B01,083215,Ganzberger; Geoffrey Michael,1,0,32,31
1656929450516,MATH 109,B02,083216,Ganzberger; Geoffrey Michael,1,0,32,31
1656929450516,MATH 109,B03,093479,Ganzberger; Geoffrey Michael,6,0,32,26
1656929456540,MATH 142A,A01,083219,Chow; Bennett,6,0,32,26
1656929456540,MATH 142A,A02,083220,Chow; Bennett,10,0,32,22
1656929456540,MATH 142A,A03,093480,Chow; Bennett,7,0,32,25
1656929456540,MATH 142A,B03,093481,Chow; Bennett,7,0,32,25
1656929456540,MATH 142A,B04,093558,Chow; Bennett,11,0,32,21
1656929456540,MATH 142A,B05,093559,Chow; Bennett,6,0,32,26
1656929462565,MATH 193A,A01,083224,Rotar; Vladimir,7,0,34,27
1656929462565,MATH 193A,A02,083225,Rotar; Vladimir,3,0,34,31
1656929462565,MATH 193A,A03,083781,Rotar; Vladimir,1,0,34,33
1656929462565,MATH 193A,A04,083782,Rotar; Vladimir,6,0,34,28
1656929462565,MATH 193A,A05,093482,Rotar; Vladimir,6,0,34,28
1656929468588,MATH 197,001,091859,McAuley; Julian John,9999,0,9999,0
1656929468588,MATH 197,002,095566,Kedlaya; Kiran S.,9997,0,9999,2
1656929468588,MATH 197,003,095567,Xiao; Ming,9999,0,9999,0
1656929468588,MATH 197,004,095571,Perols; Johan Lars,9998,0,9999,1
1656929475660,COGS 9,A01,083615,Shannon; Kyle Michael,7,0,75,68
1656929481688,COGS 11,A01,083617,Boyle; Mary E. T.,19,0,48,29
1656929487723,COGS 13,A01,083071,Bastos; Amalia Pinkusfeld,9,0,71,62
1656929493749,COGS 14A,A01,092681,Semenuks; Arturs,0,1,100,100
1656929499773,COGS 14B,A01,083073,Cheng; Tzu-Han,5,0,63,58
1656929505796,COGS 17,A01,092677,Semenuks; Arturs,4,0,81,77
1656929511821,COGS 100,A01,083619,Allen; Michael Gordon,15,0,70,55
1656929517845,COGS 101A,A01,083621,Davis; Joshua Daniel,9,0,68,59
1656929523872,COGS 101B,A01,091572,Allen; Michael Gordon,8,0,65,57
1656929529899,COGS 101C,A01,083625,Delgado; Tania,17,0,35,18
1656929535927,COGS 107A,A01,083627,Boyle; Mary E. T.,13,0,60,47
1656929541951,COGS 118A,A01,083075,Gupta; Anjum,15,0,76,61
1656929547986,CSE 3,A50,083646,Miranda; Gregory Joseph,22,0,50,28
1656929554019,CSE 8A,A50,083650,Miranda; Gregory Joseph,17,1,56,39
1656929560043,CSE 11,A01,083080,Cao; Yingjun,4,15,40,36
1656929566067,CSE 12,A01,083652,Krause-Levy; Sophia Louisa,20,1,120,100
1656929572090,CSE 15L,A01,083654,Morris; Justin Loren,8,0,50,42
1656929572090,CSE 15L,A02,083655,Morris; Justin Loren,8,0,50,42
1656929578118,CSE 20,A01,083657,Tran; Khoa Dang,37,0,80,43
1656929584143,CSE 21,A01,095574,Bach; Quang Tran,21,0,48,27
1656929590171,CSE 30,A01,083084,Eldon; John,4,0,80,76
1656929590171,CSE 30,B01,095061,Bhaskar; Nishant,6,0,50,44
1656929596199,CSE 100,A01,083659,Cao; Yingjun,3,4,70,67
1656929602224,CSE 134B,A01,083661,Powell; Thomas Allan,19,0,100,81
1656929608257,CSE 140,A01,083663,Gungor; Onat,14,0,85,71
1656929614280,CSE 140L,A01,083088,Eldon; John,16,0,100,84
1656929620302,CSE 175,A01,083665,Kumar; Rakesh,3,0,25,22
1656929626326,CSE 190,A00,092507,Dubnov; Shlomo,7,0,20,13
1656929632349,ECE 45,A01,083139,Congero; Spencer William,5,0,75,70
1656929638371,ECE 65,A50,083695,Saad; Andrew S,12,0,30,18
1656929638371,ECE 65,A51,095125,Saad; Andrew S,25,0,26,1
1656929644395,ECE 109,A01,091882,Touri; Behrouz,16,0,70,54
1656929650512,ECE 180,A00,083140,Abi Samra; Nicholas Camill,0,0,30,30
1656929650512,ECE 180,B00,083141,Abi Samra; Nicholas Camill,0,0,30,30
1656929656536,MATH 10A,A01,083735,Patchell; Gregory David,1,0,30,29
1656929656536,MATH 10A,A02,083736,Patchell; Gregory David,20,0,30,10
1656929656536,MATH 10A,A03,083737,Patchell; Gregory David,15,0,30,15
1656929662564,MATH 10B,A01,083207,Lim; Seonhee,7,0,34,27
1656929662564,MATH 10B,A02,083208,Lim; Seonhee,9,0,35,26
1656929662564,MATH 10B,A03,093472,Lim; Seonhee,4,0,34,30
1656929662564,MATH 10B,B01,083739,Sinha; Shubham,9,0,30,21
1656929668590,MATH 18,A01,083743,Cinel; Cameron Alexander,6,0,30,24
1656929668590,MATH 18,A02,083744,Cinel; Cameron Alexander,15,0,30,15
1656929668590,MATH 18,A03,083745,Cinel; Cameron Alexander,8,0,30,22
1656929668590,MATH 18,B01,083748,Rideout; David Porter,4,0,37,33
1656929668590,MATH 18,B02,083749,Rideout; David Porter,3,0,36,33
1656929668590,MATH 18,B03,083750,Rideout; David Porter,2,0,37,35
1656929668590,MATH 18,B04,083751,Rideout; David Porter,5,0,36,31
1656929668590,MATH 18,B05,093473,Rideout; David Porter,4,0,36,32
1656929668590,MATH 18,B06,093474,Rideout; David Porter,5,0,36,31
1656929674617,MATH 20A,A01,083754,Zheng; Zequn,12,0,40,28
1656929680645,MATH 20B,A01,083756,Briones; Jor-el Thomas Caparas,1,0,36,35
1656929680645,MATH 20B,A02,083757,Briones; Jor-el Thomas Caparas,1,0,36,35
1656929680645,MATH 20B,A03,093475,Briones; Jor-el Thomas Caparas,0,0,36,36
1656929686679,MATH 20C,A01,083760,Briones; Jor-el Thomas Caparas,1,0,35,34
1656929686679,MATH 20C,A02,083761,Briones; Jor-el Thomas Caparas,8,0,35,27
1656929686679,MATH 20C,A03,093476,Briones; Jor-el Thomas Caparas,0,1,36,36
1656929686679,MATH 20C,B01,083762,Bach; Quang Tran,0,0,30,30
1656929692701,MATH 20D,A01,083765,Tran; Brian Kha,4,0,30,26
1656929692701,MATH 20D,A02,083766,Tran; Brian Kha,4,0,30,26
1656929692701,MATH 20D,A03,083767,Tran; Brian Kha,3,0,30,27
1656929698732,MATH 20E,A01,083771,Ganguly; Soumya,5,0,32,27
1656929698732,MATH 20E,A02,083772,Ganguly; Soumya,6,0,32,26
1656929698732,MATH 20E,B01,083773,Ciotti; Benjamin,18,0,35,17
1656929698732,MATH 20E,B02,083774,Ciotti; Benjamin,17,0,35,18
1656929704763,MATH 103A,A01,083777,Greenfeld; Be'Eri,2,0,36,34
1656929704763,MATH 103A,A02,083778,Greenfeld; Be'Eri,5,0,36,31
1656929704763,MATH 103A,A03,093561,Greenfeld; Be'Eri,4,0,36,32
1656929704763,MATH 103A,B01,083779,Greenfeld; Be'Eri,6,0,36,30
1656929704763,MATH 103A,B02,083780,Greenfeld; Be'Eri,2,0,36,34
1656929704763,MATH 103A,B03,093562,Greenfeld; Be'Eri,2,0,36,34
1656929710798,MATH 105,A01,085443,Carter; Anne Toulson,13,0,35,22
1656929710798,MATH 105,A02,093477,Carter; Anne Toulson,20,0,35,15
1656929716828,MATH 109,A01,083213,Ganzberger; Geoffrey Michael,2,0,34,32
1656929716828,MATH 109,A02,083214,Ganzberger; Geoffrey Michael,2,0,34,32
1656929716828,MATH 109,A03,093478,Ganzberger; Geoffrey Michael,1,0,34,33
1656929716828,MATH 109,B01,083215,Ganzberger; Geoffrey Michael,1,0,32,31
1656929716828,MATH 109,B02,083216,Ganzberger; Geoffrey Michael,1,0,32,31
1656929716828,MATH 109,B03,093479,Ganzberger; Geoffrey Michael,6,0,32,26
1656929722856,MATH 142A,A01,083219,Chow; Bennett,6,0,32,26
1656929722856,MATH 142A,A02,083220,Chow; Bennett,10,0,32,22
1656929722856,MATH 142A,A03,093480,Chow; Bennett,7,0,32,25
1656929722856,MATH 142A,B03,093481,Chow; Bennett,7,0,32,25
1656929722856,MATH 142A,B04,093558,Chow; Bennett,11,0,32,21
1656929722856,MATH 142A,B05,093559,Chow; Bennett,6,0,32,26
1656929728879,MATH 193A,A01,083224,Rotar; Vladimir,7,0,34,27
1656929728879,MATH 193A,A02,083225,Rotar; Vladimir,3,0,34,31
1656929728879,MATH 193A,A03,083781,Rotar; Vladimir,1,0,34,33
1656929728879,MATH 193A,A04,083782,Rotar; Vladimir,6,0,34,28
1656929728879,MATH 193A,A05,093482,Rotar; Vladimir,6,0,34,28
1656929734918,MATH 197,001,091859,McAuley; Julian John,9999,0,9999,0
1656929734918,MATH 197,002,095566,Kedlaya; Kiran S.,9997,0,9999,2
1656929734918,MATH 197,003,095567,Xiao; Ming,9999,0,9999,0
1656929734918,MATH 197,004,095571,Perols; Johan Lars,9998,0,9999,1
1656929741977,COGS 9,A01,083615,Shannon; Kyle Michael,7,0,75,68
1656929748005,COGS 11,A01,083617,Boyle; Mary E. T.,19,0,48,29
1656929754029,COGS 13,A01,083071,Bastos; Amalia Pinkusfeld,9,0,71,62
1656929760052,COGS 14A,A01,092681,Semenuks; Arturs,0,1,100,100
1656929766079,COGS 14B,A01,083073,Cheng; Tzu-Han,5,0,63,58
1656929772106,COGS 17,A01,092677,Semenuks; Arturs,4,0,81,77
1656929778129,COGS 100,A01,083619,Allen; Michael Gordon,15,0,70,55
1656929784152,COGS 101A,A01,083621,Davis; Joshua Daniel,9,0,68,59
1656929790179,COGS 101B,A01,091572,Allen; Michael Gordon,8,0,65,57
1656929796203,COGS 101C,A01,083625,Delgado; Tania,17,0,35,18
1656929802226,COGS 107A,A01,083627,Boyle; Mary E. T.,13,0,60,47
1656929808249,COGS 118A,A01,083075,Gupta; Anjum,15,0,76,61
1656929814271,CSE 3,A50,083646,Miranda; Gregory Joseph,22,0,50,28
1656929820295,CSE 8A,A50,083650,Miranda; Gregory Joseph,17,1,56,39
1656929826321,CSE 11,A01,083080,Cao; Yingjun,4,15,40,36
1656929832346,CSE 12,A01,083652,Krause-Levy; Sophia Louisa,20,1,120,100
1656929838372,CSE 15L,A01,083654,Morris; Justin Loren,8,0,50,42
1656929838372,CSE 15L,A02,083655,Morris; Justin Loren,8,0,50,42
1656929844395,CSE 20,A01,083657,Tran; Khoa Dang,37,0,80,43
1656929850423,CSE 21,A01,095574,Bach; Quang Tran,21,0,48,27
1656929856447,CSE 30,A01,083084,Eldon; John,4,0,80,76
1656929856447,CSE 30,B01,095061,Bhaskar; Nishant,6,0,50,44
1656929862471,CSE 100,A01,083659,Cao; Yingjun,3,4,70,67
1656929868495,CSE 134B,A01,083661,Powell; Thomas Allan,19,0,100,81
1656929874519,CSE 140,A01,083663,Gungor; Onat,14,0,85,71
1656929880542,CSE 140L,A01,083088,Eldon; John,16,0,100,84
1656929886568,CSE 175,A01,083665,Kumar; Rakesh,3,0,25,22
1656929892591,CSE 190,A00,092507,Dubnov; Shlomo,7,0,20,13
1656929898614,ECE 45,A01,083139,Congero; Spencer William,5,0,75,70
1656929904638,ECE 65,A50,083695,Saad; Andrew S,12,0,30,18
1656929904638,ECE 65,A51,095125,Saad; Andrew S,25,0,26,1
1656929910661,ECE 109,A01,091882,Touri; Behrouz,16,0,70,54
1656929916688,ECE 180,A00,083140,Abi Samra; Nicholas Camill,0,0,30,30
1656929916688,ECE 180,B00,083141,Abi Samra; Nicholas Camill,0,0,30,30
1656929922716,MATH 10A,A01,083735,Patchell; Gregory David,1,0,30,29
1656929922716,MATH 10A,A02,083736,Patchell; Gregory David,20,0,30,10
1656929922716,MATH 10A,A03,083737,Patchell; Gregory David,15,0,30,15
1656929928740,MATH 10B,A01,083207,Lim; Seonhee,7,0,34,27
1656929928740,MATH 10B,A02,083208,Lim; Seonhee,9,0,35,26
1656929928740,MATH 10B,A03,093472,Lim; Seonhee,4,0,34,30
1656929928740,MATH 10B,B01,083739,Sinha; Shubham,9,0,30,21
1656929934765,MATH 18,A01,083743,Cinel; Cameron Alexander,6,0,30,24
1656929934765,MATH 18,A02,083744,Cinel; Cameron Alexander,15,0,30,15
1656929934765,MATH 18,A03,083745,Cinel; Cameron Alexander,8,0,30,22
1656929934765,MATH 18,B01,083748,Rideout; David Porter,4,0,37,33
1656929934765,MATH 18,B02,083749,Rideout; David Porter,3,0,36,33
1656929934765,MATH 18,B03,083750,Rideout; David Porter,2,0,37,35
1656929934765,MATH 18,B04,083751,Rideout; David Porter,5,0,36,31
1656929934765,MATH 18,B05,093473,Rideout; David Porter,4,0,36,32
1656929934765,MATH 18,B06,093474,Rideout; David Porter,5,0,36,31
1656929940794,MATH 20A,A01,083754,Zheng; Zequn,12,0,40,28
1656929946818,MATH 20B,A01,083756,Briones; Jor-el Thomas Caparas,1,0,36,35
1656929946818,MATH 20B,A02,083757,Briones; Jor-el Thomas Caparas,1,0,36,35
1656929946818,MATH 20B,A03,093475,Briones; Jor-el Thomas Caparas,0,0,36,36
1656929952842,MATH 20C,A01,083760,Briones; Jor-el Thomas Caparas,1,0,35,34
1656929952842,MATH 20C,A02,083761,Briones; Jor-el Thomas Caparas,8,0,35,27
1656929952842,MATH 20C,A03,093476,Briones; Jor-el Thomas Caparas,0,1,36,36
1656929952842,MATH 20C,B01,083762,Bach; Quang Tran,0,0,30,30
1656929958868,MATH 20D,A01,083765,Tran; Brian Kha,4,0,30,26
1656929958868,MATH 20D,A02,083766,Tran; Brian Kha,4,0,30,26
1656929958868,MATH 20D,A03,083767,Tran; Brian Kha,3,0,30,27
1656929964889,MATH 20E,A01,083771,Ganguly; Soumya,5,0,32,27
1656929964889,MATH 20E,A02,083772,Ganguly; Soumya,6,0,32,26
1656929964889,MATH 20E,B01,083773,Ciotti; Benjamin,18,0,35,17
1656929964889,MATH 20E,B02,083774,Ciotti; Benjamin,17,0,35,18
1656929970915,MATH 103A,A01,083777,Greenfeld; Be'Eri,2,0,36,34
1656929970915,MATH 103A,A02,083778,Greenfeld; Be'Eri,5,0,36,31
1656929970915,MATH 103A,A03,093561,Greenfeld; Be'Eri,4,0,36,32
1656929970915,MATH 103A,B01,083779,Greenfeld; Be'Eri,6,0,36,30
1656929970915,MATH 103A,B02,083780,Greenfeld; Be'Eri,2,0,36,34
1656929970915,MATH 103A,B03,093562,Greenfeld; Be'Eri,2,0,36,34
1656929976943,MATH 105,A01,085443,Carter; Anne Toulson,13,0,35,22
1656929976943,MATH 105,A02,093477,Carter; Anne Toulson,20,0,35,15
1656929982972,MATH 109,A01,083213,Ganzberger; Geoffrey Michael,2,0,34,32
1656929982972,MATH 109,A02,083214,Ganzberger; Geoffrey Michael,2,0,34,32
1656929982972,MATH 109,A03,093478,Ganzberger; Geoffrey Michael,1,0,34,33
1656929982972,MATH 109,B01,083215,Ganzberger; Geoffrey Michael,1,0,32,31
1656929982972,MATH 109,B02,083216,Ganzberger; Geoffrey Michael,1,0,32,31
1656929982972,MATH 109,B03,093479,Ganzberger; Geoffrey Michael,6,0,32,26
1656929989002,MATH 142A,A01,083219,Chow; Bennett,6,0,32,26
1656929989002,MATH 142A,A02,083220,Chow; Bennett,10,0,32,22
1656929989002,MATH 142A,A03,093480,Chow; Bennett,7,0,32,25
1656929989002,MATH 142A,B03,093481,Chow; Bennett,7,0,32,25
1656929989002,MATH 142A,B04,093558,Chow; Bennett,11,0,32,21
1656929989002,MATH 142A,B05,093559,Chow; Bennett,6,0,32,26
1656929995039,MATH 193A,A01,083224,Rotar; Vladimir,7,0,34,27
1656929995039,MATH 193A,A02,083225,Rotar; Vladimir,3,0,34,31
1656929995039,MATH 193A,A03,083781,Rotar; Vladimir,1,0,34,33
1656929995039,MATH 193A,A04,083782,Rotar; Vladimir,6,0,34,28
1656929995039,MATH 193A,A05,093482,Rotar; Vladimir,6,0,34,28
1656930001072,MATH 197,001,091859,McAuley; Julian John,9999,0,9999,0
1656930001072,MATH 197,002,095566,Kedlaya; Kiran S.,9997,0,9999,2
1656930001072,MATH 197,003,095567,Xiao; Ming,9999,0,9999,0
1656930001072,MATH 197,004,095571,Perols; Johan Lars,9998,0,9999,1
1656930008125,COGS 9,A01,083615,Shannon; Kyle Michael,7,0,75,68
1656930014152,COGS 11,A01,083617,Boyle; Mary E. T.,19,0,48,29
1656930020175,COGS 13,A01,083071,Bastos; Amalia Pinkusfeld,9,0,71,62
1656930026198,COGS 14A,A01,092681,Semenuks; Arturs,0,1,100,100
1656930032233,COGS 14B,A01,083073,Cheng; Tzu-Han,5,0,63,58
1656930038257,COGS 17,A01,092677,Semenuks; Arturs,4,0,81,77
1656930044285,COGS 100,A01,083619,Allen; Michael Gordon,15,0,70,55
1656930050311,COGS 101A,A01,083621,Davis; Joshua Daniel,9,0,68,59
1656930056334,COGS 101B,A01,091572,Allen; Michael Gordon,8,0,65,57
1656930062359,COGS 101C,A01,083625,Delgado; Tania,17,0,35,18
1656930068393,COGS 107A,A01,083627,Boyle; Mary E. T.,13,0,60,47
1656930074419,COGS 118A,A01,083075,Gupta; Anjum,15,0,76,61
1656930080447,CSE 3,A50,083646,Miranda; Gregory Joseph,22,0,50,28
1656930086474,CSE 8A,A50,083650,Miranda; Gregory Joseph,17,1,56,39
1656930092504,CSE 11,A01,083080,Cao; Yingjun,4,15,40,36
1656930098528,CSE 12,A01,083652,Krause-Levy; Sophia Louisa,20,1,120,100
1656930104552,CSE 15L,A01,083654,Morris; Justin Loren,8,0,50,42
1656930104552,CSE 15L,A02,083655,Morris; Justin Loren,8,0,50,42
1656930110580,CSE 20,A01,083657,Tran; Khoa Dang,37,0,80,43
1656930116603,CSE 21,A01,095574,Bach; Quang Tran,21,0,48,27
1656930122628,CSE 30,A01,083084,Eldon; John,4,0,80,76
1656930122628,CSE 30,B01,095061,Bhaskar; Nishant,6,0,50,44
1656930128651,CSE 100,A01,083659,Cao; Yingjun,3,4,70,67
1656930134675,CSE 134B,A01,083661,Powell; Thomas Allan,19,0,100,81
1656930140706,CSE 140,A01,083663,Gungor; Onat,14,0,85,71
1656930146742,CSE 140L,A01,083088,Eldon; John,16,0,100,84
1656930152790,CSE 175,A01,083665,Kumar; Rakesh,3,0,25,22
1656930158816,CSE 190,A00,092507,Dubnov; Shlomo,7,0,20,13
1656930164843,ECE 45,A01,083139,Congero; Spencer William,5,0,75,70
1656930170865,ECE 65,A50,083695,Saad; Andrew S,12,0,30,18
1656930170865,ECE 65,A51,095125,Saad; Andrew S,25,0,26,1
1656930176887,ECE 109,A01,091882,Touri; Behrouz,16,0,70,54
1656930182912,ECE 180,A00,083140,Abi Samra; Nicholas Camill,0,0,30,30
1656930182912,ECE 180,B00,083141,Abi Samra; Nicholas Camill,0,0,30,30
1656930188936,MATH 10A,A01,083735,Patchell; Gregory David,1,0,30,29
1656930188936,MATH 10A,A02,083736,Patchell; Gregory David,20,0,30,10
1656930188936,MATH 10A,A03,083737,Patchell; Gregory David,15,0,30,15
1656930194965,MATH 10B,A01,083207,Lim; Seonhee,7,0,34,27
1656930194965,MATH 10B,A02,083208,Lim; Seonhee,9,0,35,26
1656930194965,MATH 10B,A03,093472,Lim; Seonhee,4,0,34,30
1656930194965,MATH 10B,B01,083739,Sinha; Shubham,9,0,30,21
1656930200989,MATH 18,A01,083743,Cinel; Cameron Alexander,6,0,30,24
1656930200989,MATH 18,A02,083744,Cinel; Cameron Alexander,15,0,30,15
1656930200989,MATH 18,A03,083745,Cinel; Cameron Alexander,8,0,30,22
1656930200989,MATH 18,B01,083748,Rideout; David Porter,4,0,37,33
1656930200989,MATH 18,B02,083749,Rideout; David Porter,3,0,36,33
1656930200989,MATH 18,B03,083750,Rideout; David Porter,2,0,37,35
1656930200989,MATH 18,B04,083751,Rideout; David Porter,5,0,36,31
1656930200989,MATH 18,B05,093473,Rideout; David Porter,4,0,36,32
1656930200989,MATH 18,B06,093474,Rideout; David Porter,5,0,36,31
1656930207015,MATH 20A,A01,083754,Zheng; Zequn,12,0,40,28
1656930213039,MATH 20B,A01,083756,Briones; Jor-el Thomas Caparas,1,0,36,35
1656930213039,MATH 20B,A02,083757,Briones; Jor-el Thomas Caparas,1,0,36,35
1656930213039,MATH 20B,A03,093475,Briones; Jor-el Thomas Caparas,0,0,36,36
1656930219072,MATH 20C,A01,083760,Briones; Jor-el Thomas Caparas,1,0,35,34
1656930219072,MATH 20C,A02,083761,Briones; Jor-el Thomas Caparas,8,0,35,27
1656930219072,MATH 20C,A03,093476,Briones; Jor-el Thomas Caparas,0,1,36,36
1656930219072,MATH 20C,B01,083762,Bach; Quang Tran,0,0,30,30
1656930225102,MATH 20D,A01,083765,Tran; Brian Kha,4,0,30,26
1656930225102,MATH 20D,A02,083766,Tran; Brian Kha,4,0,30,26
1656930225102,MATH 20D,A03,083767,Tran; Brian Kha,3,0,30,27
1656930231127,MATH 20E,A01,083771,Ganguly; Soumya,5,0,32,27
1656930231127,MATH 20E,A02,083772,Ganguly; Soumya,6,0,32,26
1656930231127,MATH 20E,B01,083773,Ciotti; Benjamin,18,0,35,17
1656930231127,MATH 20E,B02,083774,Ciotti; Benjamin,17,0,35,18
1656930237152,MATH 103A,A01,083777,Greenfeld; Be'Eri,2,0,36,34
1656930237152,MATH 103A,A02,083778,Greenfeld; Be'Eri,5,0,36,31
1656930237152,MATH 103A,A03,093561,Greenfeld; Be'Eri,4,0,36,32
1656930237152,MATH 103A,B01,083779,Greenfeld; Be'Eri,6,0,36,30
1656930237152,MATH 103A,B02,083780,Greenfeld; Be'Eri,2,0,36,34
1656930237152,MATH 103A,B03,093562,Greenfeld; Be'Eri,2,0,36,34
1656930243180,MATH 105,A01,085443,Carter; Anne Toulson,13,0,35,22
1656930243180,MATH 105,A02,093477,Carter; Anne Toulson,20,0,35,15
1656930249281,MATH 109,A01,083213,Ganzberger; Geoffrey Michael,2,0,34,32
1656930249281,MATH 109,A02,083214,Ganzberger; Geoffrey Michael,2,0,34,32
1656930249281,MATH 109,A03,093478,Ganzberger; Geoffrey Michael,1,0,34,33
1656930249281,MATH 109,B01,083215,Ganzberger; Geoffrey Michael,1,0,32,31
1656930249281,MATH 109,B02,083216,Ganzberger; Geoffrey Michael,1,0,32,31
1656930249281,MATH 109,B03,093479,Ganzberger; Geoffrey Michael,6,0,32,26
1656930255304,MATH 142A,A01,083219,Chow; Bennett,6,0,32,26
1656930255304,MATH 142A,A02,083220,Chow; Bennett,10,0,32,22
1656930255304,MATH 142A,A03,093480,Chow; Bennett,7,0,32,25
1656930255304,MATH 142A,B03,093481,Chow; Bennett,7,0,32,25
1656930255304,MATH 142A,B04,093558,Chow; Bennett,11,0,32,21
1656930255304,MATH 142A,B05,093559,Chow; Bennett,6,0,32,26
1656930261328,MATH 193A,A01,083224,Rotar; Vladimir,7,0,34,27
1656930261328,MATH 193A,A02,083225,Rotar; Vladimir,3,0,34,31
1656930261328,MATH 193A,A03,083781,Rotar; Vladimir,1,0,34,33
1656930261328,MATH 193A,A04,083782,Rotar; Vladimir,6,0,34,28
1656930261328,MATH 193A,A05,093482,Rotar; Vladimir,6,0,34,28
1656930267352,MATH 197,001,091859,McAuley; Julian John,9999,0,9999,0
1656930267352,MATH 197,002,095566,Kedlaya; Kiran S.,9997,0,9999,2
1656930267352,MATH 197,003,095567,Xiao; Ming,9999,0,9999,0
1656930267352,MATH 197,004,095571,Perols; Johan Lars,9998,0,9999,1
1656930274418,COGS 9,A01,083615,Shannon; Kyle Michael,7,0,75,68
1656930280458,COGS 11,A01,083617,Boyle; Mary E. T.,19,0,48,29
1656930286483,COGS 13,A01,083071,Bastos; Amalia Pinkusfeld,9,0,71,62
1656930292512,COGS 14A,A01,092681,Semenuks; Arturs,0,1,100,100
1656930298536,COGS 14B,A01,083073,Cheng; Tzu-Han,5,0,63,58
1656930304563,COGS 17,A01,092677,Semenuks; Arturs,4,0,81,77
1656930310598,COGS 100,A01,083619,Allen; Michael Gordon,15,0,70,55
1656930316621,COGS 101A,A01,083621,Davis; Joshua Daniel,9,0,68,59
1656930322653,COGS 101B,A01,091572,Allen; Michael Gordon,8,0,65,57
1656930328679,COGS 101C,A01,083625,Delgado; Tania,17,0,35,18
1656930334704,COGS 107A,A01,083627,Boyle; Mary E. T.,13,0,60,47
1656930340730,COGS 118A,A01,083075,Gupta; Anjum,15,0,76,61
1656930346756,CSE 3,A50,083646,Miranda; Gregory Joseph,22,0,50,28
1656930352782,CSE 8A,A50,083650,Miranda; Gregory Joseph,17,1,56,39
1656930358805,CSE 11,A01,083080,Cao; Yingjun,4,15,40,36
1656930364829,CSE 12,A01,083652,Krause-Levy; Sophia Louisa,20,1,120,100
1656930370853,CSE 15L,A01,083654,Morris; Justin Loren,8,0,50,42
1656930370853,CSE 15L,A02,083655,Morris; Justin Loren,8,0,50,42
1656930376878,CSE 20,A01,083657,Tran; Khoa Dang,37,0,80,43
1656930382901,CSE 21,A01,095574,Bach; Quang Tran,21,0,48,27
1656930388929,CSE 30,A01,083084,Eldon; John,4,0,80,76
1656930388929,CSE 30,B01,095061,Bhaskar; Nishant,6,0,50,44
1656930394959,CSE 100,A01,083659,Cao; Yingjun,3,4,70,67
1656930400993,CSE 134B,A01,083661,Powell; Thomas Allan,19,0,100,81
1656930407017,CSE 140,A01,083663,Gungor; Onat,14,0,85,71
1656930413053,CSE 140L,A01,083088,Eldon; John,16,0,100,84
1656930419078,CSE 175,A01,083665,Kumar; Rakesh,3,0,25,22
1656930425104,CSE 190,A00,092507,Dubnov; Shlomo,7,0,20,13
1656930431143,ECE 45,A01,083139,Congero; Spencer William,5,0,75,70
1656930437169,ECE 65,A50,083695,Saad; Andrew S,12,0,30,18
1656930437169,ECE 65,A51,095125,Saad; Andrew S,25,0,26,1
1656930443193,ECE 109,A01,091882,Touri; Behrouz,16,0,70,54
1656930449223,ECE 180,A00,083140,Abi Samra; Nicholas Camill,0,0,30,30
1656930449223,ECE 180,B00,083141,Abi Samra; Nicholas Camill,0,0,30,30
1656930455253,MATH 10A,A01,083735,Patchell; Gregory David,1,0,30,29
1656930455253,MATH 10A,A02,083736,Patchell; Gregory David,20,0,30,10
1656930455253,MATH 10A,A03,083737,Patchell; Gregory David,15,0,30,15
1656930461277,MATH 10B,A01,083207,Lim; Seonhee,7,0,34,27
1656930461277,MATH 10B,A02,083208,Lim; Seonhee,9,0,35,26
1656930461277,MATH 10B,A03,093472,Lim; Seonhee,4,0,34,30
1656930461277,MATH 10B,B01,083739,Sinha; Shubham,9,0,30,21
1656930467304,MATH 18,A01,083743,Cinel; Cameron Alexander,6,0,30,24
1656930467304,MATH 18,A02,083744,Cinel; Cameron Alexander,15,0,30,15
1656930467304,MATH 18,A03,083745,Cinel; Cameron Alexander,8,0,30,22
1656930467304,MATH 18,B01,083748,Rideout; David Porter,4,0,37,33
1656930467304,MATH 18,B02,083749,Rideout; David Porter,3,0,36,33
1656930467304,MATH 18,B03,083750,Rideout; David Porter,2,0,37,35
1656930467304,MATH 18,B04,083751,Rideout; David Porter,5,0,36,31
1656930467304,MATH 18,B05,093473,Rideout; David Porter,4,0,36,32
1656930467304,MATH 18,B06,093474,Rideout; David Porter,5,0,36,31
1656930473347,MATH 20A,A01,083754,Zheng; Zequn,12,0,40,28
1656930479376,MATH 20B,A01,083756,Briones; Jor-el Thomas Caparas,1,0,36,35
1656930479376,MATH 20B,A02,083757,Briones; Jor-el Thomas Caparas,1,0,36,35
1656930479376,MATH 20B,A03,093475,Briones; Jor-el Thomas Caparas,0,0,36,36
1656930485416,MATH 20C,A01,083760,Briones; Jor-el Thomas Caparas,1,0,35,34
1656930485416,MATH 20C,A02,083761,Briones; Jor-el Thomas Caparas,8,0,35,27
1656930485416,MATH 20C,A03,093476,Briones; Jor-el Thomas Caparas,0,1,36,36
1656930485416,MATH 20C,B01,083762,Bach; Quang Tran,0,0,30,30
1656930491439,MATH 20D,A01,083765,Tran; Brian Kha,4,0,30,26
1656930491439,MATH 20D,A02,083766,Tran; Brian Kha,4,0,30,26
1656930491439,MATH 20D,A03,083767,Tran; Brian Kha,3,0,30,27
1656930497465,MATH 20E,A01,083771,Ganguly; Soumya,5,0,32,27
1656930497465,MATH 20E,A02,083772,Ganguly; Soumya,6,0,32,26
1656930497465,MATH 20E,B01,083773,Ciotti; Benjamin,18,0,35,17
1656930497465,MATH 20E,B02,083774,Ciotti; Benjamin,17,0,35,18
1656930503490,MATH 103A,A01,083777,Greenfeld; Be'Eri,2,0,36,34
1656930503490,MATH 103A,A02,083778,Greenfeld; Be'Eri,5,0,36,31
1656930503490,MATH 103A,A03,093561,Greenfeld; Be'Eri,4,0,36,32
1656930503490,MATH 103A,B01,083779,Greenfeld; Be'Eri,6,0,36,30
1656930503490,MATH 103A,B02,083780,Greenfeld; Be'Eri,2,0,36,34
1656930503490,MATH 103A,B03,093562,Greenfeld; Be'Eri,2,0,36,34
1656930509529,MATH 105,A01,085443,Carter; Anne Toulson,13,0,35,22
1656930509529,MATH 105,A02,093477,Carter; Anne Toulson,20,0,35,15
1656930515560,MATH 109,A01,083213,Ganzberger; Geoffrey Michael,2,0,34,32
1656930515560,MATH 109,A02,083214,Ganzberger; Geoffrey Michael,2,0,34,32
1656930515560,MATH 109,A03,093478,Ganzberger; Geoffrey Michael,1,0,34,33
1656930515560,MATH 109,B01,083215,Ganzberger; Geoffrey Michael,1,0,32,31
1656930515560,MATH 109,B02,083216,Ganzberger; Geoffrey Michael,1,0,32,31
1656930515560,MATH 109,B03,093479,Ganzberger; Geoffrey Michael,6,0,32,26
1656930521591,MATH 142A,A01,083219,Chow; Bennett,6,0,32,26
1656930521591,MATH 142A,A02,083220,Chow; Bennett,10,0,32,22
1656930521591,MATH 142A,A03,093480,Chow; Bennett,7,0,32,25
1656930521591,MATH 142A,B03,093481,Chow; Bennett,7,0,32,25
1656930521591,MATH 142A,B04,093558,Chow; Bennett,11,0,32,21
1656930521591,MATH 142A,B05,093559,Chow; Bennett,6,0,32,26
1656930527616,MATH 193A,A01,083224,Rotar; Vladimir,7,0,34,27
1656930527616,MATH 193A,A02,083225,Rotar; Vladimir,3,0,34,31
1656930527616,MATH 193A,A03,083781,Rotar; Vladimir,1,0,34,33
1656930527616,MATH 193A,A04,083782,Rotar; Vladimir,6,0,34,28
1656930527616,MATH 193A,A05,093482,Rotar; Vladimir,6,0,34,28
1656930533646,MATH 197,001,091859,McAuley; Julian John,9999,0,9999,0
1656930533646,MATH 197,002,095566,Kedlaya; Kiran S.,9997,0,9999,2
1656930533646,MATH 197,003,095567,Xiao; Ming,9999,0,9999,0
1656930533646,MATH 197,004,095571,Perols; Johan Lars,9998,0,9999,1
1656930540712,COGS 9,A01,083615,Shannon; Kyle Michael,7,0,75,68
1656930546749,COGS 11,A01,083617,Boyle; Mary E. T.,19,0,48,29
1656930552783,COGS 13,A01,083071,Bastos; Amalia Pinkusfeld,9,0,71,62
1656930558817,COGS 14A,A01,092681,Semenuks; Arturs,0,1,100,100
1656930564851,COGS 14B,A01,083073,Cheng; Tzu-Han,5,0,63,58
1656930570883,COGS 17,A01,092677,Semenuks; Arturs,4,0,81,77
1656930576913,COGS 100,A01,083619,Allen; Michael Gordon,15,0,70,55
1656930582942,COGS 101A,A01,083621,Davis; Joshua Daniel,9,0,68,59
1656930588966,COGS 101B,A01,091572,Allen; Michael Gordon,8,0,65,57
1656930594998,COGS 101C,A01,083625,Delgado; Tania,17,0,35,18
1656930601028,COGS 107A,A01,083627,Boyle; Mary E. T.,13,0,60,47
1656930607056,COGS 118A,A01,083075,Gupta; Anjum,15,0,76,61
1656930613079,CSE 3,A50,083646,Miranda; Gregory Joseph,22,0,50,28
1656930619106,CSE 8A,A50,083650,Miranda; Gregory Joseph,17,1,56,39
1656930625132,CSE 11,A01,083080,Cao; Yingjun,4,15,40,36
1656930631166,CSE 12,A01,083652,Krause-Levy; Sophia Louisa,20,1,120,100
1656930637195,CSE 15L,A01,083654,Morris; Justin Loren,8,0,50,42
1656930637195,CSE 15L,A02,083655,Morris; Justin Loren,8,0,50,42
1656930643220,CSE 20,A01,083657,Tran; Khoa Dang,37,0,80,43
1656930649244,CSE 21,A01,095574,Bach; Quang Tran,21,0,48,27
1656930655271,CSE 30,A01,083084,Eldon; John,4,0,80,76
1656930655271,CSE 30,B01,095061,Bhaskar; Nishant,6,0,50,44
1656930661296,CSE 100,A01,083659,Cao; Yingjun,3,4,70,67
1656930667320,CSE 134B,A01,083661,Powell; Thomas Allan,19,0,100,81
1656930673356,CSE 140,A01,083663,Gungor; Onat,14,0,85,71
1656930679378,CSE 140L,A01,083088,Eldon; John,16,0,100,84
1656930685408,CSE 175,A01,083665,Kumar; Rakesh,3,0,25,22
1656930691435,CSE 190,A00,092507,Dubnov; Shlomo,7,0,20,13
1656930697463,ECE 45,A01,083139,Congero; Spencer William,5,0,75,70
1656930703486,ECE 65,A50,083695,Saad; Andrew S,12,0,30,18
1656930703486,ECE 65,A51,095125,Saad; Andrew S,25,0,26,1
1656930709513,ECE 109,A01,091882,Touri; Behrouz,16,0,70,54
1656930715537,ECE 180,A00,083140,Abi Samra; Nicholas Camill,0,0,30,30
1656930715537,ECE 180,B00,083141,Abi Samra; Nicholas Camill,0,0,30,30
1656930721565,MATH 10A,A01,083735,Patchell; Gregory David,1,0,30,29
1656930721565,MATH 10A,A02,083736,Patchell; Gregory David,20,0,30,10
1656930721565,MATH 10A,A03,083737,Patchell; Gregory David,15,0,30,15
1656930727599,MATH 10B,A01,083207,Lim; Seonhee,7,0,34,27
1656930727599,MATH 10B,A02,083208,Lim; Seonhee,9,0,35,26
1656930727599,MATH 10B,A03,093472,Lim; Seonhee,4,0,34,30
1656930727599,MATH 10B,B01,083739,Sinha; Shubham,9,0,30,21
1656930733643,MATH 18,A01,083743,Cinel; Cameron Alexander,6,0,30,24
1656930733643,MATH 18,A02,083744,Cinel; Cameron Alexander,15,0,30,15
1656930733643,MATH 18,A03,083745,Cinel; Cameron Alexander,8,0,30,22
1656930733643,MATH 18,B01,083748,Rideout; David Porter,4,0,37,33
1656930733643,MATH 18,B02,083749,Rideout; David Porter,3,0,36,33
1656930733643,MATH 18,B03,083750,Rideout; David Porter,2,0,37,35
1656930733643,MATH 18,B04,083751,Rideout; David Porter,5,0,36,31
1656930733643,MATH 18,B05,093473,Rideout; David Porter,4,0,36,32
1656930733643,MATH 18,B06,093474,Rideout; David Porter,5,0,36,31
1656930739672,MATH 20A,A01,083754,Zheng; Zequn,12,0,40,28
1656930745703,MATH 20B,A01,083756,Briones; Jor-el Thomas Caparas,1,0,36,35
1656930745703,MATH 20B,A02,083757,Briones; Jor-el Thomas Caparas,1,0,36,35
1656930745703,MATH 20B,A03,093475,Briones; Jor-el Thomas Caparas,0,0,36,36
1656930751730,MATH 20C,A01,083760,Briones; Jor-el Thomas Caparas,1,0,35,34
1656930751730,MATH 20C,A02,083761,Briones; Jor-el Thomas Caparas,8,0,35,27
1656930751730,MATH 20C,A03,093476,Briones; Jor-el Thomas Caparas,0,1,36,36
1656930751730,MATH 20C,B01,083762,Bach; Quang Tran,0,0,30,30
1656930757754,MATH 20D,A01,083765,Tran; Brian Kha,4,0,30,26
1656930757754,MATH 20D,A02,083766,Tran; Brian Kha,4,0,30,26
1656930757754,MATH 20D,A03,083767,Tran; Brian Kha,3,0,30,27
1656930763785,MATH 20E,A01,083771,Ganguly; Soumya,5,0,32,27
1656930763785,MATH 20E,A02,083772,Ganguly; Soumya,6,0,32,26
1656930763785,MATH 20E,B01,083773,Ciotti; Benjamin,18,0,35,17
1656930763785,MATH 20E,B02,083774,Ciotti; Benjamin,17,0,35,18
1656930769810,MATH 103A,A01,083777,Greenfeld; Be'Eri,2,0,36,34
1656930769810,MATH 103A,A02,083778,Greenfeld; Be'Eri,5,0,36,31
1656930769810,MATH 103A,A03,093561,Greenfeld; Be'Eri,4,0,36,32
1656930769810,MATH 103A,B01,083779,Greenfeld; Be'Eri,6,0,36,30
1656930769810,MATH 103A,B02,083780,Greenfeld; Be'Eri,2,0,36,34
1656930769810,MATH 103A,B03,093562,Greenfeld; Be'Eri,2,0,36,34
1656930775836,MATH 105,A01,085443,Carter; Anne Toulson,13,0,35,22
1656930775836,MATH 105,A02,093477,Carter; Anne Toulson,20,0,35,15
1656930781867,MATH 109,A01,083213,Ganzberger; Geoffrey Michael,2,0,34,32
1656930781867,MATH 109,A02,083214,Ganzberger; Geoffrey Michael,2,0,34,32
1656930781867,MATH 109,A03,093478,Ganzberger; Geoffrey Michael,1,0,34,33
1656930781867,MATH 109,B01,083215,Ganzberger; Geoffrey Michael,1,0,32,31
1656930781867,MATH 109,B02,083216,Ganzberger; Geoffrey Michael,1,0,32,31
1656930781867,MATH 109,B03,093479,Ganzberger; Geoffrey Michael,6,0,32,26
1656930787891,MATH 142A,A01,083219,Chow; Bennett,6,0,32,26
1656930787891,MATH 142A,A02,083220,Chow; Bennett,10,0,32,22
1656930787891,MATH 142A,A03,093480,Chow; Bennett,7,0,32,25
1656930787891,MATH 142A,B03,093481,Chow; Bennett,7,0,32,25
1656930787891,MATH 142A,B04,093558,Chow; Bennett,11,0,32,21
1656930787891,MATH 142A,B05,093559,Chow; Bennett,6,0,32,26
1656930793915,MATH 193A,A01,083224,Rotar; Vladimir,7,0,34,27
1656930793915,MATH 193A,A02,083225,Rotar; Vladimir,3,0,34,31
1656930793915,MATH 193A,A03,083781,Rotar; Vladimir,1,0,34,33
1656930793915,MATH 193A,A04,083782,Rotar; Vladimir,6,0,34,28
1656930793915,MATH 193A,A05,093482,Rotar; Vladimir,6,0,34,28
1656930799943,MATH 197,001,091859,McAuley; Julian John,9999,0,9999,0
1656930799943,MATH 197,002,095566,Kedlaya; Kiran S.,9997,0,9999,2
1656930799943,MATH 197,003,095567,Xiao; Ming,9999,0,9999,0
1656930799943,MATH 197,004,095571,Perols; Johan Lars,9998,0,9999,1
1656930807016,COGS 9,A01,083615,Shannon; Kyle Michael,7,0,75,68
1656930813045,COGS 11,A01,083617,Boyle; Mary E. T.,19,0,48,29
1656930819069,COGS 13,A01,083071,Bastos; Amalia Pinkusfeld,9,0,71,62
1656930825093,COGS 14A,A01,092681,Semenuks; Arturs,0,1,100,100
1656930831116,COGS 14B,A01,083073,Cheng; Tzu-Han,5,0,63,58
1656930837142,COGS 17,A01,092677,Semenuks; Arturs,4,0,81,77
1656930843256,COGS 100,A01,083619,Allen; Michael Gordon,15,0,70,55
1656930849286,COGS 101A,A01,083621,Davis; Joshua Daniel,9,0,68,59
1656930855315,COGS 101B,A01,091572,Allen; Michael Gordon,8,0,65,57
1656930861338,COGS 101C,A01,083625,Delgado; Tania,17,0,35,18
1656930867361,COGS 107A,A01,083627,Boyle; Mary E. T.,13,0,60,47
1656930873387,COGS 118A,A01,083075,Gupta; Anjum,15,0,76,61
1656930879422,CSE 3,A50,083646,Miranda; Gregory Joseph,22,0,50,28
1656930885451,CSE 8A,A50,083650,Miranda; Gregory Joseph,17,1,56,39
1656930891478,CSE 11,A01,083080,Cao; Yingjun,4,15,40,36
1656930897504,CSE 12,A01,083652,Krause-Levy; Sophia Louisa,20,1,120,100
1656930903529,CSE 15L,A01,083654,Morris; Justin Loren,8,0,50,42
1656930903529,CSE 15L,A02,083655,Morris; Justin Loren,8,0,50,42
1656930909560,CSE 20,A01,083657,Tran; Khoa Dang,37,0,80,43
1656930915583,CSE 21,A01,095574,Bach; Quang Tran,21,0,48,27
1656930921623,CSE 30,A01,083084,Eldon; John,4,0,80,76
1656930921623,CSE 30,B01,095061,Bhaskar; Nishant,6,0,50,44
1656930927646,CSE 100,A01,083659,Cao; Yingjun,3,4,70,67
1656930933671,CSE 134B,A01,083661,Powell; Thomas Allan,19,0,100,81
1656930939713,CSE 140,A01,083663,Gungor; Onat,14,0,85,71
1656930945737,CSE 140L,A01,083088,Eldon; John,16,0,100,84
1656930951775,CSE 175,A01,083665,Kumar; Rakesh,3,0,25,22
1656930957802,CSE 190,A00,092507,Dubnov; Shlomo,7,0,20,13
1656930963825,ECE 45,A01,083139,Congero; Spencer William,5,0,75,70
1656930969859,ECE 65,A50,083695,Saad; Andrew S,12,0,30,18
1656930969859,ECE 65,A51,095125,Saad; Andrew S,25,0,26,1
1656930975885,ECE 109,A01,091882,Touri; Behrouz,16,0,70,54
1656930981920,ECE 180,A00,083140,Abi Samra; Nicholas Camill,0,0,30,30
1656930981920,ECE 180,B00,083141,Abi Samra; Nicholas Camill,0,0,30,30
1656930988011,MATH 10A,A01,083735,Patchell; Gregory David,1,0,30,29
1656930988011,MATH 10A,A02,083736,Patchell; Gregory David,20,0,30,10
1656930988011,MATH 10A,A03,083737,Patchell; Gregory David,15,0,30,15
1656930994045,MATH 10B,A01,083207,Lim; Seonhee,7,0,34,27
1656930994045,MATH 10B,A02,083208,Lim; Seonhee,9,0,35,26
1656930994045,MATH 10B,A03,093472,Lim; Seonhee,4,0,34,30
1656930994045,MATH 10B,B01,083739,Sinha; Shubham,9,0,30,21
1656931000084,MATH 18,A01,083743,Cinel; Cameron Alexander,6,0,30,24
1656931000084,MATH 18,A02,083744,Cinel; Cameron Alexander,15,0,30,15
1656931000084,MATH 18,A03,083745,Cinel; Cameron Alexander,8,0,30,22
1656931000084,MATH 18,B01,083748,Rideout; David Porter,4,0,37,33
1656931000084,MATH 18,B02,083749,Rideout; David Porter,3,0,36,33
1656931000084,MATH 18,B03,083750,Rideout; David Porter,2,0,37,35
1656931000084,MATH 18,B04,083751,Rideout; David Porter,5,0,36,31
1656931000084,MATH 18,B05,093473,Rideout; David Porter,4,0,36,32
1656931000084,MATH 18,B06,093474,Rideout; David Porter,5,0,36,31
1656931006110,MATH 20A,A01,083754,Zheng; Zequn,12,0,40,28
1656931012134,MATH 20B,A01,083756,Briones; Jor-el Thomas Caparas,1,0,36,35
1656931012134,MATH 20B,A02,083757,Briones; Jor-el Thomas Caparas,1,0,36,35
1656931012134,MATH 20B,A03,093475,Briones; Jor-el Thomas Caparas,0,0,36,36
1656931018163,MATH 20C,A01,083760,Briones; Jor-el Thomas Caparas,1,0,35,34
1656931018163,MATH 20C,A02,083761,Briones; Jor-el Thomas Caparas,8,0,35,27
1656931018163,MATH 20C,A03,093476,Briones; Jor-el Thomas Caparas,0,1,36,36
1656931018163,MATH 20C,B01,083762,Bach; Quang Tran,0,0,30,30
1656931024198,MATH 20D,A01,083765,Tran; Brian Kha,4,0,30,26
1656931024198,MATH 20D,A02,083766,Tran; Brian Kha,4,0,30,26
1656931024198,MATH 20D,A03,083767,Tran; Brian Kha,3,0,30,27
1656931030228,MATH 20E,A01,083771,Ganguly; Soumya,5,0,32,27
1656931030228,MATH 20E,A02,083772,Ganguly; Soumya,6,0,32,26
1656931030228,MATH 20E,B01,083773,Ciotti; Benjamin,18,0,35,17
1656931030228,MATH 20E,B02,083774,Ciotti; Benjamin,17,0,35,18
1656931036262,MATH 103A,A01,083777,Greenfeld; Be'Eri,2,0,36,34
1656931036262,MATH 103A,A02,083778,Greenfeld; Be'Eri,5,0,36,31
1656931036262,MATH 103A,A03,093561,Greenfeld; Be'Eri,4,0,36,32
1656931036262,MATH 103A,B01,083779,Greenfeld; Be'Eri,6,0,36,30
1656931036262,MATH 103A,B02,083780,Greenfeld; Be'Eri,2,0,36,34
1656931036262,MATH 103A,B03,093562,Greenfeld; Be'Eri,2,0,36,34
1656931042308,MATH 105,A01,085443,Carter; Anne Toulson,13,0,35,22
1656931042308,MATH 105,A02,093477,Carter; Anne Toulson,20,0,35,15
1656931048337,MATH 109,A01,083213,Ganzberger; Geoffrey Michael,2,0,34,32
1656931048337,MATH 109,A02,083214,Ganzberger; Geoffrey Michael,2,0,34,32
1656931048337,MATH 109,A03,093478,Ganzberger; Geoffrey Michael,1,0,34,33
1656931048337,MATH 109,B01,083215,Ganzberger; Geoffrey Michael,1,0,32,31
1656931048337,MATH 109,B02,083216,Ganzberger; Geoffrey Michael,1,0,32,31
1656931048337,MATH 109,B03,093479,Ganzberger; Geoffrey Michael,6,0,32,26
1656931054365,MATH 142A,A01,083219,Chow; Bennett,6,0,32,26
1656931054365,MATH 142A,A02,083220,Chow; Bennett,10,0,32,22
1656931054365,MATH 142A,A03,093480,Chow; Bennett,7,0,32,25
1656931054365,MATH 142A,B03,093481,Chow; Bennett,7,0,32,25
1656931054365,MATH 142A,B04,093558,Chow; Bennett,11,0,32,21
1656931054365,MATH 142A,B05,093559,Chow; Bennett,6,0,32,26
1656931060390,MATH 193A,A01,083224,Rotar; Vladimir,7,0,34,27
1656931060390,MATH 193A,A02,083225,Rotar; Vladimir,3,0,34,31
1656931060390,MATH 193A,A03,083781,Rotar; Vladimir,1,0,34,33
1656931060390,MATH 193A,A04,083782,Rotar; Vladimir,6,0,34,28
1656931060390,MATH 193A,A05,093482,Rotar; Vladimir,6,0,34,28
1656931066420,MATH 197,001,091859,McAuley; Julian John,9999,0,9999,0
1656931066420,MATH 197,002,095566,Kedlaya; Kiran S.,9997,0,9999,2
1656931066420,MATH 197,003,095567,Xiao; Ming,9999,0,9999,0
1656931066420,MATH 197,004,095571,Perols; Johan Lars,9998,0,9999,1
1656931073498,COGS 9,A01,083615,Shannon; Kyle Michael,7,0,75,68
1656931079530,COGS 11,A01,083617,Boyle; Mary E. T.,19,0,48,29
1656931085557,COGS 13,A01,083071,Bastos; Amalia Pinkusfeld,9,0,71,62
1656931091598,COGS 14A,A01,092681,Semenuks; Arturs,0,1,100,100
1656931097633,COGS 14B,A01,083073,Cheng; Tzu-Han,5,0,63,58
1656931103663,COGS 17,A01,092677,Semenuks; Arturs,4,0,81,77
1656931109689,COGS 100,A01,083619,Allen; Michael Gordon,15,0,70,55
1656931115727,COGS 101A,A01,083621,Davis; Joshua Daniel,9,0,68,59
1656931121766,COGS 101B,A01,091572,Allen; Michael Gordon,8,0,65,57
1656931127816,COGS 101C,A01,083625,Delgado; Tania,17,0,35,18
1656931133840,COGS 107A,A01,083627,Boyle; Mary E. T.,13,0,60,47
1656931139870,COGS 118A,A01,083075,Gupta; Anjum,15,0,76,61
1656931145921,CSE 3,A50,083646,Miranda; Gregory Joseph,22,0,50,28
1656931151950,CSE 8A,A50,083650,Miranda; Gregory Joseph,17,1,56,39
1656931157978,CSE 11,A01,083080,Cao; Yingjun,4,15,40,36
1656931164004,CSE 12,A01,083652,Krause-Levy; Sophia Louisa,20,1,120,100
1656931170027,CSE 15L,A01,083654,Morris; Justin Loren,8,0,50,42
1656931170027,CSE 15L,A02,083655,Morris; Justin Loren,8,0,50,42
1656931176059,CSE 20,A01,083657,Tran; Khoa Dang,37,0,80,43
1656931182091,CSE 21,A01,095574,Bach; Quang Tran,21,0,48,27
1656931188118,CSE 30,A01,083084,Eldon; John,4,0,80,76
1656931188118,CSE 30,B01,095061,Bhaskar; Nishant,6,0,50,44
1656931194144,CSE 100,A01,083659,Cao; Yingjun,3,4,70,67
1656931200170,CSE 134B,A01,083661,Powell; Thomas Allan,19,0,100,81
1656931206200,CSE 140,A01,083663,Gungor; Onat,14,0,85,71
1656931212236,CSE 140L,A01,083088,Eldon; John,16,0,100,84
1656931218262,CSE 175,A01,083665,Kumar; Rakesh,3,0,25,22
1656931224287,CSE 190,A00,092507,Dubnov; Shlomo,7,0,20,13
1656931230322,ECE 45,A01,083139,Congero; Spencer William,5,0,75,70
1656931236360,ECE 65,A50,083695,Saad; Andrew S,12,0,30,18
1656931236360,ECE 65,A51,095125,Saad; Andrew S,25,0,26,1
1656931242385,ECE 109,A01,091882,Touri; Behrouz,16,0,70,54
1656931248411,ECE 180,A00,083140,Abi Samra; Nicholas Camill,0,0,30,30
1656931248411,ECE 180,B00,083141,Abi Samra; Nicholas Camill,0,0,30,30
1656931254437,MATH 10A,A01,083735,Patchell; Gregory David,1,0,30,29
1656931254437,MATH 10A,A02,083736,Patchell; Gregory David,20,0,30,10
1656931254437,MATH 10A,A03,083737,Patchell; Gregory David,15,0,30,15
1656931260467,MATH 10B,A01,083207,Lim; Seonhee,7,0,34,27
1656931260467,MATH 10B,A02,083208,Lim; Seonhee,9,0,35,26
1656931260467,MATH 10B,A03,093472,Lim; Seonhee,4,0,34,30
1656931260467,MATH 10B,B01,083739,Sinha; Shubham,9,0,30,21
1656931266495,MATH 18,A01,083743,Cinel; Cameron Alexander,6,0,30,24
1656931266495,MATH 18,A02,083744,Cinel; Cameron Alexander,15,0,30,15
1656931266495,MATH 18,A03,083745,Cinel; Cameron Alexander,8,0,30,22
1656931266495,MATH 18,B01,083748,Rideout; David Porter,4,0,37,33
1656931266495,MATH 18,B02,083749,Rideout; David Porter,3,0,36,33
1656931266495,MATH 18,B03,083750,Rideout; David Porter,2,0,37,35
1656931266495,MATH 18,B04,083751,Rideout; David Porter,5,0,36,31
1656931266495,MATH 18,B05,093473,Rideout; David Porter,4,0,36,32
1656931266495,MATH 18,B06,093474,Rideout; David Porter,5,0,36,31
1656931272522,MATH 20A,A01,083754,Zheng; Zequn,12,0,40,28
1656931278549,MATH 20B,A01,083756,Briones; Jor-el Thomas Caparas,1,0,36,35
1656931278549,MATH 20B,A02,083757,Briones; Jor-el Thomas Caparas,1,0,36,35
1656931278549,MATH 20B,A03,093475,Briones; Jor-el Thomas Caparas,0,0,36,36
1656931284576,MATH 20C,A01,083760,Briones; Jor-el Thomas Caparas,1,0,35,34
1656931284576,MATH 20C,A02,083761,Briones; Jor-el Thomas Caparas,8,0,35,27
1656931284576,MATH 20C,A03,093476,Briones; Jor-el Thomas Caparas,0,1,36,36
1656931284576,MATH 20C,B01,083762,Bach; Quang Tran,0,0,30,30
1656931290604,MATH 20D,A01,083765,Tran; Brian Kha,4,0,30,26
1656931290604,MATH 20D,A02,083766,Tran; Brian Kha,4,0,30,26
1656931290604,MATH 20D,A03,083767,Tran; Brian Kha,3,0,30,27
1656931296631,MATH 20E,A01,083771,Ganguly; Soumya,5,0,32,27
1656931296631,MATH 20E,A02,083772,Ganguly; Soumya,6,0,32,26
1656931296631,MATH 20E,B01,083773,Ciotti; Benjamin,18,0,35,17
1656931296631,MATH 20E,B02,083774,Ciotti; Benjamin,17,0,35,18
1656931302669,MATH 103A,A01,083777,Greenfeld; Be'Eri,2,0,36,34
1656931302669,MATH 103A,A02,083778,Greenfeld; Be'Eri,5,0,36,31
1656931302669,MATH 103A,A03,093561,Greenfeld; Be'Eri,4,0,36,32
1656931302669,MATH 103A,B01,083779,Greenfeld; Be'Eri,6,0,36,30
1656931302669,MATH 103A,B02,083780,Greenfeld; Be'Eri,2,0,36,34
1656931302669,MATH 103A,B03,093562,Greenfeld; Be'Eri,2,0,36,34
1656931308697,MATH 105,A01,085443,Carter; Anne Toulson,13,0,35,22
1656931308697,MATH 105,A02,093477,Carter; Anne Toulson,20,0,35,15
1656931314723,MATH 109,A01,083213,Ganzberger; Geoffrey Michael,2,0,34,32
1656931314723,MATH 109,A02,083214,Ganzberger; Geoffrey Michael,2,0,34,32
1656931314723,MATH 109,A03,093478,Ganzberger; Geoffrey Michael,1,0,34,33
1656931314723,MATH 109,B01,083215,Ganzberger; Geoffrey Michael,1,0,32,31
1656931314723,MATH 109,B02,083216,Ganzberger; Geoffrey Michael,1,0,32,31
1656931314723,MATH 109,B03,093479,Ganzberger; Geoffrey Michael,6,0,32,26
1656931320752,MATH 142A,A01,083219,Chow; Bennett,6,0,32,26
1656931320752,MATH 142A,A02,083220,Chow; Bennett,10,0,32,22
1656931320752,MATH 142A,A03,093480,Chow; Bennett,7,0,32,25
1656931320752,MATH 142A,B03,093481,Chow; Bennett,7,0,32,25
1656931320752,MATH 142A,B04,093558,Chow; Bennett,11,0,32,21
1656931320752,MATH 142A,B05,093559,Chow; Bennett,6,0,32,26
1656931326795,MATH 193A,A01,083224,Rotar; Vladimir,7,0,34,27
1656931326795,MATH 193A,A02,083225,Rotar; Vladimir,3,0,34,31
1656931326795,MATH 193A,A03,083781,Rotar; Vladimir,1,0,34,33
1656931326795,MATH 193A,A04,083782,Rotar; Vladimir,6,0,34,28
1656931326795,MATH 193A,A05,093482,Rotar; Vladimir,6,0,34,28
1656931332823,MATH 197,001,091859,McAuley; Julian John,9999,0,9999,0
1656931332823,MATH 197,002,095566,Kedlaya; Kiran S.,9997,0,9999,2
1656931332823,MATH 197,003,095567,Xiao; Ming,9999,0,9999,0
1656931332823,MATH 197,004,095571,Perols; Johan Lars,9998,0,9999,1
1656931339918,COGS 9,A01,083615,Shannon; Kyle Michael,7,0,75,68
1656931345943,COGS 11,A01,083617,Boyle; Mary E. T.,19,0,48,29
1656931351967,COGS 13,A01,083071,Bastos; Amalia Pinkusfeld,9,0,71,62
1656931358001,COGS 14A,A01,092681,Semenuks; Arturs,0,1,100,100
1656931364026,COGS 14B,A01,083073,Cheng; Tzu-Han,5,0,63,58
1656931370053,COGS 17,A01,092677,Semenuks; Arturs,4,0,81,77
1656931376079,COGS 100,A01,083619,Allen; Michael Gordon,15,0,70,55
1656931382103,COGS 101A,A01,083621,Davis; Joshua Daniel,9,0,68,59
1656931388135,COGS 101B,A01,091572,Allen; Michael Gordon,8,0,65,57
1656931394166,COGS 101C,A01,083625,Delgado; Tania,17,0,35,18
1656931400195,COGS 107A,A01,083627,Boyle; Mary E. T.,13,0,60,47
1656931406220,COGS 118A,A01,083075,Gupta; Anjum,15,0,76,61
1656931412254,CSE 3,A50,083646,Miranda; Gregory Joseph,22,0,50,28
1656931418278,CSE 8A,A50,083650,Miranda; Gregory Joseph,17,1,56,39
1656931424303,CSE 11,A01,083080,Cao; Yingjun,4,15,40,36
1656931430328,CSE 12,A01,083652,Krause-Levy; Sophia Louisa,20,1,120,100
1656931436357,CSE 15L,A01,083654,Morris; Justin Loren,8,0,50,42
1656931436357,CSE 15L,A02,083655,Morris; Justin Loren,8,0,50,42
1656931442464,CSE 20,A01,083657,Tran; Khoa Dang,37,0,80,43
1656931448489,CSE 21,A01,095574,Bach; Quang Tran,21,0,48,27
1656931454514,CSE 30,A01,083084,Eldon; John,4,0,80,76
1656931454514,CSE 30,B01,095061,Bhaskar; Nishant,6,0,50,44
1656931460544,CSE 100,A01,083659,Cao; Yingjun,3,4,70,67
1656931466573,CSE 134B,A01,083661,Powell; Thomas Allan,19,0,100,81
1656931472599,CSE 140,A01,083663,Gungor; Onat,14,0,85,71
1656931478623,CSE 140L,A01,083088,Eldon; John,16,0,100,84
1656931484653,CSE 175,A01,083665,Kumar; Rakesh,3,0,25,22
1656931490680,CSE 190,A00,092507,Dubnov; Shlomo,7,0,20,13
1656931496705,ECE 45,A01,083139,Congero; Spencer William,5,0,75,70
1656931502731,ECE 65,A50,083695,Saad; Andrew S,12,0,30,18
1656931502731,ECE 65,A51,095125,Saad; Andrew S,25,0,26,1
1656931508759,ECE 109,A01,091882,Touri; Behrouz,16,0,70,54
1656931514792,ECE 180,A00,083140,Abi Samra; Nicholas Camill,0,0,30,30
1656931514792,ECE 180,B00,083141,Abi Samra; Nicholas Camill,0,0,30,30
1656931520818,MATH 10A,A01,083735,Patchell; Gregory David,1,0,30,29
1656931520818,MATH 10A,A02,083736,Patchell; Gregory David,20,0,30,10
1656931520818,MATH 10A,A03,083737,Patchell; Gregory David,15,0,30,15
1656931526847,MATH 10B,A01,083207,Lim; Seonhee,7,0,34,27
1656931526847,MATH 10B,A02,083208,Lim; Seonhee,9,0,35,26
1656931526847,MATH 10B,A03,093472,Lim; Seonhee,4,0,34,30
1656931526847,MATH 10B,B01,083739,Sinha; Shubham,9,0,30,21
1656931532886,MATH 18,A01,083743,Cinel; Cameron Alexander,6,0,30,24
1656931532886,MATH 18,A02,083744,Cinel; Cameron Alexander,15,0,30,15
1656931532886,MATH 18,A03,083745,Cinel; Cameron Alexander,8,0,30,22
1656931532886,MATH 18,B01,083748,Rideout; David Porter,4,0,37,33
1656931532886,MATH 18,B02,083749,Rideout; David Porter,3,0,36,33
1656931532886,MATH 18,B03,083750,Rideout; David Porter,2,0,37,35
1656931532886,MATH 18,B04,083751,Rideout; David Porter,5,0,36,31
1656931532886,MATH 18,B05,093473,Rideout; David Porter,4,0,36,32
1656931532886,MATH 18,B06,093474,Rideout; David Porter,5,0,36,31
1656931538918,MATH 20A,A01,083754,Zheng; Zequn,12,0,40,28
1656931544950,MATH 20B,A01,083756,Briones; Jor-el Thomas Caparas,1,0,36,35
1656931544950,MATH 20B,A02,083757,Briones; Jor-el Thomas Caparas,1,0,36,35
1656931544950,MATH 20B,A03,093475,Briones; Jor-el Thomas Caparas,0,0,36,36
1656931550976,MATH 20C,A01,083760,Briones; Jor-el Thomas Caparas,1,0,35,34
1656931550976,MATH 20C,A02,083761,Briones; Jor-el Thomas Caparas,8,0,35,27
1656931550976,MATH 20C,A03,093476,Briones; Jor-el Thomas Caparas,0,1,36,36
1656931550976,MATH 20C,B01,083762,Bach; Quang Tran,0,0,30,30
1656931557002,MATH 20D,A01,083765,Tran; Brian Kha,4,0,30,26
1656931557002,MATH 20D,A02,083766,Tran; Brian Kha,4,0,30,26
1656931557002,MATH 20D,A03,083767,Tran; Brian Kha,3,0,30,27
1656931563029,MATH 20E,A01,083771,Ganguly; Soumya,5,0,32,27
1656931563029,MATH 20E,A02,083772,Ganguly; Soumya,6,0,32,26
1656931563029,MATH 20E,B01,083773,Ciotti; Benjamin,18,0,35,17
1656931563029,MATH 20E,B02,083774,Ciotti; Benjamin,17,0,35,18
1656931569060,MATH 103A,A01,083777,Greenfeld; Be'Eri,2,0,36,34
1656931569060,MATH 103A,A02,083778,Greenfeld; Be'Eri,5,0,36,31
1656931569060,MATH 103A,A03,093561,Greenfeld; Be'Eri,4,0,36,32
1656931569060,MATH 103A,B01,083779,Greenfeld; Be'Eri,6,0,36,30
1656931569060,MATH 103A,B02,083780,Greenfeld; Be'Eri,2,0,36,34
1656931569060,MATH 103A,B03,093562,Greenfeld; Be'Eri,2,0,36,34
1656931575093,MATH 105,A01,085443,Carter; Anne Toulson,13,0,35,22
1656931575093,MATH 105,A02,093477,Carter; Anne Toulson,20,0,35,15
1656931581119,MATH 109,A01,083213,Ganzberger; Geoffrey Michael,2,0,34,32
1656931581119,MATH 109,A02,083214,Ganzberger; Geoffrey Michael,2,0,34,32
1656931581119,MATH 109,A03,093478,Ganzberger; Geoffrey Michael,1,0,34,33
1656931581119,MATH 109,B01,083215,Ganzberger; Geoffrey Michael,1,0,32,31
1656931581119,MATH 109,B02,083216,Ganzberger; Geoffrey Michael,1,0,32,31
1656931581119,MATH 109,B03,093479,Ganzberger; Geoffrey Michael,6,0,32,26
1656931587154,MATH 142A,A01,083219,Chow; Bennett,6,0,32,26
1656931587154,MATH 142A,A02,083220,Chow; Bennett,10,0,32,22
1656931587154,MATH 142A,A03,093480,Chow; Bennett,7,0,32,25
1656931587154,MATH 142A,B03,093481,Chow; Bennett,7,0,32,25
1656931587154,MATH 142A,B04,093558,Chow; Bennett,11,0,32,21
1656931587154,MATH 142A,B05,093559,Chow; Bennett,6,0,32,26
1656931593186,MATH 193A,A01,083224,Rotar; Vladimir,7,0,34,27
1656931593186,MATH 193A,A02,083225,Rotar; Vladimir,3,0,34,31
1656931593186,MATH 193A,A03,083781,Rotar; Vladimir,1,0,34,33
1656931593186,MATH 193A,A04,083782,Rotar; Vladimir,6,0,34,28
1656931593186,MATH 193A,A05,093482,Rotar; Vladimir,6,0,34,28
1656931599217,MATH 197,001,091859,McAuley; Julian John,9999,0,9999,0
1656931599217,MATH 197,002,095566,Kedlaya; Kiran S.,9997,0,9999,2
1656931599217,MATH 197,003,095567,Xiao; Ming,9999,0,9999,0
1656931599217,MATH 197,004,095571,Perols; Johan Lars,9998,0,9999,1
1656931606305,COGS 9,A01,083615,Shannon; Kyle Michael,7,0,75,68
1656931612331,COGS 11,A01,083617,Boyle; Mary E. T.,19,0,48,29
1656931618355,COGS 13,A01,083071,Bastos; Amalia Pinkusfeld,9,0,71,62
1656931624385,COGS 14A,A01,092681,Semenuks; Arturs,0,1,100,100
1656931630414,COGS 14B,A01,083073,Cheng; Tzu-Han,5,0,63,58
1656931636439,COGS 17,A01,092677,Semenuks; Arturs,4,0,81,77
1656931642463,COGS 100,A01,083619,Allen; Michael Gordon,15,0,70,55
1656931648487,COGS 101A,A01,083621,Davis; Joshua Daniel,9,0,68,59
1656931654517,COGS 101B,A01,091572,Allen; Michael Gordon,8,0,65,57
1656931660547,COGS 101C,A01,083625,Delgado; Tania,17,0,35,18
1656931666571,COGS 107A,A01,083627,Boyle; Mary E. T.,13,0,60,47
1656931672597,COGS 118A,A01,083075,Gupta; Anjum,15,0,76,61
1656931678624,CSE 3,A50,083646,Miranda; Gregory Joseph,22,0,50,28
1656931684654,CSE 8A,A50,083650,Miranda; Gregory Joseph,17,1,56,39
1656931690680,CSE 11,A01,083080,Cao; Yingjun,4,15,40,36
1656931696709,CSE 12,A01,083652,Krause-Levy; Sophia Louisa,20,1,120,100
1656931702733,CSE 15L,A01,083654,Morris; Justin Loren,8,0,50,42
1656931702733,CSE 15L,A02,083655,Morris; Justin Loren,8,0,50,42
1656931708762,CSE 20,A01,083657,Tran; Khoa Dang,37,0,80,43
1656931714790,CSE 21,A01,095574,Bach; Quang Tran,21,0,48,27
1656931720819,CSE 30,A01,083084,Eldon; John,4,0,80,76
1656931720819,CSE 30,B01,095061,Bhaskar; Nishant,6,0,50,44
1656931726844,CSE 100,A01,083659,Cao; Yingjun,3,4,70,67
1656931732870,CSE 134B,A01,083661,Powell; Thomas Allan,19,0,100,81
1656931738894,CSE 140,A01,083663,Gungor; Onat,14,0,85,71
1656931744928,CSE 140L,A01,083088,Eldon; John,16,0,100,84
1656931750959,CSE 175,A01,083665,Kumar; Rakesh,3,0,25,22
1656931756983,CSE 190,A00,092507,Dubnov; Shlomo,7,0,20,13
1656931763014,ECE 45,A01,083139,Congero; Spencer William,5,0,75,70
1656931769045,ECE 65,A50,083695,Saad; Andrew S,12,0,30,18
1656931769045,ECE 65,A51,095125,Saad; Andrew S,25,0,26,1
1656931775071,ECE 109,A01,091882,Touri; Behrouz,16,0,70,54
1656931781101,ECE 180,A00,083140,Abi Samra; Nicholas Camill,0,0,30,30
1656931781101,ECE 180,B00,083141,Abi Samra; Nicholas Camill,0,0,30,30
1656931787128,MATH 10A,A01,083735,Patchell; Gregory David,1,0,30,29
1656931787128,MATH 10A,A02,083736,Patchell; Gregory David,20,0,30,10
1656931787128,MATH 10A,A03,083737,Patchell; Gregory David,15,0,30,15
1656931793155,MATH 10B,A01,083207,Lim; Seonhee,7,0,34,27
1656931793155,MATH 10B,A02,083208,Lim; Seonhee,9,0,35,26
1656931793155,MATH 10B,A03,093472,Lim; Seonhee,4,0,34,30
1656931793155,MATH 10B,B01,083739,Sinha; Shubham,9,0,30,21
1656931799182,MATH 18,A01,083743,Cinel; Cameron Alexander,6,0,30,24
1656931799182,MATH 18,A02,083744,Cinel; Cameron Alexander,15,0,30,15
1656931799182,MATH 18,A03,083745,Cinel; Cameron Alexander,8,0,30,22
1656931799182,MATH 18,B01,083748,Rideout; David Porter,4,0,37,33
1656931799182,MATH 18,B02,083749,Rideout; David Porter,3,0,36,33
1656931799182,MATH 18,B03,083750,Rideout; David Porter,2,0,37,35
1656931799182,MATH 18,B04,083751,Rideout; David Porter,5,0,36,31
1656931799182,MATH 18,B05,093473,Rideout; David Porter,4,0,36,32
1656931799182,MATH 18,B06,093474,Rideout; David Porter,5,0,36,31
1656931805206,MATH 20A,A01,083754,Zheng; Zequn,12,0,40,28
1656931811238,MATH 20B,A01,083756,Briones; Jor-el Thomas Caparas,1,0,36,35
1656931811238,MATH 20B,A02,083757,Briones; Jor-el Thomas Caparas,1,0,36,35
1656931811238,MATH 20B,A03,093475,Briones; Jor-el Thomas Caparas,0,0,36,36
1656931817263,MATH 20C,A01,083760,Briones; Jor-el Thomas Caparas,1,0,35,34
1656931817263,MATH 20C,A02,083761,Briones; Jor-el Thomas Caparas,8,0,35,27
1656931817263,MATH 20C,A03,093476,Briones; Jor-el Thomas Caparas,0,1,36,36
1656931817263,MATH 20C,B01,083762,Bach; Quang Tran,0,0,30,30
1656931823288,MATH 20D,A01,083765,Tran; Brian Kha,4,0,30,26
1656931823288,MATH 20D,A02,083766,Tran; Brian Kha,4,0,30,26
1656931823288,MATH 20D,A03,083767,Tran; Brian Kha,3,0,30,27
1656931829324,MATH 20E,A01,083771,Ganguly; Soumya,5,0,32,27
1656931829324,MATH 20E,A02,083772,Ganguly; Soumya,6,0,32,26
1656931829324,MATH 20E,B01,083773,Ciotti; Benjamin,18,0,35,17
1656931829324,MATH 20E,B02,083774,Ciotti; Benjamin,17,0,35,18
1656931835350,MATH 103A,A01,083777,Greenfeld; Be'Eri,2,0,36,34
1656931835350,MATH 103A,A02,083778,Greenfeld; Be'Eri,5,0,36,31
1656931835350,MATH 103A,A03,093561,Greenfeld; Be'Eri,4,0,36,32
1656931835350,MATH 103A,B01,083779,Greenfeld; Be'Eri,6,0,36,30
1656931835350,MATH 103A,B02,083780,Greenfeld; Be'Eri,2,0,36,34
1656931835350,MATH 103A,B03,093562,Greenfeld; Be'Eri,2,0,36,34
1656931841373,MATH 105,A01,085443,Carter; Anne Toulson,13,0,35,22
1656931841373,MATH 105,A02,093477,Carter; Anne Toulson,20,0,35,15
1656931847399,MATH 109,A01,083213,Ganzberger; Geoffrey Michael,2,0,34,32
1656931847399,MATH 109,A02,083214,Ganzberger; Geoffrey Michael,2,0,34,32
1656931847399,MATH 109,A03,093478,Ganzberger; Geoffrey Michael,1,0,34,33
1656931847399,MATH 109,B01,083215,Ganzberger; Geoffrey Michael,1,0,32,31
1656931847399,MATH 109,B02,083216,Ganzberger; Geoffrey Michael,1,0,32,31
1656931847399,MATH 109,B03,093479,Ganzberger; Geoffrey Michael,6,0,32,26
1656931853425,MATH 142A,A01,083219,Chow; Bennett,6,0,32,26
1656931853425,MATH 142A,A02,083220,Chow; Bennett,10,0,32,22
1656931853425,MATH 142A,A03,093480,Chow; Bennett,7,0,32,25
1656931853425,MATH 142A,B03,093481,Chow; Bennett,7,0,32,25
1656931853425,MATH 142A,B04,093558,Chow; Bennett,11,0,32,21
1656931853425,MATH 142A,B05,093559,Chow; Bennett,6,0,32,26
1656931859449,MATH 193A,A01,083224,Rotar; Vladimir,7,0,34,27
1656931859449,MATH 193A,A02,083225,Rotar; Vladimir,3,0,34,31
1656931859449,MATH 193A,A03,083781,Rotar; Vladimir,1,0,34,33
1656931859449,MATH 193A,A04,083782,Rotar; Vladimir,6,0,34,28
1656931859449,MATH 193A,A05,093482,Rotar; Vladimir,6,0,34,28
1656931865481,MATH 197,001,091859,McAuley; Julian John,9999,0,9999,0
1656931865481,MATH 197,002,095566,Kedlaya; Kiran S.,9997,0,9999,2
1656931865481,MATH 197,003,095567,Xiao; Ming,9999,0,9999,0
1656931865481,MATH 197,004,095571,Perols; Johan Lars,9998,0,9999,1
1656931872542,COGS 9,A01,083615,Shannon; Kyle Michael,7,0,75,68
1656931878572,COGS 11,A01,083617,Boyle; Mary E. T.,19,0,48,29
1656931884602,COGS 13,A01,083071,Bastos; Amalia Pinkusfeld,9,0,71,62
1656931890628,COGS 14A,A01,092681,Semenuks; Arturs,0,1,100,100
1656931896660,COGS 14B,A01,083073,Cheng; Tzu-Han,5,0,63,58
1656931902688,COGS 17,A01,092677,Semenuks; Arturs,4,0,81,77
1656931908724,COGS 100,A01,083619,Allen; Michael Gordon,15,0,70,55
1656931914749,COGS 101A,A01,083621,Davis; Joshua Daniel,9,0,68,59
1656931920772,COGS 101B,A01,091572,Allen; Michael Gordon,8,0,65,57
1656931926803,COGS 101C,A01,083625,Delgado; Tania,17,0,35,18
1656931932830,COGS 107A,A01,083627,Boyle; Mary E. T.,13,0,60,47
1656931938855,COGS 118A,A01,083075,Gupta; Anjum,15,0,76,61
1656931944880,CSE 3,A50,083646,Miranda; Gregory Joseph,22,0,50,28
1656931950907,CSE 8A,A50,083650,Miranda; Gregory Joseph,17,1,56,39
1656931956931,CSE 11,A01,083080,Cao; Yingjun,4,15,40,36
1656931962955,CSE 12,A01,083652,Krause-Levy; Sophia Louisa,20,1,120,100
1656931968984,CSE 15L,A01,083654,Morris; Justin Loren,8,0,50,42
1656931968984,CSE 15L,A02,083655,Morris; Justin Loren,8,0,50,42
1656931975011,CSE 20,A01,083657,Tran; Khoa Dang,37,0,80,43
1656931981038,CSE 21,A01,095574,Bach; Quang Tran,21,0,48,27
1656931987062,CSE 30,A01,083084,Eldon; John,4,0,80,76
1656931987062,CSE 30,B01,095061,Bhaskar; Nishant,6,0,50,44
1656931993095,CSE 100,A01,083659,Cao; Yingjun,3,4,70,67
1656931999119,CSE 134B,A01,083661,Powell; Thomas Allan,19,0,100,81
1656932005147,CSE 140,A01,083663,Gungor; Onat,14,0,85,71
1656932011171,CSE 140L,A01,083088,Eldon; John,16,0,100,84
1656932017201,CSE 175,A01,083665,Kumar; Rakesh,3,0,25,22
1656932023234,CSE 190,A00,092507,Dubnov; Shlomo,7,0,20,13
1656932029267,ECE 45,A01,083139,Congero; Spencer William,5,0,75,70
1656932035303,ECE 65,A50,083695,Saad; Andrew S,12,0,30,18
1656932035303,ECE 65,A51,095125,Saad; Andrew S,25,0,26,1
1656932041401,ECE 109,A01,091882,Touri; Behrouz,16,0,70,54
1656932047426,ECE 180,A00,083140,Abi Samra; Nicholas Camill,0,0,30,30
1656932047426,ECE 180,B00,083141,Abi Samra; Nicholas Camill,0,0,30,30
1656932053453,MATH 10A,A01,083735,Patchell; Gregory David,1,0,30,29
1656932053453,MATH 10A,A02,083736,Patchell; Gregory David,20,0,30,10
1656932053453,MATH 10A,A03,083737,Patchell; Gregory David,15,0,30,15
1656932059487,MATH 10B,A01,083207,Lim; Seonhee,7,0,34,27
1656932059487,MATH 10B,A02,083208,Lim; Seonhee,9,0,35,26
1656932059487,MATH 10B,A03,093472,Lim; Seonhee,4,0,34,30
1656932059487,MATH 10B,B01,083739,Sinha; Shubham,9,0,30,21
1656932065526,MATH 18,A01,083743,Cinel; Cameron Alexander,6,0,30,24
1656932065526,MATH 18,A02,083744,Cinel; Cameron Alexander,15,0,30,15
1656932065526,MATH 18,A03,083745,Cinel; Cameron Alexander,8,0,30,22
1656932065526,MATH 18,B01,083748,Rideout; David Porter,4,0,37,33
1656932065526,MATH 18,B02,083749,Rideout; David Porter,3,0,36,33
1656932065526,MATH 18,B03,083750,Rideout; David Porter,2,0,37,35
1656932065526,MATH 18,B04,083751,Rideout; David Porter,5,0,36,31
1656932065526,MATH 18,B05,093473,Rideout; David Porter,4,0,36,32
1656932065526,MATH 18,B06,093474,Rideout; David Porter,5,0,36,31
1656932071549,MATH 20A,A01,083754,Zheng; Zequn,12,0,40,28
1656932077582,MATH 20B,A01,083756,Briones; Jor-el Thomas Caparas,1,0,36,35
1656932077582,MATH 20B,A02,083757,Briones; Jor-el Thomas Caparas,1,0,36,35
1656932077582,MATH 20B,A03,093475,Briones; Jor-el Thomas Caparas,0,0,36,36
1656932083606,MATH 20C,A01,083760,Briones; Jor-el Thomas Caparas,1,0,35,34
1656932083606,MATH 20C,A02,083761,Briones; Jor-el Thomas Caparas,8,0,35,27
1656932083606,MATH 20C,A03,093476,Briones; Jor-el Thomas Caparas,0,1,36,36
1656932083606,MATH 20C,B01,083762,Bach; Quang Tran,0,0,30,30
1656932089637,MATH 20D,A01,083765,Tran; Brian Kha,4,0,30,26
1656932089637,MATH 20D,A02,083766,Tran; Brian Kha,4,0,30,26
1656932089637,MATH 20D,A03,083767,Tran; Brian Kha,3,0,30,27
1656932095669,MATH 20E,A01,083771,Ganguly; Soumya,5,0,32,27
1656932095669,MATH 20E,A02,083772,Ganguly; Soumya,6,0,32,26
1656932095669,MATH 20E,B01,083773,Ciotti; Benjamin,18,0,35,17
1656932095669,MATH 20E,B02,083774,Ciotti; Benjamin,17,0,35,18
1656932101695,MATH 103A,A01,083777,Greenfeld; Be'Eri,2,0,36,34
1656932101695,MATH 103A,A02,083778,Greenfeld; Be'Eri,5,0,36,31
1656932101695,MATH 103A,A03,093561,Greenfeld; Be'Eri,4,0,36,32
1656932101695,MATH 103A,B01,083779,Greenfeld; Be'Eri,6,0,36,30
1656932101695,MATH 103A,B02,083780,Greenfeld; Be'Eri,2,0,36,34
1656932101695,MATH 103A,B03,093562,Greenfeld; Be'Eri,2,0,36,34
1656932107718,MATH 105,A01,085443,Carter; Anne Toulson,13,0,35,22
1656932107718,MATH 105,A02,093477,Carter; Anne Toulson,20,0,35,15
1656932113743,MATH 109,A01,083213,Ganzberger; Geoffrey Michael,2,0,34,32
1656932113743,MATH 109,A02,083214,Ganzberger; Geoffrey Michael,2,0,34,32
1656932113743,MATH 109,A03,093478,Ganzberger; Geoffrey Michael,1,0,34,33
1656932113743,MATH 109,B01,083215,Ganzberger; Geoffrey Michael,1,0,32,31
1656932113743,MATH 109,B02,083216,Ganzberger; Geoffrey Michael,1,0,32,31
1656932113743,MATH 109,B03,093479,Ganzberger; Geoffrey Michael,6,0,32,26
1656932119767,MATH 142A,A01,083219,Chow; Bennett,6,0,32,26
1656932119767,MATH 142A,A02,083220,Chow; Bennett,10,0,32,22
1656932119767,MATH 142A,A03,093480,Chow; Bennett,7,0,32,25
1656932119767,MATH 142A,B03,093481,Chow; Bennett,7,0,32,25
1656932119767,MATH 142A,B04,093558,Chow; Bennett,11,0,32,21
1656932119767,MATH 142A,B05,093559,Chow; Bennett,6,0,32,26
1656932125792,MATH 193A,A01,083224,Rotar; Vladimir,7,0,34,27
1656932125792,MATH 193A,A02,083225,Rotar; Vladimir,3,0,34,31
1656932125792,MATH 193A,A03,083781,Rotar; Vladimir,1,0,34,33
1656932125792,MATH 193A,A04,083782,Rotar; Vladimir,6,0,34,28
1656932125792,MATH 193A,A05,093482,Rotar; Vladimir,6,0,34,28
1656932131822,MATH 197,001,091859,McAuley; Julian John,9999,0,9999,0
1656932131822,MATH 197,002,095566,Kedlaya; Kiran S.,9997,0,9999,2
1656932131822,MATH 197,003,095567,Xiao; Ming,9999,0,9999,0
1656932131822,MATH 197,004,095571,Perols; Johan Lars,9998,0,9999,1
1656932138893,COGS 9,A01,083615,Shannon; Kyle Michael,7,0,75,68
1656932144917,COGS 11,A01,083617,Boyle; Mary E. T.,19,0,48,29
1656932150943,COGS 13,A01,083071,Bastos; Amalia Pinkusfeld,9,0,71,62
1656932156966,COGS 14A,A01,092681,Semenuks; Arturs,0,1,100,100
1656932162990,COGS 14B,A01,083073,Cheng; Tzu-Han,5,0,63,58
1656932169020,COGS 17,A01,092677,Semenuks; Arturs,4,0,81,77
1656932175049,COGS 100,A01,083619,Allen; Michael Gordon,15,0,70,55
1656932181076,COGS 101A,A01,083621,Davis; Joshua Daniel,9,0,68,59
1656932187100,COGS 101B,A01,091572,Allen; Michael Gordon,8,0,65,57
1656932193128,COGS 101C,A01,083625,Delgado; Tania,17,0,35,18
1656932199153,COGS 107A,A01,083627,Boyle; Mary E. T.,13,0,60,47
1656932205179,COGS 118A,A01,083075,Gupta; Anjum,15,0,76,61
1656932211210,CSE 3,A50,083646,Miranda; Gregory Joseph,22,0,50,28
1656932217234,CSE 8A,A50,083650,Miranda; Gregory Joseph,17,1,56,39
1656932223262,CSE 11,A01,083080,Cao; Yingjun,4,15,40,36
1656932229289,CSE 12,A01,083652,Krause-Levy; Sophia Louisa,20,1,120,100
1656932235312,CSE 15L,A01,083654,Morris; Justin Loren,8,0,50,42
1656932235312,CSE 15L,A02,083655,Morris; Justin Loren,8,0,50,42
1656932241343,CSE 20,A01,083657,Tran; Khoa Dang,37,0,80,43
1656932247373,CSE 21,A01,095574,Bach; Quang Tran,21,0,48,27
1656932253403,CSE 30,A01,083084,Eldon; John,4,0,80,76
1656932253403,CSE 30,B01,095061,Bhaskar; Nishant,6,0,50,44
1656932259427,CSE 100,A01,083659,Cao; Yingjun,3,4,70,67
1656932265457,CSE 134B,A01,083661,Powell; Thomas Allan,19,0,100,81
1656932271485,CSE 140,A01,083663,Gungor; Onat,14,0,85,71
1656932277513,CSE 140L,A01,083088,Eldon; John,16,0,100,84
1656932283537,CSE 175,A01,083665,Kumar; Rakesh,3,0,25,22
1656932289563,CSE 190,A00,092507,Dubnov; Shlomo,7,0,20,13
1656932295595,ECE 45,A01,083139,Congero; Spencer William,5,0,75,70
1656932301630,ECE 65,A50,083695,Saad; Andrew S,12,0,30,18
1656932301630,ECE 65,A51,095125,Saad; Andrew S,25,0,26,1
1656932307656,ECE 109,A01,091882,Touri; Behrouz,16,0,70,54
1656932313686,ECE 180,A00,083140,Abi Samra; Nicholas Camill,0,0,30,30
1656932313686,ECE 180,B00,083141,Abi Samra; Nicholas Camill,0,0,30,30
1656932319718,MATH 10A,A01,083735,Patchell; Gregory David,1,0,30,29
1656932319718,MATH 10A,A02,083736,Patchell; Gregory David,20,0,30,10
1656932319718,MATH 10A,A03,083737,Patchell; Gregory David,15,0,30,15
1656932325756,MATH 10B,A01,083207,Lim; Seonhee,7,0,34,27
1656932325756,MATH 10B,A02,083208,Lim; Seonhee,9,0,35,26
1656932325756,MATH 10B,A03,093472,Lim; Seonhee,4,0,34,30
1656932325756,MATH 10B,B01,083739,Sinha; Shubham,9,0,30,21
1656932331798,MATH 18,A01,083743,Cinel; Cameron Alexander,6,0,30,24
1656932331798,MATH 18,A02,083744,Cinel; Cameron Alexander,15,0,30,15
1656932331798,MATH 18,A03,083745,Cinel; Cameron Alexander,8,0,30,22
1656932331798,MATH 18,B01,083748,Rideout; David Porter,4,0,37,33
1656932331798,MATH 18,B02,083749,Rideout; David Porter,3,0,36,33
1656932331798,MATH 18,B03,083750,Rideout; David Porter,2,0,37,35
1656932331798,MATH 18,B04,083751,Rideout; David Porter,5,0,36,31
1656932331798,MATH 18,B05,093473,Rideout; David Porter,4,0,36,32
1656932331798,MATH 18,B06,093474,Rideout; David Porter,5,0,36,31
1656932337820,MATH 20A,A01,083754,Zheng; Zequn,12,0,40,28
1656932343851,MATH 20B,A01,083756,Briones; Jor-el Thomas Caparas,1,0,36,35
1656932343851,MATH 20B,A02,083757,Briones; Jor-el Thomas Caparas,1,0,36,35
1656932343851,MATH 20B,A03,093475,Briones; Jor-el Thomas Caparas,0,0,36,36
1656932349876,MATH 20C,A01,083760,Briones; Jor-el Thomas Caparas,1,0,35,34
1656932349876,MATH 20C,A02,083761,Briones; Jor-el Thomas Caparas,8,0,35,27
1656932349876,MATH 20C,A03,093476,Briones; Jor-el Thomas Caparas,0,1,36,36
1656932349876,MATH 20C,B01,083762,Bach; Quang Tran,0,0,30,30
1656932355901,MATH 20D,A01,083765,Tran; Brian Kha,4,0,30,26
1656932355901,MATH 20D,A02,083766,Tran; Brian Kha,4,0,30,26
1656932355901,MATH 20D,A03,083767,Tran; Brian Kha,3,0,30,27
1656932361944,MATH 20E,A01,083771,Ganguly; Soumya,5,0,32,27
1656932361944,MATH 20E,A02,083772,Ganguly; Soumya,6,0,32,26
1656932361944,MATH 20E,B01,083773,Ciotti; Benjamin,18,0,35,17
1656932361944,MATH 20E,B02,083774,Ciotti; Benjamin,17,0,35,18
1656932367977,MATH 103A,A01,083777,Greenfeld; Be'Eri,2,0,36,34
1656932367977,MATH 103A,A02,083778,Greenfeld; Be'Eri,5,0,36,31
1656932367977,MATH 103A,A03,093561,Greenfeld; Be'Eri,4,0,36,32
1656932367977,MATH 103A,B01,083779,Greenfeld; Be'Eri,6,0,36,30
1656932367977,MATH 103A,B02,083780,Greenfeld; Be'Eri,2,0,36,34
1656932367977,MATH 103A,B03,093562,Greenfeld; Be'Eri,2,0,36,34
1656932374004,MATH 105,A01,085443,Carter; Anne Toulson,13,0,35,22
1656932374004,MATH 105,A02,093477,Carter; Anne Toulson,20,0,35,15
1656932380034,MATH 109,A01,083213,Ganzberger; Geoffrey Michael,2,0,34,32
1656932380034,MATH 109,A02,083214,Ganzberger; Geoffrey Michael,2,0,34,32
1656932380034,MATH 109,A03,093478,Ganzberger; Geoffrey Michael,1,0,34,33
1656932380034,MATH 109,B01,083215,Ganzberger; Geoffrey Michael,1,0,32,31
1656932380034,MATH 109,B02,083216,Ganzberger; Geoffrey Michael,1,0,32,31
1656932380034,MATH 109,B03,093479,Ganzberger; Geoffrey Michael,6,0,32,26
1656932386059,MATH 142A,A01,083219,Chow; Bennett,6,0,32,26
1656932386059,MATH 142A,A02,083220,Chow; Bennett,10,0,32,22
1656932386059,MATH 142A,A03,093480,Chow; Bennett,7,0,32,25
1656932386059,MATH 142A,B03,093481,Chow; Bennett,7,0,32,25
1656932386059,MATH 142A,B04,093558,Chow; Bennett,11,0,32,21
1656932386059,MATH 142A,B05,093559,Chow; Bennett,6,0,32,26
1656932392084,MATH 193A,A01,083224,Rotar; Vladimir,7,0,34,27
1656932392084,MATH 193A,A02,083225,Rotar; Vladimir,3,0,34,31
1656932392084,MATH 193A,A03,083781,Rotar; Vladimir,1,0,34,33
1656932392084,MATH 193A,A04,083782,Rotar; Vladimir,6,0,34,28
1656932392084,MATH 193A,A05,093482,Rotar; Vladimir,6,0,34,28
1656932398109,MATH 197,001,091859,McAuley; Julian John,9999,0,9999,0
1656932398109,MATH 197,002,095566,Kedlaya; Kiran S.,9997,0,9999,2
1656932398109,MATH 197,003,095567,Xiao; Ming,9999,0,9999,0
1656932398109,MATH 197,004,095571,Perols; Johan Lars,9998,0,9999,1
1656932405169,COGS 9,A01,083615,Shannon; Kyle Michael,7,0,75,68
1656932411197,COGS 11,A01,083617,Boyle; Mary E. T.,19,0,48,29
1656932417222,COGS 13,A01,083071,Bastos; Amalia Pinkusfeld,9,0,71,62
1656932423245,COGS 14A,A01,092681,Semenuks; Arturs,0,1,100,100
1656932429277,COGS 14B,A01,083073,Cheng; Tzu-Han,5,0,63,58
1656932435299,COGS 17,A01,092677,Semenuks; Arturs,4,0,81,77
1656932441323,COGS 100,A01,083619,Allen; Michael Gordon,15,0,70,55
1656932447357,COGS 101A,A01,083621,Davis; Joshua Daniel,9,0,68,59
1656932453385,COGS 101B,A01,091572,Allen; Michael Gordon,8,0,65,57
1656932459419,COGS 101C,A01,083625,Delgado; Tania,17,0,35,18
1656932465449,COGS 107A,A01,083627,Boyle; Mary E. T.,13,0,60,47
1656932471472,COGS 118A,A01,083075,Gupta; Anjum,15,0,76,61
1656932477509,CSE 3,A50,083646,Miranda; Gregory Joseph,22,0,50,28
1656932483538,CSE 8A,A50,083650,Miranda; Gregory Joseph,17,1,56,39
1656932489564,CSE 11,A01,083080,Cao; Yingjun,4,15,40,36
1656932495588,CSE 12,A01,083652,Krause-Levy; Sophia Louisa,20,1,120,100
1656932501613,CSE 15L,A01,083654,Morris; Justin Loren,8,0,50,42
1656932501613,CSE 15L,A02,083655,Morris; Justin Loren,8,0,50,42
1656932507644,CSE 20,A01,083657,Tran; Khoa Dang,37,0,80,43
1656932513668,CSE 21,A01,095574,Bach; Quang Tran,21,0,48,27
1656932519699,CSE 30,A01,083084,Eldon; John,4,0,80,76
1656932519699,CSE 30,B01,095061,Bhaskar; Nishant,6,0,50,44
1656932525722,CSE 100,A01,083659,Cao; Yingjun,3,4,70,67
1656932531749,CSE 134B,A01,083661,Powell; Thomas Allan,19,0,100,81
1656932537774,CSE 140,A01,083663,Gungor; Onat,14,0,85,71
1656932543797,CSE 140L,A01,083088,Eldon; John,16,0,100,84
1656932549819,CSE 175,A01,083665,Kumar; Rakesh,3,0,25,22
1656932555841,CSE 190,A00,092507,Dubnov; Shlomo,7,0,20,13
1656932561873,ECE 45,A01,083139,Congero; Spencer William,5,0,75,70
1656932567898,ECE 65,A50,083695,Saad; Andrew S,12,0,30,18
1656932567898,ECE 65,A51,095125,Saad; Andrew S,25,0,26,1
1656932573921,ECE 109,A01,091882,Touri; Behrouz,16,0,70,54
1656932580026,ECE 180,A00,083140,Abi Samra; Nicholas Camill,0,0,30,30
1656932580026,ECE 180,B00,083141,Abi Samra; Nicholas Camill,0,0,30,30
1656932586062,MATH 10A,A01,083735,Patchell; Gregory David,1,0,30,29
1656932586062,MATH 10A,A02,083736,Patchell; Gregory David,20,0,30,10
1656932586062,MATH 10A,A03,083737,Patchell; Gregory David,15,0,30,15
1656932592089,MATH 10B,A01,083207,Lim; Seonhee,7,0,34,27
1656932592089,MATH 10B,A02,083208,Lim; Seonhee,9,0,35,26
1656932592089,MATH 10B,A03,093472,Lim; Seonhee,4,0,34,30
1656932592089,MATH 10B,B01,083739,Sinha; Shubham,9,0,30,21
1656932598118,MATH 18,A01,083743,Cinel; Cameron Alexander,6,0,30,24
1656932598118,MATH 18,A02,083744,Cinel; Cameron Alexander,15,0,30,15
1656932598118,MATH 18,A03,083745,Cinel; Cameron Alexander,8,0,30,22
1656932598118,MATH 18,B01,083748,Rideout; David Porter,4,0,37,33
1656932598118,MATH 18,B02,083749,Rideout; David Porter,3,0,36,33
1656932598118,MATH 18,B03,083750,Rideout; David Porter,2,0,37,35
1656932598118,MATH 18,B04,083751,Rideout; David Porter,5,0,36,31
1656932598118,MATH 18,B05,093473,Rideout; David Porter,4,0,36,32
1656932598118,MATH 18,B06,093474,Rideout; David Porter,5,0,36,31
1656932604148,MATH 20A,A01,083754,Zheng; Zequn,12,0,40,28
1656932610202,MATH 20B,A01,083756,Briones; Jor-el Thomas Caparas,1,0,36,35
1656932610202,MATH 20B,A02,083757,Briones; Jor-el Thomas Caparas,1,0,36,35
1656932610202,MATH 20B,A03,093475,Briones; Jor-el Thomas Caparas,0,0,36,36
1656932616228,MATH 20C,A01,083760,Briones; Jor-el Thomas Caparas,1,0,35,34
1656932616228,MATH 20C,A02,083761,Briones; Jor-el Thomas Caparas,8,0,35,27
1656932616228,MATH 20C,A03,093476,Briones; Jor-el Thomas Caparas,0,1,36,36
1656932616228,MATH 20C,B01,083762,Bach; Quang Tran,0,0,30,30
1656932622256,MATH 20D,A01,083765,Tran; Brian Kha,4,0,30,26
1656932622256,MATH 20D,A02,083766,Tran; Brian Kha,4,0,30,26
1656932622256,MATH 20D,A03,083767,Tran; Brian Kha,3,0,30,27
1656932628280,MATH 20E,A01,083771,Ganguly; Soumya,5,0,32,27
1656932628280,MATH 20E,A02,083772,Ganguly; Soumya,6,0,32,26
1656932628280,MATH 20E,B01,083773,Ciotti; Benjamin,18,0,35,17
1656932628280,MATH 20E,B02,083774,Ciotti; Benjamin,17,0,35,18
1656932634308,MATH 103A,A01,083777,Greenfeld; Be'Eri,2,0,36,34
1656932634308,MATH 103A,A02,083778,Greenfeld; Be'Eri,5,0,36,31
1656932634308,MATH 103A,A03,093561,Greenfeld; Be'Eri,4,0,36,32
1656932634308,MATH 103A,B01,083779,Greenfeld; Be'Eri,6,0,36,30
1656932634308,MATH 103A,B02,083780,Greenfeld; Be'Eri,2,0,36,34
1656932634308,MATH 103A,B03,093562,Greenfeld; Be'Eri,2,0,36,34
1656932640334,MATH 105,A01,085443,Carter; Anne Toulson,13,0,35,22
1656932640334,MATH 105,A02,093477,Carter; Anne Toulson,20,0,35,15
1656932646359,MATH 109,A01,083213,Ganzberger; Geoffrey Michael,2,0,34,32
1656932646359,MATH 109,A02,083214,Ganzberger; Geoffrey Michael,2,0,34,32
1656932646359,MATH 109,A03,093478,Ganzberger; Geoffrey Michael,1,0,34,33
1656932646359,MATH 109,B01,083215,Ganzberger; Geoffrey Michael,1,0,32,31
1656932646359,MATH 109,B02,083216,Ganzberger; Geoffrey Michael,1,0,32,31
1656932646359,MATH 109,B03,093479,Ganzberger; Geoffrey Michael,6,0,32,26
1656932652385,MATH 142A,A01,083219,Chow; Bennett,6,0,32,26
1656932652385,MATH 142A,A02,083220,Chow; Bennett,10,0,32,22
1656932652385,MATH 142A,A03,093480,Chow; Bennett,7,0,32,25
1656932652385,MATH 142A,B03,093481,Chow; Bennett,7,0,32,25
1656932652385,MATH 142A,B04,093558,Chow; Bennett,11,0,32,21
1656932652385,MATH 142A,B05,093559,Chow; Bennett,6,0,32,26
1656932658411,MATH 193A,A01,083224,Rotar; Vladimir,7,0,34,27
1656932658411,MATH 193A,A02,083225,Rotar; Vladimir,3,0,34,31
1656932658411,MATH 193A,A03,083781,Rotar; Vladimir,1,0,34,33
1656932658411,MATH 193A,A04,083782,Rotar; Vladimir,6,0,34,28
1656932658411,MATH 193A,A05,093482,Rotar; Vladimir,6,0,34,28
1656932664440,MATH 197,001,091859,McAuley; Julian John,9999,0,9999,0
1656932664440,MATH 197,002,095566,Kedlaya; Kiran S.,9997,0,9999,2
1656932664440,MATH 197,003,095567,Xiao; Ming,9999,0,9999,0
1656932664440,MATH 197,004,095571,Perols; Johan Lars,9998,0,9999,1
1656932671512,COGS 9,A01,083615,Shannon; Kyle Michael,7,0,75,68
1656932677536,COGS 11,A01,083617,Boyle; Mary E. T.,19,0,48,29
1656932683565,COGS 13,A01,083071,Bastos; Amalia Pinkusfeld,9,0,71,62
1656932689595,COGS 14A,A01,092681,Semenuks; Arturs,0,1,100,100
1656932695622,COGS 14B,A01,083073,Cheng; Tzu-Han,5,0,63,58
1656932701646,COGS 17,A01,092677,Semenuks; Arturs,4,0,81,77
1656932707673,COGS 100,A01,083619,Allen; Michael Gordon,15,0,70,55
1656932713696,COGS 101A,A01,083621,Davis; Joshua Daniel,9,0,68,59
1656932719726,COGS 101B,A01,091572,Allen; Michael Gordon,8,0,65,57
1656932725753,COGS 101C,A01,083625,Delgado; Tania,17,0,35,18
1656932731776,COGS 107A,A01,083627,Boyle; Mary E. T.,13,0,60,47
1656932737801,COGS 118A,A01,083075,Gupta; Anjum,15,0,76,61
1656932743834,CSE 3,A50,083646,Miranda; Gregory Joseph,22,0,50,28
1656932749862,CSE 8A,A50,083650,Miranda; Gregory Joseph,17,1,56,39
1656932755891,CSE 11,A01,083080,Cao; Yingjun,4,15,40,36
1656932761914,CSE 12,A01,083652,Krause-Levy; Sophia Louisa,20,1,120,100
1656932767944,CSE 15L,A01,083654,Morris; Justin Loren,8,0,50,42
1656932767944,CSE 15L,A02,083655,Morris; Justin Loren,8,0,50,42
1656932773968,CSE 20,A01,083657,Tran; Khoa Dang,37,0,80,43
1656932779993,CSE 21,A01,095574,Bach; Quang Tran,21,0,48,27
1656932786026,CSE 30,A01,083084,Eldon; John,4,0,80,76
1656932786026,CSE 30,B01,095061,Bhaskar; Nishant,6,0,50,44
1656932792051,CSE 100,A01,083659,Cao; Yingjun,3,4,70,67
1656932798074,CSE 134B,A01,083661,Powell; Thomas Allan,19,0,100,81
1656932804107,CSE 140,A01,083663,Gungor; Onat,14,0,85,71
1656932810129,CSE 140L,A01,083088,Eldon; John,16,0,100,84
1656932816154,CSE 175,A01,083665,Kumar; Rakesh,3,0,25,22
1656932822178,CSE 190,A00,092507,Dubnov; Shlomo,7,0,20,13
1656932828204,ECE 45,A01,083139,Congero; Spencer William,5,0,75,70
1656932834231,ECE 65,A50,083695,Saad; Andrew S,12,0,30,18
1656932834231,ECE 65,A51,095125,Saad; Andrew S,25,0,26,1
1656932840260,ECE 109,A01,091882,Touri; Behrouz,16,0,70,54
1656932846288,ECE 180,A00,083140,Abi Samra; Nicholas Camill,0,0,30,30
1656932846288,ECE 180,B00,083141,Abi Samra; Nicholas Camill,0,0,30,30
1656932852315,MATH 10A,A01,083735,Patchell; Gregory David,1,0,30,29
1656932852315,MATH 10A,A02,083736,Patchell; Gregory David,20,0,30,10
1656932852315,MATH 10A,A03,083737,Patchell; Gregory David,15,0,30,15
1656932858342,MATH 10B,A01,083207,Lim; Seonhee,7,0,34,27
1656932858342,MATH 10B,A02,083208,Lim; Seonhee,9,0,35,26
1656932858342,MATH 10B,A03,093472,Lim; Seonhee,4,0,34,30
1656932858342,MATH 10B,B01,083739,Sinha; Shubham,9,0,30,21
1656932864385,MATH 18,A01,083743,Cinel; Cameron Alexander,6,0,30,24
1656932864385,MATH 18,A02,083744,Cinel; Cameron Alexander,15,0,30,15
1656932864385,MATH 18,A03,083745,Cinel; Cameron Alexander,8,0,30,22
1656932864385,MATH 18,B01,083748,Rideout; David Porter,4,0,37,33
1656932864385,MATH 18,B02,083749,Rideout; David Porter,3,0,36,33
1656932864385,MATH 18,B03,083750,Rideout; David Porter,2,0,37,35
1656932864385,MATH 18,B04,083751,Rideout; David Porter,5,0,36,31
1656932864385,MATH 18,B05,093473,Rideout; David Porter,4,0,36,32
1656932864385,MATH 18,B06,093474,Rideout; David Porter,5,0,36,31
1656932870413,MATH 20A,A01,083754,Zheng; Zequn,12,0,40,28
1656932876438,MATH 20B,A01,083756,Briones; Jor-el Thomas Caparas,1,0,36,35
1656932876438,MATH 20B,A02,083757,Briones; Jor-el Thomas Caparas,1,0,36,35
1656932876438,MATH 20B,A03,093475,Briones; Jor-el Thomas Caparas,0,0,36,36
1656932882468,MATH 20C,A01,083760,Briones; Jor-el Thomas Caparas,1,0,35,34
1656932882468,MATH 20C,A02,083761,Briones; Jor-el Thomas Caparas,8,0,35,27
1656932882468,MATH 20C,A03,093476,Briones; Jor-el Thomas Caparas,0,1,36,36
1656932882468,MATH 20C,B01,083762,Bach; Quang Tran,0,0,30,30
1656932888492,MATH 20D,A01,083765,Tran; Brian Kha,4,0,30,26
1656932888492,MATH 20D,A02,083766,Tran; Brian Kha,4,0,30,26
1656932888492,MATH 20D,A03,083767,Tran; Brian Kha,3,0,30,27
1656932894517,MATH 20E,A01,083771,Ganguly; Soumya,5,0,32,27
1656932894517,MATH 20E,A02,083772,Ganguly; Soumya,6,0,32,26
1656932894517,MATH 20E,B01,083773,Ciotti; Benjamin,18,0,35,17
1656932894517,MATH 20E,B02,083774,Ciotti; Benjamin,17,0,35,18
1656932900553,MATH 103A,A01,083777,Greenfeld; Be'Eri,2,0,36,34
1656932900553,MATH 103A,A02,083778,Greenfeld; Be'Eri,5,0,36,31
1656932900553,MATH 103A,A03,093561,Greenfeld; Be'Eri,4,0,36,32
1656932900553,MATH 103A,B01,083779,Greenfeld; Be'Eri,6,0,36,30
1656932900553,MATH 103A,B02,083780,Greenfeld; Be'Eri,2,0,36,34
1656932900553,MATH 103A,B03,093562,Greenfeld; Be'Eri,2,0,36,34
1656932906585,MATH 105,A01,085443,Carter; Anne Toulson,13,0,35,22
1656932906585,MATH 105,A02,093477,Carter; Anne Toulson,20,0,35,15
1656932912624,MATH 109,A01,083213,Ganzberger; Geoffrey Michael,2,0,34,32
1656932912624,MATH 109,A02,083214,Ganzberger; Geoffrey Michael,2,0,34,32
1656932912624,MATH 109,A03,093478,Ganzberger; Geoffrey Michael,1,0,34,33
1656932912624,MATH 109,B01,083215,Ganzberger; Geoffrey Michael,1,0,32,31
1656932912624,MATH 109,B02,083216,Ganzberger; Geoffrey Michael,1,0,32,31
1656932912624,MATH 109,B03,093479,Ganzberger; Geoffrey Michael,6,0,32,26
1656932918658,MATH 142A,A01,083219,Chow; Bennett,6,0,32,26
1656932918658,MATH 142A,A02,083220,Chow; Bennett,10,0,32,22
1656932918658,MATH 142A,A03,093480,Chow; Bennett,7,0,32,25
1656932918658,MATH 142A,B03,093481,Chow; Bennett,7,0,32,25
1656932918658,MATH 142A,B04,093558,Chow; Bennett,11,0,32,21
1656932918658,MATH 142A,B05,093559,Chow; Bennett,6,0,32,26
1656932924682,MATH 193A,A01,083224,Rotar; Vladimir,7,0,34,27
1656932924682,MATH 193A,A02,083225,Rotar; Vladimir,3,0,34,31
1656932924682,MATH 193A,A03,083781,Rotar; Vladimir,1,0,34,33
1656932924682,MATH 193A,A04,083782,Rotar; Vladimir,6,0,34,28
1656932924682,MATH 193A,A05,093482,Rotar; Vladimir,6,0,34,28
1656932930714,MATH 197,001,091859,McAuley; Julian John,9999,0,9999,0
1656932930714,MATH 197,002,095566,Kedlaya; Kiran S.,9997,0,9999,2
1656932930714,MATH 197,003,095567,Xiao; Ming,9999,0,9999,0
1656932930714,MATH 197,004,095571,Perols; Johan Lars,9998,0,9999,1
1656932937784,COGS 9,A01,083615,Shannon; Kyle Michael,7,0,75,68
1656932943815,COGS 11,A01,083617,Boyle; Mary E. T.,19,0,48,29
1656932949841,COGS 13,A01,083071,Bastos; Amalia Pinkusfeld,9,0,71,62
1656932955882,COGS 14A,A01,092681,Semenuks; Arturs,0,1,100,100
1656932961907,COGS 14B,A01,083073,Cheng; Tzu-Han,5,0,63,58
1656932967933,COGS 17,A01,092677,Semenuks; Arturs,4,0,81,77
1656932973958,COGS 100,A01,083619,Allen; Michael Gordon,15,0,70,55
1656932979981,COGS 101A,A01,083621,Davis; Joshua Daniel,9,0,68,59
1656932986006,COGS 101B,A01,091572,Allen; Michael Gordon,8,0,65,57
1656932992041,COGS 101C,A01,083625,Delgado; Tania,17,0,35,18
1656932998067,COGS 107A,A01,083627,Boyle; Mary E. T.,13,0,60,47
1656933004091,COGS 118A,A01,083075,Gupta; Anjum,15,0,76,61
1656933010128,CSE 3,A50,083646,Miranda; Gregory Joseph,22,0,50,28
1656933016158,CSE 8A,A50,083650,Miranda; Gregory Joseph,17,1,56,39
1656933022183,CSE 11,A01,083080,Cao; Yingjun,4,15,40,36
1656933028212,CSE 12,A01,083652,Krause-Levy; Sophia Louisa,20,1,120,100
1656933034236,CSE 15L,A01,083654,Morris; Justin Loren,8,0,50,42
1656933034236,CSE 15L,A02,083655,Morris; Justin Loren,8,0,50,42
1656933040264,CSE 20,A01,083657,Tran; Khoa Dang,37,0,80,43
1656933046288,CSE 21,A01,095574,Bach; Quang Tran,21,0,48,27
1656933052313,CSE 30,A01,083084,Eldon; John,4,0,80,76
1656933052313,CSE 30,B01,095061,Bhaskar; Nishant,6,0,50,44
1656933058344,CSE 100,A01,083659,Cao; Yingjun,3,4,70,67
1656933064369,CSE 134B,A01,083661,Powell; Thomas Allan,19,0,100,81
1656933070396,CSE 140,A01,083663,Gungor; Onat,14,0,85,71
1656933076418,CSE 140L,A01,083088,Eldon; John,16,0,100,84
1656933082443,CSE 175,A01,083665,Kumar; Rakesh,3,0,25,22
1656933088468,CSE 190,A00,092507,Dubnov; Shlomo,7,0,20,13
1656933094492,ECE 45,A01,083139,Congero; Spencer William,5,0,75,70
1656933100518,ECE 65,A50,083695,Saad; Andrew S,12,0,30,18
1656933100518,ECE 65,A51,095125,Saad; Andrew S,25,0,26,1
1656933106549,ECE 109,A01,091882,Touri; Behrouz,16,0,70,54
1656933112572,ECE 180,A00,083140,Abi Samra; Nicholas Camill,0,0,30,30
1656933112572,ECE 180,B00,083141,Abi Samra; Nicholas Camill,0,0,30,30
1656933118607,MATH 10A,A01,083735,Patchell; Gregory David,1,0,30,29
1656933118607,MATH 10A,A02,083736,Patchell; Gregory David,20,0,30,10
1656933118607,MATH 10A,A03,083737,Patchell; Gregory David,15,0,30,15
1656933124636,MATH 10B,A01,083207,Lim; Seonhee,7,0,34,27
1656933124636,MATH 10B,A02,083208,Lim; Seonhee,9,0,35,26
1656933124636,MATH 10B,A03,093472,Lim; Seonhee,4,0,34,30
1656933124636,MATH 10B,B01,083739,Sinha; Shubham,9,0,30,21
1656933130663,MATH 18,A01,083743,Cinel; Cameron Alexander,6,0,30,24
1656933130663,MATH 18,A02,083744,Cinel; Cameron Alexander,15,0,30,15
1656933130663,MATH 18,A03,083745,Cinel; Cameron Alexander,8,0,30,22
1656933130663,MATH 18,B01,083748,Rideout; David Porter,4,0,37,33
1656933130663,MATH 18,B02,083749,Rideout; David Porter,3,0,36,33
1656933130663,MATH 18,B03,083750,Rideout; David Porter,2,0,37,35
1656933130663,MATH 18,B04,083751,Rideout; David Porter,5,0,36,31
1656933130663,MATH 18,B05,093473,Rideout; David Porter,4,0,36,32
1656933130663,MATH 18,B06,093474,Rideout; David Porter,5,0,36,31
1656933136686,MATH 20A,A01,083754,Zheng; Zequn,12,0,40,28
1656933142710,MATH 20B,A01,083756,Briones; Jor-el Thomas Caparas,1,0,36,35
1656933142710,MATH 20B,A02,083757,Briones; Jor-el Thomas Caparas,1,0,36,35
1656933142710,MATH 20B,A03,093475,Briones; Jor-el Thomas Caparas,0,0,36,36
1656933148735,MATH 20C,A01,083760,Briones; Jor-el Thomas Caparas,1,0,35,34
1656933148735,MATH 20C,A02,083761,Briones; Jor-el Thomas Caparas,8,0,35,27
1656933148735,MATH 20C,A03,093476,Briones; Jor-el Thomas Caparas,0,1,36,36
1656933148735,MATH 20C,B01,083762,Bach; Quang Tran,0,0,30,30
1656933154759,MATH 20D,A01,083765,Tran; Brian Kha,4,0,30,26
1656933154759,MATH 20D,A02,083766,Tran; Brian Kha,4,0,30,26
1656933154759,MATH 20D,A03,083767,Tran; Brian Kha,3,0,30,27
1656933160785,MATH 20E,A01,083771,Ganguly; Soumya,5,0,32,27
1656933160785,MATH 20E,A02,083772,Ganguly; Soumya,6,0,32,26
1656933160785,MATH 20E,B01,083773,Ciotti; Benjamin,18,0,35,17
1656933160785,MATH 20E,B02,083774,Ciotti; Benjamin,17,0,35,18
1656933166813,MATH 103A,A01,083777,Greenfeld; Be'Eri,2,0,36,34
1656933166813,MATH 103A,A02,083778,Greenfeld; Be'Eri,5,0,36,31
1656933166813,MATH 103A,A03,093561,Greenfeld; Be'Eri,4,0,36,32
1656933166813,MATH 103A,B01,083779,Greenfeld; Be'Eri,6,0,36,30
1656933166813,MATH 103A,B02,083780,Greenfeld; Be'Eri,2,0,36,34
1656933166813,MATH 103A,B03,093562,Greenfeld; Be'Eri,2,0,36,34
