time,subj_course_id,sec_code,sec_id,prof,available,waitlist,total,enrolled_ct
1657798388548,COGS 9,A01,083615,Shannon; Kyle Michael,9,0,75,66
1657798394579,COGS 11,A01,083617,Boyle; Mary E. T.,23,0,48,25
1657798400615,COGS 13,A01,083071,Bastos; Amalia Pinkusfeld,11,0,71,60
1657798406655,COGS 14A,A01,092681,Semenuks; Arturs,5,1,100,95
1657798412693,COGS 14B,A01,083073,Cheng; Tzu-Han,6,0,63,57
1657798418722,COGS 17,A01,092677,Semenuks; Arturs,6,0,81,75
1657798424754,COGS 100,A01,083619,Allen; Michael Gordon,17,0,70,53
1657798430785,COGS 101A,A01,083621,Davis; Joshua Daniel,9,0,68,59
1657798436825,COGS 101B,A01,091572,Allen; Michael Gordon,12,0,65,53
1657798442857,COGS 101C,A01,083625,Delgado; Tania,17,0,35,18
1657798448890,COGS 107A,A01,083627,Boyle; Mary E. T.,14,0,60,46
1657798454927,COGS 118A,A01,083075,Gupta; Anjum,21,0,76,55
1657798460964,CSE 3,A50,083646,Miranda; Gregory Joseph,24,0,50,26
1657798466991,CSE 8A,A50,083650,Miranda; Gregory Joseph,17,1,56,39
1657798473027,CSE 11,A01,083080,Cao; Yingjun,6,15,40,34
1657798479079,CSE 12,A01,083652,Krause-Levy; Sophia Louisa,28,1,120,92
1657798485116,CSE 15L,A01,083654,Morris; Justin Loren,9,0,50,41
1657798485116,CSE 15L,A02,083655,Morris; Justin Loren,9,0,50,41
1657798491145,CSE 20,A01,083657,Tran; Khoa Dang,39,0,80,41
1657798497179,CSE 21,A01,095574,Bach; Quang Tran,22,0,48,26
1657798503216,CSE 30,A01,083084,Eldon; John,6,0,80,74
1657798503216,CSE 30,B01,095061,Bhaskar; Nishant,9,0,50,41
1657798509249,CSE 100,A01,083659,Cao; Yingjun,5,4,70,65
1657798515279,CSE 134B,A01,083661,Powell; Thomas Allan,24,0,100,76
1657798521314,CSE 140,A01,083663,Gungor; Onat,15,0,85,70
1657798527343,CSE 140L,A01,083088,Eldon; John,23,0,100,77
1657798533373,CSE 175,A01,083665,Kumar; Rakesh,3,0,25,22
1657798539405,CSE 190,A00,092507,Dubnov; Shlomo,8,0,20,12
1657798545469,ECE 45,A01,083139,Congero; Spencer William,6,0,75,69
1657798551507,ECE 65,A50,083695,Saad; Andrew S,12,0,30,18
1657798551507,ECE 65,A51,095125,Saad; Andrew S,24,0,26,2
1657798557535,ECE 109,A01,091882,Touri; Behrouz,20,0,70,50
1657798563565,ECE 180,A00,083140,Abi Samra; Nicholas Camill,1,0,30,29
1657798563565,ECE 180,B00,083141,Abi Samra; Nicholas Camill,0,0,30,30
1657798569602,MATH 10A,A01,083735,Patchell; Gregory David,2,0,30,28
1657798569602,MATH 10A,A02,083736,Patchell; Gregory David,20,0,30,10
1657798569602,MATH 10A,A03,083737,Patchell; Gregory David,16,0,30,14
1657798575633,MATH 10B,A01,083207,Lim; Seonhee,8,0,34,26
1657798575633,MATH 10B,A02,083208,Lim; Seonhee,10,0,35,25
1657798575633,MATH 10B,A03,093472,Lim; Seonhee,7,0,34,27
1657798575633,MATH 10B,B01,083739,Sinha; Shubham,13,0,30,17
1657798581665,MATH 18,A01,083743,Cinel; Cameron Alexander,9,0,30,21
1657798581665,MATH 18,A02,083744,Cinel; Cameron Alexander,18,0,30,12
1657798581665,MATH 18,A03,083745,Cinel; Cameron Alexander,10,0,30,20
1657798581665,MATH 18,B01,083748,Rideout; David Porter,5,0,37,32
1657798581665,MATH 18,B02,083749,Rideout; David Porter,5,0,36,31
1657798581665,MATH 18,B03,083750,Rideout; David Porter,3,0,37,34
1657798581665,MATH 18,B04,083751,Rideout; David Porter,6,0,36,30
1657798581665,MATH 18,B05,093473,Rideout; David Porter,6,0,36,30
1657798581665,MATH 18,B06,093474,Rideout; David Porter,6,0,36,30
1657798587697,MATH 20A,A01,083754,Zheng; Zequn,14,0,40,26
1657798593735,MATH 20B,A01,083756,Briones; Jor-el Thomas Caparas,4,0,36,32
1657798593735,MATH 20B,A02,083757,Briones; Jor-el Thomas Caparas,1,0,36,35
1657798593735,MATH 20B,A03,093475,Briones; Jor-el Thomas Caparas,2,0,36,34
1657798599764,MATH 20C,A01,083760,Briones; Jor-el Thomas Caparas,1,0,35,34
1657798599764,MATH 20C,A02,083761,Briones; Jor-el Thomas Caparas,8,0,35,27
1657798599764,MATH 20C,A03,093476,Briones; Jor-el Thomas Caparas,0,1,36,36
1657798599764,MATH 20C,B01,083762,Bach; Quang Tran,1,0,30,29
1657798605791,MATH 20D,A01,083765,Tran; Brian Kha,5,0,30,25
1657798605791,MATH 20D,A02,083766,Tran; Brian Kha,5,0,30,25
1657798605791,MATH 20D,A03,083767,Tran; Brian Kha,5,0,30,25
1657798611832,MATH 20E,A01,083771,Ganguly; Soumya,10,0,32,22
1657798611832,MATH 20E,A02,083772,Ganguly; Soumya,6,0,32,26
1657798611832,MATH 20E,B01,083773,Ciotti; Benjamin,20,0,35,15
1657798611832,MATH 20E,B02,083774,Ciotti; Benjamin,18,0,35,17
1657798617877,MATH 103A,A01,083777,Greenfeld; Be'Eri,3,0,36,33
1657798617877,MATH 103A,A02,083778,Greenfeld; Be'Eri,5,0,36,31
1657798617877,MATH 103A,A03,093561,Greenfeld; Be'Eri,6,0,36,30
1657798617877,MATH 103A,B01,083779,Greenfeld; Be'Eri,7,0,36,29
1657798617877,MATH 103A,B02,083780,Greenfeld; Be'Eri,4,0,36,32
1657798617877,MATH 103A,B03,093562,Greenfeld; Be'Eri,3,0,36,33
1657798623911,MATH 105,A01,085443,Carter; Anne Toulson,15,0,35,20
1657798623911,MATH 105,A02,093477,Carter; Anne Toulson,20,0,35,15
1657798629941,MATH 109,A01,083213,Ganzberger; Geoffrey Michael,3,0,34,31
1657798629941,MATH 109,A02,083214,Ganzberger; Geoffrey Michael,4,0,34,30
1657798629941,MATH 109,A03,093478,Ganzberger; Geoffrey Michael,2,0,34,32
1657798629941,MATH 109,B01,083215,Ganzberger; Geoffrey Michael,1,0,32,31
1657798629941,MATH 109,B02,083216,Ganzberger; Geoffrey Michael,2,0,32,30
1657798629941,MATH 109,B03,093479,Ganzberger; Geoffrey Michael,8,0,32,24
1657798635982,MATH 142A,A01,083219,Chow; Bennett,7,0,32,25
1657798635982,MATH 142A,A02,083220,Chow; Bennett,10,0,32,22
1657798635982,MATH 142A,A03,093480,Chow; Bennett,9,0,32,23
1657798635982,MATH 142A,B03,093481,Chow; Bennett,8,0,32,24
1657798635982,MATH 142A,B04,093558,Chow; Bennett,13,0,32,19
1657798635982,MATH 142A,B05,093559,Chow; Bennett,6,0,32,26
1657798642013,MATH 193A,A01,083224,Rotar; Vladimir,8,0,34,26
1657798642013,MATH 193A,A02,083225,Rotar; Vladimir,9,0,34,25
1657798642013,MATH 193A,A03,083781,Rotar; Vladimir,5,0,34,29
1657798642013,MATH 193A,A04,083782,Rotar; Vladimir,10,0,34,24
1657798642013,MATH 193A,A05,093482,Rotar; Vladimir,10,0,34,24
1657798648052,MATH 197,001,091859,McAuley; Julian John,9999,0,9999,0
1657798648052,MATH 197,002,095566,Kedlaya; Kiran S.,9997,0,9999,2
1657798648052,MATH 197,003,095567,Xiao; Ming,9999,0,9999,0
1657798648052,MATH 197,004,095571,Perols; Johan Lars,9998,0,9999,1
1657798655169,COGS 9,A01,083615,Shannon; Kyle Michael,9,0,75,66
1657798661203,COGS 11,A01,083617,Boyle; Mary E. T.,23,0,48,25
1657798667231,COGS 13,A01,083071,Bastos; Amalia Pinkusfeld,11,0,71,60
1657798673262,COGS 14A,A01,092681,Semenuks; Arturs,5,1,100,95
1657798679290,COGS 14B,A01,083073,Cheng; Tzu-Han,6,0,63,57
1657798685323,COGS 17,A01,092677,Semenuks; Arturs,6,0,81,75
1657798691357,COGS 100,A01,083619,Allen; Michael Gordon,17,0,70,53
1657798697387,COGS 101A,A01,083621,Davis; Joshua Daniel,9,0,68,59
1657798703418,COGS 101B,A01,091572,Allen; Michael Gordon,12,0,65,53
1657798709446,COGS 101C,A01,083625,Delgado; Tania,17,0,35,18
1657798715473,COGS 107A,A01,083627,Boyle; Mary E. T.,14,0,60,46
1657798721500,COGS 118A,A01,083075,Gupta; Anjum,21,0,76,55
1657798727532,CSE 3,A50,083646,Miranda; Gregory Joseph,24,0,50,26
1657798733565,CSE 8A,A50,083650,Miranda; Gregory Joseph,17,1,56,39
1657798739598,CSE 11,A01,083080,Cao; Yingjun,6,15,40,34
1657798745626,CSE 12,A01,083652,Krause-Levy; Sophia Louisa,28,1,120,92
1657798751652,CSE 15L,A01,083654,Morris; Justin Loren,9,0,50,41
1657798751652,CSE 15L,A02,083655,Morris; Justin Loren,9,0,50,41
1657798757681,CSE 20,A01,083657,Tran; Khoa Dang,39,0,80,41
1657798763709,CSE 21,A01,095574,Bach; Quang Tran,22,0,48,26
1657798769760,CSE 30,A01,083084,Eldon; John,6,0,80,74
1657798769760,CSE 30,B01,095061,Bhaskar; Nishant,9,0,50,41
1657798775794,CSE 100,A01,083659,Cao; Yingjun,5,4,70,65
1657798781824,CSE 134B,A01,083661,Powell; Thomas Allan,24,0,100,76
1657798787857,CSE 140,A01,083663,Gungor; Onat,15,0,85,70
1657798793885,CSE 140L,A01,083088,Eldon; John,23,0,100,77
1657798799916,CSE 175,A01,083665,Kumar; Rakesh,3,0,25,22
1657798805942,CSE 190,A00,092507,Dubnov; Shlomo,8,0,20,12
1657798811970,ECE 45,A01,083139,Congero; Spencer William,6,0,75,69
1657798817997,ECE 65,A50,083695,Saad; Andrew S,12,0,30,18
1657798817997,ECE 65,A51,095125,Saad; Andrew S,24,0,26,2
1657798824024,ECE 109,A01,091882,Touri; Behrouz,20,0,70,50
1657798830056,ECE 180,A00,083140,Abi Samra; Nicholas Camill,1,0,30,29
1657798830056,ECE 180,B00,083141,Abi Samra; Nicholas Camill,0,0,30,30
1657798836085,MATH 10A,A01,083735,Patchell; Gregory David,2,0,30,28
1657798836085,MATH 10A,A02,083736,Patchell; Gregory David,20,0,30,10
1657798836085,MATH 10A,A03,083737,Patchell; Gregory David,16,0,30,14
1657798842126,MATH 10B,A01,083207,Lim; Seonhee,8,0,34,26
1657798842126,MATH 10B,A02,083208,Lim; Seonhee,10,0,35,25
1657798842126,MATH 10B,A03,093472,Lim; Seonhee,7,0,34,27
1657798842126,MATH 10B,B01,083739,Sinha; Shubham,13,0,30,17
1657798848170,MATH 18,A01,083743,Cinel; Cameron Alexander,9,0,30,21
1657798848170,MATH 18,A02,083744,Cinel; Cameron Alexander,18,0,30,12
1657798848170,MATH 18,A03,083745,Cinel; Cameron Alexander,10,0,30,20
1657798848170,MATH 18,B01,083748,Rideout; David Porter,5,0,37,32
1657798848170,MATH 18,B02,083749,Rideout; David Porter,5,0,36,31
1657798848170,MATH 18,B03,083750,Rideout; David Porter,3,0,37,34
1657798848170,MATH 18,B04,083751,Rideout; David Porter,6,0,36,30
1657798848170,MATH 18,B05,093473,Rideout; David Porter,6,0,36,30
1657798848170,MATH 18,B06,093474,Rideout; David Porter,6,0,36,30
1657798854196,MATH 20A,A01,083754,Zheng; Zequn,14,0,40,26
1657798860232,MATH 20B,A01,083756,Briones; Jor-el Thomas Caparas,4,0,36,32
1657798860232,MATH 20B,A02,083757,Briones; Jor-el Thomas Caparas,1,0,36,35
1657798860232,MATH 20B,A03,093475,Briones; Jor-el Thomas Caparas,2,0,36,34
1657798866267,MATH 20C,A01,083760,Briones; Jor-el Thomas Caparas,1,0,35,34
1657798866267,MATH 20C,A02,083761,Briones; Jor-el Thomas Caparas,8,0,35,27
1657798866267,MATH 20C,A03,093476,Briones; Jor-el Thomas Caparas,0,1,36,36
1657798866267,MATH 20C,B01,083762,Bach; Quang Tran,1,0,30,29
1657798872296,MATH 20D,A01,083765,Tran; Brian Kha,5,0,30,25
1657798872296,MATH 20D,A02,083766,Tran; Brian Kha,5,0,30,25
1657798872296,MATH 20D,A03,083767,Tran; Brian Kha,5,0,30,25
1657798878332,MATH 20E,A01,083771,Ganguly; Soumya,10,0,32,22
1657798878332,MATH 20E,A02,083772,Ganguly; Soumya,6,0,32,26
1657798878332,MATH 20E,B01,083773,Ciotti; Benjamin,20,0,35,15
1657798878332,MATH 20E,B02,083774,Ciotti; Benjamin,18,0,35,17
1657798884364,MATH 103A,A01,083777,Greenfeld; Be'Eri,3,0,36,33
1657798884364,MATH 103A,A02,083778,Greenfeld; Be'Eri,5,0,36,31
1657798884364,MATH 103A,A03,093561,Greenfeld; Be'Eri,6,0,36,30
1657798884364,MATH 103A,B01,083779,Greenfeld; Be'Eri,7,0,36,29
1657798884364,MATH 103A,B02,083780,Greenfeld; Be'Eri,4,0,36,32
1657798884364,MATH 103A,B03,093562,Greenfeld; Be'Eri,3,0,36,33
1657798890392,MATH 105,A01,085443,Carter; Anne Toulson,15,0,35,20
1657798890392,MATH 105,A02,093477,Carter; Anne Toulson,20,0,35,15
1657798896421,MATH 109,A01,083213,Ganzberger; Geoffrey Michael,3,0,34,31
1657798896421,MATH 109,A02,083214,Ganzberger; Geoffrey Michael,4,0,34,30
1657798896421,MATH 109,A03,093478,Ganzberger; Geoffrey Michael,2,0,34,32
1657798896421,MATH 109,B01,083215,Ganzberger; Geoffrey Michael,1,0,32,31
1657798896421,MATH 109,B02,083216,Ganzberger; Geoffrey Michael,2,0,32,30
1657798896421,MATH 109,B03,093479,Ganzberger; Geoffrey Michael,8,0,32,24
1657798902450,MATH 142A,A01,083219,Chow; Bennett,7,0,32,25
1657798902450,MATH 142A,A02,083220,Chow; Bennett,10,0,32,22
1657798902450,MATH 142A,A03,093480,Chow; Bennett,9,0,32,23
1657798902450,MATH 142A,B03,093481,Chow; Bennett,8,0,32,24
1657798902450,MATH 142A,B04,093558,Chow; Bennett,13,0,32,19
1657798902450,MATH 142A,B05,093559,Chow; Bennett,6,0,32,26
1657798908480,MATH 193A,A01,083224,Rotar; Vladimir,8,0,34,26
1657798908480,MATH 193A,A02,083225,Rotar; Vladimir,9,0,34,25
1657798908480,MATH 193A,A03,083781,Rotar; Vladimir,5,0,34,29
1657798908480,MATH 193A,A04,083782,Rotar; Vladimir,10,0,34,24
1657798908480,MATH 193A,A05,093482,Rotar; Vladimir,10,0,34,24
1657798914509,MATH 197,001,091859,McAuley; Julian John,9999,0,9999,0
1657798914509,MATH 197,002,095566,Kedlaya; Kiran S.,9997,0,9999,2
1657798914509,MATH 197,003,095567,Xiao; Ming,9999,0,9999,0
1657798914509,MATH 197,004,095571,Perols; Johan Lars,9998,0,9999,1
1657798921582,COGS 9,A01,083615,Shannon; Kyle Michael,9,0,75,66
1657798927606,COGS 11,A01,083617,Boyle; Mary E. T.,23,0,48,25
1657798933643,COGS 13,A01,083071,Bastos; Amalia Pinkusfeld,11,0,71,60
1657798939670,COGS 14A,A01,092681,Semenuks; Arturs,5,1,100,95
1657798945697,COGS 14B,A01,083073,Cheng; Tzu-Han,6,0,63,57
1657798951728,COGS 17,A01,092677,Semenuks; Arturs,6,0,81,75
1657798957761,COGS 100,A01,083619,Allen; Michael Gordon,17,0,70,53
1657798963880,COGS 101A,A01,083621,Davis; Joshua Daniel,9,0,68,59
1657798969907,COGS 101B,A01,091572,Allen; Michael Gordon,12,0,65,53
1657798975933,COGS 101C,A01,083625,Delgado; Tania,17,0,35,18
1657798981964,COGS 107A,A01,083627,Boyle; Mary E. T.,14,0,60,46
1657798987995,COGS 118A,A01,083075,Gupta; Anjum,21,0,76,55
1657798994026,CSE 3,A50,083646,Miranda; Gregory Joseph,24,0,50,26
1657799000054,CSE 8A,A50,083650,Miranda; Gregory Joseph,17,1,56,39
1657799006083,CSE 11,A01,083080,Cao; Yingjun,6,15,40,34
1657799012115,CSE 12,A01,083652,Krause-Levy; Sophia Louisa,28,1,120,92
1657799018148,CSE 15L,A01,083654,Morris; Justin Loren,9,0,50,41
1657799018148,CSE 15L,A02,083655,Morris; Justin Loren,9,0,50,41
1657799024174,CSE 20,A01,083657,Tran; Khoa Dang,39,0,80,41
1657799030200,CSE 21,A01,095574,Bach; Quang Tran,22,0,48,26
1657799036228,CSE 30,A01,083084,Eldon; John,6,0,80,74
1657799036228,CSE 30,B01,095061,Bhaskar; Nishant,9,0,50,41
1657799042258,CSE 100,A01,083659,Cao; Yingjun,5,4,70,65
1657799048290,CSE 134B,A01,083661,Powell; Thomas Allan,24,0,100,76
1657799054324,CSE 140,A01,083663,Gungor; Onat,15,0,85,70
1657799060350,CSE 140L,A01,083088,Eldon; John,23,0,100,77
1657799066380,CSE 175,A01,083665,Kumar; Rakesh,3,0,25,22
1657799072413,CSE 190,A00,092507,Dubnov; Shlomo,8,0,20,12
1657799078442,ECE 45,A01,083139,Congero; Spencer William,6,0,75,69
1657799084470,ECE 65,A50,083695,Saad; Andrew S,12,0,30,18
1657799084470,ECE 65,A51,095125,Saad; Andrew S,24,0,26,2
1657799090503,ECE 109,A01,091882,Touri; Behrouz,20,0,70,50
1657799096531,ECE 180,A00,083140,Abi Samra; Nicholas Camill,1,0,30,29
1657799096531,ECE 180,B00,083141,Abi Samra; Nicholas Camill,0,0,30,30
1657799102559,MATH 10A,A01,083735,Patchell; Gregory David,2,0,30,28
1657799102559,MATH 10A,A02,083736,Patchell; Gregory David,20,0,30,10
1657799102559,MATH 10A,A03,083737,Patchell; Gregory David,16,0,30,14
1657799108587,MATH 10B,A01,083207,Lim; Seonhee,8,0,34,26
1657799108587,MATH 10B,A02,083208,Lim; Seonhee,10,0,35,25
1657799108587,MATH 10B,A03,093472,Lim; Seonhee,7,0,34,27
1657799108587,MATH 10B,B01,083739,Sinha; Shubham,13,0,30,17
1657799114629,MATH 18,A01,083743,Cinel; Cameron Alexander,9,0,30,21
1657799114629,MATH 18,A02,083744,Cinel; Cameron Alexander,18,0,30,12
1657799114629,MATH 18,A03,083745,Cinel; Cameron Alexander,10,0,30,20
1657799114629,MATH 18,B01,083748,Rideout; David Porter,5,0,37,32
1657799114629,MATH 18,B02,083749,Rideout; David Porter,5,0,36,31
1657799114629,MATH 18,B03,083750,Rideout; David Porter,3,0,37,34
1657799114629,MATH 18,B04,083751,Rideout; David Porter,6,0,36,30
1657799114629,MATH 18,B05,093473,Rideout; David Porter,6,0,36,30
1657799114629,MATH 18,B06,093474,Rideout; David Porter,6,0,36,30
1657799120655,MATH 20A,A01,083754,Zheng; Zequn,14,0,40,26
1657799126683,MATH 20B,A01,083756,Briones; Jor-el Thomas Caparas,4,0,36,32
1657799126683,MATH 20B,A02,083757,Briones; Jor-el Thomas Caparas,1,0,36,35
1657799126683,MATH 20B,A03,093475,Briones; Jor-el Thomas Caparas,2,0,36,34
1657799132711,MATH 20C,A01,083760,Briones; Jor-el Thomas Caparas,1,0,35,34
1657799132711,MATH 20C,A02,083761,Briones; Jor-el Thomas Caparas,8,0,35,27
1657799132711,MATH 20C,A03,093476,Briones; Jor-el Thomas Caparas,0,1,36,36
1657799132711,MATH 20C,B01,083762,Bach; Quang Tran,1,0,30,29
1657799138739,MATH 20D,A01,083765,Tran; Brian Kha,5,0,30,25
1657799138739,MATH 20D,A02,083766,Tran; Brian Kha,5,0,30,25
1657799138739,MATH 20D,A03,083767,Tran; Brian Kha,5,0,30,25
1657799144769,MATH 20E,A01,083771,Ganguly; Soumya,10,0,32,22
1657799144769,MATH 20E,A02,083772,Ganguly; Soumya,6,0,32,26
1657799144769,MATH 20E,B01,083773,Ciotti; Benjamin,20,0,35,15
1657799144769,MATH 20E,B02,083774,Ciotti; Benjamin,18,0,35,17
1657799150810,MATH 103A,A01,083777,Greenfeld; Be'Eri,3,0,36,33
1657799150810,MATH 103A,A02,083778,Greenfeld; Be'Eri,5,0,36,31
1657799150810,MATH 103A,A03,093561,Greenfeld; Be'Eri,6,0,36,30
1657799150810,MATH 103A,B01,083779,Greenfeld; Be'Eri,7,0,36,29
1657799150810,MATH 103A,B02,083780,Greenfeld; Be'Eri,4,0,36,32
1657799150810,MATH 103A,B03,093562,Greenfeld; Be'Eri,3,0,36,33
1657799156838,MATH 105,A01,085443,Carter; Anne Toulson,15,0,35,20
1657799156838,MATH 105,A02,093477,Carter; Anne Toulson,20,0,35,15
1657799162874,MATH 109,A01,083213,Ganzberger; Geoffrey Michael,3,0,34,31
1657799162874,MATH 109,A02,083214,Ganzberger; Geoffrey Michael,4,0,34,30
1657799162874,MATH 109,A03,093478,Ganzberger; Geoffrey Michael,2,0,34,32
1657799162874,MATH 109,B01,083215,Ganzberger; Geoffrey Michael,1,0,32,31
1657799162874,MATH 109,B02,083216,Ganzberger; Geoffrey Michael,2,0,32,30
1657799162874,MATH 109,B03,093479,Ganzberger; Geoffrey Michael,8,0,32,24
1657799168915,MATH 142A,A01,083219,Chow; Bennett,7,0,32,25
1657799168915,MATH 142A,A02,083220,Chow; Bennett,10,0,32,22
1657799168915,MATH 142A,A03,093480,Chow; Bennett,9,0,32,23
1657799168915,MATH 142A,B03,093481,Chow; Bennett,8,0,32,24
1657799168915,MATH 142A,B04,093558,Chow; Bennett,13,0,32,19
1657799168915,MATH 142A,B05,093559,Chow; Bennett,6,0,32,26
1657799174949,MATH 193A,A01,083224,Rotar; Vladimir,8,0,34,26
1657799174949,MATH 193A,A02,083225,Rotar; Vladimir,9,0,34,25
1657799174949,MATH 193A,A03,083781,Rotar; Vladimir,5,0,34,29
1657799174949,MATH 193A,A04,083782,Rotar; Vladimir,10,0,34,24
1657799174949,MATH 193A,A05,093482,Rotar; Vladimir,10,0,34,24
1657799180977,MATH 197,001,091859,McAuley; Julian John,9999,0,9999,0
1657799180977,MATH 197,002,095566,Kedlaya; Kiran S.,9997,0,9999,2
1657799180977,MATH 197,003,095567,Xiao; Ming,9999,0,9999,0
1657799180977,MATH 197,004,095571,Perols; Johan Lars,9998,0,9999,1
1657799188048,COGS 9,A01,083615,Shannon; Kyle Michael,9,0,75,66
1657799194075,COGS 11,A01,083617,Boyle; Mary E. T.,23,0,48,25
1657799200103,COGS 13,A01,083071,Bastos; Amalia Pinkusfeld,11,0,71,60
1657799206137,COGS 14A,A01,092681,Semenuks; Arturs,5,1,100,95
1657799212162,COGS 14B,A01,083073,Cheng; Tzu-Han,6,0,63,57
1657799218189,COGS 17,A01,092677,Semenuks; Arturs,6,0,81,75
1657799224215,COGS 100,A01,083619,Allen; Michael Gordon,17,0,70,53
1657799230245,COGS 101A,A01,083621,Davis; Joshua Daniel,9,0,68,59
1657799236272,COGS 101B,A01,091572,Allen; Michael Gordon,12,0,65,53
1657799242300,COGS 101C,A01,083625,Delgado; Tania,17,0,35,18
1657799248328,COGS 107A,A01,083627,Boyle; Mary E. T.,14,0,60,46
1657799254360,COGS 118A,A01,083075,Gupta; Anjum,21,0,76,55
1657799260390,CSE 3,A50,083646,Miranda; Gregory Joseph,24,0,50,26
1657799266419,CSE 8A,A50,083650,Miranda; Gregory Joseph,17,1,56,39
1657799272448,CSE 11,A01,083080,Cao; Yingjun,6,15,40,34
1657799278478,CSE 12,A01,083652,Krause-Levy; Sophia Louisa,28,1,120,92
1657799284505,CSE 15L,A01,083654,Morris; Justin Loren,9,0,50,41
1657799284505,CSE 15L,A02,083655,Morris; Justin Loren,9,0,50,41
1657799290538,CSE 20,A01,083657,Tran; Khoa Dang,39,0,80,41
1657799296567,CSE 21,A01,095574,Bach; Quang Tran,22,0,48,26
1657799302593,CSE 30,A01,083084,Eldon; John,6,0,80,74
1657799302593,CSE 30,B01,095061,Bhaskar; Nishant,9,0,50,41
1657799308621,CSE 100,A01,083659,Cao; Yingjun,5,4,70,65
1657799314650,CSE 134B,A01,083661,Powell; Thomas Allan,24,0,100,76
1657799320679,CSE 140,A01,083663,Gungor; Onat,15,0,85,70
1657799326708,CSE 140L,A01,083088,Eldon; John,23,0,100,77
1657799332734,CSE 175,A01,083665,Kumar; Rakesh,3,0,25,22
1657799338759,CSE 190,A00,092507,Dubnov; Shlomo,8,0,20,12
1657799344790,ECE 45,A01,083139,Congero; Spencer William,6,0,75,69
1657799350817,ECE 65,A50,083695,Saad; Andrew S,12,0,30,18
1657799350817,ECE 65,A51,095125,Saad; Andrew S,24,0,26,2
1657799356845,ECE 109,A01,091882,Touri; Behrouz,20,0,70,50
1657799362872,ECE 180,A00,083140,Abi Samra; Nicholas Camill,1,0,30,29
1657799362872,ECE 180,B00,083141,Abi Samra; Nicholas Camill,0,0,30,30
1657799368903,MATH 10A,A01,083735,Patchell; Gregory David,2,0,30,28
1657799368903,MATH 10A,A02,083736,Patchell; Gregory David,20,0,30,10
1657799368903,MATH 10A,A03,083737,Patchell; Gregory David,16,0,30,14
1657799374942,MATH 10B,A01,083207,Lim; Seonhee,8,0,34,26
1657799374942,MATH 10B,A02,083208,Lim; Seonhee,10,0,35,25
1657799374942,MATH 10B,A03,093472,Lim; Seonhee,7,0,34,27
1657799374942,MATH 10B,B01,083739,Sinha; Shubham,13,0,30,17
1657799380973,MATH 18,A01,083743,Cinel; Cameron Alexander,9,0,30,21
1657799380973,MATH 18,A02,083744,Cinel; Cameron Alexander,18,0,30,12
1657799380973,MATH 18,A03,083745,Cinel; Cameron Alexander,10,0,30,20
1657799380973,MATH 18,B01,083748,Rideout; David Porter,5,0,37,32
1657799380973,MATH 18,B02,083749,Rideout; David Porter,5,0,36,31
1657799380973,MATH 18,B03,083750,Rideout; David Porter,3,0,37,34
1657799380973,MATH 18,B04,083751,Rideout; David Porter,6,0,36,30
1657799380973,MATH 18,B05,093473,Rideout; David Porter,6,0,36,30
1657799380973,MATH 18,B06,093474,Rideout; David Porter,6,0,36,30
1657799387003,MATH 20A,A01,083754,Zheng; Zequn,14,0,40,26
1657799393030,MATH 20B,A01,083756,Briones; Jor-el Thomas Caparas,4,0,36,32
1657799393030,MATH 20B,A02,083757,Briones; Jor-el Thomas Caparas,1,0,36,35
1657799393030,MATH 20B,A03,093475,Briones; Jor-el Thomas Caparas,2,0,36,34
1657799399065,MATH 20C,A01,083760,Briones; Jor-el Thomas Caparas,1,0,35,34
1657799399065,MATH 20C,A02,083761,Briones; Jor-el Thomas Caparas,8,0,35,27
1657799399065,MATH 20C,A03,093476,Briones; Jor-el Thomas Caparas,0,1,36,36
1657799399065,MATH 20C,B01,083762,Bach; Quang Tran,1,0,30,29
1657799405092,MATH 20D,A01,083765,Tran; Brian Kha,5,0,30,25
1657799405092,MATH 20D,A02,083766,Tran; Brian Kha,5,0,30,25
1657799405092,MATH 20D,A03,083767,Tran; Brian Kha,5,0,30,25
1657799411128,MATH 20E,A01,083771,Ganguly; Soumya,10,0,32,22
1657799411128,MATH 20E,A02,083772,Ganguly; Soumya,6,0,32,26
1657799411128,MATH 20E,B01,083773,Ciotti; Benjamin,20,0,35,15
1657799411128,MATH 20E,B02,083774,Ciotti; Benjamin,18,0,35,17
1657799417160,MATH 103A,A01,083777,Greenfeld; Be'Eri,3,0,36,33
1657799417160,MATH 103A,A02,083778,Greenfeld; Be'Eri,5,0,36,31
1657799417160,MATH 103A,A03,093561,Greenfeld; Be'Eri,6,0,36,30
1657799417160,MATH 103A,B01,083779,Greenfeld; Be'Eri,7,0,36,29
1657799417160,MATH 103A,B02,083780,Greenfeld; Be'Eri,4,0,36,32
1657799417160,MATH 103A,B03,093562,Greenfeld; Be'Eri,3,0,36,33
1657799423189,MATH 105,A01,085443,Carter; Anne Toulson,15,0,35,20
1657799423189,MATH 105,A02,093477,Carter; Anne Toulson,20,0,35,15
1657799429218,MATH 109,A01,083213,Ganzberger; Geoffrey Michael,3,0,34,31
1657799429218,MATH 109,A02,083214,Ganzberger; Geoffrey Michael,4,0,34,30
1657799429218,MATH 109,A03,093478,Ganzberger; Geoffrey Michael,2,0,34,32
1657799429218,MATH 109,B01,083215,Ganzberger; Geoffrey Michael,1,0,32,31
1657799429218,MATH 109,B02,083216,Ganzberger; Geoffrey Michael,2,0,32,30
1657799429218,MATH 109,B03,093479,Ganzberger; Geoffrey Michael,8,0,32,24
1657799435246,MATH 142A,A01,083219,Chow; Bennett,7,0,32,25
1657799435246,MATH 142A,A02,083220,Chow; Bennett,10,0,32,22
1657799435246,MATH 142A,A03,093480,Chow; Bennett,9,0,32,23
1657799435246,MATH 142A,B03,093481,Chow; Bennett,8,0,32,24
1657799435246,MATH 142A,B04,093558,Chow; Bennett,13,0,32,19
1657799435246,MATH 142A,B05,093559,Chow; Bennett,6,0,32,26
1657799441275,MATH 193A,A01,083224,Rotar; Vladimir,8,0,34,26
1657799441275,MATH 193A,A02,083225,Rotar; Vladimir,9,0,34,25
1657799441275,MATH 193A,A03,083781,Rotar; Vladimir,5,0,34,29
1657799441275,MATH 193A,A04,083782,Rotar; Vladimir,10,0,34,24
1657799441275,MATH 193A,A05,093482,Rotar; Vladimir,10,0,34,24
1657799447312,MATH 197,001,091859,McAuley; Julian John,9999,0,9999,0
1657799447312,MATH 197,002,095566,Kedlaya; Kiran S.,9997,0,9999,2
1657799447312,MATH 197,003,095567,Xiao; Ming,9999,0,9999,0
1657799447312,MATH 197,004,095571,Perols; Johan Lars,9998,0,9999,1
1657799454380,COGS 9,A01,083615,Shannon; Kyle Michael,9,0,75,66
1657799460414,COGS 11,A01,083617,Boyle; Mary E. T.,23,0,48,25
1657799466440,COGS 13,A01,083071,Bastos; Amalia Pinkusfeld,11,0,71,60
1657799472468,COGS 14A,A01,092681,Semenuks; Arturs,5,1,100,95
1657799478496,COGS 14B,A01,083073,Cheng; Tzu-Han,6,0,63,57
1657799484522,COGS 17,A01,092677,Semenuks; Arturs,6,0,81,75
1657799490552,COGS 100,A01,083619,Allen; Michael Gordon,17,0,70,53
1657799496579,COGS 101A,A01,083621,Davis; Joshua Daniel,9,0,68,59
1657799502605,COGS 101B,A01,091572,Allen; Michael Gordon,12,0,65,53
1657799508639,COGS 101C,A01,083625,Delgado; Tania,17,0,35,18
1657799514670,COGS 107A,A01,083627,Boyle; Mary E. T.,14,0,60,46
1657799520698,COGS 118A,A01,083075,Gupta; Anjum,21,0,76,55
1657799526733,CSE 3,A50,083646,Miranda; Gregory Joseph,24,0,50,26
1657799532767,CSE 8A,A50,083650,Miranda; Gregory Joseph,17,1,56,39
1657799538793,CSE 11,A01,083080,Cao; Yingjun,6,15,40,34
1657799544826,CSE 12,A01,083652,Krause-Levy; Sophia Louisa,28,1,120,92
1657799550857,CSE 15L,A01,083654,Morris; Justin Loren,9,0,50,41
1657799550857,CSE 15L,A02,083655,Morris; Justin Loren,9,0,50,41
1657799556885,CSE 20,A01,083657,Tran; Khoa Dang,39,0,80,41
1657799562988,CSE 21,A01,095574,Bach; Quang Tran,22,0,48,26
1657799569031,CSE 30,A01,083084,Eldon; John,6,0,80,74
1657799569031,CSE 30,B01,095061,Bhaskar; Nishant,9,0,50,41
1657799575057,CSE 100,A01,083659,Cao; Yingjun,5,4,70,65
1657799581085,CSE 134B,A01,083661,Powell; Thomas Allan,24,0,100,76
1657799587111,CSE 140,A01,083663,Gungor; Onat,15,0,85,70
1657799593140,CSE 140L,A01,083088,Eldon; John,23,0,100,77
1657799599168,CSE 175,A01,083665,Kumar; Rakesh,3,0,25,22
1657799605203,CSE 190,A00,092507,Dubnov; Shlomo,8,0,20,12
1657799611234,ECE 45,A01,083139,Congero; Spencer William,6,0,75,69
1657799617268,ECE 65,A50,083695,Saad; Andrew S,12,0,30,18
1657799617268,ECE 65,A51,095125,Saad; Andrew S,24,0,26,2
1657799623295,ECE 109,A01,091882,Touri; Behrouz,20,0,70,50
1657799629326,ECE 180,A00,083140,Abi Samra; Nicholas Camill,1,0,30,29
1657799629326,ECE 180,B00,083141,Abi Samra; Nicholas Camill,0,0,30,30
1657799635358,MATH 10A,A01,083735,Patchell; Gregory David,2,0,30,28
1657799635358,MATH 10A,A02,083736,Patchell; Gregory David,20,0,30,10
1657799635358,MATH 10A,A03,083737,Patchell; Gregory David,16,0,30,14
1657799641388,MATH 10B,A01,083207,Lim; Seonhee,8,0,34,26
1657799641388,MATH 10B,A02,083208,Lim; Seonhee,10,0,35,25
1657799641388,MATH 10B,A03,093472,Lim; Seonhee,7,0,34,27
1657799641388,MATH 10B,B01,083739,Sinha; Shubham,13,0,30,17
1657799647417,MATH 18,A01,083743,Cinel; Cameron Alexander,9,0,30,21
1657799647417,MATH 18,A02,083744,Cinel; Cameron Alexander,18,0,30,12
1657799647417,MATH 18,A03,083745,Cinel; Cameron Alexander,10,0,30,20
1657799647417,MATH 18,B01,083748,Rideout; David Porter,5,0,37,32
1657799647417,MATH 18,B02,083749,Rideout; David Porter,5,0,36,31
1657799647417,MATH 18,B03,083750,Rideout; David Porter,3,0,37,34
1657799647417,MATH 18,B04,083751,Rideout; David Porter,6,0,36,30
1657799647417,MATH 18,B05,093473,Rideout; David Porter,6,0,36,30
1657799647417,MATH 18,B06,093474,Rideout; David Porter,6,0,36,30
1657799653447,MATH 20A,A01,083754,Zheng; Zequn,14,0,40,26
1657799659480,MATH 20B,A01,083756,Briones; Jor-el Thomas Caparas,4,0,36,32
1657799659480,MATH 20B,A02,083757,Briones; Jor-el Thomas Caparas,1,0,36,35
1657799659480,MATH 20B,A03,093475,Briones; Jor-el Thomas Caparas,2,0,36,34
1657799665507,MATH 20C,A01,083760,Briones; Jor-el Thomas Caparas,1,0,35,34
1657799665507,MATH 20C,A02,083761,Briones; Jor-el Thomas Caparas,8,0,35,27
1657799665507,MATH 20C,A03,093476,Briones; Jor-el Thomas Caparas,0,1,36,36
1657799665507,MATH 20C,B01,083762,Bach; Quang Tran,1,0,30,29
1657799671534,MATH 20D,A01,083765,Tran; Brian Kha,5,0,30,25
1657799671534,MATH 20D,A02,083766,Tran; Brian Kha,5,0,30,25
1657799671534,MATH 20D,A03,083767,Tran; Brian Kha,5,0,30,25
1657799677575,MATH 20E,A01,083771,Ganguly; Soumya,10,0,32,22
1657799677575,MATH 20E,A02,083772,Ganguly; Soumya,6,0,32,26
1657799677575,MATH 20E,B01,083773,Ciotti; Benjamin,20,0,35,15
1657799677575,MATH 20E,B02,083774,Ciotti; Benjamin,18,0,35,17
1657799683611,MATH 103A,A01,083777,Greenfeld; Be'Eri,3,0,36,33
1657799683611,MATH 103A,A02,083778,Greenfeld; Be'Eri,5,0,36,31
1657799683611,MATH 103A,A03,093561,Greenfeld; Be'Eri,6,0,36,30
1657799683611,MATH 103A,B01,083779,Greenfeld; Be'Eri,7,0,36,29
1657799683611,MATH 103A,B02,083780,Greenfeld; Be'Eri,4,0,36,32
1657799683611,MATH 103A,B03,093562,Greenfeld; Be'Eri,3,0,36,33
1657799689644,MATH 105,A01,085443,Carter; Anne Toulson,15,0,35,20
1657799689644,MATH 105,A02,093477,Carter; Anne Toulson,20,0,35,15
1657799695674,MATH 109,A01,083213,Ganzberger; Geoffrey Michael,3,0,34,31
1657799695674,MATH 109,A02,083214,Ganzberger; Geoffrey Michael,4,0,34,30
1657799695674,MATH 109,A03,093478,Ganzberger; Geoffrey Michael,2,0,34,32
1657799695674,MATH 109,B01,083215,Ganzberger; Geoffrey Michael,1,0,32,31
1657799695674,MATH 109,B02,083216,Ganzberger; Geoffrey Michael,2,0,32,30
1657799695674,MATH 109,B03,093479,Ganzberger; Geoffrey Michael,8,0,32,24
1657799701704,MATH 142A,A01,083219,Chow; Bennett,7,0,32,25
1657799701704,MATH 142A,A02,083220,Chow; Bennett,10,0,32,22
1657799701704,MATH 142A,A03,093480,Chow; Bennett,9,0,32,23
1657799701704,MATH 142A,B03,093481,Chow; Bennett,8,0,32,24
1657799701704,MATH 142A,B04,093558,Chow; Bennett,13,0,32,19
1657799701704,MATH 142A,B05,093559,Chow; Bennett,6,0,32,26
1657799707737,MATH 193A,A01,083224,Rotar; Vladimir,8,0,34,26
1657799707737,MATH 193A,A02,083225,Rotar; Vladimir,9,0,34,25
1657799707737,MATH 193A,A03,083781,Rotar; Vladimir,5,0,34,29
1657799707737,MATH 193A,A04,083782,Rotar; Vladimir,10,0,34,24
1657799707737,MATH 193A,A05,093482,Rotar; Vladimir,10,0,34,24
1657799713767,MATH 197,001,091859,McAuley; Julian John,9999,0,9999,0
1657799713767,MATH 197,002,095566,Kedlaya; Kiran S.,9997,0,9999,2
1657799713767,MATH 197,003,095567,Xiao; Ming,9999,0,9999,0
1657799713767,MATH 197,004,095571,Perols; Johan Lars,9998,0,9999,1
1657799720846,COGS 9,A01,083615,Shannon; Kyle Michael,9,0,75,66
1657799726873,COGS 11,A01,083617,Boyle; Mary E. T.,23,0,48,25
1657799732900,COGS 13,A01,083071,Bastos; Amalia Pinkusfeld,11,0,71,60
1657799738940,COGS 14A,A01,092681,Semenuks; Arturs,5,1,100,95
1657799744972,COGS 14B,A01,083073,Cheng; Tzu-Han,6,0,63,57
1657799750997,COGS 17,A01,092677,Semenuks; Arturs,6,0,81,75
1657799757025,COGS 100,A01,083619,Allen; Michael Gordon,17,0,70,53
1657799763058,COGS 101A,A01,083621,Davis; Joshua Daniel,9,0,68,59
1657799769085,COGS 101B,A01,091572,Allen; Michael Gordon,12,0,65,53
1657799775112,COGS 101C,A01,083625,Delgado; Tania,17,0,35,18
1657799781145,COGS 107A,A01,083627,Boyle; Mary E. T.,14,0,60,46
1657799787174,COGS 118A,A01,083075,Gupta; Anjum,21,0,76,55
1657799793208,CSE 3,A50,083646,Miranda; Gregory Joseph,24,0,50,26
1657799799243,CSE 8A,A50,083650,Miranda; Gregory Joseph,17,1,56,39
1657799805270,CSE 11,A01,083080,Cao; Yingjun,6,15,40,34
1657799811296,CSE 12,A01,083652,Krause-Levy; Sophia Louisa,28,1,120,92
1657799817322,CSE 15L,A01,083654,Morris; Justin Loren,9,0,50,41
1657799817322,CSE 15L,A02,083655,Morris; Justin Loren,9,0,50,41
1657799823353,CSE 20,A01,083657,Tran; Khoa Dang,39,0,80,41
1657799829380,CSE 21,A01,095574,Bach; Quang Tran,22,0,48,26
1657799835408,CSE 30,A01,083084,Eldon; John,6,0,80,74
1657799835408,CSE 30,B01,095061,Bhaskar; Nishant,9,0,50,41
1657799841435,CSE 100,A01,083659,Cao; Yingjun,5,4,70,65
1657799847467,CSE 134B,A01,083661,Powell; Thomas Allan,24,0,100,76
1657799853494,CSE 140,A01,083663,Gungor; Onat,15,0,85,70
1657799859521,CSE 140L,A01,083088,Eldon; John,23,0,100,77
1657799865547,CSE 175,A01,083665,Kumar; Rakesh,3,0,25,22
1657799871579,CSE 190,A00,092507,Dubnov; Shlomo,8,0,20,12
1657799877611,ECE 45,A01,083139,Congero; Spencer William,6,0,75,69
1657799883636,ECE 65,A50,083695,Saad; Andrew S,12,0,30,18
1657799883636,ECE 65,A51,095125,Saad; Andrew S,24,0,26,2
1657799889667,ECE 109,A01,091882,Touri; Behrouz,20,0,70,50
1657799895694,ECE 180,A00,083140,Abi Samra; Nicholas Camill,1,0,30,29
1657799895694,ECE 180,B00,083141,Abi Samra; Nicholas Camill,0,0,30,30
1657799901724,MATH 10A,A01,083735,Patchell; Gregory David,2,0,30,28
1657799901724,MATH 10A,A02,083736,Patchell; Gregory David,20,0,30,10
1657799901724,MATH 10A,A03,083737,Patchell; Gregory David,16,0,30,14
1657799907764,MATH 10B,A01,083207,Lim; Seonhee,8,0,34,26
1657799907764,MATH 10B,A02,083208,Lim; Seonhee,10,0,35,25
1657799907764,MATH 10B,A03,093472,Lim; Seonhee,7,0,34,27
1657799907764,MATH 10B,B01,083739,Sinha; Shubham,13,0,30,17
1657799913792,MATH 18,A01,083743,Cinel; Cameron Alexander,9,0,30,21
1657799913792,MATH 18,A02,083744,Cinel; Cameron Alexander,18,0,30,12
1657799913792,MATH 18,A03,083745,Cinel; Cameron Alexander,10,0,30,20
1657799913792,MATH 18,B01,083748,Rideout; David Porter,5,0,37,32
1657799913792,MATH 18,B02,083749,Rideout; David Porter,5,0,36,31
1657799913792,MATH 18,B03,083750,Rideout; David Porter,3,0,37,34
1657799913792,MATH 18,B04,083751,Rideout; David Porter,6,0,36,30
1657799913792,MATH 18,B05,093473,Rideout; David Porter,6,0,36,30
1657799913792,MATH 18,B06,093474,Rideout; David Porter,6,0,36,30
1657799919820,MATH 20A,A01,083754,Zheng; Zequn,14,0,40,26
1657799925851,MATH 20B,A01,083756,Briones; Jor-el Thomas Caparas,4,0,36,32
1657799925851,MATH 20B,A02,083757,Briones; Jor-el Thomas Caparas,1,0,36,35
1657799925851,MATH 20B,A03,093475,Briones; Jor-el Thomas Caparas,2,0,36,34
1657799931881,MATH 20C,A01,083760,Briones; Jor-el Thomas Caparas,1,0,35,34
1657799931881,MATH 20C,A02,083761,Briones; Jor-el Thomas Caparas,8,0,35,27
1657799931881,MATH 20C,A03,093476,Briones; Jor-el Thomas Caparas,0,1,36,36
1657799931881,MATH 20C,B01,083762,Bach; Quang Tran,1,0,30,29
1657799937910,MATH 20D,A01,083765,Tran; Brian Kha,5,0,30,25
1657799937910,MATH 20D,A02,083766,Tran; Brian Kha,5,0,30,25
1657799937910,MATH 20D,A03,083767,Tran; Brian Kha,5,0,30,25
1657799943939,MATH 20E,A01,083771,Ganguly; Soumya,10,0,32,22
1657799943939,MATH 20E,A02,083772,Ganguly; Soumya,6,0,32,26
1657799943939,MATH 20E,B01,083773,Ciotti; Benjamin,20,0,35,15
1657799943939,MATH 20E,B02,083774,Ciotti; Benjamin,18,0,35,17
1657799949967,MATH 103A,A01,083777,Greenfeld; Be'Eri,3,0,36,33
1657799949967,MATH 103A,A02,083778,Greenfeld; Be'Eri,5,0,36,31
1657799949967,MATH 103A,A03,093561,Greenfeld; Be'Eri,6,0,36,30
1657799949967,MATH 103A,B01,083779,Greenfeld; Be'Eri,7,0,36,29
1657799949967,MATH 103A,B02,083780,Greenfeld; Be'Eri,4,0,36,32
1657799949967,MATH 103A,B03,093562,Greenfeld; Be'Eri,3,0,36,33
1657799955994,MATH 105,A01,085443,Carter; Anne Toulson,15,0,35,20
1657799955994,MATH 105,A02,093477,Carter; Anne Toulson,20,0,35,15
1657799962021,MATH 109,A01,083213,Ganzberger; Geoffrey Michael,3,0,34,31
1657799962021,MATH 109,A02,083214,Ganzberger; Geoffrey Michael,4,0,34,30
1657799962021,MATH 109,A03,093478,Ganzberger; Geoffrey Michael,2,0,34,32
1657799962021,MATH 109,B01,083215,Ganzberger; Geoffrey Michael,1,0,32,31
1657799962021,MATH 109,B02,083216,Ganzberger; Geoffrey Michael,2,0,32,30
1657799962021,MATH 109,B03,093479,Ganzberger; Geoffrey Michael,8,0,32,24
1657799968047,MATH 142A,A01,083219,Chow; Bennett,7,0,32,25
1657799968047,MATH 142A,A02,083220,Chow; Bennett,10,0,32,22
1657799968047,MATH 142A,A03,093480,Chow; Bennett,9,0,32,23
1657799968047,MATH 142A,B03,093481,Chow; Bennett,8,0,32,24
1657799968047,MATH 142A,B04,093558,Chow; Bennett,13,0,32,19
1657799968047,MATH 142A,B05,093559,Chow; Bennett,6,0,32,26
1657799974081,MATH 193A,A01,083224,Rotar; Vladimir,8,0,34,26
1657799974081,MATH 193A,A02,083225,Rotar; Vladimir,9,0,34,25
1657799974081,MATH 193A,A03,083781,Rotar; Vladimir,5,0,34,29
1657799974081,MATH 193A,A04,083782,Rotar; Vladimir,10,0,34,24
1657799974081,MATH 193A,A05,093482,Rotar; Vladimir,10,0,34,24
1657799980106,MATH 197,001,091859,McAuley; Julian John,9999,0,9999,0
1657799980106,MATH 197,002,095566,Kedlaya; Kiran S.,9997,0,9999,2
1657799980106,MATH 197,003,095567,Xiao; Ming,9999,0,9999,0
1657799980106,MATH 197,004,095571,Perols; Johan Lars,9998,0,9999,1
1657799987184,COGS 9,A01,083615,Shannon; Kyle Michael,9,0,75,66
1657799993215,COGS 11,A01,083617,Boyle; Mary E. T.,23,0,48,25
1657799999243,COGS 13,A01,083071,Bastos; Amalia Pinkusfeld,11,0,71,60
1657800005270,COGS 14A,A01,092681,Semenuks; Arturs,5,1,100,95
1657800011299,COGS 14B,A01,083073,Cheng; Tzu-Han,6,0,63,57
1657800017323,COGS 17,A01,092677,Semenuks; Arturs,6,0,81,75
1657800023352,COGS 100,A01,083619,Allen; Michael Gordon,17,0,70,53
1657800029376,COGS 101A,A01,083621,Davis; Joshua Daniel,9,0,68,59
1657800035400,COGS 101B,A01,091572,Allen; Michael Gordon,12,0,65,53
1657800041423,COGS 101C,A01,083625,Delgado; Tania,17,0,35,18
1657800047447,COGS 107A,A01,083627,Boyle; Mary E. T.,14,0,60,46
1657800053471,COGS 118A,A01,083075,Gupta; Anjum,21,0,76,55
1657800059495,CSE 3,A50,083646,Miranda; Gregory Joseph,24,0,50,26
1657800065521,CSE 8A,A50,083650,Miranda; Gregory Joseph,17,1,56,39
1657800071547,CSE 11,A01,083080,Cao; Yingjun,6,15,40,34
1657800077572,CSE 12,A01,083652,Krause-Levy; Sophia Louisa,28,1,120,92
1657800083596,CSE 15L,A01,083654,Morris; Justin Loren,9,0,50,41
1657800083596,CSE 15L,A02,083655,Morris; Justin Loren,9,0,50,41
1657800089621,CSE 20,A01,083657,Tran; Khoa Dang,39,0,80,41
1657800095653,CSE 21,A01,095574,Bach; Quang Tran,22,0,48,26
1657800101681,CSE 30,A01,083084,Eldon; John,6,0,80,74
1657800101681,CSE 30,B01,095061,Bhaskar; Nishant,9,0,50,41
1657800107716,CSE 100,A01,083659,Cao; Yingjun,5,4,70,65
1657800113748,CSE 134B,A01,083661,Powell; Thomas Allan,24,0,100,76
1657800119775,CSE 140,A01,083663,Gungor; Onat,15,0,85,70
1657800125813,CSE 140L,A01,083088,Eldon; John,23,0,100,77
1657800131840,CSE 175,A01,083665,Kumar; Rakesh,3,0,25,22
1657800137864,CSE 190,A00,092507,Dubnov; Shlomo,8,0,20,12
1657800143895,ECE 45,A01,083139,Congero; Spencer William,6,0,75,69
1657800149922,ECE 65,A50,083695,Saad; Andrew S,12,0,30,18
1657800149922,ECE 65,A51,095125,Saad; Andrew S,24,0,26,2
1657800155955,ECE 109,A01,091882,Touri; Behrouz,20,0,70,50
1657800162075,ECE 180,A00,083140,Abi Samra; Nicholas Camill,1,0,30,29
1657800162075,ECE 180,B00,083141,Abi Samra; Nicholas Camill,0,0,30,30
1657800168103,MATH 10A,A01,083735,Patchell; Gregory David,2,0,30,28
1657800168103,MATH 10A,A02,083736,Patchell; Gregory David,20,0,30,10
1657800168103,MATH 10A,A03,083737,Patchell; Gregory David,16,0,30,14
1657800174132,MATH 10B,A01,083207,Lim; Seonhee,8,0,34,26
1657800174132,MATH 10B,A02,083208,Lim; Seonhee,10,0,35,25
1657800174132,MATH 10B,A03,093472,Lim; Seonhee,7,0,34,27
1657800174132,MATH 10B,B01,083739,Sinha; Shubham,13,0,30,17
1657800180174,MATH 18,A01,083743,Cinel; Cameron Alexander,9,0,30,21
1657800180174,MATH 18,A02,083744,Cinel; Cameron Alexander,18,0,30,12
1657800180174,MATH 18,A03,083745,Cinel; Cameron Alexander,10,0,30,20
1657800180174,MATH 18,B01,083748,Rideout; David Porter,5,0,37,32
1657800180174,MATH 18,B02,083749,Rideout; David Porter,5,0,36,31
1657800180174,MATH 18,B03,083750,Rideout; David Porter,3,0,37,34
1657800180174,MATH 18,B04,083751,Rideout; David Porter,6,0,36,30
1657800180174,MATH 18,B05,093473,Rideout; David Porter,6,0,36,30
1657800180174,MATH 18,B06,093474,Rideout; David Porter,6,0,36,30
1657800186216,MATH 20A,A01,083754,Zheng; Zequn,14,0,40,26
1657800192252,MATH 20B,A01,083756,Briones; Jor-el Thomas Caparas,4,0,36,32
1657800192252,MATH 20B,A02,083757,Briones; Jor-el Thomas Caparas,1,0,36,35
1657800192252,MATH 20B,A03,093475,Briones; Jor-el Thomas Caparas,2,0,36,34
1657800198281,MATH 20C,A01,083760,Briones; Jor-el Thomas Caparas,1,0,35,34
1657800198281,MATH 20C,A02,083761,Briones; Jor-el Thomas Caparas,8,0,35,27
1657800198281,MATH 20C,A03,093476,Briones; Jor-el Thomas Caparas,0,1,36,36
1657800198281,MATH 20C,B01,083762,Bach; Quang Tran,1,0,30,29
1657800204309,MATH 20D,A01,083765,Tran; Brian Kha,5,0,30,25
1657800204309,MATH 20D,A02,083766,Tran; Brian Kha,5,0,30,25
1657800204309,MATH 20D,A03,083767,Tran; Brian Kha,5,0,30,25
1657800210366,MATH 20E,A01,083771,Ganguly; Soumya,10,0,32,22
1657800210366,MATH 20E,A02,083772,Ganguly; Soumya,6,0,32,26
1657800210366,MATH 20E,B01,083773,Ciotti; Benjamin,20,0,35,15
1657800210366,MATH 20E,B02,083774,Ciotti; Benjamin,18,0,35,17
1657800216400,MATH 103A,A01,083777,Greenfeld; Be'Eri,3,0,36,33
1657800216400,MATH 103A,A02,083778,Greenfeld; Be'Eri,5,0,36,31
1657800216400,MATH 103A,A03,093561,Greenfeld; Be'Eri,6,0,36,30
1657800216400,MATH 103A,B01,083779,Greenfeld; Be'Eri,7,0,36,29
1657800216400,MATH 103A,B02,083780,Greenfeld; Be'Eri,4,0,36,32
1657800216400,MATH 103A,B03,093562,Greenfeld; Be'Eri,3,0,36,33
1657800222429,MATH 105,A01,085443,Carter; Anne Toulson,15,0,35,20
1657800222429,MATH 105,A02,093477,Carter; Anne Toulson,20,0,35,15
1657800228455,MATH 109,A01,083213,Ganzberger; Geoffrey Michael,3,0,34,31
1657800228455,MATH 109,A02,083214,Ganzberger; Geoffrey Michael,4,0,34,30
1657800228455,MATH 109,A03,093478,Ganzberger; Geoffrey Michael,2,0,34,32
1657800228455,MATH 109,B01,083215,Ganzberger; Geoffrey Michael,1,0,32,31
1657800228455,MATH 109,B02,083216,Ganzberger; Geoffrey Michael,2,0,32,30
1657800228455,MATH 109,B03,093479,Ganzberger; Geoffrey Michael,8,0,32,24
1657800234486,MATH 142A,A01,083219,Chow; Bennett,7,0,32,25
1657800234486,MATH 142A,A02,083220,Chow; Bennett,10,0,32,22
1657800234486,MATH 142A,A03,093480,Chow; Bennett,9,0,32,23
1657800234486,MATH 142A,B03,093481,Chow; Bennett,8,0,32,24
1657800234486,MATH 142A,B04,093558,Chow; Bennett,13,0,32,19
1657800234486,MATH 142A,B05,093559,Chow; Bennett,6,0,32,26
1657800240515,MATH 193A,A01,083224,Rotar; Vladimir,8,0,34,26
1657800240515,MATH 193A,A02,083225,Rotar; Vladimir,9,0,34,25
1657800240515,MATH 193A,A03,083781,Rotar; Vladimir,5,0,34,29
1657800240515,MATH 193A,A04,083782,Rotar; Vladimir,10,0,34,24
1657800240515,MATH 193A,A05,093482,Rotar; Vladimir,10,0,34,24
1657800246547,MATH 197,001,091859,McAuley; Julian John,9999,0,9999,0
1657800246547,MATH 197,002,095566,Kedlaya; Kiran S.,9997,0,9999,2
1657800246547,MATH 197,003,095567,Xiao; Ming,9999,0,9999,0
1657800246547,MATH 197,004,095571,Perols; Johan Lars,9998,0,9999,1
1657800253611,COGS 9,A01,083615,Shannon; Kyle Michael,9,0,75,66
1657800259642,COGS 11,A01,083617,Boyle; Mary E. T.,23,0,48,25
1657800265675,COGS 13,A01,083071,Bastos; Amalia Pinkusfeld,11,0,71,60
1657800271709,COGS 14A,A01,092681,Semenuks; Arturs,5,1,100,95
1657800277735,COGS 14B,A01,083073,Cheng; Tzu-Han,6,0,63,57
1657800283760,COGS 17,A01,092677,Semenuks; Arturs,6,0,81,75
1657800289787,COGS 100,A01,083619,Allen; Michael Gordon,17,0,70,53
1657800295822,COGS 101A,A01,083621,Davis; Joshua Daniel,9,0,68,59
1657800301848,COGS 101B,A01,091572,Allen; Michael Gordon,12,0,65,53
1657800307879,COGS 101C,A01,083625,Delgado; Tania,17,0,35,18
1657800313904,COGS 107A,A01,083627,Boyle; Mary E. T.,14,0,60,46
1657800319930,COGS 118A,A01,083075,Gupta; Anjum,21,0,76,55
1657800325969,CSE 3,A50,083646,Miranda; Gregory Joseph,24,0,50,26
1657800331995,CSE 8A,A50,083650,Miranda; Gregory Joseph,17,1,56,39
1657800338020,CSE 11,A01,083080,Cao; Yingjun,6,15,40,34
1657800344047,CSE 12,A01,083652,Krause-Levy; Sophia Louisa,28,1,120,92
1657800350073,CSE 15L,A01,083654,Morris; Justin Loren,9,0,50,41
1657800350073,CSE 15L,A02,083655,Morris; Justin Loren,9,0,50,41
1657800356100,CSE 20,A01,083657,Tran; Khoa Dang,39,0,80,41
1657800362134,CSE 21,A01,095574,Bach; Quang Tran,22,0,48,26
1657800368172,CSE 30,A01,083084,Eldon; John,6,0,80,74
1657800368172,CSE 30,B01,095061,Bhaskar; Nishant,9,0,50,41
1657800374198,CSE 100,A01,083659,Cao; Yingjun,5,4,70,65
1657800380223,CSE 134B,A01,083661,Powell; Thomas Allan,24,0,100,76
1657800386252,CSE 140,A01,083663,Gungor; Onat,15,0,85,70
1657800392278,CSE 140L,A01,083088,Eldon; John,23,0,100,77
1657800398303,CSE 175,A01,083665,Kumar; Rakesh,3,0,25,22
1657800404329,CSE 190,A00,092507,Dubnov; Shlomo,8,0,20,12
1657800410364,ECE 45,A01,083139,Congero; Spencer William,6,0,75,69
1657800416392,ECE 65,A50,083695,Saad; Andrew S,12,0,30,18
1657800416392,ECE 65,A51,095125,Saad; Andrew S,24,0,26,2
1657800422419,ECE 109,A01,091882,Touri; Behrouz,20,0,70,50
1657800428444,ECE 180,A00,083140,Abi Samra; Nicholas Camill,1,0,30,29
1657800428444,ECE 180,B00,083141,Abi Samra; Nicholas Camill,0,0,30,30
1657800434499,MATH 10A,A01,083735,Patchell; Gregory David,2,0,30,28
1657800434499,MATH 10A,A02,083736,Patchell; Gregory David,20,0,30,10
1657800434499,MATH 10A,A03,083737,Patchell; Gregory David,16,0,30,14
1657800440541,MATH 10B,A01,083207,Lim; Seonhee,8,0,34,26
1657800440541,MATH 10B,A02,083208,Lim; Seonhee,10,0,35,25
1657800440541,MATH 10B,A03,093472,Lim; Seonhee,7,0,34,27
1657800440541,MATH 10B,B01,083739,Sinha; Shubham,13,0,30,17
1657800446569,MATH 18,A01,083743,Cinel; Cameron Alexander,9,0,30,21
1657800446569,MATH 18,A02,083744,Cinel; Cameron Alexander,18,0,30,12
1657800446569,MATH 18,A03,083745,Cinel; Cameron Alexander,10,0,30,20
1657800446569,MATH 18,B01,083748,Rideout; David Porter,5,0,37,32
1657800446569,MATH 18,B02,083749,Rideout; David Porter,5,0,36,31
1657800446569,MATH 18,B03,083750,Rideout; David Porter,3,0,37,34
1657800446569,MATH 18,B04,083751,Rideout; David Porter,6,0,36,30
1657800446569,MATH 18,B05,093473,Rideout; David Porter,6,0,36,30
1657800446569,MATH 18,B06,093474,Rideout; David Porter,6,0,36,30
1657800452595,MATH 20A,A01,083754,Zheng; Zequn,14,0,40,26
1657800458629,MATH 20B,A01,083756,Briones; Jor-el Thomas Caparas,4,0,36,32
1657800458629,MATH 20B,A02,083757,Briones; Jor-el Thomas Caparas,1,0,36,35
1657800458629,MATH 20B,A03,093475,Briones; Jor-el Thomas Caparas,2,0,36,34
1657800464658,MATH 20C,A01,083760,Briones; Jor-el Thomas Caparas,1,0,35,34
1657800464658,MATH 20C,A02,083761,Briones; Jor-el Thomas Caparas,8,0,35,27
1657800464658,MATH 20C,A03,093476,Briones; Jor-el Thomas Caparas,0,1,36,36
1657800464658,MATH 20C,B01,083762,Bach; Quang Tran,1,0,30,29
1657800470695,MATH 20D,A01,083765,Tran; Brian Kha,5,0,30,25
1657800470695,MATH 20D,A02,083766,Tran; Brian Kha,5,0,30,25
1657800470695,MATH 20D,A03,083767,Tran; Brian Kha,5,0,30,25
1657800476725,MATH 20E,A01,083771,Ganguly; Soumya,10,0,32,22
1657800476725,MATH 20E,A02,083772,Ganguly; Soumya,6,0,32,26
1657800476725,MATH 20E,B01,083773,Ciotti; Benjamin,20,0,35,15
1657800476725,MATH 20E,B02,083774,Ciotti; Benjamin,18,0,35,17
1657800482765,MATH 103A,A01,083777,Greenfeld; Be'Eri,3,0,36,33
1657800482765,MATH 103A,A02,083778,Greenfeld; Be'Eri,5,0,36,31
1657800482765,MATH 103A,A03,093561,Greenfeld; Be'Eri,6,0,36,30
1657800482765,MATH 103A,B01,083779,Greenfeld; Be'Eri,7,0,36,29
1657800482765,MATH 103A,B02,083780,Greenfeld; Be'Eri,4,0,36,32
1657800482765,MATH 103A,B03,093562,Greenfeld; Be'Eri,3,0,36,33
1657800488792,MATH 105,A01,085443,Carter; Anne Toulson,15,0,35,20
1657800488792,MATH 105,A02,093477,Carter; Anne Toulson,20,0,35,15
1657800494820,MATH 109,A01,083213,Ganzberger; Geoffrey Michael,3,0,34,31
1657800494820,MATH 109,A02,083214,Ganzberger; Geoffrey Michael,4,0,34,30
1657800494820,MATH 109,A03,093478,Ganzberger; Geoffrey Michael,2,0,34,32
1657800494820,MATH 109,B01,083215,Ganzberger; Geoffrey Michael,1,0,32,31
1657800494820,MATH 109,B02,083216,Ganzberger; Geoffrey Michael,2,0,32,30
1657800494820,MATH 109,B03,093479,Ganzberger; Geoffrey Michael,8,0,32,24
1657800500856,MATH 142A,A01,083219,Chow; Bennett,7,0,32,25
1657800500856,MATH 142A,A02,083220,Chow; Bennett,10,0,32,22
1657800500856,MATH 142A,A03,093480,Chow; Bennett,9,0,32,23
1657800500856,MATH 142A,B03,093481,Chow; Bennett,8,0,32,24
1657800500856,MATH 142A,B04,093558,Chow; Bennett,13,0,32,19
1657800500856,MATH 142A,B05,093559,Chow; Bennett,6,0,32,26
1657800506886,MATH 193A,A01,083224,Rotar; Vladimir,8,0,34,26
1657800506886,MATH 193A,A02,083225,Rotar; Vladimir,9,0,34,25
1657800506886,MATH 193A,A03,083781,Rotar; Vladimir,5,0,34,29
1657800506886,MATH 193A,A04,083782,Rotar; Vladimir,10,0,34,24
1657800506886,MATH 193A,A05,093482,Rotar; Vladimir,10,0,34,24
1657800512925,MATH 197,001,091859,McAuley; Julian John,9999,0,9999,0
1657800512925,MATH 197,002,095566,Kedlaya; Kiran S.,9997,0,9999,2
1657800512925,MATH 197,003,095567,Xiao; Ming,9999,0,9999,0
1657800512925,MATH 197,004,095571,Perols; Johan Lars,9998,0,9999,1
1657800519987,COGS 9,A01,083615,Shannon; Kyle Michael,9,0,75,66
1657800526012,COGS 11,A01,083617,Boyle; Mary E. T.,23,0,48,25
1657800532037,COGS 13,A01,083071,Bastos; Amalia Pinkusfeld,11,0,71,60
1657800538075,COGS 14A,A01,092681,Semenuks; Arturs,5,1,100,95
1657800544110,COGS 14B,A01,083073,Cheng; Tzu-Han,6,0,63,57
1657800550134,COGS 17,A01,092677,Semenuks; Arturs,6,0,81,75
1657800556163,COGS 100,A01,083619,Allen; Michael Gordon,17,0,70,53
1657800562190,COGS 101A,A01,083621,Davis; Joshua Daniel,9,0,68,59
1657800568216,COGS 101B,A01,091572,Allen; Michael Gordon,12,0,65,53
1657800574243,COGS 101C,A01,083625,Delgado; Tania,17,0,35,18
1657800580273,COGS 107A,A01,083627,Boyle; Mary E. T.,14,0,60,46
1657800586299,COGS 118A,A01,083075,Gupta; Anjum,21,0,76,55
1657800592333,CSE 3,A50,083646,Miranda; Gregory Joseph,24,0,50,26
1657800598363,CSE 8A,A50,083650,Miranda; Gregory Joseph,17,1,56,39
1657800604389,CSE 11,A01,083080,Cao; Yingjun,6,15,40,34
1657800610433,CSE 12,A01,083652,Krause-Levy; Sophia Louisa,28,1,120,92
1657800616461,CSE 15L,A01,083654,Morris; Justin Loren,9,0,50,41
1657800616461,CSE 15L,A02,083655,Morris; Justin Loren,9,0,50,41
1657800622493,CSE 20,A01,083657,Tran; Khoa Dang,39,0,80,41
1657800628521,CSE 21,A01,095574,Bach; Quang Tran,22,0,48,26
1657800634554,CSE 30,A01,083084,Eldon; John,6,0,80,74
1657800634554,CSE 30,B01,095061,Bhaskar; Nishant,9,0,50,41
1657800640587,CSE 100,A01,083659,Cao; Yingjun,5,4,70,65
1657800646617,CSE 134B,A01,083661,Powell; Thomas Allan,24,0,100,76
1657800652647,CSE 140,A01,083663,Gungor; Onat,15,0,85,70
1657800658672,CSE 140L,A01,083088,Eldon; John,23,0,100,77
1657800664703,CSE 175,A01,083665,Kumar; Rakesh,3,0,25,22
1657800670733,CSE 190,A00,092507,Dubnov; Shlomo,8,0,20,12
1657800676765,ECE 45,A01,083139,Congero; Spencer William,6,0,75,69
1657800682793,ECE 65,A50,083695,Saad; Andrew S,12,0,30,18
1657800682793,ECE 65,A51,095125,Saad; Andrew S,24,0,26,2
1657800688818,ECE 109,A01,091882,Touri; Behrouz,20,0,70,50
1657800694850,ECE 180,A00,083140,Abi Samra; Nicholas Camill,1,0,30,29
1657800694850,ECE 180,B00,083141,Abi Samra; Nicholas Camill,0,0,30,30
1657800700894,MATH 10A,A01,083735,Patchell; Gregory David,2,0,30,28
1657800700894,MATH 10A,A02,083736,Patchell; Gregory David,20,0,30,10
1657800700894,MATH 10A,A03,083737,Patchell; Gregory David,16,0,30,14
1657800706929,MATH 10B,A01,083207,Lim; Seonhee,8,0,34,26
1657800706929,MATH 10B,A02,083208,Lim; Seonhee,10,0,35,25
1657800706929,MATH 10B,A03,093472,Lim; Seonhee,7,0,34,27
1657800706929,MATH 10B,B01,083739,Sinha; Shubham,13,0,30,17
1657800712964,MATH 18,A01,083743,Cinel; Cameron Alexander,9,0,30,21
1657800712964,MATH 18,A02,083744,Cinel; Cameron Alexander,18,0,30,12
1657800712964,MATH 18,A03,083745,Cinel; Cameron Alexander,10,0,30,20
1657800712964,MATH 18,B01,083748,Rideout; David Porter,5,0,37,32
1657800712964,MATH 18,B02,083749,Rideout; David Porter,5,0,36,31
1657800712964,MATH 18,B03,083750,Rideout; David Porter,3,0,37,34
1657800712964,MATH 18,B04,083751,Rideout; David Porter,6,0,36,30
1657800712964,MATH 18,B05,093473,Rideout; David Porter,6,0,36,30
1657800712964,MATH 18,B06,093474,Rideout; David Porter,6,0,36,30
1657800718989,MATH 20A,A01,083754,Zheng; Zequn,14,0,40,26
1657800725021,MATH 20B,A01,083756,Briones; Jor-el Thomas Caparas,4,0,36,32
1657800725021,MATH 20B,A02,083757,Briones; Jor-el Thomas Caparas,1,0,36,35
1657800725021,MATH 20B,A03,093475,Briones; Jor-el Thomas Caparas,2,0,36,34
1657800731049,MATH 20C,A01,083760,Briones; Jor-el Thomas Caparas,1,0,35,34
1657800731049,MATH 20C,A02,083761,Briones; Jor-el Thomas Caparas,8,0,35,27
1657800731049,MATH 20C,A03,093476,Briones; Jor-el Thomas Caparas,0,1,36,36
1657800731049,MATH 20C,B01,083762,Bach; Quang Tran,1,0,30,29
1657800737076,MATH 20D,A01,083765,Tran; Brian Kha,5,0,30,25
1657800737076,MATH 20D,A02,083766,Tran; Brian Kha,5,0,30,25
1657800737076,MATH 20D,A03,083767,Tran; Brian Kha,5,0,30,25
1657800743106,MATH 20E,A01,083771,Ganguly; Soumya,10,0,32,22
1657800743106,MATH 20E,A02,083772,Ganguly; Soumya,6,0,32,26
1657800743106,MATH 20E,B01,083773,Ciotti; Benjamin,20,0,35,15
1657800743106,MATH 20E,B02,083774,Ciotti; Benjamin,18,0,35,17
1657800749144,MATH 103A,A01,083777,Greenfeld; Be'Eri,3,0,36,33
1657800749144,MATH 103A,A02,083778,Greenfeld; Be'Eri,5,0,36,31
1657800749144,MATH 103A,A03,093561,Greenfeld; Be'Eri,6,0,36,30
1657800749144,MATH 103A,B01,083779,Greenfeld; Be'Eri,7,0,36,29
1657800749144,MATH 103A,B02,083780,Greenfeld; Be'Eri,4,0,36,32
1657800749144,MATH 103A,B03,093562,Greenfeld; Be'Eri,3,0,36,33
1657800755171,MATH 105,A01,085443,Carter; Anne Toulson,15,0,35,20
1657800755171,MATH 105,A02,093477,Carter; Anne Toulson,20,0,35,15
1657800761298,MATH 109,A01,083213,Ganzberger; Geoffrey Michael,3,0,34,31
1657800761298,MATH 109,A02,083214,Ganzberger; Geoffrey Michael,4,0,34,30
1657800761298,MATH 109,A03,093478,Ganzberger; Geoffrey Michael,2,0,34,32
1657800761298,MATH 109,B01,083215,Ganzberger; Geoffrey Michael,1,0,32,31
1657800761298,MATH 109,B02,083216,Ganzberger; Geoffrey Michael,2,0,32,30
1657800761298,MATH 109,B03,093479,Ganzberger; Geoffrey Michael,8,0,32,24
1657800767335,MATH 142A,A01,083219,Chow; Bennett,7,0,32,25
1657800767335,MATH 142A,A02,083220,Chow; Bennett,10,0,32,22
1657800767335,MATH 142A,A03,093480,Chow; Bennett,9,0,32,23
1657800767335,MATH 142A,B03,093481,Chow; Bennett,8,0,32,24
1657800767335,MATH 142A,B04,093558,Chow; Bennett,13,0,32,19
1657800767335,MATH 142A,B05,093559,Chow; Bennett,6,0,32,26
1657800773361,MATH 193A,A01,083224,Rotar; Vladimir,8,0,34,26
1657800773361,MATH 193A,A02,083225,Rotar; Vladimir,9,0,34,25
1657800773361,MATH 193A,A03,083781,Rotar; Vladimir,5,0,34,29
1657800773361,MATH 193A,A04,083782,Rotar; Vladimir,10,0,34,24
1657800773361,MATH 193A,A05,093482,Rotar; Vladimir,10,0,34,24
1657800779388,MATH 197,001,091859,McAuley; Julian John,9999,0,9999,0
1657800779388,MATH 197,002,095566,Kedlaya; Kiran S.,9997,0,9999,2
1657800779388,MATH 197,003,095567,Xiao; Ming,9999,0,9999,0
1657800779388,MATH 197,004,095571,Perols; Johan Lars,9998,0,9999,1
1657800786452,COGS 9,A01,083615,Shannon; Kyle Michael,9,0,75,66
1657800792480,COGS 11,A01,083617,Boyle; Mary E. T.,23,0,48,25
1657800798507,COGS 13,A01,083071,Bastos; Amalia Pinkusfeld,11,0,71,60
1657800804534,COGS 14A,A01,092681,Semenuks; Arturs,5,1,100,95
1657800810564,COGS 14B,A01,083073,Cheng; Tzu-Han,6,0,63,57
1657800816592,COGS 17,A01,092677,Semenuks; Arturs,6,0,81,75
1657800822627,COGS 100,A01,083619,Allen; Michael Gordon,17,0,70,53
1657800828652,COGS 101A,A01,083621,Davis; Joshua Daniel,9,0,68,59
1657800834678,COGS 101B,A01,091572,Allen; Michael Gordon,12,0,65,53
1657800840703,COGS 101C,A01,083625,Delgado; Tania,17,0,35,18
1657800846731,COGS 107A,A01,083627,Boyle; Mary E. T.,14,0,60,46
1657800852762,COGS 118A,A01,083075,Gupta; Anjum,21,0,76,55
1657800858796,CSE 3,A50,083646,Miranda; Gregory Joseph,24,0,50,26
1657800864820,CSE 8A,A50,083650,Miranda; Gregory Joseph,17,1,56,39
1657800870845,CSE 11,A01,083080,Cao; Yingjun,6,15,40,34
1657800876879,CSE 12,A01,083652,Krause-Levy; Sophia Louisa,28,1,120,92
1657800882908,CSE 15L,A01,083654,Morris; Justin Loren,9,0,50,41
1657800882908,CSE 15L,A02,083655,Morris; Justin Loren,9,0,50,41
1657800888935,CSE 20,A01,083657,Tran; Khoa Dang,39,0,80,41
1657800894960,CSE 21,A01,095574,Bach; Quang Tran,22,0,48,26
1657800900986,CSE 30,A01,083084,Eldon; John,6,0,80,74
1657800900986,CSE 30,B01,095061,Bhaskar; Nishant,9,0,50,41
1657800907011,CSE 100,A01,083659,Cao; Yingjun,5,4,70,65
1657800913037,CSE 134B,A01,083661,Powell; Thomas Allan,24,0,100,76
1657800919061,CSE 140,A01,083663,Gungor; Onat,15,0,85,70
1657800925090,CSE 140L,A01,083088,Eldon; John,23,0,100,77
1657800931122,CSE 175,A01,083665,Kumar; Rakesh,3,0,25,22
1657800937148,CSE 190,A00,092507,Dubnov; Shlomo,8,0,20,12
1657800943180,ECE 45,A01,083139,Congero; Spencer William,6,0,75,69
1657800949213,ECE 65,A50,083695,Saad; Andrew S,12,0,30,18
1657800949213,ECE 65,A51,095125,Saad; Andrew S,24,0,26,2
1657800955247,ECE 109,A01,091882,Touri; Behrouz,20,0,70,50
1657800961278,ECE 180,A00,083140,Abi Samra; Nicholas Camill,1,0,30,29
1657800961278,ECE 180,B00,083141,Abi Samra; Nicholas Camill,0,0,30,30
1657800967307,MATH 10A,A01,083735,Patchell; Gregory David,2,0,30,28
1657800967307,MATH 10A,A02,083736,Patchell; Gregory David,20,0,30,10
1657800967307,MATH 10A,A03,083737,Patchell; Gregory David,16,0,30,14
1657800973345,MATH 10B,A01,083207,Lim; Seonhee,8,0,34,26
1657800973345,MATH 10B,A02,083208,Lim; Seonhee,10,0,35,25
1657800973345,MATH 10B,A03,093472,Lim; Seonhee,7,0,34,27
1657800973345,MATH 10B,B01,083739,Sinha; Shubham,13,0,30,17
1657800979374,MATH 18,A01,083743,Cinel; Cameron Alexander,9,0,30,21
1657800979374,MATH 18,A02,083744,Cinel; Cameron Alexander,18,0,30,12
1657800979374,MATH 18,A03,083745,Cinel; Cameron Alexander,10,0,30,20
1657800979374,MATH 18,B01,083748,Rideout; David Porter,5,0,37,32
1657800979374,MATH 18,B02,083749,Rideout; David Porter,5,0,36,31
1657800979374,MATH 18,B03,083750,Rideout; David Porter,3,0,37,34
1657800979374,MATH 18,B04,083751,Rideout; David Porter,6,0,36,30
1657800979374,MATH 18,B05,093473,Rideout; David Porter,6,0,36,30
1657800979374,MATH 18,B06,093474,Rideout; David Porter,6,0,36,30
1657800985400,MATH 20A,A01,083754,Zheng; Zequn,14,0,40,26
1657800991426,MATH 20B,A01,083756,Briones; Jor-el Thomas Caparas,4,0,36,32
1657800991426,MATH 20B,A02,083757,Briones; Jor-el Thomas Caparas,1,0,36,35
1657800991426,MATH 20B,A03,093475,Briones; Jor-el Thomas Caparas,2,0,36,34
1657800997452,MATH 20C,A01,083760,Briones; Jor-el Thomas Caparas,1,0,35,34
1657800997452,MATH 20C,A02,083761,Briones; Jor-el Thomas Caparas,8,0,35,27
1657800997452,MATH 20C,A03,093476,Briones; Jor-el Thomas Caparas,0,1,36,36
1657800997452,MATH 20C,B01,083762,Bach; Quang Tran,1,0,30,29
1657801003484,MATH 20D,A01,083765,Tran; Brian Kha,5,0,30,25
1657801003484,MATH 20D,A02,083766,Tran; Brian Kha,5,0,30,25
1657801003484,MATH 20D,A03,083767,Tran; Brian Kha,5,0,30,25
1657801009515,MATH 20E,A01,083771,Ganguly; Soumya,10,0,32,22
1657801009515,MATH 20E,A02,083772,Ganguly; Soumya,6,0,32,26
1657801009515,MATH 20E,B01,083773,Ciotti; Benjamin,20,0,35,15
1657801009515,MATH 20E,B02,083774,Ciotti; Benjamin,18,0,35,17
1657801015543,MATH 103A,A01,083777,Greenfeld; Be'Eri,3,0,36,33
1657801015543,MATH 103A,A02,083778,Greenfeld; Be'Eri,5,0,36,31
1657801015543,MATH 103A,A03,093561,Greenfeld; Be'Eri,6,0,36,30
1657801015543,MATH 103A,B01,083779,Greenfeld; Be'Eri,7,0,36,29
1657801015543,MATH 103A,B02,083780,Greenfeld; Be'Eri,4,0,36,32
1657801015543,MATH 103A,B03,093562,Greenfeld; Be'Eri,3,0,36,33
1657801021568,MATH 105,A01,085443,Carter; Anne Toulson,15,0,35,20
1657801021568,MATH 105,A02,093477,Carter; Anne Toulson,20,0,35,15
1657801027596,MATH 109,A01,083213,Ganzberger; Geoffrey Michael,3,0,34,31
1657801027596,MATH 109,A02,083214,Ganzberger; Geoffrey Michael,4,0,34,30
1657801027596,MATH 109,A03,093478,Ganzberger; Geoffrey Michael,2,0,34,32
1657801027596,MATH 109,B01,083215,Ganzberger; Geoffrey Michael,1,0,32,31
1657801027596,MATH 109,B02,083216,Ganzberger; Geoffrey Michael,2,0,32,30
1657801027596,MATH 109,B03,093479,Ganzberger; Geoffrey Michael,8,0,32,24
1657801033631,MATH 142A,A01,083219,Chow; Bennett,7,0,32,25
1657801033631,MATH 142A,A02,083220,Chow; Bennett,10,0,32,22
1657801033631,MATH 142A,A03,093480,Chow; Bennett,9,0,32,23
1657801033631,MATH 142A,B03,093481,Chow; Bennett,8,0,32,24
1657801033631,MATH 142A,B04,093558,Chow; Bennett,13,0,32,19
1657801033631,MATH 142A,B05,093559,Chow; Bennett,6,0,32,26
1657801039666,MATH 193A,A01,083224,Rotar; Vladimir,8,0,34,26
1657801039666,MATH 193A,A02,083225,Rotar; Vladimir,9,0,34,25
1657801039666,MATH 193A,A03,083781,Rotar; Vladimir,5,0,34,29
1657801039666,MATH 193A,A04,083782,Rotar; Vladimir,10,0,34,24
1657801039666,MATH 193A,A05,093482,Rotar; Vladimir,10,0,34,24
1657801045698,MATH 197,001,091859,McAuley; Julian John,9999,0,9999,0
1657801045698,MATH 197,002,095566,Kedlaya; Kiran S.,9997,0,9999,2
1657801045698,MATH 197,003,095567,Xiao; Ming,9999,0,9999,0
1657801045698,MATH 197,004,095571,Perols; Johan Lars,9998,0,9999,1
1657801052795,COGS 9,A01,083615,Shannon; Kyle Michael,9,0,75,66
1657801058822,COGS 11,A01,083617,Boyle; Mary E. T.,23,0,48,25
1657801064853,COGS 13,A01,083071,Bastos; Amalia Pinkusfeld,11,0,71,60
1657801070885,COGS 14A,A01,092681,Semenuks; Arturs,5,1,100,95
1657801076917,COGS 14B,A01,083073,Cheng; Tzu-Han,6,0,63,57
1657801082941,COGS 17,A01,092677,Semenuks; Arturs,6,0,81,75
1657801088966,COGS 100,A01,083619,Allen; Michael Gordon,17,0,70,53
1657801094997,COGS 101A,A01,083621,Davis; Joshua Daniel,9,0,68,59
1657801101022,COGS 101B,A01,091572,Allen; Michael Gordon,12,0,65,53
1657801107058,COGS 101C,A01,083625,Delgado; Tania,17,0,35,18
1657801113081,COGS 107A,A01,083627,Boyle; Mary E. T.,14,0,60,46
1657801119114,COGS 118A,A01,083075,Gupta; Anjum,21,0,76,55
1657801125142,CSE 3,A50,083646,Miranda; Gregory Joseph,24,0,50,26
1657801131171,CSE 8A,A50,083650,Miranda; Gregory Joseph,17,1,56,39
1657801137195,CSE 11,A01,083080,Cao; Yingjun,6,15,40,34
1657801143225,CSE 12,A01,083652,Krause-Levy; Sophia Louisa,28,1,120,92
1657801149256,CSE 15L,A01,083654,Morris; Justin Loren,9,0,50,41
1657801149256,CSE 15L,A02,083655,Morris; Justin Loren,9,0,50,41
1657801155286,CSE 20,A01,083657,Tran; Khoa Dang,39,0,80,41
1657801161317,CSE 21,A01,095574,Bach; Quang Tran,22,0,48,26
1657801167346,CSE 30,A01,083084,Eldon; John,6,0,80,74
1657801167346,CSE 30,B01,095061,Bhaskar; Nishant,9,0,50,41
1657801173374,CSE 100,A01,083659,Cao; Yingjun,5,4,70,65
1657801179405,CSE 134B,A01,083661,Powell; Thomas Allan,24,0,100,76
1657801185436,CSE 140,A01,083663,Gungor; Onat,15,0,85,70
1657801191462,CSE 140L,A01,083088,Eldon; John,23,0,100,77
1657801197493,CSE 175,A01,083665,Kumar; Rakesh,3,0,25,22
1657801203532,CSE 190,A00,092507,Dubnov; Shlomo,8,0,20,12
1657801209559,ECE 45,A01,083139,Congero; Spencer William,6,0,75,69
1657801215593,ECE 65,A50,083695,Saad; Andrew S,12,0,30,18
1657801215593,ECE 65,A51,095125,Saad; Andrew S,24,0,26,2
1657801221624,ECE 109,A01,091882,Touri; Behrouz,20,0,70,50
1657801227654,ECE 180,A00,083140,Abi Samra; Nicholas Camill,1,0,30,29
1657801227654,ECE 180,B00,083141,Abi Samra; Nicholas Camill,0,0,30,30
1657801233689,MATH 10A,A01,083735,Patchell; Gregory David,2,0,30,28
1657801233689,MATH 10A,A02,083736,Patchell; Gregory David,20,0,30,10
1657801233689,MATH 10A,A03,083737,Patchell; Gregory David,16,0,30,14
1657801239718,MATH 10B,A01,083207,Lim; Seonhee,8,0,34,26
1657801239718,MATH 10B,A02,083208,Lim; Seonhee,10,0,35,25
1657801239718,MATH 10B,A03,093472,Lim; Seonhee,7,0,34,27
1657801239718,MATH 10B,B01,083739,Sinha; Shubham,13,0,30,17
1657801245758,MATH 18,A01,083743,Cinel; Cameron Alexander,9,0,30,21
1657801245758,MATH 18,A02,083744,Cinel; Cameron Alexander,18,0,30,12
1657801245758,MATH 18,A03,083745,Cinel; Cameron Alexander,10,0,30,20
1657801245758,MATH 18,B01,083748,Rideout; David Porter,5,0,37,32
1657801245758,MATH 18,B02,083749,Rideout; David Porter,5,0,36,31
1657801245758,MATH 18,B03,083750,Rideout; David Porter,3,0,37,34
1657801245758,MATH 18,B04,083751,Rideout; David Porter,6,0,36,30
1657801245758,MATH 18,B05,093473,Rideout; David Porter,6,0,36,30
1657801245758,MATH 18,B06,093474,Rideout; David Porter,6,0,36,30
1657801251787,MATH 20A,A01,083754,Zheng; Zequn,14,0,40,26
1657801257816,MATH 20B,A01,083756,Briones; Jor-el Thomas Caparas,4,0,36,32
1657801257816,MATH 20B,A02,083757,Briones; Jor-el Thomas Caparas,1,0,36,35
1657801257816,MATH 20B,A03,093475,Briones; Jor-el Thomas Caparas,2,0,36,34
1657801263841,MATH 20C,A01,083760,Briones; Jor-el Thomas Caparas,1,0,35,34
1657801263841,MATH 20C,A02,083761,Briones; Jor-el Thomas Caparas,8,0,35,27
1657801263841,MATH 20C,A03,093476,Briones; Jor-el Thomas Caparas,0,1,36,36
1657801263841,MATH 20C,B01,083762,Bach; Quang Tran,1,0,30,29
1657801269884,MATH 20D,A01,083765,Tran; Brian Kha,5,0,30,25
1657801269884,MATH 20D,A02,083766,Tran; Brian Kha,5,0,30,25
1657801269884,MATH 20D,A03,083767,Tran; Brian Kha,5,0,30,25
1657801275912,MATH 20E,A01,083771,Ganguly; Soumya,10,0,32,22
1657801275912,MATH 20E,A02,083772,Ganguly; Soumya,6,0,32,26
1657801275912,MATH 20E,B01,083773,Ciotti; Benjamin,20,0,35,15
1657801275912,MATH 20E,B02,083774,Ciotti; Benjamin,18,0,35,17
1657801281947,MATH 103A,A01,083777,Greenfeld; Be'Eri,3,0,36,33
1657801281947,MATH 103A,A02,083778,Greenfeld; Be'Eri,5,0,36,31
1657801281947,MATH 103A,A03,093561,Greenfeld; Be'Eri,6,0,36,30
1657801281947,MATH 103A,B01,083779,Greenfeld; Be'Eri,7,0,36,29
1657801281947,MATH 103A,B02,083780,Greenfeld; Be'Eri,4,0,36,32
1657801281947,MATH 103A,B03,093562,Greenfeld; Be'Eri,3,0,36,33
1657801287976,MATH 105,A01,085443,Carter; Anne Toulson,15,0,35,20
1657801287976,MATH 105,A02,093477,Carter; Anne Toulson,20,0,35,15
1657801294004,MATH 109,A01,083213,Ganzberger; Geoffrey Michael,3,0,34,31
1657801294004,MATH 109,A02,083214,Ganzberger; Geoffrey Michael,4,0,34,30
1657801294004,MATH 109,A03,093478,Ganzberger; Geoffrey Michael,2,0,34,32
1657801294004,MATH 109,B01,083215,Ganzberger; Geoffrey Michael,1,0,32,31
1657801294004,MATH 109,B02,083216,Ganzberger; Geoffrey Michael,2,0,32,30
1657801294004,MATH 109,B03,093479,Ganzberger; Geoffrey Michael,8,0,32,24
1657801300037,MATH 142A,A01,083219,Chow; Bennett,7,0,32,25
1657801300037,MATH 142A,A02,083220,Chow; Bennett,10,0,32,22
1657801300037,MATH 142A,A03,093480,Chow; Bennett,9,0,32,23
1657801300037,MATH 142A,B03,093481,Chow; Bennett,8,0,32,24
1657801300037,MATH 142A,B04,093558,Chow; Bennett,13,0,32,19
1657801300037,MATH 142A,B05,093559,Chow; Bennett,6,0,32,26
1657801306065,MATH 193A,A01,083224,Rotar; Vladimir,8,0,34,26
1657801306065,MATH 193A,A02,083225,Rotar; Vladimir,9,0,34,25
1657801306065,MATH 193A,A03,083781,Rotar; Vladimir,5,0,34,29
1657801306065,MATH 193A,A04,083782,Rotar; Vladimir,10,0,34,24
1657801306065,MATH 193A,A05,093482,Rotar; Vladimir,10,0,34,24
1657801312091,MATH 197,001,091859,McAuley; Julian John,9999,0,9999,0
1657801312091,MATH 197,002,095566,Kedlaya; Kiran S.,9997,0,9999,2
1657801312091,MATH 197,003,095567,Xiao; Ming,9999,0,9999,0
1657801312091,MATH 197,004,095571,Perols; Johan Lars,9998,0,9999,1
1657801319175,COGS 9,A01,083615,Shannon; Kyle Michael,9,0,75,66
1657801325207,COGS 11,A01,083617,Boyle; Mary E. T.,23,0,48,25
1657801331238,COGS 13,A01,083071,Bastos; Amalia Pinkusfeld,11,0,71,60
1657801337270,COGS 14A,A01,092681,Semenuks; Arturs,5,1,100,95
1657801343296,COGS 14B,A01,083073,Cheng; Tzu-Han,6,0,63,57
1657801349323,COGS 17,A01,092677,Semenuks; Arturs,6,0,81,75
1657801355437,COGS 100,A01,083619,Allen; Michael Gordon,17,0,70,53
1657801361469,COGS 101A,A01,083621,Davis; Joshua Daniel,9,0,68,59
1657801367500,COGS 101B,A01,091572,Allen; Michael Gordon,12,0,65,53
1657801373526,COGS 101C,A01,083625,Delgado; Tania,17,0,35,18
1657801379552,COGS 107A,A01,083627,Boyle; Mary E. T.,14,0,60,46
1657801385577,COGS 118A,A01,083075,Gupta; Anjum,21,0,76,55
1657801391604,CSE 3,A50,083646,Miranda; Gregory Joseph,24,0,50,26
1657801397628,CSE 8A,A50,083650,Miranda; Gregory Joseph,17,1,56,39
1657801403658,CSE 11,A01,083080,Cao; Yingjun,6,15,40,34
1657801409684,CSE 12,A01,083652,Krause-Levy; Sophia Louisa,28,1,120,92
1657801415714,CSE 15L,A01,083654,Morris; Justin Loren,9,0,50,41
1657801415714,CSE 15L,A02,083655,Morris; Justin Loren,9,0,50,41
1657801421740,CSE 20,A01,083657,Tran; Khoa Dang,39,0,80,41
1657801427772,CSE 21,A01,095574,Bach; Quang Tran,22,0,48,26
1657801433812,CSE 30,A01,083084,Eldon; John,6,0,80,74
1657801433812,CSE 30,B01,095061,Bhaskar; Nishant,9,0,50,41
1657801439843,CSE 100,A01,083659,Cao; Yingjun,5,4,70,65
1657801445870,CSE 134B,A01,083661,Powell; Thomas Allan,24,0,100,76
1657801451898,CSE 140,A01,083663,Gungor; Onat,15,0,85,70
1657801457930,CSE 140L,A01,083088,Eldon; John,23,0,100,77
1657801463958,CSE 175,A01,083665,Kumar; Rakesh,3,0,25,22
1657801469988,CSE 190,A00,092507,Dubnov; Shlomo,8,0,20,12
1657801476029,ECE 45,A01,083139,Congero; Spencer William,6,0,75,69
1657801482057,ECE 65,A50,083695,Saad; Andrew S,12,0,30,18
1657801482057,ECE 65,A51,095125,Saad; Andrew S,24,0,26,2
1657801488088,ECE 109,A01,091882,Touri; Behrouz,20,0,70,50
1657801494113,ECE 180,A00,083140,Abi Samra; Nicholas Camill,1,0,30,29
1657801494113,ECE 180,B00,083141,Abi Samra; Nicholas Camill,0,0,30,30
1657801500146,MATH 10A,A01,083735,Patchell; Gregory David,2,0,30,28
1657801500146,MATH 10A,A02,083736,Patchell; Gregory David,20,0,30,10
1657801500146,MATH 10A,A03,083737,Patchell; Gregory David,16,0,30,14
1657801506182,MATH 10B,A01,083207,Lim; Seonhee,8,0,34,26
1657801506182,MATH 10B,A02,083208,Lim; Seonhee,10,0,35,25
1657801506182,MATH 10B,A03,093472,Lim; Seonhee,7,0,34,27
1657801506182,MATH 10B,B01,083739,Sinha; Shubham,13,0,30,17
1657801512219,MATH 18,A01,083743,Cinel; Cameron Alexander,9,0,30,21
1657801512219,MATH 18,A02,083744,Cinel; Cameron Alexander,18,0,30,12
1657801512219,MATH 18,A03,083745,Cinel; Cameron Alexander,10,0,30,20
1657801512219,MATH 18,B01,083748,Rideout; David Porter,5,0,37,32
1657801512219,MATH 18,B02,083749,Rideout; David Porter,5,0,36,31
1657801512219,MATH 18,B03,083750,Rideout; David Porter,3,0,37,34
1657801512219,MATH 18,B04,083751,Rideout; David Porter,6,0,36,30
1657801512219,MATH 18,B05,093473,Rideout; David Porter,6,0,36,30
1657801512219,MATH 18,B06,093474,Rideout; David Porter,6,0,36,30
1657801518252,MATH 20A,A01,083754,Zheng; Zequn,14,0,40,26
1657801524278,MATH 20B,A01,083756,Briones; Jor-el Thomas Caparas,4,0,36,32
1657801524278,MATH 20B,A02,083757,Briones; Jor-el Thomas Caparas,1,0,36,35
1657801524278,MATH 20B,A03,093475,Briones; Jor-el Thomas Caparas,2,0,36,34
1657801530313,MATH 20C,A01,083760,Briones; Jor-el Thomas Caparas,1,0,35,34
1657801530313,MATH 20C,A02,083761,Briones; Jor-el Thomas Caparas,8,0,35,27
1657801530313,MATH 20C,A03,093476,Briones; Jor-el Thomas Caparas,0,1,36,36
1657801530313,MATH 20C,B01,083762,Bach; Quang Tran,1,0,30,29
1657801536349,MATH 20D,A01,083765,Tran; Brian Kha,5,0,30,25
1657801536349,MATH 20D,A02,083766,Tran; Brian Kha,5,0,30,25
1657801536349,MATH 20D,A03,083767,Tran; Brian Kha,5,0,30,25
1657801542381,MATH 20E,A01,083771,Ganguly; Soumya,10,0,32,22
1657801542381,MATH 20E,A02,083772,Ganguly; Soumya,6,0,32,26
1657801542381,MATH 20E,B01,083773,Ciotti; Benjamin,20,0,35,15
1657801542381,MATH 20E,B02,083774,Ciotti; Benjamin,18,0,35,17
1657801548407,MATH 103A,A01,083777,Greenfeld; Be'Eri,3,0,36,33
1657801548407,MATH 103A,A02,083778,Greenfeld; Be'Eri,5,0,36,31
1657801548407,MATH 103A,A03,093561,Greenfeld; Be'Eri,6,0,36,30
1657801548407,MATH 103A,B01,083779,Greenfeld; Be'Eri,7,0,36,29
1657801548407,MATH 103A,B02,083780,Greenfeld; Be'Eri,4,0,36,32
1657801548407,MATH 103A,B03,093562,Greenfeld; Be'Eri,3,0,36,33
1657801554437,MATH 105,A01,085443,Carter; Anne Toulson,15,0,35,20
1657801554437,MATH 105,A02,093477,Carter; Anne Toulson,20,0,35,15
1657801560473,MATH 109,A01,083213,Ganzberger; Geoffrey Michael,3,0,34,31
1657801560473,MATH 109,A02,083214,Ganzberger; Geoffrey Michael,4,0,34,30
1657801560473,MATH 109,A03,093478,Ganzberger; Geoffrey Michael,2,0,34,32
1657801560473,MATH 109,B01,083215,Ganzberger; Geoffrey Michael,1,0,32,31
1657801560473,MATH 109,B02,083216,Ganzberger; Geoffrey Michael,2,0,32,30
1657801560473,MATH 109,B03,093479,Ganzberger; Geoffrey Michael,8,0,32,24
1657801566501,MATH 142A,A01,083219,Chow; Bennett,7,0,32,25
1657801566501,MATH 142A,A02,083220,Chow; Bennett,10,0,32,22
1657801566501,MATH 142A,A03,093480,Chow; Bennett,9,0,32,23
1657801566501,MATH 142A,B03,093481,Chow; Bennett,8,0,32,24
1657801566501,MATH 142A,B04,093558,Chow; Bennett,13,0,32,19
1657801566501,MATH 142A,B05,093559,Chow; Bennett,6,0,32,26
1657801572529,MATH 193A,A01,083224,Rotar; Vladimir,8,0,34,26
1657801572529,MATH 193A,A02,083225,Rotar; Vladimir,9,0,34,25
1657801572529,MATH 193A,A03,083781,Rotar; Vladimir,5,0,34,29
1657801572529,MATH 193A,A04,083782,Rotar; Vladimir,10,0,34,24
1657801572529,MATH 193A,A05,093482,Rotar; Vladimir,10,0,34,24
1657801578554,MATH 197,001,091859,McAuley; Julian John,9999,0,9999,0
1657801578554,MATH 197,002,095566,Kedlaya; Kiran S.,9997,0,9999,2
1657801578554,MATH 197,003,095567,Xiao; Ming,9999,0,9999,0
1657801578554,MATH 197,004,095571,Perols; Johan Lars,9998,0,9999,1
1657801585618,COGS 9,A01,083615,Shannon; Kyle Michael,9,0,75,66
1657801591643,COGS 11,A01,083617,Boyle; Mary E. T.,23,0,48,25
1657801597677,COGS 13,A01,083071,Bastos; Amalia Pinkusfeld,11,0,71,60
1657801603702,COGS 14A,A01,092681,Semenuks; Arturs,5,1,100,95
1657801609728,COGS 14B,A01,083073,Cheng; Tzu-Han,6,0,63,57
1657801615754,COGS 17,A01,092677,Semenuks; Arturs,6,0,81,75
1657801621777,COGS 100,A01,083619,Allen; Michael Gordon,17,0,70,53
1657801627800,COGS 101A,A01,083621,Davis; Joshua Daniel,9,0,68,59
1657801633828,COGS 101B,A01,091572,Allen; Michael Gordon,12,0,65,53
1657801639857,COGS 101C,A01,083625,Delgado; Tania,17,0,35,18
1657801645884,COGS 107A,A01,083627,Boyle; Mary E. T.,14,0,60,46
1657801651912,COGS 118A,A01,083075,Gupta; Anjum,21,0,76,55
1657801657942,CSE 3,A50,083646,Miranda; Gregory Joseph,24,0,50,26
1657801663974,CSE 8A,A50,083650,Miranda; Gregory Joseph,17,1,56,39
1657801669997,CSE 11,A01,083080,Cao; Yingjun,6,15,40,34
1657801676023,CSE 12,A01,083652,Krause-Levy; Sophia Louisa,28,1,120,92
1657801682048,CSE 15L,A01,083654,Morris; Justin Loren,9,0,50,41
1657801682048,CSE 15L,A02,083655,Morris; Justin Loren,9,0,50,41
1657801688074,CSE 20,A01,083657,Tran; Khoa Dang,39,0,80,41
1657801694107,CSE 21,A01,095574,Bach; Quang Tran,22,0,48,26
1657801700144,CSE 30,A01,083084,Eldon; John,6,0,80,74
1657801700144,CSE 30,B01,095061,Bhaskar; Nishant,9,0,50,41
1657801706171,CSE 100,A01,083659,Cao; Yingjun,5,4,70,65
1657801712202,CSE 134B,A01,083661,Powell; Thomas Allan,24,0,100,76
1657801718228,CSE 140,A01,083663,Gungor; Onat,15,0,85,70
1657801724257,CSE 140L,A01,083088,Eldon; John,23,0,100,77
1657801730284,CSE 175,A01,083665,Kumar; Rakesh,3,0,25,22
1657801736309,CSE 190,A00,092507,Dubnov; Shlomo,8,0,20,12
1657801742337,ECE 45,A01,083139,Congero; Spencer William,6,0,75,69
1657801748363,ECE 65,A50,083695,Saad; Andrew S,12,0,30,18
1657801748363,ECE 65,A51,095125,Saad; Andrew S,24,0,26,2
1657801754388,ECE 109,A01,091882,Touri; Behrouz,20,0,70,50
1657801760416,ECE 180,A00,083140,Abi Samra; Nicholas Camill,1,0,30,29
1657801760416,ECE 180,B00,083141,Abi Samra; Nicholas Camill,0,0,30,30
1657801766450,MATH 10A,A01,083735,Patchell; Gregory David,2,0,30,28
1657801766450,MATH 10A,A02,083736,Patchell; Gregory David,20,0,30,10
1657801766450,MATH 10A,A03,083737,Patchell; Gregory David,16,0,30,14
1657801772477,MATH 10B,A01,083207,Lim; Seonhee,8,0,34,26
1657801772477,MATH 10B,A02,083208,Lim; Seonhee,10,0,35,25
1657801772477,MATH 10B,A03,093472,Lim; Seonhee,7,0,34,27
1657801772477,MATH 10B,B01,083739,Sinha; Shubham,13,0,30,17
1657801778507,MATH 18,A01,083743,Cinel; Cameron Alexander,9,0,30,21
1657801778507,MATH 18,A02,083744,Cinel; Cameron Alexander,18,0,30,12
1657801778507,MATH 18,A03,083745,Cinel; Cameron Alexander,10,0,30,20
1657801778507,MATH 18,B01,083748,Rideout; David Porter,5,0,37,32
1657801778507,MATH 18,B02,083749,Rideout; David Porter,5,0,36,31
1657801778507,MATH 18,B03,083750,Rideout; David Porter,3,0,37,34
1657801778507,MATH 18,B04,083751,Rideout; David Porter,6,0,36,30
1657801778507,MATH 18,B05,093473,Rideout; David Porter,6,0,36,30
1657801778507,MATH 18,B06,093474,Rideout; David Porter,6,0,36,30
1657801784533,MATH 20A,A01,083754,Zheng; Zequn,14,0,40,26
1657801790569,MATH 20B,A01,083756,Briones; Jor-el Thomas Caparas,4,0,36,32
1657801790569,MATH 20B,A02,083757,Briones; Jor-el Thomas Caparas,1,0,36,35
1657801790569,MATH 20B,A03,093475,Briones; Jor-el Thomas Caparas,2,0,36,34
1657801796599,MATH 20C,A01,083760,Briones; Jor-el Thomas Caparas,1,0,35,34
1657801796599,MATH 20C,A02,083761,Briones; Jor-el Thomas Caparas,8,0,35,27
1657801796599,MATH 20C,A03,093476,Briones; Jor-el Thomas Caparas,0,1,36,36
1657801796599,MATH 20C,B01,083762,Bach; Quang Tran,1,0,30,29
1657801802628,MATH 20D,A01,083765,Tran; Brian Kha,5,0,30,25
1657801802628,MATH 20D,A02,083766,Tran; Brian Kha,5,0,30,25
1657801802628,MATH 20D,A03,083767,Tran; Brian Kha,5,0,30,25
1657801808657,MATH 20E,A01,083771,Ganguly; Soumya,10,0,32,22
1657801808657,MATH 20E,A02,083772,Ganguly; Soumya,6,0,32,26
1657801808657,MATH 20E,B01,083773,Ciotti; Benjamin,20,0,35,15
1657801808657,MATH 20E,B02,083774,Ciotti; Benjamin,18,0,35,17
1657801814689,MATH 103A,A01,083777,Greenfeld; Be'Eri,3,0,36,33
1657801814689,MATH 103A,A02,083778,Greenfeld; Be'Eri,5,0,36,31
1657801814689,MATH 103A,A03,093561,Greenfeld; Be'Eri,6,0,36,30
1657801814689,MATH 103A,B01,083779,Greenfeld; Be'Eri,7,0,36,29
1657801814689,MATH 103A,B02,083780,Greenfeld; Be'Eri,4,0,36,32
1657801814689,MATH 103A,B03,093562,Greenfeld; Be'Eri,3,0,36,33
1657801820713,MATH 105,A01,085443,Carter; Anne Toulson,15,0,35,20
1657801820713,MATH 105,A02,093477,Carter; Anne Toulson,20,0,35,15
1657801826738,MATH 109,A01,083213,Ganzberger; Geoffrey Michael,3,0,34,31
1657801826738,MATH 109,A02,083214,Ganzberger; Geoffrey Michael,4,0,34,30
1657801826738,MATH 109,A03,093478,Ganzberger; Geoffrey Michael,2,0,34,32
1657801826738,MATH 109,B01,083215,Ganzberger; Geoffrey Michael,1,0,32,31
1657801826738,MATH 109,B02,083216,Ganzberger; Geoffrey Michael,2,0,32,30
1657801826738,MATH 109,B03,093479,Ganzberger; Geoffrey Michael,8,0,32,24
1657801832761,MATH 142A,A01,083219,Chow; Bennett,7,0,32,25
1657801832761,MATH 142A,A02,083220,Chow; Bennett,10,0,32,22
1657801832761,MATH 142A,A03,093480,Chow; Bennett,9,0,32,23
1657801832761,MATH 142A,B03,093481,Chow; Bennett,8,0,32,24
1657801832761,MATH 142A,B04,093558,Chow; Bennett,13,0,32,19
1657801832761,MATH 142A,B05,093559,Chow; Bennett,6,0,32,26
1657801838791,MATH 193A,A01,083224,Rotar; Vladimir,8,0,34,26
1657801838791,MATH 193A,A02,083225,Rotar; Vladimir,9,0,34,25
1657801838791,MATH 193A,A03,083781,Rotar; Vladimir,5,0,34,29
1657801838791,MATH 193A,A04,083782,Rotar; Vladimir,10,0,34,24
1657801838791,MATH 193A,A05,093482,Rotar; Vladimir,10,0,34,24
1657801844822,MATH 197,001,091859,McAuley; Julian John,9999,0,9999,0
1657801844822,MATH 197,002,095566,Kedlaya; Kiran S.,9997,0,9999,2
1657801844822,MATH 197,003,095567,Xiao; Ming,9999,0,9999,0
1657801844822,MATH 197,004,095571,Perols; Johan Lars,9998,0,9999,1
1657801851888,COGS 9,A01,083615,Shannon; Kyle Michael,9,0,75,66
1657801857914,COGS 11,A01,083617,Boyle; Mary E. T.,23,0,48,25
1657801863939,COGS 13,A01,083071,Bastos; Amalia Pinkusfeld,11,0,71,60
1657801869963,COGS 14A,A01,092681,Semenuks; Arturs,5,1,100,95
1657801875986,COGS 14B,A01,083073,Cheng; Tzu-Han,6,0,63,57
1657801882009,COGS 17,A01,092677,Semenuks; Arturs,6,0,81,75
1657801888033,COGS 100,A01,083619,Allen; Michael Gordon,17,0,70,53
1657801894064,COGS 101A,A01,083621,Davis; Joshua Daniel,9,0,68,59
1657801900089,COGS 101B,A01,091572,Allen; Michael Gordon,12,0,65,53
1657801906112,COGS 101C,A01,083625,Delgado; Tania,17,0,35,18
1657801912137,COGS 107A,A01,083627,Boyle; Mary E. T.,14,0,60,46
1657801918162,COGS 118A,A01,083075,Gupta; Anjum,21,0,76,55
1657801924188,CSE 3,A50,083646,Miranda; Gregory Joseph,24,0,50,26
1657801930217,CSE 8A,A50,083650,Miranda; Gregory Joseph,17,1,56,39
1657801936250,CSE 11,A01,083080,Cao; Yingjun,6,15,40,34
1657801942278,CSE 12,A01,083652,Krause-Levy; Sophia Louisa,28,1,120,92
1657801948308,CSE 15L,A01,083654,Morris; Justin Loren,9,0,50,41
1657801948308,CSE 15L,A02,083655,Morris; Justin Loren,9,0,50,41
1657801954414,CSE 20,A01,083657,Tran; Khoa Dang,39,0,80,41
1657801960442,CSE 21,A01,095574,Bach; Quang Tran,22,0,48,26
1657801966473,CSE 30,A01,083084,Eldon; John,6,0,80,74
1657801966473,CSE 30,B01,095061,Bhaskar; Nishant,9,0,50,41
1657801972503,CSE 100,A01,083659,Cao; Yingjun,5,4,70,65
1657801978528,CSE 134B,A01,083661,Powell; Thomas Allan,24,0,100,76
1657801984557,CSE 140,A01,083663,Gungor; Onat,15,0,85,70
1657801990583,CSE 140L,A01,083088,Eldon; John,23,0,100,77
1657801996606,CSE 175,A01,083665,Kumar; Rakesh,3,0,25,22
1657802002632,CSE 190,A00,092507,Dubnov; Shlomo,8,0,20,12
1657802008660,ECE 45,A01,083139,Congero; Spencer William,6,0,75,69
1657802014683,ECE 65,A50,083695,Saad; Andrew S,12,0,30,18
1657802014683,ECE 65,A51,095125,Saad; Andrew S,24,0,26,2
1657802020708,ECE 109,A01,091882,Touri; Behrouz,20,0,70,50
1657802026737,ECE 180,A00,083140,Abi Samra; Nicholas Camill,1,0,30,29
1657802026737,ECE 180,B00,083141,Abi Samra; Nicholas Camill,0,0,30,30
1657802032765,MATH 10A,A01,083735,Patchell; Gregory David,2,0,30,28
1657802032765,MATH 10A,A02,083736,Patchell; Gregory David,20,0,30,10
1657802032765,MATH 10A,A03,083737,Patchell; Gregory David,16,0,30,14
1657802038803,MATH 10B,A01,083207,Lim; Seonhee,8,0,34,26
1657802038803,MATH 10B,A02,083208,Lim; Seonhee,10,0,35,25
1657802038803,MATH 10B,A03,093472,Lim; Seonhee,7,0,34,27
1657802038803,MATH 10B,B01,083739,Sinha; Shubham,13,0,30,17
1657802044827,MATH 18,A01,083743,Cinel; Cameron Alexander,9,0,30,21
1657802044827,MATH 18,A02,083744,Cinel; Cameron Alexander,18,0,30,12
1657802044827,MATH 18,A03,083745,Cinel; Cameron Alexander,10,0,30,20
1657802044827,MATH 18,B01,083748,Rideout; David Porter,5,0,37,32
1657802044827,MATH 18,B02,083749,Rideout; David Porter,5,0,36,31
1657802044827,MATH 18,B03,083750,Rideout; David Porter,3,0,37,34
1657802044827,MATH 18,B04,083751,Rideout; David Porter,6,0,36,30
1657802044827,MATH 18,B05,093473,Rideout; David Porter,6,0,36,30
1657802044827,MATH 18,B06,093474,Rideout; David Porter,6,0,36,30
1657802050853,MATH 20A,A01,083754,Zheng; Zequn,14,0,40,26
1657802056878,MATH 20B,A01,083756,Briones; Jor-el Thomas Caparas,4,0,36,32
1657802056878,MATH 20B,A02,083757,Briones; Jor-el Thomas Caparas,1,0,36,35
1657802056878,MATH 20B,A03,093475,Briones; Jor-el Thomas Caparas,2,0,36,34
1657802062904,MATH 20C,A01,083760,Briones; Jor-el Thomas Caparas,1,0,35,34
1657802062904,MATH 20C,A02,083761,Briones; Jor-el Thomas Caparas,8,0,35,27
1657802062904,MATH 20C,A03,093476,Briones; Jor-el Thomas Caparas,0,1,36,36
1657802062904,MATH 20C,B01,083762,Bach; Quang Tran,1,0,30,29
1657802068932,MATH 20D,A01,083765,Tran; Brian Kha,5,0,30,25
1657802068932,MATH 20D,A02,083766,Tran; Brian Kha,5,0,30,25
1657802068932,MATH 20D,A03,083767,Tran; Brian Kha,5,0,30,25
1657802074959,MATH 20E,A01,083771,Ganguly; Soumya,10,0,32,22
1657802074959,MATH 20E,A02,083772,Ganguly; Soumya,6,0,32,26
1657802074959,MATH 20E,B01,083773,Ciotti; Benjamin,20,0,35,15
1657802074959,MATH 20E,B02,083774,Ciotti; Benjamin,18,0,35,17
1657802080990,MATH 103A,A01,083777,Greenfeld; Be'Eri,3,0,36,33
1657802080990,MATH 103A,A02,083778,Greenfeld; Be'Eri,5,0,36,31
1657802080990,MATH 103A,A03,093561,Greenfeld; Be'Eri,6,0,36,30
1657802080990,MATH 103A,B01,083779,Greenfeld; Be'Eri,7,0,36,29
1657802080990,MATH 103A,B02,083780,Greenfeld; Be'Eri,4,0,36,32
1657802080990,MATH 103A,B03,093562,Greenfeld; Be'Eri,3,0,36,33
1657802087019,MATH 105,A01,085443,Carter; Anne Toulson,15,0,35,20
1657802087019,MATH 105,A02,093477,Carter; Anne Toulson,20,0,35,15
1657802093049,MATH 109,A01,083213,Ganzberger; Geoffrey Michael,3,0,34,31
1657802093049,MATH 109,A02,083214,Ganzberger; Geoffrey Michael,4,0,34,30
1657802093049,MATH 109,A03,093478,Ganzberger; Geoffrey Michael,2,0,34,32
1657802093049,MATH 109,B01,083215,Ganzberger; Geoffrey Michael,1,0,32,31
1657802093049,MATH 109,B02,083216,Ganzberger; Geoffrey Michael,2,0,32,30
1657802093049,MATH 109,B03,093479,Ganzberger; Geoffrey Michael,8,0,32,24
1657802099083,MATH 142A,A01,083219,Chow; Bennett,7,0,32,25
1657802099083,MATH 142A,A02,083220,Chow; Bennett,10,0,32,22
1657802099083,MATH 142A,A03,093480,Chow; Bennett,9,0,32,23
1657802099083,MATH 142A,B03,093481,Chow; Bennett,8,0,32,24
1657802099083,MATH 142A,B04,093558,Chow; Bennett,13,0,32,19
1657802099083,MATH 142A,B05,093559,Chow; Bennett,6,0,32,26
1657802105112,MATH 193A,A01,083224,Rotar; Vladimir,8,0,34,26
1657802105112,MATH 193A,A02,083225,Rotar; Vladimir,9,0,34,25
1657802105112,MATH 193A,A03,083781,Rotar; Vladimir,5,0,34,29
1657802105112,MATH 193A,A04,083782,Rotar; Vladimir,10,0,34,24
1657802105112,MATH 193A,A05,093482,Rotar; Vladimir,10,0,34,24
1657802111155,MATH 197,001,091859,McAuley; Julian John,9999,0,9999,0
1657802111155,MATH 197,002,095566,Kedlaya; Kiran S.,9997,0,9999,2
1657802111155,MATH 197,003,095567,Xiao; Ming,9999,0,9999,0
1657802111155,MATH 197,004,095571,Perols; Johan Lars,9998,0,9999,1
1657802118221,COGS 9,A01,083615,Shannon; Kyle Michael,9,0,75,66
1657802124250,COGS 11,A01,083617,Boyle; Mary E. T.,23,0,48,25
1657802130275,COGS 13,A01,083071,Bastos; Amalia Pinkusfeld,11,0,71,60
1657802136300,COGS 14A,A01,092681,Semenuks; Arturs,5,1,100,95
1657802142331,COGS 14B,A01,083073,Cheng; Tzu-Han,6,0,63,57
1657802148360,COGS 17,A01,092677,Semenuks; Arturs,6,0,81,75
1657802154384,COGS 100,A01,083619,Allen; Michael Gordon,17,0,70,53
1657802160408,COGS 101A,A01,083621,Davis; Joshua Daniel,9,0,68,59
1657802166440,COGS 101B,A01,091572,Allen; Michael Gordon,12,0,65,53
1657802172477,COGS 101C,A01,083625,Delgado; Tania,17,0,35,18
1657802178503,COGS 107A,A01,083627,Boyle; Mary E. T.,14,0,60,46
1657802184528,COGS 118A,A01,083075,Gupta; Anjum,21,0,76,55
1657802190561,CSE 3,A50,083646,Miranda; Gregory Joseph,24,0,50,26
1657802196587,CSE 8A,A50,083650,Miranda; Gregory Joseph,17,1,56,39
1657802202616,CSE 11,A01,083080,Cao; Yingjun,6,15,40,34
1657802208641,CSE 12,A01,083652,Krause-Levy; Sophia Louisa,28,1,120,92
1657802214673,CSE 15L,A01,083654,Morris; Justin Loren,9,0,50,41
1657802214673,CSE 15L,A02,083655,Morris; Justin Loren,9,0,50,41
1657802220698,CSE 20,A01,083657,Tran; Khoa Dang,39,0,80,41
1657802226725,CSE 21,A01,095574,Bach; Quang Tran,22,0,48,26
1657802232760,CSE 30,A01,083084,Eldon; John,6,0,80,74
1657802232760,CSE 30,B01,095061,Bhaskar; Nishant,9,0,50,41
1657802238791,CSE 100,A01,083659,Cao; Yingjun,5,4,70,65
1657802244814,CSE 134B,A01,083661,Powell; Thomas Allan,24,0,100,76
1657802250845,CSE 140,A01,083663,Gungor; Onat,15,0,85,70
1657802256875,CSE 140L,A01,083088,Eldon; John,23,0,100,77
1657802262900,CSE 175,A01,083665,Kumar; Rakesh,3,0,25,22
1657802268929,CSE 190,A00,092507,Dubnov; Shlomo,8,0,20,12
1657802274964,ECE 45,A01,083139,Congero; Spencer William,6,0,75,69
1657802280998,ECE 65,A50,083695,Saad; Andrew S,12,0,30,18
1657802280998,ECE 65,A51,095125,Saad; Andrew S,24,0,26,2
1657802287022,ECE 109,A01,091882,Touri; Behrouz,20,0,70,50
1657802293047,ECE 180,A00,083140,Abi Samra; Nicholas Camill,1,0,30,29
1657802293047,ECE 180,B00,083141,Abi Samra; Nicholas Camill,0,0,30,30
1657802299073,MATH 10A,A01,083735,Patchell; Gregory David,2,0,30,28
1657802299073,MATH 10A,A02,083736,Patchell; Gregory David,20,0,30,10
1657802299073,MATH 10A,A03,083737,Patchell; Gregory David,16,0,30,14
1657802305099,MATH 10B,A01,083207,Lim; Seonhee,8,0,34,26
1657802305099,MATH 10B,A02,083208,Lim; Seonhee,10,0,35,25
1657802305099,MATH 10B,A03,093472,Lim; Seonhee,7,0,34,27
1657802305099,MATH 10B,B01,083739,Sinha; Shubham,13,0,30,17
1657802311125,MATH 18,A01,083743,Cinel; Cameron Alexander,9,0,30,21
1657802311125,MATH 18,A02,083744,Cinel; Cameron Alexander,18,0,30,12
1657802311125,MATH 18,A03,083745,Cinel; Cameron Alexander,10,0,30,20
1657802311125,MATH 18,B01,083748,Rideout; David Porter,5,0,37,32
1657802311125,MATH 18,B02,083749,Rideout; David Porter,5,0,36,31
1657802311125,MATH 18,B03,083750,Rideout; David Porter,3,0,37,34
1657802311125,MATH 18,B04,083751,Rideout; David Porter,6,0,36,30
1657802311125,MATH 18,B05,093473,Rideout; David Porter,6,0,36,30
1657802311125,MATH 18,B06,093474,Rideout; David Porter,6,0,36,30
1657802317161,MATH 20A,A01,083754,Zheng; Zequn,14,0,40,26
1657802323189,MATH 20B,A01,083756,Briones; Jor-el Thomas Caparas,4,0,36,32
1657802323189,MATH 20B,A02,083757,Briones; Jor-el Thomas Caparas,1,0,36,35
1657802323189,MATH 20B,A03,093475,Briones; Jor-el Thomas Caparas,2,0,36,34
1657802329214,MATH 20C,A01,083760,Briones; Jor-el Thomas Caparas,1,0,35,34
1657802329214,MATH 20C,A02,083761,Briones; Jor-el Thomas Caparas,8,0,35,27
1657802329214,MATH 20C,A03,093476,Briones; Jor-el Thomas Caparas,0,1,36,36
1657802329214,MATH 20C,B01,083762,Bach; Quang Tran,1,0,30,29
1657802335240,MATH 20D,A01,083765,Tran; Brian Kha,5,0,30,25
1657802335240,MATH 20D,A02,083766,Tran; Brian Kha,5,0,30,25
1657802335240,MATH 20D,A03,083767,Tran; Brian Kha,5,0,30,25
1657802341268,MATH 20E,A01,083771,Ganguly; Soumya,10,0,32,22
1657802341268,MATH 20E,A02,083772,Ganguly; Soumya,6,0,32,26
1657802341268,MATH 20E,B01,083773,Ciotti; Benjamin,20,0,35,15
1657802341268,MATH 20E,B02,083774,Ciotti; Benjamin,18,0,35,17
1657802347299,MATH 103A,A01,083777,Greenfeld; Be'Eri,3,0,36,33
1657802347299,MATH 103A,A02,083778,Greenfeld; Be'Eri,5,0,36,31
1657802347299,MATH 103A,A03,093561,Greenfeld; Be'Eri,6,0,36,30
1657802347299,MATH 103A,B01,083779,Greenfeld; Be'Eri,7,0,36,29
1657802347299,MATH 103A,B02,083780,Greenfeld; Be'Eri,4,0,36,32
1657802347299,MATH 103A,B03,093562,Greenfeld; Be'Eri,3,0,36,33
1657802353325,MATH 105,A01,085443,Carter; Anne Toulson,15,0,35,20
1657802353325,MATH 105,A02,093477,Carter; Anne Toulson,20,0,35,15
1657802359350,MATH 109,A01,083213,Ganzberger; Geoffrey Michael,3,0,34,31
1657802359350,MATH 109,A02,083214,Ganzberger; Geoffrey Michael,4,0,34,30
1657802359350,MATH 109,A03,093478,Ganzberger; Geoffrey Michael,2,0,34,32
1657802359350,MATH 109,B01,083215,Ganzberger; Geoffrey Michael,1,0,32,31
1657802359350,MATH 109,B02,083216,Ganzberger; Geoffrey Michael,2,0,32,30
1657802359350,MATH 109,B03,093479,Ganzberger; Geoffrey Michael,8,0,32,24
1657802365384,MATH 142A,A01,083219,Chow; Bennett,7,0,32,25
1657802365384,MATH 142A,A02,083220,Chow; Bennett,10,0,32,22
1657802365384,MATH 142A,A03,093480,Chow; Bennett,9,0,32,23
1657802365384,MATH 142A,B03,093481,Chow; Bennett,8,0,32,24
1657802365384,MATH 142A,B04,093558,Chow; Bennett,13,0,32,19
1657802365384,MATH 142A,B05,093559,Chow; Bennett,6,0,32,26
1657802371416,MATH 193A,A01,083224,Rotar; Vladimir,8,0,34,26
1657802371416,MATH 193A,A02,083225,Rotar; Vladimir,9,0,34,25
1657802371416,MATH 193A,A03,083781,Rotar; Vladimir,5,0,34,29
1657802371416,MATH 193A,A04,083782,Rotar; Vladimir,10,0,34,24
1657802371416,MATH 193A,A05,093482,Rotar; Vladimir,10,0,34,24
1657802377442,MATH 197,001,091859,McAuley; Julian John,9999,0,9999,0
1657802377442,MATH 197,002,095566,Kedlaya; Kiran S.,9997,0,9999,2
1657802377442,MATH 197,003,095567,Xiao; Ming,9999,0,9999,0
1657802377442,MATH 197,004,095571,Perols; Johan Lars,9998,0,9999,1
1657802384512,COGS 9,A01,083615,Shannon; Kyle Michael,9,0,75,66
1657802390535,COGS 11,A01,083617,Boyle; Mary E. T.,23,0,48,25
1657802396561,COGS 13,A01,083071,Bastos; Amalia Pinkusfeld,11,0,71,60
1657802402587,COGS 14A,A01,092681,Semenuks; Arturs,5,1,100,95
1657802408613,COGS 14B,A01,083073,Cheng; Tzu-Han,6,0,63,57
1657802414635,COGS 17,A01,092677,Semenuks; Arturs,6,0,81,75
1657802420665,COGS 100,A01,083619,Allen; Michael Gordon,17,0,70,53
1657802426695,COGS 101A,A01,083621,Davis; Joshua Daniel,9,0,68,59
1657802432722,COGS 101B,A01,091572,Allen; Michael Gordon,12,0,65,53
1657802438746,COGS 101C,A01,083625,Delgado; Tania,17,0,35,18
1657802444772,COGS 107A,A01,083627,Boyle; Mary E. T.,14,0,60,46
1657802450796,COGS 118A,A01,083075,Gupta; Anjum,21,0,76,55
1657802456823,CSE 3,A50,083646,Miranda; Gregory Joseph,24,0,50,26
1657802462856,CSE 8A,A50,083650,Miranda; Gregory Joseph,17,1,56,39
1657802468882,CSE 11,A01,083080,Cao; Yingjun,6,15,40,34
1657802474909,CSE 12,A01,083652,Krause-Levy; Sophia Louisa,28,1,120,92
1657802480934,CSE 15L,A01,083654,Morris; Justin Loren,9,0,50,41
1657802480934,CSE 15L,A02,083655,Morris; Justin Loren,9,0,50,41
1657802486963,CSE 20,A01,083657,Tran; Khoa Dang,39,0,80,41
1657802492991,CSE 21,A01,095574,Bach; Quang Tran,22,0,48,26
1657802499017,CSE 30,A01,083084,Eldon; John,6,0,80,74
1657802499017,CSE 30,B01,095061,Bhaskar; Nishant,9,0,50,41
1657802505045,CSE 100,A01,083659,Cao; Yingjun,5,4,70,65
1657802511071,CSE 134B,A01,083661,Powell; Thomas Allan,24,0,100,76
1657802517095,CSE 140,A01,083663,Gungor; Onat,15,0,85,70
1657802523123,CSE 140L,A01,083088,Eldon; John,23,0,100,77
1657802529152,CSE 175,A01,083665,Kumar; Rakesh,3,0,25,22
1657802535181,CSE 190,A00,092507,Dubnov; Shlomo,8,0,20,12
1657802541207,ECE 45,A01,083139,Congero; Spencer William,6,0,75,69
1657802547238,ECE 65,A50,083695,Saad; Andrew S,12,0,30,18
1657802547238,ECE 65,A51,095125,Saad; Andrew S,24,0,26,2
1657802553351,ECE 109,A01,091882,Touri; Behrouz,20,0,70,50
1657802559383,ECE 180,A00,083140,Abi Samra; Nicholas Camill,1,0,30,29
1657802559383,ECE 180,B00,083141,Abi Samra; Nicholas Camill,0,0,30,30
1657802565409,MATH 10A,A01,083735,Patchell; Gregory David,2,0,30,28
1657802565409,MATH 10A,A02,083736,Patchell; Gregory David,20,0,30,10
1657802565409,MATH 10A,A03,083737,Patchell; Gregory David,16,0,30,14
1657802571434,MATH 10B,A01,083207,Lim; Seonhee,8,0,34,26
1657802571434,MATH 10B,A02,083208,Lim; Seonhee,10,0,35,25
1657802571434,MATH 10B,A03,093472,Lim; Seonhee,7,0,34,27
1657802571434,MATH 10B,B01,083739,Sinha; Shubham,13,0,30,17
1657802577458,MATH 18,A01,083743,Cinel; Cameron Alexander,9,0,30,21
1657802577458,MATH 18,A02,083744,Cinel; Cameron Alexander,18,0,30,12
1657802577458,MATH 18,A03,083745,Cinel; Cameron Alexander,10,0,30,20
1657802577458,MATH 18,B01,083748,Rideout; David Porter,5,0,37,32
1657802577458,MATH 18,B02,083749,Rideout; David Porter,5,0,36,31
1657802577458,MATH 18,B03,083750,Rideout; David Porter,3,0,37,34
1657802577458,MATH 18,B04,083751,Rideout; David Porter,6,0,36,30
1657802577458,MATH 18,B05,093473,Rideout; David Porter,6,0,36,30
1657802577458,MATH 18,B06,093474,Rideout; David Porter,6,0,36,30
1657802583493,MATH 20A,A01,083754,Zheng; Zequn,14,0,40,26
1657802589518,MATH 20B,A01,083756,Briones; Jor-el Thomas Caparas,4,0,36,32
1657802589518,MATH 20B,A02,083757,Briones; Jor-el Thomas Caparas,1,0,36,35
1657802589518,MATH 20B,A03,093475,Briones; Jor-el Thomas Caparas,2,0,36,34
1657802595543,MATH 20C,A01,083760,Briones; Jor-el Thomas Caparas,1,0,35,34
1657802595543,MATH 20C,A02,083761,Briones; Jor-el Thomas Caparas,8,0,35,27
1657802595543,MATH 20C,A03,093476,Briones; Jor-el Thomas Caparas,0,1,36,36
1657802595543,MATH 20C,B01,083762,Bach; Quang Tran,1,0,30,29
1657802601569,MATH 20D,A01,083765,Tran; Brian Kha,5,0,30,25
1657802601569,MATH 20D,A02,083766,Tran; Brian Kha,5,0,30,25
1657802601569,MATH 20D,A03,083767,Tran; Brian Kha,5,0,30,25
1657802607595,MATH 20E,A01,083771,Ganguly; Soumya,10,0,32,22
1657802607595,MATH 20E,A02,083772,Ganguly; Soumya,6,0,32,26
1657802607595,MATH 20E,B01,083773,Ciotti; Benjamin,20,0,35,15
1657802607595,MATH 20E,B02,083774,Ciotti; Benjamin,18,0,35,17
1657802613626,MATH 103A,A01,083777,Greenfeld; Be'Eri,3,0,36,33
1657802613626,MATH 103A,A02,083778,Greenfeld; Be'Eri,5,0,36,31
1657802613626,MATH 103A,A03,093561,Greenfeld; Be'Eri,6,0,36,30
1657802613626,MATH 103A,B01,083779,Greenfeld; Be'Eri,7,0,36,29
1657802613626,MATH 103A,B02,083780,Greenfeld; Be'Eri,4,0,36,32
1657802613626,MATH 103A,B03,093562,Greenfeld; Be'Eri,3,0,36,33
1657802619662,MATH 105,A01,085443,Carter; Anne Toulson,15,0,35,20
1657802619662,MATH 105,A02,093477,Carter; Anne Toulson,20,0,35,15
1657802625697,MATH 109,A01,083213,Ganzberger; Geoffrey Michael,3,0,34,31
1657802625697,MATH 109,A02,083214,Ganzberger; Geoffrey Michael,4,0,34,30
1657802625697,MATH 109,A03,093478,Ganzberger; Geoffrey Michael,2,0,34,32
1657802625697,MATH 109,B01,083215,Ganzberger; Geoffrey Michael,1,0,32,31
1657802625697,MATH 109,B02,083216,Ganzberger; Geoffrey Michael,2,0,32,30
1657802625697,MATH 109,B03,093479,Ganzberger; Geoffrey Michael,8,0,32,24
1657802631732,MATH 142A,A01,083219,Chow; Bennett,7,0,32,25
1657802631732,MATH 142A,A02,083220,Chow; Bennett,10,0,32,22
1657802631732,MATH 142A,A03,093480,Chow; Bennett,9,0,32,23
1657802631732,MATH 142A,B03,093481,Chow; Bennett,8,0,32,24
1657802631732,MATH 142A,B04,093558,Chow; Bennett,13,0,32,19
1657802631732,MATH 142A,B05,093559,Chow; Bennett,6,0,32,26
1657802637758,MATH 193A,A01,083224,Rotar; Vladimir,8,0,34,26
1657802637758,MATH 193A,A02,083225,Rotar; Vladimir,9,0,34,25
1657802637758,MATH 193A,A03,083781,Rotar; Vladimir,5,0,34,29
1657802637758,MATH 193A,A04,083782,Rotar; Vladimir,10,0,34,24
1657802637758,MATH 193A,A05,093482,Rotar; Vladimir,10,0,34,24
1657802643783,MATH 197,001,091859,McAuley; Julian John,9999,0,9999,0
1657802643783,MATH 197,002,095566,Kedlaya; Kiran S.,9997,0,9999,2
1657802643783,MATH 197,003,095567,Xiao; Ming,9999,0,9999,0
1657802643783,MATH 197,004,095571,Perols; Johan Lars,9998,0,9999,1
1657802650854,COGS 9,A01,083615,Shannon; Kyle Michael,9,0,75,66
1657802656884,COGS 11,A01,083617,Boyle; Mary E. T.,23,0,48,25
1657802662910,COGS 13,A01,083071,Bastos; Amalia Pinkusfeld,11,0,71,60
1657802668938,COGS 14A,A01,092681,Semenuks; Arturs,5,1,100,95
1657802674972,COGS 14B,A01,083073,Cheng; Tzu-Han,6,0,63,57
1657802680997,COGS 17,A01,092677,Semenuks; Arturs,6,0,81,75
1657802687028,COGS 100,A01,083619,Allen; Michael Gordon,17,0,70,53
1657802693053,COGS 101A,A01,083621,Davis; Joshua Daniel,9,0,68,59
1657802699081,COGS 101B,A01,091572,Allen; Michael Gordon,12,0,65,53
1657802705109,COGS 101C,A01,083625,Delgado; Tania,17,0,35,18
1657802711134,COGS 107A,A01,083627,Boyle; Mary E. T.,14,0,60,46
1657802717161,COGS 118A,A01,083075,Gupta; Anjum,21,0,76,55
1657802723188,CSE 3,A50,083646,Miranda; Gregory Joseph,24,0,50,26
1657802729215,CSE 8A,A50,083650,Miranda; Gregory Joseph,17,1,56,39
1657802735241,CSE 11,A01,083080,Cao; Yingjun,6,15,40,34
1657802741268,CSE 12,A01,083652,Krause-Levy; Sophia Louisa,28,1,120,92
1657802747296,CSE 15L,A01,083654,Morris; Justin Loren,9,0,50,41
1657802747296,CSE 15L,A02,083655,Morris; Justin Loren,9,0,50,41
1657802753321,CSE 20,A01,083657,Tran; Khoa Dang,39,0,80,41
1657802759346,CSE 21,A01,095574,Bach; Quang Tran,22,0,48,26
1657802765372,CSE 30,A01,083084,Eldon; John,6,0,80,74
1657802765372,CSE 30,B01,095061,Bhaskar; Nishant,9,0,50,41
1657802771403,CSE 100,A01,083659,Cao; Yingjun,5,4,70,65
1657802777430,CSE 134B,A01,083661,Powell; Thomas Allan,24,0,100,76
1657802783454,CSE 140,A01,083663,Gungor; Onat,15,0,85,70
1657802789482,CSE 140L,A01,083088,Eldon; John,23,0,100,77
1657802795516,CSE 175,A01,083665,Kumar; Rakesh,3,0,25,22
1657802801545,CSE 190,A00,092507,Dubnov; Shlomo,8,0,20,12
1657802807570,ECE 45,A01,083139,Congero; Spencer William,6,0,75,69
1657802813597,ECE 65,A50,083695,Saad; Andrew S,12,0,30,18
1657802813597,ECE 65,A51,095125,Saad; Andrew S,24,0,26,2
1657802819626,ECE 109,A01,091882,Touri; Behrouz,20,0,70,50
1657802825649,ECE 180,A00,083140,Abi Samra; Nicholas Camill,1,0,30,29
1657802825649,ECE 180,B00,083141,Abi Samra; Nicholas Camill,0,0,30,30
1657802831676,MATH 10A,A01,083735,Patchell; Gregory David,2,0,30,28
1657802831676,MATH 10A,A02,083736,Patchell; Gregory David,20,0,30,10
1657802831676,MATH 10A,A03,083737,Patchell; Gregory David,16,0,30,14
1657802837711,MATH 10B,A01,083207,Lim; Seonhee,8,0,34,26
1657802837711,MATH 10B,A02,083208,Lim; Seonhee,10,0,35,25
1657802837711,MATH 10B,A03,093472,Lim; Seonhee,7,0,34,27
1657802837711,MATH 10B,B01,083739,Sinha; Shubham,13,0,30,17
1657802843748,MATH 18,A01,083743,Cinel; Cameron Alexander,9,0,30,21
1657802843748,MATH 18,A02,083744,Cinel; Cameron Alexander,18,0,30,12
1657802843748,MATH 18,A03,083745,Cinel; Cameron Alexander,10,0,30,20
1657802843748,MATH 18,B01,083748,Rideout; David Porter,5,0,37,32
1657802843748,MATH 18,B02,083749,Rideout; David Porter,5,0,36,31
1657802843748,MATH 18,B03,083750,Rideout; David Porter,3,0,37,34
1657802843748,MATH 18,B04,083751,Rideout; David Porter,6,0,36,30
1657802843748,MATH 18,B05,093473,Rideout; David Porter,6,0,36,30
1657802843748,MATH 18,B06,093474,Rideout; David Porter,6,0,36,30
1657802849775,MATH 20A,A01,083754,Zheng; Zequn,14,0,40,26
1657802855803,MATH 20B,A01,083756,Briones; Jor-el Thomas Caparas,4,0,36,32
1657802855803,MATH 20B,A02,083757,Briones; Jor-el Thomas Caparas,1,0,36,35
1657802855803,MATH 20B,A03,093475,Briones; Jor-el Thomas Caparas,2,0,36,34
1657802861840,MATH 20C,A01,083760,Briones; Jor-el Thomas Caparas,1,0,35,34
1657802861840,MATH 20C,A02,083761,Briones; Jor-el Thomas Caparas,8,0,35,27
1657802861840,MATH 20C,A03,093476,Briones; Jor-el Thomas Caparas,0,1,36,36
1657802861840,MATH 20C,B01,083762,Bach; Quang Tran,1,0,30,29
1657802867872,MATH 20D,A01,083765,Tran; Brian Kha,5,0,30,25
1657802867872,MATH 20D,A02,083766,Tran; Brian Kha,5,0,30,25
1657802867872,MATH 20D,A03,083767,Tran; Brian Kha,5,0,30,25
1657802873898,MATH 20E,A01,083771,Ganguly; Soumya,10,0,32,22
1657802873898,MATH 20E,A02,083772,Ganguly; Soumya,6,0,32,26
1657802873898,MATH 20E,B01,083773,Ciotti; Benjamin,20,0,35,15
1657802873898,MATH 20E,B02,083774,Ciotti; Benjamin,18,0,35,17
1657802879925,MATH 103A,A01,083777,Greenfeld; Be'Eri,3,0,36,33
1657802879925,MATH 103A,A02,083778,Greenfeld; Be'Eri,5,0,36,31
1657802879925,MATH 103A,A03,093561,Greenfeld; Be'Eri,6,0,36,30
1657802879925,MATH 103A,B01,083779,Greenfeld; Be'Eri,7,0,36,29
1657802879925,MATH 103A,B02,083780,Greenfeld; Be'Eri,4,0,36,32
1657802879925,MATH 103A,B03,093562,Greenfeld; Be'Eri,3,0,36,33
1657802885951,MATH 105,A01,085443,Carter; Anne Toulson,15,0,35,20
1657802885951,MATH 105,A02,093477,Carter; Anne Toulson,20,0,35,15
1657802891982,MATH 109,A01,083213,Ganzberger; Geoffrey Michael,3,0,34,31
1657802891982,MATH 109,A02,083214,Ganzberger; Geoffrey Michael,4,0,34,30
1657802891982,MATH 109,A03,093478,Ganzberger; Geoffrey Michael,2,0,34,32
1657802891982,MATH 109,B01,083215,Ganzberger; Geoffrey Michael,1,0,32,31
1657802891982,MATH 109,B02,083216,Ganzberger; Geoffrey Michael,2,0,32,30
1657802891982,MATH 109,B03,093479,Ganzberger; Geoffrey Michael,8,0,32,24
1657802898012,MATH 142A,A01,083219,Chow; Bennett,7,0,32,25
1657802898012,MATH 142A,A02,083220,Chow; Bennett,10,0,32,22
1657802898012,MATH 142A,A03,093480,Chow; Bennett,9,0,32,23
1657802898012,MATH 142A,B03,093481,Chow; Bennett,8,0,32,24
1657802898012,MATH 142A,B04,093558,Chow; Bennett,13,0,32,19
1657802898012,MATH 142A,B05,093559,Chow; Bennett,6,0,32,26
1657802904035,MATH 193A,A01,083224,Rotar; Vladimir,8,0,34,26
1657802904035,MATH 193A,A02,083225,Rotar; Vladimir,9,0,34,25
1657802904035,MATH 193A,A03,083781,Rotar; Vladimir,5,0,34,29
1657802904035,MATH 193A,A04,083782,Rotar; Vladimir,10,0,34,24
1657802904035,MATH 193A,A05,093482,Rotar; Vladimir,10,0,34,24
1657802910067,MATH 197,001,091859,McAuley; Julian John,9999,0,9999,0
1657802910067,MATH 197,002,095566,Kedlaya; Kiran S.,9997,0,9999,2
1657802910067,MATH 197,003,095567,Xiao; Ming,9999,0,9999,0
1657802910067,MATH 197,004,095571,Perols; Johan Lars,9998,0,9999,1
1657802917156,COGS 9,A01,083615,Shannon; Kyle Michael,9,0,75,66
1657802923186,COGS 11,A01,083617,Boyle; Mary E. T.,23,0,48,25
1657802929213,COGS 13,A01,083071,Bastos; Amalia Pinkusfeld,11,0,71,60
1657802935246,COGS 14A,A01,092681,Semenuks; Arturs,5,1,100,95
1657802941274,COGS 14B,A01,083073,Cheng; Tzu-Han,6,0,63,57
1657802947303,COGS 17,A01,092677,Semenuks; Arturs,6,0,81,75
1657802953330,COGS 100,A01,083619,Allen; Michael Gordon,17,0,70,53
1657802959356,COGS 101A,A01,083621,Davis; Joshua Daniel,9,0,68,59
1657802965386,COGS 101B,A01,091572,Allen; Michael Gordon,12,0,65,53
1657802971418,COGS 101C,A01,083625,Delgado; Tania,17,0,35,18
1657802977444,COGS 107A,A01,083627,Boyle; Mary E. T.,14,0,60,46
1657802983474,COGS 118A,A01,083075,Gupta; Anjum,21,0,76,55
1657802989500,CSE 3,A50,083646,Miranda; Gregory Joseph,24,0,50,26
1657802995529,CSE 8A,A50,083650,Miranda; Gregory Joseph,17,1,56,39
1657803001559,CSE 11,A01,083080,Cao; Yingjun,6,15,40,34
1657803007583,CSE 12,A01,083652,Krause-Levy; Sophia Louisa,28,1,120,92
1657803013613,CSE 15L,A01,083654,Morris; Justin Loren,9,0,50,41
1657803013613,CSE 15L,A02,083655,Morris; Justin Loren,9,0,50,41
1657803019637,CSE 20,A01,083657,Tran; Khoa Dang,39,0,80,41
1657803025667,CSE 21,A01,095574,Bach; Quang Tran,22,0,48,26
1657803031697,CSE 30,A01,083084,Eldon; John,6,0,80,74
1657803031697,CSE 30,B01,095061,Bhaskar; Nishant,9,0,50,41
1657803037727,CSE 100,A01,083659,Cao; Yingjun,5,4,70,65
1657803043757,CSE 134B,A01,083661,Powell; Thomas Allan,24,0,100,76
1657803049781,CSE 140,A01,083663,Gungor; Onat,15,0,85,70
1657803055804,CSE 140L,A01,083088,Eldon; John,23,0,100,77
1657803061835,CSE 175,A01,083665,Kumar; Rakesh,3,0,25,22
1657803067859,CSE 190,A00,092507,Dubnov; Shlomo,8,0,20,12
1657803073885,ECE 45,A01,083139,Congero; Spencer William,6,0,75,69
1657803079917,ECE 65,A50,083695,Saad; Andrew S,12,0,30,18
1657803079917,ECE 65,A51,095125,Saad; Andrew S,24,0,26,2
1657803085950,ECE 109,A01,091882,Touri; Behrouz,20,0,70,50
1657803091977,ECE 180,A00,083140,Abi Samra; Nicholas Camill,1,0,30,29
1657803091977,ECE 180,B00,083141,Abi Samra; Nicholas Camill,0,0,30,30
1657803098003,MATH 10A,A01,083735,Patchell; Gregory David,2,0,30,28
1657803098003,MATH 10A,A02,083736,Patchell; Gregory David,20,0,30,10
1657803098003,MATH 10A,A03,083737,Patchell; Gregory David,16,0,30,14
1657803104029,MATH 10B,A01,083207,Lim; Seonhee,8,0,34,26
1657803104029,MATH 10B,A02,083208,Lim; Seonhee,10,0,35,25
1657803104029,MATH 10B,A03,093472,Lim; Seonhee,7,0,34,27
1657803104029,MATH 10B,B01,083739,Sinha; Shubham,13,0,30,17
1657803110064,MATH 18,A01,083743,Cinel; Cameron Alexander,9,0,30,21
1657803110064,MATH 18,A02,083744,Cinel; Cameron Alexander,18,0,30,12
1657803110064,MATH 18,A03,083745,Cinel; Cameron Alexander,10,0,30,20
1657803110064,MATH 18,B01,083748,Rideout; David Porter,5,0,37,32
1657803110064,MATH 18,B02,083749,Rideout; David Porter,5,0,36,31
1657803110064,MATH 18,B03,083750,Rideout; David Porter,3,0,37,34
1657803110064,MATH 18,B04,083751,Rideout; David Porter,6,0,36,30
1657803110064,MATH 18,B05,093473,Rideout; David Porter,6,0,36,30
1657803110064,MATH 18,B06,093474,Rideout; David Porter,6,0,36,30
1657803116090,MATH 20A,A01,083754,Zheng; Zequn,14,0,40,26
1657803122116,MATH 20B,A01,083756,Briones; Jor-el Thomas Caparas,4,0,36,32
1657803122116,MATH 20B,A02,083757,Briones; Jor-el Thomas Caparas,1,0,36,35
1657803122116,MATH 20B,A03,093475,Briones; Jor-el Thomas Caparas,2,0,36,34
1657803128147,MATH 20C,A01,083760,Briones; Jor-el Thomas Caparas,1,0,35,34
1657803128147,MATH 20C,A02,083761,Briones; Jor-el Thomas Caparas,8,0,35,27
1657803128147,MATH 20C,A03,093476,Briones; Jor-el Thomas Caparas,0,1,36,36
1657803128147,MATH 20C,B01,083762,Bach; Quang Tran,1,0,30,29
1657803134175,MATH 20D,A01,083765,Tran; Brian Kha,5,0,30,25
1657803134175,MATH 20D,A02,083766,Tran; Brian Kha,5,0,30,25
1657803134175,MATH 20D,A03,083767,Tran; Brian Kha,5,0,30,25
1657803140203,MATH 20E,A01,083771,Ganguly; Soumya,10,0,32,22
1657803140203,MATH 20E,A02,083772,Ganguly; Soumya,6,0,32,26
1657803140203,MATH 20E,B01,083773,Ciotti; Benjamin,20,0,35,15
1657803140203,MATH 20E,B02,083774,Ciotti; Benjamin,18,0,35,17
1657803146239,MATH 103A,A01,083777,Greenfeld; Be'Eri,3,0,36,33
1657803146239,MATH 103A,A02,083778,Greenfeld; Be'Eri,5,0,36,31
1657803146239,MATH 103A,A03,093561,Greenfeld; Be'Eri,6,0,36,30
1657803146239,MATH 103A,B01,083779,Greenfeld; Be'Eri,7,0,36,29
1657803146239,MATH 103A,B02,083780,Greenfeld; Be'Eri,4,0,36,32
1657803146239,MATH 103A,B03,093562,Greenfeld; Be'Eri,3,0,36,33
1657803152336,MATH 105,A01,085443,Carter; Anne Toulson,15,0,35,20
1657803152336,MATH 105,A02,093477,Carter; Anne Toulson,20,0,35,15
1657803158363,MATH 109,A01,083213,Ganzberger; Geoffrey Michael,3,0,34,31
1657803158363,MATH 109,A02,083214,Ganzberger; Geoffrey Michael,4,0,34,30
1657803158363,MATH 109,A03,093478,Ganzberger; Geoffrey Michael,2,0,34,32
1657803158363,MATH 109,B01,083215,Ganzberger; Geoffrey Michael,1,0,32,31
1657803158363,MATH 109,B02,083216,Ganzberger; Geoffrey Michael,2,0,32,30
1657803158363,MATH 109,B03,093479,Ganzberger; Geoffrey Michael,8,0,32,24
1657803164391,MATH 142A,A01,083219,Chow; Bennett,7,0,32,25
1657803164391,MATH 142A,A02,083220,Chow; Bennett,10,0,32,22
1657803164391,MATH 142A,A03,093480,Chow; Bennett,9,0,32,23
1657803164391,MATH 142A,B03,093481,Chow; Bennett,8,0,32,24
1657803164391,MATH 142A,B04,093558,Chow; Bennett,13,0,32,19
1657803164391,MATH 142A,B05,093559,Chow; Bennett,6,0,32,26
1657803170423,MATH 193A,A01,083224,Rotar; Vladimir,8,0,34,26
1657803170423,MATH 193A,A02,083225,Rotar; Vladimir,9,0,34,25
1657803170423,MATH 193A,A03,083781,Rotar; Vladimir,5,0,34,29
1657803170423,MATH 193A,A04,083782,Rotar; Vladimir,10,0,34,24
1657803170423,MATH 193A,A05,093482,Rotar; Vladimir,10,0,34,24
1657803176449,MATH 197,001,091859,McAuley; Julian John,9999,0,9999,0
1657803176449,MATH 197,002,095566,Kedlaya; Kiran S.,9997,0,9999,2
1657803176449,MATH 197,003,095567,Xiao; Ming,9999,0,9999,0
1657803176449,MATH 197,004,095571,Perols; Johan Lars,9998,0,9999,1
1657803183516,COGS 9,A01,083615,Shannon; Kyle Michael,9,0,75,66
1657803189547,COGS 11,A01,083617,Boyle; Mary E. T.,23,0,48,25
1657803195584,COGS 13,A01,083071,Bastos; Amalia Pinkusfeld,11,0,71,60
1657803201609,COGS 14A,A01,092681,Semenuks; Arturs,5,1,100,95
1657803207633,COGS 14B,A01,083073,Cheng; Tzu-Han,6,0,63,57
1657803213662,COGS 17,A01,092677,Semenuks; Arturs,6,0,81,75
1657803219694,COGS 100,A01,083619,Allen; Michael Gordon,17,0,70,53
1657803225721,COGS 101A,A01,083621,Davis; Joshua Daniel,9,0,68,59
1657803231749,COGS 101B,A01,091572,Allen; Michael Gordon,12,0,65,53
1657803237774,COGS 101C,A01,083625,Delgado; Tania,17,0,35,18
1657803243799,COGS 107A,A01,083627,Boyle; Mary E. T.,14,0,60,46
1657803249823,COGS 118A,A01,083075,Gupta; Anjum,21,0,76,55
1657803255853,CSE 3,A50,083646,Miranda; Gregory Joseph,24,0,50,26
1657803261879,CSE 8A,A50,083650,Miranda; Gregory Joseph,17,1,56,39
1657803267908,CSE 11,A01,083080,Cao; Yingjun,6,15,40,34
1657803273940,CSE 12,A01,083652,Krause-Levy; Sophia Louisa,28,1,120,92
1657803279969,CSE 15L,A01,083654,Morris; Justin Loren,9,0,50,41
1657803279969,CSE 15L,A02,083655,Morris; Justin Loren,9,0,50,41
1657803285996,CSE 20,A01,083657,Tran; Khoa Dang,39,0,80,41
1657803292028,CSE 21,A01,095574,Bach; Quang Tran,22,0,48,26
1657803298069,CSE 30,A01,083084,Eldon; John,6,0,80,74
1657803298069,CSE 30,B01,095061,Bhaskar; Nishant,9,0,50,41
1657803304096,CSE 100,A01,083659,Cao; Yingjun,5,4,70,65
1657803310121,CSE 134B,A01,083661,Powell; Thomas Allan,24,0,100,76
1657803316149,CSE 140,A01,083663,Gungor; Onat,15,0,85,70
1657803322176,CSE 140L,A01,083088,Eldon; John,23,0,100,77
1657803328202,CSE 175,A01,083665,Kumar; Rakesh,3,0,25,22
1657803334226,CSE 190,A00,092507,Dubnov; Shlomo,8,0,20,12
1657803340253,ECE 45,A01,083139,Congero; Spencer William,6,0,75,69
1657803346284,ECE 65,A50,083695,Saad; Andrew S,12,0,30,18
1657803346284,ECE 65,A51,095125,Saad; Andrew S,24,0,26,2
1657803352311,ECE 109,A01,091882,Touri; Behrouz,20,0,70,50
1657803358335,ECE 180,A00,083140,Abi Samra; Nicholas Camill,1,0,30,29
1657803358335,ECE 180,B00,083141,Abi Samra; Nicholas Camill,0,0,30,30
1657803364361,MATH 10A,A01,083735,Patchell; Gregory David,2,0,30,28
1657803364361,MATH 10A,A02,083736,Patchell; Gregory David,20,0,30,10
1657803364361,MATH 10A,A03,083737,Patchell; Gregory David,16,0,30,14
1657803370396,MATH 10B,A01,083207,Lim; Seonhee,8,0,34,26
1657803370396,MATH 10B,A02,083208,Lim; Seonhee,10,0,35,25
1657803370396,MATH 10B,A03,093472,Lim; Seonhee,7,0,34,27
1657803370396,MATH 10B,B01,083739,Sinha; Shubham,13,0,30,17
1657803376427,MATH 18,A01,083743,Cinel; Cameron Alexander,9,0,30,21
1657803376427,MATH 18,A02,083744,Cinel; Cameron Alexander,18,0,30,12
1657803376427,MATH 18,A03,083745,Cinel; Cameron Alexander,10,0,30,20
1657803376427,MATH 18,B01,083748,Rideout; David Porter,5,0,37,32
1657803376427,MATH 18,B02,083749,Rideout; David Porter,5,0,36,31
1657803376427,MATH 18,B03,083750,Rideout; David Porter,3,0,37,34
1657803376427,MATH 18,B04,083751,Rideout; David Porter,6,0,36,30
1657803376427,MATH 18,B05,093473,Rideout; David Porter,6,0,36,30
1657803376427,MATH 18,B06,093474,Rideout; David Porter,6,0,36,30
1657803382456,MATH 20A,A01,083754,Zheng; Zequn,14,0,40,26
1657803388489,MATH 20B,A01,083756,Briones; Jor-el Thomas Caparas,4,0,36,32
1657803388489,MATH 20B,A02,083757,Briones; Jor-el Thomas Caparas,1,0,36,35
1657803388489,MATH 20B,A03,093475,Briones; Jor-el Thomas Caparas,2,0,36,34
1657803394523,MATH 20C,A01,083760,Briones; Jor-el Thomas Caparas,1,0,35,34
1657803394523,MATH 20C,A02,083761,Briones; Jor-el Thomas Caparas,8,0,35,27
1657803394523,MATH 20C,A03,093476,Briones; Jor-el Thomas Caparas,0,1,36,36
1657803394523,MATH 20C,B01,083762,Bach; Quang Tran,1,0,30,29
1657803400550,MATH 20D,A01,083765,Tran; Brian Kha,5,0,30,25
1657803400550,MATH 20D,A02,083766,Tran; Brian Kha,5,0,30,25
1657803400550,MATH 20D,A03,083767,Tran; Brian Kha,5,0,30,25
1657803406585,MATH 20E,A01,083771,Ganguly; Soumya,10,0,32,22
1657803406585,MATH 20E,A02,083772,Ganguly; Soumya,6,0,32,26
1657803406585,MATH 20E,B01,083773,Ciotti; Benjamin,20,0,35,15
1657803406585,MATH 20E,B02,083774,Ciotti; Benjamin,18,0,35,17
1657803412622,MATH 103A,A01,083777,Greenfeld; Be'Eri,3,0,36,33
1657803412622,MATH 103A,A02,083778,Greenfeld; Be'Eri,5,0,36,31
1657803412622,MATH 103A,A03,093561,Greenfeld; Be'Eri,6,0,36,30
1657803412622,MATH 103A,B01,083779,Greenfeld; Be'Eri,7,0,36,29
1657803412622,MATH 103A,B02,083780,Greenfeld; Be'Eri,4,0,36,32
1657803412622,MATH 103A,B03,093562,Greenfeld; Be'Eri,3,0,36,33
1657803418656,MATH 105,A01,085443,Carter; Anne Toulson,15,0,35,20
1657803418656,MATH 105,A02,093477,Carter; Anne Toulson,20,0,35,15
1657803424689,MATH 109,A01,083213,Ganzberger; Geoffrey Michael,3,0,34,31
1657803424689,MATH 109,A02,083214,Ganzberger; Geoffrey Michael,4,0,34,30
1657803424689,MATH 109,A03,093478,Ganzberger; Geoffrey Michael,2,0,34,32
1657803424689,MATH 109,B01,083215,Ganzberger; Geoffrey Michael,1,0,32,31
1657803424689,MATH 109,B02,083216,Ganzberger; Geoffrey Michael,2,0,32,30
1657803424689,MATH 109,B03,093479,Ganzberger; Geoffrey Michael,8,0,32,24
1657803430720,MATH 142A,A01,083219,Chow; Bennett,7,0,32,25
1657803430720,MATH 142A,A02,083220,Chow; Bennett,10,0,32,22
1657803430720,MATH 142A,A03,093480,Chow; Bennett,9,0,32,23
1657803430720,MATH 142A,B03,093481,Chow; Bennett,8,0,32,24
1657803430720,MATH 142A,B04,093558,Chow; Bennett,13,0,32,19
1657803430720,MATH 142A,B05,093559,Chow; Bennett,6,0,32,26
1657803436743,MATH 193A,A01,083224,Rotar; Vladimir,8,0,34,26
1657803436743,MATH 193A,A02,083225,Rotar; Vladimir,9,0,34,25
1657803436743,MATH 193A,A03,083781,Rotar; Vladimir,5,0,34,29
1657803436743,MATH 193A,A04,083782,Rotar; Vladimir,10,0,34,24
1657803436743,MATH 193A,A05,093482,Rotar; Vladimir,10,0,34,24
1657803442769,MATH 197,001,091859,McAuley; Julian John,9999,0,9999,0
1657803442769,MATH 197,002,095566,Kedlaya; Kiran S.,9997,0,9999,2
1657803442769,MATH 197,003,095567,Xiao; Ming,9999,0,9999,0
1657803442769,MATH 197,004,095571,Perols; Johan Lars,9998,0,9999,1
1657803449845,COGS 9,A01,083615,Shannon; Kyle Michael,9,0,75,66
1657803455873,COGS 11,A01,083617,Boyle; Mary E. T.,23,0,48,25
1657803461904,COGS 13,A01,083071,Bastos; Amalia Pinkusfeld,11,0,71,60
1657803467935,COGS 14A,A01,092681,Semenuks; Arturs,5,1,100,95
1657803473958,COGS 14B,A01,083073,Cheng; Tzu-Han,6,0,63,57
1657803479988,COGS 17,A01,092677,Semenuks; Arturs,6,0,81,75
1657803486020,COGS 100,A01,083619,Allen; Michael Gordon,17,0,70,53
1657803492044,COGS 101A,A01,083621,Davis; Joshua Daniel,9,0,68,59
1657803498077,COGS 101B,A01,091572,Allen; Michael Gordon,12,0,65,53
1657803504103,COGS 101C,A01,083625,Delgado; Tania,17,0,35,18
1657803510127,COGS 107A,A01,083627,Boyle; Mary E. T.,14,0,60,46
1657803516158,COGS 118A,A01,083075,Gupta; Anjum,21,0,76,55
1657803522183,CSE 3,A50,083646,Miranda; Gregory Joseph,24,0,50,26
1657803528212,CSE 8A,A50,083650,Miranda; Gregory Joseph,17,1,56,39
1657803534239,CSE 11,A01,083080,Cao; Yingjun,6,15,40,34
1657803540271,CSE 12,A01,083652,Krause-Levy; Sophia Louisa,28,1,120,92
1657803546301,CSE 15L,A01,083654,Morris; Justin Loren,9,0,50,41
1657803546301,CSE 15L,A02,083655,Morris; Justin Loren,9,0,50,41
1657803552324,CSE 20,A01,083657,Tran; Khoa Dang,39,0,80,41
1657803558350,CSE 21,A01,095574,Bach; Quang Tran,22,0,48,26
1657803564387,CSE 30,A01,083084,Eldon; John,6,0,80,74
1657803564387,CSE 30,B01,095061,Bhaskar; Nishant,9,0,50,41
1657803570416,CSE 100,A01,083659,Cao; Yingjun,5,4,70,65
1657803576449,CSE 134B,A01,083661,Powell; Thomas Allan,24,0,100,76
1657803582479,CSE 140,A01,083663,Gungor; Onat,15,0,85,70
1657803588505,CSE 140L,A01,083088,Eldon; John,23,0,100,77
1657803594530,CSE 175,A01,083665,Kumar; Rakesh,3,0,25,22
1657803600556,CSE 190,A00,092507,Dubnov; Shlomo,8,0,20,12
1657803606587,ECE 45,A01,083139,Congero; Spencer William,6,0,75,69
1657803612617,ECE 65,A50,083695,Saad; Andrew S,12,0,30,18
1657803612617,ECE 65,A51,095125,Saad; Andrew S,24,0,26,2
1657803618648,ECE 109,A01,091882,Touri; Behrouz,20,0,70,50
1657803624680,ECE 180,A00,083140,Abi Samra; Nicholas Camill,1,0,30,29
1657803624680,ECE 180,B00,083141,Abi Samra; Nicholas Camill,0,0,30,30
1657803630707,MATH 10A,A01,083735,Patchell; Gregory David,2,0,30,28
1657803630707,MATH 10A,A02,083736,Patchell; Gregory David,20,0,30,10
1657803630707,MATH 10A,A03,083737,Patchell; Gregory David,16,0,30,14
1657803636734,MATH 10B,A01,083207,Lim; Seonhee,8,0,34,26
1657803636734,MATH 10B,A02,083208,Lim; Seonhee,10,0,35,25
1657803636734,MATH 10B,A03,093472,Lim; Seonhee,7,0,34,27
1657803636734,MATH 10B,B01,083739,Sinha; Shubham,13,0,30,17
1657803642771,MATH 18,A01,083743,Cinel; Cameron Alexander,9,0,30,21
1657803642771,MATH 18,A02,083744,Cinel; Cameron Alexander,18,0,30,12
1657803642771,MATH 18,A03,083745,Cinel; Cameron Alexander,10,0,30,20
1657803642771,MATH 18,B01,083748,Rideout; David Porter,5,0,37,32
1657803642771,MATH 18,B02,083749,Rideout; David Porter,5,0,36,31
1657803642771,MATH 18,B03,083750,Rideout; David Porter,3,0,37,34
1657803642771,MATH 18,B04,083751,Rideout; David Porter,6,0,36,30
1657803642771,MATH 18,B05,093473,Rideout; David Porter,6,0,36,30
1657803642771,MATH 18,B06,093474,Rideout; David Porter,6,0,36,30
1657803648799,MATH 20A,A01,083754,Zheng; Zequn,14,0,40,26
1657803654827,MATH 20B,A01,083756,Briones; Jor-el Thomas Caparas,4,0,36,32
1657803654827,MATH 20B,A02,083757,Briones; Jor-el Thomas Caparas,1,0,36,35
1657803654827,MATH 20B,A03,093475,Briones; Jor-el Thomas Caparas,2,0,36,34
1657803660852,MATH 20C,A01,083760,Briones; Jor-el Thomas Caparas,1,0,35,34
1657803660852,MATH 20C,A02,083761,Briones; Jor-el Thomas Caparas,8,0,35,27
1657803660852,MATH 20C,A03,093476,Briones; Jor-el Thomas Caparas,0,1,36,36
1657803660852,MATH 20C,B01,083762,Bach; Quang Tran,1,0,30,29
1657803666887,MATH 20D,A01,083765,Tran; Brian Kha,5,0,30,25
1657803666887,MATH 20D,A02,083766,Tran; Brian Kha,5,0,30,25
1657803666887,MATH 20D,A03,083767,Tran; Brian Kha,5,0,30,25
1657803672915,MATH 20E,A01,083771,Ganguly; Soumya,10,0,32,22
1657803672915,MATH 20E,A02,083772,Ganguly; Soumya,6,0,32,26
1657803672915,MATH 20E,B01,083773,Ciotti; Benjamin,20,0,35,15
1657803672915,MATH 20E,B02,083774,Ciotti; Benjamin,18,0,35,17
1657803678942,MATH 103A,A01,083777,Greenfeld; Be'Eri,3,0,36,33
1657803678942,MATH 103A,A02,083778,Greenfeld; Be'Eri,5,0,36,31
1657803678942,MATH 103A,A03,093561,Greenfeld; Be'Eri,6,0,36,30
1657803678942,MATH 103A,B01,083779,Greenfeld; Be'Eri,7,0,36,29
1657803678942,MATH 103A,B02,083780,Greenfeld; Be'Eri,4,0,36,32
1657803678942,MATH 103A,B03,093562,Greenfeld; Be'Eri,3,0,36,33
1657803684967,MATH 105,A01,085443,Carter; Anne Toulson,15,0,35,20
1657803684967,MATH 105,A02,093477,Carter; Anne Toulson,20,0,35,15
1657803690997,MATH 109,A01,083213,Ganzberger; Geoffrey Michael,3,0,34,31
1657803690997,MATH 109,A02,083214,Ganzberger; Geoffrey Michael,4,0,34,30
1657803690997,MATH 109,A03,093478,Ganzberger; Geoffrey Michael,2,0,34,32
1657803690997,MATH 109,B01,083215,Ganzberger; Geoffrey Michael,1,0,32,31
1657803690997,MATH 109,B02,083216,Ganzberger; Geoffrey Michael,2,0,32,30
1657803690997,MATH 109,B03,093479,Ganzberger; Geoffrey Michael,8,0,32,24
1657803697023,MATH 142A,A01,083219,Chow; Bennett,7,0,32,25
1657803697023,MATH 142A,A02,083220,Chow; Bennett,10,0,32,22
1657803697023,MATH 142A,A03,093480,Chow; Bennett,9,0,32,23
1657803697023,MATH 142A,B03,093481,Chow; Bennett,8,0,32,24
1657803697023,MATH 142A,B04,093558,Chow; Bennett,13,0,32,19
1657803697023,MATH 142A,B05,093559,Chow; Bennett,6,0,32,26
1657803703055,MATH 193A,A01,083224,Rotar; Vladimir,8,0,34,26
1657803703055,MATH 193A,A02,083225,Rotar; Vladimir,9,0,34,25
1657803703055,MATH 193A,A03,083781,Rotar; Vladimir,5,0,34,29
1657803703055,MATH 193A,A04,083782,Rotar; Vladimir,10,0,34,24
1657803703055,MATH 193A,A05,093482,Rotar; Vladimir,10,0,34,24
1657803709091,MATH 197,001,091859,McAuley; Julian John,9999,0,9999,0
1657803709091,MATH 197,002,095566,Kedlaya; Kiran S.,9997,0,9999,2
1657803709091,MATH 197,003,095567,Xiao; Ming,9999,0,9999,0
1657803709091,MATH 197,004,095571,Perols; Johan Lars,9998,0,9999,1
1657803716158,COGS 9,A01,083615,Shannon; Kyle Michael,9,0,75,66
1657803722187,COGS 11,A01,083617,Boyle; Mary E. T.,23,0,48,25
1657803728216,COGS 13,A01,083071,Bastos; Amalia Pinkusfeld,11,0,71,60
1657803734242,COGS 14A,A01,092681,Semenuks; Arturs,5,1,100,95
1657803740272,COGS 14B,A01,083073,Cheng; Tzu-Han,6,0,63,57
1657803746387,COGS 17,A01,092677,Semenuks; Arturs,6,0,81,75
1657803752412,COGS 100,A01,083619,Allen; Michael Gordon,17,0,70,53
1657803758446,COGS 101A,A01,083621,Davis; Joshua Daniel,9,0,68,59
1657803764475,COGS 101B,A01,091572,Allen; Michael Gordon,12,0,65,53
1657803770503,COGS 101C,A01,083625,Delgado; Tania,17,0,35,18
1657803776529,COGS 107A,A01,083627,Boyle; Mary E. T.,14,0,60,46
1657803782553,COGS 118A,A01,083075,Gupta; Anjum,21,0,76,55
1657803788583,CSE 3,A50,083646,Miranda; Gregory Joseph,24,0,50,26
1657803794612,CSE 8A,A50,083650,Miranda; Gregory Joseph,17,1,56,39
1657803800640,CSE 11,A01,083080,Cao; Yingjun,6,15,40,34
1657803806665,CSE 12,A01,083652,Krause-Levy; Sophia Louisa,28,1,120,92
1657803812692,CSE 15L,A01,083654,Morris; Justin Loren,9,0,50,41
1657803812692,CSE 15L,A02,083655,Morris; Justin Loren,9,0,50,41
1657803818719,CSE 20,A01,083657,Tran; Khoa Dang,39,0,80,41
1657803824745,CSE 21,A01,095574,Bach; Quang Tran,22,0,48,26
1657803830775,CSE 30,A01,083084,Eldon; John,6,0,80,74
1657803830775,CSE 30,B01,095061,Bhaskar; Nishant,9,0,50,41
1657803836807,CSE 100,A01,083659,Cao; Yingjun,5,4,70,65
1657803842832,CSE 134B,A01,083661,Powell; Thomas Allan,24,0,100,76
1657803848859,CSE 140,A01,083663,Gungor; Onat,15,0,85,70
1657803854890,CSE 140L,A01,083088,Eldon; John,23,0,100,77
1657803860929,CSE 175,A01,083665,Kumar; Rakesh,3,0,25,22
1657803866959,CSE 190,A00,092507,Dubnov; Shlomo,8,0,20,12
1657803872985,ECE 45,A01,083139,Congero; Spencer William,6,0,75,69
1657803879012,ECE 65,A50,083695,Saad; Andrew S,12,0,30,18
1657803879012,ECE 65,A51,095125,Saad; Andrew S,24,0,26,2
1657803885039,ECE 109,A01,091882,Touri; Behrouz,20,0,70,50
1657803891065,ECE 180,A00,083140,Abi Samra; Nicholas Camill,1,0,30,29
1657803891065,ECE 180,B00,083141,Abi Samra; Nicholas Camill,0,0,30,30
1657803897101,MATH 10A,A01,083735,Patchell; Gregory David,2,0,30,28
1657803897101,MATH 10A,A02,083736,Patchell; Gregory David,20,0,30,10
1657803897101,MATH 10A,A03,083737,Patchell; Gregory David,16,0,30,14
1657803903137,MATH 10B,A01,083207,Lim; Seonhee,8,0,34,26
1657803903137,MATH 10B,A02,083208,Lim; Seonhee,10,0,35,25
1657803903137,MATH 10B,A03,093472,Lim; Seonhee,7,0,34,27
1657803903137,MATH 10B,B01,083739,Sinha; Shubham,13,0,30,17
1657803909166,MATH 18,A01,083743,Cinel; Cameron Alexander,9,0,30,21
1657803909166,MATH 18,A02,083744,Cinel; Cameron Alexander,18,0,30,12
1657803909166,MATH 18,A03,083745,Cinel; Cameron Alexander,10,0,30,20
1657803909166,MATH 18,B01,083748,Rideout; David Porter,5,0,37,32
1657803909166,MATH 18,B02,083749,Rideout; David Porter,5,0,36,31
1657803909166,MATH 18,B03,083750,Rideout; David Porter,3,0,37,34
1657803909166,MATH 18,B04,083751,Rideout; David Porter,6,0,36,30
1657803909166,MATH 18,B05,093473,Rideout; David Porter,6,0,36,30
1657803909166,MATH 18,B06,093474,Rideout; David Porter,6,0,36,30
1657803915193,MATH 20A,A01,083754,Zheng; Zequn,14,0,40,26
1657803921231,MATH 20B,A01,083756,Briones; Jor-el Thomas Caparas,4,0,36,32
1657803921231,MATH 20B,A02,083757,Briones; Jor-el Thomas Caparas,1,0,36,35
1657803921231,MATH 20B,A03,093475,Briones; Jor-el Thomas Caparas,2,0,36,34
1657803927263,MATH 20C,A01,083760,Briones; Jor-el Thomas Caparas,1,0,35,34
1657803927263,MATH 20C,A02,083761,Briones; Jor-el Thomas Caparas,8,0,35,27
1657803927263,MATH 20C,A03,093476,Briones; Jor-el Thomas Caparas,0,1,36,36
1657803927263,MATH 20C,B01,083762,Bach; Quang Tran,1,0,30,29
1657803933290,MATH 20D,A01,083765,Tran; Brian Kha,5,0,30,25
1657803933290,MATH 20D,A02,083766,Tran; Brian Kha,5,0,30,25
1657803933290,MATH 20D,A03,083767,Tran; Brian Kha,5,0,30,25
1657803939319,MATH 20E,A01,083771,Ganguly; Soumya,10,0,32,22
1657803939319,MATH 20E,A02,083772,Ganguly; Soumya,6,0,32,26
1657803939319,MATH 20E,B01,083773,Ciotti; Benjamin,20,0,35,15
1657803939319,MATH 20E,B02,083774,Ciotti; Benjamin,18,0,35,17
1657803945348,MATH 103A,A01,083777,Greenfeld; Be'Eri,3,0,36,33
1657803945348,MATH 103A,A02,083778,Greenfeld; Be'Eri,5,0,36,31
1657803945348,MATH 103A,A03,093561,Greenfeld; Be'Eri,6,0,36,30
1657803945348,MATH 103A,B01,083779,Greenfeld; Be'Eri,7,0,36,29
1657803945348,MATH 103A,B02,083780,Greenfeld; Be'Eri,4,0,36,32
1657803945348,MATH 103A,B03,093562,Greenfeld; Be'Eri,3,0,36,33
1657803951374,MATH 105,A01,085443,Carter; Anne Toulson,15,0,35,20
1657803951374,MATH 105,A02,093477,Carter; Anne Toulson,20,0,35,15
1657803957399,MATH 109,A01,083213,Ganzberger; Geoffrey Michael,3,0,34,31
1657803957399,MATH 109,A02,083214,Ganzberger; Geoffrey Michael,4,0,34,30
1657803957399,MATH 109,A03,093478,Ganzberger; Geoffrey Michael,2,0,34,32
1657803957399,MATH 109,B01,083215,Ganzberger; Geoffrey Michael,1,0,32,31
1657803957399,MATH 109,B02,083216,Ganzberger; Geoffrey Michael,2,0,32,30
1657803957399,MATH 109,B03,093479,Ganzberger; Geoffrey Michael,8,0,32,24
1657803963431,MATH 142A,A01,083219,Chow; Bennett,7,0,32,25
1657803963431,MATH 142A,A02,083220,Chow; Bennett,10,0,32,22
1657803963431,MATH 142A,A03,093480,Chow; Bennett,9,0,32,23
1657803963431,MATH 142A,B03,093481,Chow; Bennett,8,0,32,24
1657803963431,MATH 142A,B04,093558,Chow; Bennett,13,0,32,19
1657803963431,MATH 142A,B05,093559,Chow; Bennett,6,0,32,26
1657803969458,MATH 193A,A01,083224,Rotar; Vladimir,8,0,34,26
1657803969458,MATH 193A,A02,083225,Rotar; Vladimir,9,0,34,25
1657803969458,MATH 193A,A03,083781,Rotar; Vladimir,5,0,34,29
1657803969458,MATH 193A,A04,083782,Rotar; Vladimir,10,0,34,24
1657803969458,MATH 193A,A05,093482,Rotar; Vladimir,10,0,34,24
1657803975483,MATH 197,001,091859,McAuley; Julian John,9999,0,9999,0
1657803975483,MATH 197,002,095566,Kedlaya; Kiran S.,9997,0,9999,2
1657803975483,MATH 197,003,095567,Xiao; Ming,9999,0,9999,0
1657803975483,MATH 197,004,095571,Perols; Johan Lars,9998,0,9999,1
1657803982558,COGS 9,A01,083615,Shannon; Kyle Michael,9,0,75,66
1657803988590,COGS 11,A01,083617,Boyle; Mary E. T.,23,0,48,25
1657803994621,COGS 13,A01,083071,Bastos; Amalia Pinkusfeld,11,0,71,60
1657804000644,COGS 14A,A01,092681,Semenuks; Arturs,5,1,100,95
1657804006669,COGS 14B,A01,083073,Cheng; Tzu-Han,6,0,63,57
1657804012696,COGS 17,A01,092677,Semenuks; Arturs,6,0,81,75
1657804018724,COGS 100,A01,083619,Allen; Michael Gordon,17,0,70,53
1657804024747,COGS 101A,A01,083621,Davis; Joshua Daniel,9,0,68,59
1657804030771,COGS 101B,A01,091572,Allen; Michael Gordon,12,0,65,53
1657804036794,COGS 101C,A01,083625,Delgado; Tania,17,0,35,18
1657804042819,COGS 107A,A01,083627,Boyle; Mary E. T.,14,0,60,46
1657804048847,COGS 118A,A01,083075,Gupta; Anjum,21,0,76,55
1657804054874,CSE 3,A50,083646,Miranda; Gregory Joseph,24,0,50,26
1657804060910,CSE 8A,A50,083650,Miranda; Gregory Joseph,17,1,56,39
1657804066940,CSE 11,A01,083080,Cao; Yingjun,6,15,40,34
1657804072969,CSE 12,A01,083652,Krause-Levy; Sophia Louisa,28,1,120,92
1657804079001,CSE 15L,A01,083654,Morris; Justin Loren,9,0,50,41
1657804079001,CSE 15L,A02,083655,Morris; Justin Loren,9,0,50,41
1657804085045,CSE 20,A01,083657,Tran; Khoa Dang,39,0,80,41
1657804091070,CSE 21,A01,095574,Bach; Quang Tran,22,0,48,26
1657804097097,CSE 30,A01,083084,Eldon; John,6,0,80,74
1657804097097,CSE 30,B01,095061,Bhaskar; Nishant,9,0,50,41
1657804103122,CSE 100,A01,083659,Cao; Yingjun,5,4,70,65
1657804109151,CSE 134B,A01,083661,Powell; Thomas Allan,24,0,100,76
1657804115183,CSE 140,A01,083663,Gungor; Onat,15,0,85,70
1657804121213,CSE 140L,A01,083088,Eldon; John,23,0,100,77
1657804127249,CSE 175,A01,083665,Kumar; Rakesh,3,0,25,22
1657804133276,CSE 190,A00,092507,Dubnov; Shlomo,8,0,20,12
1657804139303,ECE 45,A01,083139,Congero; Spencer William,6,0,75,69
1657804145338,ECE 65,A50,083695,Saad; Andrew S,12,0,30,18
1657804145338,ECE 65,A51,095125,Saad; Andrew S,24,0,26,2
1657804151369,ECE 109,A01,091882,Touri; Behrouz,20,0,70,50
1657804157393,ECE 180,A00,083140,Abi Samra; Nicholas Camill,1,0,30,29
1657804157393,ECE 180,B00,083141,Abi Samra; Nicholas Camill,0,0,30,30
1657804163430,MATH 10A,A01,083735,Patchell; Gregory David,2,0,30,28
1657804163430,MATH 10A,A02,083736,Patchell; Gregory David,20,0,30,10
1657804163430,MATH 10A,A03,083737,Patchell; Gregory David,16,0,30,14
1657804169459,MATH 10B,A01,083207,Lim; Seonhee,8,0,34,26
1657804169459,MATH 10B,A02,083208,Lim; Seonhee,10,0,35,25
1657804169459,MATH 10B,A03,093472,Lim; Seonhee,7,0,34,27
1657804169459,MATH 10B,B01,083739,Sinha; Shubham,13,0,30,17
1657804175501,MATH 18,A01,083743,Cinel; Cameron Alexander,9,0,30,21
1657804175501,MATH 18,A02,083744,Cinel; Cameron Alexander,18,0,30,12
1657804175501,MATH 18,A03,083745,Cinel; Cameron Alexander,10,0,30,20
1657804175501,MATH 18,B01,083748,Rideout; David Porter,5,0,37,32
1657804175501,MATH 18,B02,083749,Rideout; David Porter,5,0,36,31
1657804175501,MATH 18,B03,083750,Rideout; David Porter,3,0,37,34
1657804175501,MATH 18,B04,083751,Rideout; David Porter,6,0,36,30
1657804175501,MATH 18,B05,093473,Rideout; David Porter,6,0,36,30
1657804175501,MATH 18,B06,093474,Rideout; David Porter,6,0,36,30
1657804181533,MATH 20A,A01,083754,Zheng; Zequn,14,0,40,26
1657804187561,MATH 20B,A01,083756,Briones; Jor-el Thomas Caparas,4,0,36,32
1657804187561,MATH 20B,A02,083757,Briones; Jor-el Thomas Caparas,1,0,36,35
1657804187561,MATH 20B,A03,093475,Briones; Jor-el Thomas Caparas,2,0,36,34
1657804193593,MATH 20C,A01,083760,Briones; Jor-el Thomas Caparas,1,0,35,34
1657804193593,MATH 20C,A02,083761,Briones; Jor-el Thomas Caparas,8,0,35,27
1657804193593,MATH 20C,A03,093476,Briones; Jor-el Thomas Caparas,0,1,36,36
1657804193593,MATH 20C,B01,083762,Bach; Quang Tran,1,0,30,29
1657804199620,MATH 20D,A01,083765,Tran; Brian Kha,5,0,30,25
1657804199620,MATH 20D,A02,083766,Tran; Brian Kha,5,0,30,25
1657804199620,MATH 20D,A03,083767,Tran; Brian Kha,5,0,30,25
1657804205647,MATH 20E,A01,083771,Ganguly; Soumya,10,0,32,22
1657804205647,MATH 20E,A02,083772,Ganguly; Soumya,6,0,32,26
1657804205647,MATH 20E,B01,083773,Ciotti; Benjamin,20,0,35,15
1657804205647,MATH 20E,B02,083774,Ciotti; Benjamin,18,0,35,17
1657804211680,MATH 103A,A01,083777,Greenfeld; Be'Eri,3,0,36,33
1657804211680,MATH 103A,A02,083778,Greenfeld; Be'Eri,5,0,36,31
1657804211680,MATH 103A,A03,093561,Greenfeld; Be'Eri,6,0,36,30
1657804211680,MATH 103A,B01,083779,Greenfeld; Be'Eri,7,0,36,29
1657804211680,MATH 103A,B02,083780,Greenfeld; Be'Eri,4,0,36,32
1657804211680,MATH 103A,B03,093562,Greenfeld; Be'Eri,3,0,36,33
1657804217707,MATH 105,A01,085443,Carter; Anne Toulson,15,0,35,20
1657804217707,MATH 105,A02,093477,Carter; Anne Toulson,20,0,35,15
1657804223734,MATH 109,A01,083213,Ganzberger; Geoffrey Michael,3,0,34,31
1657804223734,MATH 109,A02,083214,Ganzberger; Geoffrey Michael,4,0,34,30
1657804223734,MATH 109,A03,093478,Ganzberger; Geoffrey Michael,2,0,34,32
1657804223734,MATH 109,B01,083215,Ganzberger; Geoffrey Michael,1,0,32,31
1657804223734,MATH 109,B02,083216,Ganzberger; Geoffrey Michael,2,0,32,30
1657804223734,MATH 109,B03,093479,Ganzberger; Geoffrey Michael,8,0,32,24
1657804229768,MATH 142A,A01,083219,Chow; Bennett,7,0,32,25
1657804229768,MATH 142A,A02,083220,Chow; Bennett,10,0,32,22
1657804229768,MATH 142A,A03,093480,Chow; Bennett,9,0,32,23
1657804229768,MATH 142A,B03,093481,Chow; Bennett,8,0,32,24
1657804229768,MATH 142A,B04,093558,Chow; Bennett,13,0,32,19
1657804229768,MATH 142A,B05,093559,Chow; Bennett,6,0,32,26
1657804235794,MATH 193A,A01,083224,Rotar; Vladimir,8,0,34,26
1657804235794,MATH 193A,A02,083225,Rotar; Vladimir,9,0,34,25
1657804235794,MATH 193A,A03,083781,Rotar; Vladimir,5,0,34,29
1657804235794,MATH 193A,A04,083782,Rotar; Vladimir,10,0,34,24
1657804235794,MATH 193A,A05,093482,Rotar; Vladimir,10,0,34,24
1657804241824,MATH 197,001,091859,McAuley; Julian John,9999,0,9999,0
1657804241824,MATH 197,002,095566,Kedlaya; Kiran S.,9997,0,9999,2
1657804241824,MATH 197,003,095567,Xiao; Ming,9999,0,9999,0
1657804241824,MATH 197,004,095571,Perols; Johan Lars,9998,0,9999,1
1657804248907,COGS 9,A01,083615,Shannon; Kyle Michael,9,0,75,66
1657804254948,COGS 11,A01,083617,Boyle; Mary E. T.,23,0,48,25
1657804260979,COGS 13,A01,083071,Bastos; Amalia Pinkusfeld,11,0,71,60
1657804267005,COGS 14A,A01,092681,Semenuks; Arturs,5,1,100,95
1657804273031,COGS 14B,A01,083073,Cheng; Tzu-Han,6,0,63,57
1657804279055,COGS 17,A01,092677,Semenuks; Arturs,6,0,81,75
1657804285082,COGS 100,A01,083619,Allen; Michael Gordon,17,0,70,53
1657804291107,COGS 101A,A01,083621,Davis; Joshua Daniel,9,0,68,59
1657804297132,COGS 101B,A01,091572,Allen; Michael Gordon,12,0,65,53
1657804303162,COGS 101C,A01,083625,Delgado; Tania,17,0,35,18
1657804309191,COGS 107A,A01,083627,Boyle; Mary E. T.,14,0,60,46
1657804315216,COGS 118A,A01,083075,Gupta; Anjum,21,0,76,55
1657804321249,CSE 3,A50,083646,Miranda; Gregory Joseph,24,0,50,26
1657804327274,CSE 8A,A50,083650,Miranda; Gregory Joseph,17,1,56,39
1657804333305,CSE 11,A01,083080,Cao; Yingjun,6,15,40,34
1657804339330,CSE 12,A01,083652,Krause-Levy; Sophia Louisa,28,1,120,92
1657804345464,CSE 15L,A01,083654,Morris; Justin Loren,9,0,50,41
1657804345464,CSE 15L,A02,083655,Morris; Justin Loren,9,0,50,41
1657804351495,CSE 20,A01,083657,Tran; Khoa Dang,39,0,80,41
1657804357521,CSE 21,A01,095574,Bach; Quang Tran,22,0,48,26
1657804363548,CSE 30,A01,083084,Eldon; John,6,0,80,74
1657804363548,CSE 30,B01,095061,Bhaskar; Nishant,9,0,50,41
1657804369582,CSE 100,A01,083659,Cao; Yingjun,5,4,70,65
1657804375610,CSE 134B,A01,083661,Powell; Thomas Allan,24,0,100,76
1657804381639,CSE 140,A01,083663,Gungor; Onat,15,0,85,70
1657804387665,CSE 140L,A01,083088,Eldon; John,23,0,100,77
1657804393697,CSE 175,A01,083665,Kumar; Rakesh,3,0,25,22
1657804399729,CSE 190,A00,092507,Dubnov; Shlomo,8,0,20,12
1657804405759,ECE 45,A01,083139,Congero; Spencer William,6,0,75,69
1657804411786,ECE 65,A50,083695,Saad; Andrew S,12,0,30,18
1657804411786,ECE 65,A51,095125,Saad; Andrew S,24,0,26,2
1657804417809,ECE 109,A01,091882,Touri; Behrouz,20,0,70,50
1657804423834,ECE 180,A00,083140,Abi Samra; Nicholas Camill,1,0,30,29
1657804423834,ECE 180,B00,083141,Abi Samra; Nicholas Camill,0,0,30,30
1657804429870,MATH 10A,A01,083735,Patchell; Gregory David,2,0,30,28
1657804429870,MATH 10A,A02,083736,Patchell; Gregory David,20,0,30,10
1657804429870,MATH 10A,A03,083737,Patchell; Gregory David,16,0,30,14
1657804435896,MATH 10B,A01,083207,Lim; Seonhee,8,0,34,26
1657804435896,MATH 10B,A02,083208,Lim; Seonhee,10,0,35,25
1657804435896,MATH 10B,A03,093472,Lim; Seonhee,7,0,34,27
1657804435896,MATH 10B,B01,083739,Sinha; Shubham,13,0,30,17
1657804441926,MATH 18,A01,083743,Cinel; Cameron Alexander,9,0,30,21
1657804441926,MATH 18,A02,083744,Cinel; Cameron Alexander,18,0,30,12
1657804441926,MATH 18,A03,083745,Cinel; Cameron Alexander,10,0,30,20
1657804441926,MATH 18,B01,083748,Rideout; David Porter,5,0,37,32
1657804441926,MATH 18,B02,083749,Rideout; David Porter,5,0,36,31
1657804441926,MATH 18,B03,083750,Rideout; David Porter,3,0,37,34
1657804441926,MATH 18,B04,083751,Rideout; David Porter,6,0,36,30
1657804441926,MATH 18,B05,093473,Rideout; David Porter,6,0,36,30
1657804441926,MATH 18,B06,093474,Rideout; David Porter,6,0,36,30
1657804447958,MATH 20A,A01,083754,Zheng; Zequn,14,0,40,26
1657804453987,MATH 20B,A01,083756,Briones; Jor-el Thomas Caparas,4,0,36,32
1657804453987,MATH 20B,A02,083757,Briones; Jor-el Thomas Caparas,1,0,36,35
1657804453987,MATH 20B,A03,093475,Briones; Jor-el Thomas Caparas,2,0,36,34
1657804460018,MATH 20C,A01,083760,Briones; Jor-el Thomas Caparas,1,0,35,34
1657804460018,MATH 20C,A02,083761,Briones; Jor-el Thomas Caparas,8,0,35,27
1657804460018,MATH 20C,A03,093476,Briones; Jor-el Thomas Caparas,0,1,36,36
1657804460018,MATH 20C,B01,083762,Bach; Quang Tran,1,0,30,29
1657804466046,MATH 20D,A01,083765,Tran; Brian Kha,5,0,30,25
1657804466046,MATH 20D,A02,083766,Tran; Brian Kha,5,0,30,25
1657804466046,MATH 20D,A03,083767,Tran; Brian Kha,5,0,30,25
1657804472075,MATH 20E,A01,083771,Ganguly; Soumya,10,0,32,22
1657804472075,MATH 20E,A02,083772,Ganguly; Soumya,6,0,32,26
1657804472075,MATH 20E,B01,083773,Ciotti; Benjamin,20,0,35,15
1657804472075,MATH 20E,B02,083774,Ciotti; Benjamin,18,0,35,17
1657804478114,MATH 103A,A01,083777,Greenfeld; Be'Eri,3,0,36,33
1657804478114,MATH 103A,A02,083778,Greenfeld; Be'Eri,5,0,36,31
1657804478114,MATH 103A,A03,093561,Greenfeld; Be'Eri,6,0,36,30
1657804478114,MATH 103A,B01,083779,Greenfeld; Be'Eri,7,0,36,29
1657804478114,MATH 103A,B02,083780,Greenfeld; Be'Eri,4,0,36,32
1657804478114,MATH 103A,B03,093562,Greenfeld; Be'Eri,3,0,36,33
1657804484142,MATH 105,A01,085443,Carter; Anne Toulson,15,0,35,20
1657804484142,MATH 105,A02,093477,Carter; Anne Toulson,20,0,35,15
1657804490174,MATH 109,A01,083213,Ganzberger; Geoffrey Michael,3,0,34,31
1657804490174,MATH 109,A02,083214,Ganzberger; Geoffrey Michael,4,0,34,30
1657804490174,MATH 109,A03,093478,Ganzberger; Geoffrey Michael,2,0,34,32
1657804490174,MATH 109,B01,083215,Ganzberger; Geoffrey Michael,1,0,32,31
1657804490174,MATH 109,B02,083216,Ganzberger; Geoffrey Michael,2,0,32,30
1657804490174,MATH 109,B03,093479,Ganzberger; Geoffrey Michael,8,0,32,24
1657804496207,MATH 142A,A01,083219,Chow; Bennett,7,0,32,25
1657804496207,MATH 142A,A02,083220,Chow; Bennett,10,0,32,22
1657804496207,MATH 142A,A03,093480,Chow; Bennett,9,0,32,23
1657804496207,MATH 142A,B03,093481,Chow; Bennett,8,0,32,24
1657804496207,MATH 142A,B04,093558,Chow; Bennett,13,0,32,19
1657804496207,MATH 142A,B05,093559,Chow; Bennett,6,0,32,26
1657804502234,MATH 193A,A01,083224,Rotar; Vladimir,8,0,34,26
1657804502234,MATH 193A,A02,083225,Rotar; Vladimir,9,0,34,25
1657804502234,MATH 193A,A03,083781,Rotar; Vladimir,5,0,34,29
1657804502234,MATH 193A,A04,083782,Rotar; Vladimir,10,0,34,24
1657804502234,MATH 193A,A05,093482,Rotar; Vladimir,10,0,34,24
1657804508263,MATH 197,001,091859,McAuley; Julian John,9999,0,9999,0
1657804508263,MATH 197,002,095566,Kedlaya; Kiran S.,9997,0,9999,2
1657804508263,MATH 197,003,095567,Xiao; Ming,9999,0,9999,0
1657804508263,MATH 197,004,095571,Perols; Johan Lars,9998,0,9999,1
1657804515325,COGS 9,A01,083615,Shannon; Kyle Michael,9,0,75,66
1657804521354,COGS 11,A01,083617,Boyle; Mary E. T.,23,0,48,25
1657804527384,COGS 13,A01,083071,Bastos; Amalia Pinkusfeld,11,0,71,60
1657804533414,COGS 14A,A01,092681,Semenuks; Arturs,5,1,100,95
1657804539463,COGS 14B,A01,083073,Cheng; Tzu-Han,6,0,63,57
1657804545490,COGS 17,A01,092677,Semenuks; Arturs,6,0,81,75
1657804551515,COGS 100,A01,083619,Allen; Michael Gordon,17,0,70,53
1657804557545,COGS 101A,A01,083621,Davis; Joshua Daniel,9,0,68,59
1657804563577,COGS 101B,A01,091572,Allen; Michael Gordon,12,0,65,53
1657804569603,COGS 101C,A01,083625,Delgado; Tania,17,0,35,18
1657804575628,COGS 107A,A01,083627,Boyle; Mary E. T.,14,0,60,46
1657804581655,COGS 118A,A01,083075,Gupta; Anjum,21,0,76,55
1657804587681,CSE 3,A50,083646,Miranda; Gregory Joseph,24,0,50,26
1657804593707,CSE 8A,A50,083650,Miranda; Gregory Joseph,17,1,56,39
1657804599735,CSE 11,A01,083080,Cao; Yingjun,6,15,40,34
1657804605762,CSE 12,A01,083652,Krause-Levy; Sophia Louisa,28,1,120,92
1657804611791,CSE 15L,A01,083654,Morris; Justin Loren,9,0,50,41
1657804611791,CSE 15L,A02,083655,Morris; Justin Loren,9,0,50,41
1657804617817,CSE 20,A01,083657,Tran; Khoa Dang,39,0,80,41
1657804623845,CSE 21,A01,095574,Bach; Quang Tran,22,0,48,26
1657804629876,CSE 30,A01,083084,Eldon; John,6,0,80,74
1657804629876,CSE 30,B01,095061,Bhaskar; Nishant,9,0,50,41
1657804635901,CSE 100,A01,083659,Cao; Yingjun,5,4,70,65
1657804641931,CSE 134B,A01,083661,Powell; Thomas Allan,24,0,100,76
1657804647957,CSE 140,A01,083663,Gungor; Onat,15,0,85,70
1657804653984,CSE 140L,A01,083088,Eldon; John,23,0,100,77
1657804660009,CSE 175,A01,083665,Kumar; Rakesh,3,0,25,22
1657804666036,CSE 190,A00,092507,Dubnov; Shlomo,8,0,20,12
1657804672061,ECE 45,A01,083139,Congero; Spencer William,6,0,75,69
1657804678088,ECE 65,A50,083695,Saad; Andrew S,12,0,30,18
1657804678088,ECE 65,A51,095125,Saad; Andrew S,24,0,26,2
1657804684114,ECE 109,A01,091882,Touri; Behrouz,20,0,70,50
1657804690145,ECE 180,A00,083140,Abi Samra; Nicholas Camill,1,0,30,29
1657804690145,ECE 180,B00,083141,Abi Samra; Nicholas Camill,0,0,30,30
1657804696171,MATH 10A,A01,083735,Patchell; Gregory David,2,0,30,28
1657804696171,MATH 10A,A02,083736,Patchell; Gregory David,20,0,30,10
1657804696171,MATH 10A,A03,083737,Patchell; Gregory David,16,0,30,14
1657804702208,MATH 10B,A01,083207,Lim; Seonhee,8,0,34,26
1657804702208,MATH 10B,A02,083208,Lim; Seonhee,10,0,35,25
1657804702208,MATH 10B,A03,093472,Lim; Seonhee,7,0,34,27
1657804702208,MATH 10B,B01,083739,Sinha; Shubham,13,0,30,17
1657804708235,MATH 18,A01,083743,Cinel; Cameron Alexander,9,0,30,21
1657804708235,MATH 18,A02,083744,Cinel; Cameron Alexander,18,0,30,12
1657804708235,MATH 18,A03,083745,Cinel; Cameron Alexander,10,0,30,20
1657804708235,MATH 18,B01,083748,Rideout; David Porter,5,0,37,32
1657804708235,MATH 18,B02,083749,Rideout; David Porter,5,0,36,31
1657804708235,MATH 18,B03,083750,Rideout; David Porter,3,0,37,34
1657804708235,MATH 18,B04,083751,Rideout; David Porter,6,0,36,30
1657804708235,MATH 18,B05,093473,Rideout; David Porter,6,0,36,30
1657804708235,MATH 18,B06,093474,Rideout; David Porter,6,0,36,30
1657804714269,MATH 20A,A01,083754,Zheng; Zequn,14,0,40,26
1657804720295,MATH 20B,A01,083756,Briones; Jor-el Thomas Caparas,4,0,36,32
1657804720295,MATH 20B,A02,083757,Briones; Jor-el Thomas Caparas,1,0,36,35
1657804720295,MATH 20B,A03,093475,Briones; Jor-el Thomas Caparas,2,0,36,34
1657804726328,MATH 20C,A01,083760,Briones; Jor-el Thomas Caparas,1,0,35,34
1657804726328,MATH 20C,A02,083761,Briones; Jor-el Thomas Caparas,8,0,35,27
1657804726328,MATH 20C,A03,093476,Briones; Jor-el Thomas Caparas,0,1,36,36
1657804726328,MATH 20C,B01,083762,Bach; Quang Tran,1,0,30,29
1657804732353,MATH 20D,A01,083765,Tran; Brian Kha,5,0,30,25
1657804732353,MATH 20D,A02,083766,Tran; Brian Kha,5,0,30,25
1657804732353,MATH 20D,A03,083767,Tran; Brian Kha,5,0,30,25
1657804738380,MATH 20E,A01,083771,Ganguly; Soumya,10,0,32,22
1657804738380,MATH 20E,A02,083772,Ganguly; Soumya,6,0,32,26
1657804738380,MATH 20E,B01,083773,Ciotti; Benjamin,20,0,35,15
1657804738380,MATH 20E,B02,083774,Ciotti; Benjamin,18,0,35,17
1657804744413,MATH 103A,A01,083777,Greenfeld; Be'Eri,3,0,36,33
1657804744413,MATH 103A,A02,083778,Greenfeld; Be'Eri,5,0,36,31
1657804744413,MATH 103A,A03,093561,Greenfeld; Be'Eri,6,0,36,30
1657804744413,MATH 103A,B01,083779,Greenfeld; Be'Eri,7,0,36,29
1657804744413,MATH 103A,B02,083780,Greenfeld; Be'Eri,4,0,36,32
1657804744413,MATH 103A,B03,093562,Greenfeld; Be'Eri,3,0,36,33
1657804750438,MATH 105,A01,085443,Carter; Anne Toulson,15,0,35,20
1657804750438,MATH 105,A02,093477,Carter; Anne Toulson,20,0,35,15
1657804756464,MATH 109,A01,083213,Ganzberger; Geoffrey Michael,3,0,34,31
1657804756464,MATH 109,A02,083214,Ganzberger; Geoffrey Michael,4,0,34,30
1657804756464,MATH 109,A03,093478,Ganzberger; Geoffrey Michael,2,0,34,32
1657804756464,MATH 109,B01,083215,Ganzberger; Geoffrey Michael,1,0,32,31
1657804756464,MATH 109,B02,083216,Ganzberger; Geoffrey Michael,2,0,32,30
1657804756464,MATH 109,B03,093479,Ganzberger; Geoffrey Michael,8,0,32,24
1657804762492,MATH 142A,A01,083219,Chow; Bennett,7,0,32,25
1657804762492,MATH 142A,A02,083220,Chow; Bennett,10,0,32,22
1657804762492,MATH 142A,A03,093480,Chow; Bennett,9,0,32,23
1657804762492,MATH 142A,B03,093481,Chow; Bennett,8,0,32,24
1657804762492,MATH 142A,B04,093558,Chow; Bennett,13,0,32,19
1657804762492,MATH 142A,B05,093559,Chow; Bennett,6,0,32,26
1657804768525,MATH 193A,A01,083224,Rotar; Vladimir,8,0,34,26
1657804768525,MATH 193A,A02,083225,Rotar; Vladimir,9,0,34,25
1657804768525,MATH 193A,A03,083781,Rotar; Vladimir,5,0,34,29
1657804768525,MATH 193A,A04,083782,Rotar; Vladimir,10,0,34,24
1657804768525,MATH 193A,A05,093482,Rotar; Vladimir,10,0,34,24
1657804774551,MATH 197,001,091859,McAuley; Julian John,9999,0,9999,0
1657804774551,MATH 197,002,095566,Kedlaya; Kiran S.,9997,0,9999,2
1657804774551,MATH 197,003,095567,Xiao; Ming,9999,0,9999,0
1657804774551,MATH 197,004,095571,Perols; Johan Lars,9998,0,9999,1
1657804781616,COGS 9,A01,083615,Shannon; Kyle Michael,9,0,75,66
1657804787641,COGS 11,A01,083617,Boyle; Mary E. T.,23,0,48,25
1657804793671,COGS 13,A01,083071,Bastos; Amalia Pinkusfeld,11,0,71,60
1657804799701,COGS 14A,A01,092681,Semenuks; Arturs,5,1,100,95
1657804805736,COGS 14B,A01,083073,Cheng; Tzu-Han,6,0,63,57
1657804811761,COGS 17,A01,092677,Semenuks; Arturs,6,0,81,75
1657804817795,COGS 100,A01,083619,Allen; Michael Gordon,17,0,70,53
1657804823824,COGS 101A,A01,083621,Davis; Joshua Daniel,9,0,68,59
1657804829849,COGS 101B,A01,091572,Allen; Michael Gordon,12,0,65,53
1657804835880,COGS 101C,A01,083625,Delgado; Tania,17,0,35,18
1657804841916,COGS 107A,A01,083627,Boyle; Mary E. T.,14,0,60,46
1657804847946,COGS 118A,A01,083075,Gupta; Anjum,21,0,76,55
1657804853990,CSE 3,A50,083646,Miranda; Gregory Joseph,24,0,50,26
1657804860019,CSE 8A,A50,083650,Miranda; Gregory Joseph,17,1,56,39
1657804866050,CSE 11,A01,083080,Cao; Yingjun,6,15,40,34
1657804872076,CSE 12,A01,083652,Krause-Levy; Sophia Louisa,28,1,120,92
1657804878102,CSE 15L,A01,083654,Morris; Justin Loren,9,0,50,41
1657804878102,CSE 15L,A02,083655,Morris; Justin Loren,9,0,50,41
1657804884128,CSE 20,A01,083657,Tran; Khoa Dang,39,0,80,41
1657804890155,CSE 21,A01,095574,Bach; Quang Tran,22,0,48,26
1657804896188,CSE 30,A01,083084,Eldon; John,6,0,80,74
1657804896188,CSE 30,B01,095061,Bhaskar; Nishant,9,0,50,41
1657804902217,CSE 100,A01,083659,Cao; Yingjun,5,4,70,65
1657804908247,CSE 134B,A01,083661,Powell; Thomas Allan,24,0,100,76
1657804914270,CSE 140,A01,083663,Gungor; Onat,15,0,85,70
1657804920298,CSE 140L,A01,083088,Eldon; John,23,0,100,77
1657804926324,CSE 175,A01,083665,Kumar; Rakesh,3,0,25,22
1657804932351,CSE 190,A00,092507,Dubnov; Shlomo,8,0,20,12
1657804938378,ECE 45,A01,083139,Congero; Spencer William,6,0,75,69
1657804944487,ECE 65,A50,083695,Saad; Andrew S,12,0,30,18
1657804944487,ECE 65,A51,095125,Saad; Andrew S,24,0,26,2
1657804950514,ECE 109,A01,091882,Touri; Behrouz,20,0,70,50
1657804956543,ECE 180,A00,083140,Abi Samra; Nicholas Camill,1,0,30,29
1657804956543,ECE 180,B00,083141,Abi Samra; Nicholas Camill,0,0,30,30
1657804962577,MATH 10A,A01,083735,Patchell; Gregory David,2,0,30,28
1657804962577,MATH 10A,A02,083736,Patchell; Gregory David,20,0,30,10
1657804962577,MATH 10A,A03,083737,Patchell; Gregory David,16,0,30,14
1657804968615,MATH 10B,A01,083207,Lim; Seonhee,8,0,34,26
1657804968615,MATH 10B,A02,083208,Lim; Seonhee,10,0,35,25
1657804968615,MATH 10B,A03,093472,Lim; Seonhee,7,0,34,27
1657804968615,MATH 10B,B01,083739,Sinha; Shubham,13,0,30,17
1657804974653,MATH 18,A01,083743,Cinel; Cameron Alexander,9,0,30,21
1657804974653,MATH 18,A02,083744,Cinel; Cameron Alexander,18,0,30,12
1657804974653,MATH 18,A03,083745,Cinel; Cameron Alexander,10,0,30,20
1657804974653,MATH 18,B01,083748,Rideout; David Porter,5,0,37,32
1657804974653,MATH 18,B02,083749,Rideout; David Porter,5,0,36,31
1657804974653,MATH 18,B03,083750,Rideout; David Porter,3,0,37,34
1657804974653,MATH 18,B04,083751,Rideout; David Porter,6,0,36,30
1657804974653,MATH 18,B05,093473,Rideout; David Porter,6,0,36,30
1657804974653,MATH 18,B06,093474,Rideout; David Porter,6,0,36,30
1657804980679,MATH 20A,A01,083754,Zheng; Zequn,14,0,40,26
1657804986706,MATH 20B,A01,083756,Briones; Jor-el Thomas Caparas,4,0,36,32
1657804986706,MATH 20B,A02,083757,Briones; Jor-el Thomas Caparas,1,0,36,35
1657804986706,MATH 20B,A03,093475,Briones; Jor-el Thomas Caparas,2,0,36,34
1657804992730,MATH 20C,A01,083760,Briones; Jor-el Thomas Caparas,1,0,35,34
1657804992730,MATH 20C,A02,083761,Briones; Jor-el Thomas Caparas,8,0,35,27
1657804992730,MATH 20C,A03,093476,Briones; Jor-el Thomas Caparas,0,1,36,36
1657804992730,MATH 20C,B01,083762,Bach; Quang Tran,1,0,30,29
1657804998755,MATH 20D,A01,083765,Tran; Brian Kha,5,0,30,25
1657804998755,MATH 20D,A02,083766,Tran; Brian Kha,5,0,30,25
1657804998755,MATH 20D,A03,083767,Tran; Brian Kha,5,0,30,25
1657805004782,MATH 20E,A01,083771,Ganguly; Soumya,10,0,32,22
1657805004782,MATH 20E,A02,083772,Ganguly; Soumya,6,0,32,26
1657805004782,MATH 20E,B01,083773,Ciotti; Benjamin,20,0,35,15
1657805004782,MATH 20E,B02,083774,Ciotti; Benjamin,18,0,35,17
1657805010809,MATH 103A,A01,083777,Greenfeld; Be'Eri,3,0,36,33
1657805010809,MATH 103A,A02,083778,Greenfeld; Be'Eri,5,0,36,31
1657805010809,MATH 103A,A03,093561,Greenfeld; Be'Eri,6,0,36,30
1657805010809,MATH 103A,B01,083779,Greenfeld; Be'Eri,7,0,36,29
1657805010809,MATH 103A,B02,083780,Greenfeld; Be'Eri,4,0,36,32
1657805010809,MATH 103A,B03,093562,Greenfeld; Be'Eri,3,0,36,33
1657805016843,MATH 105,A01,085443,Carter; Anne Toulson,15,0,35,20
1657805016843,MATH 105,A02,093477,Carter; Anne Toulson,20,0,35,15
1657805022873,MATH 109,A01,083213,Ganzberger; Geoffrey Michael,3,0,34,31
1657805022873,MATH 109,A02,083214,Ganzberger; Geoffrey Michael,4,0,34,30
1657805022873,MATH 109,A03,093478,Ganzberger; Geoffrey Michael,2,0,34,32
1657805022873,MATH 109,B01,083215,Ganzberger; Geoffrey Michael,1,0,32,31
1657805022873,MATH 109,B02,083216,Ganzberger; Geoffrey Michael,2,0,32,30
1657805022873,MATH 109,B03,093479,Ganzberger; Geoffrey Michael,8,0,32,24
1657805028903,MATH 142A,A01,083219,Chow; Bennett,7,0,32,25
1657805028903,MATH 142A,A02,083220,Chow; Bennett,10,0,32,22
1657805028903,MATH 142A,A03,093480,Chow; Bennett,9,0,32,23
1657805028903,MATH 142A,B03,093481,Chow; Bennett,8,0,32,24
1657805028903,MATH 142A,B04,093558,Chow; Bennett,13,0,32,19
1657805028903,MATH 142A,B05,093559,Chow; Bennett,6,0,32,26
1657805034930,MATH 193A,A01,083224,Rotar; Vladimir,8,0,34,26
1657805034930,MATH 193A,A02,083225,Rotar; Vladimir,9,0,34,25
1657805034930,MATH 193A,A03,083781,Rotar; Vladimir,5,0,34,29
1657805034930,MATH 193A,A04,083782,Rotar; Vladimir,10,0,34,24
1657805034930,MATH 193A,A05,093482,Rotar; Vladimir,10,0,34,24
1657805040959,MATH 197,001,091859,McAuley; Julian John,9999,0,9999,0
1657805040959,MATH 197,002,095566,Kedlaya; Kiran S.,9997,0,9999,2
1657805040959,MATH 197,003,095567,Xiao; Ming,9999,0,9999,0
1657805040959,MATH 197,004,095571,Perols; Johan Lars,9998,0,9999,1
1657805048032,COGS 9,A01,083615,Shannon; Kyle Michael,9,0,75,66
1657805054065,COGS 11,A01,083617,Boyle; Mary E. T.,23,0,48,25
1657805060097,COGS 13,A01,083071,Bastos; Amalia Pinkusfeld,11,0,71,60
1657805066122,COGS 14A,A01,092681,Semenuks; Arturs,5,1,100,95
1657805072152,COGS 14B,A01,083073,Cheng; Tzu-Han,6,0,63,57
1657805078177,COGS 17,A01,092677,Semenuks; Arturs,6,0,81,75
1657805084202,COGS 100,A01,083619,Allen; Michael Gordon,17,0,70,53
1657805090227,COGS 101A,A01,083621,Davis; Joshua Daniel,9,0,68,59
1657805096255,COGS 101B,A01,091572,Allen; Michael Gordon,12,0,65,53
1657805102289,COGS 101C,A01,083625,Delgado; Tania,17,0,35,18
1657805108314,COGS 107A,A01,083627,Boyle; Mary E. T.,14,0,60,46
1657805114341,COGS 118A,A01,083075,Gupta; Anjum,21,0,76,55
1657805120369,CSE 3,A50,083646,Miranda; Gregory Joseph,24,0,50,26
1657805126394,CSE 8A,A50,083650,Miranda; Gregory Joseph,17,1,56,39
1657805132422,CSE 11,A01,083080,Cao; Yingjun,6,15,40,34
1657805138455,CSE 12,A01,083652,Krause-Levy; Sophia Louisa,28,1,120,92
1657805144483,CSE 15L,A01,083654,Morris; Justin Loren,9,0,50,41
1657805144483,CSE 15L,A02,083655,Morris; Justin Loren,9,0,50,41
1657805150511,CSE 20,A01,083657,Tran; Khoa Dang,39,0,80,41
1657805156539,CSE 21,A01,095574,Bach; Quang Tran,22,0,48,26
1657805162564,CSE 30,A01,083084,Eldon; John,6,0,80,74
1657805162564,CSE 30,B01,095061,Bhaskar; Nishant,9,0,50,41
1657805168590,CSE 100,A01,083659,Cao; Yingjun,5,4,70,65
1657805174615,CSE 134B,A01,083661,Powell; Thomas Allan,24,0,100,76
1657805180639,CSE 140,A01,083663,Gungor; Onat,15,0,85,70
1657805186680,CSE 140L,A01,083088,Eldon; John,23,0,100,77
1657805192712,CSE 175,A01,083665,Kumar; Rakesh,3,0,25,22
1657805198744,CSE 190,A00,092507,Dubnov; Shlomo,8,0,20,12
1657805204776,ECE 45,A01,083139,Congero; Spencer William,6,0,75,69
1657805210804,ECE 65,A50,083695,Saad; Andrew S,12,0,30,18
1657805210804,ECE 65,A51,095125,Saad; Andrew S,24,0,26,2
1657805216830,ECE 109,A01,091882,Touri; Behrouz,20,0,70,50
1657805222860,ECE 180,A00,083140,Abi Samra; Nicholas Camill,1,0,30,29
1657805222860,ECE 180,B00,083141,Abi Samra; Nicholas Camill,0,0,30,30
1657805228894,MATH 10A,A01,083735,Patchell; Gregory David,2,0,30,28
1657805228894,MATH 10A,A02,083736,Patchell; Gregory David,20,0,30,10
1657805228894,MATH 10A,A03,083737,Patchell; Gregory David,16,0,30,14
1657805234928,MATH 10B,A01,083207,Lim; Seonhee,8,0,34,26
1657805234928,MATH 10B,A02,083208,Lim; Seonhee,10,0,35,25
1657805234928,MATH 10B,A03,093472,Lim; Seonhee,7,0,34,27
1657805234928,MATH 10B,B01,083739,Sinha; Shubham,13,0,30,17
1657805240960,MATH 18,A01,083743,Cinel; Cameron Alexander,9,0,30,21
1657805240960,MATH 18,A02,083744,Cinel; Cameron Alexander,18,0,30,12
1657805240960,MATH 18,A03,083745,Cinel; Cameron Alexander,10,0,30,20
1657805240960,MATH 18,B01,083748,Rideout; David Porter,5,0,37,32
1657805240960,MATH 18,B02,083749,Rideout; David Porter,5,0,36,31
1657805240960,MATH 18,B03,083750,Rideout; David Porter,3,0,37,34
1657805240960,MATH 18,B04,083751,Rideout; David Porter,6,0,36,30
1657805240960,MATH 18,B05,093473,Rideout; David Porter,6,0,36,30
1657805240960,MATH 18,B06,093474,Rideout; David Porter,6,0,36,30
1657805246987,MATH 20A,A01,083754,Zheng; Zequn,14,0,40,26
1657805253019,MATH 20B,A01,083756,Briones; Jor-el Thomas Caparas,4,0,36,32
1657805253019,MATH 20B,A02,083757,Briones; Jor-el Thomas Caparas,1,0,36,35
1657805253019,MATH 20B,A03,093475,Briones; Jor-el Thomas Caparas,2,0,36,34
1657805259051,MATH 20C,A01,083760,Briones; Jor-el Thomas Caparas,1,0,35,34
1657805259051,MATH 20C,A02,083761,Briones; Jor-el Thomas Caparas,8,0,35,27
1657805259051,MATH 20C,A03,093476,Briones; Jor-el Thomas Caparas,0,1,36,36
1657805259051,MATH 20C,B01,083762,Bach; Quang Tran,1,0,30,29
1657805265090,MATH 20D,A01,083765,Tran; Brian Kha,5,0,30,25
1657805265090,MATH 20D,A02,083766,Tran; Brian Kha,5,0,30,25
1657805265090,MATH 20D,A03,083767,Tran; Brian Kha,5,0,30,25
1657805271126,MATH 20E,A01,083771,Ganguly; Soumya,10,0,32,22
1657805271126,MATH 20E,A02,083772,Ganguly; Soumya,6,0,32,26
1657805271126,MATH 20E,B01,083773,Ciotti; Benjamin,20,0,35,15
1657805271126,MATH 20E,B02,083774,Ciotti; Benjamin,18,0,35,17
1657805277153,MATH 103A,A01,083777,Greenfeld; Be'Eri,3,0,36,33
1657805277153,MATH 103A,A02,083778,Greenfeld; Be'Eri,5,0,36,31
1657805277153,MATH 103A,A03,093561,Greenfeld; Be'Eri,6,0,36,30
1657805277153,MATH 103A,B01,083779,Greenfeld; Be'Eri,7,0,36,29
1657805277153,MATH 103A,B02,083780,Greenfeld; Be'Eri,4,0,36,32
1657805277153,MATH 103A,B03,093562,Greenfeld; Be'Eri,3,0,36,33
1657805283179,MATH 105,A01,085443,Carter; Anne Toulson,15,0,35,20
1657805283179,MATH 105,A02,093477,Carter; Anne Toulson,20,0,35,15
1657805289208,MATH 109,A01,083213,Ganzberger; Geoffrey Michael,3,0,34,31
1657805289208,MATH 109,A02,083214,Ganzberger; Geoffrey Michael,4,0,34,30
1657805289208,MATH 109,A03,093478,Ganzberger; Geoffrey Michael,2,0,34,32
1657805289208,MATH 109,B01,083215,Ganzberger; Geoffrey Michael,1,0,32,31
1657805289208,MATH 109,B02,083216,Ganzberger; Geoffrey Michael,2,0,32,30
1657805289208,MATH 109,B03,093479,Ganzberger; Geoffrey Michael,8,0,32,24
1657805295242,MATH 142A,A01,083219,Chow; Bennett,7,0,32,25
1657805295242,MATH 142A,A02,083220,Chow; Bennett,10,0,32,22
1657805295242,MATH 142A,A03,093480,Chow; Bennett,9,0,32,23
1657805295242,MATH 142A,B03,093481,Chow; Bennett,8,0,32,24
1657805295242,MATH 142A,B04,093558,Chow; Bennett,13,0,32,19
1657805295242,MATH 142A,B05,093559,Chow; Bennett,6,0,32,26
1657805301271,MATH 193A,A01,083224,Rotar; Vladimir,8,0,34,26
1657805301271,MATH 193A,A02,083225,Rotar; Vladimir,9,0,34,25
1657805301271,MATH 193A,A03,083781,Rotar; Vladimir,5,0,34,29
1657805301271,MATH 193A,A04,083782,Rotar; Vladimir,10,0,34,24
1657805301271,MATH 193A,A05,093482,Rotar; Vladimir,10,0,34,24
1657805307297,MATH 197,001,091859,McAuley; Julian John,9999,0,9999,0
1657805307297,MATH 197,002,095566,Kedlaya; Kiran S.,9997,0,9999,2
1657805307297,MATH 197,003,095567,Xiao; Ming,9999,0,9999,0
1657805307297,MATH 197,004,095571,Perols; Johan Lars,9998,0,9999,1
1657805314354,COGS 9,A01,083615,Shannon; Kyle Michael,9,0,75,66
1657805320387,COGS 11,A01,083617,Boyle; Mary E. T.,23,0,48,25
1657805326414,COGS 13,A01,083071,Bastos; Amalia Pinkusfeld,11,0,71,60
1657805332443,COGS 14A,A01,092681,Semenuks; Arturs,5,1,100,95
1657805338475,COGS 14B,A01,083073,Cheng; Tzu-Han,6,0,63,57
1657805344506,COGS 17,A01,092677,Semenuks; Arturs,6,0,81,75
1657805350531,COGS 100,A01,083619,Allen; Michael Gordon,17,0,70,53
1657805356559,COGS 101A,A01,083621,Davis; Joshua Daniel,9,0,68,59
1657805362583,COGS 101B,A01,091572,Allen; Michael Gordon,12,0,65,53
1657805368613,COGS 101C,A01,083625,Delgado; Tania,17,0,35,18
1657805374639,COGS 107A,A01,083627,Boyle; Mary E. T.,14,0,60,46
1657805380671,COGS 118A,A01,083075,Gupta; Anjum,21,0,76,55
1657805386698,CSE 3,A50,083646,Miranda; Gregory Joseph,24,0,50,26
1657805392724,CSE 8A,A50,083650,Miranda; Gregory Joseph,17,1,56,39
1657805398758,CSE 11,A01,083080,Cao; Yingjun,6,15,40,34
1657805404787,CSE 12,A01,083652,Krause-Levy; Sophia Louisa,28,1,120,92
1657805410812,CSE 15L,A01,083654,Morris; Justin Loren,9,0,50,41
1657805410812,CSE 15L,A02,083655,Morris; Justin Loren,9,0,50,41
1657805416837,CSE 20,A01,083657,Tran; Khoa Dang,39,0,80,41
1657805422860,CSE 21,A01,095574,Bach; Quang Tran,22,0,48,26
1657805428888,CSE 30,A01,083084,Eldon; John,6,0,80,74
1657805428888,CSE 30,B01,095061,Bhaskar; Nishant,9,0,50,41
1657805434912,CSE 100,A01,083659,Cao; Yingjun,5,4,70,65
1657805440944,CSE 134B,A01,083661,Powell; Thomas Allan,24,0,100,76
1657805446971,CSE 140,A01,083663,Gungor; Onat,15,0,85,70
1657805453002,CSE 140L,A01,083088,Eldon; John,23,0,100,77
1657805459033,CSE 175,A01,083665,Kumar; Rakesh,3,0,25,22
1657805465058,CSE 190,A00,092507,Dubnov; Shlomo,8,0,20,12
1657805471090,ECE 45,A01,083139,Congero; Spencer William,6,0,75,69
1657805477125,ECE 65,A50,083695,Saad; Andrew S,12,0,30,18
1657805477125,ECE 65,A51,095125,Saad; Andrew S,24,0,26,2
1657805483149,ECE 109,A01,091882,Touri; Behrouz,20,0,70,50
1657805489176,ECE 180,A00,083140,Abi Samra; Nicholas Camill,1,0,30,29
1657805489176,ECE 180,B00,083141,Abi Samra; Nicholas Camill,0,0,30,30
1657805495202,MATH 10A,A01,083735,Patchell; Gregory David,2,0,30,28
1657805495202,MATH 10A,A02,083736,Patchell; Gregory David,20,0,30,10
1657805495202,MATH 10A,A03,083737,Patchell; Gregory David,16,0,30,14
1657805501230,MATH 10B,A01,083207,Lim; Seonhee,8,0,34,26
1657805501230,MATH 10B,A02,083208,Lim; Seonhee,10,0,35,25
1657805501230,MATH 10B,A03,093472,Lim; Seonhee,7,0,34,27
1657805501230,MATH 10B,B01,083739,Sinha; Shubham,13,0,30,17
1657805507269,MATH 18,A01,083743,Cinel; Cameron Alexander,9,0,30,21
1657805507269,MATH 18,A02,083744,Cinel; Cameron Alexander,18,0,30,12
1657805507269,MATH 18,A03,083745,Cinel; Cameron Alexander,10,0,30,20
1657805507269,MATH 18,B01,083748,Rideout; David Porter,5,0,37,32
1657805507269,MATH 18,B02,083749,Rideout; David Porter,5,0,36,31
1657805507269,MATH 18,B03,083750,Rideout; David Porter,3,0,37,34
1657805507269,MATH 18,B04,083751,Rideout; David Porter,6,0,36,30
1657805507269,MATH 18,B05,093473,Rideout; David Porter,6,0,36,30
1657805507269,MATH 18,B06,093474,Rideout; David Porter,6,0,36,30
1657805513297,MATH 20A,A01,083754,Zheng; Zequn,14,0,40,26
1657805519331,MATH 20B,A01,083756,Briones; Jor-el Thomas Caparas,4,0,36,32
1657805519331,MATH 20B,A02,083757,Briones; Jor-el Thomas Caparas,1,0,36,35
1657805519331,MATH 20B,A03,093475,Briones; Jor-el Thomas Caparas,2,0,36,34
1657805525362,MATH 20C,A01,083760,Briones; Jor-el Thomas Caparas,1,0,35,34
1657805525362,MATH 20C,A02,083761,Briones; Jor-el Thomas Caparas,8,0,35,27
1657805525362,MATH 20C,A03,093476,Briones; Jor-el Thomas Caparas,0,1,36,36
1657805525362,MATH 20C,B01,083762,Bach; Quang Tran,1,0,30,29
1657805531387,MATH 20D,A01,083765,Tran; Brian Kha,5,0,30,25
1657805531387,MATH 20D,A02,083766,Tran; Brian Kha,5,0,30,25
1657805531387,MATH 20D,A03,083767,Tran; Brian Kha,5,0,30,25
1657805537419,MATH 20E,A01,083771,Ganguly; Soumya,10,0,32,22
1657805537419,MATH 20E,A02,083772,Ganguly; Soumya,6,0,32,26
1657805537419,MATH 20E,B01,083773,Ciotti; Benjamin,20,0,35,15
1657805537419,MATH 20E,B02,083774,Ciotti; Benjamin,18,0,35,17
1657805543528,MATH 103A,A01,083777,Greenfeld; Be'Eri,3,0,36,33
1657805543528,MATH 103A,A02,083778,Greenfeld; Be'Eri,5,0,36,31
1657805543528,MATH 103A,A03,093561,Greenfeld; Be'Eri,6,0,36,30
1657805543528,MATH 103A,B01,083779,Greenfeld; Be'Eri,7,0,36,29
1657805543528,MATH 103A,B02,083780,Greenfeld; Be'Eri,4,0,36,32
1657805543528,MATH 103A,B03,093562,Greenfeld; Be'Eri,3,0,36,33
1657805549555,MATH 105,A01,085443,Carter; Anne Toulson,15,0,35,20
1657805549555,MATH 105,A02,093477,Carter; Anne Toulson,20,0,35,15
1657805555581,MATH 109,A01,083213,Ganzberger; Geoffrey Michael,3,0,34,31
1657805555581,MATH 109,A02,083214,Ganzberger; Geoffrey Michael,4,0,34,30
1657805555581,MATH 109,A03,093478,Ganzberger; Geoffrey Michael,2,0,34,32
1657805555581,MATH 109,B01,083215,Ganzberger; Geoffrey Michael,1,0,32,31
1657805555581,MATH 109,B02,083216,Ganzberger; Geoffrey Michael,2,0,32,30
1657805555581,MATH 109,B03,093479,Ganzberger; Geoffrey Michael,8,0,32,24
1657805561616,MATH 142A,A01,083219,Chow; Bennett,7,0,32,25
1657805561616,MATH 142A,A02,083220,Chow; Bennett,10,0,32,22
1657805561616,MATH 142A,A03,093480,Chow; Bennett,9,0,32,23
1657805561616,MATH 142A,B03,093481,Chow; Bennett,8,0,32,24
1657805561616,MATH 142A,B04,093558,Chow; Bennett,13,0,32,19
1657805561616,MATH 142A,B05,093559,Chow; Bennett,6,0,32,26
1657805567653,MATH 193A,A01,083224,Rotar; Vladimir,8,0,34,26
1657805567653,MATH 193A,A02,083225,Rotar; Vladimir,9,0,34,25
1657805567653,MATH 193A,A03,083781,Rotar; Vladimir,5,0,34,29
1657805567653,MATH 193A,A04,083782,Rotar; Vladimir,10,0,34,24
1657805567653,MATH 193A,A05,093482,Rotar; Vladimir,10,0,34,24
1657805573687,MATH 197,001,091859,McAuley; Julian John,9999,0,9999,0
1657805573687,MATH 197,002,095566,Kedlaya; Kiran S.,9997,0,9999,2
1657805573687,MATH 197,003,095567,Xiao; Ming,9999,0,9999,0
1657805573687,MATH 197,004,095571,Perols; Johan Lars,9998,0,9999,1
1657805580768,COGS 9,A01,083615,Shannon; Kyle Michael,9,0,75,66
1657805586797,COGS 11,A01,083617,Boyle; Mary E. T.,23,0,48,25
1657805592824,COGS 13,A01,083071,Bastos; Amalia Pinkusfeld,11,0,71,60
1657805598849,COGS 14A,A01,092681,Semenuks; Arturs,5,1,100,95
1657805604876,COGS 14B,A01,083073,Cheng; Tzu-Han,6,0,63,57
1657805610902,COGS 17,A01,092677,Semenuks; Arturs,6,0,81,75
1657805616933,COGS 100,A01,083619,Allen; Michael Gordon,17,0,70,53
1657805622958,COGS 101A,A01,083621,Davis; Joshua Daniel,9,0,68,59
1657805628984,COGS 101B,A01,091572,Allen; Michael Gordon,12,0,65,53
1657805635007,COGS 101C,A01,083625,Delgado; Tania,17,0,35,18
1657805641037,COGS 107A,A01,083627,Boyle; Mary E. T.,14,0,60,46
1657805647068,COGS 118A,A01,083075,Gupta; Anjum,21,0,76,55
1657805653096,CSE 3,A50,083646,Miranda; Gregory Joseph,24,0,50,26
1657805659119,CSE 8A,A50,083650,Miranda; Gregory Joseph,17,1,56,39
1657805665158,CSE 11,A01,083080,Cao; Yingjun,6,15,40,34
1657805671189,CSE 12,A01,083652,Krause-Levy; Sophia Louisa,28,1,120,92
1657805677218,CSE 15L,A01,083654,Morris; Justin Loren,9,0,50,41
1657805677218,CSE 15L,A02,083655,Morris; Justin Loren,9,0,50,41
1657805683245,CSE 20,A01,083657,Tran; Khoa Dang,39,0,80,41
1657805689274,CSE 21,A01,095574,Bach; Quang Tran,22,0,48,26
1657805695302,CSE 30,A01,083084,Eldon; John,6,0,80,74
1657805695302,CSE 30,B01,095061,Bhaskar; Nishant,9,0,50,41
1657805701330,CSE 100,A01,083659,Cao; Yingjun,5,4,70,65
1657805707354,CSE 134B,A01,083661,Powell; Thomas Allan,24,0,100,76
1657805713384,CSE 140,A01,083663,Gungor; Onat,15,0,85,70
1657805719413,CSE 140L,A01,083088,Eldon; John,23,0,100,77
1657805725440,CSE 175,A01,083665,Kumar; Rakesh,3,0,25,22
1657805731467,CSE 190,A00,092507,Dubnov; Shlomo,8,0,20,12
1657805737499,ECE 45,A01,083139,Congero; Spencer William,6,0,75,69
1657805743527,ECE 65,A50,083695,Saad; Andrew S,12,0,30,18
1657805743527,ECE 65,A51,095125,Saad; Andrew S,24,0,26,2
1657805749552,ECE 109,A01,091882,Touri; Behrouz,20,0,70,50
1657805755579,ECE 180,A00,083140,Abi Samra; Nicholas Camill,1,0,30,29
1657805755579,ECE 180,B00,083141,Abi Samra; Nicholas Camill,0,0,30,30
1657805761613,MATH 10A,A01,083735,Patchell; Gregory David,2,0,30,28
1657805761613,MATH 10A,A02,083736,Patchell; Gregory David,20,0,30,10
1657805761613,MATH 10A,A03,083737,Patchell; Gregory David,16,0,30,14
1657805767650,MATH 10B,A01,083207,Lim; Seonhee,8,0,34,26
1657805767650,MATH 10B,A02,083208,Lim; Seonhee,10,0,35,25
1657805767650,MATH 10B,A03,093472,Lim; Seonhee,7,0,34,27
1657805767650,MATH 10B,B01,083739,Sinha; Shubham,13,0,30,17
1657805773682,MATH 18,A01,083743,Cinel; Cameron Alexander,9,0,30,21
1657805773682,MATH 18,A02,083744,Cinel; Cameron Alexander,18,0,30,12
1657805773682,MATH 18,A03,083745,Cinel; Cameron Alexander,10,0,30,20
1657805773682,MATH 18,B01,083748,Rideout; David Porter,5,0,37,32
1657805773682,MATH 18,B02,083749,Rideout; David Porter,5,0,36,31
1657805773682,MATH 18,B03,083750,Rideout; David Porter,3,0,37,34
1657805773682,MATH 18,B04,083751,Rideout; David Porter,6,0,36,30
1657805773682,MATH 18,B05,093473,Rideout; David Porter,6,0,36,30
1657805773682,MATH 18,B06,093474,Rideout; David Porter,6,0,36,30
1657805779709,MATH 20A,A01,083754,Zheng; Zequn,14,0,40,26
1657805785734,MATH 20B,A01,083756,Briones; Jor-el Thomas Caparas,4,0,36,32
1657805785734,MATH 20B,A02,083757,Briones; Jor-el Thomas Caparas,1,0,36,35
1657805785734,MATH 20B,A03,093475,Briones; Jor-el Thomas Caparas,2,0,36,34
1657805791765,MATH 20C,A01,083760,Briones; Jor-el Thomas Caparas,1,0,35,34
1657805791765,MATH 20C,A02,083761,Briones; Jor-el Thomas Caparas,8,0,35,27
1657805791765,MATH 20C,A03,093476,Briones; Jor-el Thomas Caparas,0,1,36,36
1657805791765,MATH 20C,B01,083762,Bach; Quang Tran,1,0,30,29
1657805797789,MATH 20D,A01,083765,Tran; Brian Kha,5,0,30,25
1657805797789,MATH 20D,A02,083766,Tran; Brian Kha,5,0,30,25
1657805797789,MATH 20D,A03,083767,Tran; Brian Kha,5,0,30,25
1657805803815,MATH 20E,A01,083771,Ganguly; Soumya,10,0,32,22
1657805803815,MATH 20E,A02,083772,Ganguly; Soumya,6,0,32,26
1657805803815,MATH 20E,B01,083773,Ciotti; Benjamin,20,0,35,15
1657805803815,MATH 20E,B02,083774,Ciotti; Benjamin,18,0,35,17
1657805809840,MATH 103A,A01,083777,Greenfeld; Be'Eri,3,0,36,33
1657805809840,MATH 103A,A02,083778,Greenfeld; Be'Eri,5,0,36,31
1657805809840,MATH 103A,A03,093561,Greenfeld; Be'Eri,6,0,36,30
1657805809840,MATH 103A,B01,083779,Greenfeld; Be'Eri,7,0,36,29
1657805809840,MATH 103A,B02,083780,Greenfeld; Be'Eri,4,0,36,32
1657805809840,MATH 103A,B03,093562,Greenfeld; Be'Eri,3,0,36,33
1657805815872,MATH 105,A01,085443,Carter; Anne Toulson,15,0,35,20
1657805815872,MATH 105,A02,093477,Carter; Anne Toulson,20,0,35,15
1657805821897,MATH 109,A01,083213,Ganzberger; Geoffrey Michael,3,0,34,31
1657805821897,MATH 109,A02,083214,Ganzberger; Geoffrey Michael,4,0,34,30
1657805821897,MATH 109,A03,093478,Ganzberger; Geoffrey Michael,2,0,34,32
1657805821897,MATH 109,B01,083215,Ganzberger; Geoffrey Michael,1,0,32,31
1657805821897,MATH 109,B02,083216,Ganzberger; Geoffrey Michael,2,0,32,30
1657805821897,MATH 109,B03,093479,Ganzberger; Geoffrey Michael,8,0,32,24
1657805827923,MATH 142A,A01,083219,Chow; Bennett,7,0,32,25
1657805827923,MATH 142A,A02,083220,Chow; Bennett,10,0,32,22
1657805827923,MATH 142A,A03,093480,Chow; Bennett,9,0,32,23
1657805827923,MATH 142A,B03,093481,Chow; Bennett,8,0,32,24
1657805827923,MATH 142A,B04,093558,Chow; Bennett,13,0,32,19
1657805827923,MATH 142A,B05,093559,Chow; Bennett,6,0,32,26
1657805833952,MATH 193A,A01,083224,Rotar; Vladimir,8,0,34,26
1657805833952,MATH 193A,A02,083225,Rotar; Vladimir,9,0,34,25
1657805833952,MATH 193A,A03,083781,Rotar; Vladimir,5,0,34,29
1657805833952,MATH 193A,A04,083782,Rotar; Vladimir,10,0,34,24
1657805833952,MATH 193A,A05,093482,Rotar; Vladimir,10,0,34,24
1657805839981,MATH 197,001,091859,McAuley; Julian John,9999,0,9999,0
1657805839981,MATH 197,002,095566,Kedlaya; Kiran S.,9997,0,9999,2
1657805839981,MATH 197,003,095567,Xiao; Ming,9999,0,9999,0
1657805839981,MATH 197,004,095571,Perols; Johan Lars,9998,0,9999,1
1657805847043,COGS 9,A01,083615,Shannon; Kyle Michael,9,0,75,66
1657805853068,COGS 11,A01,083617,Boyle; Mary E. T.,23,0,48,25
1657805859093,COGS 13,A01,083071,Bastos; Amalia Pinkusfeld,11,0,71,60
1657805865118,COGS 14A,A01,092681,Semenuks; Arturs,5,1,100,95
1657805871144,COGS 14B,A01,083073,Cheng; Tzu-Han,6,0,63,57
1657805877166,COGS 17,A01,092677,Semenuks; Arturs,6,0,81,75
1657805883191,COGS 100,A01,083619,Allen; Michael Gordon,17,0,70,53
1657805889220,COGS 101A,A01,083621,Davis; Joshua Daniel,9,0,68,59
1657805895246,COGS 101B,A01,091572,Allen; Michael Gordon,12,0,65,53
1657805901272,COGS 101C,A01,083625,Delgado; Tania,17,0,35,18
1657805907300,COGS 107A,A01,083627,Boyle; Mary E. T.,14,0,60,46
1657805913328,COGS 118A,A01,083075,Gupta; Anjum,21,0,76,55
1657805919355,CSE 3,A50,083646,Miranda; Gregory Joseph,24,0,50,26
1657805925392,CSE 8A,A50,083650,Miranda; Gregory Joseph,17,1,56,39
1657805931432,CSE 11,A01,083080,Cao; Yingjun,6,15,40,34
1657805937459,CSE 12,A01,083652,Krause-Levy; Sophia Louisa,28,1,120,92
1657805943487,CSE 15L,A01,083654,Morris; Justin Loren,9,0,50,41
1657805943487,CSE 15L,A02,083655,Morris; Justin Loren,9,0,50,41
1657805949517,CSE 20,A01,083657,Tran; Khoa Dang,39,0,80,41
1657805955542,CSE 21,A01,095574,Bach; Quang Tran,22,0,48,26
1657805961567,CSE 30,A01,083084,Eldon; John,6,0,80,74
1657805961567,CSE 30,B01,095061,Bhaskar; Nishant,9,0,50,41
1657805967593,CSE 100,A01,083659,Cao; Yingjun,5,4,70,65
1657805973622,CSE 134B,A01,083661,Powell; Thomas Allan,24,0,100,76
1657805979651,CSE 140,A01,083663,Gungor; Onat,15,0,85,70
1657805985676,CSE 140L,A01,083088,Eldon; John,23,0,100,77
1657805991701,CSE 175,A01,083665,Kumar; Rakesh,3,0,25,22
1657805997725,CSE 190,A00,092507,Dubnov; Shlomo,8,0,20,12
1657806003750,ECE 45,A01,083139,Congero; Spencer William,6,0,75,69
1657806009780,ECE 65,A50,083695,Saad; Andrew S,12,0,30,18
1657806009780,ECE 65,A51,095125,Saad; Andrew S,24,0,26,2
1657806015804,ECE 109,A01,091882,Touri; Behrouz,20,0,70,50
1657806021835,ECE 180,A00,083140,Abi Samra; Nicholas Camill,1,0,30,29
1657806021835,ECE 180,B00,083141,Abi Samra; Nicholas Camill,0,0,30,30
1657806027862,MATH 10A,A01,083735,Patchell; Gregory David,2,0,30,28
1657806027862,MATH 10A,A02,083736,Patchell; Gregory David,20,0,30,10
1657806027862,MATH 10A,A03,083737,Patchell; Gregory David,16,0,30,14
1657806033892,MATH 10B,A01,083207,Lim; Seonhee,8,0,34,26
1657806033892,MATH 10B,A02,083208,Lim; Seonhee,10,0,35,25
1657806033892,MATH 10B,A03,093472,Lim; Seonhee,7,0,34,27
1657806033892,MATH 10B,B01,083739,Sinha; Shubham,13,0,30,17
1657806039930,MATH 18,A01,083743,Cinel; Cameron Alexander,9,0,30,21
1657806039930,MATH 18,A02,083744,Cinel; Cameron Alexander,18,0,30,12
1657806039930,MATH 18,A03,083745,Cinel; Cameron Alexander,10,0,30,20
1657806039930,MATH 18,B01,083748,Rideout; David Porter,5,0,37,32
1657806039930,MATH 18,B02,083749,Rideout; David Porter,5,0,36,31
1657806039930,MATH 18,B03,083750,Rideout; David Porter,3,0,37,34
1657806039930,MATH 18,B04,083751,Rideout; David Porter,6,0,36,30
1657806039930,MATH 18,B05,093473,Rideout; David Porter,6,0,36,30
1657806039930,MATH 18,B06,093474,Rideout; David Porter,6,0,36,30
1657806045959,MATH 20A,A01,083754,Zheng; Zequn,14,0,40,26
1657806051986,MATH 20B,A01,083756,Briones; Jor-el Thomas Caparas,4,0,36,32
1657806051986,MATH 20B,A02,083757,Briones; Jor-el Thomas Caparas,1,0,36,35
1657806051986,MATH 20B,A03,093475,Briones; Jor-el Thomas Caparas,2,0,36,34
1657806058014,MATH 20C,A01,083760,Briones; Jor-el Thomas Caparas,1,0,35,34
1657806058014,MATH 20C,A02,083761,Briones; Jor-el Thomas Caparas,8,0,35,27
1657806058014,MATH 20C,A03,093476,Briones; Jor-el Thomas Caparas,0,1,36,36
1657806058014,MATH 20C,B01,083762,Bach; Quang Tran,1,0,30,29
1657806064041,MATH 20D,A01,083765,Tran; Brian Kha,5,0,30,25
1657806064041,MATH 20D,A02,083766,Tran; Brian Kha,5,0,30,25
1657806064041,MATH 20D,A03,083767,Tran; Brian Kha,5,0,30,25
1657806070070,MATH 20E,A01,083771,Ganguly; Soumya,10,0,32,22
1657806070070,MATH 20E,A02,083772,Ganguly; Soumya,6,0,32,26
1657806070070,MATH 20E,B01,083773,Ciotti; Benjamin,20,0,35,15
1657806070070,MATH 20E,B02,083774,Ciotti; Benjamin,18,0,35,17
1657806076096,MATH 103A,A01,083777,Greenfeld; Be'Eri,3,0,36,33
1657806076096,MATH 103A,A02,083778,Greenfeld; Be'Eri,5,0,36,31
1657806076096,MATH 103A,A03,093561,Greenfeld; Be'Eri,6,0,36,30
1657806076096,MATH 103A,B01,083779,Greenfeld; Be'Eri,7,0,36,29
1657806076096,MATH 103A,B02,083780,Greenfeld; Be'Eri,4,0,36,32
1657806076096,MATH 103A,B03,093562,Greenfeld; Be'Eri,3,0,36,33
1657806082123,MATH 105,A01,085443,Carter; Anne Toulson,15,0,35,20
1657806082123,MATH 105,A02,093477,Carter; Anne Toulson,20,0,35,15
1657806088148,MATH 109,A01,083213,Ganzberger; Geoffrey Michael,3,0,34,31
1657806088148,MATH 109,A02,083214,Ganzberger; Geoffrey Michael,4,0,34,30
1657806088148,MATH 109,A03,093478,Ganzberger; Geoffrey Michael,2,0,34,32
1657806088148,MATH 109,B01,083215,Ganzberger; Geoffrey Michael,1,0,32,31
1657806088148,MATH 109,B02,083216,Ganzberger; Geoffrey Michael,2,0,32,30
1657806088148,MATH 109,B03,093479,Ganzberger; Geoffrey Michael,8,0,32,24
1657806094181,MATH 142A,A01,083219,Chow; Bennett,7,0,32,25
1657806094181,MATH 142A,A02,083220,Chow; Bennett,10,0,32,22
1657806094181,MATH 142A,A03,093480,Chow; Bennett,9,0,32,23
1657806094181,MATH 142A,B03,093481,Chow; Bennett,8,0,32,24
1657806094181,MATH 142A,B04,093558,Chow; Bennett,13,0,32,19
1657806094181,MATH 142A,B05,093559,Chow; Bennett,6,0,32,26
1657806100210,MATH 193A,A01,083224,Rotar; Vladimir,8,0,34,26
1657806100210,MATH 193A,A02,083225,Rotar; Vladimir,9,0,34,25
1657806100210,MATH 193A,A03,083781,Rotar; Vladimir,5,0,34,29
1657806100210,MATH 193A,A04,083782,Rotar; Vladimir,10,0,34,24
1657806100210,MATH 193A,A05,093482,Rotar; Vladimir,10,0,34,24
1657806106242,MATH 197,001,091859,McAuley; Julian John,9999,0,9999,0
1657806106242,MATH 197,002,095566,Kedlaya; Kiran S.,9997,0,9999,2
1657806106242,MATH 197,003,095567,Xiao; Ming,9999,0,9999,0
1657806106242,MATH 197,004,095571,Perols; Johan Lars,9998,0,9999,1
1657806113312,COGS 9,A01,083615,Shannon; Kyle Michael,9,0,75,66
1657806119338,COGS 11,A01,083617,Boyle; Mary E. T.,23,0,48,25
1657806125361,COGS 13,A01,083071,Bastos; Amalia Pinkusfeld,11,0,71,60
1657806131391,COGS 14A,A01,092681,Semenuks; Arturs,5,1,100,95
1657806137491,COGS 14B,A01,083073,Cheng; Tzu-Han,6,0,63,57
1657806143517,COGS 17,A01,092677,Semenuks; Arturs,6,0,81,75
1657806149549,COGS 100,A01,083619,Allen; Michael Gordon,17,0,70,53
1657806155578,COGS 101A,A01,083621,Davis; Joshua Daniel,9,0,68,59
1657806161609,COGS 101B,A01,091572,Allen; Michael Gordon,12,0,65,53
1657806167636,COGS 101C,A01,083625,Delgado; Tania,17,0,35,18
1657806173662,COGS 107A,A01,083627,Boyle; Mary E. T.,14,0,60,46
1657806179686,COGS 118A,A01,083075,Gupta; Anjum,21,0,76,55
1657806185723,CSE 3,A50,083646,Miranda; Gregory Joseph,24,0,50,26
1657806191754,CSE 8A,A50,083650,Miranda; Gregory Joseph,17,1,56,39
1657806197784,CSE 11,A01,083080,Cao; Yingjun,6,15,40,34
1657806203808,CSE 12,A01,083652,Krause-Levy; Sophia Louisa,28,1,120,92
1657806209833,CSE 15L,A01,083654,Morris; Justin Loren,9,0,50,41
1657806209833,CSE 15L,A02,083655,Morris; Justin Loren,9,0,50,41
1657806215864,CSE 20,A01,083657,Tran; Khoa Dang,39,0,80,41
1657806221896,CSE 21,A01,095574,Bach; Quang Tran,22,0,48,26
1657806227924,CSE 30,A01,083084,Eldon; John,6,0,80,74
1657806227924,CSE 30,B01,095061,Bhaskar; Nishant,9,0,50,41
1657806233956,CSE 100,A01,083659,Cao; Yingjun,5,4,70,65
1657806239987,CSE 134B,A01,083661,Powell; Thomas Allan,24,0,100,76
1657806246012,CSE 140,A01,083663,Gungor; Onat,15,0,85,70
1657806252040,CSE 140L,A01,083088,Eldon; John,23,0,100,77
1657806258066,CSE 175,A01,083665,Kumar; Rakesh,3,0,25,22
1657806264091,CSE 190,A00,092507,Dubnov; Shlomo,8,0,20,12
1657806270117,ECE 45,A01,083139,Congero; Spencer William,6,0,75,69
1657806276145,ECE 65,A50,083695,Saad; Andrew S,12,0,30,18
1657806276145,ECE 65,A51,095125,Saad; Andrew S,24,0,26,2
1657806282175,ECE 109,A01,091882,Touri; Behrouz,20,0,70,50
1657806288209,ECE 180,A00,083140,Abi Samra; Nicholas Camill,1,0,30,29
1657806288209,ECE 180,B00,083141,Abi Samra; Nicholas Camill,0,0,30,30
1657806294248,MATH 10A,A01,083735,Patchell; Gregory David,2,0,30,28
1657806294248,MATH 10A,A02,083736,Patchell; Gregory David,20,0,30,10
1657806294248,MATH 10A,A03,083737,Patchell; Gregory David,16,0,30,14
1657806300287,MATH 10B,A01,083207,Lim; Seonhee,8,0,34,26
1657806300287,MATH 10B,A02,083208,Lim; Seonhee,10,0,35,25
1657806300287,MATH 10B,A03,093472,Lim; Seonhee,7,0,34,27
1657806300287,MATH 10B,B01,083739,Sinha; Shubham,13,0,30,17
1657806306331,MATH 18,A01,083743,Cinel; Cameron Alexander,9,0,30,21
1657806306331,MATH 18,A02,083744,Cinel; Cameron Alexander,18,0,30,12
1657806306331,MATH 18,A03,083745,Cinel; Cameron Alexander,10,0,30,20
1657806306331,MATH 18,B01,083748,Rideout; David Porter,5,0,37,32
1657806306331,MATH 18,B02,083749,Rideout; David Porter,5,0,36,31
1657806306331,MATH 18,B03,083750,Rideout; David Porter,3,0,37,34
1657806306331,MATH 18,B04,083751,Rideout; David Porter,6,0,36,30
1657806306331,MATH 18,B05,093473,Rideout; David Porter,6,0,36,30
1657806306331,MATH 18,B06,093474,Rideout; David Porter,6,0,36,30
1657806312357,MATH 20A,A01,083754,Zheng; Zequn,14,0,40,26
1657806318382,MATH 20B,A01,083756,Briones; Jor-el Thomas Caparas,4,0,36,32
1657806318382,MATH 20B,A02,083757,Briones; Jor-el Thomas Caparas,1,0,36,35
1657806318382,MATH 20B,A03,093475,Briones; Jor-el Thomas Caparas,2,0,36,34
1657806324408,MATH 20C,A01,083760,Briones; Jor-el Thomas Caparas,1,0,35,34
1657806324408,MATH 20C,A02,083761,Briones; Jor-el Thomas Caparas,8,0,35,27
1657806324408,MATH 20C,A03,093476,Briones; Jor-el Thomas Caparas,0,1,36,36
1657806324408,MATH 20C,B01,083762,Bach; Quang Tran,1,0,30,29
1657806330439,MATH 20D,A01,083765,Tran; Brian Kha,5,0,30,25
1657806330439,MATH 20D,A02,083766,Tran; Brian Kha,5,0,30,25
1657806330439,MATH 20D,A03,083767,Tran; Brian Kha,5,0,30,25
1657806336466,MATH 20E,A01,083771,Ganguly; Soumya,10,0,32,22
1657806336466,MATH 20E,A02,083772,Ganguly; Soumya,6,0,32,26
1657806336466,MATH 20E,B01,083773,Ciotti; Benjamin,20,0,35,15
1657806336466,MATH 20E,B02,083774,Ciotti; Benjamin,18,0,35,17
1657806342492,MATH 103A,A01,083777,Greenfeld; Be'Eri,3,0,36,33
1657806342492,MATH 103A,A02,083778,Greenfeld; Be'Eri,5,0,36,31
1657806342492,MATH 103A,A03,093561,Greenfeld; Be'Eri,6,0,36,30
1657806342492,MATH 103A,B01,083779,Greenfeld; Be'Eri,7,0,36,29
1657806342492,MATH 103A,B02,083780,Greenfeld; Be'Eri,4,0,36,32
1657806342492,MATH 103A,B03,093562,Greenfeld; Be'Eri,3,0,36,33
1657806348521,MATH 105,A01,085443,Carter; Anne Toulson,15,0,35,20
1657806348521,MATH 105,A02,093477,Carter; Anne Toulson,20,0,35,15
1657806354553,MATH 109,A01,083213,Ganzberger; Geoffrey Michael,3,0,34,31
1657806354553,MATH 109,A02,083214,Ganzberger; Geoffrey Michael,4,0,34,30
1657806354553,MATH 109,A03,093478,Ganzberger; Geoffrey Michael,2,0,34,32
1657806354553,MATH 109,B01,083215,Ganzberger; Geoffrey Michael,1,0,32,31
1657806354553,MATH 109,B02,083216,Ganzberger; Geoffrey Michael,2,0,32,30
1657806354553,MATH 109,B03,093479,Ganzberger; Geoffrey Michael,8,0,32,24
1657806360589,MATH 142A,A01,083219,Chow; Bennett,7,0,32,25
1657806360589,MATH 142A,A02,083220,Chow; Bennett,10,0,32,22
1657806360589,MATH 142A,A03,093480,Chow; Bennett,9,0,32,23
1657806360589,MATH 142A,B03,093481,Chow; Bennett,8,0,32,24
1657806360589,MATH 142A,B04,093558,Chow; Bennett,13,0,32,19
1657806360589,MATH 142A,B05,093559,Chow; Bennett,6,0,32,26
1657806366616,MATH 193A,A01,083224,Rotar; Vladimir,8,0,34,26
1657806366616,MATH 193A,A02,083225,Rotar; Vladimir,9,0,34,25
1657806366616,MATH 193A,A03,083781,Rotar; Vladimir,5,0,34,29
1657806366616,MATH 193A,A04,083782,Rotar; Vladimir,10,0,34,24
1657806366616,MATH 193A,A05,093482,Rotar; Vladimir,10,0,34,24
1657806372647,MATH 197,001,091859,McAuley; Julian John,9999,0,9999,0
1657806372647,MATH 197,002,095566,Kedlaya; Kiran S.,9997,0,9999,2
1657806372647,MATH 197,003,095567,Xiao; Ming,9999,0,9999,0
1657806372647,MATH 197,004,095571,Perols; Johan Lars,9998,0,9999,1
1657806379710,COGS 9,A01,083615,Shannon; Kyle Michael,9,0,75,66
1657806385743,COGS 11,A01,083617,Boyle; Mary E. T.,23,0,48,25
1657806391774,COGS 13,A01,083071,Bastos; Amalia Pinkusfeld,11,0,71,60
1657806397797,COGS 14A,A01,092681,Semenuks; Arturs,5,1,100,95
1657806403819,COGS 14B,A01,083073,Cheng; Tzu-Han,6,0,63,57
1657806409843,COGS 17,A01,092677,Semenuks; Arturs,6,0,81,75
1657806415875,COGS 100,A01,083619,Allen; Michael Gordon,17,0,70,53
1657806421904,COGS 101A,A01,083621,Davis; Joshua Daniel,9,0,68,59
1657806427931,COGS 101B,A01,091572,Allen; Michael Gordon,12,0,65,53
1657806433962,COGS 101C,A01,083625,Delgado; Tania,17,0,35,18
1657806439990,COGS 107A,A01,083627,Boyle; Mary E. T.,14,0,60,46
1657806446017,COGS 118A,A01,083075,Gupta; Anjum,21,0,76,55
1657806452053,CSE 3,A50,083646,Miranda; Gregory Joseph,24,0,50,26
1657806458083,CSE 8A,A50,083650,Miranda; Gregory Joseph,17,1,56,39
1657806464111,CSE 11,A01,083080,Cao; Yingjun,6,15,40,34
1657806470137,CSE 12,A01,083652,Krause-Levy; Sophia Louisa,28,1,120,92
1657806476163,CSE 15L,A01,083654,Morris; Justin Loren,9,0,50,41
1657806476163,CSE 15L,A02,083655,Morris; Justin Loren,9,0,50,41
1657806482189,CSE 20,A01,083657,Tran; Khoa Dang,39,0,80,41
1657806488219,CSE 21,A01,095574,Bach; Quang Tran,22,0,48,26
1657806494252,CSE 30,A01,083084,Eldon; John,6,0,80,74
1657806494252,CSE 30,B01,095061,Bhaskar; Nishant,9,0,50,41
1657806500276,CSE 100,A01,083659,Cao; Yingjun,5,4,70,65
1657806506305,CSE 134B,A01,083661,Powell; Thomas Allan,24,0,100,76
1657806512330,CSE 140,A01,083663,Gungor; Onat,15,0,85,70
1657806518355,CSE 140L,A01,083088,Eldon; John,23,0,100,77
1657806524382,CSE 175,A01,083665,Kumar; Rakesh,3,0,25,22
1657806530408,CSE 190,A00,092507,Dubnov; Shlomo,8,0,20,12
1657806536444,ECE 45,A01,083139,Congero; Spencer William,6,0,75,69
1657806542476,ECE 65,A50,083695,Saad; Andrew S,12,0,30,18
1657806542476,ECE 65,A51,095125,Saad; Andrew S,24,0,26,2
1657806548500,ECE 109,A01,091882,Touri; Behrouz,20,0,70,50
1657806554546,ECE 180,A00,083140,Abi Samra; Nicholas Camill,1,0,30,29
1657806554546,ECE 180,B00,083141,Abi Samra; Nicholas Camill,0,0,30,30
1657806560571,MATH 10A,A01,083735,Patchell; Gregory David,2,0,30,28
1657806560571,MATH 10A,A02,083736,Patchell; Gregory David,20,0,30,10
1657806560571,MATH 10A,A03,083737,Patchell; Gregory David,16,0,30,14
1657806566609,MATH 10B,A01,083207,Lim; Seonhee,8,0,34,26
1657806566609,MATH 10B,A02,083208,Lim; Seonhee,10,0,35,25
1657806566609,MATH 10B,A03,093472,Lim; Seonhee,7,0,34,27
1657806566609,MATH 10B,B01,083739,Sinha; Shubham,13,0,30,17
1657806572638,MATH 18,A01,083743,Cinel; Cameron Alexander,9,0,30,21
1657806572638,MATH 18,A02,083744,Cinel; Cameron Alexander,18,0,30,12
1657806572638,MATH 18,A03,083745,Cinel; Cameron Alexander,10,0,30,20
1657806572638,MATH 18,B01,083748,Rideout; David Porter,5,0,37,32
1657806572638,MATH 18,B02,083749,Rideout; David Porter,5,0,36,31
1657806572638,MATH 18,B03,083750,Rideout; David Porter,3,0,37,34
1657806572638,MATH 18,B04,083751,Rideout; David Porter,6,0,36,30
1657806572638,MATH 18,B05,093473,Rideout; David Porter,6,0,36,30
1657806572638,MATH 18,B06,093474,Rideout; David Porter,6,0,36,30
1657806578664,MATH 20A,A01,083754,Zheng; Zequn,14,0,40,26
1657806584691,MATH 20B,A01,083756,Briones; Jor-el Thomas Caparas,4,0,36,32
1657806584691,MATH 20B,A02,083757,Briones; Jor-el Thomas Caparas,1,0,36,35
1657806584691,MATH 20B,A03,093475,Briones; Jor-el Thomas Caparas,2,0,36,34
1657806590717,MATH 20C,A01,083760,Briones; Jor-el Thomas Caparas,1,0,35,34
1657806590717,MATH 20C,A02,083761,Briones; Jor-el Thomas Caparas,8,0,35,27
1657806590717,MATH 20C,A03,093476,Briones; Jor-el Thomas Caparas,0,1,36,36
1657806590717,MATH 20C,B01,083762,Bach; Quang Tran,1,0,30,29
1657806596754,MATH 20D,A01,083765,Tran; Brian Kha,5,0,30,25
1657806596754,MATH 20D,A02,083766,Tran; Brian Kha,5,0,30,25
1657806596754,MATH 20D,A03,083767,Tran; Brian Kha,5,0,30,25
1657806602796,MATH 20E,A01,083771,Ganguly; Soumya,10,0,32,22
1657806602796,MATH 20E,A02,083772,Ganguly; Soumya,6,0,32,26
1657806602796,MATH 20E,B01,083773,Ciotti; Benjamin,20,0,35,15
1657806602796,MATH 20E,B02,083774,Ciotti; Benjamin,18,0,35,17
1657806608822,MATH 103A,A01,083777,Greenfeld; Be'Eri,3,0,36,33
1657806608822,MATH 103A,A02,083778,Greenfeld; Be'Eri,5,0,36,31
1657806608822,MATH 103A,A03,093561,Greenfeld; Be'Eri,6,0,36,30
1657806608822,MATH 103A,B01,083779,Greenfeld; Be'Eri,7,0,36,29
1657806608822,MATH 103A,B02,083780,Greenfeld; Be'Eri,4,0,36,32
1657806608822,MATH 103A,B03,093562,Greenfeld; Be'Eri,3,0,36,33
1657806614847,MATH 105,A01,085443,Carter; Anne Toulson,15,0,35,20
1657806614847,MATH 105,A02,093477,Carter; Anne Toulson,20,0,35,15
1657806620876,MATH 109,A01,083213,Ganzberger; Geoffrey Michael,3,0,34,31
1657806620876,MATH 109,A02,083214,Ganzberger; Geoffrey Michael,4,0,34,30
1657806620876,MATH 109,A03,093478,Ganzberger; Geoffrey Michael,2,0,34,32
1657806620876,MATH 109,B01,083215,Ganzberger; Geoffrey Michael,1,0,32,31
1657806620876,MATH 109,B02,083216,Ganzberger; Geoffrey Michael,2,0,32,30
1657806620876,MATH 109,B03,093479,Ganzberger; Geoffrey Michael,8,0,32,24
1657806626903,MATH 142A,A01,083219,Chow; Bennett,7,0,32,25
1657806626903,MATH 142A,A02,083220,Chow; Bennett,10,0,32,22
1657806626903,MATH 142A,A03,093480,Chow; Bennett,9,0,32,23
1657806626903,MATH 142A,B03,093481,Chow; Bennett,8,0,32,24
1657806626903,MATH 142A,B04,093558,Chow; Bennett,13,0,32,19
1657806626903,MATH 142A,B05,093559,Chow; Bennett,6,0,32,26
1657806632933,MATH 193A,A01,083224,Rotar; Vladimir,8,0,34,26
1657806632933,MATH 193A,A02,083225,Rotar; Vladimir,9,0,34,25
1657806632933,MATH 193A,A03,083781,Rotar; Vladimir,5,0,34,29
1657806632933,MATH 193A,A04,083782,Rotar; Vladimir,10,0,34,24
1657806632933,MATH 193A,A05,093482,Rotar; Vladimir,10,0,34,24
1657806638960,MATH 197,001,091859,McAuley; Julian John,9999,0,9999,0
1657806638960,MATH 197,002,095566,Kedlaya; Kiran S.,9997,0,9999,2
1657806638960,MATH 197,003,095567,Xiao; Ming,9999,0,9999,0
1657806638960,MATH 197,004,095571,Perols; Johan Lars,9998,0,9999,1
1657806646027,COGS 9,A01,083615,Shannon; Kyle Michael,9,0,75,66
1657806652058,COGS 11,A01,083617,Boyle; Mary E. T.,23,0,48,25
1657806658091,COGS 13,A01,083071,Bastos; Amalia Pinkusfeld,11,0,71,60
1657806664117,COGS 14A,A01,092681,Semenuks; Arturs,5,1,100,95
1657806670146,COGS 14B,A01,083073,Cheng; Tzu-Han,6,0,63,57
1657806676169,COGS 17,A01,092677,Semenuks; Arturs,6,0,81,75
1657806682195,COGS 100,A01,083619,Allen; Michael Gordon,17,0,70,53
1657806688220,COGS 101A,A01,083621,Davis; Joshua Daniel,9,0,68,59
1657806694250,COGS 101B,A01,091572,Allen; Michael Gordon,12,0,65,53
1657806700276,COGS 101C,A01,083625,Delgado; Tania,17,0,35,18
1657806706309,COGS 107A,A01,083627,Boyle; Mary E. T.,14,0,60,46
1657806712339,COGS 118A,A01,083075,Gupta; Anjum,21,0,76,55
1657806718370,CSE 3,A50,083646,Miranda; Gregory Joseph,24,0,50,26
1657806724394,CSE 8A,A50,083650,Miranda; Gregory Joseph,17,1,56,39
1657806730419,CSE 11,A01,083080,Cao; Yingjun,6,15,40,34
1657806736539,CSE 12,A01,083652,Krause-Levy; Sophia Louisa,28,1,120,92
1657806742565,CSE 15L,A01,083654,Morris; Justin Loren,9,0,50,41
1657806742565,CSE 15L,A02,083655,Morris; Justin Loren,9,0,50,41
1657806748591,CSE 20,A01,083657,Tran; Khoa Dang,39,0,80,41
1657806754613,CSE 21,A01,095574,Bach; Quang Tran,22,0,48,26
1657806760645,CSE 30,A01,083084,Eldon; John,6,0,80,74
1657806760645,CSE 30,B01,095061,Bhaskar; Nishant,9,0,50,41
1657806766670,CSE 100,A01,083659,Cao; Yingjun,5,4,70,65
1657806772695,CSE 134B,A01,083661,Powell; Thomas Allan,24,0,100,76
1657806778720,CSE 140,A01,083663,Gungor; Onat,15,0,85,70
1657806784749,CSE 140L,A01,083088,Eldon; John,23,0,100,77
1657806790784,CSE 175,A01,083665,Kumar; Rakesh,3,0,25,22
1657806796810,CSE 190,A00,092507,Dubnov; Shlomo,8,0,20,12
1657806802835,ECE 45,A01,083139,Congero; Spencer William,6,0,75,69
1657806808862,ECE 65,A50,083695,Saad; Andrew S,12,0,30,18
1657806808862,ECE 65,A51,095125,Saad; Andrew S,24,0,26,2
1657806814893,ECE 109,A01,091882,Touri; Behrouz,20,0,70,50
1657806820918,ECE 180,A00,083140,Abi Samra; Nicholas Camill,1,0,30,29
1657806820918,ECE 180,B00,083141,Abi Samra; Nicholas Camill,0,0,30,30
1657806826946,MATH 10A,A01,083735,Patchell; Gregory David,2,0,30,28
1657806826946,MATH 10A,A02,083736,Patchell; Gregory David,20,0,30,10
1657806826946,MATH 10A,A03,083737,Patchell; Gregory David,16,0,30,14
1657806832971,MATH 10B,A01,083207,Lim; Seonhee,8,0,34,26
1657806832971,MATH 10B,A02,083208,Lim; Seonhee,10,0,35,25
1657806832971,MATH 10B,A03,093472,Lim; Seonhee,7,0,34,27
1657806832971,MATH 10B,B01,083739,Sinha; Shubham,13,0,30,17
1657806839008,MATH 18,A01,083743,Cinel; Cameron Alexander,9,0,30,21
1657806839008,MATH 18,A02,083744,Cinel; Cameron Alexander,18,0,30,12
1657806839008,MATH 18,A03,083745,Cinel; Cameron Alexander,10,0,30,20
1657806839008,MATH 18,B01,083748,Rideout; David Porter,5,0,37,32
1657806839008,MATH 18,B02,083749,Rideout; David Porter,5,0,36,31
1657806839008,MATH 18,B03,083750,Rideout; David Porter,3,0,37,34
1657806839008,MATH 18,B04,083751,Rideout; David Porter,6,0,36,30
1657806839008,MATH 18,B05,093473,Rideout; David Porter,6,0,36,30
1657806839008,MATH 18,B06,093474,Rideout; David Porter,6,0,36,30
1657806845037,MATH 20A,A01,083754,Zheng; Zequn,14,0,40,26
1657806851071,MATH 20B,A01,083756,Briones; Jor-el Thomas Caparas,4,0,36,32
1657806851071,MATH 20B,A02,083757,Briones; Jor-el Thomas Caparas,1,0,36,35
1657806851071,MATH 20B,A03,093475,Briones; Jor-el Thomas Caparas,2,0,36,34
1657806857101,MATH 20C,A01,083760,Briones; Jor-el Thomas Caparas,1,0,35,34
1657806857101,MATH 20C,A02,083761,Briones; Jor-el Thomas Caparas,8,0,35,27
1657806857101,MATH 20C,A03,093476,Briones; Jor-el Thomas Caparas,0,1,36,36
1657806857101,MATH 20C,B01,083762,Bach; Quang Tran,1,0,30,29
1657806863133,MATH 20D,A01,083765,Tran; Brian Kha,5,0,30,25
1657806863133,MATH 20D,A02,083766,Tran; Brian Kha,5,0,30,25
1657806863133,MATH 20D,A03,083767,Tran; Brian Kha,5,0,30,25
1657806869169,MATH 20E,A01,083771,Ganguly; Soumya,10,0,32,22
1657806869169,MATH 20E,A02,083772,Ganguly; Soumya,6,0,32,26
1657806869169,MATH 20E,B01,083773,Ciotti; Benjamin,20,0,35,15
1657806869169,MATH 20E,B02,083774,Ciotti; Benjamin,18,0,35,17
1657806875196,MATH 103A,A01,083777,Greenfeld; Be'Eri,3,0,36,33
1657806875196,MATH 103A,A02,083778,Greenfeld; Be'Eri,5,0,36,31
1657806875196,MATH 103A,A03,093561,Greenfeld; Be'Eri,6,0,36,30
1657806875196,MATH 103A,B01,083779,Greenfeld; Be'Eri,7,0,36,29
1657806875196,MATH 103A,B02,083780,Greenfeld; Be'Eri,4,0,36,32
1657806875196,MATH 103A,B03,093562,Greenfeld; Be'Eri,3,0,36,33
1657806881224,MATH 105,A01,085443,Carter; Anne Toulson,15,0,35,20
1657806881224,MATH 105,A02,093477,Carter; Anne Toulson,20,0,35,15
1657806887249,MATH 109,A01,083213,Ganzberger; Geoffrey Michael,3,0,34,31
1657806887249,MATH 109,A02,083214,Ganzberger; Geoffrey Michael,4,0,34,30
1657806887249,MATH 109,A03,093478,Ganzberger; Geoffrey Michael,2,0,34,32
1657806887249,MATH 109,B01,083215,Ganzberger; Geoffrey Michael,1,0,32,31
1657806887249,MATH 109,B02,083216,Ganzberger; Geoffrey Michael,2,0,32,30
1657806887249,MATH 109,B03,093479,Ganzberger; Geoffrey Michael,8,0,32,24
1657806893277,MATH 142A,A01,083219,Chow; Bennett,7,0,32,25
1657806893277,MATH 142A,A02,083220,Chow; Bennett,10,0,32,22
1657806893277,MATH 142A,A03,093480,Chow; Bennett,9,0,32,23
1657806893277,MATH 142A,B03,093481,Chow; Bennett,8,0,32,24
1657806893277,MATH 142A,B04,093558,Chow; Bennett,13,0,32,19
1657806893277,MATH 142A,B05,093559,Chow; Bennett,6,0,32,26
1657806899304,MATH 193A,A01,083224,Rotar; Vladimir,8,0,34,26
1657806899304,MATH 193A,A02,083225,Rotar; Vladimir,9,0,34,25
1657806899304,MATH 193A,A03,083781,Rotar; Vladimir,5,0,34,29
1657806899304,MATH 193A,A04,083782,Rotar; Vladimir,10,0,34,24
1657806899304,MATH 193A,A05,093482,Rotar; Vladimir,10,0,34,24
1657806905334,MATH 197,001,091859,McAuley; Julian John,9999,0,9999,0
1657806905334,MATH 197,002,095566,Kedlaya; Kiran S.,9997,0,9999,2
1657806905334,MATH 197,003,095567,Xiao; Ming,9999,0,9999,0
1657806905334,MATH 197,004,095571,Perols; Johan Lars,9998,0,9999,1
1657806912401,COGS 9,A01,083615,Shannon; Kyle Michael,9,0,75,66
1657806918428,COGS 11,A01,083617,Boyle; Mary E. T.,23,0,48,25
1657806924459,COGS 13,A01,083071,Bastos; Amalia Pinkusfeld,11,0,71,60
1657806930486,COGS 14A,A01,092681,Semenuks; Arturs,5,1,100,95
1657806936512,COGS 14B,A01,083073,Cheng; Tzu-Han,6,0,63,57
1657806942538,COGS 17,A01,092677,Semenuks; Arturs,6,0,81,75
1657806948574,COGS 100,A01,083619,Allen; Michael Gordon,17,0,70,53
1657806954605,COGS 101A,A01,083621,Davis; Joshua Daniel,9,0,68,59
1657806960634,COGS 101B,A01,091572,Allen; Michael Gordon,12,0,65,53
1657806966658,COGS 101C,A01,083625,Delgado; Tania,17,0,35,18
1657806972687,COGS 107A,A01,083627,Boyle; Mary E. T.,14,0,60,46
1657806978717,COGS 118A,A01,083075,Gupta; Anjum,21,0,76,55
1657806984747,CSE 3,A50,083646,Miranda; Gregory Joseph,24,0,50,26
1657806990780,CSE 8A,A50,083650,Miranda; Gregory Joseph,17,1,56,39
1657806996806,CSE 11,A01,083080,Cao; Yingjun,6,15,40,34
1657807002834,CSE 12,A01,083652,Krause-Levy; Sophia Louisa,28,1,120,92
1657807008861,CSE 15L,A01,083654,Morris; Justin Loren,9,0,50,41
1657807008861,CSE 15L,A02,083655,Morris; Justin Loren,9,0,50,41
1657807014890,CSE 20,A01,083657,Tran; Khoa Dang,39,0,80,41
1657807020921,CSE 21,A01,095574,Bach; Quang Tran,22,0,48,26
1657807026948,CSE 30,A01,083084,Eldon; John,6,0,80,74
1657807026948,CSE 30,B01,095061,Bhaskar; Nishant,9,0,50,41
1657807032977,CSE 100,A01,083659,Cao; Yingjun,5,4,70,65
1657807039003,CSE 134B,A01,083661,Powell; Thomas Allan,24,0,100,76
1657807045028,CSE 140,A01,083663,Gungor; Onat,15,0,85,70
1657807051054,CSE 140L,A01,083088,Eldon; John,23,0,100,77
1657807057079,CSE 175,A01,083665,Kumar; Rakesh,3,0,25,22
1657807063113,CSE 190,A00,092507,Dubnov; Shlomo,8,0,20,12
1657807069153,ECE 45,A01,083139,Congero; Spencer William,6,0,75,69
1657807075194,ECE 65,A50,083695,Saad; Andrew S,12,0,30,18
1657807075194,ECE 65,A51,095125,Saad; Andrew S,24,0,26,2
1657807081222,ECE 109,A01,091882,Touri; Behrouz,20,0,70,50
1657807087248,ECE 180,A00,083140,Abi Samra; Nicholas Camill,1,0,30,29
1657807087248,ECE 180,B00,083141,Abi Samra; Nicholas Camill,0,0,30,30
1657807093275,MATH 10A,A01,083735,Patchell; Gregory David,2,0,30,28
1657807093275,MATH 10A,A02,083736,Patchell; Gregory David,20,0,30,10
1657807093275,MATH 10A,A03,083737,Patchell; Gregory David,16,0,30,14
1657807099302,MATH 10B,A01,083207,Lim; Seonhee,8,0,34,26
1657807099302,MATH 10B,A02,083208,Lim; Seonhee,10,0,35,25
1657807099302,MATH 10B,A03,093472,Lim; Seonhee,7,0,34,27
1657807099302,MATH 10B,B01,083739,Sinha; Shubham,13,0,30,17
1657807105329,MATH 18,A01,083743,Cinel; Cameron Alexander,9,0,30,21
1657807105329,MATH 18,A02,083744,Cinel; Cameron Alexander,18,0,30,12
1657807105329,MATH 18,A03,083745,Cinel; Cameron Alexander,10,0,30,20
1657807105329,MATH 18,B01,083748,Rideout; David Porter,5,0,37,32
1657807105329,MATH 18,B02,083749,Rideout; David Porter,5,0,36,31
1657807105329,MATH 18,B03,083750,Rideout; David Porter,3,0,37,34
1657807105329,MATH 18,B04,083751,Rideout; David Porter,6,0,36,30
1657807105329,MATH 18,B05,093473,Rideout; David Porter,6,0,36,30
1657807105329,MATH 18,B06,093474,Rideout; David Porter,6,0,36,30
1657807111360,MATH 20A,A01,083754,Zheng; Zequn,14,0,40,26
1657807117397,MATH 20B,A01,083756,Briones; Jor-el Thomas Caparas,4,0,36,32
1657807117397,MATH 20B,A02,083757,Briones; Jor-el Thomas Caparas,1,0,36,35
1657807117397,MATH 20B,A03,093475,Briones; Jor-el Thomas Caparas,2,0,36,34
1657807123428,MATH 20C,A01,083760,Briones; Jor-el Thomas Caparas,1,0,35,34
1657807123428,MATH 20C,A02,083761,Briones; Jor-el Thomas Caparas,8,0,35,27
1657807123428,MATH 20C,A03,093476,Briones; Jor-el Thomas Caparas,0,1,36,36
1657807123428,MATH 20C,B01,083762,Bach; Quang Tran,1,0,30,29
1657807129453,MATH 20D,A01,083765,Tran; Brian Kha,5,0,30,25
1657807129453,MATH 20D,A02,083766,Tran; Brian Kha,5,0,30,25
1657807129453,MATH 20D,A03,083767,Tran; Brian Kha,5,0,30,25
1657807135495,MATH 20E,A01,083771,Ganguly; Soumya,10,0,32,22
1657807135495,MATH 20E,A02,083772,Ganguly; Soumya,6,0,32,26
1657807135495,MATH 20E,B01,083773,Ciotti; Benjamin,20,0,35,15
1657807135495,MATH 20E,B02,083774,Ciotti; Benjamin,18,0,35,17
1657807141530,MATH 103A,A01,083777,Greenfeld; Be'Eri,3,0,36,33
1657807141530,MATH 103A,A02,083778,Greenfeld; Be'Eri,5,0,36,31
1657807141530,MATH 103A,A03,093561,Greenfeld; Be'Eri,6,0,36,30
1657807141530,MATH 103A,B01,083779,Greenfeld; Be'Eri,7,0,36,29
1657807141530,MATH 103A,B02,083780,Greenfeld; Be'Eri,4,0,36,32
1657807141530,MATH 103A,B03,093562,Greenfeld; Be'Eri,3,0,36,33
1657807147561,MATH 105,A01,085443,Carter; Anne Toulson,15,0,35,20
1657807147561,MATH 105,A02,093477,Carter; Anne Toulson,20,0,35,15
1657807153593,MATH 109,A01,083213,Ganzberger; Geoffrey Michael,3,0,34,31
1657807153593,MATH 109,A02,083214,Ganzberger; Geoffrey Michael,4,0,34,30
1657807153593,MATH 109,A03,093478,Ganzberger; Geoffrey Michael,2,0,34,32
1657807153593,MATH 109,B01,083215,Ganzberger; Geoffrey Michael,1,0,32,31
1657807153593,MATH 109,B02,083216,Ganzberger; Geoffrey Michael,2,0,32,30
1657807153593,MATH 109,B03,093479,Ganzberger; Geoffrey Michael,8,0,32,24
1657807159618,MATH 142A,A01,083219,Chow; Bennett,7,0,32,25
1657807159618,MATH 142A,A02,083220,Chow; Bennett,10,0,32,22
1657807159618,MATH 142A,A03,093480,Chow; Bennett,9,0,32,23
1657807159618,MATH 142A,B03,093481,Chow; Bennett,8,0,32,24
1657807159618,MATH 142A,B04,093558,Chow; Bennett,13,0,32,19
1657807159618,MATH 142A,B05,093559,Chow; Bennett,6,0,32,26
1657807165651,MATH 193A,A01,083224,Rotar; Vladimir,8,0,34,26
1657807165651,MATH 193A,A02,083225,Rotar; Vladimir,9,0,34,25
1657807165651,MATH 193A,A03,083781,Rotar; Vladimir,5,0,34,29
1657807165651,MATH 193A,A04,083782,Rotar; Vladimir,10,0,34,24
1657807165651,MATH 193A,A05,093482,Rotar; Vladimir,10,0,34,24
1657807171680,MATH 197,001,091859,McAuley; Julian John,9999,0,9999,0
1657807171680,MATH 197,002,095566,Kedlaya; Kiran S.,9997,0,9999,2
1657807171680,MATH 197,003,095567,Xiao; Ming,9999,0,9999,0
1657807171680,MATH 197,004,095571,Perols; Johan Lars,9998,0,9999,1
1657807178746,COGS 9,A01,083615,Shannon; Kyle Michael,9,0,75,66
1657807184773,COGS 11,A01,083617,Boyle; Mary E. T.,23,0,48,25
1657807190797,COGS 13,A01,083071,Bastos; Amalia Pinkusfeld,11,0,71,60
1657807196829,COGS 14A,A01,092681,Semenuks; Arturs,5,1,100,95
1657807202852,COGS 14B,A01,083073,Cheng; Tzu-Han,6,0,63,57
1657807208877,COGS 17,A01,092677,Semenuks; Arturs,6,0,81,75
1657807214908,COGS 100,A01,083619,Allen; Michael Gordon,17,0,70,53
1657807220932,COGS 101A,A01,083621,Davis; Joshua Daniel,9,0,68,59
1657807226958,COGS 101B,A01,091572,Allen; Michael Gordon,12,0,65,53
1657807232988,COGS 101C,A01,083625,Delgado; Tania,17,0,35,18
1657807239013,COGS 107A,A01,083627,Boyle; Mary E. T.,14,0,60,46
1657807245043,COGS 118A,A01,083075,Gupta; Anjum,21,0,76,55
1657807251074,CSE 3,A50,083646,Miranda; Gregory Joseph,24,0,50,26
1657807257098,CSE 8A,A50,083650,Miranda; Gregory Joseph,17,1,56,39
1657807263124,CSE 11,A01,083080,Cao; Yingjun,6,15,40,34
1657807269157,CSE 12,A01,083652,Krause-Levy; Sophia Louisa,28,1,120,92
1657807275184,CSE 15L,A01,083654,Morris; Justin Loren,9,0,50,41
1657807275184,CSE 15L,A02,083655,Morris; Justin Loren,9,0,50,41
1657807281216,CSE 20,A01,083657,Tran; Khoa Dang,39,0,80,41
1657807287242,CSE 21,A01,095574,Bach; Quang Tran,22,0,48,26
1657807293276,CSE 30,A01,083084,Eldon; John,6,0,80,74
1657807293276,CSE 30,B01,095061,Bhaskar; Nishant,9,0,50,41
1657807299305,CSE 100,A01,083659,Cao; Yingjun,5,4,70,65
1657807305338,CSE 134B,A01,083661,Powell; Thomas Allan,24,0,100,76
1657807311369,CSE 140,A01,083663,Gungor; Onat,15,0,85,70
1657807317399,CSE 140L,A01,083088,Eldon; John,23,0,100,77
1657807323424,CSE 175,A01,083665,Kumar; Rakesh,3,0,25,22
1657807329450,CSE 190,A00,092507,Dubnov; Shlomo,8,0,20,12
1657807335565,ECE 45,A01,083139,Congero; Spencer William,6,0,75,69
1657807341618,ECE 65,A50,083695,Saad; Andrew S,12,0,30,18
1657807341618,ECE 65,A51,095125,Saad; Andrew S,24,0,26,2
1657807347646,ECE 109,A01,091882,Touri; Behrouz,20,0,70,50
1657807353679,ECE 180,A00,083140,Abi Samra; Nicholas Camill,1,0,30,29
1657807353679,ECE 180,B00,083141,Abi Samra; Nicholas Camill,0,0,30,30
1657807359706,MATH 10A,A01,083735,Patchell; Gregory David,2,0,30,28
1657807359706,MATH 10A,A02,083736,Patchell; Gregory David,20,0,30,10
1657807359706,MATH 10A,A03,083737,Patchell; Gregory David,16,0,30,14
1657807365736,MATH 10B,A01,083207,Lim; Seonhee,8,0,34,26
1657807365736,MATH 10B,A02,083208,Lim; Seonhee,10,0,35,25
1657807365736,MATH 10B,A03,093472,Lim; Seonhee,7,0,34,27
1657807365736,MATH 10B,B01,083739,Sinha; Shubham,13,0,30,17
1657807371778,MATH 18,A01,083743,Cinel; Cameron Alexander,9,0,30,21
1657807371778,MATH 18,A02,083744,Cinel; Cameron Alexander,18,0,30,12
1657807371778,MATH 18,A03,083745,Cinel; Cameron Alexander,10,0,30,20
1657807371778,MATH 18,B01,083748,Rideout; David Porter,5,0,37,32
1657807371778,MATH 18,B02,083749,Rideout; David Porter,5,0,36,31
1657807371778,MATH 18,B03,083750,Rideout; David Porter,3,0,37,34
1657807371778,MATH 18,B04,083751,Rideout; David Porter,6,0,36,30
1657807371778,MATH 18,B05,093473,Rideout; David Porter,6,0,36,30
1657807371778,MATH 18,B06,093474,Rideout; David Porter,6,0,36,30
1657807377811,MATH 20A,A01,083754,Zheng; Zequn,14,0,40,26
1657807383844,MATH 20B,A01,083756,Briones; Jor-el Thomas Caparas,4,0,36,32
1657807383844,MATH 20B,A02,083757,Briones; Jor-el Thomas Caparas,1,0,36,35
1657807383844,MATH 20B,A03,093475,Briones; Jor-el Thomas Caparas,2,0,36,34
1657807389875,MATH 20C,A01,083760,Briones; Jor-el Thomas Caparas,1,0,35,34
1657807389875,MATH 20C,A02,083761,Briones; Jor-el Thomas Caparas,8,0,35,27
1657807389875,MATH 20C,A03,093476,Briones; Jor-el Thomas Caparas,0,1,36,36
1657807389875,MATH 20C,B01,083762,Bach; Quang Tran,1,0,30,29
1657807395907,MATH 20D,A01,083765,Tran; Brian Kha,5,0,30,25
1657807395907,MATH 20D,A02,083766,Tran; Brian Kha,5,0,30,25
1657807395907,MATH 20D,A03,083767,Tran; Brian Kha,5,0,30,25
1657807401943,MATH 20E,A01,083771,Ganguly; Soumya,10,0,32,22
1657807401943,MATH 20E,A02,083772,Ganguly; Soumya,6,0,32,26
1657807401943,MATH 20E,B01,083773,Ciotti; Benjamin,20,0,35,15
1657807401943,MATH 20E,B02,083774,Ciotti; Benjamin,18,0,35,17
1657807407978,MATH 103A,A01,083777,Greenfeld; Be'Eri,3,0,36,33
1657807407978,MATH 103A,A02,083778,Greenfeld; Be'Eri,5,0,36,31
1657807407978,MATH 103A,A03,093561,Greenfeld; Be'Eri,6,0,36,30
1657807407978,MATH 103A,B01,083779,Greenfeld; Be'Eri,7,0,36,29
1657807407978,MATH 103A,B02,083780,Greenfeld; Be'Eri,4,0,36,32
1657807407978,MATH 103A,B03,093562,Greenfeld; Be'Eri,3,0,36,33
1657807414012,MATH 105,A01,085443,Carter; Anne Toulson,15,0,35,20
1657807414012,MATH 105,A02,093477,Carter; Anne Toulson,20,0,35,15
1657807420036,MATH 109,A01,083213,Ganzberger; Geoffrey Michael,3,0,34,31
1657807420036,MATH 109,A02,083214,Ganzberger; Geoffrey Michael,4,0,34,30
1657807420036,MATH 109,A03,093478,Ganzberger; Geoffrey Michael,2,0,34,32
1657807420036,MATH 109,B01,083215,Ganzberger; Geoffrey Michael,1,0,32,31
1657807420036,MATH 109,B02,083216,Ganzberger; Geoffrey Michael,2,0,32,30
1657807420036,MATH 109,B03,093479,Ganzberger; Geoffrey Michael,8,0,32,24
1657807426063,MATH 142A,A01,083219,Chow; Bennett,7,0,32,25
1657807426063,MATH 142A,A02,083220,Chow; Bennett,10,0,32,22
1657807426063,MATH 142A,A03,093480,Chow; Bennett,9,0,32,23
1657807426063,MATH 142A,B03,093481,Chow; Bennett,8,0,32,24
1657807426063,MATH 142A,B04,093558,Chow; Bennett,13,0,32,19
1657807426063,MATH 142A,B05,093559,Chow; Bennett,6,0,32,26
1657807432091,MATH 193A,A01,083224,Rotar; Vladimir,8,0,34,26
1657807432091,MATH 193A,A02,083225,Rotar; Vladimir,9,0,34,25
1657807432091,MATH 193A,A03,083781,Rotar; Vladimir,5,0,34,29
1657807432091,MATH 193A,A04,083782,Rotar; Vladimir,10,0,34,24
1657807432091,MATH 193A,A05,093482,Rotar; Vladimir,10,0,34,24
1657807438121,MATH 197,001,091859,McAuley; Julian John,9999,0,9999,0
1657807438121,MATH 197,002,095566,Kedlaya; Kiran S.,9997,0,9999,2
1657807438121,MATH 197,003,095567,Xiao; Ming,9999,0,9999,0
1657807438121,MATH 197,004,095571,Perols; Johan Lars,9998,0,9999,1
1657807445246,COGS 9,A01,083615,Shannon; Kyle Michael,9,0,75,66
1657807451272,COGS 11,A01,083617,Boyle; Mary E. T.,23,0,48,25
1657807457308,COGS 13,A01,083071,Bastos; Amalia Pinkusfeld,11,0,71,60
1657807463346,COGS 14A,A01,092681,Semenuks; Arturs,5,1,100,95
1657807469387,COGS 14B,A01,083073,Cheng; Tzu-Han,6,0,63,57
1657807475414,COGS 17,A01,092677,Semenuks; Arturs,6,0,81,75
1657807481437,COGS 100,A01,083619,Allen; Michael Gordon,17,0,70,53
1657807487467,COGS 101A,A01,083621,Davis; Joshua Daniel,9,0,68,59
1657807493497,COGS 101B,A01,091572,Allen; Michael Gordon,12,0,65,53
1657807499526,COGS 101C,A01,083625,Delgado; Tania,17,0,35,18
1657807505558,COGS 107A,A01,083627,Boyle; Mary E. T.,14,0,60,46
1657807511597,COGS 118A,A01,083075,Gupta; Anjum,21,0,76,55
1657807517627,CSE 3,A50,083646,Miranda; Gregory Joseph,24,0,50,26
1657807523664,CSE 8A,A50,083650,Miranda; Gregory Joseph,17,1,56,39
1657807529688,CSE 11,A01,083080,Cao; Yingjun,6,15,40,34
1657807535714,CSE 12,A01,083652,Krause-Levy; Sophia Louisa,28,1,120,92
1657807541742,CSE 15L,A01,083654,Morris; Justin Loren,9,0,50,41
1657807541742,CSE 15L,A02,083655,Morris; Justin Loren,9,0,50,41
1657807547767,CSE 20,A01,083657,Tran; Khoa Dang,39,0,80,41
1657807553792,CSE 21,A01,095574,Bach; Quang Tran,22,0,48,26
1657807559818,CSE 30,A01,083084,Eldon; John,6,0,80,74
1657807559818,CSE 30,B01,095061,Bhaskar; Nishant,9,0,50,41
1657807565842,CSE 100,A01,083659,Cao; Yingjun,5,4,70,65
1657807571873,CSE 134B,A01,083661,Powell; Thomas Allan,24,0,100,76
1657807577897,CSE 140,A01,083663,Gungor; Onat,15,0,85,70
1657807583922,CSE 140L,A01,083088,Eldon; John,23,0,100,77
1657807589952,CSE 175,A01,083665,Kumar; Rakesh,3,0,25,22
1657807595975,CSE 190,A00,092507,Dubnov; Shlomo,8,0,20,12
1657807602003,ECE 45,A01,083139,Congero; Spencer William,6,0,75,69
1657807608032,ECE 65,A50,083695,Saad; Andrew S,12,0,30,18
1657807608032,ECE 65,A51,095125,Saad; Andrew S,24,0,26,2
1657807614056,ECE 109,A01,091882,Touri; Behrouz,20,0,70,50
1657807620080,ECE 180,A00,083140,Abi Samra; Nicholas Camill,1,0,30,29
1657807620080,ECE 180,B00,083141,Abi Samra; Nicholas Camill,0,0,30,30
1657807626107,MATH 10A,A01,083735,Patchell; Gregory David,2,0,30,28
1657807626107,MATH 10A,A02,083736,Patchell; Gregory David,20,0,30,10
1657807626107,MATH 10A,A03,083737,Patchell; Gregory David,16,0,30,14
1657807632138,MATH 10B,A01,083207,Lim; Seonhee,8,0,34,26
1657807632138,MATH 10B,A02,083208,Lim; Seonhee,10,0,35,25
1657807632138,MATH 10B,A03,093472,Lim; Seonhee,7,0,34,27
1657807632138,MATH 10B,B01,083739,Sinha; Shubham,13,0,30,17
1657807638173,MATH 18,A01,083743,Cinel; Cameron Alexander,9,0,30,21
1657807638173,MATH 18,A02,083744,Cinel; Cameron Alexander,18,0,30,12
1657807638173,MATH 18,A03,083745,Cinel; Cameron Alexander,10,0,30,20
1657807638173,MATH 18,B01,083748,Rideout; David Porter,5,0,37,32
1657807638173,MATH 18,B02,083749,Rideout; David Porter,5,0,36,31
1657807638173,MATH 18,B03,083750,Rideout; David Porter,3,0,37,34
1657807638173,MATH 18,B04,083751,Rideout; David Porter,6,0,36,30
1657807638173,MATH 18,B05,093473,Rideout; David Porter,6,0,36,30
1657807638173,MATH 18,B06,093474,Rideout; David Porter,6,0,36,30
1657807644196,MATH 20A,A01,083754,Zheng; Zequn,14,0,40,26
1657807650225,MATH 20B,A01,083756,Briones; Jor-el Thomas Caparas,4,0,36,32
1657807650225,MATH 20B,A02,083757,Briones; Jor-el Thomas Caparas,1,0,36,35
1657807650225,MATH 20B,A03,093475,Briones; Jor-el Thomas Caparas,2,0,36,34
1657807656259,MATH 20C,A01,083760,Briones; Jor-el Thomas Caparas,1,0,35,34
1657807656259,MATH 20C,A02,083761,Briones; Jor-el Thomas Caparas,8,0,35,27
1657807656259,MATH 20C,A03,093476,Briones; Jor-el Thomas Caparas,0,1,36,36
1657807656259,MATH 20C,B01,083762,Bach; Quang Tran,1,0,30,29
1657807662289,MATH 20D,A01,083765,Tran; Brian Kha,5,0,30,25
1657807662289,MATH 20D,A02,083766,Tran; Brian Kha,5,0,30,25
1657807662289,MATH 20D,A03,083767,Tran; Brian Kha,5,0,30,25
1657807668313,MATH 20E,A01,083771,Ganguly; Soumya,10,0,32,22
1657807668313,MATH 20E,A02,083772,Ganguly; Soumya,6,0,32,26
1657807668313,MATH 20E,B01,083773,Ciotti; Benjamin,20,0,35,15
1657807668313,MATH 20E,B02,083774,Ciotti; Benjamin,18,0,35,17
1657807674352,MATH 103A,A01,083777,Greenfeld; Be'Eri,3,0,36,33
1657807674352,MATH 103A,A02,083778,Greenfeld; Be'Eri,5,0,36,31
1657807674352,MATH 103A,A03,093561,Greenfeld; Be'Eri,6,0,36,30
1657807674352,MATH 103A,B01,083779,Greenfeld; Be'Eri,7,0,36,29
1657807674352,MATH 103A,B02,083780,Greenfeld; Be'Eri,4,0,36,32
1657807674352,MATH 103A,B03,093562,Greenfeld; Be'Eri,3,0,36,33
1657807680378,MATH 105,A01,085443,Carter; Anne Toulson,15,0,35,20
1657807680378,MATH 105,A02,093477,Carter; Anne Toulson,20,0,35,15
1657807686404,MATH 109,A01,083213,Ganzberger; Geoffrey Michael,3,0,34,31
1657807686404,MATH 109,A02,083214,Ganzberger; Geoffrey Michael,4,0,34,30
1657807686404,MATH 109,A03,093478,Ganzberger; Geoffrey Michael,2,0,34,32
1657807686404,MATH 109,B01,083215,Ganzberger; Geoffrey Michael,1,0,32,31
1657807686404,MATH 109,B02,083216,Ganzberger; Geoffrey Michael,2,0,32,30
1657807686404,MATH 109,B03,093479,Ganzberger; Geoffrey Michael,8,0,32,24
1657807692432,MATH 142A,A01,083219,Chow; Bennett,7,0,32,25
1657807692432,MATH 142A,A02,083220,Chow; Bennett,10,0,32,22
1657807692432,MATH 142A,A03,093480,Chow; Bennett,9,0,32,23
1657807692432,MATH 142A,B03,093481,Chow; Bennett,8,0,32,24
1657807692432,MATH 142A,B04,093558,Chow; Bennett,13,0,32,19
1657807692432,MATH 142A,B05,093559,Chow; Bennett,6,0,32,26
1657807698455,MATH 193A,A01,083224,Rotar; Vladimir,8,0,34,26
1657807698455,MATH 193A,A02,083225,Rotar; Vladimir,9,0,34,25
1657807698455,MATH 193A,A03,083781,Rotar; Vladimir,5,0,34,29
1657807698455,MATH 193A,A04,083782,Rotar; Vladimir,10,0,34,24
1657807698455,MATH 193A,A05,093482,Rotar; Vladimir,10,0,34,24
1657807704485,MATH 197,001,091859,McAuley; Julian John,9999,0,9999,0
1657807704485,MATH 197,002,095566,Kedlaya; Kiran S.,9997,0,9999,2
1657807704485,MATH 197,003,095567,Xiao; Ming,9999,0,9999,0
1657807704485,MATH 197,004,095571,Perols; Johan Lars,9998,0,9999,1
1657807711543,COGS 9,A01,083615,Shannon; Kyle Michael,9,0,75,66
1657807717581,COGS 11,A01,083617,Boyle; Mary E. T.,23,0,48,25
1657807723611,COGS 13,A01,083071,Bastos; Amalia Pinkusfeld,11,0,71,60
1657807729636,COGS 14A,A01,092681,Semenuks; Arturs,5,1,100,95
1657807735659,COGS 14B,A01,083073,Cheng; Tzu-Han,6,0,63,57
1657807741691,COGS 17,A01,092677,Semenuks; Arturs,6,0,81,75
1657807747721,COGS 100,A01,083619,Allen; Michael Gordon,17,0,70,53
1657807753744,COGS 101A,A01,083621,Davis; Joshua Daniel,9,0,68,59
1657807759766,COGS 101B,A01,091572,Allen; Michael Gordon,12,0,65,53
1657807765793,COGS 101C,A01,083625,Delgado; Tania,17,0,35,18
1657807771819,COGS 107A,A01,083627,Boyle; Mary E. T.,14,0,60,46
1657807777848,COGS 118A,A01,083075,Gupta; Anjum,21,0,76,55
1657807783874,CSE 3,A50,083646,Miranda; Gregory Joseph,24,0,50,26
1657807789915,CSE 8A,A50,083650,Miranda; Gregory Joseph,17,1,56,39
1657807795944,CSE 11,A01,083080,Cao; Yingjun,6,15,40,34
1657807801973,CSE 12,A01,083652,Krause-Levy; Sophia Louisa,28,1,120,92
1657807807996,CSE 15L,A01,083654,Morris; Justin Loren,9,0,50,41
1657807807996,CSE 15L,A02,083655,Morris; Justin Loren,9,0,50,41
1657807814020,CSE 20,A01,083657,Tran; Khoa Dang,39,0,80,41
1657807820050,CSE 21,A01,095574,Bach; Quang Tran,22,0,48,26
1657807826082,CSE 30,A01,083084,Eldon; John,6,0,80,74
1657807826082,CSE 30,B01,095061,Bhaskar; Nishant,9,0,50,41
1657807832107,CSE 100,A01,083659,Cao; Yingjun,5,4,70,65
1657807838138,CSE 134B,A01,083661,Powell; Thomas Allan,24,0,100,76
1657807844169,CSE 140,A01,083663,Gungor; Onat,15,0,85,70
1657807850193,CSE 140L,A01,083088,Eldon; John,23,0,100,77
1657807856217,CSE 175,A01,083665,Kumar; Rakesh,3,0,25,22
1657807862275,CSE 190,A00,092507,Dubnov; Shlomo,8,0,20,12
1657807868302,ECE 45,A01,083139,Congero; Spencer William,6,0,75,69
1657807874331,ECE 65,A50,083695,Saad; Andrew S,12,0,30,18
1657807874331,ECE 65,A51,095125,Saad; Andrew S,24,0,26,2
1657807880360,ECE 109,A01,091882,Touri; Behrouz,20,0,70,50
1657807886386,ECE 180,A00,083140,Abi Samra; Nicholas Camill,1,0,30,29
1657807886386,ECE 180,B00,083141,Abi Samra; Nicholas Camill,0,0,30,30
1657807892410,MATH 10A,A01,083735,Patchell; Gregory David,2,0,30,28
1657807892410,MATH 10A,A02,083736,Patchell; Gregory David,20,0,30,10
1657807892410,MATH 10A,A03,083737,Patchell; Gregory David,16,0,30,14
1657807898435,MATH 10B,A01,083207,Lim; Seonhee,8,0,34,26
1657807898435,MATH 10B,A02,083208,Lim; Seonhee,10,0,35,25
1657807898435,MATH 10B,A03,093472,Lim; Seonhee,7,0,34,27
1657807898435,MATH 10B,B01,083739,Sinha; Shubham,13,0,30,17
1657807904462,MATH 18,A01,083743,Cinel; Cameron Alexander,9,0,30,21
1657807904462,MATH 18,A02,083744,Cinel; Cameron Alexander,18,0,30,12
1657807904462,MATH 18,A03,083745,Cinel; Cameron Alexander,10,0,30,20
1657807904462,MATH 18,B01,083748,Rideout; David Porter,5,0,37,32
1657807904462,MATH 18,B02,083749,Rideout; David Porter,5,0,36,31
1657807904462,MATH 18,B03,083750,Rideout; David Porter,3,0,37,34
1657807904462,MATH 18,B04,083751,Rideout; David Porter,6,0,36,30
1657807904462,MATH 18,B05,093473,Rideout; David Porter,6,0,36,30
1657807904462,MATH 18,B06,093474,Rideout; David Porter,6,0,36,30
1657807910487,MATH 20A,A01,083754,Zheng; Zequn,14,0,40,26
1657807916517,MATH 20B,A01,083756,Briones; Jor-el Thomas Caparas,4,0,36,32
1657807916517,MATH 20B,A02,083757,Briones; Jor-el Thomas Caparas,1,0,36,35
1657807916517,MATH 20B,A03,093475,Briones; Jor-el Thomas Caparas,2,0,36,34
1657807922544,MATH 20C,A01,083760,Briones; Jor-el Thomas Caparas,1,0,35,34
1657807922544,MATH 20C,A02,083761,Briones; Jor-el Thomas Caparas,8,0,35,27
1657807922544,MATH 20C,A03,093476,Briones; Jor-el Thomas Caparas,0,1,36,36
1657807922544,MATH 20C,B01,083762,Bach; Quang Tran,1,0,30,29
1657807928576,MATH 20D,A01,083765,Tran; Brian Kha,5,0,30,25
1657807928576,MATH 20D,A02,083766,Tran; Brian Kha,5,0,30,25
1657807928576,MATH 20D,A03,083767,Tran; Brian Kha,5,0,30,25
1657807934691,MATH 20E,A01,083771,Ganguly; Soumya,10,0,32,22
1657807934691,MATH 20E,A02,083772,Ganguly; Soumya,6,0,32,26
1657807934691,MATH 20E,B01,083773,Ciotti; Benjamin,20,0,35,15
1657807934691,MATH 20E,B02,083774,Ciotti; Benjamin,18,0,35,17
1657807940723,MATH 103A,A01,083777,Greenfeld; Be'Eri,3,0,36,33
1657807940723,MATH 103A,A02,083778,Greenfeld; Be'Eri,5,0,36,31
1657807940723,MATH 103A,A03,093561,Greenfeld; Be'Eri,6,0,36,30
1657807940723,MATH 103A,B01,083779,Greenfeld; Be'Eri,7,0,36,29
1657807940723,MATH 103A,B02,083780,Greenfeld; Be'Eri,4,0,36,32
1657807940723,MATH 103A,B03,093562,Greenfeld; Be'Eri,3,0,36,33
1657807946754,MATH 105,A01,085443,Carter; Anne Toulson,15,0,35,20
1657807946754,MATH 105,A02,093477,Carter; Anne Toulson,20,0,35,15
1657807952785,MATH 109,A01,083213,Ganzberger; Geoffrey Michael,3,0,34,31
1657807952785,MATH 109,A02,083214,Ganzberger; Geoffrey Michael,4,0,34,30
1657807952785,MATH 109,A03,093478,Ganzberger; Geoffrey Michael,2,0,34,32
1657807952785,MATH 109,B01,083215,Ganzberger; Geoffrey Michael,1,0,32,31
1657807952785,MATH 109,B02,083216,Ganzberger; Geoffrey Michael,2,0,32,30
1657807952785,MATH 109,B03,093479,Ganzberger; Geoffrey Michael,8,0,32,24
1657807958818,MATH 142A,A01,083219,Chow; Bennett,7,0,32,25
1657807958818,MATH 142A,A02,083220,Chow; Bennett,10,0,32,22
1657807958818,MATH 142A,A03,093480,Chow; Bennett,9,0,32,23
1657807958818,MATH 142A,B03,093481,Chow; Bennett,8,0,32,24
1657807958818,MATH 142A,B04,093558,Chow; Bennett,13,0,32,19
1657807958818,MATH 142A,B05,093559,Chow; Bennett,6,0,32,26
1657807964843,MATH 193A,A01,083224,Rotar; Vladimir,8,0,34,26
1657807964843,MATH 193A,A02,083225,Rotar; Vladimir,9,0,34,25
1657807964843,MATH 193A,A03,083781,Rotar; Vladimir,5,0,34,29
1657807964843,MATH 193A,A04,083782,Rotar; Vladimir,10,0,34,24
1657807964843,MATH 193A,A05,093482,Rotar; Vladimir,10,0,34,24
1657807970870,MATH 197,001,091859,McAuley; Julian John,9999,0,9999,0
1657807970870,MATH 197,002,095566,Kedlaya; Kiran S.,9997,0,9999,2
1657807970870,MATH 197,003,095567,Xiao; Ming,9999,0,9999,0
1657807970870,MATH 197,004,095571,Perols; Johan Lars,9998,0,9999,1
1657807977926,COGS 9,A01,083615,Shannon; Kyle Michael,9,0,75,66
1657807983953,COGS 11,A01,083617,Boyle; Mary E. T.,23,0,48,25
1657807989985,COGS 13,A01,083071,Bastos; Amalia Pinkusfeld,11,0,71,60
1657807996011,COGS 14A,A01,092681,Semenuks; Arturs,5,1,100,95
1657808002041,COGS 14B,A01,083073,Cheng; Tzu-Han,6,0,63,57
1657808008074,COGS 17,A01,092677,Semenuks; Arturs,6,0,81,75
1657808014104,COGS 100,A01,083619,Allen; Michael Gordon,17,0,70,53
1657808020128,COGS 101A,A01,083621,Davis; Joshua Daniel,9,0,68,59
1657808026156,COGS 101B,A01,091572,Allen; Michael Gordon,12,0,65,53
1657808032186,COGS 101C,A01,083625,Delgado; Tania,17,0,35,18
1657808038210,COGS 107A,A01,083627,Boyle; Mary E. T.,14,0,60,46
1657808044233,COGS 118A,A01,083075,Gupta; Anjum,21,0,76,55
1657808050258,CSE 3,A50,083646,Miranda; Gregory Joseph,24,0,50,26
1657808056288,CSE 8A,A50,083650,Miranda; Gregory Joseph,17,1,56,39
1657808062317,CSE 11,A01,083080,Cao; Yingjun,6,15,40,34
1657808068346,CSE 12,A01,083652,Krause-Levy; Sophia Louisa,28,1,120,92
1657808074377,CSE 15L,A01,083654,Morris; Justin Loren,9,0,50,41
1657808074377,CSE 15L,A02,083655,Morris; Justin Loren,9,0,50,41
1657808080403,CSE 20,A01,083657,Tran; Khoa Dang,39,0,80,41
1657808086431,CSE 21,A01,095574,Bach; Quang Tran,22,0,48,26
1657808092457,CSE 30,A01,083084,Eldon; John,6,0,80,74
1657808092457,CSE 30,B01,095061,Bhaskar; Nishant,9,0,50,41
1657808098481,CSE 100,A01,083659,Cao; Yingjun,5,4,70,65
1657808104505,CSE 134B,A01,083661,Powell; Thomas Allan,24,0,100,76
1657808110604,CSE 140,A01,083663,Gungor; Onat,15,0,85,70
1657808116627,CSE 140L,A01,083088,Eldon; John,23,0,100,77
1657808122668,CSE 175,A01,083665,Kumar; Rakesh,3,0,25,22
1657808128699,CSE 190,A00,092507,Dubnov; Shlomo,8,0,20,12
1657808134725,ECE 45,A01,083139,Congero; Spencer William,6,0,75,69
1657808140758,ECE 65,A50,083695,Saad; Andrew S,12,0,30,18
1657808140758,ECE 65,A51,095125,Saad; Andrew S,24,0,26,2
1657808146783,ECE 109,A01,091882,Touri; Behrouz,20,0,70,50
1657808152809,ECE 180,A00,083140,Abi Samra; Nicholas Camill,1,0,30,29
1657808152809,ECE 180,B00,083141,Abi Samra; Nicholas Camill,0,0,30,30
1657808158845,MATH 10A,A01,083735,Patchell; Gregory David,2,0,30,28
1657808158845,MATH 10A,A02,083736,Patchell; Gregory David,20,0,30,10
1657808158845,MATH 10A,A03,083737,Patchell; Gregory David,16,0,30,14
1657808164884,MATH 10B,A01,083207,Lim; Seonhee,8,0,34,26
1657808164884,MATH 10B,A02,083208,Lim; Seonhee,10,0,35,25
1657808164884,MATH 10B,A03,093472,Lim; Seonhee,7,0,34,27
1657808164884,MATH 10B,B01,083739,Sinha; Shubham,13,0,30,17
1657808170913,MATH 18,A01,083743,Cinel; Cameron Alexander,9,0,30,21
1657808170913,MATH 18,A02,083744,Cinel; Cameron Alexander,18,0,30,12
1657808170913,MATH 18,A03,083745,Cinel; Cameron Alexander,10,0,30,20
1657808170913,MATH 18,B01,083748,Rideout; David Porter,5,0,37,32
1657808170913,MATH 18,B02,083749,Rideout; David Porter,5,0,36,31
1657808170913,MATH 18,B03,083750,Rideout; David Porter,3,0,37,34
1657808170913,MATH 18,B04,083751,Rideout; David Porter,6,0,36,30
1657808170913,MATH 18,B05,093473,Rideout; David Porter,6,0,36,30
1657808170913,MATH 18,B06,093474,Rideout; David Porter,6,0,36,30
1657808176943,MATH 20A,A01,083754,Zheng; Zequn,14,0,40,26
1657808182971,MATH 20B,A01,083756,Briones; Jor-el Thomas Caparas,4,0,36,32
1657808182971,MATH 20B,A02,083757,Briones; Jor-el Thomas Caparas,1,0,36,35
1657808182971,MATH 20B,A03,093475,Briones; Jor-el Thomas Caparas,2,0,36,34
1657808188998,MATH 20C,A01,083760,Briones; Jor-el Thomas Caparas,1,0,35,34
1657808188998,MATH 20C,A02,083761,Briones; Jor-el Thomas Caparas,8,0,35,27
1657808188998,MATH 20C,A03,093476,Briones; Jor-el Thomas Caparas,0,1,36,36
1657808188998,MATH 20C,B01,083762,Bach; Quang Tran,1,0,30,29
1657808195024,MATH 20D,A01,083765,Tran; Brian Kha,5,0,30,25
1657808195024,MATH 20D,A02,083766,Tran; Brian Kha,5,0,30,25
1657808195024,MATH 20D,A03,083767,Tran; Brian Kha,5,0,30,25
1657808201052,MATH 20E,A01,083771,Ganguly; Soumya,10,0,32,22
1657808201052,MATH 20E,A02,083772,Ganguly; Soumya,6,0,32,26
1657808201052,MATH 20E,B01,083773,Ciotti; Benjamin,20,0,35,15
1657808201052,MATH 20E,B02,083774,Ciotti; Benjamin,18,0,35,17
1657808207079,MATH 103A,A01,083777,Greenfeld; Be'Eri,3,0,36,33
1657808207079,MATH 103A,A02,083778,Greenfeld; Be'Eri,5,0,36,31
1657808207079,MATH 103A,A03,093561,Greenfeld; Be'Eri,6,0,36,30
1657808207079,MATH 103A,B01,083779,Greenfeld; Be'Eri,7,0,36,29
1657808207079,MATH 103A,B02,083780,Greenfeld; Be'Eri,4,0,36,32
1657808207079,MATH 103A,B03,093562,Greenfeld; Be'Eri,3,0,36,33
1657808213117,MATH 105,A01,085443,Carter; Anne Toulson,15,0,35,20
1657808213117,MATH 105,A02,093477,Carter; Anne Toulson,20,0,35,15
1657808219163,MATH 109,A01,083213,Ganzberger; Geoffrey Michael,3,0,34,31
1657808219163,MATH 109,A02,083214,Ganzberger; Geoffrey Michael,4,0,34,30
1657808219163,MATH 109,A03,093478,Ganzberger; Geoffrey Michael,2,0,34,32
1657808219163,MATH 109,B01,083215,Ganzberger; Geoffrey Michael,1,0,32,31
1657808219163,MATH 109,B02,083216,Ganzberger; Geoffrey Michael,2,0,32,30
1657808219163,MATH 109,B03,093479,Ganzberger; Geoffrey Michael,8,0,32,24
1657808225194,MATH 142A,A01,083219,Chow; Bennett,7,0,32,25
1657808225194,MATH 142A,A02,083220,Chow; Bennett,10,0,32,22
1657808225194,MATH 142A,A03,093480,Chow; Bennett,9,0,32,23
1657808225194,MATH 142A,B03,093481,Chow; Bennett,8,0,32,24
1657808225194,MATH 142A,B04,093558,Chow; Bennett,13,0,32,19
1657808225194,MATH 142A,B05,093559,Chow; Bennett,6,0,32,26
1657808231226,MATH 193A,A01,083224,Rotar; Vladimir,8,0,34,26
1657808231226,MATH 193A,A02,083225,Rotar; Vladimir,9,0,34,25
1657808231226,MATH 193A,A03,083781,Rotar; Vladimir,5,0,34,29
1657808231226,MATH 193A,A04,083782,Rotar; Vladimir,10,0,34,24
1657808231226,MATH 193A,A05,093482,Rotar; Vladimir,10,0,34,24
1657808237250,MATH 197,001,091859,McAuley; Julian John,9999,0,9999,0
1657808237250,MATH 197,002,095566,Kedlaya; Kiran S.,9997,0,9999,2
1657808237250,MATH 197,003,095567,Xiao; Ming,9999,0,9999,0
1657808237250,MATH 197,004,095571,Perols; Johan Lars,9998,0,9999,1
1657808244309,COGS 9,A01,083615,Shannon; Kyle Michael,9,0,75,66
1657808250339,COGS 11,A01,083617,Boyle; Mary E. T.,23,0,48,25
1657808256366,COGS 13,A01,083071,Bastos; Amalia Pinkusfeld,11,0,71,60
1657808262392,COGS 14A,A01,092681,Semenuks; Arturs,5,1,100,95
1657808268417,COGS 14B,A01,083073,Cheng; Tzu-Han,6,0,63,57
1657808274445,COGS 17,A01,092677,Semenuks; Arturs,6,0,81,75
1657808280473,COGS 100,A01,083619,Allen; Michael Gordon,17,0,70,53
1657808286497,COGS 101A,A01,083621,Davis; Joshua Daniel,9,0,68,59
1657808292529,COGS 101B,A01,091572,Allen; Michael Gordon,12,0,65,53
1657808298556,COGS 101C,A01,083625,Delgado; Tania,17,0,35,18
1657808304586,COGS 107A,A01,083627,Boyle; Mary E. T.,14,0,60,46
1657808310612,COGS 118A,A01,083075,Gupta; Anjum,21,0,76,55
1657808316639,CSE 3,A50,083646,Miranda; Gregory Joseph,24,0,50,26
1657808322663,CSE 8A,A50,083650,Miranda; Gregory Joseph,17,1,56,39
1657808328691,CSE 11,A01,083080,Cao; Yingjun,6,15,40,34
1657808334716,CSE 12,A01,083652,Krause-Levy; Sophia Louisa,28,1,120,92
1657808340741,CSE 15L,A01,083654,Morris; Justin Loren,9,0,50,41
1657808340741,CSE 15L,A02,083655,Morris; Justin Loren,9,0,50,41
1657808346772,CSE 20,A01,083657,Tran; Khoa Dang,39,0,80,41
1657808352797,CSE 21,A01,095574,Bach; Quang Tran,22,0,48,26
1657808358831,CSE 30,A01,083084,Eldon; John,6,0,80,74
1657808358831,CSE 30,B01,095061,Bhaskar; Nishant,9,0,50,41
1657808364856,CSE 100,A01,083659,Cao; Yingjun,5,4,70,65
1657808370880,CSE 134B,A01,083661,Powell; Thomas Allan,24,0,100,76
1657808376912,CSE 140,A01,083663,Gungor; Onat,15,0,85,70
1657808382939,CSE 140L,A01,083088,Eldon; John,23,0,100,77
1657808388965,CSE 175,A01,083665,Kumar; Rakesh,3,0,25,22
1657808394992,CSE 190,A00,092507,Dubnov; Shlomo,8,0,20,12
1657808401017,ECE 45,A01,083139,Congero; Spencer William,6,0,75,69
1657808407047,ECE 65,A50,083695,Saad; Andrew S,12,0,30,18
1657808407047,ECE 65,A51,095125,Saad; Andrew S,24,0,26,2
1657808413082,ECE 109,A01,091882,Touri; Behrouz,20,0,70,50
1657808419113,ECE 180,A00,083140,Abi Samra; Nicholas Camill,1,0,30,29
1657808419113,ECE 180,B00,083141,Abi Samra; Nicholas Camill,0,0,30,30
1657808425138,MATH 10A,A01,083735,Patchell; Gregory David,2,0,30,28
1657808425138,MATH 10A,A02,083736,Patchell; Gregory David,20,0,30,10
1657808425138,MATH 10A,A03,083737,Patchell; Gregory David,16,0,30,14
1657808431165,MATH 10B,A01,083207,Lim; Seonhee,8,0,34,26
1657808431165,MATH 10B,A02,083208,Lim; Seonhee,10,0,35,25
1657808431165,MATH 10B,A03,093472,Lim; Seonhee,7,0,34,27
1657808431165,MATH 10B,B01,083739,Sinha; Shubham,13,0,30,17
1657808437195,MATH 18,A01,083743,Cinel; Cameron Alexander,9,0,30,21
1657808437195,MATH 18,A02,083744,Cinel; Cameron Alexander,18,0,30,12
1657808437195,MATH 18,A03,083745,Cinel; Cameron Alexander,10,0,30,20
1657808437195,MATH 18,B01,083748,Rideout; David Porter,5,0,37,32
1657808437195,MATH 18,B02,083749,Rideout; David Porter,5,0,36,31
1657808437195,MATH 18,B03,083750,Rideout; David Porter,3,0,37,34
1657808437195,MATH 18,B04,083751,Rideout; David Porter,6,0,36,30
1657808437195,MATH 18,B05,093473,Rideout; David Porter,6,0,36,30
1657808437195,MATH 18,B06,093474,Rideout; David Porter,6,0,36,30
1657808443227,MATH 20A,A01,083754,Zheng; Zequn,14,0,40,26
1657808449251,MATH 20B,A01,083756,Briones; Jor-el Thomas Caparas,4,0,36,32
1657808449251,MATH 20B,A02,083757,Briones; Jor-el Thomas Caparas,1,0,36,35
1657808449251,MATH 20B,A03,093475,Briones; Jor-el Thomas Caparas,2,0,36,34
1657808455283,MATH 20C,A01,083760,Briones; Jor-el Thomas Caparas,1,0,35,34
1657808455283,MATH 20C,A02,083761,Briones; Jor-el Thomas Caparas,8,0,35,27
1657808455283,MATH 20C,A03,093476,Briones; Jor-el Thomas Caparas,0,1,36,36
1657808455283,MATH 20C,B01,083762,Bach; Quang Tran,1,0,30,29
1657808461314,MATH 20D,A01,083765,Tran; Brian Kha,5,0,30,25
1657808461314,MATH 20D,A02,083766,Tran; Brian Kha,5,0,30,25
1657808461314,MATH 20D,A03,083767,Tran; Brian Kha,5,0,30,25
1657808467341,MATH 20E,A01,083771,Ganguly; Soumya,10,0,32,22
1657808467341,MATH 20E,A02,083772,Ganguly; Soumya,6,0,32,26
1657808467341,MATH 20E,B01,083773,Ciotti; Benjamin,20,0,35,15
1657808467341,MATH 20E,B02,083774,Ciotti; Benjamin,18,0,35,17
1657808473369,MATH 103A,A01,083777,Greenfeld; Be'Eri,3,0,36,33
1657808473369,MATH 103A,A02,083778,Greenfeld; Be'Eri,5,0,36,31
1657808473369,MATH 103A,A03,093561,Greenfeld; Be'Eri,6,0,36,30
1657808473369,MATH 103A,B01,083779,Greenfeld; Be'Eri,7,0,36,29
1657808473369,MATH 103A,B02,083780,Greenfeld; Be'Eri,4,0,36,32
1657808473369,MATH 103A,B03,093562,Greenfeld; Be'Eri,3,0,36,33
1657808479395,MATH 105,A01,085443,Carter; Anne Toulson,15,0,35,20
1657808479395,MATH 105,A02,093477,Carter; Anne Toulson,20,0,35,15
1657808485420,MATH 109,A01,083213,Ganzberger; Geoffrey Michael,3,0,34,31
1657808485420,MATH 109,A02,083214,Ganzberger; Geoffrey Michael,4,0,34,30
1657808485420,MATH 109,A03,093478,Ganzberger; Geoffrey Michael,2,0,34,32
1657808485420,MATH 109,B01,083215,Ganzberger; Geoffrey Michael,1,0,32,31
1657808485420,MATH 109,B02,083216,Ganzberger; Geoffrey Michael,2,0,32,30
1657808485420,MATH 109,B03,093479,Ganzberger; Geoffrey Michael,8,0,32,24
1657808491447,MATH 142A,A01,083219,Chow; Bennett,7,0,32,25
1657808491447,MATH 142A,A02,083220,Chow; Bennett,10,0,32,22
1657808491447,MATH 142A,A03,093480,Chow; Bennett,9,0,32,23
1657808491447,MATH 142A,B03,093481,Chow; Bennett,8,0,32,24
1657808491447,MATH 142A,B04,093558,Chow; Bennett,13,0,32,19
1657808491447,MATH 142A,B05,093559,Chow; Bennett,6,0,32,26
1657808497472,MATH 193A,A01,083224,Rotar; Vladimir,8,0,34,26
1657808497472,MATH 193A,A02,083225,Rotar; Vladimir,9,0,34,25
1657808497472,MATH 193A,A03,083781,Rotar; Vladimir,5,0,34,29
1657808497472,MATH 193A,A04,083782,Rotar; Vladimir,10,0,34,24
1657808497472,MATH 193A,A05,093482,Rotar; Vladimir,10,0,34,24
1657808503497,MATH 197,001,091859,McAuley; Julian John,9999,0,9999,0
1657808503497,MATH 197,002,095566,Kedlaya; Kiran S.,9997,0,9999,2
1657808503497,MATH 197,003,095567,Xiao; Ming,9999,0,9999,0
1657808503497,MATH 197,004,095571,Perols; Johan Lars,9998,0,9999,1
1657808510556,COGS 9,A01,083615,Shannon; Kyle Michael,9,0,75,66
1657808516580,COGS 11,A01,083617,Boyle; Mary E. T.,23,0,48,25
1657808522607,COGS 13,A01,083071,Bastos; Amalia Pinkusfeld,11,0,71,60
1657808528707,COGS 14A,A01,092681,Semenuks; Arturs,5,1,100,95
1657808534735,COGS 14B,A01,083073,Cheng; Tzu-Han,6,0,63,57
1657808540760,COGS 17,A01,092677,Semenuks; Arturs,6,0,81,75
1657808546785,COGS 100,A01,083619,Allen; Michael Gordon,17,0,70,53
1657808552815,COGS 101A,A01,083621,Davis; Joshua Daniel,9,0,68,59
1657808558843,COGS 101B,A01,091572,Allen; Michael Gordon,12,0,65,53
1657808564872,COGS 101C,A01,083625,Delgado; Tania,17,0,35,18
1657808570899,COGS 107A,A01,083627,Boyle; Mary E. T.,14,0,60,46
1657808576930,COGS 118A,A01,083075,Gupta; Anjum,21,0,76,55
1657808582966,CSE 3,A50,083646,Miranda; Gregory Joseph,24,0,50,26
1657808588991,CSE 8A,A50,083650,Miranda; Gregory Joseph,17,1,56,39
1657808595015,CSE 11,A01,083080,Cao; Yingjun,6,15,40,34
1657808601051,CSE 12,A01,083652,Krause-Levy; Sophia Louisa,28,1,120,92
1657808607081,CSE 15L,A01,083654,Morris; Justin Loren,9,0,50,41
1657808607081,CSE 15L,A02,083655,Morris; Justin Loren,9,0,50,41
1657808613111,CSE 20,A01,083657,Tran; Khoa Dang,39,0,80,41
1657808619142,CSE 21,A01,095574,Bach; Quang Tran,22,0,48,26
1657808625168,CSE 30,A01,083084,Eldon; John,6,0,80,74
1657808625168,CSE 30,B01,095061,Bhaskar; Nishant,9,0,50,41
1657808631194,CSE 100,A01,083659,Cao; Yingjun,5,4,70,65
1657808637222,CSE 134B,A01,083661,Powell; Thomas Allan,24,0,100,76
1657808643249,CSE 140,A01,083663,Gungor; Onat,15,0,85,70
1657808649277,CSE 140L,A01,083088,Eldon; John,23,0,100,77
1657808655305,CSE 175,A01,083665,Kumar; Rakesh,3,0,25,22
1657808661331,CSE 190,A00,092507,Dubnov; Shlomo,8,0,20,12
1657808667362,ECE 45,A01,083139,Congero; Spencer William,6,0,75,69
1657808673386,ECE 65,A50,083695,Saad; Andrew S,12,0,30,18
1657808673386,ECE 65,A51,095125,Saad; Andrew S,24,0,26,2
1657808679415,ECE 109,A01,091882,Touri; Behrouz,20,0,70,50
1657808685438,ECE 180,A00,083140,Abi Samra; Nicholas Camill,1,0,30,29
1657808685438,ECE 180,B00,083141,Abi Samra; Nicholas Camill,0,0,30,30
1657808691468,MATH 10A,A01,083735,Patchell; Gregory David,2,0,30,28
1657808691468,MATH 10A,A02,083736,Patchell; Gregory David,20,0,30,10
1657808691468,MATH 10A,A03,083737,Patchell; Gregory David,16,0,30,14
1657808697497,MATH 10B,A01,083207,Lim; Seonhee,8,0,34,26
1657808697497,MATH 10B,A02,083208,Lim; Seonhee,10,0,35,25
1657808697497,MATH 10B,A03,093472,Lim; Seonhee,7,0,34,27
1657808697497,MATH 10B,B01,083739,Sinha; Shubham,13,0,30,17
1657808703522,MATH 18,A01,083743,Cinel; Cameron Alexander,9,0,30,21
1657808703522,MATH 18,A02,083744,Cinel; Cameron Alexander,18,0,30,12
1657808703522,MATH 18,A03,083745,Cinel; Cameron Alexander,10,0,30,20
1657808703522,MATH 18,B01,083748,Rideout; David Porter,5,0,37,32
1657808703522,MATH 18,B02,083749,Rideout; David Porter,5,0,36,31
1657808703522,MATH 18,B03,083750,Rideout; David Porter,3,0,37,34
1657808703522,MATH 18,B04,083751,Rideout; David Porter,6,0,36,30
1657808703522,MATH 18,B05,093473,Rideout; David Porter,6,0,36,30
1657808703522,MATH 18,B06,093474,Rideout; David Porter,6,0,36,30
1657808709546,MATH 20A,A01,083754,Zheng; Zequn,14,0,40,26
1657808715582,MATH 20B,A01,083756,Briones; Jor-el Thomas Caparas,4,0,36,32
1657808715582,MATH 20B,A02,083757,Briones; Jor-el Thomas Caparas,1,0,36,35
1657808715582,MATH 20B,A03,093475,Briones; Jor-el Thomas Caparas,2,0,36,34
1657808721613,MATH 20C,A01,083760,Briones; Jor-el Thomas Caparas,1,0,35,34
1657808721613,MATH 20C,A02,083761,Briones; Jor-el Thomas Caparas,8,0,35,27
1657808721613,MATH 20C,A03,093476,Briones; Jor-el Thomas Caparas,0,1,36,36
1657808721613,MATH 20C,B01,083762,Bach; Quang Tran,1,0,30,29
1657808727649,MATH 20D,A01,083765,Tran; Brian Kha,5,0,30,25
1657808727649,MATH 20D,A02,083766,Tran; Brian Kha,5,0,30,25
1657808727649,MATH 20D,A03,083767,Tran; Brian Kha,5,0,30,25
1657808733672,MATH 20E,A01,083771,Ganguly; Soumya,10,0,32,22
1657808733672,MATH 20E,A02,083772,Ganguly; Soumya,6,0,32,26
1657808733672,MATH 20E,B01,083773,Ciotti; Benjamin,20,0,35,15
1657808733672,MATH 20E,B02,083774,Ciotti; Benjamin,18,0,35,17
1657808739697,MATH 103A,A01,083777,Greenfeld; Be'Eri,3,0,36,33
1657808739697,MATH 103A,A02,083778,Greenfeld; Be'Eri,5,0,36,31
1657808739697,MATH 103A,A03,093561,Greenfeld; Be'Eri,6,0,36,30
1657808739697,MATH 103A,B01,083779,Greenfeld; Be'Eri,7,0,36,29
1657808739697,MATH 103A,B02,083780,Greenfeld; Be'Eri,4,0,36,32
1657808739697,MATH 103A,B03,093562,Greenfeld; Be'Eri,3,0,36,33
1657808745723,MATH 105,A01,085443,Carter; Anne Toulson,15,0,35,20
1657808745723,MATH 105,A02,093477,Carter; Anne Toulson,20,0,35,15
1657808751753,MATH 109,A01,083213,Ganzberger; Geoffrey Michael,3,0,34,31
1657808751753,MATH 109,A02,083214,Ganzberger; Geoffrey Michael,4,0,34,30
1657808751753,MATH 109,A03,093478,Ganzberger; Geoffrey Michael,2,0,34,32
1657808751753,MATH 109,B01,083215,Ganzberger; Geoffrey Michael,1,0,32,31
1657808751753,MATH 109,B02,083216,Ganzberger; Geoffrey Michael,2,0,32,30
1657808751753,MATH 109,B03,093479,Ganzberger; Geoffrey Michael,8,0,32,24
1657808757783,MATH 142A,A01,083219,Chow; Bennett,7,0,32,25
1657808757783,MATH 142A,A02,083220,Chow; Bennett,10,0,32,22
1657808757783,MATH 142A,A03,093480,Chow; Bennett,9,0,32,23
1657808757783,MATH 142A,B03,093481,Chow; Bennett,8,0,32,24
1657808757783,MATH 142A,B04,093558,Chow; Bennett,13,0,32,19
1657808757783,MATH 142A,B05,093559,Chow; Bennett,6,0,32,26
1657808763813,MATH 193A,A01,083224,Rotar; Vladimir,8,0,34,26
1657808763813,MATH 193A,A02,083225,Rotar; Vladimir,9,0,34,25
1657808763813,MATH 193A,A03,083781,Rotar; Vladimir,5,0,34,29
1657808763813,MATH 193A,A04,083782,Rotar; Vladimir,10,0,34,24
1657808763813,MATH 193A,A05,093482,Rotar; Vladimir,10,0,34,24
1657808769841,MATH 197,001,091859,McAuley; Julian John,9999,0,9999,0
1657808769841,MATH 197,002,095566,Kedlaya; Kiran S.,9997,0,9999,2
1657808769841,MATH 197,003,095567,Xiao; Ming,9999,0,9999,0
1657808769841,MATH 197,004,095571,Perols; Johan Lars,9998,0,9999,1
1657808776901,COGS 9,A01,083615,Shannon; Kyle Michael,9,0,75,66
1657808782936,COGS 11,A01,083617,Boyle; Mary E. T.,23,0,48,25
1657808788959,COGS 13,A01,083071,Bastos; Amalia Pinkusfeld,11,0,71,60
1657808794986,COGS 14A,A01,092681,Semenuks; Arturs,5,1,100,95
1657808801013,COGS 14B,A01,083073,Cheng; Tzu-Han,6,0,63,57
1657808807038,COGS 17,A01,092677,Semenuks; Arturs,6,0,81,75
1657808813066,COGS 100,A01,083619,Allen; Michael Gordon,17,0,70,53
1657808819091,COGS 101A,A01,083621,Davis; Joshua Daniel,9,0,68,59
1657808825118,COGS 101B,A01,091572,Allen; Michael Gordon,12,0,65,53
1657808831142,COGS 101C,A01,083625,Delgado; Tania,17,0,35,18
1657808837170,COGS 107A,A01,083627,Boyle; Mary E. T.,14,0,60,46
1657808843195,COGS 118A,A01,083075,Gupta; Anjum,21,0,76,55
1657808849220,CSE 3,A50,083646,Miranda; Gregory Joseph,24,0,50,26
1657808855245,CSE 8A,A50,083650,Miranda; Gregory Joseph,17,1,56,39
1657808861273,CSE 11,A01,083080,Cao; Yingjun,6,15,40,34
1657808867305,CSE 12,A01,083652,Krause-Levy; Sophia Louisa,28,1,120,92
1657808873329,CSE 15L,A01,083654,Morris; Justin Loren,9,0,50,41
1657808873329,CSE 15L,A02,083655,Morris; Justin Loren,9,0,50,41
1657808879358,CSE 20,A01,083657,Tran; Khoa Dang,39,0,80,41
1657808885384,CSE 21,A01,095574,Bach; Quang Tran,22,0,48,26
1657808891418,CSE 30,A01,083084,Eldon; John,6,0,80,74
1657808891418,CSE 30,B01,095061,Bhaskar; Nishant,9,0,50,41
1657808897447,CSE 100,A01,083659,Cao; Yingjun,5,4,70,65
1657808903472,CSE 134B,A01,083661,Powell; Thomas Allan,24,0,100,76
1657808909494,CSE 140,A01,083663,Gungor; Onat,15,0,85,70
1657808915521,CSE 140L,A01,083088,Eldon; John,23,0,100,77
1657808921547,CSE 175,A01,083665,Kumar; Rakesh,3,0,25,22
1657808927573,CSE 190,A00,092507,Dubnov; Shlomo,8,0,20,12
1657808933602,ECE 45,A01,083139,Congero; Spencer William,6,0,75,69
1657808939625,ECE 65,A50,083695,Saad; Andrew S,12,0,30,18
1657808939625,ECE 65,A51,095125,Saad; Andrew S,24,0,26,2
1657808945652,ECE 109,A01,091882,Touri; Behrouz,20,0,70,50
1657808951674,ECE 180,A00,083140,Abi Samra; Nicholas Camill,1,0,30,29
1657808951674,ECE 180,B00,083141,Abi Samra; Nicholas Camill,0,0,30,30
1657808957699,MATH 10A,A01,083735,Patchell; Gregory David,2,0,30,28
1657808957699,MATH 10A,A02,083736,Patchell; Gregory David,20,0,30,10
1657808957699,MATH 10A,A03,083737,Patchell; Gregory David,16,0,30,14
1657808963725,MATH 10B,A01,083207,Lim; Seonhee,8,0,34,26
1657808963725,MATH 10B,A02,083208,Lim; Seonhee,10,0,35,25
1657808963725,MATH 10B,A03,093472,Lim; Seonhee,7,0,34,27
1657808963725,MATH 10B,B01,083739,Sinha; Shubham,13,0,30,17
1657808969749,MATH 18,A01,083743,Cinel; Cameron Alexander,9,0,30,21
1657808969749,MATH 18,A02,083744,Cinel; Cameron Alexander,18,0,30,12
1657808969749,MATH 18,A03,083745,Cinel; Cameron Alexander,10,0,30,20
1657808969749,MATH 18,B01,083748,Rideout; David Porter,5,0,37,32
1657808969749,MATH 18,B02,083749,Rideout; David Porter,5,0,36,31
1657808969749,MATH 18,B03,083750,Rideout; David Porter,3,0,37,34
1657808969749,MATH 18,B04,083751,Rideout; David Porter,6,0,36,30
1657808969749,MATH 18,B05,093473,Rideout; David Porter,6,0,36,30
1657808969749,MATH 18,B06,093474,Rideout; David Porter,6,0,36,30
1657808975782,MATH 20A,A01,083754,Zheng; Zequn,14,0,40,26
1657808981808,MATH 20B,A01,083756,Briones; Jor-el Thomas Caparas,4,0,36,32
1657808981808,MATH 20B,A02,083757,Briones; Jor-el Thomas Caparas,1,0,36,35
1657808981808,MATH 20B,A03,093475,Briones; Jor-el Thomas Caparas,2,0,36,34
1657808987844,MATH 20C,A01,083760,Briones; Jor-el Thomas Caparas,1,0,35,34
1657808987844,MATH 20C,A02,083761,Briones; Jor-el Thomas Caparas,8,0,35,27
1657808987844,MATH 20C,A03,093476,Briones; Jor-el Thomas Caparas,0,1,36,36
1657808987844,MATH 20C,B01,083762,Bach; Quang Tran,1,0,30,29
1657808993869,MATH 20D,A01,083765,Tran; Brian Kha,5,0,30,25
1657808993869,MATH 20D,A02,083766,Tran; Brian Kha,5,0,30,25
1657808993869,MATH 20D,A03,083767,Tran; Brian Kha,5,0,30,25
1657808999892,MATH 20E,A01,083771,Ganguly; Soumya,10,0,32,22
1657808999892,MATH 20E,A02,083772,Ganguly; Soumya,6,0,32,26
1657808999892,MATH 20E,B01,083773,Ciotti; Benjamin,20,0,35,15
1657808999892,MATH 20E,B02,083774,Ciotti; Benjamin,18,0,35,17
1657809005916,MATH 103A,A01,083777,Greenfeld; Be'Eri,3,0,36,33
1657809005916,MATH 103A,A02,083778,Greenfeld; Be'Eri,5,0,36,31
1657809005916,MATH 103A,A03,093561,Greenfeld; Be'Eri,6,0,36,30
1657809005916,MATH 103A,B01,083779,Greenfeld; Be'Eri,7,0,36,29
1657809005916,MATH 103A,B02,083780,Greenfeld; Be'Eri,4,0,36,32
1657809005916,MATH 103A,B03,093562,Greenfeld; Be'Eri,3,0,36,33
1657809011941,MATH 105,A01,085443,Carter; Anne Toulson,15,0,35,20
1657809011941,MATH 105,A02,093477,Carter; Anne Toulson,20,0,35,15
1657809017971,MATH 109,A01,083213,Ganzberger; Geoffrey Michael,3,0,34,31
1657809017971,MATH 109,A02,083214,Ganzberger; Geoffrey Michael,4,0,34,30
1657809017971,MATH 109,A03,093478,Ganzberger; Geoffrey Michael,2,0,34,32
1657809017971,MATH 109,B01,083215,Ganzberger; Geoffrey Michael,1,0,32,31
1657809017971,MATH 109,B02,083216,Ganzberger; Geoffrey Michael,2,0,32,30
1657809017971,MATH 109,B03,093479,Ganzberger; Geoffrey Michael,8,0,32,24
1657809023999,MATH 142A,A01,083219,Chow; Bennett,7,0,32,25
1657809023999,MATH 142A,A02,083220,Chow; Bennett,10,0,32,22
1657809023999,MATH 142A,A03,093480,Chow; Bennett,9,0,32,23
1657809023999,MATH 142A,B03,093481,Chow; Bennett,8,0,32,24
1657809023999,MATH 142A,B04,093558,Chow; Bennett,13,0,32,19
1657809023999,MATH 142A,B05,093559,Chow; Bennett,6,0,32,26
1657809030030,MATH 193A,A01,083224,Rotar; Vladimir,8,0,34,26
1657809030030,MATH 193A,A02,083225,Rotar; Vladimir,9,0,34,25
1657809030030,MATH 193A,A03,083781,Rotar; Vladimir,5,0,34,29
1657809030030,MATH 193A,A04,083782,Rotar; Vladimir,10,0,34,24
1657809030030,MATH 193A,A05,093482,Rotar; Vladimir,10,0,34,24
1657809036056,MATH 197,001,091859,McAuley; Julian John,9999,0,9999,0
1657809036056,MATH 197,002,095566,Kedlaya; Kiran S.,9997,0,9999,2
1657809036056,MATH 197,003,095567,Xiao; Ming,9999,0,9999,0
1657809036056,MATH 197,004,095571,Perols; Johan Lars,9998,0,9999,1
1657809043141,COGS 9,A01,083615,Shannon; Kyle Michael,9,0,75,66
1657809049177,COGS 11,A01,083617,Boyle; Mary E. T.,23,0,48,25
1657809055205,COGS 13,A01,083071,Bastos; Amalia Pinkusfeld,11,0,71,60
1657809061240,COGS 14A,A01,092681,Semenuks; Arturs,5,1,100,95
1657809067265,COGS 14B,A01,083073,Cheng; Tzu-Han,6,0,63,57
1657809073290,COGS 17,A01,092677,Semenuks; Arturs,6,0,81,75
1657809079327,COGS 100,A01,083619,Allen; Michael Gordon,17,0,70,53
1657809085351,COGS 101A,A01,083621,Davis; Joshua Daniel,9,0,68,59
1657809091380,COGS 101B,A01,091572,Allen; Michael Gordon,12,0,65,53
1657809097420,COGS 101C,A01,083625,Delgado; Tania,17,0,35,18
1657809103445,COGS 107A,A01,083627,Boyle; Mary E. T.,14,0,60,46
1657809109477,COGS 118A,A01,083075,Gupta; Anjum,21,0,76,55
1657809115503,CSE 3,A50,083646,Miranda; Gregory Joseph,24,0,50,26
1657809121535,CSE 8A,A50,083650,Miranda; Gregory Joseph,17,1,56,39
1657809127629,CSE 11,A01,083080,Cao; Yingjun,6,15,40,34
1657809133666,CSE 12,A01,083652,Krause-Levy; Sophia Louisa,28,1,120,92
1657809139695,CSE 15L,A01,083654,Morris; Justin Loren,9,0,50,41
1657809139695,CSE 15L,A02,083655,Morris; Justin Loren,9,0,50,41
1657809145735,CSE 20,A01,083657,Tran; Khoa Dang,39,0,80,41
1657809151758,CSE 21,A01,095574,Bach; Quang Tran,22,0,48,26
1657809157792,CSE 30,A01,083084,Eldon; John,6,0,80,74
1657809157792,CSE 30,B01,095061,Bhaskar; Nishant,9,0,50,41
1657809163825,CSE 100,A01,083659,Cao; Yingjun,5,4,70,65
1657809169849,CSE 134B,A01,083661,Powell; Thomas Allan,24,0,100,76
1657809175879,CSE 140,A01,083663,Gungor; Onat,15,0,85,70
1657809181907,CSE 140L,A01,083088,Eldon; John,23,0,100,77
1657809187931,CSE 175,A01,083665,Kumar; Rakesh,3,0,25,22
1657809193967,CSE 190,A00,092507,Dubnov; Shlomo,8,0,20,12
1657809199992,ECE 45,A01,083139,Congero; Spencer William,6,0,75,69
1657809206028,ECE 65,A50,083695,Saad; Andrew S,12,0,30,18
1657809206028,ECE 65,A51,095125,Saad; Andrew S,24,0,26,2
1657809212054,ECE 109,A01,091882,Touri; Behrouz,20,0,70,50
1657809218078,ECE 180,A00,083140,Abi Samra; Nicholas Camill,1,0,30,29
1657809218078,ECE 180,B00,083141,Abi Samra; Nicholas Camill,0,0,30,30
1657809224113,MATH 10A,A01,083735,Patchell; Gregory David,2,0,30,28
1657809224113,MATH 10A,A02,083736,Patchell; Gregory David,20,0,30,10
1657809224113,MATH 10A,A03,083737,Patchell; Gregory David,16,0,30,14
1657809230139,MATH 10B,A01,083207,Lim; Seonhee,8,0,34,26
1657809230139,MATH 10B,A02,083208,Lim; Seonhee,10,0,35,25
1657809230139,MATH 10B,A03,093472,Lim; Seonhee,7,0,34,27
1657809230139,MATH 10B,B01,083739,Sinha; Shubham,13,0,30,17
1657809236189,MATH 18,A01,083743,Cinel; Cameron Alexander,9,0,30,21
1657809236189,MATH 18,A02,083744,Cinel; Cameron Alexander,18,0,30,12
1657809236189,MATH 18,A03,083745,Cinel; Cameron Alexander,10,0,30,20
1657809236189,MATH 18,B01,083748,Rideout; David Porter,5,0,37,32
1657809236189,MATH 18,B02,083749,Rideout; David Porter,5,0,36,31
1657809236189,MATH 18,B03,083750,Rideout; David Porter,3,0,37,34
1657809236189,MATH 18,B04,083751,Rideout; David Porter,6,0,36,30
1657809236189,MATH 18,B05,093473,Rideout; David Porter,6,0,36,30
1657809236189,MATH 18,B06,093474,Rideout; David Porter,6,0,36,30
1657809242225,MATH 20A,A01,083754,Zheng; Zequn,14,0,40,26
1657809248261,MATH 20B,A01,083756,Briones; Jor-el Thomas Caparas,4,0,36,32
1657809248261,MATH 20B,A02,083757,Briones; Jor-el Thomas Caparas,1,0,36,35
1657809248261,MATH 20B,A03,093475,Briones; Jor-el Thomas Caparas,2,0,36,34
1657809254298,MATH 20C,A01,083760,Briones; Jor-el Thomas Caparas,1,0,35,34
1657809254298,MATH 20C,A02,083761,Briones; Jor-el Thomas Caparas,8,0,35,27
1657809254298,MATH 20C,A03,093476,Briones; Jor-el Thomas Caparas,0,1,36,36
1657809254298,MATH 20C,B01,083762,Bach; Quang Tran,1,0,30,29
1657809260333,MATH 20D,A01,083765,Tran; Brian Kha,5,0,30,25
1657809260333,MATH 20D,A02,083766,Tran; Brian Kha,5,0,30,25
1657809260333,MATH 20D,A03,083767,Tran; Brian Kha,5,0,30,25
1657809266367,MATH 20E,A01,083771,Ganguly; Soumya,10,0,32,22
1657809266367,MATH 20E,A02,083772,Ganguly; Soumya,6,0,32,26
1657809266367,MATH 20E,B01,083773,Ciotti; Benjamin,20,0,35,15
1657809266367,MATH 20E,B02,083774,Ciotti; Benjamin,18,0,35,17
1657809272393,MATH 103A,A01,083777,Greenfeld; Be'Eri,3,0,36,33
1657809272393,MATH 103A,A02,083778,Greenfeld; Be'Eri,5,0,36,31
1657809272393,MATH 103A,A03,093561,Greenfeld; Be'Eri,6,0,36,30
1657809272393,MATH 103A,B01,083779,Greenfeld; Be'Eri,7,0,36,29
1657809272393,MATH 103A,B02,083780,Greenfeld; Be'Eri,4,0,36,32
1657809272393,MATH 103A,B03,093562,Greenfeld; Be'Eri,3,0,36,33
1657809278420,MATH 105,A01,085443,Carter; Anne Toulson,15,0,35,20
1657809278420,MATH 105,A02,093477,Carter; Anne Toulson,20,0,35,15
1657809284456,MATH 109,A01,083213,Ganzberger; Geoffrey Michael,3,0,34,31
1657809284456,MATH 109,A02,083214,Ganzberger; Geoffrey Michael,4,0,34,30
1657809284456,MATH 109,A03,093478,Ganzberger; Geoffrey Michael,2,0,34,32
1657809284456,MATH 109,B01,083215,Ganzberger; Geoffrey Michael,1,0,32,31
1657809284456,MATH 109,B02,083216,Ganzberger; Geoffrey Michael,2,0,32,30
1657809284456,MATH 109,B03,093479,Ganzberger; Geoffrey Michael,8,0,32,24
1657809290481,MATH 142A,A01,083219,Chow; Bennett,7,0,32,25
1657809290481,MATH 142A,A02,083220,Chow; Bennett,10,0,32,22
1657809290481,MATH 142A,A03,093480,Chow; Bennett,9,0,32,23
1657809290481,MATH 142A,B03,093481,Chow; Bennett,8,0,32,24
1657809290481,MATH 142A,B04,093558,Chow; Bennett,13,0,32,19
1657809290481,MATH 142A,B05,093559,Chow; Bennett,6,0,32,26
1657809296512,MATH 193A,A01,083224,Rotar; Vladimir,8,0,34,26
1657809296512,MATH 193A,A02,083225,Rotar; Vladimir,9,0,34,25
1657809296512,MATH 193A,A03,083781,Rotar; Vladimir,5,0,34,29
1657809296512,MATH 193A,A04,083782,Rotar; Vladimir,10,0,34,24
1657809296512,MATH 193A,A05,093482,Rotar; Vladimir,10,0,34,24
1657809302536,MATH 197,001,091859,McAuley; Julian John,9999,0,9999,0
1657809302536,MATH 197,002,095566,Kedlaya; Kiran S.,9997,0,9999,2
1657809302536,MATH 197,003,095567,Xiao; Ming,9999,0,9999,0
1657809302536,MATH 197,004,095571,Perols; Johan Lars,9998,0,9999,1
1657809309609,COGS 9,A01,083615,Shannon; Kyle Michael,9,0,75,66
1657809315638,COGS 11,A01,083617,Boyle; Mary E. T.,23,0,48,25
1657809321663,COGS 13,A01,083071,Bastos; Amalia Pinkusfeld,11,0,71,60
1657809327689,COGS 14A,A01,092681,Semenuks; Arturs,5,1,100,95
1657809333721,COGS 14B,A01,083073,Cheng; Tzu-Han,6,0,63,57
1657809339755,COGS 17,A01,092677,Semenuks; Arturs,6,0,81,75
1657809345787,COGS 100,A01,083619,Allen; Michael Gordon,17,0,70,53
1657809351818,COGS 101A,A01,083621,Davis; Joshua Daniel,9,0,68,59
1657809357843,COGS 101B,A01,091572,Allen; Michael Gordon,12,0,65,53
1657809363879,COGS 101C,A01,083625,Delgado; Tania,17,0,35,18
1657809369904,COGS 107A,A01,083627,Boyle; Mary E. T.,14,0,60,46
1657809375931,COGS 118A,A01,083075,Gupta; Anjum,21,0,76,55
1657809381957,CSE 3,A50,083646,Miranda; Gregory Joseph,24,0,50,26
1657809387987,CSE 8A,A50,083650,Miranda; Gregory Joseph,17,1,56,39
1657809394019,CSE 11,A01,083080,Cao; Yingjun,6,15,40,34
1657809400045,CSE 12,A01,083652,Krause-Levy; Sophia Louisa,28,1,120,92
1657809406071,CSE 15L,A01,083654,Morris; Justin Loren,9,0,50,41
1657809406071,CSE 15L,A02,083655,Morris; Justin Loren,9,0,50,41
1657809412095,CSE 20,A01,083657,Tran; Khoa Dang,39,0,80,41
1657809418117,CSE 21,A01,095574,Bach; Quang Tran,22,0,48,26
1657809424143,CSE 30,A01,083084,Eldon; John,6,0,80,74
1657809424143,CSE 30,B01,095061,Bhaskar; Nishant,9,0,50,41
1657809430190,CSE 100,A01,083659,Cao; Yingjun,5,4,70,65
1657809436216,CSE 134B,A01,083661,Powell; Thomas Allan,24,0,100,76
1657809442243,CSE 140,A01,083663,Gungor; Onat,15,0,85,70
1657809448273,CSE 140L,A01,083088,Eldon; John,23,0,100,77
1657809454303,CSE 175,A01,083665,Kumar; Rakesh,3,0,25,22
1657809460335,CSE 190,A00,092507,Dubnov; Shlomo,8,0,20,12
1657809466359,ECE 45,A01,083139,Congero; Spencer William,6,0,75,69
1657809472392,ECE 65,A50,083695,Saad; Andrew S,12,0,30,18
1657809472392,ECE 65,A51,095125,Saad; Andrew S,24,0,26,2
1657809478423,ECE 109,A01,091882,Touri; Behrouz,20,0,70,50
1657809484453,ECE 180,A00,083140,Abi Samra; Nicholas Camill,1,0,30,29
1657809484453,ECE 180,B00,083141,Abi Samra; Nicholas Camill,0,0,30,30
1657809490480,MATH 10A,A01,083735,Patchell; Gregory David,2,0,30,28
1657809490480,MATH 10A,A02,083736,Patchell; Gregory David,20,0,30,10
1657809490480,MATH 10A,A03,083737,Patchell; Gregory David,16,0,30,14
1657809496518,MATH 10B,A01,083207,Lim; Seonhee,8,0,34,26
1657809496518,MATH 10B,A02,083208,Lim; Seonhee,10,0,35,25
1657809496518,MATH 10B,A03,093472,Lim; Seonhee,7,0,34,27
1657809496518,MATH 10B,B01,083739,Sinha; Shubham,13,0,30,17
1657809502552,MATH 18,A01,083743,Cinel; Cameron Alexander,9,0,30,21
1657809502552,MATH 18,A02,083744,Cinel; Cameron Alexander,18,0,30,12
1657809502552,MATH 18,A03,083745,Cinel; Cameron Alexander,10,0,30,20
1657809502552,MATH 18,B01,083748,Rideout; David Porter,5,0,37,32
1657809502552,MATH 18,B02,083749,Rideout; David Porter,5,0,36,31
1657809502552,MATH 18,B03,083750,Rideout; David Porter,3,0,37,34
1657809502552,MATH 18,B04,083751,Rideout; David Porter,6,0,36,30
1657809502552,MATH 18,B05,093473,Rideout; David Porter,6,0,36,30
1657809502552,MATH 18,B06,093474,Rideout; David Porter,6,0,36,30
1657809508592,MATH 20A,A01,083754,Zheng; Zequn,14,0,40,26
1657809514618,MATH 20B,A01,083756,Briones; Jor-el Thomas Caparas,4,0,36,32
1657809514618,MATH 20B,A02,083757,Briones; Jor-el Thomas Caparas,1,0,36,35
1657809514618,MATH 20B,A03,093475,Briones; Jor-el Thomas Caparas,2,0,36,34
1657809520643,MATH 20C,A01,083760,Briones; Jor-el Thomas Caparas,1,0,35,34
1657809520643,MATH 20C,A02,083761,Briones; Jor-el Thomas Caparas,8,0,35,27
1657809520643,MATH 20C,A03,093476,Briones; Jor-el Thomas Caparas,0,1,36,36
1657809520643,MATH 20C,B01,083762,Bach; Quang Tran,1,0,30,29
1657809526675,MATH 20D,A01,083765,Tran; Brian Kha,5,0,30,25
1657809526675,MATH 20D,A02,083766,Tran; Brian Kha,5,0,30,25
1657809526675,MATH 20D,A03,083767,Tran; Brian Kha,5,0,30,25
1657809532702,MATH 20E,A01,083771,Ganguly; Soumya,10,0,32,22
1657809532702,MATH 20E,A02,083772,Ganguly; Soumya,6,0,32,26
1657809532702,MATH 20E,B01,083773,Ciotti; Benjamin,20,0,35,15
1657809532702,MATH 20E,B02,083774,Ciotti; Benjamin,18,0,35,17
1657809538735,MATH 103A,A01,083777,Greenfeld; Be'Eri,3,0,36,33
1657809538735,MATH 103A,A02,083778,Greenfeld; Be'Eri,5,0,36,31
1657809538735,MATH 103A,A03,093561,Greenfeld; Be'Eri,6,0,36,30
1657809538735,MATH 103A,B01,083779,Greenfeld; Be'Eri,7,0,36,29
1657809538735,MATH 103A,B02,083780,Greenfeld; Be'Eri,4,0,36,32
1657809538735,MATH 103A,B03,093562,Greenfeld; Be'Eri,3,0,36,33
1657809544793,MATH 105,A01,085443,Carter; Anne Toulson,15,0,35,20
1657809544793,MATH 105,A02,093477,Carter; Anne Toulson,20,0,35,15
1657809550818,MATH 109,A01,083213,Ganzberger; Geoffrey Michael,3,0,34,31
1657809550818,MATH 109,A02,083214,Ganzberger; Geoffrey Michael,4,0,34,30
1657809550818,MATH 109,A03,093478,Ganzberger; Geoffrey Michael,2,0,34,32
1657809550818,MATH 109,B01,083215,Ganzberger; Geoffrey Michael,1,0,32,31
1657809550818,MATH 109,B02,083216,Ganzberger; Geoffrey Michael,2,0,32,30
1657809550818,MATH 109,B03,093479,Ganzberger; Geoffrey Michael,8,0,32,24
1657809556843,MATH 142A,A01,083219,Chow; Bennett,7,0,32,25
1657809556843,MATH 142A,A02,083220,Chow; Bennett,10,0,32,22
1657809556843,MATH 142A,A03,093480,Chow; Bennett,9,0,32,23
1657809556843,MATH 142A,B03,093481,Chow; Bennett,8,0,32,24
1657809556843,MATH 142A,B04,093558,Chow; Bennett,13,0,32,19
1657809556843,MATH 142A,B05,093559,Chow; Bennett,6,0,32,26
1657809562873,MATH 193A,A01,083224,Rotar; Vladimir,8,0,34,26
1657809562873,MATH 193A,A02,083225,Rotar; Vladimir,9,0,34,25
1657809562873,MATH 193A,A03,083781,Rotar; Vladimir,5,0,34,29
1657809562873,MATH 193A,A04,083782,Rotar; Vladimir,10,0,34,24
1657809562873,MATH 193A,A05,093482,Rotar; Vladimir,10,0,34,24
1657809568904,MATH 197,001,091859,McAuley; Julian John,9999,0,9999,0
1657809568904,MATH 197,002,095566,Kedlaya; Kiran S.,9997,0,9999,2
1657809568904,MATH 197,003,095567,Xiao; Ming,9999,0,9999,0
1657809568904,MATH 197,004,095571,Perols; Johan Lars,9998,0,9999,1
1657809575978,COGS 9,A01,083615,Shannon; Kyle Michael,9,0,75,66
1657809582004,COGS 11,A01,083617,Boyle; Mary E. T.,23,0,48,25
1657809588034,COGS 13,A01,083071,Bastos; Amalia Pinkusfeld,11,0,71,60
1657809594063,COGS 14A,A01,092681,Semenuks; Arturs,5,1,100,95
1657809600088,COGS 14B,A01,083073,Cheng; Tzu-Han,6,0,63,57
1657809606124,COGS 17,A01,092677,Semenuks; Arturs,6,0,81,75
1657809612154,COGS 100,A01,083619,Allen; Michael Gordon,17,0,70,53
1657809618184,COGS 101A,A01,083621,Davis; Joshua Daniel,9,0,68,59
1657809624212,COGS 101B,A01,091572,Allen; Michael Gordon,12,0,65,53
1657809630236,COGS 101C,A01,083625,Delgado; Tania,17,0,35,18
1657809636271,COGS 107A,A01,083627,Boyle; Mary E. T.,14,0,60,46
1657809642297,COGS 118A,A01,083075,Gupta; Anjum,21,0,76,55
1657809648329,CSE 3,A50,083646,Miranda; Gregory Joseph,24,0,50,26
1657809654358,CSE 8A,A50,083650,Miranda; Gregory Joseph,17,1,56,39
1657809660390,CSE 11,A01,083080,Cao; Yingjun,6,15,40,34
1657809666422,CSE 12,A01,083652,Krause-Levy; Sophia Louisa,28,1,120,92
1657809672455,CSE 15L,A01,083654,Morris; Justin Loren,9,0,50,41
1657809672455,CSE 15L,A02,083655,Morris; Justin Loren,9,0,50,41
1657809678481,CSE 20,A01,083657,Tran; Khoa Dang,39,0,80,41
1657809684504,CSE 21,A01,095574,Bach; Quang Tran,22,0,48,26
1657809690533,CSE 30,A01,083084,Eldon; John,6,0,80,74
1657809690533,CSE 30,B01,095061,Bhaskar; Nishant,9,0,50,41
1657809696556,CSE 100,A01,083659,Cao; Yingjun,5,4,70,65
1657809702581,CSE 134B,A01,083661,Powell; Thomas Allan,24,0,100,76
1657809708604,CSE 140,A01,083663,Gungor; Onat,15,0,85,70
1657809714628,CSE 140L,A01,083088,Eldon; John,23,0,100,77
1657809720662,CSE 175,A01,083665,Kumar; Rakesh,3,0,25,22
1657809726759,CSE 190,A00,092507,Dubnov; Shlomo,8,0,20,12
1657809732787,ECE 45,A01,083139,Congero; Spencer William,6,0,75,69
1657809738813,ECE 65,A50,083695,Saad; Andrew S,12,0,30,18
1657809738813,ECE 65,A51,095125,Saad; Andrew S,24,0,26,2
1657809744838,ECE 109,A01,091882,Touri; Behrouz,20,0,70,50
1657809750862,ECE 180,A00,083140,Abi Samra; Nicholas Camill,1,0,30,29
1657809750862,ECE 180,B00,083141,Abi Samra; Nicholas Camill,0,0,30,30
1657809756887,MATH 10A,A01,083735,Patchell; Gregory David,2,0,30,28
1657809756887,MATH 10A,A02,083736,Patchell; Gregory David,20,0,30,10
1657809756887,MATH 10A,A03,083737,Patchell; Gregory David,16,0,30,14
1657809762939,MATH 10B,A01,083207,Lim; Seonhee,8,0,34,26
1657809762939,MATH 10B,A02,083208,Lim; Seonhee,10,0,35,25
1657809762939,MATH 10B,A03,093472,Lim; Seonhee,7,0,34,27
1657809762939,MATH 10B,B01,083739,Sinha; Shubham,13,0,30,17
1657809768967,MATH 18,A01,083743,Cinel; Cameron Alexander,9,0,30,21
1657809768967,MATH 18,A02,083744,Cinel; Cameron Alexander,18,0,30,12
1657809768967,MATH 18,A03,083745,Cinel; Cameron Alexander,10,0,30,20
1657809768967,MATH 18,B01,083748,Rideout; David Porter,5,0,37,32
1657809768967,MATH 18,B02,083749,Rideout; David Porter,5,0,36,31
1657809768967,MATH 18,B03,083750,Rideout; David Porter,3,0,37,34
1657809768967,MATH 18,B04,083751,Rideout; David Porter,6,0,36,30
1657809768967,MATH 18,B05,093473,Rideout; David Porter,6,0,36,30
1657809768967,MATH 18,B06,093474,Rideout; David Porter,6,0,36,30
1657809774993,MATH 20A,A01,083754,Zheng; Zequn,14,0,40,26
1657809781019,MATH 20B,A01,083756,Briones; Jor-el Thomas Caparas,4,0,36,32
1657809781019,MATH 20B,A02,083757,Briones; Jor-el Thomas Caparas,1,0,36,35
1657809781019,MATH 20B,A03,093475,Briones; Jor-el Thomas Caparas,2,0,36,34
1657809787055,MATH 20C,A01,083760,Briones; Jor-el Thomas Caparas,1,0,35,34
1657809787055,MATH 20C,A02,083761,Briones; Jor-el Thomas Caparas,8,0,35,27
1657809787055,MATH 20C,A03,093476,Briones; Jor-el Thomas Caparas,0,1,36,36
1657809787055,MATH 20C,B01,083762,Bach; Quang Tran,1,0,30,29
1657809793081,MATH 20D,A01,083765,Tran; Brian Kha,5,0,30,25
1657809793081,MATH 20D,A02,083766,Tran; Brian Kha,5,0,30,25
1657809793081,MATH 20D,A03,083767,Tran; Brian Kha,5,0,30,25
1657809799108,MATH 20E,A01,083771,Ganguly; Soumya,10,0,32,22
1657809799108,MATH 20E,A02,083772,Ganguly; Soumya,6,0,32,26
1657809799108,MATH 20E,B01,083773,Ciotti; Benjamin,20,0,35,15
1657809799108,MATH 20E,B02,083774,Ciotti; Benjamin,18,0,35,17
1657809805137,MATH 103A,A01,083777,Greenfeld; Be'Eri,3,0,36,33
1657809805137,MATH 103A,A02,083778,Greenfeld; Be'Eri,5,0,36,31
1657809805137,MATH 103A,A03,093561,Greenfeld; Be'Eri,6,0,36,30
1657809805137,MATH 103A,B01,083779,Greenfeld; Be'Eri,7,0,36,29
1657809805137,MATH 103A,B02,083780,Greenfeld; Be'Eri,4,0,36,32
1657809805137,MATH 103A,B03,093562,Greenfeld; Be'Eri,3,0,36,33
1657809811164,MATH 105,A01,085443,Carter; Anne Toulson,15,0,35,20
1657809811164,MATH 105,A02,093477,Carter; Anne Toulson,20,0,35,15
1657809817196,MATH 109,A01,083213,Ganzberger; Geoffrey Michael,3,0,34,31
1657809817196,MATH 109,A02,083214,Ganzberger; Geoffrey Michael,4,0,34,30
1657809817196,MATH 109,A03,093478,Ganzberger; Geoffrey Michael,2,0,34,32
1657809817196,MATH 109,B01,083215,Ganzberger; Geoffrey Michael,1,0,32,31
1657809817196,MATH 109,B02,083216,Ganzberger; Geoffrey Michael,2,0,32,30
1657809817196,MATH 109,B03,093479,Ganzberger; Geoffrey Michael,8,0,32,24
1657809823242,MATH 142A,A01,083219,Chow; Bennett,7,0,32,25
1657809823242,MATH 142A,A02,083220,Chow; Bennett,10,0,32,22
1657809823242,MATH 142A,A03,093480,Chow; Bennett,9,0,32,23
1657809823242,MATH 142A,B03,093481,Chow; Bennett,8,0,32,24
1657809823242,MATH 142A,B04,093558,Chow; Bennett,13,0,32,19
1657809823242,MATH 142A,B05,093559,Chow; Bennett,6,0,32,26
1657809829273,MATH 193A,A01,083224,Rotar; Vladimir,8,0,34,26
1657809829273,MATH 193A,A02,083225,Rotar; Vladimir,9,0,34,25
1657809829273,MATH 193A,A03,083781,Rotar; Vladimir,5,0,34,29
1657809829273,MATH 193A,A04,083782,Rotar; Vladimir,10,0,34,24
1657809829273,MATH 193A,A05,093482,Rotar; Vladimir,10,0,34,24
1657809835301,MATH 197,001,091859,McAuley; Julian John,9999,0,9999,0
1657809835301,MATH 197,002,095566,Kedlaya; Kiran S.,9997,0,9999,2
1657809835301,MATH 197,003,095567,Xiao; Ming,9999,0,9999,0
1657809835301,MATH 197,004,095571,Perols; Johan Lars,9998,0,9999,1
1657809842370,COGS 9,A01,083615,Shannon; Kyle Michael,9,0,75,66
1657809848398,COGS 11,A01,083617,Boyle; Mary E. T.,23,0,48,25
1657809854423,COGS 13,A01,083071,Bastos; Amalia Pinkusfeld,11,0,71,60
1657809860448,COGS 14A,A01,092681,Semenuks; Arturs,5,1,100,95
1657809866473,COGS 14B,A01,083073,Cheng; Tzu-Han,6,0,63,57
1657809872498,COGS 17,A01,092677,Semenuks; Arturs,6,0,81,75
1657809878527,COGS 100,A01,083619,Allen; Michael Gordon,17,0,70,53
1657809884555,COGS 101A,A01,083621,Davis; Joshua Daniel,9,0,68,59
1657809890579,COGS 101B,A01,091572,Allen; Michael Gordon,12,0,65,53
1657809896607,COGS 101C,A01,083625,Delgado; Tania,17,0,35,18
1657809902637,COGS 107A,A01,083627,Boyle; Mary E. T.,14,0,60,46
1657809908665,COGS 118A,A01,083075,Gupta; Anjum,21,0,76,55
1657809914693,CSE 3,A50,083646,Miranda; Gregory Joseph,24,0,50,26
1657809920716,CSE 8A,A50,083650,Miranda; Gregory Joseph,17,1,56,39
1657809926741,CSE 11,A01,083080,Cao; Yingjun,6,15,40,34
1657809932776,CSE 12,A01,083652,Krause-Levy; Sophia Louisa,28,1,120,92
1657809938801,CSE 15L,A01,083654,Morris; Justin Loren,9,0,50,41
1657809938801,CSE 15L,A02,083655,Morris; Justin Loren,9,0,50,41
1657809944827,CSE 20,A01,083657,Tran; Khoa Dang,39,0,80,41
1657809950852,CSE 21,A01,095574,Bach; Quang Tran,22,0,48,26
1657809956887,CSE 30,A01,083084,Eldon; John,6,0,80,74
1657809956887,CSE 30,B01,095061,Bhaskar; Nishant,9,0,50,41
1657809962914,CSE 100,A01,083659,Cao; Yingjun,5,4,70,65
1657809968943,CSE 134B,A01,083661,Powell; Thomas Allan,24,0,100,76
1657809974968,CSE 140,A01,083663,Gungor; Onat,15,0,85,70
1657809981017,CSE 140L,A01,083088,Eldon; John,23,0,100,77
1657809987049,CSE 175,A01,083665,Kumar; Rakesh,3,0,25,22
1657809993074,CSE 190,A00,092507,Dubnov; Shlomo,8,0,20,12
1657809999105,ECE 45,A01,083139,Congero; Spencer William,6,0,75,69
1657810005130,ECE 65,A50,083695,Saad; Andrew S,12,0,30,18
1657810005130,ECE 65,A51,095125,Saad; Andrew S,24,0,26,2
1657810011153,ECE 109,A01,091882,Touri; Behrouz,20,0,70,50
1657810017184,ECE 180,A00,083140,Abi Samra; Nicholas Camill,1,0,30,29
1657810017184,ECE 180,B00,083141,Abi Samra; Nicholas Camill,0,0,30,30
1657810023212,MATH 10A,A01,083735,Patchell; Gregory David,2,0,30,28
1657810023212,MATH 10A,A02,083736,Patchell; Gregory David,20,0,30,10
1657810023212,MATH 10A,A03,083737,Patchell; Gregory David,16,0,30,14
1657810029247,MATH 10B,A01,083207,Lim; Seonhee,8,0,34,26
1657810029247,MATH 10B,A02,083208,Lim; Seonhee,10,0,35,25
1657810029247,MATH 10B,A03,093472,Lim; Seonhee,7,0,34,27
1657810029247,MATH 10B,B01,083739,Sinha; Shubham,13,0,30,17
1657810035285,MATH 18,A01,083743,Cinel; Cameron Alexander,9,0,30,21
1657810035285,MATH 18,A02,083744,Cinel; Cameron Alexander,18,0,30,12
1657810035285,MATH 18,A03,083745,Cinel; Cameron Alexander,10,0,30,20
1657810035285,MATH 18,B01,083748,Rideout; David Porter,5,0,37,32
1657810035285,MATH 18,B02,083749,Rideout; David Porter,5,0,36,31
1657810035285,MATH 18,B03,083750,Rideout; David Porter,3,0,37,34
1657810035285,MATH 18,B04,083751,Rideout; David Porter,6,0,36,30
1657810035285,MATH 18,B05,093473,Rideout; David Porter,6,0,36,30
1657810035285,MATH 18,B06,093474,Rideout; David Porter,6,0,36,30
1657810041323,MATH 20A,A01,083754,Zheng; Zequn,14,0,40,26
1657810047349,MATH 20B,A01,083756,Briones; Jor-el Thomas Caparas,4,0,36,32
1657810047349,MATH 20B,A02,083757,Briones; Jor-el Thomas Caparas,1,0,36,35
1657810047349,MATH 20B,A03,093475,Briones; Jor-el Thomas Caparas,2,0,36,34
1657810053381,MATH 20C,A01,083760,Briones; Jor-el Thomas Caparas,1,0,35,34
1657810053381,MATH 20C,A02,083761,Briones; Jor-el Thomas Caparas,8,0,35,27
1657810053381,MATH 20C,A03,093476,Briones; Jor-el Thomas Caparas,0,1,36,36
1657810053381,MATH 20C,B01,083762,Bach; Quang Tran,1,0,30,29
1657810059405,MATH 20D,A01,083765,Tran; Brian Kha,5,0,30,25
1657810059405,MATH 20D,A02,083766,Tran; Brian Kha,5,0,30,25
1657810059405,MATH 20D,A03,083767,Tran; Brian Kha,5,0,30,25
1657810065437,MATH 20E,A01,083771,Ganguly; Soumya,10,0,32,22
1657810065437,MATH 20E,A02,083772,Ganguly; Soumya,6,0,32,26
1657810065437,MATH 20E,B01,083773,Ciotti; Benjamin,20,0,35,15
1657810065437,MATH 20E,B02,083774,Ciotti; Benjamin,18,0,35,17
1657810071469,MATH 103A,A01,083777,Greenfeld; Be'Eri,3,0,36,33
1657810071469,MATH 103A,A02,083778,Greenfeld; Be'Eri,5,0,36,31
1657810071469,MATH 103A,A03,093561,Greenfeld; Be'Eri,6,0,36,30
1657810071469,MATH 103A,B01,083779,Greenfeld; Be'Eri,7,0,36,29
1657810071469,MATH 103A,B02,083780,Greenfeld; Be'Eri,4,0,36,32
1657810071469,MATH 103A,B03,093562,Greenfeld; Be'Eri,3,0,36,33
1657810077496,MATH 105,A01,085443,Carter; Anne Toulson,15,0,35,20
1657810077496,MATH 105,A02,093477,Carter; Anne Toulson,20,0,35,15
1657810083530,MATH 109,A01,083213,Ganzberger; Geoffrey Michael,3,0,34,31
1657810083530,MATH 109,A02,083214,Ganzberger; Geoffrey Michael,4,0,34,30
1657810083530,MATH 109,A03,093478,Ganzberger; Geoffrey Michael,2,0,34,32
1657810083530,MATH 109,B01,083215,Ganzberger; Geoffrey Michael,1,0,32,31
1657810083530,MATH 109,B02,083216,Ganzberger; Geoffrey Michael,2,0,32,30
1657810083530,MATH 109,B03,093479,Ganzberger; Geoffrey Michael,8,0,32,24
1657810089561,MATH 142A,A01,083219,Chow; Bennett,7,0,32,25
1657810089561,MATH 142A,A02,083220,Chow; Bennett,10,0,32,22
1657810089561,MATH 142A,A03,093480,Chow; Bennett,9,0,32,23
1657810089561,MATH 142A,B03,093481,Chow; Bennett,8,0,32,24
1657810089561,MATH 142A,B04,093558,Chow; Bennett,13,0,32,19
1657810089561,MATH 142A,B05,093559,Chow; Bennett,6,0,32,26
1657810095590,MATH 193A,A01,083224,Rotar; Vladimir,8,0,34,26
1657810095590,MATH 193A,A02,083225,Rotar; Vladimir,9,0,34,25
1657810095590,MATH 193A,A03,083781,Rotar; Vladimir,5,0,34,29
1657810095590,MATH 193A,A04,083782,Rotar; Vladimir,10,0,34,24
1657810095590,MATH 193A,A05,093482,Rotar; Vladimir,10,0,34,24
1657810101617,MATH 197,001,091859,McAuley; Julian John,9999,0,9999,0
1657810101617,MATH 197,002,095566,Kedlaya; Kiran S.,9997,0,9999,2
1657810101617,MATH 197,003,095567,Xiao; Ming,9999,0,9999,0
1657810101617,MATH 197,004,095571,Perols; Johan Lars,9998,0,9999,1
1657810108692,COGS 9,A01,083615,Shannon; Kyle Michael,9,0,75,66
1657810114716,COGS 11,A01,083617,Boyle; Mary E. T.,23,0,48,25
1657810120738,COGS 13,A01,083071,Bastos; Amalia Pinkusfeld,11,0,71,60
1657810126761,COGS 14A,A01,092681,Semenuks; Arturs,5,1,100,95
1657810132783,COGS 14B,A01,083073,Cheng; Tzu-Han,6,0,63,57
1657810138811,COGS 17,A01,092677,Semenuks; Arturs,6,0,81,75
1657810144839,COGS 100,A01,083619,Allen; Michael Gordon,17,0,70,53
1657810150872,COGS 101A,A01,083621,Davis; Joshua Daniel,9,0,68,59
1657810156897,COGS 101B,A01,091572,Allen; Michael Gordon,12,0,65,53
1657810162921,COGS 101C,A01,083625,Delgado; Tania,17,0,35,18
1657810168946,COGS 107A,A01,083627,Boyle; Mary E. T.,14,0,60,46
1657810174975,COGS 118A,A01,083075,Gupta; Anjum,21,0,76,55
1657810180997,CSE 3,A50,083646,Miranda; Gregory Joseph,24,0,50,26
1657810187023,CSE 8A,A50,083650,Miranda; Gregory Joseph,17,1,56,39
1657810193046,CSE 11,A01,083080,Cao; Yingjun,6,15,40,34
1657810199070,CSE 12,A01,083652,Krause-Levy; Sophia Louisa,28,1,120,92
1657810205097,CSE 15L,A01,083654,Morris; Justin Loren,9,0,50,41
1657810205097,CSE 15L,A02,083655,Morris; Justin Loren,9,0,50,41
1657810211120,CSE 20,A01,083657,Tran; Khoa Dang,39,0,80,41
1657810217143,CSE 21,A01,095574,Bach; Quang Tran,22,0,48,26
1657810223180,CSE 30,A01,083084,Eldon; John,6,0,80,74
1657810223180,CSE 30,B01,095061,Bhaskar; Nishant,9,0,50,41
1657810229215,CSE 100,A01,083659,Cao; Yingjun,5,4,70,65
1657810235243,CSE 134B,A01,083661,Powell; Thomas Allan,24,0,100,76
1657810241267,CSE 140,A01,083663,Gungor; Onat,15,0,85,70
1657810247290,CSE 140L,A01,083088,Eldon; John,23,0,100,77
1657810253315,CSE 175,A01,083665,Kumar; Rakesh,3,0,25,22
1657810259340,CSE 190,A00,092507,Dubnov; Shlomo,8,0,20,12
1657810265367,ECE 45,A01,083139,Congero; Spencer William,6,0,75,69
1657810271392,ECE 65,A50,083695,Saad; Andrew S,12,0,30,18
1657810271392,ECE 65,A51,095125,Saad; Andrew S,24,0,26,2
1657810277414,ECE 109,A01,091882,Touri; Behrouz,20,0,70,50
1657810283437,ECE 180,A00,083140,Abi Samra; Nicholas Camill,1,0,30,29
1657810283437,ECE 180,B00,083141,Abi Samra; Nicholas Camill,0,0,30,30
1657810289460,MATH 10A,A01,083735,Patchell; Gregory David,2,0,30,28
1657810289460,MATH 10A,A02,083736,Patchell; Gregory David,20,0,30,10
1657810289460,MATH 10A,A03,083737,Patchell; Gregory David,16,0,30,14
1657810295490,MATH 10B,A01,083207,Lim; Seonhee,8,0,34,26
1657810295490,MATH 10B,A02,083208,Lim; Seonhee,10,0,35,25
1657810295490,MATH 10B,A03,093472,Lim; Seonhee,7,0,34,27
1657810295490,MATH 10B,B01,083739,Sinha; Shubham,13,0,30,17
1657810301513,MATH 18,A01,083743,Cinel; Cameron Alexander,9,0,30,21
1657810301513,MATH 18,A02,083744,Cinel; Cameron Alexander,18,0,30,12
1657810301513,MATH 18,A03,083745,Cinel; Cameron Alexander,10,0,30,20
1657810301513,MATH 18,B01,083748,Rideout; David Porter,5,0,37,32
1657810301513,MATH 18,B02,083749,Rideout; David Porter,5,0,36,31
1657810301513,MATH 18,B03,083750,Rideout; David Porter,3,0,37,34
1657810301513,MATH 18,B04,083751,Rideout; David Porter,6,0,36,30
1657810301513,MATH 18,B05,093473,Rideout; David Porter,6,0,36,30
1657810301513,MATH 18,B06,093474,Rideout; David Porter,6,0,36,30
1657810307542,MATH 20A,A01,083754,Zheng; Zequn,14,0,40,26
1657810313570,MATH 20B,A01,083756,Briones; Jor-el Thomas Caparas,4,0,36,32
1657810313570,MATH 20B,A02,083757,Briones; Jor-el Thomas Caparas,1,0,36,35
1657810313570,MATH 20B,A03,093475,Briones; Jor-el Thomas Caparas,2,0,36,34
1657810319593,MATH 20C,A01,083760,Briones; Jor-el Thomas Caparas,1,0,35,34
1657810319593,MATH 20C,A02,083761,Briones; Jor-el Thomas Caparas,8,0,35,27
1657810319593,MATH 20C,A03,093476,Briones; Jor-el Thomas Caparas,0,1,36,36
1657810319593,MATH 20C,B01,083762,Bach; Quang Tran,1,0,30,29
1657810325699,MATH 20D,A01,083765,Tran; Brian Kha,5,0,30,25
1657810325699,MATH 20D,A02,083766,Tran; Brian Kha,5,0,30,25
1657810325699,MATH 20D,A03,083767,Tran; Brian Kha,5,0,30,25
1657810331732,MATH 20E,A01,083771,Ganguly; Soumya,10,0,32,22
1657810331732,MATH 20E,A02,083772,Ganguly; Soumya,6,0,32,26
1657810331732,MATH 20E,B01,083773,Ciotti; Benjamin,20,0,35,15
1657810331732,MATH 20E,B02,083774,Ciotti; Benjamin,18,0,35,17
1657810337757,MATH 103A,A01,083777,Greenfeld; Be'Eri,3,0,36,33
1657810337757,MATH 103A,A02,083778,Greenfeld; Be'Eri,5,0,36,31
1657810337757,MATH 103A,A03,093561,Greenfeld; Be'Eri,6,0,36,30
1657810337757,MATH 103A,B01,083779,Greenfeld; Be'Eri,7,0,36,29
1657810337757,MATH 103A,B02,083780,Greenfeld; Be'Eri,4,0,36,32
1657810337757,MATH 103A,B03,093562,Greenfeld; Be'Eri,3,0,36,33
1657810343790,MATH 105,A01,085443,Carter; Anne Toulson,15,0,35,20
1657810343790,MATH 105,A02,093477,Carter; Anne Toulson,20,0,35,15
1657810349822,MATH 109,A01,083213,Ganzberger; Geoffrey Michael,3,0,34,31
1657810349822,MATH 109,A02,083214,Ganzberger; Geoffrey Michael,4,0,34,30
1657810349822,MATH 109,A03,093478,Ganzberger; Geoffrey Michael,2,0,34,32
1657810349822,MATH 109,B01,083215,Ganzberger; Geoffrey Michael,1,0,32,31
1657810349822,MATH 109,B02,083216,Ganzberger; Geoffrey Michael,2,0,32,30
1657810349822,MATH 109,B03,093479,Ganzberger; Geoffrey Michael,8,0,32,24
1657810355847,MATH 142A,A01,083219,Chow; Bennett,7,0,32,25
1657810355847,MATH 142A,A02,083220,Chow; Bennett,10,0,32,22
1657810355847,MATH 142A,A03,093480,Chow; Bennett,9,0,32,23
1657810355847,MATH 142A,B03,093481,Chow; Bennett,8,0,32,24
1657810355847,MATH 142A,B04,093558,Chow; Bennett,13,0,32,19
1657810355847,MATH 142A,B05,093559,Chow; Bennett,6,0,32,26
1657810361880,MATH 193A,A01,083224,Rotar; Vladimir,8,0,34,26
1657810361880,MATH 193A,A02,083225,Rotar; Vladimir,9,0,34,25
1657810361880,MATH 193A,A03,083781,Rotar; Vladimir,5,0,34,29
1657810361880,MATH 193A,A04,083782,Rotar; Vladimir,10,0,34,24
1657810361880,MATH 193A,A05,093482,Rotar; Vladimir,10,0,34,24
1657810367908,MATH 197,001,091859,McAuley; Julian John,9999,0,9999,0
1657810367908,MATH 197,002,095566,Kedlaya; Kiran S.,9997,0,9999,2
1657810367908,MATH 197,003,095567,Xiao; Ming,9999,0,9999,0
1657810367908,MATH 197,004,095571,Perols; Johan Lars,9998,0,9999,1
1657810374967,COGS 9,A01,083615,Shannon; Kyle Michael,9,0,75,66
1657810380993,COGS 11,A01,083617,Boyle; Mary E. T.,23,0,48,25
1657810387016,COGS 13,A01,083071,Bastos; Amalia Pinkusfeld,11,0,71,60
1657810393038,COGS 14A,A01,092681,Semenuks; Arturs,5,1,100,95
1657810399068,COGS 14B,A01,083073,Cheng; Tzu-Han,6,0,63,57
1657810405103,COGS 17,A01,092677,Semenuks; Arturs,6,0,81,75
1657810411129,COGS 100,A01,083619,Allen; Michael Gordon,17,0,70,53
1657810417158,COGS 101A,A01,083621,Davis; Joshua Daniel,9,0,68,59
1657810423186,COGS 101B,A01,091572,Allen; Michael Gordon,12,0,65,53
1657810429219,COGS 101C,A01,083625,Delgado; Tania,17,0,35,18
1657810435248,COGS 107A,A01,083627,Boyle; Mary E. T.,14,0,60,46
1657810441275,COGS 118A,A01,083075,Gupta; Anjum,21,0,76,55
1657810447302,CSE 3,A50,083646,Miranda; Gregory Joseph,24,0,50,26
1657810453333,CSE 8A,A50,083650,Miranda; Gregory Joseph,17,1,56,39
1657810459362,CSE 11,A01,083080,Cao; Yingjun,6,15,40,34
1657810465390,CSE 12,A01,083652,Krause-Levy; Sophia Louisa,28,1,120,92
1657810471412,CSE 15L,A01,083654,Morris; Justin Loren,9,0,50,41
1657810471412,CSE 15L,A02,083655,Morris; Justin Loren,9,0,50,41
1657810477437,CSE 20,A01,083657,Tran; Khoa Dang,39,0,80,41
1657810483462,CSE 21,A01,095574,Bach; Quang Tran,22,0,48,26
1657810489485,CSE 30,A01,083084,Eldon; John,6,0,80,74
1657810489485,CSE 30,B01,095061,Bhaskar; Nishant,9,0,50,41
1657810495509,CSE 100,A01,083659,Cao; Yingjun,5,4,70,65
1657810501538,CSE 134B,A01,083661,Powell; Thomas Allan,24,0,100,76
1657810507567,CSE 140,A01,083663,Gungor; Onat,15,0,85,70
1657810513597,CSE 140L,A01,083088,Eldon; John,23,0,100,77
1657810519620,CSE 175,A01,083665,Kumar; Rakesh,3,0,25,22
1657810525649,CSE 190,A00,092507,Dubnov; Shlomo,8,0,20,12
1657810531671,ECE 45,A01,083139,Congero; Spencer William,6,0,75,69
1657810537694,ECE 65,A50,083695,Saad; Andrew S,12,0,30,18
1657810537694,ECE 65,A51,095125,Saad; Andrew S,24,0,26,2
1657810543720,ECE 109,A01,091882,Touri; Behrouz,20,0,70,50
1657810549742,ECE 180,A00,083140,Abi Samra; Nicholas Camill,1,0,30,29
1657810549742,ECE 180,B00,083141,Abi Samra; Nicholas Camill,0,0,30,30
1657810555765,MATH 10A,A01,083735,Patchell; Gregory David,2,0,30,28
1657810555765,MATH 10A,A02,083736,Patchell; Gregory David,20,0,30,10
1657810555765,MATH 10A,A03,083737,Patchell; Gregory David,16,0,30,14
1657810561794,MATH 10B,A01,083207,Lim; Seonhee,8,0,34,26
1657810561794,MATH 10B,A02,083208,Lim; Seonhee,10,0,35,25
1657810561794,MATH 10B,A03,093472,Lim; Seonhee,7,0,34,27
1657810561794,MATH 10B,B01,083739,Sinha; Shubham,13,0,30,17
1657810567817,MATH 18,A01,083743,Cinel; Cameron Alexander,9,0,30,21
1657810567817,MATH 18,A02,083744,Cinel; Cameron Alexander,18,0,30,12
1657810567817,MATH 18,A03,083745,Cinel; Cameron Alexander,10,0,30,20
1657810567817,MATH 18,B01,083748,Rideout; David Porter,5,0,37,32
1657810567817,MATH 18,B02,083749,Rideout; David Porter,5,0,36,31
1657810567817,MATH 18,B03,083750,Rideout; David Porter,3,0,37,34
1657810567817,MATH 18,B04,083751,Rideout; David Porter,6,0,36,30
1657810567817,MATH 18,B05,093473,Rideout; David Porter,6,0,36,30
1657810567817,MATH 18,B06,093474,Rideout; David Porter,6,0,36,30
1657810573842,MATH 20A,A01,083754,Zheng; Zequn,14,0,40,26
1657810579869,MATH 20B,A01,083756,Briones; Jor-el Thomas Caparas,4,0,36,32
1657810579869,MATH 20B,A02,083757,Briones; Jor-el Thomas Caparas,1,0,36,35
1657810579869,MATH 20B,A03,093475,Briones; Jor-el Thomas Caparas,2,0,36,34
1657810585893,MATH 20C,A01,083760,Briones; Jor-el Thomas Caparas,1,0,35,34
1657810585893,MATH 20C,A02,083761,Briones; Jor-el Thomas Caparas,8,0,35,27
1657810585893,MATH 20C,A03,093476,Briones; Jor-el Thomas Caparas,0,1,36,36
1657810585893,MATH 20C,B01,083762,Bach; Quang Tran,1,0,30,29
1657810591921,MATH 20D,A01,083765,Tran; Brian Kha,5,0,30,25
1657810591921,MATH 20D,A02,083766,Tran; Brian Kha,5,0,30,25
1657810591921,MATH 20D,A03,083767,Tran; Brian Kha,5,0,30,25
1657810597950,MATH 20E,A01,083771,Ganguly; Soumya,10,0,32,22
1657810597950,MATH 20E,A02,083772,Ganguly; Soumya,6,0,32,26
1657810597950,MATH 20E,B01,083773,Ciotti; Benjamin,20,0,35,15
1657810597950,MATH 20E,B02,083774,Ciotti; Benjamin,18,0,35,17
1657810603973,MATH 103A,A01,083777,Greenfeld; Be'Eri,3,0,36,33
1657810603973,MATH 103A,A02,083778,Greenfeld; Be'Eri,5,0,36,31
1657810603973,MATH 103A,A03,093561,Greenfeld; Be'Eri,6,0,36,30
1657810603973,MATH 103A,B01,083779,Greenfeld; Be'Eri,7,0,36,29
1657810603973,MATH 103A,B02,083780,Greenfeld; Be'Eri,4,0,36,32
1657810603973,MATH 103A,B03,093562,Greenfeld; Be'Eri,3,0,36,33
1657810609995,MATH 105,A01,085443,Carter; Anne Toulson,15,0,35,20
1657810609995,MATH 105,A02,093477,Carter; Anne Toulson,20,0,35,15
1657810616019,MATH 109,A01,083213,Ganzberger; Geoffrey Michael,3,0,34,31
1657810616019,MATH 109,A02,083214,Ganzberger; Geoffrey Michael,4,0,34,30
1657810616019,MATH 109,A03,093478,Ganzberger; Geoffrey Michael,2,0,34,32
1657810616019,MATH 109,B01,083215,Ganzberger; Geoffrey Michael,1,0,32,31
1657810616019,MATH 109,B02,083216,Ganzberger; Geoffrey Michael,2,0,32,30
1657810616019,MATH 109,B03,093479,Ganzberger; Geoffrey Michael,8,0,32,24
1657810622051,MATH 142A,A01,083219,Chow; Bennett,7,0,32,25
1657810622051,MATH 142A,A02,083220,Chow; Bennett,10,0,32,22
1657810622051,MATH 142A,A03,093480,Chow; Bennett,9,0,32,23
1657810622051,MATH 142A,B03,093481,Chow; Bennett,8,0,32,24
1657810622051,MATH 142A,B04,093558,Chow; Bennett,13,0,32,19
1657810622051,MATH 142A,B05,093559,Chow; Bennett,6,0,32,26
1657810628077,MATH 193A,A01,083224,Rotar; Vladimir,8,0,34,26
1657810628077,MATH 193A,A02,083225,Rotar; Vladimir,9,0,34,25
1657810628077,MATH 193A,A03,083781,Rotar; Vladimir,5,0,34,29
1657810628077,MATH 193A,A04,083782,Rotar; Vladimir,10,0,34,24
1657810628077,MATH 193A,A05,093482,Rotar; Vladimir,10,0,34,24
1657810634107,MATH 197,001,091859,McAuley; Julian John,9999,0,9999,0
1657810634107,MATH 197,002,095566,Kedlaya; Kiran S.,9997,0,9999,2
1657810634107,MATH 197,003,095567,Xiao; Ming,9999,0,9999,0
1657810634107,MATH 197,004,095571,Perols; Johan Lars,9998,0,9999,1
1657810641167,COGS 9,A01,083615,Shannon; Kyle Michael,9,0,75,66
1657810647194,COGS 11,A01,083617,Boyle; Mary E. T.,23,0,48,25
1657810653223,COGS 13,A01,083071,Bastos; Amalia Pinkusfeld,11,0,71,60
1657810659248,COGS 14A,A01,092681,Semenuks; Arturs,5,1,100,95
1657810665276,COGS 14B,A01,083073,Cheng; Tzu-Han,6,0,63,57
1657810671299,COGS 17,A01,092677,Semenuks; Arturs,6,0,81,75
1657810677325,COGS 100,A01,083619,Allen; Michael Gordon,17,0,70,53
1657810683354,COGS 101A,A01,083621,Davis; Joshua Daniel,9,0,68,59
1657810689381,COGS 101B,A01,091572,Allen; Michael Gordon,12,0,65,53
1657810695410,COGS 101C,A01,083625,Delgado; Tania,17,0,35,18
1657810701435,COGS 107A,A01,083627,Boyle; Mary E. T.,14,0,60,46
1657810707460,COGS 118A,A01,083075,Gupta; Anjum,21,0,76,55
1657810713482,CSE 3,A50,083646,Miranda; Gregory Joseph,24,0,50,26
1657810719510,CSE 8A,A50,083650,Miranda; Gregory Joseph,17,1,56,39
1657810725534,CSE 11,A01,083080,Cao; Yingjun,6,15,40,34
1657810731558,CSE 12,A01,083652,Krause-Levy; Sophia Louisa,28,1,120,92
1657810737583,CSE 15L,A01,083654,Morris; Justin Loren,9,0,50,41
1657810737583,CSE 15L,A02,083655,Morris; Justin Loren,9,0,50,41
1657810743616,CSE 20,A01,083657,Tran; Khoa Dang,39,0,80,41
1657810749639,CSE 21,A01,095574,Bach; Quang Tran,22,0,48,26
1657810755665,CSE 30,A01,083084,Eldon; John,6,0,80,74
1657810755665,CSE 30,B01,095061,Bhaskar; Nishant,9,0,50,41
1657810761689,CSE 100,A01,083659,Cao; Yingjun,5,4,70,65
1657810767713,CSE 134B,A01,083661,Powell; Thomas Allan,24,0,100,76
1657810773741,CSE 140,A01,083663,Gungor; Onat,15,0,85,70
1657810779763,CSE 140L,A01,083088,Eldon; John,23,0,100,77
1657810785787,CSE 175,A01,083665,Kumar; Rakesh,3,0,25,22
1657810791814,CSE 190,A00,092507,Dubnov; Shlomo,8,0,20,12
1657810797840,ECE 45,A01,083139,Congero; Spencer William,6,0,75,69
1657810803882,ECE 65,A50,083695,Saad; Andrew S,12,0,30,18
1657810803882,ECE 65,A51,095125,Saad; Andrew S,24,0,26,2
1657810809906,ECE 109,A01,091882,Touri; Behrouz,20,0,70,50
1657810815929,ECE 180,A00,083140,Abi Samra; Nicholas Camill,1,0,30,29
1657810815929,ECE 180,B00,083141,Abi Samra; Nicholas Camill,0,0,30,30
1657810821956,MATH 10A,A01,083735,Patchell; Gregory David,2,0,30,28
1657810821956,MATH 10A,A02,083736,Patchell; Gregory David,20,0,30,10
1657810821956,MATH 10A,A03,083737,Patchell; Gregory David,16,0,30,14
1657810827989,MATH 10B,A01,083207,Lim; Seonhee,8,0,34,26
1657810827989,MATH 10B,A02,083208,Lim; Seonhee,10,0,35,25
1657810827989,MATH 10B,A03,093472,Lim; Seonhee,7,0,34,27
1657810827989,MATH 10B,B01,083739,Sinha; Shubham,13,0,30,17
1657810834013,MATH 18,A01,083743,Cinel; Cameron Alexander,9,0,30,21
1657810834013,MATH 18,A02,083744,Cinel; Cameron Alexander,18,0,30,12
1657810834013,MATH 18,A03,083745,Cinel; Cameron Alexander,10,0,30,20
1657810834013,MATH 18,B01,083748,Rideout; David Porter,5,0,37,32
1657810834013,MATH 18,B02,083749,Rideout; David Porter,5,0,36,31
1657810834013,MATH 18,B03,083750,Rideout; David Porter,3,0,37,34
1657810834013,MATH 18,B04,083751,Rideout; David Porter,6,0,36,30
1657810834013,MATH 18,B05,093473,Rideout; David Porter,6,0,36,30
1657810834013,MATH 18,B06,093474,Rideout; David Porter,6,0,36,30
1657810840042,MATH 20A,A01,083754,Zheng; Zequn,14,0,40,26
1657810846068,MATH 20B,A01,083756,Briones; Jor-el Thomas Caparas,4,0,36,32
1657810846068,MATH 20B,A02,083757,Briones; Jor-el Thomas Caparas,1,0,36,35
1657810846068,MATH 20B,A03,093475,Briones; Jor-el Thomas Caparas,2,0,36,34
1657810852092,MATH 20C,A01,083760,Briones; Jor-el Thomas Caparas,1,0,35,34
1657810852092,MATH 20C,A02,083761,Briones; Jor-el Thomas Caparas,8,0,35,27
1657810852092,MATH 20C,A03,093476,Briones; Jor-el Thomas Caparas,0,1,36,36
1657810852092,MATH 20C,B01,083762,Bach; Quang Tran,1,0,30,29
1657810858128,MATH 20D,A01,083765,Tran; Brian Kha,5,0,30,25
1657810858128,MATH 20D,A02,083766,Tran; Brian Kha,5,0,30,25
1657810858128,MATH 20D,A03,083767,Tran; Brian Kha,5,0,30,25
1657810864152,MATH 20E,A01,083771,Ganguly; Soumya,10,0,32,22
1657810864152,MATH 20E,A02,083772,Ganguly; Soumya,6,0,32,26
1657810864152,MATH 20E,B01,083773,Ciotti; Benjamin,20,0,35,15
1657810864152,MATH 20E,B02,083774,Ciotti; Benjamin,18,0,35,17
1657810870183,MATH 103A,A01,083777,Greenfeld; Be'Eri,3,0,36,33
1657810870183,MATH 103A,A02,083778,Greenfeld; Be'Eri,5,0,36,31
1657810870183,MATH 103A,A03,093561,Greenfeld; Be'Eri,6,0,36,30
1657810870183,MATH 103A,B01,083779,Greenfeld; Be'Eri,7,0,36,29
1657810870183,MATH 103A,B02,083780,Greenfeld; Be'Eri,4,0,36,32
1657810870183,MATH 103A,B03,093562,Greenfeld; Be'Eri,3,0,36,33
1657810876210,MATH 105,A01,085443,Carter; Anne Toulson,15,0,35,20
1657810876210,MATH 105,A02,093477,Carter; Anne Toulson,20,0,35,15
1657810882239,MATH 109,A01,083213,Ganzberger; Geoffrey Michael,3,0,34,31
1657810882239,MATH 109,A02,083214,Ganzberger; Geoffrey Michael,4,0,34,30
1657810882239,MATH 109,A03,093478,Ganzberger; Geoffrey Michael,2,0,34,32
1657810882239,MATH 109,B01,083215,Ganzberger; Geoffrey Michael,1,0,32,31
1657810882239,MATH 109,B02,083216,Ganzberger; Geoffrey Michael,2,0,32,30
1657810882239,MATH 109,B03,093479,Ganzberger; Geoffrey Michael,8,0,32,24
1657810888268,MATH 142A,A01,083219,Chow; Bennett,7,0,32,25
1657810888268,MATH 142A,A02,083220,Chow; Bennett,10,0,32,22
1657810888268,MATH 142A,A03,093480,Chow; Bennett,9,0,32,23
1657810888268,MATH 142A,B03,093481,Chow; Bennett,8,0,32,24
1657810888268,MATH 142A,B04,093558,Chow; Bennett,13,0,32,19
1657810888268,MATH 142A,B05,093559,Chow; Bennett,6,0,32,26
1657810894293,MATH 193A,A01,083224,Rotar; Vladimir,8,0,34,26
1657810894293,MATH 193A,A02,083225,Rotar; Vladimir,9,0,34,25
1657810894293,MATH 193A,A03,083781,Rotar; Vladimir,5,0,34,29
1657810894293,MATH 193A,A04,083782,Rotar; Vladimir,10,0,34,24
1657810894293,MATH 193A,A05,093482,Rotar; Vladimir,10,0,34,24
1657810900318,MATH 197,001,091859,McAuley; Julian John,9999,0,9999,0
1657810900318,MATH 197,002,095566,Kedlaya; Kiran S.,9997,0,9999,2
1657810900318,MATH 197,003,095567,Xiao; Ming,9999,0,9999,0
1657810900318,MATH 197,004,095571,Perols; Johan Lars,9998,0,9999,1
1657810907372,COGS 9,A01,083615,Shannon; Kyle Michael,9,0,75,66
1657810913397,COGS 11,A01,083617,Boyle; Mary E. T.,23,0,48,25
1657810919520,COGS 13,A01,083071,Bastos; Amalia Pinkusfeld,11,0,71,60
1657810925543,COGS 14A,A01,092681,Semenuks; Arturs,5,1,100,95
1657810931568,COGS 14B,A01,083073,Cheng; Tzu-Han,6,0,63,57
1657810937592,COGS 17,A01,092677,Semenuks; Arturs,6,0,81,75
1657810943619,COGS 100,A01,083619,Allen; Michael Gordon,17,0,70,53
1657810949647,COGS 101A,A01,083621,Davis; Joshua Daniel,9,0,68,59
1657810955692,COGS 101B,A01,091572,Allen; Michael Gordon,12,0,65,53
1657810961727,COGS 101C,A01,083625,Delgado; Tania,17,0,35,18
1657810967749,COGS 107A,A01,083627,Boyle; Mary E. T.,14,0,60,46
1657810973772,COGS 118A,A01,083075,Gupta; Anjum,21,0,76,55
1657810979802,CSE 3,A50,083646,Miranda; Gregory Joseph,24,0,50,26
1657810985830,CSE 8A,A50,083650,Miranda; Gregory Joseph,17,1,56,39
1657810991855,CSE 11,A01,083080,Cao; Yingjun,6,15,40,34
1657810997878,CSE 12,A01,083652,Krause-Levy; Sophia Louisa,28,1,120,92
1657811003900,CSE 15L,A01,083654,Morris; Justin Loren,9,0,50,41
1657811003900,CSE 15L,A02,083655,Morris; Justin Loren,9,0,50,41
1657811009926,CSE 20,A01,083657,Tran; Khoa Dang,39,0,80,41
1657811015954,CSE 21,A01,095574,Bach; Quang Tran,22,0,48,26
1657811021976,CSE 30,A01,083084,Eldon; John,6,0,80,74
1657811021976,CSE 30,B01,095061,Bhaskar; Nishant,9,0,50,41
1657811028010,CSE 100,A01,083659,Cao; Yingjun,5,4,70,65
1657811034034,CSE 134B,A01,083661,Powell; Thomas Allan,24,0,100,76
1657811040064,CSE 140,A01,083663,Gungor; Onat,15,0,85,70
1657811046089,CSE 140L,A01,083088,Eldon; John,23,0,100,77
1657811052118,CSE 175,A01,083665,Kumar; Rakesh,3,0,25,22
1657811058146,CSE 190,A00,092507,Dubnov; Shlomo,8,0,20,12
1657811064173,ECE 45,A01,083139,Congero; Spencer William,6,0,75,69
1657811070201,ECE 65,A50,083695,Saad; Andrew S,12,0,30,18
1657811070201,ECE 65,A51,095125,Saad; Andrew S,24,0,26,2
1657811076230,ECE 109,A01,091882,Touri; Behrouz,20,0,70,50
1657811082254,ECE 180,A00,083140,Abi Samra; Nicholas Camill,1,0,30,29
1657811082254,ECE 180,B00,083141,Abi Samra; Nicholas Camill,0,0,30,30
1657811088280,MATH 10A,A01,083735,Patchell; Gregory David,2,0,30,28
1657811088280,MATH 10A,A02,083736,Patchell; Gregory David,20,0,30,10
1657811088280,MATH 10A,A03,083737,Patchell; Gregory David,16,0,30,14
1657811094306,MATH 10B,A01,083207,Lim; Seonhee,8,0,34,26
1657811094306,MATH 10B,A02,083208,Lim; Seonhee,10,0,35,25
1657811094306,MATH 10B,A03,093472,Lim; Seonhee,7,0,34,27
1657811094306,MATH 10B,B01,083739,Sinha; Shubham,13,0,30,17
1657811100331,MATH 18,A01,083743,Cinel; Cameron Alexander,9,0,30,21
1657811100331,MATH 18,A02,083744,Cinel; Cameron Alexander,18,0,30,12
1657811100331,MATH 18,A03,083745,Cinel; Cameron Alexander,10,0,30,20
1657811100331,MATH 18,B01,083748,Rideout; David Porter,5,0,37,32
1657811100331,MATH 18,B02,083749,Rideout; David Porter,5,0,36,31
1657811100331,MATH 18,B03,083750,Rideout; David Porter,3,0,37,34
1657811100331,MATH 18,B04,083751,Rideout; David Porter,6,0,36,30
1657811100331,MATH 18,B05,093473,Rideout; David Porter,6,0,36,30
1657811100331,MATH 18,B06,093474,Rideout; David Porter,6,0,36,30
1657811106359,MATH 20A,A01,083754,Zheng; Zequn,14,0,40,26
1657811112387,MATH 20B,A01,083756,Briones; Jor-el Thomas Caparas,4,0,36,32
1657811112387,MATH 20B,A02,083757,Briones; Jor-el Thomas Caparas,1,0,36,35
1657811112387,MATH 20B,A03,093475,Briones; Jor-el Thomas Caparas,2,0,36,34
1657811118413,MATH 20C,A01,083760,Briones; Jor-el Thomas Caparas,1,0,35,34
1657811118413,MATH 20C,A02,083761,Briones; Jor-el Thomas Caparas,8,0,35,27
1657811118413,MATH 20C,A03,093476,Briones; Jor-el Thomas Caparas,0,1,36,36
1657811118413,MATH 20C,B01,083762,Bach; Quang Tran,1,0,30,29
1657811124437,MATH 20D,A01,083765,Tran; Brian Kha,5,0,30,25
1657811124437,MATH 20D,A02,083766,Tran; Brian Kha,5,0,30,25
1657811124437,MATH 20D,A03,083767,Tran; Brian Kha,5,0,30,25
1657811130465,MATH 20E,A01,083771,Ganguly; Soumya,10,0,32,22
1657811130465,MATH 20E,A02,083772,Ganguly; Soumya,6,0,32,26
1657811130465,MATH 20E,B01,083773,Ciotti; Benjamin,20,0,35,15
1657811130465,MATH 20E,B02,083774,Ciotti; Benjamin,18,0,35,17
1657811136493,MATH 103A,A01,083777,Greenfeld; Be'Eri,3,0,36,33
1657811136493,MATH 103A,A02,083778,Greenfeld; Be'Eri,5,0,36,31
1657811136493,MATH 103A,A03,093561,Greenfeld; Be'Eri,6,0,36,30
1657811136493,MATH 103A,B01,083779,Greenfeld; Be'Eri,7,0,36,29
1657811136493,MATH 103A,B02,083780,Greenfeld; Be'Eri,4,0,36,32
1657811136493,MATH 103A,B03,093562,Greenfeld; Be'Eri,3,0,36,33
1657811142522,MATH 105,A01,085443,Carter; Anne Toulson,15,0,35,20
1657811142522,MATH 105,A02,093477,Carter; Anne Toulson,20,0,35,15
1657811148548,MATH 109,A01,083213,Ganzberger; Geoffrey Michael,3,0,34,31
1657811148548,MATH 109,A02,083214,Ganzberger; Geoffrey Michael,4,0,34,30
1657811148548,MATH 109,A03,093478,Ganzberger; Geoffrey Michael,2,0,34,32
1657811148548,MATH 109,B01,083215,Ganzberger; Geoffrey Michael,1,0,32,31
1657811148548,MATH 109,B02,083216,Ganzberger; Geoffrey Michael,2,0,32,30
1657811148548,MATH 109,B03,093479,Ganzberger; Geoffrey Michael,8,0,32,24
1657811154579,MATH 142A,A01,083219,Chow; Bennett,7,0,32,25
1657811154579,MATH 142A,A02,083220,Chow; Bennett,10,0,32,22
1657811154579,MATH 142A,A03,093480,Chow; Bennett,9,0,32,23
1657811154579,MATH 142A,B03,093481,Chow; Bennett,8,0,32,24
1657811154579,MATH 142A,B04,093558,Chow; Bennett,13,0,32,19
1657811154579,MATH 142A,B05,093559,Chow; Bennett,6,0,32,26
1657811160609,MATH 193A,A01,083224,Rotar; Vladimir,8,0,34,26
1657811160609,MATH 193A,A02,083225,Rotar; Vladimir,9,0,34,25
1657811160609,MATH 193A,A03,083781,Rotar; Vladimir,5,0,34,29
1657811160609,MATH 193A,A04,083782,Rotar; Vladimir,10,0,34,24
1657811160609,MATH 193A,A05,093482,Rotar; Vladimir,10,0,34,24
1657811166632,MATH 197,001,091859,McAuley; Julian John,9999,0,9999,0
1657811166632,MATH 197,002,095566,Kedlaya; Kiran S.,9997,0,9999,2
1657811166632,MATH 197,003,095567,Xiao; Ming,9999,0,9999,0
1657811166632,MATH 197,004,095571,Perols; Johan Lars,9998,0,9999,1
1657811173688,COGS 9,A01,083615,Shannon; Kyle Michael,9,0,75,66
1657811179709,COGS 11,A01,083617,Boyle; Mary E. T.,23,0,48,25
1657811185733,COGS 13,A01,083071,Bastos; Amalia Pinkusfeld,11,0,71,60
1657811191760,COGS 14A,A01,092681,Semenuks; Arturs,5,1,100,95
1657811197782,COGS 14B,A01,083073,Cheng; Tzu-Han,6,0,63,57
1657811203808,COGS 17,A01,092677,Semenuks; Arturs,6,0,81,75
1657811209836,COGS 100,A01,083619,Allen; Michael Gordon,17,0,70,53
1657811215857,COGS 101A,A01,083621,Davis; Joshua Daniel,9,0,68,59
1657811221882,COGS 101B,A01,091572,Allen; Michael Gordon,12,0,65,53
1657811227905,COGS 101C,A01,083625,Delgado; Tania,17,0,35,18
1657811233928,COGS 107A,A01,083627,Boyle; Mary E. T.,14,0,60,46
1657811239952,COGS 118A,A01,083075,Gupta; Anjum,21,0,76,55
1657811245975,CSE 3,A50,083646,Miranda; Gregory Joseph,24,0,50,26
1657811251999,CSE 8A,A50,083650,Miranda; Gregory Joseph,17,1,56,39
1657811258026,CSE 11,A01,083080,Cao; Yingjun,6,15,40,34
1657811264052,CSE 12,A01,083652,Krause-Levy; Sophia Louisa,28,1,120,92
1657811270077,CSE 15L,A01,083654,Morris; Justin Loren,9,0,50,41
1657811270077,CSE 15L,A02,083655,Morris; Justin Loren,9,0,50,41
1657811276104,CSE 20,A01,083657,Tran; Khoa Dang,39,0,80,41
1657811282130,CSE 21,A01,095574,Bach; Quang Tran,22,0,48,26
1657811288155,CSE 30,A01,083084,Eldon; John,6,0,80,74
1657811288155,CSE 30,B01,095061,Bhaskar; Nishant,9,0,50,41
1657811294182,CSE 100,A01,083659,Cao; Yingjun,5,4,70,65
1657811300209,CSE 134B,A01,083661,Powell; Thomas Allan,24,0,100,76
1657811306236,CSE 140,A01,083663,Gungor; Onat,15,0,85,70
1657811312259,CSE 140L,A01,083088,Eldon; John,23,0,100,77
1657811318282,CSE 175,A01,083665,Kumar; Rakesh,3,0,25,22
1657811324317,CSE 190,A00,092507,Dubnov; Shlomo,8,0,20,12
1657811330353,ECE 45,A01,083139,Congero; Spencer William,6,0,75,69
1657811336374,ECE 65,A50,083695,Saad; Andrew S,12,0,30,18
1657811336374,ECE 65,A51,095125,Saad; Andrew S,24,0,26,2
1657811342404,ECE 109,A01,091882,Touri; Behrouz,20,0,70,50
1657811348428,ECE 180,A00,083140,Abi Samra; Nicholas Camill,1,0,30,29
1657811348428,ECE 180,B00,083141,Abi Samra; Nicholas Camill,0,0,30,30
1657811354451,MATH 10A,A01,083735,Patchell; Gregory David,2,0,30,28
1657811354451,MATH 10A,A02,083736,Patchell; Gregory David,20,0,30,10
1657811354451,MATH 10A,A03,083737,Patchell; Gregory David,16,0,30,14
1657811360481,MATH 10B,A01,083207,Lim; Seonhee,8,0,34,26
1657811360481,MATH 10B,A02,083208,Lim; Seonhee,10,0,35,25
1657811360481,MATH 10B,A03,093472,Lim; Seonhee,7,0,34,27
1657811360481,MATH 10B,B01,083739,Sinha; Shubham,13,0,30,17
1657811366507,MATH 18,A01,083743,Cinel; Cameron Alexander,9,0,30,21
1657811366507,MATH 18,A02,083744,Cinel; Cameron Alexander,18,0,30,12
1657811366507,MATH 18,A03,083745,Cinel; Cameron Alexander,10,0,30,20
1657811366507,MATH 18,B01,083748,Rideout; David Porter,5,0,37,32
1657811366507,MATH 18,B02,083749,Rideout; David Porter,5,0,36,31
1657811366507,MATH 18,B03,083750,Rideout; David Porter,3,0,37,34
1657811366507,MATH 18,B04,083751,Rideout; David Porter,6,0,36,30
1657811366507,MATH 18,B05,093473,Rideout; David Porter,6,0,36,30
1657811366507,MATH 18,B06,093474,Rideout; David Porter,6,0,36,30
1657811372535,MATH 20A,A01,083754,Zheng; Zequn,14,0,40,26
1657811378559,MATH 20B,A01,083756,Briones; Jor-el Thomas Caparas,4,0,36,32
1657811378559,MATH 20B,A02,083757,Briones; Jor-el Thomas Caparas,1,0,36,35
1657811378559,MATH 20B,A03,093475,Briones; Jor-el Thomas Caparas,2,0,36,34
1657811384583,MATH 20C,A01,083760,Briones; Jor-el Thomas Caparas,1,0,35,34
1657811384583,MATH 20C,A02,083761,Briones; Jor-el Thomas Caparas,8,0,35,27
1657811384583,MATH 20C,A03,093476,Briones; Jor-el Thomas Caparas,0,1,36,36
1657811384583,MATH 20C,B01,083762,Bach; Quang Tran,1,0,30,29
1657811390620,MATH 20D,A01,083765,Tran; Brian Kha,5,0,30,25
1657811390620,MATH 20D,A02,083766,Tran; Brian Kha,5,0,30,25
1657811390620,MATH 20D,A03,083767,Tran; Brian Kha,5,0,30,25
1657811396644,MATH 20E,A01,083771,Ganguly; Soumya,10,0,32,22
1657811396644,MATH 20E,A02,083772,Ganguly; Soumya,6,0,32,26
1657811396644,MATH 20E,B01,083773,Ciotti; Benjamin,20,0,35,15
1657811396644,MATH 20E,B02,083774,Ciotti; Benjamin,18,0,35,17
1657811402679,MATH 103A,A01,083777,Greenfeld; Be'Eri,3,0,36,33
1657811402679,MATH 103A,A02,083778,Greenfeld; Be'Eri,5,0,36,31
1657811402679,MATH 103A,A03,093561,Greenfeld; Be'Eri,6,0,36,30
1657811402679,MATH 103A,B01,083779,Greenfeld; Be'Eri,7,0,36,29
1657811402679,MATH 103A,B02,083780,Greenfeld; Be'Eri,4,0,36,32
1657811402679,MATH 103A,B03,093562,Greenfeld; Be'Eri,3,0,36,33
1657811408707,MATH 105,A01,085443,Carter; Anne Toulson,15,0,35,20
1657811408707,MATH 105,A02,093477,Carter; Anne Toulson,20,0,35,15
1657811414733,MATH 109,A01,083213,Ganzberger; Geoffrey Michael,3,0,34,31
1657811414733,MATH 109,A02,083214,Ganzberger; Geoffrey Michael,4,0,34,30
1657811414733,MATH 109,A03,093478,Ganzberger; Geoffrey Michael,2,0,34,32
1657811414733,MATH 109,B01,083215,Ganzberger; Geoffrey Michael,1,0,32,31
1657811414733,MATH 109,B02,083216,Ganzberger; Geoffrey Michael,2,0,32,30
1657811414733,MATH 109,B03,093479,Ganzberger; Geoffrey Michael,8,0,32,24
1657811420763,MATH 142A,A01,083219,Chow; Bennett,7,0,32,25
1657811420763,MATH 142A,A02,083220,Chow; Bennett,10,0,32,22
1657811420763,MATH 142A,A03,093480,Chow; Bennett,9,0,32,23
1657811420763,MATH 142A,B03,093481,Chow; Bennett,8,0,32,24
1657811420763,MATH 142A,B04,093558,Chow; Bennett,13,0,32,19
1657811420763,MATH 142A,B05,093559,Chow; Bennett,6,0,32,26
1657811426792,MATH 193A,A01,083224,Rotar; Vladimir,8,0,34,26
1657811426792,MATH 193A,A02,083225,Rotar; Vladimir,9,0,34,25
1657811426792,MATH 193A,A03,083781,Rotar; Vladimir,5,0,34,29
1657811426792,MATH 193A,A04,083782,Rotar; Vladimir,10,0,34,24
1657811426792,MATH 193A,A05,093482,Rotar; Vladimir,10,0,34,24
1657811432814,MATH 197,001,091859,McAuley; Julian John,9999,0,9999,0
1657811432814,MATH 197,002,095566,Kedlaya; Kiran S.,9997,0,9999,2
1657811432814,MATH 197,003,095567,Xiao; Ming,9999,0,9999,0
1657811432814,MATH 197,004,095571,Perols; Johan Lars,9998,0,9999,1
1657811439888,COGS 9,A01,083615,Shannon; Kyle Michael,9,0,75,66
1657811445922,COGS 11,A01,083617,Boyle; Mary E. T.,23,0,48,25
1657811451947,COGS 13,A01,083071,Bastos; Amalia Pinkusfeld,11,0,71,60
1657811457987,COGS 14A,A01,092681,Semenuks; Arturs,5,1,100,95
1657811464016,COGS 14B,A01,083073,Cheng; Tzu-Han,6,0,63,57
1657811470046,COGS 17,A01,092677,Semenuks; Arturs,6,0,81,75
1657811476075,COGS 100,A01,083619,Allen; Michael Gordon,17,0,70,53
1657811482099,COGS 101A,A01,083621,Davis; Joshua Daniel,9,0,68,59
1657811488123,COGS 101B,A01,091572,Allen; Michael Gordon,12,0,65,53
1657811494149,COGS 101C,A01,083625,Delgado; Tania,17,0,35,18
1657811500176,COGS 107A,A01,083627,Boyle; Mary E. T.,14,0,60,46
1657811506203,COGS 118A,A01,083075,Gupta; Anjum,21,0,76,55
1657811512231,CSE 3,A50,083646,Miranda; Gregory Joseph,24,0,50,26
1657811518347,CSE 8A,A50,083650,Miranda; Gregory Joseph,17,1,56,39
1657811524370,CSE 11,A01,083080,Cao; Yingjun,6,15,40,34
1657811530396,CSE 12,A01,083652,Krause-Levy; Sophia Louisa,28,1,120,92
1657811536426,CSE 15L,A01,083654,Morris; Justin Loren,9,0,50,41
1657811536426,CSE 15L,A02,083655,Morris; Justin Loren,9,0,50,41
1657811542448,CSE 20,A01,083657,Tran; Khoa Dang,39,0,80,41
1657811548474,CSE 21,A01,095574,Bach; Quang Tran,22,0,48,26
1657811554498,CSE 30,A01,083084,Eldon; John,6,0,80,74
1657811554498,CSE 30,B01,095061,Bhaskar; Nishant,9,0,50,41
1657811560525,CSE 100,A01,083659,Cao; Yingjun,5,4,70,65
1657811566547,CSE 134B,A01,083661,Powell; Thomas Allan,24,0,100,76
1657811572574,CSE 140,A01,083663,Gungor; Onat,15,0,85,70
1657811578604,CSE 140L,A01,083088,Eldon; John,23,0,100,77
1657811584631,CSE 175,A01,083665,Kumar; Rakesh,3,0,25,22
1657811590655,CSE 190,A00,092507,Dubnov; Shlomo,8,0,20,12
1657811596680,ECE 45,A01,083139,Congero; Spencer William,6,0,75,69
1657811602702,ECE 65,A50,083695,Saad; Andrew S,12,0,30,18
1657811602702,ECE 65,A51,095125,Saad; Andrew S,24,0,26,2
1657811608733,ECE 109,A01,091882,Touri; Behrouz,20,0,70,50
1657811614759,ECE 180,A00,083140,Abi Samra; Nicholas Camill,1,0,30,29
1657811614759,ECE 180,B00,083141,Abi Samra; Nicholas Camill,0,0,30,30
1657811620781,MATH 10A,A01,083735,Patchell; Gregory David,2,0,30,28
1657811620781,MATH 10A,A02,083736,Patchell; Gregory David,20,0,30,10
1657811620781,MATH 10A,A03,083737,Patchell; Gregory David,16,0,30,14
1657811626815,MATH 10B,A01,083207,Lim; Seonhee,8,0,34,26
1657811626815,MATH 10B,A02,083208,Lim; Seonhee,10,0,35,25
1657811626815,MATH 10B,A03,093472,Lim; Seonhee,7,0,34,27
1657811626815,MATH 10B,B01,083739,Sinha; Shubham,13,0,30,17
1657811632839,MATH 18,A01,083743,Cinel; Cameron Alexander,9,0,30,21
1657811632839,MATH 18,A02,083744,Cinel; Cameron Alexander,18,0,30,12
1657811632839,MATH 18,A03,083745,Cinel; Cameron Alexander,10,0,30,20
1657811632839,MATH 18,B01,083748,Rideout; David Porter,5,0,37,32
1657811632839,MATH 18,B02,083749,Rideout; David Porter,5,0,36,31
1657811632839,MATH 18,B03,083750,Rideout; David Porter,3,0,37,34
1657811632839,MATH 18,B04,083751,Rideout; David Porter,6,0,36,30
1657811632839,MATH 18,B05,093473,Rideout; David Porter,6,0,36,30
1657811632839,MATH 18,B06,093474,Rideout; David Porter,6,0,36,30
1657811638872,MATH 20A,A01,083754,Zheng; Zequn,14,0,40,26
1657811644896,MATH 20B,A01,083756,Briones; Jor-el Thomas Caparas,4,0,36,32
1657811644896,MATH 20B,A02,083757,Briones; Jor-el Thomas Caparas,1,0,36,35
1657811644896,MATH 20B,A03,093475,Briones; Jor-el Thomas Caparas,2,0,36,34
1657811650921,MATH 20C,A01,083760,Briones; Jor-el Thomas Caparas,1,0,35,34
1657811650921,MATH 20C,A02,083761,Briones; Jor-el Thomas Caparas,8,0,35,27
1657811650921,MATH 20C,A03,093476,Briones; Jor-el Thomas Caparas,0,1,36,36
1657811650921,MATH 20C,B01,083762,Bach; Quang Tran,1,0,30,29
1657811656949,MATH 20D,A01,083765,Tran; Brian Kha,5,0,30,25
1657811656949,MATH 20D,A02,083766,Tran; Brian Kha,5,0,30,25
1657811656949,MATH 20D,A03,083767,Tran; Brian Kha,5,0,30,25
1657811662977,MATH 20E,A01,083771,Ganguly; Soumya,10,0,32,22
1657811662977,MATH 20E,A02,083772,Ganguly; Soumya,6,0,32,26
1657811662977,MATH 20E,B01,083773,Ciotti; Benjamin,20,0,35,15
1657811662977,MATH 20E,B02,083774,Ciotti; Benjamin,18,0,35,17
1657811669006,MATH 103A,A01,083777,Greenfeld; Be'Eri,3,0,36,33
1657811669006,MATH 103A,A02,083778,Greenfeld; Be'Eri,5,0,36,31
1657811669006,MATH 103A,A03,093561,Greenfeld; Be'Eri,6,0,36,30
1657811669006,MATH 103A,B01,083779,Greenfeld; Be'Eri,7,0,36,29
1657811669006,MATH 103A,B02,083780,Greenfeld; Be'Eri,4,0,36,32
1657811669006,MATH 103A,B03,093562,Greenfeld; Be'Eri,3,0,36,33
1657811675033,MATH 105,A01,085443,Carter; Anne Toulson,15,0,35,20
1657811675033,MATH 105,A02,093477,Carter; Anne Toulson,20,0,35,15
1657811681057,MATH 109,A01,083213,Ganzberger; Geoffrey Michael,3,0,34,31
1657811681057,MATH 109,A02,083214,Ganzberger; Geoffrey Michael,4,0,34,30
1657811681057,MATH 109,A03,093478,Ganzberger; Geoffrey Michael,2,0,34,32
1657811681057,MATH 109,B01,083215,Ganzberger; Geoffrey Michael,1,0,32,31
1657811681057,MATH 109,B02,083216,Ganzberger; Geoffrey Michael,2,0,32,30
1657811681057,MATH 109,B03,093479,Ganzberger; Geoffrey Michael,8,0,32,24
1657811687082,MATH 142A,A01,083219,Chow; Bennett,7,0,32,25
1657811687082,MATH 142A,A02,083220,Chow; Bennett,10,0,32,22
1657811687082,MATH 142A,A03,093480,Chow; Bennett,9,0,32,23
1657811687082,MATH 142A,B03,093481,Chow; Bennett,8,0,32,24
1657811687082,MATH 142A,B04,093558,Chow; Bennett,13,0,32,19
1657811687082,MATH 142A,B05,093559,Chow; Bennett,6,0,32,26
1657811693118,MATH 193A,A01,083224,Rotar; Vladimir,8,0,34,26
1657811693118,MATH 193A,A02,083225,Rotar; Vladimir,9,0,34,25
1657811693118,MATH 193A,A03,083781,Rotar; Vladimir,5,0,34,29
1657811693118,MATH 193A,A04,083782,Rotar; Vladimir,10,0,34,24
1657811693118,MATH 193A,A05,093482,Rotar; Vladimir,10,0,34,24
1657811699140,MATH 197,001,091859,McAuley; Julian John,9999,0,9999,0
1657811699140,MATH 197,002,095566,Kedlaya; Kiran S.,9997,0,9999,2
1657811699140,MATH 197,003,095567,Xiao; Ming,9999,0,9999,0
1657811699140,MATH 197,004,095571,Perols; Johan Lars,9998,0,9999,1
1657811706193,COGS 9,A01,083615,Shannon; Kyle Michael,9,0,75,66
1657811712215,COGS 11,A01,083617,Boyle; Mary E. T.,23,0,48,25
1657811718255,COGS 13,A01,083071,Bastos; Amalia Pinkusfeld,11,0,71,60
1657811724277,COGS 14A,A01,092681,Semenuks; Arturs,5,1,100,95
1657811730303,COGS 14B,A01,083073,Cheng; Tzu-Han,6,0,63,57
1657811736326,COGS 17,A01,092677,Semenuks; Arturs,6,0,81,75
1657811742348,COGS 100,A01,083619,Allen; Michael Gordon,17,0,70,53
1657811748371,COGS 101A,A01,083621,Davis; Joshua Daniel,9,0,68,59
1657811754394,COGS 101B,A01,091572,Allen; Michael Gordon,12,0,65,53
1657811760420,COGS 101C,A01,083625,Delgado; Tania,17,0,35,18
1657811766446,COGS 107A,A01,083627,Boyle; Mary E. T.,14,0,60,46
1657811772473,COGS 118A,A01,083075,Gupta; Anjum,21,0,76,55
1657811778508,CSE 3,A50,083646,Miranda; Gregory Joseph,24,0,50,26
1657811784537,CSE 8A,A50,083650,Miranda; Gregory Joseph,17,1,56,39
1657811790561,CSE 11,A01,083080,Cao; Yingjun,6,15,40,34
1657811796589,CSE 12,A01,083652,Krause-Levy; Sophia Louisa,28,1,120,92
1657811802612,CSE 15L,A01,083654,Morris; Justin Loren,9,0,50,41
1657811802612,CSE 15L,A02,083655,Morris; Justin Loren,9,0,50,41
1657811808639,CSE 20,A01,083657,Tran; Khoa Dang,39,0,80,41
1657811814664,CSE 21,A01,095574,Bach; Quang Tran,22,0,48,26
1657811820696,CSE 30,A01,083084,Eldon; John,6,0,80,74
1657811820696,CSE 30,B01,095061,Bhaskar; Nishant,9,0,50,41
1657811826720,CSE 100,A01,083659,Cao; Yingjun,5,4,70,65
1657811832743,CSE 134B,A01,083661,Powell; Thomas Allan,24,0,100,76
1657811838769,CSE 140,A01,083663,Gungor; Onat,15,0,85,70
1657811844791,CSE 140L,A01,083088,Eldon; John,23,0,100,77
1657811850816,CSE 175,A01,083665,Kumar; Rakesh,3,0,25,22
1657811856844,CSE 190,A00,092507,Dubnov; Shlomo,8,0,20,12
1657811862866,ECE 45,A01,083139,Congero; Spencer William,6,0,75,69
1657811868890,ECE 65,A50,083695,Saad; Andrew S,12,0,30,18
1657811868890,ECE 65,A51,095125,Saad; Andrew S,24,0,26,2
1657811874918,ECE 109,A01,091882,Touri; Behrouz,20,0,70,50
1657811880944,ECE 180,A00,083140,Abi Samra; Nicholas Camill,1,0,30,29
1657811880944,ECE 180,B00,083141,Abi Samra; Nicholas Camill,0,0,30,30
1657811886972,MATH 10A,A01,083735,Patchell; Gregory David,2,0,30,28
1657811886972,MATH 10A,A02,083736,Patchell; Gregory David,20,0,30,10
1657811886972,MATH 10A,A03,083737,Patchell; Gregory David,16,0,30,14
1657811892994,MATH 10B,A01,083207,Lim; Seonhee,8,0,34,26
1657811892994,MATH 10B,A02,083208,Lim; Seonhee,10,0,35,25
1657811892994,MATH 10B,A03,093472,Lim; Seonhee,7,0,34,27
1657811892994,MATH 10B,B01,083739,Sinha; Shubham,13,0,30,17
1657811899025,MATH 18,A01,083743,Cinel; Cameron Alexander,9,0,30,21
1657811899025,MATH 18,A02,083744,Cinel; Cameron Alexander,18,0,30,12
1657811899025,MATH 18,A03,083745,Cinel; Cameron Alexander,10,0,30,20
1657811899025,MATH 18,B01,083748,Rideout; David Porter,5,0,37,32
1657811899025,MATH 18,B02,083749,Rideout; David Porter,5,0,36,31
1657811899025,MATH 18,B03,083750,Rideout; David Porter,3,0,37,34
1657811899025,MATH 18,B04,083751,Rideout; David Porter,6,0,36,30
1657811899025,MATH 18,B05,093473,Rideout; David Porter,6,0,36,30
1657811899025,MATH 18,B06,093474,Rideout; David Porter,6,0,36,30
1657811905052,MATH 20A,A01,083754,Zheng; Zequn,14,0,40,26
1657811911086,MATH 20B,A01,083756,Briones; Jor-el Thomas Caparas,4,0,36,32
1657811911086,MATH 20B,A02,083757,Briones; Jor-el Thomas Caparas,1,0,36,35
1657811911086,MATH 20B,A03,093475,Briones; Jor-el Thomas Caparas,2,0,36,34
1657811917113,MATH 20C,A01,083760,Briones; Jor-el Thomas Caparas,1,0,35,34
1657811917113,MATH 20C,A02,083761,Briones; Jor-el Thomas Caparas,8,0,35,27
1657811917113,MATH 20C,A03,093476,Briones; Jor-el Thomas Caparas,0,1,36,36
1657811917113,MATH 20C,B01,083762,Bach; Quang Tran,1,0,30,29
1657811923139,MATH 20D,A01,083765,Tran; Brian Kha,5,0,30,25
1657811923139,MATH 20D,A02,083766,Tran; Brian Kha,5,0,30,25
1657811923139,MATH 20D,A03,083767,Tran; Brian Kha,5,0,30,25
1657811929176,MATH 20E,A01,083771,Ganguly; Soumya,10,0,32,22
1657811929176,MATH 20E,A02,083772,Ganguly; Soumya,6,0,32,26
1657811929176,MATH 20E,B01,083773,Ciotti; Benjamin,20,0,35,15
1657811929176,MATH 20E,B02,083774,Ciotti; Benjamin,18,0,35,17
1657811935200,MATH 103A,A01,083777,Greenfeld; Be'Eri,3,0,36,33
1657811935200,MATH 103A,A02,083778,Greenfeld; Be'Eri,5,0,36,31
1657811935200,MATH 103A,A03,093561,Greenfeld; Be'Eri,6,0,36,30
1657811935200,MATH 103A,B01,083779,Greenfeld; Be'Eri,7,0,36,29
1657811935200,MATH 103A,B02,083780,Greenfeld; Be'Eri,4,0,36,32
1657811935200,MATH 103A,B03,093562,Greenfeld; Be'Eri,3,0,36,33
1657811941224,MATH 105,A01,085443,Carter; Anne Toulson,15,0,35,20
1657811941224,MATH 105,A02,093477,Carter; Anne Toulson,20,0,35,15
1657811947256,MATH 109,A01,083213,Ganzberger; Geoffrey Michael,3,0,34,31
1657811947256,MATH 109,A02,083214,Ganzberger; Geoffrey Michael,4,0,34,30
1657811947256,MATH 109,A03,093478,Ganzberger; Geoffrey Michael,2,0,34,32
1657811947256,MATH 109,B01,083215,Ganzberger; Geoffrey Michael,1,0,32,31
1657811947256,MATH 109,B02,083216,Ganzberger; Geoffrey Michael,2,0,32,30
1657811947256,MATH 109,B03,093479,Ganzberger; Geoffrey Michael,8,0,32,24
1657811953281,MATH 142A,A01,083219,Chow; Bennett,7,0,32,25
1657811953281,MATH 142A,A02,083220,Chow; Bennett,10,0,32,22
1657811953281,MATH 142A,A03,093480,Chow; Bennett,9,0,32,23
1657811953281,MATH 142A,B03,093481,Chow; Bennett,8,0,32,24
1657811953281,MATH 142A,B04,093558,Chow; Bennett,13,0,32,19
1657811953281,MATH 142A,B05,093559,Chow; Bennett,6,0,32,26
1657811959305,MATH 193A,A01,083224,Rotar; Vladimir,8,0,34,26
1657811959305,MATH 193A,A02,083225,Rotar; Vladimir,9,0,34,25
1657811959305,MATH 193A,A03,083781,Rotar; Vladimir,5,0,34,29
1657811959305,MATH 193A,A04,083782,Rotar; Vladimir,10,0,34,24
1657811959305,MATH 193A,A05,093482,Rotar; Vladimir,10,0,34,24
1657811965329,MATH 197,001,091859,McAuley; Julian John,9999,0,9999,0
1657811965329,MATH 197,002,095566,Kedlaya; Kiran S.,9997,0,9999,2
1657811965329,MATH 197,003,095567,Xiao; Ming,9999,0,9999,0
1657811965329,MATH 197,004,095571,Perols; Johan Lars,9998,0,9999,1
1657811972397,COGS 9,A01,083615,Shannon; Kyle Michael,9,0,75,66
1657811978419,COGS 11,A01,083617,Boyle; Mary E. T.,23,0,48,25
1657811984442,COGS 13,A01,083071,Bastos; Amalia Pinkusfeld,11,0,71,60
1657811990475,COGS 14A,A01,092681,Semenuks; Arturs,5,1,100,95
1657811996499,COGS 14B,A01,083073,Cheng; Tzu-Han,6,0,63,57
1657812002523,COGS 17,A01,092677,Semenuks; Arturs,6,0,81,75
1657812008545,COGS 100,A01,083619,Allen; Michael Gordon,17,0,70,53
1657812014567,COGS 101A,A01,083621,Davis; Joshua Daniel,9,0,68,59
1657812020589,COGS 101B,A01,091572,Allen; Michael Gordon,12,0,65,53
1657812026613,COGS 101C,A01,083625,Delgado; Tania,17,0,35,18
1657812032637,COGS 107A,A01,083627,Boyle; Mary E. T.,14,0,60,46
1657812038659,COGS 118A,A01,083075,Gupta; Anjum,21,0,76,55
1657812044683,CSE 3,A50,083646,Miranda; Gregory Joseph,24,0,50,26
1657812050713,CSE 8A,A50,083650,Miranda; Gregory Joseph,17,1,56,39
1657812056736,CSE 11,A01,083080,Cao; Yingjun,6,15,40,34
1657812062760,CSE 12,A01,083652,Krause-Levy; Sophia Louisa,28,1,120,92
1657812068793,CSE 15L,A01,083654,Morris; Justin Loren,9,0,50,41
1657812068793,CSE 15L,A02,083655,Morris; Justin Loren,9,0,50,41
1657812074817,CSE 20,A01,083657,Tran; Khoa Dang,39,0,80,41
1657812080850,CSE 21,A01,095574,Bach; Quang Tran,22,0,48,26
1657812086874,CSE 30,A01,083084,Eldon; John,6,0,80,74
1657812086874,CSE 30,B01,095061,Bhaskar; Nishant,9,0,50,41
1657812092897,CSE 100,A01,083659,Cao; Yingjun,5,4,70,65
1657812098924,CSE 134B,A01,083661,Powell; Thomas Allan,24,0,100,76
1657812104949,CSE 140,A01,083663,Gungor; Onat,15,0,85,70
1657812111000,CSE 140L,A01,083088,Eldon; John,23,0,100,77
1657812117099,CSE 175,A01,083665,Kumar; Rakesh,3,0,25,22
1657812123126,CSE 190,A00,092507,Dubnov; Shlomo,8,0,20,12
1657812129153,ECE 45,A01,083139,Congero; Spencer William,6,0,75,69
1657812135176,ECE 65,A50,083695,Saad; Andrew S,12,0,30,18
1657812135176,ECE 65,A51,095125,Saad; Andrew S,24,0,26,2
1657812141200,ECE 109,A01,091882,Touri; Behrouz,20,0,70,50
1657812147227,ECE 180,A00,083140,Abi Samra; Nicholas Camill,1,0,30,29
1657812147227,ECE 180,B00,083141,Abi Samra; Nicholas Camill,0,0,30,30
1657812153255,MATH 10A,A01,083735,Patchell; Gregory David,2,0,30,28
1657812153255,MATH 10A,A02,083736,Patchell; Gregory David,20,0,30,10
1657812153255,MATH 10A,A03,083737,Patchell; Gregory David,16,0,30,14
1657812159289,MATH 10B,A01,083207,Lim; Seonhee,8,0,34,26
1657812159289,MATH 10B,A02,083208,Lim; Seonhee,10,0,35,25
1657812159289,MATH 10B,A03,093472,Lim; Seonhee,7,0,34,27
1657812159289,MATH 10B,B01,083739,Sinha; Shubham,13,0,30,17
1657812165314,MATH 18,A01,083743,Cinel; Cameron Alexander,9,0,30,21
1657812165314,MATH 18,A02,083744,Cinel; Cameron Alexander,18,0,30,12
1657812165314,MATH 18,A03,083745,Cinel; Cameron Alexander,10,0,30,20
1657812165314,MATH 18,B01,083748,Rideout; David Porter,5,0,37,32
1657812165314,MATH 18,B02,083749,Rideout; David Porter,5,0,36,31
1657812165314,MATH 18,B03,083750,Rideout; David Porter,3,0,37,34
1657812165314,MATH 18,B04,083751,Rideout; David Porter,6,0,36,30
1657812165314,MATH 18,B05,093473,Rideout; David Porter,6,0,36,30
1657812165314,MATH 18,B06,093474,Rideout; David Porter,6,0,36,30
1657812171337,MATH 20A,A01,083754,Zheng; Zequn,14,0,40,26
1657812177361,MATH 20B,A01,083756,Briones; Jor-el Thomas Caparas,4,0,36,32
1657812177361,MATH 20B,A02,083757,Briones; Jor-el Thomas Caparas,1,0,36,35
1657812177361,MATH 20B,A03,093475,Briones; Jor-el Thomas Caparas,2,0,36,34
1657812183389,MATH 20C,A01,083760,Briones; Jor-el Thomas Caparas,1,0,35,34
1657812183389,MATH 20C,A02,083761,Briones; Jor-el Thomas Caparas,8,0,35,27
1657812183389,MATH 20C,A03,093476,Briones; Jor-el Thomas Caparas,0,1,36,36
1657812183389,MATH 20C,B01,083762,Bach; Quang Tran,1,0,30,29
1657812189416,MATH 20D,A01,083765,Tran; Brian Kha,5,0,30,25
1657812189416,MATH 20D,A02,083766,Tran; Brian Kha,5,0,30,25
1657812189416,MATH 20D,A03,083767,Tran; Brian Kha,5,0,30,25
1657812195444,MATH 20E,A01,083771,Ganguly; Soumya,10,0,32,22
1657812195444,MATH 20E,A02,083772,Ganguly; Soumya,6,0,32,26
1657812195444,MATH 20E,B01,083773,Ciotti; Benjamin,20,0,35,15
1657812195444,MATH 20E,B02,083774,Ciotti; Benjamin,18,0,35,17
1657812201471,MATH 103A,A01,083777,Greenfeld; Be'Eri,3,0,36,33
1657812201471,MATH 103A,A02,083778,Greenfeld; Be'Eri,5,0,36,31
1657812201471,MATH 103A,A03,093561,Greenfeld; Be'Eri,6,0,36,30
1657812201471,MATH 103A,B01,083779,Greenfeld; Be'Eri,7,0,36,29
1657812201471,MATH 103A,B02,083780,Greenfeld; Be'Eri,4,0,36,32
1657812201471,MATH 103A,B03,093562,Greenfeld; Be'Eri,3,0,36,33
1657812207497,MATH 105,A01,085443,Carter; Anne Toulson,15,0,35,20
1657812207497,MATH 105,A02,093477,Carter; Anne Toulson,20,0,35,15
1657812213522,MATH 109,A01,083213,Ganzberger; Geoffrey Michael,3,0,34,31
1657812213522,MATH 109,A02,083214,Ganzberger; Geoffrey Michael,4,0,34,30
1657812213522,MATH 109,A03,093478,Ganzberger; Geoffrey Michael,2,0,34,32
1657812213522,MATH 109,B01,083215,Ganzberger; Geoffrey Michael,1,0,32,31
1657812213522,MATH 109,B02,083216,Ganzberger; Geoffrey Michael,2,0,32,30
1657812213522,MATH 109,B03,093479,Ganzberger; Geoffrey Michael,8,0,32,24
1657812219547,MATH 142A,A01,083219,Chow; Bennett,7,0,32,25
1657812219547,MATH 142A,A02,083220,Chow; Bennett,10,0,32,22
1657812219547,MATH 142A,A03,093480,Chow; Bennett,9,0,32,23
1657812219547,MATH 142A,B03,093481,Chow; Bennett,8,0,32,24
1657812219547,MATH 142A,B04,093558,Chow; Bennett,13,0,32,19
1657812219547,MATH 142A,B05,093559,Chow; Bennett,6,0,32,26
1657812225578,MATH 193A,A01,083224,Rotar; Vladimir,8,0,34,26
1657812225578,MATH 193A,A02,083225,Rotar; Vladimir,9,0,34,25
1657812225578,MATH 193A,A03,083781,Rotar; Vladimir,5,0,34,29
1657812225578,MATH 193A,A04,083782,Rotar; Vladimir,10,0,34,24
1657812225578,MATH 193A,A05,093482,Rotar; Vladimir,10,0,34,24
1657812231604,MATH 197,001,091859,McAuley; Julian John,9999,0,9999,0
1657812231604,MATH 197,002,095566,Kedlaya; Kiran S.,9997,0,9999,2
1657812231604,MATH 197,003,095567,Xiao; Ming,9999,0,9999,0
1657812231604,MATH 197,004,095571,Perols; Johan Lars,9998,0,9999,1
1657812238660,COGS 9,A01,083615,Shannon; Kyle Michael,9,0,75,66
1657812244690,COGS 11,A01,083617,Boyle; Mary E. T.,23,0,48,25
1657812250718,COGS 13,A01,083071,Bastos; Amalia Pinkusfeld,11,0,71,60
1657812256751,COGS 14A,A01,092681,Semenuks; Arturs,5,1,100,95
1657812262774,COGS 14B,A01,083073,Cheng; Tzu-Han,6,0,63,57
1657812268798,COGS 17,A01,092677,Semenuks; Arturs,6,0,81,75
1657812274830,COGS 100,A01,083619,Allen; Michael Gordon,17,0,70,53
1657812280863,COGS 101A,A01,083621,Davis; Joshua Daniel,9,0,68,59
1657812286888,COGS 101B,A01,091572,Allen; Michael Gordon,12,0,65,53
1657812292914,COGS 101C,A01,083625,Delgado; Tania,17,0,35,18
1657812298944,COGS 107A,A01,083627,Boyle; Mary E. T.,14,0,60,46
1657812304967,COGS 118A,A01,083075,Gupta; Anjum,21,0,76,55
1657812311003,CSE 3,A50,083646,Miranda; Gregory Joseph,24,0,50,26
1657812317029,CSE 8A,A50,083650,Miranda; Gregory Joseph,17,1,56,39
1657812323056,CSE 11,A01,083080,Cao; Yingjun,6,15,40,34
1657812329079,CSE 12,A01,083652,Krause-Levy; Sophia Louisa,28,1,120,92
1657812335105,CSE 15L,A01,083654,Morris; Justin Loren,9,0,50,41
1657812335105,CSE 15L,A02,083655,Morris; Justin Loren,9,0,50,41
1657812341138,CSE 20,A01,083657,Tran; Khoa Dang,39,0,80,41
1657812347164,CSE 21,A01,095574,Bach; Quang Tran,22,0,48,26
1657812353188,CSE 30,A01,083084,Eldon; John,6,0,80,74
1657812353188,CSE 30,B01,095061,Bhaskar; Nishant,9,0,50,41
1657812359212,CSE 100,A01,083659,Cao; Yingjun,5,4,70,65
1657812365237,CSE 134B,A01,083661,Powell; Thomas Allan,24,0,100,76
1657812371264,CSE 140,A01,083663,Gungor; Onat,15,0,85,70
1657812377286,CSE 140L,A01,083088,Eldon; John,23,0,100,77
1657812383314,CSE 175,A01,083665,Kumar; Rakesh,3,0,25,22
1657812389342,CSE 190,A00,092507,Dubnov; Shlomo,8,0,20,12
1657812395368,ECE 45,A01,083139,Congero; Spencer William,6,0,75,69
1657812401396,ECE 65,A50,083695,Saad; Andrew S,12,0,30,18
1657812401396,ECE 65,A51,095125,Saad; Andrew S,24,0,26,2
1657812407432,ECE 109,A01,091882,Touri; Behrouz,20,0,70,50
1657812413457,ECE 180,A00,083140,Abi Samra; Nicholas Camill,1,0,30,29
1657812413457,ECE 180,B00,083141,Abi Samra; Nicholas Camill,0,0,30,30
1657812419481,MATH 10A,A01,083735,Patchell; Gregory David,2,0,30,28
1657812419481,MATH 10A,A02,083736,Patchell; Gregory David,20,0,30,10
1657812419481,MATH 10A,A03,083737,Patchell; Gregory David,16,0,30,14
1657812425510,MATH 10B,A01,083207,Lim; Seonhee,8,0,34,26
1657812425510,MATH 10B,A02,083208,Lim; Seonhee,10,0,35,25
1657812425510,MATH 10B,A03,093472,Lim; Seonhee,7,0,34,27
1657812425510,MATH 10B,B01,083739,Sinha; Shubham,13,0,30,17
1657812431544,MATH 18,A01,083743,Cinel; Cameron Alexander,9,0,30,21
1657812431544,MATH 18,A02,083744,Cinel; Cameron Alexander,18,0,30,12
1657812431544,MATH 18,A03,083745,Cinel; Cameron Alexander,10,0,30,20
1657812431544,MATH 18,B01,083748,Rideout; David Porter,5,0,37,32
1657812431544,MATH 18,B02,083749,Rideout; David Porter,5,0,36,31
1657812431544,MATH 18,B03,083750,Rideout; David Porter,3,0,37,34
1657812431544,MATH 18,B04,083751,Rideout; David Porter,6,0,36,30
1657812431544,MATH 18,B05,093473,Rideout; David Porter,6,0,36,30
1657812431544,MATH 18,B06,093474,Rideout; David Porter,6,0,36,30
1657812437571,MATH 20A,A01,083754,Zheng; Zequn,14,0,40,26
1657812443594,MATH 20B,A01,083756,Briones; Jor-el Thomas Caparas,4,0,36,32
1657812443594,MATH 20B,A02,083757,Briones; Jor-el Thomas Caparas,1,0,36,35
1657812443594,MATH 20B,A03,093475,Briones; Jor-el Thomas Caparas,2,0,36,34
1657812449624,MATH 20C,A01,083760,Briones; Jor-el Thomas Caparas,1,0,35,34
1657812449624,MATH 20C,A02,083761,Briones; Jor-el Thomas Caparas,8,0,35,27
1657812449624,MATH 20C,A03,093476,Briones; Jor-el Thomas Caparas,0,1,36,36
1657812449624,MATH 20C,B01,083762,Bach; Quang Tran,1,0,30,29
1657812455649,MATH 20D,A01,083765,Tran; Brian Kha,5,0,30,25
1657812455649,MATH 20D,A02,083766,Tran; Brian Kha,5,0,30,25
1657812455649,MATH 20D,A03,083767,Tran; Brian Kha,5,0,30,25
1657812461674,MATH 20E,A01,083771,Ganguly; Soumya,10,0,32,22
1657812461674,MATH 20E,A02,083772,Ganguly; Soumya,6,0,32,26
1657812461674,MATH 20E,B01,083773,Ciotti; Benjamin,20,0,35,15
1657812461674,MATH 20E,B02,083774,Ciotti; Benjamin,18,0,35,17
1657812467703,MATH 103A,A01,083777,Greenfeld; Be'Eri,3,0,36,33
1657812467703,MATH 103A,A02,083778,Greenfeld; Be'Eri,5,0,36,31
1657812467703,MATH 103A,A03,093561,Greenfeld; Be'Eri,6,0,36,30
1657812467703,MATH 103A,B01,083779,Greenfeld; Be'Eri,7,0,36,29
1657812467703,MATH 103A,B02,083780,Greenfeld; Be'Eri,4,0,36,32
1657812467703,MATH 103A,B03,093562,Greenfeld; Be'Eri,3,0,36,33
1657812473726,MATH 105,A01,085443,Carter; Anne Toulson,15,0,35,20
1657812473726,MATH 105,A02,093477,Carter; Anne Toulson,20,0,35,15
1657812479759,MATH 109,A01,083213,Ganzberger; Geoffrey Michael,3,0,34,31
1657812479759,MATH 109,A02,083214,Ganzberger; Geoffrey Michael,4,0,34,30
1657812479759,MATH 109,A03,093478,Ganzberger; Geoffrey Michael,2,0,34,32
1657812479759,MATH 109,B01,083215,Ganzberger; Geoffrey Michael,1,0,32,31
1657812479759,MATH 109,B02,083216,Ganzberger; Geoffrey Michael,2,0,32,30
1657812479759,MATH 109,B03,093479,Ganzberger; Geoffrey Michael,8,0,32,24
1657812485797,MATH 142A,A01,083219,Chow; Bennett,7,0,32,25
1657812485797,MATH 142A,A02,083220,Chow; Bennett,10,0,32,22
1657812485797,MATH 142A,A03,093480,Chow; Bennett,9,0,32,23
1657812485797,MATH 142A,B03,093481,Chow; Bennett,8,0,32,24
1657812485797,MATH 142A,B04,093558,Chow; Bennett,13,0,32,19
1657812485797,MATH 142A,B05,093559,Chow; Bennett,6,0,32,26
1657812491821,MATH 193A,A01,083224,Rotar; Vladimir,8,0,34,26
1657812491821,MATH 193A,A02,083225,Rotar; Vladimir,9,0,34,25
1657812491821,MATH 193A,A03,083781,Rotar; Vladimir,5,0,34,29
1657812491821,MATH 193A,A04,083782,Rotar; Vladimir,10,0,34,24
1657812491821,MATH 193A,A05,093482,Rotar; Vladimir,10,0,34,24
1657812497847,MATH 197,001,091859,McAuley; Julian John,9999,0,9999,0
1657812497847,MATH 197,002,095566,Kedlaya; Kiran S.,9997,0,9999,2
1657812497847,MATH 197,003,095567,Xiao; Ming,9999,0,9999,0
1657812497847,MATH 197,004,095571,Perols; Johan Lars,9998,0,9999,1
1657812504919,COGS 9,A01,083615,Shannon; Kyle Michael,9,0,75,66
1657812510946,COGS 11,A01,083617,Boyle; Mary E. T.,23,0,48,25
1657812516987,COGS 13,A01,083071,Bastos; Amalia Pinkusfeld,11,0,71,60
1657812523009,COGS 14A,A01,092681,Semenuks; Arturs,5,1,100,95
1657812529032,COGS 14B,A01,083073,Cheng; Tzu-Han,6,0,63,57
1657812535059,COGS 17,A01,092677,Semenuks; Arturs,6,0,81,75
1657812541081,COGS 100,A01,083619,Allen; Michael Gordon,17,0,70,53
1657812547107,COGS 101A,A01,083621,Davis; Joshua Daniel,9,0,68,59
1657812553146,COGS 101B,A01,091572,Allen; Michael Gordon,12,0,65,53
1657812559167,COGS 101C,A01,083625,Delgado; Tania,17,0,35,18
1657812565191,COGS 107A,A01,083627,Boyle; Mary E. T.,14,0,60,46
1657812571214,COGS 118A,A01,083075,Gupta; Anjum,21,0,76,55
1657812577241,CSE 3,A50,083646,Miranda; Gregory Joseph,24,0,50,26
1657812583276,CSE 8A,A50,083650,Miranda; Gregory Joseph,17,1,56,39
1657812589300,CSE 11,A01,083080,Cao; Yingjun,6,15,40,34
1657812595332,CSE 12,A01,083652,Krause-Levy; Sophia Louisa,28,1,120,92
1657812601354,CSE 15L,A01,083654,Morris; Justin Loren,9,0,50,41
1657812601354,CSE 15L,A02,083655,Morris; Justin Loren,9,0,50,41
1657812607378,CSE 20,A01,083657,Tran; Khoa Dang,39,0,80,41
1657812613404,CSE 21,A01,095574,Bach; Quang Tran,22,0,48,26
1657812619431,CSE 30,A01,083084,Eldon; John,6,0,80,74
1657812619431,CSE 30,B01,095061,Bhaskar; Nishant,9,0,50,41
1657812625461,CSE 100,A01,083659,Cao; Yingjun,5,4,70,65
1657812631486,CSE 134B,A01,083661,Powell; Thomas Allan,24,0,100,76
1657812637515,CSE 140,A01,083663,Gungor; Onat,15,0,85,70
1657812643542,CSE 140L,A01,083088,Eldon; John,23,0,100,77
1657812649571,CSE 175,A01,083665,Kumar; Rakesh,3,0,25,22
1657812655599,CSE 190,A00,092507,Dubnov; Shlomo,8,0,20,12
1657812661623,ECE 45,A01,083139,Congero; Spencer William,6,0,75,69
1657812667656,ECE 65,A50,083695,Saad; Andrew S,12,0,30,18
1657812667656,ECE 65,A51,095125,Saad; Andrew S,24,0,26,2
1657812673681,ECE 109,A01,091882,Touri; Behrouz,20,0,70,50
1657812679706,ECE 180,A00,083140,Abi Samra; Nicholas Camill,1,0,30,29
1657812679706,ECE 180,B00,083141,Abi Samra; Nicholas Camill,0,0,30,30
1657812685736,MATH 10A,A01,083735,Patchell; Gregory David,2,0,30,28
1657812685736,MATH 10A,A02,083736,Patchell; Gregory David,20,0,30,10
1657812685736,MATH 10A,A03,083737,Patchell; Gregory David,16,0,30,14
1657812691772,MATH 10B,A01,083207,Lim; Seonhee,8,0,34,26
1657812691772,MATH 10B,A02,083208,Lim; Seonhee,10,0,35,25
1657812691772,MATH 10B,A03,093472,Lim; Seonhee,7,0,34,27
1657812691772,MATH 10B,B01,083739,Sinha; Shubham,13,0,30,17
1657812697808,MATH 18,A01,083743,Cinel; Cameron Alexander,9,0,30,21
1657812697808,MATH 18,A02,083744,Cinel; Cameron Alexander,18,0,30,12
1657812697808,MATH 18,A03,083745,Cinel; Cameron Alexander,10,0,30,20
1657812697808,MATH 18,B01,083748,Rideout; David Porter,5,0,37,32
1657812697808,MATH 18,B02,083749,Rideout; David Porter,5,0,36,31
1657812697808,MATH 18,B03,083750,Rideout; David Porter,3,0,37,34
1657812697808,MATH 18,B04,083751,Rideout; David Porter,6,0,36,30
1657812697808,MATH 18,B05,093473,Rideout; David Porter,6,0,36,30
1657812697808,MATH 18,B06,093474,Rideout; David Porter,6,0,36,30
1657812703830,MATH 20A,A01,083754,Zheng; Zequn,14,0,40,26
1657812709854,MATH 20B,A01,083756,Briones; Jor-el Thomas Caparas,4,0,36,32
1657812709854,MATH 20B,A02,083757,Briones; Jor-el Thomas Caparas,1,0,36,35
1657812709854,MATH 20B,A03,093475,Briones; Jor-el Thomas Caparas,2,0,36,34
1657812715951,MATH 20C,A01,083760,Briones; Jor-el Thomas Caparas,1,0,35,34
1657812715951,MATH 20C,A02,083761,Briones; Jor-el Thomas Caparas,8,0,35,27
1657812715951,MATH 20C,A03,093476,Briones; Jor-el Thomas Caparas,0,1,36,36
1657812715951,MATH 20C,B01,083762,Bach; Quang Tran,1,0,30,29
1657812721975,MATH 20D,A01,083765,Tran; Brian Kha,5,0,30,25
1657812721975,MATH 20D,A02,083766,Tran; Brian Kha,5,0,30,25
1657812721975,MATH 20D,A03,083767,Tran; Brian Kha,5,0,30,25
1657812728053,MATH 20E,A01,083771,Ganguly; Soumya,10,0,32,22
1657812728053,MATH 20E,A02,083772,Ganguly; Soumya,6,0,32,26
1657812728053,MATH 20E,B01,083773,Ciotti; Benjamin,20,0,35,15
1657812728053,MATH 20E,B02,083774,Ciotti; Benjamin,18,0,35,17
1657812734082,MATH 103A,A01,083777,Greenfeld; Be'Eri,3,0,36,33
1657812734082,MATH 103A,A02,083778,Greenfeld; Be'Eri,5,0,36,31
1657812734082,MATH 103A,A03,093561,Greenfeld; Be'Eri,6,0,36,30
1657812734082,MATH 103A,B01,083779,Greenfeld; Be'Eri,7,0,36,29
1657812734082,MATH 103A,B02,083780,Greenfeld; Be'Eri,4,0,36,32
1657812734082,MATH 103A,B03,093562,Greenfeld; Be'Eri,3,0,36,33
1657812740110,MATH 105,A01,085443,Carter; Anne Toulson,15,0,35,20
1657812740110,MATH 105,A02,093477,Carter; Anne Toulson,20,0,35,15
1657812746139,MATH 109,A01,083213,Ganzberger; Geoffrey Michael,3,0,34,31
1657812746139,MATH 109,A02,083214,Ganzberger; Geoffrey Michael,4,0,34,30
1657812746139,MATH 109,A03,093478,Ganzberger; Geoffrey Michael,2,0,34,32
1657812746139,MATH 109,B01,083215,Ganzberger; Geoffrey Michael,1,0,32,31
1657812746139,MATH 109,B02,083216,Ganzberger; Geoffrey Michael,2,0,32,30
1657812746139,MATH 109,B03,093479,Ganzberger; Geoffrey Michael,8,0,32,24
1657812752165,MATH 142A,A01,083219,Chow; Bennett,7,0,32,25
1657812752165,MATH 142A,A02,083220,Chow; Bennett,10,0,32,22
1657812752165,MATH 142A,A03,093480,Chow; Bennett,9,0,32,23
1657812752165,MATH 142A,B03,093481,Chow; Bennett,8,0,32,24
1657812752165,MATH 142A,B04,093558,Chow; Bennett,13,0,32,19
1657812752165,MATH 142A,B05,093559,Chow; Bennett,6,0,32,26
1657812758199,MATH 193A,A01,083224,Rotar; Vladimir,8,0,34,26
1657812758199,MATH 193A,A02,083225,Rotar; Vladimir,9,0,34,25
1657812758199,MATH 193A,A03,083781,Rotar; Vladimir,5,0,34,29
1657812758199,MATH 193A,A04,083782,Rotar; Vladimir,10,0,34,24
1657812758199,MATH 193A,A05,093482,Rotar; Vladimir,10,0,34,24
1657812764226,MATH 197,001,091859,McAuley; Julian John,9999,0,9999,0
1657812764226,MATH 197,002,095566,Kedlaya; Kiran S.,9997,0,9999,2
1657812764226,MATH 197,003,095567,Xiao; Ming,9999,0,9999,0
1657812764226,MATH 197,004,095571,Perols; Johan Lars,9998,0,9999,1
1657812771304,COGS 9,A01,083615,Shannon; Kyle Michael,9,0,75,66
1657812777325,COGS 11,A01,083617,Boyle; Mary E. T.,23,0,48,25
1657812783358,COGS 13,A01,083071,Bastos; Amalia Pinkusfeld,11,0,71,60
1657812789381,COGS 14A,A01,092681,Semenuks; Arturs,5,1,100,95
1657812795405,COGS 14B,A01,083073,Cheng; Tzu-Han,6,0,63,57
1657812801428,COGS 17,A01,092677,Semenuks; Arturs,6,0,81,75
1657812807458,COGS 100,A01,083619,Allen; Michael Gordon,17,0,70,53
1657812813489,COGS 101A,A01,083621,Davis; Joshua Daniel,9,0,68,59
1657812819516,COGS 101B,A01,091572,Allen; Michael Gordon,12,0,65,53
1657812825539,COGS 101C,A01,083625,Delgado; Tania,17,0,35,18
1657812831567,COGS 107A,A01,083627,Boyle; Mary E. T.,14,0,60,46
1657812837595,COGS 118A,A01,083075,Gupta; Anjum,21,0,76,55
1657812843618,CSE 3,A50,083646,Miranda; Gregory Joseph,24,0,50,26
1657812849645,CSE 8A,A50,083650,Miranda; Gregory Joseph,17,1,56,39
1657812855668,CSE 11,A01,083080,Cao; Yingjun,6,15,40,34
1657812861698,CSE 12,A01,083652,Krause-Levy; Sophia Louisa,28,1,120,92
1657812867722,CSE 15L,A01,083654,Morris; Justin Loren,9,0,50,41
1657812867722,CSE 15L,A02,083655,Morris; Justin Loren,9,0,50,41
1657812873745,CSE 20,A01,083657,Tran; Khoa Dang,39,0,80,41
1657812879770,CSE 21,A01,095574,Bach; Quang Tran,22,0,48,26
1657812885802,CSE 30,A01,083084,Eldon; John,6,0,80,74
1657812885802,CSE 30,B01,095061,Bhaskar; Nishant,9,0,50,41
1657812891830,CSE 100,A01,083659,Cao; Yingjun,5,4,70,65
1657812897854,CSE 134B,A01,083661,Powell; Thomas Allan,24,0,100,76
1657812903877,CSE 140,A01,083663,Gungor; Onat,15,0,85,70
1657812909899,CSE 140L,A01,083088,Eldon; John,23,0,100,77
1657812915921,CSE 175,A01,083665,Kumar; Rakesh,3,0,25,22
1657812921943,CSE 190,A00,092507,Dubnov; Shlomo,8,0,20,12
1657812927966,ECE 45,A01,083139,Congero; Spencer William,6,0,75,69
1657812933990,ECE 65,A50,083695,Saad; Andrew S,12,0,30,18
1657812933990,ECE 65,A51,095125,Saad; Andrew S,24,0,26,2
1657812940012,ECE 109,A01,091882,Touri; Behrouz,20,0,70,50
1657812946034,ECE 180,A00,083140,Abi Samra; Nicholas Camill,1,0,30,29
1657812946034,ECE 180,B00,083141,Abi Samra; Nicholas Camill,0,0,30,30
1657812952056,MATH 10A,A01,083735,Patchell; Gregory David,2,0,30,28
1657812952056,MATH 10A,A02,083736,Patchell; Gregory David,20,0,30,10
1657812952056,MATH 10A,A03,083737,Patchell; Gregory David,16,0,30,14
1657812958079,MATH 10B,A01,083207,Lim; Seonhee,8,0,34,26
1657812958079,MATH 10B,A02,083208,Lim; Seonhee,10,0,35,25
1657812958079,MATH 10B,A03,093472,Lim; Seonhee,7,0,34,27
1657812958079,MATH 10B,B01,083739,Sinha; Shubham,13,0,30,17
1657812964106,MATH 18,A01,083743,Cinel; Cameron Alexander,9,0,30,21
1657812964106,MATH 18,A02,083744,Cinel; Cameron Alexander,18,0,30,12
1657812964106,MATH 18,A03,083745,Cinel; Cameron Alexander,10,0,30,20
1657812964106,MATH 18,B01,083748,Rideout; David Porter,5,0,37,32
1657812964106,MATH 18,B02,083749,Rideout; David Porter,5,0,36,31
1657812964106,MATH 18,B03,083750,Rideout; David Porter,3,0,37,34
1657812964106,MATH 18,B04,083751,Rideout; David Porter,6,0,36,30
1657812964106,MATH 18,B05,093473,Rideout; David Porter,6,0,36,30
1657812964106,MATH 18,B06,093474,Rideout; David Porter,6,0,36,30
1657812970130,MATH 20A,A01,083754,Zheng; Zequn,14,0,40,26
1657812976153,MATH 20B,A01,083756,Briones; Jor-el Thomas Caparas,4,0,36,32
1657812976153,MATH 20B,A02,083757,Briones; Jor-el Thomas Caparas,1,0,36,35
1657812976153,MATH 20B,A03,093475,Briones; Jor-el Thomas Caparas,2,0,36,34
1657812982185,MATH 20C,A01,083760,Briones; Jor-el Thomas Caparas,1,0,35,34
1657812982185,MATH 20C,A02,083761,Briones; Jor-el Thomas Caparas,8,0,35,27
1657812982185,MATH 20C,A03,093476,Briones; Jor-el Thomas Caparas,0,1,36,36
1657812982185,MATH 20C,B01,083762,Bach; Quang Tran,1,0,30,29
1657812988212,MATH 20D,A01,083765,Tran; Brian Kha,5,0,30,25
1657812988212,MATH 20D,A02,083766,Tran; Brian Kha,5,0,30,25
1657812988212,MATH 20D,A03,083767,Tran; Brian Kha,5,0,30,25
1657812994237,MATH 20E,A01,083771,Ganguly; Soumya,10,0,32,22
1657812994237,MATH 20E,A02,083772,Ganguly; Soumya,6,0,32,26
1657812994237,MATH 20E,B01,083773,Ciotti; Benjamin,20,0,35,15
1657812994237,MATH 20E,B02,083774,Ciotti; Benjamin,18,0,35,17
1657813000261,MATH 103A,A01,083777,Greenfeld; Be'Eri,3,0,36,33
1657813000261,MATH 103A,A02,083778,Greenfeld; Be'Eri,5,0,36,31
1657813000261,MATH 103A,A03,093561,Greenfeld; Be'Eri,6,0,36,30
1657813000261,MATH 103A,B01,083779,Greenfeld; Be'Eri,7,0,36,29
1657813000261,MATH 103A,B02,083780,Greenfeld; Be'Eri,4,0,36,32
1657813000261,MATH 103A,B03,093562,Greenfeld; Be'Eri,3,0,36,33
1657813006286,MATH 105,A01,085443,Carter; Anne Toulson,15,0,35,20
1657813006286,MATH 105,A02,093477,Carter; Anne Toulson,20,0,35,15
1657813012311,MATH 109,A01,083213,Ganzberger; Geoffrey Michael,3,0,34,31
1657813012311,MATH 109,A02,083214,Ganzberger; Geoffrey Michael,4,0,34,30
1657813012311,MATH 109,A03,093478,Ganzberger; Geoffrey Michael,2,0,34,32
1657813012311,MATH 109,B01,083215,Ganzberger; Geoffrey Michael,1,0,32,31
1657813012311,MATH 109,B02,083216,Ganzberger; Geoffrey Michael,2,0,32,30
1657813012311,MATH 109,B03,093479,Ganzberger; Geoffrey Michael,8,0,32,24
1657813018334,MATH 142A,A01,083219,Chow; Bennett,7,0,32,25
1657813018334,MATH 142A,A02,083220,Chow; Bennett,10,0,32,22
1657813018334,MATH 142A,A03,093480,Chow; Bennett,9,0,32,23
1657813018334,MATH 142A,B03,093481,Chow; Bennett,8,0,32,24
1657813018334,MATH 142A,B04,093558,Chow; Bennett,13,0,32,19
1657813018334,MATH 142A,B05,093559,Chow; Bennett,6,0,32,26
1657813024358,MATH 193A,A01,083224,Rotar; Vladimir,8,0,34,26
1657813024358,MATH 193A,A02,083225,Rotar; Vladimir,9,0,34,25
1657813024358,MATH 193A,A03,083781,Rotar; Vladimir,5,0,34,29
1657813024358,MATH 193A,A04,083782,Rotar; Vladimir,10,0,34,24
1657813024358,MATH 193A,A05,093482,Rotar; Vladimir,10,0,34,24
1657813030383,MATH 197,001,091859,McAuley; Julian John,9999,0,9999,0
1657813030383,MATH 197,002,095566,Kedlaya; Kiran S.,9997,0,9999,2
1657813030383,MATH 197,003,095567,Xiao; Ming,9999,0,9999,0
1657813030383,MATH 197,004,095571,Perols; Johan Lars,9998,0,9999,1
1657813037445,COGS 9,A01,083615,Shannon; Kyle Michael,9,0,75,66
1657813043486,COGS 11,A01,083617,Boyle; Mary E. T.,23,0,48,25
1657813049509,COGS 13,A01,083071,Bastos; Amalia Pinkusfeld,11,0,71,60
1657813055538,COGS 14A,A01,092681,Semenuks; Arturs,5,1,100,95
1657813061567,COGS 14B,A01,083073,Cheng; Tzu-Han,6,0,63,57
1657813067593,COGS 17,A01,092677,Semenuks; Arturs,6,0,81,75
1657813073619,COGS 100,A01,083619,Allen; Michael Gordon,17,0,70,53
1657813079644,COGS 101A,A01,083621,Davis; Joshua Daniel,9,0,68,59
1657813085670,COGS 101B,A01,091572,Allen; Michael Gordon,12,0,65,53
1657813091692,COGS 101C,A01,083625,Delgado; Tania,17,0,35,18
1657813097722,COGS 107A,A01,083627,Boyle; Mary E. T.,14,0,60,46
1657813103757,COGS 118A,A01,083075,Gupta; Anjum,21,0,76,55
1657813109783,CSE 3,A50,083646,Miranda; Gregory Joseph,24,0,50,26
1657813115818,CSE 8A,A50,083650,Miranda; Gregory Joseph,17,1,56,39
1657813121841,CSE 11,A01,083080,Cao; Yingjun,6,15,40,34
1657813127864,CSE 12,A01,083652,Krause-Levy; Sophia Louisa,28,1,120,92
1657813133891,CSE 15L,A01,083654,Morris; Justin Loren,9,0,50,41
1657813133891,CSE 15L,A02,083655,Morris; Justin Loren,9,0,50,41
1657813139916,CSE 20,A01,083657,Tran; Khoa Dang,39,0,80,41
1657813145945,CSE 21,A01,095574,Bach; Quang Tran,22,0,48,26
1657813151967,CSE 30,A01,083084,Eldon; John,6,0,80,74
1657813151967,CSE 30,B01,095061,Bhaskar; Nishant,9,0,50,41
1657813157992,CSE 100,A01,083659,Cao; Yingjun,5,4,70,65
1657813164015,CSE 134B,A01,083661,Powell; Thomas Allan,24,0,100,76
1657813170038,CSE 140,A01,083663,Gungor; Onat,15,0,85,70
1657813176065,CSE 140L,A01,083088,Eldon; John,23,0,100,77
1657813182088,CSE 175,A01,083665,Kumar; Rakesh,3,0,25,22
1657813188112,CSE 190,A00,092507,Dubnov; Shlomo,8,0,20,12
1657813194146,ECE 45,A01,083139,Congero; Spencer William,6,0,75,69
1657813200170,ECE 65,A50,083695,Saad; Andrew S,12,0,30,18
1657813200170,ECE 65,A51,095125,Saad; Andrew S,24,0,26,2
1657813206193,ECE 109,A01,091882,Touri; Behrouz,20,0,70,50
1657813212222,ECE 180,A00,083140,Abi Samra; Nicholas Camill,1,0,30,29
1657813212222,ECE 180,B00,083141,Abi Samra; Nicholas Camill,0,0,30,30
1657813218255,MATH 10A,A01,083735,Patchell; Gregory David,2,0,30,28
1657813218255,MATH 10A,A02,083736,Patchell; Gregory David,20,0,30,10
1657813218255,MATH 10A,A03,083737,Patchell; Gregory David,16,0,30,14
1657813224281,MATH 10B,A01,083207,Lim; Seonhee,8,0,34,26
1657813224281,MATH 10B,A02,083208,Lim; Seonhee,10,0,35,25
1657813224281,MATH 10B,A03,093472,Lim; Seonhee,7,0,34,27
1657813224281,MATH 10B,B01,083739,Sinha; Shubham,13,0,30,17
1657813230314,MATH 18,A01,083743,Cinel; Cameron Alexander,9,0,30,21
1657813230314,MATH 18,A02,083744,Cinel; Cameron Alexander,18,0,30,12
1657813230314,MATH 18,A03,083745,Cinel; Cameron Alexander,10,0,30,20
1657813230314,MATH 18,B01,083748,Rideout; David Porter,5,0,37,32
1657813230314,MATH 18,B02,083749,Rideout; David Porter,5,0,36,31
1657813230314,MATH 18,B03,083750,Rideout; David Porter,3,0,37,34
1657813230314,MATH 18,B04,083751,Rideout; David Porter,6,0,36,30
1657813230314,MATH 18,B05,093473,Rideout; David Porter,6,0,36,30
1657813230314,MATH 18,B06,093474,Rideout; David Porter,6,0,36,30
1657813236340,MATH 20A,A01,083754,Zheng; Zequn,14,0,40,26
1657813242366,MATH 20B,A01,083756,Briones; Jor-el Thomas Caparas,4,0,36,32
1657813242366,MATH 20B,A02,083757,Briones; Jor-el Thomas Caparas,1,0,36,35
1657813242366,MATH 20B,A03,093475,Briones; Jor-el Thomas Caparas,2,0,36,34
1657813248395,MATH 20C,A01,083760,Briones; Jor-el Thomas Caparas,1,0,35,34
1657813248395,MATH 20C,A02,083761,Briones; Jor-el Thomas Caparas,8,0,35,27
1657813248395,MATH 20C,A03,093476,Briones; Jor-el Thomas Caparas,0,1,36,36
1657813248395,MATH 20C,B01,083762,Bach; Quang Tran,1,0,30,29
1657813254419,MATH 20D,A01,083765,Tran; Brian Kha,5,0,30,25
1657813254419,MATH 20D,A02,083766,Tran; Brian Kha,5,0,30,25
1657813254419,MATH 20D,A03,083767,Tran; Brian Kha,5,0,30,25
1657813260443,MATH 20E,A01,083771,Ganguly; Soumya,10,0,32,22
1657813260443,MATH 20E,A02,083772,Ganguly; Soumya,6,0,32,26
1657813260443,MATH 20E,B01,083773,Ciotti; Benjamin,20,0,35,15
1657813260443,MATH 20E,B02,083774,Ciotti; Benjamin,18,0,35,17
1657813266467,MATH 103A,A01,083777,Greenfeld; Be'Eri,3,0,36,33
1657813266467,MATH 103A,A02,083778,Greenfeld; Be'Eri,5,0,36,31
1657813266467,MATH 103A,A03,093561,Greenfeld; Be'Eri,6,0,36,30
1657813266467,MATH 103A,B01,083779,Greenfeld; Be'Eri,7,0,36,29
1657813266467,MATH 103A,B02,083780,Greenfeld; Be'Eri,4,0,36,32
1657813266467,MATH 103A,B03,093562,Greenfeld; Be'Eri,3,0,36,33
1657813272490,MATH 105,A01,085443,Carter; Anne Toulson,15,0,35,20
1657813272490,MATH 105,A02,093477,Carter; Anne Toulson,20,0,35,15
1657813278515,MATH 109,A01,083213,Ganzberger; Geoffrey Michael,3,0,34,31
1657813278515,MATH 109,A02,083214,Ganzberger; Geoffrey Michael,4,0,34,30
1657813278515,MATH 109,A03,093478,Ganzberger; Geoffrey Michael,2,0,34,32
1657813278515,MATH 109,B01,083215,Ganzberger; Geoffrey Michael,1,0,32,31
1657813278515,MATH 109,B02,083216,Ganzberger; Geoffrey Michael,2,0,32,30
1657813278515,MATH 109,B03,093479,Ganzberger; Geoffrey Michael,8,0,32,24
1657813284539,MATH 142A,A01,083219,Chow; Bennett,7,0,32,25
1657813284539,MATH 142A,A02,083220,Chow; Bennett,10,0,32,22
1657813284539,MATH 142A,A03,093480,Chow; Bennett,9,0,32,23
1657813284539,MATH 142A,B03,093481,Chow; Bennett,8,0,32,24
1657813284539,MATH 142A,B04,093558,Chow; Bennett,13,0,32,19
1657813284539,MATH 142A,B05,093559,Chow; Bennett,6,0,32,26
1657813290567,MATH 193A,A01,083224,Rotar; Vladimir,8,0,34,26
1657813290567,MATH 193A,A02,083225,Rotar; Vladimir,9,0,34,25
1657813290567,MATH 193A,A03,083781,Rotar; Vladimir,5,0,34,29
1657813290567,MATH 193A,A04,083782,Rotar; Vladimir,10,0,34,24
1657813290567,MATH 193A,A05,093482,Rotar; Vladimir,10,0,34,24
1657813296591,MATH 197,001,091859,McAuley; Julian John,9999,0,9999,0
1657813296591,MATH 197,002,095566,Kedlaya; Kiran S.,9997,0,9999,2
1657813296591,MATH 197,003,095567,Xiao; Ming,9999,0,9999,0
1657813296591,MATH 197,004,095571,Perols; Johan Lars,9998,0,9999,1
1657813303646,COGS 9,A01,083615,Shannon; Kyle Michael,9,0,75,66
1657813309739,COGS 11,A01,083617,Boyle; Mary E. T.,23,0,48,25
1657813315761,COGS 13,A01,083071,Bastos; Amalia Pinkusfeld,11,0,71,60
1657813321784,COGS 14A,A01,092681,Semenuks; Arturs,5,1,100,95
1657813327807,COGS 14B,A01,083073,Cheng; Tzu-Han,6,0,63,57
1657813333829,COGS 17,A01,092677,Semenuks; Arturs,6,0,81,75
1657813339857,COGS 100,A01,083619,Allen; Michael Gordon,17,0,70,53
1657813345879,COGS 101A,A01,083621,Davis; Joshua Daniel,9,0,68,59
1657813351902,COGS 101B,A01,091572,Allen; Michael Gordon,12,0,65,53
1657813357927,COGS 101C,A01,083625,Delgado; Tania,17,0,35,18
1657813363952,COGS 107A,A01,083627,Boyle; Mary E. T.,14,0,60,46
1657813369975,COGS 118A,A01,083075,Gupta; Anjum,21,0,76,55
1657813376001,CSE 3,A50,083646,Miranda; Gregory Joseph,24,0,50,26
1657813382030,CSE 8A,A50,083650,Miranda; Gregory Joseph,17,1,56,39
1657813388054,CSE 11,A01,083080,Cao; Yingjun,6,15,40,34
1657813394083,CSE 12,A01,083652,Krause-Levy; Sophia Louisa,28,1,120,92
1657813400106,CSE 15L,A01,083654,Morris; Justin Loren,9,0,50,41
1657813400106,CSE 15L,A02,083655,Morris; Justin Loren,9,0,50,41
1657813406131,CSE 20,A01,083657,Tran; Khoa Dang,39,0,80,41
1657813412167,CSE 21,A01,095574,Bach; Quang Tran,22,0,48,26
1657813418189,CSE 30,A01,083084,Eldon; John,6,0,80,74
1657813418189,CSE 30,B01,095061,Bhaskar; Nishant,9,0,50,41
1657813424213,CSE 100,A01,083659,Cao; Yingjun,5,4,70,65
1657813430237,CSE 134B,A01,083661,Powell; Thomas Allan,24,0,100,76
1657813436259,CSE 140,A01,083663,Gungor; Onat,15,0,85,70
1657813442283,CSE 140L,A01,083088,Eldon; John,23,0,100,77
1657813448307,CSE 175,A01,083665,Kumar; Rakesh,3,0,25,22
1657813454331,CSE 190,A00,092507,Dubnov; Shlomo,8,0,20,12
1657813460358,ECE 45,A01,083139,Congero; Spencer William,6,0,75,69
1657813466389,ECE 65,A50,083695,Saad; Andrew S,12,0,30,18
1657813466389,ECE 65,A51,095125,Saad; Andrew S,24,0,26,2
1657813472412,ECE 109,A01,091882,Touri; Behrouz,20,0,70,50
1657813478453,ECE 180,A00,083140,Abi Samra; Nicholas Camill,1,0,30,29
1657813478453,ECE 180,B00,083141,Abi Samra; Nicholas Camill,0,0,30,30
1657813484481,MATH 10A,A01,083735,Patchell; Gregory David,2,0,30,28
1657813484481,MATH 10A,A02,083736,Patchell; Gregory David,20,0,30,10
1657813484481,MATH 10A,A03,083737,Patchell; Gregory David,16,0,30,14
1657813490514,MATH 10B,A01,083207,Lim; Seonhee,8,0,34,26
1657813490514,MATH 10B,A02,083208,Lim; Seonhee,10,0,35,25
1657813490514,MATH 10B,A03,093472,Lim; Seonhee,7,0,34,27
1657813490514,MATH 10B,B01,083739,Sinha; Shubham,13,0,30,17
1657813496540,MATH 18,A01,083743,Cinel; Cameron Alexander,9,0,30,21
1657813496540,MATH 18,A02,083744,Cinel; Cameron Alexander,18,0,30,12
1657813496540,MATH 18,A03,083745,Cinel; Cameron Alexander,10,0,30,20
1657813496540,MATH 18,B01,083748,Rideout; David Porter,5,0,37,32
1657813496540,MATH 18,B02,083749,Rideout; David Porter,5,0,36,31
1657813496540,MATH 18,B03,083750,Rideout; David Porter,3,0,37,34
1657813496540,MATH 18,B04,083751,Rideout; David Porter,6,0,36,30
1657813496540,MATH 18,B05,093473,Rideout; David Porter,6,0,36,30
1657813496540,MATH 18,B06,093474,Rideout; David Porter,6,0,36,30
1657813502563,MATH 20A,A01,083754,Zheng; Zequn,14,0,40,26
1657813508584,MATH 20B,A01,083756,Briones; Jor-el Thomas Caparas,4,0,36,32
1657813508584,MATH 20B,A02,083757,Briones; Jor-el Thomas Caparas,1,0,36,35
1657813508584,MATH 20B,A03,093475,Briones; Jor-el Thomas Caparas,2,0,36,34
1657813514609,MATH 20C,A01,083760,Briones; Jor-el Thomas Caparas,1,0,35,34
1657813514609,MATH 20C,A02,083761,Briones; Jor-el Thomas Caparas,8,0,35,27
1657813514609,MATH 20C,A03,093476,Briones; Jor-el Thomas Caparas,0,1,36,36
1657813514609,MATH 20C,B01,083762,Bach; Quang Tran,1,0,30,29
1657813520651,MATH 20D,A01,083765,Tran; Brian Kha,5,0,30,25
1657813520651,MATH 20D,A02,083766,Tran; Brian Kha,5,0,30,25
1657813520651,MATH 20D,A03,083767,Tran; Brian Kha,5,0,30,25
1657813526697,MATH 20E,A01,083771,Ganguly; Soumya,10,0,32,22
1657813526697,MATH 20E,A02,083772,Ganguly; Soumya,6,0,32,26
1657813526697,MATH 20E,B01,083773,Ciotti; Benjamin,20,0,35,15
1657813526697,MATH 20E,B02,083774,Ciotti; Benjamin,18,0,35,17
1657813532725,MATH 103A,A01,083777,Greenfeld; Be'Eri,3,0,36,33
1657813532725,MATH 103A,A02,083778,Greenfeld; Be'Eri,5,0,36,31
1657813532725,MATH 103A,A03,093561,Greenfeld; Be'Eri,6,0,36,30
1657813532725,MATH 103A,B01,083779,Greenfeld; Be'Eri,7,0,36,29
1657813532725,MATH 103A,B02,083780,Greenfeld; Be'Eri,4,0,36,32
1657813532725,MATH 103A,B03,093562,Greenfeld; Be'Eri,3,0,36,33
1657813538756,MATH 105,A01,085443,Carter; Anne Toulson,15,0,35,20
1657813538756,MATH 105,A02,093477,Carter; Anne Toulson,20,0,35,15
1657813544784,MATH 109,A01,083213,Ganzberger; Geoffrey Michael,3,0,34,31
1657813544784,MATH 109,A02,083214,Ganzberger; Geoffrey Michael,4,0,34,30
1657813544784,MATH 109,A03,093478,Ganzberger; Geoffrey Michael,2,0,34,32
1657813544784,MATH 109,B01,083215,Ganzberger; Geoffrey Michael,1,0,32,31
1657813544784,MATH 109,B02,083216,Ganzberger; Geoffrey Michael,2,0,32,30
1657813544784,MATH 109,B03,093479,Ganzberger; Geoffrey Michael,8,0,32,24
1657813550808,MATH 142A,A01,083219,Chow; Bennett,7,0,32,25
1657813550808,MATH 142A,A02,083220,Chow; Bennett,10,0,32,22
1657813550808,MATH 142A,A03,093480,Chow; Bennett,9,0,32,23
1657813550808,MATH 142A,B03,093481,Chow; Bennett,8,0,32,24
1657813550808,MATH 142A,B04,093558,Chow; Bennett,13,0,32,19
1657813550808,MATH 142A,B05,093559,Chow; Bennett,6,0,32,26
1657813556832,MATH 193A,A01,083224,Rotar; Vladimir,8,0,34,26
1657813556832,MATH 193A,A02,083225,Rotar; Vladimir,9,0,34,25
1657813556832,MATH 193A,A03,083781,Rotar; Vladimir,5,0,34,29
1657813556832,MATH 193A,A04,083782,Rotar; Vladimir,10,0,34,24
1657813556832,MATH 193A,A05,093482,Rotar; Vladimir,10,0,34,24
1657813562855,MATH 197,001,091859,McAuley; Julian John,9999,0,9999,0
1657813562855,MATH 197,002,095566,Kedlaya; Kiran S.,9997,0,9999,2
1657813562855,MATH 197,003,095567,Xiao; Ming,9999,0,9999,0
1657813562855,MATH 197,004,095571,Perols; Johan Lars,9998,0,9999,1
1657813569931,COGS 9,A01,083615,Shannon; Kyle Michael,9,0,75,66
1657813575953,COGS 11,A01,083617,Boyle; Mary E. T.,23,0,48,25
1657813581983,COGS 13,A01,083071,Bastos; Amalia Pinkusfeld,11,0,71,60
1657813588012,COGS 14A,A01,092681,Semenuks; Arturs,5,1,100,95
1657813594036,COGS 14B,A01,083073,Cheng; Tzu-Han,6,0,63,57
1657813600080,COGS 17,A01,092677,Semenuks; Arturs,6,0,81,75
1657813606105,COGS 100,A01,083619,Allen; Michael Gordon,17,0,70,53
1657813612129,COGS 101A,A01,083621,Davis; Joshua Daniel,9,0,68,59
1657813618153,COGS 101B,A01,091572,Allen; Michael Gordon,12,0,65,53
1657813624178,COGS 101C,A01,083625,Delgado; Tania,17,0,35,18
1657813630205,COGS 107A,A01,083627,Boyle; Mary E. T.,14,0,60,46
1657813636229,COGS 118A,A01,083075,Gupta; Anjum,21,0,76,55
1657813642252,CSE 3,A50,083646,Miranda; Gregory Joseph,24,0,50,26
1657813648281,CSE 8A,A50,083650,Miranda; Gregory Joseph,17,1,56,39
1657813654305,CSE 11,A01,083080,Cao; Yingjun,6,15,40,34
1657813660328,CSE 12,A01,083652,Krause-Levy; Sophia Louisa,28,1,120,92
1657813666355,CSE 15L,A01,083654,Morris; Justin Loren,9,0,50,41
1657813666355,CSE 15L,A02,083655,Morris; Justin Loren,9,0,50,41
1657813672387,CSE 20,A01,083657,Tran; Khoa Dang,39,0,80,41
1657813678409,CSE 21,A01,095574,Bach; Quang Tran,22,0,48,26
1657813684436,CSE 30,A01,083084,Eldon; John,6,0,80,74
1657813684436,CSE 30,B01,095061,Bhaskar; Nishant,9,0,50,41
1657813690485,CSE 100,A01,083659,Cao; Yingjun,5,4,70,65
1657813696510,CSE 134B,A01,083661,Powell; Thomas Allan,24,0,100,76
1657813702532,CSE 140,A01,083663,Gungor; Onat,15,0,85,70
1657813708559,CSE 140L,A01,083088,Eldon; John,23,0,100,77
1657813714593,CSE 175,A01,083665,Kumar; Rakesh,3,0,25,22
1657813720617,CSE 190,A00,092507,Dubnov; Shlomo,8,0,20,12
1657813726642,ECE 45,A01,083139,Congero; Spencer William,6,0,75,69
1657813732671,ECE 65,A50,083695,Saad; Andrew S,12,0,30,18
1657813732671,ECE 65,A51,095125,Saad; Andrew S,24,0,26,2
1657813738695,ECE 109,A01,091882,Touri; Behrouz,20,0,70,50
1657813744721,ECE 180,A00,083140,Abi Samra; Nicholas Camill,1,0,30,29
1657813744721,ECE 180,B00,083141,Abi Samra; Nicholas Camill,0,0,30,30
1657813750754,MATH 10A,A01,083735,Patchell; Gregory David,2,0,30,28
1657813750754,MATH 10A,A02,083736,Patchell; Gregory David,20,0,30,10
1657813750754,MATH 10A,A03,083737,Patchell; Gregory David,16,0,30,14
1657813756782,MATH 10B,A01,083207,Lim; Seonhee,8,0,34,26
1657813756782,MATH 10B,A02,083208,Lim; Seonhee,10,0,35,25
1657813756782,MATH 10B,A03,093472,Lim; Seonhee,7,0,34,27
1657813756782,MATH 10B,B01,083739,Sinha; Shubham,13,0,30,17
1657813762813,MATH 18,A01,083743,Cinel; Cameron Alexander,9,0,30,21
1657813762813,MATH 18,A02,083744,Cinel; Cameron Alexander,18,0,30,12
1657813762813,MATH 18,A03,083745,Cinel; Cameron Alexander,10,0,30,20
1657813762813,MATH 18,B01,083748,Rideout; David Porter,5,0,37,32
1657813762813,MATH 18,B02,083749,Rideout; David Porter,5,0,36,31
1657813762813,MATH 18,B03,083750,Rideout; David Porter,3,0,37,34
1657813762813,MATH 18,B04,083751,Rideout; David Porter,6,0,36,30
1657813762813,MATH 18,B05,093473,Rideout; David Porter,6,0,36,30
1657813762813,MATH 18,B06,093474,Rideout; David Porter,6,0,36,30
1657813768856,MATH 20A,A01,083754,Zheng; Zequn,14,0,40,26
1657813774879,MATH 20B,A01,083756,Briones; Jor-el Thomas Caparas,4,0,36,32
1657813774879,MATH 20B,A02,083757,Briones; Jor-el Thomas Caparas,1,0,36,35
1657813774879,MATH 20B,A03,093475,Briones; Jor-el Thomas Caparas,2,0,36,34
1657813780903,MATH 20C,A01,083760,Briones; Jor-el Thomas Caparas,1,0,35,34
1657813780903,MATH 20C,A02,083761,Briones; Jor-el Thomas Caparas,8,0,35,27
1657813780903,MATH 20C,A03,093476,Briones; Jor-el Thomas Caparas,0,1,36,36
1657813780903,MATH 20C,B01,083762,Bach; Quang Tran,1,0,30,29
1657813786928,MATH 20D,A01,083765,Tran; Brian Kha,5,0,30,25
1657813786928,MATH 20D,A02,083766,Tran; Brian Kha,5,0,30,25
1657813786928,MATH 20D,A03,083767,Tran; Brian Kha,5,0,30,25
1657813792956,MATH 20E,A01,083771,Ganguly; Soumya,10,0,32,22
1657813792956,MATH 20E,A02,083772,Ganguly; Soumya,6,0,32,26
1657813792956,MATH 20E,B01,083773,Ciotti; Benjamin,20,0,35,15
1657813792956,MATH 20E,B02,083774,Ciotti; Benjamin,18,0,35,17
1657813798983,MATH 103A,A01,083777,Greenfeld; Be'Eri,3,0,36,33
1657813798983,MATH 103A,A02,083778,Greenfeld; Be'Eri,5,0,36,31
1657813798983,MATH 103A,A03,093561,Greenfeld; Be'Eri,6,0,36,30
1657813798983,MATH 103A,B01,083779,Greenfeld; Be'Eri,7,0,36,29
1657813798983,MATH 103A,B02,083780,Greenfeld; Be'Eri,4,0,36,32
1657813798983,MATH 103A,B03,093562,Greenfeld; Be'Eri,3,0,36,33
1657813805006,MATH 105,A01,085443,Carter; Anne Toulson,15,0,35,20
1657813805006,MATH 105,A02,093477,Carter; Anne Toulson,20,0,35,15
1657813811031,MATH 109,A01,083213,Ganzberger; Geoffrey Michael,3,0,34,31
1657813811031,MATH 109,A02,083214,Ganzberger; Geoffrey Michael,4,0,34,30
1657813811031,MATH 109,A03,093478,Ganzberger; Geoffrey Michael,2,0,34,32
1657813811031,MATH 109,B01,083215,Ganzberger; Geoffrey Michael,1,0,32,31
1657813811031,MATH 109,B02,083216,Ganzberger; Geoffrey Michael,2,0,32,30
1657813811031,MATH 109,B03,093479,Ganzberger; Geoffrey Michael,8,0,32,24
1657813817057,MATH 142A,A01,083219,Chow; Bennett,7,0,32,25
1657813817057,MATH 142A,A02,083220,Chow; Bennett,10,0,32,22
1657813817057,MATH 142A,A03,093480,Chow; Bennett,9,0,32,23
1657813817057,MATH 142A,B03,093481,Chow; Bennett,8,0,32,24
1657813817057,MATH 142A,B04,093558,Chow; Bennett,13,0,32,19
1657813817057,MATH 142A,B05,093559,Chow; Bennett,6,0,32,26
1657813823084,MATH 193A,A01,083224,Rotar; Vladimir,8,0,34,26
1657813823084,MATH 193A,A02,083225,Rotar; Vladimir,9,0,34,25
1657813823084,MATH 193A,A03,083781,Rotar; Vladimir,5,0,34,29
1657813823084,MATH 193A,A04,083782,Rotar; Vladimir,10,0,34,24
1657813823084,MATH 193A,A05,093482,Rotar; Vladimir,10,0,34,24
1657813829108,MATH 197,001,091859,McAuley; Julian John,9999,0,9999,0
1657813829108,MATH 197,002,095566,Kedlaya; Kiran S.,9997,0,9999,2
1657813829108,MATH 197,003,095567,Xiao; Ming,9999,0,9999,0
1657813829108,MATH 197,004,095571,Perols; Johan Lars,9998,0,9999,1
1657813836176,COGS 9,A01,083615,Shannon; Kyle Michael,9,0,75,66
1657813842199,COGS 11,A01,083617,Boyle; Mary E. T.,23,0,48,25
1657813848225,COGS 13,A01,083071,Bastos; Amalia Pinkusfeld,11,0,71,60
1657813854248,COGS 14A,A01,092681,Semenuks; Arturs,5,1,100,95
1657813860281,COGS 14B,A01,083073,Cheng; Tzu-Han,6,0,63,57
1657813866305,COGS 17,A01,092677,Semenuks; Arturs,6,0,81,75
1657813872332,COGS 100,A01,083619,Allen; Michael Gordon,17,0,70,53
1657813878354,COGS 101A,A01,083621,Davis; Joshua Daniel,9,0,68,59
1657813884378,COGS 101B,A01,091572,Allen; Michael Gordon,12,0,65,53
1657813890404,COGS 101C,A01,083625,Delgado; Tania,17,0,35,18
1657813896435,COGS 107A,A01,083627,Boyle; Mary E. T.,14,0,60,46
1657813902461,COGS 118A,A01,083075,Gupta; Anjum,21,0,76,55
1657813908570,CSE 3,A50,083646,Miranda; Gregory Joseph,24,0,50,26
1657813914601,CSE 8A,A50,083650,Miranda; Gregory Joseph,17,1,56,39
1657813920625,CSE 11,A01,083080,Cao; Yingjun,6,15,40,34
1657813926647,CSE 12,A01,083652,Krause-Levy; Sophia Louisa,28,1,120,92
1657813932683,CSE 15L,A01,083654,Morris; Justin Loren,9,0,50,41
1657813932683,CSE 15L,A02,083655,Morris; Justin Loren,9,0,50,41
1657813938714,CSE 20,A01,083657,Tran; Khoa Dang,39,0,80,41
1657813944744,CSE 21,A01,095574,Bach; Quang Tran,22,0,48,26
1657813950767,CSE 30,A01,083084,Eldon; John,6,0,80,74
1657813950767,CSE 30,B01,095061,Bhaskar; Nishant,9,0,50,41
1657813956795,CSE 100,A01,083659,Cao; Yingjun,5,4,70,65
1657813962819,CSE 134B,A01,083661,Powell; Thomas Allan,24,0,100,76
1657813968862,CSE 140,A01,083663,Gungor; Onat,15,0,85,70
1657813974886,CSE 140L,A01,083088,Eldon; John,23,0,100,77
1657813980907,CSE 175,A01,083665,Kumar; Rakesh,3,0,25,22
1657813986931,CSE 190,A00,092507,Dubnov; Shlomo,8,0,20,12
1657813992954,ECE 45,A01,083139,Congero; Spencer William,6,0,75,69
1657813998978,ECE 65,A50,083695,Saad; Andrew S,12,0,30,18
1657813998978,ECE 65,A51,095125,Saad; Andrew S,24,0,26,2
1657814005004,ECE 109,A01,091882,Touri; Behrouz,20,0,70,50
1657814011026,ECE 180,A00,083140,Abi Samra; Nicholas Camill,1,0,30,29
1657814011026,ECE 180,B00,083141,Abi Samra; Nicholas Camill,0,0,30,30
1657814017054,MATH 10A,A01,083735,Patchell; Gregory David,2,0,30,28
1657814017054,MATH 10A,A02,083736,Patchell; Gregory David,20,0,30,10
1657814017054,MATH 10A,A03,083737,Patchell; Gregory David,16,0,30,14
1657814023080,MATH 10B,A01,083207,Lim; Seonhee,8,0,34,26
1657814023080,MATH 10B,A02,083208,Lim; Seonhee,10,0,35,25
1657814023080,MATH 10B,A03,093472,Lim; Seonhee,7,0,34,27
1657814023080,MATH 10B,B01,083739,Sinha; Shubham,13,0,30,17
1657814029111,MATH 18,A01,083743,Cinel; Cameron Alexander,9,0,30,21
1657814029111,MATH 18,A02,083744,Cinel; Cameron Alexander,18,0,30,12
1657814029111,MATH 18,A03,083745,Cinel; Cameron Alexander,10,0,30,20
1657814029111,MATH 18,B01,083748,Rideout; David Porter,5,0,37,32
1657814029111,MATH 18,B02,083749,Rideout; David Porter,5,0,36,31
1657814029111,MATH 18,B03,083750,Rideout; David Porter,3,0,37,34
1657814029111,MATH 18,B04,083751,Rideout; David Porter,6,0,36,30
1657814029111,MATH 18,B05,093473,Rideout; David Porter,6,0,36,30
1657814029111,MATH 18,B06,093474,Rideout; David Porter,6,0,36,30
1657814035144,MATH 20A,A01,083754,Zheng; Zequn,14,0,40,26
1657814041168,MATH 20B,A01,083756,Briones; Jor-el Thomas Caparas,4,0,36,32
1657814041168,MATH 20B,A02,083757,Briones; Jor-el Thomas Caparas,1,0,36,35
1657814041168,MATH 20B,A03,093475,Briones; Jor-el Thomas Caparas,2,0,36,34
1657814047197,MATH 20C,A01,083760,Briones; Jor-el Thomas Caparas,1,0,35,34
1657814047197,MATH 20C,A02,083761,Briones; Jor-el Thomas Caparas,8,0,35,27
1657814047197,MATH 20C,A03,093476,Briones; Jor-el Thomas Caparas,0,1,36,36
1657814047197,MATH 20C,B01,083762,Bach; Quang Tran,1,0,30,29
1657814053219,MATH 20D,A01,083765,Tran; Brian Kha,5,0,30,25
1657814053219,MATH 20D,A02,083766,Tran; Brian Kha,5,0,30,25
1657814053219,MATH 20D,A03,083767,Tran; Brian Kha,5,0,30,25
1657814059245,MATH 20E,A01,083771,Ganguly; Soumya,10,0,32,22
1657814059245,MATH 20E,A02,083772,Ganguly; Soumya,6,0,32,26
1657814059245,MATH 20E,B01,083773,Ciotti; Benjamin,20,0,35,15
1657814059245,MATH 20E,B02,083774,Ciotti; Benjamin,18,0,35,17
1657814065274,MATH 103A,A01,083777,Greenfeld; Be'Eri,3,0,36,33
1657814065274,MATH 103A,A02,083778,Greenfeld; Be'Eri,5,0,36,31
1657814065274,MATH 103A,A03,093561,Greenfeld; Be'Eri,6,0,36,30
1657814065274,MATH 103A,B01,083779,Greenfeld; Be'Eri,7,0,36,29
1657814065274,MATH 103A,B02,083780,Greenfeld; Be'Eri,4,0,36,32
1657814065274,MATH 103A,B03,093562,Greenfeld; Be'Eri,3,0,36,33
1657814071299,MATH 105,A01,085443,Carter; Anne Toulson,15,0,35,20
1657814071299,MATH 105,A02,093477,Carter; Anne Toulson,20,0,35,15
1657814077325,MATH 109,A01,083213,Ganzberger; Geoffrey Michael,3,0,34,31
1657814077325,MATH 109,A02,083214,Ganzberger; Geoffrey Michael,4,0,34,30
1657814077325,MATH 109,A03,093478,Ganzberger; Geoffrey Michael,2,0,34,32
1657814077325,MATH 109,B01,083215,Ganzberger; Geoffrey Michael,1,0,32,31
1657814077325,MATH 109,B02,083216,Ganzberger; Geoffrey Michael,2,0,32,30
1657814077325,MATH 109,B03,093479,Ganzberger; Geoffrey Michael,8,0,32,24
1657814083361,MATH 142A,A01,083219,Chow; Bennett,7,0,32,25
1657814083361,MATH 142A,A02,083220,Chow; Bennett,10,0,32,22
1657814083361,MATH 142A,A03,093480,Chow; Bennett,9,0,32,23
1657814083361,MATH 142A,B03,093481,Chow; Bennett,8,0,32,24
1657814083361,MATH 142A,B04,093558,Chow; Bennett,13,0,32,19
1657814083361,MATH 142A,B05,093559,Chow; Bennett,6,0,32,26
1657814089390,MATH 193A,A01,083224,Rotar; Vladimir,8,0,34,26
1657814089390,MATH 193A,A02,083225,Rotar; Vladimir,9,0,34,25
1657814089390,MATH 193A,A03,083781,Rotar; Vladimir,5,0,34,29
1657814089390,MATH 193A,A04,083782,Rotar; Vladimir,10,0,34,24
1657814089390,MATH 193A,A05,093482,Rotar; Vladimir,10,0,34,24
1657814095413,MATH 197,001,091859,McAuley; Julian John,9999,0,9999,0
1657814095413,MATH 197,002,095566,Kedlaya; Kiran S.,9997,0,9999,2
1657814095413,MATH 197,003,095567,Xiao; Ming,9999,0,9999,0
1657814095413,MATH 197,004,095571,Perols; Johan Lars,9998,0,9999,1
1657814102490,COGS 9,A01,083615,Shannon; Kyle Michael,9,0,75,66
1657814108523,COGS 11,A01,083617,Boyle; Mary E. T.,23,0,48,25
1657814114547,COGS 13,A01,083071,Bastos; Amalia Pinkusfeld,11,0,71,60
1657814120577,COGS 14A,A01,092681,Semenuks; Arturs,5,1,100,95
1657814126604,COGS 14B,A01,083073,Cheng; Tzu-Han,6,0,63,57
1657814132627,COGS 17,A01,092677,Semenuks; Arturs,6,0,81,75
1657814138649,COGS 100,A01,083619,Allen; Michael Gordon,17,0,70,53
1657814144672,COGS 101A,A01,083621,Davis; Joshua Daniel,9,0,68,59
1657814150707,COGS 101B,A01,091572,Allen; Michael Gordon,12,0,65,53
1657814156732,COGS 101C,A01,083625,Delgado; Tania,17,0,35,18
1657814162767,COGS 107A,A01,083627,Boyle; Mary E. T.,14,0,60,46
1657814168797,COGS 118A,A01,083075,Gupta; Anjum,21,0,76,55
1657814174834,CSE 3,A50,083646,Miranda; Gregory Joseph,24,0,50,26
1657814180861,CSE 8A,A50,083650,Miranda; Gregory Joseph,17,1,56,39
1657814186885,CSE 11,A01,083080,Cao; Yingjun,6,15,40,34
1657814192907,CSE 12,A01,083652,Krause-Levy; Sophia Louisa,28,1,120,92
1657814198931,CSE 15L,A01,083654,Morris; Justin Loren,9,0,50,41
1657814198931,CSE 15L,A02,083655,Morris; Justin Loren,9,0,50,41
1657814204953,CSE 20,A01,083657,Tran; Khoa Dang,39,0,80,41
1657814210981,CSE 21,A01,095574,Bach; Quang Tran,22,0,48,26
1657814217003,CSE 30,A01,083084,Eldon; John,6,0,80,74
1657814217003,CSE 30,B01,095061,Bhaskar; Nishant,9,0,50,41
1657814223032,CSE 100,A01,083659,Cao; Yingjun,5,4,70,65
1657814229055,CSE 134B,A01,083661,Powell; Thomas Allan,24,0,100,76
1657814235085,CSE 140,A01,083663,Gungor; Onat,15,0,85,70
1657814241113,CSE 140L,A01,083088,Eldon; John,23,0,100,77
1657814247142,CSE 175,A01,083665,Kumar; Rakesh,3,0,25,22
1657814253170,CSE 190,A00,092507,Dubnov; Shlomo,8,0,20,12
1657814259193,ECE 45,A01,083139,Congero; Spencer William,6,0,75,69
1657814265217,ECE 65,A50,083695,Saad; Andrew S,12,0,30,18
1657814265217,ECE 65,A51,095125,Saad; Andrew S,24,0,26,2
1657814271258,ECE 109,A01,091882,Touri; Behrouz,20,0,70,50
1657814277293,ECE 180,A00,083140,Abi Samra; Nicholas Camill,1,0,30,29
1657814277293,ECE 180,B00,083141,Abi Samra; Nicholas Camill,0,0,30,30
1657814283317,MATH 10A,A01,083735,Patchell; Gregory David,2,0,30,28
1657814283317,MATH 10A,A02,083736,Patchell; Gregory David,20,0,30,10
1657814283317,MATH 10A,A03,083737,Patchell; Gregory David,16,0,30,14
1657814289340,MATH 10B,A01,083207,Lim; Seonhee,8,0,34,26
1657814289340,MATH 10B,A02,083208,Lim; Seonhee,10,0,35,25
1657814289340,MATH 10B,A03,093472,Lim; Seonhee,7,0,34,27
1657814289340,MATH 10B,B01,083739,Sinha; Shubham,13,0,30,17
1657814295373,MATH 18,A01,083743,Cinel; Cameron Alexander,9,0,30,21
1657814295373,MATH 18,A02,083744,Cinel; Cameron Alexander,18,0,30,12
1657814295373,MATH 18,A03,083745,Cinel; Cameron Alexander,10,0,30,20
1657814295373,MATH 18,B01,083748,Rideout; David Porter,5,0,37,32
1657814295373,MATH 18,B02,083749,Rideout; David Porter,5,0,36,31
1657814295373,MATH 18,B03,083750,Rideout; David Porter,3,0,37,34
1657814295373,MATH 18,B04,083751,Rideout; David Porter,6,0,36,30
1657814295373,MATH 18,B05,093473,Rideout; David Porter,6,0,36,30
1657814295373,MATH 18,B06,093474,Rideout; David Porter,6,0,36,30
1657814301395,MATH 20A,A01,083754,Zheng; Zequn,14,0,40,26
1657814307424,MATH 20B,A01,083756,Briones; Jor-el Thomas Caparas,4,0,36,32
1657814307424,MATH 20B,A02,083757,Briones; Jor-el Thomas Caparas,1,0,36,35
1657814307424,MATH 20B,A03,093475,Briones; Jor-el Thomas Caparas,2,0,36,34
1657814313447,MATH 20C,A01,083760,Briones; Jor-el Thomas Caparas,1,0,35,34
1657814313447,MATH 20C,A02,083761,Briones; Jor-el Thomas Caparas,8,0,35,27
1657814313447,MATH 20C,A03,093476,Briones; Jor-el Thomas Caparas,0,1,36,36
1657814313447,MATH 20C,B01,083762,Bach; Quang Tran,1,0,30,29
1657814319485,MATH 20D,A01,083765,Tran; Brian Kha,5,0,30,25
1657814319485,MATH 20D,A02,083766,Tran; Brian Kha,5,0,30,25
1657814319485,MATH 20D,A03,083767,Tran; Brian Kha,5,0,30,25
1657814325509,MATH 20E,A01,083771,Ganguly; Soumya,10,0,32,22
1657814325509,MATH 20E,A02,083772,Ganguly; Soumya,6,0,32,26
1657814325509,MATH 20E,B01,083773,Ciotti; Benjamin,20,0,35,15
1657814325509,MATH 20E,B02,083774,Ciotti; Benjamin,18,0,35,17
1657814331532,MATH 103A,A01,083777,Greenfeld; Be'Eri,3,0,36,33
1657814331532,MATH 103A,A02,083778,Greenfeld; Be'Eri,5,0,36,31
1657814331532,MATH 103A,A03,093561,Greenfeld; Be'Eri,6,0,36,30
1657814331532,MATH 103A,B01,083779,Greenfeld; Be'Eri,7,0,36,29
1657814331532,MATH 103A,B02,083780,Greenfeld; Be'Eri,4,0,36,32
1657814331532,MATH 103A,B03,093562,Greenfeld; Be'Eri,3,0,36,33
1657814337563,MATH 105,A01,085443,Carter; Anne Toulson,15,0,35,20
1657814337563,MATH 105,A02,093477,Carter; Anne Toulson,20,0,35,15
1657814343590,MATH 109,A01,083213,Ganzberger; Geoffrey Michael,3,0,34,31
1657814343590,MATH 109,A02,083214,Ganzberger; Geoffrey Michael,4,0,34,30
1657814343590,MATH 109,A03,093478,Ganzberger; Geoffrey Michael,2,0,34,32
1657814343590,MATH 109,B01,083215,Ganzberger; Geoffrey Michael,1,0,32,31
1657814343590,MATH 109,B02,083216,Ganzberger; Geoffrey Michael,2,0,32,30
1657814343590,MATH 109,B03,093479,Ganzberger; Geoffrey Michael,8,0,32,24
1657814349615,MATH 142A,A01,083219,Chow; Bennett,7,0,32,25
1657814349615,MATH 142A,A02,083220,Chow; Bennett,10,0,32,22
1657814349615,MATH 142A,A03,093480,Chow; Bennett,9,0,32,23
1657814349615,MATH 142A,B03,093481,Chow; Bennett,8,0,32,24
1657814349615,MATH 142A,B04,093558,Chow; Bennett,13,0,32,19
1657814349615,MATH 142A,B05,093559,Chow; Bennett,6,0,32,26
1657814355639,MATH 193A,A01,083224,Rotar; Vladimir,8,0,34,26
1657814355639,MATH 193A,A02,083225,Rotar; Vladimir,9,0,34,25
1657814355639,MATH 193A,A03,083781,Rotar; Vladimir,5,0,34,29
1657814355639,MATH 193A,A04,083782,Rotar; Vladimir,10,0,34,24
1657814355639,MATH 193A,A05,093482,Rotar; Vladimir,10,0,34,24
1657814361661,MATH 197,001,091859,McAuley; Julian John,9999,0,9999,0
1657814361661,MATH 197,002,095566,Kedlaya; Kiran S.,9997,0,9999,2
1657814361661,MATH 197,003,095567,Xiao; Ming,9999,0,9999,0
1657814361661,MATH 197,004,095571,Perols; Johan Lars,9998,0,9999,1
1657814368724,COGS 9,A01,083615,Shannon; Kyle Michael,9,0,75,66
1657814374754,COGS 11,A01,083617,Boyle; Mary E. T.,23,0,48,25
1657814380780,COGS 13,A01,083071,Bastos; Amalia Pinkusfeld,11,0,71,60
1657814386814,COGS 14A,A01,092681,Semenuks; Arturs,5,1,100,95
1657814392847,COGS 14B,A01,083073,Cheng; Tzu-Han,6,0,63,57
1657814398873,COGS 17,A01,092677,Semenuks; Arturs,6,0,81,75
1657814404902,COGS 100,A01,083619,Allen; Michael Gordon,17,0,70,53
1657814410932,COGS 101A,A01,083621,Davis; Joshua Daniel,9,0,68,59
1657814416958,COGS 101B,A01,091572,Allen; Michael Gordon,12,0,65,53
1657814422987,COGS 101C,A01,083625,Delgado; Tania,17,0,35,18
1657814429008,COGS 107A,A01,083627,Boyle; Mary E. T.,14,0,60,46
1657814435048,COGS 118A,A01,083075,Gupta; Anjum,21,0,76,55
1657814441072,CSE 3,A50,083646,Miranda; Gregory Joseph,24,0,50,26
1657814447113,CSE 8A,A50,083650,Miranda; Gregory Joseph,17,1,56,39
1657814453137,CSE 11,A01,083080,Cao; Yingjun,6,15,40,34
1657814459172,CSE 12,A01,083652,Krause-Levy; Sophia Louisa,28,1,120,92
1657814465215,CSE 15L,A01,083654,Morris; Justin Loren,9,0,50,41
1657814465215,CSE 15L,A02,083655,Morris; Justin Loren,9,0,50,41
1657814471238,CSE 20,A01,083657,Tran; Khoa Dang,39,0,80,41
1657814477267,CSE 21,A01,095574,Bach; Quang Tran,22,0,48,26
1657814483295,CSE 30,A01,083084,Eldon; John,6,0,80,74
1657814483295,CSE 30,B01,095061,Bhaskar; Nishant,9,0,50,41
1657814489322,CSE 100,A01,083659,Cao; Yingjun,5,4,70,65
1657814495357,CSE 134B,A01,083661,Powell; Thomas Allan,24,0,100,76
1657814501384,CSE 140,A01,083663,Gungor; Onat,15,0,85,70
1657814507487,CSE 140L,A01,083088,Eldon; John,23,0,100,77
1657814513511,CSE 175,A01,083665,Kumar; Rakesh,3,0,25,22
1657814519545,CSE 190,A00,092507,Dubnov; Shlomo,8,0,20,12
1657814525569,ECE 45,A01,083139,Congero; Spencer William,6,0,75,69
1657814531604,ECE 65,A50,083695,Saad; Andrew S,12,0,30,18
1657814531604,ECE 65,A51,095125,Saad; Andrew S,24,0,26,2
1657814537637,ECE 109,A01,091882,Touri; Behrouz,20,0,70,50
1657814543668,ECE 180,A00,083140,Abi Samra; Nicholas Camill,1,0,30,29
1657814543668,ECE 180,B00,083141,Abi Samra; Nicholas Camill,0,0,30,30
1657814549704,MATH 10A,A01,083735,Patchell; Gregory David,2,0,30,28
1657814549704,MATH 10A,A02,083736,Patchell; Gregory David,20,0,30,10
1657814549704,MATH 10A,A03,083737,Patchell; Gregory David,16,0,30,14
1657814555732,MATH 10B,A01,083207,Lim; Seonhee,8,0,34,26
1657814555732,MATH 10B,A02,083208,Lim; Seonhee,10,0,35,25
1657814555732,MATH 10B,A03,093472,Lim; Seonhee,7,0,34,27
1657814555732,MATH 10B,B01,083739,Sinha; Shubham,13,0,30,17
1657814561757,MATH 18,A01,083743,Cinel; Cameron Alexander,9,0,30,21
1657814561757,MATH 18,A02,083744,Cinel; Cameron Alexander,18,0,30,12
1657814561757,MATH 18,A03,083745,Cinel; Cameron Alexander,10,0,30,20
1657814561757,MATH 18,B01,083748,Rideout; David Porter,5,0,37,32
1657814561757,MATH 18,B02,083749,Rideout; David Porter,5,0,36,31
1657814561757,MATH 18,B03,083750,Rideout; David Porter,3,0,37,34
1657814561757,MATH 18,B04,083751,Rideout; David Porter,6,0,36,30
1657814561757,MATH 18,B05,093473,Rideout; David Porter,6,0,36,30
1657814561757,MATH 18,B06,093474,Rideout; David Porter,6,0,36,30
1657814567780,MATH 20A,A01,083754,Zheng; Zequn,14,0,40,26
1657814573808,MATH 20B,A01,083756,Briones; Jor-el Thomas Caparas,4,0,36,32
1657814573808,MATH 20B,A02,083757,Briones; Jor-el Thomas Caparas,1,0,36,35
1657814573808,MATH 20B,A03,093475,Briones; Jor-el Thomas Caparas,2,0,36,34
1657814579848,MATH 20C,A01,083760,Briones; Jor-el Thomas Caparas,1,0,35,34
1657814579848,MATH 20C,A02,083761,Briones; Jor-el Thomas Caparas,8,0,35,27
1657814579848,MATH 20C,A03,093476,Briones; Jor-el Thomas Caparas,0,1,36,36
1657814579848,MATH 20C,B01,083762,Bach; Quang Tran,1,0,30,29
1657814585878,MATH 20D,A01,083765,Tran; Brian Kha,5,0,30,25
1657814585878,MATH 20D,A02,083766,Tran; Brian Kha,5,0,30,25
1657814585878,MATH 20D,A03,083767,Tran; Brian Kha,5,0,30,25
1657814591927,MATH 20E,A01,083771,Ganguly; Soumya,10,0,32,22
1657814591927,MATH 20E,A02,083772,Ganguly; Soumya,6,0,32,26
1657814591927,MATH 20E,B01,083773,Ciotti; Benjamin,20,0,35,15
1657814591927,MATH 20E,B02,083774,Ciotti; Benjamin,18,0,35,17
1657814597953,MATH 103A,A01,083777,Greenfeld; Be'Eri,3,0,36,33
1657814597953,MATH 103A,A02,083778,Greenfeld; Be'Eri,5,0,36,31
1657814597953,MATH 103A,A03,093561,Greenfeld; Be'Eri,6,0,36,30
1657814597953,MATH 103A,B01,083779,Greenfeld; Be'Eri,7,0,36,29
1657814597953,MATH 103A,B02,083780,Greenfeld; Be'Eri,4,0,36,32
1657814597953,MATH 103A,B03,093562,Greenfeld; Be'Eri,3,0,36,33
1657814603976,MATH 105,A01,085443,Carter; Anne Toulson,15,0,35,20
1657814603976,MATH 105,A02,093477,Carter; Anne Toulson,20,0,35,15
1657814610006,MATH 109,A01,083213,Ganzberger; Geoffrey Michael,3,0,34,31
1657814610006,MATH 109,A02,083214,Ganzberger; Geoffrey Michael,4,0,34,30
1657814610006,MATH 109,A03,093478,Ganzberger; Geoffrey Michael,2,0,34,32
1657814610006,MATH 109,B01,083215,Ganzberger; Geoffrey Michael,1,0,32,31
1657814610006,MATH 109,B02,083216,Ganzberger; Geoffrey Michael,2,0,32,30
1657814610006,MATH 109,B03,093479,Ganzberger; Geoffrey Michael,8,0,32,24
1657814616041,MATH 142A,A01,083219,Chow; Bennett,7,0,32,25
1657814616041,MATH 142A,A02,083220,Chow; Bennett,10,0,32,22
1657814616041,MATH 142A,A03,093480,Chow; Bennett,9,0,32,23
1657814616041,MATH 142A,B03,093481,Chow; Bennett,8,0,32,24
1657814616041,MATH 142A,B04,093558,Chow; Bennett,13,0,32,19
1657814616041,MATH 142A,B05,093559,Chow; Bennett,6,0,32,26
1657814622076,MATH 193A,A01,083224,Rotar; Vladimir,8,0,34,26
1657814622076,MATH 193A,A02,083225,Rotar; Vladimir,9,0,34,25
1657814622076,MATH 193A,A03,083781,Rotar; Vladimir,5,0,34,29
1657814622076,MATH 193A,A04,083782,Rotar; Vladimir,10,0,34,24
1657814622076,MATH 193A,A05,093482,Rotar; Vladimir,10,0,34,24
1657814628100,MATH 197,001,091859,McAuley; Julian John,9999,0,9999,0
1657814628100,MATH 197,002,095566,Kedlaya; Kiran S.,9997,0,9999,2
1657814628100,MATH 197,003,095567,Xiao; Ming,9999,0,9999,0
1657814628100,MATH 197,004,095571,Perols; Johan Lars,9998,0,9999,1
1657814635152,COGS 9,A01,083615,Shannon; Kyle Michael,9,0,75,66
1657814641179,COGS 11,A01,083617,Boyle; Mary E. T.,23,0,48,25
1657814647202,COGS 13,A01,083071,Bastos; Amalia Pinkusfeld,11,0,71,60
1657814653229,COGS 14A,A01,092681,Semenuks; Arturs,5,1,100,95
1657814659266,COGS 14B,A01,083073,Cheng; Tzu-Han,6,0,63,57
1657814665289,COGS 17,A01,092677,Semenuks; Arturs,6,0,81,75
1657814671313,COGS 100,A01,083619,Allen; Michael Gordon,17,0,70,53
1657814677341,COGS 101A,A01,083621,Davis; Joshua Daniel,9,0,68,59
1657814683369,COGS 101B,A01,091572,Allen; Michael Gordon,12,0,65,53
1657814689400,COGS 101C,A01,083625,Delgado; Tania,17,0,35,18
1657814695426,COGS 107A,A01,083627,Boyle; Mary E. T.,14,0,60,46
1657814701453,COGS 118A,A01,083075,Gupta; Anjum,21,0,76,55
1657814707481,CSE 3,A50,083646,Miranda; Gregory Joseph,24,0,50,26
1657814713504,CSE 8A,A50,083650,Miranda; Gregory Joseph,17,1,56,39
1657814719527,CSE 11,A01,083080,Cao; Yingjun,6,15,40,34
1657814725550,CSE 12,A01,083652,Krause-Levy; Sophia Louisa,28,1,120,92
1657814731576,CSE 15L,A01,083654,Morris; Justin Loren,9,0,50,41
1657814731576,CSE 15L,A02,083655,Morris; Justin Loren,9,0,50,41
1657814737605,CSE 20,A01,083657,Tran; Khoa Dang,39,0,80,41
1657814743629,CSE 21,A01,095574,Bach; Quang Tran,22,0,48,26
1657814749666,CSE 30,A01,083084,Eldon; John,6,0,80,74
1657814749666,CSE 30,B01,095061,Bhaskar; Nishant,9,0,50,41
1657814755697,CSE 100,A01,083659,Cao; Yingjun,5,4,70,65
1657814761728,CSE 134B,A01,083661,Powell; Thomas Allan,24,0,100,76
1657814767751,CSE 140,A01,083663,Gungor; Onat,15,0,85,70
1657814773777,CSE 140L,A01,083088,Eldon; John,23,0,100,77
1657814779801,CSE 175,A01,083665,Kumar; Rakesh,3,0,25,22
1657814785825,CSE 190,A00,092507,Dubnov; Shlomo,8,0,20,12
1657814791851,ECE 45,A01,083139,Congero; Spencer William,6,0,75,69
1657814797881,ECE 65,A50,083695,Saad; Andrew S,12,0,30,18
1657814797881,ECE 65,A51,095125,Saad; Andrew S,24,0,26,2
1657814803909,ECE 109,A01,091882,Touri; Behrouz,20,0,70,50
1657814809933,ECE 180,A00,083140,Abi Samra; Nicholas Camill,1,0,30,29
1657814809933,ECE 180,B00,083141,Abi Samra; Nicholas Camill,0,0,30,30
1657814815955,MATH 10A,A01,083735,Patchell; Gregory David,2,0,30,28
1657814815955,MATH 10A,A02,083736,Patchell; Gregory David,20,0,30,10
1657814815955,MATH 10A,A03,083737,Patchell; Gregory David,16,0,30,14
1657814821980,MATH 10B,A01,083207,Lim; Seonhee,8,0,34,26
1657814821980,MATH 10B,A02,083208,Lim; Seonhee,10,0,35,25
1657814821980,MATH 10B,A03,093472,Lim; Seonhee,7,0,34,27
1657814821980,MATH 10B,B01,083739,Sinha; Shubham,13,0,30,17
1657814828005,MATH 18,A01,083743,Cinel; Cameron Alexander,9,0,30,21
1657814828005,MATH 18,A02,083744,Cinel; Cameron Alexander,18,0,30,12
1657814828005,MATH 18,A03,083745,Cinel; Cameron Alexander,10,0,30,20
1657814828005,MATH 18,B01,083748,Rideout; David Porter,5,0,37,32
1657814828005,MATH 18,B02,083749,Rideout; David Porter,5,0,36,31
1657814828005,MATH 18,B03,083750,Rideout; David Porter,3,0,37,34
1657814828005,MATH 18,B04,083751,Rideout; David Porter,6,0,36,30
1657814828005,MATH 18,B05,093473,Rideout; David Porter,6,0,36,30
1657814828005,MATH 18,B06,093474,Rideout; David Porter,6,0,36,30
1657814834029,MATH 20A,A01,083754,Zheng; Zequn,14,0,40,26
1657814840052,MATH 20B,A01,083756,Briones; Jor-el Thomas Caparas,4,0,36,32
1657814840052,MATH 20B,A02,083757,Briones; Jor-el Thomas Caparas,1,0,36,35
1657814840052,MATH 20B,A03,093475,Briones; Jor-el Thomas Caparas,2,0,36,34
1657814846088,MATH 20C,A01,083760,Briones; Jor-el Thomas Caparas,1,0,35,34
1657814846088,MATH 20C,A02,083761,Briones; Jor-el Thomas Caparas,8,0,35,27
1657814846088,MATH 20C,A03,093476,Briones; Jor-el Thomas Caparas,0,1,36,36
1657814846088,MATH 20C,B01,083762,Bach; Quang Tran,1,0,30,29
1657814852112,MATH 20D,A01,083765,Tran; Brian Kha,5,0,30,25
1657814852112,MATH 20D,A02,083766,Tran; Brian Kha,5,0,30,25
1657814852112,MATH 20D,A03,083767,Tran; Brian Kha,5,0,30,25
1657814858174,MATH 20E,A01,083771,Ganguly; Soumya,10,0,32,22
1657814858174,MATH 20E,A02,083772,Ganguly; Soumya,6,0,32,26
1657814858174,MATH 20E,B01,083773,Ciotti; Benjamin,20,0,35,15
1657814858174,MATH 20E,B02,083774,Ciotti; Benjamin,18,0,35,17
1657814864206,MATH 103A,A01,083777,Greenfeld; Be'Eri,3,0,36,33
1657814864206,MATH 103A,A02,083778,Greenfeld; Be'Eri,5,0,36,31
1657814864206,MATH 103A,A03,093561,Greenfeld; Be'Eri,6,0,36,30
1657814864206,MATH 103A,B01,083779,Greenfeld; Be'Eri,7,0,36,29
1657814864206,MATH 103A,B02,083780,Greenfeld; Be'Eri,4,0,36,32
1657814864206,MATH 103A,B03,093562,Greenfeld; Be'Eri,3,0,36,33
1657814870231,MATH 105,A01,085443,Carter; Anne Toulson,15,0,35,20
1657814870231,MATH 105,A02,093477,Carter; Anne Toulson,20,0,35,15
1657814876255,MATH 109,A01,083213,Ganzberger; Geoffrey Michael,3,0,34,31
1657814876255,MATH 109,A02,083214,Ganzberger; Geoffrey Michael,4,0,34,30
1657814876255,MATH 109,A03,093478,Ganzberger; Geoffrey Michael,2,0,34,32
1657814876255,MATH 109,B01,083215,Ganzberger; Geoffrey Michael,1,0,32,31
1657814876255,MATH 109,B02,083216,Ganzberger; Geoffrey Michael,2,0,32,30
1657814876255,MATH 109,B03,093479,Ganzberger; Geoffrey Michael,8,0,32,24
1657814882284,MATH 142A,A01,083219,Chow; Bennett,7,0,32,25
1657814882284,MATH 142A,A02,083220,Chow; Bennett,10,0,32,22
1657814882284,MATH 142A,A03,093480,Chow; Bennett,9,0,32,23
1657814882284,MATH 142A,B03,093481,Chow; Bennett,8,0,32,24
1657814882284,MATH 142A,B04,093558,Chow; Bennett,13,0,32,19
1657814882284,MATH 142A,B05,093559,Chow; Bennett,6,0,32,26
1657814888313,MATH 193A,A01,083224,Rotar; Vladimir,8,0,34,26
1657814888313,MATH 193A,A02,083225,Rotar; Vladimir,9,0,34,25
1657814888313,MATH 193A,A03,083781,Rotar; Vladimir,5,0,34,29
1657814888313,MATH 193A,A04,083782,Rotar; Vladimir,10,0,34,24
1657814888313,MATH 193A,A05,093482,Rotar; Vladimir,10,0,34,24
1657814894341,MATH 197,001,091859,McAuley; Julian John,9999,0,9999,0
1657814894341,MATH 197,002,095566,Kedlaya; Kiran S.,9997,0,9999,2
1657814894341,MATH 197,003,095567,Xiao; Ming,9999,0,9999,0
1657814894341,MATH 197,004,095571,Perols; Johan Lars,9998,0,9999,1
1657814901392,COGS 9,A01,083615,Shannon; Kyle Michael,9,0,75,66
1657814907425,COGS 11,A01,083617,Boyle; Mary E. T.,23,0,48,25
1657814913447,COGS 13,A01,083071,Bastos; Amalia Pinkusfeld,11,0,71,60
1657814919470,COGS 14A,A01,092681,Semenuks; Arturs,5,1,100,95
1657814925493,COGS 14B,A01,083073,Cheng; Tzu-Han,6,0,63,57
1657814931525,COGS 17,A01,092677,Semenuks; Arturs,6,0,81,75
1657814937546,COGS 100,A01,083619,Allen; Michael Gordon,17,0,70,53
1657814943572,COGS 101A,A01,083621,Davis; Joshua Daniel,9,0,68,59
1657814949594,COGS 101B,A01,091572,Allen; Michael Gordon,12,0,65,53
1657814955618,COGS 101C,A01,083625,Delgado; Tania,17,0,35,18
1657814961656,COGS 107A,A01,083627,Boyle; Mary E. T.,14,0,60,46
1657814967679,COGS 118A,A01,083075,Gupta; Anjum,21,0,76,55
1657814973714,CSE 3,A50,083646,Miranda; Gregory Joseph,24,0,50,26
1657814979737,CSE 8A,A50,083650,Miranda; Gregory Joseph,17,1,56,39
1657814985764,CSE 11,A01,083080,Cao; Yingjun,6,15,40,34
1657814991786,CSE 12,A01,083652,Krause-Levy; Sophia Louisa,28,1,120,92
1657814997810,CSE 15L,A01,083654,Morris; Justin Loren,9,0,50,41
1657814997810,CSE 15L,A02,083655,Morris; Justin Loren,9,0,50,41
1657815003836,CSE 20,A01,083657,Tran; Khoa Dang,39,0,80,41
1657815009859,CSE 21,A01,095574,Bach; Quang Tran,22,0,48,26
1657815015881,CSE 30,A01,083084,Eldon; John,6,0,80,74
1657815015881,CSE 30,B01,095061,Bhaskar; Nishant,9,0,50,41
1657815021919,CSE 100,A01,083659,Cao; Yingjun,5,4,70,65
1657815027942,CSE 134B,A01,083661,Powell; Thomas Allan,24,0,100,76
1657815033964,CSE 140,A01,083663,Gungor; Onat,15,0,85,70
1657815039985,CSE 140L,A01,083088,Eldon; John,23,0,100,77
1657815046012,CSE 175,A01,083665,Kumar; Rakesh,3,0,25,22
1657815052037,CSE 190,A00,092507,Dubnov; Shlomo,8,0,20,12
1657815058061,ECE 45,A01,083139,Congero; Spencer William,6,0,75,69
1657815064085,ECE 65,A50,083695,Saad; Andrew S,12,0,30,18
1657815064085,ECE 65,A51,095125,Saad; Andrew S,24,0,26,2
1657815070107,ECE 109,A01,091882,Touri; Behrouz,20,0,70,50
1657815076133,ECE 180,A00,083140,Abi Samra; Nicholas Camill,1,0,30,29
1657815076133,ECE 180,B00,083141,Abi Samra; Nicholas Camill,0,0,30,30
1657815082165,MATH 10A,A01,083735,Patchell; Gregory David,2,0,30,28
1657815082165,MATH 10A,A02,083736,Patchell; Gregory David,20,0,30,10
1657815082165,MATH 10A,A03,083737,Patchell; Gregory David,16,0,30,14
1657815088195,MATH 10B,A01,083207,Lim; Seonhee,8,0,34,26
1657815088195,MATH 10B,A02,083208,Lim; Seonhee,10,0,35,25
1657815088195,MATH 10B,A03,093472,Lim; Seonhee,7,0,34,27
1657815088195,MATH 10B,B01,083739,Sinha; Shubham,13,0,30,17
1657815094220,MATH 18,A01,083743,Cinel; Cameron Alexander,9,0,30,21
1657815094220,MATH 18,A02,083744,Cinel; Cameron Alexander,18,0,30,12
1657815094220,MATH 18,A03,083745,Cinel; Cameron Alexander,10,0,30,20
1657815094220,MATH 18,B01,083748,Rideout; David Porter,5,0,37,32
1657815094220,MATH 18,B02,083749,Rideout; David Porter,5,0,36,31
1657815094220,MATH 18,B03,083750,Rideout; David Porter,3,0,37,34
1657815094220,MATH 18,B04,083751,Rideout; David Porter,6,0,36,30
1657815094220,MATH 18,B05,093473,Rideout; David Porter,6,0,36,30
1657815094220,MATH 18,B06,093474,Rideout; David Porter,6,0,36,30
1657815100247,MATH 20A,A01,083754,Zheng; Zequn,14,0,40,26
1657815106346,MATH 20B,A01,083756,Briones; Jor-el Thomas Caparas,4,0,36,32
1657815106346,MATH 20B,A02,083757,Briones; Jor-el Thomas Caparas,1,0,36,35
1657815106346,MATH 20B,A03,093475,Briones; Jor-el Thomas Caparas,2,0,36,34
1657815112386,MATH 20C,A01,083760,Briones; Jor-el Thomas Caparas,1,0,35,34
1657815112386,MATH 20C,A02,083761,Briones; Jor-el Thomas Caparas,8,0,35,27
1657815112386,MATH 20C,A03,093476,Briones; Jor-el Thomas Caparas,0,1,36,36
1657815112386,MATH 20C,B01,083762,Bach; Quang Tran,1,0,30,29
1657815118418,MATH 20D,A01,083765,Tran; Brian Kha,5,0,30,25
1657815118418,MATH 20D,A02,083766,Tran; Brian Kha,5,0,30,25
1657815118418,MATH 20D,A03,083767,Tran; Brian Kha,5,0,30,25
1657815124444,MATH 20E,A01,083771,Ganguly; Soumya,10,0,32,22
1657815124444,MATH 20E,A02,083772,Ganguly; Soumya,6,0,32,26
1657815124444,MATH 20E,B01,083773,Ciotti; Benjamin,20,0,35,15
1657815124444,MATH 20E,B02,083774,Ciotti; Benjamin,18,0,35,17
1657815130496,MATH 103A,A01,083777,Greenfeld; Be'Eri,3,0,36,33
1657815130496,MATH 103A,A02,083778,Greenfeld; Be'Eri,5,0,36,31
1657815130496,MATH 103A,A03,093561,Greenfeld; Be'Eri,6,0,36,30
1657815130496,MATH 103A,B01,083779,Greenfeld; Be'Eri,7,0,36,29
1657815130496,MATH 103A,B02,083780,Greenfeld; Be'Eri,4,0,36,32
1657815130496,MATH 103A,B03,093562,Greenfeld; Be'Eri,3,0,36,33
1657815136523,MATH 105,A01,085443,Carter; Anne Toulson,15,0,35,20
1657815136523,MATH 105,A02,093477,Carter; Anne Toulson,20,0,35,15
1657815142547,MATH 109,A01,083213,Ganzberger; Geoffrey Michael,3,0,34,31
1657815142547,MATH 109,A02,083214,Ganzberger; Geoffrey Michael,4,0,34,30
1657815142547,MATH 109,A03,093478,Ganzberger; Geoffrey Michael,2,0,34,32
1657815142547,MATH 109,B01,083215,Ganzberger; Geoffrey Michael,1,0,32,31
1657815142547,MATH 109,B02,083216,Ganzberger; Geoffrey Michael,2,0,32,30
1657815142547,MATH 109,B03,093479,Ganzberger; Geoffrey Michael,8,0,32,24
1657815148577,MATH 142A,A01,083219,Chow; Bennett,7,0,32,25
1657815148577,MATH 142A,A02,083220,Chow; Bennett,10,0,32,22
1657815148577,MATH 142A,A03,093480,Chow; Bennett,9,0,32,23
1657815148577,MATH 142A,B03,093481,Chow; Bennett,8,0,32,24
1657815148577,MATH 142A,B04,093558,Chow; Bennett,13,0,32,19
1657815148577,MATH 142A,B05,093559,Chow; Bennett,6,0,32,26
1657815154606,MATH 193A,A01,083224,Rotar; Vladimir,8,0,34,26
1657815154606,MATH 193A,A02,083225,Rotar; Vladimir,9,0,34,25
1657815154606,MATH 193A,A03,083781,Rotar; Vladimir,5,0,34,29
1657815154606,MATH 193A,A04,083782,Rotar; Vladimir,10,0,34,24
1657815154606,MATH 193A,A05,093482,Rotar; Vladimir,10,0,34,24
1657815160629,MATH 197,001,091859,McAuley; Julian John,9999,0,9999,0
1657815160629,MATH 197,002,095566,Kedlaya; Kiran S.,9997,0,9999,2
1657815160629,MATH 197,003,095567,Xiao; Ming,9999,0,9999,0
1657815160629,MATH 197,004,095571,Perols; Johan Lars,9998,0,9999,1
1657815167686,COGS 9,A01,083615,Shannon; Kyle Michael,9,0,75,66
1657815173709,COGS 11,A01,083617,Boyle; Mary E. T.,23,0,48,25
1657815179735,COGS 13,A01,083071,Bastos; Amalia Pinkusfeld,11,0,71,60
1657815185766,COGS 14A,A01,092681,Semenuks; Arturs,5,1,100,95
1657815191795,COGS 14B,A01,083073,Cheng; Tzu-Han,6,0,63,57
1657815197825,COGS 17,A01,092677,Semenuks; Arturs,6,0,81,75
1657815203852,COGS 100,A01,083619,Allen; Michael Gordon,17,0,70,53
1657815209875,COGS 101A,A01,083621,Davis; Joshua Daniel,9,0,68,59
1657815215902,COGS 101B,A01,091572,Allen; Michael Gordon,12,0,65,53
1657815221927,COGS 101C,A01,083625,Delgado; Tania,17,0,35,18
1657815227954,COGS 107A,A01,083627,Boyle; Mary E. T.,14,0,60,46
1657815233982,COGS 118A,A01,083075,Gupta; Anjum,21,0,76,55
1657815240016,CSE 3,A50,083646,Miranda; Gregory Joseph,24,0,50,26
1657815246043,CSE 8A,A50,083650,Miranda; Gregory Joseph,17,1,56,39
1657815252088,CSE 11,A01,083080,Cao; Yingjun,6,15,40,34
1657815258134,CSE 12,A01,083652,Krause-Levy; Sophia Louisa,28,1,120,92
1657815264157,CSE 15L,A01,083654,Morris; Justin Loren,9,0,50,41
1657815264157,CSE 15L,A02,083655,Morris; Justin Loren,9,0,50,41
1657815270180,CSE 20,A01,083657,Tran; Khoa Dang,39,0,80,41
1657815276216,CSE 21,A01,095574,Bach; Quang Tran,22,0,48,26
1657815282254,CSE 30,A01,083084,Eldon; John,6,0,80,74
1657815282254,CSE 30,B01,095061,Bhaskar; Nishant,9,0,50,41
1657815288280,CSE 100,A01,083659,Cao; Yingjun,5,4,70,65
1657815294308,CSE 134B,A01,083661,Powell; Thomas Allan,24,0,100,76
1657815300340,CSE 140,A01,083663,Gungor; Onat,15,0,85,70
1657815306374,CSE 140L,A01,083088,Eldon; John,23,0,100,77
1657815312399,CSE 175,A01,083665,Kumar; Rakesh,3,0,25,22
1657815318428,CSE 190,A00,092507,Dubnov; Shlomo,8,0,20,12
1657815324451,ECE 45,A01,083139,Congero; Spencer William,6,0,75,69
1657815330475,ECE 65,A50,083695,Saad; Andrew S,12,0,30,18
1657815330475,ECE 65,A51,095125,Saad; Andrew S,24,0,26,2
1657815336505,ECE 109,A01,091882,Touri; Behrouz,20,0,70,50
1657815342532,ECE 180,A00,083140,Abi Samra; Nicholas Camill,1,0,30,29
1657815342532,ECE 180,B00,083141,Abi Samra; Nicholas Camill,0,0,30,30
1657815348560,MATH 10A,A01,083735,Patchell; Gregory David,2,0,30,28
1657815348560,MATH 10A,A02,083736,Patchell; Gregory David,20,0,30,10
1657815348560,MATH 10A,A03,083737,Patchell; Gregory David,16,0,30,14
1657815354586,MATH 10B,A01,083207,Lim; Seonhee,8,0,34,26
1657815354586,MATH 10B,A02,083208,Lim; Seonhee,10,0,35,25
1657815354586,MATH 10B,A03,093472,Lim; Seonhee,7,0,34,27
1657815354586,MATH 10B,B01,083739,Sinha; Shubham,13,0,30,17
1657815360617,MATH 18,A01,083743,Cinel; Cameron Alexander,9,0,30,21
1657815360617,MATH 18,A02,083744,Cinel; Cameron Alexander,18,0,30,12
1657815360617,MATH 18,A03,083745,Cinel; Cameron Alexander,10,0,30,20
1657815360617,MATH 18,B01,083748,Rideout; David Porter,5,0,37,32
1657815360617,MATH 18,B02,083749,Rideout; David Porter,5,0,36,31
1657815360617,MATH 18,B03,083750,Rideout; David Porter,3,0,37,34
1657815360617,MATH 18,B04,083751,Rideout; David Porter,6,0,36,30
1657815360617,MATH 18,B05,093473,Rideout; David Porter,6,0,36,30
1657815360617,MATH 18,B06,093474,Rideout; David Porter,6,0,36,30
1657815366641,MATH 20A,A01,083754,Zheng; Zequn,14,0,40,26
1657815372664,MATH 20B,A01,083756,Briones; Jor-el Thomas Caparas,4,0,36,32
1657815372664,MATH 20B,A02,083757,Briones; Jor-el Thomas Caparas,1,0,36,35
1657815372664,MATH 20B,A03,093475,Briones; Jor-el Thomas Caparas,2,0,36,34
1657815378693,MATH 20C,A01,083760,Briones; Jor-el Thomas Caparas,1,0,35,34
1657815378693,MATH 20C,A02,083761,Briones; Jor-el Thomas Caparas,8,0,35,27
1657815378693,MATH 20C,A03,093476,Briones; Jor-el Thomas Caparas,0,1,36,36
1657815378693,MATH 20C,B01,083762,Bach; Quang Tran,1,0,30,29
1657815384716,MATH 20D,A01,083765,Tran; Brian Kha,5,0,30,25
1657815384716,MATH 20D,A02,083766,Tran; Brian Kha,5,0,30,25
1657815384716,MATH 20D,A03,083767,Tran; Brian Kha,5,0,30,25
1657815390742,MATH 20E,A01,083771,Ganguly; Soumya,10,0,32,22
1657815390742,MATH 20E,A02,083772,Ganguly; Soumya,6,0,32,26
1657815390742,MATH 20E,B01,083773,Ciotti; Benjamin,20,0,35,15
1657815390742,MATH 20E,B02,083774,Ciotti; Benjamin,18,0,35,17
1657815396769,MATH 103A,A01,083777,Greenfeld; Be'Eri,3,0,36,33
1657815396769,MATH 103A,A02,083778,Greenfeld; Be'Eri,5,0,36,31
1657815396769,MATH 103A,A03,093561,Greenfeld; Be'Eri,6,0,36,30
1657815396769,MATH 103A,B01,083779,Greenfeld; Be'Eri,7,0,36,29
1657815396769,MATH 103A,B02,083780,Greenfeld; Be'Eri,4,0,36,32
1657815396769,MATH 103A,B03,093562,Greenfeld; Be'Eri,3,0,36,33
1657815402793,MATH 105,A01,085443,Carter; Anne Toulson,15,0,35,20
1657815402793,MATH 105,A02,093477,Carter; Anne Toulson,20,0,35,15
1657815408821,MATH 109,A01,083213,Ganzberger; Geoffrey Michael,3,0,34,31
1657815408821,MATH 109,A02,083214,Ganzberger; Geoffrey Michael,4,0,34,30
1657815408821,MATH 109,A03,093478,Ganzberger; Geoffrey Michael,2,0,34,32
1657815408821,MATH 109,B01,083215,Ganzberger; Geoffrey Michael,1,0,32,31
1657815408821,MATH 109,B02,083216,Ganzberger; Geoffrey Michael,2,0,32,30
1657815408821,MATH 109,B03,093479,Ganzberger; Geoffrey Michael,8,0,32,24
1657815414844,MATH 142A,A01,083219,Chow; Bennett,7,0,32,25
1657815414844,MATH 142A,A02,083220,Chow; Bennett,10,0,32,22
1657815414844,MATH 142A,A03,093480,Chow; Bennett,9,0,32,23
1657815414844,MATH 142A,B03,093481,Chow; Bennett,8,0,32,24
1657815414844,MATH 142A,B04,093558,Chow; Bennett,13,0,32,19
1657815414844,MATH 142A,B05,093559,Chow; Bennett,6,0,32,26
1657815420872,MATH 193A,A01,083224,Rotar; Vladimir,8,0,34,26
1657815420872,MATH 193A,A02,083225,Rotar; Vladimir,9,0,34,25
1657815420872,MATH 193A,A03,083781,Rotar; Vladimir,5,0,34,29
1657815420872,MATH 193A,A04,083782,Rotar; Vladimir,10,0,34,24
1657815420872,MATH 193A,A05,093482,Rotar; Vladimir,10,0,34,24
1657815426901,MATH 197,001,091859,McAuley; Julian John,9999,0,9999,0
1657815426901,MATH 197,002,095566,Kedlaya; Kiran S.,9997,0,9999,2
1657815426901,MATH 197,003,095567,Xiao; Ming,9999,0,9999,0
1657815426901,MATH 197,004,095571,Perols; Johan Lars,9998,0,9999,1
1657815433957,COGS 9,A01,083615,Shannon; Kyle Michael,9,0,75,66
1657815439983,COGS 11,A01,083617,Boyle; Mary E. T.,23,0,48,25
1657815446005,COGS 13,A01,083071,Bastos; Amalia Pinkusfeld,11,0,71,60
1657815452033,COGS 14A,A01,092681,Semenuks; Arturs,5,1,100,95
1657815458071,COGS 14B,A01,083073,Cheng; Tzu-Han,6,0,63,57
1657815464104,COGS 17,A01,092677,Semenuks; Arturs,6,0,81,75
1657815470135,COGS 100,A01,083619,Allen; Michael Gordon,17,0,70,53
1657815476163,COGS 101A,A01,083621,Davis; Joshua Daniel,9,0,68,59
1657815482186,COGS 101B,A01,091572,Allen; Michael Gordon,12,0,65,53
1657815488209,COGS 101C,A01,083625,Delgado; Tania,17,0,35,18
1657815494236,COGS 107A,A01,083627,Boyle; Mary E. T.,14,0,60,46
1657815500264,COGS 118A,A01,083075,Gupta; Anjum,21,0,76,55
1657815506288,CSE 3,A50,083646,Miranda; Gregory Joseph,24,0,50,26
1657815512312,CSE 8A,A50,083650,Miranda; Gregory Joseph,17,1,56,39
1657815518338,CSE 11,A01,083080,Cao; Yingjun,6,15,40,34
1657815524365,CSE 12,A01,083652,Krause-Levy; Sophia Louisa,28,1,120,92
1657815530396,CSE 15L,A01,083654,Morris; Justin Loren,9,0,50,41
1657815530396,CSE 15L,A02,083655,Morris; Justin Loren,9,0,50,41
1657815536435,CSE 20,A01,083657,Tran; Khoa Dang,39,0,80,41
1657815542467,CSE 21,A01,095574,Bach; Quang Tran,22,0,48,26
1657815548494,CSE 30,A01,083084,Eldon; John,6,0,80,74
1657815548494,CSE 30,B01,095061,Bhaskar; Nishant,9,0,50,41
1657815554517,CSE 100,A01,083659,Cao; Yingjun,5,4,70,65
1657815560543,CSE 134B,A01,083661,Powell; Thomas Allan,24,0,100,76
1657815566567,CSE 140,A01,083663,Gungor; Onat,15,0,85,70
1657815572592,CSE 140L,A01,083088,Eldon; John,23,0,100,77
1657815578614,CSE 175,A01,083665,Kumar; Rakesh,3,0,25,22
1657815584640,CSE 190,A00,092507,Dubnov; Shlomo,8,0,20,12
1657815590663,ECE 45,A01,083139,Congero; Spencer William,6,0,75,69
1657815596688,ECE 65,A50,083695,Saad; Andrew S,12,0,30,18
1657815596688,ECE 65,A51,095125,Saad; Andrew S,24,0,26,2
1657815602715,ECE 109,A01,091882,Touri; Behrouz,20,0,70,50
1657815608746,ECE 180,A00,083140,Abi Samra; Nicholas Camill,1,0,30,29
1657815608746,ECE 180,B00,083141,Abi Samra; Nicholas Camill,0,0,30,30
1657815614775,MATH 10A,A01,083735,Patchell; Gregory David,2,0,30,28
1657815614775,MATH 10A,A02,083736,Patchell; Gregory David,20,0,30,10
1657815614775,MATH 10A,A03,083737,Patchell; Gregory David,16,0,30,14
1657815620799,MATH 10B,A01,083207,Lim; Seonhee,8,0,34,26
1657815620799,MATH 10B,A02,083208,Lim; Seonhee,10,0,35,25
1657815620799,MATH 10B,A03,093472,Lim; Seonhee,7,0,34,27
1657815620799,MATH 10B,B01,083739,Sinha; Shubham,13,0,30,17
1657815626825,MATH 18,A01,083743,Cinel; Cameron Alexander,9,0,30,21
1657815626825,MATH 18,A02,083744,Cinel; Cameron Alexander,18,0,30,12
1657815626825,MATH 18,A03,083745,Cinel; Cameron Alexander,10,0,30,20
1657815626825,MATH 18,B01,083748,Rideout; David Porter,5,0,37,32
1657815626825,MATH 18,B02,083749,Rideout; David Porter,5,0,36,31
1657815626825,MATH 18,B03,083750,Rideout; David Porter,3,0,37,34
1657815626825,MATH 18,B04,083751,Rideout; David Porter,6,0,36,30
1657815626825,MATH 18,B05,093473,Rideout; David Porter,6,0,36,30
1657815626825,MATH 18,B06,093474,Rideout; David Porter,6,0,36,30
1657815632849,MATH 20A,A01,083754,Zheng; Zequn,14,0,40,26
1657815638878,MATH 20B,A01,083756,Briones; Jor-el Thomas Caparas,4,0,36,32
1657815638878,MATH 20B,A02,083757,Briones; Jor-el Thomas Caparas,1,0,36,35
1657815638878,MATH 20B,A03,093475,Briones; Jor-el Thomas Caparas,2,0,36,34
1657815644905,MATH 20C,A01,083760,Briones; Jor-el Thomas Caparas,1,0,35,34
1657815644905,MATH 20C,A02,083761,Briones; Jor-el Thomas Caparas,8,0,35,27
1657815644905,MATH 20C,A03,093476,Briones; Jor-el Thomas Caparas,0,1,36,36
1657815644905,MATH 20C,B01,083762,Bach; Quang Tran,1,0,30,29
1657815650932,MATH 20D,A01,083765,Tran; Brian Kha,5,0,30,25
1657815650932,MATH 20D,A02,083766,Tran; Brian Kha,5,0,30,25
1657815650932,MATH 20D,A03,083767,Tran; Brian Kha,5,0,30,25
1657815656956,MATH 20E,A01,083771,Ganguly; Soumya,10,0,32,22
1657815656956,MATH 20E,A02,083772,Ganguly; Soumya,6,0,32,26
1657815656956,MATH 20E,B01,083773,Ciotti; Benjamin,20,0,35,15
1657815656956,MATH 20E,B02,083774,Ciotti; Benjamin,18,0,35,17
1657815662981,MATH 103A,A01,083777,Greenfeld; Be'Eri,3,0,36,33
1657815662981,MATH 103A,A02,083778,Greenfeld; Be'Eri,5,0,36,31
1657815662981,MATH 103A,A03,093561,Greenfeld; Be'Eri,6,0,36,30
1657815662981,MATH 103A,B01,083779,Greenfeld; Be'Eri,7,0,36,29
1657815662981,MATH 103A,B02,083780,Greenfeld; Be'Eri,4,0,36,32
1657815662981,MATH 103A,B03,093562,Greenfeld; Be'Eri,3,0,36,33
1657815669003,MATH 105,A01,085443,Carter; Anne Toulson,15,0,35,20
1657815669003,MATH 105,A02,093477,Carter; Anne Toulson,20,0,35,15
1657815675028,MATH 109,A01,083213,Ganzberger; Geoffrey Michael,3,0,34,31
1657815675028,MATH 109,A02,083214,Ganzberger; Geoffrey Michael,4,0,34,30
1657815675028,MATH 109,A03,093478,Ganzberger; Geoffrey Michael,2,0,34,32
1657815675028,MATH 109,B01,083215,Ganzberger; Geoffrey Michael,1,0,32,31
1657815675028,MATH 109,B02,083216,Ganzberger; Geoffrey Michael,2,0,32,30
1657815675028,MATH 109,B03,093479,Ganzberger; Geoffrey Michael,8,0,32,24
1657815681055,MATH 142A,A01,083219,Chow; Bennett,7,0,32,25
1657815681055,MATH 142A,A02,083220,Chow; Bennett,10,0,32,22
1657815681055,MATH 142A,A03,093480,Chow; Bennett,9,0,32,23
1657815681055,MATH 142A,B03,093481,Chow; Bennett,8,0,32,24
1657815681055,MATH 142A,B04,093558,Chow; Bennett,13,0,32,19
1657815681055,MATH 142A,B05,093559,Chow; Bennett,6,0,32,26
1657815687096,MATH 193A,A01,083224,Rotar; Vladimir,8,0,34,26
1657815687096,MATH 193A,A02,083225,Rotar; Vladimir,9,0,34,25
1657815687096,MATH 193A,A03,083781,Rotar; Vladimir,5,0,34,29
1657815687096,MATH 193A,A04,083782,Rotar; Vladimir,10,0,34,24
1657815687096,MATH 193A,A05,093482,Rotar; Vladimir,10,0,34,24
1657815693124,MATH 197,001,091859,McAuley; Julian John,9999,0,9999,0
1657815693124,MATH 197,002,095566,Kedlaya; Kiran S.,9997,0,9999,2
1657815693124,MATH 197,003,095567,Xiao; Ming,9999,0,9999,0
1657815693124,MATH 197,004,095571,Perols; Johan Lars,9998,0,9999,1
1657815700276,COGS 9,A01,083615,Shannon; Kyle Michael,9,0,75,66
1657815706303,COGS 11,A01,083617,Boyle; Mary E. T.,23,0,48,25
1657815712326,COGS 13,A01,083071,Bastos; Amalia Pinkusfeld,11,0,71,60
1657815718353,COGS 14A,A01,092681,Semenuks; Arturs,5,1,100,95
1657815724375,COGS 14B,A01,083073,Cheng; Tzu-Han,6,0,63,57
1657815730402,COGS 17,A01,092677,Semenuks; Arturs,6,0,81,75
1657815736428,COGS 100,A01,083619,Allen; Michael Gordon,17,0,70,53
1657815742451,COGS 101A,A01,083621,Davis; Joshua Daniel,9,0,68,59
1657815748474,COGS 101B,A01,091572,Allen; Michael Gordon,12,0,65,53
1657815754500,COGS 101C,A01,083625,Delgado; Tania,17,0,35,18
1657815760531,COGS 107A,A01,083627,Boyle; Mary E. T.,14,0,60,46
1657815766569,COGS 118A,A01,083075,Gupta; Anjum,21,0,76,55
1657815772603,CSE 3,A50,083646,Miranda; Gregory Joseph,24,0,50,26
1657815778636,CSE 8A,A50,083650,Miranda; Gregory Joseph,17,1,56,39
1657815784657,CSE 11,A01,083080,Cao; Yingjun,6,15,40,34
1657815790684,CSE 12,A01,083652,Krause-Levy; Sophia Louisa,28,1,120,92
1657815796708,CSE 15L,A01,083654,Morris; Justin Loren,9,0,50,41
1657815796708,CSE 15L,A02,083655,Morris; Justin Loren,9,0,50,41
1657815802731,CSE 20,A01,083657,Tran; Khoa Dang,39,0,80,41
1657815808757,CSE 21,A01,095574,Bach; Quang Tran,22,0,48,26
1657815814779,CSE 30,A01,083084,Eldon; John,6,0,80,74
1657815814779,CSE 30,B01,095061,Bhaskar; Nishant,9,0,50,41
1657815820801,CSE 100,A01,083659,Cao; Yingjun,5,4,70,65
1657815826832,CSE 134B,A01,083661,Powell; Thomas Allan,24,0,100,76
1657815832856,CSE 140,A01,083663,Gungor; Onat,15,0,85,70
1657815838890,CSE 140L,A01,083088,Eldon; John,23,0,100,77
1657815844916,CSE 175,A01,083665,Kumar; Rakesh,3,0,25,22
1657815850950,CSE 190,A00,092507,Dubnov; Shlomo,8,0,20,12
1657815856977,ECE 45,A01,083139,Congero; Spencer William,6,0,75,69
1657815863002,ECE 65,A50,083695,Saad; Andrew S,12,0,30,18
1657815863002,ECE 65,A51,095125,Saad; Andrew S,24,0,26,2
1657815869029,ECE 109,A01,091882,Touri; Behrouz,20,0,70,50
1657815875070,ECE 180,A00,083140,Abi Samra; Nicholas Camill,1,0,30,29
1657815875070,ECE 180,B00,083141,Abi Samra; Nicholas Camill,0,0,30,30
1657815881103,MATH 10A,A01,083735,Patchell; Gregory David,2,0,30,28
1657815881103,MATH 10A,A02,083736,Patchell; Gregory David,20,0,30,10
1657815881103,MATH 10A,A03,083737,Patchell; Gregory David,16,0,30,14
1657815887145,MATH 10B,A01,083207,Lim; Seonhee,8,0,34,26
1657815887145,MATH 10B,A02,083208,Lim; Seonhee,10,0,35,25
1657815887145,MATH 10B,A03,093472,Lim; Seonhee,7,0,34,27
1657815887145,MATH 10B,B01,083739,Sinha; Shubham,13,0,30,17
1657815893187,MATH 18,A01,083743,Cinel; Cameron Alexander,9,0,30,21
1657815893187,MATH 18,A02,083744,Cinel; Cameron Alexander,18,0,30,12
1657815893187,MATH 18,A03,083745,Cinel; Cameron Alexander,10,0,30,20
1657815893187,MATH 18,B01,083748,Rideout; David Porter,5,0,37,32
1657815893187,MATH 18,B02,083749,Rideout; David Porter,5,0,36,31
1657815893187,MATH 18,B03,083750,Rideout; David Porter,3,0,37,34
1657815893187,MATH 18,B04,083751,Rideout; David Porter,6,0,36,30
1657815893187,MATH 18,B05,093473,Rideout; David Porter,6,0,36,30
1657815893187,MATH 18,B06,093474,Rideout; David Porter,6,0,36,30
1657815899211,MATH 20A,A01,083754,Zheng; Zequn,14,0,40,26
1657815905246,MATH 20B,A01,083756,Briones; Jor-el Thomas Caparas,4,0,36,32
1657815905246,MATH 20B,A02,083757,Briones; Jor-el Thomas Caparas,1,0,36,35
1657815905246,MATH 20B,A03,093475,Briones; Jor-el Thomas Caparas,2,0,36,34
1657815911274,MATH 20C,A01,083760,Briones; Jor-el Thomas Caparas,1,0,35,34
1657815911274,MATH 20C,A02,083761,Briones; Jor-el Thomas Caparas,8,0,35,27
1657815911274,MATH 20C,A03,093476,Briones; Jor-el Thomas Caparas,0,1,36,36
1657815911274,MATH 20C,B01,083762,Bach; Quang Tran,1,0,30,29
1657815917302,MATH 20D,A01,083765,Tran; Brian Kha,5,0,30,25
1657815917302,MATH 20D,A02,083766,Tran; Brian Kha,5,0,30,25
1657815917302,MATH 20D,A03,083767,Tran; Brian Kha,5,0,30,25
1657815923329,MATH 20E,A01,083771,Ganguly; Soumya,10,0,32,22
1657815923329,MATH 20E,A02,083772,Ganguly; Soumya,6,0,32,26
1657815923329,MATH 20E,B01,083773,Ciotti; Benjamin,20,0,35,15
1657815923329,MATH 20E,B02,083774,Ciotti; Benjamin,18,0,35,17
1657815929369,MATH 103A,A01,083777,Greenfeld; Be'Eri,3,0,36,33
1657815929369,MATH 103A,A02,083778,Greenfeld; Be'Eri,5,0,36,31
1657815929369,MATH 103A,A03,093561,Greenfeld; Be'Eri,6,0,36,30
1657815929369,MATH 103A,B01,083779,Greenfeld; Be'Eri,7,0,36,29
1657815929369,MATH 103A,B02,083780,Greenfeld; Be'Eri,4,0,36,32
1657815929369,MATH 103A,B03,093562,Greenfeld; Be'Eri,3,0,36,33
1657815935396,MATH 105,A01,085443,Carter; Anne Toulson,15,0,35,20
1657815935396,MATH 105,A02,093477,Carter; Anne Toulson,20,0,35,15
1657815941418,MATH 109,A01,083213,Ganzberger; Geoffrey Michael,3,0,34,31
1657815941418,MATH 109,A02,083214,Ganzberger; Geoffrey Michael,4,0,34,30
1657815941418,MATH 109,A03,093478,Ganzberger; Geoffrey Michael,2,0,34,32
1657815941418,MATH 109,B01,083215,Ganzberger; Geoffrey Michael,1,0,32,31
1657815941418,MATH 109,B02,083216,Ganzberger; Geoffrey Michael,2,0,32,30
1657815941418,MATH 109,B03,093479,Ganzberger; Geoffrey Michael,8,0,32,24
1657815947440,MATH 142A,A01,083219,Chow; Bennett,7,0,32,25
1657815947440,MATH 142A,A02,083220,Chow; Bennett,10,0,32,22
1657815947440,MATH 142A,A03,093480,Chow; Bennett,9,0,32,23
1657815947440,MATH 142A,B03,093481,Chow; Bennett,8,0,32,24
1657815947440,MATH 142A,B04,093558,Chow; Bennett,13,0,32,19
1657815947440,MATH 142A,B05,093559,Chow; Bennett,6,0,32,26
1657815953478,MATH 193A,A01,083224,Rotar; Vladimir,8,0,34,26
1657815953478,MATH 193A,A02,083225,Rotar; Vladimir,9,0,34,25
1657815953478,MATH 193A,A03,083781,Rotar; Vladimir,5,0,34,29
1657815953478,MATH 193A,A04,083782,Rotar; Vladimir,10,0,34,24
1657815953478,MATH 193A,A05,093482,Rotar; Vladimir,10,0,34,24
1657815959504,MATH 197,001,091859,McAuley; Julian John,9999,0,9999,0
1657815959504,MATH 197,002,095566,Kedlaya; Kiran S.,9997,0,9999,2
1657815959504,MATH 197,003,095567,Xiao; Ming,9999,0,9999,0
1657815959504,MATH 197,004,095571,Perols; Johan Lars,9998,0,9999,1
1657815966572,COGS 9,A01,083615,Shannon; Kyle Michael,9,0,75,66
1657815972595,COGS 11,A01,083617,Boyle; Mary E. T.,23,0,48,25
1657815978634,COGS 13,A01,083071,Bastos; Amalia Pinkusfeld,11,0,71,60
1657815984657,COGS 14A,A01,092681,Semenuks; Arturs,5,1,100,95
1657815990685,COGS 14B,A01,083073,Cheng; Tzu-Han,6,0,63,57
1657815996711,COGS 17,A01,092677,Semenuks; Arturs,6,0,81,75
1657816002732,COGS 100,A01,083619,Allen; Michael Gordon,17,0,70,53
1657816008760,COGS 101A,A01,083621,Davis; Joshua Daniel,9,0,68,59
1657816014786,COGS 101B,A01,091572,Allen; Michael Gordon,12,0,65,53
1657816020815,COGS 101C,A01,083625,Delgado; Tania,17,0,35,18
1657816026841,COGS 107A,A01,083627,Boyle; Mary E. T.,14,0,60,46
1657816032874,COGS 118A,A01,083075,Gupta; Anjum,21,0,76,55
1657816038909,CSE 3,A50,083646,Miranda; Gregory Joseph,24,0,50,26
1657816044933,CSE 8A,A50,083650,Miranda; Gregory Joseph,17,1,56,39
1657816050957,CSE 11,A01,083080,Cao; Yingjun,6,15,40,34
1657816056985,CSE 12,A01,083652,Krause-Levy; Sophia Louisa,28,1,120,92
1657816063009,CSE 15L,A01,083654,Morris; Justin Loren,9,0,50,41
1657816063009,CSE 15L,A02,083655,Morris; Justin Loren,9,0,50,41
1657816069036,CSE 20,A01,083657,Tran; Khoa Dang,39,0,80,41
1657816075058,CSE 21,A01,095574,Bach; Quang Tran,22,0,48,26
1657816081087,CSE 30,A01,083084,Eldon; John,6,0,80,74
1657816081087,CSE 30,B01,095061,Bhaskar; Nishant,9,0,50,41
1657816087115,CSE 100,A01,083659,Cao; Yingjun,5,4,70,65
1657816093141,CSE 134B,A01,083661,Powell; Thomas Allan,24,0,100,76
1657816099164,CSE 140,A01,083663,Gungor; Onat,15,0,85,70
1657816105191,CSE 140L,A01,083088,Eldon; John,23,0,100,77
1657816111215,CSE 175,A01,083665,Kumar; Rakesh,3,0,25,22
1657816117240,CSE 190,A00,092507,Dubnov; Shlomo,8,0,20,12
1657816123262,ECE 45,A01,083139,Congero; Spencer William,6,0,75,69
1657816129288,ECE 65,A50,083695,Saad; Andrew S,12,0,30,18
1657816129288,ECE 65,A51,095125,Saad; Andrew S,24,0,26,2
1657816135320,ECE 109,A01,091882,Touri; Behrouz,20,0,70,50
1657816141343,ECE 180,A00,083140,Abi Samra; Nicholas Camill,1,0,30,29
1657816141343,ECE 180,B00,083141,Abi Samra; Nicholas Camill,0,0,30,30
1657816147370,MATH 10A,A01,083735,Patchell; Gregory David,2,0,30,28
1657816147370,MATH 10A,A02,083736,Patchell; Gregory David,20,0,30,10
1657816147370,MATH 10A,A03,083737,Patchell; Gregory David,16,0,30,14
1657816153395,MATH 10B,A01,083207,Lim; Seonhee,8,0,34,26
1657816153395,MATH 10B,A02,083208,Lim; Seonhee,10,0,35,25
1657816153395,MATH 10B,A03,093472,Lim; Seonhee,7,0,34,27
1657816153395,MATH 10B,B01,083739,Sinha; Shubham,13,0,30,17
1657816159438,MATH 18,A01,083743,Cinel; Cameron Alexander,9,0,30,21
1657816159438,MATH 18,A02,083744,Cinel; Cameron Alexander,18,0,30,12
1657816159438,MATH 18,A03,083745,Cinel; Cameron Alexander,10,0,30,20
1657816159438,MATH 18,B01,083748,Rideout; David Porter,5,0,37,32
1657816159438,MATH 18,B02,083749,Rideout; David Porter,5,0,36,31
1657816159438,MATH 18,B03,083750,Rideout; David Porter,3,0,37,34
1657816159438,MATH 18,B04,083751,Rideout; David Porter,6,0,36,30
1657816159438,MATH 18,B05,093473,Rideout; David Porter,6,0,36,30
1657816159438,MATH 18,B06,093474,Rideout; David Porter,6,0,36,30
1657816165467,MATH 20A,A01,083754,Zheng; Zequn,14,0,40,26
1657816171490,MATH 20B,A01,083756,Briones; Jor-el Thomas Caparas,4,0,36,32
1657816171490,MATH 20B,A02,083757,Briones; Jor-el Thomas Caparas,1,0,36,35
1657816171490,MATH 20B,A03,093475,Briones; Jor-el Thomas Caparas,2,0,36,34
1657816177517,MATH 20C,A01,083760,Briones; Jor-el Thomas Caparas,1,0,35,34
1657816177517,MATH 20C,A02,083761,Briones; Jor-el Thomas Caparas,8,0,35,27
1657816177517,MATH 20C,A03,093476,Briones; Jor-el Thomas Caparas,0,1,36,36
1657816177517,MATH 20C,B01,083762,Bach; Quang Tran,1,0,30,29
1657816183545,MATH 20D,A01,083765,Tran; Brian Kha,5,0,30,25
1657816183545,MATH 20D,A02,083766,Tran; Brian Kha,5,0,30,25
1657816183545,MATH 20D,A03,083767,Tran; Brian Kha,5,0,30,25
1657816189587,MATH 20E,A01,083771,Ganguly; Soumya,10,0,32,22
1657816189587,MATH 20E,A02,083772,Ganguly; Soumya,6,0,32,26
1657816189587,MATH 20E,B01,083773,Ciotti; Benjamin,20,0,35,15
1657816189587,MATH 20E,B02,083774,Ciotti; Benjamin,18,0,35,17
1657816195623,MATH 103A,A01,083777,Greenfeld; Be'Eri,3,0,36,33
1657816195623,MATH 103A,A02,083778,Greenfeld; Be'Eri,5,0,36,31
1657816195623,MATH 103A,A03,093561,Greenfeld; Be'Eri,6,0,36,30
1657816195623,MATH 103A,B01,083779,Greenfeld; Be'Eri,7,0,36,29
1657816195623,MATH 103A,B02,083780,Greenfeld; Be'Eri,4,0,36,32
1657816195623,MATH 103A,B03,093562,Greenfeld; Be'Eri,3,0,36,33
1657816201655,MATH 105,A01,085443,Carter; Anne Toulson,15,0,35,20
1657816201655,MATH 105,A02,093477,Carter; Anne Toulson,20,0,35,15
1657816207682,MATH 109,A01,083213,Ganzberger; Geoffrey Michael,3,0,34,31
1657816207682,MATH 109,A02,083214,Ganzberger; Geoffrey Michael,4,0,34,30
1657816207682,MATH 109,A03,093478,Ganzberger; Geoffrey Michael,2,0,34,32
1657816207682,MATH 109,B01,083215,Ganzberger; Geoffrey Michael,1,0,32,31
1657816207682,MATH 109,B02,083216,Ganzberger; Geoffrey Michael,2,0,32,30
1657816207682,MATH 109,B03,093479,Ganzberger; Geoffrey Michael,8,0,32,24
1657816213711,MATH 142A,A01,083219,Chow; Bennett,7,0,32,25
1657816213711,MATH 142A,A02,083220,Chow; Bennett,10,0,32,22
1657816213711,MATH 142A,A03,093480,Chow; Bennett,9,0,32,23
1657816213711,MATH 142A,B03,093481,Chow; Bennett,8,0,32,24
1657816213711,MATH 142A,B04,093558,Chow; Bennett,13,0,32,19
1657816213711,MATH 142A,B05,093559,Chow; Bennett,6,0,32,26
1657816219733,MATH 193A,A01,083224,Rotar; Vladimir,8,0,34,26
1657816219733,MATH 193A,A02,083225,Rotar; Vladimir,9,0,34,25
1657816219733,MATH 193A,A03,083781,Rotar; Vladimir,5,0,34,29
1657816219733,MATH 193A,A04,083782,Rotar; Vladimir,10,0,34,24
1657816219733,MATH 193A,A05,093482,Rotar; Vladimir,10,0,34,24
1657816225755,MATH 197,001,091859,McAuley; Julian John,9999,0,9999,0
1657816225755,MATH 197,002,095566,Kedlaya; Kiran S.,9997,0,9999,2
1657816225755,MATH 197,003,095567,Xiao; Ming,9999,0,9999,0
1657816225755,MATH 197,004,095571,Perols; Johan Lars,9998,0,9999,1
1657816232807,COGS 9,A01,083615,Shannon; Kyle Michael,9,0,75,66
1657816238833,COGS 11,A01,083617,Boyle; Mary E. T.,23,0,48,25
1657816244856,COGS 13,A01,083071,Bastos; Amalia Pinkusfeld,11,0,71,60
1657816250882,COGS 14A,A01,092681,Semenuks; Arturs,5,1,100,95
1657816256908,COGS 14B,A01,083073,Cheng; Tzu-Han,6,0,63,57
1657816262932,COGS 17,A01,092677,Semenuks; Arturs,6,0,81,75
1657816268956,COGS 100,A01,083619,Allen; Michael Gordon,17,0,70,53
1657816274983,COGS 101A,A01,083621,Davis; Joshua Daniel,9,0,68,59
1657816281011,COGS 101B,A01,091572,Allen; Michael Gordon,12,0,65,53
1657816287041,COGS 101C,A01,083625,Delgado; Tania,17,0,35,18
1657816293066,COGS 107A,A01,083627,Boyle; Mary E. T.,14,0,60,46
1657816299184,COGS 118A,A01,083075,Gupta; Anjum,21,0,76,55
1657816305208,CSE 3,A50,083646,Miranda; Gregory Joseph,24,0,50,26
1657816311239,CSE 8A,A50,083650,Miranda; Gregory Joseph,17,1,56,39
1657816317264,CSE 11,A01,083080,Cao; Yingjun,6,15,40,34
1657816323293,CSE 12,A01,083652,Krause-Levy; Sophia Louisa,28,1,120,92
1657816329316,CSE 15L,A01,083654,Morris; Justin Loren,9,0,50,41
1657816329316,CSE 15L,A02,083655,Morris; Justin Loren,9,0,50,41
1657816335342,CSE 20,A01,083657,Tran; Khoa Dang,39,0,80,41
1657816341366,CSE 21,A01,095574,Bach; Quang Tran,22,0,48,26
1657816347391,CSE 30,A01,083084,Eldon; John,6,0,80,74
1657816347391,CSE 30,B01,095061,Bhaskar; Nishant,9,0,50,41
1657816353419,CSE 100,A01,083659,Cao; Yingjun,5,4,70,65
1657816359442,CSE 134B,A01,083661,Powell; Thomas Allan,24,0,100,76
1657816365475,CSE 140,A01,083663,Gungor; Onat,15,0,85,70
1657816371500,CSE 140L,A01,083088,Eldon; John,23,0,100,77
1657816377534,CSE 175,A01,083665,Kumar; Rakesh,3,0,25,22
1657816383559,CSE 190,A00,092507,Dubnov; Shlomo,8,0,20,12
1657816389589,ECE 45,A01,083139,Congero; Spencer William,6,0,75,69
1657816395614,ECE 65,A50,083695,Saad; Andrew S,12,0,30,18
1657816395614,ECE 65,A51,095125,Saad; Andrew S,24,0,26,2
1657816401642,ECE 109,A01,091882,Touri; Behrouz,20,0,70,50
1657816407665,ECE 180,A00,083140,Abi Samra; Nicholas Camill,1,0,30,29
1657816407665,ECE 180,B00,083141,Abi Samra; Nicholas Camill,0,0,30,30
1657816413692,MATH 10A,A01,083735,Patchell; Gregory David,2,0,30,28
1657816413692,MATH 10A,A02,083736,Patchell; Gregory David,20,0,30,10
1657816413692,MATH 10A,A03,083737,Patchell; Gregory David,16,0,30,14
1657816419718,MATH 10B,A01,083207,Lim; Seonhee,8,0,34,26
1657816419718,MATH 10B,A02,083208,Lim; Seonhee,10,0,35,25
1657816419718,MATH 10B,A03,093472,Lim; Seonhee,7,0,34,27
1657816419718,MATH 10B,B01,083739,Sinha; Shubham,13,0,30,17
1657816425744,MATH 18,A01,083743,Cinel; Cameron Alexander,9,0,30,21
1657816425744,MATH 18,A02,083744,Cinel; Cameron Alexander,18,0,30,12
1657816425744,MATH 18,A03,083745,Cinel; Cameron Alexander,10,0,30,20
1657816425744,MATH 18,B01,083748,Rideout; David Porter,5,0,37,32
1657816425744,MATH 18,B02,083749,Rideout; David Porter,5,0,36,31
1657816425744,MATH 18,B03,083750,Rideout; David Porter,3,0,37,34
1657816425744,MATH 18,B04,083751,Rideout; David Porter,6,0,36,30
1657816425744,MATH 18,B05,093473,Rideout; David Porter,6,0,36,30
1657816425744,MATH 18,B06,093474,Rideout; David Porter,6,0,36,30
1657816431767,MATH 20A,A01,083754,Zheng; Zequn,14,0,40,26
1657816437790,MATH 20B,A01,083756,Briones; Jor-el Thomas Caparas,4,0,36,32
1657816437790,MATH 20B,A02,083757,Briones; Jor-el Thomas Caparas,1,0,36,35
1657816437790,MATH 20B,A03,093475,Briones; Jor-el Thomas Caparas,2,0,36,34
1657816443818,MATH 20C,A01,083760,Briones; Jor-el Thomas Caparas,1,0,35,34
1657816443818,MATH 20C,A02,083761,Briones; Jor-el Thomas Caparas,8,0,35,27
1657816443818,MATH 20C,A03,093476,Briones; Jor-el Thomas Caparas,0,1,36,36
1657816443818,MATH 20C,B01,083762,Bach; Quang Tran,1,0,30,29
1657816449844,MATH 20D,A01,083765,Tran; Brian Kha,5,0,30,25
1657816449844,MATH 20D,A02,083766,Tran; Brian Kha,5,0,30,25
1657816449844,MATH 20D,A03,083767,Tran; Brian Kha,5,0,30,25
1657816455870,MATH 20E,A01,083771,Ganguly; Soumya,10,0,32,22
1657816455870,MATH 20E,A02,083772,Ganguly; Soumya,6,0,32,26
1657816455870,MATH 20E,B01,083773,Ciotti; Benjamin,20,0,35,15
1657816455870,MATH 20E,B02,083774,Ciotti; Benjamin,18,0,35,17
1657816461910,MATH 103A,A01,083777,Greenfeld; Be'Eri,3,0,36,33
1657816461910,MATH 103A,A02,083778,Greenfeld; Be'Eri,5,0,36,31
1657816461910,MATH 103A,A03,093561,Greenfeld; Be'Eri,6,0,36,30
1657816461910,MATH 103A,B01,083779,Greenfeld; Be'Eri,7,0,36,29
1657816461910,MATH 103A,B02,083780,Greenfeld; Be'Eri,4,0,36,32
1657816461910,MATH 103A,B03,093562,Greenfeld; Be'Eri,3,0,36,33
1657816467948,MATH 105,A01,085443,Carter; Anne Toulson,15,0,35,20
1657816467948,MATH 105,A02,093477,Carter; Anne Toulson,20,0,35,15
1657816473976,MATH 109,A01,083213,Ganzberger; Geoffrey Michael,3,0,34,31
1657816473976,MATH 109,A02,083214,Ganzberger; Geoffrey Michael,4,0,34,30
1657816473976,MATH 109,A03,093478,Ganzberger; Geoffrey Michael,2,0,34,32
1657816473976,MATH 109,B01,083215,Ganzberger; Geoffrey Michael,1,0,32,31
1657816473976,MATH 109,B02,083216,Ganzberger; Geoffrey Michael,2,0,32,30
1657816473976,MATH 109,B03,093479,Ganzberger; Geoffrey Michael,8,0,32,24
1657816480005,MATH 142A,A01,083219,Chow; Bennett,7,0,32,25
1657816480005,MATH 142A,A02,083220,Chow; Bennett,10,0,32,22
1657816480005,MATH 142A,A03,093480,Chow; Bennett,9,0,32,23
1657816480005,MATH 142A,B03,093481,Chow; Bennett,8,0,32,24
1657816480005,MATH 142A,B04,093558,Chow; Bennett,13,0,32,19
1657816480005,MATH 142A,B05,093559,Chow; Bennett,6,0,32,26
1657816486036,MATH 193A,A01,083224,Rotar; Vladimir,8,0,34,26
1657816486036,MATH 193A,A02,083225,Rotar; Vladimir,9,0,34,25
1657816486036,MATH 193A,A03,083781,Rotar; Vladimir,5,0,34,29
1657816486036,MATH 193A,A04,083782,Rotar; Vladimir,10,0,34,24
1657816486036,MATH 193A,A05,093482,Rotar; Vladimir,10,0,34,24
1657816492063,MATH 197,001,091859,McAuley; Julian John,9999,0,9999,0
1657816492063,MATH 197,002,095566,Kedlaya; Kiran S.,9997,0,9999,2
1657816492063,MATH 197,003,095567,Xiao; Ming,9999,0,9999,0
1657816492063,MATH 197,004,095571,Perols; Johan Lars,9998,0,9999,1
1657816499119,COGS 9,A01,083615,Shannon; Kyle Michael,9,0,75,66
1657816505151,COGS 11,A01,083617,Boyle; Mary E. T.,23,0,48,25
1657816511173,COGS 13,A01,083071,Bastos; Amalia Pinkusfeld,11,0,71,60
1657816517200,COGS 14A,A01,092681,Semenuks; Arturs,5,1,100,95
1657816523224,COGS 14B,A01,083073,Cheng; Tzu-Han,6,0,63,57
1657816529276,COGS 17,A01,092677,Semenuks; Arturs,6,0,81,75
1657816535298,COGS 100,A01,083619,Allen; Michael Gordon,17,0,70,53
1657816541323,COGS 101A,A01,083621,Davis; Joshua Daniel,9,0,68,59
1657816547349,COGS 101B,A01,091572,Allen; Michael Gordon,12,0,65,53
1657816553405,COGS 101C,A01,083625,Delgado; Tania,17,0,35,18
1657816559430,COGS 107A,A01,083627,Boyle; Mary E. T.,14,0,60,46
1657816565455,COGS 118A,A01,083075,Gupta; Anjum,21,0,76,55
1657816571497,CSE 3,A50,083646,Miranda; Gregory Joseph,24,0,50,26
1657816577525,CSE 8A,A50,083650,Miranda; Gregory Joseph,17,1,56,39
1657816583553,CSE 11,A01,083080,Cao; Yingjun,6,15,40,34
1657816589582,CSE 12,A01,083652,Krause-Levy; Sophia Louisa,28,1,120,92
1657816595605,CSE 15L,A01,083654,Morris; Justin Loren,9,0,50,41
1657816595605,CSE 15L,A02,083655,Morris; Justin Loren,9,0,50,41
1657816601630,CSE 20,A01,083657,Tran; Khoa Dang,39,0,80,41
1657816607658,CSE 21,A01,095574,Bach; Quang Tran,22,0,48,26
1657816613685,CSE 30,A01,083084,Eldon; John,6,0,80,74
1657816613685,CSE 30,B01,095061,Bhaskar; Nishant,9,0,50,41
1657816619719,CSE 100,A01,083659,Cao; Yingjun,5,4,70,65
1657816625751,CSE 134B,A01,083661,Powell; Thomas Allan,24,0,100,76
1657816631772,CSE 140,A01,083663,Gungor; Onat,15,0,85,70
1657816637796,CSE 140L,A01,083088,Eldon; John,23,0,100,77
1657816643823,CSE 175,A01,083665,Kumar; Rakesh,3,0,25,22
1657816649849,CSE 190,A00,092507,Dubnov; Shlomo,8,0,20,12
1657816655874,ECE 45,A01,083139,Congero; Spencer William,6,0,75,69
1657816661898,ECE 65,A50,083695,Saad; Andrew S,12,0,30,18
1657816661898,ECE 65,A51,095125,Saad; Andrew S,24,0,26,2
1657816667936,ECE 109,A01,091882,Touri; Behrouz,20,0,70,50
1657816673960,ECE 180,A00,083140,Abi Samra; Nicholas Camill,1,0,30,29
1657816673960,ECE 180,B00,083141,Abi Samra; Nicholas Camill,0,0,30,30
1657816680036,MATH 10A,A01,083735,Patchell; Gregory David,2,0,30,28
1657816680036,MATH 10A,A02,083736,Patchell; Gregory David,20,0,30,10
1657816680036,MATH 10A,A03,083737,Patchell; Gregory David,16,0,30,14
1657816686061,MATH 10B,A01,083207,Lim; Seonhee,8,0,34,26
1657816686061,MATH 10B,A02,083208,Lim; Seonhee,10,0,35,25
1657816686061,MATH 10B,A03,093472,Lim; Seonhee,7,0,34,27
1657816686061,MATH 10B,B01,083739,Sinha; Shubham,13,0,30,17
1657816692085,MATH 18,A01,083743,Cinel; Cameron Alexander,9,0,30,21
1657816692085,MATH 18,A02,083744,Cinel; Cameron Alexander,18,0,30,12
1657816692085,MATH 18,A03,083745,Cinel; Cameron Alexander,10,0,30,20
1657816692085,MATH 18,B01,083748,Rideout; David Porter,5,0,37,32
1657816692085,MATH 18,B02,083749,Rideout; David Porter,5,0,36,31
1657816692085,MATH 18,B03,083750,Rideout; David Porter,3,0,37,34
1657816692085,MATH 18,B04,083751,Rideout; David Porter,6,0,36,30
1657816692085,MATH 18,B05,093473,Rideout; David Porter,6,0,36,30
1657816692085,MATH 18,B06,093474,Rideout; David Porter,6,0,36,30
1657816698122,MATH 20A,A01,083754,Zheng; Zequn,14,0,40,26
1657816704145,MATH 20B,A01,083756,Briones; Jor-el Thomas Caparas,4,0,36,32
1657816704145,MATH 20B,A02,083757,Briones; Jor-el Thomas Caparas,1,0,36,35
1657816704145,MATH 20B,A03,093475,Briones; Jor-el Thomas Caparas,2,0,36,34
1657816710186,MATH 20C,A01,083760,Briones; Jor-el Thomas Caparas,1,0,35,34
1657816710186,MATH 20C,A02,083761,Briones; Jor-el Thomas Caparas,8,0,35,27
1657816710186,MATH 20C,A03,093476,Briones; Jor-el Thomas Caparas,0,1,36,36
1657816710186,MATH 20C,B01,083762,Bach; Quang Tran,1,0,30,29
1657816716210,MATH 20D,A01,083765,Tran; Brian Kha,5,0,30,25
1657816716210,MATH 20D,A02,083766,Tran; Brian Kha,5,0,30,25
1657816716210,MATH 20D,A03,083767,Tran; Brian Kha,5,0,30,25
1657816722234,MATH 20E,A01,083771,Ganguly; Soumya,10,0,32,22
1657816722234,MATH 20E,A02,083772,Ganguly; Soumya,6,0,32,26
1657816722234,MATH 20E,B01,083773,Ciotti; Benjamin,20,0,35,15
1657816722234,MATH 20E,B02,083774,Ciotti; Benjamin,18,0,35,17
1657816728276,MATH 103A,A01,083777,Greenfeld; Be'Eri,3,0,36,33
1657816728276,MATH 103A,A02,083778,Greenfeld; Be'Eri,5,0,36,31
1657816728276,MATH 103A,A03,093561,Greenfeld; Be'Eri,6,0,36,30
1657816728276,MATH 103A,B01,083779,Greenfeld; Be'Eri,7,0,36,29
1657816728276,MATH 103A,B02,083780,Greenfeld; Be'Eri,4,0,36,32
1657816728276,MATH 103A,B03,093562,Greenfeld; Be'Eri,3,0,36,33
1657816734304,MATH 105,A01,085443,Carter; Anne Toulson,15,0,35,20
1657816734304,MATH 105,A02,093477,Carter; Anne Toulson,20,0,35,15
1657816740329,MATH 109,A01,083213,Ganzberger; Geoffrey Michael,3,0,34,31
1657816740329,MATH 109,A02,083214,Ganzberger; Geoffrey Michael,4,0,34,30
1657816740329,MATH 109,A03,093478,Ganzberger; Geoffrey Michael,2,0,34,32
1657816740329,MATH 109,B01,083215,Ganzberger; Geoffrey Michael,1,0,32,31
1657816740329,MATH 109,B02,083216,Ganzberger; Geoffrey Michael,2,0,32,30
1657816740329,MATH 109,B03,093479,Ganzberger; Geoffrey Michael,8,0,32,24
1657816746361,MATH 142A,A01,083219,Chow; Bennett,7,0,32,25
1657816746361,MATH 142A,A02,083220,Chow; Bennett,10,0,32,22
1657816746361,MATH 142A,A03,093480,Chow; Bennett,9,0,32,23
1657816746361,MATH 142A,B03,093481,Chow; Bennett,8,0,32,24
1657816746361,MATH 142A,B04,093558,Chow; Bennett,13,0,32,19
1657816746361,MATH 142A,B05,093559,Chow; Bennett,6,0,32,26
1657816752385,MATH 193A,A01,083224,Rotar; Vladimir,8,0,34,26
1657816752385,MATH 193A,A02,083225,Rotar; Vladimir,9,0,34,25
1657816752385,MATH 193A,A03,083781,Rotar; Vladimir,5,0,34,29
1657816752385,MATH 193A,A04,083782,Rotar; Vladimir,10,0,34,24
1657816752385,MATH 193A,A05,093482,Rotar; Vladimir,10,0,34,24
1657816758409,MATH 197,001,091859,McAuley; Julian John,9999,0,9999,0
1657816758409,MATH 197,002,095566,Kedlaya; Kiran S.,9997,0,9999,2
1657816758409,MATH 197,003,095567,Xiao; Ming,9999,0,9999,0
1657816758409,MATH 197,004,095571,Perols; Johan Lars,9998,0,9999,1
1657816765473,COGS 9,A01,083615,Shannon; Kyle Michael,9,0,75,66
1657816771500,COGS 11,A01,083617,Boyle; Mary E. T.,23,0,48,25
1657816777526,COGS 13,A01,083071,Bastos; Amalia Pinkusfeld,11,0,71,60
1657816783553,COGS 14A,A01,092681,Semenuks; Arturs,5,1,100,95
1657816789576,COGS 14B,A01,083073,Cheng; Tzu-Han,6,0,63,57
1657816795598,COGS 17,A01,092677,Semenuks; Arturs,6,0,81,75
1657816801620,COGS 100,A01,083619,Allen; Michael Gordon,17,0,70,53
1657816807646,COGS 101A,A01,083621,Davis; Joshua Daniel,9,0,68,59
1657816813694,COGS 101B,A01,091572,Allen; Michael Gordon,12,0,65,53
1657816819716,COGS 101C,A01,083625,Delgado; Tania,17,0,35,18
1657816825740,COGS 107A,A01,083627,Boyle; Mary E. T.,14,0,60,46
1657816831762,COGS 118A,A01,083075,Gupta; Anjum,21,0,76,55
1657816837788,CSE 3,A50,083646,Miranda; Gregory Joseph,24,0,50,26
1657816843814,CSE 8A,A50,083650,Miranda; Gregory Joseph,17,1,56,39
1657816849835,CSE 11,A01,083080,Cao; Yingjun,6,15,40,34
1657816855862,CSE 12,A01,083652,Krause-Levy; Sophia Louisa,28,1,120,92
1657816861899,CSE 15L,A01,083654,Morris; Justin Loren,9,0,50,41
1657816861899,CSE 15L,A02,083655,Morris; Justin Loren,9,0,50,41
1657816867930,CSE 20,A01,083657,Tran; Khoa Dang,39,0,80,41
1657816873961,CSE 21,A01,095574,Bach; Quang Tran,22,0,48,26
1657816880001,CSE 30,A01,083084,Eldon; John,6,0,80,74
1657816880001,CSE 30,B01,095061,Bhaskar; Nishant,9,0,50,41
1657816886028,CSE 100,A01,083659,Cao; Yingjun,5,4,70,65
1657816892060,CSE 134B,A01,083661,Powell; Thomas Allan,24,0,100,76
1657816898165,CSE 140,A01,083663,Gungor; Onat,15,0,85,70
1657816904206,CSE 140L,A01,083088,Eldon; John,23,0,100,77
1657816910228,CSE 175,A01,083665,Kumar; Rakesh,3,0,25,22
1657816916258,CSE 190,A00,092507,Dubnov; Shlomo,8,0,20,12
1657816922284,ECE 45,A01,083139,Congero; Spencer William,6,0,75,69
1657816928320,ECE 65,A50,083695,Saad; Andrew S,12,0,30,18
1657816928320,ECE 65,A51,095125,Saad; Andrew S,24,0,26,2
1657816934345,ECE 109,A01,091882,Touri; Behrouz,20,0,70,50
1657816940381,ECE 180,A00,083140,Abi Samra; Nicholas Camill,1,0,30,29
1657816940381,ECE 180,B00,083141,Abi Samra; Nicholas Camill,0,0,30,30
1657816946408,MATH 10A,A01,083735,Patchell; Gregory David,2,0,30,28
1657816946408,MATH 10A,A02,083736,Patchell; Gregory David,20,0,30,10
1657816946408,MATH 10A,A03,083737,Patchell; Gregory David,16,0,30,14
1657816952440,MATH 10B,A01,083207,Lim; Seonhee,8,0,34,26
1657816952440,MATH 10B,A02,083208,Lim; Seonhee,10,0,35,25
1657816952440,MATH 10B,A03,093472,Lim; Seonhee,7,0,34,27
1657816952440,MATH 10B,B01,083739,Sinha; Shubham,13,0,30,17
1657816958473,MATH 18,A01,083743,Cinel; Cameron Alexander,9,0,30,21
1657816958473,MATH 18,A02,083744,Cinel; Cameron Alexander,18,0,30,12
1657816958473,MATH 18,A03,083745,Cinel; Cameron Alexander,10,0,30,20
1657816958473,MATH 18,B01,083748,Rideout; David Porter,5,0,37,32
1657816958473,MATH 18,B02,083749,Rideout; David Porter,5,0,36,31
1657816958473,MATH 18,B03,083750,Rideout; David Porter,3,0,37,34
1657816958473,MATH 18,B04,083751,Rideout; David Porter,6,0,36,30
1657816958473,MATH 18,B05,093473,Rideout; David Porter,6,0,36,30
1657816958473,MATH 18,B06,093474,Rideout; David Porter,6,0,36,30
1657816964504,MATH 20A,A01,083754,Zheng; Zequn,14,0,40,26
1657816970532,MATH 20B,A01,083756,Briones; Jor-el Thomas Caparas,4,0,36,32
1657816970532,MATH 20B,A02,083757,Briones; Jor-el Thomas Caparas,1,0,36,35
1657816970532,MATH 20B,A03,093475,Briones; Jor-el Thomas Caparas,2,0,36,34
1657816976562,MATH 20C,A01,083760,Briones; Jor-el Thomas Caparas,1,0,35,34
1657816976562,MATH 20C,A02,083761,Briones; Jor-el Thomas Caparas,8,0,35,27
1657816976562,MATH 20C,A03,093476,Briones; Jor-el Thomas Caparas,0,1,36,36
1657816976562,MATH 20C,B01,083762,Bach; Quang Tran,1,0,30,29
1657816982586,MATH 20D,A01,083765,Tran; Brian Kha,5,0,30,25
1657816982586,MATH 20D,A02,083766,Tran; Brian Kha,5,0,30,25
1657816982586,MATH 20D,A03,083767,Tran; Brian Kha,5,0,30,25
1657816988610,MATH 20E,A01,083771,Ganguly; Soumya,10,0,32,22
1657816988610,MATH 20E,A02,083772,Ganguly; Soumya,6,0,32,26
1657816988610,MATH 20E,B01,083773,Ciotti; Benjamin,20,0,35,15
1657816988610,MATH 20E,B02,083774,Ciotti; Benjamin,18,0,35,17
1657816994639,MATH 103A,A01,083777,Greenfeld; Be'Eri,3,0,36,33
1657816994639,MATH 103A,A02,083778,Greenfeld; Be'Eri,5,0,36,31
1657816994639,MATH 103A,A03,093561,Greenfeld; Be'Eri,6,0,36,30
1657816994639,MATH 103A,B01,083779,Greenfeld; Be'Eri,7,0,36,29
1657816994639,MATH 103A,B02,083780,Greenfeld; Be'Eri,4,0,36,32
1657816994639,MATH 103A,B03,093562,Greenfeld; Be'Eri,3,0,36,33
1657817000661,MATH 105,A01,085443,Carter; Anne Toulson,15,0,35,20
1657817000661,MATH 105,A02,093477,Carter; Anne Toulson,20,0,35,15
1657817006697,MATH 109,A01,083213,Ganzberger; Geoffrey Michael,3,0,34,31
1657817006697,MATH 109,A02,083214,Ganzberger; Geoffrey Michael,4,0,34,30
1657817006697,MATH 109,A03,093478,Ganzberger; Geoffrey Michael,2,0,34,32
1657817006697,MATH 109,B01,083215,Ganzberger; Geoffrey Michael,1,0,32,31
1657817006697,MATH 109,B02,083216,Ganzberger; Geoffrey Michael,2,0,32,30
1657817006697,MATH 109,B03,093479,Ganzberger; Geoffrey Michael,8,0,32,24
1657817012726,MATH 142A,A01,083219,Chow; Bennett,7,0,32,25
1657817012726,MATH 142A,A02,083220,Chow; Bennett,10,0,32,22
1657817012726,MATH 142A,A03,093480,Chow; Bennett,9,0,32,23
1657817012726,MATH 142A,B03,093481,Chow; Bennett,8,0,32,24
1657817012726,MATH 142A,B04,093558,Chow; Bennett,13,0,32,19
1657817012726,MATH 142A,B05,093559,Chow; Bennett,6,0,32,26
1657817018761,MATH 193A,A01,083224,Rotar; Vladimir,8,0,34,26
1657817018761,MATH 193A,A02,083225,Rotar; Vladimir,9,0,34,25
1657817018761,MATH 193A,A03,083781,Rotar; Vladimir,5,0,34,29
1657817018761,MATH 193A,A04,083782,Rotar; Vladimir,10,0,34,24
1657817018761,MATH 193A,A05,093482,Rotar; Vladimir,10,0,34,24
1657817024788,MATH 197,001,091859,McAuley; Julian John,9999,0,9999,0
1657817024788,MATH 197,002,095566,Kedlaya; Kiran S.,9997,0,9999,2
1657817024788,MATH 197,003,095567,Xiao; Ming,9999,0,9999,0
1657817024788,MATH 197,004,095571,Perols; Johan Lars,9998,0,9999,1
1657817031853,COGS 9,A01,083615,Shannon; Kyle Michael,9,0,75,66
1657817037874,COGS 11,A01,083617,Boyle; Mary E. T.,23,0,48,25
1657817043898,COGS 13,A01,083071,Bastos; Amalia Pinkusfeld,11,0,71,60
1657817049920,COGS 14A,A01,092681,Semenuks; Arturs,5,1,100,95
1657817055951,COGS 14B,A01,083073,Cheng; Tzu-Han,6,0,63,57
1657817061976,COGS 17,A01,092677,Semenuks; Arturs,6,0,81,75
1657817068002,COGS 100,A01,083619,Allen; Michael Gordon,17,0,70,53
1657817074029,COGS 101A,A01,083621,Davis; Joshua Daniel,9,0,68,59
1657817080052,COGS 101B,A01,091572,Allen; Michael Gordon,12,0,65,53
1657817086076,COGS 101C,A01,083625,Delgado; Tania,17,0,35,18
1657817092107,COGS 107A,A01,083627,Boyle; Mary E. T.,14,0,60,46
1657817098130,COGS 118A,A01,083075,Gupta; Anjum,21,0,76,55
1657817104160,CSE 3,A50,083646,Miranda; Gregory Joseph,24,0,50,26
1657817110183,CSE 8A,A50,083650,Miranda; Gregory Joseph,17,1,56,39
1657817116206,CSE 11,A01,083080,Cao; Yingjun,6,15,40,34
1657817122233,CSE 12,A01,083652,Krause-Levy; Sophia Louisa,28,1,120,92
1657817128255,CSE 15L,A01,083654,Morris; Justin Loren,9,0,50,41
1657817128255,CSE 15L,A02,083655,Morris; Justin Loren,9,0,50,41
1657817134291,CSE 20,A01,083657,Tran; Khoa Dang,39,0,80,41
1657817140315,CSE 21,A01,095574,Bach; Quang Tran,22,0,48,26
1657817146338,CSE 30,A01,083084,Eldon; John,6,0,80,74
1657817146338,CSE 30,B01,095061,Bhaskar; Nishant,9,0,50,41
1657817152364,CSE 100,A01,083659,Cao; Yingjun,5,4,70,65
1657817158399,CSE 134B,A01,083661,Powell; Thomas Allan,24,0,100,76
1657817164426,CSE 140,A01,083663,Gungor; Onat,15,0,85,70
1657817170452,CSE 140L,A01,083088,Eldon; John,23,0,100,77
1657817176475,CSE 175,A01,083665,Kumar; Rakesh,3,0,25,22
1657817182506,CSE 190,A00,092507,Dubnov; Shlomo,8,0,20,12
1657817188532,ECE 45,A01,083139,Congero; Spencer William,6,0,75,69
1657817194569,ECE 65,A50,083695,Saad; Andrew S,12,0,30,18
1657817194569,ECE 65,A51,095125,Saad; Andrew S,24,0,26,2
1657817200598,ECE 109,A01,091882,Touri; Behrouz,20,0,70,50
1657817206619,ECE 180,A00,083140,Abi Samra; Nicholas Camill,1,0,30,29
1657817206619,ECE 180,B00,083141,Abi Samra; Nicholas Camill,0,0,30,30
1657817212647,MATH 10A,A01,083735,Patchell; Gregory David,2,0,30,28
1657817212647,MATH 10A,A02,083736,Patchell; Gregory David,20,0,30,10
1657817212647,MATH 10A,A03,083737,Patchell; Gregory David,16,0,30,14
1657817218672,MATH 10B,A01,083207,Lim; Seonhee,8,0,34,26
1657817218672,MATH 10B,A02,083208,Lim; Seonhee,10,0,35,25
1657817218672,MATH 10B,A03,093472,Lim; Seonhee,7,0,34,27
1657817218672,MATH 10B,B01,083739,Sinha; Shubham,13,0,30,17
1657817224779,MATH 18,A01,083743,Cinel; Cameron Alexander,9,0,30,21
1657817224779,MATH 18,A02,083744,Cinel; Cameron Alexander,18,0,30,12
1657817224779,MATH 18,A03,083745,Cinel; Cameron Alexander,10,0,30,20
1657817224779,MATH 18,B01,083748,Rideout; David Porter,5,0,37,32
1657817224779,MATH 18,B02,083749,Rideout; David Porter,5,0,36,31
1657817224779,MATH 18,B03,083750,Rideout; David Porter,3,0,37,34
1657817224779,MATH 18,B04,083751,Rideout; David Porter,6,0,36,30
1657817224779,MATH 18,B05,093473,Rideout; David Porter,6,0,36,30
1657817224779,MATH 18,B06,093474,Rideout; David Porter,6,0,36,30
1657817230800,MATH 20A,A01,083754,Zheng; Zequn,14,0,40,26
1657817236827,MATH 20B,A01,083756,Briones; Jor-el Thomas Caparas,4,0,36,32
1657817236827,MATH 20B,A02,083757,Briones; Jor-el Thomas Caparas,1,0,36,35
1657817236827,MATH 20B,A03,093475,Briones; Jor-el Thomas Caparas,2,0,36,34
1657817242856,MATH 20C,A01,083760,Briones; Jor-el Thomas Caparas,1,0,35,34
1657817242856,MATH 20C,A02,083761,Briones; Jor-el Thomas Caparas,8,0,35,27
1657817242856,MATH 20C,A03,093476,Briones; Jor-el Thomas Caparas,0,1,36,36
1657817242856,MATH 20C,B01,083762,Bach; Quang Tran,1,0,30,29
1657817248883,MATH 20D,A01,083765,Tran; Brian Kha,5,0,30,25
1657817248883,MATH 20D,A02,083766,Tran; Brian Kha,5,0,30,25
1657817248883,MATH 20D,A03,083767,Tran; Brian Kha,5,0,30,25
1657817254907,MATH 20E,A01,083771,Ganguly; Soumya,10,0,32,22
1657817254907,MATH 20E,A02,083772,Ganguly; Soumya,6,0,32,26
1657817254907,MATH 20E,B01,083773,Ciotti; Benjamin,20,0,35,15
1657817254907,MATH 20E,B02,083774,Ciotti; Benjamin,18,0,35,17
1657817260944,MATH 103A,A01,083777,Greenfeld; Be'Eri,3,0,36,33
1657817260944,MATH 103A,A02,083778,Greenfeld; Be'Eri,5,0,36,31
1657817260944,MATH 103A,A03,093561,Greenfeld; Be'Eri,6,0,36,30
1657817260944,MATH 103A,B01,083779,Greenfeld; Be'Eri,7,0,36,29
1657817260944,MATH 103A,B02,083780,Greenfeld; Be'Eri,4,0,36,32
1657817260944,MATH 103A,B03,093562,Greenfeld; Be'Eri,3,0,36,33
1657817266973,MATH 105,A01,085443,Carter; Anne Toulson,15,0,35,20
1657817266973,MATH 105,A02,093477,Carter; Anne Toulson,20,0,35,15
1657817272996,MATH 109,A01,083213,Ganzberger; Geoffrey Michael,3,0,34,31
1657817272996,MATH 109,A02,083214,Ganzberger; Geoffrey Michael,4,0,34,30
1657817272996,MATH 109,A03,093478,Ganzberger; Geoffrey Michael,2,0,34,32
1657817272996,MATH 109,B01,083215,Ganzberger; Geoffrey Michael,1,0,32,31
1657817272996,MATH 109,B02,083216,Ganzberger; Geoffrey Michael,2,0,32,30
1657817272996,MATH 109,B03,093479,Ganzberger; Geoffrey Michael,8,0,32,24
1657817279025,MATH 142A,A01,083219,Chow; Bennett,7,0,32,25
1657817279025,MATH 142A,A02,083220,Chow; Bennett,10,0,32,22
1657817279025,MATH 142A,A03,093480,Chow; Bennett,9,0,32,23
1657817279025,MATH 142A,B03,093481,Chow; Bennett,8,0,32,24
1657817279025,MATH 142A,B04,093558,Chow; Bennett,13,0,32,19
1657817279025,MATH 142A,B05,093559,Chow; Bennett,6,0,32,26
1657817285057,MATH 193A,A01,083224,Rotar; Vladimir,8,0,34,26
1657817285057,MATH 193A,A02,083225,Rotar; Vladimir,9,0,34,25
1657817285057,MATH 193A,A03,083781,Rotar; Vladimir,5,0,34,29
1657817285057,MATH 193A,A04,083782,Rotar; Vladimir,10,0,34,24
1657817285057,MATH 193A,A05,093482,Rotar; Vladimir,10,0,34,24
1657817291087,MATH 197,001,091859,McAuley; Julian John,9999,0,9999,0
1657817291087,MATH 197,002,095566,Kedlaya; Kiran S.,9997,0,9999,2
1657817291087,MATH 197,003,095567,Xiao; Ming,9999,0,9999,0
1657817291087,MATH 197,004,095571,Perols; Johan Lars,9998,0,9999,1
1657817298139,COGS 9,A01,083615,Shannon; Kyle Michael,9,0,75,66
1657817304162,COGS 11,A01,083617,Boyle; Mary E. T.,23,0,48,25
1657817310185,COGS 13,A01,083071,Bastos; Amalia Pinkusfeld,11,0,71,60
1657817316216,COGS 14A,A01,092681,Semenuks; Arturs,5,1,100,95
1657817322239,COGS 14B,A01,083073,Cheng; Tzu-Han,6,0,63,57
1657817328261,COGS 17,A01,092677,Semenuks; Arturs,6,0,81,75
1657817334284,COGS 100,A01,083619,Allen; Michael Gordon,17,0,70,53
1657817340307,COGS 101A,A01,083621,Davis; Joshua Daniel,9,0,68,59
1657817346333,COGS 101B,A01,091572,Allen; Michael Gordon,12,0,65,53
1657817352362,COGS 101C,A01,083625,Delgado; Tania,17,0,35,18
1657817358386,COGS 107A,A01,083627,Boyle; Mary E. T.,14,0,60,46
1657817364411,COGS 118A,A01,083075,Gupta; Anjum,21,0,76,55
1657817370437,CSE 3,A50,083646,Miranda; Gregory Joseph,24,0,50,26
1657817376477,CSE 8A,A50,083650,Miranda; Gregory Joseph,17,1,56,39
1657817382562,CSE 11,A01,083080,Cao; Yingjun,6,15,40,34
1657817388589,CSE 12,A01,083652,Krause-Levy; Sophia Louisa,28,1,120,92
1657817394615,CSE 15L,A01,083654,Morris; Justin Loren,9,0,50,41
1657817394615,CSE 15L,A02,083655,Morris; Justin Loren,9,0,50,41
1657817400642,CSE 20,A01,083657,Tran; Khoa Dang,39,0,80,41
1657817406665,CSE 21,A01,095574,Bach; Quang Tran,22,0,48,26
1657817412690,CSE 30,A01,083084,Eldon; John,6,0,80,74
1657817412690,CSE 30,B01,095061,Bhaskar; Nishant,9,0,50,41
1657817418712,CSE 100,A01,083659,Cao; Yingjun,5,4,70,65
1657817424738,CSE 134B,A01,083661,Powell; Thomas Allan,24,0,100,76
1657817430767,CSE 140,A01,083663,Gungor; Onat,15,0,85,70
1657817436795,CSE 140L,A01,083088,Eldon; John,23,0,100,77
1657817442818,CSE 175,A01,083665,Kumar; Rakesh,3,0,25,22
1657817448844,CSE 190,A00,092507,Dubnov; Shlomo,8,0,20,12
1657817454867,ECE 45,A01,083139,Congero; Spencer William,6,0,75,69
1657817460891,ECE 65,A50,083695,Saad; Andrew S,12,0,30,18
1657817460891,ECE 65,A51,095125,Saad; Andrew S,24,0,26,2
1657817466913,ECE 109,A01,091882,Touri; Behrouz,20,0,70,50
1657817472938,ECE 180,A00,083140,Abi Samra; Nicholas Camill,1,0,30,29
1657817472938,ECE 180,B00,083141,Abi Samra; Nicholas Camill,0,0,30,30
1657817478964,MATH 10A,A01,083735,Patchell; Gregory David,2,0,30,28
1657817478964,MATH 10A,A02,083736,Patchell; Gregory David,20,0,30,10
1657817478964,MATH 10A,A03,083737,Patchell; Gregory David,16,0,30,14
1657817485012,MATH 10B,A01,083207,Lim; Seonhee,8,0,34,26
1657817485012,MATH 10B,A02,083208,Lim; Seonhee,10,0,35,25
1657817485012,MATH 10B,A03,093472,Lim; Seonhee,7,0,34,27
1657817485012,MATH 10B,B01,083739,Sinha; Shubham,13,0,30,17
1657817491045,MATH 18,A01,083743,Cinel; Cameron Alexander,9,0,30,21
1657817491045,MATH 18,A02,083744,Cinel; Cameron Alexander,18,0,30,12
1657817491045,MATH 18,A03,083745,Cinel; Cameron Alexander,10,0,30,20
1657817491045,MATH 18,B01,083748,Rideout; David Porter,5,0,37,32
1657817491045,MATH 18,B02,083749,Rideout; David Porter,5,0,36,31
1657817491045,MATH 18,B03,083750,Rideout; David Porter,3,0,37,34
1657817491045,MATH 18,B04,083751,Rideout; David Porter,6,0,36,30
1657817491045,MATH 18,B05,093473,Rideout; David Porter,6,0,36,30
1657817491045,MATH 18,B06,093474,Rideout; David Porter,6,0,36,30
1657817497143,MATH 20A,A01,083754,Zheng; Zequn,14,0,40,26
1657817503180,MATH 20B,A01,083756,Briones; Jor-el Thomas Caparas,4,0,36,32
1657817503180,MATH 20B,A02,083757,Briones; Jor-el Thomas Caparas,1,0,36,35
1657817503180,MATH 20B,A03,093475,Briones; Jor-el Thomas Caparas,2,0,36,34
1657817509207,MATH 20C,A01,083760,Briones; Jor-el Thomas Caparas,1,0,35,34
1657817509207,MATH 20C,A02,083761,Briones; Jor-el Thomas Caparas,8,0,35,27
1657817509207,MATH 20C,A03,093476,Briones; Jor-el Thomas Caparas,0,1,36,36
1657817509207,MATH 20C,B01,083762,Bach; Quang Tran,1,0,30,29
1657817515229,MATH 20D,A01,083765,Tran; Brian Kha,5,0,30,25
1657817515229,MATH 20D,A02,083766,Tran; Brian Kha,5,0,30,25
1657817515229,MATH 20D,A03,083767,Tran; Brian Kha,5,0,30,25
1657817521256,MATH 20E,A01,083771,Ganguly; Soumya,10,0,32,22
1657817521256,MATH 20E,A02,083772,Ganguly; Soumya,6,0,32,26
1657817521256,MATH 20E,B01,083773,Ciotti; Benjamin,20,0,35,15
1657817521256,MATH 20E,B02,083774,Ciotti; Benjamin,18,0,35,17
1657817527279,MATH 103A,A01,083777,Greenfeld; Be'Eri,3,0,36,33
1657817527279,MATH 103A,A02,083778,Greenfeld; Be'Eri,5,0,36,31
1657817527279,MATH 103A,A03,093561,Greenfeld; Be'Eri,6,0,36,30
1657817527279,MATH 103A,B01,083779,Greenfeld; Be'Eri,7,0,36,29
1657817527279,MATH 103A,B02,083780,Greenfeld; Be'Eri,4,0,36,32
1657817527279,MATH 103A,B03,093562,Greenfeld; Be'Eri,3,0,36,33
1657817533302,MATH 105,A01,085443,Carter; Anne Toulson,15,0,35,20
1657817533302,MATH 105,A02,093477,Carter; Anne Toulson,20,0,35,15
1657817539331,MATH 109,A01,083213,Ganzberger; Geoffrey Michael,3,0,34,31
1657817539331,MATH 109,A02,083214,Ganzberger; Geoffrey Michael,4,0,34,30
1657817539331,MATH 109,A03,093478,Ganzberger; Geoffrey Michael,2,0,34,32
1657817539331,MATH 109,B01,083215,Ganzberger; Geoffrey Michael,1,0,32,31
1657817539331,MATH 109,B02,083216,Ganzberger; Geoffrey Michael,2,0,32,30
1657817539331,MATH 109,B03,093479,Ganzberger; Geoffrey Michael,8,0,32,24
1657817545368,MATH 142A,A01,083219,Chow; Bennett,7,0,32,25
1657817545368,MATH 142A,A02,083220,Chow; Bennett,10,0,32,22
1657817545368,MATH 142A,A03,093480,Chow; Bennett,9,0,32,23
1657817545368,MATH 142A,B03,093481,Chow; Bennett,8,0,32,24
1657817545368,MATH 142A,B04,093558,Chow; Bennett,13,0,32,19
1657817545368,MATH 142A,B05,093559,Chow; Bennett,6,0,32,26
1657817551392,MATH 193A,A01,083224,Rotar; Vladimir,8,0,34,26
1657817551392,MATH 193A,A02,083225,Rotar; Vladimir,9,0,34,25
1657817551392,MATH 193A,A03,083781,Rotar; Vladimir,5,0,34,29
1657817551392,MATH 193A,A04,083782,Rotar; Vladimir,10,0,34,24
1657817551392,MATH 193A,A05,093482,Rotar; Vladimir,10,0,34,24
1657817557430,MATH 197,001,091859,McAuley; Julian John,9999,0,9999,0
1657817557430,MATH 197,002,095566,Kedlaya; Kiran S.,9997,0,9999,2
1657817557430,MATH 197,003,095567,Xiao; Ming,9999,0,9999,0
1657817557430,MATH 197,004,095571,Perols; Johan Lars,9998,0,9999,1
1657817564489,COGS 9,A01,083615,Shannon; Kyle Michael,9,0,75,66
1657817570518,COGS 11,A01,083617,Boyle; Mary E. T.,23,0,48,25
1657817576539,COGS 13,A01,083071,Bastos; Amalia Pinkusfeld,11,0,71,60
1657817582569,COGS 14A,A01,092681,Semenuks; Arturs,5,1,100,95
1657817588595,COGS 14B,A01,083073,Cheng; Tzu-Han,6,0,63,57
1657817594623,COGS 17,A01,092677,Semenuks; Arturs,6,0,81,75
1657817600646,COGS 100,A01,083619,Allen; Michael Gordon,17,0,70,53
1657817606678,COGS 101A,A01,083621,Davis; Joshua Daniel,9,0,68,59
1657817612702,COGS 101B,A01,091572,Allen; Michael Gordon,12,0,65,53
1657817618726,COGS 101C,A01,083625,Delgado; Tania,17,0,35,18
1657817624749,COGS 107A,A01,083627,Boyle; Mary E. T.,14,0,60,46
1657817630775,COGS 118A,A01,083075,Gupta; Anjum,21,0,76,55
1657817636802,CSE 3,A50,083646,Miranda; Gregory Joseph,24,0,50,26
1657817642826,CSE 8A,A50,083650,Miranda; Gregory Joseph,17,1,56,39
1657817648857,CSE 11,A01,083080,Cao; Yingjun,6,15,40,34
1657817654881,CSE 12,A01,083652,Krause-Levy; Sophia Louisa,28,1,120,92
1657817660910,CSE 15L,A01,083654,Morris; Justin Loren,9,0,50,41
1657817660910,CSE 15L,A02,083655,Morris; Justin Loren,9,0,50,41
1657817666937,CSE 20,A01,083657,Tran; Khoa Dang,39,0,80,41
1657817672962,CSE 21,A01,095574,Bach; Quang Tran,22,0,48,26
1657817678991,CSE 30,A01,083084,Eldon; John,6,0,80,74
1657817678991,CSE 30,B01,095061,Bhaskar; Nishant,9,0,50,41
1657817685016,CSE 100,A01,083659,Cao; Yingjun,5,4,70,65
1657817691038,CSE 134B,A01,083661,Powell; Thomas Allan,24,0,100,76
1657817697077,CSE 140,A01,083663,Gungor; Onat,15,0,85,70
1657817703108,CSE 140L,A01,083088,Eldon; John,23,0,100,77
1657817709138,CSE 175,A01,083665,Kumar; Rakesh,3,0,25,22
1657817715164,CSE 190,A00,092507,Dubnov; Shlomo,8,0,20,12
1657817721197,ECE 45,A01,083139,Congero; Spencer William,6,0,75,69
1657817727228,ECE 65,A50,083695,Saad; Andrew S,12,0,30,18
1657817727228,ECE 65,A51,095125,Saad; Andrew S,24,0,26,2
1657817733249,ECE 109,A01,091882,Touri; Behrouz,20,0,70,50
1657817739281,ECE 180,A00,083140,Abi Samra; Nicholas Camill,1,0,30,29
1657817739281,ECE 180,B00,083141,Abi Samra; Nicholas Camill,0,0,30,30
1657817745308,MATH 10A,A01,083735,Patchell; Gregory David,2,0,30,28
1657817745308,MATH 10A,A02,083736,Patchell; Gregory David,20,0,30,10
1657817745308,MATH 10A,A03,083737,Patchell; Gregory David,16,0,30,14
1657817751342,MATH 10B,A01,083207,Lim; Seonhee,8,0,34,26
1657817751342,MATH 10B,A02,083208,Lim; Seonhee,10,0,35,25
1657817751342,MATH 10B,A03,093472,Lim; Seonhee,7,0,34,27
1657817751342,MATH 10B,B01,083739,Sinha; Shubham,13,0,30,17
1657817757365,MATH 18,A01,083743,Cinel; Cameron Alexander,9,0,30,21
1657817757365,MATH 18,A02,083744,Cinel; Cameron Alexander,18,0,30,12
1657817757365,MATH 18,A03,083745,Cinel; Cameron Alexander,10,0,30,20
1657817757365,MATH 18,B01,083748,Rideout; David Porter,5,0,37,32
1657817757365,MATH 18,B02,083749,Rideout; David Porter,5,0,36,31
1657817757365,MATH 18,B03,083750,Rideout; David Porter,3,0,37,34
1657817757365,MATH 18,B04,083751,Rideout; David Porter,6,0,36,30
1657817757365,MATH 18,B05,093473,Rideout; David Porter,6,0,36,30
1657817757365,MATH 18,B06,093474,Rideout; David Porter,6,0,36,30
1657817763391,MATH 20A,A01,083754,Zheng; Zequn,14,0,40,26
1657817769413,MATH 20B,A01,083756,Briones; Jor-el Thomas Caparas,4,0,36,32
1657817769413,MATH 20B,A02,083757,Briones; Jor-el Thomas Caparas,1,0,36,35
1657817769413,MATH 20B,A03,093475,Briones; Jor-el Thomas Caparas,2,0,36,34
1657817775436,MATH 20C,A01,083760,Briones; Jor-el Thomas Caparas,1,0,35,34
1657817775436,MATH 20C,A02,083761,Briones; Jor-el Thomas Caparas,8,0,35,27
1657817775436,MATH 20C,A03,093476,Briones; Jor-el Thomas Caparas,0,1,36,36
1657817775436,MATH 20C,B01,083762,Bach; Quang Tran,1,0,30,29
1657817781466,MATH 20D,A01,083765,Tran; Brian Kha,5,0,30,25
1657817781466,MATH 20D,A02,083766,Tran; Brian Kha,5,0,30,25
1657817781466,MATH 20D,A03,083767,Tran; Brian Kha,5,0,30,25
1657817787496,MATH 20E,A01,083771,Ganguly; Soumya,10,0,32,22
1657817787496,MATH 20E,A02,083772,Ganguly; Soumya,6,0,32,26
1657817787496,MATH 20E,B01,083773,Ciotti; Benjamin,20,0,35,15
1657817787496,MATH 20E,B02,083774,Ciotti; Benjamin,18,0,35,17
1657817793524,MATH 103A,A01,083777,Greenfeld; Be'Eri,3,0,36,33
1657817793524,MATH 103A,A02,083778,Greenfeld; Be'Eri,5,0,36,31
1657817793524,MATH 103A,A03,093561,Greenfeld; Be'Eri,6,0,36,30
1657817793524,MATH 103A,B01,083779,Greenfeld; Be'Eri,7,0,36,29
1657817793524,MATH 103A,B02,083780,Greenfeld; Be'Eri,4,0,36,32
1657817793524,MATH 103A,B03,093562,Greenfeld; Be'Eri,3,0,36,33
1657817799554,MATH 105,A01,085443,Carter; Anne Toulson,15,0,35,20
1657817799554,MATH 105,A02,093477,Carter; Anne Toulson,20,0,35,15
1657817805582,MATH 109,A01,083213,Ganzberger; Geoffrey Michael,3,0,34,31
1657817805582,MATH 109,A02,083214,Ganzberger; Geoffrey Michael,4,0,34,30
1657817805582,MATH 109,A03,093478,Ganzberger; Geoffrey Michael,2,0,34,32
1657817805582,MATH 109,B01,083215,Ganzberger; Geoffrey Michael,1,0,32,31
1657817805582,MATH 109,B02,083216,Ganzberger; Geoffrey Michael,2,0,32,30
1657817805582,MATH 109,B03,093479,Ganzberger; Geoffrey Michael,8,0,32,24
1657817811606,MATH 142A,A01,083219,Chow; Bennett,7,0,32,25
1657817811606,MATH 142A,A02,083220,Chow; Bennett,10,0,32,22
1657817811606,MATH 142A,A03,093480,Chow; Bennett,9,0,32,23
1657817811606,MATH 142A,B03,093481,Chow; Bennett,8,0,32,24
1657817811606,MATH 142A,B04,093558,Chow; Bennett,13,0,32,19
1657817811606,MATH 142A,B05,093559,Chow; Bennett,6,0,32,26
1657817817641,MATH 193A,A01,083224,Rotar; Vladimir,8,0,34,26
1657817817641,MATH 193A,A02,083225,Rotar; Vladimir,9,0,34,25
1657817817641,MATH 193A,A03,083781,Rotar; Vladimir,5,0,34,29
1657817817641,MATH 193A,A04,083782,Rotar; Vladimir,10,0,34,24
1657817817641,MATH 193A,A05,093482,Rotar; Vladimir,10,0,34,24
1657817823667,MATH 197,001,091859,McAuley; Julian John,9999,0,9999,0
1657817823667,MATH 197,002,095566,Kedlaya; Kiran S.,9997,0,9999,2
1657817823667,MATH 197,003,095567,Xiao; Ming,9999,0,9999,0
1657817823667,MATH 197,004,095571,Perols; Johan Lars,9998,0,9999,1
1657817830742,COGS 9,A01,083615,Shannon; Kyle Michael,9,0,75,66
1657817836766,COGS 11,A01,083617,Boyle; Mary E. T.,23,0,48,25
1657817842789,COGS 13,A01,083071,Bastos; Amalia Pinkusfeld,11,0,71,60
1657817848815,COGS 14A,A01,092681,Semenuks; Arturs,5,1,100,95
1657817854837,COGS 14B,A01,083073,Cheng; Tzu-Han,6,0,63,57
1657817860859,COGS 17,A01,092677,Semenuks; Arturs,6,0,81,75
1657817866885,COGS 100,A01,083619,Allen; Michael Gordon,17,0,70,53
1657817872910,COGS 101A,A01,083621,Davis; Joshua Daniel,9,0,68,59
1657817878933,COGS 101B,A01,091572,Allen; Michael Gordon,12,0,65,53
1657817884966,COGS 101C,A01,083625,Delgado; Tania,17,0,35,18
1657817891006,COGS 107A,A01,083627,Boyle; Mary E. T.,14,0,60,46
1657817897036,COGS 118A,A01,083075,Gupta; Anjum,21,0,76,55
1657817903063,CSE 3,A50,083646,Miranda; Gregory Joseph,24,0,50,26
1657817909100,CSE 8A,A50,083650,Miranda; Gregory Joseph,17,1,56,39
1657817915132,CSE 11,A01,083080,Cao; Yingjun,6,15,40,34
1657817921155,CSE 12,A01,083652,Krause-Levy; Sophia Louisa,28,1,120,92
1657817927184,CSE 15L,A01,083654,Morris; Justin Loren,9,0,50,41
1657817927184,CSE 15L,A02,083655,Morris; Justin Loren,9,0,50,41
1657817933212,CSE 20,A01,083657,Tran; Khoa Dang,39,0,80,41
1657817939235,CSE 21,A01,095574,Bach; Quang Tran,22,0,48,26
1657817945267,CSE 30,A01,083084,Eldon; John,6,0,80,74
1657817945267,CSE 30,B01,095061,Bhaskar; Nishant,9,0,50,41
1657817951291,CSE 100,A01,083659,Cao; Yingjun,5,4,70,65
1657817957318,CSE 134B,A01,083661,Powell; Thomas Allan,24,0,100,76
1657817963347,CSE 140,A01,083663,Gungor; Onat,15,0,85,70
1657817969373,CSE 140L,A01,083088,Eldon; John,23,0,100,77
1657817975406,CSE 175,A01,083665,Kumar; Rakesh,3,0,25,22
1657817981442,CSE 190,A00,092507,Dubnov; Shlomo,8,0,20,12
1657817987469,ECE 45,A01,083139,Congero; Spencer William,6,0,75,69
1657817993493,ECE 65,A50,083695,Saad; Andrew S,12,0,30,18
1657817993493,ECE 65,A51,095125,Saad; Andrew S,24,0,26,2
1657817999531,ECE 109,A01,091882,Touri; Behrouz,20,0,70,50
1657818005554,ECE 180,A00,083140,Abi Samra; Nicholas Camill,1,0,30,29
1657818005554,ECE 180,B00,083141,Abi Samra; Nicholas Camill,0,0,30,30
1657818011585,MATH 10A,A01,083735,Patchell; Gregory David,2,0,30,28
1657818011585,MATH 10A,A02,083736,Patchell; Gregory David,20,0,30,10
1657818011585,MATH 10A,A03,083737,Patchell; Gregory David,16,0,30,14
1657818017609,MATH 10B,A01,083207,Lim; Seonhee,8,0,34,26
1657818017609,MATH 10B,A02,083208,Lim; Seonhee,10,0,35,25
1657818017609,MATH 10B,A03,093472,Lim; Seonhee,7,0,34,27
1657818017609,MATH 10B,B01,083739,Sinha; Shubham,13,0,30,17
1657818023637,MATH 18,A01,083743,Cinel; Cameron Alexander,9,0,30,21
1657818023637,MATH 18,A02,083744,Cinel; Cameron Alexander,18,0,30,12
1657818023637,MATH 18,A03,083745,Cinel; Cameron Alexander,10,0,30,20
1657818023637,MATH 18,B01,083748,Rideout; David Porter,5,0,37,32
1657818023637,MATH 18,B02,083749,Rideout; David Porter,5,0,36,31
1657818023637,MATH 18,B03,083750,Rideout; David Porter,3,0,37,34
1657818023637,MATH 18,B04,083751,Rideout; David Porter,6,0,36,30
1657818023637,MATH 18,B05,093473,Rideout; David Porter,6,0,36,30
1657818023637,MATH 18,B06,093474,Rideout; David Porter,6,0,36,30
1657818029668,MATH 20A,A01,083754,Zheng; Zequn,14,0,40,26
1657818035690,MATH 20B,A01,083756,Briones; Jor-el Thomas Caparas,4,0,36,32
1657818035690,MATH 20B,A02,083757,Briones; Jor-el Thomas Caparas,1,0,36,35
1657818035690,MATH 20B,A03,093475,Briones; Jor-el Thomas Caparas,2,0,36,34
1657818041727,MATH 20C,A01,083760,Briones; Jor-el Thomas Caparas,1,0,35,34
1657818041727,MATH 20C,A02,083761,Briones; Jor-el Thomas Caparas,8,0,35,27
1657818041727,MATH 20C,A03,093476,Briones; Jor-el Thomas Caparas,0,1,36,36
1657818041727,MATH 20C,B01,083762,Bach; Quang Tran,1,0,30,29
1657818047752,MATH 20D,A01,083765,Tran; Brian Kha,5,0,30,25
1657818047752,MATH 20D,A02,083766,Tran; Brian Kha,5,0,30,25
1657818047752,MATH 20D,A03,083767,Tran; Brian Kha,5,0,30,25
1657818053775,MATH 20E,A01,083771,Ganguly; Soumya,10,0,32,22
1657818053775,MATH 20E,A02,083772,Ganguly; Soumya,6,0,32,26
1657818053775,MATH 20E,B01,083773,Ciotti; Benjamin,20,0,35,15
1657818053775,MATH 20E,B02,083774,Ciotti; Benjamin,18,0,35,17
1657818059800,MATH 103A,A01,083777,Greenfeld; Be'Eri,3,0,36,33
1657818059800,MATH 103A,A02,083778,Greenfeld; Be'Eri,5,0,36,31
1657818059800,MATH 103A,A03,093561,Greenfeld; Be'Eri,6,0,36,30
1657818059800,MATH 103A,B01,083779,Greenfeld; Be'Eri,7,0,36,29
1657818059800,MATH 103A,B02,083780,Greenfeld; Be'Eri,4,0,36,32
1657818059800,MATH 103A,B03,093562,Greenfeld; Be'Eri,3,0,36,33
1657818065826,MATH 105,A01,085443,Carter; Anne Toulson,15,0,35,20
1657818065826,MATH 105,A02,093477,Carter; Anne Toulson,20,0,35,15
1657818071849,MATH 109,A01,083213,Ganzberger; Geoffrey Michael,3,0,34,31
1657818071849,MATH 109,A02,083214,Ganzberger; Geoffrey Michael,4,0,34,30
1657818071849,MATH 109,A03,093478,Ganzberger; Geoffrey Michael,2,0,34,32
1657818071849,MATH 109,B01,083215,Ganzberger; Geoffrey Michael,1,0,32,31
1657818071849,MATH 109,B02,083216,Ganzberger; Geoffrey Michael,2,0,32,30
1657818071849,MATH 109,B03,093479,Ganzberger; Geoffrey Michael,8,0,32,24
1657818077877,MATH 142A,A01,083219,Chow; Bennett,7,0,32,25
1657818077877,MATH 142A,A02,083220,Chow; Bennett,10,0,32,22
1657818077877,MATH 142A,A03,093480,Chow; Bennett,9,0,32,23
1657818077877,MATH 142A,B03,093481,Chow; Bennett,8,0,32,24
1657818077877,MATH 142A,B04,093558,Chow; Bennett,13,0,32,19
1657818077877,MATH 142A,B05,093559,Chow; Bennett,7,0,32,25
1657818083916,MATH 193A,A01,083224,Rotar; Vladimir,8,0,34,26
1657818083916,MATH 193A,A02,083225,Rotar; Vladimir,9,0,34,25
1657818083916,MATH 193A,A03,083781,Rotar; Vladimir,5,0,34,29
1657818083916,MATH 193A,A04,083782,Rotar; Vladimir,11,0,34,23
1657818083916,MATH 193A,A05,093482,Rotar; Vladimir,10,0,34,24
1657818089942,MATH 197,001,091859,McAuley; Julian John,9999,0,9999,0
1657818089942,MATH 197,002,095566,Kedlaya; Kiran S.,9997,0,9999,2
1657818089942,MATH 197,003,095567,Xiao; Ming,9999,0,9999,0
1657818089942,MATH 197,004,095571,Perols; Johan Lars,9998,0,9999,1
1657818097088,COGS 9,A01,083615,Shannon; Kyle Michael,9,0,75,66
1657818103112,COGS 11,A01,083617,Boyle; Mary E. T.,23,0,48,25
1657818109140,COGS 13,A01,083071,Bastos; Amalia Pinkusfeld,11,0,71,60
1657818115164,COGS 14A,A01,092681,Semenuks; Arturs,5,1,100,95
1657818121189,COGS 14B,A01,083073,Cheng; Tzu-Han,6,0,63,57
1657818127214,COGS 17,A01,092677,Semenuks; Arturs,6,0,81,75
1657818133238,COGS 100,A01,083619,Allen; Michael Gordon,17,0,70,53
1657818139270,COGS 101A,A01,083621,Davis; Joshua Daniel,9,0,68,59
1657818145293,COGS 101B,A01,091572,Allen; Michael Gordon,12,0,65,53
1657818151319,COGS 101C,A01,083625,Delgado; Tania,17,0,35,18
1657818157342,COGS 107A,A01,083627,Boyle; Mary E. T.,14,0,60,46
1657818163371,COGS 118A,A01,083075,Gupta; Anjum,21,0,76,55
1657818169395,CSE 3,A50,083646,Miranda; Gregory Joseph,24,0,50,26
1657818175424,CSE 8A,A50,083650,Miranda; Gregory Joseph,17,1,56,39
1657818181454,CSE 11,A01,083080,Cao; Yingjun,6,15,40,34
1657818187479,CSE 12,A01,083652,Krause-Levy; Sophia Louisa,28,1,120,92
1657818193506,CSE 15L,A01,083654,Morris; Justin Loren,9,0,50,41
1657818193506,CSE 15L,A02,083655,Morris; Justin Loren,9,0,50,41
1657818199530,CSE 20,A01,083657,Tran; Khoa Dang,39,0,80,41
1657818205552,CSE 21,A01,095574,Bach; Quang Tran,22,0,48,26
1657818211580,CSE 30,A01,083084,Eldon; John,6,0,80,74
1657818211580,CSE 30,B01,095061,Bhaskar; Nishant,9,0,50,41
1657818217607,CSE 100,A01,083659,Cao; Yingjun,5,4,70,65
1657818223636,CSE 134B,A01,083661,Powell; Thomas Allan,24,0,100,76
1657818229663,CSE 140,A01,083663,Gungor; Onat,15,0,85,70
1657818235684,CSE 140L,A01,083088,Eldon; John,23,0,100,77
1657818241725,CSE 175,A01,083665,Kumar; Rakesh,3,0,25,22
1657818247748,CSE 190,A00,092507,Dubnov; Shlomo,8,0,20,12
1657818253772,ECE 45,A01,083139,Congero; Spencer William,6,0,75,69
1657818259794,ECE 65,A50,083695,Saad; Andrew S,12,0,30,18
1657818259794,ECE 65,A51,095125,Saad; Andrew S,24,0,26,2
1657818265816,ECE 109,A01,091882,Touri; Behrouz,20,0,70,50
1657818271842,ECE 180,A00,083140,Abi Samra; Nicholas Camill,1,0,30,29
1657818271842,ECE 180,B00,083141,Abi Samra; Nicholas Camill,0,0,30,30
1657818277875,MATH 10A,A01,083735,Patchell; Gregory David,2,0,30,28
1657818277875,MATH 10A,A02,083736,Patchell; Gregory David,20,0,30,10
1657818277875,MATH 10A,A03,083737,Patchell; Gregory David,16,0,30,14
1657818283902,MATH 10B,A01,083207,Lim; Seonhee,8,0,34,26
1657818283902,MATH 10B,A02,083208,Lim; Seonhee,10,0,35,25
1657818283902,MATH 10B,A03,093472,Lim; Seonhee,7,0,34,27
1657818283902,MATH 10B,B01,083739,Sinha; Shubham,13,0,30,17
1657818289932,MATH 18,A01,083743,Cinel; Cameron Alexander,9,0,30,21
1657818289932,MATH 18,A02,083744,Cinel; Cameron Alexander,18,0,30,12
1657818289932,MATH 18,A03,083745,Cinel; Cameron Alexander,10,0,30,20
1657818289932,MATH 18,B01,083748,Rideout; David Porter,5,0,37,32
1657818289932,MATH 18,B02,083749,Rideout; David Porter,5,0,36,31
1657818289932,MATH 18,B03,083750,Rideout; David Porter,3,0,37,34
1657818289932,MATH 18,B04,083751,Rideout; David Porter,6,0,36,30
1657818289932,MATH 18,B05,093473,Rideout; David Porter,6,0,36,30
1657818289932,MATH 18,B06,093474,Rideout; David Porter,6,0,36,30
1657818295955,MATH 20A,A01,083754,Zheng; Zequn,14,0,40,26
1657818301978,MATH 20B,A01,083756,Briones; Jor-el Thomas Caparas,4,0,36,32
1657818301978,MATH 20B,A02,083757,Briones; Jor-el Thomas Caparas,1,0,36,35
1657818301978,MATH 20B,A03,093475,Briones; Jor-el Thomas Caparas,2,0,36,34
1657818308005,MATH 20C,A01,083760,Briones; Jor-el Thomas Caparas,1,0,35,34
1657818308005,MATH 20C,A02,083761,Briones; Jor-el Thomas Caparas,8,0,35,27
1657818308005,MATH 20C,A03,093476,Briones; Jor-el Thomas Caparas,0,1,36,36
1657818308005,MATH 20C,B01,083762,Bach; Quang Tran,1,0,30,29
1657818314032,MATH 20D,A01,083765,Tran; Brian Kha,5,0,30,25
1657818314032,MATH 20D,A02,083766,Tran; Brian Kha,5,0,30,25
1657818314032,MATH 20D,A03,083767,Tran; Brian Kha,5,0,30,25
1657818320055,MATH 20E,A01,083771,Ganguly; Soumya,10,0,32,22
1657818320055,MATH 20E,A02,083772,Ganguly; Soumya,6,0,32,26
1657818320055,MATH 20E,B01,083773,Ciotti; Benjamin,20,0,35,15
1657818320055,MATH 20E,B02,083774,Ciotti; Benjamin,18,0,35,17
1657818326079,MATH 103A,A01,083777,Greenfeld; Be'Eri,3,0,36,33
1657818326079,MATH 103A,A02,083778,Greenfeld; Be'Eri,5,0,36,31
1657818326079,MATH 103A,A03,093561,Greenfeld; Be'Eri,6,0,36,30
1657818326079,MATH 103A,B01,083779,Greenfeld; Be'Eri,7,0,36,29
1657818326079,MATH 103A,B02,083780,Greenfeld; Be'Eri,4,0,36,32
1657818326079,MATH 103A,B03,093562,Greenfeld; Be'Eri,3,0,36,33
1657818332102,MATH 105,A01,085443,Carter; Anne Toulson,15,0,35,20
1657818332102,MATH 105,A02,093477,Carter; Anne Toulson,20,0,35,15
1657818338128,MATH 109,A01,083213,Ganzberger; Geoffrey Michael,3,0,34,31
1657818338128,MATH 109,A02,083214,Ganzberger; Geoffrey Michael,4,0,34,30
1657818338128,MATH 109,A03,093478,Ganzberger; Geoffrey Michael,2,0,34,32
1657818338128,MATH 109,B01,083215,Ganzberger; Geoffrey Michael,1,0,32,31
1657818338128,MATH 109,B02,083216,Ganzberger; Geoffrey Michael,2,0,32,30
1657818338128,MATH 109,B03,093479,Ganzberger; Geoffrey Michael,8,0,32,24
1657818344153,MATH 142A,A01,083219,Chow; Bennett,7,0,32,25
1657818344153,MATH 142A,A02,083220,Chow; Bennett,10,0,32,22
1657818344153,MATH 142A,A03,093480,Chow; Bennett,9,0,32,23
1657818344153,MATH 142A,B03,093481,Chow; Bennett,8,0,32,24
1657818344153,MATH 142A,B04,093558,Chow; Bennett,13,0,32,19
1657818344153,MATH 142A,B05,093559,Chow; Bennett,7,0,32,25
1657818350188,MATH 193A,A01,083224,Rotar; Vladimir,8,0,34,26
1657818350188,MATH 193A,A02,083225,Rotar; Vladimir,9,0,34,25
1657818350188,MATH 193A,A03,083781,Rotar; Vladimir,5,0,34,29
1657818350188,MATH 193A,A04,083782,Rotar; Vladimir,11,0,34,23
1657818350188,MATH 193A,A05,093482,Rotar; Vladimir,10,0,34,24
1657818356214,MATH 197,001,091859,McAuley; Julian John,9999,0,9999,0
1657818356214,MATH 197,002,095566,Kedlaya; Kiran S.,9997,0,9999,2
1657818356214,MATH 197,003,095567,Xiao; Ming,9999,0,9999,0
1657818356214,MATH 197,004,095571,Perols; Johan Lars,9998,0,9999,1
1657818363288,COGS 9,A01,083615,Shannon; Kyle Michael,9,0,75,66
1657818369319,COGS 11,A01,083617,Boyle; Mary E. T.,23,0,48,25
1657818375341,COGS 13,A01,083071,Bastos; Amalia Pinkusfeld,11,0,71,60
1657818381364,COGS 14A,A01,092681,Semenuks; Arturs,5,1,100,95
1657818387390,COGS 14B,A01,083073,Cheng; Tzu-Han,6,0,63,57
1657818393415,COGS 17,A01,092677,Semenuks; Arturs,6,0,81,75
1657818399440,COGS 100,A01,083619,Allen; Michael Gordon,17,0,70,53
1657818405466,COGS 101A,A01,083621,Davis; Joshua Daniel,9,0,68,59
1657818411492,COGS 101B,A01,091572,Allen; Michael Gordon,12,0,65,53
1657818417519,COGS 101C,A01,083625,Delgado; Tania,17,0,35,18
1657818423559,COGS 107A,A01,083627,Boyle; Mary E. T.,14,0,60,46
1657818429583,COGS 118A,A01,083075,Gupta; Anjum,21,0,76,55
1657818435612,CSE 3,A50,083646,Miranda; Gregory Joseph,24,0,50,26
1657818441642,CSE 8A,A50,083650,Miranda; Gregory Joseph,17,1,56,39
1657818447672,CSE 11,A01,083080,Cao; Yingjun,6,15,40,34
1657818453695,CSE 12,A01,083652,Krause-Levy; Sophia Louisa,28,1,120,92
1657818459719,CSE 15L,A01,083654,Morris; Justin Loren,9,0,50,41
1657818459719,CSE 15L,A02,083655,Morris; Justin Loren,9,0,50,41
1657818465742,CSE 20,A01,083657,Tran; Khoa Dang,39,0,80,41
1657818471765,CSE 21,A01,095574,Bach; Quang Tran,22,0,48,26
1657818477788,CSE 30,A01,083084,Eldon; John,6,0,80,74
1657818477788,CSE 30,B01,095061,Bhaskar; Nishant,9,0,50,41
1657818483811,CSE 100,A01,083659,Cao; Yingjun,5,4,70,65
1657818489839,CSE 134B,A01,083661,Powell; Thomas Allan,24,0,100,76
1657818495862,CSE 140,A01,083663,Gungor; Onat,15,0,85,70
1657818501884,CSE 140L,A01,083088,Eldon; John,23,0,100,77
1657818507906,CSE 175,A01,083665,Kumar; Rakesh,3,0,25,22
1657818513929,CSE 190,A00,092507,Dubnov; Shlomo,8,0,20,12
1657818519956,ECE 45,A01,083139,Congero; Spencer William,6,0,75,69
1657818525991,ECE 65,A50,083695,Saad; Andrew S,12,0,30,18
1657818525991,ECE 65,A51,095125,Saad; Andrew S,24,0,26,2
1657818532013,ECE 109,A01,091882,Touri; Behrouz,20,0,70,50
1657818538035,ECE 180,A00,083140,Abi Samra; Nicholas Camill,1,0,30,29
1657818538035,ECE 180,B00,083141,Abi Samra; Nicholas Camill,0,0,30,30
1657818544058,MATH 10A,A01,083735,Patchell; Gregory David,2,0,30,28
1657818544058,MATH 10A,A02,083736,Patchell; Gregory David,20,0,30,10
1657818544058,MATH 10A,A03,083737,Patchell; Gregory David,16,0,30,14
1657818550082,MATH 10B,A01,083207,Lim; Seonhee,8,0,34,26
1657818550082,MATH 10B,A02,083208,Lim; Seonhee,10,0,35,25
1657818550082,MATH 10B,A03,093472,Lim; Seonhee,7,0,34,27
1657818550082,MATH 10B,B01,083739,Sinha; Shubham,13,0,30,17
1657818556111,MATH 18,A01,083743,Cinel; Cameron Alexander,9,0,30,21
1657818556111,MATH 18,A02,083744,Cinel; Cameron Alexander,18,0,30,12
1657818556111,MATH 18,A03,083745,Cinel; Cameron Alexander,10,0,30,20
1657818556111,MATH 18,B01,083748,Rideout; David Porter,5,0,37,32
1657818556111,MATH 18,B02,083749,Rideout; David Porter,5,0,36,31
1657818556111,MATH 18,B03,083750,Rideout; David Porter,3,0,37,34
1657818556111,MATH 18,B04,083751,Rideout; David Porter,6,0,36,30
1657818556111,MATH 18,B05,093473,Rideout; David Porter,6,0,36,30
1657818556111,MATH 18,B06,093474,Rideout; David Porter,6,0,36,30
1657818562136,MATH 20A,A01,083754,Zheng; Zequn,14,0,40,26
1657818568173,MATH 20B,A01,083756,Briones; Jor-el Thomas Caparas,4,0,36,32
1657818568173,MATH 20B,A02,083757,Briones; Jor-el Thomas Caparas,1,0,36,35
1657818568173,MATH 20B,A03,093475,Briones; Jor-el Thomas Caparas,2,0,36,34
1657818574196,MATH 20C,A01,083760,Briones; Jor-el Thomas Caparas,1,0,35,34
1657818574196,MATH 20C,A02,083761,Briones; Jor-el Thomas Caparas,8,0,35,27
1657818574196,MATH 20C,A03,093476,Briones; Jor-el Thomas Caparas,0,1,36,36
1657818574196,MATH 20C,B01,083762,Bach; Quang Tran,1,0,30,29
1657818580225,MATH 20D,A01,083765,Tran; Brian Kha,5,0,30,25
1657818580225,MATH 20D,A02,083766,Tran; Brian Kha,5,0,30,25
1657818580225,MATH 20D,A03,083767,Tran; Brian Kha,5,0,30,25
1657818586252,MATH 20E,A01,083771,Ganguly; Soumya,10,0,32,22
1657818586252,MATH 20E,A02,083772,Ganguly; Soumya,6,0,32,26
1657818586252,MATH 20E,B01,083773,Ciotti; Benjamin,20,0,35,15
1657818586252,MATH 20E,B02,083774,Ciotti; Benjamin,18,0,35,17
1657818592274,MATH 103A,A01,083777,Greenfeld; Be'Eri,3,0,36,33
1657818592274,MATH 103A,A02,083778,Greenfeld; Be'Eri,5,0,36,31
1657818592274,MATH 103A,A03,093561,Greenfeld; Be'Eri,6,0,36,30
1657818592274,MATH 103A,B01,083779,Greenfeld; Be'Eri,7,0,36,29
1657818592274,MATH 103A,B02,083780,Greenfeld; Be'Eri,4,0,36,32
1657818592274,MATH 103A,B03,093562,Greenfeld; Be'Eri,3,0,36,33
1657818598300,MATH 105,A01,085443,Carter; Anne Toulson,15,0,35,20
1657818598300,MATH 105,A02,093477,Carter; Anne Toulson,20,0,35,15
1657818604324,MATH 109,A01,083213,Ganzberger; Geoffrey Michael,3,0,34,31
1657818604324,MATH 109,A02,083214,Ganzberger; Geoffrey Michael,4,0,34,30
1657818604324,MATH 109,A03,093478,Ganzberger; Geoffrey Michael,2,0,34,32
1657818604324,MATH 109,B01,083215,Ganzberger; Geoffrey Michael,1,0,32,31
1657818604324,MATH 109,B02,083216,Ganzberger; Geoffrey Michael,2,0,32,30
1657818604324,MATH 109,B03,093479,Ganzberger; Geoffrey Michael,8,0,32,24
1657818610353,MATH 142A,A01,083219,Chow; Bennett,7,0,32,25
1657818610353,MATH 142A,A02,083220,Chow; Bennett,10,0,32,22
1657818610353,MATH 142A,A03,093480,Chow; Bennett,9,0,32,23
1657818610353,MATH 142A,B03,093481,Chow; Bennett,8,0,32,24
1657818610353,MATH 142A,B04,093558,Chow; Bennett,13,0,32,19
1657818610353,MATH 142A,B05,093559,Chow; Bennett,7,0,32,25
1657818616384,MATH 193A,A01,083224,Rotar; Vladimir,8,0,34,26
1657818616384,MATH 193A,A02,083225,Rotar; Vladimir,9,0,34,25
1657818616384,MATH 193A,A03,083781,Rotar; Vladimir,5,0,34,29
1657818616384,MATH 193A,A04,083782,Rotar; Vladimir,11,0,34,23
1657818616384,MATH 193A,A05,093482,Rotar; Vladimir,10,0,34,24
1657818622419,MATH 197,001,091859,McAuley; Julian John,9999,0,9999,0
1657818622419,MATH 197,002,095566,Kedlaya; Kiran S.,9997,0,9999,2
1657818622419,MATH 197,003,095567,Xiao; Ming,9999,0,9999,0
1657818622419,MATH 197,004,095571,Perols; Johan Lars,9998,0,9999,1
1657818629471,COGS 9,A01,083615,Shannon; Kyle Michael,9,0,75,66
1657818635497,COGS 11,A01,083617,Boyle; Mary E. T.,23,0,48,25
1657818641529,COGS 13,A01,083071,Bastos; Amalia Pinkusfeld,11,0,71,60
1657818647555,COGS 14A,A01,092681,Semenuks; Arturs,5,1,100,95
1657818653578,COGS 14B,A01,083073,Cheng; Tzu-Han,6,0,63,57
1657818659608,COGS 17,A01,092677,Semenuks; Arturs,6,0,81,75
1657818665635,COGS 100,A01,083619,Allen; Michael Gordon,17,0,70,53
1657818671657,COGS 101A,A01,083621,Davis; Joshua Daniel,9,0,68,59
1657818677681,COGS 101B,A01,091572,Allen; Michael Gordon,12,0,65,53
1657818683705,COGS 101C,A01,083625,Delgado; Tania,17,0,35,18
1657818689816,COGS 107A,A01,083627,Boyle; Mary E. T.,14,0,60,46
1657818695839,COGS 118A,A01,083075,Gupta; Anjum,21,0,76,55
1657818701863,CSE 3,A50,083646,Miranda; Gregory Joseph,24,0,50,26
1657818707920,CSE 8A,A50,083650,Miranda; Gregory Joseph,17,1,56,39
1657818713949,CSE 11,A01,083080,Cao; Yingjun,6,15,40,34
1657818719974,CSE 12,A01,083652,Krause-Levy; Sophia Louisa,28,1,120,92
1657818725997,CSE 15L,A01,083654,Morris; Justin Loren,9,0,50,41
1657818725997,CSE 15L,A02,083655,Morris; Justin Loren,9,0,50,41
1657818732020,CSE 20,A01,083657,Tran; Khoa Dang,39,0,80,41
1657818738043,CSE 21,A01,095574,Bach; Quang Tran,22,0,48,26
1657818744076,CSE 30,A01,083084,Eldon; John,6,0,80,74
1657818744076,CSE 30,B01,095061,Bhaskar; Nishant,9,0,50,41
1657818750103,CSE 100,A01,083659,Cao; Yingjun,5,4,70,65
1657818756194,CSE 134B,A01,083661,Powell; Thomas Allan,24,0,100,76
1657818762218,CSE 140,A01,083663,Gungor; Onat,15,0,85,70
1657818768242,CSE 140L,A01,083088,Eldon; John,23,0,100,77
1657818774264,CSE 175,A01,083665,Kumar; Rakesh,3,0,25,22
1657818780291,CSE 190,A00,092507,Dubnov; Shlomo,8,0,20,12
1657818786319,ECE 45,A01,083139,Congero; Spencer William,6,0,75,69
1657818792343,ECE 65,A50,083695,Saad; Andrew S,12,0,30,18
1657818792343,ECE 65,A51,095125,Saad; Andrew S,24,0,26,2
1657818798366,ECE 109,A01,091882,Touri; Behrouz,20,0,70,50
1657818804391,ECE 180,A00,083140,Abi Samra; Nicholas Camill,1,0,30,29
1657818804391,ECE 180,B00,083141,Abi Samra; Nicholas Camill,0,0,30,30
1657818810424,MATH 10A,A01,083735,Patchell; Gregory David,2,0,30,28
1657818810424,MATH 10A,A02,083736,Patchell; Gregory David,20,0,30,10
1657818810424,MATH 10A,A03,083737,Patchell; Gregory David,16,0,30,14
1657818816446,MATH 10B,A01,083207,Lim; Seonhee,8,0,34,26
1657818816446,MATH 10B,A02,083208,Lim; Seonhee,10,0,35,25
1657818816446,MATH 10B,A03,093472,Lim; Seonhee,7,0,34,27
1657818816446,MATH 10B,B01,083739,Sinha; Shubham,13,0,30,17
1657818822472,MATH 18,A01,083743,Cinel; Cameron Alexander,9,0,30,21
1657818822472,MATH 18,A02,083744,Cinel; Cameron Alexander,18,0,30,12
1657818822472,MATH 18,A03,083745,Cinel; Cameron Alexander,10,0,30,20
1657818822472,MATH 18,B01,083748,Rideout; David Porter,5,0,37,32
1657818822472,MATH 18,B02,083749,Rideout; David Porter,5,0,36,31
1657818822472,MATH 18,B03,083750,Rideout; David Porter,3,0,37,34
1657818822472,MATH 18,B04,083751,Rideout; David Porter,6,0,36,30
1657818822472,MATH 18,B05,093473,Rideout; David Porter,6,0,36,30
1657818822472,MATH 18,B06,093474,Rideout; David Porter,6,0,36,30
1657818828500,MATH 20A,A01,083754,Zheng; Zequn,14,0,40,26
1657818834532,MATH 20B,A01,083756,Briones; Jor-el Thomas Caparas,4,0,36,32
1657818834532,MATH 20B,A02,083757,Briones; Jor-el Thomas Caparas,1,0,36,35
1657818834532,MATH 20B,A03,093475,Briones; Jor-el Thomas Caparas,2,0,36,34
1657818840560,MATH 20C,A01,083760,Briones; Jor-el Thomas Caparas,1,0,35,34
1657818840560,MATH 20C,A02,083761,Briones; Jor-el Thomas Caparas,8,0,35,27
1657818840560,MATH 20C,A03,093476,Briones; Jor-el Thomas Caparas,0,1,36,36
1657818840560,MATH 20C,B01,083762,Bach; Quang Tran,1,0,30,29
1657818846589,MATH 20D,A01,083765,Tran; Brian Kha,5,0,30,25
1657818846589,MATH 20D,A02,083766,Tran; Brian Kha,5,0,30,25
1657818846589,MATH 20D,A03,083767,Tran; Brian Kha,5,0,30,25
1657818852611,MATH 20E,A01,083771,Ganguly; Soumya,10,0,32,22
1657818852611,MATH 20E,A02,083772,Ganguly; Soumya,6,0,32,26
1657818852611,MATH 20E,B01,083773,Ciotti; Benjamin,20,0,35,15
1657818852611,MATH 20E,B02,083774,Ciotti; Benjamin,18,0,35,17
1657818858634,MATH 103A,A01,083777,Greenfeld; Be'Eri,3,0,36,33
1657818858634,MATH 103A,A02,083778,Greenfeld; Be'Eri,5,0,36,31
1657818858634,MATH 103A,A03,093561,Greenfeld; Be'Eri,6,0,36,30
1657818858634,MATH 103A,B01,083779,Greenfeld; Be'Eri,7,0,36,29
1657818858634,MATH 103A,B02,083780,Greenfeld; Be'Eri,4,0,36,32
1657818858634,MATH 103A,B03,093562,Greenfeld; Be'Eri,3,0,36,33
1657818864663,MATH 105,A01,085443,Carter; Anne Toulson,15,0,35,20
1657818864663,MATH 105,A02,093477,Carter; Anne Toulson,20,0,35,15
1657818870694,MATH 109,A01,083213,Ganzberger; Geoffrey Michael,3,0,34,31
1657818870694,MATH 109,A02,083214,Ganzberger; Geoffrey Michael,4,0,34,30
1657818870694,MATH 109,A03,093478,Ganzberger; Geoffrey Michael,2,0,34,32
1657818870694,MATH 109,B01,083215,Ganzberger; Geoffrey Michael,1,0,32,31
1657818870694,MATH 109,B02,083216,Ganzberger; Geoffrey Michael,2,0,32,30
1657818870694,MATH 109,B03,093479,Ganzberger; Geoffrey Michael,8,0,32,24
1657818876718,MATH 142A,A01,083219,Chow; Bennett,7,0,32,25
1657818876718,MATH 142A,A02,083220,Chow; Bennett,10,0,32,22
1657818876718,MATH 142A,A03,093480,Chow; Bennett,9,0,32,23
1657818876718,MATH 142A,B03,093481,Chow; Bennett,8,0,32,24
1657818876718,MATH 142A,B04,093558,Chow; Bennett,13,0,32,19
1657818876718,MATH 142A,B05,093559,Chow; Bennett,7,0,32,25
1657818882748,MATH 193A,A01,083224,Rotar; Vladimir,8,0,34,26
1657818882748,MATH 193A,A02,083225,Rotar; Vladimir,9,0,34,25
1657818882748,MATH 193A,A03,083781,Rotar; Vladimir,5,0,34,29
1657818882748,MATH 193A,A04,083782,Rotar; Vladimir,11,0,34,23
1657818882748,MATH 193A,A05,093482,Rotar; Vladimir,10,0,34,24
1657818888774,MATH 197,001,091859,McAuley; Julian John,9999,0,9999,0
1657818888774,MATH 197,002,095566,Kedlaya; Kiran S.,9997,0,9999,2
1657818888774,MATH 197,003,095567,Xiao; Ming,9999,0,9999,0
1657818888774,MATH 197,004,095571,Perols; Johan Lars,9998,0,9999,1
1657818895830,COGS 9,A01,083615,Shannon; Kyle Michael,9,0,75,66
1657818901851,COGS 11,A01,083617,Boyle; Mary E. T.,23,0,48,25
1657818907878,COGS 13,A01,083071,Bastos; Amalia Pinkusfeld,11,0,71,60
1657818913901,COGS 14A,A01,092681,Semenuks; Arturs,5,1,100,95
1657818919928,COGS 14B,A01,083073,Cheng; Tzu-Han,6,0,63,57
1657818925955,COGS 17,A01,092677,Semenuks; Arturs,6,0,81,75
1657818931981,COGS 100,A01,083619,Allen; Michael Gordon,17,0,70,53
1657818938010,COGS 101A,A01,083621,Davis; Joshua Daniel,9,0,68,59
1657818944037,COGS 101B,A01,091572,Allen; Michael Gordon,12,0,65,53
1657818950069,COGS 101C,A01,083625,Delgado; Tania,17,0,35,18
1657818956092,COGS 107A,A01,083627,Boyle; Mary E. T.,14,0,60,46
1657818962124,COGS 118A,A01,083075,Gupta; Anjum,21,0,76,55
1657818968151,CSE 3,A50,083646,Miranda; Gregory Joseph,24,0,50,26
1657818974193,CSE 8A,A50,083650,Miranda; Gregory Joseph,17,1,56,39
1657818980217,CSE 11,A01,083080,Cao; Yingjun,6,15,40,34
1657818986247,CSE 12,A01,083652,Krause-Levy; Sophia Louisa,28,1,120,92
1657818992275,CSE 15L,A01,083654,Morris; Justin Loren,9,0,50,41
1657818992275,CSE 15L,A02,083655,Morris; Justin Loren,9,0,50,41
1657818998304,CSE 20,A01,083657,Tran; Khoa Dang,39,0,80,41
1657819004327,CSE 21,A01,095574,Bach; Quang Tran,22,0,48,26
1657819010354,CSE 30,A01,083084,Eldon; John,6,0,80,74
1657819010354,CSE 30,B01,095061,Bhaskar; Nishant,9,0,50,41
1657819016380,CSE 100,A01,083659,Cao; Yingjun,5,4,70,65
1657819022405,CSE 134B,A01,083661,Powell; Thomas Allan,24,0,100,76
1657819028428,CSE 140,A01,083663,Gungor; Onat,15,0,85,70
1657819034451,CSE 140L,A01,083088,Eldon; John,23,0,100,77
1657819040472,CSE 175,A01,083665,Kumar; Rakesh,3,0,25,22
1657819046503,CSE 190,A00,092507,Dubnov; Shlomo,8,0,20,12
1657819052530,ECE 45,A01,083139,Congero; Spencer William,6,0,75,69
1657819058553,ECE 65,A50,083695,Saad; Andrew S,12,0,30,18
1657819058553,ECE 65,A51,095125,Saad; Andrew S,24,0,26,2
1657819064579,ECE 109,A01,091882,Touri; Behrouz,20,0,70,50
1657819070609,ECE 180,A00,083140,Abi Samra; Nicholas Camill,1,0,30,29
1657819070609,ECE 180,B00,083141,Abi Samra; Nicholas Camill,0,0,30,30
1657819076635,MATH 10A,A01,083735,Patchell; Gregory David,2,0,30,28
1657819076635,MATH 10A,A02,083736,Patchell; Gregory David,20,0,30,10
1657819076635,MATH 10A,A03,083737,Patchell; Gregory David,16,0,30,14
1657819082664,MATH 10B,A01,083207,Lim; Seonhee,8,0,34,26
1657819082664,MATH 10B,A02,083208,Lim; Seonhee,10,0,35,25
1657819082664,MATH 10B,A03,093472,Lim; Seonhee,7,0,34,27
1657819082664,MATH 10B,B01,083739,Sinha; Shubham,13,0,30,17
1657819088695,MATH 18,A01,083743,Cinel; Cameron Alexander,9,0,30,21
1657819088695,MATH 18,A02,083744,Cinel; Cameron Alexander,18,0,30,12
1657819088695,MATH 18,A03,083745,Cinel; Cameron Alexander,10,0,30,20
1657819088695,MATH 18,B01,083748,Rideout; David Porter,5,0,37,32
1657819088695,MATH 18,B02,083749,Rideout; David Porter,5,0,36,31
1657819088695,MATH 18,B03,083750,Rideout; David Porter,3,0,37,34
1657819088695,MATH 18,B04,083751,Rideout; David Porter,6,0,36,30
1657819088695,MATH 18,B05,093473,Rideout; David Porter,6,0,36,30
1657819088695,MATH 18,B06,093474,Rideout; David Porter,6,0,36,30
1657819094739,MATH 20A,A01,083754,Zheng; Zequn,14,0,40,26
1657819100774,MATH 20B,A01,083756,Briones; Jor-el Thomas Caparas,4,0,36,32
1657819100774,MATH 20B,A02,083757,Briones; Jor-el Thomas Caparas,1,0,36,35
1657819100774,MATH 20B,A03,093475,Briones; Jor-el Thomas Caparas,2,0,36,34
1657819106801,MATH 20C,A01,083760,Briones; Jor-el Thomas Caparas,1,0,35,34
1657819106801,MATH 20C,A02,083761,Briones; Jor-el Thomas Caparas,8,0,35,27
1657819106801,MATH 20C,A03,093476,Briones; Jor-el Thomas Caparas,0,1,36,36
1657819106801,MATH 20C,B01,083762,Bach; Quang Tran,1,0,30,29
1657819112836,MATH 20D,A01,083765,Tran; Brian Kha,5,0,30,25
1657819112836,MATH 20D,A02,083766,Tran; Brian Kha,5,0,30,25
1657819112836,MATH 20D,A03,083767,Tran; Brian Kha,5,0,30,25
1657819118865,MATH 20E,A01,083771,Ganguly; Soumya,10,0,32,22
1657819118865,MATH 20E,A02,083772,Ganguly; Soumya,6,0,32,26
1657819118865,MATH 20E,B01,083773,Ciotti; Benjamin,20,0,35,15
1657819118865,MATH 20E,B02,083774,Ciotti; Benjamin,18,0,35,17
1657819124893,MATH 103A,A01,083777,Greenfeld; Be'Eri,3,0,36,33
1657819124893,MATH 103A,A02,083778,Greenfeld; Be'Eri,5,0,36,31
1657819124893,MATH 103A,A03,093561,Greenfeld; Be'Eri,6,0,36,30
1657819124893,MATH 103A,B01,083779,Greenfeld; Be'Eri,7,0,36,29
1657819124893,MATH 103A,B02,083780,Greenfeld; Be'Eri,4,0,36,32
1657819124893,MATH 103A,B03,093562,Greenfeld; Be'Eri,3,0,36,33
1657819130923,MATH 105,A01,085443,Carter; Anne Toulson,15,0,35,20
1657819130923,MATH 105,A02,093477,Carter; Anne Toulson,20,0,35,15
1657819136952,MATH 109,A01,083213,Ganzberger; Geoffrey Michael,3,0,34,31
1657819136952,MATH 109,A02,083214,Ganzberger; Geoffrey Michael,4,0,34,30
1657819136952,MATH 109,A03,093478,Ganzberger; Geoffrey Michael,2,0,34,32
1657819136952,MATH 109,B01,083215,Ganzberger; Geoffrey Michael,1,0,32,31
1657819136952,MATH 109,B02,083216,Ganzberger; Geoffrey Michael,2,0,32,30
1657819136952,MATH 109,B03,093479,Ganzberger; Geoffrey Michael,8,0,32,24
1657819142975,MATH 142A,A01,083219,Chow; Bennett,7,0,32,25
1657819142975,MATH 142A,A02,083220,Chow; Bennett,10,0,32,22
1657819142975,MATH 142A,A03,093480,Chow; Bennett,9,0,32,23
1657819142975,MATH 142A,B03,093481,Chow; Bennett,8,0,32,24
1657819142975,MATH 142A,B04,093558,Chow; Bennett,13,0,32,19
1657819142975,MATH 142A,B05,093559,Chow; Bennett,7,0,32,25
1657819149000,MATH 193A,A01,083224,Rotar; Vladimir,8,0,34,26
1657819149000,MATH 193A,A02,083225,Rotar; Vladimir,9,0,34,25
1657819149000,MATH 193A,A03,083781,Rotar; Vladimir,5,0,34,29
1657819149000,MATH 193A,A04,083782,Rotar; Vladimir,11,0,34,23
1657819149000,MATH 193A,A05,093482,Rotar; Vladimir,10,0,34,24
1657819155024,MATH 197,001,091859,McAuley; Julian John,9999,0,9999,0
1657819155024,MATH 197,002,095566,Kedlaya; Kiran S.,9997,0,9999,2
1657819155024,MATH 197,003,095567,Xiao; Ming,9999,0,9999,0
1657819155024,MATH 197,004,095571,Perols; Johan Lars,9998,0,9999,1
1657819162098,COGS 9,A01,083615,Shannon; Kyle Michael,9,0,75,66
1657819168126,COGS 11,A01,083617,Boyle; Mary E. T.,23,0,48,25
1657819174149,COGS 13,A01,083071,Bastos; Amalia Pinkusfeld,11,0,71,60
1657819180176,COGS 14A,A01,092681,Semenuks; Arturs,5,1,100,95
1657819186199,COGS 14B,A01,083073,Cheng; Tzu-Han,6,0,63,57
1657819192223,COGS 17,A01,092677,Semenuks; Arturs,6,0,81,75
1657819198245,COGS 100,A01,083619,Allen; Michael Gordon,17,0,70,53
1657819204274,COGS 101A,A01,083621,Davis; Joshua Daniel,9,0,68,59
1657819210297,COGS 101B,A01,091572,Allen; Michael Gordon,12,0,65,53
1657819216326,COGS 101C,A01,083625,Delgado; Tania,17,0,35,18
1657819222359,COGS 107A,A01,083627,Boyle; Mary E. T.,14,0,60,46
1657819228388,COGS 118A,A01,083075,Gupta; Anjum,21,0,76,55
1657819234414,CSE 3,A50,083646,Miranda; Gregory Joseph,24,0,50,26
1657819240437,CSE 8A,A50,083650,Miranda; Gregory Joseph,17,1,56,39
1657819246462,CSE 11,A01,083080,Cao; Yingjun,6,15,40,34
1657819252505,CSE 12,A01,083652,Krause-Levy; Sophia Louisa,28,1,120,92
1657819258537,CSE 15L,A01,083654,Morris; Justin Loren,9,0,50,41
1657819258537,CSE 15L,A02,083655,Morris; Justin Loren,9,0,50,41
1657819264560,CSE 20,A01,083657,Tran; Khoa Dang,39,0,80,41
1657819270582,CSE 21,A01,095574,Bach; Quang Tran,22,0,48,26
1657819276610,CSE 30,A01,083084,Eldon; John,6,0,80,74
1657819276610,CSE 30,B01,095061,Bhaskar; Nishant,9,0,50,41
1657819282635,CSE 100,A01,083659,Cao; Yingjun,5,4,70,65
1657819288740,CSE 134B,A01,083661,Powell; Thomas Allan,24,0,100,76
1657819294766,CSE 140,A01,083663,Gungor; Onat,15,0,85,70
1657819300790,CSE 140L,A01,083088,Eldon; John,23,0,100,77
1657819306815,CSE 175,A01,083665,Kumar; Rakesh,3,0,25,22
1657819312838,CSE 190,A00,092507,Dubnov; Shlomo,8,0,20,12
1657819318861,ECE 45,A01,083139,Congero; Spencer William,6,0,75,69
1657819324890,ECE 65,A50,083695,Saad; Andrew S,12,0,30,18
1657819324890,ECE 65,A51,095125,Saad; Andrew S,24,0,26,2
1657819330915,ECE 109,A01,091882,Touri; Behrouz,20,0,70,50
1657819336937,ECE 180,A00,083140,Abi Samra; Nicholas Camill,1,0,30,29
1657819336937,ECE 180,B00,083141,Abi Samra; Nicholas Camill,0,0,30,30
1657819342959,MATH 10A,A01,083735,Patchell; Gregory David,2,0,30,28
1657819342959,MATH 10A,A02,083736,Patchell; Gregory David,20,0,30,10
1657819342959,MATH 10A,A03,083737,Patchell; Gregory David,16,0,30,14
1657819348988,MATH 10B,A01,083207,Lim; Seonhee,8,0,34,26
1657819348988,MATH 10B,A02,083208,Lim; Seonhee,10,0,35,25
1657819348988,MATH 10B,A03,093472,Lim; Seonhee,7,0,34,27
1657819348988,MATH 10B,B01,083739,Sinha; Shubham,13,0,30,17
1657819355014,MATH 18,A01,083743,Cinel; Cameron Alexander,9,0,30,21
1657819355014,MATH 18,A02,083744,Cinel; Cameron Alexander,18,0,30,12
1657819355014,MATH 18,A03,083745,Cinel; Cameron Alexander,10,0,30,20
1657819355014,MATH 18,B01,083748,Rideout; David Porter,5,0,37,32
1657819355014,MATH 18,B02,083749,Rideout; David Porter,5,0,36,31
1657819355014,MATH 18,B03,083750,Rideout; David Porter,3,0,37,34
1657819355014,MATH 18,B04,083751,Rideout; David Porter,6,0,36,30
1657819355014,MATH 18,B05,093473,Rideout; David Porter,6,0,36,30
1657819355014,MATH 18,B06,093474,Rideout; David Porter,6,0,36,30
1657819361042,MATH 20A,A01,083754,Zheng; Zequn,14,0,40,26
1657819367074,MATH 20B,A01,083756,Briones; Jor-el Thomas Caparas,4,0,36,32
1657819367074,MATH 20B,A02,083757,Briones; Jor-el Thomas Caparas,1,0,36,35
1657819367074,MATH 20B,A03,093475,Briones; Jor-el Thomas Caparas,2,0,36,34
1657819373113,MATH 20C,A01,083760,Briones; Jor-el Thomas Caparas,1,0,35,34
1657819373113,MATH 20C,A02,083761,Briones; Jor-el Thomas Caparas,8,0,35,27
1657819373113,MATH 20C,A03,093476,Briones; Jor-el Thomas Caparas,0,1,36,36
1657819373113,MATH 20C,B01,083762,Bach; Quang Tran,1,0,30,29
1657819379148,MATH 20D,A01,083765,Tran; Brian Kha,5,0,30,25
1657819379148,MATH 20D,A02,083766,Tran; Brian Kha,5,0,30,25
1657819379148,MATH 20D,A03,083767,Tran; Brian Kha,5,0,30,25
1657819385172,MATH 20E,A01,083771,Ganguly; Soumya,10,0,32,22
1657819385172,MATH 20E,A02,083772,Ganguly; Soumya,6,0,32,26
1657819385172,MATH 20E,B01,083773,Ciotti; Benjamin,20,0,35,15
1657819385172,MATH 20E,B02,083774,Ciotti; Benjamin,18,0,35,17
1657819391196,MATH 103A,A01,083777,Greenfeld; Be'Eri,3,0,36,33
1657819391196,MATH 103A,A02,083778,Greenfeld; Be'Eri,5,0,36,31
1657819391196,MATH 103A,A03,093561,Greenfeld; Be'Eri,6,0,36,30
1657819391196,MATH 103A,B01,083779,Greenfeld; Be'Eri,7,0,36,29
1657819391196,MATH 103A,B02,083780,Greenfeld; Be'Eri,4,0,36,32
1657819391196,MATH 103A,B03,093562,Greenfeld; Be'Eri,3,0,36,33
1657819397219,MATH 105,A01,085443,Carter; Anne Toulson,15,0,35,20
1657819397219,MATH 105,A02,093477,Carter; Anne Toulson,20,0,35,15
1657819403244,MATH 109,A01,083213,Ganzberger; Geoffrey Michael,3,0,34,31
1657819403244,MATH 109,A02,083214,Ganzberger; Geoffrey Michael,4,0,34,30
1657819403244,MATH 109,A03,093478,Ganzberger; Geoffrey Michael,2,0,34,32
1657819403244,MATH 109,B01,083215,Ganzberger; Geoffrey Michael,1,0,32,31
1657819403244,MATH 109,B02,083216,Ganzberger; Geoffrey Michael,2,0,32,30
1657819403244,MATH 109,B03,093479,Ganzberger; Geoffrey Michael,8,0,32,24
1657819409287,MATH 142A,A01,083219,Chow; Bennett,7,0,32,25
1657819409287,MATH 142A,A02,083220,Chow; Bennett,10,0,32,22
1657819409287,MATH 142A,A03,093480,Chow; Bennett,9,0,32,23
1657819409287,MATH 142A,B03,093481,Chow; Bennett,8,0,32,24
1657819409287,MATH 142A,B04,093558,Chow; Bennett,13,0,32,19
1657819409287,MATH 142A,B05,093559,Chow; Bennett,7,0,32,25
1657819415311,MATH 193A,A01,083224,Rotar; Vladimir,8,0,34,26
1657819415311,MATH 193A,A02,083225,Rotar; Vladimir,9,0,34,25
1657819415311,MATH 193A,A03,083781,Rotar; Vladimir,5,0,34,29
1657819415311,MATH 193A,A04,083782,Rotar; Vladimir,11,0,34,23
1657819415311,MATH 193A,A05,093482,Rotar; Vladimir,10,0,34,24
1657819421333,MATH 197,001,091859,McAuley; Julian John,9999,0,9999,0
1657819421333,MATH 197,002,095566,Kedlaya; Kiran S.,9997,0,9999,2
1657819421333,MATH 197,003,095567,Xiao; Ming,9999,0,9999,0
1657819421333,MATH 197,004,095571,Perols; Johan Lars,9998,0,9999,1
1657819428411,COGS 9,A01,083615,Shannon; Kyle Michael,9,0,75,66
1657819434436,COGS 11,A01,083617,Boyle; Mary E. T.,23,0,48,25
1657819440471,COGS 13,A01,083071,Bastos; Amalia Pinkusfeld,11,0,71,60
1657819446499,COGS 14A,A01,092681,Semenuks; Arturs,5,1,100,95
1657819452528,COGS 14B,A01,083073,Cheng; Tzu-Han,6,0,63,57
1657819458560,COGS 17,A01,092677,Semenuks; Arturs,6,0,81,75
1657819464584,COGS 100,A01,083619,Allen; Michael Gordon,17,0,70,53
1657819470606,COGS 101A,A01,083621,Davis; Joshua Daniel,9,0,68,59
1657819476631,COGS 101B,A01,091572,Allen; Michael Gordon,12,0,65,53
1657819482659,COGS 101C,A01,083625,Delgado; Tania,17,0,35,18
1657819488688,COGS 107A,A01,083627,Boyle; Mary E. T.,14,0,60,46
1657819494712,COGS 118A,A01,083075,Gupta; Anjum,21,0,76,55
1657819500745,CSE 3,A50,083646,Miranda; Gregory Joseph,24,0,50,26
1657819506768,CSE 8A,A50,083650,Miranda; Gregory Joseph,17,1,56,39
1657819512789,CSE 11,A01,083080,Cao; Yingjun,6,15,40,34
1657819518812,CSE 12,A01,083652,Krause-Levy; Sophia Louisa,28,1,120,92
1657819524841,CSE 15L,A01,083654,Morris; Justin Loren,9,0,50,41
1657819524841,CSE 15L,A02,083655,Morris; Justin Loren,9,0,50,41
1657819530863,CSE 20,A01,083657,Tran; Khoa Dang,39,0,80,41
1657819536887,CSE 21,A01,095574,Bach; Quang Tran,22,0,48,26
1657819549386,CSE 30,A01,083084,Eldon; John,6,0,80,74
1657819549386,CSE 30,B01,095061,Bhaskar; Nishant,9,0,50,41
1657819555416,CSE 100,A01,083659,Cao; Yingjun,5,4,70,65
1657819561454,CSE 134B,A01,083661,Powell; Thomas Allan,24,0,100,76
1657819567480,CSE 140,A01,083663,Gungor; Onat,15,0,85,70
1657819573511,CSE 140L,A01,083088,Eldon; John,23,0,100,77
1657819579533,CSE 175,A01,083665,Kumar; Rakesh,3,0,25,22
1657819585556,CSE 190,A00,092507,Dubnov; Shlomo,8,0,20,12
1657819591579,ECE 45,A01,083139,Congero; Spencer William,6,0,75,69
1657819597601,ECE 65,A50,083695,Saad; Andrew S,12,0,30,18
1657819597601,ECE 65,A51,095125,Saad; Andrew S,24,0,26,2
1657819603624,ECE 109,A01,091882,Touri; Behrouz,20,0,70,50
1657819609646,ECE 180,A00,083140,Abi Samra; Nicholas Camill,1,0,30,29
1657819609646,ECE 180,B00,083141,Abi Samra; Nicholas Camill,0,0,30,30
1657819615672,MATH 10A,A01,083735,Patchell; Gregory David,2,0,30,28
1657819615672,MATH 10A,A02,083736,Patchell; Gregory David,20,0,30,10
1657819615672,MATH 10A,A03,083737,Patchell; Gregory David,16,0,30,14
1657819621696,MATH 10B,A01,083207,Lim; Seonhee,8,0,34,26
1657819621696,MATH 10B,A02,083208,Lim; Seonhee,10,0,35,25
1657819621696,MATH 10B,A03,093472,Lim; Seonhee,7,0,34,27
1657819621696,MATH 10B,B01,083739,Sinha; Shubham,13,0,30,17
1657819627747,MATH 18,A01,083743,Cinel; Cameron Alexander,9,0,30,21
1657819627747,MATH 18,A02,083744,Cinel; Cameron Alexander,18,0,30,12
1657819627747,MATH 18,A03,083745,Cinel; Cameron Alexander,10,0,30,20
1657819627747,MATH 18,B01,083748,Rideout; David Porter,5,0,37,32
1657819627747,MATH 18,B02,083749,Rideout; David Porter,5,0,36,31
1657819627747,MATH 18,B03,083750,Rideout; David Porter,3,0,37,34
1657819627747,MATH 18,B04,083751,Rideout; David Porter,6,0,36,30
1657819627747,MATH 18,B05,093473,Rideout; David Porter,6,0,36,30
1657819627747,MATH 18,B06,093474,Rideout; David Porter,6,0,36,30
1657819633769,MATH 20A,A01,083754,Zheng; Zequn,14,0,40,26
1657819639805,MATH 20B,A01,083756,Briones; Jor-el Thomas Caparas,4,0,36,32
1657819639805,MATH 20B,A02,083757,Briones; Jor-el Thomas Caparas,1,0,36,35
1657819639805,MATH 20B,A03,093475,Briones; Jor-el Thomas Caparas,2,0,36,34
1657819645828,MATH 20C,A01,083760,Briones; Jor-el Thomas Caparas,1,0,35,34
1657819645828,MATH 20C,A02,083761,Briones; Jor-el Thomas Caparas,8,0,35,27
1657819645828,MATH 20C,A03,093476,Briones; Jor-el Thomas Caparas,0,1,36,36
1657819645828,MATH 20C,B01,083762,Bach; Quang Tran,1,0,30,29
1657819651858,MATH 20D,A01,083765,Tran; Brian Kha,5,0,30,25
1657819651858,MATH 20D,A02,083766,Tran; Brian Kha,5,0,30,25
1657819651858,MATH 20D,A03,083767,Tran; Brian Kha,5,0,30,25
1657819657905,MATH 20E,A01,083771,Ganguly; Soumya,10,0,32,22
1657819657905,MATH 20E,A02,083772,Ganguly; Soumya,6,0,32,26
1657819657905,MATH 20E,B01,083773,Ciotti; Benjamin,20,0,35,15
1657819657905,MATH 20E,B02,083774,Ciotti; Benjamin,18,0,35,17
1657819663941,MATH 103A,A01,083777,Greenfeld; Be'Eri,3,0,36,33
1657819663941,MATH 103A,A02,083778,Greenfeld; Be'Eri,5,0,36,31
1657819663941,MATH 103A,A03,093561,Greenfeld; Be'Eri,6,0,36,30
1657819663941,MATH 103A,B01,083779,Greenfeld; Be'Eri,7,0,36,29
1657819663941,MATH 103A,B02,083780,Greenfeld; Be'Eri,4,0,36,32
1657819663941,MATH 103A,B03,093562,Greenfeld; Be'Eri,3,0,36,33
1657819669967,MATH 105,A01,085443,Carter; Anne Toulson,15,0,35,20
1657819669967,MATH 105,A02,093477,Carter; Anne Toulson,20,0,35,15
1657819675995,MATH 109,A01,083213,Ganzberger; Geoffrey Michael,3,0,34,31
1657819675995,MATH 109,A02,083214,Ganzberger; Geoffrey Michael,4,0,34,30
1657819675995,MATH 109,A03,093478,Ganzberger; Geoffrey Michael,2,0,34,32
1657819675995,MATH 109,B01,083215,Ganzberger; Geoffrey Michael,1,0,32,31
1657819675995,MATH 109,B02,083216,Ganzberger; Geoffrey Michael,2,0,32,30
1657819675995,MATH 109,B03,093479,Ganzberger; Geoffrey Michael,8,0,32,24
1657819682022,MATH 142A,A01,083219,Chow; Bennett,7,0,32,25
1657819682022,MATH 142A,A02,083220,Chow; Bennett,10,0,32,22
1657819682022,MATH 142A,A03,093480,Chow; Bennett,9,0,32,23
1657819682022,MATH 142A,B03,093481,Chow; Bennett,8,0,32,24
1657819682022,MATH 142A,B04,093558,Chow; Bennett,13,0,32,19
1657819682022,MATH 142A,B05,093559,Chow; Bennett,7,0,32,25
1657819688050,MATH 193A,A01,083224,Rotar; Vladimir,8,0,34,26
1657819688050,MATH 193A,A02,083225,Rotar; Vladimir,9,0,34,25
1657819688050,MATH 193A,A03,083781,Rotar; Vladimir,5,0,34,29
1657819688050,MATH 193A,A04,083782,Rotar; Vladimir,11,0,34,23
1657819688050,MATH 193A,A05,093482,Rotar; Vladimir,10,0,34,24
1657819694075,MATH 197,001,091859,McAuley; Julian John,9999,0,9999,0
1657819694075,MATH 197,002,095566,Kedlaya; Kiran S.,9997,0,9999,2
1657819694075,MATH 197,003,095567,Xiao; Ming,9999,0,9999,0
1657819694075,MATH 197,004,095571,Perols; Johan Lars,9998,0,9999,1
1657819701143,COGS 9,A01,083615,Shannon; Kyle Michael,9,0,75,66
1657819707165,COGS 11,A01,083617,Boyle; Mary E. T.,23,0,48,25
1657819713189,COGS 13,A01,083071,Bastos; Amalia Pinkusfeld,11,0,71,60
1657819719224,COGS 14A,A01,092681,Semenuks; Arturs,5,1,100,95
1657819725249,COGS 14B,A01,083073,Cheng; Tzu-Han,6,0,63,57
1657819731275,COGS 17,A01,092677,Semenuks; Arturs,6,0,81,75
1657819737300,COGS 100,A01,083619,Allen; Michael Gordon,17,0,70,53
1657819743323,COGS 101A,A01,083621,Davis; Joshua Daniel,9,0,68,59
1657819749349,COGS 101B,A01,091572,Allen; Michael Gordon,12,0,65,53
1657819755383,COGS 101C,A01,083625,Delgado; Tania,17,0,35,18
1657819761408,COGS 107A,A01,083627,Boyle; Mary E. T.,14,0,60,46
1657819767439,COGS 118A,A01,083075,Gupta; Anjum,21,0,76,55
1657819773468,CSE 3,A50,083646,Miranda; Gregory Joseph,24,0,50,26
1657819779499,CSE 8A,A50,083650,Miranda; Gregory Joseph,17,1,56,39
1657819785529,CSE 11,A01,083080,Cao; Yingjun,6,15,40,34
1657819791556,CSE 12,A01,083652,Krause-Levy; Sophia Louisa,28,1,120,92
1657819797579,CSE 15L,A01,083654,Morris; Justin Loren,9,0,50,41
1657819797579,CSE 15L,A02,083655,Morris; Justin Loren,9,0,50,41
1657819803606,CSE 20,A01,083657,Tran; Khoa Dang,39,0,80,41
1657819809634,CSE 21,A01,095574,Bach; Quang Tran,22,0,48,26
1657819815661,CSE 30,A01,083084,Eldon; John,6,0,80,74
1657819815661,CSE 30,B01,095061,Bhaskar; Nishant,9,0,50,41
1657819821689,CSE 100,A01,083659,Cao; Yingjun,5,4,70,65
1657819827718,CSE 134B,A01,083661,Powell; Thomas Allan,24,0,100,76
1657819833740,CSE 140,A01,083663,Gungor; Onat,15,0,85,70
1657819839768,CSE 140L,A01,083088,Eldon; John,23,0,100,77
1657819845792,CSE 175,A01,083665,Kumar; Rakesh,3,0,25,22
1657819851820,CSE 190,A00,092507,Dubnov; Shlomo,8,0,20,12
1657819857845,ECE 45,A01,083139,Congero; Spencer William,6,0,75,69
1657819863871,ECE 65,A50,083695,Saad; Andrew S,12,0,30,18
1657819863871,ECE 65,A51,095125,Saad; Andrew S,24,0,26,2
1657819869896,ECE 109,A01,091882,Touri; Behrouz,20,0,70,50
1657819875921,ECE 180,A00,083140,Abi Samra; Nicholas Camill,1,0,30,29
1657819875921,ECE 180,B00,083141,Abi Samra; Nicholas Camill,0,0,30,30
1657819881952,MATH 10A,A01,083735,Patchell; Gregory David,2,0,30,28
1657819881952,MATH 10A,A02,083736,Patchell; Gregory David,20,0,30,10
1657819881952,MATH 10A,A03,083737,Patchell; Gregory David,16,0,30,14
1657819887977,MATH 10B,A01,083207,Lim; Seonhee,8,0,34,26
1657819887977,MATH 10B,A02,083208,Lim; Seonhee,10,0,35,25
1657819887977,MATH 10B,A03,093472,Lim; Seonhee,7,0,34,27
1657819887977,MATH 10B,B01,083739,Sinha; Shubham,13,0,30,17
1657819894075,MATH 18,A01,083743,Cinel; Cameron Alexander,9,0,30,21
1657819894075,MATH 18,A02,083744,Cinel; Cameron Alexander,18,0,30,12
1657819894075,MATH 18,A03,083745,Cinel; Cameron Alexander,10,0,30,20
1657819894075,MATH 18,B01,083748,Rideout; David Porter,5,0,37,32
1657819894075,MATH 18,B02,083749,Rideout; David Porter,5,0,36,31
1657819894075,MATH 18,B03,083750,Rideout; David Porter,3,0,37,34
1657819894075,MATH 18,B04,083751,Rideout; David Porter,6,0,36,30
1657819894075,MATH 18,B05,093473,Rideout; David Porter,6,0,36,30
1657819894075,MATH 18,B06,093474,Rideout; David Porter,6,0,36,30
1657819900105,MATH 20A,A01,083754,Zheng; Zequn,14,0,40,26
1657819906135,MATH 20B,A01,083756,Briones; Jor-el Thomas Caparas,4,0,36,32
1657819906135,MATH 20B,A02,083757,Briones; Jor-el Thomas Caparas,1,0,36,35
1657819906135,MATH 20B,A03,093475,Briones; Jor-el Thomas Caparas,2,0,36,34
1657819912163,MATH 20C,A01,083760,Briones; Jor-el Thomas Caparas,1,0,35,34
1657819912163,MATH 20C,A02,083761,Briones; Jor-el Thomas Caparas,8,0,35,27
1657819912163,MATH 20C,A03,093476,Briones; Jor-el Thomas Caparas,0,1,36,36
1657819912163,MATH 20C,B01,083762,Bach; Quang Tran,1,0,30,29
1657819918192,MATH 20D,A01,083765,Tran; Brian Kha,5,0,30,25
1657819918192,MATH 20D,A02,083766,Tran; Brian Kha,5,0,30,25
1657819918192,MATH 20D,A03,083767,Tran; Brian Kha,5,0,30,25
1657819924216,MATH 20E,A01,083771,Ganguly; Soumya,10,0,32,22
1657819924216,MATH 20E,A02,083772,Ganguly; Soumya,6,0,32,26
1657819924216,MATH 20E,B01,083773,Ciotti; Benjamin,20,0,35,15
1657819924216,MATH 20E,B02,083774,Ciotti; Benjamin,18,0,35,17
1657819930241,MATH 103A,A01,083777,Greenfeld; Be'Eri,3,0,36,33
1657819930241,MATH 103A,A02,083778,Greenfeld; Be'Eri,5,0,36,31
1657819930241,MATH 103A,A03,093561,Greenfeld; Be'Eri,6,0,36,30
1657819930241,MATH 103A,B01,083779,Greenfeld; Be'Eri,7,0,36,29
1657819930241,MATH 103A,B02,083780,Greenfeld; Be'Eri,4,0,36,32
1657819930241,MATH 103A,B03,093562,Greenfeld; Be'Eri,3,0,36,33
1657819936268,MATH 105,A01,085443,Carter; Anne Toulson,15,0,35,20
1657819936268,MATH 105,A02,093477,Carter; Anne Toulson,20,0,35,15
1657819942296,MATH 109,A01,083213,Ganzberger; Geoffrey Michael,3,0,34,31
1657819942296,MATH 109,A02,083214,Ganzberger; Geoffrey Michael,4,0,34,30
1657819942296,MATH 109,A03,093478,Ganzberger; Geoffrey Michael,2,0,34,32
1657819942296,MATH 109,B01,083215,Ganzberger; Geoffrey Michael,1,0,32,31
1657819942296,MATH 109,B02,083216,Ganzberger; Geoffrey Michael,2,0,32,30
1657819942296,MATH 109,B03,093479,Ganzberger; Geoffrey Michael,8,0,32,24
1657819948331,MATH 142A,A01,083219,Chow; Bennett,7,0,32,25
1657819948331,MATH 142A,A02,083220,Chow; Bennett,10,0,32,22
1657819948331,MATH 142A,A03,093480,Chow; Bennett,9,0,32,23
1657819948331,MATH 142A,B03,093481,Chow; Bennett,8,0,32,24
1657819948331,MATH 142A,B04,093558,Chow; Bennett,13,0,32,19
1657819948331,MATH 142A,B05,093559,Chow; Bennett,7,0,32,25
1657819954354,MATH 193A,A01,083224,Rotar; Vladimir,8,0,34,26
1657819954354,MATH 193A,A02,083225,Rotar; Vladimir,9,0,34,25
1657819954354,MATH 193A,A03,083781,Rotar; Vladimir,5,0,34,29
1657819954354,MATH 193A,A04,083782,Rotar; Vladimir,11,0,34,23
1657819954354,MATH 193A,A05,093482,Rotar; Vladimir,10,0,34,24
1657819960376,MATH 197,001,091859,McAuley; Julian John,9999,0,9999,0
1657819960376,MATH 197,002,095566,Kedlaya; Kiran S.,9997,0,9999,2
1657819960376,MATH 197,003,095567,Xiao; Ming,9999,0,9999,0
1657819960376,MATH 197,004,095571,Perols; Johan Lars,9998,0,9999,1
1657819967450,COGS 9,A01,083615,Shannon; Kyle Michael,9,0,75,66
1657819973476,COGS 11,A01,083617,Boyle; Mary E. T.,23,0,48,25
1657819979500,COGS 13,A01,083071,Bastos; Amalia Pinkusfeld,11,0,71,60
1657819985523,COGS 14A,A01,092681,Semenuks; Arturs,5,1,100,95
1657819991557,COGS 14B,A01,083073,Cheng; Tzu-Han,6,0,63,57
1657819997582,COGS 17,A01,092677,Semenuks; Arturs,6,0,81,75
1657820003609,COGS 100,A01,083619,Allen; Michael Gordon,17,0,70,53
1657820009638,COGS 101A,A01,083621,Davis; Joshua Daniel,9,0,68,59
1657820015664,COGS 101B,A01,091572,Allen; Michael Gordon,12,0,65,53
1657820021690,COGS 101C,A01,083625,Delgado; Tania,17,0,35,18
1657820027723,COGS 107A,A01,083627,Boyle; Mary E. T.,14,0,60,46
1657820033746,COGS 118A,A01,083075,Gupta; Anjum,21,0,76,55
1657820039782,CSE 3,A50,083646,Miranda; Gregory Joseph,24,0,50,26
1657820045815,CSE 8A,A50,083650,Miranda; Gregory Joseph,17,1,56,39
1657820051838,CSE 11,A01,083080,Cao; Yingjun,6,15,40,34
1657820057860,CSE 12,A01,083652,Krause-Levy; Sophia Louisa,28,1,120,92
1657820063883,CSE 15L,A01,083654,Morris; Justin Loren,9,0,50,41
1657820063883,CSE 15L,A02,083655,Morris; Justin Loren,9,0,50,41
1657820069909,CSE 20,A01,083657,Tran; Khoa Dang,39,0,80,41
1657820075933,CSE 21,A01,095574,Bach; Quang Tran,22,0,48,26
1657820081958,CSE 30,A01,083084,Eldon; John,6,0,80,74
1657820081958,CSE 30,B01,095061,Bhaskar; Nishant,9,0,50,41
1657820087988,CSE 100,A01,083659,Cao; Yingjun,5,4,70,65
1657820094010,CSE 134B,A01,083661,Powell; Thomas Allan,24,0,100,76
1657820100031,CSE 140,A01,083663,Gungor; Onat,15,0,85,70
1657820106055,CSE 140L,A01,083088,Eldon; John,23,0,100,77
1657820112082,CSE 175,A01,083665,Kumar; Rakesh,3,0,25,22
1657820118115,CSE 190,A00,092507,Dubnov; Shlomo,8,0,20,12
1657820124140,ECE 45,A01,083139,Congero; Spencer William,6,0,75,69
1657820130162,ECE 65,A50,083695,Saad; Andrew S,12,0,30,18
1657820130162,ECE 65,A51,095125,Saad; Andrew S,24,0,26,2
1657820136189,ECE 109,A01,091882,Touri; Behrouz,20,0,70,50
1657820142213,ECE 180,A00,083140,Abi Samra; Nicholas Camill,1,0,30,29
1657820142213,ECE 180,B00,083141,Abi Samra; Nicholas Camill,0,0,30,30
1657820148245,MATH 10A,A01,083735,Patchell; Gregory David,2,0,30,28
1657820148245,MATH 10A,A02,083736,Patchell; Gregory David,20,0,30,10
1657820148245,MATH 10A,A03,083737,Patchell; Gregory David,16,0,30,14
1657820154273,MATH 10B,A01,083207,Lim; Seonhee,8,0,34,26
1657820154273,MATH 10B,A02,083208,Lim; Seonhee,10,0,35,25
1657820154273,MATH 10B,A03,093472,Lim; Seonhee,7,0,34,27
1657820154273,MATH 10B,B01,083739,Sinha; Shubham,13,0,30,17
1657820160299,MATH 18,A01,083743,Cinel; Cameron Alexander,9,0,30,21
1657820160299,MATH 18,A02,083744,Cinel; Cameron Alexander,18,0,30,12
1657820160299,MATH 18,A03,083745,Cinel; Cameron Alexander,10,0,30,20
1657820160299,MATH 18,B01,083748,Rideout; David Porter,5,0,37,32
1657820160299,MATH 18,B02,083749,Rideout; David Porter,5,0,36,31
1657820160299,MATH 18,B03,083750,Rideout; David Porter,3,0,37,34
1657820160299,MATH 18,B04,083751,Rideout; David Porter,6,0,36,30
1657820160299,MATH 18,B05,093473,Rideout; David Porter,6,0,36,30
1657820160299,MATH 18,B06,093474,Rideout; David Porter,6,0,36,30
1657820166323,MATH 20A,A01,083754,Zheng; Zequn,14,0,40,26
1657820172355,MATH 20B,A01,083756,Briones; Jor-el Thomas Caparas,4,0,36,32
1657820172355,MATH 20B,A02,083757,Briones; Jor-el Thomas Caparas,1,0,36,35
1657820172355,MATH 20B,A03,093475,Briones; Jor-el Thomas Caparas,2,0,36,34
1657820178384,MATH 20C,A01,083760,Briones; Jor-el Thomas Caparas,1,0,35,34
1657820178384,MATH 20C,A02,083761,Briones; Jor-el Thomas Caparas,8,0,35,27
1657820178384,MATH 20C,A03,093476,Briones; Jor-el Thomas Caparas,0,1,36,36
1657820178384,MATH 20C,B01,083762,Bach; Quang Tran,1,0,30,29
1657820184424,MATH 20D,A01,083765,Tran; Brian Kha,5,0,30,25
1657820184424,MATH 20D,A02,083766,Tran; Brian Kha,5,0,30,25
1657820184424,MATH 20D,A03,083767,Tran; Brian Kha,5,0,30,25
1657820190449,MATH 20E,A01,083771,Ganguly; Soumya,10,0,32,22
1657820190449,MATH 20E,A02,083772,Ganguly; Soumya,6,0,32,26
1657820190449,MATH 20E,B01,083773,Ciotti; Benjamin,20,0,35,15
1657820190449,MATH 20E,B02,083774,Ciotti; Benjamin,18,0,35,17
1657820196477,MATH 103A,A01,083777,Greenfeld; Be'Eri,3,0,36,33
1657820196477,MATH 103A,A02,083778,Greenfeld; Be'Eri,5,0,36,31
1657820196477,MATH 103A,A03,093561,Greenfeld; Be'Eri,6,0,36,30
1657820196477,MATH 103A,B01,083779,Greenfeld; Be'Eri,7,0,36,29
1657820196477,MATH 103A,B02,083780,Greenfeld; Be'Eri,4,0,36,32
1657820196477,MATH 103A,B03,093562,Greenfeld; Be'Eri,3,0,36,33
1657820202503,MATH 105,A01,085443,Carter; Anne Toulson,15,0,35,20
1657820202503,MATH 105,A02,093477,Carter; Anne Toulson,20,0,35,15
1657820208533,MATH 109,A01,083213,Ganzberger; Geoffrey Michael,3,0,34,31
1657820208533,MATH 109,A02,083214,Ganzberger; Geoffrey Michael,4,0,34,30
1657820208533,MATH 109,A03,093478,Ganzberger; Geoffrey Michael,2,0,34,32
1657820208533,MATH 109,B01,083215,Ganzberger; Geoffrey Michael,1,0,32,31
1657820208533,MATH 109,B02,083216,Ganzberger; Geoffrey Michael,2,0,32,30
1657820208533,MATH 109,B03,093479,Ganzberger; Geoffrey Michael,8,0,32,24
1657820214558,MATH 142A,A01,083219,Chow; Bennett,7,0,32,25
1657820214558,MATH 142A,A02,083220,Chow; Bennett,10,0,32,22
1657820214558,MATH 142A,A03,093480,Chow; Bennett,9,0,32,23
1657820214558,MATH 142A,B03,093481,Chow; Bennett,8,0,32,24
1657820214558,MATH 142A,B04,093558,Chow; Bennett,13,0,32,19
1657820214558,MATH 142A,B05,093559,Chow; Bennett,7,0,32,25
1657820220585,MATH 193A,A01,083224,Rotar; Vladimir,8,0,34,26
1657820220585,MATH 193A,A02,083225,Rotar; Vladimir,9,0,34,25
1657820220585,MATH 193A,A03,083781,Rotar; Vladimir,5,0,34,29
1657820220585,MATH 193A,A04,083782,Rotar; Vladimir,11,0,34,23
1657820220585,MATH 193A,A05,093482,Rotar; Vladimir,10,0,34,24
1657820226613,MATH 197,001,091859,McAuley; Julian John,9999,0,9999,0
1657820226613,MATH 197,002,095566,Kedlaya; Kiran S.,9997,0,9999,2
1657820226613,MATH 197,003,095567,Xiao; Ming,9999,0,9999,0
1657820226613,MATH 197,004,095571,Perols; Johan Lars,9998,0,9999,1
1657820233668,COGS 9,A01,083615,Shannon; Kyle Michael,9,0,75,66
1657820239696,COGS 11,A01,083617,Boyle; Mary E. T.,23,0,48,25
1657820245721,COGS 13,A01,083071,Bastos; Amalia Pinkusfeld,11,0,71,60
1657820251745,COGS 14A,A01,092681,Semenuks; Arturs,5,1,100,95
1657820257769,COGS 14B,A01,083073,Cheng; Tzu-Han,6,0,63,57
1657820263791,COGS 17,A01,092677,Semenuks; Arturs,6,0,81,75
1657820269813,COGS 100,A01,083619,Allen; Michael Gordon,17,0,70,53
1657820275849,COGS 101A,A01,083621,Davis; Joshua Daniel,9,0,68,59
1657820281877,COGS 101B,A01,091572,Allen; Michael Gordon,12,0,65,53
1657820287899,COGS 101C,A01,083625,Delgado; Tania,17,0,35,18
1657820293926,COGS 107A,A01,083627,Boyle; Mary E. T.,14,0,60,46
1657820299951,COGS 118A,A01,083075,Gupta; Anjum,21,0,76,55
1657820305975,CSE 3,A50,083646,Miranda; Gregory Joseph,24,0,50,26
1657820312001,CSE 8A,A50,083650,Miranda; Gregory Joseph,17,1,56,39
1657820318028,CSE 11,A01,083080,Cao; Yingjun,6,15,40,34
1657820324051,CSE 12,A01,083652,Krause-Levy; Sophia Louisa,28,1,120,92
1657820330079,CSE 15L,A01,083654,Morris; Justin Loren,9,0,50,41
1657820330079,CSE 15L,A02,083655,Morris; Justin Loren,9,0,50,41
1657820336101,CSE 20,A01,083657,Tran; Khoa Dang,39,0,80,41
1657820342124,CSE 21,A01,095574,Bach; Quang Tran,22,0,48,26
1657820348152,CSE 30,A01,083084,Eldon; John,6,0,80,74
1657820348152,CSE 30,B01,095061,Bhaskar; Nishant,9,0,50,41
1657820354190,CSE 100,A01,083659,Cao; Yingjun,5,4,70,65
1657820360213,CSE 134B,A01,083661,Powell; Thomas Allan,24,0,100,76
1657820366236,CSE 140,A01,083663,Gungor; Onat,15,0,85,70
1657820372273,CSE 140L,A01,083088,Eldon; John,23,0,100,77
1657820378300,CSE 175,A01,083665,Kumar; Rakesh,3,0,25,22
1657820384325,CSE 190,A00,092507,Dubnov; Shlomo,8,0,20,12
1657820390369,ECE 45,A01,083139,Congero; Spencer William,6,0,75,69
1657820396392,ECE 65,A50,083695,Saad; Andrew S,12,0,30,18
1657820396392,ECE 65,A51,095125,Saad; Andrew S,24,0,26,2
1657820402417,ECE 109,A01,091882,Touri; Behrouz,20,0,70,50
1657820408445,ECE 180,A00,083140,Abi Samra; Nicholas Camill,1,0,30,29
1657820408445,ECE 180,B00,083141,Abi Samra; Nicholas Camill,0,0,30,30
1657820414472,MATH 10A,A01,083735,Patchell; Gregory David,2,0,30,28
1657820414472,MATH 10A,A02,083736,Patchell; Gregory David,20,0,30,10
1657820414472,MATH 10A,A03,083737,Patchell; Gregory David,16,0,30,14
1657820420502,MATH 10B,A01,083207,Lim; Seonhee,8,0,34,26
1657820420502,MATH 10B,A02,083208,Lim; Seonhee,10,0,35,25
1657820420502,MATH 10B,A03,093472,Lim; Seonhee,7,0,34,27
1657820420502,MATH 10B,B01,083739,Sinha; Shubham,13,0,30,17
1657820426526,MATH 18,A01,083743,Cinel; Cameron Alexander,9,0,30,21
1657820426526,MATH 18,A02,083744,Cinel; Cameron Alexander,18,0,30,12
1657820426526,MATH 18,A03,083745,Cinel; Cameron Alexander,10,0,30,20
1657820426526,MATH 18,B01,083748,Rideout; David Porter,5,0,37,32
1657820426526,MATH 18,B02,083749,Rideout; David Porter,5,0,36,31
1657820426526,MATH 18,B03,083750,Rideout; David Porter,3,0,37,34
1657820426526,MATH 18,B04,083751,Rideout; David Porter,6,0,36,30
1657820426526,MATH 18,B05,093473,Rideout; David Porter,6,0,36,30
1657820426526,MATH 18,B06,093474,Rideout; David Porter,6,0,36,30
1657820432560,MATH 20A,A01,083754,Zheng; Zequn,14,0,40,26
1657820438589,MATH 20B,A01,083756,Briones; Jor-el Thomas Caparas,4,0,36,32
1657820438589,MATH 20B,A02,083757,Briones; Jor-el Thomas Caparas,1,0,36,35
1657820438589,MATH 20B,A03,093475,Briones; Jor-el Thomas Caparas,2,0,36,34
1657820444612,MATH 20C,A01,083760,Briones; Jor-el Thomas Caparas,1,0,35,34
1657820444612,MATH 20C,A02,083761,Briones; Jor-el Thomas Caparas,8,0,35,27
1657820444612,MATH 20C,A03,093476,Briones; Jor-el Thomas Caparas,0,1,36,36
1657820444612,MATH 20C,B01,083762,Bach; Quang Tran,1,0,30,29
1657820450648,MATH 20D,A01,083765,Tran; Brian Kha,5,0,30,25
1657820450648,MATH 20D,A02,083766,Tran; Brian Kha,5,0,30,25
1657820450648,MATH 20D,A03,083767,Tran; Brian Kha,5,0,30,25
1657820456676,MATH 20E,A01,083771,Ganguly; Soumya,10,0,32,22
1657820456676,MATH 20E,A02,083772,Ganguly; Soumya,6,0,32,26
1657820456676,MATH 20E,B01,083773,Ciotti; Benjamin,20,0,35,15
1657820456676,MATH 20E,B02,083774,Ciotti; Benjamin,18,0,35,17
1657820462699,MATH 103A,A01,083777,Greenfeld; Be'Eri,3,0,36,33
1657820462699,MATH 103A,A02,083778,Greenfeld; Be'Eri,5,0,36,31
1657820462699,MATH 103A,A03,093561,Greenfeld; Be'Eri,6,0,36,30
1657820462699,MATH 103A,B01,083779,Greenfeld; Be'Eri,7,0,36,29
1657820462699,MATH 103A,B02,083780,Greenfeld; Be'Eri,4,0,36,32
1657820462699,MATH 103A,B03,093562,Greenfeld; Be'Eri,3,0,36,33
1657820468732,MATH 105,A01,085443,Carter; Anne Toulson,15,0,35,20
1657820468732,MATH 105,A02,093477,Carter; Anne Toulson,20,0,35,15
1657820474759,MATH 109,A01,083213,Ganzberger; Geoffrey Michael,3,0,34,31
1657820474759,MATH 109,A02,083214,Ganzberger; Geoffrey Michael,4,0,34,30
1657820474759,MATH 109,A03,093478,Ganzberger; Geoffrey Michael,2,0,34,32
1657820474759,MATH 109,B01,083215,Ganzberger; Geoffrey Michael,1,0,32,31
1657820474759,MATH 109,B02,083216,Ganzberger; Geoffrey Michael,2,0,32,30
1657820474759,MATH 109,B03,093479,Ganzberger; Geoffrey Michael,8,0,32,24
1657820480781,MATH 142A,A01,083219,Chow; Bennett,7,0,32,25
1657820480781,MATH 142A,A02,083220,Chow; Bennett,10,0,32,22
1657820480781,MATH 142A,A03,093480,Chow; Bennett,9,0,32,23
1657820480781,MATH 142A,B03,093481,Chow; Bennett,8,0,32,24
1657820480781,MATH 142A,B04,093558,Chow; Bennett,13,0,32,19
1657820480781,MATH 142A,B05,093559,Chow; Bennett,7,0,32,25
1657820486811,MATH 193A,A01,083224,Rotar; Vladimir,8,0,34,26
1657820486811,MATH 193A,A02,083225,Rotar; Vladimir,9,0,34,25
1657820486811,MATH 193A,A03,083781,Rotar; Vladimir,5,0,34,29
1657820486811,MATH 193A,A04,083782,Rotar; Vladimir,11,0,34,23
1657820486811,MATH 193A,A05,093482,Rotar; Vladimir,10,0,34,24
1657820492904,MATH 197,001,091859,McAuley; Julian John,9999,0,9999,0
1657820492904,MATH 197,002,095566,Kedlaya; Kiran S.,9997,0,9999,2
1657820492904,MATH 197,003,095567,Xiao; Ming,9999,0,9999,0
1657820492904,MATH 197,004,095571,Perols; Johan Lars,9998,0,9999,1
1657820499965,COGS 9,A01,083615,Shannon; Kyle Michael,9,0,75,66
1657820505988,COGS 11,A01,083617,Boyle; Mary E. T.,23,0,48,25
1657820512009,COGS 13,A01,083071,Bastos; Amalia Pinkusfeld,11,0,71,60
1657820518033,COGS 14A,A01,092681,Semenuks; Arturs,5,1,100,95
1657820524086,COGS 14B,A01,083073,Cheng; Tzu-Han,6,0,63,57
1657820530111,COGS 17,A01,092677,Semenuks; Arturs,6,0,81,75
1657820536134,COGS 100,A01,083619,Allen; Michael Gordon,17,0,70,53
1657820542159,COGS 101A,A01,083621,Davis; Joshua Daniel,9,0,68,59
1657820548182,COGS 101B,A01,091572,Allen; Michael Gordon,12,0,65,53
1657820554206,COGS 101C,A01,083625,Delgado; Tania,17,0,35,18
1657820560240,COGS 107A,A01,083627,Boyle; Mary E. T.,14,0,60,46
1657820566266,COGS 118A,A01,083075,Gupta; Anjum,21,0,76,55
1657820572294,CSE 3,A50,083646,Miranda; Gregory Joseph,24,0,50,26
1657820578322,CSE 8A,A50,083650,Miranda; Gregory Joseph,17,1,56,39
1657820584344,CSE 11,A01,083080,Cao; Yingjun,6,15,40,34
1657820590381,CSE 12,A01,083652,Krause-Levy; Sophia Louisa,28,1,120,92
1657820596408,CSE 15L,A01,083654,Morris; Justin Loren,9,0,50,41
1657820596408,CSE 15L,A02,083655,Morris; Justin Loren,9,0,50,41
1657820602439,CSE 20,A01,083657,Tran; Khoa Dang,39,0,80,41
1657820608479,CSE 21,A01,095574,Bach; Quang Tran,22,0,48,26
1657820614502,CSE 30,A01,083084,Eldon; John,6,0,80,74
1657820614502,CSE 30,B01,095061,Bhaskar; Nishant,9,0,50,41
1657820620525,CSE 100,A01,083659,Cao; Yingjun,5,4,70,65
1657820626553,CSE 134B,A01,083661,Powell; Thomas Allan,24,0,100,76
1657820632578,CSE 140,A01,083663,Gungor; Onat,15,0,85,70
1657820638604,CSE 140L,A01,083088,Eldon; John,23,0,100,77
1657820644634,CSE 175,A01,083665,Kumar; Rakesh,3,0,25,22
1657820650670,CSE 190,A00,092507,Dubnov; Shlomo,8,0,20,12
1657820656696,ECE 45,A01,083139,Congero; Spencer William,6,0,75,69
1657820662717,ECE 65,A50,083695,Saad; Andrew S,12,0,30,18
1657820662717,ECE 65,A51,095125,Saad; Andrew S,24,0,26,2
1657820668744,ECE 109,A01,091882,Touri; Behrouz,20,0,70,50
1657820674769,ECE 180,A00,083140,Abi Samra; Nicholas Camill,1,0,30,29
1657820674769,ECE 180,B00,083141,Abi Samra; Nicholas Camill,0,0,30,30
1657820680797,MATH 10A,A01,083735,Patchell; Gregory David,2,0,30,28
1657820680797,MATH 10A,A02,083736,Patchell; Gregory David,20,0,30,10
1657820680797,MATH 10A,A03,083737,Patchell; Gregory David,16,0,30,14
1657820686822,MATH 10B,A01,083207,Lim; Seonhee,8,0,34,26
1657820686822,MATH 10B,A02,083208,Lim; Seonhee,10,0,35,25
1657820686822,MATH 10B,A03,093472,Lim; Seonhee,7,0,34,27
1657820686822,MATH 10B,B01,083739,Sinha; Shubham,13,0,30,17
1657820692846,MATH 18,A01,083743,Cinel; Cameron Alexander,9,0,30,21
1657820692846,MATH 18,A02,083744,Cinel; Cameron Alexander,18,0,30,12
1657820692846,MATH 18,A03,083745,Cinel; Cameron Alexander,10,0,30,20
1657820692846,MATH 18,B01,083748,Rideout; David Porter,5,0,37,32
1657820692846,MATH 18,B02,083749,Rideout; David Porter,5,0,36,31
1657820692846,MATH 18,B03,083750,Rideout; David Porter,3,0,37,34
1657820692846,MATH 18,B04,083751,Rideout; David Porter,6,0,36,30
1657820692846,MATH 18,B05,093473,Rideout; David Porter,6,0,36,30
1657820692846,MATH 18,B06,093474,Rideout; David Porter,6,0,36,30
1657820698872,MATH 20A,A01,083754,Zheng; Zequn,14,0,40,26
1657820704907,MATH 20B,A01,083756,Briones; Jor-el Thomas Caparas,4,0,36,32
1657820704907,MATH 20B,A02,083757,Briones; Jor-el Thomas Caparas,1,0,36,35
1657820704907,MATH 20B,A03,093475,Briones; Jor-el Thomas Caparas,2,0,36,34
1657820710940,MATH 20C,A01,083760,Briones; Jor-el Thomas Caparas,1,0,35,34
1657820710940,MATH 20C,A02,083761,Briones; Jor-el Thomas Caparas,8,0,35,27
1657820710940,MATH 20C,A03,093476,Briones; Jor-el Thomas Caparas,0,1,36,36
1657820710940,MATH 20C,B01,083762,Bach; Quang Tran,1,0,30,29
1657820716969,MATH 20D,A01,083765,Tran; Brian Kha,5,0,30,25
1657820716969,MATH 20D,A02,083766,Tran; Brian Kha,5,0,30,25
1657820716969,MATH 20D,A03,083767,Tran; Brian Kha,5,0,30,25
1657820723001,MATH 20E,A01,083771,Ganguly; Soumya,10,0,32,22
1657820723001,MATH 20E,A02,083772,Ganguly; Soumya,6,0,32,26
1657820723001,MATH 20E,B01,083773,Ciotti; Benjamin,20,0,35,15
1657820723001,MATH 20E,B02,083774,Ciotti; Benjamin,18,0,35,17
1657820729026,MATH 103A,A01,083777,Greenfeld; Be'Eri,3,0,36,33
1657820729026,MATH 103A,A02,083778,Greenfeld; Be'Eri,5,0,36,31
1657820729026,MATH 103A,A03,093561,Greenfeld; Be'Eri,6,0,36,30
1657820729026,MATH 103A,B01,083779,Greenfeld; Be'Eri,7,0,36,29
1657820729026,MATH 103A,B02,083780,Greenfeld; Be'Eri,4,0,36,32
1657820729026,MATH 103A,B03,093562,Greenfeld; Be'Eri,3,0,36,33
1657820735048,MATH 105,A01,085443,Carter; Anne Toulson,15,0,35,20
1657820735048,MATH 105,A02,093477,Carter; Anne Toulson,20,0,35,15
1657820741098,MATH 109,A01,083213,Ganzberger; Geoffrey Michael,3,0,34,31
1657820741098,MATH 109,A02,083214,Ganzberger; Geoffrey Michael,4,0,34,30
1657820741098,MATH 109,A03,093478,Ganzberger; Geoffrey Michael,2,0,34,32
1657820741098,MATH 109,B01,083215,Ganzberger; Geoffrey Michael,1,0,32,31
1657820741098,MATH 109,B02,083216,Ganzberger; Geoffrey Michael,2,0,32,30
1657820741098,MATH 109,B03,093479,Ganzberger; Geoffrey Michael,8,0,32,24
1657820747143,MATH 142A,A01,083219,Chow; Bennett,7,0,32,25
1657820747143,MATH 142A,A02,083220,Chow; Bennett,10,0,32,22
1657820747143,MATH 142A,A03,093480,Chow; Bennett,9,0,32,23
1657820747143,MATH 142A,B03,093481,Chow; Bennett,8,0,32,24
1657820747143,MATH 142A,B04,093558,Chow; Bennett,13,0,32,19
1657820747143,MATH 142A,B05,093559,Chow; Bennett,7,0,32,25
1657820753171,MATH 193A,A01,083224,Rotar; Vladimir,8,0,34,26
1657820753171,MATH 193A,A02,083225,Rotar; Vladimir,9,0,34,25
1657820753171,MATH 193A,A03,083781,Rotar; Vladimir,5,0,34,29
1657820753171,MATH 193A,A04,083782,Rotar; Vladimir,11,0,34,23
1657820753171,MATH 193A,A05,093482,Rotar; Vladimir,10,0,34,24
1657820759196,MATH 197,001,091859,McAuley; Julian John,9999,0,9999,0
1657820759196,MATH 197,002,095566,Kedlaya; Kiran S.,9997,0,9999,2
1657820759196,MATH 197,003,095567,Xiao; Ming,9999,0,9999,0
1657820759196,MATH 197,004,095571,Perols; Johan Lars,9998,0,9999,1
1657820766282,COGS 9,A01,083615,Shannon; Kyle Michael,9,0,75,66
1657820772305,COGS 11,A01,083617,Boyle; Mary E. T.,23,0,48,25
1657820778348,COGS 13,A01,083071,Bastos; Amalia Pinkusfeld,11,0,71,60
1657820784372,COGS 14A,A01,092681,Semenuks; Arturs,5,1,100,95
1657820790396,COGS 14B,A01,083073,Cheng; Tzu-Han,6,0,63,57
1657820796423,COGS 17,A01,092677,Semenuks; Arturs,6,0,81,75
1657820802462,COGS 100,A01,083619,Allen; Michael Gordon,17,0,70,53
1657820808495,COGS 101A,A01,083621,Davis; Joshua Daniel,9,0,68,59
1657820814519,COGS 101B,A01,091572,Allen; Michael Gordon,12,0,65,53
1657820820546,COGS 101C,A01,083625,Delgado; Tania,17,0,35,18
1657820826575,COGS 107A,A01,083627,Boyle; Mary E. T.,14,0,60,46
1657820832600,COGS 118A,A01,083075,Gupta; Anjum,21,0,76,55
1657820838627,CSE 3,A50,083646,Miranda; Gregory Joseph,24,0,50,26
1657820844665,CSE 8A,A50,083650,Miranda; Gregory Joseph,17,1,56,39
1657820850689,CSE 11,A01,083080,Cao; Yingjun,6,15,40,34
1657820856711,CSE 12,A01,083652,Krause-Levy; Sophia Louisa,28,1,120,92
1657820862740,CSE 15L,A01,083654,Morris; Justin Loren,9,0,50,41
1657820862740,CSE 15L,A02,083655,Morris; Justin Loren,9,0,50,41
1657820868777,CSE 20,A01,083657,Tran; Khoa Dang,39,0,80,41
1657820874805,CSE 21,A01,095574,Bach; Quang Tran,22,0,48,26
1657820880833,CSE 30,A01,083084,Eldon; John,6,0,80,74
1657820880833,CSE 30,B01,095061,Bhaskar; Nishant,9,0,50,41
1657820886859,CSE 100,A01,083659,Cao; Yingjun,5,4,70,65
1657820892881,CSE 134B,A01,083661,Powell; Thomas Allan,24,0,100,76
1657820898904,CSE 140,A01,083663,Gungor; Onat,15,0,85,70
1657820904929,CSE 140L,A01,083088,Eldon; John,23,0,100,77
1657820910951,CSE 175,A01,083665,Kumar; Rakesh,3,0,25,22
1657820916974,CSE 190,A00,092507,Dubnov; Shlomo,8,0,20,12
1657820922998,ECE 45,A01,083139,Congero; Spencer William,6,0,75,69
1657820929024,ECE 65,A50,083695,Saad; Andrew S,12,0,30,18
1657820929024,ECE 65,A51,095125,Saad; Andrew S,24,0,26,2
1657820935051,ECE 109,A01,091882,Touri; Behrouz,20,0,70,50
1657820941074,ECE 180,A00,083140,Abi Samra; Nicholas Camill,1,0,30,29
1657820941074,ECE 180,B00,083141,Abi Samra; Nicholas Camill,0,0,30,30
1657820947096,MATH 10A,A01,083735,Patchell; Gregory David,2,0,30,28
1657820947096,MATH 10A,A02,083736,Patchell; Gregory David,20,0,30,10
1657820947096,MATH 10A,A03,083737,Patchell; Gregory David,16,0,30,14
1657820953130,MATH 10B,A01,083207,Lim; Seonhee,8,0,34,26
1657820953130,MATH 10B,A02,083208,Lim; Seonhee,10,0,35,25
1657820953130,MATH 10B,A03,093472,Lim; Seonhee,7,0,34,27
1657820953130,MATH 10B,B01,083739,Sinha; Shubham,13,0,30,17
1657820959162,MATH 18,A01,083743,Cinel; Cameron Alexander,9,0,30,21
1657820959162,MATH 18,A02,083744,Cinel; Cameron Alexander,18,0,30,12
1657820959162,MATH 18,A03,083745,Cinel; Cameron Alexander,10,0,30,20
1657820959162,MATH 18,B01,083748,Rideout; David Porter,5,0,37,32
1657820959162,MATH 18,B02,083749,Rideout; David Porter,5,0,36,31
1657820959162,MATH 18,B03,083750,Rideout; David Porter,3,0,37,34
1657820959162,MATH 18,B04,083751,Rideout; David Porter,6,0,36,30
1657820959162,MATH 18,B05,093473,Rideout; David Porter,6,0,36,30
1657820959162,MATH 18,B06,093474,Rideout; David Porter,6,0,36,30
1657820965190,MATH 20A,A01,083754,Zheng; Zequn,14,0,40,26
1657820971213,MATH 20B,A01,083756,Briones; Jor-el Thomas Caparas,4,0,36,32
1657820971213,MATH 20B,A02,083757,Briones; Jor-el Thomas Caparas,1,0,36,35
1657820971213,MATH 20B,A03,093475,Briones; Jor-el Thomas Caparas,2,0,36,34
1657820977244,MATH 20C,A01,083760,Briones; Jor-el Thomas Caparas,1,0,35,34
1657820977244,MATH 20C,A02,083761,Briones; Jor-el Thomas Caparas,8,0,35,27
1657820977244,MATH 20C,A03,093476,Briones; Jor-el Thomas Caparas,0,1,36,36
1657820977244,MATH 20C,B01,083762,Bach; Quang Tran,1,0,30,29
1657820983269,MATH 20D,A01,083765,Tran; Brian Kha,5,0,30,25
1657820983269,MATH 20D,A02,083766,Tran; Brian Kha,5,0,30,25
1657820983269,MATH 20D,A03,083767,Tran; Brian Kha,5,0,30,25
1657820989297,MATH 20E,A01,083771,Ganguly; Soumya,10,0,32,22
1657820989297,MATH 20E,A02,083772,Ganguly; Soumya,6,0,32,26
1657820989297,MATH 20E,B01,083773,Ciotti; Benjamin,20,0,35,15
1657820989297,MATH 20E,B02,083774,Ciotti; Benjamin,18,0,35,17
1657820995320,MATH 103A,A01,083777,Greenfeld; Be'Eri,3,0,36,33
1657820995320,MATH 103A,A02,083778,Greenfeld; Be'Eri,5,0,36,31
1657820995320,MATH 103A,A03,093561,Greenfeld; Be'Eri,6,0,36,30
1657820995320,MATH 103A,B01,083779,Greenfeld; Be'Eri,7,0,36,29
1657820995320,MATH 103A,B02,083780,Greenfeld; Be'Eri,4,0,36,32
1657820995320,MATH 103A,B03,093562,Greenfeld; Be'Eri,3,0,36,33
1657821001356,MATH 105,A01,085443,Carter; Anne Toulson,15,0,35,20
1657821001356,MATH 105,A02,093477,Carter; Anne Toulson,20,0,35,15
1657821007382,MATH 109,A01,083213,Ganzberger; Geoffrey Michael,3,0,34,31
1657821007382,MATH 109,A02,083214,Ganzberger; Geoffrey Michael,4,0,34,30
1657821007382,MATH 109,A03,093478,Ganzberger; Geoffrey Michael,2,0,34,32
1657821007382,MATH 109,B01,083215,Ganzberger; Geoffrey Michael,1,0,32,31
1657821007382,MATH 109,B02,083216,Ganzberger; Geoffrey Michael,2,0,32,30
1657821007382,MATH 109,B03,093479,Ganzberger; Geoffrey Michael,8,0,32,24
1657821013407,MATH 142A,A01,083219,Chow; Bennett,7,0,32,25
1657821013407,MATH 142A,A02,083220,Chow; Bennett,10,0,32,22
1657821013407,MATH 142A,A03,093480,Chow; Bennett,9,0,32,23
1657821013407,MATH 142A,B03,093481,Chow; Bennett,8,0,32,24
1657821013407,MATH 142A,B04,093558,Chow; Bennett,13,0,32,19
1657821013407,MATH 142A,B05,093559,Chow; Bennett,7,0,32,25
1657821019444,MATH 193A,A01,083224,Rotar; Vladimir,8,0,34,26
1657821019444,MATH 193A,A02,083225,Rotar; Vladimir,9,0,34,25
1657821019444,MATH 193A,A03,083781,Rotar; Vladimir,5,0,34,29
1657821019444,MATH 193A,A04,083782,Rotar; Vladimir,11,0,34,23
1657821019444,MATH 193A,A05,093482,Rotar; Vladimir,10,0,34,24
1657821025468,MATH 197,001,091859,McAuley; Julian John,9999,0,9999,0
1657821025468,MATH 197,002,095566,Kedlaya; Kiran S.,9997,0,9999,2
1657821025468,MATH 197,003,095567,Xiao; Ming,9999,0,9999,0
1657821025468,MATH 197,004,095571,Perols; Johan Lars,9998,0,9999,1
1657821032527,COGS 9,A01,083615,Shannon; Kyle Michael,9,0,75,66
1657821038552,COGS 11,A01,083617,Boyle; Mary E. T.,23,0,48,25
1657821044581,COGS 13,A01,083071,Bastos; Amalia Pinkusfeld,11,0,71,60
1657821050608,COGS 14A,A01,092681,Semenuks; Arturs,5,1,100,95
1657821056637,COGS 14B,A01,083073,Cheng; Tzu-Han,6,0,63,57
1657821062659,COGS 17,A01,092677,Semenuks; Arturs,6,0,81,75
1657821068685,COGS 100,A01,083619,Allen; Michael Gordon,17,0,70,53
1657821074711,COGS 101A,A01,083621,Davis; Joshua Daniel,9,0,68,59
1657821080733,COGS 101B,A01,091572,Allen; Michael Gordon,12,0,65,53
1657821086832,COGS 101C,A01,083625,Delgado; Tania,17,0,35,18
1657821092854,COGS 107A,A01,083627,Boyle; Mary E. T.,14,0,60,46
1657821098881,COGS 118A,A01,083075,Gupta; Anjum,21,0,76,55
1657821104905,CSE 3,A50,083646,Miranda; Gregory Joseph,24,0,50,26
1657821110941,CSE 8A,A50,083650,Miranda; Gregory Joseph,17,1,56,39
1657821116963,CSE 11,A01,083080,Cao; Yingjun,6,15,40,34
1657821122985,CSE 12,A01,083652,Krause-Levy; Sophia Louisa,28,1,120,92
1657821129007,CSE 15L,A01,083654,Morris; Justin Loren,9,0,50,41
1657821129007,CSE 15L,A02,083655,Morris; Justin Loren,9,0,50,41
1657821135044,CSE 20,A01,083657,Tran; Khoa Dang,39,0,80,41
1657821141070,CSE 21,A01,095574,Bach; Quang Tran,22,0,48,26
1657821147098,CSE 30,A01,083084,Eldon; John,6,0,80,74
1657821147098,CSE 30,B01,095061,Bhaskar; Nishant,9,0,50,41
1657821153122,CSE 100,A01,083659,Cao; Yingjun,5,4,70,65
1657821159145,CSE 134B,A01,083661,Powell; Thomas Allan,24,0,100,76
1657821165171,CSE 140,A01,083663,Gungor; Onat,15,0,85,70
1657821171194,CSE 140L,A01,083088,Eldon; John,23,0,100,77
1657821177217,CSE 175,A01,083665,Kumar; Rakesh,3,0,25,22
1657821183240,CSE 190,A00,092507,Dubnov; Shlomo,8,0,20,12
1657821189262,ECE 45,A01,083139,Congero; Spencer William,6,0,75,69
1657821195302,ECE 65,A50,083695,Saad; Andrew S,12,0,30,18
1657821195302,ECE 65,A51,095125,Saad; Andrew S,24,0,26,2
1657821201323,ECE 109,A01,091882,Touri; Behrouz,20,0,70,50
1657821207351,ECE 180,A00,083140,Abi Samra; Nicholas Camill,1,0,30,29
1657821207351,ECE 180,B00,083141,Abi Samra; Nicholas Camill,0,0,30,30
1657821213380,MATH 10A,A01,083735,Patchell; Gregory David,2,0,30,28
1657821213380,MATH 10A,A02,083736,Patchell; Gregory David,20,0,30,10
1657821213380,MATH 10A,A03,083737,Patchell; Gregory David,16,0,30,14
1657821219404,MATH 10B,A01,083207,Lim; Seonhee,8,0,34,26
1657821219404,MATH 10B,A02,083208,Lim; Seonhee,10,0,35,25
1657821219404,MATH 10B,A03,093472,Lim; Seonhee,7,0,34,27
1657821219404,MATH 10B,B01,083739,Sinha; Shubham,13,0,30,17
1657821225435,MATH 18,A01,083743,Cinel; Cameron Alexander,9,0,30,21
1657821225435,MATH 18,A02,083744,Cinel; Cameron Alexander,18,0,30,12
1657821225435,MATH 18,A03,083745,Cinel; Cameron Alexander,10,0,30,20
1657821225435,MATH 18,B01,083748,Rideout; David Porter,5,0,37,32
1657821225435,MATH 18,B02,083749,Rideout; David Porter,5,0,36,31
1657821225435,MATH 18,B03,083750,Rideout; David Porter,3,0,37,34
1657821225435,MATH 18,B04,083751,Rideout; David Porter,6,0,36,30
1657821225435,MATH 18,B05,093473,Rideout; David Porter,6,0,36,30
1657821225435,MATH 18,B06,093474,Rideout; David Porter,6,0,36,30
1657821231457,MATH 20A,A01,083754,Zheng; Zequn,14,0,40,26
1657821237483,MATH 20B,A01,083756,Briones; Jor-el Thomas Caparas,4,0,36,32
1657821237483,MATH 20B,A02,083757,Briones; Jor-el Thomas Caparas,1,0,36,35
1657821237483,MATH 20B,A03,093475,Briones; Jor-el Thomas Caparas,2,0,36,34
1657821243505,MATH 20C,A01,083760,Briones; Jor-el Thomas Caparas,1,0,35,34
1657821243505,MATH 20C,A02,083761,Briones; Jor-el Thomas Caparas,8,0,35,27
1657821243505,MATH 20C,A03,093476,Briones; Jor-el Thomas Caparas,0,1,36,36
1657821243505,MATH 20C,B01,083762,Bach; Quang Tran,1,0,30,29
1657821249529,MATH 20D,A01,083765,Tran; Brian Kha,5,0,30,25
1657821249529,MATH 20D,A02,083766,Tran; Brian Kha,5,0,30,25
1657821249529,MATH 20D,A03,083767,Tran; Brian Kha,5,0,30,25
1657821255555,MATH 20E,A01,083771,Ganguly; Soumya,10,0,32,22
1657821255555,MATH 20E,A02,083772,Ganguly; Soumya,6,0,32,26
1657821255555,MATH 20E,B01,083773,Ciotti; Benjamin,20,0,35,15
1657821255555,MATH 20E,B02,083774,Ciotti; Benjamin,18,0,35,17
1657821261579,MATH 103A,A01,083777,Greenfeld; Be'Eri,3,0,36,33
1657821261579,MATH 103A,A02,083778,Greenfeld; Be'Eri,5,0,36,31
1657821261579,MATH 103A,A03,093561,Greenfeld; Be'Eri,6,0,36,30
1657821261579,MATH 103A,B01,083779,Greenfeld; Be'Eri,7,0,36,29
1657821261579,MATH 103A,B02,083780,Greenfeld; Be'Eri,4,0,36,32
1657821261579,MATH 103A,B03,093562,Greenfeld; Be'Eri,3,0,36,33
1657821267602,MATH 105,A01,085443,Carter; Anne Toulson,15,0,35,20
1657821267602,MATH 105,A02,093477,Carter; Anne Toulson,20,0,35,15
1657821273629,MATH 109,A01,083213,Ganzberger; Geoffrey Michael,3,0,34,31
1657821273629,MATH 109,A02,083214,Ganzberger; Geoffrey Michael,4,0,34,30
1657821273629,MATH 109,A03,093478,Ganzberger; Geoffrey Michael,2,0,34,32
1657821273629,MATH 109,B01,083215,Ganzberger; Geoffrey Michael,1,0,32,31
1657821273629,MATH 109,B02,083216,Ganzberger; Geoffrey Michael,2,0,32,30
1657821273629,MATH 109,B03,093479,Ganzberger; Geoffrey Michael,8,0,32,24
1657821279654,MATH 142A,A01,083219,Chow; Bennett,7,0,32,25
1657821279654,MATH 142A,A02,083220,Chow; Bennett,10,0,32,22
1657821279654,MATH 142A,A03,093480,Chow; Bennett,9,0,32,23
1657821279654,MATH 142A,B03,093481,Chow; Bennett,8,0,32,24
1657821279654,MATH 142A,B04,093558,Chow; Bennett,13,0,32,19
1657821279654,MATH 142A,B05,093559,Chow; Bennett,7,0,32,25
1657821285682,MATH 193A,A01,083224,Rotar; Vladimir,8,0,34,26
1657821285682,MATH 193A,A02,083225,Rotar; Vladimir,9,0,34,25
1657821285682,MATH 193A,A03,083781,Rotar; Vladimir,5,0,34,29
1657821285682,MATH 193A,A04,083782,Rotar; Vladimir,11,0,34,23
1657821285682,MATH 193A,A05,093482,Rotar; Vladimir,10,0,34,24
1657821291708,MATH 197,001,091859,McAuley; Julian John,9999,0,9999,0
1657821291708,MATH 197,002,095566,Kedlaya; Kiran S.,9997,0,9999,2
1657821291708,MATH 197,003,095567,Xiao; Ming,9999,0,9999,0
1657821291708,MATH 197,004,095571,Perols; Johan Lars,9998,0,9999,1
1657821298766,COGS 9,A01,083615,Shannon; Kyle Michael,9,0,75,66
1657821304793,COGS 11,A01,083617,Boyle; Mary E. T.,23,0,48,25
1657821310819,COGS 13,A01,083071,Bastos; Amalia Pinkusfeld,11,0,71,60
1657821316841,COGS 14A,A01,092681,Semenuks; Arturs,5,1,100,95
1657821322864,COGS 14B,A01,083073,Cheng; Tzu-Han,6,0,63,57
1657821328892,COGS 17,A01,092677,Semenuks; Arturs,6,0,81,75
1657821334916,COGS 100,A01,083619,Allen; Michael Gordon,17,0,70,53
1657821340942,COGS 101A,A01,083621,Davis; Joshua Daniel,9,0,68,59
1657821346964,COGS 101B,A01,091572,Allen; Michael Gordon,12,0,65,53
1657821352988,COGS 101C,A01,083625,Delgado; Tania,17,0,35,18
1657821359015,COGS 107A,A01,083627,Boyle; Mary E. T.,14,0,60,46
1657821365038,COGS 118A,A01,083075,Gupta; Anjum,21,0,76,55
1657821371072,CSE 3,A50,083646,Miranda; Gregory Joseph,24,0,50,26
1657821377094,CSE 8A,A50,083650,Miranda; Gregory Joseph,17,1,56,39
1657821383117,CSE 11,A01,083080,Cao; Yingjun,6,15,40,34
1657821389140,CSE 12,A01,083652,Krause-Levy; Sophia Louisa,28,1,120,92
1657821395178,CSE 15L,A01,083654,Morris; Justin Loren,9,0,50,41
1657821395178,CSE 15L,A02,083655,Morris; Justin Loren,9,0,50,41
1657821401213,CSE 20,A01,083657,Tran; Khoa Dang,39,0,80,41
1657821407241,CSE 21,A01,095574,Bach; Quang Tran,22,0,48,26
1657821413275,CSE 30,A01,083084,Eldon; John,6,0,80,74
1657821413275,CSE 30,B01,095061,Bhaskar; Nishant,9,0,50,41
1657821419302,CSE 100,A01,083659,Cao; Yingjun,5,4,70,65
1657821425334,CSE 134B,A01,083661,Powell; Thomas Allan,24,0,100,76
1657821431360,CSE 140,A01,083663,Gungor; Onat,15,0,85,70
1657821437392,CSE 140L,A01,083088,Eldon; John,23,0,100,77
1657821443415,CSE 175,A01,083665,Kumar; Rakesh,3,0,25,22
1657821449437,CSE 190,A00,092507,Dubnov; Shlomo,8,0,20,12
1657821455476,ECE 45,A01,083139,Congero; Spencer William,6,0,75,69
1657821461500,ECE 65,A50,083695,Saad; Andrew S,12,0,30,18
1657821461500,ECE 65,A51,095125,Saad; Andrew S,24,0,26,2
1657821467535,ECE 109,A01,091882,Touri; Behrouz,20,0,70,50
1657821473566,ECE 180,A00,083140,Abi Samra; Nicholas Camill,1,0,30,29
1657821473566,ECE 180,B00,083141,Abi Samra; Nicholas Camill,0,0,30,30
1657821479596,MATH 10A,A01,083735,Patchell; Gregory David,2,0,30,28
1657821479596,MATH 10A,A02,083736,Patchell; Gregory David,20,0,30,10
1657821479596,MATH 10A,A03,083737,Patchell; Gregory David,16,0,30,14
1657821485620,MATH 10B,A01,083207,Lim; Seonhee,8,0,34,26
1657821485620,MATH 10B,A02,083208,Lim; Seonhee,10,0,35,25
1657821485620,MATH 10B,A03,093472,Lim; Seonhee,7,0,34,27
1657821485620,MATH 10B,B01,083739,Sinha; Shubham,13,0,30,17
1657821491651,MATH 18,A01,083743,Cinel; Cameron Alexander,9,0,30,21
1657821491651,MATH 18,A02,083744,Cinel; Cameron Alexander,18,0,30,12
1657821491651,MATH 18,A03,083745,Cinel; Cameron Alexander,10,0,30,20
1657821491651,MATH 18,B01,083748,Rideout; David Porter,5,0,37,32
1657821491651,MATH 18,B02,083749,Rideout; David Porter,5,0,36,31
1657821491651,MATH 18,B03,083750,Rideout; David Porter,3,0,37,34
1657821491651,MATH 18,B04,083751,Rideout; David Porter,6,0,36,30
1657821491651,MATH 18,B05,093473,Rideout; David Porter,6,0,36,30
1657821491651,MATH 18,B06,093474,Rideout; David Porter,6,0,36,30
1657821497680,MATH 20A,A01,083754,Zheng; Zequn,14,0,40,26
1657821503712,MATH 20B,A01,083756,Briones; Jor-el Thomas Caparas,4,0,36,32
1657821503712,MATH 20B,A02,083757,Briones; Jor-el Thomas Caparas,1,0,36,35
1657821503712,MATH 20B,A03,093475,Briones; Jor-el Thomas Caparas,2,0,36,34
1657821509741,MATH 20C,A01,083760,Briones; Jor-el Thomas Caparas,1,0,35,34
1657821509741,MATH 20C,A02,083761,Briones; Jor-el Thomas Caparas,8,0,35,27
1657821509741,MATH 20C,A03,093476,Briones; Jor-el Thomas Caparas,0,1,36,36
1657821509741,MATH 20C,B01,083762,Bach; Quang Tran,1,0,30,29
1657821515775,MATH 20D,A01,083765,Tran; Brian Kha,5,0,30,25
1657821515775,MATH 20D,A02,083766,Tran; Brian Kha,5,0,30,25
1657821515775,MATH 20D,A03,083767,Tran; Brian Kha,5,0,30,25
1657821521801,MATH 20E,A01,083771,Ganguly; Soumya,10,0,32,22
1657821521801,MATH 20E,A02,083772,Ganguly; Soumya,6,0,32,26
1657821521801,MATH 20E,B01,083773,Ciotti; Benjamin,20,0,35,15
1657821521801,MATH 20E,B02,083774,Ciotti; Benjamin,18,0,35,17
1657821527835,MATH 103A,A01,083777,Greenfeld; Be'Eri,3,0,36,33
1657821527835,MATH 103A,A02,083778,Greenfeld; Be'Eri,5,0,36,31
1657821527835,MATH 103A,A03,093561,Greenfeld; Be'Eri,6,0,36,30
1657821527835,MATH 103A,B01,083779,Greenfeld; Be'Eri,7,0,36,29
1657821527835,MATH 103A,B02,083780,Greenfeld; Be'Eri,4,0,36,32
1657821527835,MATH 103A,B03,093562,Greenfeld; Be'Eri,3,0,36,33
1657821533858,MATH 105,A01,085443,Carter; Anne Toulson,15,0,35,20
1657821533858,MATH 105,A02,093477,Carter; Anne Toulson,20,0,35,15
1657821539885,MATH 109,A01,083213,Ganzberger; Geoffrey Michael,3,0,34,31
1657821539885,MATH 109,A02,083214,Ganzberger; Geoffrey Michael,4,0,34,30
1657821539885,MATH 109,A03,093478,Ganzberger; Geoffrey Michael,2,0,34,32
1657821539885,MATH 109,B01,083215,Ganzberger; Geoffrey Michael,1,0,32,31
1657821539885,MATH 109,B02,083216,Ganzberger; Geoffrey Michael,2,0,32,30
1657821539885,MATH 109,B03,093479,Ganzberger; Geoffrey Michael,8,0,32,24
1657821545908,MATH 142A,A01,083219,Chow; Bennett,7,0,32,25
1657821545908,MATH 142A,A02,083220,Chow; Bennett,10,0,32,22
1657821545908,MATH 142A,A03,093480,Chow; Bennett,9,0,32,23
1657821545908,MATH 142A,B03,093481,Chow; Bennett,8,0,32,24
1657821545908,MATH 142A,B04,093558,Chow; Bennett,13,0,32,19
1657821545908,MATH 142A,B05,093559,Chow; Bennett,7,0,32,25
1657821551932,MATH 193A,A01,083224,Rotar; Vladimir,8,0,34,26
1657821551932,MATH 193A,A02,083225,Rotar; Vladimir,9,0,34,25
1657821551932,MATH 193A,A03,083781,Rotar; Vladimir,5,0,34,29
1657821551932,MATH 193A,A04,083782,Rotar; Vladimir,11,0,34,23
1657821551932,MATH 193A,A05,093482,Rotar; Vladimir,10,0,34,24
1657821557963,MATH 197,001,091859,McAuley; Julian John,9999,0,9999,0
1657821557963,MATH 197,002,095566,Kedlaya; Kiran S.,9997,0,9999,2
1657821557963,MATH 197,003,095567,Xiao; Ming,9999,0,9999,0
1657821557963,MATH 197,004,095571,Perols; Johan Lars,9998,0,9999,1
1657821565028,COGS 9,A01,083615,Shannon; Kyle Michael,9,0,75,66
1657821571052,COGS 11,A01,083617,Boyle; Mary E. T.,23,0,48,25
1657821577080,COGS 13,A01,083071,Bastos; Amalia Pinkusfeld,11,0,71,60
1657821583103,COGS 14A,A01,092681,Semenuks; Arturs,5,1,100,95
1657821589126,COGS 14B,A01,083073,Cheng; Tzu-Han,6,0,63,57
1657821595150,COGS 17,A01,092677,Semenuks; Arturs,6,0,81,75
1657821601172,COGS 100,A01,083619,Allen; Michael Gordon,17,0,70,53
1657821607194,COGS 101A,A01,083621,Davis; Joshua Daniel,9,0,68,59
1657821613220,COGS 101B,A01,091572,Allen; Michael Gordon,12,0,65,53
1657821619245,COGS 101C,A01,083625,Delgado; Tania,17,0,35,18
1657821625275,COGS 107A,A01,083627,Boyle; Mary E. T.,14,0,60,46
1657821631301,COGS 118A,A01,083075,Gupta; Anjum,21,0,76,55
1657821637327,CSE 3,A50,083646,Miranda; Gregory Joseph,24,0,50,26
1657821643353,CSE 8A,A50,083650,Miranda; Gregory Joseph,17,1,56,39
1657821649380,CSE 11,A01,083080,Cao; Yingjun,6,15,40,34
1657821655404,CSE 12,A01,083652,Krause-Levy; Sophia Louisa,28,1,120,92
1657821661425,CSE 15L,A01,083654,Morris; Justin Loren,9,0,50,41
1657821661425,CSE 15L,A02,083655,Morris; Justin Loren,9,0,50,41
1657821667447,CSE 20,A01,083657,Tran; Khoa Dang,39,0,80,41
1657821673474,CSE 21,A01,095574,Bach; Quang Tran,22,0,48,26
1657821679497,CSE 30,A01,083084,Eldon; John,6,0,80,74
1657821679497,CSE 30,B01,095061,Bhaskar; Nishant,9,0,50,41
1657821685596,CSE 100,A01,083659,Cao; Yingjun,5,4,70,65
1657821691628,CSE 134B,A01,083661,Powell; Thomas Allan,24,0,100,76
1657821697651,CSE 140,A01,083663,Gungor; Onat,15,0,85,70
1657821703686,CSE 140L,A01,083088,Eldon; John,23,0,100,77
1657821709715,CSE 175,A01,083665,Kumar; Rakesh,3,0,25,22
1657821715737,CSE 190,A00,092507,Dubnov; Shlomo,8,0,20,12
1657821721760,ECE 45,A01,083139,Congero; Spencer William,6,0,75,69
1657821727785,ECE 65,A50,083695,Saad; Andrew S,12,0,30,18
1657821727785,ECE 65,A51,095125,Saad; Andrew S,24,0,26,2
1657821733807,ECE 109,A01,091882,Touri; Behrouz,20,0,70,50
1657821739830,ECE 180,A00,083140,Abi Samra; Nicholas Camill,1,0,30,29
1657821739830,ECE 180,B00,083141,Abi Samra; Nicholas Camill,0,0,30,30
1657821745852,MATH 10A,A01,083735,Patchell; Gregory David,2,0,30,28
1657821745852,MATH 10A,A02,083736,Patchell; Gregory David,20,0,30,10
1657821745852,MATH 10A,A03,083737,Patchell; Gregory David,16,0,30,14
1657821751881,MATH 10B,A01,083207,Lim; Seonhee,8,0,34,26
1657821751881,MATH 10B,A02,083208,Lim; Seonhee,10,0,35,25
1657821751881,MATH 10B,A03,093472,Lim; Seonhee,7,0,34,27
1657821751881,MATH 10B,B01,083739,Sinha; Shubham,13,0,30,17
1657821757915,MATH 18,A01,083743,Cinel; Cameron Alexander,9,0,30,21
1657821757915,MATH 18,A02,083744,Cinel; Cameron Alexander,18,0,30,12
1657821757915,MATH 18,A03,083745,Cinel; Cameron Alexander,10,0,30,20
1657821757915,MATH 18,B01,083748,Rideout; David Porter,5,0,37,32
1657821757915,MATH 18,B02,083749,Rideout; David Porter,5,0,36,31
1657821757915,MATH 18,B03,083750,Rideout; David Porter,3,0,37,34
1657821757915,MATH 18,B04,083751,Rideout; David Porter,6,0,36,30
1657821757915,MATH 18,B05,093473,Rideout; David Porter,6,0,36,30
1657821757915,MATH 18,B06,093474,Rideout; David Porter,6,0,36,30
1657821763938,MATH 20A,A01,083754,Zheng; Zequn,14,0,40,26
1657821769964,MATH 20B,A01,083756,Briones; Jor-el Thomas Caparas,4,0,36,32
1657821769964,MATH 20B,A02,083757,Briones; Jor-el Thomas Caparas,1,0,36,35
1657821769964,MATH 20B,A03,093475,Briones; Jor-el Thomas Caparas,2,0,36,34
1657821775986,MATH 20C,A01,083760,Briones; Jor-el Thomas Caparas,1,0,35,34
1657821775986,MATH 20C,A02,083761,Briones; Jor-el Thomas Caparas,8,0,35,27
1657821775986,MATH 20C,A03,093476,Briones; Jor-el Thomas Caparas,0,1,36,36
1657821775986,MATH 20C,B01,083762,Bach; Quang Tran,1,0,30,29
1657821782014,MATH 20D,A01,083765,Tran; Brian Kha,5,0,30,25
1657821782014,MATH 20D,A02,083766,Tran; Brian Kha,5,0,30,25
1657821782014,MATH 20D,A03,083767,Tran; Brian Kha,5,0,30,25
1657821788037,MATH 20E,A01,083771,Ganguly; Soumya,10,0,32,22
1657821788037,MATH 20E,A02,083772,Ganguly; Soumya,6,0,32,26
1657821788037,MATH 20E,B01,083773,Ciotti; Benjamin,20,0,35,15
1657821788037,MATH 20E,B02,083774,Ciotti; Benjamin,18,0,35,17
1657821794060,MATH 103A,A01,083777,Greenfeld; Be'Eri,3,0,36,33
1657821794060,MATH 103A,A02,083778,Greenfeld; Be'Eri,5,0,36,31
1657821794060,MATH 103A,A03,093561,Greenfeld; Be'Eri,6,0,36,30
1657821794060,MATH 103A,B01,083779,Greenfeld; Be'Eri,7,0,36,29
1657821794060,MATH 103A,B02,083780,Greenfeld; Be'Eri,4,0,36,32
1657821794060,MATH 103A,B03,093562,Greenfeld; Be'Eri,3,0,36,33
1657821800083,MATH 105,A01,085443,Carter; Anne Toulson,15,0,35,20
1657821800083,MATH 105,A02,093477,Carter; Anne Toulson,20,0,35,15
1657821806112,MATH 109,A01,083213,Ganzberger; Geoffrey Michael,3,0,34,31
1657821806112,MATH 109,A02,083214,Ganzberger; Geoffrey Michael,4,0,34,30
1657821806112,MATH 109,A03,093478,Ganzberger; Geoffrey Michael,2,0,34,32
1657821806112,MATH 109,B01,083215,Ganzberger; Geoffrey Michael,1,0,32,31
1657821806112,MATH 109,B02,083216,Ganzberger; Geoffrey Michael,2,0,32,30
1657821806112,MATH 109,B03,093479,Ganzberger; Geoffrey Michael,8,0,32,24
1657821812136,MATH 142A,A01,083219,Chow; Bennett,7,0,32,25
1657821812136,MATH 142A,A02,083220,Chow; Bennett,10,0,32,22
1657821812136,MATH 142A,A03,093480,Chow; Bennett,9,0,32,23
1657821812136,MATH 142A,B03,093481,Chow; Bennett,8,0,32,24
1657821812136,MATH 142A,B04,093558,Chow; Bennett,13,0,32,19
1657821812136,MATH 142A,B05,093559,Chow; Bennett,7,0,32,25
1657821818172,MATH 193A,A01,083224,Rotar; Vladimir,8,0,34,26
1657821818172,MATH 193A,A02,083225,Rotar; Vladimir,9,0,34,25
1657821818172,MATH 193A,A03,083781,Rotar; Vladimir,5,0,34,29
1657821818172,MATH 193A,A04,083782,Rotar; Vladimir,11,0,34,23
1657821818172,MATH 193A,A05,093482,Rotar; Vladimir,10,0,34,24
1657821824199,MATH 197,001,091859,McAuley; Julian John,9999,0,9999,0
1657821824199,MATH 197,002,095566,Kedlaya; Kiran S.,9997,0,9999,2
1657821824199,MATH 197,003,095567,Xiao; Ming,9999,0,9999,0
1657821824199,MATH 197,004,095571,Perols; Johan Lars,9998,0,9999,1
1657821831267,COGS 9,A01,083615,Shannon; Kyle Michael,9,0,75,66
1657821837296,COGS 11,A01,083617,Boyle; Mary E. T.,23,0,48,25
1657821843320,COGS 13,A01,083071,Bastos; Amalia Pinkusfeld,11,0,71,60
1657821849347,COGS 14A,A01,092681,Semenuks; Arturs,5,1,100,95
1657821855370,COGS 14B,A01,083073,Cheng; Tzu-Han,6,0,63,57
1657821861392,COGS 17,A01,092677,Semenuks; Arturs,6,0,81,75
1657821867418,COGS 100,A01,083619,Allen; Michael Gordon,17,0,70,53
1657821873451,COGS 101A,A01,083621,Davis; Joshua Daniel,9,0,68,59
1657821879486,COGS 101B,A01,091572,Allen; Michael Gordon,12,0,65,53
1657821885520,COGS 101C,A01,083625,Delgado; Tania,17,0,35,18
1657821891546,COGS 107A,A01,083627,Boyle; Mary E. T.,14,0,60,46
1657821897571,COGS 118A,A01,083075,Gupta; Anjum,21,0,76,55
1657821903594,CSE 3,A50,083646,Miranda; Gregory Joseph,24,0,50,26
1657821909625,CSE 8A,A50,083650,Miranda; Gregory Joseph,17,1,56,39
1657821915653,CSE 11,A01,083080,Cao; Yingjun,6,15,40,34
1657821921679,CSE 12,A01,083652,Krause-Levy; Sophia Louisa,28,1,120,92
1657821927703,CSE 15L,A01,083654,Morris; Justin Loren,9,0,50,41
1657821927703,CSE 15L,A02,083655,Morris; Justin Loren,9,0,50,41
1657821933728,CSE 20,A01,083657,Tran; Khoa Dang,39,0,80,41
1657821939751,CSE 21,A01,095574,Bach; Quang Tran,22,0,48,26
1657821945783,CSE 30,A01,083084,Eldon; John,6,0,80,74
1657821945783,CSE 30,B01,095061,Bhaskar; Nishant,9,0,50,41
1657821951809,CSE 100,A01,083659,Cao; Yingjun,5,4,70,65
1657821957840,CSE 134B,A01,083661,Powell; Thomas Allan,24,0,100,76
1657821963867,CSE 140,A01,083663,Gungor; Onat,15,0,85,70
1657821969892,CSE 140L,A01,083088,Eldon; John,23,0,100,77
1657821975915,CSE 175,A01,083665,Kumar; Rakesh,3,0,25,22
1657821981941,CSE 190,A00,092507,Dubnov; Shlomo,8,0,20,12
1657821987963,ECE 45,A01,083139,Congero; Spencer William,6,0,75,69
1657821993986,ECE 65,A50,083695,Saad; Andrew S,12,0,30,18
1657821993986,ECE 65,A51,095125,Saad; Andrew S,24,0,26,2
1657822000013,ECE 109,A01,091882,Touri; Behrouz,20,0,70,50
1657822006045,ECE 180,A00,083140,Abi Samra; Nicholas Camill,1,0,30,29
1657822006045,ECE 180,B00,083141,Abi Samra; Nicholas Camill,0,0,30,30
1657822012073,MATH 10A,A01,083735,Patchell; Gregory David,2,0,30,28
1657822012073,MATH 10A,A02,083736,Patchell; Gregory David,20,0,30,10
1657822012073,MATH 10A,A03,083737,Patchell; Gregory David,16,0,30,14
1657822018096,MATH 10B,A01,083207,Lim; Seonhee,8,0,34,26
1657822018096,MATH 10B,A02,083208,Lim; Seonhee,10,0,35,25
1657822018096,MATH 10B,A03,093472,Lim; Seonhee,7,0,34,27
1657822018096,MATH 10B,B01,083739,Sinha; Shubham,13,0,30,17
1657822024122,MATH 18,A01,083743,Cinel; Cameron Alexander,9,0,30,21
1657822024122,MATH 18,A02,083744,Cinel; Cameron Alexander,18,0,30,12
1657822024122,MATH 18,A03,083745,Cinel; Cameron Alexander,10,0,30,20
1657822024122,MATH 18,B01,083748,Rideout; David Porter,5,0,37,32
1657822024122,MATH 18,B02,083749,Rideout; David Porter,5,0,36,31
1657822024122,MATH 18,B03,083750,Rideout; David Porter,3,0,37,34
1657822024122,MATH 18,B04,083751,Rideout; David Porter,6,0,36,30
1657822024122,MATH 18,B05,093473,Rideout; David Porter,6,0,36,30
1657822024122,MATH 18,B06,093474,Rideout; David Porter,6,0,36,30
1657822030145,MATH 20A,A01,083754,Zheng; Zequn,14,0,40,26
1657822036177,MATH 20B,A01,083756,Briones; Jor-el Thomas Caparas,4,0,36,32
1657822036177,MATH 20B,A02,083757,Briones; Jor-el Thomas Caparas,1,0,36,35
1657822036177,MATH 20B,A03,093475,Briones; Jor-el Thomas Caparas,2,0,36,34
1657822042201,MATH 20C,A01,083760,Briones; Jor-el Thomas Caparas,1,0,35,34
1657822042201,MATH 20C,A02,083761,Briones; Jor-el Thomas Caparas,8,0,35,27
1657822042201,MATH 20C,A03,093476,Briones; Jor-el Thomas Caparas,0,1,36,36
1657822042201,MATH 20C,B01,083762,Bach; Quang Tran,1,0,30,29
1657822048233,MATH 20D,A01,083765,Tran; Brian Kha,5,0,30,25
1657822048233,MATH 20D,A02,083766,Tran; Brian Kha,5,0,30,25
1657822048233,MATH 20D,A03,083767,Tran; Brian Kha,5,0,30,25
1657822054261,MATH 20E,A01,083771,Ganguly; Soumya,10,0,32,22
1657822054261,MATH 20E,A02,083772,Ganguly; Soumya,6,0,32,26
1657822054261,MATH 20E,B01,083773,Ciotti; Benjamin,20,0,35,15
1657822054261,MATH 20E,B02,083774,Ciotti; Benjamin,18,0,35,17
1657822060286,MATH 103A,A01,083777,Greenfeld; Be'Eri,3,0,36,33
1657822060286,MATH 103A,A02,083778,Greenfeld; Be'Eri,5,0,36,31
1657822060286,MATH 103A,A03,093561,Greenfeld; Be'Eri,6,0,36,30
1657822060286,MATH 103A,B01,083779,Greenfeld; Be'Eri,7,0,36,29
1657822060286,MATH 103A,B02,083780,Greenfeld; Be'Eri,4,0,36,32
1657822060286,MATH 103A,B03,093562,Greenfeld; Be'Eri,3,0,36,33
1657822066310,MATH 105,A01,085443,Carter; Anne Toulson,15,0,35,20
1657822066310,MATH 105,A02,093477,Carter; Anne Toulson,20,0,35,15
1657822072334,MATH 109,A01,083213,Ganzberger; Geoffrey Michael,3,0,34,31
1657822072334,MATH 109,A02,083214,Ganzberger; Geoffrey Michael,4,0,34,30
1657822072334,MATH 109,A03,093478,Ganzberger; Geoffrey Michael,2,0,34,32
1657822072334,MATH 109,B01,083215,Ganzberger; Geoffrey Michael,1,0,32,31
1657822072334,MATH 109,B02,083216,Ganzberger; Geoffrey Michael,2,0,32,30
1657822072334,MATH 109,B03,093479,Ganzberger; Geoffrey Michael,8,0,32,24
1657822078358,MATH 142A,A01,083219,Chow; Bennett,7,0,32,25
1657822078358,MATH 142A,A02,083220,Chow; Bennett,10,0,32,22
1657822078358,MATH 142A,A03,093480,Chow; Bennett,9,0,32,23
1657822078358,MATH 142A,B03,093481,Chow; Bennett,8,0,32,24
1657822078358,MATH 142A,B04,093558,Chow; Bennett,13,0,32,19
1657822078358,MATH 142A,B05,093559,Chow; Bennett,7,0,32,25
1657822084381,MATH 193A,A01,083224,Rotar; Vladimir,8,0,34,26
1657822084381,MATH 193A,A02,083225,Rotar; Vladimir,9,0,34,25
1657822084381,MATH 193A,A03,083781,Rotar; Vladimir,5,0,34,29
1657822084381,MATH 193A,A04,083782,Rotar; Vladimir,11,0,34,23
1657822084381,MATH 193A,A05,093482,Rotar; Vladimir,10,0,34,24
1657822090415,MATH 197,001,091859,McAuley; Julian John,9999,0,9999,0
1657822090415,MATH 197,002,095566,Kedlaya; Kiran S.,9997,0,9999,2
1657822090415,MATH 197,003,095567,Xiao; Ming,9999,0,9999,0
1657822090415,MATH 197,004,095571,Perols; Johan Lars,9998,0,9999,1
1657822097474,COGS 9,A01,083615,Shannon; Kyle Michael,9,0,75,66
1657822103495,COGS 11,A01,083617,Boyle; Mary E. T.,23,0,48,25
1657822109518,COGS 13,A01,083071,Bastos; Amalia Pinkusfeld,11,0,71,60
1657822115544,COGS 14A,A01,092681,Semenuks; Arturs,5,1,100,95
1657822121578,COGS 14B,A01,083073,Cheng; Tzu-Han,6,0,63,57
1657822127601,COGS 17,A01,092677,Semenuks; Arturs,6,0,81,75
1657822133637,COGS 100,A01,083619,Allen; Michael Gordon,17,0,70,53
1657822139660,COGS 101A,A01,083621,Davis; Joshua Daniel,9,0,68,59
1657822145682,COGS 101B,A01,091572,Allen; Michael Gordon,12,0,65,53
1657822151712,COGS 101C,A01,083625,Delgado; Tania,17,0,35,18
1657822157737,COGS 107A,A01,083627,Boyle; Mary E. T.,14,0,60,46
1657822163763,COGS 118A,A01,083075,Gupta; Anjum,21,0,76,55
1657822169797,CSE 3,A50,083646,Miranda; Gregory Joseph,24,0,50,26
1657822175825,CSE 8A,A50,083650,Miranda; Gregory Joseph,17,1,56,39
1657822181868,CSE 11,A01,083080,Cao; Yingjun,6,15,40,34
1657822187901,CSE 12,A01,083652,Krause-Levy; Sophia Louisa,28,1,120,92
1657822193925,CSE 15L,A01,083654,Morris; Justin Loren,9,0,50,41
1657822193925,CSE 15L,A02,083655,Morris; Justin Loren,9,0,50,41
1657822199948,CSE 20,A01,083657,Tran; Khoa Dang,39,0,80,41
1657822205974,CSE 21,A01,095574,Bach; Quang Tran,22,0,48,26
1657822212001,CSE 30,A01,083084,Eldon; John,6,0,80,74
1657822212001,CSE 30,B01,095061,Bhaskar; Nishant,9,0,50,41
1657822218028,CSE 100,A01,083659,Cao; Yingjun,5,4,70,65
1657822224055,CSE 134B,A01,083661,Powell; Thomas Allan,24,0,100,76
1657822230081,CSE 140,A01,083663,Gungor; Onat,15,0,85,70
1657822236108,CSE 140L,A01,083088,Eldon; John,23,0,100,77
1657822242130,CSE 175,A01,083665,Kumar; Rakesh,3,0,25,22
1657822248153,CSE 190,A00,092507,Dubnov; Shlomo,8,0,20,12
1657822254176,ECE 45,A01,083139,Congero; Spencer William,6,0,75,69
1657822260200,ECE 65,A50,083695,Saad; Andrew S,12,0,30,18
1657822260200,ECE 65,A51,095125,Saad; Andrew S,24,0,26,2
1657822266236,ECE 109,A01,091882,Touri; Behrouz,20,0,70,50
1657822272262,ECE 180,A00,083140,Abi Samra; Nicholas Camill,1,0,30,29
1657822272262,ECE 180,B00,083141,Abi Samra; Nicholas Camill,0,0,30,30
1657822278292,MATH 10A,A01,083735,Patchell; Gregory David,2,0,30,28
1657822278292,MATH 10A,A02,083736,Patchell; Gregory David,20,0,30,10
1657822278292,MATH 10A,A03,083737,Patchell; Gregory David,16,0,30,14
1657822284389,MATH 10B,A01,083207,Lim; Seonhee,8,0,34,26
1657822284389,MATH 10B,A02,083208,Lim; Seonhee,10,0,35,25
1657822284389,MATH 10B,A03,093472,Lim; Seonhee,7,0,34,27
1657822284389,MATH 10B,B01,083739,Sinha; Shubham,13,0,30,17
1657822290417,MATH 18,A01,083743,Cinel; Cameron Alexander,9,0,30,21
1657822290417,MATH 18,A02,083744,Cinel; Cameron Alexander,18,0,30,12
1657822290417,MATH 18,A03,083745,Cinel; Cameron Alexander,10,0,30,20
1657822290417,MATH 18,B01,083748,Rideout; David Porter,5,0,37,32
1657822290417,MATH 18,B02,083749,Rideout; David Porter,5,0,36,31
1657822290417,MATH 18,B03,083750,Rideout; David Porter,3,0,37,34
1657822290417,MATH 18,B04,083751,Rideout; David Porter,6,0,36,30
1657822290417,MATH 18,B05,093473,Rideout; David Porter,6,0,36,30
1657822290417,MATH 18,B06,093474,Rideout; David Porter,6,0,36,30
1657822296441,MATH 20A,A01,083754,Zheng; Zequn,14,0,40,26
1657822302469,MATH 20B,A01,083756,Briones; Jor-el Thomas Caparas,4,0,36,32
1657822302469,MATH 20B,A02,083757,Briones; Jor-el Thomas Caparas,1,0,36,35
1657822302469,MATH 20B,A03,093475,Briones; Jor-el Thomas Caparas,2,0,36,34
1657822308493,MATH 20C,A01,083760,Briones; Jor-el Thomas Caparas,1,0,35,34
1657822308493,MATH 20C,A02,083761,Briones; Jor-el Thomas Caparas,8,0,35,27
1657822308493,MATH 20C,A03,093476,Briones; Jor-el Thomas Caparas,0,1,36,36
1657822308493,MATH 20C,B01,083762,Bach; Quang Tran,1,0,30,29
1657822314525,MATH 20D,A01,083765,Tran; Brian Kha,5,0,30,25
1657822314525,MATH 20D,A02,083766,Tran; Brian Kha,5,0,30,25
1657822314525,MATH 20D,A03,083767,Tran; Brian Kha,5,0,30,25
1657822320549,MATH 20E,A01,083771,Ganguly; Soumya,10,0,32,22
1657822320549,MATH 20E,A02,083772,Ganguly; Soumya,6,0,32,26
1657822320549,MATH 20E,B01,083773,Ciotti; Benjamin,20,0,35,15
1657822320549,MATH 20E,B02,083774,Ciotti; Benjamin,18,0,35,17
1657822326579,MATH 103A,A01,083777,Greenfeld; Be'Eri,3,0,36,33
1657822326579,MATH 103A,A02,083778,Greenfeld; Be'Eri,5,0,36,31
1657822326579,MATH 103A,A03,093561,Greenfeld; Be'Eri,6,0,36,30
1657822326579,MATH 103A,B01,083779,Greenfeld; Be'Eri,7,0,36,29
1657822326579,MATH 103A,B02,083780,Greenfeld; Be'Eri,4,0,36,32
1657822326579,MATH 103A,B03,093562,Greenfeld; Be'Eri,3,0,36,33
1657822332601,MATH 105,A01,085443,Carter; Anne Toulson,15,0,35,20
1657822332601,MATH 105,A02,093477,Carter; Anne Toulson,20,0,35,15
1657822338633,MATH 109,A01,083213,Ganzberger; Geoffrey Michael,3,0,34,31
1657822338633,MATH 109,A02,083214,Ganzberger; Geoffrey Michael,4,0,34,30
1657822338633,MATH 109,A03,093478,Ganzberger; Geoffrey Michael,2,0,34,32
1657822338633,MATH 109,B01,083215,Ganzberger; Geoffrey Michael,1,0,32,31
1657822338633,MATH 109,B02,083216,Ganzberger; Geoffrey Michael,2,0,32,30
1657822338633,MATH 109,B03,093479,Ganzberger; Geoffrey Michael,8,0,32,24
1657822344673,MATH 142A,A01,083219,Chow; Bennett,7,0,32,25
1657822344673,MATH 142A,A02,083220,Chow; Bennett,10,0,32,22
1657822344673,MATH 142A,A03,093480,Chow; Bennett,9,0,32,23
1657822344673,MATH 142A,B03,093481,Chow; Bennett,8,0,32,24
1657822344673,MATH 142A,B04,093558,Chow; Bennett,13,0,32,19
1657822344673,MATH 142A,B05,093559,Chow; Bennett,7,0,32,25
1657822350701,MATH 193A,A01,083224,Rotar; Vladimir,8,0,34,26
1657822350701,MATH 193A,A02,083225,Rotar; Vladimir,9,0,34,25
1657822350701,MATH 193A,A03,083781,Rotar; Vladimir,5,0,34,29
1657822350701,MATH 193A,A04,083782,Rotar; Vladimir,11,0,34,23
1657822350701,MATH 193A,A05,093482,Rotar; Vladimir,10,0,34,24
1657822356738,MATH 197,001,091859,McAuley; Julian John,9999,0,9999,0
1657822356738,MATH 197,002,095566,Kedlaya; Kiran S.,9997,0,9999,2
1657822356738,MATH 197,003,095567,Xiao; Ming,9999,0,9999,0
1657822356738,MATH 197,004,095571,Perols; Johan Lars,9998,0,9999,1
1657822363802,COGS 9,A01,083615,Shannon; Kyle Michael,9,0,75,66
1657822369860,COGS 11,A01,083617,Boyle; Mary E. T.,23,0,48,25
1657822375888,COGS 13,A01,083071,Bastos; Amalia Pinkusfeld,11,0,71,60
1657822381911,COGS 14A,A01,092681,Semenuks; Arturs,5,1,100,95
1657822387936,COGS 14B,A01,083073,Cheng; Tzu-Han,6,0,63,57
1657822393967,COGS 17,A01,092677,Semenuks; Arturs,6,0,81,75
1657822399994,COGS 100,A01,083619,Allen; Michael Gordon,17,0,70,53
1657822406016,COGS 101A,A01,083621,Davis; Joshua Daniel,9,0,68,59
1657822412053,COGS 101B,A01,091572,Allen; Michael Gordon,12,0,65,53
1657822418085,COGS 101C,A01,083625,Delgado; Tania,17,0,35,18
1657822424116,COGS 107A,A01,083627,Boyle; Mary E. T.,14,0,60,46
1657822430139,COGS 118A,A01,083075,Gupta; Anjum,21,0,76,55
1657822436169,CSE 3,A50,083646,Miranda; Gregory Joseph,24,0,50,26
1657822442204,CSE 8A,A50,083650,Miranda; Gregory Joseph,17,1,56,39
1657822448226,CSE 11,A01,083080,Cao; Yingjun,6,15,40,34
1657822454252,CSE 12,A01,083652,Krause-Levy; Sophia Louisa,28,1,120,92
1657822460276,CSE 15L,A01,083654,Morris; Justin Loren,9,0,50,41
1657822460276,CSE 15L,A02,083655,Morris; Justin Loren,9,0,50,41
1657822466302,CSE 20,A01,083657,Tran; Khoa Dang,39,0,80,41
1657822472326,CSE 21,A01,095574,Bach; Quang Tran,22,0,48,26
1657822478347,CSE 30,A01,083084,Eldon; John,6,0,80,74
1657822478347,CSE 30,B01,095061,Bhaskar; Nishant,9,0,50,41
1657822484370,CSE 100,A01,083659,Cao; Yingjun,5,4,70,65
1657822490401,CSE 134B,A01,083661,Powell; Thomas Allan,24,0,100,76
1657822496430,CSE 140,A01,083663,Gungor; Onat,15,0,85,70
1657822502468,CSE 140L,A01,083088,Eldon; John,23,0,100,77
1657822508493,CSE 175,A01,083665,Kumar; Rakesh,3,0,25,22
1657822514516,CSE 190,A00,092507,Dubnov; Shlomo,8,0,20,12
1657822520538,ECE 45,A01,083139,Congero; Spencer William,6,0,75,69
1657822526560,ECE 65,A50,083695,Saad; Andrew S,12,0,30,18
1657822526560,ECE 65,A51,095125,Saad; Andrew S,24,0,26,2
1657822532581,ECE 109,A01,091882,Touri; Behrouz,20,0,70,50
1657822538613,ECE 180,A00,083140,Abi Samra; Nicholas Camill,1,0,30,29
1657822538613,ECE 180,B00,083141,Abi Samra; Nicholas Camill,0,0,30,30
1657822544637,MATH 10A,A01,083735,Patchell; Gregory David,2,0,30,28
1657822544637,MATH 10A,A02,083736,Patchell; Gregory David,20,0,30,10
1657822544637,MATH 10A,A03,083737,Patchell; Gregory David,16,0,30,14
1657822550669,MATH 10B,A01,083207,Lim; Seonhee,8,0,34,26
1657822550669,MATH 10B,A02,083208,Lim; Seonhee,10,0,35,25
1657822550669,MATH 10B,A03,093472,Lim; Seonhee,7,0,34,27
1657822550669,MATH 10B,B01,083739,Sinha; Shubham,13,0,30,17
1657822556705,MATH 18,A01,083743,Cinel; Cameron Alexander,9,0,30,21
1657822556705,MATH 18,A02,083744,Cinel; Cameron Alexander,18,0,30,12
1657822556705,MATH 18,A03,083745,Cinel; Cameron Alexander,10,0,30,20
1657822556705,MATH 18,B01,083748,Rideout; David Porter,5,0,37,32
1657822556705,MATH 18,B02,083749,Rideout; David Porter,5,0,36,31
1657822556705,MATH 18,B03,083750,Rideout; David Porter,3,0,37,34
1657822556705,MATH 18,B04,083751,Rideout; David Porter,6,0,36,30
1657822556705,MATH 18,B05,093473,Rideout; David Porter,6,0,36,30
1657822556705,MATH 18,B06,093474,Rideout; David Porter,6,0,36,30
1657822562731,MATH 20A,A01,083754,Zheng; Zequn,14,0,40,26
1657822568757,MATH 20B,A01,083756,Briones; Jor-el Thomas Caparas,4,0,36,32
1657822568757,MATH 20B,A02,083757,Briones; Jor-el Thomas Caparas,1,0,36,35
1657822568757,MATH 20B,A03,093475,Briones; Jor-el Thomas Caparas,2,0,36,34
1657822574781,MATH 20C,A01,083760,Briones; Jor-el Thomas Caparas,1,0,35,34
1657822574781,MATH 20C,A02,083761,Briones; Jor-el Thomas Caparas,8,0,35,27
1657822574781,MATH 20C,A03,093476,Briones; Jor-el Thomas Caparas,0,1,36,36
1657822574781,MATH 20C,B01,083762,Bach; Quang Tran,1,0,30,29
1657822580803,MATH 20D,A01,083765,Tran; Brian Kha,5,0,30,25
1657822580803,MATH 20D,A02,083766,Tran; Brian Kha,5,0,30,25
1657822580803,MATH 20D,A03,083767,Tran; Brian Kha,5,0,30,25
1657822586833,MATH 20E,A01,083771,Ganguly; Soumya,10,0,32,22
1657822586833,MATH 20E,A02,083772,Ganguly; Soumya,6,0,32,26
1657822586833,MATH 20E,B01,083773,Ciotti; Benjamin,20,0,35,15
1657822586833,MATH 20E,B02,083774,Ciotti; Benjamin,18,0,35,17
1657822592859,MATH 103A,A01,083777,Greenfeld; Be'Eri,3,0,36,33
1657822592859,MATH 103A,A02,083778,Greenfeld; Be'Eri,5,0,36,31
1657822592859,MATH 103A,A03,093561,Greenfeld; Be'Eri,6,0,36,30
1657822592859,MATH 103A,B01,083779,Greenfeld; Be'Eri,7,0,36,29
1657822592859,MATH 103A,B02,083780,Greenfeld; Be'Eri,4,0,36,32
1657822592859,MATH 103A,B03,093562,Greenfeld; Be'Eri,3,0,36,33
1657822598882,MATH 105,A01,085443,Carter; Anne Toulson,15,0,35,20
1657822598882,MATH 105,A02,093477,Carter; Anne Toulson,20,0,35,15
1657822604908,MATH 109,A01,083213,Ganzberger; Geoffrey Michael,3,0,34,31
1657822604908,MATH 109,A02,083214,Ganzberger; Geoffrey Michael,4,0,34,30
1657822604908,MATH 109,A03,093478,Ganzberger; Geoffrey Michael,2,0,34,32
1657822604908,MATH 109,B01,083215,Ganzberger; Geoffrey Michael,1,0,32,31
1657822604908,MATH 109,B02,083216,Ganzberger; Geoffrey Michael,2,0,32,30
1657822604908,MATH 109,B03,093479,Ganzberger; Geoffrey Michael,8,0,32,24
1657822610937,MATH 142A,A01,083219,Chow; Bennett,7,0,32,25
1657822610937,MATH 142A,A02,083220,Chow; Bennett,10,0,32,22
1657822610937,MATH 142A,A03,093480,Chow; Bennett,9,0,32,23
1657822610937,MATH 142A,B03,093481,Chow; Bennett,8,0,32,24
1657822610937,MATH 142A,B04,093558,Chow; Bennett,13,0,32,19
1657822610937,MATH 142A,B05,093559,Chow; Bennett,7,0,32,25
1657822616967,MATH 193A,A01,083224,Rotar; Vladimir,8,0,34,26
1657822616967,MATH 193A,A02,083225,Rotar; Vladimir,9,0,34,25
1657822616967,MATH 193A,A03,083781,Rotar; Vladimir,5,0,34,29
1657822616967,MATH 193A,A04,083782,Rotar; Vladimir,11,0,34,23
1657822616967,MATH 193A,A05,093482,Rotar; Vladimir,10,0,34,24
1657822622993,MATH 197,001,091859,McAuley; Julian John,9999,0,9999,0
1657822622993,MATH 197,002,095566,Kedlaya; Kiran S.,9997,0,9999,2
1657822622993,MATH 197,003,095567,Xiao; Ming,9999,0,9999,0
1657822622993,MATH 197,004,095571,Perols; Johan Lars,9998,0,9999,1
1657822630063,COGS 9,A01,083615,Shannon; Kyle Michael,9,0,75,66
1657822636090,COGS 11,A01,083617,Boyle; Mary E. T.,23,0,48,25
1657822642118,COGS 13,A01,083071,Bastos; Amalia Pinkusfeld,11,0,71,60
1657822648145,COGS 14A,A01,092681,Semenuks; Arturs,5,1,100,95
1657822654169,COGS 14B,A01,083073,Cheng; Tzu-Han,6,0,63,57
1657822660190,COGS 17,A01,092677,Semenuks; Arturs,6,0,81,75
1657822666216,COGS 100,A01,083619,Allen; Michael Gordon,17,0,70,53
1657822672239,COGS 101A,A01,083621,Davis; Joshua Daniel,9,0,68,59
1657822678263,COGS 101B,A01,091572,Allen; Michael Gordon,12,0,65,53
1657822684291,COGS 101C,A01,083625,Delgado; Tania,17,0,35,18
1657822690315,COGS 107A,A01,083627,Boyle; Mary E. T.,14,0,60,46
1657822696339,COGS 118A,A01,083075,Gupta; Anjum,21,0,76,55
1657822702361,CSE 3,A50,083646,Miranda; Gregory Joseph,24,0,50,26
1657822708395,CSE 8A,A50,083650,Miranda; Gregory Joseph,17,1,56,39
1657822714418,CSE 11,A01,083080,Cao; Yingjun,6,15,40,34
1657822720447,CSE 12,A01,083652,Krause-Levy; Sophia Louisa,28,1,120,92
1657822726469,CSE 15L,A01,083654,Morris; Justin Loren,9,0,50,41
1657822726469,CSE 15L,A02,083655,Morris; Justin Loren,9,0,50,41
1657822732494,CSE 20,A01,083657,Tran; Khoa Dang,39,0,80,41
1657822738528,CSE 21,A01,095574,Bach; Quang Tran,22,0,48,26
1657822744555,CSE 30,A01,083084,Eldon; John,6,0,80,74
1657822744555,CSE 30,B01,095061,Bhaskar; Nishant,9,0,50,41
1657822750579,CSE 100,A01,083659,Cao; Yingjun,5,4,70,65
1657822756601,CSE 134B,A01,083661,Powell; Thomas Allan,24,0,100,76
1657822762627,CSE 140,A01,083663,Gungor; Onat,15,0,85,70
1657822768652,CSE 140L,A01,083088,Eldon; John,23,0,100,77
1657822774693,CSE 175,A01,083665,Kumar; Rakesh,3,0,25,22
1657822780715,CSE 190,A00,092507,Dubnov; Shlomo,8,0,20,12
1657822786743,ECE 45,A01,083139,Congero; Spencer William,6,0,75,69
1657822792772,ECE 65,A50,083695,Saad; Andrew S,12,0,30,18
1657822792772,ECE 65,A51,095125,Saad; Andrew S,24,0,26,2
1657822798799,ECE 109,A01,091882,Touri; Behrouz,20,0,70,50
1657822804824,ECE 180,A00,083140,Abi Samra; Nicholas Camill,1,0,30,29
1657822804824,ECE 180,B00,083141,Abi Samra; Nicholas Camill,0,0,30,30
1657822810849,MATH 10A,A01,083735,Patchell; Gregory David,2,0,30,28
1657822810849,MATH 10A,A02,083736,Patchell; Gregory David,20,0,30,10
1657822810849,MATH 10A,A03,083737,Patchell; Gregory David,16,0,30,14
1657822816877,MATH 10B,A01,083207,Lim; Seonhee,8,0,34,26
1657822816877,MATH 10B,A02,083208,Lim; Seonhee,10,0,35,25
1657822816877,MATH 10B,A03,093472,Lim; Seonhee,7,0,34,27
1657822816877,MATH 10B,B01,083739,Sinha; Shubham,13,0,30,17
1657822822912,MATH 18,A01,083743,Cinel; Cameron Alexander,9,0,30,21
1657822822912,MATH 18,A02,083744,Cinel; Cameron Alexander,18,0,30,12
1657822822912,MATH 18,A03,083745,Cinel; Cameron Alexander,10,0,30,20
1657822822912,MATH 18,B01,083748,Rideout; David Porter,5,0,37,32
1657822822912,MATH 18,B02,083749,Rideout; David Porter,5,0,36,31
1657822822912,MATH 18,B03,083750,Rideout; David Porter,3,0,37,34
1657822822912,MATH 18,B04,083751,Rideout; David Porter,6,0,36,30
1657822822912,MATH 18,B05,093473,Rideout; David Porter,6,0,36,30
1657822822912,MATH 18,B06,093474,Rideout; David Porter,6,0,36,30
1657822828941,MATH 20A,A01,083754,Zheng; Zequn,14,0,40,26
1657822834964,MATH 20B,A01,083756,Briones; Jor-el Thomas Caparas,4,0,36,32
1657822834964,MATH 20B,A02,083757,Briones; Jor-el Thomas Caparas,1,0,36,35
1657822834964,MATH 20B,A03,093475,Briones; Jor-el Thomas Caparas,2,0,36,34
1657822840988,MATH 20C,A01,083760,Briones; Jor-el Thomas Caparas,1,0,35,34
1657822840988,MATH 20C,A02,083761,Briones; Jor-el Thomas Caparas,8,0,35,27
1657822840988,MATH 20C,A03,093476,Briones; Jor-el Thomas Caparas,0,1,36,36
1657822840988,MATH 20C,B01,083762,Bach; Quang Tran,1,0,30,29
1657822847016,MATH 20D,A01,083765,Tran; Brian Kha,5,0,30,25
1657822847016,MATH 20D,A02,083766,Tran; Brian Kha,5,0,30,25
1657822847016,MATH 20D,A03,083767,Tran; Brian Kha,5,0,30,25
1657822853044,MATH 20E,A01,083771,Ganguly; Soumya,10,0,32,22
1657822853044,MATH 20E,A02,083772,Ganguly; Soumya,6,0,32,26
1657822853044,MATH 20E,B01,083773,Ciotti; Benjamin,20,0,35,15
1657822853044,MATH 20E,B02,083774,Ciotti; Benjamin,18,0,35,17
1657822859069,MATH 103A,A01,083777,Greenfeld; Be'Eri,3,0,36,33
1657822859069,MATH 103A,A02,083778,Greenfeld; Be'Eri,5,0,36,31
1657822859069,MATH 103A,A03,093561,Greenfeld; Be'Eri,6,0,36,30
1657822859069,MATH 103A,B01,083779,Greenfeld; Be'Eri,7,0,36,29
1657822859069,MATH 103A,B02,083780,Greenfeld; Be'Eri,4,0,36,32
1657822859069,MATH 103A,B03,093562,Greenfeld; Be'Eri,3,0,36,33
1657822865095,MATH 105,A01,085443,Carter; Anne Toulson,15,0,35,20
1657822865095,MATH 105,A02,093477,Carter; Anne Toulson,20,0,35,15
1657822871118,MATH 109,A01,083213,Ganzberger; Geoffrey Michael,3,0,34,31
1657822871118,MATH 109,A02,083214,Ganzberger; Geoffrey Michael,4,0,34,30
1657822871118,MATH 109,A03,093478,Ganzberger; Geoffrey Michael,2,0,34,32
1657822871118,MATH 109,B01,083215,Ganzberger; Geoffrey Michael,1,0,32,31
1657822871118,MATH 109,B02,083216,Ganzberger; Geoffrey Michael,2,0,32,30
1657822871118,MATH 109,B03,093479,Ganzberger; Geoffrey Michael,8,0,32,24
1657822877153,MATH 142A,A01,083219,Chow; Bennett,7,0,32,25
1657822877153,MATH 142A,A02,083220,Chow; Bennett,10,0,32,22
1657822877153,MATH 142A,A03,093480,Chow; Bennett,9,0,32,23
1657822877153,MATH 142A,B03,093481,Chow; Bennett,8,0,32,24
1657822877153,MATH 142A,B04,093558,Chow; Bennett,13,0,32,19
1657822877153,MATH 142A,B05,093559,Chow; Bennett,7,0,32,25
1657822883266,MATH 193A,A01,083224,Rotar; Vladimir,8,0,34,26
1657822883266,MATH 193A,A02,083225,Rotar; Vladimir,9,0,34,25
1657822883266,MATH 193A,A03,083781,Rotar; Vladimir,5,0,34,29
1657822883266,MATH 193A,A04,083782,Rotar; Vladimir,11,0,34,23
1657822883266,MATH 193A,A05,093482,Rotar; Vladimir,10,0,34,24
1657822889287,MATH 197,001,091859,McAuley; Julian John,9999,0,9999,0
1657822889287,MATH 197,002,095566,Kedlaya; Kiran S.,9997,0,9999,2
1657822889287,MATH 197,003,095567,Xiao; Ming,9999,0,9999,0
1657822889287,MATH 197,004,095571,Perols; Johan Lars,9998,0,9999,1
1657822896339,COGS 9,A01,083615,Shannon; Kyle Michael,9,0,75,66
1657822902371,COGS 11,A01,083617,Boyle; Mary E. T.,23,0,48,25
1657822908396,COGS 13,A01,083071,Bastos; Amalia Pinkusfeld,11,0,71,60
1657822914420,COGS 14A,A01,092681,Semenuks; Arturs,5,1,100,95
1657822920448,COGS 14B,A01,083073,Cheng; Tzu-Han,6,0,63,57
1657822926471,COGS 17,A01,092677,Semenuks; Arturs,6,0,81,75
1657822932511,COGS 100,A01,083619,Allen; Michael Gordon,17,0,70,53
1657822938546,COGS 101A,A01,083621,Davis; Joshua Daniel,9,0,68,59
1657822944570,COGS 101B,A01,091572,Allen; Michael Gordon,12,0,65,53
1657822950599,COGS 101C,A01,083625,Delgado; Tania,17,0,35,18
1657822956625,COGS 107A,A01,083627,Boyle; Mary E. T.,14,0,60,46
1657822962660,COGS 118A,A01,083075,Gupta; Anjum,21,0,76,55
1657822968686,CSE 3,A50,083646,Miranda; Gregory Joseph,24,0,50,26
1657822974710,CSE 8A,A50,083650,Miranda; Gregory Joseph,17,1,56,39
1657822980740,CSE 11,A01,083080,Cao; Yingjun,6,15,40,34
1657822986764,CSE 12,A01,083652,Krause-Levy; Sophia Louisa,28,1,120,92
1657822992792,CSE 15L,A01,083654,Morris; Justin Loren,9,0,50,41
1657822992792,CSE 15L,A02,083655,Morris; Justin Loren,9,0,50,41
1657822998833,CSE 20,A01,083657,Tran; Khoa Dang,39,0,80,41
1657823004857,CSE 21,A01,095574,Bach; Quang Tran,22,0,48,26
1657823010881,CSE 30,A01,083084,Eldon; John,6,0,80,74
1657823010881,CSE 30,B01,095061,Bhaskar; Nishant,9,0,50,41
1657823016904,CSE 100,A01,083659,Cao; Yingjun,5,4,70,65
1657823022943,CSE 134B,A01,083661,Powell; Thomas Allan,24,0,100,76
1657823028975,CSE 140,A01,083663,Gungor; Onat,15,0,85,70
1657823035001,CSE 140L,A01,083088,Eldon; John,23,0,100,77
1657823041027,CSE 175,A01,083665,Kumar; Rakesh,3,0,25,22
1657823047053,CSE 190,A00,092507,Dubnov; Shlomo,8,0,20,12
1657823053082,ECE 45,A01,083139,Congero; Spencer William,6,0,75,69
1657823059109,ECE 65,A50,083695,Saad; Andrew S,12,0,30,18
1657823059109,ECE 65,A51,095125,Saad; Andrew S,24,0,26,2
1657823065136,ECE 109,A01,091882,Touri; Behrouz,20,0,70,50
1657823071167,ECE 180,A00,083140,Abi Samra; Nicholas Camill,1,0,30,29
1657823071167,ECE 180,B00,083141,Abi Samra; Nicholas Camill,0,0,30,30
1657823077195,MATH 10A,A01,083735,Patchell; Gregory David,2,0,30,28
1657823077195,MATH 10A,A02,083736,Patchell; Gregory David,20,0,30,10
1657823077195,MATH 10A,A03,083737,Patchell; Gregory David,16,0,30,14
1657823083227,MATH 10B,A01,083207,Lim; Seonhee,8,0,34,26
1657823083227,MATH 10B,A02,083208,Lim; Seonhee,10,0,35,25
1657823083227,MATH 10B,A03,093472,Lim; Seonhee,7,0,34,27
1657823083227,MATH 10B,B01,083739,Sinha; Shubham,13,0,30,17
1657823089257,MATH 18,A01,083743,Cinel; Cameron Alexander,9,0,30,21
1657823089257,MATH 18,A02,083744,Cinel; Cameron Alexander,18,0,30,12
1657823089257,MATH 18,A03,083745,Cinel; Cameron Alexander,10,0,30,20
1657823089257,MATH 18,B01,083748,Rideout; David Porter,5,0,37,32
1657823089257,MATH 18,B02,083749,Rideout; David Porter,5,0,36,31
1657823089257,MATH 18,B03,083750,Rideout; David Porter,3,0,37,34
1657823089257,MATH 18,B04,083751,Rideout; David Porter,6,0,36,30
1657823089257,MATH 18,B05,093473,Rideout; David Porter,6,0,36,30
1657823089257,MATH 18,B06,093474,Rideout; David Porter,6,0,36,30
1657823095279,MATH 20A,A01,083754,Zheng; Zequn,14,0,40,26
1657823101303,MATH 20B,A01,083756,Briones; Jor-el Thomas Caparas,4,0,36,32
1657823101303,MATH 20B,A02,083757,Briones; Jor-el Thomas Caparas,1,0,36,35
1657823101303,MATH 20B,A03,093475,Briones; Jor-el Thomas Caparas,2,0,36,34
1657823107325,MATH 20C,A01,083760,Briones; Jor-el Thomas Caparas,1,0,35,34
1657823107325,MATH 20C,A02,083761,Briones; Jor-el Thomas Caparas,8,0,35,27
1657823107325,MATH 20C,A03,093476,Briones; Jor-el Thomas Caparas,0,1,36,36
1657823107325,MATH 20C,B01,083762,Bach; Quang Tran,1,0,30,29
1657823113349,MATH 20D,A01,083765,Tran; Brian Kha,5,0,30,25
1657823113349,MATH 20D,A02,083766,Tran; Brian Kha,5,0,30,25
1657823113349,MATH 20D,A03,083767,Tran; Brian Kha,5,0,30,25
1657823119373,MATH 20E,A01,083771,Ganguly; Soumya,10,0,32,22
1657823119373,MATH 20E,A02,083772,Ganguly; Soumya,6,0,32,26
1657823119373,MATH 20E,B01,083773,Ciotti; Benjamin,20,0,35,15
1657823119373,MATH 20E,B02,083774,Ciotti; Benjamin,18,0,35,17
1657823125408,MATH 103A,A01,083777,Greenfeld; Be'Eri,3,0,36,33
1657823125408,MATH 103A,A02,083778,Greenfeld; Be'Eri,5,0,36,31
1657823125408,MATH 103A,A03,093561,Greenfeld; Be'Eri,6,0,36,30
1657823125408,MATH 103A,B01,083779,Greenfeld; Be'Eri,7,0,36,29
1657823125408,MATH 103A,B02,083780,Greenfeld; Be'Eri,4,0,36,32
1657823125408,MATH 103A,B03,093562,Greenfeld; Be'Eri,3,0,36,33
1657823131431,MATH 105,A01,085443,Carter; Anne Toulson,15,0,35,20
1657823131431,MATH 105,A02,093477,Carter; Anne Toulson,20,0,35,15
1657823137462,MATH 109,A01,083213,Ganzberger; Geoffrey Michael,3,0,34,31
1657823137462,MATH 109,A02,083214,Ganzberger; Geoffrey Michael,4,0,34,30
1657823137462,MATH 109,A03,093478,Ganzberger; Geoffrey Michael,2,0,34,32
1657823137462,MATH 109,B01,083215,Ganzberger; Geoffrey Michael,1,0,32,31
1657823137462,MATH 109,B02,083216,Ganzberger; Geoffrey Michael,2,0,32,30
1657823137462,MATH 109,B03,093479,Ganzberger; Geoffrey Michael,8,0,32,24
1657823143486,MATH 142A,A01,083219,Chow; Bennett,7,0,32,25
1657823143486,MATH 142A,A02,083220,Chow; Bennett,10,0,32,22
1657823143486,MATH 142A,A03,093480,Chow; Bennett,9,0,32,23
1657823143486,MATH 142A,B03,093481,Chow; Bennett,8,0,32,24
1657823143486,MATH 142A,B04,093558,Chow; Bennett,13,0,32,19
1657823143486,MATH 142A,B05,093559,Chow; Bennett,7,0,32,25
1657823149515,MATH 193A,A01,083224,Rotar; Vladimir,8,0,34,26
1657823149515,MATH 193A,A02,083225,Rotar; Vladimir,9,0,34,25
1657823149515,MATH 193A,A03,083781,Rotar; Vladimir,5,0,34,29
1657823149515,MATH 193A,A04,083782,Rotar; Vladimir,11,0,34,23
1657823149515,MATH 193A,A05,093482,Rotar; Vladimir,10,0,34,24
1657823155538,MATH 197,001,091859,McAuley; Julian John,9999,0,9999,0
1657823155538,MATH 197,002,095566,Kedlaya; Kiran S.,9997,0,9999,2
1657823155538,MATH 197,003,095567,Xiao; Ming,9999,0,9999,0
1657823155538,MATH 197,004,095571,Perols; Johan Lars,9998,0,9999,1
1657823162593,COGS 9,A01,083615,Shannon; Kyle Michael,9,0,75,66
1657823168621,COGS 11,A01,083617,Boyle; Mary E. T.,23,0,48,25
1657823174658,COGS 13,A01,083071,Bastos; Amalia Pinkusfeld,11,0,71,60
1657823180687,COGS 14A,A01,092681,Semenuks; Arturs,5,1,100,95
1657823186712,COGS 14B,A01,083073,Cheng; Tzu-Han,6,0,63,57
1657823192737,COGS 17,A01,092677,Semenuks; Arturs,6,0,81,75
1657823198761,COGS 100,A01,083619,Allen; Michael Gordon,17,0,70,53
1657823204783,COGS 101A,A01,083621,Davis; Joshua Daniel,9,0,68,59
1657823210813,COGS 101B,A01,091572,Allen; Michael Gordon,12,0,65,53
1657823216843,COGS 101C,A01,083625,Delgado; Tania,17,0,35,18
1657823222865,COGS 107A,A01,083627,Boyle; Mary E. T.,14,0,60,46
1657823228898,COGS 118A,A01,083075,Gupta; Anjum,21,0,76,55
1657823234930,CSE 3,A50,083646,Miranda; Gregory Joseph,24,0,50,26
1657823240965,CSE 8A,A50,083650,Miranda; Gregory Joseph,17,1,56,39
1657823246986,CSE 11,A01,083080,Cao; Yingjun,6,15,40,34
1657823253011,CSE 12,A01,083652,Krause-Levy; Sophia Louisa,28,1,120,92
1657823259033,CSE 15L,A01,083654,Morris; Justin Loren,9,0,50,41
1657823259033,CSE 15L,A02,083655,Morris; Justin Loren,9,0,50,41
1657823265065,CSE 20,A01,083657,Tran; Khoa Dang,39,0,80,41
1657823271089,CSE 21,A01,095574,Bach; Quang Tran,22,0,48,26
1657823277113,CSE 30,A01,083084,Eldon; John,6,0,80,74
1657823277113,CSE 30,B01,095061,Bhaskar; Nishant,9,0,50,41
1657823283150,CSE 100,A01,083659,Cao; Yingjun,5,4,70,65
1657823289172,CSE 134B,A01,083661,Powell; Thomas Allan,24,0,100,76
1657823295202,CSE 140,A01,083663,Gungor; Onat,15,0,85,70
1657823301227,CSE 140L,A01,083088,Eldon; John,23,0,100,77
1657823307252,CSE 175,A01,083665,Kumar; Rakesh,3,0,25,22
1657823313282,CSE 190,A00,092507,Dubnov; Shlomo,8,0,20,12
1657823319312,ECE 45,A01,083139,Congero; Spencer William,6,0,75,69
1657823325344,ECE 65,A50,083695,Saad; Andrew S,12,0,30,18
1657823325344,ECE 65,A51,095125,Saad; Andrew S,24,0,26,2
1657823331367,ECE 109,A01,091882,Touri; Behrouz,20,0,70,50
1657823337390,ECE 180,A00,083140,Abi Samra; Nicholas Camill,1,0,30,29
1657823337390,ECE 180,B00,083141,Abi Samra; Nicholas Camill,0,0,30,30
1657823343417,MATH 10A,A01,083735,Patchell; Gregory David,2,0,30,28
1657823343417,MATH 10A,A02,083736,Patchell; Gregory David,20,0,30,10
1657823343417,MATH 10A,A03,083737,Patchell; Gregory David,16,0,30,14
1657823349459,MATH 10B,A01,083207,Lim; Seonhee,8,0,34,26
1657823349459,MATH 10B,A02,083208,Lim; Seonhee,10,0,35,25
1657823349459,MATH 10B,A03,093472,Lim; Seonhee,7,0,34,27
1657823349459,MATH 10B,B01,083739,Sinha; Shubham,13,0,30,17
1657823355484,MATH 18,A01,083743,Cinel; Cameron Alexander,9,0,30,21
1657823355484,MATH 18,A02,083744,Cinel; Cameron Alexander,18,0,30,12
1657823355484,MATH 18,A03,083745,Cinel; Cameron Alexander,10,0,30,20
1657823355484,MATH 18,B01,083748,Rideout; David Porter,5,0,37,32
1657823355484,MATH 18,B02,083749,Rideout; David Porter,5,0,36,31
1657823355484,MATH 18,B03,083750,Rideout; David Porter,3,0,37,34
1657823355484,MATH 18,B04,083751,Rideout; David Porter,6,0,36,30
1657823355484,MATH 18,B05,093473,Rideout; David Porter,6,0,36,30
1657823355484,MATH 18,B06,093474,Rideout; David Porter,6,0,36,30
1657823361507,MATH 20A,A01,083754,Zheng; Zequn,14,0,40,26
1657823367530,MATH 20B,A01,083756,Briones; Jor-el Thomas Caparas,4,0,36,32
1657823367530,MATH 20B,A02,083757,Briones; Jor-el Thomas Caparas,1,0,36,35
1657823367530,MATH 20B,A03,093475,Briones; Jor-el Thomas Caparas,2,0,36,34
1657823373554,MATH 20C,A01,083760,Briones; Jor-el Thomas Caparas,1,0,35,34
1657823373554,MATH 20C,A02,083761,Briones; Jor-el Thomas Caparas,8,0,35,27
1657823373554,MATH 20C,A03,093476,Briones; Jor-el Thomas Caparas,0,1,36,36
1657823373554,MATH 20C,B01,083762,Bach; Quang Tran,1,0,30,29
1657823379578,MATH 20D,A01,083765,Tran; Brian Kha,5,0,30,25
1657823379578,MATH 20D,A02,083766,Tran; Brian Kha,5,0,30,25
1657823379578,MATH 20D,A03,083767,Tran; Brian Kha,5,0,30,25
1657823385601,MATH 20E,A01,083771,Ganguly; Soumya,10,0,32,22
1657823385601,MATH 20E,A02,083772,Ganguly; Soumya,6,0,32,26
1657823385601,MATH 20E,B01,083773,Ciotti; Benjamin,20,0,35,15
1657823385601,MATH 20E,B02,083774,Ciotti; Benjamin,18,0,35,17
1657823391632,MATH 103A,A01,083777,Greenfeld; Be'Eri,3,0,36,33
1657823391632,MATH 103A,A02,083778,Greenfeld; Be'Eri,5,0,36,31
1657823391632,MATH 103A,A03,093561,Greenfeld; Be'Eri,6,0,36,30
1657823391632,MATH 103A,B01,083779,Greenfeld; Be'Eri,7,0,36,29
1657823391632,MATH 103A,B02,083780,Greenfeld; Be'Eri,4,0,36,32
1657823391632,MATH 103A,B03,093562,Greenfeld; Be'Eri,3,0,36,33
1657823397668,MATH 105,A01,085443,Carter; Anne Toulson,15,0,35,20
1657823397668,MATH 105,A02,093477,Carter; Anne Toulson,20,0,35,15
1657823403691,MATH 109,A01,083213,Ganzberger; Geoffrey Michael,3,0,34,31
1657823403691,MATH 109,A02,083214,Ganzberger; Geoffrey Michael,4,0,34,30
1657823403691,MATH 109,A03,093478,Ganzberger; Geoffrey Michael,2,0,34,32
1657823403691,MATH 109,B01,083215,Ganzberger; Geoffrey Michael,1,0,32,31
1657823403691,MATH 109,B02,083216,Ganzberger; Geoffrey Michael,2,0,32,30
1657823403691,MATH 109,B03,093479,Ganzberger; Geoffrey Michael,8,0,32,24
1657823409715,MATH 142A,A01,083219,Chow; Bennett,7,0,32,25
1657823409715,MATH 142A,A02,083220,Chow; Bennett,10,0,32,22
1657823409715,MATH 142A,A03,093480,Chow; Bennett,9,0,32,23
1657823409715,MATH 142A,B03,093481,Chow; Bennett,8,0,32,24
1657823409715,MATH 142A,B04,093558,Chow; Bennett,13,0,32,19
1657823409715,MATH 142A,B05,093559,Chow; Bennett,7,0,32,25
1657823415743,MATH 193A,A01,083224,Rotar; Vladimir,8,0,34,26
1657823415743,MATH 193A,A02,083225,Rotar; Vladimir,10,0,34,24
1657823415743,MATH 193A,A03,083781,Rotar; Vladimir,5,0,34,29
1657823415743,MATH 193A,A04,083782,Rotar; Vladimir,11,0,34,23
1657823415743,MATH 193A,A05,093482,Rotar; Vladimir,10,0,34,24
1657823421767,MATH 197,001,091859,McAuley; Julian John,9999,0,9999,0
1657823421767,MATH 197,002,095566,Kedlaya; Kiran S.,9997,0,9999,2
1657823421767,MATH 197,003,095567,Xiao; Ming,9999,0,9999,0
1657823421767,MATH 197,004,095571,Perols; Johan Lars,9998,0,9999,1
1657823428837,COGS 9,A01,083615,Shannon; Kyle Michael,9,0,75,66
1657823434858,COGS 11,A01,083617,Boyle; Mary E. T.,23,0,48,25
1657823440883,COGS 13,A01,083071,Bastos; Amalia Pinkusfeld,11,0,71,60
1657823446909,COGS 14A,A01,092681,Semenuks; Arturs,5,1,100,95
1657823452937,COGS 14B,A01,083073,Cheng; Tzu-Han,6,0,63,57
1657823458963,COGS 17,A01,092677,Semenuks; Arturs,6,0,81,75
1657823464996,COGS 100,A01,083619,Allen; Michael Gordon,17,0,70,53
1657823471020,COGS 101A,A01,083621,Davis; Joshua Daniel,9,0,68,59
1657823477135,COGS 101B,A01,091572,Allen; Michael Gordon,12,0,65,53
1657823483161,COGS 101C,A01,083625,Delgado; Tania,17,0,35,18
1657823489184,COGS 107A,A01,083627,Boyle; Mary E. T.,14,0,60,46
1657823495213,COGS 118A,A01,083075,Gupta; Anjum,21,0,76,55
1657823501237,CSE 3,A50,083646,Miranda; Gregory Joseph,24,0,50,26
1657823507268,CSE 8A,A50,083650,Miranda; Gregory Joseph,17,1,56,39
1657823513291,CSE 11,A01,083080,Cao; Yingjun,6,15,40,34
1657823519315,CSE 12,A01,083652,Krause-Levy; Sophia Louisa,28,1,120,92
1657823525344,CSE 15L,A01,083654,Morris; Justin Loren,9,0,50,41
1657823525344,CSE 15L,A02,083655,Morris; Justin Loren,9,0,50,41
1657823531376,CSE 20,A01,083657,Tran; Khoa Dang,39,0,80,41
1657823537399,CSE 21,A01,095574,Bach; Quang Tran,22,0,48,26
1657823543440,CSE 30,A01,083084,Eldon; John,6,0,80,74
1657823543440,CSE 30,B01,095061,Bhaskar; Nishant,9,0,50,41
1657823549463,CSE 100,A01,083659,Cao; Yingjun,5,4,70,65
1657823555506,CSE 134B,A01,083661,Powell; Thomas Allan,24,0,100,76
1657823561528,CSE 140,A01,083663,Gungor; Onat,15,0,85,70
1657823567563,CSE 140L,A01,083088,Eldon; John,23,0,100,77
1657823573590,CSE 175,A01,083665,Kumar; Rakesh,3,0,25,22
1657823579615,CSE 190,A00,092507,Dubnov; Shlomo,8,0,20,12
1657823585642,ECE 45,A01,083139,Congero; Spencer William,6,0,75,69
1657823591667,ECE 65,A50,083695,Saad; Andrew S,12,0,30,18
1657823591667,ECE 65,A51,095125,Saad; Andrew S,24,0,26,2
1657823597692,ECE 109,A01,091882,Touri; Behrouz,20,0,70,50
1657823603752,ECE 180,A00,083140,Abi Samra; Nicholas Camill,1,0,30,29
1657823603752,ECE 180,B00,083141,Abi Samra; Nicholas Camill,0,0,30,30
1657823609781,MATH 10A,A01,083735,Patchell; Gregory David,2,0,30,28
1657823609781,MATH 10A,A02,083736,Patchell; Gregory David,20,0,30,10
1657823609781,MATH 10A,A03,083737,Patchell; Gregory David,16,0,30,14
1657823615810,MATH 10B,A01,083207,Lim; Seonhee,8,0,34,26
1657823615810,MATH 10B,A02,083208,Lim; Seonhee,10,0,35,25
1657823615810,MATH 10B,A03,093472,Lim; Seonhee,7,0,34,27
1657823615810,MATH 10B,B01,083739,Sinha; Shubham,13,0,30,17
1657823621841,MATH 18,A01,083743,Cinel; Cameron Alexander,9,0,30,21
1657823621841,MATH 18,A02,083744,Cinel; Cameron Alexander,18,0,30,12
1657823621841,MATH 18,A03,083745,Cinel; Cameron Alexander,10,0,30,20
1657823621841,MATH 18,B01,083748,Rideout; David Porter,5,0,37,32
1657823621841,MATH 18,B02,083749,Rideout; David Porter,5,0,36,31
1657823621841,MATH 18,B03,083750,Rideout; David Porter,3,0,37,34
1657823621841,MATH 18,B04,083751,Rideout; David Porter,6,0,36,30
1657823621841,MATH 18,B05,093473,Rideout; David Porter,6,0,36,30
1657823621841,MATH 18,B06,093474,Rideout; David Porter,6,0,36,30
1657823627862,MATH 20A,A01,083754,Zheng; Zequn,14,0,40,26
1657823633889,MATH 20B,A01,083756,Briones; Jor-el Thomas Caparas,4,0,36,32
1657823633889,MATH 20B,A02,083757,Briones; Jor-el Thomas Caparas,1,0,36,35
1657823633889,MATH 20B,A03,093475,Briones; Jor-el Thomas Caparas,2,0,36,34
1657823639918,MATH 20C,A01,083760,Briones; Jor-el Thomas Caparas,1,0,35,34
1657823639918,MATH 20C,A02,083761,Briones; Jor-el Thomas Caparas,8,0,35,27
1657823639918,MATH 20C,A03,093476,Briones; Jor-el Thomas Caparas,0,1,36,36
1657823639918,MATH 20C,B01,083762,Bach; Quang Tran,1,0,30,29
1657823645942,MATH 20D,A01,083765,Tran; Brian Kha,5,0,30,25
1657823645942,MATH 20D,A02,083766,Tran; Brian Kha,5,0,30,25
1657823645942,MATH 20D,A03,083767,Tran; Brian Kha,5,0,30,25
1657823651965,MATH 20E,A01,083771,Ganguly; Soumya,10,0,32,22
1657823651965,MATH 20E,A02,083772,Ganguly; Soumya,6,0,32,26
1657823651965,MATH 20E,B01,083773,Ciotti; Benjamin,20,0,35,15
1657823651965,MATH 20E,B02,083774,Ciotti; Benjamin,18,0,35,17
1657823657991,MATH 103A,A01,083777,Greenfeld; Be'Eri,3,0,36,33
1657823657991,MATH 103A,A02,083778,Greenfeld; Be'Eri,5,0,36,31
1657823657991,MATH 103A,A03,093561,Greenfeld; Be'Eri,6,0,36,30
1657823657991,MATH 103A,B01,083779,Greenfeld; Be'Eri,7,0,36,29
1657823657991,MATH 103A,B02,083780,Greenfeld; Be'Eri,4,0,36,32
1657823657991,MATH 103A,B03,093562,Greenfeld; Be'Eri,3,0,36,33
1657823664015,MATH 105,A01,085443,Carter; Anne Toulson,15,0,35,20
1657823664015,MATH 105,A02,093477,Carter; Anne Toulson,20,0,35,15
1657823670044,MATH 109,A01,083213,Ganzberger; Geoffrey Michael,3,0,34,31
1657823670044,MATH 109,A02,083214,Ganzberger; Geoffrey Michael,4,0,34,30
1657823670044,MATH 109,A03,093478,Ganzberger; Geoffrey Michael,2,0,34,32
1657823670044,MATH 109,B01,083215,Ganzberger; Geoffrey Michael,1,0,32,31
1657823670044,MATH 109,B02,083216,Ganzberger; Geoffrey Michael,2,0,32,30
1657823670044,MATH 109,B03,093479,Ganzberger; Geoffrey Michael,8,0,32,24
1657823676068,MATH 142A,A01,083219,Chow; Bennett,7,0,32,25
1657823676068,MATH 142A,A02,083220,Chow; Bennett,10,0,32,22
1657823676068,MATH 142A,A03,093480,Chow; Bennett,9,0,32,23
1657823676068,MATH 142A,B03,093481,Chow; Bennett,8,0,32,24
1657823676068,MATH 142A,B04,093558,Chow; Bennett,13,0,32,19
1657823676068,MATH 142A,B05,093559,Chow; Bennett,7,0,32,25
1657823682098,MATH 193A,A01,083224,Rotar; Vladimir,8,0,34,26
1657823682098,MATH 193A,A02,083225,Rotar; Vladimir,10,0,34,24
1657823682098,MATH 193A,A03,083781,Rotar; Vladimir,5,0,34,29
1657823682098,MATH 193A,A04,083782,Rotar; Vladimir,11,0,34,23
1657823682098,MATH 193A,A05,093482,Rotar; Vladimir,10,0,34,24
1657823688127,MATH 197,001,091859,McAuley; Julian John,9999,0,9999,0
1657823688127,MATH 197,002,095566,Kedlaya; Kiran S.,9997,0,9999,2
1657823688127,MATH 197,003,095567,Xiao; Ming,9999,0,9999,0
1657823688127,MATH 197,004,095571,Perols; Johan Lars,9998,0,9999,1
1657823695183,COGS 9,A01,083615,Shannon; Kyle Michael,9,0,75,66
1657823701207,COGS 11,A01,083617,Boyle; Mary E. T.,23,0,48,25
1657823707229,COGS 13,A01,083071,Bastos; Amalia Pinkusfeld,11,0,71,60
1657823713251,COGS 14A,A01,092681,Semenuks; Arturs,5,1,100,95
1657823719272,COGS 14B,A01,083073,Cheng; Tzu-Han,6,0,63,57
1657823725303,COGS 17,A01,092677,Semenuks; Arturs,6,0,81,75
1657823731327,COGS 100,A01,083619,Allen; Michael Gordon,17,0,70,53
1657823737350,COGS 101A,A01,083621,Davis; Joshua Daniel,9,0,68,59
1657823743374,COGS 101B,A01,091572,Allen; Michael Gordon,12,0,65,53
1657823749404,COGS 101C,A01,083625,Delgado; Tania,17,0,35,18
1657823755425,COGS 107A,A01,083627,Boyle; Mary E. T.,14,0,60,46
1657823761453,COGS 118A,A01,083075,Gupta; Anjum,21,0,76,55
1657823767481,CSE 3,A50,083646,Miranda; Gregory Joseph,24,0,50,26
1657823773515,CSE 8A,A50,083650,Miranda; Gregory Joseph,17,1,56,39
1657823779538,CSE 11,A01,083080,Cao; Yingjun,6,15,40,34
1657823785574,CSE 12,A01,083652,Krause-Levy; Sophia Louisa,28,1,120,92
1657823791610,CSE 15L,A01,083654,Morris; Justin Loren,9,0,50,41
1657823791610,CSE 15L,A02,083655,Morris; Justin Loren,9,0,50,41
1657823797648,CSE 20,A01,083657,Tran; Khoa Dang,39,0,80,41
1657823803681,CSE 21,A01,095574,Bach; Quang Tran,22,0,48,26
1657823809707,CSE 30,A01,083084,Eldon; John,6,0,80,74
1657823809707,CSE 30,B01,095061,Bhaskar; Nishant,9,0,50,41
1657823815729,CSE 100,A01,083659,Cao; Yingjun,5,4,70,65
1657823821757,CSE 134B,A01,083661,Powell; Thomas Allan,24,0,100,76
1657823827778,CSE 140,A01,083663,Gungor; Onat,15,0,85,70
1657823833801,CSE 140L,A01,083088,Eldon; John,23,0,100,77
1657823839823,CSE 175,A01,083665,Kumar; Rakesh,3,0,25,22
1657823845845,CSE 190,A00,092507,Dubnov; Shlomo,8,0,20,12
1657823851874,ECE 45,A01,083139,Congero; Spencer William,6,0,75,69
1657823857905,ECE 65,A50,083695,Saad; Andrew S,12,0,30,18
1657823857905,ECE 65,A51,095125,Saad; Andrew S,24,0,26,2
1657823863933,ECE 109,A01,091882,Touri; Behrouz,20,0,70,50
1657823869956,ECE 180,A00,083140,Abi Samra; Nicholas Camill,1,0,30,29
1657823869956,ECE 180,B00,083141,Abi Samra; Nicholas Camill,0,0,30,30
1657823875979,MATH 10A,A01,083735,Patchell; Gregory David,2,0,30,28
1657823875979,MATH 10A,A02,083736,Patchell; Gregory David,20,0,30,10
1657823875979,MATH 10A,A03,083737,Patchell; Gregory David,16,0,30,14
1657823882002,MATH 10B,A01,083207,Lim; Seonhee,8,0,34,26
1657823882002,MATH 10B,A02,083208,Lim; Seonhee,10,0,35,25
1657823882002,MATH 10B,A03,093472,Lim; Seonhee,7,0,34,27
1657823882002,MATH 10B,B01,083739,Sinha; Shubham,13,0,30,17
1657823888032,MATH 18,A01,083743,Cinel; Cameron Alexander,9,0,30,21
1657823888032,MATH 18,A02,083744,Cinel; Cameron Alexander,18,0,30,12
1657823888032,MATH 18,A03,083745,Cinel; Cameron Alexander,10,0,30,20
1657823888032,MATH 18,B01,083748,Rideout; David Porter,5,0,37,32
1657823888032,MATH 18,B02,083749,Rideout; David Porter,5,0,36,31
1657823888032,MATH 18,B03,083750,Rideout; David Porter,3,0,37,34
1657823888032,MATH 18,B04,083751,Rideout; David Porter,6,0,36,30
1657823888032,MATH 18,B05,093473,Rideout; David Porter,6,0,36,30
1657823888032,MATH 18,B06,093474,Rideout; David Porter,6,0,36,30
1657823894058,MATH 20A,A01,083754,Zheng; Zequn,14,0,40,26
1657823900083,MATH 20B,A01,083756,Briones; Jor-el Thomas Caparas,4,0,36,32
1657823900083,MATH 20B,A02,083757,Briones; Jor-el Thomas Caparas,1,0,36,35
1657823900083,MATH 20B,A03,093475,Briones; Jor-el Thomas Caparas,2,0,36,34
1657823906114,MATH 20C,A01,083760,Briones; Jor-el Thomas Caparas,1,0,35,34
1657823906114,MATH 20C,A02,083761,Briones; Jor-el Thomas Caparas,8,0,35,27
1657823906114,MATH 20C,A03,093476,Briones; Jor-el Thomas Caparas,0,1,36,36
1657823906114,MATH 20C,B01,083762,Bach; Quang Tran,1,0,30,29
1657823912139,MATH 20D,A01,083765,Tran; Brian Kha,5,0,30,25
1657823912139,MATH 20D,A02,083766,Tran; Brian Kha,5,0,30,25
1657823912139,MATH 20D,A03,083767,Tran; Brian Kha,5,0,30,25
1657823918166,MATH 20E,A01,083771,Ganguly; Soumya,10,0,32,22
1657823918166,MATH 20E,A02,083772,Ganguly; Soumya,6,0,32,26
1657823918166,MATH 20E,B01,083773,Ciotti; Benjamin,20,0,35,15
1657823918166,MATH 20E,B02,083774,Ciotti; Benjamin,18,0,35,17
1657823924194,MATH 103A,A01,083777,Greenfeld; Be'Eri,3,0,36,33
1657823924194,MATH 103A,A02,083778,Greenfeld; Be'Eri,5,0,36,31
1657823924194,MATH 103A,A03,093561,Greenfeld; Be'Eri,6,0,36,30
1657823924194,MATH 103A,B01,083779,Greenfeld; Be'Eri,7,0,36,29
1657823924194,MATH 103A,B02,083780,Greenfeld; Be'Eri,4,0,36,32
1657823924194,MATH 103A,B03,093562,Greenfeld; Be'Eri,3,0,36,33
1657823930232,MATH 105,A01,085443,Carter; Anne Toulson,15,0,35,20
1657823930232,MATH 105,A02,093477,Carter; Anne Toulson,20,0,35,15
1657823936254,MATH 109,A01,083213,Ganzberger; Geoffrey Michael,3,0,34,31
1657823936254,MATH 109,A02,083214,Ganzberger; Geoffrey Michael,4,0,34,30
1657823936254,MATH 109,A03,093478,Ganzberger; Geoffrey Michael,2,0,34,32
1657823936254,MATH 109,B01,083215,Ganzberger; Geoffrey Michael,1,0,32,31
1657823936254,MATH 109,B02,083216,Ganzberger; Geoffrey Michael,2,0,32,30
1657823936254,MATH 109,B03,093479,Ganzberger; Geoffrey Michael,8,0,32,24
1657823942286,MATH 142A,A01,083219,Chow; Bennett,7,0,32,25
1657823942286,MATH 142A,A02,083220,Chow; Bennett,10,0,32,22
1657823942286,MATH 142A,A03,093480,Chow; Bennett,9,0,32,23
1657823942286,MATH 142A,B03,093481,Chow; Bennett,8,0,32,24
1657823942286,MATH 142A,B04,093558,Chow; Bennett,13,0,32,19
1657823942286,MATH 142A,B05,093559,Chow; Bennett,7,0,32,25
1657823948319,MATH 193A,A01,083224,Rotar; Vladimir,8,0,34,26
1657823948319,MATH 193A,A02,083225,Rotar; Vladimir,10,0,34,24
1657823948319,MATH 193A,A03,083781,Rotar; Vladimir,5,0,34,29
1657823948319,MATH 193A,A04,083782,Rotar; Vladimir,11,0,34,23
1657823948319,MATH 193A,A05,093482,Rotar; Vladimir,10,0,34,24
1657823954344,MATH 197,001,091859,McAuley; Julian John,9999,0,9999,0
1657823954344,MATH 197,002,095566,Kedlaya; Kiran S.,9997,0,9999,2
1657823954344,MATH 197,003,095567,Xiao; Ming,9999,0,9999,0
1657823954344,MATH 197,004,095571,Perols; Johan Lars,9998,0,9999,1
1657823961405,COGS 9,A01,083615,Shannon; Kyle Michael,9,0,75,66
1657823967432,COGS 11,A01,083617,Boyle; Mary E. T.,23,0,48,25
1657823973461,COGS 13,A01,083071,Bastos; Amalia Pinkusfeld,11,0,71,60
1657823979489,COGS 14A,A01,092681,Semenuks; Arturs,5,1,100,95
1657823985512,COGS 14B,A01,083073,Cheng; Tzu-Han,6,0,63,57
1657823991544,COGS 17,A01,092677,Semenuks; Arturs,6,0,81,75
1657823997578,COGS 100,A01,083619,Allen; Michael Gordon,17,0,70,53
1657824003612,COGS 101A,A01,083621,Davis; Joshua Daniel,9,0,68,59
1657824009635,COGS 101B,A01,091572,Allen; Michael Gordon,12,0,65,53
1657824015658,COGS 101C,A01,083625,Delgado; Tania,17,0,35,18
1657824021685,COGS 107A,A01,083627,Boyle; Mary E. T.,14,0,60,46
1657824027712,COGS 118A,A01,083075,Gupta; Anjum,21,0,76,55
1657824033736,CSE 3,A50,083646,Miranda; Gregory Joseph,24,0,50,26
1657824039762,CSE 8A,A50,083650,Miranda; Gregory Joseph,17,1,56,39
1657824045784,CSE 11,A01,083080,Cao; Yingjun,6,15,40,34
1657824051807,CSE 12,A01,083652,Krause-Levy; Sophia Louisa,28,1,120,92
1657824057838,CSE 15L,A01,083654,Morris; Justin Loren,9,0,50,41
1657824057838,CSE 15L,A02,083655,Morris; Justin Loren,9,0,50,41
1657824063867,CSE 20,A01,083657,Tran; Khoa Dang,39,0,80,41
1657824069889,CSE 21,A01,095574,Bach; Quang Tran,22,0,48,26
1657824075995,CSE 30,A01,083084,Eldon; John,6,0,80,74
1657824075995,CSE 30,B01,095061,Bhaskar; Nishant,9,0,50,41
1657824082020,CSE 100,A01,083659,Cao; Yingjun,5,4,70,65
1657824088043,CSE 134B,A01,083661,Powell; Thomas Allan,24,0,100,76
1657824094076,CSE 140,A01,083663,Gungor; Onat,15,0,85,70
1657824100106,CSE 140L,A01,083088,Eldon; John,23,0,100,77
1657824106132,CSE 175,A01,083665,Kumar; Rakesh,3,0,25,22
1657824112158,CSE 190,A00,092507,Dubnov; Shlomo,8,0,20,12
1657824118183,ECE 45,A01,083139,Congero; Spencer William,6,0,75,69
1657824124206,ECE 65,A50,083695,Saad; Andrew S,12,0,30,18
1657824124206,ECE 65,A51,095125,Saad; Andrew S,24,0,26,2
1657824130232,ECE 109,A01,091882,Touri; Behrouz,20,0,70,50
1657824136260,ECE 180,A00,083140,Abi Samra; Nicholas Camill,1,0,30,29
1657824136260,ECE 180,B00,083141,Abi Samra; Nicholas Camill,0,0,30,30
1657824142284,MATH 10A,A01,083735,Patchell; Gregory David,2,0,30,28
1657824142284,MATH 10A,A02,083736,Patchell; Gregory David,20,0,30,10
1657824142284,MATH 10A,A03,083737,Patchell; Gregory David,16,0,30,14
1657824148312,MATH 10B,A01,083207,Lim; Seonhee,8,0,34,26
1657824148312,MATH 10B,A02,083208,Lim; Seonhee,10,0,35,25
1657824148312,MATH 10B,A03,093472,Lim; Seonhee,7,0,34,27
1657824148312,MATH 10B,B01,083739,Sinha; Shubham,13,0,30,17
1657824154337,MATH 18,A01,083743,Cinel; Cameron Alexander,9,0,30,21
1657824154337,MATH 18,A02,083744,Cinel; Cameron Alexander,18,0,30,12
1657824154337,MATH 18,A03,083745,Cinel; Cameron Alexander,10,0,30,20
1657824154337,MATH 18,B01,083748,Rideout; David Porter,5,0,37,32
1657824154337,MATH 18,B02,083749,Rideout; David Porter,5,0,36,31
1657824154337,MATH 18,B03,083750,Rideout; David Porter,3,0,37,34
1657824154337,MATH 18,B04,083751,Rideout; David Porter,6,0,36,30
1657824154337,MATH 18,B05,093473,Rideout; David Porter,6,0,36,30
1657824154337,MATH 18,B06,093474,Rideout; David Porter,6,0,36,30
1657824160366,MATH 20A,A01,083754,Zheng; Zequn,14,0,40,26
1657824166390,MATH 20B,A01,083756,Briones; Jor-el Thomas Caparas,4,0,36,32
1657824166390,MATH 20B,A02,083757,Briones; Jor-el Thomas Caparas,1,0,36,35
1657824166390,MATH 20B,A03,093475,Briones; Jor-el Thomas Caparas,2,0,36,34
1657824172414,MATH 20C,A01,083760,Briones; Jor-el Thomas Caparas,1,0,35,34
1657824172414,MATH 20C,A02,083761,Briones; Jor-el Thomas Caparas,8,0,35,27
1657824172414,MATH 20C,A03,093476,Briones; Jor-el Thomas Caparas,0,1,36,36
1657824172414,MATH 20C,B01,083762,Bach; Quang Tran,1,0,30,29
1657824178438,MATH 20D,A01,083765,Tran; Brian Kha,5,0,30,25
1657824178438,MATH 20D,A02,083766,Tran; Brian Kha,5,0,30,25
1657824178438,MATH 20D,A03,083767,Tran; Brian Kha,5,0,30,25
1657824184462,MATH 20E,A01,083771,Ganguly; Soumya,10,0,32,22
1657824184462,MATH 20E,A02,083772,Ganguly; Soumya,6,0,32,26
1657824184462,MATH 20E,B01,083773,Ciotti; Benjamin,20,0,35,15
1657824184462,MATH 20E,B02,083774,Ciotti; Benjamin,18,0,35,17
1657824190501,MATH 103A,A01,083777,Greenfeld; Be'Eri,3,0,36,33
1657824190501,MATH 103A,A02,083778,Greenfeld; Be'Eri,5,0,36,31
1657824190501,MATH 103A,A03,093561,Greenfeld; Be'Eri,6,0,36,30
1657824190501,MATH 103A,B01,083779,Greenfeld; Be'Eri,7,0,36,29
1657824190501,MATH 103A,B02,083780,Greenfeld; Be'Eri,4,0,36,32
1657824190501,MATH 103A,B03,093562,Greenfeld; Be'Eri,3,0,36,33
1657824196545,MATH 105,A01,085443,Carter; Anne Toulson,15,0,35,20
1657824196545,MATH 105,A02,093477,Carter; Anne Toulson,20,0,35,15
1657824202568,MATH 109,A01,083213,Ganzberger; Geoffrey Michael,3,0,34,31
1657824202568,MATH 109,A02,083214,Ganzberger; Geoffrey Michael,4,0,34,30
1657824202568,MATH 109,A03,093478,Ganzberger; Geoffrey Michael,2,0,34,32
1657824202568,MATH 109,B01,083215,Ganzberger; Geoffrey Michael,1,0,32,31
1657824202568,MATH 109,B02,083216,Ganzberger; Geoffrey Michael,2,0,32,30
1657824202568,MATH 109,B03,093479,Ganzberger; Geoffrey Michael,8,0,32,24
1657824208600,MATH 142A,A01,083219,Chow; Bennett,7,0,32,25
1657824208600,MATH 142A,A02,083220,Chow; Bennett,10,0,32,22
1657824208600,MATH 142A,A03,093480,Chow; Bennett,9,0,32,23
1657824208600,MATH 142A,B03,093481,Chow; Bennett,8,0,32,24
1657824208600,MATH 142A,B04,093558,Chow; Bennett,13,0,32,19
1657824208600,MATH 142A,B05,093559,Chow; Bennett,7,0,32,25
1657824214626,MATH 193A,A01,083224,Rotar; Vladimir,8,0,34,26
1657824214626,MATH 193A,A02,083225,Rotar; Vladimir,10,0,34,24
1657824214626,MATH 193A,A03,083781,Rotar; Vladimir,5,0,34,29
1657824214626,MATH 193A,A04,083782,Rotar; Vladimir,11,0,34,23
1657824214626,MATH 193A,A05,093482,Rotar; Vladimir,10,0,34,24
1657824220663,MATH 197,001,091859,McAuley; Julian John,9999,0,9999,0
1657824220663,MATH 197,002,095566,Kedlaya; Kiran S.,9997,0,9999,2
1657824220663,MATH 197,003,095567,Xiao; Ming,9999,0,9999,0
1657824220663,MATH 197,004,095571,Perols; Johan Lars,9998,0,9999,1
1657824227714,COGS 9,A01,083615,Shannon; Kyle Michael,9,0,75,66
1657824233741,COGS 11,A01,083617,Boyle; Mary E. T.,23,0,48,25
1657824239766,COGS 13,A01,083071,Bastos; Amalia Pinkusfeld,11,0,71,60
1657824245802,COGS 14A,A01,092681,Semenuks; Arturs,5,1,100,95
1657824251835,COGS 14B,A01,083073,Cheng; Tzu-Han,6,0,63,57
1657824257860,COGS 17,A01,092677,Semenuks; Arturs,6,0,81,75
1657824263884,COGS 100,A01,083619,Allen; Michael Gordon,17,0,70,53
1657824269907,COGS 101A,A01,083621,Davis; Joshua Daniel,9,0,68,59
1657824275933,COGS 101B,A01,091572,Allen; Michael Gordon,12,0,65,53
1657824281968,COGS 101C,A01,083625,Delgado; Tania,17,0,35,18
1657824287993,COGS 107A,A01,083627,Boyle; Mary E. T.,14,0,60,46
1657824294022,COGS 118A,A01,083075,Gupta; Anjum,21,0,76,55
1657824300047,CSE 3,A50,083646,Miranda; Gregory Joseph,24,0,50,26
1657824306073,CSE 8A,A50,083650,Miranda; Gregory Joseph,17,1,56,39
1657824312113,CSE 11,A01,083080,Cao; Yingjun,6,15,40,34
1657824318141,CSE 12,A01,083652,Krause-Levy; Sophia Louisa,28,1,120,92
1657824324183,CSE 15L,A01,083654,Morris; Justin Loren,9,0,50,41
1657824324183,CSE 15L,A02,083655,Morris; Justin Loren,9,0,50,41
1657824330206,CSE 20,A01,083657,Tran; Khoa Dang,39,0,80,41
1657824336229,CSE 21,A01,095574,Bach; Quang Tran,22,0,48,26
1657824342255,CSE 30,A01,083084,Eldon; John,6,0,80,74
1657824342255,CSE 30,B01,095061,Bhaskar; Nishant,9,0,50,41
1657824348284,CSE 100,A01,083659,Cao; Yingjun,5,4,70,65
1657824354318,CSE 134B,A01,083661,Powell; Thomas Allan,24,0,100,76
1657824360349,CSE 140,A01,083663,Gungor; Onat,15,0,85,70
1657824366373,CSE 140L,A01,083088,Eldon; John,23,0,100,77
1657824372404,CSE 175,A01,083665,Kumar; Rakesh,3,0,25,22
1657824378441,CSE 190,A00,092507,Dubnov; Shlomo,8,0,20,12
1657824384464,ECE 45,A01,083139,Congero; Spencer William,6,0,75,69
1657824390500,ECE 65,A50,083695,Saad; Andrew S,12,0,30,18
1657824390500,ECE 65,A51,095125,Saad; Andrew S,24,0,26,2
1657824396530,ECE 109,A01,091882,Touri; Behrouz,20,0,70,50
1657824402562,ECE 180,A00,083140,Abi Samra; Nicholas Camill,1,0,30,29
1657824402562,ECE 180,B00,083141,Abi Samra; Nicholas Camill,0,0,30,30
1657824408586,MATH 10A,A01,083735,Patchell; Gregory David,2,0,30,28
1657824408586,MATH 10A,A02,083736,Patchell; Gregory David,20,0,30,10
1657824408586,MATH 10A,A03,083737,Patchell; Gregory David,16,0,30,14
1657824414616,MATH 10B,A01,083207,Lim; Seonhee,8,0,34,26
1657824414616,MATH 10B,A02,083208,Lim; Seonhee,10,0,35,25
1657824414616,MATH 10B,A03,093472,Lim; Seonhee,7,0,34,27
1657824414616,MATH 10B,B01,083739,Sinha; Shubham,13,0,30,17
1657824420646,MATH 18,A01,083743,Cinel; Cameron Alexander,9,0,30,21
1657824420646,MATH 18,A02,083744,Cinel; Cameron Alexander,18,0,30,12
1657824420646,MATH 18,A03,083745,Cinel; Cameron Alexander,10,0,30,20
1657824420646,MATH 18,B01,083748,Rideout; David Porter,5,0,37,32
1657824420646,MATH 18,B02,083749,Rideout; David Porter,5,0,36,31
1657824420646,MATH 18,B03,083750,Rideout; David Porter,3,0,37,34
1657824420646,MATH 18,B04,083751,Rideout; David Porter,6,0,36,30
1657824420646,MATH 18,B05,093473,Rideout; David Porter,6,0,36,30
1657824420646,MATH 18,B06,093474,Rideout; David Porter,6,0,36,30
1657824426676,MATH 20A,A01,083754,Zheng; Zequn,14,0,40,26
1657824432711,MATH 20B,A01,083756,Briones; Jor-el Thomas Caparas,4,0,36,32
1657824432711,MATH 20B,A02,083757,Briones; Jor-el Thomas Caparas,1,0,36,35
1657824432711,MATH 20B,A03,093475,Briones; Jor-el Thomas Caparas,2,0,36,34
1657824438740,MATH 20C,A01,083760,Briones; Jor-el Thomas Caparas,1,0,35,34
1657824438740,MATH 20C,A02,083761,Briones; Jor-el Thomas Caparas,8,0,35,27
1657824438740,MATH 20C,A03,093476,Briones; Jor-el Thomas Caparas,0,1,36,36
1657824438740,MATH 20C,B01,083762,Bach; Quang Tran,1,0,30,29
1657824444765,MATH 20D,A01,083765,Tran; Brian Kha,5,0,30,25
1657824444765,MATH 20D,A02,083766,Tran; Brian Kha,5,0,30,25
1657824444765,MATH 20D,A03,083767,Tran; Brian Kha,5,0,30,25
1657824450798,MATH 20E,A01,083771,Ganguly; Soumya,10,0,32,22
1657824450798,MATH 20E,A02,083772,Ganguly; Soumya,6,0,32,26
1657824450798,MATH 20E,B01,083773,Ciotti; Benjamin,20,0,35,15
1657824450798,MATH 20E,B02,083774,Ciotti; Benjamin,18,0,35,17
1657824456831,MATH 103A,A01,083777,Greenfeld; Be'Eri,3,0,36,33
1657824456831,MATH 103A,A02,083778,Greenfeld; Be'Eri,5,0,36,31
1657824456831,MATH 103A,A03,093561,Greenfeld; Be'Eri,6,0,36,30
1657824456831,MATH 103A,B01,083779,Greenfeld; Be'Eri,7,0,36,29
1657824456831,MATH 103A,B02,083780,Greenfeld; Be'Eri,4,0,36,32
1657824456831,MATH 103A,B03,093562,Greenfeld; Be'Eri,3,0,36,33
1657824462859,MATH 105,A01,085443,Carter; Anne Toulson,15,0,35,20
1657824462859,MATH 105,A02,093477,Carter; Anne Toulson,20,0,35,15
1657824468888,MATH 109,A01,083213,Ganzberger; Geoffrey Michael,3,0,34,31
1657824468888,MATH 109,A02,083214,Ganzberger; Geoffrey Michael,4,0,34,30
1657824468888,MATH 109,A03,093478,Ganzberger; Geoffrey Michael,2,0,34,32
1657824468888,MATH 109,B01,083215,Ganzberger; Geoffrey Michael,1,0,32,31
1657824468888,MATH 109,B02,083216,Ganzberger; Geoffrey Michael,2,0,32,30
1657824468888,MATH 109,B03,093479,Ganzberger; Geoffrey Michael,8,0,32,24
1657824474912,MATH 142A,A01,083219,Chow; Bennett,7,0,32,25
1657824474912,MATH 142A,A02,083220,Chow; Bennett,10,0,32,22
1657824474912,MATH 142A,A03,093480,Chow; Bennett,9,0,32,23
1657824474912,MATH 142A,B03,093481,Chow; Bennett,8,0,32,24
1657824474912,MATH 142A,B04,093558,Chow; Bennett,13,0,32,19
1657824474912,MATH 142A,B05,093559,Chow; Bennett,7,0,32,25
1657824480935,MATH 193A,A01,083224,Rotar; Vladimir,8,0,34,26
1657824480935,MATH 193A,A02,083225,Rotar; Vladimir,10,0,34,24
1657824480935,MATH 193A,A03,083781,Rotar; Vladimir,5,0,34,29
1657824480935,MATH 193A,A04,083782,Rotar; Vladimir,11,0,34,23
1657824480935,MATH 193A,A05,093482,Rotar; Vladimir,10,0,34,24
1657824486969,MATH 197,001,091859,McAuley; Julian John,9999,0,9999,0
1657824486969,MATH 197,002,095566,Kedlaya; Kiran S.,9997,0,9999,2
1657824486969,MATH 197,003,095567,Xiao; Ming,9999,0,9999,0
1657824486969,MATH 197,004,095571,Perols; Johan Lars,9998,0,9999,1
1657824494041,COGS 9,A01,083615,Shannon; Kyle Michael,9,0,75,66
1657824500066,COGS 11,A01,083617,Boyle; Mary E. T.,23,0,48,25
1657824506091,COGS 13,A01,083071,Bastos; Amalia Pinkusfeld,11,0,71,60
1657824512117,COGS 14A,A01,092681,Semenuks; Arturs,5,1,100,95
1657824518140,COGS 14B,A01,083073,Cheng; Tzu-Han,6,0,63,57
1657824524165,COGS 17,A01,092677,Semenuks; Arturs,6,0,81,75
1657824530189,COGS 100,A01,083619,Allen; Michael Gordon,17,0,70,53
1657824536220,COGS 101A,A01,083621,Davis; Joshua Daniel,9,0,68,59
1657824542245,COGS 101B,A01,091572,Allen; Michael Gordon,12,0,65,53
1657824548280,COGS 101C,A01,083625,Delgado; Tania,17,0,35,18
1657824554306,COGS 107A,A01,083627,Boyle; Mary E. T.,14,0,60,46
1657824560332,COGS 118A,A01,083075,Gupta; Anjum,21,0,76,55
1657824566361,CSE 3,A50,083646,Miranda; Gregory Joseph,24,0,50,26
1657824572385,CSE 8A,A50,083650,Miranda; Gregory Joseph,17,1,56,39
1657824578408,CSE 11,A01,083080,Cao; Yingjun,6,15,40,34
1657824584434,CSE 12,A01,083652,Krause-Levy; Sophia Louisa,28,1,120,92
1657824590464,CSE 15L,A01,083654,Morris; Justin Loren,9,0,50,41
1657824590464,CSE 15L,A02,083655,Morris; Justin Loren,9,0,50,41
1657824596489,CSE 20,A01,083657,Tran; Khoa Dang,39,0,80,41
1657824602516,CSE 21,A01,095574,Bach; Quang Tran,22,0,48,26
1657824608545,CSE 30,A01,083084,Eldon; John,6,0,80,74
1657824608545,CSE 30,B01,095061,Bhaskar; Nishant,9,0,50,41
1657824614576,CSE 100,A01,083659,Cao; Yingjun,5,4,70,65
1657824620599,CSE 134B,A01,083661,Powell; Thomas Allan,24,0,100,76
1657824626622,CSE 140,A01,083663,Gungor; Onat,15,0,85,70
1657824632646,CSE 140L,A01,083088,Eldon; John,23,0,100,77
1657824638672,CSE 175,A01,083665,Kumar; Rakesh,3,0,25,22
1657824644698,CSE 190,A00,092507,Dubnov; Shlomo,8,0,20,12
1657824650725,ECE 45,A01,083139,Congero; Spencer William,6,0,75,69
1657824656766,ECE 65,A50,083695,Saad; Andrew S,12,0,30,18
1657824656766,ECE 65,A51,095125,Saad; Andrew S,24,0,26,2
1657824662789,ECE 109,A01,091882,Touri; Behrouz,20,0,70,50
1657824668811,ECE 180,A00,083140,Abi Samra; Nicholas Camill,1,0,30,29
1657824668811,ECE 180,B00,083141,Abi Samra; Nicholas Camill,0,0,30,30
1657824674915,MATH 10A,A01,083735,Patchell; Gregory David,2,0,30,28
1657824674915,MATH 10A,A02,083736,Patchell; Gregory David,20,0,30,10
1657824674915,MATH 10A,A03,083737,Patchell; Gregory David,16,0,30,14
1657824680938,MATH 10B,A01,083207,Lim; Seonhee,8,0,34,26
1657824680938,MATH 10B,A02,083208,Lim; Seonhee,10,0,35,25
1657824680938,MATH 10B,A03,093472,Lim; Seonhee,7,0,34,27
1657824680938,MATH 10B,B01,083739,Sinha; Shubham,13,0,30,17
1657824686962,MATH 18,A01,083743,Cinel; Cameron Alexander,9,0,30,21
1657824686962,MATH 18,A02,083744,Cinel; Cameron Alexander,18,0,30,12
1657824686962,MATH 18,A03,083745,Cinel; Cameron Alexander,10,0,30,20
1657824686962,MATH 18,B01,083748,Rideout; David Porter,5,0,37,32
1657824686962,MATH 18,B02,083749,Rideout; David Porter,5,0,36,31
1657824686962,MATH 18,B03,083750,Rideout; David Porter,3,0,37,34
1657824686962,MATH 18,B04,083751,Rideout; David Porter,6,0,36,30
1657824686962,MATH 18,B05,093473,Rideout; David Porter,6,0,36,30
1657824686962,MATH 18,B06,093474,Rideout; David Porter,6,0,36,30
1657824692988,MATH 20A,A01,083754,Zheng; Zequn,14,0,40,26
1657824699010,MATH 20B,A01,083756,Briones; Jor-el Thomas Caparas,4,0,36,32
1657824699010,MATH 20B,A02,083757,Briones; Jor-el Thomas Caparas,1,0,36,35
1657824699010,MATH 20B,A03,093475,Briones; Jor-el Thomas Caparas,2,0,36,34
1657824705033,MATH 20C,A01,083760,Briones; Jor-el Thomas Caparas,1,0,35,34
1657824705033,MATH 20C,A02,083761,Briones; Jor-el Thomas Caparas,8,0,35,27
1657824705033,MATH 20C,A03,093476,Briones; Jor-el Thomas Caparas,0,1,36,36
1657824705033,MATH 20C,B01,083762,Bach; Quang Tran,1,0,30,29
1657824711055,MATH 20D,A01,083765,Tran; Brian Kha,5,0,30,25
1657824711055,MATH 20D,A02,083766,Tran; Brian Kha,5,0,30,25
1657824711055,MATH 20D,A03,083767,Tran; Brian Kha,5,0,30,25
1657824717092,MATH 20E,A01,083771,Ganguly; Soumya,10,0,32,22
1657824717092,MATH 20E,A02,083772,Ganguly; Soumya,6,0,32,26
1657824717092,MATH 20E,B01,083773,Ciotti; Benjamin,20,0,35,15
1657824717092,MATH 20E,B02,083774,Ciotti; Benjamin,18,0,35,17
1657824723121,MATH 103A,A01,083777,Greenfeld; Be'Eri,3,0,36,33
1657824723121,MATH 103A,A02,083778,Greenfeld; Be'Eri,5,0,36,31
1657824723121,MATH 103A,A03,093561,Greenfeld; Be'Eri,6,0,36,30
1657824723121,MATH 103A,B01,083779,Greenfeld; Be'Eri,7,0,36,29
1657824723121,MATH 103A,B02,083780,Greenfeld; Be'Eri,4,0,36,32
1657824723121,MATH 103A,B03,093562,Greenfeld; Be'Eri,3,0,36,33
1657824729149,MATH 105,A01,085443,Carter; Anne Toulson,15,0,35,20
1657824729149,MATH 105,A02,093477,Carter; Anne Toulson,20,0,35,15
1657824735179,MATH 109,A01,083213,Ganzberger; Geoffrey Michael,3,0,34,31
1657824735179,MATH 109,A02,083214,Ganzberger; Geoffrey Michael,4,0,34,30
1657824735179,MATH 109,A03,093478,Ganzberger; Geoffrey Michael,2,0,34,32
1657824735179,MATH 109,B01,083215,Ganzberger; Geoffrey Michael,1,0,32,31
1657824735179,MATH 109,B02,083216,Ganzberger; Geoffrey Michael,2,0,32,30
1657824735179,MATH 109,B03,093479,Ganzberger; Geoffrey Michael,8,0,32,24
1657824741217,MATH 142A,A01,083219,Chow; Bennett,7,0,32,25
1657824741217,MATH 142A,A02,083220,Chow; Bennett,10,0,32,22
1657824741217,MATH 142A,A03,093480,Chow; Bennett,9,0,32,23
1657824741217,MATH 142A,B03,093481,Chow; Bennett,8,0,32,24
1657824741217,MATH 142A,B04,093558,Chow; Bennett,13,0,32,19
1657824741217,MATH 142A,B05,093559,Chow; Bennett,7,0,32,25
1657824747241,MATH 193A,A01,083224,Rotar; Vladimir,8,0,34,26
1657824747241,MATH 193A,A02,083225,Rotar; Vladimir,10,0,34,24
1657824747241,MATH 193A,A03,083781,Rotar; Vladimir,5,0,34,29
1657824747241,MATH 193A,A04,083782,Rotar; Vladimir,11,0,34,23
1657824747241,MATH 193A,A05,093482,Rotar; Vladimir,10,0,34,24
1657824753273,MATH 197,001,091859,McAuley; Julian John,9999,0,9999,0
1657824753273,MATH 197,002,095566,Kedlaya; Kiran S.,9997,0,9999,2
1657824753273,MATH 197,003,095567,Xiao; Ming,9999,0,9999,0
1657824753273,MATH 197,004,095571,Perols; Johan Lars,9998,0,9999,1
1657824760336,COGS 9,A01,083615,Shannon; Kyle Michael,9,0,75,66
1657824766360,COGS 11,A01,083617,Boyle; Mary E. T.,23,0,48,25
1657824772384,COGS 13,A01,083071,Bastos; Amalia Pinkusfeld,11,0,71,60
1657824778453,COGS 14A,A01,092681,Semenuks; Arturs,5,1,100,95
1657824784479,COGS 14B,A01,083073,Cheng; Tzu-Han,6,0,63,57
1657824790507,COGS 17,A01,092677,Semenuks; Arturs,6,0,81,75
1657824796539,COGS 100,A01,083619,Allen; Michael Gordon,17,0,70,53
1657824802562,COGS 101A,A01,083621,Davis; Joshua Daniel,9,0,68,59
1657824808589,COGS 101B,A01,091572,Allen; Michael Gordon,12,0,65,53
1657824814620,COGS 101C,A01,083625,Delgado; Tania,17,0,35,18
1657824820644,COGS 107A,A01,083627,Boyle; Mary E. T.,14,0,60,46
1657824826669,COGS 118A,A01,083075,Gupta; Anjum,21,0,76,55
1657824832696,CSE 3,A50,083646,Miranda; Gregory Joseph,24,0,50,26
1657824838727,CSE 8A,A50,083650,Miranda; Gregory Joseph,17,1,56,39
1657824844753,CSE 11,A01,083080,Cao; Yingjun,6,15,40,34
1657824850783,CSE 12,A01,083652,Krause-Levy; Sophia Louisa,28,1,120,92
1657824856809,CSE 15L,A01,083654,Morris; Justin Loren,9,0,50,41
1657824856809,CSE 15L,A02,083655,Morris; Justin Loren,9,0,50,41
1657824862835,CSE 20,A01,083657,Tran; Khoa Dang,39,0,80,41
1657824868864,CSE 21,A01,095574,Bach; Quang Tran,22,0,48,26
1657824874887,CSE 30,A01,083084,Eldon; John,6,0,80,74
1657824874887,CSE 30,B01,095061,Bhaskar; Nishant,9,0,50,41
1657824880908,CSE 100,A01,083659,Cao; Yingjun,5,4,70,65
1657824886934,CSE 134B,A01,083661,Powell; Thomas Allan,24,0,100,76
1657824892960,CSE 140,A01,083663,Gungor; Onat,15,0,85,70
1657824898983,CSE 140L,A01,083088,Eldon; John,23,0,100,77
1657824905006,CSE 175,A01,083665,Kumar; Rakesh,3,0,25,22
1657824911031,CSE 190,A00,092507,Dubnov; Shlomo,8,0,20,12
1657824917056,ECE 45,A01,083139,Congero; Spencer William,6,0,75,69
1657824923082,ECE 65,A50,083695,Saad; Andrew S,12,0,30,18
1657824923082,ECE 65,A51,095125,Saad; Andrew S,24,0,26,2
1657824929107,ECE 109,A01,091882,Touri; Behrouz,20,0,70,50
1657824935129,ECE 180,A00,083140,Abi Samra; Nicholas Camill,1,0,30,29
1657824935129,ECE 180,B00,083141,Abi Samra; Nicholas Camill,0,0,30,30
1657824941171,MATH 10A,A01,083735,Patchell; Gregory David,2,0,30,28
1657824941171,MATH 10A,A02,083736,Patchell; Gregory David,20,0,30,10
1657824941171,MATH 10A,A03,083737,Patchell; Gregory David,16,0,30,14
1657824947193,MATH 10B,A01,083207,Lim; Seonhee,8,0,34,26
1657824947193,MATH 10B,A02,083208,Lim; Seonhee,10,0,35,25
1657824947193,MATH 10B,A03,093472,Lim; Seonhee,7,0,34,27
1657824947193,MATH 10B,B01,083739,Sinha; Shubham,13,0,30,17
1657824953222,MATH 18,A01,083743,Cinel; Cameron Alexander,9,0,30,21
1657824953222,MATH 18,A02,083744,Cinel; Cameron Alexander,18,0,30,12
1657824953222,MATH 18,A03,083745,Cinel; Cameron Alexander,10,0,30,20
1657824953222,MATH 18,B01,083748,Rideout; David Porter,5,0,37,32
1657824953222,MATH 18,B02,083749,Rideout; David Porter,5,0,36,31
1657824953222,MATH 18,B03,083750,Rideout; David Porter,3,0,37,34
1657824953222,MATH 18,B04,083751,Rideout; David Porter,6,0,36,30
1657824953222,MATH 18,B05,093473,Rideout; David Porter,6,0,36,30
1657824953222,MATH 18,B06,093474,Rideout; David Porter,6,0,36,30
1657824959248,MATH 20A,A01,083754,Zheng; Zequn,14,0,40,26
1657824965274,MATH 20B,A01,083756,Briones; Jor-el Thomas Caparas,4,0,36,32
1657824965274,MATH 20B,A02,083757,Briones; Jor-el Thomas Caparas,1,0,36,35
1657824965274,MATH 20B,A03,093475,Briones; Jor-el Thomas Caparas,2,0,36,34
1657824971303,MATH 20C,A01,083760,Briones; Jor-el Thomas Caparas,1,0,35,34
1657824971303,MATH 20C,A02,083761,Briones; Jor-el Thomas Caparas,8,0,35,27
1657824971303,MATH 20C,A03,093476,Briones; Jor-el Thomas Caparas,0,1,36,36
1657824971303,MATH 20C,B01,083762,Bach; Quang Tran,1,0,30,29
1657824977333,MATH 20D,A01,083765,Tran; Brian Kha,5,0,30,25
1657824977333,MATH 20D,A02,083766,Tran; Brian Kha,5,0,30,25
1657824977333,MATH 20D,A03,083767,Tran; Brian Kha,5,0,30,25
1657824983366,MATH 20E,A01,083771,Ganguly; Soumya,10,0,32,22
1657824983366,MATH 20E,A02,083772,Ganguly; Soumya,6,0,32,26
1657824983366,MATH 20E,B01,083773,Ciotti; Benjamin,20,0,35,15
1657824983366,MATH 20E,B02,083774,Ciotti; Benjamin,18,0,35,17
1657824989395,MATH 103A,A01,083777,Greenfeld; Be'Eri,3,0,36,33
1657824989395,MATH 103A,A02,083778,Greenfeld; Be'Eri,5,0,36,31
1657824989395,MATH 103A,A03,093561,Greenfeld; Be'Eri,6,0,36,30
1657824989395,MATH 103A,B01,083779,Greenfeld; Be'Eri,7,0,36,29
1657824989395,MATH 103A,B02,083780,Greenfeld; Be'Eri,4,0,36,32
1657824989395,MATH 103A,B03,093562,Greenfeld; Be'Eri,3,0,36,33
1657824995428,MATH 105,A01,085443,Carter; Anne Toulson,15,0,35,20
1657824995428,MATH 105,A02,093477,Carter; Anne Toulson,20,0,35,15
1657825001450,MATH 109,A01,083213,Ganzberger; Geoffrey Michael,3,0,34,31
1657825001450,MATH 109,A02,083214,Ganzberger; Geoffrey Michael,4,0,34,30
1657825001450,MATH 109,A03,093478,Ganzberger; Geoffrey Michael,2,0,34,32
1657825001450,MATH 109,B01,083215,Ganzberger; Geoffrey Michael,1,0,32,31
1657825001450,MATH 109,B02,083216,Ganzberger; Geoffrey Michael,2,0,32,30
1657825001450,MATH 109,B03,093479,Ganzberger; Geoffrey Michael,8,0,32,24
1657825007479,MATH 142A,A01,083219,Chow; Bennett,7,0,32,25
1657825007479,MATH 142A,A02,083220,Chow; Bennett,10,0,32,22
1657825007479,MATH 142A,A03,093480,Chow; Bennett,9,0,32,23
1657825007479,MATH 142A,B03,093481,Chow; Bennett,8,0,32,24
1657825007479,MATH 142A,B04,093558,Chow; Bennett,13,0,32,19
1657825007479,MATH 142A,B05,093559,Chow; Bennett,7,0,32,25
1657825013502,MATH 193A,A01,083224,Rotar; Vladimir,8,0,34,26
1657825013502,MATH 193A,A02,083225,Rotar; Vladimir,10,0,34,24
1657825013502,MATH 193A,A03,083781,Rotar; Vladimir,5,0,34,29
1657825013502,MATH 193A,A04,083782,Rotar; Vladimir,11,0,34,23
1657825013502,MATH 193A,A05,093482,Rotar; Vladimir,10,0,34,24
1657825019528,MATH 197,001,091859,McAuley; Julian John,9999,0,9999,0
1657825019528,MATH 197,002,095566,Kedlaya; Kiran S.,9997,0,9999,2
1657825019528,MATH 197,003,095567,Xiao; Ming,9999,0,9999,0
1657825019528,MATH 197,004,095571,Perols; Johan Lars,9998,0,9999,1
1657825026585,COGS 9,A01,083615,Shannon; Kyle Michael,9,0,75,66
1657825032611,COGS 11,A01,083617,Boyle; Mary E. T.,23,0,48,25
1657825038642,COGS 13,A01,083071,Bastos; Amalia Pinkusfeld,11,0,71,60
1657825044664,COGS 14A,A01,092681,Semenuks; Arturs,5,1,100,95
1657825050691,COGS 14B,A01,083073,Cheng; Tzu-Han,6,0,63,57
1657825056716,COGS 17,A01,092677,Semenuks; Arturs,6,0,81,75
1657825062743,COGS 100,A01,083619,Allen; Michael Gordon,17,0,70,53
1657825068769,COGS 101A,A01,083621,Davis; Joshua Daniel,9,0,68,59
1657825074793,COGS 101B,A01,091572,Allen; Michael Gordon,12,0,65,53
1657825080818,COGS 101C,A01,083625,Delgado; Tania,17,0,35,18
1657825086852,COGS 107A,A01,083627,Boyle; Mary E. T.,14,0,60,46
1657825092875,COGS 118A,A01,083075,Gupta; Anjum,21,0,76,55
1657825098903,CSE 3,A50,083646,Miranda; Gregory Joseph,24,0,50,26
1657825104931,CSE 8A,A50,083650,Miranda; Gregory Joseph,17,1,56,39
1657825110952,CSE 11,A01,083080,Cao; Yingjun,6,15,40,34
1657825116976,CSE 12,A01,083652,Krause-Levy; Sophia Louisa,28,1,120,92
1657825123002,CSE 15L,A01,083654,Morris; Justin Loren,9,0,50,41
1657825123002,CSE 15L,A02,083655,Morris; Justin Loren,9,0,50,41
1657825129037,CSE 20,A01,083657,Tran; Khoa Dang,39,0,80,41
1657825135066,CSE 21,A01,095574,Bach; Quang Tran,22,0,48,26
1657825141088,CSE 30,A01,083084,Eldon; John,6,0,80,74
1657825141088,CSE 30,B01,095061,Bhaskar; Nishant,9,0,50,41
1657825147110,CSE 100,A01,083659,Cao; Yingjun,5,4,70,65
1657825153141,CSE 134B,A01,083661,Powell; Thomas Allan,24,0,100,76
1657825159171,CSE 140,A01,083663,Gungor; Onat,15,0,85,70
1657825165195,CSE 140L,A01,083088,Eldon; John,23,0,100,77
1657825171220,CSE 175,A01,083665,Kumar; Rakesh,3,0,25,22
1657825177246,CSE 190,A00,092507,Dubnov; Shlomo,8,0,20,12
1657825183269,ECE 45,A01,083139,Congero; Spencer William,6,0,75,69
1657825189294,ECE 65,A50,083695,Saad; Andrew S,12,0,30,18
1657825189294,ECE 65,A51,095125,Saad; Andrew S,24,0,26,2
1657825195318,ECE 109,A01,091882,Touri; Behrouz,20,0,70,50
1657825201363,ECE 180,A00,083140,Abi Samra; Nicholas Camill,1,0,30,29
1657825201363,ECE 180,B00,083141,Abi Samra; Nicholas Camill,0,0,30,30
1657825207394,MATH 10A,A01,083735,Patchell; Gregory David,2,0,30,28
1657825207394,MATH 10A,A02,083736,Patchell; Gregory David,20,0,30,10
1657825207394,MATH 10A,A03,083737,Patchell; Gregory David,16,0,30,14
1657825213432,MATH 10B,A01,083207,Lim; Seonhee,8,0,34,26
1657825213432,MATH 10B,A02,083208,Lim; Seonhee,10,0,35,25
1657825213432,MATH 10B,A03,093472,Lim; Seonhee,7,0,34,27
1657825213432,MATH 10B,B01,083739,Sinha; Shubham,13,0,30,17
1657825219474,MATH 18,A01,083743,Cinel; Cameron Alexander,9,0,30,21
1657825219474,MATH 18,A02,083744,Cinel; Cameron Alexander,18,0,30,12
1657825219474,MATH 18,A03,083745,Cinel; Cameron Alexander,10,0,30,20
1657825219474,MATH 18,B01,083748,Rideout; David Porter,5,0,37,32
1657825219474,MATH 18,B02,083749,Rideout; David Porter,5,0,36,31
1657825219474,MATH 18,B03,083750,Rideout; David Porter,3,0,37,34
1657825219474,MATH 18,B04,083751,Rideout; David Porter,6,0,36,30
1657825219474,MATH 18,B05,093473,Rideout; David Porter,6,0,36,30
1657825219474,MATH 18,B06,093474,Rideout; David Porter,6,0,36,30
1657825225500,MATH 20A,A01,083754,Zheng; Zequn,14,0,40,26
1657825231522,MATH 20B,A01,083756,Briones; Jor-el Thomas Caparas,4,0,36,32
1657825231522,MATH 20B,A02,083757,Briones; Jor-el Thomas Caparas,1,0,36,35
1657825231522,MATH 20B,A03,093475,Briones; Jor-el Thomas Caparas,2,0,36,34
1657825237551,MATH 20C,A01,083760,Briones; Jor-el Thomas Caparas,1,0,35,34
1657825237551,MATH 20C,A02,083761,Briones; Jor-el Thomas Caparas,8,0,35,27
1657825237551,MATH 20C,A03,093476,Briones; Jor-el Thomas Caparas,0,1,36,36
1657825237551,MATH 20C,B01,083762,Bach; Quang Tran,1,0,30,29
1657825243589,MATH 20D,A01,083765,Tran; Brian Kha,5,0,30,25
1657825243589,MATH 20D,A02,083766,Tran; Brian Kha,5,0,30,25
1657825243589,MATH 20D,A03,083767,Tran; Brian Kha,5,0,30,25
1657825249615,MATH 20E,A01,083771,Ganguly; Soumya,10,0,32,22
1657825249615,MATH 20E,A02,083772,Ganguly; Soumya,6,0,32,26
1657825249615,MATH 20E,B01,083773,Ciotti; Benjamin,20,0,35,15
1657825249615,MATH 20E,B02,083774,Ciotti; Benjamin,18,0,35,17
1657825255642,MATH 103A,A01,083777,Greenfeld; Be'Eri,3,0,36,33
1657825255642,MATH 103A,A02,083778,Greenfeld; Be'Eri,5,0,36,31
1657825255642,MATH 103A,A03,093561,Greenfeld; Be'Eri,6,0,36,30
1657825255642,MATH 103A,B01,083779,Greenfeld; Be'Eri,7,0,36,29
1657825255642,MATH 103A,B02,083780,Greenfeld; Be'Eri,4,0,36,32
1657825255642,MATH 103A,B03,093562,Greenfeld; Be'Eri,3,0,36,33
1657825261670,MATH 105,A01,085443,Carter; Anne Toulson,15,0,35,20
1657825261670,MATH 105,A02,093477,Carter; Anne Toulson,20,0,35,15
1657825267695,MATH 109,A01,083213,Ganzberger; Geoffrey Michael,3,0,34,31
1657825267695,MATH 109,A02,083214,Ganzberger; Geoffrey Michael,4,0,34,30
1657825267695,MATH 109,A03,093478,Ganzberger; Geoffrey Michael,2,0,34,32
1657825267695,MATH 109,B01,083215,Ganzberger; Geoffrey Michael,1,0,32,31
1657825267695,MATH 109,B02,083216,Ganzberger; Geoffrey Michael,2,0,32,30
1657825267695,MATH 109,B03,093479,Ganzberger; Geoffrey Michael,8,0,32,24
1657825273798,MATH 142A,A01,083219,Chow; Bennett,7,0,32,25
1657825273798,MATH 142A,A02,083220,Chow; Bennett,10,0,32,22
1657825273798,MATH 142A,A03,093480,Chow; Bennett,9,0,32,23
1657825273798,MATH 142A,B03,093481,Chow; Bennett,8,0,32,24
1657825273798,MATH 142A,B04,093558,Chow; Bennett,13,0,32,19
1657825273798,MATH 142A,B05,093559,Chow; Bennett,7,0,32,25
1657825279828,MATH 193A,A01,083224,Rotar; Vladimir,8,0,34,26
1657825279828,MATH 193A,A02,083225,Rotar; Vladimir,10,0,34,24
1657825279828,MATH 193A,A03,083781,Rotar; Vladimir,5,0,34,29
1657825279828,MATH 193A,A04,083782,Rotar; Vladimir,11,0,34,23
1657825279828,MATH 193A,A05,093482,Rotar; Vladimir,10,0,34,24
1657825285856,MATH 197,001,091859,McAuley; Julian John,9999,0,9999,0
1657825285856,MATH 197,002,095566,Kedlaya; Kiran S.,9997,0,9999,2
1657825285856,MATH 197,003,095567,Xiao; Ming,9999,0,9999,0
1657825285856,MATH 197,004,095571,Perols; Johan Lars,9998,0,9999,1
1657825292911,COGS 9,A01,083615,Shannon; Kyle Michael,9,0,75,66
1657825298939,COGS 11,A01,083617,Boyle; Mary E. T.,23,0,48,25
1657825304966,COGS 13,A01,083071,Bastos; Amalia Pinkusfeld,11,0,71,60
1657825310990,COGS 14A,A01,092681,Semenuks; Arturs,5,1,100,95
1657825317016,COGS 14B,A01,083073,Cheng; Tzu-Han,6,0,63,57
1657825323038,COGS 17,A01,092677,Semenuks; Arturs,6,0,81,75
1657825329063,COGS 100,A01,083619,Allen; Michael Gordon,17,0,70,53
1657825335085,COGS 101A,A01,083621,Davis; Joshua Daniel,9,0,68,59
1657825341108,COGS 101B,A01,091572,Allen; Michael Gordon,12,0,65,53
1657825347140,COGS 101C,A01,083625,Delgado; Tania,17,0,35,18
1657825353164,COGS 107A,A01,083627,Boyle; Mary E. T.,14,0,60,46
1657825359189,COGS 118A,A01,083075,Gupta; Anjum,21,0,76,55
1657825365212,CSE 3,A50,083646,Miranda; Gregory Joseph,24,0,50,26
1657825371242,CSE 8A,A50,083650,Miranda; Gregory Joseph,17,1,56,39
1657825377268,CSE 11,A01,083080,Cao; Yingjun,6,15,40,34
1657825383290,CSE 12,A01,083652,Krause-Levy; Sophia Louisa,28,1,120,92
1657825389319,CSE 15L,A01,083654,Morris; Justin Loren,9,0,50,41
1657825389319,CSE 15L,A02,083655,Morris; Justin Loren,9,0,50,41
1657825395341,CSE 20,A01,083657,Tran; Khoa Dang,39,0,80,41
1657825401363,CSE 21,A01,095574,Bach; Quang Tran,22,0,48,26
1657825407393,CSE 30,A01,083084,Eldon; John,6,0,80,74
1657825407393,CSE 30,B01,095061,Bhaskar; Nishant,9,0,50,41
1657825413415,CSE 100,A01,083659,Cao; Yingjun,5,4,70,65
1657825419438,CSE 134B,A01,083661,Powell; Thomas Allan,24,0,100,76
1657825425462,CSE 140,A01,083663,Gungor; Onat,15,0,85,70
1657825431489,CSE 140L,A01,083088,Eldon; John,23,0,100,77
1657825437513,CSE 175,A01,083665,Kumar; Rakesh,3,0,25,22
1657825443544,CSE 190,A00,092507,Dubnov; Shlomo,8,0,20,12
1657825449571,ECE 45,A01,083139,Congero; Spencer William,6,0,75,69
1657825455599,ECE 65,A50,083695,Saad; Andrew S,12,0,30,18
1657825455599,ECE 65,A51,095125,Saad; Andrew S,24,0,26,2
1657825461626,ECE 109,A01,091882,Touri; Behrouz,20,0,70,50
1657825467653,ECE 180,A00,083140,Abi Samra; Nicholas Camill,1,0,30,29
1657825467653,ECE 180,B00,083141,Abi Samra; Nicholas Camill,0,0,30,30
1657825473680,MATH 10A,A01,083735,Patchell; Gregory David,2,0,30,28
1657825473680,MATH 10A,A02,083736,Patchell; Gregory David,20,0,30,10
1657825473680,MATH 10A,A03,083737,Patchell; Gregory David,16,0,30,14
1657825479705,MATH 10B,A01,083207,Lim; Seonhee,8,0,34,26
1657825479705,MATH 10B,A02,083208,Lim; Seonhee,10,0,35,25
1657825479705,MATH 10B,A03,093472,Lim; Seonhee,7,0,34,27
1657825479705,MATH 10B,B01,083739,Sinha; Shubham,13,0,30,17
1657825485731,MATH 18,A01,083743,Cinel; Cameron Alexander,9,0,30,21
1657825485731,MATH 18,A02,083744,Cinel; Cameron Alexander,18,0,30,12
1657825485731,MATH 18,A03,083745,Cinel; Cameron Alexander,10,0,30,20
1657825485731,MATH 18,B01,083748,Rideout; David Porter,5,0,37,32
1657825485731,MATH 18,B02,083749,Rideout; David Porter,5,0,36,31
1657825485731,MATH 18,B03,083750,Rideout; David Porter,3,0,37,34
1657825485731,MATH 18,B04,083751,Rideout; David Porter,6,0,36,30
1657825485731,MATH 18,B05,093473,Rideout; David Porter,6,0,36,30
1657825485731,MATH 18,B06,093474,Rideout; David Porter,6,0,36,30
1657825491754,MATH 20A,A01,083754,Zheng; Zequn,14,0,40,26
1657825497778,MATH 20B,A01,083756,Briones; Jor-el Thomas Caparas,4,0,36,32
1657825497778,MATH 20B,A02,083757,Briones; Jor-el Thomas Caparas,1,0,36,35
1657825497778,MATH 20B,A03,093475,Briones; Jor-el Thomas Caparas,2,0,36,34
1657825503803,MATH 20C,A01,083760,Briones; Jor-el Thomas Caparas,1,0,35,34
1657825503803,MATH 20C,A02,083761,Briones; Jor-el Thomas Caparas,8,0,35,27
1657825503803,MATH 20C,A03,093476,Briones; Jor-el Thomas Caparas,0,1,36,36
1657825503803,MATH 20C,B01,083762,Bach; Quang Tran,1,0,30,29
1657825509826,MATH 20D,A01,083765,Tran; Brian Kha,5,0,30,25
1657825509826,MATH 20D,A02,083766,Tran; Brian Kha,5,0,30,25
1657825509826,MATH 20D,A03,083767,Tran; Brian Kha,5,0,30,25
1657825515852,MATH 20E,A01,083771,Ganguly; Soumya,10,0,32,22
1657825515852,MATH 20E,A02,083772,Ganguly; Soumya,6,0,32,26
1657825515852,MATH 20E,B01,083773,Ciotti; Benjamin,20,0,35,15
1657825515852,MATH 20E,B02,083774,Ciotti; Benjamin,18,0,35,17
1657825521880,MATH 103A,A01,083777,Greenfeld; Be'Eri,3,0,36,33
1657825521880,MATH 103A,A02,083778,Greenfeld; Be'Eri,5,0,36,31
1657825521880,MATH 103A,A03,093561,Greenfeld; Be'Eri,6,0,36,30
1657825521880,MATH 103A,B01,083779,Greenfeld; Be'Eri,7,0,36,29
1657825521880,MATH 103A,B02,083780,Greenfeld; Be'Eri,4,0,36,32
1657825521880,MATH 103A,B03,093562,Greenfeld; Be'Eri,3,0,36,33
1657825527905,MATH 105,A01,085443,Carter; Anne Toulson,15,0,35,20
1657825527905,MATH 105,A02,093477,Carter; Anne Toulson,20,0,35,15
1657825533927,MATH 109,A01,083213,Ganzberger; Geoffrey Michael,3,0,34,31
1657825533927,MATH 109,A02,083214,Ganzberger; Geoffrey Michael,4,0,34,30
1657825533927,MATH 109,A03,093478,Ganzberger; Geoffrey Michael,2,0,34,32
1657825533927,MATH 109,B01,083215,Ganzberger; Geoffrey Michael,1,0,32,31
1657825533927,MATH 109,B02,083216,Ganzberger; Geoffrey Michael,2,0,32,30
1657825533927,MATH 109,B03,093479,Ganzberger; Geoffrey Michael,8,0,32,24
1657825539960,MATH 142A,A01,083219,Chow; Bennett,7,0,32,25
1657825539960,MATH 142A,A02,083220,Chow; Bennett,10,0,32,22
1657825539960,MATH 142A,A03,093480,Chow; Bennett,9,0,32,23
1657825539960,MATH 142A,B03,093481,Chow; Bennett,8,0,32,24
1657825539960,MATH 142A,B04,093558,Chow; Bennett,13,0,32,19
1657825539960,MATH 142A,B05,093559,Chow; Bennett,7,0,32,25
1657825545985,MATH 193A,A01,083224,Rotar; Vladimir,8,0,34,26
1657825545985,MATH 193A,A02,083225,Rotar; Vladimir,10,0,34,24
1657825545985,MATH 193A,A03,083781,Rotar; Vladimir,5,0,34,29
1657825545985,MATH 193A,A04,083782,Rotar; Vladimir,11,0,34,23
1657825545985,MATH 193A,A05,093482,Rotar; Vladimir,10,0,34,24
1657825552012,MATH 197,001,091859,McAuley; Julian John,9999,0,9999,0
1657825552012,MATH 197,002,095566,Kedlaya; Kiran S.,9997,0,9999,2
1657825552012,MATH 197,003,095567,Xiao; Ming,9999,0,9999,0
1657825552012,MATH 197,004,095571,Perols; Johan Lars,9998,0,9999,1
1657825559076,COGS 9,A01,083615,Shannon; Kyle Michael,9,0,75,66
1657825565102,COGS 11,A01,083617,Boyle; Mary E. T.,23,0,48,25
1657825571131,COGS 13,A01,083071,Bastos; Amalia Pinkusfeld,11,0,71,60
1657825577156,COGS 14A,A01,092681,Semenuks; Arturs,5,1,100,95
1657825583179,COGS 14B,A01,083073,Cheng; Tzu-Han,6,0,63,57
1657825589206,COGS 17,A01,092677,Semenuks; Arturs,6,0,81,75
1657825595232,COGS 100,A01,083619,Allen; Michael Gordon,17,0,70,53
1657825601258,COGS 101A,A01,083621,Davis; Joshua Daniel,9,0,68,59
1657825607288,COGS 101B,A01,091572,Allen; Michael Gordon,12,0,65,53
1657825613310,COGS 101C,A01,083625,Delgado; Tania,17,0,35,18
1657825619335,COGS 107A,A01,083627,Boyle; Mary E. T.,14,0,60,46
1657825625357,COGS 118A,A01,083075,Gupta; Anjum,21,0,76,55
1657825631379,CSE 3,A50,083646,Miranda; Gregory Joseph,24,0,50,26
1657825637413,CSE 8A,A50,083650,Miranda; Gregory Joseph,17,1,56,39
1657825643436,CSE 11,A01,083080,Cao; Yingjun,6,15,40,34
1657825649484,CSE 12,A01,083652,Krause-Levy; Sophia Louisa,28,1,120,92
1657825655510,CSE 15L,A01,083654,Morris; Justin Loren,9,0,50,41
1657825655510,CSE 15L,A02,083655,Morris; Justin Loren,9,0,50,41
1657825661537,CSE 20,A01,083657,Tran; Khoa Dang,39,0,80,41
1657825667574,CSE 21,A01,095574,Bach; Quang Tran,22,0,48,26
1657825673598,CSE 30,A01,083084,Eldon; John,6,0,80,74
1657825673598,CSE 30,B01,095061,Bhaskar; Nishant,9,0,50,41
1657825679624,CSE 100,A01,083659,Cao; Yingjun,5,4,70,65
1657825685649,CSE 134B,A01,083661,Powell; Thomas Allan,24,0,100,76
1657825691672,CSE 140,A01,083663,Gungor; Onat,15,0,85,70
1657825697701,CSE 140L,A01,083088,Eldon; John,23,0,100,77
1657825703724,CSE 175,A01,083665,Kumar; Rakesh,3,0,25,22
1657825709748,CSE 190,A00,092507,Dubnov; Shlomo,8,0,20,12
1657825715784,ECE 45,A01,083139,Congero; Spencer William,6,0,75,69
1657825721816,ECE 65,A50,083695,Saad; Andrew S,12,0,30,18
1657825721816,ECE 65,A51,095125,Saad; Andrew S,24,0,26,2
1657825727844,ECE 109,A01,091882,Touri; Behrouz,20,0,70,50
1657825733871,ECE 180,A00,083140,Abi Samra; Nicholas Camill,1,0,30,29
1657825733871,ECE 180,B00,083141,Abi Samra; Nicholas Camill,0,0,30,30
1657825739897,MATH 10A,A01,083735,Patchell; Gregory David,2,0,30,28
1657825739897,MATH 10A,A02,083736,Patchell; Gregory David,20,0,30,10
1657825739897,MATH 10A,A03,083737,Patchell; Gregory David,16,0,30,14
1657825745921,MATH 10B,A01,083207,Lim; Seonhee,8,0,34,26
1657825745921,MATH 10B,A02,083208,Lim; Seonhee,10,0,35,25
1657825745921,MATH 10B,A03,093472,Lim; Seonhee,7,0,34,27
1657825745921,MATH 10B,B01,083739,Sinha; Shubham,13,0,30,17
1657825751951,MATH 18,A01,083743,Cinel; Cameron Alexander,9,0,30,21
1657825751951,MATH 18,A02,083744,Cinel; Cameron Alexander,18,0,30,12
1657825751951,MATH 18,A03,083745,Cinel; Cameron Alexander,10,0,30,20
1657825751951,MATH 18,B01,083748,Rideout; David Porter,5,0,37,32
1657825751951,MATH 18,B02,083749,Rideout; David Porter,5,0,36,31
1657825751951,MATH 18,B03,083750,Rideout; David Porter,3,0,37,34
1657825751951,MATH 18,B04,083751,Rideout; David Porter,6,0,36,30
1657825751951,MATH 18,B05,093473,Rideout; David Porter,6,0,36,30
1657825751951,MATH 18,B06,093474,Rideout; David Porter,6,0,36,30
1657825757975,MATH 20A,A01,083754,Zheng; Zequn,14,0,40,26
1657825764010,MATH 20B,A01,083756,Briones; Jor-el Thomas Caparas,4,0,36,32
1657825764010,MATH 20B,A02,083757,Briones; Jor-el Thomas Caparas,1,0,36,35
1657825764010,MATH 20B,A03,093475,Briones; Jor-el Thomas Caparas,2,0,36,34
1657825770038,MATH 20C,A01,083760,Briones; Jor-el Thomas Caparas,1,0,35,34
1657825770038,MATH 20C,A02,083761,Briones; Jor-el Thomas Caparas,8,0,35,27
1657825770038,MATH 20C,A03,093476,Briones; Jor-el Thomas Caparas,0,1,36,36
1657825770038,MATH 20C,B01,083762,Bach; Quang Tran,1,0,30,29
1657825776069,MATH 20D,A01,083765,Tran; Brian Kha,5,0,30,25
1657825776069,MATH 20D,A02,083766,Tran; Brian Kha,5,0,30,25
1657825776069,MATH 20D,A03,083767,Tran; Brian Kha,5,0,30,25
1657825782093,MATH 20E,A01,083771,Ganguly; Soumya,10,0,32,22
1657825782093,MATH 20E,A02,083772,Ganguly; Soumya,6,0,32,26
1657825782093,MATH 20E,B01,083773,Ciotti; Benjamin,20,0,35,15
1657825782093,MATH 20E,B02,083774,Ciotti; Benjamin,18,0,35,17
1657825788121,MATH 103A,A01,083777,Greenfeld; Be'Eri,3,0,36,33
1657825788121,MATH 103A,A02,083778,Greenfeld; Be'Eri,5,0,36,31
1657825788121,MATH 103A,A03,093561,Greenfeld; Be'Eri,6,0,36,30
1657825788121,MATH 103A,B01,083779,Greenfeld; Be'Eri,7,0,36,29
1657825788121,MATH 103A,B02,083780,Greenfeld; Be'Eri,4,0,36,32
1657825788121,MATH 103A,B03,093562,Greenfeld; Be'Eri,3,0,36,33
1657825794144,MATH 105,A01,085443,Carter; Anne Toulson,15,0,35,20
1657825794144,MATH 105,A02,093477,Carter; Anne Toulson,20,0,35,15
1657825800168,MATH 109,A01,083213,Ganzberger; Geoffrey Michael,3,0,34,31
1657825800168,MATH 109,A02,083214,Ganzberger; Geoffrey Michael,4,0,34,30
1657825800168,MATH 109,A03,093478,Ganzberger; Geoffrey Michael,2,0,34,32
1657825800168,MATH 109,B01,083215,Ganzberger; Geoffrey Michael,1,0,32,31
1657825800168,MATH 109,B02,083216,Ganzberger; Geoffrey Michael,2,0,32,30
1657825800168,MATH 109,B03,093479,Ganzberger; Geoffrey Michael,8,0,32,24
1657825806196,MATH 142A,A01,083219,Chow; Bennett,7,0,32,25
1657825806196,MATH 142A,A02,083220,Chow; Bennett,10,0,32,22
1657825806196,MATH 142A,A03,093480,Chow; Bennett,9,0,32,23
1657825806196,MATH 142A,B03,093481,Chow; Bennett,8,0,32,24
1657825806196,MATH 142A,B04,093558,Chow; Bennett,13,0,32,19
1657825806196,MATH 142A,B05,093559,Chow; Bennett,7,0,32,25
1657825812227,MATH 193A,A01,083224,Rotar; Vladimir,8,0,34,26
1657825812227,MATH 193A,A02,083225,Rotar; Vladimir,10,0,34,24
1657825812227,MATH 193A,A03,083781,Rotar; Vladimir,5,0,34,29
1657825812227,MATH 193A,A04,083782,Rotar; Vladimir,11,0,34,23
1657825812227,MATH 193A,A05,093482,Rotar; Vladimir,10,0,34,24
1657825818264,MATH 197,001,091859,McAuley; Julian John,9999,0,9999,0
1657825818264,MATH 197,002,095566,Kedlaya; Kiran S.,9997,0,9999,2
1657825818264,MATH 197,003,095567,Xiao; Ming,9999,0,9999,0
1657825818264,MATH 197,004,095571,Perols; Johan Lars,9998,0,9999,1
1657825825314,COGS 9,A01,083615,Shannon; Kyle Michael,9,0,75,66
1657825831336,COGS 11,A01,083617,Boyle; Mary E. T.,23,0,48,25
1657825837359,COGS 13,A01,083071,Bastos; Amalia Pinkusfeld,11,0,71,60
1657825843391,COGS 14A,A01,092681,Semenuks; Arturs,5,1,100,95
1657825849419,COGS 14B,A01,083073,Cheng; Tzu-Han,6,0,63,57
1657825855448,COGS 17,A01,092677,Semenuks; Arturs,6,0,81,75
1657825861471,COGS 100,A01,083619,Allen; Michael Gordon,17,0,70,53
1657825867588,COGS 101A,A01,083621,Davis; Joshua Daniel,9,0,68,59
1657825873615,COGS 101B,A01,091572,Allen; Michael Gordon,12,0,65,53
1657825879643,COGS 101C,A01,083625,Delgado; Tania,17,0,35,18
1657825885690,COGS 107A,A01,083627,Boyle; Mary E. T.,14,0,60,46
1657825891715,COGS 118A,A01,083075,Gupta; Anjum,21,0,76,55
1657825897756,CSE 3,A50,083646,Miranda; Gregory Joseph,24,0,50,26
1657825903782,CSE 8A,A50,083650,Miranda; Gregory Joseph,17,1,56,39
1657825909807,CSE 11,A01,083080,Cao; Yingjun,6,15,40,34
1657825915831,CSE 12,A01,083652,Krause-Levy; Sophia Louisa,28,1,120,92
1657825921859,CSE 15L,A01,083654,Morris; Justin Loren,9,0,50,41
1657825921859,CSE 15L,A02,083655,Morris; Justin Loren,9,0,50,41
1657825927880,CSE 20,A01,083657,Tran; Khoa Dang,39,0,80,41
1657825933904,CSE 21,A01,095574,Bach; Quang Tran,22,0,48,26
1657825939929,CSE 30,A01,083084,Eldon; John,6,0,80,74
1657825939929,CSE 30,B01,095061,Bhaskar; Nishant,9,0,50,41
1657825945959,CSE 100,A01,083659,Cao; Yingjun,5,4,70,65
1657825951983,CSE 134B,A01,083661,Powell; Thomas Allan,24,0,100,76
1657825958007,CSE 140,A01,083663,Gungor; Onat,15,0,85,70
1657825964038,CSE 140L,A01,083088,Eldon; John,23,0,100,77
1657825970079,CSE 175,A01,083665,Kumar; Rakesh,3,0,25,22
1657825976105,CSE 190,A00,092507,Dubnov; Shlomo,8,0,20,12
1657825982131,ECE 45,A01,083139,Congero; Spencer William,6,0,75,69
1657825988154,ECE 65,A50,083695,Saad; Andrew S,12,0,30,18
1657825988154,ECE 65,A51,095125,Saad; Andrew S,24,0,26,2
1657825994187,ECE 109,A01,091882,Touri; Behrouz,20,0,70,50
1657826000212,ECE 180,A00,083140,Abi Samra; Nicholas Camill,1,0,30,29
1657826000212,ECE 180,B00,083141,Abi Samra; Nicholas Camill,0,0,30,30
1657826006234,MATH 10A,A01,083735,Patchell; Gregory David,2,0,30,28
1657826006234,MATH 10A,A02,083736,Patchell; Gregory David,20,0,30,10
1657826006234,MATH 10A,A03,083737,Patchell; Gregory David,16,0,30,14
1657826012265,MATH 10B,A01,083207,Lim; Seonhee,8,0,34,26
1657826012265,MATH 10B,A02,083208,Lim; Seonhee,10,0,35,25
1657826012265,MATH 10B,A03,093472,Lim; Seonhee,7,0,34,27
1657826012265,MATH 10B,B01,083739,Sinha; Shubham,13,0,30,17
1657826018298,MATH 18,A01,083743,Cinel; Cameron Alexander,9,0,30,21
1657826018298,MATH 18,A02,083744,Cinel; Cameron Alexander,18,0,30,12
1657826018298,MATH 18,A03,083745,Cinel; Cameron Alexander,10,0,30,20
1657826018298,MATH 18,B01,083748,Rideout; David Porter,5,0,37,32
1657826018298,MATH 18,B02,083749,Rideout; David Porter,5,0,36,31
1657826018298,MATH 18,B03,083750,Rideout; David Porter,3,0,37,34
1657826018298,MATH 18,B04,083751,Rideout; David Porter,6,0,36,30
1657826018298,MATH 18,B05,093473,Rideout; David Porter,6,0,36,30
1657826018298,MATH 18,B06,093474,Rideout; David Porter,6,0,36,30
1657826024321,MATH 20A,A01,083754,Zheng; Zequn,14,0,40,26
1657826030356,MATH 20B,A01,083756,Briones; Jor-el Thomas Caparas,4,0,36,32
1657826030356,MATH 20B,A02,083757,Briones; Jor-el Thomas Caparas,1,0,36,35
1657826030356,MATH 20B,A03,093475,Briones; Jor-el Thomas Caparas,2,0,36,34
1657826036380,MATH 20C,A01,083760,Briones; Jor-el Thomas Caparas,1,0,35,34
1657826036380,MATH 20C,A02,083761,Briones; Jor-el Thomas Caparas,8,0,35,27
1657826036380,MATH 20C,A03,093476,Briones; Jor-el Thomas Caparas,0,1,36,36
1657826036380,MATH 20C,B01,083762,Bach; Quang Tran,1,0,30,29
1657826042404,MATH 20D,A01,083765,Tran; Brian Kha,5,0,30,25
1657826042404,MATH 20D,A02,083766,Tran; Brian Kha,5,0,30,25
1657826042404,MATH 20D,A03,083767,Tran; Brian Kha,5,0,30,25
1657826048435,MATH 20E,A01,083771,Ganguly; Soumya,10,0,32,22
1657826048435,MATH 20E,A02,083772,Ganguly; Soumya,6,0,32,26
1657826048435,MATH 20E,B01,083773,Ciotti; Benjamin,20,0,35,15
1657826048435,MATH 20E,B02,083774,Ciotti; Benjamin,18,0,35,17
1657826054466,MATH 103A,A01,083777,Greenfeld; Be'Eri,3,0,36,33
1657826054466,MATH 103A,A02,083778,Greenfeld; Be'Eri,5,0,36,31
1657826054466,MATH 103A,A03,093561,Greenfeld; Be'Eri,6,0,36,30
1657826054466,MATH 103A,B01,083779,Greenfeld; Be'Eri,7,0,36,29
1657826054466,MATH 103A,B02,083780,Greenfeld; Be'Eri,4,0,36,32
1657826054466,MATH 103A,B03,093562,Greenfeld; Be'Eri,3,0,36,33
1657826060497,MATH 105,A01,085443,Carter; Anne Toulson,15,0,35,20
1657826060497,MATH 105,A02,093477,Carter; Anne Toulson,20,0,35,15
1657826066525,MATH 109,A01,083213,Ganzberger; Geoffrey Michael,3,0,34,31
1657826066525,MATH 109,A02,083214,Ganzberger; Geoffrey Michael,4,0,34,30
1657826066525,MATH 109,A03,093478,Ganzberger; Geoffrey Michael,2,0,34,32
1657826066525,MATH 109,B01,083215,Ganzberger; Geoffrey Michael,1,0,32,31
1657826066525,MATH 109,B02,083216,Ganzberger; Geoffrey Michael,2,0,32,30
1657826066525,MATH 109,B03,093479,Ganzberger; Geoffrey Michael,8,0,32,24
1657826072549,MATH 142A,A01,083219,Chow; Bennett,7,0,32,25
1657826072549,MATH 142A,A02,083220,Chow; Bennett,10,0,32,22
1657826072549,MATH 142A,A03,093480,Chow; Bennett,9,0,32,23
1657826072549,MATH 142A,B03,093481,Chow; Bennett,8,0,32,24
1657826072549,MATH 142A,B04,093558,Chow; Bennett,13,0,32,19
1657826072549,MATH 142A,B05,093559,Chow; Bennett,7,0,32,25
1657826078584,MATH 193A,A01,083224,Rotar; Vladimir,8,0,34,26
1657826078584,MATH 193A,A02,083225,Rotar; Vladimir,10,0,34,24
1657826078584,MATH 193A,A03,083781,Rotar; Vladimir,5,0,34,29
1657826078584,MATH 193A,A04,083782,Rotar; Vladimir,11,0,34,23
1657826078584,MATH 193A,A05,093482,Rotar; Vladimir,10,0,34,24
1657826084608,MATH 197,001,091859,McAuley; Julian John,9999,0,9999,0
1657826084608,MATH 197,002,095566,Kedlaya; Kiran S.,9997,0,9999,2
1657826084608,MATH 197,003,095567,Xiao; Ming,9999,0,9999,0
1657826084608,MATH 197,004,095571,Perols; Johan Lars,9998,0,9999,1
1657826091668,COGS 9,A01,083615,Shannon; Kyle Michael,9,0,75,66
1657826097691,COGS 11,A01,083617,Boyle; Mary E. T.,23,0,48,25
1657826103717,COGS 13,A01,083071,Bastos; Amalia Pinkusfeld,11,0,71,60
1657826109750,COGS 14A,A01,092681,Semenuks; Arturs,5,1,100,95
1657826115780,COGS 14B,A01,083073,Cheng; Tzu-Han,6,0,63,57
1657826121803,COGS 17,A01,092677,Semenuks; Arturs,6,0,81,75
1657826127829,COGS 100,A01,083619,Allen; Michael Gordon,17,0,70,53
1657826133863,COGS 101A,A01,083621,Davis; Joshua Daniel,9,0,68,59
1657826139888,COGS 101B,A01,091572,Allen; Michael Gordon,12,0,65,53
1657826145913,COGS 101C,A01,083625,Delgado; Tania,17,0,35,18
1657826151936,COGS 107A,A01,083627,Boyle; Mary E. T.,14,0,60,46
1657826157961,COGS 118A,A01,083075,Gupta; Anjum,21,0,76,55
1657826163988,CSE 3,A50,083646,Miranda; Gregory Joseph,24,0,50,26
1657826170012,CSE 8A,A50,083650,Miranda; Gregory Joseph,17,1,56,39
1657826176039,CSE 11,A01,083080,Cao; Yingjun,6,15,40,34
1657826182069,CSE 12,A01,083652,Krause-Levy; Sophia Louisa,28,1,120,92
1657826188092,CSE 15L,A01,083654,Morris; Justin Loren,9,0,50,41
1657826188092,CSE 15L,A02,083655,Morris; Justin Loren,9,0,50,41
1657826194115,CSE 20,A01,083657,Tran; Khoa Dang,39,0,80,41
1657826200152,CSE 21,A01,095574,Bach; Quang Tran,22,0,48,26
1657826206177,CSE 30,A01,083084,Eldon; John,6,0,80,74
1657826206177,CSE 30,B01,095061,Bhaskar; Nishant,9,0,50,41
1657826212203,CSE 100,A01,083659,Cao; Yingjun,5,4,70,65
1657826218229,CSE 134B,A01,083661,Powell; Thomas Allan,24,0,100,76
1657826224258,CSE 140,A01,083663,Gungor; Onat,15,0,85,70
1657826230281,CSE 140L,A01,083088,Eldon; John,23,0,100,77
1657826236306,CSE 175,A01,083665,Kumar; Rakesh,3,0,25,22
1657826242343,CSE 190,A00,092507,Dubnov; Shlomo,8,0,20,12
1657826248366,ECE 45,A01,083139,Congero; Spencer William,6,0,75,69
1657826254393,ECE 65,A50,083695,Saad; Andrew S,12,0,30,18
1657826254393,ECE 65,A51,095125,Saad; Andrew S,24,0,26,2
1657826260419,ECE 109,A01,091882,Touri; Behrouz,20,0,70,50
1657826266445,ECE 180,A00,083140,Abi Samra; Nicholas Camill,1,0,30,29
1657826266445,ECE 180,B00,083141,Abi Samra; Nicholas Camill,0,0,30,30
1657826272471,MATH 10A,A01,083735,Patchell; Gregory David,2,0,30,28
1657826272471,MATH 10A,A02,083736,Patchell; Gregory David,20,0,30,10
1657826272471,MATH 10A,A03,083737,Patchell; Gregory David,16,0,30,14
1657826278495,MATH 10B,A01,083207,Lim; Seonhee,8,0,34,26
1657826278495,MATH 10B,A02,083208,Lim; Seonhee,10,0,35,25
1657826278495,MATH 10B,A03,093472,Lim; Seonhee,7,0,34,27
1657826278495,MATH 10B,B01,083739,Sinha; Shubham,13,0,30,17
1657826284520,MATH 18,A01,083743,Cinel; Cameron Alexander,9,0,30,21
1657826284520,MATH 18,A02,083744,Cinel; Cameron Alexander,18,0,30,12
1657826284520,MATH 18,A03,083745,Cinel; Cameron Alexander,10,0,30,20
1657826284520,MATH 18,B01,083748,Rideout; David Porter,5,0,37,32
1657826284520,MATH 18,B02,083749,Rideout; David Porter,5,0,36,31
1657826284520,MATH 18,B03,083750,Rideout; David Porter,3,0,37,34
1657826284520,MATH 18,B04,083751,Rideout; David Porter,6,0,36,30
1657826284520,MATH 18,B05,093473,Rideout; David Porter,6,0,36,30
1657826284520,MATH 18,B06,093474,Rideout; David Porter,6,0,36,30
1657826290542,MATH 20A,A01,083754,Zheng; Zequn,14,0,40,26
1657826296575,MATH 20B,A01,083756,Briones; Jor-el Thomas Caparas,4,0,36,32
1657826296575,MATH 20B,A02,083757,Briones; Jor-el Thomas Caparas,1,0,36,35
1657826296575,MATH 20B,A03,093475,Briones; Jor-el Thomas Caparas,2,0,36,34
1657826302606,MATH 20C,A01,083760,Briones; Jor-el Thomas Caparas,1,0,35,34
1657826302606,MATH 20C,A02,083761,Briones; Jor-el Thomas Caparas,8,0,35,27
1657826302606,MATH 20C,A03,093476,Briones; Jor-el Thomas Caparas,0,1,36,36
1657826302606,MATH 20C,B01,083762,Bach; Quang Tran,1,0,30,29
1657826308629,MATH 20D,A01,083765,Tran; Brian Kha,5,0,30,25
1657826308629,MATH 20D,A02,083766,Tran; Brian Kha,5,0,30,25
1657826308629,MATH 20D,A03,083767,Tran; Brian Kha,5,0,30,25
1657826314657,MATH 20E,A01,083771,Ganguly; Soumya,10,0,32,22
1657826314657,MATH 20E,A02,083772,Ganguly; Soumya,6,0,32,26
1657826314657,MATH 20E,B01,083773,Ciotti; Benjamin,20,0,35,15
1657826314657,MATH 20E,B02,083774,Ciotti; Benjamin,18,0,35,17
1657826320693,MATH 103A,A01,083777,Greenfeld; Be'Eri,3,0,36,33
1657826320693,MATH 103A,A02,083778,Greenfeld; Be'Eri,5,0,36,31
1657826320693,MATH 103A,A03,093561,Greenfeld; Be'Eri,6,0,36,30
1657826320693,MATH 103A,B01,083779,Greenfeld; Be'Eri,7,0,36,29
1657826320693,MATH 103A,B02,083780,Greenfeld; Be'Eri,4,0,36,32
1657826320693,MATH 103A,B03,093562,Greenfeld; Be'Eri,3,0,36,33
1657826326728,MATH 105,A01,085443,Carter; Anne Toulson,15,0,35,20
1657826326728,MATH 105,A02,093477,Carter; Anne Toulson,20,0,35,15
1657826332752,MATH 109,A01,083213,Ganzberger; Geoffrey Michael,3,0,34,31
1657826332752,MATH 109,A02,083214,Ganzberger; Geoffrey Michael,4,0,34,30
1657826332752,MATH 109,A03,093478,Ganzberger; Geoffrey Michael,2,0,34,32
1657826332752,MATH 109,B01,083215,Ganzberger; Geoffrey Michael,1,0,32,31
1657826332752,MATH 109,B02,083216,Ganzberger; Geoffrey Michael,2,0,32,30
1657826332752,MATH 109,B03,093479,Ganzberger; Geoffrey Michael,8,0,32,24
1657826338774,MATH 142A,A01,083219,Chow; Bennett,7,0,32,25
1657826338774,MATH 142A,A02,083220,Chow; Bennett,10,0,32,22
1657826338774,MATH 142A,A03,093480,Chow; Bennett,9,0,32,23
1657826338774,MATH 142A,B03,093481,Chow; Bennett,8,0,32,24
1657826338774,MATH 142A,B04,093558,Chow; Bennett,13,0,32,19
1657826338774,MATH 142A,B05,093559,Chow; Bennett,7,0,32,25
1657826344796,MATH 193A,A01,083224,Rotar; Vladimir,8,0,34,26
1657826344796,MATH 193A,A02,083225,Rotar; Vladimir,10,0,34,24
1657826344796,MATH 193A,A03,083781,Rotar; Vladimir,5,0,34,29
1657826344796,MATH 193A,A04,083782,Rotar; Vladimir,11,0,34,23
1657826344796,MATH 193A,A05,093482,Rotar; Vladimir,10,0,34,24
1657826350819,MATH 197,001,091859,McAuley; Julian John,9999,0,9999,0
1657826350819,MATH 197,002,095566,Kedlaya; Kiran S.,9997,0,9999,2
1657826350819,MATH 197,003,095567,Xiao; Ming,9999,0,9999,0
1657826350819,MATH 197,004,095571,Perols; Johan Lars,9998,0,9999,1
1657826357889,COGS 9,A01,083615,Shannon; Kyle Michael,9,0,75,66
1657826363912,COGS 11,A01,083617,Boyle; Mary E. T.,23,0,48,25
1657826369939,COGS 13,A01,083071,Bastos; Amalia Pinkusfeld,11,0,71,60
1657826375992,COGS 14A,A01,092681,Semenuks; Arturs,5,1,100,95
1657826382030,COGS 14B,A01,083073,Cheng; Tzu-Han,6,0,63,57
1657826388054,COGS 17,A01,092677,Semenuks; Arturs,6,0,81,75
1657826394077,COGS 100,A01,083619,Allen; Michael Gordon,17,0,70,53
1657826400104,COGS 101A,A01,083621,Davis; Joshua Daniel,9,0,68,59
1657826406126,COGS 101B,A01,091572,Allen; Michael Gordon,12,0,65,53
1657826412152,COGS 101C,A01,083625,Delgado; Tania,17,0,35,18
1657826418175,COGS 107A,A01,083627,Boyle; Mary E. T.,14,0,60,46
1657826424197,COGS 118A,A01,083075,Gupta; Anjum,21,0,76,55
1657826430224,CSE 3,A50,083646,Miranda; Gregory Joseph,24,0,50,26
1657826436263,CSE 8A,A50,083650,Miranda; Gregory Joseph,17,1,56,39
1657826442290,CSE 11,A01,083080,Cao; Yingjun,6,15,40,34
1657826448327,CSE 12,A01,083652,Krause-Levy; Sophia Louisa,29,1,120,91
1657826454354,CSE 15L,A01,083654,Morris; Justin Loren,9,0,50,41
1657826454354,CSE 15L,A02,083655,Morris; Justin Loren,9,0,50,41
1657826460383,CSE 20,A01,083657,Tran; Khoa Dang,39,0,80,41
1657826466512,CSE 21,A01,095574,Bach; Quang Tran,22,0,48,26
1657826472550,CSE 30,A01,083084,Eldon; John,6,0,80,74
1657826472550,CSE 30,B01,095061,Bhaskar; Nishant,9,0,50,41
1657826478574,CSE 100,A01,083659,Cao; Yingjun,5,4,70,65
1657826484600,CSE 134B,A01,083661,Powell; Thomas Allan,24,0,100,76
1657826490631,CSE 140,A01,083663,Gungor; Onat,15,0,85,70
1657826496671,CSE 140L,A01,083088,Eldon; John,23,0,100,77
1657826502698,CSE 175,A01,083665,Kumar; Rakesh,3,0,25,22
1657826508720,CSE 190,A00,092507,Dubnov; Shlomo,8,0,20,12
1657826514752,ECE 45,A01,083139,Congero; Spencer William,6,0,75,69
1657826520777,ECE 65,A50,083695,Saad; Andrew S,12,0,30,18
1657826520777,ECE 65,A51,095125,Saad; Andrew S,24,0,26,2
1657826526801,ECE 109,A01,091882,Touri; Behrouz,20,0,70,50
1657826532824,ECE 180,A00,083140,Abi Samra; Nicholas Camill,1,0,30,29
1657826532824,ECE 180,B00,083141,Abi Samra; Nicholas Camill,0,0,30,30
1657826538851,MATH 10A,A01,083735,Patchell; Gregory David,2,0,30,28
1657826538851,MATH 10A,A02,083736,Patchell; Gregory David,20,0,30,10
1657826538851,MATH 10A,A03,083737,Patchell; Gregory David,16,0,30,14
1657826544879,MATH 10B,A01,083207,Lim; Seonhee,8,0,34,26
1657826544879,MATH 10B,A02,083208,Lim; Seonhee,10,0,35,25
1657826544879,MATH 10B,A03,093472,Lim; Seonhee,7,0,34,27
1657826544879,MATH 10B,B01,083739,Sinha; Shubham,13,0,30,17
1657826550910,MATH 18,A01,083743,Cinel; Cameron Alexander,9,0,30,21
1657826550910,MATH 18,A02,083744,Cinel; Cameron Alexander,18,0,30,12
1657826550910,MATH 18,A03,083745,Cinel; Cameron Alexander,10,0,30,20
1657826550910,MATH 18,B01,083748,Rideout; David Porter,5,0,37,32
1657826550910,MATH 18,B02,083749,Rideout; David Porter,5,0,36,31
1657826550910,MATH 18,B03,083750,Rideout; David Porter,3,0,37,34
1657826550910,MATH 18,B04,083751,Rideout; David Porter,6,0,36,30
1657826550910,MATH 18,B05,093473,Rideout; David Porter,6,0,36,30
1657826550910,MATH 18,B06,093474,Rideout; David Porter,6,0,36,30
1657826556943,MATH 20A,A01,083754,Zheng; Zequn,14,0,40,26
1657826562967,MATH 20B,A01,083756,Briones; Jor-el Thomas Caparas,4,0,36,32
1657826562967,MATH 20B,A02,083757,Briones; Jor-el Thomas Caparas,1,0,36,35
1657826562967,MATH 20B,A03,093475,Briones; Jor-el Thomas Caparas,2,0,36,34
1657826568989,MATH 20C,A01,083760,Briones; Jor-el Thomas Caparas,1,0,35,34
1657826568989,MATH 20C,A02,083761,Briones; Jor-el Thomas Caparas,8,0,35,27
1657826568989,MATH 20C,A03,093476,Briones; Jor-el Thomas Caparas,0,1,36,36
1657826568989,MATH 20C,B01,083762,Bach; Quang Tran,1,0,30,29
1657826575018,MATH 20D,A01,083765,Tran; Brian Kha,5,0,30,25
1657826575018,MATH 20D,A02,083766,Tran; Brian Kha,5,0,30,25
1657826575018,MATH 20D,A03,083767,Tran; Brian Kha,5,0,30,25
1657826581057,MATH 20E,A01,083771,Ganguly; Soumya,10,0,32,22
1657826581057,MATH 20E,A02,083772,Ganguly; Soumya,6,0,32,26
1657826581057,MATH 20E,B01,083773,Ciotti; Benjamin,20,0,35,15
1657826581057,MATH 20E,B02,083774,Ciotti; Benjamin,18,0,35,17
1657826587089,MATH 103A,A01,083777,Greenfeld; Be'Eri,3,0,36,33
1657826587089,MATH 103A,A02,083778,Greenfeld; Be'Eri,5,0,36,31
1657826587089,MATH 103A,A03,093561,Greenfeld; Be'Eri,6,0,36,30
1657826587089,MATH 103A,B01,083779,Greenfeld; Be'Eri,7,0,36,29
1657826587089,MATH 103A,B02,083780,Greenfeld; Be'Eri,4,0,36,32
1657826587089,MATH 103A,B03,093562,Greenfeld; Be'Eri,3,0,36,33
1657826593114,MATH 105,A01,085443,Carter; Anne Toulson,15,0,35,20
1657826593114,MATH 105,A02,093477,Carter; Anne Toulson,20,0,35,15
1657826599142,MATH 109,A01,083213,Ganzberger; Geoffrey Michael,3,0,34,31
1657826599142,MATH 109,A02,083214,Ganzberger; Geoffrey Michael,4,0,34,30
1657826599142,MATH 109,A03,093478,Ganzberger; Geoffrey Michael,2,0,34,32
1657826599142,MATH 109,B01,083215,Ganzberger; Geoffrey Michael,1,0,32,31
1657826599142,MATH 109,B02,083216,Ganzberger; Geoffrey Michael,2,0,32,30
1657826599142,MATH 109,B03,093479,Ganzberger; Geoffrey Michael,8,0,32,24
1657826605169,MATH 142A,A01,083219,Chow; Bennett,7,0,32,25
1657826605169,MATH 142A,A02,083220,Chow; Bennett,10,0,32,22
1657826605169,MATH 142A,A03,093480,Chow; Bennett,9,0,32,23
1657826605169,MATH 142A,B03,093481,Chow; Bennett,8,0,32,24
1657826605169,MATH 142A,B04,093558,Chow; Bennett,13,0,32,19
1657826605169,MATH 142A,B05,093559,Chow; Bennett,7,0,32,25
1657826611206,MATH 193A,A01,083224,Rotar; Vladimir,8,0,34,26
1657826611206,MATH 193A,A02,083225,Rotar; Vladimir,10,0,34,24
1657826611206,MATH 193A,A03,083781,Rotar; Vladimir,5,0,34,29
1657826611206,MATH 193A,A04,083782,Rotar; Vladimir,11,0,34,23
1657826611206,MATH 193A,A05,093482,Rotar; Vladimir,10,0,34,24
1657826617227,MATH 197,001,091859,McAuley; Julian John,9999,0,9999,0
1657826617227,MATH 197,002,095566,Kedlaya; Kiran S.,9997,0,9999,2
1657826617227,MATH 197,003,095567,Xiao; Ming,9999,0,9999,0
1657826617227,MATH 197,004,095571,Perols; Johan Lars,9998,0,9999,1
1657826624301,COGS 9,A01,083615,Shannon; Kyle Michael,9,0,75,66
1657826630323,COGS 11,A01,083617,Boyle; Mary E. T.,23,0,48,25
1657826636355,COGS 13,A01,083071,Bastos; Amalia Pinkusfeld,11,0,71,60
1657826642377,COGS 14A,A01,092681,Semenuks; Arturs,5,1,100,95
1657826648404,COGS 14B,A01,083073,Cheng; Tzu-Han,6,0,63,57
1657826654433,COGS 17,A01,092677,Semenuks; Arturs,6,0,81,75
1657826660457,COGS 100,A01,083619,Allen; Michael Gordon,17,0,70,53
1657826666484,COGS 101A,A01,083621,Davis; Joshua Daniel,9,0,68,59
1657826672506,COGS 101B,A01,091572,Allen; Michael Gordon,12,0,65,53
1657826678529,COGS 101C,A01,083625,Delgado; Tania,17,0,35,18
1657826684561,COGS 107A,A01,083627,Boyle; Mary E. T.,14,0,60,46
1657826690592,COGS 118A,A01,083075,Gupta; Anjum,21,0,76,55
1657826696616,CSE 3,A50,083646,Miranda; Gregory Joseph,24,0,50,26
1657826702638,CSE 8A,A50,083650,Miranda; Gregory Joseph,17,1,56,39
1657826708666,CSE 11,A01,083080,Cao; Yingjun,6,15,40,34
1657826714694,CSE 12,A01,083652,Krause-Levy; Sophia Louisa,29,1,120,91
1657826720717,CSE 15L,A01,083654,Morris; Justin Loren,9,0,50,41
1657826720717,CSE 15L,A02,083655,Morris; Justin Loren,9,0,50,41
1657826726753,CSE 20,A01,083657,Tran; Khoa Dang,39,0,80,41
1657826732776,CSE 21,A01,095574,Bach; Quang Tran,22,0,48,26
1657826738800,CSE 30,A01,083084,Eldon; John,6,0,80,74
1657826738800,CSE 30,B01,095061,Bhaskar; Nishant,9,0,50,41
1657826744828,CSE 100,A01,083659,Cao; Yingjun,5,4,70,65
1657826750852,CSE 134B,A01,083661,Powell; Thomas Allan,24,0,100,76
1657826756875,CSE 140,A01,083663,Gungor; Onat,15,0,85,70
1657826762899,CSE 140L,A01,083088,Eldon; John,23,0,100,77
1657826768924,CSE 175,A01,083665,Kumar; Rakesh,3,0,25,22
1657826774948,CSE 190,A00,092507,Dubnov; Shlomo,8,0,20,12
1657826780971,ECE 45,A01,083139,Congero; Spencer William,6,0,75,69
1657826787002,ECE 65,A50,083695,Saad; Andrew S,12,0,30,18
1657826787002,ECE 65,A51,095125,Saad; Andrew S,24,0,26,2
1657826793023,ECE 109,A01,091882,Touri; Behrouz,20,0,70,50
1657826799045,ECE 180,A00,083140,Abi Samra; Nicholas Camill,1,0,30,29
1657826799045,ECE 180,B00,083141,Abi Samra; Nicholas Camill,0,0,30,30
1657826805068,MATH 10A,A01,083735,Patchell; Gregory David,2,0,30,28
1657826805068,MATH 10A,A02,083736,Patchell; Gregory David,20,0,30,10
1657826805068,MATH 10A,A03,083737,Patchell; Gregory David,16,0,30,14
1657826811099,MATH 10B,A01,083207,Lim; Seonhee,8,0,34,26
1657826811099,MATH 10B,A02,083208,Lim; Seonhee,10,0,35,25
1657826811099,MATH 10B,A03,093472,Lim; Seonhee,7,0,34,27
1657826811099,MATH 10B,B01,083739,Sinha; Shubham,13,0,30,17
1657826817124,MATH 18,A01,083743,Cinel; Cameron Alexander,9,0,30,21
1657826817124,MATH 18,A02,083744,Cinel; Cameron Alexander,18,0,30,12
1657826817124,MATH 18,A03,083745,Cinel; Cameron Alexander,10,0,30,20
1657826817124,MATH 18,B01,083748,Rideout; David Porter,5,0,37,32
1657826817124,MATH 18,B02,083749,Rideout; David Porter,5,0,36,31
1657826817124,MATH 18,B03,083750,Rideout; David Porter,3,0,37,34
1657826817124,MATH 18,B04,083751,Rideout; David Porter,6,0,36,30
1657826817124,MATH 18,B05,093473,Rideout; David Porter,6,0,36,30
1657826817124,MATH 18,B06,093474,Rideout; David Porter,6,0,36,30
1657826823148,MATH 20A,A01,083754,Zheng; Zequn,14,0,40,26
1657826829171,MATH 20B,A01,083756,Briones; Jor-el Thomas Caparas,4,0,36,32
1657826829171,MATH 20B,A02,083757,Briones; Jor-el Thomas Caparas,1,0,36,35
1657826829171,MATH 20B,A03,093475,Briones; Jor-el Thomas Caparas,2,0,36,34
1657826835200,MATH 20C,A01,083760,Briones; Jor-el Thomas Caparas,1,0,35,34
1657826835200,MATH 20C,A02,083761,Briones; Jor-el Thomas Caparas,8,0,35,27
1657826835200,MATH 20C,A03,093476,Briones; Jor-el Thomas Caparas,0,1,36,36
1657826835200,MATH 20C,B01,083762,Bach; Quang Tran,1,0,30,29
1657826841227,MATH 20D,A01,083765,Tran; Brian Kha,5,0,30,25
1657826841227,MATH 20D,A02,083766,Tran; Brian Kha,5,0,30,25
1657826841227,MATH 20D,A03,083767,Tran; Brian Kha,5,0,30,25
1657826847256,MATH 20E,A01,083771,Ganguly; Soumya,10,0,32,22
1657826847256,MATH 20E,A02,083772,Ganguly; Soumya,6,0,32,26
1657826847256,MATH 20E,B01,083773,Ciotti; Benjamin,20,0,35,15
1657826847256,MATH 20E,B02,083774,Ciotti; Benjamin,18,0,35,17
1657826853280,MATH 103A,A01,083777,Greenfeld; Be'Eri,3,0,36,33
1657826853280,MATH 103A,A02,083778,Greenfeld; Be'Eri,5,0,36,31
1657826853280,MATH 103A,A03,093561,Greenfeld; Be'Eri,6,0,36,30
1657826853280,MATH 103A,B01,083779,Greenfeld; Be'Eri,7,0,36,29
1657826853280,MATH 103A,B02,083780,Greenfeld; Be'Eri,4,0,36,32
1657826853280,MATH 103A,B03,093562,Greenfeld; Be'Eri,3,0,36,33
1657826859304,MATH 105,A01,085443,Carter; Anne Toulson,15,0,35,20
1657826859304,MATH 105,A02,093477,Carter; Anne Toulson,20,0,35,15
1657826865333,MATH 109,A01,083213,Ganzberger; Geoffrey Michael,3,0,34,31
1657826865333,MATH 109,A02,083214,Ganzberger; Geoffrey Michael,4,0,34,30
1657826865333,MATH 109,A03,093478,Ganzberger; Geoffrey Michael,2,0,34,32
1657826865333,MATH 109,B01,083215,Ganzberger; Geoffrey Michael,1,0,32,31
1657826865333,MATH 109,B02,083216,Ganzberger; Geoffrey Michael,2,0,32,30
1657826865333,MATH 109,B03,093479,Ganzberger; Geoffrey Michael,8,0,32,24
1657826871357,MATH 142A,A01,083219,Chow; Bennett,7,0,32,25
1657826871357,MATH 142A,A02,083220,Chow; Bennett,10,0,32,22
1657826871357,MATH 142A,A03,093480,Chow; Bennett,9,0,32,23
1657826871357,MATH 142A,B03,093481,Chow; Bennett,8,0,32,24
1657826871357,MATH 142A,B04,093558,Chow; Bennett,13,0,32,19
1657826871357,MATH 142A,B05,093559,Chow; Bennett,7,0,32,25
1657826877396,MATH 193A,A01,083224,Rotar; Vladimir,8,0,34,26
1657826877396,MATH 193A,A02,083225,Rotar; Vladimir,10,0,34,24
1657826877396,MATH 193A,A03,083781,Rotar; Vladimir,5,0,34,29
1657826877396,MATH 193A,A04,083782,Rotar; Vladimir,11,0,34,23
1657826877396,MATH 193A,A05,093482,Rotar; Vladimir,10,0,34,24
1657826883425,MATH 197,001,091859,McAuley; Julian John,9999,0,9999,0
1657826883425,MATH 197,002,095566,Kedlaya; Kiran S.,9997,0,9999,2
1657826883425,MATH 197,003,095567,Xiao; Ming,9999,0,9999,0
1657826883425,MATH 197,004,095571,Perols; Johan Lars,9998,0,9999,1
1657826890486,COGS 9,A01,083615,Shannon; Kyle Michael,9,0,75,66
1657826896508,COGS 11,A01,083617,Boyle; Mary E. T.,23,0,48,25
1657826902530,COGS 13,A01,083071,Bastos; Amalia Pinkusfeld,11,0,71,60
1657826908552,COGS 14A,A01,092681,Semenuks; Arturs,5,1,100,95
1657826914575,COGS 14B,A01,083073,Cheng; Tzu-Han,6,0,63,57
1657826920606,COGS 17,A01,092677,Semenuks; Arturs,6,0,81,75
1657826926631,COGS 100,A01,083619,Allen; Michael Gordon,17,0,70,53
1657826932654,COGS 101A,A01,083621,Davis; Joshua Daniel,9,0,68,59
1657826938688,COGS 101B,A01,091572,Allen; Michael Gordon,12,0,65,53
1657826944709,COGS 101C,A01,083625,Delgado; Tania,17,0,35,18
1657826950732,COGS 107A,A01,083627,Boyle; Mary E. T.,14,0,60,46
1657826956758,COGS 118A,A01,083075,Gupta; Anjum,21,0,76,55
1657826962783,CSE 3,A50,083646,Miranda; Gregory Joseph,24,0,50,26
1657826968806,CSE 8A,A50,083650,Miranda; Gregory Joseph,17,1,56,39
1657826974832,CSE 11,A01,083080,Cao; Yingjun,6,15,40,34
1657826980856,CSE 12,A01,083652,Krause-Levy; Sophia Louisa,29,1,120,91
1657826986883,CSE 15L,A01,083654,Morris; Justin Loren,9,0,50,41
1657826986883,CSE 15L,A02,083655,Morris; Justin Loren,9,0,50,41
1657826992912,CSE 20,A01,083657,Tran; Khoa Dang,39,0,80,41
1657826998936,CSE 21,A01,095574,Bach; Quang Tran,22,0,48,26
1657827004969,CSE 30,A01,083084,Eldon; John,6,0,80,74
1657827004969,CSE 30,B01,095061,Bhaskar; Nishant,9,0,50,41
1657827010994,CSE 100,A01,083659,Cao; Yingjun,5,4,70,65
1657827017020,CSE 134B,A01,083661,Powell; Thomas Allan,24,0,100,76
1657827023049,CSE 140,A01,083663,Gungor; Onat,15,0,85,70
1657827029072,CSE 140L,A01,083088,Eldon; John,23,0,100,77
1657827035098,CSE 175,A01,083665,Kumar; Rakesh,3,0,25,22
1657827041124,CSE 190,A00,092507,Dubnov; Shlomo,8,0,20,12
1657827047154,ECE 45,A01,083139,Congero; Spencer William,6,0,75,69
1657827053176,ECE 65,A50,083695,Saad; Andrew S,12,0,30,18
1657827053176,ECE 65,A51,095125,Saad; Andrew S,24,0,26,2
1657827059204,ECE 109,A01,091882,Touri; Behrouz,20,0,70,50
1657827065301,ECE 180,A00,083140,Abi Samra; Nicholas Camill,1,0,30,29
1657827065301,ECE 180,B00,083141,Abi Samra; Nicholas Camill,0,0,30,30
1657827071327,MATH 10A,A01,083735,Patchell; Gregory David,2,0,30,28
1657827071327,MATH 10A,A02,083736,Patchell; Gregory David,20,0,30,10
1657827071327,MATH 10A,A03,083737,Patchell; Gregory David,16,0,30,14
1657827077351,MATH 10B,A01,083207,Lim; Seonhee,8,0,34,26
1657827077351,MATH 10B,A02,083208,Lim; Seonhee,10,0,35,25
1657827077351,MATH 10B,A03,093472,Lim; Seonhee,7,0,34,27
1657827077351,MATH 10B,B01,083739,Sinha; Shubham,13,0,30,17
1657827083380,MATH 18,A01,083743,Cinel; Cameron Alexander,9,0,30,21
1657827083380,MATH 18,A02,083744,Cinel; Cameron Alexander,18,0,30,12
1657827083380,MATH 18,A03,083745,Cinel; Cameron Alexander,10,0,30,20
1657827083380,MATH 18,B01,083748,Rideout; David Porter,5,0,37,32
1657827083380,MATH 18,B02,083749,Rideout; David Porter,5,0,36,31
1657827083380,MATH 18,B03,083750,Rideout; David Porter,3,0,37,34
1657827083380,MATH 18,B04,083751,Rideout; David Porter,6,0,36,30
1657827083380,MATH 18,B05,093473,Rideout; David Porter,6,0,36,30
1657827083380,MATH 18,B06,093474,Rideout; David Porter,6,0,36,30
1657827089411,MATH 20A,A01,083754,Zheng; Zequn,14,0,40,26
1657827095434,MATH 20B,A01,083756,Briones; Jor-el Thomas Caparas,4,0,36,32
1657827095434,MATH 20B,A02,083757,Briones; Jor-el Thomas Caparas,1,0,36,35
1657827095434,MATH 20B,A03,093475,Briones; Jor-el Thomas Caparas,2,0,36,34
1657827101463,MATH 20C,A01,083760,Briones; Jor-el Thomas Caparas,1,0,35,34
1657827101463,MATH 20C,A02,083761,Briones; Jor-el Thomas Caparas,8,0,35,27
1657827101463,MATH 20C,A03,093476,Briones; Jor-el Thomas Caparas,0,1,36,36
1657827101463,MATH 20C,B01,083762,Bach; Quang Tran,1,0,30,29
1657827107487,MATH 20D,A01,083765,Tran; Brian Kha,5,0,30,25
1657827107487,MATH 20D,A02,083766,Tran; Brian Kha,5,0,30,25
1657827107487,MATH 20D,A03,083767,Tran; Brian Kha,5,0,30,25
1657827123614,MATH 20E,A01,083771,Ganguly; Soumya,10,0,32,22
1657827123614,MATH 20E,A02,083772,Ganguly; Soumya,6,0,32,26
1657827123614,MATH 20E,B01,083773,Ciotti; Benjamin,20,0,35,15
1657827123614,MATH 20E,B02,083774,Ciotti; Benjamin,18,0,35,17
1657827129647,MATH 103A,A01,083777,Greenfeld; Be'Eri,3,0,36,33
1657827129647,MATH 103A,A02,083778,Greenfeld; Be'Eri,5,0,36,31
1657827129647,MATH 103A,A03,093561,Greenfeld; Be'Eri,6,0,36,30
1657827129647,MATH 103A,B01,083779,Greenfeld; Be'Eri,7,0,36,29
1657827129647,MATH 103A,B02,083780,Greenfeld; Be'Eri,4,0,36,32
1657827129647,MATH 103A,B03,093562,Greenfeld; Be'Eri,3,0,36,33
1657827135670,MATH 105,A01,085443,Carter; Anne Toulson,15,0,35,20
1657827135670,MATH 105,A02,093477,Carter; Anne Toulson,20,0,35,15
1657827141703,MATH 109,A01,083213,Ganzberger; Geoffrey Michael,3,0,34,31
1657827141703,MATH 109,A02,083214,Ganzberger; Geoffrey Michael,4,0,34,30
1657827141703,MATH 109,A03,093478,Ganzberger; Geoffrey Michael,2,0,34,32
1657827141703,MATH 109,B01,083215,Ganzberger; Geoffrey Michael,1,0,32,31
1657827141703,MATH 109,B02,083216,Ganzberger; Geoffrey Michael,2,0,32,30
1657827141703,MATH 109,B03,093479,Ganzberger; Geoffrey Michael,8,0,32,24
1657827147738,MATH 142A,A01,083219,Chow; Bennett,7,0,32,25
1657827147738,MATH 142A,A02,083220,Chow; Bennett,10,0,32,22
1657827147738,MATH 142A,A03,093480,Chow; Bennett,9,0,32,23
1657827147738,MATH 142A,B03,093481,Chow; Bennett,8,0,32,24
1657827147738,MATH 142A,B04,093558,Chow; Bennett,13,0,32,19
1657827147738,MATH 142A,B05,093559,Chow; Bennett,7,0,32,25
1657827153766,MATH 193A,A01,083224,Rotar; Vladimir,8,0,34,26
1657827153766,MATH 193A,A02,083225,Rotar; Vladimir,10,0,34,24
1657827153766,MATH 193A,A03,083781,Rotar; Vladimir,5,0,34,29
1657827153766,MATH 193A,A04,083782,Rotar; Vladimir,11,0,34,23
1657827153766,MATH 193A,A05,093482,Rotar; Vladimir,10,0,34,24
1657827159798,MATH 197,001,091859,McAuley; Julian John,9999,0,9999,0
1657827159798,MATH 197,002,095566,Kedlaya; Kiran S.,9997,0,9999,2
1657827159798,MATH 197,003,095567,Xiao; Ming,9999,0,9999,0
1657827159798,MATH 197,004,095571,Perols; Johan Lars,9998,0,9999,1
1657827166853,COGS 9,A01,083615,Shannon; Kyle Michael,9,0,75,66
1657827172877,COGS 11,A01,083617,Boyle; Mary E. T.,23,0,48,25
1657827178899,COGS 13,A01,083071,Bastos; Amalia Pinkusfeld,11,0,71,60
1657827184924,COGS 14A,A01,092681,Semenuks; Arturs,5,1,100,95
1657827190957,COGS 14B,A01,083073,Cheng; Tzu-Han,6,0,63,57
1657827196985,COGS 17,A01,092677,Semenuks; Arturs,6,0,81,75
1657827203007,COGS 100,A01,083619,Allen; Michael Gordon,17,0,70,53
1657827209034,COGS 101A,A01,083621,Davis; Joshua Daniel,9,0,68,59
1657827215076,COGS 101B,A01,091572,Allen; Michael Gordon,12,0,65,53
1657827221117,COGS 101C,A01,083625,Delgado; Tania,17,0,35,18
1657827227139,COGS 107A,A01,083627,Boyle; Mary E. T.,14,0,60,46
1657827233165,COGS 118A,A01,083075,Gupta; Anjum,21,0,76,55
1657827239190,CSE 3,A50,083646,Miranda; Gregory Joseph,24,0,50,26
1657827245214,CSE 8A,A50,083650,Miranda; Gregory Joseph,17,1,56,39
1657827251243,CSE 11,A01,083080,Cao; Yingjun,6,15,40,34
1657827257266,CSE 12,A01,083652,Krause-Levy; Sophia Louisa,29,1,120,91
1657827263290,CSE 15L,A01,083654,Morris; Justin Loren,9,0,50,41
1657827263290,CSE 15L,A02,083655,Morris; Justin Loren,9,0,50,41
1657827269312,CSE 20,A01,083657,Tran; Khoa Dang,39,0,80,41
1657827275336,CSE 21,A01,095574,Bach; Quang Tran,22,0,48,26
1657827281360,CSE 30,A01,083084,Eldon; John,6,0,80,74
1657827281360,CSE 30,B01,095061,Bhaskar; Nishant,9,0,50,41
1657827287399,CSE 100,A01,083659,Cao; Yingjun,5,4,70,65
1657827293424,CSE 134B,A01,083661,Powell; Thomas Allan,24,0,100,76
1657827299446,CSE 140,A01,083663,Gungor; Onat,15,0,85,70
1657827305469,CSE 140L,A01,083088,Eldon; John,23,0,100,77
1657827311497,CSE 175,A01,083665,Kumar; Rakesh,3,0,25,22
1657827317528,CSE 190,A00,092507,Dubnov; Shlomo,8,0,20,12
1657827323552,ECE 45,A01,083139,Congero; Spencer William,6,0,75,69
1657827329576,ECE 65,A50,083695,Saad; Andrew S,12,0,30,18
1657827329576,ECE 65,A51,095125,Saad; Andrew S,24,0,26,2
1657827335597,ECE 109,A01,091882,Touri; Behrouz,20,0,70,50
1657827341621,ECE 180,A00,083140,Abi Samra; Nicholas Camill,1,0,30,29
1657827341621,ECE 180,B00,083141,Abi Samra; Nicholas Camill,0,0,30,30
1657827347644,MATH 10A,A01,083735,Patchell; Gregory David,2,0,30,28
1657827347644,MATH 10A,A02,083736,Patchell; Gregory David,20,0,30,10
1657827347644,MATH 10A,A03,083737,Patchell; Gregory David,16,0,30,14
1657827353668,MATH 10B,A01,083207,Lim; Seonhee,8,0,34,26
1657827353668,MATH 10B,A02,083208,Lim; Seonhee,10,0,35,25
1657827353668,MATH 10B,A03,093472,Lim; Seonhee,7,0,34,27
1657827353668,MATH 10B,B01,083739,Sinha; Shubham,13,0,30,17
1657827359692,MATH 18,A01,083743,Cinel; Cameron Alexander,9,0,30,21
1657827359692,MATH 18,A02,083744,Cinel; Cameron Alexander,18,0,30,12
1657827359692,MATH 18,A03,083745,Cinel; Cameron Alexander,10,0,30,20
1657827359692,MATH 18,B01,083748,Rideout; David Porter,5,0,37,32
1657827359692,MATH 18,B02,083749,Rideout; David Porter,5,0,36,31
1657827359692,MATH 18,B03,083750,Rideout; David Porter,3,0,37,34
1657827359692,MATH 18,B04,083751,Rideout; David Porter,6,0,36,30
1657827359692,MATH 18,B05,093473,Rideout; David Porter,6,0,36,30
1657827359692,MATH 18,B06,093474,Rideout; David Porter,6,0,36,30
1657827365719,MATH 20A,A01,083754,Zheng; Zequn,14,0,40,26
1657827371748,MATH 20B,A01,083756,Briones; Jor-el Thomas Caparas,4,0,36,32
1657827371748,MATH 20B,A02,083757,Briones; Jor-el Thomas Caparas,1,0,36,35
1657827371748,MATH 20B,A03,093475,Briones; Jor-el Thomas Caparas,2,0,36,34
1657827377773,MATH 20C,A01,083760,Briones; Jor-el Thomas Caparas,1,0,35,34
1657827377773,MATH 20C,A02,083761,Briones; Jor-el Thomas Caparas,8,0,35,27
1657827377773,MATH 20C,A03,093476,Briones; Jor-el Thomas Caparas,0,1,36,36
1657827377773,MATH 20C,B01,083762,Bach; Quang Tran,1,0,30,29
1657827383794,MATH 20D,A01,083765,Tran; Brian Kha,5,0,30,25
1657827383794,MATH 20D,A02,083766,Tran; Brian Kha,5,0,30,25
1657827383794,MATH 20D,A03,083767,Tran; Brian Kha,5,0,30,25
1657827389822,MATH 20E,A01,083771,Ganguly; Soumya,10,0,32,22
1657827389822,MATH 20E,A02,083772,Ganguly; Soumya,6,0,32,26
1657827389822,MATH 20E,B01,083773,Ciotti; Benjamin,20,0,35,15
1657827389822,MATH 20E,B02,083774,Ciotti; Benjamin,18,0,35,17
1657827395848,MATH 103A,A01,083777,Greenfeld; Be'Eri,3,0,36,33
1657827395848,MATH 103A,A02,083778,Greenfeld; Be'Eri,5,0,36,31
1657827395848,MATH 103A,A03,093561,Greenfeld; Be'Eri,6,0,36,30
1657827395848,MATH 103A,B01,083779,Greenfeld; Be'Eri,7,0,36,29
1657827395848,MATH 103A,B02,083780,Greenfeld; Be'Eri,4,0,36,32
1657827395848,MATH 103A,B03,093562,Greenfeld; Be'Eri,3,0,36,33
1657827401873,MATH 105,A01,085443,Carter; Anne Toulson,15,0,35,20
1657827401873,MATH 105,A02,093477,Carter; Anne Toulson,20,0,35,15
1657827407898,MATH 109,A01,083213,Ganzberger; Geoffrey Michael,3,0,34,31
1657827407898,MATH 109,A02,083214,Ganzberger; Geoffrey Michael,4,0,34,30
1657827407898,MATH 109,A03,093478,Ganzberger; Geoffrey Michael,2,0,34,32
1657827407898,MATH 109,B01,083215,Ganzberger; Geoffrey Michael,1,0,32,31
1657827407898,MATH 109,B02,083216,Ganzberger; Geoffrey Michael,2,0,32,30
1657827407898,MATH 109,B03,093479,Ganzberger; Geoffrey Michael,8,0,32,24
1657827413926,MATH 142A,A01,083219,Chow; Bennett,7,0,32,25
1657827413926,MATH 142A,A02,083220,Chow; Bennett,10,0,32,22
1657827413926,MATH 142A,A03,093480,Chow; Bennett,9,0,32,23
1657827413926,MATH 142A,B03,093481,Chow; Bennett,8,0,32,24
1657827413926,MATH 142A,B04,093558,Chow; Bennett,13,0,32,19
1657827413926,MATH 142A,B05,093559,Chow; Bennett,7,0,32,25
1657827419953,MATH 193A,A01,083224,Rotar; Vladimir,8,0,34,26
1657827419953,MATH 193A,A02,083225,Rotar; Vladimir,10,0,34,24
1657827419953,MATH 193A,A03,083781,Rotar; Vladimir,5,0,34,29
1657827419953,MATH 193A,A04,083782,Rotar; Vladimir,11,0,34,23
1657827419953,MATH 193A,A05,093482,Rotar; Vladimir,10,0,34,24
1657827425976,MATH 197,001,091859,McAuley; Julian John,9999,0,9999,0
1657827425976,MATH 197,002,095566,Kedlaya; Kiran S.,9997,0,9999,2
1657827425976,MATH 197,003,095567,Xiao; Ming,9999,0,9999,0
1657827425976,MATH 197,004,095571,Perols; Johan Lars,9998,0,9999,1
1657827433040,COGS 9,A01,083615,Shannon; Kyle Michael,9,0,75,66
1657827439064,COGS 11,A01,083617,Boyle; Mary E. T.,23,0,48,25
1657827445088,COGS 13,A01,083071,Bastos; Amalia Pinkusfeld,11,0,71,60
1657827451115,COGS 14A,A01,092681,Semenuks; Arturs,5,1,100,95
1657827457139,COGS 14B,A01,083073,Cheng; Tzu-Han,6,0,63,57
1657827463174,COGS 17,A01,092677,Semenuks; Arturs,6,0,81,75
1657827469197,COGS 100,A01,083619,Allen; Michael Gordon,17,0,70,53
1657827475234,COGS 101A,A01,083621,Davis; Joshua Daniel,9,0,68,59
1657827481262,COGS 101B,A01,091572,Allen; Michael Gordon,12,0,65,53
1657827487286,COGS 101C,A01,083625,Delgado; Tania,17,0,35,18
1657827493309,COGS 107A,A01,083627,Boyle; Mary E. T.,14,0,60,46
1657827499335,COGS 118A,A01,083075,Gupta; Anjum,21,0,76,55
1657827505363,CSE 3,A50,083646,Miranda; Gregory Joseph,24,0,50,26
1657827511387,CSE 8A,A50,083650,Miranda; Gregory Joseph,17,1,56,39
1657827517413,CSE 11,A01,083080,Cao; Yingjun,6,15,40,34
1657827523441,CSE 12,A01,083652,Krause-Levy; Sophia Louisa,29,1,120,91
1657827529464,CSE 15L,A01,083654,Morris; Justin Loren,9,0,50,41
1657827529464,CSE 15L,A02,083655,Morris; Justin Loren,9,0,50,41
1657827535490,CSE 20,A01,083657,Tran; Khoa Dang,39,0,80,41
1657827541516,CSE 21,A01,095574,Bach; Quang Tran,22,0,48,26
1657827547539,CSE 30,A01,083084,Eldon; John,6,0,80,74
1657827547539,CSE 30,B01,095061,Bhaskar; Nishant,9,0,50,41
1657827553560,CSE 100,A01,083659,Cao; Yingjun,5,4,70,65
1657827559582,CSE 134B,A01,083661,Powell; Thomas Allan,24,0,100,76
1657827565605,CSE 140,A01,083663,Gungor; Onat,15,0,85,70
1657827571633,CSE 140L,A01,083088,Eldon; John,23,0,100,77
1657827577658,CSE 175,A01,083665,Kumar; Rakesh,3,0,25,22
1657827583680,CSE 190,A00,092507,Dubnov; Shlomo,8,0,20,12
1657827589714,ECE 45,A01,083139,Congero; Spencer William,6,0,75,69
1657827595738,ECE 65,A50,083695,Saad; Andrew S,12,0,30,18
1657827595738,ECE 65,A51,095125,Saad; Andrew S,24,0,26,2
1657827601764,ECE 109,A01,091882,Touri; Behrouz,20,0,70,50
1657827607789,ECE 180,A00,083140,Abi Samra; Nicholas Camill,1,0,30,29
1657827607789,ECE 180,B00,083141,Abi Samra; Nicholas Camill,0,0,30,30
1657827613818,MATH 10A,A01,083735,Patchell; Gregory David,2,0,30,28
1657827613818,MATH 10A,A02,083736,Patchell; Gregory David,20,0,30,10
1657827613818,MATH 10A,A03,083737,Patchell; Gregory David,16,0,30,14
1657827619840,MATH 10B,A01,083207,Lim; Seonhee,8,0,34,26
1657827619840,MATH 10B,A02,083208,Lim; Seonhee,10,0,35,25
1657827619840,MATH 10B,A03,093472,Lim; Seonhee,7,0,34,27
1657827619840,MATH 10B,B01,083739,Sinha; Shubham,13,0,30,17
1657827625869,MATH 18,A01,083743,Cinel; Cameron Alexander,9,0,30,21
1657827625869,MATH 18,A02,083744,Cinel; Cameron Alexander,18,0,30,12
1657827625869,MATH 18,A03,083745,Cinel; Cameron Alexander,10,0,30,20
1657827625869,MATH 18,B01,083748,Rideout; David Porter,5,0,37,32
1657827625869,MATH 18,B02,083749,Rideout; David Porter,5,0,36,31
1657827625869,MATH 18,B03,083750,Rideout; David Porter,3,0,37,34
1657827625869,MATH 18,B04,083751,Rideout; David Porter,6,0,36,30
1657827625869,MATH 18,B05,093473,Rideout; David Porter,6,0,36,30
1657827625869,MATH 18,B06,093474,Rideout; David Porter,6,0,36,30
1657827631895,MATH 20A,A01,083754,Zheng; Zequn,14,0,40,26
1657827637920,MATH 20B,A01,083756,Briones; Jor-el Thomas Caparas,4,0,36,32
1657827637920,MATH 20B,A02,083757,Briones; Jor-el Thomas Caparas,1,0,36,35
1657827637920,MATH 20B,A03,093475,Briones; Jor-el Thomas Caparas,2,0,36,34
1657827643947,MATH 20C,A01,083760,Briones; Jor-el Thomas Caparas,1,0,35,34
1657827643947,MATH 20C,A02,083761,Briones; Jor-el Thomas Caparas,8,0,35,27
1657827643947,MATH 20C,A03,093476,Briones; Jor-el Thomas Caparas,0,1,36,36
1657827643947,MATH 20C,B01,083762,Bach; Quang Tran,1,0,30,29
1657827649975,MATH 20D,A01,083765,Tran; Brian Kha,5,0,30,25
1657827649975,MATH 20D,A02,083766,Tran; Brian Kha,5,0,30,25
1657827649975,MATH 20D,A03,083767,Tran; Brian Kha,5,0,30,25
1657827655999,MATH 20E,A01,083771,Ganguly; Soumya,10,0,32,22
1657827655999,MATH 20E,A02,083772,Ganguly; Soumya,6,0,32,26
1657827655999,MATH 20E,B01,083773,Ciotti; Benjamin,20,0,35,15
1657827655999,MATH 20E,B02,083774,Ciotti; Benjamin,18,0,35,17
1657827662023,MATH 103A,A01,083777,Greenfeld; Be'Eri,3,0,36,33
1657827662023,MATH 103A,A02,083778,Greenfeld; Be'Eri,5,0,36,31
1657827662023,MATH 103A,A03,093561,Greenfeld; Be'Eri,6,0,36,30
1657827662023,MATH 103A,B01,083779,Greenfeld; Be'Eri,7,0,36,29
1657827662023,MATH 103A,B02,083780,Greenfeld; Be'Eri,4,0,36,32
1657827662023,MATH 103A,B03,093562,Greenfeld; Be'Eri,3,0,36,33
1657827668045,MATH 105,A01,085443,Carter; Anne Toulson,15,0,35,20
1657827668045,MATH 105,A02,093477,Carter; Anne Toulson,20,0,35,15
1657827674142,MATH 109,A01,083213,Ganzberger; Geoffrey Michael,3,0,34,31
1657827674142,MATH 109,A02,083214,Ganzberger; Geoffrey Michael,4,0,34,30
1657827674142,MATH 109,A03,093478,Ganzberger; Geoffrey Michael,2,0,34,32
1657827674142,MATH 109,B01,083215,Ganzberger; Geoffrey Michael,1,0,32,31
1657827674142,MATH 109,B02,083216,Ganzberger; Geoffrey Michael,2,0,32,30
1657827674142,MATH 109,B03,093479,Ganzberger; Geoffrey Michael,8,0,32,24
1657827680180,MATH 142A,A01,083219,Chow; Bennett,7,0,32,25
1657827680180,MATH 142A,A02,083220,Chow; Bennett,10,0,32,22
1657827680180,MATH 142A,A03,093480,Chow; Bennett,9,0,32,23
1657827680180,MATH 142A,B03,093481,Chow; Bennett,8,0,32,24
1657827680180,MATH 142A,B04,093558,Chow; Bennett,13,0,32,19
1657827680180,MATH 142A,B05,093559,Chow; Bennett,7,0,32,25
1657827686202,MATH 193A,A01,083224,Rotar; Vladimir,8,0,34,26
1657827686202,MATH 193A,A02,083225,Rotar; Vladimir,10,0,34,24
1657827686202,MATH 193A,A03,083781,Rotar; Vladimir,5,0,34,29
1657827686202,MATH 193A,A04,083782,Rotar; Vladimir,11,0,34,23
1657827686202,MATH 193A,A05,093482,Rotar; Vladimir,10,0,34,24
1657827692229,MATH 197,001,091859,McAuley; Julian John,9999,0,9999,0
1657827692229,MATH 197,002,095566,Kedlaya; Kiran S.,9997,0,9999,2
1657827692229,MATH 197,003,095567,Xiao; Ming,9999,0,9999,0
1657827692229,MATH 197,004,095571,Perols; Johan Lars,9998,0,9999,1
1657827699276,COGS 9,A01,083615,Shannon; Kyle Michael,9,0,75,66
1657827705303,COGS 11,A01,083617,Boyle; Mary E. T.,23,0,48,25
1657827711330,COGS 13,A01,083071,Bastos; Amalia Pinkusfeld,11,0,71,60
1657827717356,COGS 14A,A01,092681,Semenuks; Arturs,5,1,100,95
1657827723379,COGS 14B,A01,083073,Cheng; Tzu-Han,6,0,63,57
1657827729402,COGS 17,A01,092677,Semenuks; Arturs,6,0,81,75
1657827735429,COGS 100,A01,083619,Allen; Michael Gordon,17,0,70,53
1657827741451,COGS 101A,A01,083621,Davis; Joshua Daniel,9,0,68,59
1657827747478,COGS 101B,A01,091572,Allen; Michael Gordon,12,0,65,53
1657827753509,COGS 101C,A01,083625,Delgado; Tania,17,0,35,18
1657827759537,COGS 107A,A01,083627,Boyle; Mary E. T.,14,0,60,46
1657827765559,COGS 118A,A01,083075,Gupta; Anjum,21,0,76,55
1657827771582,CSE 3,A50,083646,Miranda; Gregory Joseph,24,0,50,26
1657827777608,CSE 8A,A50,083650,Miranda; Gregory Joseph,17,1,56,39
1657827783635,CSE 11,A01,083080,Cao; Yingjun,6,15,40,34
1657827789664,CSE 12,A01,083652,Krause-Levy; Sophia Louisa,29,1,120,91
1657827795687,CSE 15L,A01,083654,Morris; Justin Loren,9,0,50,41
1657827795687,CSE 15L,A02,083655,Morris; Justin Loren,9,0,50,41
1657827801710,CSE 20,A01,083657,Tran; Khoa Dang,39,0,80,41
1657827807732,CSE 21,A01,095574,Bach; Quang Tran,22,0,48,26
1657827813765,CSE 30,A01,083084,Eldon; John,6,0,80,74
1657827813765,CSE 30,B01,095061,Bhaskar; Nishant,9,0,50,41
1657827819789,CSE 100,A01,083659,Cao; Yingjun,5,4,70,65
1657827825815,CSE 134B,A01,083661,Powell; Thomas Allan,24,0,100,76
1657827831838,CSE 140,A01,083663,Gungor; Onat,15,0,85,70
1657827837862,CSE 140L,A01,083088,Eldon; John,23,0,100,77
1657827843891,CSE 175,A01,083665,Kumar; Rakesh,3,0,25,22
1657827849915,CSE 190,A00,092507,Dubnov; Shlomo,8,0,20,12
1657827855937,ECE 45,A01,083139,Congero; Spencer William,6,0,75,69
1657827861962,ECE 65,A50,083695,Saad; Andrew S,12,0,30,18
1657827861962,ECE 65,A51,095125,Saad; Andrew S,24,0,26,2
1657827867984,ECE 109,A01,091882,Touri; Behrouz,20,0,70,50
1657827874006,ECE 180,A00,083140,Abi Samra; Nicholas Camill,1,0,30,29
1657827874006,ECE 180,B00,083141,Abi Samra; Nicholas Camill,0,0,30,30
1657827880033,MATH 10A,A01,083735,Patchell; Gregory David,2,0,30,28
1657827880033,MATH 10A,A02,083736,Patchell; Gregory David,20,0,30,10
1657827880033,MATH 10A,A03,083737,Patchell; Gregory David,16,0,30,14
1657827886056,MATH 10B,A01,083207,Lim; Seonhee,8,0,34,26
1657827886056,MATH 10B,A02,083208,Lim; Seonhee,10,0,35,25
1657827886056,MATH 10B,A03,093472,Lim; Seonhee,7,0,34,27
1657827886056,MATH 10B,B01,083739,Sinha; Shubham,13,0,30,17
1657827892079,MATH 18,A01,083743,Cinel; Cameron Alexander,9,0,30,21
1657827892079,MATH 18,A02,083744,Cinel; Cameron Alexander,18,0,30,12
1657827892079,MATH 18,A03,083745,Cinel; Cameron Alexander,10,0,30,20
1657827892079,MATH 18,B01,083748,Rideout; David Porter,5,0,37,32
1657827892079,MATH 18,B02,083749,Rideout; David Porter,5,0,36,31
1657827892079,MATH 18,B03,083750,Rideout; David Porter,3,0,37,34
1657827892079,MATH 18,B04,083751,Rideout; David Porter,6,0,36,30
1657827892079,MATH 18,B05,093473,Rideout; David Porter,6,0,36,30
1657827892079,MATH 18,B06,093474,Rideout; David Porter,6,0,36,30
1657827898104,MATH 20A,A01,083754,Zheng; Zequn,14,0,40,26
1657827904126,MATH 20B,A01,083756,Briones; Jor-el Thomas Caparas,4,0,36,32
1657827904126,MATH 20B,A02,083757,Briones; Jor-el Thomas Caparas,1,0,36,35
1657827904126,MATH 20B,A03,093475,Briones; Jor-el Thomas Caparas,2,0,36,34
1657827910149,MATH 20C,A01,083760,Briones; Jor-el Thomas Caparas,1,0,35,34
1657827910149,MATH 20C,A02,083761,Briones; Jor-el Thomas Caparas,8,0,35,27
1657827910149,MATH 20C,A03,093476,Briones; Jor-el Thomas Caparas,0,1,36,36
1657827910149,MATH 20C,B01,083762,Bach; Quang Tran,1,0,30,29
1657827916175,MATH 20D,A01,083765,Tran; Brian Kha,5,0,30,25
1657827916175,MATH 20D,A02,083766,Tran; Brian Kha,5,0,30,25
1657827916175,MATH 20D,A03,083767,Tran; Brian Kha,5,0,30,25
1657827922198,MATH 20E,A01,083771,Ganguly; Soumya,10,0,32,22
1657827922198,MATH 20E,A02,083772,Ganguly; Soumya,6,0,32,26
1657827922198,MATH 20E,B01,083773,Ciotti; Benjamin,20,0,35,15
1657827922198,MATH 20E,B02,083774,Ciotti; Benjamin,18,0,35,17
1657827928227,MATH 103A,A01,083777,Greenfeld; Be'Eri,3,0,36,33
1657827928227,MATH 103A,A02,083778,Greenfeld; Be'Eri,5,0,36,31
1657827928227,MATH 103A,A03,093561,Greenfeld; Be'Eri,6,0,36,30
1657827928227,MATH 103A,B01,083779,Greenfeld; Be'Eri,7,0,36,29
1657827928227,MATH 103A,B02,083780,Greenfeld; Be'Eri,4,0,36,32
1657827928227,MATH 103A,B03,093562,Greenfeld; Be'Eri,3,0,36,33
1657827934249,MATH 105,A01,085443,Carter; Anne Toulson,15,0,35,20
1657827934249,MATH 105,A02,093477,Carter; Anne Toulson,20,0,35,15
1657827940275,MATH 109,A01,083213,Ganzberger; Geoffrey Michael,3,0,34,31
1657827940275,MATH 109,A02,083214,Ganzberger; Geoffrey Michael,4,0,34,30
1657827940275,MATH 109,A03,093478,Ganzberger; Geoffrey Michael,2,0,34,32
1657827940275,MATH 109,B01,083215,Ganzberger; Geoffrey Michael,1,0,32,31
1657827940275,MATH 109,B02,083216,Ganzberger; Geoffrey Michael,2,0,32,30
1657827940275,MATH 109,B03,093479,Ganzberger; Geoffrey Michael,8,0,32,24
1657827946312,MATH 142A,A01,083219,Chow; Bennett,7,0,32,25
1657827946312,MATH 142A,A02,083220,Chow; Bennett,10,0,32,22
1657827946312,MATH 142A,A03,093480,Chow; Bennett,9,0,32,23
1657827946312,MATH 142A,B03,093481,Chow; Bennett,8,0,32,24
1657827946312,MATH 142A,B04,093558,Chow; Bennett,13,0,32,19
1657827946312,MATH 142A,B05,093559,Chow; Bennett,7,0,32,25
1657827952354,MATH 193A,A01,083224,Rotar; Vladimir,8,0,34,26
1657827952354,MATH 193A,A02,083225,Rotar; Vladimir,10,0,34,24
1657827952354,MATH 193A,A03,083781,Rotar; Vladimir,5,0,34,29
1657827952354,MATH 193A,A04,083782,Rotar; Vladimir,11,0,34,23
1657827952354,MATH 193A,A05,093482,Rotar; Vladimir,10,0,34,24
1657827958378,MATH 197,001,091859,McAuley; Julian John,9999,0,9999,0
1657827958378,MATH 197,002,095566,Kedlaya; Kiran S.,9997,0,9999,2
1657827958378,MATH 197,003,095567,Xiao; Ming,9999,0,9999,0
1657827958378,MATH 197,004,095571,Perols; Johan Lars,9998,0,9999,1
1657827965437,COGS 9,A01,083615,Shannon; Kyle Michael,9,0,75,66
1657827971463,COGS 11,A01,083617,Boyle; Mary E. T.,23,0,48,25
1657827977488,COGS 13,A01,083071,Bastos; Amalia Pinkusfeld,11,0,71,60
1657827983512,COGS 14A,A01,092681,Semenuks; Arturs,5,1,100,95
1657827989537,COGS 14B,A01,083073,Cheng; Tzu-Han,6,0,63,57
1657827995563,COGS 17,A01,092677,Semenuks; Arturs,6,0,81,75
1657828001592,COGS 100,A01,083619,Allen; Michael Gordon,17,0,70,53
1657828007617,COGS 101A,A01,083621,Davis; Joshua Daniel,9,0,68,59
1657828013642,COGS 101B,A01,091572,Allen; Michael Gordon,12,0,65,53
1657828019664,COGS 101C,A01,083625,Delgado; Tania,17,0,35,18
1657828025686,COGS 107A,A01,083627,Boyle; Mary E. T.,14,0,60,46
1657828031712,COGS 118A,A01,083075,Gupta; Anjum,21,0,76,55
1657828037735,CSE 3,A50,083646,Miranda; Gregory Joseph,24,0,50,26
1657828043762,CSE 8A,A50,083650,Miranda; Gregory Joseph,17,1,56,39
1657828049784,CSE 11,A01,083080,Cao; Yingjun,6,15,40,34
1657828055807,CSE 12,A01,083652,Krause-Levy; Sophia Louisa,29,1,120,91
1657828061840,CSE 15L,A01,083654,Morris; Justin Loren,9,0,50,41
1657828061840,CSE 15L,A02,083655,Morris; Justin Loren,9,0,50,41
1657828067867,CSE 20,A01,083657,Tran; Khoa Dang,39,0,80,41
1657828073893,CSE 21,A01,095574,Bach; Quang Tran,22,0,48,26
1657828079925,CSE 30,A01,083084,Eldon; John,6,0,80,74
1657828079925,CSE 30,B01,095061,Bhaskar; Nishant,9,0,50,41
1657828085947,CSE 100,A01,083659,Cao; Yingjun,5,4,70,65
1657828091980,CSE 134B,A01,083661,Powell; Thomas Allan,24,0,100,76
1657828098021,CSE 140,A01,083663,Gungor; Onat,15,0,85,70
1657828104055,CSE 140L,A01,083088,Eldon; John,23,0,100,77
1657828110079,CSE 175,A01,083665,Kumar; Rakesh,3,0,25,22
1657828116103,CSE 190,A00,092507,Dubnov; Shlomo,8,0,20,12
1657828122138,ECE 45,A01,083139,Congero; Spencer William,6,0,75,69
1657828128161,ECE 65,A50,083695,Saad; Andrew S,12,0,30,18
1657828128161,ECE 65,A51,095125,Saad; Andrew S,24,0,26,2
1657828134187,ECE 109,A01,091882,Touri; Behrouz,20,0,70,50
1657828140214,ECE 180,A00,083140,Abi Samra; Nicholas Camill,1,0,30,29
1657828140214,ECE 180,B00,083141,Abi Samra; Nicholas Camill,0,0,30,30
1657828146236,MATH 10A,A01,083735,Patchell; Gregory David,2,0,30,28
1657828146236,MATH 10A,A02,083736,Patchell; Gregory David,20,0,30,10
1657828146236,MATH 10A,A03,083737,Patchell; Gregory David,16,0,30,14
1657828152273,MATH 10B,A01,083207,Lim; Seonhee,8,0,34,26
1657828152273,MATH 10B,A02,083208,Lim; Seonhee,10,0,35,25
1657828152273,MATH 10B,A03,093472,Lim; Seonhee,7,0,34,27
1657828152273,MATH 10B,B01,083739,Sinha; Shubham,13,0,30,17
1657828158299,MATH 18,A01,083743,Cinel; Cameron Alexander,9,0,30,21
1657828158299,MATH 18,A02,083744,Cinel; Cameron Alexander,18,0,30,12
1657828158299,MATH 18,A03,083745,Cinel; Cameron Alexander,10,0,30,20
1657828158299,MATH 18,B01,083748,Rideout; David Porter,5,0,37,32
1657828158299,MATH 18,B02,083749,Rideout; David Porter,5,0,36,31
1657828158299,MATH 18,B03,083750,Rideout; David Porter,3,0,37,34
1657828158299,MATH 18,B04,083751,Rideout; David Porter,6,0,36,30
1657828158299,MATH 18,B05,093473,Rideout; David Porter,6,0,36,30
1657828158299,MATH 18,B06,093474,Rideout; David Porter,6,0,36,30
1657828164322,MATH 20A,A01,083754,Zheng; Zequn,14,0,40,26
1657828170349,MATH 20B,A01,083756,Briones; Jor-el Thomas Caparas,4,0,36,32
1657828170349,MATH 20B,A02,083757,Briones; Jor-el Thomas Caparas,1,0,36,35
1657828170349,MATH 20B,A03,093475,Briones; Jor-el Thomas Caparas,2,0,36,34
1657828176373,MATH 20C,A01,083760,Briones; Jor-el Thomas Caparas,1,0,35,34
1657828176373,MATH 20C,A02,083761,Briones; Jor-el Thomas Caparas,8,0,35,27
1657828176373,MATH 20C,A03,093476,Briones; Jor-el Thomas Caparas,0,1,36,36
1657828176373,MATH 20C,B01,083762,Bach; Quang Tran,1,0,30,29
1657828182397,MATH 20D,A01,083765,Tran; Brian Kha,5,0,30,25
1657828182397,MATH 20D,A02,083766,Tran; Brian Kha,5,0,30,25
1657828182397,MATH 20D,A03,083767,Tran; Brian Kha,5,0,30,25
1657828188432,MATH 20E,A01,083771,Ganguly; Soumya,10,0,32,22
1657828188432,MATH 20E,A02,083772,Ganguly; Soumya,6,0,32,26
1657828188432,MATH 20E,B01,083773,Ciotti; Benjamin,20,0,35,15
1657828188432,MATH 20E,B02,083774,Ciotti; Benjamin,18,0,35,17
1657828194461,MATH 103A,A01,083777,Greenfeld; Be'Eri,3,0,36,33
1657828194461,MATH 103A,A02,083778,Greenfeld; Be'Eri,5,0,36,31
1657828194461,MATH 103A,A03,093561,Greenfeld; Be'Eri,6,0,36,30
1657828194461,MATH 103A,B01,083779,Greenfeld; Be'Eri,7,0,36,29
1657828194461,MATH 103A,B02,083780,Greenfeld; Be'Eri,4,0,36,32
1657828194461,MATH 103A,B03,093562,Greenfeld; Be'Eri,3,0,36,33
1657828200487,MATH 105,A01,085443,Carter; Anne Toulson,15,0,35,20
1657828200487,MATH 105,A02,093477,Carter; Anne Toulson,20,0,35,15
1657828206524,MATH 109,A01,083213,Ganzberger; Geoffrey Michael,3,0,34,31
1657828206524,MATH 109,A02,083214,Ganzberger; Geoffrey Michael,4,0,34,30
1657828206524,MATH 109,A03,093478,Ganzberger; Geoffrey Michael,2,0,34,32
1657828206524,MATH 109,B01,083215,Ganzberger; Geoffrey Michael,1,0,32,31
1657828206524,MATH 109,B02,083216,Ganzberger; Geoffrey Michael,2,0,32,30
1657828206524,MATH 109,B03,093479,Ganzberger; Geoffrey Michael,8,0,32,24
1657828212553,MATH 142A,A01,083219,Chow; Bennett,7,0,32,25
1657828212553,MATH 142A,A02,083220,Chow; Bennett,10,0,32,22
1657828212553,MATH 142A,A03,093480,Chow; Bennett,9,0,32,23
1657828212553,MATH 142A,B03,093481,Chow; Bennett,8,0,32,24
1657828212553,MATH 142A,B04,093558,Chow; Bennett,13,0,32,19
1657828212553,MATH 142A,B05,093559,Chow; Bennett,7,0,32,25
1657828218581,MATH 193A,A01,083224,Rotar; Vladimir,8,0,34,26
1657828218581,MATH 193A,A02,083225,Rotar; Vladimir,10,0,34,24
1657828218581,MATH 193A,A03,083781,Rotar; Vladimir,5,0,34,29
1657828218581,MATH 193A,A04,083782,Rotar; Vladimir,11,0,34,23
1657828218581,MATH 193A,A05,093482,Rotar; Vladimir,10,0,34,24
1657828224607,MATH 197,001,091859,McAuley; Julian John,9999,0,9999,0
1657828224607,MATH 197,002,095566,Kedlaya; Kiran S.,9997,0,9999,2
1657828224607,MATH 197,003,095567,Xiao; Ming,9999,0,9999,0
1657828224607,MATH 197,004,095571,Perols; Johan Lars,9998,0,9999,1
1657828231680,COGS 9,A01,083615,Shannon; Kyle Michael,9,0,75,66
1657828237706,COGS 11,A01,083617,Boyle; Mary E. T.,23,0,48,25
1657828243729,COGS 13,A01,083071,Bastos; Amalia Pinkusfeld,11,0,71,60
1657828249757,COGS 14A,A01,092681,Semenuks; Arturs,5,1,100,95
1657828255780,COGS 14B,A01,083073,Cheng; Tzu-Han,6,0,63,57
1657828261803,COGS 17,A01,092677,Semenuks; Arturs,6,0,81,75
1657828267909,COGS 100,A01,083619,Allen; Michael Gordon,17,0,70,53
1657828273939,COGS 101A,A01,083621,Davis; Joshua Daniel,9,0,68,59
1657828279967,COGS 101B,A01,091572,Allen; Michael Gordon,12,0,65,53
1657828285988,COGS 101C,A01,083625,Delgado; Tania,17,0,35,18
1657828292010,COGS 107A,A01,083627,Boyle; Mary E. T.,14,0,60,46
1657828298033,COGS 118A,A01,083075,Gupta; Anjum,21,0,76,55
1657828304056,CSE 3,A50,083646,Miranda; Gregory Joseph,24,0,50,26
1657828310081,CSE 8A,A50,083650,Miranda; Gregory Joseph,17,1,56,39
1657828316103,CSE 11,A01,083080,Cao; Yingjun,6,15,40,34
1657828322141,CSE 12,A01,083652,Krause-Levy; Sophia Louisa,29,1,120,91
1657828328165,CSE 15L,A01,083654,Morris; Justin Loren,9,0,50,41
1657828328165,CSE 15L,A02,083655,Morris; Justin Loren,9,0,50,41
1657828334187,CSE 20,A01,083657,Tran; Khoa Dang,39,0,80,41
1657828340213,CSE 21,A01,095574,Bach; Quang Tran,22,0,48,26
1657828346243,CSE 30,A01,083084,Eldon; John,6,0,80,74
1657828346243,CSE 30,B01,095061,Bhaskar; Nishant,9,0,50,41
1657828352268,CSE 100,A01,083659,Cao; Yingjun,5,4,70,65
1657828358296,CSE 134B,A01,083661,Powell; Thomas Allan,24,0,100,76
1657828364320,CSE 140,A01,083663,Gungor; Onat,15,0,85,70
1657828370346,CSE 140L,A01,083088,Eldon; John,23,0,100,77
1657828376375,CSE 175,A01,083665,Kumar; Rakesh,3,0,25,22
1657828382405,CSE 190,A00,092507,Dubnov; Shlomo,8,0,20,12
1657828388445,ECE 45,A01,083139,Congero; Spencer William,6,0,75,69
1657828394469,ECE 65,A50,083695,Saad; Andrew S,12,0,30,18
1657828394469,ECE 65,A51,095125,Saad; Andrew S,24,0,26,2
1657828400492,ECE 109,A01,091882,Touri; Behrouz,20,0,70,50
1657828406513,ECE 180,A00,083140,Abi Samra; Nicholas Camill,1,0,30,29
1657828406513,ECE 180,B00,083141,Abi Samra; Nicholas Camill,0,0,30,30
1657828412541,MATH 10A,A01,083735,Patchell; Gregory David,2,0,30,28
1657828412541,MATH 10A,A02,083736,Patchell; Gregory David,20,0,30,10
1657828412541,MATH 10A,A03,083737,Patchell; Gregory David,16,0,30,14
1657828418570,MATH 10B,A01,083207,Lim; Seonhee,8,0,34,26
1657828418570,MATH 10B,A02,083208,Lim; Seonhee,10,0,35,25
1657828418570,MATH 10B,A03,093472,Lim; Seonhee,7,0,34,27
1657828418570,MATH 10B,B01,083739,Sinha; Shubham,13,0,30,17
1657828424601,MATH 18,A01,083743,Cinel; Cameron Alexander,9,0,30,21
1657828424601,MATH 18,A02,083744,Cinel; Cameron Alexander,18,0,30,12
1657828424601,MATH 18,A03,083745,Cinel; Cameron Alexander,10,0,30,20
1657828424601,MATH 18,B01,083748,Rideout; David Porter,5,0,37,32
1657828424601,MATH 18,B02,083749,Rideout; David Porter,5,0,36,31
1657828424601,MATH 18,B03,083750,Rideout; David Porter,3,0,37,34
1657828424601,MATH 18,B04,083751,Rideout; David Porter,6,0,36,30
1657828424601,MATH 18,B05,093473,Rideout; David Porter,6,0,36,30
1657828424601,MATH 18,B06,093474,Rideout; David Porter,6,0,36,30
1657828430623,MATH 20A,A01,083754,Zheng; Zequn,14,0,40,26
1657828436647,MATH 20B,A01,083756,Briones; Jor-el Thomas Caparas,4,0,36,32
1657828436647,MATH 20B,A02,083757,Briones; Jor-el Thomas Caparas,1,0,36,35
1657828436647,MATH 20B,A03,093475,Briones; Jor-el Thomas Caparas,2,0,36,34
1657828442672,MATH 20C,A01,083760,Briones; Jor-el Thomas Caparas,1,0,35,34
1657828442672,MATH 20C,A02,083761,Briones; Jor-el Thomas Caparas,8,0,35,27
1657828442672,MATH 20C,A03,093476,Briones; Jor-el Thomas Caparas,0,1,36,36
1657828442672,MATH 20C,B01,083762,Bach; Quang Tran,1,0,30,29
1657828448701,MATH 20D,A01,083765,Tran; Brian Kha,5,0,30,25
1657828448701,MATH 20D,A02,083766,Tran; Brian Kha,5,0,30,25
1657828448701,MATH 20D,A03,083767,Tran; Brian Kha,5,0,30,25
1657828454728,MATH 20E,A01,083771,Ganguly; Soumya,10,0,32,22
1657828454728,MATH 20E,A02,083772,Ganguly; Soumya,6,0,32,26
1657828454728,MATH 20E,B01,083773,Ciotti; Benjamin,20,0,35,15
1657828454728,MATH 20E,B02,083774,Ciotti; Benjamin,18,0,35,17
1657828460758,MATH 103A,A01,083777,Greenfeld; Be'Eri,3,0,36,33
1657828460758,MATH 103A,A02,083778,Greenfeld; Be'Eri,5,0,36,31
1657828460758,MATH 103A,A03,093561,Greenfeld; Be'Eri,6,0,36,30
1657828460758,MATH 103A,B01,083779,Greenfeld; Be'Eri,7,0,36,29
1657828460758,MATH 103A,B02,083780,Greenfeld; Be'Eri,4,0,36,32
1657828460758,MATH 103A,B03,093562,Greenfeld; Be'Eri,3,0,36,33
1657828466785,MATH 105,A01,085443,Carter; Anne Toulson,15,0,35,20
1657828466785,MATH 105,A02,093477,Carter; Anne Toulson,20,0,35,15
1657828472808,MATH 109,A01,083213,Ganzberger; Geoffrey Michael,3,0,34,31
1657828472808,MATH 109,A02,083214,Ganzberger; Geoffrey Michael,4,0,34,30
1657828472808,MATH 109,A03,093478,Ganzberger; Geoffrey Michael,2,0,34,32
1657828472808,MATH 109,B01,083215,Ganzberger; Geoffrey Michael,1,0,32,31
1657828472808,MATH 109,B02,083216,Ganzberger; Geoffrey Michael,2,0,32,30
1657828472808,MATH 109,B03,093479,Ganzberger; Geoffrey Michael,8,0,32,24
1657828478831,MATH 142A,A01,083219,Chow; Bennett,7,0,32,25
1657828478831,MATH 142A,A02,083220,Chow; Bennett,10,0,32,22
1657828478831,MATH 142A,A03,093480,Chow; Bennett,9,0,32,23
1657828478831,MATH 142A,B03,093481,Chow; Bennett,8,0,32,24
1657828478831,MATH 142A,B04,093558,Chow; Bennett,13,0,32,19
1657828478831,MATH 142A,B05,093559,Chow; Bennett,7,0,32,25
1657828484860,MATH 193A,A01,083224,Rotar; Vladimir,8,0,34,26
1657828484860,MATH 193A,A02,083225,Rotar; Vladimir,10,0,34,24
1657828484860,MATH 193A,A03,083781,Rotar; Vladimir,5,0,34,29
1657828484860,MATH 193A,A04,083782,Rotar; Vladimir,11,0,34,23
1657828484860,MATH 193A,A05,093482,Rotar; Vladimir,10,0,34,24
1657828490881,MATH 197,001,091859,McAuley; Julian John,9999,0,9999,0
1657828490881,MATH 197,002,095566,Kedlaya; Kiran S.,9997,0,9999,2
1657828490881,MATH 197,003,095567,Xiao; Ming,9999,0,9999,0
1657828490881,MATH 197,004,095571,Perols; Johan Lars,9998,0,9999,1
1657828497934,COGS 9,A01,083615,Shannon; Kyle Michael,9,0,75,66
1657828503958,COGS 11,A01,083617,Boyle; Mary E. T.,23,0,48,25
1657828509985,COGS 13,A01,083071,Bastos; Amalia Pinkusfeld,11,0,71,60
1657828516019,COGS 14A,A01,092681,Semenuks; Arturs,5,1,100,95
1657828522045,COGS 14B,A01,083073,Cheng; Tzu-Han,6,0,63,57
1657828528075,COGS 17,A01,092677,Semenuks; Arturs,6,0,81,75
1657828534098,COGS 100,A01,083619,Allen; Michael Gordon,17,0,70,53
1657828540125,COGS 101A,A01,083621,Davis; Joshua Daniel,9,0,68,59
1657828546151,COGS 101B,A01,091572,Allen; Michael Gordon,12,0,65,53
1657828552176,COGS 101C,A01,083625,Delgado; Tania,17,0,35,18
1657828558203,COGS 107A,A01,083627,Boyle; Mary E. T.,14,0,60,46
1657828564225,COGS 118A,A01,083075,Gupta; Anjum,21,0,76,55
1657828570247,CSE 3,A50,083646,Miranda; Gregory Joseph,24,0,50,26
1657828576273,CSE 8A,A50,083650,Miranda; Gregory Joseph,17,1,56,39
1657828582302,CSE 11,A01,083080,Cao; Yingjun,6,15,40,34
1657828588328,CSE 12,A01,083652,Krause-Levy; Sophia Louisa,29,1,120,91
1657828594363,CSE 15L,A01,083654,Morris; Justin Loren,9,0,50,41
1657828594363,CSE 15L,A02,083655,Morris; Justin Loren,9,0,50,41
1657828600389,CSE 20,A01,083657,Tran; Khoa Dang,39,0,80,41
1657828606412,CSE 21,A01,095574,Bach; Quang Tran,22,0,48,26
1657828612435,CSE 30,A01,083084,Eldon; John,6,0,80,74
1657828612435,CSE 30,B01,095061,Bhaskar; Nishant,9,0,50,41
1657828618459,CSE 100,A01,083659,Cao; Yingjun,5,4,70,65
1657828624481,CSE 134B,A01,083661,Powell; Thomas Allan,24,0,100,76
1657828630518,CSE 140,A01,083663,Gungor; Onat,15,0,85,70
1657828636542,CSE 140L,A01,083088,Eldon; John,23,0,100,77
1657828642566,CSE 175,A01,083665,Kumar; Rakesh,3,0,25,22
1657828648587,CSE 190,A00,092507,Dubnov; Shlomo,8,0,20,12
1657828654617,ECE 45,A01,083139,Congero; Spencer William,6,0,75,69
1657828660641,ECE 65,A50,083695,Saad; Andrew S,12,0,30,18
1657828660641,ECE 65,A51,095125,Saad; Andrew S,24,0,26,2
1657828666668,ECE 109,A01,091882,Touri; Behrouz,20,0,70,50
1657828672693,ECE 180,A00,083140,Abi Samra; Nicholas Camill,1,0,30,29
1657828672693,ECE 180,B00,083141,Abi Samra; Nicholas Camill,0,0,30,30
1657828678727,MATH 10A,A01,083735,Patchell; Gregory David,2,0,30,28
1657828678727,MATH 10A,A02,083736,Patchell; Gregory David,20,0,30,10
1657828678727,MATH 10A,A03,083737,Patchell; Gregory David,16,0,30,14
1657828684755,MATH 10B,A01,083207,Lim; Seonhee,8,0,34,26
1657828684755,MATH 10B,A02,083208,Lim; Seonhee,10,0,35,25
1657828684755,MATH 10B,A03,093472,Lim; Seonhee,7,0,34,27
1657828684755,MATH 10B,B01,083739,Sinha; Shubham,13,0,30,17
1657828690780,MATH 18,A01,083743,Cinel; Cameron Alexander,9,0,30,21
1657828690780,MATH 18,A02,083744,Cinel; Cameron Alexander,18,0,30,12
1657828690780,MATH 18,A03,083745,Cinel; Cameron Alexander,10,0,30,20
1657828690780,MATH 18,B01,083748,Rideout; David Porter,5,0,37,32
1657828690780,MATH 18,B02,083749,Rideout; David Porter,5,0,36,31
1657828690780,MATH 18,B03,083750,Rideout; David Porter,3,0,37,34
1657828690780,MATH 18,B04,083751,Rideout; David Porter,6,0,36,30
1657828690780,MATH 18,B05,093473,Rideout; David Porter,6,0,36,30
1657828690780,MATH 18,B06,093474,Rideout; David Porter,6,0,36,30
1657828696803,MATH 20A,A01,083754,Zheng; Zequn,14,0,40,26
1657828702830,MATH 20B,A01,083756,Briones; Jor-el Thomas Caparas,4,0,36,32
1657828702830,MATH 20B,A02,083757,Briones; Jor-el Thomas Caparas,1,0,36,35
1657828702830,MATH 20B,A03,093475,Briones; Jor-el Thomas Caparas,2,0,36,34
1657828708857,MATH 20C,A01,083760,Briones; Jor-el Thomas Caparas,1,0,35,34
1657828708857,MATH 20C,A02,083761,Briones; Jor-el Thomas Caparas,8,0,35,27
1657828708857,MATH 20C,A03,093476,Briones; Jor-el Thomas Caparas,0,1,36,36
1657828708857,MATH 20C,B01,083762,Bach; Quang Tran,1,0,30,29
1657828714882,MATH 20D,A01,083765,Tran; Brian Kha,5,0,30,25
1657828714882,MATH 20D,A02,083766,Tran; Brian Kha,5,0,30,25
1657828714882,MATH 20D,A03,083767,Tran; Brian Kha,5,0,30,25
1657828720910,MATH 20E,A01,083771,Ganguly; Soumya,10,0,32,22
1657828720910,MATH 20E,A02,083772,Ganguly; Soumya,6,0,32,26
1657828720910,MATH 20E,B01,083773,Ciotti; Benjamin,20,0,35,15
1657828720910,MATH 20E,B02,083774,Ciotti; Benjamin,18,0,35,17
1657828726933,MATH 103A,A01,083777,Greenfeld; Be'Eri,3,0,36,33
1657828726933,MATH 103A,A02,083778,Greenfeld; Be'Eri,5,0,36,31
1657828726933,MATH 103A,A03,093561,Greenfeld; Be'Eri,6,0,36,30
1657828726933,MATH 103A,B01,083779,Greenfeld; Be'Eri,7,0,36,29
1657828726933,MATH 103A,B02,083780,Greenfeld; Be'Eri,4,0,36,32
1657828726933,MATH 103A,B03,093562,Greenfeld; Be'Eri,3,0,36,33
1657828732956,MATH 105,A01,085443,Carter; Anne Toulson,15,0,35,20
1657828732956,MATH 105,A02,093477,Carter; Anne Toulson,20,0,35,15
1657828738980,MATH 109,A01,083213,Ganzberger; Geoffrey Michael,3,0,34,31
1657828738980,MATH 109,A02,083214,Ganzberger; Geoffrey Michael,4,0,34,30
1657828738980,MATH 109,A03,093478,Ganzberger; Geoffrey Michael,2,0,34,32
1657828738980,MATH 109,B01,083215,Ganzberger; Geoffrey Michael,1,0,32,31
1657828738980,MATH 109,B02,083216,Ganzberger; Geoffrey Michael,2,0,32,30
1657828738980,MATH 109,B03,093479,Ganzberger; Geoffrey Michael,8,0,32,24
1657828745018,MATH 142A,A01,083219,Chow; Bennett,7,0,32,25
1657828745018,MATH 142A,A02,083220,Chow; Bennett,10,0,32,22
1657828745018,MATH 142A,A03,093480,Chow; Bennett,9,0,32,23
1657828745018,MATH 142A,B03,093481,Chow; Bennett,8,0,32,24
1657828745018,MATH 142A,B04,093558,Chow; Bennett,13,0,32,19
1657828745018,MATH 142A,B05,093559,Chow; Bennett,7,0,32,25
1657828751050,MATH 193A,A01,083224,Rotar; Vladimir,8,0,34,26
1657828751050,MATH 193A,A02,083225,Rotar; Vladimir,10,0,34,24
1657828751050,MATH 193A,A03,083781,Rotar; Vladimir,5,0,34,29
1657828751050,MATH 193A,A04,083782,Rotar; Vladimir,11,0,34,23
1657828751050,MATH 193A,A05,093482,Rotar; Vladimir,10,0,34,24
1657828757080,MATH 197,001,091859,McAuley; Julian John,9999,0,9999,0
1657828757080,MATH 197,002,095566,Kedlaya; Kiran S.,9997,0,9999,2
1657828757080,MATH 197,003,095567,Xiao; Ming,9999,0,9999,0
1657828757080,MATH 197,004,095571,Perols; Johan Lars,9998,0,9999,1
1657828764178,COGS 9,A01,083615,Shannon; Kyle Michael,9,0,75,66
1657828770200,COGS 11,A01,083617,Boyle; Mary E. T.,23,0,48,25
1657828776233,COGS 13,A01,083071,Bastos; Amalia Pinkusfeld,11,0,71,60
1657828782269,COGS 14A,A01,092681,Semenuks; Arturs,5,1,100,95
1657828788293,COGS 14B,A01,083073,Cheng; Tzu-Han,6,0,63,57
1657828794329,COGS 17,A01,092677,Semenuks; Arturs,6,0,81,75
1657828800356,COGS 100,A01,083619,Allen; Michael Gordon,17,0,70,53
1657828806383,COGS 101A,A01,083621,Davis; Joshua Daniel,9,0,68,59
1657828812404,COGS 101B,A01,091572,Allen; Michael Gordon,12,0,65,53
1657828818431,COGS 101C,A01,083625,Delgado; Tania,17,0,35,18
1657828824473,COGS 107A,A01,083627,Boyle; Mary E. T.,14,0,60,46
1657828830496,COGS 118A,A01,083075,Gupta; Anjum,21,0,76,55
1657828836523,CSE 3,A50,083646,Miranda; Gregory Joseph,24,0,50,26
1657828842544,CSE 8A,A50,083650,Miranda; Gregory Joseph,17,1,56,39
1657828848573,CSE 11,A01,083080,Cao; Yingjun,6,15,40,34
1657828854600,CSE 12,A01,083652,Krause-Levy; Sophia Louisa,29,1,120,91
1657828860625,CSE 15L,A01,083654,Morris; Justin Loren,9,0,50,41
1657828860625,CSE 15L,A02,083655,Morris; Justin Loren,9,0,50,41
1657828866727,CSE 20,A01,083657,Tran; Khoa Dang,39,0,80,41
1657828872749,CSE 21,A01,095574,Bach; Quang Tran,22,0,48,26
1657828878772,CSE 30,A01,083084,Eldon; John,6,0,80,74
1657828878772,CSE 30,B01,095061,Bhaskar; Nishant,9,0,50,41
1657828884798,CSE 100,A01,083659,Cao; Yingjun,5,4,70,65
1657828890826,CSE 134B,A01,083661,Powell; Thomas Allan,24,0,100,76
1657828896854,CSE 140,A01,083663,Gungor; Onat,15,0,85,70
1657828902885,CSE 140L,A01,083088,Eldon; John,23,0,100,77
1657828908908,CSE 175,A01,083665,Kumar; Rakesh,3,0,25,22
1657828914932,CSE 190,A00,092507,Dubnov; Shlomo,8,0,20,12
1657828920960,ECE 45,A01,083139,Congero; Spencer William,6,0,75,69
1657828926987,ECE 65,A50,083695,Saad; Andrew S,12,0,30,18
1657828926987,ECE 65,A51,095125,Saad; Andrew S,24,0,26,2
1657828933016,ECE 109,A01,091882,Touri; Behrouz,20,0,70,50
1657828939039,ECE 180,A00,083140,Abi Samra; Nicholas Camill,1,0,30,29
1657828939039,ECE 180,B00,083141,Abi Samra; Nicholas Camill,0,0,30,30
1657828945063,MATH 10A,A01,083735,Patchell; Gregory David,2,0,30,28
1657828945063,MATH 10A,A02,083736,Patchell; Gregory David,20,0,30,10
1657828945063,MATH 10A,A03,083737,Patchell; Gregory David,16,0,30,14
1657828951088,MATH 10B,A01,083207,Lim; Seonhee,8,0,34,26
1657828951088,MATH 10B,A02,083208,Lim; Seonhee,10,0,35,25
1657828951088,MATH 10B,A03,093472,Lim; Seonhee,7,0,34,27
1657828951088,MATH 10B,B01,083739,Sinha; Shubham,13,0,30,17
1657828957127,MATH 18,A01,083743,Cinel; Cameron Alexander,9,0,30,21
1657828957127,MATH 18,A02,083744,Cinel; Cameron Alexander,18,0,30,12
1657828957127,MATH 18,A03,083745,Cinel; Cameron Alexander,10,0,30,20
1657828957127,MATH 18,B01,083748,Rideout; David Porter,5,0,37,32
1657828957127,MATH 18,B02,083749,Rideout; David Porter,5,0,36,31
1657828957127,MATH 18,B03,083750,Rideout; David Porter,3,0,37,34
1657828957127,MATH 18,B04,083751,Rideout; David Porter,6,0,36,30
1657828957127,MATH 18,B05,093473,Rideout; David Porter,6,0,36,30
1657828957127,MATH 18,B06,093474,Rideout; David Porter,6,0,36,30
1657828963151,MATH 20A,A01,083754,Zheng; Zequn,14,0,40,26
1657828969173,MATH 20B,A01,083756,Briones; Jor-el Thomas Caparas,4,0,36,32
1657828969173,MATH 20B,A02,083757,Briones; Jor-el Thomas Caparas,1,0,36,35
1657828969173,MATH 20B,A03,093475,Briones; Jor-el Thomas Caparas,2,0,36,34
1657828975198,MATH 20C,A01,083760,Briones; Jor-el Thomas Caparas,1,0,35,34
1657828975198,MATH 20C,A02,083761,Briones; Jor-el Thomas Caparas,8,0,35,27
1657828975198,MATH 20C,A03,093476,Briones; Jor-el Thomas Caparas,0,1,36,36
1657828975198,MATH 20C,B01,083762,Bach; Quang Tran,1,0,30,29
1657828981230,MATH 20D,A01,083765,Tran; Brian Kha,5,0,30,25
1657828981230,MATH 20D,A02,083766,Tran; Brian Kha,5,0,30,25
1657828981230,MATH 20D,A03,083767,Tran; Brian Kha,5,0,30,25
1657828987258,MATH 20E,A01,083771,Ganguly; Soumya,10,0,32,22
1657828987258,MATH 20E,A02,083772,Ganguly; Soumya,6,0,32,26
1657828987258,MATH 20E,B01,083773,Ciotti; Benjamin,20,0,35,15
1657828987258,MATH 20E,B02,083774,Ciotti; Benjamin,18,0,35,17
1657828993289,MATH 103A,A01,083777,Greenfeld; Be'Eri,3,0,36,33
1657828993289,MATH 103A,A02,083778,Greenfeld; Be'Eri,5,0,36,31
1657828993289,MATH 103A,A03,093561,Greenfeld; Be'Eri,6,0,36,30
1657828993289,MATH 103A,B01,083779,Greenfeld; Be'Eri,7,0,36,29
1657828993289,MATH 103A,B02,083780,Greenfeld; Be'Eri,4,0,36,32
1657828993289,MATH 103A,B03,093562,Greenfeld; Be'Eri,3,0,36,33
1657828999315,MATH 105,A01,085443,Carter; Anne Toulson,15,0,35,20
1657828999315,MATH 105,A02,093477,Carter; Anne Toulson,20,0,35,15
1657829005343,MATH 109,A01,083213,Ganzberger; Geoffrey Michael,3,0,34,31
1657829005343,MATH 109,A02,083214,Ganzberger; Geoffrey Michael,4,0,34,30
1657829005343,MATH 109,A03,093478,Ganzberger; Geoffrey Michael,2,0,34,32
1657829005343,MATH 109,B01,083215,Ganzberger; Geoffrey Michael,1,0,32,31
1657829005343,MATH 109,B02,083216,Ganzberger; Geoffrey Michael,2,0,32,30
1657829005343,MATH 109,B03,093479,Ganzberger; Geoffrey Michael,8,0,32,24
1657829011370,MATH 142A,A01,083219,Chow; Bennett,7,0,32,25
1657829011370,MATH 142A,A02,083220,Chow; Bennett,10,0,32,22
1657829011370,MATH 142A,A03,093480,Chow; Bennett,9,0,32,23
1657829011370,MATH 142A,B03,093481,Chow; Bennett,8,0,32,24
1657829011370,MATH 142A,B04,093558,Chow; Bennett,13,0,32,19
1657829011370,MATH 142A,B05,093559,Chow; Bennett,7,0,32,25
1657829017397,MATH 193A,A01,083224,Rotar; Vladimir,8,0,34,26
1657829017397,MATH 193A,A02,083225,Rotar; Vladimir,10,0,34,24
1657829017397,MATH 193A,A03,083781,Rotar; Vladimir,5,0,34,29
1657829017397,MATH 193A,A04,083782,Rotar; Vladimir,11,0,34,23
1657829017397,MATH 193A,A05,093482,Rotar; Vladimir,10,0,34,24
1657829023419,MATH 197,001,091859,McAuley; Julian John,9999,0,9999,0
1657829023419,MATH 197,002,095566,Kedlaya; Kiran S.,9997,0,9999,2
1657829023419,MATH 197,003,095567,Xiao; Ming,9999,0,9999,0
1657829023419,MATH 197,004,095571,Perols; Johan Lars,9998,0,9999,1
1657829030480,COGS 9,A01,083615,Shannon; Kyle Michael,9,0,75,66
1657829036503,COGS 11,A01,083617,Boyle; Mary E. T.,23,0,48,25
1657829042524,COGS 13,A01,083071,Bastos; Amalia Pinkusfeld,11,0,71,60
1657829048548,COGS 14A,A01,092681,Semenuks; Arturs,5,1,100,95
1657829054575,COGS 14B,A01,083073,Cheng; Tzu-Han,6,0,63,57
1657829060598,COGS 17,A01,092677,Semenuks; Arturs,6,0,81,75
1657829066626,COGS 100,A01,083619,Allen; Michael Gordon,17,0,70,53
1657829072649,COGS 101A,A01,083621,Davis; Joshua Daniel,9,0,68,59
1657829078675,COGS 101B,A01,091572,Allen; Michael Gordon,12,0,65,53
1657829084701,COGS 101C,A01,083625,Delgado; Tania,17,0,35,18
1657829090723,COGS 107A,A01,083627,Boyle; Mary E. T.,14,0,60,46
1657829096755,COGS 118A,A01,083075,Gupta; Anjum,21,0,76,55
1657829102785,CSE 3,A50,083646,Miranda; Gregory Joseph,24,0,50,26
1657829108812,CSE 8A,A50,083650,Miranda; Gregory Joseph,17,1,56,39
1657829114836,CSE 11,A01,083080,Cao; Yingjun,6,15,40,34
1657829120861,CSE 12,A01,083652,Krause-Levy; Sophia Louisa,29,1,120,91
1657829126886,CSE 15L,A01,083654,Morris; Justin Loren,9,0,50,41
1657829126886,CSE 15L,A02,083655,Morris; Justin Loren,9,0,50,41
1657829132910,CSE 20,A01,083657,Tran; Khoa Dang,39,0,80,41
1657829138940,CSE 21,A01,095574,Bach; Quang Tran,22,0,48,26
1657829144966,CSE 30,A01,083084,Eldon; John,6,0,80,74
1657829144966,CSE 30,B01,095061,Bhaskar; Nishant,9,0,50,41
1657829150991,CSE 100,A01,083659,Cao; Yingjun,5,4,70,65
1657829157029,CSE 134B,A01,083661,Powell; Thomas Allan,24,0,100,76
1657829163052,CSE 140,A01,083663,Gungor; Onat,15,0,85,70
1657829169076,CSE 140L,A01,083088,Eldon; John,23,0,100,77
1657829175099,CSE 175,A01,083665,Kumar; Rakesh,3,0,25,22
1657829181122,CSE 190,A00,092507,Dubnov; Shlomo,8,0,20,12
1657829187150,ECE 45,A01,083139,Congero; Spencer William,6,0,75,69
1657829193173,ECE 65,A50,083695,Saad; Andrew S,12,0,30,18
1657829193173,ECE 65,A51,095125,Saad; Andrew S,24,0,26,2
1657829199196,ECE 109,A01,091882,Touri; Behrouz,20,0,70,50
1657829205224,ECE 180,A00,083140,Abi Samra; Nicholas Camill,1,0,30,29
1657829205224,ECE 180,B00,083141,Abi Samra; Nicholas Camill,0,0,30,30
1657829211249,MATH 10A,A01,083735,Patchell; Gregory David,2,0,30,28
1657829211249,MATH 10A,A02,083736,Patchell; Gregory David,20,0,30,10
1657829211249,MATH 10A,A03,083737,Patchell; Gregory David,16,0,30,14
1657829217272,MATH 10B,A01,083207,Lim; Seonhee,8,0,34,26
1657829217272,MATH 10B,A02,083208,Lim; Seonhee,10,0,35,25
1657829217272,MATH 10B,A03,093472,Lim; Seonhee,7,0,34,27
1657829217272,MATH 10B,B01,083739,Sinha; Shubham,13,0,30,17
1657829223296,MATH 18,A01,083743,Cinel; Cameron Alexander,9,0,30,21
1657829223296,MATH 18,A02,083744,Cinel; Cameron Alexander,18,0,30,12
1657829223296,MATH 18,A03,083745,Cinel; Cameron Alexander,10,0,30,20
1657829223296,MATH 18,B01,083748,Rideout; David Porter,5,0,37,32
1657829223296,MATH 18,B02,083749,Rideout; David Porter,5,0,36,31
1657829223296,MATH 18,B03,083750,Rideout; David Porter,3,0,37,34
1657829223296,MATH 18,B04,083751,Rideout; David Porter,6,0,36,30
1657829223296,MATH 18,B05,093473,Rideout; David Porter,6,0,36,30
1657829223296,MATH 18,B06,093474,Rideout; David Porter,6,0,36,30
1657829229318,MATH 20A,A01,083754,Zheng; Zequn,14,0,40,26
1657829235339,MATH 20B,A01,083756,Briones; Jor-el Thomas Caparas,4,0,36,32
1657829235339,MATH 20B,A02,083757,Briones; Jor-el Thomas Caparas,1,0,36,35
1657829235339,MATH 20B,A03,093475,Briones; Jor-el Thomas Caparas,2,0,36,34
1657829241375,MATH 20C,A01,083760,Briones; Jor-el Thomas Caparas,1,0,35,34
1657829241375,MATH 20C,A02,083761,Briones; Jor-el Thomas Caparas,8,0,35,27
1657829241375,MATH 20C,A03,093476,Briones; Jor-el Thomas Caparas,0,1,36,36
1657829241375,MATH 20C,B01,083762,Bach; Quang Tran,1,0,30,29
1657829247404,MATH 20D,A01,083765,Tran; Brian Kha,5,0,30,25
1657829247404,MATH 20D,A02,083766,Tran; Brian Kha,5,0,30,25
1657829247404,MATH 20D,A03,083767,Tran; Brian Kha,5,0,30,25
1657829253428,MATH 20E,A01,083771,Ganguly; Soumya,10,0,32,22
1657829253428,MATH 20E,A02,083772,Ganguly; Soumya,6,0,32,26
1657829253428,MATH 20E,B01,083773,Ciotti; Benjamin,20,0,35,15
1657829253428,MATH 20E,B02,083774,Ciotti; Benjamin,18,0,35,17
1657829259472,MATH 103A,A01,083777,Greenfeld; Be'Eri,3,0,36,33
1657829259472,MATH 103A,A02,083778,Greenfeld; Be'Eri,5,0,36,31
1657829259472,MATH 103A,A03,093561,Greenfeld; Be'Eri,6,0,36,30
1657829259472,MATH 103A,B01,083779,Greenfeld; Be'Eri,7,0,36,29
1657829259472,MATH 103A,B02,083780,Greenfeld; Be'Eri,4,0,36,32
1657829259472,MATH 103A,B03,093562,Greenfeld; Be'Eri,3,0,36,33
1657829265499,MATH 105,A01,085443,Carter; Anne Toulson,15,0,35,20
1657829265499,MATH 105,A02,093477,Carter; Anne Toulson,20,0,35,15
1657829271526,MATH 109,A01,083213,Ganzberger; Geoffrey Michael,3,0,34,31
1657829271526,MATH 109,A02,083214,Ganzberger; Geoffrey Michael,4,0,34,30
1657829271526,MATH 109,A03,093478,Ganzberger; Geoffrey Michael,2,0,34,32
1657829271526,MATH 109,B01,083215,Ganzberger; Geoffrey Michael,1,0,32,31
1657829271526,MATH 109,B02,083216,Ganzberger; Geoffrey Michael,2,0,32,30
1657829271526,MATH 109,B03,093479,Ganzberger; Geoffrey Michael,8,0,32,24
1657829277559,MATH 142A,A01,083219,Chow; Bennett,7,0,32,25
1657829277559,MATH 142A,A02,083220,Chow; Bennett,10,0,32,22
1657829277559,MATH 142A,A03,093480,Chow; Bennett,9,0,32,23
1657829277559,MATH 142A,B03,093481,Chow; Bennett,8,0,32,24
1657829277559,MATH 142A,B04,093558,Chow; Bennett,13,0,32,19
1657829277559,MATH 142A,B05,093559,Chow; Bennett,7,0,32,25
1657829283586,MATH 193A,A01,083224,Rotar; Vladimir,8,0,34,26
1657829283586,MATH 193A,A02,083225,Rotar; Vladimir,10,0,34,24
1657829283586,MATH 193A,A03,083781,Rotar; Vladimir,5,0,34,29
1657829283586,MATH 193A,A04,083782,Rotar; Vladimir,11,0,34,23
1657829283586,MATH 193A,A05,093482,Rotar; Vladimir,10,0,34,24
1657829289612,MATH 197,001,091859,McAuley; Julian John,9999,0,9999,0
1657829289612,MATH 197,002,095566,Kedlaya; Kiran S.,9997,0,9999,2
1657829289612,MATH 197,003,095567,Xiao; Ming,9999,0,9999,0
1657829289612,MATH 197,004,095571,Perols; Johan Lars,9998,0,9999,1
1657829296693,COGS 9,A01,083615,Shannon; Kyle Michael,9,0,75,66
1657829302716,COGS 11,A01,083617,Boyle; Mary E. T.,23,0,48,25
1657829308743,COGS 13,A01,083071,Bastos; Amalia Pinkusfeld,11,0,71,60
1657829314768,COGS 14A,A01,092681,Semenuks; Arturs,5,1,100,95
1657829320791,COGS 14B,A01,083073,Cheng; Tzu-Han,6,0,63,57
1657829326817,COGS 17,A01,092677,Semenuks; Arturs,6,0,81,75
1657829332840,COGS 100,A01,083619,Allen; Michael Gordon,17,0,70,53
1657829338866,COGS 101A,A01,083621,Davis; Joshua Daniel,9,0,68,59
1657829344892,COGS 101B,A01,091572,Allen; Michael Gordon,12,0,65,53
1657829350920,COGS 101C,A01,083625,Delgado; Tania,17,0,35,18
1657829356943,COGS 107A,A01,083627,Boyle; Mary E. T.,14,0,60,46
1657829362965,COGS 118A,A01,083075,Gupta; Anjum,21,0,76,55
1657829368991,CSE 3,A50,083646,Miranda; Gregory Joseph,24,0,50,26
1657829375017,CSE 8A,A50,083650,Miranda; Gregory Joseph,17,1,56,39
1657829381054,CSE 11,A01,083080,Cao; Yingjun,6,15,40,34
1657829387078,CSE 12,A01,083652,Krause-Levy; Sophia Louisa,29,1,120,91
1657829393114,CSE 15L,A01,083654,Morris; Justin Loren,9,0,50,41
1657829393114,CSE 15L,A02,083655,Morris; Justin Loren,9,0,50,41
1657829399137,CSE 20,A01,083657,Tran; Khoa Dang,39,0,80,41
1657829405162,CSE 21,A01,095574,Bach; Quang Tran,22,0,48,26
1657829411188,CSE 30,A01,083084,Eldon; John,6,0,80,74
1657829411188,CSE 30,B01,095061,Bhaskar; Nishant,9,0,50,41
1657829417210,CSE 100,A01,083659,Cao; Yingjun,5,4,70,65
1657829423232,CSE 134B,A01,083661,Powell; Thomas Allan,24,0,100,76
1657829429254,CSE 140,A01,083663,Gungor; Onat,15,0,85,70
1657829435276,CSE 140L,A01,083088,Eldon; John,23,0,100,77
1657829441300,CSE 175,A01,083665,Kumar; Rakesh,3,0,25,22
1657829447330,CSE 190,A00,092507,Dubnov; Shlomo,8,0,20,12
1657829453353,ECE 45,A01,083139,Congero; Spencer William,6,0,75,69
1657829459380,ECE 65,A50,083695,Saad; Andrew S,12,0,30,18
1657829459380,ECE 65,A51,095125,Saad; Andrew S,24,0,26,2
1657829465489,ECE 109,A01,091882,Touri; Behrouz,20,0,70,50
1657829471515,ECE 180,A00,083140,Abi Samra; Nicholas Camill,1,0,30,29
1657829471515,ECE 180,B00,083141,Abi Samra; Nicholas Camill,0,0,30,30
1657829477544,MATH 10A,A01,083735,Patchell; Gregory David,2,0,30,28
1657829477544,MATH 10A,A02,083736,Patchell; Gregory David,20,0,30,10
1657829477544,MATH 10A,A03,083737,Patchell; Gregory David,16,0,30,14
1657829483579,MATH 10B,A01,083207,Lim; Seonhee,8,0,34,26
1657829483579,MATH 10B,A02,083208,Lim; Seonhee,10,0,35,25
1657829483579,MATH 10B,A03,093472,Lim; Seonhee,7,0,34,27
1657829483579,MATH 10B,B01,083739,Sinha; Shubham,13,0,30,17
1657829489604,MATH 18,A01,083743,Cinel; Cameron Alexander,9,0,30,21
1657829489604,MATH 18,A02,083744,Cinel; Cameron Alexander,18,0,30,12
1657829489604,MATH 18,A03,083745,Cinel; Cameron Alexander,10,0,30,20
1657829489604,MATH 18,B01,083748,Rideout; David Porter,5,0,37,32
1657829489604,MATH 18,B02,083749,Rideout; David Porter,5,0,36,31
1657829489604,MATH 18,B03,083750,Rideout; David Porter,3,0,37,34
1657829489604,MATH 18,B04,083751,Rideout; David Porter,6,0,36,30
1657829489604,MATH 18,B05,093473,Rideout; David Porter,6,0,36,30
1657829489604,MATH 18,B06,093474,Rideout; David Porter,6,0,36,30
1657829495628,MATH 20A,A01,083754,Zheng; Zequn,14,0,40,26
1657829501657,MATH 20B,A01,083756,Briones; Jor-el Thomas Caparas,4,0,36,32
1657829501657,MATH 20B,A02,083757,Briones; Jor-el Thomas Caparas,1,0,36,35
1657829501657,MATH 20B,A03,093475,Briones; Jor-el Thomas Caparas,2,0,36,34
1657829507681,MATH 20C,A01,083760,Briones; Jor-el Thomas Caparas,1,0,35,34
1657829507681,MATH 20C,A02,083761,Briones; Jor-el Thomas Caparas,8,0,35,27
1657829507681,MATH 20C,A03,093476,Briones; Jor-el Thomas Caparas,0,1,36,36
1657829507681,MATH 20C,B01,083762,Bach; Quang Tran,1,0,30,29
1657829513707,MATH 20D,A01,083765,Tran; Brian Kha,5,0,30,25
1657829513707,MATH 20D,A02,083766,Tran; Brian Kha,5,0,30,25
1657829513707,MATH 20D,A03,083767,Tran; Brian Kha,5,0,30,25
1657829519736,MATH 20E,A01,083771,Ganguly; Soumya,10,0,32,22
1657829519736,MATH 20E,A02,083772,Ganguly; Soumya,6,0,32,26
1657829519736,MATH 20E,B01,083773,Ciotti; Benjamin,20,0,35,15
1657829519736,MATH 20E,B02,083774,Ciotti; Benjamin,18,0,35,17
1657829525774,MATH 103A,A01,083777,Greenfeld; Be'Eri,3,0,36,33
1657829525774,MATH 103A,A02,083778,Greenfeld; Be'Eri,5,0,36,31
1657829525774,MATH 103A,A03,093561,Greenfeld; Be'Eri,6,0,36,30
1657829525774,MATH 103A,B01,083779,Greenfeld; Be'Eri,7,0,36,29
1657829525774,MATH 103A,B02,083780,Greenfeld; Be'Eri,4,0,36,32
1657829525774,MATH 103A,B03,093562,Greenfeld; Be'Eri,3,0,36,33
1657829531800,MATH 105,A01,085443,Carter; Anne Toulson,15,0,35,20
1657829531800,MATH 105,A02,093477,Carter; Anne Toulson,20,0,35,15
1657829537824,MATH 109,A01,083213,Ganzberger; Geoffrey Michael,3,0,34,31
1657829537824,MATH 109,A02,083214,Ganzberger; Geoffrey Michael,4,0,34,30
1657829537824,MATH 109,A03,093478,Ganzberger; Geoffrey Michael,2,0,34,32
1657829537824,MATH 109,B01,083215,Ganzberger; Geoffrey Michael,1,0,32,31
1657829537824,MATH 109,B02,083216,Ganzberger; Geoffrey Michael,2,0,32,30
1657829537824,MATH 109,B03,093479,Ganzberger; Geoffrey Michael,8,0,32,24
1657829543848,MATH 142A,A01,083219,Chow; Bennett,7,0,32,25
1657829543848,MATH 142A,A02,083220,Chow; Bennett,10,0,32,22
1657829543848,MATH 142A,A03,093480,Chow; Bennett,9,0,32,23
1657829543848,MATH 142A,B03,093481,Chow; Bennett,8,0,32,24
1657829543848,MATH 142A,B04,093558,Chow; Bennett,13,0,32,19
1657829543848,MATH 142A,B05,093559,Chow; Bennett,7,0,32,25
1657829549876,MATH 193A,A01,083224,Rotar; Vladimir,8,0,34,26
1657829549876,MATH 193A,A02,083225,Rotar; Vladimir,10,0,34,24
1657829549876,MATH 193A,A03,083781,Rotar; Vladimir,5,0,34,29
1657829549876,MATH 193A,A04,083782,Rotar; Vladimir,11,0,34,23
1657829549876,MATH 193A,A05,093482,Rotar; Vladimir,10,0,34,24
1657829555910,MATH 197,001,091859,McAuley; Julian John,9999,0,9999,0
1657829555910,MATH 197,002,095566,Kedlaya; Kiran S.,9997,0,9999,2
1657829555910,MATH 197,003,095567,Xiao; Ming,9999,0,9999,0
1657829555910,MATH 197,004,095571,Perols; Johan Lars,9998,0,9999,1
1657829562982,COGS 9,A01,083615,Shannon; Kyle Michael,9,0,75,66
1657829569004,COGS 11,A01,083617,Boyle; Mary E. T.,23,0,48,25
1657829575032,COGS 13,A01,083071,Bastos; Amalia Pinkusfeld,11,0,71,60
1657829581060,COGS 14A,A01,092681,Semenuks; Arturs,5,1,100,95
1657829587083,COGS 14B,A01,083073,Cheng; Tzu-Han,6,0,63,57
1657829593107,COGS 17,A01,092677,Semenuks; Arturs,6,0,81,75
1657829599137,COGS 100,A01,083619,Allen; Michael Gordon,17,0,70,53
1657829605165,COGS 101A,A01,083621,Davis; Joshua Daniel,9,0,68,59
1657829611186,COGS 101B,A01,091572,Allen; Michael Gordon,12,0,65,53
1657829617212,COGS 101C,A01,083625,Delgado; Tania,17,0,35,18
1657829623247,COGS 107A,A01,083627,Boyle; Mary E. T.,14,0,60,46
1657829629272,COGS 118A,A01,083075,Gupta; Anjum,21,0,76,55
1657829635298,CSE 3,A50,083646,Miranda; Gregory Joseph,24,0,50,26
1657829641322,CSE 8A,A50,083650,Miranda; Gregory Joseph,17,1,56,39
1657829647350,CSE 11,A01,083080,Cao; Yingjun,6,15,40,34
1657829653373,CSE 12,A01,083652,Krause-Levy; Sophia Louisa,29,1,120,91
1657829659406,CSE 15L,A01,083654,Morris; Justin Loren,9,0,50,41
1657829659406,CSE 15L,A02,083655,Morris; Justin Loren,9,0,50,41
1657829665429,CSE 20,A01,083657,Tran; Khoa Dang,39,0,80,41
1657829671456,CSE 21,A01,095574,Bach; Quang Tran,22,0,48,26
1657829677484,CSE 30,A01,083084,Eldon; John,6,0,80,74
1657829677484,CSE 30,B01,095061,Bhaskar; Nishant,9,0,50,41
1657829683510,CSE 100,A01,083659,Cao; Yingjun,5,4,70,65
1657829689535,CSE 134B,A01,083661,Powell; Thomas Allan,24,0,100,76
1657829695569,CSE 140,A01,083663,Gungor; Onat,15,0,85,70
1657829701592,CSE 140L,A01,083088,Eldon; John,23,0,100,77
1657829707614,CSE 175,A01,083665,Kumar; Rakesh,3,0,25,22
1657829713640,CSE 190,A00,092507,Dubnov; Shlomo,8,0,20,12
1657829719661,ECE 45,A01,083139,Congero; Spencer William,6,0,75,69
1657829725685,ECE 65,A50,083695,Saad; Andrew S,12,0,30,18
1657829725685,ECE 65,A51,095125,Saad; Andrew S,24,0,26,2
1657829731706,ECE 109,A01,091882,Touri; Behrouz,20,0,70,50
1657829737736,ECE 180,A00,083140,Abi Samra; Nicholas Camill,1,0,30,29
1657829737736,ECE 180,B00,083141,Abi Samra; Nicholas Camill,0,0,30,30
1657829743769,MATH 10A,A01,083735,Patchell; Gregory David,2,0,30,28
1657829743769,MATH 10A,A02,083736,Patchell; Gregory David,20,0,30,10
1657829743769,MATH 10A,A03,083737,Patchell; Gregory David,16,0,30,14
1657829749817,MATH 10B,A01,083207,Lim; Seonhee,8,0,34,26
1657829749817,MATH 10B,A02,083208,Lim; Seonhee,10,0,35,25
1657829749817,MATH 10B,A03,093472,Lim; Seonhee,7,0,34,27
1657829749817,MATH 10B,B01,083739,Sinha; Shubham,13,0,30,17
1657829755840,MATH 18,A01,083743,Cinel; Cameron Alexander,9,0,30,21
1657829755840,MATH 18,A02,083744,Cinel; Cameron Alexander,18,0,30,12
1657829755840,MATH 18,A03,083745,Cinel; Cameron Alexander,10,0,30,20
1657829755840,MATH 18,B01,083748,Rideout; David Porter,5,0,37,32
1657829755840,MATH 18,B02,083749,Rideout; David Porter,5,0,36,31
1657829755840,MATH 18,B03,083750,Rideout; David Porter,3,0,37,34
1657829755840,MATH 18,B04,083751,Rideout; David Porter,6,0,36,30
1657829755840,MATH 18,B05,093473,Rideout; David Porter,6,0,36,30
1657829755840,MATH 18,B06,093474,Rideout; David Porter,6,0,36,30
1657829761867,MATH 20A,A01,083754,Zheng; Zequn,14,0,40,26
1657829767904,MATH 20B,A01,083756,Briones; Jor-el Thomas Caparas,4,0,36,32
1657829767904,MATH 20B,A02,083757,Briones; Jor-el Thomas Caparas,1,0,36,35
1657829767904,MATH 20B,A03,093475,Briones; Jor-el Thomas Caparas,2,0,36,34
1657829773944,MATH 20C,A01,083760,Briones; Jor-el Thomas Caparas,1,0,35,34
1657829773944,MATH 20C,A02,083761,Briones; Jor-el Thomas Caparas,8,0,35,27
1657829773944,MATH 20C,A03,093476,Briones; Jor-el Thomas Caparas,0,1,36,36
1657829773944,MATH 20C,B01,083762,Bach; Quang Tran,1,0,30,29
1657829779972,MATH 20D,A01,083765,Tran; Brian Kha,5,0,30,25
1657829779972,MATH 20D,A02,083766,Tran; Brian Kha,5,0,30,25
1657829779972,MATH 20D,A03,083767,Tran; Brian Kha,5,0,30,25
1657829785999,MATH 20E,A01,083771,Ganguly; Soumya,10,0,32,22
1657829785999,MATH 20E,A02,083772,Ganguly; Soumya,6,0,32,26
1657829785999,MATH 20E,B01,083773,Ciotti; Benjamin,20,0,35,15
1657829785999,MATH 20E,B02,083774,Ciotti; Benjamin,18,0,35,17
1657829792024,MATH 103A,A01,083777,Greenfeld; Be'Eri,3,0,36,33
1657829792024,MATH 103A,A02,083778,Greenfeld; Be'Eri,5,0,36,31
1657829792024,MATH 103A,A03,093561,Greenfeld; Be'Eri,6,0,36,30
1657829792024,MATH 103A,B01,083779,Greenfeld; Be'Eri,7,0,36,29
1657829792024,MATH 103A,B02,083780,Greenfeld; Be'Eri,4,0,36,32
1657829792024,MATH 103A,B03,093562,Greenfeld; Be'Eri,3,0,36,33
1657829798052,MATH 105,A01,085443,Carter; Anne Toulson,15,0,35,20
1657829798052,MATH 105,A02,093477,Carter; Anne Toulson,20,0,35,15
1657829804081,MATH 109,A01,083213,Ganzberger; Geoffrey Michael,3,0,34,31
1657829804081,MATH 109,A02,083214,Ganzberger; Geoffrey Michael,4,0,34,30
1657829804081,MATH 109,A03,093478,Ganzberger; Geoffrey Michael,2,0,34,32
1657829804081,MATH 109,B01,083215,Ganzberger; Geoffrey Michael,1,0,32,31
1657829804081,MATH 109,B02,083216,Ganzberger; Geoffrey Michael,2,0,32,30
1657829804081,MATH 109,B03,093479,Ganzberger; Geoffrey Michael,8,0,32,24
1657829810127,MATH 142A,A01,083219,Chow; Bennett,7,0,32,25
1657829810127,MATH 142A,A02,083220,Chow; Bennett,10,0,32,22
1657829810127,MATH 142A,A03,093480,Chow; Bennett,9,0,32,23
1657829810127,MATH 142A,B03,093481,Chow; Bennett,8,0,32,24
1657829810127,MATH 142A,B04,093558,Chow; Bennett,13,0,32,19
1657829810127,MATH 142A,B05,093559,Chow; Bennett,7,0,32,25
1657829816150,MATH 193A,A01,083224,Rotar; Vladimir,8,0,34,26
1657829816150,MATH 193A,A02,083225,Rotar; Vladimir,10,0,34,24
1657829816150,MATH 193A,A03,083781,Rotar; Vladimir,5,0,34,29
1657829816150,MATH 193A,A04,083782,Rotar; Vladimir,11,0,34,23
1657829816150,MATH 193A,A05,093482,Rotar; Vladimir,10,0,34,24
1657829822176,MATH 197,001,091859,McAuley; Julian John,9999,0,9999,0
1657829822176,MATH 197,002,095566,Kedlaya; Kiran S.,9997,0,9999,2
1657829822176,MATH 197,003,095567,Xiao; Ming,9999,0,9999,0
1657829822176,MATH 197,004,095571,Perols; Johan Lars,9998,0,9999,1
1657829829236,COGS 9,A01,083615,Shannon; Kyle Michael,9,0,75,66
1657829835282,COGS 11,A01,083617,Boyle; Mary E. T.,23,0,48,25
1657829841319,COGS 13,A01,083071,Bastos; Amalia Pinkusfeld,11,0,71,60
1657829847341,COGS 14A,A01,092681,Semenuks; Arturs,5,1,100,95
1657829853363,COGS 14B,A01,083073,Cheng; Tzu-Han,6,0,63,57
1657829859390,COGS 17,A01,092677,Semenuks; Arturs,6,0,81,75
1657829865445,COGS 100,A01,083619,Allen; Michael Gordon,17,0,70,53
1657829871473,COGS 101A,A01,083621,Davis; Joshua Daniel,9,0,68,59
1657829877496,COGS 101B,A01,091572,Allen; Michael Gordon,12,0,65,53
1657829883517,COGS 101C,A01,083625,Delgado; Tania,17,0,35,18
1657829889556,COGS 107A,A01,083627,Boyle; Mary E. T.,14,0,60,46
1657829895590,COGS 118A,A01,083075,Gupta; Anjum,21,0,76,55
1657829901615,CSE 3,A50,083646,Miranda; Gregory Joseph,24,0,50,26
1657829907666,CSE 8A,A50,083650,Miranda; Gregory Joseph,17,1,56,39
1657829913712,CSE 11,A01,083080,Cao; Yingjun,6,15,40,34
1657829919738,CSE 12,A01,083652,Krause-Levy; Sophia Louisa,29,1,120,91
1657829925772,CSE 15L,A01,083654,Morris; Justin Loren,9,0,50,41
1657829925772,CSE 15L,A02,083655,Morris; Justin Loren,9,0,50,41
1657829931795,CSE 20,A01,083657,Tran; Khoa Dang,39,0,80,41
1657829937831,CSE 21,A01,095574,Bach; Quang Tran,22,0,48,26
1657829943856,CSE 30,A01,083084,Eldon; John,6,0,80,74
1657829943856,CSE 30,B01,095061,Bhaskar; Nishant,9,0,50,41
1657829949887,CSE 100,A01,083659,Cao; Yingjun,5,4,70,65
1657829955914,CSE 134B,A01,083661,Powell; Thomas Allan,24,0,100,76
1657829961955,CSE 140,A01,083663,Gungor; Onat,15,0,85,70
1657829967994,CSE 140L,A01,083088,Eldon; John,23,0,100,77
1657829974031,CSE 175,A01,083665,Kumar; Rakesh,3,0,25,22
1657829980066,CSE 190,A00,092507,Dubnov; Shlomo,8,0,20,12
1657829986107,ECE 45,A01,083139,Congero; Spencer William,6,0,75,69
1657829992141,ECE 65,A50,083695,Saad; Andrew S,12,0,30,18
1657829992141,ECE 65,A51,095125,Saad; Andrew S,24,0,26,2
1657829998195,ECE 109,A01,091882,Touri; Behrouz,20,0,70,50
1657830004227,ECE 180,A00,083140,Abi Samra; Nicholas Camill,1,0,30,29
1657830004227,ECE 180,B00,083141,Abi Samra; Nicholas Camill,0,0,30,30
1657830010250,MATH 10A,A01,083735,Patchell; Gregory David,2,0,30,28
1657830010250,MATH 10A,A02,083736,Patchell; Gregory David,20,0,30,10
1657830010250,MATH 10A,A03,083737,Patchell; Gregory David,16,0,30,14
1657830016314,MATH 10B,A01,083207,Lim; Seonhee,8,0,34,26
1657830016314,MATH 10B,A02,083208,Lim; Seonhee,10,0,35,25
1657830016314,MATH 10B,A03,093472,Lim; Seonhee,7,0,34,27
1657830016314,MATH 10B,B01,083739,Sinha; Shubham,13,0,30,17
1657830022351,MATH 18,A01,083743,Cinel; Cameron Alexander,9,0,30,21
1657830022351,MATH 18,A02,083744,Cinel; Cameron Alexander,18,0,30,12
1657830022351,MATH 18,A03,083745,Cinel; Cameron Alexander,10,0,30,20
1657830022351,MATH 18,B01,083748,Rideout; David Porter,5,0,37,32
1657830022351,MATH 18,B02,083749,Rideout; David Porter,5,0,36,31
1657830022351,MATH 18,B03,083750,Rideout; David Porter,3,0,37,34
1657830022351,MATH 18,B04,083751,Rideout; David Porter,6,0,36,30
1657830022351,MATH 18,B05,093473,Rideout; David Porter,6,0,36,30
1657830022351,MATH 18,B06,093474,Rideout; David Porter,6,0,36,30
1657830028389,MATH 20A,A01,083754,Zheng; Zequn,14,0,40,26
1657830034426,MATH 20B,A01,083756,Briones; Jor-el Thomas Caparas,4,0,36,32
1657830034426,MATH 20B,A02,083757,Briones; Jor-el Thomas Caparas,1,0,36,35
1657830034426,MATH 20B,A03,093475,Briones; Jor-el Thomas Caparas,2,0,36,34
1657830040471,MATH 20C,A01,083760,Briones; Jor-el Thomas Caparas,1,0,35,34
1657830040471,MATH 20C,A02,083761,Briones; Jor-el Thomas Caparas,8,0,35,27
1657830040471,MATH 20C,A03,093476,Briones; Jor-el Thomas Caparas,0,1,36,36
1657830040471,MATH 20C,B01,083762,Bach; Quang Tran,1,0,30,29
1657830046498,MATH 20D,A01,083765,Tran; Brian Kha,5,0,30,25
1657830046498,MATH 20D,A02,083766,Tran; Brian Kha,5,0,30,25
1657830046498,MATH 20D,A03,083767,Tran; Brian Kha,5,0,30,25
1657830052526,MATH 20E,A01,083771,Ganguly; Soumya,10,0,32,22
1657830052526,MATH 20E,A02,083772,Ganguly; Soumya,6,0,32,26
1657830052526,MATH 20E,B01,083773,Ciotti; Benjamin,20,0,35,15
1657830052526,MATH 20E,B02,083774,Ciotti; Benjamin,18,0,35,17
1657830058568,MATH 103A,A01,083777,Greenfeld; Be'Eri,3,0,36,33
1657830058568,MATH 103A,A02,083778,Greenfeld; Be'Eri,5,0,36,31
1657830058568,MATH 103A,A03,093561,Greenfeld; Be'Eri,6,0,36,30
1657830058568,MATH 103A,B01,083779,Greenfeld; Be'Eri,7,0,36,29
1657830058568,MATH 103A,B02,083780,Greenfeld; Be'Eri,4,0,36,32
1657830058568,MATH 103A,B03,093562,Greenfeld; Be'Eri,3,0,36,33
1657830064719,MATH 105,A01,085443,Carter; Anne Toulson,15,0,35,20
1657830064719,MATH 105,A02,093477,Carter; Anne Toulson,20,0,35,15
1657830070762,MATH 109,A01,083213,Ganzberger; Geoffrey Michael,3,0,34,31
1657830070762,MATH 109,A02,083214,Ganzberger; Geoffrey Michael,4,0,34,30
1657830070762,MATH 109,A03,093478,Ganzberger; Geoffrey Michael,2,0,34,32
1657830070762,MATH 109,B01,083215,Ganzberger; Geoffrey Michael,1,0,32,31
1657830070762,MATH 109,B02,083216,Ganzberger; Geoffrey Michael,2,0,32,30
1657830070762,MATH 109,B03,093479,Ganzberger; Geoffrey Michael,8,0,32,24
1657830076804,MATH 142A,A01,083219,Chow; Bennett,7,0,32,25
1657830076804,MATH 142A,A02,083220,Chow; Bennett,10,0,32,22
1657830076804,MATH 142A,A03,093480,Chow; Bennett,9,0,32,23
1657830076804,MATH 142A,B03,093481,Chow; Bennett,8,0,32,24
1657830076804,MATH 142A,B04,093558,Chow; Bennett,13,0,32,19
1657830076804,MATH 142A,B05,093559,Chow; Bennett,7,0,32,25
1657830082850,MATH 193A,A01,083224,Rotar; Vladimir,8,0,34,26
1657830082850,MATH 193A,A02,083225,Rotar; Vladimir,10,0,34,24
1657830082850,MATH 193A,A03,083781,Rotar; Vladimir,5,0,34,29
1657830082850,MATH 193A,A04,083782,Rotar; Vladimir,11,0,34,23
1657830082850,MATH 193A,A05,093482,Rotar; Vladimir,10,0,34,24
1657830088879,MATH 197,001,091859,McAuley; Julian John,9999,0,9999,0
1657830088879,MATH 197,002,095566,Kedlaya; Kiran S.,9997,0,9999,2
1657830088879,MATH 197,003,095567,Xiao; Ming,9999,0,9999,0
1657830088879,MATH 197,004,095571,Perols; Johan Lars,9998,0,9999,1
1657830095960,COGS 9,A01,083615,Shannon; Kyle Michael,9,0,75,66
1657830101986,COGS 11,A01,083617,Boyle; Mary E. T.,23,0,48,25
1657830108037,COGS 13,A01,083071,Bastos; Amalia Pinkusfeld,11,0,71,60
1657830114086,COGS 14A,A01,092681,Semenuks; Arturs,5,1,100,95
1657830120118,COGS 14B,A01,083073,Cheng; Tzu-Han,6,0,63,57
1657830126169,COGS 17,A01,092677,Semenuks; Arturs,6,0,81,75
1657830132208,COGS 100,A01,083619,Allen; Michael Gordon,17,0,70,53
1657830138256,COGS 101A,A01,083621,Davis; Joshua Daniel,9,0,68,59
1657830144284,COGS 101B,A01,091572,Allen; Michael Gordon,12,0,65,53
1657830150325,COGS 101C,A01,083625,Delgado; Tania,17,0,35,18
1657830156348,COGS 107A,A01,083627,Boyle; Mary E. T.,14,0,60,46
1657830162399,COGS 118A,A01,083075,Gupta; Anjum,21,0,76,55
1657830168434,CSE 3,A50,083646,Miranda; Gregory Joseph,24,0,50,26
1657830174466,CSE 8A,A50,083650,Miranda; Gregory Joseph,17,1,56,39
1657830180506,CSE 11,A01,083080,Cao; Yingjun,6,15,40,34
1657830186539,CSE 12,A01,083652,Krause-Levy; Sophia Louisa,29,1,120,91
1657830192587,CSE 15L,A01,083654,Morris; Justin Loren,9,0,50,41
1657830192587,CSE 15L,A02,083655,Morris; Justin Loren,9,0,50,41
1657830198634,CSE 20,A01,083657,Tran; Khoa Dang,39,0,80,41
1657830204661,CSE 21,A01,095574,Bach; Quang Tran,22,0,48,26
1657830210693,CSE 30,A01,083084,Eldon; John,6,0,80,74
1657830210693,CSE 30,B01,095061,Bhaskar; Nishant,9,0,50,41
1657830216741,CSE 100,A01,083659,Cao; Yingjun,5,4,70,65
1657830222782,CSE 134B,A01,083661,Powell; Thomas Allan,24,0,100,76
1657830228822,CSE 140,A01,083663,Gungor; Onat,15,0,85,70
1657830234857,CSE 140L,A01,083088,Eldon; John,23,0,100,77
1657830240915,CSE 175,A01,083665,Kumar; Rakesh,3,0,25,22
1657830246957,CSE 190,A00,092507,Dubnov; Shlomo,8,0,20,12
1657830252997,ECE 45,A01,083139,Congero; Spencer William,6,0,75,69
1657830259040,ECE 65,A50,083695,Saad; Andrew S,12,0,30,18
1657830259040,ECE 65,A51,095125,Saad; Andrew S,24,0,26,2
1657830265084,ECE 109,A01,091882,Touri; Behrouz,20,0,70,50
1657830271129,ECE 180,A00,083140,Abi Samra; Nicholas Camill,1,0,30,29
1657830271129,ECE 180,B00,083141,Abi Samra; Nicholas Camill,0,0,30,30
1657830277160,MATH 10A,A01,083735,Patchell; Gregory David,2,0,30,28
1657830277160,MATH 10A,A02,083736,Patchell; Gregory David,20,0,30,10
1657830277160,MATH 10A,A03,083737,Patchell; Gregory David,16,0,30,14
1657830283192,MATH 10B,A01,083207,Lim; Seonhee,8,0,34,26
1657830283192,MATH 10B,A02,083208,Lim; Seonhee,10,0,35,25
1657830283192,MATH 10B,A03,093472,Lim; Seonhee,7,0,34,27
1657830283192,MATH 10B,B01,083739,Sinha; Shubham,13,0,30,17
1657830289227,MATH 18,A01,083743,Cinel; Cameron Alexander,9,0,30,21
1657830289227,MATH 18,A02,083744,Cinel; Cameron Alexander,18,0,30,12
1657830289227,MATH 18,A03,083745,Cinel; Cameron Alexander,10,0,30,20
1657830289227,MATH 18,B01,083748,Rideout; David Porter,5,0,37,32
1657830289227,MATH 18,B02,083749,Rideout; David Porter,5,0,36,31
1657830289227,MATH 18,B03,083750,Rideout; David Porter,3,0,37,34
1657830289227,MATH 18,B04,083751,Rideout; David Porter,6,0,36,30
1657830289227,MATH 18,B05,093473,Rideout; David Porter,6,0,36,30
1657830289227,MATH 18,B06,093474,Rideout; David Porter,6,0,36,30
1657830295260,MATH 20A,A01,083754,Zheng; Zequn,14,0,40,26
1657830301294,MATH 20B,A01,083756,Briones; Jor-el Thomas Caparas,4,0,36,32
1657830301294,MATH 20B,A02,083757,Briones; Jor-el Thomas Caparas,1,0,36,35
1657830301294,MATH 20B,A03,093475,Briones; Jor-el Thomas Caparas,2,0,36,34
1657830307332,MATH 20C,A01,083760,Briones; Jor-el Thomas Caparas,1,0,35,34
1657830307332,MATH 20C,A02,083761,Briones; Jor-el Thomas Caparas,8,0,35,27
1657830307332,MATH 20C,A03,093476,Briones; Jor-el Thomas Caparas,0,1,36,36
1657830307332,MATH 20C,B01,083762,Bach; Quang Tran,1,0,30,29
1657830313371,MATH 20D,A01,083765,Tran; Brian Kha,5,0,30,25
1657830313371,MATH 20D,A02,083766,Tran; Brian Kha,5,0,30,25
1657830313371,MATH 20D,A03,083767,Tran; Brian Kha,5,0,30,25
1657830319425,MATH 20E,A01,083771,Ganguly; Soumya,10,0,32,22
1657830319425,MATH 20E,A02,083772,Ganguly; Soumya,6,0,32,26
1657830319425,MATH 20E,B01,083773,Ciotti; Benjamin,20,0,35,15
1657830319425,MATH 20E,B02,083774,Ciotti; Benjamin,18,0,35,17
1657830325459,MATH 103A,A01,083777,Greenfeld; Be'Eri,3,0,36,33
1657830325459,MATH 103A,A02,083778,Greenfeld; Be'Eri,5,0,36,31
1657830325459,MATH 103A,A03,093561,Greenfeld; Be'Eri,6,0,36,30
1657830325459,MATH 103A,B01,083779,Greenfeld; Be'Eri,7,0,36,29
1657830325459,MATH 103A,B02,083780,Greenfeld; Be'Eri,4,0,36,32
1657830325459,MATH 103A,B03,093562,Greenfeld; Be'Eri,3,0,36,33
1657830331482,MATH 105,A01,085443,Carter; Anne Toulson,15,0,35,20
1657830331482,MATH 105,A02,093477,Carter; Anne Toulson,20,0,35,15
1657830337528,MATH 109,A01,083213,Ganzberger; Geoffrey Michael,3,0,34,31
1657830337528,MATH 109,A02,083214,Ganzberger; Geoffrey Michael,4,0,34,30
1657830337528,MATH 109,A03,093478,Ganzberger; Geoffrey Michael,2,0,34,32
1657830337528,MATH 109,B01,083215,Ganzberger; Geoffrey Michael,1,0,32,31
1657830337528,MATH 109,B02,083216,Ganzberger; Geoffrey Michael,2,0,32,30
1657830337528,MATH 109,B03,093479,Ganzberger; Geoffrey Michael,8,0,32,24
1657830343565,MATH 142A,A01,083219,Chow; Bennett,7,0,32,25
1657830343565,MATH 142A,A02,083220,Chow; Bennett,10,0,32,22
1657830343565,MATH 142A,A03,093480,Chow; Bennett,9,0,32,23
1657830343565,MATH 142A,B03,093481,Chow; Bennett,8,0,32,24
1657830343565,MATH 142A,B04,093558,Chow; Bennett,13,0,32,19
1657830343565,MATH 142A,B05,093559,Chow; Bennett,7,0,32,25
1657830349611,MATH 193A,A01,083224,Rotar; Vladimir,8,0,34,26
1657830349611,MATH 193A,A02,083225,Rotar; Vladimir,10,0,34,24
1657830349611,MATH 193A,A03,083781,Rotar; Vladimir,5,0,34,29
1657830349611,MATH 193A,A04,083782,Rotar; Vladimir,11,0,34,23
1657830349611,MATH 193A,A05,093482,Rotar; Vladimir,10,0,34,24
1657830355649,MATH 197,001,091859,McAuley; Julian John,9999,0,9999,0
1657830355649,MATH 197,002,095566,Kedlaya; Kiran S.,9997,0,9999,2
1657830355649,MATH 197,003,095567,Xiao; Ming,9999,0,9999,0
1657830355649,MATH 197,004,095571,Perols; Johan Lars,9998,0,9999,1
1657830362722,COGS 9,A01,083615,Shannon; Kyle Michael,9,0,75,66
1657830368759,COGS 11,A01,083617,Boyle; Mary E. T.,23,0,48,25
1657830374792,COGS 13,A01,083071,Bastos; Amalia Pinkusfeld,11,0,71,60
1657830380815,COGS 14A,A01,092681,Semenuks; Arturs,5,1,100,95
1657830386858,COGS 14B,A01,083073,Cheng; Tzu-Han,6,0,63,57
1657830392901,COGS 17,A01,092677,Semenuks; Arturs,6,0,81,75
1657830398922,COGS 100,A01,083619,Allen; Michael Gordon,17,0,70,53
1657830404953,COGS 101A,A01,083621,Davis; Joshua Daniel,9,0,68,59
1657830410978,COGS 101B,A01,091572,Allen; Michael Gordon,12,0,65,53
1657830417017,COGS 101C,A01,083625,Delgado; Tania,17,0,35,18
1657830423048,COGS 107A,A01,083627,Boyle; Mary E. T.,14,0,60,46
1657830429089,COGS 118A,A01,083075,Gupta; Anjum,21,0,76,55
1657830435130,CSE 3,A50,083646,Miranda; Gregory Joseph,24,0,50,26
1657830441152,CSE 8A,A50,083650,Miranda; Gregory Joseph,17,1,56,39
1657830447197,CSE 11,A01,083080,Cao; Yingjun,6,15,40,34
1657830453229,CSE 12,A01,083652,Krause-Levy; Sophia Louisa,29,1,120,91
1657830459253,CSE 15L,A01,083654,Morris; Justin Loren,9,0,50,41
1657830459253,CSE 15L,A02,083655,Morris; Justin Loren,9,0,50,41
1657830465279,CSE 20,A01,083657,Tran; Khoa Dang,39,0,80,41
1657830471322,CSE 21,A01,095574,Bach; Quang Tran,22,0,48,26
1657830477345,CSE 30,A01,083084,Eldon; John,6,0,80,74
1657830477345,CSE 30,B01,095061,Bhaskar; Nishant,9,0,50,41
1657830483394,CSE 100,A01,083659,Cao; Yingjun,5,4,70,65
1657830489419,CSE 134B,A01,083661,Powell; Thomas Allan,24,0,100,76
1657830495468,CSE 140,A01,083663,Gungor; Onat,15,0,85,70
1657830501507,CSE 140L,A01,083088,Eldon; John,23,0,100,77
1657830507553,CSE 175,A01,083665,Kumar; Rakesh,3,0,25,22
1657830513593,CSE 190,A00,092507,Dubnov; Shlomo,8,0,20,12
1657830519626,ECE 45,A01,083139,Congero; Spencer William,6,0,75,69
1657830525678,ECE 65,A50,083695,Saad; Andrew S,12,0,30,18
1657830525678,ECE 65,A51,095125,Saad; Andrew S,24,0,26,2
1657830531708,ECE 109,A01,091882,Touri; Behrouz,20,0,70,50
1657830537747,ECE 180,A00,083140,Abi Samra; Nicholas Camill,1,0,30,29
1657830537747,ECE 180,B00,083141,Abi Samra; Nicholas Camill,0,0,30,30
1657830543778,MATH 10A,A01,083735,Patchell; Gregory David,2,0,30,28
1657830543778,MATH 10A,A02,083736,Patchell; Gregory David,20,0,30,10
1657830543778,MATH 10A,A03,083737,Patchell; Gregory David,16,0,30,14
1657830549826,MATH 10B,A01,083207,Lim; Seonhee,8,0,34,26
1657830549826,MATH 10B,A02,083208,Lim; Seonhee,10,0,35,25
1657830549826,MATH 10B,A03,093472,Lim; Seonhee,7,0,34,27
1657830549826,MATH 10B,B01,083739,Sinha; Shubham,13,0,30,17
1657830555862,MATH 18,A01,083743,Cinel; Cameron Alexander,9,0,30,21
1657830555862,MATH 18,A02,083744,Cinel; Cameron Alexander,18,0,30,12
1657830555862,MATH 18,A03,083745,Cinel; Cameron Alexander,10,0,30,20
1657830555862,MATH 18,B01,083748,Rideout; David Porter,5,0,37,32
1657830555862,MATH 18,B02,083749,Rideout; David Porter,5,0,36,31
1657830555862,MATH 18,B03,083750,Rideout; David Porter,3,0,37,34
1657830555862,MATH 18,B04,083751,Rideout; David Porter,6,0,36,30
1657830555862,MATH 18,B05,093473,Rideout; David Porter,6,0,36,30
1657830555862,MATH 18,B06,093474,Rideout; David Porter,6,0,36,30
1657830561891,MATH 20A,A01,083754,Zheng; Zequn,14,0,40,26
1657830567919,MATH 20B,A01,083756,Briones; Jor-el Thomas Caparas,4,0,36,32
1657830567919,MATH 20B,A02,083757,Briones; Jor-el Thomas Caparas,1,0,36,35
1657830567919,MATH 20B,A03,093475,Briones; Jor-el Thomas Caparas,2,0,36,34
1657830573948,MATH 20C,A01,083760,Briones; Jor-el Thomas Caparas,1,0,35,34
1657830573948,MATH 20C,A02,083761,Briones; Jor-el Thomas Caparas,8,0,35,27
1657830573948,MATH 20C,A03,093476,Briones; Jor-el Thomas Caparas,0,1,36,36
1657830573948,MATH 20C,B01,083762,Bach; Quang Tran,1,0,30,29
1657830579972,MATH 20D,A01,083765,Tran; Brian Kha,5,0,30,25
1657830579972,MATH 20D,A02,083766,Tran; Brian Kha,5,0,30,25
1657830579972,MATH 20D,A03,083767,Tran; Brian Kha,5,0,30,25
1657830586009,MATH 20E,A01,083771,Ganguly; Soumya,10,0,32,22
1657830586009,MATH 20E,A02,083772,Ganguly; Soumya,6,0,32,26
1657830586009,MATH 20E,B01,083773,Ciotti; Benjamin,20,0,35,15
1657830586009,MATH 20E,B02,083774,Ciotti; Benjamin,18,0,35,17
1657830592055,MATH 103A,A01,083777,Greenfeld; Be'Eri,3,0,36,33
1657830592055,MATH 103A,A02,083778,Greenfeld; Be'Eri,5,0,36,31
1657830592055,MATH 103A,A03,093561,Greenfeld; Be'Eri,6,0,36,30
1657830592055,MATH 103A,B01,083779,Greenfeld; Be'Eri,7,0,36,29
1657830592055,MATH 103A,B02,083780,Greenfeld; Be'Eri,4,0,36,32
1657830592055,MATH 103A,B03,093562,Greenfeld; Be'Eri,3,0,36,33
1657830598084,MATH 105,A01,085443,Carter; Anne Toulson,15,0,35,20
1657830598084,MATH 105,A02,093477,Carter; Anne Toulson,20,0,35,15
1657830604109,MATH 109,A01,083213,Ganzberger; Geoffrey Michael,3,0,34,31
1657830604109,MATH 109,A02,083214,Ganzberger; Geoffrey Michael,4,0,34,30
1657830604109,MATH 109,A03,093478,Ganzberger; Geoffrey Michael,2,0,34,32
1657830604109,MATH 109,B01,083215,Ganzberger; Geoffrey Michael,1,0,32,31
1657830604109,MATH 109,B02,083216,Ganzberger; Geoffrey Michael,2,0,32,30
1657830604109,MATH 109,B03,093479,Ganzberger; Geoffrey Michael,8,0,32,24
1657830610158,MATH 142A,A01,083219,Chow; Bennett,7,0,32,25
1657830610158,MATH 142A,A02,083220,Chow; Bennett,10,0,32,22
1657830610158,MATH 142A,A03,093480,Chow; Bennett,9,0,32,23
1657830610158,MATH 142A,B03,093481,Chow; Bennett,8,0,32,24
1657830610158,MATH 142A,B04,093558,Chow; Bennett,13,0,32,19
1657830610158,MATH 142A,B05,093559,Chow; Bennett,7,0,32,25
1657830616204,MATH 193A,A01,083224,Rotar; Vladimir,8,0,34,26
1657830616204,MATH 193A,A02,083225,Rotar; Vladimir,10,0,34,24
1657830616204,MATH 193A,A03,083781,Rotar; Vladimir,5,0,34,29
1657830616204,MATH 193A,A04,083782,Rotar; Vladimir,11,0,34,23
1657830616204,MATH 193A,A05,093482,Rotar; Vladimir,10,0,34,24
1657830622244,MATH 197,001,091859,McAuley; Julian John,9999,0,9999,0
1657830622244,MATH 197,002,095566,Kedlaya; Kiran S.,9997,0,9999,2
1657830622244,MATH 197,003,095567,Xiao; Ming,9999,0,9999,0
1657830622244,MATH 197,004,095571,Perols; Johan Lars,9998,0,9999,1
1657830629338,COGS 9,A01,083615,Shannon; Kyle Michael,9,0,75,66
1657830635360,COGS 11,A01,083617,Boyle; Mary E. T.,23,0,48,25
1657830641414,COGS 13,A01,083071,Bastos; Amalia Pinkusfeld,11,0,71,60
1657830647441,COGS 14A,A01,092681,Semenuks; Arturs,5,1,100,95
1657830653486,COGS 14B,A01,083073,Cheng; Tzu-Han,6,0,63,57
1657830659650,COGS 17,A01,092677,Semenuks; Arturs,6,0,81,75
1657830665693,COGS 100,A01,083619,Allen; Michael Gordon,17,0,70,53
1657830671739,COGS 101A,A01,083621,Davis; Joshua Daniel,9,0,68,59
1657830677776,COGS 101B,A01,091572,Allen; Michael Gordon,12,0,65,53
1657830683809,COGS 101C,A01,083625,Delgado; Tania,17,0,35,18
1657830689833,COGS 107A,A01,083627,Boyle; Mary E. T.,14,0,60,46
1657830695864,COGS 118A,A01,083075,Gupta; Anjum,21,0,76,55
1657830701897,CSE 3,A50,083646,Miranda; Gregory Joseph,24,0,50,26
1657830707922,CSE 8A,A50,083650,Miranda; Gregory Joseph,17,1,56,39
1657830713978,CSE 11,A01,083080,Cao; Yingjun,6,15,40,34
1657830720012,CSE 12,A01,083652,Krause-Levy; Sophia Louisa,29,1,120,91
1657830726074,CSE 15L,A01,083654,Morris; Justin Loren,9,0,50,41
1657830726074,CSE 15L,A02,083655,Morris; Justin Loren,9,0,50,41
1657830732101,CSE 20,A01,083657,Tran; Khoa Dang,39,0,80,41
1657830738143,CSE 21,A01,095574,Bach; Quang Tran,22,0,48,26
1657830744179,CSE 30,A01,083084,Eldon; John,6,0,80,74
1657830744179,CSE 30,B01,095061,Bhaskar; Nishant,9,0,50,41
1657830750201,CSE 100,A01,083659,Cao; Yingjun,5,4,70,65
1657830756237,CSE 134B,A01,083661,Powell; Thomas Allan,24,0,100,76
1657830762271,CSE 140,A01,083663,Gungor; Onat,15,0,85,70
1657830768307,CSE 140L,A01,083088,Eldon; John,23,0,100,77
1657830774336,CSE 175,A01,083665,Kumar; Rakesh,3,0,25,22
1657830780373,CSE 190,A00,092507,Dubnov; Shlomo,8,0,20,12
1657830786400,ECE 45,A01,083139,Congero; Spencer William,6,0,75,69
1657830792430,ECE 65,A50,083695,Saad; Andrew S,12,0,30,18
1657830792430,ECE 65,A51,095125,Saad; Andrew S,24,0,26,2
1657830798485,ECE 109,A01,091882,Touri; Behrouz,20,0,70,50
1657830804537,ECE 180,A00,083140,Abi Samra; Nicholas Camill,1,0,30,29
1657830804537,ECE 180,B00,083141,Abi Samra; Nicholas Camill,0,0,30,30
1657830810571,MATH 10A,A01,083735,Patchell; Gregory David,2,0,30,28
1657830810571,MATH 10A,A02,083736,Patchell; Gregory David,20,0,30,10
1657830810571,MATH 10A,A03,083737,Patchell; Gregory David,16,0,30,14
1657830816599,MATH 10B,A01,083207,Lim; Seonhee,8,0,34,26
1657830816599,MATH 10B,A02,083208,Lim; Seonhee,10,0,35,25
1657830816599,MATH 10B,A03,093472,Lim; Seonhee,7,0,34,27
1657830816599,MATH 10B,B01,083739,Sinha; Shubham,13,0,30,17
1657830822629,MATH 18,A01,083743,Cinel; Cameron Alexander,9,0,30,21
1657830822629,MATH 18,A02,083744,Cinel; Cameron Alexander,18,0,30,12
1657830822629,MATH 18,A03,083745,Cinel; Cameron Alexander,10,0,30,20
1657830822629,MATH 18,B01,083748,Rideout; David Porter,5,0,37,32
1657830822629,MATH 18,B02,083749,Rideout; David Porter,5,0,36,31
1657830822629,MATH 18,B03,083750,Rideout; David Porter,3,0,37,34
1657830822629,MATH 18,B04,083751,Rideout; David Porter,6,0,36,30
1657830822629,MATH 18,B05,093473,Rideout; David Porter,6,0,36,30
1657830822629,MATH 18,B06,093474,Rideout; David Porter,6,0,36,30
1657830828666,MATH 20A,A01,083754,Zheng; Zequn,14,0,40,26
1657830834706,MATH 20B,A01,083756,Briones; Jor-el Thomas Caparas,4,0,36,32
1657830834706,MATH 20B,A02,083757,Briones; Jor-el Thomas Caparas,1,0,36,35
1657830834706,MATH 20B,A03,093475,Briones; Jor-el Thomas Caparas,2,0,36,34
1657830840736,MATH 20C,A01,083760,Briones; Jor-el Thomas Caparas,1,0,35,34
1657830840736,MATH 20C,A02,083761,Briones; Jor-el Thomas Caparas,8,0,35,27
1657830840736,MATH 20C,A03,093476,Briones; Jor-el Thomas Caparas,0,1,36,36
1657830840736,MATH 20C,B01,083762,Bach; Quang Tran,1,0,30,29
1657830846784,MATH 20D,A01,083765,Tran; Brian Kha,5,0,30,25
1657830846784,MATH 20D,A02,083766,Tran; Brian Kha,5,0,30,25
1657830846784,MATH 20D,A03,083767,Tran; Brian Kha,5,0,30,25
1657830852812,MATH 20E,A01,083771,Ganguly; Soumya,10,0,32,22
1657830852812,MATH 20E,A02,083772,Ganguly; Soumya,6,0,32,26
1657830852812,MATH 20E,B01,083773,Ciotti; Benjamin,20,0,35,15
1657830852812,MATH 20E,B02,083774,Ciotti; Benjamin,18,0,35,17
1657830858860,MATH 103A,A01,083777,Greenfeld; Be'Eri,3,0,36,33
1657830858860,MATH 103A,A02,083778,Greenfeld; Be'Eri,5,0,36,31
1657830858860,MATH 103A,A03,093561,Greenfeld; Be'Eri,6,0,36,30
1657830858860,MATH 103A,B01,083779,Greenfeld; Be'Eri,7,0,36,29
1657830858860,MATH 103A,B02,083780,Greenfeld; Be'Eri,4,0,36,32
1657830858860,MATH 103A,B03,093562,Greenfeld; Be'Eri,3,0,36,33
1657830864887,MATH 105,A01,085443,Carter; Anne Toulson,15,0,35,20
1657830864887,MATH 105,A02,093477,Carter; Anne Toulson,20,0,35,15
1657830870915,MATH 109,A01,083213,Ganzberger; Geoffrey Michael,3,0,34,31
1657830870915,MATH 109,A02,083214,Ganzberger; Geoffrey Michael,4,0,34,30
1657830870915,MATH 109,A03,093478,Ganzberger; Geoffrey Michael,2,0,34,32
1657830870915,MATH 109,B01,083215,Ganzberger; Geoffrey Michael,1,0,32,31
1657830870915,MATH 109,B02,083216,Ganzberger; Geoffrey Michael,2,0,32,30
1657830870915,MATH 109,B03,093479,Ganzberger; Geoffrey Michael,8,0,32,24
1657830876958,MATH 142A,A01,083219,Chow; Bennett,7,0,32,25
1657830876958,MATH 142A,A02,083220,Chow; Bennett,10,0,32,22
1657830876958,MATH 142A,A03,093480,Chow; Bennett,9,0,32,23
1657830876958,MATH 142A,B03,093481,Chow; Bennett,8,0,32,24
1657830876958,MATH 142A,B04,093558,Chow; Bennett,13,0,32,19
1657830876958,MATH 142A,B05,093559,Chow; Bennett,7,0,32,25
1657830882989,MATH 193A,A01,083224,Rotar; Vladimir,8,0,34,26
1657830882989,MATH 193A,A02,083225,Rotar; Vladimir,10,0,34,24
1657830882989,MATH 193A,A03,083781,Rotar; Vladimir,5,0,34,29
1657830882989,MATH 193A,A04,083782,Rotar; Vladimir,11,0,34,23
1657830882989,MATH 193A,A05,093482,Rotar; Vladimir,10,0,34,24
1657830889038,MATH 197,001,091859,McAuley; Julian John,9999,0,9999,0
1657830889038,MATH 197,002,095566,Kedlaya; Kiran S.,9997,0,9999,2
1657830889038,MATH 197,003,095567,Xiao; Ming,9999,0,9999,0
1657830889038,MATH 197,004,095571,Perols; Johan Lars,9998,0,9999,1
1657830896116,COGS 9,A01,083615,Shannon; Kyle Michael,9,0,75,66
1657830902161,COGS 11,A01,083617,Boyle; Mary E. T.,23,0,48,25
1657830908184,COGS 13,A01,083071,Bastos; Amalia Pinkusfeld,11,0,71,60
1657830914235,COGS 14A,A01,092681,Semenuks; Arturs,5,1,100,95
1657830920266,COGS 14B,A01,083073,Cheng; Tzu-Han,6,0,63,57
1657830926293,COGS 17,A01,092677,Semenuks; Arturs,6,0,81,75
1657830932348,COGS 100,A01,083619,Allen; Michael Gordon,17,0,70,53
1657830938387,COGS 101A,A01,083621,Davis; Joshua Daniel,9,0,68,59
1657830944436,COGS 101B,A01,091572,Allen; Michael Gordon,12,0,65,53
1657830950458,COGS 101C,A01,083625,Delgado; Tania,17,0,35,18
1657830956491,COGS 107A,A01,083627,Boyle; Mary E. T.,14,0,60,46
1657830962519,COGS 118A,A01,083075,Gupta; Anjum,21,0,76,55
1657830968543,CSE 3,A50,083646,Miranda; Gregory Joseph,24,0,50,26
1657830974591,CSE 8A,A50,083650,Miranda; Gregory Joseph,17,1,56,39
1657830980618,CSE 11,A01,083080,Cao; Yingjun,6,15,40,34
1657830986656,CSE 12,A01,083652,Krause-Levy; Sophia Louisa,29,1,120,91
1657830992698,CSE 15L,A01,083654,Morris; Justin Loren,9,0,50,41
1657830992698,CSE 15L,A02,083655,Morris; Justin Loren,9,0,50,41
1657830998737,CSE 20,A01,083657,Tran; Khoa Dang,39,0,80,41
1657831004779,CSE 21,A01,095574,Bach; Quang Tran,22,0,48,26
1657831010816,CSE 30,A01,083084,Eldon; John,6,0,80,74
1657831010816,CSE 30,B01,095061,Bhaskar; Nishant,9,0,50,41
1657831016846,CSE 100,A01,083659,Cao; Yingjun,5,4,70,65
1657831022895,CSE 134B,A01,083661,Powell; Thomas Allan,24,0,100,76
1657831028955,CSE 140,A01,083663,Gungor; Onat,15,0,85,70
1657831034978,CSE 140L,A01,083088,Eldon; John,23,0,100,77
1657831041020,CSE 175,A01,083665,Kumar; Rakesh,3,0,25,22
1657831047058,CSE 190,A00,092507,Dubnov; Shlomo,8,0,20,12
1657831053111,ECE 45,A01,083139,Congero; Spencer William,6,0,75,69
1657831059159,ECE 65,A50,083695,Saad; Andrew S,12,0,30,18
1657831059159,ECE 65,A51,095125,Saad; Andrew S,24,0,26,2
1657831065188,ECE 109,A01,091882,Touri; Behrouz,20,0,70,50
1657831071226,ECE 180,A00,083140,Abi Samra; Nicholas Camill,1,0,30,29
1657831071226,ECE 180,B00,083141,Abi Samra; Nicholas Camill,0,0,30,30
1657831077275,MATH 10A,A01,083735,Patchell; Gregory David,2,0,30,28
1657831077275,MATH 10A,A02,083736,Patchell; Gregory David,20,0,30,10
1657831077275,MATH 10A,A03,083737,Patchell; Gregory David,16,0,30,14
1657831083325,MATH 10B,A01,083207,Lim; Seonhee,8,0,34,26
1657831083325,MATH 10B,A02,083208,Lim; Seonhee,10,0,35,25
1657831083325,MATH 10B,A03,093472,Lim; Seonhee,7,0,34,27
1657831083325,MATH 10B,B01,083739,Sinha; Shubham,13,0,30,17
1657831089370,MATH 18,A01,083743,Cinel; Cameron Alexander,9,0,30,21
1657831089370,MATH 18,A02,083744,Cinel; Cameron Alexander,18,0,30,12
1657831089370,MATH 18,A03,083745,Cinel; Cameron Alexander,10,0,30,20
1657831089370,MATH 18,B01,083748,Rideout; David Porter,5,0,37,32
1657831089370,MATH 18,B02,083749,Rideout; David Porter,5,0,36,31
1657831089370,MATH 18,B03,083750,Rideout; David Porter,3,0,37,34
1657831089370,MATH 18,B04,083751,Rideout; David Porter,6,0,36,30
1657831089370,MATH 18,B05,093473,Rideout; David Porter,6,0,36,30
1657831089370,MATH 18,B06,093474,Rideout; David Porter,6,0,36,30
1657831095410,MATH 20A,A01,083754,Zheng; Zequn,14,0,40,26
1657831101442,MATH 20B,A01,083756,Briones; Jor-el Thomas Caparas,4,0,36,32
1657831101442,MATH 20B,A02,083757,Briones; Jor-el Thomas Caparas,1,0,36,35
1657831101442,MATH 20B,A03,093475,Briones; Jor-el Thomas Caparas,2,0,36,34
1657831107484,MATH 20C,A01,083760,Briones; Jor-el Thomas Caparas,1,0,35,34
1657831107484,MATH 20C,A02,083761,Briones; Jor-el Thomas Caparas,8,0,35,27
1657831107484,MATH 20C,A03,093476,Briones; Jor-el Thomas Caparas,0,1,36,36
1657831107484,MATH 20C,B01,083762,Bach; Quang Tran,1,0,30,29
1657831113534,MATH 20D,A01,083765,Tran; Brian Kha,5,0,30,25
1657831113534,MATH 20D,A02,083766,Tran; Brian Kha,5,0,30,25
1657831113534,MATH 20D,A03,083767,Tran; Brian Kha,5,0,30,25
1657831119566,MATH 20E,A01,083771,Ganguly; Soumya,10,0,32,22
1657831119566,MATH 20E,A02,083772,Ganguly; Soumya,6,0,32,26
1657831119566,MATH 20E,B01,083773,Ciotti; Benjamin,20,0,35,15
1657831119566,MATH 20E,B02,083774,Ciotti; Benjamin,18,0,35,17
1657831125624,MATH 103A,A01,083777,Greenfeld; Be'Eri,3,0,36,33
1657831125624,MATH 103A,A02,083778,Greenfeld; Be'Eri,5,0,36,31
1657831125624,MATH 103A,A03,093561,Greenfeld; Be'Eri,6,0,36,30
1657831125624,MATH 103A,B01,083779,Greenfeld; Be'Eri,7,0,36,29
1657831125624,MATH 103A,B02,083780,Greenfeld; Be'Eri,4,0,36,32
1657831125624,MATH 103A,B03,093562,Greenfeld; Be'Eri,3,0,36,33
1657831131647,MATH 105,A01,085443,Carter; Anne Toulson,15,0,35,20
1657831131647,MATH 105,A02,093477,Carter; Anne Toulson,20,0,35,15
1657831137693,MATH 109,A01,083213,Ganzberger; Geoffrey Michael,3,0,34,31
1657831137693,MATH 109,A02,083214,Ganzberger; Geoffrey Michael,4,0,34,30
1657831137693,MATH 109,A03,093478,Ganzberger; Geoffrey Michael,2,0,34,32
1657831137693,MATH 109,B01,083215,Ganzberger; Geoffrey Michael,1,0,32,31
1657831137693,MATH 109,B02,083216,Ganzberger; Geoffrey Michael,2,0,32,30
1657831137693,MATH 109,B03,093479,Ganzberger; Geoffrey Michael,8,0,32,24
1657831143734,MATH 142A,A01,083219,Chow; Bennett,7,0,32,25
1657831143734,MATH 142A,A02,083220,Chow; Bennett,10,0,32,22
1657831143734,MATH 142A,A03,093480,Chow; Bennett,9,0,32,23
1657831143734,MATH 142A,B03,093481,Chow; Bennett,8,0,32,24
1657831143734,MATH 142A,B04,093558,Chow; Bennett,13,0,32,19
1657831143734,MATH 142A,B05,093559,Chow; Bennett,7,0,32,25
1657831149761,MATH 193A,A01,083224,Rotar; Vladimir,8,0,34,26
1657831149761,MATH 193A,A02,083225,Rotar; Vladimir,10,0,34,24
1657831149761,MATH 193A,A03,083781,Rotar; Vladimir,5,0,34,29
1657831149761,MATH 193A,A04,083782,Rotar; Vladimir,11,0,34,23
1657831149761,MATH 193A,A05,093482,Rotar; Vladimir,10,0,34,24
1657831155794,MATH 197,001,091859,McAuley; Julian John,9999,0,9999,0
1657831155794,MATH 197,002,095566,Kedlaya; Kiran S.,9997,0,9999,2
1657831155794,MATH 197,003,095567,Xiao; Ming,9999,0,9999,0
1657831155794,MATH 197,004,095571,Perols; Johan Lars,9998,0,9999,1
1657831162894,COGS 9,A01,083615,Shannon; Kyle Michael,9,0,75,66
1657831168928,COGS 11,A01,083617,Boyle; Mary E. T.,23,0,48,25
1657831174978,COGS 13,A01,083071,Bastos; Amalia Pinkusfeld,11,0,71,60
1657831181035,COGS 14A,A01,092681,Semenuks; Arturs,5,1,100,95
1657831187084,COGS 14B,A01,083073,Cheng; Tzu-Han,6,0,63,57
1657831193132,COGS 17,A01,092677,Semenuks; Arturs,6,0,81,75
1657831199179,COGS 100,A01,083619,Allen; Michael Gordon,17,0,70,53
1657831205232,COGS 101A,A01,083621,Davis; Joshua Daniel,9,0,68,59
1657831211289,COGS 101B,A01,091572,Allen; Michael Gordon,12,0,65,53
1657831217325,COGS 101C,A01,083625,Delgado; Tania,17,0,35,18
1657831223372,COGS 107A,A01,083627,Boyle; Mary E. T.,14,0,60,46
1657831229419,COGS 118A,A01,083075,Gupta; Anjum,21,0,76,55
1657831235461,CSE 3,A50,083646,Miranda; Gregory Joseph,24,0,50,26
1657831241496,CSE 8A,A50,083650,Miranda; Gregory Joseph,17,1,56,39
1657831247539,CSE 11,A01,083080,Cao; Yingjun,6,15,40,34
1657831253585,CSE 12,A01,083652,Krause-Levy; Sophia Louisa,29,1,120,91
1657831259701,CSE 15L,A01,083654,Morris; Justin Loren,9,0,50,41
1657831259701,CSE 15L,A02,083655,Morris; Justin Loren,9,0,50,41
1657831265740,CSE 20,A01,083657,Tran; Khoa Dang,39,0,80,41
1657831271788,CSE 21,A01,095574,Bach; Quang Tran,22,0,48,26
1657831277810,CSE 30,A01,083084,Eldon; John,6,0,80,74
1657831277810,CSE 30,B01,095061,Bhaskar; Nishant,9,0,50,41
1657831283845,CSE 100,A01,083659,Cao; Yingjun,5,4,70,65
1657831289876,CSE 134B,A01,083661,Powell; Thomas Allan,24,0,100,76
1657831295925,CSE 140,A01,083663,Gungor; Onat,15,0,85,70
1657831301978,CSE 140L,A01,083088,Eldon; John,23,0,100,77
1657831308013,CSE 175,A01,083665,Kumar; Rakesh,3,0,25,22
1657831314037,CSE 190,A00,092507,Dubnov; Shlomo,8,0,20,12
1657831320066,ECE 45,A01,083139,Congero; Spencer William,6,0,75,69
1657831326122,ECE 65,A50,083695,Saad; Andrew S,12,0,30,18
1657831326122,ECE 65,A51,095125,Saad; Andrew S,24,0,26,2
1657831332169,ECE 109,A01,091882,Touri; Behrouz,20,0,70,50
1657831338206,ECE 180,A00,083140,Abi Samra; Nicholas Camill,1,0,30,29
1657831338206,ECE 180,B00,083141,Abi Samra; Nicholas Camill,0,0,30,30
1657831344242,MATH 10A,A01,083735,Patchell; Gregory David,2,0,30,28
1657831344242,MATH 10A,A02,083736,Patchell; Gregory David,20,0,30,10
1657831344242,MATH 10A,A03,083737,Patchell; Gregory David,16,0,30,14
1657831350282,MATH 10B,A01,083207,Lim; Seonhee,8,0,34,26
1657831350282,MATH 10B,A02,083208,Lim; Seonhee,10,0,35,25
1657831350282,MATH 10B,A03,093472,Lim; Seonhee,7,0,34,27
1657831350282,MATH 10B,B01,083739,Sinha; Shubham,13,0,30,17
1657831356313,MATH 18,A01,083743,Cinel; Cameron Alexander,9,0,30,21
1657831356313,MATH 18,A02,083744,Cinel; Cameron Alexander,18,0,30,12
1657831356313,MATH 18,A03,083745,Cinel; Cameron Alexander,10,0,30,20
1657831356313,MATH 18,B01,083748,Rideout; David Porter,5,0,37,32
1657831356313,MATH 18,B02,083749,Rideout; David Porter,5,0,36,31
1657831356313,MATH 18,B03,083750,Rideout; David Porter,3,0,37,34
1657831356313,MATH 18,B04,083751,Rideout; David Porter,6,0,36,30
1657831356313,MATH 18,B05,093473,Rideout; David Porter,6,0,36,30
1657831356313,MATH 18,B06,093474,Rideout; David Porter,6,0,36,30
1657831362367,MATH 20A,A01,083754,Zheng; Zequn,14,0,40,26
1657831368417,MATH 20B,A01,083756,Briones; Jor-el Thomas Caparas,4,0,36,32
1657831368417,MATH 20B,A02,083757,Briones; Jor-el Thomas Caparas,1,0,36,35
1657831368417,MATH 20B,A03,093475,Briones; Jor-el Thomas Caparas,2,0,36,34
1657831374479,MATH 20C,A01,083760,Briones; Jor-el Thomas Caparas,1,0,35,34
1657831374479,MATH 20C,A02,083761,Briones; Jor-el Thomas Caparas,8,0,35,27
1657831374479,MATH 20C,A03,093476,Briones; Jor-el Thomas Caparas,0,1,36,36
1657831374479,MATH 20C,B01,083762,Bach; Quang Tran,1,0,30,29
1657831380519,MATH 20D,A01,083765,Tran; Brian Kha,5,0,30,25
1657831380519,MATH 20D,A02,083766,Tran; Brian Kha,5,0,30,25
1657831380519,MATH 20D,A03,083767,Tran; Brian Kha,5,0,30,25
1657831386556,MATH 20E,A01,083771,Ganguly; Soumya,10,0,32,22
1657831386556,MATH 20E,A02,083772,Ganguly; Soumya,6,0,32,26
1657831386556,MATH 20E,B01,083773,Ciotti; Benjamin,20,0,35,15
1657831386556,MATH 20E,B02,083774,Ciotti; Benjamin,18,0,35,17
1657831392583,MATH 103A,A01,083777,Greenfeld; Be'Eri,3,0,36,33
1657831392583,MATH 103A,A02,083778,Greenfeld; Be'Eri,5,0,36,31
1657831392583,MATH 103A,A03,093561,Greenfeld; Be'Eri,6,0,36,30
1657831392583,MATH 103A,B01,083779,Greenfeld; Be'Eri,7,0,36,29
1657831392583,MATH 103A,B02,083780,Greenfeld; Be'Eri,4,0,36,32
1657831392583,MATH 103A,B03,093562,Greenfeld; Be'Eri,3,0,36,33
1657831398635,MATH 105,A01,085443,Carter; Anne Toulson,15,0,35,20
1657831398635,MATH 105,A02,093477,Carter; Anne Toulson,20,0,35,15
1657831404688,MATH 109,A01,083213,Ganzberger; Geoffrey Michael,3,0,34,31
1657831404688,MATH 109,A02,083214,Ganzberger; Geoffrey Michael,4,0,34,30
1657831404688,MATH 109,A03,093478,Ganzberger; Geoffrey Michael,2,0,34,32
1657831404688,MATH 109,B01,083215,Ganzberger; Geoffrey Michael,1,0,32,31
1657831404688,MATH 109,B02,083216,Ganzberger; Geoffrey Michael,2,0,32,30
1657831404688,MATH 109,B03,093479,Ganzberger; Geoffrey Michael,8,0,32,24
1657831410724,MATH 142A,A01,083219,Chow; Bennett,7,0,32,25
1657831410724,MATH 142A,A02,083220,Chow; Bennett,10,0,32,22
1657831410724,MATH 142A,A03,093480,Chow; Bennett,9,0,32,23
1657831410724,MATH 142A,B03,093481,Chow; Bennett,8,0,32,24
1657831410724,MATH 142A,B04,093558,Chow; Bennett,13,0,32,19
1657831410724,MATH 142A,B05,093559,Chow; Bennett,7,0,32,25
1657831416756,MATH 193A,A01,083224,Rotar; Vladimir,8,0,34,26
1657831416756,MATH 193A,A02,083225,Rotar; Vladimir,10,0,34,24
1657831416756,MATH 193A,A03,083781,Rotar; Vladimir,5,0,34,29
1657831416756,MATH 193A,A04,083782,Rotar; Vladimir,11,0,34,23
1657831416756,MATH 193A,A05,093482,Rotar; Vladimir,10,0,34,24
1657831422785,MATH 197,001,091859,McAuley; Julian John,9999,0,9999,0
1657831422785,MATH 197,002,095566,Kedlaya; Kiran S.,9997,0,9999,2
1657831422785,MATH 197,003,095567,Xiao; Ming,9999,0,9999,0
1657831422785,MATH 197,004,095571,Perols; Johan Lars,9998,0,9999,1
1657831429884,COGS 9,A01,083615,Shannon; Kyle Michael,9,0,75,66
1657831435919,COGS 11,A01,083617,Boyle; Mary E. T.,23,0,48,25
1657831441956,COGS 13,A01,083071,Bastos; Amalia Pinkusfeld,11,0,71,60
1657831448001,COGS 14A,A01,092681,Semenuks; Arturs,5,1,100,95
1657831454043,COGS 14B,A01,083073,Cheng; Tzu-Han,6,0,63,57
1657831460079,COGS 17,A01,092677,Semenuks; Arturs,6,0,81,75
1657831466111,COGS 100,A01,083619,Allen; Michael Gordon,17,0,70,53
1657831472150,COGS 101A,A01,083621,Davis; Joshua Daniel,9,0,68,59
1657831478194,COGS 101B,A01,091572,Allen; Michael Gordon,12,0,65,53
1657831484233,COGS 101C,A01,083625,Delgado; Tania,17,0,35,18
1657831490279,COGS 107A,A01,083627,Boyle; Mary E. T.,14,0,60,46
1657831496308,COGS 118A,A01,083075,Gupta; Anjum,21,0,76,55
1657831502344,CSE 3,A50,083646,Miranda; Gregory Joseph,24,0,50,26
1657831508394,CSE 8A,A50,083650,Miranda; Gregory Joseph,17,1,56,39
1657831514417,CSE 11,A01,083080,Cao; Yingjun,6,15,40,34
1657831520451,CSE 12,A01,083652,Krause-Levy; Sophia Louisa,29,1,120,91
1657831526485,CSE 15L,A01,083654,Morris; Justin Loren,9,0,50,41
1657831526485,CSE 15L,A02,083655,Morris; Justin Loren,9,0,50,41
1657831532638,CSE 20,A01,083657,Tran; Khoa Dang,39,0,80,41
1657831538686,CSE 21,A01,095574,Bach; Quang Tran,22,0,48,26
1657831544740,CSE 30,A01,083084,Eldon; John,6,0,80,74
1657831544740,CSE 30,B01,095061,Bhaskar; Nishant,9,0,50,41
1657831550778,CSE 100,A01,083659,Cao; Yingjun,5,4,70,65
1657831556803,CSE 134B,A01,083661,Powell; Thomas Allan,24,0,100,76
1657831562854,CSE 140,A01,083663,Gungor; Onat,15,0,85,70
1657831568889,CSE 140L,A01,083088,Eldon; John,23,0,100,77
1657831574926,CSE 175,A01,083665,Kumar; Rakesh,3,0,25,22
1657831580980,CSE 190,A00,092507,Dubnov; Shlomo,8,0,20,12
1657831587013,ECE 45,A01,083139,Congero; Spencer William,6,0,75,69
1657831593056,ECE 65,A50,083695,Saad; Andrew S,12,0,30,18
1657831593056,ECE 65,A51,095125,Saad; Andrew S,24,0,26,2
1657831599091,ECE 109,A01,091882,Touri; Behrouz,20,0,70,50
1657831605125,ECE 180,A00,083140,Abi Samra; Nicholas Camill,1,0,30,29
1657831605125,ECE 180,B00,083141,Abi Samra; Nicholas Camill,0,0,30,30
1657831611178,MATH 10A,A01,083735,Patchell; Gregory David,2,0,30,28
1657831611178,MATH 10A,A02,083736,Patchell; Gregory David,20,0,30,10
1657831611178,MATH 10A,A03,083737,Patchell; Gregory David,16,0,30,14
1657831617219,MATH 10B,A01,083207,Lim; Seonhee,8,0,34,26
1657831617219,MATH 10B,A02,083208,Lim; Seonhee,10,0,35,25
1657831617219,MATH 10B,A03,093472,Lim; Seonhee,7,0,34,27
1657831617219,MATH 10B,B01,083739,Sinha; Shubham,13,0,30,17
1657831623269,MATH 18,A01,083743,Cinel; Cameron Alexander,9,0,30,21
1657831623269,MATH 18,A02,083744,Cinel; Cameron Alexander,18,0,30,12
1657831623269,MATH 18,A03,083745,Cinel; Cameron Alexander,10,0,30,20
1657831623269,MATH 18,B01,083748,Rideout; David Porter,5,0,37,32
1657831623269,MATH 18,B02,083749,Rideout; David Porter,5,0,36,31
1657831623269,MATH 18,B03,083750,Rideout; David Porter,3,0,37,34
1657831623269,MATH 18,B04,083751,Rideout; David Porter,6,0,36,30
1657831623269,MATH 18,B05,093473,Rideout; David Porter,6,0,36,30
1657831623269,MATH 18,B06,093474,Rideout; David Porter,6,0,36,30
1657831629324,MATH 20A,A01,083754,Zheng; Zequn,14,0,40,26
1657831635376,MATH 20B,A01,083756,Briones; Jor-el Thomas Caparas,4,0,36,32
1657831635376,MATH 20B,A02,083757,Briones; Jor-el Thomas Caparas,1,0,36,35
1657831635376,MATH 20B,A03,093475,Briones; Jor-el Thomas Caparas,2,0,36,34
1657831641413,MATH 20C,A01,083760,Briones; Jor-el Thomas Caparas,1,0,35,34
1657831641413,MATH 20C,A02,083761,Briones; Jor-el Thomas Caparas,8,0,35,27
1657831641413,MATH 20C,A03,093476,Briones; Jor-el Thomas Caparas,0,1,36,36
1657831641413,MATH 20C,B01,083762,Bach; Quang Tran,1,0,30,29
1657831647462,MATH 20D,A01,083765,Tran; Brian Kha,5,0,30,25
1657831647462,MATH 20D,A02,083766,Tran; Brian Kha,5,0,30,25
1657831647462,MATH 20D,A03,083767,Tran; Brian Kha,5,0,30,25
1657831653507,MATH 20E,A01,083771,Ganguly; Soumya,10,0,32,22
1657831653507,MATH 20E,A02,083772,Ganguly; Soumya,6,0,32,26
1657831653507,MATH 20E,B01,083773,Ciotti; Benjamin,20,0,35,15
1657831653507,MATH 20E,B02,083774,Ciotti; Benjamin,18,0,35,17
1657831659566,MATH 103A,A01,083777,Greenfeld; Be'Eri,3,0,36,33
1657831659566,MATH 103A,A02,083778,Greenfeld; Be'Eri,5,0,36,31
1657831659566,MATH 103A,A03,093561,Greenfeld; Be'Eri,6,0,36,30
1657831659566,MATH 103A,B01,083779,Greenfeld; Be'Eri,7,0,36,29
1657831659566,MATH 103A,B02,083780,Greenfeld; Be'Eri,4,0,36,32
1657831659566,MATH 103A,B03,093562,Greenfeld; Be'Eri,3,0,36,33
1657831665619,MATH 105,A01,085443,Carter; Anne Toulson,15,0,35,20
1657831665619,MATH 105,A02,093477,Carter; Anne Toulson,20,0,35,15
1657831671674,MATH 109,A01,083213,Ganzberger; Geoffrey Michael,3,0,34,31
1657831671674,MATH 109,A02,083214,Ganzberger; Geoffrey Michael,4,0,34,30
1657831671674,MATH 109,A03,093478,Ganzberger; Geoffrey Michael,2,0,34,32
1657831671674,MATH 109,B01,083215,Ganzberger; Geoffrey Michael,1,0,32,31
1657831671674,MATH 109,B02,083216,Ganzberger; Geoffrey Michael,2,0,32,30
1657831671674,MATH 109,B03,093479,Ganzberger; Geoffrey Michael,8,0,32,24
1657831677728,MATH 142A,A01,083219,Chow; Bennett,7,0,32,25
1657831677728,MATH 142A,A02,083220,Chow; Bennett,10,0,32,22
1657831677728,MATH 142A,A03,093480,Chow; Bennett,9,0,32,23
1657831677728,MATH 142A,B03,093481,Chow; Bennett,8,0,32,24
1657831677728,MATH 142A,B04,093558,Chow; Bennett,13,0,32,19
1657831677728,MATH 142A,B05,093559,Chow; Bennett,7,0,32,25
1657831683777,MATH 193A,A01,083224,Rotar; Vladimir,8,0,34,26
1657831683777,MATH 193A,A02,083225,Rotar; Vladimir,10,0,34,24
1657831683777,MATH 193A,A03,083781,Rotar; Vladimir,5,0,34,29
1657831683777,MATH 193A,A04,083782,Rotar; Vladimir,11,0,34,23
1657831683777,MATH 193A,A05,093482,Rotar; Vladimir,10,0,34,24
1657831689814,MATH 197,001,091859,McAuley; Julian John,9999,0,9999,0
1657831689814,MATH 197,002,095566,Kedlaya; Kiran S.,9997,0,9999,2
1657831689814,MATH 197,003,095567,Xiao; Ming,9999,0,9999,0
1657831689814,MATH 197,004,095571,Perols; Johan Lars,9998,0,9999,1
1657831696919,COGS 9,A01,083615,Shannon; Kyle Michael,9,0,75,66
1657831702948,COGS 11,A01,083617,Boyle; Mary E. T.,23,0,48,25
1657831709010,COGS 13,A01,083071,Bastos; Amalia Pinkusfeld,11,0,71,60
1657831715055,COGS 14A,A01,092681,Semenuks; Arturs,5,1,100,95
1657831721111,COGS 14B,A01,083073,Cheng; Tzu-Han,6,0,63,57
1657831727165,COGS 17,A01,092677,Semenuks; Arturs,6,0,81,75
1657831733205,COGS 100,A01,083619,Allen; Michael Gordon,17,0,70,53
1657831739228,COGS 101A,A01,083621,Davis; Joshua Daniel,9,0,68,59
1657831745253,COGS 101B,A01,091572,Allen; Michael Gordon,12,0,65,53
1657831751294,COGS 101C,A01,083625,Delgado; Tania,17,0,35,18
1657831757325,COGS 107A,A01,083627,Boyle; Mary E. T.,14,0,60,46
1657831763374,COGS 118A,A01,083075,Gupta; Anjum,21,0,76,55
1657831769404,CSE 3,A50,083646,Miranda; Gregory Joseph,24,0,50,26
1657831775434,CSE 8A,A50,083650,Miranda; Gregory Joseph,17,1,56,39
1657831781466,CSE 11,A01,083080,Cao; Yingjun,6,15,40,34
1657831787490,CSE 12,A01,083652,Krause-Levy; Sophia Louisa,29,1,120,91
1657831793528,CSE 15L,A01,083654,Morris; Justin Loren,9,0,50,41
1657831793528,CSE 15L,A02,083655,Morris; Justin Loren,9,0,50,41
1657831799569,CSE 20,A01,083657,Tran; Khoa Dang,39,0,80,41
1657831805616,CSE 21,A01,095574,Bach; Quang Tran,22,0,48,26
1657831811649,CSE 30,A01,083084,Eldon; John,6,0,80,74
1657831811649,CSE 30,B01,095061,Bhaskar; Nishant,9,0,50,41
1657831817696,CSE 100,A01,083659,Cao; Yingjun,5,4,70,65
1657831823743,CSE 134B,A01,083661,Powell; Thomas Allan,24,0,100,76
1657831829789,CSE 140,A01,083663,Gungor; Onat,15,0,85,70
1657831835824,CSE 140L,A01,083088,Eldon; John,23,0,100,77
1657831841870,CSE 175,A01,083665,Kumar; Rakesh,3,0,25,22
1657831847908,CSE 190,A00,092507,Dubnov; Shlomo,8,0,20,12
1657831853964,ECE 45,A01,083139,Congero; Spencer William,6,0,75,69
1657831860072,ECE 65,A50,083695,Saad; Andrew S,12,0,30,18
1657831860072,ECE 65,A51,095125,Saad; Andrew S,24,0,26,2
1657831866119,ECE 109,A01,091882,Touri; Behrouz,20,0,70,50
1657831872152,ECE 180,A00,083140,Abi Samra; Nicholas Camill,1,0,30,29
1657831872152,ECE 180,B00,083141,Abi Samra; Nicholas Camill,0,0,30,30
1657831878204,MATH 10A,A01,083735,Patchell; Gregory David,2,0,30,28
1657831878204,MATH 10A,A02,083736,Patchell; Gregory David,20,0,30,10
1657831878204,MATH 10A,A03,083737,Patchell; Gregory David,16,0,30,14
1657831884261,MATH 10B,A01,083207,Lim; Seonhee,8,0,34,26
1657831884261,MATH 10B,A02,083208,Lim; Seonhee,10,0,35,25
1657831884261,MATH 10B,A03,093472,Lim; Seonhee,7,0,34,27
1657831884261,MATH 10B,B01,083739,Sinha; Shubham,13,0,30,17
1657831890297,MATH 18,A01,083743,Cinel; Cameron Alexander,9,0,30,21
1657831890297,MATH 18,A02,083744,Cinel; Cameron Alexander,18,0,30,12
1657831890297,MATH 18,A03,083745,Cinel; Cameron Alexander,10,0,30,20
1657831890297,MATH 18,B01,083748,Rideout; David Porter,5,0,37,32
1657831890297,MATH 18,B02,083749,Rideout; David Porter,5,0,36,31
1657831890297,MATH 18,B03,083750,Rideout; David Porter,3,0,37,34
1657831890297,MATH 18,B04,083751,Rideout; David Porter,6,0,36,30
1657831890297,MATH 18,B05,093473,Rideout; David Porter,6,0,36,30
1657831890297,MATH 18,B06,093474,Rideout; David Porter,6,0,36,30
1657831896345,MATH 20A,A01,083754,Zheng; Zequn,14,0,40,26
1657831902378,MATH 20B,A01,083756,Briones; Jor-el Thomas Caparas,4,0,36,32
1657831902378,MATH 20B,A02,083757,Briones; Jor-el Thomas Caparas,1,0,36,35
1657831902378,MATH 20B,A03,093475,Briones; Jor-el Thomas Caparas,2,0,36,34
1657831908411,MATH 20C,A01,083760,Briones; Jor-el Thomas Caparas,1,0,35,34
1657831908411,MATH 20C,A02,083761,Briones; Jor-el Thomas Caparas,8,0,35,27
1657831908411,MATH 20C,A03,093476,Briones; Jor-el Thomas Caparas,0,1,36,36
1657831908411,MATH 20C,B01,083762,Bach; Quang Tran,1,0,30,29
1657831914438,MATH 20D,A01,083765,Tran; Brian Kha,5,0,30,25
1657831914438,MATH 20D,A02,083766,Tran; Brian Kha,5,0,30,25
1657831914438,MATH 20D,A03,083767,Tran; Brian Kha,5,0,30,25
1657831920478,MATH 20E,A01,083771,Ganguly; Soumya,10,0,32,22
1657831920478,MATH 20E,A02,083772,Ganguly; Soumya,6,0,32,26
1657831920478,MATH 20E,B01,083773,Ciotti; Benjamin,20,0,35,15
1657831920478,MATH 20E,B02,083774,Ciotti; Benjamin,18,0,35,17
1657831926514,MATH 103A,A01,083777,Greenfeld; Be'Eri,3,0,36,33
1657831926514,MATH 103A,A02,083778,Greenfeld; Be'Eri,5,0,36,31
1657831926514,MATH 103A,A03,093561,Greenfeld; Be'Eri,6,0,36,30
1657831926514,MATH 103A,B01,083779,Greenfeld; Be'Eri,7,0,36,29
1657831926514,MATH 103A,B02,083780,Greenfeld; Be'Eri,4,0,36,32
1657831926514,MATH 103A,B03,093562,Greenfeld; Be'Eri,3,0,36,33
1657831932544,MATH 105,A01,085443,Carter; Anne Toulson,15,0,35,20
1657831932544,MATH 105,A02,093477,Carter; Anne Toulson,20,0,35,15
1657831938598,MATH 109,A01,083213,Ganzberger; Geoffrey Michael,3,0,34,31
1657831938598,MATH 109,A02,083214,Ganzberger; Geoffrey Michael,4,0,34,30
1657831938598,MATH 109,A03,093478,Ganzberger; Geoffrey Michael,2,0,34,32
1657831938598,MATH 109,B01,083215,Ganzberger; Geoffrey Michael,1,0,32,31
1657831938598,MATH 109,B02,083216,Ganzberger; Geoffrey Michael,2,0,32,30
1657831938598,MATH 109,B03,093479,Ganzberger; Geoffrey Michael,8,0,32,24
1657831944635,MATH 142A,A01,083219,Chow; Bennett,7,0,32,25
1657831944635,MATH 142A,A02,083220,Chow; Bennett,10,0,32,22
1657831944635,MATH 142A,A03,093480,Chow; Bennett,9,0,32,23
1657831944635,MATH 142A,B03,093481,Chow; Bennett,8,0,32,24
1657831944635,MATH 142A,B04,093558,Chow; Bennett,13,0,32,19
1657831944635,MATH 142A,B05,093559,Chow; Bennett,7,0,32,25
1657831950670,MATH 193A,A01,083224,Rotar; Vladimir,8,0,34,26
1657831950670,MATH 193A,A02,083225,Rotar; Vladimir,10,0,34,24
1657831950670,MATH 193A,A03,083781,Rotar; Vladimir,5,0,34,29
1657831950670,MATH 193A,A04,083782,Rotar; Vladimir,11,0,34,23
1657831950670,MATH 193A,A05,093482,Rotar; Vladimir,10,0,34,24
1657831956693,MATH 197,001,091859,McAuley; Julian John,9999,0,9999,0
1657831956693,MATH 197,002,095566,Kedlaya; Kiran S.,9997,0,9999,2
1657831956693,MATH 197,003,095567,Xiao; Ming,9999,0,9999,0
1657831956693,MATH 197,004,095571,Perols; Johan Lars,9998,0,9999,1
1657831963829,COGS 9,A01,083615,Shannon; Kyle Michael,9,0,75,66
1657831969878,COGS 11,A01,083617,Boyle; Mary E. T.,23,0,48,25
1657831975903,COGS 13,A01,083071,Bastos; Amalia Pinkusfeld,11,0,71,60
1657831981933,COGS 14A,A01,092681,Semenuks; Arturs,5,1,100,95
1657831987971,COGS 14B,A01,083073,Cheng; Tzu-Han,6,0,63,57
1657831994009,COGS 17,A01,092677,Semenuks; Arturs,6,0,81,75
1657832000058,COGS 100,A01,083619,Allen; Michael Gordon,17,0,70,53
1657832006089,COGS 101A,A01,083621,Davis; Joshua Daniel,9,0,68,59
1657832012134,COGS 101B,A01,091572,Allen; Michael Gordon,12,0,65,53
1657832018187,COGS 101C,A01,083625,Delgado; Tania,17,0,35,18
1657832024223,COGS 107A,A01,083627,Boyle; Mary E. T.,14,0,60,46
1657832030266,COGS 118A,A01,083075,Gupta; Anjum,21,0,76,55
1657832036293,CSE 3,A50,083646,Miranda; Gregory Joseph,24,0,50,26
1657832042328,CSE 8A,A50,083650,Miranda; Gregory Joseph,17,1,56,39
1657832048357,CSE 11,A01,083080,Cao; Yingjun,6,15,40,34
1657832054389,CSE 12,A01,083652,Krause-Levy; Sophia Louisa,29,1,120,91
1657832060438,CSE 15L,A01,083654,Morris; Justin Loren,9,0,50,41
1657832060438,CSE 15L,A02,083655,Morris; Justin Loren,9,0,50,41
1657832066490,CSE 20,A01,083657,Tran; Khoa Dang,39,0,80,41
1657832072532,CSE 21,A01,095574,Bach; Quang Tran,22,0,48,26
1657832078557,CSE 30,A01,083084,Eldon; John,6,0,80,74
1657832078557,CSE 30,B01,095061,Bhaskar; Nishant,9,0,50,41
1657832084602,CSE 100,A01,083659,Cao; Yingjun,5,4,70,65
1657832090629,CSE 134B,A01,083661,Powell; Thomas Allan,24,0,100,76
1657832096652,CSE 140,A01,083663,Gungor; Onat,15,0,85,70
1657832102702,CSE 140L,A01,083088,Eldon; John,23,0,100,77
1657832108737,CSE 175,A01,083665,Kumar; Rakesh,3,0,25,22
1657832114773,CSE 190,A00,092507,Dubnov; Shlomo,8,0,20,12
1657832120801,ECE 45,A01,083139,Congero; Spencer William,6,0,75,69
1657832126839,ECE 65,A50,083695,Saad; Andrew S,12,0,30,18
1657832126839,ECE 65,A51,095125,Saad; Andrew S,24,0,26,2
1657832132873,ECE 109,A01,091882,Touri; Behrouz,20,0,70,50
1657832138899,ECE 180,A00,083140,Abi Samra; Nicholas Camill,1,0,30,29
1657832138899,ECE 180,B00,083141,Abi Samra; Nicholas Camill,0,0,30,30
1657832144947,MATH 10A,A01,083735,Patchell; Gregory David,2,0,30,28
1657832144947,MATH 10A,A02,083736,Patchell; Gregory David,20,0,30,10
1657832144947,MATH 10A,A03,083737,Patchell; Gregory David,16,0,30,14
1657832150992,MATH 10B,A01,083207,Lim; Seonhee,8,0,34,26
1657832150992,MATH 10B,A02,083208,Lim; Seonhee,10,0,35,25
1657832150992,MATH 10B,A03,093472,Lim; Seonhee,7,0,34,27
1657832150992,MATH 10B,B01,083739,Sinha; Shubham,13,0,30,17
1657832157029,MATH 18,A01,083743,Cinel; Cameron Alexander,9,0,30,21
1657832157029,MATH 18,A02,083744,Cinel; Cameron Alexander,18,0,30,12
1657832157029,MATH 18,A03,083745,Cinel; Cameron Alexander,10,0,30,20
1657832157029,MATH 18,B01,083748,Rideout; David Porter,5,0,37,32
1657832157029,MATH 18,B02,083749,Rideout; David Porter,5,0,36,31
1657832157029,MATH 18,B03,083750,Rideout; David Porter,3,0,37,34
1657832157029,MATH 18,B04,083751,Rideout; David Porter,6,0,36,30
1657832157029,MATH 18,B05,093473,Rideout; David Porter,6,0,36,30
1657832157029,MATH 18,B06,093474,Rideout; David Porter,6,0,36,30
1657832163067,MATH 20A,A01,083754,Zheng; Zequn,14,0,40,26
1657832169094,MATH 20B,A01,083756,Briones; Jor-el Thomas Caparas,4,0,36,32
1657832169094,MATH 20B,A02,083757,Briones; Jor-el Thomas Caparas,1,0,36,35
1657832169094,MATH 20B,A03,093475,Briones; Jor-el Thomas Caparas,2,0,36,34
1657832175139,MATH 20C,A01,083760,Briones; Jor-el Thomas Caparas,1,0,35,34
1657832175139,MATH 20C,A02,083761,Briones; Jor-el Thomas Caparas,8,0,35,27
1657832175139,MATH 20C,A03,093476,Briones; Jor-el Thomas Caparas,0,1,36,36
1657832175139,MATH 20C,B01,083762,Bach; Quang Tran,1,0,30,29
1657832181174,MATH 20D,A01,083765,Tran; Brian Kha,5,0,30,25
1657832181174,MATH 20D,A02,083766,Tran; Brian Kha,5,0,30,25
1657832181174,MATH 20D,A03,083767,Tran; Brian Kha,5,0,30,25
1657832187212,MATH 20E,A01,083771,Ganguly; Soumya,10,0,32,22
1657832187212,MATH 20E,A02,083772,Ganguly; Soumya,6,0,32,26
1657832187212,MATH 20E,B01,083773,Ciotti; Benjamin,20,0,35,15
1657832187212,MATH 20E,B02,083774,Ciotti; Benjamin,18,0,35,17
1657832193248,MATH 103A,A01,083777,Greenfeld; Be'Eri,3,0,36,33
1657832193248,MATH 103A,A02,083778,Greenfeld; Be'Eri,5,0,36,31
1657832193248,MATH 103A,A03,093561,Greenfeld; Be'Eri,6,0,36,30
1657832193248,MATH 103A,B01,083779,Greenfeld; Be'Eri,7,0,36,29
1657832193248,MATH 103A,B02,083780,Greenfeld; Be'Eri,4,0,36,32
1657832193248,MATH 103A,B03,093562,Greenfeld; Be'Eri,3,0,36,33
1657832199289,MATH 105,A01,085443,Carter; Anne Toulson,15,0,35,20
1657832199289,MATH 105,A02,093477,Carter; Anne Toulson,20,0,35,15
1657832205351,MATH 109,A01,083213,Ganzberger; Geoffrey Michael,3,0,34,31
1657832205351,MATH 109,A02,083214,Ganzberger; Geoffrey Michael,4,0,34,30
1657832205351,MATH 109,A03,093478,Ganzberger; Geoffrey Michael,2,0,34,32
1657832205351,MATH 109,B01,083215,Ganzberger; Geoffrey Michael,1,0,32,31
1657832205351,MATH 109,B02,083216,Ganzberger; Geoffrey Michael,2,0,32,30
1657832205351,MATH 109,B03,093479,Ganzberger; Geoffrey Michael,8,0,32,24
1657832211386,MATH 142A,A01,083219,Chow; Bennett,7,0,32,25
1657832211386,MATH 142A,A02,083220,Chow; Bennett,10,0,32,22
1657832211386,MATH 142A,A03,093480,Chow; Bennett,9,0,32,23
1657832211386,MATH 142A,B03,093481,Chow; Bennett,8,0,32,24
1657832211386,MATH 142A,B04,093558,Chow; Bennett,13,0,32,19
1657832211386,MATH 142A,B05,093559,Chow; Bennett,7,0,32,25
1657832217418,MATH 193A,A01,083224,Rotar; Vladimir,8,0,34,26
1657832217418,MATH 193A,A02,083225,Rotar; Vladimir,10,0,34,24
1657832217418,MATH 193A,A03,083781,Rotar; Vladimir,5,0,34,29
1657832217418,MATH 193A,A04,083782,Rotar; Vladimir,11,0,34,23
1657832217418,MATH 193A,A05,093482,Rotar; Vladimir,10,0,34,24
1657832223473,MATH 197,001,091859,McAuley; Julian John,9999,0,9999,0
1657832223473,MATH 197,002,095566,Kedlaya; Kiran S.,9997,0,9999,2
1657832223473,MATH 197,003,095567,Xiao; Ming,9999,0,9999,0
1657832223473,MATH 197,004,095571,Perols; Johan Lars,9998,0,9999,1
1657832230541,COGS 9,A01,083615,Shannon; Kyle Michael,9,0,75,66
1657832236569,COGS 11,A01,083617,Boyle; Mary E. T.,23,0,48,25
1657832242597,COGS 13,A01,083071,Bastos; Amalia Pinkusfeld,11,0,71,60
1657832248634,COGS 14A,A01,092681,Semenuks; Arturs,5,1,100,95
1657832254662,COGS 14B,A01,083073,Cheng; Tzu-Han,6,0,63,57
1657832260689,COGS 17,A01,092677,Semenuks; Arturs,6,0,81,75
1657832266742,COGS 100,A01,083619,Allen; Michael Gordon,17,0,70,53
1657832272769,COGS 101A,A01,083621,Davis; Joshua Daniel,9,0,68,59
1657832278799,COGS 101B,A01,091572,Allen; Michael Gordon,12,0,65,53
1657832284836,COGS 101C,A01,083625,Delgado; Tania,17,0,35,18
1657832290859,COGS 107A,A01,083627,Boyle; Mary E. T.,14,0,60,46
1657832296894,COGS 118A,A01,083075,Gupta; Anjum,21,0,76,55
1657832302917,CSE 3,A50,083646,Miranda; Gregory Joseph,24,0,50,26
1657832308956,CSE 8A,A50,083650,Miranda; Gregory Joseph,17,1,56,39
1657832314993,CSE 11,A01,083080,Cao; Yingjun,6,15,40,34
1657832321048,CSE 12,A01,083652,Krause-Levy; Sophia Louisa,29,1,120,91
1657832327086,CSE 15L,A01,083654,Morris; Justin Loren,9,0,50,41
1657832327086,CSE 15L,A02,083655,Morris; Justin Loren,9,0,50,41
1657832333112,CSE 20,A01,083657,Tran; Khoa Dang,39,0,80,41
1657832339138,CSE 21,A01,095574,Bach; Quang Tran,22,0,48,26
1657832345169,CSE 30,A01,083084,Eldon; John,6,0,80,74
1657832345169,CSE 30,B01,095061,Bhaskar; Nishant,9,0,50,41
1657832351203,CSE 100,A01,083659,Cao; Yingjun,5,4,70,65
1657832357253,CSE 134B,A01,083661,Powell; Thomas Allan,24,0,100,76
1657832363280,CSE 140,A01,083663,Gungor; Onat,15,0,85,70
1657832369308,CSE 140L,A01,083088,Eldon; John,23,0,100,77
1657832375338,CSE 175,A01,083665,Kumar; Rakesh,3,0,25,22
1657832381384,CSE 190,A00,092507,Dubnov; Shlomo,8,0,20,12
1657832387410,ECE 45,A01,083139,Congero; Spencer William,6,0,75,69
1657832393449,ECE 65,A50,083695,Saad; Andrew S,12,0,30,18
1657832393449,ECE 65,A51,095125,Saad; Andrew S,24,0,26,2
1657832399497,ECE 109,A01,091882,Touri; Behrouz,20,0,70,50
1657832405520,ECE 180,A00,083140,Abi Samra; Nicholas Camill,1,0,30,29
1657832405520,ECE 180,B00,083141,Abi Samra; Nicholas Camill,0,0,30,30
1657832411544,MATH 10A,A01,083735,Patchell; Gregory David,2,0,30,28
1657832411544,MATH 10A,A02,083736,Patchell; Gregory David,20,0,30,10
1657832411544,MATH 10A,A03,083737,Patchell; Gregory David,16,0,30,14
1657832417594,MATH 10B,A01,083207,Lim; Seonhee,8,0,34,26
1657832417594,MATH 10B,A02,083208,Lim; Seonhee,10,0,35,25
1657832417594,MATH 10B,A03,093472,Lim; Seonhee,7,0,34,27
1657832417594,MATH 10B,B01,083739,Sinha; Shubham,13,0,30,17
1657832423617,MATH 18,A01,083743,Cinel; Cameron Alexander,9,0,30,21
1657832423617,MATH 18,A02,083744,Cinel; Cameron Alexander,18,0,30,12
1657832423617,MATH 18,A03,083745,Cinel; Cameron Alexander,10,0,30,20
1657832423617,MATH 18,B01,083748,Rideout; David Porter,5,0,37,32
1657832423617,MATH 18,B02,083749,Rideout; David Porter,5,0,36,31
1657832423617,MATH 18,B03,083750,Rideout; David Porter,3,0,37,34
1657832423617,MATH 18,B04,083751,Rideout; David Porter,6,0,36,30
1657832423617,MATH 18,B05,093473,Rideout; David Porter,6,0,36,30
1657832423617,MATH 18,B06,093474,Rideout; David Porter,6,0,36,30
1657832429660,MATH 20A,A01,083754,Zheng; Zequn,14,0,40,26
1657832435697,MATH 20B,A01,083756,Briones; Jor-el Thomas Caparas,4,0,36,32
1657832435697,MATH 20B,A02,083757,Briones; Jor-el Thomas Caparas,1,0,36,35
1657832435697,MATH 20B,A03,093475,Briones; Jor-el Thomas Caparas,2,0,36,34
1657832441723,MATH 20C,A01,083760,Briones; Jor-el Thomas Caparas,1,0,35,34
1657832441723,MATH 20C,A02,083761,Briones; Jor-el Thomas Caparas,8,0,35,27
1657832441723,MATH 20C,A03,093476,Briones; Jor-el Thomas Caparas,0,1,36,36
1657832441723,MATH 20C,B01,083762,Bach; Quang Tran,1,0,30,29
1657832447747,MATH 20D,A01,083765,Tran; Brian Kha,5,0,30,25
1657832447747,MATH 20D,A02,083766,Tran; Brian Kha,5,0,30,25
1657832447747,MATH 20D,A03,083767,Tran; Brian Kha,5,0,30,25
1657832453786,MATH 20E,A01,083771,Ganguly; Soumya,10,0,32,22
1657832453786,MATH 20E,A02,083772,Ganguly; Soumya,6,0,32,26
1657832453786,MATH 20E,B01,083773,Ciotti; Benjamin,20,0,35,15
1657832453786,MATH 20E,B02,083774,Ciotti; Benjamin,18,0,35,17
1657832459911,MATH 103A,A01,083777,Greenfeld; Be'Eri,3,0,36,33
1657832459911,MATH 103A,A02,083778,Greenfeld; Be'Eri,5,0,36,31
1657832459911,MATH 103A,A03,093561,Greenfeld; Be'Eri,6,0,36,30
1657832459911,MATH 103A,B01,083779,Greenfeld; Be'Eri,7,0,36,29
1657832459911,MATH 103A,B02,083780,Greenfeld; Be'Eri,4,0,36,32
1657832459911,MATH 103A,B03,093562,Greenfeld; Be'Eri,3,0,36,33
1657832465935,MATH 105,A01,085443,Carter; Anne Toulson,15,0,35,20
1657832465935,MATH 105,A02,093477,Carter; Anne Toulson,20,0,35,15
1657832471980,MATH 109,A01,083213,Ganzberger; Geoffrey Michael,3,0,34,31
1657832471980,MATH 109,A02,083214,Ganzberger; Geoffrey Michael,4,0,34,30
1657832471980,MATH 109,A03,093478,Ganzberger; Geoffrey Michael,2,0,34,32
1657832471980,MATH 109,B01,083215,Ganzberger; Geoffrey Michael,1,0,32,31
1657832471980,MATH 109,B02,083216,Ganzberger; Geoffrey Michael,2,0,32,30
1657832471980,MATH 109,B03,093479,Ganzberger; Geoffrey Michael,8,0,32,24
1657832478015,MATH 142A,A01,083219,Chow; Bennett,7,0,32,25
1657832478015,MATH 142A,A02,083220,Chow; Bennett,10,0,32,22
1657832478015,MATH 142A,A03,093480,Chow; Bennett,9,0,32,23
1657832478015,MATH 142A,B03,093481,Chow; Bennett,8,0,32,24
1657832478015,MATH 142A,B04,093558,Chow; Bennett,13,0,32,19
1657832478015,MATH 142A,B05,093559,Chow; Bennett,7,0,32,25
1657832484053,MATH 193A,A01,083224,Rotar; Vladimir,8,0,34,26
1657832484053,MATH 193A,A02,083225,Rotar; Vladimir,10,0,34,24
1657832484053,MATH 193A,A03,083781,Rotar; Vladimir,5,0,34,29
1657832484053,MATH 193A,A04,083782,Rotar; Vladimir,11,0,34,23
1657832484053,MATH 193A,A05,093482,Rotar; Vladimir,10,0,34,24
1657832490100,MATH 197,001,091859,McAuley; Julian John,9999,0,9999,0
1657832490100,MATH 197,002,095566,Kedlaya; Kiran S.,9997,0,9999,2
1657832490100,MATH 197,003,095567,Xiao; Ming,9999,0,9999,0
1657832490100,MATH 197,004,095571,Perols; Johan Lars,9998,0,9999,1
1657832497164,COGS 9,A01,083615,Shannon; Kyle Michael,9,0,75,66
1657832503206,COGS 11,A01,083617,Boyle; Mary E. T.,23,0,48,25
1657832509243,COGS 13,A01,083071,Bastos; Amalia Pinkusfeld,11,0,71,60
1657832515280,COGS 14A,A01,092681,Semenuks; Arturs,5,1,100,95
1657832521330,COGS 14B,A01,083073,Cheng; Tzu-Han,6,0,63,57
1657832527353,COGS 17,A01,092677,Semenuks; Arturs,6,0,81,75
1657832533385,COGS 100,A01,083619,Allen; Michael Gordon,17,0,70,53
1657832539408,COGS 101A,A01,083621,Davis; Joshua Daniel,9,0,68,59
1657832545454,COGS 101B,A01,091572,Allen; Michael Gordon,12,0,65,53
1657832551502,COGS 101C,A01,083625,Delgado; Tania,17,0,35,18
1657832557525,COGS 107A,A01,083627,Boyle; Mary E. T.,14,0,60,46
1657832563548,COGS 118A,A01,083075,Gupta; Anjum,21,0,76,55
1657832569580,CSE 3,A50,083646,Miranda; Gregory Joseph,24,0,50,26
1657832575620,CSE 8A,A50,083650,Miranda; Gregory Joseph,17,1,56,39
1657832581664,CSE 11,A01,083080,Cao; Yingjun,6,15,40,34
1657832587694,CSE 12,A01,083652,Krause-Levy; Sophia Louisa,29,1,120,91
1657832593722,CSE 15L,A01,083654,Morris; Justin Loren,9,0,50,41
1657832593722,CSE 15L,A02,083655,Morris; Justin Loren,9,0,50,41
1657832599773,CSE 20,A01,083657,Tran; Khoa Dang,39,0,80,41
1657832605820,CSE 21,A01,095574,Bach; Quang Tran,22,0,48,26
1657832611856,CSE 30,A01,083084,Eldon; John,6,0,80,74
1657832611856,CSE 30,B01,095061,Bhaskar; Nishant,9,0,50,41
1657832617880,CSE 100,A01,083659,Cao; Yingjun,5,4,70,65
1657832623928,CSE 134B,A01,083661,Powell; Thomas Allan,24,0,100,76
1657832629953,CSE 140,A01,083663,Gungor; Onat,15,0,85,70
1657832635976,CSE 140L,A01,083088,Eldon; John,23,0,100,77
1657832642018,CSE 175,A01,083665,Kumar; Rakesh,3,0,25,22
1657832648072,CSE 190,A00,092507,Dubnov; Shlomo,8,0,20,12
1657832654103,ECE 45,A01,083139,Congero; Spencer William,6,0,75,69
1657832660132,ECE 65,A50,083695,Saad; Andrew S,12,0,30,18
1657832660132,ECE 65,A51,095125,Saad; Andrew S,24,0,26,2
1657832666158,ECE 109,A01,091882,Touri; Behrouz,20,0,70,50
1657832672211,ECE 180,A00,083140,Abi Samra; Nicholas Camill,1,0,30,29
1657832672211,ECE 180,B00,083141,Abi Samra; Nicholas Camill,0,0,30,30
1657832678258,MATH 10A,A01,083735,Patchell; Gregory David,2,0,30,28
1657832678258,MATH 10A,A02,083736,Patchell; Gregory David,20,0,30,10
1657832678258,MATH 10A,A03,083737,Patchell; Gregory David,16,0,30,14
1657832684317,MATH 10B,A01,083207,Lim; Seonhee,8,0,34,26
1657832684317,MATH 10B,A02,083208,Lim; Seonhee,10,0,35,25
1657832684317,MATH 10B,A03,093472,Lim; Seonhee,7,0,34,27
1657832684317,MATH 10B,B01,083739,Sinha; Shubham,13,0,30,17
1657832690364,MATH 18,A01,083743,Cinel; Cameron Alexander,9,0,30,21
1657832690364,MATH 18,A02,083744,Cinel; Cameron Alexander,18,0,30,12
1657832690364,MATH 18,A03,083745,Cinel; Cameron Alexander,10,0,30,20
1657832690364,MATH 18,B01,083748,Rideout; David Porter,5,0,37,32
1657832690364,MATH 18,B02,083749,Rideout; David Porter,5,0,36,31
1657832690364,MATH 18,B03,083750,Rideout; David Porter,3,0,37,34
1657832690364,MATH 18,B04,083751,Rideout; David Porter,6,0,36,30
1657832690364,MATH 18,B05,093473,Rideout; David Porter,6,0,36,30
1657832690364,MATH 18,B06,093474,Rideout; David Porter,6,0,36,30
1657832696409,MATH 20A,A01,083754,Zheng; Zequn,14,0,40,26
1657832702437,MATH 20B,A01,083756,Briones; Jor-el Thomas Caparas,4,0,36,32
1657832702437,MATH 20B,A02,083757,Briones; Jor-el Thomas Caparas,1,0,36,35
1657832702437,MATH 20B,A03,093475,Briones; Jor-el Thomas Caparas,2,0,36,34
1657832708486,MATH 20C,A01,083760,Briones; Jor-el Thomas Caparas,1,0,35,34
1657832708486,MATH 20C,A02,083761,Briones; Jor-el Thomas Caparas,8,0,35,27
1657832708486,MATH 20C,A03,093476,Briones; Jor-el Thomas Caparas,0,1,36,36
1657832708486,MATH 20C,B01,083762,Bach; Quang Tran,1,0,30,29
1657832714530,MATH 20D,A01,083765,Tran; Brian Kha,5,0,30,25
1657832714530,MATH 20D,A02,083766,Tran; Brian Kha,5,0,30,25
1657832714530,MATH 20D,A03,083767,Tran; Brian Kha,5,0,30,25
1657832720556,MATH 20E,A01,083771,Ganguly; Soumya,10,0,32,22
1657832720556,MATH 20E,A02,083772,Ganguly; Soumya,6,0,32,26
1657832720556,MATH 20E,B01,083773,Ciotti; Benjamin,20,0,35,15
1657832720556,MATH 20E,B02,083774,Ciotti; Benjamin,18,0,35,17
1657832726598,MATH 103A,A01,083777,Greenfeld; Be'Eri,3,0,36,33
1657832726598,MATH 103A,A02,083778,Greenfeld; Be'Eri,5,0,36,31
1657832726598,MATH 103A,A03,093561,Greenfeld; Be'Eri,6,0,36,30
1657832726598,MATH 103A,B01,083779,Greenfeld; Be'Eri,7,0,36,29
1657832726598,MATH 103A,B02,083780,Greenfeld; Be'Eri,4,0,36,32
1657832726598,MATH 103A,B03,093562,Greenfeld; Be'Eri,3,0,36,33
1657832732638,MATH 105,A01,085443,Carter; Anne Toulson,15,0,35,20
1657832732638,MATH 105,A02,093477,Carter; Anne Toulson,20,0,35,15
1657832738686,MATH 109,A01,083213,Ganzberger; Geoffrey Michael,3,0,34,31
1657832738686,MATH 109,A02,083214,Ganzberger; Geoffrey Michael,4,0,34,30
1657832738686,MATH 109,A03,093478,Ganzberger; Geoffrey Michael,2,0,34,32
1657832738686,MATH 109,B01,083215,Ganzberger; Geoffrey Michael,1,0,32,31
1657832738686,MATH 109,B02,083216,Ganzberger; Geoffrey Michael,2,0,32,30
1657832738686,MATH 109,B03,093479,Ganzberger; Geoffrey Michael,8,0,32,24
1657832744746,MATH 142A,A01,083219,Chow; Bennett,7,0,32,25
1657832744746,MATH 142A,A02,083220,Chow; Bennett,10,0,32,22
1657832744746,MATH 142A,A03,093480,Chow; Bennett,9,0,32,23
1657832744746,MATH 142A,B03,093481,Chow; Bennett,8,0,32,24
1657832744746,MATH 142A,B04,093558,Chow; Bennett,13,0,32,19
1657832744746,MATH 142A,B05,093559,Chow; Bennett,7,0,32,25
1657832750772,MATH 193A,A01,083224,Rotar; Vladimir,8,0,34,26
1657832750772,MATH 193A,A02,083225,Rotar; Vladimir,10,0,34,24
1657832750772,MATH 193A,A03,083781,Rotar; Vladimir,5,0,34,29
1657832750772,MATH 193A,A04,083782,Rotar; Vladimir,11,0,34,23
1657832750772,MATH 193A,A05,093482,Rotar; Vladimir,10,0,34,24
1657832756812,MATH 197,001,091859,McAuley; Julian John,9999,0,9999,0
1657832756812,MATH 197,002,095566,Kedlaya; Kiran S.,9997,0,9999,2
1657832756812,MATH 197,003,095567,Xiao; Ming,9999,0,9999,0
1657832756812,MATH 197,004,095571,Perols; Johan Lars,9998,0,9999,1
1657832763908,COGS 9,A01,083615,Shannon; Kyle Michael,9,0,75,66
1657832769951,COGS 11,A01,083617,Boyle; Mary E. T.,23,0,48,25
1657832776000,COGS 13,A01,083071,Bastos; Amalia Pinkusfeld,11,0,71,60
1657832782024,COGS 14A,A01,092681,Semenuks; Arturs,5,1,100,95
1657832788049,COGS 14B,A01,083073,Cheng; Tzu-Han,6,0,63,57
1657832794094,COGS 17,A01,092677,Semenuks; Arturs,6,0,81,75
1657832800130,COGS 100,A01,083619,Allen; Michael Gordon,17,0,70,53
1657832806178,COGS 101A,A01,083621,Davis; Joshua Daniel,9,0,68,59
1657832812211,COGS 101B,A01,091572,Allen; Michael Gordon,12,0,65,53
1657832818249,COGS 101C,A01,083625,Delgado; Tania,17,0,35,18
1657832824273,COGS 107A,A01,083627,Boyle; Mary E. T.,14,0,60,46
1657832830310,COGS 118A,A01,083075,Gupta; Anjum,21,0,76,55
1657832836349,CSE 3,A50,083646,Miranda; Gregory Joseph,24,0,50,26
1657832842386,CSE 8A,A50,083650,Miranda; Gregory Joseph,17,1,56,39
1657832848430,CSE 11,A01,083080,Cao; Yingjun,6,15,40,34
1657832854474,CSE 12,A01,083652,Krause-Levy; Sophia Louisa,29,1,120,91
1657832860506,CSE 15L,A01,083654,Morris; Justin Loren,9,0,50,41
1657832860506,CSE 15L,A02,083655,Morris; Justin Loren,9,0,50,41
1657832866527,CSE 20,A01,083657,Tran; Khoa Dang,39,0,80,41
1657832872575,CSE 21,A01,095574,Bach; Quang Tran,22,0,48,26
1657832878632,CSE 30,A01,083084,Eldon; John,6,0,80,74
1657832878632,CSE 30,B01,095061,Bhaskar; Nishant,9,0,50,41
1657832884673,CSE 100,A01,083659,Cao; Yingjun,5,4,70,65
1657832890695,CSE 134B,A01,083661,Powell; Thomas Allan,24,0,100,76
1657832896731,CSE 140,A01,083663,Gungor; Onat,15,0,85,70
1657832902778,CSE 140L,A01,083088,Eldon; John,23,0,100,77
1657832908805,CSE 175,A01,083665,Kumar; Rakesh,3,0,25,22
1657832914849,CSE 190,A00,092507,Dubnov; Shlomo,8,0,20,12
1657832920894,ECE 45,A01,083139,Congero; Spencer William,6,0,75,69
1657832926949,ECE 65,A50,083695,Saad; Andrew S,12,0,30,18
1657832926949,ECE 65,A51,095125,Saad; Andrew S,24,0,26,2
1657832932975,ECE 109,A01,091882,Touri; Behrouz,20,0,70,50
1657832938999,ECE 180,A00,083140,Abi Samra; Nicholas Camill,1,0,30,29
1657832938999,ECE 180,B00,083141,Abi Samra; Nicholas Camill,0,0,30,30
1657832945039,MATH 10A,A01,083735,Patchell; Gregory David,2,0,30,28
1657832945039,MATH 10A,A02,083736,Patchell; Gregory David,20,0,30,10
1657832945039,MATH 10A,A03,083737,Patchell; Gregory David,16,0,30,14
1657832951073,MATH 10B,A01,083207,Lim; Seonhee,8,0,34,26
1657832951073,MATH 10B,A02,083208,Lim; Seonhee,10,0,35,25
1657832951073,MATH 10B,A03,093472,Lim; Seonhee,7,0,34,27
1657832951073,MATH 10B,B01,083739,Sinha; Shubham,13,0,30,17
1657832957102,MATH 18,A01,083743,Cinel; Cameron Alexander,9,0,30,21
1657832957102,MATH 18,A02,083744,Cinel; Cameron Alexander,18,0,30,12
1657832957102,MATH 18,A03,083745,Cinel; Cameron Alexander,10,0,30,20
1657832957102,MATH 18,B01,083748,Rideout; David Porter,5,0,37,32
1657832957102,MATH 18,B02,083749,Rideout; David Porter,5,0,36,31
1657832957102,MATH 18,B03,083750,Rideout; David Porter,3,0,37,34
1657832957102,MATH 18,B04,083751,Rideout; David Porter,6,0,36,30
1657832957102,MATH 18,B05,093473,Rideout; David Porter,6,0,36,30
1657832957102,MATH 18,B06,093474,Rideout; David Porter,6,0,36,30
1657832963124,MATH 20A,A01,083754,Zheng; Zequn,14,0,40,26
1657832969161,MATH 20B,A01,083756,Briones; Jor-el Thomas Caparas,4,0,36,32
1657832969161,MATH 20B,A02,083757,Briones; Jor-el Thomas Caparas,1,0,36,35
1657832969161,MATH 20B,A03,093475,Briones; Jor-el Thomas Caparas,2,0,36,34
1657832975187,MATH 20C,A01,083760,Briones; Jor-el Thomas Caparas,1,0,35,34
1657832975187,MATH 20C,A02,083761,Briones; Jor-el Thomas Caparas,8,0,35,27
1657832975187,MATH 20C,A03,093476,Briones; Jor-el Thomas Caparas,0,1,36,36
1657832975187,MATH 20C,B01,083762,Bach; Quang Tran,1,0,30,29
1657832981231,MATH 20D,A01,083765,Tran; Brian Kha,5,0,30,25
1657832981231,MATH 20D,A02,083766,Tran; Brian Kha,5,0,30,25
1657832981231,MATH 20D,A03,083767,Tran; Brian Kha,5,0,30,25
1657832987290,MATH 20E,A01,083771,Ganguly; Soumya,10,0,32,22
1657832987290,MATH 20E,A02,083772,Ganguly; Soumya,6,0,32,26
1657832987290,MATH 20E,B01,083773,Ciotti; Benjamin,20,0,35,15
1657832987290,MATH 20E,B02,083774,Ciotti; Benjamin,18,0,35,17
1657832993337,MATH 103A,A01,083777,Greenfeld; Be'Eri,3,0,36,33
1657832993337,MATH 103A,A02,083778,Greenfeld; Be'Eri,5,0,36,31
1657832993337,MATH 103A,A03,093561,Greenfeld; Be'Eri,6,0,36,30
1657832993337,MATH 103A,B01,083779,Greenfeld; Be'Eri,7,0,36,29
1657832993337,MATH 103A,B02,083780,Greenfeld; Be'Eri,4,0,36,32
1657832993337,MATH 103A,B03,093562,Greenfeld; Be'Eri,3,0,36,33
1657832999386,MATH 105,A01,085443,Carter; Anne Toulson,15,0,35,20
1657832999386,MATH 105,A02,093477,Carter; Anne Toulson,20,0,35,15
1657833005440,MATH 109,A01,083213,Ganzberger; Geoffrey Michael,3,0,34,31
1657833005440,MATH 109,A02,083214,Ganzberger; Geoffrey Michael,4,0,34,30
1657833005440,MATH 109,A03,093478,Ganzberger; Geoffrey Michael,2,0,34,32
1657833005440,MATH 109,B01,083215,Ganzberger; Geoffrey Michael,1,0,32,31
1657833005440,MATH 109,B02,083216,Ganzberger; Geoffrey Michael,2,0,32,30
1657833005440,MATH 109,B03,093479,Ganzberger; Geoffrey Michael,8,0,32,24
1657833011470,MATH 142A,A01,083219,Chow; Bennett,7,0,32,25
1657833011470,MATH 142A,A02,083220,Chow; Bennett,10,0,32,22
1657833011470,MATH 142A,A03,093480,Chow; Bennett,9,0,32,23
1657833011470,MATH 142A,B03,093481,Chow; Bennett,8,0,32,24
1657833011470,MATH 142A,B04,093558,Chow; Bennett,13,0,32,19
1657833011470,MATH 142A,B05,093559,Chow; Bennett,7,0,32,25
1657833017518,MATH 193A,A01,083224,Rotar; Vladimir,8,0,34,26
1657833017518,MATH 193A,A02,083225,Rotar; Vladimir,10,0,34,24
1657833017518,MATH 193A,A03,083781,Rotar; Vladimir,5,0,34,29
1657833017518,MATH 193A,A04,083782,Rotar; Vladimir,11,0,34,23
1657833017518,MATH 193A,A05,093482,Rotar; Vladimir,10,0,34,24
1657833023543,MATH 197,001,091859,McAuley; Julian John,9999,0,9999,0
1657833023543,MATH 197,002,095566,Kedlaya; Kiran S.,9997,0,9999,2
1657833023543,MATH 197,003,095567,Xiao; Ming,9999,0,9999,0
1657833023543,MATH 197,004,095571,Perols; Johan Lars,9998,0,9999,1
1657833030623,COGS 9,A01,083615,Shannon; Kyle Michael,9,0,75,66
1657833036664,COGS 11,A01,083617,Boyle; Mary E. T.,23,0,48,25
1657833042690,COGS 13,A01,083071,Bastos; Amalia Pinkusfeld,11,0,71,60
1657833048717,COGS 14A,A01,092681,Semenuks; Arturs,5,1,100,95
1657833054893,COGS 14B,A01,083073,Cheng; Tzu-Han,6,0,63,57
1657833060951,COGS 17,A01,092677,Semenuks; Arturs,6,0,81,75
1657833066989,COGS 100,A01,083619,Allen; Michael Gordon,17,0,70,53
1657833073037,COGS 101A,A01,083621,Davis; Joshua Daniel,9,0,68,59
1657833079076,COGS 101B,A01,091572,Allen; Michael Gordon,12,0,65,53
1657833085121,COGS 101C,A01,083625,Delgado; Tania,17,0,35,18
1657833091169,COGS 107A,A01,083627,Boyle; Mary E. T.,14,0,60,46
1657833097225,COGS 118A,A01,083075,Gupta; Anjum,21,0,76,55
1657833103264,CSE 3,A50,083646,Miranda; Gregory Joseph,24,0,50,26
1657833109286,CSE 8A,A50,083650,Miranda; Gregory Joseph,17,1,56,39
1657833115340,CSE 11,A01,083080,Cao; Yingjun,6,15,40,34
1657833121378,CSE 12,A01,083652,Krause-Levy; Sophia Louisa,29,1,120,91
1657833127405,CSE 15L,A01,083654,Morris; Justin Loren,9,0,50,41
1657833127405,CSE 15L,A02,083655,Morris; Justin Loren,9,0,50,41
1657833133442,CSE 20,A01,083657,Tran; Khoa Dang,39,0,80,41
1657833139479,CSE 21,A01,095574,Bach; Quang Tran,22,0,48,26
1657833145515,CSE 30,A01,083084,Eldon; John,6,0,80,74
1657833145515,CSE 30,B01,095061,Bhaskar; Nishant,9,0,50,41
1657833151561,CSE 100,A01,083659,Cao; Yingjun,5,4,70,65
1657833157612,CSE 134B,A01,083661,Powell; Thomas Allan,24,0,100,76
1657833163649,CSE 140,A01,083663,Gungor; Onat,15,0,85,70
1657833169671,CSE 140L,A01,083088,Eldon; John,23,0,100,77
1657833175728,CSE 175,A01,083665,Kumar; Rakesh,3,0,25,22
1657833181771,CSE 190,A00,092507,Dubnov; Shlomo,8,0,20,12
1657833187798,ECE 45,A01,083139,Congero; Spencer William,6,0,75,69
1657833193831,ECE 65,A50,083695,Saad; Andrew S,12,0,30,18
1657833193831,ECE 65,A51,095125,Saad; Andrew S,24,0,26,2
1657833199879,ECE 109,A01,091882,Touri; Behrouz,20,0,70,50
1657833205901,ECE 180,A00,083140,Abi Samra; Nicholas Camill,1,0,30,29
1657833205901,ECE 180,B00,083141,Abi Samra; Nicholas Camill,0,0,30,30
1657833211929,MATH 10A,A01,083735,Patchell; Gregory David,2,0,30,28
1657833211929,MATH 10A,A02,083736,Patchell; Gregory David,20,0,30,10
1657833211929,MATH 10A,A03,083737,Patchell; Gregory David,16,0,30,14
1657833217967,MATH 10B,A01,083207,Lim; Seonhee,8,0,34,26
1657833217967,MATH 10B,A02,083208,Lim; Seonhee,10,0,35,25
1657833217967,MATH 10B,A03,093472,Lim; Seonhee,7,0,34,27
1657833217967,MATH 10B,B01,083739,Sinha; Shubham,13,0,30,17
1657833224000,MATH 18,A01,083743,Cinel; Cameron Alexander,9,0,30,21
1657833224000,MATH 18,A02,083744,Cinel; Cameron Alexander,18,0,30,12
1657833224000,MATH 18,A03,083745,Cinel; Cameron Alexander,10,0,30,20
1657833224000,MATH 18,B01,083748,Rideout; David Porter,5,0,37,32
1657833224000,MATH 18,B02,083749,Rideout; David Porter,5,0,36,31
1657833224000,MATH 18,B03,083750,Rideout; David Porter,3,0,37,34
1657833224000,MATH 18,B04,083751,Rideout; David Porter,6,0,36,30
1657833224000,MATH 18,B05,093473,Rideout; David Porter,6,0,36,30
1657833224000,MATH 18,B06,093474,Rideout; David Porter,6,0,36,30
1657833230029,MATH 20A,A01,083754,Zheng; Zequn,14,0,40,26
1657833236060,MATH 20B,A01,083756,Briones; Jor-el Thomas Caparas,4,0,36,32
1657833236060,MATH 20B,A02,083757,Briones; Jor-el Thomas Caparas,1,0,36,35
1657833236060,MATH 20B,A03,093475,Briones; Jor-el Thomas Caparas,2,0,36,34
1657833242098,MATH 20C,A01,083760,Briones; Jor-el Thomas Caparas,1,0,35,34
1657833242098,MATH 20C,A02,083761,Briones; Jor-el Thomas Caparas,8,0,35,27
1657833242098,MATH 20C,A03,093476,Briones; Jor-el Thomas Caparas,0,1,36,36
1657833242098,MATH 20C,B01,083762,Bach; Quang Tran,1,0,30,29
1657833248126,MATH 20D,A01,083765,Tran; Brian Kha,5,0,30,25
1657833248126,MATH 20D,A02,083766,Tran; Brian Kha,5,0,30,25
1657833248126,MATH 20D,A03,083767,Tran; Brian Kha,5,0,30,25
1657833254175,MATH 20E,A01,083771,Ganguly; Soumya,10,0,32,22
1657833254175,MATH 20E,A02,083772,Ganguly; Soumya,6,0,32,26
1657833254175,MATH 20E,B01,083773,Ciotti; Benjamin,20,0,35,15
1657833254175,MATH 20E,B02,083774,Ciotti; Benjamin,18,0,35,17
1657833260232,MATH 103A,A01,083777,Greenfeld; Be'Eri,3,0,36,33
1657833260232,MATH 103A,A02,083778,Greenfeld; Be'Eri,5,0,36,31
1657833260232,MATH 103A,A03,093561,Greenfeld; Be'Eri,6,0,36,30
1657833260232,MATH 103A,B01,083779,Greenfeld; Be'Eri,7,0,36,29
1657833260232,MATH 103A,B02,083780,Greenfeld; Be'Eri,4,0,36,32
1657833260232,MATH 103A,B03,093562,Greenfeld; Be'Eri,3,0,36,33
1657833266267,MATH 105,A01,085443,Carter; Anne Toulson,15,0,35,20
1657833266267,MATH 105,A02,093477,Carter; Anne Toulson,20,0,35,15
1657833272290,MATH 109,A01,083213,Ganzberger; Geoffrey Michael,3,0,34,31
1657833272290,MATH 109,A02,083214,Ganzberger; Geoffrey Michael,4,0,34,30
1657833272290,MATH 109,A03,093478,Ganzberger; Geoffrey Michael,2,0,34,32
1657833272290,MATH 109,B01,083215,Ganzberger; Geoffrey Michael,1,0,32,31
1657833272290,MATH 109,B02,083216,Ganzberger; Geoffrey Michael,2,0,32,30
1657833272290,MATH 109,B03,093479,Ganzberger; Geoffrey Michael,8,0,32,24
1657833278326,MATH 142A,A01,083219,Chow; Bennett,7,0,32,25
1657833278326,MATH 142A,A02,083220,Chow; Bennett,10,0,32,22
1657833278326,MATH 142A,A03,093480,Chow; Bennett,9,0,32,23
1657833278326,MATH 142A,B03,093481,Chow; Bennett,8,0,32,24
1657833278326,MATH 142A,B04,093558,Chow; Bennett,13,0,32,19
1657833278326,MATH 142A,B05,093559,Chow; Bennett,7,0,32,25
1657833284358,MATH 193A,A01,083224,Rotar; Vladimir,8,0,34,26
1657833284358,MATH 193A,A02,083225,Rotar; Vladimir,10,0,34,24
1657833284358,MATH 193A,A03,083781,Rotar; Vladimir,5,0,34,29
1657833284358,MATH 193A,A04,083782,Rotar; Vladimir,11,0,34,23
1657833284358,MATH 193A,A05,093482,Rotar; Vladimir,10,0,34,24
1657833290381,MATH 197,001,091859,McAuley; Julian John,9999,0,9999,0
1657833290381,MATH 197,002,095566,Kedlaya; Kiran S.,9997,0,9999,2
1657833290381,MATH 197,003,095567,Xiao; Ming,9999,0,9999,0
1657833290381,MATH 197,004,095571,Perols; Johan Lars,9998,0,9999,1
1657833297479,COGS 9,A01,083615,Shannon; Kyle Michael,9,0,75,66
1657833303507,COGS 11,A01,083617,Boyle; Mary E. T.,23,0,48,25
1657833309555,COGS 13,A01,083071,Bastos; Amalia Pinkusfeld,11,0,71,60
1657833315581,COGS 14A,A01,092681,Semenuks; Arturs,5,1,100,95
1657833321604,COGS 14B,A01,083073,Cheng; Tzu-Han,6,0,63,57
1657833327658,COGS 17,A01,092677,Semenuks; Arturs,6,0,81,75
1657833333699,COGS 100,A01,083619,Allen; Michael Gordon,17,0,70,53
1657833339742,COGS 101A,A01,083621,Davis; Joshua Daniel,9,0,68,59
1657833345774,COGS 101B,A01,091572,Allen; Michael Gordon,12,0,65,53
1657833351813,COGS 101C,A01,083625,Delgado; Tania,17,0,35,18
1657833357848,COGS 107A,A01,083627,Boyle; Mary E. T.,14,0,60,46
1657833363895,COGS 118A,A01,083075,Gupta; Anjum,21,0,76,55
1657833369947,CSE 3,A50,083646,Miranda; Gregory Joseph,24,0,50,26
1657833375996,CSE 8A,A50,083650,Miranda; Gregory Joseph,17,1,56,39
1657833382058,CSE 11,A01,083080,Cao; Yingjun,6,15,40,34
1657833388096,CSE 12,A01,083652,Krause-Levy; Sophia Louisa,29,1,120,91
1657833394129,CSE 15L,A01,083654,Morris; Justin Loren,9,0,50,41
1657833394129,CSE 15L,A02,083655,Morris; Justin Loren,9,0,50,41
1657833400158,CSE 20,A01,083657,Tran; Khoa Dang,39,0,80,41
1657833406210,CSE 21,A01,095574,Bach; Quang Tran,22,0,48,26
1657833412233,CSE 30,A01,083084,Eldon; John,6,0,80,74
1657833412233,CSE 30,B01,095061,Bhaskar; Nishant,9,0,50,41
1657833418291,CSE 100,A01,083659,Cao; Yingjun,5,4,70,65
1657833424331,CSE 134B,A01,083661,Powell; Thomas Allan,24,0,100,76
1657833430361,CSE 140,A01,083663,Gungor; Onat,15,0,85,70
1657833436407,CSE 140L,A01,083088,Eldon; John,23,0,100,77
1657833442446,CSE 175,A01,083665,Kumar; Rakesh,3,0,25,22
1657833448477,CSE 190,A00,092507,Dubnov; Shlomo,8,0,20,12
1657833454510,ECE 45,A01,083139,Congero; Spencer William,6,0,75,69
1657833460553,ECE 65,A50,083695,Saad; Andrew S,12,0,30,18
1657833460553,ECE 65,A51,095125,Saad; Andrew S,24,0,26,2
1657833466588,ECE 109,A01,091882,Touri; Behrouz,20,0,70,50
1657833472637,ECE 180,A00,083140,Abi Samra; Nicholas Camill,1,0,30,29
1657833472637,ECE 180,B00,083141,Abi Samra; Nicholas Camill,0,0,30,30
1657833478663,MATH 10A,A01,083735,Patchell; Gregory David,2,0,30,28
1657833478663,MATH 10A,A02,083736,Patchell; Gregory David,20,0,30,10
1657833478663,MATH 10A,A03,083737,Patchell; Gregory David,16,0,30,14
1657833484698,MATH 10B,A01,083207,Lim; Seonhee,8,0,34,26
1657833484698,MATH 10B,A02,083208,Lim; Seonhee,10,0,35,25
1657833484698,MATH 10B,A03,093472,Lim; Seonhee,7,0,34,27
1657833484698,MATH 10B,B01,083739,Sinha; Shubham,14,0,30,16
1657833490740,MATH 18,A01,083743,Cinel; Cameron Alexander,9,0,30,21
1657833490740,MATH 18,A02,083744,Cinel; Cameron Alexander,18,0,30,12
1657833490740,MATH 18,A03,083745,Cinel; Cameron Alexander,10,0,30,20
1657833490740,MATH 18,B01,083748,Rideout; David Porter,5,0,37,32
1657833490740,MATH 18,B02,083749,Rideout; David Porter,5,0,36,31
1657833490740,MATH 18,B03,083750,Rideout; David Porter,3,0,37,34
1657833490740,MATH 18,B04,083751,Rideout; David Porter,6,0,36,30
1657833490740,MATH 18,B05,093473,Rideout; David Porter,6,0,36,30
1657833490740,MATH 18,B06,093474,Rideout; David Porter,6,0,36,30
1657833496793,MATH 20A,A01,083754,Zheng; Zequn,14,0,40,26
1657833502820,MATH 20B,A01,083756,Briones; Jor-el Thomas Caparas,4,0,36,32
1657833502820,MATH 20B,A02,083757,Briones; Jor-el Thomas Caparas,1,0,36,35
1657833502820,MATH 20B,A03,093475,Briones; Jor-el Thomas Caparas,2,0,36,34
1657833508849,MATH 20C,A01,083760,Briones; Jor-el Thomas Caparas,1,0,35,34
1657833508849,MATH 20C,A02,083761,Briones; Jor-el Thomas Caparas,8,0,35,27
1657833508849,MATH 20C,A03,093476,Briones; Jor-el Thomas Caparas,0,1,36,36
1657833508849,MATH 20C,B01,083762,Bach; Quang Tran,1,0,30,29
1657833514886,MATH 20D,A01,083765,Tran; Brian Kha,5,0,30,25
1657833514886,MATH 20D,A02,083766,Tran; Brian Kha,5,0,30,25
1657833514886,MATH 20D,A03,083767,Tran; Brian Kha,5,0,30,25
1657833520914,MATH 20E,A01,083771,Ganguly; Soumya,10,0,32,22
1657833520914,MATH 20E,A02,083772,Ganguly; Soumya,6,0,32,26
1657833520914,MATH 20E,B01,083773,Ciotti; Benjamin,20,0,35,15
1657833520914,MATH 20E,B02,083774,Ciotti; Benjamin,18,0,35,17
1657833526964,MATH 103A,A01,083777,Greenfeld; Be'Eri,3,0,36,33
1657833526964,MATH 103A,A02,083778,Greenfeld; Be'Eri,5,0,36,31
1657833526964,MATH 103A,A03,093561,Greenfeld; Be'Eri,6,0,36,30
1657833526964,MATH 103A,B01,083779,Greenfeld; Be'Eri,7,0,36,29
1657833526964,MATH 103A,B02,083780,Greenfeld; Be'Eri,4,0,36,32
1657833526964,MATH 103A,B03,093562,Greenfeld; Be'Eri,3,0,36,33
1657833532993,MATH 105,A01,085443,Carter; Anne Toulson,15,0,35,20
1657833532993,MATH 105,A02,093477,Carter; Anne Toulson,20,0,35,15
1657833539034,MATH 109,A01,083213,Ganzberger; Geoffrey Michael,3,0,34,31
1657833539034,MATH 109,A02,083214,Ganzberger; Geoffrey Michael,4,0,34,30
1657833539034,MATH 109,A03,093478,Ganzberger; Geoffrey Michael,2,0,34,32
1657833539034,MATH 109,B01,083215,Ganzberger; Geoffrey Michael,1,0,32,31
1657833539034,MATH 109,B02,083216,Ganzberger; Geoffrey Michael,2,0,32,30
1657833539034,MATH 109,B03,093479,Ganzberger; Geoffrey Michael,8,0,32,24
1657833545091,MATH 142A,A01,083219,Chow; Bennett,7,0,32,25
1657833545091,MATH 142A,A02,083220,Chow; Bennett,10,0,32,22
1657833545091,MATH 142A,A03,093480,Chow; Bennett,9,0,32,23
1657833545091,MATH 142A,B03,093481,Chow; Bennett,8,0,32,24
1657833545091,MATH 142A,B04,093558,Chow; Bennett,13,0,32,19
1657833545091,MATH 142A,B05,093559,Chow; Bennett,7,0,32,25
1657833551130,MATH 193A,A01,083224,Rotar; Vladimir,8,0,34,26
1657833551130,MATH 193A,A02,083225,Rotar; Vladimir,10,0,34,24
1657833551130,MATH 193A,A03,083781,Rotar; Vladimir,5,0,34,29
1657833551130,MATH 193A,A04,083782,Rotar; Vladimir,11,0,34,23
1657833551130,MATH 193A,A05,093482,Rotar; Vladimir,10,0,34,24
1657833557174,MATH 197,001,091859,McAuley; Julian John,9999,0,9999,0
1657833557174,MATH 197,002,095566,Kedlaya; Kiran S.,9997,0,9999,2
1657833557174,MATH 197,003,095567,Xiao; Ming,9999,0,9999,0
1657833557174,MATH 197,004,095571,Perols; Johan Lars,9998,0,9999,1
1657833564250,COGS 9,A01,083615,Shannon; Kyle Michael,9,0,75,66
1657833570287,COGS 11,A01,083617,Boyle; Mary E. T.,23,0,48,25
1657833576326,COGS 13,A01,083071,Bastos; Amalia Pinkusfeld,11,0,71,60
1657833582353,COGS 14A,A01,092681,Semenuks; Arturs,5,1,100,95
1657833588377,COGS 14B,A01,083073,Cheng; Tzu-Han,6,0,63,57
1657833594407,COGS 17,A01,092677,Semenuks; Arturs,6,0,81,75
1657833600435,COGS 100,A01,083619,Allen; Michael Gordon,17,0,70,53
1657833606474,COGS 101A,A01,083621,Davis; Joshua Daniel,9,0,68,59
1657833612509,COGS 101B,A01,091572,Allen; Michael Gordon,12,0,65,53
1657833618533,COGS 101C,A01,083625,Delgado; Tania,17,0,35,18
1657833624583,COGS 107A,A01,083627,Boyle; Mary E. T.,14,0,60,46
1657833630616,COGS 118A,A01,083075,Gupta; Anjum,21,0,76,55
1657833636663,CSE 3,A50,083646,Miranda; Gregory Joseph,24,0,50,26
1657833642697,CSE 8A,A50,083650,Miranda; Gregory Joseph,17,1,56,39
1657833648720,CSE 11,A01,083080,Cao; Yingjun,6,15,40,34
1657833654845,CSE 12,A01,083652,Krause-Levy; Sophia Louisa,29,1,120,91
1657833660893,CSE 15L,A01,083654,Morris; Justin Loren,9,0,50,41
1657833660893,CSE 15L,A02,083655,Morris; Justin Loren,9,0,50,41
1657833666929,CSE 20,A01,083657,Tran; Khoa Dang,39,0,80,41
1657833672966,CSE 21,A01,095574,Bach; Quang Tran,22,0,48,26
1657833679003,CSE 30,A01,083084,Eldon; John,6,0,80,74
1657833679003,CSE 30,B01,095061,Bhaskar; Nishant,9,0,50,41
1657833685049,CSE 100,A01,083659,Cao; Yingjun,5,4,70,65
1657833691089,CSE 134B,A01,083661,Powell; Thomas Allan,24,0,100,76
1657833697120,CSE 140,A01,083663,Gungor; Onat,15,0,85,70
1657833703145,CSE 140L,A01,083088,Eldon; John,23,0,100,77
1657833709194,CSE 175,A01,083665,Kumar; Rakesh,3,0,25,22
1657833715217,CSE 190,A00,092507,Dubnov; Shlomo,8,0,20,12
1657833721257,ECE 45,A01,083139,Congero; Spencer William,6,0,75,69
1657833727295,ECE 65,A50,083695,Saad; Andrew S,12,0,30,18
1657833727295,ECE 65,A51,095125,Saad; Andrew S,24,0,26,2
1657833733331,ECE 109,A01,091882,Touri; Behrouz,20,0,70,50
1657833739354,ECE 180,A00,083140,Abi Samra; Nicholas Camill,1,0,30,29
1657833739354,ECE 180,B00,083141,Abi Samra; Nicholas Camill,0,0,30,30
1657833745392,MATH 10A,A01,083735,Patchell; Gregory David,2,0,30,28
1657833745392,MATH 10A,A02,083736,Patchell; Gregory David,20,0,30,10
1657833745392,MATH 10A,A03,083737,Patchell; Gregory David,16,0,30,14
1657833751427,MATH 10B,A01,083207,Lim; Seonhee,8,0,34,26
1657833751427,MATH 10B,A02,083208,Lim; Seonhee,10,0,35,25
1657833751427,MATH 10B,A03,093472,Lim; Seonhee,7,0,34,27
1657833751427,MATH 10B,B01,083739,Sinha; Shubham,14,0,30,16
1657833757464,MATH 18,A01,083743,Cinel; Cameron Alexander,9,0,30,21
1657833757464,MATH 18,A02,083744,Cinel; Cameron Alexander,18,0,30,12
1657833757464,MATH 18,A03,083745,Cinel; Cameron Alexander,10,0,30,20
1657833757464,MATH 18,B01,083748,Rideout; David Porter,5,0,37,32
1657833757464,MATH 18,B02,083749,Rideout; David Porter,5,0,36,31
1657833757464,MATH 18,B03,083750,Rideout; David Porter,3,0,37,34
1657833757464,MATH 18,B04,083751,Rideout; David Porter,6,0,36,30
1657833757464,MATH 18,B05,093473,Rideout; David Porter,6,0,36,30
1657833757464,MATH 18,B06,093474,Rideout; David Porter,6,0,36,30
1657833763494,MATH 20A,A01,083754,Zheng; Zequn,14,0,40,26
1657833769521,MATH 20B,A01,083756,Briones; Jor-el Thomas Caparas,4,0,36,32
1657833769521,MATH 20B,A02,083757,Briones; Jor-el Thomas Caparas,1,0,36,35
1657833769521,MATH 20B,A03,093475,Briones; Jor-el Thomas Caparas,2,0,36,34
1657833775546,MATH 20C,A01,083760,Briones; Jor-el Thomas Caparas,1,0,35,34
1657833775546,MATH 20C,A02,083761,Briones; Jor-el Thomas Caparas,8,0,35,27
1657833775546,MATH 20C,A03,093476,Briones; Jor-el Thomas Caparas,0,1,36,36
1657833775546,MATH 20C,B01,083762,Bach; Quang Tran,1,0,30,29
1657833781570,MATH 20D,A01,083765,Tran; Brian Kha,5,0,30,25
1657833781570,MATH 20D,A02,083766,Tran; Brian Kha,5,0,30,25
1657833781570,MATH 20D,A03,083767,Tran; Brian Kha,5,0,30,25
1657833787600,MATH 20E,A01,083771,Ganguly; Soumya,10,0,32,22
1657833787600,MATH 20E,A02,083772,Ganguly; Soumya,6,0,32,26
1657833787600,MATH 20E,B01,083773,Ciotti; Benjamin,20,0,35,15
1657833787600,MATH 20E,B02,083774,Ciotti; Benjamin,18,0,35,17
1657833793641,MATH 103A,A01,083777,Greenfeld; Be'Eri,3,0,36,33
1657833793641,MATH 103A,A02,083778,Greenfeld; Be'Eri,5,0,36,31
1657833793641,MATH 103A,A03,093561,Greenfeld; Be'Eri,6,0,36,30
1657833793641,MATH 103A,B01,083779,Greenfeld; Be'Eri,7,0,36,29
1657833793641,MATH 103A,B02,083780,Greenfeld; Be'Eri,4,0,36,32
1657833793641,MATH 103A,B03,093562,Greenfeld; Be'Eri,3,0,36,33
1657833799688,MATH 105,A01,085443,Carter; Anne Toulson,15,0,35,20
1657833799688,MATH 105,A02,093477,Carter; Anne Toulson,20,0,35,15
1657833805735,MATH 109,A01,083213,Ganzberger; Geoffrey Michael,3,0,34,31
1657833805735,MATH 109,A02,083214,Ganzberger; Geoffrey Michael,4,0,34,30
1657833805735,MATH 109,A03,093478,Ganzberger; Geoffrey Michael,2,0,34,32
1657833805735,MATH 109,B01,083215,Ganzberger; Geoffrey Michael,1,0,32,31
1657833805735,MATH 109,B02,083216,Ganzberger; Geoffrey Michael,2,0,32,30
1657833805735,MATH 109,B03,093479,Ganzberger; Geoffrey Michael,8,0,32,24
1657833811762,MATH 142A,A01,083219,Chow; Bennett,7,0,32,25
1657833811762,MATH 142A,A02,083220,Chow; Bennett,10,0,32,22
1657833811762,MATH 142A,A03,093480,Chow; Bennett,9,0,32,23
1657833811762,MATH 142A,B03,093481,Chow; Bennett,8,0,32,24
1657833811762,MATH 142A,B04,093558,Chow; Bennett,13,0,32,19
1657833811762,MATH 142A,B05,093559,Chow; Bennett,7,0,32,25
1657833817798,MATH 193A,A01,083224,Rotar; Vladimir,8,0,34,26
1657833817798,MATH 193A,A02,083225,Rotar; Vladimir,10,0,34,24
1657833817798,MATH 193A,A03,083781,Rotar; Vladimir,5,0,34,29
1657833817798,MATH 193A,A04,083782,Rotar; Vladimir,11,0,34,23
1657833817798,MATH 193A,A05,093482,Rotar; Vladimir,10,0,34,24
1657833823832,MATH 197,001,091859,McAuley; Julian John,9999,0,9999,0
1657833823832,MATH 197,002,095566,Kedlaya; Kiran S.,9997,0,9999,2
1657833823832,MATH 197,003,095567,Xiao; Ming,9999,0,9999,0
1657833823832,MATH 197,004,095571,Perols; Johan Lars,9998,0,9999,1
1657833830910,COGS 9,A01,083615,Shannon; Kyle Michael,9,0,75,66
1657833836945,COGS 11,A01,083617,Boyle; Mary E. T.,23,0,48,25
1657833842976,COGS 13,A01,083071,Bastos; Amalia Pinkusfeld,11,0,71,60
1657833849018,COGS 14A,A01,092681,Semenuks; Arturs,5,1,100,95
1657833855053,COGS 14B,A01,083073,Cheng; Tzu-Han,6,0,63,57
1657833861087,COGS 17,A01,092677,Semenuks; Arturs,6,0,81,75
1657833867111,COGS 100,A01,083619,Allen; Michael Gordon,17,0,70,53
1657833873138,COGS 101A,A01,083621,Davis; Joshua Daniel,9,0,68,59
1657833879167,COGS 101B,A01,091572,Allen; Michael Gordon,12,0,65,53
1657833885193,COGS 101C,A01,083625,Delgado; Tania,17,0,35,18
1657833891235,COGS 107A,A01,083627,Boyle; Mary E. T.,14,0,60,46
1657833897271,COGS 118A,A01,083075,Gupta; Anjum,21,0,76,55
1657833903296,CSE 3,A50,083646,Miranda; Gregory Joseph,24,0,50,26
1657833909319,CSE 8A,A50,083650,Miranda; Gregory Joseph,17,1,56,39
1657833915356,CSE 11,A01,083080,Cao; Yingjun,6,15,40,34
1657833921379,CSE 12,A01,083652,Krause-Levy; Sophia Louisa,29,1,120,91
1657833927402,CSE 15L,A01,083654,Morris; Justin Loren,9,0,50,41
1657833927402,CSE 15L,A02,083655,Morris; Justin Loren,9,0,50,41
1657833933445,CSE 20,A01,083657,Tran; Khoa Dang,39,0,80,41
1657833939482,CSE 21,A01,095574,Bach; Quang Tran,22,0,48,26
1657833945506,CSE 30,A01,083084,Eldon; John,6,0,80,74
1657833945506,CSE 30,B01,095061,Bhaskar; Nishant,9,0,50,41
1657833951547,CSE 100,A01,083659,Cao; Yingjun,5,4,70,65
1657833957573,CSE 134B,A01,083661,Powell; Thomas Allan,24,0,100,76
1657833963622,CSE 140,A01,083663,Gungor; Onat,15,0,85,70
1657833969662,CSE 140L,A01,083088,Eldon; John,23,0,100,77
1657833975703,CSE 175,A01,083665,Kumar; Rakesh,3,0,25,22
1657833981729,CSE 190,A00,092507,Dubnov; Shlomo,8,0,20,12
1657833987776,ECE 45,A01,083139,Congero; Spencer William,6,0,75,69
1657833993824,ECE 65,A50,083695,Saad; Andrew S,12,0,30,18
1657833993824,ECE 65,A51,095125,Saad; Andrew S,24,0,26,2
1657833999858,ECE 109,A01,091882,Touri; Behrouz,20,0,70,50
1657834005895,ECE 180,A00,083140,Abi Samra; Nicholas Camill,1,0,30,29
1657834005895,ECE 180,B00,083141,Abi Samra; Nicholas Camill,0,0,30,30
1657834011931,MATH 10A,A01,083735,Patchell; Gregory David,2,0,30,28
1657834011931,MATH 10A,A02,083736,Patchell; Gregory David,20,0,30,10
1657834011931,MATH 10A,A03,083737,Patchell; Gregory David,16,0,30,14
1657834017974,MATH 10B,A01,083207,Lim; Seonhee,8,0,34,26
1657834017974,MATH 10B,A02,083208,Lim; Seonhee,10,0,35,25
1657834017974,MATH 10B,A03,093472,Lim; Seonhee,7,0,34,27
1657834017974,MATH 10B,B01,083739,Sinha; Shubham,14,0,30,16
1657834024030,MATH 18,A01,083743,Cinel; Cameron Alexander,9,0,30,21
1657834024030,MATH 18,A02,083744,Cinel; Cameron Alexander,18,0,30,12
1657834024030,MATH 18,A03,083745,Cinel; Cameron Alexander,10,0,30,20
1657834024030,MATH 18,B01,083748,Rideout; David Porter,5,0,37,32
1657834024030,MATH 18,B02,083749,Rideout; David Porter,5,0,36,31
1657834024030,MATH 18,B03,083750,Rideout; David Porter,3,0,37,34
1657834024030,MATH 18,B04,083751,Rideout; David Porter,6,0,36,30
1657834024030,MATH 18,B05,093473,Rideout; David Porter,6,0,36,30
1657834024030,MATH 18,B06,093474,Rideout; David Porter,6,0,36,30
1657834030066,MATH 20A,A01,083754,Zheng; Zequn,14,0,40,26
1657834036111,MATH 20B,A01,083756,Briones; Jor-el Thomas Caparas,4,0,36,32
1657834036111,MATH 20B,A02,083757,Briones; Jor-el Thomas Caparas,1,0,36,35
1657834036111,MATH 20B,A03,093475,Briones; Jor-el Thomas Caparas,2,0,36,34
1657834042155,MATH 20C,A01,083760,Briones; Jor-el Thomas Caparas,1,0,35,34
1657834042155,MATH 20C,A02,083761,Briones; Jor-el Thomas Caparas,8,0,35,27
1657834042155,MATH 20C,A03,093476,Briones; Jor-el Thomas Caparas,0,1,36,36
1657834042155,MATH 20C,B01,083762,Bach; Quang Tran,1,0,30,29
1657834048186,MATH 20D,A01,083765,Tran; Brian Kha,5,0,30,25
1657834048186,MATH 20D,A02,083766,Tran; Brian Kha,5,0,30,25
1657834048186,MATH 20D,A03,083767,Tran; Brian Kha,5,0,30,25
1657834054214,MATH 20E,A01,083771,Ganguly; Soumya,10,0,32,22
1657834054214,MATH 20E,A02,083772,Ganguly; Soumya,6,0,32,26
1657834054214,MATH 20E,B01,083773,Ciotti; Benjamin,20,0,35,15
1657834054214,MATH 20E,B02,083774,Ciotti; Benjamin,18,0,35,17
1657834060266,MATH 103A,A01,083777,Greenfeld; Be'Eri,3,0,36,33
1657834060266,MATH 103A,A02,083778,Greenfeld; Be'Eri,5,0,36,31
1657834060266,MATH 103A,A03,093561,Greenfeld; Be'Eri,6,0,36,30
1657834060266,MATH 103A,B01,083779,Greenfeld; Be'Eri,7,0,36,29
1657834060266,MATH 103A,B02,083780,Greenfeld; Be'Eri,4,0,36,32
1657834060266,MATH 103A,B03,093562,Greenfeld; Be'Eri,3,0,36,33
1657834066315,MATH 105,A01,085443,Carter; Anne Toulson,15,0,35,20
1657834066315,MATH 105,A02,093477,Carter; Anne Toulson,20,0,35,15
1657834072363,MATH 109,A01,083213,Ganzberger; Geoffrey Michael,3,0,34,31
1657834072363,MATH 109,A02,083214,Ganzberger; Geoffrey Michael,4,0,34,30
1657834072363,MATH 109,A03,093478,Ganzberger; Geoffrey Michael,2,0,34,32
1657834072363,MATH 109,B01,083215,Ganzberger; Geoffrey Michael,1,0,32,31
1657834072363,MATH 109,B02,083216,Ganzberger; Geoffrey Michael,2,0,32,30
1657834072363,MATH 109,B03,093479,Ganzberger; Geoffrey Michael,8,0,32,24
1657834078394,MATH 142A,A01,083219,Chow; Bennett,7,0,32,25
1657834078394,MATH 142A,A02,083220,Chow; Bennett,10,0,32,22
1657834078394,MATH 142A,A03,093480,Chow; Bennett,9,0,32,23
1657834078394,MATH 142A,B03,093481,Chow; Bennett,8,0,32,24
1657834078394,MATH 142A,B04,093558,Chow; Bennett,13,0,32,19
1657834078394,MATH 142A,B05,093559,Chow; Bennett,7,0,32,25
1657834084431,MATH 193A,A01,083224,Rotar; Vladimir,8,0,34,26
1657834084431,MATH 193A,A02,083225,Rotar; Vladimir,10,0,34,24
1657834084431,MATH 193A,A03,083781,Rotar; Vladimir,5,0,34,29
1657834084431,MATH 193A,A04,083782,Rotar; Vladimir,11,0,34,23
1657834084431,MATH 193A,A05,093482,Rotar; Vladimir,10,0,34,24
1657834090473,MATH 197,001,091859,McAuley; Julian John,9999,0,9999,0
1657834090473,MATH 197,002,095566,Kedlaya; Kiran S.,9997,0,9999,2
1657834090473,MATH 197,003,095567,Xiao; Ming,9999,0,9999,0
1657834090473,MATH 197,004,095571,Perols; Johan Lars,9998,0,9999,1
1657834097545,COGS 9,A01,083615,Shannon; Kyle Michael,9,0,75,66
1657834103587,COGS 11,A01,083617,Boyle; Mary E. T.,23,0,48,25
1657834109611,COGS 13,A01,083071,Bastos; Amalia Pinkusfeld,11,0,71,60
1657834115656,COGS 14A,A01,092681,Semenuks; Arturs,5,1,100,95
1657834121688,COGS 14B,A01,083073,Cheng; Tzu-Han,6,0,63,57
1657834127721,COGS 17,A01,092677,Semenuks; Arturs,6,0,81,75
1657834133743,COGS 100,A01,083619,Allen; Michael Gordon,17,0,70,53
1657834139792,COGS 101A,A01,083621,Davis; Joshua Daniel,9,0,68,59
1657834145815,COGS 101B,A01,091572,Allen; Michael Gordon,12,0,65,53
1657834151847,COGS 101C,A01,083625,Delgado; Tania,17,0,35,18
1657834157884,COGS 107A,A01,083627,Boyle; Mary E. T.,14,0,60,46
1657834163937,COGS 118A,A01,083075,Gupta; Anjum,21,0,76,55
1657834169974,CSE 3,A50,083646,Miranda; Gregory Joseph,24,0,50,26
1657834176005,CSE 8A,A50,083650,Miranda; Gregory Joseph,17,1,56,39
1657834182040,CSE 11,A01,083080,Cao; Yingjun,6,15,40,34
1657834188082,CSE 12,A01,083652,Krause-Levy; Sophia Louisa,29,1,120,91
1657834194140,CSE 15L,A01,083654,Morris; Justin Loren,9,0,50,41
1657834194140,CSE 15L,A02,083655,Morris; Justin Loren,9,0,50,41
1657834200191,CSE 20,A01,083657,Tran; Khoa Dang,39,0,80,41
1657834206217,CSE 21,A01,095574,Bach; Quang Tran,22,0,48,26
1657834212240,CSE 30,A01,083084,Eldon; John,6,0,80,74
1657834212240,CSE 30,B01,095061,Bhaskar; Nishant,9,0,50,41
1657834218272,CSE 100,A01,083659,Cao; Yingjun,5,4,70,65
1657834224297,CSE 134B,A01,083661,Powell; Thomas Allan,24,0,100,76
1657834230336,CSE 140,A01,083663,Gungor; Onat,15,0,85,70
1657834236371,CSE 140L,A01,083088,Eldon; John,23,0,100,77
1657834242400,CSE 175,A01,083665,Kumar; Rakesh,3,0,25,22
1657834248443,CSE 190,A00,092507,Dubnov; Shlomo,8,0,20,12
1657834254594,ECE 45,A01,083139,Congero; Spencer William,6,0,75,69
1657834260617,ECE 65,A50,083695,Saad; Andrew S,12,0,30,18
1657834260617,ECE 65,A51,095125,Saad; Andrew S,24,0,26,2
1657834266666,ECE 109,A01,091882,Touri; Behrouz,20,0,70,50
1657834272711,ECE 180,A00,083140,Abi Samra; Nicholas Camill,1,0,30,29
1657834272711,ECE 180,B00,083141,Abi Samra; Nicholas Camill,0,0,30,30
1657834278735,MATH 10A,A01,083735,Patchell; Gregory David,2,0,30,28
1657834278735,MATH 10A,A02,083736,Patchell; Gregory David,20,0,30,10
1657834278735,MATH 10A,A03,083737,Patchell; Gregory David,16,0,30,14
1657834284778,MATH 10B,A01,083207,Lim; Seonhee,8,0,34,26
1657834284778,MATH 10B,A02,083208,Lim; Seonhee,10,0,35,25
1657834284778,MATH 10B,A03,093472,Lim; Seonhee,7,0,34,27
1657834284778,MATH 10B,B01,083739,Sinha; Shubham,14,0,30,16
1657834290809,MATH 18,A01,083743,Cinel; Cameron Alexander,9,0,30,21
1657834290809,MATH 18,A02,083744,Cinel; Cameron Alexander,18,0,30,12
1657834290809,MATH 18,A03,083745,Cinel; Cameron Alexander,10,0,30,20
1657834290809,MATH 18,B01,083748,Rideout; David Porter,5,0,37,32
1657834290809,MATH 18,B02,083749,Rideout; David Porter,5,0,36,31
1657834290809,MATH 18,B03,083750,Rideout; David Porter,3,0,37,34
1657834290809,MATH 18,B04,083751,Rideout; David Porter,6,0,36,30
1657834290809,MATH 18,B05,093473,Rideout; David Porter,6,0,36,30
1657834290809,MATH 18,B06,093474,Rideout; David Porter,6,0,36,30
1657834296847,MATH 20A,A01,083754,Zheng; Zequn,14,0,40,26
1657834302873,MATH 20B,A01,083756,Briones; Jor-el Thomas Caparas,4,0,36,32
1657834302873,MATH 20B,A02,083757,Briones; Jor-el Thomas Caparas,1,0,36,35
1657834302873,MATH 20B,A03,093475,Briones; Jor-el Thomas Caparas,2,0,36,34
1657834308928,MATH 20C,A01,083760,Briones; Jor-el Thomas Caparas,1,0,35,34
1657834308928,MATH 20C,A02,083761,Briones; Jor-el Thomas Caparas,8,0,35,27
1657834308928,MATH 20C,A03,093476,Briones; Jor-el Thomas Caparas,0,1,36,36
1657834308928,MATH 20C,B01,083762,Bach; Quang Tran,1,0,30,29
1657834314952,MATH 20D,A01,083765,Tran; Brian Kha,5,0,30,25
1657834314952,MATH 20D,A02,083766,Tran; Brian Kha,5,0,30,25
1657834314952,MATH 20D,A03,083767,Tran; Brian Kha,5,0,30,25
1657834320974,MATH 20E,A01,083771,Ganguly; Soumya,10,0,32,22
1657834320974,MATH 20E,A02,083772,Ganguly; Soumya,6,0,32,26
1657834320974,MATH 20E,B01,083773,Ciotti; Benjamin,20,0,35,15
1657834320974,MATH 20E,B02,083774,Ciotti; Benjamin,18,0,35,17
1657834327009,MATH 103A,A01,083777,Greenfeld; Be'Eri,3,0,36,33
1657834327009,MATH 103A,A02,083778,Greenfeld; Be'Eri,5,0,36,31
1657834327009,MATH 103A,A03,093561,Greenfeld; Be'Eri,6,0,36,30
1657834327009,MATH 103A,B01,083779,Greenfeld; Be'Eri,7,0,36,29
1657834327009,MATH 103A,B02,083780,Greenfeld; Be'Eri,4,0,36,32
1657834327009,MATH 103A,B03,093562,Greenfeld; Be'Eri,3,0,36,33
1657834333049,MATH 105,A01,085443,Carter; Anne Toulson,15,0,35,20
1657834333049,MATH 105,A02,093477,Carter; Anne Toulson,20,0,35,15
1657834339104,MATH 109,A01,083213,Ganzberger; Geoffrey Michael,3,0,34,31
1657834339104,MATH 109,A02,083214,Ganzberger; Geoffrey Michael,4,0,34,30
1657834339104,MATH 109,A03,093478,Ganzberger; Geoffrey Michael,2,0,34,32
1657834339104,MATH 109,B01,083215,Ganzberger; Geoffrey Michael,1,0,32,31
1657834339104,MATH 109,B02,083216,Ganzberger; Geoffrey Michael,2,0,32,30
1657834339104,MATH 109,B03,093479,Ganzberger; Geoffrey Michael,8,0,32,24
1657834345127,MATH 142A,A01,083219,Chow; Bennett,7,0,32,25
1657834345127,MATH 142A,A02,083220,Chow; Bennett,10,0,32,22
1657834345127,MATH 142A,A03,093480,Chow; Bennett,9,0,32,23
1657834345127,MATH 142A,B03,093481,Chow; Bennett,8,0,32,24
1657834345127,MATH 142A,B04,093558,Chow; Bennett,13,0,32,19
1657834345127,MATH 142A,B05,093559,Chow; Bennett,7,0,32,25
1657834351156,MATH 193A,A01,083224,Rotar; Vladimir,8,0,34,26
1657834351156,MATH 193A,A02,083225,Rotar; Vladimir,10,0,34,24
1657834351156,MATH 193A,A03,083781,Rotar; Vladimir,5,0,34,29
1657834351156,MATH 193A,A04,083782,Rotar; Vladimir,11,0,34,23
1657834351156,MATH 193A,A05,093482,Rotar; Vladimir,10,0,34,24
1657834357191,MATH 197,001,091859,McAuley; Julian John,9999,0,9999,0
1657834357191,MATH 197,002,095566,Kedlaya; Kiran S.,9997,0,9999,2
1657834357191,MATH 197,003,095567,Xiao; Ming,9999,0,9999,0
1657834357191,MATH 197,004,095571,Perols; Johan Lars,9998,0,9999,1
1657834364274,COGS 9,A01,083615,Shannon; Kyle Michael,9,0,75,66
1657834370322,COGS 11,A01,083617,Boyle; Mary E. T.,23,0,48,25
1657834376366,COGS 13,A01,083071,Bastos; Amalia Pinkusfeld,11,0,71,60
1657834382402,COGS 14A,A01,092681,Semenuks; Arturs,5,1,100,95
1657834388436,COGS 14B,A01,083073,Cheng; Tzu-Han,6,0,63,57
1657834394470,COGS 17,A01,092677,Semenuks; Arturs,6,0,81,75
1657834400492,COGS 100,A01,083619,Allen; Michael Gordon,17,0,70,53
1657834406531,COGS 101A,A01,083621,Davis; Joshua Daniel,9,0,68,59
1657834412554,COGS 101B,A01,091572,Allen; Michael Gordon,12,0,65,53
1657834418595,COGS 101C,A01,083625,Delgado; Tania,17,0,35,18
1657834424619,COGS 107A,A01,083627,Boyle; Mary E. T.,14,0,60,46
1657834430675,COGS 118A,A01,083075,Gupta; Anjum,21,0,76,55
1657834436724,CSE 3,A50,083646,Miranda; Gregory Joseph,24,0,50,26
1657834442751,CSE 8A,A50,083650,Miranda; Gregory Joseph,17,1,56,39
1657834448787,CSE 11,A01,083080,Cao; Yingjun,6,15,40,34
1657834454818,CSE 12,A01,083652,Krause-Levy; Sophia Louisa,29,1,120,91
1657834460856,CSE 15L,A01,083654,Morris; Justin Loren,9,0,50,41
1657834460856,CSE 15L,A02,083655,Morris; Justin Loren,9,0,50,41
1657834466898,CSE 20,A01,083657,Tran; Khoa Dang,39,0,80,41
1657834472924,CSE 21,A01,095574,Bach; Quang Tran,22,0,48,26
1657834478960,CSE 30,A01,083084,Eldon; John,6,0,80,74
1657834478960,CSE 30,B01,095061,Bhaskar; Nishant,9,0,50,41
1657834484986,CSE 100,A01,083659,Cao; Yingjun,5,4,70,65
1657834491037,CSE 134B,A01,083661,Powell; Thomas Allan,24,0,100,76
1657834497067,CSE 140,A01,083663,Gungor; Onat,15,0,85,70
1657834503109,CSE 140L,A01,083088,Eldon; John,23,0,100,77
1657834509136,CSE 175,A01,083665,Kumar; Rakesh,3,0,25,22
1657834515174,CSE 190,A00,092507,Dubnov; Shlomo,8,0,20,12
1657834521206,ECE 45,A01,083139,Congero; Spencer William,6,0,75,69
1657834527233,ECE 65,A50,083695,Saad; Andrew S,12,0,30,18
1657834527233,ECE 65,A51,095125,Saad; Andrew S,24,0,26,2
1657834533268,ECE 109,A01,091882,Touri; Behrouz,20,0,70,50
1657834539298,ECE 180,A00,083140,Abi Samra; Nicholas Camill,1,0,30,29
1657834539298,ECE 180,B00,083141,Abi Samra; Nicholas Camill,0,0,30,30
1657834545339,MATH 10A,A01,083735,Patchell; Gregory David,2,0,30,28
1657834545339,MATH 10A,A02,083736,Patchell; Gregory David,20,0,30,10
1657834545339,MATH 10A,A03,083737,Patchell; Gregory David,16,0,30,14
1657834551368,MATH 10B,A01,083207,Lim; Seonhee,8,0,34,26
1657834551368,MATH 10B,A02,083208,Lim; Seonhee,10,0,35,25
1657834551368,MATH 10B,A03,093472,Lim; Seonhee,7,0,34,27
1657834551368,MATH 10B,B01,083739,Sinha; Shubham,14,0,30,16
1657834557403,MATH 18,A01,083743,Cinel; Cameron Alexander,9,0,30,21
1657834557403,MATH 18,A02,083744,Cinel; Cameron Alexander,18,0,30,12
1657834557403,MATH 18,A03,083745,Cinel; Cameron Alexander,10,0,30,20
1657834557403,MATH 18,B01,083748,Rideout; David Porter,5,0,37,32
1657834557403,MATH 18,B02,083749,Rideout; David Porter,5,0,36,31
1657834557403,MATH 18,B03,083750,Rideout; David Porter,3,0,37,34
1657834557403,MATH 18,B04,083751,Rideout; David Porter,6,0,36,30
1657834557403,MATH 18,B05,093473,Rideout; David Porter,6,0,36,30
1657834557403,MATH 18,B06,093474,Rideout; David Porter,6,0,36,30
1657834563452,MATH 20A,A01,083754,Zheng; Zequn,14,0,40,26
1657834569490,MATH 20B,A01,083756,Briones; Jor-el Thomas Caparas,4,0,36,32
1657834569490,MATH 20B,A02,083757,Briones; Jor-el Thomas Caparas,1,0,36,35
1657834569490,MATH 20B,A03,093475,Briones; Jor-el Thomas Caparas,2,0,36,34
1657834575553,MATH 20C,A01,083760,Briones; Jor-el Thomas Caparas,1,0,35,34
1657834575553,MATH 20C,A02,083761,Briones; Jor-el Thomas Caparas,8,0,35,27
1657834575553,MATH 20C,A03,093476,Briones; Jor-el Thomas Caparas,0,1,36,36
1657834575553,MATH 20C,B01,083762,Bach; Quang Tran,1,0,30,29
1657834581587,MATH 20D,A01,083765,Tran; Brian Kha,5,0,30,25
1657834581587,MATH 20D,A02,083766,Tran; Brian Kha,5,0,30,25
1657834581587,MATH 20D,A03,083767,Tran; Brian Kha,5,0,30,25
1657834587633,MATH 20E,A01,083771,Ganguly; Soumya,10,0,32,22
1657834587633,MATH 20E,A02,083772,Ganguly; Soumya,6,0,32,26
1657834587633,MATH 20E,B01,083773,Ciotti; Benjamin,20,0,35,15
1657834587633,MATH 20E,B02,083774,Ciotti; Benjamin,18,0,35,17
1657834593660,MATH 103A,A01,083777,Greenfeld; Be'Eri,3,0,36,33
1657834593660,MATH 103A,A02,083778,Greenfeld; Be'Eri,5,0,36,31
1657834593660,MATH 103A,A03,093561,Greenfeld; Be'Eri,6,0,36,30
1657834593660,MATH 103A,B01,083779,Greenfeld; Be'Eri,7,0,36,29
1657834593660,MATH 103A,B02,083780,Greenfeld; Be'Eri,4,0,36,32
1657834593660,MATH 103A,B03,093562,Greenfeld; Be'Eri,3,0,36,33
1657834599697,MATH 105,A01,085443,Carter; Anne Toulson,15,0,35,20
1657834599697,MATH 105,A02,093477,Carter; Anne Toulson,20,0,35,15
1657834605737,MATH 109,A01,083213,Ganzberger; Geoffrey Michael,3,0,34,31
1657834605737,MATH 109,A02,083214,Ganzberger; Geoffrey Michael,4,0,34,30
1657834605737,MATH 109,A03,093478,Ganzberger; Geoffrey Michael,2,0,34,32
1657834605737,MATH 109,B01,083215,Ganzberger; Geoffrey Michael,1,0,32,31
1657834605737,MATH 109,B02,083216,Ganzberger; Geoffrey Michael,2,0,32,30
1657834605737,MATH 109,B03,093479,Ganzberger; Geoffrey Michael,8,0,32,24
1657834611765,MATH 142A,A01,083219,Chow; Bennett,7,0,32,25
1657834611765,MATH 142A,A02,083220,Chow; Bennett,10,0,32,22
1657834611765,MATH 142A,A03,093480,Chow; Bennett,9,0,32,23
1657834611765,MATH 142A,B03,093481,Chow; Bennett,8,0,32,24
1657834611765,MATH 142A,B04,093558,Chow; Bennett,13,0,32,19
1657834611765,MATH 142A,B05,093559,Chow; Bennett,7,0,32,25
1657834617812,MATH 193A,A01,083224,Rotar; Vladimir,8,0,34,26
1657834617812,MATH 193A,A02,083225,Rotar; Vladimir,10,0,34,24
1657834617812,MATH 193A,A03,083781,Rotar; Vladimir,5,0,34,29
1657834617812,MATH 193A,A04,083782,Rotar; Vladimir,11,0,34,23
1657834617812,MATH 193A,A05,093482,Rotar; Vladimir,10,0,34,24
1657834623835,MATH 197,001,091859,McAuley; Julian John,9999,0,9999,0
1657834623835,MATH 197,002,095566,Kedlaya; Kiran S.,9997,0,9999,2
1657834623835,MATH 197,003,095567,Xiao; Ming,9999,0,9999,0
1657834623835,MATH 197,004,095571,Perols; Johan Lars,9998,0,9999,1
1657834630907,COGS 9,A01,083615,Shannon; Kyle Michael,9,0,75,66
1657834636936,COGS 11,A01,083617,Boyle; Mary E. T.,23,0,48,25
1657834642980,COGS 13,A01,083071,Bastos; Amalia Pinkusfeld,11,0,71,60
1657834649022,COGS 14A,A01,092681,Semenuks; Arturs,5,1,100,95
1657834655051,COGS 14B,A01,083073,Cheng; Tzu-Han,6,0,63,57
1657834661086,COGS 17,A01,092677,Semenuks; Arturs,6,0,81,75
1657834667122,COGS 100,A01,083619,Allen; Michael Gordon,17,0,70,53
1657834673163,COGS 101A,A01,083621,Davis; Joshua Daniel,9,0,68,59
1657834679187,COGS 101B,A01,091572,Allen; Michael Gordon,12,0,65,53
1657834685214,COGS 101C,A01,083625,Delgado; Tania,17,0,35,18
1657834691245,COGS 107A,A01,083627,Boyle; Mary E. T.,14,0,60,46
1657834697275,COGS 118A,A01,083075,Gupta; Anjum,21,0,76,55
1657834703309,CSE 3,A50,083646,Miranda; Gregory Joseph,24,0,50,26
1657834709339,CSE 8A,A50,083650,Miranda; Gregory Joseph,17,1,56,39
1657834715368,CSE 11,A01,083080,Cao; Yingjun,6,15,40,34
1657834721392,CSE 12,A01,083652,Krause-Levy; Sophia Louisa,29,1,120,91
1657834727414,CSE 15L,A01,083654,Morris; Justin Loren,9,0,50,41
1657834727414,CSE 15L,A02,083655,Morris; Justin Loren,9,0,50,41
1657834733447,CSE 20,A01,083657,Tran; Khoa Dang,39,0,80,41
1657834739471,CSE 21,A01,095574,Bach; Quang Tran,22,0,48,26
1657834745504,CSE 30,A01,083084,Eldon; John,6,0,80,74
1657834745504,CSE 30,B01,095061,Bhaskar; Nishant,9,0,50,41
1657834751528,CSE 100,A01,083659,Cao; Yingjun,5,4,70,65
1657834757560,CSE 134B,A01,083661,Powell; Thomas Allan,24,0,100,76
1657834763599,CSE 140,A01,083663,Gungor; Onat,15,0,85,70
1657834769636,CSE 140L,A01,083088,Eldon; John,23,0,100,77
1657834775671,CSE 175,A01,083665,Kumar; Rakesh,3,0,25,22
1657834781695,CSE 190,A00,092507,Dubnov; Shlomo,8,0,20,12
1657834787721,ECE 45,A01,083139,Congero; Spencer William,6,0,75,69
1657834793769,ECE 65,A50,083695,Saad; Andrew S,12,0,30,18
1657834793769,ECE 65,A51,095125,Saad; Andrew S,24,0,26,2
1657834799793,ECE 109,A01,091882,Touri; Behrouz,20,0,70,50
1657834805816,ECE 180,A00,083140,Abi Samra; Nicholas Camill,1,0,30,29
1657834805816,ECE 180,B00,083141,Abi Samra; Nicholas Camill,0,0,30,30
1657834811843,MATH 10A,A01,083735,Patchell; Gregory David,2,0,30,28
1657834811843,MATH 10A,A02,083736,Patchell; Gregory David,20,0,30,10
1657834811843,MATH 10A,A03,083737,Patchell; Gregory David,16,0,30,14
1657834817867,MATH 10B,A01,083207,Lim; Seonhee,8,0,34,26
1657834817867,MATH 10B,A02,083208,Lim; Seonhee,10,0,35,25
1657834817867,MATH 10B,A03,093472,Lim; Seonhee,7,0,34,27
1657834817867,MATH 10B,B01,083739,Sinha; Shubham,14,0,30,16
1657834823897,MATH 18,A01,083743,Cinel; Cameron Alexander,9,0,30,21
1657834823897,MATH 18,A02,083744,Cinel; Cameron Alexander,18,0,30,12
1657834823897,MATH 18,A03,083745,Cinel; Cameron Alexander,10,0,30,20
1657834823897,MATH 18,B01,083748,Rideout; David Porter,5,0,37,32
1657834823897,MATH 18,B02,083749,Rideout; David Porter,5,0,36,31
1657834823897,MATH 18,B03,083750,Rideout; David Porter,3,0,37,34
1657834823897,MATH 18,B04,083751,Rideout; David Porter,6,0,36,30
1657834823897,MATH 18,B05,093473,Rideout; David Porter,6,0,36,30
1657834823897,MATH 18,B06,093474,Rideout; David Porter,6,0,36,30
1657834829929,MATH 20A,A01,083754,Zheng; Zequn,14,0,40,26
1657834835953,MATH 20B,A01,083756,Briones; Jor-el Thomas Caparas,4,0,36,32
1657834835953,MATH 20B,A02,083757,Briones; Jor-el Thomas Caparas,1,0,36,35
1657834835953,MATH 20B,A03,093475,Briones; Jor-el Thomas Caparas,2,0,36,34
1657834841977,MATH 20C,A01,083760,Briones; Jor-el Thomas Caparas,1,0,35,34
1657834841977,MATH 20C,A02,083761,Briones; Jor-el Thomas Caparas,8,0,35,27
1657834841977,MATH 20C,A03,093476,Briones; Jor-el Thomas Caparas,0,1,36,36
1657834841977,MATH 20C,B01,083762,Bach; Quang Tran,1,0,30,29
1657834848003,MATH 20D,A01,083765,Tran; Brian Kha,5,0,30,25
1657834848003,MATH 20D,A02,083766,Tran; Brian Kha,5,0,30,25
1657834848003,MATH 20D,A03,083767,Tran; Brian Kha,5,0,30,25
1657834854123,MATH 20E,A01,083771,Ganguly; Soumya,10,0,32,22
1657834854123,MATH 20E,A02,083772,Ganguly; Soumya,6,0,32,26
1657834854123,MATH 20E,B01,083773,Ciotti; Benjamin,20,0,35,15
1657834854123,MATH 20E,B02,083774,Ciotti; Benjamin,18,0,35,17
1657834860158,MATH 103A,A01,083777,Greenfeld; Be'Eri,3,0,36,33
1657834860158,MATH 103A,A02,083778,Greenfeld; Be'Eri,5,0,36,31
1657834860158,MATH 103A,A03,093561,Greenfeld; Be'Eri,6,0,36,30
1657834860158,MATH 103A,B01,083779,Greenfeld; Be'Eri,7,0,36,29
1657834860158,MATH 103A,B02,083780,Greenfeld; Be'Eri,4,0,36,32
1657834860158,MATH 103A,B03,093562,Greenfeld; Be'Eri,3,0,36,33
1657834866198,MATH 105,A01,085443,Carter; Anne Toulson,15,0,35,20
1657834866198,MATH 105,A02,093477,Carter; Anne Toulson,20,0,35,15
1657834872241,MATH 109,A01,083213,Ganzberger; Geoffrey Michael,3,0,34,31
1657834872241,MATH 109,A02,083214,Ganzberger; Geoffrey Michael,4,0,34,30
1657834872241,MATH 109,A03,093478,Ganzberger; Geoffrey Michael,2,0,34,32
1657834872241,MATH 109,B01,083215,Ganzberger; Geoffrey Michael,1,0,32,31
1657834872241,MATH 109,B02,083216,Ganzberger; Geoffrey Michael,2,0,32,30
1657834872241,MATH 109,B03,093479,Ganzberger; Geoffrey Michael,8,0,32,24
1657834878290,MATH 142A,A01,083219,Chow; Bennett,7,0,32,25
1657834878290,MATH 142A,A02,083220,Chow; Bennett,10,0,32,22
1657834878290,MATH 142A,A03,093480,Chow; Bennett,9,0,32,23
1657834878290,MATH 142A,B03,093481,Chow; Bennett,8,0,32,24
1657834878290,MATH 142A,B04,093558,Chow; Bennett,13,0,32,19
1657834878290,MATH 142A,B05,093559,Chow; Bennett,7,0,32,25
1657834884330,MATH 193A,A01,083224,Rotar; Vladimir,8,0,34,26
1657834884330,MATH 193A,A02,083225,Rotar; Vladimir,10,0,34,24
1657834884330,MATH 193A,A03,083781,Rotar; Vladimir,5,0,34,29
1657834884330,MATH 193A,A04,083782,Rotar; Vladimir,11,0,34,23
1657834884330,MATH 193A,A05,093482,Rotar; Vladimir,10,0,34,24
1657834890359,MATH 197,001,091859,McAuley; Julian John,9999,0,9999,0
1657834890359,MATH 197,002,095566,Kedlaya; Kiran S.,9997,0,9999,2
1657834890359,MATH 197,003,095567,Xiao; Ming,9999,0,9999,0
1657834890359,MATH 197,004,095571,Perols; Johan Lars,9998,0,9999,1
1657834897423,COGS 9,A01,083615,Shannon; Kyle Michael,9,0,75,66
1657834903467,COGS 11,A01,083617,Boyle; Mary E. T.,23,0,48,25
1657834909508,COGS 13,A01,083071,Bastos; Amalia Pinkusfeld,11,0,71,60
1657834915530,COGS 14A,A01,092681,Semenuks; Arturs,5,1,100,95
1657834921566,COGS 14B,A01,083073,Cheng; Tzu-Han,6,0,63,57
1657834927588,COGS 17,A01,092677,Semenuks; Arturs,6,0,81,75
1657834933635,COGS 100,A01,083619,Allen; Michael Gordon,17,0,70,53
1657834939679,COGS 101A,A01,083621,Davis; Joshua Daniel,9,0,68,59
1657834945713,COGS 101B,A01,091572,Allen; Michael Gordon,12,0,65,53
1657834951750,COGS 101C,A01,083625,Delgado; Tania,17,0,35,18
1657834957773,COGS 107A,A01,083627,Boyle; Mary E. T.,14,0,60,46
1657834963808,COGS 118A,A01,083075,Gupta; Anjum,21,0,76,55
1657834969858,CSE 3,A50,083646,Miranda; Gregory Joseph,24,0,50,26
1657834975882,CSE 8A,A50,083650,Miranda; Gregory Joseph,17,1,56,39
1657834981940,CSE 11,A01,083080,Cao; Yingjun,6,15,40,34
1657834987977,CSE 12,A01,083652,Krause-Levy; Sophia Louisa,29,1,120,91
1657834993999,CSE 15L,A01,083654,Morris; Justin Loren,9,0,50,41
1657834993999,CSE 15L,A02,083655,Morris; Justin Loren,9,0,50,41
1657835000023,CSE 20,A01,083657,Tran; Khoa Dang,39,0,80,41
1657835006049,CSE 21,A01,095574,Bach; Quang Tran,22,0,48,26
1657835012074,CSE 30,A01,083084,Eldon; John,6,0,80,74
1657835012074,CSE 30,B01,095061,Bhaskar; Nishant,9,0,50,41
1657835018100,CSE 100,A01,083659,Cao; Yingjun,5,4,70,65
1657835024130,CSE 134B,A01,083661,Powell; Thomas Allan,24,0,100,76
1657835030172,CSE 140,A01,083663,Gungor; Onat,15,0,85,70
1657835036196,CSE 140L,A01,083088,Eldon; John,23,0,100,77
1657835042231,CSE 175,A01,083665,Kumar; Rakesh,3,0,25,22
1657835048275,CSE 190,A00,092507,Dubnov; Shlomo,8,0,20,12
1657835054326,ECE 45,A01,083139,Congero; Spencer William,6,0,75,69
1657835060365,ECE 65,A50,083695,Saad; Andrew S,12,0,30,18
1657835060365,ECE 65,A51,095125,Saad; Andrew S,24,0,26,2
1657835066417,ECE 109,A01,091882,Touri; Behrouz,20,0,70,50
1657835072442,ECE 180,A00,083140,Abi Samra; Nicholas Camill,1,0,30,29
1657835072442,ECE 180,B00,083141,Abi Samra; Nicholas Camill,0,0,30,30
1657835078475,MATH 10A,A01,083735,Patchell; Gregory David,2,0,30,28
1657835078475,MATH 10A,A02,083736,Patchell; Gregory David,20,0,30,10
1657835078475,MATH 10A,A03,083737,Patchell; Gregory David,16,0,30,14
1657835084504,MATH 10B,A01,083207,Lim; Seonhee,8,0,34,26
1657835084504,MATH 10B,A02,083208,Lim; Seonhee,10,0,35,25
1657835084504,MATH 10B,A03,093472,Lim; Seonhee,7,0,34,27
1657835084504,MATH 10B,B01,083739,Sinha; Shubham,14,0,30,16
1657835090555,MATH 18,A01,083743,Cinel; Cameron Alexander,9,0,30,21
1657835090555,MATH 18,A02,083744,Cinel; Cameron Alexander,18,0,30,12
1657835090555,MATH 18,A03,083745,Cinel; Cameron Alexander,10,0,30,20
1657835090555,MATH 18,B01,083748,Rideout; David Porter,5,0,37,32
1657835090555,MATH 18,B02,083749,Rideout; David Porter,5,0,36,31
1657835090555,MATH 18,B03,083750,Rideout; David Porter,3,0,37,34
1657835090555,MATH 18,B04,083751,Rideout; David Porter,6,0,36,30
1657835090555,MATH 18,B05,093473,Rideout; David Porter,6,0,36,30
1657835090555,MATH 18,B06,093474,Rideout; David Porter,6,0,36,30
1657835096591,MATH 20A,A01,083754,Zheng; Zequn,14,0,40,26
1657835102646,MATH 20B,A01,083756,Briones; Jor-el Thomas Caparas,4,0,36,32
1657835102646,MATH 20B,A02,083757,Briones; Jor-el Thomas Caparas,1,0,36,35
1657835102646,MATH 20B,A03,093475,Briones; Jor-el Thomas Caparas,2,0,36,34
1657835108674,MATH 20C,A01,083760,Briones; Jor-el Thomas Caparas,1,0,35,34
1657835108674,MATH 20C,A02,083761,Briones; Jor-el Thomas Caparas,8,0,35,27
1657835108674,MATH 20C,A03,093476,Briones; Jor-el Thomas Caparas,0,1,36,36
1657835108674,MATH 20C,B01,083762,Bach; Quang Tran,1,0,30,29
1657835114708,MATH 20D,A01,083765,Tran; Brian Kha,5,0,30,25
1657835114708,MATH 20D,A02,083766,Tran; Brian Kha,5,0,30,25
1657835114708,MATH 20D,A03,083767,Tran; Brian Kha,5,0,30,25
1657835120774,MATH 20E,A01,083771,Ganguly; Soumya,10,0,32,22
1657835120774,MATH 20E,A02,083772,Ganguly; Soumya,6,0,32,26
1657835120774,MATH 20E,B01,083773,Ciotti; Benjamin,20,0,35,15
1657835120774,MATH 20E,B02,083774,Ciotti; Benjamin,18,0,35,17
1657835126800,MATH 103A,A01,083777,Greenfeld; Be'Eri,3,0,36,33
1657835126800,MATH 103A,A02,083778,Greenfeld; Be'Eri,5,0,36,31
1657835126800,MATH 103A,A03,093561,Greenfeld; Be'Eri,6,0,36,30
1657835126800,MATH 103A,B01,083779,Greenfeld; Be'Eri,7,0,36,29
1657835126800,MATH 103A,B02,083780,Greenfeld; Be'Eri,4,0,36,32
1657835126800,MATH 103A,B03,093562,Greenfeld; Be'Eri,3,0,36,33
1657835132851,MATH 105,A01,085443,Carter; Anne Toulson,15,0,35,20
1657835132851,MATH 105,A02,093477,Carter; Anne Toulson,20,0,35,15
1657835138875,MATH 109,A01,083213,Ganzberger; Geoffrey Michael,3,0,34,31
1657835138875,MATH 109,A02,083214,Ganzberger; Geoffrey Michael,4,0,34,30
1657835138875,MATH 109,A03,093478,Ganzberger; Geoffrey Michael,2,0,34,32
1657835138875,MATH 109,B01,083215,Ganzberger; Geoffrey Michael,1,0,32,31
1657835138875,MATH 109,B02,083216,Ganzberger; Geoffrey Michael,2,0,32,30
1657835138875,MATH 109,B03,093479,Ganzberger; Geoffrey Michael,8,0,32,24
1657835144930,MATH 142A,A01,083219,Chow; Bennett,7,0,32,25
1657835144930,MATH 142A,A02,083220,Chow; Bennett,10,0,32,22
1657835144930,MATH 142A,A03,093480,Chow; Bennett,9,0,32,23
1657835144930,MATH 142A,B03,093481,Chow; Bennett,8,0,32,24
1657835144930,MATH 142A,B04,093558,Chow; Bennett,13,0,32,19
1657835144930,MATH 142A,B05,093559,Chow; Bennett,7,0,32,25
1657835150978,MATH 193A,A01,083224,Rotar; Vladimir,8,0,34,26
1657835150978,MATH 193A,A02,083225,Rotar; Vladimir,10,0,34,24
1657835150978,MATH 193A,A03,083781,Rotar; Vladimir,5,0,34,29
1657835150978,MATH 193A,A04,083782,Rotar; Vladimir,11,0,34,23
1657835150978,MATH 193A,A05,093482,Rotar; Vladimir,10,0,34,24
1657835157008,MATH 197,001,091859,McAuley; Julian John,9999,0,9999,0
1657835157008,MATH 197,002,095566,Kedlaya; Kiran S.,9997,0,9999,2
1657835157008,MATH 197,003,095567,Xiao; Ming,9999,0,9999,0
1657835157008,MATH 197,004,095571,Perols; Johan Lars,9998,0,9999,1
1657835164068,COGS 9,A01,083615,Shannon; Kyle Michael,9,0,75,66
1657835170093,COGS 11,A01,083617,Boyle; Mary E. T.,23,0,48,25
1657835176148,COGS 13,A01,083071,Bastos; Amalia Pinkusfeld,11,0,71,60
1657835182180,COGS 14A,A01,092681,Semenuks; Arturs,5,1,100,95
1657835188216,COGS 14B,A01,083073,Cheng; Tzu-Han,6,0,63,57
1657835194265,COGS 17,A01,092677,Semenuks; Arturs,6,0,81,75
1657835200289,COGS 100,A01,083619,Allen; Michael Gordon,17,0,70,53
1657835206313,COGS 101A,A01,083621,Davis; Joshua Daniel,9,0,68,59
1657835212341,COGS 101B,A01,091572,Allen; Michael Gordon,12,0,65,53
1657835218385,COGS 101C,A01,083625,Delgado; Tania,17,0,35,18
1657835224415,COGS 107A,A01,083627,Boyle; Mary E. T.,14,0,60,46
1657835230441,COGS 118A,A01,083075,Gupta; Anjum,21,0,76,55
1657835236476,CSE 3,A50,083646,Miranda; Gregory Joseph,24,0,50,26
1657835242504,CSE 8A,A50,083650,Miranda; Gregory Joseph,17,1,56,39
1657835248559,CSE 11,A01,083080,Cao; Yingjun,6,15,40,34
1657835254599,CSE 12,A01,083652,Krause-Levy; Sophia Louisa,29,1,120,91
1657835260625,CSE 15L,A01,083654,Morris; Justin Loren,9,0,50,41
1657835260625,CSE 15L,A02,083655,Morris; Justin Loren,9,0,50,41
1657835266656,CSE 20,A01,083657,Tran; Khoa Dang,39,0,80,41
1657835272696,CSE 21,A01,095574,Bach; Quang Tran,22,0,48,26
1657835278722,CSE 30,A01,083084,Eldon; John,6,0,80,74
1657835278722,CSE 30,B01,095061,Bhaskar; Nishant,9,0,50,41
1657835284748,CSE 100,A01,083659,Cao; Yingjun,5,4,70,65
1657835290776,CSE 134B,A01,083661,Powell; Thomas Allan,24,0,100,76
1657835296816,CSE 140,A01,083663,Gungor; Onat,15,0,85,70
1657835302871,CSE 140L,A01,083088,Eldon; John,23,0,100,77
1657835308895,CSE 175,A01,083665,Kumar; Rakesh,3,0,25,22
1657835314919,CSE 190,A00,092507,Dubnov; Shlomo,8,0,20,12
1657835320960,ECE 45,A01,083139,Congero; Spencer William,6,0,75,69
1657835326993,ECE 65,A50,083695,Saad; Andrew S,12,0,30,18
1657835326993,ECE 65,A51,095125,Saad; Andrew S,24,0,26,2
1657835333018,ECE 109,A01,091882,Touri; Behrouz,20,0,70,50
1657835339073,ECE 180,A00,083140,Abi Samra; Nicholas Camill,1,0,30,29
1657835339073,ECE 180,B00,083141,Abi Samra; Nicholas Camill,0,0,30,30
1657835345127,MATH 10A,A01,083735,Patchell; Gregory David,2,0,30,28
1657835345127,MATH 10A,A02,083736,Patchell; Gregory David,20,0,30,10
1657835345127,MATH 10A,A03,083737,Patchell; Gregory David,16,0,30,14
1657835351162,MATH 10B,A01,083207,Lim; Seonhee,8,0,34,26
1657835351162,MATH 10B,A02,083208,Lim; Seonhee,10,0,35,25
1657835351162,MATH 10B,A03,093472,Lim; Seonhee,7,0,34,27
1657835351162,MATH 10B,B01,083739,Sinha; Shubham,14,0,30,16
1657835357187,MATH 18,A01,083743,Cinel; Cameron Alexander,9,0,30,21
1657835357187,MATH 18,A02,083744,Cinel; Cameron Alexander,18,0,30,12
1657835357187,MATH 18,A03,083745,Cinel; Cameron Alexander,10,0,30,20
1657835357187,MATH 18,B01,083748,Rideout; David Porter,5,0,37,32
1657835357187,MATH 18,B02,083749,Rideout; David Porter,5,0,36,31
1657835357187,MATH 18,B03,083750,Rideout; David Porter,3,0,37,34
1657835357187,MATH 18,B04,083751,Rideout; David Porter,6,0,36,30
1657835357187,MATH 18,B05,093473,Rideout; David Porter,6,0,36,30
1657835357187,MATH 18,B06,093474,Rideout; David Porter,6,0,36,30
1657835363225,MATH 20A,A01,083754,Zheng; Zequn,14,0,40,26
1657835369267,MATH 20B,A01,083756,Briones; Jor-el Thomas Caparas,4,0,36,32
1657835369267,MATH 20B,A02,083757,Briones; Jor-el Thomas Caparas,1,0,36,35
1657835369267,MATH 20B,A03,093475,Briones; Jor-el Thomas Caparas,2,0,36,34
1657835375303,MATH 20C,A01,083760,Briones; Jor-el Thomas Caparas,1,0,35,34
1657835375303,MATH 20C,A02,083761,Briones; Jor-el Thomas Caparas,8,0,35,27
1657835375303,MATH 20C,A03,093476,Briones; Jor-el Thomas Caparas,0,1,36,36
1657835375303,MATH 20C,B01,083762,Bach; Quang Tran,1,0,30,29
1657835381349,MATH 20D,A01,083765,Tran; Brian Kha,5,0,30,25
1657835381349,MATH 20D,A02,083766,Tran; Brian Kha,5,0,30,25
1657835381349,MATH 20D,A03,083767,Tran; Brian Kha,5,0,30,25
1657835387403,MATH 20E,A01,083771,Ganguly; Soumya,10,0,32,22
1657835387403,MATH 20E,A02,083772,Ganguly; Soumya,6,0,32,26
1657835387403,MATH 20E,B01,083773,Ciotti; Benjamin,20,0,35,15
1657835387403,MATH 20E,B02,083774,Ciotti; Benjamin,18,0,35,17
1657835393454,MATH 103A,A01,083777,Greenfeld; Be'Eri,3,0,36,33
1657835393454,MATH 103A,A02,083778,Greenfeld; Be'Eri,5,0,36,31
1657835393454,MATH 103A,A03,093561,Greenfeld; Be'Eri,6,0,36,30
1657835393454,MATH 103A,B01,083779,Greenfeld; Be'Eri,7,0,36,29
1657835393454,MATH 103A,B02,083780,Greenfeld; Be'Eri,4,0,36,32
1657835393454,MATH 103A,B03,093562,Greenfeld; Be'Eri,3,0,36,33
1657835399490,MATH 105,A01,085443,Carter; Anne Toulson,15,0,35,20
1657835399490,MATH 105,A02,093477,Carter; Anne Toulson,20,0,35,15
1657835405528,MATH 109,A01,083213,Ganzberger; Geoffrey Michael,3,0,34,31
1657835405528,MATH 109,A02,083214,Ganzberger; Geoffrey Michael,4,0,34,30
1657835405528,MATH 109,A03,093478,Ganzberger; Geoffrey Michael,2,0,34,32
1657835405528,MATH 109,B01,083215,Ganzberger; Geoffrey Michael,1,0,32,31
1657835405528,MATH 109,B02,083216,Ganzberger; Geoffrey Michael,2,0,32,30
1657835405528,MATH 109,B03,093479,Ganzberger; Geoffrey Michael,8,0,32,24
1657835411577,MATH 142A,A01,083219,Chow; Bennett,7,0,32,25
1657835411577,MATH 142A,A02,083220,Chow; Bennett,10,0,32,22
1657835411577,MATH 142A,A03,093480,Chow; Bennett,9,0,32,23
1657835411577,MATH 142A,B03,093481,Chow; Bennett,8,0,32,24
1657835411577,MATH 142A,B04,093558,Chow; Bennett,13,0,32,19
1657835411577,MATH 142A,B05,093559,Chow; Bennett,7,0,32,25
1657835417608,MATH 193A,A01,083224,Rotar; Vladimir,8,0,34,26
1657835417608,MATH 193A,A02,083225,Rotar; Vladimir,10,0,34,24
1657835417608,MATH 193A,A03,083781,Rotar; Vladimir,5,0,34,29
1657835417608,MATH 193A,A04,083782,Rotar; Vladimir,11,0,34,23
1657835417608,MATH 193A,A05,093482,Rotar; Vladimir,10,0,34,24
1657835423658,MATH 197,001,091859,McAuley; Julian John,9999,0,9999,0
1657835423658,MATH 197,002,095566,Kedlaya; Kiran S.,9997,0,9999,2
1657835423658,MATH 197,003,095567,Xiao; Ming,9999,0,9999,0
1657835423658,MATH 197,004,095571,Perols; Johan Lars,9998,0,9999,1
1657835430727,COGS 9,A01,083615,Shannon; Kyle Michael,9,0,75,66
1657835436773,COGS 11,A01,083617,Boyle; Mary E. T.,23,0,48,25
1657835442799,COGS 13,A01,083071,Bastos; Amalia Pinkusfeld,11,0,71,60
1657835448951,COGS 14A,A01,092681,Semenuks; Arturs,5,1,100,95
1657835454977,COGS 14B,A01,083073,Cheng; Tzu-Han,6,0,63,57
1657835461030,COGS 17,A01,092677,Semenuks; Arturs,6,0,81,75
1657835467076,COGS 100,A01,083619,Allen; Michael Gordon,17,0,70,53
1657835473107,COGS 101A,A01,083621,Davis; Joshua Daniel,9,0,68,59
1657835479135,COGS 101B,A01,091572,Allen; Michael Gordon,12,0,65,53
1657835485179,COGS 101C,A01,083625,Delgado; Tania,17,0,35,18
1657835491220,COGS 107A,A01,083627,Boyle; Mary E. T.,14,0,60,46
1657835497246,COGS 118A,A01,083075,Gupta; Anjum,21,0,76,55
1657835503280,CSE 3,A50,083646,Miranda; Gregory Joseph,24,0,50,26
1657835509309,CSE 8A,A50,083650,Miranda; Gregory Joseph,17,1,56,39
1657835515343,CSE 11,A01,083080,Cao; Yingjun,6,15,40,34
1657835521376,CSE 12,A01,083652,Krause-Levy; Sophia Louisa,29,1,120,91
1657835527400,CSE 15L,A01,083654,Morris; Justin Loren,9,0,50,41
1657835527400,CSE 15L,A02,083655,Morris; Justin Loren,9,0,50,41
1657835533426,CSE 20,A01,083657,Tran; Khoa Dang,39,0,80,41
1657835539451,CSE 21,A01,095574,Bach; Quang Tran,22,0,48,26
1657835545474,CSE 30,A01,083084,Eldon; John,6,0,80,74
1657835545474,CSE 30,B01,095061,Bhaskar; Nishant,9,0,50,41
1657835551496,CSE 100,A01,083659,Cao; Yingjun,5,4,70,65
1657835557542,CSE 134B,A01,083661,Powell; Thomas Allan,24,0,100,76
1657835563575,CSE 140,A01,083663,Gungor; Onat,15,0,85,70
1657835569605,CSE 140L,A01,083088,Eldon; John,23,0,100,77
1657835575636,CSE 175,A01,083665,Kumar; Rakesh,3,0,25,22
1657835581678,CSE 190,A00,092507,Dubnov; Shlomo,8,0,20,12
1657835587703,ECE 45,A01,083139,Congero; Spencer William,6,0,75,69
1657835593743,ECE 65,A50,083695,Saad; Andrew S,12,0,30,18
1657835593743,ECE 65,A51,095125,Saad; Andrew S,24,0,26,2
1657835599776,ECE 109,A01,091882,Touri; Behrouz,20,0,70,50
1657835605820,ECE 180,A00,083140,Abi Samra; Nicholas Camill,1,0,30,29
1657835605820,ECE 180,B00,083141,Abi Samra; Nicholas Camill,0,0,30,30
1657835611843,MATH 10A,A01,083735,Patchell; Gregory David,2,0,30,28
1657835611843,MATH 10A,A02,083736,Patchell; Gregory David,20,0,30,10
1657835611843,MATH 10A,A03,083737,Patchell; Gregory David,16,0,30,14
1657835617884,MATH 10B,A01,083207,Lim; Seonhee,8,0,34,26
1657835617884,MATH 10B,A02,083208,Lim; Seonhee,10,0,35,25
1657835617884,MATH 10B,A03,093472,Lim; Seonhee,7,0,34,27
1657835617884,MATH 10B,B01,083739,Sinha; Shubham,14,0,30,16
1657835623925,MATH 18,A01,083743,Cinel; Cameron Alexander,9,0,30,21
1657835623925,MATH 18,A02,083744,Cinel; Cameron Alexander,18,0,30,12
1657835623925,MATH 18,A03,083745,Cinel; Cameron Alexander,10,0,30,20
1657835623925,MATH 18,B01,083748,Rideout; David Porter,5,0,37,32
1657835623925,MATH 18,B02,083749,Rideout; David Porter,5,0,36,31
1657835623925,MATH 18,B03,083750,Rideout; David Porter,3,0,37,34
1657835623925,MATH 18,B04,083751,Rideout; David Porter,6,0,36,30
1657835623925,MATH 18,B05,093473,Rideout; David Porter,6,0,36,30
1657835623925,MATH 18,B06,093474,Rideout; David Porter,6,0,36,30
1657835629956,MATH 20A,A01,083754,Zheng; Zequn,14,0,40,26
1657835635978,MATH 20B,A01,083756,Briones; Jor-el Thomas Caparas,4,0,36,32
1657835635978,MATH 20B,A02,083757,Briones; Jor-el Thomas Caparas,1,0,36,35
1657835635978,MATH 20B,A03,093475,Briones; Jor-el Thomas Caparas,2,0,36,34
1657835642017,MATH 20C,A01,083760,Briones; Jor-el Thomas Caparas,1,0,35,34
1657835642017,MATH 20C,A02,083761,Briones; Jor-el Thomas Caparas,8,0,35,27
1657835642017,MATH 20C,A03,093476,Briones; Jor-el Thomas Caparas,0,1,36,36
1657835642017,MATH 20C,B01,083762,Bach; Quang Tran,1,0,30,29
1657835648047,MATH 20D,A01,083765,Tran; Brian Kha,5,0,30,25
1657835648047,MATH 20D,A02,083766,Tran; Brian Kha,5,0,30,25
1657835648047,MATH 20D,A03,083767,Tran; Brian Kha,5,0,30,25
1657835654077,MATH 20E,A01,083771,Ganguly; Soumya,10,0,32,22
1657835654077,MATH 20E,A02,083772,Ganguly; Soumya,6,0,32,26
1657835654077,MATH 20E,B01,083773,Ciotti; Benjamin,20,0,35,15
1657835654077,MATH 20E,B02,083774,Ciotti; Benjamin,18,0,35,17
1657835660116,MATH 103A,A01,083777,Greenfeld; Be'Eri,3,0,36,33
1657835660116,MATH 103A,A02,083778,Greenfeld; Be'Eri,5,0,36,31
1657835660116,MATH 103A,A03,093561,Greenfeld; Be'Eri,6,0,36,30
1657835660116,MATH 103A,B01,083779,Greenfeld; Be'Eri,7,0,36,29
1657835660116,MATH 103A,B02,083780,Greenfeld; Be'Eri,4,0,36,32
1657835660116,MATH 103A,B03,093562,Greenfeld; Be'Eri,3,0,36,33
1657835666138,MATH 105,A01,085443,Carter; Anne Toulson,15,0,35,20
1657835666138,MATH 105,A02,093477,Carter; Anne Toulson,20,0,35,15
1657835672185,MATH 109,A01,083213,Ganzberger; Geoffrey Michael,3,0,34,31
1657835672185,MATH 109,A02,083214,Ganzberger; Geoffrey Michael,4,0,34,30
1657835672185,MATH 109,A03,093478,Ganzberger; Geoffrey Michael,2,0,34,32
1657835672185,MATH 109,B01,083215,Ganzberger; Geoffrey Michael,1,0,32,31
1657835672185,MATH 109,B02,083216,Ganzberger; Geoffrey Michael,2,0,32,30
1657835672185,MATH 109,B03,093479,Ganzberger; Geoffrey Michael,8,0,32,24
1657835678240,MATH 142A,A01,083219,Chow; Bennett,7,0,32,25
1657835678240,MATH 142A,A02,083220,Chow; Bennett,10,0,32,22
1657835678240,MATH 142A,A03,093480,Chow; Bennett,9,0,32,23
1657835678240,MATH 142A,B03,093481,Chow; Bennett,8,0,32,24
1657835678240,MATH 142A,B04,093558,Chow; Bennett,13,0,32,19
1657835678240,MATH 142A,B05,093559,Chow; Bennett,7,0,32,25
1657835684271,MATH 193A,A01,083224,Rotar; Vladimir,8,0,34,26
1657835684271,MATH 193A,A02,083225,Rotar; Vladimir,10,0,34,24
1657835684271,MATH 193A,A03,083781,Rotar; Vladimir,5,0,34,29
1657835684271,MATH 193A,A04,083782,Rotar; Vladimir,11,0,34,23
1657835684271,MATH 193A,A05,093482,Rotar; Vladimir,10,0,34,24
1657835690333,MATH 197,001,091859,McAuley; Julian John,9999,0,9999,0
1657835690333,MATH 197,002,095566,Kedlaya; Kiran S.,9997,0,9999,2
1657835690333,MATH 197,003,095567,Xiao; Ming,9999,0,9999,0
1657835690333,MATH 197,004,095571,Perols; Johan Lars,9998,0,9999,1
1657835697408,COGS 9,A01,083615,Shannon; Kyle Michael,9,0,75,66
1657835703462,COGS 11,A01,083617,Boyle; Mary E. T.,23,0,48,25
1657835709512,COGS 13,A01,083071,Bastos; Amalia Pinkusfeld,11,0,71,60
1657835715538,COGS 14A,A01,092681,Semenuks; Arturs,5,1,100,95
1657835721573,COGS 14B,A01,083073,Cheng; Tzu-Han,6,0,63,57
1657835727617,COGS 17,A01,092677,Semenuks; Arturs,6,0,81,75
1657835733641,COGS 100,A01,083619,Allen; Michael Gordon,17,0,70,53
1657835739670,COGS 101A,A01,083621,Davis; Joshua Daniel,9,0,68,59
1657835745723,COGS 101B,A01,091572,Allen; Michael Gordon,12,0,65,53
1657835751749,COGS 101C,A01,083625,Delgado; Tania,17,0,35,18
1657835757772,COGS 107A,A01,083627,Boyle; Mary E. T.,14,0,60,46
1657835763818,COGS 118A,A01,083075,Gupta; Anjum,21,0,76,55
1657835769842,CSE 3,A50,083646,Miranda; Gregory Joseph,24,0,50,26
1657835775875,CSE 8A,A50,083650,Miranda; Gregory Joseph,17,1,56,39
1657835781912,CSE 11,A01,083080,Cao; Yingjun,6,15,40,34
1657835787953,CSE 12,A01,083652,Krause-Levy; Sophia Louisa,29,1,120,91
1657835794012,CSE 15L,A01,083654,Morris; Justin Loren,9,0,50,41
1657835794012,CSE 15L,A02,083655,Morris; Justin Loren,9,0,50,41
1657835800053,CSE 20,A01,083657,Tran; Khoa Dang,39,0,80,41
1657835806080,CSE 21,A01,095574,Bach; Quang Tran,22,0,48,26
1657835812117,CSE 30,A01,083084,Eldon; John,6,0,80,74
1657835812117,CSE 30,B01,095061,Bhaskar; Nishant,9,0,50,41
1657835818162,CSE 100,A01,083659,Cao; Yingjun,5,4,70,65
1657835824211,CSE 134B,A01,083661,Powell; Thomas Allan,24,0,100,76
1657835830263,CSE 140,A01,083663,Gungor; Onat,15,0,85,70
1657835836294,CSE 140L,A01,083088,Eldon; John,23,0,100,77
1657835842318,CSE 175,A01,083665,Kumar; Rakesh,3,0,25,22
1657835848355,CSE 190,A00,092507,Dubnov; Shlomo,8,0,20,12
1657835854398,ECE 45,A01,083139,Congero; Spencer William,6,0,75,69
1657835860421,ECE 65,A50,083695,Saad; Andrew S,12,0,30,18
1657835860421,ECE 65,A51,095125,Saad; Andrew S,24,0,26,2
1657835866457,ECE 109,A01,091882,Touri; Behrouz,20,0,70,50
1657835872481,ECE 180,A00,083140,Abi Samra; Nicholas Camill,1,0,30,29
1657835872481,ECE 180,B00,083141,Abi Samra; Nicholas Camill,0,0,30,30
1657835878527,MATH 10A,A01,083735,Patchell; Gregory David,2,0,30,28
1657835878527,MATH 10A,A02,083736,Patchell; Gregory David,20,0,30,10
1657835878527,MATH 10A,A03,083737,Patchell; Gregory David,16,0,30,14
1657835884558,MATH 10B,A01,083207,Lim; Seonhee,8,0,34,26
1657835884558,MATH 10B,A02,083208,Lim; Seonhee,10,0,35,25
1657835884558,MATH 10B,A03,093472,Lim; Seonhee,7,0,34,27
1657835884558,MATH 10B,B01,083739,Sinha; Shubham,14,0,30,16
1657835890614,MATH 18,A01,083743,Cinel; Cameron Alexander,9,0,30,21
1657835890614,MATH 18,A02,083744,Cinel; Cameron Alexander,18,0,30,12
1657835890614,MATH 18,A03,083745,Cinel; Cameron Alexander,10,0,30,20
1657835890614,MATH 18,B01,083748,Rideout; David Porter,5,0,37,32
1657835890614,MATH 18,B02,083749,Rideout; David Porter,5,0,36,31
1657835890614,MATH 18,B03,083750,Rideout; David Porter,3,0,37,34
1657835890614,MATH 18,B04,083751,Rideout; David Porter,6,0,36,30
1657835890614,MATH 18,B05,093473,Rideout; David Porter,6,0,36,30
1657835890614,MATH 18,B06,093474,Rideout; David Porter,6,0,36,30
1657835896638,MATH 20A,A01,083754,Zheng; Zequn,14,0,40,26
1657835902680,MATH 20B,A01,083756,Briones; Jor-el Thomas Caparas,4,0,36,32
1657835902680,MATH 20B,A02,083757,Briones; Jor-el Thomas Caparas,1,0,36,35
1657835902680,MATH 20B,A03,093475,Briones; Jor-el Thomas Caparas,2,0,36,34
1657835908728,MATH 20C,A01,083760,Briones; Jor-el Thomas Caparas,1,0,35,34
1657835908728,MATH 20C,A02,083761,Briones; Jor-el Thomas Caparas,8,0,35,27
1657835908728,MATH 20C,A03,093476,Briones; Jor-el Thomas Caparas,0,1,36,36
1657835908728,MATH 20C,B01,083762,Bach; Quang Tran,1,0,30,29
1657835914763,MATH 20D,A01,083765,Tran; Brian Kha,5,0,30,25
1657835914763,MATH 20D,A02,083766,Tran; Brian Kha,5,0,30,25
1657835914763,MATH 20D,A03,083767,Tran; Brian Kha,5,0,30,25
1657835920785,MATH 20E,A01,083771,Ganguly; Soumya,10,0,32,22
1657835920785,MATH 20E,A02,083772,Ganguly; Soumya,6,0,32,26
1657835920785,MATH 20E,B01,083773,Ciotti; Benjamin,20,0,35,15
1657835920785,MATH 20E,B02,083774,Ciotti; Benjamin,18,0,35,17
1657835926807,MATH 103A,A01,083777,Greenfeld; Be'Eri,3,0,36,33
1657835926807,MATH 103A,A02,083778,Greenfeld; Be'Eri,5,0,36,31
1657835926807,MATH 103A,A03,093561,Greenfeld; Be'Eri,6,0,36,30
1657835926807,MATH 103A,B01,083779,Greenfeld; Be'Eri,7,0,36,29
1657835926807,MATH 103A,B02,083780,Greenfeld; Be'Eri,4,0,36,32
1657835926807,MATH 103A,B03,093562,Greenfeld; Be'Eri,3,0,36,33
1657835932845,MATH 105,A01,085443,Carter; Anne Toulson,15,0,35,20
1657835932845,MATH 105,A02,093477,Carter; Anne Toulson,20,0,35,15
1657835938881,MATH 109,A01,083213,Ganzberger; Geoffrey Michael,3,0,34,31
1657835938881,MATH 109,A02,083214,Ganzberger; Geoffrey Michael,4,0,34,30
1657835938881,MATH 109,A03,093478,Ganzberger; Geoffrey Michael,2,0,34,32
1657835938881,MATH 109,B01,083215,Ganzberger; Geoffrey Michael,1,0,32,31
1657835938881,MATH 109,B02,083216,Ganzberger; Geoffrey Michael,2,0,32,30
1657835938881,MATH 109,B03,093479,Ganzberger; Geoffrey Michael,8,0,32,24
1657835944918,MATH 142A,A01,083219,Chow; Bennett,7,0,32,25
1657835944918,MATH 142A,A02,083220,Chow; Bennett,10,0,32,22
1657835944918,MATH 142A,A03,093480,Chow; Bennett,9,0,32,23
1657835944918,MATH 142A,B03,093481,Chow; Bennett,8,0,32,24
1657835944918,MATH 142A,B04,093558,Chow; Bennett,13,0,32,19
1657835944918,MATH 142A,B05,093559,Chow; Bennett,7,0,32,25
1657835950942,MATH 193A,A01,083224,Rotar; Vladimir,8,0,34,26
1657835950942,MATH 193A,A02,083225,Rotar; Vladimir,10,0,34,24
1657835950942,MATH 193A,A03,083781,Rotar; Vladimir,5,0,34,29
1657835950942,MATH 193A,A04,083782,Rotar; Vladimir,11,0,34,23
1657835950942,MATH 193A,A05,093482,Rotar; Vladimir,10,0,34,24
1657835956999,MATH 197,001,091859,McAuley; Julian John,9999,0,9999,0
1657835956999,MATH 197,002,095566,Kedlaya; Kiran S.,9997,0,9999,2
1657835956999,MATH 197,003,095567,Xiao; Ming,9999,0,9999,0
1657835956999,MATH 197,004,095571,Perols; Johan Lars,9998,0,9999,1
1657835964057,COGS 9,A01,083615,Shannon; Kyle Michael,9,0,75,66
1657835970115,COGS 11,A01,083617,Boyle; Mary E. T.,23,0,48,25
1657835976138,COGS 13,A01,083071,Bastos; Amalia Pinkusfeld,11,0,71,60
1657835982169,COGS 14A,A01,092681,Semenuks; Arturs,5,1,100,95
1657835988218,COGS 14B,A01,083073,Cheng; Tzu-Han,6,0,63,57
1657835994246,COGS 17,A01,092677,Semenuks; Arturs,6,0,81,75
1657836000283,COGS 100,A01,083619,Allen; Michael Gordon,17,0,70,53
1657836006320,COGS 101A,A01,083621,Davis; Joshua Daniel,9,0,68,59
1657836012362,COGS 101B,A01,091572,Allen; Michael Gordon,12,0,65,53
1657836018405,COGS 101C,A01,083625,Delgado; Tania,17,0,35,18
1657836024427,COGS 107A,A01,083627,Boyle; Mary E. T.,14,0,60,46
1657836030458,COGS 118A,A01,083075,Gupta; Anjum,21,0,76,55
1657836036487,CSE 3,A50,083646,Miranda; Gregory Joseph,24,0,50,26
1657836042520,CSE 8A,A50,083650,Miranda; Gregory Joseph,17,1,56,39
1657836048650,CSE 11,A01,083080,Cao; Yingjun,6,15,40,34
1657836054682,CSE 12,A01,083652,Krause-Levy; Sophia Louisa,29,1,120,91
1657836060717,CSE 15L,A01,083654,Morris; Justin Loren,9,0,50,41
1657836060717,CSE 15L,A02,083655,Morris; Justin Loren,9,0,50,41
1657836070984,CSE 20,A01,083657,Tran; Khoa Dang,39,0,80,41
1657836080140,CSE 21,A01,095574,Bach; Quang Tran,22,0,48,26
1657836086168,CSE 30,A01,083084,Eldon; John,6,0,80,74
1657836086168,CSE 30,B01,095061,Bhaskar; Nishant,9,0,50,41
1657836092190,CSE 100,A01,083659,Cao; Yingjun,5,4,70,65
1657836098217,CSE 134B,A01,083661,Powell; Thomas Allan,24,0,100,76
1657836104243,CSE 140,A01,083663,Gungor; Onat,15,0,85,70
1657836110293,CSE 140L,A01,083088,Eldon; John,23,0,100,77
1657836116322,CSE 175,A01,083665,Kumar; Rakesh,3,0,25,22
1657836122365,CSE 190,A00,092507,Dubnov; Shlomo,8,0,20,12
1657836128388,ECE 45,A01,083139,Congero; Spencer William,6,0,75,69
1657836134439,ECE 65,A50,083695,Saad; Andrew S,12,0,30,18
1657836134439,ECE 65,A51,095125,Saad; Andrew S,24,0,26,2
1657836140468,ECE 109,A01,091882,Touri; Behrouz,20,0,70,50
1657836146493,ECE 180,A00,083140,Abi Samra; Nicholas Camill,1,0,30,29
1657836146493,ECE 180,B00,083141,Abi Samra; Nicholas Camill,0,0,30,30
1657836152534,MATH 10A,A01,083735,Patchell; Gregory David,2,0,30,28
1657836152534,MATH 10A,A02,083736,Patchell; Gregory David,20,0,30,10
1657836152534,MATH 10A,A03,083737,Patchell; Gregory David,16,0,30,14
1657836158575,MATH 10B,A01,083207,Lim; Seonhee,8,0,34,26
1657836158575,MATH 10B,A02,083208,Lim; Seonhee,10,0,35,25
1657836158575,MATH 10B,A03,093472,Lim; Seonhee,7,0,34,27
1657836158575,MATH 10B,B01,083739,Sinha; Shubham,14,0,30,16
1657836164599,MATH 18,A01,083743,Cinel; Cameron Alexander,9,0,30,21
1657836164599,MATH 18,A02,083744,Cinel; Cameron Alexander,18,0,30,12
1657836164599,MATH 18,A03,083745,Cinel; Cameron Alexander,10,0,30,20
1657836164599,MATH 18,B01,083748,Rideout; David Porter,5,0,37,32
1657836164599,MATH 18,B02,083749,Rideout; David Porter,5,0,36,31
1657836164599,MATH 18,B03,083750,Rideout; David Porter,3,0,37,34
1657836164599,MATH 18,B04,083751,Rideout; David Porter,6,0,36,30
1657836164599,MATH 18,B05,093473,Rideout; David Porter,6,0,36,30
1657836164599,MATH 18,B06,093474,Rideout; David Porter,6,0,36,30
1657836170648,MATH 20A,A01,083754,Zheng; Zequn,14,0,40,26
1657836176693,MATH 20B,A01,083756,Briones; Jor-el Thomas Caparas,4,0,36,32
1657836176693,MATH 20B,A02,083757,Briones; Jor-el Thomas Caparas,1,0,36,35
1657836176693,MATH 20B,A03,093475,Briones; Jor-el Thomas Caparas,2,0,36,34
1657836182733,MATH 20C,A01,083760,Briones; Jor-el Thomas Caparas,1,0,35,34
1657836182733,MATH 20C,A02,083761,Briones; Jor-el Thomas Caparas,8,0,35,27
1657836182733,MATH 20C,A03,093476,Briones; Jor-el Thomas Caparas,0,1,36,36
1657836182733,MATH 20C,B01,083762,Bach; Quang Tran,1,0,30,29
1657836188761,MATH 20D,A01,083765,Tran; Brian Kha,5,0,30,25
1657836188761,MATH 20D,A02,083766,Tran; Brian Kha,5,0,30,25
1657836188761,MATH 20D,A03,083767,Tran; Brian Kha,5,0,30,25
1657836194800,MATH 20E,A01,083771,Ganguly; Soumya,10,0,32,22
1657836194800,MATH 20E,A02,083772,Ganguly; Soumya,6,0,32,26
1657836194800,MATH 20E,B01,083773,Ciotti; Benjamin,20,0,35,15
1657836194800,MATH 20E,B02,083774,Ciotti; Benjamin,18,0,35,17
1657836200848,MATH 103A,A01,083777,Greenfeld; Be'Eri,3,0,36,33
1657836200848,MATH 103A,A02,083778,Greenfeld; Be'Eri,5,0,36,31
1657836200848,MATH 103A,A03,093561,Greenfeld; Be'Eri,6,0,36,30
1657836200848,MATH 103A,B01,083779,Greenfeld; Be'Eri,7,0,36,29
1657836200848,MATH 103A,B02,083780,Greenfeld; Be'Eri,4,0,36,32
1657836200848,MATH 103A,B03,093562,Greenfeld; Be'Eri,3,0,36,33
1657836206876,MATH 105,A01,085443,Carter; Anne Toulson,15,0,35,20
1657836206876,MATH 105,A02,093477,Carter; Anne Toulson,20,0,35,15
1657836212903,MATH 109,A01,083213,Ganzberger; Geoffrey Michael,3,0,34,31
1657836212903,MATH 109,A02,083214,Ganzberger; Geoffrey Michael,4,0,34,30
1657836212903,MATH 109,A03,093478,Ganzberger; Geoffrey Michael,2,0,34,32
1657836212903,MATH 109,B01,083215,Ganzberger; Geoffrey Michael,1,0,32,31
1657836212903,MATH 109,B02,083216,Ganzberger; Geoffrey Michael,2,0,32,30
1657836212903,MATH 109,B03,093479,Ganzberger; Geoffrey Michael,8,0,32,24
1657836218938,MATH 142A,A01,083219,Chow; Bennett,7,0,32,25
1657836218938,MATH 142A,A02,083220,Chow; Bennett,10,0,32,22
1657836218938,MATH 142A,A03,093480,Chow; Bennett,9,0,32,23
1657836218938,MATH 142A,B03,093481,Chow; Bennett,8,0,32,24
1657836218938,MATH 142A,B04,093558,Chow; Bennett,13,0,32,19
1657836218938,MATH 142A,B05,093559,Chow; Bennett,7,0,32,25
1657836224971,MATH 193A,A01,083224,Rotar; Vladimir,8,0,34,26
1657836224971,MATH 193A,A02,083225,Rotar; Vladimir,10,0,34,24
1657836224971,MATH 193A,A03,083781,Rotar; Vladimir,5,0,34,29
1657836224971,MATH 193A,A04,083782,Rotar; Vladimir,11,0,34,23
1657836224971,MATH 193A,A05,093482,Rotar; Vladimir,10,0,34,24
1657836230993,MATH 197,001,091859,McAuley; Julian John,9999,0,9999,0
1657836230993,MATH 197,002,095566,Kedlaya; Kiran S.,9997,0,9999,2
1657836230993,MATH 197,003,095567,Xiao; Ming,9999,0,9999,0
1657836230993,MATH 197,004,095571,Perols; Johan Lars,9998,0,9999,1
1657836238067,COGS 9,A01,083615,Shannon; Kyle Michael,9,0,75,66
1657836244095,COGS 11,A01,083617,Boyle; Mary E. T.,23,0,48,25
1657836250130,COGS 13,A01,083071,Bastos; Amalia Pinkusfeld,11,0,71,60
1657836256154,COGS 14A,A01,092681,Semenuks; Arturs,5,1,100,95
1657836262193,COGS 14B,A01,083073,Cheng; Tzu-Han,6,0,63,57
1657836268230,COGS 17,A01,092677,Semenuks; Arturs,6,0,81,75
1657836274270,COGS 100,A01,083619,Allen; Michael Gordon,17,0,70,53
1657836280293,COGS 101A,A01,083621,Davis; Joshua Daniel,9,0,68,59
1657836286316,COGS 101B,A01,091572,Allen; Michael Gordon,12,0,65,53
1657836292366,COGS 101C,A01,083625,Delgado; Tania,17,0,35,18
1657836298399,COGS 107A,A01,083627,Boyle; Mary E. T.,14,0,60,46
1657836304425,COGS 118A,A01,083075,Gupta; Anjum,21,0,76,55
1657836310454,CSE 3,A50,083646,Miranda; Gregory Joseph,24,0,50,26
1657836316499,CSE 8A,A50,083650,Miranda; Gregory Joseph,17,1,56,39
1657836322521,CSE 11,A01,083080,Cao; Yingjun,6,15,40,34
1657836328545,CSE 12,A01,083652,Krause-Levy; Sophia Louisa,29,1,120,91
1657836334591,CSE 15L,A01,083654,Morris; Justin Loren,9,0,50,41
1657836334591,CSE 15L,A02,083655,Morris; Justin Loren,9,0,50,41
1657836340625,CSE 20,A01,083657,Tran; Khoa Dang,39,0,80,41
1657836346648,CSE 21,A01,095574,Bach; Quang Tran,22,0,48,26
1657836352671,CSE 30,A01,083084,Eldon; John,6,0,80,74
1657836352671,CSE 30,B01,095061,Bhaskar; Nishant,9,0,50,41
1657836358694,CSE 100,A01,083659,Cao; Yingjun,5,4,70,65
1657836364726,CSE 134B,A01,083661,Powell; Thomas Allan,24,0,100,76
1657836370749,CSE 140,A01,083663,Gungor; Onat,15,0,85,70
1657836376787,CSE 140L,A01,083088,Eldon; John,23,0,100,77
1657836382822,CSE 175,A01,083665,Kumar; Rakesh,3,0,25,22
1657836388845,CSE 190,A00,092507,Dubnov; Shlomo,8,0,20,12
1657836394891,ECE 45,A01,083139,Congero; Spencer William,6,0,75,69
1657836400918,ECE 65,A50,083695,Saad; Andrew S,12,0,30,18
1657836400918,ECE 65,A51,095125,Saad; Andrew S,24,0,26,2
1657836406967,ECE 109,A01,091882,Touri; Behrouz,20,0,70,50
1657836412989,ECE 180,A00,083140,Abi Samra; Nicholas Camill,1,0,30,29
1657836412989,ECE 180,B00,083141,Abi Samra; Nicholas Camill,0,0,30,30
1657836419023,MATH 10A,A01,083735,Patchell; Gregory David,2,0,30,28
1657836419023,MATH 10A,A02,083736,Patchell; Gregory David,20,0,30,10
1657836419023,MATH 10A,A03,083737,Patchell; Gregory David,16,0,30,14
1657836425051,MATH 10B,A01,083207,Lim; Seonhee,8,0,34,26
1657836425051,MATH 10B,A02,083208,Lim; Seonhee,10,0,35,25
1657836425051,MATH 10B,A03,093472,Lim; Seonhee,7,0,34,27
1657836425051,MATH 10B,B01,083739,Sinha; Shubham,14,0,30,16
1657836431081,MATH 18,A01,083743,Cinel; Cameron Alexander,9,0,30,21
1657836431081,MATH 18,A02,083744,Cinel; Cameron Alexander,18,0,30,12
1657836431081,MATH 18,A03,083745,Cinel; Cameron Alexander,10,0,30,20
1657836431081,MATH 18,B01,083748,Rideout; David Porter,5,0,37,32
1657836431081,MATH 18,B02,083749,Rideout; David Porter,5,0,36,31
1657836431081,MATH 18,B03,083750,Rideout; David Porter,3,0,37,34
1657836431081,MATH 18,B04,083751,Rideout; David Porter,6,0,36,30
1657836431081,MATH 18,B05,093473,Rideout; David Porter,6,0,36,30
1657836431081,MATH 18,B06,093474,Rideout; David Porter,6,0,36,30
1657836437104,MATH 20A,A01,083754,Zheng; Zequn,14,0,40,26
1657836443126,MATH 20B,A01,083756,Briones; Jor-el Thomas Caparas,4,0,36,32
1657836443126,MATH 20B,A02,083757,Briones; Jor-el Thomas Caparas,1,0,36,35
1657836443126,MATH 20B,A03,093475,Briones; Jor-el Thomas Caparas,2,0,36,34
1657836449155,MATH 20C,A01,083760,Briones; Jor-el Thomas Caparas,1,0,35,34
1657836449155,MATH 20C,A02,083761,Briones; Jor-el Thomas Caparas,8,0,35,27
1657836449155,MATH 20C,A03,093476,Briones; Jor-el Thomas Caparas,0,1,36,36
1657836449155,MATH 20C,B01,083762,Bach; Quang Tran,1,0,30,29
1657836455203,MATH 20D,A01,083765,Tran; Brian Kha,5,0,30,25
1657836455203,MATH 20D,A02,083766,Tran; Brian Kha,5,0,30,25
1657836455203,MATH 20D,A03,083767,Tran; Brian Kha,5,0,30,25
1657836461236,MATH 20E,A01,083771,Ganguly; Soumya,10,0,32,22
1657836461236,MATH 20E,A02,083772,Ganguly; Soumya,6,0,32,26
1657836461236,MATH 20E,B01,083773,Ciotti; Benjamin,20,0,35,15
1657836461236,MATH 20E,B02,083774,Ciotti; Benjamin,18,0,35,17
1657836467287,MATH 103A,A01,083777,Greenfeld; Be'Eri,3,0,36,33
1657836467287,MATH 103A,A02,083778,Greenfeld; Be'Eri,5,0,36,31
1657836467287,MATH 103A,A03,093561,Greenfeld; Be'Eri,6,0,36,30
1657836467287,MATH 103A,B01,083779,Greenfeld; Be'Eri,7,0,36,29
1657836467287,MATH 103A,B02,083780,Greenfeld; Be'Eri,4,0,36,32
1657836467287,MATH 103A,B03,093562,Greenfeld; Be'Eri,3,0,36,33
1657836473315,MATH 105,A01,085443,Carter; Anne Toulson,15,0,35,20
1657836473315,MATH 105,A02,093477,Carter; Anne Toulson,20,0,35,15
1657836479351,MATH 109,A01,083213,Ganzberger; Geoffrey Michael,3,0,34,31
1657836479351,MATH 109,A02,083214,Ganzberger; Geoffrey Michael,4,0,34,30
1657836479351,MATH 109,A03,093478,Ganzberger; Geoffrey Michael,2,0,34,32
1657836479351,MATH 109,B01,083215,Ganzberger; Geoffrey Michael,1,0,32,31
1657836479351,MATH 109,B02,083216,Ganzberger; Geoffrey Michael,2,0,32,30
1657836479351,MATH 109,B03,093479,Ganzberger; Geoffrey Michael,8,0,32,24
1657836485396,MATH 142A,A01,083219,Chow; Bennett,7,0,32,25
1657836485396,MATH 142A,A02,083220,Chow; Bennett,10,0,32,22
1657836485396,MATH 142A,A03,093480,Chow; Bennett,9,0,32,23
1657836485396,MATH 142A,B03,093481,Chow; Bennett,8,0,32,24
1657836485396,MATH 142A,B04,093558,Chow; Bennett,13,0,32,19
1657836485396,MATH 142A,B05,093559,Chow; Bennett,7,0,32,25
1657836491441,MATH 193A,A01,083224,Rotar; Vladimir,8,0,34,26
1657836491441,MATH 193A,A02,083225,Rotar; Vladimir,10,0,34,24
1657836491441,MATH 193A,A03,083781,Rotar; Vladimir,5,0,34,29
1657836491441,MATH 193A,A04,083782,Rotar; Vladimir,11,0,34,23
1657836491441,MATH 193A,A05,093482,Rotar; Vladimir,10,0,34,24
1657836497463,MATH 197,001,091859,McAuley; Julian John,9999,0,9999,0
1657836497463,MATH 197,002,095566,Kedlaya; Kiran S.,9997,0,9999,2
1657836497463,MATH 197,003,095567,Xiao; Ming,9999,0,9999,0
1657836497463,MATH 197,004,095571,Perols; Johan Lars,9998,0,9999,1
1657836504514,COGS 9,A01,083615,Shannon; Kyle Michael,9,0,75,66
1657836510554,COGS 11,A01,083617,Boyle; Mary E. T.,23,0,48,25
1657836516606,COGS 13,A01,083071,Bastos; Amalia Pinkusfeld,11,0,71,60
1657836522634,COGS 14A,A01,092681,Semenuks; Arturs,5,1,100,95
1657836528660,COGS 14B,A01,083073,Cheng; Tzu-Han,6,0,63,57
1657836534686,COGS 17,A01,092677,Semenuks; Arturs,6,0,81,75
1657836540720,COGS 100,A01,083619,Allen; Michael Gordon,17,0,70,53
1657836546746,COGS 101A,A01,083621,Davis; Joshua Daniel,9,0,68,59
1657836552795,COGS 101B,A01,091572,Allen; Michael Gordon,12,0,65,53
1657836558824,COGS 101C,A01,083625,Delgado; Tania,17,0,35,18
1657836564849,COGS 107A,A01,083627,Boyle; Mary E. T.,14,0,60,46
1657836570898,COGS 118A,A01,083075,Gupta; Anjum,21,0,76,55
1657836576923,CSE 3,A50,083646,Miranda; Gregory Joseph,24,0,50,26
1657836582945,CSE 8A,A50,083650,Miranda; Gregory Joseph,17,1,56,39
1657836588968,CSE 11,A01,083080,Cao; Yingjun,6,15,40,34
1657836594990,CSE 12,A01,083652,Krause-Levy; Sophia Louisa,29,1,120,91
1657836601016,CSE 15L,A01,083654,Morris; Justin Loren,9,0,50,41
1657836601016,CSE 15L,A02,083655,Morris; Justin Loren,9,0,50,41
1657836607038,CSE 20,A01,083657,Tran; Khoa Dang,39,0,80,41
1657836613066,CSE 21,A01,095574,Bach; Quang Tran,22,0,48,26
1657836619101,CSE 30,A01,083084,Eldon; John,6,0,80,74
1657836619101,CSE 30,B01,095061,Bhaskar; Nishant,9,0,50,41
1657836625128,CSE 100,A01,083659,Cao; Yingjun,5,4,70,65
1657836631161,CSE 134B,A01,083661,Powell; Thomas Allan,24,0,100,76
1657836637186,CSE 140,A01,083663,Gungor; Onat,15,0,85,70
1657836643216,CSE 140L,A01,083088,Eldon; John,23,0,100,77
1657836649239,CSE 175,A01,083665,Kumar; Rakesh,3,0,25,22
1657836655369,CSE 190,A00,092507,Dubnov; Shlomo,8,0,20,12
1657836661393,ECE 45,A01,083139,Congero; Spencer William,6,0,75,69
1657836667423,ECE 65,A50,083695,Saad; Andrew S,12,0,30,18
1657836667423,ECE 65,A51,095125,Saad; Andrew S,24,0,26,2
1657836673446,ECE 109,A01,091882,Touri; Behrouz,20,0,70,50
1657836679471,ECE 180,A00,083140,Abi Samra; Nicholas Camill,1,0,30,29
1657836679471,ECE 180,B00,083141,Abi Samra; Nicholas Camill,0,0,30,30
1657836685523,MATH 10A,A01,083735,Patchell; Gregory David,2,0,30,28
1657836685523,MATH 10A,A02,083736,Patchell; Gregory David,20,0,30,10
1657836685523,MATH 10A,A03,083737,Patchell; Gregory David,16,0,30,14
1657836691574,MATH 10B,A01,083207,Lim; Seonhee,8,0,34,26
1657836691574,MATH 10B,A02,083208,Lim; Seonhee,10,0,35,25
1657836691574,MATH 10B,A03,093472,Lim; Seonhee,7,0,34,27
1657836691574,MATH 10B,B01,083739,Sinha; Shubham,14,0,30,16
1657836697620,MATH 18,A01,083743,Cinel; Cameron Alexander,9,0,30,21
1657836697620,MATH 18,A02,083744,Cinel; Cameron Alexander,18,0,30,12
1657836697620,MATH 18,A03,083745,Cinel; Cameron Alexander,10,0,30,20
1657836697620,MATH 18,B01,083748,Rideout; David Porter,5,0,37,32
1657836697620,MATH 18,B02,083749,Rideout; David Porter,5,0,36,31
1657836697620,MATH 18,B03,083750,Rideout; David Porter,3,0,37,34
1657836697620,MATH 18,B04,083751,Rideout; David Porter,6,0,36,30
1657836697620,MATH 18,B05,093473,Rideout; David Porter,6,0,36,30
1657836697620,MATH 18,B06,093474,Rideout; David Porter,6,0,36,30
1657836703663,MATH 20A,A01,083754,Zheng; Zequn,14,0,40,26
1657836709717,MATH 20B,A01,083756,Briones; Jor-el Thomas Caparas,4,0,36,32
1657836709717,MATH 20B,A02,083757,Briones; Jor-el Thomas Caparas,1,0,36,35
1657836709717,MATH 20B,A03,093475,Briones; Jor-el Thomas Caparas,2,0,36,34
1657836715745,MATH 20C,A01,083760,Briones; Jor-el Thomas Caparas,1,0,35,34
1657836715745,MATH 20C,A02,083761,Briones; Jor-el Thomas Caparas,8,0,35,27
1657836715745,MATH 20C,A03,093476,Briones; Jor-el Thomas Caparas,0,1,36,36
1657836715745,MATH 20C,B01,083762,Bach; Quang Tran,1,0,30,29
1657836721789,MATH 20D,A01,083765,Tran; Brian Kha,5,0,30,25
1657836721789,MATH 20D,A02,083766,Tran; Brian Kha,5,0,30,25
1657836721789,MATH 20D,A03,083767,Tran; Brian Kha,5,0,30,25
1657836727834,MATH 20E,A01,083771,Ganguly; Soumya,10,0,32,22
1657836727834,MATH 20E,A02,083772,Ganguly; Soumya,6,0,32,26
1657836727834,MATH 20E,B01,083773,Ciotti; Benjamin,20,0,35,15
1657836727834,MATH 20E,B02,083774,Ciotti; Benjamin,18,0,35,17
1657836733877,MATH 103A,A01,083777,Greenfeld; Be'Eri,3,0,36,33
1657836733877,MATH 103A,A02,083778,Greenfeld; Be'Eri,5,0,36,31
1657836733877,MATH 103A,A03,093561,Greenfeld; Be'Eri,6,0,36,30
1657836733877,MATH 103A,B01,083779,Greenfeld; Be'Eri,7,0,36,29
1657836733877,MATH 103A,B02,083780,Greenfeld; Be'Eri,4,0,36,32
1657836733877,MATH 103A,B03,093562,Greenfeld; Be'Eri,3,0,36,33
1657836739912,MATH 105,A01,085443,Carter; Anne Toulson,15,0,35,20
1657836739912,MATH 105,A02,093477,Carter; Anne Toulson,20,0,35,15
1657836745934,MATH 109,A01,083213,Ganzberger; Geoffrey Michael,3,0,34,31
1657836745934,MATH 109,A02,083214,Ganzberger; Geoffrey Michael,4,0,34,30
1657836745934,MATH 109,A03,093478,Ganzberger; Geoffrey Michael,2,0,34,32
1657836745934,MATH 109,B01,083215,Ganzberger; Geoffrey Michael,1,0,32,31
1657836745934,MATH 109,B02,083216,Ganzberger; Geoffrey Michael,2,0,32,30
1657836745934,MATH 109,B03,093479,Ganzberger; Geoffrey Michael,8,0,32,24
1657836751973,MATH 142A,A01,083219,Chow; Bennett,7,0,32,25
1657836751973,MATH 142A,A02,083220,Chow; Bennett,10,0,32,22
1657836751973,MATH 142A,A03,093480,Chow; Bennett,9,0,32,23
1657836751973,MATH 142A,B03,093481,Chow; Bennett,8,0,32,24
1657836751973,MATH 142A,B04,093558,Chow; Bennett,13,0,32,19
1657836751973,MATH 142A,B05,093559,Chow; Bennett,7,0,32,25
1657836758016,MATH 193A,A01,083224,Rotar; Vladimir,8,0,34,26
1657836758016,MATH 193A,A02,083225,Rotar; Vladimir,10,0,34,24
1657836758016,MATH 193A,A03,083781,Rotar; Vladimir,5,0,34,29
1657836758016,MATH 193A,A04,083782,Rotar; Vladimir,11,0,34,23
1657836758016,MATH 193A,A05,093482,Rotar; Vladimir,10,0,34,24
1657836764064,MATH 197,001,091859,McAuley; Julian John,9999,0,9999,0
1657836764064,MATH 197,002,095566,Kedlaya; Kiran S.,9997,0,9999,2
1657836764064,MATH 197,003,095567,Xiao; Ming,9999,0,9999,0
1657836764064,MATH 197,004,095571,Perols; Johan Lars,9998,0,9999,1
1657836771148,COGS 9,A01,083615,Shannon; Kyle Michael,9,0,75,66
1657836777173,COGS 11,A01,083617,Boyle; Mary E. T.,23,0,48,25
1657836783214,COGS 13,A01,083071,Bastos; Amalia Pinkusfeld,11,0,71,60
1657836789240,COGS 14A,A01,092681,Semenuks; Arturs,5,1,100,95
1657836795269,COGS 14B,A01,083073,Cheng; Tzu-Han,6,0,63,57
1657836801311,COGS 17,A01,092677,Semenuks; Arturs,6,0,81,75
1657836807337,COGS 100,A01,083619,Allen; Michael Gordon,17,0,70,53
1657836813363,COGS 101A,A01,083621,Davis; Joshua Daniel,9,0,68,59
1657836819397,COGS 101B,A01,091572,Allen; Michael Gordon,12,0,65,53
1657836825428,COGS 101C,A01,083625,Delgado; Tania,17,0,35,18
1657836831468,COGS 107A,A01,083627,Boyle; Mary E. T.,14,0,60,46
1657836837490,COGS 118A,A01,083075,Gupta; Anjum,21,0,76,55
1657836843512,CSE 3,A50,083646,Miranda; Gregory Joseph,24,0,50,26
1657836849562,CSE 8A,A50,083650,Miranda; Gregory Joseph,17,1,56,39
1657836855598,CSE 11,A01,083080,Cao; Yingjun,6,15,40,34
1657836861644,CSE 12,A01,083652,Krause-Levy; Sophia Louisa,29,1,120,91
1657836867671,CSE 15L,A01,083654,Morris; Justin Loren,9,0,50,41
1657836867671,CSE 15L,A02,083655,Morris; Justin Loren,9,0,50,41
1657836873715,CSE 20,A01,083657,Tran; Khoa Dang,39,0,80,41
1657836879744,CSE 21,A01,095574,Bach; Quang Tran,22,0,48,26
1657836885774,CSE 30,A01,083084,Eldon; John,6,0,80,74
1657836885774,CSE 30,B01,095061,Bhaskar; Nishant,9,0,50,41
1657836891797,CSE 100,A01,083659,Cao; Yingjun,5,4,70,65
1657836897825,CSE 134B,A01,083661,Powell; Thomas Allan,24,0,100,76
1657836903848,CSE 140,A01,083663,Gungor; Onat,15,0,85,70
1657836909900,CSE 140L,A01,083088,Eldon; John,23,0,100,77
1657836915922,CSE 175,A01,083665,Kumar; Rakesh,3,0,25,22
1657836921944,CSE 190,A00,092507,Dubnov; Shlomo,8,0,20,12
1657836927973,ECE 45,A01,083139,Congero; Spencer William,6,0,75,69
1657836934000,ECE 65,A50,083695,Saad; Andrew S,12,0,30,18
1657836934000,ECE 65,A51,095125,Saad; Andrew S,24,0,26,2
1657836940033,ECE 109,A01,091882,Touri; Behrouz,20,0,70,50
1657836946073,ECE 180,A00,083140,Abi Samra; Nicholas Camill,1,0,30,29
1657836946073,ECE 180,B00,083141,Abi Samra; Nicholas Camill,0,0,30,30
1657836952119,MATH 10A,A01,083735,Patchell; Gregory David,2,0,30,28
1657836952119,MATH 10A,A02,083736,Patchell; Gregory David,20,0,30,10
1657836952119,MATH 10A,A03,083737,Patchell; Gregory David,16,0,30,14
1657836958161,MATH 10B,A01,083207,Lim; Seonhee,8,0,34,26
1657836958161,MATH 10B,A02,083208,Lim; Seonhee,10,0,35,25
1657836958161,MATH 10B,A03,093472,Lim; Seonhee,7,0,34,27
1657836958161,MATH 10B,B01,083739,Sinha; Shubham,14,0,30,16
1657836964196,MATH 18,A01,083743,Cinel; Cameron Alexander,9,0,30,21
1657836964196,MATH 18,A02,083744,Cinel; Cameron Alexander,18,0,30,12
1657836964196,MATH 18,A03,083745,Cinel; Cameron Alexander,10,0,30,20
1657836964196,MATH 18,B01,083748,Rideout; David Porter,5,0,37,32
1657836964196,MATH 18,B02,083749,Rideout; David Porter,5,0,36,31
1657836964196,MATH 18,B03,083750,Rideout; David Porter,3,0,37,34
1657836964196,MATH 18,B04,083751,Rideout; David Porter,6,0,36,30
1657836964196,MATH 18,B05,093473,Rideout; David Porter,6,0,36,30
1657836964196,MATH 18,B06,093474,Rideout; David Porter,6,0,36,30
1657836970224,MATH 20A,A01,083754,Zheng; Zequn,14,0,40,26
1657836976278,MATH 20B,A01,083756,Briones; Jor-el Thomas Caparas,4,0,36,32
1657836976278,MATH 20B,A02,083757,Briones; Jor-el Thomas Caparas,1,0,36,35
1657836976278,MATH 20B,A03,093475,Briones; Jor-el Thomas Caparas,2,0,36,34
1657836982301,MATH 20C,A01,083760,Briones; Jor-el Thomas Caparas,1,0,35,34
1657836982301,MATH 20C,A02,083761,Briones; Jor-el Thomas Caparas,8,0,35,27
1657836982301,MATH 20C,A03,093476,Briones; Jor-el Thomas Caparas,0,1,36,36
1657836982301,MATH 20C,B01,083762,Bach; Quang Tran,1,0,30,29
1657836988324,MATH 20D,A01,083765,Tran; Brian Kha,5,0,30,25
1657836988324,MATH 20D,A02,083766,Tran; Brian Kha,5,0,30,25
1657836988324,MATH 20D,A03,083767,Tran; Brian Kha,5,0,30,25
1657836994352,MATH 20E,A01,083771,Ganguly; Soumya,10,0,32,22
1657836994352,MATH 20E,A02,083772,Ganguly; Soumya,6,0,32,26
1657836994352,MATH 20E,B01,083773,Ciotti; Benjamin,20,0,35,15
1657836994352,MATH 20E,B02,083774,Ciotti; Benjamin,18,0,35,17
1657837000390,MATH 103A,A01,083777,Greenfeld; Be'Eri,3,0,36,33
1657837000390,MATH 103A,A02,083778,Greenfeld; Be'Eri,5,0,36,31
1657837000390,MATH 103A,A03,093561,Greenfeld; Be'Eri,6,0,36,30
1657837000390,MATH 103A,B01,083779,Greenfeld; Be'Eri,7,0,36,29
1657837000390,MATH 103A,B02,083780,Greenfeld; Be'Eri,4,0,36,32
1657837000390,MATH 103A,B03,093562,Greenfeld; Be'Eri,3,0,36,33
1657837006414,MATH 105,A01,085443,Carter; Anne Toulson,15,0,35,20
1657837006414,MATH 105,A02,093477,Carter; Anne Toulson,20,0,35,15
1657837012443,MATH 109,A01,083213,Ganzberger; Geoffrey Michael,3,0,34,31
1657837012443,MATH 109,A02,083214,Ganzberger; Geoffrey Michael,4,0,34,30
1657837012443,MATH 109,A03,093478,Ganzberger; Geoffrey Michael,2,0,34,32
1657837012443,MATH 109,B01,083215,Ganzberger; Geoffrey Michael,1,0,32,31
1657837012443,MATH 109,B02,083216,Ganzberger; Geoffrey Michael,2,0,32,30
1657837012443,MATH 109,B03,093479,Ganzberger; Geoffrey Michael,8,0,32,24
1657837018482,MATH 142A,A01,083219,Chow; Bennett,7,0,32,25
1657837018482,MATH 142A,A02,083220,Chow; Bennett,10,0,32,22
1657837018482,MATH 142A,A03,093480,Chow; Bennett,9,0,32,23
1657837018482,MATH 142A,B03,093481,Chow; Bennett,8,0,32,24
1657837018482,MATH 142A,B04,093558,Chow; Bennett,13,0,32,19
1657837018482,MATH 142A,B05,093559,Chow; Bennett,7,0,32,25
1657837024505,MATH 193A,A01,083224,Rotar; Vladimir,8,0,34,26
1657837024505,MATH 193A,A02,083225,Rotar; Vladimir,10,0,34,24
1657837024505,MATH 193A,A03,083781,Rotar; Vladimir,5,0,34,29
1657837024505,MATH 193A,A04,083782,Rotar; Vladimir,11,0,34,23
1657837024505,MATH 193A,A05,093482,Rotar; Vladimir,10,0,34,24
1657837030538,MATH 197,001,091859,McAuley; Julian John,9999,0,9999,0
1657837030538,MATH 197,002,095566,Kedlaya; Kiran S.,9997,0,9999,2
1657837030538,MATH 197,003,095567,Xiao; Ming,9999,0,9999,0
1657837030538,MATH 197,004,095571,Perols; Johan Lars,9998,0,9999,1
1657837037601,COGS 9,A01,083615,Shannon; Kyle Michael,9,0,75,66
1657837043624,COGS 11,A01,083617,Boyle; Mary E. T.,23,0,48,25
1657837049674,COGS 13,A01,083071,Bastos; Amalia Pinkusfeld,11,0,71,60
1657837055711,COGS 14A,A01,092681,Semenuks; Arturs,5,1,100,95
1657837061742,COGS 14B,A01,083073,Cheng; Tzu-Han,6,0,63,57
1657837067769,COGS 17,A01,092677,Semenuks; Arturs,6,0,81,75
1657837073810,COGS 100,A01,083619,Allen; Michael Gordon,17,0,70,53
1657837079834,COGS 101A,A01,083621,Davis; Joshua Daniel,9,0,68,59
1657837085856,COGS 101B,A01,091572,Allen; Michael Gordon,12,0,65,53
1657837091893,COGS 101C,A01,083625,Delgado; Tania,17,0,35,18
1657837097919,COGS 107A,A01,083627,Boyle; Mary E. T.,14,0,60,46
1657837103968,COGS 118A,A01,083075,Gupta; Anjum,21,0,76,55
1657837109989,CSE 3,A50,083646,Miranda; Gregory Joseph,24,0,50,26
1657837116020,CSE 8A,A50,083650,Miranda; Gregory Joseph,17,1,56,39
1657837122046,CSE 11,A01,083080,Cao; Yingjun,6,15,40,34
1657837128074,CSE 12,A01,083652,Krause-Levy; Sophia Louisa,29,1,120,91
1657837134125,CSE 15L,A01,083654,Morris; Justin Loren,9,0,50,41
1657837134125,CSE 15L,A02,083655,Morris; Justin Loren,9,0,50,41
1657837140148,CSE 20,A01,083657,Tran; Khoa Dang,39,0,80,41
1657837146175,CSE 21,A01,095574,Bach; Quang Tran,22,0,48,26
1657837152229,CSE 30,A01,083084,Eldon; John,6,0,80,74
1657837152229,CSE 30,B01,095061,Bhaskar; Nishant,9,0,50,41
1657837158254,CSE 100,A01,083659,Cao; Yingjun,5,4,70,65
1657837164277,CSE 134B,A01,083661,Powell; Thomas Allan,24,0,100,76
1657837170301,CSE 140,A01,083663,Gungor; Onat,15,0,85,70
1657837176329,CSE 140L,A01,083088,Eldon; John,23,0,100,77
1657837182354,CSE 175,A01,083665,Kumar; Rakesh,3,0,25,22
1657837188379,CSE 190,A00,092507,Dubnov; Shlomo,8,0,20,12
1657837194409,ECE 45,A01,083139,Congero; Spencer William,6,0,75,69
1657837200436,ECE 65,A50,083695,Saad; Andrew S,12,0,30,18
1657837200436,ECE 65,A51,095125,Saad; Andrew S,24,0,26,2
1657837206488,ECE 109,A01,091882,Touri; Behrouz,20,0,70,50
1657837212511,ECE 180,A00,083140,Abi Samra; Nicholas Camill,1,0,30,29
1657837212511,ECE 180,B00,083141,Abi Samra; Nicholas Camill,0,0,30,30
1657837218544,MATH 10A,A01,083735,Patchell; Gregory David,2,0,30,28
1657837218544,MATH 10A,A02,083736,Patchell; Gregory David,20,0,30,10
1657837218544,MATH 10A,A03,083737,Patchell; Gregory David,16,0,30,14
1657837224581,MATH 10B,A01,083207,Lim; Seonhee,8,0,34,26
1657837224581,MATH 10B,A02,083208,Lim; Seonhee,10,0,35,25
1657837224581,MATH 10B,A03,093472,Lim; Seonhee,7,0,34,27
1657837224581,MATH 10B,B01,083739,Sinha; Shubham,14,0,30,16
1657837230606,MATH 18,A01,083743,Cinel; Cameron Alexander,9,0,30,21
1657837230606,MATH 18,A02,083744,Cinel; Cameron Alexander,18,0,30,12
1657837230606,MATH 18,A03,083745,Cinel; Cameron Alexander,10,0,30,20
1657837230606,MATH 18,B01,083748,Rideout; David Porter,5,0,37,32
1657837230606,MATH 18,B02,083749,Rideout; David Porter,5,0,36,31
1657837230606,MATH 18,B03,083750,Rideout; David Porter,3,0,37,34
1657837230606,MATH 18,B04,083751,Rideout; David Porter,6,0,36,30
1657837230606,MATH 18,B05,093473,Rideout; David Porter,6,0,36,30
1657837230606,MATH 18,B06,093474,Rideout; David Porter,6,0,36,30
1657837236629,MATH 20A,A01,083754,Zheng; Zequn,14,0,40,26
1657837242654,MATH 20B,A01,083756,Briones; Jor-el Thomas Caparas,4,0,36,32
1657837242654,MATH 20B,A02,083757,Briones; Jor-el Thomas Caparas,1,0,36,35
1657837242654,MATH 20B,A03,093475,Briones; Jor-el Thomas Caparas,2,0,36,34
1657837248704,MATH 20C,A01,083760,Briones; Jor-el Thomas Caparas,1,0,35,34
1657837248704,MATH 20C,A02,083761,Briones; Jor-el Thomas Caparas,8,0,35,27
1657837248704,MATH 20C,A03,093476,Briones; Jor-el Thomas Caparas,0,1,36,36
1657837248704,MATH 20C,B01,083762,Bach; Quang Tran,1,0,30,29
1657837254826,MATH 20D,A01,083765,Tran; Brian Kha,5,0,30,25
1657837254826,MATH 20D,A02,083766,Tran; Brian Kha,5,0,30,25
1657837254826,MATH 20D,A03,083767,Tran; Brian Kha,5,0,30,25
1657837260859,MATH 20E,A01,083771,Ganguly; Soumya,10,0,32,22
1657837260859,MATH 20E,A02,083772,Ganguly; Soumya,6,0,32,26
1657837260859,MATH 20E,B01,083773,Ciotti; Benjamin,20,0,35,15
1657837260859,MATH 20E,B02,083774,Ciotti; Benjamin,18,0,35,17
1657837266883,MATH 103A,A01,083777,Greenfeld; Be'Eri,3,0,36,33
1657837266883,MATH 103A,A02,083778,Greenfeld; Be'Eri,5,0,36,31
1657837266883,MATH 103A,A03,093561,Greenfeld; Be'Eri,6,0,36,30
1657837266883,MATH 103A,B01,083779,Greenfeld; Be'Eri,7,0,36,29
1657837266883,MATH 103A,B02,083780,Greenfeld; Be'Eri,4,0,36,32
1657837266883,MATH 103A,B03,093562,Greenfeld; Be'Eri,3,0,36,33
1657837272917,MATH 105,A01,085443,Carter; Anne Toulson,15,0,35,20
1657837272917,MATH 105,A02,093477,Carter; Anne Toulson,20,0,35,15
1657837278942,MATH 109,A01,083213,Ganzberger; Geoffrey Michael,3,0,34,31
1657837278942,MATH 109,A02,083214,Ganzberger; Geoffrey Michael,4,0,34,30
1657837278942,MATH 109,A03,093478,Ganzberger; Geoffrey Michael,2,0,34,32
1657837278942,MATH 109,B01,083215,Ganzberger; Geoffrey Michael,1,0,32,31
1657837278942,MATH 109,B02,083216,Ganzberger; Geoffrey Michael,2,0,32,30
1657837278942,MATH 109,B03,093479,Ganzberger; Geoffrey Michael,8,0,32,24
1657837284972,MATH 142A,A01,083219,Chow; Bennett,7,0,32,25
1657837284972,MATH 142A,A02,083220,Chow; Bennett,10,0,32,22
1657837284972,MATH 142A,A03,093480,Chow; Bennett,9,0,32,23
1657837284972,MATH 142A,B03,093481,Chow; Bennett,8,0,32,24
1657837284972,MATH 142A,B04,093558,Chow; Bennett,13,0,32,19
1657837284972,MATH 142A,B05,093559,Chow; Bennett,7,0,32,25
1657837291018,MATH 193A,A01,083224,Rotar; Vladimir,8,0,34,26
1657837291018,MATH 193A,A02,083225,Rotar; Vladimir,10,0,34,24
1657837291018,MATH 193A,A03,083781,Rotar; Vladimir,5,0,34,29
1657837291018,MATH 193A,A04,083782,Rotar; Vladimir,11,0,34,23
1657837291018,MATH 193A,A05,093482,Rotar; Vladimir,10,0,34,24
1657837297041,MATH 197,001,091859,McAuley; Julian John,9999,0,9999,0
1657837297041,MATH 197,002,095566,Kedlaya; Kiran S.,9997,0,9999,2
1657837297041,MATH 197,003,095567,Xiao; Ming,9999,0,9999,0
1657837297041,MATH 197,004,095571,Perols; Johan Lars,9998,0,9999,1
1657837304142,COGS 9,A01,083615,Shannon; Kyle Michael,9,0,75,66
1657837310192,COGS 11,A01,083617,Boyle; Mary E. T.,23,0,48,25
1657837316218,COGS 13,A01,083071,Bastos; Amalia Pinkusfeld,11,0,71,60
1657837322259,COGS 14A,A01,092681,Semenuks; Arturs,5,1,100,95
1657837328287,COGS 14B,A01,083073,Cheng; Tzu-Han,6,0,63,57
1657837334311,COGS 17,A01,092677,Semenuks; Arturs,6,0,81,75
1657837340332,COGS 100,A01,083619,Allen; Michael Gordon,17,0,70,53
1657837346361,COGS 101A,A01,083621,Davis; Joshua Daniel,9,0,68,59
1657837352421,COGS 101B,A01,091572,Allen; Michael Gordon,12,0,65,53
1657837358444,COGS 101C,A01,083625,Delgado; Tania,17,0,35,18
1657837364468,COGS 107A,A01,083627,Boyle; Mary E. T.,14,0,60,46
1657837370505,COGS 118A,A01,083075,Gupta; Anjum,21,0,76,55
1657837376529,CSE 3,A50,083646,Miranda; Gregory Joseph,24,0,50,26
1657837382577,CSE 8A,A50,083650,Miranda; Gregory Joseph,17,1,56,39
1657837388603,CSE 11,A01,083080,Cao; Yingjun,6,15,40,34
1657837394624,CSE 12,A01,083652,Krause-Levy; Sophia Louisa,29,1,120,91
1657837400662,CSE 15L,A01,083654,Morris; Justin Loren,9,0,50,41
1657837400662,CSE 15L,A02,083655,Morris; Justin Loren,9,0,50,41
1657837406688,CSE 20,A01,083657,Tran; Khoa Dang,39,0,80,41
1657837412721,CSE 21,A01,095574,Bach; Quang Tran,22,0,48,26
1657837418744,CSE 30,A01,083084,Eldon; John,6,0,80,74
1657837418744,CSE 30,B01,095061,Bhaskar; Nishant,9,0,50,41
1657837424788,CSE 100,A01,083659,Cao; Yingjun,5,4,70,65
1657837430838,CSE 134B,A01,083661,Powell; Thomas Allan,24,0,100,76
1657837436861,CSE 140,A01,083663,Gungor; Onat,15,0,85,70
1657837442883,CSE 140L,A01,083088,Eldon; John,23,0,100,77
1657837448934,CSE 175,A01,083665,Kumar; Rakesh,3,0,25,22
1657837454960,CSE 190,A00,092507,Dubnov; Shlomo,8,0,20,12
1657837461010,ECE 45,A01,083139,Congero; Spencer William,6,0,75,69
1657837467035,ECE 65,A50,083695,Saad; Andrew S,12,0,30,18
1657837467035,ECE 65,A51,095125,Saad; Andrew S,24,0,26,2
1657837473061,ECE 109,A01,091882,Touri; Behrouz,20,0,70,50
1657837479112,ECE 180,A00,083140,Abi Samra; Nicholas Camill,1,0,30,29
1657837479112,ECE 180,B00,083141,Abi Samra; Nicholas Camill,0,0,30,30
1657837485146,MATH 10A,A01,083735,Patchell; Gregory David,2,0,30,28
1657837485146,MATH 10A,A02,083736,Patchell; Gregory David,20,0,30,10
1657837485146,MATH 10A,A03,083737,Patchell; Gregory David,16,0,30,14
1657837491193,MATH 10B,A01,083207,Lim; Seonhee,8,0,34,26
1657837491193,MATH 10B,A02,083208,Lim; Seonhee,10,0,35,25
1657837491193,MATH 10B,A03,093472,Lim; Seonhee,7,0,34,27
1657837491193,MATH 10B,B01,083739,Sinha; Shubham,14,0,30,16
1657837497228,MATH 18,A01,083743,Cinel; Cameron Alexander,9,0,30,21
1657837497228,MATH 18,A02,083744,Cinel; Cameron Alexander,18,0,30,12
1657837497228,MATH 18,A03,083745,Cinel; Cameron Alexander,10,0,30,20
1657837497228,MATH 18,B01,083748,Rideout; David Porter,5,0,37,32
1657837497228,MATH 18,B02,083749,Rideout; David Porter,5,0,36,31
1657837497228,MATH 18,B03,083750,Rideout; David Porter,3,0,37,34
1657837497228,MATH 18,B04,083751,Rideout; David Porter,6,0,36,30
1657837497228,MATH 18,B05,093473,Rideout; David Porter,6,0,36,30
1657837497228,MATH 18,B06,093474,Rideout; David Porter,6,0,36,30
1657837503267,MATH 20A,A01,083754,Zheng; Zequn,14,0,40,26
1657837509294,MATH 20B,A01,083756,Briones; Jor-el Thomas Caparas,4,0,36,32
1657837509294,MATH 20B,A02,083757,Briones; Jor-el Thomas Caparas,1,0,36,35
1657837509294,MATH 20B,A03,093475,Briones; Jor-el Thomas Caparas,2,0,36,34
1657837515322,MATH 20C,A01,083760,Briones; Jor-el Thomas Caparas,1,0,35,34
1657837515322,MATH 20C,A02,083761,Briones; Jor-el Thomas Caparas,8,0,35,27
1657837515322,MATH 20C,A03,093476,Briones; Jor-el Thomas Caparas,0,1,36,36
1657837515322,MATH 20C,B01,083762,Bach; Quang Tran,1,0,30,29
1657837521346,MATH 20D,A01,083765,Tran; Brian Kha,5,0,30,25
1657837521346,MATH 20D,A02,083766,Tran; Brian Kha,5,0,30,25
1657837521346,MATH 20D,A03,083767,Tran; Brian Kha,5,0,30,25
1657837527397,MATH 20E,A01,083771,Ganguly; Soumya,10,0,32,22
1657837527397,MATH 20E,A02,083772,Ganguly; Soumya,6,0,32,26
1657837527397,MATH 20E,B01,083773,Ciotti; Benjamin,20,0,35,15
1657837527397,MATH 20E,B02,083774,Ciotti; Benjamin,18,0,35,17
1657837533422,MATH 103A,A01,083777,Greenfeld; Be'Eri,3,0,36,33
1657837533422,MATH 103A,A02,083778,Greenfeld; Be'Eri,5,0,36,31
1657837533422,MATH 103A,A03,093561,Greenfeld; Be'Eri,6,0,36,30
1657837533422,MATH 103A,B01,083779,Greenfeld; Be'Eri,7,0,36,29
1657837533422,MATH 103A,B02,083780,Greenfeld; Be'Eri,4,0,36,32
1657837533422,MATH 103A,B03,093562,Greenfeld; Be'Eri,3,0,36,33
1657837539458,MATH 105,A01,085443,Carter; Anne Toulson,15,0,35,20
1657837539458,MATH 105,A02,093477,Carter; Anne Toulson,20,0,35,15
1657837545483,MATH 109,A01,083213,Ganzberger; Geoffrey Michael,3,0,34,31
1657837545483,MATH 109,A02,083214,Ganzberger; Geoffrey Michael,4,0,34,30
1657837545483,MATH 109,A03,093478,Ganzberger; Geoffrey Michael,2,0,34,32
1657837545483,MATH 109,B01,083215,Ganzberger; Geoffrey Michael,1,0,32,31
1657837545483,MATH 109,B02,083216,Ganzberger; Geoffrey Michael,2,0,32,30
1657837545483,MATH 109,B03,093479,Ganzberger; Geoffrey Michael,8,0,32,24
1657837551515,MATH 142A,A01,083219,Chow; Bennett,7,0,32,25
1657837551515,MATH 142A,A02,083220,Chow; Bennett,10,0,32,22
1657837551515,MATH 142A,A03,093480,Chow; Bennett,9,0,32,23
1657837551515,MATH 142A,B03,093481,Chow; Bennett,8,0,32,24
1657837551515,MATH 142A,B04,093558,Chow; Bennett,13,0,32,19
1657837551515,MATH 142A,B05,093559,Chow; Bennett,7,0,32,25
1657837557547,MATH 193A,A01,083224,Rotar; Vladimir,8,0,34,26
1657837557547,MATH 193A,A02,083225,Rotar; Vladimir,10,0,34,24
1657837557547,MATH 193A,A03,083781,Rotar; Vladimir,5,0,34,29
1657837557547,MATH 193A,A04,083782,Rotar; Vladimir,11,0,34,23
1657837557547,MATH 193A,A05,093482,Rotar; Vladimir,10,0,34,24
1657837563573,MATH 197,001,091859,McAuley; Julian John,9999,0,9999,0
1657837563573,MATH 197,002,095566,Kedlaya; Kiran S.,9997,0,9999,2
1657837563573,MATH 197,003,095567,Xiao; Ming,9999,0,9999,0
1657837563573,MATH 197,004,095571,Perols; Johan Lars,9998,0,9999,1
1657837570661,COGS 9,A01,083615,Shannon; Kyle Michael,9,0,75,66
1657837576682,COGS 11,A01,083617,Boyle; Mary E. T.,23,0,48,25
1657837582716,COGS 13,A01,083071,Bastos; Amalia Pinkusfeld,11,0,71,60
1657837588751,COGS 14A,A01,092681,Semenuks; Arturs,5,1,100,95
1657837594778,COGS 14B,A01,083073,Cheng; Tzu-Han,6,0,63,57
1657837600805,COGS 17,A01,092677,Semenuks; Arturs,6,0,81,75
1657837606828,COGS 100,A01,083619,Allen; Michael Gordon,17,0,70,53
1657837612883,COGS 101A,A01,083621,Davis; Joshua Daniel,9,0,68,59
1657837618933,COGS 101B,A01,091572,Allen; Michael Gordon,12,0,65,53
1657837624957,COGS 101C,A01,083625,Delgado; Tania,17,0,35,18
1657837630986,COGS 107A,A01,083627,Boyle; Mary E. T.,14,0,60,46
1657837637008,COGS 118A,A01,083075,Gupta; Anjum,21,0,76,55
1657837643040,CSE 3,A50,083646,Miranda; Gregory Joseph,24,0,50,26
1657837649072,CSE 8A,A50,083650,Miranda; Gregory Joseph,17,1,56,39
1657837655112,CSE 11,A01,083080,Cao; Yingjun,6,15,40,34
1657837661156,CSE 12,A01,083652,Krause-Levy; Sophia Louisa,29,1,120,91
1657837667184,CSE 15L,A01,083654,Morris; Justin Loren,9,0,50,41
1657837667184,CSE 15L,A02,083655,Morris; Justin Loren,9,0,50,41
1657837673215,CSE 20,A01,083657,Tran; Khoa Dang,39,0,80,41
1657837679262,CSE 21,A01,095574,Bach; Quang Tran,22,0,48,26
1657837685284,CSE 30,A01,083084,Eldon; John,6,0,80,74
1657837685284,CSE 30,B01,095061,Bhaskar; Nishant,9,0,50,41
1657837691309,CSE 100,A01,083659,Cao; Yingjun,5,4,70,65
1657837697354,CSE 134B,A01,083661,Powell; Thomas Allan,24,0,100,76
1657837703377,CSE 140,A01,083663,Gungor; Onat,15,0,85,70
1657837709412,CSE 140L,A01,083088,Eldon; John,23,0,100,77
1657837715436,CSE 175,A01,083665,Kumar; Rakesh,3,0,25,22
1657837721473,CSE 190,A00,092507,Dubnov; Shlomo,8,0,20,12
1657837727509,ECE 45,A01,083139,Congero; Spencer William,6,0,75,69
1657837733564,ECE 65,A50,083695,Saad; Andrew S,12,0,30,18
1657837733564,ECE 65,A51,095125,Saad; Andrew S,24,0,26,2
1657837739593,ECE 109,A01,091882,Touri; Behrouz,20,0,70,50
1657837745630,ECE 180,A00,083140,Abi Samra; Nicholas Camill,1,0,30,29
1657837745630,ECE 180,B00,083141,Abi Samra; Nicholas Camill,0,0,30,30
1657837751653,MATH 10A,A01,083735,Patchell; Gregory David,2,0,30,28
1657837751653,MATH 10A,A02,083736,Patchell; Gregory David,20,0,30,10
1657837751653,MATH 10A,A03,083737,Patchell; Gregory David,16,0,30,14
1657837757700,MATH 10B,A01,083207,Lim; Seonhee,8,0,34,26
1657837757700,MATH 10B,A02,083208,Lim; Seonhee,10,0,35,25
1657837757700,MATH 10B,A03,093472,Lim; Seonhee,7,0,34,27
1657837757700,MATH 10B,B01,083739,Sinha; Shubham,14,0,30,16
1657837763735,MATH 18,A01,083743,Cinel; Cameron Alexander,9,0,30,21
1657837763735,MATH 18,A02,083744,Cinel; Cameron Alexander,18,0,30,12
1657837763735,MATH 18,A03,083745,Cinel; Cameron Alexander,10,0,30,20
1657837763735,MATH 18,B01,083748,Rideout; David Porter,5,0,37,32
1657837763735,MATH 18,B02,083749,Rideout; David Porter,5,0,36,31
1657837763735,MATH 18,B03,083750,Rideout; David Porter,3,0,37,34
1657837763735,MATH 18,B04,083751,Rideout; David Porter,6,0,36,30
1657837763735,MATH 18,B05,093473,Rideout; David Porter,6,0,36,30
1657837763735,MATH 18,B06,093474,Rideout; David Porter,6,0,36,30
1657837769791,MATH 20A,A01,083754,Zheng; Zequn,14,0,40,26
1657837775818,MATH 20B,A01,083756,Briones; Jor-el Thomas Caparas,4,0,36,32
1657837775818,MATH 20B,A02,083757,Briones; Jor-el Thomas Caparas,1,0,36,35
1657837775818,MATH 20B,A03,093475,Briones; Jor-el Thomas Caparas,2,0,36,34
1657837781842,MATH 20C,A01,083760,Briones; Jor-el Thomas Caparas,1,0,35,34
1657837781842,MATH 20C,A02,083761,Briones; Jor-el Thomas Caparas,8,0,35,27
1657837781842,MATH 20C,A03,093476,Briones; Jor-el Thomas Caparas,0,1,36,36
1657837781842,MATH 20C,B01,083762,Bach; Quang Tran,1,0,30,29
1657837787896,MATH 20D,A01,083765,Tran; Brian Kha,5,0,30,25
1657837787896,MATH 20D,A02,083766,Tran; Brian Kha,5,0,30,25
1657837787896,MATH 20D,A03,083767,Tran; Brian Kha,5,0,30,25
1657837793930,MATH 20E,A01,083771,Ganguly; Soumya,10,0,32,22
1657837793930,MATH 20E,A02,083772,Ganguly; Soumya,6,0,32,26
1657837793930,MATH 20E,B01,083773,Ciotti; Benjamin,20,0,35,15
1657837793930,MATH 20E,B02,083774,Ciotti; Benjamin,18,0,35,17
1657837799954,MATH 103A,A01,083777,Greenfeld; Be'Eri,3,0,36,33
1657837799954,MATH 103A,A02,083778,Greenfeld; Be'Eri,5,0,36,31
1657837799954,MATH 103A,A03,093561,Greenfeld; Be'Eri,6,0,36,30
1657837799954,MATH 103A,B01,083779,Greenfeld; Be'Eri,7,0,36,29
1657837799954,MATH 103A,B02,083780,Greenfeld; Be'Eri,4,0,36,32
1657837799954,MATH 103A,B03,093562,Greenfeld; Be'Eri,3,0,36,33
1657837805988,MATH 105,A01,085443,Carter; Anne Toulson,15,0,35,20
1657837805988,MATH 105,A02,093477,Carter; Anne Toulson,20,0,35,15
1657837812032,MATH 109,A01,083213,Ganzberger; Geoffrey Michael,3,0,34,31
1657837812032,MATH 109,A02,083214,Ganzberger; Geoffrey Michael,4,0,34,30
1657837812032,MATH 109,A03,093478,Ganzberger; Geoffrey Michael,2,0,34,32
1657837812032,MATH 109,B01,083215,Ganzberger; Geoffrey Michael,1,0,32,31
1657837812032,MATH 109,B02,083216,Ganzberger; Geoffrey Michael,2,0,32,30
1657837812032,MATH 109,B03,093479,Ganzberger; Geoffrey Michael,8,0,32,24
1657837818059,MATH 142A,A01,083219,Chow; Bennett,7,0,32,25
1657837818059,MATH 142A,A02,083220,Chow; Bennett,10,0,32,22
1657837818059,MATH 142A,A03,093480,Chow; Bennett,9,0,32,23
1657837818059,MATH 142A,B03,093481,Chow; Bennett,8,0,32,24
1657837818059,MATH 142A,B04,093558,Chow; Bennett,13,0,32,19
1657837818059,MATH 142A,B05,093559,Chow; Bennett,7,0,32,25
1657837824097,MATH 193A,A01,083224,Rotar; Vladimir,8,0,34,26
1657837824097,MATH 193A,A02,083225,Rotar; Vladimir,10,0,34,24
1657837824097,MATH 193A,A03,083781,Rotar; Vladimir,5,0,34,29
1657837824097,MATH 193A,A04,083782,Rotar; Vladimir,11,0,34,23
1657837824097,MATH 193A,A05,093482,Rotar; Vladimir,10,0,34,24
1657837830131,MATH 197,001,091859,McAuley; Julian John,9999,0,9999,0
1657837830131,MATH 197,002,095566,Kedlaya; Kiran S.,9997,0,9999,2
1657837830131,MATH 197,003,095567,Xiao; Ming,9999,0,9999,0
1657837830131,MATH 197,004,095571,Perols; Johan Lars,9998,0,9999,1
1657837837220,COGS 9,A01,083615,Shannon; Kyle Michael,9,0,75,66
1657837843279,COGS 11,A01,083617,Boyle; Mary E. T.,23,0,48,25
1657837849400,COGS 13,A01,083071,Bastos; Amalia Pinkusfeld,11,0,71,60
1657837855449,COGS 14A,A01,092681,Semenuks; Arturs,5,1,100,95
1657837861475,COGS 14B,A01,083073,Cheng; Tzu-Han,6,0,63,57
1657837867498,COGS 17,A01,092677,Semenuks; Arturs,6,0,81,75
1657837873544,COGS 100,A01,083619,Allen; Michael Gordon,17,0,70,53
1657837879570,COGS 101A,A01,083621,Davis; Joshua Daniel,9,0,68,59
1657837885618,COGS 101B,A01,091572,Allen; Michael Gordon,12,0,65,53
1657837891654,COGS 101C,A01,083625,Delgado; Tania,17,0,35,18
1657837897700,COGS 107A,A01,083627,Boyle; Mary E. T.,14,0,60,46
1657837903731,COGS 118A,A01,083075,Gupta; Anjum,21,0,76,55
1657837909778,CSE 3,A50,083646,Miranda; Gregory Joseph,24,0,50,26
1657837915804,CSE 8A,A50,083650,Miranda; Gregory Joseph,17,1,56,39
1657837921843,CSE 11,A01,083080,Cao; Yingjun,6,15,40,34
1657837927877,CSE 12,A01,083652,Krause-Levy; Sophia Louisa,29,1,120,91
1657837933913,CSE 15L,A01,083654,Morris; Justin Loren,9,0,50,41
1657837933913,CSE 15L,A02,083655,Morris; Justin Loren,9,0,50,41
1657837939945,CSE 20,A01,083657,Tran; Khoa Dang,39,0,80,41
1657837945979,CSE 21,A01,095574,Bach; Quang Tran,22,0,48,26
1657837952002,CSE 30,A01,083084,Eldon; John,6,0,80,74
1657837952002,CSE 30,B01,095061,Bhaskar; Nishant,9,0,50,41
1657837958065,CSE 100,A01,083659,Cao; Yingjun,5,4,70,65
1657837964100,CSE 134B,A01,083661,Powell; Thomas Allan,24,0,100,76
1657837970144,CSE 140,A01,083663,Gungor; Onat,15,0,85,70
1657837976175,CSE 140L,A01,083088,Eldon; John,23,0,100,77
1657837982207,CSE 175,A01,083665,Kumar; Rakesh,3,0,25,22
1657837988238,CSE 190,A00,092507,Dubnov; Shlomo,8,0,20,12
1657837994265,ECE 45,A01,083139,Congero; Spencer William,6,0,75,69
1657838000296,ECE 65,A50,083695,Saad; Andrew S,12,0,30,18
1657838000296,ECE 65,A51,095125,Saad; Andrew S,24,0,26,2
1657838006325,ECE 109,A01,091882,Touri; Behrouz,20,0,70,50
1657838012360,ECE 180,A00,083140,Abi Samra; Nicholas Camill,1,0,30,29
1657838012360,ECE 180,B00,083141,Abi Samra; Nicholas Camill,0,0,30,30
1657838018391,MATH 10A,A01,083735,Patchell; Gregory David,2,0,30,28
1657838018391,MATH 10A,A02,083736,Patchell; Gregory David,20,0,30,10
1657838018391,MATH 10A,A03,083737,Patchell; Gregory David,16,0,30,14
1657838024439,MATH 10B,A01,083207,Lim; Seonhee,8,0,34,26
1657838024439,MATH 10B,A02,083208,Lim; Seonhee,10,0,35,25
1657838024439,MATH 10B,A03,093472,Lim; Seonhee,7,0,34,27
1657838024439,MATH 10B,B01,083739,Sinha; Shubham,14,0,30,16
1657838030490,MATH 18,A01,083743,Cinel; Cameron Alexander,9,0,30,21
1657838030490,MATH 18,A02,083744,Cinel; Cameron Alexander,18,0,30,12
1657838030490,MATH 18,A03,083745,Cinel; Cameron Alexander,10,0,30,20
1657838030490,MATH 18,B01,083748,Rideout; David Porter,5,0,37,32
1657838030490,MATH 18,B02,083749,Rideout; David Porter,5,0,36,31
1657838030490,MATH 18,B03,083750,Rideout; David Porter,3,0,37,34
1657838030490,MATH 18,B04,083751,Rideout; David Porter,6,0,36,30
1657838030490,MATH 18,B05,093473,Rideout; David Porter,6,0,36,30
1657838030490,MATH 18,B06,093474,Rideout; David Porter,6,0,36,30
1657838036518,MATH 20A,A01,083754,Zheng; Zequn,14,0,40,26
1657838042544,MATH 20B,A01,083756,Briones; Jor-el Thomas Caparas,4,0,36,32
1657838042544,MATH 20B,A02,083757,Briones; Jor-el Thomas Caparas,1,0,36,35
1657838042544,MATH 20B,A03,093475,Briones; Jor-el Thomas Caparas,2,0,36,34
1657838048579,MATH 20C,A01,083760,Briones; Jor-el Thomas Caparas,1,0,35,34
1657838048579,MATH 20C,A02,083761,Briones; Jor-el Thomas Caparas,8,0,35,27
1657838048579,MATH 20C,A03,093476,Briones; Jor-el Thomas Caparas,0,1,36,36
1657838048579,MATH 20C,B01,083762,Bach; Quang Tran,1,0,30,29
1657838054611,MATH 20D,A01,083765,Tran; Brian Kha,5,0,30,25
1657838054611,MATH 20D,A02,083766,Tran; Brian Kha,5,0,30,25
1657838054611,MATH 20D,A03,083767,Tran; Brian Kha,5,0,30,25
1657838060640,MATH 20E,A01,083771,Ganguly; Soumya,10,0,32,22
1657838060640,MATH 20E,A02,083772,Ganguly; Soumya,6,0,32,26
1657838060640,MATH 20E,B01,083773,Ciotti; Benjamin,20,0,35,15
1657838060640,MATH 20E,B02,083774,Ciotti; Benjamin,18,0,35,17
1657838066671,MATH 103A,A01,083777,Greenfeld; Be'Eri,3,0,36,33
1657838066671,MATH 103A,A02,083778,Greenfeld; Be'Eri,5,0,36,31
1657838066671,MATH 103A,A03,093561,Greenfeld; Be'Eri,6,0,36,30
1657838066671,MATH 103A,B01,083779,Greenfeld; Be'Eri,7,0,36,29
1657838066671,MATH 103A,B02,083780,Greenfeld; Be'Eri,4,0,36,32
1657838066671,MATH 103A,B03,093562,Greenfeld; Be'Eri,3,0,36,33
1657838072698,MATH 105,A01,085443,Carter; Anne Toulson,15,0,35,20
1657838072698,MATH 105,A02,093477,Carter; Anne Toulson,20,0,35,15
1657838078727,MATH 109,A01,083213,Ganzberger; Geoffrey Michael,3,0,34,31
1657838078727,MATH 109,A02,083214,Ganzberger; Geoffrey Michael,4,0,34,30
1657838078727,MATH 109,A03,093478,Ganzberger; Geoffrey Michael,2,0,34,32
1657838078727,MATH 109,B01,083215,Ganzberger; Geoffrey Michael,1,0,32,31
1657838078727,MATH 109,B02,083216,Ganzberger; Geoffrey Michael,2,0,32,30
1657838078727,MATH 109,B03,093479,Ganzberger; Geoffrey Michael,8,0,32,24
1657838084761,MATH 142A,A01,083219,Chow; Bennett,7,0,32,25
1657838084761,MATH 142A,A02,083220,Chow; Bennett,10,0,32,22
1657838084761,MATH 142A,A03,093480,Chow; Bennett,9,0,32,23
1657838084761,MATH 142A,B03,093481,Chow; Bennett,8,0,32,24
1657838084761,MATH 142A,B04,093558,Chow; Bennett,13,0,32,19
1657838084761,MATH 142A,B05,093559,Chow; Bennett,7,0,32,25
1657838090800,MATH 193A,A01,083224,Rotar; Vladimir,8,0,34,26
1657838090800,MATH 193A,A02,083225,Rotar; Vladimir,10,0,34,24
1657838090800,MATH 193A,A03,083781,Rotar; Vladimir,5,0,34,29
1657838090800,MATH 193A,A04,083782,Rotar; Vladimir,11,0,34,23
1657838090800,MATH 193A,A05,093482,Rotar; Vladimir,10,0,34,24
1657838096826,MATH 197,001,091859,McAuley; Julian John,9999,0,9999,0
1657838096826,MATH 197,002,095566,Kedlaya; Kiran S.,9997,0,9999,2
1657838096826,MATH 197,003,095567,Xiao; Ming,9999,0,9999,0
1657838096826,MATH 197,004,095571,Perols; Johan Lars,9998,0,9999,1
1657838103897,COGS 9,A01,083615,Shannon; Kyle Michael,9,0,75,66
1657838109947,COGS 11,A01,083617,Boyle; Mary E. T.,23,0,48,25
1657838115992,COGS 13,A01,083071,Bastos; Amalia Pinkusfeld,11,0,71,60
1657838122015,COGS 14A,A01,092681,Semenuks; Arturs,5,1,100,95
1657838128048,COGS 14B,A01,083073,Cheng; Tzu-Han,6,0,63,57
1657838134090,COGS 17,A01,092677,Semenuks; Arturs,6,0,81,75
1657838140131,COGS 100,A01,083619,Allen; Michael Gordon,17,0,70,53
1657838146159,COGS 101A,A01,083621,Davis; Joshua Daniel,9,0,68,59
1657838152194,COGS 101B,A01,091572,Allen; Michael Gordon,12,0,65,53
1657838158219,COGS 101C,A01,083625,Delgado; Tania,17,0,35,18
1657838164247,COGS 107A,A01,083627,Boyle; Mary E. T.,14,0,60,46
1657838170274,COGS 118A,A01,083075,Gupta; Anjum,21,0,76,55
1657838176303,CSE 3,A50,083646,Miranda; Gregory Joseph,24,0,50,26
1657838182341,CSE 8A,A50,083650,Miranda; Gregory Joseph,17,1,56,39
1657838188371,CSE 11,A01,083080,Cao; Yingjun,6,15,40,34
1657838194400,CSE 12,A01,083652,Krause-Levy; Sophia Louisa,29,1,120,91
1657838200444,CSE 15L,A01,083654,Morris; Justin Loren,9,0,50,41
1657838200444,CSE 15L,A02,083655,Morris; Justin Loren,9,0,50,41
1657838206473,CSE 20,A01,083657,Tran; Khoa Dang,39,0,80,41
1657838212503,CSE 21,A01,095574,Bach; Quang Tran,22,0,48,26
1657838218539,CSE 30,A01,083084,Eldon; John,6,0,80,74
1657838218539,CSE 30,B01,095061,Bhaskar; Nishant,9,0,50,41
1657838224562,CSE 100,A01,083659,Cao; Yingjun,5,4,70,65
1657838230611,CSE 134B,A01,083661,Powell; Thomas Allan,24,0,100,76
1657838236650,CSE 140,A01,083663,Gungor; Onat,15,0,85,70
1657838242671,CSE 140L,A01,083088,Eldon; John,23,0,100,77
1657838248696,CSE 175,A01,083665,Kumar; Rakesh,3,0,25,22
1657838254739,CSE 190,A00,092507,Dubnov; Shlomo,8,0,20,12
1657838260783,ECE 45,A01,083139,Congero; Spencer William,6,0,75,69
1657838266825,ECE 65,A50,083695,Saad; Andrew S,12,0,30,18
1657838266825,ECE 65,A51,095125,Saad; Andrew S,24,0,26,2
1657838272861,ECE 109,A01,091882,Touri; Behrouz,20,0,70,50
1657838278886,ECE 180,A00,083140,Abi Samra; Nicholas Camill,1,0,30,29
1657838278886,ECE 180,B00,083141,Abi Samra; Nicholas Camill,0,0,30,30
1657838284913,MATH 10A,A01,083735,Patchell; Gregory David,2,0,30,28
1657838284913,MATH 10A,A02,083736,Patchell; Gregory David,20,0,30,10
1657838284913,MATH 10A,A03,083737,Patchell; Gregory David,16,0,30,14
1657838290964,MATH 10B,A01,083207,Lim; Seonhee,8,0,34,26
1657838290964,MATH 10B,A02,083208,Lim; Seonhee,10,0,35,25
1657838290964,MATH 10B,A03,093472,Lim; Seonhee,7,0,34,27
1657838290964,MATH 10B,B01,083739,Sinha; Shubham,14,0,30,16
1657838296989,MATH 18,A01,083743,Cinel; Cameron Alexander,9,0,30,21
1657838296989,MATH 18,A02,083744,Cinel; Cameron Alexander,18,0,30,12
1657838296989,MATH 18,A03,083745,Cinel; Cameron Alexander,10,0,30,20
1657838296989,MATH 18,B01,083748,Rideout; David Porter,5,0,37,32
1657838296989,MATH 18,B02,083749,Rideout; David Porter,5,0,36,31
1657838296989,MATH 18,B03,083750,Rideout; David Porter,3,0,37,34
1657838296989,MATH 18,B04,083751,Rideout; David Porter,6,0,36,30
1657838296989,MATH 18,B05,093473,Rideout; David Porter,6,0,36,30
1657838296989,MATH 18,B06,093474,Rideout; David Porter,6,0,36,30
1657838303036,MATH 20A,A01,083754,Zheng; Zequn,14,0,40,26
1657838309069,MATH 20B,A01,083756,Briones; Jor-el Thomas Caparas,4,0,36,32
1657838309069,MATH 20B,A02,083757,Briones; Jor-el Thomas Caparas,1,0,36,35
1657838309069,MATH 20B,A03,093475,Briones; Jor-el Thomas Caparas,2,0,36,34
1657838315103,MATH 20C,A01,083760,Briones; Jor-el Thomas Caparas,1,0,35,34
1657838315103,MATH 20C,A02,083761,Briones; Jor-el Thomas Caparas,8,0,35,27
1657838315103,MATH 20C,A03,093476,Briones; Jor-el Thomas Caparas,0,1,36,36
1657838315103,MATH 20C,B01,083762,Bach; Quang Tran,1,0,30,29
1657838321125,MATH 20D,A01,083765,Tran; Brian Kha,5,0,30,25
1657838321125,MATH 20D,A02,083766,Tran; Brian Kha,5,0,30,25
1657838321125,MATH 20D,A03,083767,Tran; Brian Kha,5,0,30,25
1657838327172,MATH 20E,A01,083771,Ganguly; Soumya,10,0,32,22
1657838327172,MATH 20E,A02,083772,Ganguly; Soumya,6,0,32,26
1657838327172,MATH 20E,B01,083773,Ciotti; Benjamin,20,0,35,15
1657838327172,MATH 20E,B02,083774,Ciotti; Benjamin,18,0,35,17
1657838333199,MATH 103A,A01,083777,Greenfeld; Be'Eri,3,0,36,33
1657838333199,MATH 103A,A02,083778,Greenfeld; Be'Eri,5,0,36,31
1657838333199,MATH 103A,A03,093561,Greenfeld; Be'Eri,6,0,36,30
1657838333199,MATH 103A,B01,083779,Greenfeld; Be'Eri,7,0,36,29
1657838333199,MATH 103A,B02,083780,Greenfeld; Be'Eri,4,0,36,32
1657838333199,MATH 103A,B03,093562,Greenfeld; Be'Eri,3,0,36,33
1657838339231,MATH 105,A01,085443,Carter; Anne Toulson,15,0,35,20
1657838339231,MATH 105,A02,093477,Carter; Anne Toulson,20,0,35,15
1657838345286,MATH 109,A01,083213,Ganzberger; Geoffrey Michael,3,0,34,31
1657838345286,MATH 109,A02,083214,Ganzberger; Geoffrey Michael,4,0,34,30
1657838345286,MATH 109,A03,093478,Ganzberger; Geoffrey Michael,2,0,34,32
1657838345286,MATH 109,B01,083215,Ganzberger; Geoffrey Michael,1,0,32,31
1657838345286,MATH 109,B02,083216,Ganzberger; Geoffrey Michael,2,0,32,30
1657838345286,MATH 109,B03,093479,Ganzberger; Geoffrey Michael,8,0,32,24
1657838351310,MATH 142A,A01,083219,Chow; Bennett,7,0,32,25
1657838351310,MATH 142A,A02,083220,Chow; Bennett,10,0,32,22
1657838351310,MATH 142A,A03,093480,Chow; Bennett,9,0,32,23
1657838351310,MATH 142A,B03,093481,Chow; Bennett,8,0,32,24
1657838351310,MATH 142A,B04,093558,Chow; Bennett,13,0,32,19
1657838351310,MATH 142A,B05,093559,Chow; Bennett,7,0,32,25
1657838357351,MATH 193A,A01,083224,Rotar; Vladimir,8,0,34,26
1657838357351,MATH 193A,A02,083225,Rotar; Vladimir,10,0,34,24
1657838357351,MATH 193A,A03,083781,Rotar; Vladimir,5,0,34,29
1657838357351,MATH 193A,A04,083782,Rotar; Vladimir,11,0,34,23
1657838357351,MATH 193A,A05,093482,Rotar; Vladimir,10,0,34,24
1657838363381,MATH 197,001,091859,McAuley; Julian John,9999,0,9999,0
1657838363381,MATH 197,002,095566,Kedlaya; Kiran S.,9997,0,9999,2
1657838363381,MATH 197,003,095567,Xiao; Ming,9999,0,9999,0
1657838363381,MATH 197,004,095571,Perols; Johan Lars,9998,0,9999,1
1657838370447,COGS 9,A01,083615,Shannon; Kyle Michael,9,0,75,66
1657838376485,COGS 11,A01,083617,Boyle; Mary E. T.,23,0,48,25
1657838382508,COGS 13,A01,083071,Bastos; Amalia Pinkusfeld,11,0,71,60
1657838388562,COGS 14A,A01,092681,Semenuks; Arturs,5,1,100,95
1657838394587,COGS 14B,A01,083073,Cheng; Tzu-Han,6,0,63,57
1657838400625,COGS 17,A01,092677,Semenuks; Arturs,6,0,81,75
1657838406660,COGS 100,A01,083619,Allen; Michael Gordon,17,0,70,53
1657838412692,COGS 101A,A01,083621,Davis; Joshua Daniel,9,0,68,59
1657838418713,COGS 101B,A01,091572,Allen; Michael Gordon,12,0,65,53
1657838424748,COGS 101C,A01,083625,Delgado; Tania,17,0,35,18
1657838430773,COGS 107A,A01,083627,Boyle; Mary E. T.,14,0,60,46
1657838436805,COGS 118A,A01,083075,Gupta; Anjum,21,0,76,55
1657838442847,CSE 3,A50,083646,Miranda; Gregory Joseph,24,0,50,26
1657838448979,CSE 8A,A50,083650,Miranda; Gregory Joseph,17,1,56,39
1657838455006,CSE 11,A01,083080,Cao; Yingjun,6,15,40,34
1657838461033,CSE 12,A01,083652,Krause-Levy; Sophia Louisa,29,1,120,91
1657838467080,CSE 15L,A01,083654,Morris; Justin Loren,9,0,50,41
1657838467080,CSE 15L,A02,083655,Morris; Justin Loren,9,0,50,41
1657838473105,CSE 20,A01,083657,Tran; Khoa Dang,39,0,80,41
1657838479135,CSE 21,A01,095574,Bach; Quang Tran,22,0,48,26
1657838485161,CSE 30,A01,083084,Eldon; John,6,0,80,74
1657838485161,CSE 30,B01,095061,Bhaskar; Nishant,9,0,50,41
1657838491186,CSE 100,A01,083659,Cao; Yingjun,5,4,70,65
1657838497211,CSE 134B,A01,083661,Powell; Thomas Allan,24,0,100,76
1657838503235,CSE 140,A01,083663,Gungor; Onat,15,0,85,70
1657838509267,CSE 140L,A01,083088,Eldon; John,23,0,100,77
1657838515288,CSE 175,A01,083665,Kumar; Rakesh,3,0,25,22
1657838521326,CSE 190,A00,092507,Dubnov; Shlomo,8,0,20,12
1657838527352,ECE 45,A01,083139,Congero; Spencer William,6,0,75,69
1657838533381,ECE 65,A50,083695,Saad; Andrew S,12,0,30,18
1657838533381,ECE 65,A51,095125,Saad; Andrew S,24,0,26,2
1657838539412,ECE 109,A01,091882,Touri; Behrouz,20,0,70,50
1657838545435,ECE 180,A00,083140,Abi Samra; Nicholas Camill,1,0,30,29
1657838545435,ECE 180,B00,083141,Abi Samra; Nicholas Camill,0,0,30,30
1657838551468,MATH 10A,A01,083735,Patchell; Gregory David,2,0,30,28
1657838551468,MATH 10A,A02,083736,Patchell; Gregory David,20,0,30,10
1657838551468,MATH 10A,A03,083737,Patchell; Gregory David,16,0,30,14
1657838557491,MATH 10B,A01,083207,Lim; Seonhee,8,0,34,26
1657838557491,MATH 10B,A02,083208,Lim; Seonhee,10,0,35,25
1657838557491,MATH 10B,A03,093472,Lim; Seonhee,7,0,34,27
1657838557491,MATH 10B,B01,083739,Sinha; Shubham,14,0,30,16
1657838563522,MATH 18,A01,083743,Cinel; Cameron Alexander,9,0,30,21
1657838563522,MATH 18,A02,083744,Cinel; Cameron Alexander,18,0,30,12
1657838563522,MATH 18,A03,083745,Cinel; Cameron Alexander,10,0,30,20
1657838563522,MATH 18,B01,083748,Rideout; David Porter,5,0,37,32
1657838563522,MATH 18,B02,083749,Rideout; David Porter,5,0,36,31
1657838563522,MATH 18,B03,083750,Rideout; David Porter,3,0,37,34
1657838563522,MATH 18,B04,083751,Rideout; David Porter,6,0,36,30
1657838563522,MATH 18,B05,093473,Rideout; David Porter,6,0,36,30
1657838563522,MATH 18,B06,093474,Rideout; David Porter,6,0,36,30
1657838569551,MATH 20A,A01,083754,Zheng; Zequn,14,0,40,26
1657838575587,MATH 20B,A01,083756,Briones; Jor-el Thomas Caparas,4,0,36,32
1657838575587,MATH 20B,A02,083757,Briones; Jor-el Thomas Caparas,1,0,36,35
1657838575587,MATH 20B,A03,093475,Briones; Jor-el Thomas Caparas,2,0,36,34
1657838581617,MATH 20C,A01,083760,Briones; Jor-el Thomas Caparas,1,0,35,34
1657838581617,MATH 20C,A02,083761,Briones; Jor-el Thomas Caparas,8,0,35,27
1657838581617,MATH 20C,A03,093476,Briones; Jor-el Thomas Caparas,0,1,36,36
1657838581617,MATH 20C,B01,083762,Bach; Quang Tran,1,0,30,29
1657838587667,MATH 20D,A01,083765,Tran; Brian Kha,5,0,30,25
1657838587667,MATH 20D,A02,083766,Tran; Brian Kha,5,0,30,25
1657838587667,MATH 20D,A03,083767,Tran; Brian Kha,5,0,30,25
1657838593709,MATH 20E,A01,083771,Ganguly; Soumya,10,0,32,22
1657838593709,MATH 20E,A02,083772,Ganguly; Soumya,6,0,32,26
1657838593709,MATH 20E,B01,083773,Ciotti; Benjamin,20,0,35,15
1657838593709,MATH 20E,B02,083774,Ciotti; Benjamin,18,0,35,17
1657838599733,MATH 103A,A01,083777,Greenfeld; Be'Eri,3,0,36,33
1657838599733,MATH 103A,A02,083778,Greenfeld; Be'Eri,5,0,36,31
1657838599733,MATH 103A,A03,093561,Greenfeld; Be'Eri,6,0,36,30
1657838599733,MATH 103A,B01,083779,Greenfeld; Be'Eri,7,0,36,29
1657838599733,MATH 103A,B02,083780,Greenfeld; Be'Eri,4,0,36,32
1657838599733,MATH 103A,B03,093562,Greenfeld; Be'Eri,3,0,36,33
1657838605760,MATH 105,A01,085443,Carter; Anne Toulson,15,0,35,20
1657838605760,MATH 105,A02,093477,Carter; Anne Toulson,20,0,35,15
1657838611801,MATH 109,A01,083213,Ganzberger; Geoffrey Michael,3,0,34,31
1657838611801,MATH 109,A02,083214,Ganzberger; Geoffrey Michael,4,0,34,30
1657838611801,MATH 109,A03,093478,Ganzberger; Geoffrey Michael,2,0,34,32
1657838611801,MATH 109,B01,083215,Ganzberger; Geoffrey Michael,1,0,32,31
1657838611801,MATH 109,B02,083216,Ganzberger; Geoffrey Michael,2,0,32,30
1657838611801,MATH 109,B03,093479,Ganzberger; Geoffrey Michael,8,0,32,24
1657838617845,MATH 142A,A01,083219,Chow; Bennett,7,0,32,25
1657838617845,MATH 142A,A02,083220,Chow; Bennett,10,0,32,22
1657838617845,MATH 142A,A03,093480,Chow; Bennett,9,0,32,23
1657838617845,MATH 142A,B03,093481,Chow; Bennett,8,0,32,24
1657838617845,MATH 142A,B04,093558,Chow; Bennett,13,0,32,19
1657838617845,MATH 142A,B05,093559,Chow; Bennett,7,0,32,25
1657838623873,MATH 193A,A01,083224,Rotar; Vladimir,8,0,34,26
1657838623873,MATH 193A,A02,083225,Rotar; Vladimir,10,0,34,24
1657838623873,MATH 193A,A03,083781,Rotar; Vladimir,5,0,34,29
1657838623873,MATH 193A,A04,083782,Rotar; Vladimir,11,0,34,23
1657838623873,MATH 193A,A05,093482,Rotar; Vladimir,10,0,34,24
1657838629908,MATH 197,001,091859,McAuley; Julian John,9999,0,9999,0
1657838629908,MATH 197,002,095566,Kedlaya; Kiran S.,9997,0,9999,2
1657838629908,MATH 197,003,095567,Xiao; Ming,9999,0,9999,0
1657838629908,MATH 197,004,095571,Perols; Johan Lars,9998,0,9999,1
1657838636980,COGS 9,A01,083615,Shannon; Kyle Michael,9,0,75,66
1657838643055,COGS 11,A01,083617,Boyle; Mary E. T.,23,0,48,25
1657838649093,COGS 13,A01,083071,Bastos; Amalia Pinkusfeld,11,0,71,60
1657838655116,COGS 14A,A01,092681,Semenuks; Arturs,5,1,100,95
1657838661155,COGS 14B,A01,083073,Cheng; Tzu-Han,6,0,63,57
1657838667177,COGS 17,A01,092677,Semenuks; Arturs,6,0,81,75
1657838673211,COGS 100,A01,083619,Allen; Michael Gordon,17,0,70,53
1657838679244,COGS 101A,A01,083621,Davis; Joshua Daniel,9,0,68,59
1657838685271,COGS 101B,A01,091572,Allen; Michael Gordon,12,0,65,53
1657838691319,COGS 101C,A01,083625,Delgado; Tania,17,0,35,18
1657838697341,COGS 107A,A01,083627,Boyle; Mary E. T.,14,0,60,46
1657838703368,COGS 118A,A01,083075,Gupta; Anjum,21,0,76,55
1657838709405,CSE 3,A50,083646,Miranda; Gregory Joseph,24,0,50,26
1657838715446,CSE 8A,A50,083650,Miranda; Gregory Joseph,17,1,56,39
1657838721468,CSE 11,A01,083080,Cao; Yingjun,6,15,40,34
1657838727503,CSE 12,A01,083652,Krause-Levy; Sophia Louisa,29,1,120,91
1657838733539,CSE 15L,A01,083654,Morris; Justin Loren,9,0,50,41
1657838733539,CSE 15L,A02,083655,Morris; Justin Loren,9,0,50,41
1657838739562,CSE 20,A01,083657,Tran; Khoa Dang,39,0,80,41
1657838745619,CSE 21,A01,095574,Bach; Quang Tran,22,0,48,26
1657838751656,CSE 30,A01,083084,Eldon; John,6,0,80,74
1657838751656,CSE 30,B01,095061,Bhaskar; Nishant,9,0,50,41
1657838757679,CSE 100,A01,083659,Cao; Yingjun,5,4,70,65
1657838763726,CSE 134B,A01,083661,Powell; Thomas Allan,24,0,100,76
1657838769747,CSE 140,A01,083663,Gungor; Onat,15,0,85,70
1657838775774,CSE 140L,A01,083088,Eldon; John,23,0,100,77
1657838781797,CSE 175,A01,083665,Kumar; Rakesh,3,0,25,22
1657838787835,CSE 190,A00,092507,Dubnov; Shlomo,8,0,20,12
1657838793869,ECE 45,A01,083139,Congero; Spencer William,6,0,75,69
1657838799898,ECE 65,A50,083695,Saad; Andrew S,12,0,30,18
1657838799898,ECE 65,A51,095125,Saad; Andrew S,24,0,26,2
1657838805924,ECE 109,A01,091882,Touri; Behrouz,20,0,70,50
1657838811962,ECE 180,A00,083140,Abi Samra; Nicholas Camill,1,0,30,29
1657838811962,ECE 180,B00,083141,Abi Samra; Nicholas Camill,0,0,30,30
1657838817992,MATH 10A,A01,083735,Patchell; Gregory David,2,0,30,28
1657838817992,MATH 10A,A02,083736,Patchell; Gregory David,20,0,30,10
1657838817992,MATH 10A,A03,083737,Patchell; Gregory David,16,0,30,14
1657838824022,MATH 10B,A01,083207,Lim; Seonhee,8,0,34,26
1657838824022,MATH 10B,A02,083208,Lim; Seonhee,10,0,35,25
1657838824022,MATH 10B,A03,093472,Lim; Seonhee,7,0,34,27
1657838824022,MATH 10B,B01,083739,Sinha; Shubham,14,0,30,16
1657838830053,MATH 18,A01,083743,Cinel; Cameron Alexander,9,0,30,21
1657838830053,MATH 18,A02,083744,Cinel; Cameron Alexander,18,0,30,12
1657838830053,MATH 18,A03,083745,Cinel; Cameron Alexander,10,0,30,20
1657838830053,MATH 18,B01,083748,Rideout; David Porter,5,0,37,32
1657838830053,MATH 18,B02,083749,Rideout; David Porter,5,0,36,31
1657838830053,MATH 18,B03,083750,Rideout; David Porter,3,0,37,34
1657838830053,MATH 18,B04,083751,Rideout; David Porter,6,0,36,30
1657838830053,MATH 18,B05,093473,Rideout; David Porter,6,0,36,30
1657838830053,MATH 18,B06,093474,Rideout; David Porter,6,0,36,30
1657838836091,MATH 20A,A01,083754,Zheng; Zequn,14,0,40,26
1657838842115,MATH 20B,A01,083756,Briones; Jor-el Thomas Caparas,4,0,36,32
1657838842115,MATH 20B,A02,083757,Briones; Jor-el Thomas Caparas,1,0,36,35
1657838842115,MATH 20B,A03,093475,Briones; Jor-el Thomas Caparas,2,0,36,34
1657838848147,MATH 20C,A01,083760,Briones; Jor-el Thomas Caparas,1,0,35,34
1657838848147,MATH 20C,A02,083761,Briones; Jor-el Thomas Caparas,8,0,35,27
1657838848147,MATH 20C,A03,093476,Briones; Jor-el Thomas Caparas,0,1,36,36
1657838848147,MATH 20C,B01,083762,Bach; Quang Tran,1,0,30,29
1657838854170,MATH 20D,A01,083765,Tran; Brian Kha,5,0,30,25
1657838854170,MATH 20D,A02,083766,Tran; Brian Kha,5,0,30,25
1657838854170,MATH 20D,A03,083767,Tran; Brian Kha,5,0,30,25
1657838860196,MATH 20E,A01,083771,Ganguly; Soumya,10,0,32,22
1657838860196,MATH 20E,A02,083772,Ganguly; Soumya,6,0,32,26
1657838860196,MATH 20E,B01,083773,Ciotti; Benjamin,20,0,35,15
1657838860196,MATH 20E,B02,083774,Ciotti; Benjamin,18,0,35,17
1657838866223,MATH 103A,A01,083777,Greenfeld; Be'Eri,3,0,36,33
1657838866223,MATH 103A,A02,083778,Greenfeld; Be'Eri,5,0,36,31
1657838866223,MATH 103A,A03,093561,Greenfeld; Be'Eri,6,0,36,30
1657838866223,MATH 103A,B01,083779,Greenfeld; Be'Eri,7,0,36,29
1657838866223,MATH 103A,B02,083780,Greenfeld; Be'Eri,4,0,36,32
1657838866223,MATH 103A,B03,093562,Greenfeld; Be'Eri,3,0,36,33
1657838872259,MATH 105,A01,085443,Carter; Anne Toulson,15,0,35,20
1657838872259,MATH 105,A02,093477,Carter; Anne Toulson,20,0,35,15
1657838878309,MATH 109,A01,083213,Ganzberger; Geoffrey Michael,3,0,34,31
1657838878309,MATH 109,A02,083214,Ganzberger; Geoffrey Michael,4,0,34,30
1657838878309,MATH 109,A03,093478,Ganzberger; Geoffrey Michael,2,0,34,32
1657838878309,MATH 109,B01,083215,Ganzberger; Geoffrey Michael,1,0,32,31
1657838878309,MATH 109,B02,083216,Ganzberger; Geoffrey Michael,2,0,32,30
1657838878309,MATH 109,B03,093479,Ganzberger; Geoffrey Michael,8,0,32,24
1657838884339,MATH 142A,A01,083219,Chow; Bennett,7,0,32,25
1657838884339,MATH 142A,A02,083220,Chow; Bennett,10,0,32,22
1657838884339,MATH 142A,A03,093480,Chow; Bennett,9,0,32,23
1657838884339,MATH 142A,B03,093481,Chow; Bennett,8,0,32,24
1657838884339,MATH 142A,B04,093558,Chow; Bennett,13,0,32,19
1657838884339,MATH 142A,B05,093559,Chow; Bennett,7,0,32,25
1657838890385,MATH 193A,A01,083224,Rotar; Vladimir,8,0,34,26
1657838890385,MATH 193A,A02,083225,Rotar; Vladimir,10,0,34,24
1657838890385,MATH 193A,A03,083781,Rotar; Vladimir,5,0,34,29
1657838890385,MATH 193A,A04,083782,Rotar; Vladimir,11,0,34,23
1657838890385,MATH 193A,A05,093482,Rotar; Vladimir,10,0,34,24
1657838896421,MATH 197,001,091859,McAuley; Julian John,9999,0,9999,0
1657838896421,MATH 197,002,095566,Kedlaya; Kiran S.,9997,0,9999,2
1657838896421,MATH 197,003,095567,Xiao; Ming,9999,0,9999,0
1657838896421,MATH 197,004,095571,Perols; Johan Lars,9998,0,9999,1
1657838903486,COGS 9,A01,083615,Shannon; Kyle Michael,9,0,75,66
1657838909524,COGS 11,A01,083617,Boyle; Mary E. T.,23,0,48,25
1657838915571,COGS 13,A01,083071,Bastos; Amalia Pinkusfeld,11,0,71,60
1657838921593,COGS 14A,A01,092681,Semenuks; Arturs,5,1,100,95
1657838927645,COGS 14B,A01,083073,Cheng; Tzu-Han,6,0,63,57
1657838933693,COGS 17,A01,092677,Semenuks; Arturs,6,0,81,75
1657838939719,COGS 100,A01,083619,Allen; Michael Gordon,17,0,70,53
1657838945758,COGS 101A,A01,083621,Davis; Joshua Daniel,9,0,68,59
1657838951804,COGS 101B,A01,091572,Allen; Michael Gordon,12,0,65,53
1657838957843,COGS 101C,A01,083625,Delgado; Tania,17,0,35,18
1657838963866,COGS 107A,A01,083627,Boyle; Mary E. T.,14,0,60,46
1657838969910,COGS 118A,A01,083075,Gupta; Anjum,21,0,76,55
1657838975937,CSE 3,A50,083646,Miranda; Gregory Joseph,24,0,50,26
1657838981974,CSE 8A,A50,083650,Miranda; Gregory Joseph,17,1,56,39
1657838987996,CSE 11,A01,083080,Cao; Yingjun,6,15,40,34
1657838994019,CSE 12,A01,083652,Krause-Levy; Sophia Louisa,29,1,120,91
1657839000068,CSE 15L,A01,083654,Morris; Justin Loren,9,0,50,41
1657839000068,CSE 15L,A02,083655,Morris; Justin Loren,9,0,50,41
1657839006097,CSE 20,A01,083657,Tran; Khoa Dang,39,0,80,41
1657839012130,CSE 21,A01,095574,Bach; Quang Tran,22,0,48,26
1657839018157,CSE 30,A01,083084,Eldon; John,6,0,80,74
1657839018157,CSE 30,B01,095061,Bhaskar; Nishant,9,0,50,41
1657839024179,CSE 100,A01,083659,Cao; Yingjun,5,4,70,65
1657839030211,CSE 134B,A01,083661,Powell; Thomas Allan,24,0,100,76
1657839036268,CSE 140,A01,083663,Gungor; Onat,15,0,85,70
1657839042291,CSE 140L,A01,083088,Eldon; John,23,0,100,77
1657839048416,CSE 175,A01,083665,Kumar; Rakesh,3,0,25,22
1657839054454,CSE 190,A00,092507,Dubnov; Shlomo,8,0,20,12
1657839060476,ECE 45,A01,083139,Congero; Spencer William,6,0,75,69
1657839066509,ECE 65,A50,083695,Saad; Andrew S,12,0,30,18
1657839066509,ECE 65,A51,095125,Saad; Andrew S,24,0,26,2
1657839072540,ECE 109,A01,091882,Touri; Behrouz,20,0,70,50
1657839078584,ECE 180,A00,083140,Abi Samra; Nicholas Camill,1,0,30,29
1657839078584,ECE 180,B00,083141,Abi Samra; Nicholas Camill,0,0,30,30
1657839084614,MATH 10A,A01,083735,Patchell; Gregory David,2,0,30,28
1657839084614,MATH 10A,A02,083736,Patchell; Gregory David,20,0,30,10
1657839084614,MATH 10A,A03,083737,Patchell; Gregory David,16,0,30,14
1657839090644,MATH 10B,A01,083207,Lim; Seonhee,8,0,34,26
1657839090644,MATH 10B,A02,083208,Lim; Seonhee,10,0,35,25
1657839090644,MATH 10B,A03,093472,Lim; Seonhee,7,0,34,27
1657839090644,MATH 10B,B01,083739,Sinha; Shubham,14,0,30,16
1657839096668,MATH 18,A01,083743,Cinel; Cameron Alexander,9,0,30,21
1657839096668,MATH 18,A02,083744,Cinel; Cameron Alexander,18,0,30,12
1657839096668,MATH 18,A03,083745,Cinel; Cameron Alexander,10,0,30,20
1657839096668,MATH 18,B01,083748,Rideout; David Porter,5,0,37,32
1657839096668,MATH 18,B02,083749,Rideout; David Porter,5,0,36,31
1657839096668,MATH 18,B03,083750,Rideout; David Porter,3,0,37,34
1657839096668,MATH 18,B04,083751,Rideout; David Porter,6,0,36,30
1657839096668,MATH 18,B05,093473,Rideout; David Porter,6,0,36,30
1657839096668,MATH 18,B06,093474,Rideout; David Porter,6,0,36,30
1657839102691,MATH 20A,A01,083754,Zheng; Zequn,14,0,40,26
1657839108713,MATH 20B,A01,083756,Briones; Jor-el Thomas Caparas,4,0,36,32
1657839108713,MATH 20B,A02,083757,Briones; Jor-el Thomas Caparas,1,0,36,35
1657839108713,MATH 20B,A03,093475,Briones; Jor-el Thomas Caparas,2,0,36,34
1657839114754,MATH 20C,A01,083760,Briones; Jor-el Thomas Caparas,1,0,35,34
1657839114754,MATH 20C,A02,083761,Briones; Jor-el Thomas Caparas,8,0,35,27
1657839114754,MATH 20C,A03,093476,Briones; Jor-el Thomas Caparas,0,1,36,36
1657839114754,MATH 20C,B01,083762,Bach; Quang Tran,1,0,30,29
1657839120789,MATH 20D,A01,083765,Tran; Brian Kha,5,0,30,25
1657839120789,MATH 20D,A02,083766,Tran; Brian Kha,5,0,30,25
1657839120789,MATH 20D,A03,083767,Tran; Brian Kha,5,0,30,25
1657839126822,MATH 20E,A01,083771,Ganguly; Soumya,10,0,32,22
1657839126822,MATH 20E,A02,083772,Ganguly; Soumya,6,0,32,26
1657839126822,MATH 20E,B01,083773,Ciotti; Benjamin,20,0,35,15
1657839126822,MATH 20E,B02,083774,Ciotti; Benjamin,18,0,35,17
1657839132846,MATH 103A,A01,083777,Greenfeld; Be'Eri,3,0,36,33
1657839132846,MATH 103A,A02,083778,Greenfeld; Be'Eri,5,0,36,31
1657839132846,MATH 103A,A03,093561,Greenfeld; Be'Eri,6,0,36,30
1657839132846,MATH 103A,B01,083779,Greenfeld; Be'Eri,7,0,36,29
1657839132846,MATH 103A,B02,083780,Greenfeld; Be'Eri,4,0,36,32
1657839132846,MATH 103A,B03,093562,Greenfeld; Be'Eri,3,0,36,33
1657839138884,MATH 105,A01,085443,Carter; Anne Toulson,15,0,35,20
1657839138884,MATH 105,A02,093477,Carter; Anne Toulson,20,0,35,15
1657839144913,MATH 109,A01,083213,Ganzberger; Geoffrey Michael,3,0,34,31
1657839144913,MATH 109,A02,083214,Ganzberger; Geoffrey Michael,4,0,34,30
1657839144913,MATH 109,A03,093478,Ganzberger; Geoffrey Michael,2,0,34,32
1657839144913,MATH 109,B01,083215,Ganzberger; Geoffrey Michael,1,0,32,31
1657839144913,MATH 109,B02,083216,Ganzberger; Geoffrey Michael,2,0,32,30
1657839144913,MATH 109,B03,093479,Ganzberger; Geoffrey Michael,8,0,32,24
1657839150942,MATH 142A,A01,083219,Chow; Bennett,7,0,32,25
1657839150942,MATH 142A,A02,083220,Chow; Bennett,10,0,32,22
1657839150942,MATH 142A,A03,093480,Chow; Bennett,9,0,32,23
1657839150942,MATH 142A,B03,093481,Chow; Bennett,8,0,32,24
1657839150942,MATH 142A,B04,093558,Chow; Bennett,13,0,32,19
1657839150942,MATH 142A,B05,093559,Chow; Bennett,7,0,32,25
1657839156980,MATH 193A,A01,083224,Rotar; Vladimir,8,0,34,26
1657839156980,MATH 193A,A02,083225,Rotar; Vladimir,10,0,34,24
1657839156980,MATH 193A,A03,083781,Rotar; Vladimir,5,0,34,29
1657839156980,MATH 193A,A04,083782,Rotar; Vladimir,11,0,34,23
1657839156980,MATH 193A,A05,093482,Rotar; Vladimir,10,0,34,24
1657839163018,MATH 197,001,091859,McAuley; Julian John,9999,0,9999,0
1657839163018,MATH 197,002,095566,Kedlaya; Kiran S.,9997,0,9999,2
1657839163018,MATH 197,003,095567,Xiao; Ming,9999,0,9999,0
1657839163018,MATH 197,004,095571,Perols; Johan Lars,9998,0,9999,1
1657839170078,COGS 9,A01,083615,Shannon; Kyle Michael,9,0,75,66
1657839176125,COGS 11,A01,083617,Boyle; Mary E. T.,23,0,48,25
1657839182150,COGS 13,A01,083071,Bastos; Amalia Pinkusfeld,11,0,71,60
1657839188197,COGS 14A,A01,092681,Semenuks; Arturs,5,1,100,95
1657839194219,COGS 14B,A01,083073,Cheng; Tzu-Han,6,0,63,57
1657839200247,COGS 17,A01,092677,Semenuks; Arturs,6,0,81,75
1657839206283,COGS 100,A01,083619,Allen; Michael Gordon,17,0,70,53
1657839212317,COGS 101A,A01,083621,Davis; Joshua Daniel,9,0,68,59
1657839218363,COGS 101B,A01,091572,Allen; Michael Gordon,12,0,65,53
1657839224386,COGS 101C,A01,083625,Delgado; Tania,17,0,35,18
1657839230410,COGS 107A,A01,083627,Boyle; Mary E. T.,14,0,60,46
1657839236433,COGS 118A,A01,083075,Gupta; Anjum,21,0,76,55
1657839242470,CSE 3,A50,083646,Miranda; Gregory Joseph,24,0,50,26
1657839248510,CSE 8A,A50,083650,Miranda; Gregory Joseph,17,1,56,39
1657839254536,CSE 11,A01,083080,Cao; Yingjun,6,15,40,34
1657839260584,CSE 12,A01,083652,Krause-Levy; Sophia Louisa,29,1,120,91
1657839266611,CSE 15L,A01,083654,Morris; Justin Loren,9,0,50,41
1657839266611,CSE 15L,A02,083655,Morris; Justin Loren,9,0,50,41
1657839272642,CSE 20,A01,083657,Tran; Khoa Dang,39,0,80,41
1657839278675,CSE 21,A01,095574,Bach; Quang Tran,22,0,48,26
1657839284699,CSE 30,A01,083084,Eldon; John,6,0,80,74
1657839284699,CSE 30,B01,095061,Bhaskar; Nishant,9,0,50,41
1657839290729,CSE 100,A01,083659,Cao; Yingjun,5,4,70,65
1657839296754,CSE 134B,A01,083661,Powell; Thomas Allan,24,0,100,76
1657839302797,CSE 140,A01,083663,Gungor; Onat,15,0,85,70
1657839308822,CSE 140L,A01,083088,Eldon; John,23,0,100,77
1657839314856,CSE 175,A01,083665,Kumar; Rakesh,3,0,25,22
1657839320880,CSE 190,A00,092507,Dubnov; Shlomo,8,0,20,12
1657839326902,ECE 45,A01,083139,Congero; Spencer William,6,0,75,69
1657839332926,ECE 65,A50,083695,Saad; Andrew S,12,0,30,18
1657839332926,ECE 65,A51,095125,Saad; Andrew S,24,0,26,2
1657839338950,ECE 109,A01,091882,Touri; Behrouz,20,0,70,50
1657839344972,ECE 180,A00,083140,Abi Samra; Nicholas Camill,1,0,30,29
1657839344972,ECE 180,B00,083141,Abi Samra; Nicholas Camill,0,0,30,30
1657839351005,MATH 10A,A01,083735,Patchell; Gregory David,2,0,30,28
1657839351005,MATH 10A,A02,083736,Patchell; Gregory David,20,0,30,10
1657839351005,MATH 10A,A03,083737,Patchell; Gregory David,16,0,30,14
1657839357043,MATH 10B,A01,083207,Lim; Seonhee,8,0,34,26
1657839357043,MATH 10B,A02,083208,Lim; Seonhee,10,0,35,25
1657839357043,MATH 10B,A03,093472,Lim; Seonhee,7,0,34,27
1657839357043,MATH 10B,B01,083739,Sinha; Shubham,14,0,30,16
1657839363068,MATH 18,A01,083743,Cinel; Cameron Alexander,9,0,30,21
1657839363068,MATH 18,A02,083744,Cinel; Cameron Alexander,18,0,30,12
1657839363068,MATH 18,A03,083745,Cinel; Cameron Alexander,10,0,30,20
1657839363068,MATH 18,B01,083748,Rideout; David Porter,5,0,37,32
1657839363068,MATH 18,B02,083749,Rideout; David Porter,5,0,36,31
1657839363068,MATH 18,B03,083750,Rideout; David Porter,3,0,37,34
1657839363068,MATH 18,B04,083751,Rideout; David Porter,6,0,36,30
1657839363068,MATH 18,B05,093473,Rideout; David Porter,6,0,36,30
1657839363068,MATH 18,B06,093474,Rideout; David Porter,6,0,36,30
1657839369103,MATH 20A,A01,083754,Zheng; Zequn,14,0,40,26
1657839375126,MATH 20B,A01,083756,Briones; Jor-el Thomas Caparas,4,0,36,32
1657839375126,MATH 20B,A02,083757,Briones; Jor-el Thomas Caparas,1,0,36,35
1657839375126,MATH 20B,A03,093475,Briones; Jor-el Thomas Caparas,2,0,36,34
1657839381165,MATH 20C,A01,083760,Briones; Jor-el Thomas Caparas,1,0,35,34
1657839381165,MATH 20C,A02,083761,Briones; Jor-el Thomas Caparas,8,0,35,27
1657839381165,MATH 20C,A03,093476,Briones; Jor-el Thomas Caparas,0,1,36,36
1657839381165,MATH 20C,B01,083762,Bach; Quang Tran,1,0,30,29
1657839387204,MATH 20D,A01,083765,Tran; Brian Kha,5,0,30,25
1657839387204,MATH 20D,A02,083766,Tran; Brian Kha,5,0,30,25
1657839387204,MATH 20D,A03,083767,Tran; Brian Kha,5,0,30,25
1657839393233,MATH 20E,A01,083771,Ganguly; Soumya,10,0,32,22
1657839393233,MATH 20E,A02,083772,Ganguly; Soumya,6,0,32,26
1657839393233,MATH 20E,B01,083773,Ciotti; Benjamin,20,0,35,15
1657839393233,MATH 20E,B02,083774,Ciotti; Benjamin,18,0,35,17
1657839399278,MATH 103A,A01,083777,Greenfeld; Be'Eri,3,0,36,33
1657839399278,MATH 103A,A02,083778,Greenfeld; Be'Eri,5,0,36,31
1657839399278,MATH 103A,A03,093561,Greenfeld; Be'Eri,6,0,36,30
1657839399278,MATH 103A,B01,083779,Greenfeld; Be'Eri,7,0,36,29
1657839399278,MATH 103A,B02,083780,Greenfeld; Be'Eri,4,0,36,32
1657839399278,MATH 103A,B03,093562,Greenfeld; Be'Eri,3,0,36,33
1657839405300,MATH 105,A01,085443,Carter; Anne Toulson,15,0,35,20
1657839405300,MATH 105,A02,093477,Carter; Anne Toulson,20,0,35,15
1657839411325,MATH 109,A01,083213,Ganzberger; Geoffrey Michael,3,0,34,31
1657839411325,MATH 109,A02,083214,Ganzberger; Geoffrey Michael,4,0,34,30
1657839411325,MATH 109,A03,093478,Ganzberger; Geoffrey Michael,2,0,34,32
1657839411325,MATH 109,B01,083215,Ganzberger; Geoffrey Michael,1,0,32,31
1657839411325,MATH 109,B02,083216,Ganzberger; Geoffrey Michael,2,0,32,30
1657839411325,MATH 109,B03,093479,Ganzberger; Geoffrey Michael,8,0,32,24
1657839417358,MATH 142A,A01,083219,Chow; Bennett,7,0,32,25
1657839417358,MATH 142A,A02,083220,Chow; Bennett,10,0,32,22
1657839417358,MATH 142A,A03,093480,Chow; Bennett,9,0,32,23
1657839417358,MATH 142A,B03,093481,Chow; Bennett,8,0,32,24
1657839417358,MATH 142A,B04,093558,Chow; Bennett,13,0,32,19
1657839417358,MATH 142A,B05,093559,Chow; Bennett,7,0,32,25
1657839423383,MATH 193A,A01,083224,Rotar; Vladimir,8,0,34,26
1657839423383,MATH 193A,A02,083225,Rotar; Vladimir,10,0,34,24
1657839423383,MATH 193A,A03,083781,Rotar; Vladimir,5,0,34,29
1657839423383,MATH 193A,A04,083782,Rotar; Vladimir,11,0,34,23
1657839423383,MATH 193A,A05,093482,Rotar; Vladimir,10,0,34,24
1657839429435,MATH 197,001,091859,McAuley; Julian John,9999,0,9999,0
1657839429435,MATH 197,002,095566,Kedlaya; Kiran S.,9997,0,9999,2
1657839429435,MATH 197,003,095567,Xiao; Ming,9999,0,9999,0
1657839429435,MATH 197,004,095571,Perols; Johan Lars,9998,0,9999,1
1657839436485,COGS 9,A01,083615,Shannon; Kyle Michael,9,0,75,66
1657839442508,COGS 11,A01,083617,Boyle; Mary E. T.,23,0,48,25
1657839448550,COGS 13,A01,083071,Bastos; Amalia Pinkusfeld,11,0,71,60
1657839454574,COGS 14A,A01,092681,Semenuks; Arturs,5,1,100,95
1657839460595,COGS 14B,A01,083073,Cheng; Tzu-Han,6,0,63,57
1657839466618,COGS 17,A01,092677,Semenuks; Arturs,6,0,81,75
1657839472646,COGS 100,A01,083619,Allen; Michael Gordon,17,0,70,53
1657839478684,COGS 101A,A01,083621,Davis; Joshua Daniel,9,0,68,59
1657839484707,COGS 101B,A01,091572,Allen; Michael Gordon,12,0,65,53
1657839490761,COGS 101C,A01,083625,Delgado; Tania,17,0,35,18
1657839496786,COGS 107A,A01,083627,Boyle; Mary E. T.,14,0,60,46
1657839502808,COGS 118A,A01,083075,Gupta; Anjum,21,0,76,55
1657839508855,CSE 3,A50,083646,Miranda; Gregory Joseph,24,0,50,26
1657839514891,CSE 8A,A50,083650,Miranda; Gregory Joseph,17,1,56,39
1657839520921,CSE 11,A01,083080,Cao; Yingjun,6,15,40,34
1657839526975,CSE 12,A01,083652,Krause-Levy; Sophia Louisa,29,1,120,91
1657839533000,CSE 15L,A01,083654,Morris; Justin Loren,9,0,50,41
1657839533000,CSE 15L,A02,083655,Morris; Justin Loren,9,0,50,41
1657839539036,CSE 20,A01,083657,Tran; Khoa Dang,39,0,80,41
1657839545060,CSE 21,A01,095574,Bach; Quang Tran,22,0,48,26
1657839551088,CSE 30,A01,083084,Eldon; John,6,0,80,74
1657839551088,CSE 30,B01,095061,Bhaskar; Nishant,9,0,50,41
1657839557123,CSE 100,A01,083659,Cao; Yingjun,5,4,70,65
1657839563167,CSE 134B,A01,083661,Powell; Thomas Allan,24,0,100,76
1657839569195,CSE 140,A01,083663,Gungor; Onat,15,0,85,70
1657839575239,CSE 140L,A01,083088,Eldon; John,23,0,100,77
1657839581286,CSE 175,A01,083665,Kumar; Rakesh,3,0,25,22
1657839587324,CSE 190,A00,092507,Dubnov; Shlomo,8,0,20,12
1657839593347,ECE 45,A01,083139,Congero; Spencer William,6,0,75,69
1657839599385,ECE 65,A50,083695,Saad; Andrew S,12,0,30,18
1657839599385,ECE 65,A51,095125,Saad; Andrew S,24,0,26,2
1657839605411,ECE 109,A01,091882,Touri; Behrouz,20,0,70,50
1657839611433,ECE 180,A00,083140,Abi Samra; Nicholas Camill,1,0,30,29
1657839611433,ECE 180,B00,083141,Abi Samra; Nicholas Camill,0,0,30,30
1657839617462,MATH 10A,A01,083735,Patchell; Gregory David,2,0,30,28
1657839617462,MATH 10A,A02,083736,Patchell; Gregory David,20,0,30,10
1657839617462,MATH 10A,A03,083737,Patchell; Gregory David,16,0,30,14
1657839623493,MATH 10B,A01,083207,Lim; Seonhee,8,0,34,26
1657839623493,MATH 10B,A02,083208,Lim; Seonhee,10,0,35,25
1657839623493,MATH 10B,A03,093472,Lim; Seonhee,7,0,34,27
1657839623493,MATH 10B,B01,083739,Sinha; Shubham,14,0,30,16
1657839629517,MATH 18,A01,083743,Cinel; Cameron Alexander,9,0,30,21
1657839629517,MATH 18,A02,083744,Cinel; Cameron Alexander,18,0,30,12
1657839629517,MATH 18,A03,083745,Cinel; Cameron Alexander,10,0,30,20
1657839629517,MATH 18,B01,083748,Rideout; David Porter,5,0,37,32
1657839629517,MATH 18,B02,083749,Rideout; David Porter,5,0,36,31
1657839629517,MATH 18,B03,083750,Rideout; David Porter,3,0,37,34
1657839629517,MATH 18,B04,083751,Rideout; David Porter,6,0,36,30
1657839629517,MATH 18,B05,093473,Rideout; David Porter,6,0,36,30
1657839629517,MATH 18,B06,093474,Rideout; David Porter,6,0,36,30
1657839635557,MATH 20A,A01,083754,Zheng; Zequn,14,0,40,26
1657839641579,MATH 20B,A01,083756,Briones; Jor-el Thomas Caparas,4,0,36,32
1657839641579,MATH 20B,A02,083757,Briones; Jor-el Thomas Caparas,1,0,36,35
1657839641579,MATH 20B,A03,093475,Briones; Jor-el Thomas Caparas,2,0,36,34
1657839647698,MATH 20C,A01,083760,Briones; Jor-el Thomas Caparas,1,0,35,34
1657839647698,MATH 20C,A02,083761,Briones; Jor-el Thomas Caparas,8,0,35,27
1657839647698,MATH 20C,A03,093476,Briones; Jor-el Thomas Caparas,0,1,36,36
1657839647698,MATH 20C,B01,083762,Bach; Quang Tran,1,0,30,29
1657839653733,MATH 20D,A01,083765,Tran; Brian Kha,5,0,30,25
1657839653733,MATH 20D,A02,083766,Tran; Brian Kha,5,0,30,25
1657839653733,MATH 20D,A03,083767,Tran; Brian Kha,5,0,30,25
1657839659762,MATH 20E,A01,083771,Ganguly; Soumya,10,0,32,22
1657839659762,MATH 20E,A02,083772,Ganguly; Soumya,6,0,32,26
1657839659762,MATH 20E,B01,083773,Ciotti; Benjamin,20,0,35,15
1657839659762,MATH 20E,B02,083774,Ciotti; Benjamin,18,0,35,17
1657839665795,MATH 103A,A01,083777,Greenfeld; Be'Eri,3,0,36,33
1657839665795,MATH 103A,A02,083778,Greenfeld; Be'Eri,5,0,36,31
1657839665795,MATH 103A,A03,093561,Greenfeld; Be'Eri,6,0,36,30
1657839665795,MATH 103A,B01,083779,Greenfeld; Be'Eri,7,0,36,29
1657839665795,MATH 103A,B02,083780,Greenfeld; Be'Eri,4,0,36,32
1657839665795,MATH 103A,B03,093562,Greenfeld; Be'Eri,3,0,36,33
1657839671819,MATH 105,A01,085443,Carter; Anne Toulson,15,0,35,20
1657839671819,MATH 105,A02,093477,Carter; Anne Toulson,20,0,35,15
1657839677864,MATH 109,A01,083213,Ganzberger; Geoffrey Michael,3,0,34,31
1657839677864,MATH 109,A02,083214,Ganzberger; Geoffrey Michael,4,0,34,30
1657839677864,MATH 109,A03,093478,Ganzberger; Geoffrey Michael,2,0,34,32
1657839677864,MATH 109,B01,083215,Ganzberger; Geoffrey Michael,1,0,32,31
1657839677864,MATH 109,B02,083216,Ganzberger; Geoffrey Michael,2,0,32,30
1657839677864,MATH 109,B03,093479,Ganzberger; Geoffrey Michael,8,0,32,24
1657839683901,MATH 142A,A01,083219,Chow; Bennett,7,0,32,25
1657839683901,MATH 142A,A02,083220,Chow; Bennett,10,0,32,22
1657839683901,MATH 142A,A03,093480,Chow; Bennett,9,0,32,23
1657839683901,MATH 142A,B03,093481,Chow; Bennett,8,0,32,24
1657839683901,MATH 142A,B04,093558,Chow; Bennett,13,0,32,19
1657839683901,MATH 142A,B05,093559,Chow; Bennett,7,0,32,25
1657839689929,MATH 193A,A01,083224,Rotar; Vladimir,8,0,34,26
1657839689929,MATH 193A,A02,083225,Rotar; Vladimir,10,0,34,24
1657839689929,MATH 193A,A03,083781,Rotar; Vladimir,5,0,34,29
1657839689929,MATH 193A,A04,083782,Rotar; Vladimir,11,0,34,23
1657839689929,MATH 193A,A05,093482,Rotar; Vladimir,10,0,34,24
1657839695964,MATH 197,001,091859,McAuley; Julian John,9999,0,9999,0
1657839695964,MATH 197,002,095566,Kedlaya; Kiran S.,9997,0,9999,2
1657839695964,MATH 197,003,095567,Xiao; Ming,9999,0,9999,0
1657839695964,MATH 197,004,095571,Perols; Johan Lars,9998,0,9999,1
1657839703030,COGS 9,A01,083615,Shannon; Kyle Michael,9,0,75,66
1657839709054,COGS 11,A01,083617,Boyle; Mary E. T.,23,0,48,25
1657839715094,COGS 13,A01,083071,Bastos; Amalia Pinkusfeld,11,0,71,60
1657839721129,COGS 14A,A01,092681,Semenuks; Arturs,5,1,100,95
1657839727151,COGS 14B,A01,083073,Cheng; Tzu-Han,6,0,63,57
1657839733177,COGS 17,A01,092677,Semenuks; Arturs,6,0,81,75
1657839739214,COGS 100,A01,083619,Allen; Michael Gordon,17,0,70,53
1657839745239,COGS 101A,A01,083621,Davis; Joshua Daniel,9,0,68,59
1657839751263,COGS 101B,A01,091572,Allen; Michael Gordon,12,0,65,53
1657839757295,COGS 101C,A01,083625,Delgado; Tania,17,0,35,18
1657839763318,COGS 107A,A01,083627,Boyle; Mary E. T.,14,0,60,46
1657839769352,COGS 118A,A01,083075,Gupta; Anjum,21,0,76,55
1657839775375,CSE 3,A50,083646,Miranda; Gregory Joseph,24,0,50,26
1657839781402,CSE 8A,A50,083650,Miranda; Gregory Joseph,17,1,56,39
1657839787432,CSE 11,A01,083080,Cao; Yingjun,6,15,40,34
1657839793455,CSE 12,A01,083652,Krause-Levy; Sophia Louisa,29,1,120,91
1657839799488,CSE 15L,A01,083654,Morris; Justin Loren,9,0,50,41
1657839799488,CSE 15L,A02,083655,Morris; Justin Loren,9,0,50,41
1657839805514,CSE 20,A01,083657,Tran; Khoa Dang,39,0,80,41
1657839811557,CSE 21,A01,095574,Bach; Quang Tran,22,0,48,26
1657839817591,CSE 30,A01,083084,Eldon; John,6,0,80,74
1657839817591,CSE 30,B01,095061,Bhaskar; Nishant,9,0,50,41
1657839823635,CSE 100,A01,083659,Cao; Yingjun,5,4,70,65
1657839829658,CSE 134B,A01,083661,Powell; Thomas Allan,24,0,100,76
1657839835680,CSE 140,A01,083663,Gungor; Onat,15,0,85,70
1657839841731,CSE 140L,A01,083088,Eldon; John,23,0,100,77
1657839847765,CSE 175,A01,083665,Kumar; Rakesh,3,0,25,22
1657839853791,CSE 190,A00,092507,Dubnov; Shlomo,8,0,20,12
1657839859827,ECE 45,A01,083139,Congero; Spencer William,6,0,75,69
1657839865878,ECE 65,A50,083695,Saad; Andrew S,12,0,30,18
1657839865878,ECE 65,A51,095125,Saad; Andrew S,24,0,26,2
1657839871915,ECE 109,A01,091882,Touri; Behrouz,20,0,70,50
1657839877959,ECE 180,A00,083140,Abi Samra; Nicholas Camill,1,0,30,29
1657839877959,ECE 180,B00,083141,Abi Samra; Nicholas Camill,0,0,30,30
1657839883985,MATH 10A,A01,083735,Patchell; Gregory David,2,0,30,28
1657839883985,MATH 10A,A02,083736,Patchell; Gregory David,20,0,30,10
1657839883985,MATH 10A,A03,083737,Patchell; Gregory David,16,0,30,14
1657839890023,MATH 10B,A01,083207,Lim; Seonhee,8,0,34,26
1657839890023,MATH 10B,A02,083208,Lim; Seonhee,10,0,35,25
1657839890023,MATH 10B,A03,093472,Lim; Seonhee,7,0,34,27
1657839890023,MATH 10B,B01,083739,Sinha; Shubham,14,0,30,16
1657839896048,MATH 18,A01,083743,Cinel; Cameron Alexander,9,0,30,21
1657839896048,MATH 18,A02,083744,Cinel; Cameron Alexander,18,0,30,12
1657839896048,MATH 18,A03,083745,Cinel; Cameron Alexander,10,0,30,20
1657839896048,MATH 18,B01,083748,Rideout; David Porter,5,0,37,32
1657839896048,MATH 18,B02,083749,Rideout; David Porter,5,0,36,31
1657839896048,MATH 18,B03,083750,Rideout; David Porter,3,0,37,34
1657839896048,MATH 18,B04,083751,Rideout; David Porter,6,0,36,30
1657839896048,MATH 18,B05,093473,Rideout; David Porter,6,0,36,30
1657839896048,MATH 18,B06,093474,Rideout; David Porter,6,0,36,30
1657839902076,MATH 20A,A01,083754,Zheng; Zequn,14,0,40,26
1657839908135,MATH 20B,A01,083756,Briones; Jor-el Thomas Caparas,4,0,36,32
1657839908135,MATH 20B,A02,083757,Briones; Jor-el Thomas Caparas,1,0,36,35
1657839908135,MATH 20B,A03,093475,Briones; Jor-el Thomas Caparas,2,0,36,34
1657839914184,MATH 20C,A01,083760,Briones; Jor-el Thomas Caparas,1,0,35,34
1657839914184,MATH 20C,A02,083761,Briones; Jor-el Thomas Caparas,8,0,35,27
1657839914184,MATH 20C,A03,093476,Briones; Jor-el Thomas Caparas,0,1,36,36
1657839914184,MATH 20C,B01,083762,Bach; Quang Tran,1,0,30,29
1657839920211,MATH 20D,A01,083765,Tran; Brian Kha,5,0,30,25
1657839920211,MATH 20D,A02,083766,Tran; Brian Kha,5,0,30,25
1657839920211,MATH 20D,A03,083767,Tran; Brian Kha,5,0,30,25
1657839926237,MATH 20E,A01,083771,Ganguly; Soumya,10,0,32,22
1657839926237,MATH 20E,A02,083772,Ganguly; Soumya,6,0,32,26
1657839926237,MATH 20E,B01,083773,Ciotti; Benjamin,20,0,35,15
1657839926237,MATH 20E,B02,083774,Ciotti; Benjamin,18,0,35,17
1657839932261,MATH 103A,A01,083777,Greenfeld; Be'Eri,3,0,36,33
1657839932261,MATH 103A,A02,083778,Greenfeld; Be'Eri,5,0,36,31
1657839932261,MATH 103A,A03,093561,Greenfeld; Be'Eri,6,0,36,30
1657839932261,MATH 103A,B01,083779,Greenfeld; Be'Eri,7,0,36,29
1657839932261,MATH 103A,B02,083780,Greenfeld; Be'Eri,4,0,36,32
1657839932261,MATH 103A,B03,093562,Greenfeld; Be'Eri,3,0,36,33
1657839938284,MATH 105,A01,085443,Carter; Anne Toulson,15,0,35,20
1657839938284,MATH 105,A02,093477,Carter; Anne Toulson,20,0,35,15
1657839944327,MATH 109,A01,083213,Ganzberger; Geoffrey Michael,3,0,34,31
1657839944327,MATH 109,A02,083214,Ganzberger; Geoffrey Michael,4,0,34,30
1657839944327,MATH 109,A03,093478,Ganzberger; Geoffrey Michael,2,0,34,32
1657839944327,MATH 109,B01,083215,Ganzberger; Geoffrey Michael,1,0,32,31
1657839944327,MATH 109,B02,083216,Ganzberger; Geoffrey Michael,2,0,32,30
1657839944327,MATH 109,B03,093479,Ganzberger; Geoffrey Michael,8,0,32,24
1657839950370,MATH 142A,A01,083219,Chow; Bennett,7,0,32,25
1657839950370,MATH 142A,A02,083220,Chow; Bennett,10,0,32,22
1657839950370,MATH 142A,A03,093480,Chow; Bennett,9,0,32,23
1657839950370,MATH 142A,B03,093481,Chow; Bennett,8,0,32,24
1657839950370,MATH 142A,B04,093558,Chow; Bennett,13,0,32,19
1657839950370,MATH 142A,B05,093559,Chow; Bennett,7,0,32,25
1657839956396,MATH 193A,A01,083224,Rotar; Vladimir,8,0,34,26
1657839956396,MATH 193A,A02,083225,Rotar; Vladimir,10,0,34,24
1657839956396,MATH 193A,A03,083781,Rotar; Vladimir,5,0,34,29
1657839956396,MATH 193A,A04,083782,Rotar; Vladimir,11,0,34,23
1657839956396,MATH 193A,A05,093482,Rotar; Vladimir,10,0,34,24
1657839962421,MATH 197,001,091859,McAuley; Julian John,9999,0,9999,0
1657839962421,MATH 197,002,095566,Kedlaya; Kiran S.,9997,0,9999,2
1657839962421,MATH 197,003,095567,Xiao; Ming,9999,0,9999,0
1657839962421,MATH 197,004,095571,Perols; Johan Lars,9998,0,9999,1
1657839969491,COGS 9,A01,083615,Shannon; Kyle Michael,9,0,75,66
1657839975528,COGS 11,A01,083617,Boyle; Mary E. T.,23,0,48,25
1657839981554,COGS 13,A01,083071,Bastos; Amalia Pinkusfeld,11,0,71,60
1657839987583,COGS 14A,A01,092681,Semenuks; Arturs,5,1,100,95
1657839993626,COGS 14B,A01,083073,Cheng; Tzu-Han,6,0,63,57
1657839999658,COGS 17,A01,092677,Semenuks; Arturs,6,0,81,75
1657840005687,COGS 100,A01,083619,Allen; Michael Gordon,17,0,70,53
1657840011709,COGS 101A,A01,083621,Davis; Joshua Daniel,9,0,68,59
1657840017753,COGS 101B,A01,091572,Allen; Michael Gordon,12,0,65,53
1657840023798,COGS 101C,A01,083625,Delgado; Tania,17,0,35,18
1657840029822,COGS 107A,A01,083627,Boyle; Mary E. T.,14,0,60,46
1657840035861,COGS 118A,A01,083075,Gupta; Anjum,21,0,76,55
1657840041888,CSE 3,A50,083646,Miranda; Gregory Joseph,24,0,50,26
1657840047914,CSE 8A,A50,083650,Miranda; Gregory Joseph,17,1,56,39
1657840053945,CSE 11,A01,083080,Cao; Yingjun,6,15,40,34
1657840059995,CSE 12,A01,083652,Krause-Levy; Sophia Louisa,29,1,120,91
1657840066021,CSE 15L,A01,083654,Morris; Justin Loren,9,0,50,41
1657840066021,CSE 15L,A02,083655,Morris; Justin Loren,9,0,50,41
1657840072070,CSE 20,A01,083657,Tran; Khoa Dang,39,0,80,41
1657840078097,CSE 21,A01,095574,Bach; Quang Tran,22,0,48,26
1657840084130,CSE 30,A01,083084,Eldon; John,6,0,80,74
1657840084130,CSE 30,B01,095061,Bhaskar; Nishant,9,0,50,41
1657840090165,CSE 100,A01,083659,Cao; Yingjun,5,4,70,65
1657840096193,CSE 134B,A01,083661,Powell; Thomas Allan,24,0,100,76
1657840102218,CSE 140,A01,083663,Gungor; Onat,15,0,85,70
1657840108242,CSE 140L,A01,083088,Eldon; John,23,0,100,77
1657840114276,CSE 175,A01,083665,Kumar; Rakesh,3,0,25,22
1657840120302,CSE 190,A00,092507,Dubnov; Shlomo,8,0,20,12
1657840126331,ECE 45,A01,083139,Congero; Spencer William,6,0,75,69
1657840132358,ECE 65,A50,083695,Saad; Andrew S,12,0,30,18
1657840132358,ECE 65,A51,095125,Saad; Andrew S,24,0,26,2
1657840138394,ECE 109,A01,091882,Touri; Behrouz,20,0,70,50
1657840144422,ECE 180,A00,083140,Abi Samra; Nicholas Camill,1,0,30,29
1657840144422,ECE 180,B00,083141,Abi Samra; Nicholas Camill,0,0,30,30
1657840150468,MATH 10A,A01,083735,Patchell; Gregory David,2,0,30,28
1657840150468,MATH 10A,A02,083736,Patchell; Gregory David,20,0,30,10
1657840150468,MATH 10A,A03,083737,Patchell; Gregory David,16,0,30,14
1657840156497,MATH 10B,A01,083207,Lim; Seonhee,8,0,34,26
1657840156497,MATH 10B,A02,083208,Lim; Seonhee,10,0,35,25
1657840156497,MATH 10B,A03,093472,Lim; Seonhee,7,0,34,27
1657840156497,MATH 10B,B01,083739,Sinha; Shubham,14,0,30,16
1657840162530,MATH 18,A01,083743,Cinel; Cameron Alexander,9,0,30,21
1657840162530,MATH 18,A02,083744,Cinel; Cameron Alexander,18,0,30,12
1657840162530,MATH 18,A03,083745,Cinel; Cameron Alexander,10,0,30,20
1657840162530,MATH 18,B01,083748,Rideout; David Porter,5,0,37,32
1657840162530,MATH 18,B02,083749,Rideout; David Porter,5,0,36,31
1657840162530,MATH 18,B03,083750,Rideout; David Porter,3,0,37,34
1657840162530,MATH 18,B04,083751,Rideout; David Porter,6,0,36,30
1657840162530,MATH 18,B05,093473,Rideout; David Porter,6,0,36,30
1657840162530,MATH 18,B06,093474,Rideout; David Porter,6,0,36,30
1657840168554,MATH 20A,A01,083754,Zheng; Zequn,14,0,40,26
1657840174616,MATH 20B,A01,083756,Briones; Jor-el Thomas Caparas,4,0,36,32
1657840174616,MATH 20B,A02,083757,Briones; Jor-el Thomas Caparas,1,0,36,35
1657840174616,MATH 20B,A03,093475,Briones; Jor-el Thomas Caparas,2,0,36,34
1657840180640,MATH 20C,A01,083760,Briones; Jor-el Thomas Caparas,1,0,35,34
1657840180640,MATH 20C,A02,083761,Briones; Jor-el Thomas Caparas,8,0,35,27
1657840180640,MATH 20C,A03,093476,Briones; Jor-el Thomas Caparas,0,1,36,36
1657840180640,MATH 20C,B01,083762,Bach; Quang Tran,1,0,30,29
1657840186697,MATH 20D,A01,083765,Tran; Brian Kha,5,0,30,25
1657840186697,MATH 20D,A02,083766,Tran; Brian Kha,5,0,30,25
1657840186697,MATH 20D,A03,083767,Tran; Brian Kha,5,0,30,25
1657840192719,MATH 20E,A01,083771,Ganguly; Soumya,10,0,32,22
1657840192719,MATH 20E,A02,083772,Ganguly; Soumya,6,0,32,26
1657840192719,MATH 20E,B01,083773,Ciotti; Benjamin,20,0,35,15
1657840192719,MATH 20E,B02,083774,Ciotti; Benjamin,18,0,35,17
1657840198763,MATH 103A,A01,083777,Greenfeld; Be'Eri,3,0,36,33
1657840198763,MATH 103A,A02,083778,Greenfeld; Be'Eri,5,0,36,31
1657840198763,MATH 103A,A03,093561,Greenfeld; Be'Eri,6,0,36,30
1657840198763,MATH 103A,B01,083779,Greenfeld; Be'Eri,7,0,36,29
1657840198763,MATH 103A,B02,083780,Greenfeld; Be'Eri,4,0,36,32
1657840198763,MATH 103A,B03,093562,Greenfeld; Be'Eri,3,0,36,33
1657840204798,MATH 105,A01,085443,Carter; Anne Toulson,15,0,35,20
1657840204798,MATH 105,A02,093477,Carter; Anne Toulson,20,0,35,15
1657840210859,MATH 109,A01,083213,Ganzberger; Geoffrey Michael,3,0,34,31
1657840210859,MATH 109,A02,083214,Ganzberger; Geoffrey Michael,4,0,34,30
1657840210859,MATH 109,A03,093478,Ganzberger; Geoffrey Michael,2,0,34,32
1657840210859,MATH 109,B01,083215,Ganzberger; Geoffrey Michael,1,0,32,31
1657840210859,MATH 109,B02,083216,Ganzberger; Geoffrey Michael,2,0,32,30
1657840210859,MATH 109,B03,093479,Ganzberger; Geoffrey Michael,8,0,32,24
1657840216894,MATH 142A,A01,083219,Chow; Bennett,7,0,32,25
1657840216894,MATH 142A,A02,083220,Chow; Bennett,10,0,32,22
1657840216894,MATH 142A,A03,093480,Chow; Bennett,9,0,32,23
1657840216894,MATH 142A,B03,093481,Chow; Bennett,8,0,32,24
1657840216894,MATH 142A,B04,093558,Chow; Bennett,13,0,32,19
1657840216894,MATH 142A,B05,093559,Chow; Bennett,7,0,32,25
1657840222917,MATH 193A,A01,083224,Rotar; Vladimir,8,0,34,26
1657840222917,MATH 193A,A02,083225,Rotar; Vladimir,10,0,34,24
1657840222917,MATH 193A,A03,083781,Rotar; Vladimir,5,0,34,29
1657840222917,MATH 193A,A04,083782,Rotar; Vladimir,11,0,34,23
1657840222917,MATH 193A,A05,093482,Rotar; Vladimir,10,0,34,24
1657840228967,MATH 197,001,091859,McAuley; Julian John,9999,0,9999,0
1657840228967,MATH 197,002,095566,Kedlaya; Kiran S.,9997,0,9999,2
1657840228967,MATH 197,003,095567,Xiao; Ming,9999,0,9999,0
1657840228967,MATH 197,004,095571,Perols; Johan Lars,9998,0,9999,1
1657840236022,COGS 9,A01,083615,Shannon; Kyle Michael,9,0,75,66
1657840242134,COGS 11,A01,083617,Boyle; Mary E. T.,23,0,48,25
1657840248166,COGS 13,A01,083071,Bastos; Amalia Pinkusfeld,11,0,71,60
1657840254207,COGS 14A,A01,092681,Semenuks; Arturs,5,1,100,95
1657840260234,COGS 14B,A01,083073,Cheng; Tzu-Han,6,0,63,57
1657840266267,COGS 17,A01,092677,Semenuks; Arturs,6,0,81,75
1657840272304,COGS 100,A01,083619,Allen; Michael Gordon,17,0,70,53
1657840278326,COGS 101A,A01,083621,Davis; Joshua Daniel,9,0,68,59
1657840284350,COGS 101B,A01,091572,Allen; Michael Gordon,12,0,65,53
1657840290379,COGS 101C,A01,083625,Delgado; Tania,17,0,35,18
1657840296410,COGS 107A,A01,083627,Boyle; Mary E. T.,14,0,60,46
1657840302447,COGS 118A,A01,083075,Gupta; Anjum,21,0,76,55
1657840308471,CSE 3,A50,083646,Miranda; Gregory Joseph,24,0,50,26
1657840314495,CSE 8A,A50,083650,Miranda; Gregory Joseph,17,1,56,39
1657840320523,CSE 11,A01,083080,Cao; Yingjun,6,15,40,34
1657840326562,CSE 12,A01,083652,Krause-Levy; Sophia Louisa,29,1,120,91
1657840332590,CSE 15L,A01,083654,Morris; Justin Loren,9,0,50,41
1657840332590,CSE 15L,A02,083655,Morris; Justin Loren,9,0,50,41
1657840338616,CSE 20,A01,083657,Tran; Khoa Dang,39,0,80,41
1657840344658,CSE 21,A01,095574,Bach; Quang Tran,22,0,48,26
1657840350680,CSE 30,A01,083084,Eldon; John,6,0,80,74
1657840350680,CSE 30,B01,095061,Bhaskar; Nishant,9,0,50,41
1657840356703,CSE 100,A01,083659,Cao; Yingjun,5,4,70,65
1657840362729,CSE 134B,A01,083661,Powell; Thomas Allan,24,0,100,76
1657840368751,CSE 140,A01,083663,Gungor; Onat,15,0,85,70
1657840374777,CSE 140L,A01,083088,Eldon; John,23,0,100,77
1657840380813,CSE 175,A01,083665,Kumar; Rakesh,3,0,25,22
1657840386835,CSE 190,A00,092507,Dubnov; Shlomo,8,0,20,12
1657840392862,ECE 45,A01,083139,Congero; Spencer William,6,0,75,69
1657840398890,ECE 65,A50,083695,Saad; Andrew S,12,0,30,18
1657840398890,ECE 65,A51,095125,Saad; Andrew S,24,0,26,2
1657840404926,ECE 109,A01,091882,Touri; Behrouz,20,0,70,50
1657840410969,ECE 180,A00,083140,Abi Samra; Nicholas Camill,1,0,30,29
1657840410969,ECE 180,B00,083141,Abi Samra; Nicholas Camill,0,0,30,30
1657840417015,MATH 10A,A01,083735,Patchell; Gregory David,2,0,30,28
1657840417015,MATH 10A,A02,083736,Patchell; Gregory David,20,0,30,10
1657840417015,MATH 10A,A03,083737,Patchell; Gregory David,16,0,30,14
1657840423044,MATH 10B,A01,083207,Lim; Seonhee,8,0,34,26
1657840423044,MATH 10B,A02,083208,Lim; Seonhee,10,0,35,25
1657840423044,MATH 10B,A03,093472,Lim; Seonhee,7,0,34,27
1657840423044,MATH 10B,B01,083739,Sinha; Shubham,14,0,30,16
1657840429069,MATH 18,A01,083743,Cinel; Cameron Alexander,9,0,30,21
1657840429069,MATH 18,A02,083744,Cinel; Cameron Alexander,18,0,30,12
1657840429069,MATH 18,A03,083745,Cinel; Cameron Alexander,10,0,30,20
1657840429069,MATH 18,B01,083748,Rideout; David Porter,5,0,37,32
1657840429069,MATH 18,B02,083749,Rideout; David Porter,5,0,36,31
1657840429069,MATH 18,B03,083750,Rideout; David Porter,3,0,37,34
1657840429069,MATH 18,B04,083751,Rideout; David Porter,6,0,36,30
1657840429069,MATH 18,B05,093473,Rideout; David Porter,6,0,36,30
1657840429069,MATH 18,B06,093474,Rideout; David Porter,6,0,36,30
1657840435091,MATH 20A,A01,083754,Zheng; Zequn,14,0,40,26
1657840441114,MATH 20B,A01,083756,Briones; Jor-el Thomas Caparas,4,0,36,32
1657840441114,MATH 20B,A02,083757,Briones; Jor-el Thomas Caparas,1,0,36,35
1657840441114,MATH 20B,A03,093475,Briones; Jor-el Thomas Caparas,2,0,36,34
1657840447144,MATH 20C,A01,083760,Briones; Jor-el Thomas Caparas,1,0,35,34
1657840447144,MATH 20C,A02,083761,Briones; Jor-el Thomas Caparas,8,0,35,27
1657840447144,MATH 20C,A03,093476,Briones; Jor-el Thomas Caparas,0,1,36,36
1657840447144,MATH 20C,B01,083762,Bach; Quang Tran,1,0,30,29
1657840453168,MATH 20D,A01,083765,Tran; Brian Kha,5,0,30,25
1657840453168,MATH 20D,A02,083766,Tran; Brian Kha,5,0,30,25
1657840453168,MATH 20D,A03,083767,Tran; Brian Kha,5,0,30,25
1657840459202,MATH 20E,A01,083771,Ganguly; Soumya,10,0,32,22
1657840459202,MATH 20E,A02,083772,Ganguly; Soumya,6,0,32,26
1657840459202,MATH 20E,B01,083773,Ciotti; Benjamin,20,0,35,15
1657840459202,MATH 20E,B02,083774,Ciotti; Benjamin,18,0,35,17
1657840465245,MATH 103A,A01,083777,Greenfeld; Be'Eri,3,0,36,33
1657840465245,MATH 103A,A02,083778,Greenfeld; Be'Eri,5,0,36,31
1657840465245,MATH 103A,A03,093561,Greenfeld; Be'Eri,6,0,36,30
1657840465245,MATH 103A,B01,083779,Greenfeld; Be'Eri,7,0,36,29
1657840465245,MATH 103A,B02,083780,Greenfeld; Be'Eri,4,0,36,32
1657840465245,MATH 103A,B03,093562,Greenfeld; Be'Eri,3,0,36,33
1657840471269,MATH 105,A01,085443,Carter; Anne Toulson,15,0,35,20
1657840471269,MATH 105,A02,093477,Carter; Anne Toulson,20,0,35,15
1657840477294,MATH 109,A01,083213,Ganzberger; Geoffrey Michael,3,0,34,31
1657840477294,MATH 109,A02,083214,Ganzberger; Geoffrey Michael,4,0,34,30
1657840477294,MATH 109,A03,093478,Ganzberger; Geoffrey Michael,2,0,34,32
1657840477294,MATH 109,B01,083215,Ganzberger; Geoffrey Michael,1,0,32,31
1657840477294,MATH 109,B02,083216,Ganzberger; Geoffrey Michael,2,0,32,30
1657840477294,MATH 109,B03,093479,Ganzberger; Geoffrey Michael,8,0,32,24
1657840483324,MATH 142A,A01,083219,Chow; Bennett,7,0,32,25
1657840483324,MATH 142A,A02,083220,Chow; Bennett,10,0,32,22
1657840483324,MATH 142A,A03,093480,Chow; Bennett,9,0,32,23
1657840483324,MATH 142A,B03,093481,Chow; Bennett,8,0,32,24
1657840483324,MATH 142A,B04,093558,Chow; Bennett,13,0,32,19
1657840483324,MATH 142A,B05,093559,Chow; Bennett,7,0,32,25
1657840489374,MATH 193A,A01,083224,Rotar; Vladimir,8,0,34,26
1657840489374,MATH 193A,A02,083225,Rotar; Vladimir,10,0,34,24
1657840489374,MATH 193A,A03,083781,Rotar; Vladimir,5,0,34,29
1657840489374,MATH 193A,A04,083782,Rotar; Vladimir,11,0,34,23
1657840489374,MATH 193A,A05,093482,Rotar; Vladimir,10,0,34,24
1657840495397,MATH 197,001,091859,McAuley; Julian John,9999,0,9999,0
1657840495397,MATH 197,002,095566,Kedlaya; Kiran S.,9997,0,9999,2
1657840495397,MATH 197,003,095567,Xiao; Ming,9999,0,9999,0
1657840495397,MATH 197,004,095571,Perols; Johan Lars,9998,0,9999,1
1657840502457,COGS 9,A01,083615,Shannon; Kyle Michael,9,0,75,66
1657840508485,COGS 11,A01,083617,Boyle; Mary E. T.,23,0,48,25
1657840514518,COGS 13,A01,083071,Bastos; Amalia Pinkusfeld,11,0,71,60
1657840520541,COGS 14A,A01,092681,Semenuks; Arturs,5,1,100,95
1657840526562,COGS 14B,A01,083073,Cheng; Tzu-Han,6,0,63,57
1657840532585,COGS 17,A01,092677,Semenuks; Arturs,6,0,81,75
1657840538620,COGS 100,A01,083619,Allen; Michael Gordon,17,0,70,53
1657840544653,COGS 101A,A01,083621,Davis; Joshua Daniel,9,0,68,59
1657840550680,COGS 101B,A01,091572,Allen; Michael Gordon,12,0,65,53
1657840556704,COGS 101C,A01,083625,Delgado; Tania,17,0,35,18
1657840562726,COGS 107A,A01,083627,Boyle; Mary E. T.,14,0,60,46
1657840568762,COGS 118A,A01,083075,Gupta; Anjum,21,0,76,55
1657840574788,CSE 3,A50,083646,Miranda; Gregory Joseph,24,0,50,26
1657840580811,CSE 8A,A50,083650,Miranda; Gregory Joseph,17,1,56,39
1657840586834,CSE 11,A01,083080,Cao; Yingjun,6,15,40,34
1657840592858,CSE 12,A01,083652,Krause-Levy; Sophia Louisa,29,1,120,91
1657840598906,CSE 15L,A01,083654,Morris; Justin Loren,9,0,50,41
1657840598906,CSE 15L,A02,083655,Morris; Justin Loren,9,0,50,41
1657840604932,CSE 20,A01,083657,Tran; Khoa Dang,39,0,80,41
1657840610955,CSE 21,A01,095574,Bach; Quang Tran,22,0,48,26
1657840616981,CSE 30,A01,083084,Eldon; John,6,0,80,74
1657840616981,CSE 30,B01,095061,Bhaskar; Nishant,9,0,50,41
1657840623007,CSE 100,A01,083659,Cao; Yingjun,5,4,70,65
1657840629029,CSE 134B,A01,083661,Powell; Thomas Allan,24,0,100,76
1657840635055,CSE 140,A01,083663,Gungor; Onat,15,0,85,70
1657840641078,CSE 140L,A01,083088,Eldon; John,23,0,100,77
1657840647100,CSE 175,A01,083665,Kumar; Rakesh,3,0,25,22
1657840653133,CSE 190,A00,092507,Dubnov; Shlomo,8,0,20,12
1657840659155,ECE 45,A01,083139,Congero; Spencer William,6,0,75,69
1657840665186,ECE 65,A50,083695,Saad; Andrew S,12,0,30,18
1657840665186,ECE 65,A51,095125,Saad; Andrew S,24,0,26,2
1657840671211,ECE 109,A01,091882,Touri; Behrouz,20,0,70,50
1657840677236,ECE 180,A00,083140,Abi Samra; Nicholas Camill,1,0,30,29
1657840677236,ECE 180,B00,083141,Abi Samra; Nicholas Camill,0,0,30,30
1657840683263,MATH 10A,A01,083735,Patchell; Gregory David,2,0,30,28
1657840683263,MATH 10A,A02,083736,Patchell; Gregory David,20,0,30,10
1657840683263,MATH 10A,A03,083737,Patchell; Gregory David,16,0,30,14
1657840689288,MATH 10B,A01,083207,Lim; Seonhee,8,0,34,26
1657840689288,MATH 10B,A02,083208,Lim; Seonhee,10,0,35,25
1657840689288,MATH 10B,A03,093472,Lim; Seonhee,7,0,34,27
1657840689288,MATH 10B,B01,083739,Sinha; Shubham,14,0,30,16
1657840695325,MATH 18,A01,083743,Cinel; Cameron Alexander,9,0,30,21
1657840695325,MATH 18,A02,083744,Cinel; Cameron Alexander,18,0,30,12
1657840695325,MATH 18,A03,083745,Cinel; Cameron Alexander,10,0,30,20
1657840695325,MATH 18,B01,083748,Rideout; David Porter,5,0,37,32
1657840695325,MATH 18,B02,083749,Rideout; David Porter,5,0,36,31
1657840695325,MATH 18,B03,083750,Rideout; David Porter,3,0,37,34
1657840695325,MATH 18,B04,083751,Rideout; David Porter,6,0,36,30
1657840695325,MATH 18,B05,093473,Rideout; David Porter,6,0,36,30
1657840695325,MATH 18,B06,093474,Rideout; David Porter,6,0,36,30
1657840701349,MATH 20A,A01,083754,Zheng; Zequn,14,0,40,26
1657840707375,MATH 20B,A01,083756,Briones; Jor-el Thomas Caparas,4,0,36,32
1657840707375,MATH 20B,A02,083757,Briones; Jor-el Thomas Caparas,1,0,36,35
1657840707375,MATH 20B,A03,093475,Briones; Jor-el Thomas Caparas,2,0,36,34
1657840713404,MATH 20C,A01,083760,Briones; Jor-el Thomas Caparas,1,0,35,34
1657840713404,MATH 20C,A02,083761,Briones; Jor-el Thomas Caparas,8,0,35,27
1657840713404,MATH 20C,A03,093476,Briones; Jor-el Thomas Caparas,0,1,36,36
1657840713404,MATH 20C,B01,083762,Bach; Quang Tran,1,0,30,29
1657840719454,MATH 20D,A01,083765,Tran; Brian Kha,5,0,30,25
1657840719454,MATH 20D,A02,083766,Tran; Brian Kha,5,0,30,25
1657840719454,MATH 20D,A03,083767,Tran; Brian Kha,5,0,30,25
1657840725482,MATH 20E,A01,083771,Ganguly; Soumya,10,0,32,22
1657840725482,MATH 20E,A02,083772,Ganguly; Soumya,6,0,32,26
1657840725482,MATH 20E,B01,083773,Ciotti; Benjamin,20,0,35,15
1657840725482,MATH 20E,B02,083774,Ciotti; Benjamin,18,0,35,17
1657840731505,MATH 103A,A01,083777,Greenfeld; Be'Eri,3,0,36,33
1657840731505,MATH 103A,A02,083778,Greenfeld; Be'Eri,5,0,36,31
1657840731505,MATH 103A,A03,093561,Greenfeld; Be'Eri,6,0,36,30
1657840731505,MATH 103A,B01,083779,Greenfeld; Be'Eri,7,0,36,29
1657840731505,MATH 103A,B02,083780,Greenfeld; Be'Eri,4,0,36,32
1657840731505,MATH 103A,B03,093562,Greenfeld; Be'Eri,3,0,36,33
1657840737551,MATH 105,A01,085443,Carter; Anne Toulson,15,0,35,20
1657840737551,MATH 105,A02,093477,Carter; Anne Toulson,20,0,35,15
1657840743574,MATH 109,A01,083213,Ganzberger; Geoffrey Michael,3,0,34,31
1657840743574,MATH 109,A02,083214,Ganzberger; Geoffrey Michael,4,0,34,30
1657840743574,MATH 109,A03,093478,Ganzberger; Geoffrey Michael,2,0,34,32
1657840743574,MATH 109,B01,083215,Ganzberger; Geoffrey Michael,1,0,32,31
1657840743574,MATH 109,B02,083216,Ganzberger; Geoffrey Michael,2,0,32,30
1657840743574,MATH 109,B03,093479,Ganzberger; Geoffrey Michael,8,0,32,24
1657840749602,MATH 142A,A01,083219,Chow; Bennett,7,0,32,25
1657840749602,MATH 142A,A02,083220,Chow; Bennett,10,0,32,22
1657840749602,MATH 142A,A03,093480,Chow; Bennett,9,0,32,23
1657840749602,MATH 142A,B03,093481,Chow; Bennett,8,0,32,24
1657840749602,MATH 142A,B04,093558,Chow; Bennett,13,0,32,19
1657840749602,MATH 142A,B05,093559,Chow; Bennett,7,0,32,25
1657840755674,MATH 193A,A01,083224,Rotar; Vladimir,8,0,34,26
1657840755674,MATH 193A,A02,083225,Rotar; Vladimir,10,0,34,24
1657840755674,MATH 193A,A03,083781,Rotar; Vladimir,5,0,34,29
1657840755674,MATH 193A,A04,083782,Rotar; Vladimir,11,0,34,23
1657840755674,MATH 193A,A05,093482,Rotar; Vladimir,10,0,34,24
1657840761699,MATH 197,001,091859,McAuley; Julian John,9999,0,9999,0
1657840761699,MATH 197,002,095566,Kedlaya; Kiran S.,9997,0,9999,2
1657840761699,MATH 197,003,095567,Xiao; Ming,9999,0,9999,0
1657840761699,MATH 197,004,095571,Perols; Johan Lars,9998,0,9999,1
1657840768776,COGS 9,A01,083615,Shannon; Kyle Michael,9,0,75,66
1657840774803,COGS 11,A01,083617,Boyle; Mary E. T.,23,0,48,25
1657840780830,COGS 13,A01,083071,Bastos; Amalia Pinkusfeld,11,0,71,60
1657840786853,COGS 14A,A01,092681,Semenuks; Arturs,5,1,100,95
1657840792909,COGS 14B,A01,083073,Cheng; Tzu-Han,6,0,63,57
1657840798932,COGS 17,A01,092677,Semenuks; Arturs,6,0,81,75
1657840804955,COGS 100,A01,083619,Allen; Michael Gordon,17,0,70,53
1657840811003,COGS 101A,A01,083621,Davis; Joshua Daniel,9,0,68,59
1657840817036,COGS 101B,A01,091572,Allen; Michael Gordon,12,0,65,53
1657840823080,COGS 101C,A01,083625,Delgado; Tania,17,0,35,18
1657840829103,COGS 107A,A01,083627,Boyle; Mary E. T.,14,0,60,46
1657840835130,COGS 118A,A01,083075,Gupta; Anjum,21,0,76,55
1657840841231,CSE 3,A50,083646,Miranda; Gregory Joseph,24,0,50,26
1657840847258,CSE 8A,A50,083650,Miranda; Gregory Joseph,17,1,56,39
1657840853297,CSE 11,A01,083080,Cao; Yingjun,6,15,40,34
1657840859319,CSE 12,A01,083652,Krause-Levy; Sophia Louisa,29,1,120,91
1657840865346,CSE 15L,A01,083654,Morris; Justin Loren,9,0,50,41
1657840865346,CSE 15L,A02,083655,Morris; Justin Loren,9,0,50,41
1657840871373,CSE 20,A01,083657,Tran; Khoa Dang,39,0,80,41
1657840877412,CSE 21,A01,095574,Bach; Quang Tran,22,0,48,26
1657840883440,CSE 30,A01,083084,Eldon; John,6,0,80,74
1657840883440,CSE 30,B01,095061,Bhaskar; Nishant,9,0,50,41
1657840889467,CSE 100,A01,083659,Cao; Yingjun,5,4,70,65
1657840895491,CSE 134B,A01,083661,Powell; Thomas Allan,24,0,100,76
1657840901517,CSE 140,A01,083663,Gungor; Onat,15,0,85,70
1657840907545,CSE 140L,A01,083088,Eldon; John,23,0,100,77
1657840913568,CSE 175,A01,083665,Kumar; Rakesh,3,0,25,22
1657840919592,CSE 190,A00,092507,Dubnov; Shlomo,8,0,20,12
1657840925637,ECE 45,A01,083139,Congero; Spencer William,6,0,75,69
1657840931661,ECE 65,A50,083695,Saad; Andrew S,12,0,30,18
1657840931661,ECE 65,A51,095125,Saad; Andrew S,24,0,26,2
1657840937688,ECE 109,A01,091882,Touri; Behrouz,20,0,70,50
1657840943712,ECE 180,A00,083140,Abi Samra; Nicholas Camill,1,0,30,29
1657840943712,ECE 180,B00,083141,Abi Samra; Nicholas Camill,0,0,30,30
1657840949738,MATH 10A,A01,083735,Patchell; Gregory David,2,0,30,28
1657840949738,MATH 10A,A02,083736,Patchell; Gregory David,20,0,30,10
1657840949738,MATH 10A,A03,083737,Patchell; Gregory David,16,0,30,14
1657840955765,MATH 10B,A01,083207,Lim; Seonhee,8,0,34,26
1657840955765,MATH 10B,A02,083208,Lim; Seonhee,10,0,35,25
1657840955765,MATH 10B,A03,093472,Lim; Seonhee,7,0,34,27
1657840955765,MATH 10B,B01,083739,Sinha; Shubham,14,0,30,16
1657840961790,MATH 18,A01,083743,Cinel; Cameron Alexander,9,0,30,21
1657840961790,MATH 18,A02,083744,Cinel; Cameron Alexander,18,0,30,12
1657840961790,MATH 18,A03,083745,Cinel; Cameron Alexander,10,0,30,20
1657840961790,MATH 18,B01,083748,Rideout; David Porter,5,0,37,32
1657840961790,MATH 18,B02,083749,Rideout; David Porter,5,0,36,31
1657840961790,MATH 18,B03,083750,Rideout; David Porter,3,0,37,34
1657840961790,MATH 18,B04,083751,Rideout; David Porter,6,0,36,30
1657840961790,MATH 18,B05,093473,Rideout; David Porter,6,0,36,30
1657840961790,MATH 18,B06,093474,Rideout; David Porter,6,0,36,30
1657840967842,MATH 20A,A01,083754,Zheng; Zequn,14,0,40,26
1657840973872,MATH 20B,A01,083756,Briones; Jor-el Thomas Caparas,4,0,36,32
1657840973872,MATH 20B,A02,083757,Briones; Jor-el Thomas Caparas,1,0,36,35
1657840973872,MATH 20B,A03,093475,Briones; Jor-el Thomas Caparas,2,0,36,34
1657840979895,MATH 20C,A01,083760,Briones; Jor-el Thomas Caparas,1,0,35,34
1657840979895,MATH 20C,A02,083761,Briones; Jor-el Thomas Caparas,8,0,35,27
1657840979895,MATH 20C,A03,093476,Briones; Jor-el Thomas Caparas,0,1,36,36
1657840979895,MATH 20C,B01,083762,Bach; Quang Tran,1,0,30,29
1657840985925,MATH 20D,A01,083765,Tran; Brian Kha,5,0,30,25
1657840985925,MATH 20D,A02,083766,Tran; Brian Kha,5,0,30,25
1657840985925,MATH 20D,A03,083767,Tran; Brian Kha,5,0,30,25
1657840991956,MATH 20E,A01,083771,Ganguly; Soumya,10,0,32,22
1657840991956,MATH 20E,A02,083772,Ganguly; Soumya,6,0,32,26
1657840991956,MATH 20E,B01,083773,Ciotti; Benjamin,20,0,35,15
1657840991956,MATH 20E,B02,083774,Ciotti; Benjamin,18,0,35,17
1657840997984,MATH 103A,A01,083777,Greenfeld; Be'Eri,3,0,36,33
1657840997984,MATH 103A,A02,083778,Greenfeld; Be'Eri,5,0,36,31
1657840997984,MATH 103A,A03,093561,Greenfeld; Be'Eri,6,0,36,30
1657840997984,MATH 103A,B01,083779,Greenfeld; Be'Eri,7,0,36,29
1657840997984,MATH 103A,B02,083780,Greenfeld; Be'Eri,4,0,36,32
1657840997984,MATH 103A,B03,093562,Greenfeld; Be'Eri,3,0,36,33
1657841004011,MATH 105,A01,085443,Carter; Anne Toulson,15,0,35,20
1657841004011,MATH 105,A02,093477,Carter; Anne Toulson,20,0,35,15
1657841010042,MATH 109,A01,083213,Ganzberger; Geoffrey Michael,3,0,34,31
1657841010042,MATH 109,A02,083214,Ganzberger; Geoffrey Michael,4,0,34,30
1657841010042,MATH 109,A03,093478,Ganzberger; Geoffrey Michael,2,0,34,32
1657841010042,MATH 109,B01,083215,Ganzberger; Geoffrey Michael,1,0,32,31
1657841010042,MATH 109,B02,083216,Ganzberger; Geoffrey Michael,2,0,32,30
1657841010042,MATH 109,B03,093479,Ganzberger; Geoffrey Michael,8,0,32,24
1657841016066,MATH 142A,A01,083219,Chow; Bennett,7,0,32,25
1657841016066,MATH 142A,A02,083220,Chow; Bennett,10,0,32,22
1657841016066,MATH 142A,A03,093480,Chow; Bennett,9,0,32,23
1657841016066,MATH 142A,B03,093481,Chow; Bennett,8,0,32,24
1657841016066,MATH 142A,B04,093558,Chow; Bennett,13,0,32,19
1657841016066,MATH 142A,B05,093559,Chow; Bennett,7,0,32,25
1657841022093,MATH 193A,A01,083224,Rotar; Vladimir,8,0,34,26
1657841022093,MATH 193A,A02,083225,Rotar; Vladimir,10,0,34,24
1657841022093,MATH 193A,A03,083781,Rotar; Vladimir,5,0,34,29
1657841022093,MATH 193A,A04,083782,Rotar; Vladimir,11,0,34,23
1657841022093,MATH 193A,A05,093482,Rotar; Vladimir,10,0,34,24
1657841028125,MATH 197,001,091859,McAuley; Julian John,9999,0,9999,0
1657841028125,MATH 197,002,095566,Kedlaya; Kiran S.,9997,0,9999,2
1657841028125,MATH 197,003,095567,Xiao; Ming,9999,0,9999,0
1657841028125,MATH 197,004,095571,Perols; Johan Lars,9998,0,9999,1
1657841035195,COGS 9,A01,083615,Shannon; Kyle Michael,9,0,75,66
1657841041220,COGS 11,A01,083617,Boyle; Mary E. T.,23,0,48,25
1657841047264,COGS 13,A01,083071,Bastos; Amalia Pinkusfeld,11,0,71,60
1657841053291,COGS 14A,A01,092681,Semenuks; Arturs,5,1,100,95
1657841059314,COGS 14B,A01,083073,Cheng; Tzu-Han,6,0,63,57
1657841065339,COGS 17,A01,092677,Semenuks; Arturs,6,0,81,75
1657841071365,COGS 100,A01,083619,Allen; Michael Gordon,17,0,70,53
1657841077389,COGS 101A,A01,083621,Davis; Joshua Daniel,9,0,68,59
1657841083418,COGS 101B,A01,091572,Allen; Michael Gordon,12,0,65,53
1657841089442,COGS 101C,A01,083625,Delgado; Tania,17,0,35,18
1657841095466,COGS 107A,A01,083627,Boyle; Mary E. T.,14,0,60,46
1657841102250,COGS 118A,A01,083075,Gupta; Anjum,21,0,76,55
1657841108279,CSE 3,A50,083646,Miranda; Gregory Joseph,24,0,50,26
1657841114318,CSE 8A,A50,083650,Miranda; Gregory Joseph,17,1,56,39
1657841120344,CSE 11,A01,083080,Cao; Yingjun,6,15,40,34
1657841126368,CSE 12,A01,083652,Krause-Levy; Sophia Louisa,29,1,120,91
1657841132392,CSE 15L,A01,083654,Morris; Justin Loren,9,0,50,41
1657841132392,CSE 15L,A02,083655,Morris; Justin Loren,9,0,50,41
1657841138422,CSE 20,A01,083657,Tran; Khoa Dang,39,0,80,41
1657841144461,CSE 21,A01,095574,Bach; Quang Tran,22,0,48,26
1657841150485,CSE 30,A01,083084,Eldon; John,6,0,80,74
1657841150485,CSE 30,B01,095061,Bhaskar; Nishant,9,0,50,41
1657841156522,CSE 100,A01,083659,Cao; Yingjun,5,4,70,65
1657841162545,CSE 134B,A01,083661,Powell; Thomas Allan,24,0,100,76
1657841168585,CSE 140,A01,083663,Gungor; Onat,15,0,85,70
1657841174608,CSE 140L,A01,083088,Eldon; John,23,0,100,77
1657841180635,CSE 175,A01,083665,Kumar; Rakesh,3,0,25,22
1657841186660,CSE 190,A00,092507,Dubnov; Shlomo,8,0,20,12
1657841192699,ECE 45,A01,083139,Congero; Spencer William,6,0,75,69
1657841198727,ECE 65,A50,083695,Saad; Andrew S,12,0,30,18
1657841198727,ECE 65,A51,095125,Saad; Andrew S,24,0,26,2
1657841204749,ECE 109,A01,091882,Touri; Behrouz,20,0,70,50
1657841210779,ECE 180,A00,083140,Abi Samra; Nicholas Camill,1,0,30,29
1657841210779,ECE 180,B00,083141,Abi Samra; Nicholas Camill,0,0,30,30
1657841216822,MATH 10A,A01,083735,Patchell; Gregory David,2,0,30,28
1657841216822,MATH 10A,A02,083736,Patchell; Gregory David,20,0,30,10
1657841216822,MATH 10A,A03,083737,Patchell; Gregory David,16,0,30,14
1657841222851,MATH 10B,A01,083207,Lim; Seonhee,8,0,34,26
1657841222851,MATH 10B,A02,083208,Lim; Seonhee,10,0,35,25
1657841222851,MATH 10B,A03,093472,Lim; Seonhee,7,0,34,27
1657841222851,MATH 10B,B01,083739,Sinha; Shubham,14,0,30,16
1657841228874,MATH 18,A01,083743,Cinel; Cameron Alexander,9,0,30,21
1657841228874,MATH 18,A02,083744,Cinel; Cameron Alexander,18,0,30,12
1657841228874,MATH 18,A03,083745,Cinel; Cameron Alexander,10,0,30,20
1657841228874,MATH 18,B01,083748,Rideout; David Porter,5,0,37,32
1657841228874,MATH 18,B02,083749,Rideout; David Porter,5,0,36,31
1657841228874,MATH 18,B03,083750,Rideout; David Porter,3,0,37,34
1657841228874,MATH 18,B04,083751,Rideout; David Porter,6,0,36,30
1657841228874,MATH 18,B05,093473,Rideout; David Porter,6,0,36,30
1657841228874,MATH 18,B06,093474,Rideout; David Porter,6,0,36,30
1657841234905,MATH 20A,A01,083754,Zheng; Zequn,14,0,40,26
1657841240929,MATH 20B,A01,083756,Briones; Jor-el Thomas Caparas,4,0,36,32
1657841240929,MATH 20B,A02,083757,Briones; Jor-el Thomas Caparas,1,0,36,35
1657841240929,MATH 20B,A03,093475,Briones; Jor-el Thomas Caparas,2,0,36,34
1657841246953,MATH 20C,A01,083760,Briones; Jor-el Thomas Caparas,1,0,35,34
1657841246953,MATH 20C,A02,083761,Briones; Jor-el Thomas Caparas,8,0,35,27
1657841246953,MATH 20C,A03,093476,Briones; Jor-el Thomas Caparas,0,1,36,36
1657841246953,MATH 20C,B01,083762,Bach; Quang Tran,1,0,30,29
1657841252984,MATH 20D,A01,083765,Tran; Brian Kha,5,0,30,25
1657841252984,MATH 20D,A02,083766,Tran; Brian Kha,5,0,30,25
1657841252984,MATH 20D,A03,083767,Tran; Brian Kha,5,0,30,25
1657841259013,MATH 20E,A01,083771,Ganguly; Soumya,10,0,32,22
1657841259013,MATH 20E,A02,083772,Ganguly; Soumya,6,0,32,26
1657841259013,MATH 20E,B01,083773,Ciotti; Benjamin,20,0,35,15
1657841259013,MATH 20E,B02,083774,Ciotti; Benjamin,18,0,35,17
1657841265037,MATH 103A,A01,083777,Greenfeld; Be'Eri,3,0,36,33
1657841265037,MATH 103A,A02,083778,Greenfeld; Be'Eri,5,0,36,31
1657841265037,MATH 103A,A03,093561,Greenfeld; Be'Eri,6,0,36,30
1657841265037,MATH 103A,B01,083779,Greenfeld; Be'Eri,7,0,36,29
1657841265037,MATH 103A,B02,083780,Greenfeld; Be'Eri,4,0,36,32
1657841265037,MATH 103A,B03,093562,Greenfeld; Be'Eri,3,0,36,33
1657841271087,MATH 105,A01,085443,Carter; Anne Toulson,15,0,35,20
1657841271087,MATH 105,A02,093477,Carter; Anne Toulson,20,0,35,15
1657841277113,MATH 109,A01,083213,Ganzberger; Geoffrey Michael,3,0,34,31
1657841277113,MATH 109,A02,083214,Ganzberger; Geoffrey Michael,4,0,34,30
1657841277113,MATH 109,A03,093478,Ganzberger; Geoffrey Michael,2,0,34,32
1657841277113,MATH 109,B01,083215,Ganzberger; Geoffrey Michael,1,0,32,31
1657841277113,MATH 109,B02,083216,Ganzberger; Geoffrey Michael,2,0,32,30
1657841277113,MATH 109,B03,093479,Ganzberger; Geoffrey Michael,8,0,32,24
1657841283144,MATH 142A,A01,083219,Chow; Bennett,7,0,32,25
1657841283144,MATH 142A,A02,083220,Chow; Bennett,10,0,32,22
1657841283144,MATH 142A,A03,093480,Chow; Bennett,9,0,32,23
1657841283144,MATH 142A,B03,093481,Chow; Bennett,8,0,32,24
1657841283144,MATH 142A,B04,093558,Chow; Bennett,13,0,32,19
1657841283144,MATH 142A,B05,093559,Chow; Bennett,7,0,32,25
1657841289189,MATH 193A,A01,083224,Rotar; Vladimir,8,0,34,26
1657841289189,MATH 193A,A02,083225,Rotar; Vladimir,10,0,34,24
1657841289189,MATH 193A,A03,083781,Rotar; Vladimir,5,0,34,29
1657841289189,MATH 193A,A04,083782,Rotar; Vladimir,11,0,34,23
1657841289189,MATH 193A,A05,093482,Rotar; Vladimir,10,0,34,24
1657841295214,MATH 197,001,091859,McAuley; Julian John,9999,0,9999,0
1657841295214,MATH 197,002,095566,Kedlaya; Kiran S.,9997,0,9999,2
1657841295214,MATH 197,003,095567,Xiao; Ming,9999,0,9999,0
1657841295214,MATH 197,004,095571,Perols; Johan Lars,9998,0,9999,1
1657841302288,COGS 9,A01,083615,Shannon; Kyle Michael,9,0,75,66
1657841308317,COGS 11,A01,083617,Boyle; Mary E. T.,23,0,48,25
1657841314356,COGS 13,A01,083071,Bastos; Amalia Pinkusfeld,11,0,71,60
1657841320378,COGS 14A,A01,092681,Semenuks; Arturs,5,1,100,95
1657841326402,COGS 14B,A01,083073,Cheng; Tzu-Han,6,0,63,57
1657841332439,COGS 17,A01,092677,Semenuks; Arturs,6,0,81,75
1657841338488,COGS 100,A01,083619,Allen; Michael Gordon,17,0,70,53
1657841344516,COGS 101A,A01,083621,Davis; Joshua Daniel,9,0,68,59
1657841350544,COGS 101B,A01,091572,Allen; Michael Gordon,12,0,65,53
1657841356568,COGS 101C,A01,083625,Delgado; Tania,17,0,35,18
1657841362600,COGS 107A,A01,083627,Boyle; Mary E. T.,14,0,60,46
1657841368630,COGS 118A,A01,083075,Gupta; Anjum,21,0,76,55
1657841374654,CSE 3,A50,083646,Miranda; Gregory Joseph,24,0,50,26
1657841380680,CSE 8A,A50,083650,Miranda; Gregory Joseph,17,1,56,39
1657841386705,CSE 11,A01,083080,Cao; Yingjun,6,15,40,34
1657841392731,CSE 12,A01,083652,Krause-Levy; Sophia Louisa,29,1,120,91
1657841398754,CSE 15L,A01,083654,Morris; Justin Loren,9,0,50,41
1657841398754,CSE 15L,A02,083655,Morris; Justin Loren,9,0,50,41
1657841404778,CSE 20,A01,083657,Tran; Khoa Dang,39,0,80,41
1657841410800,CSE 21,A01,095574,Bach; Quang Tran,22,0,48,26
1657841416844,CSE 30,A01,083084,Eldon; John,6,0,80,74
1657841416844,CSE 30,B01,095061,Bhaskar; Nishant,9,0,50,41
1657841422873,CSE 100,A01,083659,Cao; Yingjun,5,4,70,65
1657841428900,CSE 134B,A01,083661,Powell; Thomas Allan,24,0,100,76
1657841434927,CSE 140,A01,083663,Gungor; Onat,15,0,85,70
1657841441040,CSE 140L,A01,083088,Eldon; John,23,0,100,77
1657841447064,CSE 175,A01,083665,Kumar; Rakesh,3,0,25,22
1657841453087,CSE 190,A00,092507,Dubnov; Shlomo,8,0,20,12
1657841459111,ECE 45,A01,083139,Congero; Spencer William,6,0,75,69
1657841465142,ECE 65,A50,083695,Saad; Andrew S,12,0,30,18
1657841465142,ECE 65,A51,095125,Saad; Andrew S,24,0,26,2
1657841471180,ECE 109,A01,091882,Touri; Behrouz,20,0,70,50
1657841477208,ECE 180,A00,083140,Abi Samra; Nicholas Camill,1,0,30,29
1657841477208,ECE 180,B00,083141,Abi Samra; Nicholas Camill,0,0,30,30
1657841483237,MATH 10A,A01,083735,Patchell; Gregory David,2,0,30,28
1657841483237,MATH 10A,A02,083736,Patchell; Gregory David,20,0,30,10
1657841483237,MATH 10A,A03,083737,Patchell; Gregory David,16,0,30,14
1657841489262,MATH 10B,A01,083207,Lim; Seonhee,8,0,34,26
1657841489262,MATH 10B,A02,083208,Lim; Seonhee,10,0,35,25
1657841489262,MATH 10B,A03,093472,Lim; Seonhee,7,0,34,27
1657841489262,MATH 10B,B01,083739,Sinha; Shubham,14,0,30,16
1657841495307,MATH 18,A01,083743,Cinel; Cameron Alexander,9,0,30,21
1657841495307,MATH 18,A02,083744,Cinel; Cameron Alexander,18,0,30,12
1657841495307,MATH 18,A03,083745,Cinel; Cameron Alexander,10,0,30,20
1657841495307,MATH 18,B01,083748,Rideout; David Porter,5,0,37,32
1657841495307,MATH 18,B02,083749,Rideout; David Porter,5,0,36,31
1657841495307,MATH 18,B03,083750,Rideout; David Porter,3,0,37,34
1657841495307,MATH 18,B04,083751,Rideout; David Porter,6,0,36,30
1657841495307,MATH 18,B05,093473,Rideout; David Porter,6,0,36,30
1657841495307,MATH 18,B06,093474,Rideout; David Porter,6,0,36,30
1657841501347,MATH 20A,A01,083754,Zheng; Zequn,14,0,40,26
1657841507370,MATH 20B,A01,083756,Briones; Jor-el Thomas Caparas,4,0,36,32
1657841507370,MATH 20B,A02,083757,Briones; Jor-el Thomas Caparas,1,0,36,35
1657841507370,MATH 20B,A03,093475,Briones; Jor-el Thomas Caparas,2,0,36,34
1657841513403,MATH 20C,A01,083760,Briones; Jor-el Thomas Caparas,1,0,35,34
1657841513403,MATH 20C,A02,083761,Briones; Jor-el Thomas Caparas,8,0,35,27
1657841513403,MATH 20C,A03,093476,Briones; Jor-el Thomas Caparas,0,1,36,36
1657841513403,MATH 20C,B01,083762,Bach; Quang Tran,1,0,30,29
1657841519426,MATH 20D,A01,083765,Tran; Brian Kha,5,0,30,25
1657841519426,MATH 20D,A02,083766,Tran; Brian Kha,5,0,30,25
1657841519426,MATH 20D,A03,083767,Tran; Brian Kha,5,0,30,25
1657841525452,MATH 20E,A01,083771,Ganguly; Soumya,10,0,32,22
1657841525452,MATH 20E,A02,083772,Ganguly; Soumya,6,0,32,26
1657841525452,MATH 20E,B01,083773,Ciotti; Benjamin,20,0,35,15
1657841525452,MATH 20E,B02,083774,Ciotti; Benjamin,18,0,35,17
1657841531483,MATH 103A,A01,083777,Greenfeld; Be'Eri,3,0,36,33
1657841531483,MATH 103A,A02,083778,Greenfeld; Be'Eri,5,0,36,31
1657841531483,MATH 103A,A03,093561,Greenfeld; Be'Eri,6,0,36,30
1657841531483,MATH 103A,B01,083779,Greenfeld; Be'Eri,7,0,36,29
1657841531483,MATH 103A,B02,083780,Greenfeld; Be'Eri,4,0,36,32
1657841531483,MATH 103A,B03,093562,Greenfeld; Be'Eri,3,0,36,33
1657841537510,MATH 105,A01,085443,Carter; Anne Toulson,15,0,35,20
1657841537510,MATH 105,A02,093477,Carter; Anne Toulson,20,0,35,15
1657841543539,MATH 109,A01,083213,Ganzberger; Geoffrey Michael,3,0,34,31
1657841543539,MATH 109,A02,083214,Ganzberger; Geoffrey Michael,4,0,34,30
1657841543539,MATH 109,A03,093478,Ganzberger; Geoffrey Michael,2,0,34,32
1657841543539,MATH 109,B01,083215,Ganzberger; Geoffrey Michael,1,0,32,31
1657841543539,MATH 109,B02,083216,Ganzberger; Geoffrey Michael,2,0,32,30
1657841543539,MATH 109,B03,093479,Ganzberger; Geoffrey Michael,8,0,32,24
1657841549569,MATH 142A,A01,083219,Chow; Bennett,7,0,32,25
1657841549569,MATH 142A,A02,083220,Chow; Bennett,10,0,32,22
1657841549569,MATH 142A,A03,093480,Chow; Bennett,9,0,32,23
1657841549569,MATH 142A,B03,093481,Chow; Bennett,8,0,32,24
1657841549569,MATH 142A,B04,093558,Chow; Bennett,13,0,32,19
1657841549569,MATH 142A,B05,093559,Chow; Bennett,7,0,32,25
1657841555599,MATH 193A,A01,083224,Rotar; Vladimir,8,0,34,26
1657841555599,MATH 193A,A02,083225,Rotar; Vladimir,10,0,34,24
1657841555599,MATH 193A,A03,083781,Rotar; Vladimir,5,0,34,29
1657841555599,MATH 193A,A04,083782,Rotar; Vladimir,11,0,34,23
1657841555599,MATH 193A,A05,093482,Rotar; Vladimir,10,0,34,24
1657841561629,MATH 197,001,091859,McAuley; Julian John,9999,0,9999,0
1657841561629,MATH 197,002,095566,Kedlaya; Kiran S.,9997,0,9999,2
1657841561629,MATH 197,003,095567,Xiao; Ming,9999,0,9999,0
1657841561629,MATH 197,004,095571,Perols; Johan Lars,9998,0,9999,1
1657841568707,COGS 9,A01,083615,Shannon; Kyle Michael,9,0,75,66
1657841574733,COGS 11,A01,083617,Boyle; Mary E. T.,23,0,48,25
1657841580766,COGS 13,A01,083071,Bastos; Amalia Pinkusfeld,11,0,71,60
1657841586807,COGS 14A,A01,092681,Semenuks; Arturs,5,1,100,95
1657841592835,COGS 14B,A01,083073,Cheng; Tzu-Han,6,0,63,57
1657841598864,COGS 17,A01,092677,Semenuks; Arturs,6,0,81,75
1657841604891,COGS 100,A01,083619,Allen; Michael Gordon,17,0,70,53
1657841610925,COGS 101A,A01,083621,Davis; Joshua Daniel,9,0,68,59
1657841616972,COGS 101B,A01,091572,Allen; Michael Gordon,12,0,65,53
1657841622994,COGS 101C,A01,083625,Delgado; Tania,17,0,35,18
1657841629018,COGS 107A,A01,083627,Boyle; Mary E. T.,14,0,60,46
1657841635064,COGS 118A,A01,083075,Gupta; Anjum,21,0,76,55
1657841641092,CSE 3,A50,083646,Miranda; Gregory Joseph,24,0,50,26
1657841647114,CSE 8A,A50,083650,Miranda; Gregory Joseph,17,1,56,39
1657841653136,CSE 11,A01,083080,Cao; Yingjun,6,15,40,34
1657841659163,CSE 12,A01,083652,Krause-Levy; Sophia Louisa,29,1,120,91
1657841665190,CSE 15L,A01,083654,Morris; Justin Loren,9,0,50,41
1657841665190,CSE 15L,A02,083655,Morris; Justin Loren,9,0,50,41
1657841671213,CSE 20,A01,083657,Tran; Khoa Dang,39,0,80,41
1657841677237,CSE 21,A01,095574,Bach; Quang Tran,22,0,48,26
1657841683262,CSE 30,A01,083084,Eldon; John,6,0,80,74
1657841683262,CSE 30,B01,095061,Bhaskar; Nishant,9,0,50,41
1657841689287,CSE 100,A01,083659,Cao; Yingjun,5,4,70,65
1657841695319,CSE 134B,A01,083661,Powell; Thomas Allan,24,0,100,76
1657841701345,CSE 140,A01,083663,Gungor; Onat,15,0,85,70
1657841707369,CSE 140L,A01,083088,Eldon; John,23,0,100,77
1657841713402,CSE 175,A01,083665,Kumar; Rakesh,3,0,25,22
1657841719425,CSE 190,A00,092507,Dubnov; Shlomo,8,0,20,12
1657841725468,ECE 45,A01,083139,Congero; Spencer William,6,0,75,69
1657841731497,ECE 65,A50,083695,Saad; Andrew S,12,0,30,18
1657841731497,ECE 65,A51,095125,Saad; Andrew S,24,0,26,2
1657841737524,ECE 109,A01,091882,Touri; Behrouz,20,0,70,50
1657841743552,ECE 180,A00,083140,Abi Samra; Nicholas Camill,1,0,30,29
1657841743552,ECE 180,B00,083141,Abi Samra; Nicholas Camill,0,0,30,30
1657841749577,MATH 10A,A01,083735,Patchell; Gregory David,2,0,30,28
1657841749577,MATH 10A,A02,083736,Patchell; Gregory David,20,0,30,10
1657841749577,MATH 10A,A03,083737,Patchell; Gregory David,16,0,30,14
1657841755621,MATH 10B,A01,083207,Lim; Seonhee,8,0,34,26
1657841755621,MATH 10B,A02,083208,Lim; Seonhee,10,0,35,25
1657841755621,MATH 10B,A03,093472,Lim; Seonhee,7,0,34,27
1657841755621,MATH 10B,B01,083739,Sinha; Shubham,14,0,30,16
1657841761644,MATH 18,A01,083743,Cinel; Cameron Alexander,9,0,30,21
1657841761644,MATH 18,A02,083744,Cinel; Cameron Alexander,18,0,30,12
1657841761644,MATH 18,A03,083745,Cinel; Cameron Alexander,10,0,30,20
1657841761644,MATH 18,B01,083748,Rideout; David Porter,5,0,37,32
1657841761644,MATH 18,B02,083749,Rideout; David Porter,5,0,36,31
1657841761644,MATH 18,B03,083750,Rideout; David Porter,3,0,37,34
1657841761644,MATH 18,B04,083751,Rideout; David Porter,6,0,36,30
1657841761644,MATH 18,B05,093473,Rideout; David Porter,6,0,36,30
1657841761644,MATH 18,B06,093474,Rideout; David Porter,6,0,36,30
1657841767666,MATH 20A,A01,083754,Zheng; Zequn,14,0,40,26
1657841773691,MATH 20B,A01,083756,Briones; Jor-el Thomas Caparas,4,0,36,32
1657841773691,MATH 20B,A02,083757,Briones; Jor-el Thomas Caparas,1,0,36,35
1657841773691,MATH 20B,A03,093475,Briones; Jor-el Thomas Caparas,2,0,36,34
1657841779722,MATH 20C,A01,083760,Briones; Jor-el Thomas Caparas,1,0,35,34
1657841779722,MATH 20C,A02,083761,Briones; Jor-el Thomas Caparas,8,0,35,27
1657841779722,MATH 20C,A03,093476,Briones; Jor-el Thomas Caparas,0,1,36,36
1657841779722,MATH 20C,B01,083762,Bach; Quang Tran,1,0,30,29
1657841785762,MATH 20D,A01,083765,Tran; Brian Kha,5,0,30,25
1657841785762,MATH 20D,A02,083766,Tran; Brian Kha,5,0,30,25
1657841785762,MATH 20D,A03,083767,Tran; Brian Kha,5,0,30,25
1657841791785,MATH 20E,A01,083771,Ganguly; Soumya,10,0,32,22
1657841791785,MATH 20E,A02,083772,Ganguly; Soumya,6,0,32,26
1657841791785,MATH 20E,B01,083773,Ciotti; Benjamin,20,0,35,15
1657841791785,MATH 20E,B02,083774,Ciotti; Benjamin,18,0,35,17
1657841797812,MATH 103A,A01,083777,Greenfeld; Be'Eri,3,0,36,33
1657841797812,MATH 103A,A02,083778,Greenfeld; Be'Eri,5,0,36,31
1657841797812,MATH 103A,A03,093561,Greenfeld; Be'Eri,6,0,36,30
1657841797812,MATH 103A,B01,083779,Greenfeld; Be'Eri,7,0,36,29
1657841797812,MATH 103A,B02,083780,Greenfeld; Be'Eri,4,0,36,32
1657841797812,MATH 103A,B03,093562,Greenfeld; Be'Eri,3,0,36,33
1657841803839,MATH 105,A01,085443,Carter; Anne Toulson,15,0,35,20
1657841803839,MATH 105,A02,093477,Carter; Anne Toulson,20,0,35,15
1657841809863,MATH 109,A01,083213,Ganzberger; Geoffrey Michael,3,0,34,31
1657841809863,MATH 109,A02,083214,Ganzberger; Geoffrey Michael,4,0,34,30
1657841809863,MATH 109,A03,093478,Ganzberger; Geoffrey Michael,2,0,34,32
1657841809863,MATH 109,B01,083215,Ganzberger; Geoffrey Michael,1,0,32,31
1657841809863,MATH 109,B02,083216,Ganzberger; Geoffrey Michael,2,0,32,30
1657841809863,MATH 109,B03,093479,Ganzberger; Geoffrey Michael,8,0,32,24
1657841815905,MATH 142A,A01,083219,Chow; Bennett,7,0,32,25
1657841815905,MATH 142A,A02,083220,Chow; Bennett,10,0,32,22
1657841815905,MATH 142A,A03,093480,Chow; Bennett,9,0,32,23
1657841815905,MATH 142A,B03,093481,Chow; Bennett,8,0,32,24
1657841815905,MATH 142A,B04,093558,Chow; Bennett,13,0,32,19
1657841815905,MATH 142A,B05,093559,Chow; Bennett,7,0,32,25
1657841821930,MATH 193A,A01,083224,Rotar; Vladimir,8,0,34,26
1657841821930,MATH 193A,A02,083225,Rotar; Vladimir,10,0,34,24
1657841821930,MATH 193A,A03,083781,Rotar; Vladimir,5,0,34,29
1657841821930,MATH 193A,A04,083782,Rotar; Vladimir,11,0,34,23
1657841821930,MATH 193A,A05,093482,Rotar; Vladimir,10,0,34,24
1657841827956,MATH 197,001,091859,McAuley; Julian John,9999,0,9999,0
1657841827956,MATH 197,002,095566,Kedlaya; Kiran S.,9997,0,9999,2
1657841827956,MATH 197,003,095567,Xiao; Ming,9999,0,9999,0
1657841827956,MATH 197,004,095571,Perols; Johan Lars,9998,0,9999,1
1657841835026,COGS 9,A01,083615,Shannon; Kyle Michael,9,0,75,66
1657841841049,COGS 11,A01,083617,Boyle; Mary E. T.,23,0,48,25
1657841847072,COGS 13,A01,083071,Bastos; Amalia Pinkusfeld,11,0,71,60
1657841853095,COGS 14A,A01,092681,Semenuks; Arturs,5,1,100,95
1657841859118,COGS 14B,A01,083073,Cheng; Tzu-Han,6,0,63,57
1657841865160,COGS 17,A01,092677,Semenuks; Arturs,6,0,81,75
1657841871186,COGS 100,A01,083619,Allen; Michael Gordon,17,0,70,53
1657841877209,COGS 101A,A01,083621,Davis; Joshua Daniel,9,0,68,59
1657841883236,COGS 101B,A01,091572,Allen; Michael Gordon,12,0,65,53
1657841889270,COGS 101C,A01,083625,Delgado; Tania,17,0,35,18
1657841895296,COGS 107A,A01,083627,Boyle; Mary E. T.,14,0,60,46
1657841901318,COGS 118A,A01,083075,Gupta; Anjum,21,0,76,55
1657841907357,CSE 3,A50,083646,Miranda; Gregory Joseph,24,0,50,26
1657841913378,CSE 8A,A50,083650,Miranda; Gregory Joseph,17,1,56,39
1657841919400,CSE 11,A01,083080,Cao; Yingjun,6,15,40,34
1657841925423,CSE 12,A01,083652,Krause-Levy; Sophia Louisa,29,1,120,91
1657841931445,CSE 15L,A01,083654,Morris; Justin Loren,9,0,50,41
1657841931445,CSE 15L,A02,083655,Morris; Justin Loren,9,0,50,41
1657841937473,CSE 20,A01,083657,Tran; Khoa Dang,39,0,80,41
1657841943494,CSE 21,A01,095574,Bach; Quang Tran,22,0,48,26
1657841949525,CSE 30,A01,083084,Eldon; John,6,0,80,74
1657841949525,CSE 30,B01,095061,Bhaskar; Nishant,9,0,50,41
1657841955558,CSE 100,A01,083659,Cao; Yingjun,5,4,70,65
1657841961582,CSE 134B,A01,083661,Powell; Thomas Allan,24,0,100,76
1657841967605,CSE 140,A01,083663,Gungor; Onat,15,0,85,70
1657841973645,CSE 140L,A01,083088,Eldon; John,23,0,100,77
1657841979672,CSE 175,A01,083665,Kumar; Rakesh,3,0,25,22
1657841985698,CSE 190,A00,092507,Dubnov; Shlomo,8,0,20,12
1657841991719,ECE 45,A01,083139,Congero; Spencer William,6,0,75,69
1657841997741,ECE 65,A50,083695,Saad; Andrew S,12,0,30,18
1657841997741,ECE 65,A51,095125,Saad; Andrew S,24,0,26,2
1657842003762,ECE 109,A01,091882,Touri; Behrouz,20,0,70,50
1657842009786,ECE 180,A00,083140,Abi Samra; Nicholas Camill,1,0,30,29
1657842009786,ECE 180,B00,083141,Abi Samra; Nicholas Camill,0,0,30,30
1657842015821,MATH 10A,A01,083735,Patchell; Gregory David,2,0,30,28
1657842015821,MATH 10A,A02,083736,Patchell; Gregory David,20,0,30,10
1657842015821,MATH 10A,A03,083737,Patchell; Gregory David,16,0,30,14
1657842021850,MATH 10B,A01,083207,Lim; Seonhee,8,0,34,26
1657842021850,MATH 10B,A02,083208,Lim; Seonhee,10,0,35,25
1657842021850,MATH 10B,A03,093472,Lim; Seonhee,7,0,34,27
1657842021850,MATH 10B,B01,083739,Sinha; Shubham,14,0,30,16
1657842027874,MATH 18,A01,083743,Cinel; Cameron Alexander,9,0,30,21
1657842027874,MATH 18,A02,083744,Cinel; Cameron Alexander,18,0,30,12
1657842027874,MATH 18,A03,083745,Cinel; Cameron Alexander,10,0,30,20
1657842027874,MATH 18,B01,083748,Rideout; David Porter,5,0,37,32
1657842027874,MATH 18,B02,083749,Rideout; David Porter,5,0,36,31
1657842027874,MATH 18,B03,083750,Rideout; David Porter,3,0,37,34
1657842027874,MATH 18,B04,083751,Rideout; David Porter,6,0,36,30
1657842027874,MATH 18,B05,093473,Rideout; David Porter,6,0,36,30
1657842027874,MATH 18,B06,093474,Rideout; David Porter,6,0,36,30
1657842033898,MATH 20A,A01,083754,Zheng; Zequn,14,0,40,26
1657842039991,MATH 20B,A01,083756,Briones; Jor-el Thomas Caparas,4,0,36,32
1657842039991,MATH 20B,A02,083757,Briones; Jor-el Thomas Caparas,1,0,36,35
1657842039991,MATH 20B,A03,093475,Briones; Jor-el Thomas Caparas,2,0,36,34
1657842046025,MATH 20C,A01,083760,Briones; Jor-el Thomas Caparas,1,0,35,34
1657842046025,MATH 20C,A02,083761,Briones; Jor-el Thomas Caparas,8,0,35,27
1657842046025,MATH 20C,A03,093476,Briones; Jor-el Thomas Caparas,0,1,36,36
1657842046025,MATH 20C,B01,083762,Bach; Quang Tran,1,0,30,29
1657842052049,MATH 20D,A01,083765,Tran; Brian Kha,5,0,30,25
1657842052049,MATH 20D,A02,083766,Tran; Brian Kha,5,0,30,25
1657842052049,MATH 20D,A03,083767,Tran; Brian Kha,5,0,30,25
1657842058081,MATH 20E,A01,083771,Ganguly; Soumya,10,0,32,22
1657842058081,MATH 20E,A02,083772,Ganguly; Soumya,6,0,32,26
1657842058081,MATH 20E,B01,083773,Ciotti; Benjamin,20,0,35,15
1657842058081,MATH 20E,B02,083774,Ciotti; Benjamin,18,0,35,17
1657842064108,MATH 103A,A01,083777,Greenfeld; Be'Eri,3,0,36,33
1657842064108,MATH 103A,A02,083778,Greenfeld; Be'Eri,5,0,36,31
1657842064108,MATH 103A,A03,093561,Greenfeld; Be'Eri,6,0,36,30
1657842064108,MATH 103A,B01,083779,Greenfeld; Be'Eri,7,0,36,29
1657842064108,MATH 103A,B02,083780,Greenfeld; Be'Eri,4,0,36,32
1657842064108,MATH 103A,B03,093562,Greenfeld; Be'Eri,3,0,36,33
1657842070134,MATH 105,A01,085443,Carter; Anne Toulson,15,0,35,20
1657842070134,MATH 105,A02,093477,Carter; Anne Toulson,20,0,35,15
1657842076162,MATH 109,A01,083213,Ganzberger; Geoffrey Michael,3,0,34,31
1657842076162,MATH 109,A02,083214,Ganzberger; Geoffrey Michael,4,0,34,30
1657842076162,MATH 109,A03,093478,Ganzberger; Geoffrey Michael,2,0,34,32
1657842076162,MATH 109,B01,083215,Ganzberger; Geoffrey Michael,1,0,32,31
1657842076162,MATH 109,B02,083216,Ganzberger; Geoffrey Michael,2,0,32,30
1657842076162,MATH 109,B03,093479,Ganzberger; Geoffrey Michael,8,0,32,24
1657842082185,MATH 142A,A01,083219,Chow; Bennett,7,0,32,25
1657842082185,MATH 142A,A02,083220,Chow; Bennett,10,0,32,22
1657842082185,MATH 142A,A03,093480,Chow; Bennett,9,0,32,23
1657842082185,MATH 142A,B03,093481,Chow; Bennett,8,0,32,24
1657842082185,MATH 142A,B04,093558,Chow; Bennett,13,0,32,19
1657842082185,MATH 142A,B05,093559,Chow; Bennett,7,0,32,25
1657842088209,MATH 193A,A01,083224,Rotar; Vladimir,8,0,34,26
1657842088209,MATH 193A,A02,083225,Rotar; Vladimir,10,0,34,24
1657842088209,MATH 193A,A03,083781,Rotar; Vladimir,5,0,34,29
1657842088209,MATH 193A,A04,083782,Rotar; Vladimir,11,0,34,23
1657842088209,MATH 193A,A05,093482,Rotar; Vladimir,10,0,34,24
1657842094230,MATH 197,001,091859,McAuley; Julian John,9999,0,9999,0
1657842094230,MATH 197,002,095566,Kedlaya; Kiran S.,9997,0,9999,2
1657842094230,MATH 197,003,095567,Xiao; Ming,9999,0,9999,0
1657842094230,MATH 197,004,095571,Perols; Johan Lars,9998,0,9999,1
1657842101285,COGS 9,A01,083615,Shannon; Kyle Michael,9,0,75,66
1657842107306,COGS 11,A01,083617,Boyle; Mary E. T.,23,0,48,25
1657842113337,COGS 13,A01,083071,Bastos; Amalia Pinkusfeld,11,0,71,60
1657842119360,COGS 14A,A01,092681,Semenuks; Arturs,5,1,100,95
1657842125384,COGS 14B,A01,083073,Cheng; Tzu-Han,6,0,63,57
1657842131406,COGS 17,A01,092677,Semenuks; Arturs,6,0,81,75
1657842137435,COGS 100,A01,083619,Allen; Michael Gordon,17,0,70,53
1657842143462,COGS 101A,A01,083621,Davis; Joshua Daniel,9,0,68,59
1657842149485,COGS 101B,A01,091572,Allen; Michael Gordon,12,0,65,53
1657842155506,COGS 101C,A01,083625,Delgado; Tania,17,0,35,18
1657842161530,COGS 107A,A01,083627,Boyle; Mary E. T.,14,0,60,46
1657842167558,COGS 118A,A01,083075,Gupta; Anjum,21,0,76,55
1657842173582,CSE 3,A50,083646,Miranda; Gregory Joseph,24,0,50,26
1657842179604,CSE 8A,A50,083650,Miranda; Gregory Joseph,17,1,56,39
1657842185627,CSE 11,A01,083080,Cao; Yingjun,6,15,40,34
1657842191654,CSE 12,A01,083652,Krause-Levy; Sophia Louisa,29,1,120,91
1657842197676,CSE 15L,A01,083654,Morris; Justin Loren,9,0,50,41
1657842197676,CSE 15L,A02,083655,Morris; Justin Loren,9,0,50,41
1657842203697,CSE 20,A01,083657,Tran; Khoa Dang,39,0,80,41
1657842209721,CSE 21,A01,095574,Bach; Quang Tran,22,0,48,26
1657842215744,CSE 30,A01,083084,Eldon; John,6,0,80,74
1657842215744,CSE 30,B01,095061,Bhaskar; Nishant,9,0,50,41
1657842221771,CSE 100,A01,083659,Cao; Yingjun,5,4,70,65
1657842227797,CSE 134B,A01,083661,Powell; Thomas Allan,24,0,100,76
1657842233825,CSE 140,A01,083663,Gungor; Onat,15,0,85,70
1657842239855,CSE 140L,A01,083088,Eldon; John,23,0,100,77
1657842245888,CSE 175,A01,083665,Kumar; Rakesh,3,0,25,22
1657842251911,CSE 190,A00,092507,Dubnov; Shlomo,8,0,20,12
1657842257939,ECE 45,A01,083139,Congero; Spencer William,6,0,75,69
1657842263966,ECE 65,A50,083695,Saad; Andrew S,12,0,30,18
1657842263966,ECE 65,A51,095125,Saad; Andrew S,24,0,26,2
1657842269992,ECE 109,A01,091882,Touri; Behrouz,20,0,70,50
1657842276014,ECE 180,A00,083140,Abi Samra; Nicholas Camill,1,0,30,29
1657842276014,ECE 180,B00,083141,Abi Samra; Nicholas Camill,0,0,30,30
1657842282036,MATH 10A,A01,083735,Patchell; Gregory David,2,0,30,28
1657842282036,MATH 10A,A02,083736,Patchell; Gregory David,20,0,30,10
1657842282036,MATH 10A,A03,083737,Patchell; Gregory David,16,0,30,14
1657842288058,MATH 10B,A01,083207,Lim; Seonhee,8,0,34,26
1657842288058,MATH 10B,A02,083208,Lim; Seonhee,10,0,35,25
1657842288058,MATH 10B,A03,093472,Lim; Seonhee,7,0,34,27
1657842288058,MATH 10B,B01,083739,Sinha; Shubham,14,0,30,16
1657842294083,MATH 18,A01,083743,Cinel; Cameron Alexander,9,0,30,21
1657842294083,MATH 18,A02,083744,Cinel; Cameron Alexander,18,0,30,12
1657842294083,MATH 18,A03,083745,Cinel; Cameron Alexander,10,0,30,20
1657842294083,MATH 18,B01,083748,Rideout; David Porter,5,0,37,32
1657842294083,MATH 18,B02,083749,Rideout; David Porter,5,0,36,31
1657842294083,MATH 18,B03,083750,Rideout; David Porter,3,0,37,34
1657842294083,MATH 18,B04,083751,Rideout; David Porter,6,0,36,30
1657842294083,MATH 18,B05,093473,Rideout; David Porter,6,0,36,30
1657842294083,MATH 18,B06,093474,Rideout; David Porter,6,0,36,30
1657842300110,MATH 20A,A01,083754,Zheng; Zequn,14,0,40,26
1657842306137,MATH 20B,A01,083756,Briones; Jor-el Thomas Caparas,4,0,36,32
1657842306137,MATH 20B,A02,083757,Briones; Jor-el Thomas Caparas,1,0,36,35
1657842306137,MATH 20B,A03,093475,Briones; Jor-el Thomas Caparas,2,0,36,34
1657842312160,MATH 20C,A01,083760,Briones; Jor-el Thomas Caparas,1,0,35,34
1657842312160,MATH 20C,A02,083761,Briones; Jor-el Thomas Caparas,8,0,35,27
1657842312160,MATH 20C,A03,093476,Briones; Jor-el Thomas Caparas,0,1,36,36
1657842312160,MATH 20C,B01,083762,Bach; Quang Tran,1,0,30,29
1657842318190,MATH 20D,A01,083765,Tran; Brian Kha,5,0,30,25
1657842318190,MATH 20D,A02,083766,Tran; Brian Kha,5,0,30,25
1657842318190,MATH 20D,A03,083767,Tran; Brian Kha,5,0,30,25
1657842324215,MATH 20E,A01,083771,Ganguly; Soumya,10,0,32,22
1657842324215,MATH 20E,A02,083772,Ganguly; Soumya,6,0,32,26
1657842324215,MATH 20E,B01,083773,Ciotti; Benjamin,20,0,35,15
1657842324215,MATH 20E,B02,083774,Ciotti; Benjamin,18,0,35,17
1657842330239,MATH 103A,A01,083777,Greenfeld; Be'Eri,3,0,36,33
1657842330239,MATH 103A,A02,083778,Greenfeld; Be'Eri,5,0,36,31
1657842330239,MATH 103A,A03,093561,Greenfeld; Be'Eri,6,0,36,30
1657842330239,MATH 103A,B01,083779,Greenfeld; Be'Eri,7,0,36,29
1657842330239,MATH 103A,B02,083780,Greenfeld; Be'Eri,4,0,36,32
1657842330239,MATH 103A,B03,093562,Greenfeld; Be'Eri,3,0,36,33
1657842336267,MATH 105,A01,085443,Carter; Anne Toulson,15,0,35,20
1657842336267,MATH 105,A02,093477,Carter; Anne Toulson,20,0,35,15
1657842342297,MATH 109,A01,083213,Ganzberger; Geoffrey Michael,3,0,34,31
1657842342297,MATH 109,A02,083214,Ganzberger; Geoffrey Michael,4,0,34,30
1657842342297,MATH 109,A03,093478,Ganzberger; Geoffrey Michael,2,0,34,32
1657842342297,MATH 109,B01,083215,Ganzberger; Geoffrey Michael,1,0,32,31
1657842342297,MATH 109,B02,083216,Ganzberger; Geoffrey Michael,2,0,32,30
1657842342297,MATH 109,B03,093479,Ganzberger; Geoffrey Michael,8,0,32,24
1657842348340,MATH 142A,A01,083219,Chow; Bennett,7,0,32,25
1657842348340,MATH 142A,A02,083220,Chow; Bennett,10,0,32,22
1657842348340,MATH 142A,A03,093480,Chow; Bennett,9,0,32,23
1657842348340,MATH 142A,B03,093481,Chow; Bennett,8,0,32,24
1657842348340,MATH 142A,B04,093558,Chow; Bennett,13,0,32,19
1657842348340,MATH 142A,B05,093559,Chow; Bennett,7,0,32,25
1657842354363,MATH 193A,A01,083224,Rotar; Vladimir,8,0,34,26
1657842354363,MATH 193A,A02,083225,Rotar; Vladimir,10,0,34,24
1657842354363,MATH 193A,A03,083781,Rotar; Vladimir,5,0,34,29
1657842354363,MATH 193A,A04,083782,Rotar; Vladimir,11,0,34,23
1657842354363,MATH 193A,A05,093482,Rotar; Vladimir,10,0,34,24
1657842360390,MATH 197,001,091859,McAuley; Julian John,9999,0,9999,0
1657842360390,MATH 197,002,095566,Kedlaya; Kiran S.,9997,0,9999,2
1657842360390,MATH 197,003,095567,Xiao; Ming,9999,0,9999,0
1657842360390,MATH 197,004,095571,Perols; Johan Lars,9998,0,9999,1
1657842367461,COGS 9,A01,083615,Shannon; Kyle Michael,9,0,75,66
1657842373486,COGS 11,A01,083617,Boyle; Mary E. T.,23,0,48,25
1657842379509,COGS 13,A01,083071,Bastos; Amalia Pinkusfeld,11,0,71,60
1657842385537,COGS 14A,A01,092681,Semenuks; Arturs,5,1,100,95
1657842391559,COGS 14B,A01,083073,Cheng; Tzu-Han,6,0,63,57
1657842397586,COGS 17,A01,092677,Semenuks; Arturs,6,0,81,75
1657842403613,COGS 100,A01,083619,Allen; Michael Gordon,17,0,70,53
1657842409641,COGS 101A,A01,083621,Davis; Joshua Daniel,9,0,68,59
1657842415667,COGS 101B,A01,091572,Allen; Michael Gordon,12,0,65,53
1657842421694,COGS 101C,A01,083625,Delgado; Tania,17,0,35,18
1657842427719,COGS 107A,A01,083627,Boyle; Mary E. T.,14,0,60,46
1657842433749,COGS 118A,A01,083075,Gupta; Anjum,21,0,76,55
1657842439772,CSE 3,A50,083646,Miranda; Gregory Joseph,24,0,50,26
1657842445804,CSE 8A,A50,083650,Miranda; Gregory Joseph,17,1,56,39
1657842451831,CSE 11,A01,083080,Cao; Yingjun,6,15,40,34
1657842457865,CSE 12,A01,083652,Krause-Levy; Sophia Louisa,29,1,120,91
1657842463889,CSE 15L,A01,083654,Morris; Justin Loren,9,0,50,41
1657842463889,CSE 15L,A02,083655,Morris; Justin Loren,9,0,50,41
1657842469913,CSE 20,A01,083657,Tran; Khoa Dang,39,0,80,41
1657842475947,CSE 21,A01,095574,Bach; Quang Tran,22,0,48,26
1657842481974,CSE 30,A01,083084,Eldon; John,6,0,80,74
1657842481974,CSE 30,B01,095061,Bhaskar; Nishant,9,0,50,41
1657842488002,CSE 100,A01,083659,Cao; Yingjun,5,4,70,65
1657842494026,CSE 134B,A01,083661,Powell; Thomas Allan,24,0,100,76
1657842500050,CSE 140,A01,083663,Gungor; Onat,15,0,85,70
1657842506072,CSE 140L,A01,083088,Eldon; John,23,0,100,77
1657842512095,CSE 175,A01,083665,Kumar; Rakesh,3,0,25,22
1657842518120,CSE 190,A00,092507,Dubnov; Shlomo,8,0,20,12
1657842524142,ECE 45,A01,083139,Congero; Spencer William,6,0,75,69
1657842530168,ECE 65,A50,083695,Saad; Andrew S,12,0,30,18
1657842530168,ECE 65,A51,095125,Saad; Andrew S,24,0,26,2
1657842536191,ECE 109,A01,091882,Touri; Behrouz,20,0,70,50
1657842542219,ECE 180,A00,083140,Abi Samra; Nicholas Camill,1,0,30,29
1657842542219,ECE 180,B00,083141,Abi Samra; Nicholas Camill,0,0,30,30
1657842548256,MATH 10A,A01,083735,Patchell; Gregory David,2,0,30,28
1657842548256,MATH 10A,A02,083736,Patchell; Gregory David,20,0,30,10
1657842548256,MATH 10A,A03,083737,Patchell; Gregory David,16,0,30,14
1657842554293,MATH 10B,A01,083207,Lim; Seonhee,8,0,34,26
1657842554293,MATH 10B,A02,083208,Lim; Seonhee,10,0,35,25
1657842554293,MATH 10B,A03,093472,Lim; Seonhee,7,0,34,27
1657842554293,MATH 10B,B01,083739,Sinha; Shubham,14,0,30,16
1657842560318,MATH 18,A01,083743,Cinel; Cameron Alexander,9,0,30,21
1657842560318,MATH 18,A02,083744,Cinel; Cameron Alexander,18,0,30,12
1657842560318,MATH 18,A03,083745,Cinel; Cameron Alexander,10,0,30,20
1657842560318,MATH 18,B01,083748,Rideout; David Porter,5,0,37,32
1657842560318,MATH 18,B02,083749,Rideout; David Porter,5,0,36,31
1657842560318,MATH 18,B03,083750,Rideout; David Porter,3,0,37,34
1657842560318,MATH 18,B04,083751,Rideout; David Porter,6,0,36,30
1657842560318,MATH 18,B05,093473,Rideout; David Porter,6,0,36,30
1657842560318,MATH 18,B06,093474,Rideout; David Porter,6,0,36,30
1657842566341,MATH 20A,A01,083754,Zheng; Zequn,14,0,40,26
1657842572369,MATH 20B,A01,083756,Briones; Jor-el Thomas Caparas,4,0,36,32
1657842572369,MATH 20B,A02,083757,Briones; Jor-el Thomas Caparas,1,0,36,35
1657842572369,MATH 20B,A03,093475,Briones; Jor-el Thomas Caparas,2,0,36,34
1657842578393,MATH 20C,A01,083760,Briones; Jor-el Thomas Caparas,1,0,35,34
1657842578393,MATH 20C,A02,083761,Briones; Jor-el Thomas Caparas,8,0,35,27
1657842578393,MATH 20C,A03,093476,Briones; Jor-el Thomas Caparas,0,1,36,36
1657842578393,MATH 20C,B01,083762,Bach; Quang Tran,1,0,30,29
1657842584416,MATH 20D,A01,083765,Tran; Brian Kha,5,0,30,25
1657842584416,MATH 20D,A02,083766,Tran; Brian Kha,5,0,30,25
1657842584416,MATH 20D,A03,083767,Tran; Brian Kha,5,0,30,25
1657842590443,MATH 20E,A01,083771,Ganguly; Soumya,10,0,32,22
1657842590443,MATH 20E,A02,083772,Ganguly; Soumya,6,0,32,26
1657842590443,MATH 20E,B01,083773,Ciotti; Benjamin,20,0,35,15
1657842590443,MATH 20E,B02,083774,Ciotti; Benjamin,18,0,35,17
1657842596467,MATH 103A,A01,083777,Greenfeld; Be'Eri,3,0,36,33
1657842596467,MATH 103A,A02,083778,Greenfeld; Be'Eri,5,0,36,31
1657842596467,MATH 103A,A03,093561,Greenfeld; Be'Eri,6,0,36,30
1657842596467,MATH 103A,B01,083779,Greenfeld; Be'Eri,7,0,36,29
1657842596467,MATH 103A,B02,083780,Greenfeld; Be'Eri,4,0,36,32
1657842596467,MATH 103A,B03,093562,Greenfeld; Be'Eri,3,0,36,33
1657842602494,MATH 105,A01,085443,Carter; Anne Toulson,15,0,35,20
1657842602494,MATH 105,A02,093477,Carter; Anne Toulson,20,0,35,15
1657842608519,MATH 109,A01,083213,Ganzberger; Geoffrey Michael,3,0,34,31
1657842608519,MATH 109,A02,083214,Ganzberger; Geoffrey Michael,4,0,34,30
1657842608519,MATH 109,A03,093478,Ganzberger; Geoffrey Michael,2,0,34,32
1657842608519,MATH 109,B01,083215,Ganzberger; Geoffrey Michael,1,0,32,31
1657842608519,MATH 109,B02,083216,Ganzberger; Geoffrey Michael,2,0,32,30
1657842608519,MATH 109,B03,093479,Ganzberger; Geoffrey Michael,8,0,32,24
1657842614552,MATH 142A,A01,083219,Chow; Bennett,7,0,32,25
1657842614552,MATH 142A,A02,083220,Chow; Bennett,10,0,32,22
1657842614552,MATH 142A,A03,093480,Chow; Bennett,9,0,32,23
1657842614552,MATH 142A,B03,093481,Chow; Bennett,8,0,32,24
1657842614552,MATH 142A,B04,093558,Chow; Bennett,13,0,32,19
1657842614552,MATH 142A,B05,093559,Chow; Bennett,7,0,32,25
1657842620575,MATH 193A,A01,083224,Rotar; Vladimir,8,0,34,26
1657842620575,MATH 193A,A02,083225,Rotar; Vladimir,10,0,34,24
1657842620575,MATH 193A,A03,083781,Rotar; Vladimir,5,0,34,29
1657842620575,MATH 193A,A04,083782,Rotar; Vladimir,11,0,34,23
1657842620575,MATH 193A,A05,093482,Rotar; Vladimir,10,0,34,24
1657842626601,MATH 197,001,091859,McAuley; Julian John,9999,0,9999,0
1657842626601,MATH 197,002,095566,Kedlaya; Kiran S.,9997,0,9999,2
1657842626601,MATH 197,003,095567,Xiao; Ming,9999,0,9999,0
1657842626601,MATH 197,004,095571,Perols; Johan Lars,9998,0,9999,1
1657842633742,COGS 9,A01,083615,Shannon; Kyle Michael,9,0,75,66
1657842639768,COGS 11,A01,083617,Boyle; Mary E. T.,23,0,48,25
1657842645797,COGS 13,A01,083071,Bastos; Amalia Pinkusfeld,11,0,71,60
1657842651829,COGS 14A,A01,092681,Semenuks; Arturs,5,1,100,95
1657842657856,COGS 14B,A01,083073,Cheng; Tzu-Han,6,0,63,57
1657842663893,COGS 17,A01,092677,Semenuks; Arturs,6,0,81,75
1657842669915,COGS 100,A01,083619,Allen; Michael Gordon,17,0,70,53
1657842675943,COGS 101A,A01,083621,Davis; Joshua Daniel,9,0,68,59
1657842681965,COGS 101B,A01,091572,Allen; Michael Gordon,12,0,65,53
1657842687988,COGS 101C,A01,083625,Delgado; Tania,17,0,35,18
1657842694009,COGS 107A,A01,083627,Boyle; Mary E. T.,14,0,60,46
1657842700035,COGS 118A,A01,083075,Gupta; Anjum,21,0,76,55
1657842706058,CSE 3,A50,083646,Miranda; Gregory Joseph,24,0,50,26
1657842712086,CSE 8A,A50,083650,Miranda; Gregory Joseph,17,1,56,39
1657842718109,CSE 11,A01,083080,Cao; Yingjun,6,15,40,34
1657842724131,CSE 12,A01,083652,Krause-Levy; Sophia Louisa,29,1,120,91
1657842730164,CSE 15L,A01,083654,Morris; Justin Loren,9,0,50,41
1657842730164,CSE 15L,A02,083655,Morris; Justin Loren,9,0,50,41
1657842736191,CSE 20,A01,083657,Tran; Khoa Dang,39,0,80,41
1657842742216,CSE 21,A01,095574,Bach; Quang Tran,22,0,48,26
1657842748239,CSE 30,A01,083084,Eldon; John,6,0,80,74
1657842748239,CSE 30,B01,095061,Bhaskar; Nishant,9,0,50,41
1657842754272,CSE 100,A01,083659,Cao; Yingjun,5,4,70,65
1657842760295,CSE 134B,A01,083661,Powell; Thomas Allan,24,0,100,76
1657842766321,CSE 140,A01,083663,Gungor; Onat,15,0,85,70
1657842772344,CSE 140L,A01,083088,Eldon; John,23,0,100,77
1657842778369,CSE 175,A01,083665,Kumar; Rakesh,3,0,25,22
1657842784392,CSE 190,A00,092507,Dubnov; Shlomo,8,0,20,12
1657842790415,ECE 45,A01,083139,Congero; Spencer William,6,0,75,69
1657842796437,ECE 65,A50,083695,Saad; Andrew S,12,0,30,18
1657842796437,ECE 65,A51,095125,Saad; Andrew S,24,0,26,2
1657842802460,ECE 109,A01,091882,Touri; Behrouz,20,0,70,50
1657842808484,ECE 180,A00,083140,Abi Samra; Nicholas Camill,1,0,30,29
1657842808484,ECE 180,B00,083141,Abi Samra; Nicholas Camill,0,0,30,30
1657842814506,MATH 10A,A01,083735,Patchell; Gregory David,2,0,30,28
1657842814506,MATH 10A,A02,083736,Patchell; Gregory David,20,0,30,10
1657842814506,MATH 10A,A03,083737,Patchell; Gregory David,16,0,30,14
1657842820530,MATH 10B,A01,083207,Lim; Seonhee,8,0,34,26
1657842820530,MATH 10B,A02,083208,Lim; Seonhee,10,0,35,25
1657842820530,MATH 10B,A03,093472,Lim; Seonhee,7,0,34,27
1657842820530,MATH 10B,B01,083739,Sinha; Shubham,14,0,30,16
1657842826560,MATH 18,A01,083743,Cinel; Cameron Alexander,9,0,30,21
1657842826560,MATH 18,A02,083744,Cinel; Cameron Alexander,18,0,30,12
1657842826560,MATH 18,A03,083745,Cinel; Cameron Alexander,10,0,30,20
1657842826560,MATH 18,B01,083748,Rideout; David Porter,5,0,37,32
1657842826560,MATH 18,B02,083749,Rideout; David Porter,5,0,36,31
1657842826560,MATH 18,B03,083750,Rideout; David Porter,3,0,37,34
1657842826560,MATH 18,B04,083751,Rideout; David Porter,6,0,36,30
1657842826560,MATH 18,B05,093473,Rideout; David Porter,6,0,36,30
1657842826560,MATH 18,B06,093474,Rideout; David Porter,6,0,36,30
1657842832587,MATH 20A,A01,083754,Zheng; Zequn,14,0,40,26
1657842838610,MATH 20B,A01,083756,Briones; Jor-el Thomas Caparas,4,0,36,32
1657842838610,MATH 20B,A02,083757,Briones; Jor-el Thomas Caparas,1,0,36,35
1657842838610,MATH 20B,A03,093475,Briones; Jor-el Thomas Caparas,2,0,36,34
1657842844638,MATH 20C,A01,083760,Briones; Jor-el Thomas Caparas,1,0,35,34
1657842844638,MATH 20C,A02,083761,Briones; Jor-el Thomas Caparas,8,0,35,27
1657842844638,MATH 20C,A03,093476,Briones; Jor-el Thomas Caparas,0,1,36,36
1657842844638,MATH 20C,B01,083762,Bach; Quang Tran,1,0,30,29
1657842850666,MATH 20D,A01,083765,Tran; Brian Kha,5,0,30,25
1657842850666,MATH 20D,A02,083766,Tran; Brian Kha,5,0,30,25
1657842850666,MATH 20D,A03,083767,Tran; Brian Kha,5,0,30,25
1657842856692,MATH 20E,A01,083771,Ganguly; Soumya,10,0,32,22
1657842856692,MATH 20E,A02,083772,Ganguly; Soumya,6,0,32,26
1657842856692,MATH 20E,B01,083773,Ciotti; Benjamin,20,0,35,15
1657842856692,MATH 20E,B02,083774,Ciotti; Benjamin,18,0,35,17
1657842862715,MATH 103A,A01,083777,Greenfeld; Be'Eri,3,0,36,33
1657842862715,MATH 103A,A02,083778,Greenfeld; Be'Eri,5,0,36,31
1657842862715,MATH 103A,A03,093561,Greenfeld; Be'Eri,6,0,36,30
1657842862715,MATH 103A,B01,083779,Greenfeld; Be'Eri,7,0,36,29
1657842862715,MATH 103A,B02,083780,Greenfeld; Be'Eri,4,0,36,32
1657842862715,MATH 103A,B03,093562,Greenfeld; Be'Eri,3,0,36,33
1657842868738,MATH 105,A01,085443,Carter; Anne Toulson,15,0,35,20
1657842868738,MATH 105,A02,093477,Carter; Anne Toulson,20,0,35,15
1657842874766,MATH 109,A01,083213,Ganzberger; Geoffrey Michael,3,0,34,31
1657842874766,MATH 109,A02,083214,Ganzberger; Geoffrey Michael,4,0,34,30
1657842874766,MATH 109,A03,093478,Ganzberger; Geoffrey Michael,2,0,34,32
1657842874766,MATH 109,B01,083215,Ganzberger; Geoffrey Michael,1,0,32,31
1657842874766,MATH 109,B02,083216,Ganzberger; Geoffrey Michael,2,0,32,30
1657842874766,MATH 109,B03,093479,Ganzberger; Geoffrey Michael,8,0,32,24
1657842880795,MATH 142A,A01,083219,Chow; Bennett,7,0,32,25
1657842880795,MATH 142A,A02,083220,Chow; Bennett,10,0,32,22
1657842880795,MATH 142A,A03,093480,Chow; Bennett,9,0,32,23
1657842880795,MATH 142A,B03,093481,Chow; Bennett,8,0,32,24
1657842880795,MATH 142A,B04,093558,Chow; Bennett,13,0,32,19
1657842880795,MATH 142A,B05,093559,Chow; Bennett,7,0,32,25
1657842886818,MATH 193A,A01,083224,Rotar; Vladimir,8,0,34,26
1657842886818,MATH 193A,A02,083225,Rotar; Vladimir,10,0,34,24
1657842886818,MATH 193A,A03,083781,Rotar; Vladimir,5,0,34,29
1657842886818,MATH 193A,A04,083782,Rotar; Vladimir,11,0,34,23
1657842886818,MATH 193A,A05,093482,Rotar; Vladimir,10,0,34,24
1657842892843,MATH 197,001,091859,McAuley; Julian John,9999,0,9999,0
1657842892843,MATH 197,002,095566,Kedlaya; Kiran S.,9997,0,9999,2
1657842892843,MATH 197,003,095567,Xiao; Ming,9999,0,9999,0
1657842892843,MATH 197,004,095571,Perols; Johan Lars,9998,0,9999,1
1657842899898,COGS 9,A01,083615,Shannon; Kyle Michael,9,0,75,66
1657842905922,COGS 11,A01,083617,Boyle; Mary E. T.,23,0,48,25
1657842911949,COGS 13,A01,083071,Bastos; Amalia Pinkusfeld,11,0,71,60
1657842917972,COGS 14A,A01,092681,Semenuks; Arturs,5,1,100,95
1657842924001,COGS 14B,A01,083073,Cheng; Tzu-Han,6,0,63,57
1657842930029,COGS 17,A01,092677,Semenuks; Arturs,6,0,81,75
1657842936051,COGS 100,A01,083619,Allen; Michael Gordon,17,0,70,53
1657842942078,COGS 101A,A01,083621,Davis; Joshua Daniel,9,0,68,59
1657842948105,COGS 101B,A01,091572,Allen; Michael Gordon,12,0,65,53
1657842954126,COGS 101C,A01,083625,Delgado; Tania,17,0,35,18
1657842960156,COGS 107A,A01,083627,Boyle; Mary E. T.,14,0,60,46
1657842966179,COGS 118A,A01,083075,Gupta; Anjum,21,0,76,55
1657842972208,CSE 3,A50,083646,Miranda; Gregory Joseph,24,0,50,26
1657842978244,CSE 8A,A50,083650,Miranda; Gregory Joseph,17,1,56,39
1657842984272,CSE 11,A01,083080,Cao; Yingjun,6,15,40,34
1657842990300,CSE 12,A01,083652,Krause-Levy; Sophia Louisa,29,1,120,91
1657842996324,CSE 15L,A01,083654,Morris; Justin Loren,9,0,50,41
1657842996324,CSE 15L,A02,083655,Morris; Justin Loren,9,0,50,41
1657843002347,CSE 20,A01,083657,Tran; Khoa Dang,39,0,80,41
1657843008370,CSE 21,A01,095574,Bach; Quang Tran,22,0,48,26
1657843014398,CSE 30,A01,083084,Eldon; John,6,0,80,74
1657843014398,CSE 30,B01,095061,Bhaskar; Nishant,9,0,50,41
1657843020421,CSE 100,A01,083659,Cao; Yingjun,5,4,70,65
1657843026445,CSE 134B,A01,083661,Powell; Thomas Allan,24,0,100,76
1657843032471,CSE 140,A01,083663,Gungor; Onat,15,0,85,70
1657843038495,CSE 140L,A01,083088,Eldon; John,23,0,100,77
1657843051863,CSE 175,A01,083665,Kumar; Rakesh,3,0,25,22
1657843057888,CSE 190,A00,092507,Dubnov; Shlomo,8,0,20,12
1657843063910,ECE 45,A01,083139,Congero; Spencer William,6,0,75,69
1657843069934,ECE 65,A50,083695,Saad; Andrew S,12,0,30,18
1657843069934,ECE 65,A51,095125,Saad; Andrew S,24,0,26,2
1657843075964,ECE 109,A01,091882,Touri; Behrouz,20,0,70,50
1657843081996,ECE 180,A00,083140,Abi Samra; Nicholas Camill,1,0,30,29
1657843081996,ECE 180,B00,083141,Abi Samra; Nicholas Camill,0,0,30,30
1657843088025,MATH 10A,A01,083735,Patchell; Gregory David,2,0,30,28
1657843088025,MATH 10A,A02,083736,Patchell; Gregory David,20,0,30,10
1657843088025,MATH 10A,A03,083737,Patchell; Gregory David,16,0,30,14
1657843094055,MATH 10B,A01,083207,Lim; Seonhee,8,0,34,26
1657843094055,MATH 10B,A02,083208,Lim; Seonhee,10,0,35,25
1657843094055,MATH 10B,A03,093472,Lim; Seonhee,7,0,34,27
1657843094055,MATH 10B,B01,083739,Sinha; Shubham,14,0,30,16
1657843100086,MATH 18,A01,083743,Cinel; Cameron Alexander,9,0,30,21
1657843100086,MATH 18,A02,083744,Cinel; Cameron Alexander,18,0,30,12
1657843100086,MATH 18,A03,083745,Cinel; Cameron Alexander,10,0,30,20
1657843100086,MATH 18,B01,083748,Rideout; David Porter,5,0,37,32
1657843100086,MATH 18,B02,083749,Rideout; David Porter,5,0,36,31
1657843100086,MATH 18,B03,083750,Rideout; David Porter,3,0,37,34
1657843100086,MATH 18,B04,083751,Rideout; David Porter,6,0,36,30
1657843100086,MATH 18,B05,093473,Rideout; David Porter,6,0,36,30
1657843100086,MATH 18,B06,093474,Rideout; David Porter,6,0,36,30
1657843106108,MATH 20A,A01,083754,Zheng; Zequn,14,0,40,26
1657843112136,MATH 20B,A01,083756,Briones; Jor-el Thomas Caparas,4,0,36,32
1657843112136,MATH 20B,A02,083757,Briones; Jor-el Thomas Caparas,1,0,36,35
1657843112136,MATH 20B,A03,093475,Briones; Jor-el Thomas Caparas,2,0,36,34
1657843118158,MATH 20C,A01,083760,Briones; Jor-el Thomas Caparas,1,0,35,34
1657843118158,MATH 20C,A02,083761,Briones; Jor-el Thomas Caparas,8,0,35,27
1657843118158,MATH 20C,A03,093476,Briones; Jor-el Thomas Caparas,0,1,36,36
1657843118158,MATH 20C,B01,083762,Bach; Quang Tran,1,0,30,29
1657843124184,MATH 20D,A01,083765,Tran; Brian Kha,5,0,30,25
1657843124184,MATH 20D,A02,083766,Tran; Brian Kha,5,0,30,25
1657843124184,MATH 20D,A03,083767,Tran; Brian Kha,5,0,30,25
1657843130207,MATH 20E,A01,083771,Ganguly; Soumya,10,0,32,22
1657843130207,MATH 20E,A02,083772,Ganguly; Soumya,6,0,32,26
1657843130207,MATH 20E,B01,083773,Ciotti; Benjamin,20,0,35,15
1657843130207,MATH 20E,B02,083774,Ciotti; Benjamin,18,0,35,17
1657843136239,MATH 103A,A01,083777,Greenfeld; Be'Eri,3,0,36,33
1657843136239,MATH 103A,A02,083778,Greenfeld; Be'Eri,5,0,36,31
1657843136239,MATH 103A,A03,093561,Greenfeld; Be'Eri,6,0,36,30
1657843136239,MATH 103A,B01,083779,Greenfeld; Be'Eri,7,0,36,29
1657843136239,MATH 103A,B02,083780,Greenfeld; Be'Eri,4,0,36,32
1657843136239,MATH 103A,B03,093562,Greenfeld; Be'Eri,3,0,36,33
1657843142263,MATH 105,A01,085443,Carter; Anne Toulson,15,0,35,20
1657843142263,MATH 105,A02,093477,Carter; Anne Toulson,20,0,35,15
1657843148286,MATH 109,A01,083213,Ganzberger; Geoffrey Michael,3,0,34,31
1657843148286,MATH 109,A02,083214,Ganzberger; Geoffrey Michael,4,0,34,30
1657843148286,MATH 109,A03,093478,Ganzberger; Geoffrey Michael,2,0,34,32
1657843148286,MATH 109,B01,083215,Ganzberger; Geoffrey Michael,1,0,32,31
1657843148286,MATH 109,B02,083216,Ganzberger; Geoffrey Michael,2,0,32,30
1657843148286,MATH 109,B03,093479,Ganzberger; Geoffrey Michael,8,0,32,24
1657843154309,MATH 142A,A01,083219,Chow; Bennett,7,0,32,25
1657843154309,MATH 142A,A02,083220,Chow; Bennett,10,0,32,22
1657843154309,MATH 142A,A03,093480,Chow; Bennett,9,0,32,23
1657843154309,MATH 142A,B03,093481,Chow; Bennett,8,0,32,24
1657843154309,MATH 142A,B04,093558,Chow; Bennett,13,0,32,19
1657843154309,MATH 142A,B05,093559,Chow; Bennett,7,0,32,25
1657843160338,MATH 193A,A01,083224,Rotar; Vladimir,8,0,34,26
1657843160338,MATH 193A,A02,083225,Rotar; Vladimir,10,0,34,24
1657843160338,MATH 193A,A03,083781,Rotar; Vladimir,5,0,34,29
1657843160338,MATH 193A,A04,083782,Rotar; Vladimir,11,0,34,23
1657843160338,MATH 193A,A05,093482,Rotar; Vladimir,10,0,34,24
1657843166362,MATH 197,001,091859,McAuley; Julian John,9999,0,9999,0
1657843166362,MATH 197,002,095566,Kedlaya; Kiran S.,9997,0,9999,2
1657843166362,MATH 197,003,095567,Xiao; Ming,9999,0,9999,0
1657843166362,MATH 197,004,095571,Perols; Johan Lars,9998,0,9999,1
1657843173437,COGS 9,A01,083615,Shannon; Kyle Michael,9,0,75,66
1657843179472,COGS 11,A01,083617,Boyle; Mary E. T.,23,0,48,25
1657843185494,COGS 13,A01,083071,Bastos; Amalia Pinkusfeld,11,0,71,60
1657843191520,COGS 14A,A01,092681,Semenuks; Arturs,5,1,100,95
1657843197548,COGS 14B,A01,083073,Cheng; Tzu-Han,6,0,63,57
1657843203572,COGS 17,A01,092677,Semenuks; Arturs,6,0,81,75
1657843209600,COGS 100,A01,083619,Allen; Michael Gordon,17,0,70,53
1657843215622,COGS 101A,A01,083621,Davis; Joshua Daniel,9,0,68,59
1657843221648,COGS 101B,A01,091572,Allen; Michael Gordon,12,0,65,53
1657843227672,COGS 101C,A01,083625,Delgado; Tania,17,0,35,18
1657843233695,COGS 107A,A01,083627,Boyle; Mary E. T.,14,0,60,46
1657843239790,COGS 118A,A01,083075,Gupta; Anjum,21,0,76,55
1657843245813,CSE 3,A50,083646,Miranda; Gregory Joseph,24,0,50,26
1657843251837,CSE 8A,A50,083650,Miranda; Gregory Joseph,17,1,56,39
1657843257859,CSE 11,A01,083080,Cao; Yingjun,6,15,40,34
1657843263899,CSE 12,A01,083652,Krause-Levy; Sophia Louisa,29,1,120,91
1657843269922,CSE 15L,A01,083654,Morris; Justin Loren,9,0,50,41
1657843269922,CSE 15L,A02,083655,Morris; Justin Loren,9,0,50,41
1657843275944,CSE 20,A01,083657,Tran; Khoa Dang,39,0,80,41
1657843281968,CSE 21,A01,095574,Bach; Quang Tran,22,0,48,26
1657843287991,CSE 30,A01,083084,Eldon; John,6,0,80,74
1657843287991,CSE 30,B01,095061,Bhaskar; Nishant,9,0,50,41
1657843294014,CSE 100,A01,083659,Cao; Yingjun,5,4,70,65
1657843300041,CSE 134B,A01,083661,Powell; Thomas Allan,24,0,100,76
1657843306069,CSE 140,A01,083663,Gungor; Onat,15,0,85,70
1657843312092,CSE 140L,A01,083088,Eldon; John,23,0,100,77
1657843318142,CSE 175,A01,083665,Kumar; Rakesh,3,0,25,22
1657843324164,CSE 190,A00,092507,Dubnov; Shlomo,8,0,20,12
1657843330193,ECE 45,A01,083139,Congero; Spencer William,6,0,75,69
1657843336216,ECE 65,A50,083695,Saad; Andrew S,12,0,30,18
1657843336216,ECE 65,A51,095125,Saad; Andrew S,24,0,26,2
1657843342240,ECE 109,A01,091882,Touri; Behrouz,20,0,70,50
1657843348265,ECE 180,A00,083140,Abi Samra; Nicholas Camill,1,0,30,29
1657843348265,ECE 180,B00,083141,Abi Samra; Nicholas Camill,0,0,30,30
1657843354291,MATH 10A,A01,083735,Patchell; Gregory David,2,0,30,28
1657843354291,MATH 10A,A02,083736,Patchell; Gregory David,20,0,30,10
1657843354291,MATH 10A,A03,083737,Patchell; Gregory David,16,0,30,14
1657843360323,MATH 10B,A01,083207,Lim; Seonhee,8,0,34,26
1657843360323,MATH 10B,A02,083208,Lim; Seonhee,10,0,35,25
1657843360323,MATH 10B,A03,093472,Lim; Seonhee,7,0,34,27
1657843360323,MATH 10B,B01,083739,Sinha; Shubham,14,0,30,16
1657843366355,MATH 18,A01,083743,Cinel; Cameron Alexander,9,0,30,21
1657843366355,MATH 18,A02,083744,Cinel; Cameron Alexander,18,0,30,12
1657843366355,MATH 18,A03,083745,Cinel; Cameron Alexander,10,0,30,20
1657843366355,MATH 18,B01,083748,Rideout; David Porter,5,0,37,32
1657843366355,MATH 18,B02,083749,Rideout; David Porter,5,0,36,31
1657843366355,MATH 18,B03,083750,Rideout; David Porter,3,0,37,34
1657843366355,MATH 18,B04,083751,Rideout; David Porter,6,0,36,30
1657843366355,MATH 18,B05,093473,Rideout; David Porter,6,0,36,30
1657843366355,MATH 18,B06,093474,Rideout; David Porter,6,0,36,30
1657843372381,MATH 20A,A01,083754,Zheng; Zequn,14,0,40,26
1657843378404,MATH 20B,A01,083756,Briones; Jor-el Thomas Caparas,4,0,36,32
1657843378404,MATH 20B,A02,083757,Briones; Jor-el Thomas Caparas,1,0,36,35
1657843378404,MATH 20B,A03,093475,Briones; Jor-el Thomas Caparas,2,0,36,34
1657843384432,MATH 20C,A01,083760,Briones; Jor-el Thomas Caparas,1,0,35,34
1657843384432,MATH 20C,A02,083761,Briones; Jor-el Thomas Caparas,8,0,35,27
1657843384432,MATH 20C,A03,093476,Briones; Jor-el Thomas Caparas,0,1,36,36
1657843384432,MATH 20C,B01,083762,Bach; Quang Tran,1,0,30,29
1657843390460,MATH 20D,A01,083765,Tran; Brian Kha,5,0,30,25
1657843390460,MATH 20D,A02,083766,Tran; Brian Kha,5,0,30,25
1657843390460,MATH 20D,A03,083767,Tran; Brian Kha,5,0,30,25
1657843396484,MATH 20E,A01,083771,Ganguly; Soumya,10,0,32,22
1657843396484,MATH 20E,A02,083772,Ganguly; Soumya,6,0,32,26
1657843396484,MATH 20E,B01,083773,Ciotti; Benjamin,20,0,35,15
1657843396484,MATH 20E,B02,083774,Ciotti; Benjamin,18,0,35,17
1657843402507,MATH 103A,A01,083777,Greenfeld; Be'Eri,3,0,36,33
1657843402507,MATH 103A,A02,083778,Greenfeld; Be'Eri,5,0,36,31
1657843402507,MATH 103A,A03,093561,Greenfeld; Be'Eri,6,0,36,30
1657843402507,MATH 103A,B01,083779,Greenfeld; Be'Eri,7,0,36,29
1657843402507,MATH 103A,B02,083780,Greenfeld; Be'Eri,4,0,36,32
1657843402507,MATH 103A,B03,093562,Greenfeld; Be'Eri,3,0,36,33
1657843408533,MATH 105,A01,085443,Carter; Anne Toulson,15,0,35,20
1657843408533,MATH 105,A02,093477,Carter; Anne Toulson,20,0,35,15
1657843414562,MATH 109,A01,083213,Ganzberger; Geoffrey Michael,3,0,34,31
1657843414562,MATH 109,A02,083214,Ganzberger; Geoffrey Michael,4,0,34,30
1657843414562,MATH 109,A03,093478,Ganzberger; Geoffrey Michael,2,0,34,32
1657843414562,MATH 109,B01,083215,Ganzberger; Geoffrey Michael,1,0,32,31
1657843414562,MATH 109,B02,083216,Ganzberger; Geoffrey Michael,2,0,32,30
1657843414562,MATH 109,B03,093479,Ganzberger; Geoffrey Michael,8,0,32,24
1657843420585,MATH 142A,A01,083219,Chow; Bennett,7,0,32,25
1657843420585,MATH 142A,A02,083220,Chow; Bennett,10,0,32,22
1657843420585,MATH 142A,A03,093480,Chow; Bennett,9,0,32,23
1657843420585,MATH 142A,B03,093481,Chow; Bennett,8,0,32,24
1657843420585,MATH 142A,B04,093558,Chow; Bennett,13,0,32,19
1657843420585,MATH 142A,B05,093559,Chow; Bennett,7,0,32,25
1657843426612,MATH 193A,A01,083224,Rotar; Vladimir,8,0,34,26
1657843426612,MATH 193A,A02,083225,Rotar; Vladimir,10,0,34,24
1657843426612,MATH 193A,A03,083781,Rotar; Vladimir,5,0,34,29
1657843426612,MATH 193A,A04,083782,Rotar; Vladimir,11,0,34,23
1657843426612,MATH 193A,A05,093482,Rotar; Vladimir,10,0,34,24
1657843432638,MATH 197,001,091859,McAuley; Julian John,9999,0,9999,0
1657843432638,MATH 197,002,095566,Kedlaya; Kiran S.,9997,0,9999,2
1657843432638,MATH 197,003,095567,Xiao; Ming,9999,0,9999,0
1657843432638,MATH 197,004,095571,Perols; Johan Lars,9998,0,9999,1
1657843439697,COGS 9,A01,083615,Shannon; Kyle Michael,9,0,75,66
1657843445726,COGS 11,A01,083617,Boyle; Mary E. T.,23,0,48,25
1657843451754,COGS 13,A01,083071,Bastos; Amalia Pinkusfeld,11,0,71,60
1657843457776,COGS 14A,A01,092681,Semenuks; Arturs,5,1,100,95
1657843463800,COGS 14B,A01,083073,Cheng; Tzu-Han,6,0,63,57
1657843469831,COGS 17,A01,092677,Semenuks; Arturs,6,0,81,75
1657843475859,COGS 100,A01,083619,Allen; Michael Gordon,17,0,70,53
1657843481886,COGS 101A,A01,083621,Davis; Joshua Daniel,9,0,68,59
1657843487912,COGS 101B,A01,091572,Allen; Michael Gordon,12,0,65,53
1657843493936,COGS 101C,A01,083625,Delgado; Tania,17,0,35,18
1657843499963,COGS 107A,A01,083627,Boyle; Mary E. T.,14,0,60,46
1657843505986,COGS 118A,A01,083075,Gupta; Anjum,21,0,76,55
1657843512009,CSE 3,A50,083646,Miranda; Gregory Joseph,24,0,50,26
1657843518045,CSE 8A,A50,083650,Miranda; Gregory Joseph,17,1,56,39
1657843524068,CSE 11,A01,083080,Cao; Yingjun,6,15,40,34
1657843530096,CSE 12,A01,083652,Krause-Levy; Sophia Louisa,29,1,120,91
1657843536118,CSE 15L,A01,083654,Morris; Justin Loren,9,0,50,41
1657843536118,CSE 15L,A02,083655,Morris; Justin Loren,9,0,50,41
1657843542143,CSE 20,A01,083657,Tran; Khoa Dang,39,0,80,41
1657843548167,CSE 21,A01,095574,Bach; Quang Tran,22,0,48,26
1657843554195,CSE 30,A01,083084,Eldon; John,6,0,80,74
1657843554195,CSE 30,B01,095061,Bhaskar; Nishant,9,0,50,41
1657843560222,CSE 100,A01,083659,Cao; Yingjun,5,4,70,65
1657843566246,CSE 134B,A01,083661,Powell; Thomas Allan,24,0,100,76
1657843572270,CSE 140,A01,083663,Gungor; Onat,15,0,85,70
1657843578293,CSE 140L,A01,083088,Eldon; John,23,0,100,77
1657843584317,CSE 175,A01,083665,Kumar; Rakesh,3,0,25,22
1657843590340,CSE 190,A00,092507,Dubnov; Shlomo,8,0,20,12
1657843596364,ECE 45,A01,083139,Congero; Spencer William,6,0,75,69
1657843602402,ECE 65,A50,083695,Saad; Andrew S,12,0,30,18
1657843602402,ECE 65,A51,095125,Saad; Andrew S,24,0,26,2
1657843608436,ECE 109,A01,091882,Touri; Behrouz,20,0,70,50
1657843614462,ECE 180,A00,083140,Abi Samra; Nicholas Camill,1,0,30,29
1657843614462,ECE 180,B00,083141,Abi Samra; Nicholas Camill,0,0,30,30
1657843620490,MATH 10A,A01,083735,Patchell; Gregory David,2,0,30,28
1657843620490,MATH 10A,A02,083736,Patchell; Gregory David,20,0,30,10
1657843620490,MATH 10A,A03,083737,Patchell; Gregory David,16,0,30,14
1657843626523,MATH 10B,A01,083207,Lim; Seonhee,8,0,34,26
1657843626523,MATH 10B,A02,083208,Lim; Seonhee,10,0,35,25
1657843626523,MATH 10B,A03,093472,Lim; Seonhee,7,0,34,27
1657843626523,MATH 10B,B01,083739,Sinha; Shubham,14,0,30,16
1657843632555,MATH 18,A01,083743,Cinel; Cameron Alexander,9,0,30,21
1657843632555,MATH 18,A02,083744,Cinel; Cameron Alexander,18,0,30,12
1657843632555,MATH 18,A03,083745,Cinel; Cameron Alexander,10,0,30,20
1657843632555,MATH 18,B01,083748,Rideout; David Porter,5,0,37,32
1657843632555,MATH 18,B02,083749,Rideout; David Porter,5,0,36,31
1657843632555,MATH 18,B03,083750,Rideout; David Porter,3,0,37,34
1657843632555,MATH 18,B04,083751,Rideout; David Porter,6,0,36,30
1657843632555,MATH 18,B05,093473,Rideout; David Porter,6,0,36,30
1657843632555,MATH 18,B06,093474,Rideout; David Porter,6,0,36,30
1657843638578,MATH 20A,A01,083754,Zheng; Zequn,14,0,40,26
1657843644602,MATH 20B,A01,083756,Briones; Jor-el Thomas Caparas,4,0,36,32
1657843644602,MATH 20B,A02,083757,Briones; Jor-el Thomas Caparas,1,0,36,35
1657843644602,MATH 20B,A03,093475,Briones; Jor-el Thomas Caparas,2,0,36,34
1657843650626,MATH 20C,A01,083760,Briones; Jor-el Thomas Caparas,1,0,35,34
1657843650626,MATH 20C,A02,083761,Briones; Jor-el Thomas Caparas,8,0,35,27
1657843650626,MATH 20C,A03,093476,Briones; Jor-el Thomas Caparas,0,1,36,36
1657843650626,MATH 20C,B01,083762,Bach; Quang Tran,1,0,30,29
1657843656664,MATH 20D,A01,083765,Tran; Brian Kha,5,0,30,25
1657843656664,MATH 20D,A02,083766,Tran; Brian Kha,5,0,30,25
1657843656664,MATH 20D,A03,083767,Tran; Brian Kha,5,0,30,25
1657843662688,MATH 20E,A01,083771,Ganguly; Soumya,10,0,32,22
1657843662688,MATH 20E,A02,083772,Ganguly; Soumya,6,0,32,26
1657843662688,MATH 20E,B01,083773,Ciotti; Benjamin,20,0,35,15
1657843662688,MATH 20E,B02,083774,Ciotti; Benjamin,18,0,35,17
1657843668718,MATH 103A,A01,083777,Greenfeld; Be'Eri,3,0,36,33
1657843668718,MATH 103A,A02,083778,Greenfeld; Be'Eri,5,0,36,31
1657843668718,MATH 103A,A03,093561,Greenfeld; Be'Eri,6,0,36,30
1657843668718,MATH 103A,B01,083779,Greenfeld; Be'Eri,7,0,36,29
1657843668718,MATH 103A,B02,083780,Greenfeld; Be'Eri,4,0,36,32
1657843668718,MATH 103A,B03,093562,Greenfeld; Be'Eri,3,0,36,33
1657843674743,MATH 105,A01,085443,Carter; Anne Toulson,15,0,35,20
1657843674743,MATH 105,A02,093477,Carter; Anne Toulson,20,0,35,15
1657843680766,MATH 109,A01,083213,Ganzberger; Geoffrey Michael,3,0,34,31
1657843680766,MATH 109,A02,083214,Ganzberger; Geoffrey Michael,4,0,34,30
1657843680766,MATH 109,A03,093478,Ganzberger; Geoffrey Michael,2,0,34,32
1657843680766,MATH 109,B01,083215,Ganzberger; Geoffrey Michael,1,0,32,31
1657843680766,MATH 109,B02,083216,Ganzberger; Geoffrey Michael,2,0,32,30
1657843680766,MATH 109,B03,093479,Ganzberger; Geoffrey Michael,8,0,32,24
1657843686798,MATH 142A,A01,083219,Chow; Bennett,7,0,32,25
1657843686798,MATH 142A,A02,083220,Chow; Bennett,10,0,32,22
1657843686798,MATH 142A,A03,093480,Chow; Bennett,9,0,32,23
1657843686798,MATH 142A,B03,093481,Chow; Bennett,8,0,32,24
1657843686798,MATH 142A,B04,093558,Chow; Bennett,13,0,32,19
1657843686798,MATH 142A,B05,093559,Chow; Bennett,7,0,32,25
1657843692821,MATH 193A,A01,083224,Rotar; Vladimir,8,0,34,26
1657843692821,MATH 193A,A02,083225,Rotar; Vladimir,10,0,34,24
1657843692821,MATH 193A,A03,083781,Rotar; Vladimir,5,0,34,29
1657843692821,MATH 193A,A04,083782,Rotar; Vladimir,11,0,34,23
1657843692821,MATH 193A,A05,093482,Rotar; Vladimir,10,0,34,24
1657843698847,MATH 197,001,091859,McAuley; Julian John,9999,0,9999,0
1657843698847,MATH 197,002,095566,Kedlaya; Kiran S.,9997,0,9999,2
1657843698847,MATH 197,003,095567,Xiao; Ming,9999,0,9999,0
1657843698847,MATH 197,004,095571,Perols; Johan Lars,9998,0,9999,1
1657843705912,COGS 9,A01,083615,Shannon; Kyle Michael,9,0,75,66
1657843711946,COGS 11,A01,083617,Boyle; Mary E. T.,23,0,48,25
1657843717974,COGS 13,A01,083071,Bastos; Amalia Pinkusfeld,11,0,71,60
1657843724006,COGS 14A,A01,092681,Semenuks; Arturs,5,1,100,95
1657843730033,COGS 14B,A01,083073,Cheng; Tzu-Han,6,0,63,57
1657843736056,COGS 17,A01,092677,Semenuks; Arturs,6,0,81,75
1657843742088,COGS 100,A01,083619,Allen; Michael Gordon,17,0,70,53
1657843748114,COGS 101A,A01,083621,Davis; Joshua Daniel,9,0,68,59
1657843754136,COGS 101B,A01,091572,Allen; Michael Gordon,12,0,65,53
1657843760160,COGS 101C,A01,083625,Delgado; Tania,17,0,35,18
1657843766186,COGS 107A,A01,083627,Boyle; Mary E. T.,14,0,60,46
1657843772212,COGS 118A,A01,083075,Gupta; Anjum,21,0,76,55
1657843778241,CSE 3,A50,083646,Miranda; Gregory Joseph,24,0,50,26
1657843784266,CSE 8A,A50,083650,Miranda; Gregory Joseph,17,1,56,39
1657843790288,CSE 11,A01,083080,Cao; Yingjun,6,15,40,34
1657843796310,CSE 12,A01,083652,Krause-Levy; Sophia Louisa,29,1,120,91
1657843802341,CSE 15L,A01,083654,Morris; Justin Loren,9,0,50,41
1657843802341,CSE 15L,A02,083655,Morris; Justin Loren,9,0,50,41
1657843808363,CSE 20,A01,083657,Tran; Khoa Dang,39,0,80,41
1657843814385,CSE 21,A01,095574,Bach; Quang Tran,22,0,48,26
1657843820410,CSE 30,A01,083084,Eldon; John,6,0,80,74
1657843820410,CSE 30,B01,095061,Bhaskar; Nishant,9,0,50,41
1657843826432,CSE 100,A01,083659,Cao; Yingjun,5,4,70,65
1657843832460,CSE 134B,A01,083661,Powell; Thomas Allan,24,0,100,76
1657843838590,CSE 140,A01,083663,Gungor; Onat,15,0,85,70
1657843844616,CSE 140L,A01,083088,Eldon; John,23,0,100,77
1657843850648,CSE 175,A01,083665,Kumar; Rakesh,3,0,25,22
1657843856674,CSE 190,A00,092507,Dubnov; Shlomo,8,0,20,12
1657843862701,ECE 45,A01,083139,Congero; Spencer William,6,0,75,69
1657843868729,ECE 65,A50,083695,Saad; Andrew S,12,0,30,18
1657843868729,ECE 65,A51,095125,Saad; Andrew S,24,0,26,2
1657843874758,ECE 109,A01,091882,Touri; Behrouz,20,0,70,50
1657843880780,ECE 180,A00,083140,Abi Samra; Nicholas Camill,1,0,30,29
1657843880780,ECE 180,B00,083141,Abi Samra; Nicholas Camill,0,0,30,30
1657843886820,MATH 10A,A01,083735,Patchell; Gregory David,2,0,30,28
1657843886820,MATH 10A,A02,083736,Patchell; Gregory David,20,0,30,10
1657843886820,MATH 10A,A03,083737,Patchell; Gregory David,16,0,30,14
1657843892850,MATH 10B,A01,083207,Lim; Seonhee,8,0,34,26
1657843892850,MATH 10B,A02,083208,Lim; Seonhee,10,0,35,25
1657843892850,MATH 10B,A03,093472,Lim; Seonhee,7,0,34,27
1657843892850,MATH 10B,B01,083739,Sinha; Shubham,14,0,30,16
1657843898880,MATH 18,A01,083743,Cinel; Cameron Alexander,9,0,30,21
1657843898880,MATH 18,A02,083744,Cinel; Cameron Alexander,18,0,30,12
1657843898880,MATH 18,A03,083745,Cinel; Cameron Alexander,10,0,30,20
1657843898880,MATH 18,B01,083748,Rideout; David Porter,5,0,37,32
1657843898880,MATH 18,B02,083749,Rideout; David Porter,5,0,36,31
1657843898880,MATH 18,B03,083750,Rideout; David Porter,3,0,37,34
1657843898880,MATH 18,B04,083751,Rideout; David Porter,6,0,36,30
1657843898880,MATH 18,B05,093473,Rideout; David Porter,6,0,36,30
1657843898880,MATH 18,B06,093474,Rideout; David Porter,6,0,36,30
1657843904916,MATH 20A,A01,083754,Zheng; Zequn,14,0,40,26
1657843910938,MATH 20B,A01,083756,Briones; Jor-el Thomas Caparas,4,0,36,32
1657843910938,MATH 20B,A02,083757,Briones; Jor-el Thomas Caparas,1,0,36,35
1657843910938,MATH 20B,A03,093475,Briones; Jor-el Thomas Caparas,2,0,36,34
1657843916961,MATH 20C,A01,083760,Briones; Jor-el Thomas Caparas,1,0,35,34
1657843916961,MATH 20C,A02,083761,Briones; Jor-el Thomas Caparas,8,0,35,27
1657843916961,MATH 20C,A03,093476,Briones; Jor-el Thomas Caparas,0,1,36,36
1657843916961,MATH 20C,B01,083762,Bach; Quang Tran,1,0,30,29
1657843922984,MATH 20D,A01,083765,Tran; Brian Kha,5,0,30,25
1657843922984,MATH 20D,A02,083766,Tran; Brian Kha,5,0,30,25
1657843922984,MATH 20D,A03,083767,Tran; Brian Kha,5,0,30,25
1657843929009,MATH 20E,A01,083771,Ganguly; Soumya,10,0,32,22
1657843929009,MATH 20E,A02,083772,Ganguly; Soumya,6,0,32,26
1657843929009,MATH 20E,B01,083773,Ciotti; Benjamin,20,0,35,15
1657843929009,MATH 20E,B02,083774,Ciotti; Benjamin,18,0,35,17
1657843935033,MATH 103A,A01,083777,Greenfeld; Be'Eri,3,0,36,33
1657843935033,MATH 103A,A02,083778,Greenfeld; Be'Eri,5,0,36,31
1657843935033,MATH 103A,A03,093561,Greenfeld; Be'Eri,6,0,36,30
1657843935033,MATH 103A,B01,083779,Greenfeld; Be'Eri,7,0,36,29
1657843935033,MATH 103A,B02,083780,Greenfeld; Be'Eri,4,0,36,32
1657843935033,MATH 103A,B03,093562,Greenfeld; Be'Eri,3,0,36,33
1657843941073,MATH 105,A01,085443,Carter; Anne Toulson,15,0,35,20
1657843941073,MATH 105,A02,093477,Carter; Anne Toulson,20,0,35,15
1657843947097,MATH 109,A01,083213,Ganzberger; Geoffrey Michael,3,0,34,31
1657843947097,MATH 109,A02,083214,Ganzberger; Geoffrey Michael,4,0,34,30
1657843947097,MATH 109,A03,093478,Ganzberger; Geoffrey Michael,2,0,34,32
1657843947097,MATH 109,B01,083215,Ganzberger; Geoffrey Michael,1,0,32,31
1657843947097,MATH 109,B02,083216,Ganzberger; Geoffrey Michael,2,0,32,30
1657843947097,MATH 109,B03,093479,Ganzberger; Geoffrey Michael,8,0,32,24
1657843953122,MATH 142A,A01,083219,Chow; Bennett,7,0,32,25
1657843953122,MATH 142A,A02,083220,Chow; Bennett,10,0,32,22
1657843953122,MATH 142A,A03,093480,Chow; Bennett,9,0,32,23
1657843953122,MATH 142A,B03,093481,Chow; Bennett,8,0,32,24
1657843953122,MATH 142A,B04,093558,Chow; Bennett,13,0,32,19
1657843953122,MATH 142A,B05,093559,Chow; Bennett,7,0,32,25
1657843959152,MATH 193A,A01,083224,Rotar; Vladimir,8,0,34,26
1657843959152,MATH 193A,A02,083225,Rotar; Vladimir,10,0,34,24
1657843959152,MATH 193A,A03,083781,Rotar; Vladimir,5,0,34,29
1657843959152,MATH 193A,A04,083782,Rotar; Vladimir,11,0,34,23
1657843959152,MATH 193A,A05,093482,Rotar; Vladimir,10,0,34,24
1657843965177,MATH 197,001,091859,McAuley; Julian John,9999,0,9999,0
1657843965177,MATH 197,002,095566,Kedlaya; Kiran S.,9997,0,9999,2
1657843965177,MATH 197,003,095567,Xiao; Ming,9999,0,9999,0
1657843965177,MATH 197,004,095571,Perols; Johan Lars,9998,0,9999,1
1657843972246,COGS 9,A01,083615,Shannon; Kyle Michael,9,0,75,66
1657843978270,COGS 11,A01,083617,Boyle; Mary E. T.,23,0,48,25
1657843984304,COGS 13,A01,083071,Bastos; Amalia Pinkusfeld,11,0,71,60
1657843990334,COGS 14A,A01,092681,Semenuks; Arturs,5,1,100,95
1657843996356,COGS 14B,A01,083073,Cheng; Tzu-Han,6,0,63,57
1657844002379,COGS 17,A01,092677,Semenuks; Arturs,6,0,81,75
1657844008404,COGS 100,A01,083619,Allen; Michael Gordon,17,0,70,53
1657844014427,COGS 101A,A01,083621,Davis; Joshua Daniel,9,0,68,59
1657844020456,COGS 101B,A01,091572,Allen; Michael Gordon,12,0,65,53
1657844026479,COGS 101C,A01,083625,Delgado; Tania,17,0,35,18
1657844032505,COGS 107A,A01,083627,Boyle; Mary E. T.,14,0,60,46
1657844038529,COGS 118A,A01,083075,Gupta; Anjum,21,0,76,55
1657844044553,CSE 3,A50,083646,Miranda; Gregory Joseph,24,0,50,26
1657844050582,CSE 8A,A50,083650,Miranda; Gregory Joseph,17,1,56,39
1657844056611,CSE 11,A01,083080,Cao; Yingjun,6,15,40,34
1657844062641,CSE 12,A01,083652,Krause-Levy; Sophia Louisa,29,1,120,91
1657844068667,CSE 15L,A01,083654,Morris; Justin Loren,9,0,50,41
1657844068667,CSE 15L,A02,083655,Morris; Justin Loren,9,0,50,41
1657844074691,CSE 20,A01,083657,Tran; Khoa Dang,39,0,80,41
1657844080717,CSE 21,A01,095574,Bach; Quang Tran,22,0,48,26
1657844086741,CSE 30,A01,083084,Eldon; John,6,0,80,74
1657844086741,CSE 30,B01,095061,Bhaskar; Nishant,9,0,50,41
1657844092762,CSE 100,A01,083659,Cao; Yingjun,5,4,70,65
1657844098788,CSE 134B,A01,083661,Powell; Thomas Allan,24,0,100,76
1657844104818,CSE 140,A01,083663,Gungor; Onat,15,0,85,70
1657844110852,CSE 140L,A01,083088,Eldon; John,23,0,100,77
1657844116877,CSE 175,A01,083665,Kumar; Rakesh,3,0,25,22
1657844122899,CSE 190,A00,092507,Dubnov; Shlomo,8,0,20,12
1657844128923,ECE 45,A01,083139,Congero; Spencer William,6,0,75,69
1657844134950,ECE 65,A50,083695,Saad; Andrew S,12,0,30,18
1657844134950,ECE 65,A51,095125,Saad; Andrew S,24,0,26,2
1657844140989,ECE 109,A01,091882,Touri; Behrouz,20,0,70,50
1657844147016,ECE 180,A00,083140,Abi Samra; Nicholas Camill,1,0,30,29
1657844147016,ECE 180,B00,083141,Abi Samra; Nicholas Camill,0,0,30,30
1657844153040,MATH 10A,A01,083735,Patchell; Gregory David,2,0,30,28
1657844153040,MATH 10A,A02,083736,Patchell; Gregory David,20,0,30,10
1657844153040,MATH 10A,A03,083737,Patchell; Gregory David,16,0,30,14
1657844159070,MATH 10B,A01,083207,Lim; Seonhee,8,0,34,26
1657844159070,MATH 10B,A02,083208,Lim; Seonhee,10,0,35,25
1657844159070,MATH 10B,A03,093472,Lim; Seonhee,7,0,34,27
1657844159070,MATH 10B,B01,083739,Sinha; Shubham,14,0,30,16
1657844165098,MATH 18,A01,083743,Cinel; Cameron Alexander,9,0,30,21
1657844165098,MATH 18,A02,083744,Cinel; Cameron Alexander,18,0,30,12
1657844165098,MATH 18,A03,083745,Cinel; Cameron Alexander,10,0,30,20
1657844165098,MATH 18,B01,083748,Rideout; David Porter,5,0,37,32
1657844165098,MATH 18,B02,083749,Rideout; David Porter,5,0,36,31
1657844165098,MATH 18,B03,083750,Rideout; David Porter,3,0,37,34
1657844165098,MATH 18,B04,083751,Rideout; David Porter,6,0,36,30
1657844165098,MATH 18,B05,093473,Rideout; David Porter,6,0,36,30
1657844165098,MATH 18,B06,093474,Rideout; David Porter,6,0,36,30
1657844171125,MATH 20A,A01,083754,Zheng; Zequn,14,0,40,26
1657844177154,MATH 20B,A01,083756,Briones; Jor-el Thomas Caparas,4,0,36,32
1657844177154,MATH 20B,A02,083757,Briones; Jor-el Thomas Caparas,1,0,36,35
1657844177154,MATH 20B,A03,093475,Briones; Jor-el Thomas Caparas,2,0,36,34
1657844183181,MATH 20C,A01,083760,Briones; Jor-el Thomas Caparas,1,0,35,34
1657844183181,MATH 20C,A02,083761,Briones; Jor-el Thomas Caparas,8,0,35,27
1657844183181,MATH 20C,A03,093476,Briones; Jor-el Thomas Caparas,0,1,36,36
1657844183181,MATH 20C,B01,083762,Bach; Quang Tran,1,0,30,29
1657844189213,MATH 20D,A01,083765,Tran; Brian Kha,5,0,30,25
1657844189213,MATH 20D,A02,083766,Tran; Brian Kha,5,0,30,25
1657844189213,MATH 20D,A03,083767,Tran; Brian Kha,5,0,30,25
1657844195241,MATH 20E,A01,083771,Ganguly; Soumya,10,0,32,22
1657844195241,MATH 20E,A02,083772,Ganguly; Soumya,6,0,32,26
1657844195241,MATH 20E,B01,083773,Ciotti; Benjamin,20,0,35,15
1657844195241,MATH 20E,B02,083774,Ciotti; Benjamin,18,0,35,17
1657844201266,MATH 103A,A01,083777,Greenfeld; Be'Eri,3,0,36,33
1657844201266,MATH 103A,A02,083778,Greenfeld; Be'Eri,5,0,36,31
1657844201266,MATH 103A,A03,093561,Greenfeld; Be'Eri,6,0,36,30
1657844201266,MATH 103A,B01,083779,Greenfeld; Be'Eri,7,0,36,29
1657844201266,MATH 103A,B02,083780,Greenfeld; Be'Eri,4,0,36,32
1657844201266,MATH 103A,B03,093562,Greenfeld; Be'Eri,3,0,36,33
1657844207291,MATH 105,A01,085443,Carter; Anne Toulson,15,0,35,20
1657844207291,MATH 105,A02,093477,Carter; Anne Toulson,20,0,35,15
1657844213320,MATH 109,A01,083213,Ganzberger; Geoffrey Michael,3,0,34,31
1657844213320,MATH 109,A02,083214,Ganzberger; Geoffrey Michael,4,0,34,30
1657844213320,MATH 109,A03,093478,Ganzberger; Geoffrey Michael,2,0,34,32
1657844213320,MATH 109,B01,083215,Ganzberger; Geoffrey Michael,1,0,32,31
1657844213320,MATH 109,B02,083216,Ganzberger; Geoffrey Michael,2,0,32,30
1657844213320,MATH 109,B03,093479,Ganzberger; Geoffrey Michael,8,0,32,24
1657844219343,MATH 142A,A01,083219,Chow; Bennett,7,0,32,25
1657844219343,MATH 142A,A02,083220,Chow; Bennett,10,0,32,22
1657844219343,MATH 142A,A03,093480,Chow; Bennett,9,0,32,23
1657844219343,MATH 142A,B03,093481,Chow; Bennett,8,0,32,24
1657844219343,MATH 142A,B04,093558,Chow; Bennett,13,0,32,19
1657844219343,MATH 142A,B05,093559,Chow; Bennett,7,0,32,25
1657844225371,MATH 193A,A01,083224,Rotar; Vladimir,8,0,34,26
1657844225371,MATH 193A,A02,083225,Rotar; Vladimir,10,0,34,24
1657844225371,MATH 193A,A03,083781,Rotar; Vladimir,5,0,34,29
1657844225371,MATH 193A,A04,083782,Rotar; Vladimir,11,0,34,23
1657844225371,MATH 193A,A05,093482,Rotar; Vladimir,10,0,34,24
1657844231395,MATH 197,001,091859,McAuley; Julian John,9999,0,9999,0
1657844231395,MATH 197,002,095566,Kedlaya; Kiran S.,9997,0,9999,2
1657844231395,MATH 197,003,095567,Xiao; Ming,9999,0,9999,0
1657844231395,MATH 197,004,095571,Perols; Johan Lars,9998,0,9999,1
1657844238456,COGS 9,A01,083615,Shannon; Kyle Michael,9,0,75,66
1657844244480,COGS 11,A01,083617,Boyle; Mary E. T.,23,0,48,25
1657844250502,COGS 13,A01,083071,Bastos; Amalia Pinkusfeld,11,0,71,60
1657844256525,COGS 14A,A01,092681,Semenuks; Arturs,5,1,100,95
1657844262548,COGS 14B,A01,083073,Cheng; Tzu-Han,6,0,63,57
1657844268573,COGS 17,A01,092677,Semenuks; Arturs,6,0,81,75
1657844274599,COGS 100,A01,083619,Allen; Michael Gordon,17,0,70,53
1657844280625,COGS 101A,A01,083621,Davis; Joshua Daniel,9,0,68,59
1657844286670,COGS 101B,A01,091572,Allen; Michael Gordon,12,0,65,53
1657844292696,COGS 101C,A01,083625,Delgado; Tania,17,0,35,18
1657844298719,COGS 107A,A01,083627,Boyle; Mary E. T.,14,0,60,46
1657844304748,COGS 118A,A01,083075,Gupta; Anjum,21,0,76,55
1657844310777,CSE 3,A50,083646,Miranda; Gregory Joseph,24,0,50,26
1657844316808,CSE 8A,A50,083650,Miranda; Gregory Joseph,17,1,56,39
1657844322836,CSE 11,A01,083080,Cao; Yingjun,6,15,40,34
1657844328862,CSE 12,A01,083652,Krause-Levy; Sophia Louisa,29,1,120,91
1657844334890,CSE 15L,A01,083654,Morris; Justin Loren,9,0,50,41
1657844334890,CSE 15L,A02,083655,Morris; Justin Loren,9,0,50,41
1657844340925,CSE 20,A01,083657,Tran; Khoa Dang,39,0,80,41
1657844346955,CSE 21,A01,095574,Bach; Quang Tran,22,0,48,26
1657844352983,CSE 30,A01,083084,Eldon; John,6,0,80,74
1657844352983,CSE 30,B01,095061,Bhaskar; Nishant,9,0,50,41
1657844359006,CSE 100,A01,083659,Cao; Yingjun,5,4,70,65
1657844365039,CSE 134B,A01,083661,Powell; Thomas Allan,24,0,100,76
1657844371066,CSE 140,A01,083663,Gungor; Onat,15,0,85,70
1657844377089,CSE 140L,A01,083088,Eldon; John,23,0,100,77
1657844383115,CSE 175,A01,083665,Kumar; Rakesh,3,0,25,22
1657844389159,CSE 190,A00,092507,Dubnov; Shlomo,8,0,20,12
1657844395183,ECE 45,A01,083139,Congero; Spencer William,6,0,75,69
1657844401207,ECE 65,A50,083695,Saad; Andrew S,12,0,30,18
1657844401207,ECE 65,A51,095125,Saad; Andrew S,24,0,26,2
1657844407229,ECE 109,A01,091882,Touri; Behrouz,20,0,70,50
1657844413256,ECE 180,A00,083140,Abi Samra; Nicholas Camill,1,0,30,29
1657844413256,ECE 180,B00,083141,Abi Samra; Nicholas Camill,0,0,30,30
1657844419279,MATH 10A,A01,083735,Patchell; Gregory David,2,0,30,28
1657844419279,MATH 10A,A02,083736,Patchell; Gregory David,20,0,30,10
1657844419279,MATH 10A,A03,083737,Patchell; Gregory David,16,0,30,14
1657844425304,MATH 10B,A01,083207,Lim; Seonhee,8,0,34,26
1657844425304,MATH 10B,A02,083208,Lim; Seonhee,10,0,35,25
1657844425304,MATH 10B,A03,093472,Lim; Seonhee,7,0,34,27
1657844425304,MATH 10B,B01,083739,Sinha; Shubham,14,0,30,16
1657844431328,MATH 18,A01,083743,Cinel; Cameron Alexander,9,0,30,21
1657844431328,MATH 18,A02,083744,Cinel; Cameron Alexander,18,0,30,12
1657844431328,MATH 18,A03,083745,Cinel; Cameron Alexander,10,0,30,20
1657844431328,MATH 18,B01,083748,Rideout; David Porter,5,0,37,32
1657844431328,MATH 18,B02,083749,Rideout; David Porter,5,0,36,31
1657844431328,MATH 18,B03,083750,Rideout; David Porter,3,0,37,34
1657844431328,MATH 18,B04,083751,Rideout; David Porter,6,0,36,30
1657844431328,MATH 18,B05,093473,Rideout; David Porter,6,0,36,30
1657844431328,MATH 18,B06,093474,Rideout; David Porter,6,0,36,30
1657844437430,MATH 20A,A01,083754,Zheng; Zequn,14,0,40,26
1657844443453,MATH 20B,A01,083756,Briones; Jor-el Thomas Caparas,4,0,36,32
1657844443453,MATH 20B,A02,083757,Briones; Jor-el Thomas Caparas,1,0,36,35
1657844443453,MATH 20B,A03,093475,Briones; Jor-el Thomas Caparas,2,0,36,34
1657844449478,MATH 20C,A01,083760,Briones; Jor-el Thomas Caparas,1,0,35,34
1657844449478,MATH 20C,A02,083761,Briones; Jor-el Thomas Caparas,8,0,35,27
1657844449478,MATH 20C,A03,093476,Briones; Jor-el Thomas Caparas,0,1,36,36
1657844449478,MATH 20C,B01,083762,Bach; Quang Tran,1,0,30,29
1657844455501,MATH 20D,A01,083765,Tran; Brian Kha,5,0,30,25
1657844455501,MATH 20D,A02,083766,Tran; Brian Kha,5,0,30,25
1657844455501,MATH 20D,A03,083767,Tran; Brian Kha,5,0,30,25
1657844461538,MATH 20E,A01,083771,Ganguly; Soumya,10,0,32,22
1657844461538,MATH 20E,A02,083772,Ganguly; Soumya,6,0,32,26
1657844461538,MATH 20E,B01,083773,Ciotti; Benjamin,20,0,35,15
1657844461538,MATH 20E,B02,083774,Ciotti; Benjamin,18,0,35,17
1657844467567,MATH 103A,A01,083777,Greenfeld; Be'Eri,3,0,36,33
1657844467567,MATH 103A,A02,083778,Greenfeld; Be'Eri,5,0,36,31
1657844467567,MATH 103A,A03,093561,Greenfeld; Be'Eri,6,0,36,30
1657844467567,MATH 103A,B01,083779,Greenfeld; Be'Eri,7,0,36,29
1657844467567,MATH 103A,B02,083780,Greenfeld; Be'Eri,4,0,36,32
1657844467567,MATH 103A,B03,093562,Greenfeld; Be'Eri,3,0,36,33
1657844473590,MATH 105,A01,085443,Carter; Anne Toulson,15,0,35,20
1657844473590,MATH 105,A02,093477,Carter; Anne Toulson,20,0,35,15
1657844479618,MATH 109,A01,083213,Ganzberger; Geoffrey Michael,3,0,34,31
1657844479618,MATH 109,A02,083214,Ganzberger; Geoffrey Michael,4,0,34,30
1657844479618,MATH 109,A03,093478,Ganzberger; Geoffrey Michael,2,0,34,32
1657844479618,MATH 109,B01,083215,Ganzberger; Geoffrey Michael,1,0,32,31
1657844479618,MATH 109,B02,083216,Ganzberger; Geoffrey Michael,2,0,32,30
1657844479618,MATH 109,B03,093479,Ganzberger; Geoffrey Michael,8,0,32,24
1657844485651,MATH 142A,A01,083219,Chow; Bennett,7,0,32,25
1657844485651,MATH 142A,A02,083220,Chow; Bennett,10,0,32,22
1657844485651,MATH 142A,A03,093480,Chow; Bennett,9,0,32,23
1657844485651,MATH 142A,B03,093481,Chow; Bennett,8,0,32,24
1657844485651,MATH 142A,B04,093558,Chow; Bennett,13,0,32,19
1657844485651,MATH 142A,B05,093559,Chow; Bennett,7,0,32,25
1657844491674,MATH 193A,A01,083224,Rotar; Vladimir,8,0,34,26
1657844491674,MATH 193A,A02,083225,Rotar; Vladimir,10,0,34,24
1657844491674,MATH 193A,A03,083781,Rotar; Vladimir,5,0,34,29
1657844491674,MATH 193A,A04,083782,Rotar; Vladimir,11,0,34,23
1657844491674,MATH 193A,A05,093482,Rotar; Vladimir,10,0,34,24
1657844497703,MATH 197,001,091859,McAuley; Julian John,9999,0,9999,0
1657844497703,MATH 197,002,095566,Kedlaya; Kiran S.,9997,0,9999,2
1657844497703,MATH 197,003,095567,Xiao; Ming,9999,0,9999,0
1657844497703,MATH 197,004,095571,Perols; Johan Lars,9998,0,9999,1
1657844504761,COGS 9,A01,083615,Shannon; Kyle Michael,10,0,75,65
1657844510788,COGS 11,A01,083617,Boyle; Mary E. T.,23,0,48,25
1657844516810,COGS 13,A01,083071,Bastos; Amalia Pinkusfeld,11,0,71,60
1657844522842,COGS 14A,A01,092681,Semenuks; Arturs,5,1,100,95
1657844528865,COGS 14B,A01,083073,Cheng; Tzu-Han,6,0,63,57
1657844534888,COGS 17,A01,092677,Semenuks; Arturs,6,0,81,75
1657844540916,COGS 100,A01,083619,Allen; Michael Gordon,17,0,70,53
1657844546941,COGS 101A,A01,083621,Davis; Joshua Daniel,9,0,68,59
1657844552972,COGS 101B,A01,091572,Allen; Michael Gordon,12,0,65,53
1657844559006,COGS 101C,A01,083625,Delgado; Tania,17,0,35,18
1657844565030,COGS 107A,A01,083627,Boyle; Mary E. T.,14,0,60,46
1657844571056,COGS 118A,A01,083075,Gupta; Anjum,21,0,76,55
1657844577090,CSE 3,A50,083646,Miranda; Gregory Joseph,24,0,50,26
1657844583114,CSE 8A,A50,083650,Miranda; Gregory Joseph,17,1,56,39
1657844589140,CSE 11,A01,083080,Cao; Yingjun,6,15,40,34
1657844595170,CSE 12,A01,083652,Krause-Levy; Sophia Louisa,29,1,120,91
1657844601195,CSE 15L,A01,083654,Morris; Justin Loren,9,0,50,41
1657844601195,CSE 15L,A02,083655,Morris; Justin Loren,9,0,50,41
1657844607219,CSE 20,A01,083657,Tran; Khoa Dang,39,0,80,41
1657844613248,CSE 21,A01,095574,Bach; Quang Tran,22,0,48,26
1657844619277,CSE 30,A01,083084,Eldon; John,6,0,80,74
1657844619277,CSE 30,B01,095061,Bhaskar; Nishant,9,0,50,41
1657844625302,CSE 100,A01,083659,Cao; Yingjun,5,4,70,65
1657844631325,CSE 134B,A01,083661,Powell; Thomas Allan,24,0,100,76
1657844637348,CSE 140,A01,083663,Gungor; Onat,15,0,85,70
1657844643373,CSE 140L,A01,083088,Eldon; John,23,0,100,77
1657844649400,CSE 175,A01,083665,Kumar; Rakesh,3,0,25,22
1657844655423,CSE 190,A00,092507,Dubnov; Shlomo,8,0,20,12
1657844661452,ECE 45,A01,083139,Congero; Spencer William,6,0,75,69
1657844667476,ECE 65,A50,083695,Saad; Andrew S,12,0,30,18
1657844667476,ECE 65,A51,095125,Saad; Andrew S,24,0,26,2
1657844673501,ECE 109,A01,091882,Touri; Behrouz,20,0,70,50
1657844679535,ECE 180,A00,083140,Abi Samra; Nicholas Camill,1,0,30,29
1657844679535,ECE 180,B00,083141,Abi Samra; Nicholas Camill,0,0,30,30
1657844685561,MATH 10A,A01,083735,Patchell; Gregory David,2,0,30,28
1657844685561,MATH 10A,A02,083736,Patchell; Gregory David,20,0,30,10
1657844685561,MATH 10A,A03,083737,Patchell; Gregory David,16,0,30,14
1657844691585,MATH 10B,A01,083207,Lim; Seonhee,8,0,34,26
1657844691585,MATH 10B,A02,083208,Lim; Seonhee,10,0,35,25
1657844691585,MATH 10B,A03,093472,Lim; Seonhee,7,0,34,27
1657844691585,MATH 10B,B01,083739,Sinha; Shubham,14,0,30,16
1657844697621,MATH 18,A01,083743,Cinel; Cameron Alexander,9,0,30,21
1657844697621,MATH 18,A02,083744,Cinel; Cameron Alexander,18,0,30,12
1657844697621,MATH 18,A03,083745,Cinel; Cameron Alexander,10,0,30,20
1657844697621,MATH 18,B01,083748,Rideout; David Porter,5,0,37,32
1657844697621,MATH 18,B02,083749,Rideout; David Porter,5,0,36,31
1657844697621,MATH 18,B03,083750,Rideout; David Porter,3,0,37,34
1657844697621,MATH 18,B04,083751,Rideout; David Porter,6,0,36,30
1657844697621,MATH 18,B05,093473,Rideout; David Porter,6,0,36,30
1657844697621,MATH 18,B06,093474,Rideout; David Porter,6,0,36,30
1657844703651,MATH 20A,A01,083754,Zheng; Zequn,14,0,40,26
1657844709677,MATH 20B,A01,083756,Briones; Jor-el Thomas Caparas,4,0,36,32
1657844709677,MATH 20B,A02,083757,Briones; Jor-el Thomas Caparas,1,0,36,35
1657844709677,MATH 20B,A03,093475,Briones; Jor-el Thomas Caparas,2,0,36,34
1657844715700,MATH 20C,A01,083760,Briones; Jor-el Thomas Caparas,1,0,35,34
1657844715700,MATH 20C,A02,083761,Briones; Jor-el Thomas Caparas,8,0,35,27
1657844715700,MATH 20C,A03,093476,Briones; Jor-el Thomas Caparas,0,1,36,36
1657844715700,MATH 20C,B01,083762,Bach; Quang Tran,1,0,30,29
1657844721729,MATH 20D,A01,083765,Tran; Brian Kha,5,0,30,25
1657844721729,MATH 20D,A02,083766,Tran; Brian Kha,5,0,30,25
1657844721729,MATH 20D,A03,083767,Tran; Brian Kha,5,0,30,25
1657844727759,MATH 20E,A01,083771,Ganguly; Soumya,10,0,32,22
1657844727759,MATH 20E,A02,083772,Ganguly; Soumya,6,0,32,26
1657844727759,MATH 20E,B01,083773,Ciotti; Benjamin,20,0,35,15
1657844727759,MATH 20E,B02,083774,Ciotti; Benjamin,18,0,35,17
1657844733787,MATH 103A,A01,083777,Greenfeld; Be'Eri,3,0,36,33
1657844733787,MATH 103A,A02,083778,Greenfeld; Be'Eri,5,0,36,31
1657844733787,MATH 103A,A03,093561,Greenfeld; Be'Eri,6,0,36,30
1657844733787,MATH 103A,B01,083779,Greenfeld; Be'Eri,7,0,36,29
1657844733787,MATH 103A,B02,083780,Greenfeld; Be'Eri,4,0,36,32
1657844733787,MATH 103A,B03,093562,Greenfeld; Be'Eri,3,0,36,33
1657844739811,MATH 105,A01,085443,Carter; Anne Toulson,15,0,35,20
1657844739811,MATH 105,A02,093477,Carter; Anne Toulson,20,0,35,15
1657844745834,MATH 109,A01,083213,Ganzberger; Geoffrey Michael,3,0,34,31
1657844745834,MATH 109,A02,083214,Ganzberger; Geoffrey Michael,4,0,34,30
1657844745834,MATH 109,A03,093478,Ganzberger; Geoffrey Michael,2,0,34,32
1657844745834,MATH 109,B01,083215,Ganzberger; Geoffrey Michael,1,0,32,31
1657844745834,MATH 109,B02,083216,Ganzberger; Geoffrey Michael,2,0,32,30
1657844745834,MATH 109,B03,093479,Ganzberger; Geoffrey Michael,8,0,32,24
1657844751859,MATH 142A,A01,083219,Chow; Bennett,7,0,32,25
1657844751859,MATH 142A,A02,083220,Chow; Bennett,10,0,32,22
1657844751859,MATH 142A,A03,093480,Chow; Bennett,9,0,32,23
1657844751859,MATH 142A,B03,093481,Chow; Bennett,8,0,32,24
1657844751859,MATH 142A,B04,093558,Chow; Bennett,13,0,32,19
1657844751859,MATH 142A,B05,093559,Chow; Bennett,7,0,32,25
1657844757882,MATH 193A,A01,083224,Rotar; Vladimir,8,0,34,26
1657844757882,MATH 193A,A02,083225,Rotar; Vladimir,10,0,34,24
1657844757882,MATH 193A,A03,083781,Rotar; Vladimir,5,0,34,29
1657844757882,MATH 193A,A04,083782,Rotar; Vladimir,11,0,34,23
1657844757882,MATH 193A,A05,093482,Rotar; Vladimir,10,0,34,24
1657844763905,MATH 197,001,091859,McAuley; Julian John,9999,0,9999,0
1657844763905,MATH 197,002,095566,Kedlaya; Kiran S.,9997,0,9999,2
1657844763905,MATH 197,003,095567,Xiao; Ming,9999,0,9999,0
1657844763905,MATH 197,004,095571,Perols; Johan Lars,9998,0,9999,1
1657844770958,COGS 9,A01,083615,Shannon; Kyle Michael,10,0,75,65
1657844776982,COGS 11,A01,083617,Boyle; Mary E. T.,23,0,48,25
1657844783003,COGS 13,A01,083071,Bastos; Amalia Pinkusfeld,11,0,71,60
1657844789027,COGS 14A,A01,092681,Semenuks; Arturs,5,1,100,95
1657844795058,COGS 14B,A01,083073,Cheng; Tzu-Han,6,0,63,57
1657844801080,COGS 17,A01,092677,Semenuks; Arturs,6,0,81,75
1657844807107,COGS 100,A01,083619,Allen; Michael Gordon,17,0,70,53
1657844813133,COGS 101A,A01,083621,Davis; Joshua Daniel,9,0,68,59
1657844819160,COGS 101B,A01,091572,Allen; Michael Gordon,12,0,65,53
1657844825182,COGS 101C,A01,083625,Delgado; Tania,17,0,35,18
1657844831207,COGS 107A,A01,083627,Boyle; Mary E. T.,14,0,60,46
1657844837229,COGS 118A,A01,083075,Gupta; Anjum,21,0,76,55
1657844843258,CSE 3,A50,083646,Miranda; Gregory Joseph,24,0,50,26
1657844849282,CSE 8A,A50,083650,Miranda; Gregory Joseph,17,1,56,39
1657844855304,CSE 11,A01,083080,Cao; Yingjun,6,15,40,34
1657844861330,CSE 12,A01,083652,Krause-Levy; Sophia Louisa,29,1,120,91
1657844867353,CSE 15L,A01,083654,Morris; Justin Loren,9,0,50,41
1657844867353,CSE 15L,A02,083655,Morris; Justin Loren,9,0,50,41
1657844873387,CSE 20,A01,083657,Tran; Khoa Dang,39,0,80,41
1657844879412,CSE 21,A01,095574,Bach; Quang Tran,22,0,48,26
1657844885441,CSE 30,A01,083084,Eldon; John,6,0,80,74
1657844885441,CSE 30,B01,095061,Bhaskar; Nishant,9,0,50,41
1657844891464,CSE 100,A01,083659,Cao; Yingjun,5,4,70,65
1657844897491,CSE 134B,A01,083661,Powell; Thomas Allan,24,0,100,76
1657844903518,CSE 140,A01,083663,Gungor; Onat,15,0,85,70
1657844909544,CSE 140L,A01,083088,Eldon; John,23,0,100,77
1657844915571,CSE 175,A01,083665,Kumar; Rakesh,3,0,25,22
1657844921597,CSE 190,A00,092507,Dubnov; Shlomo,8,0,20,12
1657844927622,ECE 45,A01,083139,Congero; Spencer William,6,0,75,69
1657844933646,ECE 65,A50,083695,Saad; Andrew S,12,0,30,18
1657844933646,ECE 65,A51,095125,Saad; Andrew S,24,0,26,2
1657844939688,ECE 109,A01,091882,Touri; Behrouz,20,0,70,50
1657844945712,ECE 180,A00,083140,Abi Samra; Nicholas Camill,1,0,30,29
1657844945712,ECE 180,B00,083141,Abi Samra; Nicholas Camill,0,0,30,30
1657844951736,MATH 10A,A01,083735,Patchell; Gregory David,2,0,30,28
1657844951736,MATH 10A,A02,083736,Patchell; Gregory David,20,0,30,10
1657844951736,MATH 10A,A03,083737,Patchell; Gregory David,16,0,30,14
1657844957759,MATH 10B,A01,083207,Lim; Seonhee,8,0,34,26
1657844957759,MATH 10B,A02,083208,Lim; Seonhee,10,0,35,25
1657844957759,MATH 10B,A03,093472,Lim; Seonhee,7,0,34,27
1657844957759,MATH 10B,B01,083739,Sinha; Shubham,14,0,30,16
1657844963792,MATH 18,A01,083743,Cinel; Cameron Alexander,9,0,30,21
1657844963792,MATH 18,A02,083744,Cinel; Cameron Alexander,18,0,30,12
1657844963792,MATH 18,A03,083745,Cinel; Cameron Alexander,10,0,30,20
1657844963792,MATH 18,B01,083748,Rideout; David Porter,5,0,37,32
1657844963792,MATH 18,B02,083749,Rideout; David Porter,5,0,36,31
1657844963792,MATH 18,B03,083750,Rideout; David Porter,3,0,37,34
1657844963792,MATH 18,B04,083751,Rideout; David Porter,6,0,36,30
1657844963792,MATH 18,B05,093473,Rideout; David Porter,6,0,36,30
1657844963792,MATH 18,B06,093474,Rideout; David Porter,6,0,36,30
1657844969815,MATH 20A,A01,083754,Zheng; Zequn,14,0,40,26
1657844975840,MATH 20B,A01,083756,Briones; Jor-el Thomas Caparas,4,0,36,32
1657844975840,MATH 20B,A02,083757,Briones; Jor-el Thomas Caparas,1,0,36,35
1657844975840,MATH 20B,A03,093475,Briones; Jor-el Thomas Caparas,2,0,36,34
1657844981870,MATH 20C,A01,083760,Briones; Jor-el Thomas Caparas,1,0,35,34
1657844981870,MATH 20C,A02,083761,Briones; Jor-el Thomas Caparas,8,0,35,27
1657844981870,MATH 20C,A03,093476,Briones; Jor-el Thomas Caparas,0,1,36,36
1657844981870,MATH 20C,B01,083762,Bach; Quang Tran,1,0,30,29
1657844987892,MATH 20D,A01,083765,Tran; Brian Kha,5,0,30,25
1657844987892,MATH 20D,A02,083766,Tran; Brian Kha,5,0,30,25
1657844987892,MATH 20D,A03,083767,Tran; Brian Kha,5,0,30,25
1657844993915,MATH 20E,A01,083771,Ganguly; Soumya,10,0,32,22
1657844993915,MATH 20E,A02,083772,Ganguly; Soumya,6,0,32,26
1657844993915,MATH 20E,B01,083773,Ciotti; Benjamin,20,0,35,15
1657844993915,MATH 20E,B02,083774,Ciotti; Benjamin,18,0,35,17
1657844999938,MATH 103A,A01,083777,Greenfeld; Be'Eri,3,0,36,33
1657844999938,MATH 103A,A02,083778,Greenfeld; Be'Eri,5,0,36,31
1657844999938,MATH 103A,A03,093561,Greenfeld; Be'Eri,6,0,36,30
1657844999938,MATH 103A,B01,083779,Greenfeld; Be'Eri,7,0,36,29
1657844999938,MATH 103A,B02,083780,Greenfeld; Be'Eri,4,0,36,32
1657844999938,MATH 103A,B03,093562,Greenfeld; Be'Eri,3,0,36,33
1657845005960,MATH 105,A01,085443,Carter; Anne Toulson,15,0,35,20
1657845005960,MATH 105,A02,093477,Carter; Anne Toulson,20,0,35,15
1657845011995,MATH 109,A01,083213,Ganzberger; Geoffrey Michael,3,0,34,31
1657845011995,MATH 109,A02,083214,Ganzberger; Geoffrey Michael,4,0,34,30
1657845011995,MATH 109,A03,093478,Ganzberger; Geoffrey Michael,2,0,34,32
1657845011995,MATH 109,B01,083215,Ganzberger; Geoffrey Michael,1,0,32,31
1657845011995,MATH 109,B02,083216,Ganzberger; Geoffrey Michael,2,0,32,30
1657845011995,MATH 109,B03,093479,Ganzberger; Geoffrey Michael,8,0,32,24
1657845018033,MATH 142A,A01,083219,Chow; Bennett,7,0,32,25
1657845018033,MATH 142A,A02,083220,Chow; Bennett,10,0,32,22
1657845018033,MATH 142A,A03,093480,Chow; Bennett,9,0,32,23
1657845018033,MATH 142A,B03,093481,Chow; Bennett,8,0,32,24
1657845018033,MATH 142A,B04,093558,Chow; Bennett,13,0,32,19
1657845018033,MATH 142A,B05,093559,Chow; Bennett,7,0,32,25
1657845024069,MATH 193A,A01,083224,Rotar; Vladimir,8,0,34,26
1657845024069,MATH 193A,A02,083225,Rotar; Vladimir,10,0,34,24
1657845024069,MATH 193A,A03,083781,Rotar; Vladimir,5,0,34,29
1657845024069,MATH 193A,A04,083782,Rotar; Vladimir,11,0,34,23
1657845024069,MATH 193A,A05,093482,Rotar; Vladimir,10,0,34,24
1657845030092,MATH 197,001,091859,McAuley; Julian John,9999,0,9999,0
1657845030092,MATH 197,002,095566,Kedlaya; Kiran S.,9997,0,9999,2
1657845030092,MATH 197,003,095567,Xiao; Ming,9999,0,9999,0
1657845030092,MATH 197,004,095571,Perols; Johan Lars,9998,0,9999,1
1657845037223,COGS 9,A01,083615,Shannon; Kyle Michael,10,0,75,65
1657845043250,COGS 11,A01,083617,Boyle; Mary E. T.,23,0,48,25
1657845049280,COGS 13,A01,083071,Bastos; Amalia Pinkusfeld,11,0,71,60
1657845055304,COGS 14A,A01,092681,Semenuks; Arturs,5,1,100,95
1657845061327,COGS 14B,A01,083073,Cheng; Tzu-Han,6,0,63,57
1657845067354,COGS 17,A01,092677,Semenuks; Arturs,6,0,81,75
1657845073400,COGS 100,A01,083619,Allen; Michael Gordon,17,0,70,53
1657845079422,COGS 101A,A01,083621,Davis; Joshua Daniel,9,0,68,59
1657845085444,COGS 101B,A01,091572,Allen; Michael Gordon,12,0,65,53
1657845091468,COGS 101C,A01,083625,Delgado; Tania,17,0,35,18
1657845097492,COGS 107A,A01,083627,Boyle; Mary E. T.,14,0,60,46
1657845103517,COGS 118A,A01,083075,Gupta; Anjum,21,0,76,55
1657845109539,CSE 3,A50,083646,Miranda; Gregory Joseph,24,0,50,26
1657845115577,CSE 8A,A50,083650,Miranda; Gregory Joseph,17,1,56,39
1657845121599,CSE 11,A01,083080,Cao; Yingjun,6,15,40,34
1657845127636,CSE 12,A01,083652,Krause-Levy; Sophia Louisa,29,1,120,91
1657845133659,CSE 15L,A01,083654,Morris; Justin Loren,9,0,50,41
1657845133659,CSE 15L,A02,083655,Morris; Justin Loren,9,0,50,41
1657845139683,CSE 20,A01,083657,Tran; Khoa Dang,39,0,80,41
1657845145710,CSE 21,A01,095574,Bach; Quang Tran,22,0,48,26
1657845151734,CSE 30,A01,083084,Eldon; John,6,0,80,74
1657845151734,CSE 30,B01,095061,Bhaskar; Nishant,9,0,50,41
1657845157759,CSE 100,A01,083659,Cao; Yingjun,5,4,70,65
1657845163787,CSE 134B,A01,083661,Powell; Thomas Allan,24,0,100,76
1657845169809,CSE 140,A01,083663,Gungor; Onat,15,0,85,70
1657845175836,CSE 140L,A01,083088,Eldon; John,23,0,100,77
1657845181861,CSE 175,A01,083665,Kumar; Rakesh,3,0,25,22
1657845187886,CSE 190,A00,092507,Dubnov; Shlomo,8,0,20,12
1657845193909,ECE 45,A01,083139,Congero; Spencer William,6,0,75,69
1657845199937,ECE 65,A50,083695,Saad; Andrew S,12,0,30,18
1657845199937,ECE 65,A51,095125,Saad; Andrew S,24,0,26,2
1657845205960,ECE 109,A01,091882,Touri; Behrouz,20,0,70,50
1657845211983,ECE 180,A00,083140,Abi Samra; Nicholas Camill,1,0,30,29
1657845211983,ECE 180,B00,083141,Abi Samra; Nicholas Camill,0,0,30,30
1657845218005,MATH 10A,A01,083735,Patchell; Gregory David,2,0,30,28
1657845218005,MATH 10A,A02,083736,Patchell; Gregory David,20,0,30,10
1657845218005,MATH 10A,A03,083737,Patchell; Gregory David,16,0,30,14
1657845224028,MATH 10B,A01,083207,Lim; Seonhee,8,0,34,26
1657845224028,MATH 10B,A02,083208,Lim; Seonhee,10,0,35,25
1657845224028,MATH 10B,A03,093472,Lim; Seonhee,7,0,34,27
1657845224028,MATH 10B,B01,083739,Sinha; Shubham,14,0,30,16
1657845230062,MATH 18,A01,083743,Cinel; Cameron Alexander,9,0,30,21
1657845230062,MATH 18,A02,083744,Cinel; Cameron Alexander,18,0,30,12
1657845230062,MATH 18,A03,083745,Cinel; Cameron Alexander,10,0,30,20
1657845230062,MATH 18,B01,083748,Rideout; David Porter,5,0,37,32
1657845230062,MATH 18,B02,083749,Rideout; David Porter,5,0,36,31
1657845230062,MATH 18,B03,083750,Rideout; David Porter,3,0,37,34
1657845230062,MATH 18,B04,083751,Rideout; David Porter,6,0,36,30
1657845230062,MATH 18,B05,093473,Rideout; David Porter,6,0,36,30
1657845230062,MATH 18,B06,093474,Rideout; David Porter,6,0,36,30
1657845236085,MATH 20A,A01,083754,Zheng; Zequn,14,0,40,26
1657845242116,MATH 20B,A01,083756,Briones; Jor-el Thomas Caparas,4,0,36,32
1657845242116,MATH 20B,A02,083757,Briones; Jor-el Thomas Caparas,1,0,36,35
1657845242116,MATH 20B,A03,093475,Briones; Jor-el Thomas Caparas,2,0,36,34
1657845248140,MATH 20C,A01,083760,Briones; Jor-el Thomas Caparas,1,0,35,34
1657845248140,MATH 20C,A02,083761,Briones; Jor-el Thomas Caparas,8,0,35,27
1657845248140,MATH 20C,A03,093476,Briones; Jor-el Thomas Caparas,0,1,36,36
1657845248140,MATH 20C,B01,083762,Bach; Quang Tran,1,0,30,29
1657845254164,MATH 20D,A01,083765,Tran; Brian Kha,5,0,30,25
1657845254164,MATH 20D,A02,083766,Tran; Brian Kha,5,0,30,25
1657845254164,MATH 20D,A03,083767,Tran; Brian Kha,5,0,30,25
1657845260188,MATH 20E,A01,083771,Ganguly; Soumya,10,0,32,22
1657845260188,MATH 20E,A02,083772,Ganguly; Soumya,6,0,32,26
1657845260188,MATH 20E,B01,083773,Ciotti; Benjamin,20,0,35,15
1657845260188,MATH 20E,B02,083774,Ciotti; Benjamin,18,0,35,17
1657845266212,MATH 103A,A01,083777,Greenfeld; Be'Eri,3,0,36,33
1657845266212,MATH 103A,A02,083778,Greenfeld; Be'Eri,5,0,36,31
1657845266212,MATH 103A,A03,093561,Greenfeld; Be'Eri,6,0,36,30
1657845266212,MATH 103A,B01,083779,Greenfeld; Be'Eri,7,0,36,29
1657845266212,MATH 103A,B02,083780,Greenfeld; Be'Eri,4,0,36,32
1657845266212,MATH 103A,B03,093562,Greenfeld; Be'Eri,3,0,36,33
1657845272234,MATH 105,A01,085443,Carter; Anne Toulson,15,0,35,20
1657845272234,MATH 105,A02,093477,Carter; Anne Toulson,20,0,35,15
1657845278258,MATH 109,A01,083213,Ganzberger; Geoffrey Michael,3,0,34,31
1657845278258,MATH 109,A02,083214,Ganzberger; Geoffrey Michael,4,0,34,30
1657845278258,MATH 109,A03,093478,Ganzberger; Geoffrey Michael,2,0,34,32
1657845278258,MATH 109,B01,083215,Ganzberger; Geoffrey Michael,1,0,32,31
1657845278258,MATH 109,B02,083216,Ganzberger; Geoffrey Michael,2,0,32,30
1657845278258,MATH 109,B03,093479,Ganzberger; Geoffrey Michael,8,0,32,24
1657845284288,MATH 142A,A01,083219,Chow; Bennett,7,0,32,25
1657845284288,MATH 142A,A02,083220,Chow; Bennett,10,0,32,22
1657845284288,MATH 142A,A03,093480,Chow; Bennett,9,0,32,23
1657845284288,MATH 142A,B03,093481,Chow; Bennett,8,0,32,24
1657845284288,MATH 142A,B04,093558,Chow; Bennett,13,0,32,19
1657845284288,MATH 142A,B05,093559,Chow; Bennett,7,0,32,25
1657845290311,MATH 193A,A01,083224,Rotar; Vladimir,8,0,34,26
1657845290311,MATH 193A,A02,083225,Rotar; Vladimir,10,0,34,24
1657845290311,MATH 193A,A03,083781,Rotar; Vladimir,5,0,34,29
1657845290311,MATH 193A,A04,083782,Rotar; Vladimir,11,0,34,23
1657845290311,MATH 193A,A05,093482,Rotar; Vladimir,10,0,34,24
1657845296335,MATH 197,001,091859,McAuley; Julian John,9999,0,9999,0
1657845296335,MATH 197,002,095566,Kedlaya; Kiran S.,9997,0,9999,2
1657845296335,MATH 197,003,095567,Xiao; Ming,9999,0,9999,0
1657845296335,MATH 197,004,095571,Perols; Johan Lars,9998,0,9999,1
1657845303406,COGS 9,A01,083615,Shannon; Kyle Michael,10,0,75,65
1657845309428,COGS 11,A01,083617,Boyle; Mary E. T.,23,0,48,25
1657845315452,COGS 13,A01,083071,Bastos; Amalia Pinkusfeld,11,0,71,60
1657845321478,COGS 14A,A01,092681,Semenuks; Arturs,5,1,100,95
1657845327504,COGS 14B,A01,083073,Cheng; Tzu-Han,6,0,63,57
1657845333527,COGS 17,A01,092677,Semenuks; Arturs,6,0,81,75
1657845339553,COGS 100,A01,083619,Allen; Michael Gordon,17,0,70,53
1657845345580,COGS 101A,A01,083621,Davis; Joshua Daniel,9,0,68,59
1657845351608,COGS 101B,A01,091572,Allen; Michael Gordon,12,0,65,53
1657845357631,COGS 101C,A01,083625,Delgado; Tania,17,0,35,18
1657845363672,COGS 107A,A01,083627,Boyle; Mary E. T.,14,0,60,46
1657845369693,COGS 118A,A01,083075,Gupta; Anjum,21,0,76,55
1657845375717,CSE 3,A50,083646,Miranda; Gregory Joseph,24,0,50,26
1657845381740,CSE 8A,A50,083650,Miranda; Gregory Joseph,17,1,56,39
1657845387763,CSE 11,A01,083080,Cao; Yingjun,6,15,40,34
1657845393792,CSE 12,A01,083652,Krause-Levy; Sophia Louisa,29,1,120,91
1657845399813,CSE 15L,A01,083654,Morris; Justin Loren,9,0,50,41
1657845399813,CSE 15L,A02,083655,Morris; Justin Loren,9,0,50,41
1657845405837,CSE 20,A01,083657,Tran; Khoa Dang,39,0,80,41
1657845411864,CSE 21,A01,095574,Bach; Quang Tran,22,0,48,26
1657845417886,CSE 30,A01,083084,Eldon; John,6,0,80,74
1657845417886,CSE 30,B01,095061,Bhaskar; Nishant,9,0,50,41
1657845423912,CSE 100,A01,083659,Cao; Yingjun,5,4,70,65
1657845429935,CSE 134B,A01,083661,Powell; Thomas Allan,24,0,100,76
1657845435957,CSE 140,A01,083663,Gungor; Onat,15,0,85,70
1657845441982,CSE 140L,A01,083088,Eldon; John,23,0,100,77
1657845448007,CSE 175,A01,083665,Kumar; Rakesh,3,0,25,22
1657845454032,CSE 190,A00,092507,Dubnov; Shlomo,8,0,20,12
1657845460053,ECE 45,A01,083139,Congero; Spencer William,6,0,75,69
1657845466085,ECE 65,A50,083695,Saad; Andrew S,12,0,30,18
1657845466085,ECE 65,A51,095125,Saad; Andrew S,24,0,26,2
1657845472117,ECE 109,A01,091882,Touri; Behrouz,20,0,70,50
1657845478143,ECE 180,A00,083140,Abi Samra; Nicholas Camill,1,0,30,29
1657845478143,ECE 180,B00,083141,Abi Samra; Nicholas Camill,0,0,30,30
1657845484176,MATH 10A,A01,083735,Patchell; Gregory David,2,0,30,28
1657845484176,MATH 10A,A02,083736,Patchell; Gregory David,20,0,30,10
1657845484176,MATH 10A,A03,083737,Patchell; Gregory David,16,0,30,14
1657845490201,MATH 10B,A01,083207,Lim; Seonhee,8,0,34,26
1657845490201,MATH 10B,A02,083208,Lim; Seonhee,10,0,35,25
1657845490201,MATH 10B,A03,093472,Lim; Seonhee,7,0,34,27
1657845490201,MATH 10B,B01,083739,Sinha; Shubham,14,0,30,16
1657845496226,MATH 18,A01,083743,Cinel; Cameron Alexander,9,0,30,21
1657845496226,MATH 18,A02,083744,Cinel; Cameron Alexander,18,0,30,12
1657845496226,MATH 18,A03,083745,Cinel; Cameron Alexander,10,0,30,20
1657845496226,MATH 18,B01,083748,Rideout; David Porter,5,0,37,32
1657845496226,MATH 18,B02,083749,Rideout; David Porter,5,0,36,31
1657845496226,MATH 18,B03,083750,Rideout; David Porter,3,0,37,34
1657845496226,MATH 18,B04,083751,Rideout; David Porter,6,0,36,30
1657845496226,MATH 18,B05,093473,Rideout; David Porter,6,0,36,30
1657845496226,MATH 18,B06,093474,Rideout; David Porter,6,0,36,30
1657845502248,MATH 20A,A01,083754,Zheng; Zequn,14,0,40,26
1657845508284,MATH 20B,A01,083756,Briones; Jor-el Thomas Caparas,4,0,36,32
1657845508284,MATH 20B,A02,083757,Briones; Jor-el Thomas Caparas,1,0,36,35
1657845508284,MATH 20B,A03,093475,Briones; Jor-el Thomas Caparas,2,0,36,34
1657845514308,MATH 20C,A01,083760,Briones; Jor-el Thomas Caparas,1,0,35,34
1657845514308,MATH 20C,A02,083761,Briones; Jor-el Thomas Caparas,8,0,35,27
1657845514308,MATH 20C,A03,093476,Briones; Jor-el Thomas Caparas,0,1,36,36
1657845514308,MATH 20C,B01,083762,Bach; Quang Tran,1,0,30,29
1657845520339,MATH 20D,A01,083765,Tran; Brian Kha,5,0,30,25
1657845520339,MATH 20D,A02,083766,Tran; Brian Kha,5,0,30,25
1657845520339,MATH 20D,A03,083767,Tran; Brian Kha,5,0,30,25
1657845526366,MATH 20E,A01,083771,Ganguly; Soumya,10,0,32,22
1657845526366,MATH 20E,A02,083772,Ganguly; Soumya,6,0,32,26
1657845526366,MATH 20E,B01,083773,Ciotti; Benjamin,20,0,35,15
1657845526366,MATH 20E,B02,083774,Ciotti; Benjamin,18,0,35,17
1657845532389,MATH 103A,A01,083777,Greenfeld; Be'Eri,3,0,36,33
1657845532389,MATH 103A,A02,083778,Greenfeld; Be'Eri,5,0,36,31
1657845532389,MATH 103A,A03,093561,Greenfeld; Be'Eri,6,0,36,30
1657845532389,MATH 103A,B01,083779,Greenfeld; Be'Eri,7,0,36,29
1657845532389,MATH 103A,B02,083780,Greenfeld; Be'Eri,4,0,36,32
1657845532389,MATH 103A,B03,093562,Greenfeld; Be'Eri,3,0,36,33
1657845538420,MATH 105,A01,085443,Carter; Anne Toulson,15,0,35,20
1657845538420,MATH 105,A02,093477,Carter; Anne Toulson,20,0,35,15
1657845544448,MATH 109,A01,083213,Ganzberger; Geoffrey Michael,3,0,34,31
1657845544448,MATH 109,A02,083214,Ganzberger; Geoffrey Michael,4,0,34,30
1657845544448,MATH 109,A03,093478,Ganzberger; Geoffrey Michael,2,0,34,32
1657845544448,MATH 109,B01,083215,Ganzberger; Geoffrey Michael,1,0,32,31
1657845544448,MATH 109,B02,083216,Ganzberger; Geoffrey Michael,2,0,32,30
1657845544448,MATH 109,B03,093479,Ganzberger; Geoffrey Michael,8,0,32,24
1657845550471,MATH 142A,A01,083219,Chow; Bennett,7,0,32,25
1657845550471,MATH 142A,A02,083220,Chow; Bennett,10,0,32,22
1657845550471,MATH 142A,A03,093480,Chow; Bennett,9,0,32,23
1657845550471,MATH 142A,B03,093481,Chow; Bennett,8,0,32,24
1657845550471,MATH 142A,B04,093558,Chow; Bennett,13,0,32,19
1657845550471,MATH 142A,B05,093559,Chow; Bennett,7,0,32,25
1657845556503,MATH 193A,A01,083224,Rotar; Vladimir,8,0,34,26
1657845556503,MATH 193A,A02,083225,Rotar; Vladimir,10,0,34,24
1657845556503,MATH 193A,A03,083781,Rotar; Vladimir,5,0,34,29
1657845556503,MATH 193A,A04,083782,Rotar; Vladimir,11,0,34,23
1657845556503,MATH 193A,A05,093482,Rotar; Vladimir,10,0,34,24
1657845562525,MATH 197,001,091859,McAuley; Julian John,9999,0,9999,0
1657845562525,MATH 197,002,095566,Kedlaya; Kiran S.,9997,0,9999,2
1657845562525,MATH 197,003,095567,Xiao; Ming,9999,0,9999,0
1657845562525,MATH 197,004,095571,Perols; Johan Lars,9998,0,9999,1
1657845569587,COGS 9,A01,083615,Shannon; Kyle Michael,10,0,75,65
1657845575610,COGS 11,A01,083617,Boyle; Mary E. T.,23,0,48,25
1657845581634,COGS 13,A01,083071,Bastos; Amalia Pinkusfeld,11,0,71,60
1657845587662,COGS 14A,A01,092681,Semenuks; Arturs,5,1,100,95
1657845593684,COGS 14B,A01,083073,Cheng; Tzu-Han,6,0,63,57
1657845599710,COGS 17,A01,092677,Semenuks; Arturs,6,0,81,75
1657845605733,COGS 100,A01,083619,Allen; Michael Gordon,17,0,70,53
1657845611755,COGS 101A,A01,083621,Davis; Joshua Daniel,9,0,68,59
1657845617779,COGS 101B,A01,091572,Allen; Michael Gordon,12,0,65,53
1657845623805,COGS 101C,A01,083625,Delgado; Tania,17,0,35,18
1657845629918,COGS 107A,A01,083627,Boyle; Mary E. T.,14,0,60,46
1657845635939,COGS 118A,A01,083075,Gupta; Anjum,21,0,76,55
1657845641967,CSE 3,A50,083646,Miranda; Gregory Joseph,24,0,50,26
1657845647988,CSE 8A,A50,083650,Miranda; Gregory Joseph,17,1,56,39
1657845654010,CSE 11,A01,083080,Cao; Yingjun,6,15,40,34
1657845660031,CSE 12,A01,083652,Krause-Levy; Sophia Louisa,29,1,120,91
1657845666057,CSE 15L,A01,083654,Morris; Justin Loren,9,0,50,41
1657845666057,CSE 15L,A02,083655,Morris; Justin Loren,9,0,50,41
1657845672082,CSE 20,A01,083657,Tran; Khoa Dang,39,0,80,41
1657845678110,CSE 21,A01,095574,Bach; Quang Tran,22,0,48,26
1657845684133,CSE 30,A01,083084,Eldon; John,6,0,80,74
1657845684133,CSE 30,B01,095061,Bhaskar; Nishant,9,0,50,41
1657845690154,CSE 100,A01,083659,Cao; Yingjun,5,4,70,65
1657845696178,CSE 134B,A01,083661,Powell; Thomas Allan,24,0,100,76
1657845702200,CSE 140,A01,083663,Gungor; Onat,15,0,85,70
1657845708227,CSE 140L,A01,083088,Eldon; John,23,0,100,77
1657845714253,CSE 175,A01,083665,Kumar; Rakesh,3,0,25,22
1657845720281,CSE 190,A00,092507,Dubnov; Shlomo,8,0,20,12
1657845726303,ECE 45,A01,083139,Congero; Spencer William,6,0,75,69
1657845732326,ECE 65,A50,083695,Saad; Andrew S,12,0,30,18
1657845732326,ECE 65,A51,095125,Saad; Andrew S,24,0,26,2
1657845738352,ECE 109,A01,091882,Touri; Behrouz,20,0,70,50
1657845744379,ECE 180,A00,083140,Abi Samra; Nicholas Camill,1,0,30,29
1657845744379,ECE 180,B00,083141,Abi Samra; Nicholas Camill,0,0,30,30
1657845750408,MATH 10A,A01,083735,Patchell; Gregory David,2,0,30,28
1657845750408,MATH 10A,A02,083736,Patchell; Gregory David,20,0,30,10
1657845750408,MATH 10A,A03,083737,Patchell; Gregory David,16,0,30,14
1657845756431,MATH 10B,A01,083207,Lim; Seonhee,8,0,34,26
1657845756431,MATH 10B,A02,083208,Lim; Seonhee,10,0,35,25
1657845756431,MATH 10B,A03,093472,Lim; Seonhee,7,0,34,27
1657845756431,MATH 10B,B01,083739,Sinha; Shubham,14,0,30,16
1657845762467,MATH 18,A01,083743,Cinel; Cameron Alexander,9,0,30,21
1657845762467,MATH 18,A02,083744,Cinel; Cameron Alexander,18,0,30,12
1657845762467,MATH 18,A03,083745,Cinel; Cameron Alexander,10,0,30,20
1657845762467,MATH 18,B01,083748,Rideout; David Porter,5,0,37,32
1657845762467,MATH 18,B02,083749,Rideout; David Porter,5,0,36,31
1657845762467,MATH 18,B03,083750,Rideout; David Porter,3,0,37,34
1657845762467,MATH 18,B04,083751,Rideout; David Porter,6,0,36,30
1657845762467,MATH 18,B05,093473,Rideout; David Porter,6,0,36,30
1657845762467,MATH 18,B06,093474,Rideout; David Porter,6,0,36,30
1657845768494,MATH 20A,A01,083754,Zheng; Zequn,14,0,40,26
1657845774518,MATH 20B,A01,083756,Briones; Jor-el Thomas Caparas,4,0,36,32
1657845774518,MATH 20B,A02,083757,Briones; Jor-el Thomas Caparas,1,0,36,35
1657845774518,MATH 20B,A03,093475,Briones; Jor-el Thomas Caparas,2,0,36,34
1657845780541,MATH 20C,A01,083760,Briones; Jor-el Thomas Caparas,1,0,35,34
1657845780541,MATH 20C,A02,083761,Briones; Jor-el Thomas Caparas,8,0,35,27
1657845780541,MATH 20C,A03,093476,Briones; Jor-el Thomas Caparas,0,1,36,36
1657845780541,MATH 20C,B01,083762,Bach; Quang Tran,1,0,30,29
1657845786566,MATH 20D,A01,083765,Tran; Brian Kha,5,0,30,25
1657845786566,MATH 20D,A02,083766,Tran; Brian Kha,5,0,30,25
1657845786566,MATH 20D,A03,083767,Tran; Brian Kha,5,0,30,25
1657845792594,MATH 20E,A01,083771,Ganguly; Soumya,10,0,32,22
1657845792594,MATH 20E,A02,083772,Ganguly; Soumya,6,0,32,26
1657845792594,MATH 20E,B01,083773,Ciotti; Benjamin,20,0,35,15
1657845792594,MATH 20E,B02,083774,Ciotti; Benjamin,18,0,35,17
1657845798618,MATH 103A,A01,083777,Greenfeld; Be'Eri,3,0,36,33
1657845798618,MATH 103A,A02,083778,Greenfeld; Be'Eri,5,0,36,31
1657845798618,MATH 103A,A03,093561,Greenfeld; Be'Eri,6,0,36,30
1657845798618,MATH 103A,B01,083779,Greenfeld; Be'Eri,7,0,36,29
1657845798618,MATH 103A,B02,083780,Greenfeld; Be'Eri,4,0,36,32
1657845798618,MATH 103A,B03,093562,Greenfeld; Be'Eri,3,0,36,33
1657845804646,MATH 105,A01,085443,Carter; Anne Toulson,15,0,35,20
1657845804646,MATH 105,A02,093477,Carter; Anne Toulson,20,0,35,15
1657845810675,MATH 109,A01,083213,Ganzberger; Geoffrey Michael,3,0,34,31
1657845810675,MATH 109,A02,083214,Ganzberger; Geoffrey Michael,4,0,34,30
1657845810675,MATH 109,A03,093478,Ganzberger; Geoffrey Michael,2,0,34,32
1657845810675,MATH 109,B01,083215,Ganzberger; Geoffrey Michael,1,0,32,31
1657845810675,MATH 109,B02,083216,Ganzberger; Geoffrey Michael,2,0,32,30
1657845810675,MATH 109,B03,093479,Ganzberger; Geoffrey Michael,8,0,32,24
1657845816698,MATH 142A,A01,083219,Chow; Bennett,7,0,32,25
1657845816698,MATH 142A,A02,083220,Chow; Bennett,10,0,32,22
1657845816698,MATH 142A,A03,093480,Chow; Bennett,9,0,32,23
1657845816698,MATH 142A,B03,093481,Chow; Bennett,8,0,32,24
1657845816698,MATH 142A,B04,093558,Chow; Bennett,13,0,32,19
1657845816698,MATH 142A,B05,093559,Chow; Bennett,7,0,32,25
1657845822726,MATH 193A,A01,083224,Rotar; Vladimir,8,0,34,26
1657845822726,MATH 193A,A02,083225,Rotar; Vladimir,10,0,34,24
1657845822726,MATH 193A,A03,083781,Rotar; Vladimir,5,0,34,29
1657845822726,MATH 193A,A04,083782,Rotar; Vladimir,11,0,34,23
1657845822726,MATH 193A,A05,093482,Rotar; Vladimir,10,0,34,24
1657845828751,MATH 197,001,091859,McAuley; Julian John,9999,0,9999,0
1657845828751,MATH 197,002,095566,Kedlaya; Kiran S.,9997,0,9999,2
1657845828751,MATH 197,003,095567,Xiao; Ming,9999,0,9999,0
1657845828751,MATH 197,004,095571,Perols; Johan Lars,9998,0,9999,1
1657845835831,COGS 9,A01,083615,Shannon; Kyle Michael,10,0,75,65
1657845841856,COGS 11,A01,083617,Boyle; Mary E. T.,23,0,48,25
1657845847883,COGS 13,A01,083071,Bastos; Amalia Pinkusfeld,11,0,71,60
1657845853909,COGS 14A,A01,092681,Semenuks; Arturs,5,1,100,95
1657845859933,COGS 14B,A01,083073,Cheng; Tzu-Han,6,0,63,57
1657845865963,COGS 17,A01,092677,Semenuks; Arturs,6,0,81,75
1657845871986,COGS 100,A01,083619,Allen; Michael Gordon,17,0,70,53
1657845878010,COGS 101A,A01,083621,Davis; Joshua Daniel,9,0,68,59
1657845884034,COGS 101B,A01,091572,Allen; Michael Gordon,12,0,65,53
1657845890057,COGS 101C,A01,083625,Delgado; Tania,17,0,35,18
1657845896080,COGS 107A,A01,083627,Boyle; Mary E. T.,14,0,60,46
1657845902108,COGS 118A,A01,083075,Gupta; Anjum,21,0,76,55
1657845908130,CSE 3,A50,083646,Miranda; Gregory Joseph,24,0,50,26
1657845914155,CSE 8A,A50,083650,Miranda; Gregory Joseph,17,1,56,39
1657845920178,CSE 11,A01,083080,Cao; Yingjun,6,15,40,34
1657845926204,CSE 12,A01,083652,Krause-Levy; Sophia Louisa,29,1,120,91
1657845932227,CSE 15L,A01,083654,Morris; Justin Loren,9,0,50,41
1657845932227,CSE 15L,A02,083655,Morris; Justin Loren,9,0,50,41
1657845938249,CSE 20,A01,083657,Tran; Khoa Dang,39,0,80,41
1657845944270,CSE 21,A01,095574,Bach; Quang Tran,22,0,48,26
1657845950298,CSE 30,A01,083084,Eldon; John,6,0,80,74
1657845950298,CSE 30,B01,095061,Bhaskar; Nishant,9,0,50,41
1657845956323,CSE 100,A01,083659,Cao; Yingjun,5,4,70,65
1657845962350,CSE 134B,A01,083661,Powell; Thomas Allan,24,0,100,76
1657845968376,CSE 140,A01,083663,Gungor; Onat,15,0,85,70
1657845974399,CSE 140L,A01,083088,Eldon; John,23,0,100,77
1657845980423,CSE 175,A01,083665,Kumar; Rakesh,3,0,25,22
1657845986449,CSE 190,A00,092507,Dubnov; Shlomo,8,0,20,12
1657845992476,ECE 45,A01,083139,Congero; Spencer William,6,0,75,69
1657845998499,ECE 65,A50,083695,Saad; Andrew S,12,0,30,18
1657845998499,ECE 65,A51,095125,Saad; Andrew S,24,0,26,2
1657846004524,ECE 109,A01,091882,Touri; Behrouz,20,0,70,50
1657846010550,ECE 180,A00,083140,Abi Samra; Nicholas Camill,1,0,30,29
1657846010550,ECE 180,B00,083141,Abi Samra; Nicholas Camill,0,0,30,30
1657846016577,MATH 10A,A01,083735,Patchell; Gregory David,2,0,30,28
1657846016577,MATH 10A,A02,083736,Patchell; Gregory David,20,0,30,10
1657846016577,MATH 10A,A03,083737,Patchell; Gregory David,16,0,30,14
1657846022601,MATH 10B,A01,083207,Lim; Seonhee,8,0,34,26
1657846022601,MATH 10B,A02,083208,Lim; Seonhee,10,0,35,25
1657846022601,MATH 10B,A03,093472,Lim; Seonhee,7,0,34,27
1657846022601,MATH 10B,B01,083739,Sinha; Shubham,14,0,30,16
1657846028632,MATH 18,A01,083743,Cinel; Cameron Alexander,9,0,30,21
1657846028632,MATH 18,A02,083744,Cinel; Cameron Alexander,18,0,30,12
1657846028632,MATH 18,A03,083745,Cinel; Cameron Alexander,10,0,30,20
1657846028632,MATH 18,B01,083748,Rideout; David Porter,5,0,37,32
1657846028632,MATH 18,B02,083749,Rideout; David Porter,5,0,36,31
1657846028632,MATH 18,B03,083750,Rideout; David Porter,3,0,37,34
1657846028632,MATH 18,B04,083751,Rideout; David Porter,6,0,36,30
1657846028632,MATH 18,B05,093473,Rideout; David Porter,6,0,36,30
1657846028632,MATH 18,B06,093474,Rideout; David Porter,6,0,36,30
1657846034657,MATH 20A,A01,083754,Zheng; Zequn,14,0,40,26
1657846040684,MATH 20B,A01,083756,Briones; Jor-el Thomas Caparas,4,0,36,32
1657846040684,MATH 20B,A02,083757,Briones; Jor-el Thomas Caparas,1,0,36,35
1657846040684,MATH 20B,A03,093475,Briones; Jor-el Thomas Caparas,2,0,36,34
1657846046706,MATH 20C,A01,083760,Briones; Jor-el Thomas Caparas,1,0,35,34
1657846046706,MATH 20C,A02,083761,Briones; Jor-el Thomas Caparas,8,0,35,27
1657846046706,MATH 20C,A03,093476,Briones; Jor-el Thomas Caparas,0,1,36,36
1657846046706,MATH 20C,B01,083762,Bach; Quang Tran,1,0,30,29
1657846052734,MATH 20D,A01,083765,Tran; Brian Kha,5,0,30,25
1657846052734,MATH 20D,A02,083766,Tran; Brian Kha,5,0,30,25
1657846052734,MATH 20D,A03,083767,Tran; Brian Kha,5,0,30,25
1657846058760,MATH 20E,A01,083771,Ganguly; Soumya,10,0,32,22
1657846058760,MATH 20E,A02,083772,Ganguly; Soumya,6,0,32,26
1657846058760,MATH 20E,B01,083773,Ciotti; Benjamin,20,0,35,15
1657846058760,MATH 20E,B02,083774,Ciotti; Benjamin,18,0,35,17
1657846064791,MATH 103A,A01,083777,Greenfeld; Be'Eri,3,0,36,33
1657846064791,MATH 103A,A02,083778,Greenfeld; Be'Eri,5,0,36,31
1657846064791,MATH 103A,A03,093561,Greenfeld; Be'Eri,6,0,36,30
1657846064791,MATH 103A,B01,083779,Greenfeld; Be'Eri,7,0,36,29
1657846064791,MATH 103A,B02,083780,Greenfeld; Be'Eri,4,0,36,32
1657846064791,MATH 103A,B03,093562,Greenfeld; Be'Eri,3,0,36,33
1657846070818,MATH 105,A01,085443,Carter; Anne Toulson,15,0,35,20
1657846070818,MATH 105,A02,093477,Carter; Anne Toulson,20,0,35,15
1657846076846,MATH 109,A01,083213,Ganzberger; Geoffrey Michael,3,0,34,31
1657846076846,MATH 109,A02,083214,Ganzberger; Geoffrey Michael,4,0,34,30
1657846076846,MATH 109,A03,093478,Ganzberger; Geoffrey Michael,2,0,34,32
1657846076846,MATH 109,B01,083215,Ganzberger; Geoffrey Michael,1,0,32,31
1657846076846,MATH 109,B02,083216,Ganzberger; Geoffrey Michael,2,0,32,30
1657846076846,MATH 109,B03,093479,Ganzberger; Geoffrey Michael,8,0,32,24
1657846082875,MATH 142A,A01,083219,Chow; Bennett,7,0,32,25
1657846082875,MATH 142A,A02,083220,Chow; Bennett,10,0,32,22
1657846082875,MATH 142A,A03,093480,Chow; Bennett,9,0,32,23
1657846082875,MATH 142A,B03,093481,Chow; Bennett,8,0,32,24
1657846082875,MATH 142A,B04,093558,Chow; Bennett,13,0,32,19
1657846082875,MATH 142A,B05,093559,Chow; Bennett,7,0,32,25
1657846088901,MATH 193A,A01,083224,Rotar; Vladimir,8,0,34,26
1657846088901,MATH 193A,A02,083225,Rotar; Vladimir,10,0,34,24
1657846088901,MATH 193A,A03,083781,Rotar; Vladimir,5,0,34,29
1657846088901,MATH 193A,A04,083782,Rotar; Vladimir,11,0,34,23
1657846088901,MATH 193A,A05,093482,Rotar; Vladimir,10,0,34,24
1657846094928,MATH 197,001,091859,McAuley; Julian John,9999,0,9999,0
1657846094928,MATH 197,002,095566,Kedlaya; Kiran S.,9997,0,9999,2
1657846094928,MATH 197,003,095567,Xiao; Ming,9999,0,9999,0
1657846094928,MATH 197,004,095571,Perols; Johan Lars,9998,0,9999,1
1657846101991,COGS 9,A01,083615,Shannon; Kyle Michael,10,0,75,65
1657846108017,COGS 11,A01,083617,Boyle; Mary E. T.,23,0,48,25
1657846114041,COGS 13,A01,083071,Bastos; Amalia Pinkusfeld,11,0,71,60
1657846120070,COGS 14A,A01,092681,Semenuks; Arturs,5,1,100,95
1657846126099,COGS 14B,A01,083073,Cheng; Tzu-Han,6,0,63,57
1657846132123,COGS 17,A01,092677,Semenuks; Arturs,6,0,81,75
1657846138151,COGS 100,A01,083619,Allen; Michael Gordon,17,0,70,53
1657846144174,COGS 101A,A01,083621,Davis; Joshua Daniel,9,0,68,59
1657846150198,COGS 101B,A01,091572,Allen; Michael Gordon,12,0,65,53
1657846156222,COGS 101C,A01,083625,Delgado; Tania,17,0,35,18
1657846162248,COGS 107A,A01,083627,Boyle; Mary E. T.,14,0,60,46
1657846168275,COGS 118A,A01,083075,Gupta; Anjum,21,0,76,55
1657846174304,CSE 3,A50,083646,Miranda; Gregory Joseph,24,0,50,26
1657846180339,CSE 8A,A50,083650,Miranda; Gregory Joseph,17,1,56,39
1657846186360,CSE 11,A01,083080,Cao; Yingjun,6,15,40,34
1657846192386,CSE 12,A01,083652,Krause-Levy; Sophia Louisa,29,1,120,91
1657846198411,CSE 15L,A01,083654,Morris; Justin Loren,9,0,50,41
1657846198411,CSE 15L,A02,083655,Morris; Justin Loren,9,0,50,41
1657846204445,CSE 20,A01,083657,Tran; Khoa Dang,39,0,80,41
1657846210474,CSE 21,A01,095574,Bach; Quang Tran,22,0,48,26
1657846216498,CSE 30,A01,083084,Eldon; John,6,0,80,74
1657846216498,CSE 30,B01,095061,Bhaskar; Nishant,9,0,50,41
1657846222524,CSE 100,A01,083659,Cao; Yingjun,5,4,70,65
1657846228634,CSE 134B,A01,083661,Powell; Thomas Allan,24,0,100,76
1657846234662,CSE 140,A01,083663,Gungor; Onat,15,0,85,70
1657846240685,CSE 140L,A01,083088,Eldon; John,23,0,100,77
1657846246710,CSE 175,A01,083665,Kumar; Rakesh,3,0,25,22
1657846252731,CSE 190,A00,092507,Dubnov; Shlomo,8,0,20,12
1657846258753,ECE 45,A01,083139,Congero; Spencer William,6,0,75,69
1657846264775,ECE 65,A50,083695,Saad; Andrew S,12,0,30,18
1657846264775,ECE 65,A51,095125,Saad; Andrew S,24,0,26,2
1657846270798,ECE 109,A01,091882,Touri; Behrouz,20,0,70,50
1657846276823,ECE 180,A00,083140,Abi Samra; Nicholas Camill,1,0,30,29
1657846276823,ECE 180,B00,083141,Abi Samra; Nicholas Camill,0,0,30,30
1657846282849,MATH 10A,A01,083735,Patchell; Gregory David,2,0,30,28
1657846282849,MATH 10A,A02,083736,Patchell; Gregory David,20,0,30,10
1657846282849,MATH 10A,A03,083737,Patchell; Gregory David,16,0,30,14
1657846288873,MATH 10B,A01,083207,Lim; Seonhee,8,0,34,26
1657846288873,MATH 10B,A02,083208,Lim; Seonhee,10,0,35,25
1657846288873,MATH 10B,A03,093472,Lim; Seonhee,7,0,34,27
1657846288873,MATH 10B,B01,083739,Sinha; Shubham,14,0,30,16
1657846294899,MATH 18,A01,083743,Cinel; Cameron Alexander,9,0,30,21
1657846294899,MATH 18,A02,083744,Cinel; Cameron Alexander,18,0,30,12
1657846294899,MATH 18,A03,083745,Cinel; Cameron Alexander,10,0,30,20
1657846294899,MATH 18,B01,083748,Rideout; David Porter,5,0,37,32
1657846294899,MATH 18,B02,083749,Rideout; David Porter,5,0,36,31
1657846294899,MATH 18,B03,083750,Rideout; David Porter,3,0,37,34
1657846294899,MATH 18,B04,083751,Rideout; David Porter,6,0,36,30
1657846294899,MATH 18,B05,093473,Rideout; David Porter,6,0,36,30
1657846294899,MATH 18,B06,093474,Rideout; David Porter,6,0,36,30
1657846300922,MATH 20A,A01,083754,Zheng; Zequn,14,0,40,26
1657846306945,MATH 20B,A01,083756,Briones; Jor-el Thomas Caparas,4,0,36,32
1657846306945,MATH 20B,A02,083757,Briones; Jor-el Thomas Caparas,1,0,36,35
1657846306945,MATH 20B,A03,093475,Briones; Jor-el Thomas Caparas,2,0,36,34
1657846312967,MATH 20C,A01,083760,Briones; Jor-el Thomas Caparas,1,0,35,34
1657846312967,MATH 20C,A02,083761,Briones; Jor-el Thomas Caparas,8,0,35,27
1657846312967,MATH 20C,A03,093476,Briones; Jor-el Thomas Caparas,0,1,36,36
1657846312967,MATH 20C,B01,083762,Bach; Quang Tran,1,0,30,29
1657846318997,MATH 20D,A01,083765,Tran; Brian Kha,5,0,30,25
1657846318997,MATH 20D,A02,083766,Tran; Brian Kha,5,0,30,25
1657846318997,MATH 20D,A03,083767,Tran; Brian Kha,5,0,30,25
1657846325026,MATH 20E,A01,083771,Ganguly; Soumya,10,0,32,22
1657846325026,MATH 20E,A02,083772,Ganguly; Soumya,6,0,32,26
1657846325026,MATH 20E,B01,083773,Ciotti; Benjamin,20,0,35,15
1657846325026,MATH 20E,B02,083774,Ciotti; Benjamin,18,0,35,17
1657846331050,MATH 103A,A01,083777,Greenfeld; Be'Eri,3,0,36,33
1657846331050,MATH 103A,A02,083778,Greenfeld; Be'Eri,5,0,36,31
1657846331050,MATH 103A,A03,093561,Greenfeld; Be'Eri,6,0,36,30
1657846331050,MATH 103A,B01,083779,Greenfeld; Be'Eri,7,0,36,29
1657846331050,MATH 103A,B02,083780,Greenfeld; Be'Eri,4,0,36,32
1657846331050,MATH 103A,B03,093562,Greenfeld; Be'Eri,3,0,36,33
1657846337086,MATH 105,A01,085443,Carter; Anne Toulson,15,0,35,20
1657846337086,MATH 105,A02,093477,Carter; Anne Toulson,20,0,35,15
1657846343116,MATH 109,A01,083213,Ganzberger; Geoffrey Michael,3,0,34,31
1657846343116,MATH 109,A02,083214,Ganzberger; Geoffrey Michael,4,0,34,30
1657846343116,MATH 109,A03,093478,Ganzberger; Geoffrey Michael,2,0,34,32
1657846343116,MATH 109,B01,083215,Ganzberger; Geoffrey Michael,1,0,32,31
1657846343116,MATH 109,B02,083216,Ganzberger; Geoffrey Michael,2,0,32,30
1657846343116,MATH 109,B03,093479,Ganzberger; Geoffrey Michael,8,0,32,24
1657846349153,MATH 142A,A01,083219,Chow; Bennett,7,0,32,25
1657846349153,MATH 142A,A02,083220,Chow; Bennett,10,0,32,22
1657846349153,MATH 142A,A03,093480,Chow; Bennett,9,0,32,23
1657846349153,MATH 142A,B03,093481,Chow; Bennett,8,0,32,24
1657846349153,MATH 142A,B04,093558,Chow; Bennett,13,0,32,19
1657846349153,MATH 142A,B05,093559,Chow; Bennett,7,0,32,25
1657846355183,MATH 193A,A01,083224,Rotar; Vladimir,8,0,34,26
1657846355183,MATH 193A,A02,083225,Rotar; Vladimir,10,0,34,24
1657846355183,MATH 193A,A03,083781,Rotar; Vladimir,5,0,34,29
1657846355183,MATH 193A,A04,083782,Rotar; Vladimir,11,0,34,23
1657846355183,MATH 193A,A05,093482,Rotar; Vladimir,10,0,34,24
1657846361206,MATH 197,001,091859,McAuley; Julian John,9999,0,9999,0
1657846361206,MATH 197,002,095566,Kedlaya; Kiran S.,9997,0,9999,2
1657846361206,MATH 197,003,095567,Xiao; Ming,9999,0,9999,0
1657846361206,MATH 197,004,095571,Perols; Johan Lars,9998,0,9999,1
1657846368260,COGS 9,A01,083615,Shannon; Kyle Michael,10,0,75,65
1657846374282,COGS 11,A01,083617,Boyle; Mary E. T.,23,0,48,25
1657846380310,COGS 13,A01,083071,Bastos; Amalia Pinkusfeld,11,0,71,60
1657846386344,COGS 14A,A01,092681,Semenuks; Arturs,5,1,100,95
1657846392371,COGS 14B,A01,083073,Cheng; Tzu-Han,6,0,63,57
1657846398396,COGS 17,A01,092677,Semenuks; Arturs,6,0,81,75
1657846404422,COGS 100,A01,083619,Allen; Michael Gordon,17,0,70,53
1657846410446,COGS 101A,A01,083621,Davis; Joshua Daniel,9,0,68,59
1657846416475,COGS 101B,A01,091572,Allen; Michael Gordon,12,0,65,53
1657846422501,COGS 101C,A01,083625,Delgado; Tania,17,0,35,18
1657846428531,COGS 107A,A01,083627,Boyle; Mary E. T.,14,0,60,46
1657846434565,COGS 118A,A01,083075,Gupta; Anjum,21,0,76,55
1657846440592,CSE 3,A50,083646,Miranda; Gregory Joseph,24,0,50,26
1657846446616,CSE 8A,A50,083650,Miranda; Gregory Joseph,17,1,56,39
1657846452640,CSE 11,A01,083080,Cao; Yingjun,6,15,40,34
1657846458669,CSE 12,A01,083652,Krause-Levy; Sophia Louisa,29,1,120,91
1657846464692,CSE 15L,A01,083654,Morris; Justin Loren,9,0,50,41
1657846464692,CSE 15L,A02,083655,Morris; Justin Loren,9,0,50,41
1657846470720,CSE 20,A01,083657,Tran; Khoa Dang,39,0,80,41
1657846476749,CSE 21,A01,095574,Bach; Quang Tran,22,0,48,26
1657846482772,CSE 30,A01,083084,Eldon; John,6,0,80,74
1657846482772,CSE 30,B01,095061,Bhaskar; Nishant,9,0,50,41
1657846488795,CSE 100,A01,083659,Cao; Yingjun,5,4,70,65
1657846494821,CSE 134B,A01,083661,Powell; Thomas Allan,24,0,100,76
1657846500850,CSE 140,A01,083663,Gungor; Onat,15,0,85,70
1657846506872,CSE 140L,A01,083088,Eldon; John,23,0,100,77
1657846512898,CSE 175,A01,083665,Kumar; Rakesh,3,0,25,22
1657846518924,CSE 190,A00,092507,Dubnov; Shlomo,8,0,20,12
1657846524949,ECE 45,A01,083139,Congero; Spencer William,6,0,75,69
1657846530973,ECE 65,A50,083695,Saad; Andrew S,12,0,30,18
1657846530973,ECE 65,A51,095125,Saad; Andrew S,24,0,26,2
1657846537002,ECE 109,A01,091882,Touri; Behrouz,20,0,70,50
1657846543024,ECE 180,A00,083140,Abi Samra; Nicholas Camill,1,0,30,29
1657846543024,ECE 180,B00,083141,Abi Samra; Nicholas Camill,0,0,30,30
1657846549048,MATH 10A,A01,083735,Patchell; Gregory David,2,0,30,28
1657846549048,MATH 10A,A02,083736,Patchell; Gregory David,20,0,30,10
1657846549048,MATH 10A,A03,083737,Patchell; Gregory David,16,0,30,14
1657846555072,MATH 10B,A01,083207,Lim; Seonhee,8,0,34,26
1657846555072,MATH 10B,A02,083208,Lim; Seonhee,10,0,35,25
1657846555072,MATH 10B,A03,093472,Lim; Seonhee,7,0,34,27
1657846555072,MATH 10B,B01,083739,Sinha; Shubham,14,0,30,16
1657846561103,MATH 18,A01,083743,Cinel; Cameron Alexander,9,0,30,21
1657846561103,MATH 18,A02,083744,Cinel; Cameron Alexander,18,0,30,12
1657846561103,MATH 18,A03,083745,Cinel; Cameron Alexander,10,0,30,20
1657846561103,MATH 18,B01,083748,Rideout; David Porter,5,0,37,32
1657846561103,MATH 18,B02,083749,Rideout; David Porter,5,0,36,31
1657846561103,MATH 18,B03,083750,Rideout; David Porter,3,0,37,34
1657846561103,MATH 18,B04,083751,Rideout; David Porter,6,0,36,30
1657846561103,MATH 18,B05,093473,Rideout; David Porter,6,0,36,30
1657846561103,MATH 18,B06,093474,Rideout; David Porter,6,0,36,30
1657846567125,MATH 20A,A01,083754,Zheng; Zequn,14,0,40,26
1657846573154,MATH 20B,A01,083756,Briones; Jor-el Thomas Caparas,4,0,36,32
1657846573154,MATH 20B,A02,083757,Briones; Jor-el Thomas Caparas,1,0,36,35
1657846573154,MATH 20B,A03,093475,Briones; Jor-el Thomas Caparas,2,0,36,34
1657846579183,MATH 20C,A01,083760,Briones; Jor-el Thomas Caparas,1,0,35,34
1657846579183,MATH 20C,A02,083761,Briones; Jor-el Thomas Caparas,8,0,35,27
1657846579183,MATH 20C,A03,093476,Briones; Jor-el Thomas Caparas,0,1,36,36
1657846579183,MATH 20C,B01,083762,Bach; Quang Tran,1,0,30,29
1657846585205,MATH 20D,A01,083765,Tran; Brian Kha,5,0,30,25
1657846585205,MATH 20D,A02,083766,Tran; Brian Kha,5,0,30,25
1657846585205,MATH 20D,A03,083767,Tran; Brian Kha,5,0,30,25
1657846591229,MATH 20E,A01,083771,Ganguly; Soumya,10,0,32,22
1657846591229,MATH 20E,A02,083772,Ganguly; Soumya,6,0,32,26
1657846591229,MATH 20E,B01,083773,Ciotti; Benjamin,20,0,35,15
1657846591229,MATH 20E,B02,083774,Ciotti; Benjamin,18,0,35,17
1657846597253,MATH 103A,A01,083777,Greenfeld; Be'Eri,3,0,36,33
1657846597253,MATH 103A,A02,083778,Greenfeld; Be'Eri,5,0,36,31
1657846597253,MATH 103A,A03,093561,Greenfeld; Be'Eri,6,0,36,30
1657846597253,MATH 103A,B01,083779,Greenfeld; Be'Eri,7,0,36,29
1657846597253,MATH 103A,B02,083780,Greenfeld; Be'Eri,4,0,36,32
1657846597253,MATH 103A,B03,093562,Greenfeld; Be'Eri,3,0,36,33
1657846603280,MATH 105,A01,085443,Carter; Anne Toulson,15,0,35,20
1657846603280,MATH 105,A02,093477,Carter; Anne Toulson,20,0,35,15
1657846609303,MATH 109,A01,083213,Ganzberger; Geoffrey Michael,3,0,34,31
1657846609303,MATH 109,A02,083214,Ganzberger; Geoffrey Michael,4,0,34,30
1657846609303,MATH 109,A03,093478,Ganzberger; Geoffrey Michael,2,0,34,32
1657846609303,MATH 109,B01,083215,Ganzberger; Geoffrey Michael,1,0,32,31
1657846609303,MATH 109,B02,083216,Ganzberger; Geoffrey Michael,2,0,32,30
1657846609303,MATH 109,B03,093479,Ganzberger; Geoffrey Michael,8,0,32,24
1657846615329,MATH 142A,A01,083219,Chow; Bennett,7,0,32,25
1657846615329,MATH 142A,A02,083220,Chow; Bennett,10,0,32,22
1657846615329,MATH 142A,A03,093480,Chow; Bennett,9,0,32,23
1657846615329,MATH 142A,B03,093481,Chow; Bennett,8,0,32,24
1657846615329,MATH 142A,B04,093558,Chow; Bennett,13,0,32,19
1657846615329,MATH 142A,B05,093559,Chow; Bennett,7,0,32,25
1657846621353,MATH 193A,A01,083224,Rotar; Vladimir,8,0,34,26
1657846621353,MATH 193A,A02,083225,Rotar; Vladimir,10,0,34,24
1657846621353,MATH 193A,A03,083781,Rotar; Vladimir,5,0,34,29
1657846621353,MATH 193A,A04,083782,Rotar; Vladimir,11,0,34,23
1657846621353,MATH 193A,A05,093482,Rotar; Vladimir,10,0,34,24
1657846627375,MATH 197,001,091859,McAuley; Julian John,9999,0,9999,0
1657846627375,MATH 197,002,095566,Kedlaya; Kiran S.,9997,0,9999,2
1657846627375,MATH 197,003,095567,Xiao; Ming,9999,0,9999,0
1657846627375,MATH 197,004,095571,Perols; Johan Lars,9998,0,9999,1
1657846634427,COGS 9,A01,083615,Shannon; Kyle Michael,10,0,75,65
1657846640455,COGS 11,A01,083617,Boyle; Mary E. T.,23,0,48,25
1657846646482,COGS 13,A01,083071,Bastos; Amalia Pinkusfeld,11,0,71,60
1657846652505,COGS 14A,A01,092681,Semenuks; Arturs,5,1,100,95
1657846658532,COGS 14B,A01,083073,Cheng; Tzu-Han,6,0,63,57
1657846664555,COGS 17,A01,092677,Semenuks; Arturs,6,0,81,75
1657846670578,COGS 100,A01,083619,Allen; Michael Gordon,17,0,70,53
1657846676604,COGS 101A,A01,083621,Davis; Joshua Daniel,9,0,68,59
1657846682631,COGS 101B,A01,091572,Allen; Michael Gordon,12,0,65,53
1657846688658,COGS 101C,A01,083625,Delgado; Tania,17,0,35,18
1657846694690,COGS 107A,A01,083627,Boyle; Mary E. T.,14,0,60,46
1657846700728,COGS 118A,A01,083075,Gupta; Anjum,21,0,76,55
1657846706756,CSE 3,A50,083646,Miranda; Gregory Joseph,24,0,50,26
1657846712778,CSE 8A,A50,083650,Miranda; Gregory Joseph,17,1,56,39
1657846718802,CSE 11,A01,083080,Cao; Yingjun,6,15,40,34
1657846724831,CSE 12,A01,083652,Krause-Levy; Sophia Louisa,29,1,120,91
1657846730853,CSE 15L,A01,083654,Morris; Justin Loren,9,0,50,41
1657846730853,CSE 15L,A02,083655,Morris; Justin Loren,9,0,50,41
1657846736878,CSE 20,A01,083657,Tran; Khoa Dang,39,0,80,41
1657846742904,CSE 21,A01,095574,Bach; Quang Tran,22,0,48,26
1657846748926,CSE 30,A01,083084,Eldon; John,6,0,80,74
1657846748926,CSE 30,B01,095061,Bhaskar; Nishant,9,0,50,41
1657846754956,CSE 100,A01,083659,Cao; Yingjun,5,4,70,65
1657846760982,CSE 134B,A01,083661,Powell; Thomas Allan,24,0,100,76
1657846767007,CSE 140,A01,083663,Gungor; Onat,15,0,85,70
1657846773029,CSE 140L,A01,083088,Eldon; John,23,0,100,77
1657846779078,CSE 175,A01,083665,Kumar; Rakesh,3,0,25,22
1657846785102,CSE 190,A00,092507,Dubnov; Shlomo,8,0,20,12
1657846791128,ECE 45,A01,083139,Congero; Spencer William,6,0,75,69
1657846797155,ECE 65,A50,083695,Saad; Andrew S,12,0,30,18
1657846797155,ECE 65,A51,095125,Saad; Andrew S,24,0,26,2
1657846803182,ECE 109,A01,091882,Touri; Behrouz,20,0,70,50
1657846809207,ECE 180,A00,083140,Abi Samra; Nicholas Camill,1,0,30,29
1657846809207,ECE 180,B00,083141,Abi Samra; Nicholas Camill,0,0,30,30
1657846815231,MATH 10A,A01,083735,Patchell; Gregory David,2,0,30,28
1657846815231,MATH 10A,A02,083736,Patchell; Gregory David,20,0,30,10
1657846815231,MATH 10A,A03,083737,Patchell; Gregory David,16,0,30,14
1657846821259,MATH 10B,A01,083207,Lim; Seonhee,8,0,34,26
1657846821259,MATH 10B,A02,083208,Lim; Seonhee,10,0,35,25
1657846821259,MATH 10B,A03,093472,Lim; Seonhee,7,0,34,27
1657846821259,MATH 10B,B01,083739,Sinha; Shubham,14,0,30,16
1657846827375,MATH 18,A01,083743,Cinel; Cameron Alexander,9,0,30,21
1657846827375,MATH 18,A02,083744,Cinel; Cameron Alexander,18,0,30,12
1657846827375,MATH 18,A03,083745,Cinel; Cameron Alexander,10,0,30,20
1657846827375,MATH 18,B01,083748,Rideout; David Porter,5,0,37,32
1657846827375,MATH 18,B02,083749,Rideout; David Porter,5,0,36,31
1657846827375,MATH 18,B03,083750,Rideout; David Porter,3,0,37,34
1657846827375,MATH 18,B04,083751,Rideout; David Porter,6,0,36,30
1657846827375,MATH 18,B05,093473,Rideout; David Porter,6,0,36,30
1657846827375,MATH 18,B06,093474,Rideout; David Porter,6,0,36,30
1657846833402,MATH 20A,A01,083754,Zheng; Zequn,14,0,40,26
1657846839428,MATH 20B,A01,083756,Briones; Jor-el Thomas Caparas,4,0,36,32
1657846839428,MATH 20B,A02,083757,Briones; Jor-el Thomas Caparas,1,0,36,35
1657846839428,MATH 20B,A03,093475,Briones; Jor-el Thomas Caparas,2,0,36,34
1657846845461,MATH 20C,A01,083760,Briones; Jor-el Thomas Caparas,1,0,35,34
1657846845461,MATH 20C,A02,083761,Briones; Jor-el Thomas Caparas,8,0,35,27
1657846845461,MATH 20C,A03,093476,Briones; Jor-el Thomas Caparas,0,1,36,36
1657846845461,MATH 20C,B01,083762,Bach; Quang Tran,1,0,30,29
1657846851495,MATH 20D,A01,083765,Tran; Brian Kha,5,0,30,25
1657846851495,MATH 20D,A02,083766,Tran; Brian Kha,5,0,30,25
1657846851495,MATH 20D,A03,083767,Tran; Brian Kha,5,0,30,25
1657846857516,MATH 20E,A01,083771,Ganguly; Soumya,10,0,32,22
1657846857516,MATH 20E,A02,083772,Ganguly; Soumya,6,0,32,26
1657846857516,MATH 20E,B01,083773,Ciotti; Benjamin,20,0,35,15
1657846857516,MATH 20E,B02,083774,Ciotti; Benjamin,18,0,35,17
1657846863545,MATH 103A,A01,083777,Greenfeld; Be'Eri,3,0,36,33
1657846863545,MATH 103A,A02,083778,Greenfeld; Be'Eri,5,0,36,31
1657846863545,MATH 103A,A03,093561,Greenfeld; Be'Eri,6,0,36,30
1657846863545,MATH 103A,B01,083779,Greenfeld; Be'Eri,7,0,36,29
1657846863545,MATH 103A,B02,083780,Greenfeld; Be'Eri,4,0,36,32
1657846863545,MATH 103A,B03,093562,Greenfeld; Be'Eri,3,0,36,33
1657846869567,MATH 105,A01,085443,Carter; Anne Toulson,15,0,35,20
1657846869567,MATH 105,A02,093477,Carter; Anne Toulson,20,0,35,15
1657846875591,MATH 109,A01,083213,Ganzberger; Geoffrey Michael,3,0,34,31
1657846875591,MATH 109,A02,083214,Ganzberger; Geoffrey Michael,4,0,34,30
1657846875591,MATH 109,A03,093478,Ganzberger; Geoffrey Michael,2,0,34,32
1657846875591,MATH 109,B01,083215,Ganzberger; Geoffrey Michael,1,0,32,31
1657846875591,MATH 109,B02,083216,Ganzberger; Geoffrey Michael,2,0,32,30
1657846875591,MATH 109,B03,093479,Ganzberger; Geoffrey Michael,8,0,32,24
1657846881621,MATH 142A,A01,083219,Chow; Bennett,7,0,32,25
1657846881621,MATH 142A,A02,083220,Chow; Bennett,10,0,32,22
1657846881621,MATH 142A,A03,093480,Chow; Bennett,9,0,32,23
1657846881621,MATH 142A,B03,093481,Chow; Bennett,8,0,32,24
1657846881621,MATH 142A,B04,093558,Chow; Bennett,13,0,32,19
1657846881621,MATH 142A,B05,093559,Chow; Bennett,7,0,32,25
1657846887645,MATH 193A,A01,083224,Rotar; Vladimir,8,0,34,26
1657846887645,MATH 193A,A02,083225,Rotar; Vladimir,10,0,34,24
1657846887645,MATH 193A,A03,083781,Rotar; Vladimir,5,0,34,29
1657846887645,MATH 193A,A04,083782,Rotar; Vladimir,11,0,34,23
1657846887645,MATH 193A,A05,093482,Rotar; Vladimir,10,0,34,24
1657846893668,MATH 197,001,091859,McAuley; Julian John,9999,0,9999,0
1657846893668,MATH 197,002,095566,Kedlaya; Kiran S.,9997,0,9999,2
1657846893668,MATH 197,003,095567,Xiao; Ming,9999,0,9999,0
1657846893668,MATH 197,004,095571,Perols; Johan Lars,9998,0,9999,1
1657846900721,COGS 9,A01,083615,Shannon; Kyle Michael,10,0,75,65
1657846906743,COGS 11,A01,083617,Boyle; Mary E. T.,23,0,48,25
1657846912770,COGS 13,A01,083071,Bastos; Amalia Pinkusfeld,11,0,71,60
1657846918791,COGS 14A,A01,092681,Semenuks; Arturs,5,1,100,95
1657846924822,COGS 14B,A01,083073,Cheng; Tzu-Han,6,0,63,57
1657846930850,COGS 17,A01,092677,Semenuks; Arturs,6,0,81,75
1657846936877,COGS 100,A01,083619,Allen; Michael Gordon,17,0,70,53
1657846942900,COGS 101A,A01,083621,Davis; Joshua Daniel,9,0,68,59
1657846948925,COGS 101B,A01,091572,Allen; Michael Gordon,12,0,65,53
1657846954950,COGS 101C,A01,083625,Delgado; Tania,17,0,35,18
1657846960986,COGS 107A,A01,083627,Boyle; Mary E. T.,14,0,60,46
1657846967008,COGS 118A,A01,083075,Gupta; Anjum,21,0,76,55
1657846973034,CSE 3,A50,083646,Miranda; Gregory Joseph,24,0,50,26
1657846979061,CSE 8A,A50,083650,Miranda; Gregory Joseph,17,1,56,39
1657846985092,CSE 11,A01,083080,Cao; Yingjun,6,15,40,34
1657846991118,CSE 12,A01,083652,Krause-Levy; Sophia Louisa,29,1,120,91
1657846997141,CSE 15L,A01,083654,Morris; Justin Loren,9,0,50,41
1657846997141,CSE 15L,A02,083655,Morris; Justin Loren,9,0,50,41
1657847003164,CSE 20,A01,083657,Tran; Khoa Dang,39,0,80,41
1657847009190,CSE 21,A01,095574,Bach; Quang Tran,22,0,48,26
1657847015212,CSE 30,A01,083084,Eldon; John,6,0,80,74
1657847015212,CSE 30,B01,095061,Bhaskar; Nishant,9,0,50,41
1657847021239,CSE 100,A01,083659,Cao; Yingjun,5,4,70,65
1657847027265,CSE 134B,A01,083661,Powell; Thomas Allan,24,0,100,76
1657847033290,CSE 140,A01,083663,Gungor; Onat,15,0,85,70
1657847039315,CSE 140L,A01,083088,Eldon; John,23,0,100,77
1657847045339,CSE 175,A01,083665,Kumar; Rakesh,3,0,25,22
1657847051361,CSE 190,A00,092507,Dubnov; Shlomo,8,0,20,12
1657847057387,ECE 45,A01,083139,Congero; Spencer William,6,0,75,69
1657847063411,ECE 65,A50,083695,Saad; Andrew S,12,0,30,18
1657847063411,ECE 65,A51,095125,Saad; Andrew S,24,0,26,2
1657847069437,ECE 109,A01,091882,Touri; Behrouz,20,0,70,50
1657847075460,ECE 180,A00,083140,Abi Samra; Nicholas Camill,1,0,30,29
1657847075460,ECE 180,B00,083141,Abi Samra; Nicholas Camill,0,0,30,30
1657847081482,MATH 10A,A01,083735,Patchell; Gregory David,2,0,30,28
1657847081482,MATH 10A,A02,083736,Patchell; Gregory David,20,0,30,10
1657847081482,MATH 10A,A03,083737,Patchell; Gregory David,16,0,30,14
1657847087518,MATH 10B,A01,083207,Lim; Seonhee,8,0,34,26
1657847087518,MATH 10B,A02,083208,Lim; Seonhee,10,0,35,25
1657847087518,MATH 10B,A03,093472,Lim; Seonhee,7,0,34,27
1657847087518,MATH 10B,B01,083739,Sinha; Shubham,14,0,30,16
1657847093550,MATH 18,A01,083743,Cinel; Cameron Alexander,9,0,30,21
1657847093550,MATH 18,A02,083744,Cinel; Cameron Alexander,18,0,30,12
1657847093550,MATH 18,A03,083745,Cinel; Cameron Alexander,10,0,30,20
1657847093550,MATH 18,B01,083748,Rideout; David Porter,5,0,37,32
1657847093550,MATH 18,B02,083749,Rideout; David Porter,5,0,36,31
1657847093550,MATH 18,B03,083750,Rideout; David Porter,3,0,37,34
1657847093550,MATH 18,B04,083751,Rideout; David Porter,6,0,36,30
1657847093550,MATH 18,B05,093473,Rideout; David Porter,6,0,36,30
1657847093550,MATH 18,B06,093474,Rideout; David Porter,6,0,36,30
1657847099573,MATH 20A,A01,083754,Zheng; Zequn,14,0,40,26
1657847105600,MATH 20B,A01,083756,Briones; Jor-el Thomas Caparas,4,0,36,32
1657847105600,MATH 20B,A02,083757,Briones; Jor-el Thomas Caparas,1,0,36,35
1657847105600,MATH 20B,A03,093475,Briones; Jor-el Thomas Caparas,2,0,36,34
1657847111623,MATH 20C,A01,083760,Briones; Jor-el Thomas Caparas,1,0,35,34
1657847111623,MATH 20C,A02,083761,Briones; Jor-el Thomas Caparas,8,0,35,27
1657847111623,MATH 20C,A03,093476,Briones; Jor-el Thomas Caparas,0,1,36,36
1657847111623,MATH 20C,B01,083762,Bach; Quang Tran,1,0,30,29
1657847117646,MATH 20D,A01,083765,Tran; Brian Kha,5,0,30,25
1657847117646,MATH 20D,A02,083766,Tran; Brian Kha,5,0,30,25
1657847117646,MATH 20D,A03,083767,Tran; Brian Kha,5,0,30,25
1657847123669,MATH 20E,A01,083771,Ganguly; Soumya,10,0,32,22
1657847123669,MATH 20E,A02,083772,Ganguly; Soumya,6,0,32,26
1657847123669,MATH 20E,B01,083773,Ciotti; Benjamin,20,0,35,15
1657847123669,MATH 20E,B02,083774,Ciotti; Benjamin,18,0,35,17
1657847129695,MATH 103A,A01,083777,Greenfeld; Be'Eri,3,0,36,33
1657847129695,MATH 103A,A02,083778,Greenfeld; Be'Eri,5,0,36,31
1657847129695,MATH 103A,A03,093561,Greenfeld; Be'Eri,6,0,36,30
1657847129695,MATH 103A,B01,083779,Greenfeld; Be'Eri,7,0,36,29
1657847129695,MATH 103A,B02,083780,Greenfeld; Be'Eri,4,0,36,32
1657847129695,MATH 103A,B03,093562,Greenfeld; Be'Eri,3,0,36,33
1657847135727,MATH 105,A01,085443,Carter; Anne Toulson,15,0,35,20
1657847135727,MATH 105,A02,093477,Carter; Anne Toulson,20,0,35,15
1657847141752,MATH 109,A01,083213,Ganzberger; Geoffrey Michael,3,0,34,31
1657847141752,MATH 109,A02,083214,Ganzberger; Geoffrey Michael,4,0,34,30
1657847141752,MATH 109,A03,093478,Ganzberger; Geoffrey Michael,2,0,34,32
1657847141752,MATH 109,B01,083215,Ganzberger; Geoffrey Michael,1,0,32,31
1657847141752,MATH 109,B02,083216,Ganzberger; Geoffrey Michael,2,0,32,30
1657847141752,MATH 109,B03,093479,Ganzberger; Geoffrey Michael,8,0,32,24
1657847147784,MATH 142A,A01,083219,Chow; Bennett,7,0,32,25
1657847147784,MATH 142A,A02,083220,Chow; Bennett,10,0,32,22
1657847147784,MATH 142A,A03,093480,Chow; Bennett,9,0,32,23
1657847147784,MATH 142A,B03,093481,Chow; Bennett,8,0,32,24
1657847147784,MATH 142A,B04,093558,Chow; Bennett,13,0,32,19
1657847147784,MATH 142A,B05,093559,Chow; Bennett,7,0,32,25
1657847153808,MATH 193A,A01,083224,Rotar; Vladimir,8,0,34,26
1657847153808,MATH 193A,A02,083225,Rotar; Vladimir,10,0,34,24
1657847153808,MATH 193A,A03,083781,Rotar; Vladimir,5,0,34,29
1657847153808,MATH 193A,A04,083782,Rotar; Vladimir,11,0,34,23
1657847153808,MATH 193A,A05,093482,Rotar; Vladimir,10,0,34,24
1657847159835,MATH 197,001,091859,McAuley; Julian John,9999,0,9999,0
1657847159835,MATH 197,002,095566,Kedlaya; Kiran S.,9997,0,9999,2
1657847159835,MATH 197,003,095567,Xiao; Ming,9999,0,9999,0
1657847159835,MATH 197,004,095571,Perols; Johan Lars,9998,0,9999,1
1657847166895,COGS 9,A01,083615,Shannon; Kyle Michael,10,0,75,65
1657847172924,COGS 11,A01,083617,Boyle; Mary E. T.,23,0,48,25
1657847178948,COGS 13,A01,083071,Bastos; Amalia Pinkusfeld,11,0,71,60
1657847184971,COGS 14A,A01,092681,Semenuks; Arturs,5,1,100,95
1657847190995,COGS 14B,A01,083073,Cheng; Tzu-Han,6,0,63,57
1657847197018,COGS 17,A01,092677,Semenuks; Arturs,6,0,81,75
1657847203055,COGS 100,A01,083619,Allen; Michael Gordon,17,0,70,53
1657847209078,COGS 101A,A01,083621,Davis; Joshua Daniel,9,0,68,59
1657847215109,COGS 101B,A01,091572,Allen; Michael Gordon,12,0,65,53
1657847221131,COGS 101C,A01,083625,Delgado; Tania,17,0,35,18
1657847227154,COGS 107A,A01,083627,Boyle; Mary E. T.,14,0,60,46
1657847233176,COGS 118A,A01,083075,Gupta; Anjum,21,0,76,55
1657847239198,CSE 3,A50,083646,Miranda; Gregory Joseph,24,0,50,26
1657847245223,CSE 8A,A50,083650,Miranda; Gregory Joseph,17,1,56,39
1657847251249,CSE 11,A01,083080,Cao; Yingjun,6,15,40,34
1657847257273,CSE 12,A01,083652,Krause-Levy; Sophia Louisa,29,1,120,91
1657847263297,CSE 15L,A01,083654,Morris; Justin Loren,9,0,50,41
1657847263297,CSE 15L,A02,083655,Morris; Justin Loren,9,0,50,41
1657847269332,CSE 20,A01,083657,Tran; Khoa Dang,39,0,80,41
1657847275356,CSE 21,A01,095574,Bach; Quang Tran,22,0,48,26
1657847281381,CSE 30,A01,083084,Eldon; John,6,0,80,74
1657847281381,CSE 30,B01,095061,Bhaskar; Nishant,9,0,50,41
1657847287403,CSE 100,A01,083659,Cao; Yingjun,5,4,70,65
1657847293428,CSE 134B,A01,083661,Powell; Thomas Allan,24,0,100,76
1657847299455,CSE 140,A01,083663,Gungor; Onat,15,0,85,70
1657847305478,CSE 140L,A01,083088,Eldon; John,23,0,100,77
1657847311502,CSE 175,A01,083665,Kumar; Rakesh,3,0,25,22
1657847317523,CSE 190,A00,092507,Dubnov; Shlomo,8,0,20,12
1657847323547,ECE 45,A01,083139,Congero; Spencer William,6,0,75,69
1657847329575,ECE 65,A50,083695,Saad; Andrew S,12,0,30,18
1657847329575,ECE 65,A51,095125,Saad; Andrew S,24,0,26,2
1657847335600,ECE 109,A01,091882,Touri; Behrouz,20,0,70,50
1657847341632,ECE 180,A00,083140,Abi Samra; Nicholas Camill,1,0,30,29
1657847341632,ECE 180,B00,083141,Abi Samra; Nicholas Camill,0,0,30,30
1657847347654,MATH 10A,A01,083735,Patchell; Gregory David,2,0,30,28
1657847347654,MATH 10A,A02,083736,Patchell; Gregory David,20,0,30,10
1657847347654,MATH 10A,A03,083737,Patchell; Gregory David,16,0,30,14
1657847353676,MATH 10B,A01,083207,Lim; Seonhee,8,0,34,26
1657847353676,MATH 10B,A02,083208,Lim; Seonhee,10,0,35,25
1657847353676,MATH 10B,A03,093472,Lim; Seonhee,7,0,34,27
1657847353676,MATH 10B,B01,083739,Sinha; Shubham,14,0,30,16
1657847359706,MATH 18,A01,083743,Cinel; Cameron Alexander,9,0,30,21
1657847359706,MATH 18,A02,083744,Cinel; Cameron Alexander,18,0,30,12
1657847359706,MATH 18,A03,083745,Cinel; Cameron Alexander,10,0,30,20
1657847359706,MATH 18,B01,083748,Rideout; David Porter,5,0,37,32
1657847359706,MATH 18,B02,083749,Rideout; David Porter,5,0,36,31
1657847359706,MATH 18,B03,083750,Rideout; David Porter,3,0,37,34
1657847359706,MATH 18,B04,083751,Rideout; David Porter,6,0,36,30
1657847359706,MATH 18,B05,093473,Rideout; David Porter,6,0,36,30
1657847359706,MATH 18,B06,093474,Rideout; David Porter,6,0,36,30
1657847365732,MATH 20A,A01,083754,Zheng; Zequn,14,0,40,26
1657847371761,MATH 20B,A01,083756,Briones; Jor-el Thomas Caparas,4,0,36,32
1657847371761,MATH 20B,A02,083757,Briones; Jor-el Thomas Caparas,1,0,36,35
1657847371761,MATH 20B,A03,093475,Briones; Jor-el Thomas Caparas,2,0,36,34
1657847377783,MATH 20C,A01,083760,Briones; Jor-el Thomas Caparas,1,0,35,34
1657847377783,MATH 20C,A02,083761,Briones; Jor-el Thomas Caparas,8,0,35,27
1657847377783,MATH 20C,A03,093476,Briones; Jor-el Thomas Caparas,0,1,36,36
1657847377783,MATH 20C,B01,083762,Bach; Quang Tran,1,0,30,29
1657847383807,MATH 20D,A01,083765,Tran; Brian Kha,5,0,30,25
1657847383807,MATH 20D,A02,083766,Tran; Brian Kha,5,0,30,25
1657847383807,MATH 20D,A03,083767,Tran; Brian Kha,5,0,30,25
1657847389830,MATH 20E,A01,083771,Ganguly; Soumya,10,0,32,22
1657847389830,MATH 20E,A02,083772,Ganguly; Soumya,6,0,32,26
1657847389830,MATH 20E,B01,083773,Ciotti; Benjamin,20,0,35,15
1657847389830,MATH 20E,B02,083774,Ciotti; Benjamin,18,0,35,17
1657847395853,MATH 103A,A01,083777,Greenfeld; Be'Eri,3,0,36,33
1657847395853,MATH 103A,A02,083778,Greenfeld; Be'Eri,5,0,36,31
1657847395853,MATH 103A,A03,093561,Greenfeld; Be'Eri,6,0,36,30
1657847395853,MATH 103A,B01,083779,Greenfeld; Be'Eri,7,0,36,29
1657847395853,MATH 103A,B02,083780,Greenfeld; Be'Eri,4,0,36,32
1657847395853,MATH 103A,B03,093562,Greenfeld; Be'Eri,3,0,36,33
1657847401881,MATH 105,A01,085443,Carter; Anne Toulson,15,0,35,20
1657847401881,MATH 105,A02,093477,Carter; Anne Toulson,20,0,35,15
1657847407909,MATH 109,A01,083213,Ganzberger; Geoffrey Michael,3,0,34,31
1657847407909,MATH 109,A02,083214,Ganzberger; Geoffrey Michael,4,0,34,30
1657847407909,MATH 109,A03,093478,Ganzberger; Geoffrey Michael,2,0,34,32
1657847407909,MATH 109,B01,083215,Ganzberger; Geoffrey Michael,1,0,32,31
1657847407909,MATH 109,B02,083216,Ganzberger; Geoffrey Michael,2,0,32,30
1657847407909,MATH 109,B03,093479,Ganzberger; Geoffrey Michael,8,0,32,24
1657847413938,MATH 142A,A01,083219,Chow; Bennett,7,0,32,25
1657847413938,MATH 142A,A02,083220,Chow; Bennett,10,0,32,22
1657847413938,MATH 142A,A03,093480,Chow; Bennett,9,0,32,23
1657847413938,MATH 142A,B03,093481,Chow; Bennett,8,0,32,24
1657847413938,MATH 142A,B04,093558,Chow; Bennett,13,0,32,19
1657847413938,MATH 142A,B05,093559,Chow; Bennett,7,0,32,25
1657847419965,MATH 193A,A01,083224,Rotar; Vladimir,8,0,34,26
1657847419965,MATH 193A,A02,083225,Rotar; Vladimir,10,0,34,24
1657847419965,MATH 193A,A03,083781,Rotar; Vladimir,5,0,34,29
1657847419965,MATH 193A,A04,083782,Rotar; Vladimir,11,0,34,23
1657847419965,MATH 193A,A05,093482,Rotar; Vladimir,10,0,34,24
1657847426078,MATH 197,001,091859,McAuley; Julian John,9999,0,9999,0
1657847426078,MATH 197,002,095566,Kedlaya; Kiran S.,9997,0,9999,2
1657847426078,MATH 197,003,095567,Xiao; Ming,9999,0,9999,0
1657847426078,MATH 197,004,095571,Perols; Johan Lars,9998,0,9999,1
1657847433131,COGS 9,A01,083615,Shannon; Kyle Michael,10,0,75,65
1657847439155,COGS 11,A01,083617,Boyle; Mary E. T.,23,0,48,25
1657847445185,COGS 13,A01,083071,Bastos; Amalia Pinkusfeld,11,0,71,60
1657847451211,COGS 14A,A01,092681,Semenuks; Arturs,5,1,100,95
1657847457237,COGS 14B,A01,083073,Cheng; Tzu-Han,6,0,63,57
1657847463260,COGS 17,A01,092677,Semenuks; Arturs,6,0,81,75
1657847469283,COGS 100,A01,083619,Allen; Michael Gordon,17,0,70,53
1657847475317,COGS 101A,A01,083621,Davis; Joshua Daniel,9,0,68,59
1657847481342,COGS 101B,A01,091572,Allen; Michael Gordon,12,0,65,53
1657847487370,COGS 101C,A01,083625,Delgado; Tania,17,0,35,18
1657847493399,COGS 107A,A01,083627,Boyle; Mary E. T.,14,0,60,46
1657847499421,COGS 118A,A01,083075,Gupta; Anjum,21,0,76,55
1657847505445,CSE 3,A50,083646,Miranda; Gregory Joseph,24,0,50,26
1657847511473,CSE 8A,A50,083650,Miranda; Gregory Joseph,17,1,56,39
1657847517495,CSE 11,A01,083080,Cao; Yingjun,6,15,40,34
1657847523524,CSE 12,A01,083652,Krause-Levy; Sophia Louisa,29,1,120,91
1657847529550,CSE 15L,A01,083654,Morris; Justin Loren,9,0,50,41
1657847529550,CSE 15L,A02,083655,Morris; Justin Loren,9,0,50,41
1657847535572,CSE 20,A01,083657,Tran; Khoa Dang,39,0,80,41
1657847541611,CSE 21,A01,095574,Bach; Quang Tran,22,0,48,26
1657847547638,CSE 30,A01,083084,Eldon; John,6,0,80,74
1657847547638,CSE 30,B01,095061,Bhaskar; Nishant,9,0,50,41
1657847553666,CSE 100,A01,083659,Cao; Yingjun,5,4,70,65
1657847559693,CSE 134B,A01,083661,Powell; Thomas Allan,24,0,100,76
1657847565717,CSE 140,A01,083663,Gungor; Onat,15,0,85,70
1657847571740,CSE 140L,A01,083088,Eldon; John,23,0,100,77
1657847577777,CSE 175,A01,083665,Kumar; Rakesh,3,0,25,22
1657847583800,CSE 190,A00,092507,Dubnov; Shlomo,8,0,20,12
1657847589826,ECE 45,A01,083139,Congero; Spencer William,6,0,75,69
1657847595850,ECE 65,A50,083695,Saad; Andrew S,12,0,30,18
1657847595850,ECE 65,A51,095125,Saad; Andrew S,24,0,26,2
1657847601873,ECE 109,A01,091882,Touri; Behrouz,20,0,70,50
1657847607903,ECE 180,A00,083140,Abi Samra; Nicholas Camill,1,0,30,29
1657847607903,ECE 180,B00,083141,Abi Samra; Nicholas Camill,0,0,30,30
1657847613926,MATH 10A,A01,083735,Patchell; Gregory David,2,0,30,28
1657847613926,MATH 10A,A02,083736,Patchell; Gregory David,20,0,30,10
1657847613926,MATH 10A,A03,083737,Patchell; Gregory David,16,0,30,14
1657847619955,MATH 10B,A01,083207,Lim; Seonhee,8,0,34,26
1657847619955,MATH 10B,A02,083208,Lim; Seonhee,10,0,35,25
1657847619955,MATH 10B,A03,093472,Lim; Seonhee,7,0,34,27
1657847619955,MATH 10B,B01,083739,Sinha; Shubham,14,0,30,16
1657847625987,MATH 18,A01,083743,Cinel; Cameron Alexander,9,0,30,21
1657847625987,MATH 18,A02,083744,Cinel; Cameron Alexander,18,0,30,12
1657847625987,MATH 18,A03,083745,Cinel; Cameron Alexander,10,0,30,20
1657847625987,MATH 18,B01,083748,Rideout; David Porter,5,0,37,32
1657847625987,MATH 18,B02,083749,Rideout; David Porter,5,0,36,31
1657847625987,MATH 18,B03,083750,Rideout; David Porter,3,0,37,34
1657847625987,MATH 18,B04,083751,Rideout; David Porter,6,0,36,30
1657847625987,MATH 18,B05,093473,Rideout; David Porter,6,0,36,30
1657847625987,MATH 18,B06,093474,Rideout; David Porter,6,0,36,30
1657847632018,MATH 20A,A01,083754,Zheng; Zequn,14,0,40,26
1657847638041,MATH 20B,A01,083756,Briones; Jor-el Thomas Caparas,4,0,36,32
1657847638041,MATH 20B,A02,083757,Briones; Jor-el Thomas Caparas,1,0,36,35
1657847638041,MATH 20B,A03,093475,Briones; Jor-el Thomas Caparas,2,0,36,34
1657847644069,MATH 20C,A01,083760,Briones; Jor-el Thomas Caparas,1,0,35,34
1657847644069,MATH 20C,A02,083761,Briones; Jor-el Thomas Caparas,8,0,35,27
1657847644069,MATH 20C,A03,093476,Briones; Jor-el Thomas Caparas,0,1,36,36
1657847644069,MATH 20C,B01,083762,Bach; Quang Tran,1,0,30,29
1657847650094,MATH 20D,A01,083765,Tran; Brian Kha,5,0,30,25
1657847650094,MATH 20D,A02,083766,Tran; Brian Kha,5,0,30,25
1657847650094,MATH 20D,A03,083767,Tran; Brian Kha,5,0,30,25
1657847656127,MATH 20E,A01,083771,Ganguly; Soumya,10,0,32,22
1657847656127,MATH 20E,A02,083772,Ganguly; Soumya,6,0,32,26
1657847656127,MATH 20E,B01,083773,Ciotti; Benjamin,20,0,35,15
1657847656127,MATH 20E,B02,083774,Ciotti; Benjamin,18,0,35,17
1657847662165,MATH 103A,A01,083777,Greenfeld; Be'Eri,3,0,36,33
1657847662165,MATH 103A,A02,083778,Greenfeld; Be'Eri,5,0,36,31
1657847662165,MATH 103A,A03,093561,Greenfeld; Be'Eri,6,0,36,30
1657847662165,MATH 103A,B01,083779,Greenfeld; Be'Eri,7,0,36,29
1657847662165,MATH 103A,B02,083780,Greenfeld; Be'Eri,4,0,36,32
1657847662165,MATH 103A,B03,093562,Greenfeld; Be'Eri,3,0,36,33
1657847668188,MATH 105,A01,085443,Carter; Anne Toulson,15,0,35,20
1657847668188,MATH 105,A02,093477,Carter; Anne Toulson,20,0,35,15
1657847674217,MATH 109,A01,083213,Ganzberger; Geoffrey Michael,3,0,34,31
1657847674217,MATH 109,A02,083214,Ganzberger; Geoffrey Michael,4,0,34,30
1657847674217,MATH 109,A03,093478,Ganzberger; Geoffrey Michael,2,0,34,32
1657847674217,MATH 109,B01,083215,Ganzberger; Geoffrey Michael,1,0,32,31
1657847674217,MATH 109,B02,083216,Ganzberger; Geoffrey Michael,2,0,32,30
1657847674217,MATH 109,B03,093479,Ganzberger; Geoffrey Michael,8,0,32,24
1657847680240,MATH 142A,A01,083219,Chow; Bennett,7,0,32,25
1657847680240,MATH 142A,A02,083220,Chow; Bennett,10,0,32,22
1657847680240,MATH 142A,A03,093480,Chow; Bennett,9,0,32,23
1657847680240,MATH 142A,B03,093481,Chow; Bennett,8,0,32,24
1657847680240,MATH 142A,B04,093558,Chow; Bennett,13,0,32,19
1657847680240,MATH 142A,B05,093559,Chow; Bennett,7,0,32,25
1657847686268,MATH 193A,A01,083224,Rotar; Vladimir,8,0,34,26
1657847686268,MATH 193A,A02,083225,Rotar; Vladimir,10,0,34,24
1657847686268,MATH 193A,A03,083781,Rotar; Vladimir,5,0,34,29
1657847686268,MATH 193A,A04,083782,Rotar; Vladimir,11,0,34,23
1657847686268,MATH 193A,A05,093482,Rotar; Vladimir,10,0,34,24
1657847692291,MATH 197,001,091859,McAuley; Julian John,9999,0,9999,0
1657847692291,MATH 197,002,095566,Kedlaya; Kiran S.,9997,0,9999,2
1657847692291,MATH 197,003,095567,Xiao; Ming,9999,0,9999,0
1657847692291,MATH 197,004,095571,Perols; Johan Lars,9998,0,9999,1
1657847699371,COGS 9,A01,083615,Shannon; Kyle Michael,10,0,75,65
1657847705398,COGS 11,A01,083617,Boyle; Mary E. T.,23,0,48,25
1657847711420,COGS 13,A01,083071,Bastos; Amalia Pinkusfeld,11,0,71,60
1657847717454,COGS 14A,A01,092681,Semenuks; Arturs,5,1,100,95
1657847723478,COGS 14B,A01,083073,Cheng; Tzu-Han,6,0,63,57
1657847729502,COGS 17,A01,092677,Semenuks; Arturs,6,0,81,75
1657847735528,COGS 100,A01,083619,Allen; Michael Gordon,17,0,70,53
1657847741554,COGS 101A,A01,083621,Davis; Joshua Daniel,9,0,68,59
1657847747577,COGS 101B,A01,091572,Allen; Michael Gordon,12,0,65,53
1657847753605,COGS 101C,A01,083625,Delgado; Tania,17,0,35,18
1657847759632,COGS 107A,A01,083627,Boyle; Mary E. T.,14,0,60,46
1657847765654,COGS 118A,A01,083075,Gupta; Anjum,21,0,76,55
1657847771678,CSE 3,A50,083646,Miranda; Gregory Joseph,24,0,50,26
1657847777705,CSE 8A,A50,083650,Miranda; Gregory Joseph,17,1,56,39
1657847783734,CSE 11,A01,083080,Cao; Yingjun,6,15,40,34
1657847789758,CSE 12,A01,083652,Krause-Levy; Sophia Louisa,29,1,120,91
1657847795785,CSE 15L,A01,083654,Morris; Justin Loren,9,0,50,41
1657847795785,CSE 15L,A02,083655,Morris; Justin Loren,9,0,50,41
1657847801809,CSE 20,A01,083657,Tran; Khoa Dang,39,0,80,41
1657847807832,CSE 21,A01,095574,Bach; Quang Tran,22,0,48,26
1657847813857,CSE 30,A01,083084,Eldon; John,6,0,80,74
1657847813857,CSE 30,B01,095061,Bhaskar; Nishant,9,0,50,41
1657847819880,CSE 100,A01,083659,Cao; Yingjun,5,4,70,65
1657847825915,CSE 134B,A01,083661,Powell; Thomas Allan,24,0,100,76
1657847831939,CSE 140,A01,083663,Gungor; Onat,15,0,85,70
1657847837962,CSE 140L,A01,083088,Eldon; John,23,0,100,77
1657847843986,CSE 175,A01,083665,Kumar; Rakesh,3,0,25,22
1657847850012,CSE 190,A00,092507,Dubnov; Shlomo,8,0,20,12
1657847856038,ECE 45,A01,083139,Congero; Spencer William,6,0,75,69
1657847862061,ECE 65,A50,083695,Saad; Andrew S,12,0,30,18
1657847862061,ECE 65,A51,095125,Saad; Andrew S,24,0,26,2
1657847868084,ECE 109,A01,091882,Touri; Behrouz,20,0,70,50
1657847874106,ECE 180,A00,083140,Abi Samra; Nicholas Camill,1,0,30,29
1657847874106,ECE 180,B00,083141,Abi Samra; Nicholas Camill,0,0,30,30
1657847880132,MATH 10A,A01,083735,Patchell; Gregory David,2,0,30,28
1657847880132,MATH 10A,A02,083736,Patchell; Gregory David,20,0,30,10
1657847880132,MATH 10A,A03,083737,Patchell; Gregory David,16,0,30,14
1657847886156,MATH 10B,A01,083207,Lim; Seonhee,8,0,34,26
1657847886156,MATH 10B,A02,083208,Lim; Seonhee,10,0,35,25
1657847886156,MATH 10B,A03,093472,Lim; Seonhee,7,0,34,27
1657847886156,MATH 10B,B01,083739,Sinha; Shubham,14,0,30,16
1657847892189,MATH 18,A01,083743,Cinel; Cameron Alexander,9,0,30,21
1657847892189,MATH 18,A02,083744,Cinel; Cameron Alexander,18,0,30,12
1657847892189,MATH 18,A03,083745,Cinel; Cameron Alexander,10,0,30,20
1657847892189,MATH 18,B01,083748,Rideout; David Porter,5,0,37,32
1657847892189,MATH 18,B02,083749,Rideout; David Porter,5,0,36,31
1657847892189,MATH 18,B03,083750,Rideout; David Porter,3,0,37,34
1657847892189,MATH 18,B04,083751,Rideout; David Porter,6,0,36,30
1657847892189,MATH 18,B05,093473,Rideout; David Porter,6,0,36,30
1657847892189,MATH 18,B06,093474,Rideout; David Porter,6,0,36,30
1657847898212,MATH 20A,A01,083754,Zheng; Zequn,14,0,40,26
1657847904235,MATH 20B,A01,083756,Briones; Jor-el Thomas Caparas,4,0,36,32
1657847904235,MATH 20B,A02,083757,Briones; Jor-el Thomas Caparas,1,0,36,35
1657847904235,MATH 20B,A03,093475,Briones; Jor-el Thomas Caparas,2,0,36,34
1657847910268,MATH 20C,A01,083760,Briones; Jor-el Thomas Caparas,1,0,35,34
1657847910268,MATH 20C,A02,083761,Briones; Jor-el Thomas Caparas,8,0,35,27
1657847910268,MATH 20C,A03,093476,Briones; Jor-el Thomas Caparas,0,1,36,36
1657847910268,MATH 20C,B01,083762,Bach; Quang Tran,1,0,30,29
1657847916300,MATH 20D,A01,083765,Tran; Brian Kha,5,0,30,25
1657847916300,MATH 20D,A02,083766,Tran; Brian Kha,5,0,30,25
1657847916300,MATH 20D,A03,083767,Tran; Brian Kha,5,0,30,25
1657847922324,MATH 20E,A01,083771,Ganguly; Soumya,10,0,32,22
1657847922324,MATH 20E,A02,083772,Ganguly; Soumya,6,0,32,26
1657847922324,MATH 20E,B01,083773,Ciotti; Benjamin,20,0,35,15
1657847922324,MATH 20E,B02,083774,Ciotti; Benjamin,18,0,35,17
1657847928354,MATH 103A,A01,083777,Greenfeld; Be'Eri,3,0,36,33
1657847928354,MATH 103A,A02,083778,Greenfeld; Be'Eri,5,0,36,31
1657847928354,MATH 103A,A03,093561,Greenfeld; Be'Eri,6,0,36,30
1657847928354,MATH 103A,B01,083779,Greenfeld; Be'Eri,7,0,36,29
1657847928354,MATH 103A,B02,083780,Greenfeld; Be'Eri,4,0,36,32
1657847928354,MATH 103A,B03,093562,Greenfeld; Be'Eri,3,0,36,33
1657847934384,MATH 105,A01,085443,Carter; Anne Toulson,15,0,35,20
1657847934384,MATH 105,A02,093477,Carter; Anne Toulson,20,0,35,15
1657847940414,MATH 109,A01,083213,Ganzberger; Geoffrey Michael,3,0,34,31
1657847940414,MATH 109,A02,083214,Ganzberger; Geoffrey Michael,4,0,34,30
1657847940414,MATH 109,A03,093478,Ganzberger; Geoffrey Michael,2,0,34,32
1657847940414,MATH 109,B01,083215,Ganzberger; Geoffrey Michael,1,0,32,31
1657847940414,MATH 109,B02,083216,Ganzberger; Geoffrey Michael,2,0,32,30
1657847940414,MATH 109,B03,093479,Ganzberger; Geoffrey Michael,8,0,32,24
1657847946436,MATH 142A,A01,083219,Chow; Bennett,7,0,32,25
1657847946436,MATH 142A,A02,083220,Chow; Bennett,10,0,32,22
1657847946436,MATH 142A,A03,093480,Chow; Bennett,9,0,32,23
1657847946436,MATH 142A,B03,093481,Chow; Bennett,8,0,32,24
1657847946436,MATH 142A,B04,093558,Chow; Bennett,13,0,32,19
1657847946436,MATH 142A,B05,093559,Chow; Bennett,7,0,32,25
1657847952460,MATH 193A,A01,083224,Rotar; Vladimir,8,0,34,26
1657847952460,MATH 193A,A02,083225,Rotar; Vladimir,10,0,34,24
1657847952460,MATH 193A,A03,083781,Rotar; Vladimir,5,0,34,29
1657847952460,MATH 193A,A04,083782,Rotar; Vladimir,11,0,34,23
1657847952460,MATH 193A,A05,093482,Rotar; Vladimir,10,0,34,24
1657847958482,MATH 197,001,091859,McAuley; Julian John,9999,0,9999,0
1657847958482,MATH 197,002,095566,Kedlaya; Kiran S.,9997,0,9999,2
1657847958482,MATH 197,003,095567,Xiao; Ming,9999,0,9999,0
1657847958482,MATH 197,004,095571,Perols; Johan Lars,9998,0,9999,1
1657847965551,COGS 9,A01,083615,Shannon; Kyle Michael,10,0,75,65
1657847971588,COGS 11,A01,083617,Boyle; Mary E. T.,23,0,48,25
1657847977610,COGS 13,A01,083071,Bastos; Amalia Pinkusfeld,11,0,71,60
1657847983641,COGS 14A,A01,092681,Semenuks; Arturs,5,1,100,95
1657847989663,COGS 14B,A01,083073,Cheng; Tzu-Han,6,0,63,57
1657847995686,COGS 17,A01,092677,Semenuks; Arturs,6,0,81,75
1657848001727,COGS 100,A01,083619,Allen; Michael Gordon,17,0,70,53
1657848007753,COGS 101A,A01,083621,Davis; Joshua Daniel,9,0,68,59
1657848013780,COGS 101B,A01,091572,Allen; Michael Gordon,12,0,65,53
1657848019881,COGS 101C,A01,083625,Delgado; Tania,17,0,35,18
1657848025904,COGS 107A,A01,083627,Boyle; Mary E. T.,14,0,60,46
1657848031935,COGS 118A,A01,083075,Gupta; Anjum,21,0,76,55
1657848037962,CSE 3,A50,083646,Miranda; Gregory Joseph,24,0,50,26
1657848043985,CSE 8A,A50,083650,Miranda; Gregory Joseph,17,1,56,39
1657848050007,CSE 11,A01,083080,Cao; Yingjun,6,15,40,34
1657848056034,CSE 12,A01,083652,Krause-Levy; Sophia Louisa,29,1,120,91
1657848062061,CSE 15L,A01,083654,Morris; Justin Loren,9,0,50,41
1657848062061,CSE 15L,A02,083655,Morris; Justin Loren,9,0,50,41
1657848068084,CSE 20,A01,083657,Tran; Khoa Dang,39,0,80,41
1657848074108,CSE 21,A01,095574,Bach; Quang Tran,22,0,48,26
1657848080133,CSE 30,A01,083084,Eldon; John,6,0,80,74
1657848080133,CSE 30,B01,095061,Bhaskar; Nishant,9,0,50,41
1657848086155,CSE 100,A01,083659,Cao; Yingjun,5,4,70,65
1657848092180,CSE 134B,A01,083661,Powell; Thomas Allan,24,0,100,76
1657848098207,CSE 140,A01,083663,Gungor; Onat,15,0,85,70
1657848104234,CSE 140L,A01,083088,Eldon; John,23,0,100,77
1657848110257,CSE 175,A01,083665,Kumar; Rakesh,3,0,25,22
1657848116280,CSE 190,A00,092507,Dubnov; Shlomo,8,0,20,12
1657848122302,ECE 45,A01,083139,Congero; Spencer William,6,0,75,69
1657848128327,ECE 65,A50,083695,Saad; Andrew S,12,0,30,18
1657848128327,ECE 65,A51,095125,Saad; Andrew S,24,0,26,2
1657848134354,ECE 109,A01,091882,Touri; Behrouz,20,0,70,50
1657848140376,ECE 180,A00,083140,Abi Samra; Nicholas Camill,1,0,30,29
1657848140376,ECE 180,B00,083141,Abi Samra; Nicholas Camill,0,0,30,30
1657848146401,MATH 10A,A01,083735,Patchell; Gregory David,2,0,30,28
1657848146401,MATH 10A,A02,083736,Patchell; Gregory David,20,0,30,10
1657848146401,MATH 10A,A03,083737,Patchell; Gregory David,16,0,30,14
1657848152428,MATH 10B,A01,083207,Lim; Seonhee,8,0,34,26
1657848152428,MATH 10B,A02,083208,Lim; Seonhee,10,0,35,25
1657848152428,MATH 10B,A03,093472,Lim; Seonhee,7,0,34,27
1657848152428,MATH 10B,B01,083739,Sinha; Shubham,14,0,30,16
1657848158454,MATH 18,A01,083743,Cinel; Cameron Alexander,9,0,30,21
1657848158454,MATH 18,A02,083744,Cinel; Cameron Alexander,18,0,30,12
1657848158454,MATH 18,A03,083745,Cinel; Cameron Alexander,10,0,30,20
1657848158454,MATH 18,B01,083748,Rideout; David Porter,5,0,37,32
1657848158454,MATH 18,B02,083749,Rideout; David Porter,5,0,36,31
1657848158454,MATH 18,B03,083750,Rideout; David Porter,3,0,37,34
1657848158454,MATH 18,B04,083751,Rideout; David Porter,6,0,36,30
1657848158454,MATH 18,B05,093473,Rideout; David Porter,6,0,36,30
1657848158454,MATH 18,B06,093474,Rideout; David Porter,6,0,36,30
1657848164480,MATH 20A,A01,083754,Zheng; Zequn,14,0,40,26
1657848170507,MATH 20B,A01,083756,Briones; Jor-el Thomas Caparas,4,0,36,32
1657848170507,MATH 20B,A02,083757,Briones; Jor-el Thomas Caparas,1,0,36,35
1657848170507,MATH 20B,A03,093475,Briones; Jor-el Thomas Caparas,2,0,36,34
1657848176536,MATH 20C,A01,083760,Briones; Jor-el Thomas Caparas,1,0,35,34
1657848176536,MATH 20C,A02,083761,Briones; Jor-el Thomas Caparas,8,0,35,27
1657848176536,MATH 20C,A03,093476,Briones; Jor-el Thomas Caparas,0,1,36,36
1657848176536,MATH 20C,B01,083762,Bach; Quang Tran,1,0,30,29
1657848182561,MATH 20D,A01,083765,Tran; Brian Kha,5,0,30,25
1657848182561,MATH 20D,A02,083766,Tran; Brian Kha,5,0,30,25
1657848182561,MATH 20D,A03,083767,Tran; Brian Kha,5,0,30,25
1657848188588,MATH 20E,A01,083771,Ganguly; Soumya,10,0,32,22
1657848188588,MATH 20E,A02,083772,Ganguly; Soumya,6,0,32,26
1657848188588,MATH 20E,B01,083773,Ciotti; Benjamin,20,0,35,15
1657848188588,MATH 20E,B02,083774,Ciotti; Benjamin,18,0,35,17
1657848194612,MATH 103A,A01,083777,Greenfeld; Be'Eri,3,0,36,33
1657848194612,MATH 103A,A02,083778,Greenfeld; Be'Eri,5,0,36,31
1657848194612,MATH 103A,A03,093561,Greenfeld; Be'Eri,6,0,36,30
1657848194612,MATH 103A,B01,083779,Greenfeld; Be'Eri,7,0,36,29
1657848194612,MATH 103A,B02,083780,Greenfeld; Be'Eri,4,0,36,32
1657848194612,MATH 103A,B03,093562,Greenfeld; Be'Eri,3,0,36,33
1657848200641,MATH 105,A01,085443,Carter; Anne Toulson,15,0,35,20
1657848200641,MATH 105,A02,093477,Carter; Anne Toulson,20,0,35,15
1657848206664,MATH 109,A01,083213,Ganzberger; Geoffrey Michael,3,0,34,31
1657848206664,MATH 109,A02,083214,Ganzberger; Geoffrey Michael,4,0,34,30
1657848206664,MATH 109,A03,093478,Ganzberger; Geoffrey Michael,2,0,34,32
1657848206664,MATH 109,B01,083215,Ganzberger; Geoffrey Michael,1,0,32,31
1657848206664,MATH 109,B02,083216,Ganzberger; Geoffrey Michael,2,0,32,30
1657848206664,MATH 109,B03,093479,Ganzberger; Geoffrey Michael,8,0,32,24
1657848212695,MATH 142A,A01,083219,Chow; Bennett,7,0,32,25
1657848212695,MATH 142A,A02,083220,Chow; Bennett,10,0,32,22
1657848212695,MATH 142A,A03,093480,Chow; Bennett,9,0,32,23
1657848212695,MATH 142A,B03,093481,Chow; Bennett,8,0,32,24
1657848212695,MATH 142A,B04,093558,Chow; Bennett,13,0,32,19
1657848212695,MATH 142A,B05,093559,Chow; Bennett,7,0,32,25
1657848218724,MATH 193A,A01,083224,Rotar; Vladimir,8,0,34,26
1657848218724,MATH 193A,A02,083225,Rotar; Vladimir,10,0,34,24
1657848218724,MATH 193A,A03,083781,Rotar; Vladimir,5,0,34,29
1657848218724,MATH 193A,A04,083782,Rotar; Vladimir,11,0,34,23
1657848218724,MATH 193A,A05,093482,Rotar; Vladimir,10,0,34,24
1657848224746,MATH 197,001,091859,McAuley; Julian John,9999,0,9999,0
1657848224746,MATH 197,002,095566,Kedlaya; Kiran S.,9997,0,9999,2
1657848224746,MATH 197,003,095567,Xiao; Ming,9999,0,9999,0
1657848224746,MATH 197,004,095571,Perols; Johan Lars,9998,0,9999,1
1657848231815,COGS 9,A01,083615,Shannon; Kyle Michael,10,0,75,65
1657848237840,COGS 11,A01,083617,Boyle; Mary E. T.,23,0,48,25
1657848243873,COGS 13,A01,083071,Bastos; Amalia Pinkusfeld,11,0,71,60
1657848249899,COGS 14A,A01,092681,Semenuks; Arturs,5,1,100,95
1657848255924,COGS 14B,A01,083073,Cheng; Tzu-Han,6,0,63,57
1657848261949,COGS 17,A01,092677,Semenuks; Arturs,6,0,81,75
1657848267972,COGS 100,A01,083619,Allen; Michael Gordon,17,0,70,53
1657848274000,COGS 101A,A01,083621,Davis; Joshua Daniel,9,0,68,59
1657848280031,COGS 101B,A01,091572,Allen; Michael Gordon,12,0,65,53
1657848286057,COGS 101C,A01,083625,Delgado; Tania,17,0,35,18
1657848292079,COGS 107A,A01,083627,Boyle; Mary E. T.,14,0,60,46
1657848298110,COGS 118A,A01,083075,Gupta; Anjum,21,0,76,55
1657848304147,CSE 3,A50,083646,Miranda; Gregory Joseph,24,0,50,26
1657848310174,CSE 8A,A50,083650,Miranda; Gregory Joseph,17,1,56,39
1657848316197,CSE 11,A01,083080,Cao; Yingjun,6,15,40,34
1657848322223,CSE 12,A01,083652,Krause-Levy; Sophia Louisa,29,1,120,91
1657848328246,CSE 15L,A01,083654,Morris; Justin Loren,9,0,50,41
1657848328246,CSE 15L,A02,083655,Morris; Justin Loren,9,0,50,41
1657848334273,CSE 20,A01,083657,Tran; Khoa Dang,39,0,80,41
1657848340302,CSE 21,A01,095574,Bach; Quang Tran,22,0,48,26
1657848346325,CSE 30,A01,083084,Eldon; John,6,0,80,74
1657848346325,CSE 30,B01,095061,Bhaskar; Nishant,9,0,50,41
1657848352348,CSE 100,A01,083659,Cao; Yingjun,5,4,70,65
1657848358375,CSE 134B,A01,083661,Powell; Thomas Allan,24,0,100,76
1657848364401,CSE 140,A01,083663,Gungor; Onat,15,0,85,70
1657848370423,CSE 140L,A01,083088,Eldon; John,23,0,100,77
1657848376450,CSE 175,A01,083665,Kumar; Rakesh,3,0,25,22
1657848382472,CSE 190,A00,092507,Dubnov; Shlomo,8,0,20,12
1657848388497,ECE 45,A01,083139,Congero; Spencer William,6,0,75,69
1657848394524,ECE 65,A50,083695,Saad; Andrew S,12,0,30,18
1657848394524,ECE 65,A51,095125,Saad; Andrew S,24,0,26,2
1657848400548,ECE 109,A01,091882,Touri; Behrouz,20,0,70,50
1657848406575,ECE 180,A00,083140,Abi Samra; Nicholas Camill,1,0,30,29
1657848406575,ECE 180,B00,083141,Abi Samra; Nicholas Camill,0,0,30,30
1657848412598,MATH 10A,A01,083735,Patchell; Gregory David,2,0,30,28
1657848412598,MATH 10A,A02,083736,Patchell; Gregory David,20,0,30,10
1657848412598,MATH 10A,A03,083737,Patchell; Gregory David,16,0,30,14
1657848418628,MATH 10B,A01,083207,Lim; Seonhee,8,0,34,26
1657848418628,MATH 10B,A02,083208,Lim; Seonhee,10,0,35,25
1657848418628,MATH 10B,A03,093472,Lim; Seonhee,7,0,34,27
1657848418628,MATH 10B,B01,083739,Sinha; Shubham,14,0,30,16
1657848424653,MATH 18,A01,083743,Cinel; Cameron Alexander,9,0,30,21
1657848424653,MATH 18,A02,083744,Cinel; Cameron Alexander,18,0,30,12
1657848424653,MATH 18,A03,083745,Cinel; Cameron Alexander,10,0,30,20
1657848424653,MATH 18,B01,083748,Rideout; David Porter,5,0,37,32
1657848424653,MATH 18,B02,083749,Rideout; David Porter,5,0,36,31
1657848424653,MATH 18,B03,083750,Rideout; David Porter,3,0,37,34
1657848424653,MATH 18,B04,083751,Rideout; David Porter,6,0,36,30
1657848424653,MATH 18,B05,093473,Rideout; David Porter,6,0,36,30
1657848424653,MATH 18,B06,093474,Rideout; David Porter,6,0,36,30
1657848430678,MATH 20A,A01,083754,Zheng; Zequn,14,0,40,26
1657848436706,MATH 20B,A01,083756,Briones; Jor-el Thomas Caparas,4,0,36,32
1657848436706,MATH 20B,A02,083757,Briones; Jor-el Thomas Caparas,1,0,36,35
1657848436706,MATH 20B,A03,093475,Briones; Jor-el Thomas Caparas,2,0,36,34
1657848442734,MATH 20C,A01,083760,Briones; Jor-el Thomas Caparas,1,0,35,34
1657848442734,MATH 20C,A02,083761,Briones; Jor-el Thomas Caparas,8,0,35,27
1657848442734,MATH 20C,A03,093476,Briones; Jor-el Thomas Caparas,0,1,36,36
1657848442734,MATH 20C,B01,083762,Bach; Quang Tran,1,0,30,29
1657848448758,MATH 20D,A01,083765,Tran; Brian Kha,5,0,30,25
1657848448758,MATH 20D,A02,083766,Tran; Brian Kha,5,0,30,25
1657848448758,MATH 20D,A03,083767,Tran; Brian Kha,5,0,30,25
1657848454786,MATH 20E,A01,083771,Ganguly; Soumya,10,0,32,22
1657848454786,MATH 20E,A02,083772,Ganguly; Soumya,6,0,32,26
1657848454786,MATH 20E,B01,083773,Ciotti; Benjamin,20,0,35,15
1657848454786,MATH 20E,B02,083774,Ciotti; Benjamin,18,0,35,17
1657848460810,MATH 103A,A01,083777,Greenfeld; Be'Eri,3,0,36,33
1657848460810,MATH 103A,A02,083778,Greenfeld; Be'Eri,5,0,36,31
1657848460810,MATH 103A,A03,093561,Greenfeld; Be'Eri,6,0,36,30
1657848460810,MATH 103A,B01,083779,Greenfeld; Be'Eri,7,0,36,29
1657848460810,MATH 103A,B02,083780,Greenfeld; Be'Eri,4,0,36,32
1657848460810,MATH 103A,B03,093562,Greenfeld; Be'Eri,3,0,36,33
1657848466840,MATH 105,A01,085443,Carter; Anne Toulson,15,0,35,20
1657848466840,MATH 105,A02,093477,Carter; Anne Toulson,20,0,35,15
1657848472864,MATH 109,A01,083213,Ganzberger; Geoffrey Michael,3,0,34,31
1657848472864,MATH 109,A02,083214,Ganzberger; Geoffrey Michael,4,0,34,30
1657848472864,MATH 109,A03,093478,Ganzberger; Geoffrey Michael,2,0,34,32
1657848472864,MATH 109,B01,083215,Ganzberger; Geoffrey Michael,1,0,32,31
1657848472864,MATH 109,B02,083216,Ganzberger; Geoffrey Michael,2,0,32,30
1657848472864,MATH 109,B03,093479,Ganzberger; Geoffrey Michael,8,0,32,24
1657848478893,MATH 142A,A01,083219,Chow; Bennett,7,0,32,25
1657848478893,MATH 142A,A02,083220,Chow; Bennett,10,0,32,22
1657848478893,MATH 142A,A03,093480,Chow; Bennett,9,0,32,23
1657848478893,MATH 142A,B03,093481,Chow; Bennett,8,0,32,24
1657848478893,MATH 142A,B04,093558,Chow; Bennett,13,0,32,19
1657848478893,MATH 142A,B05,093559,Chow; Bennett,7,0,32,25
1657848484922,MATH 193A,A01,083224,Rotar; Vladimir,8,0,34,26
1657848484922,MATH 193A,A02,083225,Rotar; Vladimir,10,0,34,24
1657848484922,MATH 193A,A03,083781,Rotar; Vladimir,5,0,34,29
1657848484922,MATH 193A,A04,083782,Rotar; Vladimir,11,0,34,23
1657848484922,MATH 193A,A05,093482,Rotar; Vladimir,10,0,34,24
1657848490944,MATH 197,001,091859,McAuley; Julian John,9999,0,9999,0
1657848490944,MATH 197,002,095566,Kedlaya; Kiran S.,9997,0,9999,2
1657848490944,MATH 197,003,095567,Xiao; Ming,9999,0,9999,0
1657848490944,MATH 197,004,095571,Perols; Johan Lars,9998,0,9999,1
1657848497992,COGS 9,A01,083615,Shannon; Kyle Michael,10,0,75,65
1657848504014,COGS 11,A01,083617,Boyle; Mary E. T.,23,0,48,25
1657848510041,COGS 13,A01,083071,Bastos; Amalia Pinkusfeld,11,0,71,60
1657848516064,COGS 14A,A01,092681,Semenuks; Arturs,5,1,100,95
1657848522089,COGS 14B,A01,083073,Cheng; Tzu-Han,6,0,63,57
1657848528116,COGS 17,A01,092677,Semenuks; Arturs,6,0,81,75
1657848534149,COGS 100,A01,083619,Allen; Michael Gordon,17,0,70,53
1657848540188,COGS 101A,A01,083621,Davis; Joshua Daniel,9,0,68,59
1657848546212,COGS 101B,A01,091572,Allen; Michael Gordon,12,0,65,53
1657848552234,COGS 101C,A01,083625,Delgado; Tania,17,0,35,18
1657848558261,COGS 107A,A01,083627,Boyle; Mary E. T.,14,0,60,46
1657848564285,COGS 118A,A01,083075,Gupta; Anjum,21,0,76,55
1657848570311,CSE 3,A50,083646,Miranda; Gregory Joseph,24,0,50,26
1657848576334,CSE 8A,A50,083650,Miranda; Gregory Joseph,17,1,56,39
1657848582358,CSE 11,A01,083080,Cao; Yingjun,6,15,40,34
1657848588381,CSE 12,A01,083652,Krause-Levy; Sophia Louisa,29,1,120,91
1657848594419,CSE 15L,A01,083654,Morris; Justin Loren,9,0,50,41
1657848594419,CSE 15L,A02,083655,Morris; Justin Loren,9,0,50,41
1657848600452,CSE 20,A01,083657,Tran; Khoa Dang,39,0,80,41
1657848606477,CSE 21,A01,095574,Bach; Quang Tran,22,0,48,26
1657848612500,CSE 30,A01,083084,Eldon; John,6,0,80,74
1657848612500,CSE 30,B01,095061,Bhaskar; Nishant,9,0,50,41
1657848618599,CSE 100,A01,083659,Cao; Yingjun,5,4,70,65
1657848624623,CSE 134B,A01,083661,Powell; Thomas Allan,24,0,100,76
1657848630648,CSE 140,A01,083663,Gungor; Onat,15,0,85,70
1657848636669,CSE 140L,A01,083088,Eldon; John,23,0,100,77
1657848642701,CSE 175,A01,083665,Kumar; Rakesh,3,0,25,22
1657848648724,CSE 190,A00,092507,Dubnov; Shlomo,8,0,20,12
1657848654750,ECE 45,A01,083139,Congero; Spencer William,6,0,75,69
1657848660779,ECE 65,A50,083695,Saad; Andrew S,12,0,30,18
1657848660779,ECE 65,A51,095125,Saad; Andrew S,24,0,26,2
1657848666807,ECE 109,A01,091882,Touri; Behrouz,20,0,70,50
1657848672833,ECE 180,A00,083140,Abi Samra; Nicholas Camill,1,0,30,29
1657848672833,ECE 180,B00,083141,Abi Samra; Nicholas Camill,0,0,30,30
1657848678857,MATH 10A,A01,083735,Patchell; Gregory David,2,0,30,28
1657848678857,MATH 10A,A02,083736,Patchell; Gregory David,20,0,30,10
1657848678857,MATH 10A,A03,083737,Patchell; Gregory David,16,0,30,14
1657848684885,MATH 10B,A01,083207,Lim; Seonhee,8,0,34,26
1657848684885,MATH 10B,A02,083208,Lim; Seonhee,10,0,35,25
1657848684885,MATH 10B,A03,093472,Lim; Seonhee,7,0,34,27
1657848684885,MATH 10B,B01,083739,Sinha; Shubham,14,0,30,16
1657848690908,MATH 18,A01,083743,Cinel; Cameron Alexander,9,0,30,21
1657848690908,MATH 18,A02,083744,Cinel; Cameron Alexander,18,0,30,12
1657848690908,MATH 18,A03,083745,Cinel; Cameron Alexander,10,0,30,20
1657848690908,MATH 18,B01,083748,Rideout; David Porter,5,0,37,32
1657848690908,MATH 18,B02,083749,Rideout; David Porter,5,0,36,31
1657848690908,MATH 18,B03,083750,Rideout; David Porter,3,0,37,34
1657848690908,MATH 18,B04,083751,Rideout; David Porter,6,0,36,30
1657848690908,MATH 18,B05,093473,Rideout; David Porter,6,0,36,30
1657848690908,MATH 18,B06,093474,Rideout; David Porter,6,0,36,30
1657848696931,MATH 20A,A01,083754,Zheng; Zequn,14,0,40,26
1657848702958,MATH 20B,A01,083756,Briones; Jor-el Thomas Caparas,4,0,36,32
1657848702958,MATH 20B,A02,083757,Briones; Jor-el Thomas Caparas,1,0,36,35
1657848702958,MATH 20B,A03,093475,Briones; Jor-el Thomas Caparas,2,0,36,34
1657848708981,MATH 20C,A01,083760,Briones; Jor-el Thomas Caparas,1,0,35,34
1657848708981,MATH 20C,A02,083761,Briones; Jor-el Thomas Caparas,8,0,35,27
1657848708981,MATH 20C,A03,093476,Briones; Jor-el Thomas Caparas,0,1,36,36
1657848708981,MATH 20C,B01,083762,Bach; Quang Tran,1,0,30,29
1657848715006,MATH 20D,A01,083765,Tran; Brian Kha,5,0,30,25
1657848715006,MATH 20D,A02,083766,Tran; Brian Kha,5,0,30,25
1657848715006,MATH 20D,A03,083767,Tran; Brian Kha,5,0,30,25
1657848721031,MATH 20E,A01,083771,Ganguly; Soumya,10,0,32,22
1657848721031,MATH 20E,A02,083772,Ganguly; Soumya,6,0,32,26
1657848721031,MATH 20E,B01,083773,Ciotti; Benjamin,20,0,35,15
1657848721031,MATH 20E,B02,083774,Ciotti; Benjamin,18,0,35,17
1657848727054,MATH 103A,A01,083777,Greenfeld; Be'Eri,3,0,36,33
1657848727054,MATH 103A,A02,083778,Greenfeld; Be'Eri,5,0,36,31
1657848727054,MATH 103A,A03,093561,Greenfeld; Be'Eri,6,0,36,30
1657848727054,MATH 103A,B01,083779,Greenfeld; Be'Eri,7,0,36,29
1657848727054,MATH 103A,B02,083780,Greenfeld; Be'Eri,4,0,36,32
1657848727054,MATH 103A,B03,093562,Greenfeld; Be'Eri,3,0,36,33
1657848733079,MATH 105,A01,085443,Carter; Anne Toulson,15,0,35,20
1657848733079,MATH 105,A02,093477,Carter; Anne Toulson,20,0,35,15
1657848739107,MATH 109,A01,083213,Ganzberger; Geoffrey Michael,3,0,34,31
1657848739107,MATH 109,A02,083214,Ganzberger; Geoffrey Michael,4,0,34,30
1657848739107,MATH 109,A03,093478,Ganzberger; Geoffrey Michael,2,0,34,32
1657848739107,MATH 109,B01,083215,Ganzberger; Geoffrey Michael,1,0,32,31
1657848739107,MATH 109,B02,083216,Ganzberger; Geoffrey Michael,2,0,32,30
1657848739107,MATH 109,B03,093479,Ganzberger; Geoffrey Michael,8,0,32,24
1657848745137,MATH 142A,A01,083219,Chow; Bennett,7,0,32,25
1657848745137,MATH 142A,A02,083220,Chow; Bennett,10,0,32,22
1657848745137,MATH 142A,A03,093480,Chow; Bennett,9,0,32,23
1657848745137,MATH 142A,B03,093481,Chow; Bennett,8,0,32,24
1657848745137,MATH 142A,B04,093558,Chow; Bennett,13,0,32,19
1657848745137,MATH 142A,B05,093559,Chow; Bennett,7,0,32,25
1657848751165,MATH 193A,A01,083224,Rotar; Vladimir,8,0,34,26
1657848751165,MATH 193A,A02,083225,Rotar; Vladimir,10,0,34,24
1657848751165,MATH 193A,A03,083781,Rotar; Vladimir,5,0,34,29
1657848751165,MATH 193A,A04,083782,Rotar; Vladimir,11,0,34,23
1657848751165,MATH 193A,A05,093482,Rotar; Vladimir,10,0,34,24
1657848757191,MATH 197,001,091859,McAuley; Julian John,9999,0,9999,0
1657848757191,MATH 197,002,095566,Kedlaya; Kiran S.,9997,0,9999,2
1657848757191,MATH 197,003,095567,Xiao; Ming,9999,0,9999,0
1657848757191,MATH 197,004,095571,Perols; Johan Lars,9998,0,9999,1
1657848764251,COGS 9,A01,083615,Shannon; Kyle Michael,10,0,75,65
1657848770278,COGS 11,A01,083617,Boyle; Mary E. T.,23,0,48,25
1657848776311,COGS 13,A01,083071,Bastos; Amalia Pinkusfeld,11,0,71,60
1657848782338,COGS 14A,A01,092681,Semenuks; Arturs,5,1,100,95
1657848788364,COGS 14B,A01,083073,Cheng; Tzu-Han,6,0,63,57
1657848794392,COGS 17,A01,092677,Semenuks; Arturs,6,0,81,75
1657848800418,COGS 100,A01,083619,Allen; Michael Gordon,17,0,70,53
1657848806444,COGS 101A,A01,083621,Davis; Joshua Daniel,9,0,68,59
1657848812469,COGS 101B,A01,091572,Allen; Michael Gordon,12,0,65,53
1657848818498,COGS 101C,A01,083625,Delgado; Tania,17,0,35,18
1657848824525,COGS 107A,A01,083627,Boyle; Mary E. T.,14,0,60,46
1657848830547,COGS 118A,A01,083075,Gupta; Anjum,21,0,76,55
1657848836577,CSE 3,A50,083646,Miranda; Gregory Joseph,24,0,50,26
1657848842599,CSE 8A,A50,083650,Miranda; Gregory Joseph,17,1,56,39
1657848848633,CSE 11,A01,083080,Cao; Yingjun,6,15,40,34
1657848854655,CSE 12,A01,083652,Krause-Levy; Sophia Louisa,29,1,120,91
1657848860684,CSE 15L,A01,083654,Morris; Justin Loren,9,0,50,41
1657848860684,CSE 15L,A02,083655,Morris; Justin Loren,9,0,50,41
1657848866713,CSE 20,A01,083657,Tran; Khoa Dang,39,0,80,41
1657848872735,CSE 21,A01,095574,Bach; Quang Tran,22,0,48,26
1657848878758,CSE 30,A01,083084,Eldon; John,6,0,80,74
1657848878758,CSE 30,B01,095061,Bhaskar; Nishant,9,0,50,41
1657848884784,CSE 100,A01,083659,Cao; Yingjun,5,4,70,65
1657848890809,CSE 134B,A01,083661,Powell; Thomas Allan,24,0,100,76
1657848896845,CSE 140,A01,083663,Gungor; Onat,15,0,85,70
1657848902870,CSE 140L,A01,083088,Eldon; John,23,0,100,77
1657848908897,CSE 175,A01,083665,Kumar; Rakesh,3,0,25,22
1657848914923,CSE 190,A00,092507,Dubnov; Shlomo,8,0,20,12
1657848920950,ECE 45,A01,083139,Congero; Spencer William,6,0,75,69
1657848926994,ECE 65,A50,083695,Saad; Andrew S,12,0,30,18
1657848926994,ECE 65,A51,095125,Saad; Andrew S,24,0,26,2
1657848933024,ECE 109,A01,091882,Touri; Behrouz,20,0,70,50
1657848939047,ECE 180,A00,083140,Abi Samra; Nicholas Camill,1,0,30,29
1657848939047,ECE 180,B00,083141,Abi Samra; Nicholas Camill,0,0,30,30
1657848945071,MATH 10A,A01,083735,Patchell; Gregory David,2,0,30,28
1657848945071,MATH 10A,A02,083736,Patchell; Gregory David,20,0,30,10
1657848945071,MATH 10A,A03,083737,Patchell; Gregory David,16,0,30,14
1657848951099,MATH 10B,A01,083207,Lim; Seonhee,8,0,34,26
1657848951099,MATH 10B,A02,083208,Lim; Seonhee,10,0,35,25
1657848951099,MATH 10B,A03,093472,Lim; Seonhee,7,0,34,27
1657848951099,MATH 10B,B01,083739,Sinha; Shubham,14,0,30,16
1657848957132,MATH 18,A01,083743,Cinel; Cameron Alexander,9,0,30,21
1657848957132,MATH 18,A02,083744,Cinel; Cameron Alexander,18,0,30,12
1657848957132,MATH 18,A03,083745,Cinel; Cameron Alexander,10,0,30,20
1657848957132,MATH 18,B01,083748,Rideout; David Porter,5,0,37,32
1657848957132,MATH 18,B02,083749,Rideout; David Porter,5,0,36,31
1657848957132,MATH 18,B03,083750,Rideout; David Porter,3,0,37,34
1657848957132,MATH 18,B04,083751,Rideout; David Porter,6,0,36,30
1657848957132,MATH 18,B05,093473,Rideout; David Porter,6,0,36,30
1657848957132,MATH 18,B06,093474,Rideout; David Porter,6,0,36,30
1657848963154,MATH 20A,A01,083754,Zheng; Zequn,14,0,40,26
1657848969187,MATH 20B,A01,083756,Briones; Jor-el Thomas Caparas,4,0,36,32
1657848969187,MATH 20B,A02,083757,Briones; Jor-el Thomas Caparas,1,0,36,35
1657848969187,MATH 20B,A03,093475,Briones; Jor-el Thomas Caparas,2,0,36,34
1657848975212,MATH 20C,A01,083760,Briones; Jor-el Thomas Caparas,1,0,35,34
1657848975212,MATH 20C,A02,083761,Briones; Jor-el Thomas Caparas,8,0,35,27
1657848975212,MATH 20C,A03,093476,Briones; Jor-el Thomas Caparas,0,1,36,36
1657848975212,MATH 20C,B01,083762,Bach; Quang Tran,1,0,30,29
1657848981238,MATH 20D,A01,083765,Tran; Brian Kha,5,0,30,25
1657848981238,MATH 20D,A02,083766,Tran; Brian Kha,5,0,30,25
1657848981238,MATH 20D,A03,083767,Tran; Brian Kha,5,0,30,25
1657848987260,MATH 20E,A01,083771,Ganguly; Soumya,10,0,32,22
1657848987260,MATH 20E,A02,083772,Ganguly; Soumya,6,0,32,26
1657848987260,MATH 20E,B01,083773,Ciotti; Benjamin,20,0,35,15
1657848987260,MATH 20E,B02,083774,Ciotti; Benjamin,18,0,35,17
1657848993289,MATH 103A,A01,083777,Greenfeld; Be'Eri,3,0,36,33
1657848993289,MATH 103A,A02,083778,Greenfeld; Be'Eri,5,0,36,31
1657848993289,MATH 103A,A03,093561,Greenfeld; Be'Eri,6,0,36,30
1657848993289,MATH 103A,B01,083779,Greenfeld; Be'Eri,7,0,36,29
1657848993289,MATH 103A,B02,083780,Greenfeld; Be'Eri,4,0,36,32
1657848993289,MATH 103A,B03,093562,Greenfeld; Be'Eri,3,0,36,33
1657848999314,MATH 105,A01,085443,Carter; Anne Toulson,15,0,35,20
1657848999314,MATH 105,A02,093477,Carter; Anne Toulson,20,0,35,15
1657849005338,MATH 109,A01,083213,Ganzberger; Geoffrey Michael,3,0,34,31
1657849005338,MATH 109,A02,083214,Ganzberger; Geoffrey Michael,4,0,34,30
1657849005338,MATH 109,A03,093478,Ganzberger; Geoffrey Michael,2,0,34,32
1657849005338,MATH 109,B01,083215,Ganzberger; Geoffrey Michael,1,0,32,31
1657849005338,MATH 109,B02,083216,Ganzberger; Geoffrey Michael,2,0,32,30
1657849005338,MATH 109,B03,093479,Ganzberger; Geoffrey Michael,8,0,32,24
1657849011367,MATH 142A,A01,083219,Chow; Bennett,7,0,32,25
1657849011367,MATH 142A,A02,083220,Chow; Bennett,10,0,32,22
1657849011367,MATH 142A,A03,093480,Chow; Bennett,9,0,32,23
1657849011367,MATH 142A,B03,093481,Chow; Bennett,8,0,32,24
1657849011367,MATH 142A,B04,093558,Chow; Bennett,13,0,32,19
1657849011367,MATH 142A,B05,093559,Chow; Bennett,7,0,32,25
1657849017395,MATH 193A,A01,083224,Rotar; Vladimir,8,0,34,26
1657849017395,MATH 193A,A02,083225,Rotar; Vladimir,10,0,34,24
1657849017395,MATH 193A,A03,083781,Rotar; Vladimir,5,0,34,29
1657849017395,MATH 193A,A04,083782,Rotar; Vladimir,11,0,34,23
1657849017395,MATH 193A,A05,093482,Rotar; Vladimir,10,0,34,24
1657849023421,MATH 197,001,091859,McAuley; Julian John,9999,0,9999,0
1657849023421,MATH 197,002,095566,Kedlaya; Kiran S.,9997,0,9999,2
1657849023421,MATH 197,003,095567,Xiao; Ming,9999,0,9999,0
1657849023421,MATH 197,004,095571,Perols; Johan Lars,9998,0,9999,1
1657849030488,COGS 9,A01,083615,Shannon; Kyle Michael,10,0,75,65
1657849036511,COGS 11,A01,083617,Boyle; Mary E. T.,23,0,48,25
1657849042534,COGS 13,A01,083071,Bastos; Amalia Pinkusfeld,11,0,71,60
1657849048556,COGS 14A,A01,092681,Semenuks; Arturs,5,1,100,95
1657849054582,COGS 14B,A01,083073,Cheng; Tzu-Han,6,0,63,57
1657849060609,COGS 17,A01,092677,Semenuks; Arturs,6,0,81,75
1657849066632,COGS 100,A01,083619,Allen; Michael Gordon,17,0,70,53
1657849072653,COGS 101A,A01,083621,Davis; Joshua Daniel,9,0,68,59
1657849078677,COGS 101B,A01,091572,Allen; Michael Gordon,12,0,65,53
1657849084701,COGS 101C,A01,083625,Delgado; Tania,17,0,35,18
1657849090724,COGS 107A,A01,083627,Boyle; Mary E. T.,14,0,60,46
1657849096745,COGS 118A,A01,083075,Gupta; Anjum,21,0,76,55
1657849102771,CSE 3,A50,083646,Miranda; Gregory Joseph,24,0,50,26
1657849108794,CSE 8A,A50,083650,Miranda; Gregory Joseph,17,1,56,39
1657849114817,CSE 11,A01,083080,Cao; Yingjun,6,15,40,34
1657849120847,CSE 12,A01,083652,Krause-Levy; Sophia Louisa,29,1,120,91
1657849126882,CSE 15L,A01,083654,Morris; Justin Loren,9,0,50,41
1657849126882,CSE 15L,A02,083655,Morris; Justin Loren,9,0,50,41
1657849132903,CSE 20,A01,083657,Tran; Khoa Dang,39,0,80,41
1657849138945,CSE 21,A01,095574,Bach; Quang Tran,22,0,48,26
1657849144968,CSE 30,A01,083084,Eldon; John,6,0,80,74
1657849144968,CSE 30,B01,095061,Bhaskar; Nishant,9,0,50,41
1657849150990,CSE 100,A01,083659,Cao; Yingjun,5,4,70,65
1657849157030,CSE 134B,A01,083661,Powell; Thomas Allan,24,0,100,76
1657849163054,CSE 140,A01,083663,Gungor; Onat,15,0,85,70
1657849169077,CSE 140L,A01,083088,Eldon; John,23,0,100,77
1657849175101,CSE 175,A01,083665,Kumar; Rakesh,3,0,25,22
1657849181137,CSE 190,A00,092507,Dubnov; Shlomo,8,0,20,12
1657849187159,ECE 45,A01,083139,Congero; Spencer William,6,0,75,69
1657849193186,ECE 65,A50,083695,Saad; Andrew S,12,0,30,18
1657849193186,ECE 65,A51,095125,Saad; Andrew S,24,0,26,2
1657849199213,ECE 109,A01,091882,Touri; Behrouz,20,0,70,50
1657849205235,ECE 180,A00,083140,Abi Samra; Nicholas Camill,1,0,30,29
1657849205235,ECE 180,B00,083141,Abi Samra; Nicholas Camill,0,0,30,30
1657849211261,MATH 10A,A01,083735,Patchell; Gregory David,2,0,30,28
1657849211261,MATH 10A,A02,083736,Patchell; Gregory David,20,0,30,10
1657849211261,MATH 10A,A03,083737,Patchell; Gregory David,16,0,30,14
1657849217390,MATH 10B,A01,083207,Lim; Seonhee,8,0,34,26
1657849217390,MATH 10B,A02,083208,Lim; Seonhee,10,0,35,25
1657849217390,MATH 10B,A03,093472,Lim; Seonhee,7,0,34,27
1657849217390,MATH 10B,B01,083739,Sinha; Shubham,14,0,30,16
1657849223415,MATH 18,A01,083743,Cinel; Cameron Alexander,9,0,30,21
1657849223415,MATH 18,A02,083744,Cinel; Cameron Alexander,18,0,30,12
1657849223415,MATH 18,A03,083745,Cinel; Cameron Alexander,10,0,30,20
1657849223415,MATH 18,B01,083748,Rideout; David Porter,5,0,37,32
1657849223415,MATH 18,B02,083749,Rideout; David Porter,5,0,36,31
1657849223415,MATH 18,B03,083750,Rideout; David Porter,3,0,37,34
1657849223415,MATH 18,B04,083751,Rideout; David Porter,6,0,36,30
1657849223415,MATH 18,B05,093473,Rideout; David Porter,6,0,36,30
1657849223415,MATH 18,B06,093474,Rideout; David Porter,6,0,36,30
1657849229437,MATH 20A,A01,083754,Zheng; Zequn,14,0,40,26
1657849235465,MATH 20B,A01,083756,Briones; Jor-el Thomas Caparas,4,0,36,32
1657849235465,MATH 20B,A02,083757,Briones; Jor-el Thomas Caparas,1,0,36,35
1657849235465,MATH 20B,A03,093475,Briones; Jor-el Thomas Caparas,2,0,36,34
1657849241488,MATH 20C,A01,083760,Briones; Jor-el Thomas Caparas,1,0,35,34
1657849241488,MATH 20C,A02,083761,Briones; Jor-el Thomas Caparas,8,0,35,27
1657849241488,MATH 20C,A03,093476,Briones; Jor-el Thomas Caparas,0,1,36,36
1657849241488,MATH 20C,B01,083762,Bach; Quang Tran,1,0,30,29
1657849247513,MATH 20D,A01,083765,Tran; Brian Kha,5,0,30,25
1657849247513,MATH 20D,A02,083766,Tran; Brian Kha,5,0,30,25
1657849247513,MATH 20D,A03,083767,Tran; Brian Kha,5,0,30,25
1657849253541,MATH 20E,A01,083771,Ganguly; Soumya,10,0,32,22
1657849253541,MATH 20E,A02,083772,Ganguly; Soumya,6,0,32,26
1657849253541,MATH 20E,B01,083773,Ciotti; Benjamin,20,0,35,15
1657849253541,MATH 20E,B02,083774,Ciotti; Benjamin,18,0,35,17
1657849259571,MATH 103A,A01,083777,Greenfeld; Be'Eri,3,0,36,33
1657849259571,MATH 103A,A02,083778,Greenfeld; Be'Eri,5,0,36,31
1657849259571,MATH 103A,A03,093561,Greenfeld; Be'Eri,6,0,36,30
1657849259571,MATH 103A,B01,083779,Greenfeld; Be'Eri,7,0,36,29
1657849259571,MATH 103A,B02,083780,Greenfeld; Be'Eri,4,0,36,32
1657849259571,MATH 103A,B03,093562,Greenfeld; Be'Eri,3,0,36,33
1657849265599,MATH 105,A01,085443,Carter; Anne Toulson,15,0,35,20
1657849265599,MATH 105,A02,093477,Carter; Anne Toulson,20,0,35,15
1657849271622,MATH 109,A01,083213,Ganzberger; Geoffrey Michael,3,0,34,31
1657849271622,MATH 109,A02,083214,Ganzberger; Geoffrey Michael,4,0,34,30
1657849271622,MATH 109,A03,093478,Ganzberger; Geoffrey Michael,2,0,34,32
1657849271622,MATH 109,B01,083215,Ganzberger; Geoffrey Michael,1,0,32,31
1657849271622,MATH 109,B02,083216,Ganzberger; Geoffrey Michael,2,0,32,30
1657849271622,MATH 109,B03,093479,Ganzberger; Geoffrey Michael,8,0,32,24
1657849277651,MATH 142A,A01,083219,Chow; Bennett,7,0,32,25
1657849277651,MATH 142A,A02,083220,Chow; Bennett,10,0,32,22
1657849277651,MATH 142A,A03,093480,Chow; Bennett,9,0,32,23
1657849277651,MATH 142A,B03,093481,Chow; Bennett,8,0,32,24
1657849277651,MATH 142A,B04,093558,Chow; Bennett,13,0,32,19
1657849277651,MATH 142A,B05,093559,Chow; Bennett,7,0,32,25
1657849283676,MATH 193A,A01,083224,Rotar; Vladimir,8,0,34,26
1657849283676,MATH 193A,A02,083225,Rotar; Vladimir,10,0,34,24
1657849283676,MATH 193A,A03,083781,Rotar; Vladimir,5,0,34,29
1657849283676,MATH 193A,A04,083782,Rotar; Vladimir,11,0,34,23
1657849283676,MATH 193A,A05,093482,Rotar; Vladimir,10,0,34,24
1657849289699,MATH 197,001,091859,McAuley; Julian John,9999,0,9999,0
1657849289699,MATH 197,002,095566,Kedlaya; Kiran S.,9997,0,9999,2
1657849289699,MATH 197,003,095567,Xiao; Ming,9999,0,9999,0
1657849289699,MATH 197,004,095571,Perols; Johan Lars,9998,0,9999,1
1657849296797,COGS 9,A01,083615,Shannon; Kyle Michael,10,0,75,65
1657849302821,COGS 11,A01,083617,Boyle; Mary E. T.,23,0,48,25
1657849308852,COGS 13,A01,083071,Bastos; Amalia Pinkusfeld,11,0,71,60
1657849314876,COGS 14A,A01,092681,Semenuks; Arturs,5,1,100,95
1657849320903,COGS 14B,A01,083073,Cheng; Tzu-Han,6,0,63,57
1657849326927,COGS 17,A01,092677,Semenuks; Arturs,6,0,81,75
1657849332953,COGS 100,A01,083619,Allen; Michael Gordon,17,0,70,53
1657849338975,COGS 101A,A01,083621,Davis; Joshua Daniel,9,0,68,59
1657849344998,COGS 101B,A01,091572,Allen; Michael Gordon,12,0,65,53
1657849351029,COGS 101C,A01,083625,Delgado; Tania,17,0,35,18
1657849357057,COGS 107A,A01,083627,Boyle; Mary E. T.,14,0,60,46
1657849363080,COGS 118A,A01,083075,Gupta; Anjum,21,0,76,55
1657849369114,CSE 3,A50,083646,Miranda; Gregory Joseph,24,0,50,26
1657849375142,CSE 8A,A50,083650,Miranda; Gregory Joseph,17,1,56,39
1657849381165,CSE 11,A01,083080,Cao; Yingjun,6,15,40,34
1657849387191,CSE 12,A01,083652,Krause-Levy; Sophia Louisa,29,1,120,91
1657849393213,CSE 15L,A01,083654,Morris; Justin Loren,9,0,50,41
1657849393213,CSE 15L,A02,083655,Morris; Justin Loren,9,0,50,41
1657849399236,CSE 20,A01,083657,Tran; Khoa Dang,39,0,80,41
1657849405265,CSE 21,A01,095574,Bach; Quang Tran,22,0,48,26
1657849411287,CSE 30,A01,083084,Eldon; John,6,0,80,74
1657849411287,CSE 30,B01,095061,Bhaskar; Nishant,9,0,50,41
1657849417318,CSE 100,A01,083659,Cao; Yingjun,5,4,70,65
1657849423345,CSE 134B,A01,083661,Powell; Thomas Allan,24,0,100,76
1657849429372,CSE 140,A01,083663,Gungor; Onat,15,0,85,70
1657849435393,CSE 140L,A01,083088,Eldon; John,23,0,100,77
1657849441417,CSE 175,A01,083665,Kumar; Rakesh,3,0,25,22
1657849447440,CSE 190,A00,092507,Dubnov; Shlomo,8,0,20,12
1657849453463,ECE 45,A01,083139,Congero; Spencer William,6,0,75,69
1657849459491,ECE 65,A50,083695,Saad; Andrew S,12,0,30,18
1657849459491,ECE 65,A51,095125,Saad; Andrew S,24,0,26,2
1657849465518,ECE 109,A01,091882,Touri; Behrouz,20,0,70,50
1657849471557,ECE 180,A00,083140,Abi Samra; Nicholas Camill,1,0,30,29
1657849471557,ECE 180,B00,083141,Abi Samra; Nicholas Camill,0,0,30,30
1657849477582,MATH 10A,A01,083735,Patchell; Gregory David,2,0,30,28
1657849477582,MATH 10A,A02,083736,Patchell; Gregory David,20,0,30,10
1657849477582,MATH 10A,A03,083737,Patchell; Gregory David,16,0,30,14
1657849483607,MATH 10B,A01,083207,Lim; Seonhee,8,0,34,26
1657849483607,MATH 10B,A02,083208,Lim; Seonhee,10,0,35,25
1657849483607,MATH 10B,A03,093472,Lim; Seonhee,7,0,34,27
1657849483607,MATH 10B,B01,083739,Sinha; Shubham,14,0,30,16
1657849489650,MATH 18,A01,083743,Cinel; Cameron Alexander,9,0,30,21
1657849489650,MATH 18,A02,083744,Cinel; Cameron Alexander,18,0,30,12
1657849489650,MATH 18,A03,083745,Cinel; Cameron Alexander,10,0,30,20
1657849489650,MATH 18,B01,083748,Rideout; David Porter,5,0,37,32
1657849489650,MATH 18,B02,083749,Rideout; David Porter,5,0,36,31
1657849489650,MATH 18,B03,083750,Rideout; David Porter,3,0,37,34
1657849489650,MATH 18,B04,083751,Rideout; David Porter,6,0,36,30
1657849489650,MATH 18,B05,093473,Rideout; David Porter,6,0,36,30
1657849489650,MATH 18,B06,093474,Rideout; David Porter,6,0,36,30
1657849495671,MATH 20A,A01,083754,Zheng; Zequn,14,0,40,26
1657849501695,MATH 20B,A01,083756,Briones; Jor-el Thomas Caparas,4,0,36,32
1657849501695,MATH 20B,A02,083757,Briones; Jor-el Thomas Caparas,1,0,36,35
1657849501695,MATH 20B,A03,093475,Briones; Jor-el Thomas Caparas,2,0,36,34
1657849507725,MATH 20C,A01,083760,Briones; Jor-el Thomas Caparas,1,0,35,34
1657849507725,MATH 20C,A02,083761,Briones; Jor-el Thomas Caparas,8,0,35,27
1657849507725,MATH 20C,A03,093476,Briones; Jor-el Thomas Caparas,0,1,36,36
1657849507725,MATH 20C,B01,083762,Bach; Quang Tran,1,0,30,29
1657849513760,MATH 20D,A01,083765,Tran; Brian Kha,5,0,30,25
1657849513760,MATH 20D,A02,083766,Tran; Brian Kha,5,0,30,25
1657849513760,MATH 20D,A03,083767,Tran; Brian Kha,5,0,30,25
1657849519792,MATH 20E,A01,083771,Ganguly; Soumya,10,0,32,22
1657849519792,MATH 20E,A02,083772,Ganguly; Soumya,6,0,32,26
1657849519792,MATH 20E,B01,083773,Ciotti; Benjamin,20,0,35,15
1657849519792,MATH 20E,B02,083774,Ciotti; Benjamin,18,0,35,17
1657849525827,MATH 103A,A01,083777,Greenfeld; Be'Eri,3,0,36,33
1657849525827,MATH 103A,A02,083778,Greenfeld; Be'Eri,5,0,36,31
1657849525827,MATH 103A,A03,093561,Greenfeld; Be'Eri,6,0,36,30
1657849525827,MATH 103A,B01,083779,Greenfeld; Be'Eri,7,0,36,29
1657849525827,MATH 103A,B02,083780,Greenfeld; Be'Eri,4,0,36,32
1657849525827,MATH 103A,B03,093562,Greenfeld; Be'Eri,3,0,36,33
1657849531854,MATH 105,A01,085443,Carter; Anne Toulson,15,0,35,20
1657849531854,MATH 105,A02,093477,Carter; Anne Toulson,20,0,35,15
1657849537881,MATH 109,A01,083213,Ganzberger; Geoffrey Michael,3,0,34,31
1657849537881,MATH 109,A02,083214,Ganzberger; Geoffrey Michael,4,0,34,30
1657849537881,MATH 109,A03,093478,Ganzberger; Geoffrey Michael,2,0,34,32
1657849537881,MATH 109,B01,083215,Ganzberger; Geoffrey Michael,1,0,32,31
1657849537881,MATH 109,B02,083216,Ganzberger; Geoffrey Michael,2,0,32,30
1657849537881,MATH 109,B03,093479,Ganzberger; Geoffrey Michael,8,0,32,24
1657849543910,MATH 142A,A01,083219,Chow; Bennett,7,0,32,25
1657849543910,MATH 142A,A02,083220,Chow; Bennett,10,0,32,22
1657849543910,MATH 142A,A03,093480,Chow; Bennett,9,0,32,23
1657849543910,MATH 142A,B03,093481,Chow; Bennett,8,0,32,24
1657849543910,MATH 142A,B04,093558,Chow; Bennett,13,0,32,19
1657849543910,MATH 142A,B05,093559,Chow; Bennett,7,0,32,25
1657849549948,MATH 193A,A01,083224,Rotar; Vladimir,8,0,34,26
1657849549948,MATH 193A,A02,083225,Rotar; Vladimir,10,0,34,24
1657849549948,MATH 193A,A03,083781,Rotar; Vladimir,5,0,34,29
1657849549948,MATH 193A,A04,083782,Rotar; Vladimir,11,0,34,23
1657849549948,MATH 193A,A05,093482,Rotar; Vladimir,10,0,34,24
1657849555983,MATH 197,001,091859,McAuley; Julian John,9999,0,9999,0
1657849555983,MATH 197,002,095566,Kedlaya; Kiran S.,9997,0,9999,2
1657849555983,MATH 197,003,095567,Xiao; Ming,9999,0,9999,0
1657849555983,MATH 197,004,095571,Perols; Johan Lars,9998,0,9999,1
1657849563065,COGS 9,A01,083615,Shannon; Kyle Michael,10,0,75,65
1657849569087,COGS 11,A01,083617,Boyle; Mary E. T.,23,0,48,25
1657849575110,COGS 13,A01,083071,Bastos; Amalia Pinkusfeld,11,0,71,60
1657849581143,COGS 14A,A01,092681,Semenuks; Arturs,5,1,100,95
1657849587167,COGS 14B,A01,083073,Cheng; Tzu-Han,6,0,63,57
1657849593192,COGS 17,A01,092677,Semenuks; Arturs,6,0,81,75
1657849599216,COGS 100,A01,083619,Allen; Michael Gordon,17,0,70,53
1657849605239,COGS 101A,A01,083621,Davis; Joshua Daniel,9,0,68,59
1657849611274,COGS 101B,A01,091572,Allen; Michael Gordon,12,0,65,53
1657849617297,COGS 101C,A01,083625,Delgado; Tania,17,0,35,18
1657849623322,COGS 107A,A01,083627,Boyle; Mary E. T.,14,0,60,46
1657849629348,COGS 118A,A01,083075,Gupta; Anjum,21,0,76,55
1657849635376,CSE 3,A50,083646,Miranda; Gregory Joseph,24,0,50,26
1657849641403,CSE 8A,A50,083650,Miranda; Gregory Joseph,17,1,56,39
1657849647430,CSE 11,A01,083080,Cao; Yingjun,6,15,40,34
1657849653452,CSE 12,A01,083652,Krause-Levy; Sophia Louisa,29,1,120,91
1657849659475,CSE 15L,A01,083654,Morris; Justin Loren,9,0,50,41
1657849659475,CSE 15L,A02,083655,Morris; Justin Loren,9,0,50,41
1657849665497,CSE 20,A01,083657,Tran; Khoa Dang,39,0,80,41
1657849671521,CSE 21,A01,095574,Bach; Quang Tran,22,0,48,26
1657849677549,CSE 30,A01,083084,Eldon; John,6,0,80,74
1657849677549,CSE 30,B01,095061,Bhaskar; Nishant,9,0,50,41
1657849683576,CSE 100,A01,083659,Cao; Yingjun,5,4,70,65
1657849689608,CSE 134B,A01,083661,Powell; Thomas Allan,24,0,100,76
1657849695634,CSE 140,A01,083663,Gungor; Onat,15,0,85,70
1657849701660,CSE 140L,A01,083088,Eldon; John,23,0,100,77
1657849707685,CSE 175,A01,083665,Kumar; Rakesh,3,0,25,22
1657849713711,CSE 190,A00,092507,Dubnov; Shlomo,8,0,20,12
1657849719733,ECE 45,A01,083139,Congero; Spencer William,6,0,75,69
1657849725761,ECE 65,A50,083695,Saad; Andrew S,12,0,30,18
1657849725761,ECE 65,A51,095125,Saad; Andrew S,24,0,26,2
1657849731789,ECE 109,A01,091882,Touri; Behrouz,20,0,70,50
1657849737816,ECE 180,A00,083140,Abi Samra; Nicholas Camill,1,0,30,29
1657849737816,ECE 180,B00,083141,Abi Samra; Nicholas Camill,0,0,30,30
1657849743847,MATH 10A,A01,083735,Patchell; Gregory David,2,0,30,28
1657849743847,MATH 10A,A02,083736,Patchell; Gregory David,20,0,30,10
1657849743847,MATH 10A,A03,083737,Patchell; Gregory David,16,0,30,14
1657849749872,MATH 10B,A01,083207,Lim; Seonhee,8,0,34,26
1657849749872,MATH 10B,A02,083208,Lim; Seonhee,10,0,35,25
1657849749872,MATH 10B,A03,093472,Lim; Seonhee,7,0,34,27
1657849749872,MATH 10B,B01,083739,Sinha; Shubham,14,0,30,16
1657849755897,MATH 18,A01,083743,Cinel; Cameron Alexander,9,0,30,21
1657849755897,MATH 18,A02,083744,Cinel; Cameron Alexander,18,0,30,12
1657849755897,MATH 18,A03,083745,Cinel; Cameron Alexander,10,0,30,20
1657849755897,MATH 18,B01,083748,Rideout; David Porter,5,0,37,32
1657849755897,MATH 18,B02,083749,Rideout; David Porter,5,0,36,31
1657849755897,MATH 18,B03,083750,Rideout; David Porter,3,0,37,34
1657849755897,MATH 18,B04,083751,Rideout; David Porter,6,0,36,30
1657849755897,MATH 18,B05,093473,Rideout; David Porter,6,0,36,30
1657849755897,MATH 18,B06,093474,Rideout; David Porter,6,0,36,30
1657849761921,MATH 20A,A01,083754,Zheng; Zequn,14,0,40,26
1657849767946,MATH 20B,A01,083756,Briones; Jor-el Thomas Caparas,4,0,36,32
1657849767946,MATH 20B,A02,083757,Briones; Jor-el Thomas Caparas,1,0,36,35
1657849767946,MATH 20B,A03,093475,Briones; Jor-el Thomas Caparas,2,0,36,34
1657849773977,MATH 20C,A01,083760,Briones; Jor-el Thomas Caparas,1,0,35,34
1657849773977,MATH 20C,A02,083761,Briones; Jor-el Thomas Caparas,8,0,35,27
1657849773977,MATH 20C,A03,093476,Briones; Jor-el Thomas Caparas,0,1,36,36
1657849773977,MATH 20C,B01,083762,Bach; Quang Tran,1,0,30,29
1657849780020,MATH 20D,A01,083765,Tran; Brian Kha,5,0,30,25
1657849780020,MATH 20D,A02,083766,Tran; Brian Kha,5,0,30,25
1657849780020,MATH 20D,A03,083767,Tran; Brian Kha,5,0,30,25
1657849786045,MATH 20E,A01,083771,Ganguly; Soumya,10,0,32,22
1657849786045,MATH 20E,A02,083772,Ganguly; Soumya,6,0,32,26
1657849786045,MATH 20E,B01,083773,Ciotti; Benjamin,20,0,35,15
1657849786045,MATH 20E,B02,083774,Ciotti; Benjamin,18,0,35,17
1657849792067,MATH 103A,A01,083777,Greenfeld; Be'Eri,3,0,36,33
1657849792067,MATH 103A,A02,083778,Greenfeld; Be'Eri,5,0,36,31
1657849792067,MATH 103A,A03,093561,Greenfeld; Be'Eri,6,0,36,30
1657849792067,MATH 103A,B01,083779,Greenfeld; Be'Eri,7,0,36,29
1657849792067,MATH 103A,B02,083780,Greenfeld; Be'Eri,4,0,36,32
1657849792067,MATH 103A,B03,093562,Greenfeld; Be'Eri,3,0,36,33
1657849798102,MATH 105,A01,085443,Carter; Anne Toulson,15,0,35,20
1657849798102,MATH 105,A02,093477,Carter; Anne Toulson,20,0,35,15
1657849804131,MATH 109,A01,083213,Ganzberger; Geoffrey Michael,3,0,34,31
1657849804131,MATH 109,A02,083214,Ganzberger; Geoffrey Michael,4,0,34,30
1657849804131,MATH 109,A03,093478,Ganzberger; Geoffrey Michael,2,0,34,32
1657849804131,MATH 109,B01,083215,Ganzberger; Geoffrey Michael,1,0,32,31
1657849804131,MATH 109,B02,083216,Ganzberger; Geoffrey Michael,2,0,32,30
1657849804131,MATH 109,B03,093479,Ganzberger; Geoffrey Michael,8,0,32,24
1657849810163,MATH 142A,A01,083219,Chow; Bennett,7,0,32,25
1657849810163,MATH 142A,A02,083220,Chow; Bennett,10,0,32,22
1657849810163,MATH 142A,A03,093480,Chow; Bennett,9,0,32,23
1657849810163,MATH 142A,B03,093481,Chow; Bennett,8,0,32,24
1657849810163,MATH 142A,B04,093558,Chow; Bennett,13,0,32,19
1657849810163,MATH 142A,B05,093559,Chow; Bennett,7,0,32,25
1657849816285,MATH 193A,A01,083224,Rotar; Vladimir,8,0,34,26
1657849816285,MATH 193A,A02,083225,Rotar; Vladimir,10,0,34,24
1657849816285,MATH 193A,A03,083781,Rotar; Vladimir,5,0,34,29
1657849816285,MATH 193A,A04,083782,Rotar; Vladimir,11,0,34,23
1657849816285,MATH 193A,A05,093482,Rotar; Vladimir,10,0,34,24
1657849822307,MATH 197,001,091859,McAuley; Julian John,9999,0,9999,0
1657849822307,MATH 197,002,095566,Kedlaya; Kiran S.,9997,0,9999,2
1657849822307,MATH 197,003,095567,Xiao; Ming,9999,0,9999,0
1657849822307,MATH 197,004,095571,Perols; Johan Lars,9998,0,9999,1
1657849829375,COGS 9,A01,083615,Shannon; Kyle Michael,10,0,75,65
1657849835401,COGS 11,A01,083617,Boyle; Mary E. T.,23,0,48,25
1657849841423,COGS 13,A01,083071,Bastos; Amalia Pinkusfeld,11,0,71,60
1657849847456,COGS 14A,A01,092681,Semenuks; Arturs,5,1,100,95
1657849853481,COGS 14B,A01,083073,Cheng; Tzu-Han,6,0,63,57
1657849859508,COGS 17,A01,092677,Semenuks; Arturs,6,0,81,75
1657849865531,COGS 100,A01,083619,Allen; Michael Gordon,17,0,70,53
1657849871566,COGS 101A,A01,083621,Davis; Joshua Daniel,9,0,68,59
1657849877593,COGS 101B,A01,091572,Allen; Michael Gordon,12,0,65,53
1657849883615,COGS 101C,A01,083625,Delgado; Tania,17,0,35,18
1657849889638,COGS 107A,A01,083627,Boyle; Mary E. T.,14,0,60,46
1657849895661,COGS 118A,A01,083075,Gupta; Anjum,21,0,76,55
1657849901688,CSE 3,A50,083646,Miranda; Gregory Joseph,24,0,50,26
1657849907725,CSE 8A,A50,083650,Miranda; Gregory Joseph,17,1,56,39
1657849913755,CSE 11,A01,083080,Cao; Yingjun,6,15,40,34
1657849919779,CSE 12,A01,083652,Krause-Levy; Sophia Louisa,29,1,120,91
1657849925816,CSE 15L,A01,083654,Morris; Justin Loren,9,0,50,41
1657849925816,CSE 15L,A02,083655,Morris; Justin Loren,9,0,50,41
1657849931842,CSE 20,A01,083657,Tran; Khoa Dang,39,0,80,41
1657849937875,CSE 21,A01,095574,Bach; Quang Tran,22,0,48,26
1657849943908,CSE 30,A01,083084,Eldon; John,6,0,80,74
1657849943908,CSE 30,B01,095061,Bhaskar; Nishant,9,0,50,41
1657849949932,CSE 100,A01,083659,Cao; Yingjun,5,4,70,65
1657849955955,CSE 134B,A01,083661,Powell; Thomas Allan,24,0,100,76
1657849961979,CSE 140,A01,083663,Gungor; Onat,15,0,85,70
1657849968009,CSE 140L,A01,083088,Eldon; John,23,0,100,77
1657849974031,CSE 175,A01,083665,Kumar; Rakesh,3,0,25,22
1657849980059,CSE 190,A00,092507,Dubnov; Shlomo,8,0,20,12
1657849986084,ECE 45,A01,083139,Congero; Spencer William,6,0,75,69
1657849992107,ECE 65,A50,083695,Saad; Andrew S,12,0,30,18
1657849992107,ECE 65,A51,095125,Saad; Andrew S,24,0,26,2
1657849998140,ECE 109,A01,091882,Touri; Behrouz,20,0,70,50
1657850004162,ECE 180,A00,083140,Abi Samra; Nicholas Camill,1,0,30,29
1657850004162,ECE 180,B00,083141,Abi Samra; Nicholas Camill,0,0,30,30
1657850010188,MATH 10A,A01,083735,Patchell; Gregory David,2,0,30,28
1657850010188,MATH 10A,A02,083736,Patchell; Gregory David,20,0,30,10
1657850010188,MATH 10A,A03,083737,Patchell; Gregory David,16,0,30,14
1657850016211,MATH 10B,A01,083207,Lim; Seonhee,8,0,34,26
1657850016211,MATH 10B,A02,083208,Lim; Seonhee,10,0,35,25
1657850016211,MATH 10B,A03,093472,Lim; Seonhee,7,0,34,27
1657850016211,MATH 10B,B01,083739,Sinha; Shubham,14,0,30,16
1657850022234,MATH 18,A01,083743,Cinel; Cameron Alexander,9,0,30,21
1657850022234,MATH 18,A02,083744,Cinel; Cameron Alexander,18,0,30,12
1657850022234,MATH 18,A03,083745,Cinel; Cameron Alexander,10,0,30,20
1657850022234,MATH 18,B01,083748,Rideout; David Porter,5,0,37,32
1657850022234,MATH 18,B02,083749,Rideout; David Porter,5,0,36,31
1657850022234,MATH 18,B03,083750,Rideout; David Porter,3,0,37,34
1657850022234,MATH 18,B04,083751,Rideout; David Porter,6,0,36,30
1657850022234,MATH 18,B05,093473,Rideout; David Porter,6,0,36,30
1657850022234,MATH 18,B06,093474,Rideout; David Porter,6,0,36,30
1657850028256,MATH 20A,A01,083754,Zheng; Zequn,14,0,40,26
1657850034283,MATH 20B,A01,083756,Briones; Jor-el Thomas Caparas,4,0,36,32
1657850034283,MATH 20B,A02,083757,Briones; Jor-el Thomas Caparas,1,0,36,35
1657850034283,MATH 20B,A03,093475,Briones; Jor-el Thomas Caparas,2,0,36,34
1657850040306,MATH 20C,A01,083760,Briones; Jor-el Thomas Caparas,1,0,35,34
1657850040306,MATH 20C,A02,083761,Briones; Jor-el Thomas Caparas,8,0,35,27
1657850040306,MATH 20C,A03,093476,Briones; Jor-el Thomas Caparas,0,1,36,36
1657850040306,MATH 20C,B01,083762,Bach; Quang Tran,1,0,30,29
1657850046334,MATH 20D,A01,083765,Tran; Brian Kha,5,0,30,25
1657850046334,MATH 20D,A02,083766,Tran; Brian Kha,5,0,30,25
1657850046334,MATH 20D,A03,083767,Tran; Brian Kha,5,0,30,25
1657850052361,MATH 20E,A01,083771,Ganguly; Soumya,10,0,32,22
1657850052361,MATH 20E,A02,083772,Ganguly; Soumya,6,0,32,26
1657850052361,MATH 20E,B01,083773,Ciotti; Benjamin,20,0,35,15
1657850052361,MATH 20E,B02,083774,Ciotti; Benjamin,18,0,35,17
1657850058388,MATH 103A,A01,083777,Greenfeld; Be'Eri,3,0,36,33
1657850058388,MATH 103A,A02,083778,Greenfeld; Be'Eri,5,0,36,31
1657850058388,MATH 103A,A03,093561,Greenfeld; Be'Eri,6,0,36,30
1657850058388,MATH 103A,B01,083779,Greenfeld; Be'Eri,7,0,36,29
1657850058388,MATH 103A,B02,083780,Greenfeld; Be'Eri,4,0,36,32
1657850058388,MATH 103A,B03,093562,Greenfeld; Be'Eri,3,0,36,33
1657850064412,MATH 105,A01,085443,Carter; Anne Toulson,15,0,35,20
1657850064412,MATH 105,A02,093477,Carter; Anne Toulson,20,0,35,15
1657850070436,MATH 109,A01,083213,Ganzberger; Geoffrey Michael,3,0,34,31
1657850070436,MATH 109,A02,083214,Ganzberger; Geoffrey Michael,4,0,34,30
1657850070436,MATH 109,A03,093478,Ganzberger; Geoffrey Michael,2,0,34,32
1657850070436,MATH 109,B01,083215,Ganzberger; Geoffrey Michael,1,0,32,31
1657850070436,MATH 109,B02,083216,Ganzberger; Geoffrey Michael,2,0,32,30
1657850070436,MATH 109,B03,093479,Ganzberger; Geoffrey Michael,8,0,32,24
1657850076465,MATH 142A,A01,083219,Chow; Bennett,7,0,32,25
1657850076465,MATH 142A,A02,083220,Chow; Bennett,10,0,32,22
1657850076465,MATH 142A,A03,093480,Chow; Bennett,9,0,32,23
1657850076465,MATH 142A,B03,093481,Chow; Bennett,8,0,32,24
1657850076465,MATH 142A,B04,093558,Chow; Bennett,13,0,32,19
1657850076465,MATH 142A,B05,093559,Chow; Bennett,7,0,32,25
1657850082497,MATH 193A,A01,083224,Rotar; Vladimir,8,0,34,26
1657850082497,MATH 193A,A02,083225,Rotar; Vladimir,10,0,34,24
1657850082497,MATH 193A,A03,083781,Rotar; Vladimir,5,0,34,29
1657850082497,MATH 193A,A04,083782,Rotar; Vladimir,11,0,34,23
1657850082497,MATH 193A,A05,093482,Rotar; Vladimir,10,0,34,24
1657850088527,MATH 197,001,091859,McAuley; Julian John,9999,0,9999,0
1657850088527,MATH 197,002,095566,Kedlaya; Kiran S.,9997,0,9999,2
1657850088527,MATH 197,003,095567,Xiao; Ming,9999,0,9999,0
1657850088527,MATH 197,004,095571,Perols; Johan Lars,9998,0,9999,1
1657850095590,COGS 9,A01,083615,Shannon; Kyle Michael,10,0,75,65
1657850101613,COGS 11,A01,083617,Boyle; Mary E. T.,23,0,48,25
1657850107636,COGS 13,A01,083071,Bastos; Amalia Pinkusfeld,11,0,71,60
1657850113662,COGS 14A,A01,092681,Semenuks; Arturs,5,1,100,95
1657850119684,COGS 14B,A01,083073,Cheng; Tzu-Han,6,0,63,57
1657850125707,COGS 17,A01,092677,Semenuks; Arturs,6,0,81,75
1657850131746,COGS 100,A01,083619,Allen; Michael Gordon,17,0,70,53
1657850137768,COGS 101A,A01,083621,Davis; Joshua Daniel,9,0,68,59
1657850143795,COGS 101B,A01,091572,Allen; Michael Gordon,12,0,65,53
1657850149827,COGS 101C,A01,083625,Delgado; Tania,17,0,35,18
1657850155854,COGS 107A,A01,083627,Boyle; Mary E. T.,14,0,60,46
1657850161875,COGS 118A,A01,083075,Gupta; Anjum,21,0,76,55
1657850167905,CSE 3,A50,083646,Miranda; Gregory Joseph,24,0,50,26
1657850173936,CSE 8A,A50,083650,Miranda; Gregory Joseph,17,1,56,39
1657850179959,CSE 11,A01,083080,Cao; Yingjun,6,15,40,34
1657850185990,CSE 12,A01,083652,Krause-Levy; Sophia Louisa,29,1,120,91
1657850192013,CSE 15L,A01,083654,Morris; Justin Loren,9,0,50,41
1657850192013,CSE 15L,A02,083655,Morris; Justin Loren,9,0,50,41
1657850198035,CSE 20,A01,083657,Tran; Khoa Dang,39,0,80,41
1657850204061,CSE 21,A01,095574,Bach; Quang Tran,22,0,48,26
1657850210087,CSE 30,A01,083084,Eldon; John,6,0,80,74
1657850210087,CSE 30,B01,095061,Bhaskar; Nishant,9,0,50,41
1657850216110,CSE 100,A01,083659,Cao; Yingjun,5,4,70,65
1657850222139,CSE 134B,A01,083661,Powell; Thomas Allan,24,0,100,76
1657850228177,CSE 140,A01,083663,Gungor; Onat,15,0,85,70
1657850234199,CSE 140L,A01,083088,Eldon; John,23,0,100,77
1657850240224,CSE 175,A01,083665,Kumar; Rakesh,3,0,25,22
1657850246250,CSE 190,A00,092507,Dubnov; Shlomo,8,0,20,12
1657850252281,ECE 45,A01,083139,Congero; Spencer William,6,0,75,69
1657850258303,ECE 65,A50,083695,Saad; Andrew S,12,0,30,18
1657850258303,ECE 65,A51,095125,Saad; Andrew S,24,0,26,2
1657850264336,ECE 109,A01,091882,Touri; Behrouz,20,0,70,50
1657850270360,ECE 180,A00,083140,Abi Samra; Nicholas Camill,1,0,30,29
1657850270360,ECE 180,B00,083141,Abi Samra; Nicholas Camill,0,0,30,30
1657850276383,MATH 10A,A01,083735,Patchell; Gregory David,2,0,30,28
1657850276383,MATH 10A,A02,083736,Patchell; Gregory David,20,0,30,10
1657850276383,MATH 10A,A03,083737,Patchell; Gregory David,16,0,30,14
1657850282411,MATH 10B,A01,083207,Lim; Seonhee,8,0,34,26
1657850282411,MATH 10B,A02,083208,Lim; Seonhee,10,0,35,25
1657850282411,MATH 10B,A03,093472,Lim; Seonhee,7,0,34,27
1657850282411,MATH 10B,B01,083739,Sinha; Shubham,14,0,30,16
1657850288441,MATH 18,A01,083743,Cinel; Cameron Alexander,9,0,30,21
1657850288441,MATH 18,A02,083744,Cinel; Cameron Alexander,18,0,30,12
1657850288441,MATH 18,A03,083745,Cinel; Cameron Alexander,10,0,30,20
1657850288441,MATH 18,B01,083748,Rideout; David Porter,5,0,37,32
1657850288441,MATH 18,B02,083749,Rideout; David Porter,5,0,36,31
1657850288441,MATH 18,B03,083750,Rideout; David Porter,3,0,37,34
1657850288441,MATH 18,B04,083751,Rideout; David Porter,6,0,36,30
1657850288441,MATH 18,B05,093473,Rideout; David Porter,6,0,36,30
1657850288441,MATH 18,B06,093474,Rideout; David Porter,6,0,36,30
1657850294486,MATH 20A,A01,083754,Zheng; Zequn,14,0,40,26
1657850300515,MATH 20B,A01,083756,Briones; Jor-el Thomas Caparas,4,0,36,32
1657850300515,MATH 20B,A02,083757,Briones; Jor-el Thomas Caparas,1,0,36,35
1657850300515,MATH 20B,A03,093475,Briones; Jor-el Thomas Caparas,2,0,36,34
1657850306537,MATH 20C,A01,083760,Briones; Jor-el Thomas Caparas,1,0,35,34
1657850306537,MATH 20C,A02,083761,Briones; Jor-el Thomas Caparas,8,0,35,27
1657850306537,MATH 20C,A03,093476,Briones; Jor-el Thomas Caparas,0,1,36,36
1657850306537,MATH 20C,B01,083762,Bach; Quang Tran,1,0,30,29
1657850312562,MATH 20D,A01,083765,Tran; Brian Kha,5,0,30,25
1657850312562,MATH 20D,A02,083766,Tran; Brian Kha,5,0,30,25
1657850312562,MATH 20D,A03,083767,Tran; Brian Kha,5,0,30,25
1657850318595,MATH 20E,A01,083771,Ganguly; Soumya,10,0,32,22
1657850318595,MATH 20E,A02,083772,Ganguly; Soumya,6,0,32,26
1657850318595,MATH 20E,B01,083773,Ciotti; Benjamin,20,0,35,15
1657850318595,MATH 20E,B02,083774,Ciotti; Benjamin,18,0,35,17
1657850324620,MATH 103A,A01,083777,Greenfeld; Be'Eri,3,0,36,33
1657850324620,MATH 103A,A02,083778,Greenfeld; Be'Eri,5,0,36,31
1657850324620,MATH 103A,A03,093561,Greenfeld; Be'Eri,6,0,36,30
1657850324620,MATH 103A,B01,083779,Greenfeld; Be'Eri,7,0,36,29
1657850324620,MATH 103A,B02,083780,Greenfeld; Be'Eri,4,0,36,32
1657850324620,MATH 103A,B03,093562,Greenfeld; Be'Eri,3,0,36,33
1657850330649,MATH 105,A01,085443,Carter; Anne Toulson,15,0,35,20
1657850330649,MATH 105,A02,093477,Carter; Anne Toulson,20,0,35,15
1657850336672,MATH 109,A01,083213,Ganzberger; Geoffrey Michael,3,0,34,31
1657850336672,MATH 109,A02,083214,Ganzberger; Geoffrey Michael,4,0,34,30
1657850336672,MATH 109,A03,093478,Ganzberger; Geoffrey Michael,2,0,34,32
1657850336672,MATH 109,B01,083215,Ganzberger; Geoffrey Michael,1,0,32,31
1657850336672,MATH 109,B02,083216,Ganzberger; Geoffrey Michael,2,0,32,30
1657850336672,MATH 109,B03,093479,Ganzberger; Geoffrey Michael,8,0,32,24
1657850342698,MATH 142A,A01,083219,Chow; Bennett,7,0,32,25
1657850342698,MATH 142A,A02,083220,Chow; Bennett,10,0,32,22
1657850342698,MATH 142A,A03,093480,Chow; Bennett,9,0,32,23
1657850342698,MATH 142A,B03,093481,Chow; Bennett,8,0,32,24
1657850342698,MATH 142A,B04,093558,Chow; Bennett,13,0,32,19
1657850342698,MATH 142A,B05,093559,Chow; Bennett,7,0,32,25
1657850348728,MATH 193A,A01,083224,Rotar; Vladimir,8,0,34,26
1657850348728,MATH 193A,A02,083225,Rotar; Vladimir,10,0,34,24
1657850348728,MATH 193A,A03,083781,Rotar; Vladimir,5,0,34,29
1657850348728,MATH 193A,A04,083782,Rotar; Vladimir,11,0,34,23
1657850348728,MATH 193A,A05,093482,Rotar; Vladimir,10,0,34,24
1657850354765,MATH 197,001,091859,McAuley; Julian John,9999,0,9999,0
1657850354765,MATH 197,002,095566,Kedlaya; Kiran S.,9997,0,9999,2
1657850354765,MATH 197,003,095567,Xiao; Ming,9999,0,9999,0
1657850354765,MATH 197,004,095571,Perols; Johan Lars,9998,0,9999,1
1657850361827,COGS 9,A01,083615,Shannon; Kyle Michael,10,0,75,65
1657850367854,COGS 11,A01,083617,Boyle; Mary E. T.,23,0,48,25
1657850373878,COGS 13,A01,083071,Bastos; Amalia Pinkusfeld,11,0,71,60
1657850379901,COGS 14A,A01,092681,Semenuks; Arturs,5,1,100,95
1657850385925,COGS 14B,A01,083073,Cheng; Tzu-Han,6,0,63,57
1657850391954,COGS 17,A01,092677,Semenuks; Arturs,6,0,81,75
1657850397976,COGS 100,A01,083619,Allen; Michael Gordon,17,0,70,53
1657850404002,COGS 101A,A01,083621,Davis; Joshua Daniel,9,0,68,59
1657850410124,COGS 101B,A01,091572,Allen; Michael Gordon,12,0,65,53
1657850416159,COGS 101C,A01,083625,Delgado; Tania,17,0,35,18
1657850422181,COGS 107A,A01,083627,Boyle; Mary E. T.,14,0,60,46
1657850428205,COGS 118A,A01,083075,Gupta; Anjum,21,0,76,55
1657850434228,CSE 3,A50,083646,Miranda; Gregory Joseph,24,0,50,26
1657850440252,CSE 8A,A50,083650,Miranda; Gregory Joseph,17,1,56,39
1657850446275,CSE 11,A01,083080,Cao; Yingjun,6,15,40,34
1657850452297,CSE 12,A01,083652,Krause-Levy; Sophia Louisa,29,1,120,91
1657850458323,CSE 15L,A01,083654,Morris; Justin Loren,9,0,50,41
1657850458323,CSE 15L,A02,083655,Morris; Justin Loren,9,0,50,41
1657850464361,CSE 20,A01,083657,Tran; Khoa Dang,39,0,80,41
1657850470383,CSE 21,A01,095574,Bach; Quang Tran,22,0,48,26
1657850476405,CSE 30,A01,083084,Eldon; John,6,0,80,74
1657850476405,CSE 30,B01,095061,Bhaskar; Nishant,9,0,50,41
1657850482428,CSE 100,A01,083659,Cao; Yingjun,5,4,70,65
1657850488453,CSE 134B,A01,083661,Powell; Thomas Allan,24,0,100,76
1657850494475,CSE 140,A01,083663,Gungor; Onat,15,0,85,70
1657850500501,CSE 140L,A01,083088,Eldon; John,23,0,100,77
1657850506525,CSE 175,A01,083665,Kumar; Rakesh,3,0,25,22
1657850512551,CSE 190,A00,092507,Dubnov; Shlomo,8,0,20,12
1657850518576,ECE 45,A01,083139,Congero; Spencer William,6,0,75,69
1657850524606,ECE 65,A50,083695,Saad; Andrew S,12,0,30,18
1657850524606,ECE 65,A51,095125,Saad; Andrew S,24,0,26,2
1657850530630,ECE 109,A01,091882,Touri; Behrouz,20,0,70,50
1657850536654,ECE 180,A00,083140,Abi Samra; Nicholas Camill,1,0,30,29
1657850536654,ECE 180,B00,083141,Abi Samra; Nicholas Camill,0,0,30,30
1657850542687,MATH 10A,A01,083735,Patchell; Gregory David,2,0,30,28
1657850542687,MATH 10A,A02,083736,Patchell; Gregory David,20,0,30,10
1657850542687,MATH 10A,A03,083737,Patchell; Gregory David,16,0,30,14
1657850548711,MATH 10B,A01,083207,Lim; Seonhee,8,0,34,26
1657850548711,MATH 10B,A02,083208,Lim; Seonhee,10,0,35,25
1657850548711,MATH 10B,A03,093472,Lim; Seonhee,7,0,34,27
1657850548711,MATH 10B,B01,083739,Sinha; Shubham,14,0,30,16
1657850554741,MATH 18,A01,083743,Cinel; Cameron Alexander,9,0,30,21
1657850554741,MATH 18,A02,083744,Cinel; Cameron Alexander,18,0,30,12
1657850554741,MATH 18,A03,083745,Cinel; Cameron Alexander,10,0,30,20
1657850554741,MATH 18,B01,083748,Rideout; David Porter,5,0,37,32
1657850554741,MATH 18,B02,083749,Rideout; David Porter,5,0,36,31
1657850554741,MATH 18,B03,083750,Rideout; David Porter,3,0,37,34
1657850554741,MATH 18,B04,083751,Rideout; David Porter,6,0,36,30
1657850554741,MATH 18,B05,093473,Rideout; David Porter,6,0,36,30
1657850554741,MATH 18,B06,093474,Rideout; David Porter,6,0,36,30
1657850560765,MATH 20A,A01,083754,Zheng; Zequn,14,0,40,26
1657850566800,MATH 20B,A01,083756,Briones; Jor-el Thomas Caparas,4,0,36,32
1657850566800,MATH 20B,A02,083757,Briones; Jor-el Thomas Caparas,1,0,36,35
1657850566800,MATH 20B,A03,093475,Briones; Jor-el Thomas Caparas,2,0,36,34
1657850572823,MATH 20C,A01,083760,Briones; Jor-el Thomas Caparas,1,0,35,34
1657850572823,MATH 20C,A02,083761,Briones; Jor-el Thomas Caparas,8,0,35,27
1657850572823,MATH 20C,A03,093476,Briones; Jor-el Thomas Caparas,0,1,36,36
1657850572823,MATH 20C,B01,083762,Bach; Quang Tran,1,0,30,29
1657850578856,MATH 20D,A01,083765,Tran; Brian Kha,5,0,30,25
1657850578856,MATH 20D,A02,083766,Tran; Brian Kha,5,0,30,25
1657850578856,MATH 20D,A03,083767,Tran; Brian Kha,5,0,30,25
1657850584883,MATH 20E,A01,083771,Ganguly; Soumya,10,0,32,22
1657850584883,MATH 20E,A02,083772,Ganguly; Soumya,6,0,32,26
1657850584883,MATH 20E,B01,083773,Ciotti; Benjamin,20,0,35,15
1657850584883,MATH 20E,B02,083774,Ciotti; Benjamin,18,0,35,17
1657850590911,MATH 103A,A01,083777,Greenfeld; Be'Eri,3,0,36,33
1657850590911,MATH 103A,A02,083778,Greenfeld; Be'Eri,5,0,36,31
1657850590911,MATH 103A,A03,093561,Greenfeld; Be'Eri,6,0,36,30
1657850590911,MATH 103A,B01,083779,Greenfeld; Be'Eri,7,0,36,29
1657850590911,MATH 103A,B02,083780,Greenfeld; Be'Eri,4,0,36,32
1657850590911,MATH 103A,B03,093562,Greenfeld; Be'Eri,3,0,36,33
1657850596939,MATH 105,A01,085443,Carter; Anne Toulson,15,0,35,20
1657850596939,MATH 105,A02,093477,Carter; Anne Toulson,20,0,35,15
1657850602964,MATH 109,A01,083213,Ganzberger; Geoffrey Michael,3,0,34,31
1657850602964,MATH 109,A02,083214,Ganzberger; Geoffrey Michael,4,0,34,30
1657850602964,MATH 109,A03,093478,Ganzberger; Geoffrey Michael,2,0,34,32
1657850602964,MATH 109,B01,083215,Ganzberger; Geoffrey Michael,1,0,32,31
1657850602964,MATH 109,B02,083216,Ganzberger; Geoffrey Michael,2,0,32,30
1657850602964,MATH 109,B03,093479,Ganzberger; Geoffrey Michael,8,0,32,24
1657850608996,MATH 142A,A01,083219,Chow; Bennett,7,0,32,25
1657850608996,MATH 142A,A02,083220,Chow; Bennett,10,0,32,22
1657850608996,MATH 142A,A03,093480,Chow; Bennett,9,0,32,23
1657850608996,MATH 142A,B03,093481,Chow; Bennett,8,0,32,24
1657850608996,MATH 142A,B04,093558,Chow; Bennett,13,0,32,19
1657850608996,MATH 142A,B05,093559,Chow; Bennett,7,0,32,25
1657850615022,MATH 193A,A01,083224,Rotar; Vladimir,8,0,34,26
1657850615022,MATH 193A,A02,083225,Rotar; Vladimir,10,0,34,24
1657850615022,MATH 193A,A03,083781,Rotar; Vladimir,5,0,34,29
1657850615022,MATH 193A,A04,083782,Rotar; Vladimir,11,0,34,23
1657850615022,MATH 193A,A05,093482,Rotar; Vladimir,10,0,34,24
1657850621049,MATH 197,001,091859,McAuley; Julian John,9999,0,9999,0
1657850621049,MATH 197,002,095566,Kedlaya; Kiran S.,9997,0,9999,2
1657850621049,MATH 197,003,095567,Xiao; Ming,9999,0,9999,0
1657850621049,MATH 197,004,095571,Perols; Johan Lars,9998,0,9999,1
1657850628110,COGS 9,A01,083615,Shannon; Kyle Michael,10,0,75,65
1657850634136,COGS 11,A01,083617,Boyle; Mary E. T.,23,0,48,25
1657850640171,COGS 13,A01,083071,Bastos; Amalia Pinkusfeld,11,0,71,60
1657850646196,COGS 14A,A01,092681,Semenuks; Arturs,5,1,100,95
1657850652220,COGS 14B,A01,083073,Cheng; Tzu-Han,6,0,63,57
1657850658244,COGS 17,A01,092677,Semenuks; Arturs,6,0,81,75
1657850664271,COGS 100,A01,083619,Allen; Michael Gordon,17,0,70,53
1657850670299,COGS 101A,A01,083621,Davis; Joshua Daniel,9,0,68,59
1657850676327,COGS 101B,A01,091572,Allen; Michael Gordon,12,0,65,53
1657850682349,COGS 101C,A01,083625,Delgado; Tania,17,0,35,18
1657850688377,COGS 107A,A01,083627,Boyle; Mary E. T.,14,0,60,46
1657850694404,COGS 118A,A01,083075,Gupta; Anjum,21,0,76,55
1657850700436,CSE 3,A50,083646,Miranda; Gregory Joseph,24,0,50,26
1657850706459,CSE 8A,A50,083650,Miranda; Gregory Joseph,17,1,56,39
1657850712486,CSE 11,A01,083080,Cao; Yingjun,6,15,40,34
1657850718517,CSE 12,A01,083652,Krause-Levy; Sophia Louisa,29,1,120,91
1657850724551,CSE 15L,A01,083654,Morris; Justin Loren,9,0,50,41
1657850724551,CSE 15L,A02,083655,Morris; Justin Loren,9,0,50,41
1657850730574,CSE 20,A01,083657,Tran; Khoa Dang,39,0,80,41
1657850736604,CSE 21,A01,095574,Bach; Quang Tran,22,0,48,26
1657850742626,CSE 30,A01,083084,Eldon; John,6,0,80,74
1657850742626,CSE 30,B01,095061,Bhaskar; Nishant,9,0,50,41
1657850748648,CSE 100,A01,083659,Cao; Yingjun,5,4,70,65
1657850754684,CSE 134B,A01,083661,Powell; Thomas Allan,24,0,100,76
1657850760714,CSE 140,A01,083663,Gungor; Onat,15,0,85,70
1657850766738,CSE 140L,A01,083088,Eldon; John,23,0,100,77
1657850772785,CSE 175,A01,083665,Kumar; Rakesh,3,0,25,22
1657850778811,CSE 190,A00,092507,Dubnov; Shlomo,8,0,20,12
1657850784835,ECE 45,A01,083139,Congero; Spencer William,6,0,75,69
1657850790861,ECE 65,A50,083695,Saad; Andrew S,12,0,30,18
1657850790861,ECE 65,A51,095125,Saad; Andrew S,24,0,26,2
1657850803807,ECE 109,A01,091882,Touri; Behrouz,20,0,70,50
1657850809836,ECE 180,A00,083140,Abi Samra; Nicholas Camill,1,0,30,29
1657850809836,ECE 180,B00,083141,Abi Samra; Nicholas Camill,0,0,30,30
1657850815861,MATH 10A,A01,083735,Patchell; Gregory David,2,0,30,28
1657850815861,MATH 10A,A02,083736,Patchell; Gregory David,20,0,30,10
1657850815861,MATH 10A,A03,083737,Patchell; Gregory David,16,0,30,14
1657850821902,MATH 10B,A01,083207,Lim; Seonhee,8,0,34,26
1657850821902,MATH 10B,A02,083208,Lim; Seonhee,10,0,35,25
1657850821902,MATH 10B,A03,093472,Lim; Seonhee,7,0,34,27
1657850821902,MATH 10B,B01,083739,Sinha; Shubham,14,0,30,16
1657850827937,MATH 18,A01,083743,Cinel; Cameron Alexander,9,0,30,21
1657850827937,MATH 18,A02,083744,Cinel; Cameron Alexander,18,0,30,12
1657850827937,MATH 18,A03,083745,Cinel; Cameron Alexander,10,0,30,20
1657850827937,MATH 18,B01,083748,Rideout; David Porter,5,0,37,32
1657850827937,MATH 18,B02,083749,Rideout; David Porter,5,0,36,31
1657850827937,MATH 18,B03,083750,Rideout; David Porter,3,0,37,34
1657850827937,MATH 18,B04,083751,Rideout; David Porter,6,0,36,30
1657850827937,MATH 18,B05,093473,Rideout; David Porter,6,0,36,30
1657850827937,MATH 18,B06,093474,Rideout; David Porter,6,0,36,30
1657850833964,MATH 20A,A01,083754,Zheng; Zequn,14,0,40,26
1657850839986,MATH 20B,A01,083756,Briones; Jor-el Thomas Caparas,4,0,36,32
1657850839986,MATH 20B,A02,083757,Briones; Jor-el Thomas Caparas,1,0,36,35
1657850839986,MATH 20B,A03,093475,Briones; Jor-el Thomas Caparas,2,0,36,34
1657850846010,MATH 20C,A01,083760,Briones; Jor-el Thomas Caparas,1,0,35,34
1657850846010,MATH 20C,A02,083761,Briones; Jor-el Thomas Caparas,8,0,35,27
1657850846010,MATH 20C,A03,093476,Briones; Jor-el Thomas Caparas,0,1,36,36
1657850846010,MATH 20C,B01,083762,Bach; Quang Tran,1,0,30,29
1657850852038,MATH 20D,A01,083765,Tran; Brian Kha,5,0,30,25
1657850852038,MATH 20D,A02,083766,Tran; Brian Kha,5,0,30,25
1657850852038,MATH 20D,A03,083767,Tran; Brian Kha,5,0,30,25
1657850858066,MATH 20E,A01,083771,Ganguly; Soumya,10,0,32,22
1657850858066,MATH 20E,A02,083772,Ganguly; Soumya,6,0,32,26
1657850858066,MATH 20E,B01,083773,Ciotti; Benjamin,20,0,35,15
1657850858066,MATH 20E,B02,083774,Ciotti; Benjamin,18,0,35,17
1657850864096,MATH 103A,A01,083777,Greenfeld; Be'Eri,3,0,36,33
1657850864096,MATH 103A,A02,083778,Greenfeld; Be'Eri,5,0,36,31
1657850864096,MATH 103A,A03,093561,Greenfeld; Be'Eri,6,0,36,30
1657850864096,MATH 103A,B01,083779,Greenfeld; Be'Eri,7,0,36,29
1657850864096,MATH 103A,B02,083780,Greenfeld; Be'Eri,4,0,36,32
1657850864096,MATH 103A,B03,093562,Greenfeld; Be'Eri,3,0,36,33
1657850870118,MATH 105,A01,085443,Carter; Anne Toulson,15,0,35,20
1657850870118,MATH 105,A02,093477,Carter; Anne Toulson,20,0,35,15
1657850876148,MATH 109,A01,083213,Ganzberger; Geoffrey Michael,3,0,34,31
1657850876148,MATH 109,A02,083214,Ganzberger; Geoffrey Michael,4,0,34,30
1657850876148,MATH 109,A03,093478,Ganzberger; Geoffrey Michael,2,0,34,32
1657850876148,MATH 109,B01,083215,Ganzberger; Geoffrey Michael,1,0,32,31
1657850876148,MATH 109,B02,083216,Ganzberger; Geoffrey Michael,2,0,32,30
1657850876148,MATH 109,B03,093479,Ganzberger; Geoffrey Michael,8,0,32,24
1657850882192,MATH 142A,A01,083219,Chow; Bennett,7,0,32,25
1657850882192,MATH 142A,A02,083220,Chow; Bennett,10,0,32,22
1657850882192,MATH 142A,A03,093480,Chow; Bennett,9,0,32,23
1657850882192,MATH 142A,B03,093481,Chow; Bennett,8,0,32,24
1657850882192,MATH 142A,B04,093558,Chow; Bennett,13,0,32,19
1657850882192,MATH 142A,B05,093559,Chow; Bennett,7,0,32,25
1657850888215,MATH 193A,A01,083224,Rotar; Vladimir,8,0,34,26
1657850888215,MATH 193A,A02,083225,Rotar; Vladimir,10,0,34,24
1657850888215,MATH 193A,A03,083781,Rotar; Vladimir,5,0,34,29
1657850888215,MATH 193A,A04,083782,Rotar; Vladimir,11,0,34,23
1657850888215,MATH 193A,A05,093482,Rotar; Vladimir,10,0,34,24
1657850894246,MATH 197,001,091859,McAuley; Julian John,9999,0,9999,0
1657850894246,MATH 197,002,095566,Kedlaya; Kiran S.,9997,0,9999,2
1657850894246,MATH 197,003,095567,Xiao; Ming,9999,0,9999,0
1657850894246,MATH 197,004,095571,Perols; Johan Lars,9998,0,9999,1
1657850901326,COGS 9,A01,083615,Shannon; Kyle Michael,10,0,75,65
1657850907354,COGS 11,A01,083617,Boyle; Mary E. T.,23,0,48,25
1657850913381,COGS 13,A01,083071,Bastos; Amalia Pinkusfeld,11,0,71,60
1657850919408,COGS 14A,A01,092681,Semenuks; Arturs,5,1,100,95
1657850925431,COGS 14B,A01,083073,Cheng; Tzu-Han,6,0,63,57
1657850931454,COGS 17,A01,092677,Semenuks; Arturs,6,0,81,75
1657850937477,COGS 100,A01,083619,Allen; Michael Gordon,17,0,70,53
1657850943503,COGS 101A,A01,083621,Davis; Joshua Daniel,9,0,68,59
1657850949530,COGS 101B,A01,091572,Allen; Michael Gordon,12,0,65,53
1657850955556,COGS 101C,A01,083625,Delgado; Tania,17,0,35,18
1657850961580,COGS 107A,A01,083627,Boyle; Mary E. T.,14,0,60,46
1657850967611,COGS 118A,A01,083075,Gupta; Anjum,21,0,76,55
1657850973639,CSE 3,A50,083646,Miranda; Gregory Joseph,24,0,50,26
1657850979663,CSE 8A,A50,083650,Miranda; Gregory Joseph,17,1,56,39
1657850985688,CSE 11,A01,083080,Cao; Yingjun,6,15,40,34
1657850991714,CSE 12,A01,083652,Krause-Levy; Sophia Louisa,29,1,120,91
1657850997737,CSE 15L,A01,083654,Morris; Justin Loren,9,0,50,41
1657850997737,CSE 15L,A02,083655,Morris; Justin Loren,9,0,50,41
1657851003766,CSE 20,A01,083657,Tran; Khoa Dang,39,0,80,41
1657851009791,CSE 21,A01,095574,Bach; Quang Tran,22,0,48,26
1657851015904,CSE 30,A01,083084,Eldon; John,6,0,80,74
1657851015904,CSE 30,B01,095061,Bhaskar; Nishant,9,0,50,41
1657851021930,CSE 100,A01,083659,Cao; Yingjun,5,4,70,65
1657851027952,CSE 134B,A01,083661,Powell; Thomas Allan,24,0,100,76
1657851033974,CSE 140,A01,083663,Gungor; Onat,15,0,85,70
1657851039999,CSE 140L,A01,083088,Eldon; John,23,0,100,77
1657851046024,CSE 175,A01,083665,Kumar; Rakesh,3,0,25,22
1657851052047,CSE 190,A00,092507,Dubnov; Shlomo,8,0,20,12
1657851058071,ECE 45,A01,083139,Congero; Spencer William,6,0,75,69
1657851064098,ECE 65,A50,083695,Saad; Andrew S,12,0,30,18
1657851064098,ECE 65,A51,095125,Saad; Andrew S,24,0,26,2
1657851070122,ECE 109,A01,091882,Touri; Behrouz,20,0,70,50
1657851076146,ECE 180,A00,083140,Abi Samra; Nicholas Camill,1,0,30,29
1657851076146,ECE 180,B00,083141,Abi Samra; Nicholas Camill,0,0,30,30
1657851082172,MATH 10A,A01,083735,Patchell; Gregory David,2,0,30,28
1657851082172,MATH 10A,A02,083736,Patchell; Gregory David,20,0,30,10
1657851082172,MATH 10A,A03,083737,Patchell; Gregory David,16,0,30,14
1657851088207,MATH 10B,A01,083207,Lim; Seonhee,8,0,34,26
1657851088207,MATH 10B,A02,083208,Lim; Seonhee,10,0,35,25
1657851088207,MATH 10B,A03,093472,Lim; Seonhee,7,0,34,27
1657851088207,MATH 10B,B01,083739,Sinha; Shubham,14,0,30,16
1657851094232,MATH 18,A01,083743,Cinel; Cameron Alexander,9,0,30,21
1657851094232,MATH 18,A02,083744,Cinel; Cameron Alexander,18,0,30,12
1657851094232,MATH 18,A03,083745,Cinel; Cameron Alexander,10,0,30,20
1657851094232,MATH 18,B01,083748,Rideout; David Porter,5,0,37,32
1657851094232,MATH 18,B02,083749,Rideout; David Porter,5,0,36,31
1657851094232,MATH 18,B03,083750,Rideout; David Porter,3,0,37,34
1657851094232,MATH 18,B04,083751,Rideout; David Porter,6,0,36,30
1657851094232,MATH 18,B05,093473,Rideout; David Porter,6,0,36,30
1657851094232,MATH 18,B06,093474,Rideout; David Porter,6,0,36,30
1657851100257,MATH 20A,A01,083754,Zheng; Zequn,14,0,40,26
1657851106279,MATH 20B,A01,083756,Briones; Jor-el Thomas Caparas,4,0,36,32
1657851106279,MATH 20B,A02,083757,Briones; Jor-el Thomas Caparas,1,0,36,35
1657851106279,MATH 20B,A03,093475,Briones; Jor-el Thomas Caparas,2,0,36,34
1657851112302,MATH 20C,A01,083760,Briones; Jor-el Thomas Caparas,1,0,35,34
1657851112302,MATH 20C,A02,083761,Briones; Jor-el Thomas Caparas,8,0,35,27
1657851112302,MATH 20C,A03,093476,Briones; Jor-el Thomas Caparas,0,1,36,36
1657851112302,MATH 20C,B01,083762,Bach; Quang Tran,1,0,30,29
1657851118326,MATH 20D,A01,083765,Tran; Brian Kha,5,0,30,25
1657851118326,MATH 20D,A02,083766,Tran; Brian Kha,5,0,30,25
1657851118326,MATH 20D,A03,083767,Tran; Brian Kha,5,0,30,25
1657851124349,MATH 20E,A01,083771,Ganguly; Soumya,10,0,32,22
1657851124349,MATH 20E,A02,083772,Ganguly; Soumya,6,0,32,26
1657851124349,MATH 20E,B01,083773,Ciotti; Benjamin,20,0,35,15
1657851124349,MATH 20E,B02,083774,Ciotti; Benjamin,18,0,35,17
1657851130372,MATH 103A,A01,083777,Greenfeld; Be'Eri,3,0,36,33
1657851130372,MATH 103A,A02,083778,Greenfeld; Be'Eri,5,0,36,31
1657851130372,MATH 103A,A03,093561,Greenfeld; Be'Eri,6,0,36,30
1657851130372,MATH 103A,B01,083779,Greenfeld; Be'Eri,7,0,36,29
1657851130372,MATH 103A,B02,083780,Greenfeld; Be'Eri,4,0,36,32
1657851130372,MATH 103A,B03,093562,Greenfeld; Be'Eri,3,0,36,33
1657851136395,MATH 105,A01,085443,Carter; Anne Toulson,15,0,35,20
1657851136395,MATH 105,A02,093477,Carter; Anne Toulson,20,0,35,15
1657851142424,MATH 109,A01,083213,Ganzberger; Geoffrey Michael,3,0,34,31
1657851142424,MATH 109,A02,083214,Ganzberger; Geoffrey Michael,4,0,34,30
1657851142424,MATH 109,A03,093478,Ganzberger; Geoffrey Michael,2,0,34,32
1657851142424,MATH 109,B01,083215,Ganzberger; Geoffrey Michael,1,0,32,31
1657851142424,MATH 109,B02,083216,Ganzberger; Geoffrey Michael,2,0,32,30
1657851142424,MATH 109,B03,093479,Ganzberger; Geoffrey Michael,8,0,32,24
1657851148467,MATH 142A,A01,083219,Chow; Bennett,7,0,32,25
1657851148467,MATH 142A,A02,083220,Chow; Bennett,10,0,32,22
1657851148467,MATH 142A,A03,093480,Chow; Bennett,9,0,32,23
1657851148467,MATH 142A,B03,093481,Chow; Bennett,8,0,32,24
1657851148467,MATH 142A,B04,093558,Chow; Bennett,13,0,32,19
1657851148467,MATH 142A,B05,093559,Chow; Bennett,7,0,32,25
1657851154505,MATH 193A,A01,083224,Rotar; Vladimir,8,0,34,26
1657851154505,MATH 193A,A02,083225,Rotar; Vladimir,10,0,34,24
1657851154505,MATH 193A,A03,083781,Rotar; Vladimir,5,0,34,29
1657851154505,MATH 193A,A04,083782,Rotar; Vladimir,11,0,34,23
1657851154505,MATH 193A,A05,093482,Rotar; Vladimir,10,0,34,24
1657851160533,MATH 197,001,091859,McAuley; Julian John,9999,0,9999,0
1657851160533,MATH 197,002,095566,Kedlaya; Kiran S.,9997,0,9999,2
1657851160533,MATH 197,003,095567,Xiao; Ming,9999,0,9999,0
1657851160533,MATH 197,004,095571,Perols; Johan Lars,9998,0,9999,1
1657851167588,COGS 9,A01,083615,Shannon; Kyle Michael,10,0,75,65
1657851173613,COGS 11,A01,083617,Boyle; Mary E. T.,23,0,48,25
1657851179638,COGS 13,A01,083071,Bastos; Amalia Pinkusfeld,11,0,71,60
1657851185665,COGS 14A,A01,092681,Semenuks; Arturs,5,1,100,95
1657851191691,COGS 14B,A01,083073,Cheng; Tzu-Han,6,0,63,57
1657851197714,COGS 17,A01,092677,Semenuks; Arturs,6,0,81,75
1657851203740,COGS 100,A01,083619,Allen; Michael Gordon,17,0,70,53
1657851209763,COGS 101A,A01,083621,Davis; Joshua Daniel,9,0,68,59
1657851215784,COGS 101B,A01,091572,Allen; Michael Gordon,12,0,65,53
1657851221808,COGS 101C,A01,083625,Delgado; Tania,17,0,35,18
1657851227832,COGS 107A,A01,083627,Boyle; Mary E. T.,14,0,60,46
1657851233855,COGS 118A,A01,083075,Gupta; Anjum,21,0,76,55
1657851239877,CSE 3,A50,083646,Miranda; Gregory Joseph,24,0,50,26
1657851245903,CSE 8A,A50,083650,Miranda; Gregory Joseph,17,1,56,39
1657851251928,CSE 11,A01,083080,Cao; Yingjun,6,15,40,34
1657851257955,CSE 12,A01,083652,Krause-Levy; Sophia Louisa,29,1,120,91
1657851263981,CSE 15L,A01,083654,Morris; Justin Loren,9,0,50,41
1657851263981,CSE 15L,A02,083655,Morris; Justin Loren,9,0,50,41
1657851270005,CSE 20,A01,083657,Tran; Khoa Dang,39,0,80,41
1657851276036,CSE 21,A01,095574,Bach; Quang Tran,22,0,48,26
1657851282066,CSE 30,A01,083084,Eldon; John,6,0,80,74
1657851282066,CSE 30,B01,095061,Bhaskar; Nishant,9,0,50,41
1657851288092,CSE 100,A01,083659,Cao; Yingjun,5,4,70,65
1657851294121,CSE 134B,A01,083661,Powell; Thomas Allan,24,0,100,76
1657851300153,CSE 140,A01,083663,Gungor; Onat,15,0,85,70
1657851306187,CSE 140L,A01,083088,Eldon; John,23,0,100,77
1657851312211,CSE 175,A01,083665,Kumar; Rakesh,3,0,25,22
1657851318234,CSE 190,A00,092507,Dubnov; Shlomo,8,0,20,12
1657851324258,ECE 45,A01,083139,Congero; Spencer William,6,0,75,69
1657851330286,ECE 65,A50,083695,Saad; Andrew S,12,0,30,18
1657851330286,ECE 65,A51,095125,Saad; Andrew S,24,0,26,2
1657851336310,ECE 109,A01,091882,Touri; Behrouz,20,0,70,50
1657851342334,ECE 180,A00,083140,Abi Samra; Nicholas Camill,1,0,30,29
1657851342334,ECE 180,B00,083141,Abi Samra; Nicholas Camill,0,0,30,30
1657851348357,MATH 10A,A01,083735,Patchell; Gregory David,2,0,30,28
1657851348357,MATH 10A,A02,083736,Patchell; Gregory David,20,0,30,10
1657851348357,MATH 10A,A03,083737,Patchell; Gregory David,16,0,30,14
1657851354388,MATH 10B,A01,083207,Lim; Seonhee,8,0,34,26
1657851354388,MATH 10B,A02,083208,Lim; Seonhee,10,0,35,25
1657851354388,MATH 10B,A03,093472,Lim; Seonhee,7,0,34,27
1657851354388,MATH 10B,B01,083739,Sinha; Shubham,14,0,30,16
1657851360424,MATH 18,A01,083743,Cinel; Cameron Alexander,9,0,30,21
1657851360424,MATH 18,A02,083744,Cinel; Cameron Alexander,18,0,30,12
1657851360424,MATH 18,A03,083745,Cinel; Cameron Alexander,10,0,30,20
1657851360424,MATH 18,B01,083748,Rideout; David Porter,5,0,37,32
1657851360424,MATH 18,B02,083749,Rideout; David Porter,5,0,36,31
1657851360424,MATH 18,B03,083750,Rideout; David Porter,3,0,37,34
1657851360424,MATH 18,B04,083751,Rideout; David Porter,6,0,36,30
1657851360424,MATH 18,B05,093473,Rideout; David Porter,6,0,36,30
1657851360424,MATH 18,B06,093474,Rideout; David Porter,6,0,36,30
1657851366448,MATH 20A,A01,083754,Zheng; Zequn,14,0,40,26
1657851372470,MATH 20B,A01,083756,Briones; Jor-el Thomas Caparas,4,0,36,32
1657851372470,MATH 20B,A02,083757,Briones; Jor-el Thomas Caparas,1,0,36,35
1657851372470,MATH 20B,A03,093475,Briones; Jor-el Thomas Caparas,2,0,36,34
1657851378497,MATH 20C,A01,083760,Briones; Jor-el Thomas Caparas,1,0,35,34
1657851378497,MATH 20C,A02,083761,Briones; Jor-el Thomas Caparas,8,0,35,27
1657851378497,MATH 20C,A03,093476,Briones; Jor-el Thomas Caparas,0,1,36,36
1657851378497,MATH 20C,B01,083762,Bach; Quang Tran,1,0,30,29
1657851384525,MATH 20D,A01,083765,Tran; Brian Kha,5,0,30,25
1657851384525,MATH 20D,A02,083766,Tran; Brian Kha,5,0,30,25
1657851384525,MATH 20D,A03,083767,Tran; Brian Kha,5,0,30,25
1657851390593,MATH 20E,A01,083771,Ganguly; Soumya,10,0,32,22
1657851390593,MATH 20E,A02,083772,Ganguly; Soumya,6,0,32,26
1657851390593,MATH 20E,B01,083773,Ciotti; Benjamin,20,0,35,15
1657851390593,MATH 20E,B02,083774,Ciotti; Benjamin,18,0,35,17
1657851396617,MATH 103A,A01,083777,Greenfeld; Be'Eri,3,0,36,33
1657851396617,MATH 103A,A02,083778,Greenfeld; Be'Eri,5,0,36,31
1657851396617,MATH 103A,A03,093561,Greenfeld; Be'Eri,6,0,36,30
1657851396617,MATH 103A,B01,083779,Greenfeld; Be'Eri,7,0,36,29
1657851396617,MATH 103A,B02,083780,Greenfeld; Be'Eri,4,0,36,32
1657851396617,MATH 103A,B03,093562,Greenfeld; Be'Eri,3,0,36,33
1657851402647,MATH 105,A01,085443,Carter; Anne Toulson,15,0,35,20
1657851402647,MATH 105,A02,093477,Carter; Anne Toulson,20,0,35,15
1657851408671,MATH 109,A01,083213,Ganzberger; Geoffrey Michael,3,0,34,31
1657851408671,MATH 109,A02,083214,Ganzberger; Geoffrey Michael,4,0,34,30
1657851408671,MATH 109,A03,093478,Ganzberger; Geoffrey Michael,2,0,34,32
1657851408671,MATH 109,B01,083215,Ganzberger; Geoffrey Michael,1,0,32,31
1657851408671,MATH 109,B02,083216,Ganzberger; Geoffrey Michael,2,0,32,30
1657851408671,MATH 109,B03,093479,Ganzberger; Geoffrey Michael,8,0,32,24
1657851414695,MATH 142A,A01,083219,Chow; Bennett,7,0,32,25
1657851414695,MATH 142A,A02,083220,Chow; Bennett,10,0,32,22
1657851414695,MATH 142A,A03,093480,Chow; Bennett,9,0,32,23
1657851414695,MATH 142A,B03,093481,Chow; Bennett,8,0,32,24
1657851414695,MATH 142A,B04,093558,Chow; Bennett,13,0,32,19
1657851414695,MATH 142A,B05,093559,Chow; Bennett,7,0,32,25
1657851420718,MATH 193A,A01,083224,Rotar; Vladimir,8,0,34,26
1657851420718,MATH 193A,A02,083225,Rotar; Vladimir,10,0,34,24
1657851420718,MATH 193A,A03,083781,Rotar; Vladimir,5,0,34,29
1657851420718,MATH 193A,A04,083782,Rotar; Vladimir,11,0,34,23
1657851420718,MATH 193A,A05,093482,Rotar; Vladimir,10,0,34,24
1657851426751,MATH 197,001,091859,McAuley; Julian John,9999,0,9999,0
1657851426751,MATH 197,002,095566,Kedlaya; Kiran S.,9997,0,9999,2
1657851426751,MATH 197,003,095567,Xiao; Ming,9999,0,9999,0
1657851426751,MATH 197,004,095571,Perols; Johan Lars,9998,0,9999,1
1657851433821,COGS 9,A01,083615,Shannon; Kyle Michael,10,0,75,65
1657851439855,COGS 11,A01,083617,Boyle; Mary E. T.,23,0,48,25
1657851445888,COGS 13,A01,083071,Bastos; Amalia Pinkusfeld,11,0,71,60
1657851451911,COGS 14A,A01,092681,Semenuks; Arturs,5,1,100,95
1657851457935,COGS 14B,A01,083073,Cheng; Tzu-Han,6,0,63,57
1657851463962,COGS 17,A01,092677,Semenuks; Arturs,6,0,81,75
1657851469984,COGS 100,A01,083619,Allen; Michael Gordon,17,0,70,53
1657851476012,COGS 101A,A01,083621,Davis; Joshua Daniel,9,0,68,59
1657851482059,COGS 101B,A01,091572,Allen; Michael Gordon,12,0,65,53
1657851488089,COGS 101C,A01,083625,Delgado; Tania,17,0,35,18
1657851494115,COGS 107A,A01,083627,Boyle; Mary E. T.,14,0,60,46
1657851500138,COGS 118A,A01,083075,Gupta; Anjum,21,0,76,55
1657851506161,CSE 3,A50,083646,Miranda; Gregory Joseph,24,0,50,26
1657851512184,CSE 8A,A50,083650,Miranda; Gregory Joseph,17,1,56,39
1657851518207,CSE 11,A01,083080,Cao; Yingjun,6,15,40,34
1657851524233,CSE 12,A01,083652,Krause-Levy; Sophia Louisa,29,1,120,91
1657851530256,CSE 15L,A01,083654,Morris; Justin Loren,9,0,50,41
1657851530256,CSE 15L,A02,083655,Morris; Justin Loren,9,0,50,41
1657851536278,CSE 20,A01,083657,Tran; Khoa Dang,39,0,80,41
1657851542305,CSE 21,A01,095574,Bach; Quang Tran,22,0,48,26
1657851548329,CSE 30,A01,083084,Eldon; John,6,0,80,74
1657851548329,CSE 30,B01,095061,Bhaskar; Nishant,9,0,50,41
1657851554358,CSE 100,A01,083659,Cao; Yingjun,5,4,70,65
1657851560382,CSE 134B,A01,083661,Powell; Thomas Allan,24,0,100,76
1657851566410,CSE 140,A01,083663,Gungor; Onat,15,0,85,70
1657851572445,CSE 140L,A01,083088,Eldon; John,23,0,100,77
1657851578470,CSE 175,A01,083665,Kumar; Rakesh,3,0,25,22
1657851584493,CSE 190,A00,092507,Dubnov; Shlomo,8,0,20,12
1657851590521,ECE 45,A01,083139,Congero; Spencer William,6,0,75,69
1657851596544,ECE 65,A50,083695,Saad; Andrew S,12,0,30,18
1657851596544,ECE 65,A51,095125,Saad; Andrew S,24,0,26,2
1657851602570,ECE 109,A01,091882,Touri; Behrouz,20,0,70,50
1657851608596,ECE 180,A00,083140,Abi Samra; Nicholas Camill,1,0,30,29
1657851608596,ECE 180,B00,083141,Abi Samra; Nicholas Camill,0,0,30,30
1657851614697,MATH 10A,A01,083735,Patchell; Gregory David,2,0,30,28
1657851614697,MATH 10A,A02,083736,Patchell; Gregory David,20,0,30,10
1657851614697,MATH 10A,A03,083737,Patchell; Gregory David,16,0,30,14
1657851620725,MATH 10B,A01,083207,Lim; Seonhee,8,0,34,26
1657851620725,MATH 10B,A02,083208,Lim; Seonhee,10,0,35,25
1657851620725,MATH 10B,A03,093472,Lim; Seonhee,7,0,34,27
1657851620725,MATH 10B,B01,083739,Sinha; Shubham,14,0,30,16
1657851626749,MATH 18,A01,083743,Cinel; Cameron Alexander,9,0,30,21
1657851626749,MATH 18,A02,083744,Cinel; Cameron Alexander,18,0,30,12
1657851626749,MATH 18,A03,083745,Cinel; Cameron Alexander,10,0,30,20
1657851626749,MATH 18,B01,083748,Rideout; David Porter,5,0,37,32
1657851626749,MATH 18,B02,083749,Rideout; David Porter,5,0,36,31
1657851626749,MATH 18,B03,083750,Rideout; David Porter,3,0,37,34
1657851626749,MATH 18,B04,083751,Rideout; David Porter,6,0,36,30
1657851626749,MATH 18,B05,093473,Rideout; David Porter,6,0,36,30
1657851626749,MATH 18,B06,093474,Rideout; David Porter,6,0,36,30
1657851632773,MATH 20A,A01,083754,Zheng; Zequn,14,0,40,26
1657851638796,MATH 20B,A01,083756,Briones; Jor-el Thomas Caparas,4,0,36,32
1657851638796,MATH 20B,A02,083757,Briones; Jor-el Thomas Caparas,1,0,36,35
1657851638796,MATH 20B,A03,093475,Briones; Jor-el Thomas Caparas,2,0,36,34
1657851644821,MATH 20C,A01,083760,Briones; Jor-el Thomas Caparas,1,0,35,34
1657851644821,MATH 20C,A02,083761,Briones; Jor-el Thomas Caparas,8,0,35,27
1657851644821,MATH 20C,A03,093476,Briones; Jor-el Thomas Caparas,0,1,36,36
1657851644821,MATH 20C,B01,083762,Bach; Quang Tran,1,0,30,29
1657851650845,MATH 20D,A01,083765,Tran; Brian Kha,5,0,30,25
1657851650845,MATH 20D,A02,083766,Tran; Brian Kha,5,0,30,25
1657851650845,MATH 20D,A03,083767,Tran; Brian Kha,5,0,30,25
1657851656875,MATH 20E,A01,083771,Ganguly; Soumya,10,0,32,22
1657851656875,MATH 20E,A02,083772,Ganguly; Soumya,6,0,32,26
1657851656875,MATH 20E,B01,083773,Ciotti; Benjamin,20,0,35,15
1657851656875,MATH 20E,B02,083774,Ciotti; Benjamin,18,0,35,17
1657851662898,MATH 103A,A01,083777,Greenfeld; Be'Eri,3,0,36,33
1657851662898,MATH 103A,A02,083778,Greenfeld; Be'Eri,5,0,36,31
1657851662898,MATH 103A,A03,093561,Greenfeld; Be'Eri,6,0,36,30
1657851662898,MATH 103A,B01,083779,Greenfeld; Be'Eri,7,0,36,29
1657851662898,MATH 103A,B02,083780,Greenfeld; Be'Eri,4,0,36,32
1657851662898,MATH 103A,B03,093562,Greenfeld; Be'Eri,3,0,36,33
1657851668927,MATH 105,A01,085443,Carter; Anne Toulson,15,0,35,20
1657851668927,MATH 105,A02,093477,Carter; Anne Toulson,20,0,35,15
1657851674951,MATH 109,A01,083213,Ganzberger; Geoffrey Michael,3,0,34,31
1657851674951,MATH 109,A02,083214,Ganzberger; Geoffrey Michael,4,0,34,30
1657851674951,MATH 109,A03,093478,Ganzberger; Geoffrey Michael,2,0,34,32
1657851674951,MATH 109,B01,083215,Ganzberger; Geoffrey Michael,1,0,32,31
1657851674951,MATH 109,B02,083216,Ganzberger; Geoffrey Michael,2,0,32,30
1657851674951,MATH 109,B03,093479,Ganzberger; Geoffrey Michael,8,0,32,24
1657851680979,MATH 142A,A01,083219,Chow; Bennett,7,0,32,25
1657851680979,MATH 142A,A02,083220,Chow; Bennett,10,0,32,22
1657851680979,MATH 142A,A03,093480,Chow; Bennett,9,0,32,23
1657851680979,MATH 142A,B03,093481,Chow; Bennett,8,0,32,24
1657851680979,MATH 142A,B04,093558,Chow; Bennett,13,0,32,19
1657851680979,MATH 142A,B05,093559,Chow; Bennett,7,0,32,25
1657851687004,MATH 193A,A01,083224,Rotar; Vladimir,8,0,34,26
1657851687004,MATH 193A,A02,083225,Rotar; Vladimir,10,0,34,24
1657851687004,MATH 193A,A03,083781,Rotar; Vladimir,5,0,34,29
1657851687004,MATH 193A,A04,083782,Rotar; Vladimir,11,0,34,23
1657851687004,MATH 193A,A05,093482,Rotar; Vladimir,10,0,34,24
1657851693029,MATH 197,001,091859,McAuley; Julian John,9999,0,9999,0
1657851693029,MATH 197,002,095566,Kedlaya; Kiran S.,9997,0,9999,2
1657851693029,MATH 197,003,095567,Xiao; Ming,9999,0,9999,0
1657851693029,MATH 197,004,095571,Perols; Johan Lars,9998,0,9999,1
1657851700119,COGS 9,A01,083615,Shannon; Kyle Michael,10,0,75,65
1657851706142,COGS 11,A01,083617,Boyle; Mary E. T.,23,0,48,25
1657851712166,COGS 13,A01,083071,Bastos; Amalia Pinkusfeld,11,0,71,60
1657851718198,COGS 14A,A01,092681,Semenuks; Arturs,5,1,100,95
1657851724224,COGS 14B,A01,083073,Cheng; Tzu-Han,6,0,63,57
1657851730253,COGS 17,A01,092677,Semenuks; Arturs,6,0,81,75
1657851736281,COGS 100,A01,083619,Allen; Michael Gordon,17,0,70,53
1657851742308,COGS 101A,A01,083621,Davis; Joshua Daniel,9,0,68,59
1657851748333,COGS 101B,A01,091572,Allen; Michael Gordon,12,0,65,53
1657851754358,COGS 101C,A01,083625,Delgado; Tania,17,0,35,18
1657851760399,COGS 107A,A01,083627,Boyle; Mary E. T.,14,0,60,46
1657851766426,COGS 118A,A01,083075,Gupta; Anjum,21,0,76,55
1657851772455,CSE 3,A50,083646,Miranda; Gregory Joseph,24,0,50,26
1657851778483,CSE 8A,A50,083650,Miranda; Gregory Joseph,17,1,56,39
1657851784508,CSE 11,A01,083080,Cao; Yingjun,6,15,40,34
1657851790530,CSE 12,A01,083652,Krause-Levy; Sophia Louisa,29,1,120,91
1657851796552,CSE 15L,A01,083654,Morris; Justin Loren,9,0,50,41
1657851796552,CSE 15L,A02,083655,Morris; Justin Loren,9,0,50,41
1657851802574,CSE 20,A01,083657,Tran; Khoa Dang,39,0,80,41
1657851808595,CSE 21,A01,095574,Bach; Quang Tran,22,0,48,26
1657851814623,CSE 30,A01,083084,Eldon; John,6,0,80,74
1657851814623,CSE 30,B01,095061,Bhaskar; Nishant,9,0,50,41
1657851820645,CSE 100,A01,083659,Cao; Yingjun,5,4,70,65
1657851826666,CSE 134B,A01,083661,Powell; Thomas Allan,24,0,100,76
1657851832689,CSE 140,A01,083663,Gungor; Onat,15,0,85,70
1657851838715,CSE 140L,A01,083088,Eldon; John,23,0,100,77
1657851844741,CSE 175,A01,083665,Kumar; Rakesh,3,0,25,22
1657851850773,CSE 190,A00,092507,Dubnov; Shlomo,8,0,20,12
1657851856795,ECE 45,A01,083139,Congero; Spencer William,6,0,75,69
1657851862827,ECE 65,A50,083695,Saad; Andrew S,12,0,30,18
1657851862827,ECE 65,A51,095125,Saad; Andrew S,24,0,26,2
1657851868855,ECE 109,A01,091882,Touri; Behrouz,20,0,70,50
1657851874881,ECE 180,A00,083140,Abi Samra; Nicholas Camill,1,0,30,29
1657851874881,ECE 180,B00,083141,Abi Samra; Nicholas Camill,0,0,30,30
1657851880910,MATH 10A,A01,083735,Patchell; Gregory David,2,0,30,28
1657851880910,MATH 10A,A02,083736,Patchell; Gregory David,20,0,30,10
1657851880910,MATH 10A,A03,083737,Patchell; Gregory David,16,0,30,14
1657851886935,MATH 10B,A01,083207,Lim; Seonhee,8,0,34,26
1657851886935,MATH 10B,A02,083208,Lim; Seonhee,10,0,35,25
1657851886935,MATH 10B,A03,093472,Lim; Seonhee,7,0,34,27
1657851886935,MATH 10B,B01,083739,Sinha; Shubham,14,0,30,16
1657851892969,MATH 18,A01,083743,Cinel; Cameron Alexander,9,0,30,21
1657851892969,MATH 18,A02,083744,Cinel; Cameron Alexander,18,0,30,12
1657851892969,MATH 18,A03,083745,Cinel; Cameron Alexander,10,0,30,20
1657851892969,MATH 18,B01,083748,Rideout; David Porter,5,0,37,32
1657851892969,MATH 18,B02,083749,Rideout; David Porter,5,0,36,31
1657851892969,MATH 18,B03,083750,Rideout; David Porter,3,0,37,34
1657851892969,MATH 18,B04,083751,Rideout; David Porter,6,0,36,30
1657851892969,MATH 18,B05,093473,Rideout; David Porter,6,0,36,30
1657851892969,MATH 18,B06,093474,Rideout; David Porter,6,0,36,30
1657851898996,MATH 20A,A01,083754,Zheng; Zequn,14,0,40,26
1657851905023,MATH 20B,A01,083756,Briones; Jor-el Thomas Caparas,4,0,36,32
1657851905023,MATH 20B,A02,083757,Briones; Jor-el Thomas Caparas,1,0,36,35
1657851905023,MATH 20B,A03,093475,Briones; Jor-el Thomas Caparas,2,0,36,34
1657851911046,MATH 20C,A01,083760,Briones; Jor-el Thomas Caparas,1,0,35,34
1657851911046,MATH 20C,A02,083761,Briones; Jor-el Thomas Caparas,8,0,35,27
1657851911046,MATH 20C,A03,093476,Briones; Jor-el Thomas Caparas,0,1,36,36
1657851911046,MATH 20C,B01,083762,Bach; Quang Tran,1,0,30,29
1657851917076,MATH 20D,A01,083765,Tran; Brian Kha,5,0,30,25
1657851917076,MATH 20D,A02,083766,Tran; Brian Kha,5,0,30,25
1657851917076,MATH 20D,A03,083767,Tran; Brian Kha,5,0,30,25
1657851923105,MATH 20E,A01,083771,Ganguly; Soumya,10,0,32,22
1657851923105,MATH 20E,A02,083772,Ganguly; Soumya,6,0,32,26
1657851923105,MATH 20E,B01,083773,Ciotti; Benjamin,20,0,35,15
1657851923105,MATH 20E,B02,083774,Ciotti; Benjamin,18,0,35,17
1657851929138,MATH 103A,A01,083777,Greenfeld; Be'Eri,3,0,36,33
1657851929138,MATH 103A,A02,083778,Greenfeld; Be'Eri,5,0,36,31
1657851929138,MATH 103A,A03,093561,Greenfeld; Be'Eri,6,0,36,30
1657851929138,MATH 103A,B01,083779,Greenfeld; Be'Eri,7,0,36,29
1657851929138,MATH 103A,B02,083780,Greenfeld; Be'Eri,4,0,36,32
1657851929138,MATH 103A,B03,093562,Greenfeld; Be'Eri,3,0,36,33
1657851935166,MATH 105,A01,085443,Carter; Anne Toulson,15,0,35,20
1657851935166,MATH 105,A02,093477,Carter; Anne Toulson,20,0,35,15
1657851941195,MATH 109,A01,083213,Ganzberger; Geoffrey Michael,3,0,34,31
1657851941195,MATH 109,A02,083214,Ganzberger; Geoffrey Michael,4,0,34,30
1657851941195,MATH 109,A03,093478,Ganzberger; Geoffrey Michael,2,0,34,32
1657851941195,MATH 109,B01,083215,Ganzberger; Geoffrey Michael,1,0,32,31
1657851941195,MATH 109,B02,083216,Ganzberger; Geoffrey Michael,2,0,32,30
1657851941195,MATH 109,B03,093479,Ganzberger; Geoffrey Michael,8,0,32,24
1657851947220,MATH 142A,A01,083219,Chow; Bennett,7,0,32,25
1657851947220,MATH 142A,A02,083220,Chow; Bennett,10,0,32,22
1657851947220,MATH 142A,A03,093480,Chow; Bennett,9,0,32,23
1657851947220,MATH 142A,B03,093481,Chow; Bennett,8,0,32,24
1657851947220,MATH 142A,B04,093558,Chow; Bennett,13,0,32,19
1657851947220,MATH 142A,B05,093559,Chow; Bennett,7,0,32,25
1657851953243,MATH 193A,A01,083224,Rotar; Vladimir,8,0,34,26
1657851953243,MATH 193A,A02,083225,Rotar; Vladimir,10,0,34,24
1657851953243,MATH 193A,A03,083781,Rotar; Vladimir,5,0,34,29
1657851953243,MATH 193A,A04,083782,Rotar; Vladimir,11,0,34,23
1657851953243,MATH 193A,A05,093482,Rotar; Vladimir,10,0,34,24
1657851959270,MATH 197,001,091859,McAuley; Julian John,9999,0,9999,0
1657851959270,MATH 197,002,095566,Kedlaya; Kiran S.,9997,0,9999,2
1657851959270,MATH 197,003,095567,Xiao; Ming,9999,0,9999,0
1657851959270,MATH 197,004,095571,Perols; Johan Lars,9998,0,9999,1
1657851966327,COGS 9,A01,083615,Shannon; Kyle Michael,10,0,75,65
1657851972350,COGS 11,A01,083617,Boyle; Mary E. T.,23,0,48,25
1657851978373,COGS 13,A01,083071,Bastos; Amalia Pinkusfeld,11,0,71,60
1657851984397,COGS 14A,A01,092681,Semenuks; Arturs,5,1,100,95
1657851990426,COGS 14B,A01,083073,Cheng; Tzu-Han,6,0,63,57
1657851996449,COGS 17,A01,092677,Semenuks; Arturs,6,0,81,75
1657852002472,COGS 100,A01,083619,Allen; Michael Gordon,17,0,70,53
1657852008494,COGS 101A,A01,083621,Davis; Joshua Daniel,9,0,68,59
1657852014523,COGS 101B,A01,091572,Allen; Michael Gordon,12,0,65,53
1657852020548,COGS 101C,A01,083625,Delgado; Tania,17,0,35,18
1657852026575,COGS 107A,A01,083627,Boyle; Mary E. T.,14,0,60,46
1657852032614,COGS 118A,A01,083075,Gupta; Anjum,21,0,76,55
1657852038641,CSE 3,A50,083646,Miranda; Gregory Joseph,24,0,50,26
1657852044670,CSE 8A,A50,083650,Miranda; Gregory Joseph,17,1,56,39
1657852050698,CSE 11,A01,083080,Cao; Yingjun,6,15,40,34
1657852056725,CSE 12,A01,083652,Krause-Levy; Sophia Louisa,29,1,120,91
1657852062750,CSE 15L,A01,083654,Morris; Justin Loren,9,0,50,41
1657852062750,CSE 15L,A02,083655,Morris; Justin Loren,9,0,50,41
1657852068773,CSE 20,A01,083657,Tran; Khoa Dang,39,0,80,41
1657852074798,CSE 21,A01,095574,Bach; Quang Tran,22,0,48,26
1657852080825,CSE 30,A01,083084,Eldon; John,6,0,80,74
1657852080825,CSE 30,B01,095061,Bhaskar; Nishant,9,0,50,41
1657852086847,CSE 100,A01,083659,Cao; Yingjun,5,4,70,65
1657852092870,CSE 134B,A01,083661,Powell; Thomas Allan,24,0,100,76
1657852098893,CSE 140,A01,083663,Gungor; Onat,15,0,85,70
1657852104919,CSE 140L,A01,083088,Eldon; John,23,0,100,77
1657852110975,CSE 175,A01,083665,Kumar; Rakesh,3,0,25,22
1657852116998,CSE 190,A00,092507,Dubnov; Shlomo,8,0,20,12
1657852123021,ECE 45,A01,083139,Congero; Spencer William,6,0,75,69
1657852129045,ECE 65,A50,083695,Saad; Andrew S,12,0,30,18
1657852129045,ECE 65,A51,095125,Saad; Andrew S,24,0,26,2
1657852135071,ECE 109,A01,091882,Touri; Behrouz,20,0,70,50
1657852141103,ECE 180,A00,083140,Abi Samra; Nicholas Camill,1,0,30,29
1657852141103,ECE 180,B00,083141,Abi Samra; Nicholas Camill,0,0,30,30
1657852147128,MATH 10A,A01,083735,Patchell; Gregory David,2,0,30,28
1657852147128,MATH 10A,A02,083736,Patchell; Gregory David,20,0,30,10
1657852147128,MATH 10A,A03,083737,Patchell; Gregory David,16,0,30,14
1657852153151,MATH 10B,A01,083207,Lim; Seonhee,8,0,34,26
1657852153151,MATH 10B,A02,083208,Lim; Seonhee,10,0,35,25
1657852153151,MATH 10B,A03,093472,Lim; Seonhee,7,0,34,27
1657852153151,MATH 10B,B01,083739,Sinha; Shubham,14,0,30,16
1657852159176,MATH 18,A01,083743,Cinel; Cameron Alexander,9,0,30,21
1657852159176,MATH 18,A02,083744,Cinel; Cameron Alexander,18,0,30,12
1657852159176,MATH 18,A03,083745,Cinel; Cameron Alexander,10,0,30,20
1657852159176,MATH 18,B01,083748,Rideout; David Porter,5,0,37,32
1657852159176,MATH 18,B02,083749,Rideout; David Porter,5,0,36,31
1657852159176,MATH 18,B03,083750,Rideout; David Porter,3,0,37,34
1657852159176,MATH 18,B04,083751,Rideout; David Porter,6,0,36,30
1657852159176,MATH 18,B05,093473,Rideout; David Porter,6,0,36,30
1657852159176,MATH 18,B06,093474,Rideout; David Porter,6,0,36,30
1657852165199,MATH 20A,A01,083754,Zheng; Zequn,14,0,40,26
1657852171223,MATH 20B,A01,083756,Briones; Jor-el Thomas Caparas,4,0,36,32
1657852171223,MATH 20B,A02,083757,Briones; Jor-el Thomas Caparas,1,0,36,35
1657852171223,MATH 20B,A03,093475,Briones; Jor-el Thomas Caparas,2,0,36,34
1657852177250,MATH 20C,A01,083760,Briones; Jor-el Thomas Caparas,1,0,35,34
1657852177250,MATH 20C,A02,083761,Briones; Jor-el Thomas Caparas,8,0,35,27
1657852177250,MATH 20C,A03,093476,Briones; Jor-el Thomas Caparas,0,1,36,36
1657852177250,MATH 20C,B01,083762,Bach; Quang Tran,1,0,30,29
1657852183280,MATH 20D,A01,083765,Tran; Brian Kha,5,0,30,25
1657852183280,MATH 20D,A02,083766,Tran; Brian Kha,5,0,30,25
1657852183280,MATH 20D,A03,083767,Tran; Brian Kha,5,0,30,25
1657852189303,MATH 20E,A01,083771,Ganguly; Soumya,10,0,32,22
1657852189303,MATH 20E,A02,083772,Ganguly; Soumya,6,0,32,26
1657852189303,MATH 20E,B01,083773,Ciotti; Benjamin,20,0,35,15
1657852189303,MATH 20E,B02,083774,Ciotti; Benjamin,18,0,35,17
1657852195333,MATH 103A,A01,083777,Greenfeld; Be'Eri,3,0,36,33
1657852195333,MATH 103A,A02,083778,Greenfeld; Be'Eri,5,0,36,31
1657852195333,MATH 103A,A03,093561,Greenfeld; Be'Eri,6,0,36,30
1657852195333,MATH 103A,B01,083779,Greenfeld; Be'Eri,7,0,36,29
1657852195333,MATH 103A,B02,083780,Greenfeld; Be'Eri,4,0,36,32
1657852195333,MATH 103A,B03,093562,Greenfeld; Be'Eri,3,0,36,33
1657852201363,MATH 105,A01,085443,Carter; Anne Toulson,15,0,35,20
1657852201363,MATH 105,A02,093477,Carter; Anne Toulson,20,0,35,15
1657852207386,MATH 109,A01,083213,Ganzberger; Geoffrey Michael,3,0,34,31
1657852207386,MATH 109,A02,083214,Ganzberger; Geoffrey Michael,4,0,34,30
1657852207386,MATH 109,A03,093478,Ganzberger; Geoffrey Michael,2,0,34,32
1657852207386,MATH 109,B01,083215,Ganzberger; Geoffrey Michael,1,0,32,31
1657852207386,MATH 109,B02,083216,Ganzberger; Geoffrey Michael,2,0,32,30
1657852207386,MATH 109,B03,093479,Ganzberger; Geoffrey Michael,8,0,32,24
1657852213498,MATH 142A,A01,083219,Chow; Bennett,7,0,32,25
1657852213498,MATH 142A,A02,083220,Chow; Bennett,10,0,32,22
1657852213498,MATH 142A,A03,093480,Chow; Bennett,9,0,32,23
1657852213498,MATH 142A,B03,093481,Chow; Bennett,8,0,32,24
1657852213498,MATH 142A,B04,093558,Chow; Bennett,13,0,32,19
1657852213498,MATH 142A,B05,093559,Chow; Bennett,7,0,32,25
1657852219525,MATH 193A,A01,083224,Rotar; Vladimir,8,0,34,26
1657852219525,MATH 193A,A02,083225,Rotar; Vladimir,10,0,34,24
1657852219525,MATH 193A,A03,083781,Rotar; Vladimir,5,0,34,29
1657852219525,MATH 193A,A04,083782,Rotar; Vladimir,11,0,34,23
1657852219525,MATH 193A,A05,093482,Rotar; Vladimir,10,0,34,24
1657852225551,MATH 197,001,091859,McAuley; Julian John,9999,0,9999,0
1657852225551,MATH 197,002,095566,Kedlaya; Kiran S.,9997,0,9999,2
1657852225551,MATH 197,003,095567,Xiao; Ming,9999,0,9999,0
1657852225551,MATH 197,004,095571,Perols; Johan Lars,9998,0,9999,1
1657852232616,COGS 9,A01,083615,Shannon; Kyle Michael,10,0,75,65
1657852238643,COGS 11,A01,083617,Boyle; Mary E. T.,23,0,48,25
1657852244666,COGS 13,A01,083071,Bastos; Amalia Pinkusfeld,11,0,71,60
1657852250703,COGS 14A,A01,092681,Semenuks; Arturs,5,1,100,95
1657852256726,COGS 14B,A01,083073,Cheng; Tzu-Han,6,0,63,57
1657852262749,COGS 17,A01,092677,Semenuks; Arturs,6,0,81,75
1657852268776,COGS 100,A01,083619,Allen; Michael Gordon,17,0,70,53
1657852274799,COGS 101A,A01,083621,Davis; Joshua Daniel,9,0,68,59
1657852280822,COGS 101B,A01,091572,Allen; Michael Gordon,12,0,65,53
1657852286848,COGS 101C,A01,083625,Delgado; Tania,17,0,35,18
1657852292870,COGS 107A,A01,083627,Boyle; Mary E. T.,14,0,60,46
1657852298898,COGS 118A,A01,083075,Gupta; Anjum,21,0,76,55
1657852304924,CSE 3,A50,083646,Miranda; Gregory Joseph,24,0,50,26
1657852310955,CSE 8A,A50,083650,Miranda; Gregory Joseph,17,1,56,39
1657852316978,CSE 11,A01,083080,Cao; Yingjun,6,15,40,34
1657852323006,CSE 12,A01,083652,Krause-Levy; Sophia Louisa,29,1,120,91
1657852329027,CSE 15L,A01,083654,Morris; Justin Loren,9,0,50,41
1657852329027,CSE 15L,A02,083655,Morris; Justin Loren,9,0,50,41
1657852335049,CSE 20,A01,083657,Tran; Khoa Dang,39,0,80,41
1657852341083,CSE 21,A01,095574,Bach; Quang Tran,22,0,48,26
1657852347108,CSE 30,A01,083084,Eldon; John,6,0,80,74
1657852347108,CSE 30,B01,095061,Bhaskar; Nishant,9,0,50,41
1657852353133,CSE 100,A01,083659,Cao; Yingjun,5,4,70,65
1657852359177,CSE 134B,A01,083661,Powell; Thomas Allan,24,0,100,76
1657852365201,CSE 140,A01,083663,Gungor; Onat,15,0,85,70
1657852371223,CSE 140L,A01,083088,Eldon; John,23,0,100,77
1657852377249,CSE 175,A01,083665,Kumar; Rakesh,3,0,25,22
1657852383273,CSE 190,A00,092507,Dubnov; Shlomo,8,0,20,12
1657852389298,ECE 45,A01,083139,Congero; Spencer William,6,0,75,69
1657852395323,ECE 65,A50,083695,Saad; Andrew S,12,0,30,18
1657852395323,ECE 65,A51,095125,Saad; Andrew S,24,0,26,2
1657852401345,ECE 109,A01,091882,Touri; Behrouz,20,0,70,50
1657852407366,ECE 180,A00,083140,Abi Samra; Nicholas Camill,1,0,30,29
1657852407366,ECE 180,B00,083141,Abi Samra; Nicholas Camill,0,0,30,30
1657852413391,MATH 10A,A01,083735,Patchell; Gregory David,2,0,30,28
1657852413391,MATH 10A,A02,083736,Patchell; Gregory David,20,0,30,10
1657852413391,MATH 10A,A03,083737,Patchell; Gregory David,16,0,30,14
1657852419417,MATH 10B,A01,083207,Lim; Seonhee,8,0,34,26
1657852419417,MATH 10B,A02,083208,Lim; Seonhee,10,0,35,25
1657852419417,MATH 10B,A03,093472,Lim; Seonhee,7,0,34,27
1657852419417,MATH 10B,B01,083739,Sinha; Shubham,14,0,30,16
1657852425450,MATH 18,A01,083743,Cinel; Cameron Alexander,9,0,30,21
1657852425450,MATH 18,A02,083744,Cinel; Cameron Alexander,18,0,30,12
1657852425450,MATH 18,A03,083745,Cinel; Cameron Alexander,10,0,30,20
1657852425450,MATH 18,B01,083748,Rideout; David Porter,5,0,37,32
1657852425450,MATH 18,B02,083749,Rideout; David Porter,5,0,36,31
1657852425450,MATH 18,B03,083750,Rideout; David Porter,3,0,37,34
1657852425450,MATH 18,B04,083751,Rideout; David Porter,6,0,36,30
1657852425450,MATH 18,B05,093473,Rideout; David Porter,6,0,36,30
1657852425450,MATH 18,B06,093474,Rideout; David Porter,6,0,36,30
1657852431475,MATH 20A,A01,083754,Zheng; Zequn,14,0,40,26
1657852437498,MATH 20B,A01,083756,Briones; Jor-el Thomas Caparas,4,0,36,32
1657852437498,MATH 20B,A02,083757,Briones; Jor-el Thomas Caparas,1,0,36,35
1657852437498,MATH 20B,A03,093475,Briones; Jor-el Thomas Caparas,2,0,36,34
1657852443521,MATH 20C,A01,083760,Briones; Jor-el Thomas Caparas,1,0,35,34
1657852443521,MATH 20C,A02,083761,Briones; Jor-el Thomas Caparas,8,0,35,27
1657852443521,MATH 20C,A03,093476,Briones; Jor-el Thomas Caparas,0,1,36,36
1657852443521,MATH 20C,B01,083762,Bach; Quang Tran,1,0,30,29
1657852449548,MATH 20D,A01,083765,Tran; Brian Kha,5,0,30,25
1657852449548,MATH 20D,A02,083766,Tran; Brian Kha,5,0,30,25
1657852449548,MATH 20D,A03,083767,Tran; Brian Kha,5,0,30,25
1657852455586,MATH 20E,A01,083771,Ganguly; Soumya,10,0,32,22
1657852455586,MATH 20E,A02,083772,Ganguly; Soumya,6,0,32,26
1657852455586,MATH 20E,B01,083773,Ciotti; Benjamin,20,0,35,15
1657852455586,MATH 20E,B02,083774,Ciotti; Benjamin,18,0,35,17
1657852461611,MATH 103A,A01,083777,Greenfeld; Be'Eri,3,0,36,33
1657852461611,MATH 103A,A02,083778,Greenfeld; Be'Eri,5,0,36,31
1657852461611,MATH 103A,A03,093561,Greenfeld; Be'Eri,6,0,36,30
1657852461611,MATH 103A,B01,083779,Greenfeld; Be'Eri,7,0,36,29
1657852461611,MATH 103A,B02,083780,Greenfeld; Be'Eri,4,0,36,32
1657852461611,MATH 103A,B03,093562,Greenfeld; Be'Eri,3,0,36,33
1657852467634,MATH 105,A01,085443,Carter; Anne Toulson,15,0,35,20
1657852467634,MATH 105,A02,093477,Carter; Anne Toulson,20,0,35,15
1657852473666,MATH 109,A01,083213,Ganzberger; Geoffrey Michael,3,0,34,31
1657852473666,MATH 109,A02,083214,Ganzberger; Geoffrey Michael,4,0,34,30
1657852473666,MATH 109,A03,093478,Ganzberger; Geoffrey Michael,2,0,34,32
1657852473666,MATH 109,B01,083215,Ganzberger; Geoffrey Michael,1,0,32,31
1657852473666,MATH 109,B02,083216,Ganzberger; Geoffrey Michael,2,0,32,30
1657852473666,MATH 109,B03,093479,Ganzberger; Geoffrey Michael,8,0,32,24
1657852479695,MATH 142A,A01,083219,Chow; Bennett,7,0,32,25
1657852479695,MATH 142A,A02,083220,Chow; Bennett,10,0,32,22
1657852479695,MATH 142A,A03,093480,Chow; Bennett,9,0,32,23
1657852479695,MATH 142A,B03,093481,Chow; Bennett,8,0,32,24
1657852479695,MATH 142A,B04,093558,Chow; Bennett,13,0,32,19
1657852479695,MATH 142A,B05,093559,Chow; Bennett,7,0,32,25
1657852485716,MATH 193A,A01,083224,Rotar; Vladimir,8,0,34,26
1657852485716,MATH 193A,A02,083225,Rotar; Vladimir,10,0,34,24
1657852485716,MATH 193A,A03,083781,Rotar; Vladimir,5,0,34,29
1657852485716,MATH 193A,A04,083782,Rotar; Vladimir,11,0,34,23
1657852485716,MATH 193A,A05,093482,Rotar; Vladimir,10,0,34,24
1657852491738,MATH 197,001,091859,McAuley; Julian John,9999,0,9999,0
1657852491738,MATH 197,002,095566,Kedlaya; Kiran S.,9997,0,9999,2
1657852491738,MATH 197,003,095567,Xiao; Ming,9999,0,9999,0
1657852491738,MATH 197,004,095571,Perols; Johan Lars,9998,0,9999,1
1657852498791,COGS 9,A01,083615,Shannon; Kyle Michael,10,0,75,65
1657852504815,COGS 11,A01,083617,Boyle; Mary E. T.,23,0,48,25
1657852510836,COGS 13,A01,083071,Bastos; Amalia Pinkusfeld,11,0,71,60
1657852516862,COGS 14A,A01,092681,Semenuks; Arturs,5,1,100,95
1657852522894,COGS 14B,A01,083073,Cheng; Tzu-Han,6,0,63,57
1657852528916,COGS 17,A01,092677,Semenuks; Arturs,6,0,81,75
1657852534938,COGS 100,A01,083619,Allen; Michael Gordon,17,0,70,53
1657852540962,COGS 101A,A01,083621,Davis; Joshua Daniel,9,0,68,59
1657852546989,COGS 101B,A01,091572,Allen; Michael Gordon,12,0,65,53
1657852553013,COGS 101C,A01,083625,Delgado; Tania,17,0,35,18
1657852559051,COGS 107A,A01,083627,Boyle; Mary E. T.,14,0,60,46
1657852565074,COGS 118A,A01,083075,Gupta; Anjum,21,0,76,55
1657852571101,CSE 3,A50,083646,Miranda; Gregory Joseph,24,0,50,26
1657852577123,CSE 8A,A50,083650,Miranda; Gregory Joseph,17,1,56,39
1657852583148,CSE 11,A01,083080,Cao; Yingjun,6,15,40,34
1657852589174,CSE 12,A01,083652,Krause-Levy; Sophia Louisa,29,1,120,91
1657852595200,CSE 15L,A01,083654,Morris; Justin Loren,9,0,50,41
1657852595200,CSE 15L,A02,083655,Morris; Justin Loren,9,0,50,41
1657852601230,CSE 20,A01,083657,Tran; Khoa Dang,39,0,80,41
1657852607270,CSE 21,A01,095574,Bach; Quang Tran,22,0,48,26
1657852613298,CSE 30,A01,083084,Eldon; John,6,0,80,74
1657852613298,CSE 30,B01,095061,Bhaskar; Nishant,9,0,50,41
1657852619325,CSE 100,A01,083659,Cao; Yingjun,5,4,70,65
1657852625351,CSE 134B,A01,083661,Powell; Thomas Allan,24,0,100,76
1657852631376,CSE 140,A01,083663,Gungor; Onat,15,0,85,70
1657852637400,CSE 140L,A01,083088,Eldon; John,23,0,100,77
1657852643424,CSE 175,A01,083665,Kumar; Rakesh,3,0,25,22
1657852649454,CSE 190,A00,092507,Dubnov; Shlomo,8,0,20,12
1657852655486,ECE 45,A01,083139,Congero; Spencer William,6,0,75,69
1657852661513,ECE 65,A50,083695,Saad; Andrew S,12,0,30,18
1657852661513,ECE 65,A51,095125,Saad; Andrew S,24,0,26,2
1657852667536,ECE 109,A01,091882,Touri; Behrouz,20,0,70,50
1657852673561,ECE 180,A00,083140,Abi Samra; Nicholas Camill,1,0,30,29
1657852673561,ECE 180,B00,083141,Abi Samra; Nicholas Camill,0,0,30,30
1657852679585,MATH 10A,A01,083735,Patchell; Gregory David,2,0,30,28
1657852679585,MATH 10A,A02,083736,Patchell; Gregory David,20,0,30,10
1657852679585,MATH 10A,A03,083737,Patchell; Gregory David,16,0,30,14
1657852685613,MATH 10B,A01,083207,Lim; Seonhee,8,0,34,26
1657852685613,MATH 10B,A02,083208,Lim; Seonhee,10,0,35,25
1657852685613,MATH 10B,A03,093472,Lim; Seonhee,7,0,34,27
1657852685613,MATH 10B,B01,083739,Sinha; Shubham,14,0,30,16
1657852691637,MATH 18,A01,083743,Cinel; Cameron Alexander,9,0,30,21
1657852691637,MATH 18,A02,083744,Cinel; Cameron Alexander,18,0,30,12
1657852691637,MATH 18,A03,083745,Cinel; Cameron Alexander,10,0,30,20
1657852691637,MATH 18,B01,083748,Rideout; David Porter,5,0,37,32
1657852691637,MATH 18,B02,083749,Rideout; David Porter,5,0,36,31
1657852691637,MATH 18,B03,083750,Rideout; David Porter,3,0,37,34
1657852691637,MATH 18,B04,083751,Rideout; David Porter,6,0,36,30
1657852691637,MATH 18,B05,093473,Rideout; David Porter,6,0,36,30
1657852691637,MATH 18,B06,093474,Rideout; David Porter,6,0,36,30
1657852697661,MATH 20A,A01,083754,Zheng; Zequn,14,0,40,26
1657852703688,MATH 20B,A01,083756,Briones; Jor-el Thomas Caparas,4,0,36,32
1657852703688,MATH 20B,A02,083757,Briones; Jor-el Thomas Caparas,1,0,36,35
1657852703688,MATH 20B,A03,093475,Briones; Jor-el Thomas Caparas,2,0,36,34
1657852709711,MATH 20C,A01,083760,Briones; Jor-el Thomas Caparas,1,0,35,34
1657852709711,MATH 20C,A02,083761,Briones; Jor-el Thomas Caparas,8,0,35,27
1657852709711,MATH 20C,A03,093476,Briones; Jor-el Thomas Caparas,0,1,36,36
1657852709711,MATH 20C,B01,083762,Bach; Quang Tran,1,0,30,29
1657852715733,MATH 20D,A01,083765,Tran; Brian Kha,5,0,30,25
1657852715733,MATH 20D,A02,083766,Tran; Brian Kha,5,0,30,25
1657852715733,MATH 20D,A03,083767,Tran; Brian Kha,5,0,30,25
1657852721755,MATH 20E,A01,083771,Ganguly; Soumya,10,0,32,22
1657852721755,MATH 20E,A02,083772,Ganguly; Soumya,6,0,32,26
1657852721755,MATH 20E,B01,083773,Ciotti; Benjamin,20,0,35,15
1657852721755,MATH 20E,B02,083774,Ciotti; Benjamin,18,0,35,17
1657852727779,MATH 103A,A01,083777,Greenfeld; Be'Eri,3,0,36,33
1657852727779,MATH 103A,A02,083778,Greenfeld; Be'Eri,5,0,36,31
1657852727779,MATH 103A,A03,093561,Greenfeld; Be'Eri,6,0,36,30
1657852727779,MATH 103A,B01,083779,Greenfeld; Be'Eri,7,0,36,29
1657852727779,MATH 103A,B02,083780,Greenfeld; Be'Eri,4,0,36,32
1657852727779,MATH 103A,B03,093562,Greenfeld; Be'Eri,3,0,36,33
1657852733812,MATH 105,A01,085443,Carter; Anne Toulson,15,0,35,20
1657852733812,MATH 105,A02,093477,Carter; Anne Toulson,20,0,35,15
1657852739836,MATH 109,A01,083213,Ganzberger; Geoffrey Michael,3,0,34,31
1657852739836,MATH 109,A02,083214,Ganzberger; Geoffrey Michael,4,0,34,30
1657852739836,MATH 109,A03,093478,Ganzberger; Geoffrey Michael,2,0,34,32
1657852739836,MATH 109,B01,083215,Ganzberger; Geoffrey Michael,1,0,32,31
1657852739836,MATH 109,B02,083216,Ganzberger; Geoffrey Michael,2,0,32,30
1657852739836,MATH 109,B03,093479,Ganzberger; Geoffrey Michael,8,0,32,24
1657852745865,MATH 142A,A01,083219,Chow; Bennett,7,0,32,25
1657852745865,MATH 142A,A02,083220,Chow; Bennett,10,0,32,22
1657852745865,MATH 142A,A03,093480,Chow; Bennett,9,0,32,23
1657852745865,MATH 142A,B03,093481,Chow; Bennett,8,0,32,24
1657852745865,MATH 142A,B04,093558,Chow; Bennett,13,0,32,19
1657852745865,MATH 142A,B05,093559,Chow; Bennett,7,0,32,25
1657852751889,MATH 193A,A01,083224,Rotar; Vladimir,8,0,34,26
1657852751889,MATH 193A,A02,083225,Rotar; Vladimir,10,0,34,24
1657852751889,MATH 193A,A03,083781,Rotar; Vladimir,5,0,34,29
1657852751889,MATH 193A,A04,083782,Rotar; Vladimir,11,0,34,23
1657852751889,MATH 193A,A05,093482,Rotar; Vladimir,10,0,34,24
1657852757912,MATH 197,001,091859,McAuley; Julian John,9999,0,9999,0
1657852757912,MATH 197,002,095566,Kedlaya; Kiran S.,9997,0,9999,2
1657852757912,MATH 197,003,095567,Xiao; Ming,9999,0,9999,0
1657852757912,MATH 197,004,095571,Perols; Johan Lars,9998,0,9999,1
1657852764961,COGS 9,A01,083615,Shannon; Kyle Michael,10,0,75,65
1657852770988,COGS 11,A01,083617,Boyle; Mary E. T.,23,0,48,25
1657852777010,COGS 13,A01,083071,Bastos; Amalia Pinkusfeld,11,0,71,60
1657852783034,COGS 14A,A01,092681,Semenuks; Arturs,5,1,100,95
1657852789062,COGS 14B,A01,083073,Cheng; Tzu-Han,6,0,63,57
1657852795086,COGS 17,A01,092677,Semenuks; Arturs,6,0,81,75
1657852801115,COGS 100,A01,083619,Allen; Michael Gordon,17,0,70,53
1657852807234,COGS 101A,A01,083621,Davis; Joshua Daniel,9,0,68,59
1657852813259,COGS 101B,A01,091572,Allen; Michael Gordon,12,0,65,53
1657852819285,COGS 101C,A01,083625,Delgado; Tania,17,0,35,18
1657852825308,COGS 107A,A01,083627,Boyle; Mary E. T.,14,0,60,46
1657852831331,COGS 118A,A01,083075,Gupta; Anjum,21,0,76,55
1657852837359,CSE 3,A50,083646,Miranda; Gregory Joseph,24,0,50,26
1657852843385,CSE 8A,A50,083650,Miranda; Gregory Joseph,17,1,56,39
1657852849408,CSE 11,A01,083080,Cao; Yingjun,6,15,40,34
1657852855433,CSE 12,A01,083652,Krause-Levy; Sophia Louisa,29,1,120,91
1657852861461,CSE 15L,A01,083654,Morris; Justin Loren,9,0,50,41
1657852861461,CSE 15L,A02,083655,Morris; Justin Loren,9,0,50,41
1657852867483,CSE 20,A01,083657,Tran; Khoa Dang,39,0,80,41
1657852873511,CSE 21,A01,095574,Bach; Quang Tran,22,0,48,26
1657852879534,CSE 30,A01,083084,Eldon; John,6,0,80,74
1657852879534,CSE 30,B01,095061,Bhaskar; Nishant,9,0,50,41
1657852885560,CSE 100,A01,083659,Cao; Yingjun,5,4,70,65
1657852891589,CSE 134B,A01,083661,Powell; Thomas Allan,24,0,100,76
1657852897614,CSE 140,A01,083663,Gungor; Onat,15,0,85,70
1657852903638,CSE 140L,A01,083088,Eldon; John,23,0,100,77
1657852909661,CSE 175,A01,083665,Kumar; Rakesh,3,0,25,22
1657852915690,CSE 190,A00,092507,Dubnov; Shlomo,8,0,20,12
1657852921716,ECE 45,A01,083139,Congero; Spencer William,6,0,75,69
1657852927745,ECE 65,A50,083695,Saad; Andrew S,12,0,30,18
1657852927745,ECE 65,A51,095125,Saad; Andrew S,24,0,26,2
1657852933767,ECE 109,A01,091882,Touri; Behrouz,20,0,70,50
1657852939794,ECE 180,A00,083140,Abi Samra; Nicholas Camill,1,0,30,29
1657852939794,ECE 180,B00,083141,Abi Samra; Nicholas Camill,0,0,30,30
1657852945820,MATH 10A,A01,083735,Patchell; Gregory David,2,0,30,28
1657852945820,MATH 10A,A02,083736,Patchell; Gregory David,20,0,30,10
1657852945820,MATH 10A,A03,083737,Patchell; Gregory David,16,0,30,14
1657852951847,MATH 10B,A01,083207,Lim; Seonhee,8,0,34,26
1657852951847,MATH 10B,A02,083208,Lim; Seonhee,10,0,35,25
1657852951847,MATH 10B,A03,093472,Lim; Seonhee,7,0,34,27
1657852951847,MATH 10B,B01,083739,Sinha; Shubham,14,0,30,16
1657852957870,MATH 18,A01,083743,Cinel; Cameron Alexander,9,0,30,21
1657852957870,MATH 18,A02,083744,Cinel; Cameron Alexander,18,0,30,12
1657852957870,MATH 18,A03,083745,Cinel; Cameron Alexander,10,0,30,20
1657852957870,MATH 18,B01,083748,Rideout; David Porter,5,0,37,32
1657852957870,MATH 18,B02,083749,Rideout; David Porter,5,0,36,31
1657852957870,MATH 18,B03,083750,Rideout; David Porter,3,0,37,34
1657852957870,MATH 18,B04,083751,Rideout; David Porter,6,0,36,30
1657852957870,MATH 18,B05,093473,Rideout; David Porter,6,0,36,30
1657852957870,MATH 18,B06,093474,Rideout; David Porter,6,0,36,30
1657852963892,MATH 20A,A01,083754,Zheng; Zequn,14,0,40,26
1657852969916,MATH 20B,A01,083756,Briones; Jor-el Thomas Caparas,4,0,36,32
1657852969916,MATH 20B,A02,083757,Briones; Jor-el Thomas Caparas,1,0,36,35
1657852969916,MATH 20B,A03,093475,Briones; Jor-el Thomas Caparas,2,0,36,34
1657852975938,MATH 20C,A01,083760,Briones; Jor-el Thomas Caparas,1,0,35,34
1657852975938,MATH 20C,A02,083761,Briones; Jor-el Thomas Caparas,8,0,35,27
1657852975938,MATH 20C,A03,093476,Briones; Jor-el Thomas Caparas,0,1,36,36
1657852975938,MATH 20C,B01,083762,Bach; Quang Tran,1,0,30,29
1657852981960,MATH 20D,A01,083765,Tran; Brian Kha,5,0,30,25
1657852981960,MATH 20D,A02,083766,Tran; Brian Kha,5,0,30,25
1657852981960,MATH 20D,A03,083767,Tran; Brian Kha,5,0,30,25
1657852987983,MATH 20E,A01,083771,Ganguly; Soumya,10,0,32,22
1657852987983,MATH 20E,A02,083772,Ganguly; Soumya,6,0,32,26
1657852987983,MATH 20E,B01,083773,Ciotti; Benjamin,20,0,35,15
1657852987983,MATH 20E,B02,083774,Ciotti; Benjamin,18,0,35,17
1657852994005,MATH 103A,A01,083777,Greenfeld; Be'Eri,3,0,36,33
1657852994005,MATH 103A,A02,083778,Greenfeld; Be'Eri,5,0,36,31
1657852994005,MATH 103A,A03,093561,Greenfeld; Be'Eri,6,0,36,30
1657852994005,MATH 103A,B01,083779,Greenfeld; Be'Eri,7,0,36,29
1657852994005,MATH 103A,B02,083780,Greenfeld; Be'Eri,4,0,36,32
1657852994005,MATH 103A,B03,093562,Greenfeld; Be'Eri,3,0,36,33
1657853000041,MATH 105,A01,085443,Carter; Anne Toulson,15,0,35,20
1657853000041,MATH 105,A02,093477,Carter; Anne Toulson,20,0,35,15
1657853006073,MATH 109,A01,083213,Ganzberger; Geoffrey Michael,3,0,34,31
1657853006073,MATH 109,A02,083214,Ganzberger; Geoffrey Michael,4,0,34,30
1657853006073,MATH 109,A03,093478,Ganzberger; Geoffrey Michael,2,0,34,32
1657853006073,MATH 109,B01,083215,Ganzberger; Geoffrey Michael,1,0,32,31
1657853006073,MATH 109,B02,083216,Ganzberger; Geoffrey Michael,2,0,32,30
1657853006073,MATH 109,B03,093479,Ganzberger; Geoffrey Michael,8,0,32,24
1657853012101,MATH 142A,A01,083219,Chow; Bennett,7,0,32,25
1657853012101,MATH 142A,A02,083220,Chow; Bennett,10,0,32,22
1657853012101,MATH 142A,A03,093480,Chow; Bennett,9,0,32,23
1657853012101,MATH 142A,B03,093481,Chow; Bennett,8,0,32,24
1657853012101,MATH 142A,B04,093558,Chow; Bennett,13,0,32,19
1657853012101,MATH 142A,B05,093559,Chow; Bennett,7,0,32,25
1657853018130,MATH 193A,A01,083224,Rotar; Vladimir,8,0,34,26
1657853018130,MATH 193A,A02,083225,Rotar; Vladimir,10,0,34,24
1657853018130,MATH 193A,A03,083781,Rotar; Vladimir,5,0,34,29
1657853018130,MATH 193A,A04,083782,Rotar; Vladimir,11,0,34,23
1657853018130,MATH 193A,A05,093482,Rotar; Vladimir,10,0,34,24
1657853024160,MATH 197,001,091859,McAuley; Julian John,9999,0,9999,0
1657853024160,MATH 197,002,095566,Kedlaya; Kiran S.,9997,0,9999,2
1657853024160,MATH 197,003,095567,Xiao; Ming,9999,0,9999,0
1657853024160,MATH 197,004,095571,Perols; Johan Lars,9998,0,9999,1
1657853031215,COGS 9,A01,083615,Shannon; Kyle Michael,10,0,75,65
1657853037242,COGS 11,A01,083617,Boyle; Mary E. T.,23,0,48,25
1657853043269,COGS 13,A01,083071,Bastos; Amalia Pinkusfeld,11,0,71,60
1657853049292,COGS 14A,A01,092681,Semenuks; Arturs,5,1,100,95
1657853055320,COGS 14B,A01,083073,Cheng; Tzu-Han,6,0,63,57
1657853061344,COGS 17,A01,092677,Semenuks; Arturs,6,0,81,75
1657853067369,COGS 100,A01,083619,Allen; Michael Gordon,17,0,70,53
1657853073394,COGS 101A,A01,083621,Davis; Joshua Daniel,9,0,68,59
1657853079417,COGS 101B,A01,091572,Allen; Michael Gordon,12,0,65,53
1657853085442,COGS 101C,A01,083625,Delgado; Tania,17,0,35,18
1657853091466,COGS 107A,A01,083627,Boyle; Mary E. T.,14,0,60,46
1657853097489,COGS 118A,A01,083075,Gupta; Anjum,21,0,76,55
1657853103516,CSE 3,A50,083646,Miranda; Gregory Joseph,24,0,50,26
1657853109542,CSE 8A,A50,083650,Miranda; Gregory Joseph,17,1,56,39
1657853115571,CSE 11,A01,083080,Cao; Yingjun,6,15,40,34
1657853121594,CSE 12,A01,083652,Krause-Levy; Sophia Louisa,29,1,120,91
1657853127621,CSE 15L,A01,083654,Morris; Justin Loren,9,0,50,41
1657853127621,CSE 15L,A02,083655,Morris; Justin Loren,9,0,50,41
1657853133646,CSE 20,A01,083657,Tran; Khoa Dang,39,0,80,41
1657853139674,CSE 21,A01,095574,Bach; Quang Tran,22,0,48,26
1657853145697,CSE 30,A01,083084,Eldon; John,6,0,80,74
1657853145697,CSE 30,B01,095061,Bhaskar; Nishant,9,0,50,41
1657853151724,CSE 100,A01,083659,Cao; Yingjun,5,4,70,65
1657853157748,CSE 134B,A01,083661,Powell; Thomas Allan,24,0,100,76
1657853163782,CSE 140,A01,083663,Gungor; Onat,15,0,85,70
1657853169817,CSE 140L,A01,083088,Eldon; John,23,0,100,77
1657853175838,CSE 175,A01,083665,Kumar; Rakesh,3,0,25,22
1657853181861,CSE 190,A00,092507,Dubnov; Shlomo,8,0,20,12
1657853187887,ECE 45,A01,083139,Congero; Spencer William,6,0,75,69
1657853193913,ECE 65,A50,083695,Saad; Andrew S,12,0,30,18
1657853193913,ECE 65,A51,095125,Saad; Andrew S,24,0,26,2
1657853199947,ECE 109,A01,091882,Touri; Behrouz,20,0,70,50
1657853205974,ECE 180,A00,083140,Abi Samra; Nicholas Camill,1,0,30,29
1657853205974,ECE 180,B00,083141,Abi Samra; Nicholas Camill,0,0,30,30
1657853212001,MATH 10A,A01,083735,Patchell; Gregory David,2,0,30,28
1657853212001,MATH 10A,A02,083736,Patchell; Gregory David,20,0,30,10
1657853212001,MATH 10A,A03,083737,Patchell; Gregory David,16,0,30,14
1657853218024,MATH 10B,A01,083207,Lim; Seonhee,8,0,34,26
1657853218024,MATH 10B,A02,083208,Lim; Seonhee,10,0,35,25
1657853218024,MATH 10B,A03,093472,Lim; Seonhee,7,0,34,27
1657853218024,MATH 10B,B01,083739,Sinha; Shubham,14,0,30,16
1657853224054,MATH 18,A01,083743,Cinel; Cameron Alexander,9,0,30,21
1657853224054,MATH 18,A02,083744,Cinel; Cameron Alexander,18,0,30,12
1657853224054,MATH 18,A03,083745,Cinel; Cameron Alexander,10,0,30,20
1657853224054,MATH 18,B01,083748,Rideout; David Porter,5,0,37,32
1657853224054,MATH 18,B02,083749,Rideout; David Porter,5,0,36,31
1657853224054,MATH 18,B03,083750,Rideout; David Porter,3,0,37,34
1657853224054,MATH 18,B04,083751,Rideout; David Porter,6,0,36,30
1657853224054,MATH 18,B05,093473,Rideout; David Porter,6,0,36,30
1657853224054,MATH 18,B06,093474,Rideout; David Porter,6,0,36,30
1657853230082,MATH 20A,A01,083754,Zheng; Zequn,14,0,40,26
1657853236105,MATH 20B,A01,083756,Briones; Jor-el Thomas Caparas,4,0,36,32
1657853236105,MATH 20B,A02,083757,Briones; Jor-el Thomas Caparas,1,0,36,35
1657853236105,MATH 20B,A03,093475,Briones; Jor-el Thomas Caparas,2,0,36,34
1657853242134,MATH 20C,A01,083760,Briones; Jor-el Thomas Caparas,1,0,35,34
1657853242134,MATH 20C,A02,083761,Briones; Jor-el Thomas Caparas,8,0,35,27
1657853242134,MATH 20C,A03,093476,Briones; Jor-el Thomas Caparas,0,1,36,36
1657853242134,MATH 20C,B01,083762,Bach; Quang Tran,1,0,30,29
1657853248155,MATH 20D,A01,083765,Tran; Brian Kha,5,0,30,25
1657853248155,MATH 20D,A02,083766,Tran; Brian Kha,5,0,30,25
1657853248155,MATH 20D,A03,083767,Tran; Brian Kha,5,0,30,25
1657853254190,MATH 20E,A01,083771,Ganguly; Soumya,10,0,32,22
1657853254190,MATH 20E,A02,083772,Ganguly; Soumya,6,0,32,26
1657853254190,MATH 20E,B01,083773,Ciotti; Benjamin,20,0,35,15
1657853254190,MATH 20E,B02,083774,Ciotti; Benjamin,18,0,35,17
1657853260219,MATH 103A,A01,083777,Greenfeld; Be'Eri,3,0,36,33
1657853260219,MATH 103A,A02,083778,Greenfeld; Be'Eri,5,0,36,31
1657853260219,MATH 103A,A03,093561,Greenfeld; Be'Eri,6,0,36,30
1657853260219,MATH 103A,B01,083779,Greenfeld; Be'Eri,7,0,36,29
1657853260219,MATH 103A,B02,083780,Greenfeld; Be'Eri,4,0,36,32
1657853260219,MATH 103A,B03,093562,Greenfeld; Be'Eri,3,0,36,33
1657853266247,MATH 105,A01,085443,Carter; Anne Toulson,15,0,35,20
1657853266247,MATH 105,A02,093477,Carter; Anne Toulson,20,0,35,15
1657853272271,MATH 109,A01,083213,Ganzberger; Geoffrey Michael,3,0,34,31
1657853272271,MATH 109,A02,083214,Ganzberger; Geoffrey Michael,4,0,34,30
1657853272271,MATH 109,A03,093478,Ganzberger; Geoffrey Michael,2,0,34,32
1657853272271,MATH 109,B01,083215,Ganzberger; Geoffrey Michael,1,0,32,31
1657853272271,MATH 109,B02,083216,Ganzberger; Geoffrey Michael,2,0,32,30
1657853272271,MATH 109,B03,093479,Ganzberger; Geoffrey Michael,8,0,32,24
1657853278301,MATH 142A,A01,083219,Chow; Bennett,7,0,32,25
1657853278301,MATH 142A,A02,083220,Chow; Bennett,10,0,32,22
1657853278301,MATH 142A,A03,093480,Chow; Bennett,9,0,32,23
1657853278301,MATH 142A,B03,093481,Chow; Bennett,8,0,32,24
1657853278301,MATH 142A,B04,093558,Chow; Bennett,13,0,32,19
1657853278301,MATH 142A,B05,093559,Chow; Bennett,7,0,32,25
1657853284325,MATH 193A,A01,083224,Rotar; Vladimir,8,0,34,26
1657853284325,MATH 193A,A02,083225,Rotar; Vladimir,10,0,34,24
1657853284325,MATH 193A,A03,083781,Rotar; Vladimir,5,0,34,29
1657853284325,MATH 193A,A04,083782,Rotar; Vladimir,11,0,34,23
1657853284325,MATH 193A,A05,093482,Rotar; Vladimir,10,0,34,24
1657853290357,MATH 197,001,091859,McAuley; Julian John,9999,0,9999,0
1657853290357,MATH 197,002,095566,Kedlaya; Kiran S.,9997,0,9999,2
1657853290357,MATH 197,003,095567,Xiao; Ming,9999,0,9999,0
1657853290357,MATH 197,004,095571,Perols; Johan Lars,9998,0,9999,1
1657853297416,COGS 9,A01,083615,Shannon; Kyle Michael,10,0,75,65
1657853303439,COGS 11,A01,083617,Boyle; Mary E. T.,23,0,48,25
1657853309463,COGS 13,A01,083071,Bastos; Amalia Pinkusfeld,11,0,71,60
1657853315488,COGS 14A,A01,092681,Semenuks; Arturs,5,1,100,95
1657853321531,COGS 14B,A01,083073,Cheng; Tzu-Han,6,0,63,57
1657853327554,COGS 17,A01,092677,Semenuks; Arturs,6,0,81,75
1657853333576,COGS 100,A01,083619,Allen; Michael Gordon,17,0,70,53
1657853339604,COGS 101A,A01,083621,Davis; Joshua Daniel,9,0,68,59
1657853345631,COGS 101B,A01,091572,Allen; Michael Gordon,12,0,65,53
1657853351668,COGS 101C,A01,083625,Delgado; Tania,17,0,35,18
1657853357696,COGS 107A,A01,083627,Boyle; Mary E. T.,14,0,60,46
1657853363719,COGS 118A,A01,083075,Gupta; Anjum,21,0,76,55
1657853369751,CSE 3,A50,083646,Miranda; Gregory Joseph,24,0,50,26
1657853375773,CSE 8A,A50,083650,Miranda; Gregory Joseph,17,1,56,39
1657853381797,CSE 11,A01,083080,Cao; Yingjun,6,15,40,34
1657853387820,CSE 12,A01,083652,Krause-Levy; Sophia Louisa,29,1,120,91
1657853393849,CSE 15L,A01,083654,Morris; Justin Loren,9,0,50,41
1657853393849,CSE 15L,A02,083655,Morris; Justin Loren,9,0,50,41
1657853399876,CSE 20,A01,083657,Tran; Khoa Dang,39,0,80,41
1657853405987,CSE 21,A01,095574,Bach; Quang Tran,22,0,48,26
1657853412010,CSE 30,A01,083084,Eldon; John,6,0,80,74
1657853412010,CSE 30,B01,095061,Bhaskar; Nishant,9,0,50,41
1657853418038,CSE 100,A01,083659,Cao; Yingjun,5,4,70,65
1657853424061,CSE 134B,A01,083661,Powell; Thomas Allan,24,0,100,76
1657853430089,CSE 140,A01,083663,Gungor; Onat,15,0,85,70
1657853436112,CSE 140L,A01,083088,Eldon; John,23,0,100,77
1657853442138,CSE 175,A01,083665,Kumar; Rakesh,3,0,25,22
1657853448167,CSE 190,A00,092507,Dubnov; Shlomo,8,0,20,12
1657853454190,ECE 45,A01,083139,Congero; Spencer William,6,0,75,69
1657853460214,ECE 65,A50,083695,Saad; Andrew S,12,0,30,18
1657853460214,ECE 65,A51,095125,Saad; Andrew S,24,0,26,2
1657853466235,ECE 109,A01,091882,Touri; Behrouz,20,0,70,50
1657853472262,ECE 180,A00,083140,Abi Samra; Nicholas Camill,1,0,30,29
1657853472262,ECE 180,B00,083141,Abi Samra; Nicholas Camill,0,0,30,30
1657853478285,MATH 10A,A01,083735,Patchell; Gregory David,2,0,30,28
1657853478285,MATH 10A,A02,083736,Patchell; Gregory David,20,0,30,10
1657853478285,MATH 10A,A03,083737,Patchell; Gregory David,16,0,30,14
1657853484309,MATH 10B,A01,083207,Lim; Seonhee,8,0,34,26
1657853484309,MATH 10B,A02,083208,Lim; Seonhee,10,0,35,25
1657853484309,MATH 10B,A03,093472,Lim; Seonhee,7,0,34,27
1657853484309,MATH 10B,B01,083739,Sinha; Shubham,14,0,30,16
1657853490335,MATH 18,A01,083743,Cinel; Cameron Alexander,9,0,30,21
1657853490335,MATH 18,A02,083744,Cinel; Cameron Alexander,18,0,30,12
1657853490335,MATH 18,A03,083745,Cinel; Cameron Alexander,10,0,30,20
1657853490335,MATH 18,B01,083748,Rideout; David Porter,5,0,37,32
1657853490335,MATH 18,B02,083749,Rideout; David Porter,5,0,36,31
1657853490335,MATH 18,B03,083750,Rideout; David Porter,3,0,37,34
1657853490335,MATH 18,B04,083751,Rideout; David Porter,6,0,36,30
1657853490335,MATH 18,B05,093473,Rideout; David Porter,6,0,36,30
1657853490335,MATH 18,B06,093474,Rideout; David Porter,6,0,36,30
1657853496357,MATH 20A,A01,083754,Zheng; Zequn,14,0,40,26
1657853502386,MATH 20B,A01,083756,Briones; Jor-el Thomas Caparas,4,0,36,32
1657853502386,MATH 20B,A02,083757,Briones; Jor-el Thomas Caparas,1,0,36,35
1657853502386,MATH 20B,A03,093475,Briones; Jor-el Thomas Caparas,2,0,36,34
1657853508414,MATH 20C,A01,083760,Briones; Jor-el Thomas Caparas,1,0,35,34
1657853508414,MATH 20C,A02,083761,Briones; Jor-el Thomas Caparas,8,0,35,27
1657853508414,MATH 20C,A03,093476,Briones; Jor-el Thomas Caparas,0,1,36,36
1657853508414,MATH 20C,B01,083762,Bach; Quang Tran,1,0,30,29
1657853514443,MATH 20D,A01,083765,Tran; Brian Kha,5,0,30,25
1657853514443,MATH 20D,A02,083766,Tran; Brian Kha,5,0,30,25
1657853514443,MATH 20D,A03,083767,Tran; Brian Kha,5,0,30,25
1657853520482,MATH 20E,A01,083771,Ganguly; Soumya,10,0,32,22
1657853520482,MATH 20E,A02,083772,Ganguly; Soumya,6,0,32,26
1657853520482,MATH 20E,B01,083773,Ciotti; Benjamin,20,0,35,15
1657853520482,MATH 20E,B02,083774,Ciotti; Benjamin,18,0,35,17
1657853526506,MATH 103A,A01,083777,Greenfeld; Be'Eri,3,0,36,33
1657853526506,MATH 103A,A02,083778,Greenfeld; Be'Eri,5,0,36,31
1657853526506,MATH 103A,A03,093561,Greenfeld; Be'Eri,6,0,36,30
1657853526506,MATH 103A,B01,083779,Greenfeld; Be'Eri,7,0,36,29
1657853526506,MATH 103A,B02,083780,Greenfeld; Be'Eri,4,0,36,32
1657853526506,MATH 103A,B03,093562,Greenfeld; Be'Eri,3,0,36,33
1657853532536,MATH 105,A01,085443,Carter; Anne Toulson,15,0,35,20
1657853532536,MATH 105,A02,093477,Carter; Anne Toulson,20,0,35,15
1657853538567,MATH 109,A01,083213,Ganzberger; Geoffrey Michael,3,0,34,31
1657853538567,MATH 109,A02,083214,Ganzberger; Geoffrey Michael,4,0,34,30
1657853538567,MATH 109,A03,093478,Ganzberger; Geoffrey Michael,2,0,34,32
1657853538567,MATH 109,B01,083215,Ganzberger; Geoffrey Michael,1,0,32,31
1657853538567,MATH 109,B02,083216,Ganzberger; Geoffrey Michael,2,0,32,30
1657853538567,MATH 109,B03,093479,Ganzberger; Geoffrey Michael,8,0,32,24
1657853544591,MATH 142A,A01,083219,Chow; Bennett,7,0,32,25
1657853544591,MATH 142A,A02,083220,Chow; Bennett,10,0,32,22
1657853544591,MATH 142A,A03,093480,Chow; Bennett,9,0,32,23
1657853544591,MATH 142A,B03,093481,Chow; Bennett,8,0,32,24
1657853544591,MATH 142A,B04,093558,Chow; Bennett,13,0,32,19
1657853544591,MATH 142A,B05,093559,Chow; Bennett,7,0,32,25
1657853550618,MATH 193A,A01,083224,Rotar; Vladimir,8,0,34,26
1657853550618,MATH 193A,A02,083225,Rotar; Vladimir,10,0,34,24
1657853550618,MATH 193A,A03,083781,Rotar; Vladimir,5,0,34,29
1657853550618,MATH 193A,A04,083782,Rotar; Vladimir,11,0,34,23
1657853550618,MATH 193A,A05,093482,Rotar; Vladimir,10,0,34,24
1657853556641,MATH 197,001,091859,McAuley; Julian John,9999,0,9999,0
1657853556641,MATH 197,002,095566,Kedlaya; Kiran S.,9997,0,9999,2
1657853556641,MATH 197,003,095567,Xiao; Ming,9999,0,9999,0
1657853556641,MATH 197,004,095571,Perols; Johan Lars,9998,0,9999,1
1657853563698,COGS 9,A01,083615,Shannon; Kyle Michael,10,0,75,65
1657853569725,COGS 11,A01,083617,Boyle; Mary E. T.,23,0,48,25
1657853575752,COGS 13,A01,083071,Bastos; Amalia Pinkusfeld,11,0,71,60
1657853581780,COGS 14A,A01,092681,Semenuks; Arturs,5,1,100,95
1657853587806,COGS 14B,A01,083073,Cheng; Tzu-Han,6,0,63,57
1657853593831,COGS 17,A01,092677,Semenuks; Arturs,6,0,81,75
1657853599854,COGS 100,A01,083619,Allen; Michael Gordon,17,0,70,53
1657853605883,COGS 101A,A01,083621,Davis; Joshua Daniel,9,0,68,59
1657853611912,COGS 101B,A01,091572,Allen; Michael Gordon,12,0,65,53
1657853617938,COGS 101C,A01,083625,Delgado; Tania,17,0,35,18
1657853623965,COGS 107A,A01,083627,Boyle; Mary E. T.,14,0,60,46
1657853629988,COGS 118A,A01,083075,Gupta; Anjum,21,0,76,55
1657853636014,CSE 3,A50,083646,Miranda; Gregory Joseph,24,0,50,26
1657853642046,CSE 8A,A50,083650,Miranda; Gregory Joseph,17,1,56,39
1657853648069,CSE 11,A01,083080,Cao; Yingjun,6,15,40,34
1657853654096,CSE 12,A01,083652,Krause-Levy; Sophia Louisa,29,1,120,91
1657853660124,CSE 15L,A01,083654,Morris; Justin Loren,9,0,50,41
1657853660124,CSE 15L,A02,083655,Morris; Justin Loren,9,0,50,41
1657853666147,CSE 20,A01,083657,Tran; Khoa Dang,39,0,80,41
1657853672171,CSE 21,A01,095574,Bach; Quang Tran,22,0,48,26
1657853678195,CSE 30,A01,083084,Eldon; John,6,0,80,74
1657853678195,CSE 30,B01,095061,Bhaskar; Nishant,9,0,50,41
1657853684220,CSE 100,A01,083659,Cao; Yingjun,5,4,70,65
1657853690244,CSE 134B,A01,083661,Powell; Thomas Allan,24,0,100,76
1657853696273,CSE 140,A01,083663,Gungor; Onat,15,0,85,70
1657853702296,CSE 140L,A01,083088,Eldon; John,23,0,100,77
1657853708322,CSE 175,A01,083665,Kumar; Rakesh,3,0,25,22
1657853714349,CSE 190,A00,092507,Dubnov; Shlomo,8,0,20,12
1657853720371,ECE 45,A01,083139,Congero; Spencer William,6,0,75,69
1657853726398,ECE 65,A50,083695,Saad; Andrew S,12,0,30,18
1657853726398,ECE 65,A51,095125,Saad; Andrew S,24,0,26,2
1657853732421,ECE 109,A01,091882,Touri; Behrouz,20,0,70,50
1657853738444,ECE 180,A00,083140,Abi Samra; Nicholas Camill,1,0,30,29
1657853738444,ECE 180,B00,083141,Abi Samra; Nicholas Camill,0,0,30,30
1657853744473,MATH 10A,A01,083735,Patchell; Gregory David,2,0,30,28
1657853744473,MATH 10A,A02,083736,Patchell; Gregory David,20,0,30,10
1657853744473,MATH 10A,A03,083737,Patchell; Gregory David,16,0,30,14
1657853750496,MATH 10B,A01,083207,Lim; Seonhee,8,0,34,26
1657853750496,MATH 10B,A02,083208,Lim; Seonhee,10,0,35,25
1657853750496,MATH 10B,A03,093472,Lim; Seonhee,7,0,34,27
1657853750496,MATH 10B,B01,083739,Sinha; Shubham,14,0,30,16
1657853756520,MATH 18,A01,083743,Cinel; Cameron Alexander,9,0,30,21
1657853756520,MATH 18,A02,083744,Cinel; Cameron Alexander,18,0,30,12
1657853756520,MATH 18,A03,083745,Cinel; Cameron Alexander,10,0,30,20
1657853756520,MATH 18,B01,083748,Rideout; David Porter,5,0,37,32
1657853756520,MATH 18,B02,083749,Rideout; David Porter,5,0,36,31
1657853756520,MATH 18,B03,083750,Rideout; David Porter,3,0,37,34
1657853756520,MATH 18,B04,083751,Rideout; David Porter,6,0,36,30
1657853756520,MATH 18,B05,093473,Rideout; David Porter,6,0,36,30
1657853756520,MATH 18,B06,093474,Rideout; David Porter,6,0,36,30
1657853762543,MATH 20A,A01,083754,Zheng; Zequn,14,0,40,26
1657853768571,MATH 20B,A01,083756,Briones; Jor-el Thomas Caparas,4,0,36,32
1657853768571,MATH 20B,A02,083757,Briones; Jor-el Thomas Caparas,1,0,36,35
1657853768571,MATH 20B,A03,093475,Briones; Jor-el Thomas Caparas,2,0,36,34
1657853774595,MATH 20C,A01,083760,Briones; Jor-el Thomas Caparas,1,0,35,34
1657853774595,MATH 20C,A02,083761,Briones; Jor-el Thomas Caparas,8,0,35,27
1657853774595,MATH 20C,A03,093476,Briones; Jor-el Thomas Caparas,0,1,36,36
1657853774595,MATH 20C,B01,083762,Bach; Quang Tran,1,0,30,29
1657853780618,MATH 20D,A01,083765,Tran; Brian Kha,5,0,30,25
1657853780618,MATH 20D,A02,083766,Tran; Brian Kha,5,0,30,25
1657853780618,MATH 20D,A03,083767,Tran; Brian Kha,5,0,30,25
1657853786647,MATH 20E,A01,083771,Ganguly; Soumya,10,0,32,22
1657853786647,MATH 20E,A02,083772,Ganguly; Soumya,6,0,32,26
1657853786647,MATH 20E,B01,083773,Ciotti; Benjamin,20,0,35,15
1657853786647,MATH 20E,B02,083774,Ciotti; Benjamin,18,0,35,17
1657853792672,MATH 103A,A01,083777,Greenfeld; Be'Eri,3,0,36,33
1657853792672,MATH 103A,A02,083778,Greenfeld; Be'Eri,5,0,36,31
1657853792672,MATH 103A,A03,093561,Greenfeld; Be'Eri,6,0,36,30
1657853792672,MATH 103A,B01,083779,Greenfeld; Be'Eri,7,0,36,29
1657853792672,MATH 103A,B02,083780,Greenfeld; Be'Eri,4,0,36,32
1657853792672,MATH 103A,B03,093562,Greenfeld; Be'Eri,3,0,36,33
1657853798700,MATH 105,A01,085443,Carter; Anne Toulson,15,0,35,20
1657853798700,MATH 105,A02,093477,Carter; Anne Toulson,20,0,35,15
1657853804722,MATH 109,A01,083213,Ganzberger; Geoffrey Michael,3,0,34,31
1657853804722,MATH 109,A02,083214,Ganzberger; Geoffrey Michael,4,0,34,30
1657853804722,MATH 109,A03,093478,Ganzberger; Geoffrey Michael,2,0,34,32
1657853804722,MATH 109,B01,083215,Ganzberger; Geoffrey Michael,1,0,32,31
1657853804722,MATH 109,B02,083216,Ganzberger; Geoffrey Michael,2,0,32,30
1657853804722,MATH 109,B03,093479,Ganzberger; Geoffrey Michael,8,0,32,24
1657853810746,MATH 142A,A01,083219,Chow; Bennett,7,0,32,25
1657853810746,MATH 142A,A02,083220,Chow; Bennett,10,0,32,22
1657853810746,MATH 142A,A03,093480,Chow; Bennett,9,0,32,23
1657853810746,MATH 142A,B03,093481,Chow; Bennett,8,0,32,24
1657853810746,MATH 142A,B04,093558,Chow; Bennett,13,0,32,19
1657853810746,MATH 142A,B05,093559,Chow; Bennett,7,0,32,25
1657853816769,MATH 193A,A01,083224,Rotar; Vladimir,8,0,34,26
1657853816769,MATH 193A,A02,083225,Rotar; Vladimir,10,0,34,24
1657853816769,MATH 193A,A03,083781,Rotar; Vladimir,5,0,34,29
1657853816769,MATH 193A,A04,083782,Rotar; Vladimir,11,0,34,23
1657853816769,MATH 193A,A05,093482,Rotar; Vladimir,10,0,34,24
1657853822795,MATH 197,001,091859,McAuley; Julian John,9999,0,9999,0
1657853822795,MATH 197,002,095566,Kedlaya; Kiran S.,9997,0,9999,2
1657853822795,MATH 197,003,095567,Xiao; Ming,9999,0,9999,0
1657853822795,MATH 197,004,095571,Perols; Johan Lars,9998,0,9999,1
1657853829860,COGS 9,A01,083615,Shannon; Kyle Michael,10,0,75,65
1657853835887,COGS 11,A01,083617,Boyle; Mary E. T.,23,0,48,25
1657853841909,COGS 13,A01,083071,Bastos; Amalia Pinkusfeld,11,0,71,60
1657853847933,COGS 14A,A01,092681,Semenuks; Arturs,5,1,100,95
1657853853956,COGS 14B,A01,083073,Cheng; Tzu-Han,6,0,63,57
1657853859981,COGS 17,A01,092677,Semenuks; Arturs,6,0,81,75
1657853866009,COGS 100,A01,083619,Allen; Michael Gordon,17,0,70,53
1657853872039,COGS 101A,A01,083621,Davis; Joshua Daniel,9,0,68,59
1657853878063,COGS 101B,A01,091572,Allen; Michael Gordon,12,0,65,53
1657853884091,COGS 101C,A01,083625,Delgado; Tania,17,0,35,18
1657853890122,COGS 107A,A01,083627,Boyle; Mary E. T.,14,0,60,46
1657853896167,COGS 118A,A01,083075,Gupta; Anjum,21,0,76,55
1657853902191,CSE 3,A50,083646,Miranda; Gregory Joseph,24,0,50,26
1657853908219,CSE 8A,A50,083650,Miranda; Gregory Joseph,17,1,56,39
1657853914247,CSE 11,A01,083080,Cao; Yingjun,6,15,40,34
1657853920270,CSE 12,A01,083652,Krause-Levy; Sophia Louisa,29,1,120,91
1657853926301,CSE 15L,A01,083654,Morris; Justin Loren,9,0,50,41
1657853926301,CSE 15L,A02,083655,Morris; Justin Loren,9,0,50,41
1657853932325,CSE 20,A01,083657,Tran; Khoa Dang,39,0,80,41
1657853938356,CSE 21,A01,095574,Bach; Quang Tran,22,0,48,26
1657853944383,CSE 30,A01,083084,Eldon; John,6,0,80,74
1657853944383,CSE 30,B01,095061,Bhaskar; Nishant,9,0,50,41
1657853950409,CSE 100,A01,083659,Cao; Yingjun,5,4,70,65
1657853956432,CSE 134B,A01,083661,Powell; Thomas Allan,24,0,100,76
1657853962457,CSE 140,A01,083663,Gungor; Onat,15,0,85,70
1657853968481,CSE 140L,A01,083088,Eldon; John,23,0,100,77
1657853974507,CSE 175,A01,083665,Kumar; Rakesh,3,0,25,22
1657853980530,CSE 190,A00,092507,Dubnov; Shlomo,8,0,20,12
1657853986553,ECE 45,A01,083139,Congero; Spencer William,6,0,75,69
1657853992581,ECE 65,A50,083695,Saad; Andrew S,12,0,30,18
1657853992581,ECE 65,A51,095125,Saad; Andrew S,24,0,26,2
1657853998608,ECE 109,A01,091882,Touri; Behrouz,20,0,70,50
1657854004707,ECE 180,A00,083140,Abi Samra; Nicholas Camill,1,0,30,29
1657854004707,ECE 180,B00,083141,Abi Samra; Nicholas Camill,0,0,30,30
1657854010730,MATH 10A,A01,083735,Patchell; Gregory David,2,0,30,28
1657854010730,MATH 10A,A02,083736,Patchell; Gregory David,20,0,30,10
1657854010730,MATH 10A,A03,083737,Patchell; Gregory David,16,0,30,14
1657854016752,MATH 10B,A01,083207,Lim; Seonhee,8,0,34,26
1657854016752,MATH 10B,A02,083208,Lim; Seonhee,10,0,35,25
1657854016752,MATH 10B,A03,093472,Lim; Seonhee,7,0,34,27
1657854016752,MATH 10B,B01,083739,Sinha; Shubham,14,0,30,16
1657854022780,MATH 18,A01,083743,Cinel; Cameron Alexander,9,0,30,21
1657854022780,MATH 18,A02,083744,Cinel; Cameron Alexander,18,0,30,12
1657854022780,MATH 18,A03,083745,Cinel; Cameron Alexander,10,0,30,20
1657854022780,MATH 18,B01,083748,Rideout; David Porter,5,0,37,32
1657854022780,MATH 18,B02,083749,Rideout; David Porter,5,0,36,31
1657854022780,MATH 18,B03,083750,Rideout; David Porter,3,0,37,34
1657854022780,MATH 18,B04,083751,Rideout; David Porter,6,0,36,30
1657854022780,MATH 18,B05,093473,Rideout; David Porter,6,0,36,30
1657854022780,MATH 18,B06,093474,Rideout; David Porter,6,0,36,30
1657854028802,MATH 20A,A01,083754,Zheng; Zequn,14,0,40,26
1657854034826,MATH 20B,A01,083756,Briones; Jor-el Thomas Caparas,4,0,36,32
1657854034826,MATH 20B,A02,083757,Briones; Jor-el Thomas Caparas,1,0,36,35
1657854034826,MATH 20B,A03,093475,Briones; Jor-el Thomas Caparas,2,0,36,34
1657854040854,MATH 20C,A01,083760,Briones; Jor-el Thomas Caparas,1,0,35,34
1657854040854,MATH 20C,A02,083761,Briones; Jor-el Thomas Caparas,8,0,35,27
1657854040854,MATH 20C,A03,093476,Briones; Jor-el Thomas Caparas,0,1,36,36
1657854040854,MATH 20C,B01,083762,Bach; Quang Tran,1,0,30,29
1657854046881,MATH 20D,A01,083765,Tran; Brian Kha,5,0,30,25
1657854046881,MATH 20D,A02,083766,Tran; Brian Kha,5,0,30,25
1657854046881,MATH 20D,A03,083767,Tran; Brian Kha,5,0,30,25
1657854052904,MATH 20E,A01,083771,Ganguly; Soumya,10,0,32,22
1657854052904,MATH 20E,A02,083772,Ganguly; Soumya,6,0,32,26
1657854052904,MATH 20E,B01,083773,Ciotti; Benjamin,20,0,35,15
1657854052904,MATH 20E,B02,083774,Ciotti; Benjamin,18,0,35,17
1657854058926,MATH 103A,A01,083777,Greenfeld; Be'Eri,3,0,36,33
1657854058926,MATH 103A,A02,083778,Greenfeld; Be'Eri,5,0,36,31
1657854058926,MATH 103A,A03,093561,Greenfeld; Be'Eri,6,0,36,30
1657854058926,MATH 103A,B01,083779,Greenfeld; Be'Eri,7,0,36,29
1657854058926,MATH 103A,B02,083780,Greenfeld; Be'Eri,4,0,36,32
1657854058926,MATH 103A,B03,093562,Greenfeld; Be'Eri,3,0,36,33
1657854064950,MATH 105,A01,085443,Carter; Anne Toulson,15,0,35,20
1657854064950,MATH 105,A02,093477,Carter; Anne Toulson,20,0,35,15
1657854070977,MATH 109,A01,083213,Ganzberger; Geoffrey Michael,3,0,34,31
1657854070977,MATH 109,A02,083214,Ganzberger; Geoffrey Michael,4,0,34,30
1657854070977,MATH 109,A03,093478,Ganzberger; Geoffrey Michael,2,0,34,32
1657854070977,MATH 109,B01,083215,Ganzberger; Geoffrey Michael,1,0,32,31
1657854070977,MATH 109,B02,083216,Ganzberger; Geoffrey Michael,2,0,32,30
1657854070977,MATH 109,B03,093479,Ganzberger; Geoffrey Michael,8,0,32,24
1657854077001,MATH 142A,A01,083219,Chow; Bennett,7,0,32,25
1657854077001,MATH 142A,A02,083220,Chow; Bennett,10,0,32,22
1657854077001,MATH 142A,A03,093480,Chow; Bennett,9,0,32,23
1657854077001,MATH 142A,B03,093481,Chow; Bennett,8,0,32,24
1657854077001,MATH 142A,B04,093558,Chow; Bennett,13,0,32,19
1657854077001,MATH 142A,B05,093559,Chow; Bennett,7,0,32,25
1657854083024,MATH 193A,A01,083224,Rotar; Vladimir,8,0,34,26
1657854083024,MATH 193A,A02,083225,Rotar; Vladimir,10,0,34,24
1657854083024,MATH 193A,A03,083781,Rotar; Vladimir,5,0,34,29
1657854083024,MATH 193A,A04,083782,Rotar; Vladimir,11,0,34,23
1657854083024,MATH 193A,A05,093482,Rotar; Vladimir,10,0,34,24
1657854089050,MATH 197,001,091859,McAuley; Julian John,9999,0,9999,0
1657854089050,MATH 197,002,095566,Kedlaya; Kiran S.,9997,0,9999,2
1657854089050,MATH 197,003,095567,Xiao; Ming,9999,0,9999,0
1657854089050,MATH 197,004,095571,Perols; Johan Lars,9998,0,9999,1
1657854096112,COGS 9,A01,083615,Shannon; Kyle Michael,10,0,75,65
1657854102138,COGS 11,A01,083617,Boyle; Mary E. T.,23,0,48,25
1657854108162,COGS 13,A01,083071,Bastos; Amalia Pinkusfeld,11,0,71,60
1657854114185,COGS 14A,A01,092681,Semenuks; Arturs,5,1,100,95
1657854120216,COGS 14B,A01,083073,Cheng; Tzu-Han,6,0,63,57
1657854126237,COGS 17,A01,092677,Semenuks; Arturs,6,0,81,75
1657854132261,COGS 100,A01,083619,Allen; Michael Gordon,17,0,70,53
1657854138285,COGS 101A,A01,083621,Davis; Joshua Daniel,9,0,68,59
1657854144321,COGS 101B,A01,091572,Allen; Michael Gordon,12,0,65,53
1657854150343,COGS 101C,A01,083625,Delgado; Tania,17,0,35,18
1657854156367,COGS 107A,A01,083627,Boyle; Mary E. T.,14,0,60,46
1657854162393,COGS 118A,A01,083075,Gupta; Anjum,21,0,76,55
1657854168420,CSE 3,A50,083646,Miranda; Gregory Joseph,24,0,50,26
1657854174443,CSE 8A,A50,083650,Miranda; Gregory Joseph,17,1,56,39
1657854180467,CSE 11,A01,083080,Cao; Yingjun,6,15,40,34
1657854186490,CSE 12,A01,083652,Krause-Levy; Sophia Louisa,29,1,120,91
1657854192513,CSE 15L,A01,083654,Morris; Justin Loren,9,0,50,41
1657854192513,CSE 15L,A02,083655,Morris; Justin Loren,9,0,50,41
1657854198537,CSE 20,A01,083657,Tran; Khoa Dang,39,0,80,41
1657854204564,CSE 21,A01,095574,Bach; Quang Tran,22,0,48,26
1657854210587,CSE 30,A01,083084,Eldon; John,6,0,80,74
1657854210587,CSE 30,B01,095061,Bhaskar; Nishant,9,0,50,41
1657854216610,CSE 100,A01,083659,Cao; Yingjun,5,4,70,65
1657854222633,CSE 134B,A01,083661,Powell; Thomas Allan,24,0,100,76
1657854228656,CSE 140,A01,083663,Gungor; Onat,15,0,85,70
1657854234682,CSE 140L,A01,083088,Eldon; John,23,0,100,77
1657854240707,CSE 175,A01,083665,Kumar; Rakesh,3,0,25,22
1657854246729,CSE 190,A00,092507,Dubnov; Shlomo,8,0,20,12
1657854252751,ECE 45,A01,083139,Congero; Spencer William,6,0,75,69
1657854258774,ECE 65,A50,083695,Saad; Andrew S,12,0,30,18
1657854258774,ECE 65,A51,095125,Saad; Andrew S,24,0,26,2
1657854264797,ECE 109,A01,091882,Touri; Behrouz,20,0,70,50
1657854270823,ECE 180,A00,083140,Abi Samra; Nicholas Camill,1,0,30,29
1657854270823,ECE 180,B00,083141,Abi Samra; Nicholas Camill,0,0,30,30
1657854276848,MATH 10A,A01,083735,Patchell; Gregory David,2,0,30,28
1657854276848,MATH 10A,A02,083736,Patchell; Gregory David,20,0,30,10
1657854276848,MATH 10A,A03,083737,Patchell; Gregory David,16,0,30,14
1657854282872,MATH 10B,A01,083207,Lim; Seonhee,8,0,34,26
1657854282872,MATH 10B,A02,083208,Lim; Seonhee,10,0,35,25
1657854282872,MATH 10B,A03,093472,Lim; Seonhee,7,0,34,27
1657854282872,MATH 10B,B01,083739,Sinha; Shubham,14,0,30,16
1657854288907,MATH 18,A01,083743,Cinel; Cameron Alexander,9,0,30,21
1657854288907,MATH 18,A02,083744,Cinel; Cameron Alexander,18,0,30,12
1657854288907,MATH 18,A03,083745,Cinel; Cameron Alexander,10,0,30,20
1657854288907,MATH 18,B01,083748,Rideout; David Porter,5,0,37,32
1657854288907,MATH 18,B02,083749,Rideout; David Porter,5,0,36,31
1657854288907,MATH 18,B03,083750,Rideout; David Porter,3,0,37,34
1657854288907,MATH 18,B04,083751,Rideout; David Porter,6,0,36,30
1657854288907,MATH 18,B05,093473,Rideout; David Porter,6,0,36,30
1657854288907,MATH 18,B06,093474,Rideout; David Porter,6,0,36,30
1657854294930,MATH 20A,A01,083754,Zheng; Zequn,14,0,40,26
1657854300954,MATH 20B,A01,083756,Briones; Jor-el Thomas Caparas,4,0,36,32
1657854300954,MATH 20B,A02,083757,Briones; Jor-el Thomas Caparas,1,0,36,35
1657854300954,MATH 20B,A03,093475,Briones; Jor-el Thomas Caparas,2,0,36,34
1657854306982,MATH 20C,A01,083760,Briones; Jor-el Thomas Caparas,1,0,35,34
1657854306982,MATH 20C,A02,083761,Briones; Jor-el Thomas Caparas,8,0,35,27
1657854306982,MATH 20C,A03,093476,Briones; Jor-el Thomas Caparas,0,1,36,36
1657854306982,MATH 20C,B01,083762,Bach; Quang Tran,1,0,30,29
1657854313004,MATH 20D,A01,083765,Tran; Brian Kha,5,0,30,25
1657854313004,MATH 20D,A02,083766,Tran; Brian Kha,5,0,30,25
1657854313004,MATH 20D,A03,083767,Tran; Brian Kha,5,0,30,25
1657854319031,MATH 20E,A01,083771,Ganguly; Soumya,10,0,32,22
1657854319031,MATH 20E,A02,083772,Ganguly; Soumya,6,0,32,26
1657854319031,MATH 20E,B01,083773,Ciotti; Benjamin,20,0,35,15
1657854319031,MATH 20E,B02,083774,Ciotti; Benjamin,18,0,35,17
1657854325054,MATH 103A,A01,083777,Greenfeld; Be'Eri,3,0,36,33
1657854325054,MATH 103A,A02,083778,Greenfeld; Be'Eri,5,0,36,31
1657854325054,MATH 103A,A03,093561,Greenfeld; Be'Eri,6,0,36,30
1657854325054,MATH 103A,B01,083779,Greenfeld; Be'Eri,7,0,36,29
1657854325054,MATH 103A,B02,083780,Greenfeld; Be'Eri,4,0,36,32
1657854325054,MATH 103A,B03,093562,Greenfeld; Be'Eri,3,0,36,33
1657854331075,MATH 105,A01,085443,Carter; Anne Toulson,15,0,35,20
1657854331075,MATH 105,A02,093477,Carter; Anne Toulson,20,0,35,15
1657854337102,MATH 109,A01,083213,Ganzberger; Geoffrey Michael,3,0,34,31
1657854337102,MATH 109,A02,083214,Ganzberger; Geoffrey Michael,4,0,34,30
1657854337102,MATH 109,A03,093478,Ganzberger; Geoffrey Michael,2,0,34,32
1657854337102,MATH 109,B01,083215,Ganzberger; Geoffrey Michael,1,0,32,31
1657854337102,MATH 109,B02,083216,Ganzberger; Geoffrey Michael,2,0,32,30
1657854337102,MATH 109,B03,093479,Ganzberger; Geoffrey Michael,8,0,32,24
1657854343125,MATH 142A,A01,083219,Chow; Bennett,7,0,32,25
1657854343125,MATH 142A,A02,083220,Chow; Bennett,10,0,32,22
1657854343125,MATH 142A,A03,093480,Chow; Bennett,9,0,32,23
1657854343125,MATH 142A,B03,093481,Chow; Bennett,8,0,32,24
1657854343125,MATH 142A,B04,093558,Chow; Bennett,13,0,32,19
1657854343125,MATH 142A,B05,093559,Chow; Bennett,7,0,32,25
1657854349154,MATH 193A,A01,083224,Rotar; Vladimir,8,0,34,26
1657854349154,MATH 193A,A02,083225,Rotar; Vladimir,10,0,34,24
1657854349154,MATH 193A,A03,083781,Rotar; Vladimir,5,0,34,29
1657854349154,MATH 193A,A04,083782,Rotar; Vladimir,11,0,34,23
1657854349154,MATH 193A,A05,093482,Rotar; Vladimir,10,0,34,24
1657854355177,MATH 197,001,091859,McAuley; Julian John,9999,0,9999,0
1657854355177,MATH 197,002,095566,Kedlaya; Kiran S.,9997,0,9999,2
1657854355177,MATH 197,003,095567,Xiao; Ming,9999,0,9999,0
1657854355177,MATH 197,004,095571,Perols; Johan Lars,9998,0,9999,1
1657854362238,COGS 9,A01,083615,Shannon; Kyle Michael,10,0,75,65
1657854368262,COGS 11,A01,083617,Boyle; Mary E. T.,23,0,48,25
1657854374285,COGS 13,A01,083071,Bastos; Amalia Pinkusfeld,11,0,71,60
1657854380308,COGS 14A,A01,092681,Semenuks; Arturs,5,1,100,95
1657854386331,COGS 14B,A01,083073,Cheng; Tzu-Han,6,0,63,57
1657854392357,COGS 17,A01,092677,Semenuks; Arturs,6,0,81,75
1657854398384,COGS 100,A01,083619,Allen; Michael Gordon,17,0,70,53
1657854404408,COGS 101A,A01,083621,Davis; Joshua Daniel,9,0,68,59
1657854410432,COGS 101B,A01,091572,Allen; Michael Gordon,12,0,65,53
1657854416461,COGS 101C,A01,083625,Delgado; Tania,17,0,35,18
1657854422489,COGS 107A,A01,083627,Boyle; Mary E. T.,14,0,60,46
1657854428517,COGS 118A,A01,083075,Gupta; Anjum,21,0,76,55
1657854434546,CSE 3,A50,083646,Miranda; Gregory Joseph,24,0,50,26
1657854440574,CSE 8A,A50,083650,Miranda; Gregory Joseph,17,1,56,39
1657854446601,CSE 11,A01,083080,Cao; Yingjun,6,15,40,34
1657854452623,CSE 12,A01,083652,Krause-Levy; Sophia Louisa,29,1,120,91
1657854458648,CSE 15L,A01,083654,Morris; Justin Loren,9,0,50,41
1657854458648,CSE 15L,A02,083655,Morris; Justin Loren,9,0,50,41
1657854464669,CSE 20,A01,083657,Tran; Khoa Dang,39,0,80,41
1657854470693,CSE 21,A01,095574,Bach; Quang Tran,22,0,48,26
1657854476721,CSE 30,A01,083084,Eldon; John,6,0,80,74
1657854476721,CSE 30,B01,095061,Bhaskar; Nishant,9,0,50,41
1657854482748,CSE 100,A01,083659,Cao; Yingjun,5,4,70,65
1657854488772,CSE 134B,A01,083661,Powell; Thomas Allan,24,0,100,76
1657854494795,CSE 140,A01,083663,Gungor; Onat,15,0,85,70
1657854500821,CSE 140L,A01,083088,Eldon; John,23,0,100,77
1657854506845,CSE 175,A01,083665,Kumar; Rakesh,3,0,25,22
1657854512872,CSE 190,A00,092507,Dubnov; Shlomo,8,0,20,12
1657854518896,ECE 45,A01,083139,Congero; Spencer William,6,0,75,69
1657854524918,ECE 65,A50,083695,Saad; Andrew S,12,0,30,18
1657854524918,ECE 65,A51,095125,Saad; Andrew S,24,0,26,2
1657854530951,ECE 109,A01,091882,Touri; Behrouz,20,0,70,50
1657854536974,ECE 180,A00,083140,Abi Samra; Nicholas Camill,1,0,30,29
1657854536974,ECE 180,B00,083141,Abi Samra; Nicholas Camill,0,0,30,30
1657854543001,MATH 10A,A01,083735,Patchell; Gregory David,2,0,30,28
1657854543001,MATH 10A,A02,083736,Patchell; Gregory David,20,0,30,10
1657854543001,MATH 10A,A03,083737,Patchell; Gregory David,16,0,30,14
1657854549023,MATH 10B,A01,083207,Lim; Seonhee,8,0,34,26
1657854549023,MATH 10B,A02,083208,Lim; Seonhee,10,0,35,25
1657854549023,MATH 10B,A03,093472,Lim; Seonhee,7,0,34,27
1657854549023,MATH 10B,B01,083739,Sinha; Shubham,14,0,30,16
1657854555053,MATH 18,A01,083743,Cinel; Cameron Alexander,9,0,30,21
1657854555053,MATH 18,A02,083744,Cinel; Cameron Alexander,18,0,30,12
1657854555053,MATH 18,A03,083745,Cinel; Cameron Alexander,10,0,30,20
1657854555053,MATH 18,B01,083748,Rideout; David Porter,5,0,37,32
1657854555053,MATH 18,B02,083749,Rideout; David Porter,5,0,36,31
1657854555053,MATH 18,B03,083750,Rideout; David Porter,3,0,37,34
1657854555053,MATH 18,B04,083751,Rideout; David Porter,6,0,36,30
1657854555053,MATH 18,B05,093473,Rideout; David Porter,6,0,36,30
1657854555053,MATH 18,B06,093474,Rideout; David Porter,6,0,36,30
1657854561076,MATH 20A,A01,083754,Zheng; Zequn,14,0,40,26
1657854567103,MATH 20B,A01,083756,Briones; Jor-el Thomas Caparas,4,0,36,32
1657854567103,MATH 20B,A02,083757,Briones; Jor-el Thomas Caparas,1,0,36,35
1657854567103,MATH 20B,A03,093475,Briones; Jor-el Thomas Caparas,2,0,36,34
1657854573127,MATH 20C,A01,083760,Briones; Jor-el Thomas Caparas,1,0,35,34
1657854573127,MATH 20C,A02,083761,Briones; Jor-el Thomas Caparas,8,0,35,27
1657854573127,MATH 20C,A03,093476,Briones; Jor-el Thomas Caparas,0,1,36,36
1657854573127,MATH 20C,B01,083762,Bach; Quang Tran,1,0,30,29
1657854579155,MATH 20D,A01,083765,Tran; Brian Kha,5,0,30,25
1657854579155,MATH 20D,A02,083766,Tran; Brian Kha,5,0,30,25
1657854579155,MATH 20D,A03,083767,Tran; Brian Kha,5,0,30,25
1657854585180,MATH 20E,A01,083771,Ganguly; Soumya,10,0,32,22
1657854585180,MATH 20E,A02,083772,Ganguly; Soumya,6,0,32,26
1657854585180,MATH 20E,B01,083773,Ciotti; Benjamin,20,0,35,15
1657854585180,MATH 20E,B02,083774,Ciotti; Benjamin,18,0,35,17
1657854591202,MATH 103A,A01,083777,Greenfeld; Be'Eri,3,0,36,33
1657854591202,MATH 103A,A02,083778,Greenfeld; Be'Eri,5,0,36,31
1657854591202,MATH 103A,A03,093561,Greenfeld; Be'Eri,6,0,36,30
1657854591202,MATH 103A,B01,083779,Greenfeld; Be'Eri,7,0,36,29
1657854591202,MATH 103A,B02,083780,Greenfeld; Be'Eri,4,0,36,32
1657854591202,MATH 103A,B03,093562,Greenfeld; Be'Eri,3,0,36,33
1657854597239,MATH 105,A01,085443,Carter; Anne Toulson,15,0,35,20
1657854597239,MATH 105,A02,093477,Carter; Anne Toulson,20,0,35,15
1657854603333,MATH 109,A01,083213,Ganzberger; Geoffrey Michael,3,0,34,31
1657854603333,MATH 109,A02,083214,Ganzberger; Geoffrey Michael,4,0,34,30
1657854603333,MATH 109,A03,093478,Ganzberger; Geoffrey Michael,2,0,34,32
1657854603333,MATH 109,B01,083215,Ganzberger; Geoffrey Michael,1,0,32,31
1657854603333,MATH 109,B02,083216,Ganzberger; Geoffrey Michael,2,0,32,30
1657854603333,MATH 109,B03,093479,Ganzberger; Geoffrey Michael,8,0,32,24
1657854609356,MATH 142A,A01,083219,Chow; Bennett,7,0,32,25
1657854609356,MATH 142A,A02,083220,Chow; Bennett,10,0,32,22
1657854609356,MATH 142A,A03,093480,Chow; Bennett,9,0,32,23
1657854609356,MATH 142A,B03,093481,Chow; Bennett,8,0,32,24
1657854609356,MATH 142A,B04,093558,Chow; Bennett,13,0,32,19
1657854609356,MATH 142A,B05,093559,Chow; Bennett,7,0,32,25
1657854615380,MATH 193A,A01,083224,Rotar; Vladimir,8,0,34,26
1657854615380,MATH 193A,A02,083225,Rotar; Vladimir,10,0,34,24
1657854615380,MATH 193A,A03,083781,Rotar; Vladimir,5,0,34,29
1657854615380,MATH 193A,A04,083782,Rotar; Vladimir,11,0,34,23
1657854615380,MATH 193A,A05,093482,Rotar; Vladimir,10,0,34,24
1657854621407,MATH 197,001,091859,McAuley; Julian John,9999,0,9999,0
1657854621407,MATH 197,002,095566,Kedlaya; Kiran S.,9997,0,9999,2
1657854621407,MATH 197,003,095567,Xiao; Ming,9999,0,9999,0
1657854621407,MATH 197,004,095571,Perols; Johan Lars,9998,0,9999,1
1657854628469,COGS 9,A01,083615,Shannon; Kyle Michael,10,0,75,65
1657854634492,COGS 11,A01,083617,Boyle; Mary E. T.,23,0,48,25
1657854640518,COGS 13,A01,083071,Bastos; Amalia Pinkusfeld,11,0,71,60
1657854646540,COGS 14A,A01,092681,Semenuks; Arturs,5,1,100,95
1657854652564,COGS 14B,A01,083073,Cheng; Tzu-Han,6,0,63,57
1657854658592,COGS 17,A01,092677,Semenuks; Arturs,6,0,81,75
1657854664620,COGS 100,A01,083619,Allen; Michael Gordon,17,0,70,53
1657854670642,COGS 101A,A01,083621,Davis; Joshua Daniel,9,0,68,59
1657854676665,COGS 101B,A01,091572,Allen; Michael Gordon,12,0,65,53
1657854682687,COGS 101C,A01,083625,Delgado; Tania,17,0,35,18
1657854688725,COGS 107A,A01,083627,Boyle; Mary E. T.,14,0,60,46
1657854694752,COGS 118A,A01,083075,Gupta; Anjum,21,0,76,55
1657854700776,CSE 3,A50,083646,Miranda; Gregory Joseph,24,0,50,26
1657854706803,CSE 8A,A50,083650,Miranda; Gregory Joseph,17,1,56,39
1657854712825,CSE 11,A01,083080,Cao; Yingjun,6,15,40,34
1657854718847,CSE 12,A01,083652,Krause-Levy; Sophia Louisa,29,1,120,91
1657854724875,CSE 15L,A01,083654,Morris; Justin Loren,9,0,50,41
1657854724875,CSE 15L,A02,083655,Morris; Justin Loren,9,0,50,41
1657854730897,CSE 20,A01,083657,Tran; Khoa Dang,39,0,80,41
1657854736926,CSE 21,A01,095574,Bach; Quang Tran,22,0,48,26
1657854742950,CSE 30,A01,083084,Eldon; John,6,0,80,74
1657854742950,CSE 30,B01,095061,Bhaskar; Nishant,9,0,50,41
1657854748971,CSE 100,A01,083659,Cao; Yingjun,5,4,70,65
1657854754993,CSE 134B,A01,083661,Powell; Thomas Allan,24,0,100,76
1657854761020,CSE 140,A01,083663,Gungor; Onat,15,0,85,70
1657854767043,CSE 140L,A01,083088,Eldon; John,23,0,100,77
1657854773070,CSE 175,A01,083665,Kumar; Rakesh,3,0,25,22
1657854779101,CSE 190,A00,092507,Dubnov; Shlomo,8,0,20,12
1657854785124,ECE 45,A01,083139,Congero; Spencer William,6,0,75,69
1657854791151,ECE 65,A50,083695,Saad; Andrew S,12,0,30,18
1657854791151,ECE 65,A51,095125,Saad; Andrew S,24,0,26,2
1657854797176,ECE 109,A01,091882,Touri; Behrouz,20,0,70,50
1657854803199,ECE 180,A00,083140,Abi Samra; Nicholas Camill,1,0,30,29
1657854803199,ECE 180,B00,083141,Abi Samra; Nicholas Camill,0,0,30,30
1657854809222,MATH 10A,A01,083735,Patchell; Gregory David,2,0,30,28
1657854809222,MATH 10A,A02,083736,Patchell; Gregory David,20,0,30,10
1657854809222,MATH 10A,A03,083737,Patchell; Gregory David,16,0,30,14
1657854815245,MATH 10B,A01,083207,Lim; Seonhee,8,0,34,26
1657854815245,MATH 10B,A02,083208,Lim; Seonhee,10,0,35,25
1657854815245,MATH 10B,A03,093472,Lim; Seonhee,7,0,34,27
1657854815245,MATH 10B,B01,083739,Sinha; Shubham,14,0,30,16
1657854821276,MATH 18,A01,083743,Cinel; Cameron Alexander,9,0,30,21
1657854821276,MATH 18,A02,083744,Cinel; Cameron Alexander,18,0,30,12
1657854821276,MATH 18,A03,083745,Cinel; Cameron Alexander,10,0,30,20
1657854821276,MATH 18,B01,083748,Rideout; David Porter,5,0,37,32
1657854821276,MATH 18,B02,083749,Rideout; David Porter,5,0,36,31
1657854821276,MATH 18,B03,083750,Rideout; David Porter,3,0,37,34
1657854821276,MATH 18,B04,083751,Rideout; David Porter,6,0,36,30
1657854821276,MATH 18,B05,093473,Rideout; David Porter,6,0,36,30
1657854821276,MATH 18,B06,093474,Rideout; David Porter,6,0,36,30
1657854827300,MATH 20A,A01,083754,Zheng; Zequn,14,0,40,26
1657854833322,MATH 20B,A01,083756,Briones; Jor-el Thomas Caparas,4,0,36,32
1657854833322,MATH 20B,A02,083757,Briones; Jor-el Thomas Caparas,1,0,36,35
1657854833322,MATH 20B,A03,093475,Briones; Jor-el Thomas Caparas,2,0,36,34
1657854839346,MATH 20C,A01,083760,Briones; Jor-el Thomas Caparas,1,0,35,34
1657854839346,MATH 20C,A02,083761,Briones; Jor-el Thomas Caparas,8,0,35,27
1657854839346,MATH 20C,A03,093476,Briones; Jor-el Thomas Caparas,0,1,36,36
1657854839346,MATH 20C,B01,083762,Bach; Quang Tran,1,0,30,29
1657854845375,MATH 20D,A01,083765,Tran; Brian Kha,5,0,30,25
1657854845375,MATH 20D,A02,083766,Tran; Brian Kha,5,0,30,25
1657854845375,MATH 20D,A03,083767,Tran; Brian Kha,5,0,30,25
1657854851399,MATH 20E,A01,083771,Ganguly; Soumya,10,0,32,22
1657854851399,MATH 20E,A02,083772,Ganguly; Soumya,6,0,32,26
1657854851399,MATH 20E,B01,083773,Ciotti; Benjamin,20,0,35,15
1657854851399,MATH 20E,B02,083774,Ciotti; Benjamin,18,0,35,17
1657854857429,MATH 103A,A01,083777,Greenfeld; Be'Eri,3,0,36,33
1657854857429,MATH 103A,A02,083778,Greenfeld; Be'Eri,5,0,36,31
1657854857429,MATH 103A,A03,093561,Greenfeld; Be'Eri,6,0,36,30
1657854857429,MATH 103A,B01,083779,Greenfeld; Be'Eri,7,0,36,29
1657854857429,MATH 103A,B02,083780,Greenfeld; Be'Eri,4,0,36,32
1657854857429,MATH 103A,B03,093562,Greenfeld; Be'Eri,3,0,36,33
1657854863452,MATH 105,A01,085443,Carter; Anne Toulson,15,0,35,20
1657854863452,MATH 105,A02,093477,Carter; Anne Toulson,20,0,35,15
1657854869482,MATH 109,A01,083213,Ganzberger; Geoffrey Michael,3,0,34,31
1657854869482,MATH 109,A02,083214,Ganzberger; Geoffrey Michael,4,0,34,30
1657854869482,MATH 109,A03,093478,Ganzberger; Geoffrey Michael,2,0,34,32
1657854869482,MATH 109,B01,083215,Ganzberger; Geoffrey Michael,1,0,32,31
1657854869482,MATH 109,B02,083216,Ganzberger; Geoffrey Michael,2,0,32,30
1657854869482,MATH 109,B03,093479,Ganzberger; Geoffrey Michael,8,0,32,24
1657854875513,MATH 142A,A01,083219,Chow; Bennett,7,0,32,25
1657854875513,MATH 142A,A02,083220,Chow; Bennett,10,0,32,22
1657854875513,MATH 142A,A03,093480,Chow; Bennett,9,0,32,23
1657854875513,MATH 142A,B03,093481,Chow; Bennett,8,0,32,24
1657854875513,MATH 142A,B04,093558,Chow; Bennett,13,0,32,19
1657854875513,MATH 142A,B05,093559,Chow; Bennett,7,0,32,25
1657854881541,MATH 193A,A01,083224,Rotar; Vladimir,8,0,34,26
1657854881541,MATH 193A,A02,083225,Rotar; Vladimir,10,0,34,24
1657854881541,MATH 193A,A03,083781,Rotar; Vladimir,5,0,34,29
1657854881541,MATH 193A,A04,083782,Rotar; Vladimir,11,0,34,23
1657854881541,MATH 193A,A05,093482,Rotar; Vladimir,10,0,34,24
1657854887565,MATH 197,001,091859,McAuley; Julian John,9999,0,9999,0
1657854887565,MATH 197,002,095566,Kedlaya; Kiran S.,9997,0,9999,2
1657854887565,MATH 197,003,095567,Xiao; Ming,9999,0,9999,0
1657854887565,MATH 197,004,095571,Perols; Johan Lars,9998,0,9999,1
1657854894618,COGS 9,A01,083615,Shannon; Kyle Michael,10,0,75,65
1657854900640,COGS 11,A01,083617,Boyle; Mary E. T.,23,0,48,25
1657854906668,COGS 13,A01,083071,Bastos; Amalia Pinkusfeld,11,0,71,60
1657854912690,COGS 14A,A01,092681,Semenuks; Arturs,5,1,100,95
1657854918712,COGS 14B,A01,083073,Cheng; Tzu-Han,6,0,63,57
1657854924736,COGS 17,A01,092677,Semenuks; Arturs,6,0,81,75
1657854930768,COGS 100,A01,083619,Allen; Michael Gordon,17,0,70,53
1657854936797,COGS 101A,A01,083621,Davis; Joshua Daniel,9,0,68,59
1657854942822,COGS 101B,A01,091572,Allen; Michael Gordon,12,0,65,53
1657854948844,COGS 101C,A01,083625,Delgado; Tania,17,0,35,18
1657854954867,COGS 107A,A01,083627,Boyle; Mary E. T.,14,0,60,46
1657854960896,COGS 118A,A01,083075,Gupta; Anjum,21,0,76,55
1657854966921,CSE 3,A50,083646,Miranda; Gregory Joseph,24,0,50,26
1657854972949,CSE 8A,A50,083650,Miranda; Gregory Joseph,17,1,56,39
1657854978973,CSE 11,A01,083080,Cao; Yingjun,6,15,40,34
1657854984996,CSE 12,A01,083652,Krause-Levy; Sophia Louisa,29,1,120,91
1657854991022,CSE 15L,A01,083654,Morris; Justin Loren,9,0,50,41
1657854991022,CSE 15L,A02,083655,Morris; Justin Loren,9,0,50,41
1657854997043,CSE 20,A01,083657,Tran; Khoa Dang,39,0,80,41
1657855003067,CSE 21,A01,095574,Bach; Quang Tran,22,0,48,26
1657855009094,CSE 30,A01,083084,Eldon; John,6,0,80,74
1657855009094,CSE 30,B01,095061,Bhaskar; Nishant,9,0,50,41
1657855015121,CSE 100,A01,083659,Cao; Yingjun,5,4,70,65
1657855021143,CSE 134B,A01,083661,Powell; Thomas Allan,24,0,100,76
1657855027169,CSE 140,A01,083663,Gungor; Onat,15,0,85,70
1657855033203,CSE 140L,A01,083088,Eldon; John,23,0,100,77
1657855039229,CSE 175,A01,083665,Kumar; Rakesh,3,0,25,22
1657855045255,CSE 190,A00,092507,Dubnov; Shlomo,8,0,20,12
1657855051284,ECE 45,A01,083139,Congero; Spencer William,6,0,75,69
1657855057306,ECE 65,A50,083695,Saad; Andrew S,12,0,30,18
1657855057306,ECE 65,A51,095125,Saad; Andrew S,24,0,26,2
1657855063332,ECE 109,A01,091882,Touri; Behrouz,20,0,70,50
1657855069358,ECE 180,A00,083140,Abi Samra; Nicholas Camill,1,0,30,29
1657855069358,ECE 180,B00,083141,Abi Samra; Nicholas Camill,0,0,30,30
1657855075386,MATH 10A,A01,083735,Patchell; Gregory David,2,0,30,28
1657855075386,MATH 10A,A02,083736,Patchell; Gregory David,20,0,30,10
1657855075386,MATH 10A,A03,083737,Patchell; Gregory David,16,0,30,14
1657855081414,MATH 10B,A01,083207,Lim; Seonhee,8,0,34,26
1657855081414,MATH 10B,A02,083208,Lim; Seonhee,10,0,35,25
1657855081414,MATH 10B,A03,093472,Lim; Seonhee,7,0,34,27
1657855081414,MATH 10B,B01,083739,Sinha; Shubham,14,0,30,16
1657855087444,MATH 18,A01,083743,Cinel; Cameron Alexander,9,0,30,21
1657855087444,MATH 18,A02,083744,Cinel; Cameron Alexander,18,0,30,12
1657855087444,MATH 18,A03,083745,Cinel; Cameron Alexander,10,0,30,20
1657855087444,MATH 18,B01,083748,Rideout; David Porter,5,0,37,32
1657855087444,MATH 18,B02,083749,Rideout; David Porter,5,0,36,31
1657855087444,MATH 18,B03,083750,Rideout; David Porter,3,0,37,34
1657855087444,MATH 18,B04,083751,Rideout; David Porter,6,0,36,30
1657855087444,MATH 18,B05,093473,Rideout; David Porter,6,0,36,30
1657855087444,MATH 18,B06,093474,Rideout; David Porter,6,0,36,30
1657855093469,MATH 20A,A01,083754,Zheng; Zequn,14,0,40,26
1657855099497,MATH 20B,A01,083756,Briones; Jor-el Thomas Caparas,4,0,36,32
1657855099497,MATH 20B,A02,083757,Briones; Jor-el Thomas Caparas,1,0,36,35
1657855099497,MATH 20B,A03,093475,Briones; Jor-el Thomas Caparas,2,0,36,34
1657855105526,MATH 20C,A01,083760,Briones; Jor-el Thomas Caparas,1,0,35,34
1657855105526,MATH 20C,A02,083761,Briones; Jor-el Thomas Caparas,8,0,35,27
1657855105526,MATH 20C,A03,093476,Briones; Jor-el Thomas Caparas,0,1,36,36
1657855105526,MATH 20C,B01,083762,Bach; Quang Tran,1,0,30,29
1657855111561,MATH 20D,A01,083765,Tran; Brian Kha,5,0,30,25
1657855111561,MATH 20D,A02,083766,Tran; Brian Kha,5,0,30,25
1657855111561,MATH 20D,A03,083767,Tran; Brian Kha,5,0,30,25
1657855117584,MATH 20E,A01,083771,Ganguly; Soumya,10,0,32,22
1657855117584,MATH 20E,A02,083772,Ganguly; Soumya,6,0,32,26
1657855117584,MATH 20E,B01,083773,Ciotti; Benjamin,20,0,35,15
1657855117584,MATH 20E,B02,083774,Ciotti; Benjamin,18,0,35,17
1657855123610,MATH 103A,A01,083777,Greenfeld; Be'Eri,3,0,36,33
1657855123610,MATH 103A,A02,083778,Greenfeld; Be'Eri,5,0,36,31
1657855123610,MATH 103A,A03,093561,Greenfeld; Be'Eri,6,0,36,30
1657855123610,MATH 103A,B01,083779,Greenfeld; Be'Eri,7,0,36,29
1657855123610,MATH 103A,B02,083780,Greenfeld; Be'Eri,4,0,36,32
1657855123610,MATH 103A,B03,093562,Greenfeld; Be'Eri,3,0,36,33
1657855129636,MATH 105,A01,085443,Carter; Anne Toulson,15,0,35,20
1657855129636,MATH 105,A02,093477,Carter; Anne Toulson,20,0,35,15
1657855135660,MATH 109,A01,083213,Ganzberger; Geoffrey Michael,3,0,34,31
1657855135660,MATH 109,A02,083214,Ganzberger; Geoffrey Michael,4,0,34,30
1657855135660,MATH 109,A03,093478,Ganzberger; Geoffrey Michael,2,0,34,32
1657855135660,MATH 109,B01,083215,Ganzberger; Geoffrey Michael,1,0,32,31
1657855135660,MATH 109,B02,083216,Ganzberger; Geoffrey Michael,2,0,32,30
1657855135660,MATH 109,B03,093479,Ganzberger; Geoffrey Michael,8,0,32,24
1657855141688,MATH 142A,A01,083219,Chow; Bennett,7,0,32,25
1657855141688,MATH 142A,A02,083220,Chow; Bennett,10,0,32,22
1657855141688,MATH 142A,A03,093480,Chow; Bennett,9,0,32,23
1657855141688,MATH 142A,B03,093481,Chow; Bennett,8,0,32,24
1657855141688,MATH 142A,B04,093558,Chow; Bennett,13,0,32,19
1657855141688,MATH 142A,B05,093559,Chow; Bennett,7,0,32,25
1657855147716,MATH 193A,A01,083224,Rotar; Vladimir,8,0,34,26
1657855147716,MATH 193A,A02,083225,Rotar; Vladimir,10,0,34,24
1657855147716,MATH 193A,A03,083781,Rotar; Vladimir,5,0,34,29
1657855147716,MATH 193A,A04,083782,Rotar; Vladimir,11,0,34,23
1657855147716,MATH 193A,A05,093482,Rotar; Vladimir,10,0,34,24
1657855153738,MATH 197,001,091859,McAuley; Julian John,9999,0,9999,0
1657855153738,MATH 197,002,095566,Kedlaya; Kiran S.,9997,0,9999,2
1657855153738,MATH 197,003,095567,Xiao; Ming,9999,0,9999,0
1657855153738,MATH 197,004,095571,Perols; Johan Lars,9998,0,9999,1
1657855160788,COGS 9,A01,083615,Shannon; Kyle Michael,10,0,75,65
1657855166816,COGS 11,A01,083617,Boyle; Mary E. T.,23,0,48,25
1657855172840,COGS 13,A01,083071,Bastos; Amalia Pinkusfeld,11,0,71,60
1657855178862,COGS 14A,A01,092681,Semenuks; Arturs,5,1,100,95
1657855184889,COGS 14B,A01,083073,Cheng; Tzu-Han,6,0,63,57
1657855190913,COGS 17,A01,092677,Semenuks; Arturs,6,0,81,75
1657855197011,COGS 100,A01,083619,Allen; Michael Gordon,17,0,70,53
1657855203034,COGS 101A,A01,083621,Davis; Joshua Daniel,9,0,68,59
1657855209060,COGS 101B,A01,091572,Allen; Michael Gordon,12,0,65,53
1657855215085,COGS 101C,A01,083625,Delgado; Tania,17,0,35,18
1657855221129,COGS 107A,A01,083627,Boyle; Mary E. T.,14,0,60,46
1657855227160,COGS 118A,A01,083075,Gupta; Anjum,21,0,76,55
1657855233188,CSE 3,A50,083646,Miranda; Gregory Joseph,24,0,50,26
1657855239211,CSE 8A,A50,083650,Miranda; Gregory Joseph,17,1,56,39
1657855245234,CSE 11,A01,083080,Cao; Yingjun,6,15,40,34
1657855251262,CSE 12,A01,083652,Krause-Levy; Sophia Louisa,29,1,120,91
1657855257285,CSE 15L,A01,083654,Morris; Justin Loren,9,0,50,41
1657855257285,CSE 15L,A02,083655,Morris; Justin Loren,9,0,50,41
1657855263311,CSE 20,A01,083657,Tran; Khoa Dang,39,0,80,41
1657855269339,CSE 21,A01,095574,Bach; Quang Tran,22,0,48,26
1657855275367,CSE 30,A01,083084,Eldon; John,6,0,80,74
1657855275367,CSE 30,B01,095061,Bhaskar; Nishant,9,0,50,41
1657855281390,CSE 100,A01,083659,Cao; Yingjun,5,4,70,65
1657855287418,CSE 134B,A01,083661,Powell; Thomas Allan,24,0,100,76
1657855293452,CSE 140,A01,083663,Gungor; Onat,15,0,85,70
1657855299481,CSE 140L,A01,083088,Eldon; John,23,0,100,77
1657855305508,CSE 175,A01,083665,Kumar; Rakesh,3,0,25,22
1657855311530,CSE 190,A00,092507,Dubnov; Shlomo,8,0,20,12
1657855317559,ECE 45,A01,083139,Congero; Spencer William,6,0,75,69
1657855323595,ECE 65,A50,083695,Saad; Andrew S,12,0,30,18
1657855323595,ECE 65,A51,095125,Saad; Andrew S,24,0,26,2
1657855329627,ECE 109,A01,091882,Touri; Behrouz,20,0,70,50
1657855335651,ECE 180,A00,083140,Abi Samra; Nicholas Camill,1,0,30,29
1657855335651,ECE 180,B00,083141,Abi Samra; Nicholas Camill,0,0,30,30
1657855341675,MATH 10A,A01,083735,Patchell; Gregory David,2,0,30,28
1657855341675,MATH 10A,A02,083736,Patchell; Gregory David,20,0,30,10
1657855341675,MATH 10A,A03,083737,Patchell; Gregory David,16,0,30,14
1657855347707,MATH 10B,A01,083207,Lim; Seonhee,8,0,34,26
1657855347707,MATH 10B,A02,083208,Lim; Seonhee,10,0,35,25
1657855347707,MATH 10B,A03,093472,Lim; Seonhee,7,0,34,27
1657855347707,MATH 10B,B01,083739,Sinha; Shubham,14,0,30,16
1657855353738,MATH 18,A01,083743,Cinel; Cameron Alexander,9,0,30,21
1657855353738,MATH 18,A02,083744,Cinel; Cameron Alexander,18,0,30,12
1657855353738,MATH 18,A03,083745,Cinel; Cameron Alexander,10,0,30,20
1657855353738,MATH 18,B01,083748,Rideout; David Porter,5,0,37,32
1657855353738,MATH 18,B02,083749,Rideout; David Porter,5,0,36,31
1657855353738,MATH 18,B03,083750,Rideout; David Porter,3,0,37,34
1657855353738,MATH 18,B04,083751,Rideout; David Porter,6,0,36,30
1657855353738,MATH 18,B05,093473,Rideout; David Porter,6,0,36,30
1657855353738,MATH 18,B06,093474,Rideout; David Porter,6,0,36,30
1657855359765,MATH 20A,A01,083754,Zheng; Zequn,14,0,40,26
1657855365793,MATH 20B,A01,083756,Briones; Jor-el Thomas Caparas,4,0,36,32
1657855365793,MATH 20B,A02,083757,Briones; Jor-el Thomas Caparas,1,0,36,35
1657855365793,MATH 20B,A03,093475,Briones; Jor-el Thomas Caparas,2,0,36,34
1657855371823,MATH 20C,A01,083760,Briones; Jor-el Thomas Caparas,1,0,35,34
1657855371823,MATH 20C,A02,083761,Briones; Jor-el Thomas Caparas,8,0,35,27
1657855371823,MATH 20C,A03,093476,Briones; Jor-el Thomas Caparas,0,1,36,36
1657855371823,MATH 20C,B01,083762,Bach; Quang Tran,1,0,30,29
1657855377846,MATH 20D,A01,083765,Tran; Brian Kha,5,0,30,25
1657855377846,MATH 20D,A02,083766,Tran; Brian Kha,5,0,30,25
1657855377846,MATH 20D,A03,083767,Tran; Brian Kha,5,0,30,25
1657855383875,MATH 20E,A01,083771,Ganguly; Soumya,10,0,32,22
1657855383875,MATH 20E,A02,083772,Ganguly; Soumya,6,0,32,26
1657855383875,MATH 20E,B01,083773,Ciotti; Benjamin,20,0,35,15
1657855383875,MATH 20E,B02,083774,Ciotti; Benjamin,18,0,35,17
1657855389898,MATH 103A,A01,083777,Greenfeld; Be'Eri,3,0,36,33
1657855389898,MATH 103A,A02,083778,Greenfeld; Be'Eri,5,0,36,31
1657855389898,MATH 103A,A03,093561,Greenfeld; Be'Eri,6,0,36,30
1657855389898,MATH 103A,B01,083779,Greenfeld; Be'Eri,7,0,36,29
1657855389898,MATH 103A,B02,083780,Greenfeld; Be'Eri,4,0,36,32
1657855389898,MATH 103A,B03,093562,Greenfeld; Be'Eri,3,0,36,33
1657855395920,MATH 105,A01,085443,Carter; Anne Toulson,15,0,35,20
1657855395920,MATH 105,A02,093477,Carter; Anne Toulson,20,0,35,15
1657855401944,MATH 109,A01,083213,Ganzberger; Geoffrey Michael,3,0,34,31
1657855401944,MATH 109,A02,083214,Ganzberger; Geoffrey Michael,4,0,34,30
1657855401944,MATH 109,A03,093478,Ganzberger; Geoffrey Michael,2,0,34,32
1657855401944,MATH 109,B01,083215,Ganzberger; Geoffrey Michael,1,0,32,31
1657855401944,MATH 109,B02,083216,Ganzberger; Geoffrey Michael,2,0,32,30
1657855401944,MATH 109,B03,093479,Ganzberger; Geoffrey Michael,8,0,32,24
1657855407973,MATH 142A,A01,083219,Chow; Bennett,7,0,32,25
1657855407973,MATH 142A,A02,083220,Chow; Bennett,10,0,32,22
1657855407973,MATH 142A,A03,093480,Chow; Bennett,9,0,32,23
1657855407973,MATH 142A,B03,093481,Chow; Bennett,8,0,32,24
1657855407973,MATH 142A,B04,093558,Chow; Bennett,13,0,32,19
1657855407973,MATH 142A,B05,093559,Chow; Bennett,7,0,32,25
1657855413999,MATH 193A,A01,083224,Rotar; Vladimir,8,0,34,26
1657855413999,MATH 193A,A02,083225,Rotar; Vladimir,10,0,34,24
1657855413999,MATH 193A,A03,083781,Rotar; Vladimir,5,0,34,29
1657855413999,MATH 193A,A04,083782,Rotar; Vladimir,11,0,34,23
1657855413999,MATH 193A,A05,093482,Rotar; Vladimir,10,0,34,24
1657855420024,MATH 197,001,091859,McAuley; Julian John,9999,0,9999,0
1657855420024,MATH 197,002,095566,Kedlaya; Kiran S.,9997,0,9999,2
1657855420024,MATH 197,003,095567,Xiao; Ming,9999,0,9999,0
1657855420024,MATH 197,004,095571,Perols; Johan Lars,9998,0,9999,1
1657855427090,COGS 9,A01,083615,Shannon; Kyle Michael,10,0,75,65
1657855433114,COGS 11,A01,083617,Boyle; Mary E. T.,23,0,48,25
1657855439145,COGS 13,A01,083071,Bastos; Amalia Pinkusfeld,11,0,71,60
1657855445167,COGS 14A,A01,092681,Semenuks; Arturs,5,1,100,95
1657855451194,COGS 14B,A01,083073,Cheng; Tzu-Han,6,0,63,57
1657855457221,COGS 17,A01,092677,Semenuks; Arturs,6,0,81,75
1657855463247,COGS 100,A01,083619,Allen; Michael Gordon,17,0,70,53
1657855469273,COGS 101A,A01,083621,Davis; Joshua Daniel,9,0,68,59
1657855475299,COGS 101B,A01,091572,Allen; Michael Gordon,12,0,65,53
1657855481325,COGS 101C,A01,083625,Delgado; Tania,17,0,35,18
1657855487354,COGS 107A,A01,083627,Boyle; Mary E. T.,14,0,60,46
1657855493377,COGS 118A,A01,083075,Gupta; Anjum,21,0,76,55
1657855499404,CSE 3,A50,083646,Miranda; Gregory Joseph,24,0,50,26
1657855505431,CSE 8A,A50,083650,Miranda; Gregory Joseph,17,1,56,39
1657855511455,CSE 11,A01,083080,Cao; Yingjun,6,15,40,34
1657855517489,CSE 12,A01,083652,Krause-Levy; Sophia Louisa,29,1,120,91
1657855523516,CSE 15L,A01,083654,Morris; Justin Loren,9,0,50,41
1657855523516,CSE 15L,A02,083655,Morris; Justin Loren,9,0,50,41
1657855529539,CSE 20,A01,083657,Tran; Khoa Dang,39,0,80,41
1657855535562,CSE 21,A01,095574,Bach; Quang Tran,22,0,48,26
1657855541586,CSE 30,A01,083084,Eldon; John,6,0,80,74
1657855541586,CSE 30,B01,095061,Bhaskar; Nishant,9,0,50,41
1657855547619,CSE 100,A01,083659,Cao; Yingjun,5,4,70,65
1657855553646,CSE 134B,A01,083661,Powell; Thomas Allan,24,0,100,76
1657855559670,CSE 140,A01,083663,Gungor; Onat,15,0,85,70
1657855565693,CSE 140L,A01,083088,Eldon; John,23,0,100,77
1657855571717,CSE 175,A01,083665,Kumar; Rakesh,3,0,25,22
1657855577742,CSE 190,A00,092507,Dubnov; Shlomo,8,0,20,12
1657855583770,ECE 45,A01,083139,Congero; Spencer William,6,0,75,69
1657855589794,ECE 65,A50,083695,Saad; Andrew S,12,0,30,18
1657855589794,ECE 65,A51,095125,Saad; Andrew S,24,0,26,2
1657855595816,ECE 109,A01,091882,Touri; Behrouz,20,0,70,50
1657855601840,ECE 180,A00,083140,Abi Samra; Nicholas Camill,1,0,30,29
1657855601840,ECE 180,B00,083141,Abi Samra; Nicholas Camill,0,0,30,30
1657855607868,MATH 10A,A01,083735,Patchell; Gregory David,2,0,30,28
1657855607868,MATH 10A,A02,083736,Patchell; Gregory David,20,0,30,10
1657855607868,MATH 10A,A03,083737,Patchell; Gregory David,16,0,30,14
1657855613892,MATH 10B,A01,083207,Lim; Seonhee,8,0,34,26
1657855613892,MATH 10B,A02,083208,Lim; Seonhee,10,0,35,25
1657855613892,MATH 10B,A03,093472,Lim; Seonhee,7,0,34,27
1657855613892,MATH 10B,B01,083739,Sinha; Shubham,14,0,30,16
1657855619924,MATH 18,A01,083743,Cinel; Cameron Alexander,9,0,30,21
1657855619924,MATH 18,A02,083744,Cinel; Cameron Alexander,18,0,30,12
1657855619924,MATH 18,A03,083745,Cinel; Cameron Alexander,10,0,30,20
1657855619924,MATH 18,B01,083748,Rideout; David Porter,5,0,37,32
1657855619924,MATH 18,B02,083749,Rideout; David Porter,5,0,36,31
1657855619924,MATH 18,B03,083750,Rideout; David Porter,3,0,37,34
1657855619924,MATH 18,B04,083751,Rideout; David Porter,6,0,36,30
1657855619924,MATH 18,B05,093473,Rideout; David Porter,6,0,36,30
1657855619924,MATH 18,B06,093474,Rideout; David Porter,6,0,36,30
1657855625953,MATH 20A,A01,083754,Zheng; Zequn,14,0,40,26
1657855631977,MATH 20B,A01,083756,Briones; Jor-el Thomas Caparas,4,0,36,32
1657855631977,MATH 20B,A02,083757,Briones; Jor-el Thomas Caparas,1,0,36,35
1657855631977,MATH 20B,A03,093475,Briones; Jor-el Thomas Caparas,2,0,36,34
1657855638000,MATH 20C,A01,083760,Briones; Jor-el Thomas Caparas,1,0,35,34
1657855638000,MATH 20C,A02,083761,Briones; Jor-el Thomas Caparas,8,0,35,27
1657855638000,MATH 20C,A03,093476,Briones; Jor-el Thomas Caparas,0,1,36,36
1657855638000,MATH 20C,B01,083762,Bach; Quang Tran,1,0,30,29
1657855644025,MATH 20D,A01,083765,Tran; Brian Kha,5,0,30,25
1657855644025,MATH 20D,A02,083766,Tran; Brian Kha,5,0,30,25
1657855644025,MATH 20D,A03,083767,Tran; Brian Kha,5,0,30,25
1657855650049,MATH 20E,A01,083771,Ganguly; Soumya,10,0,32,22
1657855650049,MATH 20E,A02,083772,Ganguly; Soumya,6,0,32,26
1657855650049,MATH 20E,B01,083773,Ciotti; Benjamin,20,0,35,15
1657855650049,MATH 20E,B02,083774,Ciotti; Benjamin,18,0,35,17
1657855656073,MATH 103A,A01,083777,Greenfeld; Be'Eri,3,0,36,33
1657855656073,MATH 103A,A02,083778,Greenfeld; Be'Eri,5,0,36,31
1657855656073,MATH 103A,A03,093561,Greenfeld; Be'Eri,6,0,36,30
1657855656073,MATH 103A,B01,083779,Greenfeld; Be'Eri,7,0,36,29
1657855656073,MATH 103A,B02,083780,Greenfeld; Be'Eri,4,0,36,32
1657855656073,MATH 103A,B03,093562,Greenfeld; Be'Eri,3,0,36,33
1657855662098,MATH 105,A01,085443,Carter; Anne Toulson,15,0,35,20
1657855662098,MATH 105,A02,093477,Carter; Anne Toulson,20,0,35,15
1657855668128,MATH 109,A01,083213,Ganzberger; Geoffrey Michael,3,0,34,31
1657855668128,MATH 109,A02,083214,Ganzberger; Geoffrey Michael,4,0,34,30
1657855668128,MATH 109,A03,093478,Ganzberger; Geoffrey Michael,2,0,34,32
1657855668128,MATH 109,B01,083215,Ganzberger; Geoffrey Michael,1,0,32,31
1657855668128,MATH 109,B02,083216,Ganzberger; Geoffrey Michael,2,0,32,30
1657855668128,MATH 109,B03,093479,Ganzberger; Geoffrey Michael,8,0,32,24
1657855674156,MATH 142A,A01,083219,Chow; Bennett,7,0,32,25
1657855674156,MATH 142A,A02,083220,Chow; Bennett,10,0,32,22
1657855674156,MATH 142A,A03,093480,Chow; Bennett,9,0,32,23
1657855674156,MATH 142A,B03,093481,Chow; Bennett,8,0,32,24
1657855674156,MATH 142A,B04,093558,Chow; Bennett,13,0,32,19
1657855674156,MATH 142A,B05,093559,Chow; Bennett,7,0,32,25
1657855680179,MATH 193A,A01,083224,Rotar; Vladimir,8,0,34,26
1657855680179,MATH 193A,A02,083225,Rotar; Vladimir,10,0,34,24
1657855680179,MATH 193A,A03,083781,Rotar; Vladimir,5,0,34,29
1657855680179,MATH 193A,A04,083782,Rotar; Vladimir,11,0,34,23
1657855680179,MATH 193A,A05,093482,Rotar; Vladimir,10,0,34,24
1657855686204,MATH 197,001,091859,McAuley; Julian John,9999,0,9999,0
1657855686204,MATH 197,002,095566,Kedlaya; Kiran S.,9997,0,9999,2
1657855686204,MATH 197,003,095567,Xiao; Ming,9999,0,9999,0
1657855686204,MATH 197,004,095571,Perols; Johan Lars,9998,0,9999,1
1657855693256,COGS 9,A01,083615,Shannon; Kyle Michael,10,0,75,65
1657855699280,COGS 11,A01,083617,Boyle; Mary E. T.,23,0,48,25
1657855705305,COGS 13,A01,083071,Bastos; Amalia Pinkusfeld,11,0,71,60
1657855711327,COGS 14A,A01,092681,Semenuks; Arturs,5,1,100,95
1657855717351,COGS 14B,A01,083073,Cheng; Tzu-Han,6,0,63,57
1657855723378,COGS 17,A01,092677,Semenuks; Arturs,6,0,81,75
1657855729401,COGS 100,A01,083619,Allen; Michael Gordon,17,0,70,53
1657855735427,COGS 101A,A01,083621,Davis; Joshua Daniel,9,0,68,59
1657855741451,COGS 101B,A01,091572,Allen; Michael Gordon,12,0,65,53
1657855747475,COGS 101C,A01,083625,Delgado; Tania,17,0,35,18
1657855753498,COGS 107A,A01,083627,Boyle; Mary E. T.,14,0,60,46
1657855759522,COGS 118A,A01,083075,Gupta; Anjum,21,0,76,55
1657855765546,CSE 3,A50,083646,Miranda; Gregory Joseph,24,0,50,26
1657855771576,CSE 8A,A50,083650,Miranda; Gregory Joseph,17,1,56,39
1657855777597,CSE 11,A01,083080,Cao; Yingjun,6,15,40,34
1657855783621,CSE 12,A01,083652,Krause-Levy; Sophia Louisa,29,1,120,91
1657855789646,CSE 15L,A01,083654,Morris; Justin Loren,9,0,50,41
1657855789646,CSE 15L,A02,083655,Morris; Justin Loren,9,0,50,41
1657855795748,CSE 20,A01,083657,Tran; Khoa Dang,39,0,80,41
1657855801773,CSE 21,A01,095574,Bach; Quang Tran,22,0,48,26
1657855807795,CSE 30,A01,083084,Eldon; John,6,0,80,74
1657855807795,CSE 30,B01,095061,Bhaskar; Nishant,9,0,50,41
1657855813824,CSE 100,A01,083659,Cao; Yingjun,5,4,70,65
1657855819846,CSE 134B,A01,083661,Powell; Thomas Allan,24,0,100,76
1657855825872,CSE 140,A01,083663,Gungor; Onat,15,0,85,70
1657855831894,CSE 140L,A01,083088,Eldon; John,23,0,100,77
1657855837917,CSE 175,A01,083665,Kumar; Rakesh,3,0,25,22
1657855843950,CSE 190,A00,092507,Dubnov; Shlomo,8,0,20,12
1657855849974,ECE 45,A01,083139,Congero; Spencer William,6,0,75,69
1657855856015,ECE 65,A50,083695,Saad; Andrew S,12,0,30,18
1657855856015,ECE 65,A51,095125,Saad; Andrew S,24,0,26,2
1657855862041,ECE 109,A01,091882,Touri; Behrouz,20,0,70,50
1657855868065,ECE 180,A00,083140,Abi Samra; Nicholas Camill,1,0,30,29
1657855868065,ECE 180,B00,083141,Abi Samra; Nicholas Camill,0,0,30,30
1657855874093,MATH 10A,A01,083735,Patchell; Gregory David,2,0,30,28
1657855874093,MATH 10A,A02,083736,Patchell; Gregory David,20,0,30,10
1657855874093,MATH 10A,A03,083737,Patchell; Gregory David,16,0,30,14
1657855880116,MATH 10B,A01,083207,Lim; Seonhee,8,0,34,26
1657855880116,MATH 10B,A02,083208,Lim; Seonhee,10,0,35,25
1657855880116,MATH 10B,A03,093472,Lim; Seonhee,7,0,34,27
1657855880116,MATH 10B,B01,083739,Sinha; Shubham,14,0,30,16
1657855886151,MATH 18,A01,083743,Cinel; Cameron Alexander,9,0,30,21
1657855886151,MATH 18,A02,083744,Cinel; Cameron Alexander,18,0,30,12
1657855886151,MATH 18,A03,083745,Cinel; Cameron Alexander,10,0,30,20
1657855886151,MATH 18,B01,083748,Rideout; David Porter,5,0,37,32
1657855886151,MATH 18,B02,083749,Rideout; David Porter,5,0,36,31
1657855886151,MATH 18,B03,083750,Rideout; David Porter,3,0,37,34
1657855886151,MATH 18,B04,083751,Rideout; David Porter,6,0,36,30
1657855886151,MATH 18,B05,093473,Rideout; David Porter,6,0,36,30
1657855886151,MATH 18,B06,093474,Rideout; David Porter,6,0,36,30
1657855892179,MATH 20A,A01,083754,Zheng; Zequn,14,0,40,26
1657855898201,MATH 20B,A01,083756,Briones; Jor-el Thomas Caparas,4,0,36,32
1657855898201,MATH 20B,A02,083757,Briones; Jor-el Thomas Caparas,1,0,36,35
1657855898201,MATH 20B,A03,093475,Briones; Jor-el Thomas Caparas,2,0,36,34
1657855904228,MATH 20C,A01,083760,Briones; Jor-el Thomas Caparas,1,0,35,34
1657855904228,MATH 20C,A02,083761,Briones; Jor-el Thomas Caparas,8,0,35,27
1657855904228,MATH 20C,A03,093476,Briones; Jor-el Thomas Caparas,0,1,36,36
1657855904228,MATH 20C,B01,083762,Bach; Quang Tran,1,0,30,29
1657855910251,MATH 20D,A01,083765,Tran; Brian Kha,5,0,30,25
1657855910251,MATH 20D,A02,083766,Tran; Brian Kha,5,0,30,25
1657855910251,MATH 20D,A03,083767,Tran; Brian Kha,5,0,30,25
1657855916273,MATH 20E,A01,083771,Ganguly; Soumya,10,0,32,22
1657855916273,MATH 20E,A02,083772,Ganguly; Soumya,6,0,32,26
1657855916273,MATH 20E,B01,083773,Ciotti; Benjamin,20,0,35,15
1657855916273,MATH 20E,B02,083774,Ciotti; Benjamin,18,0,35,17
1657855922301,MATH 103A,A01,083777,Greenfeld; Be'Eri,3,0,36,33
1657855922301,MATH 103A,A02,083778,Greenfeld; Be'Eri,5,0,36,31
1657855922301,MATH 103A,A03,093561,Greenfeld; Be'Eri,6,0,36,30
1657855922301,MATH 103A,B01,083779,Greenfeld; Be'Eri,7,0,36,29
1657855922301,MATH 103A,B02,083780,Greenfeld; Be'Eri,4,0,36,32
1657855922301,MATH 103A,B03,093562,Greenfeld; Be'Eri,3,0,36,33
1657855928330,MATH 105,A01,085443,Carter; Anne Toulson,15,0,35,20
1657855928330,MATH 105,A02,093477,Carter; Anne Toulson,20,0,35,15
1657855934359,MATH 109,A01,083213,Ganzberger; Geoffrey Michael,3,0,34,31
1657855934359,MATH 109,A02,083214,Ganzberger; Geoffrey Michael,4,0,34,30
1657855934359,MATH 109,A03,093478,Ganzberger; Geoffrey Michael,2,0,34,32
1657855934359,MATH 109,B01,083215,Ganzberger; Geoffrey Michael,1,0,32,31
1657855934359,MATH 109,B02,083216,Ganzberger; Geoffrey Michael,2,0,32,30
1657855934359,MATH 109,B03,093479,Ganzberger; Geoffrey Michael,8,0,32,24
1657855940383,MATH 142A,A01,083219,Chow; Bennett,7,0,32,25
1657855940383,MATH 142A,A02,083220,Chow; Bennett,10,0,32,22
1657855940383,MATH 142A,A03,093480,Chow; Bennett,9,0,32,23
1657855940383,MATH 142A,B03,093481,Chow; Bennett,8,0,32,24
1657855940383,MATH 142A,B04,093558,Chow; Bennett,13,0,32,19
1657855940383,MATH 142A,B05,093559,Chow; Bennett,7,0,32,25
1657855946406,MATH 193A,A01,083224,Rotar; Vladimir,8,0,34,26
1657855946406,MATH 193A,A02,083225,Rotar; Vladimir,10,0,34,24
1657855946406,MATH 193A,A03,083781,Rotar; Vladimir,5,0,34,29
1657855946406,MATH 193A,A04,083782,Rotar; Vladimir,11,0,34,23
1657855946406,MATH 193A,A05,093482,Rotar; Vladimir,10,0,34,24
1657855952429,MATH 197,001,091859,McAuley; Julian John,9999,0,9999,0
1657855952429,MATH 197,002,095566,Kedlaya; Kiran S.,9997,0,9999,2
1657855952429,MATH 197,003,095567,Xiao; Ming,9999,0,9999,0
1657855952429,MATH 197,004,095571,Perols; Johan Lars,9998,0,9999,1
1657855959484,COGS 9,A01,083615,Shannon; Kyle Michael,10,0,75,65
1657855965508,COGS 11,A01,083617,Boyle; Mary E. T.,23,0,48,25
1657855971531,COGS 13,A01,083071,Bastos; Amalia Pinkusfeld,11,0,71,60
1657855977554,COGS 14A,A01,092681,Semenuks; Arturs,5,1,100,95
1657855983578,COGS 14B,A01,083073,Cheng; Tzu-Han,6,0,63,57
1657855989610,COGS 17,A01,092677,Semenuks; Arturs,6,0,81,75
1657855995636,COGS 100,A01,083619,Allen; Michael Gordon,17,0,70,53
1657856001670,COGS 101A,A01,083621,Davis; Joshua Daniel,9,0,68,59
1657856007694,COGS 101B,A01,091572,Allen; Michael Gordon,12,0,65,53
1657856013717,COGS 101C,A01,083625,Delgado; Tania,17,0,35,18
1657856019743,COGS 107A,A01,083627,Boyle; Mary E. T.,14,0,60,46
1657856025771,COGS 118A,A01,083075,Gupta; Anjum,21,0,76,55
1657856031807,CSE 3,A50,083646,Miranda; Gregory Joseph,24,0,50,26
1657856037831,CSE 8A,A50,083650,Miranda; Gregory Joseph,17,1,56,39
1657856043852,CSE 11,A01,083080,Cao; Yingjun,6,15,40,34
1657856049876,CSE 12,A01,083652,Krause-Levy; Sophia Louisa,29,1,120,91
1657856055905,CSE 15L,A01,083654,Morris; Justin Loren,9,0,50,41
1657856055905,CSE 15L,A02,083655,Morris; Justin Loren,9,0,50,41
1657856061928,CSE 20,A01,083657,Tran; Khoa Dang,39,0,80,41
1657856067951,CSE 21,A01,095574,Bach; Quang Tran,22,0,48,26
1657856073979,CSE 30,A01,083084,Eldon; John,6,0,80,74
1657856073979,CSE 30,B01,095061,Bhaskar; Nishant,9,0,50,41
1657856080001,CSE 100,A01,083659,Cao; Yingjun,5,4,70,65
1657856086023,CSE 134B,A01,083661,Powell; Thomas Allan,24,0,100,76
1657856092049,CSE 140,A01,083663,Gungor; Onat,15,0,85,70
1657856098073,CSE 140L,A01,083088,Eldon; John,23,0,100,77
1657856104099,CSE 175,A01,083665,Kumar; Rakesh,3,0,25,22
1657856110124,CSE 190,A00,092507,Dubnov; Shlomo,8,0,20,12
1657856116147,ECE 45,A01,083139,Congero; Spencer William,6,0,75,69
1657856122174,ECE 65,A50,083695,Saad; Andrew S,12,0,30,18
1657856122174,ECE 65,A51,095125,Saad; Andrew S,24,0,26,2
1657856128197,ECE 109,A01,091882,Touri; Behrouz,20,0,70,50
1657856134227,ECE 180,A00,083140,Abi Samra; Nicholas Camill,1,0,30,29
1657856134227,ECE 180,B00,083141,Abi Samra; Nicholas Camill,0,0,30,30
1657856140255,MATH 10A,A01,083735,Patchell; Gregory David,2,0,30,28
1657856140255,MATH 10A,A02,083736,Patchell; Gregory David,20,0,30,10
1657856140255,MATH 10A,A03,083737,Patchell; Gregory David,16,0,30,14
1657856146282,MATH 10B,A01,083207,Lim; Seonhee,8,0,34,26
1657856146282,MATH 10B,A02,083208,Lim; Seonhee,10,0,35,25
1657856146282,MATH 10B,A03,093472,Lim; Seonhee,7,0,34,27
1657856146282,MATH 10B,B01,083739,Sinha; Shubham,14,0,30,16
1657856152315,MATH 18,A01,083743,Cinel; Cameron Alexander,9,0,30,21
1657856152315,MATH 18,A02,083744,Cinel; Cameron Alexander,18,0,30,12
1657856152315,MATH 18,A03,083745,Cinel; Cameron Alexander,10,0,30,20
1657856152315,MATH 18,B01,083748,Rideout; David Porter,5,0,37,32
1657856152315,MATH 18,B02,083749,Rideout; David Porter,5,0,36,31
1657856152315,MATH 18,B03,083750,Rideout; David Porter,3,0,37,34
1657856152315,MATH 18,B04,083751,Rideout; David Porter,6,0,36,30
1657856152315,MATH 18,B05,093473,Rideout; David Porter,6,0,36,30
1657856152315,MATH 18,B06,093474,Rideout; David Porter,6,0,36,30
1657856158340,MATH 20A,A01,083754,Zheng; Zequn,14,0,40,26
1657856164362,MATH 20B,A01,083756,Briones; Jor-el Thomas Caparas,4,0,36,32
1657856164362,MATH 20B,A02,083757,Briones; Jor-el Thomas Caparas,1,0,36,35
1657856164362,MATH 20B,A03,093475,Briones; Jor-el Thomas Caparas,2,0,36,34
1657856170390,MATH 20C,A01,083760,Briones; Jor-el Thomas Caparas,1,0,35,34
1657856170390,MATH 20C,A02,083761,Briones; Jor-el Thomas Caparas,8,0,35,27
1657856170390,MATH 20C,A03,093476,Briones; Jor-el Thomas Caparas,0,1,36,36
1657856170390,MATH 20C,B01,083762,Bach; Quang Tran,1,0,30,29
1657856176414,MATH 20D,A01,083765,Tran; Brian Kha,5,0,30,25
1657856176414,MATH 20D,A02,083766,Tran; Brian Kha,5,0,30,25
1657856176414,MATH 20D,A03,083767,Tran; Brian Kha,5,0,30,25
1657856182441,MATH 20E,A01,083771,Ganguly; Soumya,10,0,32,22
1657856182441,MATH 20E,A02,083772,Ganguly; Soumya,6,0,32,26
1657856182441,MATH 20E,B01,083773,Ciotti; Benjamin,20,0,35,15
1657856182441,MATH 20E,B02,083774,Ciotti; Benjamin,18,0,35,17
1657856188464,MATH 103A,A01,083777,Greenfeld; Be'Eri,3,0,36,33
1657856188464,MATH 103A,A02,083778,Greenfeld; Be'Eri,5,0,36,31
1657856188464,MATH 103A,A03,093561,Greenfeld; Be'Eri,6,0,36,30
1657856188464,MATH 103A,B01,083779,Greenfeld; Be'Eri,7,0,36,29
1657856188464,MATH 103A,B02,083780,Greenfeld; Be'Eri,4,0,36,32
1657856188464,MATH 103A,B03,093562,Greenfeld; Be'Eri,3,0,36,33
1657856194486,MATH 105,A01,085443,Carter; Anne Toulson,15,0,35,20
1657856194486,MATH 105,A02,093477,Carter; Anne Toulson,20,0,35,15
1657856200510,MATH 109,A01,083213,Ganzberger; Geoffrey Michael,3,0,34,31
1657856200510,MATH 109,A02,083214,Ganzberger; Geoffrey Michael,4,0,34,30
1657856200510,MATH 109,A03,093478,Ganzberger; Geoffrey Michael,2,0,34,32
1657856200510,MATH 109,B01,083215,Ganzberger; Geoffrey Michael,1,0,32,31
1657856200510,MATH 109,B02,083216,Ganzberger; Geoffrey Michael,2,0,32,30
1657856200510,MATH 109,B03,093479,Ganzberger; Geoffrey Michael,8,0,32,24
1657856206540,MATH 142A,A01,083219,Chow; Bennett,7,0,32,25
1657856206540,MATH 142A,A02,083220,Chow; Bennett,10,0,32,22
1657856206540,MATH 142A,A03,093480,Chow; Bennett,9,0,32,23
1657856206540,MATH 142A,B03,093481,Chow; Bennett,8,0,32,24
1657856206540,MATH 142A,B04,093558,Chow; Bennett,13,0,32,19
1657856206540,MATH 142A,B05,093559,Chow; Bennett,7,0,32,25
1657856212568,MATH 193A,A01,083224,Rotar; Vladimir,8,0,34,26
1657856212568,MATH 193A,A02,083225,Rotar; Vladimir,10,0,34,24
1657856212568,MATH 193A,A03,083781,Rotar; Vladimir,5,0,34,29
1657856212568,MATH 193A,A04,083782,Rotar; Vladimir,11,0,34,23
1657856212568,MATH 193A,A05,093482,Rotar; Vladimir,10,0,34,24
1657856218588,MATH 197,001,091859,McAuley; Julian John,9999,0,9999,0
1657856218588,MATH 197,002,095566,Kedlaya; Kiran S.,9997,0,9999,2
1657856218588,MATH 197,003,095567,Xiao; Ming,9999,0,9999,0
1657856218588,MATH 197,004,095571,Perols; Johan Lars,9998,0,9999,1
1657856225650,COGS 9,A01,083615,Shannon; Kyle Michael,10,0,75,65
1657856231672,COGS 11,A01,083617,Boyle; Mary E. T.,23,0,48,25
1657856237699,COGS 13,A01,083071,Bastos; Amalia Pinkusfeld,11,0,71,60
1657856243722,COGS 14A,A01,092681,Semenuks; Arturs,5,1,100,95
1657856249745,COGS 14B,A01,083073,Cheng; Tzu-Han,6,0,63,57
1657856255776,COGS 17,A01,092677,Semenuks; Arturs,6,0,81,75
1657856261801,COGS 100,A01,083619,Allen; Michael Gordon,17,0,70,53
1657856267838,COGS 101A,A01,083621,Davis; Joshua Daniel,9,0,68,59
1657856273859,COGS 101B,A01,091572,Allen; Michael Gordon,12,0,65,53
1657856279885,COGS 101C,A01,083625,Delgado; Tania,17,0,35,18
1657856285908,COGS 107A,A01,083627,Boyle; Mary E. T.,14,0,60,46
1657856291937,COGS 118A,A01,083075,Gupta; Anjum,21,0,76,55
1657856297960,CSE 3,A50,083646,Miranda; Gregory Joseph,24,0,50,26
1657856303981,CSE 8A,A50,083650,Miranda; Gregory Joseph,17,1,56,39
1657856310008,CSE 11,A01,083080,Cao; Yingjun,6,15,40,34
1657856316034,CSE 12,A01,083652,Krause-Levy; Sophia Louisa,29,1,120,91
1657856322056,CSE 15L,A01,083654,Morris; Justin Loren,9,0,50,41
1657856322056,CSE 15L,A02,083655,Morris; Justin Loren,9,0,50,41
1657856328079,CSE 20,A01,083657,Tran; Khoa Dang,39,0,80,41
1657856334106,CSE 21,A01,095574,Bach; Quang Tran,22,0,48,26
1657856340130,CSE 30,A01,083084,Eldon; John,6,0,80,74
1657856340130,CSE 30,B01,095061,Bhaskar; Nishant,9,0,50,41
1657856346161,CSE 100,A01,083659,Cao; Yingjun,5,4,70,65
1657856352188,CSE 134B,A01,083661,Powell; Thomas Allan,24,0,100,76
1657856358209,CSE 140,A01,083663,Gungor; Onat,15,0,85,70
1657856364235,CSE 140L,A01,083088,Eldon; John,23,0,100,77
1657856370258,CSE 175,A01,083665,Kumar; Rakesh,3,0,25,22
1657856376284,CSE 190,A00,092507,Dubnov; Shlomo,8,0,20,12
1657856382312,ECE 45,A01,083139,Congero; Spencer William,6,0,75,69
1657856388336,ECE 65,A50,083695,Saad; Andrew S,12,0,30,18
1657856388336,ECE 65,A51,095125,Saad; Andrew S,24,0,26,2
1657856394459,ECE 109,A01,091882,Touri; Behrouz,20,0,70,50
1657856400483,ECE 180,A00,083140,Abi Samra; Nicholas Camill,1,0,30,29
1657856400483,ECE 180,B00,083141,Abi Samra; Nicholas Camill,0,0,30,30
1657856406505,MATH 10A,A01,083735,Patchell; Gregory David,2,0,30,28
1657856406505,MATH 10A,A02,083736,Patchell; Gregory David,20,0,30,10
1657856406505,MATH 10A,A03,083737,Patchell; Gregory David,16,0,30,14
1657856412533,MATH 10B,A01,083207,Lim; Seonhee,8,0,34,26
1657856412533,MATH 10B,A02,083208,Lim; Seonhee,10,0,35,25
1657856412533,MATH 10B,A03,093472,Lim; Seonhee,7,0,34,27
1657856412533,MATH 10B,B01,083739,Sinha; Shubham,14,0,30,16
1657856418556,MATH 18,A01,083743,Cinel; Cameron Alexander,9,0,30,21
1657856418556,MATH 18,A02,083744,Cinel; Cameron Alexander,18,0,30,12
1657856418556,MATH 18,A03,083745,Cinel; Cameron Alexander,10,0,30,20
1657856418556,MATH 18,B01,083748,Rideout; David Porter,5,0,37,32
1657856418556,MATH 18,B02,083749,Rideout; David Porter,5,0,36,31
1657856418556,MATH 18,B03,083750,Rideout; David Porter,3,0,37,34
1657856418556,MATH 18,B04,083751,Rideout; David Porter,6,0,36,30
1657856418556,MATH 18,B05,093473,Rideout; David Porter,6,0,36,30
1657856418556,MATH 18,B06,093474,Rideout; David Porter,6,0,36,30
1657856424578,MATH 20A,A01,083754,Zheng; Zequn,14,0,40,26
1657856430606,MATH 20B,A01,083756,Briones; Jor-el Thomas Caparas,4,0,36,32
1657856430606,MATH 20B,A02,083757,Briones; Jor-el Thomas Caparas,1,0,36,35
1657856430606,MATH 20B,A03,093475,Briones; Jor-el Thomas Caparas,2,0,36,34
1657856436630,MATH 20C,A01,083760,Briones; Jor-el Thomas Caparas,1,0,35,34
1657856436630,MATH 20C,A02,083761,Briones; Jor-el Thomas Caparas,8,0,35,27
1657856436630,MATH 20C,A03,093476,Briones; Jor-el Thomas Caparas,0,1,36,36
1657856436630,MATH 20C,B01,083762,Bach; Quang Tran,1,0,30,29
1657856442661,MATH 20D,A01,083765,Tran; Brian Kha,5,0,30,25
1657856442661,MATH 20D,A02,083766,Tran; Brian Kha,5,0,30,25
1657856442661,MATH 20D,A03,083767,Tran; Brian Kha,5,0,30,25
1657856448683,MATH 20E,A01,083771,Ganguly; Soumya,10,0,32,22
1657856448683,MATH 20E,A02,083772,Ganguly; Soumya,6,0,32,26
1657856448683,MATH 20E,B01,083773,Ciotti; Benjamin,20,0,35,15
1657856448683,MATH 20E,B02,083774,Ciotti; Benjamin,18,0,35,17
1657856454707,MATH 103A,A01,083777,Greenfeld; Be'Eri,3,0,36,33
1657856454707,MATH 103A,A02,083778,Greenfeld; Be'Eri,5,0,36,31
1657856454707,MATH 103A,A03,093561,Greenfeld; Be'Eri,6,0,36,30
1657856454707,MATH 103A,B01,083779,Greenfeld; Be'Eri,7,0,36,29
1657856454707,MATH 103A,B02,083780,Greenfeld; Be'Eri,4,0,36,32
1657856454707,MATH 103A,B03,093562,Greenfeld; Be'Eri,3,0,36,33
1657856460734,MATH 105,A01,085443,Carter; Anne Toulson,15,0,35,20
1657856460734,MATH 105,A02,093477,Carter; Anne Toulson,20,0,35,15
1657856466761,MATH 109,A01,083213,Ganzberger; Geoffrey Michael,3,0,34,31
1657856466761,MATH 109,A02,083214,Ganzberger; Geoffrey Michael,4,0,34,30
1657856466761,MATH 109,A03,093478,Ganzberger; Geoffrey Michael,2,0,34,32
1657856466761,MATH 109,B01,083215,Ganzberger; Geoffrey Michael,1,0,32,31
1657856466761,MATH 109,B02,083216,Ganzberger; Geoffrey Michael,2,0,32,30
1657856466761,MATH 109,B03,093479,Ganzberger; Geoffrey Michael,8,0,32,24
1657856472785,MATH 142A,A01,083219,Chow; Bennett,7,0,32,25
1657856472785,MATH 142A,A02,083220,Chow; Bennett,10,0,32,22
1657856472785,MATH 142A,A03,093480,Chow; Bennett,9,0,32,23
1657856472785,MATH 142A,B03,093481,Chow; Bennett,8,0,32,24
1657856472785,MATH 142A,B04,093558,Chow; Bennett,13,0,32,19
1657856472785,MATH 142A,B05,093559,Chow; Bennett,7,0,32,25
1657856478813,MATH 193A,A01,083224,Rotar; Vladimir,8,0,34,26
1657856478813,MATH 193A,A02,083225,Rotar; Vladimir,10,0,34,24
1657856478813,MATH 193A,A03,083781,Rotar; Vladimir,5,0,34,29
1657856478813,MATH 193A,A04,083782,Rotar; Vladimir,11,0,34,23
1657856478813,MATH 193A,A05,093482,Rotar; Vladimir,10,0,34,24
1657856484840,MATH 197,001,091859,McAuley; Julian John,9999,0,9999,0
1657856484840,MATH 197,002,095566,Kedlaya; Kiran S.,9997,0,9999,2
1657856484840,MATH 197,003,095567,Xiao; Ming,9999,0,9999,0
1657856484840,MATH 197,004,095571,Perols; Johan Lars,9998,0,9999,1
1657856491915,COGS 9,A01,083615,Shannon; Kyle Michael,10,0,75,65
1657856497941,COGS 11,A01,083617,Boyle; Mary E. T.,23,0,48,25
1657856503966,COGS 13,A01,083071,Bastos; Amalia Pinkusfeld,11,0,71,60
1657856509994,COGS 14A,A01,092681,Semenuks; Arturs,5,1,100,95
1657856516030,COGS 14B,A01,083073,Cheng; Tzu-Han,6,0,63,57
1657856522052,COGS 17,A01,092677,Semenuks; Arturs,6,0,81,75
1657856528075,COGS 100,A01,083619,Allen; Michael Gordon,17,0,70,53
1657856534102,COGS 101A,A01,083621,Davis; Joshua Daniel,9,0,68,59
1657856540126,COGS 101B,A01,091572,Allen; Michael Gordon,12,0,65,53
1657856546148,COGS 101C,A01,083625,Delgado; Tania,17,0,35,18
1657856552172,COGS 107A,A01,083627,Boyle; Mary E. T.,14,0,60,46
1657856558194,COGS 118A,A01,083075,Gupta; Anjum,21,0,76,55
1657856564222,CSE 3,A50,083646,Miranda; Gregory Joseph,24,0,50,26
1657856570244,CSE 8A,A50,083650,Miranda; Gregory Joseph,17,1,56,39
1657856576267,CSE 11,A01,083080,Cao; Yingjun,6,15,40,34
1657856582290,CSE 12,A01,083652,Krause-Levy; Sophia Louisa,29,1,120,91
1657856588328,CSE 15L,A01,083654,Morris; Justin Loren,9,0,50,41
1657856588328,CSE 15L,A02,083655,Morris; Justin Loren,9,0,50,41
1657856594349,CSE 20,A01,083657,Tran; Khoa Dang,39,0,80,41
1657856600372,CSE 21,A01,095574,Bach; Quang Tran,22,0,48,26
1657856606395,CSE 30,A01,083084,Eldon; John,6,0,80,74
1657856606395,CSE 30,B01,095061,Bhaskar; Nishant,9,0,50,41
1657856612418,CSE 100,A01,083659,Cao; Yingjun,5,4,70,65
1657856618440,CSE 134B,A01,083661,Powell; Thomas Allan,24,0,100,76
1657856624466,CSE 140,A01,083663,Gungor; Onat,15,0,85,70
1657856630493,CSE 140L,A01,083088,Eldon; John,23,0,100,77
1657856636515,CSE 175,A01,083665,Kumar; Rakesh,3,0,25,22
1657856642539,CSE 190,A00,092507,Dubnov; Shlomo,8,0,20,12
1657856648566,ECE 45,A01,083139,Congero; Spencer William,6,0,75,69
1657856654588,ECE 65,A50,083695,Saad; Andrew S,12,0,30,18
1657856654588,ECE 65,A51,095125,Saad; Andrew S,24,0,26,2
1657856660610,ECE 109,A01,091882,Touri; Behrouz,20,0,70,50
1657856666634,ECE 180,A00,083140,Abi Samra; Nicholas Camill,1,0,30,29
1657856666634,ECE 180,B00,083141,Abi Samra; Nicholas Camill,0,0,30,30
1657856672657,MATH 10A,A01,083735,Patchell; Gregory David,2,0,30,28
1657856672657,MATH 10A,A02,083736,Patchell; Gregory David,20,0,30,10
1657856672657,MATH 10A,A03,083737,Patchell; Gregory David,16,0,30,14
1657856678682,MATH 10B,A01,083207,Lim; Seonhee,8,0,34,26
1657856678682,MATH 10B,A02,083208,Lim; Seonhee,10,0,35,25
1657856678682,MATH 10B,A03,093472,Lim; Seonhee,7,0,34,27
1657856678682,MATH 10B,B01,083739,Sinha; Shubham,14,0,30,16
1657856684714,MATH 18,A01,083743,Cinel; Cameron Alexander,9,0,30,21
1657856684714,MATH 18,A02,083744,Cinel; Cameron Alexander,18,0,30,12
1657856684714,MATH 18,A03,083745,Cinel; Cameron Alexander,10,0,30,20
1657856684714,MATH 18,B01,083748,Rideout; David Porter,5,0,37,32
1657856684714,MATH 18,B02,083749,Rideout; David Porter,5,0,36,31
1657856684714,MATH 18,B03,083750,Rideout; David Porter,3,0,37,34
1657856684714,MATH 18,B04,083751,Rideout; David Porter,6,0,36,30
1657856684714,MATH 18,B05,093473,Rideout; David Porter,6,0,36,30
1657856684714,MATH 18,B06,093474,Rideout; David Porter,6,0,36,30
1657856690755,MATH 20A,A01,083754,Zheng; Zequn,14,0,40,26
1657856696782,MATH 20B,A01,083756,Briones; Jor-el Thomas Caparas,4,0,36,32
1657856696782,MATH 20B,A02,083757,Briones; Jor-el Thomas Caparas,1,0,36,35
1657856696782,MATH 20B,A03,093475,Briones; Jor-el Thomas Caparas,2,0,36,34
1657856702804,MATH 20C,A01,083760,Briones; Jor-el Thomas Caparas,1,0,35,34
1657856702804,MATH 20C,A02,083761,Briones; Jor-el Thomas Caparas,8,0,35,27
1657856702804,MATH 20C,A03,093476,Briones; Jor-el Thomas Caparas,0,1,36,36
1657856702804,MATH 20C,B01,083762,Bach; Quang Tran,1,0,30,29
1657856708839,MATH 20D,A01,083765,Tran; Brian Kha,5,0,30,25
1657856708839,MATH 20D,A02,083766,Tran; Brian Kha,5,0,30,25
1657856708839,MATH 20D,A03,083767,Tran; Brian Kha,5,0,30,25
1657856714861,MATH 20E,A01,083771,Ganguly; Soumya,10,0,32,22
1657856714861,MATH 20E,A02,083772,Ganguly; Soumya,6,0,32,26
1657856714861,MATH 20E,B01,083773,Ciotti; Benjamin,20,0,35,15
1657856714861,MATH 20E,B02,083774,Ciotti; Benjamin,18,0,35,17
1657856720886,MATH 103A,A01,083777,Greenfeld; Be'Eri,3,0,36,33
1657856720886,MATH 103A,A02,083778,Greenfeld; Be'Eri,5,0,36,31
1657856720886,MATH 103A,A03,093561,Greenfeld; Be'Eri,6,0,36,30
1657856720886,MATH 103A,B01,083779,Greenfeld; Be'Eri,7,0,36,29
1657856720886,MATH 103A,B02,083780,Greenfeld; Be'Eri,4,0,36,32
1657856720886,MATH 103A,B03,093562,Greenfeld; Be'Eri,3,0,36,33
1657856726912,MATH 105,A01,085443,Carter; Anne Toulson,15,0,35,20
1657856726912,MATH 105,A02,093477,Carter; Anne Toulson,20,0,35,15
1657856732937,MATH 109,A01,083213,Ganzberger; Geoffrey Michael,3,0,34,31
1657856732937,MATH 109,A02,083214,Ganzberger; Geoffrey Michael,4,0,34,30
1657856732937,MATH 109,A03,093478,Ganzberger; Geoffrey Michael,2,0,34,32
1657856732937,MATH 109,B01,083215,Ganzberger; Geoffrey Michael,1,0,32,31
1657856732937,MATH 109,B02,083216,Ganzberger; Geoffrey Michael,2,0,32,30
1657856732937,MATH 109,B03,093479,Ganzberger; Geoffrey Michael,8,0,32,24
1657856738966,MATH 142A,A01,083219,Chow; Bennett,7,0,32,25
1657856738966,MATH 142A,A02,083220,Chow; Bennett,10,0,32,22
1657856738966,MATH 142A,A03,093480,Chow; Bennett,9,0,32,23
1657856738966,MATH 142A,B03,093481,Chow; Bennett,8,0,32,24
1657856738966,MATH 142A,B04,093558,Chow; Bennett,13,0,32,19
1657856738966,MATH 142A,B05,093559,Chow; Bennett,7,0,32,25
1657856744996,MATH 193A,A01,083224,Rotar; Vladimir,8,0,34,26
1657856744996,MATH 193A,A02,083225,Rotar; Vladimir,10,0,34,24
1657856744996,MATH 193A,A03,083781,Rotar; Vladimir,5,0,34,29
1657856744996,MATH 193A,A04,083782,Rotar; Vladimir,11,0,34,23
1657856744996,MATH 193A,A05,093482,Rotar; Vladimir,10,0,34,24
1657856751018,MATH 197,001,091859,McAuley; Julian John,9999,0,9999,0
1657856751018,MATH 197,002,095566,Kedlaya; Kiran S.,9997,0,9999,2
1657856751018,MATH 197,003,095567,Xiao; Ming,9999,0,9999,0
1657856751018,MATH 197,004,095571,Perols; Johan Lars,9998,0,9999,1
1657856758083,COGS 9,A01,083615,Shannon; Kyle Michael,10,0,75,65
1657856764112,COGS 11,A01,083617,Boyle; Mary E. T.,23,0,48,25
1657856770139,COGS 13,A01,083071,Bastos; Amalia Pinkusfeld,11,0,71,60
1657856776162,COGS 14A,A01,092681,Semenuks; Arturs,5,1,100,95
1657856782187,COGS 14B,A01,083073,Cheng; Tzu-Han,6,0,63,57
1657856788212,COGS 17,A01,092677,Semenuks; Arturs,6,0,81,75
1657856794233,COGS 100,A01,083619,Allen; Michael Gordon,17,0,70,53
1657856800260,COGS 101A,A01,083621,Davis; Joshua Daniel,9,0,68,59
1657856806282,COGS 101B,A01,091572,Allen; Michael Gordon,12,0,65,53
1657856812308,COGS 101C,A01,083625,Delgado; Tania,17,0,35,18
1657856818332,COGS 107A,A01,083627,Boyle; Mary E. T.,14,0,60,46
1657856824361,COGS 118A,A01,083075,Gupta; Anjum,21,0,76,55
1657856830390,CSE 3,A50,083646,Miranda; Gregory Joseph,24,0,50,26
1657856836413,CSE 8A,A50,083650,Miranda; Gregory Joseph,17,1,56,39
1657856842451,CSE 11,A01,083080,Cao; Yingjun,6,15,40,34
1657856848474,CSE 12,A01,083652,Krause-Levy; Sophia Louisa,29,1,120,91
1657856854497,CSE 15L,A01,083654,Morris; Justin Loren,9,0,50,41
1657856854497,CSE 15L,A02,083655,Morris; Justin Loren,9,0,50,41
1657856860521,CSE 20,A01,083657,Tran; Khoa Dang,39,0,80,41
1657856866548,CSE 21,A01,095574,Bach; Quang Tran,22,0,48,26
1657856872577,CSE 30,A01,083084,Eldon; John,6,0,80,74
1657856872577,CSE 30,B01,095061,Bhaskar; Nishant,9,0,50,41
1657856878600,CSE 100,A01,083659,Cao; Yingjun,5,4,70,65
1657856884621,CSE 134B,A01,083661,Powell; Thomas Allan,24,0,100,76
1657856890648,CSE 140,A01,083663,Gungor; Onat,15,0,85,70
1657856896674,CSE 140L,A01,083088,Eldon; John,23,0,100,77
1657856902696,CSE 175,A01,083665,Kumar; Rakesh,3,0,25,22
1657856908718,CSE 190,A00,092507,Dubnov; Shlomo,8,0,20,12
1657856914739,ECE 45,A01,083139,Congero; Spencer William,6,0,75,69
1657856920764,ECE 65,A50,083695,Saad; Andrew S,12,0,30,18
1657856920764,ECE 65,A51,095125,Saad; Andrew S,24,0,26,2
1657856926799,ECE 109,A01,091882,Touri; Behrouz,20,0,70,50
1657856932827,ECE 180,A00,083140,Abi Samra; Nicholas Camill,1,0,30,29
1657856932827,ECE 180,B00,083141,Abi Samra; Nicholas Camill,0,0,30,30
1657856938851,MATH 10A,A01,083735,Patchell; Gregory David,2,0,30,28
1657856938851,MATH 10A,A02,083736,Patchell; Gregory David,20,0,30,10
1657856938851,MATH 10A,A03,083737,Patchell; Gregory David,16,0,30,14
1657856944881,MATH 10B,A01,083207,Lim; Seonhee,8,0,34,26
1657856944881,MATH 10B,A02,083208,Lim; Seonhee,10,0,35,25
1657856944881,MATH 10B,A03,093472,Lim; Seonhee,7,0,34,27
1657856944881,MATH 10B,B01,083739,Sinha; Shubham,14,0,30,16
1657856950912,MATH 18,A01,083743,Cinel; Cameron Alexander,9,0,30,21
1657856950912,MATH 18,A02,083744,Cinel; Cameron Alexander,18,0,30,12
1657856950912,MATH 18,A03,083745,Cinel; Cameron Alexander,10,0,30,20
1657856950912,MATH 18,B01,083748,Rideout; David Porter,5,0,37,32
1657856950912,MATH 18,B02,083749,Rideout; David Porter,5,0,36,31
1657856950912,MATH 18,B03,083750,Rideout; David Porter,3,0,37,34
1657856950912,MATH 18,B04,083751,Rideout; David Porter,6,0,36,30
1657856950912,MATH 18,B05,093473,Rideout; David Porter,6,0,36,30
1657856950912,MATH 18,B06,093474,Rideout; David Porter,6,0,36,30
1657856956938,MATH 20A,A01,083754,Zheng; Zequn,14,0,40,26
1657856962961,MATH 20B,A01,083756,Briones; Jor-el Thomas Caparas,4,0,36,32
1657856962961,MATH 20B,A02,083757,Briones; Jor-el Thomas Caparas,1,0,36,35
1657856962961,MATH 20B,A03,093475,Briones; Jor-el Thomas Caparas,2,0,36,34
1657856968989,MATH 20C,A01,083760,Briones; Jor-el Thomas Caparas,1,0,35,34
1657856968989,MATH 20C,A02,083761,Briones; Jor-el Thomas Caparas,8,0,35,27
1657856968989,MATH 20C,A03,093476,Briones; Jor-el Thomas Caparas,0,1,36,36
1657856968989,MATH 20C,B01,083762,Bach; Quang Tran,1,0,30,29
1657856975018,MATH 20D,A01,083765,Tran; Brian Kha,5,0,30,25
1657856975018,MATH 20D,A02,083766,Tran; Brian Kha,5,0,30,25
1657856975018,MATH 20D,A03,083767,Tran; Brian Kha,5,0,30,25
1657856981045,MATH 20E,A01,083771,Ganguly; Soumya,10,0,32,22
1657856981045,MATH 20E,A02,083772,Ganguly; Soumya,6,0,32,26
1657856981045,MATH 20E,B01,083773,Ciotti; Benjamin,20,0,35,15
1657856981045,MATH 20E,B02,083774,Ciotti; Benjamin,18,0,35,17
1657856987076,MATH 103A,A01,083777,Greenfeld; Be'Eri,3,0,36,33
1657856987076,MATH 103A,A02,083778,Greenfeld; Be'Eri,5,0,36,31
1657856987076,MATH 103A,A03,093561,Greenfeld; Be'Eri,6,0,36,30
1657856987076,MATH 103A,B01,083779,Greenfeld; Be'Eri,7,0,36,29
1657856987076,MATH 103A,B02,083780,Greenfeld; Be'Eri,4,0,36,32
1657856987076,MATH 103A,B03,093562,Greenfeld; Be'Eri,3,0,36,33
1657856993177,MATH 105,A01,085443,Carter; Anne Toulson,15,0,35,20
1657856993177,MATH 105,A02,093477,Carter; Anne Toulson,20,0,35,15
1657856999209,MATH 109,A01,083213,Ganzberger; Geoffrey Michael,3,0,34,31
1657856999209,MATH 109,A02,083214,Ganzberger; Geoffrey Michael,4,0,34,30
1657856999209,MATH 109,A03,093478,Ganzberger; Geoffrey Michael,2,0,34,32
1657856999209,MATH 109,B01,083215,Ganzberger; Geoffrey Michael,1,0,32,31
1657856999209,MATH 109,B02,083216,Ganzberger; Geoffrey Michael,2,0,32,30
1657856999209,MATH 109,B03,093479,Ganzberger; Geoffrey Michael,8,0,32,24
1657857005245,MATH 142A,A01,083219,Chow; Bennett,7,0,32,25
1657857005245,MATH 142A,A02,083220,Chow; Bennett,10,0,32,22
1657857005245,MATH 142A,A03,093480,Chow; Bennett,9,0,32,23
1657857005245,MATH 142A,B03,093481,Chow; Bennett,8,0,32,24
1657857005245,MATH 142A,B04,093558,Chow; Bennett,13,0,32,19
1657857005245,MATH 142A,B05,093559,Chow; Bennett,7,0,32,25
1657857011272,MATH 193A,A01,083224,Rotar; Vladimir,8,0,34,26
1657857011272,MATH 193A,A02,083225,Rotar; Vladimir,10,0,34,24
1657857011272,MATH 193A,A03,083781,Rotar; Vladimir,5,0,34,29
1657857011272,MATH 193A,A04,083782,Rotar; Vladimir,11,0,34,23
1657857011272,MATH 193A,A05,093482,Rotar; Vladimir,10,0,34,24
1657857017299,MATH 197,001,091859,McAuley; Julian John,9999,0,9999,0
1657857017299,MATH 197,002,095566,Kedlaya; Kiran S.,9997,0,9999,2
1657857017299,MATH 197,003,095567,Xiao; Ming,9999,0,9999,0
1657857017299,MATH 197,004,095571,Perols; Johan Lars,9998,0,9999,1
1657857024348,COGS 9,A01,083615,Shannon; Kyle Michael,10,0,75,65
1657857030374,COGS 11,A01,083617,Boyle; Mary E. T.,23,0,48,25
1657857036397,COGS 13,A01,083071,Bastos; Amalia Pinkusfeld,11,0,71,60
1657857042420,COGS 14A,A01,092681,Semenuks; Arturs,5,1,100,95
1657857048444,COGS 14B,A01,083073,Cheng; Tzu-Han,6,0,63,57
1657857054466,COGS 17,A01,092677,Semenuks; Arturs,6,0,81,75
1657857060487,COGS 100,A01,083619,Allen; Michael Gordon,17,0,70,53
1657857066510,COGS 101A,A01,083621,Davis; Joshua Daniel,9,0,68,59
1657857072537,COGS 101B,A01,091572,Allen; Michael Gordon,12,0,65,53
1657857078567,COGS 101C,A01,083625,Delgado; Tania,17,0,35,18
1657857084598,COGS 107A,A01,083627,Boyle; Mary E. T.,14,0,60,46
1657857090628,COGS 118A,A01,083075,Gupta; Anjum,21,0,76,55
1657857096660,CSE 3,A50,083646,Miranda; Gregory Joseph,24,0,50,26
1657857102685,CSE 8A,A50,083650,Miranda; Gregory Joseph,17,1,56,39
1657857108710,CSE 11,A01,083080,Cao; Yingjun,6,15,40,34
1657857114739,CSE 12,A01,083652,Krause-Levy; Sophia Louisa,29,1,120,91
1657857120762,CSE 15L,A01,083654,Morris; Justin Loren,9,0,50,41
1657857120762,CSE 15L,A02,083655,Morris; Justin Loren,9,0,50,41
1657857126796,CSE 20,A01,083657,Tran; Khoa Dang,39,0,80,41
1657857132824,CSE 21,A01,095574,Bach; Quang Tran,22,0,48,26
1657857138847,CSE 30,A01,083084,Eldon; John,6,0,80,74
1657857138847,CSE 30,B01,095061,Bhaskar; Nishant,9,0,50,41
1657857144869,CSE 100,A01,083659,Cao; Yingjun,5,4,70,65
1657857150896,CSE 134B,A01,083661,Powell; Thomas Allan,24,0,100,76
1657857156918,CSE 140,A01,083663,Gungor; Onat,15,0,85,70
1657857162940,CSE 140L,A01,083088,Eldon; John,23,0,100,77
1657857168963,CSE 175,A01,083665,Kumar; Rakesh,3,0,25,22
1657857174994,CSE 190,A00,092507,Dubnov; Shlomo,8,0,20,12
1657857181015,ECE 45,A01,083139,Congero; Spencer William,6,0,75,69
1657857187039,ECE 65,A50,083695,Saad; Andrew S,12,0,30,18
1657857187039,ECE 65,A51,095125,Saad; Andrew S,24,0,26,2
1657857193065,ECE 109,A01,091882,Touri; Behrouz,20,0,70,50
1657857199087,ECE 180,A00,083140,Abi Samra; Nicholas Camill,1,0,30,29
1657857199087,ECE 180,B00,083141,Abi Samra; Nicholas Camill,0,0,30,30
1657857205111,MATH 10A,A01,083735,Patchell; Gregory David,2,0,30,28
1657857205111,MATH 10A,A02,083736,Patchell; Gregory David,20,0,30,10
1657857205111,MATH 10A,A03,083737,Patchell; Gregory David,16,0,30,14
1657857211133,MATH 10B,A01,083207,Lim; Seonhee,8,0,34,26
1657857211133,MATH 10B,A02,083208,Lim; Seonhee,10,0,35,25
1657857211133,MATH 10B,A03,093472,Lim; Seonhee,7,0,34,27
1657857211133,MATH 10B,B01,083739,Sinha; Shubham,14,0,30,16
1657857217165,MATH 18,A01,083743,Cinel; Cameron Alexander,9,0,30,21
1657857217165,MATH 18,A02,083744,Cinel; Cameron Alexander,18,0,30,12
1657857217165,MATH 18,A03,083745,Cinel; Cameron Alexander,10,0,30,20
1657857217165,MATH 18,B01,083748,Rideout; David Porter,5,0,37,32
1657857217165,MATH 18,B02,083749,Rideout; David Porter,5,0,36,31
1657857217165,MATH 18,B03,083750,Rideout; David Porter,3,0,37,34
1657857217165,MATH 18,B04,083751,Rideout; David Porter,6,0,36,30
1657857217165,MATH 18,B05,093473,Rideout; David Porter,6,0,36,30
1657857217165,MATH 18,B06,093474,Rideout; David Porter,6,0,36,30
1657857223192,MATH 20A,A01,083754,Zheng; Zequn,14,0,40,26
1657857229221,MATH 20B,A01,083756,Briones; Jor-el Thomas Caparas,4,0,36,32
1657857229221,MATH 20B,A02,083757,Briones; Jor-el Thomas Caparas,1,0,36,35
1657857229221,MATH 20B,A03,093475,Briones; Jor-el Thomas Caparas,2,0,36,34
1657857235263,MATH 20C,A01,083760,Briones; Jor-el Thomas Caparas,1,0,35,34
1657857235263,MATH 20C,A02,083761,Briones; Jor-el Thomas Caparas,8,0,35,27
1657857235263,MATH 20C,A03,093476,Briones; Jor-el Thomas Caparas,0,1,36,36
1657857235263,MATH 20C,B01,083762,Bach; Quang Tran,1,0,30,29
1657857241286,MATH 20D,A01,083765,Tran; Brian Kha,5,0,30,25
1657857241286,MATH 20D,A02,083766,Tran; Brian Kha,5,0,30,25
1657857241286,MATH 20D,A03,083767,Tran; Brian Kha,5,0,30,25
1657857247331,MATH 20E,A01,083771,Ganguly; Soumya,10,0,32,22
1657857247331,MATH 20E,A02,083772,Ganguly; Soumya,6,0,32,26
1657857247331,MATH 20E,B01,083773,Ciotti; Benjamin,20,0,35,15
1657857247331,MATH 20E,B02,083774,Ciotti; Benjamin,18,0,35,17
1657857253365,MATH 103A,A01,083777,Greenfeld; Be'Eri,3,0,36,33
1657857253365,MATH 103A,A02,083778,Greenfeld; Be'Eri,5,0,36,31
1657857253365,MATH 103A,A03,093561,Greenfeld; Be'Eri,6,0,36,30
1657857253365,MATH 103A,B01,083779,Greenfeld; Be'Eri,7,0,36,29
1657857253365,MATH 103A,B02,083780,Greenfeld; Be'Eri,4,0,36,32
1657857253365,MATH 103A,B03,093562,Greenfeld; Be'Eri,3,0,36,33
1657857259390,MATH 105,A01,085443,Carter; Anne Toulson,15,0,35,20
1657857259390,MATH 105,A02,093477,Carter; Anne Toulson,20,0,35,15
1657857265418,MATH 109,A01,083213,Ganzberger; Geoffrey Michael,3,0,34,31
1657857265418,MATH 109,A02,083214,Ganzberger; Geoffrey Michael,4,0,34,30
1657857265418,MATH 109,A03,093478,Ganzberger; Geoffrey Michael,2,0,34,32
1657857265418,MATH 109,B01,083215,Ganzberger; Geoffrey Michael,1,0,32,31
1657857265418,MATH 109,B02,083216,Ganzberger; Geoffrey Michael,2,0,32,30
1657857265418,MATH 109,B03,093479,Ganzberger; Geoffrey Michael,8,0,32,24
1657857271451,MATH 142A,A01,083219,Chow; Bennett,7,0,32,25
1657857271451,MATH 142A,A02,083220,Chow; Bennett,10,0,32,22
1657857271451,MATH 142A,A03,093480,Chow; Bennett,9,0,32,23
1657857271451,MATH 142A,B03,093481,Chow; Bennett,8,0,32,24
1657857271451,MATH 142A,B04,093558,Chow; Bennett,13,0,32,19
1657857271451,MATH 142A,B05,093559,Chow; Bennett,7,0,32,25
1657857277479,MATH 193A,A01,083224,Rotar; Vladimir,8,0,34,26
1657857277479,MATH 193A,A02,083225,Rotar; Vladimir,10,0,34,24
1657857277479,MATH 193A,A03,083781,Rotar; Vladimir,5,0,34,29
1657857277479,MATH 193A,A04,083782,Rotar; Vladimir,11,0,34,23
1657857277479,MATH 193A,A05,093482,Rotar; Vladimir,10,0,34,24
1657857283501,MATH 197,001,091859,McAuley; Julian John,9999,0,9999,0
1657857283501,MATH 197,002,095566,Kedlaya; Kiran S.,9997,0,9999,2
1657857283501,MATH 197,003,095567,Xiao; Ming,9999,0,9999,0
1657857283501,MATH 197,004,095571,Perols; Johan Lars,9998,0,9999,1
1657857290566,COGS 9,A01,083615,Shannon; Kyle Michael,10,0,75,65
1657857296593,COGS 11,A01,083617,Boyle; Mary E. T.,23,0,48,25
1657857302617,COGS 13,A01,083071,Bastos; Amalia Pinkusfeld,11,0,71,60
1657857308641,COGS 14A,A01,092681,Semenuks; Arturs,5,1,100,95
1657857314668,COGS 14B,A01,083073,Cheng; Tzu-Han,6,0,63,57
1657857320701,COGS 17,A01,092677,Semenuks; Arturs,6,0,81,75
1657857326728,COGS 100,A01,083619,Allen; Michael Gordon,17,0,70,53
1657857332751,COGS 101A,A01,083621,Davis; Joshua Daniel,9,0,68,59
1657857338777,COGS 101B,A01,091572,Allen; Michael Gordon,12,0,65,53
1657857344811,COGS 101C,A01,083625,Delgado; Tania,17,0,35,18
1657857350834,COGS 107A,A01,083627,Boyle; Mary E. T.,14,0,60,46
1657857356859,COGS 118A,A01,083075,Gupta; Anjum,21,0,76,55
1657857362886,CSE 3,A50,083646,Miranda; Gregory Joseph,24,0,50,26
1657857368909,CSE 8A,A50,083650,Miranda; Gregory Joseph,17,1,56,39
1657857374936,CSE 11,A01,083080,Cao; Yingjun,6,15,40,34
1657857380959,CSE 12,A01,083652,Krause-Levy; Sophia Louisa,29,1,120,91
1657857387003,CSE 15L,A01,083654,Morris; Justin Loren,9,0,50,41
1657857387003,CSE 15L,A02,083655,Morris; Justin Loren,9,0,50,41
1657857393029,CSE 20,A01,083657,Tran; Khoa Dang,39,0,80,41
1657857399062,CSE 21,A01,095574,Bach; Quang Tran,22,0,48,26
1657857405095,CSE 30,A01,083084,Eldon; John,6,0,80,74
1657857405095,CSE 30,B01,095061,Bhaskar; Nishant,9,0,50,41
1657857411117,CSE 100,A01,083659,Cao; Yingjun,5,4,70,65
1657857417145,CSE 134B,A01,083661,Powell; Thomas Allan,24,0,100,76
1657857423168,CSE 140,A01,083663,Gungor; Onat,15,0,85,70
1657857429200,CSE 140L,A01,083088,Eldon; John,23,0,100,77
1657857435226,CSE 175,A01,083665,Kumar; Rakesh,3,0,25,22
1657857441252,CSE 190,A00,092507,Dubnov; Shlomo,8,0,20,12
1657857447280,ECE 45,A01,083139,Congero; Spencer William,6,0,75,69
1657857453303,ECE 65,A50,083695,Saad; Andrew S,12,0,30,18
1657857453303,ECE 65,A51,095125,Saad; Andrew S,24,0,26,2
1657857459328,ECE 109,A01,091882,Touri; Behrouz,20,0,70,50
1657857465351,ECE 180,A00,083140,Abi Samra; Nicholas Camill,1,0,30,29
1657857465351,ECE 180,B00,083141,Abi Samra; Nicholas Camill,0,0,30,30
1657857471375,MATH 10A,A01,083735,Patchell; Gregory David,2,0,30,28
1657857471375,MATH 10A,A02,083736,Patchell; Gregory David,20,0,30,10
1657857471375,MATH 10A,A03,083737,Patchell; Gregory David,16,0,30,14
1657857477404,MATH 10B,A01,083207,Lim; Seonhee,8,0,34,26
1657857477404,MATH 10B,A02,083208,Lim; Seonhee,10,0,35,25
1657857477404,MATH 10B,A03,093472,Lim; Seonhee,7,0,34,27
1657857477404,MATH 10B,B01,083739,Sinha; Shubham,14,0,30,16
1657857483434,MATH 18,A01,083743,Cinel; Cameron Alexander,9,0,30,21
1657857483434,MATH 18,A02,083744,Cinel; Cameron Alexander,18,0,30,12
1657857483434,MATH 18,A03,083745,Cinel; Cameron Alexander,10,0,30,20
1657857483434,MATH 18,B01,083748,Rideout; David Porter,5,0,37,32
1657857483434,MATH 18,B02,083749,Rideout; David Porter,5,0,36,31
1657857483434,MATH 18,B03,083750,Rideout; David Porter,3,0,37,34
1657857483434,MATH 18,B04,083751,Rideout; David Porter,6,0,36,30
1657857483434,MATH 18,B05,093473,Rideout; David Porter,6,0,36,30
1657857483434,MATH 18,B06,093474,Rideout; David Porter,6,0,36,30
1657857489462,MATH 20A,A01,083754,Zheng; Zequn,14,0,40,26
1657857495485,MATH 20B,A01,083756,Briones; Jor-el Thomas Caparas,4,0,36,32
1657857495485,MATH 20B,A02,083757,Briones; Jor-el Thomas Caparas,1,0,36,35
1657857495485,MATH 20B,A03,093475,Briones; Jor-el Thomas Caparas,2,0,36,34
1657857501518,MATH 20C,A01,083760,Briones; Jor-el Thomas Caparas,1,0,35,34
1657857501518,MATH 20C,A02,083761,Briones; Jor-el Thomas Caparas,8,0,35,27
1657857501518,MATH 20C,A03,093476,Briones; Jor-el Thomas Caparas,0,1,36,36
1657857501518,MATH 20C,B01,083762,Bach; Quang Tran,1,0,30,29
1657857507545,MATH 20D,A01,083765,Tran; Brian Kha,5,0,30,25
1657857507545,MATH 20D,A02,083766,Tran; Brian Kha,5,0,30,25
1657857507545,MATH 20D,A03,083767,Tran; Brian Kha,5,0,30,25
1657857513572,MATH 20E,A01,083771,Ganguly; Soumya,10,0,32,22
1657857513572,MATH 20E,A02,083772,Ganguly; Soumya,6,0,32,26
1657857513572,MATH 20E,B01,083773,Ciotti; Benjamin,20,0,35,15
1657857513572,MATH 20E,B02,083774,Ciotti; Benjamin,18,0,35,17
1657857519601,MATH 103A,A01,083777,Greenfeld; Be'Eri,3,0,36,33
1657857519601,MATH 103A,A02,083778,Greenfeld; Be'Eri,5,0,36,31
1657857519601,MATH 103A,A03,093561,Greenfeld; Be'Eri,6,0,36,30
1657857519601,MATH 103A,B01,083779,Greenfeld; Be'Eri,7,0,36,29
1657857519601,MATH 103A,B02,083780,Greenfeld; Be'Eri,4,0,36,32
1657857519601,MATH 103A,B03,093562,Greenfeld; Be'Eri,3,0,36,33
1657857525627,MATH 105,A01,085443,Carter; Anne Toulson,15,0,35,20
1657857525627,MATH 105,A02,093477,Carter; Anne Toulson,20,0,35,15
1657857531655,MATH 109,A01,083213,Ganzberger; Geoffrey Michael,3,0,34,31
1657857531655,MATH 109,A02,083214,Ganzberger; Geoffrey Michael,4,0,34,30
1657857531655,MATH 109,A03,093478,Ganzberger; Geoffrey Michael,2,0,34,32
1657857531655,MATH 109,B01,083215,Ganzberger; Geoffrey Michael,1,0,32,31
1657857531655,MATH 109,B02,083216,Ganzberger; Geoffrey Michael,2,0,32,30
1657857531655,MATH 109,B03,093479,Ganzberger; Geoffrey Michael,8,0,32,24
1657857537678,MATH 142A,A01,083219,Chow; Bennett,7,0,32,25
1657857537678,MATH 142A,A02,083220,Chow; Bennett,10,0,32,22
1657857537678,MATH 142A,A03,093480,Chow; Bennett,9,0,32,23
1657857537678,MATH 142A,B03,093481,Chow; Bennett,8,0,32,24
1657857537678,MATH 142A,B04,093558,Chow; Bennett,13,0,32,19
1657857537678,MATH 142A,B05,093559,Chow; Bennett,7,0,32,25
1657857543707,MATH 193A,A01,083224,Rotar; Vladimir,8,0,34,26
1657857543707,MATH 193A,A02,083225,Rotar; Vladimir,10,0,34,24
1657857543707,MATH 193A,A03,083781,Rotar; Vladimir,5,0,34,29
1657857543707,MATH 193A,A04,083782,Rotar; Vladimir,11,0,34,23
1657857543707,MATH 193A,A05,093482,Rotar; Vladimir,10,0,34,24
1657857549733,MATH 197,001,091859,McAuley; Julian John,9999,0,9999,0
1657857549733,MATH 197,002,095566,Kedlaya; Kiran S.,9997,0,9999,2
1657857549733,MATH 197,003,095567,Xiao; Ming,9999,0,9999,0
1657857549733,MATH 197,004,095571,Perols; Johan Lars,9998,0,9999,1
1657857556783,COGS 9,A01,083615,Shannon; Kyle Michael,10,0,75,65
1657857562805,COGS 11,A01,083617,Boyle; Mary E. T.,23,0,48,25
1657857568831,COGS 13,A01,083071,Bastos; Amalia Pinkusfeld,11,0,71,60
1657857574853,COGS 14A,A01,092681,Semenuks; Arturs,5,1,100,95
1657857580880,COGS 14B,A01,083073,Cheng; Tzu-Han,6,0,63,57
1657857586975,COGS 17,A01,092677,Semenuks; Arturs,6,0,81,75
1657857592998,COGS 100,A01,083619,Allen; Michael Gordon,17,0,70,53
1657857599035,COGS 101A,A01,083621,Davis; Joshua Daniel,9,0,68,59
1657857605058,COGS 101B,A01,091572,Allen; Michael Gordon,12,0,65,53
1657857611084,COGS 101C,A01,083625,Delgado; Tania,17,0,35,18
1657857617112,COGS 107A,A01,083627,Boyle; Mary E. T.,14,0,60,46
1657857623135,COGS 118A,A01,083075,Gupta; Anjum,21,0,76,55
1657857629159,CSE 3,A50,083646,Miranda; Gregory Joseph,24,0,50,26
1657857635182,CSE 8A,A50,083650,Miranda; Gregory Joseph,17,1,56,39
1657857641208,CSE 11,A01,083080,Cao; Yingjun,6,15,40,34
1657857647230,CSE 12,A01,083652,Krause-Levy; Sophia Louisa,29,1,120,91
1657857653253,CSE 15L,A01,083654,Morris; Justin Loren,9,0,50,41
1657857653253,CSE 15L,A02,083655,Morris; Justin Loren,9,0,50,41
1657857659279,CSE 20,A01,083657,Tran; Khoa Dang,39,0,80,41
1657857665307,CSE 21,A01,095574,Bach; Quang Tran,22,0,48,26
1657857671340,CSE 30,A01,083084,Eldon; John,6,0,80,74
1657857671340,CSE 30,B01,095061,Bhaskar; Nishant,9,0,50,41
1657857677362,CSE 100,A01,083659,Cao; Yingjun,5,4,70,65
1657857683388,CSE 134B,A01,083661,Powell; Thomas Allan,24,0,100,76
1657857689410,CSE 140,A01,083663,Gungor; Onat,15,0,85,70
1657857695435,CSE 140L,A01,083088,Eldon; John,23,0,100,77
1657857701459,CSE 175,A01,083665,Kumar; Rakesh,3,0,25,22
1657857707483,CSE 190,A00,092507,Dubnov; Shlomo,8,0,20,12
1657857713508,ECE 45,A01,083139,Congero; Spencer William,6,0,75,69
1657857719531,ECE 65,A50,083695,Saad; Andrew S,12,0,30,18
1657857719531,ECE 65,A51,095125,Saad; Andrew S,24,0,26,2
1657857725555,ECE 109,A01,091882,Touri; Behrouz,20,0,70,50
1657857731583,ECE 180,A00,083140,Abi Samra; Nicholas Camill,1,0,30,29
1657857731583,ECE 180,B00,083141,Abi Samra; Nicholas Camill,0,0,30,30
1657857737620,MATH 10A,A01,083735,Patchell; Gregory David,2,0,30,28
1657857737620,MATH 10A,A02,083736,Patchell; Gregory David,20,0,30,10
1657857737620,MATH 10A,A03,083737,Patchell; Gregory David,16,0,30,14
1657857743648,MATH 10B,A01,083207,Lim; Seonhee,8,0,34,26
1657857743648,MATH 10B,A02,083208,Lim; Seonhee,10,0,35,25
1657857743648,MATH 10B,A03,093472,Lim; Seonhee,7,0,34,27
1657857743648,MATH 10B,B01,083739,Sinha; Shubham,14,0,30,16
1657857749675,MATH 18,A01,083743,Cinel; Cameron Alexander,9,0,30,21
1657857749675,MATH 18,A02,083744,Cinel; Cameron Alexander,18,0,30,12
1657857749675,MATH 18,A03,083745,Cinel; Cameron Alexander,10,0,30,20
1657857749675,MATH 18,B01,083748,Rideout; David Porter,5,0,37,32
1657857749675,MATH 18,B02,083749,Rideout; David Porter,5,0,36,31
1657857749675,MATH 18,B03,083750,Rideout; David Porter,3,0,37,34
1657857749675,MATH 18,B04,083751,Rideout; David Porter,6,0,36,30
1657857749675,MATH 18,B05,093473,Rideout; David Porter,6,0,36,30
1657857749675,MATH 18,B06,093474,Rideout; David Porter,6,0,36,30
1657857755702,MATH 20A,A01,083754,Zheng; Zequn,14,0,40,26
1657857761741,MATH 20B,A01,083756,Briones; Jor-el Thomas Caparas,4,0,36,32
1657857761741,MATH 20B,A02,083757,Briones; Jor-el Thomas Caparas,1,0,36,35
1657857761741,MATH 20B,A03,093475,Briones; Jor-el Thomas Caparas,2,0,36,34
1657857767765,MATH 20C,A01,083760,Briones; Jor-el Thomas Caparas,1,0,35,34
1657857767765,MATH 20C,A02,083761,Briones; Jor-el Thomas Caparas,8,0,35,27
1657857767765,MATH 20C,A03,093476,Briones; Jor-el Thomas Caparas,0,1,36,36
1657857767765,MATH 20C,B01,083762,Bach; Quang Tran,1,0,30,29
1657857773789,MATH 20D,A01,083765,Tran; Brian Kha,5,0,30,25
1657857773789,MATH 20D,A02,083766,Tran; Brian Kha,5,0,30,25
1657857773789,MATH 20D,A03,083767,Tran; Brian Kha,5,0,30,25
1657857779814,MATH 20E,A01,083771,Ganguly; Soumya,10,0,32,22
1657857779814,MATH 20E,A02,083772,Ganguly; Soumya,6,0,32,26
1657857779814,MATH 20E,B01,083773,Ciotti; Benjamin,20,0,35,15
1657857779814,MATH 20E,B02,083774,Ciotti; Benjamin,18,0,35,17
1657857785845,MATH 103A,A01,083777,Greenfeld; Be'Eri,3,0,36,33
1657857785845,MATH 103A,A02,083778,Greenfeld; Be'Eri,5,0,36,31
1657857785845,MATH 103A,A03,093561,Greenfeld; Be'Eri,6,0,36,30
1657857785845,MATH 103A,B01,083779,Greenfeld; Be'Eri,7,0,36,29
1657857785845,MATH 103A,B02,083780,Greenfeld; Be'Eri,4,0,36,32
1657857785845,MATH 103A,B03,093562,Greenfeld; Be'Eri,3,0,36,33
1657857791871,MATH 105,A01,085443,Carter; Anne Toulson,15,0,35,20
1657857791871,MATH 105,A02,093477,Carter; Anne Toulson,20,0,35,15
1657857797900,MATH 109,A01,083213,Ganzberger; Geoffrey Michael,3,0,34,31
1657857797900,MATH 109,A02,083214,Ganzberger; Geoffrey Michael,4,0,34,30
1657857797900,MATH 109,A03,093478,Ganzberger; Geoffrey Michael,2,0,34,32
1657857797900,MATH 109,B01,083215,Ganzberger; Geoffrey Michael,1,0,32,31
1657857797900,MATH 109,B02,083216,Ganzberger; Geoffrey Michael,2,0,32,30
1657857797900,MATH 109,B03,093479,Ganzberger; Geoffrey Michael,8,0,32,24
1657857803931,MATH 142A,A01,083219,Chow; Bennett,7,0,32,25
1657857803931,MATH 142A,A02,083220,Chow; Bennett,10,0,32,22
1657857803931,MATH 142A,A03,093480,Chow; Bennett,9,0,32,23
1657857803931,MATH 142A,B03,093481,Chow; Bennett,8,0,32,24
1657857803931,MATH 142A,B04,093558,Chow; Bennett,13,0,32,19
1657857803931,MATH 142A,B05,093559,Chow; Bennett,7,0,32,25
1657857809956,MATH 193A,A01,083224,Rotar; Vladimir,8,0,34,26
1657857809956,MATH 193A,A02,083225,Rotar; Vladimir,10,0,34,24
1657857809956,MATH 193A,A03,083781,Rotar; Vladimir,5,0,34,29
1657857809956,MATH 193A,A04,083782,Rotar; Vladimir,11,0,34,23
1657857809956,MATH 193A,A05,093482,Rotar; Vladimir,10,0,34,24
1657857815983,MATH 197,001,091859,McAuley; Julian John,9999,0,9999,0
1657857815983,MATH 197,002,095566,Kedlaya; Kiran S.,9997,0,9999,2
1657857815983,MATH 197,003,095567,Xiao; Ming,9999,0,9999,0
1657857815983,MATH 197,004,095571,Perols; Johan Lars,9998,0,9999,1
1657857823033,COGS 9,A01,083615,Shannon; Kyle Michael,10,0,75,65
1657857829061,COGS 11,A01,083617,Boyle; Mary E. T.,23,0,48,25
1657857835084,COGS 13,A01,083071,Bastos; Amalia Pinkusfeld,11,0,71,60
1657857841114,COGS 14A,A01,092681,Semenuks; Arturs,5,1,100,95
1657857847141,COGS 14B,A01,083073,Cheng; Tzu-Han,6,0,63,57
1657857853166,COGS 17,A01,092677,Semenuks; Arturs,6,0,81,75
1657857859192,COGS 100,A01,083619,Allen; Michael Gordon,17,0,70,53
1657857865215,COGS 101A,A01,083621,Davis; Joshua Daniel,9,0,68,59
1657857871244,COGS 101B,A01,091572,Allen; Michael Gordon,12,0,65,53
1657857877267,COGS 101C,A01,083625,Delgado; Tania,17,0,35,18
1657857883290,COGS 107A,A01,083627,Boyle; Mary E. T.,14,0,60,46
1657857889315,COGS 118A,A01,083075,Gupta; Anjum,21,0,76,55
1657857895338,CSE 3,A50,083646,Miranda; Gregory Joseph,24,0,50,26
1657857901363,CSE 8A,A50,083650,Miranda; Gregory Joseph,17,1,56,39
1657857907389,CSE 11,A01,083080,Cao; Yingjun,6,15,40,34
1657857913412,CSE 12,A01,083652,Krause-Levy; Sophia Louisa,29,1,120,91
1657857919448,CSE 15L,A01,083654,Morris; Justin Loren,9,0,50,41
1657857919448,CSE 15L,A02,083655,Morris; Justin Loren,9,0,50,41
1657857925475,CSE 20,A01,083657,Tran; Khoa Dang,39,0,80,41
1657857931498,CSE 21,A01,095574,Bach; Quang Tran,22,0,48,26
1657857937521,CSE 30,A01,083084,Eldon; John,6,0,80,74
1657857937521,CSE 30,B01,095061,Bhaskar; Nishant,9,0,50,41
1657857943544,CSE 100,A01,083659,Cao; Yingjun,5,4,70,65
1657857949567,CSE 134B,A01,083661,Powell; Thomas Allan,24,0,100,76
1657857955595,CSE 140,A01,083663,Gungor; Onat,15,0,85,70
1657857961625,CSE 140L,A01,083088,Eldon; John,23,0,100,77
1657857967652,CSE 175,A01,083665,Kumar; Rakesh,3,0,25,22
1657857973675,CSE 190,A00,092507,Dubnov; Shlomo,8,0,20,12
1657857979704,ECE 45,A01,083139,Congero; Spencer William,6,0,75,69
1657857985730,ECE 65,A50,083695,Saad; Andrew S,12,0,30,18
1657857985730,ECE 65,A51,095125,Saad; Andrew S,24,0,26,2
1657857991762,ECE 109,A01,091882,Touri; Behrouz,20,0,70,50
1657857997783,ECE 180,A00,083140,Abi Samra; Nicholas Camill,1,0,30,29
1657857997783,ECE 180,B00,083141,Abi Samra; Nicholas Camill,0,0,30,30
1657858003807,MATH 10A,A01,083735,Patchell; Gregory David,2,0,30,28
1657858003807,MATH 10A,A02,083736,Patchell; Gregory David,20,0,30,10
1657858003807,MATH 10A,A03,083737,Patchell; Gregory David,16,0,30,14
1657858009832,MATH 10B,A01,083207,Lim; Seonhee,8,0,34,26
1657858009832,MATH 10B,A02,083208,Lim; Seonhee,10,0,35,25
1657858009832,MATH 10B,A03,093472,Lim; Seonhee,7,0,34,27
1657858009832,MATH 10B,B01,083739,Sinha; Shubham,14,0,30,16
1657858015858,MATH 18,A01,083743,Cinel; Cameron Alexander,9,0,30,21
1657858015858,MATH 18,A02,083744,Cinel; Cameron Alexander,18,0,30,12
1657858015858,MATH 18,A03,083745,Cinel; Cameron Alexander,10,0,30,20
1657858015858,MATH 18,B01,083748,Rideout; David Porter,5,0,37,32
1657858015858,MATH 18,B02,083749,Rideout; David Porter,5,0,36,31
1657858015858,MATH 18,B03,083750,Rideout; David Porter,3,0,37,34
1657858015858,MATH 18,B04,083751,Rideout; David Porter,6,0,36,30
1657858015858,MATH 18,B05,093473,Rideout; David Porter,6,0,36,30
1657858015858,MATH 18,B06,093474,Rideout; David Porter,6,0,36,30
1657858021883,MATH 20A,A01,083754,Zheng; Zequn,14,0,40,26
1657858027908,MATH 20B,A01,083756,Briones; Jor-el Thomas Caparas,4,0,36,32
1657858027908,MATH 20B,A02,083757,Briones; Jor-el Thomas Caparas,1,0,36,35
1657858027908,MATH 20B,A03,093475,Briones; Jor-el Thomas Caparas,2,0,36,34
1657858033932,MATH 20C,A01,083760,Briones; Jor-el Thomas Caparas,1,0,35,34
1657858033932,MATH 20C,A02,083761,Briones; Jor-el Thomas Caparas,8,0,35,27
1657858033932,MATH 20C,A03,093476,Briones; Jor-el Thomas Caparas,0,1,36,36
1657858033932,MATH 20C,B01,083762,Bach; Quang Tran,1,0,30,29
1657858039957,MATH 20D,A01,083765,Tran; Brian Kha,5,0,30,25
1657858039957,MATH 20D,A02,083766,Tran; Brian Kha,5,0,30,25
1657858039957,MATH 20D,A03,083767,Tran; Brian Kha,5,0,30,25
1657858045979,MATH 20E,A01,083771,Ganguly; Soumya,10,0,32,22
1657858045979,MATH 20E,A02,083772,Ganguly; Soumya,6,0,32,26
1657858045979,MATH 20E,B01,083773,Ciotti; Benjamin,20,0,35,15
1657858045979,MATH 20E,B02,083774,Ciotti; Benjamin,18,0,35,17
1657858052002,MATH 103A,A01,083777,Greenfeld; Be'Eri,3,0,36,33
1657858052002,MATH 103A,A02,083778,Greenfeld; Be'Eri,5,0,36,31
1657858052002,MATH 103A,A03,093561,Greenfeld; Be'Eri,6,0,36,30
1657858052002,MATH 103A,B01,083779,Greenfeld; Be'Eri,7,0,36,29
1657858052002,MATH 103A,B02,083780,Greenfeld; Be'Eri,4,0,36,32
1657858052002,MATH 103A,B03,093562,Greenfeld; Be'Eri,3,0,36,33
1657858058029,MATH 105,A01,085443,Carter; Anne Toulson,15,0,35,20
1657858058029,MATH 105,A02,093477,Carter; Anne Toulson,20,0,35,15
1657858064058,MATH 109,A01,083213,Ganzberger; Geoffrey Michael,3,0,34,31
1657858064058,MATH 109,A02,083214,Ganzberger; Geoffrey Michael,4,0,34,30
1657858064058,MATH 109,A03,093478,Ganzberger; Geoffrey Michael,2,0,34,32
1657858064058,MATH 109,B01,083215,Ganzberger; Geoffrey Michael,1,0,32,31
1657858064058,MATH 109,B02,083216,Ganzberger; Geoffrey Michael,2,0,32,30
1657858064058,MATH 109,B03,093479,Ganzberger; Geoffrey Michael,8,0,32,24
1657858070091,MATH 142A,A01,083219,Chow; Bennett,7,0,32,25
1657858070091,MATH 142A,A02,083220,Chow; Bennett,10,0,32,22
1657858070091,MATH 142A,A03,093480,Chow; Bennett,9,0,32,23
1657858070091,MATH 142A,B03,093481,Chow; Bennett,8,0,32,24
1657858070091,MATH 142A,B04,093558,Chow; Bennett,13,0,32,19
1657858070091,MATH 142A,B05,093559,Chow; Bennett,7,0,32,25
1657858076118,MATH 193A,A01,083224,Rotar; Vladimir,8,0,34,26
1657858076118,MATH 193A,A02,083225,Rotar; Vladimir,10,0,34,24
1657858076118,MATH 193A,A03,083781,Rotar; Vladimir,5,0,34,29
1657858076118,MATH 193A,A04,083782,Rotar; Vladimir,11,0,34,23
1657858076118,MATH 193A,A05,093482,Rotar; Vladimir,10,0,34,24
1657858082143,MATH 197,001,091859,McAuley; Julian John,9999,0,9999,0
1657858082143,MATH 197,002,095566,Kedlaya; Kiran S.,9997,0,9999,2
1657858082143,MATH 197,003,095567,Xiao; Ming,9999,0,9999,0
1657858082143,MATH 197,004,095571,Perols; Johan Lars,9998,0,9999,1
1657858089206,COGS 9,A01,083615,Shannon; Kyle Michael,10,0,75,65
1657858095228,COGS 11,A01,083617,Boyle; Mary E. T.,23,0,48,25
1657858101255,COGS 13,A01,083071,Bastos; Amalia Pinkusfeld,11,0,71,60
1657858107280,COGS 14A,A01,092681,Semenuks; Arturs,5,1,100,95
1657858113304,COGS 14B,A01,083073,Cheng; Tzu-Han,6,0,63,57
1657858119329,COGS 17,A01,092677,Semenuks; Arturs,6,0,81,75
1657858125362,COGS 100,A01,083619,Allen; Michael Gordon,17,0,70,53
1657858131387,COGS 101A,A01,083621,Davis; Joshua Daniel,9,0,68,59
1657858137409,COGS 101B,A01,091572,Allen; Michael Gordon,12,0,65,53
1657858143431,COGS 101C,A01,083625,Delgado; Tania,17,0,35,18
1657858149462,COGS 107A,A01,083627,Boyle; Mary E. T.,14,0,60,46
1657858155484,COGS 118A,A01,083075,Gupta; Anjum,21,0,76,55
1657858161508,CSE 3,A50,083646,Miranda; Gregory Joseph,24,0,50,26
1657858167532,CSE 8A,A50,083650,Miranda; Gregory Joseph,17,1,56,39
1657858173556,CSE 11,A01,083080,Cao; Yingjun,6,15,40,34
1657858179579,CSE 12,A01,083652,Krause-Levy; Sophia Louisa,29,1,120,91
1657858185693,CSE 15L,A01,083654,Morris; Justin Loren,9,0,50,41
1657858185693,CSE 15L,A02,083655,Morris; Justin Loren,9,0,50,41
1657858191715,CSE 20,A01,083657,Tran; Khoa Dang,39,0,80,41
1657858197742,CSE 21,A01,095574,Bach; Quang Tran,22,0,48,26
1657858203764,CSE 30,A01,083084,Eldon; John,6,0,80,74
1657858203764,CSE 30,B01,095061,Bhaskar; Nishant,9,0,50,41
1657858209786,CSE 100,A01,083659,Cao; Yingjun,5,4,70,65
1657858215826,CSE 134B,A01,083661,Powell; Thomas Allan,24,0,100,76
1657858221850,CSE 140,A01,083663,Gungor; Onat,15,0,85,70
1657858227874,CSE 140L,A01,083088,Eldon; John,23,0,100,77
1657858233897,CSE 175,A01,083665,Kumar; Rakesh,3,0,25,22
1657858239922,CSE 190,A00,092507,Dubnov; Shlomo,8,0,20,12
1657858245945,ECE 45,A01,083139,Congero; Spencer William,6,0,75,69
1657858251968,ECE 65,A50,083695,Saad; Andrew S,12,0,30,18
1657858251968,ECE 65,A51,095125,Saad; Andrew S,24,0,26,2
1657858257991,ECE 109,A01,091882,Touri; Behrouz,20,0,70,50
1657858264014,ECE 180,A00,083140,Abi Samra; Nicholas Camill,1,0,30,29
1657858264014,ECE 180,B00,083141,Abi Samra; Nicholas Camill,0,0,30,30
1657858270041,MATH 10A,A01,083735,Patchell; Gregory David,2,0,30,28
1657858270041,MATH 10A,A02,083736,Patchell; Gregory David,20,0,30,10
1657858270041,MATH 10A,A03,083737,Patchell; Gregory David,16,0,30,14
1657858276076,MATH 10B,A01,083207,Lim; Seonhee,8,0,34,26
1657858276076,MATH 10B,A02,083208,Lim; Seonhee,10,0,35,25
1657858276076,MATH 10B,A03,093472,Lim; Seonhee,7,0,34,27
1657858276076,MATH 10B,B01,083739,Sinha; Shubham,14,0,30,16
1657858282101,MATH 18,A01,083743,Cinel; Cameron Alexander,9,0,30,21
1657858282101,MATH 18,A02,083744,Cinel; Cameron Alexander,18,0,30,12
1657858282101,MATH 18,A03,083745,Cinel; Cameron Alexander,10,0,30,20
1657858282101,MATH 18,B01,083748,Rideout; David Porter,5,0,37,32
1657858282101,MATH 18,B02,083749,Rideout; David Porter,5,0,36,31
1657858282101,MATH 18,B03,083750,Rideout; David Porter,3,0,37,34
1657858282101,MATH 18,B04,083751,Rideout; David Porter,6,0,36,30
1657858282101,MATH 18,B05,093473,Rideout; David Porter,6,0,36,30
1657858282101,MATH 18,B06,093474,Rideout; David Porter,6,0,36,30
1657858288124,MATH 20A,A01,083754,Zheng; Zequn,14,0,40,26
1657858294148,MATH 20B,A01,083756,Briones; Jor-el Thomas Caparas,4,0,36,32
1657858294148,MATH 20B,A02,083757,Briones; Jor-el Thomas Caparas,1,0,36,35
1657858294148,MATH 20B,A03,093475,Briones; Jor-el Thomas Caparas,2,0,36,34
1657858300177,MATH 20C,A01,083760,Briones; Jor-el Thomas Caparas,1,0,35,34
1657858300177,MATH 20C,A02,083761,Briones; Jor-el Thomas Caparas,8,0,35,27
1657858300177,MATH 20C,A03,093476,Briones; Jor-el Thomas Caparas,0,1,36,36
1657858300177,MATH 20C,B01,083762,Bach; Quang Tran,1,0,30,29
1657858306201,MATH 20D,A01,083765,Tran; Brian Kha,5,0,30,25
1657858306201,MATH 20D,A02,083766,Tran; Brian Kha,5,0,30,25
1657858306201,MATH 20D,A03,083767,Tran; Brian Kha,5,0,30,25
1657858312229,MATH 20E,A01,083771,Ganguly; Soumya,10,0,32,22
1657858312229,MATH 20E,A02,083772,Ganguly; Soumya,6,0,32,26
1657858312229,MATH 20E,B01,083773,Ciotti; Benjamin,20,0,35,15
1657858312229,MATH 20E,B02,083774,Ciotti; Benjamin,18,0,35,17
1657858318261,MATH 103A,A01,083777,Greenfeld; Be'Eri,3,0,36,33
1657858318261,MATH 103A,A02,083778,Greenfeld; Be'Eri,5,0,36,31
1657858318261,MATH 103A,A03,093561,Greenfeld; Be'Eri,6,0,36,30
1657858318261,MATH 103A,B01,083779,Greenfeld; Be'Eri,7,0,36,29
1657858318261,MATH 103A,B02,083780,Greenfeld; Be'Eri,4,0,36,32
1657858318261,MATH 103A,B03,093562,Greenfeld; Be'Eri,3,0,36,33
1657858324284,MATH 105,A01,085443,Carter; Anne Toulson,15,0,35,20
1657858324284,MATH 105,A02,093477,Carter; Anne Toulson,20,0,35,15
1657858330312,MATH 109,A01,083213,Ganzberger; Geoffrey Michael,3,0,34,31
1657858330312,MATH 109,A02,083214,Ganzberger; Geoffrey Michael,4,0,34,30
1657858330312,MATH 109,A03,093478,Ganzberger; Geoffrey Michael,2,0,34,32
1657858330312,MATH 109,B01,083215,Ganzberger; Geoffrey Michael,1,0,32,31
1657858330312,MATH 109,B02,083216,Ganzberger; Geoffrey Michael,2,0,32,30
1657858330312,MATH 109,B03,093479,Ganzberger; Geoffrey Michael,8,0,32,24
1657858336342,MATH 142A,A01,083219,Chow; Bennett,7,0,32,25
1657858336342,MATH 142A,A02,083220,Chow; Bennett,10,0,32,22
1657858336342,MATH 142A,A03,093480,Chow; Bennett,9,0,32,23
1657858336342,MATH 142A,B03,093481,Chow; Bennett,8,0,32,24
1657858336342,MATH 142A,B04,093558,Chow; Bennett,13,0,32,19
1657858336342,MATH 142A,B05,093559,Chow; Bennett,7,0,32,25
1657858342369,MATH 193A,A01,083224,Rotar; Vladimir,8,0,34,26
1657858342369,MATH 193A,A02,083225,Rotar; Vladimir,10,0,34,24
1657858342369,MATH 193A,A03,083781,Rotar; Vladimir,5,0,34,29
1657858342369,MATH 193A,A04,083782,Rotar; Vladimir,11,0,34,23
1657858342369,MATH 193A,A05,093482,Rotar; Vladimir,10,0,34,24
1657858348395,MATH 197,001,091859,McAuley; Julian John,9999,0,9999,0
1657858348395,MATH 197,002,095566,Kedlaya; Kiran S.,9997,0,9999,2
1657858348395,MATH 197,003,095567,Xiao; Ming,9999,0,9999,0
1657858348395,MATH 197,004,095571,Perols; Johan Lars,9998,0,9999,1
1657858355454,COGS 9,A01,083615,Shannon; Kyle Michael,10,0,75,65
1657858361479,COGS 11,A01,083617,Boyle; Mary E. T.,23,0,48,25
1657858367502,COGS 13,A01,083071,Bastos; Amalia Pinkusfeld,11,0,71,60
1657858373551,COGS 14A,A01,092681,Semenuks; Arturs,5,1,100,95
1657858379575,COGS 14B,A01,083073,Cheng; Tzu-Han,6,0,63,57
1657858385605,COGS 17,A01,092677,Semenuks; Arturs,6,0,81,75
1657858391628,COGS 100,A01,083619,Allen; Michael Gordon,17,0,70,53
1657858397655,COGS 101A,A01,083621,Davis; Joshua Daniel,9,0,68,59
1657858403682,COGS 101B,A01,091572,Allen; Michael Gordon,12,0,65,53
1657858409709,COGS 101C,A01,083625,Delgado; Tania,17,0,35,18
1657858415736,COGS 107A,A01,083627,Boyle; Mary E. T.,14,0,60,46
1657858421758,COGS 118A,A01,083075,Gupta; Anjum,21,0,76,55
1657858427787,CSE 3,A50,083646,Miranda; Gregory Joseph,24,0,50,26
1657858433810,CSE 8A,A50,083650,Miranda; Gregory Joseph,17,1,56,39
1657858439833,CSE 11,A01,083080,Cao; Yingjun,6,15,40,34
1657858445865,CSE 12,A01,083652,Krause-Levy; Sophia Louisa,29,1,120,91
1657858451888,CSE 15L,A01,083654,Morris; Justin Loren,9,0,50,41
1657858451888,CSE 15L,A02,083655,Morris; Justin Loren,9,0,50,41
1657858457919,CSE 20,A01,083657,Tran; Khoa Dang,39,0,80,41
1657858463946,CSE 21,A01,095574,Bach; Quang Tran,22,0,48,26
1657858469972,CSE 30,A01,083084,Eldon; John,6,0,80,74
1657858469972,CSE 30,B01,095061,Bhaskar; Nishant,9,0,50,41
1657858475999,CSE 100,A01,083659,Cao; Yingjun,5,4,70,65
1657858482031,CSE 134B,A01,083661,Powell; Thomas Allan,24,0,100,76
1657858488055,CSE 140,A01,083663,Gungor; Onat,15,0,85,70
1657858494082,CSE 140L,A01,083088,Eldon; John,23,0,100,77
1657858500105,CSE 175,A01,083665,Kumar; Rakesh,3,0,25,22
1657858506128,CSE 190,A00,092507,Dubnov; Shlomo,8,0,20,12
1657858512154,ECE 45,A01,083139,Congero; Spencer William,6,0,75,69
1657858518180,ECE 65,A50,083695,Saad; Andrew S,12,0,30,18
1657858518180,ECE 65,A51,095125,Saad; Andrew S,24,0,26,2
1657858524204,ECE 109,A01,091882,Touri; Behrouz,20,0,70,50
1657858530230,ECE 180,A00,083140,Abi Samra; Nicholas Camill,1,0,30,29
1657858530230,ECE 180,B00,083141,Abi Samra; Nicholas Camill,0,0,30,30
1657858536266,MATH 10A,A01,083735,Patchell; Gregory David,2,0,30,28
1657858536266,MATH 10A,A02,083736,Patchell; Gregory David,20,0,30,10
1657858536266,MATH 10A,A03,083737,Patchell; Gregory David,16,0,30,14
1657858542297,MATH 10B,A01,083207,Lim; Seonhee,8,0,34,26
1657858542297,MATH 10B,A02,083208,Lim; Seonhee,10,0,35,25
1657858542297,MATH 10B,A03,093472,Lim; Seonhee,7,0,34,27
1657858542297,MATH 10B,B01,083739,Sinha; Shubham,14,0,30,16
1657858548336,MATH 18,A01,083743,Cinel; Cameron Alexander,9,0,30,21
1657858548336,MATH 18,A02,083744,Cinel; Cameron Alexander,18,0,30,12
1657858548336,MATH 18,A03,083745,Cinel; Cameron Alexander,10,0,30,20
1657858548336,MATH 18,B01,083748,Rideout; David Porter,5,0,37,32
1657858548336,MATH 18,B02,083749,Rideout; David Porter,5,0,36,31
1657858548336,MATH 18,B03,083750,Rideout; David Porter,3,0,37,34
1657858548336,MATH 18,B04,083751,Rideout; David Porter,6,0,36,30
1657858548336,MATH 18,B05,093473,Rideout; David Porter,6,0,36,30
1657858548336,MATH 18,B06,093474,Rideout; David Porter,6,0,36,30
1657858554360,MATH 20A,A01,083754,Zheng; Zequn,14,0,40,26
1657858560389,MATH 20B,A01,083756,Briones; Jor-el Thomas Caparas,4,0,36,32
1657858560389,MATH 20B,A02,083757,Briones; Jor-el Thomas Caparas,1,0,36,35
1657858560389,MATH 20B,A03,093475,Briones; Jor-el Thomas Caparas,2,0,36,34
1657858566414,MATH 20C,A01,083760,Briones; Jor-el Thomas Caparas,1,0,35,34
1657858566414,MATH 20C,A02,083761,Briones; Jor-el Thomas Caparas,8,0,35,27
1657858566414,MATH 20C,A03,093476,Briones; Jor-el Thomas Caparas,0,1,36,36
1657858566414,MATH 20C,B01,083762,Bach; Quang Tran,1,0,30,29
1657858572444,MATH 20D,A01,083765,Tran; Brian Kha,5,0,30,25
1657858572444,MATH 20D,A02,083766,Tran; Brian Kha,5,0,30,25
1657858572444,MATH 20D,A03,083767,Tran; Brian Kha,5,0,30,25
1657858578467,MATH 20E,A01,083771,Ganguly; Soumya,10,0,32,22
1657858578467,MATH 20E,A02,083772,Ganguly; Soumya,6,0,32,26
1657858578467,MATH 20E,B01,083773,Ciotti; Benjamin,20,0,35,15
1657858578467,MATH 20E,B02,083774,Ciotti; Benjamin,18,0,35,17
1657858584497,MATH 103A,A01,083777,Greenfeld; Be'Eri,3,0,36,33
1657858584497,MATH 103A,A02,083778,Greenfeld; Be'Eri,5,0,36,31
1657858584497,MATH 103A,A03,093561,Greenfeld; Be'Eri,6,0,36,30
1657858584497,MATH 103A,B01,083779,Greenfeld; Be'Eri,7,0,36,29
1657858584497,MATH 103A,B02,083780,Greenfeld; Be'Eri,4,0,36,32
1657858584497,MATH 103A,B03,093562,Greenfeld; Be'Eri,3,0,36,33
1657858590519,MATH 105,A01,085443,Carter; Anne Toulson,15,0,35,20
1657858590519,MATH 105,A02,093477,Carter; Anne Toulson,20,0,35,15
1657858596542,MATH 109,A01,083213,Ganzberger; Geoffrey Michael,3,0,34,31
1657858596542,MATH 109,A02,083214,Ganzberger; Geoffrey Michael,4,0,34,30
1657858596542,MATH 109,A03,093478,Ganzberger; Geoffrey Michael,2,0,34,32
1657858596542,MATH 109,B01,083215,Ganzberger; Geoffrey Michael,1,0,32,31
1657858596542,MATH 109,B02,083216,Ganzberger; Geoffrey Michael,2,0,32,30
1657858596542,MATH 109,B03,093479,Ganzberger; Geoffrey Michael,8,0,32,24
1657858602568,MATH 142A,A01,083219,Chow; Bennett,7,0,32,25
1657858602568,MATH 142A,A02,083220,Chow; Bennett,10,0,32,22
1657858602568,MATH 142A,A03,093480,Chow; Bennett,9,0,32,23
1657858602568,MATH 142A,B03,093481,Chow; Bennett,8,0,32,24
1657858602568,MATH 142A,B04,093558,Chow; Bennett,13,0,32,19
1657858602568,MATH 142A,B05,093559,Chow; Bennett,7,0,32,25
1657858608596,MATH 193A,A01,083224,Rotar; Vladimir,8,0,34,26
1657858608596,MATH 193A,A02,083225,Rotar; Vladimir,10,0,34,24
1657858608596,MATH 193A,A03,083781,Rotar; Vladimir,5,0,34,29
1657858608596,MATH 193A,A04,083782,Rotar; Vladimir,11,0,34,23
1657858608596,MATH 193A,A05,093482,Rotar; Vladimir,10,0,34,24
1657858614619,MATH 197,001,091859,McAuley; Julian John,9999,0,9999,0
1657858614619,MATH 197,002,095566,Kedlaya; Kiran S.,9997,0,9999,2
1657858614619,MATH 197,003,095567,Xiao; Ming,9999,0,9999,0
1657858614619,MATH 197,004,095571,Perols; Johan Lars,9998,0,9999,1
1657858621677,COGS 9,A01,083615,Shannon; Kyle Michael,10,0,75,65
1657858627702,COGS 11,A01,083617,Boyle; Mary E. T.,23,0,48,25
1657858633724,COGS 13,A01,083071,Bastos; Amalia Pinkusfeld,11,0,71,60
1657858639758,COGS 14A,A01,092681,Semenuks; Arturs,5,1,100,95
1657858645780,COGS 14B,A01,083073,Cheng; Tzu-Han,6,0,63,57
1657858651807,COGS 17,A01,092677,Semenuks; Arturs,6,0,81,75
1657858657828,COGS 100,A01,083619,Allen; Michael Gordon,17,0,70,53
1657858663851,COGS 101A,A01,083621,Davis; Joshua Daniel,9,0,68,59
1657858669877,COGS 101B,A01,091572,Allen; Michael Gordon,12,0,65,53
1657858675906,COGS 101C,A01,083625,Delgado; Tania,17,0,35,18
1657858681929,COGS 107A,A01,083627,Boyle; Mary E. T.,14,0,60,46
1657858687953,COGS 118A,A01,083075,Gupta; Anjum,21,0,76,55
1657858693975,CSE 3,A50,083646,Miranda; Gregory Joseph,24,0,50,26
1657858700009,CSE 8A,A50,083650,Miranda; Gregory Joseph,17,1,56,39
1657858706035,CSE 11,A01,083080,Cao; Yingjun,6,15,40,34
1657858712057,CSE 12,A01,083652,Krause-Levy; Sophia Louisa,29,1,120,91
1657858718080,CSE 15L,A01,083654,Morris; Justin Loren,9,0,50,41
1657858718080,CSE 15L,A02,083655,Morris; Justin Loren,9,0,50,41
1657858724108,CSE 20,A01,083657,Tran; Khoa Dang,39,0,80,41
1657858730132,CSE 21,A01,095574,Bach; Quang Tran,22,0,48,26
1657858736159,CSE 30,A01,083084,Eldon; John,6,0,80,74
1657858736159,CSE 30,B01,095061,Bhaskar; Nishant,9,0,50,41
1657858742183,CSE 100,A01,083659,Cao; Yingjun,5,4,70,65
1657858748215,CSE 134B,A01,083661,Powell; Thomas Allan,24,0,100,76
1657858754237,CSE 140,A01,083663,Gungor; Onat,15,0,85,70
1657858760261,CSE 140L,A01,083088,Eldon; John,23,0,100,77
1657858766286,CSE 175,A01,083665,Kumar; Rakesh,3,0,25,22
1657858772311,CSE 190,A00,092507,Dubnov; Shlomo,8,0,20,12
1657858778333,ECE 45,A01,083139,Congero; Spencer William,6,0,75,69
1657858784429,ECE 65,A50,083695,Saad; Andrew S,12,0,30,18
1657858784429,ECE 65,A51,095125,Saad; Andrew S,24,0,26,2
1657858790454,ECE 109,A01,091882,Touri; Behrouz,20,0,70,50
1657858796490,ECE 180,A00,083140,Abi Samra; Nicholas Camill,1,0,30,29
1657858796490,ECE 180,B00,083141,Abi Samra; Nicholas Camill,0,0,30,30
1657858802517,MATH 10A,A01,083735,Patchell; Gregory David,2,0,30,28
1657858802517,MATH 10A,A02,083736,Patchell; Gregory David,20,0,30,10
1657858802517,MATH 10A,A03,083737,Patchell; Gregory David,16,0,30,14
1657858808544,MATH 10B,A01,083207,Lim; Seonhee,8,0,34,26
1657858808544,MATH 10B,A02,083208,Lim; Seonhee,10,0,35,25
1657858808544,MATH 10B,A03,093472,Lim; Seonhee,7,0,34,27
1657858808544,MATH 10B,B01,083739,Sinha; Shubham,14,0,30,16
1657858814574,MATH 18,A01,083743,Cinel; Cameron Alexander,9,0,30,21
1657858814574,MATH 18,A02,083744,Cinel; Cameron Alexander,18,0,30,12
1657858814574,MATH 18,A03,083745,Cinel; Cameron Alexander,10,0,30,20
1657858814574,MATH 18,B01,083748,Rideout; David Porter,5,0,37,32
1657858814574,MATH 18,B02,083749,Rideout; David Porter,5,0,36,31
1657858814574,MATH 18,B03,083750,Rideout; David Porter,3,0,37,34
1657858814574,MATH 18,B04,083751,Rideout; David Porter,6,0,36,30
1657858814574,MATH 18,B05,093473,Rideout; David Porter,6,0,36,30
1657858814574,MATH 18,B06,093474,Rideout; David Porter,6,0,36,30
1657858820600,MATH 20A,A01,083754,Zheng; Zequn,14,0,40,26
1657858826626,MATH 20B,A01,083756,Briones; Jor-el Thomas Caparas,4,0,36,32
1657858826626,MATH 20B,A02,083757,Briones; Jor-el Thomas Caparas,1,0,36,35
1657858826626,MATH 20B,A03,093475,Briones; Jor-el Thomas Caparas,2,0,36,34
1657858832649,MATH 20C,A01,083760,Briones; Jor-el Thomas Caparas,1,0,35,34
1657858832649,MATH 20C,A02,083761,Briones; Jor-el Thomas Caparas,8,0,35,27
1657858832649,MATH 20C,A03,093476,Briones; Jor-el Thomas Caparas,0,1,36,36
1657858832649,MATH 20C,B01,083762,Bach; Quang Tran,1,0,30,29
1657858838676,MATH 20D,A01,083765,Tran; Brian Kha,5,0,30,25
1657858838676,MATH 20D,A02,083766,Tran; Brian Kha,5,0,30,25
1657858838676,MATH 20D,A03,083767,Tran; Brian Kha,5,0,30,25
1657858844699,MATH 20E,A01,083771,Ganguly; Soumya,10,0,32,22
1657858844699,MATH 20E,A02,083772,Ganguly; Soumya,6,0,32,26
1657858844699,MATH 20E,B01,083773,Ciotti; Benjamin,20,0,35,15
1657858844699,MATH 20E,B02,083774,Ciotti; Benjamin,18,0,35,17
1657858850727,MATH 103A,A01,083777,Greenfeld; Be'Eri,3,0,36,33
1657858850727,MATH 103A,A02,083778,Greenfeld; Be'Eri,5,0,36,31
1657858850727,MATH 103A,A03,093561,Greenfeld; Be'Eri,6,0,36,30
1657858850727,MATH 103A,B01,083779,Greenfeld; Be'Eri,7,0,36,29
1657858850727,MATH 103A,B02,083780,Greenfeld; Be'Eri,4,0,36,32
1657858850727,MATH 103A,B03,093562,Greenfeld; Be'Eri,3,0,36,33
1657858856753,MATH 105,A01,085443,Carter; Anne Toulson,15,0,35,20
1657858856753,MATH 105,A02,093477,Carter; Anne Toulson,20,0,35,15
1657858862777,MATH 109,A01,083213,Ganzberger; Geoffrey Michael,3,0,34,31
1657858862777,MATH 109,A02,083214,Ganzberger; Geoffrey Michael,4,0,34,30
1657858862777,MATH 109,A03,093478,Ganzberger; Geoffrey Michael,2,0,34,32
1657858862777,MATH 109,B01,083215,Ganzberger; Geoffrey Michael,1,0,32,31
1657858862777,MATH 109,B02,083216,Ganzberger; Geoffrey Michael,2,0,32,30
1657858862777,MATH 109,B03,093479,Ganzberger; Geoffrey Michael,8,0,32,24
1657858868801,MATH 142A,A01,083219,Chow; Bennett,7,0,32,25
1657858868801,MATH 142A,A02,083220,Chow; Bennett,10,0,32,22
1657858868801,MATH 142A,A03,093480,Chow; Bennett,9,0,32,23
1657858868801,MATH 142A,B03,093481,Chow; Bennett,8,0,32,24
1657858868801,MATH 142A,B04,093558,Chow; Bennett,13,0,32,19
1657858868801,MATH 142A,B05,093559,Chow; Bennett,7,0,32,25
1657858874832,MATH 193A,A01,083224,Rotar; Vladimir,8,0,34,26
1657858874832,MATH 193A,A02,083225,Rotar; Vladimir,10,0,34,24
1657858874832,MATH 193A,A03,083781,Rotar; Vladimir,5,0,34,29
1657858874832,MATH 193A,A04,083782,Rotar; Vladimir,11,0,34,23
1657858874832,MATH 193A,A05,093482,Rotar; Vladimir,10,0,34,24
1657858880855,MATH 197,001,091859,McAuley; Julian John,9999,0,9999,0
1657858880855,MATH 197,002,095566,Kedlaya; Kiran S.,9997,0,9999,2
1657858880855,MATH 197,003,095567,Xiao; Ming,9999,0,9999,0
1657858880855,MATH 197,004,095571,Perols; Johan Lars,9998,0,9999,1
1657858887916,COGS 9,A01,083615,Shannon; Kyle Michael,10,0,75,65
1657858893939,COGS 11,A01,083617,Boyle; Mary E. T.,23,0,48,25
1657858899961,COGS 13,A01,083071,Bastos; Amalia Pinkusfeld,11,0,71,60
1657858905984,COGS 14A,A01,092681,Semenuks; Arturs,5,1,100,95
1657858912012,COGS 14B,A01,083073,Cheng; Tzu-Han,6,0,63,57
1657858918036,COGS 17,A01,092677,Semenuks; Arturs,6,0,81,75
1657858924063,COGS 100,A01,083619,Allen; Michael Gordon,17,0,70,53
1657858930092,COGS 101A,A01,083621,Davis; Joshua Daniel,9,0,68,59
1657858936116,COGS 101B,A01,091572,Allen; Michael Gordon,12,0,65,53
1657858942150,COGS 101C,A01,083625,Delgado; Tania,17,0,35,18
1657858948178,COGS 107A,A01,083627,Boyle; Mary E. T.,14,0,60,46
1657858954201,COGS 118A,A01,083075,Gupta; Anjum,21,0,76,55
1657858960228,CSE 3,A50,083646,Miranda; Gregory Joseph,24,0,50,26
1657858966256,CSE 8A,A50,083650,Miranda; Gregory Joseph,17,1,56,39
1657858972280,CSE 11,A01,083080,Cao; Yingjun,6,15,40,34
1657858978307,CSE 12,A01,083652,Krause-Levy; Sophia Louisa,29,1,120,91
1657858984328,CSE 15L,A01,083654,Morris; Justin Loren,9,0,50,41
1657858984328,CSE 15L,A02,083655,Morris; Justin Loren,9,0,50,41
1657858990356,CSE 20,A01,083657,Tran; Khoa Dang,39,0,80,41
1657858996380,CSE 21,A01,095574,Bach; Quang Tran,22,0,48,26
1657859002406,CSE 30,A01,083084,Eldon; John,6,0,80,74
1657859002406,CSE 30,B01,095061,Bhaskar; Nishant,9,0,50,41
1657859008434,CSE 100,A01,083659,Cao; Yingjun,5,4,70,65
1657859014458,CSE 134B,A01,083661,Powell; Thomas Allan,24,0,100,76
1657859020480,CSE 140,A01,083663,Gungor; Onat,15,0,85,70
1657859026506,CSE 140L,A01,083088,Eldon; John,23,0,100,77
1657859032530,CSE 175,A01,083665,Kumar; Rakesh,3,0,25,22
1657859038555,CSE 190,A00,092507,Dubnov; Shlomo,8,0,20,12
1657859044591,ECE 45,A01,083139,Congero; Spencer William,6,0,75,69
1657859050617,ECE 65,A50,083695,Saad; Andrew S,12,0,30,18
1657859050617,ECE 65,A51,095125,Saad; Andrew S,24,0,26,2
1657859056640,ECE 109,A01,091882,Touri; Behrouz,20,0,70,50
1657859062673,ECE 180,A00,083140,Abi Samra; Nicholas Camill,1,0,30,29
1657859062673,ECE 180,B00,083141,Abi Samra; Nicholas Camill,0,0,30,30
1657859068700,MATH 10A,A01,083735,Patchell; Gregory David,2,0,30,28
1657859068700,MATH 10A,A02,083736,Patchell; Gregory David,20,0,30,10
1657859068700,MATH 10A,A03,083737,Patchell; Gregory David,16,0,30,14
1657859074724,MATH 10B,A01,083207,Lim; Seonhee,8,0,34,26
1657859074724,MATH 10B,A02,083208,Lim; Seonhee,10,0,35,25
1657859074724,MATH 10B,A03,093472,Lim; Seonhee,7,0,34,27
1657859074724,MATH 10B,B01,083739,Sinha; Shubham,14,0,30,16
1657859080755,MATH 18,A01,083743,Cinel; Cameron Alexander,9,0,30,21
1657859080755,MATH 18,A02,083744,Cinel; Cameron Alexander,18,0,30,12
1657859080755,MATH 18,A03,083745,Cinel; Cameron Alexander,10,0,30,20
1657859080755,MATH 18,B01,083748,Rideout; David Porter,5,0,37,32
1657859080755,MATH 18,B02,083749,Rideout; David Porter,5,0,36,31
1657859080755,MATH 18,B03,083750,Rideout; David Porter,3,0,37,34
1657859080755,MATH 18,B04,083751,Rideout; David Porter,6,0,36,30
1657859080755,MATH 18,B05,093473,Rideout; David Porter,6,0,36,30
1657859080755,MATH 18,B06,093474,Rideout; David Porter,6,0,36,30
1657859086781,MATH 20A,A01,083754,Zheng; Zequn,14,0,40,26
1657859092803,MATH 20B,A01,083756,Briones; Jor-el Thomas Caparas,4,0,36,32
1657859092803,MATH 20B,A02,083757,Briones; Jor-el Thomas Caparas,1,0,36,35
1657859092803,MATH 20B,A03,093475,Briones; Jor-el Thomas Caparas,2,0,36,34
1657859098831,MATH 20C,A01,083760,Briones; Jor-el Thomas Caparas,1,0,35,34
1657859098831,MATH 20C,A02,083761,Briones; Jor-el Thomas Caparas,8,0,35,27
1657859098831,MATH 20C,A03,093476,Briones; Jor-el Thomas Caparas,0,1,36,36
1657859098831,MATH 20C,B01,083762,Bach; Quang Tran,1,0,30,29
1657859104853,MATH 20D,A01,083765,Tran; Brian Kha,5,0,30,25
1657859104853,MATH 20D,A02,083766,Tran; Brian Kha,5,0,30,25
1657859104853,MATH 20D,A03,083767,Tran; Brian Kha,5,0,30,25
1657859110891,MATH 20E,A01,083771,Ganguly; Soumya,10,0,32,22
1657859110891,MATH 20E,A02,083772,Ganguly; Soumya,6,0,32,26
1657859110891,MATH 20E,B01,083773,Ciotti; Benjamin,20,0,35,15
1657859110891,MATH 20E,B02,083774,Ciotti; Benjamin,18,0,35,17
1657859116920,MATH 103A,A01,083777,Greenfeld; Be'Eri,3,0,36,33
1657859116920,MATH 103A,A02,083778,Greenfeld; Be'Eri,5,0,36,31
1657859116920,MATH 103A,A03,093561,Greenfeld; Be'Eri,6,0,36,30
1657859116920,MATH 103A,B01,083779,Greenfeld; Be'Eri,7,0,36,29
1657859116920,MATH 103A,B02,083780,Greenfeld; Be'Eri,4,0,36,32
1657859116920,MATH 103A,B03,093562,Greenfeld; Be'Eri,3,0,36,33
1657859122952,MATH 105,A01,085443,Carter; Anne Toulson,15,0,35,20
1657859122952,MATH 105,A02,093477,Carter; Anne Toulson,20,0,35,15
1657859128980,MATH 109,A01,083213,Ganzberger; Geoffrey Michael,3,0,34,31
1657859128980,MATH 109,A02,083214,Ganzberger; Geoffrey Michael,4,0,34,30
1657859128980,MATH 109,A03,093478,Ganzberger; Geoffrey Michael,2,0,34,32
1657859128980,MATH 109,B01,083215,Ganzberger; Geoffrey Michael,1,0,32,31
1657859128980,MATH 109,B02,083216,Ganzberger; Geoffrey Michael,2,0,32,30
1657859128980,MATH 109,B03,093479,Ganzberger; Geoffrey Michael,8,0,32,24
1657859135003,MATH 142A,A01,083219,Chow; Bennett,7,0,32,25
1657859135003,MATH 142A,A02,083220,Chow; Bennett,10,0,32,22
1657859135003,MATH 142A,A03,093480,Chow; Bennett,9,0,32,23
1657859135003,MATH 142A,B03,093481,Chow; Bennett,8,0,32,24
1657859135003,MATH 142A,B04,093558,Chow; Bennett,13,0,32,19
1657859135003,MATH 142A,B05,093559,Chow; Bennett,7,0,32,25
1657859141032,MATH 193A,A01,083224,Rotar; Vladimir,8,0,34,26
1657859141032,MATH 193A,A02,083225,Rotar; Vladimir,10,0,34,24
1657859141032,MATH 193A,A03,083781,Rotar; Vladimir,5,0,34,29
1657859141032,MATH 193A,A04,083782,Rotar; Vladimir,11,0,34,23
1657859141032,MATH 193A,A05,093482,Rotar; Vladimir,10,0,34,24
1657859147058,MATH 197,001,091859,McAuley; Julian John,9999,0,9999,0
1657859147058,MATH 197,002,095566,Kedlaya; Kiran S.,9997,0,9999,2
1657859147058,MATH 197,003,095567,Xiao; Ming,9999,0,9999,0
1657859147058,MATH 197,004,095571,Perols; Johan Lars,9998,0,9999,1
1657859154122,COGS 9,A01,083615,Shannon; Kyle Michael,10,0,75,65
1657859160144,COGS 11,A01,083617,Boyle; Mary E. T.,23,0,48,25
1657859166166,COGS 13,A01,083071,Bastos; Amalia Pinkusfeld,11,0,71,60
1657859172190,COGS 14A,A01,092681,Semenuks; Arturs,5,1,100,95
1657859178213,COGS 14B,A01,083073,Cheng; Tzu-Han,6,0,63,57
1657859184240,COGS 17,A01,092677,Semenuks; Arturs,6,0,81,75
1657859190266,COGS 100,A01,083619,Allen; Michael Gordon,17,0,70,53
1657859196290,COGS 101A,A01,083621,Davis; Joshua Daniel,9,0,68,59
1657859202313,COGS 101B,A01,091572,Allen; Michael Gordon,12,0,65,53
1657859208341,COGS 101C,A01,083625,Delgado; Tania,17,0,35,18
1657859214373,COGS 107A,A01,083627,Boyle; Mary E. T.,14,0,60,46
1657859220401,COGS 118A,A01,083075,Gupta; Anjum,21,0,76,55
1657859226438,CSE 3,A50,083646,Miranda; Gregory Joseph,24,0,50,26
1657859232465,CSE 8A,A50,083650,Miranda; Gregory Joseph,17,1,56,39
1657859238492,CSE 11,A01,083080,Cao; Yingjun,6,15,40,34
1657859244520,CSE 12,A01,083652,Krause-Levy; Sophia Louisa,29,1,120,91
1657859250545,CSE 15L,A01,083654,Morris; Justin Loren,9,0,50,41
1657859250545,CSE 15L,A02,083655,Morris; Justin Loren,9,0,50,41
1657859256567,CSE 20,A01,083657,Tran; Khoa Dang,39,0,80,41
1657859262590,CSE 21,A01,095574,Bach; Quang Tran,22,0,48,26
1657859268614,CSE 30,A01,083084,Eldon; John,6,0,80,74
1657859268614,CSE 30,B01,095061,Bhaskar; Nishant,9,0,50,41
1657859274638,CSE 100,A01,083659,Cao; Yingjun,5,4,70,65
1657859280663,CSE 134B,A01,083661,Powell; Thomas Allan,24,0,100,76
1657859286700,CSE 140,A01,083663,Gungor; Onat,15,0,85,70
1657859292723,CSE 140L,A01,083088,Eldon; John,23,0,100,77
1657859298749,CSE 175,A01,083665,Kumar; Rakesh,3,0,25,22
1657859304778,CSE 190,A00,092507,Dubnov; Shlomo,8,0,20,12
1657859310809,ECE 45,A01,083139,Congero; Spencer William,6,0,75,69
1657859316837,ECE 65,A50,083695,Saad; Andrew S,12,0,30,18
1657859316837,ECE 65,A51,095125,Saad; Andrew S,24,0,26,2
1657859322859,ECE 109,A01,091882,Touri; Behrouz,20,0,70,50
1657859328880,ECE 180,A00,083140,Abi Samra; Nicholas Camill,1,0,30,29
1657859328880,ECE 180,B00,083141,Abi Samra; Nicholas Camill,0,0,30,30
1657859334915,MATH 10A,A01,083735,Patchell; Gregory David,2,0,30,28
1657859334915,MATH 10A,A02,083736,Patchell; Gregory David,20,0,30,10
1657859334915,MATH 10A,A03,083737,Patchell; Gregory David,16,0,30,14
1657859340945,MATH 10B,A01,083207,Lim; Seonhee,8,0,34,26
1657859340945,MATH 10B,A02,083208,Lim; Seonhee,10,0,35,25
1657859340945,MATH 10B,A03,093472,Lim; Seonhee,7,0,34,27
1657859340945,MATH 10B,B01,083739,Sinha; Shubham,14,0,30,16
1657859346976,MATH 18,A01,083743,Cinel; Cameron Alexander,9,0,30,21
1657859346976,MATH 18,A02,083744,Cinel; Cameron Alexander,18,0,30,12
1657859346976,MATH 18,A03,083745,Cinel; Cameron Alexander,10,0,30,20
1657859346976,MATH 18,B01,083748,Rideout; David Porter,5,0,37,32
1657859346976,MATH 18,B02,083749,Rideout; David Porter,5,0,36,31
1657859346976,MATH 18,B03,083750,Rideout; David Porter,3,0,37,34
1657859346976,MATH 18,B04,083751,Rideout; David Porter,6,0,36,30
1657859346976,MATH 18,B05,093473,Rideout; David Porter,6,0,36,30
1657859346976,MATH 18,B06,093474,Rideout; David Porter,6,0,36,30
1657859352999,MATH 20A,A01,083754,Zheng; Zequn,14,0,40,26
1657859359025,MATH 20B,A01,083756,Briones; Jor-el Thomas Caparas,4,0,36,32
1657859359025,MATH 20B,A02,083757,Briones; Jor-el Thomas Caparas,1,0,36,35
1657859359025,MATH 20B,A03,093475,Briones; Jor-el Thomas Caparas,2,0,36,34
1657859365054,MATH 20C,A01,083760,Briones; Jor-el Thomas Caparas,1,0,35,34
1657859365054,MATH 20C,A02,083761,Briones; Jor-el Thomas Caparas,8,0,35,27
1657859365054,MATH 20C,A03,093476,Briones; Jor-el Thomas Caparas,0,1,36,36
1657859365054,MATH 20C,B01,083762,Bach; Quang Tran,1,0,30,29
1657859371081,MATH 20D,A01,083765,Tran; Brian Kha,5,0,30,25
1657859371081,MATH 20D,A02,083766,Tran; Brian Kha,5,0,30,25
1657859371081,MATH 20D,A03,083767,Tran; Brian Kha,5,0,30,25
1657859377116,MATH 20E,A01,083771,Ganguly; Soumya,10,0,32,22
1657859377116,MATH 20E,A02,083772,Ganguly; Soumya,6,0,32,26
1657859377116,MATH 20E,B01,083773,Ciotti; Benjamin,20,0,35,15
1657859377116,MATH 20E,B02,083774,Ciotti; Benjamin,18,0,35,17
1657859383222,MATH 103A,A01,083777,Greenfeld; Be'Eri,3,0,36,33
1657859383222,MATH 103A,A02,083778,Greenfeld; Be'Eri,5,0,36,31
1657859383222,MATH 103A,A03,093561,Greenfeld; Be'Eri,6,0,36,30
1657859383222,MATH 103A,B01,083779,Greenfeld; Be'Eri,7,0,36,29
1657859383222,MATH 103A,B02,083780,Greenfeld; Be'Eri,4,0,36,32
1657859383222,MATH 103A,B03,093562,Greenfeld; Be'Eri,3,0,36,33
1657859389244,MATH 105,A01,085443,Carter; Anne Toulson,15,0,35,20
1657859389244,MATH 105,A02,093477,Carter; Anne Toulson,20,0,35,15
1657859395267,MATH 109,A01,083213,Ganzberger; Geoffrey Michael,3,0,34,31
1657859395267,MATH 109,A02,083214,Ganzberger; Geoffrey Michael,4,0,34,30
1657859395267,MATH 109,A03,093478,Ganzberger; Geoffrey Michael,2,0,34,32
1657859395267,MATH 109,B01,083215,Ganzberger; Geoffrey Michael,1,0,32,31
1657859395267,MATH 109,B02,083216,Ganzberger; Geoffrey Michael,2,0,32,30
1657859395267,MATH 109,B03,093479,Ganzberger; Geoffrey Michael,8,0,32,24
1657859401297,MATH 142A,A01,083219,Chow; Bennett,7,0,32,25
1657859401297,MATH 142A,A02,083220,Chow; Bennett,10,0,32,22
1657859401297,MATH 142A,A03,093480,Chow; Bennett,9,0,32,23
1657859401297,MATH 142A,B03,093481,Chow; Bennett,8,0,32,24
1657859401297,MATH 142A,B04,093558,Chow; Bennett,13,0,32,19
1657859401297,MATH 142A,B05,093559,Chow; Bennett,7,0,32,25
1657859407325,MATH 193A,A01,083224,Rotar; Vladimir,8,0,34,26
1657859407325,MATH 193A,A02,083225,Rotar; Vladimir,10,0,34,24
1657859407325,MATH 193A,A03,083781,Rotar; Vladimir,5,0,34,29
1657859407325,MATH 193A,A04,083782,Rotar; Vladimir,11,0,34,23
1657859407325,MATH 193A,A05,093482,Rotar; Vladimir,10,0,34,24
1657859413347,MATH 197,001,091859,McAuley; Julian John,9999,0,9999,0
1657859413347,MATH 197,002,095566,Kedlaya; Kiran S.,9997,0,9999,2
1657859413347,MATH 197,003,095567,Xiao; Ming,9999,0,9999,0
1657859413347,MATH 197,004,095571,Perols; Johan Lars,9998,0,9999,1
1657859420408,COGS 9,A01,083615,Shannon; Kyle Michael,10,0,75,65
1657859426443,COGS 11,A01,083617,Boyle; Mary E. T.,23,0,48,25
1657859432467,COGS 13,A01,083071,Bastos; Amalia Pinkusfeld,11,0,71,60
1657859438496,COGS 14A,A01,092681,Semenuks; Arturs,5,1,100,95
1657859444523,COGS 14B,A01,083073,Cheng; Tzu-Han,6,0,63,57
1657859450545,COGS 17,A01,092677,Semenuks; Arturs,6,0,81,75
1657859456568,COGS 100,A01,083619,Allen; Michael Gordon,17,0,70,53
1657859462595,COGS 101A,A01,083621,Davis; Joshua Daniel,9,0,68,59
1657859468619,COGS 101B,A01,091572,Allen; Michael Gordon,12,0,65,53
1657859474648,COGS 101C,A01,083625,Delgado; Tania,17,0,35,18
1657859480672,COGS 107A,A01,083627,Boyle; Mary E. T.,14,0,60,46
1657859486696,COGS 118A,A01,083075,Gupta; Anjum,21,0,76,55
1657859492736,CSE 3,A50,083646,Miranda; Gregory Joseph,24,0,50,26
1657859498772,CSE 8A,A50,083650,Miranda; Gregory Joseph,17,1,56,39
1657859504796,CSE 11,A01,083080,Cao; Yingjun,6,15,40,34
1657859510820,CSE 12,A01,083652,Krause-Levy; Sophia Louisa,29,1,120,91
1657859516842,CSE 15L,A01,083654,Morris; Justin Loren,9,0,50,41
1657859516842,CSE 15L,A02,083655,Morris; Justin Loren,9,0,50,41
1657859522867,CSE 20,A01,083657,Tran; Khoa Dang,39,0,80,41
1657859528895,CSE 21,A01,095574,Bach; Quang Tran,22,0,48,26
1657859534919,CSE 30,A01,083084,Eldon; John,6,0,80,74
1657859534919,CSE 30,B01,095061,Bhaskar; Nishant,9,0,50,41
1657859540947,CSE 100,A01,083659,Cao; Yingjun,5,4,70,65
1657859546978,CSE 134B,A01,083661,Powell; Thomas Allan,24,0,100,76
1657859553006,CSE 140,A01,083663,Gungor; Onat,15,0,85,70
1657859559054,CSE 140L,A01,083088,Eldon; John,23,0,100,77
1657859565081,CSE 175,A01,083665,Kumar; Rakesh,3,0,25,22
1657859571105,CSE 190,A00,092507,Dubnov; Shlomo,8,0,20,12
1657859577136,ECE 45,A01,083139,Congero; Spencer William,6,0,75,69
1657859583161,ECE 65,A50,083695,Saad; Andrew S,12,0,30,18
1657859583161,ECE 65,A51,095125,Saad; Andrew S,24,0,26,2
1657859589187,ECE 109,A01,091882,Touri; Behrouz,20,0,70,50
1657859595210,ECE 180,A00,083140,Abi Samra; Nicholas Camill,1,0,30,29
1657859595210,ECE 180,B00,083141,Abi Samra; Nicholas Camill,0,0,30,30
1657859601233,MATH 10A,A01,083735,Patchell; Gregory David,2,0,30,28
1657859601233,MATH 10A,A02,083736,Patchell; Gregory David,20,0,30,10
1657859601233,MATH 10A,A03,083737,Patchell; Gregory David,16,0,30,14
1657859607256,MATH 10B,A01,083207,Lim; Seonhee,8,0,34,26
1657859607256,MATH 10B,A02,083208,Lim; Seonhee,10,0,35,25
1657859607256,MATH 10B,A03,093472,Lim; Seonhee,7,0,34,27
1657859607256,MATH 10B,B01,083739,Sinha; Shubham,14,0,30,16
1657859613285,MATH 18,A01,083743,Cinel; Cameron Alexander,9,0,30,21
1657859613285,MATH 18,A02,083744,Cinel; Cameron Alexander,18,0,30,12
1657859613285,MATH 18,A03,083745,Cinel; Cameron Alexander,10,0,30,20
1657859613285,MATH 18,B01,083748,Rideout; David Porter,5,0,37,32
1657859613285,MATH 18,B02,083749,Rideout; David Porter,5,0,36,31
1657859613285,MATH 18,B03,083750,Rideout; David Porter,3,0,37,34
1657859613285,MATH 18,B04,083751,Rideout; David Porter,6,0,36,30
1657859613285,MATH 18,B05,093473,Rideout; David Porter,6,0,36,30
1657859613285,MATH 18,B06,093474,Rideout; David Porter,6,0,36,30
1657859619308,MATH 20A,A01,083754,Zheng; Zequn,14,0,40,26
1657859625343,MATH 20B,A01,083756,Briones; Jor-el Thomas Caparas,4,0,36,32
1657859625343,MATH 20B,A02,083757,Briones; Jor-el Thomas Caparas,1,0,36,35
1657859625343,MATH 20B,A03,093475,Briones; Jor-el Thomas Caparas,2,0,36,34
1657859631372,MATH 20C,A01,083760,Briones; Jor-el Thomas Caparas,1,0,35,34
1657859631372,MATH 20C,A02,083761,Briones; Jor-el Thomas Caparas,8,0,35,27
1657859631372,MATH 20C,A03,093476,Briones; Jor-el Thomas Caparas,0,1,36,36
1657859631372,MATH 20C,B01,083762,Bach; Quang Tran,1,0,30,29
1657859637403,MATH 20D,A01,083765,Tran; Brian Kha,5,0,30,25
1657859637403,MATH 20D,A02,083766,Tran; Brian Kha,5,0,30,25
1657859637403,MATH 20D,A03,083767,Tran; Brian Kha,5,0,30,25
1657859643431,MATH 20E,A01,083771,Ganguly; Soumya,10,0,32,22
1657859643431,MATH 20E,A02,083772,Ganguly; Soumya,6,0,32,26
1657859643431,MATH 20E,B01,083773,Ciotti; Benjamin,20,0,35,15
1657859643431,MATH 20E,B02,083774,Ciotti; Benjamin,18,0,35,17
1657859649456,MATH 103A,A01,083777,Greenfeld; Be'Eri,3,0,36,33
1657859649456,MATH 103A,A02,083778,Greenfeld; Be'Eri,5,0,36,31
1657859649456,MATH 103A,A03,093561,Greenfeld; Be'Eri,6,0,36,30
1657859649456,MATH 103A,B01,083779,Greenfeld; Be'Eri,7,0,36,29
1657859649456,MATH 103A,B02,083780,Greenfeld; Be'Eri,4,0,36,32
1657859649456,MATH 103A,B03,093562,Greenfeld; Be'Eri,3,0,36,33
1657859655479,MATH 105,A01,085443,Carter; Anne Toulson,15,0,35,20
1657859655479,MATH 105,A02,093477,Carter; Anne Toulson,20,0,35,15
1657859661509,MATH 109,A01,083213,Ganzberger; Geoffrey Michael,3,0,34,31
1657859661509,MATH 109,A02,083214,Ganzberger; Geoffrey Michael,4,0,34,30
1657859661509,MATH 109,A03,093478,Ganzberger; Geoffrey Michael,2,0,34,32
1657859661509,MATH 109,B01,083215,Ganzberger; Geoffrey Michael,1,0,32,31
1657859661509,MATH 109,B02,083216,Ganzberger; Geoffrey Michael,2,0,32,30
1657859661509,MATH 109,B03,093479,Ganzberger; Geoffrey Michael,8,0,32,24
1657859667540,MATH 142A,A01,083219,Chow; Bennett,7,0,32,25
1657859667540,MATH 142A,A02,083220,Chow; Bennett,10,0,32,22
1657859667540,MATH 142A,A03,093480,Chow; Bennett,9,0,32,23
1657859667540,MATH 142A,B03,093481,Chow; Bennett,8,0,32,24
1657859667540,MATH 142A,B04,093558,Chow; Bennett,13,0,32,19
1657859667540,MATH 142A,B05,093559,Chow; Bennett,7,0,32,25
1657859673565,MATH 193A,A01,083224,Rotar; Vladimir,8,0,34,26
1657859673565,MATH 193A,A02,083225,Rotar; Vladimir,10,0,34,24
1657859673565,MATH 193A,A03,083781,Rotar; Vladimir,5,0,34,29
1657859673565,MATH 193A,A04,083782,Rotar; Vladimir,11,0,34,23
1657859673565,MATH 193A,A05,093482,Rotar; Vladimir,10,0,34,24
1657859679588,MATH 197,001,091859,McAuley; Julian John,9999,0,9999,0
1657859679588,MATH 197,002,095566,Kedlaya; Kiran S.,9997,0,9999,2
1657859679588,MATH 197,003,095567,Xiao; Ming,9999,0,9999,0
1657859679588,MATH 197,004,095571,Perols; Johan Lars,9998,0,9999,1
1657859686643,COGS 9,A01,083615,Shannon; Kyle Michael,10,0,75,65
1657859692669,COGS 11,A01,083617,Boyle; Mary E. T.,23,0,48,25
1657859698696,COGS 13,A01,083071,Bastos; Amalia Pinkusfeld,11,0,71,60
1657859704721,COGS 14A,A01,092681,Semenuks; Arturs,5,1,100,95
1657859710743,COGS 14B,A01,083073,Cheng; Tzu-Han,6,0,63,57
1657859716768,COGS 17,A01,092677,Semenuks; Arturs,6,0,81,75
1657859722794,COGS 100,A01,083619,Allen; Michael Gordon,17,0,70,53
1657859728833,COGS 101A,A01,083621,Davis; Joshua Daniel,9,0,68,59
1657859734855,COGS 101B,A01,091572,Allen; Michael Gordon,12,0,65,53
1657859740879,COGS 101C,A01,083625,Delgado; Tania,17,0,35,18
1657859746901,COGS 107A,A01,083627,Boyle; Mary E. T.,14,0,60,46
1657859752928,COGS 118A,A01,083075,Gupta; Anjum,21,0,76,55
1657859758958,CSE 3,A50,083646,Miranda; Gregory Joseph,24,0,50,26
1657859764984,CSE 8A,A50,083650,Miranda; Gregory Joseph,17,1,56,39
1657859771007,CSE 11,A01,083080,Cao; Yingjun,6,15,40,34
1657859777031,CSE 12,A01,083652,Krause-Levy; Sophia Louisa,29,1,120,91
1657859783056,CSE 15L,A01,083654,Morris; Justin Loren,9,0,50,41
1657859783056,CSE 15L,A02,083655,Morris; Justin Loren,9,0,50,41
1657859789084,CSE 20,A01,083657,Tran; Khoa Dang,39,0,80,41
1657859795106,CSE 21,A01,095574,Bach; Quang Tran,22,0,48,26
1657859801129,CSE 30,A01,083084,Eldon; John,6,0,80,74
1657859801129,CSE 30,B01,095061,Bhaskar; Nishant,9,0,50,41
1657859807151,CSE 100,A01,083659,Cao; Yingjun,5,4,70,65
1657859813183,CSE 134B,A01,083661,Powell; Thomas Allan,24,0,100,76
1657859819210,CSE 140,A01,083663,Gungor; Onat,15,0,85,70
1657859825235,CSE 140L,A01,083088,Eldon; John,23,0,100,77
1657859831261,CSE 175,A01,083665,Kumar; Rakesh,3,0,25,22
1657859837291,CSE 190,A00,092507,Dubnov; Shlomo,8,0,20,12
1657859843314,ECE 45,A01,083139,Congero; Spencer William,6,0,75,69
1657859849337,ECE 65,A50,083695,Saad; Andrew S,12,0,30,18
1657859849337,ECE 65,A51,095125,Saad; Andrew S,24,0,26,2
1657859855366,ECE 109,A01,091882,Touri; Behrouz,20,0,70,50
1657859861388,ECE 180,A00,083140,Abi Samra; Nicholas Camill,1,0,30,29
1657859861388,ECE 180,B00,083141,Abi Samra; Nicholas Camill,0,0,30,30
1657859867418,MATH 10A,A01,083735,Patchell; Gregory David,2,0,30,28
1657859867418,MATH 10A,A02,083736,Patchell; Gregory David,20,0,30,10
1657859867418,MATH 10A,A03,083737,Patchell; Gregory David,16,0,30,14
1657859873449,MATH 10B,A01,083207,Lim; Seonhee,8,0,34,26
1657859873449,MATH 10B,A02,083208,Lim; Seonhee,10,0,35,25
1657859873449,MATH 10B,A03,093472,Lim; Seonhee,7,0,34,27
1657859873449,MATH 10B,B01,083739,Sinha; Shubham,14,0,30,16
1657859879474,MATH 18,A01,083743,Cinel; Cameron Alexander,9,0,30,21
1657859879474,MATH 18,A02,083744,Cinel; Cameron Alexander,18,0,30,12
1657859879474,MATH 18,A03,083745,Cinel; Cameron Alexander,10,0,30,20
1657859879474,MATH 18,B01,083748,Rideout; David Porter,5,0,37,32
1657859879474,MATH 18,B02,083749,Rideout; David Porter,5,0,36,31
1657859879474,MATH 18,B03,083750,Rideout; David Porter,3,0,37,34
1657859879474,MATH 18,B04,083751,Rideout; David Porter,6,0,36,30
1657859879474,MATH 18,B05,093473,Rideout; David Porter,6,0,36,30
1657859879474,MATH 18,B06,093474,Rideout; David Porter,6,0,36,30
1657859885496,MATH 20A,A01,083754,Zheng; Zequn,14,0,40,26
1657859891520,MATH 20B,A01,083756,Briones; Jor-el Thomas Caparas,4,0,36,32
1657859891520,MATH 20B,A02,083757,Briones; Jor-el Thomas Caparas,1,0,36,35
1657859891520,MATH 20B,A03,093475,Briones; Jor-el Thomas Caparas,2,0,36,34
1657859897543,MATH 20C,A01,083760,Briones; Jor-el Thomas Caparas,1,0,35,34
1657859897543,MATH 20C,A02,083761,Briones; Jor-el Thomas Caparas,8,0,35,27
1657859897543,MATH 20C,A03,093476,Briones; Jor-el Thomas Caparas,0,1,36,36
1657859897543,MATH 20C,B01,083762,Bach; Quang Tran,1,0,30,29
1657859903568,MATH 20D,A01,083765,Tran; Brian Kha,5,0,30,25
1657859903568,MATH 20D,A02,083766,Tran; Brian Kha,5,0,30,25
1657859903568,MATH 20D,A03,083767,Tran; Brian Kha,5,0,30,25
1657859909600,MATH 20E,A01,083771,Ganguly; Soumya,10,0,32,22
1657859909600,MATH 20E,A02,083772,Ganguly; Soumya,6,0,32,26
1657859909600,MATH 20E,B01,083773,Ciotti; Benjamin,20,0,35,15
1657859909600,MATH 20E,B02,083774,Ciotti; Benjamin,18,0,35,17
1657859915629,MATH 103A,A01,083777,Greenfeld; Be'Eri,3,0,36,33
1657859915629,MATH 103A,A02,083778,Greenfeld; Be'Eri,5,0,36,31
1657859915629,MATH 103A,A03,093561,Greenfeld; Be'Eri,6,0,36,30
1657859915629,MATH 103A,B01,083779,Greenfeld; Be'Eri,7,0,36,29
1657859915629,MATH 103A,B02,083780,Greenfeld; Be'Eri,4,0,36,32
1657859915629,MATH 103A,B03,093562,Greenfeld; Be'Eri,3,0,36,33
1657859921657,MATH 105,A01,085443,Carter; Anne Toulson,15,0,35,20
1657859921657,MATH 105,A02,093477,Carter; Anne Toulson,20,0,35,15
1657859927686,MATH 109,A01,083213,Ganzberger; Geoffrey Michael,3,0,34,31
1657859927686,MATH 109,A02,083214,Ganzberger; Geoffrey Michael,4,0,34,30
1657859927686,MATH 109,A03,093478,Ganzberger; Geoffrey Michael,2,0,34,32
1657859927686,MATH 109,B01,083215,Ganzberger; Geoffrey Michael,1,0,32,31
1657859927686,MATH 109,B02,083216,Ganzberger; Geoffrey Michael,2,0,32,30
1657859927686,MATH 109,B03,093479,Ganzberger; Geoffrey Michael,8,0,32,24
1657859933708,MATH 142A,A01,083219,Chow; Bennett,7,0,32,25
1657859933708,MATH 142A,A02,083220,Chow; Bennett,10,0,32,22
1657859933708,MATH 142A,A03,093480,Chow; Bennett,9,0,32,23
1657859933708,MATH 142A,B03,093481,Chow; Bennett,8,0,32,24
1657859933708,MATH 142A,B04,093558,Chow; Bennett,13,0,32,19
1657859933708,MATH 142A,B05,093559,Chow; Bennett,7,0,32,25
1657859939735,MATH 193A,A01,083224,Rotar; Vladimir,8,0,34,26
1657859939735,MATH 193A,A02,083225,Rotar; Vladimir,10,0,34,24
1657859939735,MATH 193A,A03,083781,Rotar; Vladimir,5,0,34,29
1657859939735,MATH 193A,A04,083782,Rotar; Vladimir,11,0,34,23
1657859939735,MATH 193A,A05,093482,Rotar; Vladimir,10,0,34,24
1657859945757,MATH 197,001,091859,McAuley; Julian John,9999,0,9999,0
1657859945757,MATH 197,002,095566,Kedlaya; Kiran S.,9997,0,9999,2
1657859945757,MATH 197,003,095567,Xiao; Ming,9999,0,9999,0
1657859945757,MATH 197,004,095571,Perols; Johan Lars,9998,0,9999,1
1657859952813,COGS 9,A01,083615,Shannon; Kyle Michael,10,0,75,65
1657859958837,COGS 11,A01,083617,Boyle; Mary E. T.,23,0,48,25
1657859964865,COGS 13,A01,083071,Bastos; Amalia Pinkusfeld,11,0,71,60
1657859970889,COGS 14A,A01,092681,Semenuks; Arturs,5,1,100,95
1657859976985,COGS 14B,A01,083073,Cheng; Tzu-Han,6,0,63,57
1657859983007,COGS 17,A01,092677,Semenuks; Arturs,6,0,81,75
1657859989029,COGS 100,A01,083619,Allen; Michael Gordon,17,0,70,53
1657859995052,COGS 101A,A01,083621,Davis; Joshua Daniel,9,0,68,59
1657860001079,COGS 101B,A01,091572,Allen; Michael Gordon,12,0,65,53
1657860007103,COGS 101C,A01,083625,Delgado; Tania,17,0,35,18
1657860013132,COGS 107A,A01,083627,Boyle; Mary E. T.,14,0,60,46
1657860019155,COGS 118A,A01,083075,Gupta; Anjum,21,0,76,55
1657860025178,CSE 3,A50,083646,Miranda; Gregory Joseph,24,0,50,26
1657860031201,CSE 8A,A50,083650,Miranda; Gregory Joseph,17,1,56,39
1657860037227,CSE 11,A01,083080,Cao; Yingjun,6,15,40,34
1657860043250,CSE 12,A01,083652,Krause-Levy; Sophia Louisa,29,1,120,91
1657860049273,CSE 15L,A01,083654,Morris; Justin Loren,9,0,50,41
1657860049273,CSE 15L,A02,083655,Morris; Justin Loren,9,0,50,41
1657860055297,CSE 20,A01,083657,Tran; Khoa Dang,39,0,80,41
1657860061318,CSE 21,A01,095574,Bach; Quang Tran,22,0,48,26
1657860067341,CSE 30,A01,083084,Eldon; John,6,0,80,74
1657860067341,CSE 30,B01,095061,Bhaskar; Nishant,9,0,50,41
1657860073365,CSE 100,A01,083659,Cao; Yingjun,5,4,70,65
1657860079393,CSE 134B,A01,083661,Powell; Thomas Allan,24,0,100,76
1657860085416,CSE 140,A01,083663,Gungor; Onat,15,0,85,70
1657860091442,CSE 140L,A01,083088,Eldon; John,23,0,100,77
1657860097465,CSE 175,A01,083665,Kumar; Rakesh,3,0,25,22
1657860103489,CSE 190,A00,092507,Dubnov; Shlomo,8,0,20,12
1657860109516,ECE 45,A01,083139,Congero; Spencer William,6,0,75,69
1657860115542,ECE 65,A50,083695,Saad; Andrew S,12,0,30,18
1657860115542,ECE 65,A51,095125,Saad; Andrew S,24,0,26,2
1657860121568,ECE 109,A01,091882,Touri; Behrouz,20,0,70,50
1657860127595,ECE 180,A00,083140,Abi Samra; Nicholas Camill,1,0,30,29
1657860127595,ECE 180,B00,083141,Abi Samra; Nicholas Camill,0,0,30,30
1657860133617,MATH 10A,A01,083735,Patchell; Gregory David,2,0,30,28
1657860133617,MATH 10A,A02,083736,Patchell; Gregory David,20,0,30,10
1657860133617,MATH 10A,A03,083737,Patchell; Gregory David,16,0,30,14
1657860139641,MATH 10B,A01,083207,Lim; Seonhee,8,0,34,26
1657860139641,MATH 10B,A02,083208,Lim; Seonhee,10,0,35,25
1657860139641,MATH 10B,A03,093472,Lim; Seonhee,7,0,34,27
1657860139641,MATH 10B,B01,083739,Sinha; Shubham,14,0,30,16
1657860145673,MATH 18,A01,083743,Cinel; Cameron Alexander,9,0,30,21
1657860145673,MATH 18,A02,083744,Cinel; Cameron Alexander,18,0,30,12
1657860145673,MATH 18,A03,083745,Cinel; Cameron Alexander,10,0,30,20
1657860145673,MATH 18,B01,083748,Rideout; David Porter,5,0,37,32
1657860145673,MATH 18,B02,083749,Rideout; David Porter,5,0,36,31
1657860145673,MATH 18,B03,083750,Rideout; David Porter,3,0,37,34
1657860145673,MATH 18,B04,083751,Rideout; David Porter,6,0,36,30
1657860145673,MATH 18,B05,093473,Rideout; David Porter,6,0,36,30
1657860145673,MATH 18,B06,093474,Rideout; David Porter,6,0,36,30
1657860151695,MATH 20A,A01,083754,Zheng; Zequn,14,0,40,26
1657860157721,MATH 20B,A01,083756,Briones; Jor-el Thomas Caparas,4,0,36,32
1657860157721,MATH 20B,A02,083757,Briones; Jor-el Thomas Caparas,1,0,36,35
1657860157721,MATH 20B,A03,093475,Briones; Jor-el Thomas Caparas,2,0,36,34
1657860163750,MATH 20C,A01,083760,Briones; Jor-el Thomas Caparas,1,0,35,34
1657860163750,MATH 20C,A02,083761,Briones; Jor-el Thomas Caparas,8,0,35,27
1657860163750,MATH 20C,A03,093476,Briones; Jor-el Thomas Caparas,0,1,36,36
1657860163750,MATH 20C,B01,083762,Bach; Quang Tran,1,0,30,29
1657860169773,MATH 20D,A01,083765,Tran; Brian Kha,5,0,30,25
1657860169773,MATH 20D,A02,083766,Tran; Brian Kha,5,0,30,25
1657860169773,MATH 20D,A03,083767,Tran; Brian Kha,5,0,30,25
1657860175797,MATH 20E,A01,083771,Ganguly; Soumya,10,0,32,22
1657860175797,MATH 20E,A02,083772,Ganguly; Soumya,6,0,32,26
1657860175797,MATH 20E,B01,083773,Ciotti; Benjamin,20,0,35,15
1657860175797,MATH 20E,B02,083774,Ciotti; Benjamin,18,0,35,17
1657860181821,MATH 103A,A01,083777,Greenfeld; Be'Eri,3,0,36,33
1657860181821,MATH 103A,A02,083778,Greenfeld; Be'Eri,5,0,36,31
1657860181821,MATH 103A,A03,093561,Greenfeld; Be'Eri,6,0,36,30
1657860181821,MATH 103A,B01,083779,Greenfeld; Be'Eri,7,0,36,29
1657860181821,MATH 103A,B02,083780,Greenfeld; Be'Eri,4,0,36,32
1657860181821,MATH 103A,B03,093562,Greenfeld; Be'Eri,3,0,36,33
1657860187842,MATH 105,A01,085443,Carter; Anne Toulson,15,0,35,20
1657860187842,MATH 105,A02,093477,Carter; Anne Toulson,20,0,35,15
1657860193874,MATH 109,A01,083213,Ganzberger; Geoffrey Michael,3,0,34,31
1657860193874,MATH 109,A02,083214,Ganzberger; Geoffrey Michael,4,0,34,30
1657860193874,MATH 109,A03,093478,Ganzberger; Geoffrey Michael,2,0,34,32
1657860193874,MATH 109,B01,083215,Ganzberger; Geoffrey Michael,1,0,32,31
1657860193874,MATH 109,B02,083216,Ganzberger; Geoffrey Michael,2,0,32,30
1657860193874,MATH 109,B03,093479,Ganzberger; Geoffrey Michael,8,0,32,24
1657860199897,MATH 142A,A01,083219,Chow; Bennett,7,0,32,25
1657860199897,MATH 142A,A02,083220,Chow; Bennett,10,0,32,22
1657860199897,MATH 142A,A03,093480,Chow; Bennett,9,0,32,23
1657860199897,MATH 142A,B03,093481,Chow; Bennett,8,0,32,24
1657860199897,MATH 142A,B04,093558,Chow; Bennett,13,0,32,19
1657860199897,MATH 142A,B05,093559,Chow; Bennett,7,0,32,25
1657860205924,MATH 193A,A01,083224,Rotar; Vladimir,8,0,34,26
1657860205924,MATH 193A,A02,083225,Rotar; Vladimir,10,0,34,24
1657860205924,MATH 193A,A03,083781,Rotar; Vladimir,5,0,34,29
1657860205924,MATH 193A,A04,083782,Rotar; Vladimir,11,0,34,23
1657860205924,MATH 193A,A05,093482,Rotar; Vladimir,10,0,34,24
1657860211954,MATH 197,001,091859,McAuley; Julian John,9999,0,9999,0
1657860211954,MATH 197,002,095566,Kedlaya; Kiran S.,9997,0,9999,2
1657860211954,MATH 197,003,095567,Xiao; Ming,9999,0,9999,0
1657860211954,MATH 197,004,095571,Perols; Johan Lars,9998,0,9999,1
1657860219013,COGS 9,A01,083615,Shannon; Kyle Michael,10,0,75,65
1657860225037,COGS 11,A01,083617,Boyle; Mary E. T.,23,0,48,25
1657860231061,COGS 13,A01,083071,Bastos; Amalia Pinkusfeld,11,0,71,60
1657860237090,COGS 14A,A01,092681,Semenuks; Arturs,5,1,100,95
1657860243113,COGS 14B,A01,083073,Cheng; Tzu-Han,6,0,63,57
1657860249136,COGS 17,A01,092677,Semenuks; Arturs,6,0,81,75
1657860255158,COGS 100,A01,083619,Allen; Michael Gordon,17,0,70,53
1657860261182,COGS 101A,A01,083621,Davis; Joshua Daniel,9,0,68,59
1657860267210,COGS 101B,A01,091572,Allen; Michael Gordon,12,0,65,53
1657860273236,COGS 101C,A01,083625,Delgado; Tania,17,0,35,18
1657860279261,COGS 107A,A01,083627,Boyle; Mary E. T.,14,0,60,46
1657860296878,COGS 118A,A01,083075,Gupta; Anjum,21,0,76,55
1657860302902,CSE 3,A50,083646,Miranda; Gregory Joseph,24,0,50,26
1657860308925,CSE 8A,A50,083650,Miranda; Gregory Joseph,17,1,56,39
1657860314950,CSE 11,A01,083080,Cao; Yingjun,6,15,40,34
1657860320976,CSE 12,A01,083652,Krause-Levy; Sophia Louisa,29,1,120,91
1657860326998,CSE 15L,A01,083654,Morris; Justin Loren,9,0,50,41
1657860326998,CSE 15L,A02,083655,Morris; Justin Loren,9,0,50,41
1657860333023,CSE 20,A01,083657,Tran; Khoa Dang,39,0,80,41
1657860339058,CSE 21,A01,095574,Bach; Quang Tran,22,0,48,26
1657860345082,CSE 30,A01,083084,Eldon; John,6,0,80,74
1657860345082,CSE 30,B01,095061,Bhaskar; Nishant,9,0,50,41
1657860351110,CSE 100,A01,083659,Cao; Yingjun,5,4,70,65
1657860357139,CSE 134B,A01,083661,Powell; Thomas Allan,24,0,100,76
1657860363166,CSE 140,A01,083663,Gungor; Onat,15,0,85,70
1657860369193,CSE 140L,A01,083088,Eldon; John,23,0,100,77
1657860375220,CSE 175,A01,083665,Kumar; Rakesh,3,0,25,22
1657860381247,CSE 190,A00,092507,Dubnov; Shlomo,8,0,20,12
1657860387269,ECE 45,A01,083139,Congero; Spencer William,6,0,75,69
1657860393294,ECE 65,A50,083695,Saad; Andrew S,12,0,30,18
1657860393294,ECE 65,A51,095125,Saad; Andrew S,24,0,26,2
1657860399322,ECE 109,A01,091882,Touri; Behrouz,20,0,70,50
1657860405349,ECE 180,A00,083140,Abi Samra; Nicholas Camill,1,0,30,29
1657860405349,ECE 180,B00,083141,Abi Samra; Nicholas Camill,0,0,30,30
1657860411373,MATH 10A,A01,083735,Patchell; Gregory David,2,0,30,28
1657860411373,MATH 10A,A02,083736,Patchell; Gregory David,20,0,30,10
1657860411373,MATH 10A,A03,083737,Patchell; Gregory David,16,0,30,14
1657860417401,MATH 10B,A01,083207,Lim; Seonhee,8,0,34,26
1657860417401,MATH 10B,A02,083208,Lim; Seonhee,10,0,35,25
1657860417401,MATH 10B,A03,093472,Lim; Seonhee,7,0,34,27
1657860417401,MATH 10B,B01,083739,Sinha; Shubham,14,0,30,16
1657860423426,MATH 18,A01,083743,Cinel; Cameron Alexander,9,0,30,21
1657860423426,MATH 18,A02,083744,Cinel; Cameron Alexander,18,0,30,12
1657860423426,MATH 18,A03,083745,Cinel; Cameron Alexander,10,0,30,20
1657860423426,MATH 18,B01,083748,Rideout; David Porter,5,0,37,32
1657860423426,MATH 18,B02,083749,Rideout; David Porter,5,0,36,31
1657860423426,MATH 18,B03,083750,Rideout; David Porter,3,0,37,34
1657860423426,MATH 18,B04,083751,Rideout; David Porter,6,0,36,30
1657860423426,MATH 18,B05,093473,Rideout; David Porter,6,0,36,30
1657860423426,MATH 18,B06,093474,Rideout; David Porter,6,0,36,30
1657860429449,MATH 20A,A01,083754,Zheng; Zequn,14,0,40,26
1657860435471,MATH 20B,A01,083756,Briones; Jor-el Thomas Caparas,4,0,36,32
1657860435471,MATH 20B,A02,083757,Briones; Jor-el Thomas Caparas,1,0,36,35
1657860435471,MATH 20B,A03,093475,Briones; Jor-el Thomas Caparas,2,0,36,34
1657860441500,MATH 20C,A01,083760,Briones; Jor-el Thomas Caparas,1,0,35,34
1657860441500,MATH 20C,A02,083761,Briones; Jor-el Thomas Caparas,8,0,35,27
1657860441500,MATH 20C,A03,093476,Briones; Jor-el Thomas Caparas,0,1,36,36
1657860441500,MATH 20C,B01,083762,Bach; Quang Tran,1,0,30,29
1657860447524,MATH 20D,A01,083765,Tran; Brian Kha,5,0,30,25
1657860447524,MATH 20D,A02,083766,Tran; Brian Kha,5,0,30,25
1657860447524,MATH 20D,A03,083767,Tran; Brian Kha,5,0,30,25
1657860453549,MATH 20E,A01,083771,Ganguly; Soumya,10,0,32,22
1657860453549,MATH 20E,A02,083772,Ganguly; Soumya,6,0,32,26
1657860453549,MATH 20E,B01,083773,Ciotti; Benjamin,20,0,35,15
1657860453549,MATH 20E,B02,083774,Ciotti; Benjamin,18,0,35,17
1657860459577,MATH 103A,A01,083777,Greenfeld; Be'Eri,3,0,36,33
1657860459577,MATH 103A,A02,083778,Greenfeld; Be'Eri,5,0,36,31
1657860459577,MATH 103A,A03,093561,Greenfeld; Be'Eri,6,0,36,30
1657860459577,MATH 103A,B01,083779,Greenfeld; Be'Eri,7,0,36,29
1657860459577,MATH 103A,B02,083780,Greenfeld; Be'Eri,4,0,36,32
1657860459577,MATH 103A,B03,093562,Greenfeld; Be'Eri,3,0,36,33
1657860465602,MATH 105,A01,085443,Carter; Anne Toulson,15,0,35,20
1657860465602,MATH 105,A02,093477,Carter; Anne Toulson,20,0,35,15
1657860471631,MATH 109,A01,083213,Ganzberger; Geoffrey Michael,3,0,34,31
1657860471631,MATH 109,A02,083214,Ganzberger; Geoffrey Michael,4,0,34,30
1657860471631,MATH 109,A03,093478,Ganzberger; Geoffrey Michael,2,0,34,32
1657860471631,MATH 109,B01,083215,Ganzberger; Geoffrey Michael,1,0,32,31
1657860471631,MATH 109,B02,083216,Ganzberger; Geoffrey Michael,2,0,32,30
1657860471631,MATH 109,B03,093479,Ganzberger; Geoffrey Michael,8,0,32,24
1657860477655,MATH 142A,A01,083219,Chow; Bennett,7,0,32,25
1657860477655,MATH 142A,A02,083220,Chow; Bennett,10,0,32,22
1657860477655,MATH 142A,A03,093480,Chow; Bennett,9,0,32,23
1657860477655,MATH 142A,B03,093481,Chow; Bennett,8,0,32,24
1657860477655,MATH 142A,B04,093558,Chow; Bennett,13,0,32,19
1657860477655,MATH 142A,B05,093559,Chow; Bennett,7,0,32,25
1657860483679,MATH 193A,A01,083224,Rotar; Vladimir,8,0,34,26
1657860483679,MATH 193A,A02,083225,Rotar; Vladimir,10,0,34,24
1657860483679,MATH 193A,A03,083781,Rotar; Vladimir,5,0,34,29
1657860483679,MATH 193A,A04,083782,Rotar; Vladimir,11,0,34,23
1657860483679,MATH 193A,A05,093482,Rotar; Vladimir,10,0,34,24
1657860489705,MATH 197,001,091859,McAuley; Julian John,9999,0,9999,0
1657860489705,MATH 197,002,095566,Kedlaya; Kiran S.,9997,0,9999,2
1657860489705,MATH 197,003,095567,Xiao; Ming,9999,0,9999,0
1657860489705,MATH 197,004,095571,Perols; Johan Lars,9998,0,9999,1
1657860496763,COGS 9,A01,083615,Shannon; Kyle Michael,10,0,75,65
1657860502790,COGS 11,A01,083617,Boyle; Mary E. T.,23,0,48,25
1657860508813,COGS 13,A01,083071,Bastos; Amalia Pinkusfeld,11,0,71,60
1657860514836,COGS 14A,A01,092681,Semenuks; Arturs,5,1,100,95
1657860520864,COGS 14B,A01,083073,Cheng; Tzu-Han,6,0,63,57
1657860526893,COGS 17,A01,092677,Semenuks; Arturs,6,0,81,75
1657860532921,COGS 100,A01,083619,Allen; Michael Gordon,17,0,70,53
1657860538945,COGS 101A,A01,083621,Davis; Joshua Daniel,9,0,68,59
1657860544967,COGS 101B,A01,091572,Allen; Michael Gordon,12,0,65,53
1657860550989,COGS 101C,A01,083625,Delgado; Tania,17,0,35,18
1657860557013,COGS 107A,A01,083627,Boyle; Mary E. T.,14,0,60,46
1657860563035,COGS 118A,A01,083075,Gupta; Anjum,21,0,76,55
1657860569059,CSE 3,A50,083646,Miranda; Gregory Joseph,24,0,50,26
1657860575083,CSE 8A,A50,083650,Miranda; Gregory Joseph,17,1,56,39
1657860581104,CSE 11,A01,083080,Cao; Yingjun,6,15,40,34
1657860587210,CSE 12,A01,083652,Krause-Levy; Sophia Louisa,29,1,120,91
1657860593236,CSE 15L,A01,083654,Morris; Justin Loren,9,0,50,41
1657860593236,CSE 15L,A02,083655,Morris; Justin Loren,9,0,50,41
1657860599275,CSE 20,A01,083657,Tran; Khoa Dang,39,0,80,41
1657860605299,CSE 21,A01,095574,Bach; Quang Tran,22,0,48,26
1657860611322,CSE 30,A01,083084,Eldon; John,6,0,80,74
1657860611322,CSE 30,B01,095061,Bhaskar; Nishant,9,0,50,41
1657860617354,CSE 100,A01,083659,Cao; Yingjun,5,4,70,65
1657860623380,CSE 134B,A01,083661,Powell; Thomas Allan,24,0,100,76
1657860629407,CSE 140,A01,083663,Gungor; Onat,15,0,85,70
1657860635430,CSE 140L,A01,083088,Eldon; John,23,0,100,77
1657860641452,CSE 175,A01,083665,Kumar; Rakesh,3,0,25,22
1657860647476,CSE 190,A00,092507,Dubnov; Shlomo,8,0,20,12
1657860653499,ECE 45,A01,083139,Congero; Spencer William,6,0,75,69
1657860659537,ECE 65,A50,083695,Saad; Andrew S,12,0,30,18
1657860659537,ECE 65,A51,095125,Saad; Andrew S,24,0,26,2
1657860665564,ECE 109,A01,091882,Touri; Behrouz,20,0,70,50
1657860671586,ECE 180,A00,083140,Abi Samra; Nicholas Camill,1,0,30,29
1657860671586,ECE 180,B00,083141,Abi Samra; Nicholas Camill,0,0,30,30
1657860677610,MATH 10A,A01,083735,Patchell; Gregory David,2,0,30,28
1657860677610,MATH 10A,A02,083736,Patchell; Gregory David,20,0,30,10
1657860677610,MATH 10A,A03,083737,Patchell; Gregory David,16,0,30,14
1657860683634,MATH 10B,A01,083207,Lim; Seonhee,8,0,34,26
1657860683634,MATH 10B,A02,083208,Lim; Seonhee,10,0,35,25
1657860683634,MATH 10B,A03,093472,Lim; Seonhee,7,0,34,27
1657860683634,MATH 10B,B01,083739,Sinha; Shubham,14,0,30,16
1657860689663,MATH 18,A01,083743,Cinel; Cameron Alexander,9,0,30,21
1657860689663,MATH 18,A02,083744,Cinel; Cameron Alexander,18,0,30,12
1657860689663,MATH 18,A03,083745,Cinel; Cameron Alexander,10,0,30,20
1657860689663,MATH 18,B01,083748,Rideout; David Porter,5,0,37,32
1657860689663,MATH 18,B02,083749,Rideout; David Porter,5,0,36,31
1657860689663,MATH 18,B03,083750,Rideout; David Porter,3,0,37,34
1657860689663,MATH 18,B04,083751,Rideout; David Porter,6,0,36,30
1657860689663,MATH 18,B05,093473,Rideout; David Porter,6,0,36,30
1657860689663,MATH 18,B06,093474,Rideout; David Porter,6,0,36,30
1657860695687,MATH 20A,A01,083754,Zheng; Zequn,14,0,40,26
1657860701729,MATH 20B,A01,083756,Briones; Jor-el Thomas Caparas,4,0,36,32
1657860701729,MATH 20B,A02,083757,Briones; Jor-el Thomas Caparas,1,0,36,35
1657860701729,MATH 20B,A03,093475,Briones; Jor-el Thomas Caparas,2,0,36,34
1657860707757,MATH 20C,A01,083760,Briones; Jor-el Thomas Caparas,1,0,35,34
1657860707757,MATH 20C,A02,083761,Briones; Jor-el Thomas Caparas,8,0,35,27
1657860707757,MATH 20C,A03,093476,Briones; Jor-el Thomas Caparas,0,1,36,36
1657860707757,MATH 20C,B01,083762,Bach; Quang Tran,1,0,30,29
1657860713781,MATH 20D,A01,083765,Tran; Brian Kha,5,0,30,25
1657860713781,MATH 20D,A02,083766,Tran; Brian Kha,5,0,30,25
1657860713781,MATH 20D,A03,083767,Tran; Brian Kha,5,0,30,25
1657860719809,MATH 20E,A01,083771,Ganguly; Soumya,10,0,32,22
1657860719809,MATH 20E,A02,083772,Ganguly; Soumya,6,0,32,26
1657860719809,MATH 20E,B01,083773,Ciotti; Benjamin,20,0,35,15
1657860719809,MATH 20E,B02,083774,Ciotti; Benjamin,18,0,35,17
1657860725838,MATH 103A,A01,083777,Greenfeld; Be'Eri,3,0,36,33
1657860725838,MATH 103A,A02,083778,Greenfeld; Be'Eri,5,0,36,31
1657860725838,MATH 103A,A03,093561,Greenfeld; Be'Eri,6,0,36,30
1657860725838,MATH 103A,B01,083779,Greenfeld; Be'Eri,7,0,36,29
1657860725838,MATH 103A,B02,083780,Greenfeld; Be'Eri,4,0,36,32
1657860725838,MATH 103A,B03,093562,Greenfeld; Be'Eri,3,0,36,33
1657860731861,MATH 105,A01,085443,Carter; Anne Toulson,15,0,35,20
1657860731861,MATH 105,A02,093477,Carter; Anne Toulson,20,0,35,15
1657860737887,MATH 109,A01,083213,Ganzberger; Geoffrey Michael,3,0,34,31
1657860737887,MATH 109,A02,083214,Ganzberger; Geoffrey Michael,4,0,34,30
1657860737887,MATH 109,A03,093478,Ganzberger; Geoffrey Michael,2,0,34,32
1657860737887,MATH 109,B01,083215,Ganzberger; Geoffrey Michael,1,0,32,31
1657860737887,MATH 109,B02,083216,Ganzberger; Geoffrey Michael,2,0,32,30
1657860737887,MATH 109,B03,093479,Ganzberger; Geoffrey Michael,8,0,32,24
1657860743912,MATH 142A,A01,083219,Chow; Bennett,7,0,32,25
1657860743912,MATH 142A,A02,083220,Chow; Bennett,10,0,32,22
1657860743912,MATH 142A,A03,093480,Chow; Bennett,9,0,32,23
1657860743912,MATH 142A,B03,093481,Chow; Bennett,8,0,32,24
1657860743912,MATH 142A,B04,093558,Chow; Bennett,13,0,32,19
1657860743912,MATH 142A,B05,093559,Chow; Bennett,7,0,32,25
1657860749940,MATH 193A,A01,083224,Rotar; Vladimir,8,0,34,26
1657860749940,MATH 193A,A02,083225,Rotar; Vladimir,10,0,34,24
1657860749940,MATH 193A,A03,083781,Rotar; Vladimir,5,0,34,29
1657860749940,MATH 193A,A04,083782,Rotar; Vladimir,11,0,34,23
1657860749940,MATH 193A,A05,093482,Rotar; Vladimir,10,0,34,24
1657860755963,MATH 197,001,091859,McAuley; Julian John,9999,0,9999,0
1657860755963,MATH 197,002,095566,Kedlaya; Kiran S.,9997,0,9999,2
1657860755963,MATH 197,003,095567,Xiao; Ming,9999,0,9999,0
1657860755963,MATH 197,004,095571,Perols; Johan Lars,9998,0,9999,1
1657860763014,COGS 9,A01,083615,Shannon; Kyle Michael,10,0,75,65
1657860769038,COGS 11,A01,083617,Boyle; Mary E. T.,23,0,48,25
1657860775065,COGS 13,A01,083071,Bastos; Amalia Pinkusfeld,11,0,71,60
1657860781095,COGS 14A,A01,092681,Semenuks; Arturs,5,1,100,95
1657860787117,COGS 14B,A01,083073,Cheng; Tzu-Han,6,0,63,57
1657860793153,COGS 17,A01,092677,Semenuks; Arturs,6,0,81,75
1657860799176,COGS 100,A01,083619,Allen; Michael Gordon,17,0,70,53
1657860805199,COGS 101A,A01,083621,Davis; Joshua Daniel,9,0,68,59
1657860811231,COGS 101B,A01,091572,Allen; Michael Gordon,12,0,65,53
1657860817254,COGS 101C,A01,083625,Delgado; Tania,17,0,35,18
1657860823281,COGS 107A,A01,083627,Boyle; Mary E. T.,14,0,60,46
1657860829305,COGS 118A,A01,083075,Gupta; Anjum,21,0,76,55
1657860835333,CSE 3,A50,083646,Miranda; Gregory Joseph,24,0,50,26
1657860841361,CSE 8A,A50,083650,Miranda; Gregory Joseph,17,1,56,39
1657860847384,CSE 11,A01,083080,Cao; Yingjun,6,15,40,34
1657860853407,CSE 12,A01,083652,Krause-Levy; Sophia Louisa,29,1,120,91
1657860859452,CSE 15L,A01,083654,Morris; Justin Loren,9,0,50,41
1657860859452,CSE 15L,A02,083655,Morris; Justin Loren,9,0,50,41
1657860865478,CSE 20,A01,083657,Tran; Khoa Dang,39,0,80,41
1657860871501,CSE 21,A01,095574,Bach; Quang Tran,22,0,48,26
1657860877528,CSE 30,A01,083084,Eldon; John,6,0,80,74
1657860877528,CSE 30,B01,095061,Bhaskar; Nishant,9,0,50,41
1657860883553,CSE 100,A01,083659,Cao; Yingjun,5,4,70,65
1657860889576,CSE 134B,A01,083661,Powell; Thomas Allan,24,0,100,76
1657860895599,CSE 140,A01,083663,Gungor; Onat,15,0,85,70
1657860901622,CSE 140L,A01,083088,Eldon; John,23,0,100,77
1657860907643,CSE 175,A01,083665,Kumar; Rakesh,3,0,25,22
1657860913667,CSE 190,A00,092507,Dubnov; Shlomo,8,0,20,12
1657860919695,ECE 45,A01,083139,Congero; Spencer William,6,0,75,69
1657860925729,ECE 65,A50,083695,Saad; Andrew S,12,0,30,18
1657860925729,ECE 65,A51,095125,Saad; Andrew S,24,0,26,2
1657860931755,ECE 109,A01,091882,Touri; Behrouz,20,0,70,50
1657860937779,ECE 180,A00,083140,Abi Samra; Nicholas Camill,1,0,30,29
1657860937779,ECE 180,B00,083141,Abi Samra; Nicholas Camill,0,0,30,30
1657860943801,MATH 10A,A01,083735,Patchell; Gregory David,2,0,30,28
1657860943801,MATH 10A,A02,083736,Patchell; Gregory David,20,0,30,10
1657860943801,MATH 10A,A03,083737,Patchell; Gregory David,16,0,30,14
1657860949827,MATH 10B,A01,083207,Lim; Seonhee,8,0,34,26
1657860949827,MATH 10B,A02,083208,Lim; Seonhee,10,0,35,25
1657860949827,MATH 10B,A03,093472,Lim; Seonhee,7,0,34,27
1657860949827,MATH 10B,B01,083739,Sinha; Shubham,14,0,30,16
1657860955853,MATH 18,A01,083743,Cinel; Cameron Alexander,9,0,30,21
1657860955853,MATH 18,A02,083744,Cinel; Cameron Alexander,18,0,30,12
1657860955853,MATH 18,A03,083745,Cinel; Cameron Alexander,10,0,30,20
1657860955853,MATH 18,B01,083748,Rideout; David Porter,5,0,37,32
1657860955853,MATH 18,B02,083749,Rideout; David Porter,5,0,36,31
1657860955853,MATH 18,B03,083750,Rideout; David Porter,3,0,37,34
1657860955853,MATH 18,B04,083751,Rideout; David Porter,6,0,36,30
1657860955853,MATH 18,B05,093473,Rideout; David Porter,6,0,36,30
1657860955853,MATH 18,B06,093474,Rideout; David Porter,6,0,36,30
1657860961878,MATH 20A,A01,083754,Zheng; Zequn,14,0,40,26
1657860967900,MATH 20B,A01,083756,Briones; Jor-el Thomas Caparas,4,0,36,32
1657860967900,MATH 20B,A02,083757,Briones; Jor-el Thomas Caparas,1,0,36,35
1657860967900,MATH 20B,A03,093475,Briones; Jor-el Thomas Caparas,2,0,36,34
1657860973924,MATH 20C,A01,083760,Briones; Jor-el Thomas Caparas,1,0,35,34
1657860973924,MATH 20C,A02,083761,Briones; Jor-el Thomas Caparas,8,0,35,27
1657860973924,MATH 20C,A03,093476,Briones; Jor-el Thomas Caparas,0,1,36,36
1657860973924,MATH 20C,B01,083762,Bach; Quang Tran,1,0,30,29
1657860979958,MATH 20D,A01,083765,Tran; Brian Kha,5,0,30,25
1657860979958,MATH 20D,A02,083766,Tran; Brian Kha,5,0,30,25
1657860979958,MATH 20D,A03,083767,Tran; Brian Kha,5,0,30,25
1657860985980,MATH 20E,A01,083771,Ganguly; Soumya,10,0,32,22
1657860985980,MATH 20E,A02,083772,Ganguly; Soumya,6,0,32,26
1657860985980,MATH 20E,B01,083773,Ciotti; Benjamin,20,0,35,15
1657860985980,MATH 20E,B02,083774,Ciotti; Benjamin,18,0,35,17
1657860992008,MATH 103A,A01,083777,Greenfeld; Be'Eri,3,0,36,33
1657860992008,MATH 103A,A02,083778,Greenfeld; Be'Eri,5,0,36,31
1657860992008,MATH 103A,A03,093561,Greenfeld; Be'Eri,6,0,36,30
1657860992008,MATH 103A,B01,083779,Greenfeld; Be'Eri,7,0,36,29
1657860992008,MATH 103A,B02,083780,Greenfeld; Be'Eri,4,0,36,32
1657860992008,MATH 103A,B03,093562,Greenfeld; Be'Eri,3,0,36,33
1657860998045,MATH 105,A01,085443,Carter; Anne Toulson,15,0,35,20
1657860998045,MATH 105,A02,093477,Carter; Anne Toulson,20,0,35,15
1657861004085,MATH 109,A01,083213,Ganzberger; Geoffrey Michael,3,0,34,31
1657861004085,MATH 109,A02,083214,Ganzberger; Geoffrey Michael,4,0,34,30
1657861004085,MATH 109,A03,093478,Ganzberger; Geoffrey Michael,2,0,34,32
1657861004085,MATH 109,B01,083215,Ganzberger; Geoffrey Michael,1,0,32,31
1657861004085,MATH 109,B02,083216,Ganzberger; Geoffrey Michael,2,0,32,30
1657861004085,MATH 109,B03,093479,Ganzberger; Geoffrey Michael,8,0,32,24
1657861010115,MATH 142A,A01,083219,Chow; Bennett,7,0,32,25
1657861010115,MATH 142A,A02,083220,Chow; Bennett,10,0,32,22
1657861010115,MATH 142A,A03,093480,Chow; Bennett,9,0,32,23
1657861010115,MATH 142A,B03,093481,Chow; Bennett,8,0,32,24
1657861010115,MATH 142A,B04,093558,Chow; Bennett,13,0,32,19
1657861010115,MATH 142A,B05,093559,Chow; Bennett,7,0,32,25
1657861016140,MATH 193A,A01,083224,Rotar; Vladimir,8,0,34,26
1657861016140,MATH 193A,A02,083225,Rotar; Vladimir,10,0,34,24
1657861016140,MATH 193A,A03,083781,Rotar; Vladimir,5,0,34,29
1657861016140,MATH 193A,A04,083782,Rotar; Vladimir,11,0,34,23
1657861016140,MATH 193A,A05,093482,Rotar; Vladimir,10,0,34,24
1657861022167,MATH 197,001,091859,McAuley; Julian John,9999,0,9999,0
1657861022167,MATH 197,002,095566,Kedlaya; Kiran S.,9997,0,9999,2
1657861022167,MATH 197,003,095567,Xiao; Ming,9999,0,9999,0
1657861022167,MATH 197,004,095571,Perols; Johan Lars,9998,0,9999,1
1657861029219,COGS 9,A01,083615,Shannon; Kyle Michael,10,0,75,65
1657861035246,COGS 11,A01,083617,Boyle; Mary E. T.,23,0,48,25
1657861041268,COGS 13,A01,083071,Bastos; Amalia Pinkusfeld,11,0,71,60
1657861047294,COGS 14A,A01,092681,Semenuks; Arturs,5,1,100,95
1657861053318,COGS 14B,A01,083073,Cheng; Tzu-Han,6,0,63,57
1657861059341,COGS 17,A01,092677,Semenuks; Arturs,6,0,81,75
1657861065369,COGS 100,A01,083619,Allen; Michael Gordon,17,0,70,53
1657861071393,COGS 101A,A01,083621,Davis; Joshua Daniel,9,0,68,59
1657861077426,COGS 101B,A01,091572,Allen; Michael Gordon,12,0,65,53
1657861083453,COGS 101C,A01,083625,Delgado; Tania,17,0,35,18
1657861089475,COGS 107A,A01,083627,Boyle; Mary E. T.,14,0,60,46
1657861095503,COGS 118A,A01,083075,Gupta; Anjum,21,0,76,55
1657861101529,CSE 3,A50,083646,Miranda; Gregory Joseph,24,0,50,26
1657861107556,CSE 8A,A50,083650,Miranda; Gregory Joseph,17,1,56,39
1657861113582,CSE 11,A01,083080,Cao; Yingjun,6,15,40,34
1657861119604,CSE 12,A01,083652,Krause-Levy; Sophia Louisa,29,1,120,91
1657861125630,CSE 15L,A01,083654,Morris; Justin Loren,9,0,50,41
1657861125630,CSE 15L,A02,083655,Morris; Justin Loren,9,0,50,41
1657861131654,CSE 20,A01,083657,Tran; Khoa Dang,39,0,80,41
1657861137681,CSE 21,A01,095574,Bach; Quang Tran,22,0,48,26
1657861143708,CSE 30,A01,083084,Eldon; John,6,0,80,74
1657861143708,CSE 30,B01,095061,Bhaskar; Nishant,9,0,50,41
1657861149734,CSE 100,A01,083659,Cao; Yingjun,5,4,70,65
1657861155758,CSE 134B,A01,083661,Powell; Thomas Allan,24,0,100,76
1657861161806,CSE 140,A01,083663,Gungor; Onat,15,0,85,70
1657861167832,CSE 140L,A01,083088,Eldon; John,23,0,100,77
1657861173856,CSE 175,A01,083665,Kumar; Rakesh,3,0,25,22
1657861179880,CSE 190,A00,092507,Dubnov; Shlomo,8,0,20,12
1657861185995,ECE 45,A01,083139,Congero; Spencer William,6,0,75,69
1657861192019,ECE 65,A50,083695,Saad; Andrew S,12,0,30,18
1657861192019,ECE 65,A51,095125,Saad; Andrew S,24,0,26,2
1657861198049,ECE 109,A01,091882,Touri; Behrouz,20,0,70,50
1657861204082,ECE 180,A00,083140,Abi Samra; Nicholas Camill,1,0,30,29
1657861204082,ECE 180,B00,083141,Abi Samra; Nicholas Camill,0,0,30,30
1657861210104,MATH 10A,A01,083735,Patchell; Gregory David,2,0,30,28
1657861210104,MATH 10A,A02,083736,Patchell; Gregory David,20,0,30,10
1657861210104,MATH 10A,A03,083737,Patchell; Gregory David,16,0,30,14
1657861216127,MATH 10B,A01,083207,Lim; Seonhee,8,0,34,26
1657861216127,MATH 10B,A02,083208,Lim; Seonhee,10,0,35,25
1657861216127,MATH 10B,A03,093472,Lim; Seonhee,7,0,34,27
1657861216127,MATH 10B,B01,083739,Sinha; Shubham,14,0,30,16
1657861222175,MATH 18,A01,083743,Cinel; Cameron Alexander,9,0,30,21
1657861222175,MATH 18,A02,083744,Cinel; Cameron Alexander,18,0,30,12
1657861222175,MATH 18,A03,083745,Cinel; Cameron Alexander,10,0,30,20
1657861222175,MATH 18,B01,083748,Rideout; David Porter,5,0,37,32
1657861222175,MATH 18,B02,083749,Rideout; David Porter,5,0,36,31
1657861222175,MATH 18,B03,083750,Rideout; David Porter,3,0,37,34
1657861222175,MATH 18,B04,083751,Rideout; David Porter,6,0,36,30
1657861222175,MATH 18,B05,093473,Rideout; David Porter,6,0,36,30
1657861222175,MATH 18,B06,093474,Rideout; David Porter,6,0,36,30
1657861228201,MATH 20A,A01,083754,Zheng; Zequn,14,0,40,26
1657861234230,MATH 20B,A01,083756,Briones; Jor-el Thomas Caparas,4,0,36,32
1657861234230,MATH 20B,A02,083757,Briones; Jor-el Thomas Caparas,1,0,36,35
1657861234230,MATH 20B,A03,093475,Briones; Jor-el Thomas Caparas,2,0,36,34
1657861240252,MATH 20C,A01,083760,Briones; Jor-el Thomas Caparas,1,0,35,34
1657861240252,MATH 20C,A02,083761,Briones; Jor-el Thomas Caparas,8,0,35,27
1657861240252,MATH 20C,A03,093476,Briones; Jor-el Thomas Caparas,0,1,36,36
1657861240252,MATH 20C,B01,083762,Bach; Quang Tran,1,0,30,29
1657861246274,MATH 20D,A01,083765,Tran; Brian Kha,5,0,30,25
1657861246274,MATH 20D,A02,083766,Tran; Brian Kha,5,0,30,25
1657861246274,MATH 20D,A03,083767,Tran; Brian Kha,5,0,30,25
1657861252297,MATH 20E,A01,083771,Ganguly; Soumya,10,0,32,22
1657861252297,MATH 20E,A02,083772,Ganguly; Soumya,6,0,32,26
1657861252297,MATH 20E,B01,083773,Ciotti; Benjamin,20,0,35,15
1657861252297,MATH 20E,B02,083774,Ciotti; Benjamin,18,0,35,17
1657861258319,MATH 103A,A01,083777,Greenfeld; Be'Eri,3,0,36,33
1657861258319,MATH 103A,A02,083778,Greenfeld; Be'Eri,5,0,36,31
1657861258319,MATH 103A,A03,093561,Greenfeld; Be'Eri,6,0,36,30
1657861258319,MATH 103A,B01,083779,Greenfeld; Be'Eri,7,0,36,29
1657861258319,MATH 103A,B02,083780,Greenfeld; Be'Eri,4,0,36,32
1657861258319,MATH 103A,B03,093562,Greenfeld; Be'Eri,3,0,36,33
1657861264349,MATH 105,A01,085443,Carter; Anne Toulson,15,0,35,20
1657861264349,MATH 105,A02,093477,Carter; Anne Toulson,20,0,35,15
1657861270371,MATH 109,A01,083213,Ganzberger; Geoffrey Michael,3,0,34,31
1657861270371,MATH 109,A02,083214,Ganzberger; Geoffrey Michael,4,0,34,30
1657861270371,MATH 109,A03,093478,Ganzberger; Geoffrey Michael,2,0,34,32
1657861270371,MATH 109,B01,083215,Ganzberger; Geoffrey Michael,1,0,32,31
1657861270371,MATH 109,B02,083216,Ganzberger; Geoffrey Michael,2,0,32,30
1657861270371,MATH 109,B03,093479,Ganzberger; Geoffrey Michael,8,0,32,24
1657861276399,MATH 142A,A01,083219,Chow; Bennett,7,0,32,25
1657861276399,MATH 142A,A02,083220,Chow; Bennett,10,0,32,22
1657861276399,MATH 142A,A03,093480,Chow; Bennett,9,0,32,23
1657861276399,MATH 142A,B03,093481,Chow; Bennett,8,0,32,24
1657861276399,MATH 142A,B04,093558,Chow; Bennett,13,0,32,19
1657861276399,MATH 142A,B05,093559,Chow; Bennett,7,0,32,25
1657861282427,MATH 193A,A01,083224,Rotar; Vladimir,8,0,34,26
1657861282427,MATH 193A,A02,083225,Rotar; Vladimir,10,0,34,24
1657861282427,MATH 193A,A03,083781,Rotar; Vladimir,5,0,34,29
1657861282427,MATH 193A,A04,083782,Rotar; Vladimir,11,0,34,23
1657861282427,MATH 193A,A05,093482,Rotar; Vladimir,10,0,34,24
1657861288453,MATH 197,001,091859,McAuley; Julian John,9999,0,9999,0
1657861288453,MATH 197,002,095566,Kedlaya; Kiran S.,9997,0,9999,2
1657861288453,MATH 197,003,095567,Xiao; Ming,9999,0,9999,0
1657861288453,MATH 197,004,095571,Perols; Johan Lars,9998,0,9999,1
1657861295514,COGS 9,A01,083615,Shannon; Kyle Michael,10,0,75,65
1657861301537,COGS 11,A01,083617,Boyle; Mary E. T.,23,0,48,25
1657861307559,COGS 13,A01,083071,Bastos; Amalia Pinkusfeld,11,0,71,60
1657861313583,COGS 14A,A01,092681,Semenuks; Arturs,5,1,100,95
1657861319608,COGS 14B,A01,083073,Cheng; Tzu-Han,6,0,63,57
1657861325635,COGS 17,A01,092677,Semenuks; Arturs,6,0,81,75
1657861331659,COGS 100,A01,083619,Allen; Michael Gordon,17,0,70,53
1657861337688,COGS 101A,A01,083621,Davis; Joshua Daniel,9,0,68,59
1657861343711,COGS 101B,A01,091572,Allen; Michael Gordon,12,0,65,53
1657861349733,COGS 101C,A01,083625,Delgado; Tania,17,0,35,18
1657861355756,COGS 107A,A01,083627,Boyle; Mary E. T.,14,0,60,46
1657861361783,COGS 118A,A01,083075,Gupta; Anjum,21,0,76,55
1657861367808,CSE 3,A50,083646,Miranda; Gregory Joseph,24,0,50,26
1657861373833,CSE 8A,A50,083650,Miranda; Gregory Joseph,17,1,56,39
1657861379855,CSE 11,A01,083080,Cao; Yingjun,6,15,40,34
1657861385877,CSE 12,A01,083652,Krause-Levy; Sophia Louisa,29,1,120,91
1657861391911,CSE 15L,A01,083654,Morris; Justin Loren,9,0,50,41
1657861391911,CSE 15L,A02,083655,Morris; Justin Loren,9,0,50,41
1657861397934,CSE 20,A01,083657,Tran; Khoa Dang,39,0,80,41
1657861403958,CSE 21,A01,095574,Bach; Quang Tran,22,0,48,26
1657861409986,CSE 30,A01,083084,Eldon; John,6,0,80,74
1657861409986,CSE 30,B01,095061,Bhaskar; Nishant,9,0,50,41
1657861416014,CSE 100,A01,083659,Cao; Yingjun,5,4,70,65
1657861422035,CSE 134B,A01,083661,Powell; Thomas Allan,24,0,100,76
1657861428065,CSE 140,A01,083663,Gungor; Onat,15,0,85,70
1657861434107,CSE 140L,A01,083088,Eldon; John,23,0,100,77
1657861440129,CSE 175,A01,083665,Kumar; Rakesh,3,0,25,22
1657861446155,CSE 190,A00,092507,Dubnov; Shlomo,8,0,20,12
1657861452186,ECE 45,A01,083139,Congero; Spencer William,6,0,75,69
1657861458211,ECE 65,A50,083695,Saad; Andrew S,12,0,30,18
1657861458211,ECE 65,A51,095125,Saad; Andrew S,24,0,26,2
1657861464233,ECE 109,A01,091882,Touri; Behrouz,20,0,70,50
1657861470256,ECE 180,A00,083140,Abi Samra; Nicholas Camill,1,0,30,29
1657861470256,ECE 180,B00,083141,Abi Samra; Nicholas Camill,0,0,30,30
1657861476281,MATH 10A,A01,083735,Patchell; Gregory David,2,0,30,28
1657861476281,MATH 10A,A02,083736,Patchell; Gregory David,20,0,30,10
1657861476281,MATH 10A,A03,083737,Patchell; Gregory David,16,0,30,14
1657861482304,MATH 10B,A01,083207,Lim; Seonhee,8,0,34,26
1657861482304,MATH 10B,A02,083208,Lim; Seonhee,10,0,35,25
1657861482304,MATH 10B,A03,093472,Lim; Seonhee,7,0,34,27
1657861482304,MATH 10B,B01,083739,Sinha; Shubham,14,0,30,16
1657861488338,MATH 18,A01,083743,Cinel; Cameron Alexander,9,0,30,21
1657861488338,MATH 18,A02,083744,Cinel; Cameron Alexander,18,0,30,12
1657861488338,MATH 18,A03,083745,Cinel; Cameron Alexander,10,0,30,20
1657861488338,MATH 18,B01,083748,Rideout; David Porter,5,0,37,32
1657861488338,MATH 18,B02,083749,Rideout; David Porter,5,0,36,31
1657861488338,MATH 18,B03,083750,Rideout; David Porter,3,0,37,34
1657861488338,MATH 18,B04,083751,Rideout; David Porter,6,0,36,30
1657861488338,MATH 18,B05,093473,Rideout; David Porter,6,0,36,30
1657861488338,MATH 18,B06,093474,Rideout; David Porter,6,0,36,30
1657861494361,MATH 20A,A01,083754,Zheng; Zequn,14,0,40,26
1657861500397,MATH 20B,A01,083756,Briones; Jor-el Thomas Caparas,4,0,36,32
1657861500397,MATH 20B,A02,083757,Briones; Jor-el Thomas Caparas,1,0,36,35
1657861500397,MATH 20B,A03,093475,Briones; Jor-el Thomas Caparas,2,0,36,34
1657861506420,MATH 20C,A01,083760,Briones; Jor-el Thomas Caparas,1,0,35,34
1657861506420,MATH 20C,A02,083761,Briones; Jor-el Thomas Caparas,8,0,35,27
1657861506420,MATH 20C,A03,093476,Briones; Jor-el Thomas Caparas,0,1,36,36
1657861506420,MATH 20C,B01,083762,Bach; Quang Tran,1,0,30,29
1657861512445,MATH 20D,A01,083765,Tran; Brian Kha,5,0,30,25
1657861512445,MATH 20D,A02,083766,Tran; Brian Kha,5,0,30,25
1657861512445,MATH 20D,A03,083767,Tran; Brian Kha,5,0,30,25
1657861518474,MATH 20E,A01,083771,Ganguly; Soumya,10,0,32,22
1657861518474,MATH 20E,A02,083772,Ganguly; Soumya,6,0,32,26
1657861518474,MATH 20E,B01,083773,Ciotti; Benjamin,20,0,35,15
1657861518474,MATH 20E,B02,083774,Ciotti; Benjamin,18,0,35,17
1657861524497,MATH 103A,A01,083777,Greenfeld; Be'Eri,3,0,36,33
1657861524497,MATH 103A,A02,083778,Greenfeld; Be'Eri,5,0,36,31
1657861524497,MATH 103A,A03,093561,Greenfeld; Be'Eri,6,0,36,30
1657861524497,MATH 103A,B01,083779,Greenfeld; Be'Eri,7,0,36,29
1657861524497,MATH 103A,B02,083780,Greenfeld; Be'Eri,4,0,36,32
1657861524497,MATH 103A,B03,093562,Greenfeld; Be'Eri,3,0,36,33
1657861530525,MATH 105,A01,085443,Carter; Anne Toulson,15,0,35,20
1657861530525,MATH 105,A02,093477,Carter; Anne Toulson,20,0,35,15
1657861536554,MATH 109,A01,083213,Ganzberger; Geoffrey Michael,3,0,34,31
1657861536554,MATH 109,A02,083214,Ganzberger; Geoffrey Michael,4,0,34,30
1657861536554,MATH 109,A03,093478,Ganzberger; Geoffrey Michael,2,0,34,32
1657861536554,MATH 109,B01,083215,Ganzberger; Geoffrey Michael,1,0,32,31
1657861536554,MATH 109,B02,083216,Ganzberger; Geoffrey Michael,2,0,32,30
1657861536554,MATH 109,B03,093479,Ganzberger; Geoffrey Michael,8,0,32,24
1657861542577,MATH 142A,A01,083219,Chow; Bennett,7,0,32,25
1657861542577,MATH 142A,A02,083220,Chow; Bennett,10,0,32,22
1657861542577,MATH 142A,A03,093480,Chow; Bennett,9,0,32,23
1657861542577,MATH 142A,B03,093481,Chow; Bennett,8,0,32,24
1657861542577,MATH 142A,B04,093558,Chow; Bennett,13,0,32,19
1657861542577,MATH 142A,B05,093559,Chow; Bennett,7,0,32,25
1657861548602,MATH 193A,A01,083224,Rotar; Vladimir,8,0,34,26
1657861548602,MATH 193A,A02,083225,Rotar; Vladimir,10,0,34,24
1657861548602,MATH 193A,A03,083781,Rotar; Vladimir,5,0,34,29
1657861548602,MATH 193A,A04,083782,Rotar; Vladimir,11,0,34,23
1657861548602,MATH 193A,A05,093482,Rotar; Vladimir,10,0,34,24
1657861554623,MATH 197,001,091859,McAuley; Julian John,9999,0,9999,0
1657861554623,MATH 197,002,095566,Kedlaya; Kiran S.,9997,0,9999,2
1657861554623,MATH 197,003,095567,Xiao; Ming,9999,0,9999,0
1657861554623,MATH 197,004,095571,Perols; Johan Lars,9998,0,9999,1
1657861561674,COGS 9,A01,083615,Shannon; Kyle Michael,10,0,75,65
1657861567702,COGS 11,A01,083617,Boyle; Mary E. T.,23,0,48,25
1657861573725,COGS 13,A01,083071,Bastos; Amalia Pinkusfeld,11,0,71,60
1657861579750,COGS 14A,A01,092681,Semenuks; Arturs,5,1,100,95
1657861585776,COGS 14B,A01,083073,Cheng; Tzu-Han,6,0,63,57
1657861591801,COGS 17,A01,092677,Semenuks; Arturs,6,0,81,75
1657861597825,COGS 100,A01,083619,Allen; Michael Gordon,17,0,70,53
1657861603850,COGS 101A,A01,083621,Davis; Joshua Daniel,9,0,68,59
1657861609873,COGS 101B,A01,091572,Allen; Michael Gordon,12,0,65,53
1657861615903,COGS 101C,A01,083625,Delgado; Tania,17,0,35,18
1657861621929,COGS 107A,A01,083627,Boyle; Mary E. T.,14,0,60,46
1657861627950,COGS 118A,A01,083075,Gupta; Anjum,21,0,76,55
1657861633975,CSE 3,A50,083646,Miranda; Gregory Joseph,24,0,50,26
1657861640003,CSE 8A,A50,083650,Miranda; Gregory Joseph,17,1,56,39
1657861646027,CSE 11,A01,083080,Cao; Yingjun,6,15,40,34
1657861652051,CSE 12,A01,083652,Krause-Levy; Sophia Louisa,29,1,120,91
1657861658075,CSE 15L,A01,083654,Morris; Justin Loren,9,0,50,41
1657861658075,CSE 15L,A02,083655,Morris; Justin Loren,9,0,50,41
1657861664098,CSE 20,A01,083657,Tran; Khoa Dang,39,0,80,41
1657861670120,CSE 21,A01,095574,Bach; Quang Tran,22,0,48,26
1657861676147,CSE 30,A01,083084,Eldon; John,6,0,80,74
1657861676147,CSE 30,B01,095061,Bhaskar; Nishant,9,0,50,41
1657861682169,CSE 100,A01,083659,Cao; Yingjun,5,4,70,65
1657861688193,CSE 134B,A01,083661,Powell; Thomas Allan,24,0,100,76
1657861694218,CSE 140,A01,083663,Gungor; Onat,15,0,85,70
1657861700242,CSE 140L,A01,083088,Eldon; John,23,0,100,77
1657861706265,CSE 175,A01,083665,Kumar; Rakesh,3,0,25,22
1657861712291,CSE 190,A00,092507,Dubnov; Shlomo,8,0,20,12
1657861718314,ECE 45,A01,083139,Congero; Spencer William,6,0,75,69
1657861724347,ECE 65,A50,083695,Saad; Andrew S,12,0,30,18
1657861724347,ECE 65,A51,095125,Saad; Andrew S,24,0,26,2
1657861730373,ECE 109,A01,091882,Touri; Behrouz,20,0,70,50
1657861736404,ECE 180,A00,083140,Abi Samra; Nicholas Camill,1,0,30,29
1657861736404,ECE 180,B00,083141,Abi Samra; Nicholas Camill,0,0,30,30
1657861742430,MATH 10A,A01,083735,Patchell; Gregory David,2,0,30,28
1657861742430,MATH 10A,A02,083736,Patchell; Gregory David,20,0,30,10
1657861742430,MATH 10A,A03,083737,Patchell; Gregory David,16,0,30,14
1657861748454,MATH 10B,A01,083207,Lim; Seonhee,8,0,34,26
1657861748454,MATH 10B,A02,083208,Lim; Seonhee,10,0,35,25
1657861748454,MATH 10B,A03,093472,Lim; Seonhee,7,0,34,27
1657861748454,MATH 10B,B01,083739,Sinha; Shubham,14,0,30,16
1657861754490,MATH 18,A01,083743,Cinel; Cameron Alexander,9,0,30,21
1657861754490,MATH 18,A02,083744,Cinel; Cameron Alexander,18,0,30,12
1657861754490,MATH 18,A03,083745,Cinel; Cameron Alexander,10,0,30,20
1657861754490,MATH 18,B01,083748,Rideout; David Porter,5,0,37,32
1657861754490,MATH 18,B02,083749,Rideout; David Porter,5,0,36,31
1657861754490,MATH 18,B03,083750,Rideout; David Porter,3,0,37,34
1657861754490,MATH 18,B04,083751,Rideout; David Porter,6,0,36,30
1657861754490,MATH 18,B05,093473,Rideout; David Porter,6,0,36,30
1657861754490,MATH 18,B06,093474,Rideout; David Porter,6,0,36,30
1657861760512,MATH 20A,A01,083754,Zheng; Zequn,14,0,40,26
1657861766536,MATH 20B,A01,083756,Briones; Jor-el Thomas Caparas,4,0,36,32
1657861766536,MATH 20B,A02,083757,Briones; Jor-el Thomas Caparas,1,0,36,35
1657861766536,MATH 20B,A03,093475,Briones; Jor-el Thomas Caparas,2,0,36,34
1657861772560,MATH 20C,A01,083760,Briones; Jor-el Thomas Caparas,1,0,35,34
1657861772560,MATH 20C,A02,083761,Briones; Jor-el Thomas Caparas,8,0,35,27
1657861772560,MATH 20C,A03,093476,Briones; Jor-el Thomas Caparas,0,1,36,36
1657861772560,MATH 20C,B01,083762,Bach; Quang Tran,1,0,30,29
1657861778594,MATH 20D,A01,083765,Tran; Brian Kha,5,0,30,25
1657861778594,MATH 20D,A02,083766,Tran; Brian Kha,5,0,30,25
1657861778594,MATH 20D,A03,083767,Tran; Brian Kha,5,0,30,25
1657861784725,MATH 20E,A01,083771,Ganguly; Soumya,10,0,32,22
1657861784725,MATH 20E,A02,083772,Ganguly; Soumya,6,0,32,26
1657861784725,MATH 20E,B01,083773,Ciotti; Benjamin,20,0,35,15
1657861784725,MATH 20E,B02,083774,Ciotti; Benjamin,18,0,35,17
1657861790754,MATH 103A,A01,083777,Greenfeld; Be'Eri,3,0,36,33
1657861790754,MATH 103A,A02,083778,Greenfeld; Be'Eri,5,0,36,31
1657861790754,MATH 103A,A03,093561,Greenfeld; Be'Eri,6,0,36,30
1657861790754,MATH 103A,B01,083779,Greenfeld; Be'Eri,7,0,36,29
1657861790754,MATH 103A,B02,083780,Greenfeld; Be'Eri,4,0,36,32
1657861790754,MATH 103A,B03,093562,Greenfeld; Be'Eri,3,0,36,33
1657861796781,MATH 105,A01,085443,Carter; Anne Toulson,15,0,35,20
1657861796781,MATH 105,A02,093477,Carter; Anne Toulson,20,0,35,15
1657861802805,MATH 109,A01,083213,Ganzberger; Geoffrey Michael,3,0,34,31
1657861802805,MATH 109,A02,083214,Ganzberger; Geoffrey Michael,4,0,34,30
1657861802805,MATH 109,A03,093478,Ganzberger; Geoffrey Michael,2,0,34,32
1657861802805,MATH 109,B01,083215,Ganzberger; Geoffrey Michael,1,0,32,31
1657861802805,MATH 109,B02,083216,Ganzberger; Geoffrey Michael,2,0,32,30
1657861802805,MATH 109,B03,093479,Ganzberger; Geoffrey Michael,8,0,32,24
1657861808833,MATH 142A,A01,083219,Chow; Bennett,7,0,32,25
1657861808833,MATH 142A,A02,083220,Chow; Bennett,10,0,32,22
1657861808833,MATH 142A,A03,093480,Chow; Bennett,9,0,32,23
1657861808833,MATH 142A,B03,093481,Chow; Bennett,8,0,32,24
1657861808833,MATH 142A,B04,093558,Chow; Bennett,13,0,32,19
1657861808833,MATH 142A,B05,093559,Chow; Bennett,7,0,32,25
1657861814858,MATH 193A,A01,083224,Rotar; Vladimir,8,0,34,26
1657861814858,MATH 193A,A02,083225,Rotar; Vladimir,10,0,34,24
1657861814858,MATH 193A,A03,083781,Rotar; Vladimir,5,0,34,29
1657861814858,MATH 193A,A04,083782,Rotar; Vladimir,11,0,34,23
1657861814858,MATH 193A,A05,093482,Rotar; Vladimir,10,0,34,24
1657861820884,MATH 197,001,091859,McAuley; Julian John,9999,0,9999,0
1657861820884,MATH 197,002,095566,Kedlaya; Kiran S.,9997,0,9999,2
1657861820884,MATH 197,003,095567,Xiao; Ming,9999,0,9999,0
1657861820884,MATH 197,004,095571,Perols; Johan Lars,9998,0,9999,1
1657861827935,COGS 9,A01,083615,Shannon; Kyle Michael,10,0,75,65
1657861833963,COGS 11,A01,083617,Boyle; Mary E. T.,23,0,48,25
1657861839990,COGS 13,A01,083071,Bastos; Amalia Pinkusfeld,11,0,71,60
1657861846012,COGS 14A,A01,092681,Semenuks; Arturs,5,1,100,95
1657861852040,COGS 14B,A01,083073,Cheng; Tzu-Han,6,0,63,57
1657861858064,COGS 17,A01,092677,Semenuks; Arturs,6,0,81,75
1657861864090,COGS 100,A01,083619,Allen; Michael Gordon,17,0,70,53
1657861870116,COGS 101A,A01,083621,Davis; Joshua Daniel,9,0,68,59
1657861876140,COGS 101B,A01,091572,Allen; Michael Gordon,12,0,65,53
1657861882164,COGS 101C,A01,083625,Delgado; Tania,17,0,35,18
1657861888190,COGS 107A,A01,083627,Boyle; Mary E. T.,14,0,60,46
1657861894213,COGS 118A,A01,083075,Gupta; Anjum,21,0,76,55
1657861900235,CSE 3,A50,083646,Miranda; Gregory Joseph,24,0,50,26
1657861906258,CSE 8A,A50,083650,Miranda; Gregory Joseph,17,1,56,39
1657861912284,CSE 11,A01,083080,Cao; Yingjun,6,15,40,34
1657861918306,CSE 12,A01,083652,Krause-Levy; Sophia Louisa,29,1,120,91
1657861924335,CSE 15L,A01,083654,Morris; Justin Loren,9,0,50,41
1657861924335,CSE 15L,A02,083655,Morris; Justin Loren,9,0,50,41
1657861930358,CSE 20,A01,083657,Tran; Khoa Dang,39,0,80,41
1657861936379,CSE 21,A01,095574,Bach; Quang Tran,22,0,48,26
1657861942409,CSE 30,A01,083084,Eldon; John,6,0,80,74
1657861942409,CSE 30,B01,095061,Bhaskar; Nishant,9,0,50,41
1657861948431,CSE 100,A01,083659,Cao; Yingjun,5,4,70,65
1657861954457,CSE 134B,A01,083661,Powell; Thomas Allan,24,0,100,76
1657861960480,CSE 140,A01,083663,Gungor; Onat,15,0,85,70
1657861966503,CSE 140L,A01,083088,Eldon; John,23,0,100,77
1657861972525,CSE 175,A01,083665,Kumar; Rakesh,3,0,25,22
1657861978552,CSE 190,A00,092507,Dubnov; Shlomo,8,0,20,12
1657861984573,ECE 45,A01,083139,Congero; Spencer William,6,0,75,69
1657861990596,ECE 65,A50,083695,Saad; Andrew S,12,0,30,18
1657861990596,ECE 65,A51,095125,Saad; Andrew S,24,0,26,2
1657861996619,ECE 109,A01,091882,Touri; Behrouz,20,0,70,50
1657862002643,ECE 180,A00,083140,Abi Samra; Nicholas Camill,1,0,30,29
1657862002643,ECE 180,B00,083141,Abi Samra; Nicholas Camill,0,0,30,30
1657862008666,MATH 10A,A01,083735,Patchell; Gregory David,2,0,30,28
1657862008666,MATH 10A,A02,083736,Patchell; Gregory David,20,0,30,10
1657862008666,MATH 10A,A03,083737,Patchell; Gregory David,16,0,30,14
1657862014698,MATH 10B,A01,083207,Lim; Seonhee,8,0,34,26
1657862014698,MATH 10B,A02,083208,Lim; Seonhee,10,0,35,25
1657862014698,MATH 10B,A03,093472,Lim; Seonhee,7,0,34,27
1657862014698,MATH 10B,B01,083739,Sinha; Shubham,14,0,30,16
1657862020728,MATH 18,A01,083743,Cinel; Cameron Alexander,9,0,30,21
1657862020728,MATH 18,A02,083744,Cinel; Cameron Alexander,18,0,30,12
1657862020728,MATH 18,A03,083745,Cinel; Cameron Alexander,10,0,30,20
1657862020728,MATH 18,B01,083748,Rideout; David Porter,5,0,37,32
1657862020728,MATH 18,B02,083749,Rideout; David Porter,5,0,36,31
1657862020728,MATH 18,B03,083750,Rideout; David Porter,3,0,37,34
1657862020728,MATH 18,B04,083751,Rideout; David Porter,6,0,36,30
1657862020728,MATH 18,B05,093473,Rideout; David Porter,6,0,36,30
1657862020728,MATH 18,B06,093474,Rideout; David Porter,6,0,36,30
1657862026752,MATH 20A,A01,083754,Zheng; Zequn,14,0,40,26
1657862032774,MATH 20B,A01,083756,Briones; Jor-el Thomas Caparas,4,0,36,32
1657862032774,MATH 20B,A02,083757,Briones; Jor-el Thomas Caparas,1,0,36,35
1657862032774,MATH 20B,A03,093475,Briones; Jor-el Thomas Caparas,2,0,36,34
1657862038796,MATH 20C,A01,083760,Briones; Jor-el Thomas Caparas,1,0,35,34
1657862038796,MATH 20C,A02,083761,Briones; Jor-el Thomas Caparas,8,0,35,27
1657862038796,MATH 20C,A03,093476,Briones; Jor-el Thomas Caparas,0,1,36,36
1657862038796,MATH 20C,B01,083762,Bach; Quang Tran,1,0,30,29
1657862044819,MATH 20D,A01,083765,Tran; Brian Kha,5,0,30,25
1657862044819,MATH 20D,A02,083766,Tran; Brian Kha,5,0,30,25
1657862044819,MATH 20D,A03,083767,Tran; Brian Kha,5,0,30,25
1657862050842,MATH 20E,A01,083771,Ganguly; Soumya,10,0,32,22
1657862050842,MATH 20E,A02,083772,Ganguly; Soumya,6,0,32,26
1657862050842,MATH 20E,B01,083773,Ciotti; Benjamin,20,0,35,15
1657862050842,MATH 20E,B02,083774,Ciotti; Benjamin,18,0,35,17
1657862056867,MATH 103A,A01,083777,Greenfeld; Be'Eri,3,0,36,33
1657862056867,MATH 103A,A02,083778,Greenfeld; Be'Eri,5,0,36,31
1657862056867,MATH 103A,A03,093561,Greenfeld; Be'Eri,6,0,36,30
1657862056867,MATH 103A,B01,083779,Greenfeld; Be'Eri,7,0,36,29
1657862056867,MATH 103A,B02,083780,Greenfeld; Be'Eri,4,0,36,32
1657862056867,MATH 103A,B03,093562,Greenfeld; Be'Eri,3,0,36,33
1657862062891,MATH 105,A01,085443,Carter; Anne Toulson,15,0,35,20
1657862062891,MATH 105,A02,093477,Carter; Anne Toulson,20,0,35,15
1657862068919,MATH 109,A01,083213,Ganzberger; Geoffrey Michael,3,0,34,31
1657862068919,MATH 109,A02,083214,Ganzberger; Geoffrey Michael,4,0,34,30
1657862068919,MATH 109,A03,093478,Ganzberger; Geoffrey Michael,2,0,34,32
1657862068919,MATH 109,B01,083215,Ganzberger; Geoffrey Michael,1,0,32,31
1657862068919,MATH 109,B02,083216,Ganzberger; Geoffrey Michael,2,0,32,30
1657862068919,MATH 109,B03,093479,Ganzberger; Geoffrey Michael,8,0,32,24
1657862074947,MATH 142A,A01,083219,Chow; Bennett,7,0,32,25
1657862074947,MATH 142A,A02,083220,Chow; Bennett,10,0,32,22
1657862074947,MATH 142A,A03,093480,Chow; Bennett,9,0,32,23
1657862074947,MATH 142A,B03,093481,Chow; Bennett,8,0,32,24
1657862074947,MATH 142A,B04,093558,Chow; Bennett,13,0,32,19
1657862074947,MATH 142A,B05,093559,Chow; Bennett,7,0,32,25
1657862080970,MATH 193A,A01,083224,Rotar; Vladimir,8,0,34,26
1657862080970,MATH 193A,A02,083225,Rotar; Vladimir,10,0,34,24
1657862080970,MATH 193A,A03,083781,Rotar; Vladimir,5,0,34,29
1657862080970,MATH 193A,A04,083782,Rotar; Vladimir,11,0,34,23
1657862080970,MATH 193A,A05,093482,Rotar; Vladimir,10,0,34,24
1657862086994,MATH 197,001,091859,McAuley; Julian John,9999,0,9999,0
1657862086994,MATH 197,002,095566,Kedlaya; Kiran S.,9997,0,9999,2
1657862086994,MATH 197,003,095567,Xiao; Ming,9999,0,9999,0
1657862086994,MATH 197,004,095571,Perols; Johan Lars,9998,0,9999,1
1657862094056,COGS 9,A01,083615,Shannon; Kyle Michael,10,0,75,65
1657862100081,COGS 11,A01,083617,Boyle; Mary E. T.,23,0,48,25
1657862106104,COGS 13,A01,083071,Bastos; Amalia Pinkusfeld,11,0,71,60
1657862112131,COGS 14A,A01,092681,Semenuks; Arturs,5,1,100,95
1657862118154,COGS 14B,A01,083073,Cheng; Tzu-Han,6,0,63,57
1657862124179,COGS 17,A01,092677,Semenuks; Arturs,6,0,81,75
1657862130201,COGS 100,A01,083619,Allen; Michael Gordon,17,0,70,53
1657862136229,COGS 101A,A01,083621,Davis; Joshua Daniel,9,0,68,59
1657862142253,COGS 101B,A01,091572,Allen; Michael Gordon,12,0,65,53
1657862148287,COGS 101C,A01,083625,Delgado; Tania,17,0,35,18
1657862154316,COGS 107A,A01,083627,Boyle; Mary E. T.,14,0,60,46
1657862160345,COGS 118A,A01,083075,Gupta; Anjum,21,0,76,55
1657862166368,CSE 3,A50,083646,Miranda; Gregory Joseph,24,0,50,26
1657862172391,CSE 8A,A50,083650,Miranda; Gregory Joseph,17,1,56,39
1657862178415,CSE 11,A01,083080,Cao; Yingjun,6,15,40,34
1657862184442,CSE 12,A01,083652,Krause-Levy; Sophia Louisa,29,1,120,91
1657862190476,CSE 15L,A01,083654,Morris; Justin Loren,9,0,50,41
1657862190476,CSE 15L,A02,083655,Morris; Justin Loren,9,0,50,41
1657862196511,CSE 20,A01,083657,Tran; Khoa Dang,39,0,80,41
1657862202537,CSE 21,A01,095574,Bach; Quang Tran,22,0,48,26
1657862208559,CSE 30,A01,083084,Eldon; John,6,0,80,74
1657862208559,CSE 30,B01,095061,Bhaskar; Nishant,9,0,50,41
1657862214591,CSE 100,A01,083659,Cao; Yingjun,5,4,70,65
1657862220614,CSE 134B,A01,083661,Powell; Thomas Allan,24,0,100,76
1657862226636,CSE 140,A01,083663,Gungor; Onat,15,0,85,70
1657862232663,CSE 140L,A01,083088,Eldon; John,23,0,100,77
1657862238686,CSE 175,A01,083665,Kumar; Rakesh,3,0,25,22
1657862244722,CSE 190,A00,092507,Dubnov; Shlomo,8,0,20,12
1657862250746,ECE 45,A01,083139,Congero; Spencer William,6,0,75,69
1657862256769,ECE 65,A50,083695,Saad; Andrew S,12,0,30,18
1657862256769,ECE 65,A51,095125,Saad; Andrew S,24,0,26,2
1657862262791,ECE 109,A01,091882,Touri; Behrouz,20,0,70,50
1657862268827,ECE 180,A00,083140,Abi Samra; Nicholas Camill,1,0,30,29
1657862268827,ECE 180,B00,083141,Abi Samra; Nicholas Camill,0,0,30,30
1657862274860,MATH 10A,A01,083735,Patchell; Gregory David,2,0,30,28
1657862274860,MATH 10A,A02,083736,Patchell; Gregory David,20,0,30,10
1657862274860,MATH 10A,A03,083737,Patchell; Gregory David,16,0,30,14
1657862280892,MATH 10B,A01,083207,Lim; Seonhee,8,0,34,26
1657862280892,MATH 10B,A02,083208,Lim; Seonhee,10,0,35,25
1657862280892,MATH 10B,A03,093472,Lim; Seonhee,7,0,34,27
1657862280892,MATH 10B,B01,083739,Sinha; Shubham,14,0,30,16
1657862286925,MATH 18,A01,083743,Cinel; Cameron Alexander,9,0,30,21
1657862286925,MATH 18,A02,083744,Cinel; Cameron Alexander,18,0,30,12
1657862286925,MATH 18,A03,083745,Cinel; Cameron Alexander,10,0,30,20
1657862286925,MATH 18,B01,083748,Rideout; David Porter,5,0,37,32
1657862286925,MATH 18,B02,083749,Rideout; David Porter,5,0,36,31
1657862286925,MATH 18,B03,083750,Rideout; David Porter,3,0,37,34
1657862286925,MATH 18,B04,083751,Rideout; David Porter,6,0,36,30
1657862286925,MATH 18,B05,093473,Rideout; David Porter,6,0,36,30
1657862286925,MATH 18,B06,093474,Rideout; David Porter,6,0,36,30
1657862292966,MATH 20A,A01,083754,Zheng; Zequn,14,0,40,26
1657862299001,MATH 20B,A01,083756,Briones; Jor-el Thomas Caparas,4,0,36,32
1657862299001,MATH 20B,A02,083757,Briones; Jor-el Thomas Caparas,1,0,36,35
1657862299001,MATH 20B,A03,093475,Briones; Jor-el Thomas Caparas,2,0,36,34
1657862305029,MATH 20C,A01,083760,Briones; Jor-el Thomas Caparas,1,0,35,34
1657862305029,MATH 20C,A02,083761,Briones; Jor-el Thomas Caparas,8,0,35,27
1657862305029,MATH 20C,A03,093476,Briones; Jor-el Thomas Caparas,0,1,36,36
1657862305029,MATH 20C,B01,083762,Bach; Quang Tran,1,0,30,29
1657862311057,MATH 20D,A01,083765,Tran; Brian Kha,5,0,30,25
1657862311057,MATH 20D,A02,083766,Tran; Brian Kha,5,0,30,25
1657862311057,MATH 20D,A03,083767,Tran; Brian Kha,5,0,30,25
1657862317091,MATH 20E,A01,083771,Ganguly; Soumya,10,0,32,22
1657862317091,MATH 20E,A02,083772,Ganguly; Soumya,6,0,32,26
1657862317091,MATH 20E,B01,083773,Ciotti; Benjamin,20,0,35,15
1657862317091,MATH 20E,B02,083774,Ciotti; Benjamin,18,0,35,17
1657862323118,MATH 103A,A01,083777,Greenfeld; Be'Eri,3,0,36,33
1657862323118,MATH 103A,A02,083778,Greenfeld; Be'Eri,5,0,36,31
1657862323118,MATH 103A,A03,093561,Greenfeld; Be'Eri,6,0,36,30
1657862323118,MATH 103A,B01,083779,Greenfeld; Be'Eri,7,0,36,29
1657862323118,MATH 103A,B02,083780,Greenfeld; Be'Eri,4,0,36,32
1657862323118,MATH 103A,B03,093562,Greenfeld; Be'Eri,3,0,36,33
1657862329145,MATH 105,A01,085443,Carter; Anne Toulson,15,0,35,20
1657862329145,MATH 105,A02,093477,Carter; Anne Toulson,20,0,35,15
1657862335175,MATH 109,A01,083213,Ganzberger; Geoffrey Michael,3,0,34,31
1657862335175,MATH 109,A02,083214,Ganzberger; Geoffrey Michael,4,0,34,30
1657862335175,MATH 109,A03,093478,Ganzberger; Geoffrey Michael,2,0,34,32
1657862335175,MATH 109,B01,083215,Ganzberger; Geoffrey Michael,1,0,32,31
1657862335175,MATH 109,B02,083216,Ganzberger; Geoffrey Michael,2,0,32,30
1657862335175,MATH 109,B03,093479,Ganzberger; Geoffrey Michael,8,0,32,24
1657862341201,MATH 142A,A01,083219,Chow; Bennett,7,0,32,25
1657862341201,MATH 142A,A02,083220,Chow; Bennett,10,0,32,22
1657862341201,MATH 142A,A03,093480,Chow; Bennett,9,0,32,23
1657862341201,MATH 142A,B03,093481,Chow; Bennett,8,0,32,24
1657862341201,MATH 142A,B04,093558,Chow; Bennett,13,0,32,19
1657862341201,MATH 142A,B05,093559,Chow; Bennett,7,0,32,25
1657862347229,MATH 193A,A01,083224,Rotar; Vladimir,8,0,34,26
1657862347229,MATH 193A,A02,083225,Rotar; Vladimir,10,0,34,24
1657862347229,MATH 193A,A03,083781,Rotar; Vladimir,5,0,34,29
1657862347229,MATH 193A,A04,083782,Rotar; Vladimir,11,0,34,23
1657862347229,MATH 193A,A05,093482,Rotar; Vladimir,10,0,34,24
1657862353256,MATH 197,001,091859,McAuley; Julian John,9999,0,9999,0
1657862353256,MATH 197,002,095566,Kedlaya; Kiran S.,9997,0,9999,2
1657862353256,MATH 197,003,095567,Xiao; Ming,9999,0,9999,0
1657862353256,MATH 197,004,095571,Perols; Johan Lars,9998,0,9999,1
1657862360306,COGS 9,A01,083615,Shannon; Kyle Michael,10,0,75,65
1657862366329,COGS 11,A01,083617,Boyle; Mary E. T.,23,0,48,25
1657862372352,COGS 13,A01,083071,Bastos; Amalia Pinkusfeld,11,0,71,60
1657862378454,COGS 14A,A01,092681,Semenuks; Arturs,5,1,100,95
1657862384477,COGS 14B,A01,083073,Cheng; Tzu-Han,6,0,63,57
1657862390499,COGS 17,A01,092677,Semenuks; Arturs,6,0,81,75
1657862396525,COGS 100,A01,083619,Allen; Michael Gordon,17,0,70,53
1657862402550,COGS 101A,A01,083621,Davis; Joshua Daniel,9,0,68,59
1657862408571,COGS 101B,A01,091572,Allen; Michael Gordon,12,0,65,53
1657862414594,COGS 101C,A01,083625,Delgado; Tania,17,0,35,18
1657862420616,COGS 107A,A01,083627,Boyle; Mary E. T.,14,0,60,46
1657862426643,COGS 118A,A01,083075,Gupta; Anjum,21,0,76,55
1657862432665,CSE 3,A50,083646,Miranda; Gregory Joseph,24,0,50,26
1657862438689,CSE 8A,A50,083650,Miranda; Gregory Joseph,17,1,56,39
1657862444712,CSE 11,A01,083080,Cao; Yingjun,6,15,40,34
1657862450737,CSE 12,A01,083652,Krause-Levy; Sophia Louisa,30,1,120,90
1657862456761,CSE 15L,A01,083654,Morris; Justin Loren,9,0,50,41
1657862456761,CSE 15L,A02,083655,Morris; Justin Loren,10,0,50,40
1657862462784,CSE 20,A01,083657,Tran; Khoa Dang,39,0,80,41
1657862468808,CSE 21,A01,095574,Bach; Quang Tran,22,0,48,26
1657862474838,CSE 30,A01,083084,Eldon; John,6,0,80,74
1657862474838,CSE 30,B01,095061,Bhaskar; Nishant,9,0,50,41
1657862480862,CSE 100,A01,083659,Cao; Yingjun,5,4,70,65
1657862486892,CSE 134B,A01,083661,Powell; Thomas Allan,24,0,100,76
1657862492915,CSE 140,A01,083663,Gungor; Onat,15,0,85,70
1657862498941,CSE 140L,A01,083088,Eldon; John,23,0,100,77
1657862504965,CSE 175,A01,083665,Kumar; Rakesh,3,0,25,22
1657862510988,CSE 190,A00,092507,Dubnov; Shlomo,8,0,20,12
1657862517010,ECE 45,A01,083139,Congero; Spencer William,6,0,75,69
1657862523034,ECE 65,A50,083695,Saad; Andrew S,12,0,30,18
1657862523034,ECE 65,A51,095125,Saad; Andrew S,24,0,26,2
1657862529060,ECE 109,A01,091882,Touri; Behrouz,20,0,70,50
1657862535086,ECE 180,A00,083140,Abi Samra; Nicholas Camill,1,0,30,29
1657862535086,ECE 180,B00,083141,Abi Samra; Nicholas Camill,0,0,30,30
1657862541113,MATH 10A,A01,083735,Patchell; Gregory David,2,0,30,28
1657862541113,MATH 10A,A02,083736,Patchell; Gregory David,20,0,30,10
1657862541113,MATH 10A,A03,083737,Patchell; Gregory David,16,0,30,14
1657862547136,MATH 10B,A01,083207,Lim; Seonhee,8,0,34,26
1657862547136,MATH 10B,A02,083208,Lim; Seonhee,10,0,35,25
1657862547136,MATH 10B,A03,093472,Lim; Seonhee,7,0,34,27
1657862547136,MATH 10B,B01,083739,Sinha; Shubham,14,0,30,16
1657862553161,MATH 18,A01,083743,Cinel; Cameron Alexander,9,0,30,21
1657862553161,MATH 18,A02,083744,Cinel; Cameron Alexander,18,0,30,12
1657862553161,MATH 18,A03,083745,Cinel; Cameron Alexander,10,0,30,20
1657862553161,MATH 18,B01,083748,Rideout; David Porter,5,0,37,32
1657862553161,MATH 18,B02,083749,Rideout; David Porter,5,0,36,31
1657862553161,MATH 18,B03,083750,Rideout; David Porter,3,0,37,34
1657862553161,MATH 18,B04,083751,Rideout; David Porter,6,0,36,30
1657862553161,MATH 18,B05,093473,Rideout; David Porter,6,0,36,30
1657862553161,MATH 18,B06,093474,Rideout; David Porter,6,0,36,30
1657862559187,MATH 20A,A01,083754,Zheng; Zequn,14,0,40,26
1657862565232,MATH 20B,A01,083756,Briones; Jor-el Thomas Caparas,4,0,36,32
1657862565232,MATH 20B,A02,083757,Briones; Jor-el Thomas Caparas,1,0,36,35
1657862565232,MATH 20B,A03,093475,Briones; Jor-el Thomas Caparas,2,0,36,34
1657862571266,MATH 20C,A01,083760,Briones; Jor-el Thomas Caparas,1,0,35,34
1657862571266,MATH 20C,A02,083761,Briones; Jor-el Thomas Caparas,8,0,35,27
1657862571266,MATH 20C,A03,093476,Briones; Jor-el Thomas Caparas,0,1,36,36
1657862571266,MATH 20C,B01,083762,Bach; Quang Tran,1,0,30,29
1657862577299,MATH 20D,A01,083765,Tran; Brian Kha,5,0,30,25
1657862577299,MATH 20D,A02,083766,Tran; Brian Kha,5,0,30,25
1657862577299,MATH 20D,A03,083767,Tran; Brian Kha,5,0,30,25
1657862583327,MATH 20E,A01,083771,Ganguly; Soumya,10,0,32,22
1657862583327,MATH 20E,A02,083772,Ganguly; Soumya,6,0,32,26
1657862583327,MATH 20E,B01,083773,Ciotti; Benjamin,20,0,35,15
1657862583327,MATH 20E,B02,083774,Ciotti; Benjamin,18,0,35,17
1657862589357,MATH 103A,A01,083777,Greenfeld; Be'Eri,3,0,36,33
1657862589357,MATH 103A,A02,083778,Greenfeld; Be'Eri,5,0,36,31
1657862589357,MATH 103A,A03,093561,Greenfeld; Be'Eri,6,0,36,30
1657862589357,MATH 103A,B01,083779,Greenfeld; Be'Eri,7,0,36,29
1657862589357,MATH 103A,B02,083780,Greenfeld; Be'Eri,4,0,36,32
1657862589357,MATH 103A,B03,093562,Greenfeld; Be'Eri,3,0,36,33
1657862595384,MATH 105,A01,085443,Carter; Anne Toulson,15,0,35,20
1657862595384,MATH 105,A02,093477,Carter; Anne Toulson,20,0,35,15
1657862601408,MATH 109,A01,083213,Ganzberger; Geoffrey Michael,3,0,34,31
1657862601408,MATH 109,A02,083214,Ganzberger; Geoffrey Michael,4,0,34,30
1657862601408,MATH 109,A03,093478,Ganzberger; Geoffrey Michael,2,0,34,32
1657862601408,MATH 109,B01,083215,Ganzberger; Geoffrey Michael,1,0,32,31
1657862601408,MATH 109,B02,083216,Ganzberger; Geoffrey Michael,2,0,32,30
1657862601408,MATH 109,B03,093479,Ganzberger; Geoffrey Michael,8,0,32,24
1657862607430,MATH 142A,A01,083219,Chow; Bennett,7,0,32,25
1657862607430,MATH 142A,A02,083220,Chow; Bennett,10,0,32,22
1657862607430,MATH 142A,A03,093480,Chow; Bennett,9,0,32,23
1657862607430,MATH 142A,B03,093481,Chow; Bennett,8,0,32,24
1657862607430,MATH 142A,B04,093558,Chow; Bennett,13,0,32,19
1657862607430,MATH 142A,B05,093559,Chow; Bennett,7,0,32,25
1657862613459,MATH 193A,A01,083224,Rotar; Vladimir,8,0,34,26
1657862613459,MATH 193A,A02,083225,Rotar; Vladimir,10,0,34,24
1657862613459,MATH 193A,A03,083781,Rotar; Vladimir,5,0,34,29
1657862613459,MATH 193A,A04,083782,Rotar; Vladimir,11,0,34,23
1657862613459,MATH 193A,A05,093482,Rotar; Vladimir,10,0,34,24
1657862619486,MATH 197,001,091859,McAuley; Julian John,9999,0,9999,0
1657862619486,MATH 197,002,095566,Kedlaya; Kiran S.,9997,0,9999,2
1657862619486,MATH 197,003,095567,Xiao; Ming,9999,0,9999,0
1657862619486,MATH 197,004,095571,Perols; Johan Lars,9998,0,9999,1
1657862626549,COGS 9,A01,083615,Shannon; Kyle Michael,10,0,75,65
1657862632573,COGS 11,A01,083617,Boyle; Mary E. T.,23,0,48,25
1657862638598,COGS 13,A01,083071,Bastos; Amalia Pinkusfeld,11,0,71,60
1657862644624,COGS 14A,A01,092681,Semenuks; Arturs,5,1,100,95
1657862650646,COGS 14B,A01,083073,Cheng; Tzu-Han,6,0,63,57
1657862656669,COGS 17,A01,092677,Semenuks; Arturs,6,0,81,75
1657862662693,COGS 100,A01,083619,Allen; Michael Gordon,17,0,70,53
1657862668719,COGS 101A,A01,083621,Davis; Joshua Daniel,9,0,68,59
1657862674742,COGS 101B,A01,091572,Allen; Michael Gordon,12,0,65,53
1657862680768,COGS 101C,A01,083625,Delgado; Tania,17,0,35,18
1657862686793,COGS 107A,A01,083627,Boyle; Mary E. T.,14,0,60,46
1657862692816,COGS 118A,A01,083075,Gupta; Anjum,21,0,76,55
1657862698844,CSE 3,A50,083646,Miranda; Gregory Joseph,24,0,50,26
1657862704880,CSE 8A,A50,083650,Miranda; Gregory Joseph,17,1,56,39
1657862710903,CSE 11,A01,083080,Cao; Yingjun,6,15,40,34
1657862716929,CSE 12,A01,083652,Krause-Levy; Sophia Louisa,30,1,120,90
1657862722956,CSE 15L,A01,083654,Morris; Justin Loren,9,0,50,41
1657862722956,CSE 15L,A02,083655,Morris; Justin Loren,10,0,50,40
1657862728983,CSE 20,A01,083657,Tran; Khoa Dang,39,0,80,41
1657862735005,CSE 21,A01,095574,Bach; Quang Tran,22,0,48,26
1657862741029,CSE 30,A01,083084,Eldon; John,6,0,80,74
1657862741029,CSE 30,B01,095061,Bhaskar; Nishant,9,0,50,41
1657862747052,CSE 100,A01,083659,Cao; Yingjun,5,4,70,65
1657862753080,CSE 134B,A01,083661,Powell; Thomas Allan,24,0,100,76
1657862759111,CSE 140,A01,083663,Gungor; Onat,15,0,85,70
1657862765134,CSE 140L,A01,083088,Eldon; John,23,0,100,77
1657862771161,CSE 175,A01,083665,Kumar; Rakesh,3,0,25,22
1657862777188,CSE 190,A00,092507,Dubnov; Shlomo,8,0,20,12
1657862783216,ECE 45,A01,083139,Congero; Spencer William,6,0,75,69
1657862789239,ECE 65,A50,083695,Saad; Andrew S,12,0,30,18
1657862789239,ECE 65,A51,095125,Saad; Andrew S,24,0,26,2
1657862795261,ECE 109,A01,091882,Touri; Behrouz,20,0,70,50
1657862801294,ECE 180,A00,083140,Abi Samra; Nicholas Camill,1,0,30,29
1657862801294,ECE 180,B00,083141,Abi Samra; Nicholas Camill,0,0,30,30
1657862807317,MATH 10A,A01,083735,Patchell; Gregory David,2,0,30,28
1657862807317,MATH 10A,A02,083736,Patchell; Gregory David,20,0,30,10
1657862807317,MATH 10A,A03,083737,Patchell; Gregory David,16,0,30,14
1657862813340,MATH 10B,A01,083207,Lim; Seonhee,8,0,34,26
1657862813340,MATH 10B,A02,083208,Lim; Seonhee,10,0,35,25
1657862813340,MATH 10B,A03,093472,Lim; Seonhee,7,0,34,27
1657862813340,MATH 10B,B01,083739,Sinha; Shubham,14,0,30,16
1657862819371,MATH 18,A01,083743,Cinel; Cameron Alexander,9,0,30,21
1657862819371,MATH 18,A02,083744,Cinel; Cameron Alexander,18,0,30,12
1657862819371,MATH 18,A03,083745,Cinel; Cameron Alexander,10,0,30,20
1657862819371,MATH 18,B01,083748,Rideout; David Porter,5,0,37,32
1657862819371,MATH 18,B02,083749,Rideout; David Porter,5,0,36,31
1657862819371,MATH 18,B03,083750,Rideout; David Porter,3,0,37,34
1657862819371,MATH 18,B04,083751,Rideout; David Porter,6,0,36,30
1657862819371,MATH 18,B05,093473,Rideout; David Porter,6,0,36,30
1657862819371,MATH 18,B06,093474,Rideout; David Porter,6,0,36,30
1657862825399,MATH 20A,A01,083754,Zheng; Zequn,14,0,40,26
1657862831427,MATH 20B,A01,083756,Briones; Jor-el Thomas Caparas,4,0,36,32
1657862831427,MATH 20B,A02,083757,Briones; Jor-el Thomas Caparas,1,0,36,35
1657862831427,MATH 20B,A03,093475,Briones; Jor-el Thomas Caparas,2,0,36,34
1657862837451,MATH 20C,A01,083760,Briones; Jor-el Thomas Caparas,1,0,35,34
1657862837451,MATH 20C,A02,083761,Briones; Jor-el Thomas Caparas,8,0,35,27
1657862837451,MATH 20C,A03,093476,Briones; Jor-el Thomas Caparas,0,1,36,36
1657862837451,MATH 20C,B01,083762,Bach; Quang Tran,1,0,30,29
1657862843481,MATH 20D,A01,083765,Tran; Brian Kha,5,0,30,25
1657862843481,MATH 20D,A02,083766,Tran; Brian Kha,5,0,30,25
1657862843481,MATH 20D,A03,083767,Tran; Brian Kha,5,0,30,25
1657862849509,MATH 20E,A01,083771,Ganguly; Soumya,10,0,32,22
1657862849509,MATH 20E,A02,083772,Ganguly; Soumya,6,0,32,26
1657862849509,MATH 20E,B01,083773,Ciotti; Benjamin,20,0,35,15
1657862849509,MATH 20E,B02,083774,Ciotti; Benjamin,18,0,35,17
1657862855533,MATH 103A,A01,083777,Greenfeld; Be'Eri,3,0,36,33
1657862855533,MATH 103A,A02,083778,Greenfeld; Be'Eri,5,0,36,31
1657862855533,MATH 103A,A03,093561,Greenfeld; Be'Eri,6,0,36,30
1657862855533,MATH 103A,B01,083779,Greenfeld; Be'Eri,7,0,36,29
1657862855533,MATH 103A,B02,083780,Greenfeld; Be'Eri,4,0,36,32
1657862855533,MATH 103A,B03,093562,Greenfeld; Be'Eri,3,0,36,33
1657862861560,MATH 105,A01,085443,Carter; Anne Toulson,15,0,35,20
1657862861560,MATH 105,A02,093477,Carter; Anne Toulson,20,0,35,15
1657862867583,MATH 109,A01,083213,Ganzberger; Geoffrey Michael,3,0,34,31
1657862867583,MATH 109,A02,083214,Ganzberger; Geoffrey Michael,4,0,34,30
1657862867583,MATH 109,A03,093478,Ganzberger; Geoffrey Michael,2,0,34,32
1657862867583,MATH 109,B01,083215,Ganzberger; Geoffrey Michael,1,0,32,31
1657862867583,MATH 109,B02,083216,Ganzberger; Geoffrey Michael,2,0,32,30
1657862867583,MATH 109,B03,093479,Ganzberger; Geoffrey Michael,8,0,32,24
1657862873607,MATH 142A,A01,083219,Chow; Bennett,7,0,32,25
1657862873607,MATH 142A,A02,083220,Chow; Bennett,10,0,32,22
1657862873607,MATH 142A,A03,093480,Chow; Bennett,9,0,32,23
1657862873607,MATH 142A,B03,093481,Chow; Bennett,8,0,32,24
1657862873607,MATH 142A,B04,093558,Chow; Bennett,13,0,32,19
1657862873607,MATH 142A,B05,093559,Chow; Bennett,7,0,32,25
1657862879630,MATH 193A,A01,083224,Rotar; Vladimir,8,0,34,26
1657862879630,MATH 193A,A02,083225,Rotar; Vladimir,10,0,34,24
1657862879630,MATH 193A,A03,083781,Rotar; Vladimir,5,0,34,29
1657862879630,MATH 193A,A04,083782,Rotar; Vladimir,11,0,34,23
1657862879630,MATH 193A,A05,093482,Rotar; Vladimir,10,0,34,24
1657862885663,MATH 197,001,091859,McAuley; Julian John,9999,0,9999,0
1657862885663,MATH 197,002,095566,Kedlaya; Kiran S.,9997,0,9999,2
1657862885663,MATH 197,003,095567,Xiao; Ming,9999,0,9999,0
1657862885663,MATH 197,004,095571,Perols; Johan Lars,9998,0,9999,1
1657862892713,COGS 9,A01,083615,Shannon; Kyle Michael,10,0,75,65
1657862898746,COGS 11,A01,083617,Boyle; Mary E. T.,23,0,48,25
1657862904770,COGS 13,A01,083071,Bastos; Amalia Pinkusfeld,11,0,71,60
1657862910795,COGS 14A,A01,092681,Semenuks; Arturs,5,1,100,95
1657862916821,COGS 14B,A01,083073,Cheng; Tzu-Han,6,0,63,57
1657862922847,COGS 17,A01,092677,Semenuks; Arturs,6,0,81,75
1657862928869,COGS 100,A01,083619,Allen; Michael Gordon,17,0,70,53
1657862934897,COGS 101A,A01,083621,Davis; Joshua Daniel,9,0,68,59
1657862940921,COGS 101B,A01,091572,Allen; Michael Gordon,12,0,65,53
1657862946947,COGS 101C,A01,083625,Delgado; Tania,17,0,35,18
1657862952974,COGS 107A,A01,083627,Boyle; Mary E. T.,14,0,60,46
1657862958999,COGS 118A,A01,083075,Gupta; Anjum,21,0,76,55
1657862965028,CSE 3,A50,083646,Miranda; Gregory Joseph,24,0,50,26
1657862971055,CSE 8A,A50,083650,Miranda; Gregory Joseph,17,1,56,39
1657862977150,CSE 11,A01,083080,Cao; Yingjun,6,15,40,34
1657862983177,CSE 12,A01,083652,Krause-Levy; Sophia Louisa,30,1,120,90
1657862989209,CSE 15L,A01,083654,Morris; Justin Loren,9,0,50,41
1657862989209,CSE 15L,A02,083655,Morris; Justin Loren,10,0,50,40
1657862995235,CSE 20,A01,083657,Tran; Khoa Dang,39,0,80,41
1657863001261,CSE 21,A01,095574,Bach; Quang Tran,22,0,48,26
1657863007284,CSE 30,A01,083084,Eldon; John,6,0,80,74
1657863007284,CSE 30,B01,095061,Bhaskar; Nishant,9,0,50,41
1657863013307,CSE 100,A01,083659,Cao; Yingjun,5,4,70,65
1657863019329,CSE 134B,A01,083661,Powell; Thomas Allan,24,0,100,76
1657863025354,CSE 140,A01,083663,Gungor; Onat,15,0,85,70
1657863031388,CSE 140L,A01,083088,Eldon; John,23,0,100,77
1657863037413,CSE 175,A01,083665,Kumar; Rakesh,3,0,25,22
1657863043435,CSE 190,A00,092507,Dubnov; Shlomo,8,0,20,12
1657863049460,ECE 45,A01,083139,Congero; Spencer William,6,0,75,69
1657863055486,ECE 65,A50,083695,Saad; Andrew S,12,0,30,18
1657863055486,ECE 65,A51,095125,Saad; Andrew S,24,0,26,2
1657863061508,ECE 109,A01,091882,Touri; Behrouz,20,0,70,50
1657863067533,ECE 180,A00,083140,Abi Samra; Nicholas Camill,1,0,30,29
1657863067533,ECE 180,B00,083141,Abi Samra; Nicholas Camill,0,0,30,30
1657863073561,MATH 10A,A01,083735,Patchell; Gregory David,2,0,30,28
1657863073561,MATH 10A,A02,083736,Patchell; Gregory David,20,0,30,10
1657863073561,MATH 10A,A03,083737,Patchell; Gregory David,16,0,30,14
1657863079589,MATH 10B,A01,083207,Lim; Seonhee,8,0,34,26
1657863079589,MATH 10B,A02,083208,Lim; Seonhee,10,0,35,25
1657863079589,MATH 10B,A03,093472,Lim; Seonhee,7,0,34,27
1657863079589,MATH 10B,B01,083739,Sinha; Shubham,14,0,30,16
1657863085614,MATH 18,A01,083743,Cinel; Cameron Alexander,9,0,30,21
1657863085614,MATH 18,A02,083744,Cinel; Cameron Alexander,18,0,30,12
1657863085614,MATH 18,A03,083745,Cinel; Cameron Alexander,10,0,30,20
1657863085614,MATH 18,B01,083748,Rideout; David Porter,5,0,37,32
1657863085614,MATH 18,B02,083749,Rideout; David Porter,5,0,36,31
1657863085614,MATH 18,B03,083750,Rideout; David Porter,3,0,37,34
1657863085614,MATH 18,B04,083751,Rideout; David Porter,6,0,36,30
1657863085614,MATH 18,B05,093473,Rideout; David Porter,6,0,36,30
1657863085614,MATH 18,B06,093474,Rideout; David Porter,6,0,36,30
1657863091642,MATH 20A,A01,083754,Zheng; Zequn,14,0,40,26
1657863097663,MATH 20B,A01,083756,Briones; Jor-el Thomas Caparas,4,0,36,32
1657863097663,MATH 20B,A02,083757,Briones; Jor-el Thomas Caparas,1,0,36,35
1657863097663,MATH 20B,A03,093475,Briones; Jor-el Thomas Caparas,2,0,36,34
1657863103691,MATH 20C,A01,083760,Briones; Jor-el Thomas Caparas,1,0,35,34
1657863103691,MATH 20C,A02,083761,Briones; Jor-el Thomas Caparas,8,0,35,27
1657863103691,MATH 20C,A03,093476,Briones; Jor-el Thomas Caparas,0,1,36,36
1657863103691,MATH 20C,B01,083762,Bach; Quang Tran,1,0,30,29
1657863109718,MATH 20D,A01,083765,Tran; Brian Kha,5,0,30,25
1657863109718,MATH 20D,A02,083766,Tran; Brian Kha,5,0,30,25
1657863109718,MATH 20D,A03,083767,Tran; Brian Kha,5,0,30,25
1657863115742,MATH 20E,A01,083771,Ganguly; Soumya,10,0,32,22
1657863115742,MATH 20E,A02,083772,Ganguly; Soumya,6,0,32,26
1657863115742,MATH 20E,B01,083773,Ciotti; Benjamin,20,0,35,15
1657863115742,MATH 20E,B02,083774,Ciotti; Benjamin,18,0,35,17
1657863121772,MATH 103A,A01,083777,Greenfeld; Be'Eri,3,0,36,33
1657863121772,MATH 103A,A02,083778,Greenfeld; Be'Eri,5,0,36,31
1657863121772,MATH 103A,A03,093561,Greenfeld; Be'Eri,6,0,36,30
1657863121772,MATH 103A,B01,083779,Greenfeld; Be'Eri,7,0,36,29
1657863121772,MATH 103A,B02,083780,Greenfeld; Be'Eri,4,0,36,32
1657863121772,MATH 103A,B03,093562,Greenfeld; Be'Eri,3,0,36,33
1657863127799,MATH 105,A01,085443,Carter; Anne Toulson,15,0,35,20
1657863127799,MATH 105,A02,093477,Carter; Anne Toulson,20,0,35,15
1657863133826,MATH 109,A01,083213,Ganzberger; Geoffrey Michael,3,0,34,31
1657863133826,MATH 109,A02,083214,Ganzberger; Geoffrey Michael,4,0,34,30
1657863133826,MATH 109,A03,093478,Ganzberger; Geoffrey Michael,2,0,34,32
1657863133826,MATH 109,B01,083215,Ganzberger; Geoffrey Michael,1,0,32,31
1657863133826,MATH 109,B02,083216,Ganzberger; Geoffrey Michael,2,0,32,30
1657863133826,MATH 109,B03,093479,Ganzberger; Geoffrey Michael,8,0,32,24
1657863139856,MATH 142A,A01,083219,Chow; Bennett,7,0,32,25
1657863139856,MATH 142A,A02,083220,Chow; Bennett,10,0,32,22
1657863139856,MATH 142A,A03,093480,Chow; Bennett,9,0,32,23
1657863139856,MATH 142A,B03,093481,Chow; Bennett,8,0,32,24
1657863139856,MATH 142A,B04,093558,Chow; Bennett,13,0,32,19
1657863139856,MATH 142A,B05,093559,Chow; Bennett,7,0,32,25
1657863145884,MATH 193A,A01,083224,Rotar; Vladimir,8,0,34,26
1657863145884,MATH 193A,A02,083225,Rotar; Vladimir,10,0,34,24
1657863145884,MATH 193A,A03,083781,Rotar; Vladimir,5,0,34,29
1657863145884,MATH 193A,A04,083782,Rotar; Vladimir,11,0,34,23
1657863145884,MATH 193A,A05,093482,Rotar; Vladimir,10,0,34,24
1657863151905,MATH 197,001,091859,McAuley; Julian John,9999,0,9999,0
1657863151905,MATH 197,002,095566,Kedlaya; Kiran S.,9997,0,9999,2
1657863151905,MATH 197,003,095567,Xiao; Ming,9999,0,9999,0
1657863151905,MATH 197,004,095571,Perols; Johan Lars,9998,0,9999,1
1657863158955,COGS 9,A01,083615,Shannon; Kyle Michael,10,0,75,65
1657863164980,COGS 11,A01,083617,Boyle; Mary E. T.,23,0,48,25
1657863171013,COGS 13,A01,083071,Bastos; Amalia Pinkusfeld,11,0,71,60
1657863177035,COGS 14A,A01,092681,Semenuks; Arturs,5,1,100,95
1657863183058,COGS 14B,A01,083073,Cheng; Tzu-Han,6,0,63,57
1657863189081,COGS 17,A01,092677,Semenuks; Arturs,6,0,81,75
1657863195104,COGS 100,A01,083619,Allen; Michael Gordon,17,0,70,53
1657863201128,COGS 101A,A01,083621,Davis; Joshua Daniel,9,0,68,59
1657863207151,COGS 101B,A01,091572,Allen; Michael Gordon,12,0,65,53
1657863213174,COGS 101C,A01,083625,Delgado; Tania,17,0,35,18
1657863219197,COGS 107A,A01,083627,Boyle; Mary E. T.,14,0,60,46
1657863225224,COGS 118A,A01,083075,Gupta; Anjum,21,0,76,55
1657863231251,CSE 3,A50,083646,Miranda; Gregory Joseph,24,0,50,26
1657863237285,CSE 8A,A50,083650,Miranda; Gregory Joseph,17,1,56,39
1657863243309,CSE 11,A01,083080,Cao; Yingjun,6,15,40,34
1657863249336,CSE 12,A01,083652,Krause-Levy; Sophia Louisa,30,1,120,90
1657863255362,CSE 15L,A01,083654,Morris; Justin Loren,9,0,50,41
1657863255362,CSE 15L,A02,083655,Morris; Justin Loren,10,0,50,40
1657863261387,CSE 20,A01,083657,Tran; Khoa Dang,39,0,80,41
1657863267411,CSE 21,A01,095574,Bach; Quang Tran,22,0,48,26
1657863273434,CSE 30,A01,083084,Eldon; John,6,0,80,74
1657863273434,CSE 30,B01,095061,Bhaskar; Nishant,9,0,50,41
1657863279460,CSE 100,A01,083659,Cao; Yingjun,5,4,70,65
1657863285487,CSE 134B,A01,083661,Powell; Thomas Allan,24,0,100,76
1657863291512,CSE 140,A01,083663,Gungor; Onat,15,0,85,70
1657863297556,CSE 140L,A01,083088,Eldon; John,23,0,100,77
1657863303583,CSE 175,A01,083665,Kumar; Rakesh,3,0,25,22
1657863309608,CSE 190,A00,092507,Dubnov; Shlomo,8,0,20,12
1657863315635,ECE 45,A01,083139,Congero; Spencer William,6,0,75,69
1657863321660,ECE 65,A50,083695,Saad; Andrew S,12,0,30,18
1657863321660,ECE 65,A51,095125,Saad; Andrew S,24,0,26,2
1657863327683,ECE 109,A01,091882,Touri; Behrouz,20,0,70,50
1657863333706,ECE 180,A00,083140,Abi Samra; Nicholas Camill,1,0,30,29
1657863333706,ECE 180,B00,083141,Abi Samra; Nicholas Camill,0,0,30,30
1657863339732,MATH 10A,A01,083735,Patchell; Gregory David,2,0,30,28
1657863339732,MATH 10A,A02,083736,Patchell; Gregory David,20,0,30,10
1657863339732,MATH 10A,A03,083737,Patchell; Gregory David,16,0,30,14
1657863345760,MATH 10B,A01,083207,Lim; Seonhee,8,0,34,26
1657863345760,MATH 10B,A02,083208,Lim; Seonhee,10,0,35,25
1657863345760,MATH 10B,A03,093472,Lim; Seonhee,7,0,34,27
1657863345760,MATH 10B,B01,083739,Sinha; Shubham,14,0,30,16
1657863351786,MATH 18,A01,083743,Cinel; Cameron Alexander,9,0,30,21
1657863351786,MATH 18,A02,083744,Cinel; Cameron Alexander,18,0,30,12
1657863351786,MATH 18,A03,083745,Cinel; Cameron Alexander,10,0,30,20
1657863351786,MATH 18,B01,083748,Rideout; David Porter,5,0,37,32
1657863351786,MATH 18,B02,083749,Rideout; David Porter,5,0,36,31
1657863351786,MATH 18,B03,083750,Rideout; David Porter,3,0,37,34
1657863351786,MATH 18,B04,083751,Rideout; David Porter,6,0,36,30
1657863351786,MATH 18,B05,093473,Rideout; David Porter,6,0,36,30
1657863351786,MATH 18,B06,093474,Rideout; David Porter,6,0,36,30
1657863357812,MATH 20A,A01,083754,Zheng; Zequn,14,0,40,26
1657863363834,MATH 20B,A01,083756,Briones; Jor-el Thomas Caparas,4,0,36,32
1657863363834,MATH 20B,A02,083757,Briones; Jor-el Thomas Caparas,1,0,36,35
1657863363834,MATH 20B,A03,093475,Briones; Jor-el Thomas Caparas,2,0,36,34
1657863369862,MATH 20C,A01,083760,Briones; Jor-el Thomas Caparas,1,0,35,34
1657863369862,MATH 20C,A02,083761,Briones; Jor-el Thomas Caparas,8,0,35,27
1657863369862,MATH 20C,A03,093476,Briones; Jor-el Thomas Caparas,0,1,36,36
1657863369862,MATH 20C,B01,083762,Bach; Quang Tran,1,0,30,29
1657863375885,MATH 20D,A01,083765,Tran; Brian Kha,5,0,30,25
1657863375885,MATH 20D,A02,083766,Tran; Brian Kha,5,0,30,25
1657863375885,MATH 20D,A03,083767,Tran; Brian Kha,5,0,30,25
1657863381912,MATH 20E,A01,083771,Ganguly; Soumya,10,0,32,22
1657863381912,MATH 20E,A02,083772,Ganguly; Soumya,6,0,32,26
1657863381912,MATH 20E,B01,083773,Ciotti; Benjamin,20,0,35,15
1657863381912,MATH 20E,B02,083774,Ciotti; Benjamin,18,0,35,17
1657863387936,MATH 103A,A01,083777,Greenfeld; Be'Eri,3,0,36,33
1657863387936,MATH 103A,A02,083778,Greenfeld; Be'Eri,5,0,36,31
1657863387936,MATH 103A,A03,093561,Greenfeld; Be'Eri,6,0,36,30
1657863387936,MATH 103A,B01,083779,Greenfeld; Be'Eri,7,0,36,29
1657863387936,MATH 103A,B02,083780,Greenfeld; Be'Eri,4,0,36,32
1657863387936,MATH 103A,B03,093562,Greenfeld; Be'Eri,3,0,36,33
1657863393965,MATH 105,A01,085443,Carter; Anne Toulson,15,0,35,20
1657863393965,MATH 105,A02,093477,Carter; Anne Toulson,20,0,35,15
1657863399988,MATH 109,A01,083213,Ganzberger; Geoffrey Michael,3,0,34,31
1657863399988,MATH 109,A02,083214,Ganzberger; Geoffrey Michael,4,0,34,30
1657863399988,MATH 109,A03,093478,Ganzberger; Geoffrey Michael,2,0,34,32
1657863399988,MATH 109,B01,083215,Ganzberger; Geoffrey Michael,1,0,32,31
1657863399988,MATH 109,B02,083216,Ganzberger; Geoffrey Michael,2,0,32,30
1657863399988,MATH 109,B03,093479,Ganzberger; Geoffrey Michael,8,0,32,24
1657863406018,MATH 142A,A01,083219,Chow; Bennett,7,0,32,25
1657863406018,MATH 142A,A02,083220,Chow; Bennett,10,0,32,22
1657863406018,MATH 142A,A03,093480,Chow; Bennett,9,0,32,23
1657863406018,MATH 142A,B03,093481,Chow; Bennett,8,0,32,24
1657863406018,MATH 142A,B04,093558,Chow; Bennett,13,0,32,19
1657863406018,MATH 142A,B05,093559,Chow; Bennett,7,0,32,25
1657863412047,MATH 193A,A01,083224,Rotar; Vladimir,8,0,34,26
1657863412047,MATH 193A,A02,083225,Rotar; Vladimir,10,0,34,24
1657863412047,MATH 193A,A03,083781,Rotar; Vladimir,5,0,34,29
1657863412047,MATH 193A,A04,083782,Rotar; Vladimir,11,0,34,23
1657863412047,MATH 193A,A05,093482,Rotar; Vladimir,10,0,34,24
1657863418071,MATH 197,001,091859,McAuley; Julian John,9999,0,9999,0
1657863418071,MATH 197,002,095566,Kedlaya; Kiran S.,9997,0,9999,2
1657863418071,MATH 197,003,095567,Xiao; Ming,9999,0,9999,0
1657863418071,MATH 197,004,095571,Perols; Johan Lars,9998,0,9999,1
1657863425134,COGS 9,A01,083615,Shannon; Kyle Michael,10,0,75,65
1657863431157,COGS 11,A01,083617,Boyle; Mary E. T.,23,0,48,25
1657863437180,COGS 13,A01,083071,Bastos; Amalia Pinkusfeld,11,0,71,60
1657863443207,COGS 14A,A01,092681,Semenuks; Arturs,5,1,100,95
1657863449236,COGS 14B,A01,083073,Cheng; Tzu-Han,6,0,63,57
1657863455260,COGS 17,A01,092677,Semenuks; Arturs,6,0,81,75
1657863461284,COGS 100,A01,083619,Allen; Michael Gordon,17,0,70,53
1657863467310,COGS 101A,A01,083621,Davis; Joshua Daniel,9,0,68,59
1657863473336,COGS 101B,A01,091572,Allen; Michael Gordon,12,0,65,53
1657863479365,COGS 101C,A01,083625,Delgado; Tania,17,0,35,18
1657863485388,COGS 107A,A01,083627,Boyle; Mary E. T.,14,0,60,46
1657863491416,COGS 118A,A01,083075,Gupta; Anjum,21,0,76,55
1657863497447,CSE 3,A50,083646,Miranda; Gregory Joseph,24,0,50,26
1657863503471,CSE 8A,A50,083650,Miranda; Gregory Joseph,17,1,56,39
1657863509495,CSE 11,A01,083080,Cao; Yingjun,6,15,40,34
1657863515522,CSE 12,A01,083652,Krause-Levy; Sophia Louisa,30,1,120,90
1657863521545,CSE 15L,A01,083654,Morris; Justin Loren,9,0,50,41
1657863521545,CSE 15L,A02,083655,Morris; Justin Loren,10,0,50,40
1657863527567,CSE 20,A01,083657,Tran; Khoa Dang,39,0,80,41
1657863533595,CSE 21,A01,095574,Bach; Quang Tran,22,0,48,26
1657863539623,CSE 30,A01,083084,Eldon; John,6,0,80,74
1657863539623,CSE 30,B01,095061,Bhaskar; Nishant,9,0,50,41
1657863545647,CSE 100,A01,083659,Cao; Yingjun,5,4,70,65
1657863551671,CSE 134B,A01,083661,Powell; Thomas Allan,24,0,100,76
1657863557695,CSE 140,A01,083663,Gungor; Onat,15,0,85,70
1657863563720,CSE 140L,A01,083088,Eldon; John,23,0,100,77
1657863569746,CSE 175,A01,083665,Kumar; Rakesh,3,0,25,22
1657863575844,CSE 190,A00,092507,Dubnov; Shlomo,8,0,20,12
1657863581869,ECE 45,A01,083139,Congero; Spencer William,6,0,75,69
1657863587893,ECE 65,A50,083695,Saad; Andrew S,12,0,30,18
1657863587893,ECE 65,A51,095125,Saad; Andrew S,24,0,26,2
1657863593917,ECE 109,A01,091882,Touri; Behrouz,20,0,70,50
1657863599940,ECE 180,A00,083140,Abi Samra; Nicholas Camill,1,0,30,29
1657863599940,ECE 180,B00,083141,Abi Samra; Nicholas Camill,0,0,30,30
1657863605963,MATH 10A,A01,083735,Patchell; Gregory David,2,0,30,28
1657863605963,MATH 10A,A02,083736,Patchell; Gregory David,20,0,30,10
1657863605963,MATH 10A,A03,083737,Patchell; Gregory David,16,0,30,14
1657863611998,MATH 10B,A01,083207,Lim; Seonhee,8,0,34,26
1657863611998,MATH 10B,A02,083208,Lim; Seonhee,10,0,35,25
1657863611998,MATH 10B,A03,093472,Lim; Seonhee,7,0,34,27
1657863611998,MATH 10B,B01,083739,Sinha; Shubham,14,0,30,16
1657863618030,MATH 18,A01,083743,Cinel; Cameron Alexander,9,0,30,21
1657863618030,MATH 18,A02,083744,Cinel; Cameron Alexander,18,0,30,12
1657863618030,MATH 18,A03,083745,Cinel; Cameron Alexander,10,0,30,20
1657863618030,MATH 18,B01,083748,Rideout; David Porter,5,0,37,32
1657863618030,MATH 18,B02,083749,Rideout; David Porter,5,0,36,31
1657863618030,MATH 18,B03,083750,Rideout; David Porter,3,0,37,34
1657863618030,MATH 18,B04,083751,Rideout; David Porter,6,0,36,30
1657863618030,MATH 18,B05,093473,Rideout; David Porter,6,0,36,30
1657863618030,MATH 18,B06,093474,Rideout; David Porter,6,0,36,30
1657863624059,MATH 20A,A01,083754,Zheng; Zequn,14,0,40,26
1657863630082,MATH 20B,A01,083756,Briones; Jor-el Thomas Caparas,4,0,36,32
1657863630082,MATH 20B,A02,083757,Briones; Jor-el Thomas Caparas,1,0,36,35
1657863630082,MATH 20B,A03,093475,Briones; Jor-el Thomas Caparas,2,0,36,34
1657863636109,MATH 20C,A01,083760,Briones; Jor-el Thomas Caparas,1,0,35,34
1657863636109,MATH 20C,A02,083761,Briones; Jor-el Thomas Caparas,8,0,35,27
1657863636109,MATH 20C,A03,093476,Briones; Jor-el Thomas Caparas,0,1,36,36
1657863636109,MATH 20C,B01,083762,Bach; Quang Tran,1,0,30,29
1657863642132,MATH 20D,A01,083765,Tran; Brian Kha,5,0,30,25
1657863642132,MATH 20D,A02,083766,Tran; Brian Kha,5,0,30,25
1657863642132,MATH 20D,A03,083767,Tran; Brian Kha,5,0,30,25
1657863648167,MATH 20E,A01,083771,Ganguly; Soumya,10,0,32,22
1657863648167,MATH 20E,A02,083772,Ganguly; Soumya,6,0,32,26
1657863648167,MATH 20E,B01,083773,Ciotti; Benjamin,20,0,35,15
1657863648167,MATH 20E,B02,083774,Ciotti; Benjamin,18,0,35,17
1657863654192,MATH 103A,A01,083777,Greenfeld; Be'Eri,3,0,36,33
1657863654192,MATH 103A,A02,083778,Greenfeld; Be'Eri,5,0,36,31
1657863654192,MATH 103A,A03,093561,Greenfeld; Be'Eri,6,0,36,30
1657863654192,MATH 103A,B01,083779,Greenfeld; Be'Eri,7,0,36,29
1657863654192,MATH 103A,B02,083780,Greenfeld; Be'Eri,4,0,36,32
1657863654192,MATH 103A,B03,093562,Greenfeld; Be'Eri,3,0,36,33
1657863660219,MATH 105,A01,085443,Carter; Anne Toulson,15,0,35,20
1657863660219,MATH 105,A02,093477,Carter; Anne Toulson,20,0,35,15
1657863666245,MATH 109,A01,083213,Ganzberger; Geoffrey Michael,3,0,34,31
1657863666245,MATH 109,A02,083214,Ganzberger; Geoffrey Michael,4,0,34,30
1657863666245,MATH 109,A03,093478,Ganzberger; Geoffrey Michael,2,0,34,32
1657863666245,MATH 109,B01,083215,Ganzberger; Geoffrey Michael,1,0,32,31
1657863666245,MATH 109,B02,083216,Ganzberger; Geoffrey Michael,2,0,32,30
1657863666245,MATH 109,B03,093479,Ganzberger; Geoffrey Michael,8,0,32,24
1657863672273,MATH 142A,A01,083219,Chow; Bennett,7,0,32,25
1657863672273,MATH 142A,A02,083220,Chow; Bennett,10,0,32,22
1657863672273,MATH 142A,A03,093480,Chow; Bennett,9,0,32,23
1657863672273,MATH 142A,B03,093481,Chow; Bennett,8,0,32,24
1657863672273,MATH 142A,B04,093558,Chow; Bennett,13,0,32,19
1657863672273,MATH 142A,B05,093559,Chow; Bennett,7,0,32,25
1657863678295,MATH 193A,A01,083224,Rotar; Vladimir,8,0,34,26
1657863678295,MATH 193A,A02,083225,Rotar; Vladimir,10,0,34,24
1657863678295,MATH 193A,A03,083781,Rotar; Vladimir,5,0,34,29
1657863678295,MATH 193A,A04,083782,Rotar; Vladimir,11,0,34,23
1657863678295,MATH 193A,A05,093482,Rotar; Vladimir,10,0,34,24
1657863684319,MATH 197,001,091859,McAuley; Julian John,9999,0,9999,0
1657863684319,MATH 197,002,095566,Kedlaya; Kiran S.,9997,0,9999,2
1657863684319,MATH 197,003,095567,Xiao; Ming,9999,0,9999,0
1657863684319,MATH 197,004,095571,Perols; Johan Lars,9998,0,9999,1
1657863691377,COGS 9,A01,083615,Shannon; Kyle Michael,10,0,75,65
1657863697400,COGS 11,A01,083617,Boyle; Mary E. T.,23,0,48,25
1657863703422,COGS 13,A01,083071,Bastos; Amalia Pinkusfeld,11,0,71,60
1657863709449,COGS 14A,A01,092681,Semenuks; Arturs,5,1,100,95
1657863715472,COGS 14B,A01,083073,Cheng; Tzu-Han,6,0,63,57
1657863721503,COGS 17,A01,092677,Semenuks; Arturs,6,0,81,75
1657863727526,COGS 100,A01,083619,Allen; Michael Gordon,17,0,70,53
1657863733554,COGS 101A,A01,083621,Davis; Joshua Daniel,9,0,68,59
1657863739578,COGS 101B,A01,091572,Allen; Michael Gordon,12,0,65,53
1657863745602,COGS 101C,A01,083625,Delgado; Tania,17,0,35,18
1657863751627,COGS 107A,A01,083627,Boyle; Mary E. T.,14,0,60,46
1657863757649,COGS 118A,A01,083075,Gupta; Anjum,21,0,76,55
1657863763675,CSE 3,A50,083646,Miranda; Gregory Joseph,24,0,50,26
1657863769703,CSE 8A,A50,083650,Miranda; Gregory Joseph,17,1,56,39
1657863775725,CSE 11,A01,083080,Cao; Yingjun,6,15,40,34
1657863781748,CSE 12,A01,083652,Krause-Levy; Sophia Louisa,30,1,120,90
1657863787770,CSE 15L,A01,083654,Morris; Justin Loren,9,0,50,41
1657863787770,CSE 15L,A02,083655,Morris; Justin Loren,10,0,50,40
1657863793795,CSE 20,A01,083657,Tran; Khoa Dang,39,0,80,41
1657863799817,CSE 21,A01,095574,Bach; Quang Tran,22,0,48,26
1657863805839,CSE 30,A01,083084,Eldon; John,6,0,80,74
1657863805839,CSE 30,B01,095061,Bhaskar; Nishant,9,0,50,41
1657863811862,CSE 100,A01,083659,Cao; Yingjun,5,4,70,65
1657863817883,CSE 134B,A01,083661,Powell; Thomas Allan,24,0,100,76
1657863823905,CSE 140,A01,083663,Gungor; Onat,15,0,85,70
1657863829932,CSE 140L,A01,083088,Eldon; John,23,0,100,77
1657863835958,CSE 175,A01,083665,Kumar; Rakesh,3,0,25,22
1657863841979,CSE 190,A00,092507,Dubnov; Shlomo,8,0,20,12
1657863848006,ECE 45,A01,083139,Congero; Spencer William,6,0,75,69
1657863854031,ECE 65,A50,083695,Saad; Andrew S,12,0,30,18
1657863854031,ECE 65,A51,095125,Saad; Andrew S,24,0,26,2
1657863860057,ECE 109,A01,091882,Touri; Behrouz,20,0,70,50
1657863866081,ECE 180,A00,083140,Abi Samra; Nicholas Camill,1,0,30,29
1657863866081,ECE 180,B00,083141,Abi Samra; Nicholas Camill,0,0,30,30
1657863872107,MATH 10A,A01,083735,Patchell; Gregory David,2,0,30,28
1657863872107,MATH 10A,A02,083736,Patchell; Gregory David,20,0,30,10
1657863872107,MATH 10A,A03,083737,Patchell; Gregory David,16,0,30,14
1657863878130,MATH 10B,A01,083207,Lim; Seonhee,8,0,34,26
1657863878130,MATH 10B,A02,083208,Lim; Seonhee,10,0,35,25
1657863878130,MATH 10B,A03,093472,Lim; Seonhee,7,0,34,27
1657863878130,MATH 10B,B01,083739,Sinha; Shubham,14,0,30,16
1657863884155,MATH 18,A01,083743,Cinel; Cameron Alexander,9,0,30,21
1657863884155,MATH 18,A02,083744,Cinel; Cameron Alexander,18,0,30,12
1657863884155,MATH 18,A03,083745,Cinel; Cameron Alexander,10,0,30,20
1657863884155,MATH 18,B01,083748,Rideout; David Porter,5,0,37,32
1657863884155,MATH 18,B02,083749,Rideout; David Porter,5,0,36,31
1657863884155,MATH 18,B03,083750,Rideout; David Porter,3,0,37,34
1657863884155,MATH 18,B04,083751,Rideout; David Porter,6,0,36,30
1657863884155,MATH 18,B05,093473,Rideout; David Porter,6,0,36,30
1657863884155,MATH 18,B06,093474,Rideout; David Porter,6,0,36,30
1657863890184,MATH 20A,A01,083754,Zheng; Zequn,14,0,40,26
1657863896206,MATH 20B,A01,083756,Briones; Jor-el Thomas Caparas,4,0,36,32
1657863896206,MATH 20B,A02,083757,Briones; Jor-el Thomas Caparas,1,0,36,35
1657863896206,MATH 20B,A03,093475,Briones; Jor-el Thomas Caparas,2,0,36,34
1657863902229,MATH 20C,A01,083760,Briones; Jor-el Thomas Caparas,1,0,35,34
1657863902229,MATH 20C,A02,083761,Briones; Jor-el Thomas Caparas,8,0,35,27
1657863902229,MATH 20C,A03,093476,Briones; Jor-el Thomas Caparas,0,1,36,36
1657863902229,MATH 20C,B01,083762,Bach; Quang Tran,1,0,30,29
1657863908257,MATH 20D,A01,083765,Tran; Brian Kha,5,0,30,25
1657863908257,MATH 20D,A02,083766,Tran; Brian Kha,5,0,30,25
1657863908257,MATH 20D,A03,083767,Tran; Brian Kha,5,0,30,25
1657863914283,MATH 20E,A01,083771,Ganguly; Soumya,10,0,32,22
1657863914283,MATH 20E,A02,083772,Ganguly; Soumya,6,0,32,26
1657863914283,MATH 20E,B01,083773,Ciotti; Benjamin,20,0,35,15
1657863914283,MATH 20E,B02,083774,Ciotti; Benjamin,18,0,35,17
1657863920307,MATH 103A,A01,083777,Greenfeld; Be'Eri,3,0,36,33
1657863920307,MATH 103A,A02,083778,Greenfeld; Be'Eri,5,0,36,31
1657863920307,MATH 103A,A03,093561,Greenfeld; Be'Eri,6,0,36,30
1657863920307,MATH 103A,B01,083779,Greenfeld; Be'Eri,7,0,36,29
1657863920307,MATH 103A,B02,083780,Greenfeld; Be'Eri,4,0,36,32
1657863920307,MATH 103A,B03,093562,Greenfeld; Be'Eri,3,0,36,33
1657863926333,MATH 105,A01,085443,Carter; Anne Toulson,15,0,35,20
1657863926333,MATH 105,A02,093477,Carter; Anne Toulson,20,0,35,15
1657863932357,MATH 109,A01,083213,Ganzberger; Geoffrey Michael,3,0,34,31
1657863932357,MATH 109,A02,083214,Ganzberger; Geoffrey Michael,4,0,34,30
1657863932357,MATH 109,A03,093478,Ganzberger; Geoffrey Michael,2,0,34,32
1657863932357,MATH 109,B01,083215,Ganzberger; Geoffrey Michael,1,0,32,31
1657863932357,MATH 109,B02,083216,Ganzberger; Geoffrey Michael,2,0,32,30
1657863932357,MATH 109,B03,093479,Ganzberger; Geoffrey Michael,8,0,32,24
1657863938380,MATH 142A,A01,083219,Chow; Bennett,7,0,32,25
1657863938380,MATH 142A,A02,083220,Chow; Bennett,10,0,32,22
1657863938380,MATH 142A,A03,093480,Chow; Bennett,9,0,32,23
1657863938380,MATH 142A,B03,093481,Chow; Bennett,8,0,32,24
1657863938380,MATH 142A,B04,093558,Chow; Bennett,13,0,32,19
1657863938380,MATH 142A,B05,093559,Chow; Bennett,7,0,32,25
1657863944408,MATH 193A,A01,083224,Rotar; Vladimir,8,0,34,26
1657863944408,MATH 193A,A02,083225,Rotar; Vladimir,10,0,34,24
1657863944408,MATH 193A,A03,083781,Rotar; Vladimir,5,0,34,29
1657863944408,MATH 193A,A04,083782,Rotar; Vladimir,11,0,34,23
1657863944408,MATH 193A,A05,093482,Rotar; Vladimir,10,0,34,24
1657863950434,MATH 197,001,091859,McAuley; Julian John,9999,0,9999,0
1657863950434,MATH 197,002,095566,Kedlaya; Kiran S.,9997,0,9999,2
1657863950434,MATH 197,003,095567,Xiao; Ming,9999,0,9999,0
1657863950434,MATH 197,004,095571,Perols; Johan Lars,9998,0,9999,1
1657863957499,COGS 9,A01,083615,Shannon; Kyle Michael,10,0,75,65
1657863963527,COGS 11,A01,083617,Boyle; Mary E. T.,23,0,48,25
1657863969550,COGS 13,A01,083071,Bastos; Amalia Pinkusfeld,11,0,71,60
1657863975579,COGS 14A,A01,092681,Semenuks; Arturs,5,1,100,95
1657863981603,COGS 14B,A01,083073,Cheng; Tzu-Han,6,0,63,57
1657863987642,COGS 17,A01,092677,Semenuks; Arturs,6,0,81,75
1657863993665,COGS 100,A01,083619,Allen; Michael Gordon,17,0,70,53
1657863999695,COGS 101A,A01,083621,Davis; Joshua Daniel,9,0,68,59
1657864005718,COGS 101B,A01,091572,Allen; Michael Gordon,12,0,65,53
1657864011745,COGS 101C,A01,083625,Delgado; Tania,17,0,35,18
1657864017777,COGS 107A,A01,083627,Boyle; Mary E. T.,14,0,60,46
1657864023801,COGS 118A,A01,083075,Gupta; Anjum,21,0,76,55
1657864029829,CSE 3,A50,083646,Miranda; Gregory Joseph,24,0,50,26
1657864035853,CSE 8A,A50,083650,Miranda; Gregory Joseph,17,1,56,39
1657864041879,CSE 11,A01,083080,Cao; Yingjun,6,15,40,34
1657864047902,CSE 12,A01,083652,Krause-Levy; Sophia Louisa,30,1,120,90
1657864053929,CSE 15L,A01,083654,Morris; Justin Loren,9,0,50,41
1657864053929,CSE 15L,A02,083655,Morris; Justin Loren,10,0,50,40
1657864059952,CSE 20,A01,083657,Tran; Khoa Dang,39,0,80,41
1657864065986,CSE 21,A01,095574,Bach; Quang Tran,22,0,48,26
1657864072011,CSE 30,A01,083084,Eldon; John,6,0,80,74
1657864072011,CSE 30,B01,095061,Bhaskar; Nishant,9,0,50,41
1657864078036,CSE 100,A01,083659,Cao; Yingjun,5,4,70,65
1657864084058,CSE 134B,A01,083661,Powell; Thomas Allan,24,0,100,76
1657864090086,CSE 140,A01,083663,Gungor; Onat,15,0,85,70
1657864096112,CSE 140L,A01,083088,Eldon; John,23,0,100,77
1657864102133,CSE 175,A01,083665,Kumar; Rakesh,3,0,25,22
1657864108158,CSE 190,A00,092507,Dubnov; Shlomo,8,0,20,12
1657864114182,ECE 45,A01,083139,Congero; Spencer William,6,0,75,69
1657864120215,ECE 65,A50,083695,Saad; Andrew S,12,0,30,18
1657864120215,ECE 65,A51,095125,Saad; Andrew S,24,0,26,2
1657864126245,ECE 109,A01,091882,Touri; Behrouz,20,0,70,50
1657864132269,ECE 180,A00,083140,Abi Samra; Nicholas Camill,1,0,30,29
1657864132269,ECE 180,B00,083141,Abi Samra; Nicholas Camill,0,0,30,30
1657864138296,MATH 10A,A01,083735,Patchell; Gregory David,2,0,30,28
1657864138296,MATH 10A,A02,083736,Patchell; Gregory David,20,0,30,10
1657864138296,MATH 10A,A03,083737,Patchell; Gregory David,16,0,30,14
1657864144323,MATH 10B,A01,083207,Lim; Seonhee,8,0,34,26
1657864144323,MATH 10B,A02,083208,Lim; Seonhee,10,0,35,25
1657864144323,MATH 10B,A03,093472,Lim; Seonhee,7,0,34,27
1657864144323,MATH 10B,B01,083739,Sinha; Shubham,14,0,30,16
1657864150348,MATH 18,A01,083743,Cinel; Cameron Alexander,9,0,30,21
1657864150348,MATH 18,A02,083744,Cinel; Cameron Alexander,18,0,30,12
1657864150348,MATH 18,A03,083745,Cinel; Cameron Alexander,10,0,30,20
1657864150348,MATH 18,B01,083748,Rideout; David Porter,5,0,37,32
1657864150348,MATH 18,B02,083749,Rideout; David Porter,5,0,36,31
1657864150348,MATH 18,B03,083750,Rideout; David Porter,3,0,37,34
1657864150348,MATH 18,B04,083751,Rideout; David Porter,6,0,36,30
1657864150348,MATH 18,B05,093473,Rideout; David Porter,6,0,36,30
1657864150348,MATH 18,B06,093474,Rideout; David Porter,6,0,36,30
1657864156373,MATH 20A,A01,083754,Zheng; Zequn,14,0,40,26
1657864162399,MATH 20B,A01,083756,Briones; Jor-el Thomas Caparas,4,0,36,32
1657864162399,MATH 20B,A02,083757,Briones; Jor-el Thomas Caparas,1,0,36,35
1657864162399,MATH 20B,A03,093475,Briones; Jor-el Thomas Caparas,2,0,36,34
1657864168423,MATH 20C,A01,083760,Briones; Jor-el Thomas Caparas,1,0,35,34
1657864168423,MATH 20C,A02,083761,Briones; Jor-el Thomas Caparas,8,0,35,27
1657864168423,MATH 20C,A03,093476,Briones; Jor-el Thomas Caparas,0,1,36,36
1657864168423,MATH 20C,B01,083762,Bach; Quang Tran,1,0,30,29
1657864174536,MATH 20D,A01,083765,Tran; Brian Kha,5,0,30,25
1657864174536,MATH 20D,A02,083766,Tran; Brian Kha,5,0,30,25
1657864174536,MATH 20D,A03,083767,Tran; Brian Kha,5,0,30,25
1657864180560,MATH 20E,A01,083771,Ganguly; Soumya,10,0,32,22
1657864180560,MATH 20E,A02,083772,Ganguly; Soumya,6,0,32,26
1657864180560,MATH 20E,B01,083773,Ciotti; Benjamin,20,0,35,15
1657864180560,MATH 20E,B02,083774,Ciotti; Benjamin,18,0,35,17
1657864186590,MATH 103A,A01,083777,Greenfeld; Be'Eri,3,0,36,33
1657864186590,MATH 103A,A02,083778,Greenfeld; Be'Eri,5,0,36,31
1657864186590,MATH 103A,A03,093561,Greenfeld; Be'Eri,6,0,36,30
1657864186590,MATH 103A,B01,083779,Greenfeld; Be'Eri,7,0,36,29
1657864186590,MATH 103A,B02,083780,Greenfeld; Be'Eri,4,0,36,32
1657864186590,MATH 103A,B03,093562,Greenfeld; Be'Eri,3,0,36,33
1657864192616,MATH 105,A01,085443,Carter; Anne Toulson,15,0,35,20
1657864192616,MATH 105,A02,093477,Carter; Anne Toulson,20,0,35,15
1657864198643,MATH 109,A01,083213,Ganzberger; Geoffrey Michael,3,0,34,31
1657864198643,MATH 109,A02,083214,Ganzberger; Geoffrey Michael,4,0,34,30
1657864198643,MATH 109,A03,093478,Ganzberger; Geoffrey Michael,2,0,34,32
1657864198643,MATH 109,B01,083215,Ganzberger; Geoffrey Michael,1,0,32,31
1657864198643,MATH 109,B02,083216,Ganzberger; Geoffrey Michael,2,0,32,30
1657864198643,MATH 109,B03,093479,Ganzberger; Geoffrey Michael,8,0,32,24
1657864204671,MATH 142A,A01,083219,Chow; Bennett,7,0,32,25
1657864204671,MATH 142A,A02,083220,Chow; Bennett,10,0,32,22
1657864204671,MATH 142A,A03,093480,Chow; Bennett,9,0,32,23
1657864204671,MATH 142A,B03,093481,Chow; Bennett,8,0,32,24
1657864204671,MATH 142A,B04,093558,Chow; Bennett,13,0,32,19
1657864204671,MATH 142A,B05,093559,Chow; Bennett,7,0,32,25
1657864210698,MATH 193A,A01,083224,Rotar; Vladimir,8,0,34,26
1657864210698,MATH 193A,A02,083225,Rotar; Vladimir,10,0,34,24
1657864210698,MATH 193A,A03,083781,Rotar; Vladimir,5,0,34,29
1657864210698,MATH 193A,A04,083782,Rotar; Vladimir,11,0,34,23
1657864210698,MATH 193A,A05,093482,Rotar; Vladimir,10,0,34,24
1657864216719,MATH 197,001,091859,McAuley; Julian John,9999,0,9999,0
1657864216719,MATH 197,002,095566,Kedlaya; Kiran S.,9997,0,9999,2
1657864216719,MATH 197,003,095567,Xiao; Ming,9999,0,9999,0
1657864216719,MATH 197,004,095571,Perols; Johan Lars,9998,0,9999,1
1657864223778,COGS 9,A01,083615,Shannon; Kyle Michael,10,0,75,65
1657864229805,COGS 11,A01,083617,Boyle; Mary E. T.,23,0,48,25
1657864235827,COGS 13,A01,083071,Bastos; Amalia Pinkusfeld,11,0,71,60
1657864241849,COGS 14A,A01,092681,Semenuks; Arturs,5,1,100,95
1657864247872,COGS 14B,A01,083073,Cheng; Tzu-Han,6,0,63,57
1657864253900,COGS 17,A01,092677,Semenuks; Arturs,6,0,81,75
1657864259926,COGS 100,A01,083619,Allen; Michael Gordon,17,0,70,53
1657864265948,COGS 101A,A01,083621,Davis; Joshua Daniel,9,0,68,59
1657864271971,COGS 101B,A01,091572,Allen; Michael Gordon,12,0,65,53
1657864277998,COGS 101C,A01,083625,Delgado; Tania,17,0,35,18
1657864284026,COGS 107A,A01,083627,Boyle; Mary E. T.,14,0,60,46
1657864290051,COGS 118A,A01,083075,Gupta; Anjum,21,0,76,55
1657864296079,CSE 3,A50,083646,Miranda; Gregory Joseph,24,0,50,26
1657864302110,CSE 8A,A50,083650,Miranda; Gregory Joseph,17,1,56,39
1657864308135,CSE 11,A01,083080,Cao; Yingjun,6,15,40,34
1657864314181,CSE 12,A01,083652,Krause-Levy; Sophia Louisa,30,1,120,90
1657864320204,CSE 15L,A01,083654,Morris; Justin Loren,9,0,50,41
1657864320204,CSE 15L,A02,083655,Morris; Justin Loren,10,0,50,40
1657864326237,CSE 20,A01,083657,Tran; Khoa Dang,39,0,80,41
1657864332260,CSE 21,A01,095574,Bach; Quang Tran,22,0,48,26
1657864338292,CSE 30,A01,083084,Eldon; John,6,0,80,74
1657864338292,CSE 30,B01,095061,Bhaskar; Nishant,9,0,50,41
1657864344317,CSE 100,A01,083659,Cao; Yingjun,5,4,70,65
1657864350341,CSE 134B,A01,083661,Powell; Thomas Allan,24,0,100,76
1657864356364,CSE 140,A01,083663,Gungor; Onat,15,0,85,70
1657864362386,CSE 140L,A01,083088,Eldon; John,23,0,100,77
1657864368408,CSE 175,A01,083665,Kumar; Rakesh,3,0,25,22
1657864374446,CSE 190,A00,092507,Dubnov; Shlomo,8,0,20,12
1657864380468,ECE 45,A01,083139,Congero; Spencer William,6,0,75,69
1657864386496,ECE 65,A50,083695,Saad; Andrew S,12,0,30,18
1657864386496,ECE 65,A51,095125,Saad; Andrew S,24,0,26,2
1657864392520,ECE 109,A01,091882,Touri; Behrouz,20,0,70,50
1657864398543,ECE 180,A00,083140,Abi Samra; Nicholas Camill,1,0,30,29
1657864398543,ECE 180,B00,083141,Abi Samra; Nicholas Camill,0,0,30,30
1657864404565,MATH 10A,A01,083735,Patchell; Gregory David,2,0,30,28
1657864404565,MATH 10A,A02,083736,Patchell; Gregory David,20,0,30,10
1657864404565,MATH 10A,A03,083737,Patchell; Gregory David,16,0,30,14
1657864410590,MATH 10B,A01,083207,Lim; Seonhee,8,0,34,26
1657864410590,MATH 10B,A02,083208,Lim; Seonhee,10,0,35,25
1657864410590,MATH 10B,A03,093472,Lim; Seonhee,7,0,34,27
1657864410590,MATH 10B,B01,083739,Sinha; Shubham,14,0,30,16
1657864416616,MATH 18,A01,083743,Cinel; Cameron Alexander,9,0,30,21
1657864416616,MATH 18,A02,083744,Cinel; Cameron Alexander,18,0,30,12
1657864416616,MATH 18,A03,083745,Cinel; Cameron Alexander,10,0,30,20
1657864416616,MATH 18,B01,083748,Rideout; David Porter,5,0,37,32
1657864416616,MATH 18,B02,083749,Rideout; David Porter,5,0,36,31
1657864416616,MATH 18,B03,083750,Rideout; David Porter,3,0,37,34
1657864416616,MATH 18,B04,083751,Rideout; David Porter,6,0,36,30
1657864416616,MATH 18,B05,093473,Rideout; David Porter,6,0,36,30
1657864416616,MATH 18,B06,093474,Rideout; David Porter,6,0,36,30
1657864422643,MATH 20A,A01,083754,Zheng; Zequn,14,0,40,26
1657864428667,MATH 20B,A01,083756,Briones; Jor-el Thomas Caparas,4,0,36,32
1657864428667,MATH 20B,A02,083757,Briones; Jor-el Thomas Caparas,1,0,36,35
1657864428667,MATH 20B,A03,093475,Briones; Jor-el Thomas Caparas,2,0,36,34
1657864434691,MATH 20C,A01,083760,Briones; Jor-el Thomas Caparas,1,0,35,34
1657864434691,MATH 20C,A02,083761,Briones; Jor-el Thomas Caparas,8,0,35,27
1657864434691,MATH 20C,A03,093476,Briones; Jor-el Thomas Caparas,0,1,36,36
1657864434691,MATH 20C,B01,083762,Bach; Quang Tran,1,0,30,29
1657864440713,MATH 20D,A01,083765,Tran; Brian Kha,5,0,30,25
1657864440713,MATH 20D,A02,083766,Tran; Brian Kha,5,0,30,25
1657864440713,MATH 20D,A03,083767,Tran; Brian Kha,5,0,30,25
1657864446737,MATH 20E,A01,083771,Ganguly; Soumya,10,0,32,22
1657864446737,MATH 20E,A02,083772,Ganguly; Soumya,6,0,32,26
1657864446737,MATH 20E,B01,083773,Ciotti; Benjamin,20,0,35,15
1657864446737,MATH 20E,B02,083774,Ciotti; Benjamin,18,0,35,17
1657864452761,MATH 103A,A01,083777,Greenfeld; Be'Eri,3,0,36,33
1657864452761,MATH 103A,A02,083778,Greenfeld; Be'Eri,5,0,36,31
1657864452761,MATH 103A,A03,093561,Greenfeld; Be'Eri,6,0,36,30
1657864452761,MATH 103A,B01,083779,Greenfeld; Be'Eri,7,0,36,29
1657864452761,MATH 103A,B02,083780,Greenfeld; Be'Eri,4,0,36,32
1657864452761,MATH 103A,B03,093562,Greenfeld; Be'Eri,3,0,36,33
1657864458783,MATH 105,A01,085443,Carter; Anne Toulson,15,0,35,20
1657864458783,MATH 105,A02,093477,Carter; Anne Toulson,20,0,35,15
1657864464812,MATH 109,A01,083213,Ganzberger; Geoffrey Michael,3,0,34,31
1657864464812,MATH 109,A02,083214,Ganzberger; Geoffrey Michael,4,0,34,30
1657864464812,MATH 109,A03,093478,Ganzberger; Geoffrey Michael,2,0,34,32
1657864464812,MATH 109,B01,083215,Ganzberger; Geoffrey Michael,1,0,32,31
1657864464812,MATH 109,B02,083216,Ganzberger; Geoffrey Michael,2,0,32,30
1657864464812,MATH 109,B03,093479,Ganzberger; Geoffrey Michael,8,0,32,24
1657864470842,MATH 142A,A01,083219,Chow; Bennett,7,0,32,25
1657864470842,MATH 142A,A02,083220,Chow; Bennett,10,0,32,22
1657864470842,MATH 142A,A03,093480,Chow; Bennett,9,0,32,23
1657864470842,MATH 142A,B03,093481,Chow; Bennett,8,0,32,24
1657864470842,MATH 142A,B04,093558,Chow; Bennett,13,0,32,19
1657864470842,MATH 142A,B05,093559,Chow; Bennett,7,0,32,25
1657864476867,MATH 193A,A01,083224,Rotar; Vladimir,8,0,34,26
1657864476867,MATH 193A,A02,083225,Rotar; Vladimir,10,0,34,24
1657864476867,MATH 193A,A03,083781,Rotar; Vladimir,5,0,34,29
1657864476867,MATH 193A,A04,083782,Rotar; Vladimir,11,0,34,23
1657864476867,MATH 193A,A05,093482,Rotar; Vladimir,10,0,34,24
1657864482905,MATH 197,001,091859,McAuley; Julian John,9999,0,9999,0
1657864482905,MATH 197,002,095566,Kedlaya; Kiran S.,9997,0,9999,2
1657864482905,MATH 197,003,095567,Xiao; Ming,9999,0,9999,0
1657864482905,MATH 197,004,095571,Perols; Johan Lars,9998,0,9999,1
1657864489959,COGS 9,A01,083615,Shannon; Kyle Michael,10,0,75,65
1657864495986,COGS 11,A01,083617,Boyle; Mary E. T.,23,0,48,25
1657864502012,COGS 13,A01,083071,Bastos; Amalia Pinkusfeld,11,0,71,60
1657864508034,COGS 14A,A01,092681,Semenuks; Arturs,5,1,100,95
1657864514057,COGS 14B,A01,083073,Cheng; Tzu-Han,6,0,63,57
1657864520084,COGS 17,A01,092677,Semenuks; Arturs,6,0,81,75
1657864526105,COGS 100,A01,083619,Allen; Michael Gordon,17,0,70,53
1657864532132,COGS 101A,A01,083621,Davis; Joshua Daniel,9,0,68,59
1657864538158,COGS 101B,A01,091572,Allen; Michael Gordon,12,0,65,53
1657864544182,COGS 101C,A01,083625,Delgado; Tania,17,0,35,18
1657864550205,COGS 107A,A01,083627,Boyle; Mary E. T.,14,0,60,46
1657864556227,COGS 118A,A01,083075,Gupta; Anjum,21,0,76,55
1657864562253,CSE 3,A50,083646,Miranda; Gregory Joseph,24,0,50,26
1657864568279,CSE 8A,A50,083650,Miranda; Gregory Joseph,17,1,56,39
1657864574303,CSE 11,A01,083080,Cao; Yingjun,6,15,40,34
1657864580326,CSE 12,A01,083652,Krause-Levy; Sophia Louisa,30,1,120,90
1657864586350,CSE 15L,A01,083654,Morris; Justin Loren,9,0,50,41
1657864586350,CSE 15L,A02,083655,Morris; Justin Loren,10,0,50,40
1657864592378,CSE 20,A01,083657,Tran; Khoa Dang,39,0,80,41
1657864598405,CSE 21,A01,095574,Bach; Quang Tran,22,0,48,26
1657864604430,CSE 30,A01,083084,Eldon; John,6,0,80,74
1657864604430,CSE 30,B01,095061,Bhaskar; Nishant,9,0,50,41
1657864610452,CSE 100,A01,083659,Cao; Yingjun,5,4,70,65
1657864616475,CSE 134B,A01,083661,Powell; Thomas Allan,24,0,100,76
1657864622499,CSE 140,A01,083663,Gungor; Onat,15,0,85,70
1657864628527,CSE 140L,A01,083088,Eldon; John,23,0,100,77
1657864634554,CSE 175,A01,083665,Kumar; Rakesh,3,0,25,22
1657864640576,CSE 190,A00,092507,Dubnov; Shlomo,8,0,20,12
1657864646600,ECE 45,A01,083139,Congero; Spencer William,6,0,75,69
1657864652628,ECE 65,A50,083695,Saad; Andrew S,12,0,30,18
1657864652628,ECE 65,A51,095125,Saad; Andrew S,24,0,26,2
1657864658651,ECE 109,A01,091882,Touri; Behrouz,20,0,70,50
1657864664675,ECE 180,A00,083140,Abi Samra; Nicholas Camill,1,0,30,29
1657864664675,ECE 180,B00,083141,Abi Samra; Nicholas Camill,0,0,30,30
1657864670704,MATH 10A,A01,083735,Patchell; Gregory David,2,0,30,28
1657864670704,MATH 10A,A02,083736,Patchell; Gregory David,20,0,30,10
1657864670704,MATH 10A,A03,083737,Patchell; Gregory David,16,0,30,14
1657864676738,MATH 10B,A01,083207,Lim; Seonhee,8,0,34,26
1657864676738,MATH 10B,A02,083208,Lim; Seonhee,10,0,35,25
1657864676738,MATH 10B,A03,093472,Lim; Seonhee,7,0,34,27
1657864676738,MATH 10B,B01,083739,Sinha; Shubham,14,0,30,16
1657864682763,MATH 18,A01,083743,Cinel; Cameron Alexander,9,0,30,21
1657864682763,MATH 18,A02,083744,Cinel; Cameron Alexander,18,0,30,12
1657864682763,MATH 18,A03,083745,Cinel; Cameron Alexander,10,0,30,20
1657864682763,MATH 18,B01,083748,Rideout; David Porter,5,0,37,32
1657864682763,MATH 18,B02,083749,Rideout; David Porter,5,0,36,31
1657864682763,MATH 18,B03,083750,Rideout; David Porter,3,0,37,34
1657864682763,MATH 18,B04,083751,Rideout; David Porter,6,0,36,30
1657864682763,MATH 18,B05,093473,Rideout; David Porter,6,0,36,30
1657864682763,MATH 18,B06,093474,Rideout; David Porter,6,0,36,30
1657864688789,MATH 20A,A01,083754,Zheng; Zequn,14,0,40,26
1657864694818,MATH 20B,A01,083756,Briones; Jor-el Thomas Caparas,4,0,36,32
1657864694818,MATH 20B,A02,083757,Briones; Jor-el Thomas Caparas,1,0,36,35
1657864694818,MATH 20B,A03,093475,Briones; Jor-el Thomas Caparas,2,0,36,34
1657864700846,MATH 20C,A01,083760,Briones; Jor-el Thomas Caparas,1,0,35,34
1657864700846,MATH 20C,A02,083761,Briones; Jor-el Thomas Caparas,8,0,35,27
1657864700846,MATH 20C,A03,093476,Briones; Jor-el Thomas Caparas,0,1,36,36
1657864700846,MATH 20C,B01,083762,Bach; Quang Tran,1,0,30,29
1657864706876,MATH 20D,A01,083765,Tran; Brian Kha,5,0,30,25
1657864706876,MATH 20D,A02,083766,Tran; Brian Kha,5,0,30,25
1657864706876,MATH 20D,A03,083767,Tran; Brian Kha,5,0,30,25
1657864712899,MATH 20E,A01,083771,Ganguly; Soumya,10,0,32,22
1657864712899,MATH 20E,A02,083772,Ganguly; Soumya,6,0,32,26
1657864712899,MATH 20E,B01,083773,Ciotti; Benjamin,20,0,35,15
1657864712899,MATH 20E,B02,083774,Ciotti; Benjamin,18,0,35,17
1657864718928,MATH 103A,A01,083777,Greenfeld; Be'Eri,3,0,36,33
1657864718928,MATH 103A,A02,083778,Greenfeld; Be'Eri,5,0,36,31
1657864718928,MATH 103A,A03,093561,Greenfeld; Be'Eri,6,0,36,30
1657864718928,MATH 103A,B01,083779,Greenfeld; Be'Eri,7,0,36,29
1657864718928,MATH 103A,B02,083780,Greenfeld; Be'Eri,4,0,36,32
1657864718928,MATH 103A,B03,093562,Greenfeld; Be'Eri,3,0,36,33
1657864724950,MATH 105,A01,085443,Carter; Anne Toulson,15,0,35,20
1657864724950,MATH 105,A02,093477,Carter; Anne Toulson,20,0,35,15
1657864730979,MATH 109,A01,083213,Ganzberger; Geoffrey Michael,3,0,34,31
1657864730979,MATH 109,A02,083214,Ganzberger; Geoffrey Michael,4,0,34,30
1657864730979,MATH 109,A03,093478,Ganzberger; Geoffrey Michael,2,0,34,32
1657864730979,MATH 109,B01,083215,Ganzberger; Geoffrey Michael,1,0,32,31
1657864730979,MATH 109,B02,083216,Ganzberger; Geoffrey Michael,2,0,32,30
1657864730979,MATH 109,B03,093479,Ganzberger; Geoffrey Michael,8,0,32,24
1657864737001,MATH 142A,A01,083219,Chow; Bennett,7,0,32,25
1657864737001,MATH 142A,A02,083220,Chow; Bennett,10,0,32,22
1657864737001,MATH 142A,A03,093480,Chow; Bennett,9,0,32,23
1657864737001,MATH 142A,B03,093481,Chow; Bennett,8,0,32,24
1657864737001,MATH 142A,B04,093558,Chow; Bennett,13,0,32,19
1657864737001,MATH 142A,B05,093559,Chow; Bennett,7,0,32,25
1657864743025,MATH 193A,A01,083224,Rotar; Vladimir,8,0,34,26
1657864743025,MATH 193A,A02,083225,Rotar; Vladimir,10,0,34,24
1657864743025,MATH 193A,A03,083781,Rotar; Vladimir,5,0,34,29
1657864743025,MATH 193A,A04,083782,Rotar; Vladimir,11,0,34,23
1657864743025,MATH 193A,A05,093482,Rotar; Vladimir,10,0,34,24
1657864749052,MATH 197,001,091859,McAuley; Julian John,9999,0,9999,0
1657864749052,MATH 197,002,095566,Kedlaya; Kiran S.,9997,0,9999,2
1657864749052,MATH 197,003,095567,Xiao; Ming,9999,0,9999,0
1657864749052,MATH 197,004,095571,Perols; Johan Lars,9998,0,9999,1
1657864756115,COGS 9,A01,083615,Shannon; Kyle Michael,10,0,75,65
1657864762144,COGS 11,A01,083617,Boyle; Mary E. T.,23,0,48,25
1657864768239,COGS 13,A01,083071,Bastos; Amalia Pinkusfeld,11,0,71,60
1657864774269,COGS 14A,A01,092681,Semenuks; Arturs,5,1,100,95
1657864780292,COGS 14B,A01,083073,Cheng; Tzu-Han,6,0,63,57
1657864786321,COGS 17,A01,092677,Semenuks; Arturs,6,0,81,75
1657864792347,COGS 100,A01,083619,Allen; Michael Gordon,17,0,70,53
1657864798371,COGS 101A,A01,083621,Davis; Joshua Daniel,9,0,68,59
1657864804398,COGS 101B,A01,091572,Allen; Michael Gordon,12,0,65,53
1657864810427,COGS 101C,A01,083625,Delgado; Tania,17,0,35,18
1657864816449,COGS 107A,A01,083627,Boyle; Mary E. T.,14,0,60,46
1657864822475,COGS 118A,A01,083075,Gupta; Anjum,21,0,76,55
1657864828500,CSE 3,A50,083646,Miranda; Gregory Joseph,24,0,50,26
1657864834526,CSE 8A,A50,083650,Miranda; Gregory Joseph,17,1,56,39
1657864840550,CSE 11,A01,083080,Cao; Yingjun,6,15,40,34
1657864846572,CSE 12,A01,083652,Krause-Levy; Sophia Louisa,30,1,120,90
1657864852595,CSE 15L,A01,083654,Morris; Justin Loren,9,0,50,41
1657864852595,CSE 15L,A02,083655,Morris; Justin Loren,10,0,50,40
1657864858619,CSE 20,A01,083657,Tran; Khoa Dang,39,0,80,41
1657864864646,CSE 21,A01,095574,Bach; Quang Tran,22,0,48,26
1657864870669,CSE 30,A01,083084,Eldon; John,6,0,80,74
1657864870669,CSE 30,B01,095061,Bhaskar; Nishant,9,0,50,41
1657864876691,CSE 100,A01,083659,Cao; Yingjun,5,4,70,65
1657864882714,CSE 134B,A01,083661,Powell; Thomas Allan,24,0,100,76
1657864888740,CSE 140,A01,083663,Gungor; Onat,15,0,85,70
1657864894767,CSE 140L,A01,083088,Eldon; John,23,0,100,77
1657864900788,CSE 175,A01,083665,Kumar; Rakesh,3,0,25,22
1657864906810,CSE 190,A00,092507,Dubnov; Shlomo,8,0,20,12
1657864912837,ECE 45,A01,083139,Congero; Spencer William,6,0,75,69
1657864918860,ECE 65,A50,083695,Saad; Andrew S,12,0,30,18
1657864918860,ECE 65,A51,095125,Saad; Andrew S,24,0,26,2
1657864924886,ECE 109,A01,091882,Touri; Behrouz,20,0,70,50
1657864930914,ECE 180,A00,083140,Abi Samra; Nicholas Camill,1,0,30,29
1657864930914,ECE 180,B00,083141,Abi Samra; Nicholas Camill,0,0,30,30
1657864936938,MATH 10A,A01,083735,Patchell; Gregory David,2,0,30,28
1657864936938,MATH 10A,A02,083736,Patchell; Gregory David,20,0,30,10
1657864936938,MATH 10A,A03,083737,Patchell; Gregory David,16,0,30,14
1657864942964,MATH 10B,A01,083207,Lim; Seonhee,8,0,34,26
1657864942964,MATH 10B,A02,083208,Lim; Seonhee,10,0,35,25
1657864942964,MATH 10B,A03,093472,Lim; Seonhee,7,0,34,27
1657864942964,MATH 10B,B01,083739,Sinha; Shubham,14,0,30,16
1657864948989,MATH 18,A01,083743,Cinel; Cameron Alexander,9,0,30,21
1657864948989,MATH 18,A02,083744,Cinel; Cameron Alexander,18,0,30,12
1657864948989,MATH 18,A03,083745,Cinel; Cameron Alexander,10,0,30,20
1657864948989,MATH 18,B01,083748,Rideout; David Porter,5,0,37,32
1657864948989,MATH 18,B02,083749,Rideout; David Porter,5,0,36,31
1657864948989,MATH 18,B03,083750,Rideout; David Porter,3,0,37,34
1657864948989,MATH 18,B04,083751,Rideout; David Porter,6,0,36,30
1657864948989,MATH 18,B05,093473,Rideout; David Porter,6,0,36,30
1657864948989,MATH 18,B06,093474,Rideout; David Porter,6,0,36,30
1657864955015,MATH 20A,A01,083754,Zheng; Zequn,14,0,40,26
1657864961038,MATH 20B,A01,083756,Briones; Jor-el Thomas Caparas,4,0,36,32
1657864961038,MATH 20B,A02,083757,Briones; Jor-el Thomas Caparas,1,0,36,35
1657864961038,MATH 20B,A03,093475,Briones; Jor-el Thomas Caparas,2,0,36,34
1657864967067,MATH 20C,A01,083760,Briones; Jor-el Thomas Caparas,1,0,35,34
1657864967067,MATH 20C,A02,083761,Briones; Jor-el Thomas Caparas,8,0,35,27
1657864967067,MATH 20C,A03,093476,Briones; Jor-el Thomas Caparas,0,1,36,36
1657864967067,MATH 20C,B01,083762,Bach; Quang Tran,1,0,30,29
1657864973089,MATH 20D,A01,083765,Tran; Brian Kha,5,0,30,25
1657864973089,MATH 20D,A02,083766,Tran; Brian Kha,5,0,30,25
1657864973089,MATH 20D,A03,083767,Tran; Brian Kha,5,0,30,25
1657864979113,MATH 20E,A01,083771,Ganguly; Soumya,10,0,32,22
1657864979113,MATH 20E,A02,083772,Ganguly; Soumya,6,0,32,26
1657864979113,MATH 20E,B01,083773,Ciotti; Benjamin,20,0,35,15
1657864979113,MATH 20E,B02,083774,Ciotti; Benjamin,18,0,35,17
1657864985145,MATH 103A,A01,083777,Greenfeld; Be'Eri,3,0,36,33
1657864985145,MATH 103A,A02,083778,Greenfeld; Be'Eri,5,0,36,31
1657864985145,MATH 103A,A03,093561,Greenfeld; Be'Eri,6,0,36,30
1657864985145,MATH 103A,B01,083779,Greenfeld; Be'Eri,7,0,36,29
1657864985145,MATH 103A,B02,083780,Greenfeld; Be'Eri,4,0,36,32
1657864985145,MATH 103A,B03,093562,Greenfeld; Be'Eri,3,0,36,33
1657864991169,MATH 105,A01,085443,Carter; Anne Toulson,15,0,35,20
1657864991169,MATH 105,A02,093477,Carter; Anne Toulson,20,0,35,15
1657864997192,MATH 109,A01,083213,Ganzberger; Geoffrey Michael,3,0,34,31
1657864997192,MATH 109,A02,083214,Ganzberger; Geoffrey Michael,4,0,34,30
1657864997192,MATH 109,A03,093478,Ganzberger; Geoffrey Michael,2,0,34,32
1657864997192,MATH 109,B01,083215,Ganzberger; Geoffrey Michael,1,0,32,31
1657864997192,MATH 109,B02,083216,Ganzberger; Geoffrey Michael,2,0,32,30
1657864997192,MATH 109,B03,093479,Ganzberger; Geoffrey Michael,8,0,32,24
1657865003217,MATH 142A,A01,083219,Chow; Bennett,7,0,32,25
1657865003217,MATH 142A,A02,083220,Chow; Bennett,10,0,32,22
1657865003217,MATH 142A,A03,093480,Chow; Bennett,9,0,32,23
1657865003217,MATH 142A,B03,093481,Chow; Bennett,8,0,32,24
1657865003217,MATH 142A,B04,093558,Chow; Bennett,13,0,32,19
1657865003217,MATH 142A,B05,093559,Chow; Bennett,7,0,32,25
1657865009243,MATH 193A,A01,083224,Rotar; Vladimir,8,0,34,26
1657865009243,MATH 193A,A02,083225,Rotar; Vladimir,10,0,34,24
1657865009243,MATH 193A,A03,083781,Rotar; Vladimir,5,0,34,29
1657865009243,MATH 193A,A04,083782,Rotar; Vladimir,11,0,34,23
1657865009243,MATH 193A,A05,093482,Rotar; Vladimir,10,0,34,24
1657865015267,MATH 197,001,091859,McAuley; Julian John,9999,0,9999,0
1657865015267,MATH 197,002,095566,Kedlaya; Kiran S.,9997,0,9999,2
1657865015267,MATH 197,003,095567,Xiao; Ming,9999,0,9999,0
1657865015267,MATH 197,004,095571,Perols; Johan Lars,9998,0,9999,1
1657865022340,COGS 9,A01,083615,Shannon; Kyle Michael,10,0,75,65
1657865028369,COGS 11,A01,083617,Boyle; Mary E. T.,23,0,48,25
1657865034392,COGS 13,A01,083071,Bastos; Amalia Pinkusfeld,11,0,71,60
1657865040420,COGS 14A,A01,092681,Semenuks; Arturs,5,1,100,95
1657865046442,COGS 14B,A01,083073,Cheng; Tzu-Han,6,0,63,57
1657865052464,COGS 17,A01,092677,Semenuks; Arturs,6,0,81,75
1657865058495,COGS 100,A01,083619,Allen; Michael Gordon,17,0,70,53
1657865064526,COGS 101A,A01,083621,Davis; Joshua Daniel,9,0,68,59
1657865070549,COGS 101B,A01,091572,Allen; Michael Gordon,12,0,65,53
1657865076577,COGS 101C,A01,083625,Delgado; Tania,17,0,35,18
1657865082602,COGS 107A,A01,083627,Boyle; Mary E. T.,14,0,60,46
1657865088627,COGS 118A,A01,083075,Gupta; Anjum,21,0,76,55
1657865094649,CSE 3,A50,083646,Miranda; Gregory Joseph,24,0,50,26
1657865100676,CSE 8A,A50,083650,Miranda; Gregory Joseph,17,1,56,39
1657865106702,CSE 11,A01,083080,Cao; Yingjun,6,15,40,34
1657865112730,CSE 12,A01,083652,Krause-Levy; Sophia Louisa,30,1,120,90
1657865118756,CSE 15L,A01,083654,Morris; Justin Loren,9,0,50,41
1657865118756,CSE 15L,A02,083655,Morris; Justin Loren,10,0,50,40
1657865124789,CSE 20,A01,083657,Tran; Khoa Dang,39,0,80,41
1657865130818,CSE 21,A01,095574,Bach; Quang Tran,22,0,48,26
1657865136842,CSE 30,A01,083084,Eldon; John,6,0,80,74
1657865136842,CSE 30,B01,095061,Bhaskar; Nishant,9,0,50,41
1657865142875,CSE 100,A01,083659,Cao; Yingjun,5,4,70,65
1657865148901,CSE 134B,A01,083661,Powell; Thomas Allan,24,0,100,76
1657865154934,CSE 140,A01,083663,Gungor; Onat,15,0,85,70
1657865160959,CSE 140L,A01,083088,Eldon; John,23,0,100,77
1657865166984,CSE 175,A01,083665,Kumar; Rakesh,3,0,25,22
1657865173014,CSE 190,A00,092507,Dubnov; Shlomo,8,0,20,12
1657865179038,ECE 45,A01,083139,Congero; Spencer William,6,0,75,69
1657865185065,ECE 65,A50,083695,Saad; Andrew S,12,0,30,18
1657865185065,ECE 65,A51,095125,Saad; Andrew S,24,0,26,2
1657865191106,ECE 109,A01,091882,Touri; Behrouz,20,0,70,50
1657865197131,ECE 180,A00,083140,Abi Samra; Nicholas Camill,1,0,30,29
1657865197131,ECE 180,B00,083141,Abi Samra; Nicholas Camill,0,0,30,30
1657865203156,MATH 10A,A01,083735,Patchell; Gregory David,2,0,30,28
1657865203156,MATH 10A,A02,083736,Patchell; Gregory David,20,0,30,10
1657865203156,MATH 10A,A03,083737,Patchell; Gregory David,16,0,30,14
1657865209178,MATH 10B,A01,083207,Lim; Seonhee,8,0,34,26
1657865209178,MATH 10B,A02,083208,Lim; Seonhee,10,0,35,25
1657865209178,MATH 10B,A03,093472,Lim; Seonhee,7,0,34,27
1657865209178,MATH 10B,B01,083739,Sinha; Shubham,14,0,30,16
1657865215208,MATH 18,A01,083743,Cinel; Cameron Alexander,9,0,30,21
1657865215208,MATH 18,A02,083744,Cinel; Cameron Alexander,18,0,30,12
1657865215208,MATH 18,A03,083745,Cinel; Cameron Alexander,10,0,30,20
1657865215208,MATH 18,B01,083748,Rideout; David Porter,5,0,37,32
1657865215208,MATH 18,B02,083749,Rideout; David Porter,5,0,36,31
1657865215208,MATH 18,B03,083750,Rideout; David Porter,3,0,37,34
1657865215208,MATH 18,B04,083751,Rideout; David Porter,6,0,36,30
1657865215208,MATH 18,B05,093473,Rideout; David Porter,6,0,36,30
1657865215208,MATH 18,B06,093474,Rideout; David Porter,6,0,36,30
1657865221231,MATH 20A,A01,083754,Zheng; Zequn,14,0,40,26
1657865227255,MATH 20B,A01,083756,Briones; Jor-el Thomas Caparas,4,0,36,32
1657865227255,MATH 20B,A02,083757,Briones; Jor-el Thomas Caparas,1,0,36,35
1657865227255,MATH 20B,A03,093475,Briones; Jor-el Thomas Caparas,2,0,36,34
1657865233283,MATH 20C,A01,083760,Briones; Jor-el Thomas Caparas,1,0,35,34
1657865233283,MATH 20C,A02,083761,Briones; Jor-el Thomas Caparas,8,0,35,27
1657865233283,MATH 20C,A03,093476,Briones; Jor-el Thomas Caparas,0,1,36,36
1657865233283,MATH 20C,B01,083762,Bach; Quang Tran,1,0,30,29
1657865239307,MATH 20D,A01,083765,Tran; Brian Kha,5,0,30,25
1657865239307,MATH 20D,A02,083766,Tran; Brian Kha,5,0,30,25
1657865239307,MATH 20D,A03,083767,Tran; Brian Kha,5,0,30,25
1657865245335,MATH 20E,A01,083771,Ganguly; Soumya,10,0,32,22
1657865245335,MATH 20E,A02,083772,Ganguly; Soumya,6,0,32,26
1657865245335,MATH 20E,B01,083773,Ciotti; Benjamin,20,0,35,15
1657865245335,MATH 20E,B02,083774,Ciotti; Benjamin,18,0,35,17
1657865251370,MATH 103A,A01,083777,Greenfeld; Be'Eri,3,0,36,33
1657865251370,MATH 103A,A02,083778,Greenfeld; Be'Eri,5,0,36,31
1657865251370,MATH 103A,A03,093561,Greenfeld; Be'Eri,6,0,36,30
1657865251370,MATH 103A,B01,083779,Greenfeld; Be'Eri,7,0,36,29
1657865251370,MATH 103A,B02,083780,Greenfeld; Be'Eri,4,0,36,32
1657865251370,MATH 103A,B03,093562,Greenfeld; Be'Eri,3,0,36,33
1657865257398,MATH 105,A01,085443,Carter; Anne Toulson,15,0,35,20
1657865257398,MATH 105,A02,093477,Carter; Anne Toulson,20,0,35,15
1657865263422,MATH 109,A01,083213,Ganzberger; Geoffrey Michael,3,0,34,31
1657865263422,MATH 109,A02,083214,Ganzberger; Geoffrey Michael,4,0,34,30
1657865263422,MATH 109,A03,093478,Ganzberger; Geoffrey Michael,2,0,34,32
1657865263422,MATH 109,B01,083215,Ganzberger; Geoffrey Michael,1,0,32,31
1657865263422,MATH 109,B02,083216,Ganzberger; Geoffrey Michael,2,0,32,30
1657865263422,MATH 109,B03,093479,Ganzberger; Geoffrey Michael,8,0,32,24
1657865269446,MATH 142A,A01,083219,Chow; Bennett,7,0,32,25
1657865269446,MATH 142A,A02,083220,Chow; Bennett,10,0,32,22
1657865269446,MATH 142A,A03,093480,Chow; Bennett,9,0,32,23
1657865269446,MATH 142A,B03,093481,Chow; Bennett,8,0,32,24
1657865269446,MATH 142A,B04,093558,Chow; Bennett,13,0,32,19
1657865269446,MATH 142A,B05,093559,Chow; Bennett,7,0,32,25
1657865275471,MATH 193A,A01,083224,Rotar; Vladimir,8,0,34,26
1657865275471,MATH 193A,A02,083225,Rotar; Vladimir,10,0,34,24
1657865275471,MATH 193A,A03,083781,Rotar; Vladimir,5,0,34,29
1657865275471,MATH 193A,A04,083782,Rotar; Vladimir,11,0,34,23
1657865275471,MATH 193A,A05,093482,Rotar; Vladimir,10,0,34,24
1657865281508,MATH 197,001,091859,McAuley; Julian John,9999,0,9999,0
1657865281508,MATH 197,002,095566,Kedlaya; Kiran S.,9997,0,9999,2
1657865281508,MATH 197,003,095567,Xiao; Ming,9999,0,9999,0
1657865281508,MATH 197,004,095571,Perols; Johan Lars,9998,0,9999,1
1657865288588,COGS 9,A01,083615,Shannon; Kyle Michael,10,0,75,65
1657865294611,COGS 11,A01,083617,Boyle; Mary E. T.,23,0,48,25
1657865300637,COGS 13,A01,083071,Bastos; Amalia Pinkusfeld,11,0,71,60
1657865306661,COGS 14A,A01,092681,Semenuks; Arturs,5,1,100,95
1657865312694,COGS 14B,A01,083073,Cheng; Tzu-Han,6,0,63,57
1657865318718,COGS 17,A01,092677,Semenuks; Arturs,6,0,81,75
1657865324746,COGS 100,A01,083619,Allen; Michael Gordon,17,0,70,53
1657865330775,COGS 101A,A01,083621,Davis; Joshua Daniel,9,0,68,59
1657865336798,COGS 101B,A01,091572,Allen; Michael Gordon,12,0,65,53
1657865342829,COGS 101C,A01,083625,Delgado; Tania,17,0,35,18
1657865348855,COGS 107A,A01,083627,Boyle; Mary E. T.,14,0,60,46
1657865354878,COGS 118A,A01,083075,Gupta; Anjum,21,0,76,55
1657865360906,CSE 3,A50,083646,Miranda; Gregory Joseph,24,0,50,26
1657865367038,CSE 8A,A50,083650,Miranda; Gregory Joseph,17,1,56,39
1657865373063,CSE 11,A01,083080,Cao; Yingjun,6,15,40,34
1657865379088,CSE 12,A01,083652,Krause-Levy; Sophia Louisa,30,1,120,90
1657865385110,CSE 15L,A01,083654,Morris; Justin Loren,9,0,50,41
1657865385110,CSE 15L,A02,083655,Morris; Justin Loren,10,0,50,40
1657865391132,CSE 20,A01,083657,Tran; Khoa Dang,39,0,80,41
1657865397156,CSE 21,A01,095574,Bach; Quang Tran,22,0,48,26
1657865403184,CSE 30,A01,083084,Eldon; John,6,0,80,74
1657865403184,CSE 30,B01,095061,Bhaskar; Nishant,9,0,50,41
1657865409219,CSE 100,A01,083659,Cao; Yingjun,5,4,70,65
1657865415244,CSE 134B,A01,083661,Powell; Thomas Allan,24,0,100,76
1657865421288,CSE 140,A01,083663,Gungor; Onat,15,0,85,70
1657865427316,CSE 140L,A01,083088,Eldon; John,23,0,100,77
1657865433346,CSE 175,A01,083665,Kumar; Rakesh,3,0,25,22
1657865439372,CSE 190,A00,092507,Dubnov; Shlomo,8,0,20,12
1657865445399,ECE 45,A01,083139,Congero; Spencer William,6,0,75,69
1657865451428,ECE 65,A50,083695,Saad; Andrew S,12,0,30,18
1657865451428,ECE 65,A51,095125,Saad; Andrew S,24,0,26,2
1657865457452,ECE 109,A01,091882,Touri; Behrouz,20,0,70,50
1657865463496,ECE 180,A00,083140,Abi Samra; Nicholas Camill,1,0,30,29
1657865463496,ECE 180,B00,083141,Abi Samra; Nicholas Camill,0,0,30,30
1657865469533,MATH 10A,A01,083735,Patchell; Gregory David,2,0,30,28
1657865469533,MATH 10A,A02,083736,Patchell; Gregory David,20,0,30,10
1657865469533,MATH 10A,A03,083737,Patchell; Gregory David,16,0,30,14
1657865475563,MATH 10B,A01,083207,Lim; Seonhee,8,0,34,26
1657865475563,MATH 10B,A02,083208,Lim; Seonhee,10,0,35,25
1657865475563,MATH 10B,A03,093472,Lim; Seonhee,7,0,34,27
1657865475563,MATH 10B,B01,083739,Sinha; Shubham,14,0,30,16
1657865481587,MATH 18,A01,083743,Cinel; Cameron Alexander,9,0,30,21
1657865481587,MATH 18,A02,083744,Cinel; Cameron Alexander,18,0,30,12
1657865481587,MATH 18,A03,083745,Cinel; Cameron Alexander,10,0,30,20
1657865481587,MATH 18,B01,083748,Rideout; David Porter,5,0,37,32
1657865481587,MATH 18,B02,083749,Rideout; David Porter,5,0,36,31
1657865481587,MATH 18,B03,083750,Rideout; David Porter,3,0,37,34
1657865481587,MATH 18,B04,083751,Rideout; David Porter,6,0,36,30
1657865481587,MATH 18,B05,093473,Rideout; David Porter,6,0,36,30
1657865481587,MATH 18,B06,093474,Rideout; David Porter,6,0,36,30
1657865487614,MATH 20A,A01,083754,Zheng; Zequn,14,0,40,26
1657865493643,MATH 20B,A01,083756,Briones; Jor-el Thomas Caparas,4,0,36,32
1657865493643,MATH 20B,A02,083757,Briones; Jor-el Thomas Caparas,1,0,36,35
1657865493643,MATH 20B,A03,093475,Briones; Jor-el Thomas Caparas,2,0,36,34
1657865499667,MATH 20C,A01,083760,Briones; Jor-el Thomas Caparas,1,0,35,34
1657865499667,MATH 20C,A02,083761,Briones; Jor-el Thomas Caparas,8,0,35,27
1657865499667,MATH 20C,A03,093476,Briones; Jor-el Thomas Caparas,0,1,36,36
1657865499667,MATH 20C,B01,083762,Bach; Quang Tran,1,0,30,29
1657865505690,MATH 20D,A01,083765,Tran; Brian Kha,5,0,30,25
1657865505690,MATH 20D,A02,083766,Tran; Brian Kha,5,0,30,25
1657865505690,MATH 20D,A03,083767,Tran; Brian Kha,5,0,30,25
1657865511711,MATH 20E,A01,083771,Ganguly; Soumya,10,0,32,22
1657865511711,MATH 20E,A02,083772,Ganguly; Soumya,6,0,32,26
1657865511711,MATH 20E,B01,083773,Ciotti; Benjamin,20,0,35,15
1657865511711,MATH 20E,B02,083774,Ciotti; Benjamin,18,0,35,17
1657865517738,MATH 103A,A01,083777,Greenfeld; Be'Eri,3,0,36,33
1657865517738,MATH 103A,A02,083778,Greenfeld; Be'Eri,5,0,36,31
1657865517738,MATH 103A,A03,093561,Greenfeld; Be'Eri,6,0,36,30
1657865517738,MATH 103A,B01,083779,Greenfeld; Be'Eri,7,0,36,29
1657865517738,MATH 103A,B02,083780,Greenfeld; Be'Eri,4,0,36,32
1657865517738,MATH 103A,B03,093562,Greenfeld; Be'Eri,3,0,36,33
1657865523764,MATH 105,A01,085443,Carter; Anne Toulson,15,0,35,20
1657865523764,MATH 105,A02,093477,Carter; Anne Toulson,20,0,35,15
1657865529788,MATH 109,A01,083213,Ganzberger; Geoffrey Michael,3,0,34,31
1657865529788,MATH 109,A02,083214,Ganzberger; Geoffrey Michael,4,0,34,30
1657865529788,MATH 109,A03,093478,Ganzberger; Geoffrey Michael,2,0,34,32
1657865529788,MATH 109,B01,083215,Ganzberger; Geoffrey Michael,1,0,32,31
1657865529788,MATH 109,B02,083216,Ganzberger; Geoffrey Michael,2,0,32,30
1657865529788,MATH 109,B03,093479,Ganzberger; Geoffrey Michael,8,0,32,24
1657865535812,MATH 142A,A01,083219,Chow; Bennett,7,0,32,25
1657865535812,MATH 142A,A02,083220,Chow; Bennett,10,0,32,22
1657865535812,MATH 142A,A03,093480,Chow; Bennett,9,0,32,23
1657865535812,MATH 142A,B03,093481,Chow; Bennett,8,0,32,24
1657865535812,MATH 142A,B04,093558,Chow; Bennett,13,0,32,19
1657865535812,MATH 142A,B05,093559,Chow; Bennett,7,0,32,25
1657865541840,MATH 193A,A01,083224,Rotar; Vladimir,8,0,34,26
1657865541840,MATH 193A,A02,083225,Rotar; Vladimir,10,0,34,24
1657865541840,MATH 193A,A03,083781,Rotar; Vladimir,5,0,34,29
1657865541840,MATH 193A,A04,083782,Rotar; Vladimir,11,0,34,23
1657865541840,MATH 193A,A05,093482,Rotar; Vladimir,10,0,34,24
1657865547872,MATH 197,001,091859,McAuley; Julian John,9999,0,9999,0
1657865547872,MATH 197,002,095566,Kedlaya; Kiran S.,9997,0,9999,2
1657865547872,MATH 197,003,095567,Xiao; Ming,9999,0,9999,0
1657865547872,MATH 197,004,095571,Perols; Johan Lars,9998,0,9999,1
1657865554939,COGS 9,A01,083615,Shannon; Kyle Michael,10,0,75,65
1657865560983,COGS 11,A01,083617,Boyle; Mary E. T.,23,0,48,25
1657865567005,COGS 13,A01,083071,Bastos; Amalia Pinkusfeld,11,0,71,60
1657865573032,COGS 14A,A01,092681,Semenuks; Arturs,5,1,100,95
1657865579057,COGS 14B,A01,083073,Cheng; Tzu-Han,6,0,63,57
1657865585084,COGS 17,A01,092677,Semenuks; Arturs,6,0,81,75
1657865591112,COGS 100,A01,083619,Allen; Michael Gordon,17,0,70,53
1657865597133,COGS 101A,A01,083621,Davis; Joshua Daniel,9,0,68,59
1657865603158,COGS 101B,A01,091572,Allen; Michael Gordon,12,0,65,53
1657865609187,COGS 101C,A01,083625,Delgado; Tania,17,0,35,18
1657865615214,COGS 107A,A01,083627,Boyle; Mary E. T.,14,0,60,46
1657865621241,COGS 118A,A01,083075,Gupta; Anjum,21,0,76,55
1657865627267,CSE 3,A50,083646,Miranda; Gregory Joseph,24,0,50,26
1657865633291,CSE 8A,A50,083650,Miranda; Gregory Joseph,17,1,56,39
1657865639318,CSE 11,A01,083080,Cao; Yingjun,6,15,40,34
1657865645341,CSE 12,A01,083652,Krause-Levy; Sophia Louisa,30,1,120,90
1657865651365,CSE 15L,A01,083654,Morris; Justin Loren,9,0,50,41
1657865651365,CSE 15L,A02,083655,Morris; Justin Loren,10,0,50,40
1657865657392,CSE 20,A01,083657,Tran; Khoa Dang,39,0,80,41
1657865663417,CSE 21,A01,095574,Bach; Quang Tran,22,0,48,26
1657865669450,CSE 30,A01,083084,Eldon; John,6,0,80,74
1657865669450,CSE 30,B01,095061,Bhaskar; Nishant,9,0,50,41
1657865675473,CSE 100,A01,083659,Cao; Yingjun,5,4,70,65
1657865681497,CSE 134B,A01,083661,Powell; Thomas Allan,24,0,100,76
1657865687522,CSE 140,A01,083663,Gungor; Onat,15,0,85,70
1657865693555,CSE 140L,A01,083088,Eldon; John,23,0,100,77
1657865699579,CSE 175,A01,083665,Kumar; Rakesh,3,0,25,22
1657865705601,CSE 190,A00,092507,Dubnov; Shlomo,8,0,20,12
1657865711623,ECE 45,A01,083139,Congero; Spencer William,6,0,75,69
1657865717656,ECE 65,A50,083695,Saad; Andrew S,12,0,30,18
1657865717656,ECE 65,A51,095125,Saad; Andrew S,24,0,26,2
1657865723678,ECE 109,A01,091882,Touri; Behrouz,20,0,70,50
1657865729707,ECE 180,A00,083140,Abi Samra; Nicholas Camill,1,0,30,29
1657865729707,ECE 180,B00,083141,Abi Samra; Nicholas Camill,0,0,30,30
1657865735755,MATH 10A,A01,083735,Patchell; Gregory David,2,0,30,28
1657865735755,MATH 10A,A02,083736,Patchell; Gregory David,20,0,30,10
1657865735755,MATH 10A,A03,083737,Patchell; Gregory David,16,0,30,14
1657865741788,MATH 10B,A01,083207,Lim; Seonhee,8,0,34,26
1657865741788,MATH 10B,A02,083208,Lim; Seonhee,10,0,35,25
1657865741788,MATH 10B,A03,093472,Lim; Seonhee,7,0,34,27
1657865741788,MATH 10B,B01,083739,Sinha; Shubham,14,0,30,16
1657865747812,MATH 18,A01,083743,Cinel; Cameron Alexander,9,0,30,21
1657865747812,MATH 18,A02,083744,Cinel; Cameron Alexander,18,0,30,12
1657865747812,MATH 18,A03,083745,Cinel; Cameron Alexander,10,0,30,20
1657865747812,MATH 18,B01,083748,Rideout; David Porter,5,0,37,32
1657865747812,MATH 18,B02,083749,Rideout; David Porter,5,0,36,31
1657865747812,MATH 18,B03,083750,Rideout; David Porter,3,0,37,34
1657865747812,MATH 18,B04,083751,Rideout; David Porter,6,0,36,30
1657865747812,MATH 18,B05,093473,Rideout; David Porter,6,0,36,30
1657865747812,MATH 18,B06,093474,Rideout; David Porter,6,0,36,30
1657865753838,MATH 20A,A01,083754,Zheng; Zequn,14,0,40,26
1657865759860,MATH 20B,A01,083756,Briones; Jor-el Thomas Caparas,4,0,36,32
1657865759860,MATH 20B,A02,083757,Briones; Jor-el Thomas Caparas,1,0,36,35
1657865759860,MATH 20B,A03,093475,Briones; Jor-el Thomas Caparas,2,0,36,34
1657865765883,MATH 20C,A01,083760,Briones; Jor-el Thomas Caparas,1,0,35,34
1657865765883,MATH 20C,A02,083761,Briones; Jor-el Thomas Caparas,8,0,35,27
1657865765883,MATH 20C,A03,093476,Briones; Jor-el Thomas Caparas,0,1,36,36
1657865765883,MATH 20C,B01,083762,Bach; Quang Tran,1,0,30,29
1657865771911,MATH 20D,A01,083765,Tran; Brian Kha,5,0,30,25
1657865771911,MATH 20D,A02,083766,Tran; Brian Kha,5,0,30,25
1657865771911,MATH 20D,A03,083767,Tran; Brian Kha,5,0,30,25
1657865777939,MATH 20E,A01,083771,Ganguly; Soumya,10,0,32,22
1657865777939,MATH 20E,A02,083772,Ganguly; Soumya,6,0,32,26
1657865777939,MATH 20E,B01,083773,Ciotti; Benjamin,20,0,35,15
1657865777939,MATH 20E,B02,083774,Ciotti; Benjamin,18,0,35,17
1657865783963,MATH 103A,A01,083777,Greenfeld; Be'Eri,3,0,36,33
1657865783963,MATH 103A,A02,083778,Greenfeld; Be'Eri,5,0,36,31
1657865783963,MATH 103A,A03,093561,Greenfeld; Be'Eri,6,0,36,30
1657865783963,MATH 103A,B01,083779,Greenfeld; Be'Eri,7,0,36,29
1657865783963,MATH 103A,B02,083780,Greenfeld; Be'Eri,4,0,36,32
1657865783963,MATH 103A,B03,093562,Greenfeld; Be'Eri,3,0,36,33
1657865789990,MATH 105,A01,085443,Carter; Anne Toulson,15,0,35,20
1657865789990,MATH 105,A02,093477,Carter; Anne Toulson,20,0,35,15
1657865796018,MATH 109,A01,083213,Ganzberger; Geoffrey Michael,3,0,34,31
1657865796018,MATH 109,A02,083214,Ganzberger; Geoffrey Michael,4,0,34,30
1657865796018,MATH 109,A03,093478,Ganzberger; Geoffrey Michael,2,0,34,32
1657865796018,MATH 109,B01,083215,Ganzberger; Geoffrey Michael,1,0,32,31
1657865796018,MATH 109,B02,083216,Ganzberger; Geoffrey Michael,2,0,32,30
1657865796018,MATH 109,B03,093479,Ganzberger; Geoffrey Michael,8,0,32,24
1657865802042,MATH 142A,A01,083219,Chow; Bennett,7,0,32,25
1657865802042,MATH 142A,A02,083220,Chow; Bennett,10,0,32,22
1657865802042,MATH 142A,A03,093480,Chow; Bennett,9,0,32,23
1657865802042,MATH 142A,B03,093481,Chow; Bennett,8,0,32,24
1657865802042,MATH 142A,B04,093558,Chow; Bennett,13,0,32,19
1657865802042,MATH 142A,B05,093559,Chow; Bennett,7,0,32,25
1657865808067,MATH 193A,A01,083224,Rotar; Vladimir,8,0,34,26
1657865808067,MATH 193A,A02,083225,Rotar; Vladimir,10,0,34,24
1657865808067,MATH 193A,A03,083781,Rotar; Vladimir,5,0,34,29
1657865808067,MATH 193A,A04,083782,Rotar; Vladimir,11,0,34,23
1657865808067,MATH 193A,A05,093482,Rotar; Vladimir,10,0,34,24
1657865814091,MATH 197,001,091859,McAuley; Julian John,9999,0,9999,0
1657865814091,MATH 197,002,095566,Kedlaya; Kiran S.,9997,0,9999,2
1657865814091,MATH 197,003,095567,Xiao; Ming,9999,0,9999,0
1657865814091,MATH 197,004,095571,Perols; Johan Lars,9998,0,9999,1
1657865821143,COGS 9,A01,083615,Shannon; Kyle Michael,10,0,75,65
1657865827164,COGS 11,A01,083617,Boyle; Mary E. T.,23,0,48,25
1657865833187,COGS 13,A01,083071,Bastos; Amalia Pinkusfeld,11,0,71,60
1657865839209,COGS 14A,A01,092681,Semenuks; Arturs,5,1,100,95
1657865845246,COGS 14B,A01,083073,Cheng; Tzu-Han,6,0,63,57
1657865851270,COGS 17,A01,092677,Semenuks; Arturs,6,0,81,75
1657865857293,COGS 100,A01,083619,Allen; Michael Gordon,17,0,70,53
1657865863328,COGS 101A,A01,083621,Davis; Joshua Daniel,9,0,68,59
1657865869352,COGS 101B,A01,091572,Allen; Michael Gordon,12,0,65,53
1657865875380,COGS 101C,A01,083625,Delgado; Tania,17,0,35,18
1657865881408,COGS 107A,A01,083627,Boyle; Mary E. T.,14,0,60,46
1657865887434,COGS 118A,A01,083075,Gupta; Anjum,21,0,76,55
1657865893459,CSE 3,A50,083646,Miranda; Gregory Joseph,24,0,50,26
1657865899482,CSE 8A,A50,083650,Miranda; Gregory Joseph,17,1,56,39
1657865905520,CSE 11,A01,083080,Cao; Yingjun,6,15,40,34
1657865911544,CSE 12,A01,083652,Krause-Levy; Sophia Louisa,30,1,120,90
1657865917569,CSE 15L,A01,083654,Morris; Justin Loren,9,0,50,41
1657865917569,CSE 15L,A02,083655,Morris; Justin Loren,10,0,50,40
1657865923593,CSE 20,A01,083657,Tran; Khoa Dang,39,0,80,41
1657865929621,CSE 21,A01,095574,Bach; Quang Tran,22,0,48,26
1657865935656,CSE 30,A01,083084,Eldon; John,6,0,80,74
1657865935656,CSE 30,B01,095061,Bhaskar; Nishant,9,0,50,41
1657865941678,CSE 100,A01,083659,Cao; Yingjun,5,4,70,65
1657865947705,CSE 134B,A01,083661,Powell; Thomas Allan,24,0,100,76
1657865953731,CSE 140,A01,083663,Gungor; Onat,15,0,85,70
1657865959754,CSE 140L,A01,083088,Eldon; John,23,0,100,77
1657865965856,CSE 175,A01,083665,Kumar; Rakesh,3,0,25,22
1657865971884,CSE 190,A00,092507,Dubnov; Shlomo,8,0,20,12
1657865977915,ECE 45,A01,083139,Congero; Spencer William,6,0,75,69
1657865983945,ECE 65,A50,083695,Saad; Andrew S,12,0,30,18
1657865983945,ECE 65,A51,095125,Saad; Andrew S,24,0,26,2
1657865989981,ECE 109,A01,091882,Touri; Behrouz,20,0,70,50
1657865996008,ECE 180,A00,083140,Abi Samra; Nicholas Camill,1,0,30,29
1657865996008,ECE 180,B00,083141,Abi Samra; Nicholas Camill,0,0,30,30
1657866002041,MATH 10A,A01,083735,Patchell; Gregory David,2,0,30,28
1657866002041,MATH 10A,A02,083736,Patchell; Gregory David,20,0,30,10
1657866002041,MATH 10A,A03,083737,Patchell; Gregory David,16,0,30,14
1657866008071,MATH 10B,A01,083207,Lim; Seonhee,8,0,34,26
1657866008071,MATH 10B,A02,083208,Lim; Seonhee,10,0,35,25
1657866008071,MATH 10B,A03,093472,Lim; Seonhee,7,0,34,27
1657866008071,MATH 10B,B01,083739,Sinha; Shubham,14,0,30,16
1657866014102,MATH 18,A01,083743,Cinel; Cameron Alexander,9,0,30,21
1657866014102,MATH 18,A02,083744,Cinel; Cameron Alexander,18,0,30,12
1657866014102,MATH 18,A03,083745,Cinel; Cameron Alexander,10,0,30,20
1657866014102,MATH 18,B01,083748,Rideout; David Porter,5,0,37,32
1657866014102,MATH 18,B02,083749,Rideout; David Porter,5,0,36,31
1657866014102,MATH 18,B03,083750,Rideout; David Porter,3,0,37,34
1657866014102,MATH 18,B04,083751,Rideout; David Porter,6,0,36,30
1657866014102,MATH 18,B05,093473,Rideout; David Porter,6,0,36,30
1657866014102,MATH 18,B06,093474,Rideout; David Porter,6,0,36,30
1657866020125,MATH 20A,A01,083754,Zheng; Zequn,14,0,40,26
1657866026164,MATH 20B,A01,083756,Briones; Jor-el Thomas Caparas,4,0,36,32
1657866026164,MATH 20B,A02,083757,Briones; Jor-el Thomas Caparas,1,0,36,35
1657866026164,MATH 20B,A03,093475,Briones; Jor-el Thomas Caparas,2,0,36,34
1657866032192,MATH 20C,A01,083760,Briones; Jor-el Thomas Caparas,1,0,35,34
1657866032192,MATH 20C,A02,083761,Briones; Jor-el Thomas Caparas,8,0,35,27
1657866032192,MATH 20C,A03,093476,Briones; Jor-el Thomas Caparas,0,1,36,36
1657866032192,MATH 20C,B01,083762,Bach; Quang Tran,1,0,30,29
1657866038215,MATH 20D,A01,083765,Tran; Brian Kha,5,0,30,25
1657866038215,MATH 20D,A02,083766,Tran; Brian Kha,5,0,30,25
1657866038215,MATH 20D,A03,083767,Tran; Brian Kha,5,0,30,25
1657866044240,MATH 20E,A01,083771,Ganguly; Soumya,10,0,32,22
1657866044240,MATH 20E,A02,083772,Ganguly; Soumya,6,0,32,26
1657866044240,MATH 20E,B01,083773,Ciotti; Benjamin,20,0,35,15
1657866044240,MATH 20E,B02,083774,Ciotti; Benjamin,18,0,35,17
1657866050263,MATH 103A,A01,083777,Greenfeld; Be'Eri,3,0,36,33
1657866050263,MATH 103A,A02,083778,Greenfeld; Be'Eri,5,0,36,31
1657866050263,MATH 103A,A03,093561,Greenfeld; Be'Eri,6,0,36,30
1657866050263,MATH 103A,B01,083779,Greenfeld; Be'Eri,7,0,36,29
1657866050263,MATH 103A,B02,083780,Greenfeld; Be'Eri,4,0,36,32
1657866050263,MATH 103A,B03,093562,Greenfeld; Be'Eri,3,0,36,33
1657866056288,MATH 105,A01,085443,Carter; Anne Toulson,15,0,35,20
1657866056288,MATH 105,A02,093477,Carter; Anne Toulson,20,0,35,15
1657866062312,MATH 109,A01,083213,Ganzberger; Geoffrey Michael,3,0,34,31
1657866062312,MATH 109,A02,083214,Ganzberger; Geoffrey Michael,4,0,34,30
1657866062312,MATH 109,A03,093478,Ganzberger; Geoffrey Michael,2,0,34,32
1657866062312,MATH 109,B01,083215,Ganzberger; Geoffrey Michael,1,0,32,31
1657866062312,MATH 109,B02,083216,Ganzberger; Geoffrey Michael,2,0,32,30
1657866062312,MATH 109,B03,093479,Ganzberger; Geoffrey Michael,8,0,32,24
1657866068336,MATH 142A,A01,083219,Chow; Bennett,7,0,32,25
1657866068336,MATH 142A,A02,083220,Chow; Bennett,10,0,32,22
1657866068336,MATH 142A,A03,093480,Chow; Bennett,9,0,32,23
1657866068336,MATH 142A,B03,093481,Chow; Bennett,8,0,32,24
1657866068336,MATH 142A,B04,093558,Chow; Bennett,13,0,32,19
1657866068336,MATH 142A,B05,093559,Chow; Bennett,7,0,32,25
1657866074367,MATH 193A,A01,083224,Rotar; Vladimir,8,0,34,26
1657866074367,MATH 193A,A02,083225,Rotar; Vladimir,10,0,34,24
1657866074367,MATH 193A,A03,083781,Rotar; Vladimir,5,0,34,29
1657866074367,MATH 193A,A04,083782,Rotar; Vladimir,11,0,34,23
1657866074367,MATH 193A,A05,093482,Rotar; Vladimir,10,0,34,24
1657866080395,MATH 197,001,091859,McAuley; Julian John,9999,0,9999,0
1657866080395,MATH 197,002,095566,Kedlaya; Kiran S.,9997,0,9999,2
1657866080395,MATH 197,003,095567,Xiao; Ming,9999,0,9999,0
1657866080395,MATH 197,004,095571,Perols; Johan Lars,9998,0,9999,1
1657866087447,COGS 9,A01,083615,Shannon; Kyle Michael,10,0,75,65
1657866093475,COGS 11,A01,083617,Boyle; Mary E. T.,23,0,48,25
1657866099509,COGS 13,A01,083071,Bastos; Amalia Pinkusfeld,11,0,71,60
1657866105539,COGS 14A,A01,092681,Semenuks; Arturs,5,1,100,95
1657866111563,COGS 14B,A01,083073,Cheng; Tzu-Han,6,0,63,57
1657866117588,COGS 17,A01,092677,Semenuks; Arturs,6,0,81,75
1657866123610,COGS 100,A01,083619,Allen; Michael Gordon,17,0,70,53
1657866129634,COGS 101A,A01,083621,Davis; Joshua Daniel,9,0,68,59
1657866135662,COGS 101B,A01,091572,Allen; Michael Gordon,12,0,65,53
1657866141686,COGS 101C,A01,083625,Delgado; Tania,17,0,35,18
1657866147712,COGS 107A,A01,083627,Boyle; Mary E. T.,14,0,60,46
1657866153735,COGS 118A,A01,083075,Gupta; Anjum,21,0,76,55
1657866159763,CSE 3,A50,083646,Miranda; Gregory Joseph,24,0,50,26
1657866165792,CSE 8A,A50,083650,Miranda; Gregory Joseph,17,1,56,39
1657866171816,CSE 11,A01,083080,Cao; Yingjun,6,15,40,34
1657866177840,CSE 12,A01,083652,Krause-Levy; Sophia Louisa,30,1,120,90
1657866183867,CSE 15L,A01,083654,Morris; Justin Loren,9,0,50,41
1657866183867,CSE 15L,A02,083655,Morris; Justin Loren,10,0,50,40
1657866189900,CSE 20,A01,083657,Tran; Khoa Dang,39,0,80,41
1657866195924,CSE 21,A01,095574,Bach; Quang Tran,22,0,48,26
1657866201951,CSE 30,A01,083084,Eldon; John,6,0,80,74
1657866201951,CSE 30,B01,095061,Bhaskar; Nishant,9,0,50,41
1657866207974,CSE 100,A01,083659,Cao; Yingjun,5,4,70,65
1657866214000,CSE 134B,A01,083661,Powell; Thomas Allan,24,0,100,76
1657866220024,CSE 140,A01,083663,Gungor; Onat,15,0,85,70
1657866226047,CSE 140L,A01,083088,Eldon; John,23,0,100,77
1657866232071,CSE 175,A01,083665,Kumar; Rakesh,3,0,25,22
1657866238094,CSE 190,A00,092507,Dubnov; Shlomo,8,0,20,12
1657866244122,ECE 45,A01,083139,Congero; Spencer William,6,0,75,69
1657866250150,ECE 65,A50,083695,Saad; Andrew S,12,0,30,18
1657866250150,ECE 65,A51,095125,Saad; Andrew S,24,0,26,2
1657866256174,ECE 109,A01,091882,Touri; Behrouz,20,0,70,50
1657866262201,ECE 180,A00,083140,Abi Samra; Nicholas Camill,1,0,30,29
1657866262201,ECE 180,B00,083141,Abi Samra; Nicholas Camill,0,0,30,30
1657866268231,MATH 10A,A01,083735,Patchell; Gregory David,2,0,30,28
1657866268231,MATH 10A,A02,083736,Patchell; Gregory David,20,0,30,10
1657866268231,MATH 10A,A03,083737,Patchell; Gregory David,16,0,30,14
1657866274260,MATH 10B,A01,083207,Lim; Seonhee,8,0,34,26
1657866274260,MATH 10B,A02,083208,Lim; Seonhee,10,0,35,25
1657866274260,MATH 10B,A03,093472,Lim; Seonhee,7,0,34,27
1657866274260,MATH 10B,B01,083739,Sinha; Shubham,14,0,30,16
1657866280294,MATH 18,A01,083743,Cinel; Cameron Alexander,9,0,30,21
1657866280294,MATH 18,A02,083744,Cinel; Cameron Alexander,18,0,30,12
1657866280294,MATH 18,A03,083745,Cinel; Cameron Alexander,10,0,30,20
1657866280294,MATH 18,B01,083748,Rideout; David Porter,5,0,37,32
1657866280294,MATH 18,B02,083749,Rideout; David Porter,5,0,36,31
1657866280294,MATH 18,B03,083750,Rideout; David Porter,3,0,37,34
1657866280294,MATH 18,B04,083751,Rideout; David Porter,6,0,36,30
1657866280294,MATH 18,B05,093473,Rideout; David Porter,6,0,36,30
1657866280294,MATH 18,B06,093474,Rideout; David Porter,6,0,36,30
1657866286320,MATH 20A,A01,083754,Zheng; Zequn,14,0,40,26
1657866292348,MATH 20B,A01,083756,Briones; Jor-el Thomas Caparas,4,0,36,32
1657866292348,MATH 20B,A02,083757,Briones; Jor-el Thomas Caparas,1,0,36,35
1657866292348,MATH 20B,A03,093475,Briones; Jor-el Thomas Caparas,2,0,36,34
1657866298378,MATH 20C,A01,083760,Briones; Jor-el Thomas Caparas,1,0,35,34
1657866298378,MATH 20C,A02,083761,Briones; Jor-el Thomas Caparas,8,0,35,27
1657866298378,MATH 20C,A03,093476,Briones; Jor-el Thomas Caparas,0,1,36,36
1657866298378,MATH 20C,B01,083762,Bach; Quang Tran,1,0,30,29
1657866304408,MATH 20D,A01,083765,Tran; Brian Kha,5,0,30,25
1657866304408,MATH 20D,A02,083766,Tran; Brian Kha,5,0,30,25
1657866304408,MATH 20D,A03,083767,Tran; Brian Kha,5,0,30,25
1657866310432,MATH 20E,A01,083771,Ganguly; Soumya,10,0,32,22
1657866310432,MATH 20E,A02,083772,Ganguly; Soumya,6,0,32,26
1657866310432,MATH 20E,B01,083773,Ciotti; Benjamin,20,0,35,15
1657866310432,MATH 20E,B02,083774,Ciotti; Benjamin,18,0,35,17
1657866316455,MATH 103A,A01,083777,Greenfeld; Be'Eri,3,0,36,33
1657866316455,MATH 103A,A02,083778,Greenfeld; Be'Eri,5,0,36,31
1657866316455,MATH 103A,A03,093561,Greenfeld; Be'Eri,6,0,36,30
1657866316455,MATH 103A,B01,083779,Greenfeld; Be'Eri,7,0,36,29
1657866316455,MATH 103A,B02,083780,Greenfeld; Be'Eri,4,0,36,32
1657866316455,MATH 103A,B03,093562,Greenfeld; Be'Eri,3,0,36,33
1657866322477,MATH 105,A01,085443,Carter; Anne Toulson,15,0,35,20
1657866322477,MATH 105,A02,093477,Carter; Anne Toulson,20,0,35,15
1657866328506,MATH 109,A01,083213,Ganzberger; Geoffrey Michael,3,0,34,31
1657866328506,MATH 109,A02,083214,Ganzberger; Geoffrey Michael,4,0,34,30
1657866328506,MATH 109,A03,093478,Ganzberger; Geoffrey Michael,2,0,34,32
1657866328506,MATH 109,B01,083215,Ganzberger; Geoffrey Michael,1,0,32,31
1657866328506,MATH 109,B02,083216,Ganzberger; Geoffrey Michael,2,0,32,30
1657866328506,MATH 109,B03,093479,Ganzberger; Geoffrey Michael,8,0,32,24
1657866334541,MATH 142A,A01,083219,Chow; Bennett,7,0,32,25
1657866334541,MATH 142A,A02,083220,Chow; Bennett,10,0,32,22
1657866334541,MATH 142A,A03,093480,Chow; Bennett,9,0,32,23
1657866334541,MATH 142A,B03,093481,Chow; Bennett,8,0,32,24
1657866334541,MATH 142A,B04,093558,Chow; Bennett,13,0,32,19
1657866334541,MATH 142A,B05,093559,Chow; Bennett,7,0,32,25
1657866340570,MATH 193A,A01,083224,Rotar; Vladimir,8,0,34,26
1657866340570,MATH 193A,A02,083225,Rotar; Vladimir,10,0,34,24
1657866340570,MATH 193A,A03,083781,Rotar; Vladimir,5,0,34,29
1657866340570,MATH 193A,A04,083782,Rotar; Vladimir,11,0,34,23
1657866340570,MATH 193A,A05,093482,Rotar; Vladimir,10,0,34,24
1657866346594,MATH 197,001,091859,McAuley; Julian John,9999,0,9999,0
1657866346594,MATH 197,002,095566,Kedlaya; Kiran S.,9997,0,9999,2
1657866346594,MATH 197,003,095567,Xiao; Ming,9999,0,9999,0
1657866346594,MATH 197,004,095571,Perols; Johan Lars,9998,0,9999,1
1657866353657,COGS 9,A01,083615,Shannon; Kyle Michael,10,0,75,65
1657866359685,COGS 11,A01,083617,Boyle; Mary E. T.,23,0,48,25
1657866365708,COGS 13,A01,083071,Bastos; Amalia Pinkusfeld,11,0,71,60
1657866371731,COGS 14A,A01,092681,Semenuks; Arturs,5,1,100,95
1657866377760,COGS 14B,A01,083073,Cheng; Tzu-Han,6,0,63,57
1657866383782,COGS 17,A01,092677,Semenuks; Arturs,6,0,81,75
1657866389806,COGS 100,A01,083619,Allen; Michael Gordon,17,0,70,53
1657866395830,COGS 101A,A01,083621,Davis; Joshua Daniel,9,0,68,59
1657866401862,COGS 101B,A01,091572,Allen; Michael Gordon,12,0,65,53
1657866407900,COGS 101C,A01,083625,Delgado; Tania,17,0,35,18
1657866413924,COGS 107A,A01,083627,Boyle; Mary E. T.,14,0,60,46
1657866419948,COGS 118A,A01,083075,Gupta; Anjum,21,0,76,55
1657866425974,CSE 3,A50,083646,Miranda; Gregory Joseph,24,0,50,26
1657866431999,CSE 8A,A50,083650,Miranda; Gregory Joseph,17,1,56,39
1657866438024,CSE 11,A01,083080,Cao; Yingjun,6,15,40,34
1657866444052,CSE 12,A01,083652,Krause-Levy; Sophia Louisa,30,1,120,90
1657866450079,CSE 15L,A01,083654,Morris; Justin Loren,9,0,50,41
1657866450079,CSE 15L,A02,083655,Morris; Justin Loren,10,0,50,40
1657866456102,CSE 20,A01,083657,Tran; Khoa Dang,39,0,80,41
1657866462125,CSE 21,A01,095574,Bach; Quang Tran,22,0,48,26
1657866468151,CSE 30,A01,083084,Eldon; John,6,0,80,74
1657866468151,CSE 30,B01,095061,Bhaskar; Nishant,9,0,50,41
1657866474175,CSE 100,A01,083659,Cao; Yingjun,5,4,70,65
1657866480206,CSE 134B,A01,083661,Powell; Thomas Allan,24,0,100,76
1657866486232,CSE 140,A01,083663,Gungor; Onat,15,0,85,70
1657866492255,CSE 140L,A01,083088,Eldon; John,23,0,100,77
1657866498282,CSE 175,A01,083665,Kumar; Rakesh,3,0,25,22
1657866504305,CSE 190,A00,092507,Dubnov; Shlomo,8,0,20,12
1657866510330,ECE 45,A01,083139,Congero; Spencer William,6,0,75,69
1657866516356,ECE 65,A50,083695,Saad; Andrew S,12,0,30,18
1657866516356,ECE 65,A51,095125,Saad; Andrew S,24,0,26,2
1657866522380,ECE 109,A01,091882,Touri; Behrouz,20,0,70,50
1657866528407,ECE 180,A00,083140,Abi Samra; Nicholas Camill,1,0,30,29
1657866528407,ECE 180,B00,083141,Abi Samra; Nicholas Camill,0,0,30,30
1657866534435,MATH 10A,A01,083735,Patchell; Gregory David,2,0,30,28
1657866534435,MATH 10A,A02,083736,Patchell; Gregory David,20,0,30,10
1657866534435,MATH 10A,A03,083737,Patchell; Gregory David,16,0,30,14
1657866540460,MATH 10B,A01,083207,Lim; Seonhee,8,0,34,26
1657866540460,MATH 10B,A02,083208,Lim; Seonhee,10,0,35,25
1657866540460,MATH 10B,A03,093472,Lim; Seonhee,7,0,34,27
1657866540460,MATH 10B,B01,083739,Sinha; Shubham,14,0,30,16
1657866546484,MATH 18,A01,083743,Cinel; Cameron Alexander,9,0,30,21
1657866546484,MATH 18,A02,083744,Cinel; Cameron Alexander,18,0,30,12
1657866546484,MATH 18,A03,083745,Cinel; Cameron Alexander,10,0,30,20
1657866546484,MATH 18,B01,083748,Rideout; David Porter,5,0,37,32
1657866546484,MATH 18,B02,083749,Rideout; David Porter,5,0,36,31
1657866546484,MATH 18,B03,083750,Rideout; David Porter,3,0,37,34
1657866546484,MATH 18,B04,083751,Rideout; David Porter,6,0,36,30
1657866546484,MATH 18,B05,093473,Rideout; David Porter,6,0,36,30
1657866546484,MATH 18,B06,093474,Rideout; David Porter,6,0,36,30
1657866552506,MATH 20A,A01,083754,Zheng; Zequn,14,0,40,26
1657866558530,MATH 20B,A01,083756,Briones; Jor-el Thomas Caparas,4,0,36,32
1657866558530,MATH 20B,A02,083757,Briones; Jor-el Thomas Caparas,1,0,36,35
1657866558530,MATH 20B,A03,093475,Briones; Jor-el Thomas Caparas,2,0,36,34
1657866564634,MATH 20C,A01,083760,Briones; Jor-el Thomas Caparas,1,0,35,34
1657866564634,MATH 20C,A02,083761,Briones; Jor-el Thomas Caparas,8,0,35,27
1657866564634,MATH 20C,A03,093476,Briones; Jor-el Thomas Caparas,0,1,36,36
1657866564634,MATH 20C,B01,083762,Bach; Quang Tran,1,0,30,29
1657866570664,MATH 20D,A01,083765,Tran; Brian Kha,5,0,30,25
1657866570664,MATH 20D,A02,083766,Tran; Brian Kha,5,0,30,25
1657866570664,MATH 20D,A03,083767,Tran; Brian Kha,5,0,30,25
1657866576697,MATH 20E,A01,083771,Ganguly; Soumya,10,0,32,22
1657866576697,MATH 20E,A02,083772,Ganguly; Soumya,6,0,32,26
1657866576697,MATH 20E,B01,083773,Ciotti; Benjamin,20,0,35,15
1657866576697,MATH 20E,B02,083774,Ciotti; Benjamin,18,0,35,17
1657866582723,MATH 103A,A01,083777,Greenfeld; Be'Eri,3,0,36,33
1657866582723,MATH 103A,A02,083778,Greenfeld; Be'Eri,5,0,36,31
1657866582723,MATH 103A,A03,093561,Greenfeld; Be'Eri,6,0,36,30
1657866582723,MATH 103A,B01,083779,Greenfeld; Be'Eri,7,0,36,29
1657866582723,MATH 103A,B02,083780,Greenfeld; Be'Eri,4,0,36,32
1657866582723,MATH 103A,B03,093562,Greenfeld; Be'Eri,3,0,36,33
1657866588762,MATH 105,A01,085443,Carter; Anne Toulson,15,0,35,20
1657866588762,MATH 105,A02,093477,Carter; Anne Toulson,20,0,35,15
1657866594791,MATH 109,A01,083213,Ganzberger; Geoffrey Michael,3,0,34,31
1657866594791,MATH 109,A02,083214,Ganzberger; Geoffrey Michael,4,0,34,30
1657866594791,MATH 109,A03,093478,Ganzberger; Geoffrey Michael,2,0,34,32
1657866594791,MATH 109,B01,083215,Ganzberger; Geoffrey Michael,1,0,32,31
1657866594791,MATH 109,B02,083216,Ganzberger; Geoffrey Michael,2,0,32,30
1657866594791,MATH 109,B03,093479,Ganzberger; Geoffrey Michael,8,0,32,24
1657866600819,MATH 142A,A01,083219,Chow; Bennett,7,0,32,25
1657866600819,MATH 142A,A02,083220,Chow; Bennett,10,0,32,22
1657866600819,MATH 142A,A03,093480,Chow; Bennett,9,0,32,23
1657866600819,MATH 142A,B03,093481,Chow; Bennett,8,0,32,24
1657866600819,MATH 142A,B04,093558,Chow; Bennett,13,0,32,19
1657866600819,MATH 142A,B05,093559,Chow; Bennett,7,0,32,25
1657866606842,MATH 193A,A01,083224,Rotar; Vladimir,8,0,34,26
1657866606842,MATH 193A,A02,083225,Rotar; Vladimir,10,0,34,24
1657866606842,MATH 193A,A03,083781,Rotar; Vladimir,5,0,34,29
1657866606842,MATH 193A,A04,083782,Rotar; Vladimir,11,0,34,23
1657866606842,MATH 193A,A05,093482,Rotar; Vladimir,10,0,34,24
1657866612872,MATH 197,001,091859,McAuley; Julian John,9999,0,9999,0
1657866612872,MATH 197,002,095566,Kedlaya; Kiran S.,9997,0,9999,2
1657866612872,MATH 197,003,095567,Xiao; Ming,9999,0,9999,0
1657866612872,MATH 197,004,095571,Perols; Johan Lars,9998,0,9999,1
1657866619934,COGS 9,A01,083615,Shannon; Kyle Michael,10,0,75,65
1657866625960,COGS 11,A01,083617,Boyle; Mary E. T.,23,0,48,25
1657866631983,COGS 13,A01,083071,Bastos; Amalia Pinkusfeld,11,0,71,60
1657866638019,COGS 14A,A01,092681,Semenuks; Arturs,5,1,100,95
1657866644048,COGS 14B,A01,083073,Cheng; Tzu-Han,6,0,63,57
1657866650074,COGS 17,A01,092677,Semenuks; Arturs,6,0,81,75
1657866656098,COGS 100,A01,083619,Allen; Michael Gordon,17,0,70,53
1657866662312,COGS 101A,A01,083621,Davis; Joshua Daniel,9,0,68,59
1657866668337,COGS 101B,A01,091572,Allen; Michael Gordon,12,0,65,53
1657866674363,COGS 101C,A01,083625,Delgado; Tania,17,0,35,18
1657866680387,COGS 107A,A01,083627,Boyle; Mary E. T.,14,0,60,46
1657866686414,COGS 118A,A01,083075,Gupta; Anjum,21,0,76,55
1657866692439,CSE 3,A50,083646,Miranda; Gregory Joseph,24,0,50,26
1657866698478,CSE 8A,A50,083650,Miranda; Gregory Joseph,17,1,56,39
1657866704505,CSE 11,A01,083080,Cao; Yingjun,6,15,40,34
1657866710529,CSE 12,A01,083652,Krause-Levy; Sophia Louisa,30,1,120,90
1657866716553,CSE 15L,A01,083654,Morris; Justin Loren,9,0,50,41
1657866716553,CSE 15L,A02,083655,Morris; Justin Loren,10,0,50,40
1657866722580,CSE 20,A01,083657,Tran; Khoa Dang,39,0,80,41
1657866728606,CSE 21,A01,095574,Bach; Quang Tran,22,0,48,26
1657866734660,CSE 30,A01,083084,Eldon; John,6,0,80,74
1657866734660,CSE 30,B01,095061,Bhaskar; Nishant,9,0,50,41
1657866740688,CSE 100,A01,083659,Cao; Yingjun,5,4,70,65
1657866746714,CSE 134B,A01,083661,Powell; Thomas Allan,24,0,100,76
1657866752744,CSE 140,A01,083663,Gungor; Onat,15,0,85,70
1657866758767,CSE 140L,A01,083088,Eldon; John,23,0,100,77
1657866764801,CSE 175,A01,083665,Kumar; Rakesh,3,0,25,22
1657866770828,CSE 190,A00,092507,Dubnov; Shlomo,8,0,20,12
1657866776857,ECE 45,A01,083139,Congero; Spencer William,6,0,75,69
1657866782887,ECE 65,A50,083695,Saad; Andrew S,12,0,30,18
1657866782887,ECE 65,A51,095125,Saad; Andrew S,24,0,26,2
1657866788909,ECE 109,A01,091882,Touri; Behrouz,20,0,70,50
1657866794931,ECE 180,A00,083140,Abi Samra; Nicholas Camill,1,0,30,29
1657866794931,ECE 180,B00,083141,Abi Samra; Nicholas Camill,0,0,30,30
1657866800957,MATH 10A,A01,083735,Patchell; Gregory David,2,0,30,28
1657866800957,MATH 10A,A02,083736,Patchell; Gregory David,20,0,30,10
1657866800957,MATH 10A,A03,083737,Patchell; Gregory David,16,0,30,14
1657866806997,MATH 10B,A01,083207,Lim; Seonhee,8,0,34,26
1657866806997,MATH 10B,A02,083208,Lim; Seonhee,10,0,35,25
1657866806997,MATH 10B,A03,093472,Lim; Seonhee,7,0,34,27
1657866806997,MATH 10B,B01,083739,Sinha; Shubham,14,0,30,16
1657866813029,MATH 18,A01,083743,Cinel; Cameron Alexander,9,0,30,21
1657866813029,MATH 18,A02,083744,Cinel; Cameron Alexander,18,0,30,12
1657866813029,MATH 18,A03,083745,Cinel; Cameron Alexander,10,0,30,20
1657866813029,MATH 18,B01,083748,Rideout; David Porter,5,0,37,32
1657866813029,MATH 18,B02,083749,Rideout; David Porter,5,0,36,31
1657866813029,MATH 18,B03,083750,Rideout; David Porter,3,0,37,34
1657866813029,MATH 18,B04,083751,Rideout; David Porter,6,0,36,30
1657866813029,MATH 18,B05,093473,Rideout; David Porter,6,0,36,30
1657866813029,MATH 18,B06,093474,Rideout; David Porter,6,0,36,30
1657866819054,MATH 20A,A01,083754,Zheng; Zequn,14,0,40,26
1657866825081,MATH 20B,A01,083756,Briones; Jor-el Thomas Caparas,4,0,36,32
1657866825081,MATH 20B,A02,083757,Briones; Jor-el Thomas Caparas,1,0,36,35
1657866825081,MATH 20B,A03,093475,Briones; Jor-el Thomas Caparas,2,0,36,34
1657866831108,MATH 20C,A01,083760,Briones; Jor-el Thomas Caparas,1,0,35,34
1657866831108,MATH 20C,A02,083761,Briones; Jor-el Thomas Caparas,8,0,35,27
1657866831108,MATH 20C,A03,093476,Briones; Jor-el Thomas Caparas,0,1,36,36
1657866831108,MATH 20C,B01,083762,Bach; Quang Tran,1,0,30,29
1657866837131,MATH 20D,A01,083765,Tran; Brian Kha,5,0,30,25
1657866837131,MATH 20D,A02,083766,Tran; Brian Kha,5,0,30,25
1657866837131,MATH 20D,A03,083767,Tran; Brian Kha,5,0,30,25
1657866843161,MATH 20E,A01,083771,Ganguly; Soumya,10,0,32,22
1657866843161,MATH 20E,A02,083772,Ganguly; Soumya,6,0,32,26
1657866843161,MATH 20E,B01,083773,Ciotti; Benjamin,20,0,35,15
1657866843161,MATH 20E,B02,083774,Ciotti; Benjamin,18,0,35,17
1657866849185,MATH 103A,A01,083777,Greenfeld; Be'Eri,3,0,36,33
1657866849185,MATH 103A,A02,083778,Greenfeld; Be'Eri,5,0,36,31
1657866849185,MATH 103A,A03,093561,Greenfeld; Be'Eri,6,0,36,30
1657866849185,MATH 103A,B01,083779,Greenfeld; Be'Eri,7,0,36,29
1657866849185,MATH 103A,B02,083780,Greenfeld; Be'Eri,4,0,36,32
1657866849185,MATH 103A,B03,093562,Greenfeld; Be'Eri,3,0,36,33
1657866855209,MATH 105,A01,085443,Carter; Anne Toulson,15,0,35,20
1657866855209,MATH 105,A02,093477,Carter; Anne Toulson,20,0,35,15
1657866861241,MATH 109,A01,083213,Ganzberger; Geoffrey Michael,3,0,34,31
1657866861241,MATH 109,A02,083214,Ganzberger; Geoffrey Michael,4,0,34,30
1657866861241,MATH 109,A03,093478,Ganzberger; Geoffrey Michael,2,0,34,32
1657866861241,MATH 109,B01,083215,Ganzberger; Geoffrey Michael,1,0,32,31
1657866861241,MATH 109,B02,083216,Ganzberger; Geoffrey Michael,2,0,32,30
1657866861241,MATH 109,B03,093479,Ganzberger; Geoffrey Michael,8,0,32,24
1657866867271,MATH 142A,A01,083219,Chow; Bennett,7,0,32,25
1657866867271,MATH 142A,A02,083220,Chow; Bennett,10,0,32,22
1657866867271,MATH 142A,A03,093480,Chow; Bennett,9,0,32,23
1657866867271,MATH 142A,B03,093481,Chow; Bennett,8,0,32,24
1657866867271,MATH 142A,B04,093558,Chow; Bennett,13,0,32,19
1657866867271,MATH 142A,B05,093559,Chow; Bennett,7,0,32,25
1657866873297,MATH 193A,A01,083224,Rotar; Vladimir,8,0,34,26
1657866873297,MATH 193A,A02,083225,Rotar; Vladimir,10,0,34,24
1657866873297,MATH 193A,A03,083781,Rotar; Vladimir,5,0,34,29
1657866873297,MATH 193A,A04,083782,Rotar; Vladimir,11,0,34,23
1657866873297,MATH 193A,A05,093482,Rotar; Vladimir,10,0,34,24
1657866879320,MATH 197,001,091859,McAuley; Julian John,9999,0,9999,0
1657866879320,MATH 197,002,095566,Kedlaya; Kiran S.,9997,0,9999,2
1657866879320,MATH 197,003,095567,Xiao; Ming,9999,0,9999,0
1657866879320,MATH 197,004,095571,Perols; Johan Lars,9998,0,9999,1
1657866886374,COGS 9,A01,083615,Shannon; Kyle Michael,10,0,75,65
1657866892398,COGS 11,A01,083617,Boyle; Mary E. T.,23,0,48,25
1657866898421,COGS 13,A01,083071,Bastos; Amalia Pinkusfeld,11,0,71,60
1657866904444,COGS 14A,A01,092681,Semenuks; Arturs,5,1,100,95
1657866910472,COGS 14B,A01,083073,Cheng; Tzu-Han,6,0,63,57
1657866916499,COGS 17,A01,092677,Semenuks; Arturs,6,0,81,75
1657866922526,COGS 100,A01,083619,Allen; Michael Gordon,17,0,70,53
1657866928553,COGS 101A,A01,083621,Davis; Joshua Daniel,9,0,68,59
1657866934575,COGS 101B,A01,091572,Allen; Michael Gordon,12,0,65,53
1657866940598,COGS 101C,A01,083625,Delgado; Tania,17,0,35,18
1657866946624,COGS 107A,A01,083627,Boyle; Mary E. T.,14,0,60,46
1657866952651,COGS 118A,A01,083075,Gupta; Anjum,21,0,76,55
1657866958677,CSE 3,A50,083646,Miranda; Gregory Joseph,24,0,50,26
1657866964703,CSE 8A,A50,083650,Miranda; Gregory Joseph,17,1,56,39
1657866970727,CSE 11,A01,083080,Cao; Yingjun,6,15,40,34
1657866976749,CSE 12,A01,083652,Krause-Levy; Sophia Louisa,30,1,120,90
1657866982772,CSE 15L,A01,083654,Morris; Justin Loren,9,0,50,41
1657866982772,CSE 15L,A02,083655,Morris; Justin Loren,10,0,50,40
1657866988795,CSE 20,A01,083657,Tran; Khoa Dang,39,0,80,41
1657866994821,CSE 21,A01,095574,Bach; Quang Tran,22,0,48,26
1657867000849,CSE 30,A01,083084,Eldon; John,6,0,80,74
1657867000849,CSE 30,B01,095061,Bhaskar; Nishant,9,0,50,41
1657867006873,CSE 100,A01,083659,Cao; Yingjun,5,4,70,65
1657867012902,CSE 134B,A01,083661,Powell; Thomas Allan,24,0,100,76
1657867018926,CSE 140,A01,083663,Gungor; Onat,15,0,85,70
1657867024953,CSE 140L,A01,083088,Eldon; John,23,0,100,77
1657867030981,CSE 175,A01,083665,Kumar; Rakesh,3,0,25,22
1657867037004,CSE 190,A00,092507,Dubnov; Shlomo,8,0,20,12
1657867043033,ECE 45,A01,083139,Congero; Spencer William,6,0,75,69
1657867049060,ECE 65,A50,083695,Saad; Andrew S,12,0,30,18
1657867049060,ECE 65,A51,095125,Saad; Andrew S,24,0,26,2
1657867055084,ECE 109,A01,091882,Touri; Behrouz,20,0,70,50
1657867061106,ECE 180,A00,083140,Abi Samra; Nicholas Camill,1,0,30,29
1657867061106,ECE 180,B00,083141,Abi Samra; Nicholas Camill,0,0,30,30
1657867067128,MATH 10A,A01,083735,Patchell; Gregory David,2,0,30,28
1657867067128,MATH 10A,A02,083736,Patchell; Gregory David,20,0,30,10
1657867067128,MATH 10A,A03,083737,Patchell; Gregory David,16,0,30,14
1657867073173,MATH 10B,A01,083207,Lim; Seonhee,8,0,34,26
1657867073173,MATH 10B,A02,083208,Lim; Seonhee,10,0,35,25
1657867073173,MATH 10B,A03,093472,Lim; Seonhee,7,0,34,27
1657867073173,MATH 10B,B01,083739,Sinha; Shubham,14,0,30,16
1657867079204,MATH 18,A01,083743,Cinel; Cameron Alexander,9,0,30,21
1657867079204,MATH 18,A02,083744,Cinel; Cameron Alexander,18,0,30,12
1657867079204,MATH 18,A03,083745,Cinel; Cameron Alexander,10,0,30,20
1657867079204,MATH 18,B01,083748,Rideout; David Porter,5,0,37,32
1657867079204,MATH 18,B02,083749,Rideout; David Porter,5,0,36,31
1657867079204,MATH 18,B03,083750,Rideout; David Porter,3,0,37,34
1657867079204,MATH 18,B04,083751,Rideout; David Porter,6,0,36,30
1657867079204,MATH 18,B05,093473,Rideout; David Porter,6,0,36,30
1657867079204,MATH 18,B06,093474,Rideout; David Porter,6,0,36,30
1657867085227,MATH 20A,A01,083754,Zheng; Zequn,14,0,40,26
1657867091253,MATH 20B,A01,083756,Briones; Jor-el Thomas Caparas,4,0,36,32
1657867091253,MATH 20B,A02,083757,Briones; Jor-el Thomas Caparas,1,0,36,35
1657867091253,MATH 20B,A03,093475,Briones; Jor-el Thomas Caparas,2,0,36,34
1657867097281,MATH 20C,A01,083760,Briones; Jor-el Thomas Caparas,1,0,35,34
1657867097281,MATH 20C,A02,083761,Briones; Jor-el Thomas Caparas,8,0,35,27
1657867097281,MATH 20C,A03,093476,Briones; Jor-el Thomas Caparas,0,1,36,36
1657867097281,MATH 20C,B01,083762,Bach; Quang Tran,1,0,30,29
1657867103304,MATH 20D,A01,083765,Tran; Brian Kha,5,0,30,25
1657867103304,MATH 20D,A02,083766,Tran; Brian Kha,5,0,30,25
1657867103304,MATH 20D,A03,083767,Tran; Brian Kha,5,0,30,25
1657867109332,MATH 20E,A01,083771,Ganguly; Soumya,10,0,32,22
1657867109332,MATH 20E,A02,083772,Ganguly; Soumya,6,0,32,26
1657867109332,MATH 20E,B01,083773,Ciotti; Benjamin,20,0,35,15
1657867109332,MATH 20E,B02,083774,Ciotti; Benjamin,18,0,35,17
1657867115363,MATH 103A,A01,083777,Greenfeld; Be'Eri,3,0,36,33
1657867115363,MATH 103A,A02,083778,Greenfeld; Be'Eri,5,0,36,31
1657867115363,MATH 103A,A03,093561,Greenfeld; Be'Eri,6,0,36,30
1657867115363,MATH 103A,B01,083779,Greenfeld; Be'Eri,7,0,36,29
1657867115363,MATH 103A,B02,083780,Greenfeld; Be'Eri,4,0,36,32
1657867115363,MATH 103A,B03,093562,Greenfeld; Be'Eri,3,0,36,33
1657867121392,MATH 105,A01,085443,Carter; Anne Toulson,15,0,35,20
1657867121392,MATH 105,A02,093477,Carter; Anne Toulson,20,0,35,15
1657867127416,MATH 109,A01,083213,Ganzberger; Geoffrey Michael,3,0,34,31
1657867127416,MATH 109,A02,083214,Ganzberger; Geoffrey Michael,4,0,34,30
1657867127416,MATH 109,A03,093478,Ganzberger; Geoffrey Michael,2,0,34,32
1657867127416,MATH 109,B01,083215,Ganzberger; Geoffrey Michael,1,0,32,31
1657867127416,MATH 109,B02,083216,Ganzberger; Geoffrey Michael,2,0,32,30
1657867127416,MATH 109,B03,093479,Ganzberger; Geoffrey Michael,8,0,32,24
1657867133450,MATH 142A,A01,083219,Chow; Bennett,7,0,32,25
1657867133450,MATH 142A,A02,083220,Chow; Bennett,10,0,32,22
1657867133450,MATH 142A,A03,093480,Chow; Bennett,9,0,32,23
1657867133450,MATH 142A,B03,093481,Chow; Bennett,8,0,32,24
1657867133450,MATH 142A,B04,093558,Chow; Bennett,13,0,32,19
1657867133450,MATH 142A,B05,093559,Chow; Bennett,7,0,32,25
1657867139475,MATH 193A,A01,083224,Rotar; Vladimir,8,0,34,26
1657867139475,MATH 193A,A02,083225,Rotar; Vladimir,10,0,34,24
1657867139475,MATH 193A,A03,083781,Rotar; Vladimir,5,0,34,29
1657867139475,MATH 193A,A04,083782,Rotar; Vladimir,11,0,34,23
1657867139475,MATH 193A,A05,093482,Rotar; Vladimir,10,0,34,24
1657867145500,MATH 197,001,091859,McAuley; Julian John,9999,0,9999,0
1657867145500,MATH 197,002,095566,Kedlaya; Kiran S.,9997,0,9999,2
1657867145500,MATH 197,003,095567,Xiao; Ming,9999,0,9999,0
1657867145500,MATH 197,004,095571,Perols; Johan Lars,9998,0,9999,1
1657867152564,COGS 9,A01,083615,Shannon; Kyle Michael,10,0,75,65
1657867158671,COGS 11,A01,083617,Boyle; Mary E. T.,23,0,48,25
1657867164695,COGS 13,A01,083071,Bastos; Amalia Pinkusfeld,11,0,71,60
1657867170718,COGS 14A,A01,092681,Semenuks; Arturs,5,1,100,95
1657867176745,COGS 14B,A01,083073,Cheng; Tzu-Han,6,0,63,57
1657867182772,COGS 17,A01,092677,Semenuks; Arturs,6,0,81,75
1657867188799,COGS 100,A01,083619,Allen; Michael Gordon,17,0,70,53
1657867194826,COGS 101A,A01,083621,Davis; Joshua Daniel,9,0,68,59
1657867200852,COGS 101B,A01,091572,Allen; Michael Gordon,12,0,65,53
1657867206874,COGS 101C,A01,083625,Delgado; Tania,17,0,35,18
1657867212898,COGS 107A,A01,083627,Boyle; Mary E. T.,14,0,60,46
1657867218921,COGS 118A,A01,083075,Gupta; Anjum,21,0,76,55
1657867224945,CSE 3,A50,083646,Miranda; Gregory Joseph,24,0,50,26
1657867230975,CSE 8A,A50,083650,Miranda; Gregory Joseph,17,1,56,39
1657867236998,CSE 11,A01,083080,Cao; Yingjun,6,15,40,34
1657867243020,CSE 12,A01,083652,Krause-Levy; Sophia Louisa,30,1,120,90
1657867249043,CSE 15L,A01,083654,Morris; Justin Loren,9,0,50,41
1657867249043,CSE 15L,A02,083655,Morris; Justin Loren,10,0,50,40
1657867255079,CSE 20,A01,083657,Tran; Khoa Dang,39,0,80,41
1657867261109,CSE 21,A01,095574,Bach; Quang Tran,22,0,48,26
1657867267131,CSE 30,A01,083084,Eldon; John,6,0,80,74
1657867267131,CSE 30,B01,095061,Bhaskar; Nishant,9,0,50,41
1657867273153,CSE 100,A01,083659,Cao; Yingjun,5,4,70,65
1657867279179,CSE 134B,A01,083661,Powell; Thomas Allan,24,0,100,76
1657867285205,CSE 140,A01,083663,Gungor; Onat,15,0,85,70
1657867291232,CSE 140L,A01,083088,Eldon; John,23,0,100,77
1657867297277,CSE 175,A01,083665,Kumar; Rakesh,3,0,25,22
1657867303300,CSE 190,A00,092507,Dubnov; Shlomo,8,0,20,12
1657867309324,ECE 45,A01,083139,Congero; Spencer William,6,0,75,69
1657867315352,ECE 65,A50,083695,Saad; Andrew S,12,0,30,18
1657867315352,ECE 65,A51,095125,Saad; Andrew S,24,0,26,2
1657867321379,ECE 109,A01,091882,Touri; Behrouz,20,0,70,50
1657867327405,ECE 180,A00,083140,Abi Samra; Nicholas Camill,1,0,30,29
1657867327405,ECE 180,B00,083141,Abi Samra; Nicholas Camill,0,0,30,30
1657867333430,MATH 10A,A01,083735,Patchell; Gregory David,2,0,30,28
1657867333430,MATH 10A,A02,083736,Patchell; Gregory David,20,0,30,10
1657867333430,MATH 10A,A03,083737,Patchell; Gregory David,16,0,30,14
1657867339456,MATH 10B,A01,083207,Lim; Seonhee,8,0,34,26
1657867339456,MATH 10B,A02,083208,Lim; Seonhee,10,0,35,25
1657867339456,MATH 10B,A03,093472,Lim; Seonhee,7,0,34,27
1657867339456,MATH 10B,B01,083739,Sinha; Shubham,14,0,30,16
1657867345488,MATH 18,A01,083743,Cinel; Cameron Alexander,9,0,30,21
1657867345488,MATH 18,A02,083744,Cinel; Cameron Alexander,18,0,30,12
1657867345488,MATH 18,A03,083745,Cinel; Cameron Alexander,10,0,30,20
1657867345488,MATH 18,B01,083748,Rideout; David Porter,5,0,37,32
1657867345488,MATH 18,B02,083749,Rideout; David Porter,5,0,36,31
1657867345488,MATH 18,B03,083750,Rideout; David Porter,3,0,37,34
1657867345488,MATH 18,B04,083751,Rideout; David Porter,6,0,36,30
1657867345488,MATH 18,B05,093473,Rideout; David Porter,6,0,36,30
1657867345488,MATH 18,B06,093474,Rideout; David Porter,6,0,36,30
1657867351516,MATH 20A,A01,083754,Zheng; Zequn,14,0,40,26
1657867357544,MATH 20B,A01,083756,Briones; Jor-el Thomas Caparas,4,0,36,32
1657867357544,MATH 20B,A02,083757,Briones; Jor-el Thomas Caparas,1,0,36,35
1657867357544,MATH 20B,A03,093475,Briones; Jor-el Thomas Caparas,2,0,36,34
1657867363573,MATH 20C,A01,083760,Briones; Jor-el Thomas Caparas,1,0,35,34
1657867363573,MATH 20C,A02,083761,Briones; Jor-el Thomas Caparas,8,0,35,27
1657867363573,MATH 20C,A03,093476,Briones; Jor-el Thomas Caparas,0,1,36,36
1657867363573,MATH 20C,B01,083762,Bach; Quang Tran,1,0,30,29
1657867369595,MATH 20D,A01,083765,Tran; Brian Kha,5,0,30,25
1657867369595,MATH 20D,A02,083766,Tran; Brian Kha,5,0,30,25
1657867369595,MATH 20D,A03,083767,Tran; Brian Kha,5,0,30,25
1657867375621,MATH 20E,A01,083771,Ganguly; Soumya,10,0,32,22
1657867375621,MATH 20E,A02,083772,Ganguly; Soumya,6,0,32,26
1657867375621,MATH 20E,B01,083773,Ciotti; Benjamin,20,0,35,15
1657867375621,MATH 20E,B02,083774,Ciotti; Benjamin,18,0,35,17
1657867381646,MATH 103A,A01,083777,Greenfeld; Be'Eri,3,0,36,33
1657867381646,MATH 103A,A02,083778,Greenfeld; Be'Eri,5,0,36,31
1657867381646,MATH 103A,A03,093561,Greenfeld; Be'Eri,6,0,36,30
1657867381646,MATH 103A,B01,083779,Greenfeld; Be'Eri,7,0,36,29
1657867381646,MATH 103A,B02,083780,Greenfeld; Be'Eri,4,0,36,32
1657867381646,MATH 103A,B03,093562,Greenfeld; Be'Eri,3,0,36,33
1657867387668,MATH 105,A01,085443,Carter; Anne Toulson,15,0,35,20
1657867387668,MATH 105,A02,093477,Carter; Anne Toulson,20,0,35,15
1657867393694,MATH 109,A01,083213,Ganzberger; Geoffrey Michael,3,0,34,31
1657867393694,MATH 109,A02,083214,Ganzberger; Geoffrey Michael,4,0,34,30
1657867393694,MATH 109,A03,093478,Ganzberger; Geoffrey Michael,2,0,34,32
1657867393694,MATH 109,B01,083215,Ganzberger; Geoffrey Michael,1,0,32,31
1657867393694,MATH 109,B02,083216,Ganzberger; Geoffrey Michael,2,0,32,30
1657867393694,MATH 109,B03,093479,Ganzberger; Geoffrey Michael,8,0,32,24
1657867399716,MATH 142A,A01,083219,Chow; Bennett,7,0,32,25
1657867399716,MATH 142A,A02,083220,Chow; Bennett,10,0,32,22
1657867399716,MATH 142A,A03,093480,Chow; Bennett,9,0,32,23
1657867399716,MATH 142A,B03,093481,Chow; Bennett,8,0,32,24
1657867399716,MATH 142A,B04,093558,Chow; Bennett,13,0,32,19
1657867399716,MATH 142A,B05,093559,Chow; Bennett,7,0,32,25
1657867405746,MATH 193A,A01,083224,Rotar; Vladimir,8,0,34,26
1657867405746,MATH 193A,A02,083225,Rotar; Vladimir,10,0,34,24
1657867405746,MATH 193A,A03,083781,Rotar; Vladimir,5,0,34,29
1657867405746,MATH 193A,A04,083782,Rotar; Vladimir,11,0,34,23
1657867405746,MATH 193A,A05,093482,Rotar; Vladimir,10,0,34,24
1657867411772,MATH 197,001,091859,McAuley; Julian John,9999,0,9999,0
1657867411772,MATH 197,002,095566,Kedlaya; Kiran S.,9997,0,9999,2
1657867411772,MATH 197,003,095567,Xiao; Ming,9999,0,9999,0
1657867411772,MATH 197,004,095571,Perols; Johan Lars,9998,0,9999,1
1657867418840,COGS 9,A01,083615,Shannon; Kyle Michael,10,0,75,65
1657867424867,COGS 11,A01,083617,Boyle; Mary E. T.,23,0,48,25
1657867430890,COGS 13,A01,083071,Bastos; Amalia Pinkusfeld,11,0,71,60
1657867436914,COGS 14A,A01,092681,Semenuks; Arturs,5,1,100,95
1657867442938,COGS 14B,A01,083073,Cheng; Tzu-Han,6,0,63,57
1657867448962,COGS 17,A01,092677,Semenuks; Arturs,6,0,81,75
1657867454986,COGS 100,A01,083619,Allen; Michael Gordon,17,0,70,53
1657867461014,COGS 101A,A01,083621,Davis; Joshua Daniel,9,0,68,59
1657867467036,COGS 101B,A01,091572,Allen; Michael Gordon,12,0,65,53
1657867473061,COGS 101C,A01,083625,Delgado; Tania,17,0,35,18
1657867479089,COGS 107A,A01,083627,Boyle; Mary E. T.,14,0,60,46
1657867485111,COGS 118A,A01,083075,Gupta; Anjum,21,0,76,55
1657867491134,CSE 3,A50,083646,Miranda; Gregory Joseph,24,0,50,26
1657867497157,CSE 8A,A50,083650,Miranda; Gregory Joseph,17,1,56,39
1657867503180,CSE 11,A01,083080,Cao; Yingjun,6,15,40,34
1657867509203,CSE 12,A01,083652,Krause-Levy; Sophia Louisa,30,1,120,90
1657867515230,CSE 15L,A01,083654,Morris; Justin Loren,9,0,50,41
1657867515230,CSE 15L,A02,083655,Morris; Justin Loren,10,0,50,40
1657867521257,CSE 20,A01,083657,Tran; Khoa Dang,39,0,80,41
1657867527283,CSE 21,A01,095574,Bach; Quang Tran,22,0,48,26
1657867533311,CSE 30,A01,083084,Eldon; John,6,0,80,74
1657867533311,CSE 30,B01,095061,Bhaskar; Nishant,9,0,50,41
1657867539333,CSE 100,A01,083659,Cao; Yingjun,5,4,70,65
1657867545361,CSE 134B,A01,083661,Powell; Thomas Allan,24,0,100,76
1657867551387,CSE 140,A01,083663,Gungor; Onat,15,0,85,70
1657867557417,CSE 140L,A01,083088,Eldon; John,23,0,100,77
1657867563440,CSE 175,A01,083665,Kumar; Rakesh,3,0,25,22
1657867569467,CSE 190,A00,092507,Dubnov; Shlomo,8,0,20,12
1657867575490,ECE 45,A01,083139,Congero; Spencer William,6,0,75,69
1657867581515,ECE 65,A50,083695,Saad; Andrew S,12,0,30,18
1657867581515,ECE 65,A51,095125,Saad; Andrew S,24,0,26,2
1657867587542,ECE 109,A01,091882,Touri; Behrouz,20,0,70,50
1657867593567,ECE 180,A00,083140,Abi Samra; Nicholas Camill,1,0,30,29
1657867593567,ECE 180,B00,083141,Abi Samra; Nicholas Camill,0,0,30,30
1657867599594,MATH 10A,A01,083735,Patchell; Gregory David,2,0,30,28
1657867599594,MATH 10A,A02,083736,Patchell; Gregory David,20,0,30,10
1657867599594,MATH 10A,A03,083737,Patchell; Gregory David,16,0,30,14
1657867605616,MATH 10B,A01,083207,Lim; Seonhee,8,0,34,26
1657867605616,MATH 10B,A02,083208,Lim; Seonhee,10,0,35,25
1657867605616,MATH 10B,A03,093472,Lim; Seonhee,7,0,34,27
1657867605616,MATH 10B,B01,083739,Sinha; Shubham,14,0,30,16
1657867611640,MATH 18,A01,083743,Cinel; Cameron Alexander,9,0,30,21
1657867611640,MATH 18,A02,083744,Cinel; Cameron Alexander,18,0,30,12
1657867611640,MATH 18,A03,083745,Cinel; Cameron Alexander,10,0,30,20
1657867611640,MATH 18,B01,083748,Rideout; David Porter,5,0,37,32
1657867611640,MATH 18,B02,083749,Rideout; David Porter,5,0,36,31
1657867611640,MATH 18,B03,083750,Rideout; David Porter,3,0,37,34
1657867611640,MATH 18,B04,083751,Rideout; David Porter,6,0,36,30
1657867611640,MATH 18,B05,093473,Rideout; David Porter,6,0,36,30
1657867611640,MATH 18,B06,093474,Rideout; David Porter,6,0,36,30
1657867617678,MATH 20A,A01,083754,Zheng; Zequn,14,0,40,26
1657867623703,MATH 20B,A01,083756,Briones; Jor-el Thomas Caparas,4,0,36,32
1657867623703,MATH 20B,A02,083757,Briones; Jor-el Thomas Caparas,1,0,36,35
1657867623703,MATH 20B,A03,093475,Briones; Jor-el Thomas Caparas,2,0,36,34
1657867629728,MATH 20C,A01,083760,Briones; Jor-el Thomas Caparas,1,0,35,34
1657867629728,MATH 20C,A02,083761,Briones; Jor-el Thomas Caparas,8,0,35,27
1657867629728,MATH 20C,A03,093476,Briones; Jor-el Thomas Caparas,0,1,36,36
1657867629728,MATH 20C,B01,083762,Bach; Quang Tran,1,0,30,29
1657867635752,MATH 20D,A01,083765,Tran; Brian Kha,5,0,30,25
1657867635752,MATH 20D,A02,083766,Tran; Brian Kha,5,0,30,25
1657867635752,MATH 20D,A03,083767,Tran; Brian Kha,5,0,30,25
1657867641780,MATH 20E,A01,083771,Ganguly; Soumya,10,0,32,22
1657867641780,MATH 20E,A02,083772,Ganguly; Soumya,6,0,32,26
1657867641780,MATH 20E,B01,083773,Ciotti; Benjamin,20,0,35,15
1657867641780,MATH 20E,B02,083774,Ciotti; Benjamin,18,0,35,17
1657867647810,MATH 103A,A01,083777,Greenfeld; Be'Eri,3,0,36,33
1657867647810,MATH 103A,A02,083778,Greenfeld; Be'Eri,5,0,36,31
1657867647810,MATH 103A,A03,093561,Greenfeld; Be'Eri,6,0,36,30
1657867647810,MATH 103A,B01,083779,Greenfeld; Be'Eri,7,0,36,29
1657867647810,MATH 103A,B02,083780,Greenfeld; Be'Eri,4,0,36,32
1657867647810,MATH 103A,B03,093562,Greenfeld; Be'Eri,3,0,36,33
1657867653834,MATH 105,A01,085443,Carter; Anne Toulson,15,0,35,20
1657867653834,MATH 105,A02,093477,Carter; Anne Toulson,20,0,35,15
1657867659858,MATH 109,A01,083213,Ganzberger; Geoffrey Michael,3,0,34,31
1657867659858,MATH 109,A02,083214,Ganzberger; Geoffrey Michael,4,0,34,30
1657867659858,MATH 109,A03,093478,Ganzberger; Geoffrey Michael,2,0,34,32
1657867659858,MATH 109,B01,083215,Ganzberger; Geoffrey Michael,1,0,32,31
1657867659858,MATH 109,B02,083216,Ganzberger; Geoffrey Michael,2,0,32,30
1657867659858,MATH 109,B03,093479,Ganzberger; Geoffrey Michael,8,0,32,24
1657867665881,MATH 142A,A01,083219,Chow; Bennett,7,0,32,25
1657867665881,MATH 142A,A02,083220,Chow; Bennett,10,0,32,22
1657867665881,MATH 142A,A03,093480,Chow; Bennett,9,0,32,23
1657867665881,MATH 142A,B03,093481,Chow; Bennett,8,0,32,24
1657867665881,MATH 142A,B04,093558,Chow; Bennett,13,0,32,19
1657867665881,MATH 142A,B05,093559,Chow; Bennett,7,0,32,25
1657867671914,MATH 193A,A01,083224,Rotar; Vladimir,8,0,34,26
1657867671914,MATH 193A,A02,083225,Rotar; Vladimir,10,0,34,24
1657867671914,MATH 193A,A03,083781,Rotar; Vladimir,5,0,34,29
1657867671914,MATH 193A,A04,083782,Rotar; Vladimir,11,0,34,23
1657867671914,MATH 193A,A05,093482,Rotar; Vladimir,10,0,34,24
1657867677939,MATH 197,001,091859,McAuley; Julian John,9999,0,9999,0
1657867677939,MATH 197,002,095566,Kedlaya; Kiran S.,9997,0,9999,2
1657867677939,MATH 197,003,095567,Xiao; Ming,9999,0,9999,0
1657867677939,MATH 197,004,095571,Perols; Johan Lars,9998,0,9999,1
1657867684991,COGS 9,A01,083615,Shannon; Kyle Michael,10,0,75,65
1657867691017,COGS 11,A01,083617,Boyle; Mary E. T.,23,0,48,25
1657867697046,COGS 13,A01,083071,Bastos; Amalia Pinkusfeld,11,0,71,60
1657867703073,COGS 14A,A01,092681,Semenuks; Arturs,5,1,100,95
1657867709099,COGS 14B,A01,083073,Cheng; Tzu-Han,6,0,63,57
1657867715125,COGS 17,A01,092677,Semenuks; Arturs,6,0,81,75
1657867721151,COGS 100,A01,083619,Allen; Michael Gordon,17,0,70,53
1657867727176,COGS 101A,A01,083621,Davis; Joshua Daniel,9,0,68,59
1657867733199,COGS 101B,A01,091572,Allen; Michael Gordon,12,0,65,53
1657867739224,COGS 101C,A01,083625,Delgado; Tania,17,0,35,18
1657867745252,COGS 107A,A01,083627,Boyle; Mary E. T.,14,0,60,46
1657867751280,COGS 118A,A01,083075,Gupta; Anjum,21,0,76,55
1657867757376,CSE 3,A50,083646,Miranda; Gregory Joseph,24,0,50,26
1657867763404,CSE 8A,A50,083650,Miranda; Gregory Joseph,17,1,56,39
1657867769428,CSE 11,A01,083080,Cao; Yingjun,6,15,40,34
1657867775453,CSE 12,A01,083652,Krause-Levy; Sophia Louisa,30,1,120,90
1657867781480,CSE 15L,A01,083654,Morris; Justin Loren,9,0,50,41
1657867781480,CSE 15L,A02,083655,Morris; Justin Loren,10,0,50,40
1657867787508,CSE 20,A01,083657,Tran; Khoa Dang,39,0,80,41
1657867793531,CSE 21,A01,095574,Bach; Quang Tran,22,0,48,26
1657867799554,CSE 30,A01,083084,Eldon; John,6,0,80,74
1657867799554,CSE 30,B01,095061,Bhaskar; Nishant,9,0,50,41
1657867805577,CSE 100,A01,083659,Cao; Yingjun,5,4,70,65
1657867811601,CSE 134B,A01,083661,Powell; Thomas Allan,24,0,100,76
1657867817629,CSE 140,A01,083663,Gungor; Onat,15,0,85,70
1657867823653,CSE 140L,A01,083088,Eldon; John,23,0,100,77
1657867829681,CSE 175,A01,083665,Kumar; Rakesh,3,0,25,22
1657867835703,CSE 190,A00,092507,Dubnov; Shlomo,8,0,20,12
1657867841725,ECE 45,A01,083139,Congero; Spencer William,6,0,75,69
1657867847749,ECE 65,A50,083695,Saad; Andrew S,12,0,30,18
1657867847749,ECE 65,A51,095125,Saad; Andrew S,24,0,26,2
1657867853773,ECE 109,A01,091882,Touri; Behrouz,20,0,70,50
1657867859799,ECE 180,A00,083140,Abi Samra; Nicholas Camill,1,0,30,29
1657867859799,ECE 180,B00,083141,Abi Samra; Nicholas Camill,0,0,30,30
1657867865830,MATH 10A,A01,083735,Patchell; Gregory David,2,0,30,28
1657867865830,MATH 10A,A02,083736,Patchell; Gregory David,20,0,30,10
1657867865830,MATH 10A,A03,083737,Patchell; Gregory David,16,0,30,14
1657867871854,MATH 10B,A01,083207,Lim; Seonhee,8,0,34,26
1657867871854,MATH 10B,A02,083208,Lim; Seonhee,10,0,35,25
1657867871854,MATH 10B,A03,093472,Lim; Seonhee,7,0,34,27
1657867871854,MATH 10B,B01,083739,Sinha; Shubham,14,0,30,16
1657867877885,MATH 18,A01,083743,Cinel; Cameron Alexander,9,0,30,21
1657867877885,MATH 18,A02,083744,Cinel; Cameron Alexander,18,0,30,12
1657867877885,MATH 18,A03,083745,Cinel; Cameron Alexander,10,0,30,20
1657867877885,MATH 18,B01,083748,Rideout; David Porter,5,0,37,32
1657867877885,MATH 18,B02,083749,Rideout; David Porter,5,0,36,31
1657867877885,MATH 18,B03,083750,Rideout; David Porter,3,0,37,34
1657867877885,MATH 18,B04,083751,Rideout; David Porter,6,0,36,30
1657867877885,MATH 18,B05,093473,Rideout; David Porter,6,0,36,30
1657867877885,MATH 18,B06,093474,Rideout; David Porter,6,0,36,30
1657867883908,MATH 20A,A01,083754,Zheng; Zequn,14,0,40,26
1657867889932,MATH 20B,A01,083756,Briones; Jor-el Thomas Caparas,4,0,36,32
1657867889932,MATH 20B,A02,083757,Briones; Jor-el Thomas Caparas,1,0,36,35
1657867889932,MATH 20B,A03,093475,Briones; Jor-el Thomas Caparas,2,0,36,34
1657867895954,MATH 20C,A01,083760,Briones; Jor-el Thomas Caparas,1,0,35,34
1657867895954,MATH 20C,A02,083761,Briones; Jor-el Thomas Caparas,8,0,35,27
1657867895954,MATH 20C,A03,093476,Briones; Jor-el Thomas Caparas,0,1,36,36
1657867895954,MATH 20C,B01,083762,Bach; Quang Tran,1,0,30,29
1657867901976,MATH 20D,A01,083765,Tran; Brian Kha,5,0,30,25
1657867901976,MATH 20D,A02,083766,Tran; Brian Kha,5,0,30,25
1657867901976,MATH 20D,A03,083767,Tran; Brian Kha,5,0,30,25
1657867908004,MATH 20E,A01,083771,Ganguly; Soumya,10,0,32,22
1657867908004,MATH 20E,A02,083772,Ganguly; Soumya,6,0,32,26
1657867908004,MATH 20E,B01,083773,Ciotti; Benjamin,20,0,35,15
1657867908004,MATH 20E,B02,083774,Ciotti; Benjamin,18,0,35,17
1657867914034,MATH 103A,A01,083777,Greenfeld; Be'Eri,3,0,36,33
1657867914034,MATH 103A,A02,083778,Greenfeld; Be'Eri,5,0,36,31
1657867914034,MATH 103A,A03,093561,Greenfeld; Be'Eri,6,0,36,30
1657867914034,MATH 103A,B01,083779,Greenfeld; Be'Eri,7,0,36,29
1657867914034,MATH 103A,B02,083780,Greenfeld; Be'Eri,4,0,36,32
1657867914034,MATH 103A,B03,093562,Greenfeld; Be'Eri,3,0,36,33
1657867920058,MATH 105,A01,085443,Carter; Anne Toulson,15,0,35,20
1657867920058,MATH 105,A02,093477,Carter; Anne Toulson,20,0,35,15
1657867926089,MATH 109,A01,083213,Ganzberger; Geoffrey Michael,3,0,34,31
1657867926089,MATH 109,A02,083214,Ganzberger; Geoffrey Michael,4,0,34,30
1657867926089,MATH 109,A03,093478,Ganzberger; Geoffrey Michael,2,0,34,32
1657867926089,MATH 109,B01,083215,Ganzberger; Geoffrey Michael,1,0,32,31
1657867926089,MATH 109,B02,083216,Ganzberger; Geoffrey Michael,2,0,32,30
1657867926089,MATH 109,B03,093479,Ganzberger; Geoffrey Michael,8,0,32,24
1657867932112,MATH 142A,A01,083219,Chow; Bennett,7,0,32,25
1657867932112,MATH 142A,A02,083220,Chow; Bennett,10,0,32,22
1657867932112,MATH 142A,A03,093480,Chow; Bennett,9,0,32,23
1657867932112,MATH 142A,B03,093481,Chow; Bennett,8,0,32,24
1657867932112,MATH 142A,B04,093558,Chow; Bennett,13,0,32,19
1657867932112,MATH 142A,B05,093559,Chow; Bennett,7,0,32,25
1657867938140,MATH 193A,A01,083224,Rotar; Vladimir,8,0,34,26
1657867938140,MATH 193A,A02,083225,Rotar; Vladimir,10,0,34,24
1657867938140,MATH 193A,A03,083781,Rotar; Vladimir,5,0,34,29
1657867938140,MATH 193A,A04,083782,Rotar; Vladimir,11,0,34,23
1657867938140,MATH 193A,A05,093482,Rotar; Vladimir,10,0,34,24
1657867944161,MATH 197,001,091859,McAuley; Julian John,9999,0,9999,0
1657867944161,MATH 197,002,095566,Kedlaya; Kiran S.,9997,0,9999,2
1657867944161,MATH 197,003,095567,Xiao; Ming,9999,0,9999,0
1657867944161,MATH 197,004,095571,Perols; Johan Lars,9998,0,9999,1
1657867951234,COGS 9,A01,083615,Shannon; Kyle Michael,10,0,75,65
1657867957261,COGS 11,A01,083617,Boyle; Mary E. T.,23,0,48,25
1657867963289,COGS 13,A01,083071,Bastos; Amalia Pinkusfeld,11,0,71,60
1657867969311,COGS 14A,A01,092681,Semenuks; Arturs,5,1,100,95
1657867975340,COGS 14B,A01,083073,Cheng; Tzu-Han,6,0,63,57
1657867981363,COGS 17,A01,092677,Semenuks; Arturs,6,0,81,75
1657867987391,COGS 100,A01,083619,Allen; Michael Gordon,17,0,70,53
1657867993418,COGS 101A,A01,083621,Davis; Joshua Daniel,9,0,68,59
1657867999445,COGS 101B,A01,091572,Allen; Michael Gordon,12,0,65,53
1657868005472,COGS 101C,A01,083625,Delgado; Tania,17,0,35,18
1657868011494,COGS 107A,A01,083627,Boyle; Mary E. T.,14,0,60,46
1657868017516,COGS 118A,A01,083075,Gupta; Anjum,21,0,76,55
1657868023543,CSE 3,A50,083646,Miranda; Gregory Joseph,24,0,50,26
1657868029576,CSE 8A,A50,083650,Miranda; Gregory Joseph,17,1,56,39
1657868035602,CSE 11,A01,083080,Cao; Yingjun,6,15,40,34
1657868041624,CSE 12,A01,083652,Krause-Levy; Sophia Louisa,30,1,120,90
1657868047646,CSE 15L,A01,083654,Morris; Justin Loren,9,0,50,41
1657868047646,CSE 15L,A02,083655,Morris; Justin Loren,10,0,50,40
1657868053669,CSE 20,A01,083657,Tran; Khoa Dang,39,0,80,41
1657868059697,CSE 21,A01,095574,Bach; Quang Tran,22,0,48,26
1657868065728,CSE 30,A01,083084,Eldon; John,6,0,80,74
1657868065728,CSE 30,B01,095061,Bhaskar; Nishant,9,0,50,41
1657868071751,CSE 100,A01,083659,Cao; Yingjun,5,4,70,65
1657868077772,CSE 134B,A01,083661,Powell; Thomas Allan,24,0,100,76
1657868083798,CSE 140,A01,083663,Gungor; Onat,15,0,85,70
1657868089824,CSE 140L,A01,083088,Eldon; John,23,0,100,77
1657868095849,CSE 175,A01,083665,Kumar; Rakesh,3,0,25,22
1657868101870,CSE 190,A00,092507,Dubnov; Shlomo,8,0,20,12
1657868107903,ECE 45,A01,083139,Congero; Spencer William,6,0,75,69
1657868113926,ECE 65,A50,083695,Saad; Andrew S,12,0,30,18
1657868113926,ECE 65,A51,095125,Saad; Andrew S,24,0,26,2
1657868119958,ECE 109,A01,091882,Touri; Behrouz,20,0,70,50
1657868125986,ECE 180,A00,083140,Abi Samra; Nicholas Camill,1,0,30,29
1657868125986,ECE 180,B00,083141,Abi Samra; Nicholas Camill,0,0,30,30
1657868132017,MATH 10A,A01,083735,Patchell; Gregory David,2,0,30,28
1657868132017,MATH 10A,A02,083736,Patchell; Gregory David,20,0,30,10
1657868132017,MATH 10A,A03,083737,Patchell; Gregory David,16,0,30,14
1657868138046,MATH 10B,A01,083207,Lim; Seonhee,8,0,34,26
1657868138046,MATH 10B,A02,083208,Lim; Seonhee,10,0,35,25
1657868138046,MATH 10B,A03,093472,Lim; Seonhee,7,0,34,27
1657868138046,MATH 10B,B01,083739,Sinha; Shubham,14,0,30,16
1657868144071,MATH 18,A01,083743,Cinel; Cameron Alexander,9,0,30,21
1657868144071,MATH 18,A02,083744,Cinel; Cameron Alexander,18,0,30,12
1657868144071,MATH 18,A03,083745,Cinel; Cameron Alexander,10,0,30,20
1657868144071,MATH 18,B01,083748,Rideout; David Porter,5,0,37,32
1657868144071,MATH 18,B02,083749,Rideout; David Porter,5,0,36,31
1657868144071,MATH 18,B03,083750,Rideout; David Porter,3,0,37,34
1657868144071,MATH 18,B04,083751,Rideout; David Porter,6,0,36,30
1657868144071,MATH 18,B05,093473,Rideout; David Porter,6,0,36,30
1657868144071,MATH 18,B06,093474,Rideout; David Porter,6,0,36,30
1657868150093,MATH 20A,A01,083754,Zheng; Zequn,14,0,40,26
1657868156118,MATH 20B,A01,083756,Briones; Jor-el Thomas Caparas,4,0,36,32
1657868156118,MATH 20B,A02,083757,Briones; Jor-el Thomas Caparas,1,0,36,35
1657868156118,MATH 20B,A03,093475,Briones; Jor-el Thomas Caparas,2,0,36,34
1657868162164,MATH 20C,A01,083760,Briones; Jor-el Thomas Caparas,1,0,35,34
1657868162164,MATH 20C,A02,083761,Briones; Jor-el Thomas Caparas,8,0,35,27
1657868162164,MATH 20C,A03,093476,Briones; Jor-el Thomas Caparas,0,1,36,36
1657868162164,MATH 20C,B01,083762,Bach; Quang Tran,1,0,30,29
1657868168189,MATH 20D,A01,083765,Tran; Brian Kha,5,0,30,25
1657868168189,MATH 20D,A02,083766,Tran; Brian Kha,5,0,30,25
1657868168189,MATH 20D,A03,083767,Tran; Brian Kha,5,0,30,25
1657868174217,MATH 20E,A01,083771,Ganguly; Soumya,10,0,32,22
1657868174217,MATH 20E,A02,083772,Ganguly; Soumya,6,0,32,26
1657868174217,MATH 20E,B01,083773,Ciotti; Benjamin,20,0,35,15
1657868174217,MATH 20E,B02,083774,Ciotti; Benjamin,18,0,35,17
1657868180247,MATH 103A,A01,083777,Greenfeld; Be'Eri,3,0,36,33
1657868180247,MATH 103A,A02,083778,Greenfeld; Be'Eri,5,0,36,31
1657868180247,MATH 103A,A03,093561,Greenfeld; Be'Eri,6,0,36,30
1657868180247,MATH 103A,B01,083779,Greenfeld; Be'Eri,7,0,36,29
1657868180247,MATH 103A,B02,083780,Greenfeld; Be'Eri,4,0,36,32
1657868180247,MATH 103A,B03,093562,Greenfeld; Be'Eri,3,0,36,33
1657868186271,MATH 105,A01,085443,Carter; Anne Toulson,15,0,35,20
1657868186271,MATH 105,A02,093477,Carter; Anne Toulson,20,0,35,15
1657868192308,MATH 109,A01,083213,Ganzberger; Geoffrey Michael,3,0,34,31
1657868192308,MATH 109,A02,083214,Ganzberger; Geoffrey Michael,4,0,34,30
1657868192308,MATH 109,A03,093478,Ganzberger; Geoffrey Michael,2,0,34,32
1657868192308,MATH 109,B01,083215,Ganzberger; Geoffrey Michael,1,0,32,31
1657868192308,MATH 109,B02,083216,Ganzberger; Geoffrey Michael,2,0,32,30
1657868192308,MATH 109,B03,093479,Ganzberger; Geoffrey Michael,8,0,32,24
1657868198331,MATH 142A,A01,083219,Chow; Bennett,7,0,32,25
1657868198331,MATH 142A,A02,083220,Chow; Bennett,10,0,32,22
1657868198331,MATH 142A,A03,093480,Chow; Bennett,9,0,32,23
1657868198331,MATH 142A,B03,093481,Chow; Bennett,8,0,32,24
1657868198331,MATH 142A,B04,093558,Chow; Bennett,13,0,32,19
1657868198331,MATH 142A,B05,093559,Chow; Bennett,7,0,32,25
1657868204360,MATH 193A,A01,083224,Rotar; Vladimir,8,0,34,26
1657868204360,MATH 193A,A02,083225,Rotar; Vladimir,10,0,34,24
1657868204360,MATH 193A,A03,083781,Rotar; Vladimir,5,0,34,29
1657868204360,MATH 193A,A04,083782,Rotar; Vladimir,11,0,34,23
1657868204360,MATH 193A,A05,093482,Rotar; Vladimir,10,0,34,24
1657868210387,MATH 197,001,091859,McAuley; Julian John,9999,0,9999,0
1657868210387,MATH 197,002,095566,Kedlaya; Kiran S.,9997,0,9999,2
1657868210387,MATH 197,003,095567,Xiao; Ming,9999,0,9999,0
1657868210387,MATH 197,004,095571,Perols; Johan Lars,9998,0,9999,1
1657868217449,COGS 9,A01,083615,Shannon; Kyle Michael,10,0,75,65
1657868223471,COGS 11,A01,083617,Boyle; Mary E. T.,23,0,48,25
1657868229494,COGS 13,A01,083071,Bastos; Amalia Pinkusfeld,11,0,71,60
1657868235518,COGS 14A,A01,092681,Semenuks; Arturs,5,1,100,95
1657868241545,COGS 14B,A01,083073,Cheng; Tzu-Han,6,0,63,57
1657868247569,COGS 17,A01,092677,Semenuks; Arturs,6,0,81,75
1657868253598,COGS 100,A01,083619,Allen; Michael Gordon,17,0,70,53
1657868259624,COGS 101A,A01,083621,Davis; Joshua Daniel,9,0,68,59
1657868265652,COGS 101B,A01,091572,Allen; Michael Gordon,12,0,65,53
1657868271675,COGS 101C,A01,083625,Delgado; Tania,17,0,35,18
1657868277696,COGS 107A,A01,083627,Boyle; Mary E. T.,14,0,60,46
1657868283721,COGS 118A,A01,083075,Gupta; Anjum,21,0,76,55
1657868289744,CSE 3,A50,083646,Miranda; Gregory Joseph,24,0,50,26
1657868295768,CSE 8A,A50,083650,Miranda; Gregory Joseph,17,1,56,39
1657868301792,CSE 11,A01,083080,Cao; Yingjun,6,15,40,34
1657868307820,CSE 12,A01,083652,Krause-Levy; Sophia Louisa,30,1,120,90
1657868313843,CSE 15L,A01,083654,Morris; Justin Loren,9,0,50,41
1657868313843,CSE 15L,A02,083655,Morris; Justin Loren,10,0,50,40
1657868319868,CSE 20,A01,083657,Tran; Khoa Dang,39,0,80,41
1657868325896,CSE 21,A01,095574,Bach; Quang Tran,22,0,48,26
1657868331923,CSE 30,A01,083084,Eldon; John,6,0,80,74
1657868331923,CSE 30,B01,095061,Bhaskar; Nishant,9,0,50,41
1657868337946,CSE 100,A01,083659,Cao; Yingjun,5,4,70,65
1657868343978,CSE 134B,A01,083661,Powell; Thomas Allan,24,0,100,76
1657868350001,CSE 140,A01,083663,Gungor; Onat,15,0,85,70
1657868356115,CSE 140L,A01,083088,Eldon; John,23,0,100,77
1657868362138,CSE 175,A01,083665,Kumar; Rakesh,3,0,25,22
1657868368162,CSE 190,A00,092507,Dubnov; Shlomo,8,0,20,12
1657868374184,ECE 45,A01,083139,Congero; Spencer William,6,0,75,69
1657868380207,ECE 65,A50,083695,Saad; Andrew S,12,0,30,18
1657868380207,ECE 65,A51,095125,Saad; Andrew S,24,0,26,2
1657868386236,ECE 109,A01,091882,Touri; Behrouz,20,0,70,50
1657868392262,ECE 180,A00,083140,Abi Samra; Nicholas Camill,1,0,30,29
1657868392262,ECE 180,B00,083141,Abi Samra; Nicholas Camill,0,0,30,30
1657868398287,MATH 10A,A01,083735,Patchell; Gregory David,2,0,30,28
1657868398287,MATH 10A,A02,083736,Patchell; Gregory David,20,0,30,10
1657868398287,MATH 10A,A03,083737,Patchell; Gregory David,16,0,30,14
1657868404309,MATH 10B,A01,083207,Lim; Seonhee,8,0,34,26
1657868404309,MATH 10B,A02,083208,Lim; Seonhee,10,0,35,25
1657868404309,MATH 10B,A03,093472,Lim; Seonhee,7,0,34,27
1657868404309,MATH 10B,B01,083739,Sinha; Shubham,14,0,30,16
1657868410333,MATH 18,A01,083743,Cinel; Cameron Alexander,9,0,30,21
1657868410333,MATH 18,A02,083744,Cinel; Cameron Alexander,18,0,30,12
1657868410333,MATH 18,A03,083745,Cinel; Cameron Alexander,10,0,30,20
1657868410333,MATH 18,B01,083748,Rideout; David Porter,5,0,37,32
1657868410333,MATH 18,B02,083749,Rideout; David Porter,5,0,36,31
1657868410333,MATH 18,B03,083750,Rideout; David Porter,3,0,37,34
1657868410333,MATH 18,B04,083751,Rideout; David Porter,6,0,36,30
1657868410333,MATH 18,B05,093473,Rideout; David Porter,6,0,36,30
1657868410333,MATH 18,B06,093474,Rideout; David Porter,6,0,36,30
1657868416360,MATH 20A,A01,083754,Zheng; Zequn,14,0,40,26
1657868422388,MATH 20B,A01,083756,Briones; Jor-el Thomas Caparas,4,0,36,32
1657868422388,MATH 20B,A02,083757,Briones; Jor-el Thomas Caparas,1,0,36,35
1657868422388,MATH 20B,A03,093475,Briones; Jor-el Thomas Caparas,2,0,36,34
1657868428411,MATH 20C,A01,083760,Briones; Jor-el Thomas Caparas,1,0,35,34
1657868428411,MATH 20C,A02,083761,Briones; Jor-el Thomas Caparas,8,0,35,27
1657868428411,MATH 20C,A03,093476,Briones; Jor-el Thomas Caparas,0,1,36,36
1657868428411,MATH 20C,B01,083762,Bach; Quang Tran,1,0,30,29
1657868434434,MATH 20D,A01,083765,Tran; Brian Kha,5,0,30,25
1657868434434,MATH 20D,A02,083766,Tran; Brian Kha,5,0,30,25
1657868434434,MATH 20D,A03,083767,Tran; Brian Kha,5,0,30,25
1657868440463,MATH 20E,A01,083771,Ganguly; Soumya,10,0,32,22
1657868440463,MATH 20E,A02,083772,Ganguly; Soumya,6,0,32,26
1657868440463,MATH 20E,B01,083773,Ciotti; Benjamin,20,0,35,15
1657868440463,MATH 20E,B02,083774,Ciotti; Benjamin,18,0,35,17
1657868446493,MATH 103A,A01,083777,Greenfeld; Be'Eri,3,0,36,33
1657868446493,MATH 103A,A02,083778,Greenfeld; Be'Eri,5,0,36,31
1657868446493,MATH 103A,A03,093561,Greenfeld; Be'Eri,6,0,36,30
1657868446493,MATH 103A,B01,083779,Greenfeld; Be'Eri,7,0,36,29
1657868446493,MATH 103A,B02,083780,Greenfeld; Be'Eri,4,0,36,32
1657868446493,MATH 103A,B03,093562,Greenfeld; Be'Eri,3,0,36,33
1657868452521,MATH 105,A01,085443,Carter; Anne Toulson,15,0,35,20
1657868452521,MATH 105,A02,093477,Carter; Anne Toulson,20,0,35,15
1657868458547,MATH 109,A01,083213,Ganzberger; Geoffrey Michael,3,0,34,31
1657868458547,MATH 109,A02,083214,Ganzberger; Geoffrey Michael,4,0,34,30
1657868458547,MATH 109,A03,093478,Ganzberger; Geoffrey Michael,2,0,34,32
1657868458547,MATH 109,B01,083215,Ganzberger; Geoffrey Michael,1,0,32,31
1657868458547,MATH 109,B02,083216,Ganzberger; Geoffrey Michael,2,0,32,30
1657868458547,MATH 109,B03,093479,Ganzberger; Geoffrey Michael,8,0,32,24
1657868464579,MATH 142A,A01,083219,Chow; Bennett,7,0,32,25
1657868464579,MATH 142A,A02,083220,Chow; Bennett,10,0,32,22
1657868464579,MATH 142A,A03,093480,Chow; Bennett,9,0,32,23
1657868464579,MATH 142A,B03,093481,Chow; Bennett,8,0,32,24
1657868464579,MATH 142A,B04,093558,Chow; Bennett,13,0,32,19
1657868464579,MATH 142A,B05,093559,Chow; Bennett,7,0,32,25
1657868470610,MATH 193A,A01,083224,Rotar; Vladimir,8,0,34,26
1657868470610,MATH 193A,A02,083225,Rotar; Vladimir,10,0,34,24
1657868470610,MATH 193A,A03,083781,Rotar; Vladimir,5,0,34,29
1657868470610,MATH 193A,A04,083782,Rotar; Vladimir,11,0,34,23
1657868470610,MATH 193A,A05,093482,Rotar; Vladimir,10,0,34,24
1657868476638,MATH 197,001,091859,McAuley; Julian John,9999,0,9999,0
1657868476638,MATH 197,002,095566,Kedlaya; Kiran S.,9997,0,9999,2
1657868476638,MATH 197,003,095567,Xiao; Ming,9999,0,9999,0
1657868476638,MATH 197,004,095571,Perols; Johan Lars,9998,0,9999,1
1657868483701,COGS 9,A01,083615,Shannon; Kyle Michael,10,0,75,65
1657868489730,COGS 11,A01,083617,Boyle; Mary E. T.,23,0,48,25
1657868495756,COGS 13,A01,083071,Bastos; Amalia Pinkusfeld,11,0,71,60
1657868501809,COGS 14A,A01,092681,Semenuks; Arturs,5,1,100,95
1657868507837,COGS 14B,A01,083073,Cheng; Tzu-Han,6,0,63,57
1657868513870,COGS 17,A01,092677,Semenuks; Arturs,6,0,81,75
1657868519895,COGS 100,A01,083619,Allen; Michael Gordon,17,0,70,53
1657868525925,COGS 101A,A01,083621,Davis; Joshua Daniel,9,0,68,59
1657868531954,COGS 101B,A01,091572,Allen; Michael Gordon,12,0,65,53
1657868537978,COGS 101C,A01,083625,Delgado; Tania,17,0,35,18
1657868544002,COGS 107A,A01,083627,Boyle; Mary E. T.,14,0,60,46
1657868550026,COGS 118A,A01,083075,Gupta; Anjum,21,0,76,55
1657868556058,CSE 3,A50,083646,Miranda; Gregory Joseph,24,0,50,26
1657868562087,CSE 8A,A50,083650,Miranda; Gregory Joseph,17,1,56,39
1657868568128,CSE 11,A01,083080,Cao; Yingjun,6,15,40,34
1657868574153,CSE 12,A01,083652,Krause-Levy; Sophia Louisa,30,1,120,90
1657868580178,CSE 15L,A01,083654,Morris; Justin Loren,9,0,50,41
1657868580178,CSE 15L,A02,083655,Morris; Justin Loren,10,0,50,40
1657868586203,CSE 20,A01,083657,Tran; Khoa Dang,39,0,80,41
1657868592234,CSE 21,A01,095574,Bach; Quang Tran,22,0,48,26
1657868598270,CSE 30,A01,083084,Eldon; John,6,0,80,74
1657868598270,CSE 30,B01,095061,Bhaskar; Nishant,9,0,50,41
1657868604295,CSE 100,A01,083659,Cao; Yingjun,5,4,70,65
1657868610325,CSE 134B,A01,083661,Powell; Thomas Allan,24,0,100,76
1657868616354,CSE 140,A01,083663,Gungor; Onat,15,0,85,70
1657868622378,CSE 140L,A01,083088,Eldon; John,23,0,100,77
1657868628402,CSE 175,A01,083665,Kumar; Rakesh,3,0,25,22
1657868634435,CSE 190,A00,092507,Dubnov; Shlomo,8,0,20,12
1657868640460,ECE 45,A01,083139,Congero; Spencer William,6,0,75,69
1657868646489,ECE 65,A50,083695,Saad; Andrew S,12,0,30,18
1657868646489,ECE 65,A51,095125,Saad; Andrew S,24,0,26,2
1657868652514,ECE 109,A01,091882,Touri; Behrouz,20,0,70,50
1657868658546,ECE 180,A00,083140,Abi Samra; Nicholas Camill,1,0,30,29
1657868658546,ECE 180,B00,083141,Abi Samra; Nicholas Camill,0,0,30,30
1657868664575,MATH 10A,A01,083735,Patchell; Gregory David,2,0,30,28
1657868664575,MATH 10A,A02,083736,Patchell; Gregory David,20,0,30,10
1657868664575,MATH 10A,A03,083737,Patchell; Gregory David,16,0,30,14
1657868670599,MATH 10B,A01,083207,Lim; Seonhee,8,0,34,26
1657868670599,MATH 10B,A02,083208,Lim; Seonhee,10,0,35,25
1657868670599,MATH 10B,A03,093472,Lim; Seonhee,7,0,34,27
1657868670599,MATH 10B,B01,083739,Sinha; Shubham,14,0,30,16
1657868676624,MATH 18,A01,083743,Cinel; Cameron Alexander,9,0,30,21
1657868676624,MATH 18,A02,083744,Cinel; Cameron Alexander,18,0,30,12
1657868676624,MATH 18,A03,083745,Cinel; Cameron Alexander,10,0,30,20
1657868676624,MATH 18,B01,083748,Rideout; David Porter,5,0,37,32
1657868676624,MATH 18,B02,083749,Rideout; David Porter,5,0,36,31
1657868676624,MATH 18,B03,083750,Rideout; David Porter,3,0,37,34
1657868676624,MATH 18,B04,083751,Rideout; David Porter,6,0,36,30
1657868676624,MATH 18,B05,093473,Rideout; David Porter,6,0,36,30
1657868676624,MATH 18,B06,093474,Rideout; David Porter,6,0,36,30
1657868682652,MATH 20A,A01,083754,Zheng; Zequn,14,0,40,26
1657868688675,MATH 20B,A01,083756,Briones; Jor-el Thomas Caparas,4,0,36,32
1657868688675,MATH 20B,A02,083757,Briones; Jor-el Thomas Caparas,1,0,36,35
1657868688675,MATH 20B,A03,093475,Briones; Jor-el Thomas Caparas,2,0,36,34
1657868694699,MATH 20C,A01,083760,Briones; Jor-el Thomas Caparas,1,0,35,34
1657868694699,MATH 20C,A02,083761,Briones; Jor-el Thomas Caparas,8,0,35,27
1657868694699,MATH 20C,A03,093476,Briones; Jor-el Thomas Caparas,0,1,36,36
1657868694699,MATH 20C,B01,083762,Bach; Quang Tran,1,0,30,29
1657868700723,MATH 20D,A01,083765,Tran; Brian Kha,5,0,30,25
1657868700723,MATH 20D,A02,083766,Tran; Brian Kha,5,0,30,25
1657868700723,MATH 20D,A03,083767,Tran; Brian Kha,5,0,30,25
1657868706752,MATH 20E,A01,083771,Ganguly; Soumya,10,0,32,22
1657868706752,MATH 20E,A02,083772,Ganguly; Soumya,6,0,32,26
1657868706752,MATH 20E,B01,083773,Ciotti; Benjamin,20,0,35,15
1657868706752,MATH 20E,B02,083774,Ciotti; Benjamin,18,0,35,17
1657868712777,MATH 103A,A01,083777,Greenfeld; Be'Eri,3,0,36,33
1657868712777,MATH 103A,A02,083778,Greenfeld; Be'Eri,5,0,36,31
1657868712777,MATH 103A,A03,093561,Greenfeld; Be'Eri,6,0,36,30
1657868712777,MATH 103A,B01,083779,Greenfeld; Be'Eri,7,0,36,29
1657868712777,MATH 103A,B02,083780,Greenfeld; Be'Eri,4,0,36,32
1657868712777,MATH 103A,B03,093562,Greenfeld; Be'Eri,3,0,36,33
1657868718805,MATH 105,A01,085443,Carter; Anne Toulson,15,0,35,20
1657868718805,MATH 105,A02,093477,Carter; Anne Toulson,20,0,35,15
1657868724834,MATH 109,A01,083213,Ganzberger; Geoffrey Michael,3,0,34,31
1657868724834,MATH 109,A02,083214,Ganzberger; Geoffrey Michael,4,0,34,30
1657868724834,MATH 109,A03,093478,Ganzberger; Geoffrey Michael,2,0,34,32
1657868724834,MATH 109,B01,083215,Ganzberger; Geoffrey Michael,1,0,32,31
1657868724834,MATH 109,B02,083216,Ganzberger; Geoffrey Michael,2,0,32,30
1657868724834,MATH 109,B03,093479,Ganzberger; Geoffrey Michael,8,0,32,24
1657868730863,MATH 142A,A01,083219,Chow; Bennett,7,0,32,25
1657868730863,MATH 142A,A02,083220,Chow; Bennett,10,0,32,22
1657868730863,MATH 142A,A03,093480,Chow; Bennett,9,0,32,23
1657868730863,MATH 142A,B03,093481,Chow; Bennett,8,0,32,24
1657868730863,MATH 142A,B04,093558,Chow; Bennett,13,0,32,19
1657868730863,MATH 142A,B05,093559,Chow; Bennett,7,0,32,25
1657868736894,MATH 193A,A01,083224,Rotar; Vladimir,8,0,34,26
1657868736894,MATH 193A,A02,083225,Rotar; Vladimir,10,0,34,24
1657868736894,MATH 193A,A03,083781,Rotar; Vladimir,5,0,34,29
1657868736894,MATH 193A,A04,083782,Rotar; Vladimir,11,0,34,23
1657868736894,MATH 193A,A05,093482,Rotar; Vladimir,10,0,34,24
1657868742918,MATH 197,001,091859,McAuley; Julian John,9999,0,9999,0
1657868742918,MATH 197,002,095566,Kedlaya; Kiran S.,9997,0,9999,2
1657868742918,MATH 197,003,095567,Xiao; Ming,9999,0,9999,0
1657868742918,MATH 197,004,095571,Perols; Johan Lars,9998,0,9999,1
1657868749977,COGS 9,A01,083615,Shannon; Kyle Michael,10,0,75,65
1657868756000,COGS 11,A01,083617,Boyle; Mary E. T.,23,0,48,25
1657868762037,COGS 13,A01,083071,Bastos; Amalia Pinkusfeld,11,0,71,60
1657868768059,COGS 14A,A01,092681,Semenuks; Arturs,5,1,100,95
1657868774090,COGS 14B,A01,083073,Cheng; Tzu-Han,6,0,63,57
1657868780115,COGS 17,A01,092677,Semenuks; Arturs,6,0,81,75
1657868786139,COGS 100,A01,083619,Allen; Michael Gordon,17,0,70,53
1657868792165,COGS 101A,A01,083621,Davis; Joshua Daniel,9,0,68,59
1657868798194,COGS 101B,A01,091572,Allen; Michael Gordon,12,0,65,53
1657868804217,COGS 101C,A01,083625,Delgado; Tania,17,0,35,18
1657868810261,COGS 107A,A01,083627,Boyle; Mary E. T.,14,0,60,46
1657868816290,COGS 118A,A01,083075,Gupta; Anjum,21,0,76,55
1657868822316,CSE 3,A50,083646,Miranda; Gregory Joseph,24,0,50,26
1657868828341,CSE 8A,A50,083650,Miranda; Gregory Joseph,17,1,56,39
1657868834369,CSE 11,A01,083080,Cao; Yingjun,6,15,40,34
1657868840392,CSE 12,A01,083652,Krause-Levy; Sophia Louisa,30,1,120,90
1657868846422,CSE 15L,A01,083654,Morris; Justin Loren,9,0,50,41
1657868846422,CSE 15L,A02,083655,Morris; Justin Loren,10,0,50,40
1657868852446,CSE 20,A01,083657,Tran; Khoa Dang,39,0,80,41
1657868858470,CSE 21,A01,095574,Bach; Quang Tran,22,0,48,26
1657868864495,CSE 30,A01,083084,Eldon; John,6,0,80,74
1657868864495,CSE 30,B01,095061,Bhaskar; Nishant,9,0,50,41
1657868870518,CSE 100,A01,083659,Cao; Yingjun,5,4,70,65
1657868876543,CSE 134B,A01,083661,Powell; Thomas Allan,24,0,100,76
1657868882567,CSE 140,A01,083663,Gungor; Onat,15,0,85,70
1657868888596,CSE 140L,A01,083088,Eldon; John,23,0,100,77
1657868894625,CSE 175,A01,083665,Kumar; Rakesh,3,0,25,22
1657868900649,CSE 190,A00,092507,Dubnov; Shlomo,8,0,20,12
1657868906675,ECE 45,A01,083139,Congero; Spencer William,6,0,75,69
1657868912722,ECE 65,A50,083695,Saad; Andrew S,12,0,30,18
1657868912722,ECE 65,A51,095125,Saad; Andrew S,24,0,26,2
1657868918748,ECE 109,A01,091882,Touri; Behrouz,20,0,70,50
1657868924777,ECE 180,A00,083140,Abi Samra; Nicholas Camill,1,0,30,29
1657868924777,ECE 180,B00,083141,Abi Samra; Nicholas Camill,0,0,30,30
1657868930820,MATH 10A,A01,083735,Patchell; Gregory David,2,0,30,28
1657868930820,MATH 10A,A02,083736,Patchell; Gregory David,20,0,30,10
1657868930820,MATH 10A,A03,083737,Patchell; Gregory David,16,0,30,14
1657868936852,MATH 10B,A01,083207,Lim; Seonhee,8,0,34,26
1657868936852,MATH 10B,A02,083208,Lim; Seonhee,10,0,35,25
1657868936852,MATH 10B,A03,093472,Lim; Seonhee,7,0,34,27
1657868936852,MATH 10B,B01,083739,Sinha; Shubham,14,0,30,16
1657868942878,MATH 18,A01,083743,Cinel; Cameron Alexander,9,0,30,21
1657868942878,MATH 18,A02,083744,Cinel; Cameron Alexander,18,0,30,12
1657868942878,MATH 18,A03,083745,Cinel; Cameron Alexander,10,0,30,20
1657868942878,MATH 18,B01,083748,Rideout; David Porter,5,0,37,32
1657868942878,MATH 18,B02,083749,Rideout; David Porter,5,0,36,31
1657868942878,MATH 18,B03,083750,Rideout; David Porter,3,0,37,34
1657868942878,MATH 18,B04,083751,Rideout; David Porter,6,0,36,30
1657868942878,MATH 18,B05,093473,Rideout; David Porter,6,0,36,30
1657868942878,MATH 18,B06,093474,Rideout; David Porter,6,0,36,30
1657868948901,MATH 20A,A01,083754,Zheng; Zequn,14,0,40,26
1657868954998,MATH 20B,A01,083756,Briones; Jor-el Thomas Caparas,4,0,36,32
1657868954998,MATH 20B,A02,083757,Briones; Jor-el Thomas Caparas,1,0,36,35
1657868954998,MATH 20B,A03,093475,Briones; Jor-el Thomas Caparas,2,0,36,34
1657868961030,MATH 20C,A01,083760,Briones; Jor-el Thomas Caparas,1,0,35,34
1657868961030,MATH 20C,A02,083761,Briones; Jor-el Thomas Caparas,8,0,35,27
1657868961030,MATH 20C,A03,093476,Briones; Jor-el Thomas Caparas,0,1,36,36
1657868961030,MATH 20C,B01,083762,Bach; Quang Tran,1,0,30,29
1657868967055,MATH 20D,A01,083765,Tran; Brian Kha,5,0,30,25
1657868967055,MATH 20D,A02,083766,Tran; Brian Kha,5,0,30,25
1657868967055,MATH 20D,A03,083767,Tran; Brian Kha,5,0,30,25
1657868973079,MATH 20E,A01,083771,Ganguly; Soumya,10,0,32,22
1657868973079,MATH 20E,A02,083772,Ganguly; Soumya,6,0,32,26
1657868973079,MATH 20E,B01,083773,Ciotti; Benjamin,20,0,35,15
1657868973079,MATH 20E,B02,083774,Ciotti; Benjamin,18,0,35,17
1657868979104,MATH 103A,A01,083777,Greenfeld; Be'Eri,3,0,36,33
1657868979104,MATH 103A,A02,083778,Greenfeld; Be'Eri,5,0,36,31
1657868979104,MATH 103A,A03,093561,Greenfeld; Be'Eri,6,0,36,30
1657868979104,MATH 103A,B01,083779,Greenfeld; Be'Eri,7,0,36,29
1657868979104,MATH 103A,B02,083780,Greenfeld; Be'Eri,4,0,36,32
1657868979104,MATH 103A,B03,093562,Greenfeld; Be'Eri,3,0,36,33
1657868985129,MATH 105,A01,085443,Carter; Anne Toulson,15,0,35,20
1657868985129,MATH 105,A02,093477,Carter; Anne Toulson,20,0,35,15
1657868991158,MATH 109,A01,083213,Ganzberger; Geoffrey Michael,3,0,34,31
1657868991158,MATH 109,A02,083214,Ganzberger; Geoffrey Michael,4,0,34,30
1657868991158,MATH 109,A03,093478,Ganzberger; Geoffrey Michael,2,0,34,32
1657868991158,MATH 109,B01,083215,Ganzberger; Geoffrey Michael,1,0,32,31
1657868991158,MATH 109,B02,083216,Ganzberger; Geoffrey Michael,2,0,32,30
1657868991158,MATH 109,B03,093479,Ganzberger; Geoffrey Michael,8,0,32,24
1657868997183,MATH 142A,A01,083219,Chow; Bennett,7,0,32,25
1657868997183,MATH 142A,A02,083220,Chow; Bennett,10,0,32,22
1657868997183,MATH 142A,A03,093480,Chow; Bennett,9,0,32,23
1657868997183,MATH 142A,B03,093481,Chow; Bennett,8,0,32,24
1657868997183,MATH 142A,B04,093558,Chow; Bennett,13,0,32,19
1657868997183,MATH 142A,B05,093559,Chow; Bennett,7,0,32,25
1657869003215,MATH 193A,A01,083224,Rotar; Vladimir,8,0,34,26
1657869003215,MATH 193A,A02,083225,Rotar; Vladimir,10,0,34,24
1657869003215,MATH 193A,A03,083781,Rotar; Vladimir,5,0,34,29
1657869003215,MATH 193A,A04,083782,Rotar; Vladimir,11,0,34,23
1657869003215,MATH 193A,A05,093482,Rotar; Vladimir,10,0,34,24
1657869009243,MATH 197,001,091859,McAuley; Julian John,9999,0,9999,0
1657869009243,MATH 197,002,095566,Kedlaya; Kiran S.,9997,0,9999,2
1657869009243,MATH 197,003,095567,Xiao; Ming,9999,0,9999,0
1657869009243,MATH 197,004,095571,Perols; Johan Lars,9998,0,9999,1
1657869016334,COGS 9,A01,083615,Shannon; Kyle Michael,10,0,75,65
1657869022356,COGS 11,A01,083617,Boyle; Mary E. T.,23,0,48,25
1657869028384,COGS 13,A01,083071,Bastos; Amalia Pinkusfeld,11,0,71,60
1657869034416,COGS 14A,A01,092681,Semenuks; Arturs,5,1,100,95
1657869040445,COGS 14B,A01,083073,Cheng; Tzu-Han,6,0,63,57
1657869046468,COGS 17,A01,092677,Semenuks; Arturs,6,0,81,75
1657869052502,COGS 100,A01,083619,Allen; Michael Gordon,17,0,70,53
1657869058530,COGS 101A,A01,083621,Davis; Joshua Daniel,9,0,68,59
1657869064564,COGS 101B,A01,091572,Allen; Michael Gordon,12,0,65,53
1657869070588,COGS 101C,A01,083625,Delgado; Tania,17,0,35,18
1657869076615,COGS 107A,A01,083627,Boyle; Mary E. T.,14,0,60,46
1657869082653,COGS 118A,A01,083075,Gupta; Anjum,21,0,76,55
1657869088675,CSE 3,A50,083646,Miranda; Gregory Joseph,24,0,50,26
1657869094698,CSE 8A,A50,083650,Miranda; Gregory Joseph,17,1,56,39
1657869100722,CSE 11,A01,083080,Cao; Yingjun,6,15,40,34
1657869106745,CSE 12,A01,083652,Krause-Levy; Sophia Louisa,30,1,120,90
1657869112775,CSE 15L,A01,083654,Morris; Justin Loren,9,0,50,41
1657869112775,CSE 15L,A02,083655,Morris; Justin Loren,10,0,50,40
1657869118974,CSE 20,A01,083657,Tran; Khoa Dang,39,0,80,41
1657869125235,CSE 21,A01,095574,Bach; Quang Tran,22,0,48,26
1657869131272,CSE 30,A01,083084,Eldon; John,6,0,80,74
1657869131272,CSE 30,B01,095061,Bhaskar; Nishant,9,0,50,41
1657869137306,CSE 100,A01,083659,Cao; Yingjun,5,4,70,65
1657869143347,CSE 134B,A01,083661,Powell; Thomas Allan,24,0,100,76
1657869149372,CSE 140,A01,083663,Gungor; Onat,15,0,85,70
1657869155397,CSE 140L,A01,083088,Eldon; John,23,0,100,77
1657869161422,CSE 175,A01,083665,Kumar; Rakesh,3,0,25,22
1657869167447,CSE 190,A00,092507,Dubnov; Shlomo,8,0,20,12
1657869173471,ECE 45,A01,083139,Congero; Spencer William,6,0,75,69
1657869179497,ECE 65,A50,083695,Saad; Andrew S,12,0,30,18
1657869179497,ECE 65,A51,095125,Saad; Andrew S,24,0,26,2
1657869185519,ECE 109,A01,091882,Touri; Behrouz,20,0,70,50
1657869191543,ECE 180,A00,083140,Abi Samra; Nicholas Camill,1,0,30,29
1657869191543,ECE 180,B00,083141,Abi Samra; Nicholas Camill,0,0,30,30
1657869197570,MATH 10A,A01,083735,Patchell; Gregory David,2,0,30,28
1657869197570,MATH 10A,A02,083736,Patchell; Gregory David,20,0,30,10
1657869197570,MATH 10A,A03,083737,Patchell; Gregory David,16,0,30,14
1657869203594,MATH 10B,A01,083207,Lim; Seonhee,8,0,34,26
1657869203594,MATH 10B,A02,083208,Lim; Seonhee,10,0,35,25
1657869203594,MATH 10B,A03,093472,Lim; Seonhee,7,0,34,27
1657869203594,MATH 10B,B01,083739,Sinha; Shubham,14,0,30,16
1657869209629,MATH 18,A01,083743,Cinel; Cameron Alexander,9,0,30,21
1657869209629,MATH 18,A02,083744,Cinel; Cameron Alexander,18,0,30,12
1657869209629,MATH 18,A03,083745,Cinel; Cameron Alexander,10,0,30,20
1657869209629,MATH 18,B01,083748,Rideout; David Porter,5,0,37,32
1657869209629,MATH 18,B02,083749,Rideout; David Porter,5,0,36,31
1657869209629,MATH 18,B03,083750,Rideout; David Porter,3,0,37,34
1657869209629,MATH 18,B04,083751,Rideout; David Porter,6,0,36,30
1657869209629,MATH 18,B05,093473,Rideout; David Porter,6,0,36,30
1657869209629,MATH 18,B06,093474,Rideout; David Porter,6,0,36,30
1657869215656,MATH 20A,A01,083754,Zheng; Zequn,14,0,40,26
1657869221683,MATH 20B,A01,083756,Briones; Jor-el Thomas Caparas,4,0,36,32
1657869221683,MATH 20B,A02,083757,Briones; Jor-el Thomas Caparas,1,0,36,35
1657869221683,MATH 20B,A03,093475,Briones; Jor-el Thomas Caparas,2,0,36,34
1657869227709,MATH 20C,A01,083760,Briones; Jor-el Thomas Caparas,1,0,35,34
1657869227709,MATH 20C,A02,083761,Briones; Jor-el Thomas Caparas,8,0,35,27
1657869227709,MATH 20C,A03,093476,Briones; Jor-el Thomas Caparas,0,1,36,36
1657869227709,MATH 20C,B01,083762,Bach; Quang Tran,1,0,30,29
1657869233742,MATH 20D,A01,083765,Tran; Brian Kha,5,0,30,25
1657869233742,MATH 20D,A02,083766,Tran; Brian Kha,5,0,30,25
1657869233742,MATH 20D,A03,083767,Tran; Brian Kha,5,0,30,25
1657869239767,MATH 20E,A01,083771,Ganguly; Soumya,10,0,32,22
1657869239767,MATH 20E,A02,083772,Ganguly; Soumya,6,0,32,26
1657869239767,MATH 20E,B01,083773,Ciotti; Benjamin,20,0,35,15
1657869239767,MATH 20E,B02,083774,Ciotti; Benjamin,18,0,35,17
1657869245810,MATH 103A,A01,083777,Greenfeld; Be'Eri,3,0,36,33
1657869245810,MATH 103A,A02,083778,Greenfeld; Be'Eri,5,0,36,31
1657869245810,MATH 103A,A03,093561,Greenfeld; Be'Eri,6,0,36,30
1657869245810,MATH 103A,B01,083779,Greenfeld; Be'Eri,7,0,36,29
1657869245810,MATH 103A,B02,083780,Greenfeld; Be'Eri,4,0,36,32
1657869245810,MATH 103A,B03,093562,Greenfeld; Be'Eri,3,0,36,33
1657869251835,MATH 105,A01,085443,Carter; Anne Toulson,15,0,35,20
1657869251835,MATH 105,A02,093477,Carter; Anne Toulson,20,0,35,15
1657869257863,MATH 109,A01,083213,Ganzberger; Geoffrey Michael,3,0,34,31
1657869257863,MATH 109,A02,083214,Ganzberger; Geoffrey Michael,4,0,34,30
1657869257863,MATH 109,A03,093478,Ganzberger; Geoffrey Michael,2,0,34,32
1657869257863,MATH 109,B01,083215,Ganzberger; Geoffrey Michael,1,0,32,31
1657869257863,MATH 109,B02,083216,Ganzberger; Geoffrey Michael,2,0,32,30
1657869257863,MATH 109,B03,093479,Ganzberger; Geoffrey Michael,8,0,32,24
1657869263887,MATH 142A,A01,083219,Chow; Bennett,7,0,32,25
1657869263887,MATH 142A,A02,083220,Chow; Bennett,10,0,32,22
1657869263887,MATH 142A,A03,093480,Chow; Bennett,9,0,32,23
1657869263887,MATH 142A,B03,093481,Chow; Bennett,8,0,32,24
1657869263887,MATH 142A,B04,093558,Chow; Bennett,13,0,32,19
1657869263887,MATH 142A,B05,093559,Chow; Bennett,7,0,32,25
1657869269921,MATH 193A,A01,083224,Rotar; Vladimir,8,0,34,26
1657869269921,MATH 193A,A02,083225,Rotar; Vladimir,10,0,34,24
1657869269921,MATH 193A,A03,083781,Rotar; Vladimir,5,0,34,29
1657869269921,MATH 193A,A04,083782,Rotar; Vladimir,11,0,34,23
1657869269921,MATH 193A,A05,093482,Rotar; Vladimir,10,0,34,24
1657869275960,MATH 197,001,091859,McAuley; Julian John,9999,0,9999,0
1657869275960,MATH 197,002,095566,Kedlaya; Kiran S.,9997,0,9999,2
1657869275960,MATH 197,003,095567,Xiao; Ming,9999,0,9999,0
1657869275960,MATH 197,004,095571,Perols; Johan Lars,9998,0,9999,1
1657869283018,COGS 9,A01,083615,Shannon; Kyle Michael,10,0,75,65
1657869289046,COGS 11,A01,083617,Boyle; Mary E. T.,23,0,48,25
1657869295075,COGS 13,A01,083071,Bastos; Amalia Pinkusfeld,11,0,71,60
1657869301108,COGS 14A,A01,092681,Semenuks; Arturs,5,1,100,95
1657869307133,COGS 14B,A01,083073,Cheng; Tzu-Han,6,0,63,57
1657869313163,COGS 17,A01,092677,Semenuks; Arturs,6,0,81,75
1657869319194,COGS 100,A01,083619,Allen; Michael Gordon,17,0,70,53
1657869325223,COGS 101A,A01,083621,Davis; Joshua Daniel,9,0,68,59
1657869331247,COGS 101B,A01,091572,Allen; Michael Gordon,12,0,65,53
1657869337274,COGS 101C,A01,083625,Delgado; Tania,17,0,35,18
1657869343321,COGS 107A,A01,083627,Boyle; Mary E. T.,14,0,60,46
1657869349349,COGS 118A,A01,083075,Gupta; Anjum,21,0,76,55
1657869355375,CSE 3,A50,083646,Miranda; Gregory Joseph,24,0,50,26
1657869361399,CSE 8A,A50,083650,Miranda; Gregory Joseph,17,1,56,39
1657869367452,CSE 11,A01,083080,Cao; Yingjun,6,15,40,34
1657869373479,CSE 12,A01,083652,Krause-Levy; Sophia Louisa,30,1,120,90
1657869379503,CSE 15L,A01,083654,Morris; Justin Loren,9,0,50,41
1657869379503,CSE 15L,A02,083655,Morris; Justin Loren,10,0,50,40
1657869385528,CSE 20,A01,083657,Tran; Khoa Dang,39,0,80,41
1657869391562,CSE 21,A01,095574,Bach; Quang Tran,22,0,48,26
1657869397585,CSE 30,A01,083084,Eldon; John,6,0,80,74
1657869397585,CSE 30,B01,095061,Bhaskar; Nishant,9,0,50,41
1657869403610,CSE 100,A01,083659,Cao; Yingjun,5,4,70,65
1657869409641,CSE 134B,A01,083661,Powell; Thomas Allan,24,0,100,76
1657869415670,CSE 140,A01,083663,Gungor; Onat,15,0,85,70
1657869421699,CSE 140L,A01,083088,Eldon; John,23,0,100,77
1657869427723,CSE 175,A01,083665,Kumar; Rakesh,3,0,25,22
1657869433745,CSE 190,A00,092507,Dubnov; Shlomo,8,0,20,12
1657869439774,ECE 45,A01,083139,Congero; Spencer William,6,0,75,69
1657869445805,ECE 65,A50,083695,Saad; Andrew S,12,0,30,18
1657869445805,ECE 65,A51,095125,Saad; Andrew S,24,0,26,2
1657869451837,ECE 109,A01,091882,Touri; Behrouz,20,0,70,50
1657869457870,ECE 180,A00,083140,Abi Samra; Nicholas Camill,1,0,30,29
1657869457870,ECE 180,B00,083141,Abi Samra; Nicholas Camill,0,0,30,30
1657869463893,MATH 10A,A01,083735,Patchell; Gregory David,2,0,30,28
1657869463893,MATH 10A,A02,083736,Patchell; Gregory David,20,0,30,10
1657869463893,MATH 10A,A03,083737,Patchell; Gregory David,16,0,30,14
1657869469926,MATH 10B,A01,083207,Lim; Seonhee,8,0,34,26
1657869469926,MATH 10B,A02,083208,Lim; Seonhee,10,0,35,25
1657869469926,MATH 10B,A03,093472,Lim; Seonhee,7,0,34,27
1657869469926,MATH 10B,B01,083739,Sinha; Shubham,14,0,30,16
1657869475952,MATH 18,A01,083743,Cinel; Cameron Alexander,9,0,30,21
1657869475952,MATH 18,A02,083744,Cinel; Cameron Alexander,18,0,30,12
1657869475952,MATH 18,A03,083745,Cinel; Cameron Alexander,10,0,30,20
1657869475952,MATH 18,B01,083748,Rideout; David Porter,5,0,37,32
1657869475952,MATH 18,B02,083749,Rideout; David Porter,5,0,36,31
1657869475952,MATH 18,B03,083750,Rideout; David Porter,3,0,37,34
1657869475952,MATH 18,B04,083751,Rideout; David Porter,6,0,36,30
1657869475952,MATH 18,B05,093473,Rideout; David Porter,6,0,36,30
1657869475952,MATH 18,B06,093474,Rideout; David Porter,6,0,36,30
1657869481977,MATH 20A,A01,083754,Zheng; Zequn,14,0,40,26
1657869488004,MATH 20B,A01,083756,Briones; Jor-el Thomas Caparas,4,0,36,32
1657869488004,MATH 20B,A02,083757,Briones; Jor-el Thomas Caparas,1,0,36,35
1657869488004,MATH 20B,A03,093475,Briones; Jor-el Thomas Caparas,2,0,36,34
1657869494029,MATH 20C,A01,083760,Briones; Jor-el Thomas Caparas,1,0,35,34
1657869494029,MATH 20C,A02,083761,Briones; Jor-el Thomas Caparas,8,0,35,27
1657869494029,MATH 20C,A03,093476,Briones; Jor-el Thomas Caparas,0,1,36,36
1657869494029,MATH 20C,B01,083762,Bach; Quang Tran,1,0,30,29
1657869500054,MATH 20D,A01,083765,Tran; Brian Kha,5,0,30,25
1657869500054,MATH 20D,A02,083766,Tran; Brian Kha,5,0,30,25
1657869500054,MATH 20D,A03,083767,Tran; Brian Kha,5,0,30,25
1657869506088,MATH 20E,A01,083771,Ganguly; Soumya,10,0,32,22
1657869506088,MATH 20E,A02,083772,Ganguly; Soumya,6,0,32,26
1657869506088,MATH 20E,B01,083773,Ciotti; Benjamin,20,0,35,15
1657869506088,MATH 20E,B02,083774,Ciotti; Benjamin,18,0,35,17
1657869512114,MATH 103A,A01,083777,Greenfeld; Be'Eri,3,0,36,33
1657869512114,MATH 103A,A02,083778,Greenfeld; Be'Eri,5,0,36,31
1657869512114,MATH 103A,A03,093561,Greenfeld; Be'Eri,6,0,36,30
1657869512114,MATH 103A,B01,083779,Greenfeld; Be'Eri,7,0,36,29
1657869512114,MATH 103A,B02,083780,Greenfeld; Be'Eri,4,0,36,32
1657869512114,MATH 103A,B03,093562,Greenfeld; Be'Eri,3,0,36,33
1657869518140,MATH 105,A01,085443,Carter; Anne Toulson,15,0,35,20
1657869518140,MATH 105,A02,093477,Carter; Anne Toulson,20,0,35,15
1657869524169,MATH 109,A01,083213,Ganzberger; Geoffrey Michael,3,0,34,31
1657869524169,MATH 109,A02,083214,Ganzberger; Geoffrey Michael,4,0,34,30
1657869524169,MATH 109,A03,093478,Ganzberger; Geoffrey Michael,2,0,34,32
1657869524169,MATH 109,B01,083215,Ganzberger; Geoffrey Michael,1,0,32,31
1657869524169,MATH 109,B02,083216,Ganzberger; Geoffrey Michael,2,0,32,30
1657869524169,MATH 109,B03,093479,Ganzberger; Geoffrey Michael,8,0,32,24
1657869530213,MATH 142A,A01,083219,Chow; Bennett,7,0,32,25
1657869530213,MATH 142A,A02,083220,Chow; Bennett,10,0,32,22
1657869530213,MATH 142A,A03,093480,Chow; Bennett,9,0,32,23
1657869530213,MATH 142A,B03,093481,Chow; Bennett,8,0,32,24
1657869530213,MATH 142A,B04,093558,Chow; Bennett,13,0,32,19
1657869530213,MATH 142A,B05,093559,Chow; Bennett,7,0,32,25
1657869536243,MATH 193A,A01,083224,Rotar; Vladimir,8,0,34,26
1657869536243,MATH 193A,A02,083225,Rotar; Vladimir,10,0,34,24
1657869536243,MATH 193A,A03,083781,Rotar; Vladimir,5,0,34,29
1657869536243,MATH 193A,A04,083782,Rotar; Vladimir,11,0,34,23
1657869536243,MATH 193A,A05,093482,Rotar; Vladimir,10,0,34,24
1657869542269,MATH 197,001,091859,McAuley; Julian John,9999,0,9999,0
1657869542269,MATH 197,002,095566,Kedlaya; Kiran S.,9997,0,9999,2
1657869542269,MATH 197,003,095567,Xiao; Ming,9999,0,9999,0
1657869542269,MATH 197,004,095571,Perols; Johan Lars,9998,0,9999,1
1657869549423,COGS 9,A01,083615,Shannon; Kyle Michael,10,0,75,65
1657869555448,COGS 11,A01,083617,Boyle; Mary E. T.,23,0,48,25
1657869561484,COGS 13,A01,083071,Bastos; Amalia Pinkusfeld,11,0,71,60
1657869567511,COGS 14A,A01,092681,Semenuks; Arturs,5,1,100,95
1657869573534,COGS 14B,A01,083073,Cheng; Tzu-Han,6,0,63,57
1657869579561,COGS 17,A01,092677,Semenuks; Arturs,6,0,81,75
1657869585591,COGS 100,A01,083619,Allen; Michael Gordon,17,0,70,53
1657869591615,COGS 101A,A01,083621,Davis; Joshua Daniel,9,0,68,59
1657869597638,COGS 101B,A01,091572,Allen; Michael Gordon,12,0,65,53
1657869603668,COGS 101C,A01,083625,Delgado; Tania,17,0,35,18
1657869609695,COGS 107A,A01,083627,Boyle; Mary E. T.,14,0,60,46
1657869615723,COGS 118A,A01,083075,Gupta; Anjum,21,0,76,55
1657869621747,CSE 3,A50,083646,Miranda; Gregory Joseph,24,0,50,26
1657869627776,CSE 8A,A50,083650,Miranda; Gregory Joseph,17,1,56,39
1657869633803,CSE 11,A01,083080,Cao; Yingjun,6,15,40,34
1657869639833,CSE 12,A01,083652,Krause-Levy; Sophia Louisa,30,1,120,90
1657869645856,CSE 15L,A01,083654,Morris; Justin Loren,9,0,50,41
1657869645856,CSE 15L,A02,083655,Morris; Justin Loren,10,0,50,40
1657869651879,CSE 20,A01,083657,Tran; Khoa Dang,39,0,80,41
1657869657901,CSE 21,A01,095574,Bach; Quang Tran,22,0,48,26
1657869663933,CSE 30,A01,083084,Eldon; John,6,0,80,74
1657869663933,CSE 30,B01,095061,Bhaskar; Nishant,9,0,50,41
1657869669961,CSE 100,A01,083659,Cao; Yingjun,5,4,70,65
1657869675990,CSE 134B,A01,083661,Powell; Thomas Allan,24,0,100,76
1657869682020,CSE 140,A01,083663,Gungor; Onat,15,0,85,70
1657869688047,CSE 140L,A01,083088,Eldon; John,23,0,100,77
1657869694072,CSE 175,A01,083665,Kumar; Rakesh,3,0,25,22
1657869700098,CSE 190,A00,092507,Dubnov; Shlomo,8,0,20,12
1657869706127,ECE 45,A01,083139,Congero; Spencer William,6,0,75,69
1657869712159,ECE 65,A50,083695,Saad; Andrew S,12,0,30,18
1657869712159,ECE 65,A51,095125,Saad; Andrew S,24,0,26,2
1657869718183,ECE 109,A01,091882,Touri; Behrouz,20,0,70,50
1657869724208,ECE 180,A00,083140,Abi Samra; Nicholas Camill,1,0,30,29
1657869724208,ECE 180,B00,083141,Abi Samra; Nicholas Camill,0,0,30,30
1657869730234,MATH 10A,A01,083735,Patchell; Gregory David,2,0,30,28
1657869730234,MATH 10A,A02,083736,Patchell; Gregory David,20,0,30,10
1657869730234,MATH 10A,A03,083737,Patchell; Gregory David,16,0,30,14
1657869736270,MATH 10B,A01,083207,Lim; Seonhee,8,0,34,26
1657869736270,MATH 10B,A02,083208,Lim; Seonhee,10,0,35,25
1657869736270,MATH 10B,A03,093472,Lim; Seonhee,7,0,34,27
1657869736270,MATH 10B,B01,083739,Sinha; Shubham,14,0,30,16
1657869742300,MATH 18,A01,083743,Cinel; Cameron Alexander,9,0,30,21
1657869742300,MATH 18,A02,083744,Cinel; Cameron Alexander,18,0,30,12
1657869742300,MATH 18,A03,083745,Cinel; Cameron Alexander,10,0,30,20
1657869742300,MATH 18,B01,083748,Rideout; David Porter,5,0,37,32
1657869742300,MATH 18,B02,083749,Rideout; David Porter,5,0,36,31
1657869742300,MATH 18,B03,083750,Rideout; David Porter,3,0,37,34
1657869742300,MATH 18,B04,083751,Rideout; David Porter,6,0,36,30
1657869742300,MATH 18,B05,093473,Rideout; David Porter,6,0,36,30
1657869742300,MATH 18,B06,093474,Rideout; David Porter,6,0,36,30
1657869748328,MATH 20A,A01,083754,Zheng; Zequn,14,0,40,26
1657869754362,MATH 20B,A01,083756,Briones; Jor-el Thomas Caparas,4,0,36,32
1657869754362,MATH 20B,A02,083757,Briones; Jor-el Thomas Caparas,1,0,36,35
1657869754362,MATH 20B,A03,093475,Briones; Jor-el Thomas Caparas,2,0,36,34
1657869760392,MATH 20C,A01,083760,Briones; Jor-el Thomas Caparas,1,0,35,34
1657869760392,MATH 20C,A02,083761,Briones; Jor-el Thomas Caparas,8,0,35,27
1657869760392,MATH 20C,A03,093476,Briones; Jor-el Thomas Caparas,0,1,36,36
1657869760392,MATH 20C,B01,083762,Bach; Quang Tran,1,0,30,29
1657869766420,MATH 20D,A01,083765,Tran; Brian Kha,5,0,30,25
1657869766420,MATH 20D,A02,083766,Tran; Brian Kha,5,0,30,25
1657869766420,MATH 20D,A03,083767,Tran; Brian Kha,5,0,30,25
1657869772451,MATH 20E,A01,083771,Ganguly; Soumya,10,0,32,22
1657869772451,MATH 20E,A02,083772,Ganguly; Soumya,6,0,32,26
1657869772451,MATH 20E,B01,083773,Ciotti; Benjamin,20,0,35,15
1657869772451,MATH 20E,B02,083774,Ciotti; Benjamin,18,0,35,17
1657869778478,MATH 103A,A01,083777,Greenfeld; Be'Eri,3,0,36,33
1657869778478,MATH 103A,A02,083778,Greenfeld; Be'Eri,5,0,36,31
1657869778478,MATH 103A,A03,093561,Greenfeld; Be'Eri,6,0,36,30
1657869778478,MATH 103A,B01,083779,Greenfeld; Be'Eri,7,0,36,29
1657869778478,MATH 103A,B02,083780,Greenfeld; Be'Eri,4,0,36,32
1657869778478,MATH 103A,B03,093562,Greenfeld; Be'Eri,3,0,36,33
1657869784503,MATH 105,A01,085443,Carter; Anne Toulson,15,0,35,20
1657869784503,MATH 105,A02,093477,Carter; Anne Toulson,20,0,35,15
1657869790528,MATH 109,A01,083213,Ganzberger; Geoffrey Michael,3,0,34,31
1657869790528,MATH 109,A02,083214,Ganzberger; Geoffrey Michael,4,0,34,30
1657869790528,MATH 109,A03,093478,Ganzberger; Geoffrey Michael,2,0,34,32
1657869790528,MATH 109,B01,083215,Ganzberger; Geoffrey Michael,1,0,32,31
1657869790528,MATH 109,B02,083216,Ganzberger; Geoffrey Michael,2,0,32,30
1657869790528,MATH 109,B03,093479,Ganzberger; Geoffrey Michael,8,0,32,24
1657869796553,MATH 142A,A01,083219,Chow; Bennett,7,0,32,25
1657869796553,MATH 142A,A02,083220,Chow; Bennett,10,0,32,22
1657869796553,MATH 142A,A03,093480,Chow; Bennett,9,0,32,23
1657869796553,MATH 142A,B03,093481,Chow; Bennett,8,0,32,24
1657869796553,MATH 142A,B04,093558,Chow; Bennett,13,0,32,19
1657869796553,MATH 142A,B05,093559,Chow; Bennett,7,0,32,25
1657869802578,MATH 193A,A01,083224,Rotar; Vladimir,8,0,34,26
1657869802578,MATH 193A,A02,083225,Rotar; Vladimir,10,0,34,24
1657869802578,MATH 193A,A03,083781,Rotar; Vladimir,5,0,34,29
1657869802578,MATH 193A,A04,083782,Rotar; Vladimir,11,0,34,23
1657869802578,MATH 193A,A05,093482,Rotar; Vladimir,10,0,34,24
1657869808603,MATH 197,001,091859,McAuley; Julian John,9999,0,9999,0
1657869808603,MATH 197,002,095566,Kedlaya; Kiran S.,9997,0,9999,2
1657869808603,MATH 197,003,095567,Xiao; Ming,9999,0,9999,0
1657869808603,MATH 197,004,095571,Perols; Johan Lars,9998,0,9999,1
1657869815662,COGS 9,A01,083615,Shannon; Kyle Michael,10,0,75,65
1657869821689,COGS 11,A01,083617,Boyle; Mary E. T.,23,0,48,25
1657869827720,COGS 13,A01,083071,Bastos; Amalia Pinkusfeld,11,0,71,60
1657869833747,COGS 14A,A01,092681,Semenuks; Arturs,5,1,100,95
1657869839772,COGS 14B,A01,083073,Cheng; Tzu-Han,6,0,63,57
1657869845796,COGS 17,A01,092677,Semenuks; Arturs,6,0,81,75
1657869851819,COGS 100,A01,083619,Allen; Michael Gordon,17,0,70,53
1657869857844,COGS 101A,A01,083621,Davis; Joshua Daniel,9,0,68,59
1657869863866,COGS 101B,A01,091572,Allen; Michael Gordon,12,0,65,53
1657869869895,COGS 101C,A01,083625,Delgado; Tania,17,0,35,18
1657869875919,COGS 107A,A01,083627,Boyle; Mary E. T.,14,0,60,46
1657869881946,COGS 118A,A01,083075,Gupta; Anjum,21,0,76,55
1657869887976,CSE 3,A50,083646,Miranda; Gregory Joseph,24,0,50,26
1657869894001,CSE 8A,A50,083650,Miranda; Gregory Joseph,17,1,56,39
1657869900026,CSE 11,A01,083080,Cao; Yingjun,6,15,40,34
1657869906053,CSE 12,A01,083652,Krause-Levy; Sophia Louisa,30,1,120,90
1657869912083,CSE 15L,A01,083654,Morris; Justin Loren,9,0,50,41
1657869912083,CSE 15L,A02,083655,Morris; Justin Loren,10,0,50,40
1657869918110,CSE 20,A01,083657,Tran; Khoa Dang,39,0,80,41
1657869924133,CSE 21,A01,095574,Bach; Quang Tran,22,0,48,26
1657869930161,CSE 30,A01,083084,Eldon; John,6,0,80,74
1657869930161,CSE 30,B01,095061,Bhaskar; Nishant,9,0,50,41
1657869936185,CSE 100,A01,083659,Cao; Yingjun,5,4,70,65
1657869942213,CSE 134B,A01,083661,Powell; Thomas Allan,24,0,100,76
1657869948235,CSE 140,A01,083663,Gungor; Onat,15,0,85,70
1657869954259,CSE 140L,A01,083088,Eldon; John,23,0,100,77
1657869960286,CSE 175,A01,083665,Kumar; Rakesh,3,0,25,22
1657869966316,CSE 190,A00,092507,Dubnov; Shlomo,8,0,20,12
1657869972344,ECE 45,A01,083139,Congero; Spencer William,6,0,75,69
1657869978394,ECE 65,A50,083695,Saad; Andrew S,12,0,30,18
1657869978394,ECE 65,A51,095125,Saad; Andrew S,24,0,26,2
1657869984421,ECE 109,A01,091882,Touri; Behrouz,20,0,70,50
1657869990444,ECE 180,A00,083140,Abi Samra; Nicholas Camill,1,0,30,29
1657869990444,ECE 180,B00,083141,Abi Samra; Nicholas Camill,0,0,30,30
1657869996467,MATH 10A,A01,083735,Patchell; Gregory David,2,0,30,28
1657869996467,MATH 10A,A02,083736,Patchell; Gregory David,20,0,30,10
1657869996467,MATH 10A,A03,083737,Patchell; Gregory David,16,0,30,14
1657870002492,MATH 10B,A01,083207,Lim; Seonhee,8,0,34,26
1657870002492,MATH 10B,A02,083208,Lim; Seonhee,10,0,35,25
1657870002492,MATH 10B,A03,093472,Lim; Seonhee,7,0,34,27
1657870002492,MATH 10B,B01,083739,Sinha; Shubham,14,0,30,16
1657870008526,MATH 18,A01,083743,Cinel; Cameron Alexander,9,0,30,21
1657870008526,MATH 18,A02,083744,Cinel; Cameron Alexander,18,0,30,12
1657870008526,MATH 18,A03,083745,Cinel; Cameron Alexander,10,0,30,20
1657870008526,MATH 18,B01,083748,Rideout; David Porter,5,0,37,32
1657870008526,MATH 18,B02,083749,Rideout; David Porter,5,0,36,31
1657870008526,MATH 18,B03,083750,Rideout; David Porter,3,0,37,34
1657870008526,MATH 18,B04,083751,Rideout; David Porter,6,0,36,30
1657870008526,MATH 18,B05,093473,Rideout; David Porter,6,0,36,30
1657870008526,MATH 18,B06,093474,Rideout; David Porter,6,0,36,30
1657870014557,MATH 20A,A01,083754,Zheng; Zequn,14,0,40,26
1657870020590,MATH 20B,A01,083756,Briones; Jor-el Thomas Caparas,4,0,36,32
1657870020590,MATH 20B,A02,083757,Briones; Jor-el Thomas Caparas,1,0,36,35
1657870020590,MATH 20B,A03,093475,Briones; Jor-el Thomas Caparas,2,0,36,34
1657870026614,MATH 20C,A01,083760,Briones; Jor-el Thomas Caparas,1,0,35,34
1657870026614,MATH 20C,A02,083761,Briones; Jor-el Thomas Caparas,8,0,35,27
1657870026614,MATH 20C,A03,093476,Briones; Jor-el Thomas Caparas,0,1,36,36
1657870026614,MATH 20C,B01,083762,Bach; Quang Tran,1,0,30,29
1657870032663,MATH 20D,A01,083765,Tran; Brian Kha,5,0,30,25
1657870032663,MATH 20D,A02,083766,Tran; Brian Kha,5,0,30,25
1657870032663,MATH 20D,A03,083767,Tran; Brian Kha,5,0,30,25
1657870038694,MATH 20E,A01,083771,Ganguly; Soumya,10,0,32,22
1657870038694,MATH 20E,A02,083772,Ganguly; Soumya,6,0,32,26
1657870038694,MATH 20E,B01,083773,Ciotti; Benjamin,20,0,35,15
1657870038694,MATH 20E,B02,083774,Ciotti; Benjamin,18,0,35,17
1657870044731,MATH 103A,A01,083777,Greenfeld; Be'Eri,3,0,36,33
1657870044731,MATH 103A,A02,083778,Greenfeld; Be'Eri,5,0,36,31
1657870044731,MATH 103A,A03,093561,Greenfeld; Be'Eri,6,0,36,30
1657870044731,MATH 103A,B01,083779,Greenfeld; Be'Eri,7,0,36,29
1657870044731,MATH 103A,B02,083780,Greenfeld; Be'Eri,4,0,36,32
1657870044731,MATH 103A,B03,093562,Greenfeld; Be'Eri,3,0,36,33
1657870050755,MATH 105,A01,085443,Carter; Anne Toulson,15,0,35,20
1657870050755,MATH 105,A02,093477,Carter; Anne Toulson,20,0,35,15
1657870056780,MATH 109,A01,083213,Ganzberger; Geoffrey Michael,3,0,34,31
1657870056780,MATH 109,A02,083214,Ganzberger; Geoffrey Michael,4,0,34,30
1657870056780,MATH 109,A03,093478,Ganzberger; Geoffrey Michael,2,0,34,32
1657870056780,MATH 109,B01,083215,Ganzberger; Geoffrey Michael,1,0,32,31
1657870056780,MATH 109,B02,083216,Ganzberger; Geoffrey Michael,2,0,32,30
1657870056780,MATH 109,B03,093479,Ganzberger; Geoffrey Michael,8,0,32,24
1657870062812,MATH 142A,A01,083219,Chow; Bennett,7,0,32,25
1657870062812,MATH 142A,A02,083220,Chow; Bennett,10,0,32,22
1657870062812,MATH 142A,A03,093480,Chow; Bennett,9,0,32,23
1657870062812,MATH 142A,B03,093481,Chow; Bennett,8,0,32,24
1657870062812,MATH 142A,B04,093558,Chow; Bennett,13,0,32,19
1657870062812,MATH 142A,B05,093559,Chow; Bennett,7,0,32,25
1657870068841,MATH 193A,A01,083224,Rotar; Vladimir,8,0,34,26
1657870068841,MATH 193A,A02,083225,Rotar; Vladimir,10,0,34,24
1657870068841,MATH 193A,A03,083781,Rotar; Vladimir,5,0,34,29
1657870068841,MATH 193A,A04,083782,Rotar; Vladimir,11,0,34,23
1657870068841,MATH 193A,A05,093482,Rotar; Vladimir,10,0,34,24
1657870074872,MATH 197,001,091859,McAuley; Julian John,9999,0,9999,0
1657870074872,MATH 197,002,095566,Kedlaya; Kiran S.,9997,0,9999,2
1657870074872,MATH 197,003,095567,Xiao; Ming,9999,0,9999,0
1657870074872,MATH 197,004,095571,Perols; Johan Lars,9998,0,9999,1
1657870081939,COGS 9,A01,083615,Shannon; Kyle Michael,10,0,75,65
1657870087962,COGS 11,A01,083617,Boyle; Mary E. T.,23,0,48,25
1657870093989,COGS 13,A01,083071,Bastos; Amalia Pinkusfeld,11,0,71,60
1657870100012,COGS 14A,A01,092681,Semenuks; Arturs,5,1,100,95
1657870106036,COGS 14B,A01,083073,Cheng; Tzu-Han,6,0,63,57
1657870112058,COGS 17,A01,092677,Semenuks; Arturs,6,0,81,75
1657870118081,COGS 100,A01,083619,Allen; Michael Gordon,17,0,70,53
1657870124106,COGS 101A,A01,083621,Davis; Joshua Daniel,9,0,68,59
1657870130129,COGS 101B,A01,091572,Allen; Michael Gordon,12,0,65,53
1657870136152,COGS 101C,A01,083625,Delgado; Tania,17,0,35,18
1657870142176,COGS 107A,A01,083627,Boyle; Mary E. T.,14,0,60,46
1657870148272,COGS 118A,A01,083075,Gupta; Anjum,21,0,76,55
1657870154303,CSE 3,A50,083646,Miranda; Gregory Joseph,24,0,50,26
1657870160328,CSE 8A,A50,083650,Miranda; Gregory Joseph,17,1,56,39
1657870166352,CSE 11,A01,083080,Cao; Yingjun,6,15,40,34
1657870172380,CSE 12,A01,083652,Krause-Levy; Sophia Louisa,30,1,120,90
1657870178408,CSE 15L,A01,083654,Morris; Justin Loren,9,0,50,41
1657870178408,CSE 15L,A02,083655,Morris; Justin Loren,10,0,50,40
1657870184437,CSE 20,A01,083657,Tran; Khoa Dang,39,0,80,41
1657870190461,CSE 21,A01,095574,Bach; Quang Tran,22,0,48,26
1657870196484,CSE 30,A01,083084,Eldon; John,6,0,80,74
1657870196484,CSE 30,B01,095061,Bhaskar; Nishant,9,0,50,41
1657870202514,CSE 100,A01,083659,Cao; Yingjun,5,4,70,65
1657870208536,CSE 134B,A01,083661,Powell; Thomas Allan,24,0,100,76
1657870214559,CSE 140,A01,083663,Gungor; Onat,15,0,85,70
1657870220582,CSE 140L,A01,083088,Eldon; John,23,0,100,77
1657870226605,CSE 175,A01,083665,Kumar; Rakesh,3,0,25,22
1657870232629,CSE 190,A00,092507,Dubnov; Shlomo,8,0,20,12
1657870238653,ECE 45,A01,083139,Congero; Spencer William,6,0,75,69
1657870244680,ECE 65,A50,083695,Saad; Andrew S,12,0,30,18
1657870244680,ECE 65,A51,095125,Saad; Andrew S,24,0,26,2
1657870250703,ECE 109,A01,091882,Touri; Behrouz,20,0,70,50
1657870256734,ECE 180,A00,083140,Abi Samra; Nicholas Camill,1,0,30,29
1657870256734,ECE 180,B00,083141,Abi Samra; Nicholas Camill,0,0,30,30
1657870262767,MATH 10A,A01,083735,Patchell; Gregory David,2,0,30,28
1657870262767,MATH 10A,A02,083736,Patchell; Gregory David,20,0,30,10
1657870262767,MATH 10A,A03,083737,Patchell; Gregory David,16,0,30,14
1657870268791,MATH 10B,A01,083207,Lim; Seonhee,8,0,34,26
1657870268791,MATH 10B,A02,083208,Lim; Seonhee,10,0,35,25
1657870268791,MATH 10B,A03,093472,Lim; Seonhee,7,0,34,27
1657870268791,MATH 10B,B01,083739,Sinha; Shubham,14,0,30,16
1657870274822,MATH 18,A01,083743,Cinel; Cameron Alexander,9,0,30,21
1657870274822,MATH 18,A02,083744,Cinel; Cameron Alexander,18,0,30,12
1657870274822,MATH 18,A03,083745,Cinel; Cameron Alexander,10,0,30,20
1657870274822,MATH 18,B01,083748,Rideout; David Porter,5,0,37,32
1657870274822,MATH 18,B02,083749,Rideout; David Porter,5,0,36,31
1657870274822,MATH 18,B03,083750,Rideout; David Porter,3,0,37,34
1657870274822,MATH 18,B04,083751,Rideout; David Porter,6,0,36,30
1657870274822,MATH 18,B05,093473,Rideout; David Porter,6,0,36,30
1657870274822,MATH 18,B06,093474,Rideout; David Porter,6,0,36,30
1657870280846,MATH 20A,A01,083754,Zheng; Zequn,14,0,40,26
1657870286871,MATH 20B,A01,083756,Briones; Jor-el Thomas Caparas,4,0,36,32
1657870286871,MATH 20B,A02,083757,Briones; Jor-el Thomas Caparas,1,0,36,35
1657870286871,MATH 20B,A03,093475,Briones; Jor-el Thomas Caparas,2,0,36,34
1657870292897,MATH 20C,A01,083760,Briones; Jor-el Thomas Caparas,1,0,35,34
1657870292897,MATH 20C,A02,083761,Briones; Jor-el Thomas Caparas,8,0,35,27
1657870292897,MATH 20C,A03,093476,Briones; Jor-el Thomas Caparas,0,1,36,36
1657870292897,MATH 20C,B01,083762,Bach; Quang Tran,1,0,30,29
1657870298921,MATH 20D,A01,083765,Tran; Brian Kha,5,0,30,25
1657870298921,MATH 20D,A02,083766,Tran; Brian Kha,5,0,30,25
1657870298921,MATH 20D,A03,083767,Tran; Brian Kha,5,0,30,25
1657870304945,MATH 20E,A01,083771,Ganguly; Soumya,10,0,32,22
1657870304945,MATH 20E,A02,083772,Ganguly; Soumya,6,0,32,26
1657870304945,MATH 20E,B01,083773,Ciotti; Benjamin,20,0,35,15
1657870304945,MATH 20E,B02,083774,Ciotti; Benjamin,18,0,35,17
1657870310976,MATH 103A,A01,083777,Greenfeld; Be'Eri,3,0,36,33
1657870310976,MATH 103A,A02,083778,Greenfeld; Be'Eri,5,0,36,31
1657870310976,MATH 103A,A03,093561,Greenfeld; Be'Eri,6,0,36,30
1657870310976,MATH 103A,B01,083779,Greenfeld; Be'Eri,7,0,36,29
1657870310976,MATH 103A,B02,083780,Greenfeld; Be'Eri,4,0,36,32
1657870310976,MATH 103A,B03,093562,Greenfeld; Be'Eri,3,0,36,33
1657870317003,MATH 105,A01,085443,Carter; Anne Toulson,15,0,35,20
1657870317003,MATH 105,A02,093477,Carter; Anne Toulson,20,0,35,15
1657870323027,MATH 109,A01,083213,Ganzberger; Geoffrey Michael,3,0,34,31
1657870323027,MATH 109,A02,083214,Ganzberger; Geoffrey Michael,4,0,34,30
1657870323027,MATH 109,A03,093478,Ganzberger; Geoffrey Michael,2,0,34,32
1657870323027,MATH 109,B01,083215,Ganzberger; Geoffrey Michael,1,0,32,31
1657870323027,MATH 109,B02,083216,Ganzberger; Geoffrey Michael,2,0,32,30
1657870323027,MATH 109,B03,093479,Ganzberger; Geoffrey Michael,8,0,32,24
1657870329059,MATH 142A,A01,083219,Chow; Bennett,7,0,32,25
1657870329059,MATH 142A,A02,083220,Chow; Bennett,10,0,32,22
1657870329059,MATH 142A,A03,093480,Chow; Bennett,9,0,32,23
1657870329059,MATH 142A,B03,093481,Chow; Bennett,8,0,32,24
1657870329059,MATH 142A,B04,093558,Chow; Bennett,13,0,32,19
1657870329059,MATH 142A,B05,093559,Chow; Bennett,7,0,32,25
1657870335085,MATH 193A,A01,083224,Rotar; Vladimir,8,0,34,26
1657870335085,MATH 193A,A02,083225,Rotar; Vladimir,10,0,34,24
1657870335085,MATH 193A,A03,083781,Rotar; Vladimir,5,0,34,29
1657870335085,MATH 193A,A04,083782,Rotar; Vladimir,11,0,34,23
1657870335085,MATH 193A,A05,093482,Rotar; Vladimir,10,0,34,24
1657870341111,MATH 197,001,091859,McAuley; Julian John,9999,0,9999,0
1657870341111,MATH 197,002,095566,Kedlaya; Kiran S.,9997,0,9999,2
1657870341111,MATH 197,003,095567,Xiao; Ming,9999,0,9999,0
1657870341111,MATH 197,004,095571,Perols; Johan Lars,9998,0,9999,1
1657870348179,COGS 9,A01,083615,Shannon; Kyle Michael,10,0,75,65
1657870354208,COGS 11,A01,083617,Boyle; Mary E. T.,23,0,48,25
1657870360234,COGS 13,A01,083071,Bastos; Amalia Pinkusfeld,11,0,71,60
1657870366265,COGS 14A,A01,092681,Semenuks; Arturs,5,1,100,95
1657870372289,COGS 14B,A01,083073,Cheng; Tzu-Han,6,0,63,57
1657870378320,COGS 17,A01,092677,Semenuks; Arturs,6,0,81,75
1657870384344,COGS 100,A01,083619,Allen; Michael Gordon,17,0,70,53
1657870390368,COGS 101A,A01,083621,Davis; Joshua Daniel,9,0,68,59
1657870396392,COGS 101B,A01,091572,Allen; Michael Gordon,12,0,65,53
1657870402417,COGS 101C,A01,083625,Delgado; Tania,17,0,35,18
1657870408447,COGS 107A,A01,083627,Boyle; Mary E. T.,14,0,60,46
1657870414478,COGS 118A,A01,083075,Gupta; Anjum,21,0,76,55
1657870420504,CSE 3,A50,083646,Miranda; Gregory Joseph,24,0,50,26
1657870426529,CSE 8A,A50,083650,Miranda; Gregory Joseph,17,1,56,39
1657870432552,CSE 11,A01,083080,Cao; Yingjun,6,15,40,34
1657870438577,CSE 12,A01,083652,Krause-Levy; Sophia Louisa,30,1,120,90
1657870444608,CSE 15L,A01,083654,Morris; Justin Loren,9,0,50,41
1657870444608,CSE 15L,A02,083655,Morris; Justin Loren,10,0,50,40
1657870450638,CSE 20,A01,083657,Tran; Khoa Dang,39,0,80,41
1657870456663,CSE 21,A01,095574,Bach; Quang Tran,22,0,48,26
1657870462689,CSE 30,A01,083084,Eldon; John,6,0,80,74
1657870462689,CSE 30,B01,095061,Bhaskar; Nishant,9,0,50,41
1657870468714,CSE 100,A01,083659,Cao; Yingjun,5,4,70,65
1657870474742,CSE 134B,A01,083661,Powell; Thomas Allan,24,0,100,76
1657870480771,CSE 140,A01,083663,Gungor; Onat,15,0,85,70
1657870486793,CSE 140L,A01,083088,Eldon; John,23,0,100,77
1657870492821,CSE 175,A01,083665,Kumar; Rakesh,3,0,25,22
1657870498856,CSE 190,A00,092507,Dubnov; Shlomo,8,0,20,12
1657870504887,ECE 45,A01,083139,Congero; Spencer William,6,0,75,69
1657870510914,ECE 65,A50,083695,Saad; Andrew S,12,0,30,18
1657870510914,ECE 65,A51,095125,Saad; Andrew S,24,0,26,2
1657870516940,ECE 109,A01,091882,Touri; Behrouz,20,0,70,50
1657870522964,ECE 180,A00,083140,Abi Samra; Nicholas Camill,1,0,30,29
1657870522964,ECE 180,B00,083141,Abi Samra; Nicholas Camill,0,0,30,30
1657870528993,MATH 10A,A01,083735,Patchell; Gregory David,2,0,30,28
1657870528993,MATH 10A,A02,083736,Patchell; Gregory David,20,0,30,10
1657870528993,MATH 10A,A03,083737,Patchell; Gregory David,16,0,30,14
1657870535030,MATH 10B,A01,083207,Lim; Seonhee,8,0,34,26
1657870535030,MATH 10B,A02,083208,Lim; Seonhee,10,0,35,25
1657870535030,MATH 10B,A03,093472,Lim; Seonhee,7,0,34,27
1657870535030,MATH 10B,B01,083739,Sinha; Shubham,14,0,30,16
1657870541070,MATH 18,A01,083743,Cinel; Cameron Alexander,9,0,30,21
1657870541070,MATH 18,A02,083744,Cinel; Cameron Alexander,18,0,30,12
1657870541070,MATH 18,A03,083745,Cinel; Cameron Alexander,10,0,30,20
1657870541070,MATH 18,B01,083748,Rideout; David Porter,5,0,37,32
1657870541070,MATH 18,B02,083749,Rideout; David Porter,5,0,36,31
1657870541070,MATH 18,B03,083750,Rideout; David Porter,3,0,37,34
1657870541070,MATH 18,B04,083751,Rideout; David Porter,6,0,36,30
1657870541070,MATH 18,B05,093473,Rideout; David Porter,6,0,36,30
1657870541070,MATH 18,B06,093474,Rideout; David Porter,6,0,36,30
1657870547100,MATH 20A,A01,083754,Zheng; Zequn,14,0,40,26
1657870553126,MATH 20B,A01,083756,Briones; Jor-el Thomas Caparas,4,0,36,32
1657870553126,MATH 20B,A02,083757,Briones; Jor-el Thomas Caparas,1,0,36,35
1657870553126,MATH 20B,A03,093475,Briones; Jor-el Thomas Caparas,2,0,36,34
1657870559163,MATH 20C,A01,083760,Briones; Jor-el Thomas Caparas,1,0,35,34
1657870559163,MATH 20C,A02,083761,Briones; Jor-el Thomas Caparas,8,0,35,27
1657870559163,MATH 20C,A03,093476,Briones; Jor-el Thomas Caparas,0,1,36,36
1657870559163,MATH 20C,B01,083762,Bach; Quang Tran,1,0,30,29
1657870565199,MATH 20D,A01,083765,Tran; Brian Kha,5,0,30,25
1657870565199,MATH 20D,A02,083766,Tran; Brian Kha,5,0,30,25
1657870565199,MATH 20D,A03,083767,Tran; Brian Kha,5,0,30,25
1657870571225,MATH 20E,A01,083771,Ganguly; Soumya,10,0,32,22
1657870571225,MATH 20E,A02,083772,Ganguly; Soumya,6,0,32,26
1657870571225,MATH 20E,B01,083773,Ciotti; Benjamin,20,0,35,15
1657870571225,MATH 20E,B02,083774,Ciotti; Benjamin,18,0,35,17
1657870577250,MATH 103A,A01,083777,Greenfeld; Be'Eri,3,0,36,33
1657870577250,MATH 103A,A02,083778,Greenfeld; Be'Eri,5,0,36,31
1657870577250,MATH 103A,A03,093561,Greenfeld; Be'Eri,6,0,36,30
1657870577250,MATH 103A,B01,083779,Greenfeld; Be'Eri,7,0,36,29
1657870577250,MATH 103A,B02,083780,Greenfeld; Be'Eri,4,0,36,32
1657870577250,MATH 103A,B03,093562,Greenfeld; Be'Eri,3,0,36,33
1657870583280,MATH 105,A01,085443,Carter; Anne Toulson,15,0,35,20
1657870583280,MATH 105,A02,093477,Carter; Anne Toulson,20,0,35,15
1657870589305,MATH 109,A01,083213,Ganzberger; Geoffrey Michael,3,0,34,31
1657870589305,MATH 109,A02,083214,Ganzberger; Geoffrey Michael,4,0,34,30
1657870589305,MATH 109,A03,093478,Ganzberger; Geoffrey Michael,2,0,34,32
1657870589305,MATH 109,B01,083215,Ganzberger; Geoffrey Michael,1,0,32,31
1657870589305,MATH 109,B02,083216,Ganzberger; Geoffrey Michael,2,0,32,30
1657870589305,MATH 109,B03,093479,Ganzberger; Geoffrey Michael,8,0,32,24
1657870595342,MATH 142A,A01,083219,Chow; Bennett,7,0,32,25
1657870595342,MATH 142A,A02,083220,Chow; Bennett,10,0,32,22
1657870595342,MATH 142A,A03,093480,Chow; Bennett,9,0,32,23
1657870595342,MATH 142A,B03,093481,Chow; Bennett,8,0,32,24
1657870595342,MATH 142A,B04,093558,Chow; Bennett,13,0,32,19
1657870595342,MATH 142A,B05,093559,Chow; Bennett,7,0,32,25
1657870601365,MATH 193A,A01,083224,Rotar; Vladimir,8,0,34,26
1657870601365,MATH 193A,A02,083225,Rotar; Vladimir,10,0,34,24
1657870601365,MATH 193A,A03,083781,Rotar; Vladimir,5,0,34,29
1657870601365,MATH 193A,A04,083782,Rotar; Vladimir,11,0,34,23
1657870601365,MATH 193A,A05,093482,Rotar; Vladimir,10,0,34,24
1657870607391,MATH 197,001,091859,McAuley; Julian John,9999,0,9999,0
1657870607391,MATH 197,002,095566,Kedlaya; Kiran S.,9997,0,9999,2
1657870607391,MATH 197,003,095567,Xiao; Ming,9999,0,9999,0
1657870607391,MATH 197,004,095571,Perols; Johan Lars,9998,0,9999,1
1657870614480,COGS 9,A01,083615,Shannon; Kyle Michael,10,0,75,65
1657870620520,COGS 11,A01,083617,Boyle; Mary E. T.,23,0,48,25
1657870626545,COGS 13,A01,083071,Bastos; Amalia Pinkusfeld,11,0,71,60
1657870632574,COGS 14A,A01,092681,Semenuks; Arturs,5,1,100,95
1657870638597,COGS 14B,A01,083073,Cheng; Tzu-Han,6,0,63,57
1657870644620,COGS 17,A01,092677,Semenuks; Arturs,6,0,81,75
1657870650644,COGS 100,A01,083619,Allen; Michael Gordon,17,0,70,53
1657870656675,COGS 101A,A01,083621,Davis; Joshua Daniel,9,0,68,59
1657870662699,COGS 101B,A01,091572,Allen; Michael Gordon,12,0,65,53
1657870668728,COGS 101C,A01,083625,Delgado; Tania,17,0,35,18
1657870674753,COGS 107A,A01,083627,Boyle; Mary E. T.,14,0,60,46
1657870680776,COGS 118A,A01,083075,Gupta; Anjum,21,0,76,55
1657870686810,CSE 3,A50,083646,Miranda; Gregory Joseph,24,0,50,26
1657870692835,CSE 8A,A50,083650,Miranda; Gregory Joseph,17,1,56,39
1657870698858,CSE 11,A01,083080,Cao; Yingjun,6,15,40,34
1657870704889,CSE 12,A01,083652,Krause-Levy; Sophia Louisa,30,1,120,90
1657870710918,CSE 15L,A01,083654,Morris; Justin Loren,9,0,50,41
1657870710918,CSE 15L,A02,083655,Morris; Justin Loren,10,0,50,40
1657870716941,CSE 20,A01,083657,Tran; Khoa Dang,39,0,80,41
1657870722969,CSE 21,A01,095574,Bach; Quang Tran,22,0,48,26
1657870728993,CSE 30,A01,083084,Eldon; John,6,0,80,74
1657870728993,CSE 30,B01,095061,Bhaskar; Nishant,9,0,50,41
1657870735022,CSE 100,A01,083659,Cao; Yingjun,5,4,70,65
1657870741047,CSE 134B,A01,083661,Powell; Thomas Allan,24,0,100,76
1657870747145,CSE 140,A01,083663,Gungor; Onat,15,0,85,70
1657870753173,CSE 140L,A01,083088,Eldon; John,23,0,100,77
1657870759198,CSE 175,A01,083665,Kumar; Rakesh,3,0,25,22
1657870765222,CSE 190,A00,092507,Dubnov; Shlomo,8,0,20,12
1657870771256,ECE 45,A01,083139,Congero; Spencer William,6,0,75,69
1657870777282,ECE 65,A50,083695,Saad; Andrew S,12,0,30,18
1657870777282,ECE 65,A51,095125,Saad; Andrew S,24,0,26,2
1657870783307,ECE 109,A01,091882,Touri; Behrouz,20,0,70,50
1657870789334,ECE 180,A00,083140,Abi Samra; Nicholas Camill,1,0,30,29
1657870789334,ECE 180,B00,083141,Abi Samra; Nicholas Camill,0,0,30,30
1657870795361,MATH 10A,A01,083735,Patchell; Gregory David,2,0,30,28
1657870795361,MATH 10A,A02,083736,Patchell; Gregory David,20,0,30,10
1657870795361,MATH 10A,A03,083737,Patchell; Gregory David,16,0,30,14
1657870801390,MATH 10B,A01,083207,Lim; Seonhee,8,0,34,26
1657870801390,MATH 10B,A02,083208,Lim; Seonhee,10,0,35,25
1657870801390,MATH 10B,A03,093472,Lim; Seonhee,7,0,34,27
1657870801390,MATH 10B,B01,083739,Sinha; Shubham,14,0,30,16
1657870807419,MATH 18,A01,083743,Cinel; Cameron Alexander,9,0,30,21
1657870807419,MATH 18,A02,083744,Cinel; Cameron Alexander,18,0,30,12
1657870807419,MATH 18,A03,083745,Cinel; Cameron Alexander,10,0,30,20
1657870807419,MATH 18,B01,083748,Rideout; David Porter,5,0,37,32
1657870807419,MATH 18,B02,083749,Rideout; David Porter,5,0,36,31
1657870807419,MATH 18,B03,083750,Rideout; David Porter,3,0,37,34
1657870807419,MATH 18,B04,083751,Rideout; David Porter,6,0,36,30
1657870807419,MATH 18,B05,093473,Rideout; David Porter,6,0,36,30
1657870807419,MATH 18,B06,093474,Rideout; David Porter,6,0,36,30
1657870813448,MATH 20A,A01,083754,Zheng; Zequn,14,0,40,26
1657870819474,MATH 20B,A01,083756,Briones; Jor-el Thomas Caparas,4,0,36,32
1657870819474,MATH 20B,A02,083757,Briones; Jor-el Thomas Caparas,1,0,36,35
1657870819474,MATH 20B,A03,093475,Briones; Jor-el Thomas Caparas,2,0,36,34
1657870825507,MATH 20C,A01,083760,Briones; Jor-el Thomas Caparas,1,0,35,34
1657870825507,MATH 20C,A02,083761,Briones; Jor-el Thomas Caparas,8,0,35,27
1657870825507,MATH 20C,A03,093476,Briones; Jor-el Thomas Caparas,0,1,36,36
1657870825507,MATH 20C,B01,083762,Bach; Quang Tran,1,0,30,29
1657870831536,MATH 20D,A01,083765,Tran; Brian Kha,5,0,30,25
1657870831536,MATH 20D,A02,083766,Tran; Brian Kha,5,0,30,25
1657870831536,MATH 20D,A03,083767,Tran; Brian Kha,5,0,30,25
1657870837575,MATH 20E,A01,083771,Ganguly; Soumya,10,0,32,22
1657870837575,MATH 20E,A02,083772,Ganguly; Soumya,6,0,32,26
1657870837575,MATH 20E,B01,083773,Ciotti; Benjamin,20,0,35,15
1657870837575,MATH 20E,B02,083774,Ciotti; Benjamin,18,0,35,17
1657870843602,MATH 103A,A01,083777,Greenfeld; Be'Eri,3,0,36,33
1657870843602,MATH 103A,A02,083778,Greenfeld; Be'Eri,5,0,36,31
1657870843602,MATH 103A,A03,093561,Greenfeld; Be'Eri,6,0,36,30
1657870843602,MATH 103A,B01,083779,Greenfeld; Be'Eri,7,0,36,29
1657870843602,MATH 103A,B02,083780,Greenfeld; Be'Eri,4,0,36,32
1657870843602,MATH 103A,B03,093562,Greenfeld; Be'Eri,3,0,36,33
1657870849627,MATH 105,A01,085443,Carter; Anne Toulson,15,0,35,20
1657870849627,MATH 105,A02,093477,Carter; Anne Toulson,20,0,35,15
1657870855652,MATH 109,A01,083213,Ganzberger; Geoffrey Michael,3,0,34,31
1657870855652,MATH 109,A02,083214,Ganzberger; Geoffrey Michael,4,0,34,30
1657870855652,MATH 109,A03,093478,Ganzberger; Geoffrey Michael,2,0,34,32
1657870855652,MATH 109,B01,083215,Ganzberger; Geoffrey Michael,1,0,32,31
1657870855652,MATH 109,B02,083216,Ganzberger; Geoffrey Michael,2,0,32,30
1657870855652,MATH 109,B03,093479,Ganzberger; Geoffrey Michael,8,0,32,24
1657870861683,MATH 142A,A01,083219,Chow; Bennett,7,0,32,25
1657870861683,MATH 142A,A02,083220,Chow; Bennett,10,0,32,22
1657870861683,MATH 142A,A03,093480,Chow; Bennett,9,0,32,23
1657870861683,MATH 142A,B03,093481,Chow; Bennett,8,0,32,24
1657870861683,MATH 142A,B04,093558,Chow; Bennett,13,0,32,19
1657870861683,MATH 142A,B05,093559,Chow; Bennett,7,0,32,25
1657870867715,MATH 193A,A01,083224,Rotar; Vladimir,8,0,34,26
1657870867715,MATH 193A,A02,083225,Rotar; Vladimir,10,0,34,24
1657870867715,MATH 193A,A03,083781,Rotar; Vladimir,5,0,34,29
1657870867715,MATH 193A,A04,083782,Rotar; Vladimir,11,0,34,23
1657870867715,MATH 193A,A05,093482,Rotar; Vladimir,10,0,34,24
1657870873741,MATH 197,001,091859,McAuley; Julian John,9999,0,9999,0
1657870873741,MATH 197,002,095566,Kedlaya; Kiran S.,9997,0,9999,2
1657870873741,MATH 197,003,095567,Xiao; Ming,9999,0,9999,0
1657870873741,MATH 197,004,095571,Perols; Johan Lars,9998,0,9999,1
1657870880831,COGS 9,A01,083615,Shannon; Kyle Michael,10,0,75,65
1657870886862,COGS 11,A01,083617,Boyle; Mary E. T.,23,0,48,25
1657870892892,COGS 13,A01,083071,Bastos; Amalia Pinkusfeld,11,0,71,60
1657870898920,COGS 14A,A01,092681,Semenuks; Arturs,5,1,100,95
1657870904955,COGS 14B,A01,083073,Cheng; Tzu-Han,6,0,63,57
1657870910985,COGS 17,A01,092677,Semenuks; Arturs,6,0,81,75
1657870917014,COGS 100,A01,083619,Allen; Michael Gordon,17,0,70,53
1657870923038,COGS 101A,A01,083621,Davis; Joshua Daniel,9,0,68,59
1657870929065,COGS 101B,A01,091572,Allen; Michael Gordon,12,0,65,53
1657870935091,COGS 101C,A01,083625,Delgado; Tania,17,0,35,18
1657870941121,COGS 107A,A01,083627,Boyle; Mary E. T.,14,0,60,46
1657870947150,COGS 118A,A01,083075,Gupta; Anjum,21,0,76,55
1657870953187,CSE 3,A50,083646,Miranda; Gregory Joseph,24,0,50,26
1657870959212,CSE 8A,A50,083650,Miranda; Gregory Joseph,17,1,56,39
1657870965238,CSE 11,A01,083080,Cao; Yingjun,6,15,40,34
1657870971262,CSE 12,A01,083652,Krause-Levy; Sophia Louisa,30,1,120,90
1657870977291,CSE 15L,A01,083654,Morris; Justin Loren,9,0,50,41
1657870977291,CSE 15L,A02,083655,Morris; Justin Loren,10,0,50,40
1657870983315,CSE 20,A01,083657,Tran; Khoa Dang,39,0,80,41
1657870989342,CSE 21,A01,095574,Bach; Quang Tran,22,0,48,26
1657870995366,CSE 30,A01,083084,Eldon; John,6,0,80,74
1657870995366,CSE 30,B01,095061,Bhaskar; Nishant,9,0,50,41
1657871001390,CSE 100,A01,083659,Cao; Yingjun,5,4,70,65
1657871007416,CSE 134B,A01,083661,Powell; Thomas Allan,24,0,100,76
1657871013445,CSE 140,A01,083663,Gungor; Onat,15,0,85,70
1657871019475,CSE 140L,A01,083088,Eldon; John,23,0,100,77
1657871025502,CSE 175,A01,083665,Kumar; Rakesh,3,0,25,22
1657871031532,CSE 190,A00,092507,Dubnov; Shlomo,8,0,20,12
1657871037567,ECE 45,A01,083139,Congero; Spencer William,6,0,75,69
1657871043600,ECE 65,A50,083695,Saad; Andrew S,12,0,30,18
1657871043600,ECE 65,A51,095125,Saad; Andrew S,24,0,26,2
1657871049632,ECE 109,A01,091882,Touri; Behrouz,20,0,70,50
1657871055662,ECE 180,A00,083140,Abi Samra; Nicholas Camill,1,0,30,29
1657871055662,ECE 180,B00,083141,Abi Samra; Nicholas Camill,0,0,30,30
1657871061688,MATH 10A,A01,083735,Patchell; Gregory David,2,0,30,28
1657871061688,MATH 10A,A02,083736,Patchell; Gregory David,20,0,30,10
1657871061688,MATH 10A,A03,083737,Patchell; Gregory David,16,0,30,14
1657871067727,MATH 10B,A01,083207,Lim; Seonhee,8,0,34,26
1657871067727,MATH 10B,A02,083208,Lim; Seonhee,10,0,35,25
1657871067727,MATH 10B,A03,093472,Lim; Seonhee,7,0,34,27
1657871067727,MATH 10B,B01,083739,Sinha; Shubham,14,0,30,16
1657871073757,MATH 18,A01,083743,Cinel; Cameron Alexander,9,0,30,21
1657871073757,MATH 18,A02,083744,Cinel; Cameron Alexander,18,0,30,12
1657871073757,MATH 18,A03,083745,Cinel; Cameron Alexander,10,0,30,20
1657871073757,MATH 18,B01,083748,Rideout; David Porter,5,0,37,32
1657871073757,MATH 18,B02,083749,Rideout; David Porter,5,0,36,31
1657871073757,MATH 18,B03,083750,Rideout; David Porter,3,0,37,34
1657871073757,MATH 18,B04,083751,Rideout; David Porter,6,0,36,30
1657871073757,MATH 18,B05,093473,Rideout; David Porter,6,0,36,30
1657871073757,MATH 18,B06,093474,Rideout; David Porter,6,0,36,30
1657871079782,MATH 20A,A01,083754,Zheng; Zequn,14,0,40,26
1657871085807,MATH 20B,A01,083756,Briones; Jor-el Thomas Caparas,4,0,36,32
1657871085807,MATH 20B,A02,083757,Briones; Jor-el Thomas Caparas,1,0,36,35
1657871085807,MATH 20B,A03,093475,Briones; Jor-el Thomas Caparas,2,0,36,34
1657871091834,MATH 20C,A01,083760,Briones; Jor-el Thomas Caparas,1,0,35,34
1657871091834,MATH 20C,A02,083761,Briones; Jor-el Thomas Caparas,8,0,35,27
1657871091834,MATH 20C,A03,093476,Briones; Jor-el Thomas Caparas,0,1,36,36
1657871091834,MATH 20C,B01,083762,Bach; Quang Tran,1,0,30,29
1657871097859,MATH 20D,A01,083765,Tran; Brian Kha,5,0,30,25
1657871097859,MATH 20D,A02,083766,Tran; Brian Kha,5,0,30,25
1657871097859,MATH 20D,A03,083767,Tran; Brian Kha,5,0,30,25
1657871103890,MATH 20E,A01,083771,Ganguly; Soumya,10,0,32,22
1657871103890,MATH 20E,A02,083772,Ganguly; Soumya,6,0,32,26
1657871103890,MATH 20E,B01,083773,Ciotti; Benjamin,20,0,35,15
1657871103890,MATH 20E,B02,083774,Ciotti; Benjamin,18,0,35,17
1657871109925,MATH 103A,A01,083777,Greenfeld; Be'Eri,3,0,36,33
1657871109925,MATH 103A,A02,083778,Greenfeld; Be'Eri,5,0,36,31
1657871109925,MATH 103A,A03,093561,Greenfeld; Be'Eri,6,0,36,30
1657871109925,MATH 103A,B01,083779,Greenfeld; Be'Eri,7,0,36,29
1657871109925,MATH 103A,B02,083780,Greenfeld; Be'Eri,4,0,36,32
1657871109925,MATH 103A,B03,093562,Greenfeld; Be'Eri,3,0,36,33
1657871115951,MATH 105,A01,085443,Carter; Anne Toulson,15,0,35,20
1657871115951,MATH 105,A02,093477,Carter; Anne Toulson,20,0,35,15
1657871121985,MATH 109,A01,083213,Ganzberger; Geoffrey Michael,3,0,34,31
1657871121985,MATH 109,A02,083214,Ganzberger; Geoffrey Michael,4,0,34,30
1657871121985,MATH 109,A03,093478,Ganzberger; Geoffrey Michael,2,0,34,32
1657871121985,MATH 109,B01,083215,Ganzberger; Geoffrey Michael,1,0,32,31
1657871121985,MATH 109,B02,083216,Ganzberger; Geoffrey Michael,2,0,32,30
1657871121985,MATH 109,B03,093479,Ganzberger; Geoffrey Michael,8,0,32,24
1657871128015,MATH 142A,A01,083219,Chow; Bennett,7,0,32,25
1657871128015,MATH 142A,A02,083220,Chow; Bennett,10,0,32,22
1657871128015,MATH 142A,A03,093480,Chow; Bennett,9,0,32,23
1657871128015,MATH 142A,B03,093481,Chow; Bennett,8,0,32,24
1657871128015,MATH 142A,B04,093558,Chow; Bennett,13,0,32,19
1657871128015,MATH 142A,B05,093559,Chow; Bennett,7,0,32,25
1657871134042,MATH 193A,A01,083224,Rotar; Vladimir,8,0,34,26
1657871134042,MATH 193A,A02,083225,Rotar; Vladimir,10,0,34,24
1657871134042,MATH 193A,A03,083781,Rotar; Vladimir,5,0,34,29
1657871134042,MATH 193A,A04,083782,Rotar; Vladimir,11,0,34,23
1657871134042,MATH 193A,A05,093482,Rotar; Vladimir,10,0,34,24
1657871140069,MATH 197,001,091859,McAuley; Julian John,9999,0,9999,0
1657871140069,MATH 197,002,095566,Kedlaya; Kiran S.,9997,0,9999,2
1657871140069,MATH 197,003,095567,Xiao; Ming,9999,0,9999,0
1657871140069,MATH 197,004,095571,Perols; Johan Lars,9998,0,9999,1
1657871147155,COGS 9,A01,083615,Shannon; Kyle Michael,10,0,75,65
1657871153182,COGS 11,A01,083617,Boyle; Mary E. T.,23,0,48,25
1657871159208,COGS 13,A01,083071,Bastos; Amalia Pinkusfeld,11,0,71,60
1657871165247,COGS 14A,A01,092681,Semenuks; Arturs,5,1,100,95
1657871171272,COGS 14B,A01,083073,Cheng; Tzu-Han,6,0,63,57
1657871177304,COGS 17,A01,092677,Semenuks; Arturs,6,0,81,75
1657871183337,COGS 100,A01,083619,Allen; Michael Gordon,17,0,70,53
1657871189362,COGS 101A,A01,083621,Davis; Joshua Daniel,9,0,68,59
1657871195391,COGS 101B,A01,091572,Allen; Michael Gordon,12,0,65,53
1657871201428,COGS 101C,A01,083625,Delgado; Tania,17,0,35,18
1657871207461,COGS 107A,A01,083627,Boyle; Mary E. T.,14,0,60,46
1657871213486,COGS 118A,A01,083075,Gupta; Anjum,21,0,76,55
1657871219513,CSE 3,A50,083646,Miranda; Gregory Joseph,24,0,50,26
1657871225537,CSE 8A,A50,083650,Miranda; Gregory Joseph,17,1,56,39
1657871231561,CSE 11,A01,083080,Cao; Yingjun,6,15,40,34
1657871237585,CSE 12,A01,083652,Krause-Levy; Sophia Louisa,30,1,120,90
1657871243609,CSE 15L,A01,083654,Morris; Justin Loren,9,0,50,41
1657871243609,CSE 15L,A02,083655,Morris; Justin Loren,10,0,50,40
1657871249641,CSE 20,A01,083657,Tran; Khoa Dang,39,0,80,41
1657871255677,CSE 21,A01,095574,Bach; Quang Tran,22,0,48,26
1657871261707,CSE 30,A01,083084,Eldon; John,6,0,80,74
1657871261707,CSE 30,B01,095061,Bhaskar; Nishant,9,0,50,41
1657871267740,CSE 100,A01,083659,Cao; Yingjun,5,4,70,65
1657871273772,CSE 134B,A01,083661,Powell; Thomas Allan,24,0,100,76
1657871279797,CSE 140,A01,083663,Gungor; Onat,15,0,85,70
1657871285823,CSE 140L,A01,083088,Eldon; John,23,0,100,77
1657871291852,CSE 175,A01,083665,Kumar; Rakesh,3,0,25,22
1657871297876,CSE 190,A00,092507,Dubnov; Shlomo,8,0,20,12
1657871303915,ECE 45,A01,083139,Congero; Spencer William,6,0,75,69
1657871309946,ECE 65,A50,083695,Saad; Andrew S,12,0,30,18
1657871309946,ECE 65,A51,095125,Saad; Andrew S,24,0,26,2
1657871315969,ECE 109,A01,091882,Touri; Behrouz,20,0,70,50
1657871321995,ECE 180,A00,083140,Abi Samra; Nicholas Camill,1,0,30,29
1657871321995,ECE 180,B00,083141,Abi Samra; Nicholas Camill,0,0,30,30
1657871328024,MATH 10A,A01,083735,Patchell; Gregory David,2,0,30,28
1657871328024,MATH 10A,A02,083736,Patchell; Gregory David,20,0,30,10
1657871328024,MATH 10A,A03,083737,Patchell; Gregory David,16,0,30,14
1657871334054,MATH 10B,A01,083207,Lim; Seonhee,8,0,34,26
1657871334054,MATH 10B,A02,083208,Lim; Seonhee,10,0,35,25
1657871334054,MATH 10B,A03,093472,Lim; Seonhee,7,0,34,27
1657871334054,MATH 10B,B01,083739,Sinha; Shubham,14,0,30,16
1657871340085,MATH 18,A01,083743,Cinel; Cameron Alexander,9,0,30,21
1657871340085,MATH 18,A02,083744,Cinel; Cameron Alexander,18,0,30,12
1657871340085,MATH 18,A03,083745,Cinel; Cameron Alexander,10,0,30,20
1657871340085,MATH 18,B01,083748,Rideout; David Porter,5,0,37,32
1657871340085,MATH 18,B02,083749,Rideout; David Porter,5,0,36,31
1657871340085,MATH 18,B03,083750,Rideout; David Porter,3,0,37,34
1657871340085,MATH 18,B04,083751,Rideout; David Porter,6,0,36,30
1657871340085,MATH 18,B05,093473,Rideout; David Porter,6,0,36,30
1657871340085,MATH 18,B06,093474,Rideout; David Porter,6,0,36,30
1657871346182,MATH 20A,A01,083754,Zheng; Zequn,14,0,40,26
1657871352219,MATH 20B,A01,083756,Briones; Jor-el Thomas Caparas,4,0,36,32
1657871352219,MATH 20B,A02,083757,Briones; Jor-el Thomas Caparas,1,0,36,35
1657871352219,MATH 20B,A03,093475,Briones; Jor-el Thomas Caparas,2,0,36,34
1657871358267,MATH 20C,A01,083760,Briones; Jor-el Thomas Caparas,1,0,35,34
1657871358267,MATH 20C,A02,083761,Briones; Jor-el Thomas Caparas,8,0,35,27
1657871358267,MATH 20C,A03,093476,Briones; Jor-el Thomas Caparas,0,1,36,36
1657871358267,MATH 20C,B01,083762,Bach; Quang Tran,1,0,30,29
1657871364295,MATH 20D,A01,083765,Tran; Brian Kha,5,0,30,25
1657871364295,MATH 20D,A02,083766,Tran; Brian Kha,5,0,30,25
1657871364295,MATH 20D,A03,083767,Tran; Brian Kha,5,0,30,25
1657871370323,MATH 20E,A01,083771,Ganguly; Soumya,10,0,32,22
1657871370323,MATH 20E,A02,083772,Ganguly; Soumya,6,0,32,26
1657871370323,MATH 20E,B01,083773,Ciotti; Benjamin,20,0,35,15
1657871370323,MATH 20E,B02,083774,Ciotti; Benjamin,18,0,35,17
1657871376351,MATH 103A,A01,083777,Greenfeld; Be'Eri,3,0,36,33
1657871376351,MATH 103A,A02,083778,Greenfeld; Be'Eri,5,0,36,31
1657871376351,MATH 103A,A03,093561,Greenfeld; Be'Eri,6,0,36,30
1657871376351,MATH 103A,B01,083779,Greenfeld; Be'Eri,7,0,36,29
1657871376351,MATH 103A,B02,083780,Greenfeld; Be'Eri,4,0,36,32
1657871376351,MATH 103A,B03,093562,Greenfeld; Be'Eri,3,0,36,33
1657871382382,MATH 105,A01,085443,Carter; Anne Toulson,15,0,35,20
1657871382382,MATH 105,A02,093477,Carter; Anne Toulson,20,0,35,15
1657871388411,MATH 109,A01,083213,Ganzberger; Geoffrey Michael,3,0,34,31
1657871388411,MATH 109,A02,083214,Ganzberger; Geoffrey Michael,4,0,34,30
1657871388411,MATH 109,A03,093478,Ganzberger; Geoffrey Michael,2,0,34,32
1657871388411,MATH 109,B01,083215,Ganzberger; Geoffrey Michael,1,0,32,31
1657871388411,MATH 109,B02,083216,Ganzberger; Geoffrey Michael,2,0,32,30
1657871388411,MATH 109,B03,093479,Ganzberger; Geoffrey Michael,8,0,32,24
1657871394439,MATH 142A,A01,083219,Chow; Bennett,7,0,32,25
1657871394439,MATH 142A,A02,083220,Chow; Bennett,10,0,32,22
1657871394439,MATH 142A,A03,093480,Chow; Bennett,9,0,32,23
1657871394439,MATH 142A,B03,093481,Chow; Bennett,8,0,32,24
1657871394439,MATH 142A,B04,093558,Chow; Bennett,13,0,32,19
1657871394439,MATH 142A,B05,093559,Chow; Bennett,7,0,32,25
1657871400467,MATH 193A,A01,083224,Rotar; Vladimir,8,0,34,26
1657871400467,MATH 193A,A02,083225,Rotar; Vladimir,10,0,34,24
1657871400467,MATH 193A,A03,083781,Rotar; Vladimir,5,0,34,29
1657871400467,MATH 193A,A04,083782,Rotar; Vladimir,11,0,34,23
1657871400467,MATH 193A,A05,093482,Rotar; Vladimir,10,0,34,24
1657871406498,MATH 197,001,091859,McAuley; Julian John,9999,0,9999,0
1657871406498,MATH 197,002,095566,Kedlaya; Kiran S.,9997,0,9999,2
1657871406498,MATH 197,003,095567,Xiao; Ming,9999,0,9999,0
1657871406498,MATH 197,004,095571,Perols; Johan Lars,9998,0,9999,1
1657871413586,COGS 9,A01,083615,Shannon; Kyle Michael,10,0,75,65
1657871419613,COGS 11,A01,083617,Boyle; Mary E. T.,23,0,48,25
1657871425645,COGS 13,A01,083071,Bastos; Amalia Pinkusfeld,11,0,71,60
1657871431669,COGS 14A,A01,092681,Semenuks; Arturs,5,1,100,95
1657871437702,COGS 14B,A01,083073,Cheng; Tzu-Han,6,0,63,57
1657871443728,COGS 17,A01,092677,Semenuks; Arturs,6,0,81,75
1657871449759,COGS 100,A01,083619,Allen; Michael Gordon,17,0,70,53
1657871455783,COGS 101A,A01,083621,Davis; Joshua Daniel,9,0,68,59
1657871461811,COGS 101B,A01,091572,Allen; Michael Gordon,12,0,65,53
1657871467844,COGS 101C,A01,083625,Delgado; Tania,17,0,35,18
1657871473875,COGS 107A,A01,083627,Boyle; Mary E. T.,14,0,60,46
1657871479908,COGS 118A,A01,083075,Gupta; Anjum,21,0,76,55
1657871485934,CSE 3,A50,083646,Miranda; Gregory Joseph,24,0,50,26
1657871491965,CSE 8A,A50,083650,Miranda; Gregory Joseph,17,1,56,39
1657871497996,CSE 11,A01,083080,Cao; Yingjun,6,15,40,34
1657871504028,CSE 12,A01,083652,Krause-Levy; Sophia Louisa,30,1,120,90
1657871510052,CSE 15L,A01,083654,Morris; Justin Loren,9,0,50,41
1657871510052,CSE 15L,A02,083655,Morris; Justin Loren,10,0,50,40
1657871516078,CSE 20,A01,083657,Tran; Khoa Dang,39,0,80,41
1657871522105,CSE 21,A01,095574,Bach; Quang Tran,22,0,48,26
1657871528140,CSE 30,A01,083084,Eldon; John,6,0,80,74
1657871528140,CSE 30,B01,095061,Bhaskar; Nishant,9,0,50,41
1657871534165,CSE 100,A01,083659,Cao; Yingjun,5,4,70,65
1657871540190,CSE 134B,A01,083661,Powell; Thomas Allan,24,0,100,76
1657871546234,CSE 140,A01,083663,Gungor; Onat,15,0,85,70
1657871552258,CSE 140L,A01,083088,Eldon; John,23,0,100,77
1657871558303,CSE 175,A01,083665,Kumar; Rakesh,3,0,25,22
1657871564327,CSE 190,A00,092507,Dubnov; Shlomo,8,0,20,12
1657871570356,ECE 45,A01,083139,Congero; Spencer William,6,0,75,69
1657871576404,ECE 65,A50,083695,Saad; Andrew S,12,0,30,18
1657871576404,ECE 65,A51,095125,Saad; Andrew S,24,0,26,2
1657871582434,ECE 109,A01,091882,Touri; Behrouz,20,0,70,50
1657871588458,ECE 180,A00,083140,Abi Samra; Nicholas Camill,1,0,30,29
1657871588458,ECE 180,B00,083141,Abi Samra; Nicholas Camill,0,0,30,30
1657871594495,MATH 10A,A01,083735,Patchell; Gregory David,2,0,30,28
1657871594495,MATH 10A,A02,083736,Patchell; Gregory David,20,0,30,10
1657871594495,MATH 10A,A03,083737,Patchell; Gregory David,16,0,30,14
1657871600524,MATH 10B,A01,083207,Lim; Seonhee,8,0,34,26
1657871600524,MATH 10B,A02,083208,Lim; Seonhee,10,0,35,25
1657871600524,MATH 10B,A03,093472,Lim; Seonhee,7,0,34,27
1657871600524,MATH 10B,B01,083739,Sinha; Shubham,14,0,30,16
1657871606555,MATH 18,A01,083743,Cinel; Cameron Alexander,9,0,30,21
1657871606555,MATH 18,A02,083744,Cinel; Cameron Alexander,18,0,30,12
1657871606555,MATH 18,A03,083745,Cinel; Cameron Alexander,10,0,30,20
1657871606555,MATH 18,B01,083748,Rideout; David Porter,5,0,37,32
1657871606555,MATH 18,B02,083749,Rideout; David Porter,5,0,36,31
1657871606555,MATH 18,B03,083750,Rideout; David Porter,3,0,37,34
1657871606555,MATH 18,B04,083751,Rideout; David Porter,6,0,36,30
1657871606555,MATH 18,B05,093473,Rideout; David Porter,6,0,36,30
1657871606555,MATH 18,B06,093474,Rideout; David Porter,6,0,36,30
1657871612581,MATH 20A,A01,083754,Zheng; Zequn,14,0,40,26
1657871618618,MATH 20B,A01,083756,Briones; Jor-el Thomas Caparas,4,0,36,32
1657871618618,MATH 20B,A02,083757,Briones; Jor-el Thomas Caparas,1,0,36,35
1657871618618,MATH 20B,A03,093475,Briones; Jor-el Thomas Caparas,2,0,36,34
1657871624656,MATH 20C,A01,083760,Briones; Jor-el Thomas Caparas,1,0,35,34
1657871624656,MATH 20C,A02,083761,Briones; Jor-el Thomas Caparas,8,0,35,27
1657871624656,MATH 20C,A03,093476,Briones; Jor-el Thomas Caparas,0,1,36,36
1657871624656,MATH 20C,B01,083762,Bach; Quang Tran,1,0,30,29
1657871630683,MATH 20D,A01,083765,Tran; Brian Kha,5,0,30,25
1657871630683,MATH 20D,A02,083766,Tran; Brian Kha,5,0,30,25
1657871630683,MATH 20D,A03,083767,Tran; Brian Kha,5,0,30,25
1657871636709,MATH 20E,A01,083771,Ganguly; Soumya,10,0,32,22
1657871636709,MATH 20E,A02,083772,Ganguly; Soumya,6,0,32,26
1657871636709,MATH 20E,B01,083773,Ciotti; Benjamin,20,0,35,15
1657871636709,MATH 20E,B02,083774,Ciotti; Benjamin,18,0,35,17
1657871642759,MATH 103A,A01,083777,Greenfeld; Be'Eri,3,0,36,33
1657871642759,MATH 103A,A02,083778,Greenfeld; Be'Eri,5,0,36,31
1657871642759,MATH 103A,A03,093561,Greenfeld; Be'Eri,6,0,36,30
1657871642759,MATH 103A,B01,083779,Greenfeld; Be'Eri,7,0,36,29
1657871642759,MATH 103A,B02,083780,Greenfeld; Be'Eri,4,0,36,32
1657871642759,MATH 103A,B03,093562,Greenfeld; Be'Eri,3,0,36,33
1657871648784,MATH 105,A01,085443,Carter; Anne Toulson,15,0,35,20
1657871648784,MATH 105,A02,093477,Carter; Anne Toulson,20,0,35,15
1657871654810,MATH 109,A01,083213,Ganzberger; Geoffrey Michael,3,0,34,31
1657871654810,MATH 109,A02,083214,Ganzberger; Geoffrey Michael,4,0,34,30
1657871654810,MATH 109,A03,093478,Ganzberger; Geoffrey Michael,2,0,34,32
1657871654810,MATH 109,B01,083215,Ganzberger; Geoffrey Michael,1,0,32,31
1657871654810,MATH 109,B02,083216,Ganzberger; Geoffrey Michael,2,0,32,30
1657871654810,MATH 109,B03,093479,Ganzberger; Geoffrey Michael,8,0,32,24
1657871660840,MATH 142A,A01,083219,Chow; Bennett,7,0,32,25
1657871660840,MATH 142A,A02,083220,Chow; Bennett,10,0,32,22
1657871660840,MATH 142A,A03,093480,Chow; Bennett,9,0,32,23
1657871660840,MATH 142A,B03,093481,Chow; Bennett,8,0,32,24
1657871660840,MATH 142A,B04,093558,Chow; Bennett,13,0,32,19
1657871660840,MATH 142A,B05,093559,Chow; Bennett,7,0,32,25
1657871666865,MATH 193A,A01,083224,Rotar; Vladimir,8,0,34,26
1657871666865,MATH 193A,A02,083225,Rotar; Vladimir,10,0,34,24
1657871666865,MATH 193A,A03,083781,Rotar; Vladimir,5,0,34,29
1657871666865,MATH 193A,A04,083782,Rotar; Vladimir,11,0,34,23
1657871666865,MATH 193A,A05,093482,Rotar; Vladimir,10,0,34,24
1657871672891,MATH 197,001,091859,McAuley; Julian John,9999,0,9999,0
1657871672891,MATH 197,002,095566,Kedlaya; Kiran S.,9997,0,9999,2
1657871672891,MATH 197,003,095567,Xiao; Ming,9999,0,9999,0
1657871672891,MATH 197,004,095571,Perols; Johan Lars,9998,0,9999,1
1657871679958,COGS 9,A01,083615,Shannon; Kyle Michael,10,0,75,65
1657871685988,COGS 11,A01,083617,Boyle; Mary E. T.,23,0,48,25
1657871692020,COGS 13,A01,083071,Bastos; Amalia Pinkusfeld,11,0,71,60
1657871698045,COGS 14A,A01,092681,Semenuks; Arturs,5,1,100,95
1657871704069,COGS 14B,A01,083073,Cheng; Tzu-Han,6,0,63,57
1657871710104,COGS 17,A01,092677,Semenuks; Arturs,6,0,81,75
1657871716136,COGS 100,A01,083619,Allen; Michael Gordon,17,0,70,53
1657871722160,COGS 101A,A01,083621,Davis; Joshua Daniel,9,0,68,59
1657871728185,COGS 101B,A01,091572,Allen; Michael Gordon,12,0,65,53
1657871734214,COGS 101C,A01,083625,Delgado; Tania,17,0,35,18
1657871740238,COGS 107A,A01,083627,Boyle; Mary E. T.,14,0,60,46
1657871746263,COGS 118A,A01,083075,Gupta; Anjum,21,0,76,55
1657871752295,CSE 3,A50,083646,Miranda; Gregory Joseph,24,0,50,26
1657871758319,CSE 8A,A50,083650,Miranda; Gregory Joseph,17,1,56,39
1657871764342,CSE 11,A01,083080,Cao; Yingjun,6,15,40,34
1657871770373,CSE 12,A01,083652,Krause-Levy; Sophia Louisa,30,1,120,90
1657871776398,CSE 15L,A01,083654,Morris; Justin Loren,9,0,50,41
1657871776398,CSE 15L,A02,083655,Morris; Justin Loren,10,0,50,40
1657871782422,CSE 20,A01,083657,Tran; Khoa Dang,39,0,80,41
1657871788445,CSE 21,A01,095574,Bach; Quang Tran,22,0,48,26
1657871794469,CSE 30,A01,083084,Eldon; John,6,0,80,74
1657871794469,CSE 30,B01,095061,Bhaskar; Nishant,9,0,50,41
1657871800499,CSE 100,A01,083659,Cao; Yingjun,5,4,70,65
1657871806523,CSE 134B,A01,083661,Powell; Thomas Allan,24,0,100,76
1657871812553,CSE 140,A01,083663,Gungor; Onat,15,0,85,70
1657871818584,CSE 140L,A01,083088,Eldon; John,23,0,100,77
1657871824609,CSE 175,A01,083665,Kumar; Rakesh,3,0,25,22
1657871830635,CSE 190,A00,092507,Dubnov; Shlomo,8,0,20,12
1657871836662,ECE 45,A01,083139,Congero; Spencer William,6,0,75,69
1657871842696,ECE 65,A50,083695,Saad; Andrew S,12,0,30,18
1657871842696,ECE 65,A51,095125,Saad; Andrew S,24,0,26,2
1657871848726,ECE 109,A01,091882,Touri; Behrouz,20,0,70,50
1657871854757,ECE 180,A00,083140,Abi Samra; Nicholas Camill,1,0,30,29
1657871854757,ECE 180,B00,083141,Abi Samra; Nicholas Camill,0,0,30,30
1657871860782,MATH 10A,A01,083735,Patchell; Gregory David,2,0,30,28
1657871860782,MATH 10A,A02,083736,Patchell; Gregory David,20,0,30,10
1657871860782,MATH 10A,A03,083737,Patchell; Gregory David,16,0,30,14
1657871866808,MATH 10B,A01,083207,Lim; Seonhee,8,0,34,26
1657871866808,MATH 10B,A02,083208,Lim; Seonhee,10,0,35,25
1657871866808,MATH 10B,A03,093472,Lim; Seonhee,7,0,34,27
1657871866808,MATH 10B,B01,083739,Sinha; Shubham,14,0,30,16
1657871872845,MATH 18,A01,083743,Cinel; Cameron Alexander,9,0,30,21
1657871872845,MATH 18,A02,083744,Cinel; Cameron Alexander,18,0,30,12
1657871872845,MATH 18,A03,083745,Cinel; Cameron Alexander,10,0,30,20
1657871872845,MATH 18,B01,083748,Rideout; David Porter,5,0,37,32
1657871872845,MATH 18,B02,083749,Rideout; David Porter,5,0,36,31
1657871872845,MATH 18,B03,083750,Rideout; David Porter,3,0,37,34
1657871872845,MATH 18,B04,083751,Rideout; David Porter,6,0,36,30
1657871872845,MATH 18,B05,093473,Rideout; David Porter,6,0,36,30
1657871872845,MATH 18,B06,093474,Rideout; David Porter,6,0,36,30
1657871878872,MATH 20A,A01,083754,Zheng; Zequn,14,0,40,26
1657871884896,MATH 20B,A01,083756,Briones; Jor-el Thomas Caparas,4,0,36,32
1657871884896,MATH 20B,A02,083757,Briones; Jor-el Thomas Caparas,1,0,36,35
1657871884896,MATH 20B,A03,093475,Briones; Jor-el Thomas Caparas,2,0,36,34
1657871890920,MATH 20C,A01,083760,Briones; Jor-el Thomas Caparas,1,0,35,34
1657871890920,MATH 20C,A02,083761,Briones; Jor-el Thomas Caparas,8,0,35,27
1657871890920,MATH 20C,A03,093476,Briones; Jor-el Thomas Caparas,0,1,36,36
1657871890920,MATH 20C,B01,083762,Bach; Quang Tran,1,0,30,29
1657871896956,MATH 20D,A01,083765,Tran; Brian Kha,5,0,30,25
1657871896956,MATH 20D,A02,083766,Tran; Brian Kha,5,0,30,25
1657871896956,MATH 20D,A03,083767,Tran; Brian Kha,5,0,30,25
1657871902980,MATH 20E,A01,083771,Ganguly; Soumya,10,0,32,22
1657871902980,MATH 20E,A02,083772,Ganguly; Soumya,6,0,32,26
1657871902980,MATH 20E,B01,083773,Ciotti; Benjamin,20,0,35,15
1657871902980,MATH 20E,B02,083774,Ciotti; Benjamin,18,0,35,17
1657871909012,MATH 103A,A01,083777,Greenfeld; Be'Eri,3,0,36,33
1657871909012,MATH 103A,A02,083778,Greenfeld; Be'Eri,5,0,36,31
1657871909012,MATH 103A,A03,093561,Greenfeld; Be'Eri,6,0,36,30
1657871909012,MATH 103A,B01,083779,Greenfeld; Be'Eri,7,0,36,29
1657871909012,MATH 103A,B02,083780,Greenfeld; Be'Eri,4,0,36,32
1657871909012,MATH 103A,B03,093562,Greenfeld; Be'Eri,3,0,36,33
1657871915038,MATH 105,A01,085443,Carter; Anne Toulson,15,0,35,20
1657871915038,MATH 105,A02,093477,Carter; Anne Toulson,20,0,35,15
1657871921067,MATH 109,A01,083213,Ganzberger; Geoffrey Michael,3,0,34,31
1657871921067,MATH 109,A02,083214,Ganzberger; Geoffrey Michael,4,0,34,30
1657871921067,MATH 109,A03,093478,Ganzberger; Geoffrey Michael,2,0,34,32
1657871921067,MATH 109,B01,083215,Ganzberger; Geoffrey Michael,1,0,32,31
1657871921067,MATH 109,B02,083216,Ganzberger; Geoffrey Michael,2,0,32,30
1657871921067,MATH 109,B03,093479,Ganzberger; Geoffrey Michael,8,0,32,24
1657871927091,MATH 142A,A01,083219,Chow; Bennett,7,0,32,25
1657871927091,MATH 142A,A02,083220,Chow; Bennett,10,0,32,22
1657871927091,MATH 142A,A03,093480,Chow; Bennett,9,0,32,23
1657871927091,MATH 142A,B03,093481,Chow; Bennett,8,0,32,24
1657871927091,MATH 142A,B04,093558,Chow; Bennett,13,0,32,19
1657871927091,MATH 142A,B05,093559,Chow; Bennett,7,0,32,25
1657871933115,MATH 193A,A01,083224,Rotar; Vladimir,8,0,34,26
1657871933115,MATH 193A,A02,083225,Rotar; Vladimir,10,0,34,24
1657871933115,MATH 193A,A03,083781,Rotar; Vladimir,5,0,34,29
1657871933115,MATH 193A,A04,083782,Rotar; Vladimir,11,0,34,23
1657871933115,MATH 193A,A05,093482,Rotar; Vladimir,10,0,34,24
1657871939145,MATH 197,001,091859,McAuley; Julian John,9999,0,9999,0
1657871939145,MATH 197,002,095566,Kedlaya; Kiran S.,9997,0,9999,2
1657871939145,MATH 197,003,095567,Xiao; Ming,9999,0,9999,0
1657871939145,MATH 197,004,095571,Perols; Johan Lars,9998,0,9999,1
1657871946308,COGS 9,A01,083615,Shannon; Kyle Michael,10,0,75,65
1657871952334,COGS 11,A01,083617,Boyle; Mary E. T.,23,0,48,25
1657871958364,COGS 13,A01,083071,Bastos; Amalia Pinkusfeld,11,0,71,60
1657871964387,COGS 14A,A01,092681,Semenuks; Arturs,5,1,100,95
1657871970412,COGS 14B,A01,083073,Cheng; Tzu-Han,6,0,63,57
1657871976441,COGS 17,A01,092677,Semenuks; Arturs,6,0,81,75
1657871982465,COGS 100,A01,083619,Allen; Michael Gordon,17,0,70,53
1657871988491,COGS 101A,A01,083621,Davis; Joshua Daniel,9,0,68,59
1657871994514,COGS 101B,A01,091572,Allen; Michael Gordon,12,0,65,53
1657872000542,COGS 101C,A01,083625,Delgado; Tania,17,0,35,18
1657872006573,COGS 107A,A01,083627,Boyle; Mary E. T.,14,0,60,46
1657872012597,COGS 118A,A01,083075,Gupta; Anjum,21,0,76,55
1657872018626,CSE 3,A50,083646,Miranda; Gregory Joseph,24,0,50,26
1657872024653,CSE 8A,A50,083650,Miranda; Gregory Joseph,17,1,56,39
1657872030675,CSE 11,A01,083080,Cao; Yingjun,6,15,40,34
1657872036700,CSE 12,A01,083652,Krause-Levy; Sophia Louisa,30,1,120,90
1657872042723,CSE 15L,A01,083654,Morris; Justin Loren,9,0,50,41
1657872042723,CSE 15L,A02,083655,Morris; Justin Loren,10,0,50,40
1657872048752,CSE 20,A01,083657,Tran; Khoa Dang,39,0,80,41
1657872054781,CSE 21,A01,095574,Bach; Quang Tran,22,0,48,26
1657872060814,CSE 30,A01,083084,Eldon; John,6,0,80,74
1657872060814,CSE 30,B01,095061,Bhaskar; Nishant,9,0,50,41
1657872066836,CSE 100,A01,083659,Cao; Yingjun,5,4,70,65
1657872072866,CSE 134B,A01,083661,Powell; Thomas Allan,24,0,100,76
1657872078894,CSE 140,A01,083663,Gungor; Onat,15,0,85,70
1657872084928,CSE 140L,A01,083088,Eldon; John,23,0,100,77
1657872090961,CSE 175,A01,083665,Kumar; Rakesh,3,0,25,22
1657872096984,CSE 190,A00,092507,Dubnov; Shlomo,8,0,20,12
1657872103018,ECE 45,A01,083139,Congero; Spencer William,6,0,75,69
1657872109052,ECE 65,A50,083695,Saad; Andrew S,12,0,30,18
1657872109052,ECE 65,A51,095125,Saad; Andrew S,24,0,26,2
1657872115077,ECE 109,A01,091882,Touri; Behrouz,20,0,70,50
1657872121112,ECE 180,A00,083140,Abi Samra; Nicholas Camill,1,0,30,29
1657872121112,ECE 180,B00,083141,Abi Samra; Nicholas Camill,0,0,30,30
1657872127146,MATH 10A,A01,083735,Patchell; Gregory David,2,0,30,28
1657872127146,MATH 10A,A02,083736,Patchell; Gregory David,20,0,30,10
1657872127146,MATH 10A,A03,083737,Patchell; Gregory David,16,0,30,14
1657872133182,MATH 10B,A01,083207,Lim; Seonhee,8,0,34,26
1657872133182,MATH 10B,A02,083208,Lim; Seonhee,10,0,35,25
1657872133182,MATH 10B,A03,093472,Lim; Seonhee,7,0,34,27
1657872133182,MATH 10B,B01,083739,Sinha; Shubham,14,0,30,16
1657872139210,MATH 18,A01,083743,Cinel; Cameron Alexander,9,0,30,21
1657872139210,MATH 18,A02,083744,Cinel; Cameron Alexander,18,0,30,12
1657872139210,MATH 18,A03,083745,Cinel; Cameron Alexander,10,0,30,20
1657872139210,MATH 18,B01,083748,Rideout; David Porter,5,0,37,32
1657872139210,MATH 18,B02,083749,Rideout; David Porter,5,0,36,31
1657872139210,MATH 18,B03,083750,Rideout; David Porter,3,0,37,34
1657872139210,MATH 18,B04,083751,Rideout; David Porter,6,0,36,30
1657872139210,MATH 18,B05,093473,Rideout; David Porter,6,0,36,30
1657872139210,MATH 18,B06,093474,Rideout; David Porter,6,0,36,30
1657872145234,MATH 20A,A01,083754,Zheng; Zequn,14,0,40,26
1657872151260,MATH 20B,A01,083756,Briones; Jor-el Thomas Caparas,4,0,36,32
1657872151260,MATH 20B,A02,083757,Briones; Jor-el Thomas Caparas,1,0,36,35
1657872151260,MATH 20B,A03,093475,Briones; Jor-el Thomas Caparas,2,0,36,34
1657872157291,MATH 20C,A01,083760,Briones; Jor-el Thomas Caparas,1,0,35,34
1657872157291,MATH 20C,A02,083761,Briones; Jor-el Thomas Caparas,8,0,35,27
1657872157291,MATH 20C,A03,093476,Briones; Jor-el Thomas Caparas,0,1,36,36
1657872157291,MATH 20C,B01,083762,Bach; Quang Tran,1,0,30,29
1657872163321,MATH 20D,A01,083765,Tran; Brian Kha,5,0,30,25
1657872163321,MATH 20D,A02,083766,Tran; Brian Kha,5,0,30,25
1657872163321,MATH 20D,A03,083767,Tran; Brian Kha,5,0,30,25
1657872169348,MATH 20E,A01,083771,Ganguly; Soumya,10,0,32,22
1657872169348,MATH 20E,A02,083772,Ganguly; Soumya,6,0,32,26
1657872169348,MATH 20E,B01,083773,Ciotti; Benjamin,20,0,35,15
1657872169348,MATH 20E,B02,083774,Ciotti; Benjamin,18,0,35,17
1657872175382,MATH 103A,A01,083777,Greenfeld; Be'Eri,3,0,36,33
1657872175382,MATH 103A,A02,083778,Greenfeld; Be'Eri,5,0,36,31
1657872175382,MATH 103A,A03,093561,Greenfeld; Be'Eri,6,0,36,30
1657872175382,MATH 103A,B01,083779,Greenfeld; Be'Eri,7,0,36,29
1657872175382,MATH 103A,B02,083780,Greenfeld; Be'Eri,4,0,36,32
1657872175382,MATH 103A,B03,093562,Greenfeld; Be'Eri,3,0,36,33
1657872181412,MATH 105,A01,085443,Carter; Anne Toulson,15,0,35,20
1657872181412,MATH 105,A02,093477,Carter; Anne Toulson,20,0,35,15
1657872187444,MATH 109,A01,083213,Ganzberger; Geoffrey Michael,3,0,34,31
1657872187444,MATH 109,A02,083214,Ganzberger; Geoffrey Michael,4,0,34,30
1657872187444,MATH 109,A03,093478,Ganzberger; Geoffrey Michael,2,0,34,32
1657872187444,MATH 109,B01,083215,Ganzberger; Geoffrey Michael,1,0,32,31
1657872187444,MATH 109,B02,083216,Ganzberger; Geoffrey Michael,2,0,32,30
1657872187444,MATH 109,B03,093479,Ganzberger; Geoffrey Michael,8,0,32,24
1657872193469,MATH 142A,A01,083219,Chow; Bennett,7,0,32,25
1657872193469,MATH 142A,A02,083220,Chow; Bennett,10,0,32,22
1657872193469,MATH 142A,A03,093480,Chow; Bennett,9,0,32,23
1657872193469,MATH 142A,B03,093481,Chow; Bennett,8,0,32,24
1657872193469,MATH 142A,B04,093558,Chow; Bennett,13,0,32,19
1657872193469,MATH 142A,B05,093559,Chow; Bennett,7,0,32,25
1657872199496,MATH 193A,A01,083224,Rotar; Vladimir,8,0,34,26
1657872199496,MATH 193A,A02,083225,Rotar; Vladimir,10,0,34,24
1657872199496,MATH 193A,A03,083781,Rotar; Vladimir,5,0,34,29
1657872199496,MATH 193A,A04,083782,Rotar; Vladimir,11,0,34,23
1657872199496,MATH 193A,A05,093482,Rotar; Vladimir,10,0,34,24
1657872205525,MATH 197,001,091859,McAuley; Julian John,9999,0,9999,0
1657872205525,MATH 197,002,095566,Kedlaya; Kiran S.,9997,0,9999,2
1657872205525,MATH 197,003,095567,Xiao; Ming,9999,0,9999,0
1657872205525,MATH 197,004,095571,Perols; Johan Lars,9998,0,9999,1
1657872212596,COGS 9,A01,083615,Shannon; Kyle Michael,10,0,75,65
1657872218621,COGS 11,A01,083617,Boyle; Mary E. T.,23,0,48,25
1657872224645,COGS 13,A01,083071,Bastos; Amalia Pinkusfeld,11,0,71,60
1657872230669,COGS 14A,A01,092681,Semenuks; Arturs,5,1,100,95
1657872236697,COGS 14B,A01,083073,Cheng; Tzu-Han,6,0,63,57
1657872242731,COGS 17,A01,092677,Semenuks; Arturs,6,0,81,75
1657872248755,COGS 100,A01,083619,Allen; Michael Gordon,17,0,70,53
1657872254780,COGS 101A,A01,083621,Davis; Joshua Daniel,9,0,68,59
1657872260806,COGS 101B,A01,091572,Allen; Michael Gordon,12,0,65,53
1657872266833,COGS 101C,A01,083625,Delgado; Tania,17,0,35,18
1657872272857,COGS 107A,A01,083627,Boyle; Mary E. T.,14,0,60,46
1657872278886,COGS 118A,A01,083075,Gupta; Anjum,21,0,76,55
1657872284918,CSE 3,A50,083646,Miranda; Gregory Joseph,24,0,50,26
1657872290946,CSE 8A,A50,083650,Miranda; Gregory Joseph,17,1,56,39
1657872296974,CSE 11,A01,083080,Cao; Yingjun,6,15,40,34
1657872303005,CSE 12,A01,083652,Krause-Levy; Sophia Louisa,30,1,120,90
1657872309033,CSE 15L,A01,083654,Morris; Justin Loren,9,0,50,41
1657872309033,CSE 15L,A02,083655,Morris; Justin Loren,10,0,50,40
1657872315064,CSE 20,A01,083657,Tran; Khoa Dang,39,0,80,41
1657872321092,CSE 21,A01,095574,Bach; Quang Tran,22,0,48,26
1657872327120,CSE 30,A01,083084,Eldon; John,6,0,80,74
1657872327120,CSE 30,B01,095061,Bhaskar; Nishant,9,0,50,41
1657872333152,CSE 100,A01,083659,Cao; Yingjun,5,4,70,65
1657872339175,CSE 134B,A01,083661,Powell; Thomas Allan,24,0,100,76
1657872345200,CSE 140,A01,083663,Gungor; Onat,15,0,85,70
1657872351224,CSE 140L,A01,083088,Eldon; John,23,0,100,77
1657872357247,CSE 175,A01,083665,Kumar; Rakesh,3,0,25,22
1657872363270,CSE 190,A00,092507,Dubnov; Shlomo,8,0,20,12
1657872369293,ECE 45,A01,083139,Congero; Spencer William,6,0,75,69
1657872375318,ECE 65,A50,083695,Saad; Andrew S,12,0,30,18
1657872375318,ECE 65,A51,095125,Saad; Andrew S,24,0,26,2
1657872381342,ECE 109,A01,091882,Touri; Behrouz,20,0,70,50
1657872387364,ECE 180,A00,083140,Abi Samra; Nicholas Camill,1,0,30,29
1657872387364,ECE 180,B00,083141,Abi Samra; Nicholas Camill,0,0,30,30
1657872393389,MATH 10A,A01,083735,Patchell; Gregory David,2,0,30,28
1657872393389,MATH 10A,A02,083736,Patchell; Gregory David,20,0,30,10
1657872393389,MATH 10A,A03,083737,Patchell; Gregory David,16,0,30,14
1657872399416,MATH 10B,A01,083207,Lim; Seonhee,8,0,34,26
1657872399416,MATH 10B,A02,083208,Lim; Seonhee,10,0,35,25
1657872399416,MATH 10B,A03,093472,Lim; Seonhee,7,0,34,27
1657872399416,MATH 10B,B01,083739,Sinha; Shubham,14,0,30,16
1657872405442,MATH 18,A01,083743,Cinel; Cameron Alexander,9,0,30,21
1657872405442,MATH 18,A02,083744,Cinel; Cameron Alexander,18,0,30,12
1657872405442,MATH 18,A03,083745,Cinel; Cameron Alexander,10,0,30,20
1657872405442,MATH 18,B01,083748,Rideout; David Porter,5,0,37,32
1657872405442,MATH 18,B02,083749,Rideout; David Porter,5,0,36,31
1657872405442,MATH 18,B03,083750,Rideout; David Porter,3,0,37,34
1657872405442,MATH 18,B04,083751,Rideout; David Porter,6,0,36,30
1657872405442,MATH 18,B05,093473,Rideout; David Porter,6,0,36,30
1657872405442,MATH 18,B06,093474,Rideout; David Porter,6,0,36,30
1657872411470,MATH 20A,A01,083754,Zheng; Zequn,14,0,40,26
1657872417494,MATH 20B,A01,083756,Briones; Jor-el Thomas Caparas,4,0,36,32
1657872417494,MATH 20B,A02,083757,Briones; Jor-el Thomas Caparas,1,0,36,35
1657872417494,MATH 20B,A03,093475,Briones; Jor-el Thomas Caparas,2,0,36,34
1657872423520,MATH 20C,A01,083760,Briones; Jor-el Thomas Caparas,1,0,35,34
1657872423520,MATH 20C,A02,083761,Briones; Jor-el Thomas Caparas,8,0,35,27
1657872423520,MATH 20C,A03,093476,Briones; Jor-el Thomas Caparas,0,1,36,36
1657872423520,MATH 20C,B01,083762,Bach; Quang Tran,1,0,30,29
1657872429545,MATH 20D,A01,083765,Tran; Brian Kha,5,0,30,25
1657872429545,MATH 20D,A02,083766,Tran; Brian Kha,5,0,30,25
1657872429545,MATH 20D,A03,083767,Tran; Brian Kha,5,0,30,25
1657872435578,MATH 20E,A01,083771,Ganguly; Soumya,10,0,32,22
1657872435578,MATH 20E,A02,083772,Ganguly; Soumya,6,0,32,26
1657872435578,MATH 20E,B01,083773,Ciotti; Benjamin,20,0,35,15
1657872435578,MATH 20E,B02,083774,Ciotti; Benjamin,18,0,35,17
1657872441603,MATH 103A,A01,083777,Greenfeld; Be'Eri,3,0,36,33
1657872441603,MATH 103A,A02,083778,Greenfeld; Be'Eri,5,0,36,31
1657872441603,MATH 103A,A03,093561,Greenfeld; Be'Eri,6,0,36,30
1657872441603,MATH 103A,B01,083779,Greenfeld; Be'Eri,7,0,36,29
1657872441603,MATH 103A,B02,083780,Greenfeld; Be'Eri,4,0,36,32
1657872441603,MATH 103A,B03,093562,Greenfeld; Be'Eri,3,0,36,33
1657872447627,MATH 105,A01,085443,Carter; Anne Toulson,15,0,35,20
1657872447627,MATH 105,A02,093477,Carter; Anne Toulson,20,0,35,15
1657872453657,MATH 109,A01,083213,Ganzberger; Geoffrey Michael,3,0,34,31
1657872453657,MATH 109,A02,083214,Ganzberger; Geoffrey Michael,4,0,34,30
1657872453657,MATH 109,A03,093478,Ganzberger; Geoffrey Michael,2,0,34,32
1657872453657,MATH 109,B01,083215,Ganzberger; Geoffrey Michael,1,0,32,31
1657872453657,MATH 109,B02,083216,Ganzberger; Geoffrey Michael,2,0,32,30
1657872453657,MATH 109,B03,093479,Ganzberger; Geoffrey Michael,8,0,32,24
1657872459690,MATH 142A,A01,083219,Chow; Bennett,7,0,32,25
1657872459690,MATH 142A,A02,083220,Chow; Bennett,10,0,32,22
1657872459690,MATH 142A,A03,093480,Chow; Bennett,9,0,32,23
1657872459690,MATH 142A,B03,093481,Chow; Bennett,8,0,32,24
1657872459690,MATH 142A,B04,093558,Chow; Bennett,13,0,32,19
1657872459690,MATH 142A,B05,093559,Chow; Bennett,7,0,32,25
1657872465714,MATH 193A,A01,083224,Rotar; Vladimir,8,0,34,26
1657872465714,MATH 193A,A02,083225,Rotar; Vladimir,10,0,34,24
1657872465714,MATH 193A,A03,083781,Rotar; Vladimir,5,0,34,29
1657872465714,MATH 193A,A04,083782,Rotar; Vladimir,11,0,34,23
1657872465714,MATH 193A,A05,093482,Rotar; Vladimir,10,0,34,24
1657872471739,MATH 197,001,091859,McAuley; Julian John,9999,0,9999,0
1657872471739,MATH 197,002,095566,Kedlaya; Kiran S.,9997,0,9999,2
1657872471739,MATH 197,003,095567,Xiao; Ming,9999,0,9999,0
1657872471739,MATH 197,004,095571,Perols; Johan Lars,9998,0,9999,1
1657872478798,COGS 9,A01,083615,Shannon; Kyle Michael,10,0,75,65
1657872484821,COGS 11,A01,083617,Boyle; Mary E. T.,23,0,48,25
1657872490846,COGS 13,A01,083071,Bastos; Amalia Pinkusfeld,11,0,71,60
1657872496871,COGS 14A,A01,092681,Semenuks; Arturs,5,1,100,95
1657872502897,COGS 14B,A01,083073,Cheng; Tzu-Han,6,0,63,57
1657872508923,COGS 17,A01,092677,Semenuks; Arturs,6,0,81,75
1657872514949,COGS 100,A01,083619,Allen; Michael Gordon,17,0,70,53
1657872520981,COGS 101A,A01,083621,Davis; Joshua Daniel,9,0,68,59
1657872527006,COGS 101B,A01,091572,Allen; Michael Gordon,13,0,65,52
1657872533029,COGS 101C,A01,083625,Delgado; Tania,17,0,35,18
1657872539134,COGS 107A,A01,083627,Boyle; Mary E. T.,14,0,60,46
1657872545157,COGS 118A,A01,083075,Gupta; Anjum,21,0,76,55
1657872551182,CSE 3,A50,083646,Miranda; Gregory Joseph,24,0,50,26
1657872557207,CSE 8A,A50,083650,Miranda; Gregory Joseph,17,1,56,39
1657872563235,CSE 11,A01,083080,Cao; Yingjun,6,15,40,34
1657872569261,CSE 12,A01,083652,Krause-Levy; Sophia Louisa,30,1,120,90
1657872575291,CSE 15L,A01,083654,Morris; Justin Loren,9,0,50,41
1657872575291,CSE 15L,A02,083655,Morris; Justin Loren,10,0,50,40
1657872581316,CSE 20,A01,083657,Tran; Khoa Dang,39,0,80,41
1657872587349,CSE 21,A01,095574,Bach; Quang Tran,22,0,48,26
1657872593373,CSE 30,A01,083084,Eldon; John,6,0,80,74
1657872593373,CSE 30,B01,095061,Bhaskar; Nishant,9,0,50,41
1657872599398,CSE 100,A01,083659,Cao; Yingjun,5,4,70,65
1657872605426,CSE 134B,A01,083661,Powell; Thomas Allan,24,0,100,76
1657872611448,CSE 140,A01,083663,Gungor; Onat,15,0,85,70
1657872617473,CSE 140L,A01,083088,Eldon; John,23,0,100,77
1657872623497,CSE 175,A01,083665,Kumar; Rakesh,3,0,25,22
1657872629520,CSE 190,A00,092507,Dubnov; Shlomo,8,0,20,12
1657872635544,ECE 45,A01,083139,Congero; Spencer William,6,0,75,69
1657872641569,ECE 65,A50,083695,Saad; Andrew S,12,0,30,18
1657872641569,ECE 65,A51,095125,Saad; Andrew S,24,0,26,2
1657872647593,ECE 109,A01,091882,Touri; Behrouz,20,0,70,50
1657872653616,ECE 180,A00,083140,Abi Samra; Nicholas Camill,1,0,30,29
1657872653616,ECE 180,B00,083141,Abi Samra; Nicholas Camill,0,0,30,30
1657872659642,MATH 10A,A01,083735,Patchell; Gregory David,2,0,30,28
1657872659642,MATH 10A,A02,083736,Patchell; Gregory David,20,0,30,10
1657872659642,MATH 10A,A03,083737,Patchell; Gregory David,16,0,30,14
1657872665670,MATH 10B,A01,083207,Lim; Seonhee,8,0,34,26
1657872665670,MATH 10B,A02,083208,Lim; Seonhee,10,0,35,25
1657872665670,MATH 10B,A03,093472,Lim; Seonhee,7,0,34,27
1657872665670,MATH 10B,B01,083739,Sinha; Shubham,14,0,30,16
1657872671703,MATH 18,A01,083743,Cinel; Cameron Alexander,9,0,30,21
1657872671703,MATH 18,A02,083744,Cinel; Cameron Alexander,18,0,30,12
1657872671703,MATH 18,A03,083745,Cinel; Cameron Alexander,10,0,30,20
1657872671703,MATH 18,B01,083748,Rideout; David Porter,5,0,37,32
1657872671703,MATH 18,B02,083749,Rideout; David Porter,5,0,36,31
1657872671703,MATH 18,B03,083750,Rideout; David Porter,3,0,37,34
1657872671703,MATH 18,B04,083751,Rideout; David Porter,6,0,36,30
1657872671703,MATH 18,B05,093473,Rideout; David Porter,6,0,36,30
1657872671703,MATH 18,B06,093474,Rideout; David Porter,6,0,36,30
1657872677727,MATH 20A,A01,083754,Zheng; Zequn,14,0,40,26
1657872683751,MATH 20B,A01,083756,Briones; Jor-el Thomas Caparas,4,0,36,32
1657872683751,MATH 20B,A02,083757,Briones; Jor-el Thomas Caparas,1,0,36,35
1657872683751,MATH 20B,A03,093475,Briones; Jor-el Thomas Caparas,2,0,36,34
1657872689781,MATH 20C,A01,083760,Briones; Jor-el Thomas Caparas,1,0,35,34
1657872689781,MATH 20C,A02,083761,Briones; Jor-el Thomas Caparas,8,0,35,27
1657872689781,MATH 20C,A03,093476,Briones; Jor-el Thomas Caparas,0,1,36,36
1657872689781,MATH 20C,B01,083762,Bach; Quang Tran,1,0,30,29
1657872695811,MATH 20D,A01,083765,Tran; Brian Kha,5,0,30,25
1657872695811,MATH 20D,A02,083766,Tran; Brian Kha,5,0,30,25
1657872695811,MATH 20D,A03,083767,Tran; Brian Kha,5,0,30,25
1657872701838,MATH 20E,A01,083771,Ganguly; Soumya,10,0,32,22
1657872701838,MATH 20E,A02,083772,Ganguly; Soumya,6,0,32,26
1657872701838,MATH 20E,B01,083773,Ciotti; Benjamin,20,0,35,15
1657872701838,MATH 20E,B02,083774,Ciotti; Benjamin,18,0,35,17
1657872707864,MATH 103A,A01,083777,Greenfeld; Be'Eri,3,0,36,33
1657872707864,MATH 103A,A02,083778,Greenfeld; Be'Eri,5,0,36,31
1657872707864,MATH 103A,A03,093561,Greenfeld; Be'Eri,6,0,36,30
1657872707864,MATH 103A,B01,083779,Greenfeld; Be'Eri,7,0,36,29
1657872707864,MATH 103A,B02,083780,Greenfeld; Be'Eri,4,0,36,32
1657872707864,MATH 103A,B03,093562,Greenfeld; Be'Eri,3,0,36,33
1657872713889,MATH 105,A01,085443,Carter; Anne Toulson,15,0,35,20
1657872713889,MATH 105,A02,093477,Carter; Anne Toulson,20,0,35,15
1657872719921,MATH 109,A01,083213,Ganzberger; Geoffrey Michael,3,0,34,31
1657872719921,MATH 109,A02,083214,Ganzberger; Geoffrey Michael,4,0,34,30
1657872719921,MATH 109,A03,093478,Ganzberger; Geoffrey Michael,2,0,34,32
1657872719921,MATH 109,B01,083215,Ganzberger; Geoffrey Michael,1,0,32,31
1657872719921,MATH 109,B02,083216,Ganzberger; Geoffrey Michael,2,0,32,30
1657872719921,MATH 109,B03,093479,Ganzberger; Geoffrey Michael,8,0,32,24
1657872725964,MATH 142A,A01,083219,Chow; Bennett,7,0,32,25
1657872725964,MATH 142A,A02,083220,Chow; Bennett,10,0,32,22
1657872725964,MATH 142A,A03,093480,Chow; Bennett,9,0,32,23
1657872725964,MATH 142A,B03,093481,Chow; Bennett,8,0,32,24
1657872725964,MATH 142A,B04,093558,Chow; Bennett,13,0,32,19
1657872725964,MATH 142A,B05,093559,Chow; Bennett,7,0,32,25
1657872731999,MATH 193A,A01,083224,Rotar; Vladimir,8,0,34,26
1657872731999,MATH 193A,A02,083225,Rotar; Vladimir,10,0,34,24
1657872731999,MATH 193A,A03,083781,Rotar; Vladimir,5,0,34,29
1657872731999,MATH 193A,A04,083782,Rotar; Vladimir,11,0,34,23
1657872731999,MATH 193A,A05,093482,Rotar; Vladimir,10,0,34,24
1657872738034,MATH 197,001,091859,McAuley; Julian John,9999,0,9999,0
1657872738034,MATH 197,002,095566,Kedlaya; Kiran S.,9997,0,9999,2
1657872738034,MATH 197,003,095567,Xiao; Ming,9999,0,9999,0
1657872738034,MATH 197,004,095571,Perols; Johan Lars,9998,0,9999,1
1657872745136,COGS 9,A01,083615,Shannon; Kyle Michael,10,0,75,65
1657872751160,COGS 11,A01,083617,Boyle; Mary E. T.,23,0,48,25
1657872757187,COGS 13,A01,083071,Bastos; Amalia Pinkusfeld,11,0,71,60
1657872763214,COGS 14A,A01,092681,Semenuks; Arturs,5,1,100,95
1657872769239,COGS 14B,A01,083073,Cheng; Tzu-Han,6,0,63,57
1657872775268,COGS 17,A01,092677,Semenuks; Arturs,6,0,81,75
1657872781296,COGS 100,A01,083619,Allen; Michael Gordon,17,0,70,53
1657872787329,COGS 101A,A01,083621,Davis; Joshua Daniel,9,0,68,59
1657872793352,COGS 101B,A01,091572,Allen; Michael Gordon,13,0,65,52
1657872799377,COGS 101C,A01,083625,Delgado; Tania,17,0,35,18
1657872805407,COGS 107A,A01,083627,Boyle; Mary E. T.,14,0,60,46
1657872811440,COGS 118A,A01,083075,Gupta; Anjum,21,0,76,55
1657872817466,CSE 3,A50,083646,Miranda; Gregory Joseph,24,0,50,26
1657872823495,CSE 8A,A50,083650,Miranda; Gregory Joseph,17,1,56,39
1657872829520,CSE 11,A01,083080,Cao; Yingjun,6,15,40,34
1657872835553,CSE 12,A01,083652,Krause-Levy; Sophia Louisa,30,1,120,90
1657872841579,CSE 15L,A01,083654,Morris; Justin Loren,9,0,50,41
1657872841579,CSE 15L,A02,083655,Morris; Justin Loren,10,0,50,40
1657872847601,CSE 20,A01,083657,Tran; Khoa Dang,39,0,80,41
1657872853627,CSE 21,A01,095574,Bach; Quang Tran,22,0,48,26
1657872859661,CSE 30,A01,083084,Eldon; John,6,0,80,74
1657872859661,CSE 30,B01,095061,Bhaskar; Nishant,9,0,50,41
1657872865689,CSE 100,A01,083659,Cao; Yingjun,5,4,70,65
1657872871714,CSE 134B,A01,083661,Powell; Thomas Allan,24,0,100,76
1657872877742,CSE 140,A01,083663,Gungor; Onat,15,0,85,70
1657872883771,CSE 140L,A01,083088,Eldon; John,23,0,100,77
1657872889795,CSE 175,A01,083665,Kumar; Rakesh,3,0,25,22
1657872895825,CSE 190,A00,092507,Dubnov; Shlomo,8,0,20,12
1657872901850,ECE 45,A01,083139,Congero; Spencer William,6,0,75,69
1657872907880,ECE 65,A50,083695,Saad; Andrew S,12,0,30,18
1657872907880,ECE 65,A51,095125,Saad; Andrew S,24,0,26,2
1657872913904,ECE 109,A01,091882,Touri; Behrouz,20,0,70,50
1657872919929,ECE 180,A00,083140,Abi Samra; Nicholas Camill,1,0,30,29
1657872919929,ECE 180,B00,083141,Abi Samra; Nicholas Camill,0,0,30,30
1657872925957,MATH 10A,A01,083735,Patchell; Gregory David,2,0,30,28
1657872925957,MATH 10A,A02,083736,Patchell; Gregory David,20,0,30,10
1657872925957,MATH 10A,A03,083737,Patchell; Gregory David,16,0,30,14
1657872931983,MATH 10B,A01,083207,Lim; Seonhee,8,0,34,26
1657872931983,MATH 10B,A02,083208,Lim; Seonhee,10,0,35,25
1657872931983,MATH 10B,A03,093472,Lim; Seonhee,7,0,34,27
1657872931983,MATH 10B,B01,083739,Sinha; Shubham,14,0,30,16
1657872938010,MATH 18,A01,083743,Cinel; Cameron Alexander,9,0,30,21
1657872938010,MATH 18,A02,083744,Cinel; Cameron Alexander,18,0,30,12
1657872938010,MATH 18,A03,083745,Cinel; Cameron Alexander,10,0,30,20
1657872938010,MATH 18,B01,083748,Rideout; David Porter,5,0,37,32
1657872938010,MATH 18,B02,083749,Rideout; David Porter,5,0,36,31
1657872938010,MATH 18,B03,083750,Rideout; David Porter,3,0,37,34
1657872938010,MATH 18,B04,083751,Rideout; David Porter,6,0,36,30
1657872938010,MATH 18,B05,093473,Rideout; David Porter,6,0,36,30
1657872938010,MATH 18,B06,093474,Rideout; David Porter,6,0,36,30
1657872944041,MATH 20A,A01,083754,Zheng; Zequn,14,0,40,26
1657872950068,MATH 20B,A01,083756,Briones; Jor-el Thomas Caparas,4,0,36,32
1657872950068,MATH 20B,A02,083757,Briones; Jor-el Thomas Caparas,1,0,36,35
1657872950068,MATH 20B,A03,093475,Briones; Jor-el Thomas Caparas,2,0,36,34
1657872956096,MATH 20C,A01,083760,Briones; Jor-el Thomas Caparas,1,0,35,34
1657872956096,MATH 20C,A02,083761,Briones; Jor-el Thomas Caparas,8,0,35,27
1657872956096,MATH 20C,A03,093476,Briones; Jor-el Thomas Caparas,0,1,36,36
1657872956096,MATH 20C,B01,083762,Bach; Quang Tran,1,0,30,29
1657872962144,MATH 20D,A01,083765,Tran; Brian Kha,5,0,30,25
1657872962144,MATH 20D,A02,083766,Tran; Brian Kha,5,0,30,25
1657872962144,MATH 20D,A03,083767,Tran; Brian Kha,5,0,30,25
1657872968172,MATH 20E,A01,083771,Ganguly; Soumya,10,0,32,22
1657872968172,MATH 20E,A02,083772,Ganguly; Soumya,6,0,32,26
1657872968172,MATH 20E,B01,083773,Ciotti; Benjamin,20,0,35,15
1657872968172,MATH 20E,B02,083774,Ciotti; Benjamin,18,0,35,17
1657872974200,MATH 103A,A01,083777,Greenfeld; Be'Eri,3,0,36,33
1657872974200,MATH 103A,A02,083778,Greenfeld; Be'Eri,5,0,36,31
1657872974200,MATH 103A,A03,093561,Greenfeld; Be'Eri,6,0,36,30
1657872974200,MATH 103A,B01,083779,Greenfeld; Be'Eri,7,0,36,29
1657872974200,MATH 103A,B02,083780,Greenfeld; Be'Eri,4,0,36,32
1657872974200,MATH 103A,B03,093562,Greenfeld; Be'Eri,3,0,36,33
1657872980227,MATH 105,A01,085443,Carter; Anne Toulson,15,0,35,20
1657872980227,MATH 105,A02,093477,Carter; Anne Toulson,20,0,35,15
1657872986252,MATH 109,A01,083213,Ganzberger; Geoffrey Michael,3,0,34,31
1657872986252,MATH 109,A02,083214,Ganzberger; Geoffrey Michael,4,0,34,30
1657872986252,MATH 109,A03,093478,Ganzberger; Geoffrey Michael,2,0,34,32
1657872986252,MATH 109,B01,083215,Ganzberger; Geoffrey Michael,1,0,32,31
1657872986252,MATH 109,B02,083216,Ganzberger; Geoffrey Michael,2,0,32,30
1657872986252,MATH 109,B03,093479,Ganzberger; Geoffrey Michael,8,0,32,24
1657872992284,MATH 142A,A01,083219,Chow; Bennett,7,0,32,25
1657872992284,MATH 142A,A02,083220,Chow; Bennett,10,0,32,22
1657872992284,MATH 142A,A03,093480,Chow; Bennett,9,0,32,23
1657872992284,MATH 142A,B03,093481,Chow; Bennett,8,0,32,24
1657872992284,MATH 142A,B04,093558,Chow; Bennett,13,0,32,19
1657872992284,MATH 142A,B05,093559,Chow; Bennett,7,0,32,25
1657872998308,MATH 193A,A01,083224,Rotar; Vladimir,8,0,34,26
1657872998308,MATH 193A,A02,083225,Rotar; Vladimir,10,0,34,24
1657872998308,MATH 193A,A03,083781,Rotar; Vladimir,5,0,34,29
1657872998308,MATH 193A,A04,083782,Rotar; Vladimir,11,0,34,23
1657872998308,MATH 193A,A05,093482,Rotar; Vladimir,10,0,34,24
1657873004339,MATH 197,001,091859,McAuley; Julian John,9999,0,9999,0
1657873004339,MATH 197,002,095566,Kedlaya; Kiran S.,9997,0,9999,2
1657873004339,MATH 197,003,095567,Xiao; Ming,9999,0,9999,0
1657873004339,MATH 197,004,095571,Perols; Johan Lars,9998,0,9999,1
1657873011421,COGS 9,A01,083615,Shannon; Kyle Michael,10,0,75,65
1657873017443,COGS 11,A01,083617,Boyle; Mary E. T.,23,0,48,25
1657873023469,COGS 13,A01,083071,Bastos; Amalia Pinkusfeld,11,0,71,60
1657873029495,COGS 14A,A01,092681,Semenuks; Arturs,5,1,100,95
1657873035524,COGS 14B,A01,083073,Cheng; Tzu-Han,6,0,63,57
1657873041548,COGS 17,A01,092677,Semenuks; Arturs,6,0,81,75
1657873047577,COGS 100,A01,083619,Allen; Michael Gordon,17,0,70,53
1657873053600,COGS 101A,A01,083621,Davis; Joshua Daniel,9,0,68,59
1657873059628,COGS 101B,A01,091572,Allen; Michael Gordon,13,0,65,52
1657873065654,COGS 101C,A01,083625,Delgado; Tania,17,0,35,18
1657873071679,COGS 107A,A01,083627,Boyle; Mary E. T.,14,0,60,46
1657873077707,COGS 118A,A01,083075,Gupta; Anjum,21,0,76,55
1657873083731,CSE 3,A50,083646,Miranda; Gregory Joseph,24,0,50,26
1657873089759,CSE 8A,A50,083650,Miranda; Gregory Joseph,17,1,56,39
1657873095785,CSE 11,A01,083080,Cao; Yingjun,6,15,40,34
1657873101809,CSE 12,A01,083652,Krause-Levy; Sophia Louisa,30,1,120,90
1657873107833,CSE 15L,A01,083654,Morris; Justin Loren,9,0,50,41
1657873107833,CSE 15L,A02,083655,Morris; Justin Loren,10,0,50,40
1657873113856,CSE 20,A01,083657,Tran; Khoa Dang,39,0,80,41
1657873119884,CSE 21,A01,095574,Bach; Quang Tran,22,0,48,26
1657873125910,CSE 30,A01,083084,Eldon; John,6,0,80,74
1657873125910,CSE 30,B01,095061,Bhaskar; Nishant,9,0,50,41
1657873131937,CSE 100,A01,083659,Cao; Yingjun,5,4,70,65
1657873138036,CSE 134B,A01,083661,Powell; Thomas Allan,24,0,100,76
1657873144064,CSE 140,A01,083663,Gungor; Onat,15,0,85,70
1657873150093,CSE 140L,A01,083088,Eldon; John,23,0,100,77
1657873156122,CSE 175,A01,083665,Kumar; Rakesh,3,0,25,22
1657873162149,CSE 190,A00,092507,Dubnov; Shlomo,8,0,20,12
1657873168182,ECE 45,A01,083139,Congero; Spencer William,6,0,75,69
1657873174208,ECE 65,A50,083695,Saad; Andrew S,12,0,30,18
1657873174208,ECE 65,A51,095125,Saad; Andrew S,24,0,26,2
1657873180233,ECE 109,A01,091882,Touri; Behrouz,20,0,70,50
1657873186260,ECE 180,A00,083140,Abi Samra; Nicholas Camill,1,0,30,29
1657873186260,ECE 180,B00,083141,Abi Samra; Nicholas Camill,0,0,30,30
1657873192285,MATH 10A,A01,083735,Patchell; Gregory David,2,0,30,28
1657873192285,MATH 10A,A02,083736,Patchell; Gregory David,20,0,30,10
1657873192285,MATH 10A,A03,083737,Patchell; Gregory David,16,0,30,14
1657873198313,MATH 10B,A01,083207,Lim; Seonhee,8,0,34,26
1657873198313,MATH 10B,A02,083208,Lim; Seonhee,10,0,35,25
1657873198313,MATH 10B,A03,093472,Lim; Seonhee,7,0,34,27
1657873198313,MATH 10B,B01,083739,Sinha; Shubham,14,0,30,16
1657873204341,MATH 18,A01,083743,Cinel; Cameron Alexander,9,0,30,21
1657873204341,MATH 18,A02,083744,Cinel; Cameron Alexander,18,0,30,12
1657873204341,MATH 18,A03,083745,Cinel; Cameron Alexander,10,0,30,20
1657873204341,MATH 18,B01,083748,Rideout; David Porter,5,0,37,32
1657873204341,MATH 18,B02,083749,Rideout; David Porter,5,0,36,31
1657873204341,MATH 18,B03,083750,Rideout; David Porter,3,0,37,34
1657873204341,MATH 18,B04,083751,Rideout; David Porter,6,0,36,30
1657873204341,MATH 18,B05,093473,Rideout; David Porter,6,0,36,30
1657873204341,MATH 18,B06,093474,Rideout; David Porter,6,0,36,30
1657873210370,MATH 20A,A01,083754,Zheng; Zequn,14,0,40,26
1657873216393,MATH 20B,A01,083756,Briones; Jor-el Thomas Caparas,4,0,36,32
1657873216393,MATH 20B,A02,083757,Briones; Jor-el Thomas Caparas,1,0,36,35
1657873216393,MATH 20B,A03,093475,Briones; Jor-el Thomas Caparas,2,0,36,34
1657873222417,MATH 20C,A01,083760,Briones; Jor-el Thomas Caparas,1,0,35,34
1657873222417,MATH 20C,A02,083761,Briones; Jor-el Thomas Caparas,8,0,35,27
1657873222417,MATH 20C,A03,093476,Briones; Jor-el Thomas Caparas,0,1,36,36
1657873222417,MATH 20C,B01,083762,Bach; Quang Tran,1,0,30,29
1657873228453,MATH 20D,A01,083765,Tran; Brian Kha,5,0,30,25
1657873228453,MATH 20D,A02,083766,Tran; Brian Kha,5,0,30,25
1657873228453,MATH 20D,A03,083767,Tran; Brian Kha,5,0,30,25
1657873234498,MATH 20E,A01,083771,Ganguly; Soumya,10,0,32,22
1657873234498,MATH 20E,A02,083772,Ganguly; Soumya,6,0,32,26
1657873234498,MATH 20E,B01,083773,Ciotti; Benjamin,20,0,35,15
1657873234498,MATH 20E,B02,083774,Ciotti; Benjamin,18,0,35,17
1657873240526,MATH 103A,A01,083777,Greenfeld; Be'Eri,3,0,36,33
1657873240526,MATH 103A,A02,083778,Greenfeld; Be'Eri,5,0,36,31
1657873240526,MATH 103A,A03,093561,Greenfeld; Be'Eri,6,0,36,30
1657873240526,MATH 103A,B01,083779,Greenfeld; Be'Eri,7,0,36,29
1657873240526,MATH 103A,B02,083780,Greenfeld; Be'Eri,4,0,36,32
1657873240526,MATH 103A,B03,093562,Greenfeld; Be'Eri,3,0,36,33
1657873246551,MATH 105,A01,085443,Carter; Anne Toulson,15,0,35,20
1657873246551,MATH 105,A02,093477,Carter; Anne Toulson,20,0,35,15
1657873252576,MATH 109,A01,083213,Ganzberger; Geoffrey Michael,3,0,34,31
1657873252576,MATH 109,A02,083214,Ganzberger; Geoffrey Michael,4,0,34,30
1657873252576,MATH 109,A03,093478,Ganzberger; Geoffrey Michael,2,0,34,32
1657873252576,MATH 109,B01,083215,Ganzberger; Geoffrey Michael,1,0,32,31
1657873252576,MATH 109,B02,083216,Ganzberger; Geoffrey Michael,2,0,32,30
1657873252576,MATH 109,B03,093479,Ganzberger; Geoffrey Michael,8,0,32,24
1657873258599,MATH 142A,A01,083219,Chow; Bennett,7,0,32,25
1657873258599,MATH 142A,A02,083220,Chow; Bennett,10,0,32,22
1657873258599,MATH 142A,A03,093480,Chow; Bennett,9,0,32,23
1657873258599,MATH 142A,B03,093481,Chow; Bennett,8,0,32,24
1657873258599,MATH 142A,B04,093558,Chow; Bennett,13,0,32,19
1657873258599,MATH 142A,B05,093559,Chow; Bennett,7,0,32,25
1657873264629,MATH 193A,A01,083224,Rotar; Vladimir,8,0,34,26
1657873264629,MATH 193A,A02,083225,Rotar; Vladimir,10,0,34,24
1657873264629,MATH 193A,A03,083781,Rotar; Vladimir,5,0,34,29
1657873264629,MATH 193A,A04,083782,Rotar; Vladimir,11,0,34,23
1657873264629,MATH 193A,A05,093482,Rotar; Vladimir,10,0,34,24
1657873270660,MATH 197,001,091859,McAuley; Julian John,9999,0,9999,0
1657873270660,MATH 197,002,095566,Kedlaya; Kiran S.,9997,0,9999,2
1657873270660,MATH 197,003,095567,Xiao; Ming,9999,0,9999,0
1657873270660,MATH 197,004,095571,Perols; Johan Lars,9998,0,9999,1
1657873277730,COGS 9,A01,083615,Shannon; Kyle Michael,10,0,75,65
1657873283767,COGS 11,A01,083617,Boyle; Mary E. T.,23,0,48,25
1657873289791,COGS 13,A01,083071,Bastos; Amalia Pinkusfeld,11,0,71,60
1657873295823,COGS 14A,A01,092681,Semenuks; Arturs,5,1,100,95
1657873301861,COGS 14B,A01,083073,Cheng; Tzu-Han,6,0,63,57
1657873307891,COGS 17,A01,092677,Semenuks; Arturs,6,0,81,75
1657873313916,COGS 100,A01,083619,Allen; Michael Gordon,17,0,70,53
1657873319947,COGS 101A,A01,083621,Davis; Joshua Daniel,9,0,68,59
1657873325972,COGS 101B,A01,091572,Allen; Michael Gordon,13,0,65,52
1657873332006,COGS 101C,A01,083625,Delgado; Tania,17,0,35,18
1657873338035,COGS 107A,A01,083627,Boyle; Mary E. T.,14,0,60,46
1657873344065,COGS 118A,A01,083075,Gupta; Anjum,21,0,76,55
1657873350093,CSE 3,A50,083646,Miranda; Gregory Joseph,24,0,50,26
1657873356119,CSE 8A,A50,083650,Miranda; Gregory Joseph,17,1,56,39
1657873362154,CSE 11,A01,083080,Cao; Yingjun,6,15,40,34
1657873368180,CSE 12,A01,083652,Krause-Levy; Sophia Louisa,30,1,120,90
1657873374209,CSE 15L,A01,083654,Morris; Justin Loren,9,0,50,41
1657873374209,CSE 15L,A02,083655,Morris; Justin Loren,10,0,50,40
1657873380244,CSE 20,A01,083657,Tran; Khoa Dang,39,0,80,41
1657873386271,CSE 21,A01,095574,Bach; Quang Tran,22,0,48,26
1657873392305,CSE 30,A01,083084,Eldon; John,6,0,80,74
1657873392305,CSE 30,B01,095061,Bhaskar; Nishant,9,0,50,41
1657873398331,CSE 100,A01,083659,Cao; Yingjun,5,4,70,65
1657873404363,CSE 134B,A01,083661,Powell; Thomas Allan,24,0,100,76
1657873410390,CSE 140,A01,083663,Gungor; Onat,15,0,85,70
1657873416421,CSE 140L,A01,083088,Eldon; John,23,0,100,77
1657873422447,CSE 175,A01,083665,Kumar; Rakesh,3,0,25,22
1657873428483,CSE 190,A00,092507,Dubnov; Shlomo,8,0,20,12
1657873434510,ECE 45,A01,083139,Congero; Spencer William,6,0,75,69
1657873440544,ECE 65,A50,083695,Saad; Andrew S,12,0,30,18
1657873440544,ECE 65,A51,095125,Saad; Andrew S,24,0,26,2
1657873446572,ECE 109,A01,091882,Touri; Behrouz,20,0,70,50
1657873452599,ECE 180,A00,083140,Abi Samra; Nicholas Camill,1,0,30,29
1657873452599,ECE 180,B00,083141,Abi Samra; Nicholas Camill,0,0,30,30
1657873458635,MATH 10A,A01,083735,Patchell; Gregory David,2,0,30,28
1657873458635,MATH 10A,A02,083736,Patchell; Gregory David,20,0,30,10
1657873458635,MATH 10A,A03,083737,Patchell; Gregory David,16,0,30,14
1657873464665,MATH 10B,A01,083207,Lim; Seonhee,8,0,34,26
1657873464665,MATH 10B,A02,083208,Lim; Seonhee,10,0,35,25
1657873464665,MATH 10B,A03,093472,Lim; Seonhee,7,0,34,27
1657873464665,MATH 10B,B01,083739,Sinha; Shubham,14,0,30,16
1657873470708,MATH 18,A01,083743,Cinel; Cameron Alexander,9,0,30,21
1657873470708,MATH 18,A02,083744,Cinel; Cameron Alexander,18,0,30,12
1657873470708,MATH 18,A03,083745,Cinel; Cameron Alexander,10,0,30,20
1657873470708,MATH 18,B01,083748,Rideout; David Porter,5,0,37,32
1657873470708,MATH 18,B02,083749,Rideout; David Porter,5,0,36,31
1657873470708,MATH 18,B03,083750,Rideout; David Porter,3,0,37,34
1657873470708,MATH 18,B04,083751,Rideout; David Porter,6,0,36,30
1657873470708,MATH 18,B05,093473,Rideout; David Porter,6,0,36,30
1657873470708,MATH 18,B06,093474,Rideout; David Porter,6,0,36,30
1657873476739,MATH 20A,A01,083754,Zheng; Zequn,14,0,40,26
1657873482766,MATH 20B,A01,083756,Briones; Jor-el Thomas Caparas,4,0,36,32
1657873482766,MATH 20B,A02,083757,Briones; Jor-el Thomas Caparas,1,0,36,35
1657873482766,MATH 20B,A03,093475,Briones; Jor-el Thomas Caparas,2,0,36,34
1657873488794,MATH 20C,A01,083760,Briones; Jor-el Thomas Caparas,1,0,35,34
1657873488794,MATH 20C,A02,083761,Briones; Jor-el Thomas Caparas,8,0,35,27
1657873488794,MATH 20C,A03,093476,Briones; Jor-el Thomas Caparas,0,1,36,36
1657873488794,MATH 20C,B01,083762,Bach; Quang Tran,1,0,30,29
1657873494819,MATH 20D,A01,083765,Tran; Brian Kha,5,0,30,25
1657873494819,MATH 20D,A02,083766,Tran; Brian Kha,5,0,30,25
1657873494819,MATH 20D,A03,083767,Tran; Brian Kha,5,0,30,25
1657873500848,MATH 20E,A01,083771,Ganguly; Soumya,10,0,32,22
1657873500848,MATH 20E,A02,083772,Ganguly; Soumya,6,0,32,26
1657873500848,MATH 20E,B01,083773,Ciotti; Benjamin,20,0,35,15
1657873500848,MATH 20E,B02,083774,Ciotti; Benjamin,18,0,35,17
1657873506884,MATH 103A,A01,083777,Greenfeld; Be'Eri,3,0,36,33
1657873506884,MATH 103A,A02,083778,Greenfeld; Be'Eri,5,0,36,31
1657873506884,MATH 103A,A03,093561,Greenfeld; Be'Eri,6,0,36,30
1657873506884,MATH 103A,B01,083779,Greenfeld; Be'Eri,7,0,36,29
1657873506884,MATH 103A,B02,083780,Greenfeld; Be'Eri,4,0,36,32
1657873506884,MATH 103A,B03,093562,Greenfeld; Be'Eri,3,0,36,33
1657873512917,MATH 105,A01,085443,Carter; Anne Toulson,15,0,35,20
1657873512917,MATH 105,A02,093477,Carter; Anne Toulson,20,0,35,15
1657873518943,MATH 109,A01,083213,Ganzberger; Geoffrey Michael,3,0,34,31
1657873518943,MATH 109,A02,083214,Ganzberger; Geoffrey Michael,4,0,34,30
1657873518943,MATH 109,A03,093478,Ganzberger; Geoffrey Michael,2,0,34,32
1657873518943,MATH 109,B01,083215,Ganzberger; Geoffrey Michael,1,0,32,31
1657873518943,MATH 109,B02,083216,Ganzberger; Geoffrey Michael,2,0,32,30
1657873518943,MATH 109,B03,093479,Ganzberger; Geoffrey Michael,8,0,32,24
1657873524978,MATH 142A,A01,083219,Chow; Bennett,7,0,32,25
1657873524978,MATH 142A,A02,083220,Chow; Bennett,10,0,32,22
1657873524978,MATH 142A,A03,093480,Chow; Bennett,9,0,32,23
1657873524978,MATH 142A,B03,093481,Chow; Bennett,8,0,32,24
1657873524978,MATH 142A,B04,093558,Chow; Bennett,13,0,32,19
1657873524978,MATH 142A,B05,093559,Chow; Bennett,7,0,32,25
1657873531014,MATH 193A,A01,083224,Rotar; Vladimir,8,0,34,26
1657873531014,MATH 193A,A02,083225,Rotar; Vladimir,10,0,34,24
1657873531014,MATH 193A,A03,083781,Rotar; Vladimir,5,0,34,29
1657873531014,MATH 193A,A04,083782,Rotar; Vladimir,11,0,34,23
1657873531014,MATH 193A,A05,093482,Rotar; Vladimir,10,0,34,24
1657873537038,MATH 197,001,091859,McAuley; Julian John,9999,0,9999,0
1657873537038,MATH 197,002,095566,Kedlaya; Kiran S.,9997,0,9999,2
1657873537038,MATH 197,003,095567,Xiao; Ming,9999,0,9999,0
1657873537038,MATH 197,004,095571,Perols; Johan Lars,9998,0,9999,1
1657873544112,COGS 9,A01,083615,Shannon; Kyle Michael,10,0,75,65
1657873550148,COGS 11,A01,083617,Boyle; Mary E. T.,23,0,48,25
1657873556175,COGS 13,A01,083071,Bastos; Amalia Pinkusfeld,11,0,71,60
1657873569203,COGS 14A,A01,092681,Semenuks; Arturs,5,1,100,95
1657873575227,COGS 14B,A01,083073,Cheng; Tzu-Han,6,0,63,57
1657873581256,COGS 17,A01,092677,Semenuks; Arturs,6,0,81,75
1657873587284,COGS 100,A01,083619,Allen; Michael Gordon,17,0,70,53
1657873593308,COGS 101A,A01,083621,Davis; Joshua Daniel,9,0,68,59
1657873599334,COGS 101B,A01,091572,Allen; Michael Gordon,13,0,65,52
1657873605367,COGS 101C,A01,083625,Delgado; Tania,17,0,35,18
1657873611398,COGS 107A,A01,083627,Boyle; Mary E. T.,14,0,60,46
1657873617423,COGS 118A,A01,083075,Gupta; Anjum,21,0,76,55
1657873623451,CSE 3,A50,083646,Miranda; Gregory Joseph,24,0,50,26
1657873629477,CSE 8A,A50,083650,Miranda; Gregory Joseph,17,1,56,39
1657873635501,CSE 11,A01,083080,Cao; Yingjun,6,15,40,34
1657873641533,CSE 12,A01,083652,Krause-Levy; Sophia Louisa,30,1,120,90
1657873647559,CSE 15L,A01,083654,Morris; Justin Loren,9,0,50,41
1657873647559,CSE 15L,A02,083655,Morris; Justin Loren,10,0,50,40
1657873653585,CSE 20,A01,083657,Tran; Khoa Dang,39,0,80,41
1657873659609,CSE 21,A01,095574,Bach; Quang Tran,22,0,48,26
1657873665636,CSE 30,A01,083084,Eldon; John,6,0,80,74
1657873665636,CSE 30,B01,095061,Bhaskar; Nishant,9,0,50,41
1657873671662,CSE 100,A01,083659,Cao; Yingjun,5,4,70,65
1657873677687,CSE 134B,A01,083661,Powell; Thomas Allan,24,0,100,76
1657873683715,CSE 140,A01,083663,Gungor; Onat,15,0,85,70
1657873689744,CSE 140L,A01,083088,Eldon; John,23,0,100,77
1657873695768,CSE 175,A01,083665,Kumar; Rakesh,3,0,25,22
1657873701792,CSE 190,A00,092507,Dubnov; Shlomo,8,0,20,12
1657873707818,ECE 45,A01,083139,Congero; Spencer William,6,0,75,69
1657873713853,ECE 65,A50,083695,Saad; Andrew S,12,0,30,18
1657873713853,ECE 65,A51,095125,Saad; Andrew S,24,0,26,2
1657873719886,ECE 109,A01,091882,Touri; Behrouz,20,0,70,50
1657873725911,ECE 180,A00,083140,Abi Samra; Nicholas Camill,1,0,30,29
1657873725911,ECE 180,B00,083141,Abi Samra; Nicholas Camill,0,0,30,30
1657873731937,MATH 10A,A01,083735,Patchell; Gregory David,2,0,30,28
1657873731937,MATH 10A,A02,083736,Patchell; Gregory David,20,0,30,10
1657873731937,MATH 10A,A03,083737,Patchell; Gregory David,16,0,30,14
1657873737976,MATH 10B,A01,083207,Lim; Seonhee,8,0,34,26
1657873737976,MATH 10B,A02,083208,Lim; Seonhee,10,0,35,25
1657873737976,MATH 10B,A03,093472,Lim; Seonhee,7,0,34,27
1657873737976,MATH 10B,B01,083739,Sinha; Shubham,14,0,30,16
1657873744100,MATH 18,A01,083743,Cinel; Cameron Alexander,9,0,30,21
1657873744100,MATH 18,A02,083744,Cinel; Cameron Alexander,18,0,30,12
1657873744100,MATH 18,A03,083745,Cinel; Cameron Alexander,10,0,30,20
1657873744100,MATH 18,B01,083748,Rideout; David Porter,5,0,37,32
1657873744100,MATH 18,B02,083749,Rideout; David Porter,5,0,36,31
1657873744100,MATH 18,B03,083750,Rideout; David Porter,3,0,37,34
1657873744100,MATH 18,B04,083751,Rideout; David Porter,6,0,36,30
1657873744100,MATH 18,B05,093473,Rideout; David Porter,6,0,36,30
1657873744100,MATH 18,B06,093474,Rideout; David Porter,6,0,36,30
1657873750124,MATH 20A,A01,083754,Zheng; Zequn,14,0,40,26
1657873756164,MATH 20B,A01,083756,Briones; Jor-el Thomas Caparas,4,0,36,32
1657873756164,MATH 20B,A02,083757,Briones; Jor-el Thomas Caparas,1,0,36,35
1657873756164,MATH 20B,A03,093475,Briones; Jor-el Thomas Caparas,2,0,36,34
1657873762199,MATH 20C,A01,083760,Briones; Jor-el Thomas Caparas,1,0,35,34
1657873762199,MATH 20C,A02,083761,Briones; Jor-el Thomas Caparas,8,0,35,27
1657873762199,MATH 20C,A03,093476,Briones; Jor-el Thomas Caparas,0,1,36,36
1657873762199,MATH 20C,B01,083762,Bach; Quang Tran,1,0,30,29
1657873768226,MATH 20D,A01,083765,Tran; Brian Kha,5,0,30,25
1657873768226,MATH 20D,A02,083766,Tran; Brian Kha,5,0,30,25
1657873768226,MATH 20D,A03,083767,Tran; Brian Kha,5,0,30,25
1657873774252,MATH 20E,A01,083771,Ganguly; Soumya,10,0,32,22
1657873774252,MATH 20E,A02,083772,Ganguly; Soumya,6,0,32,26
1657873774252,MATH 20E,B01,083773,Ciotti; Benjamin,20,0,35,15
1657873774252,MATH 20E,B02,083774,Ciotti; Benjamin,18,0,35,17
1657873780282,MATH 103A,A01,083777,Greenfeld; Be'Eri,3,0,36,33
1657873780282,MATH 103A,A02,083778,Greenfeld; Be'Eri,5,0,36,31
1657873780282,MATH 103A,A03,093561,Greenfeld; Be'Eri,6,0,36,30
1657873780282,MATH 103A,B01,083779,Greenfeld; Be'Eri,7,0,36,29
1657873780282,MATH 103A,B02,083780,Greenfeld; Be'Eri,4,0,36,32
1657873780282,MATH 103A,B03,093562,Greenfeld; Be'Eri,3,0,36,33
1657873786308,MATH 105,A01,085443,Carter; Anne Toulson,15,0,35,20
1657873786308,MATH 105,A02,093477,Carter; Anne Toulson,20,0,35,15
1657873792335,MATH 109,A01,083213,Ganzberger; Geoffrey Michael,3,0,34,31
1657873792335,MATH 109,A02,083214,Ganzberger; Geoffrey Michael,4,0,34,30
1657873792335,MATH 109,A03,093478,Ganzberger; Geoffrey Michael,2,0,34,32
1657873792335,MATH 109,B01,083215,Ganzberger; Geoffrey Michael,1,0,32,31
1657873792335,MATH 109,B02,083216,Ganzberger; Geoffrey Michael,2,0,32,30
1657873792335,MATH 109,B03,093479,Ganzberger; Geoffrey Michael,8,0,32,24
1657873798362,MATH 142A,A01,083219,Chow; Bennett,7,0,32,25
1657873798362,MATH 142A,A02,083220,Chow; Bennett,10,0,32,22
1657873798362,MATH 142A,A03,093480,Chow; Bennett,9,0,32,23
1657873798362,MATH 142A,B03,093481,Chow; Bennett,8,0,32,24
1657873798362,MATH 142A,B04,093558,Chow; Bennett,13,0,32,19
1657873798362,MATH 142A,B05,093559,Chow; Bennett,7,0,32,25
1657873804390,MATH 193A,A01,083224,Rotar; Vladimir,8,0,34,26
1657873804390,MATH 193A,A02,083225,Rotar; Vladimir,10,0,34,24
1657873804390,MATH 193A,A03,083781,Rotar; Vladimir,5,0,34,29
1657873804390,MATH 193A,A04,083782,Rotar; Vladimir,11,0,34,23
1657873804390,MATH 193A,A05,093482,Rotar; Vladimir,10,0,34,24
1657873810416,MATH 197,001,091859,McAuley; Julian John,9999,0,9999,0
1657873810416,MATH 197,002,095566,Kedlaya; Kiran S.,9997,0,9999,2
1657873810416,MATH 197,003,095567,Xiao; Ming,9999,0,9999,0
1657873810416,MATH 197,004,095571,Perols; Johan Lars,9998,0,9999,1
1657873817488,COGS 9,A01,083615,Shannon; Kyle Michael,10,0,75,65
1657873823513,COGS 11,A01,083617,Boyle; Mary E. T.,23,0,48,25
1657873829538,COGS 13,A01,083071,Bastos; Amalia Pinkusfeld,11,0,71,60
1657873835570,COGS 14A,A01,092681,Semenuks; Arturs,5,1,100,95
1657873841593,COGS 14B,A01,083073,Cheng; Tzu-Han,6,0,63,57
1657873847616,COGS 17,A01,092677,Semenuks; Arturs,6,0,81,75
1657873853649,COGS 100,A01,083619,Allen; Michael Gordon,17,0,70,53
1657873859674,COGS 101A,A01,083621,Davis; Joshua Daniel,9,0,68,59
1657873865700,COGS 101B,A01,091572,Allen; Michael Gordon,13,0,65,52
1657873871725,COGS 101C,A01,083625,Delgado; Tania,17,0,35,18
1657873877749,COGS 107A,A01,083627,Boyle; Mary E. T.,14,0,60,46
1657873883776,COGS 118A,A01,083075,Gupta; Anjum,21,0,76,55
1657873889811,CSE 3,A50,083646,Miranda; Gregory Joseph,24,0,50,26
1657873895837,CSE 8A,A50,083650,Miranda; Gregory Joseph,17,1,56,39
1657873901867,CSE 11,A01,083080,Cao; Yingjun,6,15,40,34
1657873907892,CSE 12,A01,083652,Krause-Levy; Sophia Louisa,30,1,120,90
1657873913924,CSE 15L,A01,083654,Morris; Justin Loren,9,0,50,41
1657873913924,CSE 15L,A02,083655,Morris; Justin Loren,10,0,50,40
1657873919949,CSE 20,A01,083657,Tran; Khoa Dang,39,0,80,41
1657873925981,CSE 21,A01,095574,Bach; Quang Tran,22,0,48,26
1657873932007,CSE 30,A01,083084,Eldon; John,6,0,80,74
1657873932007,CSE 30,B01,095061,Bhaskar; Nishant,9,0,50,41
1657873938037,CSE 100,A01,083659,Cao; Yingjun,5,4,70,65
1657873944070,CSE 134B,A01,083661,Powell; Thomas Allan,24,0,100,76
1657873950096,CSE 140,A01,083663,Gungor; Onat,15,0,85,70
1657873956121,CSE 140L,A01,083088,Eldon; John,23,0,100,77
1657873962148,CSE 175,A01,083665,Kumar; Rakesh,3,0,25,22
1657873968174,CSE 190,A00,092507,Dubnov; Shlomo,8,0,20,12
1657873974214,ECE 45,A01,083139,Congero; Spencer William,6,0,75,69
1657873980255,ECE 65,A50,083695,Saad; Andrew S,12,0,30,18
1657873980255,ECE 65,A51,095125,Saad; Andrew S,24,0,26,2
1657873986282,ECE 109,A01,091882,Touri; Behrouz,20,0,70,50
1657873992307,ECE 180,A00,083140,Abi Samra; Nicholas Camill,1,0,30,29
1657873992307,ECE 180,B00,083141,Abi Samra; Nicholas Camill,0,0,30,30
1657873998333,MATH 10A,A01,083735,Patchell; Gregory David,2,0,30,28
1657873998333,MATH 10A,A02,083736,Patchell; Gregory David,20,0,30,10
1657873998333,MATH 10A,A03,083737,Patchell; Gregory David,16,0,30,14
1657874004361,MATH 10B,A01,083207,Lim; Seonhee,8,0,34,26
1657874004361,MATH 10B,A02,083208,Lim; Seonhee,10,0,35,25
1657874004361,MATH 10B,A03,093472,Lim; Seonhee,7,0,34,27
1657874004361,MATH 10B,B01,083739,Sinha; Shubham,14,0,30,16
1657874010390,MATH 18,A01,083743,Cinel; Cameron Alexander,9,0,30,21
1657874010390,MATH 18,A02,083744,Cinel; Cameron Alexander,18,0,30,12
1657874010390,MATH 18,A03,083745,Cinel; Cameron Alexander,10,0,30,20
1657874010390,MATH 18,B01,083748,Rideout; David Porter,5,0,37,32
1657874010390,MATH 18,B02,083749,Rideout; David Porter,5,0,36,31
1657874010390,MATH 18,B03,083750,Rideout; David Porter,3,0,37,34
1657874010390,MATH 18,B04,083751,Rideout; David Porter,6,0,36,30
1657874010390,MATH 18,B05,093473,Rideout; David Porter,6,0,36,30
1657874010390,MATH 18,B06,093474,Rideout; David Porter,6,0,36,30
1657874016420,MATH 20A,A01,083754,Zheng; Zequn,14,0,40,26
1657874022447,MATH 20B,A01,083756,Briones; Jor-el Thomas Caparas,4,0,36,32
1657874022447,MATH 20B,A02,083757,Briones; Jor-el Thomas Caparas,1,0,36,35
1657874022447,MATH 20B,A03,093475,Briones; Jor-el Thomas Caparas,2,0,36,34
1657874028480,MATH 20C,A01,083760,Briones; Jor-el Thomas Caparas,1,0,35,34
1657874028480,MATH 20C,A02,083761,Briones; Jor-el Thomas Caparas,8,0,35,27
1657874028480,MATH 20C,A03,093476,Briones; Jor-el Thomas Caparas,0,1,36,36
1657874028480,MATH 20C,B01,083762,Bach; Quang Tran,1,0,30,29
1657874034505,MATH 20D,A01,083765,Tran; Brian Kha,5,0,30,25
1657874034505,MATH 20D,A02,083766,Tran; Brian Kha,5,0,30,25
1657874034505,MATH 20D,A03,083767,Tran; Brian Kha,5,0,30,25
1657874040541,MATH 20E,A01,083771,Ganguly; Soumya,10,0,32,22
1657874040541,MATH 20E,A02,083772,Ganguly; Soumya,6,0,32,26
1657874040541,MATH 20E,B01,083773,Ciotti; Benjamin,20,0,35,15
1657874040541,MATH 20E,B02,083774,Ciotti; Benjamin,18,0,35,17
1657874046572,MATH 103A,A01,083777,Greenfeld; Be'Eri,3,0,36,33
1657874046572,MATH 103A,A02,083778,Greenfeld; Be'Eri,5,0,36,31
1657874046572,MATH 103A,A03,093561,Greenfeld; Be'Eri,6,0,36,30
1657874046572,MATH 103A,B01,083779,Greenfeld; Be'Eri,7,0,36,29
1657874046572,MATH 103A,B02,083780,Greenfeld; Be'Eri,4,0,36,32
1657874046572,MATH 103A,B03,093562,Greenfeld; Be'Eri,3,0,36,33
1657874052598,MATH 105,A01,085443,Carter; Anne Toulson,15,0,35,20
1657874052598,MATH 105,A02,093477,Carter; Anne Toulson,20,0,35,15
1657874058636,MATH 109,A01,083213,Ganzberger; Geoffrey Michael,3,0,34,31
1657874058636,MATH 109,A02,083214,Ganzberger; Geoffrey Michael,4,0,34,30
1657874058636,MATH 109,A03,093478,Ganzberger; Geoffrey Michael,2,0,34,32
1657874058636,MATH 109,B01,083215,Ganzberger; Geoffrey Michael,1,0,32,31
1657874058636,MATH 109,B02,083216,Ganzberger; Geoffrey Michael,2,0,32,30
1657874058636,MATH 109,B03,093479,Ganzberger; Geoffrey Michael,8,0,32,24
1657874064668,MATH 142A,A01,083219,Chow; Bennett,7,0,32,25
1657874064668,MATH 142A,A02,083220,Chow; Bennett,10,0,32,22
1657874064668,MATH 142A,A03,093480,Chow; Bennett,9,0,32,23
1657874064668,MATH 142A,B03,093481,Chow; Bennett,8,0,32,24
1657874064668,MATH 142A,B04,093558,Chow; Bennett,13,0,32,19
1657874064668,MATH 142A,B05,093559,Chow; Bennett,7,0,32,25
1657874070699,MATH 193A,A01,083224,Rotar; Vladimir,8,0,34,26
1657874070699,MATH 193A,A02,083225,Rotar; Vladimir,10,0,34,24
1657874070699,MATH 193A,A03,083781,Rotar; Vladimir,5,0,34,29
1657874070699,MATH 193A,A04,083782,Rotar; Vladimir,11,0,34,23
1657874070699,MATH 193A,A05,093482,Rotar; Vladimir,10,0,34,24
1657874076727,MATH 197,001,091859,McAuley; Julian John,9999,0,9999,0
1657874076727,MATH 197,002,095566,Kedlaya; Kiran S.,9997,0,9999,2
1657874076727,MATH 197,003,095567,Xiao; Ming,9999,0,9999,0
1657874076727,MATH 197,004,095571,Perols; Johan Lars,9998,0,9999,1
1657874083814,COGS 9,A01,083615,Shannon; Kyle Michael,10,0,75,65
1657874089838,COGS 11,A01,083617,Boyle; Mary E. T.,23,0,48,25
1657874095863,COGS 13,A01,083071,Bastos; Amalia Pinkusfeld,11,0,71,60
1657874101893,COGS 14A,A01,092681,Semenuks; Arturs,5,1,100,95
1657874107922,COGS 14B,A01,083073,Cheng; Tzu-Han,6,0,63,57
1657874113946,COGS 17,A01,092677,Semenuks; Arturs,6,0,81,75
1657874119969,COGS 100,A01,083619,Allen; Michael Gordon,17,0,70,53
1657874125992,COGS 101A,A01,083621,Davis; Joshua Daniel,9,0,68,59
1657874132019,COGS 101B,A01,091572,Allen; Michael Gordon,13,0,65,52
1657874138049,COGS 101C,A01,083625,Delgado; Tania,17,0,35,18
1657874144076,COGS 107A,A01,083627,Boyle; Mary E. T.,14,0,60,46
1657874150101,COGS 118A,A01,083075,Gupta; Anjum,21,0,76,55
1657874156128,CSE 3,A50,083646,Miranda; Gregory Joseph,24,0,50,26
1657874162154,CSE 8A,A50,083650,Miranda; Gregory Joseph,17,1,56,39
1657874168178,CSE 11,A01,083080,Cao; Yingjun,6,15,40,34
1657874174201,CSE 12,A01,083652,Krause-Levy; Sophia Louisa,30,1,120,90
1657874180225,CSE 15L,A01,083654,Morris; Justin Loren,9,0,50,41
1657874180225,CSE 15L,A02,083655,Morris; Justin Loren,10,0,50,40
1657874186249,CSE 20,A01,083657,Tran; Khoa Dang,39,0,80,41
1657874192273,CSE 21,A01,095574,Bach; Quang Tran,22,0,48,26
1657874198299,CSE 30,A01,083084,Eldon; John,6,0,80,74
1657874198299,CSE 30,B01,095061,Bhaskar; Nishant,9,0,50,41
1657874204329,CSE 100,A01,083659,Cao; Yingjun,5,4,70,65
1657874210355,CSE 134B,A01,083661,Powell; Thomas Allan,24,0,100,76
1657874216383,CSE 140,A01,083663,Gungor; Onat,15,0,85,70
1657874222407,CSE 140L,A01,083088,Eldon; John,23,0,100,77
1657874228431,CSE 175,A01,083665,Kumar; Rakesh,3,0,25,22
1657874234458,CSE 190,A00,092507,Dubnov; Shlomo,8,0,20,12
1657874240489,ECE 45,A01,083139,Congero; Spencer William,6,0,75,69
1657874246521,ECE 65,A50,083695,Saad; Andrew S,12,0,30,18
1657874246521,ECE 65,A51,095125,Saad; Andrew S,24,0,26,2
1657874252545,ECE 109,A01,091882,Touri; Behrouz,20,0,70,50
1657874258572,ECE 180,A00,083140,Abi Samra; Nicholas Camill,1,0,30,29
1657874258572,ECE 180,B00,083141,Abi Samra; Nicholas Camill,0,0,30,30
1657874264603,MATH 10A,A01,083735,Patchell; Gregory David,2,0,30,28
1657874264603,MATH 10A,A02,083736,Patchell; Gregory David,20,0,30,10
1657874264603,MATH 10A,A03,083737,Patchell; Gregory David,16,0,30,14
1657874270628,MATH 10B,A01,083207,Lim; Seonhee,8,0,34,26
1657874270628,MATH 10B,A02,083208,Lim; Seonhee,10,0,35,25
1657874270628,MATH 10B,A03,093472,Lim; Seonhee,7,0,34,27
1657874270628,MATH 10B,B01,083739,Sinha; Shubham,14,0,30,16
1657874276658,MATH 18,A01,083743,Cinel; Cameron Alexander,9,0,30,21
1657874276658,MATH 18,A02,083744,Cinel; Cameron Alexander,18,0,30,12
1657874276658,MATH 18,A03,083745,Cinel; Cameron Alexander,10,0,30,20
1657874276658,MATH 18,B01,083748,Rideout; David Porter,5,0,37,32
1657874276658,MATH 18,B02,083749,Rideout; David Porter,5,0,36,31
1657874276658,MATH 18,B03,083750,Rideout; David Porter,3,0,37,34
1657874276658,MATH 18,B04,083751,Rideout; David Porter,6,0,36,30
1657874276658,MATH 18,B05,093473,Rideout; David Porter,6,0,36,30
1657874276658,MATH 18,B06,093474,Rideout; David Porter,6,0,36,30
1657874282684,MATH 20A,A01,083754,Zheng; Zequn,14,0,40,26
1657874288707,MATH 20B,A01,083756,Briones; Jor-el Thomas Caparas,4,0,36,32
1657874288707,MATH 20B,A02,083757,Briones; Jor-el Thomas Caparas,1,0,36,35
1657874288707,MATH 20B,A03,093475,Briones; Jor-el Thomas Caparas,2,0,36,34
1657874294736,MATH 20C,A01,083760,Briones; Jor-el Thomas Caparas,1,0,35,34
1657874294736,MATH 20C,A02,083761,Briones; Jor-el Thomas Caparas,8,0,35,27
1657874294736,MATH 20C,A03,093476,Briones; Jor-el Thomas Caparas,0,1,36,36
1657874294736,MATH 20C,B01,083762,Bach; Quang Tran,1,0,30,29
1657874300762,MATH 20D,A01,083765,Tran; Brian Kha,5,0,30,25
1657874300762,MATH 20D,A02,083766,Tran; Brian Kha,5,0,30,25
1657874300762,MATH 20D,A03,083767,Tran; Brian Kha,5,0,30,25
1657874306792,MATH 20E,A01,083771,Ganguly; Soumya,10,0,32,22
1657874306792,MATH 20E,A02,083772,Ganguly; Soumya,6,0,32,26
1657874306792,MATH 20E,B01,083773,Ciotti; Benjamin,20,0,35,15
1657874306792,MATH 20E,B02,083774,Ciotti; Benjamin,18,0,35,17
1657874312819,MATH 103A,A01,083777,Greenfeld; Be'Eri,3,0,36,33
1657874312819,MATH 103A,A02,083778,Greenfeld; Be'Eri,5,0,36,31
1657874312819,MATH 103A,A03,093561,Greenfeld; Be'Eri,6,0,36,30
1657874312819,MATH 103A,B01,083779,Greenfeld; Be'Eri,7,0,36,29
1657874312819,MATH 103A,B02,083780,Greenfeld; Be'Eri,4,0,36,32
1657874312819,MATH 103A,B03,093562,Greenfeld; Be'Eri,3,0,36,33
1657874318844,MATH 105,A01,085443,Carter; Anne Toulson,15,0,35,20
1657874318844,MATH 105,A02,093477,Carter; Anne Toulson,20,0,35,15
1657874324881,MATH 109,A01,083213,Ganzberger; Geoffrey Michael,3,0,34,31
1657874324881,MATH 109,A02,083214,Ganzberger; Geoffrey Michael,4,0,34,30
1657874324881,MATH 109,A03,093478,Ganzberger; Geoffrey Michael,2,0,34,32
1657874324881,MATH 109,B01,083215,Ganzberger; Geoffrey Michael,1,0,32,31
1657874324881,MATH 109,B02,083216,Ganzberger; Geoffrey Michael,2,0,32,30
1657874324881,MATH 109,B03,093479,Ganzberger; Geoffrey Michael,8,0,32,24
1657874330912,MATH 142A,A01,083219,Chow; Bennett,7,0,32,25
1657874330912,MATH 142A,A02,083220,Chow; Bennett,10,0,32,22
1657874330912,MATH 142A,A03,093480,Chow; Bennett,9,0,32,23
1657874330912,MATH 142A,B03,093481,Chow; Bennett,8,0,32,24
1657874330912,MATH 142A,B04,093558,Chow; Bennett,13,0,32,19
1657874330912,MATH 142A,B05,093559,Chow; Bennett,7,0,32,25
1657874336937,MATH 193A,A01,083224,Rotar; Vladimir,8,0,34,26
1657874336937,MATH 193A,A02,083225,Rotar; Vladimir,10,0,34,24
1657874336937,MATH 193A,A03,083781,Rotar; Vladimir,5,0,34,29
1657874336937,MATH 193A,A04,083782,Rotar; Vladimir,11,0,34,23
1657874336937,MATH 193A,A05,093482,Rotar; Vladimir,10,0,34,24
1657874343069,MATH 197,001,091859,McAuley; Julian John,9999,0,9999,0
1657874343069,MATH 197,002,095566,Kedlaya; Kiran S.,9997,0,9999,2
1657874343069,MATH 197,003,095567,Xiao; Ming,9999,0,9999,0
1657874343069,MATH 197,004,095571,Perols; Johan Lars,9998,0,9999,1
1657874350135,COGS 9,A01,083615,Shannon; Kyle Michael,10,0,75,65
1657874356164,COGS 11,A01,083617,Boyle; Mary E. T.,23,0,48,25
1657874362191,COGS 13,A01,083071,Bastos; Amalia Pinkusfeld,11,0,71,60
1657874368219,COGS 14A,A01,092681,Semenuks; Arturs,5,1,100,95
1657874374249,COGS 14B,A01,083073,Cheng; Tzu-Han,6,0,63,57
1657874380272,COGS 17,A01,092677,Semenuks; Arturs,6,0,81,75
1657874386299,COGS 100,A01,083619,Allen; Michael Gordon,17,0,70,53
1657874392321,COGS 101A,A01,083621,Davis; Joshua Daniel,9,0,68,59
1657874398350,COGS 101B,A01,091572,Allen; Michael Gordon,13,0,65,52
1657874404374,COGS 101C,A01,083625,Delgado; Tania,17,0,35,18
1657874410400,COGS 107A,A01,083627,Boyle; Mary E. T.,14,0,60,46
1657874416427,COGS 118A,A01,083075,Gupta; Anjum,21,0,76,55
1657874422452,CSE 3,A50,083646,Miranda; Gregory Joseph,24,0,50,26
1657874428474,CSE 8A,A50,083650,Miranda; Gregory Joseph,17,1,56,39
1657874434500,CSE 11,A01,083080,Cao; Yingjun,6,15,40,34
1657874440522,CSE 12,A01,083652,Krause-Levy; Sophia Louisa,30,1,120,90
1657874446546,CSE 15L,A01,083654,Morris; Justin Loren,9,0,50,41
1657874446546,CSE 15L,A02,083655,Morris; Justin Loren,10,0,50,40
1657874452571,CSE 20,A01,083657,Tran; Khoa Dang,39,0,80,41
1657874458597,CSE 21,A01,095574,Bach; Quang Tran,22,0,48,26
1657874464620,CSE 30,A01,083084,Eldon; John,6,0,80,74
1657874464620,CSE 30,B01,095061,Bhaskar; Nishant,9,0,50,41
1657874470648,CSE 100,A01,083659,Cao; Yingjun,5,4,70,65
1657874476672,CSE 134B,A01,083661,Powell; Thomas Allan,24,0,100,76
1657874482696,CSE 140,A01,083663,Gungor; Onat,15,0,85,70
1657874488719,CSE 140L,A01,083088,Eldon; John,23,0,100,77
1657874494743,CSE 175,A01,083665,Kumar; Rakesh,3,0,25,22
1657874500766,CSE 190,A00,092507,Dubnov; Shlomo,8,0,20,12
1657874506789,ECE 45,A01,083139,Congero; Spencer William,6,0,75,69
1657874512813,ECE 65,A50,083695,Saad; Andrew S,12,0,30,18
1657874512813,ECE 65,A51,095125,Saad; Andrew S,24,0,26,2
1657874518843,ECE 109,A01,091882,Touri; Behrouz,20,0,70,50
1657874524867,ECE 180,A00,083140,Abi Samra; Nicholas Camill,1,0,30,29
1657874524867,ECE 180,B00,083141,Abi Samra; Nicholas Camill,0,0,30,30
1657874530900,MATH 10A,A01,083735,Patchell; Gregory David,2,0,30,28
1657874530900,MATH 10A,A02,083736,Patchell; Gregory David,20,0,30,10
1657874530900,MATH 10A,A03,083737,Patchell; Gregory David,16,0,30,14
1657874536928,MATH 10B,A01,083207,Lim; Seonhee,8,0,34,26
1657874536928,MATH 10B,A02,083208,Lim; Seonhee,10,0,35,25
1657874536928,MATH 10B,A03,093472,Lim; Seonhee,7,0,34,27
1657874536928,MATH 10B,B01,083739,Sinha; Shubham,14,0,30,16
1657874542964,MATH 18,A01,083743,Cinel; Cameron Alexander,9,0,30,21
1657874542964,MATH 18,A02,083744,Cinel; Cameron Alexander,18,0,30,12
1657874542964,MATH 18,A03,083745,Cinel; Cameron Alexander,10,0,30,20
1657874542964,MATH 18,B01,083748,Rideout; David Porter,5,0,37,32
1657874542964,MATH 18,B02,083749,Rideout; David Porter,5,0,36,31
1657874542964,MATH 18,B03,083750,Rideout; David Porter,3,0,37,34
1657874542964,MATH 18,B04,083751,Rideout; David Porter,6,0,36,30
1657874542964,MATH 18,B05,093473,Rideout; David Porter,6,0,36,30
1657874542964,MATH 18,B06,093474,Rideout; David Porter,6,0,36,30
1657874548997,MATH 20A,A01,083754,Zheng; Zequn,14,0,40,26
1657874555029,MATH 20B,A01,083756,Briones; Jor-el Thomas Caparas,4,0,36,32
1657874555029,MATH 20B,A02,083757,Briones; Jor-el Thomas Caparas,1,0,36,35
1657874555029,MATH 20B,A03,093475,Briones; Jor-el Thomas Caparas,2,0,36,34
1657874561063,MATH 20C,A01,083760,Briones; Jor-el Thomas Caparas,1,0,35,34
1657874561063,MATH 20C,A02,083761,Briones; Jor-el Thomas Caparas,8,0,35,27
1657874561063,MATH 20C,A03,093476,Briones; Jor-el Thomas Caparas,0,1,36,36
1657874561063,MATH 20C,B01,083762,Bach; Quang Tran,1,0,30,29
1657874567086,MATH 20D,A01,083765,Tran; Brian Kha,5,0,30,25
1657874567086,MATH 20D,A02,083766,Tran; Brian Kha,5,0,30,25
1657874567086,MATH 20D,A03,083767,Tran; Brian Kha,5,0,30,25
1657874573112,MATH 20E,A01,083771,Ganguly; Soumya,10,0,32,22
1657874573112,MATH 20E,A02,083772,Ganguly; Soumya,6,0,32,26
1657874573112,MATH 20E,B01,083773,Ciotti; Benjamin,20,0,35,15
1657874573112,MATH 20E,B02,083774,Ciotti; Benjamin,18,0,35,17
1657874579146,MATH 103A,A01,083777,Greenfeld; Be'Eri,3,0,36,33
1657874579146,MATH 103A,A02,083778,Greenfeld; Be'Eri,5,0,36,31
1657874579146,MATH 103A,A03,093561,Greenfeld; Be'Eri,6,0,36,30
1657874579146,MATH 103A,B01,083779,Greenfeld; Be'Eri,7,0,36,29
1657874579146,MATH 103A,B02,083780,Greenfeld; Be'Eri,4,0,36,32
1657874579146,MATH 103A,B03,093562,Greenfeld; Be'Eri,3,0,36,33
1657874585171,MATH 105,A01,085443,Carter; Anne Toulson,15,0,35,20
1657874585171,MATH 105,A02,093477,Carter; Anne Toulson,20,0,35,15
1657874591204,MATH 109,A01,083213,Ganzberger; Geoffrey Michael,3,0,34,31
1657874591204,MATH 109,A02,083214,Ganzberger; Geoffrey Michael,4,0,34,30
1657874591204,MATH 109,A03,093478,Ganzberger; Geoffrey Michael,2,0,34,32
1657874591204,MATH 109,B01,083215,Ganzberger; Geoffrey Michael,1,0,32,31
1657874591204,MATH 109,B02,083216,Ganzberger; Geoffrey Michael,2,0,32,30
1657874591204,MATH 109,B03,093479,Ganzberger; Geoffrey Michael,8,0,32,24
1657874597232,MATH 142A,A01,083219,Chow; Bennett,7,0,32,25
1657874597232,MATH 142A,A02,083220,Chow; Bennett,10,0,32,22
1657874597232,MATH 142A,A03,093480,Chow; Bennett,9,0,32,23
1657874597232,MATH 142A,B03,093481,Chow; Bennett,8,0,32,24
1657874597232,MATH 142A,B04,093558,Chow; Bennett,13,0,32,19
1657874597232,MATH 142A,B05,093559,Chow; Bennett,7,0,32,25
1657874603264,MATH 193A,A01,083224,Rotar; Vladimir,8,0,34,26
1657874603264,MATH 193A,A02,083225,Rotar; Vladimir,10,0,34,24
1657874603264,MATH 193A,A03,083781,Rotar; Vladimir,5,0,34,29
1657874603264,MATH 193A,A04,083782,Rotar; Vladimir,11,0,34,23
1657874603264,MATH 193A,A05,093482,Rotar; Vladimir,10,0,34,24
1657874609292,MATH 197,001,091859,McAuley; Julian John,9999,0,9999,0
1657874609292,MATH 197,002,095566,Kedlaya; Kiran S.,9997,0,9999,2
1657874609292,MATH 197,003,095567,Xiao; Ming,9999,0,9999,0
1657874609292,MATH 197,004,095571,Perols; Johan Lars,9998,0,9999,1
1657874616363,COGS 9,A01,083615,Shannon; Kyle Michael,10,0,75,65
1657874622390,COGS 11,A01,083617,Boyle; Mary E. T.,23,0,48,25
1657874628419,COGS 13,A01,083071,Bastos; Amalia Pinkusfeld,11,0,71,60
1657874634447,COGS 14A,A01,092681,Semenuks; Arturs,5,1,100,95
1657874640476,COGS 14B,A01,083073,Cheng; Tzu-Han,6,0,63,57
1657874646499,COGS 17,A01,092677,Semenuks; Arturs,6,0,81,75
1657874652523,COGS 100,A01,083619,Allen; Michael Gordon,17,0,70,53
1657874658548,COGS 101A,A01,083621,Davis; Joshua Daniel,9,0,68,59
1657874664578,COGS 101B,A01,091572,Allen; Michael Gordon,13,0,65,52
1657874670609,COGS 101C,A01,083625,Delgado; Tania,17,0,35,18
1657874676644,COGS 107A,A01,083627,Boyle; Mary E. T.,14,0,60,46
1657874682668,COGS 118A,A01,083075,Gupta; Anjum,21,0,76,55
1657874688694,CSE 3,A50,083646,Miranda; Gregory Joseph,24,0,50,26
1657874694717,CSE 8A,A50,083650,Miranda; Gregory Joseph,17,1,56,39
1657874700741,CSE 11,A01,083080,Cao; Yingjun,6,15,40,34
1657874706766,CSE 12,A01,083652,Krause-Levy; Sophia Louisa,30,1,120,90
1657874712796,CSE 15L,A01,083654,Morris; Justin Loren,9,0,50,41
1657874712796,CSE 15L,A02,083655,Morris; Justin Loren,10,0,50,40
1657874718824,CSE 20,A01,083657,Tran; Khoa Dang,39,0,80,41
1657874724848,CSE 21,A01,095574,Bach; Quang Tran,22,0,48,26
1657874730871,CSE 30,A01,083084,Eldon; John,6,0,80,74
1657874730871,CSE 30,B01,095061,Bhaskar; Nishant,9,0,50,41
1657874736899,CSE 100,A01,083659,Cao; Yingjun,5,4,70,65
1657874742925,CSE 134B,A01,083661,Powell; Thomas Allan,24,0,100,76
1657874748954,CSE 140,A01,083663,Gungor; Onat,15,0,85,70
1657874754978,CSE 140L,A01,083088,Eldon; John,23,0,100,77
1657874761003,CSE 175,A01,083665,Kumar; Rakesh,3,0,25,22
1657874767030,CSE 190,A00,092507,Dubnov; Shlomo,8,0,20,12
1657874773062,ECE 45,A01,083139,Congero; Spencer William,6,0,75,69
1657874779099,ECE 65,A50,083695,Saad; Andrew S,12,0,30,18
1657874779099,ECE 65,A51,095125,Saad; Andrew S,24,0,26,2
1657874785127,ECE 109,A01,091882,Touri; Behrouz,20,0,70,50
1657874791159,ECE 180,A00,083140,Abi Samra; Nicholas Camill,1,0,30,29
1657874791159,ECE 180,B00,083141,Abi Samra; Nicholas Camill,0,0,30,30
1657874797192,MATH 10A,A01,083735,Patchell; Gregory David,2,0,30,28
1657874797192,MATH 10A,A02,083736,Patchell; Gregory David,20,0,30,10
1657874797192,MATH 10A,A03,083737,Patchell; Gregory David,16,0,30,14
1657874803223,MATH 10B,A01,083207,Lim; Seonhee,8,0,34,26
1657874803223,MATH 10B,A02,083208,Lim; Seonhee,10,0,35,25
1657874803223,MATH 10B,A03,093472,Lim; Seonhee,7,0,34,27
1657874803223,MATH 10B,B01,083739,Sinha; Shubham,14,0,30,16
1657874809264,MATH 18,A01,083743,Cinel; Cameron Alexander,9,0,30,21
1657874809264,MATH 18,A02,083744,Cinel; Cameron Alexander,18,0,30,12
1657874809264,MATH 18,A03,083745,Cinel; Cameron Alexander,10,0,30,20
1657874809264,MATH 18,B01,083748,Rideout; David Porter,5,0,37,32
1657874809264,MATH 18,B02,083749,Rideout; David Porter,5,0,36,31
1657874809264,MATH 18,B03,083750,Rideout; David Porter,3,0,37,34
1657874809264,MATH 18,B04,083751,Rideout; David Porter,6,0,36,30
1657874809264,MATH 18,B05,093473,Rideout; David Porter,6,0,36,30
1657874809264,MATH 18,B06,093474,Rideout; David Porter,6,0,36,30
1657874815290,MATH 20A,A01,083754,Zheng; Zequn,14,0,40,26
1657874821322,MATH 20B,A01,083756,Briones; Jor-el Thomas Caparas,4,0,36,32
1657874821322,MATH 20B,A02,083757,Briones; Jor-el Thomas Caparas,1,0,36,35
1657874821322,MATH 20B,A03,093475,Briones; Jor-el Thomas Caparas,2,0,36,34
1657874827347,MATH 20C,A01,083760,Briones; Jor-el Thomas Caparas,1,0,35,34
1657874827347,MATH 20C,A02,083761,Briones; Jor-el Thomas Caparas,8,0,35,27
1657874827347,MATH 20C,A03,093476,Briones; Jor-el Thomas Caparas,0,1,36,36
1657874827347,MATH 20C,B01,083762,Bach; Quang Tran,1,0,30,29
1657874833377,MATH 20D,A01,083765,Tran; Brian Kha,5,0,30,25
1657874833377,MATH 20D,A02,083766,Tran; Brian Kha,5,0,30,25
1657874833377,MATH 20D,A03,083767,Tran; Brian Kha,5,0,30,25
1657874839414,MATH 20E,A01,083771,Ganguly; Soumya,10,0,32,22
1657874839414,MATH 20E,A02,083772,Ganguly; Soumya,6,0,32,26
1657874839414,MATH 20E,B01,083773,Ciotti; Benjamin,20,0,35,15
1657874839414,MATH 20E,B02,083774,Ciotti; Benjamin,18,0,35,17
1657874845449,MATH 103A,A01,083777,Greenfeld; Be'Eri,3,0,36,33
1657874845449,MATH 103A,A02,083778,Greenfeld; Be'Eri,5,0,36,31
1657874845449,MATH 103A,A03,093561,Greenfeld; Be'Eri,6,0,36,30
1657874845449,MATH 103A,B01,083779,Greenfeld; Be'Eri,7,0,36,29
1657874845449,MATH 103A,B02,083780,Greenfeld; Be'Eri,4,0,36,32
1657874845449,MATH 103A,B03,093562,Greenfeld; Be'Eri,3,0,36,33
1657874851476,MATH 105,A01,085443,Carter; Anne Toulson,15,0,35,20
1657874851476,MATH 105,A02,093477,Carter; Anne Toulson,20,0,35,15
1657874857508,MATH 109,A01,083213,Ganzberger; Geoffrey Michael,3,0,34,31
1657874857508,MATH 109,A02,083214,Ganzberger; Geoffrey Michael,4,0,34,30
1657874857508,MATH 109,A03,093478,Ganzberger; Geoffrey Michael,2,0,34,32
1657874857508,MATH 109,B01,083215,Ganzberger; Geoffrey Michael,1,0,32,31
1657874857508,MATH 109,B02,083216,Ganzberger; Geoffrey Michael,2,0,32,30
1657874857508,MATH 109,B03,093479,Ganzberger; Geoffrey Michael,8,0,32,24
1657874863535,MATH 142A,A01,083219,Chow; Bennett,7,0,32,25
1657874863535,MATH 142A,A02,083220,Chow; Bennett,10,0,32,22
1657874863535,MATH 142A,A03,093480,Chow; Bennett,9,0,32,23
1657874863535,MATH 142A,B03,093481,Chow; Bennett,8,0,32,24
1657874863535,MATH 142A,B04,093558,Chow; Bennett,13,0,32,19
1657874863535,MATH 142A,B05,093559,Chow; Bennett,7,0,32,25
1657874869561,MATH 193A,A01,083224,Rotar; Vladimir,8,0,34,26
1657874869561,MATH 193A,A02,083225,Rotar; Vladimir,10,0,34,24
1657874869561,MATH 193A,A03,083781,Rotar; Vladimir,5,0,34,29
1657874869561,MATH 193A,A04,083782,Rotar; Vladimir,11,0,34,23
1657874869561,MATH 193A,A05,093482,Rotar; Vladimir,10,0,34,24
1657874875592,MATH 197,001,091859,McAuley; Julian John,9999,0,9999,0
1657874875592,MATH 197,002,095566,Kedlaya; Kiran S.,9997,0,9999,2
1657874875592,MATH 197,003,095567,Xiao; Ming,9999,0,9999,0
1657874875592,MATH 197,004,095571,Perols; Johan Lars,9998,0,9999,1
1657874882664,COGS 9,A01,083615,Shannon; Kyle Michael,10,0,75,65
1657874888688,COGS 11,A01,083617,Boyle; Mary E. T.,23,0,48,25
1657874894717,COGS 13,A01,083071,Bastos; Amalia Pinkusfeld,11,0,71,60
1657874900743,COGS 14A,A01,092681,Semenuks; Arturs,5,1,100,95
1657874906775,COGS 14B,A01,083073,Cheng; Tzu-Han,6,0,63,57
1657874912800,COGS 17,A01,092677,Semenuks; Arturs,6,0,81,75
1657874918835,COGS 100,A01,083619,Allen; Michael Gordon,17,0,70,53
1657874924859,COGS 101A,A01,083621,Davis; Joshua Daniel,9,0,68,59
1657874930884,COGS 101B,A01,091572,Allen; Michael Gordon,13,0,65,52
1657874936983,COGS 101C,A01,083625,Delgado; Tania,17,0,35,18
1657874943011,COGS 107A,A01,083627,Boyle; Mary E. T.,14,0,60,46
1657874949034,COGS 118A,A01,083075,Gupta; Anjum,21,0,76,55
1657874955065,CSE 3,A50,083646,Miranda; Gregory Joseph,24,0,50,26
1657874961088,CSE 8A,A50,083650,Miranda; Gregory Joseph,17,1,56,39
1657874967111,CSE 11,A01,083080,Cao; Yingjun,6,15,40,34
1657874973141,CSE 12,A01,083652,Krause-Levy; Sophia Louisa,30,1,120,90
1657874979165,CSE 15L,A01,083654,Morris; Justin Loren,9,0,50,41
1657874979165,CSE 15L,A02,083655,Morris; Justin Loren,10,0,50,40
1657874985194,CSE 20,A01,083657,Tran; Khoa Dang,39,0,80,41
1657874991220,CSE 21,A01,095574,Bach; Quang Tran,22,0,48,26
1657874997244,CSE 30,A01,083084,Eldon; John,6,0,80,74
1657874997244,CSE 30,B01,095061,Bhaskar; Nishant,9,0,50,41
1657875003274,CSE 100,A01,083659,Cao; Yingjun,5,4,70,65
1657875009305,CSE 134B,A01,083661,Powell; Thomas Allan,24,0,100,76
1657875015332,CSE 140,A01,083663,Gungor; Onat,15,0,85,70
1657875021355,CSE 140L,A01,083088,Eldon; John,23,0,100,77
1657875027381,CSE 175,A01,083665,Kumar; Rakesh,3,0,25,22
1657875033408,CSE 190,A00,092507,Dubnov; Shlomo,8,0,20,12
1657875039435,ECE 45,A01,083139,Congero; Spencer William,6,0,75,69
1657875045460,ECE 65,A50,083695,Saad; Andrew S,12,0,30,18
1657875045460,ECE 65,A51,095125,Saad; Andrew S,24,0,26,2
1657875051489,ECE 109,A01,091882,Touri; Behrouz,20,0,70,50
1657875057516,ECE 180,A00,083140,Abi Samra; Nicholas Camill,1,0,30,29
1657875057516,ECE 180,B00,083141,Abi Samra; Nicholas Camill,0,0,30,30
1657875063554,MATH 10A,A01,083735,Patchell; Gregory David,2,0,30,28
1657875063554,MATH 10A,A02,083736,Patchell; Gregory David,20,0,30,10
1657875063554,MATH 10A,A03,083737,Patchell; Gregory David,16,0,30,14
1657875069583,MATH 10B,A01,083207,Lim; Seonhee,8,0,34,26
1657875069583,MATH 10B,A02,083208,Lim; Seonhee,10,0,35,25
1657875069583,MATH 10B,A03,093472,Lim; Seonhee,7,0,34,27
1657875069583,MATH 10B,B01,083739,Sinha; Shubham,14,0,30,16
1657875075614,MATH 18,A01,083743,Cinel; Cameron Alexander,9,0,30,21
1657875075614,MATH 18,A02,083744,Cinel; Cameron Alexander,18,0,30,12
1657875075614,MATH 18,A03,083745,Cinel; Cameron Alexander,10,0,30,20
1657875075614,MATH 18,B01,083748,Rideout; David Porter,5,0,37,32
1657875075614,MATH 18,B02,083749,Rideout; David Porter,5,0,36,31
1657875075614,MATH 18,B03,083750,Rideout; David Porter,3,0,37,34
1657875075614,MATH 18,B04,083751,Rideout; David Porter,6,0,36,30
1657875075614,MATH 18,B05,093473,Rideout; David Porter,6,0,36,30
1657875075614,MATH 18,B06,093474,Rideout; David Porter,6,0,36,30
1657875081652,MATH 20A,A01,083754,Zheng; Zequn,14,0,40,26
1657875087682,MATH 20B,A01,083756,Briones; Jor-el Thomas Caparas,4,0,36,32
1657875087682,MATH 20B,A02,083757,Briones; Jor-el Thomas Caparas,1,0,36,35
1657875087682,MATH 20B,A03,093475,Briones; Jor-el Thomas Caparas,2,0,36,34
1657875093708,MATH 20C,A01,083760,Briones; Jor-el Thomas Caparas,1,0,35,34
1657875093708,MATH 20C,A02,083761,Briones; Jor-el Thomas Caparas,8,0,35,27
1657875093708,MATH 20C,A03,093476,Briones; Jor-el Thomas Caparas,0,1,36,36
1657875093708,MATH 20C,B01,083762,Bach; Quang Tran,1,0,30,29
1657875099738,MATH 20D,A01,083765,Tran; Brian Kha,5,0,30,25
1657875099738,MATH 20D,A02,083766,Tran; Brian Kha,5,0,30,25
1657875099738,MATH 20D,A03,083767,Tran; Brian Kha,5,0,30,25
1657875105770,MATH 20E,A01,083771,Ganguly; Soumya,10,0,32,22
1657875105770,MATH 20E,A02,083772,Ganguly; Soumya,6,0,32,26
1657875105770,MATH 20E,B01,083773,Ciotti; Benjamin,20,0,35,15
1657875105770,MATH 20E,B02,083774,Ciotti; Benjamin,18,0,35,17
1657875111797,MATH 103A,A01,083777,Greenfeld; Be'Eri,3,0,36,33
1657875111797,MATH 103A,A02,083778,Greenfeld; Be'Eri,5,0,36,31
1657875111797,MATH 103A,A03,093561,Greenfeld; Be'Eri,6,0,36,30
1657875111797,MATH 103A,B01,083779,Greenfeld; Be'Eri,7,0,36,29
1657875111797,MATH 103A,B02,083780,Greenfeld; Be'Eri,4,0,36,32
1657875111797,MATH 103A,B03,093562,Greenfeld; Be'Eri,3,0,36,33
1657875117824,MATH 105,A01,085443,Carter; Anne Toulson,15,0,35,20
1657875117824,MATH 105,A02,093477,Carter; Anne Toulson,20,0,35,15
1657875123850,MATH 109,A01,083213,Ganzberger; Geoffrey Michael,3,0,34,31
1657875123850,MATH 109,A02,083214,Ganzberger; Geoffrey Michael,4,0,34,30
1657875123850,MATH 109,A03,093478,Ganzberger; Geoffrey Michael,2,0,34,32
1657875123850,MATH 109,B01,083215,Ganzberger; Geoffrey Michael,1,0,32,31
1657875123850,MATH 109,B02,083216,Ganzberger; Geoffrey Michael,2,0,32,30
1657875123850,MATH 109,B03,093479,Ganzberger; Geoffrey Michael,8,0,32,24
1657875129889,MATH 142A,A01,083219,Chow; Bennett,7,0,32,25
1657875129889,MATH 142A,A02,083220,Chow; Bennett,10,0,32,22
1657875129889,MATH 142A,A03,093480,Chow; Bennett,9,0,32,23
1657875129889,MATH 142A,B03,093481,Chow; Bennett,8,0,32,24
1657875129889,MATH 142A,B04,093558,Chow; Bennett,13,0,32,19
1657875129889,MATH 142A,B05,093559,Chow; Bennett,7,0,32,25
1657875135916,MATH 193A,A01,083224,Rotar; Vladimir,8,0,34,26
1657875135916,MATH 193A,A02,083225,Rotar; Vladimir,10,0,34,24
1657875135916,MATH 193A,A03,083781,Rotar; Vladimir,5,0,34,29
1657875135916,MATH 193A,A04,083782,Rotar; Vladimir,11,0,34,23
1657875135916,MATH 193A,A05,093482,Rotar; Vladimir,10,0,34,24
1657875141945,MATH 197,001,091859,McAuley; Julian John,9999,0,9999,0
1657875141945,MATH 197,002,095566,Kedlaya; Kiran S.,9997,0,9999,2
1657875141945,MATH 197,003,095567,Xiao; Ming,9999,0,9999,0
1657875141945,MATH 197,004,095571,Perols; Johan Lars,9998,0,9999,1
1657875149008,COGS 9,A01,083615,Shannon; Kyle Michael,10,0,75,65
1657875155032,COGS 11,A01,083617,Boyle; Mary E. T.,23,0,48,25
1657875161061,COGS 13,A01,083071,Bastos; Amalia Pinkusfeld,11,0,71,60
1657875167090,COGS 14A,A01,092681,Semenuks; Arturs,5,1,100,95
1657875173116,COGS 14B,A01,083073,Cheng; Tzu-Han,6,0,63,57
1657875179143,COGS 17,A01,092677,Semenuks; Arturs,6,0,81,75
1657875185168,COGS 100,A01,083619,Allen; Michael Gordon,17,0,70,53
1657875191191,COGS 101A,A01,083621,Davis; Joshua Daniel,9,0,68,59
1657875197213,COGS 101B,A01,091572,Allen; Michael Gordon,13,0,65,52
1657875203248,COGS 101C,A01,083625,Delgado; Tania,17,0,35,18
1657875209276,COGS 107A,A01,083627,Boyle; Mary E. T.,14,0,60,46
1657875215299,COGS 118A,A01,083075,Gupta; Anjum,21,0,76,55
1657875221388,CSE 3,A50,083646,Miranda; Gregory Joseph,24,0,50,26
1657875227416,CSE 8A,A50,083650,Miranda; Gregory Joseph,17,1,56,39
1657875233444,CSE 11,A01,083080,Cao; Yingjun,6,15,40,34
1657875239468,CSE 12,A01,083652,Krause-Levy; Sophia Louisa,30,1,120,90
1657875245492,CSE 15L,A01,083654,Morris; Justin Loren,9,0,50,41
1657875245492,CSE 15L,A02,083655,Morris; Justin Loren,10,0,50,40
1657875251519,CSE 20,A01,083657,Tran; Khoa Dang,39,0,80,41
1657875257544,CSE 21,A01,095574,Bach; Quang Tran,22,0,48,26
1657875263569,CSE 30,A01,083084,Eldon; John,6,0,80,74
1657875263569,CSE 30,B01,095061,Bhaskar; Nishant,9,0,50,41
1657875269593,CSE 100,A01,083659,Cao; Yingjun,5,4,70,65
1657875275620,CSE 134B,A01,083661,Powell; Thomas Allan,24,0,100,76
1657875281645,CSE 140,A01,083663,Gungor; Onat,15,0,85,70
1657875287669,CSE 140L,A01,083088,Eldon; John,23,0,100,77
1657875293694,CSE 175,A01,083665,Kumar; Rakesh,3,0,25,22
1657875299721,CSE 190,A00,092507,Dubnov; Shlomo,8,0,20,12
1657875305745,ECE 45,A01,083139,Congero; Spencer William,6,0,75,69
1657875311776,ECE 65,A50,083695,Saad; Andrew S,12,0,30,18
1657875311776,ECE 65,A51,095125,Saad; Andrew S,24,0,26,2
1657875317805,ECE 109,A01,091882,Touri; Behrouz,20,0,70,50
1657875323839,ECE 180,A00,083140,Abi Samra; Nicholas Camill,1,0,30,29
1657875323839,ECE 180,B00,083141,Abi Samra; Nicholas Camill,0,0,30,30
1657875329867,MATH 10A,A01,083735,Patchell; Gregory David,2,0,30,28
1657875329867,MATH 10A,A02,083736,Patchell; Gregory David,20,0,30,10
1657875329867,MATH 10A,A03,083737,Patchell; Gregory David,16,0,30,14
1657875335891,MATH 10B,A01,083207,Lim; Seonhee,8,0,34,26
1657875335891,MATH 10B,A02,083208,Lim; Seonhee,10,0,35,25
1657875335891,MATH 10B,A03,093472,Lim; Seonhee,7,0,34,27
1657875335891,MATH 10B,B01,083739,Sinha; Shubham,14,0,30,16
1657875341917,MATH 18,A01,083743,Cinel; Cameron Alexander,9,0,30,21
1657875341917,MATH 18,A02,083744,Cinel; Cameron Alexander,18,0,30,12
1657875341917,MATH 18,A03,083745,Cinel; Cameron Alexander,10,0,30,20
1657875341917,MATH 18,B01,083748,Rideout; David Porter,5,0,37,32
1657875341917,MATH 18,B02,083749,Rideout; David Porter,5,0,36,31
1657875341917,MATH 18,B03,083750,Rideout; David Porter,3,0,37,34
1657875341917,MATH 18,B04,083751,Rideout; David Porter,6,0,36,30
1657875341917,MATH 18,B05,093473,Rideout; David Porter,6,0,36,30
1657875341917,MATH 18,B06,093474,Rideout; David Porter,6,0,36,30
1657875347942,MATH 20A,A01,083754,Zheng; Zequn,14,0,40,26
1657875353969,MATH 20B,A01,083756,Briones; Jor-el Thomas Caparas,4,0,36,32
1657875353969,MATH 20B,A02,083757,Briones; Jor-el Thomas Caparas,1,0,36,35
1657875353969,MATH 20B,A03,093475,Briones; Jor-el Thomas Caparas,2,0,36,34
1657875360001,MATH 20C,A01,083760,Briones; Jor-el Thomas Caparas,1,0,35,34
1657875360001,MATH 20C,A02,083761,Briones; Jor-el Thomas Caparas,8,0,35,27
1657875360001,MATH 20C,A03,093476,Briones; Jor-el Thomas Caparas,0,1,36,36
1657875360001,MATH 20C,B01,083762,Bach; Quang Tran,1,0,30,29
1657875366023,MATH 20D,A01,083765,Tran; Brian Kha,5,0,30,25
1657875366023,MATH 20D,A02,083766,Tran; Brian Kha,5,0,30,25
1657875366023,MATH 20D,A03,083767,Tran; Brian Kha,5,0,30,25
1657875372055,MATH 20E,A01,083771,Ganguly; Soumya,10,0,32,22
1657875372055,MATH 20E,A02,083772,Ganguly; Soumya,6,0,32,26
1657875372055,MATH 20E,B01,083773,Ciotti; Benjamin,20,0,35,15
1657875372055,MATH 20E,B02,083774,Ciotti; Benjamin,18,0,35,17
1657875378089,MATH 103A,A01,083777,Greenfeld; Be'Eri,3,0,36,33
1657875378089,MATH 103A,A02,083778,Greenfeld; Be'Eri,5,0,36,31
1657875378089,MATH 103A,A03,093561,Greenfeld; Be'Eri,6,0,36,30
1657875378089,MATH 103A,B01,083779,Greenfeld; Be'Eri,7,0,36,29
1657875378089,MATH 103A,B02,083780,Greenfeld; Be'Eri,4,0,36,32
1657875378089,MATH 103A,B03,093562,Greenfeld; Be'Eri,3,0,36,33
1657875384114,MATH 105,A01,085443,Carter; Anne Toulson,15,0,35,20
1657875384114,MATH 105,A02,093477,Carter; Anne Toulson,20,0,35,15
1657875390138,MATH 109,A01,083213,Ganzberger; Geoffrey Michael,3,0,34,31
1657875390138,MATH 109,A02,083214,Ganzberger; Geoffrey Michael,4,0,34,30
1657875390138,MATH 109,A03,093478,Ganzberger; Geoffrey Michael,2,0,34,32
1657875390138,MATH 109,B01,083215,Ganzberger; Geoffrey Michael,1,0,32,31
1657875390138,MATH 109,B02,083216,Ganzberger; Geoffrey Michael,2,0,32,30
1657875390138,MATH 109,B03,093479,Ganzberger; Geoffrey Michael,8,0,32,24
1657875396163,MATH 142A,A01,083219,Chow; Bennett,7,0,32,25
1657875396163,MATH 142A,A02,083220,Chow; Bennett,10,0,32,22
1657875396163,MATH 142A,A03,093480,Chow; Bennett,9,0,32,23
1657875396163,MATH 142A,B03,093481,Chow; Bennett,8,0,32,24
1657875396163,MATH 142A,B04,093558,Chow; Bennett,13,0,32,19
1657875396163,MATH 142A,B05,093559,Chow; Bennett,7,0,32,25
1657875402188,MATH 193A,A01,083224,Rotar; Vladimir,8,0,34,26
1657875402188,MATH 193A,A02,083225,Rotar; Vladimir,10,0,34,24
1657875402188,MATH 193A,A03,083781,Rotar; Vladimir,5,0,34,29
1657875402188,MATH 193A,A04,083782,Rotar; Vladimir,11,0,34,23
1657875402188,MATH 193A,A05,093482,Rotar; Vladimir,10,0,34,24
1657875408214,MATH 197,001,091859,McAuley; Julian John,9999,0,9999,0
1657875408214,MATH 197,002,095566,Kedlaya; Kiran S.,9997,0,9999,2
1657875408214,MATH 197,003,095567,Xiao; Ming,9999,0,9999,0
1657875408214,MATH 197,004,095571,Perols; Johan Lars,9998,0,9999,1
1657875415290,COGS 9,A01,083615,Shannon; Kyle Michael,10,0,75,65
1657875421313,COGS 11,A01,083617,Boyle; Mary E. T.,23,0,48,25
1657875427338,COGS 13,A01,083071,Bastos; Amalia Pinkusfeld,11,0,71,60
1657875433363,COGS 14A,A01,092681,Semenuks; Arturs,5,1,100,95
1657875439387,COGS 14B,A01,083073,Cheng; Tzu-Han,6,0,63,57
1657875445411,COGS 17,A01,092677,Semenuks; Arturs,6,0,81,75
1657875451436,COGS 100,A01,083619,Allen; Michael Gordon,17,0,70,53
1657875457460,COGS 101A,A01,083621,Davis; Joshua Daniel,9,0,68,59
1657875463488,COGS 101B,A01,091572,Allen; Michael Gordon,13,0,65,52
1657875469516,COGS 101C,A01,083625,Delgado; Tania,17,0,35,18
1657875475545,COGS 107A,A01,083627,Boyle; Mary E. T.,14,0,60,46
1657875481573,COGS 118A,A01,083075,Gupta; Anjum,21,0,76,55
1657875487598,CSE 3,A50,083646,Miranda; Gregory Joseph,24,0,50,26
1657875493621,CSE 8A,A50,083650,Miranda; Gregory Joseph,17,1,56,39
1657875499643,CSE 11,A01,083080,Cao; Yingjun,6,15,40,34
1657875505670,CSE 12,A01,083652,Krause-Levy; Sophia Louisa,30,1,120,90
1657875511699,CSE 15L,A01,083654,Morris; Justin Loren,9,0,50,41
1657875511699,CSE 15L,A02,083655,Morris; Justin Loren,10,0,50,40
1657875517722,CSE 20,A01,083657,Tran; Khoa Dang,39,0,80,41
1657875523750,CSE 21,A01,095574,Bach; Quang Tran,22,0,48,26
1657875529775,CSE 30,A01,083084,Eldon; John,6,0,80,74
1657875529775,CSE 30,B01,095061,Bhaskar; Nishant,9,0,50,41
1657875535880,CSE 100,A01,083659,Cao; Yingjun,5,4,70,65
1657875541905,CSE 134B,A01,083661,Powell; Thomas Allan,24,0,100,76
1657875547931,CSE 140,A01,083663,Gungor; Onat,15,0,85,70
1657875553963,CSE 140L,A01,083088,Eldon; John,23,0,100,77
1657875559987,CSE 175,A01,083665,Kumar; Rakesh,3,0,25,22
1657875566014,CSE 190,A00,092507,Dubnov; Shlomo,8,0,20,12
1657875572038,ECE 45,A01,083139,Congero; Spencer William,6,0,75,69
1657875578065,ECE 65,A50,083695,Saad; Andrew S,12,0,30,18
1657875578065,ECE 65,A51,095125,Saad; Andrew S,24,0,26,2
1657875584095,ECE 109,A01,091882,Touri; Behrouz,20,0,70,50
1657875590130,ECE 180,A00,083140,Abi Samra; Nicholas Camill,1,0,30,29
1657875590130,ECE 180,B00,083141,Abi Samra; Nicholas Camill,0,0,30,30
1657875596162,MATH 10A,A01,083735,Patchell; Gregory David,2,0,30,28
1657875596162,MATH 10A,A02,083736,Patchell; Gregory David,20,0,30,10
1657875596162,MATH 10A,A03,083737,Patchell; Gregory David,16,0,30,14
1657875602187,MATH 10B,A01,083207,Lim; Seonhee,8,0,34,26
1657875602187,MATH 10B,A02,083208,Lim; Seonhee,10,0,35,25
1657875602187,MATH 10B,A03,093472,Lim; Seonhee,7,0,34,27
1657875602187,MATH 10B,B01,083739,Sinha; Shubham,14,0,30,16
1657875608213,MATH 18,A01,083743,Cinel; Cameron Alexander,9,0,30,21
1657875608213,MATH 18,A02,083744,Cinel; Cameron Alexander,18,0,30,12
1657875608213,MATH 18,A03,083745,Cinel; Cameron Alexander,10,0,30,20
1657875608213,MATH 18,B01,083748,Rideout; David Porter,5,0,37,32
1657875608213,MATH 18,B02,083749,Rideout; David Porter,5,0,36,31
1657875608213,MATH 18,B03,083750,Rideout; David Porter,3,0,37,34
1657875608213,MATH 18,B04,083751,Rideout; David Porter,6,0,36,30
1657875608213,MATH 18,B05,093473,Rideout; David Porter,6,0,36,30
1657875608213,MATH 18,B06,093474,Rideout; David Porter,6,0,36,30
1657875614239,MATH 20A,A01,083754,Zheng; Zequn,14,0,40,26
1657875620262,MATH 20B,A01,083756,Briones; Jor-el Thomas Caparas,4,0,36,32
1657875620262,MATH 20B,A02,083757,Briones; Jor-el Thomas Caparas,1,0,36,35
1657875620262,MATH 20B,A03,093475,Briones; Jor-el Thomas Caparas,2,0,36,34
1657875626286,MATH 20C,A01,083760,Briones; Jor-el Thomas Caparas,1,0,35,34
1657875626286,MATH 20C,A02,083761,Briones; Jor-el Thomas Caparas,8,0,35,27
1657875626286,MATH 20C,A03,093476,Briones; Jor-el Thomas Caparas,0,1,36,36
1657875626286,MATH 20C,B01,083762,Bach; Quang Tran,1,0,30,29
1657875632316,MATH 20D,A01,083765,Tran; Brian Kha,5,0,30,25
1657875632316,MATH 20D,A02,083766,Tran; Brian Kha,5,0,30,25
1657875632316,MATH 20D,A03,083767,Tran; Brian Kha,5,0,30,25
1657875638344,MATH 20E,A01,083771,Ganguly; Soumya,10,0,32,22
1657875638344,MATH 20E,A02,083772,Ganguly; Soumya,6,0,32,26
1657875638344,MATH 20E,B01,083773,Ciotti; Benjamin,20,0,35,15
1657875638344,MATH 20E,B02,083774,Ciotti; Benjamin,18,0,35,17
1657875644376,MATH 103A,A01,083777,Greenfeld; Be'Eri,3,0,36,33
1657875644376,MATH 103A,A02,083778,Greenfeld; Be'Eri,5,0,36,31
1657875644376,MATH 103A,A03,093561,Greenfeld; Be'Eri,6,0,36,30
1657875644376,MATH 103A,B01,083779,Greenfeld; Be'Eri,7,0,36,29
1657875644376,MATH 103A,B02,083780,Greenfeld; Be'Eri,4,0,36,32
1657875644376,MATH 103A,B03,093562,Greenfeld; Be'Eri,3,0,36,33
1657875650401,MATH 105,A01,085443,Carter; Anne Toulson,15,0,35,20
1657875650401,MATH 105,A02,093477,Carter; Anne Toulson,20,0,35,15
1657875656432,MATH 109,A01,083213,Ganzberger; Geoffrey Michael,3,0,34,31
1657875656432,MATH 109,A02,083214,Ganzberger; Geoffrey Michael,4,0,34,30
1657875656432,MATH 109,A03,093478,Ganzberger; Geoffrey Michael,2,0,34,32
1657875656432,MATH 109,B01,083215,Ganzberger; Geoffrey Michael,1,0,32,31
1657875656432,MATH 109,B02,083216,Ganzberger; Geoffrey Michael,2,0,32,30
1657875656432,MATH 109,B03,093479,Ganzberger; Geoffrey Michael,8,0,32,24
1657875662471,MATH 142A,A01,083219,Chow; Bennett,7,0,32,25
1657875662471,MATH 142A,A02,083220,Chow; Bennett,10,0,32,22
1657875662471,MATH 142A,A03,093480,Chow; Bennett,9,0,32,23
1657875662471,MATH 142A,B03,093481,Chow; Bennett,8,0,32,24
1657875662471,MATH 142A,B04,093558,Chow; Bennett,13,0,32,19
1657875662471,MATH 142A,B05,093559,Chow; Bennett,7,0,32,25
1657875668505,MATH 193A,A01,083224,Rotar; Vladimir,8,0,34,26
1657875668505,MATH 193A,A02,083225,Rotar; Vladimir,10,0,34,24
1657875668505,MATH 193A,A03,083781,Rotar; Vladimir,5,0,34,29
1657875668505,MATH 193A,A04,083782,Rotar; Vladimir,11,0,34,23
1657875668505,MATH 193A,A05,093482,Rotar; Vladimir,10,0,34,24
1657875674536,MATH 197,001,091859,McAuley; Julian John,9999,0,9999,0
1657875674536,MATH 197,002,095566,Kedlaya; Kiran S.,9997,0,9999,2
1657875674536,MATH 197,003,095567,Xiao; Ming,9999,0,9999,0
1657875674536,MATH 197,004,095571,Perols; Johan Lars,9998,0,9999,1
1657875681599,COGS 9,A01,083615,Shannon; Kyle Michael,10,0,75,65
1657875687624,COGS 11,A01,083617,Boyle; Mary E. T.,23,0,48,25
1657875693659,COGS 13,A01,083071,Bastos; Amalia Pinkusfeld,11,0,71,60
1657875699684,COGS 14A,A01,092681,Semenuks; Arturs,5,1,100,95
1657875705713,COGS 14B,A01,083073,Cheng; Tzu-Han,6,0,63,57
1657875711736,COGS 17,A01,092677,Semenuks; Arturs,6,0,81,75
1657875717760,COGS 100,A01,083619,Allen; Michael Gordon,17,0,70,53
1657875723790,COGS 101A,A01,083621,Davis; Joshua Daniel,9,0,68,59
1657875729816,COGS 101B,A01,091572,Allen; Michael Gordon,13,0,65,52
1657875735847,COGS 101C,A01,083625,Delgado; Tania,17,0,35,18
1657875741875,COGS 107A,A01,083627,Boyle; Mary E. T.,14,0,60,46
1657875747906,COGS 118A,A01,083075,Gupta; Anjum,21,0,76,55
1657875753938,CSE 3,A50,083646,Miranda; Gregory Joseph,24,0,50,26
1657875759968,CSE 8A,A50,083650,Miranda; Gregory Joseph,17,1,56,39
1657875766018,CSE 11,A01,083080,Cao; Yingjun,6,15,40,34
1657875772047,CSE 12,A01,083652,Krause-Levy; Sophia Louisa,30,1,120,90
1657875778074,CSE 15L,A01,083654,Morris; Justin Loren,9,0,50,41
1657875778074,CSE 15L,A02,083655,Morris; Justin Loren,10,0,50,40
1657875784098,CSE 20,A01,083657,Tran; Khoa Dang,39,0,80,41
1657875790126,CSE 21,A01,095574,Bach; Quang Tran,22,0,48,26
1657875796156,CSE 30,A01,083084,Eldon; John,6,0,80,74
1657875796156,CSE 30,B01,095061,Bhaskar; Nishant,9,0,50,41
1657875802188,CSE 100,A01,083659,Cao; Yingjun,5,4,70,65
1657875808212,CSE 134B,A01,083661,Powell; Thomas Allan,24,0,100,76
1657875814236,CSE 140,A01,083663,Gungor; Onat,15,0,85,70
1657875820259,CSE 140L,A01,083088,Eldon; John,23,0,100,77
1657875826284,CSE 175,A01,083665,Kumar; Rakesh,3,0,25,22
1657875832307,CSE 190,A00,092507,Dubnov; Shlomo,8,0,20,12
1657875838336,ECE 45,A01,083139,Congero; Spencer William,6,0,75,69
1657875844361,ECE 65,A50,083695,Saad; Andrew S,12,0,30,18
1657875844361,ECE 65,A51,095125,Saad; Andrew S,24,0,26,2
1657875850392,ECE 109,A01,091882,Touri; Behrouz,20,0,70,50
1657875856415,ECE 180,A00,083140,Abi Samra; Nicholas Camill,1,0,30,29
1657875856415,ECE 180,B00,083141,Abi Samra; Nicholas Camill,0,0,30,30
1657875862439,MATH 10A,A01,083735,Patchell; Gregory David,2,0,30,28
1657875862439,MATH 10A,A02,083736,Patchell; Gregory David,20,0,30,10
1657875862439,MATH 10A,A03,083737,Patchell; Gregory David,16,0,30,14
1657875868466,MATH 10B,A01,083207,Lim; Seonhee,8,0,34,26
1657875868466,MATH 10B,A02,083208,Lim; Seonhee,10,0,35,25
1657875868466,MATH 10B,A03,093472,Lim; Seonhee,7,0,34,27
1657875868466,MATH 10B,B01,083739,Sinha; Shubham,14,0,30,16
1657875874493,MATH 18,A01,083743,Cinel; Cameron Alexander,9,0,30,21
1657875874493,MATH 18,A02,083744,Cinel; Cameron Alexander,18,0,30,12
1657875874493,MATH 18,A03,083745,Cinel; Cameron Alexander,10,0,30,20
1657875874493,MATH 18,B01,083748,Rideout; David Porter,5,0,37,32
1657875874493,MATH 18,B02,083749,Rideout; David Porter,5,0,36,31
1657875874493,MATH 18,B03,083750,Rideout; David Porter,3,0,37,34
1657875874493,MATH 18,B04,083751,Rideout; David Porter,6,0,36,30
1657875874493,MATH 18,B05,093473,Rideout; David Porter,6,0,36,30
1657875874493,MATH 18,B06,093474,Rideout; David Porter,6,0,36,30
1657875880517,MATH 20A,A01,083754,Zheng; Zequn,14,0,40,26
1657875886549,MATH 20B,A01,083756,Briones; Jor-el Thomas Caparas,4,0,36,32
1657875886549,MATH 20B,A02,083757,Briones; Jor-el Thomas Caparas,1,0,36,35
1657875886549,MATH 20B,A03,093475,Briones; Jor-el Thomas Caparas,2,0,36,34
1657875892574,MATH 20C,A01,083760,Briones; Jor-el Thomas Caparas,1,0,35,34
1657875892574,MATH 20C,A02,083761,Briones; Jor-el Thomas Caparas,8,0,35,27
1657875892574,MATH 20C,A03,093476,Briones; Jor-el Thomas Caparas,0,1,36,36
1657875892574,MATH 20C,B01,083762,Bach; Quang Tran,1,0,30,29
1657875898599,MATH 20D,A01,083765,Tran; Brian Kha,5,0,30,25
1657875898599,MATH 20D,A02,083766,Tran; Brian Kha,5,0,30,25
1657875898599,MATH 20D,A03,083767,Tran; Brian Kha,5,0,30,25
1657875904630,MATH 20E,A01,083771,Ganguly; Soumya,10,0,32,22
1657875904630,MATH 20E,A02,083772,Ganguly; Soumya,6,0,32,26
1657875904630,MATH 20E,B01,083773,Ciotti; Benjamin,20,0,35,15
1657875904630,MATH 20E,B02,083774,Ciotti; Benjamin,18,0,35,17
1657875910678,MATH 103A,A01,083777,Greenfeld; Be'Eri,3,0,36,33
1657875910678,MATH 103A,A02,083778,Greenfeld; Be'Eri,5,0,36,31
1657875910678,MATH 103A,A03,093561,Greenfeld; Be'Eri,6,0,36,30
1657875910678,MATH 103A,B01,083779,Greenfeld; Be'Eri,7,0,36,29
1657875910678,MATH 103A,B02,083780,Greenfeld; Be'Eri,4,0,36,32
1657875910678,MATH 103A,B03,093562,Greenfeld; Be'Eri,3,0,36,33
1657875916707,MATH 105,A01,085443,Carter; Anne Toulson,15,0,35,20
1657875916707,MATH 105,A02,093477,Carter; Anne Toulson,20,0,35,15
1657875922734,MATH 109,A01,083213,Ganzberger; Geoffrey Michael,3,0,34,31
1657875922734,MATH 109,A02,083214,Ganzberger; Geoffrey Michael,4,0,34,30
1657875922734,MATH 109,A03,093478,Ganzberger; Geoffrey Michael,2,0,34,32
1657875922734,MATH 109,B01,083215,Ganzberger; Geoffrey Michael,1,0,32,31
1657875922734,MATH 109,B02,083216,Ganzberger; Geoffrey Michael,2,0,32,30
1657875922734,MATH 109,B03,093479,Ganzberger; Geoffrey Michael,8,0,32,24
1657875928764,MATH 142A,A01,083219,Chow; Bennett,7,0,32,25
1657875928764,MATH 142A,A02,083220,Chow; Bennett,10,0,32,22
1657875928764,MATH 142A,A03,093480,Chow; Bennett,9,0,32,23
1657875928764,MATH 142A,B03,093481,Chow; Bennett,8,0,32,24
1657875928764,MATH 142A,B04,093558,Chow; Bennett,13,0,32,19
1657875928764,MATH 142A,B05,093559,Chow; Bennett,7,0,32,25
1657875934790,MATH 193A,A01,083224,Rotar; Vladimir,8,0,34,26
1657875934790,MATH 193A,A02,083225,Rotar; Vladimir,10,0,34,24
1657875934790,MATH 193A,A03,083781,Rotar; Vladimir,5,0,34,29
1657875934790,MATH 193A,A04,083782,Rotar; Vladimir,11,0,34,23
1657875934790,MATH 193A,A05,093482,Rotar; Vladimir,10,0,34,24
1657875940813,MATH 197,001,091859,McAuley; Julian John,9999,0,9999,0
1657875940813,MATH 197,002,095566,Kedlaya; Kiran S.,9997,0,9999,2
1657875940813,MATH 197,003,095567,Xiao; Ming,9999,0,9999,0
1657875940813,MATH 197,004,095571,Perols; Johan Lars,9998,0,9999,1
1657875947872,COGS 9,A01,083615,Shannon; Kyle Michael,10,0,75,65
1657875953898,COGS 11,A01,083617,Boyle; Mary E. T.,23,0,48,25
1657875959926,COGS 13,A01,083071,Bastos; Amalia Pinkusfeld,11,0,71,60
1657875965955,COGS 14A,A01,092681,Semenuks; Arturs,5,1,100,95
1657875971977,COGS 14B,A01,083073,Cheng; Tzu-Han,6,0,63,57
1657875978004,COGS 17,A01,092677,Semenuks; Arturs,6,0,81,75
1657875984031,COGS 100,A01,083619,Allen; Michael Gordon,17,0,70,53
1657875990058,COGS 101A,A01,083621,Davis; Joshua Daniel,9,0,68,59
1657875996082,COGS 101B,A01,091572,Allen; Michael Gordon,13,0,65,52
1657876002110,COGS 101C,A01,083625,Delgado; Tania,17,0,35,18
1657876008147,COGS 107A,A01,083627,Boyle; Mary E. T.,14,0,60,46
1657876014170,COGS 118A,A01,083075,Gupta; Anjum,21,0,76,55
1657876020196,CSE 3,A50,083646,Miranda; Gregory Joseph,24,0,50,26
1657876026225,CSE 8A,A50,083650,Miranda; Gregory Joseph,17,1,56,39
1657876032248,CSE 11,A01,083080,Cao; Yingjun,6,15,40,34
1657876038277,CSE 12,A01,083652,Krause-Levy; Sophia Louisa,30,1,120,90
1657876044301,CSE 15L,A01,083654,Morris; Justin Loren,9,0,50,41
1657876044301,CSE 15L,A02,083655,Morris; Justin Loren,10,0,50,40
1657876050325,CSE 20,A01,083657,Tran; Khoa Dang,39,0,80,41
1657876056349,CSE 21,A01,095574,Bach; Quang Tran,22,0,48,26
1657876062374,CSE 30,A01,083084,Eldon; John,6,0,80,74
1657876062374,CSE 30,B01,095061,Bhaskar; Nishant,9,0,50,41
1657876068397,CSE 100,A01,083659,Cao; Yingjun,5,4,70,65
1657876074422,CSE 134B,A01,083661,Powell; Thomas Allan,24,0,100,76
1657876080446,CSE 140,A01,083663,Gungor; Onat,15,0,85,70
1657876086468,CSE 140L,A01,083088,Eldon; John,23,0,100,77
1657876092496,CSE 175,A01,083665,Kumar; Rakesh,3,0,25,22
1657876098522,CSE 190,A00,092507,Dubnov; Shlomo,8,0,20,12
1657876104546,ECE 45,A01,083139,Congero; Spencer William,6,0,75,69
1657876110575,ECE 65,A50,083695,Saad; Andrew S,12,0,30,18
1657876110575,ECE 65,A51,095125,Saad; Andrew S,24,0,26,2
1657876116603,ECE 109,A01,091882,Touri; Behrouz,20,0,70,50
1657876122630,ECE 180,A00,083140,Abi Samra; Nicholas Camill,1,0,30,29
1657876122630,ECE 180,B00,083141,Abi Samra; Nicholas Camill,0,0,30,30
1657876128662,MATH 10A,A01,083735,Patchell; Gregory David,2,0,30,28
1657876128662,MATH 10A,A02,083736,Patchell; Gregory David,20,0,30,10
1657876128662,MATH 10A,A03,083737,Patchell; Gregory David,16,0,30,14
1657876134777,MATH 10B,A01,083207,Lim; Seonhee,8,0,34,26
1657876134777,MATH 10B,A02,083208,Lim; Seonhee,10,0,35,25
1657876134777,MATH 10B,A03,093472,Lim; Seonhee,7,0,34,27
1657876134777,MATH 10B,B01,083739,Sinha; Shubham,14,0,30,16
1657876140813,MATH 18,A01,083743,Cinel; Cameron Alexander,9,0,30,21
1657876140813,MATH 18,A02,083744,Cinel; Cameron Alexander,18,0,30,12
1657876140813,MATH 18,A03,083745,Cinel; Cameron Alexander,10,0,30,20
1657876140813,MATH 18,B01,083748,Rideout; David Porter,5,0,37,32
1657876140813,MATH 18,B02,083749,Rideout; David Porter,5,0,36,31
1657876140813,MATH 18,B03,083750,Rideout; David Porter,3,0,37,34
1657876140813,MATH 18,B04,083751,Rideout; David Porter,6,0,36,30
1657876140813,MATH 18,B05,093473,Rideout; David Porter,6,0,36,30
1657876140813,MATH 18,B06,093474,Rideout; David Porter,6,0,36,30
1657876146841,MATH 20A,A01,083754,Zheng; Zequn,14,0,40,26
1657876152873,MATH 20B,A01,083756,Briones; Jor-el Thomas Caparas,4,0,36,32
1657876152873,MATH 20B,A02,083757,Briones; Jor-el Thomas Caparas,1,0,36,35
1657876152873,MATH 20B,A03,093475,Briones; Jor-el Thomas Caparas,2,0,36,34
1657876158898,MATH 20C,A01,083760,Briones; Jor-el Thomas Caparas,1,0,35,34
1657876158898,MATH 20C,A02,083761,Briones; Jor-el Thomas Caparas,8,0,35,27
1657876158898,MATH 20C,A03,093476,Briones; Jor-el Thomas Caparas,0,1,36,36
1657876158898,MATH 20C,B01,083762,Bach; Quang Tran,1,0,30,29
1657876164924,MATH 20D,A01,083765,Tran; Brian Kha,5,0,30,25
1657876164924,MATH 20D,A02,083766,Tran; Brian Kha,5,0,30,25
1657876164924,MATH 20D,A03,083767,Tran; Brian Kha,5,0,30,25
1657876170958,MATH 20E,A01,083771,Ganguly; Soumya,10,0,32,22
1657876170958,MATH 20E,A02,083772,Ganguly; Soumya,6,0,32,26
1657876170958,MATH 20E,B01,083773,Ciotti; Benjamin,20,0,35,15
1657876170958,MATH 20E,B02,083774,Ciotti; Benjamin,18,0,35,17
1657876176991,MATH 103A,A01,083777,Greenfeld; Be'Eri,3,0,36,33
1657876176991,MATH 103A,A02,083778,Greenfeld; Be'Eri,5,0,36,31
1657876176991,MATH 103A,A03,093561,Greenfeld; Be'Eri,6,0,36,30
1657876176991,MATH 103A,B01,083779,Greenfeld; Be'Eri,7,0,36,29
1657876176991,MATH 103A,B02,083780,Greenfeld; Be'Eri,4,0,36,32
1657876176991,MATH 103A,B03,093562,Greenfeld; Be'Eri,3,0,36,33
1657876183019,MATH 105,A01,085443,Carter; Anne Toulson,15,0,35,20
1657876183019,MATH 105,A02,093477,Carter; Anne Toulson,20,0,35,15
1657876189042,MATH 109,A01,083213,Ganzberger; Geoffrey Michael,3,0,34,31
1657876189042,MATH 109,A02,083214,Ganzberger; Geoffrey Michael,4,0,34,30
1657876189042,MATH 109,A03,093478,Ganzberger; Geoffrey Michael,2,0,34,32
1657876189042,MATH 109,B01,083215,Ganzberger; Geoffrey Michael,1,0,32,31
1657876189042,MATH 109,B02,083216,Ganzberger; Geoffrey Michael,2,0,32,30
1657876189042,MATH 109,B03,093479,Ganzberger; Geoffrey Michael,8,0,32,24
1657876195073,MATH 142A,A01,083219,Chow; Bennett,7,0,32,25
1657876195073,MATH 142A,A02,083220,Chow; Bennett,10,0,32,22
1657876195073,MATH 142A,A03,093480,Chow; Bennett,9,0,32,23
1657876195073,MATH 142A,B03,093481,Chow; Bennett,8,0,32,24
1657876195073,MATH 142A,B04,093558,Chow; Bennett,13,0,32,19
1657876195073,MATH 142A,B05,093559,Chow; Bennett,7,0,32,25
1657876201098,MATH 193A,A01,083224,Rotar; Vladimir,8,0,34,26
1657876201098,MATH 193A,A02,083225,Rotar; Vladimir,10,0,34,24
1657876201098,MATH 193A,A03,083781,Rotar; Vladimir,5,0,34,29
1657876201098,MATH 193A,A04,083782,Rotar; Vladimir,11,0,34,23
1657876201098,MATH 193A,A05,093482,Rotar; Vladimir,10,0,34,24
1657876207121,MATH 197,001,091859,McAuley; Julian John,9999,0,9999,0
1657876207121,MATH 197,002,095566,Kedlaya; Kiran S.,9997,0,9999,2
1657876207121,MATH 197,003,095567,Xiao; Ming,9999,0,9999,0
1657876207121,MATH 197,004,095571,Perols; Johan Lars,9998,0,9999,1
1657876214185,COGS 9,A01,083615,Shannon; Kyle Michael,10,0,75,65
1657876220212,COGS 11,A01,083617,Boyle; Mary E. T.,23,0,48,25
1657876226237,COGS 13,A01,083071,Bastos; Amalia Pinkusfeld,11,0,71,60
1657876232260,COGS 14A,A01,092681,Semenuks; Arturs,5,1,100,95
1657876238289,COGS 14B,A01,083073,Cheng; Tzu-Han,6,0,63,57
1657876244316,COGS 17,A01,092677,Semenuks; Arturs,6,0,81,75
1657876250345,COGS 100,A01,083619,Allen; Michael Gordon,17,0,70,53
1657876256372,COGS 101A,A01,083621,Davis; Joshua Daniel,9,0,68,59
1657876262403,COGS 101B,A01,091572,Allen; Michael Gordon,13,0,65,52
1657876268436,COGS 101C,A01,083625,Delgado; Tania,17,0,35,18
1657876274463,COGS 107A,A01,083627,Boyle; Mary E. T.,14,0,60,46
1657876280493,COGS 118A,A01,083075,Gupta; Anjum,21,0,76,55
1657876286522,CSE 3,A50,083646,Miranda; Gregory Joseph,24,0,50,26
1657876292561,CSE 8A,A50,083650,Miranda; Gregory Joseph,17,1,56,39
1657876298584,CSE 11,A01,083080,Cao; Yingjun,6,15,40,34
1657876304621,CSE 12,A01,083652,Krause-Levy; Sophia Louisa,30,1,120,90
1657876310646,CSE 15L,A01,083654,Morris; Justin Loren,9,0,50,41
1657876310646,CSE 15L,A02,083655,Morris; Justin Loren,10,0,50,40
1657876316670,CSE 20,A01,083657,Tran; Khoa Dang,39,0,80,41
1657876322695,CSE 21,A01,095574,Bach; Quang Tran,22,0,48,26
1657876328721,CSE 30,A01,083084,Eldon; John,6,0,80,74
1657876328721,CSE 30,B01,095061,Bhaskar; Nishant,9,0,50,41
1657876334750,CSE 100,A01,083659,Cao; Yingjun,5,4,70,65
1657876340779,CSE 134B,A01,083661,Powell; Thomas Allan,24,0,100,76
1657876346804,CSE 140,A01,083663,Gungor; Onat,15,0,85,70
1657876352835,CSE 140L,A01,083088,Eldon; John,23,0,100,77
1657876358860,CSE 175,A01,083665,Kumar; Rakesh,3,0,25,22
1657876364884,CSE 190,A00,092507,Dubnov; Shlomo,8,0,20,12
1657876370909,ECE 45,A01,083139,Congero; Spencer William,6,0,75,69
1657876376932,ECE 65,A50,083695,Saad; Andrew S,12,0,30,18
1657876376932,ECE 65,A51,095125,Saad; Andrew S,24,0,26,2
1657876382957,ECE 109,A01,091882,Touri; Behrouz,20,0,70,50
1657876388987,ECE 180,A00,083140,Abi Samra; Nicholas Camill,1,0,30,29
1657876388987,ECE 180,B00,083141,Abi Samra; Nicholas Camill,0,0,30,30
1657876395015,MATH 10A,A01,083735,Patchell; Gregory David,2,0,30,28
1657876395015,MATH 10A,A02,083736,Patchell; Gregory David,20,0,30,10
1657876395015,MATH 10A,A03,083737,Patchell; Gregory David,16,0,30,14
1657876401043,MATH 10B,A01,083207,Lim; Seonhee,8,0,34,26
1657876401043,MATH 10B,A02,083208,Lim; Seonhee,10,0,35,25
1657876401043,MATH 10B,A03,093472,Lim; Seonhee,7,0,34,27
1657876401043,MATH 10B,B01,083739,Sinha; Shubham,14,0,30,16
1657876407084,MATH 18,A01,083743,Cinel; Cameron Alexander,9,0,30,21
1657876407084,MATH 18,A02,083744,Cinel; Cameron Alexander,18,0,30,12
1657876407084,MATH 18,A03,083745,Cinel; Cameron Alexander,10,0,30,20
1657876407084,MATH 18,B01,083748,Rideout; David Porter,5,0,37,32
1657876407084,MATH 18,B02,083749,Rideout; David Porter,5,0,36,31
1657876407084,MATH 18,B03,083750,Rideout; David Porter,3,0,37,34
1657876407084,MATH 18,B04,083751,Rideout; David Porter,6,0,36,30
1657876407084,MATH 18,B05,093473,Rideout; David Porter,6,0,36,30
1657876407084,MATH 18,B06,093474,Rideout; David Porter,6,0,36,30
1657876413114,MATH 20A,A01,083754,Zheng; Zequn,14,0,40,26
1657876419140,MATH 20B,A01,083756,Briones; Jor-el Thomas Caparas,4,0,36,32
1657876419140,MATH 20B,A02,083757,Briones; Jor-el Thomas Caparas,1,0,36,35
1657876419140,MATH 20B,A03,093475,Briones; Jor-el Thomas Caparas,2,0,36,34
1657876425172,MATH 20C,A01,083760,Briones; Jor-el Thomas Caparas,1,0,35,34
1657876425172,MATH 20C,A02,083761,Briones; Jor-el Thomas Caparas,8,0,35,27
1657876425172,MATH 20C,A03,093476,Briones; Jor-el Thomas Caparas,0,1,36,36
1657876425172,MATH 20C,B01,083762,Bach; Quang Tran,1,0,30,29
1657876431196,MATH 20D,A01,083765,Tran; Brian Kha,5,0,30,25
1657876431196,MATH 20D,A02,083766,Tran; Brian Kha,5,0,30,25
1657876431196,MATH 20D,A03,083767,Tran; Brian Kha,5,0,30,25
1657876437223,MATH 20E,A01,083771,Ganguly; Soumya,10,0,32,22
1657876437223,MATH 20E,A02,083772,Ganguly; Soumya,6,0,32,26
1657876437223,MATH 20E,B01,083773,Ciotti; Benjamin,20,0,35,15
1657876437223,MATH 20E,B02,083774,Ciotti; Benjamin,18,0,35,17
1657876443252,MATH 103A,A01,083777,Greenfeld; Be'Eri,3,0,36,33
1657876443252,MATH 103A,A02,083778,Greenfeld; Be'Eri,5,0,36,31
1657876443252,MATH 103A,A03,093561,Greenfeld; Be'Eri,6,0,36,30
1657876443252,MATH 103A,B01,083779,Greenfeld; Be'Eri,7,0,36,29
1657876443252,MATH 103A,B02,083780,Greenfeld; Be'Eri,4,0,36,32
1657876443252,MATH 103A,B03,093562,Greenfeld; Be'Eri,3,0,36,33
1657876449284,MATH 105,A01,085443,Carter; Anne Toulson,15,0,35,20
1657876449284,MATH 105,A02,093477,Carter; Anne Toulson,20,0,35,15
1657876455331,MATH 109,A01,083213,Ganzberger; Geoffrey Michael,3,0,34,31
1657876455331,MATH 109,A02,083214,Ganzberger; Geoffrey Michael,4,0,34,30
1657876455331,MATH 109,A03,093478,Ganzberger; Geoffrey Michael,2,0,34,32
1657876455331,MATH 109,B01,083215,Ganzberger; Geoffrey Michael,1,0,32,31
1657876455331,MATH 109,B02,083216,Ganzberger; Geoffrey Michael,2,0,32,30
1657876455331,MATH 109,B03,093479,Ganzberger; Geoffrey Michael,8,0,32,24
1657876461367,MATH 142A,A01,083219,Chow; Bennett,7,0,32,25
1657876461367,MATH 142A,A02,083220,Chow; Bennett,10,0,32,22
1657876461367,MATH 142A,A03,093480,Chow; Bennett,9,0,32,23
1657876461367,MATH 142A,B03,093481,Chow; Bennett,8,0,32,24
1657876461367,MATH 142A,B04,093558,Chow; Bennett,13,0,32,19
1657876461367,MATH 142A,B05,093559,Chow; Bennett,7,0,32,25
1657876467403,MATH 193A,A01,083224,Rotar; Vladimir,8,0,34,26
1657876467403,MATH 193A,A02,083225,Rotar; Vladimir,10,0,34,24
1657876467403,MATH 193A,A03,083781,Rotar; Vladimir,5,0,34,29
1657876467403,MATH 193A,A04,083782,Rotar; Vladimir,11,0,34,23
1657876467403,MATH 193A,A05,093482,Rotar; Vladimir,10,0,34,24
1657876473432,MATH 197,001,091859,McAuley; Julian John,9999,0,9999,0
1657876473432,MATH 197,002,095566,Kedlaya; Kiran S.,9997,0,9999,2
1657876473432,MATH 197,003,095567,Xiao; Ming,9999,0,9999,0
1657876473432,MATH 197,004,095571,Perols; Johan Lars,9998,0,9999,1
1657876480505,COGS 9,A01,083615,Shannon; Kyle Michael,10,0,75,65
1657876486530,COGS 11,A01,083617,Boyle; Mary E. T.,23,0,48,25
1657876492554,COGS 13,A01,083071,Bastos; Amalia Pinkusfeld,11,0,71,60
1657876498586,COGS 14A,A01,092681,Semenuks; Arturs,5,1,100,95
1657876504610,COGS 14B,A01,083073,Cheng; Tzu-Han,6,0,63,57
1657876510639,COGS 17,A01,092677,Semenuks; Arturs,6,0,81,75
1657876516669,COGS 100,A01,083619,Allen; Michael Gordon,17,0,70,53
1657876522698,COGS 101A,A01,083621,Davis; Joshua Daniel,9,0,68,59
1657876528726,COGS 101B,A01,091572,Allen; Michael Gordon,13,0,65,52
1657876534750,COGS 101C,A01,083625,Delgado; Tania,17,0,35,18
1657876540776,COGS 107A,A01,083627,Boyle; Mary E. T.,14,0,60,46
1657876546802,COGS 118A,A01,083075,Gupta; Anjum,21,0,76,55
1657876552840,CSE 3,A50,083646,Miranda; Gregory Joseph,24,0,50,26
1657876558871,CSE 8A,A50,083650,Miranda; Gregory Joseph,17,1,56,39
1657876564902,CSE 11,A01,083080,Cao; Yingjun,6,15,40,34
1657876570928,CSE 12,A01,083652,Krause-Levy; Sophia Louisa,30,1,120,90
1657876576952,CSE 15L,A01,083654,Morris; Justin Loren,9,0,50,41
1657876576952,CSE 15L,A02,083655,Morris; Justin Loren,10,0,50,40
1657876582981,CSE 20,A01,083657,Tran; Khoa Dang,39,0,80,41
1657876589010,CSE 21,A01,095574,Bach; Quang Tran,22,0,48,26
1657876595036,CSE 30,A01,083084,Eldon; John,6,0,80,74
1657876595036,CSE 30,B01,095061,Bhaskar; Nishant,9,0,50,41
1657876601062,CSE 100,A01,083659,Cao; Yingjun,5,4,70,65
1657876607108,CSE 134B,A01,083661,Powell; Thomas Allan,24,0,100,76
1657876613135,CSE 140,A01,083663,Gungor; Onat,15,0,85,70
1657876619158,CSE 140L,A01,083088,Eldon; John,23,0,100,77
1657876625182,CSE 175,A01,083665,Kumar; Rakesh,3,0,25,22
1657876631207,CSE 190,A00,092507,Dubnov; Shlomo,8,0,20,12
1657876637241,ECE 45,A01,083139,Congero; Spencer William,6,0,75,69
1657876643286,ECE 65,A50,083695,Saad; Andrew S,12,0,30,18
1657876643286,ECE 65,A51,095125,Saad; Andrew S,24,0,26,2
1657876649313,ECE 109,A01,091882,Touri; Behrouz,20,0,70,50
1657876655340,ECE 180,A00,083140,Abi Samra; Nicholas Camill,1,0,30,29
1657876655340,ECE 180,B00,083141,Abi Samra; Nicholas Camill,0,0,30,30
1657876661376,MATH 10A,A01,083735,Patchell; Gregory David,2,0,30,28
1657876661376,MATH 10A,A02,083736,Patchell; Gregory David,20,0,30,10
1657876661376,MATH 10A,A03,083737,Patchell; Gregory David,16,0,30,14
1657876667414,MATH 10B,A01,083207,Lim; Seonhee,8,0,34,26
1657876667414,MATH 10B,A02,083208,Lim; Seonhee,10,0,35,25
1657876667414,MATH 10B,A03,093472,Lim; Seonhee,7,0,34,27
1657876667414,MATH 10B,B01,083739,Sinha; Shubham,14,0,30,16
1657876673457,MATH 18,A01,083743,Cinel; Cameron Alexander,9,0,30,21
1657876673457,MATH 18,A02,083744,Cinel; Cameron Alexander,18,0,30,12
1657876673457,MATH 18,A03,083745,Cinel; Cameron Alexander,10,0,30,20
1657876673457,MATH 18,B01,083748,Rideout; David Porter,5,0,37,32
1657876673457,MATH 18,B02,083749,Rideout; David Porter,5,0,36,31
1657876673457,MATH 18,B03,083750,Rideout; David Porter,3,0,37,34
1657876673457,MATH 18,B04,083751,Rideout; David Porter,6,0,36,30
1657876673457,MATH 18,B05,093473,Rideout; David Porter,6,0,36,30
1657876673457,MATH 18,B06,093474,Rideout; David Porter,6,0,36,30
1657876679490,MATH 20A,A01,083754,Zheng; Zequn,14,0,40,26
1657876685523,MATH 20B,A01,083756,Briones; Jor-el Thomas Caparas,4,0,36,32
1657876685523,MATH 20B,A02,083757,Briones; Jor-el Thomas Caparas,1,0,36,35
1657876685523,MATH 20B,A03,093475,Briones; Jor-el Thomas Caparas,2,0,36,34
1657876691556,MATH 20C,A01,083760,Briones; Jor-el Thomas Caparas,1,0,35,34
1657876691556,MATH 20C,A02,083761,Briones; Jor-el Thomas Caparas,8,0,35,27
1657876691556,MATH 20C,A03,093476,Briones; Jor-el Thomas Caparas,0,1,36,36
1657876691556,MATH 20C,B01,083762,Bach; Quang Tran,1,0,30,29
1657876697584,MATH 20D,A01,083765,Tran; Brian Kha,5,0,30,25
1657876697584,MATH 20D,A02,083766,Tran; Brian Kha,5,0,30,25
1657876697584,MATH 20D,A03,083767,Tran; Brian Kha,5,0,30,25
1657876703621,MATH 20E,A01,083771,Ganguly; Soumya,10,0,32,22
1657876703621,MATH 20E,A02,083772,Ganguly; Soumya,6,0,32,26
1657876703621,MATH 20E,B01,083773,Ciotti; Benjamin,20,0,35,15
1657876703621,MATH 20E,B02,083774,Ciotti; Benjamin,18,0,35,17
1657876709650,MATH 103A,A01,083777,Greenfeld; Be'Eri,3,0,36,33
1657876709650,MATH 103A,A02,083778,Greenfeld; Be'Eri,5,0,36,31
1657876709650,MATH 103A,A03,093561,Greenfeld; Be'Eri,6,0,36,30
1657876709650,MATH 103A,B01,083779,Greenfeld; Be'Eri,7,0,36,29
1657876709650,MATH 103A,B02,083780,Greenfeld; Be'Eri,4,0,36,32
1657876709650,MATH 103A,B03,093562,Greenfeld; Be'Eri,3,0,36,33
1657876715684,MATH 105,A01,085443,Carter; Anne Toulson,15,0,35,20
1657876715684,MATH 105,A02,093477,Carter; Anne Toulson,20,0,35,15
1657876721721,MATH 109,A01,083213,Ganzberger; Geoffrey Michael,3,0,34,31
1657876721721,MATH 109,A02,083214,Ganzberger; Geoffrey Michael,4,0,34,30
1657876721721,MATH 109,A03,093478,Ganzberger; Geoffrey Michael,2,0,34,32
1657876721721,MATH 109,B01,083215,Ganzberger; Geoffrey Michael,1,0,32,31
1657876721721,MATH 109,B02,083216,Ganzberger; Geoffrey Michael,2,0,32,30
1657876721721,MATH 109,B03,093479,Ganzberger; Geoffrey Michael,8,0,32,24
1657876727761,MATH 142A,A01,083219,Chow; Bennett,7,0,32,25
1657876727761,MATH 142A,A02,083220,Chow; Bennett,10,0,32,22
1657876727761,MATH 142A,A03,093480,Chow; Bennett,9,0,32,23
1657876727761,MATH 142A,B03,093481,Chow; Bennett,8,0,32,24
1657876727761,MATH 142A,B04,093558,Chow; Bennett,13,0,32,19
1657876727761,MATH 142A,B05,093559,Chow; Bennett,7,0,32,25
1657876733871,MATH 193A,A01,083224,Rotar; Vladimir,8,0,34,26
1657876733871,MATH 193A,A02,083225,Rotar; Vladimir,10,0,34,24
1657876733871,MATH 193A,A03,083781,Rotar; Vladimir,5,0,34,29
1657876733871,MATH 193A,A04,083782,Rotar; Vladimir,11,0,34,23
1657876733871,MATH 193A,A05,093482,Rotar; Vladimir,10,0,34,24
1657876739904,MATH 197,001,091859,McAuley; Julian John,9999,0,9999,0
1657876739904,MATH 197,002,095566,Kedlaya; Kiran S.,9997,0,9999,2
1657876739904,MATH 197,003,095567,Xiao; Ming,9999,0,9999,0
1657876739904,MATH 197,004,095571,Perols; Johan Lars,9998,0,9999,1
1657876746979,COGS 9,A01,083615,Shannon; Kyle Michael,10,0,75,65
1657876753007,COGS 11,A01,083617,Boyle; Mary E. T.,23,0,48,25
1657876759039,COGS 13,A01,083071,Bastos; Amalia Pinkusfeld,11,0,71,60
1657876765071,COGS 14A,A01,092681,Semenuks; Arturs,5,1,100,95
1657876771095,COGS 14B,A01,083073,Cheng; Tzu-Han,6,0,63,57
1657876777123,COGS 17,A01,092677,Semenuks; Arturs,6,0,81,75
1657876783154,COGS 100,A01,083619,Allen; Michael Gordon,17,0,70,53
1657876789183,COGS 101A,A01,083621,Davis; Joshua Daniel,9,0,68,59
1657876795212,COGS 101B,A01,091572,Allen; Michael Gordon,13,0,65,52
1657876801240,COGS 101C,A01,083625,Delgado; Tania,17,0,35,18
1657876807270,COGS 107A,A01,083627,Boyle; Mary E. T.,14,0,60,46
1657876813299,COGS 118A,A01,083075,Gupta; Anjum,21,0,76,55
1657876819335,CSE 3,A50,083646,Miranda; Gregory Joseph,24,0,50,26
1657876825367,CSE 8A,A50,083650,Miranda; Gregory Joseph,17,1,56,39
1657876831391,CSE 11,A01,083080,Cao; Yingjun,6,15,40,34
1657876837426,CSE 12,A01,083652,Krause-Levy; Sophia Louisa,30,1,120,90
1657876843456,CSE 15L,A01,083654,Morris; Justin Loren,9,0,50,41
1657876843456,CSE 15L,A02,083655,Morris; Justin Loren,10,0,50,40
1657876849481,CSE 20,A01,083657,Tran; Khoa Dang,39,0,80,41
1657876855525,CSE 21,A01,095574,Bach; Quang Tran,22,0,48,26
1657876861572,CSE 30,A01,083084,Eldon; John,6,0,80,74
1657876861572,CSE 30,B01,095061,Bhaskar; Nishant,9,0,50,41
1657876867596,CSE 100,A01,083659,Cao; Yingjun,5,4,70,65
1657876873628,CSE 134B,A01,083661,Powell; Thomas Allan,24,0,100,76
1657876879652,CSE 140,A01,083663,Gungor; Onat,15,0,85,70
1657876885680,CSE 140L,A01,083088,Eldon; John,23,0,100,77
1657876891710,CSE 175,A01,083665,Kumar; Rakesh,3,0,25,22
1657876897734,CSE 190,A00,092507,Dubnov; Shlomo,8,0,20,12
1657876903770,ECE 45,A01,083139,Congero; Spencer William,6,0,75,69
1657876909796,ECE 65,A50,083695,Saad; Andrew S,12,0,30,18
1657876909796,ECE 65,A51,095125,Saad; Andrew S,24,0,26,2
1657876915839,ECE 109,A01,091882,Touri; Behrouz,20,0,70,50
1657876921866,ECE 180,A00,083140,Abi Samra; Nicholas Camill,1,0,30,29
1657876921866,ECE 180,B00,083141,Abi Samra; Nicholas Camill,0,0,30,30
1657876927907,MATH 10A,A01,083735,Patchell; Gregory David,2,0,30,28
1657876927907,MATH 10A,A02,083736,Patchell; Gregory David,20,0,30,10
1657876927907,MATH 10A,A03,083737,Patchell; Gregory David,16,0,30,14
1657876933940,MATH 10B,A01,083207,Lim; Seonhee,8,0,34,26
1657876933940,MATH 10B,A02,083208,Lim; Seonhee,10,0,35,25
1657876933940,MATH 10B,A03,093472,Lim; Seonhee,7,0,34,27
1657876933940,MATH 10B,B01,083739,Sinha; Shubham,14,0,30,16
1657876939982,MATH 18,A01,083743,Cinel; Cameron Alexander,9,0,30,21
1657876939982,MATH 18,A02,083744,Cinel; Cameron Alexander,18,0,30,12
1657876939982,MATH 18,A03,083745,Cinel; Cameron Alexander,10,0,30,20
1657876939982,MATH 18,B01,083748,Rideout; David Porter,5,0,37,32
1657876939982,MATH 18,B02,083749,Rideout; David Porter,5,0,36,31
1657876939982,MATH 18,B03,083750,Rideout; David Porter,3,0,37,34
1657876939982,MATH 18,B04,083751,Rideout; David Porter,6,0,36,30
1657876939982,MATH 18,B05,093473,Rideout; David Porter,6,0,36,30
1657876939982,MATH 18,B06,093474,Rideout; David Porter,6,0,36,30
1657876946014,MATH 20A,A01,083754,Zheng; Zequn,14,0,40,26
1657876952040,MATH 20B,A01,083756,Briones; Jor-el Thomas Caparas,4,0,36,32
1657876952040,MATH 20B,A02,083757,Briones; Jor-el Thomas Caparas,1,0,36,35
1657876952040,MATH 20B,A03,093475,Briones; Jor-el Thomas Caparas,2,0,36,34
1657876958072,MATH 20C,A01,083760,Briones; Jor-el Thomas Caparas,1,0,35,34
1657876958072,MATH 20C,A02,083761,Briones; Jor-el Thomas Caparas,8,0,35,27
1657876958072,MATH 20C,A03,093476,Briones; Jor-el Thomas Caparas,0,1,36,36
1657876958072,MATH 20C,B01,083762,Bach; Quang Tran,1,0,30,29
1657876964100,MATH 20D,A01,083765,Tran; Brian Kha,5,0,30,25
1657876964100,MATH 20D,A02,083766,Tran; Brian Kha,5,0,30,25
1657876964100,MATH 20D,A03,083767,Tran; Brian Kha,5,0,30,25
1657876970127,MATH 20E,A01,083771,Ganguly; Soumya,10,0,32,22
1657876970127,MATH 20E,A02,083772,Ganguly; Soumya,6,0,32,26
1657876970127,MATH 20E,B01,083773,Ciotti; Benjamin,20,0,35,15
1657876970127,MATH 20E,B02,083774,Ciotti; Benjamin,18,0,35,17
1657876976157,MATH 103A,A01,083777,Greenfeld; Be'Eri,3,0,36,33
1657876976157,MATH 103A,A02,083778,Greenfeld; Be'Eri,5,0,36,31
1657876976157,MATH 103A,A03,093561,Greenfeld; Be'Eri,6,0,36,30
1657876976157,MATH 103A,B01,083779,Greenfeld; Be'Eri,7,0,36,29
1657876976157,MATH 103A,B02,083780,Greenfeld; Be'Eri,4,0,36,32
1657876976157,MATH 103A,B03,093562,Greenfeld; Be'Eri,3,0,36,33
1657876982195,MATH 105,A01,085443,Carter; Anne Toulson,15,0,35,20
1657876982195,MATH 105,A02,093477,Carter; Anne Toulson,20,0,35,15
1657876988228,MATH 109,A01,083213,Ganzberger; Geoffrey Michael,3,0,34,31
1657876988228,MATH 109,A02,083214,Ganzberger; Geoffrey Michael,4,0,34,30
1657876988228,MATH 109,A03,093478,Ganzberger; Geoffrey Michael,2,0,34,32
1657876988228,MATH 109,B01,083215,Ganzberger; Geoffrey Michael,1,0,32,31
1657876988228,MATH 109,B02,083216,Ganzberger; Geoffrey Michael,2,0,32,30
1657876988228,MATH 109,B03,093479,Ganzberger; Geoffrey Michael,8,0,32,24
1657876994261,MATH 142A,A01,083219,Chow; Bennett,7,0,32,25
1657876994261,MATH 142A,A02,083220,Chow; Bennett,10,0,32,22
1657876994261,MATH 142A,A03,093480,Chow; Bennett,9,0,32,23
1657876994261,MATH 142A,B03,093481,Chow; Bennett,8,0,32,24
1657876994261,MATH 142A,B04,093558,Chow; Bennett,13,0,32,19
1657876994261,MATH 142A,B05,093559,Chow; Bennett,7,0,32,25
1657877000294,MATH 193A,A01,083224,Rotar; Vladimir,8,0,34,26
1657877000294,MATH 193A,A02,083225,Rotar; Vladimir,10,0,34,24
1657877000294,MATH 193A,A03,083781,Rotar; Vladimir,5,0,34,29
1657877000294,MATH 193A,A04,083782,Rotar; Vladimir,11,0,34,23
1657877000294,MATH 193A,A05,093482,Rotar; Vladimir,10,0,34,24
1657877006325,MATH 197,001,091859,McAuley; Julian John,9999,0,9999,0
1657877006325,MATH 197,002,095566,Kedlaya; Kiran S.,9997,0,9999,2
1657877006325,MATH 197,003,095567,Xiao; Ming,9999,0,9999,0
1657877006325,MATH 197,004,095571,Perols; Johan Lars,9998,0,9999,1
1657877013421,COGS 9,A01,083615,Shannon; Kyle Michael,10,0,75,65
1657877019453,COGS 11,A01,083617,Boyle; Mary E. T.,23,0,48,25
1657877025491,COGS 13,A01,083071,Bastos; Amalia Pinkusfeld,11,0,71,60
1657877031538,COGS 14A,A01,092681,Semenuks; Arturs,5,1,100,95
1657877037580,COGS 14B,A01,083073,Cheng; Tzu-Han,6,0,63,57
1657877043609,COGS 17,A01,092677,Semenuks; Arturs,6,0,81,75
1657877049637,COGS 100,A01,083619,Allen; Michael Gordon,17,0,70,53
1657877055663,COGS 101A,A01,083621,Davis; Joshua Daniel,9,0,68,59
1657877061692,COGS 101B,A01,091572,Allen; Michael Gordon,13,0,65,52
1657877067722,COGS 101C,A01,083625,Delgado; Tania,17,0,35,18
1657877073748,COGS 107A,A01,083627,Boyle; Mary E. T.,14,0,60,46
1657877079775,COGS 118A,A01,083075,Gupta; Anjum,21,0,76,55
1657877085801,CSE 3,A50,083646,Miranda; Gregory Joseph,24,0,50,26
1657877091829,CSE 8A,A50,083650,Miranda; Gregory Joseph,17,1,56,39
1657877097854,CSE 11,A01,083080,Cao; Yingjun,6,15,40,34
1657877103885,CSE 12,A01,083652,Krause-Levy; Sophia Louisa,30,1,120,90
1657877109915,CSE 15L,A01,083654,Morris; Justin Loren,9,0,50,41
1657877109915,CSE 15L,A02,083655,Morris; Justin Loren,10,0,50,40
1657877115940,CSE 20,A01,083657,Tran; Khoa Dang,39,0,80,41
1657877121968,CSE 21,A01,095574,Bach; Quang Tran,22,0,48,26
1657877127994,CSE 30,A01,083084,Eldon; John,6,0,80,74
1657877127994,CSE 30,B01,095061,Bhaskar; Nishant,9,0,50,41
1657877134026,CSE 100,A01,083659,Cao; Yingjun,5,4,70,65
1657877140056,CSE 134B,A01,083661,Powell; Thomas Allan,24,0,100,76
1657877146081,CSE 140,A01,083663,Gungor; Onat,15,0,85,70
1657877152104,CSE 140L,A01,083088,Eldon; John,23,0,100,77
1657877158138,CSE 175,A01,083665,Kumar; Rakesh,3,0,25,22
1657877164163,CSE 190,A00,092507,Dubnov; Shlomo,8,0,20,12
1657877170195,ECE 45,A01,083139,Congero; Spencer William,6,0,75,69
1657877176224,ECE 65,A50,083695,Saad; Andrew S,12,0,30,18
1657877176224,ECE 65,A51,095125,Saad; Andrew S,24,0,26,2
1657877182265,ECE 109,A01,091882,Touri; Behrouz,20,0,70,50
1657877188290,ECE 180,A00,083140,Abi Samra; Nicholas Camill,1,0,30,29
1657877188290,ECE 180,B00,083141,Abi Samra; Nicholas Camill,0,0,30,30
1657877194323,MATH 10A,A01,083735,Patchell; Gregory David,2,0,30,28
1657877194323,MATH 10A,A02,083736,Patchell; Gregory David,20,0,30,10
1657877194323,MATH 10A,A03,083737,Patchell; Gregory David,16,0,30,14
1657877200349,MATH 10B,A01,083207,Lim; Seonhee,8,0,34,26
1657877200349,MATH 10B,A02,083208,Lim; Seonhee,10,0,35,25
1657877200349,MATH 10B,A03,093472,Lim; Seonhee,7,0,34,27
1657877200349,MATH 10B,B01,083739,Sinha; Shubham,14,0,30,16
1657877206388,MATH 18,A01,083743,Cinel; Cameron Alexander,9,0,30,21
1657877206388,MATH 18,A02,083744,Cinel; Cameron Alexander,18,0,30,12
1657877206388,MATH 18,A03,083745,Cinel; Cameron Alexander,10,0,30,20
1657877206388,MATH 18,B01,083748,Rideout; David Porter,5,0,37,32
1657877206388,MATH 18,B02,083749,Rideout; David Porter,5,0,36,31
1657877206388,MATH 18,B03,083750,Rideout; David Porter,3,0,37,34
1657877206388,MATH 18,B04,083751,Rideout; David Porter,6,0,36,30
1657877206388,MATH 18,B05,093473,Rideout; David Porter,6,0,36,30
1657877206388,MATH 18,B06,093474,Rideout; David Porter,6,0,36,30
1657877212411,MATH 20A,A01,083754,Zheng; Zequn,14,0,40,26
1657877218437,MATH 20B,A01,083756,Briones; Jor-el Thomas Caparas,4,0,36,32
1657877218437,MATH 20B,A02,083757,Briones; Jor-el Thomas Caparas,1,0,36,35
1657877218437,MATH 20B,A03,093475,Briones; Jor-el Thomas Caparas,2,0,36,34
1657877224462,MATH 20C,A01,083760,Briones; Jor-el Thomas Caparas,1,0,35,34
1657877224462,MATH 20C,A02,083761,Briones; Jor-el Thomas Caparas,8,0,35,27
1657877224462,MATH 20C,A03,093476,Briones; Jor-el Thomas Caparas,0,1,36,36
1657877224462,MATH 20C,B01,083762,Bach; Quang Tran,1,0,30,29
1657877230493,MATH 20D,A01,083765,Tran; Brian Kha,5,0,30,25
1657877230493,MATH 20D,A02,083766,Tran; Brian Kha,5,0,30,25
1657877230493,MATH 20D,A03,083767,Tran; Brian Kha,5,0,30,25
1657877236524,MATH 20E,A01,083771,Ganguly; Soumya,10,0,32,22
1657877236524,MATH 20E,A02,083772,Ganguly; Soumya,6,0,32,26
1657877236524,MATH 20E,B01,083773,Ciotti; Benjamin,20,0,35,15
1657877236524,MATH 20E,B02,083774,Ciotti; Benjamin,18,0,35,17
1657877242550,MATH 103A,A01,083777,Greenfeld; Be'Eri,3,0,36,33
1657877242550,MATH 103A,A02,083778,Greenfeld; Be'Eri,5,0,36,31
1657877242550,MATH 103A,A03,093561,Greenfeld; Be'Eri,6,0,36,30
1657877242550,MATH 103A,B01,083779,Greenfeld; Be'Eri,7,0,36,29
1657877242550,MATH 103A,B02,083780,Greenfeld; Be'Eri,4,0,36,32
1657877242550,MATH 103A,B03,093562,Greenfeld; Be'Eri,3,0,36,33
1657877248584,MATH 105,A01,085443,Carter; Anne Toulson,15,0,35,20
1657877248584,MATH 105,A02,093477,Carter; Anne Toulson,20,0,35,15
1657877254607,MATH 109,A01,083213,Ganzberger; Geoffrey Michael,3,0,34,31
1657877254607,MATH 109,A02,083214,Ganzberger; Geoffrey Michael,4,0,34,30
1657877254607,MATH 109,A03,093478,Ganzberger; Geoffrey Michael,2,0,34,32
1657877254607,MATH 109,B01,083215,Ganzberger; Geoffrey Michael,1,0,32,31
1657877254607,MATH 109,B02,083216,Ganzberger; Geoffrey Michael,2,0,32,30
1657877254607,MATH 109,B03,093479,Ganzberger; Geoffrey Michael,8,0,32,24
1657877260634,MATH 142A,A01,083219,Chow; Bennett,7,0,32,25
1657877260634,MATH 142A,A02,083220,Chow; Bennett,10,0,32,22
1657877260634,MATH 142A,A03,093480,Chow; Bennett,9,0,32,23
1657877260634,MATH 142A,B03,093481,Chow; Bennett,8,0,32,24
1657877260634,MATH 142A,B04,093558,Chow; Bennett,13,0,32,19
1657877260634,MATH 142A,B05,093559,Chow; Bennett,7,0,32,25
1657877266664,MATH 193A,A01,083224,Rotar; Vladimir,8,0,34,26
1657877266664,MATH 193A,A02,083225,Rotar; Vladimir,10,0,34,24
1657877266664,MATH 193A,A03,083781,Rotar; Vladimir,5,0,34,29
1657877266664,MATH 193A,A04,083782,Rotar; Vladimir,11,0,34,23
1657877266664,MATH 193A,A05,093482,Rotar; Vladimir,10,0,34,24
1657877272696,MATH 197,001,091859,McAuley; Julian John,9999,0,9999,0
1657877272696,MATH 197,002,095566,Kedlaya; Kiran S.,9997,0,9999,2
1657877272696,MATH 197,003,095567,Xiao; Ming,9999,0,9999,0
1657877272696,MATH 197,004,095571,Perols; Johan Lars,9998,0,9999,1
1657877279763,COGS 9,A01,083615,Shannon; Kyle Michael,10,0,75,65
1657877285787,COGS 11,A01,083617,Boyle; Mary E. T.,23,0,48,25
1657877291811,COGS 13,A01,083071,Bastos; Amalia Pinkusfeld,11,0,71,60
1657877297841,COGS 14A,A01,092681,Semenuks; Arturs,5,1,100,95
1657877303868,COGS 14B,A01,083073,Cheng; Tzu-Han,6,0,63,57
1657877309900,COGS 17,A01,092677,Semenuks; Arturs,6,0,81,75
1657877315925,COGS 100,A01,083619,Allen; Michael Gordon,17,0,70,53
1657877321951,COGS 101A,A01,083621,Davis; Joshua Daniel,9,0,68,59
1657877328044,COGS 101B,A01,091572,Allen; Michael Gordon,13,0,65,52
1657877334075,COGS 101C,A01,083625,Delgado; Tania,17,0,35,18
1657877340099,COGS 107A,A01,083627,Boyle; Mary E. T.,14,0,60,46
1657877346126,COGS 118A,A01,083075,Gupta; Anjum,21,0,76,55
1657877352154,CSE 3,A50,083646,Miranda; Gregory Joseph,24,0,50,26
1657877358181,CSE 8A,A50,083650,Miranda; Gregory Joseph,17,1,56,39
1657877364209,CSE 11,A01,083080,Cao; Yingjun,6,15,40,34
1657877370237,CSE 12,A01,083652,Krause-Levy; Sophia Louisa,30,1,120,90
1657877376261,CSE 15L,A01,083654,Morris; Justin Loren,9,0,50,41
1657877376261,CSE 15L,A02,083655,Morris; Justin Loren,10,0,50,40
1657877382287,CSE 20,A01,083657,Tran; Khoa Dang,39,0,80,41
1657877388311,CSE 21,A01,095574,Bach; Quang Tran,22,0,48,26
1657877394337,CSE 30,A01,083084,Eldon; John,6,0,80,74
1657877394337,CSE 30,B01,095061,Bhaskar; Nishant,9,0,50,41
1657877400363,CSE 100,A01,083659,Cao; Yingjun,5,4,70,65
1657877406395,CSE 134B,A01,083661,Powell; Thomas Allan,24,0,100,76
1657877412417,CSE 140,A01,083663,Gungor; Onat,15,0,85,70
1657877418441,CSE 140L,A01,083088,Eldon; John,23,0,100,77
1657877424468,CSE 175,A01,083665,Kumar; Rakesh,3,0,25,22
1657877430498,CSE 190,A00,092507,Dubnov; Shlomo,8,0,20,12
1657877436523,ECE 45,A01,083139,Congero; Spencer William,6,0,75,69
1657877442548,ECE 65,A50,083695,Saad; Andrew S,12,0,30,18
1657877442548,ECE 65,A51,095125,Saad; Andrew S,24,0,26,2
1657877448579,ECE 109,A01,091882,Touri; Behrouz,20,0,70,50
1657877454606,ECE 180,A00,083140,Abi Samra; Nicholas Camill,1,0,30,29
1657877454606,ECE 180,B00,083141,Abi Samra; Nicholas Camill,0,0,30,30
1657877460634,MATH 10A,A01,083735,Patchell; Gregory David,2,0,30,28
1657877460634,MATH 10A,A02,083736,Patchell; Gregory David,20,0,30,10
1657877460634,MATH 10A,A03,083737,Patchell; Gregory David,16,0,30,14
1657877466671,MATH 10B,A01,083207,Lim; Seonhee,8,0,34,26
1657877466671,MATH 10B,A02,083208,Lim; Seonhee,10,0,35,25
1657877466671,MATH 10B,A03,093472,Lim; Seonhee,7,0,34,27
1657877466671,MATH 10B,B01,083739,Sinha; Shubham,14,0,30,16
1657877472700,MATH 18,A01,083743,Cinel; Cameron Alexander,9,0,30,21
1657877472700,MATH 18,A02,083744,Cinel; Cameron Alexander,18,0,30,12
1657877472700,MATH 18,A03,083745,Cinel; Cameron Alexander,10,0,30,20
1657877472700,MATH 18,B01,083748,Rideout; David Porter,5,0,37,32
1657877472700,MATH 18,B02,083749,Rideout; David Porter,5,0,36,31
1657877472700,MATH 18,B03,083750,Rideout; David Porter,3,0,37,34
1657877472700,MATH 18,B04,083751,Rideout; David Porter,6,0,36,30
1657877472700,MATH 18,B05,093473,Rideout; David Porter,6,0,36,30
1657877472700,MATH 18,B06,093474,Rideout; David Porter,6,0,36,30
1657877478730,MATH 20A,A01,083754,Zheng; Zequn,14,0,40,26
1657877484765,MATH 20B,A01,083756,Briones; Jor-el Thomas Caparas,4,0,36,32
1657877484765,MATH 20B,A02,083757,Briones; Jor-el Thomas Caparas,1,0,36,35
1657877484765,MATH 20B,A03,093475,Briones; Jor-el Thomas Caparas,2,0,36,34
1657877490791,MATH 20C,A01,083760,Briones; Jor-el Thomas Caparas,1,0,35,34
1657877490791,MATH 20C,A02,083761,Briones; Jor-el Thomas Caparas,8,0,35,27
1657877490791,MATH 20C,A03,093476,Briones; Jor-el Thomas Caparas,0,1,36,36
1657877490791,MATH 20C,B01,083762,Bach; Quang Tran,1,0,30,29
1657877496819,MATH 20D,A01,083765,Tran; Brian Kha,5,0,30,25
1657877496819,MATH 20D,A02,083766,Tran; Brian Kha,5,0,30,25
1657877496819,MATH 20D,A03,083767,Tran; Brian Kha,5,0,30,25
1657877502853,MATH 20E,A01,083771,Ganguly; Soumya,10,0,32,22
1657877502853,MATH 20E,A02,083772,Ganguly; Soumya,6,0,32,26
1657877502853,MATH 20E,B01,083773,Ciotti; Benjamin,20,0,35,15
1657877502853,MATH 20E,B02,083774,Ciotti; Benjamin,18,0,35,17
1657877508890,MATH 103A,A01,083777,Greenfeld; Be'Eri,3,0,36,33
1657877508890,MATH 103A,A02,083778,Greenfeld; Be'Eri,5,0,36,31
1657877508890,MATH 103A,A03,093561,Greenfeld; Be'Eri,6,0,36,30
1657877508890,MATH 103A,B01,083779,Greenfeld; Be'Eri,7,0,36,29
1657877508890,MATH 103A,B02,083780,Greenfeld; Be'Eri,4,0,36,32
1657877508890,MATH 103A,B03,093562,Greenfeld; Be'Eri,3,0,36,33
1657877514916,MATH 105,A01,085443,Carter; Anne Toulson,15,0,35,20
1657877514916,MATH 105,A02,093477,Carter; Anne Toulson,20,0,35,15
1657877520949,MATH 109,A01,083213,Ganzberger; Geoffrey Michael,3,0,34,31
1657877520949,MATH 109,A02,083214,Ganzberger; Geoffrey Michael,4,0,34,30
1657877520949,MATH 109,A03,093478,Ganzberger; Geoffrey Michael,2,0,34,32
1657877520949,MATH 109,B01,083215,Ganzberger; Geoffrey Michael,1,0,32,31
1657877520949,MATH 109,B02,083216,Ganzberger; Geoffrey Michael,2,0,32,30
1657877520949,MATH 109,B03,093479,Ganzberger; Geoffrey Michael,8,0,32,24
1657877526984,MATH 142A,A01,083219,Chow; Bennett,7,0,32,25
1657877526984,MATH 142A,A02,083220,Chow; Bennett,10,0,32,22
1657877526984,MATH 142A,A03,093480,Chow; Bennett,9,0,32,23
1657877526984,MATH 142A,B03,093481,Chow; Bennett,8,0,32,24
1657877526984,MATH 142A,B04,093558,Chow; Bennett,13,0,32,19
1657877526984,MATH 142A,B05,093559,Chow; Bennett,7,0,32,25
1657877533015,MATH 193A,A01,083224,Rotar; Vladimir,8,0,34,26
1657877533015,MATH 193A,A02,083225,Rotar; Vladimir,10,0,34,24
1657877533015,MATH 193A,A03,083781,Rotar; Vladimir,5,0,34,29
1657877533015,MATH 193A,A04,083782,Rotar; Vladimir,11,0,34,23
1657877533015,MATH 193A,A05,093482,Rotar; Vladimir,10,0,34,24
1657877539046,MATH 197,001,091859,McAuley; Julian John,9999,0,9999,0
1657877539046,MATH 197,002,095566,Kedlaya; Kiran S.,9997,0,9999,2
1657877539046,MATH 197,003,095567,Xiao; Ming,9999,0,9999,0
1657877539046,MATH 197,004,095571,Perols; Johan Lars,9998,0,9999,1
1657877546125,COGS 9,A01,083615,Shannon; Kyle Michael,10,0,75,65
1657877552149,COGS 11,A01,083617,Boyle; Mary E. T.,23,0,48,25
1657877558175,COGS 13,A01,083071,Bastos; Amalia Pinkusfeld,11,0,71,60
1657877564198,COGS 14A,A01,092681,Semenuks; Arturs,5,1,100,95
1657877570226,COGS 14B,A01,083073,Cheng; Tzu-Han,6,0,63,57
1657877576252,COGS 17,A01,092677,Semenuks; Arturs,6,0,81,75
1657877582277,COGS 100,A01,083619,Allen; Michael Gordon,17,0,70,53
1657877588302,COGS 101A,A01,083621,Davis; Joshua Daniel,9,0,68,59
1657877594333,COGS 101B,A01,091572,Allen; Michael Gordon,13,0,65,52
1657877600357,COGS 101C,A01,083625,Delgado; Tania,17,0,35,18
1657877606419,COGS 107A,A01,083627,Boyle; Mary E. T.,14,0,60,46
1657877612444,COGS 118A,A01,083075,Gupta; Anjum,21,0,76,55
1657877618474,CSE 3,A50,083646,Miranda; Gregory Joseph,24,0,50,26
1657877624497,CSE 8A,A50,083650,Miranda; Gregory Joseph,17,1,56,39
1657877630527,CSE 11,A01,083080,Cao; Yingjun,6,15,40,34
1657877636556,CSE 12,A01,083652,Krause-Levy; Sophia Louisa,30,1,120,90
1657877642590,CSE 15L,A01,083654,Morris; Justin Loren,9,0,50,41
1657877642590,CSE 15L,A02,083655,Morris; Justin Loren,10,0,50,40
1657877648616,CSE 20,A01,083657,Tran; Khoa Dang,39,0,80,41
1657877654640,CSE 21,A01,095574,Bach; Quang Tran,22,0,48,26
1657877660677,CSE 30,A01,083084,Eldon; John,6,0,80,74
1657877660677,CSE 30,B01,095061,Bhaskar; Nishant,9,0,50,41
1657877666703,CSE 100,A01,083659,Cao; Yingjun,5,4,70,65
1657877672728,CSE 134B,A01,083661,Powell; Thomas Allan,24,0,100,76
1657877678757,CSE 140,A01,083663,Gungor; Onat,15,0,85,70
1657877684786,CSE 140L,A01,083088,Eldon; John,23,0,100,77
1657877690811,CSE 175,A01,083665,Kumar; Rakesh,3,0,25,22
1657877696836,CSE 190,A00,092507,Dubnov; Shlomo,8,0,20,12
1657877702863,ECE 45,A01,083139,Congero; Spencer William,6,0,75,69
1657877708888,ECE 65,A50,083695,Saad; Andrew S,12,0,30,18
1657877708888,ECE 65,A51,095125,Saad; Andrew S,24,0,26,2
1657877714912,ECE 109,A01,091882,Touri; Behrouz,20,0,70,50
1657877720937,ECE 180,A00,083140,Abi Samra; Nicholas Camill,1,0,30,29
1657877720937,ECE 180,B00,083141,Abi Samra; Nicholas Camill,0,0,30,30
1657877726965,MATH 10A,A01,083735,Patchell; Gregory David,2,0,30,28
1657877726965,MATH 10A,A02,083736,Patchell; Gregory David,20,0,30,10
1657877726965,MATH 10A,A03,083737,Patchell; Gregory David,16,0,30,14
1657877732994,MATH 10B,A01,083207,Lim; Seonhee,8,0,34,26
1657877732994,MATH 10B,A02,083208,Lim; Seonhee,10,0,35,25
1657877732994,MATH 10B,A03,093472,Lim; Seonhee,7,0,34,27
1657877732994,MATH 10B,B01,083739,Sinha; Shubham,14,0,30,16
1657877739025,MATH 18,A01,083743,Cinel; Cameron Alexander,9,0,30,21
1657877739025,MATH 18,A02,083744,Cinel; Cameron Alexander,18,0,30,12
1657877739025,MATH 18,A03,083745,Cinel; Cameron Alexander,10,0,30,20
1657877739025,MATH 18,B01,083748,Rideout; David Porter,5,0,37,32
1657877739025,MATH 18,B02,083749,Rideout; David Porter,5,0,36,31
1657877739025,MATH 18,B03,083750,Rideout; David Porter,3,0,37,34
1657877739025,MATH 18,B04,083751,Rideout; David Porter,6,0,36,30
1657877739025,MATH 18,B05,093473,Rideout; David Porter,6,0,36,30
1657877739025,MATH 18,B06,093474,Rideout; David Porter,6,0,36,30
1657877745057,MATH 20A,A01,083754,Zheng; Zequn,14,0,40,26
1657877751082,MATH 20B,A01,083756,Briones; Jor-el Thomas Caparas,4,0,36,32
1657877751082,MATH 20B,A02,083757,Briones; Jor-el Thomas Caparas,1,0,36,35
1657877751082,MATH 20B,A03,093475,Briones; Jor-el Thomas Caparas,2,0,36,34
1657877757109,MATH 20C,A01,083760,Briones; Jor-el Thomas Caparas,1,0,35,34
1657877757109,MATH 20C,A02,083761,Briones; Jor-el Thomas Caparas,8,0,35,27
1657877757109,MATH 20C,A03,093476,Briones; Jor-el Thomas Caparas,0,1,36,36
1657877757109,MATH 20C,B01,083762,Bach; Quang Tran,1,0,30,29
1657877763135,MATH 20D,A01,083765,Tran; Brian Kha,5,0,30,25
1657877763135,MATH 20D,A02,083766,Tran; Brian Kha,5,0,30,25
1657877763135,MATH 20D,A03,083767,Tran; Brian Kha,5,0,30,25
1657877769171,MATH 20E,A01,083771,Ganguly; Soumya,10,0,32,22
1657877769171,MATH 20E,A02,083772,Ganguly; Soumya,6,0,32,26
1657877769171,MATH 20E,B01,083773,Ciotti; Benjamin,20,0,35,15
1657877769171,MATH 20E,B02,083774,Ciotti; Benjamin,18,0,35,17
1657877775210,MATH 103A,A01,083777,Greenfeld; Be'Eri,3,0,36,33
1657877775210,MATH 103A,A02,083778,Greenfeld; Be'Eri,5,0,36,31
1657877775210,MATH 103A,A03,093561,Greenfeld; Be'Eri,6,0,36,30
1657877775210,MATH 103A,B01,083779,Greenfeld; Be'Eri,7,0,36,29
1657877775210,MATH 103A,B02,083780,Greenfeld; Be'Eri,4,0,36,32
1657877775210,MATH 103A,B03,093562,Greenfeld; Be'Eri,3,0,36,33
1657877781244,MATH 105,A01,085443,Carter; Anne Toulson,15,0,35,20
1657877781244,MATH 105,A02,093477,Carter; Anne Toulson,20,0,35,15
1657877787270,MATH 109,A01,083213,Ganzberger; Geoffrey Michael,3,0,34,31
1657877787270,MATH 109,A02,083214,Ganzberger; Geoffrey Michael,4,0,34,30
1657877787270,MATH 109,A03,093478,Ganzberger; Geoffrey Michael,2,0,34,32
1657877787270,MATH 109,B01,083215,Ganzberger; Geoffrey Michael,1,0,32,31
1657877787270,MATH 109,B02,083216,Ganzberger; Geoffrey Michael,2,0,32,30
1657877787270,MATH 109,B03,093479,Ganzberger; Geoffrey Michael,8,0,32,24
1657877793302,MATH 142A,A01,083219,Chow; Bennett,7,0,32,25
1657877793302,MATH 142A,A02,083220,Chow; Bennett,10,0,32,22
1657877793302,MATH 142A,A03,093480,Chow; Bennett,9,0,32,23
1657877793302,MATH 142A,B03,093481,Chow; Bennett,8,0,32,24
1657877793302,MATH 142A,B04,093558,Chow; Bennett,13,0,32,19
1657877793302,MATH 142A,B05,093559,Chow; Bennett,7,0,32,25
1657877799332,MATH 193A,A01,083224,Rotar; Vladimir,8,0,34,26
1657877799332,MATH 193A,A02,083225,Rotar; Vladimir,10,0,34,24
1657877799332,MATH 193A,A03,083781,Rotar; Vladimir,5,0,34,29
1657877799332,MATH 193A,A04,083782,Rotar; Vladimir,11,0,34,23
1657877799332,MATH 193A,A05,093482,Rotar; Vladimir,10,0,34,24
1657877805364,MATH 197,001,091859,McAuley; Julian John,9999,0,9999,0
1657877805364,MATH 197,002,095566,Kedlaya; Kiran S.,9997,0,9999,2
1657877805364,MATH 197,003,095567,Xiao; Ming,9999,0,9999,0
1657877805364,MATH 197,004,095571,Perols; Johan Lars,9998,0,9999,1
1657877812439,COGS 9,A01,083615,Shannon; Kyle Michael,10,0,75,65
1657877818464,COGS 11,A01,083617,Boyle; Mary E. T.,23,0,48,25
1657877824496,COGS 13,A01,083071,Bastos; Amalia Pinkusfeld,11,0,71,60
1657877830522,COGS 14A,A01,092681,Semenuks; Arturs,5,1,100,95
1657877836551,COGS 14B,A01,083073,Cheng; Tzu-Han,6,0,63,57
1657877842582,COGS 17,A01,092677,Semenuks; Arturs,6,0,81,75
1657877848606,COGS 100,A01,083619,Allen; Michael Gordon,17,0,70,53
1657877854633,COGS 101A,A01,083621,Davis; Joshua Daniel,9,0,68,59
1657877860661,COGS 101B,A01,091572,Allen; Michael Gordon,13,0,65,52
1657877866686,COGS 101C,A01,083625,Delgado; Tania,17,0,35,18
1657877872708,COGS 107A,A01,083627,Boyle; Mary E. T.,14,0,60,46
1657877878733,COGS 118A,A01,083075,Gupta; Anjum,21,0,76,55
1657877884766,CSE 3,A50,083646,Miranda; Gregory Joseph,24,0,50,26
1657877890789,CSE 8A,A50,083650,Miranda; Gregory Joseph,17,1,56,39
1657877896812,CSE 11,A01,083080,Cao; Yingjun,6,15,40,34
1657877902843,CSE 12,A01,083652,Krause-Levy; Sophia Louisa,30,1,120,90
1657877908874,CSE 15L,A01,083654,Morris; Justin Loren,9,0,50,41
1657877908874,CSE 15L,A02,083655,Morris; Justin Loren,10,0,50,40
1657877914900,CSE 20,A01,083657,Tran; Khoa Dang,39,0,80,41
1657877920932,CSE 21,A01,095574,Bach; Quang Tran,22,0,48,26
1657877927054,CSE 30,A01,083084,Eldon; John,6,0,80,74
1657877927054,CSE 30,B01,095061,Bhaskar; Nishant,9,0,50,41
1657877933078,CSE 100,A01,083659,Cao; Yingjun,5,4,70,65
1657877939103,CSE 134B,A01,083661,Powell; Thomas Allan,24,0,100,76
1657877945132,CSE 140,A01,083663,Gungor; Onat,15,0,85,70
1657877951156,CSE 140L,A01,083088,Eldon; John,23,0,100,77
1657877957180,CSE 175,A01,083665,Kumar; Rakesh,3,0,25,22
1657877963206,CSE 190,A00,092507,Dubnov; Shlomo,8,0,20,12
1657877969235,ECE 45,A01,083139,Congero; Spencer William,6,0,75,69
1657877975259,ECE 65,A50,083695,Saad; Andrew S,12,0,30,18
1657877975259,ECE 65,A51,095125,Saad; Andrew S,24,0,26,2
1657877981289,ECE 109,A01,091882,Touri; Behrouz,20,0,70,50
1657877987314,ECE 180,A00,083140,Abi Samra; Nicholas Camill,1,0,30,29
1657877987314,ECE 180,B00,083141,Abi Samra; Nicholas Camill,0,0,30,30
1657877993348,MATH 10A,A01,083735,Patchell; Gregory David,2,0,30,28
1657877993348,MATH 10A,A02,083736,Patchell; Gregory David,20,0,30,10
1657877993348,MATH 10A,A03,083737,Patchell; Gregory David,16,0,30,14
1657877999375,MATH 10B,A01,083207,Lim; Seonhee,8,0,34,26
1657877999375,MATH 10B,A02,083208,Lim; Seonhee,10,0,35,25
1657877999375,MATH 10B,A03,093472,Lim; Seonhee,7,0,34,27
1657877999375,MATH 10B,B01,083739,Sinha; Shubham,14,0,30,16
1657878005413,MATH 18,A01,083743,Cinel; Cameron Alexander,9,0,30,21
1657878005413,MATH 18,A02,083744,Cinel; Cameron Alexander,18,0,30,12
1657878005413,MATH 18,A03,083745,Cinel; Cameron Alexander,10,0,30,20
1657878005413,MATH 18,B01,083748,Rideout; David Porter,5,0,37,32
1657878005413,MATH 18,B02,083749,Rideout; David Porter,5,0,36,31
1657878005413,MATH 18,B03,083750,Rideout; David Porter,3,0,37,34
1657878005413,MATH 18,B04,083751,Rideout; David Porter,6,0,36,30
1657878005413,MATH 18,B05,093473,Rideout; David Porter,6,0,36,30
1657878005413,MATH 18,B06,093474,Rideout; David Porter,6,0,36,30
1657878011443,MATH 20A,A01,083754,Zheng; Zequn,14,0,40,26
1657878017468,MATH 20B,A01,083756,Briones; Jor-el Thomas Caparas,4,0,36,32
1657878017468,MATH 20B,A02,083757,Briones; Jor-el Thomas Caparas,1,0,36,35
1657878017468,MATH 20B,A03,093475,Briones; Jor-el Thomas Caparas,2,0,36,34
1657878023493,MATH 20C,A01,083760,Briones; Jor-el Thomas Caparas,1,0,35,34
1657878023493,MATH 20C,A02,083761,Briones; Jor-el Thomas Caparas,8,0,35,27
1657878023493,MATH 20C,A03,093476,Briones; Jor-el Thomas Caparas,0,1,36,36
1657878023493,MATH 20C,B01,083762,Bach; Quang Tran,1,0,30,29
1657878029521,MATH 20D,A01,083765,Tran; Brian Kha,5,0,30,25
1657878029521,MATH 20D,A02,083766,Tran; Brian Kha,5,0,30,25
1657878029521,MATH 20D,A03,083767,Tran; Brian Kha,5,0,30,25
1657878035548,MATH 20E,A01,083771,Ganguly; Soumya,10,0,32,22
1657878035548,MATH 20E,A02,083772,Ganguly; Soumya,6,0,32,26
1657878035548,MATH 20E,B01,083773,Ciotti; Benjamin,20,0,35,15
1657878035548,MATH 20E,B02,083774,Ciotti; Benjamin,18,0,35,17
1657878041572,MATH 103A,A01,083777,Greenfeld; Be'Eri,3,0,36,33
1657878041572,MATH 103A,A02,083778,Greenfeld; Be'Eri,5,0,36,31
1657878041572,MATH 103A,A03,093561,Greenfeld; Be'Eri,6,0,36,30
1657878041572,MATH 103A,B01,083779,Greenfeld; Be'Eri,7,0,36,29
1657878041572,MATH 103A,B02,083780,Greenfeld; Be'Eri,4,0,36,32
1657878041572,MATH 103A,B03,093562,Greenfeld; Be'Eri,3,0,36,33
1657878047598,MATH 105,A01,085443,Carter; Anne Toulson,15,0,35,20
1657878047598,MATH 105,A02,093477,Carter; Anne Toulson,20,0,35,15
1657878053630,MATH 109,A01,083213,Ganzberger; Geoffrey Michael,3,0,34,31
1657878053630,MATH 109,A02,083214,Ganzberger; Geoffrey Michael,4,0,34,30
1657878053630,MATH 109,A03,093478,Ganzberger; Geoffrey Michael,2,0,34,32
1657878053630,MATH 109,B01,083215,Ganzberger; Geoffrey Michael,1,0,32,31
1657878053630,MATH 109,B02,083216,Ganzberger; Geoffrey Michael,2,0,32,30
1657878053630,MATH 109,B03,093479,Ganzberger; Geoffrey Michael,8,0,32,24
1657878059662,MATH 142A,A01,083219,Chow; Bennett,7,0,32,25
1657878059662,MATH 142A,A02,083220,Chow; Bennett,10,0,32,22
1657878059662,MATH 142A,A03,093480,Chow; Bennett,9,0,32,23
1657878059662,MATH 142A,B03,093481,Chow; Bennett,8,0,32,24
1657878059662,MATH 142A,B04,093558,Chow; Bennett,13,0,32,19
1657878059662,MATH 142A,B05,093559,Chow; Bennett,7,0,32,25
1657878065686,MATH 193A,A01,083224,Rotar; Vladimir,8,0,34,26
1657878065686,MATH 193A,A02,083225,Rotar; Vladimir,10,0,34,24
1657878065686,MATH 193A,A03,083781,Rotar; Vladimir,5,0,34,29
1657878065686,MATH 193A,A04,083782,Rotar; Vladimir,11,0,34,23
1657878065686,MATH 193A,A05,093482,Rotar; Vladimir,10,0,34,24
1657878071712,MATH 197,001,091859,McAuley; Julian John,9999,0,9999,0
1657878071712,MATH 197,002,095566,Kedlaya; Kiran S.,9997,0,9999,2
1657878071712,MATH 197,003,095567,Xiao; Ming,9999,0,9999,0
1657878071712,MATH 197,004,095571,Perols; Johan Lars,9998,0,9999,1
1657878078787,COGS 9,A01,083615,Shannon; Kyle Michael,10,0,75,65
1657878084815,COGS 11,A01,083617,Boyle; Mary E. T.,23,0,48,25
1657878090852,COGS 13,A01,083071,Bastos; Amalia Pinkusfeld,11,0,71,60
1657878096879,COGS 14A,A01,092681,Semenuks; Arturs,5,1,100,95
1657878102903,COGS 14B,A01,083073,Cheng; Tzu-Han,6,0,63,57
1657878108925,COGS 17,A01,092677,Semenuks; Arturs,6,0,81,75
1657878114949,COGS 100,A01,083619,Allen; Michael Gordon,17,0,70,53
1657878120977,COGS 101A,A01,083621,Davis; Joshua Daniel,9,0,68,59
1657878127002,COGS 101B,A01,091572,Allen; Michael Gordon,13,0,65,52
1657878133025,COGS 101C,A01,083625,Delgado; Tania,17,0,35,18
1657878139051,COGS 107A,A01,083627,Boyle; Mary E. T.,14,0,60,46
1657878145077,COGS 118A,A01,083075,Gupta; Anjum,21,0,76,55
1657878151109,CSE 3,A50,083646,Miranda; Gregory Joseph,24,0,50,26
1657878157136,CSE 8A,A50,083650,Miranda; Gregory Joseph,17,1,56,39
1657878163165,CSE 11,A01,083080,Cao; Yingjun,6,15,40,34
1657878169195,CSE 12,A01,083652,Krause-Levy; Sophia Louisa,30,1,120,90
1657878175220,CSE 15L,A01,083654,Morris; Justin Loren,9,0,50,41
1657878175220,CSE 15L,A02,083655,Morris; Justin Loren,10,0,50,40
1657878181245,CSE 20,A01,083657,Tran; Khoa Dang,39,0,80,41
1657878187268,CSE 21,A01,095574,Bach; Quang Tran,22,0,48,26
1657878193296,CSE 30,A01,083084,Eldon; John,6,0,80,74
1657878193296,CSE 30,B01,095061,Bhaskar; Nishant,9,0,50,41
1657878199320,CSE 100,A01,083659,Cao; Yingjun,5,4,70,65
1657878205348,CSE 134B,A01,083661,Powell; Thomas Allan,24,0,100,76
1657878211373,CSE 140,A01,083663,Gungor; Onat,15,0,85,70
1657878217397,CSE 140L,A01,083088,Eldon; John,23,0,100,77
1657878223434,CSE 175,A01,083665,Kumar; Rakesh,3,0,25,22
1657878229458,CSE 190,A00,092507,Dubnov; Shlomo,8,0,20,12
1657878235489,ECE 45,A01,083139,Congero; Spencer William,6,0,75,69
1657878241515,ECE 65,A50,083695,Saad; Andrew S,12,0,30,18
1657878241515,ECE 65,A51,095125,Saad; Andrew S,24,0,26,2
1657878247542,ECE 109,A01,091882,Touri; Behrouz,20,0,70,50
1657878253569,ECE 180,A00,083140,Abi Samra; Nicholas Camill,1,0,30,29
1657878253569,ECE 180,B00,083141,Abi Samra; Nicholas Camill,0,0,30,30
1657878259594,MATH 10A,A01,083735,Patchell; Gregory David,2,0,30,28
1657878259594,MATH 10A,A02,083736,Patchell; Gregory David,20,0,30,10
1657878259594,MATH 10A,A03,083737,Patchell; Gregory David,16,0,30,14
1657878265624,MATH 10B,A01,083207,Lim; Seonhee,8,0,34,26
1657878265624,MATH 10B,A02,083208,Lim; Seonhee,10,0,35,25
1657878265624,MATH 10B,A03,093472,Lim; Seonhee,7,0,34,27
1657878265624,MATH 10B,B01,083739,Sinha; Shubham,14,0,30,16
1657878271654,MATH 18,A01,083743,Cinel; Cameron Alexander,9,0,30,21
1657878271654,MATH 18,A02,083744,Cinel; Cameron Alexander,18,0,30,12
1657878271654,MATH 18,A03,083745,Cinel; Cameron Alexander,10,0,30,20
1657878271654,MATH 18,B01,083748,Rideout; David Porter,5,0,37,32
1657878271654,MATH 18,B02,083749,Rideout; David Porter,5,0,36,31
1657878271654,MATH 18,B03,083750,Rideout; David Porter,3,0,37,34
1657878271654,MATH 18,B04,083751,Rideout; David Porter,6,0,36,30
1657878271654,MATH 18,B05,093473,Rideout; David Porter,6,0,36,30
1657878271654,MATH 18,B06,093474,Rideout; David Porter,6,0,36,30
1657878277686,MATH 20A,A01,083754,Zheng; Zequn,14,0,40,26
1657878283709,MATH 20B,A01,083756,Briones; Jor-el Thomas Caparas,4,0,36,32
1657878283709,MATH 20B,A02,083757,Briones; Jor-el Thomas Caparas,1,0,36,35
1657878283709,MATH 20B,A03,093475,Briones; Jor-el Thomas Caparas,2,0,36,34
1657878289734,MATH 20C,A01,083760,Briones; Jor-el Thomas Caparas,1,0,35,34
1657878289734,MATH 20C,A02,083761,Briones; Jor-el Thomas Caparas,8,0,35,27
1657878289734,MATH 20C,A03,093476,Briones; Jor-el Thomas Caparas,0,1,36,36
1657878289734,MATH 20C,B01,083762,Bach; Quang Tran,1,0,30,29
1657878295764,MATH 20D,A01,083765,Tran; Brian Kha,5,0,30,25
1657878295764,MATH 20D,A02,083766,Tran; Brian Kha,5,0,30,25
1657878295764,MATH 20D,A03,083767,Tran; Brian Kha,5,0,30,25
1657878301788,MATH 20E,A01,083771,Ganguly; Soumya,10,0,32,22
1657878301788,MATH 20E,A02,083772,Ganguly; Soumya,6,0,32,26
1657878301788,MATH 20E,B01,083773,Ciotti; Benjamin,20,0,35,15
1657878301788,MATH 20E,B02,083774,Ciotti; Benjamin,18,0,35,17
1657878307813,MATH 103A,A01,083777,Greenfeld; Be'Eri,3,0,36,33
1657878307813,MATH 103A,A02,083778,Greenfeld; Be'Eri,5,0,36,31
1657878307813,MATH 103A,A03,093561,Greenfeld; Be'Eri,6,0,36,30
1657878307813,MATH 103A,B01,083779,Greenfeld; Be'Eri,7,0,36,29
1657878307813,MATH 103A,B02,083780,Greenfeld; Be'Eri,4,0,36,32
1657878307813,MATH 103A,B03,093562,Greenfeld; Be'Eri,3,0,36,33
1657878313847,MATH 105,A01,085443,Carter; Anne Toulson,15,0,35,20
1657878313847,MATH 105,A02,093477,Carter; Anne Toulson,20,0,35,15
1657878319871,MATH 109,A01,083213,Ganzberger; Geoffrey Michael,3,0,34,31
1657878319871,MATH 109,A02,083214,Ganzberger; Geoffrey Michael,4,0,34,30
1657878319871,MATH 109,A03,093478,Ganzberger; Geoffrey Michael,2,0,34,32
1657878319871,MATH 109,B01,083215,Ganzberger; Geoffrey Michael,1,0,32,31
1657878319871,MATH 109,B02,083216,Ganzberger; Geoffrey Michael,2,0,32,30
1657878319871,MATH 109,B03,093479,Ganzberger; Geoffrey Michael,8,0,32,24
1657878325896,MATH 142A,A01,083219,Chow; Bennett,7,0,32,25
1657878325896,MATH 142A,A02,083220,Chow; Bennett,10,0,32,22
1657878325896,MATH 142A,A03,093480,Chow; Bennett,9,0,32,23
1657878325896,MATH 142A,B03,093481,Chow; Bennett,8,0,32,24
1657878325896,MATH 142A,B04,093558,Chow; Bennett,13,0,32,19
1657878325896,MATH 142A,B05,093559,Chow; Bennett,7,0,32,25
1657878331923,MATH 193A,A01,083224,Rotar; Vladimir,8,0,34,26
1657878331923,MATH 193A,A02,083225,Rotar; Vladimir,10,0,34,24
1657878331923,MATH 193A,A03,083781,Rotar; Vladimir,5,0,34,29
1657878331923,MATH 193A,A04,083782,Rotar; Vladimir,11,0,34,23
1657878331923,MATH 193A,A05,093482,Rotar; Vladimir,10,0,34,24
1657878337951,MATH 197,001,091859,McAuley; Julian John,9999,0,9999,0
1657878337951,MATH 197,002,095566,Kedlaya; Kiran S.,9997,0,9999,2
1657878337951,MATH 197,003,095567,Xiao; Ming,9999,0,9999,0
1657878337951,MATH 197,004,095571,Perols; Johan Lars,9998,0,9999,1
1657878345021,COGS 9,A01,083615,Shannon; Kyle Michael,10,0,75,65
1657878351048,COGS 11,A01,083617,Boyle; Mary E. T.,23,0,48,25
1657878357079,COGS 13,A01,083071,Bastos; Amalia Pinkusfeld,11,0,71,60
1657878363106,COGS 14A,A01,092681,Semenuks; Arturs,5,1,100,95
1657878369133,COGS 14B,A01,083073,Cheng; Tzu-Han,6,0,63,57
1657878375160,COGS 17,A01,092677,Semenuks; Arturs,6,0,81,75
1657878381185,COGS 100,A01,083619,Allen; Michael Gordon,17,0,70,53
1657878387213,COGS 101A,A01,083621,Davis; Joshua Daniel,9,0,68,59
1657878393240,COGS 101B,A01,091572,Allen; Michael Gordon,13,0,65,52
1657878399264,COGS 101C,A01,083625,Delgado; Tania,17,0,35,18
1657878405287,COGS 107A,A01,083627,Boyle; Mary E. T.,14,0,60,46
1657878411315,COGS 118A,A01,083075,Gupta; Anjum,21,0,76,55
1657878417342,CSE 3,A50,083646,Miranda; Gregory Joseph,24,0,50,26
1657878423366,CSE 8A,A50,083650,Miranda; Gregory Joseph,17,1,56,39
1657878429390,CSE 11,A01,083080,Cao; Yingjun,6,15,40,34
1657878435417,CSE 12,A01,083652,Krause-Levy; Sophia Louisa,30,1,120,90
1657878441446,CSE 15L,A01,083654,Morris; Justin Loren,9,0,50,41
1657878441446,CSE 15L,A02,083655,Morris; Justin Loren,10,0,50,40
1657878447470,CSE 20,A01,083657,Tran; Khoa Dang,39,0,80,41
1657878453492,CSE 21,A01,095574,Bach; Quang Tran,22,0,48,26
1657878459519,CSE 30,A01,083084,Eldon; John,6,0,80,74
1657878459519,CSE 30,B01,095061,Bhaskar; Nishant,9,0,50,41
1657878465547,CSE 100,A01,083659,Cao; Yingjun,5,4,70,65
1657878471573,CSE 134B,A01,083661,Powell; Thomas Allan,24,0,100,76
1657878477598,CSE 140,A01,083663,Gungor; Onat,15,0,85,70
1657878483620,CSE 140L,A01,083088,Eldon; John,23,0,100,77
1657878489644,CSE 175,A01,083665,Kumar; Rakesh,3,0,25,22
1657878495670,CSE 190,A00,092507,Dubnov; Shlomo,8,0,20,12
1657878501694,ECE 45,A01,083139,Congero; Spencer William,6,0,75,69
1657878507732,ECE 65,A50,083695,Saad; Andrew S,12,0,30,18
1657878507732,ECE 65,A51,095125,Saad; Andrew S,24,0,26,2
1657878513760,ECE 109,A01,091882,Touri; Behrouz,20,0,70,50
1657878519788,ECE 180,A00,083140,Abi Samra; Nicholas Camill,1,0,30,29
1657878519788,ECE 180,B00,083141,Abi Samra; Nicholas Camill,0,0,30,30
1657878525886,MATH 10A,A01,083735,Patchell; Gregory David,2,0,30,28
1657878525886,MATH 10A,A02,083736,Patchell; Gregory David,20,0,30,10
1657878525886,MATH 10A,A03,083737,Patchell; Gregory David,16,0,30,14
1657878531912,MATH 10B,A01,083207,Lim; Seonhee,8,0,34,26
1657878531912,MATH 10B,A02,083208,Lim; Seonhee,10,0,35,25
1657878531912,MATH 10B,A03,093472,Lim; Seonhee,7,0,34,27
1657878531912,MATH 10B,B01,083739,Sinha; Shubham,14,0,30,16
1657878537946,MATH 18,A01,083743,Cinel; Cameron Alexander,9,0,30,21
1657878537946,MATH 18,A02,083744,Cinel; Cameron Alexander,18,0,30,12
1657878537946,MATH 18,A03,083745,Cinel; Cameron Alexander,10,0,30,20
1657878537946,MATH 18,B01,083748,Rideout; David Porter,5,0,37,32
1657878537946,MATH 18,B02,083749,Rideout; David Porter,5,0,36,31
1657878537946,MATH 18,B03,083750,Rideout; David Porter,3,0,37,34
1657878537946,MATH 18,B04,083751,Rideout; David Porter,6,0,36,30
1657878537946,MATH 18,B05,093473,Rideout; David Porter,6,0,36,30
1657878537946,MATH 18,B06,093474,Rideout; David Porter,6,0,36,30
1657878543975,MATH 20A,A01,083754,Zheng; Zequn,14,0,40,26
1657878549998,MATH 20B,A01,083756,Briones; Jor-el Thomas Caparas,4,0,36,32
1657878549998,MATH 20B,A02,083757,Briones; Jor-el Thomas Caparas,1,0,36,35
1657878549998,MATH 20B,A03,093475,Briones; Jor-el Thomas Caparas,2,0,36,34
1657878556023,MATH 20C,A01,083760,Briones; Jor-el Thomas Caparas,1,0,35,34
1657878556023,MATH 20C,A02,083761,Briones; Jor-el Thomas Caparas,8,0,35,27
1657878556023,MATH 20C,A03,093476,Briones; Jor-el Thomas Caparas,0,1,36,36
1657878556023,MATH 20C,B01,083762,Bach; Quang Tran,1,0,30,29
1657878562048,MATH 20D,A01,083765,Tran; Brian Kha,5,0,30,25
1657878562048,MATH 20D,A02,083766,Tran; Brian Kha,5,0,30,25
1657878562048,MATH 20D,A03,083767,Tran; Brian Kha,5,0,30,25
1657878568083,MATH 20E,A01,083771,Ganguly; Soumya,10,0,32,22
1657878568083,MATH 20E,A02,083772,Ganguly; Soumya,6,0,32,26
1657878568083,MATH 20E,B01,083773,Ciotti; Benjamin,20,0,35,15
1657878568083,MATH 20E,B02,083774,Ciotti; Benjamin,18,0,35,17
1657878574113,MATH 103A,A01,083777,Greenfeld; Be'Eri,3,0,36,33
1657878574113,MATH 103A,A02,083778,Greenfeld; Be'Eri,5,0,36,31
1657878574113,MATH 103A,A03,093561,Greenfeld; Be'Eri,6,0,36,30
1657878574113,MATH 103A,B01,083779,Greenfeld; Be'Eri,7,0,36,29
1657878574113,MATH 103A,B02,083780,Greenfeld; Be'Eri,4,0,36,32
1657878574113,MATH 103A,B03,093562,Greenfeld; Be'Eri,3,0,36,33
1657878580137,MATH 105,A01,085443,Carter; Anne Toulson,15,0,35,20
1657878580137,MATH 105,A02,093477,Carter; Anne Toulson,20,0,35,15
1657878586161,MATH 109,A01,083213,Ganzberger; Geoffrey Michael,3,0,34,31
1657878586161,MATH 109,A02,083214,Ganzberger; Geoffrey Michael,4,0,34,30
1657878586161,MATH 109,A03,093478,Ganzberger; Geoffrey Michael,2,0,34,32
1657878586161,MATH 109,B01,083215,Ganzberger; Geoffrey Michael,1,0,32,31
1657878586161,MATH 109,B02,083216,Ganzberger; Geoffrey Michael,2,0,32,30
1657878586161,MATH 109,B03,093479,Ganzberger; Geoffrey Michael,8,0,32,24
1657878592188,MATH 142A,A01,083219,Chow; Bennett,7,0,32,25
1657878592188,MATH 142A,A02,083220,Chow; Bennett,10,0,32,22
1657878592188,MATH 142A,A03,093480,Chow; Bennett,9,0,32,23
1657878592188,MATH 142A,B03,093481,Chow; Bennett,8,0,32,24
1657878592188,MATH 142A,B04,093558,Chow; Bennett,13,0,32,19
1657878592188,MATH 142A,B05,093559,Chow; Bennett,7,0,32,25
1657878598214,MATH 193A,A01,083224,Rotar; Vladimir,8,0,34,26
1657878598214,MATH 193A,A02,083225,Rotar; Vladimir,10,0,34,24
1657878598214,MATH 193A,A03,083781,Rotar; Vladimir,5,0,34,29
1657878598214,MATH 193A,A04,083782,Rotar; Vladimir,11,0,34,23
1657878598214,MATH 193A,A05,093482,Rotar; Vladimir,10,0,34,24
1657878604243,MATH 197,001,091859,McAuley; Julian John,9999,0,9999,0
1657878604243,MATH 197,002,095566,Kedlaya; Kiran S.,9997,0,9999,2
1657878604243,MATH 197,003,095567,Xiao; Ming,9999,0,9999,0
1657878604243,MATH 197,004,095571,Perols; Johan Lars,9998,0,9999,1
1657878611307,COGS 9,A01,083615,Shannon; Kyle Michael,10,0,75,65
1657878617334,COGS 11,A01,083617,Boyle; Mary E. T.,23,0,48,25
1657878623357,COGS 13,A01,083071,Bastos; Amalia Pinkusfeld,11,0,71,60
1657878629384,COGS 14A,A01,092681,Semenuks; Arturs,5,1,100,95
1657878635412,COGS 14B,A01,083073,Cheng; Tzu-Han,6,0,63,57
1657878641438,COGS 17,A01,092677,Semenuks; Arturs,6,0,81,75
1657878647462,COGS 100,A01,083619,Allen; Michael Gordon,17,0,70,53
1657878653486,COGS 101A,A01,083621,Davis; Joshua Daniel,9,0,68,59
1657878659511,COGS 101B,A01,091572,Allen; Michael Gordon,13,0,65,52
1657878665536,COGS 101C,A01,083625,Delgado; Tania,17,0,35,18
1657878671567,COGS 107A,A01,083627,Boyle; Mary E. T.,14,0,60,46
1657878677592,COGS 118A,A01,083075,Gupta; Anjum,21,0,76,55
1657878683616,CSE 3,A50,083646,Miranda; Gregory Joseph,24,0,50,26
1657878689643,CSE 8A,A50,083650,Miranda; Gregory Joseph,17,1,56,39
1657878695667,CSE 11,A01,083080,Cao; Yingjun,6,15,40,34
1657878701694,CSE 12,A01,083652,Krause-Levy; Sophia Louisa,30,1,120,90
1657878707719,CSE 15L,A01,083654,Morris; Justin Loren,9,0,50,41
1657878707719,CSE 15L,A02,083655,Morris; Justin Loren,10,0,50,40
1657878713747,CSE 20,A01,083657,Tran; Khoa Dang,39,0,80,41
1657878719775,CSE 21,A01,095574,Bach; Quang Tran,22,0,48,26
1657878725801,CSE 30,A01,083084,Eldon; John,6,0,80,74
1657878725801,CSE 30,B01,095061,Bhaskar; Nishant,9,0,50,41
1657878731825,CSE 100,A01,083659,Cao; Yingjun,5,4,70,65
1657878737852,CSE 134B,A01,083661,Powell; Thomas Allan,24,0,100,76
1657878743881,CSE 140,A01,083663,Gungor; Onat,15,0,85,70
1657878749908,CSE 140L,A01,083088,Eldon; John,23,0,100,77
1657878755933,CSE 175,A01,083665,Kumar; Rakesh,3,0,25,22
1657878761962,CSE 190,A00,092507,Dubnov; Shlomo,8,0,20,12
1657878767991,ECE 45,A01,083139,Congero; Spencer William,6,0,75,69
1657878774016,ECE 65,A50,083695,Saad; Andrew S,12,0,30,18
1657878774016,ECE 65,A51,095125,Saad; Andrew S,24,0,26,2
1657878780043,ECE 109,A01,091882,Touri; Behrouz,20,0,70,50
1657878786068,ECE 180,A00,083140,Abi Samra; Nicholas Camill,1,0,30,29
1657878786068,ECE 180,B00,083141,Abi Samra; Nicholas Camill,0,0,30,30
1657878792093,MATH 10A,A01,083735,Patchell; Gregory David,2,0,30,28
1657878792093,MATH 10A,A02,083736,Patchell; Gregory David,20,0,30,10
1657878792093,MATH 10A,A03,083737,Patchell; Gregory David,16,0,30,14
1657878798119,MATH 10B,A01,083207,Lim; Seonhee,8,0,34,26
1657878798119,MATH 10B,A02,083208,Lim; Seonhee,10,0,35,25
1657878798119,MATH 10B,A03,093472,Lim; Seonhee,7,0,34,27
1657878798119,MATH 10B,B01,083739,Sinha; Shubham,14,0,30,16
1657878804142,MATH 18,A01,083743,Cinel; Cameron Alexander,9,0,30,21
1657878804142,MATH 18,A02,083744,Cinel; Cameron Alexander,18,0,30,12
1657878804142,MATH 18,A03,083745,Cinel; Cameron Alexander,10,0,30,20
1657878804142,MATH 18,B01,083748,Rideout; David Porter,5,0,37,32
1657878804142,MATH 18,B02,083749,Rideout; David Porter,5,0,36,31
1657878804142,MATH 18,B03,083750,Rideout; David Porter,3,0,37,34
1657878804142,MATH 18,B04,083751,Rideout; David Porter,6,0,36,30
1657878804142,MATH 18,B05,093473,Rideout; David Porter,6,0,36,30
1657878804142,MATH 18,B06,093474,Rideout; David Porter,6,0,36,30
1657878810169,MATH 20A,A01,083754,Zheng; Zequn,14,0,40,26
1657878816194,MATH 20B,A01,083756,Briones; Jor-el Thomas Caparas,4,0,36,32
1657878816194,MATH 20B,A02,083757,Briones; Jor-el Thomas Caparas,1,0,36,35
1657878816194,MATH 20B,A03,093475,Briones; Jor-el Thomas Caparas,2,0,36,34
1657878822219,MATH 20C,A01,083760,Briones; Jor-el Thomas Caparas,1,0,35,34
1657878822219,MATH 20C,A02,083761,Briones; Jor-el Thomas Caparas,8,0,35,27
1657878822219,MATH 20C,A03,093476,Briones; Jor-el Thomas Caparas,0,1,36,36
1657878822219,MATH 20C,B01,083762,Bach; Quang Tran,1,0,30,29
1657878828247,MATH 20D,A01,083765,Tran; Brian Kha,5,0,30,25
1657878828247,MATH 20D,A02,083766,Tran; Brian Kha,5,0,30,25
1657878828247,MATH 20D,A03,083767,Tran; Brian Kha,5,0,30,25
1657878834272,MATH 20E,A01,083771,Ganguly; Soumya,10,0,32,22
1657878834272,MATH 20E,A02,083772,Ganguly; Soumya,6,0,32,26
1657878834272,MATH 20E,B01,083773,Ciotti; Benjamin,20,0,35,15
1657878834272,MATH 20E,B02,083774,Ciotti; Benjamin,18,0,35,17
1657878840298,MATH 103A,A01,083777,Greenfeld; Be'Eri,3,0,36,33
1657878840298,MATH 103A,A02,083778,Greenfeld; Be'Eri,5,0,36,31
1657878840298,MATH 103A,A03,093561,Greenfeld; Be'Eri,6,0,36,30
1657878840298,MATH 103A,B01,083779,Greenfeld; Be'Eri,7,0,36,29
1657878840298,MATH 103A,B02,083780,Greenfeld; Be'Eri,4,0,36,32
1657878840298,MATH 103A,B03,093562,Greenfeld; Be'Eri,3,0,36,33
1657878846323,MATH 105,A01,085443,Carter; Anne Toulson,15,0,35,20
1657878846323,MATH 105,A02,093477,Carter; Anne Toulson,20,0,35,15
1657878852348,MATH 109,A01,083213,Ganzberger; Geoffrey Michael,3,0,34,31
1657878852348,MATH 109,A02,083214,Ganzberger; Geoffrey Michael,4,0,34,30
1657878852348,MATH 109,A03,093478,Ganzberger; Geoffrey Michael,2,0,34,32
1657878852348,MATH 109,B01,083215,Ganzberger; Geoffrey Michael,1,0,32,31
1657878852348,MATH 109,B02,083216,Ganzberger; Geoffrey Michael,2,0,32,30
1657878852348,MATH 109,B03,093479,Ganzberger; Geoffrey Michael,8,0,32,24
1657878858376,MATH 142A,A01,083219,Chow; Bennett,7,0,32,25
1657878858376,MATH 142A,A02,083220,Chow; Bennett,10,0,32,22
1657878858376,MATH 142A,A03,093480,Chow; Bennett,9,0,32,23
1657878858376,MATH 142A,B03,093481,Chow; Bennett,8,0,32,24
1657878858376,MATH 142A,B04,093558,Chow; Bennett,13,0,32,19
1657878858376,MATH 142A,B05,093559,Chow; Bennett,7,0,32,25
1657878864410,MATH 193A,A01,083224,Rotar; Vladimir,8,0,34,26
1657878864410,MATH 193A,A02,083225,Rotar; Vladimir,10,0,34,24
1657878864410,MATH 193A,A03,083781,Rotar; Vladimir,5,0,34,29
1657878864410,MATH 193A,A04,083782,Rotar; Vladimir,11,0,34,23
1657878864410,MATH 193A,A05,093482,Rotar; Vladimir,10,0,34,24
1657878870434,MATH 197,001,091859,McAuley; Julian John,9999,0,9999,0
1657878870434,MATH 197,002,095566,Kedlaya; Kiran S.,9997,0,9999,2
1657878870434,MATH 197,003,095567,Xiao; Ming,9999,0,9999,0
1657878870434,MATH 197,004,095571,Perols; Johan Lars,9998,0,9999,1
1657878877501,COGS 9,A01,083615,Shannon; Kyle Michael,10,0,75,65
1657878883525,COGS 11,A01,083617,Boyle; Mary E. T.,23,0,48,25
1657878889550,COGS 13,A01,083071,Bastos; Amalia Pinkusfeld,11,0,71,60
1657878895579,COGS 14A,A01,092681,Semenuks; Arturs,5,1,100,95
1657878901612,COGS 14B,A01,083073,Cheng; Tzu-Han,6,0,63,57
1657878907639,COGS 17,A01,092677,Semenuks; Arturs,6,0,81,75
1657878913666,COGS 100,A01,083619,Allen; Michael Gordon,17,0,70,53
1657878919690,COGS 101A,A01,083621,Davis; Joshua Daniel,9,0,68,59
1657878925719,COGS 101B,A01,091572,Allen; Michael Gordon,13,0,65,52
1657878931742,COGS 101C,A01,083625,Delgado; Tania,17,0,35,18
1657878937770,COGS 107A,A01,083627,Boyle; Mary E. T.,14,0,60,46
1657878943796,COGS 118A,A01,083075,Gupta; Anjum,21,0,76,55
1657878949819,CSE 3,A50,083646,Miranda; Gregory Joseph,24,0,50,26
1657878955843,CSE 8A,A50,083650,Miranda; Gregory Joseph,17,1,56,39
1657878961867,CSE 11,A01,083080,Cao; Yingjun,6,15,40,34
1657878967891,CSE 12,A01,083652,Krause-Levy; Sophia Louisa,30,1,120,90
1657878973920,CSE 15L,A01,083654,Morris; Justin Loren,9,0,50,41
1657878973920,CSE 15L,A02,083655,Morris; Justin Loren,10,0,50,40
1657878979944,CSE 20,A01,083657,Tran; Khoa Dang,39,0,80,41
1657878985974,CSE 21,A01,095574,Bach; Quang Tran,22,0,48,26
1657878992002,CSE 30,A01,083084,Eldon; John,6,0,80,74
1657878992002,CSE 30,B01,095061,Bhaskar; Nishant,9,0,50,41
1657878998032,CSE 100,A01,083659,Cao; Yingjun,5,4,70,65
1657879004061,CSE 134B,A01,083661,Powell; Thomas Allan,24,0,100,76
1657879010085,CSE 140,A01,083663,Gungor; Onat,15,0,85,70
1657879016107,CSE 140L,A01,083088,Eldon; John,23,0,100,77
1657879022131,CSE 175,A01,083665,Kumar; Rakesh,3,0,25,22
1657879028160,CSE 190,A00,092507,Dubnov; Shlomo,8,0,20,12
1657879034189,ECE 45,A01,083139,Congero; Spencer William,6,0,75,69
1657879040216,ECE 65,A50,083695,Saad; Andrew S,12,0,30,18
1657879040216,ECE 65,A51,095125,Saad; Andrew S,24,0,26,2
1657879046245,ECE 109,A01,091882,Touri; Behrouz,20,0,70,50
1657879052270,ECE 180,A00,083140,Abi Samra; Nicholas Camill,1,0,30,29
1657879052270,ECE 180,B00,083141,Abi Samra; Nicholas Camill,0,0,30,30
1657879058296,MATH 10A,A01,083735,Patchell; Gregory David,2,0,30,28
1657879058296,MATH 10A,A02,083736,Patchell; Gregory David,20,0,30,10
1657879058296,MATH 10A,A03,083737,Patchell; Gregory David,16,0,30,14
1657879064321,MATH 10B,A01,083207,Lim; Seonhee,8,0,34,26
1657879064321,MATH 10B,A02,083208,Lim; Seonhee,10,0,35,25
1657879064321,MATH 10B,A03,093472,Lim; Seonhee,7,0,34,27
1657879064321,MATH 10B,B01,083739,Sinha; Shubham,14,0,30,16
1657879070356,MATH 18,A01,083743,Cinel; Cameron Alexander,9,0,30,21
1657879070356,MATH 18,A02,083744,Cinel; Cameron Alexander,18,0,30,12
1657879070356,MATH 18,A03,083745,Cinel; Cameron Alexander,10,0,30,20
1657879070356,MATH 18,B01,083748,Rideout; David Porter,5,0,37,32
1657879070356,MATH 18,B02,083749,Rideout; David Porter,5,0,36,31
1657879070356,MATH 18,B03,083750,Rideout; David Porter,3,0,37,34
1657879070356,MATH 18,B04,083751,Rideout; David Porter,6,0,36,30
1657879070356,MATH 18,B05,093473,Rideout; David Porter,6,0,36,30
1657879070356,MATH 18,B06,093474,Rideout; David Porter,6,0,36,30
1657879076384,MATH 20A,A01,083754,Zheng; Zequn,14,0,40,26
1657879082416,MATH 20B,A01,083756,Briones; Jor-el Thomas Caparas,4,0,36,32
1657879082416,MATH 20B,A02,083757,Briones; Jor-el Thomas Caparas,1,0,36,35
1657879082416,MATH 20B,A03,093475,Briones; Jor-el Thomas Caparas,2,0,36,34
1657879088444,MATH 20C,A01,083760,Briones; Jor-el Thomas Caparas,1,0,35,34
1657879088444,MATH 20C,A02,083761,Briones; Jor-el Thomas Caparas,8,0,35,27
1657879088444,MATH 20C,A03,093476,Briones; Jor-el Thomas Caparas,0,1,36,36
1657879088444,MATH 20C,B01,083762,Bach; Quang Tran,1,0,30,29
1657879094470,MATH 20D,A01,083765,Tran; Brian Kha,5,0,30,25
1657879094470,MATH 20D,A02,083766,Tran; Brian Kha,5,0,30,25
1657879094470,MATH 20D,A03,083767,Tran; Brian Kha,5,0,30,25
1657879100505,MATH 20E,A01,083771,Ganguly; Soumya,10,0,32,22
1657879100505,MATH 20E,A02,083772,Ganguly; Soumya,6,0,32,26
1657879100505,MATH 20E,B01,083773,Ciotti; Benjamin,20,0,35,15
1657879100505,MATH 20E,B02,083774,Ciotti; Benjamin,18,0,35,17
1657879106532,MATH 103A,A01,083777,Greenfeld; Be'Eri,3,0,36,33
1657879106532,MATH 103A,A02,083778,Greenfeld; Be'Eri,5,0,36,31
1657879106532,MATH 103A,A03,093561,Greenfeld; Be'Eri,6,0,36,30
1657879106532,MATH 103A,B01,083779,Greenfeld; Be'Eri,7,0,36,29
1657879106532,MATH 103A,B02,083780,Greenfeld; Be'Eri,4,0,36,32
1657879106532,MATH 103A,B03,093562,Greenfeld; Be'Eri,3,0,36,33
1657879112555,MATH 105,A01,085443,Carter; Anne Toulson,15,0,35,20
1657879112555,MATH 105,A02,093477,Carter; Anne Toulson,20,0,35,15
1657879118579,MATH 109,A01,083213,Ganzberger; Geoffrey Michael,3,0,34,31
1657879118579,MATH 109,A02,083214,Ganzberger; Geoffrey Michael,4,0,34,30
1657879118579,MATH 109,A03,093478,Ganzberger; Geoffrey Michael,2,0,34,32
1657879118579,MATH 109,B01,083215,Ganzberger; Geoffrey Michael,1,0,32,31
1657879118579,MATH 109,B02,083216,Ganzberger; Geoffrey Michael,2,0,32,30
1657879118579,MATH 109,B03,093479,Ganzberger; Geoffrey Michael,8,0,32,24
1657879124677,MATH 142A,A01,083219,Chow; Bennett,7,0,32,25
1657879124677,MATH 142A,A02,083220,Chow; Bennett,10,0,32,22
1657879124677,MATH 142A,A03,093480,Chow; Bennett,9,0,32,23
1657879124677,MATH 142A,B03,093481,Chow; Bennett,8,0,32,24
1657879124677,MATH 142A,B04,093558,Chow; Bennett,13,0,32,19
1657879124677,MATH 142A,B05,093559,Chow; Bennett,7,0,32,25
1657879130700,MATH 193A,A01,083224,Rotar; Vladimir,8,0,34,26
1657879130700,MATH 193A,A02,083225,Rotar; Vladimir,10,0,34,24
1657879130700,MATH 193A,A03,083781,Rotar; Vladimir,5,0,34,29
1657879130700,MATH 193A,A04,083782,Rotar; Vladimir,11,0,34,23
1657879130700,MATH 193A,A05,093482,Rotar; Vladimir,10,0,34,24
1657879136725,MATH 197,001,091859,McAuley; Julian John,9999,0,9999,0
1657879136725,MATH 197,002,095566,Kedlaya; Kiran S.,9997,0,9999,2
1657879136725,MATH 197,003,095567,Xiao; Ming,9999,0,9999,0
1657879136725,MATH 197,004,095571,Perols; Johan Lars,9998,0,9999,1
1657879143806,COGS 9,A01,083615,Shannon; Kyle Michael,10,0,75,65
1657879149830,COGS 11,A01,083617,Boyle; Mary E. T.,23,0,48,25
1657879155854,COGS 13,A01,083071,Bastos; Amalia Pinkusfeld,11,0,71,60
1657879161879,COGS 14A,A01,092681,Semenuks; Arturs,5,1,100,95
1657879167910,COGS 14B,A01,083073,Cheng; Tzu-Han,6,0,63,57
1657879173934,COGS 17,A01,092677,Semenuks; Arturs,6,0,81,75
1657879179963,COGS 100,A01,083619,Allen; Michael Gordon,17,0,70,53
1657879185988,COGS 101A,A01,083621,Davis; Joshua Daniel,9,0,68,59
1657879192016,COGS 101B,A01,091572,Allen; Michael Gordon,13,0,65,52
1657879198041,COGS 101C,A01,083625,Delgado; Tania,17,0,35,18
1657879204066,COGS 107A,A01,083627,Boyle; Mary E. T.,14,0,60,46
1657879210094,COGS 118A,A01,083075,Gupta; Anjum,21,0,76,55
1657879216118,CSE 3,A50,083646,Miranda; Gregory Joseph,24,0,50,26
1657879222144,CSE 8A,A50,083650,Miranda; Gregory Joseph,17,1,56,39
1657879228167,CSE 11,A01,083080,Cao; Yingjun,6,15,40,34
1657879234192,CSE 12,A01,083652,Krause-Levy; Sophia Louisa,30,1,120,90
1657879240219,CSE 15L,A01,083654,Morris; Justin Loren,9,0,50,41
1657879240219,CSE 15L,A02,083655,Morris; Justin Loren,10,0,50,40
1657879246242,CSE 20,A01,083657,Tran; Khoa Dang,39,0,80,41
1657879252269,CSE 21,A01,095574,Bach; Quang Tran,22,0,48,26
1657879258293,CSE 30,A01,083084,Eldon; John,6,0,80,74
1657879258293,CSE 30,B01,095061,Bhaskar; Nishant,9,0,50,41
1657879264316,CSE 100,A01,083659,Cao; Yingjun,5,4,70,65
1657879270338,CSE 134B,A01,083661,Powell; Thomas Allan,24,0,100,76
1657879276367,CSE 140,A01,083663,Gungor; Onat,15,0,85,70
1657879282394,CSE 140L,A01,083088,Eldon; John,23,0,100,77
1657879288419,CSE 175,A01,083665,Kumar; Rakesh,3,0,25,22
1657879294447,CSE 190,A00,092507,Dubnov; Shlomo,8,0,20,12
1657879300471,ECE 45,A01,083139,Congero; Spencer William,6,0,75,69
1657879306495,ECE 65,A50,083695,Saad; Andrew S,12,0,30,18
1657879306495,ECE 65,A51,095125,Saad; Andrew S,24,0,26,2
1657879312518,ECE 109,A01,091882,Touri; Behrouz,20,0,70,50
1657879318543,ECE 180,A00,083140,Abi Samra; Nicholas Camill,1,0,30,29
1657879318543,ECE 180,B00,083141,Abi Samra; Nicholas Camill,0,0,30,30
1657879324573,MATH 10A,A01,083735,Patchell; Gregory David,2,0,30,28
1657879324573,MATH 10A,A02,083736,Patchell; Gregory David,20,0,30,10
1657879324573,MATH 10A,A03,083737,Patchell; Gregory David,16,0,30,14
1657879330605,MATH 10B,A01,083207,Lim; Seonhee,8,0,34,26
1657879330605,MATH 10B,A02,083208,Lim; Seonhee,10,0,35,25
1657879330605,MATH 10B,A03,093472,Lim; Seonhee,7,0,34,27
1657879330605,MATH 10B,B01,083739,Sinha; Shubham,14,0,30,16
1657879336639,MATH 18,A01,083743,Cinel; Cameron Alexander,9,0,30,21
1657879336639,MATH 18,A02,083744,Cinel; Cameron Alexander,18,0,30,12
1657879336639,MATH 18,A03,083745,Cinel; Cameron Alexander,10,0,30,20
1657879336639,MATH 18,B01,083748,Rideout; David Porter,5,0,37,32
1657879336639,MATH 18,B02,083749,Rideout; David Porter,5,0,36,31
1657879336639,MATH 18,B03,083750,Rideout; David Porter,3,0,37,34
1657879336639,MATH 18,B04,083751,Rideout; David Porter,6,0,36,30
1657879336639,MATH 18,B05,093473,Rideout; David Porter,6,0,36,30
1657879336639,MATH 18,B06,093474,Rideout; David Porter,6,0,36,30
1657879342666,MATH 20A,A01,083754,Zheng; Zequn,14,0,40,26
1657879348690,MATH 20B,A01,083756,Briones; Jor-el Thomas Caparas,4,0,36,32
1657879348690,MATH 20B,A02,083757,Briones; Jor-el Thomas Caparas,1,0,36,35
1657879348690,MATH 20B,A03,093475,Briones; Jor-el Thomas Caparas,2,0,36,34
1657879354720,MATH 20C,A01,083760,Briones; Jor-el Thomas Caparas,1,0,35,34
1657879354720,MATH 20C,A02,083761,Briones; Jor-el Thomas Caparas,8,0,35,27
1657879354720,MATH 20C,A03,093476,Briones; Jor-el Thomas Caparas,0,1,36,36
1657879354720,MATH 20C,B01,083762,Bach; Quang Tran,1,0,30,29
1657879360750,MATH 20D,A01,083765,Tran; Brian Kha,5,0,30,25
1657879360750,MATH 20D,A02,083766,Tran; Brian Kha,5,0,30,25
1657879360750,MATH 20D,A03,083767,Tran; Brian Kha,5,0,30,25
1657879366779,MATH 20E,A01,083771,Ganguly; Soumya,10,0,32,22
1657879366779,MATH 20E,A02,083772,Ganguly; Soumya,6,0,32,26
1657879366779,MATH 20E,B01,083773,Ciotti; Benjamin,20,0,35,15
1657879366779,MATH 20E,B02,083774,Ciotti; Benjamin,18,0,35,17
1657879372810,MATH 103A,A01,083777,Greenfeld; Be'Eri,3,0,36,33
1657879372810,MATH 103A,A02,083778,Greenfeld; Be'Eri,5,0,36,31
1657879372810,MATH 103A,A03,093561,Greenfeld; Be'Eri,6,0,36,30
1657879372810,MATH 103A,B01,083779,Greenfeld; Be'Eri,7,0,36,29
1657879372810,MATH 103A,B02,083780,Greenfeld; Be'Eri,4,0,36,32
1657879372810,MATH 103A,B03,093562,Greenfeld; Be'Eri,3,0,36,33
1657879378855,MATH 105,A01,085443,Carter; Anne Toulson,15,0,35,20
1657879378855,MATH 105,A02,093477,Carter; Anne Toulson,20,0,35,15
1657879384885,MATH 109,A01,083213,Ganzberger; Geoffrey Michael,3,0,34,31
1657879384885,MATH 109,A02,083214,Ganzberger; Geoffrey Michael,4,0,34,30
1657879384885,MATH 109,A03,093478,Ganzberger; Geoffrey Michael,2,0,34,32
1657879384885,MATH 109,B01,083215,Ganzberger; Geoffrey Michael,1,0,32,31
1657879384885,MATH 109,B02,083216,Ganzberger; Geoffrey Michael,2,0,32,30
1657879384885,MATH 109,B03,093479,Ganzberger; Geoffrey Michael,8,0,32,24
1657879390918,MATH 142A,A01,083219,Chow; Bennett,7,0,32,25
1657879390918,MATH 142A,A02,083220,Chow; Bennett,10,0,32,22
1657879390918,MATH 142A,A03,093480,Chow; Bennett,9,0,32,23
1657879390918,MATH 142A,B03,093481,Chow; Bennett,8,0,32,24
1657879390918,MATH 142A,B04,093558,Chow; Bennett,13,0,32,19
1657879390918,MATH 142A,B05,093559,Chow; Bennett,7,0,32,25
1657879396951,MATH 193A,A01,083224,Rotar; Vladimir,8,0,34,26
1657879396951,MATH 193A,A02,083225,Rotar; Vladimir,10,0,34,24
1657879396951,MATH 193A,A03,083781,Rotar; Vladimir,5,0,34,29
1657879396951,MATH 193A,A04,083782,Rotar; Vladimir,11,0,34,23
1657879396951,MATH 193A,A05,093482,Rotar; Vladimir,10,0,34,24
1657879402981,MATH 197,001,091859,McAuley; Julian John,9999,0,9999,0
1657879402981,MATH 197,002,095566,Kedlaya; Kiran S.,9997,0,9999,2
1657879402981,MATH 197,003,095567,Xiao; Ming,9999,0,9999,0
1657879402981,MATH 197,004,095571,Perols; Johan Lars,9998,0,9999,1
1657879410044,COGS 9,A01,083615,Shannon; Kyle Michael,10,0,75,65
1657879416069,COGS 11,A01,083617,Boyle; Mary E. T.,23,0,48,25
1657879422092,COGS 13,A01,083071,Bastos; Amalia Pinkusfeld,11,0,71,60
1657879428116,COGS 14A,A01,092681,Semenuks; Arturs,5,1,100,95
1657879434139,COGS 14B,A01,083073,Cheng; Tzu-Han,6,0,63,57
1657879440166,COGS 17,A01,092677,Semenuks; Arturs,6,0,81,75
1657879446192,COGS 100,A01,083619,Allen; Michael Gordon,17,0,70,53
1657879452218,COGS 101A,A01,083621,Davis; Joshua Daniel,9,0,68,59
1657879458244,COGS 101B,A01,091572,Allen; Michael Gordon,13,0,65,52
1657879464272,COGS 101C,A01,083625,Delgado; Tania,17,0,35,18
1657879470302,COGS 107A,A01,083627,Boyle; Mary E. T.,14,0,60,46
1657879476329,COGS 118A,A01,083075,Gupta; Anjum,21,0,76,55
1657879482353,CSE 3,A50,083646,Miranda; Gregory Joseph,24,0,50,26
1657879488377,CSE 8A,A50,083650,Miranda; Gregory Joseph,17,1,56,39
1657879494401,CSE 11,A01,083080,Cao; Yingjun,6,15,40,34
1657879500427,CSE 12,A01,083652,Krause-Levy; Sophia Louisa,30,1,120,90
1657879506452,CSE 15L,A01,083654,Morris; Justin Loren,9,0,50,41
1657879506452,CSE 15L,A02,083655,Morris; Justin Loren,10,0,50,40
1657879512476,CSE 20,A01,083657,Tran; Khoa Dang,39,0,80,41
1657879518514,CSE 21,A01,095574,Bach; Quang Tran,22,0,48,26
1657879524541,CSE 30,A01,083084,Eldon; John,6,0,80,74
1657879524541,CSE 30,B01,095061,Bhaskar; Nishant,9,0,50,41
1657879530564,CSE 100,A01,083659,Cao; Yingjun,5,4,70,65
1657879536590,CSE 134B,A01,083661,Powell; Thomas Allan,24,0,100,76
1657879542620,CSE 140,A01,083663,Gungor; Onat,15,0,85,70
1657879548647,CSE 140L,A01,083088,Eldon; John,23,0,100,77
1657879554673,CSE 175,A01,083665,Kumar; Rakesh,3,0,25,22
1657879560697,CSE 190,A00,092507,Dubnov; Shlomo,8,0,20,12
1657879566722,ECE 45,A01,083139,Congero; Spencer William,6,0,75,69
1657879572746,ECE 65,A50,083695,Saad; Andrew S,12,0,30,18
1657879572746,ECE 65,A51,095125,Saad; Andrew S,24,0,26,2
1657879578770,ECE 109,A01,091882,Touri; Behrouz,20,0,70,50
1657879584793,ECE 180,A00,083140,Abi Samra; Nicholas Camill,1,0,30,29
1657879584793,ECE 180,B00,083141,Abi Samra; Nicholas Camill,0,0,30,30
1657879590818,MATH 10A,A01,083735,Patchell; Gregory David,2,0,30,28
1657879590818,MATH 10A,A02,083736,Patchell; Gregory David,20,0,30,10
1657879590818,MATH 10A,A03,083737,Patchell; Gregory David,16,0,30,14
1657879596844,MATH 10B,A01,083207,Lim; Seonhee,8,0,34,26
1657879596844,MATH 10B,A02,083208,Lim; Seonhee,10,0,35,25
1657879596844,MATH 10B,A03,093472,Lim; Seonhee,7,0,34,27
1657879596844,MATH 10B,B01,083739,Sinha; Shubham,14,0,30,16
1657879602876,MATH 18,A01,083743,Cinel; Cameron Alexander,9,0,30,21
1657879602876,MATH 18,A02,083744,Cinel; Cameron Alexander,18,0,30,12
1657879602876,MATH 18,A03,083745,Cinel; Cameron Alexander,10,0,30,20
1657879602876,MATH 18,B01,083748,Rideout; David Porter,5,0,37,32
1657879602876,MATH 18,B02,083749,Rideout; David Porter,5,0,36,31
1657879602876,MATH 18,B03,083750,Rideout; David Porter,3,0,37,34
1657879602876,MATH 18,B04,083751,Rideout; David Porter,6,0,36,30
1657879602876,MATH 18,B05,093473,Rideout; David Porter,6,0,36,30
1657879602876,MATH 18,B06,093474,Rideout; David Porter,6,0,36,30
1657879608899,MATH 20A,A01,083754,Zheng; Zequn,14,0,40,26
1657879614923,MATH 20B,A01,083756,Briones; Jor-el Thomas Caparas,4,0,36,32
1657879614923,MATH 20B,A02,083757,Briones; Jor-el Thomas Caparas,1,0,36,35
1657879614923,MATH 20B,A03,093475,Briones; Jor-el Thomas Caparas,2,0,36,34
1657879620947,MATH 20C,A01,083760,Briones; Jor-el Thomas Caparas,1,0,35,34
1657879620947,MATH 20C,A02,083761,Briones; Jor-el Thomas Caparas,8,0,35,27
1657879620947,MATH 20C,A03,093476,Briones; Jor-el Thomas Caparas,0,1,36,36
1657879620947,MATH 20C,B01,083762,Bach; Quang Tran,1,0,30,29
1657879626972,MATH 20D,A01,083765,Tran; Brian Kha,5,0,30,25
1657879626972,MATH 20D,A02,083766,Tran; Brian Kha,5,0,30,25
1657879626972,MATH 20D,A03,083767,Tran; Brian Kha,5,0,30,25
1657879632997,MATH 20E,A01,083771,Ganguly; Soumya,10,0,32,22
1657879632997,MATH 20E,A02,083772,Ganguly; Soumya,6,0,32,26
1657879632997,MATH 20E,B01,083773,Ciotti; Benjamin,20,0,35,15
1657879632997,MATH 20E,B02,083774,Ciotti; Benjamin,18,0,35,17
1657879639028,MATH 103A,A01,083777,Greenfeld; Be'Eri,3,0,36,33
1657879639028,MATH 103A,A02,083778,Greenfeld; Be'Eri,5,0,36,31
1657879639028,MATH 103A,A03,093561,Greenfeld; Be'Eri,6,0,36,30
1657879639028,MATH 103A,B01,083779,Greenfeld; Be'Eri,7,0,36,29
1657879639028,MATH 103A,B02,083780,Greenfeld; Be'Eri,4,0,36,32
1657879639028,MATH 103A,B03,093562,Greenfeld; Be'Eri,3,0,36,33
1657879645057,MATH 105,A01,085443,Carter; Anne Toulson,15,0,35,20
1657879645057,MATH 105,A02,093477,Carter; Anne Toulson,20,0,35,15
1657879651087,MATH 109,A01,083213,Ganzberger; Geoffrey Michael,3,0,34,31
1657879651087,MATH 109,A02,083214,Ganzberger; Geoffrey Michael,4,0,34,30
1657879651087,MATH 109,A03,093478,Ganzberger; Geoffrey Michael,2,0,34,32
1657879651087,MATH 109,B01,083215,Ganzberger; Geoffrey Michael,1,0,32,31
1657879651087,MATH 109,B02,083216,Ganzberger; Geoffrey Michael,2,0,32,30
1657879651087,MATH 109,B03,093479,Ganzberger; Geoffrey Michael,8,0,32,24
1657879657126,MATH 142A,A01,083219,Chow; Bennett,7,0,32,25
1657879657126,MATH 142A,A02,083220,Chow; Bennett,10,0,32,22
1657879657126,MATH 142A,A03,093480,Chow; Bennett,9,0,32,23
1657879657126,MATH 142A,B03,093481,Chow; Bennett,8,0,32,24
1657879657126,MATH 142A,B04,093558,Chow; Bennett,13,0,32,19
1657879657126,MATH 142A,B05,093559,Chow; Bennett,7,0,32,25
1657879663154,MATH 193A,A01,083224,Rotar; Vladimir,8,0,34,26
1657879663154,MATH 193A,A02,083225,Rotar; Vladimir,10,0,34,24
1657879663154,MATH 193A,A03,083781,Rotar; Vladimir,5,0,34,29
1657879663154,MATH 193A,A04,083782,Rotar; Vladimir,11,0,34,23
1657879663154,MATH 193A,A05,093482,Rotar; Vladimir,10,0,34,24
1657879669176,MATH 197,001,091859,McAuley; Julian John,9999,0,9999,0
1657879669176,MATH 197,002,095566,Kedlaya; Kiran S.,9997,0,9999,2
1657879669176,MATH 197,003,095567,Xiao; Ming,9999,0,9999,0
1657879669176,MATH 197,004,095571,Perols; Johan Lars,9998,0,9999,1
1657879676240,COGS 9,A01,083615,Shannon; Kyle Michael,10,0,75,65
1657879682262,COGS 11,A01,083617,Boyle; Mary E. T.,23,0,48,25
1657879688290,COGS 13,A01,083071,Bastos; Amalia Pinkusfeld,11,0,71,60
1657879694314,COGS 14A,A01,092681,Semenuks; Arturs,5,1,100,95
1657879700350,COGS 14B,A01,083073,Cheng; Tzu-Han,6,0,63,57
1657879706377,COGS 17,A01,092677,Semenuks; Arturs,6,0,81,75
1657879712401,COGS 100,A01,083619,Allen; Michael Gordon,17,0,70,53
1657879718513,COGS 101A,A01,083621,Davis; Joshua Daniel,9,0,68,59
1657879724537,COGS 101B,A01,091572,Allen; Michael Gordon,13,0,65,52
1657879730562,COGS 101C,A01,083625,Delgado; Tania,17,0,35,18
1657879736587,COGS 107A,A01,083627,Boyle; Mary E. T.,14,0,60,46
1657879742611,COGS 118A,A01,083075,Gupta; Anjum,21,0,76,55
1657879748637,CSE 3,A50,083646,Miranda; Gregory Joseph,24,0,50,26
1657879754665,CSE 8A,A50,083650,Miranda; Gregory Joseph,17,1,56,39
1657879760692,CSE 11,A01,083080,Cao; Yingjun,6,15,40,34
1657879766715,CSE 12,A01,083652,Krause-Levy; Sophia Louisa,30,1,120,90
1657879772744,CSE 15L,A01,083654,Morris; Justin Loren,9,0,50,41
1657879772744,CSE 15L,A02,083655,Morris; Justin Loren,10,0,50,40
1657879778767,CSE 20,A01,083657,Tran; Khoa Dang,39,0,80,41
1657879784797,CSE 21,A01,095574,Bach; Quang Tran,22,0,48,26
1657879790820,CSE 30,A01,083084,Eldon; John,6,0,80,74
1657879790820,CSE 30,B01,095061,Bhaskar; Nishant,9,0,50,41
1657879796843,CSE 100,A01,083659,Cao; Yingjun,5,4,70,65
1657879802866,CSE 134B,A01,083661,Powell; Thomas Allan,24,0,100,76
1657879808889,CSE 140,A01,083663,Gungor; Onat,15,0,85,70
1657879814912,CSE 140L,A01,083088,Eldon; John,23,0,100,77
1657879820938,CSE 175,A01,083665,Kumar; Rakesh,3,0,25,22
1657879826964,CSE 190,A00,092507,Dubnov; Shlomo,8,0,20,12
1657879832993,ECE 45,A01,083139,Congero; Spencer William,6,0,75,69
1657879839017,ECE 65,A50,083695,Saad; Andrew S,12,0,30,18
1657879839017,ECE 65,A51,095125,Saad; Andrew S,24,0,26,2
1657879845041,ECE 109,A01,091882,Touri; Behrouz,20,0,70,50
1657879851069,ECE 180,A00,083140,Abi Samra; Nicholas Camill,1,0,30,29
1657879851069,ECE 180,B00,083141,Abi Samra; Nicholas Camill,0,0,30,30
1657879857097,MATH 10A,A01,083735,Patchell; Gregory David,2,0,30,28
1657879857097,MATH 10A,A02,083736,Patchell; Gregory David,20,0,30,10
1657879857097,MATH 10A,A03,083737,Patchell; Gregory David,16,0,30,14
1657879863128,MATH 10B,A01,083207,Lim; Seonhee,8,0,34,26
1657879863128,MATH 10B,A02,083208,Lim; Seonhee,10,0,35,25
1657879863128,MATH 10B,A03,093472,Lim; Seonhee,7,0,34,27
1657879863128,MATH 10B,B01,083739,Sinha; Shubham,14,0,30,16
1657879869153,MATH 18,A01,083743,Cinel; Cameron Alexander,9,0,30,21
1657879869153,MATH 18,A02,083744,Cinel; Cameron Alexander,18,0,30,12
1657879869153,MATH 18,A03,083745,Cinel; Cameron Alexander,10,0,30,20
1657879869153,MATH 18,B01,083748,Rideout; David Porter,5,0,37,32
1657879869153,MATH 18,B02,083749,Rideout; David Porter,5,0,36,31
1657879869153,MATH 18,B03,083750,Rideout; David Porter,3,0,37,34
1657879869153,MATH 18,B04,083751,Rideout; David Porter,6,0,36,30
1657879869153,MATH 18,B05,093473,Rideout; David Porter,6,0,36,30
1657879869153,MATH 18,B06,093474,Rideout; David Porter,6,0,36,30
1657879875177,MATH 20A,A01,083754,Zheng; Zequn,14,0,40,26
1657879881202,MATH 20B,A01,083756,Briones; Jor-el Thomas Caparas,4,0,36,32
1657879881202,MATH 20B,A02,083757,Briones; Jor-el Thomas Caparas,1,0,36,35
1657879881202,MATH 20B,A03,093475,Briones; Jor-el Thomas Caparas,2,0,36,34
1657879887226,MATH 20C,A01,083760,Briones; Jor-el Thomas Caparas,1,0,35,34
1657879887226,MATH 20C,A02,083761,Briones; Jor-el Thomas Caparas,8,0,35,27
1657879887226,MATH 20C,A03,093476,Briones; Jor-el Thomas Caparas,0,1,36,36
1657879887226,MATH 20C,B01,083762,Bach; Quang Tran,1,0,30,29
1657879893249,MATH 20D,A01,083765,Tran; Brian Kha,5,0,30,25
1657879893249,MATH 20D,A02,083766,Tran; Brian Kha,5,0,30,25
1657879893249,MATH 20D,A03,083767,Tran; Brian Kha,5,0,30,25
1657879899274,MATH 20E,A01,083771,Ganguly; Soumya,10,0,32,22
1657879899274,MATH 20E,A02,083772,Ganguly; Soumya,6,0,32,26
1657879899274,MATH 20E,B01,083773,Ciotti; Benjamin,20,0,35,15
1657879899274,MATH 20E,B02,083774,Ciotti; Benjamin,18,0,35,17
1657879905297,MATH 103A,A01,083777,Greenfeld; Be'Eri,3,0,36,33
1657879905297,MATH 103A,A02,083778,Greenfeld; Be'Eri,5,0,36,31
1657879905297,MATH 103A,A03,093561,Greenfeld; Be'Eri,6,0,36,30
1657879905297,MATH 103A,B01,083779,Greenfeld; Be'Eri,7,0,36,29
1657879905297,MATH 103A,B02,083780,Greenfeld; Be'Eri,4,0,36,32
1657879905297,MATH 103A,B03,093562,Greenfeld; Be'Eri,3,0,36,33
1657879911326,MATH 105,A01,085443,Carter; Anne Toulson,15,0,35,20
1657879911326,MATH 105,A02,093477,Carter; Anne Toulson,20,0,35,15
1657879917351,MATH 109,A01,083213,Ganzberger; Geoffrey Michael,3,0,34,31
1657879917351,MATH 109,A02,083214,Ganzberger; Geoffrey Michael,4,0,34,30
1657879917351,MATH 109,A03,093478,Ganzberger; Geoffrey Michael,2,0,34,32
1657879917351,MATH 109,B01,083215,Ganzberger; Geoffrey Michael,1,0,32,31
1657879917351,MATH 109,B02,083216,Ganzberger; Geoffrey Michael,2,0,32,30
1657879917351,MATH 109,B03,093479,Ganzberger; Geoffrey Michael,8,0,32,24
1657879923376,MATH 142A,A01,083219,Chow; Bennett,7,0,32,25
1657879923376,MATH 142A,A02,083220,Chow; Bennett,10,0,32,22
1657879923376,MATH 142A,A03,093480,Chow; Bennett,9,0,32,23
1657879923376,MATH 142A,B03,093481,Chow; Bennett,8,0,32,24
1657879923376,MATH 142A,B04,093558,Chow; Bennett,13,0,32,19
1657879923376,MATH 142A,B05,093559,Chow; Bennett,7,0,32,25
1657879929399,MATH 193A,A01,083224,Rotar; Vladimir,8,0,34,26
1657879929399,MATH 193A,A02,083225,Rotar; Vladimir,10,0,34,24
1657879929399,MATH 193A,A03,083781,Rotar; Vladimir,5,0,34,29
1657879929399,MATH 193A,A04,083782,Rotar; Vladimir,11,0,34,23
1657879929399,MATH 193A,A05,093482,Rotar; Vladimir,10,0,34,24
1657879935440,MATH 197,001,091859,McAuley; Julian John,9999,0,9999,0
1657879935440,MATH 197,002,095566,Kedlaya; Kiran S.,9997,0,9999,2
1657879935440,MATH 197,003,095567,Xiao; Ming,9999,0,9999,0
1657879935440,MATH 197,004,095571,Perols; Johan Lars,9998,0,9999,1
1657879942495,COGS 9,A01,083615,Shannon; Kyle Michael,10,0,75,65
1657879948519,COGS 11,A01,083617,Boyle; Mary E. T.,23,0,48,25
1657879954544,COGS 13,A01,083071,Bastos; Amalia Pinkusfeld,11,0,71,60
1657879960573,COGS 14A,A01,092681,Semenuks; Arturs,5,1,100,95
1657879966600,COGS 14B,A01,083073,Cheng; Tzu-Han,6,0,63,57
1657879972624,COGS 17,A01,092677,Semenuks; Arturs,6,0,81,75
1657879978650,COGS 100,A01,083619,Allen; Michael Gordon,17,0,70,53
1657879984674,COGS 101A,A01,083621,Davis; Joshua Daniel,9,0,68,59
1657879990702,COGS 101B,A01,091572,Allen; Michael Gordon,13,0,65,52
1657879996728,COGS 101C,A01,083625,Delgado; Tania,17,0,35,18
1657880002751,COGS 107A,A01,083627,Boyle; Mary E. T.,14,0,60,46
1657880008773,COGS 118A,A01,083075,Gupta; Anjum,21,0,76,55
1657880014802,CSE 3,A50,083646,Miranda; Gregory Joseph,24,0,50,26
1657880020825,CSE 8A,A50,083650,Miranda; Gregory Joseph,17,1,56,39
1657880026851,CSE 11,A01,083080,Cao; Yingjun,6,15,40,34
1657880032873,CSE 12,A01,083652,Krause-Levy; Sophia Louisa,30,1,120,90
1657880038895,CSE 15L,A01,083654,Morris; Justin Loren,9,0,50,41
1657880038895,CSE 15L,A02,083655,Morris; Justin Loren,10,0,50,40
1657880044918,CSE 20,A01,083657,Tran; Khoa Dang,39,0,80,41
1657880050942,CSE 21,A01,095574,Bach; Quang Tran,22,0,48,26
1657880056970,CSE 30,A01,083084,Eldon; John,6,0,80,74
1657880056970,CSE 30,B01,095061,Bhaskar; Nishant,9,0,50,41
1657880062993,CSE 100,A01,083659,Cao; Yingjun,5,4,70,65
1657880069019,CSE 134B,A01,083661,Powell; Thomas Allan,24,0,100,76
1657880075046,CSE 140,A01,083663,Gungor; Onat,15,0,85,70
1657880081069,CSE 140L,A01,083088,Eldon; John,23,0,100,77
1657880087093,CSE 175,A01,083665,Kumar; Rakesh,3,0,25,22
1657880093115,CSE 190,A00,092507,Dubnov; Shlomo,8,0,20,12
1657880099137,ECE 45,A01,083139,Congero; Spencer William,6,0,75,69
1657880105161,ECE 65,A50,083695,Saad; Andrew S,12,0,30,18
1657880105161,ECE 65,A51,095125,Saad; Andrew S,24,0,26,2
1657880111190,ECE 109,A01,091882,Touri; Behrouz,20,0,70,50
1657880117213,ECE 180,A00,083140,Abi Samra; Nicholas Camill,1,0,30,29
1657880117213,ECE 180,B00,083141,Abi Samra; Nicholas Camill,0,0,30,30
1657880123238,MATH 10A,A01,083735,Patchell; Gregory David,2,0,30,28
1657880123238,MATH 10A,A02,083736,Patchell; Gregory David,20,0,30,10
1657880123238,MATH 10A,A03,083737,Patchell; Gregory David,16,0,30,14
1657880129262,MATH 10B,A01,083207,Lim; Seonhee,8,0,34,26
1657880129262,MATH 10B,A02,083208,Lim; Seonhee,10,0,35,25
1657880129262,MATH 10B,A03,093472,Lim; Seonhee,7,0,34,27
1657880129262,MATH 10B,B01,083739,Sinha; Shubham,14,0,30,16
1657880135294,MATH 18,A01,083743,Cinel; Cameron Alexander,9,0,30,21
1657880135294,MATH 18,A02,083744,Cinel; Cameron Alexander,18,0,30,12
1657880135294,MATH 18,A03,083745,Cinel; Cameron Alexander,10,0,30,20
1657880135294,MATH 18,B01,083748,Rideout; David Porter,5,0,37,32
1657880135294,MATH 18,B02,083749,Rideout; David Porter,5,0,36,31
1657880135294,MATH 18,B03,083750,Rideout; David Porter,3,0,37,34
1657880135294,MATH 18,B04,083751,Rideout; David Porter,6,0,36,30
1657880135294,MATH 18,B05,093473,Rideout; David Porter,6,0,36,30
1657880135294,MATH 18,B06,093474,Rideout; David Porter,6,0,36,30
1657880141321,MATH 20A,A01,083754,Zheng; Zequn,14,0,40,26
1657880147349,MATH 20B,A01,083756,Briones; Jor-el Thomas Caparas,4,0,36,32
1657880147349,MATH 20B,A02,083757,Briones; Jor-el Thomas Caparas,1,0,36,35
1657880147349,MATH 20B,A03,093475,Briones; Jor-el Thomas Caparas,2,0,36,34
1657880153374,MATH 20C,A01,083760,Briones; Jor-el Thomas Caparas,1,0,35,34
1657880153374,MATH 20C,A02,083761,Briones; Jor-el Thomas Caparas,8,0,35,27
1657880153374,MATH 20C,A03,093476,Briones; Jor-el Thomas Caparas,0,1,36,36
1657880153374,MATH 20C,B01,083762,Bach; Quang Tran,1,0,30,29
1657880159402,MATH 20D,A01,083765,Tran; Brian Kha,5,0,30,25
1657880159402,MATH 20D,A02,083766,Tran; Brian Kha,5,0,30,25
1657880159402,MATH 20D,A03,083767,Tran; Brian Kha,5,0,30,25
1657880165432,MATH 20E,A01,083771,Ganguly; Soumya,10,0,32,22
1657880165432,MATH 20E,A02,083772,Ganguly; Soumya,6,0,32,26
1657880165432,MATH 20E,B01,083773,Ciotti; Benjamin,20,0,35,15
1657880165432,MATH 20E,B02,083774,Ciotti; Benjamin,18,0,35,17
1657880171462,MATH 103A,A01,083777,Greenfeld; Be'Eri,3,0,36,33
1657880171462,MATH 103A,A02,083778,Greenfeld; Be'Eri,5,0,36,31
1657880171462,MATH 103A,A03,093561,Greenfeld; Be'Eri,6,0,36,30
1657880171462,MATH 103A,B01,083779,Greenfeld; Be'Eri,7,0,36,29
1657880171462,MATH 103A,B02,083780,Greenfeld; Be'Eri,4,0,36,32
1657880171462,MATH 103A,B03,093562,Greenfeld; Be'Eri,3,0,36,33
1657880177486,MATH 105,A01,085443,Carter; Anne Toulson,15,0,35,20
1657880177486,MATH 105,A02,093477,Carter; Anne Toulson,20,0,35,15
1657880183510,MATH 109,A01,083213,Ganzberger; Geoffrey Michael,3,0,34,31
1657880183510,MATH 109,A02,083214,Ganzberger; Geoffrey Michael,4,0,34,30
1657880183510,MATH 109,A03,093478,Ganzberger; Geoffrey Michael,2,0,34,32
1657880183510,MATH 109,B01,083215,Ganzberger; Geoffrey Michael,1,0,32,31
1657880183510,MATH 109,B02,083216,Ganzberger; Geoffrey Michael,2,0,32,30
1657880183510,MATH 109,B03,093479,Ganzberger; Geoffrey Michael,8,0,32,24
1657880189538,MATH 142A,A01,083219,Chow; Bennett,7,0,32,25
1657880189538,MATH 142A,A02,083220,Chow; Bennett,10,0,32,22
1657880189538,MATH 142A,A03,093480,Chow; Bennett,9,0,32,23
1657880189538,MATH 142A,B03,093481,Chow; Bennett,8,0,32,24
1657880189538,MATH 142A,B04,093558,Chow; Bennett,13,0,32,19
1657880189538,MATH 142A,B05,093559,Chow; Bennett,7,0,32,25
1657880195562,MATH 193A,A01,083224,Rotar; Vladimir,8,0,34,26
1657880195562,MATH 193A,A02,083225,Rotar; Vladimir,10,0,34,24
1657880195562,MATH 193A,A03,083781,Rotar; Vladimir,5,0,34,29
1657880195562,MATH 193A,A04,083782,Rotar; Vladimir,11,0,34,23
1657880195562,MATH 193A,A05,093482,Rotar; Vladimir,10,0,34,24
1657880201585,MATH 197,001,091859,McAuley; Julian John,9999,0,9999,0
1657880201585,MATH 197,002,095566,Kedlaya; Kiran S.,9997,0,9999,2
1657880201585,MATH 197,003,095567,Xiao; Ming,9999,0,9999,0
1657880201585,MATH 197,004,095571,Perols; Johan Lars,9998,0,9999,1
1657880208638,COGS 9,A01,083615,Shannon; Kyle Michael,10,0,75,65
1657880214666,COGS 11,A01,083617,Boyle; Mary E. T.,23,0,48,25
1657880220694,COGS 13,A01,083071,Bastos; Amalia Pinkusfeld,11,0,71,60
1657880226717,COGS 14A,A01,092681,Semenuks; Arturs,5,1,100,95
1657880232742,COGS 14B,A01,083073,Cheng; Tzu-Han,6,0,63,57
1657880238767,COGS 17,A01,092677,Semenuks; Arturs,6,0,81,75
1657880244791,COGS 100,A01,083619,Allen; Michael Gordon,17,0,70,53
1657880250815,COGS 101A,A01,083621,Davis; Joshua Daniel,9,0,68,59
1657880256838,COGS 101B,A01,091572,Allen; Michael Gordon,13,0,65,52
1657880262861,COGS 101C,A01,083625,Delgado; Tania,17,0,35,18
1657880268887,COGS 107A,A01,083627,Boyle; Mary E. T.,14,0,60,46
1657880274912,COGS 118A,A01,083075,Gupta; Anjum,21,0,76,55
1657880280935,CSE 3,A50,083646,Miranda; Gregory Joseph,24,0,50,26
1657880286958,CSE 8A,A50,083650,Miranda; Gregory Joseph,17,1,56,39
1657880292982,CSE 11,A01,083080,Cao; Yingjun,6,15,40,34
1657880299011,CSE 12,A01,083652,Krause-Levy; Sophia Louisa,30,1,120,90
1657880305036,CSE 15L,A01,083654,Morris; Justin Loren,9,0,50,41
1657880305036,CSE 15L,A02,083655,Morris; Justin Loren,10,0,50,40
1657880311058,CSE 20,A01,083657,Tran; Khoa Dang,39,0,80,41
1657880317158,CSE 21,A01,095574,Bach; Quang Tran,22,0,48,26
1657880323185,CSE 30,A01,083084,Eldon; John,6,0,80,74
1657880323185,CSE 30,B01,095061,Bhaskar; Nishant,9,0,50,41
1657880329211,CSE 100,A01,083659,Cao; Yingjun,5,4,70,65
1657880335238,CSE 134B,A01,083661,Powell; Thomas Allan,24,0,100,76
1657880341261,CSE 140,A01,083663,Gungor; Onat,15,0,85,70
1657880347284,CSE 140L,A01,083088,Eldon; John,23,0,100,77
1657880353309,CSE 175,A01,083665,Kumar; Rakesh,3,0,25,22
1657880359332,CSE 190,A00,092507,Dubnov; Shlomo,8,0,20,12
1657880365357,ECE 45,A01,083139,Congero; Spencer William,6,0,75,69
1657880371385,ECE 65,A50,083695,Saad; Andrew S,12,0,30,18
1657880371385,ECE 65,A51,095125,Saad; Andrew S,24,0,26,2
1657880377408,ECE 109,A01,091882,Touri; Behrouz,20,0,70,50
1657880383434,ECE 180,A00,083140,Abi Samra; Nicholas Camill,1,0,30,29
1657880383434,ECE 180,B00,083141,Abi Samra; Nicholas Camill,0,0,30,30
1657880389459,MATH 10A,A01,083735,Patchell; Gregory David,2,0,30,28
1657880389459,MATH 10A,A02,083736,Patchell; Gregory David,20,0,30,10
1657880389459,MATH 10A,A03,083737,Patchell; Gregory David,16,0,30,14
1657880395488,MATH 10B,A01,083207,Lim; Seonhee,8,0,34,26
1657880395488,MATH 10B,A02,083208,Lim; Seonhee,10,0,35,25
1657880395488,MATH 10B,A03,093472,Lim; Seonhee,7,0,34,27
1657880395488,MATH 10B,B01,083739,Sinha; Shubham,14,0,30,16
1657880401513,MATH 18,A01,083743,Cinel; Cameron Alexander,9,0,30,21
1657880401513,MATH 18,A02,083744,Cinel; Cameron Alexander,18,0,30,12
1657880401513,MATH 18,A03,083745,Cinel; Cameron Alexander,10,0,30,20
1657880401513,MATH 18,B01,083748,Rideout; David Porter,5,0,37,32
1657880401513,MATH 18,B02,083749,Rideout; David Porter,5,0,36,31
1657880401513,MATH 18,B03,083750,Rideout; David Porter,3,0,37,34
1657880401513,MATH 18,B04,083751,Rideout; David Porter,6,0,36,30
1657880401513,MATH 18,B05,093473,Rideout; David Porter,6,0,36,30
1657880401513,MATH 18,B06,093474,Rideout; David Porter,6,0,36,30
1657880407541,MATH 20A,A01,083754,Zheng; Zequn,14,0,40,26
1657880413568,MATH 20B,A01,083756,Briones; Jor-el Thomas Caparas,4,0,36,32
1657880413568,MATH 20B,A02,083757,Briones; Jor-el Thomas Caparas,1,0,36,35
1657880413568,MATH 20B,A03,093475,Briones; Jor-el Thomas Caparas,2,0,36,34
1657880419593,MATH 20C,A01,083760,Briones; Jor-el Thomas Caparas,1,0,35,34
1657880419593,MATH 20C,A02,083761,Briones; Jor-el Thomas Caparas,8,0,35,27
1657880419593,MATH 20C,A03,093476,Briones; Jor-el Thomas Caparas,0,1,36,36
1657880419593,MATH 20C,B01,083762,Bach; Quang Tran,1,0,30,29
1657880425624,MATH 20D,A01,083765,Tran; Brian Kha,5,0,30,25
1657880425624,MATH 20D,A02,083766,Tran; Brian Kha,5,0,30,25
1657880425624,MATH 20D,A03,083767,Tran; Brian Kha,5,0,30,25
1657880431654,MATH 20E,A01,083771,Ganguly; Soumya,10,0,32,22
1657880431654,MATH 20E,A02,083772,Ganguly; Soumya,6,0,32,26
1657880431654,MATH 20E,B01,083773,Ciotti; Benjamin,20,0,35,15
1657880431654,MATH 20E,B02,083774,Ciotti; Benjamin,18,0,35,17
1657880437684,MATH 103A,A01,083777,Greenfeld; Be'Eri,3,0,36,33
1657880437684,MATH 103A,A02,083778,Greenfeld; Be'Eri,5,0,36,31
1657880437684,MATH 103A,A03,093561,Greenfeld; Be'Eri,6,0,36,30
1657880437684,MATH 103A,B01,083779,Greenfeld; Be'Eri,7,0,36,29
1657880437684,MATH 103A,B02,083780,Greenfeld; Be'Eri,4,0,36,32
1657880437684,MATH 103A,B03,093562,Greenfeld; Be'Eri,3,0,36,33
1657880443707,MATH 105,A01,085443,Carter; Anne Toulson,15,0,35,20
1657880443707,MATH 105,A02,093477,Carter; Anne Toulson,20,0,35,15
1657880449729,MATH 109,A01,083213,Ganzberger; Geoffrey Michael,3,0,34,31
1657880449729,MATH 109,A02,083214,Ganzberger; Geoffrey Michael,4,0,34,30
1657880449729,MATH 109,A03,093478,Ganzberger; Geoffrey Michael,2,0,34,32
1657880449729,MATH 109,B01,083215,Ganzberger; Geoffrey Michael,1,0,32,31
1657880449729,MATH 109,B02,083216,Ganzberger; Geoffrey Michael,2,0,32,30
1657880449729,MATH 109,B03,093479,Ganzberger; Geoffrey Michael,8,0,32,24
1657880455761,MATH 142A,A01,083219,Chow; Bennett,7,0,32,25
1657880455761,MATH 142A,A02,083220,Chow; Bennett,10,0,32,22
1657880455761,MATH 142A,A03,093480,Chow; Bennett,9,0,32,23
1657880455761,MATH 142A,B03,093481,Chow; Bennett,8,0,32,24
1657880455761,MATH 142A,B04,093558,Chow; Bennett,13,0,32,19
1657880455761,MATH 142A,B05,093559,Chow; Bennett,7,0,32,25
1657880461784,MATH 193A,A01,083224,Rotar; Vladimir,8,0,34,26
1657880461784,MATH 193A,A02,083225,Rotar; Vladimir,10,0,34,24
1657880461784,MATH 193A,A03,083781,Rotar; Vladimir,5,0,34,29
1657880461784,MATH 193A,A04,083782,Rotar; Vladimir,11,0,34,23
1657880461784,MATH 193A,A05,093482,Rotar; Vladimir,10,0,34,24
1657880467806,MATH 197,001,091859,McAuley; Julian John,9999,0,9999,0
1657880467806,MATH 197,002,095566,Kedlaya; Kiran S.,9997,0,9999,2
1657880467806,MATH 197,003,095567,Xiao; Ming,9999,0,9999,0
1657880467806,MATH 197,004,095571,Perols; Johan Lars,9998,0,9999,1
1657880474867,COGS 9,A01,083615,Shannon; Kyle Michael,10,0,75,65
1657880480892,COGS 11,A01,083617,Boyle; Mary E. T.,23,0,48,25
1657880486917,COGS 13,A01,083071,Bastos; Amalia Pinkusfeld,11,0,71,60
1657880492941,COGS 14A,A01,092681,Semenuks; Arturs,5,1,100,95
1657880498965,COGS 14B,A01,083073,Cheng; Tzu-Han,6,0,63,57
1657880504988,COGS 17,A01,092677,Semenuks; Arturs,6,0,81,75
1657880511013,COGS 100,A01,083619,Allen; Michael Gordon,17,0,70,53
1657880517054,COGS 101A,A01,083621,Davis; Joshua Daniel,9,0,68,59
1657880523084,COGS 101B,A01,091572,Allen; Michael Gordon,13,0,65,52
1657880529108,COGS 101C,A01,083625,Delgado; Tania,17,0,35,18
1657880535136,COGS 107A,A01,083627,Boyle; Mary E. T.,14,0,60,46
1657880541163,COGS 118A,A01,083075,Gupta; Anjum,21,0,76,55
1657880547188,CSE 3,A50,083646,Miranda; Gregory Joseph,24,0,50,26
1657880553217,CSE 8A,A50,083650,Miranda; Gregory Joseph,17,1,56,39
1657880559242,CSE 11,A01,083080,Cao; Yingjun,6,15,40,34
1657880565269,CSE 12,A01,083652,Krause-Levy; Sophia Louisa,30,1,120,90
1657880571294,CSE 15L,A01,083654,Morris; Justin Loren,9,0,50,41
1657880571294,CSE 15L,A02,083655,Morris; Justin Loren,10,0,50,40
1657880577318,CSE 20,A01,083657,Tran; Khoa Dang,39,0,80,41
1657880583347,CSE 21,A01,095574,Bach; Quang Tran,22,0,48,26
1657880589375,CSE 30,A01,083084,Eldon; John,6,0,80,74
1657880589375,CSE 30,B01,095061,Bhaskar; Nishant,9,0,50,41
1657880595398,CSE 100,A01,083659,Cao; Yingjun,5,4,70,65
1657880601426,CSE 134B,A01,083661,Powell; Thomas Allan,24,0,100,76
1657880607451,CSE 140,A01,083663,Gungor; Onat,15,0,85,70
1657880613477,CSE 140L,A01,083088,Eldon; John,23,0,100,77
1657880619500,CSE 175,A01,083665,Kumar; Rakesh,3,0,25,22
1657880625523,CSE 190,A00,092507,Dubnov; Shlomo,8,0,20,12
1657880631547,ECE 45,A01,083139,Congero; Spencer William,6,0,75,69
1657880637575,ECE 65,A50,083695,Saad; Andrew S,12,0,30,18
1657880637575,ECE 65,A51,095125,Saad; Andrew S,24,0,26,2
1657880643603,ECE 109,A01,091882,Touri; Behrouz,20,0,70,50
1657880649630,ECE 180,A00,083140,Abi Samra; Nicholas Camill,1,0,30,29
1657880649630,ECE 180,B00,083141,Abi Samra; Nicholas Camill,0,0,30,30
1657880655653,MATH 10A,A01,083735,Patchell; Gregory David,2,0,30,28
1657880655653,MATH 10A,A02,083736,Patchell; Gregory David,20,0,30,10
1657880655653,MATH 10A,A03,083737,Patchell; Gregory David,16,0,30,14
1657880661682,MATH 10B,A01,083207,Lim; Seonhee,8,0,34,26
1657880661682,MATH 10B,A02,083208,Lim; Seonhee,10,0,35,25
1657880661682,MATH 10B,A03,093472,Lim; Seonhee,7,0,34,27
1657880661682,MATH 10B,B01,083739,Sinha; Shubham,14,0,30,16
1657880667714,MATH 18,A01,083743,Cinel; Cameron Alexander,9,0,30,21
1657880667714,MATH 18,A02,083744,Cinel; Cameron Alexander,18,0,30,12
1657880667714,MATH 18,A03,083745,Cinel; Cameron Alexander,10,0,30,20
1657880667714,MATH 18,B01,083748,Rideout; David Porter,5,0,37,32
1657880667714,MATH 18,B02,083749,Rideout; David Porter,5,0,36,31
1657880667714,MATH 18,B03,083750,Rideout; David Porter,3,0,37,34
1657880667714,MATH 18,B04,083751,Rideout; David Porter,6,0,36,30
1657880667714,MATH 18,B05,093473,Rideout; David Porter,6,0,36,30
1657880667714,MATH 18,B06,093474,Rideout; David Porter,6,0,36,30
1657880673738,MATH 20A,A01,083754,Zheng; Zequn,14,0,40,26
1657880679766,MATH 20B,A01,083756,Briones; Jor-el Thomas Caparas,4,0,36,32
1657880679766,MATH 20B,A02,083757,Briones; Jor-el Thomas Caparas,1,0,36,35
1657880679766,MATH 20B,A03,093475,Briones; Jor-el Thomas Caparas,2,0,36,34
1657880685796,MATH 20C,A01,083760,Briones; Jor-el Thomas Caparas,1,0,35,34
1657880685796,MATH 20C,A02,083761,Briones; Jor-el Thomas Caparas,8,0,35,27
1657880685796,MATH 20C,A03,093476,Briones; Jor-el Thomas Caparas,0,1,36,36
1657880685796,MATH 20C,B01,083762,Bach; Quang Tran,1,0,30,29
1657880691819,MATH 20D,A01,083765,Tran; Brian Kha,5,0,30,25
1657880691819,MATH 20D,A02,083766,Tran; Brian Kha,5,0,30,25
1657880691819,MATH 20D,A03,083767,Tran; Brian Kha,5,0,30,25
1657880697849,MATH 20E,A01,083771,Ganguly; Soumya,10,0,32,22
1657880697849,MATH 20E,A02,083772,Ganguly; Soumya,6,0,32,26
1657880697849,MATH 20E,B01,083773,Ciotti; Benjamin,20,0,35,15
1657880697849,MATH 20E,B02,083774,Ciotti; Benjamin,18,0,35,17
1657880703878,MATH 103A,A01,083777,Greenfeld; Be'Eri,3,0,36,33
1657880703878,MATH 103A,A02,083778,Greenfeld; Be'Eri,5,0,36,31
1657880703878,MATH 103A,A03,093561,Greenfeld; Be'Eri,6,0,36,30
1657880703878,MATH 103A,B01,083779,Greenfeld; Be'Eri,7,0,36,29
1657880703878,MATH 103A,B02,083780,Greenfeld; Be'Eri,4,0,36,32
1657880703878,MATH 103A,B03,093562,Greenfeld; Be'Eri,3,0,36,33
1657880709904,MATH 105,A01,085443,Carter; Anne Toulson,15,0,35,20
1657880709904,MATH 105,A02,093477,Carter; Anne Toulson,20,0,35,15
1657880715928,MATH 109,A01,083213,Ganzberger; Geoffrey Michael,3,0,34,31
1657880715928,MATH 109,A02,083214,Ganzberger; Geoffrey Michael,4,0,34,30
1657880715928,MATH 109,A03,093478,Ganzberger; Geoffrey Michael,2,0,34,32
1657880715928,MATH 109,B01,083215,Ganzberger; Geoffrey Michael,1,0,32,31
1657880715928,MATH 109,B02,083216,Ganzberger; Geoffrey Michael,2,0,32,30
1657880715928,MATH 109,B03,093479,Ganzberger; Geoffrey Michael,8,0,32,24
1657880721958,MATH 142A,A01,083219,Chow; Bennett,7,0,32,25
1657880721958,MATH 142A,A02,083220,Chow; Bennett,10,0,32,22
1657880721958,MATH 142A,A03,093480,Chow; Bennett,9,0,32,23
1657880721958,MATH 142A,B03,093481,Chow; Bennett,8,0,32,24
1657880721958,MATH 142A,B04,093558,Chow; Bennett,13,0,32,19
1657880721958,MATH 142A,B05,093559,Chow; Bennett,7,0,32,25
1657880727981,MATH 193A,A01,083224,Rotar; Vladimir,8,0,34,26
1657880727981,MATH 193A,A02,083225,Rotar; Vladimir,10,0,34,24
1657880727981,MATH 193A,A03,083781,Rotar; Vladimir,5,0,34,29
1657880727981,MATH 193A,A04,083782,Rotar; Vladimir,11,0,34,23
1657880727981,MATH 193A,A05,093482,Rotar; Vladimir,10,0,34,24
1657880734005,MATH 197,001,091859,McAuley; Julian John,9999,0,9999,0
1657880734005,MATH 197,002,095566,Kedlaya; Kiran S.,9997,0,9999,2
1657880734005,MATH 197,003,095567,Xiao; Ming,9999,0,9999,0
1657880734005,MATH 197,004,095571,Perols; Johan Lars,9998,0,9999,1
1657880741063,COGS 9,A01,083615,Shannon; Kyle Michael,10,0,75,65
1657880747089,COGS 11,A01,083617,Boyle; Mary E. T.,23,0,48,25
1657880753114,COGS 13,A01,083071,Bastos; Amalia Pinkusfeld,11,0,71,60
1657880759135,COGS 14A,A01,092681,Semenuks; Arturs,5,1,100,95
1657880765164,COGS 14B,A01,083073,Cheng; Tzu-Han,6,0,63,57
1657880771186,COGS 17,A01,092677,Semenuks; Arturs,6,0,81,75
1657880777209,COGS 100,A01,083619,Allen; Michael Gordon,17,0,70,53
1657880783232,COGS 101A,A01,083621,Davis; Joshua Daniel,9,0,68,59
1657880789256,COGS 101B,A01,091572,Allen; Michael Gordon,13,0,65,52
1657880795278,COGS 101C,A01,083625,Delgado; Tania,17,0,35,18
1657880801306,COGS 107A,A01,083627,Boyle; Mary E. T.,14,0,60,46
1657880807334,COGS 118A,A01,083075,Gupta; Anjum,21,0,76,55
1657880813358,CSE 3,A50,083646,Miranda; Gregory Joseph,24,0,50,26
1657880819385,CSE 8A,A50,083650,Miranda; Gregory Joseph,17,1,56,39
1657880825412,CSE 11,A01,083080,Cao; Yingjun,6,15,40,34
1657880831438,CSE 12,A01,083652,Krause-Levy; Sophia Louisa,30,1,120,90
1657880837459,CSE 15L,A01,083654,Morris; Justin Loren,9,0,50,41
1657880837459,CSE 15L,A02,083655,Morris; Justin Loren,10,0,50,40
1657880843483,CSE 20,A01,083657,Tran; Khoa Dang,39,0,80,41
1657880849508,CSE 21,A01,095574,Bach; Quang Tran,22,0,48,26
1657880855532,CSE 30,A01,083084,Eldon; John,6,0,80,74
1657880855532,CSE 30,B01,095061,Bhaskar; Nishant,9,0,50,41
1657880861559,CSE 100,A01,083659,Cao; Yingjun,5,4,70,65
1657880867581,CSE 134B,A01,083661,Powell; Thomas Allan,24,0,100,76
1657880873609,CSE 140,A01,083663,Gungor; Onat,15,0,85,70
1657880879635,CSE 140L,A01,083088,Eldon; John,23,0,100,77
1657880885658,CSE 175,A01,083665,Kumar; Rakesh,3,0,25,22
1657880891682,CSE 190,A00,092507,Dubnov; Shlomo,8,0,20,12
1657880897709,ECE 45,A01,083139,Congero; Spencer William,6,0,75,69
1657880903731,ECE 65,A50,083695,Saad; Andrew S,12,0,30,18
1657880903731,ECE 65,A51,095125,Saad; Andrew S,24,0,26,2
1657880909754,ECE 109,A01,091882,Touri; Behrouz,20,0,70,50
1657880915869,ECE 180,A00,083140,Abi Samra; Nicholas Camill,1,0,30,29
1657880915869,ECE 180,B00,083141,Abi Samra; Nicholas Camill,0,0,30,30
1657880921893,MATH 10A,A01,083735,Patchell; Gregory David,2,0,30,28
1657880921893,MATH 10A,A02,083736,Patchell; Gregory David,20,0,30,10
1657880921893,MATH 10A,A03,083737,Patchell; Gregory David,16,0,30,14
1657880927916,MATH 10B,A01,083207,Lim; Seonhee,8,0,34,26
1657880927916,MATH 10B,A02,083208,Lim; Seonhee,10,0,35,25
1657880927916,MATH 10B,A03,093472,Lim; Seonhee,7,0,34,27
1657880927916,MATH 10B,B01,083739,Sinha; Shubham,14,0,30,16
1657880933938,MATH 18,A01,083743,Cinel; Cameron Alexander,9,0,30,21
1657880933938,MATH 18,A02,083744,Cinel; Cameron Alexander,18,0,30,12
1657880933938,MATH 18,A03,083745,Cinel; Cameron Alexander,10,0,30,20
1657880933938,MATH 18,B01,083748,Rideout; David Porter,5,0,37,32
1657880933938,MATH 18,B02,083749,Rideout; David Porter,5,0,36,31
1657880933938,MATH 18,B03,083750,Rideout; David Porter,3,0,37,34
1657880933938,MATH 18,B04,083751,Rideout; David Porter,6,0,36,30
1657880933938,MATH 18,B05,093473,Rideout; David Porter,6,0,36,30
1657880933938,MATH 18,B06,093474,Rideout; David Porter,6,0,36,30
1657880939961,MATH 20A,A01,083754,Zheng; Zequn,14,0,40,26
1657880945984,MATH 20B,A01,083756,Briones; Jor-el Thomas Caparas,4,0,36,32
1657880945984,MATH 20B,A02,083757,Briones; Jor-el Thomas Caparas,1,0,36,35
1657880945984,MATH 20B,A03,093475,Briones; Jor-el Thomas Caparas,2,0,36,34
1657880952009,MATH 20C,A01,083760,Briones; Jor-el Thomas Caparas,1,0,35,34
1657880952009,MATH 20C,A02,083761,Briones; Jor-el Thomas Caparas,8,0,35,27
1657880952009,MATH 20C,A03,093476,Briones; Jor-el Thomas Caparas,0,1,36,36
1657880952009,MATH 20C,B01,083762,Bach; Quang Tran,1,0,30,29
1657880958033,MATH 20D,A01,083765,Tran; Brian Kha,5,0,30,25
1657880958033,MATH 20D,A02,083766,Tran; Brian Kha,5,0,30,25
1657880958033,MATH 20D,A03,083767,Tran; Brian Kha,5,0,30,25
1657880964058,MATH 20E,A01,083771,Ganguly; Soumya,10,0,32,22
1657880964058,MATH 20E,A02,083772,Ganguly; Soumya,6,0,32,26
1657880964058,MATH 20E,B01,083773,Ciotti; Benjamin,20,0,35,15
1657880964058,MATH 20E,B02,083774,Ciotti; Benjamin,18,0,35,17
1657880970090,MATH 103A,A01,083777,Greenfeld; Be'Eri,3,0,36,33
1657880970090,MATH 103A,A02,083778,Greenfeld; Be'Eri,5,0,36,31
1657880970090,MATH 103A,A03,093561,Greenfeld; Be'Eri,6,0,36,30
1657880970090,MATH 103A,B01,083779,Greenfeld; Be'Eri,7,0,36,29
1657880970090,MATH 103A,B02,083780,Greenfeld; Be'Eri,4,0,36,32
1657880970090,MATH 103A,B03,093562,Greenfeld; Be'Eri,3,0,36,33
1657880976114,MATH 105,A01,085443,Carter; Anne Toulson,15,0,35,20
1657880976114,MATH 105,A02,093477,Carter; Anne Toulson,20,0,35,15
1657880982140,MATH 109,A01,083213,Ganzberger; Geoffrey Michael,3,0,34,31
1657880982140,MATH 109,A02,083214,Ganzberger; Geoffrey Michael,4,0,34,30
1657880982140,MATH 109,A03,093478,Ganzberger; Geoffrey Michael,2,0,34,32
1657880982140,MATH 109,B01,083215,Ganzberger; Geoffrey Michael,1,0,32,31
1657880982140,MATH 109,B02,083216,Ganzberger; Geoffrey Michael,2,0,32,30
1657880982140,MATH 109,B03,093479,Ganzberger; Geoffrey Michael,8,0,32,24
1657880988183,MATH 142A,A01,083219,Chow; Bennett,7,0,32,25
1657880988183,MATH 142A,A02,083220,Chow; Bennett,10,0,32,22
1657880988183,MATH 142A,A03,093480,Chow; Bennett,9,0,32,23
1657880988183,MATH 142A,B03,093481,Chow; Bennett,8,0,32,24
1657880988183,MATH 142A,B04,093558,Chow; Bennett,13,0,32,19
1657880988183,MATH 142A,B05,093559,Chow; Bennett,7,0,32,25
1657880994213,MATH 193A,A01,083224,Rotar; Vladimir,8,0,34,26
1657880994213,MATH 193A,A02,083225,Rotar; Vladimir,10,0,34,24
1657880994213,MATH 193A,A03,083781,Rotar; Vladimir,5,0,34,29
1657880994213,MATH 193A,A04,083782,Rotar; Vladimir,11,0,34,23
1657880994213,MATH 193A,A05,093482,Rotar; Vladimir,10,0,34,24
1657881000243,MATH 197,001,091859,McAuley; Julian John,9999,0,9999,0
1657881000243,MATH 197,002,095566,Kedlaya; Kiran S.,9997,0,9999,2
1657881000243,MATH 197,003,095567,Xiao; Ming,9999,0,9999,0
1657881000243,MATH 197,004,095571,Perols; Johan Lars,9998,0,9999,1
1657881007295,COGS 9,A01,083615,Shannon; Kyle Michael,10,0,75,65
1657881013322,COGS 11,A01,083617,Boyle; Mary E. T.,23,0,48,25
1657881019348,COGS 13,A01,083071,Bastos; Amalia Pinkusfeld,11,0,71,60
1657881025375,COGS 14A,A01,092681,Semenuks; Arturs,5,1,100,95
1657881031400,COGS 14B,A01,083073,Cheng; Tzu-Han,6,0,63,57
1657881037428,COGS 17,A01,092677,Semenuks; Arturs,6,0,81,75
1657881043450,COGS 100,A01,083619,Allen; Michael Gordon,17,0,70,53
1657881049474,COGS 101A,A01,083621,Davis; Joshua Daniel,9,0,68,59
1657881055499,COGS 101B,A01,091572,Allen; Michael Gordon,13,0,65,52
1657881061523,COGS 101C,A01,083625,Delgado; Tania,17,0,35,18
1657881067546,COGS 107A,A01,083627,Boyle; Mary E. T.,14,0,60,46
1657881073570,COGS 118A,A01,083075,Gupta; Anjum,21,0,76,55
1657881079593,CSE 3,A50,083646,Miranda; Gregory Joseph,24,0,50,26
1657881085615,CSE 8A,A50,083650,Miranda; Gregory Joseph,17,1,56,39
1657881091639,CSE 11,A01,083080,Cao; Yingjun,6,15,40,34
1657881097661,CSE 12,A01,083652,Krause-Levy; Sophia Louisa,30,1,120,90
1657881103686,CSE 15L,A01,083654,Morris; Justin Loren,9,0,50,41
1657881103686,CSE 15L,A02,083655,Morris; Justin Loren,10,0,50,40
1657881109708,CSE 20,A01,083657,Tran; Khoa Dang,39,0,80,41
1657881115735,CSE 21,A01,095574,Bach; Quang Tran,22,0,48,26
1657881121757,CSE 30,A01,083084,Eldon; John,6,0,80,74
1657881121757,CSE 30,B01,095061,Bhaskar; Nishant,9,0,50,41
1657881127782,CSE 100,A01,083659,Cao; Yingjun,5,4,70,65
1657881133814,CSE 134B,A01,083661,Powell; Thomas Allan,24,0,100,76
1657881139841,CSE 140,A01,083663,Gungor; Onat,15,0,85,70
1657881145865,CSE 140L,A01,083088,Eldon; John,23,0,100,77
1657881151888,CSE 175,A01,083665,Kumar; Rakesh,3,0,25,22
1657881157917,CSE 190,A00,092507,Dubnov; Shlomo,8,0,20,12
1657881163941,ECE 45,A01,083139,Congero; Spencer William,6,0,75,69
1657881169971,ECE 65,A50,083695,Saad; Andrew S,12,0,30,18
1657881169971,ECE 65,A51,095125,Saad; Andrew S,24,0,26,2
1657881176000,ECE 109,A01,091882,Touri; Behrouz,20,0,70,50
1657881182026,ECE 180,A00,083140,Abi Samra; Nicholas Camill,1,0,30,29
1657881182026,ECE 180,B00,083141,Abi Samra; Nicholas Camill,0,0,30,30
1657881188050,MATH 10A,A01,083735,Patchell; Gregory David,2,0,30,28
1657881188050,MATH 10A,A02,083736,Patchell; Gregory David,20,0,30,10
1657881188050,MATH 10A,A03,083737,Patchell; Gregory David,16,0,30,14
1657881194077,MATH 10B,A01,083207,Lim; Seonhee,8,0,34,26
1657881194077,MATH 10B,A02,083208,Lim; Seonhee,10,0,35,25
1657881194077,MATH 10B,A03,093472,Lim; Seonhee,7,0,34,27
1657881194077,MATH 10B,B01,083739,Sinha; Shubham,14,0,30,16
1657881200100,MATH 18,A01,083743,Cinel; Cameron Alexander,9,0,30,21
1657881200100,MATH 18,A02,083744,Cinel; Cameron Alexander,18,0,30,12
1657881200100,MATH 18,A03,083745,Cinel; Cameron Alexander,10,0,30,20
1657881200100,MATH 18,B01,083748,Rideout; David Porter,5,0,37,32
1657881200100,MATH 18,B02,083749,Rideout; David Porter,5,0,36,31
1657881200100,MATH 18,B03,083750,Rideout; David Porter,3,0,37,34
1657881200100,MATH 18,B04,083751,Rideout; David Porter,6,0,36,30
1657881200100,MATH 18,B05,093473,Rideout; David Porter,6,0,36,30
1657881200100,MATH 18,B06,093474,Rideout; David Porter,6,0,36,30
1657881206134,MATH 20A,A01,083754,Zheng; Zequn,14,0,40,26
1657881212160,MATH 20B,A01,083756,Briones; Jor-el Thomas Caparas,4,0,36,32
1657881212160,MATH 20B,A02,083757,Briones; Jor-el Thomas Caparas,1,0,36,35
1657881212160,MATH 20B,A03,093475,Briones; Jor-el Thomas Caparas,2,0,36,34
1657881218190,MATH 20C,A01,083760,Briones; Jor-el Thomas Caparas,1,0,35,34
1657881218190,MATH 20C,A02,083761,Briones; Jor-el Thomas Caparas,8,0,35,27
1657881218190,MATH 20C,A03,093476,Briones; Jor-el Thomas Caparas,0,1,36,36
1657881218190,MATH 20C,B01,083762,Bach; Quang Tran,1,0,30,29
1657881224219,MATH 20D,A01,083765,Tran; Brian Kha,5,0,30,25
1657881224219,MATH 20D,A02,083766,Tran; Brian Kha,5,0,30,25
1657881224219,MATH 20D,A03,083767,Tran; Brian Kha,5,0,30,25
1657881230244,MATH 20E,A01,083771,Ganguly; Soumya,10,0,32,22
1657881230244,MATH 20E,A02,083772,Ganguly; Soumya,6,0,32,26
1657881230244,MATH 20E,B01,083773,Ciotti; Benjamin,20,0,35,15
1657881230244,MATH 20E,B02,083774,Ciotti; Benjamin,18,0,35,17
1657881236268,MATH 103A,A01,083777,Greenfeld; Be'Eri,3,0,36,33
1657881236268,MATH 103A,A02,083778,Greenfeld; Be'Eri,5,0,36,31
1657881236268,MATH 103A,A03,093561,Greenfeld; Be'Eri,6,0,36,30
1657881236268,MATH 103A,B01,083779,Greenfeld; Be'Eri,7,0,36,29
1657881236268,MATH 103A,B02,083780,Greenfeld; Be'Eri,4,0,36,32
1657881236268,MATH 103A,B03,093562,Greenfeld; Be'Eri,3,0,36,33
1657881242291,MATH 105,A01,085443,Carter; Anne Toulson,15,0,35,20
1657881242291,MATH 105,A02,093477,Carter; Anne Toulson,20,0,35,15
1657881248316,MATH 109,A01,083213,Ganzberger; Geoffrey Michael,3,0,34,31
1657881248316,MATH 109,A02,083214,Ganzberger; Geoffrey Michael,4,0,34,30
1657881248316,MATH 109,A03,093478,Ganzberger; Geoffrey Michael,2,0,34,32
1657881248316,MATH 109,B01,083215,Ganzberger; Geoffrey Michael,1,0,32,31
1657881248316,MATH 109,B02,083216,Ganzberger; Geoffrey Michael,2,0,32,30
1657881248316,MATH 109,B03,093479,Ganzberger; Geoffrey Michael,8,0,32,24
1657881254341,MATH 142A,A01,083219,Chow; Bennett,7,0,32,25
1657881254341,MATH 142A,A02,083220,Chow; Bennett,10,0,32,22
1657881254341,MATH 142A,A03,093480,Chow; Bennett,9,0,32,23
1657881254341,MATH 142A,B03,093481,Chow; Bennett,8,0,32,24
1657881254341,MATH 142A,B04,093558,Chow; Bennett,13,0,32,19
1657881254341,MATH 142A,B05,093559,Chow; Bennett,7,0,32,25
1657881260365,MATH 193A,A01,083224,Rotar; Vladimir,8,0,34,26
1657881260365,MATH 193A,A02,083225,Rotar; Vladimir,10,0,34,24
1657881260365,MATH 193A,A03,083781,Rotar; Vladimir,5,0,34,29
1657881260365,MATH 193A,A04,083782,Rotar; Vladimir,11,0,34,23
1657881260365,MATH 193A,A05,093482,Rotar; Vladimir,10,0,34,24
1657881266392,MATH 197,001,091859,McAuley; Julian John,9999,0,9999,0
1657881266392,MATH 197,002,095566,Kedlaya; Kiran S.,9997,0,9999,2
1657881266392,MATH 197,003,095567,Xiao; Ming,9999,0,9999,0
1657881266392,MATH 197,004,095571,Perols; Johan Lars,9998,0,9999,1
1657881273454,COGS 9,A01,083615,Shannon; Kyle Michael,10,0,75,65
1657881279481,COGS 11,A01,083617,Boyle; Mary E. T.,23,0,48,25
1657881285504,COGS 13,A01,083071,Bastos; Amalia Pinkusfeld,11,0,71,60
1657881291527,COGS 14A,A01,092681,Semenuks; Arturs,5,1,100,95
1657881297551,COGS 14B,A01,083073,Cheng; Tzu-Han,6,0,63,57
1657881303575,COGS 17,A01,092677,Semenuks; Arturs,6,0,81,75
1657881309598,COGS 100,A01,083619,Allen; Michael Gordon,17,0,70,53
1657881315620,COGS 101A,A01,083621,Davis; Joshua Daniel,9,0,68,59
1657881321647,COGS 101B,A01,091572,Allen; Michael Gordon,13,0,65,52
1657881327674,COGS 101C,A01,083625,Delgado; Tania,17,0,35,18
1657881333696,COGS 107A,A01,083627,Boyle; Mary E. T.,14,0,60,46
1657881339723,COGS 118A,A01,083075,Gupta; Anjum,21,0,76,55
1657881345748,CSE 3,A50,083646,Miranda; Gregory Joseph,24,0,50,26
1657881351772,CSE 8A,A50,083650,Miranda; Gregory Joseph,17,1,56,39
1657881357795,CSE 11,A01,083080,Cao; Yingjun,6,15,40,34
1657881363822,CSE 12,A01,083652,Krause-Levy; Sophia Louisa,30,1,120,90
1657881369847,CSE 15L,A01,083654,Morris; Justin Loren,9,0,50,41
1657881369847,CSE 15L,A02,083655,Morris; Justin Loren,10,0,50,40
1657881375870,CSE 20,A01,083657,Tran; Khoa Dang,39,0,80,41
1657881381895,CSE 21,A01,095574,Bach; Quang Tran,22,0,48,26
1657881387921,CSE 30,A01,083084,Eldon; John,6,0,80,74
1657881387921,CSE 30,B01,095061,Bhaskar; Nishant,9,0,50,41
1657881393949,CSE 100,A01,083659,Cao; Yingjun,5,4,70,65
1657881399974,CSE 134B,A01,083661,Powell; Thomas Allan,24,0,100,76
1657881406004,CSE 140,A01,083663,Gungor; Onat,15,0,85,70
1657881412031,CSE 140L,A01,083088,Eldon; John,23,0,100,77
1657881418065,CSE 175,A01,083665,Kumar; Rakesh,3,0,25,22
1657881424093,CSE 190,A00,092507,Dubnov; Shlomo,8,0,20,12
1657881430123,ECE 45,A01,083139,Congero; Spencer William,6,0,75,69
1657881436157,ECE 65,A50,083695,Saad; Andrew S,12,0,30,18
1657881436157,ECE 65,A51,095125,Saad; Andrew S,24,0,26,2
1657881442181,ECE 109,A01,091882,Touri; Behrouz,20,0,70,50
1657881448204,ECE 180,A00,083140,Abi Samra; Nicholas Camill,1,0,30,29
1657881448204,ECE 180,B00,083141,Abi Samra; Nicholas Camill,0,0,30,30
1657881454230,MATH 10A,A01,083735,Patchell; Gregory David,2,0,30,28
1657881454230,MATH 10A,A02,083736,Patchell; Gregory David,20,0,30,10
1657881454230,MATH 10A,A03,083737,Patchell; Gregory David,16,0,30,14
1657881460263,MATH 10B,A01,083207,Lim; Seonhee,8,0,34,26
1657881460263,MATH 10B,A02,083208,Lim; Seonhee,10,0,35,25
1657881460263,MATH 10B,A03,093472,Lim; Seonhee,7,0,34,27
1657881460263,MATH 10B,B01,083739,Sinha; Shubham,14,0,30,16
1657881466288,MATH 18,A01,083743,Cinel; Cameron Alexander,9,0,30,21
1657881466288,MATH 18,A02,083744,Cinel; Cameron Alexander,18,0,30,12
1657881466288,MATH 18,A03,083745,Cinel; Cameron Alexander,10,0,30,20
1657881466288,MATH 18,B01,083748,Rideout; David Porter,5,0,37,32
1657881466288,MATH 18,B02,083749,Rideout; David Porter,5,0,36,31
1657881466288,MATH 18,B03,083750,Rideout; David Porter,3,0,37,34
1657881466288,MATH 18,B04,083751,Rideout; David Porter,6,0,36,30
1657881466288,MATH 18,B05,093473,Rideout; David Porter,6,0,36,30
1657881466288,MATH 18,B06,093474,Rideout; David Porter,6,0,36,30
1657881472318,MATH 20A,A01,083754,Zheng; Zequn,14,0,40,26
1657881478347,MATH 20B,A01,083756,Briones; Jor-el Thomas Caparas,4,0,36,32
1657881478347,MATH 20B,A02,083757,Briones; Jor-el Thomas Caparas,1,0,36,35
1657881478347,MATH 20B,A03,093475,Briones; Jor-el Thomas Caparas,2,0,36,34
1657881484376,MATH 20C,A01,083760,Briones; Jor-el Thomas Caparas,1,0,35,34
1657881484376,MATH 20C,A02,083761,Briones; Jor-el Thomas Caparas,8,0,35,27
1657881484376,MATH 20C,A03,093476,Briones; Jor-el Thomas Caparas,0,1,36,36
1657881484376,MATH 20C,B01,083762,Bach; Quang Tran,1,0,30,29
1657881490400,MATH 20D,A01,083765,Tran; Brian Kha,5,0,30,25
1657881490400,MATH 20D,A02,083766,Tran; Brian Kha,5,0,30,25
1657881490400,MATH 20D,A03,083767,Tran; Brian Kha,5,0,30,25
1657881496423,MATH 20E,A01,083771,Ganguly; Soumya,10,0,32,22
1657881496423,MATH 20E,A02,083772,Ganguly; Soumya,6,0,32,26
1657881496423,MATH 20E,B01,083773,Ciotti; Benjamin,20,0,35,15
1657881496423,MATH 20E,B02,083774,Ciotti; Benjamin,18,0,35,17
1657881502454,MATH 103A,A01,083777,Greenfeld; Be'Eri,3,0,36,33
1657881502454,MATH 103A,A02,083778,Greenfeld; Be'Eri,5,0,36,31
1657881502454,MATH 103A,A03,093561,Greenfeld; Be'Eri,6,0,36,30
1657881502454,MATH 103A,B01,083779,Greenfeld; Be'Eri,7,0,36,29
1657881502454,MATH 103A,B02,083780,Greenfeld; Be'Eri,4,0,36,32
1657881502454,MATH 103A,B03,093562,Greenfeld; Be'Eri,3,0,36,33
1657881508479,MATH 105,A01,085443,Carter; Anne Toulson,15,0,35,20
1657881508479,MATH 105,A02,093477,Carter; Anne Toulson,20,0,35,15
1657881514585,MATH 109,A01,083213,Ganzberger; Geoffrey Michael,3,0,34,31
1657881514585,MATH 109,A02,083214,Ganzberger; Geoffrey Michael,4,0,34,30
1657881514585,MATH 109,A03,093478,Ganzberger; Geoffrey Michael,2,0,34,32
1657881514585,MATH 109,B01,083215,Ganzberger; Geoffrey Michael,1,0,32,31
1657881514585,MATH 109,B02,083216,Ganzberger; Geoffrey Michael,2,0,32,30
1657881514585,MATH 109,B03,093479,Ganzberger; Geoffrey Michael,8,0,32,24
1657881520626,MATH 142A,A01,083219,Chow; Bennett,7,0,32,25
1657881520626,MATH 142A,A02,083220,Chow; Bennett,10,0,32,22
1657881520626,MATH 142A,A03,093480,Chow; Bennett,9,0,32,23
1657881520626,MATH 142A,B03,093481,Chow; Bennett,8,0,32,24
1657881520626,MATH 142A,B04,093558,Chow; Bennett,13,0,32,19
1657881520626,MATH 142A,B05,093559,Chow; Bennett,7,0,32,25
1657881526652,MATH 193A,A01,083224,Rotar; Vladimir,8,0,34,26
1657881526652,MATH 193A,A02,083225,Rotar; Vladimir,10,0,34,24
1657881526652,MATH 193A,A03,083781,Rotar; Vladimir,5,0,34,29
1657881526652,MATH 193A,A04,083782,Rotar; Vladimir,11,0,34,23
1657881526652,MATH 193A,A05,093482,Rotar; Vladimir,10,0,34,24
1657881532682,MATH 197,001,091859,McAuley; Julian John,9999,0,9999,0
1657881532682,MATH 197,002,095566,Kedlaya; Kiran S.,9997,0,9999,2
1657881532682,MATH 197,003,095567,Xiao; Ming,9999,0,9999,0
1657881532682,MATH 197,004,095571,Perols; Johan Lars,9998,0,9999,1
1657881539745,COGS 9,A01,083615,Shannon; Kyle Michael,10,0,75,65
1657881545773,COGS 11,A01,083617,Boyle; Mary E. T.,23,0,48,25
1657881551798,COGS 13,A01,083071,Bastos; Amalia Pinkusfeld,11,0,71,60
1657881557828,COGS 14A,A01,092681,Semenuks; Arturs,5,1,100,95
1657881563856,COGS 14B,A01,083073,Cheng; Tzu-Han,6,0,63,57
1657881569878,COGS 17,A01,092677,Semenuks; Arturs,6,0,81,75
1657881575908,COGS 100,A01,083619,Allen; Michael Gordon,17,0,70,53
1657881581935,COGS 101A,A01,083621,Davis; Joshua Daniel,9,0,68,59
1657881587963,COGS 101B,A01,091572,Allen; Michael Gordon,13,0,65,52
1657881593993,COGS 101C,A01,083625,Delgado; Tania,17,0,35,18
1657881600016,COGS 107A,A01,083627,Boyle; Mary E. T.,14,0,60,46
1657881606040,COGS 118A,A01,083075,Gupta; Anjum,21,0,76,55
1657881612071,CSE 3,A50,083646,Miranda; Gregory Joseph,24,0,50,26
1657881618099,CSE 8A,A50,083650,Miranda; Gregory Joseph,17,1,56,39
1657881624121,CSE 11,A01,083080,Cao; Yingjun,6,15,40,34
1657881630154,CSE 12,A01,083652,Krause-Levy; Sophia Louisa,30,1,120,90
1657881636178,CSE 15L,A01,083654,Morris; Justin Loren,9,0,50,41
1657881636178,CSE 15L,A02,083655,Morris; Justin Loren,10,0,50,40
1657881642204,CSE 20,A01,083657,Tran; Khoa Dang,39,0,80,41
1657881648228,CSE 21,A01,095574,Bach; Quang Tran,22,0,48,26
1657881654254,CSE 30,A01,083084,Eldon; John,6,0,80,74
1657881654254,CSE 30,B01,095061,Bhaskar; Nishant,9,0,50,41
1657881660283,CSE 100,A01,083659,Cao; Yingjun,5,4,70,65
1657881666305,CSE 134B,A01,083661,Powell; Thomas Allan,24,0,100,76
1657881672328,CSE 140,A01,083663,Gungor; Onat,15,0,85,70
1657881678354,CSE 140L,A01,083088,Eldon; John,23,0,100,77
1657881684379,CSE 175,A01,083665,Kumar; Rakesh,3,0,25,22
1657881690417,CSE 190,A00,092507,Dubnov; Shlomo,8,0,20,12
1657881696443,ECE 45,A01,083139,Congero; Spencer William,6,0,75,69
1657881702484,ECE 65,A50,083695,Saad; Andrew S,12,0,30,18
1657881702484,ECE 65,A51,095125,Saad; Andrew S,24,0,26,2
1657881708517,ECE 109,A01,091882,Touri; Behrouz,20,0,70,50
1657881714545,ECE 180,A00,083140,Abi Samra; Nicholas Camill,1,0,30,29
1657881714545,ECE 180,B00,083141,Abi Samra; Nicholas Camill,0,0,30,30
1657881720579,MATH 10A,A01,083735,Patchell; Gregory David,2,0,30,28
1657881720579,MATH 10A,A02,083736,Patchell; Gregory David,20,0,30,10
1657881720579,MATH 10A,A03,083737,Patchell; Gregory David,16,0,30,14
1657881726606,MATH 10B,A01,083207,Lim; Seonhee,8,0,34,26
1657881726606,MATH 10B,A02,083208,Lim; Seonhee,10,0,35,25
1657881726606,MATH 10B,A03,093472,Lim; Seonhee,7,0,34,27
1657881726606,MATH 10B,B01,083739,Sinha; Shubham,14,0,30,16
1657881732649,MATH 18,A01,083743,Cinel; Cameron Alexander,9,0,30,21
1657881732649,MATH 18,A02,083744,Cinel; Cameron Alexander,18,0,30,12
1657881732649,MATH 18,A03,083745,Cinel; Cameron Alexander,10,0,30,20
1657881732649,MATH 18,B01,083748,Rideout; David Porter,5,0,37,32
1657881732649,MATH 18,B02,083749,Rideout; David Porter,5,0,36,31
1657881732649,MATH 18,B03,083750,Rideout; David Porter,3,0,37,34
1657881732649,MATH 18,B04,083751,Rideout; David Porter,6,0,36,30
1657881732649,MATH 18,B05,093473,Rideout; David Porter,6,0,36,30
1657881732649,MATH 18,B06,093474,Rideout; David Porter,6,0,36,30
1657881738674,MATH 20A,A01,083754,Zheng; Zequn,14,0,40,26
1657881744705,MATH 20B,A01,083756,Briones; Jor-el Thomas Caparas,4,0,36,32
1657881744705,MATH 20B,A02,083757,Briones; Jor-el Thomas Caparas,1,0,36,35
1657881744705,MATH 20B,A03,093475,Briones; Jor-el Thomas Caparas,2,0,36,34
1657881750736,MATH 20C,A01,083760,Briones; Jor-el Thomas Caparas,1,0,35,34
1657881750736,MATH 20C,A02,083761,Briones; Jor-el Thomas Caparas,8,0,35,27
1657881750736,MATH 20C,A03,093476,Briones; Jor-el Thomas Caparas,0,1,36,36
1657881750736,MATH 20C,B01,083762,Bach; Quang Tran,1,0,30,29
1657881756768,MATH 20D,A01,083765,Tran; Brian Kha,5,0,30,25
1657881756768,MATH 20D,A02,083766,Tran; Brian Kha,5,0,30,25
1657881756768,MATH 20D,A03,083767,Tran; Brian Kha,5,0,30,25
1657881762795,MATH 20E,A01,083771,Ganguly; Soumya,10,0,32,22
1657881762795,MATH 20E,A02,083772,Ganguly; Soumya,6,0,32,26
1657881762795,MATH 20E,B01,083773,Ciotti; Benjamin,20,0,35,15
1657881762795,MATH 20E,B02,083774,Ciotti; Benjamin,18,0,35,17
1657881768829,MATH 103A,A01,083777,Greenfeld; Be'Eri,3,0,36,33
1657881768829,MATH 103A,A02,083778,Greenfeld; Be'Eri,5,0,36,31
1657881768829,MATH 103A,A03,093561,Greenfeld; Be'Eri,6,0,36,30
1657881768829,MATH 103A,B01,083779,Greenfeld; Be'Eri,7,0,36,29
1657881768829,MATH 103A,B02,083780,Greenfeld; Be'Eri,4,0,36,32
1657881768829,MATH 103A,B03,093562,Greenfeld; Be'Eri,3,0,36,33
1657881774854,MATH 105,A01,085443,Carter; Anne Toulson,15,0,35,20
1657881774854,MATH 105,A02,093477,Carter; Anne Toulson,20,0,35,15
1657881780880,MATH 109,A01,083213,Ganzberger; Geoffrey Michael,3,0,34,31
1657881780880,MATH 109,A02,083214,Ganzberger; Geoffrey Michael,4,0,34,30
1657881780880,MATH 109,A03,093478,Ganzberger; Geoffrey Michael,2,0,34,32
1657881780880,MATH 109,B01,083215,Ganzberger; Geoffrey Michael,1,0,32,31
1657881780880,MATH 109,B02,083216,Ganzberger; Geoffrey Michael,2,0,32,30
1657881780880,MATH 109,B03,093479,Ganzberger; Geoffrey Michael,8,0,32,24
1657881786904,MATH 142A,A01,083219,Chow; Bennett,7,0,32,25
1657881786904,MATH 142A,A02,083220,Chow; Bennett,10,0,32,22
1657881786904,MATH 142A,A03,093480,Chow; Bennett,9,0,32,23
1657881786904,MATH 142A,B03,093481,Chow; Bennett,8,0,32,24
1657881786904,MATH 142A,B04,093558,Chow; Bennett,13,0,32,19
1657881786904,MATH 142A,B05,093559,Chow; Bennett,7,0,32,25
1657881792929,MATH 193A,A01,083224,Rotar; Vladimir,8,0,34,26
1657881792929,MATH 193A,A02,083225,Rotar; Vladimir,10,0,34,24
1657881792929,MATH 193A,A03,083781,Rotar; Vladimir,5,0,34,29
1657881792929,MATH 193A,A04,083782,Rotar; Vladimir,11,0,34,23
1657881792929,MATH 193A,A05,093482,Rotar; Vladimir,10,0,34,24
1657881798952,MATH 197,001,091859,McAuley; Julian John,9999,0,9999,0
1657881798952,MATH 197,002,095566,Kedlaya; Kiran S.,9997,0,9999,2
1657881798952,MATH 197,003,095567,Xiao; Ming,9999,0,9999,0
1657881798952,MATH 197,004,095571,Perols; Johan Lars,9998,0,9999,1
1657881806038,COGS 9,A01,083615,Shannon; Kyle Michael,10,0,75,65
1657881812066,COGS 11,A01,083617,Boyle; Mary E. T.,23,0,48,25
1657881818090,COGS 13,A01,083071,Bastos; Amalia Pinkusfeld,11,0,71,60
1657881824114,COGS 14A,A01,092681,Semenuks; Arturs,5,1,100,95
1657881830142,COGS 14B,A01,083073,Cheng; Tzu-Han,6,0,63,57
1657881836166,COGS 17,A01,092677,Semenuks; Arturs,6,0,81,75
1657881842191,COGS 100,A01,083619,Allen; Michael Gordon,17,0,70,53
1657881848216,COGS 101A,A01,083621,Davis; Joshua Daniel,9,0,68,59
1657881854239,COGS 101B,A01,091572,Allen; Michael Gordon,13,0,65,52
1657881860263,COGS 101C,A01,083625,Delgado; Tania,17,0,35,18
1657881866290,COGS 107A,A01,083627,Boyle; Mary E. T.,14,0,60,46
1657881872314,COGS 118A,A01,083075,Gupta; Anjum,21,0,76,55
1657881878339,CSE 3,A50,083646,Miranda; Gregory Joseph,24,0,50,26
1657881884364,CSE 8A,A50,083650,Miranda; Gregory Joseph,17,1,56,39
1657881890389,CSE 11,A01,083080,Cao; Yingjun,6,15,40,34
1657881896421,CSE 12,A01,083652,Krause-Levy; Sophia Louisa,30,1,120,90
1657881902448,CSE 15L,A01,083654,Morris; Justin Loren,9,0,50,41
1657881902448,CSE 15L,A02,083655,Morris; Justin Loren,10,0,50,40
1657881908477,CSE 20,A01,083657,Tran; Khoa Dang,39,0,80,41
1657881914504,CSE 21,A01,095574,Bach; Quang Tran,22,0,48,26
1657881920546,CSE 30,A01,083084,Eldon; John,6,0,80,74
1657881920546,CSE 30,B01,095061,Bhaskar; Nishant,9,0,50,41
1657881926570,CSE 100,A01,083659,Cao; Yingjun,5,4,70,65
1657881932597,CSE 134B,A01,083661,Powell; Thomas Allan,24,0,100,76
1657881938623,CSE 140,A01,083663,Gungor; Onat,15,0,85,70
1657881944646,CSE 140L,A01,083088,Eldon; John,23,0,100,77
1657881950676,CSE 175,A01,083665,Kumar; Rakesh,3,0,25,22
1657881956700,CSE 190,A00,092507,Dubnov; Shlomo,8,0,20,12
1657881962726,ECE 45,A01,083139,Congero; Spencer William,6,0,75,69
1657881968757,ECE 65,A50,083695,Saad; Andrew S,12,0,30,18
1657881968757,ECE 65,A51,095125,Saad; Andrew S,24,0,26,2
1657881974784,ECE 109,A01,091882,Touri; Behrouz,20,0,70,50
1657881980809,ECE 180,A00,083140,Abi Samra; Nicholas Camill,1,0,30,29
1657881980809,ECE 180,B00,083141,Abi Samra; Nicholas Camill,0,0,30,30
1657881986835,MATH 10A,A01,083735,Patchell; Gregory David,2,0,30,28
1657881986835,MATH 10A,A02,083736,Patchell; Gregory David,20,0,30,10
1657881986835,MATH 10A,A03,083737,Patchell; Gregory David,16,0,30,14
1657881992860,MATH 10B,A01,083207,Lim; Seonhee,8,0,34,26
1657881992860,MATH 10B,A02,083208,Lim; Seonhee,10,0,35,25
1657881992860,MATH 10B,A03,093472,Lim; Seonhee,7,0,34,27
1657881992860,MATH 10B,B01,083739,Sinha; Shubham,14,0,30,16
1657881998899,MATH 18,A01,083743,Cinel; Cameron Alexander,9,0,30,21
1657881998899,MATH 18,A02,083744,Cinel; Cameron Alexander,18,0,30,12
1657881998899,MATH 18,A03,083745,Cinel; Cameron Alexander,10,0,30,20
1657881998899,MATH 18,B01,083748,Rideout; David Porter,5,0,37,32
1657881998899,MATH 18,B02,083749,Rideout; David Porter,5,0,36,31
1657881998899,MATH 18,B03,083750,Rideout; David Porter,3,0,37,34
1657881998899,MATH 18,B04,083751,Rideout; David Porter,6,0,36,30
1657881998899,MATH 18,B05,093473,Rideout; David Porter,6,0,36,30
1657881998899,MATH 18,B06,093474,Rideout; David Porter,6,0,36,30
1657882004922,MATH 20A,A01,083754,Zheng; Zequn,14,0,40,26
1657882010949,MATH 20B,A01,083756,Briones; Jor-el Thomas Caparas,4,0,36,32
1657882010949,MATH 20B,A02,083757,Briones; Jor-el Thomas Caparas,1,0,36,35
1657882010949,MATH 20B,A03,093475,Briones; Jor-el Thomas Caparas,2,0,36,34
1657882016980,MATH 20C,A01,083760,Briones; Jor-el Thomas Caparas,1,0,35,34
1657882016980,MATH 20C,A02,083761,Briones; Jor-el Thomas Caparas,8,0,35,27
1657882016980,MATH 20C,A03,093476,Briones; Jor-el Thomas Caparas,0,1,36,36
1657882016980,MATH 20C,B01,083762,Bach; Quang Tran,1,0,30,29
1657882023010,MATH 20D,A01,083765,Tran; Brian Kha,5,0,30,25
1657882023010,MATH 20D,A02,083766,Tran; Brian Kha,5,0,30,25
1657882023010,MATH 20D,A03,083767,Tran; Brian Kha,5,0,30,25
1657882029036,MATH 20E,A01,083771,Ganguly; Soumya,10,0,32,22
1657882029036,MATH 20E,A02,083772,Ganguly; Soumya,6,0,32,26
1657882029036,MATH 20E,B01,083773,Ciotti; Benjamin,20,0,35,15
1657882029036,MATH 20E,B02,083774,Ciotti; Benjamin,18,0,35,17
1657882035070,MATH 103A,A01,083777,Greenfeld; Be'Eri,3,0,36,33
1657882035070,MATH 103A,A02,083778,Greenfeld; Be'Eri,5,0,36,31
1657882035070,MATH 103A,A03,093561,Greenfeld; Be'Eri,6,0,36,30
1657882035070,MATH 103A,B01,083779,Greenfeld; Be'Eri,7,0,36,29
1657882035070,MATH 103A,B02,083780,Greenfeld; Be'Eri,4,0,36,32
1657882035070,MATH 103A,B03,093562,Greenfeld; Be'Eri,3,0,36,33
1657882041097,MATH 105,A01,085443,Carter; Anne Toulson,15,0,35,20
1657882041097,MATH 105,A02,093477,Carter; Anne Toulson,20,0,35,15
1657882047121,MATH 109,A01,083213,Ganzberger; Geoffrey Michael,3,0,34,31
1657882047121,MATH 109,A02,083214,Ganzberger; Geoffrey Michael,4,0,34,30
1657882047121,MATH 109,A03,093478,Ganzberger; Geoffrey Michael,2,0,34,32
1657882047121,MATH 109,B01,083215,Ganzberger; Geoffrey Michael,1,0,32,31
1657882047121,MATH 109,B02,083216,Ganzberger; Geoffrey Michael,2,0,32,30
1657882047121,MATH 109,B03,093479,Ganzberger; Geoffrey Michael,8,0,32,24
1657882053151,MATH 142A,A01,083219,Chow; Bennett,7,0,32,25
1657882053151,MATH 142A,A02,083220,Chow; Bennett,10,0,32,22
1657882053151,MATH 142A,A03,093480,Chow; Bennett,9,0,32,23
1657882053151,MATH 142A,B03,093481,Chow; Bennett,8,0,32,24
1657882053151,MATH 142A,B04,093558,Chow; Bennett,13,0,32,19
1657882053151,MATH 142A,B05,093559,Chow; Bennett,7,0,32,25
1657882059175,MATH 193A,A01,083224,Rotar; Vladimir,8,0,34,26
1657882059175,MATH 193A,A02,083225,Rotar; Vladimir,10,0,34,24
1657882059175,MATH 193A,A03,083781,Rotar; Vladimir,5,0,34,29
1657882059175,MATH 193A,A04,083782,Rotar; Vladimir,11,0,34,23
1657882059175,MATH 193A,A05,093482,Rotar; Vladimir,10,0,34,24
1657882065199,MATH 197,001,091859,McAuley; Julian John,9999,0,9999,0
1657882065199,MATH 197,002,095566,Kedlaya; Kiran S.,9997,0,9999,2
1657882065199,MATH 197,003,095567,Xiao; Ming,9999,0,9999,0
1657882065199,MATH 197,004,095571,Perols; Johan Lars,9998,0,9999,1
1657882072267,COGS 9,A01,083615,Shannon; Kyle Michael,10,0,75,65
1657882078289,COGS 11,A01,083617,Boyle; Mary E. T.,23,0,48,25
1657882084313,COGS 13,A01,083071,Bastos; Amalia Pinkusfeld,11,0,71,60
1657882090337,COGS 14A,A01,092681,Semenuks; Arturs,5,1,100,95
1657882096359,COGS 14B,A01,083073,Cheng; Tzu-Han,6,0,63,57
1657882102382,COGS 17,A01,092677,Semenuks; Arturs,6,0,81,75
1657882108498,COGS 100,A01,083619,Allen; Michael Gordon,17,0,70,53
1657882114523,COGS 101A,A01,083621,Davis; Joshua Daniel,9,0,68,59
1657882120548,COGS 101B,A01,091572,Allen; Michael Gordon,13,0,65,52
1657882126577,COGS 101C,A01,083625,Delgado; Tania,17,0,35,18
1657882132600,COGS 107A,A01,083627,Boyle; Mary E. T.,14,0,60,46
1657882138624,COGS 118A,A01,083075,Gupta; Anjum,21,0,76,55
1657882144647,CSE 3,A50,083646,Miranda; Gregory Joseph,24,0,50,26
1657882150676,CSE 8A,A50,083650,Miranda; Gregory Joseph,17,1,56,39
1657882156701,CSE 11,A01,083080,Cao; Yingjun,6,15,40,34
1657882162724,CSE 12,A01,083652,Krause-Levy; Sophia Louisa,30,1,120,90
1657882168747,CSE 15L,A01,083654,Morris; Justin Loren,9,0,50,41
1657882168747,CSE 15L,A02,083655,Morris; Justin Loren,10,0,50,40
1657882174769,CSE 20,A01,083657,Tran; Khoa Dang,39,0,80,41
1657882180791,CSE 21,A01,095574,Bach; Quang Tran,22,0,48,26
1657882186815,CSE 30,A01,083084,Eldon; John,6,0,80,74
1657882186815,CSE 30,B01,095061,Bhaskar; Nishant,9,0,50,41
1657882192837,CSE 100,A01,083659,Cao; Yingjun,5,4,70,65
1657882198860,CSE 134B,A01,083661,Powell; Thomas Allan,24,0,100,76
1657882204887,CSE 140,A01,083663,Gungor; Onat,15,0,85,70
1657882210910,CSE 140L,A01,083088,Eldon; John,23,0,100,77
1657882216932,CSE 175,A01,083665,Kumar; Rakesh,3,0,25,22
1657882222958,CSE 190,A00,092507,Dubnov; Shlomo,8,0,20,12
1657882228987,ECE 45,A01,083139,Congero; Spencer William,6,0,75,69
1657882235011,ECE 65,A50,083695,Saad; Andrew S,12,0,30,18
1657882235011,ECE 65,A51,095125,Saad; Andrew S,24,0,26,2
1657882241038,ECE 109,A01,091882,Touri; Behrouz,20,0,70,50
1657882247065,ECE 180,A00,083140,Abi Samra; Nicholas Camill,1,0,30,29
1657882247065,ECE 180,B00,083141,Abi Samra; Nicholas Camill,0,0,30,30
1657882253094,MATH 10A,A01,083735,Patchell; Gregory David,2,0,30,28
1657882253094,MATH 10A,A02,083736,Patchell; Gregory David,20,0,30,10
1657882253094,MATH 10A,A03,083737,Patchell; Gregory David,16,0,30,14
1657882259126,MATH 10B,A01,083207,Lim; Seonhee,8,0,34,26
1657882259126,MATH 10B,A02,083208,Lim; Seonhee,10,0,35,25
1657882259126,MATH 10B,A03,093472,Lim; Seonhee,7,0,34,27
1657882259126,MATH 10B,B01,083739,Sinha; Shubham,14,0,30,16
1657882265159,MATH 18,A01,083743,Cinel; Cameron Alexander,9,0,30,21
1657882265159,MATH 18,A02,083744,Cinel; Cameron Alexander,18,0,30,12
1657882265159,MATH 18,A03,083745,Cinel; Cameron Alexander,10,0,30,20
1657882265159,MATH 18,B01,083748,Rideout; David Porter,5,0,37,32
1657882265159,MATH 18,B02,083749,Rideout; David Porter,5,0,36,31
1657882265159,MATH 18,B03,083750,Rideout; David Porter,3,0,37,34
1657882265159,MATH 18,B04,083751,Rideout; David Porter,6,0,36,30
1657882265159,MATH 18,B05,093473,Rideout; David Porter,6,0,36,30
1657882265159,MATH 18,B06,093474,Rideout; David Porter,6,0,36,30
1657882271182,MATH 20A,A01,083754,Zheng; Zequn,14,0,40,26
1657882277208,MATH 20B,A01,083756,Briones; Jor-el Thomas Caparas,4,0,36,32
1657882277208,MATH 20B,A02,083757,Briones; Jor-el Thomas Caparas,1,0,36,35
1657882277208,MATH 20B,A03,093475,Briones; Jor-el Thomas Caparas,2,0,36,34
1657882283236,MATH 20C,A01,083760,Briones; Jor-el Thomas Caparas,1,0,35,34
1657882283236,MATH 20C,A02,083761,Briones; Jor-el Thomas Caparas,8,0,35,27
1657882283236,MATH 20C,A03,093476,Briones; Jor-el Thomas Caparas,0,1,36,36
1657882283236,MATH 20C,B01,083762,Bach; Quang Tran,1,0,30,29
1657882289260,MATH 20D,A01,083765,Tran; Brian Kha,5,0,30,25
1657882289260,MATH 20D,A02,083766,Tran; Brian Kha,5,0,30,25
1657882289260,MATH 20D,A03,083767,Tran; Brian Kha,5,0,30,25
1657882295286,MATH 20E,A01,083771,Ganguly; Soumya,10,0,32,22
1657882295286,MATH 20E,A02,083772,Ganguly; Soumya,6,0,32,26
1657882295286,MATH 20E,B01,083773,Ciotti; Benjamin,20,0,35,15
1657882295286,MATH 20E,B02,083774,Ciotti; Benjamin,18,0,35,17
1657882301312,MATH 103A,A01,083777,Greenfeld; Be'Eri,3,0,36,33
1657882301312,MATH 103A,A02,083778,Greenfeld; Be'Eri,5,0,36,31
1657882301312,MATH 103A,A03,093561,Greenfeld; Be'Eri,6,0,36,30
1657882301312,MATH 103A,B01,083779,Greenfeld; Be'Eri,7,0,36,29
1657882301312,MATH 103A,B02,083780,Greenfeld; Be'Eri,4,0,36,32
1657882301312,MATH 103A,B03,093562,Greenfeld; Be'Eri,3,0,36,33
1657882307343,MATH 105,A01,085443,Carter; Anne Toulson,15,0,35,20
1657882307343,MATH 105,A02,093477,Carter; Anne Toulson,20,0,35,15
1657882313372,MATH 109,A01,083213,Ganzberger; Geoffrey Michael,3,0,34,31
1657882313372,MATH 109,A02,083214,Ganzberger; Geoffrey Michael,4,0,34,30
1657882313372,MATH 109,A03,093478,Ganzberger; Geoffrey Michael,2,0,34,32
1657882313372,MATH 109,B01,083215,Ganzberger; Geoffrey Michael,1,0,32,31
1657882313372,MATH 109,B02,083216,Ganzberger; Geoffrey Michael,2,0,32,30
1657882313372,MATH 109,B03,093479,Ganzberger; Geoffrey Michael,8,0,32,24
1657882319398,MATH 142A,A01,083219,Chow; Bennett,7,0,32,25
1657882319398,MATH 142A,A02,083220,Chow; Bennett,10,0,32,22
1657882319398,MATH 142A,A03,093480,Chow; Bennett,9,0,32,23
1657882319398,MATH 142A,B03,093481,Chow; Bennett,8,0,32,24
1657882319398,MATH 142A,B04,093558,Chow; Bennett,13,0,32,19
1657882319398,MATH 142A,B05,093559,Chow; Bennett,7,0,32,25
1657882325431,MATH 193A,A01,083224,Rotar; Vladimir,8,0,34,26
1657882325431,MATH 193A,A02,083225,Rotar; Vladimir,10,0,34,24
1657882325431,MATH 193A,A03,083781,Rotar; Vladimir,5,0,34,29
1657882325431,MATH 193A,A04,083782,Rotar; Vladimir,11,0,34,23
1657882325431,MATH 193A,A05,093482,Rotar; Vladimir,10,0,34,24
1657882331468,MATH 197,001,091859,McAuley; Julian John,9999,0,9999,0
1657882331468,MATH 197,002,095566,Kedlaya; Kiran S.,9997,0,9999,2
1657882331468,MATH 197,003,095567,Xiao; Ming,9999,0,9999,0
1657882331468,MATH 197,004,095571,Perols; Johan Lars,9998,0,9999,1
1657882338551,COGS 9,A01,083615,Shannon; Kyle Michael,10,0,75,65
1657882344575,COGS 11,A01,083617,Boyle; Mary E. T.,23,0,48,25
1657882350599,COGS 13,A01,083071,Bastos; Amalia Pinkusfeld,11,0,71,60
1657882356628,COGS 14A,A01,092681,Semenuks; Arturs,5,1,100,95
1657882362657,COGS 14B,A01,083073,Cheng; Tzu-Han,6,0,63,57
1657882368681,COGS 17,A01,092677,Semenuks; Arturs,6,0,81,75
1657882374711,COGS 100,A01,083619,Allen; Michael Gordon,17,0,70,53
1657882380734,COGS 101A,A01,083621,Davis; Joshua Daniel,9,0,68,59
1657882386759,COGS 101B,A01,091572,Allen; Michael Gordon,13,0,65,52
1657882392784,COGS 101C,A01,083625,Delgado; Tania,17,0,35,18
1657882398807,COGS 107A,A01,083627,Boyle; Mary E. T.,14,0,60,46
1657882404836,COGS 118A,A01,083075,Gupta; Anjum,21,0,76,55
1657882410872,CSE 3,A50,083646,Miranda; Gregory Joseph,24,0,50,26
1657882416897,CSE 8A,A50,083650,Miranda; Gregory Joseph,17,1,56,39
1657882422927,CSE 11,A01,083080,Cao; Yingjun,6,15,40,34
1657882428957,CSE 12,A01,083652,Krause-Levy; Sophia Louisa,30,1,120,90
1657882434996,CSE 15L,A01,083654,Morris; Justin Loren,9,0,50,41
1657882434996,CSE 15L,A02,083655,Morris; Justin Loren,10,0,50,40
1657882441026,CSE 20,A01,083657,Tran; Khoa Dang,39,0,80,41
1657882447052,CSE 21,A01,095574,Bach; Quang Tran,22,0,48,26
1657882453087,CSE 30,A01,083084,Eldon; John,6,0,80,74
1657882453087,CSE 30,B01,095061,Bhaskar; Nishant,9,0,50,41
1657882459112,CSE 100,A01,083659,Cao; Yingjun,5,4,70,65
1657882465142,CSE 134B,A01,083661,Powell; Thomas Allan,24,0,100,76
1657882471171,CSE 140,A01,083663,Gungor; Onat,15,0,85,70
1657882477196,CSE 140L,A01,083088,Eldon; John,23,0,100,77
1657882483225,CSE 175,A01,083665,Kumar; Rakesh,3,0,25,22
1657882489250,CSE 190,A00,092507,Dubnov; Shlomo,8,0,20,12
1657882495283,ECE 45,A01,083139,Congero; Spencer William,6,0,75,69
1657882501309,ECE 65,A50,083695,Saad; Andrew S,12,0,30,18
1657882501309,ECE 65,A51,095125,Saad; Andrew S,24,0,26,2
1657882507334,ECE 109,A01,091882,Touri; Behrouz,20,0,70,50
1657882513364,ECE 180,A00,083140,Abi Samra; Nicholas Camill,1,0,30,29
1657882513364,ECE 180,B00,083141,Abi Samra; Nicholas Camill,0,0,30,30
1657882531012,MATH 10A,A01,083735,Patchell; Gregory David,2,0,30,28
1657882531012,MATH 10A,A02,083736,Patchell; Gregory David,20,0,30,10
1657882531012,MATH 10A,A03,083737,Patchell; Gregory David,16,0,30,14
1657882537045,MATH 10B,A01,083207,Lim; Seonhee,8,0,34,26
1657882537045,MATH 10B,A02,083208,Lim; Seonhee,10,0,35,25
1657882537045,MATH 10B,A03,093472,Lim; Seonhee,7,0,34,27
1657882537045,MATH 10B,B01,083739,Sinha; Shubham,14,0,30,16
1657882554674,MATH 18,A01,083743,Cinel; Cameron Alexander,9,0,30,21
1657882554674,MATH 18,A02,083744,Cinel; Cameron Alexander,18,0,30,12
1657882554674,MATH 18,A03,083745,Cinel; Cameron Alexander,10,0,30,20
1657882554674,MATH 18,B01,083748,Rideout; David Porter,5,0,37,32
1657882554674,MATH 18,B02,083749,Rideout; David Porter,5,0,36,31
1657882554674,MATH 18,B03,083750,Rideout; David Porter,3,0,37,34
1657882554674,MATH 18,B04,083751,Rideout; David Porter,6,0,36,30
1657882554674,MATH 18,B05,093473,Rideout; David Porter,6,0,36,30
1657882554674,MATH 18,B06,093474,Rideout; David Porter,6,0,36,30
1657882560702,MATH 20A,A01,083754,Zheng; Zequn,14,0,40,26
1657882578575,MATH 20B,A01,083756,Briones; Jor-el Thomas Caparas,4,0,36,32
1657882578575,MATH 20B,A02,083757,Briones; Jor-el Thomas Caparas,1,0,36,35
1657882578575,MATH 20B,A03,093475,Briones; Jor-el Thomas Caparas,2,0,36,34
1657882584599,MATH 20C,A01,083760,Briones; Jor-el Thomas Caparas,1,0,35,34
1657882584599,MATH 20C,A02,083761,Briones; Jor-el Thomas Caparas,8,0,35,27
1657882584599,MATH 20C,A03,093476,Briones; Jor-el Thomas Caparas,0,1,36,36
1657882584599,MATH 20C,B01,083762,Bach; Quang Tran,1,0,30,29
1657882601593,MATH 20D,A01,083765,Tran; Brian Kha,5,0,30,25
1657882601593,MATH 20D,A02,083766,Tran; Brian Kha,5,0,30,25
1657882601593,MATH 20D,A03,083767,Tran; Brian Kha,5,0,30,25
1657882607620,MATH 20E,A01,083771,Ganguly; Soumya,10,0,32,22
1657882607620,MATH 20E,A02,083772,Ganguly; Soumya,6,0,32,26
1657882607620,MATH 20E,B01,083773,Ciotti; Benjamin,20,0,35,15
1657882607620,MATH 20E,B02,083774,Ciotti; Benjamin,18,0,35,17
1657882625207,MATH 103A,A01,083777,Greenfeld; Be'Eri,3,0,36,33
1657882625207,MATH 103A,A02,083778,Greenfeld; Be'Eri,5,0,36,31
1657882625207,MATH 103A,A03,093561,Greenfeld; Be'Eri,6,0,36,30
1657882625207,MATH 103A,B01,083779,Greenfeld; Be'Eri,7,0,36,29
1657882625207,MATH 103A,B02,083780,Greenfeld; Be'Eri,4,0,36,32
1657882625207,MATH 103A,B03,093562,Greenfeld; Be'Eri,3,0,36,33
1657882631233,MATH 105,A01,085443,Carter; Anne Toulson,15,0,35,20
1657882631233,MATH 105,A02,093477,Carter; Anne Toulson,20,0,35,15
1657882648269,MATH 109,A01,083213,Ganzberger; Geoffrey Michael,3,0,34,31
1657882648269,MATH 109,A02,083214,Ganzberger; Geoffrey Michael,4,0,34,30
1657882648269,MATH 109,A03,093478,Ganzberger; Geoffrey Michael,2,0,34,32
1657882648269,MATH 109,B01,083215,Ganzberger; Geoffrey Michael,1,0,32,31
1657882648269,MATH 109,B02,083216,Ganzberger; Geoffrey Michael,2,0,32,30
1657882648269,MATH 109,B03,093479,Ganzberger; Geoffrey Michael,8,0,32,24
1657882654296,MATH 142A,A01,083219,Chow; Bennett,7,0,32,25
1657882654296,MATH 142A,A02,083220,Chow; Bennett,10,0,32,22
1657882654296,MATH 142A,A03,093480,Chow; Bennett,9,0,32,23
1657882654296,MATH 142A,B03,093481,Chow; Bennett,8,0,32,24
1657882654296,MATH 142A,B04,093558,Chow; Bennett,13,0,32,19
1657882654296,MATH 142A,B05,093559,Chow; Bennett,7,0,32,25
1657882670847,MATH 193A,A01,083224,Rotar; Vladimir,8,0,34,26
1657882670847,MATH 193A,A02,083225,Rotar; Vladimir,10,0,34,24
1657882670847,MATH 193A,A03,083781,Rotar; Vladimir,5,0,34,29
1657882670847,MATH 193A,A04,083782,Rotar; Vladimir,11,0,34,23
1657882670847,MATH 193A,A05,093482,Rotar; Vladimir,10,0,34,24
1657882676874,MATH 197,001,091859,McAuley; Julian John,9999,0,9999,0
1657882676874,MATH 197,002,095566,Kedlaya; Kiran S.,9997,0,9999,2
1657882676874,MATH 197,003,095567,Xiao; Ming,9999,0,9999,0
1657882676874,MATH 197,004,095571,Perols; Johan Lars,9998,0,9999,1
1657882694762,COGS 9,A01,083615,Shannon; Kyle Michael,10,0,75,65
1657882700792,COGS 11,A01,083617,Boyle; Mary E. T.,23,0,48,25
1657882716518,COGS 13,A01,083071,Bastos; Amalia Pinkusfeld,11,0,71,60
1657882722550,COGS 14A,A01,092681,Semenuks; Arturs,5,1,100,95
1657882739471,COGS 14B,A01,083073,Cheng; Tzu-Han,6,0,63,57
1657882745494,COGS 17,A01,092677,Semenuks; Arturs,6,0,81,75
1657882751557,COGS 100,A01,083619,Allen; Michael Gordon,17,0,70,53
1657882757583,COGS 101A,A01,083621,Davis; Joshua Daniel,9,0,68,59
1657882763609,COGS 101B,A01,091572,Allen; Michael Gordon,13,0,65,52
1657882769635,COGS 101C,A01,083625,Delgado; Tania,17,0,35,18
1657882775659,COGS 107A,A01,083627,Boyle; Mary E. T.,14,0,60,46
1657882781686,COGS 118A,A01,083075,Gupta; Anjum,21,0,76,55
1657882787722,CSE 3,A50,083646,Miranda; Gregory Joseph,24,0,50,26
1657882793746,CSE 8A,A50,083650,Miranda; Gregory Joseph,17,1,56,39
1657882799773,CSE 11,A01,083080,Cao; Yingjun,6,15,40,34
1657882805803,CSE 12,A01,083652,Krause-Levy; Sophia Louisa,30,1,120,90
1657882811832,CSE 15L,A01,083654,Morris; Justin Loren,9,0,50,41
1657882811832,CSE 15L,A02,083655,Morris; Justin Loren,10,0,50,40
1657882817931,CSE 20,A01,083657,Tran; Khoa Dang,39,0,80,41
1657882823956,CSE 21,A01,095574,Bach; Quang Tran,22,0,48,26
1657882829980,CSE 30,A01,083084,Eldon; John,6,0,80,74
1657882829980,CSE 30,B01,095061,Bhaskar; Nishant,9,0,50,41
1657882836011,CSE 100,A01,083659,Cao; Yingjun,5,4,70,65
1657882842036,CSE 134B,A01,083661,Powell; Thomas Allan,24,0,100,76
1657882848068,CSE 140,A01,083663,Gungor; Onat,15,0,85,70
1657882854092,CSE 140L,A01,083088,Eldon; John,23,0,100,77
1657882860122,CSE 175,A01,083665,Kumar; Rakesh,3,0,25,22
1657882866147,CSE 190,A00,092507,Dubnov; Shlomo,8,0,20,12
1657882872178,ECE 45,A01,083139,Congero; Spencer William,6,0,75,69
1657882878209,ECE 65,A50,083695,Saad; Andrew S,12,0,30,18
1657882878209,ECE 65,A51,095125,Saad; Andrew S,24,0,26,2
1657882884239,ECE 109,A01,091882,Touri; Behrouz,20,0,70,50
1657882890266,ECE 180,A00,083140,Abi Samra; Nicholas Camill,1,0,30,29
1657882890266,ECE 180,B00,083141,Abi Samra; Nicholas Camill,0,0,30,30
1657882896294,MATH 10A,A01,083735,Patchell; Gregory David,2,0,30,28
1657882896294,MATH 10A,A02,083736,Patchell; Gregory David,20,0,30,10
1657882896294,MATH 10A,A03,083737,Patchell; Gregory David,16,0,30,14
1657882902323,MATH 10B,A01,083207,Lim; Seonhee,8,0,34,26
1657882902323,MATH 10B,A02,083208,Lim; Seonhee,10,0,35,25
1657882902323,MATH 10B,A03,093472,Lim; Seonhee,7,0,34,27
1657882902323,MATH 10B,B01,083739,Sinha; Shubham,14,0,30,16
1657882908363,MATH 18,A01,083743,Cinel; Cameron Alexander,9,0,30,21
1657882908363,MATH 18,A02,083744,Cinel; Cameron Alexander,18,0,30,12
1657882908363,MATH 18,A03,083745,Cinel; Cameron Alexander,10,0,30,20
1657882908363,MATH 18,B01,083748,Rideout; David Porter,5,0,37,32
1657882908363,MATH 18,B02,083749,Rideout; David Porter,5,0,36,31
1657882908363,MATH 18,B03,083750,Rideout; David Porter,3,0,37,34
1657882908363,MATH 18,B04,083751,Rideout; David Porter,6,0,36,30
1657882908363,MATH 18,B05,093473,Rideout; David Porter,6,0,36,30
1657882908363,MATH 18,B06,093474,Rideout; David Porter,6,0,36,30
1657882914387,MATH 20A,A01,083754,Zheng; Zequn,14,0,40,26
1657882920418,MATH 20B,A01,083756,Briones; Jor-el Thomas Caparas,4,0,36,32
1657882920418,MATH 20B,A02,083757,Briones; Jor-el Thomas Caparas,1,0,36,35
1657882920418,MATH 20B,A03,093475,Briones; Jor-el Thomas Caparas,2,0,36,34
1657882926442,MATH 20C,A01,083760,Briones; Jor-el Thomas Caparas,1,0,35,34
1657882926442,MATH 20C,A02,083761,Briones; Jor-el Thomas Caparas,8,0,35,27
1657882926442,MATH 20C,A03,093476,Briones; Jor-el Thomas Caparas,0,1,36,36
1657882926442,MATH 20C,B01,083762,Bach; Quang Tran,1,0,30,29
1657882932490,MATH 20D,A01,083765,Tran; Brian Kha,5,0,30,25
1657882932490,MATH 20D,A02,083766,Tran; Brian Kha,5,0,30,25
1657882932490,MATH 20D,A03,083767,Tran; Brian Kha,5,0,30,25
1657882938530,MATH 20E,A01,083771,Ganguly; Soumya,10,0,32,22
1657882938530,MATH 20E,A02,083772,Ganguly; Soumya,6,0,32,26
1657882938530,MATH 20E,B01,083773,Ciotti; Benjamin,20,0,35,15
1657882938530,MATH 20E,B02,083774,Ciotti; Benjamin,18,0,35,17
1657882944556,MATH 103A,A01,083777,Greenfeld; Be'Eri,3,0,36,33
1657882944556,MATH 103A,A02,083778,Greenfeld; Be'Eri,5,0,36,31
1657882944556,MATH 103A,A03,093561,Greenfeld; Be'Eri,6,0,36,30
1657882944556,MATH 103A,B01,083779,Greenfeld; Be'Eri,7,0,36,29
1657882944556,MATH 103A,B02,083780,Greenfeld; Be'Eri,4,0,36,32
1657882944556,MATH 103A,B03,093562,Greenfeld; Be'Eri,3,0,36,33
1657882950591,MATH 105,A01,085443,Carter; Anne Toulson,15,0,35,20
1657882950591,MATH 105,A02,093477,Carter; Anne Toulson,20,0,35,15
1657882956618,MATH 109,A01,083213,Ganzberger; Geoffrey Michael,3,0,34,31
1657882956618,MATH 109,A02,083214,Ganzberger; Geoffrey Michael,4,0,34,30
1657882956618,MATH 109,A03,093478,Ganzberger; Geoffrey Michael,2,0,34,32
1657882956618,MATH 109,B01,083215,Ganzberger; Geoffrey Michael,1,0,32,31
1657882956618,MATH 109,B02,083216,Ganzberger; Geoffrey Michael,2,0,32,30
1657882956618,MATH 109,B03,093479,Ganzberger; Geoffrey Michael,8,0,32,24
1657882962645,MATH 142A,A01,083219,Chow; Bennett,7,0,32,25
1657882962645,MATH 142A,A02,083220,Chow; Bennett,10,0,32,22
1657882962645,MATH 142A,A03,093480,Chow; Bennett,9,0,32,23
1657882962645,MATH 142A,B03,093481,Chow; Bennett,8,0,32,24
1657882962645,MATH 142A,B04,093558,Chow; Bennett,13,0,32,19
1657882962645,MATH 142A,B05,093559,Chow; Bennett,7,0,32,25
1657882968679,MATH 193A,A01,083224,Rotar; Vladimir,8,0,34,26
1657882968679,MATH 193A,A02,083225,Rotar; Vladimir,10,0,34,24
1657882968679,MATH 193A,A03,083781,Rotar; Vladimir,5,0,34,29
1657882968679,MATH 193A,A04,083782,Rotar; Vladimir,11,0,34,23
1657882968679,MATH 193A,A05,093482,Rotar; Vladimir,10,0,34,24
1657882974706,MATH 197,001,091859,McAuley; Julian John,9999,0,9999,0
1657882974706,MATH 197,002,095566,Kedlaya; Kiran S.,9997,0,9999,2
1657882974706,MATH 197,003,095567,Xiao; Ming,9999,0,9999,0
1657882974706,MATH 197,004,095571,Perols; Johan Lars,9998,0,9999,1
1657882981786,COGS 9,A01,083615,Shannon; Kyle Michael,10,0,75,65
1657883000098,COGS 11,A01,083617,Boyle; Mary E. T.,23,0,48,25
1657883006208,COGS 13,A01,083071,Bastos; Amalia Pinkusfeld,11,0,71,60
1657883015458,COGS 14A,A01,092681,Semenuks; Arturs,5,1,100,95
1657883021488,COGS 14B,A01,083073,Cheng; Tzu-Han,6,0,63,57
1657883027520,COGS 17,A01,092677,Semenuks; Arturs,6,0,81,75
1657883033552,COGS 100,A01,083619,Allen; Michael Gordon,17,0,70,53
1657883039585,COGS 101A,A01,083621,Davis; Joshua Daniel,9,0,68,59
1657883045611,COGS 101B,A01,091572,Allen; Michael Gordon,13,0,65,52
1657883051641,COGS 101C,A01,083625,Delgado; Tania,17,0,35,18
1657883057663,COGS 107A,A01,083627,Boyle; Mary E. T.,14,0,60,46
1657883063688,COGS 118A,A01,083075,Gupta; Anjum,21,0,76,55
1657883069720,CSE 3,A50,083646,Miranda; Gregory Joseph,24,0,50,26
1657883075744,CSE 8A,A50,083650,Miranda; Gregory Joseph,17,1,56,39
1657883081769,CSE 11,A01,083080,Cao; Yingjun,6,15,40,34
1657883087795,CSE 12,A01,083652,Krause-Levy; Sophia Louisa,30,1,120,90
1657883093825,CSE 15L,A01,083654,Morris; Justin Loren,9,0,50,41
1657883093825,CSE 15L,A02,083655,Morris; Justin Loren,10,0,50,40
1657883099849,CSE 20,A01,083657,Tran; Khoa Dang,39,0,80,41
1657883105873,CSE 21,A01,095574,Bach; Quang Tran,22,0,48,26
1657883111906,CSE 30,A01,083084,Eldon; John,6,0,80,74
1657883111906,CSE 30,B01,095061,Bhaskar; Nishant,9,0,50,41
1657883117933,CSE 100,A01,083659,Cao; Yingjun,5,4,70,65
1657883123957,CSE 134B,A01,083661,Powell; Thomas Allan,24,0,100,76
1657883129981,CSE 140,A01,083663,Gungor; Onat,15,0,85,70
1657883136005,CSE 140L,A01,083088,Eldon; John,23,0,100,77
1657883142036,CSE 175,A01,083665,Kumar; Rakesh,3,0,25,22
1657883148078,CSE 190,A00,092507,Dubnov; Shlomo,8,0,20,12
1657883154105,ECE 45,A01,083139,Congero; Spencer William,6,0,75,69
1657883160129,ECE 65,A50,083695,Saad; Andrew S,12,0,30,18
1657883160129,ECE 65,A51,095125,Saad; Andrew S,24,0,26,2
1657883166158,ECE 109,A01,091882,Touri; Behrouz,20,0,70,50
1657883172182,ECE 180,A00,083140,Abi Samra; Nicholas Camill,1,0,30,29
1657883172182,ECE 180,B00,083141,Abi Samra; Nicholas Camill,0,0,30,30
1657883178210,MATH 10A,A01,083735,Patchell; Gregory David,2,0,30,28
1657883178210,MATH 10A,A02,083736,Patchell; Gregory David,20,0,30,10
1657883178210,MATH 10A,A03,083737,Patchell; Gregory David,16,0,30,14
1657883184238,MATH 10B,A01,083207,Lim; Seonhee,8,0,34,26
1657883184238,MATH 10B,A02,083208,Lim; Seonhee,10,0,35,25
1657883184238,MATH 10B,A03,093472,Lim; Seonhee,7,0,34,27
1657883184238,MATH 10B,B01,083739,Sinha; Shubham,14,0,30,16
1657883190273,MATH 18,A01,083743,Cinel; Cameron Alexander,9,0,30,21
1657883190273,MATH 18,A02,083744,Cinel; Cameron Alexander,18,0,30,12
1657883190273,MATH 18,A03,083745,Cinel; Cameron Alexander,10,0,30,20
1657883190273,MATH 18,B01,083748,Rideout; David Porter,5,0,37,32
1657883190273,MATH 18,B02,083749,Rideout; David Porter,5,0,36,31
1657883190273,MATH 18,B03,083750,Rideout; David Porter,3,0,37,34
1657883190273,MATH 18,B04,083751,Rideout; David Porter,6,0,36,30
1657883190273,MATH 18,B05,093473,Rideout; David Porter,6,0,36,30
1657883190273,MATH 18,B06,093474,Rideout; David Porter,6,0,36,30
1657883196296,MATH 20A,A01,083754,Zheng; Zequn,14,0,40,26
1657883202322,MATH 20B,A01,083756,Briones; Jor-el Thomas Caparas,4,0,36,32
1657883202322,MATH 20B,A02,083757,Briones; Jor-el Thomas Caparas,1,0,36,35
1657883202322,MATH 20B,A03,093475,Briones; Jor-el Thomas Caparas,2,0,36,34
1657883208348,MATH 20C,A01,083760,Briones; Jor-el Thomas Caparas,1,0,35,34
1657883208348,MATH 20C,A02,083761,Briones; Jor-el Thomas Caparas,8,0,35,27
1657883208348,MATH 20C,A03,093476,Briones; Jor-el Thomas Caparas,0,1,36,36
1657883208348,MATH 20C,B01,083762,Bach; Quang Tran,1,0,30,29
1657883214380,MATH 20D,A01,083765,Tran; Brian Kha,5,0,30,25
1657883214380,MATH 20D,A02,083766,Tran; Brian Kha,5,0,30,25
1657883214380,MATH 20D,A03,083767,Tran; Brian Kha,5,0,30,25
1657883220416,MATH 20E,A01,083771,Ganguly; Soumya,10,0,32,22
1657883220416,MATH 20E,A02,083772,Ganguly; Soumya,6,0,32,26
1657883220416,MATH 20E,B01,083773,Ciotti; Benjamin,20,0,35,15
1657883220416,MATH 20E,B02,083774,Ciotti; Benjamin,18,0,35,17
1657883226450,MATH 103A,A01,083777,Greenfeld; Be'Eri,3,0,36,33
1657883226450,MATH 103A,A02,083778,Greenfeld; Be'Eri,5,0,36,31
1657883226450,MATH 103A,A03,093561,Greenfeld; Be'Eri,6,0,36,30
1657883226450,MATH 103A,B01,083779,Greenfeld; Be'Eri,7,0,36,29
1657883226450,MATH 103A,B02,083780,Greenfeld; Be'Eri,4,0,36,32
1657883226450,MATH 103A,B03,093562,Greenfeld; Be'Eri,3,0,36,33
1657883232476,MATH 105,A01,085443,Carter; Anne Toulson,15,0,35,20
1657883232476,MATH 105,A02,093477,Carter; Anne Toulson,20,0,35,15
1657883238501,MATH 109,A01,083213,Ganzberger; Geoffrey Michael,3,0,34,31
1657883238501,MATH 109,A02,083214,Ganzberger; Geoffrey Michael,4,0,34,30
1657883238501,MATH 109,A03,093478,Ganzberger; Geoffrey Michael,2,0,34,32
1657883238501,MATH 109,B01,083215,Ganzberger; Geoffrey Michael,1,0,32,31
1657883238501,MATH 109,B02,083216,Ganzberger; Geoffrey Michael,2,0,32,30
1657883238501,MATH 109,B03,093479,Ganzberger; Geoffrey Michael,8,0,32,24
1657883244526,MATH 142A,A01,083219,Chow; Bennett,7,0,32,25
1657883244526,MATH 142A,A02,083220,Chow; Bennett,10,0,32,22
1657883244526,MATH 142A,A03,093480,Chow; Bennett,9,0,32,23
1657883244526,MATH 142A,B03,093481,Chow; Bennett,8,0,32,24
1657883244526,MATH 142A,B04,093558,Chow; Bennett,13,0,32,19
1657883244526,MATH 142A,B05,093559,Chow; Bennett,7,0,32,25
1657883250551,MATH 193A,A01,083224,Rotar; Vladimir,8,0,34,26
1657883250551,MATH 193A,A02,083225,Rotar; Vladimir,10,0,34,24
1657883250551,MATH 193A,A03,083781,Rotar; Vladimir,5,0,34,29
1657883250551,MATH 193A,A04,083782,Rotar; Vladimir,11,0,34,23
1657883250551,MATH 193A,A05,093482,Rotar; Vladimir,10,0,34,24
1657883256583,MATH 197,001,091859,McAuley; Julian John,9999,0,9999,0
1657883256583,MATH 197,002,095566,Kedlaya; Kiran S.,9997,0,9999,2
1657883256583,MATH 197,003,095567,Xiao; Ming,9999,0,9999,0
1657883256583,MATH 197,004,095571,Perols; Johan Lars,9998,0,9999,1
1657883263649,COGS 9,A01,083615,Shannon; Kyle Michael,10,0,75,65
1657883269672,COGS 11,A01,083617,Boyle; Mary E. T.,23,0,48,25
1657883275699,COGS 13,A01,083071,Bastos; Amalia Pinkusfeld,11,0,71,60
1657883281739,COGS 14A,A01,092681,Semenuks; Arturs,5,1,100,95
1657883287764,COGS 14B,A01,083073,Cheng; Tzu-Han,6,0,63,57
1657883293786,COGS 17,A01,092677,Semenuks; Arturs,6,0,81,75
1657883299817,COGS 100,A01,083619,Allen; Michael Gordon,17,0,70,53
1657883305845,COGS 101A,A01,083621,Davis; Joshua Daniel,9,0,68,59
1657883311870,COGS 101B,A01,091572,Allen; Michael Gordon,13,0,65,52
1657883317896,COGS 101C,A01,083625,Delgado; Tania,17,0,35,18
1657883323920,COGS 107A,A01,083627,Boyle; Mary E. T.,14,0,60,46
1657883329943,COGS 118A,A01,083075,Gupta; Anjum,21,0,76,55
1657883335979,CSE 3,A50,083646,Miranda; Gregory Joseph,24,0,50,26
1657883342007,CSE 8A,A50,083650,Miranda; Gregory Joseph,17,1,56,39
1657883348035,CSE 11,A01,083080,Cao; Yingjun,6,15,40,34
1657883354070,CSE 12,A01,083652,Krause-Levy; Sophia Louisa,30,1,120,90
1657883360095,CSE 15L,A01,083654,Morris; Justin Loren,9,0,50,41
1657883360095,CSE 15L,A02,083655,Morris; Justin Loren,10,0,50,40
1657883366118,CSE 20,A01,083657,Tran; Khoa Dang,39,0,80,41
1657883372149,CSE 21,A01,095574,Bach; Quang Tran,22,0,48,26
1657883378178,CSE 30,A01,083084,Eldon; John,6,0,80,74
1657883378178,CSE 30,B01,095061,Bhaskar; Nishant,9,0,50,41
1657883384209,CSE 100,A01,083659,Cao; Yingjun,5,4,70,65
1657883390234,CSE 134B,A01,083661,Powell; Thomas Allan,24,0,100,76
1657883396262,CSE 140,A01,083663,Gungor; Onat,15,0,85,70
1657883402285,CSE 140L,A01,083088,Eldon; John,23,0,100,77
1657883408312,CSE 175,A01,083665,Kumar; Rakesh,3,0,25,22
1657883414338,CSE 190,A00,092507,Dubnov; Shlomo,8,0,20,12
1657883420369,ECE 45,A01,083139,Congero; Spencer William,6,0,75,69
1657883426397,ECE 65,A50,083695,Saad; Andrew S,12,0,30,18
1657883426397,ECE 65,A51,095125,Saad; Andrew S,24,0,26,2
1657883432428,ECE 109,A01,091882,Touri; Behrouz,20,0,70,50
1657883438452,ECE 180,A00,083140,Abi Samra; Nicholas Camill,1,0,30,29
1657883438452,ECE 180,B00,083141,Abi Samra; Nicholas Camill,0,0,30,30
1657883444479,MATH 10A,A01,083735,Patchell; Gregory David,2,0,30,28
1657883444479,MATH 10A,A02,083736,Patchell; Gregory David,20,0,30,10
1657883444479,MATH 10A,A03,083737,Patchell; Gregory David,16,0,30,14
1657883450520,MATH 10B,A01,083207,Lim; Seonhee,8,0,34,26
1657883450520,MATH 10B,A02,083208,Lim; Seonhee,10,0,35,25
1657883450520,MATH 10B,A03,093472,Lim; Seonhee,7,0,34,27
1657883450520,MATH 10B,B01,083739,Sinha; Shubham,14,0,30,16
1657883456565,MATH 18,A01,083743,Cinel; Cameron Alexander,9,0,30,21
1657883456565,MATH 18,A02,083744,Cinel; Cameron Alexander,18,0,30,12
1657883456565,MATH 18,A03,083745,Cinel; Cameron Alexander,10,0,30,20
1657883456565,MATH 18,B01,083748,Rideout; David Porter,5,0,37,32
1657883456565,MATH 18,B02,083749,Rideout; David Porter,5,0,36,31
1657883456565,MATH 18,B03,083750,Rideout; David Porter,3,0,37,34
1657883456565,MATH 18,B04,083751,Rideout; David Porter,6,0,36,30
1657883456565,MATH 18,B05,093473,Rideout; David Porter,6,0,36,30
1657883456565,MATH 18,B06,093474,Rideout; David Porter,6,0,36,30
1657883462590,MATH 20A,A01,083754,Zheng; Zequn,14,0,40,26
1657883468624,MATH 20B,A01,083756,Briones; Jor-el Thomas Caparas,4,0,36,32
1657883468624,MATH 20B,A02,083757,Briones; Jor-el Thomas Caparas,1,0,36,35
1657883468624,MATH 20B,A03,093475,Briones; Jor-el Thomas Caparas,2,0,36,34
1657883474662,MATH 20C,A01,083760,Briones; Jor-el Thomas Caparas,1,0,35,34
1657883474662,MATH 20C,A02,083761,Briones; Jor-el Thomas Caparas,8,0,35,27
1657883474662,MATH 20C,A03,093476,Briones; Jor-el Thomas Caparas,0,1,36,36
1657883474662,MATH 20C,B01,083762,Bach; Quang Tran,1,0,30,29
1657883480689,MATH 20D,A01,083765,Tran; Brian Kha,5,0,30,25
1657883480689,MATH 20D,A02,083766,Tran; Brian Kha,5,0,30,25
1657883480689,MATH 20D,A03,083767,Tran; Brian Kha,5,0,30,25
1657883486717,MATH 20E,A01,083771,Ganguly; Soumya,10,0,32,22
1657883486717,MATH 20E,A02,083772,Ganguly; Soumya,6,0,32,26
1657883486717,MATH 20E,B01,083773,Ciotti; Benjamin,20,0,35,15
1657883486717,MATH 20E,B02,083774,Ciotti; Benjamin,18,0,35,17
1657883492756,MATH 103A,A01,083777,Greenfeld; Be'Eri,3,0,36,33
1657883492756,MATH 103A,A02,083778,Greenfeld; Be'Eri,5,0,36,31
1657883492756,MATH 103A,A03,093561,Greenfeld; Be'Eri,6,0,36,30
1657883492756,MATH 103A,B01,083779,Greenfeld; Be'Eri,7,0,36,29
1657883492756,MATH 103A,B02,083780,Greenfeld; Be'Eri,4,0,36,32
1657883492756,MATH 103A,B03,093562,Greenfeld; Be'Eri,3,0,36,33
1657883498787,MATH 105,A01,085443,Carter; Anne Toulson,15,0,35,20
1657883498787,MATH 105,A02,093477,Carter; Anne Toulson,20,0,35,15
1657883504815,MATH 109,A01,083213,Ganzberger; Geoffrey Michael,3,0,34,31
1657883504815,MATH 109,A02,083214,Ganzberger; Geoffrey Michael,4,0,34,30
1657883504815,MATH 109,A03,093478,Ganzberger; Geoffrey Michael,2,0,34,32
1657883504815,MATH 109,B01,083215,Ganzberger; Geoffrey Michael,1,0,32,31
1657883504815,MATH 109,B02,083216,Ganzberger; Geoffrey Michael,2,0,32,30
1657883504815,MATH 109,B03,093479,Ganzberger; Geoffrey Michael,8,0,32,24
1657883510845,MATH 142A,A01,083219,Chow; Bennett,7,0,32,25
1657883510845,MATH 142A,A02,083220,Chow; Bennett,10,0,32,22
1657883510845,MATH 142A,A03,093480,Chow; Bennett,9,0,32,23
1657883510845,MATH 142A,B03,093481,Chow; Bennett,8,0,32,24
1657883510845,MATH 142A,B04,093558,Chow; Bennett,13,0,32,19
1657883510845,MATH 142A,B05,093559,Chow; Bennett,7,0,32,25
1657883516873,MATH 193A,A01,083224,Rotar; Vladimir,8,0,34,26
1657883516873,MATH 193A,A02,083225,Rotar; Vladimir,10,0,34,24
1657883516873,MATH 193A,A03,083781,Rotar; Vladimir,5,0,34,29
1657883516873,MATH 193A,A04,083782,Rotar; Vladimir,11,0,34,23
1657883516873,MATH 193A,A05,093482,Rotar; Vladimir,10,0,34,24
1657883522899,MATH 197,001,091859,McAuley; Julian John,9999,0,9999,0
1657883522899,MATH 197,002,095566,Kedlaya; Kiran S.,9997,0,9999,2
1657883522899,MATH 197,003,095567,Xiao; Ming,9999,0,9999,0
1657883522899,MATH 197,004,095571,Perols; Johan Lars,9998,0,9999,1
1657883529985,COGS 9,A01,083615,Shannon; Kyle Michael,10,0,75,65
1657883536015,COGS 11,A01,083617,Boyle; Mary E. T.,23,0,48,25
1657883542043,COGS 13,A01,083071,Bastos; Amalia Pinkusfeld,11,0,71,60
1657883548069,COGS 14A,A01,092681,Semenuks; Arturs,5,1,100,95
1657883554093,COGS 14B,A01,083073,Cheng; Tzu-Han,6,0,63,57
1657883560123,COGS 17,A01,092677,Semenuks; Arturs,6,0,81,75
1657883566156,COGS 100,A01,083619,Allen; Michael Gordon,17,0,70,53
1657883572188,COGS 101A,A01,083621,Davis; Joshua Daniel,9,0,68,59
1657883578214,COGS 101B,A01,091572,Allen; Michael Gordon,13,0,65,52
1657883584240,COGS 101C,A01,083625,Delgado; Tania,17,0,35,18
1657883590265,COGS 107A,A01,083627,Boyle; Mary E. T.,14,0,60,46
1657883596292,COGS 118A,A01,083075,Gupta; Anjum,21,0,76,55
1657883602328,CSE 3,A50,083646,Miranda; Gregory Joseph,24,0,50,26
1657883608433,CSE 8A,A50,083650,Miranda; Gregory Joseph,17,1,56,39
1657883614466,CSE 11,A01,083080,Cao; Yingjun,6,15,40,34
1657883620499,CSE 12,A01,083652,Krause-Levy; Sophia Louisa,30,1,120,90
1657883626529,CSE 15L,A01,083654,Morris; Justin Loren,9,0,50,41
1657883626529,CSE 15L,A02,083655,Morris; Justin Loren,10,0,50,40
1657883632559,CSE 20,A01,083657,Tran; Khoa Dang,39,0,80,41
1657883638586,CSE 21,A01,095574,Bach; Quang Tran,22,0,48,26
1657883644614,CSE 30,A01,083084,Eldon; John,6,0,80,74
1657883644614,CSE 30,B01,095061,Bhaskar; Nishant,9,0,50,41
1657883650648,CSE 100,A01,083659,Cao; Yingjun,5,4,70,65
1657883656677,CSE 134B,A01,083661,Powell; Thomas Allan,24,0,100,76
1657883662702,CSE 140,A01,083663,Gungor; Onat,15,0,85,70
1657883668725,CSE 140L,A01,083088,Eldon; John,23,0,100,77
1657883674756,CSE 175,A01,083665,Kumar; Rakesh,3,0,25,22
1657883680787,CSE 190,A00,092507,Dubnov; Shlomo,8,0,20,12
1657883686813,ECE 45,A01,083139,Congero; Spencer William,6,0,75,69
1657883692846,ECE 65,A50,083695,Saad; Andrew S,12,0,30,18
1657883692846,ECE 65,A51,095125,Saad; Andrew S,24,0,26,2
1657883698884,ECE 109,A01,091882,Touri; Behrouz,20,0,70,50
1657883704911,ECE 180,A00,083140,Abi Samra; Nicholas Camill,1,0,30,29
1657883704911,ECE 180,B00,083141,Abi Samra; Nicholas Camill,0,0,30,30
1657883710945,MATH 10A,A01,083735,Patchell; Gregory David,2,0,30,28
1657883710945,MATH 10A,A02,083736,Patchell; Gregory David,20,0,30,10
1657883710945,MATH 10A,A03,083737,Patchell; Gregory David,16,0,30,14
1657883716982,MATH 10B,A01,083207,Lim; Seonhee,8,0,34,26
1657883716982,MATH 10B,A02,083208,Lim; Seonhee,10,0,35,25
1657883716982,MATH 10B,A03,093472,Lim; Seonhee,7,0,34,27
1657883716982,MATH 10B,B01,083739,Sinha; Shubham,14,0,30,16
1657883723022,MATH 18,A01,083743,Cinel; Cameron Alexander,9,0,30,21
1657883723022,MATH 18,A02,083744,Cinel; Cameron Alexander,18,0,30,12
1657883723022,MATH 18,A03,083745,Cinel; Cameron Alexander,10,0,30,20
1657883723022,MATH 18,B01,083748,Rideout; David Porter,5,0,37,32
1657883723022,MATH 18,B02,083749,Rideout; David Porter,5,0,36,31
1657883723022,MATH 18,B03,083750,Rideout; David Porter,3,0,37,34
1657883723022,MATH 18,B04,083751,Rideout; David Porter,6,0,36,30
1657883723022,MATH 18,B05,093473,Rideout; David Porter,6,0,36,30
1657883723022,MATH 18,B06,093474,Rideout; David Porter,6,0,36,30
1657883729059,MATH 20A,A01,083754,Zheng; Zequn,14,0,40,26
1657883735087,MATH 20B,A01,083756,Briones; Jor-el Thomas Caparas,4,0,36,32
1657883735087,MATH 20B,A02,083757,Briones; Jor-el Thomas Caparas,1,0,36,35
1657883735087,MATH 20B,A03,093475,Briones; Jor-el Thomas Caparas,2,0,36,34
1657883741118,MATH 20C,A01,083760,Briones; Jor-el Thomas Caparas,1,0,35,34
1657883741118,MATH 20C,A02,083761,Briones; Jor-el Thomas Caparas,8,0,35,27
1657883741118,MATH 20C,A03,093476,Briones; Jor-el Thomas Caparas,0,1,36,36
1657883741118,MATH 20C,B01,083762,Bach; Quang Tran,1,0,30,29
1657883747152,MATH 20D,A01,083765,Tran; Brian Kha,5,0,30,25
1657883747152,MATH 20D,A02,083766,Tran; Brian Kha,5,0,30,25
1657883747152,MATH 20D,A03,083767,Tran; Brian Kha,5,0,30,25
1657883753185,MATH 20E,A01,083771,Ganguly; Soumya,10,0,32,22
1657883753185,MATH 20E,A02,083772,Ganguly; Soumya,6,0,32,26
1657883753185,MATH 20E,B01,083773,Ciotti; Benjamin,20,0,35,15
1657883753185,MATH 20E,B02,083774,Ciotti; Benjamin,18,0,35,17
1657883759220,MATH 103A,A01,083777,Greenfeld; Be'Eri,3,0,36,33
1657883759220,MATH 103A,A02,083778,Greenfeld; Be'Eri,5,0,36,31
1657883759220,MATH 103A,A03,093561,Greenfeld; Be'Eri,6,0,36,30
1657883759220,MATH 103A,B01,083779,Greenfeld; Be'Eri,7,0,36,29
1657883759220,MATH 103A,B02,083780,Greenfeld; Be'Eri,4,0,36,32
1657883759220,MATH 103A,B03,093562,Greenfeld; Be'Eri,3,0,36,33
1657883765255,MATH 105,A01,085443,Carter; Anne Toulson,15,0,35,20
1657883765255,MATH 105,A02,093477,Carter; Anne Toulson,20,0,35,15
1657883771282,MATH 109,A01,083213,Ganzberger; Geoffrey Michael,3,0,34,31
1657883771282,MATH 109,A02,083214,Ganzberger; Geoffrey Michael,4,0,34,30
1657883771282,MATH 109,A03,093478,Ganzberger; Geoffrey Michael,2,0,34,32
1657883771282,MATH 109,B01,083215,Ganzberger; Geoffrey Michael,1,0,32,31
1657883771282,MATH 109,B02,083216,Ganzberger; Geoffrey Michael,2,0,32,30
1657883771282,MATH 109,B03,093479,Ganzberger; Geoffrey Michael,8,0,32,24
1657883777320,MATH 142A,A01,083219,Chow; Bennett,7,0,32,25
1657883777320,MATH 142A,A02,083220,Chow; Bennett,10,0,32,22
1657883777320,MATH 142A,A03,093480,Chow; Bennett,9,0,32,23
1657883777320,MATH 142A,B03,093481,Chow; Bennett,8,0,32,24
1657883777320,MATH 142A,B04,093558,Chow; Bennett,13,0,32,19
1657883777320,MATH 142A,B05,093559,Chow; Bennett,7,0,32,25
1657883783344,MATH 193A,A01,083224,Rotar; Vladimir,8,0,34,26
1657883783344,MATH 193A,A02,083225,Rotar; Vladimir,10,0,34,24
1657883783344,MATH 193A,A03,083781,Rotar; Vladimir,5,0,34,29
1657883783344,MATH 193A,A04,083782,Rotar; Vladimir,11,0,34,23
1657883783344,MATH 193A,A05,093482,Rotar; Vladimir,10,0,34,24
1657883789389,MATH 197,001,091859,McAuley; Julian John,9999,0,9999,0
1657883789389,MATH 197,002,095566,Kedlaya; Kiran S.,9997,0,9999,2
1657883789389,MATH 197,003,095567,Xiao; Ming,9999,0,9999,0
1657883789389,MATH 197,004,095571,Perols; Johan Lars,9998,0,9999,1
1657883796455,COGS 9,A01,083615,Shannon; Kyle Michael,10,0,75,65
