time,subj_course_id,sec_code,sec_id,prof,available,waitlist,total,enrolled_ct
1657020546984,COGS 9,A01,083615,Shannon; Kyle Michael,7,0,75,68
1657020553013,COGS 11,A01,083617,Boyle; Mary E. T.,20,0,48,28
1657020559053,COGS 13,A01,083071,Bastos; Amalia Pinkusfeld,9,0,71,62
1657020565084,COGS 14A,A01,092681,Semenuks; Arturs,0,1,100,100
1657020571121,COGS 14B,A01,083073,Cheng; Tzu-Han,5,0,63,58
1657020577154,COGS 17,A01,092677,Semenuks; Arturs,4,0,81,77
1657020583183,COGS 100,A01,083619,Allen; Michael Gordon,15,0,70,55
1657020589214,COGS 101A,A01,083621,Davis; Joshua Daniel,9,0,68,59
1657020595264,COGS 101B,A01,091572,Allen; Michael Gordon,8,0,65,57
1657020601294,COGS 101C,A01,083625,Delgado; Tania,17,0,35,18
1657020607324,COGS 107A,A01,083627,Boyle; Mary E. T.,13,0,60,47
1657020613365,COGS 118A,A01,083075,Gupta; Anjum,15,0,76,61
1657020619402,CSE 3,A50,083646,Miranda; Gregory Joseph,22,0,50,28
1657020625434,CSE 8A,A50,083650,Miranda; Gregory Joseph,17,1,56,39
1657020631466,CSE 11,A01,083080,Cao; Yingjun,4,15,40,36
1657020637502,CSE 12,A01,083652,Krause-Levy; Sophia Louisa,21,1,120,99
1657020643539,CSE 15L,A01,083654,Morris; Justin Loren,8,0,50,42
1657020643539,CSE 15L,A02,083655,Morris; Justin Loren,9,0,50,41
1657020649580,CSE 20,A01,083657,Tran; Khoa Dang,37,0,80,43
1657020655609,CSE 21,A01,095574,Bach; Quang Tran,21,0,48,27
1657020661638,CSE 30,A01,083084,Eldon; John,4,0,80,76
1657020661638,CSE 30,B01,095061,Bhaskar; Nishant,6,0,50,44
1657020667665,CSE 100,A01,083659,Cao; Yingjun,3,4,70,67
1657020673700,CSE 134B,A01,083661,Powell; Thomas Allan,19,0,100,81
1657020679727,CSE 140,A01,083663,Gungor; Onat,14,0,85,71
1657020685755,CSE 140L,A01,083088,Eldon; John,16,0,100,84
1657020691788,CSE 175,A01,083665,Kumar; Rakesh,3,0,25,22
1657020697815,CSE 190,A00,092507,Dubnov; Shlomo,7,0,20,13
1657020703856,ECE 45,A01,083139,Congero; Spencer William,5,0,75,70
1657020709896,ECE 65,A50,083695,Saad; Andrew S,12,0,30,18
1657020709896,ECE 65,A51,095125,Saad; Andrew S,25,0,26,1
1657020715926,ECE 109,A01,091882,Touri; Behrouz,16,0,70,54
1657020721972,ECE 180,A00,083140,Abi Samra; Nicholas Camill,1,0,30,29
1657020721972,ECE 180,B00,083141,Abi Samra; Nicholas Camill,0,0,30,30
1657020728004,MATH 10A,A01,083735,Patchell; Gregory David,1,0,30,29
1657020728004,MATH 10A,A02,083736,Patchell; Gregory David,20,0,30,10
1657020728004,MATH 10A,A03,083737,Patchell; Gregory David,16,0,30,14
1657020734047,MATH 10B,A01,083207,Lim; Seonhee,7,0,34,27
1657020734047,MATH 10B,A02,083208,Lim; Seonhee,9,0,35,26
1657020734047,MATH 10B,A03,093472,Lim; Seonhee,4,0,34,30
1657020734047,MATH 10B,B01,083739,Sinha; Shubham,9,0,30,21
1657020740081,MATH 18,A01,083743,Cinel; Cameron Alexander,6,0,30,24
1657020740081,MATH 18,A02,083744,Cinel; Cameron Alexander,15,0,30,15
1657020740081,MATH 18,A03,083745,Cinel; Cameron Alexander,8,0,30,22
1657020740081,MATH 18,B01,083748,Rideout; David Porter,4,0,37,33
1657020740081,MATH 18,B02,083749,Rideout; David Porter,3,0,36,33
1657020740081,MATH 18,B03,083750,Rideout; David Porter,2,0,37,35
1657020740081,MATH 18,B04,083751,Rideout; David Porter,5,0,36,31
1657020740081,MATH 18,B05,093473,Rideout; David Porter,4,0,36,32
1657020740081,MATH 18,B06,093474,Rideout; David Porter,5,0,36,31
1657020746114,MATH 20A,A01,083754,Zheng; Zequn,12,0,40,28
1657020752153,MATH 20B,A01,083756,Briones; Jor-el Thomas Caparas,1,0,36,35
1657020752153,MATH 20B,A02,083757,Briones; Jor-el Thomas Caparas,1,0,36,35
1657020752153,MATH 20B,A03,093475,Briones; Jor-el Thomas Caparas,0,0,36,36
1657020758196,MATH 20C,A01,083760,Briones; Jor-el Thomas Caparas,1,0,35,34
1657020758196,MATH 20C,A02,083761,Briones; Jor-el Thomas Caparas,8,0,35,27
1657020758196,MATH 20C,A03,093476,Briones; Jor-el Thomas Caparas,0,1,36,36
1657020758196,MATH 20C,B01,083762,Bach; Quang Tran,0,0,30,30
1657020764234,MATH 20D,A01,083765,Tran; Brian Kha,4,0,30,26
1657020764234,MATH 20D,A02,083766,Tran; Brian Kha,5,0,30,25
1657020764234,MATH 20D,A03,083767,Tran; Brian Kha,3,0,30,27
1657020770267,MATH 20E,A01,083771,Ganguly; Soumya,5,0,32,27
1657020770267,MATH 20E,A02,083772,Ganguly; Soumya,6,0,32,26
1657020770267,MATH 20E,B01,083773,Ciotti; Benjamin,18,0,35,17
1657020770267,MATH 20E,B02,083774,Ciotti; Benjamin,17,0,35,18
1657020776318,MATH 103A,A01,083777,Greenfeld; Be'Eri,2,0,36,34
1657020776318,MATH 103A,A02,083778,Greenfeld; Be'Eri,5,0,36,31
1657020776318,MATH 103A,A03,093561,Greenfeld; Be'Eri,4,0,36,32
1657020776318,MATH 103A,B01,083779,Greenfeld; Be'Eri,6,0,36,30
1657020776318,MATH 103A,B02,083780,Greenfeld; Be'Eri,2,0,36,34
1657020776318,MATH 103A,B03,093562,Greenfeld; Be'Eri,2,0,36,34
1657020782357,MATH 105,A01,085443,Carter; Anne Toulson,14,0,35,21
1657020782357,MATH 105,A02,093477,Carter; Anne Toulson,20,0,35,15
1657020788408,MATH 109,A01,083213,Ganzberger; Geoffrey Michael,2,0,34,32
1657020788408,MATH 109,A02,083214,Ganzberger; Geoffrey Michael,2,0,34,32
1657020788408,MATH 109,A03,093478,Ganzberger; Geoffrey Michael,1,0,34,33
1657020788408,MATH 109,B01,083215,Ganzberger; Geoffrey Michael,1,0,32,31
1657020788408,MATH 109,B02,083216,Ganzberger; Geoffrey Michael,1,0,32,31
1657020788408,MATH 109,B03,093479,Ganzberger; Geoffrey Michael,6,0,32,26
1657020794437,MATH 142A,A01,083219,Chow; Bennett,6,0,32,26
1657020794437,MATH 142A,A02,083220,Chow; Bennett,10,0,32,22
1657020794437,MATH 142A,A03,093480,Chow; Bennett,7,0,32,25
1657020794437,MATH 142A,B03,093481,Chow; Bennett,7,0,32,25
1657020794437,MATH 142A,B04,093558,Chow; Bennett,11,0,32,21
1657020794437,MATH 142A,B05,093559,Chow; Bennett,6,0,32,26
1657020800474,MATH 193A,A01,083224,Rotar; Vladimir,7,0,34,27
1657020800474,MATH 193A,A02,083225,Rotar; Vladimir,4,0,34,30
1657020800474,MATH 193A,A03,083781,Rotar; Vladimir,1,0,34,33
1657020800474,MATH 193A,A04,083782,Rotar; Vladimir,6,0,34,28
1657020800474,MATH 193A,A05,093482,Rotar; Vladimir,6,0,34,28
1657020806506,MATH 197,001,091859,McAuley; Julian John,9999,0,9999,0
1657020806506,MATH 197,002,095566,Kedlaya; Kiran S.,9997,0,9999,2
1657020806506,MATH 197,003,095567,Xiao; Ming,9999,0,9999,0
1657020806506,MATH 197,004,095571,Perols; Johan Lars,9998,0,9999,1
1657020813580,COGS 9,A01,083615,Shannon; Kyle Michael,7,0,75,68
1657020819618,COGS 11,A01,083617,Boyle; Mary E. T.,20,0,48,28
1657020825645,COGS 13,A01,083071,Bastos; Amalia Pinkusfeld,9,0,71,62
1657020831680,COGS 14A,A01,092681,Semenuks; Arturs,0,1,100,100
1657020837716,COGS 14B,A01,083073,Cheng; Tzu-Han,5,0,63,58
1657020843748,COGS 17,A01,092677,Semenuks; Arturs,4,0,81,77
1657020849782,COGS 100,A01,083619,Allen; Michael Gordon,15,0,70,55
1657020855820,COGS 101A,A01,083621,Davis; Joshua Daniel,9,0,68,59
1657020861876,COGS 101B,A01,091572,Allen; Michael Gordon,8,0,65,57
1657020867924,COGS 101C,A01,083625,Delgado; Tania,17,0,35,18
1657020873957,COGS 107A,A01,083627,Boyle; Mary E. T.,13,0,60,47
1657020879993,COGS 118A,A01,083075,Gupta; Anjum,15,0,76,61
1657020886035,CSE 3,A50,083646,Miranda; Gregory Joseph,22,0,50,28
1657020892061,CSE 8A,A50,083650,Miranda; Gregory Joseph,17,1,56,39
1657020898089,CSE 11,A01,083080,Cao; Yingjun,4,15,40,36
1657020904119,CSE 12,A01,083652,Krause-Levy; Sophia Louisa,21,1,120,99
1657020910147,CSE 15L,A01,083654,Morris; Justin Loren,8,0,50,42
1657020910147,CSE 15L,A02,083655,Morris; Justin Loren,9,0,50,41
1657020916180,CSE 20,A01,083657,Tran; Khoa Dang,37,0,80,43
1657020922208,CSE 21,A01,095574,Bach; Quang Tran,21,0,48,27
1657020928238,CSE 30,A01,083084,Eldon; John,4,0,80,76
1657020928238,CSE 30,B01,095061,Bhaskar; Nishant,6,0,50,44
1657020934272,CSE 100,A01,083659,Cao; Yingjun,3,4,70,67
1657020940310,CSE 134B,A01,083661,Powell; Thomas Allan,19,0,100,81
1657020946341,CSE 140,A01,083663,Gungor; Onat,14,0,85,71
1657020952371,CSE 140L,A01,083088,Eldon; John,16,0,100,84
1657020958402,CSE 175,A01,083665,Kumar; Rakesh,3,0,25,22
1657020964435,CSE 190,A00,092507,Dubnov; Shlomo,7,0,20,13
1657020970479,ECE 45,A01,083139,Congero; Spencer William,5,0,75,70
1657020976508,ECE 65,A50,083695,Saad; Andrew S,12,0,30,18
1657020976508,ECE 65,A51,095125,Saad; Andrew S,25,0,26,1
1657020982548,ECE 109,A01,091882,Touri; Behrouz,16,0,70,54
1657020988592,ECE 180,A00,083140,Abi Samra; Nicholas Camill,1,0,30,29
1657020988592,ECE 180,B00,083141,Abi Samra; Nicholas Camill,0,0,30,30
1657020994626,MATH 10A,A01,083735,Patchell; Gregory David,1,0,30,29
1657020994626,MATH 10A,A02,083736,Patchell; Gregory David,20,0,30,10
1657020994626,MATH 10A,A03,083737,Patchell; Gregory David,16,0,30,14
1657021000661,MATH 10B,A01,083207,Lim; Seonhee,7,0,34,27
1657021000661,MATH 10B,A02,083208,Lim; Seonhee,9,0,35,26
1657021000661,MATH 10B,A03,093472,Lim; Seonhee,4,0,34,30
1657021000661,MATH 10B,B01,083739,Sinha; Shubham,9,0,30,21
1657021006703,MATH 18,A01,083743,Cinel; Cameron Alexander,6,0,30,24
1657021006703,MATH 18,A02,083744,Cinel; Cameron Alexander,15,0,30,15
1657021006703,MATH 18,A03,083745,Cinel; Cameron Alexander,8,0,30,22
1657021006703,MATH 18,B01,083748,Rideout; David Porter,4,0,37,33
1657021006703,MATH 18,B02,083749,Rideout; David Porter,3,0,36,33
1657021006703,MATH 18,B03,083750,Rideout; David Porter,2,0,37,35
1657021006703,MATH 18,B04,083751,Rideout; David Porter,5,0,36,31
1657021006703,MATH 18,B05,093473,Rideout; David Porter,4,0,36,32
1657021006703,MATH 18,B06,093474,Rideout; David Porter,5,0,36,31
1657021012729,MATH 20A,A01,083754,Zheng; Zequn,12,0,40,28
1657021018763,MATH 20B,A01,083756,Briones; Jor-el Thomas Caparas,1,0,36,35
1657021018763,MATH 20B,A02,083757,Briones; Jor-el Thomas Caparas,1,0,36,35
1657021018763,MATH 20B,A03,093475,Briones; Jor-el Thomas Caparas,0,0,36,36
1657021024793,MATH 20C,A01,083760,Briones; Jor-el Thomas Caparas,1,0,35,34
1657021024793,MATH 20C,A02,083761,Briones; Jor-el Thomas Caparas,8,0,35,27
1657021024793,MATH 20C,A03,093476,Briones; Jor-el Thomas Caparas,0,1,36,36
1657021024793,MATH 20C,B01,083762,Bach; Quang Tran,0,0,30,30
1657021030841,MATH 20D,A01,083765,Tran; Brian Kha,4,0,30,26
1657021030841,MATH 20D,A02,083766,Tran; Brian Kha,5,0,30,25
1657021030841,MATH 20D,A03,083767,Tran; Brian Kha,3,0,30,27
1657021036887,MATH 20E,A01,083771,Ganguly; Soumya,5,0,32,27
1657021036887,MATH 20E,A02,083772,Ganguly; Soumya,6,0,32,26
1657021036887,MATH 20E,B01,083773,Ciotti; Benjamin,18,0,35,17
1657021036887,MATH 20E,B02,083774,Ciotti; Benjamin,17,0,35,18
1657021042917,MATH 103A,A01,083777,Greenfeld; Be'Eri,2,0,36,34
1657021042917,MATH 103A,A02,083778,Greenfeld; Be'Eri,5,0,36,31
1657021042917,MATH 103A,A03,093561,Greenfeld; Be'Eri,4,0,36,32
1657021042917,MATH 103A,B01,083779,Greenfeld; Be'Eri,6,0,36,30
1657021042917,MATH 103A,B02,083780,Greenfeld; Be'Eri,2,0,36,34
1657021042917,MATH 103A,B03,093562,Greenfeld; Be'Eri,2,0,36,34
1657021048943,MATH 105,A01,085443,Carter; Anne Toulson,14,0,35,21
1657021048943,MATH 105,A02,093477,Carter; Anne Toulson,20,0,35,15
1657021054989,MATH 109,A01,083213,Ganzberger; Geoffrey Michael,2,0,34,32
1657021054989,MATH 109,A02,083214,Ganzberger; Geoffrey Michael,2,0,34,32
1657021054989,MATH 109,A03,093478,Ganzberger; Geoffrey Michael,1,0,34,33
1657021054989,MATH 109,B01,083215,Ganzberger; Geoffrey Michael,1,0,32,31
1657021054989,MATH 109,B02,083216,Ganzberger; Geoffrey Michael,1,0,32,31
1657021054989,MATH 109,B03,093479,Ganzberger; Geoffrey Michael,6,0,32,26
1657021061047,MATH 142A,A01,083219,Chow; Bennett,6,0,32,26
1657021061047,MATH 142A,A02,083220,Chow; Bennett,10,0,32,22
1657021061047,MATH 142A,A03,093480,Chow; Bennett,7,0,32,25
1657021061047,MATH 142A,B03,093481,Chow; Bennett,7,0,32,25
1657021061047,MATH 142A,B04,093558,Chow; Bennett,11,0,32,21
1657021061047,MATH 142A,B05,093559,Chow; Bennett,6,0,32,26
1657021067075,MATH 193A,A01,083224,Rotar; Vladimir,7,0,34,27
1657021067075,MATH 193A,A02,083225,Rotar; Vladimir,4,0,34,30
1657021067075,MATH 193A,A03,083781,Rotar; Vladimir,1,0,34,33
1657021067075,MATH 193A,A04,083782,Rotar; Vladimir,6,0,34,28
1657021067075,MATH 193A,A05,093482,Rotar; Vladimir,6,0,34,28
1657021073116,MATH 197,001,091859,McAuley; Julian John,9999,0,9999,0
1657021073116,MATH 197,002,095566,Kedlaya; Kiran S.,9997,0,9999,2
1657021073116,MATH 197,003,095567,Xiao; Ming,9999,0,9999,0
1657021073116,MATH 197,004,095571,Perols; Johan Lars,9998,0,9999,1
1657021080227,COGS 9,A01,083615,Shannon; Kyle Michael,7,0,75,68
1657021086257,COGS 11,A01,083617,Boyle; Mary E. T.,20,0,48,28
1657021092292,COGS 13,A01,083071,Bastos; Amalia Pinkusfeld,9,0,71,62
1657021098336,COGS 14A,A01,092681,Semenuks; Arturs,0,1,100,100
1657021104375,COGS 14B,A01,083073,Cheng; Tzu-Han,5,0,63,58
1657021110407,COGS 17,A01,092677,Semenuks; Arturs,4,0,81,77
1657021116450,COGS 100,A01,083619,Allen; Michael Gordon,15,0,70,55
1657021122563,COGS 101A,A01,083621,Davis; Joshua Daniel,9,0,68,59
1657021128598,COGS 101B,A01,091572,Allen; Michael Gordon,8,0,65,57
1657021134636,COGS 101C,A01,083625,Delgado; Tania,17,0,35,18
1657021140669,COGS 107A,A01,083627,Boyle; Mary E. T.,13,0,60,47
1657021146702,COGS 118A,A01,083075,Gupta; Anjum,15,0,76,61
1657021152741,CSE 3,A50,083646,Miranda; Gregory Joseph,22,0,50,28
1657021158777,CSE 8A,A50,083650,Miranda; Gregory Joseph,17,1,56,39
1657021164805,CSE 11,A01,083080,Cao; Yingjun,4,15,40,36
1657021170846,CSE 12,A01,083652,Krause-Levy; Sophia Louisa,21,1,120,99
1657021176875,CSE 15L,A01,083654,Morris; Justin Loren,8,0,50,42
1657021176875,CSE 15L,A02,083655,Morris; Justin Loren,9,0,50,41
1657021182917,CSE 20,A01,083657,Tran; Khoa Dang,37,0,80,43
1657021188945,CSE 21,A01,095574,Bach; Quang Tran,21,0,48,27
1657021194975,CSE 30,A01,083084,Eldon; John,4,0,80,76
1657021194975,CSE 30,B01,095061,Bhaskar; Nishant,6,0,50,44
1657021201001,CSE 100,A01,083659,Cao; Yingjun,3,4,70,67
1657021207047,CSE 134B,A01,083661,Powell; Thomas Allan,19,0,100,81
1657021213081,CSE 140,A01,083663,Gungor; Onat,14,0,85,71
1657021219109,CSE 140L,A01,083088,Eldon; John,16,0,100,84
1657021225141,CSE 175,A01,083665,Kumar; Rakesh,3,0,25,22
1657021231185,CSE 190,A00,092507,Dubnov; Shlomo,7,0,20,13
1657021237228,ECE 45,A01,083139,Congero; Spencer William,5,0,75,70
1657021243254,ECE 65,A50,083695,Saad; Andrew S,12,0,30,18
1657021243254,ECE 65,A51,095125,Saad; Andrew S,25,0,26,1
1657021249292,ECE 109,A01,091882,Touri; Behrouz,16,0,70,54
1657021255319,ECE 180,A00,083140,Abi Samra; Nicholas Camill,1,0,30,29
1657021255319,ECE 180,B00,083141,Abi Samra; Nicholas Camill,0,0,30,30
1657021261348,MATH 10A,A01,083735,Patchell; Gregory David,1,0,30,29
1657021261348,MATH 10A,A02,083736,Patchell; Gregory David,20,0,30,10
1657021261348,MATH 10A,A03,083737,Patchell; Gregory David,16,0,30,14
1657021267394,MATH 10B,A01,083207,Lim; Seonhee,7,0,34,27
1657021267394,MATH 10B,A02,083208,Lim; Seonhee,9,0,35,26
1657021267394,MATH 10B,A03,093472,Lim; Seonhee,4,0,34,30
1657021267394,MATH 10B,B01,083739,Sinha; Shubham,9,0,30,21
1657021273429,MATH 18,A01,083743,Cinel; Cameron Alexander,6,0,30,24
1657021273429,MATH 18,A02,083744,Cinel; Cameron Alexander,15,0,30,15
1657021273429,MATH 18,A03,083745,Cinel; Cameron Alexander,8,0,30,22
1657021273429,MATH 18,B01,083748,Rideout; David Porter,4,0,37,33
1657021273429,MATH 18,B02,083749,Rideout; David Porter,3,0,36,33
1657021273429,MATH 18,B03,083750,Rideout; David Porter,2,0,37,35
1657021273429,MATH 18,B04,083751,Rideout; David Porter,5,0,36,31
1657021273429,MATH 18,B05,093473,Rideout; David Porter,4,0,36,32
1657021273429,MATH 18,B06,093474,Rideout; David Porter,5,0,36,31
1657021279460,MATH 20A,A01,083754,Zheng; Zequn,12,0,40,28
1657021285488,MATH 20B,A01,083756,Briones; Jor-el Thomas Caparas,1,0,36,35
1657021285488,MATH 20B,A02,083757,Briones; Jor-el Thomas Caparas,1,0,36,35
1657021285488,MATH 20B,A03,093475,Briones; Jor-el Thomas Caparas,0,0,36,36
1657021291521,MATH 20C,A01,083760,Briones; Jor-el Thomas Caparas,1,0,35,34
1657021291521,MATH 20C,A02,083761,Briones; Jor-el Thomas Caparas,8,0,35,27
1657021291521,MATH 20C,A03,093476,Briones; Jor-el Thomas Caparas,0,1,36,36
1657021291521,MATH 20C,B01,083762,Bach; Quang Tran,0,0,30,30
1657021297549,MATH 20D,A01,083765,Tran; Brian Kha,4,0,30,26
1657021297549,MATH 20D,A02,083766,Tran; Brian Kha,5,0,30,25
1657021297549,MATH 20D,A03,083767,Tran; Brian Kha,3,0,30,27
1657021303595,MATH 20E,A01,083771,Ganguly; Soumya,5,0,32,27
1657021303595,MATH 20E,A02,083772,Ganguly; Soumya,6,0,32,26
1657021303595,MATH 20E,B01,083773,Ciotti; Benjamin,18,0,35,17
1657021303595,MATH 20E,B02,083774,Ciotti; Benjamin,17,0,35,18
1657021309630,MATH 103A,A01,083777,Greenfeld; Be'Eri,2,0,36,34
1657021309630,MATH 103A,A02,083778,Greenfeld; Be'Eri,5,0,36,31
1657021309630,MATH 103A,A03,093561,Greenfeld; Be'Eri,4,0,36,32
1657021309630,MATH 103A,B01,083779,Greenfeld; Be'Eri,6,0,36,30
1657021309630,MATH 103A,B02,083780,Greenfeld; Be'Eri,2,0,36,34
1657021309630,MATH 103A,B03,093562,Greenfeld; Be'Eri,2,0,36,34
1657021315657,MATH 105,A01,085443,Carter; Anne Toulson,14,0,35,21
1657021315657,MATH 105,A02,093477,Carter; Anne Toulson,20,0,35,15
1657021321683,MATH 109,A01,083213,Ganzberger; Geoffrey Michael,2,0,34,32
1657021321683,MATH 109,A02,083214,Ganzberger; Geoffrey Michael,2,0,34,32
1657021321683,MATH 109,A03,093478,Ganzberger; Geoffrey Michael,1,0,34,33
1657021321683,MATH 109,B01,083215,Ganzberger; Geoffrey Michael,1,0,32,31
1657021321683,MATH 109,B02,083216,Ganzberger; Geoffrey Michael,1,0,32,31
1657021321683,MATH 109,B03,093479,Ganzberger; Geoffrey Michael,6,0,32,26
1657021327714,MATH 142A,A01,083219,Chow; Bennett,6,0,32,26
1657021327714,MATH 142A,A02,083220,Chow; Bennett,10,0,32,22
1657021327714,MATH 142A,A03,093480,Chow; Bennett,7,0,32,25
1657021327714,MATH 142A,B03,093481,Chow; Bennett,7,0,32,25
1657021327714,MATH 142A,B04,093558,Chow; Bennett,11,0,32,21
1657021327714,MATH 142A,B05,093559,Chow; Bennett,6,0,32,26
1657021333748,MATH 193A,A01,083224,Rotar; Vladimir,7,0,34,27
1657021333748,MATH 193A,A02,083225,Rotar; Vladimir,4,0,34,30
1657021333748,MATH 193A,A03,083781,Rotar; Vladimir,1,0,34,33
1657021333748,MATH 193A,A04,083782,Rotar; Vladimir,6,0,34,28
1657021333748,MATH 193A,A05,093482,Rotar; Vladimir,6,0,34,28
1657021339776,MATH 197,001,091859,McAuley; Julian John,9999,0,9999,0
1657021339776,MATH 197,002,095566,Kedlaya; Kiran S.,9997,0,9999,2
1657021339776,MATH 197,003,095567,Xiao; Ming,9999,0,9999,0
1657021339776,MATH 197,004,095571,Perols; Johan Lars,9998,0,9999,1
1657021346863,COGS 9,A01,083615,Shannon; Kyle Michael,7,0,75,68
1657021352898,COGS 11,A01,083617,Boyle; Mary E. T.,20,0,48,28
1657021358926,COGS 13,A01,083071,Bastos; Amalia Pinkusfeld,9,0,71,62
1657021364968,COGS 14A,A01,092681,Semenuks; Arturs,0,1,100,100
1657021371001,COGS 14B,A01,083073,Cheng; Tzu-Han,5,0,63,58
1657021377027,COGS 17,A01,092677,Semenuks; Arturs,4,0,81,77
1657021383055,COGS 100,A01,083619,Allen; Michael Gordon,15,0,70,55
1657021389089,COGS 101A,A01,083621,Davis; Joshua Daniel,9,0,68,59
1657021395116,COGS 101B,A01,091572,Allen; Michael Gordon,8,0,65,57
1657021401145,COGS 101C,A01,083625,Delgado; Tania,17,0,35,18
1657021407172,COGS 107A,A01,083627,Boyle; Mary E. T.,13,0,60,47
1657021413226,COGS 118A,A01,083075,Gupta; Anjum,15,0,76,61
1657021419271,CSE 3,A50,083646,Miranda; Gregory Joseph,22,0,50,28
1657021425326,CSE 8A,A50,083650,Miranda; Gregory Joseph,17,1,56,39
1657021431354,CSE 11,A01,083080,Cao; Yingjun,4,15,40,36
1657021437400,CSE 12,A01,083652,Krause-Levy; Sophia Louisa,21,1,120,99
1657021443436,CSE 15L,A01,083654,Morris; Justin Loren,8,0,50,42
1657021443436,CSE 15L,A02,083655,Morris; Justin Loren,9,0,50,41
1657021449480,CSE 20,A01,083657,Tran; Khoa Dang,37,0,80,43
1657021455518,CSE 21,A01,095574,Bach; Quang Tran,21,0,48,27
1657021461573,CSE 30,A01,083084,Eldon; John,4,0,80,76
1657021461573,CSE 30,B01,095061,Bhaskar; Nishant,6,0,50,44
1657021467621,CSE 100,A01,083659,Cao; Yingjun,3,4,70,67
1657021473653,CSE 134B,A01,083661,Powell; Thomas Allan,19,0,100,81
1657021479690,CSE 140,A01,083663,Gungor; Onat,14,0,85,71
1657021485735,CSE 140L,A01,083088,Eldon; John,16,0,100,84
1657021491766,CSE 175,A01,083665,Kumar; Rakesh,3,0,25,22
1657021497792,CSE 190,A00,092507,Dubnov; Shlomo,7,0,20,13
1657021503819,ECE 45,A01,083139,Congero; Spencer William,5,0,75,70
1657021509868,ECE 65,A50,083695,Saad; Andrew S,12,0,30,18
1657021509868,ECE 65,A51,095125,Saad; Andrew S,25,0,26,1
1657021515897,ECE 109,A01,091882,Touri; Behrouz,16,0,70,54
1657021521934,ECE 180,A00,083140,Abi Samra; Nicholas Camill,1,0,30,29
1657021521934,ECE 180,B00,083141,Abi Samra; Nicholas Camill,0,0,30,30
1657021527964,MATH 10A,A01,083735,Patchell; Gregory David,1,0,30,29
1657021527964,MATH 10A,A02,083736,Patchell; Gregory David,20,0,30,10
1657021527964,MATH 10A,A03,083737,Patchell; Gregory David,16,0,30,14
1657021533997,MATH 10B,A01,083207,Lim; Seonhee,7,0,34,27
1657021533997,MATH 10B,A02,083208,Lim; Seonhee,9,0,35,26
1657021533997,MATH 10B,A03,093472,Lim; Seonhee,4,0,34,30
1657021533997,MATH 10B,B01,083739,Sinha; Shubham,9,0,30,21
1657021540026,MATH 18,A01,083743,Cinel; Cameron Alexander,6,0,30,24
1657021540026,MATH 18,A02,083744,Cinel; Cameron Alexander,15,0,30,15
1657021540026,MATH 18,A03,083745,Cinel; Cameron Alexander,8,0,30,22
1657021540026,MATH 18,B01,083748,Rideout; David Porter,4,0,37,33
1657021540026,MATH 18,B02,083749,Rideout; David Porter,3,0,36,33
1657021540026,MATH 18,B03,083750,Rideout; David Porter,2,0,37,35
1657021540026,MATH 18,B04,083751,Rideout; David Porter,5,0,36,31
1657021540026,MATH 18,B05,093473,Rideout; David Porter,4,0,36,32
1657021540026,MATH 18,B06,093474,Rideout; David Porter,5,0,36,31
1657021546059,MATH 20A,A01,083754,Zheng; Zequn,12,0,40,28
1657021552098,MATH 20B,A01,083756,Briones; Jor-el Thomas Caparas,1,0,36,35
1657021552098,MATH 20B,A02,083757,Briones; Jor-el Thomas Caparas,1,0,36,35
1657021552098,MATH 20B,A03,093475,Briones; Jor-el Thomas Caparas,0,0,36,36
1657021558134,MATH 20C,A01,083760,Briones; Jor-el Thomas Caparas,1,0,35,34
1657021558134,MATH 20C,A02,083761,Briones; Jor-el Thomas Caparas,8,0,35,27
1657021558134,MATH 20C,A03,093476,Briones; Jor-el Thomas Caparas,0,1,36,36
1657021558134,MATH 20C,B01,083762,Bach; Quang Tran,0,0,30,30
1657021564171,MATH 20D,A01,083765,Tran; Brian Kha,4,0,30,26
1657021564171,MATH 20D,A02,083766,Tran; Brian Kha,5,0,30,25
1657021564171,MATH 20D,A03,083767,Tran; Brian Kha,3,0,30,27
1657021570208,MATH 20E,A01,083771,Ganguly; Soumya,5,0,32,27
1657021570208,MATH 20E,A02,083772,Ganguly; Soumya,6,0,32,26
1657021570208,MATH 20E,B01,083773,Ciotti; Benjamin,18,0,35,17
1657021570208,MATH 20E,B02,083774,Ciotti; Benjamin,17,0,35,18
1657021576239,MATH 103A,A01,083777,Greenfeld; Be'Eri,2,0,36,34
1657021576239,MATH 103A,A02,083778,Greenfeld; Be'Eri,5,0,36,31
1657021576239,MATH 103A,A03,093561,Greenfeld; Be'Eri,4,0,36,32
1657021576239,MATH 103A,B01,083779,Greenfeld; Be'Eri,6,0,36,30
1657021576239,MATH 103A,B02,083780,Greenfeld; Be'Eri,2,0,36,34
1657021576239,MATH 103A,B03,093562,Greenfeld; Be'Eri,2,0,36,34
1657021582267,MATH 105,A01,085443,Carter; Anne Toulson,14,0,35,21
1657021582267,MATH 105,A02,093477,Carter; Anne Toulson,20,0,35,15
1657021588308,MATH 109,A01,083213,Ganzberger; Geoffrey Michael,2,0,34,32
1657021588308,MATH 109,A02,083214,Ganzberger; Geoffrey Michael,2,0,34,32
1657021588308,MATH 109,A03,093478,Ganzberger; Geoffrey Michael,1,0,34,33
1657021588308,MATH 109,B01,083215,Ganzberger; Geoffrey Michael,1,0,32,31
1657021588308,MATH 109,B02,083216,Ganzberger; Geoffrey Michael,1,0,32,31
1657021588308,MATH 109,B03,093479,Ganzberger; Geoffrey Michael,6,0,32,26
1657021594339,MATH 142A,A01,083219,Chow; Bennett,6,0,32,26
1657021594339,MATH 142A,A02,083220,Chow; Bennett,10,0,32,22
1657021594339,MATH 142A,A03,093480,Chow; Bennett,7,0,32,25
1657021594339,MATH 142A,B03,093481,Chow; Bennett,7,0,32,25
1657021594339,MATH 142A,B04,093558,Chow; Bennett,11,0,32,21
1657021594339,MATH 142A,B05,093559,Chow; Bennett,6,0,32,26
1657021600379,MATH 193A,A01,083224,Rotar; Vladimir,7,0,34,27
1657021600379,MATH 193A,A02,083225,Rotar; Vladimir,4,0,34,30
1657021600379,MATH 193A,A03,083781,Rotar; Vladimir,1,0,34,33
1657021600379,MATH 193A,A04,083782,Rotar; Vladimir,6,0,34,28
1657021600379,MATH 193A,A05,093482,Rotar; Vladimir,6,0,34,28
1657021606419,MATH 197,001,091859,McAuley; Julian John,9999,0,9999,0
1657021606419,MATH 197,002,095566,Kedlaya; Kiran S.,9997,0,9999,2
1657021606419,MATH 197,003,095567,Xiao; Ming,9999,0,9999,0
1657021606419,MATH 197,004,095571,Perols; Johan Lars,9998,0,9999,1
1657021613493,COGS 9,A01,083615,Shannon; Kyle Michael,7,0,75,68
1657021619524,COGS 11,A01,083617,Boyle; Mary E. T.,20,0,48,28
1657021625555,COGS 13,A01,083071,Bastos; Amalia Pinkusfeld,9,0,71,62
1657021631585,COGS 14A,A01,092681,Semenuks; Arturs,0,1,100,100
1657021637618,COGS 14B,A01,083073,Cheng; Tzu-Han,5,0,63,58
1657021643651,COGS 17,A01,092677,Semenuks; Arturs,4,0,81,77
1657021649681,COGS 100,A01,083619,Allen; Michael Gordon,15,0,70,55
1657021655715,COGS 101A,A01,083621,Davis; Joshua Daniel,9,0,68,59
1657021661748,COGS 101B,A01,091572,Allen; Michael Gordon,8,0,65,57
1657021667786,COGS 101C,A01,083625,Delgado; Tania,17,0,35,18
1657021673813,COGS 107A,A01,083627,Boyle; Mary E. T.,13,0,60,47
1657021679858,COGS 118A,A01,083075,Gupta; Anjum,15,0,76,61
1657021685890,CSE 3,A50,083646,Miranda; Gregory Joseph,22,0,50,28
1657021691915,CSE 8A,A50,083650,Miranda; Gregory Joseph,17,1,56,39
1657021697945,CSE 11,A01,083080,Cao; Yingjun,4,15,40,36
1657021703977,CSE 12,A01,083652,Krause-Levy; Sophia Louisa,21,1,120,99
1657021710003,CSE 15L,A01,083654,Morris; Justin Loren,8,0,50,42
1657021710003,CSE 15L,A02,083655,Morris; Justin Loren,9,0,50,41
1657021716029,CSE 20,A01,083657,Tran; Khoa Dang,37,0,80,43
1657021722164,CSE 21,A01,095574,Bach; Quang Tran,21,0,48,27
1657021728209,CSE 30,A01,083084,Eldon; John,4,0,80,76
1657021728209,CSE 30,B01,095061,Bhaskar; Nishant,6,0,50,44
1657021734242,CSE 100,A01,083659,Cao; Yingjun,3,4,70,67
1657021740267,CSE 134B,A01,083661,Powell; Thomas Allan,19,0,100,81
1657021746303,CSE 140,A01,083663,Gungor; Onat,14,0,85,71
1657021752341,CSE 140L,A01,083088,Eldon; John,16,0,100,84
1657021758368,CSE 175,A01,083665,Kumar; Rakesh,3,0,25,22
1657021764402,CSE 190,A00,092507,Dubnov; Shlomo,7,0,20,13
1657021770440,ECE 45,A01,083139,Congero; Spencer William,5,0,75,70
1657021776469,ECE 65,A50,083695,Saad; Andrew S,12,0,30,18
1657021776469,ECE 65,A51,095125,Saad; Andrew S,25,0,26,1
1657021782502,ECE 109,A01,091882,Touri; Behrouz,16,0,70,54
1657021788534,ECE 180,A00,083140,Abi Samra; Nicholas Camill,1,0,30,29
1657021788534,ECE 180,B00,083141,Abi Samra; Nicholas Camill,0,0,30,30
1657021794563,MATH 10A,A01,083735,Patchell; Gregory David,1,0,30,29
1657021794563,MATH 10A,A02,083736,Patchell; Gregory David,20,0,30,10
1657021794563,MATH 10A,A03,083737,Patchell; Gregory David,16,0,30,14
1657021800605,MATH 10B,A01,083207,Lim; Seonhee,7,0,34,27
1657021800605,MATH 10B,A02,083208,Lim; Seonhee,9,0,35,26
1657021800605,MATH 10B,A03,093472,Lim; Seonhee,4,0,34,30
1657021800605,MATH 10B,B01,083739,Sinha; Shubham,9,0,30,21
1657021806652,MATH 18,A01,083743,Cinel; Cameron Alexander,6,0,30,24
1657021806652,MATH 18,A02,083744,Cinel; Cameron Alexander,15,0,30,15
1657021806652,MATH 18,A03,083745,Cinel; Cameron Alexander,8,0,30,22
1657021806652,MATH 18,B01,083748,Rideout; David Porter,4,0,37,33
1657021806652,MATH 18,B02,083749,Rideout; David Porter,3,0,36,33
1657021806652,MATH 18,B03,083750,Rideout; David Porter,2,0,37,35
1657021806652,MATH 18,B04,083751,Rideout; David Porter,5,0,36,31
1657021806652,MATH 18,B05,093473,Rideout; David Porter,4,0,36,32
1657021806652,MATH 18,B06,093474,Rideout; David Porter,5,0,36,31
1657021812687,MATH 20A,A01,083754,Zheng; Zequn,12,0,40,28
1657021818728,MATH 20B,A01,083756,Briones; Jor-el Thomas Caparas,1,0,36,35
1657021818728,MATH 20B,A02,083757,Briones; Jor-el Thomas Caparas,1,0,36,35
1657021818728,MATH 20B,A03,093475,Briones; Jor-el Thomas Caparas,0,0,36,36
1657021824764,MATH 20C,A01,083760,Briones; Jor-el Thomas Caparas,1,0,35,34
1657021824764,MATH 20C,A02,083761,Briones; Jor-el Thomas Caparas,8,0,35,27
1657021824764,MATH 20C,A03,093476,Briones; Jor-el Thomas Caparas,0,1,36,36
1657021824764,MATH 20C,B01,083762,Bach; Quang Tran,0,0,30,30
1657021830792,MATH 20D,A01,083765,Tran; Brian Kha,4,0,30,26
1657021830792,MATH 20D,A02,083766,Tran; Brian Kha,5,0,30,25
1657021830792,MATH 20D,A03,083767,Tran; Brian Kha,3,0,30,27
1657021836825,MATH 20E,A01,083771,Ganguly; Soumya,5,0,32,27
1657021836825,MATH 20E,A02,083772,Ganguly; Soumya,6,0,32,26
1657021836825,MATH 20E,B01,083773,Ciotti; Benjamin,18,0,35,17
1657021836825,MATH 20E,B02,083774,Ciotti; Benjamin,17,0,35,18
1657021842856,MATH 103A,A01,083777,Greenfeld; Be'Eri,2,0,36,34
1657021842856,MATH 103A,A02,083778,Greenfeld; Be'Eri,5,0,36,31
1657021842856,MATH 103A,A03,093561,Greenfeld; Be'Eri,4,0,36,32
1657021842856,MATH 103A,B01,083779,Greenfeld; Be'Eri,6,0,36,30
1657021842856,MATH 103A,B02,083780,Greenfeld; Be'Eri,2,0,36,34
1657021842856,MATH 103A,B03,093562,Greenfeld; Be'Eri,2,0,36,34
1657021848889,MATH 105,A01,085443,Carter; Anne Toulson,14,0,35,21
1657021848889,MATH 105,A02,093477,Carter; Anne Toulson,20,0,35,15
1657021854950,MATH 109,A01,083213,Ganzberger; Geoffrey Michael,2,0,34,32
1657021854950,MATH 109,A02,083214,Ganzberger; Geoffrey Michael,2,0,34,32
1657021854950,MATH 109,A03,093478,Ganzberger; Geoffrey Michael,1,0,34,33
1657021854950,MATH 109,B01,083215,Ganzberger; Geoffrey Michael,1,0,32,31
1657021854950,MATH 109,B02,083216,Ganzberger; Geoffrey Michael,1,0,32,31
1657021854950,MATH 109,B03,093479,Ganzberger; Geoffrey Michael,6,0,32,26
1657021860995,MATH 142A,A01,083219,Chow; Bennett,6,0,32,26
1657021860995,MATH 142A,A02,083220,Chow; Bennett,10,0,32,22
1657021860995,MATH 142A,A03,093480,Chow; Bennett,7,0,32,25
1657021860995,MATH 142A,B03,093481,Chow; Bennett,7,0,32,25
1657021860995,MATH 142A,B04,093558,Chow; Bennett,11,0,32,21
1657021860995,MATH 142A,B05,093559,Chow; Bennett,6,0,32,26
1657021867042,MATH 193A,A01,083224,Rotar; Vladimir,7,0,34,27
1657021867042,MATH 193A,A02,083225,Rotar; Vladimir,4,0,34,30
1657021867042,MATH 193A,A03,083781,Rotar; Vladimir,1,0,34,33
1657021867042,MATH 193A,A04,083782,Rotar; Vladimir,6,0,34,28
1657021867042,MATH 193A,A05,093482,Rotar; Vladimir,6,0,34,28
1657021873077,MATH 197,001,091859,McAuley; Julian John,9999,0,9999,0
1657021873077,MATH 197,002,095566,Kedlaya; Kiran S.,9997,0,9999,2
1657021873077,MATH 197,003,095567,Xiao; Ming,9999,0,9999,0
1657021873077,MATH 197,004,095571,Perols; Johan Lars,9998,0,9999,1
1657021880161,COGS 9,A01,083615,Shannon; Kyle Michael,7,0,75,68
1657021886196,COGS 11,A01,083617,Boyle; Mary E. T.,20,0,48,28
1657021892223,COGS 13,A01,083071,Bastos; Amalia Pinkusfeld,9,0,71,62
1657021898255,COGS 14A,A01,092681,Semenuks; Arturs,0,1,100,100
1657021904284,COGS 14B,A01,083073,Cheng; Tzu-Han,5,0,63,58
1657021910325,COGS 17,A01,092677,Semenuks; Arturs,4,0,81,77
1657021916361,COGS 100,A01,083619,Allen; Michael Gordon,15,0,70,55
1657021922402,COGS 101A,A01,083621,Davis; Joshua Daniel,9,0,68,59
1657021928433,COGS 101B,A01,091572,Allen; Michael Gordon,8,0,65,57
1657021934465,COGS 101C,A01,083625,Delgado; Tania,17,0,35,18
1657021940509,COGS 107A,A01,083627,Boyle; Mary E. T.,13,0,60,47
1657021946538,COGS 118A,A01,083075,Gupta; Anjum,15,0,76,61
1657021952568,CSE 3,A50,083646,Miranda; Gregory Joseph,22,0,50,28
1657021958602,CSE 8A,A50,083650,Miranda; Gregory Joseph,17,1,56,39
1657021964633,CSE 11,A01,083080,Cao; Yingjun,4,15,40,36
1657021970677,CSE 12,A01,083652,Krause-Levy; Sophia Louisa,21,1,120,99
1657021976723,CSE 15L,A01,083654,Morris; Justin Loren,8,0,50,42
1657021976723,CSE 15L,A02,083655,Morris; Justin Loren,9,0,50,41
1657021982772,CSE 20,A01,083657,Tran; Khoa Dang,37,0,80,43
1657021988807,CSE 21,A01,095574,Bach; Quang Tran,21,0,48,27
1657021994847,CSE 30,A01,083084,Eldon; John,4,0,80,76
1657021994847,CSE 30,B01,095061,Bhaskar; Nishant,6,0,50,44
1657022000880,CSE 100,A01,083659,Cao; Yingjun,3,4,70,67
1657022006909,CSE 134B,A01,083661,Powell; Thomas Allan,19,0,100,81
1657022012942,CSE 140,A01,083663,Gungor; Onat,14,0,85,71
1657022018969,CSE 140L,A01,083088,Eldon; John,16,0,100,84
1657022025004,CSE 175,A01,083665,Kumar; Rakesh,3,0,25,22
1657022031047,CSE 190,A00,092507,Dubnov; Shlomo,7,0,20,13
1657022037086,ECE 45,A01,083139,Congero; Spencer William,5,0,75,70
1657022043151,ECE 65,A50,083695,Saad; Andrew S,12,0,30,18
1657022043151,ECE 65,A51,095125,Saad; Andrew S,25,0,26,1
1657022049185,ECE 109,A01,091882,Touri; Behrouz,16,0,70,54
1657022055217,ECE 180,A00,083140,Abi Samra; Nicholas Camill,1,0,30,29
1657022055217,ECE 180,B00,083141,Abi Samra; Nicholas Camill,0,0,30,30
1657022061246,MATH 10A,A01,083735,Patchell; Gregory David,1,0,30,29
1657022061246,MATH 10A,A02,083736,Patchell; Gregory David,20,0,30,10
1657022061246,MATH 10A,A03,083737,Patchell; Gregory David,16,0,30,14
1657022067285,MATH 10B,A01,083207,Lim; Seonhee,7,0,34,27
1657022067285,MATH 10B,A02,083208,Lim; Seonhee,9,0,35,26
1657022067285,MATH 10B,A03,093472,Lim; Seonhee,4,0,34,30
1657022067285,MATH 10B,B01,083739,Sinha; Shubham,9,0,30,21
1657022073329,MATH 18,A01,083743,Cinel; Cameron Alexander,6,0,30,24
1657022073329,MATH 18,A02,083744,Cinel; Cameron Alexander,15,0,30,15
1657022073329,MATH 18,A03,083745,Cinel; Cameron Alexander,8,0,30,22
1657022073329,MATH 18,B01,083748,Rideout; David Porter,4,0,37,33
1657022073329,MATH 18,B02,083749,Rideout; David Porter,3,0,36,33
1657022073329,MATH 18,B03,083750,Rideout; David Porter,2,0,37,35
1657022073329,MATH 18,B04,083751,Rideout; David Porter,5,0,36,31
1657022073329,MATH 18,B05,093473,Rideout; David Porter,4,0,36,32
1657022073329,MATH 18,B06,093474,Rideout; David Porter,5,0,36,31
1657022079361,MATH 20A,A01,083754,Zheng; Zequn,12,0,40,28
1657022085389,MATH 20B,A01,083756,Briones; Jor-el Thomas Caparas,1,0,36,35
1657022085389,MATH 20B,A02,083757,Briones; Jor-el Thomas Caparas,1,0,36,35
1657022085389,MATH 20B,A03,093475,Briones; Jor-el Thomas Caparas,0,0,36,36
1657022091431,MATH 20C,A01,083760,Briones; Jor-el Thomas Caparas,1,0,35,34
1657022091431,MATH 20C,A02,083761,Briones; Jor-el Thomas Caparas,8,0,35,27
1657022091431,MATH 20C,A03,093476,Briones; Jor-el Thomas Caparas,0,1,36,36
1657022091431,MATH 20C,B01,083762,Bach; Quang Tran,0,0,30,30
1657022097484,MATH 20D,A01,083765,Tran; Brian Kha,4,0,30,26
1657022097484,MATH 20D,A02,083766,Tran; Brian Kha,5,0,30,25
1657022097484,MATH 20D,A03,083767,Tran; Brian Kha,3,0,30,27
1657022103526,MATH 20E,A01,083771,Ganguly; Soumya,5,0,32,27
1657022103526,MATH 20E,A02,083772,Ganguly; Soumya,6,0,32,26
1657022103526,MATH 20E,B01,083773,Ciotti; Benjamin,18,0,35,17
1657022103526,MATH 20E,B02,083774,Ciotti; Benjamin,17,0,35,18
1657022109562,MATH 103A,A01,083777,Greenfeld; Be'Eri,2,0,36,34
1657022109562,MATH 103A,A02,083778,Greenfeld; Be'Eri,5,0,36,31
1657022109562,MATH 103A,A03,093561,Greenfeld; Be'Eri,4,0,36,32
1657022109562,MATH 103A,B01,083779,Greenfeld; Be'Eri,6,0,36,30
1657022109562,MATH 103A,B02,083780,Greenfeld; Be'Eri,2,0,36,34
1657022109562,MATH 103A,B03,093562,Greenfeld; Be'Eri,2,0,36,34
1657022115590,MATH 105,A01,085443,Carter; Anne Toulson,14,0,35,21
1657022115590,MATH 105,A02,093477,Carter; Anne Toulson,20,0,35,15
1657022121623,MATH 109,A01,083213,Ganzberger; Geoffrey Michael,2,0,34,32
1657022121623,MATH 109,A02,083214,Ganzberger; Geoffrey Michael,2,0,34,32
1657022121623,MATH 109,A03,093478,Ganzberger; Geoffrey Michael,1,0,34,33
1657022121623,MATH 109,B01,083215,Ganzberger; Geoffrey Michael,1,0,32,31
1657022121623,MATH 109,B02,083216,Ganzberger; Geoffrey Michael,1,0,32,31
1657022121623,MATH 109,B03,093479,Ganzberger; Geoffrey Michael,6,0,32,26
1657022127660,MATH 142A,A01,083219,Chow; Bennett,6,0,32,26
1657022127660,MATH 142A,A02,083220,Chow; Bennett,10,0,32,22
1657022127660,MATH 142A,A03,093480,Chow; Bennett,7,0,32,25
1657022127660,MATH 142A,B03,093481,Chow; Bennett,7,0,32,25
1657022127660,MATH 142A,B04,093558,Chow; Bennett,11,0,32,21
1657022127660,MATH 142A,B05,093559,Chow; Bennett,6,0,32,26
1657022133710,MATH 193A,A01,083224,Rotar; Vladimir,7,0,34,27
1657022133710,MATH 193A,A02,083225,Rotar; Vladimir,4,0,34,30
1657022133710,MATH 193A,A03,083781,Rotar; Vladimir,1,0,34,33
1657022133710,MATH 193A,A04,083782,Rotar; Vladimir,6,0,34,28
1657022133710,MATH 193A,A05,093482,Rotar; Vladimir,6,0,34,28
1657022139742,MATH 197,001,091859,McAuley; Julian John,9999,0,9999,0
1657022139742,MATH 197,002,095566,Kedlaya; Kiran S.,9997,0,9999,2
1657022139742,MATH 197,003,095567,Xiao; Ming,9999,0,9999,0
1657022139742,MATH 197,004,095571,Perols; Johan Lars,9998,0,9999,1
1657022146828,COGS 9,A01,083615,Shannon; Kyle Michael,7,0,75,68
1657022152860,COGS 11,A01,083617,Boyle; Mary E. T.,20,0,48,28
1657022158886,COGS 13,A01,083071,Bastos; Amalia Pinkusfeld,9,0,71,62
1657022164921,COGS 14A,A01,092681,Semenuks; Arturs,0,1,100,100
1657022170952,COGS 14B,A01,083073,Cheng; Tzu-Han,5,0,63,58
1657022176979,COGS 17,A01,092677,Semenuks; Arturs,4,0,81,77
1657022183007,COGS 100,A01,083619,Allen; Michael Gordon,15,0,70,55
1657022189041,COGS 101A,A01,083621,Davis; Joshua Daniel,9,0,68,59
1657022195066,COGS 101B,A01,091572,Allen; Michael Gordon,8,0,65,57
1657022201095,COGS 101C,A01,083625,Delgado; Tania,17,0,35,18
1657022207125,COGS 107A,A01,083627,Boyle; Mary E. T.,13,0,60,47
1657022213159,COGS 118A,A01,083075,Gupta; Anjum,15,0,76,61
1657022219205,CSE 3,A50,083646,Miranda; Gregory Joseph,22,0,50,28
1657022225244,CSE 8A,A50,083650,Miranda; Gregory Joseph,17,1,56,39
1657022231278,CSE 11,A01,083080,Cao; Yingjun,4,15,40,36
1657022237315,CSE 12,A01,083652,Krause-Levy; Sophia Louisa,21,1,120,99
1657022243343,CSE 15L,A01,083654,Morris; Justin Loren,8,0,50,42
1657022243343,CSE 15L,A02,083655,Morris; Justin Loren,9,0,50,41
1657022249375,CSE 20,A01,083657,Tran; Khoa Dang,37,0,80,43
1657022255413,CSE 21,A01,095574,Bach; Quang Tran,21,0,48,27
1657022261446,CSE 30,A01,083084,Eldon; John,4,0,80,76
1657022261446,CSE 30,B01,095061,Bhaskar; Nishant,6,0,50,44
1657022267475,CSE 100,A01,083659,Cao; Yingjun,3,4,70,67
1657022273500,CSE 134B,A01,083661,Powell; Thomas Allan,19,0,100,81
1657022279536,CSE 140,A01,083663,Gungor; Onat,14,0,85,71
1657022285564,CSE 140L,A01,083088,Eldon; John,16,0,100,84
1657022291593,CSE 175,A01,083665,Kumar; Rakesh,3,0,25,22
1657022297623,CSE 190,A00,092507,Dubnov; Shlomo,7,0,20,13
1657022303661,ECE 45,A01,083139,Congero; Spencer William,5,0,75,70
1657022309704,ECE 65,A50,083695,Saad; Andrew S,12,0,30,18
1657022309704,ECE 65,A51,095125,Saad; Andrew S,25,0,26,1
1657022315746,ECE 109,A01,091882,Touri; Behrouz,16,0,70,54
1657022321897,ECE 180,A00,083140,Abi Samra; Nicholas Camill,1,0,30,29
1657022321897,ECE 180,B00,083141,Abi Samra; Nicholas Camill,0,0,30,30
1657022327936,MATH 10A,A01,083735,Patchell; Gregory David,1,0,30,29
1657022327936,MATH 10A,A02,083736,Patchell; Gregory David,20,0,30,10
1657022327936,MATH 10A,A03,083737,Patchell; Gregory David,16,0,30,14
1657022333980,MATH 10B,A01,083207,Lim; Seonhee,7,0,34,27
1657022333980,MATH 10B,A02,083208,Lim; Seonhee,9,0,35,26
1657022333980,MATH 10B,A03,093472,Lim; Seonhee,4,0,34,30
1657022333980,MATH 10B,B01,083739,Sinha; Shubham,9,0,30,21
1657022340012,MATH 18,A01,083743,Cinel; Cameron Alexander,6,0,30,24
1657022340012,MATH 18,A02,083744,Cinel; Cameron Alexander,15,0,30,15
1657022340012,MATH 18,A03,083745,Cinel; Cameron Alexander,8,0,30,22
1657022340012,MATH 18,B01,083748,Rideout; David Porter,4,0,37,33
1657022340012,MATH 18,B02,083749,Rideout; David Porter,3,0,36,33
1657022340012,MATH 18,B03,083750,Rideout; David Porter,2,0,37,35
1657022340012,MATH 18,B04,083751,Rideout; David Porter,5,0,36,31
1657022340012,MATH 18,B05,093473,Rideout; David Porter,4,0,36,32
1657022340012,MATH 18,B06,093474,Rideout; David Porter,5,0,36,31
1657022346044,MATH 20A,A01,083754,Zheng; Zequn,12,0,40,28
1657022352073,MATH 20B,A01,083756,Briones; Jor-el Thomas Caparas,1,0,36,35
1657022352073,MATH 20B,A02,083757,Briones; Jor-el Thomas Caparas,1,0,36,35
1657022352073,MATH 20B,A03,093475,Briones; Jor-el Thomas Caparas,0,0,36,36
1657022358109,MATH 20C,A01,083760,Briones; Jor-el Thomas Caparas,1,0,35,34
1657022358109,MATH 20C,A02,083761,Briones; Jor-el Thomas Caparas,8,0,35,27
1657022358109,MATH 20C,A03,093476,Briones; Jor-el Thomas Caparas,0,1,36,36
1657022358109,MATH 20C,B01,083762,Bach; Quang Tran,0,0,30,30
1657022364145,MATH 20D,A01,083765,Tran; Brian Kha,4,0,30,26
1657022364145,MATH 20D,A02,083766,Tran; Brian Kha,5,0,30,25
1657022364145,MATH 20D,A03,083767,Tran; Brian Kha,3,0,30,27
1657022370206,MATH 20E,A01,083771,Ganguly; Soumya,5,0,32,27
1657022370206,MATH 20E,A02,083772,Ganguly; Soumya,6,0,32,26
1657022370206,MATH 20E,B01,083773,Ciotti; Benjamin,18,0,35,17
1657022370206,MATH 20E,B02,083774,Ciotti; Benjamin,17,0,35,18
1657022376245,MATH 103A,A01,083777,Greenfeld; Be'Eri,2,0,36,34
1657022376245,MATH 103A,A02,083778,Greenfeld; Be'Eri,5,0,36,31
1657022376245,MATH 103A,A03,093561,Greenfeld; Be'Eri,4,0,36,32
1657022376245,MATH 103A,B01,083779,Greenfeld; Be'Eri,6,0,36,30
1657022376245,MATH 103A,B02,083780,Greenfeld; Be'Eri,2,0,36,34
1657022376245,MATH 103A,B03,093562,Greenfeld; Be'Eri,2,0,36,34
1657022382273,MATH 105,A01,085443,Carter; Anne Toulson,14,0,35,21
1657022382273,MATH 105,A02,093477,Carter; Anne Toulson,20,0,35,15
1657022388301,MATH 109,A01,083213,Ganzberger; Geoffrey Michael,2,0,34,32
1657022388301,MATH 109,A02,083214,Ganzberger; Geoffrey Michael,2,0,34,32
1657022388301,MATH 109,A03,093478,Ganzberger; Geoffrey Michael,1,0,34,33
1657022388301,MATH 109,B01,083215,Ganzberger; Geoffrey Michael,1,0,32,31
1657022388301,MATH 109,B02,083216,Ganzberger; Geoffrey Michael,1,0,32,31
1657022388301,MATH 109,B03,093479,Ganzberger; Geoffrey Michael,6,0,32,26
1657022394348,MATH 142A,A01,083219,Chow; Bennett,6,0,32,26
1657022394348,MATH 142A,A02,083220,Chow; Bennett,10,0,32,22
1657022394348,MATH 142A,A03,093480,Chow; Bennett,7,0,32,25
1657022394348,MATH 142A,B03,093481,Chow; Bennett,7,0,32,25
1657022394348,MATH 142A,B04,093558,Chow; Bennett,11,0,32,21
1657022394348,MATH 142A,B05,093559,Chow; Bennett,6,0,32,26
1657022400378,MATH 193A,A01,083224,Rotar; Vladimir,7,0,34,27
1657022400378,MATH 193A,A02,083225,Rotar; Vladimir,4,0,34,30
1657022400378,MATH 193A,A03,083781,Rotar; Vladimir,1,0,34,33
1657022400378,MATH 193A,A04,083782,Rotar; Vladimir,6,0,34,28
1657022400378,MATH 193A,A05,093482,Rotar; Vladimir,6,0,34,28
1657022406404,MATH 197,001,091859,McAuley; Julian John,9999,0,9999,0
1657022406404,MATH 197,002,095566,Kedlaya; Kiran S.,9997,0,9999,2
1657022406404,MATH 197,003,095567,Xiao; Ming,9999,0,9999,0
1657022406404,MATH 197,004,095571,Perols; Johan Lars,9998,0,9999,1
1657022413488,COGS 9,A01,083615,Shannon; Kyle Michael,7,0,75,68
1657022419516,COGS 11,A01,083617,Boyle; Mary E. T.,20,0,48,28
1657022425552,COGS 13,A01,083071,Bastos; Amalia Pinkusfeld,9,0,71,62
1657022431580,COGS 14A,A01,092681,Semenuks; Arturs,0,1,100,100
1657022437602,COGS 14B,A01,083073,Cheng; Tzu-Han,5,0,63,58
1657022443630,COGS 17,A01,092677,Semenuks; Arturs,4,0,81,77
1657022449663,COGS 100,A01,083619,Allen; Michael Gordon,15,0,70,55
1657022455693,COGS 101A,A01,083621,Davis; Joshua Daniel,9,0,68,59
1657022461722,COGS 101B,A01,091572,Allen; Michael Gordon,8,0,65,57
1657022467747,COGS 101C,A01,083625,Delgado; Tania,17,0,35,18
1657022473777,COGS 107A,A01,083627,Boyle; Mary E. T.,13,0,60,47
1657022479807,COGS 118A,A01,083075,Gupta; Anjum,15,0,76,61
1657022485834,CSE 3,A50,083646,Miranda; Gregory Joseph,22,0,50,28
1657022491862,CSE 8A,A50,083650,Miranda; Gregory Joseph,17,1,56,39
1657022497898,CSE 11,A01,083080,Cao; Yingjun,4,15,40,36
1657022504111,CSE 12,A01,083652,Krause-Levy; Sophia Louisa,21,1,120,99
1657022510142,CSE 15L,A01,083654,Morris; Justin Loren,8,0,50,42
1657022510142,CSE 15L,A02,083655,Morris; Justin Loren,9,0,50,41
1657022516349,CSE 20,A01,083657,Tran; Khoa Dang,37,0,80,43
1657022522375,CSE 21,A01,095574,Bach; Quang Tran,21,0,48,27
1657022528442,CSE 30,A01,083084,Eldon; John,4,0,80,76
1657022528442,CSE 30,B01,095061,Bhaskar; Nishant,6,0,50,44
1657022534471,CSE 100,A01,083659,Cao; Yingjun,3,4,70,67
1657022540501,CSE 134B,A01,083661,Powell; Thomas Allan,19,0,100,81
1657022546548,CSE 140,A01,083663,Gungor; Onat,14,0,85,71
1657022552576,CSE 140L,A01,083088,Eldon; John,16,0,100,84
1657022558599,CSE 175,A01,083665,Kumar; Rakesh,3,0,25,22
1657022564632,CSE 190,A00,092507,Dubnov; Shlomo,7,0,20,13
1657022570659,ECE 45,A01,083139,Congero; Spencer William,5,0,75,70
1657022576687,ECE 65,A50,083695,Saad; Andrew S,12,0,30,18
1657022576687,ECE 65,A51,095125,Saad; Andrew S,25,0,26,1
1657022582713,ECE 109,A01,091882,Touri; Behrouz,16,0,70,54
1657022588745,ECE 180,A00,083140,Abi Samra; Nicholas Camill,1,0,30,29
1657022588745,ECE 180,B00,083141,Abi Samra; Nicholas Camill,0,0,30,30
1657022594772,MATH 10A,A01,083735,Patchell; Gregory David,1,0,30,29
1657022594772,MATH 10A,A02,083736,Patchell; Gregory David,20,0,30,10
1657022594772,MATH 10A,A03,083737,Patchell; Gregory David,16,0,30,14
1657022600834,MATH 10B,A01,083207,Lim; Seonhee,7,0,34,27
1657022600834,MATH 10B,A02,083208,Lim; Seonhee,9,0,35,26
1657022600834,MATH 10B,A03,093472,Lim; Seonhee,4,0,34,30
1657022600834,MATH 10B,B01,083739,Sinha; Shubham,9,0,30,21
1657022606866,MATH 18,A01,083743,Cinel; Cameron Alexander,6,0,30,24
1657022606866,MATH 18,A02,083744,Cinel; Cameron Alexander,15,0,30,15
1657022606866,MATH 18,A03,083745,Cinel; Cameron Alexander,8,0,30,22
1657022606866,MATH 18,B01,083748,Rideout; David Porter,4,0,37,33
1657022606866,MATH 18,B02,083749,Rideout; David Porter,3,0,36,33
1657022606866,MATH 18,B03,083750,Rideout; David Porter,2,0,37,35
1657022606866,MATH 18,B04,083751,Rideout; David Porter,5,0,36,31
1657022606866,MATH 18,B05,093473,Rideout; David Porter,4,0,36,32
1657022606866,MATH 18,B06,093474,Rideout; David Porter,5,0,36,31
1657022612896,MATH 20A,A01,083754,Zheng; Zequn,12,0,40,28
1657022618935,MATH 20B,A01,083756,Briones; Jor-el Thomas Caparas,1,0,36,35
1657022618935,MATH 20B,A02,083757,Briones; Jor-el Thomas Caparas,1,0,36,35
1657022618935,MATH 20B,A03,093475,Briones; Jor-el Thomas Caparas,0,0,36,36
1657022624964,MATH 20C,A01,083760,Briones; Jor-el Thomas Caparas,1,0,35,34
1657022624964,MATH 20C,A02,083761,Briones; Jor-el Thomas Caparas,8,0,35,27
1657022624964,MATH 20C,A03,093476,Briones; Jor-el Thomas Caparas,0,1,36,36
1657022624964,MATH 20C,B01,083762,Bach; Quang Tran,0,0,30,30
1657022630993,MATH 20D,A01,083765,Tran; Brian Kha,4,0,30,26
1657022630993,MATH 20D,A02,083766,Tran; Brian Kha,5,0,30,25
1657022630993,MATH 20D,A03,083767,Tran; Brian Kha,3,0,30,27
1657022637023,MATH 20E,A01,083771,Ganguly; Soumya,5,0,32,27
1657022637023,MATH 20E,A02,083772,Ganguly; Soumya,6,0,32,26
1657022637023,MATH 20E,B01,083773,Ciotti; Benjamin,18,0,35,17
1657022637023,MATH 20E,B02,083774,Ciotti; Benjamin,17,0,35,18
1657022643066,MATH 103A,A01,083777,Greenfeld; Be'Eri,2,0,36,34
1657022643066,MATH 103A,A02,083778,Greenfeld; Be'Eri,5,0,36,31
1657022643066,MATH 103A,A03,093561,Greenfeld; Be'Eri,4,0,36,32
1657022643066,MATH 103A,B01,083779,Greenfeld; Be'Eri,6,0,36,30
1657022643066,MATH 103A,B02,083780,Greenfeld; Be'Eri,2,0,36,34
1657022643066,MATH 103A,B03,093562,Greenfeld; Be'Eri,2,0,36,34
1657022649099,MATH 105,A01,085443,Carter; Anne Toulson,14,0,35,21
1657022649099,MATH 105,A02,093477,Carter; Anne Toulson,20,0,35,15
1657022655125,MATH 109,A01,083213,Ganzberger; Geoffrey Michael,2,0,34,32
1657022655125,MATH 109,A02,083214,Ganzberger; Geoffrey Michael,2,0,34,32
1657022655125,MATH 109,A03,093478,Ganzberger; Geoffrey Michael,1,0,34,33
1657022655125,MATH 109,B01,083215,Ganzberger; Geoffrey Michael,1,0,32,31
1657022655125,MATH 109,B02,083216,Ganzberger; Geoffrey Michael,1,0,32,31
1657022655125,MATH 109,B03,093479,Ganzberger; Geoffrey Michael,6,0,32,26
1657022661156,MATH 142A,A01,083219,Chow; Bennett,6,0,32,26
1657022661156,MATH 142A,A02,083220,Chow; Bennett,10,0,32,22
1657022661156,MATH 142A,A03,093480,Chow; Bennett,7,0,32,25
1657022661156,MATH 142A,B03,093481,Chow; Bennett,7,0,32,25
1657022661156,MATH 142A,B04,093558,Chow; Bennett,11,0,32,21
1657022661156,MATH 142A,B05,093559,Chow; Bennett,6,0,32,26
1657022667415,MATH 193A,A01,083224,Rotar; Vladimir,7,0,34,27
1657022667415,MATH 193A,A02,083225,Rotar; Vladimir,4,0,34,30
1657022667415,MATH 193A,A03,083781,Rotar; Vladimir,1,0,34,33
1657022667415,MATH 193A,A04,083782,Rotar; Vladimir,6,0,34,28
1657022667415,MATH 193A,A05,093482,Rotar; Vladimir,6,0,34,28
1657022673441,MATH 197,001,091859,McAuley; Julian John,9999,0,9999,0
1657022673441,MATH 197,002,095566,Kedlaya; Kiran S.,9997,0,9999,2
1657022673441,MATH 197,003,095567,Xiao; Ming,9999,0,9999,0
1657022673441,MATH 197,004,095571,Perols; Johan Lars,9998,0,9999,1
1657022680516,COGS 9,A01,083615,Shannon; Kyle Michael,7,0,75,68
1657022686550,COGS 11,A01,083617,Boyle; Mary E. T.,20,0,48,28
1657022692581,COGS 13,A01,083071,Bastos; Amalia Pinkusfeld,9,0,71,62
1657022698615,COGS 14A,A01,092681,Semenuks; Arturs,0,1,100,100
1657022704647,COGS 14B,A01,083073,Cheng; Tzu-Han,5,0,63,58
1657022710673,COGS 17,A01,092677,Semenuks; Arturs,4,0,81,77
1657022716704,COGS 100,A01,083619,Allen; Michael Gordon,15,0,70,55
1657022722730,COGS 101A,A01,083621,Davis; Joshua Daniel,9,0,68,59
1657022728761,COGS 101B,A01,091572,Allen; Michael Gordon,8,0,65,57
1657022734799,COGS 101C,A01,083625,Delgado; Tania,17,0,35,18
1657022740835,COGS 107A,A01,083627,Boyle; Mary E. T.,13,0,60,47
1657022746868,COGS 118A,A01,083075,Gupta; Anjum,15,0,76,61
1657022752906,CSE 3,A50,083646,Miranda; Gregory Joseph,22,0,50,28
1657022758932,CSE 8A,A50,083650,Miranda; Gregory Joseph,17,1,56,39
1657022764966,CSE 11,A01,083080,Cao; Yingjun,4,15,40,36
1657022770993,CSE 12,A01,083652,Krause-Levy; Sophia Louisa,21,1,120,99
1657022777022,CSE 15L,A01,083654,Morris; Justin Loren,8,0,50,42
1657022777022,CSE 15L,A02,083655,Morris; Justin Loren,9,0,50,41
1657022783057,CSE 20,A01,083657,Tran; Khoa Dang,37,0,80,43
1657022789083,CSE 21,A01,095574,Bach; Quang Tran,21,0,48,27
1657022795120,CSE 30,A01,083084,Eldon; John,4,0,80,76
1657022795120,CSE 30,B01,095061,Bhaskar; Nishant,6,0,50,44
1657022801170,CSE 100,A01,083659,Cao; Yingjun,3,4,70,67
1657022807199,CSE 134B,A01,083661,Powell; Thomas Allan,19,0,100,81
1657022813227,CSE 140,A01,083663,Gungor; Onat,14,0,85,71
1657022819254,CSE 140L,A01,083088,Eldon; John,16,0,100,84
1657022825284,CSE 175,A01,083665,Kumar; Rakesh,3,0,25,22
1657022831317,CSE 190,A00,092507,Dubnov; Shlomo,7,0,20,13
1657022837345,ECE 45,A01,083139,Congero; Spencer William,5,0,75,70
1657022843375,ECE 65,A50,083695,Saad; Andrew S,12,0,30,18
1657022843375,ECE 65,A51,095125,Saad; Andrew S,25,0,26,1
1657022849413,ECE 109,A01,091882,Touri; Behrouz,16,0,70,54
1657022855439,ECE 180,A00,083140,Abi Samra; Nicholas Camill,1,0,30,29
1657022855439,ECE 180,B00,083141,Abi Samra; Nicholas Camill,0,0,30,30
1657022861476,MATH 10A,A01,083735,Patchell; Gregory David,1,0,30,29
1657022861476,MATH 10A,A02,083736,Patchell; Gregory David,20,0,30,10
1657022861476,MATH 10A,A03,083737,Patchell; Gregory David,16,0,30,14
1657022867505,MATH 10B,A01,083207,Lim; Seonhee,7,0,34,27
1657022867505,MATH 10B,A02,083208,Lim; Seonhee,9,0,35,26
1657022867505,MATH 10B,A03,093472,Lim; Seonhee,4,0,34,30
1657022867505,MATH 10B,B01,083739,Sinha; Shubham,9,0,30,21
1657022873536,MATH 18,A01,083743,Cinel; Cameron Alexander,6,0,30,24
1657022873536,MATH 18,A02,083744,Cinel; Cameron Alexander,15,0,30,15
1657022873536,MATH 18,A03,083745,Cinel; Cameron Alexander,8,0,30,22
1657022873536,MATH 18,B01,083748,Rideout; David Porter,4,0,37,33
1657022873536,MATH 18,B02,083749,Rideout; David Porter,3,0,36,33
1657022873536,MATH 18,B03,083750,Rideout; David Porter,2,0,37,35
1657022873536,MATH 18,B04,083751,Rideout; David Porter,5,0,36,31
1657022873536,MATH 18,B05,093473,Rideout; David Porter,4,0,36,32
1657022873536,MATH 18,B06,093474,Rideout; David Porter,5,0,36,31
1657022879574,MATH 20A,A01,083754,Zheng; Zequn,12,0,40,28
1657022885600,MATH 20B,A01,083756,Briones; Jor-el Thomas Caparas,1,0,36,35
1657022885600,MATH 20B,A02,083757,Briones; Jor-el Thomas Caparas,1,0,36,35
1657022885600,MATH 20B,A03,093475,Briones; Jor-el Thomas Caparas,0,0,36,36
1657022891635,MATH 20C,A01,083760,Briones; Jor-el Thomas Caparas,1,0,35,34
1657022891635,MATH 20C,A02,083761,Briones; Jor-el Thomas Caparas,8,0,35,27
1657022891635,MATH 20C,A03,093476,Briones; Jor-el Thomas Caparas,0,1,36,36
1657022891635,MATH 20C,B01,083762,Bach; Quang Tran,0,0,30,30
1657022897660,MATH 20D,A01,083765,Tran; Brian Kha,4,0,30,26
1657022897660,MATH 20D,A02,083766,Tran; Brian Kha,5,0,30,25
1657022897660,MATH 20D,A03,083767,Tran; Brian Kha,3,0,30,27
1657022903695,MATH 20E,A01,083771,Ganguly; Soumya,5,0,32,27
1657022903695,MATH 20E,A02,083772,Ganguly; Soumya,6,0,32,26
1657022903695,MATH 20E,B01,083773,Ciotti; Benjamin,18,0,35,17
1657022903695,MATH 20E,B02,083774,Ciotti; Benjamin,17,0,35,18
1657022909732,MATH 103A,A01,083777,Greenfeld; Be'Eri,2,0,36,34
1657022909732,MATH 103A,A02,083778,Greenfeld; Be'Eri,5,0,36,31
1657022909732,MATH 103A,A03,093561,Greenfeld; Be'Eri,4,0,36,32
1657022909732,MATH 103A,B01,083779,Greenfeld; Be'Eri,6,0,36,30
1657022909732,MATH 103A,B02,083780,Greenfeld; Be'Eri,2,0,36,34
1657022909732,MATH 103A,B03,093562,Greenfeld; Be'Eri,2,0,36,34
1657022915767,MATH 105,A01,085443,Carter; Anne Toulson,14,0,35,21
1657022915767,MATH 105,A02,093477,Carter; Anne Toulson,20,0,35,15
1657022921889,MATH 109,A01,083213,Ganzberger; Geoffrey Michael,2,0,34,32
1657022921889,MATH 109,A02,083214,Ganzberger; Geoffrey Michael,2,0,34,32
1657022921889,MATH 109,A03,093478,Ganzberger; Geoffrey Michael,1,0,34,33
1657022921889,MATH 109,B01,083215,Ganzberger; Geoffrey Michael,1,0,32,31
1657022921889,MATH 109,B02,083216,Ganzberger; Geoffrey Michael,1,0,32,31
1657022921889,MATH 109,B03,093479,Ganzberger; Geoffrey Michael,6,0,32,26
1657022927916,MATH 142A,A01,083219,Chow; Bennett,6,0,32,26
1657022927916,MATH 142A,A02,083220,Chow; Bennett,10,0,32,22
1657022927916,MATH 142A,A03,093480,Chow; Bennett,7,0,32,25
1657022927916,MATH 142A,B03,093481,Chow; Bennett,7,0,32,25
1657022927916,MATH 142A,B04,093558,Chow; Bennett,11,0,32,21
1657022927916,MATH 142A,B05,093559,Chow; Bennett,6,0,32,26
1657022933948,MATH 193A,A01,083224,Rotar; Vladimir,7,0,34,27
1657022933948,MATH 193A,A02,083225,Rotar; Vladimir,4,0,34,30
1657022933948,MATH 193A,A03,083781,Rotar; Vladimir,1,0,34,33
1657022933948,MATH 193A,A04,083782,Rotar; Vladimir,6,0,34,28
1657022933948,MATH 193A,A05,093482,Rotar; Vladimir,6,0,34,28
1657022939974,MATH 197,001,091859,McAuley; Julian John,9999,0,9999,0
1657022939974,MATH 197,002,095566,Kedlaya; Kiran S.,9997,0,9999,2
1657022939974,MATH 197,003,095567,Xiao; Ming,9999,0,9999,0
1657022939974,MATH 197,004,095571,Perols; Johan Lars,9998,0,9999,1
1657022947056,COGS 9,A01,083615,Shannon; Kyle Michael,7,0,75,68
1657022953086,COGS 11,A01,083617,Boyle; Mary E. T.,20,0,48,28
1657022959118,COGS 13,A01,083071,Bastos; Amalia Pinkusfeld,9,0,71,62
1657022965145,COGS 14A,A01,092681,Semenuks; Arturs,0,1,100,100
1657022971177,COGS 14B,A01,083073,Cheng; Tzu-Han,5,0,63,58
1657022977201,COGS 17,A01,092677,Semenuks; Arturs,4,0,81,77
1657022983229,COGS 100,A01,083619,Allen; Michael Gordon,15,0,70,55
1657022989275,COGS 101A,A01,083621,Davis; Joshua Daniel,9,0,68,59
1657022995307,COGS 101B,A01,091572,Allen; Michael Gordon,8,0,65,57
1657023001349,COGS 101C,A01,083625,Delgado; Tania,17,0,35,18
1657023007379,COGS 107A,A01,083627,Boyle; Mary E. T.,13,0,60,47
1657023013404,COGS 118A,A01,083075,Gupta; Anjum,15,0,76,61
1657023019432,CSE 3,A50,083646,Miranda; Gregory Joseph,22,0,50,28
1657023025459,CSE 8A,A50,083650,Miranda; Gregory Joseph,17,1,56,39
1657023031488,CSE 11,A01,083080,Cao; Yingjun,4,15,40,36
1657023037513,CSE 12,A01,083652,Krause-Levy; Sophia Louisa,21,1,120,99
1657023043542,CSE 15L,A01,083654,Morris; Justin Loren,8,0,50,42
1657023043542,CSE 15L,A02,083655,Morris; Justin Loren,9,0,50,41
1657023049570,CSE 20,A01,083657,Tran; Khoa Dang,37,0,80,43
1657023055595,CSE 21,A01,095574,Bach; Quang Tran,21,0,48,27
1657023061636,CSE 30,A01,083084,Eldon; John,4,0,80,76
1657023061636,CSE 30,B01,095061,Bhaskar; Nishant,6,0,50,44
1657023067671,CSE 100,A01,083659,Cao; Yingjun,3,4,70,67
1657023073702,CSE 134B,A01,083661,Powell; Thomas Allan,19,0,100,81
1657023079728,CSE 140,A01,083663,Gungor; Onat,14,0,85,71
1657023085758,CSE 140L,A01,083088,Eldon; John,16,0,100,84
1657023091784,CSE 175,A01,083665,Kumar; Rakesh,3,0,25,22
1657023097813,CSE 190,A00,092507,Dubnov; Shlomo,7,0,20,13
1657023103846,ECE 45,A01,083139,Congero; Spencer William,5,0,75,70
1657023109926,ECE 65,A50,083695,Saad; Andrew S,12,0,30,18
1657023109926,ECE 65,A51,095125,Saad; Andrew S,25,0,26,1
1657023115963,ECE 109,A01,091882,Touri; Behrouz,16,0,70,54
1657023121995,ECE 180,A00,083140,Abi Samra; Nicholas Camill,1,0,30,29
1657023121995,ECE 180,B00,083141,Abi Samra; Nicholas Camill,0,0,30,30
1657023128024,MATH 10A,A01,083735,Patchell; Gregory David,1,0,30,29
1657023128024,MATH 10A,A02,083736,Patchell; Gregory David,20,0,30,10
1657023128024,MATH 10A,A03,083737,Patchell; Gregory David,16,0,30,14
1657023134056,MATH 10B,A01,083207,Lim; Seonhee,7,0,34,27
1657023134056,MATH 10B,A02,083208,Lim; Seonhee,9,0,35,26
1657023134056,MATH 10B,A03,093472,Lim; Seonhee,4,0,34,30
1657023134056,MATH 10B,B01,083739,Sinha; Shubham,9,0,30,21
1657023140084,MATH 18,A01,083743,Cinel; Cameron Alexander,6,0,30,24
1657023140084,MATH 18,A02,083744,Cinel; Cameron Alexander,15,0,30,15
1657023140084,MATH 18,A03,083745,Cinel; Cameron Alexander,8,0,30,22
1657023140084,MATH 18,B01,083748,Rideout; David Porter,4,0,37,33
1657023140084,MATH 18,B02,083749,Rideout; David Porter,3,0,36,33
1657023140084,MATH 18,B03,083750,Rideout; David Porter,2,0,37,35
1657023140084,MATH 18,B04,083751,Rideout; David Porter,5,0,36,31
1657023140084,MATH 18,B05,093473,Rideout; David Porter,4,0,36,32
1657023140084,MATH 18,B06,093474,Rideout; David Porter,5,0,36,31
1657023146113,MATH 20A,A01,083754,Zheng; Zequn,12,0,40,28
1657023152142,MATH 20B,A01,083756,Briones; Jor-el Thomas Caparas,1,0,36,35
1657023152142,MATH 20B,A02,083757,Briones; Jor-el Thomas Caparas,1,0,36,35
1657023152142,MATH 20B,A03,093475,Briones; Jor-el Thomas Caparas,0,0,36,36
1657023158171,MATH 20C,A01,083760,Briones; Jor-el Thomas Caparas,1,0,35,34
1657023158171,MATH 20C,A02,083761,Briones; Jor-el Thomas Caparas,8,0,35,27
1657023158171,MATH 20C,A03,093476,Briones; Jor-el Thomas Caparas,0,1,36,36
1657023158171,MATH 20C,B01,083762,Bach; Quang Tran,0,0,30,30
1657023164200,MATH 20D,A01,083765,Tran; Brian Kha,4,0,30,26
1657023164200,MATH 20D,A02,083766,Tran; Brian Kha,5,0,30,25
1657023164200,MATH 20D,A03,083767,Tran; Brian Kha,3,0,30,27
1657023170235,MATH 20E,A01,083771,Ganguly; Soumya,5,0,32,27
1657023170235,MATH 20E,A02,083772,Ganguly; Soumya,6,0,32,26
1657023170235,MATH 20E,B01,083773,Ciotti; Benjamin,18,0,35,17
1657023170235,MATH 20E,B02,083774,Ciotti; Benjamin,17,0,35,18
1657023176270,MATH 103A,A01,083777,Greenfeld; Be'Eri,2,0,36,34
1657023176270,MATH 103A,A02,083778,Greenfeld; Be'Eri,5,0,36,31
1657023176270,MATH 103A,A03,093561,Greenfeld; Be'Eri,4,0,36,32
1657023176270,MATH 103A,B01,083779,Greenfeld; Be'Eri,6,0,36,30
1657023176270,MATH 103A,B02,083780,Greenfeld; Be'Eri,2,0,36,34
1657023176270,MATH 103A,B03,093562,Greenfeld; Be'Eri,2,0,36,34
1657023182305,MATH 105,A01,085443,Carter; Anne Toulson,14,0,35,21
1657023182305,MATH 105,A02,093477,Carter; Anne Toulson,20,0,35,15
1657023188332,MATH 109,A01,083213,Ganzberger; Geoffrey Michael,2,0,34,32
1657023188332,MATH 109,A02,083214,Ganzberger; Geoffrey Michael,2,0,34,32
1657023188332,MATH 109,A03,093478,Ganzberger; Geoffrey Michael,1,0,34,33
1657023188332,MATH 109,B01,083215,Ganzberger; Geoffrey Michael,1,0,32,31
1657023188332,MATH 109,B02,083216,Ganzberger; Geoffrey Michael,1,0,32,31
1657023188332,MATH 109,B03,093479,Ganzberger; Geoffrey Michael,6,0,32,26
1657023194363,MATH 142A,A01,083219,Chow; Bennett,6,0,32,26
1657023194363,MATH 142A,A02,083220,Chow; Bennett,10,0,32,22
1657023194363,MATH 142A,A03,093480,Chow; Bennett,7,0,32,25
1657023194363,MATH 142A,B03,093481,Chow; Bennett,7,0,32,25
1657023194363,MATH 142A,B04,093558,Chow; Bennett,11,0,32,21
1657023194363,MATH 142A,B05,093559,Chow; Bennett,6,0,32,26
1657023200400,MATH 193A,A01,083224,Rotar; Vladimir,7,0,34,27
1657023200400,MATH 193A,A02,083225,Rotar; Vladimir,4,0,34,30
1657023200400,MATH 193A,A03,083781,Rotar; Vladimir,1,0,34,33
1657023200400,MATH 193A,A04,083782,Rotar; Vladimir,6,0,34,28
1657023200400,MATH 193A,A05,093482,Rotar; Vladimir,6,0,34,28
1657023206428,MATH 197,001,091859,McAuley; Julian John,9999,0,9999,0
1657023206428,MATH 197,002,095566,Kedlaya; Kiran S.,9997,0,9999,2
1657023206428,MATH 197,003,095567,Xiao; Ming,9999,0,9999,0
1657023206428,MATH 197,004,095571,Perols; Johan Lars,9998,0,9999,1
1657023213505,COGS 9,A01,083615,Shannon; Kyle Michael,7,0,75,68
1657023219534,COGS 11,A01,083617,Boyle; Mary E. T.,20,0,48,28
1657023225561,COGS 13,A01,083071,Bastos; Amalia Pinkusfeld,9,0,71,62
1657023231594,COGS 14A,A01,092681,Semenuks; Arturs,0,1,100,100
1657023237625,COGS 14B,A01,083073,Cheng; Tzu-Han,5,0,63,58
1657023243652,COGS 17,A01,092677,Semenuks; Arturs,4,0,81,77
1657023249692,COGS 100,A01,083619,Allen; Michael Gordon,15,0,70,55
1657023255723,COGS 101A,A01,083621,Davis; Joshua Daniel,9,0,68,59
1657023261755,COGS 101B,A01,091572,Allen; Michael Gordon,8,0,65,57
1657023267783,COGS 101C,A01,083625,Delgado; Tania,17,0,35,18
1657023273807,COGS 107A,A01,083627,Boyle; Mary E. T.,13,0,60,47
1657023279833,COGS 118A,A01,083075,Gupta; Anjum,15,0,76,61
1657023285873,CSE 3,A50,083646,Miranda; Gregory Joseph,22,0,50,28
1657023291898,CSE 8A,A50,083650,Miranda; Gregory Joseph,17,1,56,39
1657023297930,CSE 11,A01,083080,Cao; Yingjun,4,15,40,36
1657023303959,CSE 12,A01,083652,Krause-Levy; Sophia Louisa,21,1,120,99
1657023309984,CSE 15L,A01,083654,Morris; Justin Loren,8,0,50,42
1657023309984,CSE 15L,A02,083655,Morris; Justin Loren,9,0,50,41
1657023316035,CSE 20,A01,083657,Tran; Khoa Dang,37,0,80,43
1657023322068,CSE 21,A01,095574,Bach; Quang Tran,21,0,48,27
1657023328108,CSE 30,A01,083084,Eldon; John,4,0,80,76
1657023328108,CSE 30,B01,095061,Bhaskar; Nishant,6,0,50,44
1657023334135,CSE 100,A01,083659,Cao; Yingjun,3,4,70,67
1657023340169,CSE 134B,A01,083661,Powell; Thomas Allan,19,0,100,81
1657023346204,CSE 140,A01,083663,Gungor; Onat,14,0,85,71
1657023352230,CSE 140L,A01,083088,Eldon; John,16,0,100,84
1657023358258,CSE 175,A01,083665,Kumar; Rakesh,3,0,25,22
1657023364295,CSE 190,A00,092507,Dubnov; Shlomo,7,0,20,13
1657023370335,ECE 45,A01,083139,Congero; Spencer William,5,0,75,70
1657023376365,ECE 65,A50,083695,Saad; Andrew S,12,0,30,18
1657023376365,ECE 65,A51,095125,Saad; Andrew S,25,0,26,1
1657023382397,ECE 109,A01,091882,Touri; Behrouz,16,0,70,54
1657023388424,ECE 180,A00,083140,Abi Samra; Nicholas Camill,1,0,30,29
1657023388424,ECE 180,B00,083141,Abi Samra; Nicholas Camill,0,0,30,30
1657023394467,MATH 10A,A01,083735,Patchell; Gregory David,1,0,30,29
1657023394467,MATH 10A,A02,083736,Patchell; Gregory David,20,0,30,10
1657023394467,MATH 10A,A03,083737,Patchell; Gregory David,16,0,30,14
1657023400508,MATH 10B,A01,083207,Lim; Seonhee,7,0,34,27
1657023400508,MATH 10B,A02,083208,Lim; Seonhee,9,0,35,26
1657023400508,MATH 10B,A03,093472,Lim; Seonhee,4,0,34,30
1657023400508,MATH 10B,B01,083739,Sinha; Shubham,9,0,30,21
1657023406541,MATH 18,A01,083743,Cinel; Cameron Alexander,6,0,30,24
1657023406541,MATH 18,A02,083744,Cinel; Cameron Alexander,15,0,30,15
1657023406541,MATH 18,A03,083745,Cinel; Cameron Alexander,8,0,30,22
1657023406541,MATH 18,B01,083748,Rideout; David Porter,4,0,37,33
1657023406541,MATH 18,B02,083749,Rideout; David Porter,3,0,36,33
1657023406541,MATH 18,B03,083750,Rideout; David Porter,2,0,37,35
1657023406541,MATH 18,B04,083751,Rideout; David Porter,5,0,36,31
1657023406541,MATH 18,B05,093473,Rideout; David Porter,4,0,36,32
1657023406541,MATH 18,B06,093474,Rideout; David Porter,5,0,36,31
1657023412578,MATH 20A,A01,083754,Zheng; Zequn,12,0,40,28
1657023418607,MATH 20B,A01,083756,Briones; Jor-el Thomas Caparas,1,0,36,35
1657023418607,MATH 20B,A02,083757,Briones; Jor-el Thomas Caparas,1,0,36,35
1657023418607,MATH 20B,A03,093475,Briones; Jor-el Thomas Caparas,0,0,36,36
1657023424638,MATH 20C,A01,083760,Briones; Jor-el Thomas Caparas,1,0,35,34
1657023424638,MATH 20C,A02,083761,Briones; Jor-el Thomas Caparas,8,0,35,27
1657023424638,MATH 20C,A03,093476,Briones; Jor-el Thomas Caparas,0,1,36,36
1657023424638,MATH 20C,B01,083762,Bach; Quang Tran,0,0,30,30
1657023430666,MATH 20D,A01,083765,Tran; Brian Kha,4,0,30,26
1657023430666,MATH 20D,A02,083766,Tran; Brian Kha,5,0,30,25
1657023430666,MATH 20D,A03,083767,Tran; Brian Kha,3,0,30,27
1657023436700,MATH 20E,A01,083771,Ganguly; Soumya,5,0,32,27
1657023436700,MATH 20E,A02,083772,Ganguly; Soumya,6,0,32,26
1657023436700,MATH 20E,B01,083773,Ciotti; Benjamin,18,0,35,17
1657023436700,MATH 20E,B02,083774,Ciotti; Benjamin,17,0,35,18
1657023442739,MATH 103A,A01,083777,Greenfeld; Be'Eri,2,0,36,34
1657023442739,MATH 103A,A02,083778,Greenfeld; Be'Eri,5,0,36,31
1657023442739,MATH 103A,A03,093561,Greenfeld; Be'Eri,4,0,36,32
1657023442739,MATH 103A,B01,083779,Greenfeld; Be'Eri,6,0,36,30
1657023442739,MATH 103A,B02,083780,Greenfeld; Be'Eri,2,0,36,34
1657023442739,MATH 103A,B03,093562,Greenfeld; Be'Eri,2,0,36,34
1657023448774,MATH 105,A01,085443,Carter; Anne Toulson,14,0,35,21
1657023448774,MATH 105,A02,093477,Carter; Anne Toulson,20,0,35,15
1657023454803,MATH 109,A01,083213,Ganzberger; Geoffrey Michael,2,0,34,32
1657023454803,MATH 109,A02,083214,Ganzberger; Geoffrey Michael,2,0,34,32
1657023454803,MATH 109,A03,093478,Ganzberger; Geoffrey Michael,1,0,34,33
1657023454803,MATH 109,B01,083215,Ganzberger; Geoffrey Michael,1,0,32,31
1657023454803,MATH 109,B02,083216,Ganzberger; Geoffrey Michael,1,0,32,31
1657023454803,MATH 109,B03,093479,Ganzberger; Geoffrey Michael,6,0,32,26
1657023460841,MATH 142A,A01,083219,Chow; Bennett,6,0,32,26
1657023460841,MATH 142A,A02,083220,Chow; Bennett,10,0,32,22
1657023460841,MATH 142A,A03,093480,Chow; Bennett,7,0,32,25
1657023460841,MATH 142A,B03,093481,Chow; Bennett,7,0,32,25
1657023460841,MATH 142A,B04,093558,Chow; Bennett,11,0,32,21
1657023460841,MATH 142A,B05,093559,Chow; Bennett,6,0,32,26
1657023466876,MATH 193A,A01,083224,Rotar; Vladimir,7,0,34,27
1657023466876,MATH 193A,A02,083225,Rotar; Vladimir,4,0,34,30
1657023466876,MATH 193A,A03,083781,Rotar; Vladimir,1,0,34,33
1657023466876,MATH 193A,A04,083782,Rotar; Vladimir,6,0,34,28
1657023466876,MATH 193A,A05,093482,Rotar; Vladimir,6,0,34,28
1657023472911,MATH 197,001,091859,McAuley; Julian John,9999,0,9999,0
1657023472911,MATH 197,002,095566,Kedlaya; Kiran S.,9997,0,9999,2
1657023472911,MATH 197,003,095567,Xiao; Ming,9999,0,9999,0
1657023472911,MATH 197,004,095571,Perols; Johan Lars,9998,0,9999,1
1657023480003,COGS 9,A01,083615,Shannon; Kyle Michael,7,0,75,68
1657023486034,COGS 11,A01,083617,Boyle; Mary E. T.,20,0,48,28
1657023492063,COGS 13,A01,083071,Bastos; Amalia Pinkusfeld,9,0,71,62
1657023498099,COGS 14A,A01,092681,Semenuks; Arturs,0,1,100,100
1657023504125,COGS 14B,A01,083073,Cheng; Tzu-Han,5,0,63,58
1657023510153,COGS 17,A01,092677,Semenuks; Arturs,4,0,81,77
1657023516264,COGS 100,A01,083619,Allen; Michael Gordon,15,0,70,55
1657023522297,COGS 101A,A01,083621,Davis; Joshua Daniel,9,0,68,59
1657023528326,COGS 101B,A01,091572,Allen; Michael Gordon,8,0,65,57
1657023534359,COGS 101C,A01,083625,Delgado; Tania,17,0,35,18
1657023540387,COGS 107A,A01,083627,Boyle; Mary E. T.,13,0,60,47
1657023546419,COGS 118A,A01,083075,Gupta; Anjum,15,0,76,61
1657023552448,CSE 3,A50,083646,Miranda; Gregory Joseph,22,0,50,28
1657023558477,CSE 8A,A50,083650,Miranda; Gregory Joseph,17,1,56,39
1657023564506,CSE 11,A01,083080,Cao; Yingjun,4,15,40,36
1657023570535,CSE 12,A01,083652,Krause-Levy; Sophia Louisa,21,1,120,99
1657023576562,CSE 15L,A01,083654,Morris; Justin Loren,8,0,50,42
1657023576562,CSE 15L,A02,083655,Morris; Justin Loren,9,0,50,41
1657023582593,CSE 20,A01,083657,Tran; Khoa Dang,37,0,80,43
1657023588621,CSE 21,A01,095574,Bach; Quang Tran,21,0,48,27
1657023594660,CSE 30,A01,083084,Eldon; John,4,0,80,76
1657023594660,CSE 30,B01,095061,Bhaskar; Nishant,6,0,50,44
1657023600694,CSE 100,A01,083659,Cao; Yingjun,3,4,70,67
1657023606733,CSE 134B,A01,083661,Powell; Thomas Allan,19,0,100,81
1657023612763,CSE 140,A01,083663,Gungor; Onat,14,0,85,71
1657023618795,CSE 140L,A01,083088,Eldon; John,16,0,100,84
1657023624828,CSE 175,A01,083665,Kumar; Rakesh,3,0,25,22
1657023630860,CSE 190,A00,092507,Dubnov; Shlomo,7,0,20,13
1657023636897,ECE 45,A01,083139,Congero; Spencer William,5,0,75,70
1657023642934,ECE 65,A50,083695,Saad; Andrew S,12,0,30,18
1657023642934,ECE 65,A51,095125,Saad; Andrew S,25,0,26,1
1657023648961,ECE 109,A01,091882,Touri; Behrouz,16,0,70,54
1657023655018,ECE 180,A00,083140,Abi Samra; Nicholas Camill,1,0,30,29
1657023655018,ECE 180,B00,083141,Abi Samra; Nicholas Camill,0,0,30,30
1657023661056,MATH 10A,A01,083735,Patchell; Gregory David,1,0,30,29
1657023661056,MATH 10A,A02,083736,Patchell; Gregory David,20,0,30,10
1657023661056,MATH 10A,A03,083737,Patchell; Gregory David,16,0,30,14
1657023667093,MATH 10B,A01,083207,Lim; Seonhee,7,0,34,27
1657023667093,MATH 10B,A02,083208,Lim; Seonhee,9,0,35,26
1657023667093,MATH 10B,A03,093472,Lim; Seonhee,4,0,34,30
1657023667093,MATH 10B,B01,083739,Sinha; Shubham,9,0,30,21
1657023673136,MATH 18,A01,083743,Cinel; Cameron Alexander,6,0,30,24
1657023673136,MATH 18,A02,083744,Cinel; Cameron Alexander,15,0,30,15
1657023673136,MATH 18,A03,083745,Cinel; Cameron Alexander,8,0,30,22
1657023673136,MATH 18,B01,083748,Rideout; David Porter,4,0,37,33
1657023673136,MATH 18,B02,083749,Rideout; David Porter,3,0,36,33
1657023673136,MATH 18,B03,083750,Rideout; David Porter,2,0,37,35
1657023673136,MATH 18,B04,083751,Rideout; David Porter,5,0,36,31
1657023673136,MATH 18,B05,093473,Rideout; David Porter,4,0,36,32
1657023673136,MATH 18,B06,093474,Rideout; David Porter,5,0,36,31
1657023679167,MATH 20A,A01,083754,Zheng; Zequn,12,0,40,28
1657023685202,MATH 20B,A01,083756,Briones; Jor-el Thomas Caparas,1,0,36,35
1657023685202,MATH 20B,A02,083757,Briones; Jor-el Thomas Caparas,1,0,36,35
1657023685202,MATH 20B,A03,093475,Briones; Jor-el Thomas Caparas,0,0,36,36
1657023691230,MATH 20C,A01,083760,Briones; Jor-el Thomas Caparas,1,0,35,34
1657023691230,MATH 20C,A02,083761,Briones; Jor-el Thomas Caparas,8,0,35,27
1657023691230,MATH 20C,A03,093476,Briones; Jor-el Thomas Caparas,0,1,36,36
1657023691230,MATH 20C,B01,083762,Bach; Quang Tran,0,0,30,30
1657023697262,MATH 20D,A01,083765,Tran; Brian Kha,4,0,30,26
1657023697262,MATH 20D,A02,083766,Tran; Brian Kha,5,0,30,25
1657023697262,MATH 20D,A03,083767,Tran; Brian Kha,3,0,30,27
1657023703290,MATH 20E,A01,083771,Ganguly; Soumya,5,0,32,27
1657023703290,MATH 20E,A02,083772,Ganguly; Soumya,6,0,32,26
1657023703290,MATH 20E,B01,083773,Ciotti; Benjamin,18,0,35,17
1657023703290,MATH 20E,B02,083774,Ciotti; Benjamin,17,0,35,18
1657023709354,MATH 103A,A01,083777,Greenfeld; Be'Eri,2,0,36,34
1657023709354,MATH 103A,A02,083778,Greenfeld; Be'Eri,5,0,36,31
1657023709354,MATH 103A,A03,093561,Greenfeld; Be'Eri,4,0,36,32
1657023709354,MATH 103A,B01,083779,Greenfeld; Be'Eri,6,0,36,30
1657023709354,MATH 103A,B02,083780,Greenfeld; Be'Eri,2,0,36,34
1657023709354,MATH 103A,B03,093562,Greenfeld; Be'Eri,2,0,36,34
1657023715381,MATH 105,A01,085443,Carter; Anne Toulson,14,0,35,21
1657023715381,MATH 105,A02,093477,Carter; Anne Toulson,20,0,35,15
1657023721420,MATH 109,A01,083213,Ganzberger; Geoffrey Michael,2,0,34,32
1657023721420,MATH 109,A02,083214,Ganzberger; Geoffrey Michael,2,0,34,32
1657023721420,MATH 109,A03,093478,Ganzberger; Geoffrey Michael,1,0,34,33
1657023721420,MATH 109,B01,083215,Ganzberger; Geoffrey Michael,1,0,32,31
1657023721420,MATH 109,B02,083216,Ganzberger; Geoffrey Michael,1,0,32,31
1657023721420,MATH 109,B03,093479,Ganzberger; Geoffrey Michael,6,0,32,26
1657023727446,MATH 142A,A01,083219,Chow; Bennett,6,0,32,26
1657023727446,MATH 142A,A02,083220,Chow; Bennett,10,0,32,22
1657023727446,MATH 142A,A03,093480,Chow; Bennett,7,0,32,25
1657023727446,MATH 142A,B03,093481,Chow; Bennett,7,0,32,25
1657023727446,MATH 142A,B04,093558,Chow; Bennett,11,0,32,21
1657023727446,MATH 142A,B05,093559,Chow; Bennett,6,0,32,26
1657023733489,MATH 193A,A01,083224,Rotar; Vladimir,7,0,34,27
1657023733489,MATH 193A,A02,083225,Rotar; Vladimir,4,0,34,30
1657023733489,MATH 193A,A03,083781,Rotar; Vladimir,1,0,34,33
1657023733489,MATH 193A,A04,083782,Rotar; Vladimir,6,0,34,28
1657023733489,MATH 193A,A05,093482,Rotar; Vladimir,6,0,34,28
1657023739526,MATH 197,001,091859,McAuley; Julian John,9999,0,9999,0
1657023739526,MATH 197,002,095566,Kedlaya; Kiran S.,9997,0,9999,2
1657023739526,MATH 197,003,095567,Xiao; Ming,9999,0,9999,0
1657023739526,MATH 197,004,095571,Perols; Johan Lars,9998,0,9999,1
1657023746595,COGS 9,A01,083615,Shannon; Kyle Michael,7,0,75,68
1657023752623,COGS 11,A01,083617,Boyle; Mary E. T.,20,0,48,28
1657023758651,COGS 13,A01,083071,Bastos; Amalia Pinkusfeld,9,0,71,62
1657023764686,COGS 14A,A01,092681,Semenuks; Arturs,0,1,100,100
1657023770713,COGS 14B,A01,083073,Cheng; Tzu-Han,5,0,63,58
1657023776743,COGS 17,A01,092677,Semenuks; Arturs,4,0,81,77
1657023782782,COGS 100,A01,083619,Allen; Michael Gordon,15,0,70,55
1657023788808,COGS 101A,A01,083621,Davis; Joshua Daniel,9,0,68,59
1657023794834,COGS 101B,A01,091572,Allen; Michael Gordon,8,0,65,57
1657023800863,COGS 101C,A01,083625,Delgado; Tania,17,0,35,18
1657023806888,COGS 107A,A01,083627,Boyle; Mary E. T.,13,0,60,47
1657023812914,COGS 118A,A01,083075,Gupta; Anjum,15,0,76,61
1657023818957,CSE 3,A50,083646,Miranda; Gregory Joseph,22,0,50,28
1657023824985,CSE 8A,A50,083650,Miranda; Gregory Joseph,17,1,56,39
1657023831023,CSE 11,A01,083080,Cao; Yingjun,4,15,40,36
1657023837050,CSE 12,A01,083652,Krause-Levy; Sophia Louisa,21,1,120,99
1657023843092,CSE 15L,A01,083654,Morris; Justin Loren,8,0,50,42
1657023843092,CSE 15L,A02,083655,Morris; Justin Loren,9,0,50,41
1657023849118,CSE 20,A01,083657,Tran; Khoa Dang,37,0,80,43
1657023855153,CSE 21,A01,095574,Bach; Quang Tran,21,0,48,27
1657023861180,CSE 30,A01,083084,Eldon; John,4,0,80,76
1657023861180,CSE 30,B01,095061,Bhaskar; Nishant,6,0,50,44
1657023867210,CSE 100,A01,083659,Cao; Yingjun,3,4,70,67
1657023873238,CSE 134B,A01,083661,Powell; Thomas Allan,19,0,100,81
1657023879266,CSE 140,A01,083663,Gungor; Onat,14,0,85,71
1657023885298,CSE 140L,A01,083088,Eldon; John,16,0,100,84
1657023891323,CSE 175,A01,083665,Kumar; Rakesh,3,0,25,22
1657023897351,CSE 190,A00,092507,Dubnov; Shlomo,7,0,20,13
1657023903398,ECE 45,A01,083139,Congero; Spencer William,5,0,75,70
1657023909444,ECE 65,A50,083695,Saad; Andrew S,12,0,30,18
1657023909444,ECE 65,A51,095125,Saad; Andrew S,25,0,26,1
1657023915471,ECE 109,A01,091882,Touri; Behrouz,16,0,70,54
1657023921505,ECE 180,A00,083140,Abi Samra; Nicholas Camill,1,0,30,29
1657023921505,ECE 180,B00,083141,Abi Samra; Nicholas Camill,0,0,30,30
1657023927560,MATH 10A,A01,083735,Patchell; Gregory David,1,0,30,29
1657023927560,MATH 10A,A02,083736,Patchell; Gregory David,20,0,30,10
1657023927560,MATH 10A,A03,083737,Patchell; Gregory David,16,0,30,14
1657023933589,MATH 10B,A01,083207,Lim; Seonhee,7,0,34,27
1657023933589,MATH 10B,A02,083208,Lim; Seonhee,9,0,35,26
1657023933589,MATH 10B,A03,093472,Lim; Seonhee,4,0,34,30
1657023933589,MATH 10B,B01,083739,Sinha; Shubham,9,0,30,21
1657023939622,MATH 18,A01,083743,Cinel; Cameron Alexander,6,0,30,24
1657023939622,MATH 18,A02,083744,Cinel; Cameron Alexander,15,0,30,15
1657023939622,MATH 18,A03,083745,Cinel; Cameron Alexander,8,0,30,22
1657023939622,MATH 18,B01,083748,Rideout; David Porter,4,0,37,33
1657023939622,MATH 18,B02,083749,Rideout; David Porter,3,0,36,33
1657023939622,MATH 18,B03,083750,Rideout; David Porter,2,0,37,35
1657023939622,MATH 18,B04,083751,Rideout; David Porter,5,0,36,31
1657023939622,MATH 18,B05,093473,Rideout; David Porter,4,0,36,32
1657023939622,MATH 18,B06,093474,Rideout; David Porter,5,0,36,31
1657023945648,MATH 20A,A01,083754,Zheng; Zequn,12,0,40,28
1657023951683,MATH 20B,A01,083756,Briones; Jor-el Thomas Caparas,1,0,36,35
1657023951683,MATH 20B,A02,083757,Briones; Jor-el Thomas Caparas,1,0,36,35
1657023951683,MATH 20B,A03,093475,Briones; Jor-el Thomas Caparas,0,0,36,36
1657023957711,MATH 20C,A01,083760,Briones; Jor-el Thomas Caparas,1,0,35,34
1657023957711,MATH 20C,A02,083761,Briones; Jor-el Thomas Caparas,8,0,35,27
1657023957711,MATH 20C,A03,093476,Briones; Jor-el Thomas Caparas,0,1,36,36
1657023957711,MATH 20C,B01,083762,Bach; Quang Tran,0,0,30,30
1657023963738,MATH 20D,A01,083765,Tran; Brian Kha,4,0,30,26
1657023963738,MATH 20D,A02,083766,Tran; Brian Kha,5,0,30,25
1657023963738,MATH 20D,A03,083767,Tran; Brian Kha,3,0,30,27
1657023969774,MATH 20E,A01,083771,Ganguly; Soumya,5,0,32,27
1657023969774,MATH 20E,A02,083772,Ganguly; Soumya,6,0,32,26
1657023969774,MATH 20E,B01,083773,Ciotti; Benjamin,18,0,35,17
1657023969774,MATH 20E,B02,083774,Ciotti; Benjamin,17,0,35,18
1657023975808,MATH 103A,A01,083777,Greenfeld; Be'Eri,2,0,36,34
1657023975808,MATH 103A,A02,083778,Greenfeld; Be'Eri,5,0,36,31
1657023975808,MATH 103A,A03,093561,Greenfeld; Be'Eri,4,0,36,32
1657023975808,MATH 103A,B01,083779,Greenfeld; Be'Eri,6,0,36,30
1657023975808,MATH 103A,B02,083780,Greenfeld; Be'Eri,2,0,36,34
1657023975808,MATH 103A,B03,093562,Greenfeld; Be'Eri,2,0,36,34
1657023981841,MATH 105,A01,085443,Carter; Anne Toulson,14,0,35,21
1657023981841,MATH 105,A02,093477,Carter; Anne Toulson,20,0,35,15
1657023987867,MATH 109,A01,083213,Ganzberger; Geoffrey Michael,2,0,34,32
1657023987867,MATH 109,A02,083214,Ganzberger; Geoffrey Michael,2,0,34,32
1657023987867,MATH 109,A03,093478,Ganzberger; Geoffrey Michael,1,0,34,33
1657023987867,MATH 109,B01,083215,Ganzberger; Geoffrey Michael,1,0,32,31
1657023987867,MATH 109,B02,083216,Ganzberger; Geoffrey Michael,1,0,32,31
1657023987867,MATH 109,B03,093479,Ganzberger; Geoffrey Michael,6,0,32,26
1657023993895,MATH 142A,A01,083219,Chow; Bennett,6,0,32,26
1657023993895,MATH 142A,A02,083220,Chow; Bennett,10,0,32,22
1657023993895,MATH 142A,A03,093480,Chow; Bennett,7,0,32,25
1657023993895,MATH 142A,B03,093481,Chow; Bennett,7,0,32,25
1657023993895,MATH 142A,B04,093558,Chow; Bennett,11,0,32,21
1657023993895,MATH 142A,B05,093559,Chow; Bennett,6,0,32,26
1657023999931,MATH 193A,A01,083224,Rotar; Vladimir,7,0,34,27
1657023999931,MATH 193A,A02,083225,Rotar; Vladimir,4,0,34,30
1657023999931,MATH 193A,A03,083781,Rotar; Vladimir,1,0,34,33
1657023999931,MATH 193A,A04,083782,Rotar; Vladimir,6,0,34,28
1657023999931,MATH 193A,A05,093482,Rotar; Vladimir,6,0,34,28
1657024005960,MATH 197,001,091859,McAuley; Julian John,9999,0,9999,0
1657024005960,MATH 197,002,095566,Kedlaya; Kiran S.,9997,0,9999,2
1657024005960,MATH 197,003,095567,Xiao; Ming,9999,0,9999,0
1657024005960,MATH 197,004,095571,Perols; Johan Lars,9998,0,9999,1
1657024013037,COGS 9,A01,083615,Shannon; Kyle Michael,7,0,75,68
1657024019064,COGS 11,A01,083617,Boyle; Mary E. T.,20,0,48,28
1657024025103,COGS 13,A01,083071,Bastos; Amalia Pinkusfeld,9,0,71,62
1657024031130,COGS 14A,A01,092681,Semenuks; Arturs,0,1,100,100
1657024037158,COGS 14B,A01,083073,Cheng; Tzu-Han,5,0,63,58
1657024043187,COGS 17,A01,092677,Semenuks; Arturs,4,0,81,77
1657024049228,COGS 100,A01,083619,Allen; Michael Gordon,15,0,70,55
1657024055254,COGS 101A,A01,083621,Davis; Joshua Daniel,9,0,68,59
1657024061303,COGS 101B,A01,091572,Allen; Michael Gordon,8,0,65,57
1657024067334,COGS 101C,A01,083625,Delgado; Tania,17,0,35,18
1657024073358,COGS 107A,A01,083627,Boyle; Mary E. T.,13,0,60,47
1657024079389,COGS 118A,A01,083075,Gupta; Anjum,15,0,76,61
1657024085420,CSE 3,A50,083646,Miranda; Gregory Joseph,22,0,50,28
1657024091452,CSE 8A,A50,083650,Miranda; Gregory Joseph,17,1,56,39
1657024097483,CSE 11,A01,083080,Cao; Yingjun,4,15,40,36
1657024103515,CSE 12,A01,083652,Krause-Levy; Sophia Louisa,21,1,120,99
1657024109542,CSE 15L,A01,083654,Morris; Justin Loren,8,0,50,42
1657024109542,CSE 15L,A02,083655,Morris; Justin Loren,9,0,50,41
1657024115643,CSE 20,A01,083657,Tran; Khoa Dang,37,0,80,43
1657024121674,CSE 21,A01,095574,Bach; Quang Tran,21,0,48,27
1657024127711,CSE 30,A01,083084,Eldon; John,4,0,80,76
1657024127711,CSE 30,B01,095061,Bhaskar; Nishant,6,0,50,44
1657024133743,CSE 100,A01,083659,Cao; Yingjun,3,4,70,67
1657024139769,CSE 134B,A01,083661,Powell; Thomas Allan,19,0,100,81
1657024145795,CSE 140,A01,083663,Gungor; Onat,14,0,85,71
1657024151819,CSE 140L,A01,083088,Eldon; John,16,0,100,84
1657024157849,CSE 175,A01,083665,Kumar; Rakesh,3,0,25,22
1657024163900,CSE 190,A00,092507,Dubnov; Shlomo,7,0,20,13
1657024169927,ECE 45,A01,083139,Congero; Spencer William,5,0,75,70
1657024175954,ECE 65,A50,083695,Saad; Andrew S,12,0,30,18
1657024175954,ECE 65,A51,095125,Saad; Andrew S,25,0,26,1
1657024181986,ECE 109,A01,091882,Touri; Behrouz,16,0,70,54
1657024188011,ECE 180,A00,083140,Abi Samra; Nicholas Camill,1,0,30,29
1657024188011,ECE 180,B00,083141,Abi Samra; Nicholas Camill,0,0,30,30
1657024194040,MATH 10A,A01,083735,Patchell; Gregory David,1,0,30,29
1657024194040,MATH 10A,A02,083736,Patchell; Gregory David,20,0,30,10
1657024194040,MATH 10A,A03,083737,Patchell; Gregory David,16,0,30,14
1657024200106,MATH 10B,A01,083207,Lim; Seonhee,7,0,34,27
1657024200106,MATH 10B,A02,083208,Lim; Seonhee,9,0,35,26
1657024200106,MATH 10B,A03,093472,Lim; Seonhee,4,0,34,30
1657024200106,MATH 10B,B01,083739,Sinha; Shubham,9,0,30,21
1657024206148,MATH 18,A01,083743,Cinel; Cameron Alexander,6,0,30,24
1657024206148,MATH 18,A02,083744,Cinel; Cameron Alexander,15,0,30,15
1657024206148,MATH 18,A03,083745,Cinel; Cameron Alexander,8,0,30,22
1657024206148,MATH 18,B01,083748,Rideout; David Porter,4,0,37,33
1657024206148,MATH 18,B02,083749,Rideout; David Porter,3,0,36,33
1657024206148,MATH 18,B03,083750,Rideout; David Porter,2,0,37,35
1657024206148,MATH 18,B04,083751,Rideout; David Porter,5,0,36,31
1657024206148,MATH 18,B05,093473,Rideout; David Porter,4,0,36,32
1657024206148,MATH 18,B06,093474,Rideout; David Porter,5,0,36,31
1657024212179,MATH 20A,A01,083754,Zheng; Zequn,12,0,40,28
1657024218207,MATH 20B,A01,083756,Briones; Jor-el Thomas Caparas,1,0,36,35
1657024218207,MATH 20B,A02,083757,Briones; Jor-el Thomas Caparas,1,0,36,35
1657024218207,MATH 20B,A03,093475,Briones; Jor-el Thomas Caparas,0,0,36,36
1657024224236,MATH 20C,A01,083760,Briones; Jor-el Thomas Caparas,1,0,35,34
1657024224236,MATH 20C,A02,083761,Briones; Jor-el Thomas Caparas,8,0,35,27
1657024224236,MATH 20C,A03,093476,Briones; Jor-el Thomas Caparas,0,1,36,36
1657024224236,MATH 20C,B01,083762,Bach; Quang Tran,0,0,30,30
1657024230270,MATH 20D,A01,083765,Tran; Brian Kha,4,0,30,26
1657024230270,MATH 20D,A02,083766,Tran; Brian Kha,5,0,30,25
1657024230270,MATH 20D,A03,083767,Tran; Brian Kha,3,0,30,27
1657024236303,MATH 20E,A01,083771,Ganguly; Soumya,5,0,32,27
1657024236303,MATH 20E,A02,083772,Ganguly; Soumya,6,0,32,26
1657024236303,MATH 20E,B01,083773,Ciotti; Benjamin,18,0,35,17
1657024236303,MATH 20E,B02,083774,Ciotti; Benjamin,17,0,35,18
1657024242332,MATH 103A,A01,083777,Greenfeld; Be'Eri,2,0,36,34
1657024242332,MATH 103A,A02,083778,Greenfeld; Be'Eri,5,0,36,31
1657024242332,MATH 103A,A03,093561,Greenfeld; Be'Eri,4,0,36,32
1657024242332,MATH 103A,B01,083779,Greenfeld; Be'Eri,6,0,36,30
1657024242332,MATH 103A,B02,083780,Greenfeld; Be'Eri,2,0,36,34
1657024242332,MATH 103A,B03,093562,Greenfeld; Be'Eri,2,0,36,34
1657024248361,MATH 105,A01,085443,Carter; Anne Toulson,14,0,35,21
1657024248361,MATH 105,A02,093477,Carter; Anne Toulson,20,0,35,15
1657024254395,MATH 109,A01,083213,Ganzberger; Geoffrey Michael,2,0,34,32
1657024254395,MATH 109,A02,083214,Ganzberger; Geoffrey Michael,2,0,34,32
1657024254395,MATH 109,A03,093478,Ganzberger; Geoffrey Michael,1,0,34,33
1657024254395,MATH 109,B01,083215,Ganzberger; Geoffrey Michael,1,0,32,31
1657024254395,MATH 109,B02,083216,Ganzberger; Geoffrey Michael,1,0,32,31
1657024254395,MATH 109,B03,093479,Ganzberger; Geoffrey Michael,6,0,32,26
1657024260423,MATH 142A,A01,083219,Chow; Bennett,6,0,32,26
1657024260423,MATH 142A,A02,083220,Chow; Bennett,10,0,32,22
1657024260423,MATH 142A,A03,093480,Chow; Bennett,7,0,32,25
1657024260423,MATH 142A,B03,093481,Chow; Bennett,7,0,32,25
1657024260423,MATH 142A,B04,093558,Chow; Bennett,11,0,32,21
1657024260423,MATH 142A,B05,093559,Chow; Bennett,6,0,32,26
1657024266451,MATH 193A,A01,083224,Rotar; Vladimir,7,0,34,27
1657024266451,MATH 193A,A02,083225,Rotar; Vladimir,4,0,34,30
1657024266451,MATH 193A,A03,083781,Rotar; Vladimir,1,0,34,33
1657024266451,MATH 193A,A04,083782,Rotar; Vladimir,6,0,34,28
1657024266451,MATH 193A,A05,093482,Rotar; Vladimir,6,0,34,28
1657024272480,MATH 197,001,091859,McAuley; Julian John,9999,0,9999,0
1657024272480,MATH 197,002,095566,Kedlaya; Kiran S.,9997,0,9999,2
1657024272480,MATH 197,003,095567,Xiao; Ming,9999,0,9999,0
1657024272480,MATH 197,004,095571,Perols; Johan Lars,9998,0,9999,1
1657024279557,COGS 9,A01,083615,Shannon; Kyle Michael,7,0,75,68
1657024285583,COGS 11,A01,083617,Boyle; Mary E. T.,20,0,48,28
1657024291611,COGS 13,A01,083071,Bastos; Amalia Pinkusfeld,9,0,71,62
1657024297637,COGS 14A,A01,092681,Semenuks; Arturs,0,1,100,100
1657024303672,COGS 14B,A01,083073,Cheng; Tzu-Han,5,0,63,58
1657024309696,COGS 17,A01,092677,Semenuks; Arturs,4,0,81,77
1657024315731,COGS 100,A01,083619,Allen; Michael Gordon,15,0,70,55
1657024321756,COGS 101A,A01,083621,Davis; Joshua Daniel,9,0,68,59
1657024327781,COGS 101B,A01,091572,Allen; Michael Gordon,8,0,65,57
1657024333821,COGS 101C,A01,083625,Delgado; Tania,17,0,35,18
1657024339852,COGS 107A,A01,083627,Boyle; Mary E. T.,13,0,60,47
1657024345887,COGS 118A,A01,083075,Gupta; Anjum,15,0,76,61
1657024351912,CSE 3,A50,083646,Miranda; Gregory Joseph,22,0,50,28
1657024357936,CSE 8A,A50,083650,Miranda; Gregory Joseph,17,1,56,39
1657024363964,CSE 11,A01,083080,Cao; Yingjun,4,15,40,36
1657024369989,CSE 12,A01,083652,Krause-Levy; Sophia Louisa,21,1,120,99
1657024376015,CSE 15L,A01,083654,Morris; Justin Loren,8,0,50,42
1657024376015,CSE 15L,A02,083655,Morris; Justin Loren,9,0,50,41
1657024382044,CSE 20,A01,083657,Tran; Khoa Dang,37,0,80,43
1657024388071,CSE 21,A01,095574,Bach; Quang Tran,21,0,48,27
1657024394099,CSE 30,A01,083084,Eldon; John,4,0,80,76
1657024394099,CSE 30,B01,095061,Bhaskar; Nishant,6,0,50,44
1657024400128,CSE 100,A01,083659,Cao; Yingjun,3,4,70,67
1657024406259,CSE 134B,A01,083661,Powell; Thomas Allan,19,0,100,81
1657024412290,CSE 140,A01,083663,Gungor; Onat,14,0,85,71
1657024418330,CSE 140L,A01,083088,Eldon; John,16,0,100,84
1657024424357,CSE 175,A01,083665,Kumar; Rakesh,3,0,25,22
1657024430399,CSE 190,A00,092507,Dubnov; Shlomo,7,0,20,13
1657024436428,ECE 45,A01,083139,Congero; Spencer William,5,0,75,70
1657024442457,ECE 65,A50,083695,Saad; Andrew S,12,0,30,18
1657024442457,ECE 65,A51,095125,Saad; Andrew S,25,0,26,1
1657024448492,ECE 109,A01,091882,Touri; Behrouz,16,0,70,54
1657024454516,ECE 180,A00,083140,Abi Samra; Nicholas Camill,1,0,30,29
1657024454516,ECE 180,B00,083141,Abi Samra; Nicholas Camill,0,0,30,30
1657024460544,MATH 10A,A01,083735,Patchell; Gregory David,1,0,30,29
1657024460544,MATH 10A,A02,083736,Patchell; Gregory David,20,0,30,10
1657024460544,MATH 10A,A03,083737,Patchell; Gregory David,16,0,30,14
1657024466587,MATH 10B,A01,083207,Lim; Seonhee,7,0,34,27
1657024466587,MATH 10B,A02,083208,Lim; Seonhee,9,0,35,26
1657024466587,MATH 10B,A03,093472,Lim; Seonhee,4,0,34,30
1657024466587,MATH 10B,B01,083739,Sinha; Shubham,9,0,30,21
1657024472626,MATH 18,A01,083743,Cinel; Cameron Alexander,6,0,30,24
1657024472626,MATH 18,A02,083744,Cinel; Cameron Alexander,15,0,30,15
1657024472626,MATH 18,A03,083745,Cinel; Cameron Alexander,8,0,30,22
1657024472626,MATH 18,B01,083748,Rideout; David Porter,4,0,37,33
1657024472626,MATH 18,B02,083749,Rideout; David Porter,3,0,36,33
1657024472626,MATH 18,B03,083750,Rideout; David Porter,2,0,37,35
1657024472626,MATH 18,B04,083751,Rideout; David Porter,5,0,36,31
1657024472626,MATH 18,B05,093473,Rideout; David Porter,4,0,36,32
1657024472626,MATH 18,B06,093474,Rideout; David Porter,5,0,36,31
1657024478659,MATH 20A,A01,083754,Zheng; Zequn,12,0,40,28
1657024484691,MATH 20B,A01,083756,Briones; Jor-el Thomas Caparas,1,0,36,35
1657024484691,MATH 20B,A02,083757,Briones; Jor-el Thomas Caparas,1,0,36,35
1657024484691,MATH 20B,A03,093475,Briones; Jor-el Thomas Caparas,0,0,36,36
1657024490717,MATH 20C,A01,083760,Briones; Jor-el Thomas Caparas,1,0,35,34
1657024490717,MATH 20C,A02,083761,Briones; Jor-el Thomas Caparas,8,0,35,27
1657024490717,MATH 20C,A03,093476,Briones; Jor-el Thomas Caparas,0,1,36,36
1657024490717,MATH 20C,B01,083762,Bach; Quang Tran,0,0,30,30
1657024496745,MATH 20D,A01,083765,Tran; Brian Kha,4,0,30,26
1657024496745,MATH 20D,A02,083766,Tran; Brian Kha,5,0,30,25
1657024496745,MATH 20D,A03,083767,Tran; Brian Kha,3,0,30,27
1657024502772,MATH 20E,A01,083771,Ganguly; Soumya,5,0,32,27
1657024502772,MATH 20E,A02,083772,Ganguly; Soumya,6,0,32,26
1657024502772,MATH 20E,B01,083773,Ciotti; Benjamin,18,0,35,17
1657024502772,MATH 20E,B02,083774,Ciotti; Benjamin,17,0,35,18
1657024508804,MATH 103A,A01,083777,Greenfeld; Be'Eri,2,0,36,34
1657024508804,MATH 103A,A02,083778,Greenfeld; Be'Eri,5,0,36,31
1657024508804,MATH 103A,A03,093561,Greenfeld; Be'Eri,4,0,36,32
1657024508804,MATH 103A,B01,083779,Greenfeld; Be'Eri,6,0,36,30
1657024508804,MATH 103A,B02,083780,Greenfeld; Be'Eri,2,0,36,34
1657024508804,MATH 103A,B03,093562,Greenfeld; Be'Eri,2,0,36,34
1657024514832,MATH 105,A01,085443,Carter; Anne Toulson,14,0,35,21
1657024514832,MATH 105,A02,093477,Carter; Anne Toulson,20,0,35,15
1657024520871,MATH 109,A01,083213,Ganzberger; Geoffrey Michael,2,0,34,32
1657024520871,MATH 109,A02,083214,Ganzberger; Geoffrey Michael,2,0,34,32
1657024520871,MATH 109,A03,093478,Ganzberger; Geoffrey Michael,1,0,34,33
1657024520871,MATH 109,B01,083215,Ganzberger; Geoffrey Michael,1,0,32,31
1657024520871,MATH 109,B02,083216,Ganzberger; Geoffrey Michael,1,0,32,31
1657024520871,MATH 109,B03,093479,Ganzberger; Geoffrey Michael,6,0,32,26
1657024526905,MATH 142A,A01,083219,Chow; Bennett,6,0,32,26
1657024526905,MATH 142A,A02,083220,Chow; Bennett,10,0,32,22
1657024526905,MATH 142A,A03,093480,Chow; Bennett,7,0,32,25
1657024526905,MATH 142A,B03,093481,Chow; Bennett,7,0,32,25
1657024526905,MATH 142A,B04,093558,Chow; Bennett,11,0,32,21
1657024526905,MATH 142A,B05,093559,Chow; Bennett,6,0,32,26
1657024532937,MATH 193A,A01,083224,Rotar; Vladimir,7,0,34,27
1657024532937,MATH 193A,A02,083225,Rotar; Vladimir,4,0,34,30
1657024532937,MATH 193A,A03,083781,Rotar; Vladimir,1,0,34,33
1657024532937,MATH 193A,A04,083782,Rotar; Vladimir,6,0,34,28
1657024532937,MATH 193A,A05,093482,Rotar; Vladimir,6,0,34,28
1657024538959,MATH 197,001,091859,McAuley; Julian John,9999,0,9999,0
1657024538959,MATH 197,002,095566,Kedlaya; Kiran S.,9997,0,9999,2
1657024538959,MATH 197,003,095567,Xiao; Ming,9999,0,9999,0
1657024538959,MATH 197,004,095571,Perols; Johan Lars,9998,0,9999,1
1657024546045,COGS 9,A01,083615,Shannon; Kyle Michael,7,0,75,68
1657024552070,COGS 11,A01,083617,Boyle; Mary E. T.,20,0,48,28
1657024558098,COGS 13,A01,083071,Bastos; Amalia Pinkusfeld,9,0,71,62
1657024564124,COGS 14A,A01,092681,Semenuks; Arturs,0,1,100,100
1657024570156,COGS 14B,A01,083073,Cheng; Tzu-Han,5,0,63,58
1657024576185,COGS 17,A01,092677,Semenuks; Arturs,4,0,81,77
1657024582217,COGS 100,A01,083619,Allen; Michael Gordon,15,0,70,55
1657024588243,COGS 101A,A01,083621,Davis; Joshua Daniel,9,0,68,59
1657024594272,COGS 101B,A01,091572,Allen; Michael Gordon,8,0,65,57
1657024600302,COGS 101C,A01,083625,Delgado; Tania,17,0,35,18
1657024606335,COGS 107A,A01,083627,Boyle; Mary E. T.,13,0,60,47
1657024612363,COGS 118A,A01,083075,Gupta; Anjum,15,0,76,61
1657024618412,CSE 3,A50,083646,Miranda; Gregory Joseph,22,0,50,28
1657024624437,CSE 8A,A50,083650,Miranda; Gregory Joseph,17,1,56,39
1657024630467,CSE 11,A01,083080,Cao; Yingjun,4,15,40,36
1657024636492,CSE 12,A01,083652,Krause-Levy; Sophia Louisa,21,1,120,99
1657024642521,CSE 15L,A01,083654,Morris; Justin Loren,8,0,50,42
1657024642521,CSE 15L,A02,083655,Morris; Justin Loren,9,0,50,41
1657024648546,CSE 20,A01,083657,Tran; Khoa Dang,37,0,80,43
1657024654582,CSE 21,A01,095574,Bach; Quang Tran,21,0,48,27
1657024660608,CSE 30,A01,083084,Eldon; John,4,0,80,76
1657024660608,CSE 30,B01,095061,Bhaskar; Nishant,6,0,50,44
1657024666635,CSE 100,A01,083659,Cao; Yingjun,3,4,70,67
1657024672664,CSE 134B,A01,083661,Powell; Thomas Allan,19,0,100,81
1657024678694,CSE 140,A01,083663,Gungor; Onat,14,0,85,71
1657024684722,CSE 140L,A01,083088,Eldon; John,16,0,100,84
1657024690752,CSE 175,A01,083665,Kumar; Rakesh,3,0,25,22
1657024696779,CSE 190,A00,092507,Dubnov; Shlomo,7,0,20,13
1657024702803,ECE 45,A01,083139,Congero; Spencer William,5,0,75,70
1657024708829,ECE 65,A50,083695,Saad; Andrew S,12,0,30,18
1657024708829,ECE 65,A51,095125,Saad; Andrew S,25,0,26,1
1657024714925,ECE 109,A01,091882,Touri; Behrouz,16,0,70,54
1657024720961,ECE 180,A00,083140,Abi Samra; Nicholas Camill,1,0,30,29
1657024720961,ECE 180,B00,083141,Abi Samra; Nicholas Camill,0,0,30,30
1657024726990,MATH 10A,A01,083735,Patchell; Gregory David,1,0,30,29
1657024726990,MATH 10A,A02,083736,Patchell; Gregory David,20,0,30,10
1657024726990,MATH 10A,A03,083737,Patchell; Gregory David,16,0,30,14
1657024733023,MATH 10B,A01,083207,Lim; Seonhee,7,0,34,27
1657024733023,MATH 10B,A02,083208,Lim; Seonhee,9,0,35,26
1657024733023,MATH 10B,A03,093472,Lim; Seonhee,4,0,34,30
1657024733023,MATH 10B,B01,083739,Sinha; Shubham,9,0,30,21
1657024739048,MATH 18,A01,083743,Cinel; Cameron Alexander,6,0,30,24
1657024739048,MATH 18,A02,083744,Cinel; Cameron Alexander,15,0,30,15
1657024739048,MATH 18,A03,083745,Cinel; Cameron Alexander,8,0,30,22
1657024739048,MATH 18,B01,083748,Rideout; David Porter,4,0,37,33
1657024739048,MATH 18,B02,083749,Rideout; David Porter,3,0,36,33
1657024739048,MATH 18,B03,083750,Rideout; David Porter,2,0,37,35
1657024739048,MATH 18,B04,083751,Rideout; David Porter,5,0,36,31
1657024739048,MATH 18,B05,093473,Rideout; David Porter,4,0,36,32
1657024739048,MATH 18,B06,093474,Rideout; David Porter,5,0,36,31
1657024745079,MATH 20A,A01,083754,Zheng; Zequn,12,0,40,28
1657024751102,MATH 20B,A01,083756,Briones; Jor-el Thomas Caparas,1,0,36,35
1657024751102,MATH 20B,A02,083757,Briones; Jor-el Thomas Caparas,1,0,36,35
1657024751102,MATH 20B,A03,093475,Briones; Jor-el Thomas Caparas,0,0,36,36
1657024757140,MATH 20C,A01,083760,Briones; Jor-el Thomas Caparas,1,0,35,34
1657024757140,MATH 20C,A02,083761,Briones; Jor-el Thomas Caparas,8,0,35,27
1657024757140,MATH 20C,A03,093476,Briones; Jor-el Thomas Caparas,0,1,36,36
1657024757140,MATH 20C,B01,083762,Bach; Quang Tran,0,0,30,30
1657024763170,MATH 20D,A01,083765,Tran; Brian Kha,4,0,30,26
1657024763170,MATH 20D,A02,083766,Tran; Brian Kha,5,0,30,25
1657024763170,MATH 20D,A03,083767,Tran; Brian Kha,3,0,30,27
1657024769200,MATH 20E,A01,083771,Ganguly; Soumya,5,0,32,27
1657024769200,MATH 20E,A02,083772,Ganguly; Soumya,6,0,32,26
1657024769200,MATH 20E,B01,083773,Ciotti; Benjamin,18,0,35,17
1657024769200,MATH 20E,B02,083774,Ciotti; Benjamin,17,0,35,18
1657024775231,MATH 103A,A01,083777,Greenfeld; Be'Eri,2,0,36,34
1657024775231,MATH 103A,A02,083778,Greenfeld; Be'Eri,5,0,36,31
1657024775231,MATH 103A,A03,093561,Greenfeld; Be'Eri,4,0,36,32
1657024775231,MATH 103A,B01,083779,Greenfeld; Be'Eri,6,0,36,30
1657024775231,MATH 103A,B02,083780,Greenfeld; Be'Eri,2,0,36,34
1657024775231,MATH 103A,B03,093562,Greenfeld; Be'Eri,2,0,36,34
1657024781258,MATH 105,A01,085443,Carter; Anne Toulson,14,0,35,21
1657024781258,MATH 105,A02,093477,Carter; Anne Toulson,20,0,35,15
1657024787282,MATH 109,A01,083213,Ganzberger; Geoffrey Michael,2,0,34,32
1657024787282,MATH 109,A02,083214,Ganzberger; Geoffrey Michael,2,0,34,32
1657024787282,MATH 109,A03,093478,Ganzberger; Geoffrey Michael,1,0,34,33
1657024787282,MATH 109,B01,083215,Ganzberger; Geoffrey Michael,1,0,32,31
1657024787282,MATH 109,B02,083216,Ganzberger; Geoffrey Michael,1,0,32,31
1657024787282,MATH 109,B03,093479,Ganzberger; Geoffrey Michael,6,0,32,26
1657024793312,MATH 142A,A01,083219,Chow; Bennett,6,0,32,26
1657024793312,MATH 142A,A02,083220,Chow; Bennett,10,0,32,22
1657024793312,MATH 142A,A03,093480,Chow; Bennett,7,0,32,25
1657024793312,MATH 142A,B03,093481,Chow; Bennett,7,0,32,25
1657024793312,MATH 142A,B04,093558,Chow; Bennett,11,0,32,21
1657024793312,MATH 142A,B05,093559,Chow; Bennett,6,0,32,26
1657024799337,MATH 193A,A01,083224,Rotar; Vladimir,7,0,34,27
1657024799337,MATH 193A,A02,083225,Rotar; Vladimir,4,0,34,30
1657024799337,MATH 193A,A03,083781,Rotar; Vladimir,1,0,34,33
1657024799337,MATH 193A,A04,083782,Rotar; Vladimir,6,0,34,28
1657024799337,MATH 193A,A05,093482,Rotar; Vladimir,6,0,34,28
1657024805367,MATH 197,001,091859,McAuley; Julian John,9999,0,9999,0
1657024805367,MATH 197,002,095566,Kedlaya; Kiran S.,9997,0,9999,2
1657024805367,MATH 197,003,095567,Xiao; Ming,9999,0,9999,0
1657024805367,MATH 197,004,095571,Perols; Johan Lars,9998,0,9999,1
1657024812427,COGS 9,A01,083615,Shannon; Kyle Michael,7,0,75,68
1657024818454,COGS 11,A01,083617,Boyle; Mary E. T.,20,0,48,28
1657024824478,COGS 13,A01,083071,Bastos; Amalia Pinkusfeld,9,0,71,62
1657024830508,COGS 14A,A01,092681,Semenuks; Arturs,0,1,100,100
1657024836537,COGS 14B,A01,083073,Cheng; Tzu-Han,5,0,63,58
1657024842561,COGS 17,A01,092677,Semenuks; Arturs,4,0,81,77
1657024848601,COGS 100,A01,083619,Allen; Michael Gordon,15,0,70,55
1657024854631,COGS 101A,A01,083621,Davis; Joshua Daniel,9,0,68,59
1657024860655,COGS 101B,A01,091572,Allen; Michael Gordon,8,0,65,57
1657024866684,COGS 101C,A01,083625,Delgado; Tania,17,0,35,18
1657024872709,COGS 107A,A01,083627,Boyle; Mary E. T.,13,0,60,47
1657024878733,COGS 118A,A01,083075,Gupta; Anjum,15,0,76,61
1657024884759,CSE 3,A50,083646,Miranda; Gregory Joseph,22,0,50,28
1657024890783,CSE 8A,A50,083650,Miranda; Gregory Joseph,17,1,56,39
1657024896813,CSE 11,A01,083080,Cao; Yingjun,4,15,40,36
1657024902840,CSE 12,A01,083652,Krause-Levy; Sophia Louisa,21,1,120,99
1657024908867,CSE 15L,A01,083654,Morris; Justin Loren,8,0,50,42
1657024908867,CSE 15L,A02,083655,Morris; Justin Loren,9,0,50,41
1657024914894,CSE 20,A01,083657,Tran; Khoa Dang,37,0,80,43
1657024920920,CSE 21,A01,095574,Bach; Quang Tran,21,0,48,27
1657024926950,CSE 30,A01,083084,Eldon; John,4,0,80,76
1657024926950,CSE 30,B01,095061,Bhaskar; Nishant,6,0,50,44
1657024932977,CSE 100,A01,083659,Cao; Yingjun,3,4,70,67
1657024939005,CSE 134B,A01,083661,Powell; Thomas Allan,19,0,100,81
1657024945028,CSE 140,A01,083663,Gungor; Onat,14,0,85,71
1657024951067,CSE 140L,A01,083088,Eldon; John,16,0,100,84
1657024957096,CSE 175,A01,083665,Kumar; Rakesh,3,0,25,22
1657024963129,CSE 190,A00,092507,Dubnov; Shlomo,7,0,20,13
1657024969155,ECE 45,A01,083139,Congero; Spencer William,5,0,75,70
1657024975179,ECE 65,A50,083695,Saad; Andrew S,12,0,30,18
1657024975179,ECE 65,A51,095125,Saad; Andrew S,25,0,26,1
1657024981209,ECE 109,A01,091882,Touri; Behrouz,16,0,70,54
1657024987232,ECE 180,A00,083140,Abi Samra; Nicholas Camill,1,0,30,29
1657024987232,ECE 180,B00,083141,Abi Samra; Nicholas Camill,0,0,30,30
1657024993256,MATH 10A,A01,083735,Patchell; Gregory David,1,0,30,29
1657024993256,MATH 10A,A02,083736,Patchell; Gregory David,20,0,30,10
1657024993256,MATH 10A,A03,083737,Patchell; Gregory David,16,0,30,14
1657024999282,MATH 10B,A01,083207,Lim; Seonhee,7,0,34,27
1657024999282,MATH 10B,A02,083208,Lim; Seonhee,9,0,35,26
1657024999282,MATH 10B,A03,093472,Lim; Seonhee,4,0,34,30
1657024999282,MATH 10B,B01,083739,Sinha; Shubham,9,0,30,21
1657025005307,MATH 18,A01,083743,Cinel; Cameron Alexander,6,0,30,24
1657025005307,MATH 18,A02,083744,Cinel; Cameron Alexander,15,0,30,15
1657025005307,MATH 18,A03,083745,Cinel; Cameron Alexander,8,0,30,22
1657025005307,MATH 18,B01,083748,Rideout; David Porter,4,0,37,33
1657025005307,MATH 18,B02,083749,Rideout; David Porter,3,0,36,33
1657025005307,MATH 18,B03,083750,Rideout; David Porter,2,0,37,35
1657025005307,MATH 18,B04,083751,Rideout; David Porter,5,0,36,31
1657025005307,MATH 18,B05,093473,Rideout; David Porter,4,0,36,32
1657025005307,MATH 18,B06,093474,Rideout; David Porter,5,0,36,31
1657025011337,MATH 20A,A01,083754,Zheng; Zequn,12,0,40,28
1657025017365,MATH 20B,A01,083756,Briones; Jor-el Thomas Caparas,1,0,36,35
1657025017365,MATH 20B,A02,083757,Briones; Jor-el Thomas Caparas,1,0,36,35
1657025017365,MATH 20B,A03,093475,Briones; Jor-el Thomas Caparas,0,0,36,36
1657025023391,MATH 20C,A01,083760,Briones; Jor-el Thomas Caparas,1,0,35,34
1657025023391,MATH 20C,A02,083761,Briones; Jor-el Thomas Caparas,8,0,35,27
1657025023391,MATH 20C,A03,093476,Briones; Jor-el Thomas Caparas,0,1,36,36
1657025023391,MATH 20C,B01,083762,Bach; Quang Tran,0,0,30,30
1657025029417,MATH 20D,A01,083765,Tran; Brian Kha,4,0,30,26
1657025029417,MATH 20D,A02,083766,Tran; Brian Kha,5,0,30,25
1657025029417,MATH 20D,A03,083767,Tran; Brian Kha,3,0,30,27
1657025035444,MATH 20E,A01,083771,Ganguly; Soumya,5,0,32,27
1657025035444,MATH 20E,A02,083772,Ganguly; Soumya,6,0,32,26
1657025035444,MATH 20E,B01,083773,Ciotti; Benjamin,18,0,35,17
1657025035444,MATH 20E,B02,083774,Ciotti; Benjamin,17,0,35,18
1657025041473,MATH 103A,A01,083777,Greenfeld; Be'Eri,2,0,36,34
1657025041473,MATH 103A,A02,083778,Greenfeld; Be'Eri,5,0,36,31
1657025041473,MATH 103A,A03,093561,Greenfeld; Be'Eri,4,0,36,32
1657025041473,MATH 103A,B01,083779,Greenfeld; Be'Eri,6,0,36,30
1657025041473,MATH 103A,B02,083780,Greenfeld; Be'Eri,2,0,36,34
1657025041473,MATH 103A,B03,093562,Greenfeld; Be'Eri,2,0,36,34
1657025047498,MATH 105,A01,085443,Carter; Anne Toulson,14,0,35,21
1657025047498,MATH 105,A02,093477,Carter; Anne Toulson,20,0,35,15
1657025053525,MATH 109,A01,083213,Ganzberger; Geoffrey Michael,2,0,34,32
1657025053525,MATH 109,A02,083214,Ganzberger; Geoffrey Michael,2,0,34,32
1657025053525,MATH 109,A03,093478,Ganzberger; Geoffrey Michael,1,0,34,33
1657025053525,MATH 109,B01,083215,Ganzberger; Geoffrey Michael,1,0,32,31
1657025053525,MATH 109,B02,083216,Ganzberger; Geoffrey Michael,1,0,32,31
1657025053525,MATH 109,B03,093479,Ganzberger; Geoffrey Michael,6,0,32,26
1657025059552,MATH 142A,A01,083219,Chow; Bennett,6,0,32,26
1657025059552,MATH 142A,A02,083220,Chow; Bennett,10,0,32,22
1657025059552,MATH 142A,A03,093480,Chow; Bennett,7,0,32,25
1657025059552,MATH 142A,B03,093481,Chow; Bennett,7,0,32,25
1657025059552,MATH 142A,B04,093558,Chow; Bennett,11,0,32,21
1657025059552,MATH 142A,B05,093559,Chow; Bennett,6,0,32,26
1657025065577,MATH 193A,A01,083224,Rotar; Vladimir,7,0,34,27
1657025065577,MATH 193A,A02,083225,Rotar; Vladimir,4,0,34,30
1657025065577,MATH 193A,A03,083781,Rotar; Vladimir,1,0,34,33
1657025065577,MATH 193A,A04,083782,Rotar; Vladimir,6,0,34,28
1657025065577,MATH 193A,A05,093482,Rotar; Vladimir,6,0,34,28
1657025071606,MATH 197,001,091859,McAuley; Julian John,9999,0,9999,0
1657025071606,MATH 197,002,095566,Kedlaya; Kiran S.,9997,0,9999,2
1657025071606,MATH 197,003,095567,Xiao; Ming,9999,0,9999,0
1657025071606,MATH 197,004,095571,Perols; Johan Lars,9998,0,9999,1
1657025078668,COGS 9,A01,083615,Shannon; Kyle Michael,7,0,75,68
1657025084692,COGS 11,A01,083617,Boyle; Mary E. T.,20,0,48,28
1657025090725,COGS 13,A01,083071,Bastos; Amalia Pinkusfeld,9,0,71,62
1657025096750,COGS 14A,A01,092681,Semenuks; Arturs,0,1,100,100
1657025102779,COGS 14B,A01,083073,Cheng; Tzu-Han,5,0,63,58
1657025108803,COGS 17,A01,092677,Semenuks; Arturs,4,0,81,77
1657025114831,COGS 100,A01,083619,Allen; Michael Gordon,15,0,70,55
1657025120859,COGS 101A,A01,083621,Davis; Joshua Daniel,9,0,68,59
1657025126888,COGS 101B,A01,091572,Allen; Michael Gordon,8,0,65,57
1657025132916,COGS 101C,A01,083625,Delgado; Tania,17,0,35,18
1657025138941,COGS 107A,A01,083627,Boyle; Mary E. T.,13,0,60,47
1657025144969,COGS 118A,A01,083075,Gupta; Anjum,15,0,76,61
1657025150997,CSE 3,A50,083646,Miranda; Gregory Joseph,22,0,50,28
1657025157025,CSE 8A,A50,083650,Miranda; Gregory Joseph,17,1,56,39
1657025163050,CSE 11,A01,083080,Cao; Yingjun,4,15,40,36
1657025169088,CSE 12,A01,083652,Krause-Levy; Sophia Louisa,21,1,120,99
1657025175114,CSE 15L,A01,083654,Morris; Justin Loren,8,0,50,42
1657025175114,CSE 15L,A02,083655,Morris; Justin Loren,9,0,50,41
1657025181139,CSE 20,A01,083657,Tran; Khoa Dang,37,0,80,43
1657025187167,CSE 21,A01,095574,Bach; Quang Tran,21,0,48,27
1657025193194,CSE 30,A01,083084,Eldon; John,4,0,80,76
1657025193194,CSE 30,B01,095061,Bhaskar; Nishant,6,0,50,44
1657025199224,CSE 100,A01,083659,Cao; Yingjun,3,4,70,67
1657025205248,CSE 134B,A01,083661,Powell; Thomas Allan,19,0,100,81
1657025211279,CSE 140,A01,083663,Gungor; Onat,14,0,85,71
1657025217305,CSE 140L,A01,083088,Eldon; John,16,0,100,84
1657025223339,CSE 175,A01,083665,Kumar; Rakesh,3,0,25,22
1657025229365,CSE 190,A00,092507,Dubnov; Shlomo,7,0,20,13
1657025235391,ECE 45,A01,083139,Congero; Spencer William,5,0,75,70
1657025241417,ECE 65,A50,083695,Saad; Andrew S,12,0,30,18
1657025241417,ECE 65,A51,095125,Saad; Andrew S,25,0,26,1
1657025247441,ECE 109,A01,091882,Touri; Behrouz,16,0,70,54
1657025253470,ECE 180,A00,083140,Abi Samra; Nicholas Camill,1,0,30,29
1657025253470,ECE 180,B00,083141,Abi Samra; Nicholas Camill,0,0,30,30
1657025259494,MATH 10A,A01,083735,Patchell; Gregory David,1,0,30,29
1657025259494,MATH 10A,A02,083736,Patchell; Gregory David,20,0,30,10
1657025259494,MATH 10A,A03,083737,Patchell; Gregory David,16,0,30,14
1657025265522,MATH 10B,A01,083207,Lim; Seonhee,7,0,34,27
1657025265522,MATH 10B,A02,083208,Lim; Seonhee,9,0,35,26
1657025265522,MATH 10B,A03,093472,Lim; Seonhee,4,0,34,30
1657025265522,MATH 10B,B01,083739,Sinha; Shubham,9,0,30,21
1657025271549,MATH 18,A01,083743,Cinel; Cameron Alexander,6,0,30,24
1657025271549,MATH 18,A02,083744,Cinel; Cameron Alexander,15,0,30,15
1657025271549,MATH 18,A03,083745,Cinel; Cameron Alexander,8,0,30,22
1657025271549,MATH 18,B01,083748,Rideout; David Porter,4,0,37,33
1657025271549,MATH 18,B02,083749,Rideout; David Porter,3,0,36,33
1657025271549,MATH 18,B03,083750,Rideout; David Porter,2,0,37,35
1657025271549,MATH 18,B04,083751,Rideout; David Porter,5,0,36,31
1657025271549,MATH 18,B05,093473,Rideout; David Porter,4,0,36,32
1657025271549,MATH 18,B06,093474,Rideout; David Porter,5,0,36,31
1657025277578,MATH 20A,A01,083754,Zheng; Zequn,12,0,40,28
1657025283602,MATH 20B,A01,083756,Briones; Jor-el Thomas Caparas,1,0,36,35
1657025283602,MATH 20B,A02,083757,Briones; Jor-el Thomas Caparas,1,0,36,35
1657025283602,MATH 20B,A03,093475,Briones; Jor-el Thomas Caparas,0,0,36,36
1657025289629,MATH 20C,A01,083760,Briones; Jor-el Thomas Caparas,1,0,35,34
1657025289629,MATH 20C,A02,083761,Briones; Jor-el Thomas Caparas,8,0,35,27
1657025289629,MATH 20C,A03,093476,Briones; Jor-el Thomas Caparas,0,1,36,36
1657025289629,MATH 20C,B01,083762,Bach; Quang Tran,0,0,30,30
1657025295656,MATH 20D,A01,083765,Tran; Brian Kha,4,0,30,26
1657025295656,MATH 20D,A02,083766,Tran; Brian Kha,5,0,30,25
1657025295656,MATH 20D,A03,083767,Tran; Brian Kha,3,0,30,27
1657025301684,MATH 20E,A01,083771,Ganguly; Soumya,5,0,32,27
1657025301684,MATH 20E,A02,083772,Ganguly; Soumya,6,0,32,26
1657025301684,MATH 20E,B01,083773,Ciotti; Benjamin,18,0,35,17
1657025301684,MATH 20E,B02,083774,Ciotti; Benjamin,17,0,35,18
1657025307707,MATH 103A,A01,083777,Greenfeld; Be'Eri,2,0,36,34
1657025307707,MATH 103A,A02,083778,Greenfeld; Be'Eri,5,0,36,31
1657025307707,MATH 103A,A03,093561,Greenfeld; Be'Eri,4,0,36,32
1657025307707,MATH 103A,B01,083779,Greenfeld; Be'Eri,6,0,36,30
1657025307707,MATH 103A,B02,083780,Greenfeld; Be'Eri,2,0,36,34
1657025307707,MATH 103A,B03,093562,Greenfeld; Be'Eri,2,0,36,34
1657025313816,MATH 105,A01,085443,Carter; Anne Toulson,14,0,35,21
1657025313816,MATH 105,A02,093477,Carter; Anne Toulson,20,0,35,15
1657025319849,MATH 109,A01,083213,Ganzberger; Geoffrey Michael,2,0,34,32
1657025319849,MATH 109,A02,083214,Ganzberger; Geoffrey Michael,2,0,34,32
1657025319849,MATH 109,A03,093478,Ganzberger; Geoffrey Michael,1,0,34,33
1657025319849,MATH 109,B01,083215,Ganzberger; Geoffrey Michael,1,0,32,31
1657025319849,MATH 109,B02,083216,Ganzberger; Geoffrey Michael,1,0,32,31
1657025319849,MATH 109,B03,093479,Ganzberger; Geoffrey Michael,6,0,32,26
1657025325876,MATH 142A,A01,083219,Chow; Bennett,6,0,32,26
1657025325876,MATH 142A,A02,083220,Chow; Bennett,10,0,32,22
1657025325876,MATH 142A,A03,093480,Chow; Bennett,7,0,32,25
1657025325876,MATH 142A,B03,093481,Chow; Bennett,7,0,32,25
1657025325876,MATH 142A,B04,093558,Chow; Bennett,11,0,32,21
1657025325876,MATH 142A,B05,093559,Chow; Bennett,6,0,32,26
1657025331904,MATH 193A,A01,083224,Rotar; Vladimir,7,0,34,27
1657025331904,MATH 193A,A02,083225,Rotar; Vladimir,4,0,34,30
1657025331904,MATH 193A,A03,083781,Rotar; Vladimir,1,0,34,33
1657025331904,MATH 193A,A04,083782,Rotar; Vladimir,6,0,34,28
1657025331904,MATH 193A,A05,093482,Rotar; Vladimir,6,0,34,28
1657025337930,MATH 197,001,091859,McAuley; Julian John,9999,0,9999,0
1657025337930,MATH 197,002,095566,Kedlaya; Kiran S.,9997,0,9999,2
1657025337930,MATH 197,003,095567,Xiao; Ming,9999,0,9999,0
1657025337930,MATH 197,004,095571,Perols; Johan Lars,9998,0,9999,1
1657025345000,COGS 9,A01,083615,Shannon; Kyle Michael,7,0,75,68
1657025351026,COGS 11,A01,083617,Boyle; Mary E. T.,20,0,48,28
1657025357051,COGS 13,A01,083071,Bastos; Amalia Pinkusfeld,9,0,71,62
1657025363076,COGS 14A,A01,092681,Semenuks; Arturs,0,1,100,100
1657025369101,COGS 14B,A01,083073,Cheng; Tzu-Han,5,0,63,58
1657025375132,COGS 17,A01,092677,Semenuks; Arturs,4,0,81,77
1657025381157,COGS 100,A01,083619,Allen; Michael Gordon,15,0,70,55
1657025387183,COGS 101A,A01,083621,Davis; Joshua Daniel,9,0,68,59
1657025393213,COGS 101B,A01,091572,Allen; Michael Gordon,8,0,65,57
1657025399244,COGS 101C,A01,083625,Delgado; Tania,17,0,35,18
1657025405270,COGS 107A,A01,083627,Boyle; Mary E. T.,13,0,60,47
1657025411299,COGS 118A,A01,083075,Gupta; Anjum,15,0,76,61
1657025417330,CSE 3,A50,083646,Miranda; Gregory Joseph,22,0,50,28
1657025423361,CSE 8A,A50,083650,Miranda; Gregory Joseph,17,1,56,39
1657025429388,CSE 11,A01,083080,Cao; Yingjun,4,15,40,36
1657025435414,CSE 12,A01,083652,Krause-Levy; Sophia Louisa,21,1,120,99
1657025441452,CSE 15L,A01,083654,Morris; Justin Loren,8,0,50,42
1657025441452,CSE 15L,A02,083655,Morris; Justin Loren,9,0,50,41
1657025447481,CSE 20,A01,083657,Tran; Khoa Dang,37,0,80,43
1657025453507,CSE 21,A01,095574,Bach; Quang Tran,21,0,48,27
1657025459539,CSE 30,A01,083084,Eldon; John,4,0,80,76
1657025459539,CSE 30,B01,095061,Bhaskar; Nishant,6,0,50,44
1657025465565,CSE 100,A01,083659,Cao; Yingjun,3,4,70,67
1657025471594,CSE 134B,A01,083661,Powell; Thomas Allan,19,0,100,81
1657025477620,CSE 140,A01,083663,Gungor; Onat,14,0,85,71
1657025483646,CSE 140L,A01,083088,Eldon; John,16,0,100,84
1657025489674,CSE 175,A01,083665,Kumar; Rakesh,3,0,25,22
1657025495704,CSE 190,A00,092507,Dubnov; Shlomo,7,0,20,13
1657025501735,ECE 45,A01,083139,Congero; Spencer William,5,0,75,70
1657025507762,ECE 65,A50,083695,Saad; Andrew S,12,0,30,18
1657025507762,ECE 65,A51,095125,Saad; Andrew S,25,0,26,1
1657025513788,ECE 109,A01,091882,Touri; Behrouz,16,0,70,54
1657025519825,ECE 180,A00,083140,Abi Samra; Nicholas Camill,1,0,30,29
1657025519825,ECE 180,B00,083141,Abi Samra; Nicholas Camill,0,0,30,30
1657025525859,MATH 10A,A01,083735,Patchell; Gregory David,1,0,30,29
1657025525859,MATH 10A,A02,083736,Patchell; Gregory David,20,0,30,10
1657025525859,MATH 10A,A03,083737,Patchell; Gregory David,16,0,30,14
1657025531888,MATH 10B,A01,083207,Lim; Seonhee,7,0,34,27
1657025531888,MATH 10B,A02,083208,Lim; Seonhee,9,0,35,26
1657025531888,MATH 10B,A03,093472,Lim; Seonhee,4,0,34,30
1657025531888,MATH 10B,B01,083739,Sinha; Shubham,9,0,30,21
1657025537918,MATH 18,A01,083743,Cinel; Cameron Alexander,6,0,30,24
1657025537918,MATH 18,A02,083744,Cinel; Cameron Alexander,15,0,30,15
1657025537918,MATH 18,A03,083745,Cinel; Cameron Alexander,8,0,30,22
1657025537918,MATH 18,B01,083748,Rideout; David Porter,4,0,37,33
1657025537918,MATH 18,B02,083749,Rideout; David Porter,3,0,36,33
1657025537918,MATH 18,B03,083750,Rideout; David Porter,2,0,37,35
1657025537918,MATH 18,B04,083751,Rideout; David Porter,5,0,36,31
1657025537918,MATH 18,B05,093473,Rideout; David Porter,4,0,36,32
1657025537918,MATH 18,B06,093474,Rideout; David Porter,5,0,36,31
1657025543947,MATH 20A,A01,083754,Zheng; Zequn,12,0,40,28
1657025549975,MATH 20B,A01,083756,Briones; Jor-el Thomas Caparas,1,0,36,35
1657025549975,MATH 20B,A02,083757,Briones; Jor-el Thomas Caparas,1,0,36,35
1657025549975,MATH 20B,A03,093475,Briones; Jor-el Thomas Caparas,0,0,36,36
1657025556003,MATH 20C,A01,083760,Briones; Jor-el Thomas Caparas,1,0,35,34
1657025556003,MATH 20C,A02,083761,Briones; Jor-el Thomas Caparas,8,0,35,27
1657025556003,MATH 20C,A03,093476,Briones; Jor-el Thomas Caparas,0,1,36,36
1657025556003,MATH 20C,B01,083762,Bach; Quang Tran,0,0,30,30
1657025562032,MATH 20D,A01,083765,Tran; Brian Kha,4,0,30,26
1657025562032,MATH 20D,A02,083766,Tran; Brian Kha,5,0,30,25
1657025562032,MATH 20D,A03,083767,Tran; Brian Kha,3,0,30,27
1657025568061,MATH 20E,A01,083771,Ganguly; Soumya,5,0,32,27
1657025568061,MATH 20E,A02,083772,Ganguly; Soumya,6,0,32,26
1657025568061,MATH 20E,B01,083773,Ciotti; Benjamin,18,0,35,17
1657025568061,MATH 20E,B02,083774,Ciotti; Benjamin,17,0,35,18
1657025574089,MATH 103A,A01,083777,Greenfeld; Be'Eri,2,0,36,34
1657025574089,MATH 103A,A02,083778,Greenfeld; Be'Eri,5,0,36,31
1657025574089,MATH 103A,A03,093561,Greenfeld; Be'Eri,4,0,36,32
1657025574089,MATH 103A,B01,083779,Greenfeld; Be'Eri,6,0,36,30
1657025574089,MATH 103A,B02,083780,Greenfeld; Be'Eri,2,0,36,34
1657025574089,MATH 103A,B03,093562,Greenfeld; Be'Eri,2,0,36,34
1657025580120,MATH 105,A01,085443,Carter; Anne Toulson,14,0,35,21
1657025580120,MATH 105,A02,093477,Carter; Anne Toulson,20,0,35,15
1657025586144,MATH 109,A01,083213,Ganzberger; Geoffrey Michael,2,0,34,32
1657025586144,MATH 109,A02,083214,Ganzberger; Geoffrey Michael,2,0,34,32
1657025586144,MATH 109,A03,093478,Ganzberger; Geoffrey Michael,1,0,34,33
1657025586144,MATH 109,B01,083215,Ganzberger; Geoffrey Michael,1,0,32,31
1657025586144,MATH 109,B02,083216,Ganzberger; Geoffrey Michael,1,0,32,31
1657025586144,MATH 109,B03,093479,Ganzberger; Geoffrey Michael,6,0,32,26
1657025592178,MATH 142A,A01,083219,Chow; Bennett,6,0,32,26
1657025592178,MATH 142A,A02,083220,Chow; Bennett,10,0,32,22
1657025592178,MATH 142A,A03,093480,Chow; Bennett,7,0,32,25
1657025592178,MATH 142A,B03,093481,Chow; Bennett,7,0,32,25
1657025592178,MATH 142A,B04,093558,Chow; Bennett,11,0,32,21
1657025592178,MATH 142A,B05,093559,Chow; Bennett,6,0,32,26
1657025598203,MATH 193A,A01,083224,Rotar; Vladimir,7,0,34,27
1657025598203,MATH 193A,A02,083225,Rotar; Vladimir,4,0,34,30
1657025598203,MATH 193A,A03,083781,Rotar; Vladimir,1,0,34,33
1657025598203,MATH 193A,A04,083782,Rotar; Vladimir,6,0,34,28
1657025598203,MATH 193A,A05,093482,Rotar; Vladimir,6,0,34,28
1657025604231,MATH 197,001,091859,McAuley; Julian John,9999,0,9999,0
1657025604231,MATH 197,002,095566,Kedlaya; Kiran S.,9997,0,9999,2
1657025604231,MATH 197,003,095567,Xiao; Ming,9999,0,9999,0
1657025604231,MATH 197,004,095571,Perols; Johan Lars,9998,0,9999,1
1657025611301,COGS 9,A01,083615,Shannon; Kyle Michael,7,0,75,68
1657025617328,COGS 11,A01,083617,Boyle; Mary E. T.,20,0,48,28
1657025623363,COGS 13,A01,083071,Bastos; Amalia Pinkusfeld,9,0,71,62
1657025629390,COGS 14A,A01,092681,Semenuks; Arturs,0,1,100,100
1657025635415,COGS 14B,A01,083073,Cheng; Tzu-Han,5,0,63,58
1657025641439,COGS 17,A01,092677,Semenuks; Arturs,4,0,81,77
1657025647464,COGS 100,A01,083619,Allen; Michael Gordon,15,0,70,55
1657025653490,COGS 101A,A01,083621,Davis; Joshua Daniel,9,0,68,59
1657025659519,COGS 101B,A01,091572,Allen; Michael Gordon,8,0,65,57
1657025665551,COGS 101C,A01,083625,Delgado; Tania,17,0,35,18
1657025671581,COGS 107A,A01,083627,Boyle; Mary E. T.,13,0,60,47
1657025677614,COGS 118A,A01,083075,Gupta; Anjum,15,0,76,61
1657025683643,CSE 3,A50,083646,Miranda; Gregory Joseph,22,0,50,28
1657025689672,CSE 8A,A50,083650,Miranda; Gregory Joseph,17,1,56,39
1657025695698,CSE 11,A01,083080,Cao; Yingjun,4,15,40,36
1657025701722,CSE 12,A01,083652,Krause-Levy; Sophia Louisa,21,1,120,99
1657025707751,CSE 15L,A01,083654,Morris; Justin Loren,8,0,50,42
1657025707751,CSE 15L,A02,083655,Morris; Justin Loren,9,0,50,41
1657025713780,CSE 20,A01,083657,Tran; Khoa Dang,37,0,80,43
1657025719809,CSE 21,A01,095574,Bach; Quang Tran,21,0,48,27
1657025725845,CSE 30,A01,083084,Eldon; John,4,0,80,76
1657025725845,CSE 30,B01,095061,Bhaskar; Nishant,6,0,50,44
1657025731885,CSE 100,A01,083659,Cao; Yingjun,3,4,70,67
1657025737914,CSE 134B,A01,083661,Powell; Thomas Allan,19,0,100,81
1657025743943,CSE 140,A01,083663,Gungor; Onat,14,0,85,71
1657025749969,CSE 140L,A01,083088,Eldon; John,16,0,100,84
1657025756000,CSE 175,A01,083665,Kumar; Rakesh,3,0,25,22
1657025762023,CSE 190,A00,092507,Dubnov; Shlomo,7,0,20,13
1657025768049,ECE 45,A01,083139,Congero; Spencer William,5,0,75,70
1657025774074,ECE 65,A50,083695,Saad; Andrew S,12,0,30,18
1657025774074,ECE 65,A51,095125,Saad; Andrew S,25,0,26,1
1657025780117,ECE 109,A01,091882,Touri; Behrouz,16,0,70,54
1657025786142,ECE 180,A00,083140,Abi Samra; Nicholas Camill,1,0,30,29
1657025786142,ECE 180,B00,083141,Abi Samra; Nicholas Camill,0,0,30,30
1657025792173,MATH 10A,A01,083735,Patchell; Gregory David,1,0,30,29
1657025792173,MATH 10A,A02,083736,Patchell; Gregory David,20,0,30,10
1657025792173,MATH 10A,A03,083737,Patchell; Gregory David,16,0,30,14
1657025798204,MATH 10B,A01,083207,Lim; Seonhee,7,0,34,27
1657025798204,MATH 10B,A02,083208,Lim; Seonhee,9,0,35,26
1657025798204,MATH 10B,A03,093472,Lim; Seonhee,4,0,34,30
1657025798204,MATH 10B,B01,083739,Sinha; Shubham,9,0,30,21
1657025804239,MATH 18,A01,083743,Cinel; Cameron Alexander,6,0,30,24
1657025804239,MATH 18,A02,083744,Cinel; Cameron Alexander,15,0,30,15
1657025804239,MATH 18,A03,083745,Cinel; Cameron Alexander,8,0,30,22
1657025804239,MATH 18,B01,083748,Rideout; David Porter,4,0,37,33
1657025804239,MATH 18,B02,083749,Rideout; David Porter,3,0,36,33
1657025804239,MATH 18,B03,083750,Rideout; David Porter,2,0,37,35
1657025804239,MATH 18,B04,083751,Rideout; David Porter,5,0,36,31
1657025804239,MATH 18,B05,093473,Rideout; David Porter,4,0,36,32
1657025804239,MATH 18,B06,093474,Rideout; David Porter,5,0,36,31
1657025810265,MATH 20A,A01,083754,Zheng; Zequn,12,0,40,28
1657025816295,MATH 20B,A01,083756,Briones; Jor-el Thomas Caparas,1,0,36,35
1657025816295,MATH 20B,A02,083757,Briones; Jor-el Thomas Caparas,1,0,36,35
1657025816295,MATH 20B,A03,093475,Briones; Jor-el Thomas Caparas,0,0,36,36
1657025822328,MATH 20C,A01,083760,Briones; Jor-el Thomas Caparas,1,0,35,34
1657025822328,MATH 20C,A02,083761,Briones; Jor-el Thomas Caparas,8,0,35,27
1657025822328,MATH 20C,A03,093476,Briones; Jor-el Thomas Caparas,0,1,36,36
1657025822328,MATH 20C,B01,083762,Bach; Quang Tran,0,0,30,30
1657025828359,MATH 20D,A01,083765,Tran; Brian Kha,4,0,30,26
1657025828359,MATH 20D,A02,083766,Tran; Brian Kha,5,0,30,25
1657025828359,MATH 20D,A03,083767,Tran; Brian Kha,3,0,30,27
1657025834391,MATH 20E,A01,083771,Ganguly; Soumya,5,0,32,27
1657025834391,MATH 20E,A02,083772,Ganguly; Soumya,6,0,32,26
1657025834391,MATH 20E,B01,083773,Ciotti; Benjamin,18,0,35,17
1657025834391,MATH 20E,B02,083774,Ciotti; Benjamin,17,0,35,18
1657025840422,MATH 103A,A01,083777,Greenfeld; Be'Eri,2,0,36,34
1657025840422,MATH 103A,A02,083778,Greenfeld; Be'Eri,5,0,36,31
1657025840422,MATH 103A,A03,093561,Greenfeld; Be'Eri,4,0,36,32
1657025840422,MATH 103A,B01,083779,Greenfeld; Be'Eri,6,0,36,30
1657025840422,MATH 103A,B02,083780,Greenfeld; Be'Eri,2,0,36,34
1657025840422,MATH 103A,B03,093562,Greenfeld; Be'Eri,2,0,36,34
1657025846453,MATH 105,A01,085443,Carter; Anne Toulson,14,0,35,21
1657025846453,MATH 105,A02,093477,Carter; Anne Toulson,20,0,35,15
1657025852487,MATH 109,A01,083213,Ganzberger; Geoffrey Michael,2,0,34,32
1657025852487,MATH 109,A02,083214,Ganzberger; Geoffrey Michael,2,0,34,32
1657025852487,MATH 109,A03,093478,Ganzberger; Geoffrey Michael,1,0,34,33
1657025852487,MATH 109,B01,083215,Ganzberger; Geoffrey Michael,1,0,32,31
1657025852487,MATH 109,B02,083216,Ganzberger; Geoffrey Michael,1,0,32,31
1657025852487,MATH 109,B03,093479,Ganzberger; Geoffrey Michael,6,0,32,26
1657025858521,MATH 142A,A01,083219,Chow; Bennett,6,0,32,26
1657025858521,MATH 142A,A02,083220,Chow; Bennett,10,0,32,22
1657025858521,MATH 142A,A03,093480,Chow; Bennett,7,0,32,25
1657025858521,MATH 142A,B03,093481,Chow; Bennett,7,0,32,25
1657025858521,MATH 142A,B04,093558,Chow; Bennett,11,0,32,21
1657025858521,MATH 142A,B05,093559,Chow; Bennett,6,0,32,26
1657025864551,MATH 193A,A01,083224,Rotar; Vladimir,7,0,34,27
1657025864551,MATH 193A,A02,083225,Rotar; Vladimir,4,0,34,30
1657025864551,MATH 193A,A03,083781,Rotar; Vladimir,1,0,34,33
1657025864551,MATH 193A,A04,083782,Rotar; Vladimir,6,0,34,28
1657025864551,MATH 193A,A05,093482,Rotar; Vladimir,6,0,34,28
1657025870577,MATH 197,001,091859,McAuley; Julian John,9999,0,9999,0
1657025870577,MATH 197,002,095566,Kedlaya; Kiran S.,9997,0,9999,2
1657025870577,MATH 197,003,095567,Xiao; Ming,9999,0,9999,0
1657025870577,MATH 197,004,095571,Perols; Johan Lars,9998,0,9999,1
1657025877641,COGS 9,A01,083615,Shannon; Kyle Michael,7,0,75,68
1657025883668,COGS 11,A01,083617,Boyle; Mary E. T.,20,0,48,28
1657025889696,COGS 13,A01,083071,Bastos; Amalia Pinkusfeld,9,0,71,62
1657025895721,COGS 14A,A01,092681,Semenuks; Arturs,0,1,100,100
1657025901749,COGS 14B,A01,083073,Cheng; Tzu-Han,5,0,63,58
1657025907861,COGS 17,A01,092677,Semenuks; Arturs,4,0,81,77
1657025913889,COGS 100,A01,083619,Allen; Michael Gordon,15,0,70,55
1657025919913,COGS 101A,A01,083621,Davis; Joshua Daniel,9,0,68,59
1657025925941,COGS 101B,A01,091572,Allen; Michael Gordon,8,0,65,57
1657025931989,COGS 101C,A01,083625,Delgado; Tania,17,0,35,18
1657025938013,COGS 107A,A01,083627,Boyle; Mary E. T.,13,0,60,47
1657025944041,COGS 118A,A01,083075,Gupta; Anjum,15,0,76,61
1657025950067,CSE 3,A50,083646,Miranda; Gregory Joseph,22,0,50,28
1657025956093,CSE 8A,A50,083650,Miranda; Gregory Joseph,17,1,56,39
1657025962117,CSE 11,A01,083080,Cao; Yingjun,4,15,40,36
1657025968146,CSE 12,A01,083652,Krause-Levy; Sophia Louisa,21,1,120,99
1657025974173,CSE 15L,A01,083654,Morris; Justin Loren,8,0,50,42
1657025974173,CSE 15L,A02,083655,Morris; Justin Loren,9,0,50,41
1657025980204,CSE 20,A01,083657,Tran; Khoa Dang,37,0,80,43
1657025986235,CSE 21,A01,095574,Bach; Quang Tran,21,0,48,27
1657025992259,CSE 30,A01,083084,Eldon; John,4,0,80,76
1657025992259,CSE 30,B01,095061,Bhaskar; Nishant,6,0,50,44
1657025998284,CSE 100,A01,083659,Cao; Yingjun,3,4,70,67
1657026004313,CSE 134B,A01,083661,Powell; Thomas Allan,19,0,100,81
1657026010341,CSE 140,A01,083663,Gungor; Onat,14,0,85,71
1657026016366,CSE 140L,A01,083088,Eldon; John,16,0,100,84
1657026022393,CSE 175,A01,083665,Kumar; Rakesh,3,0,25,22
1657026028427,CSE 190,A00,092507,Dubnov; Shlomo,7,0,20,13
1657026034457,ECE 45,A01,083139,Congero; Spencer William,5,0,75,70
1657026040481,ECE 65,A50,083695,Saad; Andrew S,12,0,30,18
1657026040481,ECE 65,A51,095125,Saad; Andrew S,25,0,26,1
1657026046511,ECE 109,A01,091882,Touri; Behrouz,16,0,70,54
1657026052537,ECE 180,A00,083140,Abi Samra; Nicholas Camill,1,0,30,29
1657026052537,ECE 180,B00,083141,Abi Samra; Nicholas Camill,0,0,30,30
1657026058570,MATH 10A,A01,083735,Patchell; Gregory David,1,0,30,29
1657026058570,MATH 10A,A02,083736,Patchell; Gregory David,20,0,30,10
1657026058570,MATH 10A,A03,083737,Patchell; Gregory David,16,0,30,14
1657026064598,MATH 10B,A01,083207,Lim; Seonhee,7,0,34,27
1657026064598,MATH 10B,A02,083208,Lim; Seonhee,9,0,35,26
1657026064598,MATH 10B,A03,093472,Lim; Seonhee,4,0,34,30
1657026064598,MATH 10B,B01,083739,Sinha; Shubham,9,0,30,21
1657026070644,MATH 18,A01,083743,Cinel; Cameron Alexander,6,0,30,24
1657026070644,MATH 18,A02,083744,Cinel; Cameron Alexander,15,0,30,15
1657026070644,MATH 18,A03,083745,Cinel; Cameron Alexander,8,0,30,22
1657026070644,MATH 18,B01,083748,Rideout; David Porter,4,0,37,33
1657026070644,MATH 18,B02,083749,Rideout; David Porter,3,0,36,33
1657026070644,MATH 18,B03,083750,Rideout; David Porter,2,0,37,35
1657026070644,MATH 18,B04,083751,Rideout; David Porter,5,0,36,31
1657026070644,MATH 18,B05,093473,Rideout; David Porter,4,0,36,32
1657026070644,MATH 18,B06,093474,Rideout; David Porter,5,0,36,31
1657026076671,MATH 20A,A01,083754,Zheng; Zequn,12,0,40,28
1657026082705,MATH 20B,A01,083756,Briones; Jor-el Thomas Caparas,1,0,36,35
1657026082705,MATH 20B,A02,083757,Briones; Jor-el Thomas Caparas,1,0,36,35
1657026082705,MATH 20B,A03,093475,Briones; Jor-el Thomas Caparas,0,0,36,36
1657026088734,MATH 20C,A01,083760,Briones; Jor-el Thomas Caparas,1,0,35,34
1657026088734,MATH 20C,A02,083761,Briones; Jor-el Thomas Caparas,8,0,35,27
1657026088734,MATH 20C,A03,093476,Briones; Jor-el Thomas Caparas,0,1,36,36
1657026088734,MATH 20C,B01,083762,Bach; Quang Tran,0,0,30,30
1657026094759,MATH 20D,A01,083765,Tran; Brian Kha,4,0,30,26
1657026094759,MATH 20D,A02,083766,Tran; Brian Kha,5,0,30,25
1657026094759,MATH 20D,A03,083767,Tran; Brian Kha,3,0,30,27
1657026100792,MATH 20E,A01,083771,Ganguly; Soumya,5,0,32,27
1657026100792,MATH 20E,A02,083772,Ganguly; Soumya,6,0,32,26
1657026100792,MATH 20E,B01,083773,Ciotti; Benjamin,18,0,35,17
1657026100792,MATH 20E,B02,083774,Ciotti; Benjamin,17,0,35,18
1657026106820,MATH 103A,A01,083777,Greenfeld; Be'Eri,2,0,36,34
1657026106820,MATH 103A,A02,083778,Greenfeld; Be'Eri,5,0,36,31
1657026106820,MATH 103A,A03,093561,Greenfeld; Be'Eri,4,0,36,32
1657026106820,MATH 103A,B01,083779,Greenfeld; Be'Eri,6,0,36,30
1657026106820,MATH 103A,B02,083780,Greenfeld; Be'Eri,2,0,36,34
1657026106820,MATH 103A,B03,093562,Greenfeld; Be'Eri,2,0,36,34
1657026112846,MATH 105,A01,085443,Carter; Anne Toulson,14,0,35,21
1657026112846,MATH 105,A02,093477,Carter; Anne Toulson,20,0,35,15
1657026118886,MATH 109,A01,083213,Ganzberger; Geoffrey Michael,2,0,34,32
1657026118886,MATH 109,A02,083214,Ganzberger; Geoffrey Michael,2,0,34,32
1657026118886,MATH 109,A03,093478,Ganzberger; Geoffrey Michael,1,0,34,33
1657026118886,MATH 109,B01,083215,Ganzberger; Geoffrey Michael,1,0,32,31
1657026118886,MATH 109,B02,083216,Ganzberger; Geoffrey Michael,1,0,32,31
1657026118886,MATH 109,B03,093479,Ganzberger; Geoffrey Michael,6,0,32,26
1657026124914,MATH 142A,A01,083219,Chow; Bennett,6,0,32,26
1657026124914,MATH 142A,A02,083220,Chow; Bennett,10,0,32,22
1657026124914,MATH 142A,A03,093480,Chow; Bennett,7,0,32,25
1657026124914,MATH 142A,B03,093481,Chow; Bennett,7,0,32,25
1657026124914,MATH 142A,B04,093558,Chow; Bennett,11,0,32,21
1657026124914,MATH 142A,B05,093559,Chow; Bennett,6,0,32,26
1657026130946,MATH 193A,A01,083224,Rotar; Vladimir,7,0,34,27
1657026130946,MATH 193A,A02,083225,Rotar; Vladimir,4,0,34,30
1657026130946,MATH 193A,A03,083781,Rotar; Vladimir,1,0,34,33
1657026130946,MATH 193A,A04,083782,Rotar; Vladimir,6,0,34,28
1657026130946,MATH 193A,A05,093482,Rotar; Vladimir,6,0,34,28
1657026136981,MATH 197,001,091859,McAuley; Julian John,9999,0,9999,0
1657026136981,MATH 197,002,095566,Kedlaya; Kiran S.,9997,0,9999,2
1657026136981,MATH 197,003,095567,Xiao; Ming,9999,0,9999,0
1657026136981,MATH 197,004,095571,Perols; Johan Lars,9998,0,9999,1
1657026144052,COGS 9,A01,083615,Shannon; Kyle Michael,7,0,75,68
1657026150079,COGS 11,A01,083617,Boyle; Mary E. T.,20,0,48,28
1657026156106,COGS 13,A01,083071,Bastos; Amalia Pinkusfeld,9,0,71,62
1657026162139,COGS 14A,A01,092681,Semenuks; Arturs,0,1,100,100
1657026168165,COGS 14B,A01,083073,Cheng; Tzu-Han,5,0,63,58
1657026174191,COGS 17,A01,092677,Semenuks; Arturs,4,0,81,77
1657026180216,COGS 100,A01,083619,Allen; Michael Gordon,15,0,70,55
1657026186241,COGS 101A,A01,083621,Davis; Joshua Daniel,9,0,68,59
1657026192266,COGS 101B,A01,091572,Allen; Michael Gordon,8,0,65,57
1657026198296,COGS 101C,A01,083625,Delgado; Tania,17,0,35,18
1657026204320,COGS 107A,A01,083627,Boyle; Mary E. T.,13,0,60,47
1657026210348,COGS 118A,A01,083075,Gupta; Anjum,15,0,76,61
1657026216372,CSE 3,A50,083646,Miranda; Gregory Joseph,22,0,50,28
1657026222397,CSE 8A,A50,083650,Miranda; Gregory Joseph,17,1,56,39
1657026228421,CSE 11,A01,083080,Cao; Yingjun,4,15,40,36
1657026234446,CSE 12,A01,083652,Krause-Levy; Sophia Louisa,21,1,120,99
1657026240477,CSE 15L,A01,083654,Morris; Justin Loren,8,0,50,42
1657026240477,CSE 15L,A02,083655,Morris; Justin Loren,9,0,50,41
1657026246500,CSE 20,A01,083657,Tran; Khoa Dang,37,0,80,43
1657026252531,CSE 21,A01,095574,Bach; Quang Tran,21,0,48,27
1657026258561,CSE 30,A01,083084,Eldon; John,4,0,80,76
1657026258561,CSE 30,B01,095061,Bhaskar; Nishant,6,0,50,44
1657026264593,CSE 100,A01,083659,Cao; Yingjun,3,4,70,67
1657026270617,CSE 134B,A01,083661,Powell; Thomas Allan,19,0,100,81
1657026276641,CSE 140,A01,083663,Gungor; Onat,14,0,85,71
1657026282666,CSE 140L,A01,083088,Eldon; John,16,0,100,84
1657026288691,CSE 175,A01,083665,Kumar; Rakesh,3,0,25,22
1657026294722,CSE 190,A00,092507,Dubnov; Shlomo,7,0,20,13
1657026300751,ECE 45,A01,083139,Congero; Spencer William,5,0,75,70
1657026306780,ECE 65,A50,083695,Saad; Andrew S,12,0,30,18
1657026306780,ECE 65,A51,095125,Saad; Andrew S,25,0,26,1
1657026312805,ECE 109,A01,091882,Touri; Behrouz,16,0,70,54
1657026318840,ECE 180,A00,083140,Abi Samra; Nicholas Camill,1,0,30,29
1657026318840,ECE 180,B00,083141,Abi Samra; Nicholas Camill,0,0,30,30
1657026324866,MATH 10A,A01,083735,Patchell; Gregory David,1,0,30,29
1657026324866,MATH 10A,A02,083736,Patchell; Gregory David,20,0,30,10
1657026324866,MATH 10A,A03,083737,Patchell; Gregory David,16,0,30,14
1657026330899,MATH 10B,A01,083207,Lim; Seonhee,7,0,34,27
1657026330899,MATH 10B,A02,083208,Lim; Seonhee,9,0,35,26
1657026330899,MATH 10B,A03,093472,Lim; Seonhee,4,0,34,30
1657026330899,MATH 10B,B01,083739,Sinha; Shubham,9,0,30,21
1657026336926,MATH 18,A01,083743,Cinel; Cameron Alexander,6,0,30,24
1657026336926,MATH 18,A02,083744,Cinel; Cameron Alexander,15,0,30,15
1657026336926,MATH 18,A03,083745,Cinel; Cameron Alexander,8,0,30,22
1657026336926,MATH 18,B01,083748,Rideout; David Porter,4,0,37,33
1657026336926,MATH 18,B02,083749,Rideout; David Porter,3,0,36,33
1657026336926,MATH 18,B03,083750,Rideout; David Porter,2,0,37,35
1657026336926,MATH 18,B04,083751,Rideout; David Porter,5,0,36,31
1657026336926,MATH 18,B05,093473,Rideout; David Porter,4,0,36,32
1657026336926,MATH 18,B06,093474,Rideout; David Porter,5,0,36,31
1657026342951,MATH 20A,A01,083754,Zheng; Zequn,12,0,40,28
1657026348978,MATH 20B,A01,083756,Briones; Jor-el Thomas Caparas,1,0,36,35
1657026348978,MATH 20B,A02,083757,Briones; Jor-el Thomas Caparas,1,0,36,35
1657026348978,MATH 20B,A03,093475,Briones; Jor-el Thomas Caparas,0,0,36,36
1657026355007,MATH 20C,A01,083760,Briones; Jor-el Thomas Caparas,1,0,35,34
1657026355007,MATH 20C,A02,083761,Briones; Jor-el Thomas Caparas,8,0,35,27
1657026355007,MATH 20C,A03,093476,Briones; Jor-el Thomas Caparas,0,1,36,36
1657026355007,MATH 20C,B01,083762,Bach; Quang Tran,0,0,30,30
1657026361039,MATH 20D,A01,083765,Tran; Brian Kha,4,0,30,26
1657026361039,MATH 20D,A02,083766,Tran; Brian Kha,5,0,30,25
1657026361039,MATH 20D,A03,083767,Tran; Brian Kha,3,0,30,27
1657026367065,MATH 20E,A01,083771,Ganguly; Soumya,5,0,32,27
1657026367065,MATH 20E,A02,083772,Ganguly; Soumya,6,0,32,26
1657026367065,MATH 20E,B01,083773,Ciotti; Benjamin,18,0,35,17
1657026367065,MATH 20E,B02,083774,Ciotti; Benjamin,17,0,35,18
1657026373099,MATH 103A,A01,083777,Greenfeld; Be'Eri,2,0,36,34
1657026373099,MATH 103A,A02,083778,Greenfeld; Be'Eri,5,0,36,31
1657026373099,MATH 103A,A03,093561,Greenfeld; Be'Eri,4,0,36,32
1657026373099,MATH 103A,B01,083779,Greenfeld; Be'Eri,6,0,36,30
1657026373099,MATH 103A,B02,083780,Greenfeld; Be'Eri,2,0,36,34
1657026373099,MATH 103A,B03,093562,Greenfeld; Be'Eri,2,0,36,34
1657026379131,MATH 105,A01,085443,Carter; Anne Toulson,14,0,35,21
1657026379131,MATH 105,A02,093477,Carter; Anne Toulson,20,0,35,15
1657026385154,MATH 109,A01,083213,Ganzberger; Geoffrey Michael,2,0,34,32
1657026385154,MATH 109,A02,083214,Ganzberger; Geoffrey Michael,2,0,34,32
1657026385154,MATH 109,A03,093478,Ganzberger; Geoffrey Michael,1,0,34,33
1657026385154,MATH 109,B01,083215,Ganzberger; Geoffrey Michael,1,0,32,31
1657026385154,MATH 109,B02,083216,Ganzberger; Geoffrey Michael,1,0,32,31
1657026385154,MATH 109,B03,093479,Ganzberger; Geoffrey Michael,6,0,32,26
1657026391187,MATH 142A,A01,083219,Chow; Bennett,6,0,32,26
1657026391187,MATH 142A,A02,083220,Chow; Bennett,10,0,32,22
1657026391187,MATH 142A,A03,093480,Chow; Bennett,7,0,32,25
1657026391187,MATH 142A,B03,093481,Chow; Bennett,7,0,32,25
1657026391187,MATH 142A,B04,093558,Chow; Bennett,11,0,32,21
1657026391187,MATH 142A,B05,093559,Chow; Bennett,6,0,32,26
1657026397215,MATH 193A,A01,083224,Rotar; Vladimir,7,0,34,27
1657026397215,MATH 193A,A02,083225,Rotar; Vladimir,4,0,34,30
1657026397215,MATH 193A,A03,083781,Rotar; Vladimir,1,0,34,33
1657026397215,MATH 193A,A04,083782,Rotar; Vladimir,6,0,34,28
1657026397215,MATH 193A,A05,093482,Rotar; Vladimir,6,0,34,28
1657026403241,MATH 197,001,091859,McAuley; Julian John,9999,0,9999,0
1657026403241,MATH 197,002,095566,Kedlaya; Kiran S.,9997,0,9999,2
1657026403241,MATH 197,003,095567,Xiao; Ming,9999,0,9999,0
1657026403241,MATH 197,004,095571,Perols; Johan Lars,9998,0,9999,1
1657026410313,COGS 9,A01,083615,Shannon; Kyle Michael,7,0,75,68
1657026416336,COGS 11,A01,083617,Boyle; Mary E. T.,20,0,48,28
1657026422363,COGS 13,A01,083071,Bastos; Amalia Pinkusfeld,9,0,71,62
1657026428392,COGS 14A,A01,092681,Semenuks; Arturs,0,1,100,100
1657026434416,COGS 14B,A01,083073,Cheng; Tzu-Han,5,0,63,58
1657026440444,COGS 17,A01,092677,Semenuks; Arturs,4,0,81,77
1657026446469,COGS 100,A01,083619,Allen; Michael Gordon,15,0,70,55
1657026452494,COGS 101A,A01,083621,Davis; Joshua Daniel,9,0,68,59
1657026458522,COGS 101B,A01,091572,Allen; Michael Gordon,8,0,65,57
1657026464549,COGS 101C,A01,083625,Delgado; Tania,17,0,35,18
1657026470572,COGS 107A,A01,083627,Boyle; Mary E. T.,13,0,60,47
1657026476597,COGS 118A,A01,083075,Gupta; Anjum,15,0,76,61
1657026482625,CSE 3,A50,083646,Miranda; Gregory Joseph,22,0,50,28
1657026488653,CSE 8A,A50,083650,Miranda; Gregory Joseph,17,1,56,39
1657026494679,CSE 11,A01,083080,Cao; Yingjun,4,15,40,36
1657026500703,CSE 12,A01,083652,Krause-Levy; Sophia Louisa,21,1,120,99
1657026506805,CSE 15L,A01,083654,Morris; Justin Loren,8,0,50,42
1657026506805,CSE 15L,A02,083655,Morris; Justin Loren,9,0,50,41
1657026512830,CSE 20,A01,083657,Tran; Khoa Dang,37,0,80,43
1657026518856,CSE 21,A01,095574,Bach; Quang Tran,21,0,48,27
1657026524882,CSE 30,A01,083084,Eldon; John,4,0,80,76
1657026524882,CSE 30,B01,095061,Bhaskar; Nishant,6,0,50,44
1657026530906,CSE 100,A01,083659,Cao; Yingjun,3,4,70,67
1657026536930,CSE 134B,A01,083661,Powell; Thomas Allan,19,0,100,81
1657026542959,CSE 140,A01,083663,Gungor; Onat,14,0,85,71
1657026548985,CSE 140L,A01,083088,Eldon; John,16,0,100,84
1657026555008,CSE 175,A01,083665,Kumar; Rakesh,3,0,25,22
1657026561037,CSE 190,A00,092507,Dubnov; Shlomo,7,0,20,13
1657026567062,ECE 45,A01,083139,Congero; Spencer William,5,0,75,70
1657026573088,ECE 65,A50,083695,Saad; Andrew S,12,0,30,18
1657026573088,ECE 65,A51,095125,Saad; Andrew S,25,0,26,1
1657026579120,ECE 109,A01,091882,Touri; Behrouz,16,0,70,54
1657026585154,ECE 180,A00,083140,Abi Samra; Nicholas Camill,1,0,30,29
1657026585154,ECE 180,B00,083141,Abi Samra; Nicholas Camill,0,0,30,30
1657026591179,MATH 10A,A01,083735,Patchell; Gregory David,1,0,30,29
1657026591179,MATH 10A,A02,083736,Patchell; Gregory David,20,0,30,10
1657026591179,MATH 10A,A03,083737,Patchell; Gregory David,16,0,30,14
1657026597216,MATH 10B,A01,083207,Lim; Seonhee,7,0,34,27
1657026597216,MATH 10B,A02,083208,Lim; Seonhee,9,0,35,26
1657026597216,MATH 10B,A03,093472,Lim; Seonhee,4,0,34,30
1657026597216,MATH 10B,B01,083739,Sinha; Shubham,9,0,30,21
1657026603242,MATH 18,A01,083743,Cinel; Cameron Alexander,6,0,30,24
1657026603242,MATH 18,A02,083744,Cinel; Cameron Alexander,15,0,30,15
1657026603242,MATH 18,A03,083745,Cinel; Cameron Alexander,8,0,30,22
1657026603242,MATH 18,B01,083748,Rideout; David Porter,4,0,37,33
1657026603242,MATH 18,B02,083749,Rideout; David Porter,3,0,36,33
1657026603242,MATH 18,B03,083750,Rideout; David Porter,2,0,37,35
1657026603242,MATH 18,B04,083751,Rideout; David Porter,5,0,36,31
1657026603242,MATH 18,B05,093473,Rideout; David Porter,4,0,36,32
1657026603242,MATH 18,B06,093474,Rideout; David Porter,5,0,36,31
1657026609272,MATH 20A,A01,083754,Zheng; Zequn,12,0,40,28
1657026615302,MATH 20B,A01,083756,Briones; Jor-el Thomas Caparas,1,0,36,35
1657026615302,MATH 20B,A02,083757,Briones; Jor-el Thomas Caparas,1,0,36,35
1657026615302,MATH 20B,A03,093475,Briones; Jor-el Thomas Caparas,0,0,36,36
1657026621330,MATH 20C,A01,083760,Briones; Jor-el Thomas Caparas,1,0,35,34
1657026621330,MATH 20C,A02,083761,Briones; Jor-el Thomas Caparas,8,0,35,27
1657026621330,MATH 20C,A03,093476,Briones; Jor-el Thomas Caparas,0,1,36,36
1657026621330,MATH 20C,B01,083762,Bach; Quang Tran,0,0,30,30
1657026627355,MATH 20D,A01,083765,Tran; Brian Kha,4,0,30,26
1657026627355,MATH 20D,A02,083766,Tran; Brian Kha,5,0,30,25
1657026627355,MATH 20D,A03,083767,Tran; Brian Kha,3,0,30,27
1657026633385,MATH 20E,A01,083771,Ganguly; Soumya,5,0,32,27
1657026633385,MATH 20E,A02,083772,Ganguly; Soumya,6,0,32,26
1657026633385,MATH 20E,B01,083773,Ciotti; Benjamin,18,0,35,17
1657026633385,MATH 20E,B02,083774,Ciotti; Benjamin,17,0,35,18
1657026639413,MATH 103A,A01,083777,Greenfeld; Be'Eri,2,0,36,34
1657026639413,MATH 103A,A02,083778,Greenfeld; Be'Eri,5,0,36,31
1657026639413,MATH 103A,A03,093561,Greenfeld; Be'Eri,4,0,36,32
1657026639413,MATH 103A,B01,083779,Greenfeld; Be'Eri,6,0,36,30
1657026639413,MATH 103A,B02,083780,Greenfeld; Be'Eri,2,0,36,34
1657026639413,MATH 103A,B03,093562,Greenfeld; Be'Eri,2,0,36,34
1657026645439,MATH 105,A01,085443,Carter; Anne Toulson,14,0,35,21
1657026645439,MATH 105,A02,093477,Carter; Anne Toulson,20,0,35,15
1657026651471,MATH 109,A01,083213,Ganzberger; Geoffrey Michael,2,0,34,32
1657026651471,MATH 109,A02,083214,Ganzberger; Geoffrey Michael,2,0,34,32
1657026651471,MATH 109,A03,093478,Ganzberger; Geoffrey Michael,1,0,34,33
1657026651471,MATH 109,B01,083215,Ganzberger; Geoffrey Michael,1,0,32,31
1657026651471,MATH 109,B02,083216,Ganzberger; Geoffrey Michael,1,0,32,31
1657026651471,MATH 109,B03,093479,Ganzberger; Geoffrey Michael,6,0,32,26
1657026657505,MATH 142A,A01,083219,Chow; Bennett,6,0,32,26
1657026657505,MATH 142A,A02,083220,Chow; Bennett,10,0,32,22
1657026657505,MATH 142A,A03,093480,Chow; Bennett,7,0,32,25
1657026657505,MATH 142A,B03,093481,Chow; Bennett,7,0,32,25
1657026657505,MATH 142A,B04,093558,Chow; Bennett,11,0,32,21
1657026657505,MATH 142A,B05,093559,Chow; Bennett,6,0,32,26
1657026663537,MATH 193A,A01,083224,Rotar; Vladimir,7,0,34,27
1657026663537,MATH 193A,A02,083225,Rotar; Vladimir,4,0,34,30
1657026663537,MATH 193A,A03,083781,Rotar; Vladimir,1,0,34,33
1657026663537,MATH 193A,A04,083782,Rotar; Vladimir,6,0,34,28
1657026663537,MATH 193A,A05,093482,Rotar; Vladimir,6,0,34,28
1657026669563,MATH 197,001,091859,McAuley; Julian John,9999,0,9999,0
1657026669563,MATH 197,002,095566,Kedlaya; Kiran S.,9997,0,9999,2
1657026669563,MATH 197,003,095567,Xiao; Ming,9999,0,9999,0
1657026669563,MATH 197,004,095571,Perols; Johan Lars,9998,0,9999,1
1657026676638,COGS 9,A01,083615,Shannon; Kyle Michael,7,0,75,68
1657026682664,COGS 11,A01,083617,Boyle; Mary E. T.,20,0,48,28
1657026688692,COGS 13,A01,083071,Bastos; Amalia Pinkusfeld,9,0,71,62
1657026694722,COGS 14A,A01,092681,Semenuks; Arturs,0,1,100,100
1657026700746,COGS 14B,A01,083073,Cheng; Tzu-Han,5,0,63,58
1657026706769,COGS 17,A01,092677,Semenuks; Arturs,4,0,81,77
1657026712800,COGS 100,A01,083619,Allen; Michael Gordon,15,0,70,55
1657026718827,COGS 101A,A01,083621,Davis; Joshua Daniel,9,0,68,59
1657026724858,COGS 101B,A01,091572,Allen; Michael Gordon,8,0,65,57
1657026730888,COGS 101C,A01,083625,Delgado; Tania,17,0,35,18
1657026736915,COGS 107A,A01,083627,Boyle; Mary E. T.,13,0,60,47
1657026742940,COGS 118A,A01,083075,Gupta; Anjum,15,0,76,61
1657026748967,CSE 3,A50,083646,Miranda; Gregory Joseph,22,0,50,28
1657026754993,CSE 8A,A50,083650,Miranda; Gregory Joseph,17,1,56,39
1657026761017,CSE 11,A01,083080,Cao; Yingjun,4,15,40,36
1657026767042,CSE 12,A01,083652,Krause-Levy; Sophia Louisa,21,1,120,99
1657026773067,CSE 15L,A01,083654,Morris; Justin Loren,8,0,50,42
1657026773067,CSE 15L,A02,083655,Morris; Justin Loren,9,0,50,41
1657026779091,CSE 20,A01,083657,Tran; Khoa Dang,37,0,80,43
1657026785118,CSE 21,A01,095574,Bach; Quang Tran,21,0,48,27
1657026791145,CSE 30,A01,083084,Eldon; John,4,0,80,76
1657026791145,CSE 30,B01,095061,Bhaskar; Nishant,6,0,50,44
1657026797171,CSE 100,A01,083659,Cao; Yingjun,3,4,70,67
1657026803197,CSE 134B,A01,083661,Powell; Thomas Allan,19,0,100,81
1657026809223,CSE 140,A01,083663,Gungor; Onat,14,0,85,71
1657026815251,CSE 140L,A01,083088,Eldon; John,16,0,100,84
1657026821278,CSE 175,A01,083665,Kumar; Rakesh,3,0,25,22
1657026827306,CSE 190,A00,092507,Dubnov; Shlomo,7,0,20,13
1657026833330,ECE 45,A01,083139,Congero; Spencer William,5,0,75,70
1657026839357,ECE 65,A50,083695,Saad; Andrew S,12,0,30,18
1657026839357,ECE 65,A51,095125,Saad; Andrew S,25,0,26,1
1657026845388,ECE 109,A01,091882,Touri; Behrouz,16,0,70,54
1657026851421,ECE 180,A00,083140,Abi Samra; Nicholas Camill,1,0,30,29
1657026851421,ECE 180,B00,083141,Abi Samra; Nicholas Camill,0,0,30,30
1657026857454,MATH 10A,A01,083735,Patchell; Gregory David,1,0,30,29
1657026857454,MATH 10A,A02,083736,Patchell; Gregory David,20,0,30,10
1657026857454,MATH 10A,A03,083737,Patchell; Gregory David,16,0,30,14
1657026863483,MATH 10B,A01,083207,Lim; Seonhee,7,0,34,27
1657026863483,MATH 10B,A02,083208,Lim; Seonhee,9,0,35,26
1657026863483,MATH 10B,A03,093472,Lim; Seonhee,4,0,34,30
1657026863483,MATH 10B,B01,083739,Sinha; Shubham,9,0,30,21
1657026869518,MATH 18,A01,083743,Cinel; Cameron Alexander,6,0,30,24
1657026869518,MATH 18,A02,083744,Cinel; Cameron Alexander,15,0,30,15
1657026869518,MATH 18,A03,083745,Cinel; Cameron Alexander,8,0,30,22
1657026869518,MATH 18,B01,083748,Rideout; David Porter,4,0,37,33
1657026869518,MATH 18,B02,083749,Rideout; David Porter,3,0,36,33
1657026869518,MATH 18,B03,083750,Rideout; David Porter,2,0,37,35
1657026869518,MATH 18,B04,083751,Rideout; David Porter,5,0,36,31
1657026869518,MATH 18,B05,093473,Rideout; David Porter,4,0,36,32
1657026869518,MATH 18,B06,093474,Rideout; David Porter,5,0,36,31
1657026875549,MATH 20A,A01,083754,Zheng; Zequn,12,0,40,28
1657026881574,MATH 20B,A01,083756,Briones; Jor-el Thomas Caparas,1,0,36,35
1657026881574,MATH 20B,A02,083757,Briones; Jor-el Thomas Caparas,1,0,36,35
1657026881574,MATH 20B,A03,093475,Briones; Jor-el Thomas Caparas,0,0,36,36
1657026887608,MATH 20C,A01,083760,Briones; Jor-el Thomas Caparas,1,0,35,34
1657026887608,MATH 20C,A02,083761,Briones; Jor-el Thomas Caparas,8,0,35,27
1657026887608,MATH 20C,A03,093476,Briones; Jor-el Thomas Caparas,0,1,36,36
1657026887608,MATH 20C,B01,083762,Bach; Quang Tran,0,0,30,30
1657026893632,MATH 20D,A01,083765,Tran; Brian Kha,4,0,30,26
1657026893632,MATH 20D,A02,083766,Tran; Brian Kha,5,0,30,25
1657026893632,MATH 20D,A03,083767,Tran; Brian Kha,3,0,30,27
1657026899665,MATH 20E,A01,083771,Ganguly; Soumya,5,0,32,27
1657026899665,MATH 20E,A02,083772,Ganguly; Soumya,6,0,32,26
1657026899665,MATH 20E,B01,083773,Ciotti; Benjamin,18,0,35,17
1657026899665,MATH 20E,B02,083774,Ciotti; Benjamin,17,0,35,18
1657026905695,MATH 103A,A01,083777,Greenfeld; Be'Eri,2,0,36,34
1657026905695,MATH 103A,A02,083778,Greenfeld; Be'Eri,5,0,36,31
1657026905695,MATH 103A,A03,093561,Greenfeld; Be'Eri,4,0,36,32
1657026905695,MATH 103A,B01,083779,Greenfeld; Be'Eri,6,0,36,30
1657026905695,MATH 103A,B02,083780,Greenfeld; Be'Eri,2,0,36,34
1657026905695,MATH 103A,B03,093562,Greenfeld; Be'Eri,2,0,36,34
1657026911724,MATH 105,A01,085443,Carter; Anne Toulson,14,0,35,21
1657026911724,MATH 105,A02,093477,Carter; Anne Toulson,20,0,35,15
1657026917759,MATH 109,A01,083213,Ganzberger; Geoffrey Michael,2,0,34,32
1657026917759,MATH 109,A02,083214,Ganzberger; Geoffrey Michael,2,0,34,32
1657026917759,MATH 109,A03,093478,Ganzberger; Geoffrey Michael,1,0,34,33
1657026917759,MATH 109,B01,083215,Ganzberger; Geoffrey Michael,1,0,32,31
1657026917759,MATH 109,B02,083216,Ganzberger; Geoffrey Michael,1,0,32,31
1657026917759,MATH 109,B03,093479,Ganzberger; Geoffrey Michael,6,0,32,26
1657026923792,MATH 142A,A01,083219,Chow; Bennett,6,0,32,26
1657026923792,MATH 142A,A02,083220,Chow; Bennett,10,0,32,22
1657026923792,MATH 142A,A03,093480,Chow; Bennett,7,0,32,25
1657026923792,MATH 142A,B03,093481,Chow; Bennett,7,0,32,25
1657026923792,MATH 142A,B04,093558,Chow; Bennett,11,0,32,21
1657026923792,MATH 142A,B05,093559,Chow; Bennett,6,0,32,26
1657026929817,MATH 193A,A01,083224,Rotar; Vladimir,7,0,34,27
1657026929817,MATH 193A,A02,083225,Rotar; Vladimir,4,0,34,30
1657026929817,MATH 193A,A03,083781,Rotar; Vladimir,1,0,34,33
1657026929817,MATH 193A,A04,083782,Rotar; Vladimir,6,0,34,28
1657026929817,MATH 193A,A05,093482,Rotar; Vladimir,6,0,34,28
1657026935842,MATH 197,001,091859,McAuley; Julian John,9999,0,9999,0
1657026935842,MATH 197,002,095566,Kedlaya; Kiran S.,9997,0,9999,2
1657026935842,MATH 197,003,095567,Xiao; Ming,9999,0,9999,0
1657026935842,MATH 197,004,095571,Perols; Johan Lars,9998,0,9999,1
1657026942926,COGS 9,A01,083615,Shannon; Kyle Michael,7,0,75,68
1657026948952,COGS 11,A01,083617,Boyle; Mary E. T.,20,0,48,28
1657026954979,COGS 13,A01,083071,Bastos; Amalia Pinkusfeld,9,0,71,62
1657026961012,COGS 14A,A01,092681,Semenuks; Arturs,0,1,100,100
1657026967037,COGS 14B,A01,083073,Cheng; Tzu-Han,5,0,63,58
1657026973060,COGS 17,A01,092677,Semenuks; Arturs,4,0,81,77
1657026979089,COGS 100,A01,083619,Allen; Michael Gordon,15,0,70,55
1657026985118,COGS 101A,A01,083621,Davis; Joshua Daniel,9,0,68,59
1657026991146,COGS 101B,A01,091572,Allen; Michael Gordon,8,0,65,57
1657026997169,COGS 101C,A01,083625,Delgado; Tania,17,0,35,18
1657027003193,COGS 107A,A01,083627,Boyle; Mary E. T.,13,0,60,47
1657027009221,COGS 118A,A01,083075,Gupta; Anjum,15,0,76,61
1657027015250,CSE 3,A50,083646,Miranda; Gregory Joseph,22,0,50,28
1657027021289,CSE 8A,A50,083650,Miranda; Gregory Joseph,17,1,56,39
1657027027315,CSE 11,A01,083080,Cao; Yingjun,4,15,40,36
1657027033344,CSE 12,A01,083652,Krause-Levy; Sophia Louisa,21,1,120,99
1657027039372,CSE 15L,A01,083654,Morris; Justin Loren,8,0,50,42
1657027039372,CSE 15L,A02,083655,Morris; Justin Loren,9,0,50,41
1657027045401,CSE 20,A01,083657,Tran; Khoa Dang,37,0,80,43
1657027051427,CSE 21,A01,095574,Bach; Quang Tran,21,0,48,27
1657027057455,CSE 30,A01,083084,Eldon; John,4,0,80,76
1657027057455,CSE 30,B01,095061,Bhaskar; Nishant,6,0,50,44
1657027063481,CSE 100,A01,083659,Cao; Yingjun,3,4,70,67
1657027069511,CSE 134B,A01,083661,Powell; Thomas Allan,19,0,100,81
1657027075540,CSE 140,A01,083663,Gungor; Onat,14,0,85,71
1657027081564,CSE 140L,A01,083088,Eldon; John,16,0,100,84
1657027087588,CSE 175,A01,083665,Kumar; Rakesh,3,0,25,22
1657027093613,CSE 190,A00,092507,Dubnov; Shlomo,7,0,20,13
1657027099643,ECE 45,A01,083139,Congero; Spencer William,5,0,75,70
1657027105758,ECE 65,A50,083695,Saad; Andrew S,12,0,30,18
1657027105758,ECE 65,A51,095125,Saad; Andrew S,25,0,26,1
1657027111782,ECE 109,A01,091882,Touri; Behrouz,16,0,70,54
1657027117808,ECE 180,A00,083140,Abi Samra; Nicholas Camill,1,0,30,29
1657027117808,ECE 180,B00,083141,Abi Samra; Nicholas Camill,0,0,30,30
1657027123832,MATH 10A,A01,083735,Patchell; Gregory David,1,0,30,29
1657027123832,MATH 10A,A02,083736,Patchell; Gregory David,20,0,30,10
1657027123832,MATH 10A,A03,083737,Patchell; Gregory David,16,0,30,14
1657027129857,MATH 10B,A01,083207,Lim; Seonhee,7,0,34,27
1657027129857,MATH 10B,A02,083208,Lim; Seonhee,9,0,35,26
1657027129857,MATH 10B,A03,093472,Lim; Seonhee,4,0,34,30
1657027129857,MATH 10B,B01,083739,Sinha; Shubham,9,0,30,21
1657027135893,MATH 18,A01,083743,Cinel; Cameron Alexander,6,0,30,24
1657027135893,MATH 18,A02,083744,Cinel; Cameron Alexander,15,0,30,15
1657027135893,MATH 18,A03,083745,Cinel; Cameron Alexander,8,0,30,22
1657027135893,MATH 18,B01,083748,Rideout; David Porter,4,0,37,33
1657027135893,MATH 18,B02,083749,Rideout; David Porter,3,0,36,33
1657027135893,MATH 18,B03,083750,Rideout; David Porter,2,0,37,35
1657027135893,MATH 18,B04,083751,Rideout; David Porter,5,0,36,31
1657027135893,MATH 18,B05,093473,Rideout; David Porter,4,0,36,32
1657027135893,MATH 18,B06,093474,Rideout; David Porter,5,0,36,31
1657027141918,MATH 20A,A01,083754,Zheng; Zequn,12,0,40,28
1657027147947,MATH 20B,A01,083756,Briones; Jor-el Thomas Caparas,1,0,36,35
1657027147947,MATH 20B,A02,083757,Briones; Jor-el Thomas Caparas,1,0,36,35
1657027147947,MATH 20B,A03,093475,Briones; Jor-el Thomas Caparas,0,0,36,36
1657027153976,MATH 20C,A01,083760,Briones; Jor-el Thomas Caparas,1,0,35,34
1657027153976,MATH 20C,A02,083761,Briones; Jor-el Thomas Caparas,8,0,35,27
1657027153976,MATH 20C,A03,093476,Briones; Jor-el Thomas Caparas,0,1,36,36
1657027153976,MATH 20C,B01,083762,Bach; Quang Tran,0,0,30,30
1657027160002,MATH 20D,A01,083765,Tran; Brian Kha,4,0,30,26
1657027160002,MATH 20D,A02,083766,Tran; Brian Kha,5,0,30,25
1657027160002,MATH 20D,A03,083767,Tran; Brian Kha,3,0,30,27
1657027166032,MATH 20E,A01,083771,Ganguly; Soumya,5,0,32,27
1657027166032,MATH 20E,A02,083772,Ganguly; Soumya,6,0,32,26
1657027166032,MATH 20E,B01,083773,Ciotti; Benjamin,18,0,35,17
1657027166032,MATH 20E,B02,083774,Ciotti; Benjamin,17,0,35,18
1657027172065,MATH 103A,A01,083777,Greenfeld; Be'Eri,2,0,36,34
1657027172065,MATH 103A,A02,083778,Greenfeld; Be'Eri,5,0,36,31
1657027172065,MATH 103A,A03,093561,Greenfeld; Be'Eri,4,0,36,32
1657027172065,MATH 103A,B01,083779,Greenfeld; Be'Eri,6,0,36,30
1657027172065,MATH 103A,B02,083780,Greenfeld; Be'Eri,2,0,36,34
1657027172065,MATH 103A,B03,093562,Greenfeld; Be'Eri,2,0,36,34
1657027178090,MATH 105,A01,085443,Carter; Anne Toulson,14,0,35,21
1657027178090,MATH 105,A02,093477,Carter; Anne Toulson,20,0,35,15
1657027184121,MATH 109,A01,083213,Ganzberger; Geoffrey Michael,2,0,34,32
1657027184121,MATH 109,A02,083214,Ganzberger; Geoffrey Michael,2,0,34,32
1657027184121,MATH 109,A03,093478,Ganzberger; Geoffrey Michael,1,0,34,33
1657027184121,MATH 109,B01,083215,Ganzberger; Geoffrey Michael,1,0,32,31
1657027184121,MATH 109,B02,083216,Ganzberger; Geoffrey Michael,1,0,32,31
1657027184121,MATH 109,B03,093479,Ganzberger; Geoffrey Michael,6,0,32,26
1657027190156,MATH 142A,A01,083219,Chow; Bennett,6,0,32,26
1657027190156,MATH 142A,A02,083220,Chow; Bennett,10,0,32,22
1657027190156,MATH 142A,A03,093480,Chow; Bennett,7,0,32,25
1657027190156,MATH 142A,B03,093481,Chow; Bennett,7,0,32,25
1657027190156,MATH 142A,B04,093558,Chow; Bennett,11,0,32,21
1657027190156,MATH 142A,B05,093559,Chow; Bennett,6,0,32,26
1657027196186,MATH 193A,A01,083224,Rotar; Vladimir,7,0,34,27
1657027196186,MATH 193A,A02,083225,Rotar; Vladimir,4,0,34,30
1657027196186,MATH 193A,A03,083781,Rotar; Vladimir,1,0,34,33
1657027196186,MATH 193A,A04,083782,Rotar; Vladimir,6,0,34,28
1657027196186,MATH 193A,A05,093482,Rotar; Vladimir,6,0,34,28
1657027202212,MATH 197,001,091859,McAuley; Julian John,9999,0,9999,0
1657027202212,MATH 197,002,095566,Kedlaya; Kiran S.,9997,0,9999,2
1657027202212,MATH 197,003,095567,Xiao; Ming,9999,0,9999,0
1657027202212,MATH 197,004,095571,Perols; Johan Lars,9998,0,9999,1
1657027209270,COGS 9,A01,083615,Shannon; Kyle Michael,7,0,75,68
1657027215293,COGS 11,A01,083617,Boyle; Mary E. T.,20,0,48,28
1657027221321,COGS 13,A01,083071,Bastos; Amalia Pinkusfeld,9,0,71,62
1657027227350,COGS 14A,A01,092681,Semenuks; Arturs,0,1,100,100
1657027233375,COGS 14B,A01,083073,Cheng; Tzu-Han,5,0,63,58
1657027239401,COGS 17,A01,092677,Semenuks; Arturs,4,0,81,77
1657027245438,COGS 100,A01,083619,Allen; Michael Gordon,15,0,70,55
1657027251474,COGS 101A,A01,083621,Davis; Joshua Daniel,9,0,68,59
1657027257505,COGS 101B,A01,091572,Allen; Michael Gordon,8,0,65,57
1657027263534,COGS 101C,A01,083625,Delgado; Tania,17,0,35,18
1657027269558,COGS 107A,A01,083627,Boyle; Mary E. T.,13,0,60,47
1657027275582,COGS 118A,A01,083075,Gupta; Anjum,15,0,76,61
1657027281614,CSE 3,A50,083646,Miranda; Gregory Joseph,22,0,50,28
1657027287638,CSE 8A,A50,083650,Miranda; Gregory Joseph,17,1,56,39
1657027293668,CSE 11,A01,083080,Cao; Yingjun,4,15,40,36
1657027299697,CSE 12,A01,083652,Krause-Levy; Sophia Louisa,21,1,120,99
1657027305726,CSE 15L,A01,083654,Morris; Justin Loren,8,0,50,42
1657027305726,CSE 15L,A02,083655,Morris; Justin Loren,9,0,50,41
1657027311750,CSE 20,A01,083657,Tran; Khoa Dang,37,0,80,43
1657027317782,CSE 21,A01,095574,Bach; Quang Tran,21,0,48,27
1657027323807,CSE 30,A01,083084,Eldon; John,4,0,80,76
1657027323807,CSE 30,B01,095061,Bhaskar; Nishant,6,0,50,44
1657027329832,CSE 100,A01,083659,Cao; Yingjun,3,4,70,67
1657027335860,CSE 134B,A01,083661,Powell; Thomas Allan,19,0,100,81
1657027341898,CSE 140,A01,083663,Gungor; Onat,14,0,85,71
1657027347927,CSE 140L,A01,083088,Eldon; John,16,0,100,84
1657027353959,CSE 175,A01,083665,Kumar; Rakesh,3,0,25,22
1657027359989,CSE 190,A00,092507,Dubnov; Shlomo,7,0,20,13
1657027366012,ECE 45,A01,083139,Congero; Spencer William,5,0,75,70
1657027372036,ECE 65,A50,083695,Saad; Andrew S,12,0,30,18
1657027372036,ECE 65,A51,095125,Saad; Andrew S,25,0,26,1
1657027378061,ECE 109,A01,091882,Touri; Behrouz,16,0,70,54
1657027384086,ECE 180,A00,083140,Abi Samra; Nicholas Camill,1,0,30,29
1657027384086,ECE 180,B00,083141,Abi Samra; Nicholas Camill,0,0,30,30
1657027390115,MATH 10A,A01,083735,Patchell; Gregory David,1,0,30,29
1657027390115,MATH 10A,A02,083736,Patchell; Gregory David,20,0,30,10
1657027390115,MATH 10A,A03,083737,Patchell; Gregory David,16,0,30,14
1657027396141,MATH 10B,A01,083207,Lim; Seonhee,7,0,34,27
1657027396141,MATH 10B,A02,083208,Lim; Seonhee,9,0,35,26
1657027396141,MATH 10B,A03,093472,Lim; Seonhee,4,0,34,30
1657027396141,MATH 10B,B01,083739,Sinha; Shubham,9,0,30,21
1657027402170,MATH 18,A01,083743,Cinel; Cameron Alexander,6,0,30,24
1657027402170,MATH 18,A02,083744,Cinel; Cameron Alexander,15,0,30,15
1657027402170,MATH 18,A03,083745,Cinel; Cameron Alexander,8,0,30,22
1657027402170,MATH 18,B01,083748,Rideout; David Porter,4,0,37,33
1657027402170,MATH 18,B02,083749,Rideout; David Porter,3,0,36,33
1657027402170,MATH 18,B03,083750,Rideout; David Porter,2,0,37,35
1657027402170,MATH 18,B04,083751,Rideout; David Porter,5,0,36,31
1657027402170,MATH 18,B05,093473,Rideout; David Porter,4,0,36,32
1657027402170,MATH 18,B06,093474,Rideout; David Porter,5,0,36,31
1657027408195,MATH 20A,A01,083754,Zheng; Zequn,12,0,40,28
1657027414219,MATH 20B,A01,083756,Briones; Jor-el Thomas Caparas,1,0,36,35
1657027414219,MATH 20B,A02,083757,Briones; Jor-el Thomas Caparas,1,0,36,35
1657027414219,MATH 20B,A03,093475,Briones; Jor-el Thomas Caparas,0,0,36,36
1657027420243,MATH 20C,A01,083760,Briones; Jor-el Thomas Caparas,1,0,35,34
1657027420243,MATH 20C,A02,083761,Briones; Jor-el Thomas Caparas,8,0,35,27
1657027420243,MATH 20C,A03,093476,Briones; Jor-el Thomas Caparas,0,1,36,36
1657027420243,MATH 20C,B01,083762,Bach; Quang Tran,0,0,30,30
1657027426270,MATH 20D,A01,083765,Tran; Brian Kha,4,0,30,26
1657027426270,MATH 20D,A02,083766,Tran; Brian Kha,5,0,30,25
1657027426270,MATH 20D,A03,083767,Tran; Brian Kha,3,0,30,27
1657027432298,MATH 20E,A01,083771,Ganguly; Soumya,5,0,32,27
1657027432298,MATH 20E,A02,083772,Ganguly; Soumya,6,0,32,26
1657027432298,MATH 20E,B01,083773,Ciotti; Benjamin,18,0,35,17
1657027432298,MATH 20E,B02,083774,Ciotti; Benjamin,17,0,35,18
1657027438323,MATH 103A,A01,083777,Greenfeld; Be'Eri,2,0,36,34
1657027438323,MATH 103A,A02,083778,Greenfeld; Be'Eri,5,0,36,31
1657027438323,MATH 103A,A03,093561,Greenfeld; Be'Eri,4,0,36,32
1657027438323,MATH 103A,B01,083779,Greenfeld; Be'Eri,6,0,36,30
1657027438323,MATH 103A,B02,083780,Greenfeld; Be'Eri,2,0,36,34
1657027438323,MATH 103A,B03,093562,Greenfeld; Be'Eri,2,0,36,34
1657027444349,MATH 105,A01,085443,Carter; Anne Toulson,14,0,35,21
1657027444349,MATH 105,A02,093477,Carter; Anne Toulson,20,0,35,15
1657027450380,MATH 109,A01,083213,Ganzberger; Geoffrey Michael,2,0,34,32
1657027450380,MATH 109,A02,083214,Ganzberger; Geoffrey Michael,2,0,34,32
1657027450380,MATH 109,A03,093478,Ganzberger; Geoffrey Michael,1,0,34,33
1657027450380,MATH 109,B01,083215,Ganzberger; Geoffrey Michael,1,0,32,31
1657027450380,MATH 109,B02,083216,Ganzberger; Geoffrey Michael,1,0,32,31
1657027450380,MATH 109,B03,093479,Ganzberger; Geoffrey Michael,6,0,32,26
1657027456407,MATH 142A,A01,083219,Chow; Bennett,6,0,32,26
1657027456407,MATH 142A,A02,083220,Chow; Bennett,10,0,32,22
1657027456407,MATH 142A,A03,093480,Chow; Bennett,7,0,32,25
1657027456407,MATH 142A,B03,093481,Chow; Bennett,7,0,32,25
1657027456407,MATH 142A,B04,093558,Chow; Bennett,11,0,32,21
1657027456407,MATH 142A,B05,093559,Chow; Bennett,6,0,32,26
1657027462440,MATH 193A,A01,083224,Rotar; Vladimir,7,0,34,27
1657027462440,MATH 193A,A02,083225,Rotar; Vladimir,4,0,34,30
1657027462440,MATH 193A,A03,083781,Rotar; Vladimir,1,0,34,33
1657027462440,MATH 193A,A04,083782,Rotar; Vladimir,6,0,34,28
1657027462440,MATH 193A,A05,093482,Rotar; Vladimir,6,0,34,28
1657027468467,MATH 197,001,091859,McAuley; Julian John,9999,0,9999,0
1657027468467,MATH 197,002,095566,Kedlaya; Kiran S.,9997,0,9999,2
1657027468467,MATH 197,003,095567,Xiao; Ming,9999,0,9999,0
1657027468467,MATH 197,004,095571,Perols; Johan Lars,9998,0,9999,1
1657027475541,COGS 9,A01,083615,Shannon; Kyle Michael,7,0,75,68
1657027481569,COGS 11,A01,083617,Boyle; Mary E. T.,20,0,48,28
1657027487592,COGS 13,A01,083071,Bastos; Amalia Pinkusfeld,9,0,71,62
1657027493621,COGS 14A,A01,092681,Semenuks; Arturs,0,1,100,100
1657027499645,COGS 14B,A01,083073,Cheng; Tzu-Han,5,0,63,58
1657027505670,COGS 17,A01,092677,Semenuks; Arturs,4,0,81,77
1657027511696,COGS 100,A01,083619,Allen; Michael Gordon,15,0,70,55
1657027517721,COGS 101A,A01,083621,Davis; Joshua Daniel,9,0,68,59
1657027523751,COGS 101B,A01,091572,Allen; Michael Gordon,8,0,65,57
1657027529775,COGS 101C,A01,083625,Delgado; Tania,17,0,35,18
1657027535803,COGS 107A,A01,083627,Boyle; Mary E. T.,13,0,60,47
1657027541829,COGS 118A,A01,083075,Gupta; Anjum,15,0,76,61
1657027547856,CSE 3,A50,083646,Miranda; Gregory Joseph,22,0,50,28
1657027553884,CSE 8A,A50,083650,Miranda; Gregory Joseph,17,1,56,39
1657027559912,CSE 11,A01,083080,Cao; Yingjun,4,15,40,36
1657027565940,CSE 12,A01,083652,Krause-Levy; Sophia Louisa,21,1,120,99
1657027571967,CSE 15L,A01,083654,Morris; Justin Loren,8,0,50,42
1657027571967,CSE 15L,A02,083655,Morris; Justin Loren,9,0,50,41
1657027577996,CSE 20,A01,083657,Tran; Khoa Dang,37,0,80,43
1657027584019,CSE 21,A01,095574,Bach; Quang Tran,21,0,48,27
1657027590043,CSE 30,A01,083084,Eldon; John,4,0,80,76
1657027590043,CSE 30,B01,095061,Bhaskar; Nishant,6,0,50,44
1657027596074,CSE 100,A01,083659,Cao; Yingjun,3,4,70,67
1657027602105,CSE 134B,A01,083661,Powell; Thomas Allan,19,0,100,81
1657027608133,CSE 140,A01,083663,Gungor; Onat,14,0,85,71
1657027614158,CSE 140L,A01,083088,Eldon; John,16,0,100,84
1657027620182,CSE 175,A01,083665,Kumar; Rakesh,3,0,25,22
1657027626205,CSE 190,A00,092507,Dubnov; Shlomo,7,0,20,13
1657027632232,ECE 45,A01,083139,Congero; Spencer William,5,0,75,70
1657027638257,ECE 65,A50,083695,Saad; Andrew S,12,0,30,18
1657027638257,ECE 65,A51,095125,Saad; Andrew S,25,0,26,1
1657027644283,ECE 109,A01,091882,Touri; Behrouz,16,0,70,54
1657027650311,ECE 180,A00,083140,Abi Samra; Nicholas Camill,1,0,30,29
1657027650311,ECE 180,B00,083141,Abi Samra; Nicholas Camill,0,0,30,30
1657027656335,MATH 10A,A01,083735,Patchell; Gregory David,1,0,30,29
1657027656335,MATH 10A,A02,083736,Patchell; Gregory David,20,0,30,10
1657027656335,MATH 10A,A03,083737,Patchell; Gregory David,16,0,30,14
1657027662366,MATH 10B,A01,083207,Lim; Seonhee,7,0,34,27
1657027662366,MATH 10B,A02,083208,Lim; Seonhee,9,0,35,26
1657027662366,MATH 10B,A03,093472,Lim; Seonhee,4,0,34,30
1657027662366,MATH 10B,B01,083739,Sinha; Shubham,9,0,30,21
1657027668401,MATH 18,A01,083743,Cinel; Cameron Alexander,6,0,30,24
1657027668401,MATH 18,A02,083744,Cinel; Cameron Alexander,15,0,30,15
1657027668401,MATH 18,A03,083745,Cinel; Cameron Alexander,8,0,30,22
1657027668401,MATH 18,B01,083748,Rideout; David Porter,4,0,37,33
1657027668401,MATH 18,B02,083749,Rideout; David Porter,3,0,36,33
1657027668401,MATH 18,B03,083750,Rideout; David Porter,2,0,37,35
1657027668401,MATH 18,B04,083751,Rideout; David Porter,5,0,36,31
1657027668401,MATH 18,B05,093473,Rideout; David Porter,4,0,36,32
1657027668401,MATH 18,B06,093474,Rideout; David Porter,5,0,36,31
1657027674433,MATH 20A,A01,083754,Zheng; Zequn,12,0,40,28
1657027680463,MATH 20B,A01,083756,Briones; Jor-el Thomas Caparas,1,0,36,35
1657027680463,MATH 20B,A02,083757,Briones; Jor-el Thomas Caparas,1,0,36,35
1657027680463,MATH 20B,A03,093475,Briones; Jor-el Thomas Caparas,0,0,36,36
1657027686492,MATH 20C,A01,083760,Briones; Jor-el Thomas Caparas,1,0,35,34
1657027686492,MATH 20C,A02,083761,Briones; Jor-el Thomas Caparas,8,0,35,27
1657027686492,MATH 20C,A03,093476,Briones; Jor-el Thomas Caparas,0,1,36,36
1657027686492,MATH 20C,B01,083762,Bach; Quang Tran,0,0,30,30
1657027692516,MATH 20D,A01,083765,Tran; Brian Kha,4,0,30,26
1657027692516,MATH 20D,A02,083766,Tran; Brian Kha,5,0,30,25
1657027692516,MATH 20D,A03,083767,Tran; Brian Kha,3,0,30,27
1657027698540,MATH 20E,A01,083771,Ganguly; Soumya,5,0,32,27
1657027698540,MATH 20E,A02,083772,Ganguly; Soumya,6,0,32,26
1657027698540,MATH 20E,B01,083773,Ciotti; Benjamin,18,0,35,17
1657027698540,MATH 20E,B02,083774,Ciotti; Benjamin,17,0,35,18
1657027704646,MATH 103A,A01,083777,Greenfeld; Be'Eri,2,0,36,34
1657027704646,MATH 103A,A02,083778,Greenfeld; Be'Eri,5,0,36,31
1657027704646,MATH 103A,A03,093561,Greenfeld; Be'Eri,4,0,36,32
1657027704646,MATH 103A,B01,083779,Greenfeld; Be'Eri,6,0,36,30
1657027704646,MATH 103A,B02,083780,Greenfeld; Be'Eri,2,0,36,34
1657027704646,MATH 103A,B03,093562,Greenfeld; Be'Eri,2,0,36,34
1657027710674,MATH 105,A01,085443,Carter; Anne Toulson,14,0,35,21
1657027710674,MATH 105,A02,093477,Carter; Anne Toulson,20,0,35,15
1657027716700,MATH 109,A01,083213,Ganzberger; Geoffrey Michael,2,0,34,32
1657027716700,MATH 109,A02,083214,Ganzberger; Geoffrey Michael,2,0,34,32
1657027716700,MATH 109,A03,093478,Ganzberger; Geoffrey Michael,1,0,34,33
1657027716700,MATH 109,B01,083215,Ganzberger; Geoffrey Michael,1,0,32,31
1657027716700,MATH 109,B02,083216,Ganzberger; Geoffrey Michael,1,0,32,31
1657027716700,MATH 109,B03,093479,Ganzberger; Geoffrey Michael,6,0,32,26
1657027722727,MATH 142A,A01,083219,Chow; Bennett,6,0,32,26
1657027722727,MATH 142A,A02,083220,Chow; Bennett,10,0,32,22
1657027722727,MATH 142A,A03,093480,Chow; Bennett,7,0,32,25
1657027722727,MATH 142A,B03,093481,Chow; Bennett,7,0,32,25
1657027722727,MATH 142A,B04,093558,Chow; Bennett,11,0,32,21
1657027722727,MATH 142A,B05,093559,Chow; Bennett,6,0,32,26
1657027728750,MATH 193A,A01,083224,Rotar; Vladimir,7,0,34,27
1657027728750,MATH 193A,A02,083225,Rotar; Vladimir,4,0,34,30
1657027728750,MATH 193A,A03,083781,Rotar; Vladimir,1,0,34,33
1657027728750,MATH 193A,A04,083782,Rotar; Vladimir,6,0,34,28
1657027728750,MATH 193A,A05,093482,Rotar; Vladimir,6,0,34,28
1657027734779,MATH 197,001,091859,McAuley; Julian John,9999,0,9999,0
1657027734779,MATH 197,002,095566,Kedlaya; Kiran S.,9997,0,9999,2
1657027734779,MATH 197,003,095567,Xiao; Ming,9999,0,9999,0
1657027734779,MATH 197,004,095571,Perols; Johan Lars,9998,0,9999,1
1657027741847,COGS 9,A01,083615,Shannon; Kyle Michael,7,0,75,68
1657027747875,COGS 11,A01,083617,Boyle; Mary E. T.,20,0,48,28
1657027753898,COGS 13,A01,083071,Bastos; Amalia Pinkusfeld,9,0,71,62
1657027759925,COGS 14A,A01,092681,Semenuks; Arturs,0,1,100,100
1657027765949,COGS 14B,A01,083073,Cheng; Tzu-Han,5,0,63,58
1657027771982,COGS 17,A01,092677,Semenuks; Arturs,4,0,81,77
1657027778009,COGS 100,A01,083619,Allen; Michael Gordon,15,0,70,55
1657027784038,COGS 101A,A01,083621,Davis; Joshua Daniel,9,0,68,59
1657027790066,COGS 101B,A01,091572,Allen; Michael Gordon,8,0,65,57
1657027796093,COGS 101C,A01,083625,Delgado; Tania,17,0,35,18
1657027802122,COGS 107A,A01,083627,Boyle; Mary E. T.,13,0,60,47
1657027808151,COGS 118A,A01,083075,Gupta; Anjum,15,0,76,61
1657027814175,CSE 3,A50,083646,Miranda; Gregory Joseph,22,0,50,28
1657027820217,CSE 8A,A50,083650,Miranda; Gregory Joseph,17,1,56,39
1657027826242,CSE 11,A01,083080,Cao; Yingjun,4,15,40,36
1657027832273,CSE 12,A01,083652,Krause-Levy; Sophia Louisa,21,1,120,99
1657027838298,CSE 15L,A01,083654,Morris; Justin Loren,8,0,50,42
1657027838298,CSE 15L,A02,083655,Morris; Justin Loren,9,0,50,41
1657027844324,CSE 20,A01,083657,Tran; Khoa Dang,37,0,80,43
1657027850369,CSE 21,A01,095574,Bach; Quang Tran,21,0,48,27
1657027856393,CSE 30,A01,083084,Eldon; John,4,0,80,76
1657027856393,CSE 30,B01,095061,Bhaskar; Nishant,6,0,50,44
1657027862422,CSE 100,A01,083659,Cao; Yingjun,3,4,70,67
1657027868448,CSE 134B,A01,083661,Powell; Thomas Allan,19,0,100,81
1657027874475,CSE 140,A01,083663,Gungor; Onat,14,0,85,71
1657027880502,CSE 140L,A01,083088,Eldon; John,16,0,100,84
1657027886528,CSE 175,A01,083665,Kumar; Rakesh,3,0,25,22
1657027892558,CSE 190,A00,092507,Dubnov; Shlomo,7,0,20,13
1657027898586,ECE 45,A01,083139,Congero; Spencer William,5,0,75,70
1657027904608,ECE 65,A50,083695,Saad; Andrew S,12,0,30,18
1657027904608,ECE 65,A51,095125,Saad; Andrew S,25,0,26,1
1657027910641,ECE 109,A01,091882,Touri; Behrouz,16,0,70,54
1657027916668,ECE 180,A00,083140,Abi Samra; Nicholas Camill,1,0,30,29
1657027916668,ECE 180,B00,083141,Abi Samra; Nicholas Camill,0,0,30,30
1657027922697,MATH 10A,A01,083735,Patchell; Gregory David,1,0,30,29
1657027922697,MATH 10A,A02,083736,Patchell; Gregory David,20,0,30,10
1657027922697,MATH 10A,A03,083737,Patchell; Gregory David,16,0,30,14
1657027928723,MATH 10B,A01,083207,Lim; Seonhee,7,0,34,27
1657027928723,MATH 10B,A02,083208,Lim; Seonhee,9,0,35,26
1657027928723,MATH 10B,A03,093472,Lim; Seonhee,4,0,34,30
1657027928723,MATH 10B,B01,083739,Sinha; Shubham,9,0,30,21
1657027934754,MATH 18,A01,083743,Cinel; Cameron Alexander,6,0,30,24
1657027934754,MATH 18,A02,083744,Cinel; Cameron Alexander,15,0,30,15
1657027934754,MATH 18,A03,083745,Cinel; Cameron Alexander,8,0,30,22
1657027934754,MATH 18,B01,083748,Rideout; David Porter,4,0,37,33
1657027934754,MATH 18,B02,083749,Rideout; David Porter,3,0,36,33
1657027934754,MATH 18,B03,083750,Rideout; David Porter,2,0,37,35
1657027934754,MATH 18,B04,083751,Rideout; David Porter,5,0,36,31
1657027934754,MATH 18,B05,093473,Rideout; David Porter,4,0,36,32
1657027934754,MATH 18,B06,093474,Rideout; David Porter,5,0,36,31
1657027940776,MATH 20A,A01,083754,Zheng; Zequn,12,0,40,28
1657027946800,MATH 20B,A01,083756,Briones; Jor-el Thomas Caparas,1,0,36,35
1657027946800,MATH 20B,A02,083757,Briones; Jor-el Thomas Caparas,1,0,36,35
1657027946800,MATH 20B,A03,093475,Briones; Jor-el Thomas Caparas,0,0,36,36
1657027952837,MATH 20C,A01,083760,Briones; Jor-el Thomas Caparas,1,0,35,34
1657027952837,MATH 20C,A02,083761,Briones; Jor-el Thomas Caparas,8,0,35,27
1657027952837,MATH 20C,A03,093476,Briones; Jor-el Thomas Caparas,0,1,36,36
1657027952837,MATH 20C,B01,083762,Bach; Quang Tran,0,0,30,30
1657027958866,MATH 20D,A01,083765,Tran; Brian Kha,4,0,30,26
1657027958866,MATH 20D,A02,083766,Tran; Brian Kha,5,0,30,25
1657027958866,MATH 20D,A03,083767,Tran; Brian Kha,3,0,30,27
1657027964892,MATH 20E,A01,083771,Ganguly; Soumya,5,0,32,27
1657027964892,MATH 20E,A02,083772,Ganguly; Soumya,6,0,32,26
1657027964892,MATH 20E,B01,083773,Ciotti; Benjamin,18,0,35,17
1657027964892,MATH 20E,B02,083774,Ciotti; Benjamin,17,0,35,18
1657027970916,MATH 103A,A01,083777,Greenfeld; Be'Eri,2,0,36,34
1657027970916,MATH 103A,A02,083778,Greenfeld; Be'Eri,5,0,36,31
1657027970916,MATH 103A,A03,093561,Greenfeld; Be'Eri,4,0,36,32
1657027970916,MATH 103A,B01,083779,Greenfeld; Be'Eri,6,0,36,30
1657027970916,MATH 103A,B02,083780,Greenfeld; Be'Eri,2,0,36,34
1657027970916,MATH 103A,B03,093562,Greenfeld; Be'Eri,2,0,36,34
1657027976950,MATH 105,A01,085443,Carter; Anne Toulson,14,0,35,21
1657027976950,MATH 105,A02,093477,Carter; Anne Toulson,20,0,35,15
1657027982980,MATH 109,A01,083213,Ganzberger; Geoffrey Michael,2,0,34,32
1657027982980,MATH 109,A02,083214,Ganzberger; Geoffrey Michael,2,0,34,32
1657027982980,MATH 109,A03,093478,Ganzberger; Geoffrey Michael,1,0,34,33
1657027982980,MATH 109,B01,083215,Ganzberger; Geoffrey Michael,1,0,32,31
1657027982980,MATH 109,B02,083216,Ganzberger; Geoffrey Michael,1,0,32,31
1657027982980,MATH 109,B03,093479,Ganzberger; Geoffrey Michael,6,0,32,26
1657027989010,MATH 142A,A01,083219,Chow; Bennett,6,0,32,26
1657027989010,MATH 142A,A02,083220,Chow; Bennett,10,0,32,22
1657027989010,MATH 142A,A03,093480,Chow; Bennett,7,0,32,25
1657027989010,MATH 142A,B03,093481,Chow; Bennett,7,0,32,25
1657027989010,MATH 142A,B04,093558,Chow; Bennett,11,0,32,21
1657027989010,MATH 142A,B05,093559,Chow; Bennett,6,0,32,26
1657027995038,MATH 193A,A01,083224,Rotar; Vladimir,7,0,34,27
1657027995038,MATH 193A,A02,083225,Rotar; Vladimir,4,0,34,30
1657027995038,MATH 193A,A03,083781,Rotar; Vladimir,1,0,34,33
1657027995038,MATH 193A,A04,083782,Rotar; Vladimir,6,0,34,28
1657027995038,MATH 193A,A05,093482,Rotar; Vladimir,6,0,34,28
1657028001065,MATH 197,001,091859,McAuley; Julian John,9999,0,9999,0
1657028001065,MATH 197,002,095566,Kedlaya; Kiran S.,9997,0,9999,2
1657028001065,MATH 197,003,095567,Xiao; Ming,9999,0,9999,0
1657028001065,MATH 197,004,095571,Perols; Johan Lars,9998,0,9999,1
1657028008137,COGS 9,A01,083615,Shannon; Kyle Michael,7,0,75,68
1657028014165,COGS 11,A01,083617,Boyle; Mary E. T.,20,0,48,28
1657028020193,COGS 13,A01,083071,Bastos; Amalia Pinkusfeld,9,0,71,62
1657028026221,COGS 14A,A01,092681,Semenuks; Arturs,0,1,100,100
1657028032249,COGS 14B,A01,083073,Cheng; Tzu-Han,5,0,63,58
1657028038274,COGS 17,A01,092677,Semenuks; Arturs,4,0,81,77
1657028044300,COGS 100,A01,083619,Allen; Michael Gordon,15,0,70,55
1657028050331,COGS 101A,A01,083621,Davis; Joshua Daniel,9,0,68,59
1657028056356,COGS 101B,A01,091572,Allen; Michael Gordon,8,0,65,57
1657028062379,COGS 101C,A01,083625,Delgado; Tania,17,0,35,18
1657028068405,COGS 107A,A01,083627,Boyle; Mary E. T.,13,0,60,47
1657028074431,COGS 118A,A01,083075,Gupta; Anjum,15,0,76,61
1657028080455,CSE 3,A50,083646,Miranda; Gregory Joseph,22,0,50,28
1657028086486,CSE 8A,A50,083650,Miranda; Gregory Joseph,17,1,56,39
1657028092511,CSE 11,A01,083080,Cao; Yingjun,4,15,40,36
1657028098535,CSE 12,A01,083652,Krause-Levy; Sophia Louisa,21,1,120,99
1657028104563,CSE 15L,A01,083654,Morris; Justin Loren,8,0,50,42
1657028104563,CSE 15L,A02,083655,Morris; Justin Loren,9,0,50,41
1657028110587,CSE 20,A01,083657,Tran; Khoa Dang,37,0,80,43
1657028116610,CSE 21,A01,095574,Bach; Quang Tran,21,0,48,27
1657028122634,CSE 30,A01,083084,Eldon; John,4,0,80,76
1657028122634,CSE 30,B01,095061,Bhaskar; Nishant,6,0,50,44
1657028128660,CSE 100,A01,083659,Cao; Yingjun,3,4,70,67
1657028134687,CSE 134B,A01,083661,Powell; Thomas Allan,19,0,100,81
1657028140708,CSE 140,A01,083663,Gungor; Onat,14,0,85,71
1657028146733,CSE 140L,A01,083088,Eldon; John,16,0,100,84
1657028152754,CSE 175,A01,083665,Kumar; Rakesh,3,0,25,22
1657028158780,CSE 190,A00,092507,Dubnov; Shlomo,7,0,20,13
1657028164810,ECE 45,A01,083139,Congero; Spencer William,5,0,75,70
1657028170840,ECE 65,A50,083695,Saad; Andrew S,12,0,30,18
1657028170840,ECE 65,A51,095125,Saad; Andrew S,25,0,26,1
1657028176877,ECE 109,A01,091882,Touri; Behrouz,16,0,70,54
1657028182911,ECE 180,A00,083140,Abi Samra; Nicholas Camill,1,0,30,29
1657028182911,ECE 180,B00,083141,Abi Samra; Nicholas Camill,0,0,30,30
1657028188934,MATH 10A,A01,083735,Patchell; Gregory David,1,0,30,29
1657028188934,MATH 10A,A02,083736,Patchell; Gregory David,20,0,30,10
1657028188934,MATH 10A,A03,083737,Patchell; Gregory David,16,0,30,14
1657028194960,MATH 10B,A01,083207,Lim; Seonhee,7,0,34,27
1657028194960,MATH 10B,A02,083208,Lim; Seonhee,9,0,35,26
1657028194960,MATH 10B,A03,093472,Lim; Seonhee,4,0,34,30
1657028194960,MATH 10B,B01,083739,Sinha; Shubham,9,0,30,21
1657028200988,MATH 18,A01,083743,Cinel; Cameron Alexander,6,0,30,24
1657028200988,MATH 18,A02,083744,Cinel; Cameron Alexander,15,0,30,15
1657028200988,MATH 18,A03,083745,Cinel; Cameron Alexander,8,0,30,22
1657028200988,MATH 18,B01,083748,Rideout; David Porter,4,0,37,33
1657028200988,MATH 18,B02,083749,Rideout; David Porter,3,0,36,33
1657028200988,MATH 18,B03,083750,Rideout; David Porter,2,0,37,35
1657028200988,MATH 18,B04,083751,Rideout; David Porter,5,0,36,31
1657028200988,MATH 18,B05,093473,Rideout; David Porter,4,0,36,32
1657028200988,MATH 18,B06,093474,Rideout; David Porter,5,0,36,31
1657028207013,MATH 20A,A01,083754,Zheng; Zequn,12,0,40,28
1657028213036,MATH 20B,A01,083756,Briones; Jor-el Thomas Caparas,1,0,36,35
1657028213036,MATH 20B,A02,083757,Briones; Jor-el Thomas Caparas,1,0,36,35
1657028213036,MATH 20B,A03,093475,Briones; Jor-el Thomas Caparas,0,0,36,36
1657028219060,MATH 20C,A01,083760,Briones; Jor-el Thomas Caparas,1,0,35,34
1657028219060,MATH 20C,A02,083761,Briones; Jor-el Thomas Caparas,8,0,35,27
1657028219060,MATH 20C,A03,093476,Briones; Jor-el Thomas Caparas,0,1,36,36
1657028219060,MATH 20C,B01,083762,Bach; Quang Tran,0,0,30,30
1657028225093,MATH 20D,A01,083765,Tran; Brian Kha,4,0,30,26
1657028225093,MATH 20D,A02,083766,Tran; Brian Kha,5,0,30,25
1657028225093,MATH 20D,A03,083767,Tran; Brian Kha,3,0,30,27
1657028231124,MATH 20E,A01,083771,Ganguly; Soumya,5,0,32,27
1657028231124,MATH 20E,A02,083772,Ganguly; Soumya,6,0,32,26
1657028231124,MATH 20E,B01,083773,Ciotti; Benjamin,18,0,35,17
1657028231124,MATH 20E,B02,083774,Ciotti; Benjamin,17,0,35,18
1657028237148,MATH 103A,A01,083777,Greenfeld; Be'Eri,2,0,36,34
1657028237148,MATH 103A,A02,083778,Greenfeld; Be'Eri,5,0,36,31
1657028237148,MATH 103A,A03,093561,Greenfeld; Be'Eri,4,0,36,32
1657028237148,MATH 103A,B01,083779,Greenfeld; Be'Eri,6,0,36,30
1657028237148,MATH 103A,B02,083780,Greenfeld; Be'Eri,2,0,36,34
1657028237148,MATH 103A,B03,093562,Greenfeld; Be'Eri,2,0,36,34
1657028243175,MATH 105,A01,085443,Carter; Anne Toulson,14,0,35,21
1657028243175,MATH 105,A02,093477,Carter; Anne Toulson,20,0,35,15
1657028249203,MATH 109,A01,083213,Ganzberger; Geoffrey Michael,2,0,34,32
1657028249203,MATH 109,A02,083214,Ganzberger; Geoffrey Michael,2,0,34,32
1657028249203,MATH 109,A03,093478,Ganzberger; Geoffrey Michael,1,0,34,33
1657028249203,MATH 109,B01,083215,Ganzberger; Geoffrey Michael,1,0,32,31
1657028249203,MATH 109,B02,083216,Ganzberger; Geoffrey Michael,1,0,32,31
1657028249203,MATH 109,B03,093479,Ganzberger; Geoffrey Michael,6,0,32,26
1657028255227,MATH 142A,A01,083219,Chow; Bennett,6,0,32,26
1657028255227,MATH 142A,A02,083220,Chow; Bennett,10,0,32,22
1657028255227,MATH 142A,A03,093480,Chow; Bennett,7,0,32,25
1657028255227,MATH 142A,B03,093481,Chow; Bennett,7,0,32,25
1657028255227,MATH 142A,B04,093558,Chow; Bennett,11,0,32,21
1657028255227,MATH 142A,B05,093559,Chow; Bennett,6,0,32,26
1657028261251,MATH 193A,A01,083224,Rotar; Vladimir,7,0,34,27
1657028261251,MATH 193A,A02,083225,Rotar; Vladimir,4,0,34,30
1657028261251,MATH 193A,A03,083781,Rotar; Vladimir,1,0,34,33
1657028261251,MATH 193A,A04,083782,Rotar; Vladimir,6,0,34,28
1657028261251,MATH 193A,A05,093482,Rotar; Vladimir,6,0,34,28
1657028267277,MATH 197,001,091859,McAuley; Julian John,9999,0,9999,0
1657028267277,MATH 197,002,095566,Kedlaya; Kiran S.,9997,0,9999,2
1657028267277,MATH 197,003,095567,Xiao; Ming,9999,0,9999,0
1657028267277,MATH 197,004,095571,Perols; Johan Lars,9998,0,9999,1
1657028274344,COGS 9,A01,083615,Shannon; Kyle Michael,7,0,75,68
1657028280374,COGS 11,A01,083617,Boyle; Mary E. T.,20,0,48,28
1657028286398,COGS 13,A01,083071,Bastos; Amalia Pinkusfeld,9,0,71,62
1657028292426,COGS 14A,A01,092681,Semenuks; Arturs,0,1,100,100
1657028298522,COGS 14B,A01,083073,Cheng; Tzu-Han,5,0,63,58
1657028304545,COGS 17,A01,092677,Semenuks; Arturs,4,0,81,77
1657028310570,COGS 100,A01,083619,Allen; Michael Gordon,15,0,70,55
1657028316597,COGS 101A,A01,083621,Davis; Joshua Daniel,9,0,68,59
1657028322621,COGS 101B,A01,091572,Allen; Michael Gordon,8,0,65,57
1657028328645,COGS 101C,A01,083625,Delgado; Tania,17,0,35,18
1657028334668,COGS 107A,A01,083627,Boyle; Mary E. T.,13,0,60,47
1657028340701,COGS 118A,A01,083075,Gupta; Anjum,15,0,76,61
1657028346730,CSE 3,A50,083646,Miranda; Gregory Joseph,22,0,50,28
1657028352755,CSE 8A,A50,083650,Miranda; Gregory Joseph,17,1,56,39
1657028358786,CSE 11,A01,083080,Cao; Yingjun,4,15,40,36
1657028364814,CSE 12,A01,083652,Krause-Levy; Sophia Louisa,21,1,120,99
1657028370837,CSE 15L,A01,083654,Morris; Justin Loren,8,0,50,42
1657028370837,CSE 15L,A02,083655,Morris; Justin Loren,9,0,50,41
1657028376864,CSE 20,A01,083657,Tran; Khoa Dang,37,0,80,43
1657028382886,CSE 21,A01,095574,Bach; Quang Tran,21,0,48,27
1657028388916,CSE 30,A01,083084,Eldon; John,4,0,80,76
1657028388916,CSE 30,B01,095061,Bhaskar; Nishant,6,0,50,44
1657028394946,CSE 100,A01,083659,Cao; Yingjun,3,4,70,67
1657028400972,CSE 134B,A01,083661,Powell; Thomas Allan,19,0,100,81
1657028406995,CSE 140,A01,083663,Gungor; Onat,14,0,85,71
1657028413031,CSE 140L,A01,083088,Eldon; John,16,0,100,84
1657028419055,CSE 175,A01,083665,Kumar; Rakesh,3,0,25,22
1657028425084,CSE 190,A00,092507,Dubnov; Shlomo,7,0,20,13
1657028431108,ECE 45,A01,083139,Congero; Spencer William,5,0,75,70
1657028437134,ECE 65,A50,083695,Saad; Andrew S,12,0,30,18
1657028437134,ECE 65,A51,095125,Saad; Andrew S,25,0,26,1
1657028443159,ECE 109,A01,091882,Touri; Behrouz,16,0,70,54
1657028449181,ECE 180,A00,083140,Abi Samra; Nicholas Camill,1,0,30,29
1657028449181,ECE 180,B00,083141,Abi Samra; Nicholas Camill,0,0,30,30
1657028455214,MATH 10A,A01,083735,Patchell; Gregory David,1,0,30,29
1657028455214,MATH 10A,A02,083736,Patchell; Gregory David,20,0,30,10
1657028455214,MATH 10A,A03,083737,Patchell; Gregory David,16,0,30,14
1657028461237,MATH 10B,A01,083207,Lim; Seonhee,7,0,34,27
1657028461237,MATH 10B,A02,083208,Lim; Seonhee,9,0,35,26
1657028461237,MATH 10B,A03,093472,Lim; Seonhee,4,0,34,30
1657028461237,MATH 10B,B01,083739,Sinha; Shubham,9,0,30,21
1657028467263,MATH 18,A01,083743,Cinel; Cameron Alexander,6,0,30,24
1657028467263,MATH 18,A02,083744,Cinel; Cameron Alexander,15,0,30,15
1657028467263,MATH 18,A03,083745,Cinel; Cameron Alexander,8,0,30,22
1657028467263,MATH 18,B01,083748,Rideout; David Porter,4,0,37,33
1657028467263,MATH 18,B02,083749,Rideout; David Porter,3,0,36,33
1657028467263,MATH 18,B03,083750,Rideout; David Porter,2,0,37,35
1657028467263,MATH 18,B04,083751,Rideout; David Porter,5,0,36,31
1657028467263,MATH 18,B05,093473,Rideout; David Porter,4,0,36,32
1657028467263,MATH 18,B06,093474,Rideout; David Porter,5,0,36,31
1657028473288,MATH 20A,A01,083754,Zheng; Zequn,12,0,40,28
1657028479317,MATH 20B,A01,083756,Briones; Jor-el Thomas Caparas,1,0,36,35
1657028479317,MATH 20B,A02,083757,Briones; Jor-el Thomas Caparas,1,0,36,35
1657028479317,MATH 20B,A03,093475,Briones; Jor-el Thomas Caparas,0,0,36,36
1657028485343,MATH 20C,A01,083760,Briones; Jor-el Thomas Caparas,1,0,35,34
1657028485343,MATH 20C,A02,083761,Briones; Jor-el Thomas Caparas,8,0,35,27
1657028485343,MATH 20C,A03,093476,Briones; Jor-el Thomas Caparas,0,1,36,36
1657028485343,MATH 20C,B01,083762,Bach; Quang Tran,0,0,30,30
1657028491371,MATH 20D,A01,083765,Tran; Brian Kha,4,0,30,26
1657028491371,MATH 20D,A02,083766,Tran; Brian Kha,5,0,30,25
1657028491371,MATH 20D,A03,083767,Tran; Brian Kha,3,0,30,27
1657028497400,MATH 20E,A01,083771,Ganguly; Soumya,5,0,32,27
1657028497400,MATH 20E,A02,083772,Ganguly; Soumya,6,0,32,26
1657028497400,MATH 20E,B01,083773,Ciotti; Benjamin,18,0,35,17
1657028497400,MATH 20E,B02,083774,Ciotti; Benjamin,17,0,35,18
1657028503427,MATH 103A,A01,083777,Greenfeld; Be'Eri,2,0,36,34
1657028503427,MATH 103A,A02,083778,Greenfeld; Be'Eri,5,0,36,31
1657028503427,MATH 103A,A03,093561,Greenfeld; Be'Eri,4,0,36,32
1657028503427,MATH 103A,B01,083779,Greenfeld; Be'Eri,6,0,36,30
1657028503427,MATH 103A,B02,083780,Greenfeld; Be'Eri,2,0,36,34
1657028503427,MATH 103A,B03,093562,Greenfeld; Be'Eri,2,0,36,34
1657028509460,MATH 105,A01,085443,Carter; Anne Toulson,14,0,35,21
1657028509460,MATH 105,A02,093477,Carter; Anne Toulson,20,0,35,15
1657028515485,MATH 109,A01,083213,Ganzberger; Geoffrey Michael,2,0,34,32
1657028515485,MATH 109,A02,083214,Ganzberger; Geoffrey Michael,2,0,34,32
1657028515485,MATH 109,A03,093478,Ganzberger; Geoffrey Michael,1,0,34,33
1657028515485,MATH 109,B01,083215,Ganzberger; Geoffrey Michael,1,0,32,31
1657028515485,MATH 109,B02,083216,Ganzberger; Geoffrey Michael,1,0,32,31
1657028515485,MATH 109,B03,093479,Ganzberger; Geoffrey Michael,6,0,32,26
1657028521510,MATH 142A,A01,083219,Chow; Bennett,6,0,32,26
1657028521510,MATH 142A,A02,083220,Chow; Bennett,10,0,32,22
1657028521510,MATH 142A,A03,093480,Chow; Bennett,7,0,32,25
1657028521510,MATH 142A,B03,093481,Chow; Bennett,7,0,32,25
1657028521510,MATH 142A,B04,093558,Chow; Bennett,11,0,32,21
1657028521510,MATH 142A,B05,093559,Chow; Bennett,6,0,32,26
1657028527535,MATH 193A,A01,083224,Rotar; Vladimir,7,0,34,27
1657028527535,MATH 193A,A02,083225,Rotar; Vladimir,4,0,34,30
1657028527535,MATH 193A,A03,083781,Rotar; Vladimir,1,0,34,33
1657028527535,MATH 193A,A04,083782,Rotar; Vladimir,6,0,34,28
1657028527535,MATH 193A,A05,093482,Rotar; Vladimir,6,0,34,28
1657028533557,MATH 197,001,091859,McAuley; Julian John,9999,0,9999,0
1657028533557,MATH 197,002,095566,Kedlaya; Kiran S.,9997,0,9999,2
1657028533557,MATH 197,003,095567,Xiao; Ming,9999,0,9999,0
1657028533557,MATH 197,004,095571,Perols; Johan Lars,9998,0,9999,1
1657028540624,COGS 9,A01,083615,Shannon; Kyle Michael,7,0,75,68
1657028546652,COGS 11,A01,083617,Boyle; Mary E. T.,20,0,48,28
1657028552681,COGS 13,A01,083071,Bastos; Amalia Pinkusfeld,9,0,71,62
1657028558705,COGS 14A,A01,092681,Semenuks; Arturs,0,1,100,100
1657028564730,COGS 14B,A01,083073,Cheng; Tzu-Han,5,0,63,58
1657028570756,COGS 17,A01,092677,Semenuks; Arturs,4,0,81,77
1657028576781,COGS 100,A01,083619,Allen; Michael Gordon,15,0,70,55
1657028582816,COGS 101A,A01,083621,Davis; Joshua Daniel,9,0,68,59
1657028588843,COGS 101B,A01,091572,Allen; Michael Gordon,8,0,65,57
1657028594872,COGS 101C,A01,083625,Delgado; Tania,17,0,35,18
1657028600904,COGS 107A,A01,083627,Boyle; Mary E. T.,13,0,60,47
1657028606930,COGS 118A,A01,083075,Gupta; Anjum,15,0,76,61
1657028612960,CSE 3,A50,083646,Miranda; Gregory Joseph,22,0,50,28
1657028618983,CSE 8A,A50,083650,Miranda; Gregory Joseph,17,1,56,39
1657028625010,CSE 11,A01,083080,Cao; Yingjun,4,15,40,36
1657028631034,CSE 12,A01,083652,Krause-Levy; Sophia Louisa,21,1,120,99
1657028637057,CSE 15L,A01,083654,Morris; Justin Loren,8,0,50,42
1657028637057,CSE 15L,A02,083655,Morris; Justin Loren,9,0,50,41
1657028643097,CSE 20,A01,083657,Tran; Khoa Dang,37,0,80,43
1657028649125,CSE 21,A01,095574,Bach; Quang Tran,21,0,48,27
1657028655160,CSE 30,A01,083084,Eldon; John,4,0,80,76
1657028655160,CSE 30,B01,095061,Bhaskar; Nishant,6,0,50,44
1657028661183,CSE 100,A01,083659,Cao; Yingjun,3,4,70,67
1657028667213,CSE 134B,A01,083661,Powell; Thomas Allan,19,0,100,81
1657028673237,CSE 140,A01,083663,Gungor; Onat,14,0,85,71
1657028679262,CSE 140L,A01,083088,Eldon; John,16,0,100,84
1657028685286,CSE 175,A01,083665,Kumar; Rakesh,3,0,25,22
1657028691311,CSE 190,A00,092507,Dubnov; Shlomo,7,0,20,13
1657028697339,ECE 45,A01,083139,Congero; Spencer William,5,0,75,70
1657028703362,ECE 65,A50,083695,Saad; Andrew S,12,0,30,18
1657028703362,ECE 65,A51,095125,Saad; Andrew S,25,0,26,1
1657028709386,ECE 109,A01,091882,Touri; Behrouz,16,0,70,54
1657028715411,ECE 180,A00,083140,Abi Samra; Nicholas Camill,1,0,30,29
1657028715411,ECE 180,B00,083141,Abi Samra; Nicholas Camill,0,0,30,30
1657028721438,MATH 10A,A01,083735,Patchell; Gregory David,1,0,30,29
1657028721438,MATH 10A,A02,083736,Patchell; Gregory David,20,0,30,10
1657028721438,MATH 10A,A03,083737,Patchell; Gregory David,16,0,30,14
1657028727467,MATH 10B,A01,083207,Lim; Seonhee,7,0,34,27
1657028727467,MATH 10B,A02,083208,Lim; Seonhee,9,0,35,26
1657028727467,MATH 10B,A03,093472,Lim; Seonhee,4,0,34,30
1657028727467,MATH 10B,B01,083739,Sinha; Shubham,9,0,30,21
1657028733500,MATH 18,A01,083743,Cinel; Cameron Alexander,6,0,30,24
1657028733500,MATH 18,A02,083744,Cinel; Cameron Alexander,15,0,30,15
1657028733500,MATH 18,A03,083745,Cinel; Cameron Alexander,8,0,30,22
1657028733500,MATH 18,B01,083748,Rideout; David Porter,4,0,37,33
1657028733500,MATH 18,B02,083749,Rideout; David Porter,3,0,36,33
1657028733500,MATH 18,B03,083750,Rideout; David Porter,2,0,37,35
1657028733500,MATH 18,B04,083751,Rideout; David Porter,5,0,36,31
1657028733500,MATH 18,B05,093473,Rideout; David Porter,4,0,36,32
1657028733500,MATH 18,B06,093474,Rideout; David Porter,5,0,36,31
1657028739524,MATH 20A,A01,083754,Zheng; Zequn,12,0,40,28
1657028745549,MATH 20B,A01,083756,Briones; Jor-el Thomas Caparas,1,0,36,35
1657028745549,MATH 20B,A02,083757,Briones; Jor-el Thomas Caparas,1,0,36,35
1657028745549,MATH 20B,A03,093475,Briones; Jor-el Thomas Caparas,0,0,36,36
1657028751579,MATH 20C,A01,083760,Briones; Jor-el Thomas Caparas,1,0,35,34
1657028751579,MATH 20C,A02,083761,Briones; Jor-el Thomas Caparas,8,0,35,27
1657028751579,MATH 20C,A03,093476,Briones; Jor-el Thomas Caparas,0,1,36,36
1657028751579,MATH 20C,B01,083762,Bach; Quang Tran,0,0,30,30
1657028757609,MATH 20D,A01,083765,Tran; Brian Kha,4,0,30,26
1657028757609,MATH 20D,A02,083766,Tran; Brian Kha,5,0,30,25
1657028757609,MATH 20D,A03,083767,Tran; Brian Kha,3,0,30,27
1657028763636,MATH 20E,A01,083771,Ganguly; Soumya,5,0,32,27
1657028763636,MATH 20E,A02,083772,Ganguly; Soumya,6,0,32,26
1657028763636,MATH 20E,B01,083773,Ciotti; Benjamin,18,0,35,17
1657028763636,MATH 20E,B02,083774,Ciotti; Benjamin,17,0,35,18
1657028769665,MATH 103A,A01,083777,Greenfeld; Be'Eri,2,0,36,34
1657028769665,MATH 103A,A02,083778,Greenfeld; Be'Eri,5,0,36,31
1657028769665,MATH 103A,A03,093561,Greenfeld; Be'Eri,4,0,36,32
1657028769665,MATH 103A,B01,083779,Greenfeld; Be'Eri,6,0,36,30
1657028769665,MATH 103A,B02,083780,Greenfeld; Be'Eri,2,0,36,34
1657028769665,MATH 103A,B03,093562,Greenfeld; Be'Eri,2,0,36,34
1657028775695,MATH 105,A01,085443,Carter; Anne Toulson,14,0,35,21
1657028775695,MATH 105,A02,093477,Carter; Anne Toulson,20,0,35,15
1657028781719,MATH 109,A01,083213,Ganzberger; Geoffrey Michael,2,0,34,32
1657028781719,MATH 109,A02,083214,Ganzberger; Geoffrey Michael,2,0,34,32
1657028781719,MATH 109,A03,093478,Ganzberger; Geoffrey Michael,1,0,34,33
1657028781719,MATH 109,B01,083215,Ganzberger; Geoffrey Michael,1,0,32,31
1657028781719,MATH 109,B02,083216,Ganzberger; Geoffrey Michael,1,0,32,31
1657028781719,MATH 109,B03,093479,Ganzberger; Geoffrey Michael,6,0,32,26
1657028787747,MATH 142A,A01,083219,Chow; Bennett,6,0,32,26
1657028787747,MATH 142A,A02,083220,Chow; Bennett,10,0,32,22
1657028787747,MATH 142A,A03,093480,Chow; Bennett,7,0,32,25
1657028787747,MATH 142A,B03,093481,Chow; Bennett,7,0,32,25
1657028787747,MATH 142A,B04,093558,Chow; Bennett,11,0,32,21
1657028787747,MATH 142A,B05,093559,Chow; Bennett,6,0,32,26
1657028793771,MATH 193A,A01,083224,Rotar; Vladimir,7,0,34,27
1657028793771,MATH 193A,A02,083225,Rotar; Vladimir,4,0,34,30
1657028793771,MATH 193A,A03,083781,Rotar; Vladimir,1,0,34,33
1657028793771,MATH 193A,A04,083782,Rotar; Vladimir,6,0,34,28
1657028793771,MATH 193A,A05,093482,Rotar; Vladimir,6,0,34,28
1657028799794,MATH 197,001,091859,McAuley; Julian John,9999,0,9999,0
1657028799794,MATH 197,002,095566,Kedlaya; Kiran S.,9997,0,9999,2
1657028799794,MATH 197,003,095567,Xiao; Ming,9999,0,9999,0
1657028799794,MATH 197,004,095571,Perols; Johan Lars,9998,0,9999,1
1657028806863,COGS 9,A01,083615,Shannon; Kyle Michael,7,0,75,68
1657028812887,COGS 11,A01,083617,Boyle; Mary E. T.,20,0,48,28
1657028818911,COGS 13,A01,083071,Bastos; Amalia Pinkusfeld,9,0,71,62
1657028824937,COGS 14A,A01,092681,Semenuks; Arturs,0,1,100,100
1657028830966,COGS 14B,A01,083073,Cheng; Tzu-Han,5,0,63,58
1657028836993,COGS 17,A01,092677,Semenuks; Arturs,4,0,81,77
1657028843021,COGS 100,A01,083619,Allen; Michael Gordon,15,0,70,55
1657028849048,COGS 101A,A01,083621,Davis; Joshua Daniel,9,0,68,59
1657028855093,COGS 101B,A01,091572,Allen; Michael Gordon,8,0,65,57
1657028861119,COGS 101C,A01,083625,Delgado; Tania,17,0,35,18
1657028867149,COGS 107A,A01,083627,Boyle; Mary E. T.,13,0,60,47
1657028873188,COGS 118A,A01,083075,Gupta; Anjum,15,0,76,61
1657028879215,CSE 3,A50,083646,Miranda; Gregory Joseph,22,0,50,28
1657028885245,CSE 8A,A50,083650,Miranda; Gregory Joseph,17,1,56,39
1657028891278,CSE 11,A01,083080,Cao; Yingjun,4,15,40,36
1657028897410,CSE 12,A01,083652,Krause-Levy; Sophia Louisa,21,1,120,99
1657028903439,CSE 15L,A01,083654,Morris; Justin Loren,8,0,50,42
1657028903439,CSE 15L,A02,083655,Morris; Justin Loren,9,0,50,41
1657028909465,CSE 20,A01,083657,Tran; Khoa Dang,37,0,80,43
1657028915493,CSE 21,A01,095574,Bach; Quang Tran,21,0,48,27
1657028921523,CSE 30,A01,083084,Eldon; John,4,0,80,76
1657028921523,CSE 30,B01,095061,Bhaskar; Nishant,6,0,50,44
1657028927549,CSE 100,A01,083659,Cao; Yingjun,3,4,70,67
1657028933577,CSE 134B,A01,083661,Powell; Thomas Allan,19,0,100,81
1657028939601,CSE 140,A01,083663,Gungor; Onat,14,0,85,71
1657028945626,CSE 140L,A01,083088,Eldon; John,16,0,100,84
1657028951656,CSE 175,A01,083665,Kumar; Rakesh,3,0,25,22
1657028957684,CSE 190,A00,092507,Dubnov; Shlomo,7,0,20,13
1657028963707,ECE 45,A01,083139,Congero; Spencer William,5,0,75,70
1657028969737,ECE 65,A50,083695,Saad; Andrew S,12,0,30,18
1657028969737,ECE 65,A51,095125,Saad; Andrew S,25,0,26,1
1657028975761,ECE 109,A01,091882,Touri; Behrouz,16,0,70,54
1657028981789,ECE 180,A00,083140,Abi Samra; Nicholas Camill,1,0,30,29
1657028981789,ECE 180,B00,083141,Abi Samra; Nicholas Camill,0,0,30,30
1657028987813,MATH 10A,A01,083735,Patchell; Gregory David,1,0,30,29
1657028987813,MATH 10A,A02,083736,Patchell; Gregory David,20,0,30,10
1657028987813,MATH 10A,A03,083737,Patchell; Gregory David,16,0,30,14
1657028993843,MATH 10B,A01,083207,Lim; Seonhee,7,0,34,27
1657028993843,MATH 10B,A02,083208,Lim; Seonhee,9,0,35,26
1657028993843,MATH 10B,A03,093472,Lim; Seonhee,4,0,34,30
1657028993843,MATH 10B,B01,083739,Sinha; Shubham,9,0,30,21
1657028999878,MATH 18,A01,083743,Cinel; Cameron Alexander,6,0,30,24
1657028999878,MATH 18,A02,083744,Cinel; Cameron Alexander,15,0,30,15
1657028999878,MATH 18,A03,083745,Cinel; Cameron Alexander,8,0,30,22
1657028999878,MATH 18,B01,083748,Rideout; David Porter,4,0,37,33
1657028999878,MATH 18,B02,083749,Rideout; David Porter,3,0,36,33
1657028999878,MATH 18,B03,083750,Rideout; David Porter,2,0,37,35
1657028999878,MATH 18,B04,083751,Rideout; David Porter,5,0,36,31
1657028999878,MATH 18,B05,093473,Rideout; David Porter,4,0,36,32
1657028999878,MATH 18,B06,093474,Rideout; David Porter,5,0,36,31
1657029005903,MATH 20A,A01,083754,Zheng; Zequn,12,0,40,28
1657029011928,MATH 20B,A01,083756,Briones; Jor-el Thomas Caparas,1,0,36,35
1657029011928,MATH 20B,A02,083757,Briones; Jor-el Thomas Caparas,1,0,36,35
1657029011928,MATH 20B,A03,093475,Briones; Jor-el Thomas Caparas,0,0,36,36
1657029017952,MATH 20C,A01,083760,Briones; Jor-el Thomas Caparas,1,0,35,34
1657029017952,MATH 20C,A02,083761,Briones; Jor-el Thomas Caparas,8,0,35,27
1657029017952,MATH 20C,A03,093476,Briones; Jor-el Thomas Caparas,0,1,36,36
1657029017952,MATH 20C,B01,083762,Bach; Quang Tran,0,0,30,30
1657029023983,MATH 20D,A01,083765,Tran; Brian Kha,4,0,30,26
1657029023983,MATH 20D,A02,083766,Tran; Brian Kha,5,0,30,25
1657029023983,MATH 20D,A03,083767,Tran; Brian Kha,3,0,30,27
1657029030011,MATH 20E,A01,083771,Ganguly; Soumya,5,0,32,27
1657029030011,MATH 20E,A02,083772,Ganguly; Soumya,6,0,32,26
1657029030011,MATH 20E,B01,083773,Ciotti; Benjamin,18,0,35,17
1657029030011,MATH 20E,B02,083774,Ciotti; Benjamin,17,0,35,18
1657029036035,MATH 103A,A01,083777,Greenfeld; Be'Eri,2,0,36,34
1657029036035,MATH 103A,A02,083778,Greenfeld; Be'Eri,5,0,36,31
1657029036035,MATH 103A,A03,093561,Greenfeld; Be'Eri,4,0,36,32
1657029036035,MATH 103A,B01,083779,Greenfeld; Be'Eri,6,0,36,30
1657029036035,MATH 103A,B02,083780,Greenfeld; Be'Eri,2,0,36,34
1657029036035,MATH 103A,B03,093562,Greenfeld; Be'Eri,2,0,36,34
1657029042059,MATH 105,A01,085443,Carter; Anne Toulson,14,0,35,21
1657029042059,MATH 105,A02,093477,Carter; Anne Toulson,20,0,35,15
1657029048091,MATH 109,A01,083213,Ganzberger; Geoffrey Michael,2,0,34,32
1657029048091,MATH 109,A02,083214,Ganzberger; Geoffrey Michael,2,0,34,32
1657029048091,MATH 109,A03,093478,Ganzberger; Geoffrey Michael,1,0,34,33
1657029048091,MATH 109,B01,083215,Ganzberger; Geoffrey Michael,1,0,32,31
1657029048091,MATH 109,B02,083216,Ganzberger; Geoffrey Michael,1,0,32,31
1657029048091,MATH 109,B03,093479,Ganzberger; Geoffrey Michael,6,0,32,26
1657029054115,MATH 142A,A01,083219,Chow; Bennett,6,0,32,26
1657029054115,MATH 142A,A02,083220,Chow; Bennett,10,0,32,22
1657029054115,MATH 142A,A03,093480,Chow; Bennett,7,0,32,25
1657029054115,MATH 142A,B03,093481,Chow; Bennett,7,0,32,25
1657029054115,MATH 142A,B04,093558,Chow; Bennett,11,0,32,21
1657029054115,MATH 142A,B05,093559,Chow; Bennett,6,0,32,26
1657029060140,MATH 193A,A01,083224,Rotar; Vladimir,7,0,34,27
1657029060140,MATH 193A,A02,083225,Rotar; Vladimir,4,0,34,30
1657029060140,MATH 193A,A03,083781,Rotar; Vladimir,1,0,34,33
1657029060140,MATH 193A,A04,083782,Rotar; Vladimir,6,0,34,28
1657029060140,MATH 193A,A05,093482,Rotar; Vladimir,6,0,34,28
1657029066168,MATH 197,001,091859,McAuley; Julian John,9999,0,9999,0
1657029066168,MATH 197,002,095566,Kedlaya; Kiran S.,9997,0,9999,2
1657029066168,MATH 197,003,095567,Xiao; Ming,9999,0,9999,0
1657029066168,MATH 197,004,095571,Perols; Johan Lars,9998,0,9999,1
1657029073228,COGS 9,A01,083615,Shannon; Kyle Michael,7,0,75,68
1657029079256,COGS 11,A01,083617,Boyle; Mary E. T.,20,0,48,28
1657029085280,COGS 13,A01,083071,Bastos; Amalia Pinkusfeld,9,0,71,62
1657029091303,COGS 14A,A01,092681,Semenuks; Arturs,0,1,100,100
1657029097332,COGS 14B,A01,083073,Cheng; Tzu-Han,5,0,63,58
1657029103354,COGS 17,A01,092677,Semenuks; Arturs,4,0,81,77
1657029109383,COGS 100,A01,083619,Allen; Michael Gordon,15,0,70,55
1657029115412,COGS 101A,A01,083621,Davis; Joshua Daniel,9,0,68,59
1657029121435,COGS 101B,A01,091572,Allen; Michael Gordon,8,0,65,57
1657029127464,COGS 101C,A01,083625,Delgado; Tania,17,0,35,18
1657029133492,COGS 107A,A01,083627,Boyle; Mary E. T.,13,0,60,47
1657029139519,COGS 118A,A01,083075,Gupta; Anjum,15,0,76,61
1657029145542,CSE 3,A50,083646,Miranda; Gregory Joseph,22,0,50,28
1657029151570,CSE 8A,A50,083650,Miranda; Gregory Joseph,17,1,56,39
1657029157593,CSE 11,A01,083080,Cao; Yingjun,4,15,40,36
1657029163616,CSE 12,A01,083652,Krause-Levy; Sophia Louisa,21,1,120,99
1657029169640,CSE 15L,A01,083654,Morris; Justin Loren,8,0,50,42
1657029169640,CSE 15L,A02,083655,Morris; Justin Loren,9,0,50,41
1657029175664,CSE 20,A01,083657,Tran; Khoa Dang,37,0,80,43
1657029181692,CSE 21,A01,095574,Bach; Quang Tran,21,0,48,27
1657029187722,CSE 30,A01,083084,Eldon; John,4,0,80,76
1657029187722,CSE 30,B01,095061,Bhaskar; Nishant,6,0,50,44
1657029193753,CSE 100,A01,083659,Cao; Yingjun,3,4,70,67
1657029199779,CSE 134B,A01,083661,Powell; Thomas Allan,19,0,100,81
1657029205818,CSE 140,A01,083663,Gungor; Onat,14,0,85,71
1657029211841,CSE 140L,A01,083088,Eldon; John,16,0,100,84
1657029217867,CSE 175,A01,083665,Kumar; Rakesh,3,0,25,22
1657029223892,CSE 190,A00,092507,Dubnov; Shlomo,7,0,20,13
1657029229918,ECE 45,A01,083139,Congero; Spencer William,5,0,75,70
1657029235943,ECE 65,A50,083695,Saad; Andrew S,12,0,30,18
1657029235943,ECE 65,A51,095125,Saad; Andrew S,25,0,26,1
1657029241967,ECE 109,A01,091882,Touri; Behrouz,16,0,70,54
1657029247990,ECE 180,A00,083140,Abi Samra; Nicholas Camill,1,0,30,29
1657029247990,ECE 180,B00,083141,Abi Samra; Nicholas Camill,0,0,30,30
1657029254013,MATH 10A,A01,083735,Patchell; Gregory David,1,0,30,29
1657029254013,MATH 10A,A02,083736,Patchell; Gregory David,20,0,30,10
1657029254013,MATH 10A,A03,083737,Patchell; Gregory David,16,0,30,14
1657029260038,MATH 10B,A01,083207,Lim; Seonhee,7,0,34,27
1657029260038,MATH 10B,A02,083208,Lim; Seonhee,9,0,35,26
1657029260038,MATH 10B,A03,093472,Lim; Seonhee,4,0,34,30
1657029260038,MATH 10B,B01,083739,Sinha; Shubham,9,0,30,21
1657029266063,MATH 18,A01,083743,Cinel; Cameron Alexander,6,0,30,24
1657029266063,MATH 18,A02,083744,Cinel; Cameron Alexander,15,0,30,15
1657029266063,MATH 18,A03,083745,Cinel; Cameron Alexander,8,0,30,22
1657029266063,MATH 18,B01,083748,Rideout; David Porter,4,0,37,33
1657029266063,MATH 18,B02,083749,Rideout; David Porter,3,0,36,33
1657029266063,MATH 18,B03,083750,Rideout; David Porter,2,0,37,35
1657029266063,MATH 18,B04,083751,Rideout; David Porter,5,0,36,31
1657029266063,MATH 18,B05,093473,Rideout; David Porter,4,0,36,32
1657029266063,MATH 18,B06,093474,Rideout; David Porter,5,0,36,31
1657029272088,MATH 20A,A01,083754,Zheng; Zequn,12,0,40,28
1657029278112,MATH 20B,A01,083756,Briones; Jor-el Thomas Caparas,1,0,36,35
1657029278112,MATH 20B,A02,083757,Briones; Jor-el Thomas Caparas,1,0,36,35
1657029278112,MATH 20B,A03,093475,Briones; Jor-el Thomas Caparas,0,0,36,36
1657029284143,MATH 20C,A01,083760,Briones; Jor-el Thomas Caparas,1,0,35,34
1657029284143,MATH 20C,A02,083761,Briones; Jor-el Thomas Caparas,8,0,35,27
1657029284143,MATH 20C,A03,093476,Briones; Jor-el Thomas Caparas,0,1,36,36
1657029284143,MATH 20C,B01,083762,Bach; Quang Tran,0,0,30,30
1657029290171,MATH 20D,A01,083765,Tran; Brian Kha,4,0,30,26
1657029290171,MATH 20D,A02,083766,Tran; Brian Kha,5,0,30,25
1657029290171,MATH 20D,A03,083767,Tran; Brian Kha,3,0,30,27
1657029296200,MATH 20E,A01,083771,Ganguly; Soumya,5,0,32,27
1657029296200,MATH 20E,A02,083772,Ganguly; Soumya,6,0,32,26
1657029296200,MATH 20E,B01,083773,Ciotti; Benjamin,18,0,35,17
1657029296200,MATH 20E,B02,083774,Ciotti; Benjamin,17,0,35,18
1657029302234,MATH 103A,A01,083777,Greenfeld; Be'Eri,2,0,36,34
1657029302234,MATH 103A,A02,083778,Greenfeld; Be'Eri,5,0,36,31
1657029302234,MATH 103A,A03,093561,Greenfeld; Be'Eri,4,0,36,32
1657029302234,MATH 103A,B01,083779,Greenfeld; Be'Eri,6,0,36,30
1657029302234,MATH 103A,B02,083780,Greenfeld; Be'Eri,2,0,36,34
1657029302234,MATH 103A,B03,093562,Greenfeld; Be'Eri,2,0,36,34
1657029308261,MATH 105,A01,085443,Carter; Anne Toulson,14,0,35,21
1657029308261,MATH 105,A02,093477,Carter; Anne Toulson,20,0,35,15
1657029314302,MATH 109,A01,083213,Ganzberger; Geoffrey Michael,2,0,34,32
1657029314302,MATH 109,A02,083214,Ganzberger; Geoffrey Michael,2,0,34,32
1657029314302,MATH 109,A03,093478,Ganzberger; Geoffrey Michael,1,0,34,33
1657029314302,MATH 109,B01,083215,Ganzberger; Geoffrey Michael,1,0,32,31
1657029314302,MATH 109,B02,083216,Ganzberger; Geoffrey Michael,1,0,32,31
1657029314302,MATH 109,B03,093479,Ganzberger; Geoffrey Michael,6,0,32,26
1657029320327,MATH 142A,A01,083219,Chow; Bennett,6,0,32,26
1657029320327,MATH 142A,A02,083220,Chow; Bennett,10,0,32,22
1657029320327,MATH 142A,A03,093480,Chow; Bennett,7,0,32,25
1657029320327,MATH 142A,B03,093481,Chow; Bennett,7,0,32,25
1657029320327,MATH 142A,B04,093558,Chow; Bennett,11,0,32,21
1657029320327,MATH 142A,B05,093559,Chow; Bennett,6,0,32,26
1657029326359,MATH 193A,A01,083224,Rotar; Vladimir,7,0,34,27
1657029326359,MATH 193A,A02,083225,Rotar; Vladimir,4,0,34,30
1657029326359,MATH 193A,A03,083781,Rotar; Vladimir,1,0,34,33
1657029326359,MATH 193A,A04,083782,Rotar; Vladimir,6,0,34,28
1657029326359,MATH 193A,A05,093482,Rotar; Vladimir,6,0,34,28
1657029332384,MATH 197,001,091859,McAuley; Julian John,9999,0,9999,0
1657029332384,MATH 197,002,095566,Kedlaya; Kiran S.,9997,0,9999,2
1657029332384,MATH 197,003,095567,Xiao; Ming,9999,0,9999,0
1657029332384,MATH 197,004,095571,Perols; Johan Lars,9998,0,9999,1
1657029339455,COGS 9,A01,083615,Shannon; Kyle Michael,7,0,75,68
1657029345483,COGS 11,A01,083617,Boyle; Mary E. T.,20,0,48,28
1657029351508,COGS 13,A01,083071,Bastos; Amalia Pinkusfeld,9,0,71,62
1657029357534,COGS 14A,A01,092681,Semenuks; Arturs,0,1,100,100
1657029363561,COGS 14B,A01,083073,Cheng; Tzu-Han,5,0,63,58
1657029369586,COGS 17,A01,092677,Semenuks; Arturs,4,0,81,77
1657029375610,COGS 100,A01,083619,Allen; Michael Gordon,15,0,70,55
1657029381639,COGS 101A,A01,083621,Davis; Joshua Daniel,9,0,68,59
1657029387664,COGS 101B,A01,091572,Allen; Michael Gordon,8,0,65,57
1657029393699,COGS 101C,A01,083625,Delgado; Tania,17,0,35,18
1657029399725,COGS 107A,A01,083627,Boyle; Mary E. T.,13,0,60,47
1657029405761,COGS 118A,A01,083075,Gupta; Anjum,15,0,76,61
1657029411788,CSE 3,A50,083646,Miranda; Gregory Joseph,22,0,50,28
1657029417814,CSE 8A,A50,083650,Miranda; Gregory Joseph,17,1,56,39
1657029423844,CSE 11,A01,083080,Cao; Yingjun,4,15,40,36
1657029429870,CSE 12,A01,083652,Krause-Levy; Sophia Louisa,21,1,120,99
1657029435899,CSE 15L,A01,083654,Morris; Justin Loren,8,0,50,42
1657029435899,CSE 15L,A02,083655,Morris; Justin Loren,9,0,50,41
1657029441932,CSE 20,A01,083657,Tran; Khoa Dang,37,0,80,43
1657029447962,CSE 21,A01,095574,Bach; Quang Tran,21,0,48,27
1657029453989,CSE 30,A01,083084,Eldon; John,4,0,80,76
1657029453989,CSE 30,B01,095061,Bhaskar; Nishant,6,0,50,44
1657029460014,CSE 100,A01,083659,Cao; Yingjun,3,4,70,67
1657029466043,CSE 134B,A01,083661,Powell; Thomas Allan,19,0,100,81
1657029472069,CSE 140,A01,083663,Gungor; Onat,14,0,85,71
1657029478097,CSE 140L,A01,083088,Eldon; John,16,0,100,84
1657029484144,CSE 175,A01,083665,Kumar; Rakesh,3,0,25,22
1657029490170,CSE 190,A00,092507,Dubnov; Shlomo,7,0,20,13
1657029496266,ECE 45,A01,083139,Congero; Spencer William,5,0,75,70
1657029502293,ECE 65,A50,083695,Saad; Andrew S,12,0,30,18
1657029502293,ECE 65,A51,095125,Saad; Andrew S,25,0,26,1
1657029508322,ECE 109,A01,091882,Touri; Behrouz,16,0,70,54
1657029514347,ECE 180,A00,083140,Abi Samra; Nicholas Camill,1,0,30,29
1657029514347,ECE 180,B00,083141,Abi Samra; Nicholas Camill,0,0,30,30
1657029520372,MATH 10A,A01,083735,Patchell; Gregory David,1,0,30,29
1657029520372,MATH 10A,A02,083736,Patchell; Gregory David,20,0,30,10
1657029520372,MATH 10A,A03,083737,Patchell; Gregory David,16,0,30,14
1657029526395,MATH 10B,A01,083207,Lim; Seonhee,7,0,34,27
1657029526395,MATH 10B,A02,083208,Lim; Seonhee,9,0,35,26
1657029526395,MATH 10B,A03,093472,Lim; Seonhee,4,0,34,30
1657029526395,MATH 10B,B01,083739,Sinha; Shubham,9,0,30,21
1657029532421,MATH 18,A01,083743,Cinel; Cameron Alexander,6,0,30,24
1657029532421,MATH 18,A02,083744,Cinel; Cameron Alexander,15,0,30,15
1657029532421,MATH 18,A03,083745,Cinel; Cameron Alexander,8,0,30,22
1657029532421,MATH 18,B01,083748,Rideout; David Porter,4,0,37,33
1657029532421,MATH 18,B02,083749,Rideout; David Porter,3,0,36,33
1657029532421,MATH 18,B03,083750,Rideout; David Porter,2,0,37,35
1657029532421,MATH 18,B04,083751,Rideout; David Porter,5,0,36,31
1657029532421,MATH 18,B05,093473,Rideout; David Porter,4,0,36,32
1657029532421,MATH 18,B06,093474,Rideout; David Porter,5,0,36,31
1657029538444,MATH 20A,A01,083754,Zheng; Zequn,12,0,40,28
1657029544486,MATH 20B,A01,083756,Briones; Jor-el Thomas Caparas,1,0,36,35
1657029544486,MATH 20B,A02,083757,Briones; Jor-el Thomas Caparas,1,0,36,35
1657029544486,MATH 20B,A03,093475,Briones; Jor-el Thomas Caparas,0,0,36,36
1657029550509,MATH 20C,A01,083760,Briones; Jor-el Thomas Caparas,1,0,35,34
1657029550509,MATH 20C,A02,083761,Briones; Jor-el Thomas Caparas,8,0,35,27
1657029550509,MATH 20C,A03,093476,Briones; Jor-el Thomas Caparas,0,1,36,36
1657029550509,MATH 20C,B01,083762,Bach; Quang Tran,0,0,30,30
1657029556537,MATH 20D,A01,083765,Tran; Brian Kha,4,0,30,26
1657029556537,MATH 20D,A02,083766,Tran; Brian Kha,5,0,30,25
1657029556537,MATH 20D,A03,083767,Tran; Brian Kha,3,0,30,27
1657029562562,MATH 20E,A01,083771,Ganguly; Soumya,5,0,32,27
1657029562562,MATH 20E,A02,083772,Ganguly; Soumya,6,0,32,26
1657029562562,MATH 20E,B01,083773,Ciotti; Benjamin,18,0,35,17
1657029562562,MATH 20E,B02,083774,Ciotti; Benjamin,17,0,35,18
1657029568592,MATH 103A,A01,083777,Greenfeld; Be'Eri,2,0,36,34
1657029568592,MATH 103A,A02,083778,Greenfeld; Be'Eri,5,0,36,31
1657029568592,MATH 103A,A03,093561,Greenfeld; Be'Eri,4,0,36,32
1657029568592,MATH 103A,B01,083779,Greenfeld; Be'Eri,6,0,36,30
1657029568592,MATH 103A,B02,083780,Greenfeld; Be'Eri,2,0,36,34
1657029568592,MATH 103A,B03,093562,Greenfeld; Be'Eri,2,0,36,34
1657029574617,MATH 105,A01,085443,Carter; Anne Toulson,14,0,35,21
1657029574617,MATH 105,A02,093477,Carter; Anne Toulson,20,0,35,15
1657029580640,MATH 109,A01,083213,Ganzberger; Geoffrey Michael,2,0,34,32
1657029580640,MATH 109,A02,083214,Ganzberger; Geoffrey Michael,2,0,34,32
1657029580640,MATH 109,A03,093478,Ganzberger; Geoffrey Michael,1,0,34,33
1657029580640,MATH 109,B01,083215,Ganzberger; Geoffrey Michael,1,0,32,31
1657029580640,MATH 109,B02,083216,Ganzberger; Geoffrey Michael,1,0,32,31
1657029580640,MATH 109,B03,093479,Ganzberger; Geoffrey Michael,6,0,32,26
1657029586669,MATH 142A,A01,083219,Chow; Bennett,6,0,32,26
1657029586669,MATH 142A,A02,083220,Chow; Bennett,10,0,32,22
1657029586669,MATH 142A,A03,093480,Chow; Bennett,7,0,32,25
1657029586669,MATH 142A,B03,093481,Chow; Bennett,7,0,32,25
1657029586669,MATH 142A,B04,093558,Chow; Bennett,11,0,32,21
1657029586669,MATH 142A,B05,093559,Chow; Bennett,6,0,32,26
1657029592693,MATH 193A,A01,083224,Rotar; Vladimir,7,0,34,27
1657029592693,MATH 193A,A02,083225,Rotar; Vladimir,4,0,34,30
1657029592693,MATH 193A,A03,083781,Rotar; Vladimir,1,0,34,33
1657029592693,MATH 193A,A04,083782,Rotar; Vladimir,6,0,34,28
1657029592693,MATH 193A,A05,093482,Rotar; Vladimir,6,0,34,28
1657029598724,MATH 197,001,091859,McAuley; Julian John,9999,0,9999,0
1657029598724,MATH 197,002,095566,Kedlaya; Kiran S.,9997,0,9999,2
1657029598724,MATH 197,003,095567,Xiao; Ming,9999,0,9999,0
1657029598724,MATH 197,004,095571,Perols; Johan Lars,9998,0,9999,1
1657029605779,COGS 9,A01,083615,Shannon; Kyle Michael,7,0,75,68
1657029611804,COGS 11,A01,083617,Boyle; Mary E. T.,20,0,48,28
1657029617873,COGS 13,A01,083071,Bastos; Amalia Pinkusfeld,9,0,71,62
1657029623897,COGS 14A,A01,092681,Semenuks; Arturs,0,1,100,100
1657029629920,COGS 14B,A01,083073,Cheng; Tzu-Han,5,0,63,58
1657029635946,COGS 17,A01,092677,Semenuks; Arturs,4,0,81,77
1657029641979,COGS 100,A01,083619,Allen; Michael Gordon,15,0,70,55
1657029648012,COGS 101A,A01,083621,Davis; Joshua Daniel,9,0,68,59
1657029654036,COGS 101B,A01,091572,Allen; Michael Gordon,8,0,65,57
1657029660065,COGS 101C,A01,083625,Delgado; Tania,17,0,35,18
1657029666090,COGS 107A,A01,083627,Boyle; Mary E. T.,13,0,60,47
1657029672117,COGS 118A,A01,083075,Gupta; Anjum,15,0,76,61
1657029678149,CSE 3,A50,083646,Miranda; Gregory Joseph,22,0,50,28
1657029684174,CSE 8A,A50,083650,Miranda; Gregory Joseph,17,1,56,39
1657029690198,CSE 11,A01,083080,Cao; Yingjun,4,15,40,36
1657029696225,CSE 12,A01,083652,Krause-Levy; Sophia Louisa,21,1,120,99
1657029702257,CSE 15L,A01,083654,Morris; Justin Loren,8,0,50,42
1657029702257,CSE 15L,A02,083655,Morris; Justin Loren,9,0,50,41
1657029708284,CSE 20,A01,083657,Tran; Khoa Dang,37,0,80,43
1657029714310,CSE 21,A01,095574,Bach; Quang Tran,21,0,48,27
1657029720342,CSE 30,A01,083084,Eldon; John,4,0,80,76
1657029720342,CSE 30,B01,095061,Bhaskar; Nishant,6,0,50,44
1657029726365,CSE 100,A01,083659,Cao; Yingjun,3,4,70,67
1657029732428,CSE 134B,A01,083661,Powell; Thomas Allan,19,0,100,81
1657029738456,CSE 140,A01,083663,Gungor; Onat,14,0,85,71
1657029744484,CSE 140L,A01,083088,Eldon; John,16,0,100,84
1657029750511,CSE 175,A01,083665,Kumar; Rakesh,3,0,25,22
1657029756537,CSE 190,A00,092507,Dubnov; Shlomo,7,0,20,13
1657029762565,ECE 45,A01,083139,Congero; Spencer William,5,0,75,70
1657029768598,ECE 65,A50,083695,Saad; Andrew S,12,0,30,18
1657029768598,ECE 65,A51,095125,Saad; Andrew S,25,0,26,1
1657029774622,ECE 109,A01,091882,Touri; Behrouz,16,0,70,54
1657029780648,ECE 180,A00,083140,Abi Samra; Nicholas Camill,1,0,30,29
1657029780648,ECE 180,B00,083141,Abi Samra; Nicholas Camill,0,0,30,30
1657029786674,MATH 10A,A01,083735,Patchell; Gregory David,1,0,30,29
1657029786674,MATH 10A,A02,083736,Patchell; Gregory David,20,0,30,10
1657029786674,MATH 10A,A03,083737,Patchell; Gregory David,16,0,30,14
1657029792705,MATH 10B,A01,083207,Lim; Seonhee,7,0,34,27
1657029792705,MATH 10B,A02,083208,Lim; Seonhee,9,0,35,26
1657029792705,MATH 10B,A03,093472,Lim; Seonhee,4,0,34,30
1657029792705,MATH 10B,B01,083739,Sinha; Shubham,9,0,30,21
1657029798731,MATH 18,A01,083743,Cinel; Cameron Alexander,6,0,30,24
1657029798731,MATH 18,A02,083744,Cinel; Cameron Alexander,15,0,30,15
1657029798731,MATH 18,A03,083745,Cinel; Cameron Alexander,8,0,30,22
1657029798731,MATH 18,B01,083748,Rideout; David Porter,4,0,37,33
1657029798731,MATH 18,B02,083749,Rideout; David Porter,3,0,36,33
1657029798731,MATH 18,B03,083750,Rideout; David Porter,2,0,37,35
1657029798731,MATH 18,B04,083751,Rideout; David Porter,5,0,36,31
1657029798731,MATH 18,B05,093473,Rideout; David Porter,4,0,36,32
1657029798731,MATH 18,B06,093474,Rideout; David Porter,5,0,36,31
1657029804758,MATH 20A,A01,083754,Zheng; Zequn,12,0,40,28
1657029810781,MATH 20B,A01,083756,Briones; Jor-el Thomas Caparas,1,0,36,35
1657029810781,MATH 20B,A02,083757,Briones; Jor-el Thomas Caparas,1,0,36,35
1657029810781,MATH 20B,A03,093475,Briones; Jor-el Thomas Caparas,0,0,36,36
1657029816807,MATH 20C,A01,083760,Briones; Jor-el Thomas Caparas,1,0,35,34
1657029816807,MATH 20C,A02,083761,Briones; Jor-el Thomas Caparas,8,0,35,27
1657029816807,MATH 20C,A03,093476,Briones; Jor-el Thomas Caparas,0,1,36,36
1657029816807,MATH 20C,B01,083762,Bach; Quang Tran,0,0,30,30
1657029822870,MATH 20D,A01,083765,Tran; Brian Kha,4,0,30,26
1657029822870,MATH 20D,A02,083766,Tran; Brian Kha,5,0,30,25
1657029822870,MATH 20D,A03,083767,Tran; Brian Kha,3,0,30,27
1657029828896,MATH 20E,A01,083771,Ganguly; Soumya,5,0,32,27
1657029828896,MATH 20E,A02,083772,Ganguly; Soumya,6,0,32,26
1657029828896,MATH 20E,B01,083773,Ciotti; Benjamin,18,0,35,17
1657029828896,MATH 20E,B02,083774,Ciotti; Benjamin,17,0,35,18
1657029834923,MATH 103A,A01,083777,Greenfeld; Be'Eri,2,0,36,34
1657029834923,MATH 103A,A02,083778,Greenfeld; Be'Eri,5,0,36,31
1657029834923,MATH 103A,A03,093561,Greenfeld; Be'Eri,4,0,36,32
1657029834923,MATH 103A,B01,083779,Greenfeld; Be'Eri,6,0,36,30
1657029834923,MATH 103A,B02,083780,Greenfeld; Be'Eri,2,0,36,34
1657029834923,MATH 103A,B03,093562,Greenfeld; Be'Eri,2,0,36,34
1657029840950,MATH 105,A01,085443,Carter; Anne Toulson,14,0,35,21
1657029840950,MATH 105,A02,093477,Carter; Anne Toulson,20,0,35,15
1657029846981,MATH 109,A01,083213,Ganzberger; Geoffrey Michael,2,0,34,32
1657029846981,MATH 109,A02,083214,Ganzberger; Geoffrey Michael,2,0,34,32
1657029846981,MATH 109,A03,093478,Ganzberger; Geoffrey Michael,1,0,34,33
1657029846981,MATH 109,B01,083215,Ganzberger; Geoffrey Michael,1,0,32,31
1657029846981,MATH 109,B02,083216,Ganzberger; Geoffrey Michael,1,0,32,31
1657029846981,MATH 109,B03,093479,Ganzberger; Geoffrey Michael,6,0,32,26
1657029853021,MATH 142A,A01,083219,Chow; Bennett,6,0,32,26
1657029853021,MATH 142A,A02,083220,Chow; Bennett,10,0,32,22
1657029853021,MATH 142A,A03,093480,Chow; Bennett,7,0,32,25
1657029853021,MATH 142A,B03,093481,Chow; Bennett,7,0,32,25
1657029853021,MATH 142A,B04,093558,Chow; Bennett,11,0,32,21
1657029853021,MATH 142A,B05,093559,Chow; Bennett,6,0,32,26
1657029859049,MATH 193A,A01,083224,Rotar; Vladimir,7,0,34,27
1657029859049,MATH 193A,A02,083225,Rotar; Vladimir,4,0,34,30
1657029859049,MATH 193A,A03,083781,Rotar; Vladimir,1,0,34,33
1657029859049,MATH 193A,A04,083782,Rotar; Vladimir,6,0,34,28
1657029859049,MATH 193A,A05,093482,Rotar; Vladimir,6,0,34,28
1657029865078,MATH 197,001,091859,McAuley; Julian John,9999,0,9999,0
1657029865078,MATH 197,002,095566,Kedlaya; Kiran S.,9997,0,9999,2
1657029865078,MATH 197,003,095567,Xiao; Ming,9999,0,9999,0
1657029865078,MATH 197,004,095571,Perols; Johan Lars,9998,0,9999,1
1657029872142,COGS 9,A01,083615,Shannon; Kyle Michael,7,0,75,68
1657029878176,COGS 11,A01,083617,Boyle; Mary E. T.,20,0,48,28
1657029884203,COGS 13,A01,083071,Bastos; Amalia Pinkusfeld,9,0,71,62
1657029890234,COGS 14A,A01,092681,Semenuks; Arturs,0,1,100,100
1657029896261,COGS 14B,A01,083073,Cheng; Tzu-Han,5,0,63,58
1657029902292,COGS 17,A01,092677,Semenuks; Arturs,4,0,81,77
1657029908321,COGS 100,A01,083619,Allen; Michael Gordon,15,0,70,55
1657029914348,COGS 101A,A01,083621,Davis; Joshua Daniel,9,0,68,59
1657029920372,COGS 101B,A01,091572,Allen; Michael Gordon,8,0,65,57
1657029926396,COGS 101C,A01,083625,Delgado; Tania,17,0,35,18
1657029932419,COGS 107A,A01,083627,Boyle; Mary E. T.,13,0,60,47
1657029938454,COGS 118A,A01,083075,Gupta; Anjum,15,0,76,61
1657029944482,CSE 3,A50,083646,Miranda; Gregory Joseph,22,0,50,28
1657029950504,CSE 8A,A50,083650,Miranda; Gregory Joseph,17,1,56,39
1657029956529,CSE 11,A01,083080,Cao; Yingjun,4,15,40,36
1657029962552,CSE 12,A01,083652,Krause-Levy; Sophia Louisa,21,1,120,99
1657029968579,CSE 15L,A01,083654,Morris; Justin Loren,8,0,50,42
1657029968579,CSE 15L,A02,083655,Morris; Justin Loren,9,0,50,41
1657029974617,CSE 20,A01,083657,Tran; Khoa Dang,37,0,80,43
1657029980644,CSE 21,A01,095574,Bach; Quang Tran,21,0,48,27
1657029986668,CSE 30,A01,083084,Eldon; John,4,0,80,76
1657029986668,CSE 30,B01,095061,Bhaskar; Nishant,6,0,50,44
1657029992705,CSE 100,A01,083659,Cao; Yingjun,3,4,70,67
1657029998729,CSE 134B,A01,083661,Powell; Thomas Allan,19,0,100,81
1657030004754,CSE 140,A01,083663,Gungor; Onat,14,0,85,71
1657030010778,CSE 140L,A01,083088,Eldon; John,16,0,100,84
1657030016805,CSE 175,A01,083665,Kumar; Rakesh,3,0,25,22
1657030022829,CSE 190,A00,092507,Dubnov; Shlomo,7,0,20,13
1657030028856,ECE 45,A01,083139,Congero; Spencer William,5,0,75,70
1657030034890,ECE 65,A50,083695,Saad; Andrew S,12,0,30,18
1657030034890,ECE 65,A51,095125,Saad; Andrew S,25,0,26,1
1657030040918,ECE 109,A01,091882,Touri; Behrouz,16,0,70,54
1657030046942,ECE 180,A00,083140,Abi Samra; Nicholas Camill,1,0,30,29
1657030046942,ECE 180,B00,083141,Abi Samra; Nicholas Camill,0,0,30,30
1657030052977,MATH 10A,A01,083735,Patchell; Gregory David,1,0,30,29
1657030052977,MATH 10A,A02,083736,Patchell; Gregory David,20,0,30,10
1657030052977,MATH 10A,A03,083737,Patchell; Gregory David,16,0,30,14
1657030059002,MATH 10B,A01,083207,Lim; Seonhee,7,0,34,27
1657030059002,MATH 10B,A02,083208,Lim; Seonhee,9,0,35,26
1657030059002,MATH 10B,A03,093472,Lim; Seonhee,4,0,34,30
1657030059002,MATH 10B,B01,083739,Sinha; Shubham,9,0,30,21
1657030065046,MATH 18,A01,083743,Cinel; Cameron Alexander,6,0,30,24
1657030065046,MATH 18,A02,083744,Cinel; Cameron Alexander,15,0,30,15
1657030065046,MATH 18,A03,083745,Cinel; Cameron Alexander,8,0,30,22
1657030065046,MATH 18,B01,083748,Rideout; David Porter,4,0,37,33
1657030065046,MATH 18,B02,083749,Rideout; David Porter,3,0,36,33
1657030065046,MATH 18,B03,083750,Rideout; David Porter,2,0,37,35
1657030065046,MATH 18,B04,083751,Rideout; David Porter,5,0,36,31
1657030065046,MATH 18,B05,093473,Rideout; David Porter,4,0,36,32
1657030065046,MATH 18,B06,093474,Rideout; David Porter,5,0,36,31
1657030071071,MATH 20A,A01,083754,Zheng; Zequn,12,0,40,28
1657030077096,MATH 20B,A01,083756,Briones; Jor-el Thomas Caparas,1,0,36,35
1657030077096,MATH 20B,A02,083757,Briones; Jor-el Thomas Caparas,1,0,36,35
1657030077096,MATH 20B,A03,093475,Briones; Jor-el Thomas Caparas,0,0,36,36
1657030083121,MATH 20C,A01,083760,Briones; Jor-el Thomas Caparas,1,0,35,34
1657030083121,MATH 20C,A02,083761,Briones; Jor-el Thomas Caparas,8,0,35,27
1657030083121,MATH 20C,A03,093476,Briones; Jor-el Thomas Caparas,0,1,36,36
1657030083121,MATH 20C,B01,083762,Bach; Quang Tran,0,0,30,30
1657030089146,MATH 20D,A01,083765,Tran; Brian Kha,4,0,30,26
1657030089146,MATH 20D,A02,083766,Tran; Brian Kha,5,0,30,25
1657030089146,MATH 20D,A03,083767,Tran; Brian Kha,3,0,30,27
1657030095263,MATH 20E,A01,083771,Ganguly; Soumya,5,0,32,27
1657030095263,MATH 20E,A02,083772,Ganguly; Soumya,6,0,32,26
1657030095263,MATH 20E,B01,083773,Ciotti; Benjamin,18,0,35,17
1657030095263,MATH 20E,B02,083774,Ciotti; Benjamin,17,0,35,18
1657030101291,MATH 103A,A01,083777,Greenfeld; Be'Eri,2,0,36,34
1657030101291,MATH 103A,A02,083778,Greenfeld; Be'Eri,5,0,36,31
1657030101291,MATH 103A,A03,093561,Greenfeld; Be'Eri,4,0,36,32
1657030101291,MATH 103A,B01,083779,Greenfeld; Be'Eri,6,0,36,30
1657030101291,MATH 103A,B02,083780,Greenfeld; Be'Eri,2,0,36,34
1657030101291,MATH 103A,B03,093562,Greenfeld; Be'Eri,2,0,36,34
1657030107319,MATH 105,A01,085443,Carter; Anne Toulson,14,0,35,21
1657030107319,MATH 105,A02,093477,Carter; Anne Toulson,20,0,35,15
1657030113344,MATH 109,A01,083213,Ganzberger; Geoffrey Michael,2,0,34,32
1657030113344,MATH 109,A02,083214,Ganzberger; Geoffrey Michael,2,0,34,32
1657030113344,MATH 109,A03,093478,Ganzberger; Geoffrey Michael,1,0,34,33
1657030113344,MATH 109,B01,083215,Ganzberger; Geoffrey Michael,1,0,32,31
1657030113344,MATH 109,B02,083216,Ganzberger; Geoffrey Michael,1,0,32,31
1657030113344,MATH 109,B03,093479,Ganzberger; Geoffrey Michael,6,0,32,26
1657030119370,MATH 142A,A01,083219,Chow; Bennett,6,0,32,26
1657030119370,MATH 142A,A02,083220,Chow; Bennett,10,0,32,22
1657030119370,MATH 142A,A03,093480,Chow; Bennett,7,0,32,25
1657030119370,MATH 142A,B03,093481,Chow; Bennett,7,0,32,25
1657030119370,MATH 142A,B04,093558,Chow; Bennett,11,0,32,21
1657030119370,MATH 142A,B05,093559,Chow; Bennett,6,0,32,26
1657030125395,MATH 193A,A01,083224,Rotar; Vladimir,7,0,34,27
1657030125395,MATH 193A,A02,083225,Rotar; Vladimir,4,0,34,30
1657030125395,MATH 193A,A03,083781,Rotar; Vladimir,1,0,34,33
1657030125395,MATH 193A,A04,083782,Rotar; Vladimir,6,0,34,28
1657030125395,MATH 193A,A05,093482,Rotar; Vladimir,6,0,34,28
1657030131420,MATH 197,001,091859,McAuley; Julian John,9999,0,9999,0
1657030131420,MATH 197,002,095566,Kedlaya; Kiran S.,9997,0,9999,2
1657030131420,MATH 197,003,095567,Xiao; Ming,9999,0,9999,0
1657030131420,MATH 197,004,095571,Perols; Johan Lars,9998,0,9999,1
1657030138475,COGS 9,A01,083615,Shannon; Kyle Michael,7,0,75,68
1657030144503,COGS 11,A01,083617,Boyle; Mary E. T.,20,0,48,28
1657030150528,COGS 13,A01,083071,Bastos; Amalia Pinkusfeld,9,0,71,62
1657030156556,COGS 14A,A01,092681,Semenuks; Arturs,0,1,100,100
1657030162589,COGS 14B,A01,083073,Cheng; Tzu-Han,5,0,63,58
1657030168617,COGS 17,A01,092677,Semenuks; Arturs,4,0,81,77
1657030174640,COGS 100,A01,083619,Allen; Michael Gordon,15,0,70,55
1657030180675,COGS 101A,A01,083621,Davis; Joshua Daniel,9,0,68,59
1657030186709,COGS 101B,A01,091572,Allen; Michael Gordon,8,0,65,57
1657030192733,COGS 101C,A01,083625,Delgado; Tania,17,0,35,18
1657030198759,COGS 107A,A01,083627,Boyle; Mary E. T.,13,0,60,47
1657030204783,COGS 118A,A01,083075,Gupta; Anjum,15,0,76,61
1657030210808,CSE 3,A50,083646,Miranda; Gregory Joseph,22,0,50,28
1657030216833,CSE 8A,A50,083650,Miranda; Gregory Joseph,17,1,56,39
1657030222858,CSE 11,A01,083080,Cao; Yingjun,4,15,40,36
1657030228888,CSE 12,A01,083652,Krause-Levy; Sophia Louisa,21,1,120,99
1657030234913,CSE 15L,A01,083654,Morris; Justin Loren,8,0,50,42
1657030234913,CSE 15L,A02,083655,Morris; Justin Loren,9,0,50,41
1657030240940,CSE 20,A01,083657,Tran; Khoa Dang,37,0,80,43
1657030246964,CSE 21,A01,095574,Bach; Quang Tran,21,0,48,27
1657030252991,CSE 30,A01,083084,Eldon; John,4,0,80,76
1657030252991,CSE 30,B01,095061,Bhaskar; Nishant,6,0,50,44
1657030259014,CSE 100,A01,083659,Cao; Yingjun,3,4,70,67
1657030265037,CSE 134B,A01,083661,Powell; Thomas Allan,19,0,100,81
1657030271077,CSE 140,A01,083663,Gungor; Onat,14,0,85,71
1657030277103,CSE 140L,A01,083088,Eldon; John,16,0,100,84
1657030283131,CSE 175,A01,083665,Kumar; Rakesh,3,0,25,22
1657030289159,CSE 190,A00,092507,Dubnov; Shlomo,7,0,20,13
1657030295186,ECE 45,A01,083139,Congero; Spencer William,5,0,75,70
1657030301211,ECE 65,A50,083695,Saad; Andrew S,12,0,30,18
1657030301211,ECE 65,A51,095125,Saad; Andrew S,25,0,26,1
1657030307237,ECE 109,A01,091882,Touri; Behrouz,16,0,70,54
1657030313261,ECE 180,A00,083140,Abi Samra; Nicholas Camill,1,0,30,29
1657030313261,ECE 180,B00,083141,Abi Samra; Nicholas Camill,0,0,30,30
1657030319298,MATH 10A,A01,083735,Patchell; Gregory David,1,0,30,29
1657030319298,MATH 10A,A02,083736,Patchell; Gregory David,20,0,30,10
1657030319298,MATH 10A,A03,083737,Patchell; Gregory David,16,0,30,14
1657030325330,MATH 10B,A01,083207,Lim; Seonhee,7,0,34,27
1657030325330,MATH 10B,A02,083208,Lim; Seonhee,9,0,35,26
1657030325330,MATH 10B,A03,093472,Lim; Seonhee,4,0,34,30
1657030325330,MATH 10B,B01,083739,Sinha; Shubham,9,0,30,21
1657030331356,MATH 18,A01,083743,Cinel; Cameron Alexander,6,0,30,24
1657030331356,MATH 18,A02,083744,Cinel; Cameron Alexander,15,0,30,15
1657030331356,MATH 18,A03,083745,Cinel; Cameron Alexander,8,0,30,22
1657030331356,MATH 18,B01,083748,Rideout; David Porter,4,0,37,33
1657030331356,MATH 18,B02,083749,Rideout; David Porter,3,0,36,33
1657030331356,MATH 18,B03,083750,Rideout; David Porter,2,0,37,35
1657030331356,MATH 18,B04,083751,Rideout; David Porter,5,0,36,31
1657030331356,MATH 18,B05,093473,Rideout; David Porter,4,0,36,32
1657030331356,MATH 18,B06,093474,Rideout; David Porter,5,0,36,31
1657030337381,MATH 20A,A01,083754,Zheng; Zequn,12,0,40,28
1657030343410,MATH 20B,A01,083756,Briones; Jor-el Thomas Caparas,1,0,36,35
1657030343410,MATH 20B,A02,083757,Briones; Jor-el Thomas Caparas,1,0,36,35
1657030343410,MATH 20B,A03,093475,Briones; Jor-el Thomas Caparas,0,0,36,36
1657030349434,MATH 20C,A01,083760,Briones; Jor-el Thomas Caparas,1,0,35,34
1657030349434,MATH 20C,A02,083761,Briones; Jor-el Thomas Caparas,8,0,35,27
1657030349434,MATH 20C,A03,093476,Briones; Jor-el Thomas Caparas,0,1,36,36
1657030349434,MATH 20C,B01,083762,Bach; Quang Tran,0,0,30,30
1657030355461,MATH 20D,A01,083765,Tran; Brian Kha,4,0,30,26
1657030355461,MATH 20D,A02,083766,Tran; Brian Kha,5,0,30,25
1657030355461,MATH 20D,A03,083767,Tran; Brian Kha,3,0,30,27
1657030361486,MATH 20E,A01,083771,Ganguly; Soumya,5,0,32,27
1657030361486,MATH 20E,A02,083772,Ganguly; Soumya,6,0,32,26
1657030361486,MATH 20E,B01,083773,Ciotti; Benjamin,18,0,35,17
1657030361486,MATH 20E,B02,083774,Ciotti; Benjamin,17,0,35,18
1657030367512,MATH 103A,A01,083777,Greenfeld; Be'Eri,2,0,36,34
1657030367512,MATH 103A,A02,083778,Greenfeld; Be'Eri,5,0,36,31
1657030367512,MATH 103A,A03,093561,Greenfeld; Be'Eri,4,0,36,32
1657030367512,MATH 103A,B01,083779,Greenfeld; Be'Eri,6,0,36,30
1657030367512,MATH 103A,B02,083780,Greenfeld; Be'Eri,2,0,36,34
1657030367512,MATH 103A,B03,093562,Greenfeld; Be'Eri,2,0,36,34
1657030373542,MATH 105,A01,085443,Carter; Anne Toulson,14,0,35,21
1657030373542,MATH 105,A02,093477,Carter; Anne Toulson,20,0,35,15
1657030379572,MATH 109,A01,083213,Ganzberger; Geoffrey Michael,2,0,34,32
1657030379572,MATH 109,A02,083214,Ganzberger; Geoffrey Michael,2,0,34,32
1657030379572,MATH 109,A03,093478,Ganzberger; Geoffrey Michael,1,0,34,33
1657030379572,MATH 109,B01,083215,Ganzberger; Geoffrey Michael,1,0,32,31
1657030379572,MATH 109,B02,083216,Ganzberger; Geoffrey Michael,1,0,32,31
1657030379572,MATH 109,B03,093479,Ganzberger; Geoffrey Michael,6,0,32,26
1657030385600,MATH 142A,A01,083219,Chow; Bennett,6,0,32,26
1657030385600,MATH 142A,A02,083220,Chow; Bennett,10,0,32,22
1657030385600,MATH 142A,A03,093480,Chow; Bennett,7,0,32,25
1657030385600,MATH 142A,B03,093481,Chow; Bennett,7,0,32,25
1657030385600,MATH 142A,B04,093558,Chow; Bennett,11,0,32,21
1657030385600,MATH 142A,B05,093559,Chow; Bennett,6,0,32,26
1657030391625,MATH 193A,A01,083224,Rotar; Vladimir,7,0,34,27
1657030391625,MATH 193A,A02,083225,Rotar; Vladimir,4,0,34,30
1657030391625,MATH 193A,A03,083781,Rotar; Vladimir,1,0,34,33
1657030391625,MATH 193A,A04,083782,Rotar; Vladimir,6,0,34,28
1657030391625,MATH 193A,A05,093482,Rotar; Vladimir,6,0,34,28
1657030397647,MATH 197,001,091859,McAuley; Julian John,9999,0,9999,0
1657030397647,MATH 197,002,095566,Kedlaya; Kiran S.,9997,0,9999,2
1657030397647,MATH 197,003,095567,Xiao; Ming,9999,0,9999,0
1657030397647,MATH 197,004,095571,Perols; Johan Lars,9998,0,9999,1
1657030404728,COGS 9,A01,083615,Shannon; Kyle Michael,7,0,75,68
1657030410757,COGS 11,A01,083617,Boyle; Mary E. T.,20,0,48,28
1657030416780,COGS 13,A01,083071,Bastos; Amalia Pinkusfeld,9,0,71,62
1657030422804,COGS 14A,A01,092681,Semenuks; Arturs,0,1,100,100
1657030428832,COGS 14B,A01,083073,Cheng; Tzu-Han,5,0,63,58
1657030434857,COGS 17,A01,092677,Semenuks; Arturs,4,0,81,77
1657030440888,COGS 100,A01,083619,Allen; Michael Gordon,15,0,70,55
1657030446915,COGS 101A,A01,083621,Davis; Joshua Daniel,9,0,68,59
1657030452939,COGS 101B,A01,091572,Allen; Michael Gordon,8,0,65,57
1657030458967,COGS 101C,A01,083625,Delgado; Tania,17,0,35,18
1657030464995,COGS 107A,A01,083627,Boyle; Mary E. T.,13,0,60,47
1657030471027,COGS 118A,A01,083075,Gupta; Anjum,15,0,76,61
1657030477057,CSE 3,A50,083646,Miranda; Gregory Joseph,22,0,50,28
1657030483083,CSE 8A,A50,083650,Miranda; Gregory Joseph,17,1,56,39
1657030489106,CSE 11,A01,083080,Cao; Yingjun,4,15,40,36
1657030495131,CSE 12,A01,083652,Krause-Levy; Sophia Louisa,21,1,120,99
1657030501157,CSE 15L,A01,083654,Morris; Justin Loren,8,0,50,42
1657030501157,CSE 15L,A02,083655,Morris; Justin Loren,9,0,50,41
1657030507180,CSE 20,A01,083657,Tran; Khoa Dang,37,0,80,43
1657030513212,CSE 21,A01,095574,Bach; Quang Tran,21,0,48,27
1657030519241,CSE 30,A01,083084,Eldon; John,4,0,80,76
1657030519241,CSE 30,B01,095061,Bhaskar; Nishant,6,0,50,44
1657030525263,CSE 100,A01,083659,Cao; Yingjun,3,4,70,67
1657030531291,CSE 134B,A01,083661,Powell; Thomas Allan,19,0,100,81
1657030537321,CSE 140,A01,083663,Gungor; Onat,14,0,85,71
1657030543356,CSE 140L,A01,083088,Eldon; John,16,0,100,84
1657030549384,CSE 175,A01,083665,Kumar; Rakesh,3,0,25,22
1657030555408,CSE 190,A00,092507,Dubnov; Shlomo,7,0,20,13
1657030561432,ECE 45,A01,083139,Congero; Spencer William,5,0,75,70
1657030567457,ECE 65,A50,083695,Saad; Andrew S,12,0,30,18
1657030567457,ECE 65,A51,095125,Saad; Andrew S,25,0,26,1
1657030573488,ECE 109,A01,091882,Touri; Behrouz,16,0,70,54
1657030579520,ECE 180,A00,083140,Abi Samra; Nicholas Camill,1,0,30,29
1657030579520,ECE 180,B00,083141,Abi Samra; Nicholas Camill,0,0,30,30
1657030585546,MATH 10A,A01,083735,Patchell; Gregory David,1,0,30,29
1657030585546,MATH 10A,A02,083736,Patchell; Gregory David,20,0,30,10
1657030585546,MATH 10A,A03,083737,Patchell; Gregory David,16,0,30,14
1657030591568,MATH 10B,A01,083207,Lim; Seonhee,7,0,34,27
1657030591568,MATH 10B,A02,083208,Lim; Seonhee,9,0,35,26
1657030591568,MATH 10B,A03,093472,Lim; Seonhee,4,0,34,30
1657030591568,MATH 10B,B01,083739,Sinha; Shubham,9,0,30,21
1657030597593,MATH 18,A01,083743,Cinel; Cameron Alexander,6,0,30,24
1657030597593,MATH 18,A02,083744,Cinel; Cameron Alexander,15,0,30,15
1657030597593,MATH 18,A03,083745,Cinel; Cameron Alexander,8,0,30,22
1657030597593,MATH 18,B01,083748,Rideout; David Porter,4,0,37,33
1657030597593,MATH 18,B02,083749,Rideout; David Porter,3,0,36,33
1657030597593,MATH 18,B03,083750,Rideout; David Porter,2,0,37,35
1657030597593,MATH 18,B04,083751,Rideout; David Porter,5,0,36,31
1657030597593,MATH 18,B05,093473,Rideout; David Porter,4,0,36,32
1657030597593,MATH 18,B06,093474,Rideout; David Porter,5,0,36,31
1657030603617,MATH 20A,A01,083754,Zheng; Zequn,12,0,40,28
1657030609641,MATH 20B,A01,083756,Briones; Jor-el Thomas Caparas,1,0,36,35
1657030609641,MATH 20B,A02,083757,Briones; Jor-el Thomas Caparas,1,0,36,35
1657030609641,MATH 20B,A03,093475,Briones; Jor-el Thomas Caparas,0,0,36,36
1657030615668,MATH 20C,A01,083760,Briones; Jor-el Thomas Caparas,1,0,35,34
1657030615668,MATH 20C,A02,083761,Briones; Jor-el Thomas Caparas,8,0,35,27
1657030615668,MATH 20C,A03,093476,Briones; Jor-el Thomas Caparas,0,1,36,36
1657030615668,MATH 20C,B01,083762,Bach; Quang Tran,0,0,30,30
1657030621691,MATH 20D,A01,083765,Tran; Brian Kha,4,0,30,26
1657030621691,MATH 20D,A02,083766,Tran; Brian Kha,5,0,30,25
1657030621691,MATH 20D,A03,083767,Tran; Brian Kha,3,0,30,27
1657030627722,MATH 20E,A01,083771,Ganguly; Soumya,5,0,32,27
1657030627722,MATH 20E,A02,083772,Ganguly; Soumya,6,0,32,26
1657030627722,MATH 20E,B01,083773,Ciotti; Benjamin,18,0,35,17
1657030627722,MATH 20E,B02,083774,Ciotti; Benjamin,17,0,35,18
1657030633748,MATH 103A,A01,083777,Greenfeld; Be'Eri,2,0,36,34
1657030633748,MATH 103A,A02,083778,Greenfeld; Be'Eri,5,0,36,31
1657030633748,MATH 103A,A03,093561,Greenfeld; Be'Eri,4,0,36,32
1657030633748,MATH 103A,B01,083779,Greenfeld; Be'Eri,6,0,36,30
1657030633748,MATH 103A,B02,083780,Greenfeld; Be'Eri,2,0,36,34
1657030633748,MATH 103A,B03,093562,Greenfeld; Be'Eri,2,0,36,34
1657030639777,MATH 105,A01,085443,Carter; Anne Toulson,14,0,35,21
1657030639777,MATH 105,A02,093477,Carter; Anne Toulson,20,0,35,15
1657030645804,MATH 109,A01,083213,Ganzberger; Geoffrey Michael,2,0,34,32
1657030645804,MATH 109,A02,083214,Ganzberger; Geoffrey Michael,2,0,34,32
1657030645804,MATH 109,A03,093478,Ganzberger; Geoffrey Michael,1,0,34,33
1657030645804,MATH 109,B01,083215,Ganzberger; Geoffrey Michael,1,0,32,31
1657030645804,MATH 109,B02,083216,Ganzberger; Geoffrey Michael,1,0,32,31
1657030645804,MATH 109,B03,093479,Ganzberger; Geoffrey Michael,6,0,32,26
1657030651835,MATH 142A,A01,083219,Chow; Bennett,6,0,32,26
1657030651835,MATH 142A,A02,083220,Chow; Bennett,10,0,32,22
1657030651835,MATH 142A,A03,093480,Chow; Bennett,7,0,32,25
1657030651835,MATH 142A,B03,093481,Chow; Bennett,7,0,32,25
1657030651835,MATH 142A,B04,093558,Chow; Bennett,11,0,32,21
1657030651835,MATH 142A,B05,093559,Chow; Bennett,6,0,32,26
1657030657887,MATH 193A,A01,083224,Rotar; Vladimir,7,0,34,27
1657030657887,MATH 193A,A02,083225,Rotar; Vladimir,4,0,34,30
1657030657887,MATH 193A,A03,083781,Rotar; Vladimir,1,0,34,33
1657030657887,MATH 193A,A04,083782,Rotar; Vladimir,6,0,34,28
1657030657887,MATH 193A,A05,093482,Rotar; Vladimir,6,0,34,28
1657030663911,MATH 197,001,091859,McAuley; Julian John,9999,0,9999,0
1657030663911,MATH 197,002,095566,Kedlaya; Kiran S.,9997,0,9999,2
1657030663911,MATH 197,003,095567,Xiao; Ming,9999,0,9999,0
1657030663911,MATH 197,004,095571,Perols; Johan Lars,9998,0,9999,1
1657030670992,COGS 9,A01,083615,Shannon; Kyle Michael,7,0,75,68
1657030677031,COGS 11,A01,083617,Boyle; Mary E. T.,20,0,48,28
1657030683066,COGS 13,A01,083071,Bastos; Amalia Pinkusfeld,9,0,71,62
1657030689165,COGS 14A,A01,092681,Semenuks; Arturs,0,1,100,100
1657030695193,COGS 14B,A01,083073,Cheng; Tzu-Han,5,0,63,58
1657030701225,COGS 17,A01,092677,Semenuks; Arturs,4,0,81,77
1657030707253,COGS 100,A01,083619,Allen; Michael Gordon,15,0,70,55
1657030713276,COGS 101A,A01,083621,Davis; Joshua Daniel,9,0,68,59
1657030719302,COGS 101B,A01,091572,Allen; Michael Gordon,8,0,65,57
1657030725328,COGS 101C,A01,083625,Delgado; Tania,17,0,35,18
1657030731355,COGS 107A,A01,083627,Boyle; Mary E. T.,13,0,60,47
1657030737384,COGS 118A,A01,083075,Gupta; Anjum,15,0,76,61
1657030743440,CSE 3,A50,083646,Miranda; Gregory Joseph,22,0,50,28
1657030749465,CSE 8A,A50,083650,Miranda; Gregory Joseph,17,1,56,39
1657030755498,CSE 11,A01,083080,Cao; Yingjun,4,15,40,36
1657030761532,CSE 12,A01,083652,Krause-Levy; Sophia Louisa,21,1,120,99
1657030767557,CSE 15L,A01,083654,Morris; Justin Loren,8,0,50,42
1657030767557,CSE 15L,A02,083655,Morris; Justin Loren,9,0,50,41
1657030773586,CSE 20,A01,083657,Tran; Khoa Dang,37,0,80,43
1657030779611,CSE 21,A01,095574,Bach; Quang Tran,21,0,48,27
1657030785636,CSE 30,A01,083084,Eldon; John,4,0,80,76
1657030785636,CSE 30,B01,095061,Bhaskar; Nishant,6,0,50,44
1657030791664,CSE 100,A01,083659,Cao; Yingjun,3,4,70,67
1657030797690,CSE 134B,A01,083661,Powell; Thomas Allan,19,0,100,81
1657030803718,CSE 140,A01,083663,Gungor; Onat,14,0,85,71
1657030809745,CSE 140L,A01,083088,Eldon; John,16,0,100,84
1657030815771,CSE 175,A01,083665,Kumar; Rakesh,3,0,25,22
1657030821800,CSE 190,A00,092507,Dubnov; Shlomo,7,0,20,13
1657030827826,ECE 45,A01,083139,Congero; Spencer William,5,0,75,70
1657030833854,ECE 65,A50,083695,Saad; Andrew S,12,0,30,18
1657030833854,ECE 65,A51,095125,Saad; Andrew S,25,0,26,1
1657030839877,ECE 109,A01,091882,Touri; Behrouz,16,0,70,54
1657030845905,ECE 180,A00,083140,Abi Samra; Nicholas Camill,1,0,30,29
1657030845905,ECE 180,B00,083141,Abi Samra; Nicholas Camill,0,0,30,30
1657030852017,MATH 10A,A01,083735,Patchell; Gregory David,1,0,30,29
1657030852017,MATH 10A,A02,083736,Patchell; Gregory David,20,0,30,10
1657030852017,MATH 10A,A03,083737,Patchell; Gregory David,16,0,30,14
1657030858058,MATH 10B,A01,083207,Lim; Seonhee,7,0,34,27
1657030858058,MATH 10B,A02,083208,Lim; Seonhee,9,0,35,26
1657030858058,MATH 10B,A03,093472,Lim; Seonhee,4,0,34,30
1657030858058,MATH 10B,B01,083739,Sinha; Shubham,9,0,30,21
1657030864084,MATH 18,A01,083743,Cinel; Cameron Alexander,6,0,30,24
1657030864084,MATH 18,A02,083744,Cinel; Cameron Alexander,15,0,30,15
1657030864084,MATH 18,A03,083745,Cinel; Cameron Alexander,8,0,30,22
1657030864084,MATH 18,B01,083748,Rideout; David Porter,4,0,37,33
1657030864084,MATH 18,B02,083749,Rideout; David Porter,3,0,36,33
1657030864084,MATH 18,B03,083750,Rideout; David Porter,2,0,37,35
1657030864084,MATH 18,B04,083751,Rideout; David Porter,5,0,36,31
1657030864084,MATH 18,B05,093473,Rideout; David Porter,4,0,36,32
1657030864084,MATH 18,B06,093474,Rideout; David Porter,5,0,36,31
1657030870113,MATH 20A,A01,083754,Zheng; Zequn,12,0,40,28
1657030876138,MATH 20B,A01,083756,Briones; Jor-el Thomas Caparas,1,0,36,35
1657030876138,MATH 20B,A02,083757,Briones; Jor-el Thomas Caparas,1,0,36,35
1657030876138,MATH 20B,A03,093475,Briones; Jor-el Thomas Caparas,0,0,36,36
1657030882166,MATH 20C,A01,083760,Briones; Jor-el Thomas Caparas,1,0,35,34
1657030882166,MATH 20C,A02,083761,Briones; Jor-el Thomas Caparas,8,0,35,27
1657030882166,MATH 20C,A03,093476,Briones; Jor-el Thomas Caparas,0,1,36,36
1657030882166,MATH 20C,B01,083762,Bach; Quang Tran,0,0,30,30
1657030888190,MATH 20D,A01,083765,Tran; Brian Kha,4,0,30,26
1657030888190,MATH 20D,A02,083766,Tran; Brian Kha,5,0,30,25
1657030888190,MATH 20D,A03,083767,Tran; Brian Kha,3,0,30,27
1657030894216,MATH 20E,A01,083771,Ganguly; Soumya,5,0,32,27
1657030894216,MATH 20E,A02,083772,Ganguly; Soumya,6,0,32,26
1657030894216,MATH 20E,B01,083773,Ciotti; Benjamin,18,0,35,17
1657030894216,MATH 20E,B02,083774,Ciotti; Benjamin,17,0,35,18
1657030900250,MATH 103A,A01,083777,Greenfeld; Be'Eri,2,0,36,34
1657030900250,MATH 103A,A02,083778,Greenfeld; Be'Eri,5,0,36,31
1657030900250,MATH 103A,A03,093561,Greenfeld; Be'Eri,4,0,36,32
1657030900250,MATH 103A,B01,083779,Greenfeld; Be'Eri,6,0,36,30
1657030900250,MATH 103A,B02,083780,Greenfeld; Be'Eri,2,0,36,34
1657030900250,MATH 103A,B03,093562,Greenfeld; Be'Eri,2,0,36,34
1657030906275,MATH 105,A01,085443,Carter; Anne Toulson,14,0,35,21
1657030906275,MATH 105,A02,093477,Carter; Anne Toulson,20,0,35,15
1657030912306,MATH 109,A01,083213,Ganzberger; Geoffrey Michael,2,0,34,32
1657030912306,MATH 109,A02,083214,Ganzberger; Geoffrey Michael,2,0,34,32
1657030912306,MATH 109,A03,093478,Ganzberger; Geoffrey Michael,1,0,34,33
1657030912306,MATH 109,B01,083215,Ganzberger; Geoffrey Michael,1,0,32,31
1657030912306,MATH 109,B02,083216,Ganzberger; Geoffrey Michael,1,0,32,31
1657030912306,MATH 109,B03,093479,Ganzberger; Geoffrey Michael,6,0,32,26
1657030918331,MATH 142A,A01,083219,Chow; Bennett,6,0,32,26
1657030918331,MATH 142A,A02,083220,Chow; Bennett,10,0,32,22
1657030918331,MATH 142A,A03,093480,Chow; Bennett,7,0,32,25
1657030918331,MATH 142A,B03,093481,Chow; Bennett,7,0,32,25
1657030918331,MATH 142A,B04,093558,Chow; Bennett,11,0,32,21
1657030918331,MATH 142A,B05,093559,Chow; Bennett,6,0,32,26
1657030924360,MATH 193A,A01,083224,Rotar; Vladimir,7,0,34,27
1657030924360,MATH 193A,A02,083225,Rotar; Vladimir,4,0,34,30
1657030924360,MATH 193A,A03,083781,Rotar; Vladimir,1,0,34,33
1657030924360,MATH 193A,A04,083782,Rotar; Vladimir,6,0,34,28
1657030924360,MATH 193A,A05,093482,Rotar; Vladimir,6,0,34,28
1657030930400,MATH 197,001,091859,McAuley; Julian John,9999,0,9999,0
1657030930400,MATH 197,002,095566,Kedlaya; Kiran S.,9997,0,9999,2
1657030930400,MATH 197,003,095567,Xiao; Ming,9999,0,9999,0
1657030930400,MATH 197,004,095571,Perols; Johan Lars,9998,0,9999,1
1657030937459,COGS 9,A01,083615,Shannon; Kyle Michael,7,0,75,68
1657030943484,COGS 11,A01,083617,Boyle; Mary E. T.,20,0,48,28
1657030949508,COGS 13,A01,083071,Bastos; Amalia Pinkusfeld,9,0,71,62
1657030955533,COGS 14A,A01,092681,Semenuks; Arturs,0,1,100,100
1657030961558,COGS 14B,A01,083073,Cheng; Tzu-Han,5,0,63,58
1657030967585,COGS 17,A01,092677,Semenuks; Arturs,4,0,81,77
1657030973614,COGS 100,A01,083619,Allen; Michael Gordon,15,0,70,55
1657030979640,COGS 101A,A01,083621,Davis; Joshua Daniel,9,0,68,59
1657030985668,COGS 101B,A01,091572,Allen; Michael Gordon,8,0,65,57
1657030991700,COGS 101C,A01,083625,Delgado; Tania,17,0,35,18
1657030997723,COGS 107A,A01,083627,Boyle; Mary E. T.,13,0,60,47
1657031003748,COGS 118A,A01,083075,Gupta; Anjum,15,0,76,61
1657031009777,CSE 3,A50,083646,Miranda; Gregory Joseph,22,0,50,28
1657031015806,CSE 8A,A50,083650,Miranda; Gregory Joseph,17,1,56,39
1657031021830,CSE 11,A01,083080,Cao; Yingjun,4,15,40,36
1657031027860,CSE 12,A01,083652,Krause-Levy; Sophia Louisa,21,1,120,99
1657031033885,CSE 15L,A01,083654,Morris; Justin Loren,8,0,50,42
1657031033885,CSE 15L,A02,083655,Morris; Justin Loren,9,0,50,41
1657031039914,CSE 20,A01,083657,Tran; Khoa Dang,37,0,80,43
1657031045943,CSE 21,A01,095574,Bach; Quang Tran,21,0,48,27
1657031051972,CSE 30,A01,083084,Eldon; John,4,0,80,76
1657031051972,CSE 30,B01,095061,Bhaskar; Nishant,6,0,50,44
1657031057997,CSE 100,A01,083659,Cao; Yingjun,3,4,70,67
1657031064025,CSE 134B,A01,083661,Powell; Thomas Allan,19,0,100,81
1657031070050,CSE 140,A01,083663,Gungor; Onat,14,0,85,71
1657031076084,CSE 140L,A01,083088,Eldon; John,16,0,100,84
1657031082111,CSE 175,A01,083665,Kumar; Rakesh,3,0,25,22
1657031088136,CSE 190,A00,092507,Dubnov; Shlomo,7,0,20,13
1657031094178,ECE 45,A01,083139,Congero; Spencer William,5,0,75,70
1657031100206,ECE 65,A50,083695,Saad; Andrew S,12,0,30,18
1657031100206,ECE 65,A51,095125,Saad; Andrew S,25,0,26,1
1657031106230,ECE 109,A01,091882,Touri; Behrouz,16,0,70,54
1657031112261,ECE 180,A00,083140,Abi Samra; Nicholas Camill,1,0,30,29
1657031112261,ECE 180,B00,083141,Abi Samra; Nicholas Camill,0,0,30,30
1657031118286,MATH 10A,A01,083735,Patchell; Gregory David,1,0,30,29
1657031118286,MATH 10A,A02,083736,Patchell; Gregory David,20,0,30,10
1657031118286,MATH 10A,A03,083737,Patchell; Gregory David,16,0,30,14
1657031124311,MATH 10B,A01,083207,Lim; Seonhee,7,0,34,27
1657031124311,MATH 10B,A02,083208,Lim; Seonhee,9,0,35,26
1657031124311,MATH 10B,A03,093472,Lim; Seonhee,4,0,34,30
1657031124311,MATH 10B,B01,083739,Sinha; Shubham,9,0,30,21
1657031130343,MATH 18,A01,083743,Cinel; Cameron Alexander,6,0,30,24
1657031130343,MATH 18,A02,083744,Cinel; Cameron Alexander,15,0,30,15
1657031130343,MATH 18,A03,083745,Cinel; Cameron Alexander,8,0,30,22
1657031130343,MATH 18,B01,083748,Rideout; David Porter,4,0,37,33
1657031130343,MATH 18,B02,083749,Rideout; David Porter,3,0,36,33
1657031130343,MATH 18,B03,083750,Rideout; David Porter,2,0,37,35
1657031130343,MATH 18,B04,083751,Rideout; David Porter,5,0,36,31
1657031130343,MATH 18,B05,093473,Rideout; David Porter,4,0,36,32
1657031130343,MATH 18,B06,093474,Rideout; David Porter,5,0,36,31
1657031136369,MATH 20A,A01,083754,Zheng; Zequn,12,0,40,28
1657031142396,MATH 20B,A01,083756,Briones; Jor-el Thomas Caparas,1,0,36,35
1657031142396,MATH 20B,A02,083757,Briones; Jor-el Thomas Caparas,1,0,36,35
1657031142396,MATH 20B,A03,093475,Briones; Jor-el Thomas Caparas,0,0,36,36
1657031148423,MATH 20C,A01,083760,Briones; Jor-el Thomas Caparas,1,0,35,34
1657031148423,MATH 20C,A02,083761,Briones; Jor-el Thomas Caparas,8,0,35,27
1657031148423,MATH 20C,A03,093476,Briones; Jor-el Thomas Caparas,0,1,36,36
1657031148423,MATH 20C,B01,083762,Bach; Quang Tran,0,0,30,30
1657031154451,MATH 20D,A01,083765,Tran; Brian Kha,4,0,30,26
1657031154451,MATH 20D,A02,083766,Tran; Brian Kha,5,0,30,25
1657031154451,MATH 20D,A03,083767,Tran; Brian Kha,3,0,30,27
1657031160486,MATH 20E,A01,083771,Ganguly; Soumya,5,0,32,27
1657031160486,MATH 20E,A02,083772,Ganguly; Soumya,6,0,32,26
1657031160486,MATH 20E,B01,083773,Ciotti; Benjamin,18,0,35,17
1657031160486,MATH 20E,B02,083774,Ciotti; Benjamin,17,0,35,18
1657031166523,MATH 103A,A01,083777,Greenfeld; Be'Eri,2,0,36,34
1657031166523,MATH 103A,A02,083778,Greenfeld; Be'Eri,5,0,36,31
1657031166523,MATH 103A,A03,093561,Greenfeld; Be'Eri,4,0,36,32
1657031166523,MATH 103A,B01,083779,Greenfeld; Be'Eri,6,0,36,30
1657031166523,MATH 103A,B02,083780,Greenfeld; Be'Eri,2,0,36,34
1657031166523,MATH 103A,B03,093562,Greenfeld; Be'Eri,2,0,36,34
1657031172548,MATH 105,A01,085443,Carter; Anne Toulson,14,0,35,21
1657031172548,MATH 105,A02,093477,Carter; Anne Toulson,20,0,35,15
1657031178574,MATH 109,A01,083213,Ganzberger; Geoffrey Michael,2,0,34,32
1657031178574,MATH 109,A02,083214,Ganzberger; Geoffrey Michael,2,0,34,32
1657031178574,MATH 109,A03,093478,Ganzberger; Geoffrey Michael,1,0,34,33
1657031178574,MATH 109,B01,083215,Ganzberger; Geoffrey Michael,1,0,32,31
1657031178574,MATH 109,B02,083216,Ganzberger; Geoffrey Michael,1,0,32,31
1657031178574,MATH 109,B03,093479,Ganzberger; Geoffrey Michael,6,0,32,26
1657031184599,MATH 142A,A01,083219,Chow; Bennett,6,0,32,26
1657031184599,MATH 142A,A02,083220,Chow; Bennett,10,0,32,22
1657031184599,MATH 142A,A03,093480,Chow; Bennett,7,0,32,25
1657031184599,MATH 142A,B03,093481,Chow; Bennett,7,0,32,25
1657031184599,MATH 142A,B04,093558,Chow; Bennett,11,0,32,21
1657031184599,MATH 142A,B05,093559,Chow; Bennett,6,0,32,26
1657031190624,MATH 193A,A01,083224,Rotar; Vladimir,7,0,34,27
1657031190624,MATH 193A,A02,083225,Rotar; Vladimir,4,0,34,30
1657031190624,MATH 193A,A03,083781,Rotar; Vladimir,1,0,34,33
1657031190624,MATH 193A,A04,083782,Rotar; Vladimir,6,0,34,28
1657031190624,MATH 193A,A05,093482,Rotar; Vladimir,6,0,34,28
1657031196683,MATH 197,001,091859,McAuley; Julian John,9999,0,9999,0
1657031196683,MATH 197,002,095566,Kedlaya; Kiran S.,9997,0,9999,2
1657031196683,MATH 197,003,095567,Xiao; Ming,9999,0,9999,0
1657031196683,MATH 197,004,095571,Perols; Johan Lars,9998,0,9999,1
1657031203737,COGS 9,A01,083615,Shannon; Kyle Michael,7,0,75,68
1657031209763,COGS 11,A01,083617,Boyle; Mary E. T.,20,0,48,28
1657031215786,COGS 13,A01,083071,Bastos; Amalia Pinkusfeld,9,0,71,62
1657031221821,COGS 14A,A01,092681,Semenuks; Arturs,0,1,100,100
1657031227844,COGS 14B,A01,083073,Cheng; Tzu-Han,5,0,63,58
1657031233868,COGS 17,A01,092677,Semenuks; Arturs,4,0,81,77
1657031239894,COGS 100,A01,083619,Allen; Michael Gordon,15,0,70,55
1657031245921,COGS 101A,A01,083621,Davis; Joshua Daniel,9,0,68,59
1657031251949,COGS 101B,A01,091572,Allen; Michael Gordon,8,0,65,57
1657031257977,COGS 101C,A01,083625,Delgado; Tania,17,0,35,18
1657031264002,COGS 107A,A01,083627,Boyle; Mary E. T.,13,0,60,47
1657031271603,COGS 118A,A01,083075,Gupta; Anjum,15,0,76,61
1657031277632,CSE 3,A50,083646,Miranda; Gregory Joseph,22,0,50,28
1657031283657,CSE 8A,A50,083650,Miranda; Gregory Joseph,17,1,56,39
1657031289782,CSE 11,A01,083080,Cao; Yingjun,4,15,40,36
1657031295810,CSE 12,A01,083652,Krause-Levy; Sophia Louisa,21,1,120,99
1657031301838,CSE 15L,A01,083654,Morris; Justin Loren,8,0,50,42
1657031301838,CSE 15L,A02,083655,Morris; Justin Loren,9,0,50,41
1657031307862,CSE 20,A01,083657,Tran; Khoa Dang,37,0,80,43
1657031313891,CSE 21,A01,095574,Bach; Quang Tran,21,0,48,27
1657031319919,CSE 30,A01,083084,Eldon; John,4,0,80,76
1657031319919,CSE 30,B01,095061,Bhaskar; Nishant,6,0,50,44
1657031325953,CSE 100,A01,083659,Cao; Yingjun,3,4,70,67
1657031332011,CSE 134B,A01,083661,Powell; Thomas Allan,19,0,100,81
1657031338037,CSE 140,A01,083663,Gungor; Onat,14,0,85,71
1657031344062,CSE 140L,A01,083088,Eldon; John,16,0,100,84
1657031350088,CSE 175,A01,083665,Kumar; Rakesh,3,0,25,22
1657031356114,CSE 190,A00,092507,Dubnov; Shlomo,7,0,20,13
1657031362143,ECE 45,A01,083139,Congero; Spencer William,5,0,75,70
1657031368174,ECE 65,A50,083695,Saad; Andrew S,12,0,30,18
1657031368174,ECE 65,A51,095125,Saad; Andrew S,25,0,26,1
1657031374201,ECE 109,A01,091882,Touri; Behrouz,16,0,70,54
1657031380225,ECE 180,A00,083140,Abi Samra; Nicholas Camill,1,0,30,29
1657031380225,ECE 180,B00,083141,Abi Samra; Nicholas Camill,0,0,30,30
1657031386255,MATH 10A,A01,083735,Patchell; Gregory David,1,0,30,29
1657031386255,MATH 10A,A02,083736,Patchell; Gregory David,20,0,30,10
1657031386255,MATH 10A,A03,083737,Patchell; Gregory David,16,0,30,14
1657031392299,MATH 10B,A01,083207,Lim; Seonhee,7,0,34,27
1657031392299,MATH 10B,A02,083208,Lim; Seonhee,9,0,35,26
1657031392299,MATH 10B,A03,093472,Lim; Seonhee,4,0,34,30
1657031392299,MATH 10B,B01,083739,Sinha; Shubham,9,0,30,21
1657031398325,MATH 18,A01,083743,Cinel; Cameron Alexander,6,0,30,24
1657031398325,MATH 18,A02,083744,Cinel; Cameron Alexander,15,0,30,15
1657031398325,MATH 18,A03,083745,Cinel; Cameron Alexander,8,0,30,22
1657031398325,MATH 18,B01,083748,Rideout; David Porter,4,0,37,33
1657031398325,MATH 18,B02,083749,Rideout; David Porter,3,0,36,33
1657031398325,MATH 18,B03,083750,Rideout; David Porter,2,0,37,35
1657031398325,MATH 18,B04,083751,Rideout; David Porter,5,0,36,31
1657031398325,MATH 18,B05,093473,Rideout; David Porter,4,0,36,32
1657031398325,MATH 18,B06,093474,Rideout; David Porter,5,0,36,31
1657031404356,MATH 20A,A01,083754,Zheng; Zequn,12,0,40,28
1657031410385,MATH 20B,A01,083756,Briones; Jor-el Thomas Caparas,1,0,36,35
1657031410385,MATH 20B,A02,083757,Briones; Jor-el Thomas Caparas,1,0,36,35
1657031410385,MATH 20B,A03,093475,Briones; Jor-el Thomas Caparas,0,0,36,36
1657031416415,MATH 20C,A01,083760,Briones; Jor-el Thomas Caparas,1,0,35,34
1657031416415,MATH 20C,A02,083761,Briones; Jor-el Thomas Caparas,8,0,35,27
1657031416415,MATH 20C,A03,093476,Briones; Jor-el Thomas Caparas,0,1,36,36
1657031416415,MATH 20C,B01,083762,Bach; Quang Tran,0,0,30,30
1657031422439,MATH 20D,A01,083765,Tran; Brian Kha,4,0,30,26
1657031422439,MATH 20D,A02,083766,Tran; Brian Kha,5,0,30,25
1657031422439,MATH 20D,A03,083767,Tran; Brian Kha,3,0,30,27
1657031428464,MATH 20E,A01,083771,Ganguly; Soumya,5,0,32,27
1657031428464,MATH 20E,A02,083772,Ganguly; Soumya,6,0,32,26
1657031428464,MATH 20E,B01,083773,Ciotti; Benjamin,18,0,35,17
1657031428464,MATH 20E,B02,083774,Ciotti; Benjamin,17,0,35,18
1657031434486,MATH 103A,A01,083777,Greenfeld; Be'Eri,2,0,36,34
1657031434486,MATH 103A,A02,083778,Greenfeld; Be'Eri,5,0,36,31
1657031434486,MATH 103A,A03,093561,Greenfeld; Be'Eri,4,0,36,32
1657031434486,MATH 103A,B01,083779,Greenfeld; Be'Eri,6,0,36,30
1657031434486,MATH 103A,B02,083780,Greenfeld; Be'Eri,2,0,36,34
1657031434486,MATH 103A,B03,093562,Greenfeld; Be'Eri,2,0,36,34
1657031440510,MATH 105,A01,085443,Carter; Anne Toulson,14,0,35,21
1657031440510,MATH 105,A02,093477,Carter; Anne Toulson,20,0,35,15
1657031446546,MATH 109,A01,083213,Ganzberger; Geoffrey Michael,2,0,34,32
1657031446546,MATH 109,A02,083214,Ganzberger; Geoffrey Michael,2,0,34,32
1657031446546,MATH 109,A03,093478,Ganzberger; Geoffrey Michael,1,0,34,33
1657031446546,MATH 109,B01,083215,Ganzberger; Geoffrey Michael,1,0,32,31
1657031446546,MATH 109,B02,083216,Ganzberger; Geoffrey Michael,1,0,32,31
1657031446546,MATH 109,B03,093479,Ganzberger; Geoffrey Michael,6,0,32,26
1657031452572,MATH 142A,A01,083219,Chow; Bennett,6,0,32,26
1657031452572,MATH 142A,A02,083220,Chow; Bennett,10,0,32,22
1657031452572,MATH 142A,A03,093480,Chow; Bennett,7,0,32,25
1657031452572,MATH 142A,B03,093481,Chow; Bennett,7,0,32,25
1657031452572,MATH 142A,B04,093558,Chow; Bennett,11,0,32,21
1657031452572,MATH 142A,B05,093559,Chow; Bennett,6,0,32,26
1657031458606,MATH 193A,A01,083224,Rotar; Vladimir,7,0,34,27
1657031458606,MATH 193A,A02,083225,Rotar; Vladimir,4,0,34,30
1657031458606,MATH 193A,A03,083781,Rotar; Vladimir,1,0,34,33
1657031458606,MATH 193A,A04,083782,Rotar; Vladimir,6,0,34,28
1657031458606,MATH 193A,A05,093482,Rotar; Vladimir,6,0,34,28
1657031464641,MATH 197,001,091859,McAuley; Julian John,9999,0,9999,0
1657031464641,MATH 197,002,095566,Kedlaya; Kiran S.,9997,0,9999,2
1657031464641,MATH 197,003,095567,Xiao; Ming,9999,0,9999,0
1657031464641,MATH 197,004,095571,Perols; Johan Lars,9998,0,9999,1
1657031471716,COGS 9,A01,083615,Shannon; Kyle Michael,7,0,75,68
1657031477743,COGS 11,A01,083617,Boyle; Mary E. T.,20,0,48,28
1657031483769,COGS 13,A01,083071,Bastos; Amalia Pinkusfeld,9,0,71,62
1657031489793,COGS 14A,A01,092681,Semenuks; Arturs,0,1,100,100
1657031495821,COGS 14B,A01,083073,Cheng; Tzu-Han,5,0,63,58
1657031501849,COGS 17,A01,092677,Semenuks; Arturs,4,0,81,77
1657031507874,COGS 100,A01,083619,Allen; Michael Gordon,15,0,70,55
1657031513906,COGS 101A,A01,083621,Davis; Joshua Daniel,9,0,68,59
1657031519936,COGS 101B,A01,091572,Allen; Michael Gordon,8,0,65,57
1657031525964,COGS 101C,A01,083625,Delgado; Tania,17,0,35,18
1657031531994,COGS 107A,A01,083627,Boyle; Mary E. T.,13,0,60,47
1657031538028,COGS 118A,A01,083075,Gupta; Anjum,15,0,76,61
1657031544052,CSE 3,A50,083646,Miranda; Gregory Joseph,22,0,50,28
1657031550077,CSE 8A,A50,083650,Miranda; Gregory Joseph,17,1,56,39
1657031556105,CSE 11,A01,083080,Cao; Yingjun,4,15,40,36
1657031562134,CSE 12,A01,083652,Krause-Levy; Sophia Louisa,21,1,120,99
1657031568159,CSE 15L,A01,083654,Morris; Justin Loren,8,0,50,42
1657031568159,CSE 15L,A02,083655,Morris; Justin Loren,9,0,50,41
1657031574187,CSE 20,A01,083657,Tran; Khoa Dang,37,0,80,43
1657031580217,CSE 21,A01,095574,Bach; Quang Tran,21,0,48,27
1657031586243,CSE 30,A01,083084,Eldon; John,4,0,80,76
1657031586243,CSE 30,B01,095061,Bhaskar; Nishant,6,0,50,44
1657031592268,CSE 100,A01,083659,Cao; Yingjun,3,4,70,67
1657031598300,CSE 134B,A01,083661,Powell; Thomas Allan,19,0,100,81
1657031604323,CSE 140,A01,083663,Gungor; Onat,14,0,85,71
1657031610351,CSE 140L,A01,083088,Eldon; John,16,0,100,84
1657031616382,CSE 175,A01,083665,Kumar; Rakesh,3,0,25,22
1657031622409,CSE 190,A00,092507,Dubnov; Shlomo,7,0,20,13
1657031628442,ECE 45,A01,083139,Congero; Spencer William,5,0,75,70
1657031634469,ECE 65,A50,083695,Saad; Andrew S,12,0,30,18
1657031634469,ECE 65,A51,095125,Saad; Andrew S,25,0,26,1
1657031640494,ECE 109,A01,091882,Touri; Behrouz,16,0,70,54
1657031646524,ECE 180,A00,083140,Abi Samra; Nicholas Camill,1,0,30,29
1657031646524,ECE 180,B00,083141,Abi Samra; Nicholas Camill,0,0,30,30
1657031652549,MATH 10A,A01,083735,Patchell; Gregory David,1,0,30,29
1657031652549,MATH 10A,A02,083736,Patchell; Gregory David,20,0,30,10
1657031652549,MATH 10A,A03,083737,Patchell; Gregory David,16,0,30,14
1657031658575,MATH 10B,A01,083207,Lim; Seonhee,7,0,34,27
1657031658575,MATH 10B,A02,083208,Lim; Seonhee,9,0,35,26
1657031658575,MATH 10B,A03,093472,Lim; Seonhee,4,0,34,30
1657031658575,MATH 10B,B01,083739,Sinha; Shubham,9,0,30,21
1657031664600,MATH 18,A01,083743,Cinel; Cameron Alexander,6,0,30,24
1657031664600,MATH 18,A02,083744,Cinel; Cameron Alexander,15,0,30,15
1657031664600,MATH 18,A03,083745,Cinel; Cameron Alexander,8,0,30,22
1657031664600,MATH 18,B01,083748,Rideout; David Porter,4,0,37,33
1657031664600,MATH 18,B02,083749,Rideout; David Porter,3,0,36,33
1657031664600,MATH 18,B03,083750,Rideout; David Porter,2,0,37,35
1657031664600,MATH 18,B04,083751,Rideout; David Porter,5,0,36,31
1657031664600,MATH 18,B05,093473,Rideout; David Porter,4,0,36,32
1657031664600,MATH 18,B06,093474,Rideout; David Porter,5,0,36,31
1657031670634,MATH 20A,A01,083754,Zheng; Zequn,12,0,40,28
1657031676661,MATH 20B,A01,083756,Briones; Jor-el Thomas Caparas,1,0,36,35
1657031676661,MATH 20B,A02,083757,Briones; Jor-el Thomas Caparas,1,0,36,35
1657031676661,MATH 20B,A03,093475,Briones; Jor-el Thomas Caparas,0,0,36,36
1657031682691,MATH 20C,A01,083760,Briones; Jor-el Thomas Caparas,1,0,35,34
1657031682691,MATH 20C,A02,083761,Briones; Jor-el Thomas Caparas,8,0,35,27
1657031682691,MATH 20C,A03,093476,Briones; Jor-el Thomas Caparas,0,1,36,36
1657031682691,MATH 20C,B01,083762,Bach; Quang Tran,0,0,30,30
1657031688717,MATH 20D,A01,083765,Tran; Brian Kha,4,0,30,26
1657031688717,MATH 20D,A02,083766,Tran; Brian Kha,5,0,30,25
1657031688717,MATH 20D,A03,083767,Tran; Brian Kha,3,0,30,27
1657031694745,MATH 20E,A01,083771,Ganguly; Soumya,5,0,32,27
1657031694745,MATH 20E,A02,083772,Ganguly; Soumya,6,0,32,26
1657031694745,MATH 20E,B01,083773,Ciotti; Benjamin,18,0,35,17
1657031694745,MATH 20E,B02,083774,Ciotti; Benjamin,17,0,35,18
1657031700777,MATH 103A,A01,083777,Greenfeld; Be'Eri,2,0,36,34
1657031700777,MATH 103A,A02,083778,Greenfeld; Be'Eri,5,0,36,31
1657031700777,MATH 103A,A03,093561,Greenfeld; Be'Eri,4,0,36,32
1657031700777,MATH 103A,B01,083779,Greenfeld; Be'Eri,6,0,36,30
1657031700777,MATH 103A,B02,083780,Greenfeld; Be'Eri,2,0,36,34
1657031700777,MATH 103A,B03,093562,Greenfeld; Be'Eri,2,0,36,34
1657031706802,MATH 105,A01,085443,Carter; Anne Toulson,14,0,35,21
1657031706802,MATH 105,A02,093477,Carter; Anne Toulson,20,0,35,15
1657031712839,MATH 109,A01,083213,Ganzberger; Geoffrey Michael,2,0,34,32
1657031712839,MATH 109,A02,083214,Ganzberger; Geoffrey Michael,2,0,34,32
1657031712839,MATH 109,A03,093478,Ganzberger; Geoffrey Michael,1,0,34,33
1657031712839,MATH 109,B01,083215,Ganzberger; Geoffrey Michael,1,0,32,31
1657031712839,MATH 109,B02,083216,Ganzberger; Geoffrey Michael,1,0,32,31
1657031712839,MATH 109,B03,093479,Ganzberger; Geoffrey Michael,6,0,32,26
1657031718870,MATH 142A,A01,083219,Chow; Bennett,6,0,32,26
1657031718870,MATH 142A,A02,083220,Chow; Bennett,10,0,32,22
1657031718870,MATH 142A,A03,093480,Chow; Bennett,7,0,32,25
1657031718870,MATH 142A,B03,093481,Chow; Bennett,7,0,32,25
1657031718870,MATH 142A,B04,093558,Chow; Bennett,11,0,32,21
1657031718870,MATH 142A,B05,093559,Chow; Bennett,6,0,32,26
1657031724894,MATH 193A,A01,083224,Rotar; Vladimir,7,0,34,27
1657031724894,MATH 193A,A02,083225,Rotar; Vladimir,4,0,34,30
1657031724894,MATH 193A,A03,083781,Rotar; Vladimir,1,0,34,33
1657031724894,MATH 193A,A04,083782,Rotar; Vladimir,6,0,34,28
1657031724894,MATH 193A,A05,093482,Rotar; Vladimir,6,0,34,28
1657031730922,MATH 197,001,091859,McAuley; Julian John,9999,0,9999,0
1657031730922,MATH 197,002,095566,Kedlaya; Kiran S.,9997,0,9999,2
1657031730922,MATH 197,003,095567,Xiao; Ming,9999,0,9999,0
1657031730922,MATH 197,004,095571,Perols; Johan Lars,9998,0,9999,1
1657031737985,COGS 9,A01,083615,Shannon; Kyle Michael,7,0,75,68
1657031744016,COGS 11,A01,083617,Boyle; Mary E. T.,20,0,48,28
1657031750043,COGS 13,A01,083071,Bastos; Amalia Pinkusfeld,9,0,71,62
1657031756075,COGS 14A,A01,092681,Semenuks; Arturs,0,1,100,100
1657031762107,COGS 14B,A01,083073,Cheng; Tzu-Han,5,0,63,58
1657031768131,COGS 17,A01,092677,Semenuks; Arturs,4,0,81,77
1657031774158,COGS 100,A01,083619,Allen; Michael Gordon,15,0,70,55
1657031780185,COGS 101A,A01,083621,Davis; Joshua Daniel,9,0,68,59
1657031786219,COGS 101B,A01,091572,Allen; Michael Gordon,8,0,65,57
1657031792251,COGS 101C,A01,083625,Delgado; Tania,17,0,35,18
1657031798292,COGS 107A,A01,083627,Boyle; Mary E. T.,13,0,60,47
1657031804317,COGS 118A,A01,083075,Gupta; Anjum,15,0,76,61
1657031810343,CSE 3,A50,083646,Miranda; Gregory Joseph,22,0,50,28
1657031816368,CSE 8A,A50,083650,Miranda; Gregory Joseph,17,1,56,39
1657031822397,CSE 11,A01,083080,Cao; Yingjun,4,15,40,36
1657031828428,CSE 12,A01,083652,Krause-Levy; Sophia Louisa,21,1,120,99
1657031834454,CSE 15L,A01,083654,Morris; Justin Loren,8,0,50,42
1657031834454,CSE 15L,A02,083655,Morris; Justin Loren,9,0,50,41
1657031840483,CSE 20,A01,083657,Tran; Khoa Dang,37,0,80,43
1657031846509,CSE 21,A01,095574,Bach; Quang Tran,21,0,48,27
1657031852535,CSE 30,A01,083084,Eldon; John,4,0,80,76
1657031852535,CSE 30,B01,095061,Bhaskar; Nishant,6,0,50,44
1657031858575,CSE 100,A01,083659,Cao; Yingjun,3,4,70,67
1657031864600,CSE 134B,A01,083661,Powell; Thomas Allan,19,0,100,81
1657031870625,CSE 140,A01,083663,Gungor; Onat,14,0,85,71
1657031876654,CSE 140L,A01,083088,Eldon; John,16,0,100,84
1657031882678,CSE 175,A01,083665,Kumar; Rakesh,3,0,25,22
1657031888808,CSE 190,A00,092507,Dubnov; Shlomo,7,0,20,13
1657031894846,ECE 45,A01,083139,Congero; Spencer William,5,0,75,70
1657031900881,ECE 65,A50,083695,Saad; Andrew S,12,0,30,18
1657031900881,ECE 65,A51,095125,Saad; Andrew S,25,0,26,1
1657031906904,ECE 109,A01,091882,Touri; Behrouz,16,0,70,54
1657031912927,ECE 180,A00,083140,Abi Samra; Nicholas Camill,1,0,30,29
1657031912927,ECE 180,B00,083141,Abi Samra; Nicholas Camill,0,0,30,30
1657031918951,MATH 10A,A01,083735,Patchell; Gregory David,1,0,30,29
1657031918951,MATH 10A,A02,083736,Patchell; Gregory David,20,0,30,10
1657031918951,MATH 10A,A03,083737,Patchell; Gregory David,16,0,30,14
1657031924981,MATH 10B,A01,083207,Lim; Seonhee,7,0,34,27
1657031924981,MATH 10B,A02,083208,Lim; Seonhee,9,0,35,26
1657031924981,MATH 10B,A03,093472,Lim; Seonhee,4,0,34,30
1657031924981,MATH 10B,B01,083739,Sinha; Shubham,9,0,30,21
1657031931006,MATH 18,A01,083743,Cinel; Cameron Alexander,6,0,30,24
1657031931006,MATH 18,A02,083744,Cinel; Cameron Alexander,15,0,30,15
1657031931006,MATH 18,A03,083745,Cinel; Cameron Alexander,8,0,30,22
1657031931006,MATH 18,B01,083748,Rideout; David Porter,4,0,37,33
1657031931006,MATH 18,B02,083749,Rideout; David Porter,3,0,36,33
1657031931006,MATH 18,B03,083750,Rideout; David Porter,2,0,37,35
1657031931006,MATH 18,B04,083751,Rideout; David Porter,5,0,36,31
1657031931006,MATH 18,B05,093473,Rideout; David Porter,4,0,36,32
1657031931006,MATH 18,B06,093474,Rideout; David Porter,5,0,36,31
1657031937034,MATH 20A,A01,083754,Zheng; Zequn,12,0,40,28
1657031943059,MATH 20B,A01,083756,Briones; Jor-el Thomas Caparas,1,0,36,35
1657031943059,MATH 20B,A02,083757,Briones; Jor-el Thomas Caparas,1,0,36,35
1657031943059,MATH 20B,A03,093475,Briones; Jor-el Thomas Caparas,0,0,36,36
1657031949091,MATH 20C,A01,083760,Briones; Jor-el Thomas Caparas,1,0,35,34
1657031949091,MATH 20C,A02,083761,Briones; Jor-el Thomas Caparas,8,0,35,27
1657031949091,MATH 20C,A03,093476,Briones; Jor-el Thomas Caparas,0,1,36,36
1657031949091,MATH 20C,B01,083762,Bach; Quang Tran,0,0,30,30
1657031955124,MATH 20D,A01,083765,Tran; Brian Kha,4,0,30,26
1657031955124,MATH 20D,A02,083766,Tran; Brian Kha,5,0,30,25
1657031955124,MATH 20D,A03,083767,Tran; Brian Kha,3,0,30,27
1657031961171,MATH 20E,A01,083771,Ganguly; Soumya,5,0,32,27
1657031961171,MATH 20E,A02,083772,Ganguly; Soumya,6,0,32,26
1657031961171,MATH 20E,B01,083773,Ciotti; Benjamin,18,0,35,17
1657031961171,MATH 20E,B02,083774,Ciotti; Benjamin,17,0,35,18
1657031967206,MATH 103A,A01,083777,Greenfeld; Be'Eri,2,0,36,34
1657031967206,MATH 103A,A02,083778,Greenfeld; Be'Eri,5,0,36,31
1657031967206,MATH 103A,A03,093561,Greenfeld; Be'Eri,4,0,36,32
1657031967206,MATH 103A,B01,083779,Greenfeld; Be'Eri,6,0,36,30
1657031967206,MATH 103A,B02,083780,Greenfeld; Be'Eri,2,0,36,34
1657031967206,MATH 103A,B03,093562,Greenfeld; Be'Eri,2,0,36,34
1657031973231,MATH 105,A01,085443,Carter; Anne Toulson,14,0,35,21
1657031973231,MATH 105,A02,093477,Carter; Anne Toulson,20,0,35,15
1657031979262,MATH 109,A01,083213,Ganzberger; Geoffrey Michael,2,0,34,32
1657031979262,MATH 109,A02,083214,Ganzberger; Geoffrey Michael,2,0,34,32
1657031979262,MATH 109,A03,093478,Ganzberger; Geoffrey Michael,1,0,34,33
1657031979262,MATH 109,B01,083215,Ganzberger; Geoffrey Michael,1,0,32,31
1657031979262,MATH 109,B02,083216,Ganzberger; Geoffrey Michael,1,0,32,31
1657031979262,MATH 109,B03,093479,Ganzberger; Geoffrey Michael,6,0,32,26
1657031985296,MATH 142A,A01,083219,Chow; Bennett,6,0,32,26
1657031985296,MATH 142A,A02,083220,Chow; Bennett,10,0,32,22
1657031985296,MATH 142A,A03,093480,Chow; Bennett,7,0,32,25
1657031985296,MATH 142A,B03,093481,Chow; Bennett,7,0,32,25
1657031985296,MATH 142A,B04,093558,Chow; Bennett,11,0,32,21
1657031985296,MATH 142A,B05,093559,Chow; Bennett,6,0,32,26
1657031991323,MATH 193A,A01,083224,Rotar; Vladimir,7,0,34,27
1657031991323,MATH 193A,A02,083225,Rotar; Vladimir,4,0,34,30
1657031991323,MATH 193A,A03,083781,Rotar; Vladimir,1,0,34,33
1657031991323,MATH 193A,A04,083782,Rotar; Vladimir,6,0,34,28
1657031991323,MATH 193A,A05,093482,Rotar; Vladimir,6,0,34,28
1657031997353,MATH 197,001,091859,McAuley; Julian John,9999,0,9999,0
1657031997353,MATH 197,002,095566,Kedlaya; Kiran S.,9997,0,9999,2
1657031997353,MATH 197,003,095567,Xiao; Ming,9999,0,9999,0
1657031997353,MATH 197,004,095571,Perols; Johan Lars,9998,0,9999,1
1657032004417,COGS 9,A01,083615,Shannon; Kyle Michael,7,0,75,68
1657032010444,COGS 11,A01,083617,Boyle; Mary E. T.,20,0,48,28
1657032016474,COGS 13,A01,083071,Bastos; Amalia Pinkusfeld,9,0,71,62
1657032022503,COGS 14A,A01,092681,Semenuks; Arturs,0,1,100,100
1657032028527,COGS 14B,A01,083073,Cheng; Tzu-Han,5,0,63,58
1657032034555,COGS 17,A01,092677,Semenuks; Arturs,4,0,81,77
1657032040583,COGS 100,A01,083619,Allen; Michael Gordon,15,0,70,55
1657032046612,COGS 101A,A01,083621,Davis; Joshua Daniel,9,0,68,59
1657032052640,COGS 101B,A01,091572,Allen; Michael Gordon,8,0,65,57
1657032058675,COGS 101C,A01,083625,Delgado; Tania,17,0,35,18
1657032064700,COGS 107A,A01,083627,Boyle; Mary E. T.,13,0,60,47
1657032070724,COGS 118A,A01,083075,Gupta; Anjum,15,0,76,61
1657032076748,CSE 3,A50,083646,Miranda; Gregory Joseph,22,0,50,28
1657032082776,CSE 8A,A50,083650,Miranda; Gregory Joseph,17,1,56,39
1657032088802,CSE 11,A01,083080,Cao; Yingjun,4,15,40,36
1657032094825,CSE 12,A01,083652,Krause-Levy; Sophia Louisa,21,1,120,99
1657032100853,CSE 15L,A01,083654,Morris; Justin Loren,8,0,50,42
1657032100853,CSE 15L,A02,083655,Morris; Justin Loren,9,0,50,41
1657032106877,CSE 20,A01,083657,Tran; Khoa Dang,37,0,80,43
1657032112910,CSE 21,A01,095574,Bach; Quang Tran,21,0,48,27
1657032118943,CSE 30,A01,083084,Eldon; John,4,0,80,76
1657032118943,CSE 30,B01,095061,Bhaskar; Nishant,6,0,50,44
1657032124975,CSE 100,A01,083659,Cao; Yingjun,3,4,70,67
1657032131003,CSE 134B,A01,083661,Powell; Thomas Allan,19,0,100,81
1657032137029,CSE 140,A01,083663,Gungor; Onat,14,0,85,71
1657032143071,CSE 140L,A01,083088,Eldon; John,16,0,100,84
1657032149103,CSE 175,A01,083665,Kumar; Rakesh,3,0,25,22
1657032155129,CSE 190,A00,092507,Dubnov; Shlomo,7,0,20,13
1657032161157,ECE 45,A01,083139,Congero; Spencer William,5,0,75,70
1657032167184,ECE 65,A50,083695,Saad; Andrew S,12,0,30,18
1657032167184,ECE 65,A51,095125,Saad; Andrew S,25,0,26,1
1657032173217,ECE 109,A01,091882,Touri; Behrouz,16,0,70,54
1657032179244,ECE 180,A00,083140,Abi Samra; Nicholas Camill,1,0,30,29
1657032179244,ECE 180,B00,083141,Abi Samra; Nicholas Camill,0,0,30,30
1657032185268,MATH 10A,A01,083735,Patchell; Gregory David,1,0,30,29
1657032185268,MATH 10A,A02,083736,Patchell; Gregory David,20,0,30,10
1657032185268,MATH 10A,A03,083737,Patchell; Gregory David,16,0,30,14
1657032191293,MATH 10B,A01,083207,Lim; Seonhee,7,0,34,27
1657032191293,MATH 10B,A02,083208,Lim; Seonhee,9,0,35,26
1657032191293,MATH 10B,A03,093472,Lim; Seonhee,4,0,34,30
1657032191293,MATH 10B,B01,083739,Sinha; Shubham,9,0,30,21
1657032197334,MATH 18,A01,083743,Cinel; Cameron Alexander,6,0,30,24
1657032197334,MATH 18,A02,083744,Cinel; Cameron Alexander,15,0,30,15
1657032197334,MATH 18,A03,083745,Cinel; Cameron Alexander,8,0,30,22
1657032197334,MATH 18,B01,083748,Rideout; David Porter,4,0,37,33
1657032197334,MATH 18,B02,083749,Rideout; David Porter,3,0,36,33
1657032197334,MATH 18,B03,083750,Rideout; David Porter,2,0,37,35
1657032197334,MATH 18,B04,083751,Rideout; David Porter,5,0,36,31
1657032197334,MATH 18,B05,093473,Rideout; David Porter,4,0,36,32
1657032197334,MATH 18,B06,093474,Rideout; David Porter,5,0,36,31
1657032203360,MATH 20A,A01,083754,Zheng; Zequn,12,0,40,28
1657032209382,MATH 20B,A01,083756,Briones; Jor-el Thomas Caparas,1,0,36,35
1657032209382,MATH 20B,A02,083757,Briones; Jor-el Thomas Caparas,1,0,36,35
1657032209382,MATH 20B,A03,093475,Briones; Jor-el Thomas Caparas,0,0,36,36
1657032215415,MATH 20C,A01,083760,Briones; Jor-el Thomas Caparas,1,0,35,34
1657032215415,MATH 20C,A02,083761,Briones; Jor-el Thomas Caparas,8,0,35,27
1657032215415,MATH 20C,A03,093476,Briones; Jor-el Thomas Caparas,0,1,36,36
1657032215415,MATH 20C,B01,083762,Bach; Quang Tran,0,0,30,30
1657032221438,MATH 20D,A01,083765,Tran; Brian Kha,4,0,30,26
1657032221438,MATH 20D,A02,083766,Tran; Brian Kha,5,0,30,25
1657032221438,MATH 20D,A03,083767,Tran; Brian Kha,3,0,30,27
1657032227463,MATH 20E,A01,083771,Ganguly; Soumya,5,0,32,27
1657032227463,MATH 20E,A02,083772,Ganguly; Soumya,6,0,32,26
1657032227463,MATH 20E,B01,083773,Ciotti; Benjamin,18,0,35,17
1657032227463,MATH 20E,B02,083774,Ciotti; Benjamin,17,0,35,18
1657032233494,MATH 103A,A01,083777,Greenfeld; Be'Eri,2,0,36,34
1657032233494,MATH 103A,A02,083778,Greenfeld; Be'Eri,5,0,36,31
1657032233494,MATH 103A,A03,093561,Greenfeld; Be'Eri,4,0,36,32
1657032233494,MATH 103A,B01,083779,Greenfeld; Be'Eri,6,0,36,30
1657032233494,MATH 103A,B02,083780,Greenfeld; Be'Eri,2,0,36,34
1657032233494,MATH 103A,B03,093562,Greenfeld; Be'Eri,2,0,36,34
1657032239519,MATH 105,A01,085443,Carter; Anne Toulson,14,0,35,21
1657032239519,MATH 105,A02,093477,Carter; Anne Toulson,20,0,35,15
1657032245544,MATH 109,A01,083213,Ganzberger; Geoffrey Michael,2,0,34,32
1657032245544,MATH 109,A02,083214,Ganzberger; Geoffrey Michael,2,0,34,32
1657032245544,MATH 109,A03,093478,Ganzberger; Geoffrey Michael,1,0,34,33
1657032245544,MATH 109,B01,083215,Ganzberger; Geoffrey Michael,1,0,32,31
1657032245544,MATH 109,B02,083216,Ganzberger; Geoffrey Michael,1,0,32,31
1657032245544,MATH 109,B03,093479,Ganzberger; Geoffrey Michael,6,0,32,26
1657032251575,MATH 142A,A01,083219,Chow; Bennett,6,0,32,26
1657032251575,MATH 142A,A02,083220,Chow; Bennett,10,0,32,22
1657032251575,MATH 142A,A03,093480,Chow; Bennett,7,0,32,25
1657032251575,MATH 142A,B03,093481,Chow; Bennett,7,0,32,25
1657032251575,MATH 142A,B04,093558,Chow; Bennett,11,0,32,21
1657032251575,MATH 142A,B05,093559,Chow; Bennett,6,0,32,26
1657032257600,MATH 193A,A01,083224,Rotar; Vladimir,7,0,34,27
1657032257600,MATH 193A,A02,083225,Rotar; Vladimir,4,0,34,30
1657032257600,MATH 193A,A03,083781,Rotar; Vladimir,1,0,34,33
1657032257600,MATH 193A,A04,083782,Rotar; Vladimir,6,0,34,28
1657032257600,MATH 193A,A05,093482,Rotar; Vladimir,6,0,34,28
1657032263622,MATH 197,001,091859,McAuley; Julian John,9999,0,9999,0
1657032263622,MATH 197,002,095566,Kedlaya; Kiran S.,9997,0,9999,2
1657032263622,MATH 197,003,095567,Xiao; Ming,9999,0,9999,0
1657032263622,MATH 197,004,095571,Perols; Johan Lars,9998,0,9999,1
1657032270690,COGS 9,A01,083615,Shannon; Kyle Michael,7,0,75,68
1657032276721,COGS 11,A01,083617,Boyle; Mary E. T.,20,0,48,28
1657032282746,COGS 13,A01,083071,Bastos; Amalia Pinkusfeld,9,0,71,62
1657032288768,COGS 14A,A01,092681,Semenuks; Arturs,0,1,100,100
1657032294798,COGS 14B,A01,083073,Cheng; Tzu-Han,5,0,63,58
1657032300822,COGS 17,A01,092677,Semenuks; Arturs,4,0,81,77
1657032306855,COGS 100,A01,083619,Allen; Michael Gordon,15,0,70,55
1657032312884,COGS 101A,A01,083621,Davis; Joshua Daniel,9,0,68,59
1657032318913,COGS 101B,A01,091572,Allen; Michael Gordon,8,0,65,57
1657032324937,COGS 101C,A01,083625,Delgado; Tania,17,0,35,18
1657032330964,COGS 107A,A01,083627,Boyle; Mary E. T.,13,0,60,47
1657032336988,COGS 118A,A01,083075,Gupta; Anjum,15,0,76,61
1657032343017,CSE 3,A50,083646,Miranda; Gregory Joseph,22,0,50,28
1657032349042,CSE 8A,A50,083650,Miranda; Gregory Joseph,17,1,56,39
1657032355066,CSE 11,A01,083080,Cao; Yingjun,4,15,40,36
1657032361106,CSE 12,A01,083652,Krause-Levy; Sophia Louisa,21,1,120,99
1657032367137,CSE 15L,A01,083654,Morris; Justin Loren,8,0,50,42
1657032367137,CSE 15L,A02,083655,Morris; Justin Loren,9,0,50,41
1657032373165,CSE 20,A01,083657,Tran; Khoa Dang,37,0,80,43
1657032379192,CSE 21,A01,095574,Bach; Quang Tran,21,0,48,27
1657032385221,CSE 30,A01,083084,Eldon; John,4,0,80,76
1657032385221,CSE 30,B01,095061,Bhaskar; Nishant,6,0,50,44
1657032391246,CSE 100,A01,083659,Cao; Yingjun,3,4,70,67
1657032397271,CSE 134B,A01,083661,Powell; Thomas Allan,19,0,100,81
1657032403300,CSE 140,A01,083663,Gungor; Onat,14,0,85,71
1657032409323,CSE 140L,A01,083088,Eldon; John,16,0,100,84
1657032415350,CSE 175,A01,083665,Kumar; Rakesh,3,0,25,22
1657032421383,CSE 190,A00,092507,Dubnov; Shlomo,7,0,20,13
1657032427410,ECE 45,A01,083139,Congero; Spencer William,5,0,75,70
1657032433434,ECE 65,A50,083695,Saad; Andrew S,12,0,30,18
1657032433434,ECE 65,A51,095125,Saad; Andrew S,25,0,26,1
1657032439461,ECE 109,A01,091882,Touri; Behrouz,16,0,70,54
1657032445485,ECE 180,A00,083140,Abi Samra; Nicholas Camill,1,0,30,29
1657032445485,ECE 180,B00,083141,Abi Samra; Nicholas Camill,0,0,30,30
1657032451509,MATH 10A,A01,083735,Patchell; Gregory David,1,0,30,29
1657032451509,MATH 10A,A02,083736,Patchell; Gregory David,20,0,30,10
1657032451509,MATH 10A,A03,083737,Patchell; Gregory David,16,0,30,14
1657032457537,MATH 10B,A01,083207,Lim; Seonhee,7,0,34,27
1657032457537,MATH 10B,A02,083208,Lim; Seonhee,9,0,35,26
1657032457537,MATH 10B,A03,093472,Lim; Seonhee,4,0,34,30
1657032457537,MATH 10B,B01,083739,Sinha; Shubham,9,0,30,21
1657032463570,MATH 18,A01,083743,Cinel; Cameron Alexander,6,0,30,24
1657032463570,MATH 18,A02,083744,Cinel; Cameron Alexander,15,0,30,15
1657032463570,MATH 18,A03,083745,Cinel; Cameron Alexander,8,0,30,22
1657032463570,MATH 18,B01,083748,Rideout; David Porter,4,0,37,33
1657032463570,MATH 18,B02,083749,Rideout; David Porter,3,0,36,33
1657032463570,MATH 18,B03,083750,Rideout; David Porter,2,0,37,35
1657032463570,MATH 18,B04,083751,Rideout; David Porter,5,0,36,31
1657032463570,MATH 18,B05,093473,Rideout; David Porter,4,0,36,32
1657032463570,MATH 18,B06,093474,Rideout; David Porter,5,0,36,31
1657032469600,MATH 20A,A01,083754,Zheng; Zequn,12,0,40,28
1657032475630,MATH 20B,A01,083756,Briones; Jor-el Thomas Caparas,1,0,36,35
1657032475630,MATH 20B,A02,083757,Briones; Jor-el Thomas Caparas,1,0,36,35
1657032475630,MATH 20B,A03,093475,Briones; Jor-el Thomas Caparas,0,0,36,36
1657032481655,MATH 20C,A01,083760,Briones; Jor-el Thomas Caparas,1,0,35,34
1657032481655,MATH 20C,A02,083761,Briones; Jor-el Thomas Caparas,8,0,35,27
1657032481655,MATH 20C,A03,093476,Briones; Jor-el Thomas Caparas,0,1,36,36
1657032481655,MATH 20C,B01,083762,Bach; Quang Tran,0,0,30,30
1657032487770,MATH 20D,A01,083765,Tran; Brian Kha,4,0,30,26
1657032487770,MATH 20D,A02,083766,Tran; Brian Kha,5,0,30,25
1657032487770,MATH 20D,A03,083767,Tran; Brian Kha,3,0,30,27
1657032493803,MATH 20E,A01,083771,Ganguly; Soumya,5,0,32,27
1657032493803,MATH 20E,A02,083772,Ganguly; Soumya,6,0,32,26
1657032493803,MATH 20E,B01,083773,Ciotti; Benjamin,18,0,35,17
1657032493803,MATH 20E,B02,083774,Ciotti; Benjamin,17,0,35,18
1657032499832,MATH 103A,A01,083777,Greenfeld; Be'Eri,2,0,36,34
1657032499832,MATH 103A,A02,083778,Greenfeld; Be'Eri,5,0,36,31
1657032499832,MATH 103A,A03,093561,Greenfeld; Be'Eri,4,0,36,32
1657032499832,MATH 103A,B01,083779,Greenfeld; Be'Eri,6,0,36,30
1657032499832,MATH 103A,B02,083780,Greenfeld; Be'Eri,2,0,36,34
1657032499832,MATH 103A,B03,093562,Greenfeld; Be'Eri,2,0,36,34
1657032505855,MATH 105,A01,085443,Carter; Anne Toulson,14,0,35,21
1657032505855,MATH 105,A02,093477,Carter; Anne Toulson,20,0,35,15
1657032511879,MATH 109,A01,083213,Ganzberger; Geoffrey Michael,2,0,34,32
1657032511879,MATH 109,A02,083214,Ganzberger; Geoffrey Michael,2,0,34,32
1657032511879,MATH 109,A03,093478,Ganzberger; Geoffrey Michael,1,0,34,33
1657032511879,MATH 109,B01,083215,Ganzberger; Geoffrey Michael,1,0,32,31
1657032511879,MATH 109,B02,083216,Ganzberger; Geoffrey Michael,1,0,32,31
1657032511879,MATH 109,B03,093479,Ganzberger; Geoffrey Michael,6,0,32,26
1657032517905,MATH 142A,A01,083219,Chow; Bennett,6,0,32,26
1657032517905,MATH 142A,A02,083220,Chow; Bennett,10,0,32,22
1657032517905,MATH 142A,A03,093480,Chow; Bennett,7,0,32,25
1657032517905,MATH 142A,B03,093481,Chow; Bennett,7,0,32,25
1657032517905,MATH 142A,B04,093558,Chow; Bennett,11,0,32,21
1657032517905,MATH 142A,B05,093559,Chow; Bennett,6,0,32,26
1657032523933,MATH 193A,A01,083224,Rotar; Vladimir,7,0,34,27
1657032523933,MATH 193A,A02,083225,Rotar; Vladimir,5,0,34,29
1657032523933,MATH 193A,A03,083781,Rotar; Vladimir,1,0,34,33
1657032523933,MATH 193A,A04,083782,Rotar; Vladimir,6,0,34,28
1657032523933,MATH 193A,A05,093482,Rotar; Vladimir,6,0,34,28
1657032529957,MATH 197,001,091859,McAuley; Julian John,9999,0,9999,0
1657032529957,MATH 197,002,095566,Kedlaya; Kiran S.,9997,0,9999,2
1657032529957,MATH 197,003,095567,Xiao; Ming,9999,0,9999,0
1657032529957,MATH 197,004,095571,Perols; Johan Lars,9998,0,9999,1
1657032537030,COGS 9,A01,083615,Shannon; Kyle Michael,7,0,75,68
1657032543053,COGS 11,A01,083617,Boyle; Mary E. T.,20,0,48,28
1657032549085,COGS 13,A01,083071,Bastos; Amalia Pinkusfeld,9,0,71,62
1657032555111,COGS 14A,A01,092681,Semenuks; Arturs,0,1,100,100
1657032561135,COGS 14B,A01,083073,Cheng; Tzu-Han,5,0,63,58
1657032567160,COGS 17,A01,092677,Semenuks; Arturs,4,0,81,77
1657032573184,COGS 100,A01,083619,Allen; Michael Gordon,15,0,70,55
1657032579209,COGS 101A,A01,083621,Davis; Joshua Daniel,9,0,68,59
1657032585240,COGS 101B,A01,091572,Allen; Michael Gordon,8,0,65,57
1657032591263,COGS 101C,A01,083625,Delgado; Tania,17,0,35,18
1657032597287,COGS 107A,A01,083627,Boyle; Mary E. T.,13,0,60,47
1657032603321,COGS 118A,A01,083075,Gupta; Anjum,15,0,76,61
1657032609348,CSE 3,A50,083646,Miranda; Gregory Joseph,22,0,50,28
1657032615378,CSE 8A,A50,083650,Miranda; Gregory Joseph,17,1,56,39
1657032621405,CSE 11,A01,083080,Cao; Yingjun,4,15,40,36
1657032627438,CSE 12,A01,083652,Krause-Levy; Sophia Louisa,21,1,120,99
1657032633462,CSE 15L,A01,083654,Morris; Justin Loren,8,0,50,42
1657032633462,CSE 15L,A02,083655,Morris; Justin Loren,9,0,50,41
1657032639490,CSE 20,A01,083657,Tran; Khoa Dang,37,0,80,43
1657032645514,CSE 21,A01,095574,Bach; Quang Tran,21,0,48,27
1657032651537,CSE 30,A01,083084,Eldon; John,4,0,80,76
1657032651537,CSE 30,B01,095061,Bhaskar; Nishant,6,0,50,44
1657032657561,CSE 100,A01,083659,Cao; Yingjun,3,4,70,67
1657032663589,CSE 134B,A01,083661,Powell; Thomas Allan,19,0,100,81
1657032669616,CSE 140,A01,083663,Gungor; Onat,14,0,85,71
1657032675639,CSE 140L,A01,083088,Eldon; John,16,0,100,84
1657032681664,CSE 175,A01,083665,Kumar; Rakesh,3,0,25,22
1657032687688,CSE 190,A00,092507,Dubnov; Shlomo,7,0,20,13
1657032693717,ECE 45,A01,083139,Congero; Spencer William,5,0,75,70
1657032699746,ECE 65,A50,083695,Saad; Andrew S,12,0,30,18
1657032699746,ECE 65,A51,095125,Saad; Andrew S,25,0,26,1
1657032705774,ECE 109,A01,091882,Touri; Behrouz,16,0,70,54
1657032711799,ECE 180,A00,083140,Abi Samra; Nicholas Camill,1,0,30,29
1657032711799,ECE 180,B00,083141,Abi Samra; Nicholas Camill,0,0,30,30
1657032717828,MATH 10A,A01,083735,Patchell; Gregory David,1,0,30,29
1657032717828,MATH 10A,A02,083736,Patchell; Gregory David,20,0,30,10
1657032717828,MATH 10A,A03,083737,Patchell; Gregory David,16,0,30,14
1657032723857,MATH 10B,A01,083207,Lim; Seonhee,7,0,34,27
1657032723857,MATH 10B,A02,083208,Lim; Seonhee,9,0,35,26
1657032723857,MATH 10B,A03,093472,Lim; Seonhee,4,0,34,30
1657032723857,MATH 10B,B01,083739,Sinha; Shubham,9,0,30,21
1657032729894,MATH 18,A01,083743,Cinel; Cameron Alexander,6,0,30,24
1657032729894,MATH 18,A02,083744,Cinel; Cameron Alexander,15,0,30,15
1657032729894,MATH 18,A03,083745,Cinel; Cameron Alexander,8,0,30,22
1657032729894,MATH 18,B01,083748,Rideout; David Porter,4,0,37,33
1657032729894,MATH 18,B02,083749,Rideout; David Porter,3,0,36,33
1657032729894,MATH 18,B03,083750,Rideout; David Porter,2,0,37,35
1657032729894,MATH 18,B04,083751,Rideout; David Porter,5,0,36,31
1657032729894,MATH 18,B05,093473,Rideout; David Porter,4,0,36,32
1657032729894,MATH 18,B06,093474,Rideout; David Porter,5,0,36,31
1657032735932,MATH 20A,A01,083754,Zheng; Zequn,12,0,40,28
1657032741957,MATH 20B,A01,083756,Briones; Jor-el Thomas Caparas,1,0,36,35
1657032741957,MATH 20B,A02,083757,Briones; Jor-el Thomas Caparas,1,0,36,35
1657032741957,MATH 20B,A03,093475,Briones; Jor-el Thomas Caparas,0,0,36,36
1657032747987,MATH 20C,A01,083760,Briones; Jor-el Thomas Caparas,1,0,35,34
1657032747987,MATH 20C,A02,083761,Briones; Jor-el Thomas Caparas,8,0,35,27
1657032747987,MATH 20C,A03,093476,Briones; Jor-el Thomas Caparas,0,1,36,36
1657032747987,MATH 20C,B01,083762,Bach; Quang Tran,0,0,30,30
1657032754014,MATH 20D,A01,083765,Tran; Brian Kha,4,0,30,26
1657032754014,MATH 20D,A02,083766,Tran; Brian Kha,5,0,30,25
1657032754014,MATH 20D,A03,083767,Tran; Brian Kha,3,0,30,27
1657032760043,MATH 20E,A01,083771,Ganguly; Soumya,5,0,32,27
1657032760043,MATH 20E,A02,083772,Ganguly; Soumya,6,0,32,26
1657032760043,MATH 20E,B01,083773,Ciotti; Benjamin,18,0,35,17
1657032760043,MATH 20E,B02,083774,Ciotti; Benjamin,17,0,35,18
1657032766071,MATH 103A,A01,083777,Greenfeld; Be'Eri,2,0,36,34
1657032766071,MATH 103A,A02,083778,Greenfeld; Be'Eri,5,0,36,31
1657032766071,MATH 103A,A03,093561,Greenfeld; Be'Eri,4,0,36,32
1657032766071,MATH 103A,B01,083779,Greenfeld; Be'Eri,6,0,36,30
1657032766071,MATH 103A,B02,083780,Greenfeld; Be'Eri,2,0,36,34
1657032766071,MATH 103A,B03,093562,Greenfeld; Be'Eri,2,0,36,34
1657032772098,MATH 105,A01,085443,Carter; Anne Toulson,14,0,35,21
1657032772098,MATH 105,A02,093477,Carter; Anne Toulson,20,0,35,15
1657032778123,MATH 109,A01,083213,Ganzberger; Geoffrey Michael,2,0,34,32
1657032778123,MATH 109,A02,083214,Ganzberger; Geoffrey Michael,2,0,34,32
1657032778123,MATH 109,A03,093478,Ganzberger; Geoffrey Michael,1,0,34,33
1657032778123,MATH 109,B01,083215,Ganzberger; Geoffrey Michael,1,0,32,31
1657032778123,MATH 109,B02,083216,Ganzberger; Geoffrey Michael,1,0,32,31
1657032778123,MATH 109,B03,093479,Ganzberger; Geoffrey Michael,6,0,32,26
1657032784148,MATH 142A,A01,083219,Chow; Bennett,6,0,32,26
1657032784148,MATH 142A,A02,083220,Chow; Bennett,10,0,32,22
1657032784148,MATH 142A,A03,093480,Chow; Bennett,7,0,32,25
1657032784148,MATH 142A,B03,093481,Chow; Bennett,7,0,32,25
1657032784148,MATH 142A,B04,093558,Chow; Bennett,11,0,32,21
1657032784148,MATH 142A,B05,093559,Chow; Bennett,6,0,32,26
1657032790182,MATH 193A,A01,083224,Rotar; Vladimir,7,0,34,27
1657032790182,MATH 193A,A02,083225,Rotar; Vladimir,5,0,34,29
1657032790182,MATH 193A,A03,083781,Rotar; Vladimir,1,0,34,33
1657032790182,MATH 193A,A04,083782,Rotar; Vladimir,6,0,34,28
1657032790182,MATH 193A,A05,093482,Rotar; Vladimir,6,0,34,28
1657032796209,MATH 197,001,091859,McAuley; Julian John,9999,0,9999,0
1657032796209,MATH 197,002,095566,Kedlaya; Kiran S.,9997,0,9999,2
1657032796209,MATH 197,003,095567,Xiao; Ming,9999,0,9999,0
1657032796209,MATH 197,004,095571,Perols; Johan Lars,9998,0,9999,1
1657032803269,COGS 9,A01,083615,Shannon; Kyle Michael,7,0,75,68
1657032809293,COGS 11,A01,083617,Boyle; Mary E. T.,20,0,48,28
1657032815316,COGS 13,A01,083071,Bastos; Amalia Pinkusfeld,9,0,71,62
1657032821338,COGS 14A,A01,092681,Semenuks; Arturs,0,1,100,100
1657032827370,COGS 14B,A01,083073,Cheng; Tzu-Han,5,0,63,58
1657032833399,COGS 17,A01,092677,Semenuks; Arturs,4,0,81,77
1657032839423,COGS 100,A01,083619,Allen; Michael Gordon,15,0,70,55
1657032845447,COGS 101A,A01,083621,Davis; Joshua Daniel,9,0,68,59
1657032851475,COGS 101B,A01,091572,Allen; Michael Gordon,8,0,65,57
1657032857499,COGS 101C,A01,083625,Delgado; Tania,17,0,35,18
1657032863523,COGS 107A,A01,083627,Boyle; Mary E. T.,13,0,60,47
1657032869548,COGS 118A,A01,083075,Gupta; Anjum,15,0,76,61
1657032875575,CSE 3,A50,083646,Miranda; Gregory Joseph,22,0,50,28
1657032881598,CSE 8A,A50,083650,Miranda; Gregory Joseph,17,1,56,39
1657032887622,CSE 11,A01,083080,Cao; Yingjun,4,15,40,36
1657032893650,CSE 12,A01,083652,Krause-Levy; Sophia Louisa,21,1,120,99
1657032899684,CSE 15L,A01,083654,Morris; Justin Loren,8,0,50,42
1657032899684,CSE 15L,A02,083655,Morris; Justin Loren,9,0,50,41
1657032905707,CSE 20,A01,083657,Tran; Khoa Dang,37,0,80,43
1657032911735,CSE 21,A01,095574,Bach; Quang Tran,21,0,48,27
1657032917759,CSE 30,A01,083084,Eldon; John,4,0,80,76
1657032917759,CSE 30,B01,095061,Bhaskar; Nishant,6,0,50,44
1657032923783,CSE 100,A01,083659,Cao; Yingjun,3,4,70,67
1657032929807,CSE 134B,A01,083661,Powell; Thomas Allan,19,0,100,81
1657032935848,CSE 140,A01,083663,Gungor; Onat,14,0,85,71
1657032941872,CSE 140L,A01,083088,Eldon; John,16,0,100,84
1657032947900,CSE 175,A01,083665,Kumar; Rakesh,3,0,25,22
1657032953923,CSE 190,A00,092507,Dubnov; Shlomo,7,0,20,13
1657032959953,ECE 45,A01,083139,Congero; Spencer William,5,0,75,70
1657032965983,ECE 65,A50,083695,Saad; Andrew S,12,0,30,18
1657032965983,ECE 65,A51,095125,Saad; Andrew S,25,0,26,1
1657032972011,ECE 109,A01,091882,Touri; Behrouz,16,0,70,54
1657032978038,ECE 180,A00,083140,Abi Samra; Nicholas Camill,1,0,30,29
1657032978038,ECE 180,B00,083141,Abi Samra; Nicholas Camill,0,0,30,30
1657032984082,MATH 10A,A01,083735,Patchell; Gregory David,1,0,30,29
1657032984082,MATH 10A,A02,083736,Patchell; Gregory David,20,0,30,10
1657032984082,MATH 10A,A03,083737,Patchell; Gregory David,16,0,30,14
1657032990112,MATH 10B,A01,083207,Lim; Seonhee,7,0,34,27
1657032990112,MATH 10B,A02,083208,Lim; Seonhee,9,0,35,26
1657032990112,MATH 10B,A03,093472,Lim; Seonhee,4,0,34,30
1657032990112,MATH 10B,B01,083739,Sinha; Shubham,9,0,30,21
1657032996136,MATH 18,A01,083743,Cinel; Cameron Alexander,6,0,30,24
1657032996136,MATH 18,A02,083744,Cinel; Cameron Alexander,15,0,30,15
1657032996136,MATH 18,A03,083745,Cinel; Cameron Alexander,8,0,30,22
1657032996136,MATH 18,B01,083748,Rideout; David Porter,4,0,37,33
1657032996136,MATH 18,B02,083749,Rideout; David Porter,3,0,36,33
1657032996136,MATH 18,B03,083750,Rideout; David Porter,2,0,37,35
1657032996136,MATH 18,B04,083751,Rideout; David Porter,5,0,36,31
1657032996136,MATH 18,B05,093473,Rideout; David Porter,4,0,36,32
1657032996136,MATH 18,B06,093474,Rideout; David Porter,5,0,36,31
1657033002165,MATH 20A,A01,083754,Zheng; Zequn,12,0,40,28
1657033008197,MATH 20B,A01,083756,Briones; Jor-el Thomas Caparas,1,0,36,35
1657033008197,MATH 20B,A02,083757,Briones; Jor-el Thomas Caparas,1,0,36,35
1657033008197,MATH 20B,A03,093475,Briones; Jor-el Thomas Caparas,0,0,36,36
1657033014222,MATH 20C,A01,083760,Briones; Jor-el Thomas Caparas,1,0,35,34
1657033014222,MATH 20C,A02,083761,Briones; Jor-el Thomas Caparas,8,0,35,27
1657033014222,MATH 20C,A03,093476,Briones; Jor-el Thomas Caparas,0,1,36,36
1657033014222,MATH 20C,B01,083762,Bach; Quang Tran,0,0,30,30
1657033020251,MATH 20D,A01,083765,Tran; Brian Kha,4,0,30,26
1657033020251,MATH 20D,A02,083766,Tran; Brian Kha,5,0,30,25
1657033020251,MATH 20D,A03,083767,Tran; Brian Kha,3,0,30,27
1657033026275,MATH 20E,A01,083771,Ganguly; Soumya,5,0,32,27
1657033026275,MATH 20E,A02,083772,Ganguly; Soumya,6,0,32,26
1657033026275,MATH 20E,B01,083773,Ciotti; Benjamin,18,0,35,17
1657033026275,MATH 20E,B02,083774,Ciotti; Benjamin,17,0,35,18
1657033032305,MATH 103A,A01,083777,Greenfeld; Be'Eri,2,0,36,34
1657033032305,MATH 103A,A02,083778,Greenfeld; Be'Eri,5,0,36,31
1657033032305,MATH 103A,A03,093561,Greenfeld; Be'Eri,4,0,36,32
1657033032305,MATH 103A,B01,083779,Greenfeld; Be'Eri,6,0,36,30
1657033032305,MATH 103A,B02,083780,Greenfeld; Be'Eri,2,0,36,34
1657033032305,MATH 103A,B03,093562,Greenfeld; Be'Eri,2,0,36,34
1657033038329,MATH 105,A01,085443,Carter; Anne Toulson,14,0,35,21
1657033038329,MATH 105,A02,093477,Carter; Anne Toulson,20,0,35,15
1657033044358,MATH 109,A01,083213,Ganzberger; Geoffrey Michael,2,0,34,32
1657033044358,MATH 109,A02,083214,Ganzberger; Geoffrey Michael,2,0,34,32
1657033044358,MATH 109,A03,093478,Ganzberger; Geoffrey Michael,1,0,34,33
1657033044358,MATH 109,B01,083215,Ganzberger; Geoffrey Michael,1,0,32,31
1657033044358,MATH 109,B02,083216,Ganzberger; Geoffrey Michael,1,0,32,31
1657033044358,MATH 109,B03,093479,Ganzberger; Geoffrey Michael,6,0,32,26
1657033050388,MATH 142A,A01,083219,Chow; Bennett,6,0,32,26
1657033050388,MATH 142A,A02,083220,Chow; Bennett,10,0,32,22
1657033050388,MATH 142A,A03,093480,Chow; Bennett,7,0,32,25
1657033050388,MATH 142A,B03,093481,Chow; Bennett,7,0,32,25
1657033050388,MATH 142A,B04,093558,Chow; Bennett,11,0,32,21
1657033050388,MATH 142A,B05,093559,Chow; Bennett,6,0,32,26
1657033056413,MATH 193A,A01,083224,Rotar; Vladimir,7,0,34,27
1657033056413,MATH 193A,A02,083225,Rotar; Vladimir,5,0,34,29
1657033056413,MATH 193A,A03,083781,Rotar; Vladimir,1,0,34,33
1657033056413,MATH 193A,A04,083782,Rotar; Vladimir,6,0,34,28
1657033056413,MATH 193A,A05,093482,Rotar; Vladimir,6,0,34,28
1657033062441,MATH 197,001,091859,McAuley; Julian John,9999,0,9999,0
1657033062441,MATH 197,002,095566,Kedlaya; Kiran S.,9997,0,9999,2
1657033062441,MATH 197,003,095567,Xiao; Ming,9999,0,9999,0
1657033062441,MATH 197,004,095571,Perols; Johan Lars,9998,0,9999,1
1657033069502,COGS 9,A01,083615,Shannon; Kyle Michael,7,0,75,68
1657033075525,COGS 11,A01,083617,Boyle; Mary E. T.,20,0,48,28
1657033081627,COGS 13,A01,083071,Bastos; Amalia Pinkusfeld,9,0,71,62
1657033087654,COGS 14A,A01,092681,Semenuks; Arturs,0,1,100,100
1657033093677,COGS 14B,A01,083073,Cheng; Tzu-Han,5,0,63,58
1657033099699,COGS 17,A01,092677,Semenuks; Arturs,4,0,81,77
1657033105734,COGS 100,A01,083619,Allen; Michael Gordon,15,0,70,55
1657033111760,COGS 101A,A01,083621,Davis; Joshua Daniel,9,0,68,59
1657033117782,COGS 101B,A01,091572,Allen; Michael Gordon,8,0,65,57
1657033123809,COGS 101C,A01,083625,Delgado; Tania,17,0,35,18
1657033129842,COGS 107A,A01,083627,Boyle; Mary E. T.,13,0,60,47
1657033135868,COGS 118A,A01,083075,Gupta; Anjum,15,0,76,61
1657033141895,CSE 3,A50,083646,Miranda; Gregory Joseph,22,0,50,28
1657033147918,CSE 8A,A50,083650,Miranda; Gregory Joseph,17,1,56,39
1657033153943,CSE 11,A01,083080,Cao; Yingjun,4,15,40,36
1657033159968,CSE 12,A01,083652,Krause-Levy; Sophia Louisa,21,1,120,99
1657033165997,CSE 15L,A01,083654,Morris; Justin Loren,8,0,50,42
1657033165997,CSE 15L,A02,083655,Morris; Justin Loren,9,0,50,41
1657033172024,CSE 20,A01,083657,Tran; Khoa Dang,37,0,80,43
1657033178050,CSE 21,A01,095574,Bach; Quang Tran,21,0,48,27
1657033184075,CSE 30,A01,083084,Eldon; John,4,0,80,76
1657033184075,CSE 30,B01,095061,Bhaskar; Nishant,6,0,50,44
1657033190102,CSE 100,A01,083659,Cao; Yingjun,3,4,70,67
1657033196126,CSE 134B,A01,083661,Powell; Thomas Allan,19,0,100,81
1657033202151,CSE 140,A01,083663,Gungor; Onat,14,0,85,71
1657033208185,CSE 140L,A01,083088,Eldon; John,16,0,100,84
1657033214207,CSE 175,A01,083665,Kumar; Rakesh,3,0,25,22
1657033220231,CSE 190,A00,092507,Dubnov; Shlomo,7,0,20,13
1657033226255,ECE 45,A01,083139,Congero; Spencer William,5,0,75,70
1657033232280,ECE 65,A50,083695,Saad; Andrew S,12,0,30,18
1657033232280,ECE 65,A51,095125,Saad; Andrew S,25,0,26,1
1657033238303,ECE 109,A01,091882,Touri; Behrouz,16,0,70,54
1657033244331,ECE 180,A00,083140,Abi Samra; Nicholas Camill,1,0,30,29
1657033244331,ECE 180,B00,083141,Abi Samra; Nicholas Camill,0,0,30,30
1657033250356,MATH 10A,A01,083735,Patchell; Gregory David,1,0,30,29
1657033250356,MATH 10A,A02,083736,Patchell; Gregory David,20,0,30,10
1657033250356,MATH 10A,A03,083737,Patchell; Gregory David,16,0,30,14
1657033256387,MATH 10B,A01,083207,Lim; Seonhee,7,0,34,27
1657033256387,MATH 10B,A02,083208,Lim; Seonhee,9,0,35,26
1657033256387,MATH 10B,A03,093472,Lim; Seonhee,4,0,34,30
1657033256387,MATH 10B,B01,083739,Sinha; Shubham,9,0,30,21
1657033262412,MATH 18,A01,083743,Cinel; Cameron Alexander,6,0,30,24
1657033262412,MATH 18,A02,083744,Cinel; Cameron Alexander,15,0,30,15
1657033262412,MATH 18,A03,083745,Cinel; Cameron Alexander,8,0,30,22
1657033262412,MATH 18,B01,083748,Rideout; David Porter,4,0,37,33
1657033262412,MATH 18,B02,083749,Rideout; David Porter,3,0,36,33
1657033262412,MATH 18,B03,083750,Rideout; David Porter,2,0,37,35
1657033262412,MATH 18,B04,083751,Rideout; David Porter,5,0,36,31
1657033262412,MATH 18,B05,093473,Rideout; David Porter,4,0,36,32
1657033262412,MATH 18,B06,093474,Rideout; David Porter,5,0,36,31
1657033268488,MATH 20A,A01,083754,Zheng; Zequn,12,0,40,28
1657033274519,MATH 20B,A01,083756,Briones; Jor-el Thomas Caparas,1,0,36,35
1657033274519,MATH 20B,A02,083757,Briones; Jor-el Thomas Caparas,1,0,36,35
1657033274519,MATH 20B,A03,093475,Briones; Jor-el Thomas Caparas,0,0,36,36
1657033280547,MATH 20C,A01,083760,Briones; Jor-el Thomas Caparas,1,0,35,34
1657033280547,MATH 20C,A02,083761,Briones; Jor-el Thomas Caparas,8,0,35,27
1657033280547,MATH 20C,A03,093476,Briones; Jor-el Thomas Caparas,0,1,36,36
1657033280547,MATH 20C,B01,083762,Bach; Quang Tran,0,0,30,30
1657033286573,MATH 20D,A01,083765,Tran; Brian Kha,4,0,30,26
1657033286573,MATH 20D,A02,083766,Tran; Brian Kha,5,0,30,25
1657033286573,MATH 20D,A03,083767,Tran; Brian Kha,3,0,30,27
1657033292601,MATH 20E,A01,083771,Ganguly; Soumya,5,0,32,27
1657033292601,MATH 20E,A02,083772,Ganguly; Soumya,6,0,32,26
1657033292601,MATH 20E,B01,083773,Ciotti; Benjamin,18,0,35,17
1657033292601,MATH 20E,B02,083774,Ciotti; Benjamin,17,0,35,18
1657033298638,MATH 103A,A01,083777,Greenfeld; Be'Eri,2,0,36,34
1657033298638,MATH 103A,A02,083778,Greenfeld; Be'Eri,5,0,36,31
1657033298638,MATH 103A,A03,093561,Greenfeld; Be'Eri,4,0,36,32
1657033298638,MATH 103A,B01,083779,Greenfeld; Be'Eri,6,0,36,30
1657033298638,MATH 103A,B02,083780,Greenfeld; Be'Eri,2,0,36,34
1657033298638,MATH 103A,B03,093562,Greenfeld; Be'Eri,2,0,36,34
1657033304662,MATH 105,A01,085443,Carter; Anne Toulson,14,0,35,21
1657033304662,MATH 105,A02,093477,Carter; Anne Toulson,20,0,35,15
1657033310694,MATH 109,A01,083213,Ganzberger; Geoffrey Michael,2,0,34,32
1657033310694,MATH 109,A02,083214,Ganzberger; Geoffrey Michael,2,0,34,32
1657033310694,MATH 109,A03,093478,Ganzberger; Geoffrey Michael,1,0,34,33
1657033310694,MATH 109,B01,083215,Ganzberger; Geoffrey Michael,1,0,32,31
1657033310694,MATH 109,B02,083216,Ganzberger; Geoffrey Michael,1,0,32,31
1657033310694,MATH 109,B03,093479,Ganzberger; Geoffrey Michael,6,0,32,26
1657033316720,MATH 142A,A01,083219,Chow; Bennett,6,0,32,26
1657033316720,MATH 142A,A02,083220,Chow; Bennett,10,0,32,22
1657033316720,MATH 142A,A03,093480,Chow; Bennett,7,0,32,25
1657033316720,MATH 142A,B03,093481,Chow; Bennett,7,0,32,25
1657033316720,MATH 142A,B04,093558,Chow; Bennett,11,0,32,21
1657033316720,MATH 142A,B05,093559,Chow; Bennett,6,0,32,26
1657033322748,MATH 193A,A01,083224,Rotar; Vladimir,7,0,34,27
1657033322748,MATH 193A,A02,083225,Rotar; Vladimir,5,0,34,29
1657033322748,MATH 193A,A03,083781,Rotar; Vladimir,1,0,34,33
1657033322748,MATH 193A,A04,083782,Rotar; Vladimir,6,0,34,28
1657033322748,MATH 193A,A05,093482,Rotar; Vladimir,6,0,34,28
1657033328776,MATH 197,001,091859,McAuley; Julian John,9999,0,9999,0
1657033328776,MATH 197,002,095566,Kedlaya; Kiran S.,9997,0,9999,2
1657033328776,MATH 197,003,095567,Xiao; Ming,9999,0,9999,0
1657033328776,MATH 197,004,095571,Perols; Johan Lars,9998,0,9999,1
1657033335830,COGS 9,A01,083615,Shannon; Kyle Michael,7,0,75,68
1657033341858,COGS 11,A01,083617,Boyle; Mary E. T.,20,0,48,28
1657033347885,COGS 13,A01,083071,Bastos; Amalia Pinkusfeld,9,0,71,62
1657033353910,COGS 14A,A01,092681,Semenuks; Arturs,0,1,100,100
1657033359932,COGS 14B,A01,083073,Cheng; Tzu-Han,5,0,63,58
1657033365956,COGS 17,A01,092677,Semenuks; Arturs,4,0,81,77
1657033371989,COGS 100,A01,083619,Allen; Michael Gordon,15,0,70,55
1657033378013,COGS 101A,A01,083621,Davis; Joshua Daniel,9,0,68,59
1657033384040,COGS 101B,A01,091572,Allen; Michael Gordon,8,0,65,57
1657033390065,COGS 101C,A01,083625,Delgado; Tania,17,0,35,18
1657033396093,COGS 107A,A01,083627,Boyle; Mary E. T.,13,0,60,47
1657033402123,COGS 118A,A01,083075,Gupta; Anjum,15,0,76,61
1657033408163,CSE 3,A50,083646,Miranda; Gregory Joseph,22,0,50,28
1657033414192,CSE 8A,A50,083650,Miranda; Gregory Joseph,17,1,56,39
1657033420220,CSE 11,A01,083080,Cao; Yingjun,4,15,40,36
1657033426247,CSE 12,A01,083652,Krause-Levy; Sophia Louisa,21,1,120,99
1657033432276,CSE 15L,A01,083654,Morris; Justin Loren,8,0,50,42
1657033432276,CSE 15L,A02,083655,Morris; Justin Loren,9,0,50,41
1657033438300,CSE 20,A01,083657,Tran; Khoa Dang,37,0,80,43
1657033444335,CSE 21,A01,095574,Bach; Quang Tran,21,0,48,27
1657033450364,CSE 30,A01,083084,Eldon; John,4,0,80,76
1657033450364,CSE 30,B01,095061,Bhaskar; Nishant,6,0,50,44
1657033456391,CSE 100,A01,083659,Cao; Yingjun,3,4,70,67
1657033462415,CSE 134B,A01,083661,Powell; Thomas Allan,19,0,100,81
1657033468442,CSE 140,A01,083663,Gungor; Onat,14,0,85,71
1657033474469,CSE 140L,A01,083088,Eldon; John,16,0,100,84
1657033480495,CSE 175,A01,083665,Kumar; Rakesh,3,0,25,22
1657033486522,CSE 190,A00,092507,Dubnov; Shlomo,7,0,20,13
1657033492552,ECE 45,A01,083139,Congero; Spencer William,5,0,75,70
1657033498578,ECE 65,A50,083695,Saad; Andrew S,12,0,30,18
1657033498578,ECE 65,A51,095125,Saad; Andrew S,25,0,26,1
1657033504601,ECE 109,A01,091882,Touri; Behrouz,16,0,70,54
1657033510629,ECE 180,A00,083140,Abi Samra; Nicholas Camill,1,0,30,29
1657033510629,ECE 180,B00,083141,Abi Samra; Nicholas Camill,0,0,30,30
1657033516655,MATH 10A,A01,083735,Patchell; Gregory David,1,0,30,29
1657033516655,MATH 10A,A02,083736,Patchell; Gregory David,20,0,30,10
1657033516655,MATH 10A,A03,083737,Patchell; Gregory David,16,0,30,14
1657033522688,MATH 10B,A01,083207,Lim; Seonhee,7,0,34,27
1657033522688,MATH 10B,A02,083208,Lim; Seonhee,9,0,35,26
1657033522688,MATH 10B,A03,093472,Lim; Seonhee,4,0,34,30
1657033522688,MATH 10B,B01,083739,Sinha; Shubham,9,0,30,21
1657033528712,MATH 18,A01,083743,Cinel; Cameron Alexander,6,0,30,24
1657033528712,MATH 18,A02,083744,Cinel; Cameron Alexander,15,0,30,15
1657033528712,MATH 18,A03,083745,Cinel; Cameron Alexander,8,0,30,22
1657033528712,MATH 18,B01,083748,Rideout; David Porter,4,0,37,33
1657033528712,MATH 18,B02,083749,Rideout; David Porter,3,0,36,33
1657033528712,MATH 18,B03,083750,Rideout; David Porter,2,0,37,35
1657033528712,MATH 18,B04,083751,Rideout; David Porter,5,0,36,31
1657033528712,MATH 18,B05,093473,Rideout; David Porter,4,0,36,32
1657033528712,MATH 18,B06,093474,Rideout; David Porter,5,0,36,31
1657033534736,MATH 20A,A01,083754,Zheng; Zequn,12,0,40,28
1657033540758,MATH 20B,A01,083756,Briones; Jor-el Thomas Caparas,1,0,36,35
1657033540758,MATH 20B,A02,083757,Briones; Jor-el Thomas Caparas,1,0,36,35
1657033540758,MATH 20B,A03,093475,Briones; Jor-el Thomas Caparas,0,0,36,36
1657033546784,MATH 20C,A01,083760,Briones; Jor-el Thomas Caparas,1,0,35,34
1657033546784,MATH 20C,A02,083761,Briones; Jor-el Thomas Caparas,8,0,35,27
1657033546784,MATH 20C,A03,093476,Briones; Jor-el Thomas Caparas,0,1,36,36
1657033546784,MATH 20C,B01,083762,Bach; Quang Tran,0,0,30,30
1657033552808,MATH 20D,A01,083765,Tran; Brian Kha,4,0,30,26
1657033552808,MATH 20D,A02,083766,Tran; Brian Kha,5,0,30,25
1657033552808,MATH 20D,A03,083767,Tran; Brian Kha,3,0,30,27
1657033558837,MATH 20E,A01,083771,Ganguly; Soumya,5,0,32,27
1657033558837,MATH 20E,A02,083772,Ganguly; Soumya,6,0,32,26
1657033558837,MATH 20E,B01,083773,Ciotti; Benjamin,18,0,35,17
1657033558837,MATH 20E,B02,083774,Ciotti; Benjamin,17,0,35,18
1657033564867,MATH 103A,A01,083777,Greenfeld; Be'Eri,2,0,36,34
1657033564867,MATH 103A,A02,083778,Greenfeld; Be'Eri,5,0,36,31
1657033564867,MATH 103A,A03,093561,Greenfeld; Be'Eri,4,0,36,32
1657033564867,MATH 103A,B01,083779,Greenfeld; Be'Eri,6,0,36,30
1657033564867,MATH 103A,B02,083780,Greenfeld; Be'Eri,2,0,36,34
1657033564867,MATH 103A,B03,093562,Greenfeld; Be'Eri,2,0,36,34
1657033570899,MATH 105,A01,085443,Carter; Anne Toulson,14,0,35,21
1657033570899,MATH 105,A02,093477,Carter; Anne Toulson,20,0,35,15
1657033576938,MATH 109,A01,083213,Ganzberger; Geoffrey Michael,2,0,34,32
1657033576938,MATH 109,A02,083214,Ganzberger; Geoffrey Michael,2,0,34,32
1657033576938,MATH 109,A03,093478,Ganzberger; Geoffrey Michael,1,0,34,33
1657033576938,MATH 109,B01,083215,Ganzberger; Geoffrey Michael,1,0,32,31
1657033576938,MATH 109,B02,083216,Ganzberger; Geoffrey Michael,1,0,32,31
1657033576938,MATH 109,B03,093479,Ganzberger; Geoffrey Michael,6,0,32,26
1657033582965,MATH 142A,A01,083219,Chow; Bennett,6,0,32,26
1657033582965,MATH 142A,A02,083220,Chow; Bennett,10,0,32,22
1657033582965,MATH 142A,A03,093480,Chow; Bennett,7,0,32,25
1657033582965,MATH 142A,B03,093481,Chow; Bennett,7,0,32,25
1657033582965,MATH 142A,B04,093558,Chow; Bennett,11,0,32,21
1657033582965,MATH 142A,B05,093559,Chow; Bennett,6,0,32,26
1657033588989,MATH 193A,A01,083224,Rotar; Vladimir,7,0,34,27
1657033588989,MATH 193A,A02,083225,Rotar; Vladimir,5,0,34,29
1657033588989,MATH 193A,A03,083781,Rotar; Vladimir,1,0,34,33
1657033588989,MATH 193A,A04,083782,Rotar; Vladimir,6,0,34,28
1657033588989,MATH 193A,A05,093482,Rotar; Vladimir,6,0,34,28
1657033595018,MATH 197,001,091859,McAuley; Julian John,9999,0,9999,0
1657033595018,MATH 197,002,095566,Kedlaya; Kiran S.,9997,0,9999,2
1657033595018,MATH 197,003,095567,Xiao; Ming,9999,0,9999,0
1657033595018,MATH 197,004,095571,Perols; Johan Lars,9998,0,9999,1
1657033602080,COGS 9,A01,083615,Shannon; Kyle Michael,7,0,75,68
1657033608109,COGS 11,A01,083617,Boyle; Mary E. T.,20,0,48,28
1657033614136,COGS 13,A01,083071,Bastos; Amalia Pinkusfeld,9,0,71,62
1657033620165,COGS 14A,A01,092681,Semenuks; Arturs,0,1,100,100
1657033626193,COGS 14B,A01,083073,Cheng; Tzu-Han,5,0,63,58
1657033632224,COGS 17,A01,092677,Semenuks; Arturs,4,0,81,77
1657033638252,COGS 100,A01,083619,Allen; Michael Gordon,15,0,70,55
1657033644280,COGS 101A,A01,083621,Davis; Joshua Daniel,9,0,68,59
1657033650304,COGS 101B,A01,091572,Allen; Michael Gordon,8,0,65,57
1657033656333,COGS 101C,A01,083625,Delgado; Tania,17,0,35,18
1657033662356,COGS 107A,A01,083627,Boyle; Mary E. T.,13,0,60,47
1657033668379,COGS 118A,A01,083075,Gupta; Anjum,15,0,76,61
1657033674413,CSE 3,A50,083646,Miranda; Gregory Joseph,22,0,50,28
1657033680562,CSE 8A,A50,083650,Miranda; Gregory Joseph,17,1,56,39
1657033686589,CSE 11,A01,083080,Cao; Yingjun,4,15,40,36
1657033692617,CSE 12,A01,083652,Krause-Levy; Sophia Louisa,21,1,120,99
1657033698641,CSE 15L,A01,083654,Morris; Justin Loren,8,0,50,42
1657033698641,CSE 15L,A02,083655,Morris; Justin Loren,9,0,50,41
1657033704673,CSE 20,A01,083657,Tran; Khoa Dang,37,0,80,43
1657033710696,CSE 21,A01,095574,Bach; Quang Tran,21,0,48,27
1657033716725,CSE 30,A01,083084,Eldon; John,4,0,80,76
1657033716725,CSE 30,B01,095061,Bhaskar; Nishant,6,0,50,44
1657033722752,CSE 100,A01,083659,Cao; Yingjun,3,4,70,67
1657033728775,CSE 134B,A01,083661,Powell; Thomas Allan,19,0,100,81
1657033734797,CSE 140,A01,083663,Gungor; Onat,14,0,85,71
1657033740829,CSE 140L,A01,083088,Eldon; John,16,0,100,84
1657033746853,CSE 175,A01,083665,Kumar; Rakesh,3,0,25,22
1657033752877,CSE 190,A00,092507,Dubnov; Shlomo,7,0,20,13
1657033758902,ECE 45,A01,083139,Congero; Spencer William,5,0,75,70
1657033764928,ECE 65,A50,083695,Saad; Andrew S,12,0,30,18
1657033764928,ECE 65,A51,095125,Saad; Andrew S,25,0,26,1
1657033770957,ECE 109,A01,091882,Touri; Behrouz,16,0,70,54
1657033776981,ECE 180,A00,083140,Abi Samra; Nicholas Camill,1,0,30,29
1657033776981,ECE 180,B00,083141,Abi Samra; Nicholas Camill,0,0,30,30
1657033783009,MATH 10A,A01,083735,Patchell; Gregory David,1,0,30,29
1657033783009,MATH 10A,A02,083736,Patchell; Gregory David,20,0,30,10
1657033783009,MATH 10A,A03,083737,Patchell; Gregory David,16,0,30,14
1657033789034,MATH 10B,A01,083207,Lim; Seonhee,7,0,34,27
1657033789034,MATH 10B,A02,083208,Lim; Seonhee,9,0,35,26
1657033789034,MATH 10B,A03,093472,Lim; Seonhee,4,0,34,30
1657033789034,MATH 10B,B01,083739,Sinha; Shubham,9,0,30,21
1657033795066,MATH 18,A01,083743,Cinel; Cameron Alexander,6,0,30,24
1657033795066,MATH 18,A02,083744,Cinel; Cameron Alexander,15,0,30,15
1657033795066,MATH 18,A03,083745,Cinel; Cameron Alexander,8,0,30,22
1657033795066,MATH 18,B01,083748,Rideout; David Porter,4,0,37,33
1657033795066,MATH 18,B02,083749,Rideout; David Porter,3,0,36,33
1657033795066,MATH 18,B03,083750,Rideout; David Porter,2,0,37,35
1657033795066,MATH 18,B04,083751,Rideout; David Porter,5,0,36,31
1657033795066,MATH 18,B05,093473,Rideout; David Porter,4,0,36,32
1657033795066,MATH 18,B06,093474,Rideout; David Porter,5,0,36,31
1657033801094,MATH 20A,A01,083754,Zheng; Zequn,12,0,40,28
1657033807119,MATH 20B,A01,083756,Briones; Jor-el Thomas Caparas,1,0,36,35
1657033807119,MATH 20B,A02,083757,Briones; Jor-el Thomas Caparas,1,0,36,35
1657033807119,MATH 20B,A03,093475,Briones; Jor-el Thomas Caparas,0,0,36,36
1657033813147,MATH 20C,A01,083760,Briones; Jor-el Thomas Caparas,1,0,35,34
1657033813147,MATH 20C,A02,083761,Briones; Jor-el Thomas Caparas,8,0,35,27
1657033813147,MATH 20C,A03,093476,Briones; Jor-el Thomas Caparas,0,1,36,36
1657033813147,MATH 20C,B01,083762,Bach; Quang Tran,0,0,30,30
1657033819177,MATH 20D,A01,083765,Tran; Brian Kha,4,0,30,26
1657033819177,MATH 20D,A02,083766,Tran; Brian Kha,5,0,30,25
1657033819177,MATH 20D,A03,083767,Tran; Brian Kha,3,0,30,27
1657033825209,MATH 20E,A01,083771,Ganguly; Soumya,5,0,32,27
1657033825209,MATH 20E,A02,083772,Ganguly; Soumya,6,0,32,26
1657033825209,MATH 20E,B01,083773,Ciotti; Benjamin,18,0,35,17
1657033825209,MATH 20E,B02,083774,Ciotti; Benjamin,17,0,35,18
1657033831245,MATH 103A,A01,083777,Greenfeld; Be'Eri,2,0,36,34
1657033831245,MATH 103A,A02,083778,Greenfeld; Be'Eri,5,0,36,31
1657033831245,MATH 103A,A03,093561,Greenfeld; Be'Eri,4,0,36,32
1657033831245,MATH 103A,B01,083779,Greenfeld; Be'Eri,6,0,36,30
1657033831245,MATH 103A,B02,083780,Greenfeld; Be'Eri,2,0,36,34
1657033831245,MATH 103A,B03,093562,Greenfeld; Be'Eri,2,0,36,34
1657033837274,MATH 105,A01,085443,Carter; Anne Toulson,14,0,35,21
1657033837274,MATH 105,A02,093477,Carter; Anne Toulson,20,0,35,15
1657033843304,MATH 109,A01,083213,Ganzberger; Geoffrey Michael,2,0,34,32
1657033843304,MATH 109,A02,083214,Ganzberger; Geoffrey Michael,2,0,34,32
1657033843304,MATH 109,A03,093478,Ganzberger; Geoffrey Michael,1,0,34,33
1657033843304,MATH 109,B01,083215,Ganzberger; Geoffrey Michael,1,0,32,31
1657033843304,MATH 109,B02,083216,Ganzberger; Geoffrey Michael,1,0,32,31
1657033843304,MATH 109,B03,093479,Ganzberger; Geoffrey Michael,6,0,32,26
1657033849330,MATH 142A,A01,083219,Chow; Bennett,6,0,32,26
1657033849330,MATH 142A,A02,083220,Chow; Bennett,10,0,32,22
1657033849330,MATH 142A,A03,093480,Chow; Bennett,7,0,32,25
1657033849330,MATH 142A,B03,093481,Chow; Bennett,7,0,32,25
1657033849330,MATH 142A,B04,093558,Chow; Bennett,11,0,32,21
1657033849330,MATH 142A,B05,093559,Chow; Bennett,6,0,32,26
1657033855355,MATH 193A,A01,083224,Rotar; Vladimir,7,0,34,27
1657033855355,MATH 193A,A02,083225,Rotar; Vladimir,5,0,34,29
1657033855355,MATH 193A,A03,083781,Rotar; Vladimir,1,0,34,33
1657033855355,MATH 193A,A04,083782,Rotar; Vladimir,6,0,34,28
1657033855355,MATH 193A,A05,093482,Rotar; Vladimir,6,0,34,28
1657033861379,MATH 197,001,091859,McAuley; Julian John,9999,0,9999,0
1657033861379,MATH 197,002,095566,Kedlaya; Kiran S.,9997,0,9999,2
1657033861379,MATH 197,003,095567,Xiao; Ming,9999,0,9999,0
1657033861379,MATH 197,004,095571,Perols; Johan Lars,9998,0,9999,1
1657033868435,COGS 9,A01,083615,Shannon; Kyle Michael,7,0,75,68
1657033874460,COGS 11,A01,083617,Boyle; Mary E. T.,20,0,48,28
1657033880489,COGS 13,A01,083071,Bastos; Amalia Pinkusfeld,9,0,71,62
1657033886519,COGS 14A,A01,092681,Semenuks; Arturs,0,1,100,100
1657033892543,COGS 14B,A01,083073,Cheng; Tzu-Han,5,0,63,58
1657033898568,COGS 17,A01,092677,Semenuks; Arturs,4,0,81,77
1657033904598,COGS 100,A01,083619,Allen; Michael Gordon,15,0,70,55
1657033910623,COGS 101A,A01,083621,Davis; Joshua Daniel,9,0,68,59
1657033916661,COGS 101B,A01,091572,Allen; Michael Gordon,8,0,65,57
1657033922691,COGS 101C,A01,083625,Delgado; Tania,17,0,35,18
1657033928719,COGS 107A,A01,083627,Boyle; Mary E. T.,13,0,60,47
1657033934749,COGS 118A,A01,083075,Gupta; Anjum,15,0,76,61
1657033940788,CSE 3,A50,083646,Miranda; Gregory Joseph,22,0,50,28
1657033946817,CSE 8A,A50,083650,Miranda; Gregory Joseph,17,1,56,39
1657033952845,CSE 11,A01,083080,Cao; Yingjun,4,15,40,36
1657033958870,CSE 12,A01,083652,Krause-Levy; Sophia Louisa,21,1,120,99
1657033964898,CSE 15L,A01,083654,Morris; Justin Loren,8,0,50,42
1657033964898,CSE 15L,A02,083655,Morris; Justin Loren,9,0,50,41
1657033970925,CSE 20,A01,083657,Tran; Khoa Dang,37,0,80,43
1657033976950,CSE 21,A01,095574,Bach; Quang Tran,21,0,48,27
1657033982974,CSE 30,A01,083084,Eldon; John,4,0,80,76
1657033982974,CSE 30,B01,095061,Bhaskar; Nishant,6,0,50,44
1657033989003,CSE 100,A01,083659,Cao; Yingjun,3,4,70,67
1657033995026,CSE 134B,A01,083661,Powell; Thomas Allan,19,0,100,81
1657034001049,CSE 140,A01,083663,Gungor; Onat,14,0,85,71
1657034007079,CSE 140L,A01,083088,Eldon; John,16,0,100,84
1657034013102,CSE 175,A01,083665,Kumar; Rakesh,3,0,25,22
1657034019126,CSE 190,A00,092507,Dubnov; Shlomo,7,0,20,13
1657034025150,ECE 45,A01,083139,Congero; Spencer William,5,0,75,70
1657034031175,ECE 65,A50,083695,Saad; Andrew S,12,0,30,18
1657034031175,ECE 65,A51,095125,Saad; Andrew S,25,0,26,1
1657034037202,ECE 109,A01,091882,Touri; Behrouz,16,0,70,54
1657034043230,ECE 180,A00,083140,Abi Samra; Nicholas Camill,1,0,30,29
1657034043230,ECE 180,B00,083141,Abi Samra; Nicholas Camill,0,0,30,30
1657034049255,MATH 10A,A01,083735,Patchell; Gregory David,1,0,30,29
1657034049255,MATH 10A,A02,083736,Patchell; Gregory David,20,0,30,10
1657034049255,MATH 10A,A03,083737,Patchell; Gregory David,16,0,30,14
1657034055284,MATH 10B,A01,083207,Lim; Seonhee,7,0,34,27
1657034055284,MATH 10B,A02,083208,Lim; Seonhee,9,0,35,26
1657034055284,MATH 10B,A03,093472,Lim; Seonhee,4,0,34,30
1657034055284,MATH 10B,B01,083739,Sinha; Shubham,9,0,30,21
1657034061316,MATH 18,A01,083743,Cinel; Cameron Alexander,6,0,30,24
1657034061316,MATH 18,A02,083744,Cinel; Cameron Alexander,15,0,30,15
1657034061316,MATH 18,A03,083745,Cinel; Cameron Alexander,8,0,30,22
1657034061316,MATH 18,B01,083748,Rideout; David Porter,4,0,37,33
1657034061316,MATH 18,B02,083749,Rideout; David Porter,3,0,36,33
1657034061316,MATH 18,B03,083750,Rideout; David Porter,2,0,37,35
1657034061316,MATH 18,B04,083751,Rideout; David Porter,5,0,36,31
1657034061316,MATH 18,B05,093473,Rideout; David Porter,4,0,36,32
1657034061316,MATH 18,B06,093474,Rideout; David Porter,5,0,36,31
1657034067341,MATH 20A,A01,083754,Zheng; Zequn,12,0,40,28
1657034073365,MATH 20B,A01,083756,Briones; Jor-el Thomas Caparas,1,0,36,35
1657034073365,MATH 20B,A02,083757,Briones; Jor-el Thomas Caparas,1,0,36,35
1657034073365,MATH 20B,A03,093475,Briones; Jor-el Thomas Caparas,0,0,36,36
1657034079403,MATH 20C,A01,083760,Briones; Jor-el Thomas Caparas,1,0,35,34
1657034079403,MATH 20C,A02,083761,Briones; Jor-el Thomas Caparas,8,0,35,27
1657034079403,MATH 20C,A03,093476,Briones; Jor-el Thomas Caparas,0,1,36,36
1657034079403,MATH 20C,B01,083762,Bach; Quang Tran,0,0,30,30
1657034085429,MATH 20D,A01,083765,Tran; Brian Kha,4,0,30,26
1657034085429,MATH 20D,A02,083766,Tran; Brian Kha,5,0,30,25
1657034085429,MATH 20D,A03,083767,Tran; Brian Kha,3,0,30,27
1657034091454,MATH 20E,A01,083771,Ganguly; Soumya,5,0,32,27
1657034091454,MATH 20E,A02,083772,Ganguly; Soumya,6,0,32,26
1657034091454,MATH 20E,B01,083773,Ciotti; Benjamin,18,0,35,17
1657034091454,MATH 20E,B02,083774,Ciotti; Benjamin,17,0,35,18
1657034097479,MATH 103A,A01,083777,Greenfeld; Be'Eri,2,0,36,34
1657034097479,MATH 103A,A02,083778,Greenfeld; Be'Eri,5,0,36,31
1657034097479,MATH 103A,A03,093561,Greenfeld; Be'Eri,4,0,36,32
1657034097479,MATH 103A,B01,083779,Greenfeld; Be'Eri,6,0,36,30
1657034097479,MATH 103A,B02,083780,Greenfeld; Be'Eri,2,0,36,34
1657034097479,MATH 103A,B03,093562,Greenfeld; Be'Eri,2,0,36,34
1657034103529,MATH 105,A01,085443,Carter; Anne Toulson,14,0,35,21
1657034103529,MATH 105,A02,093477,Carter; Anne Toulson,20,0,35,15
1657034109559,MATH 109,A01,083213,Ganzberger; Geoffrey Michael,2,0,34,32
1657034109559,MATH 109,A02,083214,Ganzberger; Geoffrey Michael,2,0,34,32
1657034109559,MATH 109,A03,093478,Ganzberger; Geoffrey Michael,1,0,34,33
1657034109559,MATH 109,B01,083215,Ganzberger; Geoffrey Michael,1,0,32,31
1657034109559,MATH 109,B02,083216,Ganzberger; Geoffrey Michael,1,0,32,31
1657034109559,MATH 109,B03,093479,Ganzberger; Geoffrey Michael,6,0,32,26
1657034115583,MATH 142A,A01,083219,Chow; Bennett,6,0,32,26
1657034115583,MATH 142A,A02,083220,Chow; Bennett,10,0,32,22
1657034115583,MATH 142A,A03,093480,Chow; Bennett,7,0,32,25
1657034115583,MATH 142A,B03,093481,Chow; Bennett,7,0,32,25
1657034115583,MATH 142A,B04,093558,Chow; Bennett,11,0,32,21
1657034115583,MATH 142A,B05,093559,Chow; Bennett,6,0,32,26
1657034121608,MATH 193A,A01,083224,Rotar; Vladimir,7,0,34,27
1657034121608,MATH 193A,A02,083225,Rotar; Vladimir,5,0,34,29
1657034121608,MATH 193A,A03,083781,Rotar; Vladimir,1,0,34,33
1657034121608,MATH 193A,A04,083782,Rotar; Vladimir,6,0,34,28
1657034121608,MATH 193A,A05,093482,Rotar; Vladimir,6,0,34,28
1657034127630,MATH 197,001,091859,McAuley; Julian John,9999,0,9999,0
1657034127630,MATH 197,002,095566,Kedlaya; Kiran S.,9997,0,9999,2
1657034127630,MATH 197,003,095567,Xiao; Ming,9999,0,9999,0
1657034127630,MATH 197,004,095571,Perols; Johan Lars,9998,0,9999,1
1657034134686,COGS 9,A01,083615,Shannon; Kyle Michael,7,0,75,68
1657034140708,COGS 11,A01,083617,Boyle; Mary E. T.,20,0,48,28
1657034146738,COGS 13,A01,083071,Bastos; Amalia Pinkusfeld,9,0,71,62
1657034152764,COGS 14A,A01,092681,Semenuks; Arturs,0,1,100,100
1657034158786,COGS 14B,A01,083073,Cheng; Tzu-Han,5,0,63,58
1657034164815,COGS 17,A01,092677,Semenuks; Arturs,4,0,81,77
1657034170842,COGS 100,A01,083619,Allen; Michael Gordon,15,0,70,55
1657034176870,COGS 101A,A01,083621,Davis; Joshua Daniel,9,0,68,59
1657034182894,COGS 101B,A01,091572,Allen; Michael Gordon,8,0,65,57
1657034188923,COGS 101C,A01,083625,Delgado; Tania,17,0,35,18
1657034194945,COGS 107A,A01,083627,Boyle; Mary E. T.,13,0,60,47
1657034200974,COGS 118A,A01,083075,Gupta; Anjum,15,0,76,61
1657034207008,CSE 3,A50,083646,Miranda; Gregory Joseph,22,0,50,28
1657034213034,CSE 8A,A50,083650,Miranda; Gregory Joseph,17,1,56,39
1657034219063,CSE 11,A01,083080,Cao; Yingjun,4,15,40,36
1657034225086,CSE 12,A01,083652,Krause-Levy; Sophia Louisa,21,1,120,99
1657034231114,CSE 15L,A01,083654,Morris; Justin Loren,8,0,50,42
1657034231114,CSE 15L,A02,083655,Morris; Justin Loren,9,0,50,41
1657034237138,CSE 20,A01,083657,Tran; Khoa Dang,37,0,80,43
1657034243164,CSE 21,A01,095574,Bach; Quang Tran,21,0,48,27
1657034249202,CSE 30,A01,083084,Eldon; John,4,0,80,76
1657034249202,CSE 30,B01,095061,Bhaskar; Nishant,6,0,50,44
1657034255230,CSE 100,A01,083659,Cao; Yingjun,3,4,70,67
1657034261254,CSE 134B,A01,083661,Powell; Thomas Allan,19,0,100,81
1657034267285,CSE 140,A01,083663,Gungor; Onat,14,0,85,71
1657034273310,CSE 140L,A01,083088,Eldon; John,16,0,100,84
1657034279408,CSE 175,A01,083665,Kumar; Rakesh,3,0,25,22
1657034285435,CSE 190,A00,092507,Dubnov; Shlomo,7,0,20,13
1657034291457,ECE 45,A01,083139,Congero; Spencer William,5,0,75,70
1657034297496,ECE 65,A50,083695,Saad; Andrew S,12,0,30,18
1657034297496,ECE 65,A51,095125,Saad; Andrew S,25,0,26,1
1657034303527,ECE 109,A01,091882,Touri; Behrouz,16,0,70,54
1657034309551,ECE 180,A00,083140,Abi Samra; Nicholas Camill,1,0,30,29
1657034309551,ECE 180,B00,083141,Abi Samra; Nicholas Camill,0,0,30,30
1657034315577,MATH 10A,A01,083735,Patchell; Gregory David,1,0,30,29
1657034315577,MATH 10A,A02,083736,Patchell; Gregory David,20,0,30,10
1657034315577,MATH 10A,A03,083737,Patchell; Gregory David,16,0,30,14
1657034321606,MATH 10B,A01,083207,Lim; Seonhee,7,0,34,27
1657034321606,MATH 10B,A02,083208,Lim; Seonhee,9,0,35,26
1657034321606,MATH 10B,A03,093472,Lim; Seonhee,4,0,34,30
1657034321606,MATH 10B,B01,083739,Sinha; Shubham,9,0,30,21
1657034327638,MATH 18,A01,083743,Cinel; Cameron Alexander,6,0,30,24
1657034327638,MATH 18,A02,083744,Cinel; Cameron Alexander,15,0,30,15
1657034327638,MATH 18,A03,083745,Cinel; Cameron Alexander,8,0,30,22
1657034327638,MATH 18,B01,083748,Rideout; David Porter,4,0,37,33
1657034327638,MATH 18,B02,083749,Rideout; David Porter,3,0,36,33
1657034327638,MATH 18,B03,083750,Rideout; David Porter,2,0,37,35
1657034327638,MATH 18,B04,083751,Rideout; David Porter,5,0,36,31
1657034327638,MATH 18,B05,093473,Rideout; David Porter,4,0,36,32
1657034327638,MATH 18,B06,093474,Rideout; David Porter,5,0,36,31
1657034333662,MATH 20A,A01,083754,Zheng; Zequn,12,0,40,28
1657034339696,MATH 20B,A01,083756,Briones; Jor-el Thomas Caparas,1,0,36,35
1657034339696,MATH 20B,A02,083757,Briones; Jor-el Thomas Caparas,1,0,36,35
1657034339696,MATH 20B,A03,093475,Briones; Jor-el Thomas Caparas,0,0,36,36
1657034345720,MATH 20C,A01,083760,Briones; Jor-el Thomas Caparas,1,0,35,34
1657034345720,MATH 20C,A02,083761,Briones; Jor-el Thomas Caparas,8,0,35,27
1657034345720,MATH 20C,A03,093476,Briones; Jor-el Thomas Caparas,0,1,36,36
1657034345720,MATH 20C,B01,083762,Bach; Quang Tran,0,0,30,30
1657034351745,MATH 20D,A01,083765,Tran; Brian Kha,4,0,30,26
1657034351745,MATH 20D,A02,083766,Tran; Brian Kha,5,0,30,25
1657034351745,MATH 20D,A03,083767,Tran; Brian Kha,3,0,30,27
1657034357774,MATH 20E,A01,083771,Ganguly; Soumya,5,0,32,27
1657034357774,MATH 20E,A02,083772,Ganguly; Soumya,6,0,32,26
1657034357774,MATH 20E,B01,083773,Ciotti; Benjamin,18,0,35,17
1657034357774,MATH 20E,B02,083774,Ciotti; Benjamin,17,0,35,18
1657034363803,MATH 103A,A01,083777,Greenfeld; Be'Eri,2,0,36,34
1657034363803,MATH 103A,A02,083778,Greenfeld; Be'Eri,5,0,36,31
1657034363803,MATH 103A,A03,093561,Greenfeld; Be'Eri,4,0,36,32
1657034363803,MATH 103A,B01,083779,Greenfeld; Be'Eri,6,0,36,30
1657034363803,MATH 103A,B02,083780,Greenfeld; Be'Eri,2,0,36,34
1657034363803,MATH 103A,B03,093562,Greenfeld; Be'Eri,2,0,36,34
1657034369832,MATH 105,A01,085443,Carter; Anne Toulson,14,0,35,21
1657034369832,MATH 105,A02,093477,Carter; Anne Toulson,20,0,35,15
1657034375862,MATH 109,A01,083213,Ganzberger; Geoffrey Michael,2,0,34,32
1657034375862,MATH 109,A02,083214,Ganzberger; Geoffrey Michael,2,0,34,32
1657034375862,MATH 109,A03,093478,Ganzberger; Geoffrey Michael,1,0,34,33
1657034375862,MATH 109,B01,083215,Ganzberger; Geoffrey Michael,1,0,32,31
1657034375862,MATH 109,B02,083216,Ganzberger; Geoffrey Michael,1,0,32,31
1657034375862,MATH 109,B03,093479,Ganzberger; Geoffrey Michael,6,0,32,26
1657034381899,MATH 142A,A01,083219,Chow; Bennett,6,0,32,26
1657034381899,MATH 142A,A02,083220,Chow; Bennett,10,0,32,22
1657034381899,MATH 142A,A03,093480,Chow; Bennett,7,0,32,25
1657034381899,MATH 142A,B03,093481,Chow; Bennett,7,0,32,25
1657034381899,MATH 142A,B04,093558,Chow; Bennett,11,0,32,21
1657034381899,MATH 142A,B05,093559,Chow; Bennett,6,0,32,26
1657034387925,MATH 193A,A01,083224,Rotar; Vladimir,7,0,34,27
1657034387925,MATH 193A,A02,083225,Rotar; Vladimir,5,0,34,29
1657034387925,MATH 193A,A03,083781,Rotar; Vladimir,1,0,34,33
1657034387925,MATH 193A,A04,083782,Rotar; Vladimir,6,0,34,28
1657034387925,MATH 193A,A05,093482,Rotar; Vladimir,6,0,34,28
1657034393958,MATH 197,001,091859,McAuley; Julian John,9999,0,9999,0
1657034393958,MATH 197,002,095566,Kedlaya; Kiran S.,9997,0,9999,2
1657034393958,MATH 197,003,095567,Xiao; Ming,9999,0,9999,0
1657034393958,MATH 197,004,095571,Perols; Johan Lars,9998,0,9999,1
1657034401032,COGS 9,A01,083615,Shannon; Kyle Michael,7,0,75,68
1657034407055,COGS 11,A01,083617,Boyle; Mary E. T.,20,0,48,28
1657034413079,COGS 13,A01,083071,Bastos; Amalia Pinkusfeld,9,0,71,62
1657034419107,COGS 14A,A01,092681,Semenuks; Arturs,0,1,100,100
1657034425132,COGS 14B,A01,083073,Cheng; Tzu-Han,5,0,63,58
1657034431158,COGS 17,A01,092677,Semenuks; Arturs,4,0,81,77
1657034437184,COGS 100,A01,083619,Allen; Michael Gordon,15,0,70,55
1657034443213,COGS 101A,A01,083621,Davis; Joshua Daniel,9,0,68,59
1657034449237,COGS 101B,A01,091572,Allen; Michael Gordon,8,0,65,57
1657034455262,COGS 101C,A01,083625,Delgado; Tania,17,0,35,18
1657034461289,COGS 107A,A01,083627,Boyle; Mary E. T.,13,0,60,47
1657034467312,COGS 118A,A01,083075,Gupta; Anjum,15,0,76,61
1657034473341,CSE 3,A50,083646,Miranda; Gregory Joseph,22,0,50,28
1657034479369,CSE 8A,A50,083650,Miranda; Gregory Joseph,17,1,56,39
1657034485394,CSE 11,A01,083080,Cao; Yingjun,4,15,40,36
1657034491421,CSE 12,A01,083652,Krause-Levy; Sophia Louisa,21,1,120,99
1657034497444,CSE 15L,A01,083654,Morris; Justin Loren,8,0,50,42
1657034497444,CSE 15L,A02,083655,Morris; Justin Loren,9,0,50,41
1657034503472,CSE 20,A01,083657,Tran; Khoa Dang,37,0,80,43
1657034509500,CSE 21,A01,095574,Bach; Quang Tran,21,0,48,27
1657034515529,CSE 30,A01,083084,Eldon; John,4,0,80,76
1657034515529,CSE 30,B01,095061,Bhaskar; Nishant,6,0,50,44
1657034521554,CSE 100,A01,083659,Cao; Yingjun,3,4,70,67
1657034527586,CSE 134B,A01,083661,Powell; Thomas Allan,19,0,100,81
1657034533611,CSE 140,A01,083663,Gungor; Onat,14,0,85,71
1657034539639,CSE 140L,A01,083088,Eldon; John,16,0,100,84
1657034545666,CSE 175,A01,083665,Kumar; Rakesh,3,0,25,22
1657034551690,CSE 190,A00,092507,Dubnov; Shlomo,7,0,20,13
1657034557714,ECE 45,A01,083139,Congero; Spencer William,5,0,75,70
1657034563742,ECE 65,A50,083695,Saad; Andrew S,12,0,30,18
1657034563742,ECE 65,A51,095125,Saad; Andrew S,25,0,26,1
1657034569769,ECE 109,A01,091882,Touri; Behrouz,16,0,70,54
1657034575803,ECE 180,A00,083140,Abi Samra; Nicholas Camill,1,0,30,29
1657034575803,ECE 180,B00,083141,Abi Samra; Nicholas Camill,0,0,30,30
1657034581833,MATH 10A,A01,083735,Patchell; Gregory David,1,0,30,29
1657034581833,MATH 10A,A02,083736,Patchell; Gregory David,20,0,30,10
1657034581833,MATH 10A,A03,083737,Patchell; Gregory David,16,0,30,14
1657034587860,MATH 10B,A01,083207,Lim; Seonhee,7,0,34,27
1657034587860,MATH 10B,A02,083208,Lim; Seonhee,9,0,35,26
1657034587860,MATH 10B,A03,093472,Lim; Seonhee,4,0,34,30
1657034587860,MATH 10B,B01,083739,Sinha; Shubham,9,0,30,21
1657034593891,MATH 18,A01,083743,Cinel; Cameron Alexander,6,0,30,24
1657034593891,MATH 18,A02,083744,Cinel; Cameron Alexander,15,0,30,15
1657034593891,MATH 18,A03,083745,Cinel; Cameron Alexander,8,0,30,22
1657034593891,MATH 18,B01,083748,Rideout; David Porter,4,0,37,33
1657034593891,MATH 18,B02,083749,Rideout; David Porter,3,0,36,33
1657034593891,MATH 18,B03,083750,Rideout; David Porter,2,0,37,35
1657034593891,MATH 18,B04,083751,Rideout; David Porter,5,0,36,31
1657034593891,MATH 18,B05,093473,Rideout; David Porter,4,0,36,32
1657034593891,MATH 18,B06,093474,Rideout; David Porter,5,0,36,31
1657034599918,MATH 20A,A01,083754,Zheng; Zequn,12,0,40,28
1657034605942,MATH 20B,A01,083756,Briones; Jor-el Thomas Caparas,1,0,36,35
1657034605942,MATH 20B,A02,083757,Briones; Jor-el Thomas Caparas,1,0,36,35
1657034605942,MATH 20B,A03,093475,Briones; Jor-el Thomas Caparas,0,0,36,36
1657034611970,MATH 20C,A01,083760,Briones; Jor-el Thomas Caparas,1,0,35,34
1657034611970,MATH 20C,A02,083761,Briones; Jor-el Thomas Caparas,8,0,35,27
1657034611970,MATH 20C,A03,093476,Briones; Jor-el Thomas Caparas,0,1,36,36
1657034611970,MATH 20C,B01,083762,Bach; Quang Tran,0,0,30,30
1657034617995,MATH 20D,A01,083765,Tran; Brian Kha,4,0,30,26
1657034617995,MATH 20D,A02,083766,Tran; Brian Kha,5,0,30,25
1657034617995,MATH 20D,A03,083767,Tran; Brian Kha,3,0,30,27
1657034624021,MATH 20E,A01,083771,Ganguly; Soumya,5,0,32,27
1657034624021,MATH 20E,A02,083772,Ganguly; Soumya,6,0,32,26
1657034624021,MATH 20E,B01,083773,Ciotti; Benjamin,18,0,35,17
1657034624021,MATH 20E,B02,083774,Ciotti; Benjamin,17,0,35,18
1657034630057,MATH 103A,A01,083777,Greenfeld; Be'Eri,2,0,36,34
1657034630057,MATH 103A,A02,083778,Greenfeld; Be'Eri,5,0,36,31
1657034630057,MATH 103A,A03,093561,Greenfeld; Be'Eri,4,0,36,32
1657034630057,MATH 103A,B01,083779,Greenfeld; Be'Eri,6,0,36,30
1657034630057,MATH 103A,B02,083780,Greenfeld; Be'Eri,2,0,36,34
1657034630057,MATH 103A,B03,093562,Greenfeld; Be'Eri,2,0,36,34
1657034636083,MATH 105,A01,085443,Carter; Anne Toulson,14,0,35,21
1657034636083,MATH 105,A02,093477,Carter; Anne Toulson,20,0,35,15
1657034642112,MATH 109,A01,083213,Ganzberger; Geoffrey Michael,2,0,34,32
1657034642112,MATH 109,A02,083214,Ganzberger; Geoffrey Michael,2,0,34,32
1657034642112,MATH 109,A03,093478,Ganzberger; Geoffrey Michael,1,0,34,33
1657034642112,MATH 109,B01,083215,Ganzberger; Geoffrey Michael,1,0,32,31
1657034642112,MATH 109,B02,083216,Ganzberger; Geoffrey Michael,1,0,32,31
1657034642112,MATH 109,B03,093479,Ganzberger; Geoffrey Michael,6,0,32,26
1657034648143,MATH 142A,A01,083219,Chow; Bennett,6,0,32,26
1657034648143,MATH 142A,A02,083220,Chow; Bennett,10,0,32,22
1657034648143,MATH 142A,A03,093480,Chow; Bennett,7,0,32,25
1657034648143,MATH 142A,B03,093481,Chow; Bennett,7,0,32,25
1657034648143,MATH 142A,B04,093558,Chow; Bennett,11,0,32,21
1657034648143,MATH 142A,B05,093559,Chow; Bennett,6,0,32,26
1657034654167,MATH 193A,A01,083224,Rotar; Vladimir,7,0,34,27
1657034654167,MATH 193A,A02,083225,Rotar; Vladimir,5,0,34,29
1657034654167,MATH 193A,A03,083781,Rotar; Vladimir,1,0,34,33
1657034654167,MATH 193A,A04,083782,Rotar; Vladimir,6,0,34,28
1657034654167,MATH 193A,A05,093482,Rotar; Vladimir,6,0,34,28
1657034660194,MATH 197,001,091859,McAuley; Julian John,9999,0,9999,0
1657034660194,MATH 197,002,095566,Kedlaya; Kiran S.,9997,0,9999,2
1657034660194,MATH 197,003,095567,Xiao; Ming,9999,0,9999,0
1657034660194,MATH 197,004,095571,Perols; Johan Lars,9998,0,9999,1
1657034667250,COGS 9,A01,083615,Shannon; Kyle Michael,7,0,75,68
1657034673281,COGS 11,A01,083617,Boyle; Mary E. T.,20,0,48,28
1657034679310,COGS 13,A01,083071,Bastos; Amalia Pinkusfeld,9,0,71,62
1657034685338,COGS 14A,A01,092681,Semenuks; Arturs,0,1,100,100
1657034691363,COGS 14B,A01,083073,Cheng; Tzu-Han,5,0,63,58
1657034697388,COGS 17,A01,092677,Semenuks; Arturs,4,0,81,77
1657034703416,COGS 100,A01,083619,Allen; Michael Gordon,15,0,70,55
1657034709442,COGS 101A,A01,083621,Davis; Joshua Daniel,9,0,68,59
1657034715474,COGS 101B,A01,091572,Allen; Michael Gordon,8,0,65,57
1657034721509,COGS 101C,A01,083625,Delgado; Tania,17,0,35,18
1657034727541,COGS 107A,A01,083627,Boyle; Mary E. T.,13,0,60,47
1657034733567,COGS 118A,A01,083075,Gupta; Anjum,15,0,76,61
1657034739593,CSE 3,A50,083646,Miranda; Gregory Joseph,22,0,50,28
1657034745626,CSE 8A,A50,083650,Miranda; Gregory Joseph,17,1,56,39
1657034751654,CSE 11,A01,083080,Cao; Yingjun,4,15,40,36
1657034757677,CSE 12,A01,083652,Krause-Levy; Sophia Louisa,21,1,120,99
1657034763702,CSE 15L,A01,083654,Morris; Justin Loren,8,0,50,42
1657034763702,CSE 15L,A02,083655,Morris; Justin Loren,9,0,50,41
1657034769736,CSE 20,A01,083657,Tran; Khoa Dang,37,0,80,43
1657034775770,CSE 21,A01,095574,Bach; Quang Tran,21,0,48,27
1657034781800,CSE 30,A01,083084,Eldon; John,4,0,80,76
1657034781800,CSE 30,B01,095061,Bhaskar; Nishant,6,0,50,44
1657034787823,CSE 100,A01,083659,Cao; Yingjun,3,4,70,67
1657034793847,CSE 134B,A01,083661,Powell; Thomas Allan,19,0,100,81
1657034799871,CSE 140,A01,083663,Gungor; Onat,14,0,85,71
1657034805898,CSE 140L,A01,083088,Eldon; John,16,0,100,84
1657034811925,CSE 175,A01,083665,Kumar; Rakesh,3,0,25,22
1657034817949,CSE 190,A00,092507,Dubnov; Shlomo,7,0,20,13
1657034823979,ECE 45,A01,083139,Congero; Spencer William,5,0,75,70
1657034830009,ECE 65,A50,083695,Saad; Andrew S,12,0,30,18
1657034830009,ECE 65,A51,095125,Saad; Andrew S,25,0,26,1
1657034836033,ECE 109,A01,091882,Touri; Behrouz,16,0,70,54
1657034842057,ECE 180,A00,083140,Abi Samra; Nicholas Camill,1,0,30,29
1657034842057,ECE 180,B00,083141,Abi Samra; Nicholas Camill,0,0,30,30
1657034848082,MATH 10A,A01,083735,Patchell; Gregory David,1,0,30,29
1657034848082,MATH 10A,A02,083736,Patchell; Gregory David,20,0,30,10
1657034848082,MATH 10A,A03,083737,Patchell; Gregory David,16,0,30,14
1657034854107,MATH 10B,A01,083207,Lim; Seonhee,7,0,34,27
1657034854107,MATH 10B,A02,083208,Lim; Seonhee,9,0,35,26
1657034854107,MATH 10B,A03,093472,Lim; Seonhee,4,0,34,30
1657034854107,MATH 10B,B01,083739,Sinha; Shubham,9,0,30,21
1657034860139,MATH 18,A01,083743,Cinel; Cameron Alexander,6,0,30,24
1657034860139,MATH 18,A02,083744,Cinel; Cameron Alexander,15,0,30,15
1657034860139,MATH 18,A03,083745,Cinel; Cameron Alexander,8,0,30,22
1657034860139,MATH 18,B01,083748,Rideout; David Porter,4,0,37,33
1657034860139,MATH 18,B02,083749,Rideout; David Porter,3,0,36,33
1657034860139,MATH 18,B03,083750,Rideout; David Porter,2,0,37,35
1657034860139,MATH 18,B04,083751,Rideout; David Porter,5,0,36,31
1657034860139,MATH 18,B05,093473,Rideout; David Porter,4,0,36,32
1657034860139,MATH 18,B06,093474,Rideout; David Porter,5,0,36,31
1657034866165,MATH 20A,A01,083754,Zheng; Zequn,12,0,40,28
1657034872195,MATH 20B,A01,083756,Briones; Jor-el Thomas Caparas,1,0,36,35
1657034872195,MATH 20B,A02,083757,Briones; Jor-el Thomas Caparas,1,0,36,35
1657034872195,MATH 20B,A03,093475,Briones; Jor-el Thomas Caparas,0,0,36,36
1657034878292,MATH 20C,A01,083760,Briones; Jor-el Thomas Caparas,1,0,35,34
1657034878292,MATH 20C,A02,083761,Briones; Jor-el Thomas Caparas,8,0,35,27
1657034878292,MATH 20C,A03,093476,Briones; Jor-el Thomas Caparas,0,1,36,36
1657034878292,MATH 20C,B01,083762,Bach; Quang Tran,0,0,30,30
1657034884317,MATH 20D,A01,083765,Tran; Brian Kha,4,0,30,26
1657034884317,MATH 20D,A02,083766,Tran; Brian Kha,5,0,30,25
1657034884317,MATH 20D,A03,083767,Tran; Brian Kha,3,0,30,27
1657034890346,MATH 20E,A01,083771,Ganguly; Soumya,5,0,32,27
1657034890346,MATH 20E,A02,083772,Ganguly; Soumya,6,0,32,26
1657034890346,MATH 20E,B01,083773,Ciotti; Benjamin,18,0,35,17
1657034890346,MATH 20E,B02,083774,Ciotti; Benjamin,17,0,35,18
1657034896372,MATH 103A,A01,083777,Greenfeld; Be'Eri,2,0,36,34
1657034896372,MATH 103A,A02,083778,Greenfeld; Be'Eri,5,0,36,31
1657034896372,MATH 103A,A03,093561,Greenfeld; Be'Eri,4,0,36,32
1657034896372,MATH 103A,B01,083779,Greenfeld; Be'Eri,6,0,36,30
1657034896372,MATH 103A,B02,083780,Greenfeld; Be'Eri,2,0,36,34
1657034896372,MATH 103A,B03,093562,Greenfeld; Be'Eri,2,0,36,34
1657034902395,MATH 105,A01,085443,Carter; Anne Toulson,14,0,35,21
1657034902395,MATH 105,A02,093477,Carter; Anne Toulson,20,0,35,15
1657034908418,MATH 109,A01,083213,Ganzberger; Geoffrey Michael,2,0,34,32
1657034908418,MATH 109,A02,083214,Ganzberger; Geoffrey Michael,2,0,34,32
1657034908418,MATH 109,A03,093478,Ganzberger; Geoffrey Michael,1,0,34,33
1657034908418,MATH 109,B01,083215,Ganzberger; Geoffrey Michael,1,0,32,31
1657034908418,MATH 109,B02,083216,Ganzberger; Geoffrey Michael,1,0,32,31
1657034908418,MATH 109,B03,093479,Ganzberger; Geoffrey Michael,6,0,32,26
1657034914443,MATH 142A,A01,083219,Chow; Bennett,6,0,32,26
1657034914443,MATH 142A,A02,083220,Chow; Bennett,10,0,32,22
1657034914443,MATH 142A,A03,093480,Chow; Bennett,7,0,32,25
1657034914443,MATH 142A,B03,093481,Chow; Bennett,7,0,32,25
1657034914443,MATH 142A,B04,093558,Chow; Bennett,11,0,32,21
1657034914443,MATH 142A,B05,093559,Chow; Bennett,6,0,32,26
1657034920477,MATH 193A,A01,083224,Rotar; Vladimir,7,0,34,27
1657034920477,MATH 193A,A02,083225,Rotar; Vladimir,5,0,34,29
1657034920477,MATH 193A,A03,083781,Rotar; Vladimir,1,0,34,33
1657034920477,MATH 193A,A04,083782,Rotar; Vladimir,6,0,34,28
1657034920477,MATH 193A,A05,093482,Rotar; Vladimir,6,0,34,28
1657034926503,MATH 197,001,091859,McAuley; Julian John,9999,0,9999,0
1657034926503,MATH 197,002,095566,Kedlaya; Kiran S.,9997,0,9999,2
1657034926503,MATH 197,003,095567,Xiao; Ming,9999,0,9999,0
1657034926503,MATH 197,004,095571,Perols; Johan Lars,9998,0,9999,1
1657034933558,COGS 9,A01,083615,Shannon; Kyle Michael,7,0,75,68
1657034939586,COGS 11,A01,083617,Boyle; Mary E. T.,20,0,48,28
1657034945613,COGS 13,A01,083071,Bastos; Amalia Pinkusfeld,9,0,71,62
1657034951638,COGS 14A,A01,092681,Semenuks; Arturs,0,1,100,100
1657034957663,COGS 14B,A01,083073,Cheng; Tzu-Han,5,0,63,58
1657034963689,COGS 17,A01,092677,Semenuks; Arturs,4,0,81,77
1657034969718,COGS 100,A01,083619,Allen; Michael Gordon,15,0,70,55
1657034975754,COGS 101A,A01,083621,Davis; Joshua Daniel,9,0,68,59
1657034981780,COGS 101B,A01,091572,Allen; Michael Gordon,8,0,65,57
1657034987809,COGS 101C,A01,083625,Delgado; Tania,17,0,35,18
1657034993842,COGS 107A,A01,083627,Boyle; Mary E. T.,13,0,60,47
1657034999868,COGS 118A,A01,083075,Gupta; Anjum,15,0,76,61
1657035005896,CSE 3,A50,083646,Miranda; Gregory Joseph,22,0,50,28
1657035011925,CSE 8A,A50,083650,Miranda; Gregory Joseph,17,1,56,39
1657035017948,CSE 11,A01,083080,Cao; Yingjun,4,15,40,36
1657035023972,CSE 12,A01,083652,Krause-Levy; Sophia Louisa,21,1,120,99
1657035030013,CSE 15L,A01,083654,Morris; Justin Loren,8,0,50,42
1657035030013,CSE 15L,A02,083655,Morris; Justin Loren,9,0,50,41
1657035036038,CSE 20,A01,083657,Tran; Khoa Dang,37,0,80,43
1657035042062,CSE 21,A01,095574,Bach; Quang Tran,21,0,48,27
1657035048096,CSE 30,A01,083084,Eldon; John,4,0,80,76
1657035048096,CSE 30,B01,095061,Bhaskar; Nishant,6,0,50,44
1657035054130,CSE 100,A01,083659,Cao; Yingjun,3,4,70,67
1657035060164,CSE 134B,A01,083661,Powell; Thomas Allan,19,0,100,81
1657035066194,CSE 140,A01,083663,Gungor; Onat,14,0,85,71
1657035072226,CSE 140L,A01,083088,Eldon; John,16,0,100,84
1657035078254,CSE 175,A01,083665,Kumar; Rakesh,3,0,25,22
1657035084276,CSE 190,A00,092507,Dubnov; Shlomo,7,0,20,13
1657035090307,ECE 45,A01,083139,Congero; Spencer William,5,0,75,70
1657035096337,ECE 65,A50,083695,Saad; Andrew S,12,0,30,18
1657035096337,ECE 65,A51,095125,Saad; Andrew S,25,0,26,1
1657035102363,ECE 109,A01,091882,Touri; Behrouz,16,0,70,54
1657035108396,ECE 180,A00,083140,Abi Samra; Nicholas Camill,1,0,30,29
1657035108396,ECE 180,B00,083141,Abi Samra; Nicholas Camill,0,0,30,30
1657035114420,MATH 10A,A01,083735,Patchell; Gregory David,1,0,30,29
1657035114420,MATH 10A,A02,083736,Patchell; Gregory David,20,0,30,10
1657035114420,MATH 10A,A03,083737,Patchell; Gregory David,16,0,30,14
1657035120450,MATH 10B,A01,083207,Lim; Seonhee,7,0,34,27
1657035120450,MATH 10B,A02,083208,Lim; Seonhee,9,0,35,26
1657035120450,MATH 10B,A03,093472,Lim; Seonhee,4,0,34,30
1657035120450,MATH 10B,B01,083739,Sinha; Shubham,9,0,30,21
1657035126478,MATH 18,A01,083743,Cinel; Cameron Alexander,6,0,30,24
1657035126478,MATH 18,A02,083744,Cinel; Cameron Alexander,15,0,30,15
1657035126478,MATH 18,A03,083745,Cinel; Cameron Alexander,8,0,30,22
1657035126478,MATH 18,B01,083748,Rideout; David Porter,4,0,37,33
1657035126478,MATH 18,B02,083749,Rideout; David Porter,3,0,36,33
1657035126478,MATH 18,B03,083750,Rideout; David Porter,2,0,37,35
1657035126478,MATH 18,B04,083751,Rideout; David Porter,5,0,36,31
1657035126478,MATH 18,B05,093473,Rideout; David Porter,4,0,36,32
1657035126478,MATH 18,B06,093474,Rideout; David Porter,5,0,36,31
1657035132511,MATH 20A,A01,083754,Zheng; Zequn,12,0,40,28
1657035138534,MATH 20B,A01,083756,Briones; Jor-el Thomas Caparas,1,0,36,35
1657035138534,MATH 20B,A02,083757,Briones; Jor-el Thomas Caparas,1,0,36,35
1657035138534,MATH 20B,A03,093475,Briones; Jor-el Thomas Caparas,0,0,36,36
1657035144572,MATH 20C,A01,083760,Briones; Jor-el Thomas Caparas,1,0,35,34
1657035144572,MATH 20C,A02,083761,Briones; Jor-el Thomas Caparas,8,0,35,27
1657035144572,MATH 20C,A03,093476,Briones; Jor-el Thomas Caparas,0,1,36,36
1657035144572,MATH 20C,B01,083762,Bach; Quang Tran,0,0,30,30
1657035150603,MATH 20D,A01,083765,Tran; Brian Kha,4,0,30,26
1657035150603,MATH 20D,A02,083766,Tran; Brian Kha,5,0,30,25
1657035150603,MATH 20D,A03,083767,Tran; Brian Kha,3,0,30,27
1657035156635,MATH 20E,A01,083771,Ganguly; Soumya,5,0,32,27
1657035156635,MATH 20E,A02,083772,Ganguly; Soumya,6,0,32,26
1657035156635,MATH 20E,B01,083773,Ciotti; Benjamin,18,0,35,17
1657035156635,MATH 20E,B02,083774,Ciotti; Benjamin,17,0,35,18
1657035162665,MATH 103A,A01,083777,Greenfeld; Be'Eri,2,0,36,34
1657035162665,MATH 103A,A02,083778,Greenfeld; Be'Eri,5,0,36,31
1657035162665,MATH 103A,A03,093561,Greenfeld; Be'Eri,4,0,36,32
1657035162665,MATH 103A,B01,083779,Greenfeld; Be'Eri,6,0,36,30
1657035162665,MATH 103A,B02,083780,Greenfeld; Be'Eri,2,0,36,34
1657035162665,MATH 103A,B03,093562,Greenfeld; Be'Eri,2,0,36,34
1657035168692,MATH 105,A01,085443,Carter; Anne Toulson,14,0,35,21
1657035168692,MATH 105,A02,093477,Carter; Anne Toulson,20,0,35,15
1657035174720,MATH 109,A01,083213,Ganzberger; Geoffrey Michael,2,0,34,32
1657035174720,MATH 109,A02,083214,Ganzberger; Geoffrey Michael,2,0,34,32
1657035174720,MATH 109,A03,093478,Ganzberger; Geoffrey Michael,1,0,34,33
1657035174720,MATH 109,B01,083215,Ganzberger; Geoffrey Michael,1,0,32,31
1657035174720,MATH 109,B02,083216,Ganzberger; Geoffrey Michael,1,0,32,31
1657035174720,MATH 109,B03,093479,Ganzberger; Geoffrey Michael,6,0,32,26
1657035180751,MATH 142A,A01,083219,Chow; Bennett,6,0,32,26
1657035180751,MATH 142A,A02,083220,Chow; Bennett,10,0,32,22
1657035180751,MATH 142A,A03,093480,Chow; Bennett,7,0,32,25
1657035180751,MATH 142A,B03,093481,Chow; Bennett,7,0,32,25
1657035180751,MATH 142A,B04,093558,Chow; Bennett,11,0,32,21
1657035180751,MATH 142A,B05,093559,Chow; Bennett,6,0,32,26
1657035186781,MATH 193A,A01,083224,Rotar; Vladimir,7,0,34,27
1657035186781,MATH 193A,A02,083225,Rotar; Vladimir,5,0,34,29
1657035186781,MATH 193A,A03,083781,Rotar; Vladimir,1,0,34,33
1657035186781,MATH 193A,A04,083782,Rotar; Vladimir,6,0,34,28
1657035186781,MATH 193A,A05,093482,Rotar; Vladimir,6,0,34,28
1657035192809,MATH 197,001,091859,McAuley; Julian John,9999,0,9999,0
1657035192809,MATH 197,002,095566,Kedlaya; Kiran S.,9997,0,9999,2
1657035192809,MATH 197,003,095567,Xiao; Ming,9999,0,9999,0
1657035192809,MATH 197,004,095571,Perols; Johan Lars,9998,0,9999,1
1657035199873,COGS 9,A01,083615,Shannon; Kyle Michael,7,0,75,68
1657035205896,COGS 11,A01,083617,Boyle; Mary E. T.,20,0,48,28
1657035211925,COGS 13,A01,083071,Bastos; Amalia Pinkusfeld,9,0,71,62
1657035217947,COGS 14A,A01,092681,Semenuks; Arturs,0,1,100,100
1657035223985,COGS 14B,A01,083073,Cheng; Tzu-Han,5,0,63,58
1657035230009,COGS 17,A01,092677,Semenuks; Arturs,4,0,81,77
1657035236035,COGS 100,A01,083619,Allen; Michael Gordon,15,0,70,55
1657035242062,COGS 101A,A01,083621,Davis; Joshua Daniel,9,0,68,59
1657035248090,COGS 101B,A01,091572,Allen; Michael Gordon,8,0,65,57
1657035254116,COGS 101C,A01,083625,Delgado; Tania,17,0,35,18
1657035260144,COGS 107A,A01,083627,Boyle; Mary E. T.,13,0,60,47
1657035266168,COGS 118A,A01,083075,Gupta; Anjum,15,0,76,61
1657035272196,CSE 3,A50,083646,Miranda; Gregory Joseph,22,0,50,28
1657035278225,CSE 8A,A50,083650,Miranda; Gregory Joseph,17,1,56,39
1657035284250,CSE 11,A01,083080,Cao; Yingjun,4,15,40,36
1657035290277,CSE 12,A01,083652,Krause-Levy; Sophia Louisa,21,1,120,99
1657035296304,CSE 15L,A01,083654,Morris; Justin Loren,8,0,50,42
1657035296304,CSE 15L,A02,083655,Morris; Justin Loren,9,0,50,41
1657035302332,CSE 20,A01,083657,Tran; Khoa Dang,37,0,80,43
1657035308356,CSE 21,A01,095574,Bach; Quang Tran,21,0,48,27
1657035314381,CSE 30,A01,083084,Eldon; John,4,0,80,76
1657035314381,CSE 30,B01,095061,Bhaskar; Nishant,6,0,50,44
1657035320411,CSE 100,A01,083659,Cao; Yingjun,3,4,70,67
1657035326437,CSE 134B,A01,083661,Powell; Thomas Allan,19,0,100,81
1657035332475,CSE 140,A01,083663,Gungor; Onat,14,0,85,71
1657035338499,CSE 140L,A01,083088,Eldon; John,16,0,100,84
1657035344525,CSE 175,A01,083665,Kumar; Rakesh,3,0,25,22
1657035350553,CSE 190,A00,092507,Dubnov; Shlomo,7,0,20,13
1657035356576,ECE 45,A01,083139,Congero; Spencer William,5,0,75,70
1657035362603,ECE 65,A50,083695,Saad; Andrew S,12,0,30,18
1657035362603,ECE 65,A51,095125,Saad; Andrew S,25,0,26,1
1657035368625,ECE 109,A01,091882,Touri; Behrouz,16,0,70,54
1657035374648,ECE 180,A00,083140,Abi Samra; Nicholas Camill,1,0,30,29
1657035374648,ECE 180,B00,083141,Abi Samra; Nicholas Camill,0,0,30,30
1657035380675,MATH 10A,A01,083735,Patchell; Gregory David,1,0,30,29
1657035380675,MATH 10A,A02,083736,Patchell; Gregory David,20,0,30,10
1657035380675,MATH 10A,A03,083737,Patchell; Gregory David,16,0,30,14
1657035386699,MATH 10B,A01,083207,Lim; Seonhee,7,0,34,27
1657035386699,MATH 10B,A02,083208,Lim; Seonhee,9,0,35,26
1657035386699,MATH 10B,A03,093472,Lim; Seonhee,4,0,34,30
1657035386699,MATH 10B,B01,083739,Sinha; Shubham,9,0,30,21
1657035392730,MATH 18,A01,083743,Cinel; Cameron Alexander,6,0,30,24
1657035392730,MATH 18,A02,083744,Cinel; Cameron Alexander,15,0,30,15
1657035392730,MATH 18,A03,083745,Cinel; Cameron Alexander,8,0,30,22
1657035392730,MATH 18,B01,083748,Rideout; David Porter,4,0,37,33
1657035392730,MATH 18,B02,083749,Rideout; David Porter,3,0,36,33
1657035392730,MATH 18,B03,083750,Rideout; David Porter,2,0,37,35
1657035392730,MATH 18,B04,083751,Rideout; David Porter,5,0,36,31
1657035392730,MATH 18,B05,093473,Rideout; David Porter,4,0,36,32
1657035392730,MATH 18,B06,093474,Rideout; David Porter,5,0,36,31
1657035398754,MATH 20A,A01,083754,Zheng; Zequn,12,0,40,28
1657035404782,MATH 20B,A01,083756,Briones; Jor-el Thomas Caparas,1,0,36,35
1657035404782,MATH 20B,A02,083757,Briones; Jor-el Thomas Caparas,1,0,36,35
1657035404782,MATH 20B,A03,093475,Briones; Jor-el Thomas Caparas,0,0,36,36
1657035410809,MATH 20C,A01,083760,Briones; Jor-el Thomas Caparas,1,0,35,34
1657035410809,MATH 20C,A02,083761,Briones; Jor-el Thomas Caparas,8,0,35,27
1657035410809,MATH 20C,A03,093476,Briones; Jor-el Thomas Caparas,0,1,36,36
1657035410809,MATH 20C,B01,083762,Bach; Quang Tran,0,0,30,30
1657035416832,MATH 20D,A01,083765,Tran; Brian Kha,4,0,30,26
1657035416832,MATH 20D,A02,083766,Tran; Brian Kha,5,0,30,25
1657035416832,MATH 20D,A03,083767,Tran; Brian Kha,3,0,30,27
1657035422858,MATH 20E,A01,083771,Ganguly; Soumya,5,0,32,27
1657035422858,MATH 20E,A02,083772,Ganguly; Soumya,6,0,32,26
1657035422858,MATH 20E,B01,083773,Ciotti; Benjamin,18,0,35,17
1657035422858,MATH 20E,B02,083774,Ciotti; Benjamin,17,0,35,18
1657035428887,MATH 103A,A01,083777,Greenfeld; Be'Eri,2,0,36,34
1657035428887,MATH 103A,A02,083778,Greenfeld; Be'Eri,5,0,36,31
1657035428887,MATH 103A,A03,093561,Greenfeld; Be'Eri,4,0,36,32
1657035428887,MATH 103A,B01,083779,Greenfeld; Be'Eri,6,0,36,30
1657035428887,MATH 103A,B02,083780,Greenfeld; Be'Eri,2,0,36,34
1657035428887,MATH 103A,B03,093562,Greenfeld; Be'Eri,2,0,36,34
1657035434913,MATH 105,A01,085443,Carter; Anne Toulson,14,0,35,21
1657035434913,MATH 105,A02,093477,Carter; Anne Toulson,20,0,35,15
1657035440953,MATH 109,A01,083213,Ganzberger; Geoffrey Michael,2,0,34,32
1657035440953,MATH 109,A02,083214,Ganzberger; Geoffrey Michael,2,0,34,32
1657035440953,MATH 109,A03,093478,Ganzberger; Geoffrey Michael,1,0,34,33
1657035440953,MATH 109,B01,083215,Ganzberger; Geoffrey Michael,1,0,32,31
1657035440953,MATH 109,B02,083216,Ganzberger; Geoffrey Michael,1,0,32,31
1657035440953,MATH 109,B03,093479,Ganzberger; Geoffrey Michael,6,0,32,26
1657035446981,MATH 142A,A01,083219,Chow; Bennett,6,0,32,26
1657035446981,MATH 142A,A02,083220,Chow; Bennett,10,0,32,22
1657035446981,MATH 142A,A03,093480,Chow; Bennett,7,0,32,25
1657035446981,MATH 142A,B03,093481,Chow; Bennett,7,0,32,25
1657035446981,MATH 142A,B04,093558,Chow; Bennett,11,0,32,21
1657035446981,MATH 142A,B05,093559,Chow; Bennett,6,0,32,26
1657035453004,MATH 193A,A01,083224,Rotar; Vladimir,7,0,34,27
1657035453004,MATH 193A,A02,083225,Rotar; Vladimir,5,0,34,29
1657035453004,MATH 193A,A03,083781,Rotar; Vladimir,1,0,34,33
1657035453004,MATH 193A,A04,083782,Rotar; Vladimir,6,0,34,28
1657035453004,MATH 193A,A05,093482,Rotar; Vladimir,6,0,34,28
1657035459026,MATH 197,001,091859,McAuley; Julian John,9999,0,9999,0
1657035459026,MATH 197,002,095566,Kedlaya; Kiran S.,9997,0,9999,2
1657035459026,MATH 197,003,095567,Xiao; Ming,9999,0,9999,0
1657035459026,MATH 197,004,095571,Perols; Johan Lars,9998,0,9999,1
1657035466101,COGS 9,A01,083615,Shannon; Kyle Michael,7,0,75,68
1657035472197,COGS 11,A01,083617,Boyle; Mary E. T.,20,0,48,28
1657035478221,COGS 13,A01,083071,Bastos; Amalia Pinkusfeld,9,0,71,62
1657035484245,COGS 14A,A01,092681,Semenuks; Arturs,0,1,100,100
1657035490267,COGS 14B,A01,083073,Cheng; Tzu-Han,5,0,63,58
1657035496299,COGS 17,A01,092677,Semenuks; Arturs,4,0,81,77
1657035502326,COGS 100,A01,083619,Allen; Michael Gordon,15,0,70,55
1657035508354,COGS 101A,A01,083621,Davis; Joshua Daniel,9,0,68,59
1657035514385,COGS 101B,A01,091572,Allen; Michael Gordon,8,0,65,57
1657035520418,COGS 101C,A01,083625,Delgado; Tania,17,0,35,18
1657035526443,COGS 107A,A01,083627,Boyle; Mary E. T.,13,0,60,47
1657035532466,COGS 118A,A01,083075,Gupta; Anjum,15,0,76,61
1657035538495,CSE 3,A50,083646,Miranda; Gregory Joseph,22,0,50,28
1657035544522,CSE 8A,A50,083650,Miranda; Gregory Joseph,17,1,56,39
1657035550554,CSE 11,A01,083080,Cao; Yingjun,4,15,40,36
1657035556582,CSE 12,A01,083652,Krause-Levy; Sophia Louisa,21,1,120,99
1657035562608,CSE 15L,A01,083654,Morris; Justin Loren,8,0,50,42
1657035562608,CSE 15L,A02,083655,Morris; Justin Loren,9,0,50,41
1657035568640,CSE 20,A01,083657,Tran; Khoa Dang,37,0,80,43
1657035574666,CSE 21,A01,095574,Bach; Quang Tran,21,0,48,27
1657035580695,CSE 30,A01,083084,Eldon; John,4,0,80,76
1657035580695,CSE 30,B01,095061,Bhaskar; Nishant,6,0,50,44
1657035586723,CSE 100,A01,083659,Cao; Yingjun,3,4,70,67
1657035592755,CSE 134B,A01,083661,Powell; Thomas Allan,19,0,100,81
1657035598781,CSE 140,A01,083663,Gungor; Onat,14,0,85,71
1657035604809,CSE 140L,A01,083088,Eldon; John,16,0,100,84
1657035610836,CSE 175,A01,083665,Kumar; Rakesh,3,0,25,22
1657035616861,CSE 190,A00,092507,Dubnov; Shlomo,7,0,20,13
1657035622891,ECE 45,A01,083139,Congero; Spencer William,5,0,75,70
1657035628926,ECE 65,A50,083695,Saad; Andrew S,12,0,30,18
1657035628926,ECE 65,A51,095125,Saad; Andrew S,25,0,26,1
1657035634949,ECE 109,A01,091882,Touri; Behrouz,16,0,70,54
1657035640973,ECE 180,A00,083140,Abi Samra; Nicholas Camill,1,0,30,29
1657035640973,ECE 180,B00,083141,Abi Samra; Nicholas Camill,0,0,30,30
1657035646997,MATH 10A,A01,083735,Patchell; Gregory David,1,0,30,29
1657035646997,MATH 10A,A02,083736,Patchell; Gregory David,20,0,30,10
1657035646997,MATH 10A,A03,083737,Patchell; Gregory David,16,0,30,14
1657035653028,MATH 10B,A01,083207,Lim; Seonhee,7,0,34,27
1657035653028,MATH 10B,A02,083208,Lim; Seonhee,9,0,35,26
1657035653028,MATH 10B,A03,093472,Lim; Seonhee,4,0,34,30
1657035653028,MATH 10B,B01,083739,Sinha; Shubham,9,0,30,21
1657035659060,MATH 18,A01,083743,Cinel; Cameron Alexander,6,0,30,24
1657035659060,MATH 18,A02,083744,Cinel; Cameron Alexander,15,0,30,15
1657035659060,MATH 18,A03,083745,Cinel; Cameron Alexander,8,0,30,22
1657035659060,MATH 18,B01,083748,Rideout; David Porter,4,0,37,33
1657035659060,MATH 18,B02,083749,Rideout; David Porter,3,0,36,33
1657035659060,MATH 18,B03,083750,Rideout; David Porter,2,0,37,35
1657035659060,MATH 18,B04,083751,Rideout; David Porter,5,0,36,31
1657035659060,MATH 18,B05,093473,Rideout; David Porter,4,0,36,32
1657035659060,MATH 18,B06,093474,Rideout; David Porter,5,0,36,31
1657035665083,MATH 20A,A01,083754,Zheng; Zequn,12,0,40,28
1657035671111,MATH 20B,A01,083756,Briones; Jor-el Thomas Caparas,1,0,36,35
1657035671111,MATH 20B,A02,083757,Briones; Jor-el Thomas Caparas,1,0,36,35
1657035671111,MATH 20B,A03,093475,Briones; Jor-el Thomas Caparas,0,0,36,36
1657035677143,MATH 20C,A01,083760,Briones; Jor-el Thomas Caparas,1,0,35,34
1657035677143,MATH 20C,A02,083761,Briones; Jor-el Thomas Caparas,8,0,35,27
1657035677143,MATH 20C,A03,093476,Briones; Jor-el Thomas Caparas,0,1,36,36
1657035677143,MATH 20C,B01,083762,Bach; Quang Tran,0,0,30,30
1657035683172,MATH 20D,A01,083765,Tran; Brian Kha,4,0,30,26
1657035683172,MATH 20D,A02,083766,Tran; Brian Kha,5,0,30,25
1657035683172,MATH 20D,A03,083767,Tran; Brian Kha,3,0,30,27
1657035689217,MATH 20E,A01,083771,Ganguly; Soumya,5,0,32,27
1657035689217,MATH 20E,A02,083772,Ganguly; Soumya,6,0,32,26
1657035689217,MATH 20E,B01,083773,Ciotti; Benjamin,18,0,35,17
1657035689217,MATH 20E,B02,083774,Ciotti; Benjamin,17,0,35,18
1657035695253,MATH 103A,A01,083777,Greenfeld; Be'Eri,2,0,36,34
1657035695253,MATH 103A,A02,083778,Greenfeld; Be'Eri,5,0,36,31
1657035695253,MATH 103A,A03,093561,Greenfeld; Be'Eri,4,0,36,32
1657035695253,MATH 103A,B01,083779,Greenfeld; Be'Eri,6,0,36,30
1657035695253,MATH 103A,B02,083780,Greenfeld; Be'Eri,2,0,36,34
1657035695253,MATH 103A,B03,093562,Greenfeld; Be'Eri,2,0,36,34
1657035701280,MATH 105,A01,085443,Carter; Anne Toulson,14,0,35,21
1657035701280,MATH 105,A02,093477,Carter; Anne Toulson,20,0,35,15
1657035707310,MATH 109,A01,083213,Ganzberger; Geoffrey Michael,2,0,34,32
1657035707310,MATH 109,A02,083214,Ganzberger; Geoffrey Michael,2,0,34,32
1657035707310,MATH 109,A03,093478,Ganzberger; Geoffrey Michael,1,0,34,33
1657035707310,MATH 109,B01,083215,Ganzberger; Geoffrey Michael,1,0,32,31
1657035707310,MATH 109,B02,083216,Ganzberger; Geoffrey Michael,1,0,32,31
1657035707310,MATH 109,B03,093479,Ganzberger; Geoffrey Michael,6,0,32,26
1657035713340,MATH 142A,A01,083219,Chow; Bennett,6,0,32,26
1657035713340,MATH 142A,A02,083220,Chow; Bennett,10,0,32,22
1657035713340,MATH 142A,A03,093480,Chow; Bennett,7,0,32,25
1657035713340,MATH 142A,B03,093481,Chow; Bennett,7,0,32,25
1657035713340,MATH 142A,B04,093558,Chow; Bennett,11,0,32,21
1657035713340,MATH 142A,B05,093559,Chow; Bennett,6,0,32,26
1657035719363,MATH 193A,A01,083224,Rotar; Vladimir,7,0,34,27
1657035719363,MATH 193A,A02,083225,Rotar; Vladimir,5,0,34,29
1657035719363,MATH 193A,A03,083781,Rotar; Vladimir,1,0,34,33
1657035719363,MATH 193A,A04,083782,Rotar; Vladimir,6,0,34,28
1657035719363,MATH 193A,A05,093482,Rotar; Vladimir,6,0,34,28
1657035725391,MATH 197,001,091859,McAuley; Julian John,9999,0,9999,0
1657035725391,MATH 197,002,095566,Kedlaya; Kiran S.,9997,0,9999,2
1657035725391,MATH 197,003,095567,Xiao; Ming,9999,0,9999,0
1657035725391,MATH 197,004,095571,Perols; Johan Lars,9998,0,9999,1
1657035732456,COGS 9,A01,083615,Shannon; Kyle Michael,7,0,75,68
1657035738481,COGS 11,A01,083617,Boyle; Mary E. T.,20,0,48,28
1657035744520,COGS 13,A01,083071,Bastos; Amalia Pinkusfeld,9,0,71,62
1657035750548,COGS 14A,A01,092681,Semenuks; Arturs,0,1,100,100
1657035756572,COGS 14B,A01,083073,Cheng; Tzu-Han,5,0,63,58
1657035762599,COGS 17,A01,092677,Semenuks; Arturs,4,0,81,77
1657035768622,COGS 100,A01,083619,Allen; Michael Gordon,15,0,70,55
1657035774649,COGS 101A,A01,083621,Davis; Joshua Daniel,9,0,68,59
1657035780672,COGS 101B,A01,091572,Allen; Michael Gordon,8,0,65,57
1657035786708,COGS 101C,A01,083625,Delgado; Tania,17,0,35,18
1657035792731,COGS 107A,A01,083627,Boyle; Mary E. T.,13,0,60,47
1657035798759,COGS 118A,A01,083075,Gupta; Anjum,15,0,76,61
1657035804789,CSE 3,A50,083646,Miranda; Gregory Joseph,22,0,50,28
1657035810813,CSE 8A,A50,083650,Miranda; Gregory Joseph,17,1,56,39
1657035816838,CSE 11,A01,083080,Cao; Yingjun,4,15,40,36
1657035822868,CSE 12,A01,083652,Krause-Levy; Sophia Louisa,21,1,120,99
1657035828893,CSE 15L,A01,083654,Morris; Justin Loren,8,0,50,42
1657035828893,CSE 15L,A02,083655,Morris; Justin Loren,9,0,50,41
1657035834936,CSE 20,A01,083657,Tran; Khoa Dang,37,0,80,43
1657035840968,CSE 21,A01,095574,Bach; Quang Tran,21,0,48,27
1657035846997,CSE 30,A01,083084,Eldon; John,4,0,80,76
1657035846997,CSE 30,B01,095061,Bhaskar; Nishant,6,0,50,44
1657035853022,CSE 100,A01,083659,Cao; Yingjun,3,4,70,67
1657035859055,CSE 134B,A01,083661,Powell; Thomas Allan,19,0,100,81
1657035865077,CSE 140,A01,083663,Gungor; Onat,14,0,85,71
1657035871101,CSE 140L,A01,083088,Eldon; John,16,0,100,84
1657035877126,CSE 175,A01,083665,Kumar; Rakesh,3,0,25,22
1657035883155,CSE 190,A00,092507,Dubnov; Shlomo,7,0,20,13
1657035889186,ECE 45,A01,083139,Congero; Spencer William,5,0,75,70
1657035895208,ECE 65,A50,083695,Saad; Andrew S,12,0,30,18
1657035895208,ECE 65,A51,095125,Saad; Andrew S,25,0,26,1
1657035901231,ECE 109,A01,091882,Touri; Behrouz,16,0,70,54
1657035907267,ECE 180,A00,083140,Abi Samra; Nicholas Camill,1,0,30,29
1657035907267,ECE 180,B00,083141,Abi Samra; Nicholas Camill,0,0,30,30
1657035913296,MATH 10A,A01,083735,Patchell; Gregory David,1,0,30,29
1657035913296,MATH 10A,A02,083736,Patchell; Gregory David,20,0,30,10
1657035913296,MATH 10A,A03,083737,Patchell; Gregory David,16,0,30,14
1657035919338,MATH 10B,A01,083207,Lim; Seonhee,7,0,34,27
1657035919338,MATH 10B,A02,083208,Lim; Seonhee,9,0,35,26
1657035919338,MATH 10B,A03,093472,Lim; Seonhee,4,0,34,30
1657035919338,MATH 10B,B01,083739,Sinha; Shubham,9,0,30,21
1657035925369,MATH 18,A01,083743,Cinel; Cameron Alexander,6,0,30,24
1657035925369,MATH 18,A02,083744,Cinel; Cameron Alexander,15,0,30,15
1657035925369,MATH 18,A03,083745,Cinel; Cameron Alexander,8,0,30,22
1657035925369,MATH 18,B01,083748,Rideout; David Porter,4,0,37,33
1657035925369,MATH 18,B02,083749,Rideout; David Porter,3,0,36,33
1657035925369,MATH 18,B03,083750,Rideout; David Porter,2,0,37,35
1657035925369,MATH 18,B04,083751,Rideout; David Porter,5,0,36,31
1657035925369,MATH 18,B05,093473,Rideout; David Porter,4,0,36,32
1657035925369,MATH 18,B06,093474,Rideout; David Porter,5,0,36,31
1657035931393,MATH 20A,A01,083754,Zheng; Zequn,12,0,40,28
1657035937423,MATH 20B,A01,083756,Briones; Jor-el Thomas Caparas,1,0,36,35
1657035937423,MATH 20B,A02,083757,Briones; Jor-el Thomas Caparas,1,0,36,35
1657035937423,MATH 20B,A03,093475,Briones; Jor-el Thomas Caparas,0,0,36,36
1657035943448,MATH 20C,A01,083760,Briones; Jor-el Thomas Caparas,1,0,35,34
1657035943448,MATH 20C,A02,083761,Briones; Jor-el Thomas Caparas,8,0,35,27
1657035943448,MATH 20C,A03,093476,Briones; Jor-el Thomas Caparas,0,1,36,36
1657035943448,MATH 20C,B01,083762,Bach; Quang Tran,0,0,30,30
1657035949481,MATH 20D,A01,083765,Tran; Brian Kha,4,0,30,26
1657035949481,MATH 20D,A02,083766,Tran; Brian Kha,5,0,30,25
1657035949481,MATH 20D,A03,083767,Tran; Brian Kha,3,0,30,27
1657035955508,MATH 20E,A01,083771,Ganguly; Soumya,5,0,32,27
1657035955508,MATH 20E,A02,083772,Ganguly; Soumya,6,0,32,26
1657035955508,MATH 20E,B01,083773,Ciotti; Benjamin,18,0,35,17
1657035955508,MATH 20E,B02,083774,Ciotti; Benjamin,17,0,35,18
1657035961537,MATH 103A,A01,083777,Greenfeld; Be'Eri,2,0,36,34
1657035961537,MATH 103A,A02,083778,Greenfeld; Be'Eri,5,0,36,31
1657035961537,MATH 103A,A03,093561,Greenfeld; Be'Eri,4,0,36,32
1657035961537,MATH 103A,B01,083779,Greenfeld; Be'Eri,6,0,36,30
1657035961537,MATH 103A,B02,083780,Greenfeld; Be'Eri,2,0,36,34
1657035961537,MATH 103A,B03,093562,Greenfeld; Be'Eri,2,0,36,34
1657035967575,MATH 105,A01,085443,Carter; Anne Toulson,14,0,35,21
1657035967575,MATH 105,A02,093477,Carter; Anne Toulson,20,0,35,15
1657035973604,MATH 109,A01,083213,Ganzberger; Geoffrey Michael,2,0,34,32
1657035973604,MATH 109,A02,083214,Ganzberger; Geoffrey Michael,2,0,34,32
1657035973604,MATH 109,A03,093478,Ganzberger; Geoffrey Michael,1,0,34,33
1657035973604,MATH 109,B01,083215,Ganzberger; Geoffrey Michael,1,0,32,31
1657035973604,MATH 109,B02,083216,Ganzberger; Geoffrey Michael,1,0,32,31
1657035973604,MATH 109,B03,093479,Ganzberger; Geoffrey Michael,6,0,32,26
1657035979635,MATH 142A,A01,083219,Chow; Bennett,6,0,32,26
1657035979635,MATH 142A,A02,083220,Chow; Bennett,10,0,32,22
1657035979635,MATH 142A,A03,093480,Chow; Bennett,7,0,32,25
1657035979635,MATH 142A,B03,093481,Chow; Bennett,7,0,32,25
1657035979635,MATH 142A,B04,093558,Chow; Bennett,11,0,32,21
1657035979635,MATH 142A,B05,093559,Chow; Bennett,6,0,32,26
1657035985663,MATH 193A,A01,083224,Rotar; Vladimir,7,0,34,27
1657035985663,MATH 193A,A02,083225,Rotar; Vladimir,5,0,34,29
1657035985663,MATH 193A,A03,083781,Rotar; Vladimir,1,0,34,33
1657035985663,MATH 193A,A04,083782,Rotar; Vladimir,6,0,34,28
1657035985663,MATH 193A,A05,093482,Rotar; Vladimir,6,0,34,28
1657035991685,MATH 197,001,091859,McAuley; Julian John,9999,0,9999,0
1657035991685,MATH 197,002,095566,Kedlaya; Kiran S.,9997,0,9999,2
1657035991685,MATH 197,003,095567,Xiao; Ming,9999,0,9999,0
1657035991685,MATH 197,004,095571,Perols; Johan Lars,9998,0,9999,1
1657035998738,COGS 9,A01,083615,Shannon; Kyle Michael,7,0,75,68
1657036004762,COGS 11,A01,083617,Boyle; Mary E. T.,20,0,48,28
1657036010787,COGS 13,A01,083071,Bastos; Amalia Pinkusfeld,9,0,71,62
1657036016812,COGS 14A,A01,092681,Semenuks; Arturs,0,1,100,100
1657036022836,COGS 14B,A01,083073,Cheng; Tzu-Han,5,0,63,58
1657036028863,COGS 17,A01,092677,Semenuks; Arturs,4,0,81,77
1657036034907,COGS 100,A01,083619,Allen; Michael Gordon,15,0,70,55
1657036040930,COGS 101A,A01,083621,Davis; Joshua Daniel,9,0,68,59
1657036046954,COGS 101B,A01,091572,Allen; Michael Gordon,8,0,65,57
1657036052978,COGS 101C,A01,083625,Delgado; Tania,17,0,35,18
1657036059007,COGS 107A,A01,083627,Boyle; Mary E. T.,13,0,60,47
1657036065033,COGS 118A,A01,083075,Gupta; Anjum,15,0,76,61
1657036071158,CSE 3,A50,083646,Miranda; Gregory Joseph,22,0,50,28
1657036077182,CSE 8A,A50,083650,Miranda; Gregory Joseph,17,1,56,39
1657036083224,CSE 11,A01,083080,Cao; Yingjun,4,15,40,36
1657036089246,CSE 12,A01,083652,Krause-Levy; Sophia Louisa,21,1,120,99
1657036095275,CSE 15L,A01,083654,Morris; Justin Loren,8,0,50,42
1657036095275,CSE 15L,A02,083655,Morris; Justin Loren,9,0,50,41
1657036101307,CSE 20,A01,083657,Tran; Khoa Dang,37,0,80,43
1657036107335,CSE 21,A01,095574,Bach; Quang Tran,21,0,48,27
1657036113359,CSE 30,A01,083084,Eldon; John,4,0,80,76
1657036113359,CSE 30,B01,095061,Bhaskar; Nishant,6,0,50,44
1657036119383,CSE 100,A01,083659,Cao; Yingjun,3,4,70,67
1657036125405,CSE 134B,A01,083661,Powell; Thomas Allan,19,0,100,81
1657036131428,CSE 140,A01,083663,Gungor; Onat,14,0,85,71
1657036137455,CSE 140L,A01,083088,Eldon; John,16,0,100,84
1657036143478,CSE 175,A01,083665,Kumar; Rakesh,3,0,25,22
1657036149501,CSE 190,A00,092507,Dubnov; Shlomo,7,0,20,13
1657036155534,ECE 45,A01,083139,Congero; Spencer William,5,0,75,70
1657036161559,ECE 65,A50,083695,Saad; Andrew S,12,0,30,18
1657036161559,ECE 65,A51,095125,Saad; Andrew S,25,0,26,1
1657036167584,ECE 109,A01,091882,Touri; Behrouz,16,0,70,54
1657036173606,ECE 180,A00,083140,Abi Samra; Nicholas Camill,1,0,30,29
1657036173606,ECE 180,B00,083141,Abi Samra; Nicholas Camill,0,0,30,30
1657036179637,MATH 10A,A01,083735,Patchell; Gregory David,1,0,30,29
1657036179637,MATH 10A,A02,083736,Patchell; Gregory David,20,0,30,10
1657036179637,MATH 10A,A03,083737,Patchell; Gregory David,16,0,30,14
1657036185664,MATH 10B,A01,083207,Lim; Seonhee,7,0,34,27
1657036185664,MATH 10B,A02,083208,Lim; Seonhee,9,0,35,26
1657036185664,MATH 10B,A03,093472,Lim; Seonhee,4,0,34,30
1657036185664,MATH 10B,B01,083739,Sinha; Shubham,9,0,30,21
1657036191691,MATH 18,A01,083743,Cinel; Cameron Alexander,6,0,30,24
1657036191691,MATH 18,A02,083744,Cinel; Cameron Alexander,15,0,30,15
1657036191691,MATH 18,A03,083745,Cinel; Cameron Alexander,8,0,30,22
1657036191691,MATH 18,B01,083748,Rideout; David Porter,4,0,37,33
1657036191691,MATH 18,B02,083749,Rideout; David Porter,3,0,36,33
1657036191691,MATH 18,B03,083750,Rideout; David Porter,2,0,37,35
1657036191691,MATH 18,B04,083751,Rideout; David Porter,5,0,36,31
1657036191691,MATH 18,B05,093473,Rideout; David Porter,4,0,36,32
1657036191691,MATH 18,B06,093474,Rideout; David Porter,5,0,36,31
1657036197718,MATH 20A,A01,083754,Zheng; Zequn,12,0,40,28
1657036203752,MATH 20B,A01,083756,Briones; Jor-el Thomas Caparas,1,0,36,35
1657036203752,MATH 20B,A02,083757,Briones; Jor-el Thomas Caparas,1,0,36,35
1657036203752,MATH 20B,A03,093475,Briones; Jor-el Thomas Caparas,0,0,36,36
1657036209785,MATH 20C,A01,083760,Briones; Jor-el Thomas Caparas,1,0,35,34
1657036209785,MATH 20C,A02,083761,Briones; Jor-el Thomas Caparas,8,0,35,27
1657036209785,MATH 20C,A03,093476,Briones; Jor-el Thomas Caparas,0,1,36,36
1657036209785,MATH 20C,B01,083762,Bach; Quang Tran,0,0,30,30
1657036215815,MATH 20D,A01,083765,Tran; Brian Kha,4,0,30,26
1657036215815,MATH 20D,A02,083766,Tran; Brian Kha,5,0,30,25
1657036215815,MATH 20D,A03,083767,Tran; Brian Kha,3,0,30,27
1657036221841,MATH 20E,A01,083771,Ganguly; Soumya,5,0,32,27
1657036221841,MATH 20E,A02,083772,Ganguly; Soumya,6,0,32,26
1657036221841,MATH 20E,B01,083773,Ciotti; Benjamin,18,0,35,17
1657036221841,MATH 20E,B02,083774,Ciotti; Benjamin,17,0,35,18
1657036227865,MATH 103A,A01,083777,Greenfeld; Be'Eri,2,0,36,34
1657036227865,MATH 103A,A02,083778,Greenfeld; Be'Eri,5,0,36,31
1657036227865,MATH 103A,A03,093561,Greenfeld; Be'Eri,4,0,36,32
1657036227865,MATH 103A,B01,083779,Greenfeld; Be'Eri,6,0,36,30
1657036227865,MATH 103A,B02,083780,Greenfeld; Be'Eri,2,0,36,34
1657036227865,MATH 103A,B03,093562,Greenfeld; Be'Eri,2,0,36,34
1657036233890,MATH 105,A01,085443,Carter; Anne Toulson,14,0,35,21
1657036233890,MATH 105,A02,093477,Carter; Anne Toulson,20,0,35,15
1657036239921,MATH 109,A01,083213,Ganzberger; Geoffrey Michael,2,0,34,32
1657036239921,MATH 109,A02,083214,Ganzberger; Geoffrey Michael,2,0,34,32
1657036239921,MATH 109,A03,093478,Ganzberger; Geoffrey Michael,1,0,34,33
1657036239921,MATH 109,B01,083215,Ganzberger; Geoffrey Michael,1,0,32,31
1657036239921,MATH 109,B02,083216,Ganzberger; Geoffrey Michael,1,0,32,31
1657036239921,MATH 109,B03,093479,Ganzberger; Geoffrey Michael,6,0,32,26
1657036245945,MATH 142A,A01,083219,Chow; Bennett,6,0,32,26
1657036245945,MATH 142A,A02,083220,Chow; Bennett,10,0,32,22
1657036245945,MATH 142A,A03,093480,Chow; Bennett,7,0,32,25
1657036245945,MATH 142A,B03,093481,Chow; Bennett,7,0,32,25
1657036245945,MATH 142A,B04,093558,Chow; Bennett,11,0,32,21
1657036245945,MATH 142A,B05,093559,Chow; Bennett,6,0,32,26
1657036251989,MATH 193A,A01,083224,Rotar; Vladimir,7,0,34,27
1657036251989,MATH 193A,A02,083225,Rotar; Vladimir,5,0,34,29
1657036251989,MATH 193A,A03,083781,Rotar; Vladimir,1,0,34,33
1657036251989,MATH 193A,A04,083782,Rotar; Vladimir,6,0,34,28
1657036251989,MATH 193A,A05,093482,Rotar; Vladimir,6,0,34,28
1657036258014,MATH 197,001,091859,McAuley; Julian John,9999,0,9999,0
1657036258014,MATH 197,002,095566,Kedlaya; Kiran S.,9997,0,9999,2
1657036258014,MATH 197,003,095567,Xiao; Ming,9999,0,9999,0
1657036258014,MATH 197,004,095571,Perols; Johan Lars,9998,0,9999,1
1657036265072,COGS 9,A01,083615,Shannon; Kyle Michael,7,0,75,68
1657036271102,COGS 11,A01,083617,Boyle; Mary E. T.,20,0,48,28
1657036277141,COGS 13,A01,083071,Bastos; Amalia Pinkusfeld,9,0,71,62
1657036283165,COGS 14A,A01,092681,Semenuks; Arturs,0,1,100,100
1657036289193,COGS 14B,A01,083073,Cheng; Tzu-Han,5,0,63,58
1657036295224,COGS 17,A01,092677,Semenuks; Arturs,4,0,81,77
1657036301251,COGS 100,A01,083619,Allen; Michael Gordon,15,0,70,55
1657036307283,COGS 101A,A01,083621,Davis; Joshua Daniel,9,0,68,59
1657036313310,COGS 101B,A01,091572,Allen; Michael Gordon,8,0,65,57
1657036319335,COGS 101C,A01,083625,Delgado; Tania,17,0,35,18
1657036325364,COGS 107A,A01,083627,Boyle; Mary E. T.,13,0,60,47
1657036331389,COGS 118A,A01,083075,Gupta; Anjum,15,0,76,61
1657036337423,CSE 3,A50,083646,Miranda; Gregory Joseph,22,0,50,28
1657036343451,CSE 8A,A50,083650,Miranda; Gregory Joseph,17,1,56,39
1657036349476,CSE 11,A01,083080,Cao; Yingjun,4,15,40,36
1657036355506,CSE 12,A01,083652,Krause-Levy; Sophia Louisa,21,1,120,99
1657036361532,CSE 15L,A01,083654,Morris; Justin Loren,8,0,50,42
1657036361532,CSE 15L,A02,083655,Morris; Justin Loren,9,0,50,41
1657036367574,CSE 20,A01,083657,Tran; Khoa Dang,37,0,80,43
1657036373603,CSE 21,A01,095574,Bach; Quang Tran,21,0,48,27
1657036379630,CSE 30,A01,083084,Eldon; John,4,0,80,76
1657036379630,CSE 30,B01,095061,Bhaskar; Nishant,6,0,50,44
1657036385659,CSE 100,A01,083659,Cao; Yingjun,3,4,70,67
1657036391681,CSE 134B,A01,083661,Powell; Thomas Allan,19,0,100,81
1657036397707,CSE 140,A01,083663,Gungor; Onat,14,0,85,71
1657036403735,CSE 140L,A01,083088,Eldon; John,16,0,100,84
1657036409764,CSE 175,A01,083665,Kumar; Rakesh,3,0,25,22
1657036415787,CSE 190,A00,092507,Dubnov; Shlomo,7,0,20,13
1657036421812,ECE 45,A01,083139,Congero; Spencer William,5,0,75,70
1657036427836,ECE 65,A50,083695,Saad; Andrew S,12,0,30,18
1657036427836,ECE 65,A51,095125,Saad; Andrew S,25,0,26,1
1657036433861,ECE 109,A01,091882,Touri; Behrouz,16,0,70,54
1657036439884,ECE 180,A00,083140,Abi Samra; Nicholas Camill,1,0,30,29
1657036439884,ECE 180,B00,083141,Abi Samra; Nicholas Camill,0,0,30,30
1657036445917,MATH 10A,A01,083735,Patchell; Gregory David,1,0,30,29
1657036445917,MATH 10A,A02,083736,Patchell; Gregory David,20,0,30,10
1657036445917,MATH 10A,A03,083737,Patchell; Gregory David,16,0,30,14
1657036451941,MATH 10B,A01,083207,Lim; Seonhee,7,0,34,27
1657036451941,MATH 10B,A02,083208,Lim; Seonhee,9,0,35,26
1657036451941,MATH 10B,A03,093472,Lim; Seonhee,4,0,34,30
1657036451941,MATH 10B,B01,083739,Sinha; Shubham,9,0,30,21
1657036457970,MATH 18,A01,083743,Cinel; Cameron Alexander,6,0,30,24
1657036457970,MATH 18,A02,083744,Cinel; Cameron Alexander,15,0,30,15
1657036457970,MATH 18,A03,083745,Cinel; Cameron Alexander,8,0,30,22
1657036457970,MATH 18,B01,083748,Rideout; David Porter,4,0,37,33
1657036457970,MATH 18,B02,083749,Rideout; David Porter,3,0,36,33
1657036457970,MATH 18,B03,083750,Rideout; David Porter,2,0,37,35
1657036457970,MATH 18,B04,083751,Rideout; David Porter,5,0,36,31
1657036457970,MATH 18,B05,093473,Rideout; David Porter,4,0,36,32
1657036457970,MATH 18,B06,093474,Rideout; David Porter,5,0,36,31
1657036464003,MATH 20A,A01,083754,Zheng; Zequn,12,0,40,28
1657036470025,MATH 20B,A01,083756,Briones; Jor-el Thomas Caparas,1,0,36,35
1657036470025,MATH 20B,A02,083757,Briones; Jor-el Thomas Caparas,1,0,36,35
1657036470025,MATH 20B,A03,093475,Briones; Jor-el Thomas Caparas,0,0,36,36
1657036476053,MATH 20C,A01,083760,Briones; Jor-el Thomas Caparas,1,0,35,34
1657036476053,MATH 20C,A02,083761,Briones; Jor-el Thomas Caparas,8,0,35,27
1657036476053,MATH 20C,A03,093476,Briones; Jor-el Thomas Caparas,0,1,36,36
1657036476053,MATH 20C,B01,083762,Bach; Quang Tran,0,0,30,30
1657036482076,MATH 20D,A01,083765,Tran; Brian Kha,4,0,30,26
1657036482076,MATH 20D,A02,083766,Tran; Brian Kha,5,0,30,25
1657036482076,MATH 20D,A03,083767,Tran; Brian Kha,3,0,30,27
1657036488100,MATH 20E,A01,083771,Ganguly; Soumya,5,0,32,27
1657036488100,MATH 20E,A02,083772,Ganguly; Soumya,6,0,32,26
1657036488100,MATH 20E,B01,083773,Ciotti; Benjamin,18,0,35,17
1657036488100,MATH 20E,B02,083774,Ciotti; Benjamin,17,0,35,18
1657036494125,MATH 103A,A01,083777,Greenfeld; Be'Eri,2,0,36,34
1657036494125,MATH 103A,A02,083778,Greenfeld; Be'Eri,5,0,36,31
1657036494125,MATH 103A,A03,093561,Greenfeld; Be'Eri,4,0,36,32
1657036494125,MATH 103A,B01,083779,Greenfeld; Be'Eri,6,0,36,30
1657036494125,MATH 103A,B02,083780,Greenfeld; Be'Eri,2,0,36,34
1657036494125,MATH 103A,B03,093562,Greenfeld; Be'Eri,2,0,36,34
1657036500149,MATH 105,A01,085443,Carter; Anne Toulson,14,0,35,21
1657036500149,MATH 105,A02,093477,Carter; Anne Toulson,20,0,35,15
1657036506173,MATH 109,A01,083213,Ganzberger; Geoffrey Michael,2,0,34,32
1657036506173,MATH 109,A02,083214,Ganzberger; Geoffrey Michael,2,0,34,32
1657036506173,MATH 109,A03,093478,Ganzberger; Geoffrey Michael,1,0,34,33
1657036506173,MATH 109,B01,083215,Ganzberger; Geoffrey Michael,1,0,32,31
1657036506173,MATH 109,B02,083216,Ganzberger; Geoffrey Michael,1,0,32,31
1657036506173,MATH 109,B03,093479,Ganzberger; Geoffrey Michael,6,0,32,26
1657036512198,MATH 142A,A01,083219,Chow; Bennett,6,0,32,26
1657036512198,MATH 142A,A02,083220,Chow; Bennett,10,0,32,22
1657036512198,MATH 142A,A03,093480,Chow; Bennett,7,0,32,25
1657036512198,MATH 142A,B03,093481,Chow; Bennett,7,0,32,25
1657036512198,MATH 142A,B04,093558,Chow; Bennett,11,0,32,21
1657036512198,MATH 142A,B05,093559,Chow; Bennett,6,0,32,26
1657036518225,MATH 193A,A01,083224,Rotar; Vladimir,7,0,34,27
1657036518225,MATH 193A,A02,083225,Rotar; Vladimir,5,0,34,29
1657036518225,MATH 193A,A03,083781,Rotar; Vladimir,1,0,34,33
1657036518225,MATH 193A,A04,083782,Rotar; Vladimir,6,0,34,28
1657036518225,MATH 193A,A05,093482,Rotar; Vladimir,6,0,34,28
1657036524252,MATH 197,001,091859,McAuley; Julian John,9999,0,9999,0
1657036524252,MATH 197,002,095566,Kedlaya; Kiran S.,9997,0,9999,2
1657036524252,MATH 197,003,095567,Xiao; Ming,9999,0,9999,0
1657036524252,MATH 197,004,095571,Perols; Johan Lars,9998,0,9999,1
1657036531317,COGS 9,A01,083615,Shannon; Kyle Michael,7,0,75,68
1657036537354,COGS 11,A01,083617,Boyle; Mary E. T.,20,0,48,28
1657036543381,COGS 13,A01,083071,Bastos; Amalia Pinkusfeld,9,0,71,62
1657036549404,COGS 14A,A01,092681,Semenuks; Arturs,0,1,100,100
1657036555426,COGS 14B,A01,083073,Cheng; Tzu-Han,5,0,63,58
1657036561453,COGS 17,A01,092677,Semenuks; Arturs,4,0,81,77
1657036567477,COGS 100,A01,083619,Allen; Michael Gordon,15,0,70,55
1657036573502,COGS 101A,A01,083621,Davis; Joshua Daniel,9,0,68,59
1657036579529,COGS 101B,A01,091572,Allen; Michael Gordon,8,0,65,57
1657036585557,COGS 101C,A01,083625,Delgado; Tania,17,0,35,18
1657036591581,COGS 107A,A01,083627,Boyle; Mary E. T.,13,0,60,47
1657036597612,COGS 118A,A01,083075,Gupta; Anjum,15,0,76,61
1657036603639,CSE 3,A50,083646,Miranda; Gregory Joseph,22,0,50,28
1657036609667,CSE 8A,A50,083650,Miranda; Gregory Joseph,17,1,56,39
1657036615702,CSE 11,A01,083080,Cao; Yingjun,4,15,40,36
1657036621728,CSE 12,A01,083652,Krause-Levy; Sophia Louisa,21,1,120,99
1657036627749,CSE 15L,A01,083654,Morris; Justin Loren,8,0,50,42
1657036627749,CSE 15L,A02,083655,Morris; Justin Loren,9,0,50,41
1657036633771,CSE 20,A01,083657,Tran; Khoa Dang,37,0,80,43
1657036639795,CSE 21,A01,095574,Bach; Quang Tran,21,0,48,27
1657036645823,CSE 30,A01,083084,Eldon; John,4,0,80,76
1657036645823,CSE 30,B01,095061,Bhaskar; Nishant,6,0,50,44
1657036651846,CSE 100,A01,083659,Cao; Yingjun,3,4,70,67
1657036657872,CSE 134B,A01,083661,Powell; Thomas Allan,19,0,100,81
1657036663897,CSE 140,A01,083663,Gungor; Onat,14,0,85,71
1657036670011,CSE 140L,A01,083088,Eldon; John,16,0,100,84
1657036676034,CSE 175,A01,083665,Kumar; Rakesh,3,0,25,22
1657036682060,CSE 190,A00,092507,Dubnov; Shlomo,7,0,20,13
1657036688093,ECE 45,A01,083139,Congero; Spencer William,5,0,75,70
1657036694122,ECE 65,A50,083695,Saad; Andrew S,12,0,30,18
1657036694122,ECE 65,A51,095125,Saad; Andrew S,25,0,26,1
1657036700156,ECE 109,A01,091882,Touri; Behrouz,16,0,70,54
1657036706180,ECE 180,A00,083140,Abi Samra; Nicholas Camill,1,0,30,29
1657036706180,ECE 180,B00,083141,Abi Samra; Nicholas Camill,0,0,30,30
1657036712216,MATH 10A,A01,083735,Patchell; Gregory David,1,0,30,29
1657036712216,MATH 10A,A02,083736,Patchell; Gregory David,20,0,30,10
1657036712216,MATH 10A,A03,083737,Patchell; Gregory David,16,0,30,14
1657036718241,MATH 10B,A01,083207,Lim; Seonhee,7,0,34,27
1657036718241,MATH 10B,A02,083208,Lim; Seonhee,9,0,35,26
1657036718241,MATH 10B,A03,093472,Lim; Seonhee,4,0,34,30
1657036718241,MATH 10B,B01,083739,Sinha; Shubham,9,0,30,21
1657036724270,MATH 18,A01,083743,Cinel; Cameron Alexander,6,0,30,24
1657036724270,MATH 18,A02,083744,Cinel; Cameron Alexander,15,0,30,15
1657036724270,MATH 18,A03,083745,Cinel; Cameron Alexander,8,0,30,22
1657036724270,MATH 18,B01,083748,Rideout; David Porter,4,0,37,33
1657036724270,MATH 18,B02,083749,Rideout; David Porter,3,0,36,33
1657036724270,MATH 18,B03,083750,Rideout; David Porter,2,0,37,35
1657036724270,MATH 18,B04,083751,Rideout; David Porter,5,0,36,31
1657036724270,MATH 18,B05,093473,Rideout; David Porter,4,0,36,32
1657036724270,MATH 18,B06,093474,Rideout; David Porter,5,0,36,31
1657036730304,MATH 20A,A01,083754,Zheng; Zequn,12,0,40,28
1657036736340,MATH 20B,A01,083756,Briones; Jor-el Thomas Caparas,1,0,36,35
1657036736340,MATH 20B,A02,083757,Briones; Jor-el Thomas Caparas,1,0,36,35
1657036736340,MATH 20B,A03,093475,Briones; Jor-el Thomas Caparas,0,0,36,36
1657036742365,MATH 20C,A01,083760,Briones; Jor-el Thomas Caparas,1,0,35,34
1657036742365,MATH 20C,A02,083761,Briones; Jor-el Thomas Caparas,8,0,35,27
1657036742365,MATH 20C,A03,093476,Briones; Jor-el Thomas Caparas,0,1,36,36
1657036742365,MATH 20C,B01,083762,Bach; Quang Tran,0,0,30,30
1657036748392,MATH 20D,A01,083765,Tran; Brian Kha,4,0,30,26
1657036748392,MATH 20D,A02,083766,Tran; Brian Kha,5,0,30,25
1657036748392,MATH 20D,A03,083767,Tran; Brian Kha,3,0,30,27
1657036754417,MATH 20E,A01,083771,Ganguly; Soumya,5,0,32,27
1657036754417,MATH 20E,A02,083772,Ganguly; Soumya,6,0,32,26
1657036754417,MATH 20E,B01,083773,Ciotti; Benjamin,18,0,35,17
1657036754417,MATH 20E,B02,083774,Ciotti; Benjamin,17,0,35,18
1657036760446,MATH 103A,A01,083777,Greenfeld; Be'Eri,2,0,36,34
1657036760446,MATH 103A,A02,083778,Greenfeld; Be'Eri,5,0,36,31
1657036760446,MATH 103A,A03,093561,Greenfeld; Be'Eri,4,0,36,32
1657036760446,MATH 103A,B01,083779,Greenfeld; Be'Eri,6,0,36,30
1657036760446,MATH 103A,B02,083780,Greenfeld; Be'Eri,2,0,36,34
1657036760446,MATH 103A,B03,093562,Greenfeld; Be'Eri,2,0,36,34
1657036766468,MATH 105,A01,085443,Carter; Anne Toulson,14,0,35,21
1657036766468,MATH 105,A02,093477,Carter; Anne Toulson,20,0,35,15
1657036772505,MATH 109,A01,083213,Ganzberger; Geoffrey Michael,2,0,34,32
1657036772505,MATH 109,A02,083214,Ganzberger; Geoffrey Michael,2,0,34,32
1657036772505,MATH 109,A03,093478,Ganzberger; Geoffrey Michael,1,0,34,33
1657036772505,MATH 109,B01,083215,Ganzberger; Geoffrey Michael,1,0,32,31
1657036772505,MATH 109,B02,083216,Ganzberger; Geoffrey Michael,1,0,32,31
1657036772505,MATH 109,B03,093479,Ganzberger; Geoffrey Michael,6,0,32,26
1657036778529,MATH 142A,A01,083219,Chow; Bennett,6,0,32,26
1657036778529,MATH 142A,A02,083220,Chow; Bennett,10,0,32,22
1657036778529,MATH 142A,A03,093480,Chow; Bennett,7,0,32,25
1657036778529,MATH 142A,B03,093481,Chow; Bennett,7,0,32,25
1657036778529,MATH 142A,B04,093558,Chow; Bennett,11,0,32,21
1657036778529,MATH 142A,B05,093559,Chow; Bennett,6,0,32,26
1657036784563,MATH 193A,A01,083224,Rotar; Vladimir,7,0,34,27
1657036784563,MATH 193A,A02,083225,Rotar; Vladimir,5,0,34,29
1657036784563,MATH 193A,A03,083781,Rotar; Vladimir,1,0,34,33
1657036784563,MATH 193A,A04,083782,Rotar; Vladimir,6,0,34,28
1657036784563,MATH 193A,A05,093482,Rotar; Vladimir,6,0,34,28
1657036790586,MATH 197,001,091859,McAuley; Julian John,9999,0,9999,0
1657036790586,MATH 197,002,095566,Kedlaya; Kiran S.,9997,0,9999,2
1657036790586,MATH 197,003,095567,Xiao; Ming,9999,0,9999,0
1657036790586,MATH 197,004,095571,Perols; Johan Lars,9998,0,9999,1
1657036797651,COGS 9,A01,083615,Shannon; Kyle Michael,7,0,75,68
1657036803674,COGS 11,A01,083617,Boyle; Mary E. T.,20,0,48,28
1657036809698,COGS 13,A01,083071,Bastos; Amalia Pinkusfeld,9,0,71,62
1657036815721,COGS 14A,A01,092681,Semenuks; Arturs,0,1,100,100
1657036821749,COGS 14B,A01,083073,Cheng; Tzu-Han,5,0,63,58
1657036827779,COGS 17,A01,092677,Semenuks; Arturs,4,0,81,77
1657036833802,COGS 100,A01,083619,Allen; Michael Gordon,15,0,70,55
1657036839825,COGS 101A,A01,083621,Davis; Joshua Daniel,9,0,68,59
1657036845853,COGS 101B,A01,091572,Allen; Michael Gordon,8,0,65,57
1657036851880,COGS 101C,A01,083625,Delgado; Tania,17,0,35,18
1657036857906,COGS 107A,A01,083627,Boyle; Mary E. T.,13,0,60,47
1657036863929,COGS 118A,A01,083075,Gupta; Anjum,15,0,76,61
1657036869954,CSE 3,A50,083646,Miranda; Gregory Joseph,22,0,50,28
1657036875982,CSE 8A,A50,083650,Miranda; Gregory Joseph,17,1,56,39
1657036882010,CSE 11,A01,083080,Cao; Yingjun,4,15,40,36
1657036888041,CSE 12,A01,083652,Krause-Levy; Sophia Louisa,21,1,120,99
1657036894067,CSE 15L,A01,083654,Morris; Justin Loren,8,0,50,42
1657036894067,CSE 15L,A02,083655,Morris; Justin Loren,9,0,50,41
1657036900090,CSE 20,A01,083657,Tran; Khoa Dang,37,0,80,43
1657036906113,CSE 21,A01,095574,Bach; Quang Tran,21,0,48,27
1657036912147,CSE 30,A01,083084,Eldon; John,4,0,80,76
1657036912147,CSE 30,B01,095061,Bhaskar; Nishant,6,0,50,44
1657036918182,CSE 100,A01,083659,Cao; Yingjun,3,4,70,67
1657036924213,CSE 134B,A01,083661,Powell; Thomas Allan,19,0,100,81
1657036930236,CSE 140,A01,083663,Gungor; Onat,14,0,85,71
1657036936259,CSE 140L,A01,083088,Eldon; John,16,0,100,84
1657036942291,CSE 175,A01,083665,Kumar; Rakesh,3,0,25,22
1657036948319,CSE 190,A00,092507,Dubnov; Shlomo,7,0,20,13
1657036954351,ECE 45,A01,083139,Congero; Spencer William,5,0,75,70
1657036960382,ECE 65,A50,083695,Saad; Andrew S,12,0,30,18
1657036960382,ECE 65,A51,095125,Saad; Andrew S,25,0,26,1
1657036966408,ECE 109,A01,091882,Touri; Behrouz,16,0,70,54
1657036972436,ECE 180,A00,083140,Abi Samra; Nicholas Camill,1,0,30,29
1657036972436,ECE 180,B00,083141,Abi Samra; Nicholas Camill,0,0,30,30
1657036978465,MATH 10A,A01,083735,Patchell; Gregory David,1,0,30,29
1657036978465,MATH 10A,A02,083736,Patchell; Gregory David,20,0,30,10
1657036978465,MATH 10A,A03,083737,Patchell; Gregory David,16,0,30,14
1657036984489,MATH 10B,A01,083207,Lim; Seonhee,7,0,34,27
1657036984489,MATH 10B,A02,083208,Lim; Seonhee,9,0,35,26
1657036984489,MATH 10B,A03,093472,Lim; Seonhee,4,0,34,30
1657036984489,MATH 10B,B01,083739,Sinha; Shubham,9,0,30,21
1657036990521,MATH 18,A01,083743,Cinel; Cameron Alexander,6,0,30,24
1657036990521,MATH 18,A02,083744,Cinel; Cameron Alexander,15,0,30,15
1657036990521,MATH 18,A03,083745,Cinel; Cameron Alexander,8,0,30,22
1657036990521,MATH 18,B01,083748,Rideout; David Porter,4,0,37,33
1657036990521,MATH 18,B02,083749,Rideout; David Porter,3,0,36,33
1657036990521,MATH 18,B03,083750,Rideout; David Porter,2,0,37,35
1657036990521,MATH 18,B04,083751,Rideout; David Porter,5,0,36,31
1657036990521,MATH 18,B05,093473,Rideout; David Porter,4,0,36,32
1657036990521,MATH 18,B06,093474,Rideout; David Porter,5,0,36,31
1657036996548,MATH 20A,A01,083754,Zheng; Zequn,12,0,40,28
1657037002577,MATH 20B,A01,083756,Briones; Jor-el Thomas Caparas,1,0,36,35
1657037002577,MATH 20B,A02,083757,Briones; Jor-el Thomas Caparas,1,0,36,35
1657037002577,MATH 20B,A03,093475,Briones; Jor-el Thomas Caparas,0,0,36,36
1657037008598,MATH 20C,A01,083760,Briones; Jor-el Thomas Caparas,1,0,35,34
1657037008598,MATH 20C,A02,083761,Briones; Jor-el Thomas Caparas,8,0,35,27
1657037008598,MATH 20C,A03,093476,Briones; Jor-el Thomas Caparas,0,1,36,36
1657037008598,MATH 20C,B01,083762,Bach; Quang Tran,0,0,30,30
1657037014625,MATH 20D,A01,083765,Tran; Brian Kha,4,0,30,26
1657037014625,MATH 20D,A02,083766,Tran; Brian Kha,5,0,30,25
1657037014625,MATH 20D,A03,083767,Tran; Brian Kha,3,0,30,27
1657037020650,MATH 20E,A01,083771,Ganguly; Soumya,5,0,32,27
1657037020650,MATH 20E,A02,083772,Ganguly; Soumya,6,0,32,26
1657037020650,MATH 20E,B01,083773,Ciotti; Benjamin,18,0,35,17
1657037020650,MATH 20E,B02,083774,Ciotti; Benjamin,17,0,35,18
1657037026683,MATH 103A,A01,083777,Greenfeld; Be'Eri,2,0,36,34
1657037026683,MATH 103A,A02,083778,Greenfeld; Be'Eri,5,0,36,31
1657037026683,MATH 103A,A03,093561,Greenfeld; Be'Eri,4,0,36,32
1657037026683,MATH 103A,B01,083779,Greenfeld; Be'Eri,6,0,36,30
1657037026683,MATH 103A,B02,083780,Greenfeld; Be'Eri,2,0,36,34
1657037026683,MATH 103A,B03,093562,Greenfeld; Be'Eri,2,0,36,34
1657037032708,MATH 105,A01,085443,Carter; Anne Toulson,14,0,35,21
1657037032708,MATH 105,A02,093477,Carter; Anne Toulson,20,0,35,15
1657037038732,MATH 109,A01,083213,Ganzberger; Geoffrey Michael,2,0,34,32
1657037038732,MATH 109,A02,083214,Ganzberger; Geoffrey Michael,2,0,34,32
1657037038732,MATH 109,A03,093478,Ganzberger; Geoffrey Michael,1,0,34,33
1657037038732,MATH 109,B01,083215,Ganzberger; Geoffrey Michael,1,0,32,31
1657037038732,MATH 109,B02,083216,Ganzberger; Geoffrey Michael,1,0,32,31
1657037038732,MATH 109,B03,093479,Ganzberger; Geoffrey Michael,6,0,32,26
1657037044763,MATH 142A,A01,083219,Chow; Bennett,6,0,32,26
1657037044763,MATH 142A,A02,083220,Chow; Bennett,10,0,32,22
1657037044763,MATH 142A,A03,093480,Chow; Bennett,7,0,32,25
1657037044763,MATH 142A,B03,093481,Chow; Bennett,7,0,32,25
1657037044763,MATH 142A,B04,093558,Chow; Bennett,11,0,32,21
1657037044763,MATH 142A,B05,093559,Chow; Bennett,6,0,32,26
1657037050794,MATH 193A,A01,083224,Rotar; Vladimir,7,0,34,27
1657037050794,MATH 193A,A02,083225,Rotar; Vladimir,5,0,34,29
1657037050794,MATH 193A,A03,083781,Rotar; Vladimir,1,0,34,33
1657037050794,MATH 193A,A04,083782,Rotar; Vladimir,6,0,34,28
1657037050794,MATH 193A,A05,093482,Rotar; Vladimir,6,0,34,28
1657037056825,MATH 197,001,091859,McAuley; Julian John,9999,0,9999,0
1657037056825,MATH 197,002,095566,Kedlaya; Kiran S.,9997,0,9999,2
1657037056825,MATH 197,003,095567,Xiao; Ming,9999,0,9999,0
1657037056825,MATH 197,004,095571,Perols; Johan Lars,9998,0,9999,1
1657037063887,COGS 9,A01,083615,Shannon; Kyle Michael,7,0,75,68
1657037069910,COGS 11,A01,083617,Boyle; Mary E. T.,20,0,48,28
1657037075938,COGS 13,A01,083071,Bastos; Amalia Pinkusfeld,9,0,71,62
1657037081973,COGS 14A,A01,092681,Semenuks; Arturs,0,1,100,100
1657037088006,COGS 14B,A01,083073,Cheng; Tzu-Han,5,0,63,58
1657037094045,COGS 17,A01,092677,Semenuks; Arturs,4,0,81,77
1657037100068,COGS 100,A01,083619,Allen; Michael Gordon,15,0,70,55
1657037106098,COGS 101A,A01,083621,Davis; Joshua Daniel,9,0,68,59
1657037112125,COGS 101B,A01,091572,Allen; Michael Gordon,8,0,65,57
1657037118148,COGS 101C,A01,083625,Delgado; Tania,17,0,35,18
1657037124189,COGS 107A,A01,083627,Boyle; Mary E. T.,13,0,60,47
1657037130220,COGS 118A,A01,083075,Gupta; Anjum,15,0,76,61
1657037136248,CSE 3,A50,083646,Miranda; Gregory Joseph,22,0,50,28
1657037142291,CSE 8A,A50,083650,Miranda; Gregory Joseph,17,1,56,39
1657037148317,CSE 11,A01,083080,Cao; Yingjun,4,15,40,36
1657037154344,CSE 12,A01,083652,Krause-Levy; Sophia Louisa,21,1,120,99
1657037160371,CSE 15L,A01,083654,Morris; Justin Loren,8,0,50,42
1657037160371,CSE 15L,A02,083655,Morris; Justin Loren,9,0,50,41
1657037166399,CSE 20,A01,083657,Tran; Khoa Dang,37,0,80,43
1657037172438,CSE 21,A01,095574,Bach; Quang Tran,21,0,48,27
1657037178467,CSE 30,A01,083084,Eldon; John,4,0,80,76
1657037178467,CSE 30,B01,095061,Bhaskar; Nishant,6,0,50,44
1657037184489,CSE 100,A01,083659,Cao; Yingjun,3,4,70,67
1657037190515,CSE 134B,A01,083661,Powell; Thomas Allan,19,0,100,81
1657037196542,CSE 140,A01,083663,Gungor; Onat,14,0,85,71
1657037202564,CSE 140L,A01,083088,Eldon; John,16,0,100,84
1657037208588,CSE 175,A01,083665,Kumar; Rakesh,3,0,25,22
1657037214609,CSE 190,A00,092507,Dubnov; Shlomo,7,0,20,13
1657037220635,ECE 45,A01,083139,Congero; Spencer William,5,0,75,70
1657037226659,ECE 65,A50,083695,Saad; Andrew S,12,0,30,18
1657037226659,ECE 65,A51,095125,Saad; Andrew S,25,0,26,1
1657037232687,ECE 109,A01,091882,Touri; Behrouz,16,0,70,54
1657037238723,ECE 180,A00,083140,Abi Samra; Nicholas Camill,1,0,30,29
1657037238723,ECE 180,B00,083141,Abi Samra; Nicholas Camill,0,0,30,30
1657037244747,MATH 10A,A01,083735,Patchell; Gregory David,1,0,30,29
1657037244747,MATH 10A,A02,083736,Patchell; Gregory David,20,0,30,10
1657037244747,MATH 10A,A03,083737,Patchell; Gregory David,16,0,30,14
1657037250771,MATH 10B,A01,083207,Lim; Seonhee,7,0,34,27
1657037250771,MATH 10B,A02,083208,Lim; Seonhee,9,0,35,26
1657037250771,MATH 10B,A03,093472,Lim; Seonhee,4,0,34,30
1657037250771,MATH 10B,B01,083739,Sinha; Shubham,9,0,30,21
1657037256796,MATH 18,A01,083743,Cinel; Cameron Alexander,6,0,30,24
1657037256796,MATH 18,A02,083744,Cinel; Cameron Alexander,15,0,30,15
1657037256796,MATH 18,A03,083745,Cinel; Cameron Alexander,8,0,30,22
1657037256796,MATH 18,B01,083748,Rideout; David Porter,4,0,37,33
1657037256796,MATH 18,B02,083749,Rideout; David Porter,3,0,36,33
1657037256796,MATH 18,B03,083750,Rideout; David Porter,2,0,37,35
1657037256796,MATH 18,B04,083751,Rideout; David Porter,5,0,36,31
1657037256796,MATH 18,B05,093473,Rideout; David Porter,4,0,36,32
1657037256796,MATH 18,B06,093474,Rideout; David Porter,5,0,36,31
1657037262819,MATH 20A,A01,083754,Zheng; Zequn,12,0,40,28
1657037268933,MATH 20B,A01,083756,Briones; Jor-el Thomas Caparas,1,0,36,35
1657037268933,MATH 20B,A02,083757,Briones; Jor-el Thomas Caparas,1,0,36,35
1657037268933,MATH 20B,A03,093475,Briones; Jor-el Thomas Caparas,0,0,36,36
1657037274956,MATH 20C,A01,083760,Briones; Jor-el Thomas Caparas,1,0,35,34
1657037274956,MATH 20C,A02,083761,Briones; Jor-el Thomas Caparas,8,0,35,27
1657037274956,MATH 20C,A03,093476,Briones; Jor-el Thomas Caparas,0,1,36,36
1657037274956,MATH 20C,B01,083762,Bach; Quang Tran,0,0,30,30
1657037280985,MATH 20D,A01,083765,Tran; Brian Kha,4,0,30,26
1657037280985,MATH 20D,A02,083766,Tran; Brian Kha,5,0,30,25
1657037280985,MATH 20D,A03,083767,Tran; Brian Kha,3,0,30,27
1657037287013,MATH 20E,A01,083771,Ganguly; Soumya,5,0,32,27
1657037287013,MATH 20E,A02,083772,Ganguly; Soumya,6,0,32,26
1657037287013,MATH 20E,B01,083773,Ciotti; Benjamin,18,0,35,17
1657037287013,MATH 20E,B02,083774,Ciotti; Benjamin,17,0,35,18
1657037293037,MATH 103A,A01,083777,Greenfeld; Be'Eri,2,0,36,34
1657037293037,MATH 103A,A02,083778,Greenfeld; Be'Eri,5,0,36,31
1657037293037,MATH 103A,A03,093561,Greenfeld; Be'Eri,4,0,36,32
1657037293037,MATH 103A,B01,083779,Greenfeld; Be'Eri,6,0,36,30
1657037293037,MATH 103A,B02,083780,Greenfeld; Be'Eri,2,0,36,34
1657037293037,MATH 103A,B03,093562,Greenfeld; Be'Eri,2,0,36,34
1657037299066,MATH 105,A01,085443,Carter; Anne Toulson,14,0,35,21
1657037299066,MATH 105,A02,093477,Carter; Anne Toulson,20,0,35,15
1657037305087,MATH 109,A01,083213,Ganzberger; Geoffrey Michael,2,0,34,32
1657037305087,MATH 109,A02,083214,Ganzberger; Geoffrey Michael,2,0,34,32
1657037305087,MATH 109,A03,093478,Ganzberger; Geoffrey Michael,1,0,34,33
1657037305087,MATH 109,B01,083215,Ganzberger; Geoffrey Michael,1,0,32,31
1657037305087,MATH 109,B02,083216,Ganzberger; Geoffrey Michael,1,0,32,31
1657037305087,MATH 109,B03,093479,Ganzberger; Geoffrey Michael,6,0,32,26
1657037311111,MATH 142A,A01,083219,Chow; Bennett,6,0,32,26
1657037311111,MATH 142A,A02,083220,Chow; Bennett,10,0,32,22
1657037311111,MATH 142A,A03,093480,Chow; Bennett,7,0,32,25
1657037311111,MATH 142A,B03,093481,Chow; Bennett,7,0,32,25
1657037311111,MATH 142A,B04,093558,Chow; Bennett,11,0,32,21
1657037311111,MATH 142A,B05,093559,Chow; Bennett,6,0,32,26
1657037317137,MATH 193A,A01,083224,Rotar; Vladimir,7,0,34,27
1657037317137,MATH 193A,A02,083225,Rotar; Vladimir,5,0,34,29
1657037317137,MATH 193A,A03,083781,Rotar; Vladimir,1,0,34,33
1657037317137,MATH 193A,A04,083782,Rotar; Vladimir,6,0,34,28
1657037317137,MATH 193A,A05,093482,Rotar; Vladimir,6,0,34,28
1657037323161,MATH 197,001,091859,McAuley; Julian John,9999,0,9999,0
1657037323161,MATH 197,002,095566,Kedlaya; Kiran S.,9997,0,9999,2
1657037323161,MATH 197,003,095567,Xiao; Ming,9999,0,9999,0
1657037323161,MATH 197,004,095571,Perols; Johan Lars,9998,0,9999,1
1657037330215,COGS 9,A01,083615,Shannon; Kyle Michael,7,0,75,68
1657037336239,COGS 11,A01,083617,Boyle; Mary E. T.,20,0,48,28
1657037342267,COGS 13,A01,083071,Bastos; Amalia Pinkusfeld,9,0,71,62
1657037348292,COGS 14A,A01,092681,Semenuks; Arturs,0,1,100,100
1657037354316,COGS 14B,A01,083073,Cheng; Tzu-Han,5,0,63,58
1657037360343,COGS 17,A01,092677,Semenuks; Arturs,4,0,81,77
1657037366376,COGS 100,A01,083619,Allen; Michael Gordon,15,0,70,55
1657037372404,COGS 101A,A01,083621,Davis; Joshua Daniel,9,0,68,59
1657037378426,COGS 101B,A01,091572,Allen; Michael Gordon,8,0,65,57
1657037384450,COGS 101C,A01,083625,Delgado; Tania,17,0,35,18
1657037390481,COGS 107A,A01,083627,Boyle; Mary E. T.,13,0,60,47
1657037396508,COGS 118A,A01,083075,Gupta; Anjum,15,0,76,61
1657037402536,CSE 3,A50,083646,Miranda; Gregory Joseph,22,0,50,28
1657037408565,CSE 8A,A50,083650,Miranda; Gregory Joseph,17,1,56,39
1657037414601,CSE 11,A01,083080,Cao; Yingjun,4,15,40,36
1657037420629,CSE 12,A01,083652,Krause-Levy; Sophia Louisa,21,1,120,99
1657037426657,CSE 15L,A01,083654,Morris; Justin Loren,8,0,50,42
1657037426657,CSE 15L,A02,083655,Morris; Justin Loren,9,0,50,41
1657037432689,CSE 20,A01,083657,Tran; Khoa Dang,37,0,80,43
1657037438727,CSE 21,A01,095574,Bach; Quang Tran,21,0,48,27
1657037444759,CSE 30,A01,083084,Eldon; John,4,0,80,76
1657037444759,CSE 30,B01,095061,Bhaskar; Nishant,6,0,50,44
1657037450783,CSE 100,A01,083659,Cao; Yingjun,3,4,70,67
1657037456805,CSE 134B,A01,083661,Powell; Thomas Allan,19,0,100,81
1657037462847,CSE 140,A01,083663,Gungor; Onat,14,0,85,71
1657037468881,CSE 140L,A01,083088,Eldon; John,16,0,100,84
1657037474912,CSE 175,A01,083665,Kumar; Rakesh,3,0,25,22
1657037480937,CSE 190,A00,092507,Dubnov; Shlomo,7,0,20,13
1657037486970,ECE 45,A01,083139,Congero; Spencer William,5,0,75,70
1657037492997,ECE 65,A50,083695,Saad; Andrew S,12,0,30,18
1657037492997,ECE 65,A51,095125,Saad; Andrew S,25,0,26,1
1657037499021,ECE 109,A01,091882,Touri; Behrouz,16,0,70,54
1657037511079,ECE 180,A00,083140,Abi Samra; Nicholas Camill,1,0,30,29
1657037511079,ECE 180,B00,083141,Abi Samra; Nicholas Camill,0,0,30,30
1657037517108,MATH 10A,A01,083735,Patchell; Gregory David,1,0,30,29
1657037517108,MATH 10A,A02,083736,Patchell; Gregory David,20,0,30,10
1657037517108,MATH 10A,A03,083737,Patchell; Gregory David,16,0,30,14
1657037523131,MATH 10B,A01,083207,Lim; Seonhee,7,0,34,27
1657037523131,MATH 10B,A02,083208,Lim; Seonhee,9,0,35,26
1657037523131,MATH 10B,A03,093472,Lim; Seonhee,4,0,34,30
1657037523131,MATH 10B,B01,083739,Sinha; Shubham,9,0,30,21
1657037529155,MATH 18,A01,083743,Cinel; Cameron Alexander,6,0,30,24
1657037529155,MATH 18,A02,083744,Cinel; Cameron Alexander,15,0,30,15
1657037529155,MATH 18,A03,083745,Cinel; Cameron Alexander,8,0,30,22
1657037529155,MATH 18,B01,083748,Rideout; David Porter,4,0,37,33
1657037529155,MATH 18,B02,083749,Rideout; David Porter,3,0,36,33
1657037529155,MATH 18,B03,083750,Rideout; David Porter,2,0,37,35
1657037529155,MATH 18,B04,083751,Rideout; David Porter,5,0,36,31
1657037529155,MATH 18,B05,093473,Rideout; David Porter,4,0,36,32
1657037529155,MATH 18,B06,093474,Rideout; David Porter,5,0,36,31
1657037535185,MATH 20A,A01,083754,Zheng; Zequn,12,0,40,28
1657037541213,MATH 20B,A01,083756,Briones; Jor-el Thomas Caparas,1,0,36,35
1657037541213,MATH 20B,A02,083757,Briones; Jor-el Thomas Caparas,1,0,36,35
1657037541213,MATH 20B,A03,093475,Briones; Jor-el Thomas Caparas,0,0,36,36
1657037547241,MATH 20C,A01,083760,Briones; Jor-el Thomas Caparas,1,0,35,34
1657037547241,MATH 20C,A02,083761,Briones; Jor-el Thomas Caparas,8,0,35,27
1657037547241,MATH 20C,A03,093476,Briones; Jor-el Thomas Caparas,0,1,36,36
1657037547241,MATH 20C,B01,083762,Bach; Quang Tran,0,0,30,30
1657037553267,MATH 20D,A01,083765,Tran; Brian Kha,4,0,30,26
1657037553267,MATH 20D,A02,083766,Tran; Brian Kha,5,0,30,25
1657037553267,MATH 20D,A03,083767,Tran; Brian Kha,3,0,30,27
1657037559291,MATH 20E,A01,083771,Ganguly; Soumya,5,0,32,27
1657037559291,MATH 20E,A02,083772,Ganguly; Soumya,6,0,32,26
1657037559291,MATH 20E,B01,083773,Ciotti; Benjamin,18,0,35,17
1657037559291,MATH 20E,B02,083774,Ciotti; Benjamin,17,0,35,18
1657037565327,MATH 103A,A01,083777,Greenfeld; Be'Eri,2,0,36,34
1657037565327,MATH 103A,A02,083778,Greenfeld; Be'Eri,5,0,36,31
1657037565327,MATH 103A,A03,093561,Greenfeld; Be'Eri,4,0,36,32
1657037565327,MATH 103A,B01,083779,Greenfeld; Be'Eri,6,0,36,30
1657037565327,MATH 103A,B02,083780,Greenfeld; Be'Eri,2,0,36,34
1657037565327,MATH 103A,B03,093562,Greenfeld; Be'Eri,2,0,36,34
1657037571354,MATH 105,A01,085443,Carter; Anne Toulson,14,0,35,21
1657037571354,MATH 105,A02,093477,Carter; Anne Toulson,20,0,35,15
1657037577385,MATH 109,A01,083213,Ganzberger; Geoffrey Michael,2,0,34,32
1657037577385,MATH 109,A02,083214,Ganzberger; Geoffrey Michael,2,0,34,32
1657037577385,MATH 109,A03,093478,Ganzberger; Geoffrey Michael,1,0,34,33
1657037577385,MATH 109,B01,083215,Ganzberger; Geoffrey Michael,1,0,32,31
1657037577385,MATH 109,B02,083216,Ganzberger; Geoffrey Michael,1,0,32,31
1657037577385,MATH 109,B03,093479,Ganzberger; Geoffrey Michael,6,0,32,26
1657037583409,MATH 142A,A01,083219,Chow; Bennett,6,0,32,26
1657037583409,MATH 142A,A02,083220,Chow; Bennett,10,0,32,22
1657037583409,MATH 142A,A03,093480,Chow; Bennett,7,0,32,25
1657037583409,MATH 142A,B03,093481,Chow; Bennett,7,0,32,25
1657037583409,MATH 142A,B04,093558,Chow; Bennett,11,0,32,21
1657037583409,MATH 142A,B05,093559,Chow; Bennett,6,0,32,26
1657037589437,MATH 193A,A01,083224,Rotar; Vladimir,7,0,34,27
1657037589437,MATH 193A,A02,083225,Rotar; Vladimir,5,0,34,29
1657037589437,MATH 193A,A03,083781,Rotar; Vladimir,1,0,34,33
1657037589437,MATH 193A,A04,083782,Rotar; Vladimir,6,0,34,28
1657037589437,MATH 193A,A05,093482,Rotar; Vladimir,6,0,34,28
1657037595469,MATH 197,001,091859,McAuley; Julian John,9999,0,9999,0
1657037595469,MATH 197,002,095566,Kedlaya; Kiran S.,9997,0,9999,2
1657037595469,MATH 197,003,095567,Xiao; Ming,9999,0,9999,0
1657037595469,MATH 197,004,095571,Perols; Johan Lars,9998,0,9999,1
1657037602519,COGS 9,A01,083615,Shannon; Kyle Michael,7,0,75,68
1657037608546,COGS 11,A01,083617,Boyle; Mary E. T.,20,0,48,28
1657037614574,COGS 13,A01,083071,Bastos; Amalia Pinkusfeld,9,0,71,62
1657037620597,COGS 14A,A01,092681,Semenuks; Arturs,0,1,100,100
1657037626625,COGS 14B,A01,083073,Cheng; Tzu-Han,5,0,63,58
1657037632657,COGS 17,A01,092677,Semenuks; Arturs,4,0,81,77
1657037638679,COGS 100,A01,083619,Allen; Michael Gordon,15,0,70,55
1657037644703,COGS 101A,A01,083621,Davis; Joshua Daniel,9,0,68,59
1657037650727,COGS 101B,A01,091572,Allen; Michael Gordon,8,0,65,57
1657037656750,COGS 101C,A01,083625,Delgado; Tania,17,0,35,18
1657037662780,COGS 107A,A01,083627,Boyle; Mary E. T.,13,0,60,47
1657037668804,COGS 118A,A01,083075,Gupta; Anjum,15,0,76,61
1657037674831,CSE 3,A50,083646,Miranda; Gregory Joseph,22,0,50,28
1657037680860,CSE 8A,A50,083650,Miranda; Gregory Joseph,17,1,56,39
1657037686889,CSE 11,A01,083080,Cao; Yingjun,4,15,40,36
1657037692914,CSE 12,A01,083652,Krause-Levy; Sophia Louisa,21,1,120,99
1657037698937,CSE 15L,A01,083654,Morris; Justin Loren,8,0,50,42
1657037698937,CSE 15L,A02,083655,Morris; Justin Loren,9,0,50,41
1657037704963,CSE 20,A01,083657,Tran; Khoa Dang,37,0,80,43
1657037710985,CSE 21,A01,095574,Bach; Quang Tran,21,0,48,27
1657037717013,CSE 30,A01,083084,Eldon; John,4,0,80,76
1657037717013,CSE 30,B01,095061,Bhaskar; Nishant,6,0,50,44
1657037723040,CSE 100,A01,083659,Cao; Yingjun,3,4,70,67
1657037729065,CSE 134B,A01,083661,Powell; Thomas Allan,19,0,100,81
1657037735098,CSE 140,A01,083663,Gungor; Onat,14,0,85,71
1657037741124,CSE 140L,A01,083088,Eldon; John,16,0,100,84
1657037747148,CSE 175,A01,083665,Kumar; Rakesh,3,0,25,22
1657037753172,CSE 190,A00,092507,Dubnov; Shlomo,7,0,20,13
1657037759195,ECE 45,A01,083139,Congero; Spencer William,5,0,75,70
1657037765221,ECE 65,A50,083695,Saad; Andrew S,12,0,30,18
1657037765221,ECE 65,A51,095125,Saad; Andrew S,25,0,26,1
1657037771255,ECE 109,A01,091882,Touri; Behrouz,16,0,70,54
1657037777281,ECE 180,A00,083140,Abi Samra; Nicholas Camill,1,0,30,29
1657037777281,ECE 180,B00,083141,Abi Samra; Nicholas Camill,0,0,30,30
1657037783319,MATH 10A,A01,083735,Patchell; Gregory David,1,0,30,29
1657037783319,MATH 10A,A02,083736,Patchell; Gregory David,20,0,30,10
1657037783319,MATH 10A,A03,083737,Patchell; Gregory David,16,0,30,14
1657037789351,MATH 10B,A01,083207,Lim; Seonhee,7,0,34,27
1657037789351,MATH 10B,A02,083208,Lim; Seonhee,9,0,35,26
1657037789351,MATH 10B,A03,093472,Lim; Seonhee,4,0,34,30
1657037789351,MATH 10B,B01,083739,Sinha; Shubham,9,0,30,21
1657037795375,MATH 18,A01,083743,Cinel; Cameron Alexander,6,0,30,24
1657037795375,MATH 18,A02,083744,Cinel; Cameron Alexander,15,0,30,15
1657037795375,MATH 18,A03,083745,Cinel; Cameron Alexander,8,0,30,22
1657037795375,MATH 18,B01,083748,Rideout; David Porter,4,0,37,33
1657037795375,MATH 18,B02,083749,Rideout; David Porter,3,0,36,33
1657037795375,MATH 18,B03,083750,Rideout; David Porter,2,0,37,35
1657037795375,MATH 18,B04,083751,Rideout; David Porter,5,0,36,31
1657037795375,MATH 18,B05,093473,Rideout; David Porter,4,0,36,32
1657037795375,MATH 18,B06,093474,Rideout; David Porter,5,0,36,31
1657037801397,MATH 20A,A01,083754,Zheng; Zequn,12,0,40,28
1657037807420,MATH 20B,A01,083756,Briones; Jor-el Thomas Caparas,1,0,36,35
1657037807420,MATH 20B,A02,083757,Briones; Jor-el Thomas Caparas,1,0,36,35
1657037807420,MATH 20B,A03,093475,Briones; Jor-el Thomas Caparas,0,0,36,36
1657037813449,MATH 20C,A01,083760,Briones; Jor-el Thomas Caparas,1,0,35,34
1657037813449,MATH 20C,A02,083761,Briones; Jor-el Thomas Caparas,8,0,35,27
1657037813449,MATH 20C,A03,093476,Briones; Jor-el Thomas Caparas,0,1,36,36
1657037813449,MATH 20C,B01,083762,Bach; Quang Tran,0,0,30,30
1657037819471,MATH 20D,A01,083765,Tran; Brian Kha,4,0,30,26
1657037819471,MATH 20D,A02,083766,Tran; Brian Kha,5,0,30,25
1657037819471,MATH 20D,A03,083767,Tran; Brian Kha,3,0,30,27
1657037825516,MATH 20E,A01,083771,Ganguly; Soumya,5,0,32,27
1657037825516,MATH 20E,A02,083772,Ganguly; Soumya,6,0,32,26
1657037825516,MATH 20E,B01,083773,Ciotti; Benjamin,18,0,35,17
1657037825516,MATH 20E,B02,083774,Ciotti; Benjamin,17,0,35,18
1657037831548,MATH 103A,A01,083777,Greenfeld; Be'Eri,2,0,36,34
1657037831548,MATH 103A,A02,083778,Greenfeld; Be'Eri,5,0,36,31
1657037831548,MATH 103A,A03,093561,Greenfeld; Be'Eri,4,0,36,32
1657037831548,MATH 103A,B01,083779,Greenfeld; Be'Eri,6,0,36,30
1657037831548,MATH 103A,B02,083780,Greenfeld; Be'Eri,2,0,36,34
1657037831548,MATH 103A,B03,093562,Greenfeld; Be'Eri,2,0,36,34
1657037837571,MATH 105,A01,085443,Carter; Anne Toulson,14,0,35,21
1657037837571,MATH 105,A02,093477,Carter; Anne Toulson,20,0,35,15
1657037843601,MATH 109,A01,083213,Ganzberger; Geoffrey Michael,2,0,34,32
1657037843601,MATH 109,A02,083214,Ganzberger; Geoffrey Michael,2,0,34,32
1657037843601,MATH 109,A03,093478,Ganzberger; Geoffrey Michael,1,0,34,33
1657037843601,MATH 109,B01,083215,Ganzberger; Geoffrey Michael,1,0,32,31
1657037843601,MATH 109,B02,083216,Ganzberger; Geoffrey Michael,1,0,32,31
1657037843601,MATH 109,B03,093479,Ganzberger; Geoffrey Michael,6,0,32,26
1657037849623,MATH 142A,A01,083219,Chow; Bennett,6,0,32,26
1657037849623,MATH 142A,A02,083220,Chow; Bennett,10,0,32,22
1657037849623,MATH 142A,A03,093480,Chow; Bennett,7,0,32,25
1657037849623,MATH 142A,B03,093481,Chow; Bennett,7,0,32,25
1657037849623,MATH 142A,B04,093558,Chow; Bennett,11,0,32,21
1657037849623,MATH 142A,B05,093559,Chow; Bennett,6,0,32,26
1657037855652,MATH 193A,A01,083224,Rotar; Vladimir,7,0,34,27
1657037855652,MATH 193A,A02,083225,Rotar; Vladimir,5,0,34,29
1657037855652,MATH 193A,A03,083781,Rotar; Vladimir,1,0,34,33
1657037855652,MATH 193A,A04,083782,Rotar; Vladimir,6,0,34,28
1657037855652,MATH 193A,A05,093482,Rotar; Vladimir,6,0,34,28
1657037861677,MATH 197,001,091859,McAuley; Julian John,9999,0,9999,0
1657037861677,MATH 197,002,095566,Kedlaya; Kiran S.,9997,0,9999,2
1657037861677,MATH 197,003,095567,Xiao; Ming,9999,0,9999,0
1657037861677,MATH 197,004,095571,Perols; Johan Lars,9998,0,9999,1
1657037868836,COGS 9,A01,083615,Shannon; Kyle Michael,7,0,75,68
1657037874864,COGS 11,A01,083617,Boyle; Mary E. T.,20,0,48,28
1657037880890,COGS 13,A01,083071,Bastos; Amalia Pinkusfeld,9,0,71,62
1657037886913,COGS 14A,A01,092681,Semenuks; Arturs,0,1,100,100
1657037892943,COGS 14B,A01,083073,Cheng; Tzu-Han,5,0,63,58
1657037898964,COGS 17,A01,092677,Semenuks; Arturs,4,0,81,77
1657037904990,COGS 100,A01,083619,Allen; Michael Gordon,15,0,70,55
1657037911012,COGS 101A,A01,083621,Davis; Joshua Daniel,9,0,68,59
1657037917035,COGS 101B,A01,091572,Allen; Michael Gordon,8,0,65,57
1657037923057,COGS 101C,A01,083625,Delgado; Tania,17,0,35,18
1657037929093,COGS 107A,A01,083627,Boyle; Mary E. T.,13,0,60,47
1657037935116,COGS 118A,A01,083075,Gupta; Anjum,15,0,76,61
1657037941143,CSE 3,A50,083646,Miranda; Gregory Joseph,22,0,50,28
1657037947167,CSE 8A,A50,083650,Miranda; Gregory Joseph,17,1,56,39
1657037953192,CSE 11,A01,083080,Cao; Yingjun,4,15,40,36
1657037959219,CSE 12,A01,083652,Krause-Levy; Sophia Louisa,21,1,120,99
1657037965250,CSE 15L,A01,083654,Morris; Justin Loren,8,0,50,42
1657037965250,CSE 15L,A02,083655,Morris; Justin Loren,9,0,50,41
1657037971277,CSE 20,A01,083657,Tran; Khoa Dang,37,0,80,43
1657037977303,CSE 21,A01,095574,Bach; Quang Tran,21,0,48,27
1657037983329,CSE 30,A01,083084,Eldon; John,4,0,80,76
1657037983329,CSE 30,B01,095061,Bhaskar; Nishant,6,0,50,44
1657037989353,CSE 100,A01,083659,Cao; Yingjun,3,4,70,67
1657037995386,CSE 134B,A01,083661,Powell; Thomas Allan,19,0,100,81
1657038001412,CSE 140,A01,083663,Gungor; Onat,14,0,85,71
1657038007447,CSE 140L,A01,083088,Eldon; John,16,0,100,84
1657038013474,CSE 175,A01,083665,Kumar; Rakesh,3,0,25,22
1657038019498,CSE 190,A00,092507,Dubnov; Shlomo,7,0,20,13
1657038025528,ECE 45,A01,083139,Congero; Spencer William,5,0,75,70
1657038031550,ECE 65,A50,083695,Saad; Andrew S,12,0,30,18
1657038031550,ECE 65,A51,095125,Saad; Andrew S,25,0,26,1
1657038037577,ECE 109,A01,091882,Touri; Behrouz,16,0,70,54
1657038043604,ECE 180,A00,083140,Abi Samra; Nicholas Camill,1,0,30,29
1657038043604,ECE 180,B00,083141,Abi Samra; Nicholas Camill,0,0,30,30
1657038049630,MATH 10A,A01,083735,Patchell; Gregory David,1,0,30,29
1657038049630,MATH 10A,A02,083736,Patchell; Gregory David,20,0,30,10
1657038049630,MATH 10A,A03,083737,Patchell; Gregory David,16,0,30,14
1657038055653,MATH 10B,A01,083207,Lim; Seonhee,7,0,34,27
1657038055653,MATH 10B,A02,083208,Lim; Seonhee,9,0,35,26
1657038055653,MATH 10B,A03,093472,Lim; Seonhee,4,0,34,30
1657038055653,MATH 10B,B01,083739,Sinha; Shubham,9,0,30,21
1657038061676,MATH 18,A01,083743,Cinel; Cameron Alexander,6,0,30,24
1657038061676,MATH 18,A02,083744,Cinel; Cameron Alexander,15,0,30,15
1657038061676,MATH 18,A03,083745,Cinel; Cameron Alexander,8,0,30,22
1657038061676,MATH 18,B01,083748,Rideout; David Porter,4,0,37,33
1657038061676,MATH 18,B02,083749,Rideout; David Porter,3,0,36,33
1657038061676,MATH 18,B03,083750,Rideout; David Porter,2,0,37,35
1657038061676,MATH 18,B04,083751,Rideout; David Porter,5,0,36,31
1657038061676,MATH 18,B05,093473,Rideout; David Porter,4,0,36,32
1657038061676,MATH 18,B06,093474,Rideout; David Porter,5,0,36,31
1657038067699,MATH 20A,A01,083754,Zheng; Zequn,12,0,40,28
1657038073735,MATH 20B,A01,083756,Briones; Jor-el Thomas Caparas,1,0,36,35
1657038073735,MATH 20B,A02,083757,Briones; Jor-el Thomas Caparas,1,0,36,35
1657038073735,MATH 20B,A03,093475,Briones; Jor-el Thomas Caparas,0,0,36,36
1657038079761,MATH 20C,A01,083760,Briones; Jor-el Thomas Caparas,1,0,35,34
1657038079761,MATH 20C,A02,083761,Briones; Jor-el Thomas Caparas,8,0,35,27
1657038079761,MATH 20C,A03,093476,Briones; Jor-el Thomas Caparas,0,1,36,36
1657038079761,MATH 20C,B01,083762,Bach; Quang Tran,0,0,30,30
1657038085790,MATH 20D,A01,083765,Tran; Brian Kha,4,0,30,26
1657038085790,MATH 20D,A02,083766,Tran; Brian Kha,5,0,30,25
1657038085790,MATH 20D,A03,083767,Tran; Brian Kha,3,0,30,27
1657038091817,MATH 20E,A01,083771,Ganguly; Soumya,5,0,32,27
1657038091817,MATH 20E,A02,083772,Ganguly; Soumya,6,0,32,26
1657038091817,MATH 20E,B01,083773,Ciotti; Benjamin,18,0,35,17
1657038091817,MATH 20E,B02,083774,Ciotti; Benjamin,17,0,35,18
1657038097839,MATH 103A,A01,083777,Greenfeld; Be'Eri,2,0,36,34
1657038097839,MATH 103A,A02,083778,Greenfeld; Be'Eri,5,0,36,31
1657038097839,MATH 103A,A03,093561,Greenfeld; Be'Eri,4,0,36,32
1657038097839,MATH 103A,B01,083779,Greenfeld; Be'Eri,6,0,36,30
1657038097839,MATH 103A,B02,083780,Greenfeld; Be'Eri,2,0,36,34
1657038097839,MATH 103A,B03,093562,Greenfeld; Be'Eri,2,0,36,34
1657038103866,MATH 105,A01,085443,Carter; Anne Toulson,14,0,35,21
1657038103866,MATH 105,A02,093477,Carter; Anne Toulson,20,0,35,15
1657038109897,MATH 109,A01,083213,Ganzberger; Geoffrey Michael,2,0,34,32
1657038109897,MATH 109,A02,083214,Ganzberger; Geoffrey Michael,2,0,34,32
1657038109897,MATH 109,A03,093478,Ganzberger; Geoffrey Michael,1,0,34,33
1657038109897,MATH 109,B01,083215,Ganzberger; Geoffrey Michael,1,0,32,31
1657038109897,MATH 109,B02,083216,Ganzberger; Geoffrey Michael,1,0,32,31
1657038109897,MATH 109,B03,093479,Ganzberger; Geoffrey Michael,6,0,32,26
1657038115938,MATH 142A,A01,083219,Chow; Bennett,6,0,32,26
1657038115938,MATH 142A,A02,083220,Chow; Bennett,10,0,32,22
1657038115938,MATH 142A,A03,093480,Chow; Bennett,7,0,32,25
1657038115938,MATH 142A,B03,093481,Chow; Bennett,7,0,32,25
1657038115938,MATH 142A,B04,093558,Chow; Bennett,11,0,32,21
1657038115938,MATH 142A,B05,093559,Chow; Bennett,6,0,32,26
1657038121964,MATH 193A,A01,083224,Rotar; Vladimir,7,0,34,27
1657038121964,MATH 193A,A02,083225,Rotar; Vladimir,5,0,34,29
1657038121964,MATH 193A,A03,083781,Rotar; Vladimir,1,0,34,33
1657038121964,MATH 193A,A04,083782,Rotar; Vladimir,6,0,34,28
1657038121964,MATH 193A,A05,093482,Rotar; Vladimir,6,0,34,28
1657038127990,MATH 197,001,091859,McAuley; Julian John,9999,0,9999,0
1657038127990,MATH 197,002,095566,Kedlaya; Kiran S.,9997,0,9999,2
1657038127990,MATH 197,003,095567,Xiao; Ming,9999,0,9999,0
1657038127990,MATH 197,004,095571,Perols; Johan Lars,9998,0,9999,1
1657038135058,COGS 9,A01,083615,Shannon; Kyle Michael,7,0,75,68
1657038141080,COGS 11,A01,083617,Boyle; Mary E. T.,20,0,48,28
1657038147101,COGS 13,A01,083071,Bastos; Amalia Pinkusfeld,9,0,71,62
1657038153128,COGS 14A,A01,092681,Semenuks; Arturs,0,1,100,100
1657038159159,COGS 14B,A01,083073,Cheng; Tzu-Han,5,0,63,58
1657038165183,COGS 17,A01,092677,Semenuks; Arturs,4,0,81,77
1657038171209,COGS 100,A01,083619,Allen; Michael Gordon,15,0,70,55
1657038177236,COGS 101A,A01,083621,Davis; Joshua Daniel,9,0,68,59
1657038183262,COGS 101B,A01,091572,Allen; Michael Gordon,8,0,65,57
1657038189287,COGS 101C,A01,083625,Delgado; Tania,17,0,35,18
1657038195324,COGS 107A,A01,083627,Boyle; Mary E. T.,13,0,60,47
1657038201346,COGS 118A,A01,083075,Gupta; Anjum,15,0,76,61
1657038207374,CSE 3,A50,083646,Miranda; Gregory Joseph,22,0,50,28
1657038213398,CSE 8A,A50,083650,Miranda; Gregory Joseph,17,1,56,39
1657038219435,CSE 11,A01,083080,Cao; Yingjun,4,15,40,36
1657038225460,CSE 12,A01,083652,Krause-Levy; Sophia Louisa,21,1,120,99
1657038231496,CSE 15L,A01,083654,Morris; Justin Loren,8,0,50,42
1657038231496,CSE 15L,A02,083655,Morris; Justin Loren,9,0,50,41
1657038237521,CSE 20,A01,083657,Tran; Khoa Dang,37,0,80,43
1657038243546,CSE 21,A01,095574,Bach; Quang Tran,21,0,48,27
1657038249573,CSE 30,A01,083084,Eldon; John,4,0,80,76
1657038249573,CSE 30,B01,095061,Bhaskar; Nishant,6,0,50,44
1657038255596,CSE 100,A01,083659,Cao; Yingjun,3,4,70,67
1657038261637,CSE 134B,A01,083661,Powell; Thomas Allan,19,0,100,81
1657038267660,CSE 140,A01,083663,Gungor; Onat,14,0,85,71
1657038273687,CSE 140L,A01,083088,Eldon; John,16,0,100,84
1657038279730,CSE 175,A01,083665,Kumar; Rakesh,3,0,25,22
1657038285757,CSE 190,A00,092507,Dubnov; Shlomo,7,0,20,13
1657038291780,ECE 45,A01,083139,Congero; Spencer William,5,0,75,70
1657038297807,ECE 65,A50,083695,Saad; Andrew S,12,0,30,18
1657038297807,ECE 65,A51,095125,Saad; Andrew S,25,0,26,1
1657038303838,ECE 109,A01,091882,Touri; Behrouz,16,0,70,54
1657038309902,ECE 180,A00,083140,Abi Samra; Nicholas Camill,1,0,30,29
1657038309902,ECE 180,B00,083141,Abi Samra; Nicholas Camill,0,0,30,30
1657038315927,MATH 10A,A01,083735,Patchell; Gregory David,1,0,30,29
1657038315927,MATH 10A,A02,083736,Patchell; Gregory David,20,0,30,10
1657038315927,MATH 10A,A03,083737,Patchell; Gregory David,16,0,30,14
1657038321957,MATH 10B,A01,083207,Lim; Seonhee,7,0,34,27
1657038321957,MATH 10B,A02,083208,Lim; Seonhee,9,0,35,26
1657038321957,MATH 10B,A03,093472,Lim; Seonhee,4,0,34,30
1657038321957,MATH 10B,B01,083739,Sinha; Shubham,9,0,30,21
1657038327987,MATH 18,A01,083743,Cinel; Cameron Alexander,6,0,30,24
1657038327987,MATH 18,A02,083744,Cinel; Cameron Alexander,15,0,30,15
1657038327987,MATH 18,A03,083745,Cinel; Cameron Alexander,8,0,30,22
1657038327987,MATH 18,B01,083748,Rideout; David Porter,4,0,37,33
1657038327987,MATH 18,B02,083749,Rideout; David Porter,3,0,36,33
1657038327987,MATH 18,B03,083750,Rideout; David Porter,2,0,37,35
1657038327987,MATH 18,B04,083751,Rideout; David Porter,5,0,36,31
1657038327987,MATH 18,B05,093473,Rideout; David Porter,4,0,36,32
1657038327987,MATH 18,B06,093474,Rideout; David Porter,5,0,36,31
1657038334013,MATH 20A,A01,083754,Zheng; Zequn,12,0,40,28
1657038340046,MATH 20B,A01,083756,Briones; Jor-el Thomas Caparas,1,0,36,35
1657038340046,MATH 20B,A02,083757,Briones; Jor-el Thomas Caparas,1,0,36,35
1657038340046,MATH 20B,A03,093475,Briones; Jor-el Thomas Caparas,0,0,36,36
1657038346069,MATH 20C,A01,083760,Briones; Jor-el Thomas Caparas,1,0,35,34
1657038346069,MATH 20C,A02,083761,Briones; Jor-el Thomas Caparas,8,0,35,27
1657038346069,MATH 20C,A03,093476,Briones; Jor-el Thomas Caparas,0,1,36,36
1657038346069,MATH 20C,B01,083762,Bach; Quang Tran,0,0,30,30
1657038352098,MATH 20D,A01,083765,Tran; Brian Kha,4,0,30,26
1657038352098,MATH 20D,A02,083766,Tran; Brian Kha,5,0,30,25
1657038352098,MATH 20D,A03,083767,Tran; Brian Kha,3,0,30,27
1657038358128,MATH 20E,A01,083771,Ganguly; Soumya,5,0,32,27
1657038358128,MATH 20E,A02,083772,Ganguly; Soumya,6,0,32,26
1657038358128,MATH 20E,B01,083773,Ciotti; Benjamin,18,0,35,17
1657038358128,MATH 20E,B02,083774,Ciotti; Benjamin,17,0,35,18
1657038364156,MATH 103A,A01,083777,Greenfeld; Be'Eri,2,0,36,34
1657038364156,MATH 103A,A02,083778,Greenfeld; Be'Eri,5,0,36,31
1657038364156,MATH 103A,A03,093561,Greenfeld; Be'Eri,4,0,36,32
1657038364156,MATH 103A,B01,083779,Greenfeld; Be'Eri,6,0,36,30
1657038364156,MATH 103A,B02,083780,Greenfeld; Be'Eri,2,0,36,34
1657038364156,MATH 103A,B03,093562,Greenfeld; Be'Eri,2,0,36,34
1657038370185,MATH 105,A01,085443,Carter; Anne Toulson,14,0,35,21
1657038370185,MATH 105,A02,093477,Carter; Anne Toulson,20,0,35,15
1657038376227,MATH 109,A01,083213,Ganzberger; Geoffrey Michael,2,0,34,32
1657038376227,MATH 109,A02,083214,Ganzberger; Geoffrey Michael,2,0,34,32
1657038376227,MATH 109,A03,093478,Ganzberger; Geoffrey Michael,1,0,34,33
1657038376227,MATH 109,B01,083215,Ganzberger; Geoffrey Michael,1,0,32,31
1657038376227,MATH 109,B02,083216,Ganzberger; Geoffrey Michael,1,0,32,31
1657038376227,MATH 109,B03,093479,Ganzberger; Geoffrey Michael,6,0,32,26
1657038382251,MATH 142A,A01,083219,Chow; Bennett,6,0,32,26
1657038382251,MATH 142A,A02,083220,Chow; Bennett,10,0,32,22
1657038382251,MATH 142A,A03,093480,Chow; Bennett,7,0,32,25
1657038382251,MATH 142A,B03,093481,Chow; Bennett,7,0,32,25
1657038382251,MATH 142A,B04,093558,Chow; Bennett,11,0,32,21
1657038382251,MATH 142A,B05,093559,Chow; Bennett,6,0,32,26
1657038388281,MATH 193A,A01,083224,Rotar; Vladimir,7,0,34,27
1657038388281,MATH 193A,A02,083225,Rotar; Vladimir,5,0,34,29
1657038388281,MATH 193A,A03,083781,Rotar; Vladimir,1,0,34,33
1657038388281,MATH 193A,A04,083782,Rotar; Vladimir,6,0,34,28
1657038388281,MATH 193A,A05,093482,Rotar; Vladimir,6,0,34,28
1657038394307,MATH 197,001,091859,McAuley; Julian John,9999,0,9999,0
1657038394307,MATH 197,002,095566,Kedlaya; Kiran S.,9997,0,9999,2
1657038394307,MATH 197,003,095567,Xiao; Ming,9999,0,9999,0
1657038394307,MATH 197,004,095571,Perols; Johan Lars,9998,0,9999,1
1657038401366,COGS 9,A01,083615,Shannon; Kyle Michael,7,0,75,68
1657038407392,COGS 11,A01,083617,Boyle; Mary E. T.,20,0,48,28
1657038413416,COGS 13,A01,083071,Bastos; Amalia Pinkusfeld,9,0,71,62
1657038419443,COGS 14A,A01,092681,Semenuks; Arturs,0,1,100,100
1657038425467,COGS 14B,A01,083073,Cheng; Tzu-Han,5,0,63,58
1657038431494,COGS 17,A01,092677,Semenuks; Arturs,4,0,81,77
1657038437516,COGS 100,A01,083619,Allen; Michael Gordon,15,0,70,55
1657038443544,COGS 101A,A01,083621,Davis; Joshua Daniel,9,0,68,59
1657038449569,COGS 101B,A01,091572,Allen; Michael Gordon,8,0,65,57
1657038455594,COGS 101C,A01,083625,Delgado; Tania,17,0,35,18
1657038461619,COGS 107A,A01,083627,Boyle; Mary E. T.,13,0,60,47
1657038467735,COGS 118A,A01,083075,Gupta; Anjum,15,0,76,61
1657038473759,CSE 3,A50,083646,Miranda; Gregory Joseph,22,0,50,28
1657038479782,CSE 8A,A50,083650,Miranda; Gregory Joseph,17,1,56,39
1657038485806,CSE 11,A01,083080,Cao; Yingjun,4,15,40,36
1657038491832,CSE 12,A01,083652,Krause-Levy; Sophia Louisa,21,1,120,99
1657038497855,CSE 15L,A01,083654,Morris; Justin Loren,8,0,50,42
1657038497855,CSE 15L,A02,083655,Morris; Justin Loren,9,0,50,41
1657038503886,CSE 20,A01,083657,Tran; Khoa Dang,37,0,80,43
1657038509922,CSE 21,A01,095574,Bach; Quang Tran,21,0,48,27
1657038515946,CSE 30,A01,083084,Eldon; John,4,0,80,76
1657038515946,CSE 30,B01,095061,Bhaskar; Nishant,6,0,50,44
1657038522003,CSE 100,A01,083659,Cao; Yingjun,3,4,70,67
1657038528028,CSE 134B,A01,083661,Powell; Thomas Allan,19,0,100,81
1657038534051,CSE 140,A01,083663,Gungor; Onat,14,0,85,71
1657038540087,CSE 140L,A01,083088,Eldon; John,16,0,100,84
1657038546112,CSE 175,A01,083665,Kumar; Rakesh,3,0,25,22
1657038552138,CSE 190,A00,092507,Dubnov; Shlomo,7,0,20,13
1657038558163,ECE 45,A01,083139,Congero; Spencer William,5,0,75,70
1657038564187,ECE 65,A50,083695,Saad; Andrew S,12,0,30,18
1657038564187,ECE 65,A51,095125,Saad; Andrew S,25,0,26,1
1657038570213,ECE 109,A01,091882,Touri; Behrouz,16,0,70,54
1657038576244,ECE 180,A00,083140,Abi Samra; Nicholas Camill,1,0,30,29
1657038576244,ECE 180,B00,083141,Abi Samra; Nicholas Camill,0,0,30,30
1657038582281,MATH 10A,A01,083735,Patchell; Gregory David,1,0,30,29
1657038582281,MATH 10A,A02,083736,Patchell; Gregory David,20,0,30,10
1657038582281,MATH 10A,A03,083737,Patchell; Gregory David,16,0,30,14
1657038588340,MATH 10B,A01,083207,Lim; Seonhee,7,0,34,27
1657038588340,MATH 10B,A02,083208,Lim; Seonhee,9,0,35,26
1657038588340,MATH 10B,A03,093472,Lim; Seonhee,4,0,34,30
1657038588340,MATH 10B,B01,083739,Sinha; Shubham,9,0,30,21
1657038594377,MATH 18,A01,083743,Cinel; Cameron Alexander,6,0,30,24
1657038594377,MATH 18,A02,083744,Cinel; Cameron Alexander,15,0,30,15
1657038594377,MATH 18,A03,083745,Cinel; Cameron Alexander,8,0,30,22
1657038594377,MATH 18,B01,083748,Rideout; David Porter,4,0,37,33
1657038594377,MATH 18,B02,083749,Rideout; David Porter,3,0,36,33
1657038594377,MATH 18,B03,083750,Rideout; David Porter,2,0,37,35
1657038594377,MATH 18,B04,083751,Rideout; David Porter,5,0,36,31
1657038594377,MATH 18,B05,093473,Rideout; David Porter,4,0,36,32
1657038594377,MATH 18,B06,093474,Rideout; David Porter,5,0,36,31
1657038600402,MATH 20A,A01,083754,Zheng; Zequn,12,0,40,28
1657038606426,MATH 20B,A01,083756,Briones; Jor-el Thomas Caparas,1,0,36,35
1657038606426,MATH 20B,A02,083757,Briones; Jor-el Thomas Caparas,1,0,36,35
1657038606426,MATH 20B,A03,093475,Briones; Jor-el Thomas Caparas,0,0,36,36
1657038612448,MATH 20C,A01,083760,Briones; Jor-el Thomas Caparas,1,0,35,34
1657038612448,MATH 20C,A02,083761,Briones; Jor-el Thomas Caparas,8,0,35,27
1657038612448,MATH 20C,A03,093476,Briones; Jor-el Thomas Caparas,0,1,36,36
1657038612448,MATH 20C,B01,083762,Bach; Quang Tran,0,0,30,30
1657038618475,MATH 20D,A01,083765,Tran; Brian Kha,4,0,30,26
1657038618475,MATH 20D,A02,083766,Tran; Brian Kha,5,0,30,25
1657038618475,MATH 20D,A03,083767,Tran; Brian Kha,3,0,30,27
1657038624511,MATH 20E,A01,083771,Ganguly; Soumya,5,0,32,27
1657038624511,MATH 20E,A02,083772,Ganguly; Soumya,6,0,32,26
1657038624511,MATH 20E,B01,083773,Ciotti; Benjamin,18,0,35,17
1657038624511,MATH 20E,B02,083774,Ciotti; Benjamin,17,0,35,18
1657038630533,MATH 103A,A01,083777,Greenfeld; Be'Eri,2,0,36,34
1657038630533,MATH 103A,A02,083778,Greenfeld; Be'Eri,5,0,36,31
1657038630533,MATH 103A,A03,093561,Greenfeld; Be'Eri,4,0,36,32
1657038630533,MATH 103A,B01,083779,Greenfeld; Be'Eri,6,0,36,30
1657038630533,MATH 103A,B02,083780,Greenfeld; Be'Eri,2,0,36,34
1657038630533,MATH 103A,B03,093562,Greenfeld; Be'Eri,2,0,36,34
1657038636561,MATH 105,A01,085443,Carter; Anne Toulson,14,0,35,21
1657038636561,MATH 105,A02,093477,Carter; Anne Toulson,20,0,35,15
1657038642590,MATH 109,A01,083213,Ganzberger; Geoffrey Michael,2,0,34,32
1657038642590,MATH 109,A02,083214,Ganzberger; Geoffrey Michael,2,0,34,32
1657038642590,MATH 109,A03,093478,Ganzberger; Geoffrey Michael,1,0,34,33
1657038642590,MATH 109,B01,083215,Ganzberger; Geoffrey Michael,1,0,32,31
1657038642590,MATH 109,B02,083216,Ganzberger; Geoffrey Michael,1,0,32,31
1657038642590,MATH 109,B03,093479,Ganzberger; Geoffrey Michael,6,0,32,26
1657038648615,MATH 142A,A01,083219,Chow; Bennett,6,0,32,26
1657038648615,MATH 142A,A02,083220,Chow; Bennett,10,0,32,22
1657038648615,MATH 142A,A03,093480,Chow; Bennett,7,0,32,25
1657038648615,MATH 142A,B03,093481,Chow; Bennett,7,0,32,25
1657038648615,MATH 142A,B04,093558,Chow; Bennett,11,0,32,21
1657038648615,MATH 142A,B05,093559,Chow; Bennett,6,0,32,26
1657038654644,MATH 193A,A01,083224,Rotar; Vladimir,7,0,34,27
1657038654644,MATH 193A,A02,083225,Rotar; Vladimir,5,0,34,29
1657038654644,MATH 193A,A03,083781,Rotar; Vladimir,1,0,34,33
1657038654644,MATH 193A,A04,083782,Rotar; Vladimir,6,0,34,28
1657038654644,MATH 193A,A05,093482,Rotar; Vladimir,6,0,34,28
1657038660665,MATH 197,001,091859,McAuley; Julian John,9999,0,9999,0
1657038660665,MATH 197,002,095566,Kedlaya; Kiran S.,9997,0,9999,2
1657038660665,MATH 197,003,095567,Xiao; Ming,9999,0,9999,0
1657038660665,MATH 197,004,095571,Perols; Johan Lars,9998,0,9999,1
1657038667738,COGS 9,A01,083615,Shannon; Kyle Michael,7,0,75,68
1657038673766,COGS 11,A01,083617,Boyle; Mary E. T.,20,0,48,28
1657038679789,COGS 13,A01,083071,Bastos; Amalia Pinkusfeld,9,0,71,62
1657038685814,COGS 14A,A01,092681,Semenuks; Arturs,0,1,100,100
1657038691843,COGS 14B,A01,083073,Cheng; Tzu-Han,5,0,63,58
1657038697871,COGS 17,A01,092677,Semenuks; Arturs,4,0,81,77
1657038703893,COGS 100,A01,083619,Allen; Michael Gordon,15,0,70,55
1657038709932,COGS 101A,A01,083621,Davis; Joshua Daniel,9,0,68,59
1657038715959,COGS 101B,A01,091572,Allen; Michael Gordon,8,0,65,57
1657038721981,COGS 101C,A01,083625,Delgado; Tania,17,0,35,18
1657038728005,COGS 107A,A01,083627,Boyle; Mary E. T.,13,0,60,47
1657038734038,COGS 118A,A01,083075,Gupta; Anjum,15,0,76,61
1657038740066,CSE 3,A50,083646,Miranda; Gregory Joseph,22,0,50,28
1657038746088,CSE 8A,A50,083650,Miranda; Gregory Joseph,17,1,56,39
1657038752116,CSE 11,A01,083080,Cao; Yingjun,4,15,40,36
1657038758144,CSE 12,A01,083652,Krause-Levy; Sophia Louisa,21,1,120,99
1657038764166,CSE 15L,A01,083654,Morris; Justin Loren,8,0,50,42
1657038764166,CSE 15L,A02,083655,Morris; Justin Loren,9,0,50,41
1657038770192,CSE 20,A01,083657,Tran; Khoa Dang,37,0,80,43
1657038776215,CSE 21,A01,095574,Bach; Quang Tran,21,0,48,27
1657038782240,CSE 30,A01,083084,Eldon; John,4,0,80,76
1657038782240,CSE 30,B01,095061,Bhaskar; Nishant,6,0,50,44
1657038788270,CSE 100,A01,083659,Cao; Yingjun,3,4,70,67
1657038794294,CSE 134B,A01,083661,Powell; Thomas Allan,19,0,100,81
1657038800337,CSE 140,A01,083663,Gungor; Onat,14,0,85,71
1657038806364,CSE 140L,A01,083088,Eldon; John,16,0,100,84
1657038812389,CSE 175,A01,083665,Kumar; Rakesh,3,0,25,22
1657038818411,CSE 190,A00,092507,Dubnov; Shlomo,7,0,20,13
1657038824441,ECE 45,A01,083139,Congero; Spencer William,5,0,75,70
1657038830465,ECE 65,A50,083695,Saad; Andrew S,12,0,30,18
1657038830465,ECE 65,A51,095125,Saad; Andrew S,25,0,26,1
1657038836488,ECE 109,A01,091882,Touri; Behrouz,16,0,70,54
1657038842524,ECE 180,A00,083140,Abi Samra; Nicholas Camill,1,0,30,29
1657038842524,ECE 180,B00,083141,Abi Samra; Nicholas Camill,0,0,30,30
1657038848554,MATH 10A,A01,083735,Patchell; Gregory David,1,0,30,29
1657038848554,MATH 10A,A02,083736,Patchell; Gregory David,20,0,30,10
1657038848554,MATH 10A,A03,083737,Patchell; Gregory David,16,0,30,14
1657038854584,MATH 10B,A01,083207,Lim; Seonhee,7,0,34,27
1657038854584,MATH 10B,A02,083208,Lim; Seonhee,9,0,35,26
1657038854584,MATH 10B,A03,093472,Lim; Seonhee,4,0,34,30
1657038854584,MATH 10B,B01,083739,Sinha; Shubham,9,0,30,21
1657038860613,MATH 18,A01,083743,Cinel; Cameron Alexander,6,0,30,24
1657038860613,MATH 18,A02,083744,Cinel; Cameron Alexander,15,0,30,15
1657038860613,MATH 18,A03,083745,Cinel; Cameron Alexander,8,0,30,22
1657038860613,MATH 18,B01,083748,Rideout; David Porter,4,0,37,33
1657038860613,MATH 18,B02,083749,Rideout; David Porter,3,0,36,33
1657038860613,MATH 18,B03,083750,Rideout; David Porter,2,0,37,35
1657038860613,MATH 18,B04,083751,Rideout; David Porter,5,0,36,31
1657038860613,MATH 18,B05,093473,Rideout; David Porter,4,0,36,32
1657038860613,MATH 18,B06,093474,Rideout; David Porter,5,0,36,31
1657038866639,MATH 20A,A01,083754,Zheng; Zequn,12,0,40,28
1657038872661,MATH 20B,A01,083756,Briones; Jor-el Thomas Caparas,1,0,36,35
1657038872661,MATH 20B,A02,083757,Briones; Jor-el Thomas Caparas,1,0,36,35
1657038872661,MATH 20B,A03,093475,Briones; Jor-el Thomas Caparas,0,0,36,36
1657038878685,MATH 20C,A01,083760,Briones; Jor-el Thomas Caparas,1,0,35,34
1657038878685,MATH 20C,A02,083761,Briones; Jor-el Thomas Caparas,8,0,35,27
1657038878685,MATH 20C,A03,093476,Briones; Jor-el Thomas Caparas,0,1,36,36
1657038878685,MATH 20C,B01,083762,Bach; Quang Tran,0,0,30,30
1657038884708,MATH 20D,A01,083765,Tran; Brian Kha,4,0,30,26
1657038884708,MATH 20D,A02,083766,Tran; Brian Kha,5,0,30,25
1657038884708,MATH 20D,A03,083767,Tran; Brian Kha,3,0,30,27
1657038890736,MATH 20E,A01,083771,Ganguly; Soumya,5,0,32,27
1657038890736,MATH 20E,A02,083772,Ganguly; Soumya,6,0,32,26
1657038890736,MATH 20E,B01,083773,Ciotti; Benjamin,18,0,35,17
1657038890736,MATH 20E,B02,083774,Ciotti; Benjamin,17,0,35,18
1657038896776,MATH 103A,A01,083777,Greenfeld; Be'Eri,2,0,36,34
1657038896776,MATH 103A,A02,083778,Greenfeld; Be'Eri,5,0,36,31
1657038896776,MATH 103A,A03,093561,Greenfeld; Be'Eri,4,0,36,32
1657038896776,MATH 103A,B01,083779,Greenfeld; Be'Eri,6,0,36,30
1657038896776,MATH 103A,B02,083780,Greenfeld; Be'Eri,2,0,36,34
1657038896776,MATH 103A,B03,093562,Greenfeld; Be'Eri,2,0,36,34
1657038902806,MATH 105,A01,085443,Carter; Anne Toulson,14,0,35,21
1657038902806,MATH 105,A02,093477,Carter; Anne Toulson,20,0,35,15
1657038908841,MATH 109,A01,083213,Ganzberger; Geoffrey Michael,2,0,34,32
1657038908841,MATH 109,A02,083214,Ganzberger; Geoffrey Michael,2,0,34,32
1657038908841,MATH 109,A03,093478,Ganzberger; Geoffrey Michael,1,0,34,33
1657038908841,MATH 109,B01,083215,Ganzberger; Geoffrey Michael,1,0,32,31
1657038908841,MATH 109,B02,083216,Ganzberger; Geoffrey Michael,1,0,32,31
1657038908841,MATH 109,B03,093479,Ganzberger; Geoffrey Michael,6,0,32,26
1657038914882,MATH 142A,A01,083219,Chow; Bennett,6,0,32,26
1657038914882,MATH 142A,A02,083220,Chow; Bennett,10,0,32,22
1657038914882,MATH 142A,A03,093480,Chow; Bennett,7,0,32,25
1657038914882,MATH 142A,B03,093481,Chow; Bennett,7,0,32,25
1657038914882,MATH 142A,B04,093558,Chow; Bennett,11,0,32,21
1657038914882,MATH 142A,B05,093559,Chow; Bennett,6,0,32,26
1657038920910,MATH 193A,A01,083224,Rotar; Vladimir,7,0,34,27
1657038920910,MATH 193A,A02,083225,Rotar; Vladimir,5,0,34,29
1657038920910,MATH 193A,A03,083781,Rotar; Vladimir,1,0,34,33
1657038920910,MATH 193A,A04,083782,Rotar; Vladimir,6,0,34,28
1657038920910,MATH 193A,A05,093482,Rotar; Vladimir,6,0,34,28
1657038926935,MATH 197,001,091859,McAuley; Julian John,9999,0,9999,0
1657038926935,MATH 197,002,095566,Kedlaya; Kiran S.,9997,0,9999,2
1657038926935,MATH 197,003,095567,Xiao; Ming,9999,0,9999,0
1657038926935,MATH 197,004,095571,Perols; Johan Lars,9998,0,9999,1
1657038933990,COGS 9,A01,083615,Shannon; Kyle Michael,7,0,75,68
1657038940024,COGS 11,A01,083617,Boyle; Mary E. T.,20,0,48,28
1657038946046,COGS 13,A01,083071,Bastos; Amalia Pinkusfeld,9,0,71,62
1657038952073,COGS 14A,A01,092681,Semenuks; Arturs,0,1,100,100
1657038958099,COGS 14B,A01,083073,Cheng; Tzu-Han,5,0,63,58
1657038964123,COGS 17,A01,092677,Semenuks; Arturs,4,0,81,77
1657038970149,COGS 100,A01,083619,Allen; Michael Gordon,15,0,70,55
1657038976183,COGS 101A,A01,083621,Davis; Joshua Daniel,9,0,68,59
1657038982207,COGS 101B,A01,091572,Allen; Michael Gordon,8,0,65,57
1657038988235,COGS 101C,A01,083625,Delgado; Tania,17,0,35,18
1657038994269,COGS 107A,A01,083627,Boyle; Mary E. T.,13,0,60,47
1657039000294,COGS 118A,A01,083075,Gupta; Anjum,15,0,76,61
1657039006328,CSE 3,A50,083646,Miranda; Gregory Joseph,22,0,50,28
1657039012357,CSE 8A,A50,083650,Miranda; Gregory Joseph,17,1,56,39
1657039018380,CSE 11,A01,083080,Cao; Yingjun,4,15,40,36
1657039024410,CSE 12,A01,083652,Krause-Levy; Sophia Louisa,21,1,120,99
1657039030445,CSE 15L,A01,083654,Morris; Justin Loren,8,0,50,42
1657039030445,CSE 15L,A02,083655,Morris; Justin Loren,9,0,50,41
1657039036467,CSE 20,A01,083657,Tran; Khoa Dang,37,0,80,43
1657039042491,CSE 21,A01,095574,Bach; Quang Tran,21,0,48,27
1657039048518,CSE 30,A01,083084,Eldon; John,4,0,80,76
1657039048518,CSE 30,B01,095061,Bhaskar; Nishant,6,0,50,44
1657039054548,CSE 100,A01,083659,Cao; Yingjun,3,4,70,67
1657039060580,CSE 134B,A01,083661,Powell; Thomas Allan,19,0,100,81
1657039066676,CSE 140,A01,083663,Gungor; Onat,14,0,85,71
1657039072707,CSE 140L,A01,083088,Eldon; John,16,0,100,84
1657039078744,CSE 175,A01,083665,Kumar; Rakesh,3,0,25,22
1657039084769,CSE 190,A00,092507,Dubnov; Shlomo,7,0,20,13
1657039090796,ECE 45,A01,083139,Congero; Spencer William,5,0,75,70
1657039096825,ECE 65,A50,083695,Saad; Andrew S,12,0,30,18
1657039096825,ECE 65,A51,095125,Saad; Andrew S,25,0,26,1
1657039102854,ECE 109,A01,091882,Touri; Behrouz,16,0,70,54
1657039108880,ECE 180,A00,083140,Abi Samra; Nicholas Camill,1,0,30,29
1657039108880,ECE 180,B00,083141,Abi Samra; Nicholas Camill,0,0,30,30
1657039114908,MATH 10A,A01,083735,Patchell; Gregory David,1,0,30,29
1657039114908,MATH 10A,A02,083736,Patchell; Gregory David,20,0,30,10
1657039114908,MATH 10A,A03,083737,Patchell; Gregory David,16,0,30,14
1657039120932,MATH 10B,A01,083207,Lim; Seonhee,7,0,34,27
1657039120932,MATH 10B,A02,083208,Lim; Seonhee,9,0,35,26
1657039120932,MATH 10B,A03,093472,Lim; Seonhee,4,0,34,30
1657039120932,MATH 10B,B01,083739,Sinha; Shubham,9,0,30,21
1657039126962,MATH 18,A01,083743,Cinel; Cameron Alexander,6,0,30,24
1657039126962,MATH 18,A02,083744,Cinel; Cameron Alexander,15,0,30,15
1657039126962,MATH 18,A03,083745,Cinel; Cameron Alexander,8,0,30,22
1657039126962,MATH 18,B01,083748,Rideout; David Porter,4,0,37,33
1657039126962,MATH 18,B02,083749,Rideout; David Porter,3,0,36,33
1657039126962,MATH 18,B03,083750,Rideout; David Porter,2,0,37,35
1657039126962,MATH 18,B04,083751,Rideout; David Porter,5,0,36,31
1657039126962,MATH 18,B05,093473,Rideout; David Porter,4,0,36,32
1657039126962,MATH 18,B06,093474,Rideout; David Porter,5,0,36,31
1657039132984,MATH 20A,A01,083754,Zheng; Zequn,12,0,40,28
1657039139008,MATH 20B,A01,083756,Briones; Jor-el Thomas Caparas,1,0,36,35
1657039139008,MATH 20B,A02,083757,Briones; Jor-el Thomas Caparas,1,0,36,35
1657039139008,MATH 20B,A03,093475,Briones; Jor-el Thomas Caparas,0,0,36,36
1657039145031,MATH 20C,A01,083760,Briones; Jor-el Thomas Caparas,1,0,35,34
1657039145031,MATH 20C,A02,083761,Briones; Jor-el Thomas Caparas,8,0,35,27
1657039145031,MATH 20C,A03,093476,Briones; Jor-el Thomas Caparas,0,1,36,36
1657039145031,MATH 20C,B01,083762,Bach; Quang Tran,0,0,30,30
1657039151067,MATH 20D,A01,083765,Tran; Brian Kha,4,0,30,26
1657039151067,MATH 20D,A02,083766,Tran; Brian Kha,5,0,30,25
1657039151067,MATH 20D,A03,083767,Tran; Brian Kha,3,0,30,27
1657039157106,MATH 20E,A01,083771,Ganguly; Soumya,5,0,32,27
1657039157106,MATH 20E,A02,083772,Ganguly; Soumya,6,0,32,26
1657039157106,MATH 20E,B01,083773,Ciotti; Benjamin,18,0,35,17
1657039157106,MATH 20E,B02,083774,Ciotti; Benjamin,17,0,35,18
1657039163130,MATH 103A,A01,083777,Greenfeld; Be'Eri,2,0,36,34
1657039163130,MATH 103A,A02,083778,Greenfeld; Be'Eri,5,0,36,31
1657039163130,MATH 103A,A03,093561,Greenfeld; Be'Eri,4,0,36,32
1657039163130,MATH 103A,B01,083779,Greenfeld; Be'Eri,6,0,36,30
1657039163130,MATH 103A,B02,083780,Greenfeld; Be'Eri,2,0,36,34
1657039163130,MATH 103A,B03,093562,Greenfeld; Be'Eri,2,0,36,34
1657039169166,MATH 105,A01,085443,Carter; Anne Toulson,14,0,35,21
1657039169166,MATH 105,A02,093477,Carter; Anne Toulson,20,0,35,15
1657039175199,MATH 109,A01,083213,Ganzberger; Geoffrey Michael,2,0,34,32
1657039175199,MATH 109,A02,083214,Ganzberger; Geoffrey Michael,2,0,34,32
1657039175199,MATH 109,A03,093478,Ganzberger; Geoffrey Michael,1,0,34,33
1657039175199,MATH 109,B01,083215,Ganzberger; Geoffrey Michael,1,0,32,31
1657039175199,MATH 109,B02,083216,Ganzberger; Geoffrey Michael,1,0,32,31
1657039175199,MATH 109,B03,093479,Ganzberger; Geoffrey Michael,6,0,32,26
1657039181223,MATH 142A,A01,083219,Chow; Bennett,6,0,32,26
1657039181223,MATH 142A,A02,083220,Chow; Bennett,10,0,32,22
1657039181223,MATH 142A,A03,093480,Chow; Bennett,7,0,32,25
1657039181223,MATH 142A,B03,093481,Chow; Bennett,7,0,32,25
1657039181223,MATH 142A,B04,093558,Chow; Bennett,11,0,32,21
1657039181223,MATH 142A,B05,093559,Chow; Bennett,6,0,32,26
1657039187251,MATH 193A,A01,083224,Rotar; Vladimir,7,0,34,27
1657039187251,MATH 193A,A02,083225,Rotar; Vladimir,5,0,34,29
1657039187251,MATH 193A,A03,083781,Rotar; Vladimir,1,0,34,33
1657039187251,MATH 193A,A04,083782,Rotar; Vladimir,6,0,34,28
1657039187251,MATH 193A,A05,093482,Rotar; Vladimir,6,0,34,28
1657039193281,MATH 197,001,091859,McAuley; Julian John,9999,0,9999,0
1657039193281,MATH 197,002,095566,Kedlaya; Kiran S.,9997,0,9999,2
1657039193281,MATH 197,003,095567,Xiao; Ming,9999,0,9999,0
1657039193281,MATH 197,004,095571,Perols; Johan Lars,9998,0,9999,1
1657039200336,COGS 9,A01,083615,Shannon; Kyle Michael,7,0,75,68
1657039206361,COGS 11,A01,083617,Boyle; Mary E. T.,20,0,48,28
1657039212389,COGS 13,A01,083071,Bastos; Amalia Pinkusfeld,9,0,71,62
1657039218414,COGS 14A,A01,092681,Semenuks; Arturs,0,1,100,100
1657039224445,COGS 14B,A01,083073,Cheng; Tzu-Han,5,0,63,58
1657039230467,COGS 17,A01,092677,Semenuks; Arturs,4,0,81,77
1657039236491,COGS 100,A01,083619,Allen; Michael Gordon,15,0,70,55
1657039242518,COGS 101A,A01,083621,Davis; Joshua Daniel,9,0,68,59
1657039248545,COGS 101B,A01,091572,Allen; Michael Gordon,8,0,65,57
1657039254575,COGS 101C,A01,083625,Delgado; Tania,17,0,35,18
1657039260598,COGS 107A,A01,083627,Boyle; Mary E. T.,13,0,60,47
1657039266620,COGS 118A,A01,083075,Gupta; Anjum,15,0,76,61
1657039272644,CSE 3,A50,083646,Miranda; Gregory Joseph,22,0,50,28
1657039278715,CSE 8A,A50,083650,Miranda; Gregory Joseph,17,1,56,39
1657039284742,CSE 11,A01,083080,Cao; Yingjun,4,15,40,36
1657039290775,CSE 12,A01,083652,Krause-Levy; Sophia Louisa,22,1,120,98
1657039296806,CSE 15L,A01,083654,Morris; Justin Loren,8,0,50,42
1657039296806,CSE 15L,A02,083655,Morris; Justin Loren,9,0,50,41
1657039302834,CSE 20,A01,083657,Tran; Khoa Dang,37,0,80,43
1657039308873,CSE 21,A01,095574,Bach; Quang Tran,21,0,48,27
1657039314896,CSE 30,A01,083084,Eldon; John,4,0,80,76
1657039314896,CSE 30,B01,095061,Bhaskar; Nishant,6,0,50,44
1657039320920,CSE 100,A01,083659,Cao; Yingjun,3,4,70,67
1657039326946,CSE 134B,A01,083661,Powell; Thomas Allan,19,0,100,81
1657039332969,CSE 140,A01,083663,Gungor; Onat,14,0,85,71
1657039338996,CSE 140L,A01,083088,Eldon; John,16,0,100,84
1657039345019,CSE 175,A01,083665,Kumar; Rakesh,3,0,25,22
1657039351041,CSE 190,A00,092507,Dubnov; Shlomo,7,0,20,13
1657039357072,ECE 45,A01,083139,Congero; Spencer William,5,0,75,70
1657039363096,ECE 65,A50,083695,Saad; Andrew S,12,0,30,18
1657039363096,ECE 65,A51,095125,Saad; Andrew S,25,0,26,1
1657039369125,ECE 109,A01,091882,Touri; Behrouz,16,0,70,54
1657039375150,ECE 180,A00,083140,Abi Samra; Nicholas Camill,1,0,30,29
1657039375150,ECE 180,B00,083141,Abi Samra; Nicholas Camill,0,0,30,30
1657039381178,MATH 10A,A01,083735,Patchell; Gregory David,1,0,30,29
1657039381178,MATH 10A,A02,083736,Patchell; Gregory David,20,0,30,10
1657039381178,MATH 10A,A03,083737,Patchell; Gregory David,16,0,30,14
1657039387206,MATH 10B,A01,083207,Lim; Seonhee,7,0,34,27
1657039387206,MATH 10B,A02,083208,Lim; Seonhee,9,0,35,26
1657039387206,MATH 10B,A03,093472,Lim; Seonhee,4,0,34,30
1657039387206,MATH 10B,B01,083739,Sinha; Shubham,9,0,30,21
1657039393236,MATH 18,A01,083743,Cinel; Cameron Alexander,6,0,30,24
1657039393236,MATH 18,A02,083744,Cinel; Cameron Alexander,15,0,30,15
1657039393236,MATH 18,A03,083745,Cinel; Cameron Alexander,8,0,30,22
1657039393236,MATH 18,B01,083748,Rideout; David Porter,4,0,37,33
1657039393236,MATH 18,B02,083749,Rideout; David Porter,3,0,36,33
1657039393236,MATH 18,B03,083750,Rideout; David Porter,2,0,37,35
1657039393236,MATH 18,B04,083751,Rideout; David Porter,5,0,36,31
1657039393236,MATH 18,B05,093473,Rideout; David Porter,4,0,36,32
1657039393236,MATH 18,B06,093474,Rideout; David Porter,5,0,36,31
1657039399268,MATH 20A,A01,083754,Zheng; Zequn,12,0,40,28
1657039405295,MATH 20B,A01,083756,Briones; Jor-el Thomas Caparas,1,0,36,35
1657039405295,MATH 20B,A02,083757,Briones; Jor-el Thomas Caparas,1,0,36,35
1657039405295,MATH 20B,A03,093475,Briones; Jor-el Thomas Caparas,0,0,36,36
1657039411319,MATH 20C,A01,083760,Briones; Jor-el Thomas Caparas,1,0,35,34
1657039411319,MATH 20C,A02,083761,Briones; Jor-el Thomas Caparas,8,0,35,27
1657039411319,MATH 20C,A03,093476,Briones; Jor-el Thomas Caparas,0,1,36,36
1657039411319,MATH 20C,B01,083762,Bach; Quang Tran,0,0,30,30
1657039417347,MATH 20D,A01,083765,Tran; Brian Kha,4,0,30,26
1657039417347,MATH 20D,A02,083766,Tran; Brian Kha,5,0,30,25
1657039417347,MATH 20D,A03,083767,Tran; Brian Kha,3,0,30,27
1657039423379,MATH 20E,A01,083771,Ganguly; Soumya,5,0,32,27
1657039423379,MATH 20E,A02,083772,Ganguly; Soumya,6,0,32,26
1657039423379,MATH 20E,B01,083773,Ciotti; Benjamin,18,0,35,17
1657039423379,MATH 20E,B02,083774,Ciotti; Benjamin,17,0,35,18
1657039429405,MATH 103A,A01,083777,Greenfeld; Be'Eri,2,0,36,34
1657039429405,MATH 103A,A02,083778,Greenfeld; Be'Eri,5,0,36,31
1657039429405,MATH 103A,A03,093561,Greenfeld; Be'Eri,4,0,36,32
1657039429405,MATH 103A,B01,083779,Greenfeld; Be'Eri,6,0,36,30
1657039429405,MATH 103A,B02,083780,Greenfeld; Be'Eri,2,0,36,34
1657039429405,MATH 103A,B03,093562,Greenfeld; Be'Eri,2,0,36,34
1657039435433,MATH 105,A01,085443,Carter; Anne Toulson,14,0,35,21
1657039435433,MATH 105,A02,093477,Carter; Anne Toulson,20,0,35,15
1657039441457,MATH 109,A01,083213,Ganzberger; Geoffrey Michael,2,0,34,32
1657039441457,MATH 109,A02,083214,Ganzberger; Geoffrey Michael,2,0,34,32
1657039441457,MATH 109,A03,093478,Ganzberger; Geoffrey Michael,1,0,34,33
1657039441457,MATH 109,B01,083215,Ganzberger; Geoffrey Michael,1,0,32,31
1657039441457,MATH 109,B02,083216,Ganzberger; Geoffrey Michael,1,0,32,31
1657039441457,MATH 109,B03,093479,Ganzberger; Geoffrey Michael,6,0,32,26
1657039447496,MATH 142A,A01,083219,Chow; Bennett,6,0,32,26
1657039447496,MATH 142A,A02,083220,Chow; Bennett,10,0,32,22
1657039447496,MATH 142A,A03,093480,Chow; Bennett,7,0,32,25
1657039447496,MATH 142A,B03,093481,Chow; Bennett,7,0,32,25
1657039447496,MATH 142A,B04,093558,Chow; Bennett,11,0,32,21
1657039447496,MATH 142A,B05,093559,Chow; Bennett,6,0,32,26
1657039453519,MATH 193A,A01,083224,Rotar; Vladimir,7,0,34,27
1657039453519,MATH 193A,A02,083225,Rotar; Vladimir,5,0,34,29
1657039453519,MATH 193A,A03,083781,Rotar; Vladimir,1,0,34,33
1657039453519,MATH 193A,A04,083782,Rotar; Vladimir,6,0,34,28
1657039453519,MATH 193A,A05,093482,Rotar; Vladimir,6,0,34,28
1657039459544,MATH 197,001,091859,McAuley; Julian John,9999,0,9999,0
1657039459544,MATH 197,002,095566,Kedlaya; Kiran S.,9997,0,9999,2
1657039459544,MATH 197,003,095567,Xiao; Ming,9999,0,9999,0
1657039459544,MATH 197,004,095571,Perols; Johan Lars,9998,0,9999,1
1657039466626,COGS 9,A01,083615,Shannon; Kyle Michael,7,0,75,68
1657039472652,COGS 11,A01,083617,Boyle; Mary E. T.,20,0,48,28
1657039478682,COGS 13,A01,083071,Bastos; Amalia Pinkusfeld,9,0,71,62
1657039484708,COGS 14A,A01,092681,Semenuks; Arturs,0,1,100,100
1657039490735,COGS 14B,A01,083073,Cheng; Tzu-Han,5,0,63,58
1657039496756,COGS 17,A01,092677,Semenuks; Arturs,4,0,81,77
1657039502778,COGS 100,A01,083619,Allen; Michael Gordon,15,0,70,55
1657039508803,COGS 101A,A01,083621,Davis; Joshua Daniel,9,0,68,59
1657039514829,COGS 101B,A01,091572,Allen; Michael Gordon,8,0,65,57
1657039520852,COGS 101C,A01,083625,Delgado; Tania,17,0,35,18
1657039526878,COGS 107A,A01,083627,Boyle; Mary E. T.,13,0,60,47
1657039532902,COGS 118A,A01,083075,Gupta; Anjum,15,0,76,61
1657039538927,CSE 3,A50,083646,Miranda; Gregory Joseph,22,0,50,28
1657039544965,CSE 8A,A50,083650,Miranda; Gregory Joseph,17,1,56,39
1657039550989,CSE 11,A01,083080,Cao; Yingjun,4,15,40,36
1657039557017,CSE 12,A01,083652,Krause-Levy; Sophia Louisa,22,1,120,98
1657039563040,CSE 15L,A01,083654,Morris; Justin Loren,8,0,50,42
1657039563040,CSE 15L,A02,083655,Morris; Justin Loren,9,0,50,41
1657039569065,CSE 20,A01,083657,Tran; Khoa Dang,37,0,80,43
1657039575086,CSE 21,A01,095574,Bach; Quang Tran,21,0,48,27
1657039581110,CSE 30,A01,083084,Eldon; John,4,0,80,76
1657039581110,CSE 30,B01,095061,Bhaskar; Nishant,6,0,50,44
1657039587136,CSE 100,A01,083659,Cao; Yingjun,3,4,70,67
1657039593159,CSE 134B,A01,083661,Powell; Thomas Allan,19,0,100,81
1657039599184,CSE 140,A01,083663,Gungor; Onat,14,0,85,71
1657039605225,CSE 140L,A01,083088,Eldon; John,16,0,100,84
1657039611247,CSE 175,A01,083665,Kumar; Rakesh,3,0,25,22
1657039617271,CSE 190,A00,092507,Dubnov; Shlomo,7,0,20,13
1657039623298,ECE 45,A01,083139,Congero; Spencer William,5,0,75,70
1657039629322,ECE 65,A50,083695,Saad; Andrew S,12,0,30,18
1657039629322,ECE 65,A51,095125,Saad; Andrew S,25,0,26,1
1657039635346,ECE 109,A01,091882,Touri; Behrouz,16,0,70,54
1657039641371,ECE 180,A00,083140,Abi Samra; Nicholas Camill,1,0,30,29
1657039641371,ECE 180,B00,083141,Abi Samra; Nicholas Camill,0,0,30,30
1657039647393,MATH 10A,A01,083735,Patchell; Gregory David,1,0,30,29
1657039647393,MATH 10A,A02,083736,Patchell; Gregory David,20,0,30,10
1657039647393,MATH 10A,A03,083737,Patchell; Gregory David,16,0,30,14
1657039653419,MATH 10B,A01,083207,Lim; Seonhee,7,0,34,27
1657039653419,MATH 10B,A02,083208,Lim; Seonhee,9,0,35,26
1657039653419,MATH 10B,A03,093472,Lim; Seonhee,4,0,34,30
1657039653419,MATH 10B,B01,083739,Sinha; Shubham,9,0,30,21
1657039659455,MATH 18,A01,083743,Cinel; Cameron Alexander,6,0,30,24
1657039659455,MATH 18,A02,083744,Cinel; Cameron Alexander,15,0,30,15
1657039659455,MATH 18,A03,083745,Cinel; Cameron Alexander,8,0,30,22
1657039659455,MATH 18,B01,083748,Rideout; David Porter,4,0,37,33
1657039659455,MATH 18,B02,083749,Rideout; David Porter,3,0,36,33
1657039659455,MATH 18,B03,083750,Rideout; David Porter,2,0,37,35
1657039659455,MATH 18,B04,083751,Rideout; David Porter,5,0,36,31
1657039659455,MATH 18,B05,093473,Rideout; David Porter,4,0,36,32
1657039659455,MATH 18,B06,093474,Rideout; David Porter,5,0,36,31
1657039665561,MATH 20A,A01,083754,Zheng; Zequn,12,0,40,28
1657039671588,MATH 20B,A01,083756,Briones; Jor-el Thomas Caparas,1,0,36,35
1657039671588,MATH 20B,A02,083757,Briones; Jor-el Thomas Caparas,1,0,36,35
1657039671588,MATH 20B,A03,093475,Briones; Jor-el Thomas Caparas,0,0,36,36
1657039677614,MATH 20C,A01,083760,Briones; Jor-el Thomas Caparas,1,0,35,34
1657039677614,MATH 20C,A02,083761,Briones; Jor-el Thomas Caparas,8,0,35,27
1657039677614,MATH 20C,A03,093476,Briones; Jor-el Thomas Caparas,0,1,36,36
1657039677614,MATH 20C,B01,083762,Bach; Quang Tran,0,0,30,30
1657039683639,MATH 20D,A01,083765,Tran; Brian Kha,4,0,30,26
1657039683639,MATH 20D,A02,083766,Tran; Brian Kha,5,0,30,25
1657039683639,MATH 20D,A03,083767,Tran; Brian Kha,3,0,30,27
1657039689663,MATH 20E,A01,083771,Ganguly; Soumya,5,0,32,27
1657039689663,MATH 20E,A02,083772,Ganguly; Soumya,6,0,32,26
1657039689663,MATH 20E,B01,083773,Ciotti; Benjamin,18,0,35,17
1657039689663,MATH 20E,B02,083774,Ciotti; Benjamin,17,0,35,18
1657039695685,MATH 103A,A01,083777,Greenfeld; Be'Eri,2,0,36,34
1657039695685,MATH 103A,A02,083778,Greenfeld; Be'Eri,5,0,36,31
1657039695685,MATH 103A,A03,093561,Greenfeld; Be'Eri,4,0,36,32
1657039695685,MATH 103A,B01,083779,Greenfeld; Be'Eri,6,0,36,30
1657039695685,MATH 103A,B02,083780,Greenfeld; Be'Eri,2,0,36,34
1657039695685,MATH 103A,B03,093562,Greenfeld; Be'Eri,2,0,36,34
1657039701709,MATH 105,A01,085443,Carter; Anne Toulson,14,0,35,21
1657039701709,MATH 105,A02,093477,Carter; Anne Toulson,20,0,35,15
1657039707745,MATH 109,A01,083213,Ganzberger; Geoffrey Michael,2,0,34,32
1657039707745,MATH 109,A02,083214,Ganzberger; Geoffrey Michael,2,0,34,32
1657039707745,MATH 109,A03,093478,Ganzberger; Geoffrey Michael,1,0,34,33
1657039707745,MATH 109,B01,083215,Ganzberger; Geoffrey Michael,1,0,32,31
1657039707745,MATH 109,B02,083216,Ganzberger; Geoffrey Michael,1,0,32,31
1657039707745,MATH 109,B03,093479,Ganzberger; Geoffrey Michael,6,0,32,26
1657039713774,MATH 142A,A01,083219,Chow; Bennett,6,0,32,26
1657039713774,MATH 142A,A02,083220,Chow; Bennett,10,0,32,22
1657039713774,MATH 142A,A03,093480,Chow; Bennett,7,0,32,25
1657039713774,MATH 142A,B03,093481,Chow; Bennett,7,0,32,25
1657039713774,MATH 142A,B04,093558,Chow; Bennett,11,0,32,21
1657039713774,MATH 142A,B05,093559,Chow; Bennett,6,0,32,26
1657039719802,MATH 193A,A01,083224,Rotar; Vladimir,7,0,34,27
1657039719802,MATH 193A,A02,083225,Rotar; Vladimir,5,0,34,29
1657039719802,MATH 193A,A03,083781,Rotar; Vladimir,1,0,34,33
1657039719802,MATH 193A,A04,083782,Rotar; Vladimir,6,0,34,28
1657039719802,MATH 193A,A05,093482,Rotar; Vladimir,6,0,34,28
1657039725827,MATH 197,001,091859,McAuley; Julian John,9999,0,9999,0
1657039725827,MATH 197,002,095566,Kedlaya; Kiran S.,9997,0,9999,2
1657039725827,MATH 197,003,095567,Xiao; Ming,9999,0,9999,0
1657039725827,MATH 197,004,095571,Perols; Johan Lars,9998,0,9999,1
1657039732922,COGS 9,A01,083615,Shannon; Kyle Michael,7,0,75,68
1657039738950,COGS 11,A01,083617,Boyle; Mary E. T.,20,0,48,28
1657039744979,COGS 13,A01,083071,Bastos; Amalia Pinkusfeld,9,0,71,62
1657039751004,COGS 14A,A01,092681,Semenuks; Arturs,0,1,100,100
1657039757028,COGS 14B,A01,083073,Cheng; Tzu-Han,5,0,63,58
1657039763057,COGS 17,A01,092677,Semenuks; Arturs,4,0,81,77
1657039769084,COGS 100,A01,083619,Allen; Michael Gordon,15,0,70,55
1657039775110,COGS 101A,A01,083621,Davis; Joshua Daniel,9,0,68,59
1657039781134,COGS 101B,A01,091572,Allen; Michael Gordon,8,0,65,57
1657039787162,COGS 101C,A01,083625,Delgado; Tania,17,0,35,18
1657039793190,COGS 107A,A01,083627,Boyle; Mary E. T.,13,0,60,47
1657039799213,COGS 118A,A01,083075,Gupta; Anjum,15,0,76,61
1657039805240,CSE 3,A50,083646,Miranda; Gregory Joseph,22,0,50,28
1657039811265,CSE 8A,A50,083650,Miranda; Gregory Joseph,17,1,56,39
1657039817288,CSE 11,A01,083080,Cao; Yingjun,4,15,40,36
1657039823309,CSE 12,A01,083652,Krause-Levy; Sophia Louisa,22,1,120,98
1657039829349,CSE 15L,A01,083654,Morris; Justin Loren,8,0,50,42
1657039829349,CSE 15L,A02,083655,Morris; Justin Loren,9,0,50,41
1657039835381,CSE 20,A01,083657,Tran; Khoa Dang,37,0,80,43
1657039841409,CSE 21,A01,095574,Bach; Quang Tran,21,0,48,27
1657039847451,CSE 30,A01,083084,Eldon; John,4,0,80,76
1657039847451,CSE 30,B01,095061,Bhaskar; Nishant,6,0,50,44
1657039853484,CSE 100,A01,083659,Cao; Yingjun,3,4,70,67
1657039859521,CSE 134B,A01,083661,Powell; Thomas Allan,19,0,100,81
1657039865552,CSE 140,A01,083663,Gungor; Onat,14,0,85,71
1657039871580,CSE 140L,A01,083088,Eldon; John,16,0,100,84
1657039877611,CSE 175,A01,083665,Kumar; Rakesh,3,0,25,22
1657039883634,CSE 190,A00,092507,Dubnov; Shlomo,7,0,20,13
1657039889663,ECE 45,A01,083139,Congero; Spencer William,5,0,75,70
1657039895690,ECE 65,A50,083695,Saad; Andrew S,12,0,30,18
1657039895690,ECE 65,A51,095125,Saad; Andrew S,25,0,26,1
1657039901715,ECE 109,A01,091882,Touri; Behrouz,16,0,70,54
1657039907741,ECE 180,A00,083140,Abi Samra; Nicholas Camill,1,0,30,29
1657039907741,ECE 180,B00,083141,Abi Samra; Nicholas Camill,0,0,30,30
1657039913765,MATH 10A,A01,083735,Patchell; Gregory David,1,0,30,29
1657039913765,MATH 10A,A02,083736,Patchell; Gregory David,20,0,30,10
1657039913765,MATH 10A,A03,083737,Patchell; Gregory David,16,0,30,14
1657039919789,MATH 10B,A01,083207,Lim; Seonhee,7,0,34,27
1657039919789,MATH 10B,A02,083208,Lim; Seonhee,9,0,35,26
1657039919789,MATH 10B,A03,093472,Lim; Seonhee,4,0,34,30
1657039919789,MATH 10B,B01,083739,Sinha; Shubham,9,0,30,21
1657039925821,MATH 18,A01,083743,Cinel; Cameron Alexander,6,0,30,24
1657039925821,MATH 18,A02,083744,Cinel; Cameron Alexander,15,0,30,15
1657039925821,MATH 18,A03,083745,Cinel; Cameron Alexander,8,0,30,22
1657039925821,MATH 18,B01,083748,Rideout; David Porter,4,0,37,33
1657039925821,MATH 18,B02,083749,Rideout; David Porter,3,0,36,33
1657039925821,MATH 18,B03,083750,Rideout; David Porter,2,0,37,35
1657039925821,MATH 18,B04,083751,Rideout; David Porter,5,0,36,31
1657039925821,MATH 18,B05,093473,Rideout; David Porter,4,0,36,32
1657039925821,MATH 18,B06,093474,Rideout; David Porter,5,0,36,31
1657039931847,MATH 20A,A01,083754,Zheng; Zequn,12,0,40,28
1657039937872,MATH 20B,A01,083756,Briones; Jor-el Thomas Caparas,1,0,36,35
1657039937872,MATH 20B,A02,083757,Briones; Jor-el Thomas Caparas,1,0,36,35
1657039937872,MATH 20B,A03,093475,Briones; Jor-el Thomas Caparas,0,0,36,36
1657039943901,MATH 20C,A01,083760,Briones; Jor-el Thomas Caparas,1,0,35,34
1657039943901,MATH 20C,A02,083761,Briones; Jor-el Thomas Caparas,8,0,35,27
1657039943901,MATH 20C,A03,093476,Briones; Jor-el Thomas Caparas,0,1,36,36
1657039943901,MATH 20C,B01,083762,Bach; Quang Tran,0,0,30,30
1657039949926,MATH 20D,A01,083765,Tran; Brian Kha,4,0,30,26
1657039949926,MATH 20D,A02,083766,Tran; Brian Kha,5,0,30,25
1657039949926,MATH 20D,A03,083767,Tran; Brian Kha,3,0,30,27
1657039955950,MATH 20E,A01,083771,Ganguly; Soumya,5,0,32,27
1657039955950,MATH 20E,A02,083772,Ganguly; Soumya,6,0,32,26
1657039955950,MATH 20E,B01,083773,Ciotti; Benjamin,18,0,35,17
1657039955950,MATH 20E,B02,083774,Ciotti; Benjamin,17,0,35,18
1657039961980,MATH 103A,A01,083777,Greenfeld; Be'Eri,2,0,36,34
1657039961980,MATH 103A,A02,083778,Greenfeld; Be'Eri,5,0,36,31
1657039961980,MATH 103A,A03,093561,Greenfeld; Be'Eri,4,0,36,32
1657039961980,MATH 103A,B01,083779,Greenfeld; Be'Eri,6,0,36,30
1657039961980,MATH 103A,B02,083780,Greenfeld; Be'Eri,2,0,36,34
1657039961980,MATH 103A,B03,093562,Greenfeld; Be'Eri,2,0,36,34
1657039968017,MATH 105,A01,085443,Carter; Anne Toulson,14,0,35,21
1657039968017,MATH 105,A02,093477,Carter; Anne Toulson,20,0,35,15
1657039974040,MATH 109,A01,083213,Ganzberger; Geoffrey Michael,2,0,34,32
1657039974040,MATH 109,A02,083214,Ganzberger; Geoffrey Michael,2,0,34,32
1657039974040,MATH 109,A03,093478,Ganzberger; Geoffrey Michael,1,0,34,33
1657039974040,MATH 109,B01,083215,Ganzberger; Geoffrey Michael,1,0,32,31
1657039974040,MATH 109,B02,083216,Ganzberger; Geoffrey Michael,1,0,32,31
1657039974040,MATH 109,B03,093479,Ganzberger; Geoffrey Michael,6,0,32,26
1657039980071,MATH 142A,A01,083219,Chow; Bennett,6,0,32,26
1657039980071,MATH 142A,A02,083220,Chow; Bennett,10,0,32,22
1657039980071,MATH 142A,A03,093480,Chow; Bennett,7,0,32,25
1657039980071,MATH 142A,B03,093481,Chow; Bennett,7,0,32,25
1657039980071,MATH 142A,B04,093558,Chow; Bennett,11,0,32,21
1657039980071,MATH 142A,B05,093559,Chow; Bennett,6,0,32,26
1657039986099,MATH 193A,A01,083224,Rotar; Vladimir,7,0,34,27
1657039986099,MATH 193A,A02,083225,Rotar; Vladimir,5,0,34,29
1657039986099,MATH 193A,A03,083781,Rotar; Vladimir,1,0,34,33
1657039986099,MATH 193A,A04,083782,Rotar; Vladimir,6,0,34,28
1657039986099,MATH 193A,A05,093482,Rotar; Vladimir,6,0,34,28
1657039992122,MATH 197,001,091859,McAuley; Julian John,9999,0,9999,0
1657039992122,MATH 197,002,095566,Kedlaya; Kiran S.,9997,0,9999,2
1657039992122,MATH 197,003,095567,Xiao; Ming,9999,0,9999,0
1657039992122,MATH 197,004,095571,Perols; Johan Lars,9998,0,9999,1
1657039999180,COGS 9,A01,083615,Shannon; Kyle Michael,7,0,75,68
1657040005203,COGS 11,A01,083617,Boyle; Mary E. T.,20,0,48,28
1657040011241,COGS 13,A01,083071,Bastos; Amalia Pinkusfeld,9,0,71,62
1657040017277,COGS 14A,A01,092681,Semenuks; Arturs,0,1,100,100
1657040023299,COGS 14B,A01,083073,Cheng; Tzu-Han,5,0,63,58
1657040029322,COGS 17,A01,092677,Semenuks; Arturs,4,0,81,77
1657040035345,COGS 100,A01,083619,Allen; Michael Gordon,15,0,70,55
1657040041368,COGS 101A,A01,083621,Davis; Joshua Daniel,9,0,68,59
1657040047395,COGS 101B,A01,091572,Allen; Michael Gordon,8,0,65,57
1657040053421,COGS 101C,A01,083625,Delgado; Tania,17,0,35,18
1657040059446,COGS 107A,A01,083627,Boyle; Mary E. T.,13,0,60,47
1657040065467,COGS 118A,A01,083075,Gupta; Anjum,15,0,76,61
1657040071493,CSE 3,A50,083646,Miranda; Gregory Joseph,22,0,50,28
1657040077518,CSE 8A,A50,083650,Miranda; Gregory Joseph,17,1,56,39
1657040083546,CSE 11,A01,083080,Cao; Yingjun,4,15,40,36
1657040089571,CSE 12,A01,083652,Krause-Levy; Sophia Louisa,22,1,120,98
1657040095600,CSE 15L,A01,083654,Morris; Justin Loren,8,0,50,42
1657040095600,CSE 15L,A02,083655,Morris; Justin Loren,9,0,50,41
1657040101627,CSE 20,A01,083657,Tran; Khoa Dang,37,0,80,43
1657040107665,CSE 21,A01,095574,Bach; Quang Tran,21,0,48,27
1657040113688,CSE 30,A01,083084,Eldon; John,4,0,80,76
1657040113688,CSE 30,B01,095061,Bhaskar; Nishant,6,0,50,44
1657040119711,CSE 100,A01,083659,Cao; Yingjun,3,4,70,67
1657040125733,CSE 134B,A01,083661,Powell; Thomas Allan,19,0,100,81
1657040131759,CSE 140,A01,083663,Gungor; Onat,14,0,85,71
1657040137782,CSE 140L,A01,083088,Eldon; John,16,0,100,84
1657040143810,CSE 175,A01,083665,Kumar; Rakesh,3,0,25,22
1657040149832,CSE 190,A00,092507,Dubnov; Shlomo,7,0,20,13
1657040155863,ECE 45,A01,083139,Congero; Spencer William,5,0,75,70
1657040161889,ECE 65,A50,083695,Saad; Andrew S,12,0,30,18
1657040161889,ECE 65,A51,095125,Saad; Andrew S,25,0,26,1
1657040167911,ECE 109,A01,091882,Touri; Behrouz,16,0,70,54
1657040173935,ECE 180,A00,083140,Abi Samra; Nicholas Camill,1,0,30,29
1657040173935,ECE 180,B00,083141,Abi Samra; Nicholas Camill,0,0,30,30
1657040179965,MATH 10A,A01,083735,Patchell; Gregory David,1,0,30,29
1657040179965,MATH 10A,A02,083736,Patchell; Gregory David,20,0,30,10
1657040179965,MATH 10A,A03,083737,Patchell; Gregory David,16,0,30,14
1657040185996,MATH 10B,A01,083207,Lim; Seonhee,7,0,34,27
1657040185996,MATH 10B,A02,083208,Lim; Seonhee,9,0,35,26
1657040185996,MATH 10B,A03,093472,Lim; Seonhee,4,0,34,30
1657040185996,MATH 10B,B01,083739,Sinha; Shubham,9,0,30,21
1657040192025,MATH 18,A01,083743,Cinel; Cameron Alexander,6,0,30,24
1657040192025,MATH 18,A02,083744,Cinel; Cameron Alexander,15,0,30,15
1657040192025,MATH 18,A03,083745,Cinel; Cameron Alexander,8,0,30,22
1657040192025,MATH 18,B01,083748,Rideout; David Porter,4,0,37,33
1657040192025,MATH 18,B02,083749,Rideout; David Porter,3,0,36,33
1657040192025,MATH 18,B03,083750,Rideout; David Porter,2,0,37,35
1657040192025,MATH 18,B04,083751,Rideout; David Porter,5,0,36,31
1657040192025,MATH 18,B05,093473,Rideout; David Porter,4,0,36,32
1657040192025,MATH 18,B06,093474,Rideout; David Porter,5,0,36,31
1657040198061,MATH 20A,A01,083754,Zheng; Zequn,12,0,40,28
1657040204088,MATH 20B,A01,083756,Briones; Jor-el Thomas Caparas,1,0,36,35
1657040204088,MATH 20B,A02,083757,Briones; Jor-el Thomas Caparas,1,0,36,35
1657040204088,MATH 20B,A03,093475,Briones; Jor-el Thomas Caparas,0,0,36,36
1657040210113,MATH 20C,A01,083760,Briones; Jor-el Thomas Caparas,1,0,35,34
1657040210113,MATH 20C,A02,083761,Briones; Jor-el Thomas Caparas,8,0,35,27
1657040210113,MATH 20C,A03,093476,Briones; Jor-el Thomas Caparas,0,1,36,36
1657040210113,MATH 20C,B01,083762,Bach; Quang Tran,0,0,30,30
1657040216140,MATH 20D,A01,083765,Tran; Brian Kha,4,0,30,26
1657040216140,MATH 20D,A02,083766,Tran; Brian Kha,5,0,30,25
1657040216140,MATH 20D,A03,083767,Tran; Brian Kha,3,0,30,27
1657040222170,MATH 20E,A01,083771,Ganguly; Soumya,5,0,32,27
1657040222170,MATH 20E,A02,083772,Ganguly; Soumya,6,0,32,26
1657040222170,MATH 20E,B01,083773,Ciotti; Benjamin,18,0,35,17
1657040222170,MATH 20E,B02,083774,Ciotti; Benjamin,17,0,35,18
1657040228194,MATH 103A,A01,083777,Greenfeld; Be'Eri,2,0,36,34
1657040228194,MATH 103A,A02,083778,Greenfeld; Be'Eri,5,0,36,31
1657040228194,MATH 103A,A03,093561,Greenfeld; Be'Eri,4,0,36,32
1657040228194,MATH 103A,B01,083779,Greenfeld; Be'Eri,6,0,36,30
1657040228194,MATH 103A,B02,083780,Greenfeld; Be'Eri,2,0,36,34
1657040228194,MATH 103A,B03,093562,Greenfeld; Be'Eri,2,0,36,34
1657040234220,MATH 105,A01,085443,Carter; Anne Toulson,14,0,35,21
1657040234220,MATH 105,A02,093477,Carter; Anne Toulson,20,0,35,15
1657040240249,MATH 109,A01,083213,Ganzberger; Geoffrey Michael,2,0,34,32
1657040240249,MATH 109,A02,083214,Ganzberger; Geoffrey Michael,2,0,34,32
1657040240249,MATH 109,A03,093478,Ganzberger; Geoffrey Michael,1,0,34,33
1657040240249,MATH 109,B01,083215,Ganzberger; Geoffrey Michael,1,0,32,31
1657040240249,MATH 109,B02,083216,Ganzberger; Geoffrey Michael,1,0,32,31
1657040240249,MATH 109,B03,093479,Ganzberger; Geoffrey Michael,6,0,32,26
1657040246275,MATH 142A,A01,083219,Chow; Bennett,6,0,32,26
1657040246275,MATH 142A,A02,083220,Chow; Bennett,10,0,32,22
1657040246275,MATH 142A,A03,093480,Chow; Bennett,7,0,32,25
1657040246275,MATH 142A,B03,093481,Chow; Bennett,7,0,32,25
1657040246275,MATH 142A,B04,093558,Chow; Bennett,11,0,32,21
1657040246275,MATH 142A,B05,093559,Chow; Bennett,6,0,32,26
1657040252296,MATH 193A,A01,083224,Rotar; Vladimir,7,0,34,27
1657040252296,MATH 193A,A02,083225,Rotar; Vladimir,5,0,34,29
1657040252296,MATH 193A,A03,083781,Rotar; Vladimir,1,0,34,33
1657040252296,MATH 193A,A04,083782,Rotar; Vladimir,6,0,34,28
1657040252296,MATH 193A,A05,093482,Rotar; Vladimir,6,0,34,28
1657040258320,MATH 197,001,091859,McAuley; Julian John,9999,0,9999,0
1657040258320,MATH 197,002,095566,Kedlaya; Kiran S.,9997,0,9999,2
1657040258320,MATH 197,003,095567,Xiao; Ming,9999,0,9999,0
1657040258320,MATH 197,004,095571,Perols; Johan Lars,9998,0,9999,1
1657040265475,COGS 9,A01,083615,Shannon; Kyle Michael,7,0,75,68
1657040271509,COGS 11,A01,083617,Boyle; Mary E. T.,20,0,48,28
1657040277532,COGS 13,A01,083071,Bastos; Amalia Pinkusfeld,9,0,71,62
1657040283557,COGS 14A,A01,092681,Semenuks; Arturs,0,1,100,100
1657040289580,COGS 14B,A01,083073,Cheng; Tzu-Han,5,0,63,58
1657040295606,COGS 17,A01,092677,Semenuks; Arturs,4,0,81,77
1657040301629,COGS 100,A01,083619,Allen; Michael Gordon,15,0,70,55
1657040307653,COGS 101A,A01,083621,Davis; Joshua Daniel,9,0,68,59
1657040313679,COGS 101B,A01,091572,Allen; Michael Gordon,8,0,65,57
1657040319707,COGS 101C,A01,083625,Delgado; Tania,17,0,35,18
1657040325742,COGS 107A,A01,083627,Boyle; Mary E. T.,13,0,60,47
1657040331766,COGS 118A,A01,083075,Gupta; Anjum,15,0,76,61
1657040337789,CSE 3,A50,083646,Miranda; Gregory Joseph,22,0,50,28
1657040343814,CSE 8A,A50,083650,Miranda; Gregory Joseph,17,1,56,39
1657040349840,CSE 11,A01,083080,Cao; Yingjun,4,15,40,36
1657040355870,CSE 12,A01,083652,Krause-Levy; Sophia Louisa,22,1,120,98
1657040361893,CSE 15L,A01,083654,Morris; Justin Loren,8,0,50,42
1657040361893,CSE 15L,A02,083655,Morris; Justin Loren,9,0,50,41
1657040367920,CSE 20,A01,083657,Tran; Khoa Dang,37,0,80,43
1657040373945,CSE 21,A01,095574,Bach; Quang Tran,21,0,48,27
1657040379969,CSE 30,A01,083084,Eldon; John,4,0,80,76
1657040379969,CSE 30,B01,095061,Bhaskar; Nishant,6,0,50,44
1657040386003,CSE 100,A01,083659,Cao; Yingjun,3,4,70,67
1657040392028,CSE 134B,A01,083661,Powell; Thomas Allan,19,0,100,81
1657040398056,CSE 140,A01,083663,Gungor; Onat,14,0,85,71
1657040404080,CSE 140L,A01,083088,Eldon; John,16,0,100,84
1657040410115,CSE 175,A01,083665,Kumar; Rakesh,3,0,25,22
1657040416143,CSE 190,A00,092507,Dubnov; Shlomo,7,0,20,13
1657040422171,ECE 45,A01,083139,Congero; Spencer William,5,0,75,70
1657040428196,ECE 65,A50,083695,Saad; Andrew S,12,0,30,18
1657040428196,ECE 65,A51,095125,Saad; Andrew S,25,0,26,1
1657040434220,ECE 109,A01,091882,Touri; Behrouz,16,0,70,54
1657040440249,ECE 180,A00,083140,Abi Samra; Nicholas Camill,1,0,30,29
1657040440249,ECE 180,B00,083141,Abi Samra; Nicholas Camill,0,0,30,30
1657040446272,MATH 10A,A01,083735,Patchell; Gregory David,1,0,30,29
1657040446272,MATH 10A,A02,083736,Patchell; Gregory David,20,0,30,10
1657040446272,MATH 10A,A03,083737,Patchell; Gregory David,16,0,30,14
1657040452301,MATH 10B,A01,083207,Lim; Seonhee,7,0,34,27
1657040452301,MATH 10B,A02,083208,Lim; Seonhee,9,0,35,26
1657040452301,MATH 10B,A03,093472,Lim; Seonhee,4,0,34,30
1657040452301,MATH 10B,B01,083739,Sinha; Shubham,9,0,30,21
1657040458327,MATH 18,A01,083743,Cinel; Cameron Alexander,6,0,30,24
1657040458327,MATH 18,A02,083744,Cinel; Cameron Alexander,15,0,30,15
1657040458327,MATH 18,A03,083745,Cinel; Cameron Alexander,8,0,30,22
1657040458327,MATH 18,B01,083748,Rideout; David Porter,4,0,37,33
1657040458327,MATH 18,B02,083749,Rideout; David Porter,3,0,36,33
1657040458327,MATH 18,B03,083750,Rideout; David Porter,2,0,37,35
1657040458327,MATH 18,B04,083751,Rideout; David Porter,5,0,36,31
1657040458327,MATH 18,B05,093473,Rideout; David Porter,4,0,36,32
1657040458327,MATH 18,B06,093474,Rideout; David Porter,5,0,36,31
1657040464349,MATH 20A,A01,083754,Zheng; Zequn,12,0,40,28
1657040470373,MATH 20B,A01,083756,Briones; Jor-el Thomas Caparas,1,0,36,35
1657040470373,MATH 20B,A02,083757,Briones; Jor-el Thomas Caparas,1,0,36,35
1657040470373,MATH 20B,A03,093475,Briones; Jor-el Thomas Caparas,0,0,36,36
1657040476401,MATH 20C,A01,083760,Briones; Jor-el Thomas Caparas,1,0,35,34
1657040476401,MATH 20C,A02,083761,Briones; Jor-el Thomas Caparas,8,0,35,27
1657040476401,MATH 20C,A03,093476,Briones; Jor-el Thomas Caparas,0,1,36,36
1657040476401,MATH 20C,B01,083762,Bach; Quang Tran,0,0,30,30
1657040482425,MATH 20D,A01,083765,Tran; Brian Kha,4,0,30,26
1657040482425,MATH 20D,A02,083766,Tran; Brian Kha,5,0,30,25
1657040482425,MATH 20D,A03,083767,Tran; Brian Kha,3,0,30,27
1657040488470,MATH 20E,A01,083771,Ganguly; Soumya,5,0,32,27
1657040488470,MATH 20E,A02,083772,Ganguly; Soumya,6,0,32,26
1657040488470,MATH 20E,B01,083773,Ciotti; Benjamin,18,0,35,17
1657040488470,MATH 20E,B02,083774,Ciotti; Benjamin,17,0,35,18
1657040494501,MATH 103A,A01,083777,Greenfeld; Be'Eri,2,0,36,34
1657040494501,MATH 103A,A02,083778,Greenfeld; Be'Eri,5,0,36,31
1657040494501,MATH 103A,A03,093561,Greenfeld; Be'Eri,4,0,36,32
1657040494501,MATH 103A,B01,083779,Greenfeld; Be'Eri,6,0,36,30
1657040494501,MATH 103A,B02,083780,Greenfeld; Be'Eri,2,0,36,34
1657040494501,MATH 103A,B03,093562,Greenfeld; Be'Eri,2,0,36,34
1657040500529,MATH 105,A01,085443,Carter; Anne Toulson,14,0,35,21
1657040500529,MATH 105,A02,093477,Carter; Anne Toulson,20,0,35,15
1657040506561,MATH 109,A01,083213,Ganzberger; Geoffrey Michael,2,0,34,32
1657040506561,MATH 109,A02,083214,Ganzberger; Geoffrey Michael,2,0,34,32
1657040506561,MATH 109,A03,093478,Ganzberger; Geoffrey Michael,1,0,34,33
1657040506561,MATH 109,B01,083215,Ganzberger; Geoffrey Michael,1,0,32,31
1657040506561,MATH 109,B02,083216,Ganzberger; Geoffrey Michael,1,0,32,31
1657040506561,MATH 109,B03,093479,Ganzberger; Geoffrey Michael,6,0,32,26
1657040512588,MATH 142A,A01,083219,Chow; Bennett,6,0,32,26
1657040512588,MATH 142A,A02,083220,Chow; Bennett,10,0,32,22
1657040512588,MATH 142A,A03,093480,Chow; Bennett,7,0,32,25
1657040512588,MATH 142A,B03,093481,Chow; Bennett,7,0,32,25
1657040512588,MATH 142A,B04,093558,Chow; Bennett,11,0,32,21
1657040512588,MATH 142A,B05,093559,Chow; Bennett,6,0,32,26
1657040518616,MATH 193A,A01,083224,Rotar; Vladimir,7,0,34,27
1657040518616,MATH 193A,A02,083225,Rotar; Vladimir,5,0,34,29
1657040518616,MATH 193A,A03,083781,Rotar; Vladimir,1,0,34,33
1657040518616,MATH 193A,A04,083782,Rotar; Vladimir,6,0,34,28
1657040518616,MATH 193A,A05,093482,Rotar; Vladimir,6,0,34,28
1657040524654,MATH 197,001,091859,McAuley; Julian John,9999,0,9999,0
1657040524654,MATH 197,002,095566,Kedlaya; Kiran S.,9997,0,9999,2
1657040524654,MATH 197,003,095567,Xiao; Ming,9999,0,9999,0
1657040524654,MATH 197,004,095571,Perols; Johan Lars,9998,0,9999,1
1657040531720,COGS 9,A01,083615,Shannon; Kyle Michael,7,0,75,68
1657040537745,COGS 11,A01,083617,Boyle; Mary E. T.,20,0,48,28
1657040543772,COGS 13,A01,083071,Bastos; Amalia Pinkusfeld,9,0,71,62
1657040549800,COGS 14A,A01,092681,Semenuks; Arturs,0,1,100,100
1657040555835,COGS 14B,A01,083073,Cheng; Tzu-Han,5,0,63,58
1657040561861,COGS 17,A01,092677,Semenuks; Arturs,4,0,81,77
1657040567885,COGS 100,A01,083619,Allen; Michael Gordon,15,0,70,55
1657040573909,COGS 101A,A01,083621,Davis; Joshua Daniel,9,0,68,59
1657040579931,COGS 101B,A01,091572,Allen; Michael Gordon,8,0,65,57
1657040585970,COGS 101C,A01,083625,Delgado; Tania,17,0,35,18
1657040591992,COGS 107A,A01,083627,Boyle; Mary E. T.,13,0,60,47
1657040598016,COGS 118A,A01,083075,Gupta; Anjum,15,0,76,61
1657040604043,CSE 3,A50,083646,Miranda; Gregory Joseph,22,0,50,28
1657040610066,CSE 8A,A50,083650,Miranda; Gregory Joseph,17,1,56,39
1657040616095,CSE 11,A01,083080,Cao; Yingjun,4,15,40,36
1657040622119,CSE 12,A01,083652,Krause-Levy; Sophia Louisa,22,1,120,98
1657040628148,CSE 15L,A01,083654,Morris; Justin Loren,8,0,50,42
1657040628148,CSE 15L,A02,083655,Morris; Justin Loren,9,0,50,41
1657040634177,CSE 20,A01,083657,Tran; Khoa Dang,37,0,80,43
1657040640208,CSE 21,A01,095574,Bach; Quang Tran,21,0,48,27
1657040646240,CSE 30,A01,083084,Eldon; John,4,0,80,76
1657040646240,CSE 30,B01,095061,Bhaskar; Nishant,6,0,50,44
1657040652263,CSE 100,A01,083659,Cao; Yingjun,3,4,70,67
1657040658284,CSE 134B,A01,083661,Powell; Thomas Allan,19,0,100,81
1657040664311,CSE 140,A01,083663,Gungor; Onat,14,0,85,71
1657040670338,CSE 140L,A01,083088,Eldon; John,16,0,100,84
1657040676367,CSE 175,A01,083665,Kumar; Rakesh,3,0,25,22
1657040682392,CSE 190,A00,092507,Dubnov; Shlomo,7,0,20,13
1657040688420,ECE 45,A01,083139,Congero; Spencer William,5,0,75,70
1657040694448,ECE 65,A50,083695,Saad; Andrew S,12,0,30,18
1657040694448,ECE 65,A51,095125,Saad; Andrew S,25,0,26,1
1657040700471,ECE 109,A01,091882,Touri; Behrouz,16,0,70,54
1657040706506,ECE 180,A00,083140,Abi Samra; Nicholas Camill,1,0,30,29
1657040706506,ECE 180,B00,083141,Abi Samra; Nicholas Camill,0,0,30,30
1657040712533,MATH 10A,A01,083735,Patchell; Gregory David,1,0,30,29
1657040712533,MATH 10A,A02,083736,Patchell; Gregory David,20,0,30,10
1657040712533,MATH 10A,A03,083737,Patchell; Gregory David,16,0,30,14
1657040718559,MATH 10B,A01,083207,Lim; Seonhee,7,0,34,27
1657040718559,MATH 10B,A02,083208,Lim; Seonhee,9,0,35,26
1657040718559,MATH 10B,A03,093472,Lim; Seonhee,4,0,34,30
1657040718559,MATH 10B,B01,083739,Sinha; Shubham,9,0,30,21
1657040724593,MATH 18,A01,083743,Cinel; Cameron Alexander,6,0,30,24
1657040724593,MATH 18,A02,083744,Cinel; Cameron Alexander,15,0,30,15
1657040724593,MATH 18,A03,083745,Cinel; Cameron Alexander,8,0,30,22
1657040724593,MATH 18,B01,083748,Rideout; David Porter,4,0,37,33
1657040724593,MATH 18,B02,083749,Rideout; David Porter,3,0,36,33
1657040724593,MATH 18,B03,083750,Rideout; David Porter,2,0,37,35
1657040724593,MATH 18,B04,083751,Rideout; David Porter,5,0,36,31
1657040724593,MATH 18,B05,093473,Rideout; David Porter,4,0,36,32
1657040724593,MATH 18,B06,093474,Rideout; David Porter,5,0,36,31
1657040730624,MATH 20A,A01,083754,Zheng; Zequn,12,0,40,28
1657040736649,MATH 20B,A01,083756,Briones; Jor-el Thomas Caparas,1,0,36,35
1657040736649,MATH 20B,A02,083757,Briones; Jor-el Thomas Caparas,1,0,36,35
1657040736649,MATH 20B,A03,093475,Briones; Jor-el Thomas Caparas,0,0,36,36
1657040742681,MATH 20C,A01,083760,Briones; Jor-el Thomas Caparas,1,0,35,34
1657040742681,MATH 20C,A02,083761,Briones; Jor-el Thomas Caparas,8,0,35,27
1657040742681,MATH 20C,A03,093476,Briones; Jor-el Thomas Caparas,0,1,36,36
1657040742681,MATH 20C,B01,083762,Bach; Quang Tran,0,0,30,30
1657040748704,MATH 20D,A01,083765,Tran; Brian Kha,4,0,30,26
1657040748704,MATH 20D,A02,083766,Tran; Brian Kha,5,0,30,25
1657040748704,MATH 20D,A03,083767,Tran; Brian Kha,3,0,30,27
1657040754733,MATH 20E,A01,083771,Ganguly; Soumya,5,0,32,27
1657040754733,MATH 20E,A02,083772,Ganguly; Soumya,6,0,32,26
1657040754733,MATH 20E,B01,083773,Ciotti; Benjamin,18,0,35,17
1657040754733,MATH 20E,B02,083774,Ciotti; Benjamin,17,0,35,18
1657040760778,MATH 103A,A01,083777,Greenfeld; Be'Eri,2,0,36,34
1657040760778,MATH 103A,A02,083778,Greenfeld; Be'Eri,5,0,36,31
1657040760778,MATH 103A,A03,093561,Greenfeld; Be'Eri,4,0,36,32
1657040760778,MATH 103A,B01,083779,Greenfeld; Be'Eri,6,0,36,30
1657040760778,MATH 103A,B02,083780,Greenfeld; Be'Eri,2,0,36,34
1657040760778,MATH 103A,B03,093562,Greenfeld; Be'Eri,2,0,36,34
1657040766812,MATH 105,A01,085443,Carter; Anne Toulson,14,0,35,21
1657040766812,MATH 105,A02,093477,Carter; Anne Toulson,20,0,35,15
1657040772841,MATH 109,A01,083213,Ganzberger; Geoffrey Michael,2,0,34,32
1657040772841,MATH 109,A02,083214,Ganzberger; Geoffrey Michael,2,0,34,32
1657040772841,MATH 109,A03,093478,Ganzberger; Geoffrey Michael,1,0,34,33
1657040772841,MATH 109,B01,083215,Ganzberger; Geoffrey Michael,1,0,32,31
1657040772841,MATH 109,B02,083216,Ganzberger; Geoffrey Michael,1,0,32,31
1657040772841,MATH 109,B03,093479,Ganzberger; Geoffrey Michael,6,0,32,26
1657040778869,MATH 142A,A01,083219,Chow; Bennett,6,0,32,26
1657040778869,MATH 142A,A02,083220,Chow; Bennett,10,0,32,22
1657040778869,MATH 142A,A03,093480,Chow; Bennett,7,0,32,25
1657040778869,MATH 142A,B03,093481,Chow; Bennett,7,0,32,25
1657040778869,MATH 142A,B04,093558,Chow; Bennett,11,0,32,21
1657040778869,MATH 142A,B05,093559,Chow; Bennett,6,0,32,26
1657040784897,MATH 193A,A01,083224,Rotar; Vladimir,7,0,34,27
1657040784897,MATH 193A,A02,083225,Rotar; Vladimir,5,0,34,29
1657040784897,MATH 193A,A03,083781,Rotar; Vladimir,1,0,34,33
1657040784897,MATH 193A,A04,083782,Rotar; Vladimir,6,0,34,28
1657040784897,MATH 193A,A05,093482,Rotar; Vladimir,6,0,34,28
1657040790920,MATH 197,001,091859,McAuley; Julian John,9999,0,9999,0
1657040790920,MATH 197,002,095566,Kedlaya; Kiran S.,9997,0,9999,2
1657040790920,MATH 197,003,095567,Xiao; Ming,9999,0,9999,0
1657040790920,MATH 197,004,095571,Perols; Johan Lars,9998,0,9999,1
1657040797985,COGS 9,A01,083615,Shannon; Kyle Michael,7,0,75,68
1657040804012,COGS 11,A01,083617,Boyle; Mary E. T.,20,0,48,28
1657040810034,COGS 13,A01,083071,Bastos; Amalia Pinkusfeld,9,0,71,62
1657040816060,COGS 14A,A01,092681,Semenuks; Arturs,0,1,100,100
1657040822095,COGS 14B,A01,083073,Cheng; Tzu-Han,5,0,63,58
1657040828118,COGS 17,A01,092677,Semenuks; Arturs,4,0,81,77
1657040834140,COGS 100,A01,083619,Allen; Michael Gordon,15,0,70,55
1657040840161,COGS 101A,A01,083621,Davis; Joshua Daniel,9,0,68,59
1657040846186,COGS 101B,A01,091572,Allen; Michael Gordon,8,0,65,57
1657040852212,COGS 101C,A01,083625,Delgado; Tania,17,0,35,18
1657040858325,COGS 107A,A01,083627,Boyle; Mary E. T.,13,0,60,47
1657040864350,COGS 118A,A01,083075,Gupta; Anjum,15,0,76,61
1657040870377,CSE 3,A50,083646,Miranda; Gregory Joseph,22,0,50,28
1657040876411,CSE 8A,A50,083650,Miranda; Gregory Joseph,17,1,56,39
1657040882432,CSE 11,A01,083080,Cao; Yingjun,4,15,40,36
1657040888459,CSE 12,A01,083652,Krause-Levy; Sophia Louisa,22,1,120,98
1657040894482,CSE 15L,A01,083654,Morris; Justin Loren,8,0,50,42
1657040894482,CSE 15L,A02,083655,Morris; Justin Loren,9,0,50,41
1657040900504,CSE 20,A01,083657,Tran; Khoa Dang,37,0,80,43
1657040906527,CSE 21,A01,095574,Bach; Quang Tran,21,0,48,27
1657040912554,CSE 30,A01,083084,Eldon; John,4,0,80,76
1657040912554,CSE 30,B01,095061,Bhaskar; Nishant,6,0,50,44
1657040918577,CSE 100,A01,083659,Cao; Yingjun,3,4,70,67
1657040924600,CSE 134B,A01,083661,Powell; Thomas Allan,19,0,100,81
1657040930622,CSE 140,A01,083663,Gungor; Onat,14,0,85,71
1657040936649,CSE 140L,A01,083088,Eldon; John,16,0,100,84
1657040942673,CSE 175,A01,083665,Kumar; Rakesh,3,0,25,22
1657040948699,CSE 190,A00,092507,Dubnov; Shlomo,7,0,20,13
1657040954723,ECE 45,A01,083139,Congero; Spencer William,5,0,75,70
1657040960750,ECE 65,A50,083695,Saad; Andrew S,12,0,30,18
1657040960750,ECE 65,A51,095125,Saad; Andrew S,25,0,26,1
1657040966777,ECE 109,A01,091882,Touri; Behrouz,16,0,70,54
1657040972808,ECE 180,A00,083140,Abi Samra; Nicholas Camill,1,0,30,29
1657040972808,ECE 180,B00,083141,Abi Samra; Nicholas Camill,0,0,30,30
1657040978830,MATH 10A,A01,083735,Patchell; Gregory David,1,0,30,29
1657040978830,MATH 10A,A02,083736,Patchell; Gregory David,20,0,30,10
1657040978830,MATH 10A,A03,083737,Patchell; Gregory David,16,0,30,14
1657040984860,MATH 10B,A01,083207,Lim; Seonhee,7,0,34,27
1657040984860,MATH 10B,A02,083208,Lim; Seonhee,9,0,35,26
1657040984860,MATH 10B,A03,093472,Lim; Seonhee,4,0,34,30
1657040984860,MATH 10B,B01,083739,Sinha; Shubham,9,0,30,21
1657040990884,MATH 18,A01,083743,Cinel; Cameron Alexander,6,0,30,24
1657040990884,MATH 18,A02,083744,Cinel; Cameron Alexander,15,0,30,15
1657040990884,MATH 18,A03,083745,Cinel; Cameron Alexander,8,0,30,22
1657040990884,MATH 18,B01,083748,Rideout; David Porter,4,0,37,33
1657040990884,MATH 18,B02,083749,Rideout; David Porter,3,0,36,33
1657040990884,MATH 18,B03,083750,Rideout; David Porter,2,0,37,35
1657040990884,MATH 18,B04,083751,Rideout; David Porter,5,0,36,31
1657040990884,MATH 18,B05,093473,Rideout; David Porter,4,0,36,32
1657040990884,MATH 18,B06,093474,Rideout; David Porter,5,0,36,31
1657040996906,MATH 20A,A01,083754,Zheng; Zequn,12,0,40,28
1657041002938,MATH 20B,A01,083756,Briones; Jor-el Thomas Caparas,1,0,36,35
1657041002938,MATH 20B,A02,083757,Briones; Jor-el Thomas Caparas,1,0,36,35
1657041002938,MATH 20B,A03,093475,Briones; Jor-el Thomas Caparas,0,0,36,36
1657041008969,MATH 20C,A01,083760,Briones; Jor-el Thomas Caparas,1,0,35,34
1657041008969,MATH 20C,A02,083761,Briones; Jor-el Thomas Caparas,8,0,35,27
1657041008969,MATH 20C,A03,093476,Briones; Jor-el Thomas Caparas,0,1,36,36
1657041008969,MATH 20C,B01,083762,Bach; Quang Tran,0,0,30,30
1657041014991,MATH 20D,A01,083765,Tran; Brian Kha,4,0,30,26
1657041014991,MATH 20D,A02,083766,Tran; Brian Kha,5,0,30,25
1657041014991,MATH 20D,A03,083767,Tran; Brian Kha,3,0,30,27
1657041021020,MATH 20E,A01,083771,Ganguly; Soumya,5,0,32,27
1657041021020,MATH 20E,A02,083772,Ganguly; Soumya,6,0,32,26
1657041021020,MATH 20E,B01,083773,Ciotti; Benjamin,18,0,35,17
1657041021020,MATH 20E,B02,083774,Ciotti; Benjamin,17,0,35,18
1657041027049,MATH 103A,A01,083777,Greenfeld; Be'Eri,2,0,36,34
1657041027049,MATH 103A,A02,083778,Greenfeld; Be'Eri,5,0,36,31
1657041027049,MATH 103A,A03,093561,Greenfeld; Be'Eri,4,0,36,32
1657041027049,MATH 103A,B01,083779,Greenfeld; Be'Eri,6,0,36,30
1657041027049,MATH 103A,B02,083780,Greenfeld; Be'Eri,2,0,36,34
1657041027049,MATH 103A,B03,093562,Greenfeld; Be'Eri,2,0,36,34
1657041033076,MATH 105,A01,085443,Carter; Anne Toulson,14,0,35,21
1657041033076,MATH 105,A02,093477,Carter; Anne Toulson,20,0,35,15
1657041039102,MATH 109,A01,083213,Ganzberger; Geoffrey Michael,2,0,34,32
1657041039102,MATH 109,A02,083214,Ganzberger; Geoffrey Michael,2,0,34,32
1657041039102,MATH 109,A03,093478,Ganzberger; Geoffrey Michael,1,0,34,33
1657041039102,MATH 109,B01,083215,Ganzberger; Geoffrey Michael,1,0,32,31
1657041039102,MATH 109,B02,083216,Ganzberger; Geoffrey Michael,1,0,32,31
1657041039102,MATH 109,B03,093479,Ganzberger; Geoffrey Michael,6,0,32,26
1657041045126,MATH 142A,A01,083219,Chow; Bennett,6,0,32,26
1657041045126,MATH 142A,A02,083220,Chow; Bennett,10,0,32,22
1657041045126,MATH 142A,A03,093480,Chow; Bennett,7,0,32,25
1657041045126,MATH 142A,B03,093481,Chow; Bennett,7,0,32,25
1657041045126,MATH 142A,B04,093558,Chow; Bennett,11,0,32,21
1657041045126,MATH 142A,B05,093559,Chow; Bennett,6,0,32,26
1657041051149,MATH 193A,A01,083224,Rotar; Vladimir,7,0,34,27
1657041051149,MATH 193A,A02,083225,Rotar; Vladimir,5,0,34,29
1657041051149,MATH 193A,A03,083781,Rotar; Vladimir,1,0,34,33
1657041051149,MATH 193A,A04,083782,Rotar; Vladimir,6,0,34,28
1657041051149,MATH 193A,A05,093482,Rotar; Vladimir,6,0,34,28
1657041057174,MATH 197,001,091859,McAuley; Julian John,9999,0,9999,0
1657041057174,MATH 197,002,095566,Kedlaya; Kiran S.,9997,0,9999,2
1657041057174,MATH 197,003,095567,Xiao; Ming,9999,0,9999,0
1657041057174,MATH 197,004,095571,Perols; Johan Lars,9998,0,9999,1
1657041064244,COGS 9,A01,083615,Shannon; Kyle Michael,7,0,75,68
1657041070273,COGS 11,A01,083617,Boyle; Mary E. T.,20,0,48,28
1657041076309,COGS 13,A01,083071,Bastos; Amalia Pinkusfeld,9,0,71,62
1657041082337,COGS 14A,A01,092681,Semenuks; Arturs,0,1,100,100
1657041088360,COGS 14B,A01,083073,Cheng; Tzu-Han,5,0,63,58
1657041094394,COGS 17,A01,092677,Semenuks; Arturs,4,0,81,77
1657041100417,COGS 100,A01,083619,Allen; Michael Gordon,15,0,70,55
1657041106440,COGS 101A,A01,083621,Davis; Joshua Daniel,9,0,68,59
1657041112463,COGS 101B,A01,091572,Allen; Michael Gordon,8,0,65,57
1657041118487,COGS 101C,A01,083625,Delgado; Tania,17,0,35,18
1657041124513,COGS 107A,A01,083627,Boyle; Mary E. T.,13,0,60,47
1657041130535,COGS 118A,A01,083075,Gupta; Anjum,15,0,76,61
1657041136560,CSE 3,A50,083646,Miranda; Gregory Joseph,22,0,50,28
1657041142584,CSE 8A,A50,083650,Miranda; Gregory Joseph,17,1,56,39
1657041148610,CSE 11,A01,083080,Cao; Yingjun,4,15,40,36
1657041154637,CSE 12,A01,083652,Krause-Levy; Sophia Louisa,22,1,120,98
1657041160663,CSE 15L,A01,083654,Morris; Justin Loren,8,0,50,42
1657041160663,CSE 15L,A02,083655,Morris; Justin Loren,9,0,50,41
1657041166685,CSE 20,A01,083657,Tran; Khoa Dang,37,0,80,43
1657041172712,CSE 21,A01,095574,Bach; Quang Tran,21,0,48,27
1657041178741,CSE 30,A01,083084,Eldon; John,4,0,80,76
1657041178741,CSE 30,B01,095061,Bhaskar; Nishant,6,0,50,44
1657041184768,CSE 100,A01,083659,Cao; Yingjun,3,4,70,67
1657041190791,CSE 134B,A01,083661,Powell; Thomas Allan,19,0,100,81
1657041196812,CSE 140,A01,083663,Gungor; Onat,14,0,85,71
1657041202837,CSE 140L,A01,083088,Eldon; John,16,0,100,84
1657041208861,CSE 175,A01,083665,Kumar; Rakesh,3,0,25,22
1657041214883,CSE 190,A00,092507,Dubnov; Shlomo,7,0,20,13
1657041220907,ECE 45,A01,083139,Congero; Spencer William,5,0,75,70
1657041226934,ECE 65,A50,083695,Saad; Andrew S,12,0,30,18
1657041226934,ECE 65,A51,095125,Saad; Andrew S,25,0,26,1
1657041232964,ECE 109,A01,091882,Touri; Behrouz,16,0,70,54
1657041238990,ECE 180,A00,083140,Abi Samra; Nicholas Camill,1,0,30,29
1657041238990,ECE 180,B00,083141,Abi Samra; Nicholas Camill,0,0,30,30
1657041245013,MATH 10A,A01,083735,Patchell; Gregory David,1,0,30,29
1657041245013,MATH 10A,A02,083736,Patchell; Gregory David,20,0,30,10
1657041245013,MATH 10A,A03,083737,Patchell; Gregory David,16,0,30,14
1657041251036,MATH 10B,A01,083207,Lim; Seonhee,7,0,34,27
1657041251036,MATH 10B,A02,083208,Lim; Seonhee,9,0,35,26
1657041251036,MATH 10B,A03,093472,Lim; Seonhee,4,0,34,30
1657041251036,MATH 10B,B01,083739,Sinha; Shubham,9,0,30,21
1657041257065,MATH 18,A01,083743,Cinel; Cameron Alexander,6,0,30,24
1657041257065,MATH 18,A02,083744,Cinel; Cameron Alexander,15,0,30,15
1657041257065,MATH 18,A03,083745,Cinel; Cameron Alexander,8,0,30,22
1657041257065,MATH 18,B01,083748,Rideout; David Porter,4,0,37,33
1657041257065,MATH 18,B02,083749,Rideout; David Porter,3,0,36,33
1657041257065,MATH 18,B03,083750,Rideout; David Porter,2,0,37,35
1657041257065,MATH 18,B04,083751,Rideout; David Porter,5,0,36,31
1657041257065,MATH 18,B05,093473,Rideout; David Porter,4,0,36,32
1657041257065,MATH 18,B06,093474,Rideout; David Porter,5,0,36,31
1657041263099,MATH 20A,A01,083754,Zheng; Zequn,12,0,40,28
1657041269126,MATH 20B,A01,083756,Briones; Jor-el Thomas Caparas,1,0,36,35
1657041269126,MATH 20B,A02,083757,Briones; Jor-el Thomas Caparas,1,0,36,35
1657041269126,MATH 20B,A03,093475,Briones; Jor-el Thomas Caparas,0,0,36,36
1657041275150,MATH 20C,A01,083760,Briones; Jor-el Thomas Caparas,1,0,35,34
1657041275150,MATH 20C,A02,083761,Briones; Jor-el Thomas Caparas,8,0,35,27
1657041275150,MATH 20C,A03,093476,Briones; Jor-el Thomas Caparas,0,1,36,36
1657041275150,MATH 20C,B01,083762,Bach; Quang Tran,0,0,30,30
1657041281178,MATH 20D,A01,083765,Tran; Brian Kha,4,0,30,26
1657041281178,MATH 20D,A02,083766,Tran; Brian Kha,5,0,30,25
1657041281178,MATH 20D,A03,083767,Tran; Brian Kha,3,0,30,27
1657041287206,MATH 20E,A01,083771,Ganguly; Soumya,5,0,32,27
1657041287206,MATH 20E,A02,083772,Ganguly; Soumya,6,0,32,26
1657041287206,MATH 20E,B01,083773,Ciotti; Benjamin,18,0,35,17
1657041287206,MATH 20E,B02,083774,Ciotti; Benjamin,17,0,35,18
1657041293229,MATH 103A,A01,083777,Greenfeld; Be'Eri,2,0,36,34
1657041293229,MATH 103A,A02,083778,Greenfeld; Be'Eri,5,0,36,31
1657041293229,MATH 103A,A03,093561,Greenfeld; Be'Eri,4,0,36,32
1657041293229,MATH 103A,B01,083779,Greenfeld; Be'Eri,6,0,36,30
1657041293229,MATH 103A,B02,083780,Greenfeld; Be'Eri,2,0,36,34
1657041293229,MATH 103A,B03,093562,Greenfeld; Be'Eri,2,0,36,34
1657041299264,MATH 105,A01,085443,Carter; Anne Toulson,14,0,35,21
1657041299264,MATH 105,A02,093477,Carter; Anne Toulson,20,0,35,15
1657041305298,MATH 109,A01,083213,Ganzberger; Geoffrey Michael,2,0,34,32
1657041305298,MATH 109,A02,083214,Ganzberger; Geoffrey Michael,2,0,34,32
1657041305298,MATH 109,A03,093478,Ganzberger; Geoffrey Michael,1,0,34,33
1657041305298,MATH 109,B01,083215,Ganzberger; Geoffrey Michael,1,0,32,31
1657041305298,MATH 109,B02,083216,Ganzberger; Geoffrey Michael,1,0,32,31
1657041305298,MATH 109,B03,093479,Ganzberger; Geoffrey Michael,6,0,32,26
1657041311324,MATH 142A,A01,083219,Chow; Bennett,6,0,32,26
1657041311324,MATH 142A,A02,083220,Chow; Bennett,10,0,32,22
1657041311324,MATH 142A,A03,093480,Chow; Bennett,7,0,32,25
1657041311324,MATH 142A,B03,093481,Chow; Bennett,7,0,32,25
1657041311324,MATH 142A,B04,093558,Chow; Bennett,11,0,32,21
1657041311324,MATH 142A,B05,093559,Chow; Bennett,6,0,32,26
1657041317355,MATH 193A,A01,083224,Rotar; Vladimir,7,0,34,27
1657041317355,MATH 193A,A02,083225,Rotar; Vladimir,5,0,34,29
1657041317355,MATH 193A,A03,083781,Rotar; Vladimir,1,0,34,33
1657041317355,MATH 193A,A04,083782,Rotar; Vladimir,6,0,34,28
1657041317355,MATH 193A,A05,093482,Rotar; Vladimir,6,0,34,28
1657041323377,MATH 197,001,091859,McAuley; Julian John,9999,0,9999,0
1657041323377,MATH 197,002,095566,Kedlaya; Kiran S.,9997,0,9999,2
1657041323377,MATH 197,003,095567,Xiao; Ming,9999,0,9999,0
1657041323377,MATH 197,004,095571,Perols; Johan Lars,9998,0,9999,1
1657041330428,COGS 9,A01,083615,Shannon; Kyle Michael,7,0,75,68
1657041336450,COGS 11,A01,083617,Boyle; Mary E. T.,20,0,48,28
1657041342473,COGS 13,A01,083071,Bastos; Amalia Pinkusfeld,9,0,71,62
1657041348501,COGS 14A,A01,092681,Semenuks; Arturs,0,1,100,100
1657041354524,COGS 14B,A01,083073,Cheng; Tzu-Han,5,0,63,58
1657041360549,COGS 17,A01,092677,Semenuks; Arturs,4,0,81,77
1657041366574,COGS 100,A01,083619,Allen; Michael Gordon,15,0,70,55
1657041372597,COGS 101A,A01,083621,Davis; Joshua Daniel,9,0,68,59
1657041378619,COGS 101B,A01,091572,Allen; Michael Gordon,8,0,65,57
1657041384643,COGS 101C,A01,083625,Delgado; Tania,17,0,35,18
1657041390667,COGS 107A,A01,083627,Boyle; Mary E. T.,13,0,60,47
1657041396691,COGS 118A,A01,083075,Gupta; Anjum,15,0,76,61
1657041402714,CSE 3,A50,083646,Miranda; Gregory Joseph,22,0,50,28
1657041408756,CSE 8A,A50,083650,Miranda; Gregory Joseph,17,1,56,39
1657041414786,CSE 11,A01,083080,Cao; Yingjun,4,15,40,36
1657041420811,CSE 12,A01,083652,Krause-Levy; Sophia Louisa,22,1,120,98
1657041426846,CSE 15L,A01,083654,Morris; Justin Loren,8,0,50,42
1657041426846,CSE 15L,A02,083655,Morris; Justin Loren,9,0,50,41
1657041432871,CSE 20,A01,083657,Tran; Khoa Dang,37,0,80,43
1657041438899,CSE 21,A01,095574,Bach; Quang Tran,21,0,48,27
1657041444929,CSE 30,A01,083084,Eldon; John,4,0,80,76
1657041444929,CSE 30,B01,095061,Bhaskar; Nishant,6,0,50,44
1657041450955,CSE 100,A01,083659,Cao; Yingjun,3,4,70,67
1657041457075,CSE 134B,A01,083661,Powell; Thomas Allan,19,0,100,81
1657041463112,CSE 140,A01,083663,Gungor; Onat,14,0,85,71
1657041469136,CSE 140L,A01,083088,Eldon; John,16,0,100,84
1657041475163,CSE 175,A01,083665,Kumar; Rakesh,3,0,25,22
1657041481186,CSE 190,A00,092507,Dubnov; Shlomo,7,0,20,13
1657041487214,ECE 45,A01,083139,Congero; Spencer William,5,0,75,70
1657041493238,ECE 65,A50,083695,Saad; Andrew S,12,0,30,18
1657041493238,ECE 65,A51,095125,Saad; Andrew S,25,0,26,1
1657041499262,ECE 109,A01,091882,Touri; Behrouz,16,0,70,54
1657041505286,ECE 180,A00,083140,Abi Samra; Nicholas Camill,1,0,30,29
1657041505286,ECE 180,B00,083141,Abi Samra; Nicholas Camill,0,0,30,30
1657041511310,MATH 10A,A01,083735,Patchell; Gregory David,1,0,30,29
1657041511310,MATH 10A,A02,083736,Patchell; Gregory David,20,0,30,10
1657041511310,MATH 10A,A03,083737,Patchell; Gregory David,16,0,30,14
1657041517335,MATH 10B,A01,083207,Lim; Seonhee,7,0,34,27
1657041517335,MATH 10B,A02,083208,Lim; Seonhee,9,0,35,26
1657041517335,MATH 10B,A03,093472,Lim; Seonhee,4,0,34,30
1657041517335,MATH 10B,B01,083739,Sinha; Shubham,9,0,30,21
1657041523374,MATH 18,A01,083743,Cinel; Cameron Alexander,6,0,30,24
1657041523374,MATH 18,A02,083744,Cinel; Cameron Alexander,15,0,30,15
1657041523374,MATH 18,A03,083745,Cinel; Cameron Alexander,8,0,30,22
1657041523374,MATH 18,B01,083748,Rideout; David Porter,4,0,37,33
1657041523374,MATH 18,B02,083749,Rideout; David Porter,3,0,36,33
1657041523374,MATH 18,B03,083750,Rideout; David Porter,2,0,37,35
1657041523374,MATH 18,B04,083751,Rideout; David Porter,5,0,36,31
1657041523374,MATH 18,B05,093473,Rideout; David Porter,4,0,36,32
1657041523374,MATH 18,B06,093474,Rideout; David Porter,5,0,36,31
1657041529402,MATH 20A,A01,083754,Zheng; Zequn,12,0,40,28
1657041535428,MATH 20B,A01,083756,Briones; Jor-el Thomas Caparas,1,0,36,35
1657041535428,MATH 20B,A02,083757,Briones; Jor-el Thomas Caparas,1,0,36,35
1657041535428,MATH 20B,A03,093475,Briones; Jor-el Thomas Caparas,0,0,36,36
1657041541457,MATH 20C,A01,083760,Briones; Jor-el Thomas Caparas,1,0,35,34
1657041541457,MATH 20C,A02,083761,Briones; Jor-el Thomas Caparas,8,0,35,27
1657041541457,MATH 20C,A03,093476,Briones; Jor-el Thomas Caparas,0,1,36,36
1657041541457,MATH 20C,B01,083762,Bach; Quang Tran,0,0,30,30
1657041547482,MATH 20D,A01,083765,Tran; Brian Kha,4,0,30,26
1657041547482,MATH 20D,A02,083766,Tran; Brian Kha,5,0,30,25
1657041547482,MATH 20D,A03,083767,Tran; Brian Kha,3,0,30,27
1657041553511,MATH 20E,A01,083771,Ganguly; Soumya,5,0,32,27
1657041553511,MATH 20E,A02,083772,Ganguly; Soumya,6,0,32,26
1657041553511,MATH 20E,B01,083773,Ciotti; Benjamin,18,0,35,17
1657041553511,MATH 20E,B02,083774,Ciotti; Benjamin,17,0,35,18
1657041559538,MATH 103A,A01,083777,Greenfeld; Be'Eri,2,0,36,34
1657041559538,MATH 103A,A02,083778,Greenfeld; Be'Eri,5,0,36,31
1657041559538,MATH 103A,A03,093561,Greenfeld; Be'Eri,4,0,36,32
1657041559538,MATH 103A,B01,083779,Greenfeld; Be'Eri,6,0,36,30
1657041559538,MATH 103A,B02,083780,Greenfeld; Be'Eri,2,0,36,34
1657041559538,MATH 103A,B03,093562,Greenfeld; Be'Eri,2,0,36,34
1657041565566,MATH 105,A01,085443,Carter; Anne Toulson,14,0,35,21
1657041565566,MATH 105,A02,093477,Carter; Anne Toulson,20,0,35,15
1657041571591,MATH 109,A01,083213,Ganzberger; Geoffrey Michael,2,0,34,32
1657041571591,MATH 109,A02,083214,Ganzberger; Geoffrey Michael,2,0,34,32
1657041571591,MATH 109,A03,093478,Ganzberger; Geoffrey Michael,1,0,34,33
1657041571591,MATH 109,B01,083215,Ganzberger; Geoffrey Michael,1,0,32,31
1657041571591,MATH 109,B02,083216,Ganzberger; Geoffrey Michael,1,0,32,31
1657041571591,MATH 109,B03,093479,Ganzberger; Geoffrey Michael,6,0,32,26
1657041577622,MATH 142A,A01,083219,Chow; Bennett,6,0,32,26
1657041577622,MATH 142A,A02,083220,Chow; Bennett,10,0,32,22
1657041577622,MATH 142A,A03,093480,Chow; Bennett,7,0,32,25
1657041577622,MATH 142A,B03,093481,Chow; Bennett,7,0,32,25
1657041577622,MATH 142A,B04,093558,Chow; Bennett,11,0,32,21
1657041577622,MATH 142A,B05,093559,Chow; Bennett,6,0,32,26
1657041583664,MATH 193A,A01,083224,Rotar; Vladimir,7,0,34,27
1657041583664,MATH 193A,A02,083225,Rotar; Vladimir,5,0,34,29
1657041583664,MATH 193A,A03,083781,Rotar; Vladimir,1,0,34,33
1657041583664,MATH 193A,A04,083782,Rotar; Vladimir,6,0,34,28
1657041583664,MATH 193A,A05,093482,Rotar; Vladimir,6,0,34,28
1657041589686,MATH 197,001,091859,McAuley; Julian John,9999,0,9999,0
1657041589686,MATH 197,002,095566,Kedlaya; Kiran S.,9997,0,9999,2
1657041589686,MATH 197,003,095567,Xiao; Ming,9999,0,9999,0
1657041589686,MATH 197,004,095571,Perols; Johan Lars,9998,0,9999,1
1657041596744,COGS 9,A01,083615,Shannon; Kyle Michael,7,0,75,68
1657041602768,COGS 11,A01,083617,Boyle; Mary E. T.,20,0,48,28
1657041608792,COGS 13,A01,083071,Bastos; Amalia Pinkusfeld,9,0,71,62
1657041614826,COGS 14A,A01,092681,Semenuks; Arturs,0,1,100,100
1657041620853,COGS 14B,A01,083073,Cheng; Tzu-Han,5,0,63,58
1657041626892,COGS 17,A01,092677,Semenuks; Arturs,4,0,81,77
1657041632933,COGS 100,A01,083619,Allen; Michael Gordon,15,0,70,55
1657041638962,COGS 101A,A01,083621,Davis; Joshua Daniel,9,0,68,59
1657041644989,COGS 101B,A01,091572,Allen; Michael Gordon,8,0,65,57
1657041651015,COGS 101C,A01,083625,Delgado; Tania,17,0,35,18
1657041657046,COGS 107A,A01,083627,Boyle; Mary E. T.,13,0,60,47
1657041663068,COGS 118A,A01,083075,Gupta; Anjum,15,0,76,61
1657041669092,CSE 3,A50,083646,Miranda; Gregory Joseph,22,0,50,28
1657041675129,CSE 8A,A50,083650,Miranda; Gregory Joseph,17,1,56,39
1657041681153,CSE 11,A01,083080,Cao; Yingjun,4,15,40,36
1657041687181,CSE 12,A01,083652,Krause-Levy; Sophia Louisa,23,1,120,97
1657041693211,CSE 15L,A01,083654,Morris; Justin Loren,8,0,50,42
1657041693211,CSE 15L,A02,083655,Morris; Justin Loren,9,0,50,41
1657041699237,CSE 20,A01,083657,Tran; Khoa Dang,37,0,80,43
1657041705266,CSE 21,A01,095574,Bach; Quang Tran,21,0,48,27
1657041711289,CSE 30,A01,083084,Eldon; John,4,0,80,76
1657041711289,CSE 30,B01,095061,Bhaskar; Nishant,6,0,50,44
1657041717324,CSE 100,A01,083659,Cao; Yingjun,3,4,70,67
1657041723353,CSE 134B,A01,083661,Powell; Thomas Allan,19,0,100,81
1657041729392,CSE 140,A01,083663,Gungor; Onat,14,0,85,71
1657041735417,CSE 140L,A01,083088,Eldon; John,16,0,100,84
1657041741439,CSE 175,A01,083665,Kumar; Rakesh,3,0,25,22
1657041747464,CSE 190,A00,092507,Dubnov; Shlomo,7,0,20,13
1657041753497,ECE 45,A01,083139,Congero; Spencer William,5,0,75,70
1657041759525,ECE 65,A50,083695,Saad; Andrew S,12,0,30,18
1657041759525,ECE 65,A51,095125,Saad; Andrew S,25,0,26,1
1657041765548,ECE 109,A01,091882,Touri; Behrouz,16,0,70,54
1657041771576,ECE 180,A00,083140,Abi Samra; Nicholas Camill,1,0,30,29
1657041771576,ECE 180,B00,083141,Abi Samra; Nicholas Camill,0,0,30,30
1657041777605,MATH 10A,A01,083735,Patchell; Gregory David,1,0,30,29
1657041777605,MATH 10A,A02,083736,Patchell; Gregory David,20,0,30,10
1657041777605,MATH 10A,A03,083737,Patchell; Gregory David,16,0,30,14
1657041783632,MATH 10B,A01,083207,Lim; Seonhee,7,0,34,27
1657041783632,MATH 10B,A02,083208,Lim; Seonhee,9,0,35,26
1657041783632,MATH 10B,A03,093472,Lim; Seonhee,4,0,34,30
1657041783632,MATH 10B,B01,083739,Sinha; Shubham,9,0,30,21
1657041789665,MATH 18,A01,083743,Cinel; Cameron Alexander,6,0,30,24
1657041789665,MATH 18,A02,083744,Cinel; Cameron Alexander,15,0,30,15
1657041789665,MATH 18,A03,083745,Cinel; Cameron Alexander,8,0,30,22
1657041789665,MATH 18,B01,083748,Rideout; David Porter,4,0,37,33
1657041789665,MATH 18,B02,083749,Rideout; David Porter,3,0,36,33
1657041789665,MATH 18,B03,083750,Rideout; David Porter,2,0,37,35
1657041789665,MATH 18,B04,083751,Rideout; David Porter,5,0,36,31
1657041789665,MATH 18,B05,093473,Rideout; David Porter,4,0,36,32
1657041789665,MATH 18,B06,093474,Rideout; David Porter,5,0,36,31
1657041795691,MATH 20A,A01,083754,Zheng; Zequn,12,0,40,28
1657041801720,MATH 20B,A01,083756,Briones; Jor-el Thomas Caparas,1,0,36,35
1657041801720,MATH 20B,A02,083757,Briones; Jor-el Thomas Caparas,1,0,36,35
1657041801720,MATH 20B,A03,093475,Briones; Jor-el Thomas Caparas,0,0,36,36
1657041807747,MATH 20C,A01,083760,Briones; Jor-el Thomas Caparas,1,0,35,34
1657041807747,MATH 20C,A02,083761,Briones; Jor-el Thomas Caparas,8,0,35,27
1657041807747,MATH 20C,A03,093476,Briones; Jor-el Thomas Caparas,0,1,36,36
1657041807747,MATH 20C,B01,083762,Bach; Quang Tran,0,0,30,30
1657041813775,MATH 20D,A01,083765,Tran; Brian Kha,4,0,30,26
1657041813775,MATH 20D,A02,083766,Tran; Brian Kha,5,0,30,25
1657041813775,MATH 20D,A03,083767,Tran; Brian Kha,3,0,30,27
1657041819808,MATH 20E,A01,083771,Ganguly; Soumya,5,0,32,27
1657041819808,MATH 20E,A02,083772,Ganguly; Soumya,6,0,32,26
1657041819808,MATH 20E,B01,083773,Ciotti; Benjamin,18,0,35,17
1657041819808,MATH 20E,B02,083774,Ciotti; Benjamin,17,0,35,18
1657041825838,MATH 103A,A01,083777,Greenfeld; Be'Eri,2,0,36,34
1657041825838,MATH 103A,A02,083778,Greenfeld; Be'Eri,5,0,36,31
1657041825838,MATH 103A,A03,093561,Greenfeld; Be'Eri,4,0,36,32
1657041825838,MATH 103A,B01,083779,Greenfeld; Be'Eri,6,0,36,30
1657041825838,MATH 103A,B02,083780,Greenfeld; Be'Eri,2,0,36,34
1657041825838,MATH 103A,B03,093562,Greenfeld; Be'Eri,2,0,36,34
1657041831874,MATH 105,A01,085443,Carter; Anne Toulson,14,0,35,21
1657041831874,MATH 105,A02,093477,Carter; Anne Toulson,20,0,35,15
1657041837899,MATH 109,A01,083213,Ganzberger; Geoffrey Michael,2,0,34,32
1657041837899,MATH 109,A02,083214,Ganzberger; Geoffrey Michael,2,0,34,32
1657041837899,MATH 109,A03,093478,Ganzberger; Geoffrey Michael,1,0,34,33
1657041837899,MATH 109,B01,083215,Ganzberger; Geoffrey Michael,1,0,32,31
1657041837899,MATH 109,B02,083216,Ganzberger; Geoffrey Michael,1,0,32,31
1657041837899,MATH 109,B03,093479,Ganzberger; Geoffrey Michael,6,0,32,26
1657041843924,MATH 142A,A01,083219,Chow; Bennett,6,0,32,26
1657041843924,MATH 142A,A02,083220,Chow; Bennett,10,0,32,22
1657041843924,MATH 142A,A03,093480,Chow; Bennett,7,0,32,25
1657041843924,MATH 142A,B03,093481,Chow; Bennett,7,0,32,25
1657041843924,MATH 142A,B04,093558,Chow; Bennett,11,0,32,21
1657041843924,MATH 142A,B05,093559,Chow; Bennett,6,0,32,26
1657041849953,MATH 193A,A01,083224,Rotar; Vladimir,7,0,34,27
1657041849953,MATH 193A,A02,083225,Rotar; Vladimir,5,0,34,29
1657041849953,MATH 193A,A03,083781,Rotar; Vladimir,1,0,34,33
1657041849953,MATH 193A,A04,083782,Rotar; Vladimir,6,0,34,28
1657041849953,MATH 193A,A05,093482,Rotar; Vladimir,6,0,34,28
1657041855979,MATH 197,001,091859,McAuley; Julian John,9999,0,9999,0
1657041855979,MATH 197,002,095566,Kedlaya; Kiran S.,9997,0,9999,2
1657041855979,MATH 197,003,095567,Xiao; Ming,9999,0,9999,0
1657041855979,MATH 197,004,095571,Perols; Johan Lars,9998,0,9999,1
1657041863119,COGS 9,A01,083615,Shannon; Kyle Michael,7,0,75,68
1657041869146,COGS 11,A01,083617,Boyle; Mary E. T.,20,0,48,28
1657041875181,COGS 13,A01,083071,Bastos; Amalia Pinkusfeld,9,0,71,62
1657041881207,COGS 14A,A01,092681,Semenuks; Arturs,0,1,100,100
1657041887229,COGS 14B,A01,083073,Cheng; Tzu-Han,5,0,63,58
1657041893251,COGS 17,A01,092677,Semenuks; Arturs,4,0,81,77
1657041899277,COGS 100,A01,083619,Allen; Michael Gordon,15,0,70,55
1657041905300,COGS 101A,A01,083621,Davis; Joshua Daniel,9,0,68,59
1657041911323,COGS 101B,A01,091572,Allen; Michael Gordon,8,0,65,57
1657041917347,COGS 101C,A01,083625,Delgado; Tania,17,0,35,18
1657041923371,COGS 107A,A01,083627,Boyle; Mary E. T.,13,0,60,47
1657041929397,COGS 118A,A01,083075,Gupta; Anjum,15,0,76,61
1657041935424,CSE 3,A50,083646,Miranda; Gregory Joseph,22,0,50,28
1657041941454,CSE 8A,A50,083650,Miranda; Gregory Joseph,17,1,56,39
1657041947476,CSE 11,A01,083080,Cao; Yingjun,4,15,40,36
1657041953507,CSE 12,A01,083652,Krause-Levy; Sophia Louisa,23,1,120,97
1657041959531,CSE 15L,A01,083654,Morris; Justin Loren,8,0,50,42
1657041959531,CSE 15L,A02,083655,Morris; Justin Loren,9,0,50,41
1657041965561,CSE 20,A01,083657,Tran; Khoa Dang,37,0,80,43
1657041971586,CSE 21,A01,095574,Bach; Quang Tran,21,0,48,27
1657041977627,CSE 30,A01,083084,Eldon; John,4,0,80,76
1657041977627,CSE 30,B01,095061,Bhaskar; Nishant,6,0,50,44
1657041983651,CSE 100,A01,083659,Cao; Yingjun,3,4,70,67
1657041989673,CSE 134B,A01,083661,Powell; Thomas Allan,19,0,100,81
1657041995703,CSE 140,A01,083663,Gungor; Onat,14,0,85,71
1657042001729,CSE 140L,A01,083088,Eldon; John,16,0,100,84
1657042007761,CSE 175,A01,083665,Kumar; Rakesh,3,0,25,22
1657042013785,CSE 190,A00,092507,Dubnov; Shlomo,7,0,20,13
1657042019808,ECE 45,A01,083139,Congero; Spencer William,5,0,75,70
1657042025831,ECE 65,A50,083695,Saad; Andrew S,12,0,30,18
1657042025831,ECE 65,A51,095125,Saad; Andrew S,25,0,26,1
1657042031856,ECE 109,A01,091882,Touri; Behrouz,16,0,70,54
1657042037880,ECE 180,A00,083140,Abi Samra; Nicholas Camill,1,0,30,29
1657042037880,ECE 180,B00,083141,Abi Samra; Nicholas Camill,0,0,30,30
1657042043913,MATH 10A,A01,083735,Patchell; Gregory David,1,0,30,29
1657042043913,MATH 10A,A02,083736,Patchell; Gregory David,20,0,30,10
1657042043913,MATH 10A,A03,083737,Patchell; Gregory David,16,0,30,14
1657042049950,MATH 10B,A01,083207,Lim; Seonhee,7,0,34,27
1657042049950,MATH 10B,A02,083208,Lim; Seonhee,9,0,35,26
1657042049950,MATH 10B,A03,093472,Lim; Seonhee,4,0,34,30
1657042049950,MATH 10B,B01,083739,Sinha; Shubham,9,0,30,21
1657042056106,MATH 18,A01,083743,Cinel; Cameron Alexander,6,0,30,24
1657042056106,MATH 18,A02,083744,Cinel; Cameron Alexander,15,0,30,15
1657042056106,MATH 18,A03,083745,Cinel; Cameron Alexander,8,0,30,22
1657042056106,MATH 18,B01,083748,Rideout; David Porter,4,0,37,33
1657042056106,MATH 18,B02,083749,Rideout; David Porter,3,0,36,33
1657042056106,MATH 18,B03,083750,Rideout; David Porter,2,0,37,35
1657042056106,MATH 18,B04,083751,Rideout; David Porter,5,0,36,31
1657042056106,MATH 18,B05,093473,Rideout; David Porter,4,0,36,32
1657042056106,MATH 18,B06,093474,Rideout; David Porter,5,0,36,31
1657042062132,MATH 20A,A01,083754,Zheng; Zequn,12,0,40,28
1657042068154,MATH 20B,A01,083756,Briones; Jor-el Thomas Caparas,1,0,36,35
1657042068154,MATH 20B,A02,083757,Briones; Jor-el Thomas Caparas,1,0,36,35
1657042068154,MATH 20B,A03,093475,Briones; Jor-el Thomas Caparas,0,0,36,36
1657042074198,MATH 20C,A01,083760,Briones; Jor-el Thomas Caparas,1,0,35,34
1657042074198,MATH 20C,A02,083761,Briones; Jor-el Thomas Caparas,8,0,35,27
1657042074198,MATH 20C,A03,093476,Briones; Jor-el Thomas Caparas,0,1,36,36
1657042074198,MATH 20C,B01,083762,Bach; Quang Tran,0,0,30,30
1657042080221,MATH 20D,A01,083765,Tran; Brian Kha,4,0,30,26
1657042080221,MATH 20D,A02,083766,Tran; Brian Kha,5,0,30,25
1657042080221,MATH 20D,A03,083767,Tran; Brian Kha,3,0,30,27
1657042086243,MATH 20E,A01,083771,Ganguly; Soumya,5,0,32,27
1657042086243,MATH 20E,A02,083772,Ganguly; Soumya,6,0,32,26
1657042086243,MATH 20E,B01,083773,Ciotti; Benjamin,18,0,35,17
1657042086243,MATH 20E,B02,083774,Ciotti; Benjamin,17,0,35,18
1657042092271,MATH 103A,A01,083777,Greenfeld; Be'Eri,2,0,36,34
1657042092271,MATH 103A,A02,083778,Greenfeld; Be'Eri,5,0,36,31
1657042092271,MATH 103A,A03,093561,Greenfeld; Be'Eri,4,0,36,32
1657042092271,MATH 103A,B01,083779,Greenfeld; Be'Eri,6,0,36,30
1657042092271,MATH 103A,B02,083780,Greenfeld; Be'Eri,2,0,36,34
1657042092271,MATH 103A,B03,093562,Greenfeld; Be'Eri,2,0,36,34
1657042098306,MATH 105,A01,085443,Carter; Anne Toulson,14,0,35,21
1657042098306,MATH 105,A02,093477,Carter; Anne Toulson,20,0,35,15
1657042104333,MATH 109,A01,083213,Ganzberger; Geoffrey Michael,2,0,34,32
1657042104333,MATH 109,A02,083214,Ganzberger; Geoffrey Michael,2,0,34,32
1657042104333,MATH 109,A03,093478,Ganzberger; Geoffrey Michael,1,0,34,33
1657042104333,MATH 109,B01,083215,Ganzberger; Geoffrey Michael,1,0,32,31
1657042104333,MATH 109,B02,083216,Ganzberger; Geoffrey Michael,1,0,32,31
1657042104333,MATH 109,B03,093479,Ganzberger; Geoffrey Michael,6,0,32,26
1657042110355,MATH 142A,A01,083219,Chow; Bennett,6,0,32,26
1657042110355,MATH 142A,A02,083220,Chow; Bennett,10,0,32,22
1657042110355,MATH 142A,A03,093480,Chow; Bennett,7,0,32,25
1657042110355,MATH 142A,B03,093481,Chow; Bennett,7,0,32,25
1657042110355,MATH 142A,B04,093558,Chow; Bennett,11,0,32,21
1657042110355,MATH 142A,B05,093559,Chow; Bennett,6,0,32,26
1657042116378,MATH 193A,A01,083224,Rotar; Vladimir,7,0,34,27
1657042116378,MATH 193A,A02,083225,Rotar; Vladimir,5,0,34,29
1657042116378,MATH 193A,A03,083781,Rotar; Vladimir,1,0,34,33
1657042116378,MATH 193A,A04,083782,Rotar; Vladimir,6,0,34,28
1657042116378,MATH 193A,A05,093482,Rotar; Vladimir,6,0,34,28
1657042122405,MATH 197,001,091859,McAuley; Julian John,9999,0,9999,0
1657042122405,MATH 197,002,095566,Kedlaya; Kiran S.,9997,0,9999,2
1657042122405,MATH 197,003,095567,Xiao; Ming,9999,0,9999,0
1657042122405,MATH 197,004,095571,Perols; Johan Lars,9998,0,9999,1
1657042129458,COGS 9,A01,083615,Shannon; Kyle Michael,7,0,75,68
1657042135488,COGS 11,A01,083617,Boyle; Mary E. T.,20,0,48,28
1657042141512,COGS 13,A01,083071,Bastos; Amalia Pinkusfeld,9,0,71,62
1657042147539,COGS 14A,A01,092681,Semenuks; Arturs,0,1,100,100
1657042153566,COGS 14B,A01,083073,Cheng; Tzu-Han,5,0,63,58
1657042159589,COGS 17,A01,092677,Semenuks; Arturs,4,0,81,77
1657042165626,COGS 100,A01,083619,Allen; Michael Gordon,15,0,70,55
1657042171654,COGS 101A,A01,083621,Davis; Joshua Daniel,9,0,68,59
1657042177677,COGS 101B,A01,091572,Allen; Michael Gordon,8,0,65,57
1657042183713,COGS 101C,A01,083625,Delgado; Tania,17,0,35,18
1657042189738,COGS 107A,A01,083627,Boyle; Mary E. T.,13,0,60,47
1657042195766,COGS 118A,A01,083075,Gupta; Anjum,15,0,76,61
1657042201805,CSE 3,A50,083646,Miranda; Gregory Joseph,22,0,50,28
1657042207829,CSE 8A,A50,083650,Miranda; Gregory Joseph,17,1,56,39
1657042213859,CSE 11,A01,083080,Cao; Yingjun,4,15,40,36
1657042219882,CSE 12,A01,083652,Krause-Levy; Sophia Louisa,23,1,120,97
1657042225911,CSE 15L,A01,083654,Morris; Justin Loren,8,0,50,42
1657042225911,CSE 15L,A02,083655,Morris; Justin Loren,9,0,50,41
1657042231935,CSE 20,A01,083657,Tran; Khoa Dang,37,0,80,43
1657042237963,CSE 21,A01,095574,Bach; Quang Tran,21,0,48,27
1657042243995,CSE 30,A01,083084,Eldon; John,4,0,80,76
1657042243995,CSE 30,B01,095061,Bhaskar; Nishant,6,0,50,44
1657042250023,CSE 100,A01,083659,Cao; Yingjun,3,4,70,67
1657042256048,CSE 134B,A01,083661,Powell; Thomas Allan,19,0,100,81
1657042262081,CSE 140,A01,083663,Gungor; Onat,14,0,85,71
1657042268129,CSE 140L,A01,083088,Eldon; John,16,0,100,84
1657042274154,CSE 175,A01,083665,Kumar; Rakesh,3,0,25,22
1657042280189,CSE 190,A00,092507,Dubnov; Shlomo,7,0,20,13
1657042286234,ECE 45,A01,083139,Congero; Spencer William,5,0,75,70
1657042292259,ECE 65,A50,083695,Saad; Andrew S,12,0,30,18
1657042292259,ECE 65,A51,095125,Saad; Andrew S,25,0,26,1
1657042298286,ECE 109,A01,091882,Touri; Behrouz,16,0,70,54
1657042304312,ECE 180,A00,083140,Abi Samra; Nicholas Camill,1,0,30,29
1657042304312,ECE 180,B00,083141,Abi Samra; Nicholas Camill,0,0,30,30
1657042310338,MATH 10A,A01,083735,Patchell; Gregory David,1,0,30,29
1657042310338,MATH 10A,A02,083736,Patchell; Gregory David,20,0,30,10
1657042310338,MATH 10A,A03,083737,Patchell; Gregory David,16,0,30,14
1657042316364,MATH 10B,A01,083207,Lim; Seonhee,7,0,34,27
1657042316364,MATH 10B,A02,083208,Lim; Seonhee,9,0,35,26
1657042316364,MATH 10B,A03,093472,Lim; Seonhee,4,0,34,30
1657042316364,MATH 10B,B01,083739,Sinha; Shubham,9,0,30,21
1657042322401,MATH 18,A01,083743,Cinel; Cameron Alexander,6,0,30,24
1657042322401,MATH 18,A02,083744,Cinel; Cameron Alexander,15,0,30,15
1657042322401,MATH 18,A03,083745,Cinel; Cameron Alexander,8,0,30,22
1657042322401,MATH 18,B01,083748,Rideout; David Porter,4,0,37,33
1657042322401,MATH 18,B02,083749,Rideout; David Porter,3,0,36,33
1657042322401,MATH 18,B03,083750,Rideout; David Porter,2,0,37,35
1657042322401,MATH 18,B04,083751,Rideout; David Porter,5,0,36,31
1657042322401,MATH 18,B05,093473,Rideout; David Porter,4,0,36,32
1657042322401,MATH 18,B06,093474,Rideout; David Porter,5,0,36,31
1657042328432,MATH 20A,A01,083754,Zheng; Zequn,12,0,40,28
1657042334455,MATH 20B,A01,083756,Briones; Jor-el Thomas Caparas,1,0,36,35
1657042334455,MATH 20B,A02,083757,Briones; Jor-el Thomas Caparas,1,0,36,35
1657042334455,MATH 20B,A03,093475,Briones; Jor-el Thomas Caparas,0,0,36,36
1657042340483,MATH 20C,A01,083760,Briones; Jor-el Thomas Caparas,1,0,35,34
1657042340483,MATH 20C,A02,083761,Briones; Jor-el Thomas Caparas,8,0,35,27
1657042340483,MATH 20C,A03,093476,Briones; Jor-el Thomas Caparas,0,1,36,36
1657042340483,MATH 20C,B01,083762,Bach; Quang Tran,0,0,30,30
1657042346513,MATH 20D,A01,083765,Tran; Brian Kha,4,0,30,26
1657042346513,MATH 20D,A02,083766,Tran; Brian Kha,5,0,30,25
1657042346513,MATH 20D,A03,083767,Tran; Brian Kha,3,0,30,27
1657042352556,MATH 20E,A01,083771,Ganguly; Soumya,5,0,32,27
1657042352556,MATH 20E,A02,083772,Ganguly; Soumya,6,0,32,26
1657042352556,MATH 20E,B01,083773,Ciotti; Benjamin,18,0,35,17
1657042352556,MATH 20E,B02,083774,Ciotti; Benjamin,17,0,35,18
1657042358593,MATH 103A,A01,083777,Greenfeld; Be'Eri,2,0,36,34
1657042358593,MATH 103A,A02,083778,Greenfeld; Be'Eri,5,0,36,31
1657042358593,MATH 103A,A03,093561,Greenfeld; Be'Eri,4,0,36,32
1657042358593,MATH 103A,B01,083779,Greenfeld; Be'Eri,6,0,36,30
1657042358593,MATH 103A,B02,083780,Greenfeld; Be'Eri,2,0,36,34
1657042358593,MATH 103A,B03,093562,Greenfeld; Be'Eri,2,0,36,34
1657042364615,MATH 105,A01,085443,Carter; Anne Toulson,14,0,35,21
1657042364615,MATH 105,A02,093477,Carter; Anne Toulson,20,0,35,15
1657042370644,MATH 109,A01,083213,Ganzberger; Geoffrey Michael,2,0,34,32
1657042370644,MATH 109,A02,083214,Ganzberger; Geoffrey Michael,2,0,34,32
1657042370644,MATH 109,A03,093478,Ganzberger; Geoffrey Michael,1,0,34,33
1657042370644,MATH 109,B01,083215,Ganzberger; Geoffrey Michael,1,0,32,31
1657042370644,MATH 109,B02,083216,Ganzberger; Geoffrey Michael,1,0,32,31
1657042370644,MATH 109,B03,093479,Ganzberger; Geoffrey Michael,6,0,32,26
1657042376669,MATH 142A,A01,083219,Chow; Bennett,6,0,32,26
1657042376669,MATH 142A,A02,083220,Chow; Bennett,10,0,32,22
1657042376669,MATH 142A,A03,093480,Chow; Bennett,7,0,32,25
1657042376669,MATH 142A,B03,093481,Chow; Bennett,7,0,32,25
1657042376669,MATH 142A,B04,093558,Chow; Bennett,11,0,32,21
1657042376669,MATH 142A,B05,093559,Chow; Bennett,6,0,32,26
1657042382697,MATH 193A,A01,083224,Rotar; Vladimir,7,0,34,27
1657042382697,MATH 193A,A02,083225,Rotar; Vladimir,5,0,34,29
1657042382697,MATH 193A,A03,083781,Rotar; Vladimir,1,0,34,33
1657042382697,MATH 193A,A04,083782,Rotar; Vladimir,6,0,34,28
1657042382697,MATH 193A,A05,093482,Rotar; Vladimir,6,0,34,28
1657042388722,MATH 197,001,091859,McAuley; Julian John,9999,0,9999,0
1657042388722,MATH 197,002,095566,Kedlaya; Kiran S.,9997,0,9999,2
1657042388722,MATH 197,003,095567,Xiao; Ming,9999,0,9999,0
1657042388722,MATH 197,004,095571,Perols; Johan Lars,9998,0,9999,1
1657042395774,COGS 9,A01,083615,Shannon; Kyle Michael,7,0,75,68
1657042401801,COGS 11,A01,083617,Boyle; Mary E. T.,20,0,48,28
1657042407825,COGS 13,A01,083071,Bastos; Amalia Pinkusfeld,9,0,71,62
1657042413848,COGS 14A,A01,092681,Semenuks; Arturs,0,1,100,100
1657042419881,COGS 14B,A01,083073,Cheng; Tzu-Han,5,0,63,58
1657042425904,COGS 17,A01,092677,Semenuks; Arturs,4,0,81,77
1657042431926,COGS 100,A01,083619,Allen; Michael Gordon,15,0,70,55
1657042437954,COGS 101A,A01,083621,Davis; Joshua Daniel,9,0,68,59
1657042443984,COGS 101B,A01,091572,Allen; Michael Gordon,8,0,65,57
1657042450009,COGS 101C,A01,083625,Delgado; Tania,17,0,35,18
1657042456034,COGS 107A,A01,083627,Boyle; Mary E. T.,13,0,60,47
1657042462056,COGS 118A,A01,083075,Gupta; Anjum,15,0,76,61
1657042468080,CSE 3,A50,083646,Miranda; Gregory Joseph,22,0,50,28
1657042474103,CSE 8A,A50,083650,Miranda; Gregory Joseph,17,1,56,39
1657042480126,CSE 11,A01,083080,Cao; Yingjun,4,15,40,36
1657042486152,CSE 12,A01,083652,Krause-Levy; Sophia Louisa,23,1,120,97
1657042492183,CSE 15L,A01,083654,Morris; Justin Loren,8,0,50,42
1657042492183,CSE 15L,A02,083655,Morris; Justin Loren,9,0,50,41
1657042498211,CSE 20,A01,083657,Tran; Khoa Dang,37,0,80,43
1657042504243,CSE 21,A01,095574,Bach; Quang Tran,21,0,48,27
1657042510279,CSE 30,A01,083084,Eldon; John,4,0,80,76
1657042510279,CSE 30,B01,095061,Bhaskar; Nishant,6,0,50,44
1657042516306,CSE 100,A01,083659,Cao; Yingjun,3,4,70,67
1657042522334,CSE 134B,A01,083661,Powell; Thomas Allan,19,0,100,81
1657042528358,CSE 140,A01,083663,Gungor; Onat,14,0,85,71
1657042534381,CSE 140L,A01,083088,Eldon; John,16,0,100,84
1657042540404,CSE 175,A01,083665,Kumar; Rakesh,3,0,25,22
1657042546429,CSE 190,A00,092507,Dubnov; Shlomo,7,0,20,13
1657042552452,ECE 45,A01,083139,Congero; Spencer William,5,0,75,70
1657042558483,ECE 65,A50,083695,Saad; Andrew S,12,0,30,18
1657042558483,ECE 65,A51,095125,Saad; Andrew S,25,0,26,1
1657042564513,ECE 109,A01,091882,Touri; Behrouz,16,0,70,54
1657042570540,ECE 180,A00,083140,Abi Samra; Nicholas Camill,1,0,30,29
1657042570540,ECE 180,B00,083141,Abi Samra; Nicholas Camill,0,0,30,30
1657042576565,MATH 10A,A01,083735,Patchell; Gregory David,1,0,30,29
1657042576565,MATH 10A,A02,083736,Patchell; Gregory David,20,0,30,10
1657042576565,MATH 10A,A03,083737,Patchell; Gregory David,16,0,30,14
1657042582589,MATH 10B,A01,083207,Lim; Seonhee,7,0,34,27
1657042582589,MATH 10B,A02,083208,Lim; Seonhee,9,0,35,26
1657042582589,MATH 10B,A03,093472,Lim; Seonhee,4,0,34,30
1657042582589,MATH 10B,B01,083739,Sinha; Shubham,9,0,30,21
1657042588612,MATH 18,A01,083743,Cinel; Cameron Alexander,6,0,30,24
1657042588612,MATH 18,A02,083744,Cinel; Cameron Alexander,15,0,30,15
1657042588612,MATH 18,A03,083745,Cinel; Cameron Alexander,8,0,30,22
1657042588612,MATH 18,B01,083748,Rideout; David Porter,4,0,37,33
1657042588612,MATH 18,B02,083749,Rideout; David Porter,3,0,36,33
1657042588612,MATH 18,B03,083750,Rideout; David Porter,2,0,37,35
1657042588612,MATH 18,B04,083751,Rideout; David Porter,5,0,36,31
1657042588612,MATH 18,B05,093473,Rideout; David Porter,4,0,36,32
1657042588612,MATH 18,B06,093474,Rideout; David Porter,5,0,36,31
1657042594633,MATH 20A,A01,083754,Zheng; Zequn,12,0,40,28
1657042600657,MATH 20B,A01,083756,Briones; Jor-el Thomas Caparas,1,0,36,35
1657042600657,MATH 20B,A02,083757,Briones; Jor-el Thomas Caparas,1,0,36,35
1657042600657,MATH 20B,A03,093475,Briones; Jor-el Thomas Caparas,0,0,36,36
1657042606686,MATH 20C,A01,083760,Briones; Jor-el Thomas Caparas,1,0,35,34
1657042606686,MATH 20C,A02,083761,Briones; Jor-el Thomas Caparas,8,0,35,27
1657042606686,MATH 20C,A03,093476,Briones; Jor-el Thomas Caparas,0,1,36,36
1657042606686,MATH 20C,B01,083762,Bach; Quang Tran,0,0,30,30
1657042612713,MATH 20D,A01,083765,Tran; Brian Kha,4,0,30,26
1657042612713,MATH 20D,A02,083766,Tran; Brian Kha,5,0,30,25
1657042612713,MATH 20D,A03,083767,Tran; Brian Kha,3,0,30,27
1657042618750,MATH 20E,A01,083771,Ganguly; Soumya,5,0,32,27
1657042618750,MATH 20E,A02,083772,Ganguly; Soumya,6,0,32,26
1657042618750,MATH 20E,B01,083773,Ciotti; Benjamin,18,0,35,17
1657042618750,MATH 20E,B02,083774,Ciotti; Benjamin,17,0,35,18
1657042624794,MATH 103A,A01,083777,Greenfeld; Be'Eri,2,0,36,34
1657042624794,MATH 103A,A02,083778,Greenfeld; Be'Eri,5,0,36,31
1657042624794,MATH 103A,A03,093561,Greenfeld; Be'Eri,4,0,36,32
1657042624794,MATH 103A,B01,083779,Greenfeld; Be'Eri,6,0,36,30
1657042624794,MATH 103A,B02,083780,Greenfeld; Be'Eri,2,0,36,34
1657042624794,MATH 103A,B03,093562,Greenfeld; Be'Eri,2,0,36,34
1657042630818,MATH 105,A01,085443,Carter; Anne Toulson,14,0,35,21
1657042630818,MATH 105,A02,093477,Carter; Anne Toulson,20,0,35,15
1657042636850,MATH 109,A01,083213,Ganzberger; Geoffrey Michael,2,0,34,32
1657042636850,MATH 109,A02,083214,Ganzberger; Geoffrey Michael,2,0,34,32
1657042636850,MATH 109,A03,093478,Ganzberger; Geoffrey Michael,1,0,34,33
1657042636850,MATH 109,B01,083215,Ganzberger; Geoffrey Michael,1,0,32,31
1657042636850,MATH 109,B02,083216,Ganzberger; Geoffrey Michael,1,0,32,31
1657042636850,MATH 109,B03,093479,Ganzberger; Geoffrey Michael,6,0,32,26
1657042642879,MATH 142A,A01,083219,Chow; Bennett,6,0,32,26
1657042642879,MATH 142A,A02,083220,Chow; Bennett,10,0,32,22
1657042642879,MATH 142A,A03,093480,Chow; Bennett,7,0,32,25
1657042642879,MATH 142A,B03,093481,Chow; Bennett,7,0,32,25
1657042642879,MATH 142A,B04,093558,Chow; Bennett,11,0,32,21
1657042642879,MATH 142A,B05,093559,Chow; Bennett,6,0,32,26
1657042648902,MATH 193A,A01,083224,Rotar; Vladimir,7,0,34,27
1657042648902,MATH 193A,A02,083225,Rotar; Vladimir,5,0,34,29
1657042648902,MATH 193A,A03,083781,Rotar; Vladimir,1,0,34,33
1657042648902,MATH 193A,A04,083782,Rotar; Vladimir,6,0,34,28
1657042648902,MATH 193A,A05,093482,Rotar; Vladimir,6,0,34,28
1657042655030,MATH 197,001,091859,McAuley; Julian John,9999,0,9999,0
1657042655030,MATH 197,002,095566,Kedlaya; Kiran S.,9997,0,9999,2
1657042655030,MATH 197,003,095567,Xiao; Ming,9999,0,9999,0
1657042655030,MATH 197,004,095571,Perols; Johan Lars,9998,0,9999,1
1657042662097,COGS 9,A01,083615,Shannon; Kyle Michael,7,0,75,68
1657042668122,COGS 11,A01,083617,Boyle; Mary E. T.,20,0,48,28
1657042674148,COGS 13,A01,083071,Bastos; Amalia Pinkusfeld,9,0,71,62
1657042680171,COGS 14A,A01,092681,Semenuks; Arturs,0,1,100,100
1657042686193,COGS 14B,A01,083073,Cheng; Tzu-Han,5,0,63,58
1657042692230,COGS 17,A01,092677,Semenuks; Arturs,4,0,81,77
1657042698265,COGS 100,A01,083619,Allen; Michael Gordon,15,0,70,55
1657042704287,COGS 101A,A01,083621,Davis; Joshua Daniel,9,0,68,59
1657042710327,COGS 101B,A01,091572,Allen; Michael Gordon,8,0,65,57
1657042716352,COGS 101C,A01,083625,Delgado; Tania,17,0,35,18
1657042722375,COGS 107A,A01,083627,Boyle; Mary E. T.,13,0,60,47
1657042728406,COGS 118A,A01,083075,Gupta; Anjum,15,0,76,61
1657042734433,CSE 3,A50,083646,Miranda; Gregory Joseph,22,0,50,28
1657042740468,CSE 8A,A50,083650,Miranda; Gregory Joseph,17,1,56,39
1657042746491,CSE 11,A01,083080,Cao; Yingjun,4,15,40,36
1657042752515,CSE 12,A01,083652,Krause-Levy; Sophia Louisa,23,1,120,97
1657042758551,CSE 15L,A01,083654,Morris; Justin Loren,8,0,50,42
1657042758551,CSE 15L,A02,083655,Morris; Justin Loren,9,0,50,41
1657042764579,CSE 20,A01,083657,Tran; Khoa Dang,37,0,80,43
1657042770613,CSE 21,A01,095574,Bach; Quang Tran,21,0,48,27
1657042776640,CSE 30,A01,083084,Eldon; John,4,0,80,76
1657042776640,CSE 30,B01,095061,Bhaskar; Nishant,6,0,50,44
1657042782667,CSE 100,A01,083659,Cao; Yingjun,3,4,70,67
1657042788704,CSE 134B,A01,083661,Powell; Thomas Allan,19,0,100,81
1657042794730,CSE 140,A01,083663,Gungor; Onat,14,0,85,71
1657042800753,CSE 140L,A01,083088,Eldon; John,16,0,100,84
1657042806787,CSE 175,A01,083665,Kumar; Rakesh,3,0,25,22
1657042812809,CSE 190,A00,092507,Dubnov; Shlomo,7,0,20,13
1657042818835,ECE 45,A01,083139,Congero; Spencer William,5,0,75,70
1657042824859,ECE 65,A50,083695,Saad; Andrew S,12,0,30,18
1657042824859,ECE 65,A51,095125,Saad; Andrew S,25,0,26,1
1657042830885,ECE 109,A01,091882,Touri; Behrouz,16,0,70,54
1657042836911,ECE 180,A00,083140,Abi Samra; Nicholas Camill,1,0,30,29
1657042836911,ECE 180,B00,083141,Abi Samra; Nicholas Camill,0,0,30,30
1657042842941,MATH 10A,A01,083735,Patchell; Gregory David,1,0,30,29
1657042842941,MATH 10A,A02,083736,Patchell; Gregory David,20,0,30,10
1657042842941,MATH 10A,A03,083737,Patchell; Gregory David,16,0,30,14
1657042848971,MATH 10B,A01,083207,Lim; Seonhee,7,0,34,27
1657042848971,MATH 10B,A02,083208,Lim; Seonhee,9,0,35,26
1657042848971,MATH 10B,A03,093472,Lim; Seonhee,4,0,34,30
1657042848971,MATH 10B,B01,083739,Sinha; Shubham,9,0,30,21
1657042854999,MATH 18,A01,083743,Cinel; Cameron Alexander,6,0,30,24
1657042854999,MATH 18,A02,083744,Cinel; Cameron Alexander,15,0,30,15
1657042854999,MATH 18,A03,083745,Cinel; Cameron Alexander,8,0,30,22
1657042854999,MATH 18,B01,083748,Rideout; David Porter,4,0,37,33
1657042854999,MATH 18,B02,083749,Rideout; David Porter,3,0,36,33
1657042854999,MATH 18,B03,083750,Rideout; David Porter,2,0,37,35
1657042854999,MATH 18,B04,083751,Rideout; David Porter,5,0,36,31
1657042854999,MATH 18,B05,093473,Rideout; David Porter,4,0,36,32
1657042854999,MATH 18,B06,093474,Rideout; David Porter,5,0,36,31
1657042861030,MATH 20A,A01,083754,Zheng; Zequn,12,0,40,28
1657042867057,MATH 20B,A01,083756,Briones; Jor-el Thomas Caparas,1,0,36,35
1657042867057,MATH 20B,A02,083757,Briones; Jor-el Thomas Caparas,1,0,36,35
1657042867057,MATH 20B,A03,093475,Briones; Jor-el Thomas Caparas,0,0,36,36
1657042873084,MATH 20C,A01,083760,Briones; Jor-el Thomas Caparas,1,0,35,34
1657042873084,MATH 20C,A02,083761,Briones; Jor-el Thomas Caparas,8,0,35,27
1657042873084,MATH 20C,A03,093476,Briones; Jor-el Thomas Caparas,0,1,36,36
1657042873084,MATH 20C,B01,083762,Bach; Quang Tran,0,0,30,30
1657042879114,MATH 20D,A01,083765,Tran; Brian Kha,4,0,30,26
1657042879114,MATH 20D,A02,083766,Tran; Brian Kha,5,0,30,25
1657042879114,MATH 20D,A03,083767,Tran; Brian Kha,3,0,30,27
1657042885139,MATH 20E,A01,083771,Ganguly; Soumya,5,0,32,27
1657042885139,MATH 20E,A02,083772,Ganguly; Soumya,6,0,32,26
1657042885139,MATH 20E,B01,083773,Ciotti; Benjamin,18,0,35,17
1657042885139,MATH 20E,B02,083774,Ciotti; Benjamin,17,0,35,18
1657042891163,MATH 103A,A01,083777,Greenfeld; Be'Eri,2,0,36,34
1657042891163,MATH 103A,A02,083778,Greenfeld; Be'Eri,5,0,36,31
1657042891163,MATH 103A,A03,093561,Greenfeld; Be'Eri,4,0,36,32
1657042891163,MATH 103A,B01,083779,Greenfeld; Be'Eri,6,0,36,30
1657042891163,MATH 103A,B02,083780,Greenfeld; Be'Eri,2,0,36,34
1657042891163,MATH 103A,B03,093562,Greenfeld; Be'Eri,2,0,36,34
1657042897185,MATH 105,A01,085443,Carter; Anne Toulson,14,0,35,21
1657042897185,MATH 105,A02,093477,Carter; Anne Toulson,20,0,35,15
1657042903207,MATH 109,A01,083213,Ganzberger; Geoffrey Michael,2,0,34,32
1657042903207,MATH 109,A02,083214,Ganzberger; Geoffrey Michael,2,0,34,32
1657042903207,MATH 109,A03,093478,Ganzberger; Geoffrey Michael,1,0,34,33
1657042903207,MATH 109,B01,083215,Ganzberger; Geoffrey Michael,1,0,32,31
1657042903207,MATH 109,B02,083216,Ganzberger; Geoffrey Michael,1,0,32,31
1657042903207,MATH 109,B03,093479,Ganzberger; Geoffrey Michael,6,0,32,26
1657042909240,MATH 142A,A01,083219,Chow; Bennett,6,0,32,26
1657042909240,MATH 142A,A02,083220,Chow; Bennett,10,0,32,22
1657042909240,MATH 142A,A03,093480,Chow; Bennett,7,0,32,25
1657042909240,MATH 142A,B03,093481,Chow; Bennett,7,0,32,25
1657042909240,MATH 142A,B04,093558,Chow; Bennett,11,0,32,21
1657042909240,MATH 142A,B05,093559,Chow; Bennett,6,0,32,26
1657042915264,MATH 193A,A01,083224,Rotar; Vladimir,7,0,34,27
1657042915264,MATH 193A,A02,083225,Rotar; Vladimir,5,0,34,29
1657042915264,MATH 193A,A03,083781,Rotar; Vladimir,1,0,34,33
1657042915264,MATH 193A,A04,083782,Rotar; Vladimir,6,0,34,28
1657042915264,MATH 193A,A05,093482,Rotar; Vladimir,6,0,34,28
1657042921286,MATH 197,001,091859,McAuley; Julian John,9999,0,9999,0
1657042921286,MATH 197,002,095566,Kedlaya; Kiran S.,9997,0,9999,2
1657042921286,MATH 197,003,095567,Xiao; Ming,9999,0,9999,0
1657042921286,MATH 197,004,095571,Perols; Johan Lars,9998,0,9999,1
1657042928339,COGS 9,A01,083615,Shannon; Kyle Michael,7,0,75,68
1657042934365,COGS 11,A01,083617,Boyle; Mary E. T.,20,0,48,28
1657042940388,COGS 13,A01,083071,Bastos; Amalia Pinkusfeld,9,0,71,62
1657042946414,COGS 14A,A01,092681,Semenuks; Arturs,0,1,100,100
1657042952447,COGS 14B,A01,083073,Cheng; Tzu-Han,5,0,63,58
1657042958471,COGS 17,A01,092677,Semenuks; Arturs,4,0,81,77
1657042964496,COGS 100,A01,083619,Allen; Michael Gordon,15,0,70,55
1657042970520,COGS 101A,A01,083621,Davis; Joshua Daniel,9,0,68,59
1657042976548,COGS 101B,A01,091572,Allen; Michael Gordon,8,0,65,57
1657042982575,COGS 101C,A01,083625,Delgado; Tania,17,0,35,18
1657042988601,COGS 107A,A01,083627,Boyle; Mary E. T.,13,0,60,47
1657042994625,COGS 118A,A01,083075,Gupta; Anjum,15,0,76,61
1657043000651,CSE 3,A50,083646,Miranda; Gregory Joseph,22,0,50,28
1657043006677,CSE 8A,A50,083650,Miranda; Gregory Joseph,17,1,56,39
1657043012708,CSE 11,A01,083080,Cao; Yingjun,4,15,40,36
1657043018732,CSE 12,A01,083652,Krause-Levy; Sophia Louisa,23,1,120,97
1657043024756,CSE 15L,A01,083654,Morris; Justin Loren,8,0,50,42
1657043024756,CSE 15L,A02,083655,Morris; Justin Loren,9,0,50,41
1657043030786,CSE 20,A01,083657,Tran; Khoa Dang,37,0,80,43
1657043036815,CSE 21,A01,095574,Bach; Quang Tran,21,0,48,27
1657043042839,CSE 30,A01,083084,Eldon; John,4,0,80,76
1657043042839,CSE 30,B01,095061,Bhaskar; Nishant,6,0,50,44
1657043048865,CSE 100,A01,083659,Cao; Yingjun,3,4,70,67
1657043054891,CSE 134B,A01,083661,Powell; Thomas Allan,19,0,100,81
1657043060914,CSE 140,A01,083663,Gungor; Onat,14,0,85,71
1657043066950,CSE 140L,A01,083088,Eldon; John,16,0,100,84
1657043072985,CSE 175,A01,083665,Kumar; Rakesh,3,0,25,22
1657043079008,CSE 190,A00,092507,Dubnov; Shlomo,7,0,20,13
1657043085034,ECE 45,A01,083139,Congero; Spencer William,5,0,75,70
1657043091060,ECE 65,A50,083695,Saad; Andrew S,12,0,30,18
1657043091060,ECE 65,A51,095125,Saad; Andrew S,25,0,26,1
1657043097085,ECE 109,A01,091882,Touri; Behrouz,16,0,70,54
1657043103106,ECE 180,A00,083140,Abi Samra; Nicholas Camill,1,0,30,29
1657043103106,ECE 180,B00,083141,Abi Samra; Nicholas Camill,0,0,30,30
1657043109130,MATH 10A,A01,083735,Patchell; Gregory David,1,0,30,29
1657043109130,MATH 10A,A02,083736,Patchell; Gregory David,20,0,30,10
1657043109130,MATH 10A,A03,083737,Patchell; Gregory David,16,0,30,14
1657043115153,MATH 10B,A01,083207,Lim; Seonhee,7,0,34,27
1657043115153,MATH 10B,A02,083208,Lim; Seonhee,9,0,35,26
1657043115153,MATH 10B,A03,093472,Lim; Seonhee,4,0,34,30
1657043115153,MATH 10B,B01,083739,Sinha; Shubham,9,0,30,21
1657043121182,MATH 18,A01,083743,Cinel; Cameron Alexander,6,0,30,24
1657043121182,MATH 18,A02,083744,Cinel; Cameron Alexander,15,0,30,15
1657043121182,MATH 18,A03,083745,Cinel; Cameron Alexander,8,0,30,22
1657043121182,MATH 18,B01,083748,Rideout; David Porter,4,0,37,33
1657043121182,MATH 18,B02,083749,Rideout; David Porter,3,0,36,33
1657043121182,MATH 18,B03,083750,Rideout; David Porter,2,0,37,35
1657043121182,MATH 18,B04,083751,Rideout; David Porter,5,0,36,31
1657043121182,MATH 18,B05,093473,Rideout; David Porter,4,0,36,32
1657043121182,MATH 18,B06,093474,Rideout; David Porter,5,0,36,31
1657043127214,MATH 20A,A01,083754,Zheng; Zequn,12,0,40,28
1657043133238,MATH 20B,A01,083756,Briones; Jor-el Thomas Caparas,1,0,36,35
1657043133238,MATH 20B,A02,083757,Briones; Jor-el Thomas Caparas,1,0,36,35
1657043133238,MATH 20B,A03,093475,Briones; Jor-el Thomas Caparas,0,0,36,36
1657043139273,MATH 20C,A01,083760,Briones; Jor-el Thomas Caparas,1,0,35,34
1657043139273,MATH 20C,A02,083761,Briones; Jor-el Thomas Caparas,8,0,35,27
1657043139273,MATH 20C,A03,093476,Briones; Jor-el Thomas Caparas,0,1,36,36
1657043139273,MATH 20C,B01,083762,Bach; Quang Tran,0,0,30,30
1657043145306,MATH 20D,A01,083765,Tran; Brian Kha,4,0,30,26
1657043145306,MATH 20D,A02,083766,Tran; Brian Kha,5,0,30,25
1657043145306,MATH 20D,A03,083767,Tran; Brian Kha,3,0,30,27
1657043151331,MATH 20E,A01,083771,Ganguly; Soumya,5,0,32,27
1657043151331,MATH 20E,A02,083772,Ganguly; Soumya,6,0,32,26
1657043151331,MATH 20E,B01,083773,Ciotti; Benjamin,18,0,35,17
1657043151331,MATH 20E,B02,083774,Ciotti; Benjamin,17,0,35,18
1657043157380,MATH 103A,A01,083777,Greenfeld; Be'Eri,2,0,36,34
1657043157380,MATH 103A,A02,083778,Greenfeld; Be'Eri,5,0,36,31
1657043157380,MATH 103A,A03,093561,Greenfeld; Be'Eri,4,0,36,32
1657043157380,MATH 103A,B01,083779,Greenfeld; Be'Eri,6,0,36,30
1657043157380,MATH 103A,B02,083780,Greenfeld; Be'Eri,2,0,36,34
1657043157380,MATH 103A,B03,093562,Greenfeld; Be'Eri,2,0,36,34
1657043163403,MATH 105,A01,085443,Carter; Anne Toulson,14,0,35,21
1657043163403,MATH 105,A02,093477,Carter; Anne Toulson,20,0,35,15
1657043169442,MATH 109,A01,083213,Ganzberger; Geoffrey Michael,2,0,34,32
1657043169442,MATH 109,A02,083214,Ganzberger; Geoffrey Michael,2,0,34,32
1657043169442,MATH 109,A03,093478,Ganzberger; Geoffrey Michael,1,0,34,33
1657043169442,MATH 109,B01,083215,Ganzberger; Geoffrey Michael,1,0,32,31
1657043169442,MATH 109,B02,083216,Ganzberger; Geoffrey Michael,1,0,32,31
1657043169442,MATH 109,B03,093479,Ganzberger; Geoffrey Michael,6,0,32,26
1657043175472,MATH 142A,A01,083219,Chow; Bennett,6,0,32,26
1657043175472,MATH 142A,A02,083220,Chow; Bennett,10,0,32,22
1657043175472,MATH 142A,A03,093480,Chow; Bennett,7,0,32,25
1657043175472,MATH 142A,B03,093481,Chow; Bennett,7,0,32,25
1657043175472,MATH 142A,B04,093558,Chow; Bennett,11,0,32,21
1657043175472,MATH 142A,B05,093559,Chow; Bennett,6,0,32,26
1657043181496,MATH 193A,A01,083224,Rotar; Vladimir,7,0,34,27
1657043181496,MATH 193A,A02,083225,Rotar; Vladimir,5,0,34,29
1657043181496,MATH 193A,A03,083781,Rotar; Vladimir,1,0,34,33
1657043181496,MATH 193A,A04,083782,Rotar; Vladimir,6,0,34,28
1657043181496,MATH 193A,A05,093482,Rotar; Vladimir,6,0,34,28
1657043187534,MATH 197,001,091859,McAuley; Julian John,9999,0,9999,0
1657043187534,MATH 197,002,095566,Kedlaya; Kiran S.,9997,0,9999,2
1657043187534,MATH 197,003,095567,Xiao; Ming,9999,0,9999,0
1657043187534,MATH 197,004,095571,Perols; Johan Lars,9998,0,9999,1
1657043194583,COGS 9,A01,083615,Shannon; Kyle Michael,7,0,75,68
1657043200605,COGS 11,A01,083617,Boyle; Mary E. T.,20,0,48,28
1657043206641,COGS 13,A01,083071,Bastos; Amalia Pinkusfeld,9,0,71,62
1657043212665,COGS 14A,A01,092681,Semenuks; Arturs,0,1,100,100
1657043218699,COGS 14B,A01,083073,Cheng; Tzu-Han,5,0,63,58
1657043224725,COGS 17,A01,092677,Semenuks; Arturs,4,0,81,77
1657043230747,COGS 100,A01,083619,Allen; Michael Gordon,15,0,70,55
1657043236781,COGS 101A,A01,083621,Davis; Joshua Daniel,9,0,68,59
1657043242816,COGS 101B,A01,091572,Allen; Michael Gordon,8,0,65,57
1657043248914,COGS 101C,A01,083625,Delgado; Tania,17,0,35,18
1657043254943,COGS 107A,A01,083627,Boyle; Mary E. T.,13,0,60,47
1657043260969,COGS 118A,A01,083075,Gupta; Anjum,15,0,76,61
1657043266994,CSE 3,A50,083646,Miranda; Gregory Joseph,22,0,50,28
1657043273022,CSE 8A,A50,083650,Miranda; Gregory Joseph,17,1,56,39
1657043279056,CSE 11,A01,083080,Cao; Yingjun,4,15,40,36
1657043285092,CSE 12,A01,083652,Krause-Levy; Sophia Louisa,23,1,120,97
1657043291119,CSE 15L,A01,083654,Morris; Justin Loren,8,0,50,42
1657043291119,CSE 15L,A02,083655,Morris; Justin Loren,9,0,50,41
1657043297147,CSE 20,A01,083657,Tran; Khoa Dang,37,0,80,43
1657043303174,CSE 21,A01,095574,Bach; Quang Tran,21,0,48,27
1657043309196,CSE 30,A01,083084,Eldon; John,4,0,80,76
1657043309196,CSE 30,B01,095061,Bhaskar; Nishant,6,0,50,44
1657043315226,CSE 100,A01,083659,Cao; Yingjun,3,4,70,67
1657043321248,CSE 134B,A01,083661,Powell; Thomas Allan,19,0,100,81
1657043327273,CSE 140,A01,083663,Gungor; Onat,14,0,85,71
1657043333296,CSE 140L,A01,083088,Eldon; John,16,0,100,84
1657043339322,CSE 175,A01,083665,Kumar; Rakesh,3,0,25,22
1657043345347,CSE 190,A00,092507,Dubnov; Shlomo,7,0,20,13
1657043351372,ECE 45,A01,083139,Congero; Spencer William,5,0,75,70
1657043357399,ECE 65,A50,083695,Saad; Andrew S,12,0,30,18
1657043357399,ECE 65,A51,095125,Saad; Andrew S,25,0,26,1
1657043363425,ECE 109,A01,091882,Touri; Behrouz,16,0,70,54
1657043369455,ECE 180,A00,083140,Abi Samra; Nicholas Camill,1,0,30,29
1657043369455,ECE 180,B00,083141,Abi Samra; Nicholas Camill,0,0,30,30
1657043375481,MATH 10A,A01,083735,Patchell; Gregory David,1,0,30,29
1657043375481,MATH 10A,A02,083736,Patchell; Gregory David,20,0,30,10
1657043375481,MATH 10A,A03,083737,Patchell; Gregory David,16,0,30,14
1657043381510,MATH 10B,A01,083207,Lim; Seonhee,7,0,34,27
1657043381510,MATH 10B,A02,083208,Lim; Seonhee,9,0,35,26
1657043381510,MATH 10B,A03,093472,Lim; Seonhee,4,0,34,30
1657043381510,MATH 10B,B01,083739,Sinha; Shubham,9,0,30,21
1657043387537,MATH 18,A01,083743,Cinel; Cameron Alexander,6,0,30,24
1657043387537,MATH 18,A02,083744,Cinel; Cameron Alexander,15,0,30,15
1657043387537,MATH 18,A03,083745,Cinel; Cameron Alexander,8,0,30,22
1657043387537,MATH 18,B01,083748,Rideout; David Porter,4,0,37,33
1657043387537,MATH 18,B02,083749,Rideout; David Porter,3,0,36,33
1657043387537,MATH 18,B03,083750,Rideout; David Porter,2,0,37,35
1657043387537,MATH 18,B04,083751,Rideout; David Porter,5,0,36,31
1657043387537,MATH 18,B05,093473,Rideout; David Porter,4,0,36,32
1657043387537,MATH 18,B06,093474,Rideout; David Porter,5,0,36,31
1657043393561,MATH 20A,A01,083754,Zheng; Zequn,12,0,40,28
1657043399583,MATH 20B,A01,083756,Briones; Jor-el Thomas Caparas,1,0,36,35
1657043399583,MATH 20B,A02,083757,Briones; Jor-el Thomas Caparas,1,0,36,35
1657043399583,MATH 20B,A03,093475,Briones; Jor-el Thomas Caparas,0,0,36,36
1657043405615,MATH 20C,A01,083760,Briones; Jor-el Thomas Caparas,1,0,35,34
1657043405615,MATH 20C,A02,083761,Briones; Jor-el Thomas Caparas,8,0,35,27
1657043405615,MATH 20C,A03,093476,Briones; Jor-el Thomas Caparas,0,1,36,36
1657043405615,MATH 20C,B01,083762,Bach; Quang Tran,0,0,30,30
1657043411643,MATH 20D,A01,083765,Tran; Brian Kha,4,0,30,26
1657043411643,MATH 20D,A02,083766,Tran; Brian Kha,5,0,30,25
1657043411643,MATH 20D,A03,083767,Tran; Brian Kha,3,0,30,27
1657043417665,MATH 20E,A01,083771,Ganguly; Soumya,5,0,32,27
1657043417665,MATH 20E,A02,083772,Ganguly; Soumya,6,0,32,26
1657043417665,MATH 20E,B01,083773,Ciotti; Benjamin,18,0,35,17
1657043417665,MATH 20E,B02,083774,Ciotti; Benjamin,17,0,35,18
1657043423708,MATH 103A,A01,083777,Greenfeld; Be'Eri,2,0,36,34
1657043423708,MATH 103A,A02,083778,Greenfeld; Be'Eri,5,0,36,31
1657043423708,MATH 103A,A03,093561,Greenfeld; Be'Eri,4,0,36,32
1657043423708,MATH 103A,B01,083779,Greenfeld; Be'Eri,6,0,36,30
1657043423708,MATH 103A,B02,083780,Greenfeld; Be'Eri,2,0,36,34
1657043423708,MATH 103A,B03,093562,Greenfeld; Be'Eri,2,0,36,34
1657043429730,MATH 105,A01,085443,Carter; Anne Toulson,14,0,35,21
1657043429730,MATH 105,A02,093477,Carter; Anne Toulson,20,0,35,15
1657043435757,MATH 109,A01,083213,Ganzberger; Geoffrey Michael,2,0,34,32
1657043435757,MATH 109,A02,083214,Ganzberger; Geoffrey Michael,2,0,34,32
1657043435757,MATH 109,A03,093478,Ganzberger; Geoffrey Michael,1,0,34,33
1657043435757,MATH 109,B01,083215,Ganzberger; Geoffrey Michael,1,0,32,31
1657043435757,MATH 109,B02,083216,Ganzberger; Geoffrey Michael,1,0,32,31
1657043435757,MATH 109,B03,093479,Ganzberger; Geoffrey Michael,6,0,32,26
1657043441786,MATH 142A,A01,083219,Chow; Bennett,6,0,32,26
1657043441786,MATH 142A,A02,083220,Chow; Bennett,10,0,32,22
1657043441786,MATH 142A,A03,093480,Chow; Bennett,7,0,32,25
1657043441786,MATH 142A,B03,093481,Chow; Bennett,7,0,32,25
1657043441786,MATH 142A,B04,093558,Chow; Bennett,11,0,32,21
1657043441786,MATH 142A,B05,093559,Chow; Bennett,6,0,32,26
1657043447809,MATH 193A,A01,083224,Rotar; Vladimir,7,0,34,27
1657043447809,MATH 193A,A02,083225,Rotar; Vladimir,5,0,34,29
1657043447809,MATH 193A,A03,083781,Rotar; Vladimir,1,0,34,33
1657043447809,MATH 193A,A04,083782,Rotar; Vladimir,6,0,34,28
1657043447809,MATH 193A,A05,093482,Rotar; Vladimir,6,0,34,28
1657043453833,MATH 197,001,091859,McAuley; Julian John,9999,0,9999,0
1657043453833,MATH 197,002,095566,Kedlaya; Kiran S.,9997,0,9999,2
1657043453833,MATH 197,003,095567,Xiao; Ming,9999,0,9999,0
1657043453833,MATH 197,004,095571,Perols; Johan Lars,9998,0,9999,1
1657043460900,COGS 9,A01,083615,Shannon; Kyle Michael,7,0,75,68
1657043466922,COGS 11,A01,083617,Boyle; Mary E. T.,20,0,48,28
1657043472958,COGS 13,A01,083071,Bastos; Amalia Pinkusfeld,9,0,71,62
1657043478988,COGS 14A,A01,092681,Semenuks; Arturs,0,1,100,100
1657043485022,COGS 14B,A01,083073,Cheng; Tzu-Han,5,0,63,58
1657043491043,COGS 17,A01,092677,Semenuks; Arturs,4,0,81,77
1657043497071,COGS 100,A01,083619,Allen; Michael Gordon,15,0,70,55
1657043503098,COGS 101A,A01,083621,Davis; Joshua Daniel,9,0,68,59
1657043509121,COGS 101B,A01,091572,Allen; Michael Gordon,8,0,65,57
1657043515145,COGS 101C,A01,083625,Delgado; Tania,17,0,35,18
1657043521174,COGS 107A,A01,083627,Boyle; Mary E. T.,13,0,60,47
1657043527197,COGS 118A,A01,083075,Gupta; Anjum,15,0,76,61
1657043533221,CSE 3,A50,083646,Miranda; Gregory Joseph,22,0,50,28
1657043539246,CSE 8A,A50,083650,Miranda; Gregory Joseph,17,1,56,39
1657043545272,CSE 11,A01,083080,Cao; Yingjun,4,15,40,36
1657043551302,CSE 12,A01,083652,Krause-Levy; Sophia Louisa,23,1,120,97
1657043557335,CSE 15L,A01,083654,Morris; Justin Loren,8,0,50,42
1657043557335,CSE 15L,A02,083655,Morris; Justin Loren,9,0,50,41
1657043563374,CSE 20,A01,083657,Tran; Khoa Dang,37,0,80,43
1657043569404,CSE 21,A01,095574,Bach; Quang Tran,21,0,48,27
1657043575427,CSE 30,A01,083084,Eldon; John,4,0,80,76
1657043575427,CSE 30,B01,095061,Bhaskar; Nishant,6,0,50,44
1657043581463,CSE 100,A01,083659,Cao; Yingjun,3,4,70,67
1657043587492,CSE 134B,A01,083661,Powell; Thomas Allan,19,0,100,81
1657043593521,CSE 140,A01,083663,Gungor; Onat,14,0,85,71
1657043599544,CSE 140L,A01,083088,Eldon; John,16,0,100,84
1657043605567,CSE 175,A01,083665,Kumar; Rakesh,3,0,25,22
1657043611592,CSE 190,A00,092507,Dubnov; Shlomo,7,0,20,13
1657043617614,ECE 45,A01,083139,Congero; Spencer William,5,0,75,70
1657043623646,ECE 65,A50,083695,Saad; Andrew S,12,0,30,18
1657043623646,ECE 65,A51,095125,Saad; Andrew S,25,0,26,1
1657043629668,ECE 109,A01,091882,Touri; Behrouz,16,0,70,54
1657043635690,ECE 180,A00,083140,Abi Samra; Nicholas Camill,1,0,30,29
1657043635690,ECE 180,B00,083141,Abi Samra; Nicholas Camill,0,0,30,30
1657043641714,MATH 10A,A01,083735,Patchell; Gregory David,1,0,30,29
1657043641714,MATH 10A,A02,083736,Patchell; Gregory David,20,0,30,10
1657043641714,MATH 10A,A03,083737,Patchell; Gregory David,16,0,30,14
1657043647745,MATH 10B,A01,083207,Lim; Seonhee,7,0,34,27
1657043647745,MATH 10B,A02,083208,Lim; Seonhee,9,0,35,26
1657043647745,MATH 10B,A03,093472,Lim; Seonhee,4,0,34,30
1657043647745,MATH 10B,B01,083739,Sinha; Shubham,9,0,30,21
1657043653769,MATH 18,A01,083743,Cinel; Cameron Alexander,6,0,30,24
1657043653769,MATH 18,A02,083744,Cinel; Cameron Alexander,15,0,30,15
1657043653769,MATH 18,A03,083745,Cinel; Cameron Alexander,8,0,30,22
1657043653769,MATH 18,B01,083748,Rideout; David Porter,4,0,37,33
1657043653769,MATH 18,B02,083749,Rideout; David Porter,3,0,36,33
1657043653769,MATH 18,B03,083750,Rideout; David Porter,2,0,37,35
1657043653769,MATH 18,B04,083751,Rideout; David Porter,5,0,36,31
1657043653769,MATH 18,B05,093473,Rideout; David Porter,4,0,36,32
1657043653769,MATH 18,B06,093474,Rideout; David Porter,5,0,36,31
1657043659792,MATH 20A,A01,083754,Zheng; Zequn,12,0,40,28
1657043665824,MATH 20B,A01,083756,Briones; Jor-el Thomas Caparas,1,0,36,35
1657043665824,MATH 20B,A02,083757,Briones; Jor-el Thomas Caparas,1,0,36,35
1657043665824,MATH 20B,A03,093475,Briones; Jor-el Thomas Caparas,0,0,36,36
1657043671867,MATH 20C,A01,083760,Briones; Jor-el Thomas Caparas,1,0,35,34
1657043671867,MATH 20C,A02,083761,Briones; Jor-el Thomas Caparas,8,0,35,27
1657043671867,MATH 20C,A03,093476,Briones; Jor-el Thomas Caparas,0,1,36,36
1657043671867,MATH 20C,B01,083762,Bach; Quang Tran,0,0,30,30
1657043677907,MATH 20D,A01,083765,Tran; Brian Kha,4,0,30,26
1657043677907,MATH 20D,A02,083766,Tran; Brian Kha,5,0,30,25
1657043677907,MATH 20D,A03,083767,Tran; Brian Kha,3,0,30,27
1657043683930,MATH 20E,A01,083771,Ganguly; Soumya,5,0,32,27
1657043683930,MATH 20E,A02,083772,Ganguly; Soumya,6,0,32,26
1657043683930,MATH 20E,B01,083773,Ciotti; Benjamin,18,0,35,17
1657043683930,MATH 20E,B02,083774,Ciotti; Benjamin,17,0,35,18
1657043689964,MATH 103A,A01,083777,Greenfeld; Be'Eri,2,0,36,34
1657043689964,MATH 103A,A02,083778,Greenfeld; Be'Eri,5,0,36,31
1657043689964,MATH 103A,A03,093561,Greenfeld; Be'Eri,4,0,36,32
1657043689964,MATH 103A,B01,083779,Greenfeld; Be'Eri,6,0,36,30
1657043689964,MATH 103A,B02,083780,Greenfeld; Be'Eri,2,0,36,34
1657043689964,MATH 103A,B03,093562,Greenfeld; Be'Eri,2,0,36,34
1657043695989,MATH 105,A01,085443,Carter; Anne Toulson,14,0,35,21
1657043695989,MATH 105,A02,093477,Carter; Anne Toulson,20,0,35,15
1657043702023,MATH 109,A01,083213,Ganzberger; Geoffrey Michael,2,0,34,32
1657043702023,MATH 109,A02,083214,Ganzberger; Geoffrey Michael,2,0,34,32
1657043702023,MATH 109,A03,093478,Ganzberger; Geoffrey Michael,1,0,34,33
1657043702023,MATH 109,B01,083215,Ganzberger; Geoffrey Michael,1,0,32,31
1657043702023,MATH 109,B02,083216,Ganzberger; Geoffrey Michael,1,0,32,31
1657043702023,MATH 109,B03,093479,Ganzberger; Geoffrey Michael,6,0,32,26
1657043708046,MATH 142A,A01,083219,Chow; Bennett,6,0,32,26
1657043708046,MATH 142A,A02,083220,Chow; Bennett,10,0,32,22
1657043708046,MATH 142A,A03,093480,Chow; Bennett,7,0,32,25
1657043708046,MATH 142A,B03,093481,Chow; Bennett,7,0,32,25
1657043708046,MATH 142A,B04,093558,Chow; Bennett,11,0,32,21
1657043708046,MATH 142A,B05,093559,Chow; Bennett,6,0,32,26
1657043714070,MATH 193A,A01,083224,Rotar; Vladimir,7,0,34,27
1657043714070,MATH 193A,A02,083225,Rotar; Vladimir,5,0,34,29
1657043714070,MATH 193A,A03,083781,Rotar; Vladimir,1,0,34,33
1657043714070,MATH 193A,A04,083782,Rotar; Vladimir,6,0,34,28
1657043714070,MATH 193A,A05,093482,Rotar; Vladimir,6,0,34,28
1657043720093,MATH 197,001,091859,McAuley; Julian John,9999,0,9999,0
1657043720093,MATH 197,002,095566,Kedlaya; Kiran S.,9997,0,9999,2
1657043720093,MATH 197,003,095567,Xiao; Ming,9999,0,9999,0
1657043720093,MATH 197,004,095571,Perols; Johan Lars,9998,0,9999,1
1657043727153,COGS 9,A01,083615,Shannon; Kyle Michael,7,0,75,68
1657043733180,COGS 11,A01,083617,Boyle; Mary E. T.,20,0,48,28
1657043739203,COGS 13,A01,083071,Bastos; Amalia Pinkusfeld,9,0,71,62
1657043745229,COGS 14A,A01,092681,Semenuks; Arturs,0,1,100,100
1657043751265,COGS 14B,A01,083073,Cheng; Tzu-Han,5,0,63,58
1657043757287,COGS 17,A01,092677,Semenuks; Arturs,4,0,81,77
1657043763310,COGS 100,A01,083619,Allen; Michael Gordon,15,0,70,55
1657043769337,COGS 101A,A01,083621,Davis; Joshua Daniel,9,0,68,59
1657043775391,COGS 101B,A01,091572,Allen; Michael Gordon,8,0,65,57
1657043781413,COGS 101C,A01,083625,Delgado; Tania,17,0,35,18
1657043787435,COGS 107A,A01,083627,Boyle; Mary E. T.,13,0,60,47
1657043793572,COGS 118A,A01,083075,Gupta; Anjum,15,0,76,61
1657043799595,CSE 3,A50,083646,Miranda; Gregory Joseph,22,0,50,28
1657043805633,CSE 8A,A50,083650,Miranda; Gregory Joseph,17,1,56,39
1657043811667,CSE 11,A01,083080,Cao; Yingjun,4,15,40,36
1657043817693,CSE 12,A01,083652,Krause-Levy; Sophia Louisa,23,1,120,97
1657043823752,CSE 15L,A01,083654,Morris; Justin Loren,8,0,50,42
1657043823752,CSE 15L,A02,083655,Morris; Justin Loren,9,0,50,41
1657043829775,CSE 20,A01,083657,Tran; Khoa Dang,37,0,80,43
1657043835802,CSE 21,A01,095574,Bach; Quang Tran,21,0,48,27
1657043841832,CSE 30,A01,083084,Eldon; John,4,0,80,76
1657043841832,CSE 30,B01,095061,Bhaskar; Nishant,6,0,50,44
1657043847960,CSE 100,A01,083659,Cao; Yingjun,3,4,70,67
1657043853989,CSE 134B,A01,083661,Powell; Thomas Allan,19,0,100,81
1657043860012,CSE 140,A01,083663,Gungor; Onat,14,0,85,71
1657043866040,CSE 140L,A01,083088,Eldon; John,16,0,100,84
1657043872067,CSE 175,A01,083665,Kumar; Rakesh,3,0,25,22
1657043878094,CSE 190,A00,092507,Dubnov; Shlomo,7,0,20,13
1657043884117,ECE 45,A01,083139,Congero; Spencer William,5,0,75,70
1657043890144,ECE 65,A50,083695,Saad; Andrew S,12,0,30,18
1657043890144,ECE 65,A51,095125,Saad; Andrew S,25,0,26,1
1657043896171,ECE 109,A01,091882,Touri; Behrouz,16,0,70,54
1657043902200,ECE 180,A00,083140,Abi Samra; Nicholas Camill,1,0,30,29
1657043902200,ECE 180,B00,083141,Abi Samra; Nicholas Camill,0,0,30,30
1657043908223,MATH 10A,A01,083735,Patchell; Gregory David,1,0,30,29
1657043908223,MATH 10A,A02,083736,Patchell; Gregory David,20,0,30,10
1657043908223,MATH 10A,A03,083737,Patchell; Gregory David,16,0,30,14
1657043914261,MATH 10B,A01,083207,Lim; Seonhee,7,0,34,27
1657043914261,MATH 10B,A02,083208,Lim; Seonhee,9,0,35,26
1657043914261,MATH 10B,A03,093472,Lim; Seonhee,4,0,34,30
1657043914261,MATH 10B,B01,083739,Sinha; Shubham,9,0,30,21
1657043920299,MATH 18,A01,083743,Cinel; Cameron Alexander,6,0,30,24
1657043920299,MATH 18,A02,083744,Cinel; Cameron Alexander,15,0,30,15
1657043920299,MATH 18,A03,083745,Cinel; Cameron Alexander,8,0,30,22
1657043920299,MATH 18,B01,083748,Rideout; David Porter,4,0,37,33
1657043920299,MATH 18,B02,083749,Rideout; David Porter,3,0,36,33
1657043920299,MATH 18,B03,083750,Rideout; David Porter,2,0,37,35
1657043920299,MATH 18,B04,083751,Rideout; David Porter,5,0,36,31
1657043920299,MATH 18,B05,093473,Rideout; David Porter,4,0,36,32
1657043920299,MATH 18,B06,093474,Rideout; David Porter,5,0,36,31
1657043926322,MATH 20A,A01,083754,Zheng; Zequn,12,0,40,28
1657043932351,MATH 20B,A01,083756,Briones; Jor-el Thomas Caparas,1,0,36,35
1657043932351,MATH 20B,A02,083757,Briones; Jor-el Thomas Caparas,1,0,36,35
1657043932351,MATH 20B,A03,093475,Briones; Jor-el Thomas Caparas,0,0,36,36
1657043938379,MATH 20C,A01,083760,Briones; Jor-el Thomas Caparas,1,0,35,34
1657043938379,MATH 20C,A02,083761,Briones; Jor-el Thomas Caparas,8,0,35,27
1657043938379,MATH 20C,A03,093476,Briones; Jor-el Thomas Caparas,0,1,36,36
1657043938379,MATH 20C,B01,083762,Bach; Quang Tran,0,0,30,30
1657043944407,MATH 20D,A01,083765,Tran; Brian Kha,4,0,30,26
1657043944407,MATH 20D,A02,083766,Tran; Brian Kha,5,0,30,25
1657043944407,MATH 20D,A03,083767,Tran; Brian Kha,3,0,30,27
1657043950429,MATH 20E,A01,083771,Ganguly; Soumya,5,0,32,27
1657043950429,MATH 20E,A02,083772,Ganguly; Soumya,6,0,32,26
1657043950429,MATH 20E,B01,083773,Ciotti; Benjamin,18,0,35,17
1657043950429,MATH 20E,B02,083774,Ciotti; Benjamin,17,0,35,18
1657043956458,MATH 103A,A01,083777,Greenfeld; Be'Eri,2,0,36,34
1657043956458,MATH 103A,A02,083778,Greenfeld; Be'Eri,5,0,36,31
1657043956458,MATH 103A,A03,093561,Greenfeld; Be'Eri,4,0,36,32
1657043956458,MATH 103A,B01,083779,Greenfeld; Be'Eri,6,0,36,30
1657043956458,MATH 103A,B02,083780,Greenfeld; Be'Eri,2,0,36,34
1657043956458,MATH 103A,B03,093562,Greenfeld; Be'Eri,2,0,36,34
1657043962492,MATH 105,A01,085443,Carter; Anne Toulson,14,0,35,21
1657043962492,MATH 105,A02,093477,Carter; Anne Toulson,20,0,35,15
1657043968521,MATH 109,A01,083213,Ganzberger; Geoffrey Michael,2,0,34,32
1657043968521,MATH 109,A02,083214,Ganzberger; Geoffrey Michael,2,0,34,32
1657043968521,MATH 109,A03,093478,Ganzberger; Geoffrey Michael,1,0,34,33
1657043968521,MATH 109,B01,083215,Ganzberger; Geoffrey Michael,1,0,32,31
1657043968521,MATH 109,B02,083216,Ganzberger; Geoffrey Michael,1,0,32,31
1657043968521,MATH 109,B03,093479,Ganzberger; Geoffrey Michael,6,0,32,26
1657043974550,MATH 142A,A01,083219,Chow; Bennett,6,0,32,26
1657043974550,MATH 142A,A02,083220,Chow; Bennett,10,0,32,22
1657043974550,MATH 142A,A03,093480,Chow; Bennett,7,0,32,25
1657043974550,MATH 142A,B03,093481,Chow; Bennett,7,0,32,25
1657043974550,MATH 142A,B04,093558,Chow; Bennett,11,0,32,21
1657043974550,MATH 142A,B05,093559,Chow; Bennett,6,0,32,26
1657043980581,MATH 193A,A01,083224,Rotar; Vladimir,7,0,34,27
1657043980581,MATH 193A,A02,083225,Rotar; Vladimir,5,0,34,29
1657043980581,MATH 193A,A03,083781,Rotar; Vladimir,1,0,34,33
1657043980581,MATH 193A,A04,083782,Rotar; Vladimir,6,0,34,28
1657043980581,MATH 193A,A05,093482,Rotar; Vladimir,6,0,34,28
1657043986616,MATH 197,001,091859,McAuley; Julian John,9999,0,9999,0
1657043986616,MATH 197,002,095566,Kedlaya; Kiran S.,9997,0,9999,2
1657043986616,MATH 197,003,095567,Xiao; Ming,9999,0,9999,0
1657043986616,MATH 197,004,095571,Perols; Johan Lars,9998,0,9999,1
1657043993673,COGS 9,A01,083615,Shannon; Kyle Michael,7,0,75,68
1657043999695,COGS 11,A01,083617,Boyle; Mary E. T.,20,0,48,28
1657044005717,COGS 13,A01,083071,Bastos; Amalia Pinkusfeld,9,0,71,62
1657044011740,COGS 14A,A01,092681,Semenuks; Arturs,0,1,100,100
1657044017763,COGS 14B,A01,083073,Cheng; Tzu-Han,5,0,63,58
1657044023803,COGS 17,A01,092677,Semenuks; Arturs,4,0,81,77
1657044029831,COGS 100,A01,083619,Allen; Michael Gordon,15,0,70,55
1657044035870,COGS 101A,A01,083621,Davis; Joshua Daniel,9,0,68,59
1657044041893,COGS 101B,A01,091572,Allen; Michael Gordon,8,0,65,57
1657044047920,COGS 101C,A01,083625,Delgado; Tania,17,0,35,18
1657044053943,COGS 107A,A01,083627,Boyle; Mary E. T.,13,0,60,47
1657044059972,COGS 118A,A01,083075,Gupta; Anjum,15,0,76,61
1657044065994,CSE 3,A50,083646,Miranda; Gregory Joseph,22,0,50,28
1657044072058,CSE 8A,A50,083650,Miranda; Gregory Joseph,17,1,56,39
1657044078082,CSE 11,A01,083080,Cao; Yingjun,4,15,40,36
1657044084111,CSE 12,A01,083652,Krause-Levy; Sophia Louisa,23,1,120,97
1657044090137,CSE 15L,A01,083654,Morris; Justin Loren,8,0,50,42
1657044090137,CSE 15L,A02,083655,Morris; Justin Loren,9,0,50,41
1657044096161,CSE 20,A01,083657,Tran; Khoa Dang,37,0,80,43
1657044102183,CSE 21,A01,095574,Bach; Quang Tran,21,0,48,27
1657044108208,CSE 30,A01,083084,Eldon; John,4,0,80,76
1657044108208,CSE 30,B01,095061,Bhaskar; Nishant,6,0,50,44
1657044114238,CSE 100,A01,083659,Cao; Yingjun,3,4,70,67
1657044120261,CSE 134B,A01,083661,Powell; Thomas Allan,19,0,100,81
1657044126288,CSE 140,A01,083663,Gungor; Onat,14,0,85,71
1657044132309,CSE 140L,A01,083088,Eldon; John,16,0,100,84
1657044138332,CSE 175,A01,083665,Kumar; Rakesh,3,0,25,22
1657044144353,CSE 190,A00,092507,Dubnov; Shlomo,7,0,20,13
1657044150377,ECE 45,A01,083139,Congero; Spencer William,5,0,75,70
1657044156398,ECE 65,A50,083695,Saad; Andrew S,12,0,30,18
1657044156398,ECE 65,A51,095125,Saad; Andrew S,25,0,26,1
1657044162420,ECE 109,A01,091882,Touri; Behrouz,16,0,70,54
1657044168442,ECE 180,A00,083140,Abi Samra; Nicholas Camill,1,0,30,29
1657044168442,ECE 180,B00,083141,Abi Samra; Nicholas Camill,0,0,30,30
1657044174469,MATH 10A,A01,083735,Patchell; Gregory David,1,0,30,29
1657044174469,MATH 10A,A02,083736,Patchell; Gregory David,20,0,30,10
1657044174469,MATH 10A,A03,083737,Patchell; Gregory David,16,0,30,14
1657044180582,MATH 10B,A01,083207,Lim; Seonhee,7,0,34,27
1657044180582,MATH 10B,A02,083208,Lim; Seonhee,9,0,35,26
1657044180582,MATH 10B,A03,093472,Lim; Seonhee,4,0,34,30
1657044180582,MATH 10B,B01,083739,Sinha; Shubham,9,0,30,21
1657044186628,MATH 18,A01,083743,Cinel; Cameron Alexander,6,0,30,24
1657044186628,MATH 18,A02,083744,Cinel; Cameron Alexander,15,0,30,15
1657044186628,MATH 18,A03,083745,Cinel; Cameron Alexander,8,0,30,22
1657044186628,MATH 18,B01,083748,Rideout; David Porter,4,0,37,33
1657044186628,MATH 18,B02,083749,Rideout; David Porter,3,0,36,33
1657044186628,MATH 18,B03,083750,Rideout; David Porter,2,0,37,35
1657044186628,MATH 18,B04,083751,Rideout; David Porter,5,0,36,31
1657044186628,MATH 18,B05,093473,Rideout; David Porter,4,0,36,32
1657044186628,MATH 18,B06,093474,Rideout; David Porter,5,0,36,31
1657044192656,MATH 20A,A01,083754,Zheng; Zequn,12,0,40,28
1657044198678,MATH 20B,A01,083756,Briones; Jor-el Thomas Caparas,1,0,36,35
1657044198678,MATH 20B,A02,083757,Briones; Jor-el Thomas Caparas,1,0,36,35
1657044198678,MATH 20B,A03,093475,Briones; Jor-el Thomas Caparas,0,0,36,36
1657044204700,MATH 20C,A01,083760,Briones; Jor-el Thomas Caparas,1,0,35,34
1657044204700,MATH 20C,A02,083761,Briones; Jor-el Thomas Caparas,8,0,35,27
1657044204700,MATH 20C,A03,093476,Briones; Jor-el Thomas Caparas,0,1,36,36
1657044204700,MATH 20C,B01,083762,Bach; Quang Tran,0,0,30,30
1657044210723,MATH 20D,A01,083765,Tran; Brian Kha,4,0,30,26
1657044210723,MATH 20D,A02,083766,Tran; Brian Kha,5,0,30,25
1657044210723,MATH 20D,A03,083767,Tran; Brian Kha,3,0,30,27
1657044216746,MATH 20E,A01,083771,Ganguly; Soumya,5,0,32,27
1657044216746,MATH 20E,A02,083772,Ganguly; Soumya,6,0,32,26
1657044216746,MATH 20E,B01,083773,Ciotti; Benjamin,18,0,35,17
1657044216746,MATH 20E,B02,083774,Ciotti; Benjamin,17,0,35,18
1657044222793,MATH 103A,A01,083777,Greenfeld; Be'Eri,2,0,36,34
1657044222793,MATH 103A,A02,083778,Greenfeld; Be'Eri,5,0,36,31
1657044222793,MATH 103A,A03,093561,Greenfeld; Be'Eri,4,0,36,32
1657044222793,MATH 103A,B01,083779,Greenfeld; Be'Eri,6,0,36,30
1657044222793,MATH 103A,B02,083780,Greenfeld; Be'Eri,2,0,36,34
1657044222793,MATH 103A,B03,093562,Greenfeld; Be'Eri,2,0,36,34
1657044228828,MATH 105,A01,085443,Carter; Anne Toulson,14,0,35,21
1657044228828,MATH 105,A02,093477,Carter; Anne Toulson,20,0,35,15
1657044234850,MATH 109,A01,083213,Ganzberger; Geoffrey Michael,2,0,34,32
1657044234850,MATH 109,A02,083214,Ganzberger; Geoffrey Michael,2,0,34,32
1657044234850,MATH 109,A03,093478,Ganzberger; Geoffrey Michael,1,0,34,33
1657044234850,MATH 109,B01,083215,Ganzberger; Geoffrey Michael,1,0,32,31
1657044234850,MATH 109,B02,083216,Ganzberger; Geoffrey Michael,1,0,32,31
1657044234850,MATH 109,B03,093479,Ganzberger; Geoffrey Michael,6,0,32,26
1657044240878,MATH 142A,A01,083219,Chow; Bennett,6,0,32,26
1657044240878,MATH 142A,A02,083220,Chow; Bennett,10,0,32,22
1657044240878,MATH 142A,A03,093480,Chow; Bennett,7,0,32,25
1657044240878,MATH 142A,B03,093481,Chow; Bennett,7,0,32,25
1657044240878,MATH 142A,B04,093558,Chow; Bennett,11,0,32,21
1657044240878,MATH 142A,B05,093559,Chow; Bennett,6,0,32,26
1657044246903,MATH 193A,A01,083224,Rotar; Vladimir,7,0,34,27
1657044246903,MATH 193A,A02,083225,Rotar; Vladimir,5,0,34,29
1657044246903,MATH 193A,A03,083781,Rotar; Vladimir,1,0,34,33
1657044246903,MATH 193A,A04,083782,Rotar; Vladimir,6,0,34,28
1657044246903,MATH 193A,A05,093482,Rotar; Vladimir,6,0,34,28
1657044252925,MATH 197,001,091859,McAuley; Julian John,9999,0,9999,0
1657044252925,MATH 197,002,095566,Kedlaya; Kiran S.,9997,0,9999,2
1657044252925,MATH 197,003,095567,Xiao; Ming,9999,0,9999,0
1657044252925,MATH 197,004,095571,Perols; Johan Lars,9998,0,9999,1
1657044259992,COGS 9,A01,083615,Shannon; Kyle Michael,7,0,75,68
1657044266030,COGS 11,A01,083617,Boyle; Mary E. T.,20,0,48,28
1657044272055,COGS 13,A01,083071,Bastos; Amalia Pinkusfeld,9,0,71,62
1657044278077,COGS 14A,A01,092681,Semenuks; Arturs,0,1,100,100
1657044284106,COGS 14B,A01,083073,Cheng; Tzu-Han,5,0,63,58
1657044290131,COGS 17,A01,092677,Semenuks; Arturs,4,0,81,77
1657044296154,COGS 100,A01,083619,Allen; Michael Gordon,15,0,70,55
1657044302178,COGS 101A,A01,083621,Davis; Joshua Daniel,9,0,68,59
1657044308199,COGS 101B,A01,091572,Allen; Michael Gordon,8,0,65,57
1657044314225,COGS 101C,A01,083625,Delgado; Tania,17,0,35,18
1657044320247,COGS 107A,A01,083627,Boyle; Mary E. T.,13,0,60,47
1657044326270,COGS 118A,A01,083075,Gupta; Anjum,15,0,76,61
1657044332297,CSE 3,A50,083646,Miranda; Gregory Joseph,22,0,50,28
1657044338320,CSE 8A,A50,083650,Miranda; Gregory Joseph,17,1,56,39
1657044344349,CSE 11,A01,083080,Cao; Yingjun,4,15,40,36
1657044350376,CSE 12,A01,083652,Krause-Levy; Sophia Louisa,23,1,120,97
1657044356400,CSE 15L,A01,083654,Morris; Justin Loren,8,0,50,42
1657044356400,CSE 15L,A02,083655,Morris; Justin Loren,9,0,50,41
1657044362424,CSE 20,A01,083657,Tran; Khoa Dang,37,0,80,43
1657044368449,CSE 21,A01,095574,Bach; Quang Tran,21,0,48,27
1657044374476,CSE 30,A01,083084,Eldon; John,4,0,80,76
1657044374476,CSE 30,B01,095061,Bhaskar; Nishant,6,0,50,44
1657044380499,CSE 100,A01,083659,Cao; Yingjun,3,4,70,67
1657044386523,CSE 134B,A01,083661,Powell; Thomas Allan,19,0,100,81
1657044392545,CSE 140,A01,083663,Gungor; Onat,14,0,85,71
1657044398575,CSE 140L,A01,083088,Eldon; John,16,0,100,84
1657044404605,CSE 175,A01,083665,Kumar; Rakesh,3,0,25,22
1657044410632,CSE 190,A00,092507,Dubnov; Shlomo,7,0,20,13
1657044416656,ECE 45,A01,083139,Congero; Spencer William,5,0,75,70
1657044422687,ECE 65,A50,083695,Saad; Andrew S,12,0,30,18
1657044422687,ECE 65,A51,095125,Saad; Andrew S,25,0,26,1
1657044428720,ECE 109,A01,091882,Touri; Behrouz,16,0,70,54
1657044434743,ECE 180,A00,083140,Abi Samra; Nicholas Camill,1,0,30,29
1657044434743,ECE 180,B00,083141,Abi Samra; Nicholas Camill,0,0,30,30
1657044440766,MATH 10A,A01,083735,Patchell; Gregory David,1,0,30,29
1657044440766,MATH 10A,A02,083736,Patchell; Gregory David,20,0,30,10
1657044440766,MATH 10A,A03,083737,Patchell; Gregory David,16,0,30,14
1657044446874,MATH 10B,A01,083207,Lim; Seonhee,7,0,34,27
1657044446874,MATH 10B,A02,083208,Lim; Seonhee,9,0,35,26
1657044446874,MATH 10B,A03,093472,Lim; Seonhee,4,0,34,30
1657044446874,MATH 10B,B01,083739,Sinha; Shubham,9,0,30,21
1657044452902,MATH 18,A01,083743,Cinel; Cameron Alexander,6,0,30,24
1657044452902,MATH 18,A02,083744,Cinel; Cameron Alexander,15,0,30,15
1657044452902,MATH 18,A03,083745,Cinel; Cameron Alexander,8,0,30,22
1657044452902,MATH 18,B01,083748,Rideout; David Porter,4,0,37,33
1657044452902,MATH 18,B02,083749,Rideout; David Porter,3,0,36,33
1657044452902,MATH 18,B03,083750,Rideout; David Porter,2,0,37,35
1657044452902,MATH 18,B04,083751,Rideout; David Porter,5,0,36,31
1657044452902,MATH 18,B05,093473,Rideout; David Porter,4,0,36,32
1657044452902,MATH 18,B06,093474,Rideout; David Porter,5,0,36,31
1657044458925,MATH 20A,A01,083754,Zheng; Zequn,12,0,40,28
1657044464949,MATH 20B,A01,083756,Briones; Jor-el Thomas Caparas,1,0,36,35
1657044464949,MATH 20B,A02,083757,Briones; Jor-el Thomas Caparas,1,0,36,35
1657044464949,MATH 20B,A03,093475,Briones; Jor-el Thomas Caparas,0,0,36,36
1657044470972,MATH 20C,A01,083760,Briones; Jor-el Thomas Caparas,1,0,35,34
1657044470972,MATH 20C,A02,083761,Briones; Jor-el Thomas Caparas,8,0,35,27
1657044470972,MATH 20C,A03,093476,Briones; Jor-el Thomas Caparas,0,1,36,36
1657044470972,MATH 20C,B01,083762,Bach; Quang Tran,0,0,30,30
1657044476999,MATH 20D,A01,083765,Tran; Brian Kha,4,0,30,26
1657044476999,MATH 20D,A02,083766,Tran; Brian Kha,5,0,30,25
1657044476999,MATH 20D,A03,083767,Tran; Brian Kha,3,0,30,27
1657044483022,MATH 20E,A01,083771,Ganguly; Soumya,5,0,32,27
1657044483022,MATH 20E,A02,083772,Ganguly; Soumya,6,0,32,26
1657044483022,MATH 20E,B01,083773,Ciotti; Benjamin,18,0,35,17
1657044483022,MATH 20E,B02,083774,Ciotti; Benjamin,17,0,35,18
1657044489049,MATH 103A,A01,083777,Greenfeld; Be'Eri,2,0,36,34
1657044489049,MATH 103A,A02,083778,Greenfeld; Be'Eri,5,0,36,31
1657044489049,MATH 103A,A03,093561,Greenfeld; Be'Eri,4,0,36,32
1657044489049,MATH 103A,B01,083779,Greenfeld; Be'Eri,6,0,36,30
1657044489049,MATH 103A,B02,083780,Greenfeld; Be'Eri,2,0,36,34
1657044489049,MATH 103A,B03,093562,Greenfeld; Be'Eri,2,0,36,34
1657044495075,MATH 105,A01,085443,Carter; Anne Toulson,14,0,35,21
1657044495075,MATH 105,A02,093477,Carter; Anne Toulson,20,0,35,15
1657044501103,MATH 109,A01,083213,Ganzberger; Geoffrey Michael,2,0,34,32
1657044501103,MATH 109,A02,083214,Ganzberger; Geoffrey Michael,2,0,34,32
1657044501103,MATH 109,A03,093478,Ganzberger; Geoffrey Michael,1,0,34,33
1657044501103,MATH 109,B01,083215,Ganzberger; Geoffrey Michael,1,0,32,31
1657044501103,MATH 109,B02,083216,Ganzberger; Geoffrey Michael,1,0,32,31
1657044501103,MATH 109,B03,093479,Ganzberger; Geoffrey Michael,6,0,32,26
1657044507135,MATH 142A,A01,083219,Chow; Bennett,6,0,32,26
1657044507135,MATH 142A,A02,083220,Chow; Bennett,10,0,32,22
1657044507135,MATH 142A,A03,093480,Chow; Bennett,7,0,32,25
1657044507135,MATH 142A,B03,093481,Chow; Bennett,7,0,32,25
1657044507135,MATH 142A,B04,093558,Chow; Bennett,11,0,32,21
1657044507135,MATH 142A,B05,093559,Chow; Bennett,6,0,32,26
1657044513163,MATH 193A,A01,083224,Rotar; Vladimir,7,0,34,27
1657044513163,MATH 193A,A02,083225,Rotar; Vladimir,5,0,34,29
1657044513163,MATH 193A,A03,083781,Rotar; Vladimir,1,0,34,33
1657044513163,MATH 193A,A04,083782,Rotar; Vladimir,6,0,34,28
1657044513163,MATH 193A,A05,093482,Rotar; Vladimir,6,0,34,28
1657044519185,MATH 197,001,091859,McAuley; Julian John,9999,0,9999,0
1657044519185,MATH 197,002,095566,Kedlaya; Kiran S.,9997,0,9999,2
1657044519185,MATH 197,003,095567,Xiao; Ming,9999,0,9999,0
1657044519185,MATH 197,004,095571,Perols; Johan Lars,9998,0,9999,1
1657044526239,COGS 9,A01,083615,Shannon; Kyle Michael,7,0,75,68
1657044532266,COGS 11,A01,083617,Boyle; Mary E. T.,20,0,48,28
1657044538292,COGS 13,A01,083071,Bastos; Amalia Pinkusfeld,9,0,71,62
1657044544320,COGS 14A,A01,092681,Semenuks; Arturs,0,1,100,100
1657044550345,COGS 14B,A01,083073,Cheng; Tzu-Han,5,0,63,58
1657044556372,COGS 17,A01,092677,Semenuks; Arturs,4,0,81,77
1657044562397,COGS 100,A01,083619,Allen; Michael Gordon,15,0,70,55
1657044568422,COGS 101A,A01,083621,Davis; Joshua Daniel,9,0,68,59
1657044574450,COGS 101B,A01,091572,Allen; Michael Gordon,8,0,65,57
1657044580479,COGS 101C,A01,083625,Delgado; Tania,17,0,35,18
1657044586510,COGS 107A,A01,083627,Boyle; Mary E. T.,13,0,60,47
1657044592543,COGS 118A,A01,083075,Gupta; Anjum,15,0,76,61
1657044598577,CSE 3,A50,083646,Miranda; Gregory Joseph,22,0,50,28
1657044604604,CSE 8A,A50,083650,Miranda; Gregory Joseph,17,1,56,39
1657044610630,CSE 11,A01,083080,Cao; Yingjun,4,15,40,36
1657044616662,CSE 12,A01,083652,Krause-Levy; Sophia Louisa,23,1,120,97
1657044622689,CSE 15L,A01,083654,Morris; Justin Loren,8,0,50,42
1657044622689,CSE 15L,A02,083655,Morris; Justin Loren,9,0,50,41
1657044628720,CSE 20,A01,083657,Tran; Khoa Dang,37,0,80,43
1657044634753,CSE 21,A01,095574,Bach; Quang Tran,21,0,48,27
1657044640781,CSE 30,A01,083084,Eldon; John,4,0,80,76
1657044640781,CSE 30,B01,095061,Bhaskar; Nishant,6,0,50,44
1657044646815,CSE 100,A01,083659,Cao; Yingjun,3,4,70,67
1657044652840,CSE 134B,A01,083661,Powell; Thomas Allan,19,0,100,81
1657044658864,CSE 140,A01,083663,Gungor; Onat,14,0,85,71
1657044664892,CSE 140L,A01,083088,Eldon; John,16,0,100,84
1657044670918,CSE 175,A01,083665,Kumar; Rakesh,3,0,25,22
1657044676946,CSE 190,A00,092507,Dubnov; Shlomo,7,0,20,13
1657044682981,ECE 45,A01,083139,Congero; Spencer William,5,0,75,70
1657044689007,ECE 65,A50,083695,Saad; Andrew S,12,0,30,18
1657044689007,ECE 65,A51,095125,Saad; Andrew S,25,0,26,1
1657044695044,ECE 109,A01,091882,Touri; Behrouz,16,0,70,54
1657044701068,ECE 180,A00,083140,Abi Samra; Nicholas Camill,1,0,30,29
1657044701068,ECE 180,B00,083141,Abi Samra; Nicholas Camill,0,0,30,30
1657044707091,MATH 10A,A01,083735,Patchell; Gregory David,1,0,30,29
1657044707091,MATH 10A,A02,083736,Patchell; Gregory David,20,0,30,10
1657044707091,MATH 10A,A03,083737,Patchell; Gregory David,16,0,30,14
1657044713114,MATH 10B,A01,083207,Lim; Seonhee,7,0,34,27
1657044713114,MATH 10B,A02,083208,Lim; Seonhee,9,0,35,26
1657044713114,MATH 10B,A03,093472,Lim; Seonhee,4,0,34,30
1657044713114,MATH 10B,B01,083739,Sinha; Shubham,9,0,30,21
1657044719140,MATH 18,A01,083743,Cinel; Cameron Alexander,6,0,30,24
1657044719140,MATH 18,A02,083744,Cinel; Cameron Alexander,15,0,30,15
1657044719140,MATH 18,A03,083745,Cinel; Cameron Alexander,8,0,30,22
1657044719140,MATH 18,B01,083748,Rideout; David Porter,4,0,37,33
1657044719140,MATH 18,B02,083749,Rideout; David Porter,3,0,36,33
1657044719140,MATH 18,B03,083750,Rideout; David Porter,2,0,37,35
1657044719140,MATH 18,B04,083751,Rideout; David Porter,5,0,36,31
1657044719140,MATH 18,B05,093473,Rideout; David Porter,4,0,36,32
1657044719140,MATH 18,B06,093474,Rideout; David Porter,5,0,36,31
1657044725175,MATH 20A,A01,083754,Zheng; Zequn,12,0,40,28
1657044731210,MATH 20B,A01,083756,Briones; Jor-el Thomas Caparas,1,0,36,35
1657044731210,MATH 20B,A02,083757,Briones; Jor-el Thomas Caparas,1,0,36,35
1657044731210,MATH 20B,A03,093475,Briones; Jor-el Thomas Caparas,0,0,36,36
1657044737234,MATH 20C,A01,083760,Briones; Jor-el Thomas Caparas,1,0,35,34
1657044737234,MATH 20C,A02,083761,Briones; Jor-el Thomas Caparas,8,0,35,27
1657044737234,MATH 20C,A03,093476,Briones; Jor-el Thomas Caparas,0,1,36,36
1657044737234,MATH 20C,B01,083762,Bach; Quang Tran,0,0,30,30
1657044743257,MATH 20D,A01,083765,Tran; Brian Kha,4,0,30,26
1657044743257,MATH 20D,A02,083766,Tran; Brian Kha,5,0,30,25
1657044743257,MATH 20D,A03,083767,Tran; Brian Kha,3,0,30,27
1657044749280,MATH 20E,A01,083771,Ganguly; Soumya,5,0,32,27
1657044749280,MATH 20E,A02,083772,Ganguly; Soumya,6,0,32,26
1657044749280,MATH 20E,B01,083773,Ciotti; Benjamin,18,0,35,17
1657044749280,MATH 20E,B02,083774,Ciotti; Benjamin,17,0,35,18
1657044755303,MATH 103A,A01,083777,Greenfeld; Be'Eri,2,0,36,34
1657044755303,MATH 103A,A02,083778,Greenfeld; Be'Eri,5,0,36,31
1657044755303,MATH 103A,A03,093561,Greenfeld; Be'Eri,4,0,36,32
1657044755303,MATH 103A,B01,083779,Greenfeld; Be'Eri,6,0,36,30
1657044755303,MATH 103A,B02,083780,Greenfeld; Be'Eri,2,0,36,34
1657044755303,MATH 103A,B03,093562,Greenfeld; Be'Eri,2,0,36,34
1657044761328,MATH 105,A01,085443,Carter; Anne Toulson,14,0,35,21
1657044761328,MATH 105,A02,093477,Carter; Anne Toulson,20,0,35,15
1657044767356,MATH 109,A01,083213,Ganzberger; Geoffrey Michael,2,0,34,32
1657044767356,MATH 109,A02,083214,Ganzberger; Geoffrey Michael,2,0,34,32
1657044767356,MATH 109,A03,093478,Ganzberger; Geoffrey Michael,1,0,34,33
1657044767356,MATH 109,B01,083215,Ganzberger; Geoffrey Michael,1,0,32,31
1657044767356,MATH 109,B02,083216,Ganzberger; Geoffrey Michael,1,0,32,31
1657044767356,MATH 109,B03,093479,Ganzberger; Geoffrey Michael,6,0,32,26
1657044773379,MATH 142A,A01,083219,Chow; Bennett,6,0,32,26
1657044773379,MATH 142A,A02,083220,Chow; Bennett,10,0,32,22
1657044773379,MATH 142A,A03,093480,Chow; Bennett,7,0,32,25
1657044773379,MATH 142A,B03,093481,Chow; Bennett,7,0,32,25
1657044773379,MATH 142A,B04,093558,Chow; Bennett,11,0,32,21
1657044773379,MATH 142A,B05,093559,Chow; Bennett,6,0,32,26
1657044779403,MATH 193A,A01,083224,Rotar; Vladimir,7,0,34,27
1657044779403,MATH 193A,A02,083225,Rotar; Vladimir,5,0,34,29
1657044779403,MATH 193A,A03,083781,Rotar; Vladimir,1,0,34,33
1657044779403,MATH 193A,A04,083782,Rotar; Vladimir,6,0,34,28
1657044779403,MATH 193A,A05,093482,Rotar; Vladimir,6,0,34,28
1657044785426,MATH 197,001,091859,McAuley; Julian John,9999,0,9999,0
1657044785426,MATH 197,002,095566,Kedlaya; Kiran S.,9997,0,9999,2
1657044785426,MATH 197,003,095567,Xiao; Ming,9999,0,9999,0
1657044785426,MATH 197,004,095571,Perols; Johan Lars,9998,0,9999,1
1657044792490,COGS 9,A01,083615,Shannon; Kyle Michael,7,0,75,68
1657044798514,COGS 11,A01,083617,Boyle; Mary E. T.,20,0,48,28
1657044804549,COGS 13,A01,083071,Bastos; Amalia Pinkusfeld,9,0,71,62
1657044810571,COGS 14A,A01,092681,Semenuks; Arturs,0,1,100,100
1657044816594,COGS 14B,A01,083073,Cheng; Tzu-Han,5,0,63,58
1657044822616,COGS 17,A01,092677,Semenuks; Arturs,4,0,81,77
1657044828641,COGS 100,A01,083619,Allen; Michael Gordon,15,0,70,55
1657044834663,COGS 101A,A01,083621,Davis; Joshua Daniel,9,0,68,59
1657044840692,COGS 101B,A01,091572,Allen; Michael Gordon,8,0,65,57
1657044846716,COGS 101C,A01,083625,Delgado; Tania,17,0,35,18
1657044852743,COGS 107A,A01,083627,Boyle; Mary E. T.,13,0,60,47
1657044858778,COGS 118A,A01,083075,Gupta; Anjum,15,0,76,61
1657044864800,CSE 3,A50,083646,Miranda; Gregory Joseph,22,0,50,28
1657044870822,CSE 8A,A50,083650,Miranda; Gregory Joseph,17,1,56,39
1657044876844,CSE 11,A01,083080,Cao; Yingjun,4,15,40,36
1657044882866,CSE 12,A01,083652,Krause-Levy; Sophia Louisa,23,1,120,97
1657044888893,CSE 15L,A01,083654,Morris; Justin Loren,8,0,50,42
1657044888893,CSE 15L,A02,083655,Morris; Justin Loren,9,0,50,41
1657044894926,CSE 20,A01,083657,Tran; Khoa Dang,37,0,80,43
1657044900950,CSE 21,A01,095574,Bach; Quang Tran,21,0,48,27
1657044906973,CSE 30,A01,083084,Eldon; John,4,0,80,76
1657044906973,CSE 30,B01,095061,Bhaskar; Nishant,6,0,50,44
1657044912998,CSE 100,A01,083659,Cao; Yingjun,3,4,70,67
1657044919021,CSE 134B,A01,083661,Powell; Thomas Allan,19,0,100,81
1657044925044,CSE 140,A01,083663,Gungor; Onat,14,0,85,71
1657044931068,CSE 140L,A01,083088,Eldon; John,16,0,100,84
1657044937090,CSE 175,A01,083665,Kumar; Rakesh,3,0,25,22
1657044943112,CSE 190,A00,092507,Dubnov; Shlomo,7,0,20,13
1657044949136,ECE 45,A01,083139,Congero; Spencer William,5,0,75,70
1657044955158,ECE 65,A50,083695,Saad; Andrew S,12,0,30,18
1657044955158,ECE 65,A51,095125,Saad; Andrew S,25,0,26,1
1657044961184,ECE 109,A01,091882,Touri; Behrouz,16,0,70,54
1657044967219,ECE 180,A00,083140,Abi Samra; Nicholas Camill,1,0,30,29
1657044967219,ECE 180,B00,083141,Abi Samra; Nicholas Camill,0,0,30,30
1657044973244,MATH 10A,A01,083735,Patchell; Gregory David,1,0,30,29
1657044973244,MATH 10A,A02,083736,Patchell; Gregory David,20,0,30,10
1657044973244,MATH 10A,A03,083737,Patchell; Gregory David,16,0,30,14
1657044979268,MATH 10B,A01,083207,Lim; Seonhee,7,0,34,27
1657044979268,MATH 10B,A02,083208,Lim; Seonhee,9,0,35,26
1657044979268,MATH 10B,A03,093472,Lim; Seonhee,4,0,34,30
1657044979268,MATH 10B,B01,083739,Sinha; Shubham,9,0,30,21
1657044985300,MATH 18,A01,083743,Cinel; Cameron Alexander,6,0,30,24
1657044985300,MATH 18,A02,083744,Cinel; Cameron Alexander,15,0,30,15
1657044985300,MATH 18,A03,083745,Cinel; Cameron Alexander,8,0,30,22
1657044985300,MATH 18,B01,083748,Rideout; David Porter,4,0,37,33
1657044985300,MATH 18,B02,083749,Rideout; David Porter,3,0,36,33
1657044985300,MATH 18,B03,083750,Rideout; David Porter,2,0,37,35
1657044985300,MATH 18,B04,083751,Rideout; David Porter,5,0,36,31
1657044985300,MATH 18,B05,093473,Rideout; David Porter,4,0,36,32
1657044985300,MATH 18,B06,093474,Rideout; David Porter,5,0,36,31
1657044991324,MATH 20A,A01,083754,Zheng; Zequn,12,0,40,28
1657044997352,MATH 20B,A01,083756,Briones; Jor-el Thomas Caparas,1,0,36,35
1657044997352,MATH 20B,A02,083757,Briones; Jor-el Thomas Caparas,1,0,36,35
1657044997352,MATH 20B,A03,093475,Briones; Jor-el Thomas Caparas,0,0,36,36
1657045003384,MATH 20C,A01,083760,Briones; Jor-el Thomas Caparas,1,0,35,34
1657045003384,MATH 20C,A02,083761,Briones; Jor-el Thomas Caparas,8,0,35,27
1657045003384,MATH 20C,A03,093476,Briones; Jor-el Thomas Caparas,0,1,36,36
1657045003384,MATH 20C,B01,083762,Bach; Quang Tran,0,0,30,30
1657045009408,MATH 20D,A01,083765,Tran; Brian Kha,4,0,30,26
1657045009408,MATH 20D,A02,083766,Tran; Brian Kha,5,0,30,25
1657045009408,MATH 20D,A03,083767,Tran; Brian Kha,3,0,30,27
1657045015435,MATH 20E,A01,083771,Ganguly; Soumya,5,0,32,27
1657045015435,MATH 20E,A02,083772,Ganguly; Soumya,6,0,32,26
1657045015435,MATH 20E,B01,083773,Ciotti; Benjamin,18,0,35,17
1657045015435,MATH 20E,B02,083774,Ciotti; Benjamin,17,0,35,18
1657045021459,MATH 103A,A01,083777,Greenfeld; Be'Eri,2,0,36,34
1657045021459,MATH 103A,A02,083778,Greenfeld; Be'Eri,5,0,36,31
1657045021459,MATH 103A,A03,093561,Greenfeld; Be'Eri,4,0,36,32
1657045021459,MATH 103A,B01,083779,Greenfeld; Be'Eri,6,0,36,30
1657045021459,MATH 103A,B02,083780,Greenfeld; Be'Eri,2,0,36,34
1657045021459,MATH 103A,B03,093562,Greenfeld; Be'Eri,2,0,36,34
1657045027482,MATH 105,A01,085443,Carter; Anne Toulson,14,0,35,21
1657045027482,MATH 105,A02,093477,Carter; Anne Toulson,20,0,35,15
1657045033507,MATH 109,A01,083213,Ganzberger; Geoffrey Michael,2,0,34,32
1657045033507,MATH 109,A02,083214,Ganzberger; Geoffrey Michael,2,0,34,32
1657045033507,MATH 109,A03,093478,Ganzberger; Geoffrey Michael,1,0,34,33
1657045033507,MATH 109,B01,083215,Ganzberger; Geoffrey Michael,1,0,32,31
1657045033507,MATH 109,B02,083216,Ganzberger; Geoffrey Michael,1,0,32,31
1657045033507,MATH 109,B03,093479,Ganzberger; Geoffrey Michael,6,0,32,26
1657045039532,MATH 142A,A01,083219,Chow; Bennett,6,0,32,26
1657045039532,MATH 142A,A02,083220,Chow; Bennett,10,0,32,22
1657045039532,MATH 142A,A03,093480,Chow; Bennett,7,0,32,25
1657045039532,MATH 142A,B03,093481,Chow; Bennett,7,0,32,25
1657045039532,MATH 142A,B04,093558,Chow; Bennett,11,0,32,21
1657045039532,MATH 142A,B05,093559,Chow; Bennett,6,0,32,26
1657045045637,MATH 193A,A01,083224,Rotar; Vladimir,7,0,34,27
1657045045637,MATH 193A,A02,083225,Rotar; Vladimir,5,0,34,29
1657045045637,MATH 193A,A03,083781,Rotar; Vladimir,1,0,34,33
1657045045637,MATH 193A,A04,083782,Rotar; Vladimir,6,0,34,28
1657045045637,MATH 193A,A05,093482,Rotar; Vladimir,6,0,34,28
1657045051666,MATH 197,001,091859,McAuley; Julian John,9999,0,9999,0
1657045051666,MATH 197,002,095566,Kedlaya; Kiran S.,9997,0,9999,2
1657045051666,MATH 197,003,095567,Xiao; Ming,9999,0,9999,0
1657045051666,MATH 197,004,095571,Perols; Johan Lars,9998,0,9999,1
1657045058721,COGS 9,A01,083615,Shannon; Kyle Michael,7,0,75,68
1657045064744,COGS 11,A01,083617,Boyle; Mary E. T.,20,0,48,28
1657045070771,COGS 13,A01,083071,Bastos; Amalia Pinkusfeld,9,0,71,62
1657045076805,COGS 14A,A01,092681,Semenuks; Arturs,0,1,100,100
1657045082827,COGS 14B,A01,083073,Cheng; Tzu-Han,5,0,63,58
1657045088855,COGS 17,A01,092677,Semenuks; Arturs,4,0,81,77
1657045094883,COGS 100,A01,083619,Allen; Michael Gordon,15,0,70,55
1657045100909,COGS 101A,A01,083621,Davis; Joshua Daniel,9,0,68,59
1657045106936,COGS 101B,A01,091572,Allen; Michael Gordon,8,0,65,57
1657045112969,COGS 101C,A01,083625,Delgado; Tania,17,0,35,18
1657045118992,COGS 107A,A01,083627,Boyle; Mary E. T.,13,0,60,47
1657045125025,COGS 118A,A01,083075,Gupta; Anjum,15,0,76,61
1657045131054,CSE 3,A50,083646,Miranda; Gregory Joseph,22,0,50,28
1657045137088,CSE 8A,A50,083650,Miranda; Gregory Joseph,17,1,56,39
1657045143111,CSE 11,A01,083080,Cao; Yingjun,4,15,40,36
1657045149142,CSE 12,A01,083652,Krause-Levy; Sophia Louisa,23,1,120,97
1657045155169,CSE 15L,A01,083654,Morris; Justin Loren,8,0,50,42
1657045155169,CSE 15L,A02,083655,Morris; Justin Loren,9,0,50,41
1657045161202,CSE 20,A01,083657,Tran; Khoa Dang,37,0,80,43
1657045167225,CSE 21,A01,095574,Bach; Quang Tran,21,0,48,27
1657045173249,CSE 30,A01,083084,Eldon; John,4,0,80,76
1657045173249,CSE 30,B01,095061,Bhaskar; Nishant,6,0,50,44
1657045179290,CSE 100,A01,083659,Cao; Yingjun,3,4,70,67
1657045185312,CSE 134B,A01,083661,Powell; Thomas Allan,19,0,100,81
1657045191343,CSE 140,A01,083663,Gungor; Onat,14,0,85,71
1657045197369,CSE 140L,A01,083088,Eldon; John,16,0,100,84
1657045203400,CSE 175,A01,083665,Kumar; Rakesh,3,0,25,22
1657045209436,CSE 190,A00,092507,Dubnov; Shlomo,7,0,20,13
1657045215464,ECE 45,A01,083139,Congero; Spencer William,5,0,75,70
1657045221488,ECE 65,A50,083695,Saad; Andrew S,12,0,30,18
1657045221488,ECE 65,A51,095125,Saad; Andrew S,25,0,26,1
1657045227521,ECE 109,A01,091882,Touri; Behrouz,16,0,70,54
1657045233545,ECE 180,A00,083140,Abi Samra; Nicholas Camill,1,0,30,29
1657045233545,ECE 180,B00,083141,Abi Samra; Nicholas Camill,0,0,30,30
1657045239571,MATH 10A,A01,083735,Patchell; Gregory David,1,0,30,29
1657045239571,MATH 10A,A02,083736,Patchell; Gregory David,20,0,30,10
1657045239571,MATH 10A,A03,083737,Patchell; Gregory David,16,0,30,14
1657045245594,MATH 10B,A01,083207,Lim; Seonhee,7,0,34,27
1657045245594,MATH 10B,A02,083208,Lim; Seonhee,9,0,35,26
1657045245594,MATH 10B,A03,093472,Lim; Seonhee,4,0,34,30
1657045245594,MATH 10B,B01,083739,Sinha; Shubham,9,0,30,21
1657045251627,MATH 18,A01,083743,Cinel; Cameron Alexander,6,0,30,24
1657045251627,MATH 18,A02,083744,Cinel; Cameron Alexander,15,0,30,15
1657045251627,MATH 18,A03,083745,Cinel; Cameron Alexander,8,0,30,22
1657045251627,MATH 18,B01,083748,Rideout; David Porter,4,0,37,33
1657045251627,MATH 18,B02,083749,Rideout; David Porter,3,0,36,33
1657045251627,MATH 18,B03,083750,Rideout; David Porter,2,0,37,35
1657045251627,MATH 18,B04,083751,Rideout; David Porter,5,0,36,31
1657045251627,MATH 18,B05,093473,Rideout; David Porter,4,0,36,32
1657045251627,MATH 18,B06,093474,Rideout; David Porter,5,0,36,31
1657045257658,MATH 20A,A01,083754,Zheng; Zequn,12,0,40,28
1657045263680,MATH 20B,A01,083756,Briones; Jor-el Thomas Caparas,1,0,36,35
1657045263680,MATH 20B,A02,083757,Briones; Jor-el Thomas Caparas,1,0,36,35
1657045263680,MATH 20B,A03,093475,Briones; Jor-el Thomas Caparas,0,0,36,36
1657045269712,MATH 20C,A01,083760,Briones; Jor-el Thomas Caparas,1,0,35,34
1657045269712,MATH 20C,A02,083761,Briones; Jor-el Thomas Caparas,8,0,35,27
1657045269712,MATH 20C,A03,093476,Briones; Jor-el Thomas Caparas,0,1,36,36
1657045269712,MATH 20C,B01,083762,Bach; Quang Tran,0,0,30,30
1657045275739,MATH 20D,A01,083765,Tran; Brian Kha,4,0,30,26
1657045275739,MATH 20D,A02,083766,Tran; Brian Kha,5,0,30,25
1657045275739,MATH 20D,A03,083767,Tran; Brian Kha,3,0,30,27
1657045281762,MATH 20E,A01,083771,Ganguly; Soumya,5,0,32,27
1657045281762,MATH 20E,A02,083772,Ganguly; Soumya,6,0,32,26
1657045281762,MATH 20E,B01,083773,Ciotti; Benjamin,18,0,35,17
1657045281762,MATH 20E,B02,083774,Ciotti; Benjamin,17,0,35,18
1657045287795,MATH 103A,A01,083777,Greenfeld; Be'Eri,2,0,36,34
1657045287795,MATH 103A,A02,083778,Greenfeld; Be'Eri,5,0,36,31
1657045287795,MATH 103A,A03,093561,Greenfeld; Be'Eri,4,0,36,32
1657045287795,MATH 103A,B01,083779,Greenfeld; Be'Eri,6,0,36,30
1657045287795,MATH 103A,B02,083780,Greenfeld; Be'Eri,2,0,36,34
1657045287795,MATH 103A,B03,093562,Greenfeld; Be'Eri,2,0,36,34
1657045293822,MATH 105,A01,085443,Carter; Anne Toulson,14,0,35,21
1657045293822,MATH 105,A02,093477,Carter; Anne Toulson,20,0,35,15
1657045299849,MATH 109,A01,083213,Ganzberger; Geoffrey Michael,2,0,34,32
1657045299849,MATH 109,A02,083214,Ganzberger; Geoffrey Michael,2,0,34,32
1657045299849,MATH 109,A03,093478,Ganzberger; Geoffrey Michael,1,0,34,33
1657045299849,MATH 109,B01,083215,Ganzberger; Geoffrey Michael,1,0,32,31
1657045299849,MATH 109,B02,083216,Ganzberger; Geoffrey Michael,1,0,32,31
1657045299849,MATH 109,B03,093479,Ganzberger; Geoffrey Michael,6,0,32,26
1657045305878,MATH 142A,A01,083219,Chow; Bennett,6,0,32,26
1657045305878,MATH 142A,A02,083220,Chow; Bennett,10,0,32,22
1657045305878,MATH 142A,A03,093480,Chow; Bennett,7,0,32,25
1657045305878,MATH 142A,B03,093481,Chow; Bennett,7,0,32,25
1657045305878,MATH 142A,B04,093558,Chow; Bennett,11,0,32,21
1657045305878,MATH 142A,B05,093559,Chow; Bennett,6,0,32,26
1657045311903,MATH 193A,A01,083224,Rotar; Vladimir,7,0,34,27
1657045311903,MATH 193A,A02,083225,Rotar; Vladimir,5,0,34,29
1657045311903,MATH 193A,A03,083781,Rotar; Vladimir,1,0,34,33
1657045311903,MATH 193A,A04,083782,Rotar; Vladimir,6,0,34,28
1657045311903,MATH 193A,A05,093482,Rotar; Vladimir,6,0,34,28
1657045317928,MATH 197,001,091859,McAuley; Julian John,9999,0,9999,0
1657045317928,MATH 197,002,095566,Kedlaya; Kiran S.,9997,0,9999,2
1657045317928,MATH 197,003,095567,Xiao; Ming,9999,0,9999,0
1657045317928,MATH 197,004,095571,Perols; Johan Lars,9998,0,9999,1
1657045324983,COGS 9,A01,083615,Shannon; Kyle Michael,7,0,75,68
1657045331006,COGS 11,A01,083617,Boyle; Mary E. T.,20,0,48,28
1657045337034,COGS 13,A01,083071,Bastos; Amalia Pinkusfeld,9,0,71,62
1657045343059,COGS 14A,A01,092681,Semenuks; Arturs,0,1,100,100
1657045349084,COGS 14B,A01,083073,Cheng; Tzu-Han,5,0,63,58
1657045355105,COGS 17,A01,092677,Semenuks; Arturs,4,0,81,77
1657045361133,COGS 100,A01,083619,Allen; Michael Gordon,15,0,70,55
1657045367159,COGS 101A,A01,083621,Davis; Joshua Daniel,9,0,68,59
1657045373182,COGS 101B,A01,091572,Allen; Michael Gordon,8,0,65,57
1657045379203,COGS 101C,A01,083625,Delgado; Tania,17,0,35,18
1657045385238,COGS 107A,A01,083627,Boyle; Mary E. T.,13,0,60,47
1657045391263,COGS 118A,A01,083075,Gupta; Anjum,15,0,76,61
1657045397289,CSE 3,A50,083646,Miranda; Gregory Joseph,22,0,50,28
1657045403311,CSE 8A,A50,083650,Miranda; Gregory Joseph,17,1,56,39
1657045409340,CSE 11,A01,083080,Cao; Yingjun,4,15,40,36
1657045415364,CSE 12,A01,083652,Krause-Levy; Sophia Louisa,23,1,120,97
1657045421390,CSE 15L,A01,083654,Morris; Justin Loren,8,0,50,42
1657045421390,CSE 15L,A02,083655,Morris; Justin Loren,9,0,50,41
1657045427419,CSE 20,A01,083657,Tran; Khoa Dang,37,0,80,43
1657045433443,CSE 21,A01,095574,Bach; Quang Tran,21,0,48,27
1657045439468,CSE 30,A01,083084,Eldon; John,4,0,80,76
1657045439468,CSE 30,B01,095061,Bhaskar; Nishant,6,0,50,44
1657045445492,CSE 100,A01,083659,Cao; Yingjun,3,4,70,67
1657045451516,CSE 134B,A01,083661,Powell; Thomas Allan,19,0,100,81
1657045457542,CSE 140,A01,083663,Gungor; Onat,14,0,85,71
1657045463566,CSE 140L,A01,083088,Eldon; John,16,0,100,84
1657045469589,CSE 175,A01,083665,Kumar; Rakesh,3,0,25,22
1657045475615,CSE 190,A00,092507,Dubnov; Shlomo,7,0,20,13
1657045481638,ECE 45,A01,083139,Congero; Spencer William,5,0,75,70
1657045487665,ECE 65,A50,083695,Saad; Andrew S,12,0,30,18
1657045487665,ECE 65,A51,095125,Saad; Andrew S,25,0,26,1
1657045493689,ECE 109,A01,091882,Touri; Behrouz,16,0,70,54
1657045499717,ECE 180,A00,083140,Abi Samra; Nicholas Camill,1,0,30,29
1657045499717,ECE 180,B00,083141,Abi Samra; Nicholas Camill,0,0,30,30
1657045505740,MATH 10A,A01,083735,Patchell; Gregory David,1,0,30,29
1657045505740,MATH 10A,A02,083736,Patchell; Gregory David,20,0,30,10
1657045505740,MATH 10A,A03,083737,Patchell; Gregory David,16,0,30,14
1657045511763,MATH 10B,A01,083207,Lim; Seonhee,7,0,34,27
1657045511763,MATH 10B,A02,083208,Lim; Seonhee,9,0,35,26
1657045511763,MATH 10B,A03,093472,Lim; Seonhee,4,0,34,30
1657045511763,MATH 10B,B01,083739,Sinha; Shubham,9,0,30,21
1657045517793,MATH 18,A01,083743,Cinel; Cameron Alexander,6,0,30,24
1657045517793,MATH 18,A02,083744,Cinel; Cameron Alexander,15,0,30,15
1657045517793,MATH 18,A03,083745,Cinel; Cameron Alexander,8,0,30,22
1657045517793,MATH 18,B01,083748,Rideout; David Porter,4,0,37,33
1657045517793,MATH 18,B02,083749,Rideout; David Porter,3,0,36,33
1657045517793,MATH 18,B03,083750,Rideout; David Porter,2,0,37,35
1657045517793,MATH 18,B04,083751,Rideout; David Porter,5,0,36,31
1657045517793,MATH 18,B05,093473,Rideout; David Porter,4,0,36,32
1657045517793,MATH 18,B06,093474,Rideout; David Porter,5,0,36,31
1657045523821,MATH 20A,A01,083754,Zheng; Zequn,12,0,40,28
1657045529846,MATH 20B,A01,083756,Briones; Jor-el Thomas Caparas,1,0,36,35
1657045529846,MATH 20B,A02,083757,Briones; Jor-el Thomas Caparas,1,0,36,35
1657045529846,MATH 20B,A03,093475,Briones; Jor-el Thomas Caparas,0,0,36,36
1657045535882,MATH 20C,A01,083760,Briones; Jor-el Thomas Caparas,1,0,35,34
1657045535882,MATH 20C,A02,083761,Briones; Jor-el Thomas Caparas,8,0,35,27
1657045535882,MATH 20C,A03,093476,Briones; Jor-el Thomas Caparas,0,1,36,36
1657045535882,MATH 20C,B01,083762,Bach; Quang Tran,0,0,30,30
1657045541910,MATH 20D,A01,083765,Tran; Brian Kha,4,0,30,26
1657045541910,MATH 20D,A02,083766,Tran; Brian Kha,5,0,30,25
1657045541910,MATH 20D,A03,083767,Tran; Brian Kha,3,0,30,27
1657045547943,MATH 20E,A01,083771,Ganguly; Soumya,5,0,32,27
1657045547943,MATH 20E,A02,083772,Ganguly; Soumya,6,0,32,26
1657045547943,MATH 20E,B01,083773,Ciotti; Benjamin,18,0,35,17
1657045547943,MATH 20E,B02,083774,Ciotti; Benjamin,17,0,35,18
1657045553971,MATH 103A,A01,083777,Greenfeld; Be'Eri,2,0,36,34
1657045553971,MATH 103A,A02,083778,Greenfeld; Be'Eri,5,0,36,31
1657045553971,MATH 103A,A03,093561,Greenfeld; Be'Eri,4,0,36,32
1657045553971,MATH 103A,B01,083779,Greenfeld; Be'Eri,6,0,36,30
1657045553971,MATH 103A,B02,083780,Greenfeld; Be'Eri,2,0,36,34
1657045553971,MATH 103A,B03,093562,Greenfeld; Be'Eri,2,0,36,34
1657045559994,MATH 105,A01,085443,Carter; Anne Toulson,14,0,35,21
1657045559994,MATH 105,A02,093477,Carter; Anne Toulson,20,0,35,15
1657045566026,MATH 109,A01,083213,Ganzberger; Geoffrey Michael,2,0,34,32
1657045566026,MATH 109,A02,083214,Ganzberger; Geoffrey Michael,2,0,34,32
1657045566026,MATH 109,A03,093478,Ganzberger; Geoffrey Michael,1,0,34,33
1657045566026,MATH 109,B01,083215,Ganzberger; Geoffrey Michael,1,0,32,31
1657045566026,MATH 109,B02,083216,Ganzberger; Geoffrey Michael,1,0,32,31
1657045566026,MATH 109,B03,093479,Ganzberger; Geoffrey Michael,6,0,32,26
1657045572050,MATH 142A,A01,083219,Chow; Bennett,6,0,32,26
1657045572050,MATH 142A,A02,083220,Chow; Bennett,10,0,32,22
1657045572050,MATH 142A,A03,093480,Chow; Bennett,7,0,32,25
1657045572050,MATH 142A,B03,093481,Chow; Bennett,7,0,32,25
1657045572050,MATH 142A,B04,093558,Chow; Bennett,11,0,32,21
1657045572050,MATH 142A,B05,093559,Chow; Bennett,6,0,32,26
1657045578085,MATH 193A,A01,083224,Rotar; Vladimir,7,0,34,27
1657045578085,MATH 193A,A02,083225,Rotar; Vladimir,5,0,34,29
1657045578085,MATH 193A,A03,083781,Rotar; Vladimir,1,0,34,33
1657045578085,MATH 193A,A04,083782,Rotar; Vladimir,6,0,34,28
1657045578085,MATH 193A,A05,093482,Rotar; Vladimir,6,0,34,28
1657045584108,MATH 197,001,091859,McAuley; Julian John,9999,0,9999,0
1657045584108,MATH 197,002,095566,Kedlaya; Kiran S.,9997,0,9999,2
1657045584108,MATH 197,003,095567,Xiao; Ming,9999,0,9999,0
1657045584108,MATH 197,004,095571,Perols; Johan Lars,9998,0,9999,1
1657045591161,COGS 9,A01,083615,Shannon; Kyle Michael,7,0,75,68
1657045597188,COGS 11,A01,083617,Boyle; Mary E. T.,20,0,48,28
1657045603211,COGS 13,A01,083071,Bastos; Amalia Pinkusfeld,9,0,71,62
1657045609238,COGS 14A,A01,092681,Semenuks; Arturs,0,1,100,100
1657045615265,COGS 14B,A01,083073,Cheng; Tzu-Han,5,0,63,58
1657045621306,COGS 17,A01,092677,Semenuks; Arturs,4,0,81,77
1657045627332,COGS 100,A01,083619,Allen; Michael Gordon,15,0,70,55
1657045633355,COGS 101A,A01,083621,Davis; Joshua Daniel,9,0,68,59
1657045639479,COGS 101B,A01,091572,Allen; Michael Gordon,8,0,65,57
1657045645505,COGS 101C,A01,083625,Delgado; Tania,17,0,35,18
1657045651531,COGS 107A,A01,083627,Boyle; Mary E. T.,13,0,60,47
1657045657556,COGS 118A,A01,083075,Gupta; Anjum,15,0,76,61
1657045663584,CSE 3,A50,083646,Miranda; Gregory Joseph,22,0,50,28
1657045669610,CSE 8A,A50,083650,Miranda; Gregory Joseph,17,1,56,39
1657045675649,CSE 11,A01,083080,Cao; Yingjun,4,15,40,36
1657045681673,CSE 12,A01,083652,Krause-Levy; Sophia Louisa,23,1,120,97
1657045687699,CSE 15L,A01,083654,Morris; Justin Loren,8,0,50,42
1657045687699,CSE 15L,A02,083655,Morris; Justin Loren,9,0,50,41
1657045693722,CSE 20,A01,083657,Tran; Khoa Dang,37,0,80,43
1657045699754,CSE 21,A01,095574,Bach; Quang Tran,21,0,48,27
1657045705777,CSE 30,A01,083084,Eldon; John,4,0,80,76
1657045705777,CSE 30,B01,095061,Bhaskar; Nishant,6,0,50,44
1657045711800,CSE 100,A01,083659,Cao; Yingjun,3,4,70,67
1657045717825,CSE 134B,A01,083661,Powell; Thomas Allan,19,0,100,81
1657045723851,CSE 140,A01,083663,Gungor; Onat,14,0,85,71
1657045729876,CSE 140L,A01,083088,Eldon; John,16,0,100,84
1657045745759,CSE 175,A01,083665,Kumar; Rakesh,3,0,25,22
1657045751784,CSE 190,A00,092507,Dubnov; Shlomo,7,0,20,13
1657045757807,ECE 45,A01,083139,Congero; Spencer William,5,0,75,70
1657045763829,ECE 65,A50,083695,Saad; Andrew S,12,0,30,18
1657045763829,ECE 65,A51,095125,Saad; Andrew S,25,0,26,1
1657045769851,ECE 109,A01,091882,Touri; Behrouz,16,0,70,54
1657045775873,ECE 180,A00,083140,Abi Samra; Nicholas Camill,1,0,30,29
1657045775873,ECE 180,B00,083141,Abi Samra; Nicholas Camill,0,0,30,30
1657045781900,MATH 10A,A01,083735,Patchell; Gregory David,1,0,30,29
1657045781900,MATH 10A,A02,083736,Patchell; Gregory David,20,0,30,10
1657045781900,MATH 10A,A03,083737,Patchell; Gregory David,16,0,30,14
1657045787928,MATH 10B,A01,083207,Lim; Seonhee,7,0,34,27
1657045787928,MATH 10B,A02,083208,Lim; Seonhee,9,0,35,26
1657045787928,MATH 10B,A03,093472,Lim; Seonhee,4,0,34,30
1657045787928,MATH 10B,B01,083739,Sinha; Shubham,9,0,30,21
1657045793957,MATH 18,A01,083743,Cinel; Cameron Alexander,6,0,30,24
1657045793957,MATH 18,A02,083744,Cinel; Cameron Alexander,15,0,30,15
1657045793957,MATH 18,A03,083745,Cinel; Cameron Alexander,8,0,30,22
1657045793957,MATH 18,B01,083748,Rideout; David Porter,4,0,37,33
1657045793957,MATH 18,B02,083749,Rideout; David Porter,3,0,36,33
1657045793957,MATH 18,B03,083750,Rideout; David Porter,2,0,37,35
1657045793957,MATH 18,B04,083751,Rideout; David Porter,5,0,36,31
1657045793957,MATH 18,B05,093473,Rideout; David Porter,4,0,36,32
1657045793957,MATH 18,B06,093474,Rideout; David Porter,5,0,36,31
1657045799981,MATH 20A,A01,083754,Zheng; Zequn,12,0,40,28
1657045806009,MATH 20B,A01,083756,Briones; Jor-el Thomas Caparas,1,0,36,35
1657045806009,MATH 20B,A02,083757,Briones; Jor-el Thomas Caparas,1,0,36,35
1657045806009,MATH 20B,A03,093475,Briones; Jor-el Thomas Caparas,0,0,36,36
1657045812045,MATH 20C,A01,083760,Briones; Jor-el Thomas Caparas,1,0,35,34
1657045812045,MATH 20C,A02,083761,Briones; Jor-el Thomas Caparas,8,0,35,27
1657045812045,MATH 20C,A03,093476,Briones; Jor-el Thomas Caparas,0,1,36,36
1657045812045,MATH 20C,B01,083762,Bach; Quang Tran,0,0,30,30
1657045818070,MATH 20D,A01,083765,Tran; Brian Kha,4,0,30,26
1657045818070,MATH 20D,A02,083766,Tran; Brian Kha,5,0,30,25
1657045818070,MATH 20D,A03,083767,Tran; Brian Kha,3,0,30,27
1657045824095,MATH 20E,A01,083771,Ganguly; Soumya,5,0,32,27
1657045824095,MATH 20E,A02,083772,Ganguly; Soumya,6,0,32,26
1657045824095,MATH 20E,B01,083773,Ciotti; Benjamin,18,0,35,17
1657045824095,MATH 20E,B02,083774,Ciotti; Benjamin,17,0,35,18
1657045830120,MATH 103A,A01,083777,Greenfeld; Be'Eri,2,0,36,34
1657045830120,MATH 103A,A02,083778,Greenfeld; Be'Eri,5,0,36,31
1657045830120,MATH 103A,A03,093561,Greenfeld; Be'Eri,4,0,36,32
1657045830120,MATH 103A,B01,083779,Greenfeld; Be'Eri,6,0,36,30
1657045830120,MATH 103A,B02,083780,Greenfeld; Be'Eri,2,0,36,34
1657045830120,MATH 103A,B03,093562,Greenfeld; Be'Eri,2,0,36,34
1657045836144,MATH 105,A01,085443,Carter; Anne Toulson,14,0,35,21
1657045836144,MATH 105,A02,093477,Carter; Anne Toulson,20,0,35,15
1657045842170,MATH 109,A01,083213,Ganzberger; Geoffrey Michael,2,0,34,32
1657045842170,MATH 109,A02,083214,Ganzberger; Geoffrey Michael,2,0,34,32
1657045842170,MATH 109,A03,093478,Ganzberger; Geoffrey Michael,1,0,34,33
1657045842170,MATH 109,B01,083215,Ganzberger; Geoffrey Michael,1,0,32,31
1657045842170,MATH 109,B02,083216,Ganzberger; Geoffrey Michael,1,0,32,31
1657045842170,MATH 109,B03,093479,Ganzberger; Geoffrey Michael,6,0,32,26
1657045848226,MATH 142A,A01,083219,Chow; Bennett,6,0,32,26
1657045848226,MATH 142A,A02,083220,Chow; Bennett,10,0,32,22
1657045848226,MATH 142A,A03,093480,Chow; Bennett,7,0,32,25
1657045848226,MATH 142A,B03,093481,Chow; Bennett,7,0,32,25
1657045848226,MATH 142A,B04,093558,Chow; Bennett,11,0,32,21
1657045848226,MATH 142A,B05,093559,Chow; Bennett,6,0,32,26
1657045854253,MATH 193A,A01,083224,Rotar; Vladimir,7,0,34,27
1657045854253,MATH 193A,A02,083225,Rotar; Vladimir,5,0,34,29
1657045854253,MATH 193A,A03,083781,Rotar; Vladimir,1,0,34,33
1657045854253,MATH 193A,A04,083782,Rotar; Vladimir,6,0,34,28
1657045854253,MATH 193A,A05,093482,Rotar; Vladimir,6,0,34,28
1657045860298,MATH 197,001,091859,McAuley; Julian John,9999,0,9999,0
1657045860298,MATH 197,002,095566,Kedlaya; Kiran S.,9997,0,9999,2
1657045860298,MATH 197,003,095567,Xiao; Ming,9999,0,9999,0
1657045860298,MATH 197,004,095571,Perols; Johan Lars,9998,0,9999,1
1657045867362,COGS 9,A01,083615,Shannon; Kyle Michael,7,0,75,68
1657045873384,COGS 11,A01,083617,Boyle; Mary E. T.,20,0,48,28
1657045879407,COGS 13,A01,083071,Bastos; Amalia Pinkusfeld,9,0,71,62
1657045885440,COGS 14A,A01,092681,Semenuks; Arturs,0,1,100,100
1657045891464,COGS 14B,A01,083073,Cheng; Tzu-Han,5,0,63,58
1657045897498,COGS 17,A01,092677,Semenuks; Arturs,4,0,81,77
1657045903521,COGS 100,A01,083619,Allen; Michael Gordon,15,0,70,55
1657045909549,COGS 101A,A01,083621,Davis; Joshua Daniel,9,0,68,59
1657045915582,COGS 101B,A01,091572,Allen; Michael Gordon,8,0,65,57
1657045921605,COGS 101C,A01,083625,Delgado; Tania,17,0,35,18
1657045927635,COGS 107A,A01,083627,Boyle; Mary E. T.,13,0,60,47
1657045933661,COGS 118A,A01,083075,Gupta; Anjum,15,0,76,61
1657045939702,CSE 3,A50,083646,Miranda; Gregory Joseph,22,0,50,28
1657045945731,CSE 8A,A50,083650,Miranda; Gregory Joseph,17,1,56,39
1657045951753,CSE 11,A01,083080,Cao; Yingjun,4,15,40,36
1657045957786,CSE 12,A01,083652,Krause-Levy; Sophia Louisa,23,1,120,97
1657045963809,CSE 15L,A01,083654,Morris; Justin Loren,8,0,50,42
1657045963809,CSE 15L,A02,083655,Morris; Justin Loren,9,0,50,41
1657045969833,CSE 20,A01,083657,Tran; Khoa Dang,37,0,80,43
1657045975861,CSE 21,A01,095574,Bach; Quang Tran,21,0,48,27
1657045981885,CSE 30,A01,083084,Eldon; John,4,0,80,76
1657045981885,CSE 30,B01,095061,Bhaskar; Nishant,6,0,50,44
1657045987911,CSE 100,A01,083659,Cao; Yingjun,3,4,70,67
1657045993937,CSE 134B,A01,083661,Powell; Thomas Allan,19,0,100,81
1657045999964,CSE 140,A01,083663,Gungor; Onat,14,0,85,71
1657046006000,CSE 140L,A01,083088,Eldon; John,16,0,100,84
1657046012035,CSE 175,A01,083665,Kumar; Rakesh,3,0,25,22
1657046018061,CSE 190,A00,092507,Dubnov; Shlomo,7,0,20,13
1657046024102,ECE 45,A01,083139,Congero; Spencer William,5,0,75,70
1657046030129,ECE 65,A50,083695,Saad; Andrew S,12,0,30,18
1657046030129,ECE 65,A51,095125,Saad; Andrew S,25,0,26,1
1657046036162,ECE 109,A01,091882,Touri; Behrouz,16,0,70,54
1657046042192,ECE 180,A00,083140,Abi Samra; Nicholas Camill,1,0,30,29
1657046042192,ECE 180,B00,083141,Abi Samra; Nicholas Camill,0,0,30,30
1657046048223,MATH 10A,A01,083735,Patchell; Gregory David,1,0,30,29
1657046048223,MATH 10A,A02,083736,Patchell; Gregory David,20,0,30,10
1657046048223,MATH 10A,A03,083737,Patchell; Gregory David,16,0,30,14
1657046054263,MATH 10B,A01,083207,Lim; Seonhee,7,0,34,27
1657046054263,MATH 10B,A02,083208,Lim; Seonhee,9,0,35,26
1657046054263,MATH 10B,A03,093472,Lim; Seonhee,4,0,34,30
1657046054263,MATH 10B,B01,083739,Sinha; Shubham,9,0,30,21
1657046060292,MATH 18,A01,083743,Cinel; Cameron Alexander,6,0,30,24
1657046060292,MATH 18,A02,083744,Cinel; Cameron Alexander,15,0,30,15
1657046060292,MATH 18,A03,083745,Cinel; Cameron Alexander,8,0,30,22
1657046060292,MATH 18,B01,083748,Rideout; David Porter,4,0,37,33
1657046060292,MATH 18,B02,083749,Rideout; David Porter,3,0,36,33
1657046060292,MATH 18,B03,083750,Rideout; David Porter,2,0,37,35
1657046060292,MATH 18,B04,083751,Rideout; David Porter,5,0,36,31
1657046060292,MATH 18,B05,093473,Rideout; David Porter,4,0,36,32
1657046060292,MATH 18,B06,093474,Rideout; David Porter,5,0,36,31
1657046066321,MATH 20A,A01,083754,Zheng; Zequn,12,0,40,28
1657046072344,MATH 20B,A01,083756,Briones; Jor-el Thomas Caparas,1,0,36,35
1657046072344,MATH 20B,A02,083757,Briones; Jor-el Thomas Caparas,1,0,36,35
1657046072344,MATH 20B,A03,093475,Briones; Jor-el Thomas Caparas,0,0,36,36
1657046078367,MATH 20C,A01,083760,Briones; Jor-el Thomas Caparas,1,0,35,34
1657046078367,MATH 20C,A02,083761,Briones; Jor-el Thomas Caparas,8,0,35,27
1657046078367,MATH 20C,A03,093476,Briones; Jor-el Thomas Caparas,0,1,36,36
1657046078367,MATH 20C,B01,083762,Bach; Quang Tran,0,0,30,30
1657046084395,MATH 20D,A01,083765,Tran; Brian Kha,4,0,30,26
1657046084395,MATH 20D,A02,083766,Tran; Brian Kha,5,0,30,25
1657046084395,MATH 20D,A03,083767,Tran; Brian Kha,3,0,30,27
1657046090422,MATH 20E,A01,083771,Ganguly; Soumya,5,0,32,27
1657046090422,MATH 20E,A02,083772,Ganguly; Soumya,6,0,32,26
1657046090422,MATH 20E,B01,083773,Ciotti; Benjamin,18,0,35,17
1657046090422,MATH 20E,B02,083774,Ciotti; Benjamin,17,0,35,18
1657046096451,MATH 103A,A01,083777,Greenfeld; Be'Eri,2,0,36,34
1657046096451,MATH 103A,A02,083778,Greenfeld; Be'Eri,5,0,36,31
1657046096451,MATH 103A,A03,093561,Greenfeld; Be'Eri,4,0,36,32
1657046096451,MATH 103A,B01,083779,Greenfeld; Be'Eri,6,0,36,30
1657046096451,MATH 103A,B02,083780,Greenfeld; Be'Eri,2,0,36,34
1657046096451,MATH 103A,B03,093562,Greenfeld; Be'Eri,2,0,36,34
1657046102474,MATH 105,A01,085443,Carter; Anne Toulson,14,0,35,21
1657046102474,MATH 105,A02,093477,Carter; Anne Toulson,20,0,35,15
1657046108497,MATH 109,A01,083213,Ganzberger; Geoffrey Michael,2,0,34,32
1657046108497,MATH 109,A02,083214,Ganzberger; Geoffrey Michael,2,0,34,32
1657046108497,MATH 109,A03,093478,Ganzberger; Geoffrey Michael,1,0,34,33
1657046108497,MATH 109,B01,083215,Ganzberger; Geoffrey Michael,1,0,32,31
1657046108497,MATH 109,B02,083216,Ganzberger; Geoffrey Michael,1,0,32,31
1657046108497,MATH 109,B03,093479,Ganzberger; Geoffrey Michael,6,0,32,26
1657046114526,MATH 142A,A01,083219,Chow; Bennett,6,0,32,26
1657046114526,MATH 142A,A02,083220,Chow; Bennett,10,0,32,22
1657046114526,MATH 142A,A03,093480,Chow; Bennett,7,0,32,25
1657046114526,MATH 142A,B03,093481,Chow; Bennett,7,0,32,25
1657046114526,MATH 142A,B04,093558,Chow; Bennett,11,0,32,21
1657046114526,MATH 142A,B05,093559,Chow; Bennett,6,0,32,26
1657046120558,MATH 193A,A01,083224,Rotar; Vladimir,7,0,34,27
1657046120558,MATH 193A,A02,083225,Rotar; Vladimir,5,0,34,29
1657046120558,MATH 193A,A03,083781,Rotar; Vladimir,1,0,34,33
1657046120558,MATH 193A,A04,083782,Rotar; Vladimir,6,0,34,28
1657046120558,MATH 193A,A05,093482,Rotar; Vladimir,6,0,34,28
1657046126586,MATH 197,001,091859,McAuley; Julian John,9999,0,9999,0
1657046126586,MATH 197,002,095566,Kedlaya; Kiran S.,9997,0,9999,2
1657046126586,MATH 197,003,095567,Xiao; Ming,9999,0,9999,0
1657046126586,MATH 197,004,095571,Perols; Johan Lars,9998,0,9999,1
1657046133648,COGS 9,A01,083615,Shannon; Kyle Michael,7,0,75,68
1657046139670,COGS 11,A01,083617,Boyle; Mary E. T.,20,0,48,28
1657046145701,COGS 13,A01,083071,Bastos; Amalia Pinkusfeld,9,0,71,62
1657046151741,COGS 14A,A01,092681,Semenuks; Arturs,0,1,100,100
1657046157769,COGS 14B,A01,083073,Cheng; Tzu-Han,5,0,63,58
1657046163798,COGS 17,A01,092677,Semenuks; Arturs,4,0,81,77
1657046169826,COGS 100,A01,083619,Allen; Michael Gordon,15,0,70,55
1657046175861,COGS 101A,A01,083621,Davis; Joshua Daniel,9,0,68,59
1657046181885,COGS 101B,A01,091572,Allen; Michael Gordon,8,0,65,57
1657046187906,COGS 101C,A01,083625,Delgado; Tania,17,0,35,18
1657046193935,COGS 107A,A01,083627,Boyle; Mary E. T.,13,0,60,47
1657046199961,COGS 118A,A01,083075,Gupta; Anjum,15,0,76,61
1657046205989,CSE 3,A50,083646,Miranda; Gregory Joseph,22,0,50,28
1657046212014,CSE 8A,A50,083650,Miranda; Gregory Joseph,17,1,56,39
1657046218040,CSE 11,A01,083080,Cao; Yingjun,4,15,40,36
1657046224073,CSE 12,A01,083652,Krause-Levy; Sophia Louisa,23,1,120,97
1657046230096,CSE 15L,A01,083654,Morris; Justin Loren,8,0,50,42
1657046230096,CSE 15L,A02,083655,Morris; Justin Loren,9,0,50,41
1657046236130,CSE 20,A01,083657,Tran; Khoa Dang,37,0,80,43
1657046242155,CSE 21,A01,095574,Bach; Quang Tran,21,0,48,27
1657046248252,CSE 30,A01,083084,Eldon; John,4,0,80,76
1657046248252,CSE 30,B01,095061,Bhaskar; Nishant,6,0,50,44
1657046254278,CSE 100,A01,083659,Cao; Yingjun,3,4,70,67
1657046260305,CSE 134B,A01,083661,Powell; Thomas Allan,19,0,100,81
1657046266329,CSE 140,A01,083663,Gungor; Onat,14,0,85,71
1657046272356,CSE 140L,A01,083088,Eldon; John,16,0,100,84
1657046278391,CSE 175,A01,083665,Kumar; Rakesh,3,0,25,22
1657046284428,CSE 190,A00,092507,Dubnov; Shlomo,7,0,20,13
1657046290451,ECE 45,A01,083139,Congero; Spencer William,5,0,75,70
1657046296478,ECE 65,A50,083695,Saad; Andrew S,12,0,30,18
1657046296478,ECE 65,A51,095125,Saad; Andrew S,25,0,26,1
1657046302502,ECE 109,A01,091882,Touri; Behrouz,16,0,70,54
1657046308524,ECE 180,A00,083140,Abi Samra; Nicholas Camill,1,0,30,29
1657046308524,ECE 180,B00,083141,Abi Samra; Nicholas Camill,0,0,30,30
1657046314552,MATH 10A,A01,083735,Patchell; Gregory David,1,0,30,29
1657046314552,MATH 10A,A02,083736,Patchell; Gregory David,20,0,30,10
1657046314552,MATH 10A,A03,083737,Patchell; Gregory David,16,0,30,14
1657046320575,MATH 10B,A01,083207,Lim; Seonhee,7,0,34,27
1657046320575,MATH 10B,A02,083208,Lim; Seonhee,9,0,35,26
1657046320575,MATH 10B,A03,093472,Lim; Seonhee,4,0,34,30
1657046320575,MATH 10B,B01,083739,Sinha; Shubham,9,0,30,21
1657046326603,MATH 18,A01,083743,Cinel; Cameron Alexander,6,0,30,24
1657046326603,MATH 18,A02,083744,Cinel; Cameron Alexander,15,0,30,15
1657046326603,MATH 18,A03,083745,Cinel; Cameron Alexander,8,0,30,22
1657046326603,MATH 18,B01,083748,Rideout; David Porter,4,0,37,33
1657046326603,MATH 18,B02,083749,Rideout; David Porter,3,0,36,33
1657046326603,MATH 18,B03,083750,Rideout; David Porter,2,0,37,35
1657046326603,MATH 18,B04,083751,Rideout; David Porter,5,0,36,31
1657046326603,MATH 18,B05,093473,Rideout; David Porter,4,0,36,32
1657046326603,MATH 18,B06,093474,Rideout; David Porter,5,0,36,31
1657046332625,MATH 20A,A01,083754,Zheng; Zequn,12,0,40,28
1657046338647,MATH 20B,A01,083756,Briones; Jor-el Thomas Caparas,1,0,36,35
1657046338647,MATH 20B,A02,083757,Briones; Jor-el Thomas Caparas,1,0,36,35
1657046338647,MATH 20B,A03,093475,Briones; Jor-el Thomas Caparas,0,0,36,36
1657046344671,MATH 20C,A01,083760,Briones; Jor-el Thomas Caparas,1,0,35,34
1657046344671,MATH 20C,A02,083761,Briones; Jor-el Thomas Caparas,8,0,35,27
1657046344671,MATH 20C,A03,093476,Briones; Jor-el Thomas Caparas,0,1,36,36
1657046344671,MATH 20C,B01,083762,Bach; Quang Tran,0,0,30,30
1657046350694,MATH 20D,A01,083765,Tran; Brian Kha,4,0,30,26
1657046350694,MATH 20D,A02,083766,Tran; Brian Kha,5,0,30,25
1657046350694,MATH 20D,A03,083767,Tran; Brian Kha,3,0,30,27
1657046356728,MATH 20E,A01,083771,Ganguly; Soumya,5,0,32,27
1657046356728,MATH 20E,A02,083772,Ganguly; Soumya,6,0,32,26
1657046356728,MATH 20E,B01,083773,Ciotti; Benjamin,18,0,35,17
1657046356728,MATH 20E,B02,083774,Ciotti; Benjamin,17,0,35,18
1657046362758,MATH 103A,A01,083777,Greenfeld; Be'Eri,2,0,36,34
1657046362758,MATH 103A,A02,083778,Greenfeld; Be'Eri,5,0,36,31
1657046362758,MATH 103A,A03,093561,Greenfeld; Be'Eri,4,0,36,32
1657046362758,MATH 103A,B01,083779,Greenfeld; Be'Eri,6,0,36,30
1657046362758,MATH 103A,B02,083780,Greenfeld; Be'Eri,2,0,36,34
1657046362758,MATH 103A,B03,093562,Greenfeld; Be'Eri,2,0,36,34
1657046368790,MATH 105,A01,085443,Carter; Anne Toulson,14,0,35,21
1657046368790,MATH 105,A02,093477,Carter; Anne Toulson,20,0,35,15
1657046374813,MATH 109,A01,083213,Ganzberger; Geoffrey Michael,2,0,34,32
1657046374813,MATH 109,A02,083214,Ganzberger; Geoffrey Michael,2,0,34,32
1657046374813,MATH 109,A03,093478,Ganzberger; Geoffrey Michael,1,0,34,33
1657046374813,MATH 109,B01,083215,Ganzberger; Geoffrey Michael,1,0,32,31
1657046374813,MATH 109,B02,083216,Ganzberger; Geoffrey Michael,1,0,32,31
1657046374813,MATH 109,B03,093479,Ganzberger; Geoffrey Michael,6,0,32,26
1657046380841,MATH 142A,A01,083219,Chow; Bennett,6,0,32,26
1657046380841,MATH 142A,A02,083220,Chow; Bennett,10,0,32,22
1657046380841,MATH 142A,A03,093480,Chow; Bennett,7,0,32,25
1657046380841,MATH 142A,B03,093481,Chow; Bennett,7,0,32,25
1657046380841,MATH 142A,B04,093558,Chow; Bennett,11,0,32,21
1657046380841,MATH 142A,B05,093559,Chow; Bennett,6,0,32,26
1657046386875,MATH 193A,A01,083224,Rotar; Vladimir,7,0,34,27
1657046386875,MATH 193A,A02,083225,Rotar; Vladimir,5,0,34,29
1657046386875,MATH 193A,A03,083781,Rotar; Vladimir,1,0,34,33
1657046386875,MATH 193A,A04,083782,Rotar; Vladimir,6,0,34,28
1657046386875,MATH 193A,A05,093482,Rotar; Vladimir,6,0,34,28
1657046392899,MATH 197,001,091859,McAuley; Julian John,9999,0,9999,0
1657046392899,MATH 197,002,095566,Kedlaya; Kiran S.,9997,0,9999,2
1657046392899,MATH 197,003,095567,Xiao; Ming,9999,0,9999,0
1657046392899,MATH 197,004,095571,Perols; Johan Lars,9998,0,9999,1
1657046399954,COGS 9,A01,083615,Shannon; Kyle Michael,7,0,75,68
1657046405977,COGS 11,A01,083617,Boyle; Mary E. T.,20,0,48,28
1657046412001,COGS 13,A01,083071,Bastos; Amalia Pinkusfeld,9,0,71,62
1657046418034,COGS 14A,A01,092681,Semenuks; Arturs,0,1,100,100
1657046424063,COGS 14B,A01,083073,Cheng; Tzu-Han,5,0,63,58
1657046430086,COGS 17,A01,092677,Semenuks; Arturs,4,0,81,77
1657046436118,COGS 100,A01,083619,Allen; Michael Gordon,15,0,70,55
1657046442146,COGS 101A,A01,083621,Davis; Joshua Daniel,9,0,68,59
1657046448168,COGS 101B,A01,091572,Allen; Michael Gordon,8,0,65,57
1657046454198,COGS 101C,A01,083625,Delgado; Tania,17,0,35,18
1657046460220,COGS 107A,A01,083627,Boyle; Mary E. T.,13,0,60,47
1657046466242,COGS 118A,A01,083075,Gupta; Anjum,15,0,76,61
1657046472276,CSE 3,A50,083646,Miranda; Gregory Joseph,22,0,50,28
1657046478305,CSE 8A,A50,083650,Miranda; Gregory Joseph,17,1,56,39
1657046484337,CSE 11,A01,083080,Cao; Yingjun,4,15,40,36
1657046490365,CSE 12,A01,083652,Krause-Levy; Sophia Louisa,23,1,120,97
1657046496396,CSE 15L,A01,083654,Morris; Justin Loren,8,0,50,42
1657046496396,CSE 15L,A02,083655,Morris; Justin Loren,9,0,50,41
1657046502419,CSE 20,A01,083657,Tran; Khoa Dang,37,0,80,43
1657046508442,CSE 21,A01,095574,Bach; Quang Tran,21,0,48,27
1657046514468,CSE 30,A01,083084,Eldon; John,4,0,80,76
1657046514468,CSE 30,B01,095061,Bhaskar; Nishant,6,0,50,44
1657046520508,CSE 100,A01,083659,Cao; Yingjun,3,4,70,67
1657046526531,CSE 134B,A01,083661,Powell; Thomas Allan,19,0,100,81
1657046532559,CSE 140,A01,083663,Gungor; Onat,14,0,85,71
1657046538581,CSE 140L,A01,083088,Eldon; John,16,0,100,84
1657046544604,CSE 175,A01,083665,Kumar; Rakesh,3,0,25,22
1657046550627,CSE 190,A00,092507,Dubnov; Shlomo,7,0,20,13
1657046556651,ECE 45,A01,083139,Congero; Spencer William,5,0,75,70
1657046562684,ECE 65,A50,083695,Saad; Andrew S,12,0,30,18
1657046562684,ECE 65,A51,095125,Saad; Andrew S,25,0,26,1
1657046568707,ECE 109,A01,091882,Touri; Behrouz,16,0,70,54
1657046574730,ECE 180,A00,083140,Abi Samra; Nicholas Camill,1,0,30,29
1657046574730,ECE 180,B00,083141,Abi Samra; Nicholas Camill,0,0,30,30
1657046580756,MATH 10A,A01,083735,Patchell; Gregory David,1,0,30,29
1657046580756,MATH 10A,A02,083736,Patchell; Gregory David,20,0,30,10
1657046580756,MATH 10A,A03,083737,Patchell; Gregory David,16,0,30,14
1657046586794,MATH 10B,A01,083207,Lim; Seonhee,7,0,34,27
1657046586794,MATH 10B,A02,083208,Lim; Seonhee,9,0,35,26
1657046586794,MATH 10B,A03,093472,Lim; Seonhee,4,0,34,30
1657046586794,MATH 10B,B01,083739,Sinha; Shubham,9,0,30,21
1657046592823,MATH 18,A01,083743,Cinel; Cameron Alexander,6,0,30,24
1657046592823,MATH 18,A02,083744,Cinel; Cameron Alexander,15,0,30,15
1657046592823,MATH 18,A03,083745,Cinel; Cameron Alexander,8,0,30,22
1657046592823,MATH 18,B01,083748,Rideout; David Porter,4,0,37,33
1657046592823,MATH 18,B02,083749,Rideout; David Porter,3,0,36,33
1657046592823,MATH 18,B03,083750,Rideout; David Porter,2,0,37,35
1657046592823,MATH 18,B04,083751,Rideout; David Porter,5,0,36,31
1657046592823,MATH 18,B05,093473,Rideout; David Porter,4,0,36,32
1657046592823,MATH 18,B06,093474,Rideout; David Porter,5,0,36,31
1657046598855,MATH 20A,A01,083754,Zheng; Zequn,12,0,40,28
1657046604878,MATH 20B,A01,083756,Briones; Jor-el Thomas Caparas,1,0,36,35
1657046604878,MATH 20B,A02,083757,Briones; Jor-el Thomas Caparas,1,0,36,35
1657046604878,MATH 20B,A03,093475,Briones; Jor-el Thomas Caparas,0,0,36,36
1657046610900,MATH 20C,A01,083760,Briones; Jor-el Thomas Caparas,1,0,35,34
1657046610900,MATH 20C,A02,083761,Briones; Jor-el Thomas Caparas,8,0,35,27
1657046610900,MATH 20C,A03,093476,Briones; Jor-el Thomas Caparas,0,1,36,36
1657046610900,MATH 20C,B01,083762,Bach; Quang Tran,0,0,30,30
1657046616928,MATH 20D,A01,083765,Tran; Brian Kha,4,0,30,26
1657046616928,MATH 20D,A02,083766,Tran; Brian Kha,5,0,30,25
1657046616928,MATH 20D,A03,083767,Tran; Brian Kha,3,0,30,27
1657046622955,MATH 20E,A01,083771,Ganguly; Soumya,5,0,32,27
1657046622955,MATH 20E,A02,083772,Ganguly; Soumya,6,0,32,26
1657046622955,MATH 20E,B01,083773,Ciotti; Benjamin,18,0,35,17
1657046622955,MATH 20E,B02,083774,Ciotti; Benjamin,17,0,35,18
1657046628985,MATH 103A,A01,083777,Greenfeld; Be'Eri,2,0,36,34
1657046628985,MATH 103A,A02,083778,Greenfeld; Be'Eri,5,0,36,31
1657046628985,MATH 103A,A03,093561,Greenfeld; Be'Eri,4,0,36,32
1657046628985,MATH 103A,B01,083779,Greenfeld; Be'Eri,6,0,36,30
1657046628985,MATH 103A,B02,083780,Greenfeld; Be'Eri,2,0,36,34
1657046628985,MATH 103A,B03,093562,Greenfeld; Be'Eri,2,0,36,34
1657046635008,MATH 105,A01,085443,Carter; Anne Toulson,14,0,35,21
1657046635008,MATH 105,A02,093477,Carter; Anne Toulson,20,0,35,15
1657046641040,MATH 109,A01,083213,Ganzberger; Geoffrey Michael,2,0,34,32
1657046641040,MATH 109,A02,083214,Ganzberger; Geoffrey Michael,2,0,34,32
1657046641040,MATH 109,A03,093478,Ganzberger; Geoffrey Michael,1,0,34,33
1657046641040,MATH 109,B01,083215,Ganzberger; Geoffrey Michael,1,0,32,31
1657046641040,MATH 109,B02,083216,Ganzberger; Geoffrey Michael,1,0,32,31
1657046641040,MATH 109,B03,093479,Ganzberger; Geoffrey Michael,6,0,32,26
1657046647062,MATH 142A,A01,083219,Chow; Bennett,6,0,32,26
1657046647062,MATH 142A,A02,083220,Chow; Bennett,10,0,32,22
1657046647062,MATH 142A,A03,093480,Chow; Bennett,7,0,32,25
1657046647062,MATH 142A,B03,093481,Chow; Bennett,7,0,32,25
1657046647062,MATH 142A,B04,093558,Chow; Bennett,11,0,32,21
1657046647062,MATH 142A,B05,093559,Chow; Bennett,6,0,32,26
1657046653083,MATH 193A,A01,083224,Rotar; Vladimir,7,0,34,27
1657046653083,MATH 193A,A02,083225,Rotar; Vladimir,5,0,34,29
1657046653083,MATH 193A,A03,083781,Rotar; Vladimir,1,0,34,33
1657046653083,MATH 193A,A04,083782,Rotar; Vladimir,6,0,34,28
1657046653083,MATH 193A,A05,093482,Rotar; Vladimir,6,0,34,28
1657046659106,MATH 197,001,091859,McAuley; Julian John,9999,0,9999,0
1657046659106,MATH 197,002,095566,Kedlaya; Kiran S.,9997,0,9999,2
1657046659106,MATH 197,003,095567,Xiao; Ming,9999,0,9999,0
1657046659106,MATH 197,004,095571,Perols; Johan Lars,9998,0,9999,1
1657046666165,COGS 9,A01,083615,Shannon; Kyle Michael,7,0,75,68
1657046672200,COGS 11,A01,083617,Boyle; Mary E. T.,20,0,48,28
1657046678234,COGS 13,A01,083071,Bastos; Amalia Pinkusfeld,9,0,71,62
1657046684258,COGS 14A,A01,092681,Semenuks; Arturs,0,1,100,100
1657046690285,COGS 14B,A01,083073,Cheng; Tzu-Han,5,0,63,58
1657046696307,COGS 17,A01,092677,Semenuks; Arturs,4,0,81,77
1657046702335,COGS 100,A01,083619,Allen; Michael Gordon,15,0,70,55
1657046708361,COGS 101A,A01,083621,Davis; Joshua Daniel,9,0,68,59
1657046714384,COGS 101B,A01,091572,Allen; Michael Gordon,8,0,65,57
1657046720408,COGS 101C,A01,083625,Delgado; Tania,17,0,35,18
1657046726429,COGS 107A,A01,083627,Boyle; Mary E. T.,13,0,60,47
1657046732452,COGS 118A,A01,083075,Gupta; Anjum,15,0,76,61
1657046738475,CSE 3,A50,083646,Miranda; Gregory Joseph,22,0,50,28
1657046744497,CSE 8A,A50,083650,Miranda; Gregory Joseph,17,1,56,39
1657046750524,CSE 11,A01,083080,Cao; Yingjun,4,15,40,36
1657046756555,CSE 12,A01,083652,Krause-Levy; Sophia Louisa,23,1,120,97
1657046762577,CSE 15L,A01,083654,Morris; Justin Loren,8,0,50,42
1657046762577,CSE 15L,A02,083655,Morris; Justin Loren,9,0,50,41
1657046768604,CSE 20,A01,083657,Tran; Khoa Dang,37,0,80,43
1657046774638,CSE 21,A01,095574,Bach; Quang Tran,21,0,48,27
1657046780665,CSE 30,A01,083084,Eldon; John,4,0,80,76
1657046780665,CSE 30,B01,095061,Bhaskar; Nishant,6,0,50,44
1657046786693,CSE 100,A01,083659,Cao; Yingjun,3,4,70,67
1657046792716,CSE 134B,A01,083661,Powell; Thomas Allan,19,0,100,81
1657046798738,CSE 140,A01,083663,Gungor; Onat,14,0,85,71
1657046804764,CSE 140L,A01,083088,Eldon; John,16,0,100,84
1657046810788,CSE 175,A01,083665,Kumar; Rakesh,3,0,25,22
1657046816811,CSE 190,A00,092507,Dubnov; Shlomo,7,0,20,13
1657046822836,ECE 45,A01,083139,Congero; Spencer William,5,0,75,70
1657046828857,ECE 65,A50,083695,Saad; Andrew S,12,0,30,18
1657046828857,ECE 65,A51,095125,Saad; Andrew S,25,0,26,1
1657046834880,ECE 109,A01,091882,Touri; Behrouz,16,0,70,54
1657046840909,ECE 180,A00,083140,Abi Samra; Nicholas Camill,1,0,30,29
1657046840909,ECE 180,B00,083141,Abi Samra; Nicholas Camill,0,0,30,30
1657046847009,MATH 10A,A01,083735,Patchell; Gregory David,1,0,30,29
1657046847009,MATH 10A,A02,083736,Patchell; Gregory David,20,0,30,10
1657046847009,MATH 10A,A03,083737,Patchell; Gregory David,16,0,30,14
1657046853033,MATH 10B,A01,083207,Lim; Seonhee,7,0,34,27
1657046853033,MATH 10B,A02,083208,Lim; Seonhee,9,0,35,26
1657046853033,MATH 10B,A03,093472,Lim; Seonhee,4,0,34,30
1657046853033,MATH 10B,B01,083739,Sinha; Shubham,9,0,30,21
1657046859059,MATH 18,A01,083743,Cinel; Cameron Alexander,6,0,30,24
1657046859059,MATH 18,A02,083744,Cinel; Cameron Alexander,15,0,30,15
1657046859059,MATH 18,A03,083745,Cinel; Cameron Alexander,8,0,30,22
1657046859059,MATH 18,B01,083748,Rideout; David Porter,4,0,37,33
1657046859059,MATH 18,B02,083749,Rideout; David Porter,3,0,36,33
1657046859059,MATH 18,B03,083750,Rideout; David Porter,2,0,37,35
1657046859059,MATH 18,B04,083751,Rideout; David Porter,5,0,36,31
1657046859059,MATH 18,B05,093473,Rideout; David Porter,4,0,36,32
1657046859059,MATH 18,B06,093474,Rideout; David Porter,5,0,36,31
1657046865083,MATH 20A,A01,083754,Zheng; Zequn,12,0,40,28
1657046871111,MATH 20B,A01,083756,Briones; Jor-el Thomas Caparas,1,0,36,35
1657046871111,MATH 20B,A02,083757,Briones; Jor-el Thomas Caparas,1,0,36,35
1657046871111,MATH 20B,A03,093475,Briones; Jor-el Thomas Caparas,0,0,36,36
1657046877145,MATH 20C,A01,083760,Briones; Jor-el Thomas Caparas,1,0,35,34
1657046877145,MATH 20C,A02,083761,Briones; Jor-el Thomas Caparas,8,0,35,27
1657046877145,MATH 20C,A03,093476,Briones; Jor-el Thomas Caparas,0,1,36,36
1657046877145,MATH 20C,B01,083762,Bach; Quang Tran,0,0,30,30
1657046883170,MATH 20D,A01,083765,Tran; Brian Kha,4,0,30,26
1657046883170,MATH 20D,A02,083766,Tran; Brian Kha,5,0,30,25
1657046883170,MATH 20D,A03,083767,Tran; Brian Kha,3,0,30,27
1657046889198,MATH 20E,A01,083771,Ganguly; Soumya,5,0,32,27
1657046889198,MATH 20E,A02,083772,Ganguly; Soumya,6,0,32,26
1657046889198,MATH 20E,B01,083773,Ciotti; Benjamin,18,0,35,17
1657046889198,MATH 20E,B02,083774,Ciotti; Benjamin,17,0,35,18
1657046895221,MATH 103A,A01,083777,Greenfeld; Be'Eri,2,0,36,34
1657046895221,MATH 103A,A02,083778,Greenfeld; Be'Eri,5,0,36,31
1657046895221,MATH 103A,A03,093561,Greenfeld; Be'Eri,4,0,36,32
1657046895221,MATH 103A,B01,083779,Greenfeld; Be'Eri,6,0,36,30
1657046895221,MATH 103A,B02,083780,Greenfeld; Be'Eri,2,0,36,34
1657046895221,MATH 103A,B03,093562,Greenfeld; Be'Eri,2,0,36,34
1657046901251,MATH 105,A01,085443,Carter; Anne Toulson,14,0,35,21
1657046901251,MATH 105,A02,093477,Carter; Anne Toulson,20,0,35,15
1657046907281,MATH 109,A01,083213,Ganzberger; Geoffrey Michael,2,0,34,32
1657046907281,MATH 109,A02,083214,Ganzberger; Geoffrey Michael,2,0,34,32
1657046907281,MATH 109,A03,093478,Ganzberger; Geoffrey Michael,1,0,34,33
1657046907281,MATH 109,B01,083215,Ganzberger; Geoffrey Michael,1,0,32,31
1657046907281,MATH 109,B02,083216,Ganzberger; Geoffrey Michael,1,0,32,31
1657046907281,MATH 109,B03,093479,Ganzberger; Geoffrey Michael,6,0,32,26
1657046913310,MATH 142A,A01,083219,Chow; Bennett,6,0,32,26
1657046913310,MATH 142A,A02,083220,Chow; Bennett,10,0,32,22
1657046913310,MATH 142A,A03,093480,Chow; Bennett,7,0,32,25
1657046913310,MATH 142A,B03,093481,Chow; Bennett,7,0,32,25
1657046913310,MATH 142A,B04,093558,Chow; Bennett,11,0,32,21
1657046913310,MATH 142A,B05,093559,Chow; Bennett,6,0,32,26
1657046919340,MATH 193A,A01,083224,Rotar; Vladimir,7,0,34,27
1657046919340,MATH 193A,A02,083225,Rotar; Vladimir,5,0,34,29
1657046919340,MATH 193A,A03,083781,Rotar; Vladimir,1,0,34,33
1657046919340,MATH 193A,A04,083782,Rotar; Vladimir,6,0,34,28
1657046919340,MATH 193A,A05,093482,Rotar; Vladimir,6,0,34,28
1657046925365,MATH 197,001,091859,McAuley; Julian John,9999,0,9999,0
1657046925365,MATH 197,002,095566,Kedlaya; Kiran S.,9997,0,9999,2
1657046925365,MATH 197,003,095567,Xiao; Ming,9999,0,9999,0
1657046925365,MATH 197,004,095571,Perols; Johan Lars,9998,0,9999,1
1657046932417,COGS 9,A01,083615,Shannon; Kyle Michael,7,0,75,68
1657046938442,COGS 11,A01,083617,Boyle; Mary E. T.,20,0,48,28
1657046944479,COGS 13,A01,083071,Bastos; Amalia Pinkusfeld,9,0,71,62
1657046950503,COGS 14A,A01,092681,Semenuks; Arturs,0,1,100,100
1657046956531,COGS 14B,A01,083073,Cheng; Tzu-Han,5,0,63,58
1657046962557,COGS 17,A01,092677,Semenuks; Arturs,4,0,81,77
1657046968581,COGS 100,A01,083619,Allen; Michael Gordon,15,0,70,55
1657046974607,COGS 101A,A01,083621,Davis; Joshua Daniel,9,0,68,59
1657046980633,COGS 101B,A01,091572,Allen; Michael Gordon,8,0,65,57
1657046986655,COGS 101C,A01,083625,Delgado; Tania,17,0,35,18
1657046992681,COGS 107A,A01,083627,Boyle; Mary E. T.,13,0,60,47
1657046998719,COGS 118A,A01,083075,Gupta; Anjum,15,0,76,61
1657047004742,CSE 3,A50,083646,Miranda; Gregory Joseph,22,0,50,28
1657047010764,CSE 8A,A50,083650,Miranda; Gregory Joseph,17,1,56,39
1657047016798,CSE 11,A01,083080,Cao; Yingjun,4,15,40,36
1657047022823,CSE 12,A01,083652,Krause-Levy; Sophia Louisa,23,1,120,97
1657047028852,CSE 15L,A01,083654,Morris; Justin Loren,8,0,50,42
1657047028852,CSE 15L,A02,083655,Morris; Justin Loren,9,0,50,41
1657047034874,CSE 20,A01,083657,Tran; Khoa Dang,37,0,80,43
1657047040903,CSE 21,A01,095574,Bach; Quang Tran,21,0,48,27
1657047046942,CSE 30,A01,083084,Eldon; John,4,0,80,76
1657047046942,CSE 30,B01,095061,Bhaskar; Nishant,6,0,50,44
1657047052970,CSE 100,A01,083659,Cao; Yingjun,3,4,70,67
1657047058994,CSE 134B,A01,083661,Powell; Thomas Allan,19,0,100,81
1657047065021,CSE 140,A01,083663,Gungor; Onat,14,0,85,71
1657047071042,CSE 140L,A01,083088,Eldon; John,16,0,100,84
1657047077066,CSE 175,A01,083665,Kumar; Rakesh,3,0,25,22
1657047083088,CSE 190,A00,092507,Dubnov; Shlomo,7,0,20,13
1657047089113,ECE 45,A01,083139,Congero; Spencer William,5,0,75,70
1657047095141,ECE 65,A50,083695,Saad; Andrew S,12,0,30,18
1657047095141,ECE 65,A51,095125,Saad; Andrew S,25,0,26,1
1657047101172,ECE 109,A01,091882,Touri; Behrouz,16,0,70,54
1657047107194,ECE 180,A00,083140,Abi Samra; Nicholas Camill,1,0,30,29
1657047107194,ECE 180,B00,083141,Abi Samra; Nicholas Camill,0,0,30,30
1657047113240,MATH 10A,A01,083735,Patchell; Gregory David,1,0,30,29
1657047113240,MATH 10A,A02,083736,Patchell; Gregory David,20,0,30,10
1657047113240,MATH 10A,A03,083737,Patchell; Gregory David,16,0,30,14
1657047119267,MATH 10B,A01,083207,Lim; Seonhee,7,0,34,27
1657047119267,MATH 10B,A02,083208,Lim; Seonhee,9,0,35,26
1657047119267,MATH 10B,A03,093472,Lim; Seonhee,4,0,34,30
1657047119267,MATH 10B,B01,083739,Sinha; Shubham,9,0,30,21
1657047125295,MATH 18,A01,083743,Cinel; Cameron Alexander,6,0,30,24
1657047125295,MATH 18,A02,083744,Cinel; Cameron Alexander,15,0,30,15
1657047125295,MATH 18,A03,083745,Cinel; Cameron Alexander,8,0,30,22
1657047125295,MATH 18,B01,083748,Rideout; David Porter,4,0,37,33
1657047125295,MATH 18,B02,083749,Rideout; David Porter,3,0,36,33
1657047125295,MATH 18,B03,083750,Rideout; David Porter,2,0,37,35
1657047125295,MATH 18,B04,083751,Rideout; David Porter,5,0,36,31
1657047125295,MATH 18,B05,093473,Rideout; David Porter,4,0,36,32
1657047125295,MATH 18,B06,093474,Rideout; David Porter,5,0,36,31
1657047131329,MATH 20A,A01,083754,Zheng; Zequn,12,0,40,28
1657047137354,MATH 20B,A01,083756,Briones; Jor-el Thomas Caparas,1,0,36,35
1657047137354,MATH 20B,A02,083757,Briones; Jor-el Thomas Caparas,1,0,36,35
1657047137354,MATH 20B,A03,093475,Briones; Jor-el Thomas Caparas,0,0,36,36
1657047143377,MATH 20C,A01,083760,Briones; Jor-el Thomas Caparas,1,0,35,34
1657047143377,MATH 20C,A02,083761,Briones; Jor-el Thomas Caparas,8,0,35,27
1657047143377,MATH 20C,A03,093476,Briones; Jor-el Thomas Caparas,0,1,36,36
1657047143377,MATH 20C,B01,083762,Bach; Quang Tran,0,0,30,30
1657047149401,MATH 20D,A01,083765,Tran; Brian Kha,4,0,30,26
1657047149401,MATH 20D,A02,083766,Tran; Brian Kha,5,0,30,25
1657047149401,MATH 20D,A03,083767,Tran; Brian Kha,3,0,30,27
1657047155427,MATH 20E,A01,083771,Ganguly; Soumya,5,0,32,27
1657047155427,MATH 20E,A02,083772,Ganguly; Soumya,6,0,32,26
1657047155427,MATH 20E,B01,083773,Ciotti; Benjamin,18,0,35,17
1657047155427,MATH 20E,B02,083774,Ciotti; Benjamin,17,0,35,18
1657047161459,MATH 103A,A01,083777,Greenfeld; Be'Eri,2,0,36,34
1657047161459,MATH 103A,A02,083778,Greenfeld; Be'Eri,5,0,36,31
1657047161459,MATH 103A,A03,093561,Greenfeld; Be'Eri,4,0,36,32
1657047161459,MATH 103A,B01,083779,Greenfeld; Be'Eri,6,0,36,30
1657047161459,MATH 103A,B02,083780,Greenfeld; Be'Eri,2,0,36,34
1657047161459,MATH 103A,B03,093562,Greenfeld; Be'Eri,2,0,36,34
1657047167493,MATH 105,A01,085443,Carter; Anne Toulson,14,0,35,21
1657047167493,MATH 105,A02,093477,Carter; Anne Toulson,20,0,35,15
1657047173528,MATH 109,A01,083213,Ganzberger; Geoffrey Michael,2,0,34,32
1657047173528,MATH 109,A02,083214,Ganzberger; Geoffrey Michael,2,0,34,32
1657047173528,MATH 109,A03,093478,Ganzberger; Geoffrey Michael,1,0,34,33
1657047173528,MATH 109,B01,083215,Ganzberger; Geoffrey Michael,1,0,32,31
1657047173528,MATH 109,B02,083216,Ganzberger; Geoffrey Michael,1,0,32,31
1657047173528,MATH 109,B03,093479,Ganzberger; Geoffrey Michael,6,0,32,26
1657047179560,MATH 142A,A01,083219,Chow; Bennett,6,0,32,26
1657047179560,MATH 142A,A02,083220,Chow; Bennett,10,0,32,22
1657047179560,MATH 142A,A03,093480,Chow; Bennett,7,0,32,25
1657047179560,MATH 142A,B03,093481,Chow; Bennett,7,0,32,25
1657047179560,MATH 142A,B04,093558,Chow; Bennett,11,0,32,21
1657047179560,MATH 142A,B05,093559,Chow; Bennett,6,0,32,26
1657047185586,MATH 193A,A01,083224,Rotar; Vladimir,7,0,34,27
1657047185586,MATH 193A,A02,083225,Rotar; Vladimir,5,0,34,29
1657047185586,MATH 193A,A03,083781,Rotar; Vladimir,1,0,34,33
1657047185586,MATH 193A,A04,083782,Rotar; Vladimir,6,0,34,28
1657047185586,MATH 193A,A05,093482,Rotar; Vladimir,6,0,34,28
1657047191620,MATH 197,001,091859,McAuley; Julian John,9999,0,9999,0
1657047191620,MATH 197,002,095566,Kedlaya; Kiran S.,9997,0,9999,2
1657047191620,MATH 197,003,095567,Xiao; Ming,9999,0,9999,0
1657047191620,MATH 197,004,095571,Perols; Johan Lars,9998,0,9999,1
1657047198676,COGS 9,A01,083615,Shannon; Kyle Michael,7,0,75,68
1657047204701,COGS 11,A01,083617,Boyle; Mary E. T.,20,0,48,28
1657047210735,COGS 13,A01,083071,Bastos; Amalia Pinkusfeld,9,0,71,62
1657047216762,COGS 14A,A01,092681,Semenuks; Arturs,0,1,100,100
1657047222800,COGS 14B,A01,083073,Cheng; Tzu-Han,5,0,63,58
1657047228825,COGS 17,A01,092677,Semenuks; Arturs,4,0,81,77
1657047234851,COGS 100,A01,083619,Allen; Michael Gordon,15,0,70,55
1657047240880,COGS 101A,A01,083621,Davis; Joshua Daniel,9,0,68,59
1657047246902,COGS 101B,A01,091572,Allen; Michael Gordon,8,0,65,57
1657047252925,COGS 101C,A01,083625,Delgado; Tania,17,0,35,18
1657047258948,COGS 107A,A01,083627,Boyle; Mary E. T.,13,0,60,47
1657047264969,COGS 118A,A01,083075,Gupta; Anjum,15,0,76,61
1657047270992,CSE 3,A50,083646,Miranda; Gregory Joseph,22,0,50,28
1657047277018,CSE 8A,A50,083650,Miranda; Gregory Joseph,17,1,56,39
1657047283041,CSE 11,A01,083080,Cao; Yingjun,4,15,40,36
1657047289068,CSE 12,A01,083652,Krause-Levy; Sophia Louisa,23,1,120,97
1657047295097,CSE 15L,A01,083654,Morris; Justin Loren,8,0,50,42
1657047295097,CSE 15L,A02,083655,Morris; Justin Loren,9,0,50,41
1657047301126,CSE 20,A01,083657,Tran; Khoa Dang,37,0,80,43
1657047307153,CSE 21,A01,095574,Bach; Quang Tran,21,0,48,27
1657047313176,CSE 30,A01,083084,Eldon; John,4,0,80,76
1657047313176,CSE 30,B01,095061,Bhaskar; Nishant,6,0,50,44
1657047319202,CSE 100,A01,083659,Cao; Yingjun,3,4,70,67
1657047325227,CSE 134B,A01,083661,Powell; Thomas Allan,19,0,100,81
1657047331250,CSE 140,A01,083663,Gungor; Onat,14,0,85,71
1657047337273,CSE 140L,A01,083088,Eldon; John,16,0,100,84
1657047343296,CSE 175,A01,083665,Kumar; Rakesh,3,0,25,22
1657047349321,CSE 190,A00,092507,Dubnov; Shlomo,7,0,20,13
1657047355344,ECE 45,A01,083139,Congero; Spencer William,5,0,75,70
1657047361370,ECE 65,A50,083695,Saad; Andrew S,12,0,30,18
1657047361370,ECE 65,A51,095125,Saad; Andrew S,25,0,26,1
1657047367393,ECE 109,A01,091882,Touri; Behrouz,16,0,70,54
1657047373418,ECE 180,A00,083140,Abi Samra; Nicholas Camill,1,0,30,29
1657047373418,ECE 180,B00,083141,Abi Samra; Nicholas Camill,0,0,30,30
1657047379440,MATH 10A,A01,083735,Patchell; Gregory David,1,0,30,29
1657047379440,MATH 10A,A02,083736,Patchell; Gregory David,20,0,30,10
1657047379440,MATH 10A,A03,083737,Patchell; Gregory David,16,0,30,14
1657047385464,MATH 10B,A01,083207,Lim; Seonhee,7,0,34,27
1657047385464,MATH 10B,A02,083208,Lim; Seonhee,9,0,35,26
1657047385464,MATH 10B,A03,093472,Lim; Seonhee,4,0,34,30
1657047385464,MATH 10B,B01,083739,Sinha; Shubham,9,0,30,21
1657047391488,MATH 18,A01,083743,Cinel; Cameron Alexander,6,0,30,24
1657047391488,MATH 18,A02,083744,Cinel; Cameron Alexander,15,0,30,15
1657047391488,MATH 18,A03,083745,Cinel; Cameron Alexander,8,0,30,22
1657047391488,MATH 18,B01,083748,Rideout; David Porter,4,0,37,33
1657047391488,MATH 18,B02,083749,Rideout; David Porter,3,0,36,33
1657047391488,MATH 18,B03,083750,Rideout; David Porter,2,0,37,35
1657047391488,MATH 18,B04,083751,Rideout; David Porter,5,0,36,31
1657047391488,MATH 18,B05,093473,Rideout; David Porter,4,0,36,32
1657047391488,MATH 18,B06,093474,Rideout; David Porter,5,0,36,31
1657047397515,MATH 20A,A01,083754,Zheng; Zequn,12,0,40,28
1657047403546,MATH 20B,A01,083756,Briones; Jor-el Thomas Caparas,1,0,36,35
1657047403546,MATH 20B,A02,083757,Briones; Jor-el Thomas Caparas,1,0,36,35
1657047403546,MATH 20B,A03,093475,Briones; Jor-el Thomas Caparas,0,0,36,36
1657047409576,MATH 20C,A01,083760,Briones; Jor-el Thomas Caparas,1,0,35,34
1657047409576,MATH 20C,A02,083761,Briones; Jor-el Thomas Caparas,8,0,35,27
1657047409576,MATH 20C,A03,093476,Briones; Jor-el Thomas Caparas,0,1,36,36
1657047409576,MATH 20C,B01,083762,Bach; Quang Tran,0,0,30,30
1657047415599,MATH 20D,A01,083765,Tran; Brian Kha,4,0,30,26
1657047415599,MATH 20D,A02,083766,Tran; Brian Kha,5,0,30,25
1657047415599,MATH 20D,A03,083767,Tran; Brian Kha,3,0,30,27
1657047421629,MATH 20E,A01,083771,Ganguly; Soumya,5,0,32,27
1657047421629,MATH 20E,A02,083772,Ganguly; Soumya,6,0,32,26
1657047421629,MATH 20E,B01,083773,Ciotti; Benjamin,18,0,35,17
1657047421629,MATH 20E,B02,083774,Ciotti; Benjamin,17,0,35,18
1657047427671,MATH 103A,A01,083777,Greenfeld; Be'Eri,2,0,36,34
1657047427671,MATH 103A,A02,083778,Greenfeld; Be'Eri,5,0,36,31
1657047427671,MATH 103A,A03,093561,Greenfeld; Be'Eri,4,0,36,32
1657047427671,MATH 103A,B01,083779,Greenfeld; Be'Eri,6,0,36,30
1657047427671,MATH 103A,B02,083780,Greenfeld; Be'Eri,2,0,36,34
1657047427671,MATH 103A,B03,093562,Greenfeld; Be'Eri,2,0,36,34
1657047433698,MATH 105,A01,085443,Carter; Anne Toulson,14,0,35,21
1657047433698,MATH 105,A02,093477,Carter; Anne Toulson,20,0,35,15
1657047439724,MATH 109,A01,083213,Ganzberger; Geoffrey Michael,2,0,34,32
1657047439724,MATH 109,A02,083214,Ganzberger; Geoffrey Michael,2,0,34,32
1657047439724,MATH 109,A03,093478,Ganzberger; Geoffrey Michael,1,0,34,33
1657047439724,MATH 109,B01,083215,Ganzberger; Geoffrey Michael,1,0,32,31
1657047439724,MATH 109,B02,083216,Ganzberger; Geoffrey Michael,1,0,32,31
1657047439724,MATH 109,B03,093479,Ganzberger; Geoffrey Michael,6,0,32,26
1657047445865,MATH 142A,A01,083219,Chow; Bennett,6,0,32,26
1657047445865,MATH 142A,A02,083220,Chow; Bennett,10,0,32,22
1657047445865,MATH 142A,A03,093480,Chow; Bennett,7,0,32,25
1657047445865,MATH 142A,B03,093481,Chow; Bennett,7,0,32,25
1657047445865,MATH 142A,B04,093558,Chow; Bennett,11,0,32,21
1657047445865,MATH 142A,B05,093559,Chow; Bennett,6,0,32,26
1657047451895,MATH 193A,A01,083224,Rotar; Vladimir,7,0,34,27
1657047451895,MATH 193A,A02,083225,Rotar; Vladimir,5,0,34,29
1657047451895,MATH 193A,A03,083781,Rotar; Vladimir,1,0,34,33
1657047451895,MATH 193A,A04,083782,Rotar; Vladimir,6,0,34,28
1657047451895,MATH 193A,A05,093482,Rotar; Vladimir,6,0,34,28
1657047457921,MATH 197,001,091859,McAuley; Julian John,9999,0,9999,0
1657047457921,MATH 197,002,095566,Kedlaya; Kiran S.,9997,0,9999,2
1657047457921,MATH 197,003,095567,Xiao; Ming,9999,0,9999,0
1657047457921,MATH 197,004,095571,Perols; Johan Lars,9998,0,9999,1
1657047465001,COGS 9,A01,083615,Shannon; Kyle Michael,7,0,75,68
1657047471024,COGS 11,A01,083617,Boyle; Mary E. T.,20,0,48,28
1657047477048,COGS 13,A01,083071,Bastos; Amalia Pinkusfeld,9,0,71,62
1657047483075,COGS 14A,A01,092681,Semenuks; Arturs,0,1,100,100
1657047489106,COGS 14B,A01,083073,Cheng; Tzu-Han,5,0,63,58
1657047495128,COGS 17,A01,092677,Semenuks; Arturs,4,0,81,77
1657047501155,COGS 100,A01,083619,Allen; Michael Gordon,15,0,70,55
1657047507189,COGS 101A,A01,083621,Davis; Joshua Daniel,9,0,68,59
1657047513211,COGS 101B,A01,091572,Allen; Michael Gordon,8,0,65,57
1657047519239,COGS 101C,A01,083625,Delgado; Tania,17,0,35,18
1657047525261,COGS 107A,A01,083627,Boyle; Mary E. T.,13,0,60,47
1657047531299,COGS 118A,A01,083075,Gupta; Anjum,15,0,76,61
1657047537327,CSE 3,A50,083646,Miranda; Gregory Joseph,22,0,50,28
1657047543349,CSE 8A,A50,083650,Miranda; Gregory Joseph,17,1,56,39
1657047549376,CSE 11,A01,083080,Cao; Yingjun,4,15,40,36
1657047555398,CSE 12,A01,083652,Krause-Levy; Sophia Louisa,23,1,120,97
1657047561422,CSE 15L,A01,083654,Morris; Justin Loren,8,0,50,42
1657047561422,CSE 15L,A02,083655,Morris; Justin Loren,9,0,50,41
1657047567445,CSE 20,A01,083657,Tran; Khoa Dang,37,0,80,43
1657047573476,CSE 21,A01,095574,Bach; Quang Tran,21,0,48,27
1657047579518,CSE 30,A01,083084,Eldon; John,4,0,80,76
1657047579518,CSE 30,B01,095061,Bhaskar; Nishant,6,0,50,44
1657047585545,CSE 100,A01,083659,Cao; Yingjun,3,4,70,67
1657047591576,CSE 134B,A01,083661,Powell; Thomas Allan,19,0,100,81
1657047597599,CSE 140,A01,083663,Gungor; Onat,14,0,85,71
1657047603622,CSE 140L,A01,083088,Eldon; John,16,0,100,84
1657047609650,CSE 175,A01,083665,Kumar; Rakesh,3,0,25,22
1657047615677,CSE 190,A00,092507,Dubnov; Shlomo,7,0,20,13
1657047621703,ECE 45,A01,083139,Congero; Spencer William,5,0,75,70
1657047627732,ECE 65,A50,083695,Saad; Andrew S,12,0,30,18
1657047627732,ECE 65,A51,095125,Saad; Andrew S,25,0,26,1
1657047633758,ECE 109,A01,091882,Touri; Behrouz,16,0,70,54
1657047639795,ECE 180,A00,083140,Abi Samra; Nicholas Camill,1,0,30,29
1657047639795,ECE 180,B00,083141,Abi Samra; Nicholas Camill,0,0,30,30
1657047645828,MATH 10A,A01,083735,Patchell; Gregory David,1,0,30,29
1657047645828,MATH 10A,A02,083736,Patchell; Gregory David,20,0,30,10
1657047645828,MATH 10A,A03,083737,Patchell; Gregory David,16,0,30,14
1657047651851,MATH 10B,A01,083207,Lim; Seonhee,7,0,34,27
1657047651851,MATH 10B,A02,083208,Lim; Seonhee,9,0,35,26
1657047651851,MATH 10B,A03,093472,Lim; Seonhee,4,0,34,30
1657047651851,MATH 10B,B01,083739,Sinha; Shubham,9,0,30,21
1657047657878,MATH 18,A01,083743,Cinel; Cameron Alexander,6,0,30,24
1657047657878,MATH 18,A02,083744,Cinel; Cameron Alexander,15,0,30,15
1657047657878,MATH 18,A03,083745,Cinel; Cameron Alexander,8,0,30,22
1657047657878,MATH 18,B01,083748,Rideout; David Porter,4,0,37,33
1657047657878,MATH 18,B02,083749,Rideout; David Porter,3,0,36,33
1657047657878,MATH 18,B03,083750,Rideout; David Porter,2,0,37,35
1657047657878,MATH 18,B04,083751,Rideout; David Porter,5,0,36,31
1657047657878,MATH 18,B05,093473,Rideout; David Porter,4,0,36,32
1657047657878,MATH 18,B06,093474,Rideout; David Porter,5,0,36,31
1657047663904,MATH 20A,A01,083754,Zheng; Zequn,12,0,40,28
1657047669937,MATH 20B,A01,083756,Briones; Jor-el Thomas Caparas,1,0,36,35
1657047669937,MATH 20B,A02,083757,Briones; Jor-el Thomas Caparas,1,0,36,35
1657047669937,MATH 20B,A03,093475,Briones; Jor-el Thomas Caparas,0,0,36,36
1657047675963,MATH 20C,A01,083760,Briones; Jor-el Thomas Caparas,1,0,35,34
1657047675963,MATH 20C,A02,083761,Briones; Jor-el Thomas Caparas,8,0,35,27
1657047675963,MATH 20C,A03,093476,Briones; Jor-el Thomas Caparas,0,1,36,36
1657047675963,MATH 20C,B01,083762,Bach; Quang Tran,0,0,30,30
1657047681986,MATH 20D,A01,083765,Tran; Brian Kha,4,0,30,26
1657047681986,MATH 20D,A02,083766,Tran; Brian Kha,5,0,30,25
1657047681986,MATH 20D,A03,083767,Tran; Brian Kha,3,0,30,27
1657047688010,MATH 20E,A01,083771,Ganguly; Soumya,5,0,32,27
1657047688010,MATH 20E,A02,083772,Ganguly; Soumya,6,0,32,26
1657047688010,MATH 20E,B01,083773,Ciotti; Benjamin,18,0,35,17
1657047688010,MATH 20E,B02,083774,Ciotti; Benjamin,17,0,35,18
1657047694034,MATH 103A,A01,083777,Greenfeld; Be'Eri,2,0,36,34
1657047694034,MATH 103A,A02,083778,Greenfeld; Be'Eri,5,0,36,31
1657047694034,MATH 103A,A03,093561,Greenfeld; Be'Eri,4,0,36,32
1657047694034,MATH 103A,B01,083779,Greenfeld; Be'Eri,6,0,36,30
1657047694034,MATH 103A,B02,083780,Greenfeld; Be'Eri,2,0,36,34
1657047694034,MATH 103A,B03,093562,Greenfeld; Be'Eri,2,0,36,34
1657047700057,MATH 105,A01,085443,Carter; Anne Toulson,14,0,35,21
1657047700057,MATH 105,A02,093477,Carter; Anne Toulson,20,0,35,15
1657047706086,MATH 109,A01,083213,Ganzberger; Geoffrey Michael,2,0,34,32
1657047706086,MATH 109,A02,083214,Ganzberger; Geoffrey Michael,2,0,34,32
1657047706086,MATH 109,A03,093478,Ganzberger; Geoffrey Michael,1,0,34,33
1657047706086,MATH 109,B01,083215,Ganzberger; Geoffrey Michael,1,0,32,31
1657047706086,MATH 109,B02,083216,Ganzberger; Geoffrey Michael,1,0,32,31
1657047706086,MATH 109,B03,093479,Ganzberger; Geoffrey Michael,6,0,32,26
1657047712112,MATH 142A,A01,083219,Chow; Bennett,6,0,32,26
1657047712112,MATH 142A,A02,083220,Chow; Bennett,10,0,32,22
1657047712112,MATH 142A,A03,093480,Chow; Bennett,7,0,32,25
1657047712112,MATH 142A,B03,093481,Chow; Bennett,7,0,32,25
1657047712112,MATH 142A,B04,093558,Chow; Bennett,11,0,32,21
1657047712112,MATH 142A,B05,093559,Chow; Bennett,6,0,32,26
1657047718136,MATH 193A,A01,083224,Rotar; Vladimir,7,0,34,27
1657047718136,MATH 193A,A02,083225,Rotar; Vladimir,5,0,34,29
1657047718136,MATH 193A,A03,083781,Rotar; Vladimir,1,0,34,33
1657047718136,MATH 193A,A04,083782,Rotar; Vladimir,6,0,34,28
1657047718136,MATH 193A,A05,093482,Rotar; Vladimir,6,0,34,28
1657047724165,MATH 197,001,091859,McAuley; Julian John,9999,0,9999,0
1657047724165,MATH 197,002,095566,Kedlaya; Kiran S.,9997,0,9999,2
1657047724165,MATH 197,003,095567,Xiao; Ming,9999,0,9999,0
1657047724165,MATH 197,004,095571,Perols; Johan Lars,9998,0,9999,1
1657047731235,COGS 9,A01,083615,Shannon; Kyle Michael,7,0,75,68
1657047737258,COGS 11,A01,083617,Boyle; Mary E. T.,20,0,48,28
1657047743283,COGS 13,A01,083071,Bastos; Amalia Pinkusfeld,9,0,71,62
1657047749306,COGS 14A,A01,092681,Semenuks; Arturs,0,1,100,100
1657047755333,COGS 14B,A01,083073,Cheng; Tzu-Han,5,0,63,58
1657047761357,COGS 17,A01,092677,Semenuks; Arturs,4,0,81,77
1657047767387,COGS 100,A01,083619,Allen; Michael Gordon,15,0,70,55
1657047773411,COGS 101A,A01,083621,Davis; Joshua Daniel,9,0,68,59
1657047779451,COGS 101B,A01,091572,Allen; Michael Gordon,8,0,65,57
1657047785488,COGS 101C,A01,083625,Delgado; Tania,17,0,35,18
1657047791515,COGS 107A,A01,083627,Boyle; Mary E. T.,13,0,60,47
1657047797545,COGS 118A,A01,083075,Gupta; Anjum,15,0,76,61
1657047803574,CSE 3,A50,083646,Miranda; Gregory Joseph,22,0,50,28
1657047809597,CSE 8A,A50,083650,Miranda; Gregory Joseph,17,1,56,39
1657047815625,CSE 11,A01,083080,Cao; Yingjun,4,15,40,36
1657047821652,CSE 12,A01,083652,Krause-Levy; Sophia Louisa,23,1,120,97
1657047827682,CSE 15L,A01,083654,Morris; Justin Loren,8,0,50,42
1657047827682,CSE 15L,A02,083655,Morris; Justin Loren,9,0,50,41
1657047833706,CSE 20,A01,083657,Tran; Khoa Dang,37,0,80,43
1657047839729,CSE 21,A01,095574,Bach; Quang Tran,21,0,48,27
1657047845751,CSE 30,A01,083084,Eldon; John,4,0,80,76
1657047845751,CSE 30,B01,095061,Bhaskar; Nishant,6,0,50,44
1657047851784,CSE 100,A01,083659,Cao; Yingjun,3,4,70,67
1657047857810,CSE 134B,A01,083661,Powell; Thomas Allan,19,0,100,81
1657047863835,CSE 140,A01,083663,Gungor; Onat,14,0,85,71
1657047869861,CSE 140L,A01,083088,Eldon; John,16,0,100,84
1657047875889,CSE 175,A01,083665,Kumar; Rakesh,3,0,25,22
1657047881921,CSE 190,A00,092507,Dubnov; Shlomo,7,0,20,13
1657047887957,ECE 45,A01,083139,Congero; Spencer William,5,0,75,70
1657047893981,ECE 65,A50,083695,Saad; Andrew S,12,0,30,18
1657047893981,ECE 65,A51,095125,Saad; Andrew S,25,0,26,1
1657047900006,ECE 109,A01,091882,Touri; Behrouz,16,0,70,54
1657047906033,ECE 180,A00,083140,Abi Samra; Nicholas Camill,1,0,30,29
1657047906033,ECE 180,B00,083141,Abi Samra; Nicholas Camill,0,0,30,30
1657047912066,MATH 10A,A01,083735,Patchell; Gregory David,1,0,30,29
1657047912066,MATH 10A,A02,083736,Patchell; Gregory David,20,0,30,10
1657047912066,MATH 10A,A03,083737,Patchell; Gregory David,16,0,30,14
1657047918096,MATH 10B,A01,083207,Lim; Seonhee,7,0,34,27
1657047918096,MATH 10B,A02,083208,Lim; Seonhee,9,0,35,26
1657047918096,MATH 10B,A03,093472,Lim; Seonhee,4,0,34,30
1657047918096,MATH 10B,B01,083739,Sinha; Shubham,9,0,30,21
1657047924126,MATH 18,A01,083743,Cinel; Cameron Alexander,6,0,30,24
1657047924126,MATH 18,A02,083744,Cinel; Cameron Alexander,15,0,30,15
1657047924126,MATH 18,A03,083745,Cinel; Cameron Alexander,8,0,30,22
1657047924126,MATH 18,B01,083748,Rideout; David Porter,4,0,37,33
1657047924126,MATH 18,B02,083749,Rideout; David Porter,3,0,36,33
1657047924126,MATH 18,B03,083750,Rideout; David Porter,2,0,37,35
1657047924126,MATH 18,B04,083751,Rideout; David Porter,5,0,36,31
1657047924126,MATH 18,B05,093473,Rideout; David Porter,4,0,36,32
1657047924126,MATH 18,B06,093474,Rideout; David Porter,5,0,36,31
1657047930150,MATH 20A,A01,083754,Zheng; Zequn,12,0,40,28
1657047936174,MATH 20B,A01,083756,Briones; Jor-el Thomas Caparas,1,0,36,35
1657047936174,MATH 20B,A02,083757,Briones; Jor-el Thomas Caparas,1,0,36,35
1657047936174,MATH 20B,A03,093475,Briones; Jor-el Thomas Caparas,0,0,36,36
1657047942200,MATH 20C,A01,083760,Briones; Jor-el Thomas Caparas,1,0,35,34
1657047942200,MATH 20C,A02,083761,Briones; Jor-el Thomas Caparas,8,0,35,27
1657047942200,MATH 20C,A03,093476,Briones; Jor-el Thomas Caparas,0,1,36,36
1657047942200,MATH 20C,B01,083762,Bach; Quang Tran,0,0,30,30
1657047948240,MATH 20D,A01,083765,Tran; Brian Kha,4,0,30,26
1657047948240,MATH 20D,A02,083766,Tran; Brian Kha,5,0,30,25
1657047948240,MATH 20D,A03,083767,Tran; Brian Kha,3,0,30,27
1657047954268,MATH 20E,A01,083771,Ganguly; Soumya,5,0,32,27
1657047954268,MATH 20E,A02,083772,Ganguly; Soumya,6,0,32,26
1657047954268,MATH 20E,B01,083773,Ciotti; Benjamin,18,0,35,17
1657047954268,MATH 20E,B02,083774,Ciotti; Benjamin,17,0,35,18
1657047960293,MATH 103A,A01,083777,Greenfeld; Be'Eri,2,0,36,34
1657047960293,MATH 103A,A02,083778,Greenfeld; Be'Eri,5,0,36,31
1657047960293,MATH 103A,A03,093561,Greenfeld; Be'Eri,4,0,36,32
1657047960293,MATH 103A,B01,083779,Greenfeld; Be'Eri,6,0,36,30
1657047960293,MATH 103A,B02,083780,Greenfeld; Be'Eri,2,0,36,34
1657047960293,MATH 103A,B03,093562,Greenfeld; Be'Eri,2,0,36,34
1657047966317,MATH 105,A01,085443,Carter; Anne Toulson,14,0,35,21
1657047966317,MATH 105,A02,093477,Carter; Anne Toulson,20,0,35,15
1657047972346,MATH 109,A01,083213,Ganzberger; Geoffrey Michael,2,0,34,32
1657047972346,MATH 109,A02,083214,Ganzberger; Geoffrey Michael,2,0,34,32
1657047972346,MATH 109,A03,093478,Ganzberger; Geoffrey Michael,1,0,34,33
1657047972346,MATH 109,B01,083215,Ganzberger; Geoffrey Michael,1,0,32,31
1657047972346,MATH 109,B02,083216,Ganzberger; Geoffrey Michael,1,0,32,31
1657047972346,MATH 109,B03,093479,Ganzberger; Geoffrey Michael,6,0,32,26
1657047978385,MATH 142A,A01,083219,Chow; Bennett,6,0,32,26
1657047978385,MATH 142A,A02,083220,Chow; Bennett,10,0,32,22
1657047978385,MATH 142A,A03,093480,Chow; Bennett,7,0,32,25
1657047978385,MATH 142A,B03,093481,Chow; Bennett,7,0,32,25
1657047978385,MATH 142A,B04,093558,Chow; Bennett,11,0,32,21
1657047978385,MATH 142A,B05,093559,Chow; Bennett,6,0,32,26
1657047984418,MATH 193A,A01,083224,Rotar; Vladimir,7,0,34,27
1657047984418,MATH 193A,A02,083225,Rotar; Vladimir,5,0,34,29
1657047984418,MATH 193A,A03,083781,Rotar; Vladimir,1,0,34,33
1657047984418,MATH 193A,A04,083782,Rotar; Vladimir,6,0,34,28
1657047984418,MATH 193A,A05,093482,Rotar; Vladimir,6,0,34,28
1657047990443,MATH 197,001,091859,McAuley; Julian John,9999,0,9999,0
1657047990443,MATH 197,002,095566,Kedlaya; Kiran S.,9997,0,9999,2
1657047990443,MATH 197,003,095567,Xiao; Ming,9999,0,9999,0
1657047990443,MATH 197,004,095571,Perols; Johan Lars,9998,0,9999,1
1657047997503,COGS 9,A01,083615,Shannon; Kyle Michael,7,0,75,68
1657048003533,COGS 11,A01,083617,Boyle; Mary E. T.,20,0,48,28
1657048009557,COGS 13,A01,083071,Bastos; Amalia Pinkusfeld,9,0,71,62
1657048015581,COGS 14A,A01,092681,Semenuks; Arturs,0,1,100,100
1657048021617,COGS 14B,A01,083073,Cheng; Tzu-Han,5,0,63,58
1657048027639,COGS 17,A01,092677,Semenuks; Arturs,4,0,81,77
1657048033668,COGS 100,A01,083619,Allen; Michael Gordon,15,0,70,55
1657048039775,COGS 101A,A01,083621,Davis; Joshua Daniel,9,0,68,59
1657048045800,COGS 101B,A01,091572,Allen; Michael Gordon,8,0,65,57
1657048051830,COGS 101C,A01,083625,Delgado; Tania,17,0,35,18
1657048057852,COGS 107A,A01,083627,Boyle; Mary E. T.,13,0,60,47
1657048063877,COGS 118A,A01,083075,Gupta; Anjum,15,0,76,61
1657048069907,CSE 3,A50,083646,Miranda; Gregory Joseph,22,0,50,28
1657048075936,CSE 8A,A50,083650,Miranda; Gregory Joseph,17,1,56,39
1657048081972,CSE 11,A01,083080,Cao; Yingjun,4,15,40,36
1657048088012,CSE 12,A01,083652,Krause-Levy; Sophia Louisa,23,1,120,97
1657048094045,CSE 15L,A01,083654,Morris; Justin Loren,8,0,50,42
1657048094045,CSE 15L,A02,083655,Morris; Justin Loren,9,0,50,41
1657048100078,CSE 20,A01,083657,Tran; Khoa Dang,37,0,80,43
1657048106101,CSE 21,A01,095574,Bach; Quang Tran,21,0,48,27
1657048112127,CSE 30,A01,083084,Eldon; John,4,0,80,76
1657048112127,CSE 30,B01,095061,Bhaskar; Nishant,6,0,50,44
1657048118154,CSE 100,A01,083659,Cao; Yingjun,3,4,70,67
1657048124176,CSE 134B,A01,083661,Powell; Thomas Allan,19,0,100,81
1657048130203,CSE 140,A01,083663,Gungor; Onat,14,0,85,71
1657048136240,CSE 140L,A01,083088,Eldon; John,16,0,100,84
1657048142269,CSE 175,A01,083665,Kumar; Rakesh,3,0,25,22
1657048148304,CSE 190,A00,092507,Dubnov; Shlomo,7,0,20,13
1657048154334,ECE 45,A01,083139,Congero; Spencer William,5,0,75,70
1657048160371,ECE 65,A50,083695,Saad; Andrew S,12,0,30,18
1657048160371,ECE 65,A51,095125,Saad; Andrew S,25,0,26,1
1657048166398,ECE 109,A01,091882,Touri; Behrouz,16,0,70,54
1657048172424,ECE 180,A00,083140,Abi Samra; Nicholas Camill,1,0,30,29
1657048172424,ECE 180,B00,083141,Abi Samra; Nicholas Camill,0,0,30,30
1657048178448,MATH 10A,A01,083735,Patchell; Gregory David,1,0,30,29
1657048178448,MATH 10A,A02,083736,Patchell; Gregory David,20,0,30,10
1657048178448,MATH 10A,A03,083737,Patchell; Gregory David,16,0,30,14
1657048184471,MATH 10B,A01,083207,Lim; Seonhee,7,0,34,27
1657048184471,MATH 10B,A02,083208,Lim; Seonhee,9,0,35,26
1657048184471,MATH 10B,A03,093472,Lim; Seonhee,4,0,34,30
1657048184471,MATH 10B,B01,083739,Sinha; Shubham,9,0,30,21
1657048190504,MATH 18,A01,083743,Cinel; Cameron Alexander,6,0,30,24
1657048190504,MATH 18,A02,083744,Cinel; Cameron Alexander,15,0,30,15
1657048190504,MATH 18,A03,083745,Cinel; Cameron Alexander,8,0,30,22
1657048190504,MATH 18,B01,083748,Rideout; David Porter,4,0,37,33
1657048190504,MATH 18,B02,083749,Rideout; David Porter,3,0,36,33
1657048190504,MATH 18,B03,083750,Rideout; David Porter,2,0,37,35
1657048190504,MATH 18,B04,083751,Rideout; David Porter,5,0,36,31
1657048190504,MATH 18,B05,093473,Rideout; David Porter,4,0,36,32
1657048190504,MATH 18,B06,093474,Rideout; David Porter,5,0,36,31
1657048196532,MATH 20A,A01,083754,Zheng; Zequn,12,0,40,28
1657048202563,MATH 20B,A01,083756,Briones; Jor-el Thomas Caparas,1,0,36,35
1657048202563,MATH 20B,A02,083757,Briones; Jor-el Thomas Caparas,1,0,36,35
1657048202563,MATH 20B,A03,093475,Briones; Jor-el Thomas Caparas,0,0,36,36
1657048208587,MATH 20C,A01,083760,Briones; Jor-el Thomas Caparas,1,0,35,34
1657048208587,MATH 20C,A02,083761,Briones; Jor-el Thomas Caparas,8,0,35,27
1657048208587,MATH 20C,A03,093476,Briones; Jor-el Thomas Caparas,0,1,36,36
1657048208587,MATH 20C,B01,083762,Bach; Quang Tran,0,0,30,30
1657048214611,MATH 20D,A01,083765,Tran; Brian Kha,4,0,30,26
1657048214611,MATH 20D,A02,083766,Tran; Brian Kha,5,0,30,25
1657048214611,MATH 20D,A03,083767,Tran; Brian Kha,3,0,30,27
1657048220636,MATH 20E,A01,083771,Ganguly; Soumya,5,0,32,27
1657048220636,MATH 20E,A02,083772,Ganguly; Soumya,6,0,32,26
1657048220636,MATH 20E,B01,083773,Ciotti; Benjamin,18,0,35,17
1657048220636,MATH 20E,B02,083774,Ciotti; Benjamin,17,0,35,18
1657048226667,MATH 103A,A01,083777,Greenfeld; Be'Eri,2,0,36,34
1657048226667,MATH 103A,A02,083778,Greenfeld; Be'Eri,5,0,36,31
1657048226667,MATH 103A,A03,093561,Greenfeld; Be'Eri,4,0,36,32
1657048226667,MATH 103A,B01,083779,Greenfeld; Be'Eri,6,0,36,30
1657048226667,MATH 103A,B02,083780,Greenfeld; Be'Eri,2,0,36,34
1657048226667,MATH 103A,B03,093562,Greenfeld; Be'Eri,2,0,36,34
1657048232689,MATH 105,A01,085443,Carter; Anne Toulson,14,0,35,21
1657048232689,MATH 105,A02,093477,Carter; Anne Toulson,20,0,35,15
1657048238714,MATH 109,A01,083213,Ganzberger; Geoffrey Michael,2,0,34,32
1657048238714,MATH 109,A02,083214,Ganzberger; Geoffrey Michael,2,0,34,32
1657048238714,MATH 109,A03,093478,Ganzberger; Geoffrey Michael,1,0,34,33
1657048238714,MATH 109,B01,083215,Ganzberger; Geoffrey Michael,1,0,32,31
1657048238714,MATH 109,B02,083216,Ganzberger; Geoffrey Michael,1,0,32,31
1657048238714,MATH 109,B03,093479,Ganzberger; Geoffrey Michael,6,0,32,26
1657048244741,MATH 142A,A01,083219,Chow; Bennett,6,0,32,26
1657048244741,MATH 142A,A02,083220,Chow; Bennett,10,0,32,22
1657048244741,MATH 142A,A03,093480,Chow; Bennett,7,0,32,25
1657048244741,MATH 142A,B03,093481,Chow; Bennett,7,0,32,25
1657048244741,MATH 142A,B04,093558,Chow; Bennett,11,0,32,21
1657048244741,MATH 142A,B05,093559,Chow; Bennett,6,0,32,26
1657048250768,MATH 193A,A01,083224,Rotar; Vladimir,7,0,34,27
1657048250768,MATH 193A,A02,083225,Rotar; Vladimir,5,0,34,29
1657048250768,MATH 193A,A03,083781,Rotar; Vladimir,1,0,34,33
1657048250768,MATH 193A,A04,083782,Rotar; Vladimir,6,0,34,28
1657048250768,MATH 193A,A05,093482,Rotar; Vladimir,6,0,34,28
1657048256796,MATH 197,001,091859,McAuley; Julian John,9999,0,9999,0
1657048256796,MATH 197,002,095566,Kedlaya; Kiran S.,9997,0,9999,2
1657048256796,MATH 197,003,095567,Xiao; Ming,9999,0,9999,0
1657048256796,MATH 197,004,095571,Perols; Johan Lars,9998,0,9999,1
1657048263851,COGS 9,A01,083615,Shannon; Kyle Michael,7,0,75,68
1657048269874,COGS 11,A01,083617,Boyle; Mary E. T.,20,0,48,28
1657048275897,COGS 13,A01,083071,Bastos; Amalia Pinkusfeld,9,0,71,62
1657048281924,COGS 14A,A01,092681,Semenuks; Arturs,0,1,100,100
1657048287959,COGS 14B,A01,083073,Cheng; Tzu-Han,5,0,63,58
1657048293983,COGS 17,A01,092677,Semenuks; Arturs,4,0,81,77
1657048300007,COGS 100,A01,083619,Allen; Michael Gordon,15,0,70,55
1657048306039,COGS 101A,A01,083621,Davis; Joshua Daniel,9,0,68,59
1657048312064,COGS 101B,A01,091572,Allen; Michael Gordon,8,0,65,57
1657048318101,COGS 101C,A01,083625,Delgado; Tania,17,0,35,18
1657048324124,COGS 107A,A01,083627,Boyle; Mary E. T.,13,0,60,47
1657048330150,COGS 118A,A01,083075,Gupta; Anjum,15,0,76,61
1657048336188,CSE 3,A50,083646,Miranda; Gregory Joseph,22,0,50,28
1657048342216,CSE 8A,A50,083650,Miranda; Gregory Joseph,17,1,56,39
1657048348242,CSE 11,A01,083080,Cao; Yingjun,4,15,40,36
1657048354272,CSE 12,A01,083652,Krause-Levy; Sophia Louisa,23,1,120,97
1657048360295,CSE 15L,A01,083654,Morris; Justin Loren,8,0,50,42
1657048360295,CSE 15L,A02,083655,Morris; Justin Loren,9,0,50,41
1657048366319,CSE 20,A01,083657,Tran; Khoa Dang,37,0,80,43
1657048372346,CSE 21,A01,095574,Bach; Quang Tran,21,0,48,27
1657048378369,CSE 30,A01,083084,Eldon; John,4,0,80,76
1657048378369,CSE 30,B01,095061,Bhaskar; Nishant,6,0,50,44
1657048384395,CSE 100,A01,083659,Cao; Yingjun,3,4,70,67
1657048390420,CSE 134B,A01,083661,Powell; Thomas Allan,19,0,100,81
1657048396452,CSE 140,A01,083663,Gungor; Onat,14,0,85,71
1657048402475,CSE 140L,A01,083088,Eldon; John,16,0,100,84
1657048408502,CSE 175,A01,083665,Kumar; Rakesh,3,0,25,22
1657048414525,CSE 190,A00,092507,Dubnov; Shlomo,7,0,20,13
1657048420550,ECE 45,A01,083139,Congero; Spencer William,5,0,75,70
1657048426578,ECE 65,A50,083695,Saad; Andrew S,12,0,30,18
1657048426578,ECE 65,A51,095125,Saad; Andrew S,25,0,26,1
1657048432601,ECE 109,A01,091882,Touri; Behrouz,16,0,70,54
1657048438637,ECE 180,A00,083140,Abi Samra; Nicholas Camill,1,0,30,29
1657048438637,ECE 180,B00,083141,Abi Samra; Nicholas Camill,0,0,30,30
1657048444676,MATH 10A,A01,083735,Patchell; Gregory David,1,0,30,29
1657048444676,MATH 10A,A02,083736,Patchell; Gregory David,20,0,30,10
1657048444676,MATH 10A,A03,083737,Patchell; Gregory David,16,0,30,14
1657048450698,MATH 10B,A01,083207,Lim; Seonhee,7,0,34,27
1657048450698,MATH 10B,A02,083208,Lim; Seonhee,9,0,35,26
1657048450698,MATH 10B,A03,093472,Lim; Seonhee,4,0,34,30
1657048450698,MATH 10B,B01,083739,Sinha; Shubham,9,0,30,21
1657048456724,MATH 18,A01,083743,Cinel; Cameron Alexander,6,0,30,24
1657048456724,MATH 18,A02,083744,Cinel; Cameron Alexander,15,0,30,15
1657048456724,MATH 18,A03,083745,Cinel; Cameron Alexander,8,0,30,22
1657048456724,MATH 18,B01,083748,Rideout; David Porter,4,0,37,33
1657048456724,MATH 18,B02,083749,Rideout; David Porter,3,0,36,33
1657048456724,MATH 18,B03,083750,Rideout; David Porter,2,0,37,35
1657048456724,MATH 18,B04,083751,Rideout; David Porter,5,0,36,31
1657048456724,MATH 18,B05,093473,Rideout; David Porter,4,0,36,32
1657048456724,MATH 18,B06,093474,Rideout; David Porter,5,0,36,31
1657048462748,MATH 20A,A01,083754,Zheng; Zequn,12,0,40,28
1657048468781,MATH 20B,A01,083756,Briones; Jor-el Thomas Caparas,1,0,36,35
1657048468781,MATH 20B,A02,083757,Briones; Jor-el Thomas Caparas,1,0,36,35
1657048468781,MATH 20B,A03,093475,Briones; Jor-el Thomas Caparas,0,0,36,36
1657048474802,MATH 20C,A01,083760,Briones; Jor-el Thomas Caparas,1,0,35,34
1657048474802,MATH 20C,A02,083761,Briones; Jor-el Thomas Caparas,8,0,35,27
1657048474802,MATH 20C,A03,093476,Briones; Jor-el Thomas Caparas,0,1,36,36
1657048474802,MATH 20C,B01,083762,Bach; Quang Tran,0,0,30,30
1657048480833,MATH 20D,A01,083765,Tran; Brian Kha,4,0,30,26
1657048480833,MATH 20D,A02,083766,Tran; Brian Kha,5,0,30,25
1657048480833,MATH 20D,A03,083767,Tran; Brian Kha,3,0,30,27
1657048486873,MATH 20E,A01,083771,Ganguly; Soumya,5,0,32,27
1657048486873,MATH 20E,A02,083772,Ganguly; Soumya,6,0,32,26
1657048486873,MATH 20E,B01,083773,Ciotti; Benjamin,18,0,35,17
1657048486873,MATH 20E,B02,083774,Ciotti; Benjamin,17,0,35,18
1657048492899,MATH 103A,A01,083777,Greenfeld; Be'Eri,2,0,36,34
1657048492899,MATH 103A,A02,083778,Greenfeld; Be'Eri,5,0,36,31
1657048492899,MATH 103A,A03,093561,Greenfeld; Be'Eri,4,0,36,32
1657048492899,MATH 103A,B01,083779,Greenfeld; Be'Eri,6,0,36,30
1657048492899,MATH 103A,B02,083780,Greenfeld; Be'Eri,2,0,36,34
1657048492899,MATH 103A,B03,093562,Greenfeld; Be'Eri,2,0,36,34
1657048498921,MATH 105,A01,085443,Carter; Anne Toulson,14,0,35,21
1657048498921,MATH 105,A02,093477,Carter; Anne Toulson,20,0,35,15
1657048504946,MATH 109,A01,083213,Ganzberger; Geoffrey Michael,2,0,34,32
1657048504946,MATH 109,A02,083214,Ganzberger; Geoffrey Michael,2,0,34,32
1657048504946,MATH 109,A03,093478,Ganzberger; Geoffrey Michael,1,0,34,33
1657048504946,MATH 109,B01,083215,Ganzberger; Geoffrey Michael,1,0,32,31
1657048504946,MATH 109,B02,083216,Ganzberger; Geoffrey Michael,1,0,32,31
1657048504946,MATH 109,B03,093479,Ganzberger; Geoffrey Michael,6,0,32,26
1657048510971,MATH 142A,A01,083219,Chow; Bennett,6,0,32,26
1657048510971,MATH 142A,A02,083220,Chow; Bennett,10,0,32,22
1657048510971,MATH 142A,A03,093480,Chow; Bennett,7,0,32,25
1657048510971,MATH 142A,B03,093481,Chow; Bennett,7,0,32,25
1657048510971,MATH 142A,B04,093558,Chow; Bennett,11,0,32,21
1657048510971,MATH 142A,B05,093559,Chow; Bennett,6,0,32,26
1657048516993,MATH 193A,A01,083224,Rotar; Vladimir,7,0,34,27
1657048516993,MATH 193A,A02,083225,Rotar; Vladimir,5,0,34,29
1657048516993,MATH 193A,A03,083781,Rotar; Vladimir,1,0,34,33
1657048516993,MATH 193A,A04,083782,Rotar; Vladimir,6,0,34,28
1657048516993,MATH 193A,A05,093482,Rotar; Vladimir,6,0,34,28
1657048523021,MATH 197,001,091859,McAuley; Julian John,9999,0,9999,0
1657048523021,MATH 197,002,095566,Kedlaya; Kiran S.,9997,0,9999,2
1657048523021,MATH 197,003,095567,Xiao; Ming,9999,0,9999,0
1657048523021,MATH 197,004,095571,Perols; Johan Lars,9998,0,9999,1
1657048530077,COGS 9,A01,083615,Shannon; Kyle Michael,7,0,75,68
1657048536100,COGS 11,A01,083617,Boyle; Mary E. T.,20,0,48,28
1657048542124,COGS 13,A01,083071,Bastos; Amalia Pinkusfeld,9,0,71,62
1657048548163,COGS 14A,A01,092681,Semenuks; Arturs,0,1,100,100
1657048554185,COGS 14B,A01,083073,Cheng; Tzu-Han,5,0,63,58
1657048560221,COGS 17,A01,092677,Semenuks; Arturs,4,0,81,77
1657048566246,COGS 100,A01,083619,Allen; Michael Gordon,15,0,70,55
1657048572270,COGS 101A,A01,083621,Davis; Joshua Daniel,9,0,68,59
1657048578297,COGS 101B,A01,091572,Allen; Michael Gordon,8,0,65,57
1657048584320,COGS 101C,A01,083625,Delgado; Tania,17,0,35,18
1657048590348,COGS 107A,A01,083627,Boyle; Mary E. T.,13,0,60,47
1657048596382,COGS 118A,A01,083075,Gupta; Anjum,15,0,76,61
1657048602408,CSE 3,A50,083646,Miranda; Gregory Joseph,22,0,50,28
1657048608435,CSE 8A,A50,083650,Miranda; Gregory Joseph,17,1,56,39
1657048614456,CSE 11,A01,083080,Cao; Yingjun,4,15,40,36
1657048620485,CSE 12,A01,083652,Krause-Levy; Sophia Louisa,23,1,120,97
1657048626523,CSE 15L,A01,083654,Morris; Justin Loren,8,0,50,42
1657048626523,CSE 15L,A02,083655,Morris; Justin Loren,9,0,50,41
1657048632547,CSE 20,A01,083657,Tran; Khoa Dang,37,0,80,43
1657048638657,CSE 21,A01,095574,Bach; Quang Tran,21,0,48,27
1657048644689,CSE 30,A01,083084,Eldon; John,4,0,80,76
1657048644689,CSE 30,B01,095061,Bhaskar; Nishant,6,0,50,44
1657048650725,CSE 100,A01,083659,Cao; Yingjun,3,4,70,67
1657048656750,CSE 134B,A01,083661,Powell; Thomas Allan,19,0,100,81
1657048662782,CSE 140,A01,083663,Gungor; Onat,14,0,85,71
1657048668805,CSE 140L,A01,083088,Eldon; John,16,0,100,84
1657048674827,CSE 175,A01,083665,Kumar; Rakesh,3,0,25,22
1657048680850,CSE 190,A00,092507,Dubnov; Shlomo,7,0,20,13
1657048686874,ECE 45,A01,083139,Congero; Spencer William,5,0,75,70
1657048692900,ECE 65,A50,083695,Saad; Andrew S,12,0,30,18
1657048692900,ECE 65,A51,095125,Saad; Andrew S,25,0,26,1
1657048698923,ECE 109,A01,091882,Touri; Behrouz,16,0,70,54
1657048704947,ECE 180,A00,083140,Abi Samra; Nicholas Camill,1,0,30,29
1657048704947,ECE 180,B00,083141,Abi Samra; Nicholas Camill,0,0,30,30
1657048710969,MATH 10A,A01,083735,Patchell; Gregory David,1,0,30,29
1657048710969,MATH 10A,A02,083736,Patchell; Gregory David,20,0,30,10
1657048710969,MATH 10A,A03,083737,Patchell; Gregory David,16,0,30,14
1657048716992,MATH 10B,A01,083207,Lim; Seonhee,7,0,34,27
1657048716992,MATH 10B,A02,083208,Lim; Seonhee,9,0,35,26
1657048716992,MATH 10B,A03,093472,Lim; Seonhee,4,0,34,30
1657048716992,MATH 10B,B01,083739,Sinha; Shubham,9,0,30,21
1657048723020,MATH 18,A01,083743,Cinel; Cameron Alexander,6,0,30,24
1657048723020,MATH 18,A02,083744,Cinel; Cameron Alexander,15,0,30,15
1657048723020,MATH 18,A03,083745,Cinel; Cameron Alexander,8,0,30,22
1657048723020,MATH 18,B01,083748,Rideout; David Porter,4,0,37,33
1657048723020,MATH 18,B02,083749,Rideout; David Porter,3,0,36,33
1657048723020,MATH 18,B03,083750,Rideout; David Porter,2,0,37,35
1657048723020,MATH 18,B04,083751,Rideout; David Porter,5,0,36,31
1657048723020,MATH 18,B05,093473,Rideout; David Porter,4,0,36,32
1657048723020,MATH 18,B06,093474,Rideout; David Porter,5,0,36,31
1657048729047,MATH 20A,A01,083754,Zheng; Zequn,12,0,40,28
1657048735071,MATH 20B,A01,083756,Briones; Jor-el Thomas Caparas,1,0,36,35
1657048735071,MATH 20B,A02,083757,Briones; Jor-el Thomas Caparas,1,0,36,35
1657048735071,MATH 20B,A03,093475,Briones; Jor-el Thomas Caparas,0,0,36,36
1657048741095,MATH 20C,A01,083760,Briones; Jor-el Thomas Caparas,1,0,35,34
1657048741095,MATH 20C,A02,083761,Briones; Jor-el Thomas Caparas,8,0,35,27
1657048741095,MATH 20C,A03,093476,Briones; Jor-el Thomas Caparas,0,1,36,36
1657048741095,MATH 20C,B01,083762,Bach; Quang Tran,0,0,30,30
1657048747119,MATH 20D,A01,083765,Tran; Brian Kha,4,0,30,26
1657048747119,MATH 20D,A02,083766,Tran; Brian Kha,5,0,30,25
1657048747119,MATH 20D,A03,083767,Tran; Brian Kha,3,0,30,27
1657048753140,MATH 20E,A01,083771,Ganguly; Soumya,5,0,32,27
1657048753140,MATH 20E,A02,083772,Ganguly; Soumya,6,0,32,26
1657048753140,MATH 20E,B01,083773,Ciotti; Benjamin,18,0,35,17
1657048753140,MATH 20E,B02,083774,Ciotti; Benjamin,17,0,35,18
1657048759164,MATH 103A,A01,083777,Greenfeld; Be'Eri,2,0,36,34
1657048759164,MATH 103A,A02,083778,Greenfeld; Be'Eri,5,0,36,31
1657048759164,MATH 103A,A03,093561,Greenfeld; Be'Eri,4,0,36,32
1657048759164,MATH 103A,B01,083779,Greenfeld; Be'Eri,6,0,36,30
1657048759164,MATH 103A,B02,083780,Greenfeld; Be'Eri,2,0,36,34
1657048759164,MATH 103A,B03,093562,Greenfeld; Be'Eri,2,0,36,34
1657048765196,MATH 105,A01,085443,Carter; Anne Toulson,14,0,35,21
1657048765196,MATH 105,A02,093477,Carter; Anne Toulson,20,0,35,15
1657048771223,MATH 109,A01,083213,Ganzberger; Geoffrey Michael,2,0,34,32
1657048771223,MATH 109,A02,083214,Ganzberger; Geoffrey Michael,2,0,34,32
1657048771223,MATH 109,A03,093478,Ganzberger; Geoffrey Michael,1,0,34,33
1657048771223,MATH 109,B01,083215,Ganzberger; Geoffrey Michael,1,0,32,31
1657048771223,MATH 109,B02,083216,Ganzberger; Geoffrey Michael,1,0,32,31
1657048771223,MATH 109,B03,093479,Ganzberger; Geoffrey Michael,6,0,32,26
1657048777252,MATH 142A,A01,083219,Chow; Bennett,6,0,32,26
1657048777252,MATH 142A,A02,083220,Chow; Bennett,10,0,32,22
1657048777252,MATH 142A,A03,093480,Chow; Bennett,7,0,32,25
1657048777252,MATH 142A,B03,093481,Chow; Bennett,7,0,32,25
1657048777252,MATH 142A,B04,093558,Chow; Bennett,11,0,32,21
1657048777252,MATH 142A,B05,093559,Chow; Bennett,6,0,32,26
1657048783277,MATH 193A,A01,083224,Rotar; Vladimir,7,0,34,27
1657048783277,MATH 193A,A02,083225,Rotar; Vladimir,5,0,34,29
1657048783277,MATH 193A,A03,083781,Rotar; Vladimir,1,0,34,33
1657048783277,MATH 193A,A04,083782,Rotar; Vladimir,6,0,34,28
1657048783277,MATH 193A,A05,093482,Rotar; Vladimir,6,0,34,28
1657048789299,MATH 197,001,091859,McAuley; Julian John,9999,0,9999,0
1657048789299,MATH 197,002,095566,Kedlaya; Kiran S.,9997,0,9999,2
1657048789299,MATH 197,003,095567,Xiao; Ming,9999,0,9999,0
1657048789299,MATH 197,004,095571,Perols; Johan Lars,9998,0,9999,1
1657048796360,COGS 9,A01,083615,Shannon; Kyle Michael,7,0,75,68
1657048802387,COGS 11,A01,083617,Boyle; Mary E. T.,20,0,48,28
1657048808417,COGS 13,A01,083071,Bastos; Amalia Pinkusfeld,9,0,71,62
1657048814443,COGS 14A,A01,092681,Semenuks; Arturs,0,1,100,100
1657048820465,COGS 14B,A01,083073,Cheng; Tzu-Han,5,0,63,58
1657048826490,COGS 17,A01,092677,Semenuks; Arturs,4,0,81,77
1657048832514,COGS 100,A01,083619,Allen; Michael Gordon,15,0,70,55
1657048838538,COGS 101A,A01,083621,Davis; Joshua Daniel,9,0,68,59
1657048844561,COGS 101B,A01,091572,Allen; Michael Gordon,8,0,65,57
1657048850583,COGS 101C,A01,083625,Delgado; Tania,17,0,35,18
1657048856617,COGS 107A,A01,083627,Boyle; Mary E. T.,13,0,60,47
1657048862646,COGS 118A,A01,083075,Gupta; Anjum,15,0,76,61
1657048868667,CSE 3,A50,083646,Miranda; Gregory Joseph,22,0,50,28
1657048874696,CSE 8A,A50,083650,Miranda; Gregory Joseph,17,1,56,39
1657048880721,CSE 11,A01,083080,Cao; Yingjun,4,15,40,36
1657048886749,CSE 12,A01,083652,Krause-Levy; Sophia Louisa,23,1,120,97
1657048892774,CSE 15L,A01,083654,Morris; Justin Loren,8,0,50,42
1657048892774,CSE 15L,A02,083655,Morris; Justin Loren,9,0,50,41
1657048898808,CSE 20,A01,083657,Tran; Khoa Dang,37,0,80,43
1657048904831,CSE 21,A01,095574,Bach; Quang Tran,21,0,48,27
1657048910858,CSE 30,A01,083084,Eldon; John,4,0,80,76
1657048910858,CSE 30,B01,095061,Bhaskar; Nishant,6,0,50,44
1657048916884,CSE 100,A01,083659,Cao; Yingjun,3,4,70,67
1657048922914,CSE 134B,A01,083661,Powell; Thomas Allan,19,0,100,81
1657048928943,CSE 140,A01,083663,Gungor; Onat,14,0,85,71
1657048934968,CSE 140L,A01,083088,Eldon; John,16,0,100,84
1657048941000,CSE 175,A01,083665,Kumar; Rakesh,3,0,25,22
1657048947021,CSE 190,A00,092507,Dubnov; Shlomo,7,0,20,13
1657048953044,ECE 45,A01,083139,Congero; Spencer William,5,0,75,70
1657048959072,ECE 65,A50,083695,Saad; Andrew S,12,0,30,18
1657048959072,ECE 65,A51,095125,Saad; Andrew S,25,0,26,1
1657048965100,ECE 109,A01,091882,Touri; Behrouz,16,0,70,54
1657048971122,ECE 180,A00,083140,Abi Samra; Nicholas Camill,1,0,30,29
1657048971122,ECE 180,B00,083141,Abi Samra; Nicholas Camill,0,0,30,30
1657048977152,MATH 10A,A01,083735,Patchell; Gregory David,1,0,30,29
1657048977152,MATH 10A,A02,083736,Patchell; Gregory David,20,0,30,10
1657048977152,MATH 10A,A03,083737,Patchell; Gregory David,16,0,30,14
1657048983176,MATH 10B,A01,083207,Lim; Seonhee,7,0,34,27
1657048983176,MATH 10B,A02,083208,Lim; Seonhee,9,0,35,26
1657048983176,MATH 10B,A03,093472,Lim; Seonhee,4,0,34,30
1657048983176,MATH 10B,B01,083739,Sinha; Shubham,9,0,30,21
1657048989200,MATH 18,A01,083743,Cinel; Cameron Alexander,6,0,30,24
1657048989200,MATH 18,A02,083744,Cinel; Cameron Alexander,15,0,30,15
1657048989200,MATH 18,A03,083745,Cinel; Cameron Alexander,8,0,30,22
1657048989200,MATH 18,B01,083748,Rideout; David Porter,4,0,37,33
1657048989200,MATH 18,B02,083749,Rideout; David Porter,3,0,36,33
1657048989200,MATH 18,B03,083750,Rideout; David Porter,2,0,37,35
1657048989200,MATH 18,B04,083751,Rideout; David Porter,5,0,36,31
1657048989200,MATH 18,B05,093473,Rideout; David Porter,4,0,36,32
1657048989200,MATH 18,B06,093474,Rideout; David Porter,5,0,36,31
1657048995226,MATH 20A,A01,083754,Zheng; Zequn,12,0,40,28
1657049001255,MATH 20B,A01,083756,Briones; Jor-el Thomas Caparas,1,0,36,35
1657049001255,MATH 20B,A02,083757,Briones; Jor-el Thomas Caparas,1,0,36,35
1657049001255,MATH 20B,A03,093475,Briones; Jor-el Thomas Caparas,0,0,36,36
1657049007295,MATH 20C,A01,083760,Briones; Jor-el Thomas Caparas,1,0,35,34
1657049007295,MATH 20C,A02,083761,Briones; Jor-el Thomas Caparas,8,0,35,27
1657049007295,MATH 20C,A03,093476,Briones; Jor-el Thomas Caparas,0,1,36,36
1657049007295,MATH 20C,B01,083762,Bach; Quang Tran,0,0,30,30
1657049013323,MATH 20D,A01,083765,Tran; Brian Kha,4,0,30,26
1657049013323,MATH 20D,A02,083766,Tran; Brian Kha,5,0,30,25
1657049013323,MATH 20D,A03,083767,Tran; Brian Kha,3,0,30,27
1657049019347,MATH 20E,A01,083771,Ganguly; Soumya,5,0,32,27
1657049019347,MATH 20E,A02,083772,Ganguly; Soumya,6,0,32,26
1657049019347,MATH 20E,B01,083773,Ciotti; Benjamin,18,0,35,17
1657049019347,MATH 20E,B02,083774,Ciotti; Benjamin,17,0,35,18
1657049025369,MATH 103A,A01,083777,Greenfeld; Be'Eri,2,0,36,34
1657049025369,MATH 103A,A02,083778,Greenfeld; Be'Eri,5,0,36,31
1657049025369,MATH 103A,A03,093561,Greenfeld; Be'Eri,4,0,36,32
1657049025369,MATH 103A,B01,083779,Greenfeld; Be'Eri,6,0,36,30
1657049025369,MATH 103A,B02,083780,Greenfeld; Be'Eri,2,0,36,34
1657049025369,MATH 103A,B03,093562,Greenfeld; Be'Eri,2,0,36,34
1657049031404,MATH 105,A01,085443,Carter; Anne Toulson,14,0,35,21
1657049031404,MATH 105,A02,093477,Carter; Anne Toulson,20,0,35,15
1657049037434,MATH 109,A01,083213,Ganzberger; Geoffrey Michael,2,0,34,32
1657049037434,MATH 109,A02,083214,Ganzberger; Geoffrey Michael,2,0,34,32
1657049037434,MATH 109,A03,093478,Ganzberger; Geoffrey Michael,1,0,34,33
1657049037434,MATH 109,B01,083215,Ganzberger; Geoffrey Michael,1,0,32,31
1657049037434,MATH 109,B02,083216,Ganzberger; Geoffrey Michael,1,0,32,31
1657049037434,MATH 109,B03,093479,Ganzberger; Geoffrey Michael,6,0,32,26
1657049043474,MATH 142A,A01,083219,Chow; Bennett,6,0,32,26
1657049043474,MATH 142A,A02,083220,Chow; Bennett,10,0,32,22
1657049043474,MATH 142A,A03,093480,Chow; Bennett,7,0,32,25
1657049043474,MATH 142A,B03,093481,Chow; Bennett,7,0,32,25
1657049043474,MATH 142A,B04,093558,Chow; Bennett,11,0,32,21
1657049043474,MATH 142A,B05,093559,Chow; Bennett,6,0,32,26
1657049049502,MATH 193A,A01,083224,Rotar; Vladimir,7,0,34,27
1657049049502,MATH 193A,A02,083225,Rotar; Vladimir,5,0,34,29
1657049049502,MATH 193A,A03,083781,Rotar; Vladimir,1,0,34,33
1657049049502,MATH 193A,A04,083782,Rotar; Vladimir,6,0,34,28
1657049049502,MATH 193A,A05,093482,Rotar; Vladimir,6,0,34,28
1657049055540,MATH 197,001,091859,McAuley; Julian John,9999,0,9999,0
1657049055540,MATH 197,002,095566,Kedlaya; Kiran S.,9997,0,9999,2
1657049055540,MATH 197,003,095567,Xiao; Ming,9999,0,9999,0
1657049055540,MATH 197,004,095571,Perols; Johan Lars,9998,0,9999,1
1657049062614,COGS 9,A01,083615,Shannon; Kyle Michael,7,0,75,68
1657049068648,COGS 11,A01,083617,Boyle; Mary E. T.,20,0,48,28
1657049074673,COGS 13,A01,083071,Bastos; Amalia Pinkusfeld,9,0,71,62
1657049080698,COGS 14A,A01,092681,Semenuks; Arturs,0,1,100,100
1657049086722,COGS 14B,A01,083073,Cheng; Tzu-Han,5,0,63,58
1657049092749,COGS 17,A01,092677,Semenuks; Arturs,4,0,81,77
1657049098776,COGS 100,A01,083619,Allen; Michael Gordon,15,0,70,55
1657049104807,COGS 101A,A01,083621,Davis; Joshua Daniel,9,0,68,59
1657049110829,COGS 101B,A01,091572,Allen; Michael Gordon,8,0,65,57
1657049116853,COGS 101C,A01,083625,Delgado; Tania,17,0,35,18
1657049122876,COGS 107A,A01,083627,Boyle; Mary E. T.,13,0,60,47
1657049128898,COGS 118A,A01,083075,Gupta; Anjum,15,0,76,61
1657049134925,CSE 3,A50,083646,Miranda; Gregory Joseph,22,0,50,28
1657049140951,CSE 8A,A50,083650,Miranda; Gregory Joseph,17,1,56,39
1657049146976,CSE 11,A01,083080,Cao; Yingjun,4,15,40,36
1657049153005,CSE 12,A01,083652,Krause-Levy; Sophia Louisa,23,1,120,97
1657049159028,CSE 15L,A01,083654,Morris; Justin Loren,8,0,50,42
1657049159028,CSE 15L,A02,083655,Morris; Justin Loren,9,0,50,41
1657049165060,CSE 20,A01,083657,Tran; Khoa Dang,37,0,80,43
1657049171082,CSE 21,A01,095574,Bach; Quang Tran,21,0,48,27
1657049177105,CSE 30,A01,083084,Eldon; John,4,0,80,76
1657049177105,CSE 30,B01,095061,Bhaskar; Nishant,6,0,50,44
1657049183139,CSE 100,A01,083659,Cao; Yingjun,3,4,70,67
1657049189186,CSE 134B,A01,083661,Powell; Thomas Allan,19,0,100,81
1657049195212,CSE 140,A01,083663,Gungor; Onat,14,0,85,71
1657049201237,CSE 140L,A01,083088,Eldon; John,16,0,100,84
1657049207263,CSE 175,A01,083665,Kumar; Rakesh,3,0,25,22
1657049213285,CSE 190,A00,092507,Dubnov; Shlomo,7,0,20,13
1657049219312,ECE 45,A01,083139,Congero; Spencer William,5,0,75,70
1657049225342,ECE 65,A50,083695,Saad; Andrew S,12,0,30,18
1657049225342,ECE 65,A51,095125,Saad; Andrew S,25,0,26,1
1657049231369,ECE 109,A01,091882,Touri; Behrouz,16,0,70,54
1657049237464,ECE 180,A00,083140,Abi Samra; Nicholas Camill,1,0,30,29
1657049237464,ECE 180,B00,083141,Abi Samra; Nicholas Camill,0,0,30,30
1657049243496,MATH 10A,A01,083735,Patchell; Gregory David,1,0,30,29
1657049243496,MATH 10A,A02,083736,Patchell; Gregory David,20,0,30,10
1657049243496,MATH 10A,A03,083737,Patchell; Gregory David,16,0,30,14
1657049249523,MATH 10B,A01,083207,Lim; Seonhee,7,0,34,27
1657049249523,MATH 10B,A02,083208,Lim; Seonhee,9,0,35,26
1657049249523,MATH 10B,A03,093472,Lim; Seonhee,4,0,34,30
1657049249523,MATH 10B,B01,083739,Sinha; Shubham,9,0,30,21
1657049255555,MATH 18,A01,083743,Cinel; Cameron Alexander,6,0,30,24
1657049255555,MATH 18,A02,083744,Cinel; Cameron Alexander,15,0,30,15
1657049255555,MATH 18,A03,083745,Cinel; Cameron Alexander,8,0,30,22
1657049255555,MATH 18,B01,083748,Rideout; David Porter,4,0,37,33
1657049255555,MATH 18,B02,083749,Rideout; David Porter,3,0,36,33
1657049255555,MATH 18,B03,083750,Rideout; David Porter,2,0,37,35
1657049255555,MATH 18,B04,083751,Rideout; David Porter,5,0,36,31
1657049255555,MATH 18,B05,093473,Rideout; David Porter,4,0,36,32
1657049255555,MATH 18,B06,093474,Rideout; David Porter,5,0,36,31
1657049261578,MATH 20A,A01,083754,Zheng; Zequn,12,0,40,28
1657049267601,MATH 20B,A01,083756,Briones; Jor-el Thomas Caparas,1,0,36,35
1657049267601,MATH 20B,A02,083757,Briones; Jor-el Thomas Caparas,1,0,36,35
1657049267601,MATH 20B,A03,093475,Briones; Jor-el Thomas Caparas,0,0,36,36
1657049273625,MATH 20C,A01,083760,Briones; Jor-el Thomas Caparas,1,0,35,34
1657049273625,MATH 20C,A02,083761,Briones; Jor-el Thomas Caparas,8,0,35,27
1657049273625,MATH 20C,A03,093476,Briones; Jor-el Thomas Caparas,0,1,36,36
1657049273625,MATH 20C,B01,083762,Bach; Quang Tran,0,0,30,30
1657049279654,MATH 20D,A01,083765,Tran; Brian Kha,4,0,30,26
1657049279654,MATH 20D,A02,083766,Tran; Brian Kha,5,0,30,25
1657049279654,MATH 20D,A03,083767,Tran; Brian Kha,3,0,30,27
1657049285677,MATH 20E,A01,083771,Ganguly; Soumya,5,0,32,27
1657049285677,MATH 20E,A02,083772,Ganguly; Soumya,6,0,32,26
1657049285677,MATH 20E,B01,083773,Ciotti; Benjamin,18,0,35,17
1657049285677,MATH 20E,B02,083774,Ciotti; Benjamin,17,0,35,18
1657049291705,MATH 103A,A01,083777,Greenfeld; Be'Eri,2,0,36,34
1657049291705,MATH 103A,A02,083778,Greenfeld; Be'Eri,5,0,36,31
1657049291705,MATH 103A,A03,093561,Greenfeld; Be'Eri,4,0,36,32
1657049291705,MATH 103A,B01,083779,Greenfeld; Be'Eri,6,0,36,30
1657049291705,MATH 103A,B02,083780,Greenfeld; Be'Eri,2,0,36,34
1657049291705,MATH 103A,B03,093562,Greenfeld; Be'Eri,2,0,36,34
1657049297736,MATH 105,A01,085443,Carter; Anne Toulson,14,0,35,21
1657049297736,MATH 105,A02,093477,Carter; Anne Toulson,20,0,35,15
1657049303771,MATH 109,A01,083213,Ganzberger; Geoffrey Michael,2,0,34,32
1657049303771,MATH 109,A02,083214,Ganzberger; Geoffrey Michael,2,0,34,32
1657049303771,MATH 109,A03,093478,Ganzberger; Geoffrey Michael,1,0,34,33
1657049303771,MATH 109,B01,083215,Ganzberger; Geoffrey Michael,1,0,32,31
1657049303771,MATH 109,B02,083216,Ganzberger; Geoffrey Michael,1,0,32,31
1657049303771,MATH 109,B03,093479,Ganzberger; Geoffrey Michael,6,0,32,26
1657049309799,MATH 142A,A01,083219,Chow; Bennett,6,0,32,26
1657049309799,MATH 142A,A02,083220,Chow; Bennett,10,0,32,22
1657049309799,MATH 142A,A03,093480,Chow; Bennett,7,0,32,25
1657049309799,MATH 142A,B03,093481,Chow; Bennett,7,0,32,25
1657049309799,MATH 142A,B04,093558,Chow; Bennett,11,0,32,21
1657049309799,MATH 142A,B05,093559,Chow; Bennett,6,0,32,26
1657049315827,MATH 193A,A01,083224,Rotar; Vladimir,7,0,34,27
1657049315827,MATH 193A,A02,083225,Rotar; Vladimir,5,0,34,29
1657049315827,MATH 193A,A03,083781,Rotar; Vladimir,1,0,34,33
1657049315827,MATH 193A,A04,083782,Rotar; Vladimir,6,0,34,28
1657049315827,MATH 193A,A05,093482,Rotar; Vladimir,6,0,34,28
1657049321854,MATH 197,001,091859,McAuley; Julian John,9999,0,9999,0
1657049321854,MATH 197,002,095566,Kedlaya; Kiran S.,9997,0,9999,2
1657049321854,MATH 197,003,095567,Xiao; Ming,9999,0,9999,0
1657049321854,MATH 197,004,095571,Perols; Johan Lars,9998,0,9999,1
1657049328905,COGS 9,A01,083615,Shannon; Kyle Michael,7,0,75,68
1657049334928,COGS 11,A01,083617,Boyle; Mary E. T.,20,0,48,28
1657049340950,COGS 13,A01,083071,Bastos; Amalia Pinkusfeld,9,0,71,62
1657049346976,COGS 14A,A01,092681,Semenuks; Arturs,0,1,100,100
1657049352997,COGS 14B,A01,083073,Cheng; Tzu-Han,5,0,63,58
1657049359019,COGS 17,A01,092677,Semenuks; Arturs,4,0,81,77
1657049365043,COGS 100,A01,083619,Allen; Michael Gordon,15,0,70,55
1657049371070,COGS 101A,A01,083621,Davis; Joshua Daniel,9,0,68,59
1657049377104,COGS 101B,A01,091572,Allen; Michael Gordon,8,0,65,57
1657049383131,COGS 101C,A01,083625,Delgado; Tania,17,0,35,18
1657049389152,COGS 107A,A01,083627,Boyle; Mary E. T.,13,0,60,47
1657049395178,COGS 118A,A01,083075,Gupta; Anjum,15,0,76,61
1657049401205,CSE 3,A50,083646,Miranda; Gregory Joseph,22,0,50,28
1657049407235,CSE 8A,A50,083650,Miranda; Gregory Joseph,17,1,56,39
1657049413259,CSE 11,A01,083080,Cao; Yingjun,4,15,40,36
1657049419293,CSE 12,A01,083652,Krause-Levy; Sophia Louisa,23,1,120,97
1657049425321,CSE 15L,A01,083654,Morris; Justin Loren,8,0,50,42
1657049425321,CSE 15L,A02,083655,Morris; Justin Loren,9,0,50,41
1657049431346,CSE 20,A01,083657,Tran; Khoa Dang,37,0,80,43
1657049437376,CSE 21,A01,095574,Bach; Quang Tran,21,0,48,27
1657049443404,CSE 30,A01,083084,Eldon; John,4,0,80,76
1657049443404,CSE 30,B01,095061,Bhaskar; Nishant,6,0,50,44
1657049449440,CSE 100,A01,083659,Cao; Yingjun,3,4,70,67
1657049455465,CSE 134B,A01,083661,Powell; Thomas Allan,19,0,100,81
1657049461492,CSE 140,A01,083663,Gungor; Onat,14,0,85,71
1657049467522,CSE 140L,A01,083088,Eldon; John,16,0,100,84
1657049473545,CSE 175,A01,083665,Kumar; Rakesh,3,0,25,22
1657049479566,CSE 190,A00,092507,Dubnov; Shlomo,7,0,20,13
1657049485591,ECE 45,A01,083139,Congero; Spencer William,5,0,75,70
1657049491616,ECE 65,A50,083695,Saad; Andrew S,12,0,30,18
1657049491616,ECE 65,A51,095125,Saad; Andrew S,25,0,26,1
1657049497642,ECE 109,A01,091882,Touri; Behrouz,16,0,70,54
1657049503663,ECE 180,A00,083140,Abi Samra; Nicholas Camill,1,0,30,29
1657049503663,ECE 180,B00,083141,Abi Samra; Nicholas Camill,0,0,30,30
1657049509690,MATH 10A,A01,083735,Patchell; Gregory David,1,0,30,29
1657049509690,MATH 10A,A02,083736,Patchell; Gregory David,20,0,30,10
1657049509690,MATH 10A,A03,083737,Patchell; Gregory David,16,0,30,14
1657049515730,MATH 10B,A01,083207,Lim; Seonhee,7,0,34,27
1657049515730,MATH 10B,A02,083208,Lim; Seonhee,9,0,35,26
1657049515730,MATH 10B,A03,093472,Lim; Seonhee,4,0,34,30
1657049515730,MATH 10B,B01,083739,Sinha; Shubham,9,0,30,21
1657049521760,MATH 18,A01,083743,Cinel; Cameron Alexander,6,0,30,24
1657049521760,MATH 18,A02,083744,Cinel; Cameron Alexander,15,0,30,15
1657049521760,MATH 18,A03,083745,Cinel; Cameron Alexander,8,0,30,22
1657049521760,MATH 18,B01,083748,Rideout; David Porter,4,0,37,33
1657049521760,MATH 18,B02,083749,Rideout; David Porter,3,0,36,33
1657049521760,MATH 18,B03,083750,Rideout; David Porter,2,0,37,35
1657049521760,MATH 18,B04,083751,Rideout; David Porter,5,0,36,31
1657049521760,MATH 18,B05,093473,Rideout; David Porter,4,0,36,32
1657049521760,MATH 18,B06,093474,Rideout; David Porter,5,0,36,31
1657049527783,MATH 20A,A01,083754,Zheng; Zequn,12,0,40,28
1657049533809,MATH 20B,A01,083756,Briones; Jor-el Thomas Caparas,1,0,36,35
1657049533809,MATH 20B,A02,083757,Briones; Jor-el Thomas Caparas,1,0,36,35
1657049533809,MATH 20B,A03,093475,Briones; Jor-el Thomas Caparas,0,0,36,36
1657049539844,MATH 20C,A01,083760,Briones; Jor-el Thomas Caparas,1,0,35,34
1657049539844,MATH 20C,A02,083761,Briones; Jor-el Thomas Caparas,8,0,35,27
1657049539844,MATH 20C,A03,093476,Briones; Jor-el Thomas Caparas,0,1,36,36
1657049539844,MATH 20C,B01,083762,Bach; Quang Tran,0,0,30,30
1657049545875,MATH 20D,A01,083765,Tran; Brian Kha,4,0,30,26
1657049545875,MATH 20D,A02,083766,Tran; Brian Kha,5,0,30,25
1657049545875,MATH 20D,A03,083767,Tran; Brian Kha,3,0,30,27
1657049551901,MATH 20E,A01,083771,Ganguly; Soumya,5,0,32,27
1657049551901,MATH 20E,A02,083772,Ganguly; Soumya,6,0,32,26
1657049551901,MATH 20E,B01,083773,Ciotti; Benjamin,18,0,35,17
1657049551901,MATH 20E,B02,083774,Ciotti; Benjamin,17,0,35,18
1657049557932,MATH 103A,A01,083777,Greenfeld; Be'Eri,2,0,36,34
1657049557932,MATH 103A,A02,083778,Greenfeld; Be'Eri,5,0,36,31
1657049557932,MATH 103A,A03,093561,Greenfeld; Be'Eri,4,0,36,32
1657049557932,MATH 103A,B01,083779,Greenfeld; Be'Eri,6,0,36,30
1657049557932,MATH 103A,B02,083780,Greenfeld; Be'Eri,2,0,36,34
1657049557932,MATH 103A,B03,093562,Greenfeld; Be'Eri,2,0,36,34
1657049563964,MATH 105,A01,085443,Carter; Anne Toulson,14,0,35,21
1657049563964,MATH 105,A02,093477,Carter; Anne Toulson,20,0,35,15
1657049569992,MATH 109,A01,083213,Ganzberger; Geoffrey Michael,2,0,34,32
1657049569992,MATH 109,A02,083214,Ganzberger; Geoffrey Michael,2,0,34,32
1657049569992,MATH 109,A03,093478,Ganzberger; Geoffrey Michael,1,0,34,33
1657049569992,MATH 109,B01,083215,Ganzberger; Geoffrey Michael,1,0,32,31
1657049569992,MATH 109,B02,083216,Ganzberger; Geoffrey Michael,1,0,32,31
1657049569992,MATH 109,B03,093479,Ganzberger; Geoffrey Michael,6,0,32,26
1657049576015,MATH 142A,A01,083219,Chow; Bennett,6,0,32,26
1657049576015,MATH 142A,A02,083220,Chow; Bennett,10,0,32,22
1657049576015,MATH 142A,A03,093480,Chow; Bennett,7,0,32,25
1657049576015,MATH 142A,B03,093481,Chow; Bennett,7,0,32,25
1657049576015,MATH 142A,B04,093558,Chow; Bennett,11,0,32,21
1657049576015,MATH 142A,B05,093559,Chow; Bennett,6,0,32,26
1657049582041,MATH 193A,A01,083224,Rotar; Vladimir,7,0,34,27
1657049582041,MATH 193A,A02,083225,Rotar; Vladimir,5,0,34,29
1657049582041,MATH 193A,A03,083781,Rotar; Vladimir,1,0,34,33
1657049582041,MATH 193A,A04,083782,Rotar; Vladimir,6,0,34,28
1657049582041,MATH 193A,A05,093482,Rotar; Vladimir,6,0,34,28
1657049588070,MATH 197,001,091859,McAuley; Julian John,9999,0,9999,0
1657049588070,MATH 197,002,095566,Kedlaya; Kiran S.,9997,0,9999,2
1657049588070,MATH 197,003,095567,Xiao; Ming,9999,0,9999,0
1657049588070,MATH 197,004,095571,Perols; Johan Lars,9998,0,9999,1
1657049595139,COGS 9,A01,083615,Shannon; Kyle Michael,7,0,75,68
1657049601165,COGS 11,A01,083617,Boyle; Mary E. T.,20,0,48,28
1657049607188,COGS 13,A01,083071,Bastos; Amalia Pinkusfeld,9,0,71,62
1657049613211,COGS 14A,A01,092681,Semenuks; Arturs,0,1,100,100
1657049619239,COGS 14B,A01,083073,Cheng; Tzu-Han,5,0,63,58
1657049625266,COGS 17,A01,092677,Semenuks; Arturs,4,0,81,77
1657049631287,COGS 100,A01,083619,Allen; Michael Gordon,15,0,70,55
1657049637309,COGS 101A,A01,083621,Davis; Joshua Daniel,9,0,68,59
1657049643335,COGS 101B,A01,091572,Allen; Michael Gordon,8,0,65,57
1657049649364,COGS 101C,A01,083625,Delgado; Tania,17,0,35,18
1657049655391,COGS 107A,A01,083627,Boyle; Mary E. T.,13,0,60,47
1657049661419,COGS 118A,A01,083075,Gupta; Anjum,15,0,76,61
1657049667444,CSE 3,A50,083646,Miranda; Gregory Joseph,22,0,50,28
1657049673489,CSE 8A,A50,083650,Miranda; Gregory Joseph,17,1,56,39
1657049679511,CSE 11,A01,083080,Cao; Yingjun,4,15,40,36
1657049685535,CSE 12,A01,083652,Krause-Levy; Sophia Louisa,23,1,120,97
1657049691562,CSE 15L,A01,083654,Morris; Justin Loren,8,0,50,42
1657049691562,CSE 15L,A02,083655,Morris; Justin Loren,9,0,50,41
1657049697585,CSE 20,A01,083657,Tran; Khoa Dang,37,0,80,43
1657049703617,CSE 21,A01,095574,Bach; Quang Tran,21,0,48,27
1657049709641,CSE 30,A01,083084,Eldon; John,4,0,80,76
1657049709641,CSE 30,B01,095061,Bhaskar; Nishant,6,0,50,44
1657049715663,CSE 100,A01,083659,Cao; Yingjun,3,4,70,67
1657049721690,CSE 134B,A01,083661,Powell; Thomas Allan,19,0,100,81
1657049727711,CSE 140,A01,083663,Gungor; Onat,14,0,85,71
1657049733732,CSE 140L,A01,083088,Eldon; John,16,0,100,84
1657049739754,CSE 175,A01,083665,Kumar; Rakesh,3,0,25,22
1657049745788,CSE 190,A00,092507,Dubnov; Shlomo,7,0,20,13
1657049751813,ECE 45,A01,083139,Congero; Spencer William,5,0,75,70
1657049757841,ECE 65,A50,083695,Saad; Andrew S,12,0,30,18
1657049757841,ECE 65,A51,095125,Saad; Andrew S,25,0,26,1
1657049763869,ECE 109,A01,091882,Touri; Behrouz,16,0,70,54
1657049769896,ECE 180,A00,083140,Abi Samra; Nicholas Camill,1,0,30,29
1657049769896,ECE 180,B00,083141,Abi Samra; Nicholas Camill,0,0,30,30
1657049775919,MATH 10A,A01,083735,Patchell; Gregory David,1,0,30,29
1657049775919,MATH 10A,A02,083736,Patchell; Gregory David,20,0,30,10
1657049775919,MATH 10A,A03,083737,Patchell; Gregory David,16,0,30,14
1657049781948,MATH 10B,A01,083207,Lim; Seonhee,7,0,34,27
1657049781948,MATH 10B,A02,083208,Lim; Seonhee,9,0,35,26
1657049781948,MATH 10B,A03,093472,Lim; Seonhee,4,0,34,30
1657049781948,MATH 10B,B01,083739,Sinha; Shubham,9,0,30,21
1657049787975,MATH 18,A01,083743,Cinel; Cameron Alexander,6,0,30,24
1657049787975,MATH 18,A02,083744,Cinel; Cameron Alexander,15,0,30,15
1657049787975,MATH 18,A03,083745,Cinel; Cameron Alexander,8,0,30,22
1657049787975,MATH 18,B01,083748,Rideout; David Porter,4,0,37,33
1657049787975,MATH 18,B02,083749,Rideout; David Porter,3,0,36,33
1657049787975,MATH 18,B03,083750,Rideout; David Porter,2,0,37,35
1657049787975,MATH 18,B04,083751,Rideout; David Porter,5,0,36,31
1657049787975,MATH 18,B05,093473,Rideout; David Porter,4,0,36,32
1657049787975,MATH 18,B06,093474,Rideout; David Porter,5,0,36,31
1657049794004,MATH 20A,A01,083754,Zheng; Zequn,12,0,40,28
1657049800031,MATH 20B,A01,083756,Briones; Jor-el Thomas Caparas,1,0,36,35
1657049800031,MATH 20B,A02,083757,Briones; Jor-el Thomas Caparas,1,0,36,35
1657049800031,MATH 20B,A03,093475,Briones; Jor-el Thomas Caparas,0,0,36,36
1657049806055,MATH 20C,A01,083760,Briones; Jor-el Thomas Caparas,1,0,35,34
1657049806055,MATH 20C,A02,083761,Briones; Jor-el Thomas Caparas,8,0,35,27
1657049806055,MATH 20C,A03,093476,Briones; Jor-el Thomas Caparas,0,1,36,36
1657049806055,MATH 20C,B01,083762,Bach; Quang Tran,0,0,30,30
1657049812083,MATH 20D,A01,083765,Tran; Brian Kha,4,0,30,26
1657049812083,MATH 20D,A02,083766,Tran; Brian Kha,5,0,30,25
1657049812083,MATH 20D,A03,083767,Tran; Brian Kha,3,0,30,27
1657049818107,MATH 20E,A01,083771,Ganguly; Soumya,5,0,32,27
1657049818107,MATH 20E,A02,083772,Ganguly; Soumya,6,0,32,26
1657049818107,MATH 20E,B01,083773,Ciotti; Benjamin,18,0,35,17
1657049818107,MATH 20E,B02,083774,Ciotti; Benjamin,17,0,35,18
1657049824131,MATH 103A,A01,083777,Greenfeld; Be'Eri,2,0,36,34
1657049824131,MATH 103A,A02,083778,Greenfeld; Be'Eri,5,0,36,31
1657049824131,MATH 103A,A03,093561,Greenfeld; Be'Eri,4,0,36,32
1657049824131,MATH 103A,B01,083779,Greenfeld; Be'Eri,6,0,36,30
1657049824131,MATH 103A,B02,083780,Greenfeld; Be'Eri,2,0,36,34
1657049824131,MATH 103A,B03,093562,Greenfeld; Be'Eri,2,0,36,34
1657049830154,MATH 105,A01,085443,Carter; Anne Toulson,14,0,35,21
1657049830154,MATH 105,A02,093477,Carter; Anne Toulson,20,0,35,15
1657049836247,MATH 109,A01,083213,Ganzberger; Geoffrey Michael,2,0,34,32
1657049836247,MATH 109,A02,083214,Ganzberger; Geoffrey Michael,2,0,34,32
1657049836247,MATH 109,A03,093478,Ganzberger; Geoffrey Michael,1,0,34,33
1657049836247,MATH 109,B01,083215,Ganzberger; Geoffrey Michael,1,0,32,31
1657049836247,MATH 109,B02,083216,Ganzberger; Geoffrey Michael,1,0,32,31
1657049836247,MATH 109,B03,093479,Ganzberger; Geoffrey Michael,6,0,32,26
1657049842274,MATH 142A,A01,083219,Chow; Bennett,6,0,32,26
1657049842274,MATH 142A,A02,083220,Chow; Bennett,10,0,32,22
1657049842274,MATH 142A,A03,093480,Chow; Bennett,7,0,32,25
1657049842274,MATH 142A,B03,093481,Chow; Bennett,7,0,32,25
1657049842274,MATH 142A,B04,093558,Chow; Bennett,11,0,32,21
1657049842274,MATH 142A,B05,093559,Chow; Bennett,6,0,32,26
1657049848303,MATH 193A,A01,083224,Rotar; Vladimir,7,0,34,27
1657049848303,MATH 193A,A02,083225,Rotar; Vladimir,5,0,34,29
1657049848303,MATH 193A,A03,083781,Rotar; Vladimir,1,0,34,33
1657049848303,MATH 193A,A04,083782,Rotar; Vladimir,6,0,34,28
1657049848303,MATH 193A,A05,093482,Rotar; Vladimir,6,0,34,28
1657049854327,MATH 197,001,091859,McAuley; Julian John,9999,0,9999,0
1657049854327,MATH 197,002,095566,Kedlaya; Kiran S.,9997,0,9999,2
1657049854327,MATH 197,003,095567,Xiao; Ming,9999,0,9999,0
1657049854327,MATH 197,004,095571,Perols; Johan Lars,9998,0,9999,1
1657049861382,COGS 9,A01,083615,Shannon; Kyle Michael,7,0,75,68
1657049867405,COGS 11,A01,083617,Boyle; Mary E. T.,20,0,48,28
1657049873438,COGS 13,A01,083071,Bastos; Amalia Pinkusfeld,9,0,71,62
1657049879459,COGS 14A,A01,092681,Semenuks; Arturs,0,1,100,100
1657049885487,COGS 14B,A01,083073,Cheng; Tzu-Han,5,0,63,58
1657049891510,COGS 17,A01,092677,Semenuks; Arturs,4,0,81,77
1657049897536,COGS 100,A01,083619,Allen; Michael Gordon,15,0,70,55
1657049903560,COGS 101A,A01,083621,Davis; Joshua Daniel,9,0,68,59
1657049909589,COGS 101B,A01,091572,Allen; Michael Gordon,8,0,65,57
1657049915612,COGS 101C,A01,083625,Delgado; Tania,17,0,35,18
1657049921634,COGS 107A,A01,083627,Boyle; Mary E. T.,13,0,60,47
1657049927672,COGS 118A,A01,083075,Gupta; Anjum,15,0,76,61
1657049933700,CSE 3,A50,083646,Miranda; Gregory Joseph,22,0,50,28
1657049939724,CSE 8A,A50,083650,Miranda; Gregory Joseph,17,1,56,39
1657049945747,CSE 11,A01,083080,Cao; Yingjun,4,15,40,36
1657049951770,CSE 12,A01,083652,Krause-Levy; Sophia Louisa,23,1,120,97
1657049957796,CSE 15L,A01,083654,Morris; Justin Loren,8,0,50,42
1657049957796,CSE 15L,A02,083655,Morris; Justin Loren,9,0,50,41
1657049963829,CSE 20,A01,083657,Tran; Khoa Dang,37,0,80,43
1657049969851,CSE 21,A01,095574,Bach; Quang Tran,21,0,48,27
1657049975874,CSE 30,A01,083084,Eldon; John,4,0,80,76
1657049975874,CSE 30,B01,095061,Bhaskar; Nishant,6,0,50,44
1657049981899,CSE 100,A01,083659,Cao; Yingjun,3,4,70,67
1657049987921,CSE 134B,A01,083661,Powell; Thomas Allan,19,0,100,81
1657049993944,CSE 140,A01,083663,Gungor; Onat,14,0,85,71
1657049999968,CSE 140L,A01,083088,Eldon; John,16,0,100,84
1657050005996,CSE 175,A01,083665,Kumar; Rakesh,3,0,25,22
1657050012020,CSE 190,A00,092507,Dubnov; Shlomo,7,0,20,13
1657050018043,ECE 45,A01,083139,Congero; Spencer William,5,0,75,70
1657050024076,ECE 65,A50,083695,Saad; Andrew S,12,0,30,18
1657050024076,ECE 65,A51,095125,Saad; Andrew S,25,0,26,1
1657050030102,ECE 109,A01,091882,Touri; Behrouz,16,0,70,54
1657050036125,ECE 180,A00,083140,Abi Samra; Nicholas Camill,1,0,30,29
1657050036125,ECE 180,B00,083141,Abi Samra; Nicholas Camill,0,0,30,30
1657050042152,MATH 10A,A01,083735,Patchell; Gregory David,1,0,30,29
1657050042152,MATH 10A,A02,083736,Patchell; Gregory David,20,0,30,10
1657050042152,MATH 10A,A03,083737,Patchell; Gregory David,16,0,30,14
1657050048181,MATH 10B,A01,083207,Lim; Seonhee,7,0,34,27
1657050048181,MATH 10B,A02,083208,Lim; Seonhee,9,0,35,26
1657050048181,MATH 10B,A03,093472,Lim; Seonhee,4,0,34,30
1657050048181,MATH 10B,B01,083739,Sinha; Shubham,9,0,30,21
1657050054219,MATH 18,A01,083743,Cinel; Cameron Alexander,6,0,30,24
1657050054219,MATH 18,A02,083744,Cinel; Cameron Alexander,15,0,30,15
1657050054219,MATH 18,A03,083745,Cinel; Cameron Alexander,8,0,30,22
1657050054219,MATH 18,B01,083748,Rideout; David Porter,4,0,37,33
1657050054219,MATH 18,B02,083749,Rideout; David Porter,3,0,36,33
1657050054219,MATH 18,B03,083750,Rideout; David Porter,2,0,37,35
1657050054219,MATH 18,B04,083751,Rideout; David Porter,5,0,36,31
1657050054219,MATH 18,B05,093473,Rideout; David Porter,4,0,36,32
1657050054219,MATH 18,B06,093474,Rideout; David Porter,5,0,36,31
1657050060244,MATH 20A,A01,083754,Zheng; Zequn,12,0,40,28
1657050066274,MATH 20B,A01,083756,Briones; Jor-el Thomas Caparas,1,0,36,35
1657050066274,MATH 20B,A02,083757,Briones; Jor-el Thomas Caparas,1,0,36,35
1657050066274,MATH 20B,A03,093475,Briones; Jor-el Thomas Caparas,0,0,36,36
1657050072302,MATH 20C,A01,083760,Briones; Jor-el Thomas Caparas,1,0,35,34
1657050072302,MATH 20C,A02,083761,Briones; Jor-el Thomas Caparas,8,0,35,27
1657050072302,MATH 20C,A03,093476,Briones; Jor-el Thomas Caparas,0,1,36,36
1657050072302,MATH 20C,B01,083762,Bach; Quang Tran,0,0,30,30
1657050078329,MATH 20D,A01,083765,Tran; Brian Kha,4,0,30,26
1657050078329,MATH 20D,A02,083766,Tran; Brian Kha,5,0,30,25
1657050078329,MATH 20D,A03,083767,Tran; Brian Kha,3,0,30,27
1657050084354,MATH 20E,A01,083771,Ganguly; Soumya,5,0,32,27
1657050084354,MATH 20E,A02,083772,Ganguly; Soumya,6,0,32,26
1657050084354,MATH 20E,B01,083773,Ciotti; Benjamin,18,0,35,17
1657050084354,MATH 20E,B02,083774,Ciotti; Benjamin,17,0,35,18
1657050090389,MATH 103A,A01,083777,Greenfeld; Be'Eri,2,0,36,34
1657050090389,MATH 103A,A02,083778,Greenfeld; Be'Eri,5,0,36,31
1657050090389,MATH 103A,A03,093561,Greenfeld; Be'Eri,4,0,36,32
1657050090389,MATH 103A,B01,083779,Greenfeld; Be'Eri,6,0,36,30
1657050090389,MATH 103A,B02,083780,Greenfeld; Be'Eri,2,0,36,34
1657050090389,MATH 103A,B03,093562,Greenfeld; Be'Eri,2,0,36,34
1657050096412,MATH 105,A01,085443,Carter; Anne Toulson,14,0,35,21
1657050096412,MATH 105,A02,093477,Carter; Anne Toulson,20,0,35,15
1657050102440,MATH 109,A01,083213,Ganzberger; Geoffrey Michael,2,0,34,32
1657050102440,MATH 109,A02,083214,Ganzberger; Geoffrey Michael,2,0,34,32
1657050102440,MATH 109,A03,093478,Ganzberger; Geoffrey Michael,1,0,34,33
1657050102440,MATH 109,B01,083215,Ganzberger; Geoffrey Michael,1,0,32,31
1657050102440,MATH 109,B02,083216,Ganzberger; Geoffrey Michael,1,0,32,31
1657050102440,MATH 109,B03,093479,Ganzberger; Geoffrey Michael,6,0,32,26
1657050108464,MATH 142A,A01,083219,Chow; Bennett,6,0,32,26
1657050108464,MATH 142A,A02,083220,Chow; Bennett,10,0,32,22
1657050108464,MATH 142A,A03,093480,Chow; Bennett,7,0,32,25
1657050108464,MATH 142A,B03,093481,Chow; Bennett,7,0,32,25
1657050108464,MATH 142A,B04,093558,Chow; Bennett,11,0,32,21
1657050108464,MATH 142A,B05,093559,Chow; Bennett,6,0,32,26
1657050114500,MATH 193A,A01,083224,Rotar; Vladimir,7,0,34,27
1657050114500,MATH 193A,A02,083225,Rotar; Vladimir,5,0,34,29
1657050114500,MATH 193A,A03,083781,Rotar; Vladimir,1,0,34,33
1657050114500,MATH 193A,A04,083782,Rotar; Vladimir,6,0,34,28
1657050114500,MATH 193A,A05,093482,Rotar; Vladimir,6,0,34,28
1657050120522,MATH 197,001,091859,McAuley; Julian John,9999,0,9999,0
1657050120522,MATH 197,002,095566,Kedlaya; Kiran S.,9997,0,9999,2
1657050120522,MATH 197,003,095567,Xiao; Ming,9999,0,9999,0
1657050120522,MATH 197,004,095571,Perols; Johan Lars,9998,0,9999,1
1657050127597,COGS 9,A01,083615,Shannon; Kyle Michael,7,0,75,68
1657050133623,COGS 11,A01,083617,Boyle; Mary E. T.,20,0,48,28
1657050139651,COGS 13,A01,083071,Bastos; Amalia Pinkusfeld,9,0,71,62
1657050145676,COGS 14A,A01,092681,Semenuks; Arturs,0,1,100,100
1657050151703,COGS 14B,A01,083073,Cheng; Tzu-Han,5,0,63,58
1657050157732,COGS 17,A01,092677,Semenuks; Arturs,4,0,81,77
1657050163755,COGS 100,A01,083619,Allen; Michael Gordon,15,0,70,55
1657050169785,COGS 101A,A01,083621,Davis; Joshua Daniel,9,0,68,59
1657050175808,COGS 101B,A01,091572,Allen; Michael Gordon,8,0,65,57
1657050181844,COGS 101C,A01,083625,Delgado; Tania,17,0,35,18
1657050187865,COGS 107A,A01,083627,Boyle; Mary E. T.,13,0,60,47
1657050193897,COGS 118A,A01,083075,Gupta; Anjum,15,0,76,61
1657050199924,CSE 3,A50,083646,Miranda; Gregory Joseph,22,0,50,28
1657050205951,CSE 8A,A50,083650,Miranda; Gregory Joseph,17,1,56,39
1657050211980,CSE 11,A01,083080,Cao; Yingjun,4,15,40,36
1657050218003,CSE 12,A01,083652,Krause-Levy; Sophia Louisa,23,1,120,97
1657050224029,CSE 15L,A01,083654,Morris; Justin Loren,8,0,50,42
1657050224029,CSE 15L,A02,083655,Morris; Justin Loren,9,0,50,41
1657050230053,CSE 20,A01,083657,Tran; Khoa Dang,37,0,80,43
1657050236081,CSE 21,A01,095574,Bach; Quang Tran,21,0,48,27
1657050242107,CSE 30,A01,083084,Eldon; John,4,0,80,76
1657050242107,CSE 30,B01,095061,Bhaskar; Nishant,6,0,50,44
1657050248147,CSE 100,A01,083659,Cao; Yingjun,3,4,70,67
1657050254172,CSE 134B,A01,083661,Powell; Thomas Allan,19,0,100,81
1657050260199,CSE 140,A01,083663,Gungor; Onat,14,0,85,71
1657050266225,CSE 140L,A01,083088,Eldon; John,16,0,100,84
1657050272249,CSE 175,A01,083665,Kumar; Rakesh,3,0,25,22
1657050278279,CSE 190,A00,092507,Dubnov; Shlomo,7,0,20,13
1657050284303,ECE 45,A01,083139,Congero; Spencer William,5,0,75,70
1657050290330,ECE 65,A50,083695,Saad; Andrew S,12,0,30,18
1657050290330,ECE 65,A51,095125,Saad; Andrew S,25,0,26,1
1657050296362,ECE 109,A01,091882,Touri; Behrouz,16,0,70,54
1657050302389,ECE 180,A00,083140,Abi Samra; Nicholas Camill,1,0,30,29
1657050302389,ECE 180,B00,083141,Abi Samra; Nicholas Camill,0,0,30,30
1657050308415,MATH 10A,A01,083735,Patchell; Gregory David,1,0,30,29
1657050308415,MATH 10A,A02,083736,Patchell; Gregory David,20,0,30,10
1657050308415,MATH 10A,A03,083737,Patchell; Gregory David,16,0,30,14
1657050314447,MATH 10B,A01,083207,Lim; Seonhee,7,0,34,27
1657050314447,MATH 10B,A02,083208,Lim; Seonhee,9,0,35,26
1657050314447,MATH 10B,A03,093472,Lim; Seonhee,4,0,34,30
1657050314447,MATH 10B,B01,083739,Sinha; Shubham,9,0,30,21
1657050320484,MATH 18,A01,083743,Cinel; Cameron Alexander,6,0,30,24
1657050320484,MATH 18,A02,083744,Cinel; Cameron Alexander,15,0,30,15
1657050320484,MATH 18,A03,083745,Cinel; Cameron Alexander,8,0,30,22
1657050320484,MATH 18,B01,083748,Rideout; David Porter,4,0,37,33
1657050320484,MATH 18,B02,083749,Rideout; David Porter,3,0,36,33
1657050320484,MATH 18,B03,083750,Rideout; David Porter,2,0,37,35
1657050320484,MATH 18,B04,083751,Rideout; David Porter,5,0,36,31
1657050320484,MATH 18,B05,093473,Rideout; David Porter,4,0,36,32
1657050320484,MATH 18,B06,093474,Rideout; David Porter,5,0,36,31
1657050326522,MATH 20A,A01,083754,Zheng; Zequn,12,0,40,28
1657050332550,MATH 20B,A01,083756,Briones; Jor-el Thomas Caparas,1,0,36,35
1657050332550,MATH 20B,A02,083757,Briones; Jor-el Thomas Caparas,1,0,36,35
1657050332550,MATH 20B,A03,093475,Briones; Jor-el Thomas Caparas,0,0,36,36
1657050338582,MATH 20C,A01,083760,Briones; Jor-el Thomas Caparas,1,0,35,34
1657050338582,MATH 20C,A02,083761,Briones; Jor-el Thomas Caparas,8,0,35,27
1657050338582,MATH 20C,A03,093476,Briones; Jor-el Thomas Caparas,0,1,36,36
1657050338582,MATH 20C,B01,083762,Bach; Quang Tran,0,0,30,30
1657050344610,MATH 20D,A01,083765,Tran; Brian Kha,4,0,30,26
1657050344610,MATH 20D,A02,083766,Tran; Brian Kha,5,0,30,25
1657050344610,MATH 20D,A03,083767,Tran; Brian Kha,3,0,30,27
1657050350639,MATH 20E,A01,083771,Ganguly; Soumya,5,0,32,27
1657050350639,MATH 20E,A02,083772,Ganguly; Soumya,6,0,32,26
1657050350639,MATH 20E,B01,083773,Ciotti; Benjamin,18,0,35,17
1657050350639,MATH 20E,B02,083774,Ciotti; Benjamin,17,0,35,18
1657050356662,MATH 103A,A01,083777,Greenfeld; Be'Eri,2,0,36,34
1657050356662,MATH 103A,A02,083778,Greenfeld; Be'Eri,5,0,36,31
1657050356662,MATH 103A,A03,093561,Greenfeld; Be'Eri,4,0,36,32
1657050356662,MATH 103A,B01,083779,Greenfeld; Be'Eri,6,0,36,30
1657050356662,MATH 103A,B02,083780,Greenfeld; Be'Eri,2,0,36,34
1657050356662,MATH 103A,B03,093562,Greenfeld; Be'Eri,2,0,36,34
1657050362688,MATH 105,A01,085443,Carter; Anne Toulson,14,0,35,21
1657050362688,MATH 105,A02,093477,Carter; Anne Toulson,20,0,35,15
1657050368711,MATH 109,A01,083213,Ganzberger; Geoffrey Michael,2,0,34,32
1657050368711,MATH 109,A02,083214,Ganzberger; Geoffrey Michael,2,0,34,32
1657050368711,MATH 109,A03,093478,Ganzberger; Geoffrey Michael,1,0,34,33
1657050368711,MATH 109,B01,083215,Ganzberger; Geoffrey Michael,1,0,32,31
1657050368711,MATH 109,B02,083216,Ganzberger; Geoffrey Michael,1,0,32,31
1657050368711,MATH 109,B03,093479,Ganzberger; Geoffrey Michael,6,0,32,26
1657050374732,MATH 142A,A01,083219,Chow; Bennett,6,0,32,26
1657050374732,MATH 142A,A02,083220,Chow; Bennett,10,0,32,22
1657050374732,MATH 142A,A03,093480,Chow; Bennett,7,0,32,25
1657050374732,MATH 142A,B03,093481,Chow; Bennett,7,0,32,25
1657050374732,MATH 142A,B04,093558,Chow; Bennett,11,0,32,21
1657050374732,MATH 142A,B05,093559,Chow; Bennett,6,0,32,26
1657050380777,MATH 193A,A01,083224,Rotar; Vladimir,7,0,34,27
1657050380777,MATH 193A,A02,083225,Rotar; Vladimir,5,0,34,29
1657050380777,MATH 193A,A03,083781,Rotar; Vladimir,1,0,34,33
1657050380777,MATH 193A,A04,083782,Rotar; Vladimir,6,0,34,28
1657050380777,MATH 193A,A05,093482,Rotar; Vladimir,6,0,34,28
1657050386809,MATH 197,001,091859,McAuley; Julian John,9999,0,9999,0
1657050386809,MATH 197,002,095566,Kedlaya; Kiran S.,9997,0,9999,2
1657050386809,MATH 197,003,095567,Xiao; Ming,9999,0,9999,0
1657050386809,MATH 197,004,095571,Perols; Johan Lars,9998,0,9999,1
1657050393880,COGS 9,A01,083615,Shannon; Kyle Michael,7,0,75,68
1657050399906,COGS 11,A01,083617,Boyle; Mary E. T.,20,0,48,28
1657050405930,COGS 13,A01,083071,Bastos; Amalia Pinkusfeld,9,0,71,62
1657050411957,COGS 14A,A01,092681,Semenuks; Arturs,0,1,100,100
1657050417980,COGS 14B,A01,083073,Cheng; Tzu-Han,5,0,63,58
1657050424004,COGS 17,A01,092677,Semenuks; Arturs,4,0,81,77
1657050430101,COGS 100,A01,083619,Allen; Michael Gordon,15,0,70,55
1657050436128,COGS 101A,A01,083621,Davis; Joshua Daniel,9,0,68,59
1657050442154,COGS 101B,A01,091572,Allen; Michael Gordon,8,0,65,57
1657050448181,COGS 101C,A01,083625,Delgado; Tania,17,0,35,18
1657050454208,COGS 107A,A01,083627,Boyle; Mary E. T.,13,0,60,47
1657050460235,COGS 118A,A01,083075,Gupta; Anjum,15,0,76,61
1657050466261,CSE 3,A50,083646,Miranda; Gregory Joseph,22,0,50,28
1657050472296,CSE 8A,A50,083650,Miranda; Gregory Joseph,17,1,56,39
1657050478323,CSE 11,A01,083080,Cao; Yingjun,4,15,40,36
1657050484345,CSE 12,A01,083652,Krause-Levy; Sophia Louisa,23,1,120,97
1657050490372,CSE 15L,A01,083654,Morris; Justin Loren,8,0,50,42
1657050490372,CSE 15L,A02,083655,Morris; Justin Loren,9,0,50,41
1657050496393,CSE 20,A01,083657,Tran; Khoa Dang,37,0,80,43
1657050502420,CSE 21,A01,095574,Bach; Quang Tran,21,0,48,27
1657050508447,CSE 30,A01,083084,Eldon; John,4,0,80,76
1657050508447,CSE 30,B01,095061,Bhaskar; Nishant,6,0,50,44
1657050514473,CSE 100,A01,083659,Cao; Yingjun,3,4,70,67
1657050520495,CSE 134B,A01,083661,Powell; Thomas Allan,19,0,100,81
1657050526517,CSE 140,A01,083663,Gungor; Onat,14,0,85,71
1657050532541,CSE 140L,A01,083088,Eldon; John,16,0,100,84
1657050538564,CSE 175,A01,083665,Kumar; Rakesh,3,0,25,22
1657050544590,CSE 190,A00,092507,Dubnov; Shlomo,7,0,20,13
1657050550620,ECE 45,A01,083139,Congero; Spencer William,5,0,75,70
1657050556655,ECE 65,A50,083695,Saad; Andrew S,12,0,30,18
1657050556655,ECE 65,A51,095125,Saad; Andrew S,25,0,26,1
1657050562680,ECE 109,A01,091882,Touri; Behrouz,16,0,70,54
1657050568721,ECE 180,A00,083140,Abi Samra; Nicholas Camill,1,0,30,29
1657050568721,ECE 180,B00,083141,Abi Samra; Nicholas Camill,0,0,30,30
1657050574748,MATH 10A,A01,083735,Patchell; Gregory David,1,0,30,29
1657050574748,MATH 10A,A02,083736,Patchell; Gregory David,20,0,30,10
1657050574748,MATH 10A,A03,083737,Patchell; Gregory David,16,0,30,14
1657050580774,MATH 10B,A01,083207,Lim; Seonhee,7,0,34,27
1657050580774,MATH 10B,A02,083208,Lim; Seonhee,9,0,35,26
1657050580774,MATH 10B,A03,093472,Lim; Seonhee,4,0,34,30
1657050580774,MATH 10B,B01,083739,Sinha; Shubham,9,0,30,21
1657050586800,MATH 18,A01,083743,Cinel; Cameron Alexander,6,0,30,24
1657050586800,MATH 18,A02,083744,Cinel; Cameron Alexander,15,0,30,15
1657050586800,MATH 18,A03,083745,Cinel; Cameron Alexander,8,0,30,22
1657050586800,MATH 18,B01,083748,Rideout; David Porter,4,0,37,33
1657050586800,MATH 18,B02,083749,Rideout; David Porter,3,0,36,33
1657050586800,MATH 18,B03,083750,Rideout; David Porter,2,0,37,35
1657050586800,MATH 18,B04,083751,Rideout; David Porter,5,0,36,31
1657050586800,MATH 18,B05,093473,Rideout; David Porter,4,0,36,32
1657050586800,MATH 18,B06,093474,Rideout; David Porter,5,0,36,31
1657050592825,MATH 20A,A01,083754,Zheng; Zequn,12,0,40,28
1657050598847,MATH 20B,A01,083756,Briones; Jor-el Thomas Caparas,1,0,36,35
1657050598847,MATH 20B,A02,083757,Briones; Jor-el Thomas Caparas,1,0,36,35
1657050598847,MATH 20B,A03,093475,Briones; Jor-el Thomas Caparas,0,0,36,36
1657050604872,MATH 20C,A01,083760,Briones; Jor-el Thomas Caparas,1,0,35,34
1657050604872,MATH 20C,A02,083761,Briones; Jor-el Thomas Caparas,8,0,35,27
1657050604872,MATH 20C,A03,093476,Briones; Jor-el Thomas Caparas,0,1,36,36
1657050604872,MATH 20C,B01,083762,Bach; Quang Tran,0,0,30,30
1657050610901,MATH 20D,A01,083765,Tran; Brian Kha,4,0,30,26
1657050610901,MATH 20D,A02,083766,Tran; Brian Kha,5,0,30,25
1657050610901,MATH 20D,A03,083767,Tran; Brian Kha,3,0,30,27
1657050616930,MATH 20E,A01,083771,Ganguly; Soumya,5,0,32,27
1657050616930,MATH 20E,A02,083772,Ganguly; Soumya,6,0,32,26
1657050616930,MATH 20E,B01,083773,Ciotti; Benjamin,18,0,35,17
1657050616930,MATH 20E,B02,083774,Ciotti; Benjamin,17,0,35,18
1657050622959,MATH 103A,A01,083777,Greenfeld; Be'Eri,2,0,36,34
1657050622959,MATH 103A,A02,083778,Greenfeld; Be'Eri,5,0,36,31
1657050622959,MATH 103A,A03,093561,Greenfeld; Be'Eri,4,0,36,32
1657050622959,MATH 103A,B01,083779,Greenfeld; Be'Eri,6,0,36,30
1657050622959,MATH 103A,B02,083780,Greenfeld; Be'Eri,2,0,36,34
1657050622959,MATH 103A,B03,093562,Greenfeld; Be'Eri,2,0,36,34
1657050628998,MATH 105,A01,085443,Carter; Anne Toulson,14,0,35,21
1657050628998,MATH 105,A02,093477,Carter; Anne Toulson,20,0,35,15
1657050635024,MATH 109,A01,083213,Ganzberger; Geoffrey Michael,2,0,34,32
1657050635024,MATH 109,A02,083214,Ganzberger; Geoffrey Michael,2,0,34,32
1657050635024,MATH 109,A03,093478,Ganzberger; Geoffrey Michael,1,0,34,33
1657050635024,MATH 109,B01,083215,Ganzberger; Geoffrey Michael,1,0,32,31
1657050635024,MATH 109,B02,083216,Ganzberger; Geoffrey Michael,1,0,32,31
1657050635024,MATH 109,B03,093479,Ganzberger; Geoffrey Michael,6,0,32,26
1657050641048,MATH 142A,A01,083219,Chow; Bennett,6,0,32,26
1657050641048,MATH 142A,A02,083220,Chow; Bennett,10,0,32,22
1657050641048,MATH 142A,A03,093480,Chow; Bennett,7,0,32,25
1657050641048,MATH 142A,B03,093481,Chow; Bennett,7,0,32,25
1657050641048,MATH 142A,B04,093558,Chow; Bennett,11,0,32,21
1657050641048,MATH 142A,B05,093559,Chow; Bennett,6,0,32,26
1657050647072,MATH 193A,A01,083224,Rotar; Vladimir,7,0,34,27
1657050647072,MATH 193A,A02,083225,Rotar; Vladimir,5,0,34,29
1657050647072,MATH 193A,A03,083781,Rotar; Vladimir,1,0,34,33
1657050647072,MATH 193A,A04,083782,Rotar; Vladimir,6,0,34,28
1657050647072,MATH 193A,A05,093482,Rotar; Vladimir,6,0,34,28
1657050653099,MATH 197,001,091859,McAuley; Julian John,9999,0,9999,0
1657050653099,MATH 197,002,095566,Kedlaya; Kiran S.,9997,0,9999,2
1657050653099,MATH 197,003,095567,Xiao; Ming,9999,0,9999,0
1657050653099,MATH 197,004,095571,Perols; Johan Lars,9998,0,9999,1
1657050660153,COGS 9,A01,083615,Shannon; Kyle Michael,7,0,75,68
1657050666175,COGS 11,A01,083617,Boyle; Mary E. T.,20,0,48,28
1657050672197,COGS 13,A01,083071,Bastos; Amalia Pinkusfeld,9,0,71,62
1657050678223,COGS 14A,A01,092681,Semenuks; Arturs,0,1,100,100
1657050684246,COGS 14B,A01,083073,Cheng; Tzu-Han,5,0,63,58
1657050690271,COGS 17,A01,092677,Semenuks; Arturs,4,0,81,77
1657050696304,COGS 100,A01,083619,Allen; Michael Gordon,15,0,70,55
1657050702329,COGS 101A,A01,083621,Davis; Joshua Daniel,9,0,68,59
1657050708351,COGS 101B,A01,091572,Allen; Michael Gordon,8,0,65,57
1657050714374,COGS 101C,A01,083625,Delgado; Tania,17,0,35,18
1657050720397,COGS 107A,A01,083627,Boyle; Mary E. T.,13,0,60,47
1657050726425,COGS 118A,A01,083075,Gupta; Anjum,15,0,76,61
1657050732449,CSE 3,A50,083646,Miranda; Gregory Joseph,22,0,50,28
1657050738472,CSE 8A,A50,083650,Miranda; Gregory Joseph,17,1,56,39
1657050744497,CSE 11,A01,083080,Cao; Yingjun,4,15,40,36
1657050750526,CSE 12,A01,083652,Krause-Levy; Sophia Louisa,23,1,120,97
1657050756553,CSE 15L,A01,083654,Morris; Justin Loren,8,0,50,42
1657050756553,CSE 15L,A02,083655,Morris; Justin Loren,9,0,50,41
1657050762577,CSE 20,A01,083657,Tran; Khoa Dang,37,0,80,43
1657050768599,CSE 21,A01,095574,Bach; Quang Tran,21,0,48,27
1657050774622,CSE 30,A01,083084,Eldon; John,4,0,80,76
1657050774622,CSE 30,B01,095061,Bhaskar; Nishant,6,0,50,44
1657050780645,CSE 100,A01,083659,Cao; Yingjun,3,4,70,67
1657050786668,CSE 134B,A01,083661,Powell; Thomas Allan,19,0,100,81
1657050792690,CSE 140,A01,083663,Gungor; Onat,14,0,85,71
1657050798713,CSE 140L,A01,083088,Eldon; John,16,0,100,84
1657050804738,CSE 175,A01,083665,Kumar; Rakesh,3,0,25,22
1657050810766,CSE 190,A00,092507,Dubnov; Shlomo,7,0,20,13
1657050816795,ECE 45,A01,083139,Congero; Spencer William,5,0,75,70
1657050822818,ECE 65,A50,083695,Saad; Andrew S,12,0,30,18
1657050822818,ECE 65,A51,095125,Saad; Andrew S,25,0,26,1
1657050828839,ECE 109,A01,091882,Touri; Behrouz,16,0,70,54
1657050834863,ECE 180,A00,083140,Abi Samra; Nicholas Camill,1,0,30,29
1657050834863,ECE 180,B00,083141,Abi Samra; Nicholas Camill,0,0,30,30
1657050840894,MATH 10A,A01,083735,Patchell; Gregory David,1,0,30,29
1657050840894,MATH 10A,A02,083736,Patchell; Gregory David,20,0,30,10
1657050840894,MATH 10A,A03,083737,Patchell; Gregory David,16,0,30,14
1657050846925,MATH 10B,A01,083207,Lim; Seonhee,7,0,34,27
1657050846925,MATH 10B,A02,083208,Lim; Seonhee,9,0,35,26
1657050846925,MATH 10B,A03,093472,Lim; Seonhee,4,0,34,30
1657050846925,MATH 10B,B01,083739,Sinha; Shubham,9,0,30,21
1657050852950,MATH 18,A01,083743,Cinel; Cameron Alexander,6,0,30,24
1657050852950,MATH 18,A02,083744,Cinel; Cameron Alexander,15,0,30,15
1657050852950,MATH 18,A03,083745,Cinel; Cameron Alexander,8,0,30,22
1657050852950,MATH 18,B01,083748,Rideout; David Porter,4,0,37,33
1657050852950,MATH 18,B02,083749,Rideout; David Porter,3,0,36,33
1657050852950,MATH 18,B03,083750,Rideout; David Porter,2,0,37,35
1657050852950,MATH 18,B04,083751,Rideout; David Porter,5,0,36,31
1657050852950,MATH 18,B05,093473,Rideout; David Porter,4,0,36,32
1657050852950,MATH 18,B06,093474,Rideout; David Porter,5,0,36,31
1657050858974,MATH 20A,A01,083754,Zheng; Zequn,12,0,40,28
1657050865004,MATH 20B,A01,083756,Briones; Jor-el Thomas Caparas,1,0,36,35
1657050865004,MATH 20B,A02,083757,Briones; Jor-el Thomas Caparas,1,0,36,35
1657050865004,MATH 20B,A03,093475,Briones; Jor-el Thomas Caparas,0,0,36,36
1657050871038,MATH 20C,A01,083760,Briones; Jor-el Thomas Caparas,1,0,35,34
1657050871038,MATH 20C,A02,083761,Briones; Jor-el Thomas Caparas,8,0,35,27
1657050871038,MATH 20C,A03,093476,Briones; Jor-el Thomas Caparas,0,1,36,36
1657050871038,MATH 20C,B01,083762,Bach; Quang Tran,0,0,30,30
1657050877075,MATH 20D,A01,083765,Tran; Brian Kha,4,0,30,26
1657050877075,MATH 20D,A02,083766,Tran; Brian Kha,5,0,30,25
1657050877075,MATH 20D,A03,083767,Tran; Brian Kha,3,0,30,27
1657050883098,MATH 20E,A01,083771,Ganguly; Soumya,5,0,32,27
1657050883098,MATH 20E,A02,083772,Ganguly; Soumya,6,0,32,26
1657050883098,MATH 20E,B01,083773,Ciotti; Benjamin,18,0,35,17
1657050883098,MATH 20E,B02,083774,Ciotti; Benjamin,17,0,35,18
1657050889123,MATH 103A,A01,083777,Greenfeld; Be'Eri,2,0,36,34
1657050889123,MATH 103A,A02,083778,Greenfeld; Be'Eri,5,0,36,31
1657050889123,MATH 103A,A03,093561,Greenfeld; Be'Eri,4,0,36,32
1657050889123,MATH 103A,B01,083779,Greenfeld; Be'Eri,6,0,36,30
1657050889123,MATH 103A,B02,083780,Greenfeld; Be'Eri,2,0,36,34
1657050889123,MATH 103A,B03,093562,Greenfeld; Be'Eri,2,0,36,34
1657050895150,MATH 105,A01,085443,Carter; Anne Toulson,14,0,35,21
1657050895150,MATH 105,A02,093477,Carter; Anne Toulson,20,0,35,15
1657050901173,MATH 109,A01,083213,Ganzberger; Geoffrey Michael,2,0,34,32
1657050901173,MATH 109,A02,083214,Ganzberger; Geoffrey Michael,2,0,34,32
1657050901173,MATH 109,A03,093478,Ganzberger; Geoffrey Michael,1,0,34,33
1657050901173,MATH 109,B01,083215,Ganzberger; Geoffrey Michael,1,0,32,31
1657050901173,MATH 109,B02,083216,Ganzberger; Geoffrey Michael,1,0,32,31
1657050901173,MATH 109,B03,093479,Ganzberger; Geoffrey Michael,6,0,32,26
1657050907196,MATH 142A,A01,083219,Chow; Bennett,6,0,32,26
1657050907196,MATH 142A,A02,083220,Chow; Bennett,10,0,32,22
1657050907196,MATH 142A,A03,093480,Chow; Bennett,7,0,32,25
1657050907196,MATH 142A,B03,093481,Chow; Bennett,7,0,32,25
1657050907196,MATH 142A,B04,093558,Chow; Bennett,11,0,32,21
1657050907196,MATH 142A,B05,093559,Chow; Bennett,6,0,32,26
1657050913224,MATH 193A,A01,083224,Rotar; Vladimir,7,0,34,27
1657050913224,MATH 193A,A02,083225,Rotar; Vladimir,5,0,34,29
1657050913224,MATH 193A,A03,083781,Rotar; Vladimir,1,0,34,33
1657050913224,MATH 193A,A04,083782,Rotar; Vladimir,6,0,34,28
1657050913224,MATH 193A,A05,093482,Rotar; Vladimir,6,0,34,28
1657050919248,MATH 197,001,091859,McAuley; Julian John,9999,0,9999,0
1657050919248,MATH 197,002,095566,Kedlaya; Kiran S.,9997,0,9999,2
1657050919248,MATH 197,003,095567,Xiao; Ming,9999,0,9999,0
1657050919248,MATH 197,004,095571,Perols; Johan Lars,9998,0,9999,1
1657050926329,COGS 9,A01,083615,Shannon; Kyle Michael,7,0,75,68
1657050932352,COGS 11,A01,083617,Boyle; Mary E. T.,20,0,48,28
1657050938391,COGS 13,A01,083071,Bastos; Amalia Pinkusfeld,9,0,71,62
1657050944415,COGS 14A,A01,092681,Semenuks; Arturs,0,1,100,100
1657050950442,COGS 14B,A01,083073,Cheng; Tzu-Han,5,0,63,58
1657050956469,COGS 17,A01,092677,Semenuks; Arturs,4,0,81,77
1657050962489,COGS 100,A01,083619,Allen; Michael Gordon,15,0,70,55
1657050968517,COGS 101A,A01,083621,Davis; Joshua Daniel,9,0,68,59
1657050974549,COGS 101B,A01,091572,Allen; Michael Gordon,8,0,65,57
1657050980572,COGS 101C,A01,083625,Delgado; Tania,17,0,35,18
1657050986599,COGS 107A,A01,083627,Boyle; Mary E. T.,13,0,60,47
1657050992622,COGS 118A,A01,083075,Gupta; Anjum,15,0,76,61
1657050998650,CSE 3,A50,083646,Miranda; Gregory Joseph,22,0,50,28
1657051004674,CSE 8A,A50,083650,Miranda; Gregory Joseph,17,1,56,39
1657051010701,CSE 11,A01,083080,Cao; Yingjun,4,15,40,36
1657051016724,CSE 12,A01,083652,Krause-Levy; Sophia Louisa,23,1,120,97
1657051022751,CSE 15L,A01,083654,Morris; Justin Loren,8,0,50,42
1657051022751,CSE 15L,A02,083655,Morris; Justin Loren,9,0,50,41
1657051028866,CSE 20,A01,083657,Tran; Khoa Dang,37,0,80,43
1657051034894,CSE 21,A01,095574,Bach; Quang Tran,21,0,48,27
1657051040917,CSE 30,A01,083084,Eldon; John,4,0,80,76
1657051040917,CSE 30,B01,095061,Bhaskar; Nishant,6,0,50,44
1657051046941,CSE 100,A01,083659,Cao; Yingjun,3,4,70,67
1657051052977,CSE 134B,A01,083661,Powell; Thomas Allan,19,0,100,81
1657051059003,CSE 140,A01,083663,Gungor; Onat,14,0,85,71
1657051065024,CSE 140L,A01,083088,Eldon; John,16,0,100,84
1657051071051,CSE 175,A01,083665,Kumar; Rakesh,3,0,25,22
1657051077083,CSE 190,A00,092507,Dubnov; Shlomo,7,0,20,13
1657051083110,ECE 45,A01,083139,Congero; Spencer William,5,0,75,70
1657051089149,ECE 65,A50,083695,Saad; Andrew S,12,0,30,18
1657051089149,ECE 65,A51,095125,Saad; Andrew S,25,0,26,1
1657051095175,ECE 109,A01,091882,Touri; Behrouz,16,0,70,54
1657051101201,ECE 180,A00,083140,Abi Samra; Nicholas Camill,1,0,30,29
1657051101201,ECE 180,B00,083141,Abi Samra; Nicholas Camill,0,0,30,30
1657051107229,MATH 10A,A01,083735,Patchell; Gregory David,1,0,30,29
1657051107229,MATH 10A,A02,083736,Patchell; Gregory David,20,0,30,10
1657051107229,MATH 10A,A03,083737,Patchell; Gregory David,16,0,30,14
1657051113259,MATH 10B,A01,083207,Lim; Seonhee,7,0,34,27
1657051113259,MATH 10B,A02,083208,Lim; Seonhee,9,0,35,26
1657051113259,MATH 10B,A03,093472,Lim; Seonhee,4,0,34,30
1657051113259,MATH 10B,B01,083739,Sinha; Shubham,9,0,30,21
1657051119286,MATH 18,A01,083743,Cinel; Cameron Alexander,6,0,30,24
1657051119286,MATH 18,A02,083744,Cinel; Cameron Alexander,15,0,30,15
1657051119286,MATH 18,A03,083745,Cinel; Cameron Alexander,8,0,30,22
1657051119286,MATH 18,B01,083748,Rideout; David Porter,4,0,37,33
1657051119286,MATH 18,B02,083749,Rideout; David Porter,3,0,36,33
1657051119286,MATH 18,B03,083750,Rideout; David Porter,2,0,37,35
1657051119286,MATH 18,B04,083751,Rideout; David Porter,5,0,36,31
1657051119286,MATH 18,B05,093473,Rideout; David Porter,4,0,36,32
1657051119286,MATH 18,B06,093474,Rideout; David Porter,5,0,36,31
1657051125312,MATH 20A,A01,083754,Zheng; Zequn,12,0,40,28
1657051131334,MATH 20B,A01,083756,Briones; Jor-el Thomas Caparas,1,0,36,35
1657051131334,MATH 20B,A02,083757,Briones; Jor-el Thomas Caparas,1,0,36,35
1657051131334,MATH 20B,A03,093475,Briones; Jor-el Thomas Caparas,0,0,36,36
1657051137369,MATH 20C,A01,083760,Briones; Jor-el Thomas Caparas,1,0,35,34
1657051137369,MATH 20C,A02,083761,Briones; Jor-el Thomas Caparas,8,0,35,27
1657051137369,MATH 20C,A03,093476,Briones; Jor-el Thomas Caparas,0,1,36,36
1657051137369,MATH 20C,B01,083762,Bach; Quang Tran,0,0,30,30
1657051143406,MATH 20D,A01,083765,Tran; Brian Kha,4,0,30,26
1657051143406,MATH 20D,A02,083766,Tran; Brian Kha,5,0,30,25
1657051143406,MATH 20D,A03,083767,Tran; Brian Kha,3,0,30,27
1657051149436,MATH 20E,A01,083771,Ganguly; Soumya,5,0,32,27
1657051149436,MATH 20E,A02,083772,Ganguly; Soumya,6,0,32,26
1657051149436,MATH 20E,B01,083773,Ciotti; Benjamin,18,0,35,17
1657051149436,MATH 20E,B02,083774,Ciotti; Benjamin,17,0,35,18
1657051155465,MATH 103A,A01,083777,Greenfeld; Be'Eri,2,0,36,34
1657051155465,MATH 103A,A02,083778,Greenfeld; Be'Eri,5,0,36,31
1657051155465,MATH 103A,A03,093561,Greenfeld; Be'Eri,4,0,36,32
1657051155465,MATH 103A,B01,083779,Greenfeld; Be'Eri,6,0,36,30
1657051155465,MATH 103A,B02,083780,Greenfeld; Be'Eri,2,0,36,34
1657051155465,MATH 103A,B03,093562,Greenfeld; Be'Eri,2,0,36,34
1657051161501,MATH 105,A01,085443,Carter; Anne Toulson,14,0,35,21
1657051161501,MATH 105,A02,093477,Carter; Anne Toulson,20,0,35,15
1657051167527,MATH 109,A01,083213,Ganzberger; Geoffrey Michael,2,0,34,32
1657051167527,MATH 109,A02,083214,Ganzberger; Geoffrey Michael,2,0,34,32
1657051167527,MATH 109,A03,093478,Ganzberger; Geoffrey Michael,1,0,34,33
1657051167527,MATH 109,B01,083215,Ganzberger; Geoffrey Michael,1,0,32,31
1657051167527,MATH 109,B02,083216,Ganzberger; Geoffrey Michael,1,0,32,31
1657051167527,MATH 109,B03,093479,Ganzberger; Geoffrey Michael,6,0,32,26
1657051173552,MATH 142A,A01,083219,Chow; Bennett,6,0,32,26
1657051173552,MATH 142A,A02,083220,Chow; Bennett,10,0,32,22
1657051173552,MATH 142A,A03,093480,Chow; Bennett,7,0,32,25
1657051173552,MATH 142A,B03,093481,Chow; Bennett,7,0,32,25
1657051173552,MATH 142A,B04,093558,Chow; Bennett,11,0,32,21
1657051173552,MATH 142A,B05,093559,Chow; Bennett,6,0,32,26
1657051179586,MATH 193A,A01,083224,Rotar; Vladimir,7,0,34,27
1657051179586,MATH 193A,A02,083225,Rotar; Vladimir,5,0,34,29
1657051179586,MATH 193A,A03,083781,Rotar; Vladimir,1,0,34,33
1657051179586,MATH 193A,A04,083782,Rotar; Vladimir,6,0,34,28
1657051179586,MATH 193A,A05,093482,Rotar; Vladimir,6,0,34,28
1657051185610,MATH 197,001,091859,McAuley; Julian John,9999,0,9999,0
1657051185610,MATH 197,002,095566,Kedlaya; Kiran S.,9997,0,9999,2
1657051185610,MATH 197,003,095567,Xiao; Ming,9999,0,9999,0
1657051185610,MATH 197,004,095571,Perols; Johan Lars,9998,0,9999,1
1657051192666,COGS 9,A01,083615,Shannon; Kyle Michael,7,0,75,68
1657051198690,COGS 11,A01,083617,Boyle; Mary E. T.,20,0,48,28
1657051204712,COGS 13,A01,083071,Bastos; Amalia Pinkusfeld,9,0,71,62
1657051210762,COGS 14A,A01,092681,Semenuks; Arturs,0,1,100,100
1657051216798,COGS 14B,A01,083073,Cheng; Tzu-Han,5,0,63,58
1657051222837,COGS 17,A01,092677,Semenuks; Arturs,4,0,81,77
1657051228860,COGS 100,A01,083619,Allen; Michael Gordon,15,0,70,55
1657051234891,COGS 101A,A01,083621,Davis; Joshua Daniel,9,0,68,59
1657051240920,COGS 101B,A01,091572,Allen; Michael Gordon,8,0,65,57
1657051246943,COGS 101C,A01,083625,Delgado; Tania,17,0,35,18
1657051252966,COGS 107A,A01,083627,Boyle; Mary E. T.,13,0,60,47
1657051258990,COGS 118A,A01,083075,Gupta; Anjum,15,0,76,61
1657051265018,CSE 3,A50,083646,Miranda; Gregory Joseph,22,0,50,28
1657051271048,CSE 8A,A50,083650,Miranda; Gregory Joseph,17,1,56,39
1657051277071,CSE 11,A01,083080,Cao; Yingjun,4,15,40,36
1657051283093,CSE 12,A01,083652,Krause-Levy; Sophia Louisa,23,1,120,97
1657051289116,CSE 15L,A01,083654,Morris; Justin Loren,8,0,50,42
1657051289116,CSE 15L,A02,083655,Morris; Justin Loren,9,0,50,41
1657051295141,CSE 20,A01,083657,Tran; Khoa Dang,37,0,80,43
1657051301180,CSE 21,A01,095574,Bach; Quang Tran,21,0,48,27
1657051307216,CSE 30,A01,083084,Eldon; John,4,0,80,76
1657051307216,CSE 30,B01,095061,Bhaskar; Nishant,6,0,50,44
1657051313243,CSE 100,A01,083659,Cao; Yingjun,3,4,70,67
1657051319265,CSE 134B,A01,083661,Powell; Thomas Allan,19,0,100,81
1657051325291,CSE 140,A01,083663,Gungor; Onat,14,0,85,71
1657051331318,CSE 140L,A01,083088,Eldon; John,16,0,100,84
1657051337341,CSE 175,A01,083665,Kumar; Rakesh,3,0,25,22
1657051343367,CSE 190,A00,092507,Dubnov; Shlomo,7,0,20,13
1657051349389,ECE 45,A01,083139,Congero; Spencer William,5,0,75,70
1657051355424,ECE 65,A50,083695,Saad; Andrew S,12,0,30,18
1657051355424,ECE 65,A51,095125,Saad; Andrew S,25,0,26,1
1657051361447,ECE 109,A01,091882,Touri; Behrouz,16,0,70,54
1657051367469,ECE 180,A00,083140,Abi Samra; Nicholas Camill,1,0,30,29
1657051367469,ECE 180,B00,083141,Abi Samra; Nicholas Camill,0,0,30,30
1657051373502,MATH 10A,A01,083735,Patchell; Gregory David,1,0,30,29
1657051373502,MATH 10A,A02,083736,Patchell; Gregory David,20,0,30,10
1657051373502,MATH 10A,A03,083737,Patchell; Gregory David,16,0,30,14
1657051379526,MATH 10B,A01,083207,Lim; Seonhee,7,0,34,27
1657051379526,MATH 10B,A02,083208,Lim; Seonhee,9,0,35,26
1657051379526,MATH 10B,A03,093472,Lim; Seonhee,4,0,34,30
1657051379526,MATH 10B,B01,083739,Sinha; Shubham,9,0,30,21
1657051385550,MATH 18,A01,083743,Cinel; Cameron Alexander,6,0,30,24
1657051385550,MATH 18,A02,083744,Cinel; Cameron Alexander,15,0,30,15
1657051385550,MATH 18,A03,083745,Cinel; Cameron Alexander,8,0,30,22
1657051385550,MATH 18,B01,083748,Rideout; David Porter,4,0,37,33
1657051385550,MATH 18,B02,083749,Rideout; David Porter,3,0,36,33
1657051385550,MATH 18,B03,083750,Rideout; David Porter,2,0,37,35
1657051385550,MATH 18,B04,083751,Rideout; David Porter,5,0,36,31
1657051385550,MATH 18,B05,093473,Rideout; David Porter,4,0,36,32
1657051385550,MATH 18,B06,093474,Rideout; David Porter,5,0,36,31
1657051391571,MATH 20A,A01,083754,Zheng; Zequn,12,0,40,28
1657051397593,MATH 20B,A01,083756,Briones; Jor-el Thomas Caparas,1,0,36,35
1657051397593,MATH 20B,A02,083757,Briones; Jor-el Thomas Caparas,1,0,36,35
1657051397593,MATH 20B,A03,093475,Briones; Jor-el Thomas Caparas,0,0,36,36
1657051403619,MATH 20C,A01,083760,Briones; Jor-el Thomas Caparas,1,0,35,34
1657051403619,MATH 20C,A02,083761,Briones; Jor-el Thomas Caparas,8,0,35,27
1657051403619,MATH 20C,A03,093476,Briones; Jor-el Thomas Caparas,0,1,36,36
1657051403619,MATH 20C,B01,083762,Bach; Quang Tran,0,0,30,30
1657051409643,MATH 20D,A01,083765,Tran; Brian Kha,4,0,30,26
1657051409643,MATH 20D,A02,083766,Tran; Brian Kha,5,0,30,25
1657051409643,MATH 20D,A03,083767,Tran; Brian Kha,3,0,30,27
1657051415665,MATH 20E,A01,083771,Ganguly; Soumya,5,0,32,27
1657051415665,MATH 20E,A02,083772,Ganguly; Soumya,6,0,32,26
1657051415665,MATH 20E,B01,083773,Ciotti; Benjamin,18,0,35,17
1657051415665,MATH 20E,B02,083774,Ciotti; Benjamin,17,0,35,18
1657051421703,MATH 103A,A01,083777,Greenfeld; Be'Eri,2,0,36,34
1657051421703,MATH 103A,A02,083778,Greenfeld; Be'Eri,5,0,36,31
1657051421703,MATH 103A,A03,093561,Greenfeld; Be'Eri,4,0,36,32
1657051421703,MATH 103A,B01,083779,Greenfeld; Be'Eri,6,0,36,30
1657051421703,MATH 103A,B02,083780,Greenfeld; Be'Eri,2,0,36,34
1657051421703,MATH 103A,B03,093562,Greenfeld; Be'Eri,2,0,36,34
1657051427729,MATH 105,A01,085443,Carter; Anne Toulson,14,0,35,21
1657051427729,MATH 105,A02,093477,Carter; Anne Toulson,20,0,35,15
1657051433754,MATH 109,A01,083213,Ganzberger; Geoffrey Michael,2,0,34,32
1657051433754,MATH 109,A02,083214,Ganzberger; Geoffrey Michael,2,0,34,32
1657051433754,MATH 109,A03,093478,Ganzberger; Geoffrey Michael,1,0,34,33
1657051433754,MATH 109,B01,083215,Ganzberger; Geoffrey Michael,1,0,32,31
1657051433754,MATH 109,B02,083216,Ganzberger; Geoffrey Michael,1,0,32,31
1657051433754,MATH 109,B03,093479,Ganzberger; Geoffrey Michael,6,0,32,26
1657051439778,MATH 142A,A01,083219,Chow; Bennett,6,0,32,26
1657051439778,MATH 142A,A02,083220,Chow; Bennett,10,0,32,22
1657051439778,MATH 142A,A03,093480,Chow; Bennett,7,0,32,25
1657051439778,MATH 142A,B03,093481,Chow; Bennett,7,0,32,25
1657051439778,MATH 142A,B04,093558,Chow; Bennett,11,0,32,21
1657051439778,MATH 142A,B05,093559,Chow; Bennett,6,0,32,26
1657051445803,MATH 193A,A01,083224,Rotar; Vladimir,7,0,34,27
1657051445803,MATH 193A,A02,083225,Rotar; Vladimir,5,0,34,29
1657051445803,MATH 193A,A03,083781,Rotar; Vladimir,1,0,34,33
1657051445803,MATH 193A,A04,083782,Rotar; Vladimir,6,0,34,28
1657051445803,MATH 193A,A05,093482,Rotar; Vladimir,6,0,34,28
1657051451836,MATH 197,001,091859,McAuley; Julian John,9999,0,9999,0
1657051451836,MATH 197,002,095566,Kedlaya; Kiran S.,9997,0,9999,2
1657051451836,MATH 197,003,095567,Xiao; Ming,9999,0,9999,0
1657051451836,MATH 197,004,095571,Perols; Johan Lars,9998,0,9999,1
1657051458889,COGS 9,A01,083615,Shannon; Kyle Michael,7,0,75,68
1657051464918,COGS 11,A01,083617,Boyle; Mary E. T.,20,0,48,28
1657051470940,COGS 13,A01,083071,Bastos; Amalia Pinkusfeld,9,0,71,62
1657051476964,COGS 14A,A01,092681,Semenuks; Arturs,0,1,100,100
1657051482988,COGS 14B,A01,083073,Cheng; Tzu-Han,5,0,63,58
1657051489011,COGS 17,A01,092677,Semenuks; Arturs,4,0,81,77
1657051495038,COGS 100,A01,083619,Allen; Michael Gordon,15,0,70,55
1657051501065,COGS 101A,A01,083621,Davis; Joshua Daniel,9,0,68,59
1657051507088,COGS 101B,A01,091572,Allen; Michael Gordon,8,0,65,57
1657051513124,COGS 101C,A01,083625,Delgado; Tania,17,0,35,18
1657051519163,COGS 107A,A01,083627,Boyle; Mary E. T.,13,0,60,47
1657051525186,COGS 118A,A01,083075,Gupta; Anjum,15,0,76,61
1657051531213,CSE 3,A50,083646,Miranda; Gregory Joseph,22,0,50,28
1657051537247,CSE 8A,A50,083650,Miranda; Gregory Joseph,17,1,56,39
1657051543273,CSE 11,A01,083080,Cao; Yingjun,4,15,40,36
1657051549300,CSE 12,A01,083652,Krause-Levy; Sophia Louisa,23,1,120,97
1657051555323,CSE 15L,A01,083654,Morris; Justin Loren,8,0,50,42
1657051555323,CSE 15L,A02,083655,Morris; Justin Loren,9,0,50,41
1657051561361,CSE 20,A01,083657,Tran; Khoa Dang,37,0,80,43
1657051567387,CSE 21,A01,095574,Bach; Quang Tran,21,0,48,27
1657051573410,CSE 30,A01,083084,Eldon; John,4,0,80,76
1657051573410,CSE 30,B01,095061,Bhaskar; Nishant,6,0,50,44
1657051579431,CSE 100,A01,083659,Cao; Yingjun,3,4,70,67
1657051585455,CSE 134B,A01,083661,Powell; Thomas Allan,19,0,100,81
1657051591488,CSE 140,A01,083663,Gungor; Onat,14,0,85,71
1657051597519,CSE 140L,A01,083088,Eldon; John,16,0,100,84
1657051603557,CSE 175,A01,083665,Kumar; Rakesh,3,0,25,22
1657051609580,CSE 190,A00,092507,Dubnov; Shlomo,7,0,20,13
1657051615606,ECE 45,A01,083139,Congero; Spencer William,5,0,75,70
1657051621629,ECE 65,A50,083695,Saad; Andrew S,12,0,30,18
1657051621629,ECE 65,A51,095125,Saad; Andrew S,25,0,26,1
1657051627784,ECE 109,A01,091882,Touri; Behrouz,16,0,70,54
1657051633811,ECE 180,A00,083140,Abi Samra; Nicholas Camill,1,0,30,29
1657051633811,ECE 180,B00,083141,Abi Samra; Nicholas Camill,0,0,30,30
1657051639841,MATH 10A,A01,083735,Patchell; Gregory David,1,0,30,29
1657051639841,MATH 10A,A02,083736,Patchell; Gregory David,20,0,30,10
1657051639841,MATH 10A,A03,083737,Patchell; Gregory David,16,0,30,14
1657051645878,MATH 10B,A01,083207,Lim; Seonhee,7,0,34,27
1657051645878,MATH 10B,A02,083208,Lim; Seonhee,9,0,35,26
1657051645878,MATH 10B,A03,093472,Lim; Seonhee,4,0,34,30
1657051645878,MATH 10B,B01,083739,Sinha; Shubham,9,0,30,21
1657051651903,MATH 18,A01,083743,Cinel; Cameron Alexander,6,0,30,24
1657051651903,MATH 18,A02,083744,Cinel; Cameron Alexander,15,0,30,15
1657051651903,MATH 18,A03,083745,Cinel; Cameron Alexander,8,0,30,22
1657051651903,MATH 18,B01,083748,Rideout; David Porter,4,0,37,33
1657051651903,MATH 18,B02,083749,Rideout; David Porter,3,0,36,33
1657051651903,MATH 18,B03,083750,Rideout; David Porter,2,0,37,35
1657051651903,MATH 18,B04,083751,Rideout; David Porter,5,0,36,31
1657051651903,MATH 18,B05,093473,Rideout; David Porter,4,0,36,32
1657051651903,MATH 18,B06,093474,Rideout; David Porter,5,0,36,31
1657051657926,MATH 20A,A01,083754,Zheng; Zequn,12,0,40,28
1657051663956,MATH 20B,A01,083756,Briones; Jor-el Thomas Caparas,1,0,36,35
1657051663956,MATH 20B,A02,083757,Briones; Jor-el Thomas Caparas,1,0,36,35
1657051663956,MATH 20B,A03,093475,Briones; Jor-el Thomas Caparas,0,0,36,36
1657051669978,MATH 20C,A01,083760,Briones; Jor-el Thomas Caparas,1,0,35,34
1657051669978,MATH 20C,A02,083761,Briones; Jor-el Thomas Caparas,8,0,35,27
1657051669978,MATH 20C,A03,093476,Briones; Jor-el Thomas Caparas,0,1,36,36
1657051669978,MATH 20C,B01,083762,Bach; Quang Tran,0,0,30,30
1657051676006,MATH 20D,A01,083765,Tran; Brian Kha,4,0,30,26
1657051676006,MATH 20D,A02,083766,Tran; Brian Kha,5,0,30,25
1657051676006,MATH 20D,A03,083767,Tran; Brian Kha,3,0,30,27
1657051682029,MATH 20E,A01,083771,Ganguly; Soumya,5,0,32,27
1657051682029,MATH 20E,A02,083772,Ganguly; Soumya,6,0,32,26
1657051682029,MATH 20E,B01,083773,Ciotti; Benjamin,18,0,35,17
1657051682029,MATH 20E,B02,083774,Ciotti; Benjamin,17,0,35,18
1657051688053,MATH 103A,A01,083777,Greenfeld; Be'Eri,2,0,36,34
1657051688053,MATH 103A,A02,083778,Greenfeld; Be'Eri,5,0,36,31
1657051688053,MATH 103A,A03,093561,Greenfeld; Be'Eri,4,0,36,32
1657051688053,MATH 103A,B01,083779,Greenfeld; Be'Eri,6,0,36,30
1657051688053,MATH 103A,B02,083780,Greenfeld; Be'Eri,2,0,36,34
1657051688053,MATH 103A,B03,093562,Greenfeld; Be'Eri,2,0,36,34
1657051694075,MATH 105,A01,085443,Carter; Anne Toulson,14,0,35,21
1657051694075,MATH 105,A02,093477,Carter; Anne Toulson,20,0,35,15
1657051700100,MATH 109,A01,083213,Ganzberger; Geoffrey Michael,2,0,34,32
1657051700100,MATH 109,A02,083214,Ganzberger; Geoffrey Michael,2,0,34,32
1657051700100,MATH 109,A03,093478,Ganzberger; Geoffrey Michael,1,0,34,33
1657051700100,MATH 109,B01,083215,Ganzberger; Geoffrey Michael,1,0,32,31
1657051700100,MATH 109,B02,083216,Ganzberger; Geoffrey Michael,1,0,32,31
1657051700100,MATH 109,B03,093479,Ganzberger; Geoffrey Michael,6,0,32,26
1657051706132,MATH 142A,A01,083219,Chow; Bennett,6,0,32,26
1657051706132,MATH 142A,A02,083220,Chow; Bennett,10,0,32,22
1657051706132,MATH 142A,A03,093480,Chow; Bennett,7,0,32,25
1657051706132,MATH 142A,B03,093481,Chow; Bennett,7,0,32,25
1657051706132,MATH 142A,B04,093558,Chow; Bennett,11,0,32,21
1657051706132,MATH 142A,B05,093559,Chow; Bennett,6,0,32,26
1657051712156,MATH 193A,A01,083224,Rotar; Vladimir,7,0,34,27
1657051712156,MATH 193A,A02,083225,Rotar; Vladimir,5,0,34,29
1657051712156,MATH 193A,A03,083781,Rotar; Vladimir,1,0,34,33
1657051712156,MATH 193A,A04,083782,Rotar; Vladimir,6,0,34,28
1657051712156,MATH 193A,A05,093482,Rotar; Vladimir,6,0,34,28
1657051718179,MATH 197,001,091859,McAuley; Julian John,9999,0,9999,0
1657051718179,MATH 197,002,095566,Kedlaya; Kiran S.,9997,0,9999,2
1657051718179,MATH 197,003,095567,Xiao; Ming,9999,0,9999,0
1657051718179,MATH 197,004,095571,Perols; Johan Lars,9998,0,9999,1
1657051725276,COGS 9,A01,083615,Shannon; Kyle Michael,7,0,75,68
1657051731299,COGS 11,A01,083617,Boyle; Mary E. T.,20,0,48,28
1657051737327,COGS 13,A01,083071,Bastos; Amalia Pinkusfeld,9,0,71,62
1657051743354,COGS 14A,A01,092681,Semenuks; Arturs,0,1,100,100
1657051749376,COGS 14B,A01,083073,Cheng; Tzu-Han,5,0,63,58
1657051755399,COGS 17,A01,092677,Semenuks; Arturs,4,0,81,77
1657051761434,COGS 100,A01,083619,Allen; Michael Gordon,15,0,70,55
1657051767457,COGS 101A,A01,083621,Davis; Joshua Daniel,9,0,68,59
1657051773481,COGS 101B,A01,091572,Allen; Michael Gordon,8,0,65,57
1657051779507,COGS 101C,A01,083625,Delgado; Tania,17,0,35,18
1657051785532,COGS 107A,A01,083627,Boyle; Mary E. T.,13,0,60,47
1657051791558,COGS 118A,A01,083075,Gupta; Anjum,15,0,76,61
1657051797585,CSE 3,A50,083646,Miranda; Gregory Joseph,22,0,50,28
1657051803608,CSE 8A,A50,083650,Miranda; Gregory Joseph,17,1,56,39
1657051809635,CSE 11,A01,083080,Cao; Yingjun,4,15,40,36
1657051815663,CSE 12,A01,083652,Krause-Levy; Sophia Louisa,23,1,120,97
1657051821687,CSE 15L,A01,083654,Morris; Justin Loren,8,0,50,42
1657051821687,CSE 15L,A02,083655,Morris; Justin Loren,9,0,50,41
1657051827724,CSE 20,A01,083657,Tran; Khoa Dang,37,0,80,43
1657051833753,CSE 21,A01,095574,Bach; Quang Tran,21,0,48,27
1657051839783,CSE 30,A01,083084,Eldon; John,4,0,80,76
1657051839783,CSE 30,B01,095061,Bhaskar; Nishant,6,0,50,44
1657051845806,CSE 100,A01,083659,Cao; Yingjun,3,4,70,67
1657051851827,CSE 134B,A01,083661,Powell; Thomas Allan,19,0,100,81
1657051857850,CSE 140,A01,083663,Gungor; Onat,14,0,85,71
1657051863872,CSE 140L,A01,083088,Eldon; John,16,0,100,84
1657051869907,CSE 175,A01,083665,Kumar; Rakesh,3,0,25,22
1657051875941,CSE 190,A00,092507,Dubnov; Shlomo,7,0,20,13
1657051881981,ECE 45,A01,083139,Congero; Spencer William,5,0,75,70
1657051888009,ECE 65,A50,083695,Saad; Andrew S,12,0,30,18
1657051888009,ECE 65,A51,095125,Saad; Andrew S,25,0,26,1
1657051894032,ECE 109,A01,091882,Touri; Behrouz,16,0,70,54
1657051900068,ECE 180,A00,083140,Abi Samra; Nicholas Camill,1,0,30,29
1657051900068,ECE 180,B00,083141,Abi Samra; Nicholas Camill,0,0,30,30
1657051906098,MATH 10A,A01,083735,Patchell; Gregory David,1,0,30,29
1657051906098,MATH 10A,A02,083736,Patchell; Gregory David,20,0,30,10
1657051906098,MATH 10A,A03,083737,Patchell; Gregory David,16,0,30,14
1657051912128,MATH 10B,A01,083207,Lim; Seonhee,7,0,34,27
1657051912128,MATH 10B,A02,083208,Lim; Seonhee,9,0,35,26
1657051912128,MATH 10B,A03,093472,Lim; Seonhee,4,0,34,30
1657051912128,MATH 10B,B01,083739,Sinha; Shubham,9,0,30,21
1657051918152,MATH 18,A01,083743,Cinel; Cameron Alexander,6,0,30,24
1657051918152,MATH 18,A02,083744,Cinel; Cameron Alexander,15,0,30,15
1657051918152,MATH 18,A03,083745,Cinel; Cameron Alexander,8,0,30,22
1657051918152,MATH 18,B01,083748,Rideout; David Porter,4,0,37,33
1657051918152,MATH 18,B02,083749,Rideout; David Porter,3,0,36,33
1657051918152,MATH 18,B03,083750,Rideout; David Porter,2,0,37,35
1657051918152,MATH 18,B04,083751,Rideout; David Porter,5,0,36,31
1657051918152,MATH 18,B05,093473,Rideout; David Porter,4,0,36,32
1657051918152,MATH 18,B06,093474,Rideout; David Porter,5,0,36,31
1657051924186,MATH 20A,A01,083754,Zheng; Zequn,12,0,40,28
1657051930217,MATH 20B,A01,083756,Briones; Jor-el Thomas Caparas,1,0,36,35
1657051930217,MATH 20B,A02,083757,Briones; Jor-el Thomas Caparas,1,0,36,35
1657051930217,MATH 20B,A03,093475,Briones; Jor-el Thomas Caparas,0,0,36,36
1657051936242,MATH 20C,A01,083760,Briones; Jor-el Thomas Caparas,1,0,35,34
1657051936242,MATH 20C,A02,083761,Briones; Jor-el Thomas Caparas,8,0,35,27
1657051936242,MATH 20C,A03,093476,Briones; Jor-el Thomas Caparas,0,1,36,36
1657051936242,MATH 20C,B01,083762,Bach; Quang Tran,0,0,30,30
1657051942271,MATH 20D,A01,083765,Tran; Brian Kha,4,0,30,26
1657051942271,MATH 20D,A02,083766,Tran; Brian Kha,5,0,30,25
1657051942271,MATH 20D,A03,083767,Tran; Brian Kha,3,0,30,27
1657051948294,MATH 20E,A01,083771,Ganguly; Soumya,5,0,32,27
1657051948294,MATH 20E,A02,083772,Ganguly; Soumya,6,0,32,26
1657051948294,MATH 20E,B01,083773,Ciotti; Benjamin,18,0,35,17
1657051948294,MATH 20E,B02,083774,Ciotti; Benjamin,17,0,35,18
1657051954325,MATH 103A,A01,083777,Greenfeld; Be'Eri,2,0,36,34
1657051954325,MATH 103A,A02,083778,Greenfeld; Be'Eri,5,0,36,31
1657051954325,MATH 103A,A03,093561,Greenfeld; Be'Eri,4,0,36,32
1657051954325,MATH 103A,B01,083779,Greenfeld; Be'Eri,6,0,36,30
1657051954325,MATH 103A,B02,083780,Greenfeld; Be'Eri,2,0,36,34
1657051954325,MATH 103A,B03,093562,Greenfeld; Be'Eri,2,0,36,34
1657051960355,MATH 105,A01,085443,Carter; Anne Toulson,14,0,35,21
1657051960355,MATH 105,A02,093477,Carter; Anne Toulson,20,0,35,15
1657051966384,MATH 109,A01,083213,Ganzberger; Geoffrey Michael,2,0,34,32
1657051966384,MATH 109,A02,083214,Ganzberger; Geoffrey Michael,2,0,34,32
1657051966384,MATH 109,A03,093478,Ganzberger; Geoffrey Michael,1,0,34,33
1657051966384,MATH 109,B01,083215,Ganzberger; Geoffrey Michael,1,0,32,31
1657051966384,MATH 109,B02,083216,Ganzberger; Geoffrey Michael,1,0,32,31
1657051966384,MATH 109,B03,093479,Ganzberger; Geoffrey Michael,6,0,32,26
1657051972414,MATH 142A,A01,083219,Chow; Bennett,6,0,32,26
1657051972414,MATH 142A,A02,083220,Chow; Bennett,10,0,32,22
1657051972414,MATH 142A,A03,093480,Chow; Bennett,7,0,32,25
1657051972414,MATH 142A,B03,093481,Chow; Bennett,7,0,32,25
1657051972414,MATH 142A,B04,093558,Chow; Bennett,11,0,32,21
1657051972414,MATH 142A,B05,093559,Chow; Bennett,6,0,32,26
1657051978443,MATH 193A,A01,083224,Rotar; Vladimir,7,0,34,27
1657051978443,MATH 193A,A02,083225,Rotar; Vladimir,5,0,34,29
1657051978443,MATH 193A,A03,083781,Rotar; Vladimir,1,0,34,33
1657051978443,MATH 193A,A04,083782,Rotar; Vladimir,6,0,34,28
1657051978443,MATH 193A,A05,093482,Rotar; Vladimir,6,0,34,28
1657051984468,MATH 197,001,091859,McAuley; Julian John,9999,0,9999,0
1657051984468,MATH 197,002,095566,Kedlaya; Kiran S.,9997,0,9999,2
1657051984468,MATH 197,003,095567,Xiao; Ming,9999,0,9999,0
1657051984468,MATH 197,004,095571,Perols; Johan Lars,9998,0,9999,1
1657051991523,COGS 9,A01,083615,Shannon; Kyle Michael,7,0,75,68
1657051997553,COGS 11,A01,083617,Boyle; Mary E. T.,20,0,48,28
1657052003580,COGS 13,A01,083071,Bastos; Amalia Pinkusfeld,9,0,71,62
1657052009604,COGS 14A,A01,092681,Semenuks; Arturs,0,1,100,100
1657052015629,COGS 14B,A01,083073,Cheng; Tzu-Han,5,0,63,58
1657052021654,COGS 17,A01,092677,Semenuks; Arturs,4,0,81,77
1657052027676,COGS 100,A01,083619,Allen; Michael Gordon,15,0,70,55
1657052033700,COGS 101A,A01,083621,Davis; Joshua Daniel,9,0,68,59
1657052039723,COGS 101B,A01,091572,Allen; Michael Gordon,8,0,65,57
1657052045747,COGS 101C,A01,083625,Delgado; Tania,17,0,35,18
1657052051778,COGS 107A,A01,083627,Boyle; Mary E. T.,13,0,60,47
1657052057819,COGS 118A,A01,083075,Gupta; Anjum,15,0,76,61
1657052063850,CSE 3,A50,083646,Miranda; Gregory Joseph,22,0,50,28
1657052069876,CSE 8A,A50,083650,Miranda; Gregory Joseph,17,1,56,39
1657052075902,CSE 11,A01,083080,Cao; Yingjun,4,15,40,36
1657052081925,CSE 12,A01,083652,Krause-Levy; Sophia Louisa,23,1,120,97
1657052087953,CSE 15L,A01,083654,Morris; Justin Loren,8,0,50,42
1657052087953,CSE 15L,A02,083655,Morris; Justin Loren,9,0,50,41
1657052093976,CSE 20,A01,083657,Tran; Khoa Dang,37,0,80,43
1657052100000,CSE 21,A01,095574,Bach; Quang Tran,21,0,48,27
1657052106023,CSE 30,A01,083084,Eldon; John,4,0,80,76
1657052106023,CSE 30,B01,095061,Bhaskar; Nishant,6,0,50,44
1657052112049,CSE 100,A01,083659,Cao; Yingjun,3,4,70,67
1657052118072,CSE 134B,A01,083661,Powell; Thomas Allan,19,0,100,81
1657052124098,CSE 140,A01,083663,Gungor; Onat,14,0,85,71
1657052130119,CSE 140L,A01,083088,Eldon; John,16,0,100,84
1657052136149,CSE 175,A01,083665,Kumar; Rakesh,3,0,25,22
1657052142179,CSE 190,A00,092507,Dubnov; Shlomo,7,0,20,13
1657052148214,ECE 45,A01,083139,Congero; Spencer William,5,0,75,70
1657052154253,ECE 65,A50,083695,Saad; Andrew S,12,0,30,18
1657052154253,ECE 65,A51,095125,Saad; Andrew S,25,0,26,1
1657052160290,ECE 109,A01,091882,Touri; Behrouz,16,0,70,54
1657052166313,ECE 180,A00,083140,Abi Samra; Nicholas Camill,1,0,30,29
1657052166313,ECE 180,B00,083141,Abi Samra; Nicholas Camill,0,0,30,30
1657052172335,MATH 10A,A01,083735,Patchell; Gregory David,1,0,30,29
1657052172335,MATH 10A,A02,083736,Patchell; Gregory David,20,0,30,10
1657052172335,MATH 10A,A03,083737,Patchell; Gregory David,16,0,30,14
1657052178361,MATH 10B,A01,083207,Lim; Seonhee,7,0,34,27
1657052178361,MATH 10B,A02,083208,Lim; Seonhee,9,0,35,26
1657052178361,MATH 10B,A03,093472,Lim; Seonhee,4,0,34,30
1657052178361,MATH 10B,B01,083739,Sinha; Shubham,9,0,30,21
1657052184405,MATH 18,A01,083743,Cinel; Cameron Alexander,6,0,30,24
1657052184405,MATH 18,A02,083744,Cinel; Cameron Alexander,15,0,30,15
1657052184405,MATH 18,A03,083745,Cinel; Cameron Alexander,8,0,30,22
1657052184405,MATH 18,B01,083748,Rideout; David Porter,4,0,37,33
1657052184405,MATH 18,B02,083749,Rideout; David Porter,3,0,36,33
1657052184405,MATH 18,B03,083750,Rideout; David Porter,2,0,37,35
1657052184405,MATH 18,B04,083751,Rideout; David Porter,5,0,36,31
1657052184405,MATH 18,B05,093473,Rideout; David Porter,4,0,36,32
1657052184405,MATH 18,B06,093474,Rideout; David Porter,5,0,36,31
1657052190430,MATH 20A,A01,083754,Zheng; Zequn,12,0,40,28
1657052196462,MATH 20B,A01,083756,Briones; Jor-el Thomas Caparas,1,0,36,35
1657052196462,MATH 20B,A02,083757,Briones; Jor-el Thomas Caparas,1,0,36,35
1657052196462,MATH 20B,A03,093475,Briones; Jor-el Thomas Caparas,0,0,36,36
1657052202491,MATH 20C,A01,083760,Briones; Jor-el Thomas Caparas,1,0,35,34
1657052202491,MATH 20C,A02,083761,Briones; Jor-el Thomas Caparas,8,0,35,27
1657052202491,MATH 20C,A03,093476,Briones; Jor-el Thomas Caparas,0,1,36,36
1657052202491,MATH 20C,B01,083762,Bach; Quang Tran,0,0,30,30
1657052208516,MATH 20D,A01,083765,Tran; Brian Kha,4,0,30,26
1657052208516,MATH 20D,A02,083766,Tran; Brian Kha,5,0,30,25
1657052208516,MATH 20D,A03,083767,Tran; Brian Kha,3,0,30,27
1657052214538,MATH 20E,A01,083771,Ganguly; Soumya,5,0,32,27
1657052214538,MATH 20E,A02,083772,Ganguly; Soumya,6,0,32,26
1657052214538,MATH 20E,B01,083773,Ciotti; Benjamin,18,0,35,17
1657052214538,MATH 20E,B02,083774,Ciotti; Benjamin,17,0,35,18
1657052220570,MATH 103A,A01,083777,Greenfeld; Be'Eri,2,0,36,34
1657052220570,MATH 103A,A02,083778,Greenfeld; Be'Eri,5,0,36,31
1657052220570,MATH 103A,A03,093561,Greenfeld; Be'Eri,4,0,36,32
1657052220570,MATH 103A,B01,083779,Greenfeld; Be'Eri,6,0,36,30
1657052220570,MATH 103A,B02,083780,Greenfeld; Be'Eri,2,0,36,34
1657052220570,MATH 103A,B03,093562,Greenfeld; Be'Eri,2,0,36,34
1657052226688,MATH 105,A01,085443,Carter; Anne Toulson,14,0,35,21
1657052226688,MATH 105,A02,093477,Carter; Anne Toulson,20,0,35,15
1657052232720,MATH 109,A01,083213,Ganzberger; Geoffrey Michael,2,0,34,32
1657052232720,MATH 109,A02,083214,Ganzberger; Geoffrey Michael,2,0,34,32
1657052232720,MATH 109,A03,093478,Ganzberger; Geoffrey Michael,1,0,34,33
1657052232720,MATH 109,B01,083215,Ganzberger; Geoffrey Michael,1,0,32,31
1657052232720,MATH 109,B02,083216,Ganzberger; Geoffrey Michael,1,0,32,31
1657052232720,MATH 109,B03,093479,Ganzberger; Geoffrey Michael,6,0,32,26
1657052238747,MATH 142A,A01,083219,Chow; Bennett,6,0,32,26
1657052238747,MATH 142A,A02,083220,Chow; Bennett,10,0,32,22
1657052238747,MATH 142A,A03,093480,Chow; Bennett,7,0,32,25
1657052238747,MATH 142A,B03,093481,Chow; Bennett,7,0,32,25
1657052238747,MATH 142A,B04,093558,Chow; Bennett,11,0,32,21
1657052238747,MATH 142A,B05,093559,Chow; Bennett,6,0,32,26
1657052244788,MATH 193A,A01,083224,Rotar; Vladimir,7,0,34,27
1657052244788,MATH 193A,A02,083225,Rotar; Vladimir,5,0,34,29
1657052244788,MATH 193A,A03,083781,Rotar; Vladimir,1,0,34,33
1657052244788,MATH 193A,A04,083782,Rotar; Vladimir,6,0,34,28
1657052244788,MATH 193A,A05,093482,Rotar; Vladimir,6,0,34,28
1657052250824,MATH 197,001,091859,McAuley; Julian John,9999,0,9999,0
1657052250824,MATH 197,002,095566,Kedlaya; Kiran S.,9997,0,9999,2
1657052250824,MATH 197,003,095567,Xiao; Ming,9999,0,9999,0
1657052250824,MATH 197,004,095571,Perols; Johan Lars,9998,0,9999,1
1657052257890,COGS 9,A01,083615,Shannon; Kyle Michael,7,0,75,68
1657052263918,COGS 11,A01,083617,Boyle; Mary E. T.,20,0,48,28
1657052269947,COGS 13,A01,083071,Bastos; Amalia Pinkusfeld,9,0,71,62
1657052275970,COGS 14A,A01,092681,Semenuks; Arturs,0,1,100,100
1657052281994,COGS 14B,A01,083073,Cheng; Tzu-Han,5,0,63,58
1657052288016,COGS 17,A01,092677,Semenuks; Arturs,4,0,81,77
1657052294039,COGS 100,A01,083619,Allen; Michael Gordon,15,0,70,55
1657052300061,COGS 101A,A01,083621,Davis; Joshua Daniel,9,0,68,59
1657052306088,COGS 101B,A01,091572,Allen; Michael Gordon,8,0,65,57
1657052312115,COGS 101C,A01,083625,Delgado; Tania,17,0,35,18
1657052318155,COGS 107A,A01,083627,Boyle; Mary E. T.,13,0,60,47
1657052324179,COGS 118A,A01,083075,Gupta; Anjum,15,0,76,61
1657052330204,CSE 3,A50,083646,Miranda; Gregory Joseph,22,0,50,28
1657052336228,CSE 8A,A50,083650,Miranda; Gregory Joseph,17,1,56,39
1657052342255,CSE 11,A01,083080,Cao; Yingjun,4,15,40,36
1657052348299,CSE 12,A01,083652,Krause-Levy; Sophia Louisa,23,1,120,97
1657052354322,CSE 15L,A01,083654,Morris; Justin Loren,8,0,50,42
1657052354322,CSE 15L,A02,083655,Morris; Justin Loren,9,0,50,41
1657052360346,CSE 20,A01,083657,Tran; Khoa Dang,37,0,80,43
1657052366368,CSE 21,A01,095574,Bach; Quang Tran,21,0,48,27
1657052372396,CSE 30,A01,083084,Eldon; John,4,0,80,76
1657052372396,CSE 30,B01,095061,Bhaskar; Nishant,6,0,50,44
1657052378420,CSE 100,A01,083659,Cao; Yingjun,3,4,70,67
1657052384447,CSE 134B,A01,083661,Powell; Thomas Allan,19,0,100,81
1657052390470,CSE 140,A01,083663,Gungor; Onat,14,0,85,71
1657052396506,CSE 140L,A01,083088,Eldon; John,16,0,100,84
1657052402536,CSE 175,A01,083665,Kumar; Rakesh,3,0,25,22
1657052408563,CSE 190,A00,092507,Dubnov; Shlomo,7,0,20,13
1657052414593,ECE 45,A01,083139,Congero; Spencer William,5,0,75,70
1657052420628,ECE 65,A50,083695,Saad; Andrew S,12,0,30,18
1657052420628,ECE 65,A51,095125,Saad; Andrew S,25,0,26,1
1657052426653,ECE 109,A01,091882,Touri; Behrouz,16,0,70,54
1657052432678,ECE 180,A00,083140,Abi Samra; Nicholas Camill,1,0,30,29
1657052432678,ECE 180,B00,083141,Abi Samra; Nicholas Camill,0,0,30,30
1657052438706,MATH 10A,A01,083735,Patchell; Gregory David,1,0,30,29
1657052438706,MATH 10A,A02,083736,Patchell; Gregory David,20,0,30,10
1657052438706,MATH 10A,A03,083737,Patchell; Gregory David,16,0,30,14
1657052444731,MATH 10B,A01,083207,Lim; Seonhee,7,0,34,27
1657052444731,MATH 10B,A02,083208,Lim; Seonhee,9,0,35,26
1657052444731,MATH 10B,A03,093472,Lim; Seonhee,4,0,34,30
1657052444731,MATH 10B,B01,083739,Sinha; Shubham,9,0,30,21
1657052450754,MATH 18,A01,083743,Cinel; Cameron Alexander,6,0,30,24
1657052450754,MATH 18,A02,083744,Cinel; Cameron Alexander,15,0,30,15
1657052450754,MATH 18,A03,083745,Cinel; Cameron Alexander,8,0,30,22
1657052450754,MATH 18,B01,083748,Rideout; David Porter,4,0,37,33
1657052450754,MATH 18,B02,083749,Rideout; David Porter,3,0,36,33
1657052450754,MATH 18,B03,083750,Rideout; David Porter,2,0,37,35
1657052450754,MATH 18,B04,083751,Rideout; David Porter,5,0,36,31
1657052450754,MATH 18,B05,093473,Rideout; David Porter,4,0,36,32
1657052450754,MATH 18,B06,093474,Rideout; David Porter,5,0,36,31
1657052456785,MATH 20A,A01,083754,Zheng; Zequn,12,0,40,28
1657052462807,MATH 20B,A01,083756,Briones; Jor-el Thomas Caparas,1,0,36,35
1657052462807,MATH 20B,A02,083757,Briones; Jor-el Thomas Caparas,1,0,36,35
1657052462807,MATH 20B,A03,093475,Briones; Jor-el Thomas Caparas,0,0,36,36
1657052468842,MATH 20C,A01,083760,Briones; Jor-el Thomas Caparas,1,0,35,34
1657052468842,MATH 20C,A02,083761,Briones; Jor-el Thomas Caparas,8,0,35,27
1657052468842,MATH 20C,A03,093476,Briones; Jor-el Thomas Caparas,0,1,36,36
1657052468842,MATH 20C,B01,083762,Bach; Quang Tran,0,0,30,30
1657052474878,MATH 20D,A01,083765,Tran; Brian Kha,4,0,30,26
1657052474878,MATH 20D,A02,083766,Tran; Brian Kha,5,0,30,25
1657052474878,MATH 20D,A03,083767,Tran; Brian Kha,3,0,30,27
1657052480908,MATH 20E,A01,083771,Ganguly; Soumya,5,0,32,27
1657052480908,MATH 20E,A02,083772,Ganguly; Soumya,6,0,32,26
1657052480908,MATH 20E,B01,083773,Ciotti; Benjamin,18,0,35,17
1657052480908,MATH 20E,B02,083774,Ciotti; Benjamin,17,0,35,18
1657052486932,MATH 103A,A01,083777,Greenfeld; Be'Eri,2,0,36,34
1657052486932,MATH 103A,A02,083778,Greenfeld; Be'Eri,5,0,36,31
1657052486932,MATH 103A,A03,093561,Greenfeld; Be'Eri,4,0,36,32
1657052486932,MATH 103A,B01,083779,Greenfeld; Be'Eri,6,0,36,30
1657052486932,MATH 103A,B02,083780,Greenfeld; Be'Eri,2,0,36,34
1657052486932,MATH 103A,B03,093562,Greenfeld; Be'Eri,2,0,36,34
1657052492956,MATH 105,A01,085443,Carter; Anne Toulson,14,0,35,21
1657052492956,MATH 105,A02,093477,Carter; Anne Toulson,20,0,35,15
1657052498985,MATH 109,A01,083213,Ganzberger; Geoffrey Michael,2,0,34,32
1657052498985,MATH 109,A02,083214,Ganzberger; Geoffrey Michael,2,0,34,32
1657052498985,MATH 109,A03,093478,Ganzberger; Geoffrey Michael,1,0,34,33
1657052498985,MATH 109,B01,083215,Ganzberger; Geoffrey Michael,1,0,32,31
1657052498985,MATH 109,B02,083216,Ganzberger; Geoffrey Michael,1,0,32,31
1657052498985,MATH 109,B03,093479,Ganzberger; Geoffrey Michael,6,0,32,26
1657052505009,MATH 142A,A01,083219,Chow; Bennett,6,0,32,26
1657052505009,MATH 142A,A02,083220,Chow; Bennett,10,0,32,22
1657052505009,MATH 142A,A03,093480,Chow; Bennett,7,0,32,25
1657052505009,MATH 142A,B03,093481,Chow; Bennett,7,0,32,25
1657052505009,MATH 142A,B04,093558,Chow; Bennett,11,0,32,21
1657052505009,MATH 142A,B05,093559,Chow; Bennett,6,0,32,26
1657052511031,MATH 193A,A01,083224,Rotar; Vladimir,7,0,34,27
1657052511031,MATH 193A,A02,083225,Rotar; Vladimir,5,0,34,29
1657052511031,MATH 193A,A03,083781,Rotar; Vladimir,1,0,34,33
1657052511031,MATH 193A,A04,083782,Rotar; Vladimir,6,0,34,28
1657052511031,MATH 193A,A05,093482,Rotar; Vladimir,6,0,34,28
1657052517069,MATH 197,001,091859,McAuley; Julian John,9999,0,9999,0
1657052517069,MATH 197,002,095566,Kedlaya; Kiran S.,9997,0,9999,2
1657052517069,MATH 197,003,095567,Xiao; Ming,9999,0,9999,0
1657052517069,MATH 197,004,095571,Perols; Johan Lars,9998,0,9999,1
1657052524122,COGS 9,A01,083615,Shannon; Kyle Michael,7,0,75,68
1657052530153,COGS 11,A01,083617,Boyle; Mary E. T.,20,0,48,28
1657052536181,COGS 13,A01,083071,Bastos; Amalia Pinkusfeld,9,0,71,62
1657052542208,COGS 14A,A01,092681,Semenuks; Arturs,0,1,100,100
1657052548243,COGS 14B,A01,083073,Cheng; Tzu-Han,5,0,63,58
1657052554277,COGS 17,A01,092677,Semenuks; Arturs,4,0,81,77
1657052560304,COGS 100,A01,083619,Allen; Michael Gordon,15,0,70,55
1657052566327,COGS 101A,A01,083621,Davis; Joshua Daniel,9,0,68,59
1657052572356,COGS 101B,A01,091572,Allen; Michael Gordon,8,0,65,57
1657052578378,COGS 101C,A01,083625,Delgado; Tania,17,0,35,18
1657052584400,COGS 107A,A01,083627,Boyle; Mary E. T.,13,0,60,47
1657052590421,COGS 118A,A01,083075,Gupta; Anjum,15,0,76,61
1657052596445,CSE 3,A50,083646,Miranda; Gregory Joseph,22,0,50,28
1657052602477,CSE 8A,A50,083650,Miranda; Gregory Joseph,17,1,56,39
1657052608505,CSE 11,A01,083080,Cao; Yingjun,4,15,40,36
1657052614530,CSE 12,A01,083652,Krause-Levy; Sophia Louisa,23,1,120,97
1657052620553,CSE 15L,A01,083654,Morris; Justin Loren,8,0,50,42
1657052620553,CSE 15L,A02,083655,Morris; Justin Loren,9,0,50,41
1657052626577,CSE 20,A01,083657,Tran; Khoa Dang,37,0,80,43
1657052632598,CSE 21,A01,095574,Bach; Quang Tran,21,0,48,27
1657052638621,CSE 30,A01,083084,Eldon; John,4,0,80,76
1657052638621,CSE 30,B01,095061,Bhaskar; Nishant,6,0,50,44
1657052644647,CSE 100,A01,083659,Cao; Yingjun,3,4,70,67
1657052650669,CSE 134B,A01,083661,Powell; Thomas Allan,19,0,100,81
1657052656692,CSE 140,A01,083663,Gungor; Onat,14,0,85,71
1657052662739,CSE 140L,A01,083088,Eldon; John,16,0,100,84
1657052668764,CSE 175,A01,083665,Kumar; Rakesh,3,0,25,22
1657052674788,CSE 190,A00,092507,Dubnov; Shlomo,7,0,20,13
1657052680814,ECE 45,A01,083139,Congero; Spencer William,5,0,75,70
1657052686841,ECE 65,A50,083695,Saad; Andrew S,12,0,30,18
1657052686841,ECE 65,A51,095125,Saad; Andrew S,25,0,26,1
1657052692865,ECE 109,A01,091882,Touri; Behrouz,16,0,70,54
1657052698889,ECE 180,A00,083140,Abi Samra; Nicholas Camill,1,0,30,29
1657052698889,ECE 180,B00,083141,Abi Samra; Nicholas Camill,0,0,30,30
1657052704912,MATH 10A,A01,083735,Patchell; Gregory David,1,0,30,29
1657052704912,MATH 10A,A02,083736,Patchell; Gregory David,20,0,30,10
1657052704912,MATH 10A,A03,083737,Patchell; Gregory David,16,0,30,14
1657052710944,MATH 10B,A01,083207,Lim; Seonhee,7,0,34,27
1657052710944,MATH 10B,A02,083208,Lim; Seonhee,9,0,35,26
1657052710944,MATH 10B,A03,093472,Lim; Seonhee,4,0,34,30
1657052710944,MATH 10B,B01,083739,Sinha; Shubham,9,0,30,21
1657052716984,MATH 18,A01,083743,Cinel; Cameron Alexander,6,0,30,24
1657052716984,MATH 18,A02,083744,Cinel; Cameron Alexander,15,0,30,15
1657052716984,MATH 18,A03,083745,Cinel; Cameron Alexander,8,0,30,22
1657052716984,MATH 18,B01,083748,Rideout; David Porter,4,0,37,33
1657052716984,MATH 18,B02,083749,Rideout; David Porter,3,0,36,33
1657052716984,MATH 18,B03,083750,Rideout; David Porter,2,0,37,35
1657052716984,MATH 18,B04,083751,Rideout; David Porter,5,0,36,31
1657052716984,MATH 18,B05,093473,Rideout; David Porter,4,0,36,32
1657052716984,MATH 18,B06,093474,Rideout; David Porter,5,0,36,31
1657052723008,MATH 20A,A01,083754,Zheng; Zequn,12,0,40,28
1657052729035,MATH 20B,A01,083756,Briones; Jor-el Thomas Caparas,1,0,36,35
1657052729035,MATH 20B,A02,083757,Briones; Jor-el Thomas Caparas,1,0,36,35
1657052729035,MATH 20B,A03,093475,Briones; Jor-el Thomas Caparas,0,0,36,36
1657052735058,MATH 20C,A01,083760,Briones; Jor-el Thomas Caparas,1,0,35,34
1657052735058,MATH 20C,A02,083761,Briones; Jor-el Thomas Caparas,8,0,35,27
1657052735058,MATH 20C,A03,093476,Briones; Jor-el Thomas Caparas,0,1,36,36
1657052735058,MATH 20C,B01,083762,Bach; Quang Tran,0,0,30,30
1657052741083,MATH 20D,A01,083765,Tran; Brian Kha,4,0,30,26
1657052741083,MATH 20D,A02,083766,Tran; Brian Kha,5,0,30,25
1657052741083,MATH 20D,A03,083767,Tran; Brian Kha,3,0,30,27
1657052747106,MATH 20E,A01,083771,Ganguly; Soumya,5,0,32,27
1657052747106,MATH 20E,A02,083772,Ganguly; Soumya,6,0,32,26
1657052747106,MATH 20E,B01,083773,Ciotti; Benjamin,18,0,35,17
1657052747106,MATH 20E,B02,083774,Ciotti; Benjamin,17,0,35,18
1657052753130,MATH 103A,A01,083777,Greenfeld; Be'Eri,2,0,36,34
1657052753130,MATH 103A,A02,083778,Greenfeld; Be'Eri,5,0,36,31
1657052753130,MATH 103A,A03,093561,Greenfeld; Be'Eri,4,0,36,32
1657052753130,MATH 103A,B01,083779,Greenfeld; Be'Eri,6,0,36,30
1657052753130,MATH 103A,B02,083780,Greenfeld; Be'Eri,2,0,36,34
1657052753130,MATH 103A,B03,093562,Greenfeld; Be'Eri,2,0,36,34
1657052759158,MATH 105,A01,085443,Carter; Anne Toulson,14,0,35,21
1657052759158,MATH 105,A02,093477,Carter; Anne Toulson,20,0,35,15
1657052765195,MATH 109,A01,083213,Ganzberger; Geoffrey Michael,2,0,34,32
1657052765195,MATH 109,A02,083214,Ganzberger; Geoffrey Michael,2,0,34,32
1657052765195,MATH 109,A03,093478,Ganzberger; Geoffrey Michael,1,0,34,33
1657052765195,MATH 109,B01,083215,Ganzberger; Geoffrey Michael,1,0,32,31
1657052765195,MATH 109,B02,083216,Ganzberger; Geoffrey Michael,1,0,32,31
1657052765195,MATH 109,B03,093479,Ganzberger; Geoffrey Michael,6,0,32,26
1657052771219,MATH 142A,A01,083219,Chow; Bennett,6,0,32,26
1657052771219,MATH 142A,A02,083220,Chow; Bennett,10,0,32,22
1657052771219,MATH 142A,A03,093480,Chow; Bennett,7,0,32,25
1657052771219,MATH 142A,B03,093481,Chow; Bennett,7,0,32,25
1657052771219,MATH 142A,B04,093558,Chow; Bennett,11,0,32,21
1657052771219,MATH 142A,B05,093559,Chow; Bennett,6,0,32,26
1657052777246,MATH 193A,A01,083224,Rotar; Vladimir,7,0,34,27
1657052777246,MATH 193A,A02,083225,Rotar; Vladimir,5,0,34,29
1657052777246,MATH 193A,A03,083781,Rotar; Vladimir,1,0,34,33
1657052777246,MATH 193A,A04,083782,Rotar; Vladimir,6,0,34,28
1657052777246,MATH 193A,A05,093482,Rotar; Vladimir,6,0,34,28
1657052783271,MATH 197,001,091859,McAuley; Julian John,9999,0,9999,0
1657052783271,MATH 197,002,095566,Kedlaya; Kiran S.,9997,0,9999,2
1657052783271,MATH 197,003,095567,Xiao; Ming,9999,0,9999,0
1657052783271,MATH 197,004,095571,Perols; Johan Lars,9998,0,9999,1
1657052790329,COGS 9,A01,083615,Shannon; Kyle Michael,7,0,75,68
1657052796354,COGS 11,A01,083617,Boyle; Mary E. T.,20,0,48,28
1657052802377,COGS 13,A01,083071,Bastos; Amalia Pinkusfeld,9,0,71,62
1657052808404,COGS 14A,A01,092681,Semenuks; Arturs,0,1,100,100
1657052814435,COGS 14B,A01,083073,Cheng; Tzu-Han,5,0,63,58
1657052820538,COGS 17,A01,092677,Semenuks; Arturs,4,0,81,77
1657052826563,COGS 100,A01,083619,Allen; Michael Gordon,15,0,70,55
1657052832599,COGS 101A,A01,083621,Davis; Joshua Daniel,9,0,68,59
1657052838635,COGS 101B,A01,091572,Allen; Michael Gordon,8,0,65,57
1657052844662,COGS 101C,A01,083625,Delgado; Tania,17,0,35,18
1657052850688,COGS 107A,A01,083627,Boyle; Mary E. T.,13,0,60,47
1657052856715,COGS 118A,A01,083075,Gupta; Anjum,15,0,76,61
1657052862743,CSE 3,A50,083646,Miranda; Gregory Joseph,22,0,50,28
1657052868766,CSE 8A,A50,083650,Miranda; Gregory Joseph,17,1,56,39
1657052874798,CSE 11,A01,083080,Cao; Yingjun,4,15,40,36
1657052880826,CSE 12,A01,083652,Krause-Levy; Sophia Louisa,23,1,120,97
1657052886849,CSE 15L,A01,083654,Morris; Justin Loren,8,0,50,42
1657052886849,CSE 15L,A02,083655,Morris; Justin Loren,9,0,50,41
1657052892871,CSE 20,A01,083657,Tran; Khoa Dang,37,0,80,43
1657052898902,CSE 21,A01,095574,Bach; Quang Tran,21,0,48,27
1657052904924,CSE 30,A01,083084,Eldon; John,4,0,80,76
1657052904924,CSE 30,B01,095061,Bhaskar; Nishant,6,0,50,44
1657052910949,CSE 100,A01,083659,Cao; Yingjun,3,4,70,67
1657052916985,CSE 134B,A01,083661,Powell; Thomas Allan,19,0,100,81
1657052923014,CSE 140,A01,083663,Gungor; Onat,14,0,85,71
1657052929042,CSE 140L,A01,083088,Eldon; John,16,0,100,84
1657052935068,CSE 175,A01,083665,Kumar; Rakesh,3,0,25,22
1657052941090,CSE 190,A00,092507,Dubnov; Shlomo,7,0,20,13
1657052947122,ECE 45,A01,083139,Congero; Spencer William,5,0,75,70
1657052953145,ECE 65,A50,083695,Saad; Andrew S,12,0,30,18
1657052953145,ECE 65,A51,095125,Saad; Andrew S,25,0,26,1
1657052959169,ECE 109,A01,091882,Touri; Behrouz,16,0,70,54
1657052965192,ECE 180,A00,083140,Abi Samra; Nicholas Camill,1,0,30,29
1657052965192,ECE 180,B00,083141,Abi Samra; Nicholas Camill,0,0,30,30
1657052971221,MATH 10A,A01,083735,Patchell; Gregory David,1,0,30,29
1657052971221,MATH 10A,A02,083736,Patchell; Gregory David,20,0,30,10
1657052971221,MATH 10A,A03,083737,Patchell; Gregory David,16,0,30,14
1657052977261,MATH 10B,A01,083207,Lim; Seonhee,7,0,34,27
1657052977261,MATH 10B,A02,083208,Lim; Seonhee,9,0,35,26
1657052977261,MATH 10B,A03,093472,Lim; Seonhee,4,0,34,30
1657052977261,MATH 10B,B01,083739,Sinha; Shubham,9,0,30,21
1657052983293,MATH 18,A01,083743,Cinel; Cameron Alexander,6,0,30,24
1657052983293,MATH 18,A02,083744,Cinel; Cameron Alexander,15,0,30,15
1657052983293,MATH 18,A03,083745,Cinel; Cameron Alexander,8,0,30,22
1657052983293,MATH 18,B01,083748,Rideout; David Porter,4,0,37,33
1657052983293,MATH 18,B02,083749,Rideout; David Porter,3,0,36,33
1657052983293,MATH 18,B03,083750,Rideout; David Porter,2,0,37,35
1657052983293,MATH 18,B04,083751,Rideout; David Porter,5,0,36,31
1657052983293,MATH 18,B05,093473,Rideout; David Porter,4,0,36,32
1657052983293,MATH 18,B06,093474,Rideout; David Porter,5,0,36,31
1657052989317,MATH 20A,A01,083754,Zheng; Zequn,12,0,40,28
1657052995342,MATH 20B,A01,083756,Briones; Jor-el Thomas Caparas,1,0,36,35
1657052995342,MATH 20B,A02,083757,Briones; Jor-el Thomas Caparas,1,0,36,35
1657052995342,MATH 20B,A03,093475,Briones; Jor-el Thomas Caparas,0,0,36,36
1657053001380,MATH 20C,A01,083760,Briones; Jor-el Thomas Caparas,1,0,35,34
1657053001380,MATH 20C,A02,083761,Briones; Jor-el Thomas Caparas,8,0,35,27
1657053001380,MATH 20C,A03,093476,Briones; Jor-el Thomas Caparas,0,1,36,36
1657053001380,MATH 20C,B01,083762,Bach; Quang Tran,0,0,30,30
1657053007402,MATH 20D,A01,083765,Tran; Brian Kha,4,0,30,26
1657053007402,MATH 20D,A02,083766,Tran; Brian Kha,5,0,30,25
1657053007402,MATH 20D,A03,083767,Tran; Brian Kha,3,0,30,27
1657053013434,MATH 20E,A01,083771,Ganguly; Soumya,5,0,32,27
1657053013434,MATH 20E,A02,083772,Ganguly; Soumya,6,0,32,26
1657053013434,MATH 20E,B01,083773,Ciotti; Benjamin,18,0,35,17
1657053013434,MATH 20E,B02,083774,Ciotti; Benjamin,17,0,35,18
1657053019463,MATH 103A,A01,083777,Greenfeld; Be'Eri,2,0,36,34
1657053019463,MATH 103A,A02,083778,Greenfeld; Be'Eri,5,0,36,31
1657053019463,MATH 103A,A03,093561,Greenfeld; Be'Eri,4,0,36,32
1657053019463,MATH 103A,B01,083779,Greenfeld; Be'Eri,6,0,36,30
1657053019463,MATH 103A,B02,083780,Greenfeld; Be'Eri,2,0,36,34
1657053019463,MATH 103A,B03,093562,Greenfeld; Be'Eri,2,0,36,34
1657053025495,MATH 105,A01,085443,Carter; Anne Toulson,14,0,35,21
1657053025495,MATH 105,A02,093477,Carter; Anne Toulson,20,0,35,15
1657053031521,MATH 109,A01,083213,Ganzberger; Geoffrey Michael,2,0,34,32
1657053031521,MATH 109,A02,083214,Ganzberger; Geoffrey Michael,2,0,34,32
1657053031521,MATH 109,A03,093478,Ganzberger; Geoffrey Michael,1,0,34,33
1657053031521,MATH 109,B01,083215,Ganzberger; Geoffrey Michael,1,0,32,31
1657053031521,MATH 109,B02,083216,Ganzberger; Geoffrey Michael,1,0,32,31
1657053031521,MATH 109,B03,093479,Ganzberger; Geoffrey Michael,6,0,32,26
1657053037561,MATH 142A,A01,083219,Chow; Bennett,6,0,32,26
1657053037561,MATH 142A,A02,083220,Chow; Bennett,10,0,32,22
1657053037561,MATH 142A,A03,093480,Chow; Bennett,7,0,32,25
1657053037561,MATH 142A,B03,093481,Chow; Bennett,7,0,32,25
1657053037561,MATH 142A,B04,093558,Chow; Bennett,11,0,32,21
1657053037561,MATH 142A,B05,093559,Chow; Bennett,6,0,32,26
1657053043588,MATH 193A,A01,083224,Rotar; Vladimir,7,0,34,27
1657053043588,MATH 193A,A02,083225,Rotar; Vladimir,5,0,34,29
1657053043588,MATH 193A,A03,083781,Rotar; Vladimir,1,0,34,33
1657053043588,MATH 193A,A04,083782,Rotar; Vladimir,6,0,34,28
1657053043588,MATH 193A,A05,093482,Rotar; Vladimir,6,0,34,28
1657053049614,MATH 197,001,091859,McAuley; Julian John,9999,0,9999,0
1657053049614,MATH 197,002,095566,Kedlaya; Kiran S.,9997,0,9999,2
1657053049614,MATH 197,003,095567,Xiao; Ming,9999,0,9999,0
1657053049614,MATH 197,004,095571,Perols; Johan Lars,9998,0,9999,1
1657053056670,COGS 9,A01,083615,Shannon; Kyle Michael,7,0,75,68
1657053062695,COGS 11,A01,083617,Boyle; Mary E. T.,20,0,48,28
1657053068718,COGS 13,A01,083071,Bastos; Amalia Pinkusfeld,9,0,71,62
1657053074750,COGS 14A,A01,092681,Semenuks; Arturs,0,1,100,100
1657053080780,COGS 14B,A01,083073,Cheng; Tzu-Han,5,0,63,58
1657053086804,COGS 17,A01,092677,Semenuks; Arturs,4,0,81,77
1657053092828,COGS 100,A01,083619,Allen; Michael Gordon,15,0,70,55
1657053098854,COGS 101A,A01,083621,Davis; Joshua Daniel,9,0,68,59
1657053104884,COGS 101B,A01,091572,Allen; Michael Gordon,8,0,65,57
1657053110906,COGS 101C,A01,083625,Delgado; Tania,17,0,35,18
1657053116930,COGS 107A,A01,083627,Boyle; Mary E. T.,13,0,60,47
1657053122959,COGS 118A,A01,083075,Gupta; Anjum,15,0,76,61
1657053128981,CSE 3,A50,083646,Miranda; Gregory Joseph,22,0,50,28
1657053135013,CSE 8A,A50,083650,Miranda; Gregory Joseph,17,1,56,39
1657053141035,CSE 11,A01,083080,Cao; Yingjun,4,15,40,36
1657053147058,CSE 12,A01,083652,Krause-Levy; Sophia Louisa,23,1,120,97
1657053153092,CSE 15L,A01,083654,Morris; Justin Loren,8,0,50,42
1657053153092,CSE 15L,A02,083655,Morris; Justin Loren,9,0,50,41
1657053159115,CSE 20,A01,083657,Tran; Khoa Dang,37,0,80,43
1657053165142,CSE 21,A01,095574,Bach; Quang Tran,21,0,48,27
1657053171174,CSE 30,A01,083084,Eldon; John,4,0,80,76
1657053171174,CSE 30,B01,095061,Bhaskar; Nishant,6,0,50,44
1657053177198,CSE 100,A01,083659,Cao; Yingjun,3,4,70,67
1657053183224,CSE 134B,A01,083661,Powell; Thomas Allan,19,0,100,81
1657053189247,CSE 140,A01,083663,Gungor; Onat,14,0,85,71
1657053195270,CSE 140L,A01,083088,Eldon; John,16,0,100,84
1657053201302,CSE 175,A01,083665,Kumar; Rakesh,3,0,25,22
1657053207324,CSE 190,A00,092507,Dubnov; Shlomo,7,0,20,13
1657053213365,ECE 45,A01,083139,Congero; Spencer William,5,0,75,70
1657053219400,ECE 65,A50,083695,Saad; Andrew S,12,0,30,18
1657053219400,ECE 65,A51,095125,Saad; Andrew S,25,0,26,1
1657053225423,ECE 109,A01,091882,Touri; Behrouz,16,0,70,54
1657053231450,ECE 180,A00,083140,Abi Samra; Nicholas Camill,1,0,30,29
1657053231450,ECE 180,B00,083141,Abi Samra; Nicholas Camill,0,0,30,30
1657053237473,MATH 10A,A01,083735,Patchell; Gregory David,1,0,30,29
1657053237473,MATH 10A,A02,083736,Patchell; Gregory David,20,0,30,10
1657053237473,MATH 10A,A03,083737,Patchell; Gregory David,16,0,30,14
1657053243496,MATH 10B,A01,083207,Lim; Seonhee,7,0,34,27
1657053243496,MATH 10B,A02,083208,Lim; Seonhee,9,0,35,26
1657053243496,MATH 10B,A03,093472,Lim; Seonhee,4,0,34,30
1657053243496,MATH 10B,B01,083739,Sinha; Shubham,9,0,30,21
1657053249530,MATH 18,A01,083743,Cinel; Cameron Alexander,6,0,30,24
1657053249530,MATH 18,A02,083744,Cinel; Cameron Alexander,15,0,30,15
1657053249530,MATH 18,A03,083745,Cinel; Cameron Alexander,8,0,30,22
1657053249530,MATH 18,B01,083748,Rideout; David Porter,4,0,37,33
1657053249530,MATH 18,B02,083749,Rideout; David Porter,3,0,36,33
1657053249530,MATH 18,B03,083750,Rideout; David Porter,2,0,37,35
1657053249530,MATH 18,B04,083751,Rideout; David Porter,5,0,36,31
1657053249530,MATH 18,B05,093473,Rideout; David Porter,4,0,36,32
1657053249530,MATH 18,B06,093474,Rideout; David Porter,5,0,36,31
1657053255554,MATH 20A,A01,083754,Zheng; Zequn,12,0,40,28
1657053261581,MATH 20B,A01,083756,Briones; Jor-el Thomas Caparas,1,0,36,35
1657053261581,MATH 20B,A02,083757,Briones; Jor-el Thomas Caparas,1,0,36,35
1657053261581,MATH 20B,A03,093475,Briones; Jor-el Thomas Caparas,0,0,36,36
1657053267623,MATH 20C,A01,083760,Briones; Jor-el Thomas Caparas,1,0,35,34
1657053267623,MATH 20C,A02,083761,Briones; Jor-el Thomas Caparas,8,0,35,27
1657053267623,MATH 20C,A03,093476,Briones; Jor-el Thomas Caparas,0,1,36,36
1657053267623,MATH 20C,B01,083762,Bach; Quang Tran,0,0,30,30
1657053273648,MATH 20D,A01,083765,Tran; Brian Kha,4,0,30,26
1657053273648,MATH 20D,A02,083766,Tran; Brian Kha,5,0,30,25
1657053273648,MATH 20D,A03,083767,Tran; Brian Kha,3,0,30,27
1657053279671,MATH 20E,A01,083771,Ganguly; Soumya,5,0,32,27
1657053279671,MATH 20E,A02,083772,Ganguly; Soumya,6,0,32,26
1657053279671,MATH 20E,B01,083773,Ciotti; Benjamin,18,0,35,17
1657053279671,MATH 20E,B02,083774,Ciotti; Benjamin,17,0,35,18
1657053285709,MATH 103A,A01,083777,Greenfeld; Be'Eri,2,0,36,34
1657053285709,MATH 103A,A02,083778,Greenfeld; Be'Eri,5,0,36,31
1657053285709,MATH 103A,A03,093561,Greenfeld; Be'Eri,4,0,36,32
1657053285709,MATH 103A,B01,083779,Greenfeld; Be'Eri,6,0,36,30
1657053285709,MATH 103A,B02,083780,Greenfeld; Be'Eri,2,0,36,34
1657053285709,MATH 103A,B03,093562,Greenfeld; Be'Eri,2,0,36,34
1657053291736,MATH 105,A01,085443,Carter; Anne Toulson,14,0,35,21
1657053291736,MATH 105,A02,093477,Carter; Anne Toulson,20,0,35,15
1657053297759,MATH 109,A01,083213,Ganzberger; Geoffrey Michael,2,0,34,32
1657053297759,MATH 109,A02,083214,Ganzberger; Geoffrey Michael,2,0,34,32
1657053297759,MATH 109,A03,093478,Ganzberger; Geoffrey Michael,1,0,34,33
1657053297759,MATH 109,B01,083215,Ganzberger; Geoffrey Michael,1,0,32,31
1657053297759,MATH 109,B02,083216,Ganzberger; Geoffrey Michael,1,0,32,31
1657053297759,MATH 109,B03,093479,Ganzberger; Geoffrey Michael,6,0,32,26
1657053303789,MATH 142A,A01,083219,Chow; Bennett,6,0,32,26
1657053303789,MATH 142A,A02,083220,Chow; Bennett,10,0,32,22
1657053303789,MATH 142A,A03,093480,Chow; Bennett,7,0,32,25
1657053303789,MATH 142A,B03,093481,Chow; Bennett,7,0,32,25
1657053303789,MATH 142A,B04,093558,Chow; Bennett,11,0,32,21
1657053303789,MATH 142A,B05,093559,Chow; Bennett,6,0,32,26
1657053309811,MATH 193A,A01,083224,Rotar; Vladimir,7,0,34,27
1657053309811,MATH 193A,A02,083225,Rotar; Vladimir,5,0,34,29
1657053309811,MATH 193A,A03,083781,Rotar; Vladimir,1,0,34,33
1657053309811,MATH 193A,A04,083782,Rotar; Vladimir,6,0,34,28
1657053309811,MATH 193A,A05,093482,Rotar; Vladimir,6,0,34,28
1657053315846,MATH 197,001,091859,McAuley; Julian John,9999,0,9999,0
1657053315846,MATH 197,002,095566,Kedlaya; Kiran S.,9997,0,9999,2
1657053315846,MATH 197,003,095567,Xiao; Ming,9999,0,9999,0
1657053315846,MATH 197,004,095571,Perols; Johan Lars,9998,0,9999,1
1657053322902,COGS 9,A01,083615,Shannon; Kyle Michael,7,0,75,68
1657053328927,COGS 11,A01,083617,Boyle; Mary E. T.,20,0,48,28
1657053334960,COGS 13,A01,083071,Bastos; Amalia Pinkusfeld,9,0,71,62
1657053340987,COGS 14A,A01,092681,Semenuks; Arturs,0,1,100,100
1657053347015,COGS 14B,A01,083073,Cheng; Tzu-Han,5,0,63,58
1657053353041,COGS 17,A01,092677,Semenuks; Arturs,4,0,81,77
1657053359064,COGS 100,A01,083619,Allen; Michael Gordon,15,0,70,55
1657053365090,COGS 101A,A01,083621,Davis; Joshua Daniel,9,0,68,59
1657053371114,COGS 101B,A01,091572,Allen; Michael Gordon,8,0,65,57
1657053377138,COGS 101C,A01,083625,Delgado; Tania,17,0,35,18
1657053383170,COGS 107A,A01,083627,Boyle; Mary E. T.,13,0,60,47
1657053389195,COGS 118A,A01,083075,Gupta; Anjum,15,0,76,61
1657053395229,CSE 3,A50,083646,Miranda; Gregory Joseph,22,0,50,28
1657053401286,CSE 8A,A50,083650,Miranda; Gregory Joseph,17,1,56,39
1657053407309,CSE 11,A01,083080,Cao; Yingjun,4,15,40,36
1657053413336,CSE 12,A01,083652,Krause-Levy; Sophia Louisa,23,1,120,97
1657053419462,CSE 15L,A01,083654,Morris; Justin Loren,8,0,50,42
1657053419462,CSE 15L,A02,083655,Morris; Justin Loren,9,0,50,41
1657053425489,CSE 20,A01,083657,Tran; Khoa Dang,37,0,80,43
1657053439899,CSE 21,A01,095574,Bach; Quang Tran,21,0,48,27
1657053445928,CSE 30,A01,083084,Eldon; John,4,0,80,76
1657053445928,CSE 30,B01,095061,Bhaskar; Nishant,6,0,50,44
1657053451955,CSE 100,A01,083659,Cao; Yingjun,3,4,70,67
1657053457982,CSE 134B,A01,083661,Powell; Thomas Allan,19,0,100,81
1657053464013,CSE 140,A01,083663,Gungor; Onat,14,0,85,71
1657053470039,CSE 140L,A01,083088,Eldon; John,16,0,100,84
1657053476064,CSE 175,A01,083665,Kumar; Rakesh,3,0,25,22
1657053482098,CSE 190,A00,092507,Dubnov; Shlomo,7,0,20,13
1657053488135,ECE 45,A01,083139,Congero; Spencer William,5,0,75,70
1657053494171,ECE 65,A50,083695,Saad; Andrew S,12,0,30,18
1657053494171,ECE 65,A51,095125,Saad; Andrew S,25,0,26,1
1657053500195,ECE 109,A01,091882,Touri; Behrouz,16,0,70,54
1657053506217,ECE 180,A00,083140,Abi Samra; Nicholas Camill,1,0,30,29
1657053506217,ECE 180,B00,083141,Abi Samra; Nicholas Camill,0,0,30,30
1657053512239,MATH 10A,A01,083735,Patchell; Gregory David,1,0,30,29
1657053512239,MATH 10A,A02,083736,Patchell; Gregory David,20,0,30,10
1657053512239,MATH 10A,A03,083737,Patchell; Gregory David,16,0,30,14
1657053518265,MATH 10B,A01,083207,Lim; Seonhee,7,0,34,27
1657053518265,MATH 10B,A02,083208,Lim; Seonhee,9,0,35,26
1657053518265,MATH 10B,A03,093472,Lim; Seonhee,4,0,34,30
1657053518265,MATH 10B,B01,083739,Sinha; Shubham,9,0,30,21
1657053524296,MATH 18,A01,083743,Cinel; Cameron Alexander,6,0,30,24
1657053524296,MATH 18,A02,083744,Cinel; Cameron Alexander,15,0,30,15
1657053524296,MATH 18,A03,083745,Cinel; Cameron Alexander,8,0,30,22
1657053524296,MATH 18,B01,083748,Rideout; David Porter,4,0,37,33
1657053524296,MATH 18,B02,083749,Rideout; David Porter,3,0,36,33
1657053524296,MATH 18,B03,083750,Rideout; David Porter,2,0,37,35
1657053524296,MATH 18,B04,083751,Rideout; David Porter,5,0,36,31
1657053524296,MATH 18,B05,093473,Rideout; David Porter,4,0,36,32
1657053524296,MATH 18,B06,093474,Rideout; David Porter,5,0,36,31
1657053530321,MATH 20A,A01,083754,Zheng; Zequn,12,0,40,28
1657053536351,MATH 20B,A01,083756,Briones; Jor-el Thomas Caparas,1,0,36,35
1657053536351,MATH 20B,A02,083757,Briones; Jor-el Thomas Caparas,1,0,36,35
1657053536351,MATH 20B,A03,093475,Briones; Jor-el Thomas Caparas,0,0,36,36
1657053542376,MATH 20C,A01,083760,Briones; Jor-el Thomas Caparas,1,0,35,34
1657053542376,MATH 20C,A02,083761,Briones; Jor-el Thomas Caparas,8,0,35,27
1657053542376,MATH 20C,A03,093476,Briones; Jor-el Thomas Caparas,0,1,36,36
1657053542376,MATH 20C,B01,083762,Bach; Quang Tran,0,0,30,30
1657053548403,MATH 20D,A01,083765,Tran; Brian Kha,4,0,30,26
1657053548403,MATH 20D,A02,083766,Tran; Brian Kha,5,0,30,25
1657053548403,MATH 20D,A03,083767,Tran; Brian Kha,3,0,30,27
1657053554431,MATH 20E,A01,083771,Ganguly; Soumya,5,0,32,27
1657053554431,MATH 20E,A02,083772,Ganguly; Soumya,6,0,32,26
1657053554431,MATH 20E,B01,083773,Ciotti; Benjamin,18,0,35,17
1657053554431,MATH 20E,B02,083774,Ciotti; Benjamin,17,0,35,18
1657053560463,MATH 103A,A01,083777,Greenfeld; Be'Eri,2,0,36,34
1657053560463,MATH 103A,A02,083778,Greenfeld; Be'Eri,5,0,36,31
1657053560463,MATH 103A,A03,093561,Greenfeld; Be'Eri,4,0,36,32
1657053560463,MATH 103A,B01,083779,Greenfeld; Be'Eri,6,0,36,30
1657053560463,MATH 103A,B02,083780,Greenfeld; Be'Eri,2,0,36,34
1657053560463,MATH 103A,B03,093562,Greenfeld; Be'Eri,2,0,36,34
1657053566490,MATH 105,A01,085443,Carter; Anne Toulson,14,0,35,21
1657053566490,MATH 105,A02,093477,Carter; Anne Toulson,20,0,35,15
1657053572518,MATH 109,A01,083213,Ganzberger; Geoffrey Michael,2,0,34,32
1657053572518,MATH 109,A02,083214,Ganzberger; Geoffrey Michael,2,0,34,32
1657053572518,MATH 109,A03,093478,Ganzberger; Geoffrey Michael,1,0,34,33
1657053572518,MATH 109,B01,083215,Ganzberger; Geoffrey Michael,1,0,32,31
1657053572518,MATH 109,B02,083216,Ganzberger; Geoffrey Michael,1,0,32,31
1657053572518,MATH 109,B03,093479,Ganzberger; Geoffrey Michael,6,0,32,26
1657053578542,MATH 142A,A01,083219,Chow; Bennett,6,0,32,26
1657053578542,MATH 142A,A02,083220,Chow; Bennett,10,0,32,22
1657053578542,MATH 142A,A03,093480,Chow; Bennett,7,0,32,25
1657053578542,MATH 142A,B03,093481,Chow; Bennett,7,0,32,25
1657053578542,MATH 142A,B04,093558,Chow; Bennett,11,0,32,21
1657053578542,MATH 142A,B05,093559,Chow; Bennett,6,0,32,26
1657053584571,MATH 193A,A01,083224,Rotar; Vladimir,7,0,34,27
1657053584571,MATH 193A,A02,083225,Rotar; Vladimir,5,0,34,29
1657053584571,MATH 193A,A03,083781,Rotar; Vladimir,1,0,34,33
1657053584571,MATH 193A,A04,083782,Rotar; Vladimir,6,0,34,28
1657053584571,MATH 193A,A05,093482,Rotar; Vladimir,6,0,34,28
1657053590596,MATH 197,001,091859,McAuley; Julian John,9999,0,9999,0
1657053590596,MATH 197,002,095566,Kedlaya; Kiran S.,9997,0,9999,2
1657053590596,MATH 197,003,095567,Xiao; Ming,9999,0,9999,0
1657053590596,MATH 197,004,095571,Perols; Johan Lars,9998,0,9999,1
1657053597657,COGS 9,A01,083615,Shannon; Kyle Michael,7,0,75,68
1657053603680,COGS 11,A01,083617,Boyle; Mary E. T.,20,0,48,28
1657053609720,COGS 13,A01,083071,Bastos; Amalia Pinkusfeld,9,0,71,62
1657053615762,COGS 14A,A01,092681,Semenuks; Arturs,0,1,100,100
1657053621784,COGS 14B,A01,083073,Cheng; Tzu-Han,5,0,63,58
1657053627807,COGS 17,A01,092677,Semenuks; Arturs,4,0,81,77
1657053633848,COGS 100,A01,083619,Allen; Michael Gordon,15,0,70,55
1657053639874,COGS 101A,A01,083621,Davis; Joshua Daniel,9,0,68,59
1657053645903,COGS 101B,A01,091572,Allen; Michael Gordon,8,0,65,57
1657053651927,COGS 101C,A01,083625,Delgado; Tania,17,0,35,18
1657053657951,COGS 107A,A01,083627,Boyle; Mary E. T.,13,0,60,47
1657053663981,COGS 118A,A01,083075,Gupta; Anjum,15,0,76,61
1657053670014,CSE 3,A50,083646,Miranda; Gregory Joseph,22,0,50,28
1657053676042,CSE 8A,A50,083650,Miranda; Gregory Joseph,17,1,56,39
1657053682067,CSE 11,A01,083080,Cao; Yingjun,4,15,40,36
1657053688089,CSE 12,A01,083652,Krause-Levy; Sophia Louisa,23,1,120,97
1657053694111,CSE 15L,A01,083654,Morris; Justin Loren,8,0,50,42
1657053694111,CSE 15L,A02,083655,Morris; Justin Loren,9,0,50,41
1657053700139,CSE 20,A01,083657,Tran; Khoa Dang,37,0,80,43
1657053706166,CSE 21,A01,095574,Bach; Quang Tran,21,0,48,27
1657053712191,CSE 30,A01,083084,Eldon; John,4,0,80,76
1657053712191,CSE 30,B01,095061,Bhaskar; Nishant,6,0,50,44
1657053718216,CSE 100,A01,083659,Cao; Yingjun,3,4,70,67
1657053724238,CSE 134B,A01,083661,Powell; Thomas Allan,19,0,100,81
1657053730265,CSE 140,A01,083663,Gungor; Onat,14,0,85,71
1657053736293,CSE 140L,A01,083088,Eldon; John,16,0,100,84
1657053742333,CSE 175,A01,083665,Kumar; Rakesh,3,0,25,22
1657053748356,CSE 190,A00,092507,Dubnov; Shlomo,7,0,20,13
1657053754383,ECE 45,A01,083139,Congero; Spencer William,5,0,75,70
1657053760411,ECE 65,A50,083695,Saad; Andrew S,12,0,30,18
1657053760411,ECE 65,A51,095125,Saad; Andrew S,25,0,26,1
1657053766437,ECE 109,A01,091882,Touri; Behrouz,16,0,70,54
1657053772463,ECE 180,A00,083140,Abi Samra; Nicholas Camill,1,0,30,29
1657053772463,ECE 180,B00,083141,Abi Samra; Nicholas Camill,0,0,30,30
1657053778486,MATH 10A,A01,083735,Patchell; Gregory David,1,0,30,29
1657053778486,MATH 10A,A02,083736,Patchell; Gregory David,20,0,30,10
1657053778486,MATH 10A,A03,083737,Patchell; Gregory David,16,0,30,14
1657053784511,MATH 10B,A01,083207,Lim; Seonhee,7,0,34,27
1657053784511,MATH 10B,A02,083208,Lim; Seonhee,9,0,35,26
1657053784511,MATH 10B,A03,093472,Lim; Seonhee,4,0,34,30
1657053784511,MATH 10B,B01,083739,Sinha; Shubham,9,0,30,21
1657053790545,MATH 18,A01,083743,Cinel; Cameron Alexander,6,0,30,24
1657053790545,MATH 18,A02,083744,Cinel; Cameron Alexander,15,0,30,15
1657053790545,MATH 18,A03,083745,Cinel; Cameron Alexander,8,0,30,22
1657053790545,MATH 18,B01,083748,Rideout; David Porter,4,0,37,33
1657053790545,MATH 18,B02,083749,Rideout; David Porter,3,0,36,33
1657053790545,MATH 18,B03,083750,Rideout; David Porter,2,0,37,35
1657053790545,MATH 18,B04,083751,Rideout; David Porter,5,0,36,31
1657053790545,MATH 18,B05,093473,Rideout; David Porter,4,0,36,32
1657053790545,MATH 18,B06,093474,Rideout; David Porter,5,0,36,31
1657053796572,MATH 20A,A01,083754,Zheng; Zequn,12,0,40,28
1657053802605,MATH 20B,A01,083756,Briones; Jor-el Thomas Caparas,1,0,36,35
1657053802605,MATH 20B,A02,083757,Briones; Jor-el Thomas Caparas,1,0,36,35
1657053802605,MATH 20B,A03,093475,Briones; Jor-el Thomas Caparas,0,0,36,36
1657053808641,MATH 20C,A01,083760,Briones; Jor-el Thomas Caparas,1,0,35,34
1657053808641,MATH 20C,A02,083761,Briones; Jor-el Thomas Caparas,8,0,35,27
1657053808641,MATH 20C,A03,093476,Briones; Jor-el Thomas Caparas,0,1,36,36
1657053808641,MATH 20C,B01,083762,Bach; Quang Tran,0,0,30,30
1657053814663,MATH 20D,A01,083765,Tran; Brian Kha,4,0,30,26
1657053814663,MATH 20D,A02,083766,Tran; Brian Kha,5,0,30,25
1657053814663,MATH 20D,A03,083767,Tran; Brian Kha,3,0,30,27
1657053820690,MATH 20E,A01,083771,Ganguly; Soumya,5,0,32,27
1657053820690,MATH 20E,A02,083772,Ganguly; Soumya,6,0,32,26
1657053820690,MATH 20E,B01,083773,Ciotti; Benjamin,18,0,35,17
1657053820690,MATH 20E,B02,083774,Ciotti; Benjamin,17,0,35,18
1657053826727,MATH 103A,A01,083777,Greenfeld; Be'Eri,2,0,36,34
1657053826727,MATH 103A,A02,083778,Greenfeld; Be'Eri,5,0,36,31
1657053826727,MATH 103A,A03,093561,Greenfeld; Be'Eri,4,0,36,32
1657053826727,MATH 103A,B01,083779,Greenfeld; Be'Eri,6,0,36,30
1657053826727,MATH 103A,B02,083780,Greenfeld; Be'Eri,2,0,36,34
1657053826727,MATH 103A,B03,093562,Greenfeld; Be'Eri,2,0,36,34
1657053832917,MATH 105,A01,085443,Carter; Anne Toulson,14,0,35,21
1657053832917,MATH 105,A02,093477,Carter; Anne Toulson,20,0,35,15
1657053838973,MATH 109,A01,083213,Ganzberger; Geoffrey Michael,2,0,34,32
1657053838973,MATH 109,A02,083214,Ganzberger; Geoffrey Michael,2,0,34,32
1657053838973,MATH 109,A03,093478,Ganzberger; Geoffrey Michael,1,0,34,33
1657053838973,MATH 109,B01,083215,Ganzberger; Geoffrey Michael,1,0,32,31
1657053838973,MATH 109,B02,083216,Ganzberger; Geoffrey Michael,1,0,32,31
1657053838973,MATH 109,B03,093479,Ganzberger; Geoffrey Michael,6,0,32,26
1657053845018,MATH 142A,A01,083219,Chow; Bennett,6,0,32,26
1657053845018,MATH 142A,A02,083220,Chow; Bennett,10,0,32,22
1657053845018,MATH 142A,A03,093480,Chow; Bennett,7,0,32,25
1657053845018,MATH 142A,B03,093481,Chow; Bennett,7,0,32,25
1657053845018,MATH 142A,B04,093558,Chow; Bennett,11,0,32,21
1657053845018,MATH 142A,B05,093559,Chow; Bennett,6,0,32,26
1657053851052,MATH 193A,A01,083224,Rotar; Vladimir,7,0,34,27
1657053851052,MATH 193A,A02,083225,Rotar; Vladimir,5,0,34,29
1657053851052,MATH 193A,A03,083781,Rotar; Vladimir,1,0,34,33
1657053851052,MATH 193A,A04,083782,Rotar; Vladimir,6,0,34,28
1657053851052,MATH 193A,A05,093482,Rotar; Vladimir,6,0,34,28
1657053857077,MATH 197,001,091859,McAuley; Julian John,9999,0,9999,0
1657053857077,MATH 197,002,095566,Kedlaya; Kiran S.,9997,0,9999,2
1657053857077,MATH 197,003,095567,Xiao; Ming,9999,0,9999,0
1657053857077,MATH 197,004,095571,Perols; Johan Lars,9998,0,9999,1
1657053864137,COGS 9,A01,083615,Shannon; Kyle Michael,7,0,75,68
1657053870166,COGS 11,A01,083617,Boyle; Mary E. T.,20,0,48,28
1657053876192,COGS 13,A01,083071,Bastos; Amalia Pinkusfeld,9,0,71,62
1657053882214,COGS 14A,A01,092681,Semenuks; Arturs,0,1,100,100
1657053888240,COGS 14B,A01,083073,Cheng; Tzu-Han,5,0,63,58
1657053894268,COGS 17,A01,092677,Semenuks; Arturs,4,0,81,77
1657053900293,COGS 100,A01,083619,Allen; Michael Gordon,15,0,70,55
1657053906315,COGS 101A,A01,083621,Davis; Joshua Daniel,9,0,68,59
1657053912348,COGS 101B,A01,091572,Allen; Michael Gordon,8,0,65,57
1657053918370,COGS 101C,A01,083625,Delgado; Tania,17,0,35,18
1657053924397,COGS 107A,A01,083627,Boyle; Mary E. T.,13,0,60,47
1657053930420,COGS 118A,A01,083075,Gupta; Anjum,15,0,76,61
1657053936446,CSE 3,A50,083646,Miranda; Gregory Joseph,22,0,50,28
1657053942476,CSE 8A,A50,083650,Miranda; Gregory Joseph,17,1,56,39
1657053948511,CSE 11,A01,083080,Cao; Yingjun,4,15,40,36
1657053954545,CSE 12,A01,083652,Krause-Levy; Sophia Louisa,23,1,120,97
1657053960570,CSE 15L,A01,083654,Morris; Justin Loren,8,0,50,42
1657053960570,CSE 15L,A02,083655,Morris; Justin Loren,9,0,50,41
1657053966597,CSE 20,A01,083657,Tran; Khoa Dang,37,0,80,43
1657053972628,CSE 21,A01,095574,Bach; Quang Tran,21,0,48,27
1657053978659,CSE 30,A01,083084,Eldon; John,4,0,80,76
1657053978659,CSE 30,B01,095061,Bhaskar; Nishant,6,0,50,44
1657053984689,CSE 100,A01,083659,Cao; Yingjun,3,4,70,67
1657053990712,CSE 134B,A01,083661,Powell; Thomas Allan,19,0,100,81
1657053996737,CSE 140,A01,083663,Gungor; Onat,14,0,85,71
1657054002764,CSE 140L,A01,083088,Eldon; John,16,0,100,84
1657054008796,CSE 175,A01,083665,Kumar; Rakesh,3,0,25,22
1657054014832,CSE 190,A00,092507,Dubnov; Shlomo,7,0,20,13
1657054020864,ECE 45,A01,083139,Congero; Spencer William,5,0,75,70
1657054026972,ECE 65,A50,083695,Saad; Andrew S,12,0,30,18
1657054026972,ECE 65,A51,095125,Saad; Andrew S,25,0,26,1
1657054033001,ECE 109,A01,091882,Touri; Behrouz,16,0,70,54
1657054039043,ECE 180,A00,083140,Abi Samra; Nicholas Camill,1,0,30,29
1657054039043,ECE 180,B00,083141,Abi Samra; Nicholas Camill,0,0,30,30
1657054045092,MATH 10A,A01,083735,Patchell; Gregory David,1,0,30,29
1657054045092,MATH 10A,A02,083736,Patchell; Gregory David,20,0,30,10
1657054045092,MATH 10A,A03,083737,Patchell; Gregory David,16,0,30,14
1657054051119,MATH 10B,A01,083207,Lim; Seonhee,7,0,34,27
1657054051119,MATH 10B,A02,083208,Lim; Seonhee,9,0,35,26
1657054051119,MATH 10B,A03,093472,Lim; Seonhee,4,0,34,30
1657054051119,MATH 10B,B01,083739,Sinha; Shubham,9,0,30,21
1657054057155,MATH 18,A01,083743,Cinel; Cameron Alexander,6,0,30,24
1657054057155,MATH 18,A02,083744,Cinel; Cameron Alexander,15,0,30,15
1657054057155,MATH 18,A03,083745,Cinel; Cameron Alexander,8,0,30,22
1657054057155,MATH 18,B01,083748,Rideout; David Porter,4,0,37,33
1657054057155,MATH 18,B02,083749,Rideout; David Porter,3,0,36,33
1657054057155,MATH 18,B03,083750,Rideout; David Porter,2,0,37,35
1657054057155,MATH 18,B04,083751,Rideout; David Porter,5,0,36,31
1657054057155,MATH 18,B05,093473,Rideout; David Porter,4,0,36,32
1657054057155,MATH 18,B06,093474,Rideout; David Porter,5,0,36,31
1657054063178,MATH 20A,A01,083754,Zheng; Zequn,12,0,40,28
1657054069200,MATH 20B,A01,083756,Briones; Jor-el Thomas Caparas,1,0,36,35
1657054069200,MATH 20B,A02,083757,Briones; Jor-el Thomas Caparas,1,0,36,35
1657054069200,MATH 20B,A03,093475,Briones; Jor-el Thomas Caparas,0,0,36,36
1657054075224,MATH 20C,A01,083760,Briones; Jor-el Thomas Caparas,1,0,35,34
1657054075224,MATH 20C,A02,083761,Briones; Jor-el Thomas Caparas,8,0,35,27
1657054075224,MATH 20C,A03,093476,Briones; Jor-el Thomas Caparas,0,1,36,36
1657054075224,MATH 20C,B01,083762,Bach; Quang Tran,0,0,30,30
1657054081247,MATH 20D,A01,083765,Tran; Brian Kha,4,0,30,26
1657054081247,MATH 20D,A02,083766,Tran; Brian Kha,5,0,30,25
1657054081247,MATH 20D,A03,083767,Tran; Brian Kha,3,0,30,27
1657054087271,MATH 20E,A01,083771,Ganguly; Soumya,5,0,32,27
1657054087271,MATH 20E,A02,083772,Ganguly; Soumya,6,0,32,26
1657054087271,MATH 20E,B01,083773,Ciotti; Benjamin,18,0,35,17
1657054087271,MATH 20E,B02,083774,Ciotti; Benjamin,17,0,35,18
1657054093297,MATH 103A,A01,083777,Greenfeld; Be'Eri,2,0,36,34
1657054093297,MATH 103A,A02,083778,Greenfeld; Be'Eri,5,0,36,31
1657054093297,MATH 103A,A03,093561,Greenfeld; Be'Eri,4,0,36,32
1657054093297,MATH 103A,B01,083779,Greenfeld; Be'Eri,6,0,36,30
1657054093297,MATH 103A,B02,083780,Greenfeld; Be'Eri,2,0,36,34
1657054093297,MATH 103A,B03,093562,Greenfeld; Be'Eri,2,0,36,34
1657054099320,MATH 105,A01,085443,Carter; Anne Toulson,14,0,35,21
1657054099320,MATH 105,A02,093477,Carter; Anne Toulson,20,0,35,15
1657054105344,MATH 109,A01,083213,Ganzberger; Geoffrey Michael,2,0,34,32
1657054105344,MATH 109,A02,083214,Ganzberger; Geoffrey Michael,2,0,34,32
1657054105344,MATH 109,A03,093478,Ganzberger; Geoffrey Michael,1,0,34,33
1657054105344,MATH 109,B01,083215,Ganzberger; Geoffrey Michael,1,0,32,31
1657054105344,MATH 109,B02,083216,Ganzberger; Geoffrey Michael,1,0,32,31
1657054105344,MATH 109,B03,093479,Ganzberger; Geoffrey Michael,6,0,32,26
1657054111368,MATH 142A,A01,083219,Chow; Bennett,6,0,32,26
1657054111368,MATH 142A,A02,083220,Chow; Bennett,10,0,32,22
1657054111368,MATH 142A,A03,093480,Chow; Bennett,7,0,32,25
1657054111368,MATH 142A,B03,093481,Chow; Bennett,7,0,32,25
1657054111368,MATH 142A,B04,093558,Chow; Bennett,11,0,32,21
1657054111368,MATH 142A,B05,093559,Chow; Bennett,6,0,32,26
1657054117392,MATH 193A,A01,083224,Rotar; Vladimir,7,0,34,27
1657054117392,MATH 193A,A02,083225,Rotar; Vladimir,5,0,34,29
1657054117392,MATH 193A,A03,083781,Rotar; Vladimir,1,0,34,33
1657054117392,MATH 193A,A04,083782,Rotar; Vladimir,6,0,34,28
1657054117392,MATH 193A,A05,093482,Rotar; Vladimir,6,0,34,28
1657054123422,MATH 197,001,091859,McAuley; Julian John,9999,0,9999,0
1657054123422,MATH 197,002,095566,Kedlaya; Kiran S.,9997,0,9999,2
1657054123422,MATH 197,003,095567,Xiao; Ming,9999,0,9999,0
1657054123422,MATH 197,004,095571,Perols; Johan Lars,9998,0,9999,1
1657054130491,COGS 9,A01,083615,Shannon; Kyle Michael,7,0,75,68
1657054136514,COGS 11,A01,083617,Boyle; Mary E. T.,20,0,48,28
1657054142546,COGS 13,A01,083071,Bastos; Amalia Pinkusfeld,9,0,71,62
1657054148586,COGS 14A,A01,092681,Semenuks; Arturs,0,1,100,100
1657054154609,COGS 14B,A01,083073,Cheng; Tzu-Han,5,0,63,58
1657054160642,COGS 17,A01,092677,Semenuks; Arturs,4,0,81,77
1657054166665,COGS 100,A01,083619,Allen; Michael Gordon,15,0,70,55
1657054172688,COGS 101A,A01,083621,Davis; Joshua Daniel,9,0,68,59
1657054178713,COGS 101B,A01,091572,Allen; Michael Gordon,8,0,65,57
1657054184737,COGS 101C,A01,083625,Delgado; Tania,17,0,35,18
1657054190764,COGS 107A,A01,083627,Boyle; Mary E. T.,13,0,60,47
1657054196799,COGS 118A,A01,083075,Gupta; Anjum,15,0,76,61
1657054202829,CSE 3,A50,083646,Miranda; Gregory Joseph,22,0,50,28
1657054208857,CSE 8A,A50,083650,Miranda; Gregory Joseph,17,1,56,39
1657054214883,CSE 11,A01,083080,Cao; Yingjun,4,15,40,36
1657054220910,CSE 12,A01,083652,Krause-Levy; Sophia Louisa,23,1,120,97
1657054226937,CSE 15L,A01,083654,Morris; Justin Loren,8,0,50,42
1657054226937,CSE 15L,A02,083655,Morris; Justin Loren,9,0,50,41
1657054232970,CSE 20,A01,083657,Tran; Khoa Dang,37,0,80,43
1657054238994,CSE 21,A01,095574,Bach; Quang Tran,21,0,48,27
1657054245017,CSE 30,A01,083084,Eldon; John,4,0,80,76
1657054245017,CSE 30,B01,095061,Bhaskar; Nishant,6,0,50,44
1657054251039,CSE 100,A01,083659,Cao; Yingjun,3,4,70,67
1657054257070,CSE 134B,A01,083661,Powell; Thomas Allan,19,0,100,81
1657054263097,CSE 140,A01,083663,Gungor; Onat,14,0,85,71
1657054269124,CSE 140L,A01,083088,Eldon; John,16,0,100,84
1657054275148,CSE 175,A01,083665,Kumar; Rakesh,3,0,25,22
1657054281170,CSE 190,A00,092507,Dubnov; Shlomo,7,0,20,13
1657054287196,ECE 45,A01,083139,Congero; Spencer William,5,0,75,70
1657054293219,ECE 65,A50,083695,Saad; Andrew S,12,0,30,18
1657054293219,ECE 65,A51,095125,Saad; Andrew S,25,0,26,1
1657054299241,ECE 109,A01,091882,Touri; Behrouz,16,0,70,54
1657054305266,ECE 180,A00,083140,Abi Samra; Nicholas Camill,1,0,30,29
1657054305266,ECE 180,B00,083141,Abi Samra; Nicholas Camill,0,0,30,30
1657054311293,MATH 10A,A01,083735,Patchell; Gregory David,1,0,30,29
1657054311293,MATH 10A,A02,083736,Patchell; Gregory David,20,0,30,10
1657054311293,MATH 10A,A03,083737,Patchell; Gregory David,16,0,30,14
1657054317321,MATH 10B,A01,083207,Lim; Seonhee,7,0,34,27
1657054317321,MATH 10B,A02,083208,Lim; Seonhee,9,0,35,26
1657054317321,MATH 10B,A03,093472,Lim; Seonhee,4,0,34,30
1657054317321,MATH 10B,B01,083739,Sinha; Shubham,9,0,30,21
1657054323352,MATH 18,A01,083743,Cinel; Cameron Alexander,6,0,30,24
1657054323352,MATH 18,A02,083744,Cinel; Cameron Alexander,15,0,30,15
1657054323352,MATH 18,A03,083745,Cinel; Cameron Alexander,8,0,30,22
1657054323352,MATH 18,B01,083748,Rideout; David Porter,4,0,37,33
1657054323352,MATH 18,B02,083749,Rideout; David Porter,3,0,36,33
1657054323352,MATH 18,B03,083750,Rideout; David Porter,2,0,37,35
1657054323352,MATH 18,B04,083751,Rideout; David Porter,5,0,36,31
1657054323352,MATH 18,B05,093473,Rideout; David Porter,4,0,36,32
1657054323352,MATH 18,B06,093474,Rideout; David Porter,5,0,36,31
1657054329379,MATH 20A,A01,083754,Zheng; Zequn,12,0,40,28
1657054335410,MATH 20B,A01,083756,Briones; Jor-el Thomas Caparas,1,0,36,35
1657054335410,MATH 20B,A02,083757,Briones; Jor-el Thomas Caparas,1,0,36,35
1657054335410,MATH 20B,A03,093475,Briones; Jor-el Thomas Caparas,0,0,36,36
1657054341446,MATH 20C,A01,083760,Briones; Jor-el Thomas Caparas,1,0,35,34
1657054341446,MATH 20C,A02,083761,Briones; Jor-el Thomas Caparas,8,0,35,27
1657054341446,MATH 20C,A03,093476,Briones; Jor-el Thomas Caparas,0,1,36,36
1657054341446,MATH 20C,B01,083762,Bach; Quang Tran,0,0,30,30
1657054347482,MATH 20D,A01,083765,Tran; Brian Kha,4,0,30,26
1657054347482,MATH 20D,A02,083766,Tran; Brian Kha,5,0,30,25
1657054347482,MATH 20D,A03,083767,Tran; Brian Kha,3,0,30,27
1657054353525,MATH 20E,A01,083771,Ganguly; Soumya,5,0,32,27
1657054353525,MATH 20E,A02,083772,Ganguly; Soumya,6,0,32,26
1657054353525,MATH 20E,B01,083773,Ciotti; Benjamin,18,0,35,17
1657054353525,MATH 20E,B02,083774,Ciotti; Benjamin,17,0,35,18
1657054359564,MATH 103A,A01,083777,Greenfeld; Be'Eri,2,0,36,34
1657054359564,MATH 103A,A02,083778,Greenfeld; Be'Eri,5,0,36,31
1657054359564,MATH 103A,A03,093561,Greenfeld; Be'Eri,4,0,36,32
1657054359564,MATH 103A,B01,083779,Greenfeld; Be'Eri,6,0,36,30
1657054359564,MATH 103A,B02,083780,Greenfeld; Be'Eri,2,0,36,34
1657054359564,MATH 103A,B03,093562,Greenfeld; Be'Eri,2,0,36,34
1657054365587,MATH 105,A01,085443,Carter; Anne Toulson,14,0,35,21
1657054365587,MATH 105,A02,093477,Carter; Anne Toulson,20,0,35,15
1657054371611,MATH 109,A01,083213,Ganzberger; Geoffrey Michael,2,0,34,32
1657054371611,MATH 109,A02,083214,Ganzberger; Geoffrey Michael,2,0,34,32
1657054371611,MATH 109,A03,093478,Ganzberger; Geoffrey Michael,1,0,34,33
1657054371611,MATH 109,B01,083215,Ganzberger; Geoffrey Michael,1,0,32,31
1657054371611,MATH 109,B02,083216,Ganzberger; Geoffrey Michael,1,0,32,31
1657054371611,MATH 109,B03,093479,Ganzberger; Geoffrey Michael,6,0,32,26
1657054377642,MATH 142A,A01,083219,Chow; Bennett,6,0,32,26
1657054377642,MATH 142A,A02,083220,Chow; Bennett,10,0,32,22
1657054377642,MATH 142A,A03,093480,Chow; Bennett,7,0,32,25
1657054377642,MATH 142A,B03,093481,Chow; Bennett,7,0,32,25
1657054377642,MATH 142A,B04,093558,Chow; Bennett,11,0,32,21
1657054377642,MATH 142A,B05,093559,Chow; Bennett,6,0,32,26
1657054383672,MATH 193A,A01,083224,Rotar; Vladimir,7,0,34,27
1657054383672,MATH 193A,A02,083225,Rotar; Vladimir,5,0,34,29
1657054383672,MATH 193A,A03,083781,Rotar; Vladimir,1,0,34,33
1657054383672,MATH 193A,A04,083782,Rotar; Vladimir,6,0,34,28
1657054383672,MATH 193A,A05,093482,Rotar; Vladimir,6,0,34,28
1657054389701,MATH 197,001,091859,McAuley; Julian John,9999,0,9999,0
1657054389701,MATH 197,002,095566,Kedlaya; Kiran S.,9997,0,9999,2
1657054389701,MATH 197,003,095567,Xiao; Ming,9999,0,9999,0
1657054389701,MATH 197,004,095571,Perols; Johan Lars,9998,0,9999,1
1657054396762,COGS 9,A01,083615,Shannon; Kyle Michael,7,0,75,68
1657054402794,COGS 11,A01,083617,Boyle; Mary E. T.,20,0,48,28
1657054408816,COGS 13,A01,083071,Bastos; Amalia Pinkusfeld,9,0,71,62
1657054414843,COGS 14A,A01,092681,Semenuks; Arturs,0,1,100,100
1657054420867,COGS 14B,A01,083073,Cheng; Tzu-Han,5,0,63,58
1657054426890,COGS 17,A01,092677,Semenuks; Arturs,4,0,81,77
1657054432924,COGS 100,A01,083619,Allen; Michael Gordon,15,0,70,55
1657054438953,COGS 101A,A01,083621,Davis; Joshua Daniel,9,0,68,59
1657054444980,COGS 101B,A01,091572,Allen; Michael Gordon,8,0,65,57
1657054451002,COGS 101C,A01,083625,Delgado; Tania,17,0,35,18
1657054457035,COGS 107A,A01,083627,Boyle; Mary E. T.,13,0,60,47
1657054463068,COGS 118A,A01,083075,Gupta; Anjum,15,0,76,61
1657054469099,CSE 3,A50,083646,Miranda; Gregory Joseph,22,0,50,28
1657054475125,CSE 8A,A50,083650,Miranda; Gregory Joseph,17,1,56,39
1657054481151,CSE 11,A01,083080,Cao; Yingjun,4,15,40,36
1657054487179,CSE 12,A01,083652,Krause-Levy; Sophia Louisa,23,1,120,97
1657054493205,CSE 15L,A01,083654,Morris; Justin Loren,8,0,50,42
1657054493205,CSE 15L,A02,083655,Morris; Justin Loren,9,0,50,41
1657054499232,CSE 20,A01,083657,Tran; Khoa Dang,37,0,80,43
1657054505289,CSE 21,A01,095574,Bach; Quang Tran,21,0,48,27
1657054511319,CSE 30,A01,083084,Eldon; John,4,0,80,76
1657054511319,CSE 30,B01,095061,Bhaskar; Nishant,6,0,50,44
1657054517342,CSE 100,A01,083659,Cao; Yingjun,3,4,70,67
1657054523367,CSE 134B,A01,083661,Powell; Thomas Allan,19,0,100,81
1657054529407,CSE 140,A01,083663,Gungor; Onat,14,0,85,71
1657054535431,CSE 140L,A01,083088,Eldon; John,16,0,100,84
1657054541465,CSE 175,A01,083665,Kumar; Rakesh,3,0,25,22
1657054547486,CSE 190,A00,092507,Dubnov; Shlomo,7,0,20,13
1657054553521,ECE 45,A01,083139,Congero; Spencer William,5,0,75,70
1657054559552,ECE 65,A50,083695,Saad; Andrew S,12,0,30,18
1657054559552,ECE 65,A51,095125,Saad; Andrew S,25,0,26,1
1657054565580,ECE 109,A01,091882,Touri; Behrouz,16,0,70,54
1657054571605,ECE 180,A00,083140,Abi Samra; Nicholas Camill,1,0,30,29
1657054571605,ECE 180,B00,083141,Abi Samra; Nicholas Camill,0,0,30,30
1657054577634,MATH 10A,A01,083735,Patchell; Gregory David,1,0,30,29
1657054577634,MATH 10A,A02,083736,Patchell; Gregory David,20,0,30,10
1657054577634,MATH 10A,A03,083737,Patchell; Gregory David,16,0,30,14
1657054583662,MATH 10B,A01,083207,Lim; Seonhee,7,0,34,27
1657054583662,MATH 10B,A02,083208,Lim; Seonhee,9,0,35,26
1657054583662,MATH 10B,A03,093472,Lim; Seonhee,4,0,34,30
1657054583662,MATH 10B,B01,083739,Sinha; Shubham,9,0,30,21
1657054589699,MATH 18,A01,083743,Cinel; Cameron Alexander,6,0,30,24
1657054589699,MATH 18,A02,083744,Cinel; Cameron Alexander,15,0,30,15
1657054589699,MATH 18,A03,083745,Cinel; Cameron Alexander,8,0,30,22
1657054589699,MATH 18,B01,083748,Rideout; David Porter,4,0,37,33
1657054589699,MATH 18,B02,083749,Rideout; David Porter,3,0,36,33
1657054589699,MATH 18,B03,083750,Rideout; David Porter,2,0,37,35
1657054589699,MATH 18,B04,083751,Rideout; David Porter,5,0,36,31
1657054589699,MATH 18,B05,093473,Rideout; David Porter,4,0,36,32
1657054589699,MATH 18,B06,093474,Rideout; David Porter,5,0,36,31
1657054595736,MATH 20A,A01,083754,Zheng; Zequn,12,0,40,28
1657054601773,MATH 20B,A01,083756,Briones; Jor-el Thomas Caparas,1,0,36,35
1657054601773,MATH 20B,A02,083757,Briones; Jor-el Thomas Caparas,1,0,36,35
1657054601773,MATH 20B,A03,093475,Briones; Jor-el Thomas Caparas,0,0,36,36
1657054607806,MATH 20C,A01,083760,Briones; Jor-el Thomas Caparas,1,0,35,34
1657054607806,MATH 20C,A02,083761,Briones; Jor-el Thomas Caparas,8,0,35,27
1657054607806,MATH 20C,A03,093476,Briones; Jor-el Thomas Caparas,0,1,36,36
1657054607806,MATH 20C,B01,083762,Bach; Quang Tran,0,0,30,30
1657054613829,MATH 20D,A01,083765,Tran; Brian Kha,4,0,30,26
1657054613829,MATH 20D,A02,083766,Tran; Brian Kha,5,0,30,25
1657054613829,MATH 20D,A03,083767,Tran; Brian Kha,3,0,30,27
1657054619858,MATH 20E,A01,083771,Ganguly; Soumya,5,0,32,27
1657054619858,MATH 20E,A02,083772,Ganguly; Soumya,6,0,32,26
1657054619858,MATH 20E,B01,083773,Ciotti; Benjamin,18,0,35,17
1657054619858,MATH 20E,B02,083774,Ciotti; Benjamin,17,0,35,18
1657054625976,MATH 103A,A01,083777,Greenfeld; Be'Eri,2,0,36,34
1657054625976,MATH 103A,A02,083778,Greenfeld; Be'Eri,5,0,36,31
1657054625976,MATH 103A,A03,093561,Greenfeld; Be'Eri,4,0,36,32
1657054625976,MATH 103A,B01,083779,Greenfeld; Be'Eri,6,0,36,30
1657054625976,MATH 103A,B02,083780,Greenfeld; Be'Eri,2,0,36,34
1657054625976,MATH 103A,B03,093562,Greenfeld; Be'Eri,2,0,36,34
1657054632004,MATH 105,A01,085443,Carter; Anne Toulson,14,0,35,21
1657054632004,MATH 105,A02,093477,Carter; Anne Toulson,20,0,35,15
1657054638027,MATH 109,A01,083213,Ganzberger; Geoffrey Michael,2,0,34,32
1657054638027,MATH 109,A02,083214,Ganzberger; Geoffrey Michael,2,0,34,32
1657054638027,MATH 109,A03,093478,Ganzberger; Geoffrey Michael,1,0,34,33
1657054638027,MATH 109,B01,083215,Ganzberger; Geoffrey Michael,1,0,32,31
1657054638027,MATH 109,B02,083216,Ganzberger; Geoffrey Michael,1,0,32,31
1657054638027,MATH 109,B03,093479,Ganzberger; Geoffrey Michael,6,0,32,26
1657054644056,MATH 142A,A01,083219,Chow; Bennett,6,0,32,26
1657054644056,MATH 142A,A02,083220,Chow; Bennett,10,0,32,22
1657054644056,MATH 142A,A03,093480,Chow; Bennett,7,0,32,25
1657054644056,MATH 142A,B03,093481,Chow; Bennett,7,0,32,25
1657054644056,MATH 142A,B04,093558,Chow; Bennett,11,0,32,21
1657054644056,MATH 142A,B05,093559,Chow; Bennett,6,0,32,26
1657054650085,MATH 193A,A01,083224,Rotar; Vladimir,7,0,34,27
1657054650085,MATH 193A,A02,083225,Rotar; Vladimir,5,0,34,29
1657054650085,MATH 193A,A03,083781,Rotar; Vladimir,1,0,34,33
1657054650085,MATH 193A,A04,083782,Rotar; Vladimir,6,0,34,28
1657054650085,MATH 193A,A05,093482,Rotar; Vladimir,6,0,34,28
1657054656119,MATH 197,001,091859,McAuley; Julian John,9999,0,9999,0
1657054656119,MATH 197,002,095566,Kedlaya; Kiran S.,9997,0,9999,2
1657054656119,MATH 197,003,095567,Xiao; Ming,9999,0,9999,0
1657054656119,MATH 197,004,095571,Perols; Johan Lars,9998,0,9999,1
1657054663188,COGS 9,A01,083615,Shannon; Kyle Michael,7,0,75,68
1657054669210,COGS 11,A01,083617,Boyle; Mary E. T.,20,0,48,28
1657054675235,COGS 13,A01,083071,Bastos; Amalia Pinkusfeld,9,0,71,62
1657054681266,COGS 14A,A01,092681,Semenuks; Arturs,0,1,100,100
1657054687287,COGS 14B,A01,083073,Cheng; Tzu-Han,5,0,63,58
1657054693309,COGS 17,A01,092677,Semenuks; Arturs,4,0,81,77
1657054699331,COGS 100,A01,083619,Allen; Michael Gordon,15,0,70,55
1657054705354,COGS 101A,A01,083621,Davis; Joshua Daniel,9,0,68,59
1657054711375,COGS 101B,A01,091572,Allen; Michael Gordon,8,0,65,57
1657054717410,COGS 101C,A01,083625,Delgado; Tania,17,0,35,18
1657054723437,COGS 107A,A01,083627,Boyle; Mary E. T.,13,0,60,47
1657054729464,COGS 118A,A01,083075,Gupta; Anjum,15,0,76,61
1657054735497,CSE 3,A50,083646,Miranda; Gregory Joseph,22,0,50,28
1657054741519,CSE 8A,A50,083650,Miranda; Gregory Joseph,17,1,56,39
1657054747543,CSE 11,A01,083080,Cao; Yingjun,4,15,40,36
1657054753585,CSE 12,A01,083652,Krause-Levy; Sophia Louisa,23,1,120,97
1657054759614,CSE 15L,A01,083654,Morris; Justin Loren,8,0,50,42
1657054759614,CSE 15L,A02,083655,Morris; Justin Loren,9,0,50,41
1657054765640,CSE 20,A01,083657,Tran; Khoa Dang,37,0,80,43
1657054771668,CSE 21,A01,095574,Bach; Quang Tran,21,0,48,27
1657054777698,CSE 30,A01,083084,Eldon; John,4,0,80,76
1657054777698,CSE 30,B01,095061,Bhaskar; Nishant,6,0,50,44
1657054783720,CSE 100,A01,083659,Cao; Yingjun,3,4,70,67
1657054789741,CSE 134B,A01,083661,Powell; Thomas Allan,19,0,100,81
1657054795776,CSE 140,A01,083663,Gungor; Onat,14,0,85,71
1657054801822,CSE 140L,A01,083088,Eldon; John,16,0,100,84
1657054807848,CSE 175,A01,083665,Kumar; Rakesh,3,0,25,22
1657054813874,CSE 190,A00,092507,Dubnov; Shlomo,7,0,20,13
1657054819897,ECE 45,A01,083139,Congero; Spencer William,5,0,75,70
1657054825923,ECE 65,A50,083695,Saad; Andrew S,12,0,30,18
1657054825923,ECE 65,A51,095125,Saad; Andrew S,25,0,26,1
1657054831949,ECE 109,A01,091882,Touri; Behrouz,16,0,70,54
1657054837990,ECE 180,A00,083140,Abi Samra; Nicholas Camill,1,0,30,29
1657054837990,ECE 180,B00,083141,Abi Samra; Nicholas Camill,0,0,30,30
1657054844022,MATH 10A,A01,083735,Patchell; Gregory David,1,0,30,29
1657054844022,MATH 10A,A02,083736,Patchell; Gregory David,20,0,30,10
1657054844022,MATH 10A,A03,083737,Patchell; Gregory David,16,0,30,14
1657054850047,MATH 10B,A01,083207,Lim; Seonhee,7,0,34,27
1657054850047,MATH 10B,A02,083208,Lim; Seonhee,9,0,35,26
1657054850047,MATH 10B,A03,093472,Lim; Seonhee,4,0,34,30
1657054850047,MATH 10B,B01,083739,Sinha; Shubham,9,0,30,21
1657054856070,MATH 18,A01,083743,Cinel; Cameron Alexander,6,0,30,24
1657054856070,MATH 18,A02,083744,Cinel; Cameron Alexander,15,0,30,15
1657054856070,MATH 18,A03,083745,Cinel; Cameron Alexander,8,0,30,22
1657054856070,MATH 18,B01,083748,Rideout; David Porter,4,0,37,33
1657054856070,MATH 18,B02,083749,Rideout; David Porter,3,0,36,33
1657054856070,MATH 18,B03,083750,Rideout; David Porter,2,0,37,35
1657054856070,MATH 18,B04,083751,Rideout; David Porter,5,0,36,31
1657054856070,MATH 18,B05,093473,Rideout; David Porter,4,0,36,32
1657054856070,MATH 18,B06,093474,Rideout; David Porter,5,0,36,31
1657054862096,MATH 20A,A01,083754,Zheng; Zequn,12,0,40,28
1657054868123,MATH 20B,A01,083756,Briones; Jor-el Thomas Caparas,1,0,36,35
1657054868123,MATH 20B,A02,083757,Briones; Jor-el Thomas Caparas,1,0,36,35
1657054868123,MATH 20B,A03,093475,Briones; Jor-el Thomas Caparas,0,0,36,36
1657054874151,MATH 20C,A01,083760,Briones; Jor-el Thomas Caparas,1,0,35,34
1657054874151,MATH 20C,A02,083761,Briones; Jor-el Thomas Caparas,8,0,35,27
1657054874151,MATH 20C,A03,093476,Briones; Jor-el Thomas Caparas,0,1,36,36
1657054874151,MATH 20C,B01,083762,Bach; Quang Tran,0,0,30,30
1657054880178,MATH 20D,A01,083765,Tran; Brian Kha,4,0,30,26
1657054880178,MATH 20D,A02,083766,Tran; Brian Kha,5,0,30,25
1657054880178,MATH 20D,A03,083767,Tran; Brian Kha,3,0,30,27
1657054886212,MATH 20E,A01,083771,Ganguly; Soumya,5,0,32,27
1657054886212,MATH 20E,A02,083772,Ganguly; Soumya,6,0,32,26
1657054886212,MATH 20E,B01,083773,Ciotti; Benjamin,18,0,35,17
1657054886212,MATH 20E,B02,083774,Ciotti; Benjamin,17,0,35,18
1657054892242,MATH 103A,A01,083777,Greenfeld; Be'Eri,2,0,36,34
1657054892242,MATH 103A,A02,083778,Greenfeld; Be'Eri,5,0,36,31
1657054892242,MATH 103A,A03,093561,Greenfeld; Be'Eri,4,0,36,32
1657054892242,MATH 103A,B01,083779,Greenfeld; Be'Eri,6,0,36,30
1657054892242,MATH 103A,B02,083780,Greenfeld; Be'Eri,2,0,36,34
1657054892242,MATH 103A,B03,093562,Greenfeld; Be'Eri,2,0,36,34
1657054898266,MATH 105,A01,085443,Carter; Anne Toulson,14,0,35,21
1657054898266,MATH 105,A02,093477,Carter; Anne Toulson,20,0,35,15
1657054904312,MATH 109,A01,083213,Ganzberger; Geoffrey Michael,2,0,34,32
1657054904312,MATH 109,A02,083214,Ganzberger; Geoffrey Michael,2,0,34,32
1657054904312,MATH 109,A03,093478,Ganzberger; Geoffrey Michael,1,0,34,33
1657054904312,MATH 109,B01,083215,Ganzberger; Geoffrey Michael,1,0,32,31
1657054904312,MATH 109,B02,083216,Ganzberger; Geoffrey Michael,1,0,32,31
1657054904312,MATH 109,B03,093479,Ganzberger; Geoffrey Michael,6,0,32,26
1657054910342,MATH 142A,A01,083219,Chow; Bennett,6,0,32,26
1657054910342,MATH 142A,A02,083220,Chow; Bennett,10,0,32,22
1657054910342,MATH 142A,A03,093480,Chow; Bennett,7,0,32,25
1657054910342,MATH 142A,B03,093481,Chow; Bennett,7,0,32,25
1657054910342,MATH 142A,B04,093558,Chow; Bennett,11,0,32,21
1657054910342,MATH 142A,B05,093559,Chow; Bennett,6,0,32,26
1657054916368,MATH 193A,A01,083224,Rotar; Vladimir,7,0,34,27
1657054916368,MATH 193A,A02,083225,Rotar; Vladimir,5,0,34,29
1657054916368,MATH 193A,A03,083781,Rotar; Vladimir,1,0,34,33
1657054916368,MATH 193A,A04,083782,Rotar; Vladimir,6,0,34,28
1657054916368,MATH 193A,A05,093482,Rotar; Vladimir,6,0,34,28
1657054922396,MATH 197,001,091859,McAuley; Julian John,9999,0,9999,0
1657054922396,MATH 197,002,095566,Kedlaya; Kiran S.,9997,0,9999,2
1657054922396,MATH 197,003,095567,Xiao; Ming,9999,0,9999,0
1657054922396,MATH 197,004,095571,Perols; Johan Lars,9998,0,9999,1
1657054929471,COGS 9,A01,083615,Shannon; Kyle Michael,7,0,75,68
1657054935494,COGS 11,A01,083617,Boyle; Mary E. T.,20,0,48,28
1657054941518,COGS 13,A01,083071,Bastos; Amalia Pinkusfeld,9,0,71,62
1657054947561,COGS 14A,A01,092681,Semenuks; Arturs,0,1,100,100
1657054953587,COGS 14B,A01,083073,Cheng; Tzu-Han,5,0,63,58
1657054959616,COGS 17,A01,092677,Semenuks; Arturs,4,0,81,77
1657054965640,COGS 100,A01,083619,Allen; Michael Gordon,15,0,70,55
1657054971667,COGS 101A,A01,083621,Davis; Joshua Daniel,9,0,68,59
1657054977692,COGS 101B,A01,091572,Allen; Michael Gordon,8,0,65,57
1657054983718,COGS 101C,A01,083625,Delgado; Tania,17,0,35,18
1657054989741,COGS 107A,A01,083627,Boyle; Mary E. T.,13,0,60,47
1657054995779,COGS 118A,A01,083075,Gupta; Anjum,15,0,76,61
1657055001802,CSE 3,A50,083646,Miranda; Gregory Joseph,22,0,50,28
1657055007827,CSE 8A,A50,083650,Miranda; Gregory Joseph,17,1,56,39
1657055013857,CSE 11,A01,083080,Cao; Yingjun,4,15,40,36
1657055019880,CSE 12,A01,083652,Krause-Levy; Sophia Louisa,23,1,120,97
1657055025908,CSE 15L,A01,083654,Morris; Justin Loren,8,0,50,42
1657055025908,CSE 15L,A02,083655,Morris; Justin Loren,9,0,50,41
1657055031937,CSE 20,A01,083657,Tran; Khoa Dang,37,0,80,43
1657055037962,CSE 21,A01,095574,Bach; Quang Tran,21,0,48,27
1657055043984,CSE 30,A01,083084,Eldon; John,4,0,80,76
1657055043984,CSE 30,B01,095061,Bhaskar; Nishant,6,0,50,44
1657055050007,CSE 100,A01,083659,Cao; Yingjun,3,4,70,67
1657055056030,CSE 134B,A01,083661,Powell; Thomas Allan,19,0,100,81
1657055062055,CSE 140,A01,083663,Gungor; Onat,14,0,85,71
1657055068078,CSE 140L,A01,083088,Eldon; John,16,0,100,84
1657055074110,CSE 175,A01,083665,Kumar; Rakesh,3,0,25,22
1657055080133,CSE 190,A00,092507,Dubnov; Shlomo,7,0,20,13
1657055086155,ECE 45,A01,083139,Congero; Spencer William,5,0,75,70
1657055092178,ECE 65,A50,083695,Saad; Andrew S,12,0,30,18
1657055092178,ECE 65,A51,095125,Saad; Andrew S,25,0,26,1
1657055098203,ECE 109,A01,091882,Touri; Behrouz,16,0,70,54
1657055104227,ECE 180,A00,083140,Abi Samra; Nicholas Camill,1,0,30,29
1657055104227,ECE 180,B00,083141,Abi Samra; Nicholas Camill,0,0,30,30
1657055110254,MATH 10A,A01,083735,Patchell; Gregory David,1,0,30,29
1657055110254,MATH 10A,A02,083736,Patchell; Gregory David,20,0,30,10
1657055110254,MATH 10A,A03,083737,Patchell; Gregory David,16,0,30,14
1657055116279,MATH 10B,A01,083207,Lim; Seonhee,7,0,34,27
1657055116279,MATH 10B,A02,083208,Lim; Seonhee,9,0,35,26
1657055116279,MATH 10B,A03,093472,Lim; Seonhee,4,0,34,30
1657055116279,MATH 10B,B01,083739,Sinha; Shubham,9,0,30,21
1657055122305,MATH 18,A01,083743,Cinel; Cameron Alexander,6,0,30,24
1657055122305,MATH 18,A02,083744,Cinel; Cameron Alexander,15,0,30,15
1657055122305,MATH 18,A03,083745,Cinel; Cameron Alexander,8,0,30,22
1657055122305,MATH 18,B01,083748,Rideout; David Porter,4,0,37,33
1657055122305,MATH 18,B02,083749,Rideout; David Porter,3,0,36,33
1657055122305,MATH 18,B03,083750,Rideout; David Porter,2,0,37,35
1657055122305,MATH 18,B04,083751,Rideout; David Porter,5,0,36,31
1657055122305,MATH 18,B05,093473,Rideout; David Porter,4,0,36,32
1657055122305,MATH 18,B06,093474,Rideout; David Porter,5,0,36,31
1657055128331,MATH 20A,A01,083754,Zheng; Zequn,12,0,40,28
1657055134355,MATH 20B,A01,083756,Briones; Jor-el Thomas Caparas,1,0,36,35
1657055134355,MATH 20B,A02,083757,Briones; Jor-el Thomas Caparas,1,0,36,35
1657055134355,MATH 20B,A03,093475,Briones; Jor-el Thomas Caparas,0,0,36,36
1657055140379,MATH 20C,A01,083760,Briones; Jor-el Thomas Caparas,1,0,35,34
1657055140379,MATH 20C,A02,083761,Briones; Jor-el Thomas Caparas,8,0,35,27
1657055140379,MATH 20C,A03,093476,Briones; Jor-el Thomas Caparas,0,1,36,36
1657055140379,MATH 20C,B01,083762,Bach; Quang Tran,0,0,30,30
1657055146404,MATH 20D,A01,083765,Tran; Brian Kha,4,0,30,26
1657055146404,MATH 20D,A02,083766,Tran; Brian Kha,5,0,30,25
1657055146404,MATH 20D,A03,083767,Tran; Brian Kha,3,0,30,27
1657055152435,MATH 20E,A01,083771,Ganguly; Soumya,5,0,32,27
1657055152435,MATH 20E,A02,083772,Ganguly; Soumya,6,0,32,26
1657055152435,MATH 20E,B01,083773,Ciotti; Benjamin,18,0,35,17
1657055152435,MATH 20E,B02,083774,Ciotti; Benjamin,17,0,35,18
1657055158458,MATH 103A,A01,083777,Greenfeld; Be'Eri,2,0,36,34
1657055158458,MATH 103A,A02,083778,Greenfeld; Be'Eri,5,0,36,31
1657055158458,MATH 103A,A03,093561,Greenfeld; Be'Eri,4,0,36,32
1657055158458,MATH 103A,B01,083779,Greenfeld; Be'Eri,6,0,36,30
1657055158458,MATH 103A,B02,083780,Greenfeld; Be'Eri,2,0,36,34
1657055158458,MATH 103A,B03,093562,Greenfeld; Be'Eri,2,0,36,34
1657055164485,MATH 105,A01,085443,Carter; Anne Toulson,14,0,35,21
1657055164485,MATH 105,A02,093477,Carter; Anne Toulson,20,0,35,15
1657055170515,MATH 109,A01,083213,Ganzberger; Geoffrey Michael,2,0,34,32
1657055170515,MATH 109,A02,083214,Ganzberger; Geoffrey Michael,2,0,34,32
1657055170515,MATH 109,A03,093478,Ganzberger; Geoffrey Michael,1,0,34,33
1657055170515,MATH 109,B01,083215,Ganzberger; Geoffrey Michael,1,0,32,31
1657055170515,MATH 109,B02,083216,Ganzberger; Geoffrey Michael,1,0,32,31
1657055170515,MATH 109,B03,093479,Ganzberger; Geoffrey Michael,6,0,32,26
1657055176556,MATH 142A,A01,083219,Chow; Bennett,6,0,32,26
1657055176556,MATH 142A,A02,083220,Chow; Bennett,10,0,32,22
1657055176556,MATH 142A,A03,093480,Chow; Bennett,7,0,32,25
1657055176556,MATH 142A,B03,093481,Chow; Bennett,7,0,32,25
1657055176556,MATH 142A,B04,093558,Chow; Bennett,11,0,32,21
1657055176556,MATH 142A,B05,093559,Chow; Bennett,6,0,32,26
1657055182583,MATH 193A,A01,083224,Rotar; Vladimir,7,0,34,27
1657055182583,MATH 193A,A02,083225,Rotar; Vladimir,5,0,34,29
1657055182583,MATH 193A,A03,083781,Rotar; Vladimir,1,0,34,33
1657055182583,MATH 193A,A04,083782,Rotar; Vladimir,6,0,34,28
1657055182583,MATH 193A,A05,093482,Rotar; Vladimir,6,0,34,28
1657055188608,MATH 197,001,091859,McAuley; Julian John,9999,0,9999,0
1657055188608,MATH 197,002,095566,Kedlaya; Kiran S.,9997,0,9999,2
1657055188608,MATH 197,003,095567,Xiao; Ming,9999,0,9999,0
1657055188608,MATH 197,004,095571,Perols; Johan Lars,9998,0,9999,1
1657055195662,COGS 9,A01,083615,Shannon; Kyle Michael,7,0,75,68
1657055201684,COGS 11,A01,083617,Boyle; Mary E. T.,20,0,48,28
1657055207719,COGS 13,A01,083071,Bastos; Amalia Pinkusfeld,9,0,71,62
1657055213741,COGS 14A,A01,092681,Semenuks; Arturs,0,1,100,100
1657055219852,COGS 14B,A01,083073,Cheng; Tzu-Han,5,0,63,58
1657055225875,COGS 17,A01,092677,Semenuks; Arturs,4,0,81,77
1657055231896,COGS 100,A01,083619,Allen; Michael Gordon,15,0,70,55
1657055237919,COGS 101A,A01,083621,Davis; Joshua Daniel,9,0,68,59
1657055243943,COGS 101B,A01,091572,Allen; Michael Gordon,8,0,65,57
1657055249965,COGS 101C,A01,083625,Delgado; Tania,17,0,35,18
1657055255989,COGS 107A,A01,083627,Boyle; Mary E. T.,13,0,60,47
1657055262012,COGS 118A,A01,083075,Gupta; Anjum,15,0,76,61
1657055268041,CSE 3,A50,083646,Miranda; Gregory Joseph,22,0,50,28
1657055274069,CSE 8A,A50,083650,Miranda; Gregory Joseph,17,1,56,39
1657055280092,CSE 11,A01,083080,Cao; Yingjun,4,15,40,36
1657055286135,CSE 12,A01,083652,Krause-Levy; Sophia Louisa,23,1,120,97
1657055292159,CSE 15L,A01,083654,Morris; Justin Loren,8,0,50,42
1657055292159,CSE 15L,A02,083655,Morris; Justin Loren,9,0,50,41
1657055298186,CSE 20,A01,083657,Tran; Khoa Dang,37,0,80,43
1657055304213,CSE 21,A01,095574,Bach; Quang Tran,21,0,48,27
1657055310243,CSE 30,A01,083084,Eldon; John,4,0,80,76
1657055310243,CSE 30,B01,095061,Bhaskar; Nishant,6,0,50,44
1657055316264,CSE 100,A01,083659,Cao; Yingjun,3,4,70,67
1657055322292,CSE 134B,A01,083661,Powell; Thomas Allan,19,0,100,81
1657055328329,CSE 140,A01,083663,Gungor; Onat,14,0,85,71
1657055334353,CSE 140L,A01,083088,Eldon; John,16,0,100,84
1657055340380,CSE 175,A01,083665,Kumar; Rakesh,3,0,25,22
1657055346409,CSE 190,A00,092507,Dubnov; Shlomo,7,0,20,13
1657055352437,ECE 45,A01,083139,Congero; Spencer William,5,0,75,70
1657055358462,ECE 65,A50,083695,Saad; Andrew S,12,0,30,18
1657055358462,ECE 65,A51,095125,Saad; Andrew S,25,0,26,1
1657055364498,ECE 109,A01,091882,Touri; Behrouz,16,0,70,54
1657055370524,ECE 180,A00,083140,Abi Samra; Nicholas Camill,1,0,30,29
1657055370524,ECE 180,B00,083141,Abi Samra; Nicholas Camill,0,0,30,30
1657055376546,MATH 10A,A01,083735,Patchell; Gregory David,1,0,30,29
1657055376546,MATH 10A,A02,083736,Patchell; Gregory David,20,0,30,10
1657055376546,MATH 10A,A03,083737,Patchell; Gregory David,16,0,30,14
1657055382582,MATH 10B,A01,083207,Lim; Seonhee,7,0,34,27
1657055382582,MATH 10B,A02,083208,Lim; Seonhee,9,0,35,26
1657055382582,MATH 10B,A03,093472,Lim; Seonhee,4,0,34,30
1657055382582,MATH 10B,B01,083739,Sinha; Shubham,9,0,30,21
1657055388612,MATH 18,A01,083743,Cinel; Cameron Alexander,6,0,30,24
1657055388612,MATH 18,A02,083744,Cinel; Cameron Alexander,15,0,30,15
1657055388612,MATH 18,A03,083745,Cinel; Cameron Alexander,8,0,30,22
1657055388612,MATH 18,B01,083748,Rideout; David Porter,4,0,37,33
1657055388612,MATH 18,B02,083749,Rideout; David Porter,3,0,36,33
1657055388612,MATH 18,B03,083750,Rideout; David Porter,2,0,37,35
1657055388612,MATH 18,B04,083751,Rideout; David Porter,5,0,36,31
1657055388612,MATH 18,B05,093473,Rideout; David Porter,4,0,36,32
1657055388612,MATH 18,B06,093474,Rideout; David Porter,5,0,36,31
1657055394638,MATH 20A,A01,083754,Zheng; Zequn,12,0,40,28
1657055400666,MATH 20B,A01,083756,Briones; Jor-el Thomas Caparas,1,0,36,35
1657055400666,MATH 20B,A02,083757,Briones; Jor-el Thomas Caparas,1,0,36,35
1657055400666,MATH 20B,A03,093475,Briones; Jor-el Thomas Caparas,0,0,36,36
1657055406692,MATH 20C,A01,083760,Briones; Jor-el Thomas Caparas,1,0,35,34
1657055406692,MATH 20C,A02,083761,Briones; Jor-el Thomas Caparas,8,0,35,27
1657055406692,MATH 20C,A03,093476,Briones; Jor-el Thomas Caparas,0,1,36,36
1657055406692,MATH 20C,B01,083762,Bach; Quang Tran,0,0,30,30
1657055412720,MATH 20D,A01,083765,Tran; Brian Kha,4,0,30,26
1657055412720,MATH 20D,A02,083766,Tran; Brian Kha,5,0,30,25
1657055412720,MATH 20D,A03,083767,Tran; Brian Kha,3,0,30,27
1657055418745,MATH 20E,A01,083771,Ganguly; Soumya,5,0,32,27
1657055418745,MATH 20E,A02,083772,Ganguly; Soumya,6,0,32,26
1657055418745,MATH 20E,B01,083773,Ciotti; Benjamin,18,0,35,17
1657055418745,MATH 20E,B02,083774,Ciotti; Benjamin,17,0,35,18
1657055424767,MATH 103A,A01,083777,Greenfeld; Be'Eri,2,0,36,34
1657055424767,MATH 103A,A02,083778,Greenfeld; Be'Eri,5,0,36,31
1657055424767,MATH 103A,A03,093561,Greenfeld; Be'Eri,4,0,36,32
1657055424767,MATH 103A,B01,083779,Greenfeld; Be'Eri,6,0,36,30
1657055424767,MATH 103A,B02,083780,Greenfeld; Be'Eri,2,0,36,34
1657055424767,MATH 103A,B03,093562,Greenfeld; Be'Eri,2,0,36,34
1657055430794,MATH 105,A01,085443,Carter; Anne Toulson,14,0,35,21
1657055430794,MATH 105,A02,093477,Carter; Anne Toulson,20,0,35,15
1657055436824,MATH 109,A01,083213,Ganzberger; Geoffrey Michael,2,0,34,32
1657055436824,MATH 109,A02,083214,Ganzberger; Geoffrey Michael,2,0,34,32
1657055436824,MATH 109,A03,093478,Ganzberger; Geoffrey Michael,1,0,34,33
1657055436824,MATH 109,B01,083215,Ganzberger; Geoffrey Michael,1,0,32,31
1657055436824,MATH 109,B02,083216,Ganzberger; Geoffrey Michael,1,0,32,31
1657055436824,MATH 109,B03,093479,Ganzberger; Geoffrey Michael,6,0,32,26
1657055442848,MATH 142A,A01,083219,Chow; Bennett,6,0,32,26
1657055442848,MATH 142A,A02,083220,Chow; Bennett,10,0,32,22
1657055442848,MATH 142A,A03,093480,Chow; Bennett,7,0,32,25
1657055442848,MATH 142A,B03,093481,Chow; Bennett,7,0,32,25
1657055442848,MATH 142A,B04,093558,Chow; Bennett,11,0,32,21
1657055442848,MATH 142A,B05,093559,Chow; Bennett,6,0,32,26
1657055448872,MATH 193A,A01,083224,Rotar; Vladimir,7,0,34,27
1657055448872,MATH 193A,A02,083225,Rotar; Vladimir,5,0,34,29
1657055448872,MATH 193A,A03,083781,Rotar; Vladimir,1,0,34,33
1657055448872,MATH 193A,A04,083782,Rotar; Vladimir,6,0,34,28
1657055448872,MATH 193A,A05,093482,Rotar; Vladimir,6,0,34,28
1657055454913,MATH 197,001,091859,McAuley; Julian John,9999,0,9999,0
1657055454913,MATH 197,002,095566,Kedlaya; Kiran S.,9997,0,9999,2
1657055454913,MATH 197,003,095567,Xiao; Ming,9999,0,9999,0
1657055454913,MATH 197,004,095571,Perols; Johan Lars,9998,0,9999,1
1657055461965,COGS 9,A01,083615,Shannon; Kyle Michael,7,0,75,68
1657055467987,COGS 11,A01,083617,Boyle; Mary E. T.,20,0,48,28
1657055474022,COGS 13,A01,083071,Bastos; Amalia Pinkusfeld,9,0,71,62
1657055480049,COGS 14A,A01,092681,Semenuks; Arturs,0,1,100,100
1657055486083,COGS 14B,A01,083073,Cheng; Tzu-Han,5,0,63,58
1657055492106,COGS 17,A01,092677,Semenuks; Arturs,4,0,81,77
1657055498132,COGS 100,A01,083619,Allen; Michael Gordon,15,0,70,55
1657055504156,COGS 101A,A01,083621,Davis; Joshua Daniel,9,0,68,59
1657055510186,COGS 101B,A01,091572,Allen; Michael Gordon,8,0,65,57
1657055516209,COGS 101C,A01,083625,Delgado; Tania,17,0,35,18
1657055522235,COGS 107A,A01,083627,Boyle; Mary E. T.,13,0,60,47
1657055528268,COGS 118A,A01,083075,Gupta; Anjum,15,0,76,61
1657055534300,CSE 3,A50,083646,Miranda; Gregory Joseph,22,0,50,28
1657055540330,CSE 8A,A50,083650,Miranda; Gregory Joseph,17,1,56,39
1657055546356,CSE 11,A01,083080,Cao; Yingjun,4,15,40,36
1657055552382,CSE 12,A01,083652,Krause-Levy; Sophia Louisa,23,1,120,97
1657055558404,CSE 15L,A01,083654,Morris; Justin Loren,8,0,50,42
1657055558404,CSE 15L,A02,083655,Morris; Justin Loren,9,0,50,41
1657055564428,CSE 20,A01,083657,Tran; Khoa Dang,37,0,80,43
1657055570451,CSE 21,A01,095574,Bach; Quang Tran,21,0,48,27
1657055576475,CSE 30,A01,083084,Eldon; John,4,0,80,76
1657055576475,CSE 30,B01,095061,Bhaskar; Nishant,6,0,50,44
1657055582504,CSE 100,A01,083659,Cao; Yingjun,3,4,70,67
1657055588530,CSE 134B,A01,083661,Powell; Thomas Allan,19,0,100,81
1657055594559,CSE 140,A01,083663,Gungor; Onat,14,0,85,71
1657055600582,CSE 140L,A01,083088,Eldon; John,16,0,100,84
1657055606605,CSE 175,A01,083665,Kumar; Rakesh,3,0,25,22
1657055612627,CSE 190,A00,092507,Dubnov; Shlomo,7,0,20,13
1657055618654,ECE 45,A01,083139,Congero; Spencer William,5,0,75,70
1657055624677,ECE 65,A50,083695,Saad; Andrew S,12,0,30,18
1657055624677,ECE 65,A51,095125,Saad; Andrew S,25,0,26,1
1657055630704,ECE 109,A01,091882,Touri; Behrouz,16,0,70,54
1657055636726,ECE 180,A00,083140,Abi Samra; Nicholas Camill,1,0,30,29
1657055636726,ECE 180,B00,083141,Abi Samra; Nicholas Camill,0,0,30,30
1657055642750,MATH 10A,A01,083735,Patchell; Gregory David,1,0,30,29
1657055642750,MATH 10A,A02,083736,Patchell; Gregory David,20,0,30,10
1657055642750,MATH 10A,A03,083737,Patchell; Gregory David,16,0,30,14
1657055648779,MATH 10B,A01,083207,Lim; Seonhee,7,0,34,27
1657055648779,MATH 10B,A02,083208,Lim; Seonhee,9,0,35,26
1657055648779,MATH 10B,A03,093472,Lim; Seonhee,4,0,34,30
1657055648779,MATH 10B,B01,083739,Sinha; Shubham,9,0,30,21
1657055654809,MATH 18,A01,083743,Cinel; Cameron Alexander,6,0,30,24
1657055654809,MATH 18,A02,083744,Cinel; Cameron Alexander,15,0,30,15
1657055654809,MATH 18,A03,083745,Cinel; Cameron Alexander,8,0,30,22
1657055654809,MATH 18,B01,083748,Rideout; David Porter,4,0,37,33
1657055654809,MATH 18,B02,083749,Rideout; David Porter,3,0,36,33
1657055654809,MATH 18,B03,083750,Rideout; David Porter,2,0,37,35
1657055654809,MATH 18,B04,083751,Rideout; David Porter,5,0,36,31
1657055654809,MATH 18,B05,093473,Rideout; David Porter,4,0,36,32
1657055654809,MATH 18,B06,093474,Rideout; David Porter,5,0,36,31
1657055660835,MATH 20A,A01,083754,Zheng; Zequn,12,0,40,28
1657055666861,MATH 20B,A01,083756,Briones; Jor-el Thomas Caparas,1,0,36,35
1657055666861,MATH 20B,A02,083757,Briones; Jor-el Thomas Caparas,1,0,36,35
1657055666861,MATH 20B,A03,093475,Briones; Jor-el Thomas Caparas,0,0,36,36
1657055672888,MATH 20C,A01,083760,Briones; Jor-el Thomas Caparas,1,0,35,34
1657055672888,MATH 20C,A02,083761,Briones; Jor-el Thomas Caparas,8,0,35,27
1657055672888,MATH 20C,A03,093476,Briones; Jor-el Thomas Caparas,0,1,36,36
1657055672888,MATH 20C,B01,083762,Bach; Quang Tran,0,0,30,30
1657055678933,MATH 20D,A01,083765,Tran; Brian Kha,4,0,30,26
1657055678933,MATH 20D,A02,083766,Tran; Brian Kha,5,0,30,25
1657055678933,MATH 20D,A03,083767,Tran; Brian Kha,3,0,30,27
1657055684961,MATH 20E,A01,083771,Ganguly; Soumya,5,0,32,27
1657055684961,MATH 20E,A02,083772,Ganguly; Soumya,6,0,32,26
1657055684961,MATH 20E,B01,083773,Ciotti; Benjamin,18,0,35,17
1657055684961,MATH 20E,B02,083774,Ciotti; Benjamin,17,0,35,18
1657055690984,MATH 103A,A01,083777,Greenfeld; Be'Eri,2,0,36,34
1657055690984,MATH 103A,A02,083778,Greenfeld; Be'Eri,5,0,36,31
1657055690984,MATH 103A,A03,093561,Greenfeld; Be'Eri,4,0,36,32
1657055690984,MATH 103A,B01,083779,Greenfeld; Be'Eri,6,0,36,30
1657055690984,MATH 103A,B02,083780,Greenfeld; Be'Eri,2,0,36,34
1657055690984,MATH 103A,B03,093562,Greenfeld; Be'Eri,2,0,36,34
1657055697010,MATH 105,A01,085443,Carter; Anne Toulson,14,0,35,21
1657055697010,MATH 105,A02,093477,Carter; Anne Toulson,20,0,35,15
1657055703039,MATH 109,A01,083213,Ganzberger; Geoffrey Michael,2,0,34,32
1657055703039,MATH 109,A02,083214,Ganzberger; Geoffrey Michael,2,0,34,32
1657055703039,MATH 109,A03,093478,Ganzberger; Geoffrey Michael,1,0,34,33
1657055703039,MATH 109,B01,083215,Ganzberger; Geoffrey Michael,1,0,32,31
1657055703039,MATH 109,B02,083216,Ganzberger; Geoffrey Michael,1,0,32,31
1657055703039,MATH 109,B03,093479,Ganzberger; Geoffrey Michael,6,0,32,26
1657055709062,MATH 142A,A01,083219,Chow; Bennett,6,0,32,26
1657055709062,MATH 142A,A02,083220,Chow; Bennett,10,0,32,22
1657055709062,MATH 142A,A03,093480,Chow; Bennett,7,0,32,25
1657055709062,MATH 142A,B03,093481,Chow; Bennett,7,0,32,25
1657055709062,MATH 142A,B04,093558,Chow; Bennett,11,0,32,21
1657055709062,MATH 142A,B05,093559,Chow; Bennett,6,0,32,26
1657055715108,MATH 193A,A01,083224,Rotar; Vladimir,7,0,34,27
1657055715108,MATH 193A,A02,083225,Rotar; Vladimir,5,0,34,29
1657055715108,MATH 193A,A03,083781,Rotar; Vladimir,1,0,34,33
1657055715108,MATH 193A,A04,083782,Rotar; Vladimir,6,0,34,28
1657055715108,MATH 193A,A05,093482,Rotar; Vladimir,6,0,34,28
1657055721131,MATH 197,001,091859,McAuley; Julian John,9999,0,9999,0
1657055721131,MATH 197,002,095566,Kedlaya; Kiran S.,9997,0,9999,2
1657055721131,MATH 197,003,095567,Xiao; Ming,9999,0,9999,0
1657055721131,MATH 197,004,095571,Perols; Johan Lars,9998,0,9999,1
1657055728192,COGS 9,A01,083615,Shannon; Kyle Michael,7,0,75,68
1657055734226,COGS 11,A01,083617,Boyle; Mary E. T.,20,0,48,28
1657055740250,COGS 13,A01,083071,Bastos; Amalia Pinkusfeld,9,0,71,62
1657055746279,COGS 14A,A01,092681,Semenuks; Arturs,0,1,100,100
1657055752307,COGS 14B,A01,083073,Cheng; Tzu-Han,5,0,63,58
1657055758330,COGS 17,A01,092677,Semenuks; Arturs,4,0,81,77
1657055764357,COGS 100,A01,083619,Allen; Michael Gordon,15,0,70,55
1657055770378,COGS 101A,A01,083621,Davis; Joshua Daniel,9,0,68,59
1657055776401,COGS 101B,A01,091572,Allen; Michael Gordon,8,0,65,57
1657055782426,COGS 101C,A01,083625,Delgado; Tania,17,0,35,18
1657055788454,COGS 107A,A01,083627,Boyle; Mary E. T.,13,0,60,47
1657055794484,COGS 118A,A01,083075,Gupta; Anjum,15,0,76,61
1657055800506,CSE 3,A50,083646,Miranda; Gregory Joseph,22,0,50,28
1657055806532,CSE 8A,A50,083650,Miranda; Gregory Joseph,17,1,56,39
1657055812562,CSE 11,A01,083080,Cao; Yingjun,4,15,40,36
1657055818662,CSE 12,A01,083652,Krause-Levy; Sophia Louisa,23,1,120,97
1657055824702,CSE 15L,A01,083654,Morris; Justin Loren,8,0,50,42
1657055824702,CSE 15L,A02,083655,Morris; Justin Loren,9,0,50,41
1657055830729,CSE 20,A01,083657,Tran; Khoa Dang,37,0,80,43
1657055836752,CSE 21,A01,095574,Bach; Quang Tran,21,0,48,27
1657055842774,CSE 30,A01,083084,Eldon; John,4,0,80,76
1657055842774,CSE 30,B01,095061,Bhaskar; Nishant,6,0,50,44
1657055848796,CSE 100,A01,083659,Cao; Yingjun,3,4,70,67
1657055854822,CSE 134B,A01,083661,Powell; Thomas Allan,19,0,100,81
1657055860848,CSE 140,A01,083663,Gungor; Onat,14,0,85,71
1657055866879,CSE 140L,A01,083088,Eldon; John,16,0,100,84
1657055872904,CSE 175,A01,083665,Kumar; Rakesh,3,0,25,22
1657055878930,CSE 190,A00,092507,Dubnov; Shlomo,7,0,20,13
1657055884954,ECE 45,A01,083139,Congero; Spencer William,5,0,75,70
1657055890982,ECE 65,A50,083695,Saad; Andrew S,12,0,30,18
1657055890982,ECE 65,A51,095125,Saad; Andrew S,25,0,26,1
1657055897007,ECE 109,A01,091882,Touri; Behrouz,16,0,70,54
1657055903032,ECE 180,A00,083140,Abi Samra; Nicholas Camill,1,0,30,29
1657055903032,ECE 180,B00,083141,Abi Samra; Nicholas Camill,0,0,30,30
1657055909063,MATH 10A,A01,083735,Patchell; Gregory David,1,0,30,29
1657055909063,MATH 10A,A02,083736,Patchell; Gregory David,20,0,30,10
1657055909063,MATH 10A,A03,083737,Patchell; Gregory David,16,0,30,14
1657055915094,MATH 10B,A01,083207,Lim; Seonhee,7,0,34,27
1657055915094,MATH 10B,A02,083208,Lim; Seonhee,9,0,35,26
1657055915094,MATH 10B,A03,093472,Lim; Seonhee,4,0,34,30
1657055915094,MATH 10B,B01,083739,Sinha; Shubham,9,0,30,21
1657055921118,MATH 18,A01,083743,Cinel; Cameron Alexander,6,0,30,24
1657055921118,MATH 18,A02,083744,Cinel; Cameron Alexander,15,0,30,15
1657055921118,MATH 18,A03,083745,Cinel; Cameron Alexander,8,0,30,22
1657055921118,MATH 18,B01,083748,Rideout; David Porter,4,0,37,33
1657055921118,MATH 18,B02,083749,Rideout; David Porter,3,0,36,33
1657055921118,MATH 18,B03,083750,Rideout; David Porter,2,0,37,35
1657055921118,MATH 18,B04,083751,Rideout; David Porter,5,0,36,31
1657055921118,MATH 18,B05,093473,Rideout; David Porter,4,0,36,32
1657055921118,MATH 18,B06,093474,Rideout; David Porter,5,0,36,31
1657055927151,MATH 20A,A01,083754,Zheng; Zequn,12,0,40,28
1657055933178,MATH 20B,A01,083756,Briones; Jor-el Thomas Caparas,1,0,36,35
1657055933178,MATH 20B,A02,083757,Briones; Jor-el Thomas Caparas,1,0,36,35
1657055933178,MATH 20B,A03,093475,Briones; Jor-el Thomas Caparas,0,0,36,36
1657055939206,MATH 20C,A01,083760,Briones; Jor-el Thomas Caparas,1,0,35,34
1657055939206,MATH 20C,A02,083761,Briones; Jor-el Thomas Caparas,8,0,35,27
1657055939206,MATH 20C,A03,093476,Briones; Jor-el Thomas Caparas,0,1,36,36
1657055939206,MATH 20C,B01,083762,Bach; Quang Tran,0,0,30,30
1657055945229,MATH 20D,A01,083765,Tran; Brian Kha,4,0,30,26
1657055945229,MATH 20D,A02,083766,Tran; Brian Kha,5,0,30,25
1657055945229,MATH 20D,A03,083767,Tran; Brian Kha,3,0,30,27
1657055951258,MATH 20E,A01,083771,Ganguly; Soumya,5,0,32,27
1657055951258,MATH 20E,A02,083772,Ganguly; Soumya,6,0,32,26
1657055951258,MATH 20E,B01,083773,Ciotti; Benjamin,18,0,35,17
1657055951258,MATH 20E,B02,083774,Ciotti; Benjamin,17,0,35,18
1657055957288,MATH 103A,A01,083777,Greenfeld; Be'Eri,2,0,36,34
1657055957288,MATH 103A,A02,083778,Greenfeld; Be'Eri,5,0,36,31
1657055957288,MATH 103A,A03,093561,Greenfeld; Be'Eri,4,0,36,32
1657055957288,MATH 103A,B01,083779,Greenfeld; Be'Eri,6,0,36,30
1657055957288,MATH 103A,B02,083780,Greenfeld; Be'Eri,2,0,36,34
1657055957288,MATH 103A,B03,093562,Greenfeld; Be'Eri,2,0,36,34
1657055963319,MATH 105,A01,085443,Carter; Anne Toulson,14,0,35,21
1657055963319,MATH 105,A02,093477,Carter; Anne Toulson,20,0,35,15
1657055969343,MATH 109,A01,083213,Ganzberger; Geoffrey Michael,2,0,34,32
1657055969343,MATH 109,A02,083214,Ganzberger; Geoffrey Michael,2,0,34,32
1657055969343,MATH 109,A03,093478,Ganzberger; Geoffrey Michael,1,0,34,33
1657055969343,MATH 109,B01,083215,Ganzberger; Geoffrey Michael,1,0,32,31
1657055969343,MATH 109,B02,083216,Ganzberger; Geoffrey Michael,1,0,32,31
1657055969343,MATH 109,B03,093479,Ganzberger; Geoffrey Michael,6,0,32,26
1657055975367,MATH 142A,A01,083219,Chow; Bennett,6,0,32,26
1657055975367,MATH 142A,A02,083220,Chow; Bennett,10,0,32,22
1657055975367,MATH 142A,A03,093480,Chow; Bennett,7,0,32,25
1657055975367,MATH 142A,B03,093481,Chow; Bennett,7,0,32,25
1657055975367,MATH 142A,B04,093558,Chow; Bennett,11,0,32,21
1657055975367,MATH 142A,B05,093559,Chow; Bennett,6,0,32,26
1657055981394,MATH 193A,A01,083224,Rotar; Vladimir,7,0,34,27
1657055981394,MATH 193A,A02,083225,Rotar; Vladimir,5,0,34,29
1657055981394,MATH 193A,A03,083781,Rotar; Vladimir,1,0,34,33
1657055981394,MATH 193A,A04,083782,Rotar; Vladimir,6,0,34,28
1657055981394,MATH 193A,A05,093482,Rotar; Vladimir,6,0,34,28
1657055987419,MATH 197,001,091859,McAuley; Julian John,9999,0,9999,0
1657055987419,MATH 197,002,095566,Kedlaya; Kiran S.,9997,0,9999,2
1657055987419,MATH 197,003,095567,Xiao; Ming,9999,0,9999,0
1657055987419,MATH 197,004,095571,Perols; Johan Lars,9998,0,9999,1
1657055994486,COGS 9,A01,083615,Shannon; Kyle Michael,7,0,75,68
1657056000513,COGS 11,A01,083617,Boyle; Mary E. T.,20,0,48,28
1657056006536,COGS 13,A01,083071,Bastos; Amalia Pinkusfeld,9,0,71,62
1657056012559,COGS 14A,A01,092681,Semenuks; Arturs,0,1,100,100
1657056018585,COGS 14B,A01,083073,Cheng; Tzu-Han,5,0,63,58
1657056024606,COGS 17,A01,092677,Semenuks; Arturs,4,0,81,77
1657056030629,COGS 100,A01,083619,Allen; Michael Gordon,15,0,70,55
1657056036664,COGS 101A,A01,083621,Davis; Joshua Daniel,9,0,68,59
1657056042686,COGS 101B,A01,091572,Allen; Michael Gordon,8,0,65,57
1657056048711,COGS 101C,A01,083625,Delgado; Tania,17,0,35,18
1657056054740,COGS 107A,A01,083627,Boyle; Mary E. T.,13,0,60,47
1657056060764,COGS 118A,A01,083075,Gupta; Anjum,15,0,76,61
1657056066790,CSE 3,A50,083646,Miranda; Gregory Joseph,22,0,50,28
1657056072812,CSE 8A,A50,083650,Miranda; Gregory Joseph,17,1,56,39
1657056078839,CSE 11,A01,083080,Cao; Yingjun,4,15,40,36
1657056084862,CSE 12,A01,083652,Krause-Levy; Sophia Louisa,23,1,120,97
1657056090888,CSE 15L,A01,083654,Morris; Justin Loren,8,0,50,42
1657056090888,CSE 15L,A02,083655,Morris; Justin Loren,9,0,50,41
1657056096910,CSE 20,A01,083657,Tran; Khoa Dang,37,0,80,43
1657056102942,CSE 21,A01,095574,Bach; Quang Tran,21,0,48,27
1657056108969,CSE 30,A01,083084,Eldon; John,4,0,80,76
1657056108969,CSE 30,B01,095061,Bhaskar; Nishant,6,0,50,44
1657056114991,CSE 100,A01,083659,Cao; Yingjun,3,4,70,67
1657056121015,CSE 134B,A01,083661,Powell; Thomas Allan,19,0,100,81
1657056127051,CSE 140,A01,083663,Gungor; Onat,14,0,85,71
1657056133073,CSE 140L,A01,083088,Eldon; John,16,0,100,84
1657056139096,CSE 175,A01,083665,Kumar; Rakesh,3,0,25,22
1657056145121,CSE 190,A00,092507,Dubnov; Shlomo,7,0,20,13
1657056151145,ECE 45,A01,083139,Congero; Spencer William,5,0,75,70
1657056157174,ECE 65,A50,083695,Saad; Andrew S,12,0,30,18
1657056157174,ECE 65,A51,095125,Saad; Andrew S,25,0,26,1
1657056163198,ECE 109,A01,091882,Touri; Behrouz,16,0,70,54
1657056169224,ECE 180,A00,083140,Abi Samra; Nicholas Camill,1,0,30,29
1657056169224,ECE 180,B00,083141,Abi Samra; Nicholas Camill,0,0,30,30
1657056175252,MATH 10A,A01,083735,Patchell; Gregory David,1,0,30,29
1657056175252,MATH 10A,A02,083736,Patchell; Gregory David,20,0,30,10
1657056175252,MATH 10A,A03,083737,Patchell; Gregory David,16,0,30,14
1657056181286,MATH 10B,A01,083207,Lim; Seonhee,7,0,34,27
1657056181286,MATH 10B,A02,083208,Lim; Seonhee,9,0,35,26
1657056181286,MATH 10B,A03,093472,Lim; Seonhee,4,0,34,30
1657056181286,MATH 10B,B01,083739,Sinha; Shubham,9,0,30,21
1657056187312,MATH 18,A01,083743,Cinel; Cameron Alexander,6,0,30,24
1657056187312,MATH 18,A02,083744,Cinel; Cameron Alexander,15,0,30,15
1657056187312,MATH 18,A03,083745,Cinel; Cameron Alexander,8,0,30,22
1657056187312,MATH 18,B01,083748,Rideout; David Porter,4,0,37,33
1657056187312,MATH 18,B02,083749,Rideout; David Porter,3,0,36,33
1657056187312,MATH 18,B03,083750,Rideout; David Porter,2,0,37,35
1657056187312,MATH 18,B04,083751,Rideout; David Porter,5,0,36,31
1657056187312,MATH 18,B05,093473,Rideout; David Porter,4,0,36,32
1657056187312,MATH 18,B06,093474,Rideout; David Porter,5,0,36,31
1657056193334,MATH 20A,A01,083754,Zheng; Zequn,12,0,40,28
1657056199360,MATH 20B,A01,083756,Briones; Jor-el Thomas Caparas,1,0,36,35
1657056199360,MATH 20B,A02,083757,Briones; Jor-el Thomas Caparas,1,0,36,35
1657056199360,MATH 20B,A03,093475,Briones; Jor-el Thomas Caparas,0,0,36,36
1657056205392,MATH 20C,A01,083760,Briones; Jor-el Thomas Caparas,1,0,35,34
1657056205392,MATH 20C,A02,083761,Briones; Jor-el Thomas Caparas,8,0,35,27
1657056205392,MATH 20C,A03,093476,Briones; Jor-el Thomas Caparas,0,1,36,36
1657056205392,MATH 20C,B01,083762,Bach; Quang Tran,0,0,30,30
1657056211427,MATH 20D,A01,083765,Tran; Brian Kha,4,0,30,26
1657056211427,MATH 20D,A02,083766,Tran; Brian Kha,5,0,30,25
1657056211427,MATH 20D,A03,083767,Tran; Brian Kha,3,0,30,27
1657056217450,MATH 20E,A01,083771,Ganguly; Soumya,5,0,32,27
1657056217450,MATH 20E,A02,083772,Ganguly; Soumya,6,0,32,26
1657056217450,MATH 20E,B01,083773,Ciotti; Benjamin,18,0,35,17
1657056217450,MATH 20E,B02,083774,Ciotti; Benjamin,17,0,35,18
1657056223478,MATH 103A,A01,083777,Greenfeld; Be'Eri,2,0,36,34
1657056223478,MATH 103A,A02,083778,Greenfeld; Be'Eri,5,0,36,31
1657056223478,MATH 103A,A03,093561,Greenfeld; Be'Eri,4,0,36,32
1657056223478,MATH 103A,B01,083779,Greenfeld; Be'Eri,6,0,36,30
1657056223478,MATH 103A,B02,083780,Greenfeld; Be'Eri,2,0,36,34
1657056223478,MATH 103A,B03,093562,Greenfeld; Be'Eri,2,0,36,34
1657056229502,MATH 105,A01,085443,Carter; Anne Toulson,14,0,35,21
1657056229502,MATH 105,A02,093477,Carter; Anne Toulson,20,0,35,15
1657056235532,MATH 109,A01,083213,Ganzberger; Geoffrey Michael,2,0,34,32
1657056235532,MATH 109,A02,083214,Ganzberger; Geoffrey Michael,2,0,34,32
1657056235532,MATH 109,A03,093478,Ganzberger; Geoffrey Michael,1,0,34,33
1657056235532,MATH 109,B01,083215,Ganzberger; Geoffrey Michael,1,0,32,31
1657056235532,MATH 109,B02,083216,Ganzberger; Geoffrey Michael,1,0,32,31
1657056235532,MATH 109,B03,093479,Ganzberger; Geoffrey Michael,6,0,32,26
1657056241555,MATH 142A,A01,083219,Chow; Bennett,6,0,32,26
1657056241555,MATH 142A,A02,083220,Chow; Bennett,10,0,32,22
1657056241555,MATH 142A,A03,093480,Chow; Bennett,7,0,32,25
1657056241555,MATH 142A,B03,093481,Chow; Bennett,7,0,32,25
1657056241555,MATH 142A,B04,093558,Chow; Bennett,11,0,32,21
1657056241555,MATH 142A,B05,093559,Chow; Bennett,6,0,32,26
1657056247582,MATH 193A,A01,083224,Rotar; Vladimir,7,0,34,27
1657056247582,MATH 193A,A02,083225,Rotar; Vladimir,5,0,34,29
1657056247582,MATH 193A,A03,083781,Rotar; Vladimir,1,0,34,33
1657056247582,MATH 193A,A04,083782,Rotar; Vladimir,6,0,34,28
1657056247582,MATH 193A,A05,093482,Rotar; Vladimir,6,0,34,28
1657056253605,MATH 197,001,091859,McAuley; Julian John,9999,0,9999,0
1657056253605,MATH 197,002,095566,Kedlaya; Kiran S.,9997,0,9999,2
1657056253605,MATH 197,003,095567,Xiao; Ming,9999,0,9999,0
1657056253605,MATH 197,004,095571,Perols; Johan Lars,9998,0,9999,1
1657056260701,COGS 9,A01,083615,Shannon; Kyle Michael,7,0,75,68
1657056266734,COGS 11,A01,083617,Boyle; Mary E. T.,20,0,48,28
1657056272756,COGS 13,A01,083071,Bastos; Amalia Pinkusfeld,9,0,71,62
1657056278783,COGS 14A,A01,092681,Semenuks; Arturs,0,1,100,100
1657056284808,COGS 14B,A01,083073,Cheng; Tzu-Han,5,0,63,58
1657056290832,COGS 17,A01,092677,Semenuks; Arturs,4,0,81,77
1657056296855,COGS 100,A01,083619,Allen; Michael Gordon,15,0,70,55
1657056302879,COGS 101A,A01,083621,Davis; Joshua Daniel,9,0,68,59
1657056308906,COGS 101B,A01,091572,Allen; Michael Gordon,8,0,65,57
1657056314928,COGS 101C,A01,083625,Delgado; Tania,17,0,35,18
1657056320951,COGS 107A,A01,083627,Boyle; Mary E. T.,13,0,60,47
1657056326980,COGS 118A,A01,083075,Gupta; Anjum,15,0,76,61
1657056333007,CSE 3,A50,083646,Miranda; Gregory Joseph,22,0,50,28
1657056339036,CSE 8A,A50,083650,Miranda; Gregory Joseph,17,1,56,39
1657056345059,CSE 11,A01,083080,Cao; Yingjun,4,15,40,36
1657056351082,CSE 12,A01,083652,Krause-Levy; Sophia Louisa,23,1,120,97
1657056357108,CSE 15L,A01,083654,Morris; Justin Loren,8,0,50,42
1657056357108,CSE 15L,A02,083655,Morris; Justin Loren,9,0,50,41
1657056363133,CSE 20,A01,083657,Tran; Khoa Dang,37,0,80,43
1657056369158,CSE 21,A01,095574,Bach; Quang Tran,21,0,48,27
1657056375186,CSE 30,A01,083084,Eldon; John,4,0,80,76
1657056375186,CSE 30,B01,095061,Bhaskar; Nishant,6,0,50,44
1657056381210,CSE 100,A01,083659,Cao; Yingjun,3,4,70,67
1657056387241,CSE 134B,A01,083661,Powell; Thomas Allan,19,0,100,81
1657056393264,CSE 140,A01,083663,Gungor; Onat,14,0,85,71
1657056399290,CSE 140L,A01,083088,Eldon; John,16,0,100,84
1657056405313,CSE 175,A01,083665,Kumar; Rakesh,3,0,25,22
1657056411342,CSE 190,A00,092507,Dubnov; Shlomo,7,0,20,13
1657056417437,ECE 45,A01,083139,Congero; Spencer William,5,0,75,70
1657056423476,ECE 65,A50,083695,Saad; Andrew S,12,0,30,18
1657056423476,ECE 65,A51,095125,Saad; Andrew S,25,0,26,1
1657056429500,ECE 109,A01,091882,Touri; Behrouz,16,0,70,54
1657056435524,ECE 180,A00,083140,Abi Samra; Nicholas Camill,1,0,30,29
1657056435524,ECE 180,B00,083141,Abi Samra; Nicholas Camill,0,0,30,30
1657056441546,MATH 10A,A01,083735,Patchell; Gregory David,1,0,30,29
1657056441546,MATH 10A,A02,083736,Patchell; Gregory David,20,0,30,10
1657056441546,MATH 10A,A03,083737,Patchell; Gregory David,16,0,30,14
1657056447569,MATH 10B,A01,083207,Lim; Seonhee,7,0,34,27
1657056447569,MATH 10B,A02,083208,Lim; Seonhee,9,0,35,26
1657056447569,MATH 10B,A03,093472,Lim; Seonhee,4,0,34,30
1657056447569,MATH 10B,B01,083739,Sinha; Shubham,9,0,30,21
1657056453601,MATH 18,A01,083743,Cinel; Cameron Alexander,6,0,30,24
1657056453601,MATH 18,A02,083744,Cinel; Cameron Alexander,15,0,30,15
1657056453601,MATH 18,A03,083745,Cinel; Cameron Alexander,8,0,30,22
1657056453601,MATH 18,B01,083748,Rideout; David Porter,4,0,37,33
1657056453601,MATH 18,B02,083749,Rideout; David Porter,3,0,36,33
1657056453601,MATH 18,B03,083750,Rideout; David Porter,2,0,37,35
1657056453601,MATH 18,B04,083751,Rideout; David Porter,5,0,36,31
1657056453601,MATH 18,B05,093473,Rideout; David Porter,4,0,36,32
1657056453601,MATH 18,B06,093474,Rideout; David Porter,5,0,36,31
1657056459625,MATH 20A,A01,083754,Zheng; Zequn,12,0,40,28
1657056465650,MATH 20B,A01,083756,Briones; Jor-el Thomas Caparas,1,0,36,35
1657056465650,MATH 20B,A02,083757,Briones; Jor-el Thomas Caparas,1,0,36,35
1657056465650,MATH 20B,A03,093475,Briones; Jor-el Thomas Caparas,0,0,36,36
1657056471672,MATH 20C,A01,083760,Briones; Jor-el Thomas Caparas,1,0,35,34
1657056471672,MATH 20C,A02,083761,Briones; Jor-el Thomas Caparas,8,0,35,27
1657056471672,MATH 20C,A03,093476,Briones; Jor-el Thomas Caparas,0,1,36,36
1657056471672,MATH 20C,B01,083762,Bach; Quang Tran,0,0,30,30
1657056477695,MATH 20D,A01,083765,Tran; Brian Kha,4,0,30,26
1657056477695,MATH 20D,A02,083766,Tran; Brian Kha,5,0,30,25
1657056477695,MATH 20D,A03,083767,Tran; Brian Kha,3,0,30,27
1657056483727,MATH 20E,A01,083771,Ganguly; Soumya,5,0,32,27
1657056483727,MATH 20E,A02,083772,Ganguly; Soumya,6,0,32,26
1657056483727,MATH 20E,B01,083773,Ciotti; Benjamin,18,0,35,17
1657056483727,MATH 20E,B02,083774,Ciotti; Benjamin,17,0,35,18
1657056489751,MATH 103A,A01,083777,Greenfeld; Be'Eri,2,0,36,34
1657056489751,MATH 103A,A02,083778,Greenfeld; Be'Eri,5,0,36,31
1657056489751,MATH 103A,A03,093561,Greenfeld; Be'Eri,4,0,36,32
1657056489751,MATH 103A,B01,083779,Greenfeld; Be'Eri,6,0,36,30
1657056489751,MATH 103A,B02,083780,Greenfeld; Be'Eri,2,0,36,34
1657056489751,MATH 103A,B03,093562,Greenfeld; Be'Eri,2,0,36,34
1657056495774,MATH 105,A01,085443,Carter; Anne Toulson,14,0,35,21
1657056495774,MATH 105,A02,093477,Carter; Anne Toulson,20,0,35,15
1657056501802,MATH 109,A01,083213,Ganzberger; Geoffrey Michael,2,0,34,32
1657056501802,MATH 109,A02,083214,Ganzberger; Geoffrey Michael,2,0,34,32
1657056501802,MATH 109,A03,093478,Ganzberger; Geoffrey Michael,1,0,34,33
1657056501802,MATH 109,B01,083215,Ganzberger; Geoffrey Michael,1,0,32,31
1657056501802,MATH 109,B02,083216,Ganzberger; Geoffrey Michael,1,0,32,31
1657056501802,MATH 109,B03,093479,Ganzberger; Geoffrey Michael,6,0,32,26
1657056507825,MATH 142A,A01,083219,Chow; Bennett,6,0,32,26
1657056507825,MATH 142A,A02,083220,Chow; Bennett,10,0,32,22
1657056507825,MATH 142A,A03,093480,Chow; Bennett,7,0,32,25
1657056507825,MATH 142A,B03,093481,Chow; Bennett,7,0,32,25
1657056507825,MATH 142A,B04,093558,Chow; Bennett,11,0,32,21
1657056507825,MATH 142A,B05,093559,Chow; Bennett,6,0,32,26
1657056513848,MATH 193A,A01,083224,Rotar; Vladimir,7,0,34,27
1657056513848,MATH 193A,A02,083225,Rotar; Vladimir,5,0,34,29
1657056513848,MATH 193A,A03,083781,Rotar; Vladimir,1,0,34,33
1657056513848,MATH 193A,A04,083782,Rotar; Vladimir,6,0,34,28
1657056513848,MATH 193A,A05,093482,Rotar; Vladimir,6,0,34,28
1657056519881,MATH 197,001,091859,McAuley; Julian John,9999,0,9999,0
1657056519881,MATH 197,002,095566,Kedlaya; Kiran S.,9997,0,9999,2
1657056519881,MATH 197,003,095567,Xiao; Ming,9999,0,9999,0
1657056519881,MATH 197,004,095571,Perols; Johan Lars,9998,0,9999,1
1657056526941,COGS 9,A01,083615,Shannon; Kyle Michael,7,0,75,68
1657056532964,COGS 11,A01,083617,Boyle; Mary E. T.,20,0,48,28
1657056539009,COGS 13,A01,083071,Bastos; Amalia Pinkusfeld,9,0,71,62
1657056545049,COGS 14A,A01,092681,Semenuks; Arturs,0,1,100,100
1657056551073,COGS 14B,A01,083073,Cheng; Tzu-Han,5,0,63,58
1657056557098,COGS 17,A01,092677,Semenuks; Arturs,4,0,81,77
1657056563131,COGS 100,A01,083619,Allen; Michael Gordon,15,0,70,55
1657056569159,COGS 101A,A01,083621,Davis; Joshua Daniel,9,0,68,59
1657056575181,COGS 101B,A01,091572,Allen; Michael Gordon,8,0,65,57
1657056581218,COGS 101C,A01,083625,Delgado; Tania,17,0,35,18
1657056587241,COGS 107A,A01,083627,Boyle; Mary E. T.,13,0,60,47
1657056593266,COGS 118A,A01,083075,Gupta; Anjum,15,0,76,61
1657056599292,CSE 3,A50,083646,Miranda; Gregory Joseph,22,0,50,28
1657056605316,CSE 8A,A50,083650,Miranda; Gregory Joseph,17,1,56,39
1657056611339,CSE 11,A01,083080,Cao; Yingjun,4,15,40,36
1657056617362,CSE 12,A01,083652,Krause-Levy; Sophia Louisa,23,1,120,97
1657056623392,CSE 15L,A01,083654,Morris; Justin Loren,8,0,50,42
1657056623392,CSE 15L,A02,083655,Morris; Justin Loren,9,0,50,41
1657056629418,CSE 20,A01,083657,Tran; Khoa Dang,37,0,80,43
1657056635445,CSE 21,A01,095574,Bach; Quang Tran,21,0,48,27
1657056641469,CSE 30,A01,083084,Eldon; John,4,0,80,76
1657056641469,CSE 30,B01,095061,Bhaskar; Nishant,6,0,50,44
1657056647498,CSE 100,A01,083659,Cao; Yingjun,3,4,70,67
1657056653528,CSE 134B,A01,083661,Powell; Thomas Allan,19,0,100,81
1657056659555,CSE 140,A01,083663,Gungor; Onat,14,0,85,71
1657056665579,CSE 140L,A01,083088,Eldon; John,16,0,100,84
1657056671605,CSE 175,A01,083665,Kumar; Rakesh,3,0,25,22
1657056677646,CSE 190,A00,092507,Dubnov; Shlomo,7,0,20,13
1657056683670,ECE 45,A01,083139,Congero; Spencer William,5,0,75,70
1657056689693,ECE 65,A50,083695,Saad; Andrew S,12,0,30,18
1657056689693,ECE 65,A51,095125,Saad; Andrew S,25,0,26,1
1657056695727,ECE 109,A01,091882,Touri; Behrouz,16,0,70,54
1657056701750,ECE 180,A00,083140,Abi Samra; Nicholas Camill,1,0,30,29
1657056701750,ECE 180,B00,083141,Abi Samra; Nicholas Camill,0,0,30,30
1657056707776,MATH 10A,A01,083735,Patchell; Gregory David,1,0,30,29
1657056707776,MATH 10A,A02,083736,Patchell; Gregory David,20,0,30,10
1657056707776,MATH 10A,A03,083737,Patchell; Gregory David,16,0,30,14
1657056713798,MATH 10B,A01,083207,Lim; Seonhee,7,0,34,27
1657056713798,MATH 10B,A02,083208,Lim; Seonhee,9,0,35,26
1657056713798,MATH 10B,A03,093472,Lim; Seonhee,4,0,34,30
1657056713798,MATH 10B,B01,083739,Sinha; Shubham,9,0,30,21
1657056719829,MATH 18,A01,083743,Cinel; Cameron Alexander,6,0,30,24
1657056719829,MATH 18,A02,083744,Cinel; Cameron Alexander,15,0,30,15
1657056719829,MATH 18,A03,083745,Cinel; Cameron Alexander,8,0,30,22
1657056719829,MATH 18,B01,083748,Rideout; David Porter,4,0,37,33
1657056719829,MATH 18,B02,083749,Rideout; David Porter,3,0,36,33
1657056719829,MATH 18,B03,083750,Rideout; David Porter,2,0,37,35
1657056719829,MATH 18,B04,083751,Rideout; David Porter,5,0,36,31
1657056719829,MATH 18,B05,093473,Rideout; David Porter,4,0,36,32
1657056719829,MATH 18,B06,093474,Rideout; David Porter,5,0,36,31
1657056725858,MATH 20A,A01,083754,Zheng; Zequn,12,0,40,28
1657056731880,MATH 20B,A01,083756,Briones; Jor-el Thomas Caparas,1,0,36,35
1657056731880,MATH 20B,A02,083757,Briones; Jor-el Thomas Caparas,1,0,36,35
1657056731880,MATH 20B,A03,093475,Briones; Jor-el Thomas Caparas,0,0,36,36
1657056737904,MATH 20C,A01,083760,Briones; Jor-el Thomas Caparas,1,0,35,34
1657056737904,MATH 20C,A02,083761,Briones; Jor-el Thomas Caparas,8,0,35,27
1657056737904,MATH 20C,A03,093476,Briones; Jor-el Thomas Caparas,0,1,36,36
1657056737904,MATH 20C,B01,083762,Bach; Quang Tran,0,0,30,30
1657056743937,MATH 20D,A01,083765,Tran; Brian Kha,4,0,30,26
1657056743937,MATH 20D,A02,083766,Tran; Brian Kha,5,0,30,25
1657056743937,MATH 20D,A03,083767,Tran; Brian Kha,3,0,30,27
1657056749968,MATH 20E,A01,083771,Ganguly; Soumya,5,0,32,27
1657056749968,MATH 20E,A02,083772,Ganguly; Soumya,6,0,32,26
1657056749968,MATH 20E,B01,083773,Ciotti; Benjamin,18,0,35,17
1657056749968,MATH 20E,B02,083774,Ciotti; Benjamin,17,0,35,18
1657056755999,MATH 103A,A01,083777,Greenfeld; Be'Eri,2,0,36,34
1657056755999,MATH 103A,A02,083778,Greenfeld; Be'Eri,5,0,36,31
1657056755999,MATH 103A,A03,093561,Greenfeld; Be'Eri,4,0,36,32
1657056755999,MATH 103A,B01,083779,Greenfeld; Be'Eri,6,0,36,30
1657056755999,MATH 103A,B02,083780,Greenfeld; Be'Eri,2,0,36,34
1657056755999,MATH 103A,B03,093562,Greenfeld; Be'Eri,2,0,36,34
1657056762028,MATH 105,A01,085443,Carter; Anne Toulson,14,0,35,21
1657056762028,MATH 105,A02,093477,Carter; Anne Toulson,20,0,35,15
1657056768051,MATH 109,A01,083213,Ganzberger; Geoffrey Michael,2,0,34,32
1657056768051,MATH 109,A02,083214,Ganzberger; Geoffrey Michael,2,0,34,32
1657056768051,MATH 109,A03,093478,Ganzberger; Geoffrey Michael,1,0,34,33
1657056768051,MATH 109,B01,083215,Ganzberger; Geoffrey Michael,1,0,32,31
1657056768051,MATH 109,B02,083216,Ganzberger; Geoffrey Michael,1,0,32,31
1657056768051,MATH 109,B03,093479,Ganzberger; Geoffrey Michael,6,0,32,26
1657056774087,MATH 142A,A01,083219,Chow; Bennett,6,0,32,26
1657056774087,MATH 142A,A02,083220,Chow; Bennett,10,0,32,22
1657056774087,MATH 142A,A03,093480,Chow; Bennett,7,0,32,25
1657056774087,MATH 142A,B03,093481,Chow; Bennett,7,0,32,25
1657056774087,MATH 142A,B04,093558,Chow; Bennett,11,0,32,21
1657056774087,MATH 142A,B05,093559,Chow; Bennett,6,0,32,26
1657056780128,MATH 193A,A01,083224,Rotar; Vladimir,7,0,34,27
1657056780128,MATH 193A,A02,083225,Rotar; Vladimir,5,0,34,29
1657056780128,MATH 193A,A03,083781,Rotar; Vladimir,1,0,34,33
1657056780128,MATH 193A,A04,083782,Rotar; Vladimir,6,0,34,28
1657056780128,MATH 193A,A05,093482,Rotar; Vladimir,6,0,34,28
1657056786156,MATH 197,001,091859,McAuley; Julian John,9999,0,9999,0
1657056786156,MATH 197,002,095566,Kedlaya; Kiran S.,9997,0,9999,2
1657056786156,MATH 197,003,095567,Xiao; Ming,9999,0,9999,0
1657056786156,MATH 197,004,095571,Perols; Johan Lars,9998,0,9999,1
1657056793210,COGS 9,A01,083615,Shannon; Kyle Michael,7,0,75,68
1657056799235,COGS 11,A01,083617,Boyle; Mary E. T.,20,0,48,28
1657056805258,COGS 13,A01,083071,Bastos; Amalia Pinkusfeld,9,0,71,62
1657056811280,COGS 14A,A01,092681,Semenuks; Arturs,0,1,100,100
1657056817311,COGS 14B,A01,083073,Cheng; Tzu-Han,5,0,63,58
1657056823339,COGS 17,A01,092677,Semenuks; Arturs,4,0,81,77
1657056829374,COGS 100,A01,083619,Allen; Michael Gordon,15,0,70,55
1657056835407,COGS 101A,A01,083621,Davis; Joshua Daniel,9,0,68,59
1657056841430,COGS 101B,A01,091572,Allen; Michael Gordon,8,0,65,57
1657056847456,COGS 101C,A01,083625,Delgado; Tania,17,0,35,18
1657056853483,COGS 107A,A01,083627,Boyle; Mary E. T.,13,0,60,47
1657056859506,COGS 118A,A01,083075,Gupta; Anjum,15,0,76,61
1657056865540,CSE 3,A50,083646,Miranda; Gregory Joseph,22,0,50,28
1657056871565,CSE 8A,A50,083650,Miranda; Gregory Joseph,17,1,56,39
1657056877586,CSE 11,A01,083080,Cao; Yingjun,4,15,40,36
1657056883608,CSE 12,A01,083652,Krause-Levy; Sophia Louisa,23,1,120,97
1657056889641,CSE 15L,A01,083654,Morris; Justin Loren,8,0,50,42
1657056889641,CSE 15L,A02,083655,Morris; Justin Loren,9,0,50,41
1657056895663,CSE 20,A01,083657,Tran; Khoa Dang,37,0,80,43
1657056901697,CSE 21,A01,095574,Bach; Quang Tran,21,0,48,27
1657056907722,CSE 30,A01,083084,Eldon; John,4,0,80,76
1657056907722,CSE 30,B01,095061,Bhaskar; Nishant,6,0,50,44
1657056913749,CSE 100,A01,083659,Cao; Yingjun,3,4,70,67
1657056919773,CSE 134B,A01,083661,Powell; Thomas Allan,19,0,100,81
1657056925796,CSE 140,A01,083663,Gungor; Onat,14,0,85,71
1657056931819,CSE 140L,A01,083088,Eldon; John,16,0,100,84
1657056937843,CSE 175,A01,083665,Kumar; Rakesh,3,0,25,22
1657056943874,CSE 190,A00,092507,Dubnov; Shlomo,7,0,20,13
1657056949900,ECE 45,A01,083139,Congero; Spencer William,5,0,75,70
1657056955926,ECE 65,A50,083695,Saad; Andrew S,12,0,30,18
1657056955926,ECE 65,A51,095125,Saad; Andrew S,25,0,26,1
1657056961949,ECE 109,A01,091882,Touri; Behrouz,16,0,70,54
1657056967981,ECE 180,A00,083140,Abi Samra; Nicholas Camill,1,0,30,29
1657056967981,ECE 180,B00,083141,Abi Samra; Nicholas Camill,0,0,30,30
1657056974005,MATH 10A,A01,083735,Patchell; Gregory David,1,0,30,29
1657056974005,MATH 10A,A02,083736,Patchell; Gregory David,20,0,30,10
1657056974005,MATH 10A,A03,083737,Patchell; Gregory David,16,0,30,14
1657056980028,MATH 10B,A01,083207,Lim; Seonhee,7,0,34,27
1657056980028,MATH 10B,A02,083208,Lim; Seonhee,9,0,35,26
1657056980028,MATH 10B,A03,093472,Lim; Seonhee,4,0,34,30
1657056980028,MATH 10B,B01,083739,Sinha; Shubham,9,0,30,21
1657056986062,MATH 18,A01,083743,Cinel; Cameron Alexander,6,0,30,24
1657056986062,MATH 18,A02,083744,Cinel; Cameron Alexander,15,0,30,15
1657056986062,MATH 18,A03,083745,Cinel; Cameron Alexander,8,0,30,22
1657056986062,MATH 18,B01,083748,Rideout; David Porter,4,0,37,33
1657056986062,MATH 18,B02,083749,Rideout; David Porter,3,0,36,33
1657056986062,MATH 18,B03,083750,Rideout; David Porter,2,0,37,35
1657056986062,MATH 18,B04,083751,Rideout; David Porter,5,0,36,31
1657056986062,MATH 18,B05,093473,Rideout; David Porter,4,0,36,32
1657056986062,MATH 18,B06,093474,Rideout; David Porter,5,0,36,31
1657056992094,MATH 20A,A01,083754,Zheng; Zequn,12,0,40,28
1657056998127,MATH 20B,A01,083756,Briones; Jor-el Thomas Caparas,1,0,36,35
1657056998127,MATH 20B,A02,083757,Briones; Jor-el Thomas Caparas,1,0,36,35
1657056998127,MATH 20B,A03,093475,Briones; Jor-el Thomas Caparas,0,0,36,36
1657057004155,MATH 20C,A01,083760,Briones; Jor-el Thomas Caparas,1,0,35,34
1657057004155,MATH 20C,A02,083761,Briones; Jor-el Thomas Caparas,8,0,35,27
1657057004155,MATH 20C,A03,093476,Briones; Jor-el Thomas Caparas,0,1,36,36
1657057004155,MATH 20C,B01,083762,Bach; Quang Tran,0,0,30,30
1657057010203,MATH 20D,A01,083765,Tran; Brian Kha,4,0,30,26
1657057010203,MATH 20D,A02,083766,Tran; Brian Kha,5,0,30,25
1657057010203,MATH 20D,A03,083767,Tran; Brian Kha,3,0,30,27
1657057016324,MATH 20E,A01,083771,Ganguly; Soumya,5,0,32,27
1657057016324,MATH 20E,A02,083772,Ganguly; Soumya,6,0,32,26
1657057016324,MATH 20E,B01,083773,Ciotti; Benjamin,18,0,35,17
1657057016324,MATH 20E,B02,083774,Ciotti; Benjamin,17,0,35,18
1657057022369,MATH 103A,A01,083777,Greenfeld; Be'Eri,2,0,36,34
1657057022369,MATH 103A,A02,083778,Greenfeld; Be'Eri,5,0,36,31
1657057022369,MATH 103A,A03,093561,Greenfeld; Be'Eri,4,0,36,32
1657057022369,MATH 103A,B01,083779,Greenfeld; Be'Eri,6,0,36,30
1657057022369,MATH 103A,B02,083780,Greenfeld; Be'Eri,2,0,36,34
1657057022369,MATH 103A,B03,093562,Greenfeld; Be'Eri,2,0,36,34
1657057028400,MATH 105,A01,085443,Carter; Anne Toulson,14,0,35,21
1657057028400,MATH 105,A02,093477,Carter; Anne Toulson,20,0,35,15
1657057034428,MATH 109,A01,083213,Ganzberger; Geoffrey Michael,2,0,34,32
1657057034428,MATH 109,A02,083214,Ganzberger; Geoffrey Michael,2,0,34,32
1657057034428,MATH 109,A03,093478,Ganzberger; Geoffrey Michael,1,0,34,33
1657057034428,MATH 109,B01,083215,Ganzberger; Geoffrey Michael,1,0,32,31
1657057034428,MATH 109,B02,083216,Ganzberger; Geoffrey Michael,1,0,32,31
1657057034428,MATH 109,B03,093479,Ganzberger; Geoffrey Michael,6,0,32,26
1657057040455,MATH 142A,A01,083219,Chow; Bennett,6,0,32,26
1657057040455,MATH 142A,A02,083220,Chow; Bennett,10,0,32,22
1657057040455,MATH 142A,A03,093480,Chow; Bennett,7,0,32,25
1657057040455,MATH 142A,B03,093481,Chow; Bennett,7,0,32,25
1657057040455,MATH 142A,B04,093558,Chow; Bennett,11,0,32,21
1657057040455,MATH 142A,B05,093559,Chow; Bennett,6,0,32,26
1657057046479,MATH 193A,A01,083224,Rotar; Vladimir,7,0,34,27
1657057046479,MATH 193A,A02,083225,Rotar; Vladimir,5,0,34,29
1657057046479,MATH 193A,A03,083781,Rotar; Vladimir,1,0,34,33
1657057046479,MATH 193A,A04,083782,Rotar; Vladimir,6,0,34,28
1657057046479,MATH 193A,A05,093482,Rotar; Vladimir,6,0,34,28
1657057052507,MATH 197,001,091859,McAuley; Julian John,9999,0,9999,0
1657057052507,MATH 197,002,095566,Kedlaya; Kiran S.,9997,0,9999,2
1657057052507,MATH 197,003,095567,Xiao; Ming,9999,0,9999,0
1657057052507,MATH 197,004,095571,Perols; Johan Lars,9998,0,9999,1
1657057059579,COGS 9,A01,083615,Shannon; Kyle Michael,7,0,75,68
1657057065606,COGS 11,A01,083617,Boyle; Mary E. T.,20,0,48,28
1657057071630,COGS 13,A01,083071,Bastos; Amalia Pinkusfeld,9,0,71,62
1657057077659,COGS 14A,A01,092681,Semenuks; Arturs,0,1,100,100
1657057083682,COGS 14B,A01,083073,Cheng; Tzu-Han,5,0,63,58
1657057089704,COGS 17,A01,092677,Semenuks; Arturs,4,0,81,77
1657057095725,COGS 100,A01,083619,Allen; Michael Gordon,15,0,70,55
1657057101751,COGS 101A,A01,083621,Davis; Joshua Daniel,9,0,68,59
1657057107776,COGS 101B,A01,091572,Allen; Michael Gordon,8,0,65,57
1657057113798,COGS 101C,A01,083625,Delgado; Tania,17,0,35,18
1657057119822,COGS 107A,A01,083627,Boyle; Mary E. T.,13,0,60,47
1657057125847,COGS 118A,A01,083075,Gupta; Anjum,15,0,76,61
1657057131869,CSE 3,A50,083646,Miranda; Gregory Joseph,22,0,50,28
1657057137890,CSE 8A,A50,083650,Miranda; Gregory Joseph,17,1,56,39
1657057143916,CSE 11,A01,083080,Cao; Yingjun,4,15,40,36
1657057149939,CSE 12,A01,083652,Krause-Levy; Sophia Louisa,23,1,120,97
1657057155963,CSE 15L,A01,083654,Morris; Justin Loren,8,0,50,42
1657057155963,CSE 15L,A02,083655,Morris; Justin Loren,9,0,50,41
1657057162005,CSE 20,A01,083657,Tran; Khoa Dang,37,0,80,43
1657057168027,CSE 21,A01,095574,Bach; Quang Tran,21,0,48,27
1657057174053,CSE 30,A01,083084,Eldon; John,4,0,80,76
1657057174053,CSE 30,B01,095061,Bhaskar; Nishant,6,0,50,44
1657057180077,CSE 100,A01,083659,Cao; Yingjun,3,4,70,67
1657057186102,CSE 134B,A01,083661,Powell; Thomas Allan,19,0,100,81
1657057192126,CSE 140,A01,083663,Gungor; Onat,14,0,85,71
1657057198149,CSE 140L,A01,083088,Eldon; John,16,0,100,84
1657057204171,CSE 175,A01,083665,Kumar; Rakesh,3,0,25,22
1657057210200,CSE 190,A00,092507,Dubnov; Shlomo,7,0,20,13
1657057216223,ECE 45,A01,083139,Congero; Spencer William,5,0,75,70
1657057222251,ECE 65,A50,083695,Saad; Andrew S,12,0,30,18
1657057222251,ECE 65,A51,095125,Saad; Andrew S,25,0,26,1
1657057228275,ECE 109,A01,091882,Touri; Behrouz,16,0,70,54
1657057234298,ECE 180,A00,083140,Abi Samra; Nicholas Camill,1,0,30,29
1657057234298,ECE 180,B00,083141,Abi Samra; Nicholas Camill,0,0,30,30
1657057240336,MATH 10A,A01,083735,Patchell; Gregory David,1,0,30,29
1657057240336,MATH 10A,A02,083736,Patchell; Gregory David,20,0,30,10
1657057240336,MATH 10A,A03,083737,Patchell; Gregory David,16,0,30,14
1657057246358,MATH 10B,A01,083207,Lim; Seonhee,7,0,34,27
1657057246358,MATH 10B,A02,083208,Lim; Seonhee,9,0,35,26
1657057246358,MATH 10B,A03,093472,Lim; Seonhee,4,0,34,30
1657057246358,MATH 10B,B01,083739,Sinha; Shubham,9,0,30,21
1657057252380,MATH 18,A01,083743,Cinel; Cameron Alexander,6,0,30,24
1657057252380,MATH 18,A02,083744,Cinel; Cameron Alexander,15,0,30,15
1657057252380,MATH 18,A03,083745,Cinel; Cameron Alexander,8,0,30,22
1657057252380,MATH 18,B01,083748,Rideout; David Porter,4,0,37,33
1657057252380,MATH 18,B02,083749,Rideout; David Porter,3,0,36,33
1657057252380,MATH 18,B03,083750,Rideout; David Porter,2,0,37,35
1657057252380,MATH 18,B04,083751,Rideout; David Porter,5,0,36,31
1657057252380,MATH 18,B05,093473,Rideout; David Porter,4,0,36,32
1657057252380,MATH 18,B06,093474,Rideout; David Porter,5,0,36,31
1657057258404,MATH 20A,A01,083754,Zheng; Zequn,12,0,40,28
1657057264434,MATH 20B,A01,083756,Briones; Jor-el Thomas Caparas,1,0,36,35
1657057264434,MATH 20B,A02,083757,Briones; Jor-el Thomas Caparas,1,0,36,35
1657057264434,MATH 20B,A03,093475,Briones; Jor-el Thomas Caparas,0,0,36,36
1657057270462,MATH 20C,A01,083760,Briones; Jor-el Thomas Caparas,1,0,35,34
1657057270462,MATH 20C,A02,083761,Briones; Jor-el Thomas Caparas,8,0,35,27
1657057270462,MATH 20C,A03,093476,Briones; Jor-el Thomas Caparas,0,1,36,36
1657057270462,MATH 20C,B01,083762,Bach; Quang Tran,0,0,30,30
1657057276491,MATH 20D,A01,083765,Tran; Brian Kha,4,0,30,26
1657057276491,MATH 20D,A02,083766,Tran; Brian Kha,5,0,30,25
1657057276491,MATH 20D,A03,083767,Tran; Brian Kha,3,0,30,27
1657057282516,MATH 20E,A01,083771,Ganguly; Soumya,5,0,32,27
1657057282516,MATH 20E,A02,083772,Ganguly; Soumya,6,0,32,26
1657057282516,MATH 20E,B01,083773,Ciotti; Benjamin,18,0,35,17
1657057282516,MATH 20E,B02,083774,Ciotti; Benjamin,17,0,35,18
1657057288543,MATH 103A,A01,083777,Greenfeld; Be'Eri,2,0,36,34
1657057288543,MATH 103A,A02,083778,Greenfeld; Be'Eri,5,0,36,31
1657057288543,MATH 103A,A03,093561,Greenfeld; Be'Eri,4,0,36,32
1657057288543,MATH 103A,B01,083779,Greenfeld; Be'Eri,6,0,36,30
1657057288543,MATH 103A,B02,083780,Greenfeld; Be'Eri,2,0,36,34
1657057288543,MATH 103A,B03,093562,Greenfeld; Be'Eri,2,0,36,34
1657057294570,MATH 105,A01,085443,Carter; Anne Toulson,14,0,35,21
1657057294570,MATH 105,A02,093477,Carter; Anne Toulson,20,0,35,15
1657057300605,MATH 109,A01,083213,Ganzberger; Geoffrey Michael,2,0,34,32
1657057300605,MATH 109,A02,083214,Ganzberger; Geoffrey Michael,2,0,34,32
1657057300605,MATH 109,A03,093478,Ganzberger; Geoffrey Michael,1,0,34,33
1657057300605,MATH 109,B01,083215,Ganzberger; Geoffrey Michael,1,0,32,31
1657057300605,MATH 109,B02,083216,Ganzberger; Geoffrey Michael,1,0,32,31
1657057300605,MATH 109,B03,093479,Ganzberger; Geoffrey Michael,6,0,32,26
1657057306627,MATH 142A,A01,083219,Chow; Bennett,6,0,32,26
1657057306627,MATH 142A,A02,083220,Chow; Bennett,10,0,32,22
1657057306627,MATH 142A,A03,093480,Chow; Bennett,7,0,32,25
1657057306627,MATH 142A,B03,093481,Chow; Bennett,7,0,32,25
1657057306627,MATH 142A,B04,093558,Chow; Bennett,11,0,32,21
1657057306627,MATH 142A,B05,093559,Chow; Bennett,6,0,32,26
1657057312651,MATH 193A,A01,083224,Rotar; Vladimir,7,0,34,27
1657057312651,MATH 193A,A02,083225,Rotar; Vladimir,5,0,34,29
1657057312651,MATH 193A,A03,083781,Rotar; Vladimir,1,0,34,33
1657057312651,MATH 193A,A04,083782,Rotar; Vladimir,6,0,34,28
1657057312651,MATH 193A,A05,093482,Rotar; Vladimir,6,0,34,28
1657057318677,MATH 197,001,091859,McAuley; Julian John,9999,0,9999,0
1657057318677,MATH 197,002,095566,Kedlaya; Kiran S.,9997,0,9999,2
1657057318677,MATH 197,003,095567,Xiao; Ming,9999,0,9999,0
1657057318677,MATH 197,004,095571,Perols; Johan Lars,9998,0,9999,1
1657057325733,COGS 9,A01,083615,Shannon; Kyle Michael,7,0,75,68
1657057331760,COGS 11,A01,083617,Boyle; Mary E. T.,20,0,48,28
1657057337786,COGS 13,A01,083071,Bastos; Amalia Pinkusfeld,9,0,71,62
1657057343811,COGS 14A,A01,092681,Semenuks; Arturs,0,1,100,100
1657057349837,COGS 14B,A01,083073,Cheng; Tzu-Han,5,0,63,58
1657057355862,COGS 17,A01,092677,Semenuks; Arturs,4,0,81,77
1657057361886,COGS 100,A01,083619,Allen; Michael Gordon,15,0,70,55
1657057367908,COGS 101A,A01,083621,Davis; Joshua Daniel,9,0,68,59
1657057373940,COGS 101B,A01,091572,Allen; Michael Gordon,8,0,65,57
1657057379967,COGS 101C,A01,083625,Delgado; Tania,17,0,35,18
1657057385992,COGS 107A,A01,083627,Boyle; Mary E. T.,13,0,60,47
1657057392029,COGS 118A,A01,083075,Gupta; Anjum,15,0,76,61
1657057398052,CSE 3,A50,083646,Miranda; Gregory Joseph,22,0,50,28
1657057404084,CSE 8A,A50,083650,Miranda; Gregory Joseph,17,1,56,39
1657057410107,CSE 11,A01,083080,Cao; Yingjun,4,15,40,36
1657057416138,CSE 12,A01,083652,Krause-Levy; Sophia Louisa,23,1,120,97
1657057422166,CSE 15L,A01,083654,Morris; Justin Loren,8,0,50,42
1657057422166,CSE 15L,A02,083655,Morris; Justin Loren,9,0,50,41
1657057428191,CSE 20,A01,083657,Tran; Khoa Dang,37,0,80,43
1657057434217,CSE 21,A01,095574,Bach; Quang Tran,21,0,48,27
1657057440248,CSE 30,A01,083084,Eldon; John,4,0,80,76
1657057440248,CSE 30,B01,095061,Bhaskar; Nishant,6,0,50,44
1657057446279,CSE 100,A01,083659,Cao; Yingjun,3,4,70,67
1657057452310,CSE 134B,A01,083661,Powell; Thomas Allan,19,0,100,81
1657057458349,CSE 140,A01,083663,Gungor; Onat,14,0,85,71
1657057464372,CSE 140L,A01,083088,Eldon; John,16,0,100,84
1657057470396,CSE 175,A01,083665,Kumar; Rakesh,3,0,25,22
1657057476431,CSE 190,A00,092507,Dubnov; Shlomo,7,0,20,13
1657057482464,ECE 45,A01,083139,Congero; Spencer William,5,0,75,70
1657057488487,ECE 65,A50,083695,Saad; Andrew S,12,0,30,18
1657057488487,ECE 65,A51,095125,Saad; Andrew S,25,0,26,1
1657057494511,ECE 109,A01,091882,Touri; Behrouz,16,0,70,54
1657057500536,ECE 180,A00,083140,Abi Samra; Nicholas Camill,1,0,30,29
1657057500536,ECE 180,B00,083141,Abi Samra; Nicholas Camill,0,0,30,30
1657057506563,MATH 10A,A01,083735,Patchell; Gregory David,1,0,30,29
1657057506563,MATH 10A,A02,083736,Patchell; Gregory David,20,0,30,10
1657057506563,MATH 10A,A03,083737,Patchell; Gregory David,16,0,30,14
1657057512591,MATH 10B,A01,083207,Lim; Seonhee,7,0,34,27
1657057512591,MATH 10B,A02,083208,Lim; Seonhee,9,0,35,26
1657057512591,MATH 10B,A03,093472,Lim; Seonhee,4,0,34,30
1657057512591,MATH 10B,B01,083739,Sinha; Shubham,9,0,30,21
1657057518615,MATH 18,A01,083743,Cinel; Cameron Alexander,6,0,30,24
1657057518615,MATH 18,A02,083744,Cinel; Cameron Alexander,15,0,30,15
1657057518615,MATH 18,A03,083745,Cinel; Cameron Alexander,8,0,30,22
1657057518615,MATH 18,B01,083748,Rideout; David Porter,4,0,37,33
1657057518615,MATH 18,B02,083749,Rideout; David Porter,3,0,36,33
1657057518615,MATH 18,B03,083750,Rideout; David Porter,2,0,37,35
1657057518615,MATH 18,B04,083751,Rideout; David Porter,5,0,36,31
1657057518615,MATH 18,B05,093473,Rideout; David Porter,4,0,36,32
1657057518615,MATH 18,B06,093474,Rideout; David Porter,5,0,36,31
1657057524640,MATH 20A,A01,083754,Zheng; Zequn,12,0,40,28
1657057530667,MATH 20B,A01,083756,Briones; Jor-el Thomas Caparas,1,0,36,35
1657057530667,MATH 20B,A02,083757,Briones; Jor-el Thomas Caparas,1,0,36,35
1657057530667,MATH 20B,A03,093475,Briones; Jor-el Thomas Caparas,0,0,36,36
1657057536690,MATH 20C,A01,083760,Briones; Jor-el Thomas Caparas,1,0,35,34
1657057536690,MATH 20C,A02,083761,Briones; Jor-el Thomas Caparas,8,0,35,27
1657057536690,MATH 20C,A03,093476,Briones; Jor-el Thomas Caparas,0,1,36,36
1657057536690,MATH 20C,B01,083762,Bach; Quang Tran,0,0,30,30
1657057542718,MATH 20D,A01,083765,Tran; Brian Kha,4,0,30,26
1657057542718,MATH 20D,A02,083766,Tran; Brian Kha,5,0,30,25
1657057542718,MATH 20D,A03,083767,Tran; Brian Kha,3,0,30,27
1657057548743,MATH 20E,A01,083771,Ganguly; Soumya,5,0,32,27
1657057548743,MATH 20E,A02,083772,Ganguly; Soumya,6,0,32,26
1657057548743,MATH 20E,B01,083773,Ciotti; Benjamin,18,0,35,17
1657057548743,MATH 20E,B02,083774,Ciotti; Benjamin,17,0,35,18
1657057554767,MATH 103A,A01,083777,Greenfeld; Be'Eri,2,0,36,34
1657057554767,MATH 103A,A02,083778,Greenfeld; Be'Eri,5,0,36,31
1657057554767,MATH 103A,A03,093561,Greenfeld; Be'Eri,4,0,36,32
1657057554767,MATH 103A,B01,083779,Greenfeld; Be'Eri,6,0,36,30
1657057554767,MATH 103A,B02,083780,Greenfeld; Be'Eri,2,0,36,34
1657057554767,MATH 103A,B03,093562,Greenfeld; Be'Eri,2,0,36,34
1657057560793,MATH 105,A01,085443,Carter; Anne Toulson,14,0,35,21
1657057560793,MATH 105,A02,093477,Carter; Anne Toulson,20,0,35,15
1657057566822,MATH 109,A01,083213,Ganzberger; Geoffrey Michael,2,0,34,32
1657057566822,MATH 109,A02,083214,Ganzberger; Geoffrey Michael,2,0,34,32
1657057566822,MATH 109,A03,093478,Ganzberger; Geoffrey Michael,1,0,34,33
1657057566822,MATH 109,B01,083215,Ganzberger; Geoffrey Michael,1,0,32,31
1657057566822,MATH 109,B02,083216,Ganzberger; Geoffrey Michael,1,0,32,31
1657057566822,MATH 109,B03,093479,Ganzberger; Geoffrey Michael,6,0,32,26
1657057572855,MATH 142A,A01,083219,Chow; Bennett,6,0,32,26
1657057572855,MATH 142A,A02,083220,Chow; Bennett,10,0,32,22
1657057572855,MATH 142A,A03,093480,Chow; Bennett,7,0,32,25
1657057572855,MATH 142A,B03,093481,Chow; Bennett,7,0,32,25
1657057572855,MATH 142A,B04,093558,Chow; Bennett,11,0,32,21
1657057572855,MATH 142A,B05,093559,Chow; Bennett,6,0,32,26
1657057578884,MATH 193A,A01,083224,Rotar; Vladimir,7,0,34,27
1657057578884,MATH 193A,A02,083225,Rotar; Vladimir,5,0,34,29
1657057578884,MATH 193A,A03,083781,Rotar; Vladimir,1,0,34,33
1657057578884,MATH 193A,A04,083782,Rotar; Vladimir,6,0,34,28
1657057578884,MATH 193A,A05,093482,Rotar; Vladimir,6,0,34,28
1657057584906,MATH 197,001,091859,McAuley; Julian John,9999,0,9999,0
1657057584906,MATH 197,002,095566,Kedlaya; Kiran S.,9997,0,9999,2
1657057584906,MATH 197,003,095567,Xiao; Ming,9999,0,9999,0
1657057584906,MATH 197,004,095571,Perols; Johan Lars,9998,0,9999,1
1657057592002,COGS 9,A01,083615,Shannon; Kyle Michael,7,0,75,68
1657057598025,COGS 11,A01,083617,Boyle; Mary E. T.,20,0,48,28
1657057604048,COGS 13,A01,083071,Bastos; Amalia Pinkusfeld,9,0,71,62
1657057610145,COGS 14A,A01,092681,Semenuks; Arturs,0,1,100,100
1657057616185,COGS 14B,A01,083073,Cheng; Tzu-Han,5,0,63,58
1657057622216,COGS 17,A01,092677,Semenuks; Arturs,4,0,81,77
1657057628239,COGS 100,A01,083619,Allen; Michael Gordon,15,0,70,55
1657057634262,COGS 101A,A01,083621,Davis; Joshua Daniel,9,0,68,59
1657057640285,COGS 101B,A01,091572,Allen; Michael Gordon,8,0,65,57
1657057646318,COGS 101C,A01,083625,Delgado; Tania,17,0,35,18
1657057652353,COGS 107A,A01,083627,Boyle; Mary E. T.,13,0,60,47
1657057658376,COGS 118A,A01,083075,Gupta; Anjum,15,0,76,61
1657057664407,CSE 3,A50,083646,Miranda; Gregory Joseph,22,0,50,28
1657057670436,CSE 8A,A50,083650,Miranda; Gregory Joseph,17,1,56,39
1657057676472,CSE 11,A01,083080,Cao; Yingjun,4,15,40,36
1657057682496,CSE 12,A01,083652,Krause-Levy; Sophia Louisa,23,1,120,97
1657057688520,CSE 15L,A01,083654,Morris; Justin Loren,8,0,50,42
1657057688520,CSE 15L,A02,083655,Morris; Justin Loren,9,0,50,41
1657057694549,CSE 20,A01,083657,Tran; Khoa Dang,37,0,80,43
1657057700576,CSE 21,A01,095574,Bach; Quang Tran,21,0,48,27
1657057706607,CSE 30,A01,083084,Eldon; John,4,0,80,76
1657057706607,CSE 30,B01,095061,Bhaskar; Nishant,6,0,50,44
1657057712628,CSE 100,A01,083659,Cao; Yingjun,3,4,70,67
1657057718665,CSE 134B,A01,083661,Powell; Thomas Allan,19,0,100,81
1657057724691,CSE 140,A01,083663,Gungor; Onat,14,0,85,71
1657057730713,CSE 140L,A01,083088,Eldon; John,16,0,100,84
1657057736740,CSE 175,A01,083665,Kumar; Rakesh,3,0,25,22
1657057742772,CSE 190,A00,092507,Dubnov; Shlomo,7,0,20,13
1657057748795,ECE 45,A01,083139,Congero; Spencer William,5,0,75,70
1657057754819,ECE 65,A50,083695,Saad; Andrew S,12,0,30,18
1657057754819,ECE 65,A51,095125,Saad; Andrew S,25,0,26,1
1657057760844,ECE 109,A01,091882,Touri; Behrouz,16,0,70,54
1657057766873,ECE 180,A00,083140,Abi Samra; Nicholas Camill,1,0,30,29
1657057766873,ECE 180,B00,083141,Abi Samra; Nicholas Camill,0,0,30,30
1657057772914,MATH 10A,A01,083735,Patchell; Gregory David,1,0,30,29
1657057772914,MATH 10A,A02,083736,Patchell; Gregory David,20,0,30,10
1657057772914,MATH 10A,A03,083737,Patchell; Gregory David,16,0,30,14
1657057778949,MATH 10B,A01,083207,Lim; Seonhee,7,0,34,27
1657057778949,MATH 10B,A02,083208,Lim; Seonhee,9,0,35,26
1657057778949,MATH 10B,A03,093472,Lim; Seonhee,4,0,34,30
1657057778949,MATH 10B,B01,083739,Sinha; Shubham,9,0,30,21
1657057784978,MATH 18,A01,083743,Cinel; Cameron Alexander,6,0,30,24
1657057784978,MATH 18,A02,083744,Cinel; Cameron Alexander,15,0,30,15
1657057784978,MATH 18,A03,083745,Cinel; Cameron Alexander,8,0,30,22
1657057784978,MATH 18,B01,083748,Rideout; David Porter,4,0,37,33
1657057784978,MATH 18,B02,083749,Rideout; David Porter,3,0,36,33
1657057784978,MATH 18,B03,083750,Rideout; David Porter,2,0,37,35
1657057784978,MATH 18,B04,083751,Rideout; David Porter,5,0,36,31
1657057784978,MATH 18,B05,093473,Rideout; David Porter,4,0,36,32
1657057784978,MATH 18,B06,093474,Rideout; David Porter,5,0,36,31
1657057791005,MATH 20A,A01,083754,Zheng; Zequn,12,0,40,28
1657057797027,MATH 20B,A01,083756,Briones; Jor-el Thomas Caparas,1,0,36,35
1657057797027,MATH 20B,A02,083757,Briones; Jor-el Thomas Caparas,1,0,36,35
1657057797027,MATH 20B,A03,093475,Briones; Jor-el Thomas Caparas,0,0,36,36
1657057803063,MATH 20C,A01,083760,Briones; Jor-el Thomas Caparas,1,0,35,34
1657057803063,MATH 20C,A02,083761,Briones; Jor-el Thomas Caparas,8,0,35,27
1657057803063,MATH 20C,A03,093476,Briones; Jor-el Thomas Caparas,0,1,36,36
1657057803063,MATH 20C,B01,083762,Bach; Quang Tran,0,0,30,30
1657057809085,MATH 20D,A01,083765,Tran; Brian Kha,4,0,30,26
1657057809085,MATH 20D,A02,083766,Tran; Brian Kha,5,0,30,25
1657057809085,MATH 20D,A03,083767,Tran; Brian Kha,3,0,30,27
1657057815117,MATH 20E,A01,083771,Ganguly; Soumya,5,0,32,27
1657057815117,MATH 20E,A02,083772,Ganguly; Soumya,6,0,32,26
1657057815117,MATH 20E,B01,083773,Ciotti; Benjamin,18,0,35,17
1657057815117,MATH 20E,B02,083774,Ciotti; Benjamin,17,0,35,18
1657057821149,MATH 103A,A01,083777,Greenfeld; Be'Eri,2,0,36,34
1657057821149,MATH 103A,A02,083778,Greenfeld; Be'Eri,5,0,36,31
1657057821149,MATH 103A,A03,093561,Greenfeld; Be'Eri,4,0,36,32
1657057821149,MATH 103A,B01,083779,Greenfeld; Be'Eri,6,0,36,30
1657057821149,MATH 103A,B02,083780,Greenfeld; Be'Eri,2,0,36,34
1657057821149,MATH 103A,B03,093562,Greenfeld; Be'Eri,2,0,36,34
1657057827175,MATH 105,A01,085443,Carter; Anne Toulson,14,0,35,21
1657057827175,MATH 105,A02,093477,Carter; Anne Toulson,20,0,35,15
1657057833211,MATH 109,A01,083213,Ganzberger; Geoffrey Michael,2,0,34,32
1657057833211,MATH 109,A02,083214,Ganzberger; Geoffrey Michael,2,0,34,32
1657057833211,MATH 109,A03,093478,Ganzberger; Geoffrey Michael,1,0,34,33
1657057833211,MATH 109,B01,083215,Ganzberger; Geoffrey Michael,1,0,32,31
1657057833211,MATH 109,B02,083216,Ganzberger; Geoffrey Michael,1,0,32,31
1657057833211,MATH 109,B03,093479,Ganzberger; Geoffrey Michael,6,0,32,26
1657057839246,MATH 142A,A01,083219,Chow; Bennett,6,0,32,26
1657057839246,MATH 142A,A02,083220,Chow; Bennett,10,0,32,22
1657057839246,MATH 142A,A03,093480,Chow; Bennett,7,0,32,25
1657057839246,MATH 142A,B03,093481,Chow; Bennett,7,0,32,25
1657057839246,MATH 142A,B04,093558,Chow; Bennett,11,0,32,21
1657057839246,MATH 142A,B05,093559,Chow; Bennett,6,0,32,26
1657057845277,MATH 193A,A01,083224,Rotar; Vladimir,7,0,34,27
1657057845277,MATH 193A,A02,083225,Rotar; Vladimir,5,0,34,29
1657057845277,MATH 193A,A03,083781,Rotar; Vladimir,1,0,34,33
1657057845277,MATH 193A,A04,083782,Rotar; Vladimir,6,0,34,28
1657057845277,MATH 193A,A05,093482,Rotar; Vladimir,6,0,34,28
1657057851310,MATH 197,001,091859,McAuley; Julian John,9999,0,9999,0
1657057851310,MATH 197,002,095566,Kedlaya; Kiran S.,9997,0,9999,2
1657057851310,MATH 197,003,095567,Xiao; Ming,9999,0,9999,0
1657057851310,MATH 197,004,095571,Perols; Johan Lars,9998,0,9999,1
1657057858372,COGS 9,A01,083615,Shannon; Kyle Michael,7,0,75,68
1657057864395,COGS 11,A01,083617,Boyle; Mary E. T.,20,0,48,28
1657057870433,COGS 13,A01,083071,Bastos; Amalia Pinkusfeld,9,0,71,62
1657057876460,COGS 14A,A01,092681,Semenuks; Arturs,0,1,100,100
1657057882485,COGS 14B,A01,083073,Cheng; Tzu-Han,5,0,63,58
1657057888512,COGS 17,A01,092677,Semenuks; Arturs,4,0,81,77
1657057894536,COGS 100,A01,083619,Allen; Michael Gordon,15,0,70,55
1657057900563,COGS 101A,A01,083621,Davis; Joshua Daniel,9,0,68,59
1657057906588,COGS 101B,A01,091572,Allen; Michael Gordon,8,0,65,57
1657057912621,COGS 101C,A01,083625,Delgado; Tania,17,0,35,18
1657057918643,COGS 107A,A01,083627,Boyle; Mary E. T.,13,0,60,47
1657057924665,COGS 118A,A01,083075,Gupta; Anjum,15,0,76,61
1657057930694,CSE 3,A50,083646,Miranda; Gregory Joseph,22,0,50,28
1657057936724,CSE 8A,A50,083650,Miranda; Gregory Joseph,17,1,56,39
1657057942749,CSE 11,A01,083080,Cao; Yingjun,4,15,40,36
1657057948774,CSE 12,A01,083652,Krause-Levy; Sophia Louisa,23,1,120,97
1657057954807,CSE 15L,A01,083654,Morris; Justin Loren,8,0,50,42
1657057954807,CSE 15L,A02,083655,Morris; Justin Loren,9,0,50,41
1657057960830,CSE 20,A01,083657,Tran; Khoa Dang,37,0,80,43
1657057966852,CSE 21,A01,095574,Bach; Quang Tran,21,0,48,27
1657057972892,CSE 30,A01,083084,Eldon; John,4,0,80,76
1657057972892,CSE 30,B01,095061,Bhaskar; Nishant,6,0,50,44
1657057978915,CSE 100,A01,083659,Cao; Yingjun,3,4,70,67
1657057984945,CSE 134B,A01,083661,Powell; Thomas Allan,19,0,100,81
1657057990969,CSE 140,A01,083663,Gungor; Onat,14,0,85,71
1657057996999,CSE 140L,A01,083088,Eldon; John,16,0,100,84
1657058003029,CSE 175,A01,083665,Kumar; Rakesh,3,0,25,22
1657058009054,CSE 190,A00,092507,Dubnov; Shlomo,7,0,20,13
1657058015085,ECE 45,A01,083139,Congero; Spencer William,5,0,75,70
1657058021108,ECE 65,A50,083695,Saad; Andrew S,12,0,30,18
1657058021108,ECE 65,A51,095125,Saad; Andrew S,25,0,26,1
1657058027136,ECE 109,A01,091882,Touri; Behrouz,16,0,70,54
1657058033158,ECE 180,A00,083140,Abi Samra; Nicholas Camill,1,0,30,29
1657058033158,ECE 180,B00,083141,Abi Samra; Nicholas Camill,0,0,30,30
1657058039180,MATH 10A,A01,083735,Patchell; Gregory David,1,0,30,29
1657058039180,MATH 10A,A02,083736,Patchell; Gregory David,20,0,30,10
1657058039180,MATH 10A,A03,083737,Patchell; Gregory David,16,0,30,14
1657058045205,MATH 10B,A01,083207,Lim; Seonhee,7,0,34,27
1657058045205,MATH 10B,A02,083208,Lim; Seonhee,9,0,35,26
1657058045205,MATH 10B,A03,093472,Lim; Seonhee,4,0,34,30
1657058045205,MATH 10B,B01,083739,Sinha; Shubham,9,0,30,21
1657058051236,MATH 18,A01,083743,Cinel; Cameron Alexander,6,0,30,24
1657058051236,MATH 18,A02,083744,Cinel; Cameron Alexander,15,0,30,15
1657058051236,MATH 18,A03,083745,Cinel; Cameron Alexander,8,0,30,22
1657058051236,MATH 18,B01,083748,Rideout; David Porter,4,0,37,33
1657058051236,MATH 18,B02,083749,Rideout; David Porter,3,0,36,33
1657058051236,MATH 18,B03,083750,Rideout; David Porter,2,0,37,35
1657058051236,MATH 18,B04,083751,Rideout; David Porter,5,0,36,31
1657058051236,MATH 18,B05,093473,Rideout; David Porter,4,0,36,32
1657058051236,MATH 18,B06,093474,Rideout; David Porter,5,0,36,31
1657058057263,MATH 20A,A01,083754,Zheng; Zequn,12,0,40,28
1657058063289,MATH 20B,A01,083756,Briones; Jor-el Thomas Caparas,1,0,36,35
1657058063289,MATH 20B,A02,083757,Briones; Jor-el Thomas Caparas,1,0,36,35
1657058063289,MATH 20B,A03,093475,Briones; Jor-el Thomas Caparas,0,0,36,36
1657058069326,MATH 20C,A01,083760,Briones; Jor-el Thomas Caparas,1,0,35,34
1657058069326,MATH 20C,A02,083761,Briones; Jor-el Thomas Caparas,8,0,35,27
1657058069326,MATH 20C,A03,093476,Briones; Jor-el Thomas Caparas,0,1,36,36
1657058069326,MATH 20C,B01,083762,Bach; Quang Tran,0,0,30,30
1657058075354,MATH 20D,A01,083765,Tran; Brian Kha,4,0,30,26
1657058075354,MATH 20D,A02,083766,Tran; Brian Kha,5,0,30,25
1657058075354,MATH 20D,A03,083767,Tran; Brian Kha,3,0,30,27
1657058081382,MATH 20E,A01,083771,Ganguly; Soumya,5,0,32,27
1657058081382,MATH 20E,A02,083772,Ganguly; Soumya,6,0,32,26
1657058081382,MATH 20E,B01,083773,Ciotti; Benjamin,18,0,35,17
1657058081382,MATH 20E,B02,083774,Ciotti; Benjamin,17,0,35,18
1657058087407,MATH 103A,A01,083777,Greenfeld; Be'Eri,2,0,36,34
1657058087407,MATH 103A,A02,083778,Greenfeld; Be'Eri,5,0,36,31
1657058087407,MATH 103A,A03,093561,Greenfeld; Be'Eri,4,0,36,32
1657058087407,MATH 103A,B01,083779,Greenfeld; Be'Eri,6,0,36,30
1657058087407,MATH 103A,B02,083780,Greenfeld; Be'Eri,2,0,36,34
1657058087407,MATH 103A,B03,093562,Greenfeld; Be'Eri,2,0,36,34
1657058093433,MATH 105,A01,085443,Carter; Anne Toulson,14,0,35,21
1657058093433,MATH 105,A02,093477,Carter; Anne Toulson,20,0,35,15
1657058099457,MATH 109,A01,083213,Ganzberger; Geoffrey Michael,2,0,34,32
1657058099457,MATH 109,A02,083214,Ganzberger; Geoffrey Michael,2,0,34,32
1657058099457,MATH 109,A03,093478,Ganzberger; Geoffrey Michael,1,0,34,33
1657058099457,MATH 109,B01,083215,Ganzberger; Geoffrey Michael,1,0,32,31
1657058099457,MATH 109,B02,083216,Ganzberger; Geoffrey Michael,1,0,32,31
1657058099457,MATH 109,B03,093479,Ganzberger; Geoffrey Michael,6,0,32,26
1657058105483,MATH 142A,A01,083219,Chow; Bennett,6,0,32,26
1657058105483,MATH 142A,A02,083220,Chow; Bennett,10,0,32,22
1657058105483,MATH 142A,A03,093480,Chow; Bennett,7,0,32,25
1657058105483,MATH 142A,B03,093481,Chow; Bennett,7,0,32,25
1657058105483,MATH 142A,B04,093558,Chow; Bennett,11,0,32,21
1657058105483,MATH 142A,B05,093559,Chow; Bennett,6,0,32,26
1657058111506,MATH 193A,A01,083224,Rotar; Vladimir,7,0,34,27
1657058111506,MATH 193A,A02,083225,Rotar; Vladimir,5,0,34,29
1657058111506,MATH 193A,A03,083781,Rotar; Vladimir,1,0,34,33
1657058111506,MATH 193A,A04,083782,Rotar; Vladimir,6,0,34,28
1657058111506,MATH 193A,A05,093482,Rotar; Vladimir,6,0,34,28
1657058117530,MATH 197,001,091859,McAuley; Julian John,9999,0,9999,0
1657058117530,MATH 197,002,095566,Kedlaya; Kiran S.,9997,0,9999,2
1657058117530,MATH 197,003,095567,Xiao; Ming,9999,0,9999,0
1657058117530,MATH 197,004,095571,Perols; Johan Lars,9998,0,9999,1
1657058124601,COGS 9,A01,083615,Shannon; Kyle Michael,7,0,75,68
1657058130628,COGS 11,A01,083617,Boyle; Mary E. T.,20,0,48,28
1657058136658,COGS 13,A01,083071,Bastos; Amalia Pinkusfeld,9,0,71,62
1657058142686,COGS 14A,A01,092681,Semenuks; Arturs,0,1,100,100
1657058148713,COGS 14B,A01,083073,Cheng; Tzu-Han,5,0,63,58
1657058154738,COGS 17,A01,092677,Semenuks; Arturs,4,0,81,77
1657058160762,COGS 100,A01,083619,Allen; Michael Gordon,15,0,70,55
1657058166788,COGS 101A,A01,083621,Davis; Joshua Daniel,9,0,68,59
1657058172814,COGS 101B,A01,091572,Allen; Michael Gordon,8,0,65,57
1657058178838,COGS 101C,A01,083625,Delgado; Tania,17,0,35,18
1657058184861,COGS 107A,A01,083627,Boyle; Mary E. T.,13,0,60,47
1657058190892,COGS 118A,A01,083075,Gupta; Anjum,15,0,76,61
1657058196926,CSE 3,A50,083646,Miranda; Gregory Joseph,22,0,50,28
1657058202959,CSE 8A,A50,083650,Miranda; Gregory Joseph,17,1,56,39
1657058209057,CSE 11,A01,083080,Cao; Yingjun,4,15,40,36
1657058215080,CSE 12,A01,083652,Krause-Levy; Sophia Louisa,23,1,120,97
1657058221101,CSE 15L,A01,083654,Morris; Justin Loren,8,0,50,42
1657058221101,CSE 15L,A02,083655,Morris; Justin Loren,9,0,50,41
1657058227128,CSE 20,A01,083657,Tran; Khoa Dang,37,0,80,43
1657058233149,CSE 21,A01,095574,Bach; Quang Tran,21,0,48,27
1657058239175,CSE 30,A01,083084,Eldon; John,4,0,80,76
1657058239175,CSE 30,B01,095061,Bhaskar; Nishant,6,0,50,44
1657058245199,CSE 100,A01,083659,Cao; Yingjun,3,4,70,67
1657058251227,CSE 134B,A01,083661,Powell; Thomas Allan,19,0,100,81
1657058257254,CSE 140,A01,083663,Gungor; Onat,14,0,85,71
1657058263277,CSE 140L,A01,083088,Eldon; John,16,0,100,84
1657058269301,CSE 175,A01,083665,Kumar; Rakesh,3,0,25,22
1657058275325,CSE 190,A00,092507,Dubnov; Shlomo,7,0,20,13
1657058281352,ECE 45,A01,083139,Congero; Spencer William,5,0,75,70
1657058287379,ECE 65,A50,083695,Saad; Andrew S,12,0,30,18
1657058287379,ECE 65,A51,095125,Saad; Andrew S,25,0,26,1
1657058293409,ECE 109,A01,091882,Touri; Behrouz,16,0,70,54
1657058299431,ECE 180,A00,083140,Abi Samra; Nicholas Camill,1,0,30,29
1657058299431,ECE 180,B00,083141,Abi Samra; Nicholas Camill,0,0,30,30
1657058305456,MATH 10A,A01,083735,Patchell; Gregory David,1,0,30,29
1657058305456,MATH 10A,A02,083736,Patchell; Gregory David,20,0,30,10
1657058305456,MATH 10A,A03,083737,Patchell; Gregory David,16,0,30,14
1657058311481,MATH 10B,A01,083207,Lim; Seonhee,7,0,34,27
1657058311481,MATH 10B,A02,083208,Lim; Seonhee,9,0,35,26
1657058311481,MATH 10B,A03,093472,Lim; Seonhee,4,0,34,30
1657058311481,MATH 10B,B01,083739,Sinha; Shubham,9,0,30,21
1657058317514,MATH 18,A01,083743,Cinel; Cameron Alexander,6,0,30,24
1657058317514,MATH 18,A02,083744,Cinel; Cameron Alexander,15,0,30,15
1657058317514,MATH 18,A03,083745,Cinel; Cameron Alexander,8,0,30,22
1657058317514,MATH 18,B01,083748,Rideout; David Porter,4,0,37,33
1657058317514,MATH 18,B02,083749,Rideout; David Porter,3,0,36,33
1657058317514,MATH 18,B03,083750,Rideout; David Porter,2,0,37,35
1657058317514,MATH 18,B04,083751,Rideout; David Porter,5,0,36,31
1657058317514,MATH 18,B05,093473,Rideout; David Porter,4,0,36,32
1657058317514,MATH 18,B06,093474,Rideout; David Porter,5,0,36,31
1657058323538,MATH 20A,A01,083754,Zheng; Zequn,12,0,40,28
1657058329566,MATH 20B,A01,083756,Briones; Jor-el Thomas Caparas,1,0,36,35
1657058329566,MATH 20B,A02,083757,Briones; Jor-el Thomas Caparas,1,0,36,35
1657058329566,MATH 20B,A03,093475,Briones; Jor-el Thomas Caparas,0,0,36,36
1657058335593,MATH 20C,A01,083760,Briones; Jor-el Thomas Caparas,1,0,35,34
1657058335593,MATH 20C,A02,083761,Briones; Jor-el Thomas Caparas,8,0,35,27
1657058335593,MATH 20C,A03,093476,Briones; Jor-el Thomas Caparas,0,1,36,36
1657058335593,MATH 20C,B01,083762,Bach; Quang Tran,0,0,30,30
1657058341630,MATH 20D,A01,083765,Tran; Brian Kha,4,0,30,26
1657058341630,MATH 20D,A02,083766,Tran; Brian Kha,5,0,30,25
1657058341630,MATH 20D,A03,083767,Tran; Brian Kha,3,0,30,27
1657058347666,MATH 20E,A01,083771,Ganguly; Soumya,5,0,32,27
1657058347666,MATH 20E,A02,083772,Ganguly; Soumya,6,0,32,26
1657058347666,MATH 20E,B01,083773,Ciotti; Benjamin,18,0,35,17
1657058347666,MATH 20E,B02,083774,Ciotti; Benjamin,17,0,35,18
1657058353696,MATH 103A,A01,083777,Greenfeld; Be'Eri,2,0,36,34
1657058353696,MATH 103A,A02,083778,Greenfeld; Be'Eri,5,0,36,31
1657058353696,MATH 103A,A03,093561,Greenfeld; Be'Eri,4,0,36,32
1657058353696,MATH 103A,B01,083779,Greenfeld; Be'Eri,6,0,36,30
1657058353696,MATH 103A,B02,083780,Greenfeld; Be'Eri,2,0,36,34
1657058353696,MATH 103A,B03,093562,Greenfeld; Be'Eri,2,0,36,34
1657058359721,MATH 105,A01,085443,Carter; Anne Toulson,14,0,35,21
1657058359721,MATH 105,A02,093477,Carter; Anne Toulson,20,0,35,15
1657058374111,MATH 109,A01,083213,Ganzberger; Geoffrey Michael,2,0,34,32
1657058374111,MATH 109,A02,083214,Ganzberger; Geoffrey Michael,2,0,34,32
1657058374111,MATH 109,A03,093478,Ganzberger; Geoffrey Michael,1,0,34,33
1657058374111,MATH 109,B01,083215,Ganzberger; Geoffrey Michael,1,0,32,31
1657058374111,MATH 109,B02,083216,Ganzberger; Geoffrey Michael,1,0,32,31
1657058374111,MATH 109,B03,093479,Ganzberger; Geoffrey Michael,6,0,32,26
1657058380135,MATH 142A,A01,083219,Chow; Bennett,6,0,32,26
1657058380135,MATH 142A,A02,083220,Chow; Bennett,10,0,32,22
1657058380135,MATH 142A,A03,093480,Chow; Bennett,7,0,32,25
1657058380135,MATH 142A,B03,093481,Chow; Bennett,7,0,32,25
1657058380135,MATH 142A,B04,093558,Chow; Bennett,11,0,32,21
1657058380135,MATH 142A,B05,093559,Chow; Bennett,6,0,32,26
1657058386168,MATH 193A,A01,083224,Rotar; Vladimir,7,0,34,27
1657058386168,MATH 193A,A02,083225,Rotar; Vladimir,5,0,34,29
1657058386168,MATH 193A,A03,083781,Rotar; Vladimir,1,0,34,33
1657058386168,MATH 193A,A04,083782,Rotar; Vladimir,6,0,34,28
1657058386168,MATH 193A,A05,093482,Rotar; Vladimir,6,0,34,28
1657058392193,MATH 197,001,091859,McAuley; Julian John,9999,0,9999,0
1657058392193,MATH 197,002,095566,Kedlaya; Kiran S.,9997,0,9999,2
1657058392193,MATH 197,003,095567,Xiao; Ming,9999,0,9999,0
1657058392193,MATH 197,004,095571,Perols; Johan Lars,9998,0,9999,1
1657058399241,COGS 9,A01,083615,Shannon; Kyle Michael,7,0,75,68
1657058405265,COGS 11,A01,083617,Boyle; Mary E. T.,20,0,48,28
1657058411297,COGS 13,A01,083071,Bastos; Amalia Pinkusfeld,9,0,71,62
1657058417322,COGS 14A,A01,092681,Semenuks; Arturs,0,1,100,100
1657058423346,COGS 14B,A01,083073,Cheng; Tzu-Han,5,0,63,58
1657058429369,COGS 17,A01,092677,Semenuks; Arturs,4,0,81,77
1657058435396,COGS 100,A01,083619,Allen; Michael Gordon,15,0,70,55
1657058441419,COGS 101A,A01,083621,Davis; Joshua Daniel,9,0,68,59
1657058447444,COGS 101B,A01,091572,Allen; Michael Gordon,8,0,65,57
1657058453472,COGS 101C,A01,083625,Delgado; Tania,17,0,35,18
1657058459495,COGS 107A,A01,083627,Boyle; Mary E. T.,13,0,60,47
1657058465523,COGS 118A,A01,083075,Gupta; Anjum,15,0,76,61
1657058471547,CSE 3,A50,083646,Miranda; Gregory Joseph,22,0,50,28
1657058477575,CSE 8A,A50,083650,Miranda; Gregory Joseph,17,1,56,39
1657058483597,CSE 11,A01,083080,Cao; Yingjun,4,15,40,36
1657058489623,CSE 12,A01,083652,Krause-Levy; Sophia Louisa,23,1,120,97
1657058495661,CSE 15L,A01,083654,Morris; Justin Loren,8,0,50,42
1657058495661,CSE 15L,A02,083655,Morris; Justin Loren,9,0,50,41
1657058501687,CSE 20,A01,083657,Tran; Khoa Dang,37,0,80,43
1657058507710,CSE 21,A01,095574,Bach; Quang Tran,21,0,48,27
1657058513736,CSE 30,A01,083084,Eldon; John,4,0,80,76
1657058513736,CSE 30,B01,095061,Bhaskar; Nishant,6,0,50,44
1657058519759,CSE 100,A01,083659,Cao; Yingjun,3,4,70,67
1657058525788,CSE 134B,A01,083661,Powell; Thomas Allan,19,0,100,81
1657058531825,CSE 140,A01,083663,Gungor; Onat,14,0,85,71
1657058537848,CSE 140L,A01,083088,Eldon; John,16,0,100,84
1657058543872,CSE 175,A01,083665,Kumar; Rakesh,3,0,25,22
1657058549901,CSE 190,A00,092507,Dubnov; Shlomo,7,0,20,13
1657058555930,ECE 45,A01,083139,Congero; Spencer William,5,0,75,70
1657058561954,ECE 65,A50,083695,Saad; Andrew S,12,0,30,18
1657058561954,ECE 65,A51,095125,Saad; Andrew S,25,0,26,1
1657058567978,ECE 109,A01,091882,Touri; Behrouz,16,0,70,54
1657058574000,ECE 180,A00,083140,Abi Samra; Nicholas Camill,1,0,30,29
1657058574000,ECE 180,B00,083141,Abi Samra; Nicholas Camill,0,0,30,30
1657058580031,MATH 10A,A01,083735,Patchell; Gregory David,1,0,30,29
1657058580031,MATH 10A,A02,083736,Patchell; Gregory David,20,0,30,10
1657058580031,MATH 10A,A03,083737,Patchell; Gregory David,16,0,30,14
1657058586055,MATH 10B,A01,083207,Lim; Seonhee,7,0,34,27
1657058586055,MATH 10B,A02,083208,Lim; Seonhee,9,0,35,26
1657058586055,MATH 10B,A03,093472,Lim; Seonhee,4,0,34,30
1657058586055,MATH 10B,B01,083739,Sinha; Shubham,9,0,30,21
1657058592077,MATH 18,A01,083743,Cinel; Cameron Alexander,6,0,30,24
1657058592077,MATH 18,A02,083744,Cinel; Cameron Alexander,15,0,30,15
1657058592077,MATH 18,A03,083745,Cinel; Cameron Alexander,8,0,30,22
1657058592077,MATH 18,B01,083748,Rideout; David Porter,4,0,37,33
1657058592077,MATH 18,B02,083749,Rideout; David Porter,3,0,36,33
1657058592077,MATH 18,B03,083750,Rideout; David Porter,2,0,37,35
1657058592077,MATH 18,B04,083751,Rideout; David Porter,5,0,36,31
1657058592077,MATH 18,B05,093473,Rideout; David Porter,4,0,36,32
1657058592077,MATH 18,B06,093474,Rideout; David Porter,5,0,36,31
1657058598099,MATH 20A,A01,083754,Zheng; Zequn,12,0,40,28
1657058604122,MATH 20B,A01,083756,Briones; Jor-el Thomas Caparas,1,0,36,35
1657058604122,MATH 20B,A02,083757,Briones; Jor-el Thomas Caparas,1,0,36,35
1657058604122,MATH 20B,A03,093475,Briones; Jor-el Thomas Caparas,0,0,36,36
1657058610153,MATH 20C,A01,083760,Briones; Jor-el Thomas Caparas,1,0,35,34
1657058610153,MATH 20C,A02,083761,Briones; Jor-el Thomas Caparas,8,0,35,27
1657058610153,MATH 20C,A03,093476,Briones; Jor-el Thomas Caparas,0,1,36,36
1657058610153,MATH 20C,B01,083762,Bach; Quang Tran,0,0,30,30
1657058616191,MATH 20D,A01,083765,Tran; Brian Kha,4,0,30,26
1657058616191,MATH 20D,A02,083766,Tran; Brian Kha,5,0,30,25
1657058616191,MATH 20D,A03,083767,Tran; Brian Kha,3,0,30,27
1657058622216,MATH 20E,A01,083771,Ganguly; Soumya,5,0,32,27
1657058622216,MATH 20E,A02,083772,Ganguly; Soumya,6,0,32,26
1657058622216,MATH 20E,B01,083773,Ciotti; Benjamin,18,0,35,17
1657058622216,MATH 20E,B02,083774,Ciotti; Benjamin,17,0,35,18
1657058628252,MATH 103A,A01,083777,Greenfeld; Be'Eri,2,0,36,34
1657058628252,MATH 103A,A02,083778,Greenfeld; Be'Eri,5,0,36,31
1657058628252,MATH 103A,A03,093561,Greenfeld; Be'Eri,4,0,36,32
1657058628252,MATH 103A,B01,083779,Greenfeld; Be'Eri,6,0,36,30
1657058628252,MATH 103A,B02,083780,Greenfeld; Be'Eri,2,0,36,34
1657058628252,MATH 103A,B03,093562,Greenfeld; Be'Eri,2,0,36,34
1657058634278,MATH 105,A01,085443,Carter; Anne Toulson,14,0,35,21
1657058634278,MATH 105,A02,093477,Carter; Anne Toulson,20,0,35,15
1657058640318,MATH 109,A01,083213,Ganzberger; Geoffrey Michael,2,0,34,32
1657058640318,MATH 109,A02,083214,Ganzberger; Geoffrey Michael,2,0,34,32
1657058640318,MATH 109,A03,093478,Ganzberger; Geoffrey Michael,1,0,34,33
1657058640318,MATH 109,B01,083215,Ganzberger; Geoffrey Michael,1,0,32,31
1657058640318,MATH 109,B02,083216,Ganzberger; Geoffrey Michael,1,0,32,31
1657058640318,MATH 109,B03,093479,Ganzberger; Geoffrey Michael,6,0,32,26
1657058646346,MATH 142A,A01,083219,Chow; Bennett,6,0,32,26
1657058646346,MATH 142A,A02,083220,Chow; Bennett,10,0,32,22
1657058646346,MATH 142A,A03,093480,Chow; Bennett,7,0,32,25
1657058646346,MATH 142A,B03,093481,Chow; Bennett,7,0,32,25
1657058646346,MATH 142A,B04,093558,Chow; Bennett,11,0,32,21
1657058646346,MATH 142A,B05,093559,Chow; Bennett,6,0,32,26
1657058652370,MATH 193A,A01,083224,Rotar; Vladimir,7,0,34,27
1657058652370,MATH 193A,A02,083225,Rotar; Vladimir,5,0,34,29
1657058652370,MATH 193A,A03,083781,Rotar; Vladimir,1,0,34,33
1657058652370,MATH 193A,A04,083782,Rotar; Vladimir,6,0,34,28
1657058652370,MATH 193A,A05,093482,Rotar; Vladimir,6,0,34,28
1657058658395,MATH 197,001,091859,McAuley; Julian John,9999,0,9999,0
1657058658395,MATH 197,002,095566,Kedlaya; Kiran S.,9997,0,9999,2
1657058658395,MATH 197,003,095567,Xiao; Ming,9999,0,9999,0
1657058658395,MATH 197,004,095571,Perols; Johan Lars,9998,0,9999,1
1657058665458,COGS 9,A01,083615,Shannon; Kyle Michael,7,0,75,68
1657058671483,COGS 11,A01,083617,Boyle; Mary E. T.,20,0,48,28
1657058677506,COGS 13,A01,083071,Bastos; Amalia Pinkusfeld,9,0,71,62
1657058683535,COGS 14A,A01,092681,Semenuks; Arturs,0,1,100,100
1657058689559,COGS 14B,A01,083073,Cheng; Tzu-Han,5,0,63,58
1657058695582,COGS 17,A01,092677,Semenuks; Arturs,4,0,81,77
1657058701606,COGS 100,A01,083619,Allen; Michael Gordon,15,0,70,55
1657058707629,COGS 101A,A01,083621,Davis; Joshua Daniel,9,0,68,59
1657058713657,COGS 101B,A01,091572,Allen; Michael Gordon,8,0,65,57
1657058719683,COGS 101C,A01,083625,Delgado; Tania,17,0,35,18
1657058725725,COGS 107A,A01,083627,Boyle; Mary E. T.,13,0,60,47
1657058731754,COGS 118A,A01,083075,Gupta; Anjum,15,0,76,61
1657058737779,CSE 3,A50,083646,Miranda; Gregory Joseph,22,0,50,28
1657058743802,CSE 8A,A50,083650,Miranda; Gregory Joseph,17,1,56,39
1657058749826,CSE 11,A01,083080,Cao; Yingjun,4,15,40,36
1657058755847,CSE 12,A01,083652,Krause-Levy; Sophia Louisa,23,1,120,97
1657058761873,CSE 15L,A01,083654,Morris; Justin Loren,8,0,50,42
1657058761873,CSE 15L,A02,083655,Morris; Justin Loren,9,0,50,41
1657058767902,CSE 20,A01,083657,Tran; Khoa Dang,37,0,80,43
1657058773926,CSE 21,A01,095574,Bach; Quang Tran,21,0,48,27
1657058779950,CSE 30,A01,083084,Eldon; John,4,0,80,76
1657058779950,CSE 30,B01,095061,Bhaskar; Nishant,6,0,50,44
1657058785977,CSE 100,A01,083659,Cao; Yingjun,3,4,70,67
1657058792001,CSE 134B,A01,083661,Powell; Thomas Allan,19,0,100,81
1657058798026,CSE 140,A01,083663,Gungor; Onat,14,0,85,71
1657058804065,CSE 140L,A01,083088,Eldon; John,16,0,100,84
1657058810088,CSE 175,A01,083665,Kumar; Rakesh,3,0,25,22
1657058816196,CSE 190,A00,092507,Dubnov; Shlomo,7,0,20,13
1657058822224,ECE 45,A01,083139,Congero; Spencer William,5,0,75,70
1657058828246,ECE 65,A50,083695,Saad; Andrew S,12,0,30,18
1657058828246,ECE 65,A51,095125,Saad; Andrew S,25,0,26,1
1657058834270,ECE 109,A01,091882,Touri; Behrouz,16,0,70,54
1657058840292,ECE 180,A00,083140,Abi Samra; Nicholas Camill,1,0,30,29
1657058840292,ECE 180,B00,083141,Abi Samra; Nicholas Camill,0,0,30,30
1657058846321,MATH 10A,A01,083735,Patchell; Gregory David,1,0,30,29
1657058846321,MATH 10A,A02,083736,Patchell; Gregory David,20,0,30,10
1657058846321,MATH 10A,A03,083737,Patchell; Gregory David,16,0,30,14
1657058852357,MATH 10B,A01,083207,Lim; Seonhee,7,0,34,27
1657058852357,MATH 10B,A02,083208,Lim; Seonhee,9,0,35,26
1657058852357,MATH 10B,A03,093472,Lim; Seonhee,4,0,34,30
1657058852357,MATH 10B,B01,083739,Sinha; Shubham,9,0,30,21
1657058858403,MATH 18,A01,083743,Cinel; Cameron Alexander,6,0,30,24
1657058858403,MATH 18,A02,083744,Cinel; Cameron Alexander,15,0,30,15
1657058858403,MATH 18,A03,083745,Cinel; Cameron Alexander,8,0,30,22
1657058858403,MATH 18,B01,083748,Rideout; David Porter,4,0,37,33
1657058858403,MATH 18,B02,083749,Rideout; David Porter,3,0,36,33
1657058858403,MATH 18,B03,083750,Rideout; David Porter,2,0,37,35
1657058858403,MATH 18,B04,083751,Rideout; David Porter,5,0,36,31
1657058858403,MATH 18,B05,093473,Rideout; David Porter,4,0,36,32
1657058858403,MATH 18,B06,093474,Rideout; David Porter,5,0,36,31
1657058864435,MATH 20A,A01,083754,Zheng; Zequn,12,0,40,28
1657058870458,MATH 20B,A01,083756,Briones; Jor-el Thomas Caparas,1,0,36,35
1657058870458,MATH 20B,A02,083757,Briones; Jor-el Thomas Caparas,1,0,36,35
1657058870458,MATH 20B,A03,093475,Briones; Jor-el Thomas Caparas,0,0,36,36
1657058876486,MATH 20C,A01,083760,Briones; Jor-el Thomas Caparas,1,0,35,34
1657058876486,MATH 20C,A02,083761,Briones; Jor-el Thomas Caparas,8,0,35,27
1657058876486,MATH 20C,A03,093476,Briones; Jor-el Thomas Caparas,0,1,36,36
1657058876486,MATH 20C,B01,083762,Bach; Quang Tran,0,0,30,30
1657058882511,MATH 20D,A01,083765,Tran; Brian Kha,4,0,30,26
1657058882511,MATH 20D,A02,083766,Tran; Brian Kha,5,0,30,25
1657058882511,MATH 20D,A03,083767,Tran; Brian Kha,3,0,30,27
1657058888542,MATH 20E,A01,083771,Ganguly; Soumya,5,0,32,27
1657058888542,MATH 20E,A02,083772,Ganguly; Soumya,6,0,32,26
1657058888542,MATH 20E,B01,083773,Ciotti; Benjamin,18,0,35,17
1657058888542,MATH 20E,B02,083774,Ciotti; Benjamin,17,0,35,18
1657058894565,MATH 103A,A01,083777,Greenfeld; Be'Eri,2,0,36,34
1657058894565,MATH 103A,A02,083778,Greenfeld; Be'Eri,5,0,36,31
1657058894565,MATH 103A,A03,093561,Greenfeld; Be'Eri,4,0,36,32
1657058894565,MATH 103A,B01,083779,Greenfeld; Be'Eri,6,0,36,30
1657058894565,MATH 103A,B02,083780,Greenfeld; Be'Eri,2,0,36,34
1657058894565,MATH 103A,B03,093562,Greenfeld; Be'Eri,2,0,36,34
1657058900589,MATH 105,A01,085443,Carter; Anne Toulson,14,0,35,21
1657058900589,MATH 105,A02,093477,Carter; Anne Toulson,20,0,35,15
1657058906612,MATH 109,A01,083213,Ganzberger; Geoffrey Michael,2,0,34,32
1657058906612,MATH 109,A02,083214,Ganzberger; Geoffrey Michael,2,0,34,32
1657058906612,MATH 109,A03,093478,Ganzberger; Geoffrey Michael,1,0,34,33
1657058906612,MATH 109,B01,083215,Ganzberger; Geoffrey Michael,1,0,32,31
1657058906612,MATH 109,B02,083216,Ganzberger; Geoffrey Michael,1,0,32,31
1657058906612,MATH 109,B03,093479,Ganzberger; Geoffrey Michael,6,0,32,26
1657058912636,MATH 142A,A01,083219,Chow; Bennett,6,0,32,26
1657058912636,MATH 142A,A02,083220,Chow; Bennett,10,0,32,22
1657058912636,MATH 142A,A03,093480,Chow; Bennett,7,0,32,25
1657058912636,MATH 142A,B03,093481,Chow; Bennett,7,0,32,25
1657058912636,MATH 142A,B04,093558,Chow; Bennett,11,0,32,21
1657058912636,MATH 142A,B05,093559,Chow; Bennett,6,0,32,26
1657058918660,MATH 193A,A01,083224,Rotar; Vladimir,7,0,34,27
1657058918660,MATH 193A,A02,083225,Rotar; Vladimir,5,0,34,29
1657058918660,MATH 193A,A03,083781,Rotar; Vladimir,1,0,34,33
1657058918660,MATH 193A,A04,083782,Rotar; Vladimir,6,0,34,28
1657058918660,MATH 193A,A05,093482,Rotar; Vladimir,6,0,34,28
1657058924685,MATH 197,001,091859,McAuley; Julian John,9999,0,9999,0
1657058924685,MATH 197,002,095566,Kedlaya; Kiran S.,9997,0,9999,2
1657058924685,MATH 197,003,095567,Xiao; Ming,9999,0,9999,0
1657058924685,MATH 197,004,095571,Perols; Johan Lars,9998,0,9999,1
1657058931760,COGS 9,A01,083615,Shannon; Kyle Michael,7,0,75,68
1657058937783,COGS 11,A01,083617,Boyle; Mary E. T.,20,0,48,28
1657058943805,COGS 13,A01,083071,Bastos; Amalia Pinkusfeld,9,0,71,62
1657058949834,COGS 14A,A01,092681,Semenuks; Arturs,0,1,100,100
1657058955862,COGS 14B,A01,083073,Cheng; Tzu-Han,5,0,63,58
1657058961894,COGS 17,A01,092677,Semenuks; Arturs,4,0,81,77
1657058967918,COGS 100,A01,083619,Allen; Michael Gordon,15,0,70,55
1657058973944,COGS 101A,A01,083621,Davis; Joshua Daniel,9,0,68,59
1657058979965,COGS 101B,A01,091572,Allen; Michael Gordon,8,0,65,57
1657058985994,COGS 101C,A01,083625,Delgado; Tania,17,0,35,18
1657058992016,COGS 107A,A01,083627,Boyle; Mary E. T.,13,0,60,47
1657058998041,COGS 118A,A01,083075,Gupta; Anjum,15,0,76,61
1657059004064,CSE 3,A50,083646,Miranda; Gregory Joseph,22,0,50,28
1657059010087,CSE 8A,A50,083650,Miranda; Gregory Joseph,17,1,56,39
1657059016113,CSE 11,A01,083080,Cao; Yingjun,4,15,40,36
1657059022149,CSE 12,A01,083652,Krause-Levy; Sophia Louisa,23,1,120,97
1657059028173,CSE 15L,A01,083654,Morris; Justin Loren,8,0,50,42
1657059028173,CSE 15L,A02,083655,Morris; Justin Loren,9,0,50,41
1657059034198,CSE 20,A01,083657,Tran; Khoa Dang,37,0,80,43
1657059040224,CSE 21,A01,095574,Bach; Quang Tran,21,0,48,27
1657059046248,CSE 30,A01,083084,Eldon; John,4,0,80,76
1657059046248,CSE 30,B01,095061,Bhaskar; Nishant,6,0,50,44
1657059052271,CSE 100,A01,083659,Cao; Yingjun,3,4,70,67
1657059058294,CSE 134B,A01,083661,Powell; Thomas Allan,19,0,100,81
1657059064321,CSE 140,A01,083663,Gungor; Onat,14,0,85,71
1657059070344,CSE 140L,A01,083088,Eldon; John,16,0,100,84
1657059076367,CSE 175,A01,083665,Kumar; Rakesh,3,0,25,22
1657059082389,CSE 190,A00,092507,Dubnov; Shlomo,7,0,20,13
1657059088415,ECE 45,A01,083139,Congero; Spencer William,5,0,75,70
1657059094453,ECE 65,A50,083695,Saad; Andrew S,12,0,30,18
1657059094453,ECE 65,A51,095125,Saad; Andrew S,25,0,26,1
1657059100479,ECE 109,A01,091882,Touri; Behrouz,16,0,70,54
1657059106506,ECE 180,A00,083140,Abi Samra; Nicholas Camill,1,0,30,29
1657059106506,ECE 180,B00,083141,Abi Samra; Nicholas Camill,0,0,30,30
1657059112542,MATH 10A,A01,083735,Patchell; Gregory David,1,0,30,29
1657059112542,MATH 10A,A02,083736,Patchell; Gregory David,20,0,30,10
1657059112542,MATH 10A,A03,083737,Patchell; Gregory David,16,0,30,14
1657059118565,MATH 10B,A01,083207,Lim; Seonhee,7,0,34,27
1657059118565,MATH 10B,A02,083208,Lim; Seonhee,9,0,35,26
1657059118565,MATH 10B,A03,093472,Lim; Seonhee,4,0,34,30
1657059118565,MATH 10B,B01,083739,Sinha; Shubham,9,0,30,21
1657059124599,MATH 18,A01,083743,Cinel; Cameron Alexander,6,0,30,24
1657059124599,MATH 18,A02,083744,Cinel; Cameron Alexander,15,0,30,15
1657059124599,MATH 18,A03,083745,Cinel; Cameron Alexander,8,0,30,22
1657059124599,MATH 18,B01,083748,Rideout; David Porter,4,0,37,33
1657059124599,MATH 18,B02,083749,Rideout; David Porter,3,0,36,33
1657059124599,MATH 18,B03,083750,Rideout; David Porter,2,0,37,35
1657059124599,MATH 18,B04,083751,Rideout; David Porter,5,0,36,31
1657059124599,MATH 18,B05,093473,Rideout; David Porter,4,0,36,32
1657059124599,MATH 18,B06,093474,Rideout; David Porter,5,0,36,31
1657059130636,MATH 20A,A01,083754,Zheng; Zequn,12,0,40,28
1657059136660,MATH 20B,A01,083756,Briones; Jor-el Thomas Caparas,1,0,36,35
1657059136660,MATH 20B,A02,083757,Briones; Jor-el Thomas Caparas,1,0,36,35
1657059136660,MATH 20B,A03,093475,Briones; Jor-el Thomas Caparas,0,0,36,36
1657059142682,MATH 20C,A01,083760,Briones; Jor-el Thomas Caparas,1,0,35,34
1657059142682,MATH 20C,A02,083761,Briones; Jor-el Thomas Caparas,8,0,35,27
1657059142682,MATH 20C,A03,093476,Briones; Jor-el Thomas Caparas,0,1,36,36
1657059142682,MATH 20C,B01,083762,Bach; Quang Tran,0,0,30,30
1657059148711,MATH 20D,A01,083765,Tran; Brian Kha,4,0,30,26
1657059148711,MATH 20D,A02,083766,Tran; Brian Kha,5,0,30,25
1657059148711,MATH 20D,A03,083767,Tran; Brian Kha,3,0,30,27
1657059154744,MATH 20E,A01,083771,Ganguly; Soumya,5,0,32,27
1657059154744,MATH 20E,A02,083772,Ganguly; Soumya,6,0,32,26
1657059154744,MATH 20E,B01,083773,Ciotti; Benjamin,18,0,35,17
1657059154744,MATH 20E,B02,083774,Ciotti; Benjamin,17,0,35,18
1657059160766,MATH 103A,A01,083777,Greenfeld; Be'Eri,2,0,36,34
1657059160766,MATH 103A,A02,083778,Greenfeld; Be'Eri,5,0,36,31
1657059160766,MATH 103A,A03,093561,Greenfeld; Be'Eri,4,0,36,32
1657059160766,MATH 103A,B01,083779,Greenfeld; Be'Eri,6,0,36,30
1657059160766,MATH 103A,B02,083780,Greenfeld; Be'Eri,2,0,36,34
1657059160766,MATH 103A,B03,093562,Greenfeld; Be'Eri,2,0,36,34
1657059166793,MATH 105,A01,085443,Carter; Anne Toulson,14,0,35,21
1657059166793,MATH 105,A02,093477,Carter; Anne Toulson,20,0,35,15
1657059172819,MATH 109,A01,083213,Ganzberger; Geoffrey Michael,2,0,34,32
1657059172819,MATH 109,A02,083214,Ganzberger; Geoffrey Michael,2,0,34,32
1657059172819,MATH 109,A03,093478,Ganzberger; Geoffrey Michael,1,0,34,33
1657059172819,MATH 109,B01,083215,Ganzberger; Geoffrey Michael,1,0,32,31
1657059172819,MATH 109,B02,083216,Ganzberger; Geoffrey Michael,1,0,32,31
1657059172819,MATH 109,B03,093479,Ganzberger; Geoffrey Michael,6,0,32,26
1657059178843,MATH 142A,A01,083219,Chow; Bennett,6,0,32,26
1657059178843,MATH 142A,A02,083220,Chow; Bennett,10,0,32,22
1657059178843,MATH 142A,A03,093480,Chow; Bennett,7,0,32,25
1657059178843,MATH 142A,B03,093481,Chow; Bennett,7,0,32,25
1657059178843,MATH 142A,B04,093558,Chow; Bennett,11,0,32,21
1657059178843,MATH 142A,B05,093559,Chow; Bennett,6,0,32,26
1657059184870,MATH 193A,A01,083224,Rotar; Vladimir,7,0,34,27
1657059184870,MATH 193A,A02,083225,Rotar; Vladimir,5,0,34,29
1657059184870,MATH 193A,A03,083781,Rotar; Vladimir,1,0,34,33
1657059184870,MATH 193A,A04,083782,Rotar; Vladimir,6,0,34,28
1657059184870,MATH 193A,A05,093482,Rotar; Vladimir,6,0,34,28
1657059190893,MATH 197,001,091859,McAuley; Julian John,9999,0,9999,0
1657059190893,MATH 197,002,095566,Kedlaya; Kiran S.,9997,0,9999,2
1657059190893,MATH 197,003,095567,Xiao; Ming,9999,0,9999,0
1657059190893,MATH 197,004,095571,Perols; Johan Lars,9998,0,9999,1
1657059197981,COGS 9,A01,083615,Shannon; Kyle Michael,7,0,75,68
1657059204006,COGS 11,A01,083617,Boyle; Mary E. T.,20,0,48,28
1657059210033,COGS 13,A01,083071,Bastos; Amalia Pinkusfeld,9,0,71,62
1657059216057,COGS 14A,A01,092681,Semenuks; Arturs,0,1,100,100
1657059222080,COGS 14B,A01,083073,Cheng; Tzu-Han,5,0,63,58
1657059228103,COGS 17,A01,092677,Semenuks; Arturs,4,0,81,77
1657059234130,COGS 100,A01,083619,Allen; Michael Gordon,15,0,70,55
1657059240154,COGS 101A,A01,083621,Davis; Joshua Daniel,9,0,68,59
1657059246176,COGS 101B,A01,091572,Allen; Michael Gordon,8,0,65,57
1657059252199,COGS 101C,A01,083625,Delgado; Tania,17,0,35,18
1657059258226,COGS 107A,A01,083627,Boyle; Mary E. T.,13,0,60,47
1657059264250,COGS 118A,A01,083075,Gupta; Anjum,15,0,76,61
1657059270284,CSE 3,A50,083646,Miranda; Gregory Joseph,22,0,50,28
1657059276305,CSE 8A,A50,083650,Miranda; Gregory Joseph,17,1,56,39
1657059282328,CSE 11,A01,083080,Cao; Yingjun,4,15,40,36
1657059288349,CSE 12,A01,083652,Krause-Levy; Sophia Louisa,23,1,120,97
1657059294376,CSE 15L,A01,083654,Morris; Justin Loren,8,0,50,42
1657059294376,CSE 15L,A02,083655,Morris; Justin Loren,9,0,50,41
1657059300402,CSE 20,A01,083657,Tran; Khoa Dang,37,0,80,43
1657059306427,CSE 21,A01,095574,Bach; Quang Tran,21,0,48,27
1657059312458,CSE 30,A01,083084,Eldon; John,4,0,80,76
1657059312458,CSE 30,B01,095061,Bhaskar; Nishant,6,0,50,44
1657059318499,CSE 100,A01,083659,Cao; Yingjun,3,4,70,67
1657059324527,CSE 134B,A01,083661,Powell; Thomas Allan,19,0,100,81
1657059330555,CSE 140,A01,083663,Gungor; Onat,14,0,85,71
1657059336593,CSE 140L,A01,083088,Eldon; John,16,0,100,84
1657059342617,CSE 175,A01,083665,Kumar; Rakesh,3,0,25,22
1657059348641,CSE 190,A00,092507,Dubnov; Shlomo,7,0,20,13
1657059354664,ECE 45,A01,083139,Congero; Spencer William,5,0,75,70
1657059360689,ECE 65,A50,083695,Saad; Andrew S,12,0,30,18
1657059360689,ECE 65,A51,095125,Saad; Andrew S,25,0,26,1
1657059366715,ECE 109,A01,091882,Touri; Behrouz,16,0,70,54
1657059372738,ECE 180,A00,083140,Abi Samra; Nicholas Camill,1,0,30,29
1657059372738,ECE 180,B00,083141,Abi Samra; Nicholas Camill,0,0,30,30
1657059378772,MATH 10A,A01,083735,Patchell; Gregory David,1,0,30,29
1657059378772,MATH 10A,A02,083736,Patchell; Gregory David,20,0,30,10
1657059378772,MATH 10A,A03,083737,Patchell; Gregory David,16,0,30,14
1657059384797,MATH 10B,A01,083207,Lim; Seonhee,7,0,34,27
1657059384797,MATH 10B,A02,083208,Lim; Seonhee,9,0,35,26
1657059384797,MATH 10B,A03,093472,Lim; Seonhee,4,0,34,30
1657059384797,MATH 10B,B01,083739,Sinha; Shubham,9,0,30,21
1657059390826,MATH 18,A01,083743,Cinel; Cameron Alexander,6,0,30,24
1657059390826,MATH 18,A02,083744,Cinel; Cameron Alexander,15,0,30,15
1657059390826,MATH 18,A03,083745,Cinel; Cameron Alexander,8,0,30,22
1657059390826,MATH 18,B01,083748,Rideout; David Porter,4,0,37,33
1657059390826,MATH 18,B02,083749,Rideout; David Porter,3,0,36,33
1657059390826,MATH 18,B03,083750,Rideout; David Porter,2,0,37,35
1657059390826,MATH 18,B04,083751,Rideout; David Porter,5,0,36,31
1657059390826,MATH 18,B05,093473,Rideout; David Porter,4,0,36,32
1657059390826,MATH 18,B06,093474,Rideout; David Porter,5,0,36,31
1657059396850,MATH 20A,A01,083754,Zheng; Zequn,12,0,40,28
1657059402883,MATH 20B,A01,083756,Briones; Jor-el Thomas Caparas,1,0,36,35
1657059402883,MATH 20B,A02,083757,Briones; Jor-el Thomas Caparas,1,0,36,35
1657059402883,MATH 20B,A03,093475,Briones; Jor-el Thomas Caparas,0,0,36,36
1657059408907,MATH 20C,A01,083760,Briones; Jor-el Thomas Caparas,1,0,35,34
1657059408907,MATH 20C,A02,083761,Briones; Jor-el Thomas Caparas,8,0,35,27
1657059408907,MATH 20C,A03,093476,Briones; Jor-el Thomas Caparas,0,1,36,36
1657059408907,MATH 20C,B01,083762,Bach; Quang Tran,0,0,30,30
1657059415014,MATH 20D,A01,083765,Tran; Brian Kha,4,0,30,26
1657059415014,MATH 20D,A02,083766,Tran; Brian Kha,5,0,30,25
1657059415014,MATH 20D,A03,083767,Tran; Brian Kha,3,0,30,27
1657059421046,MATH 20E,A01,083771,Ganguly; Soumya,5,0,32,27
1657059421046,MATH 20E,A02,083772,Ganguly; Soumya,6,0,32,26
1657059421046,MATH 20E,B01,083773,Ciotti; Benjamin,18,0,35,17
1657059421046,MATH 20E,B02,083774,Ciotti; Benjamin,17,0,35,18
1657059427071,MATH 103A,A01,083777,Greenfeld; Be'Eri,2,0,36,34
1657059427071,MATH 103A,A02,083778,Greenfeld; Be'Eri,5,0,36,31
1657059427071,MATH 103A,A03,093561,Greenfeld; Be'Eri,4,0,36,32
1657059427071,MATH 103A,B01,083779,Greenfeld; Be'Eri,6,0,36,30
1657059427071,MATH 103A,B02,083780,Greenfeld; Be'Eri,2,0,36,34
1657059427071,MATH 103A,B03,093562,Greenfeld; Be'Eri,3,0,36,33
1657059433095,MATH 105,A01,085443,Carter; Anne Toulson,14,0,35,21
1657059433095,MATH 105,A02,093477,Carter; Anne Toulson,20,0,35,15
1657059439125,MATH 109,A01,083213,Ganzberger; Geoffrey Michael,2,0,34,32
1657059439125,MATH 109,A02,083214,Ganzberger; Geoffrey Michael,2,0,34,32
1657059439125,MATH 109,A03,093478,Ganzberger; Geoffrey Michael,1,0,34,33
1657059439125,MATH 109,B01,083215,Ganzberger; Geoffrey Michael,1,0,32,31
1657059439125,MATH 109,B02,083216,Ganzberger; Geoffrey Michael,1,0,32,31
1657059439125,MATH 109,B03,093479,Ganzberger; Geoffrey Michael,6,0,32,26
1657059445151,MATH 142A,A01,083219,Chow; Bennett,6,0,32,26
1657059445151,MATH 142A,A02,083220,Chow; Bennett,10,0,32,22
1657059445151,MATH 142A,A03,093480,Chow; Bennett,7,0,32,25
1657059445151,MATH 142A,B03,093481,Chow; Bennett,7,0,32,25
1657059445151,MATH 142A,B04,093558,Chow; Bennett,11,0,32,21
1657059445151,MATH 142A,B05,093559,Chow; Bennett,6,0,32,26
1657059451177,MATH 193A,A01,083224,Rotar; Vladimir,7,0,34,27
1657059451177,MATH 193A,A02,083225,Rotar; Vladimir,5,0,34,29
1657059451177,MATH 193A,A03,083781,Rotar; Vladimir,1,0,34,33
1657059451177,MATH 193A,A04,083782,Rotar; Vladimir,6,0,34,28
1657059451177,MATH 193A,A05,093482,Rotar; Vladimir,6,0,34,28
1657059457203,MATH 197,001,091859,McAuley; Julian John,9999,0,9999,0
1657059457203,MATH 197,002,095566,Kedlaya; Kiran S.,9997,0,9999,2
1657059457203,MATH 197,003,095567,Xiao; Ming,9999,0,9999,0
1657059457203,MATH 197,004,095571,Perols; Johan Lars,9998,0,9999,1
1657059464278,COGS 9,A01,083615,Shannon; Kyle Michael,7,0,75,68
1657059470303,COGS 11,A01,083617,Boyle; Mary E. T.,20,0,48,28
1657059476330,COGS 13,A01,083071,Bastos; Amalia Pinkusfeld,9,0,71,62
1657059482365,COGS 14A,A01,092681,Semenuks; Arturs,0,1,100,100
1657059488394,COGS 14B,A01,083073,Cheng; Tzu-Han,5,0,63,58
1657059494423,COGS 17,A01,092677,Semenuks; Arturs,4,0,81,77
1657059500452,COGS 100,A01,083619,Allen; Michael Gordon,15,0,70,55
1657059506485,COGS 101A,A01,083621,Davis; Joshua Daniel,9,0,68,59
1657059512512,COGS 101B,A01,091572,Allen; Michael Gordon,8,0,65,57
1657059518534,COGS 101C,A01,083625,Delgado; Tania,17,0,35,18
1657059524570,COGS 107A,A01,083627,Boyle; Mary E. T.,13,0,60,47
1657059530597,COGS 118A,A01,083075,Gupta; Anjum,15,0,76,61
1657059536624,CSE 3,A50,083646,Miranda; Gregory Joseph,22,0,50,28
1657059542647,CSE 8A,A50,083650,Miranda; Gregory Joseph,17,1,56,39
1657059548674,CSE 11,A01,083080,Cao; Yingjun,4,15,40,36
1657059554702,CSE 12,A01,083652,Krause-Levy; Sophia Louisa,23,1,120,97
1657059560736,CSE 15L,A01,083654,Morris; Justin Loren,8,0,50,42
1657059560736,CSE 15L,A02,083655,Morris; Justin Loren,9,0,50,41
1657059566762,CSE 20,A01,083657,Tran; Khoa Dang,37,0,80,43
1657059572784,CSE 21,A01,095574,Bach; Quang Tran,21,0,48,27
1657059578812,CSE 30,A01,083084,Eldon; John,4,0,80,76
1657059578812,CSE 30,B01,095061,Bhaskar; Nishant,6,0,50,44
1657059584835,CSE 100,A01,083659,Cao; Yingjun,3,4,70,67
1657059590867,CSE 134B,A01,083661,Powell; Thomas Allan,19,0,100,81
1657059596896,CSE 140,A01,083663,Gungor; Onat,14,0,85,71
1657059602935,CSE 140L,A01,083088,Eldon; John,16,0,100,84
1657059608958,CSE 175,A01,083665,Kumar; Rakesh,3,0,25,22
1657059614982,CSE 190,A00,092507,Dubnov; Shlomo,7,0,20,13
1657059621032,ECE 45,A01,083139,Congero; Spencer William,5,0,75,70
1657059627057,ECE 65,A50,083695,Saad; Andrew S,12,0,30,18
1657059627057,ECE 65,A51,095125,Saad; Andrew S,25,0,26,1
1657059633085,ECE 109,A01,091882,Touri; Behrouz,16,0,70,54
1657059639112,ECE 180,A00,083140,Abi Samra; Nicholas Camill,1,0,30,29
1657059639112,ECE 180,B00,083141,Abi Samra; Nicholas Camill,0,0,30,30
1657059645145,MATH 10A,A01,083735,Patchell; Gregory David,1,0,30,29
1657059645145,MATH 10A,A02,083736,Patchell; Gregory David,20,0,30,10
1657059645145,MATH 10A,A03,083737,Patchell; Gregory David,16,0,30,14
1657059651168,MATH 10B,A01,083207,Lim; Seonhee,7,0,34,27
1657059651168,MATH 10B,A02,083208,Lim; Seonhee,9,0,35,26
1657059651168,MATH 10B,A03,093472,Lim; Seonhee,4,0,34,30
1657059651168,MATH 10B,B01,083739,Sinha; Shubham,9,0,30,21
1657059657198,MATH 18,A01,083743,Cinel; Cameron Alexander,6,0,30,24
1657059657198,MATH 18,A02,083744,Cinel; Cameron Alexander,15,0,30,15
1657059657198,MATH 18,A03,083745,Cinel; Cameron Alexander,8,0,30,22
1657059657198,MATH 18,B01,083748,Rideout; David Porter,4,0,37,33
1657059657198,MATH 18,B02,083749,Rideout; David Porter,3,0,36,33
1657059657198,MATH 18,B03,083750,Rideout; David Porter,2,0,37,35
1657059657198,MATH 18,B04,083751,Rideout; David Porter,5,0,36,31
1657059657198,MATH 18,B05,093473,Rideout; David Porter,4,0,36,32
1657059657198,MATH 18,B06,093474,Rideout; David Porter,5,0,36,31
1657059663221,MATH 20A,A01,083754,Zheng; Zequn,12,0,40,28
1657059669246,MATH 20B,A01,083756,Briones; Jor-el Thomas Caparas,1,0,36,35
1657059669246,MATH 20B,A02,083757,Briones; Jor-el Thomas Caparas,1,0,36,35
1657059669246,MATH 20B,A03,093475,Briones; Jor-el Thomas Caparas,0,0,36,36
1657059675274,MATH 20C,A01,083760,Briones; Jor-el Thomas Caparas,1,0,35,34
1657059675274,MATH 20C,A02,083761,Briones; Jor-el Thomas Caparas,8,0,35,27
1657059675274,MATH 20C,A03,093476,Briones; Jor-el Thomas Caparas,0,1,36,36
1657059675274,MATH 20C,B01,083762,Bach; Quang Tran,0,0,30,30
1657059681302,MATH 20D,A01,083765,Tran; Brian Kha,4,0,30,26
1657059681302,MATH 20D,A02,083766,Tran; Brian Kha,5,0,30,25
1657059681302,MATH 20D,A03,083767,Tran; Brian Kha,3,0,30,27
1657059687325,MATH 20E,A01,083771,Ganguly; Soumya,5,0,32,27
1657059687325,MATH 20E,A02,083772,Ganguly; Soumya,6,0,32,26
1657059687325,MATH 20E,B01,083773,Ciotti; Benjamin,18,0,35,17
1657059687325,MATH 20E,B02,083774,Ciotti; Benjamin,17,0,35,18
1657059693363,MATH 103A,A01,083777,Greenfeld; Be'Eri,2,0,36,34
1657059693363,MATH 103A,A02,083778,Greenfeld; Be'Eri,5,0,36,31
1657059693363,MATH 103A,A03,093561,Greenfeld; Be'Eri,4,0,36,32
1657059693363,MATH 103A,B01,083779,Greenfeld; Be'Eri,6,0,36,30
1657059693363,MATH 103A,B02,083780,Greenfeld; Be'Eri,2,0,36,34
1657059693363,MATH 103A,B03,093562,Greenfeld; Be'Eri,3,0,36,33
1657059699399,MATH 105,A01,085443,Carter; Anne Toulson,14,0,35,21
1657059699399,MATH 105,A02,093477,Carter; Anne Toulson,20,0,35,15
1657059705428,MATH 109,A01,083213,Ganzberger; Geoffrey Michael,2,0,34,32
1657059705428,MATH 109,A02,083214,Ganzberger; Geoffrey Michael,2,0,34,32
1657059705428,MATH 109,A03,093478,Ganzberger; Geoffrey Michael,1,0,34,33
1657059705428,MATH 109,B01,083215,Ganzberger; Geoffrey Michael,1,0,32,31
1657059705428,MATH 109,B02,083216,Ganzberger; Geoffrey Michael,1,0,32,31
1657059705428,MATH 109,B03,093479,Ganzberger; Geoffrey Michael,6,0,32,26
1657059711467,MATH 142A,A01,083219,Chow; Bennett,6,0,32,26
1657059711467,MATH 142A,A02,083220,Chow; Bennett,10,0,32,22
1657059711467,MATH 142A,A03,093480,Chow; Bennett,7,0,32,25
1657059711467,MATH 142A,B03,093481,Chow; Bennett,7,0,32,25
1657059711467,MATH 142A,B04,093558,Chow; Bennett,11,0,32,21
1657059711467,MATH 142A,B05,093559,Chow; Bennett,6,0,32,26
1657059717501,MATH 193A,A01,083224,Rotar; Vladimir,7,0,34,27
1657059717501,MATH 193A,A02,083225,Rotar; Vladimir,5,0,34,29
1657059717501,MATH 193A,A03,083781,Rotar; Vladimir,1,0,34,33
1657059717501,MATH 193A,A04,083782,Rotar; Vladimir,6,0,34,28
1657059717501,MATH 193A,A05,093482,Rotar; Vladimir,6,0,34,28
1657059723527,MATH 197,001,091859,McAuley; Julian John,9999,0,9999,0
1657059723527,MATH 197,002,095566,Kedlaya; Kiran S.,9997,0,9999,2
1657059723527,MATH 197,003,095567,Xiao; Ming,9999,0,9999,0
1657059723527,MATH 197,004,095571,Perols; Johan Lars,9998,0,9999,1
1657059730588,COGS 9,A01,083615,Shannon; Kyle Michael,7,0,75,68
1657059736622,COGS 11,A01,083617,Boyle; Mary E. T.,20,0,48,28
1657059742645,COGS 13,A01,083071,Bastos; Amalia Pinkusfeld,9,0,71,62
1657059748669,COGS 14A,A01,092681,Semenuks; Arturs,0,1,100,100
1657059754691,COGS 14B,A01,083073,Cheng; Tzu-Han,5,0,63,58
1657059760717,COGS 17,A01,092677,Semenuks; Arturs,4,0,81,77
1657059766739,COGS 100,A01,083619,Allen; Michael Gordon,15,0,70,55
1657059772761,COGS 101A,A01,083621,Davis; Joshua Daniel,9,0,68,59
1657059778789,COGS 101B,A01,091572,Allen; Michael Gordon,8,0,65,57
1657059784815,COGS 101C,A01,083625,Delgado; Tania,17,0,35,18
1657059790840,COGS 107A,A01,083627,Boyle; Mary E. T.,13,0,60,47
1657059796864,COGS 118A,A01,083075,Gupta; Anjum,15,0,76,61
1657059802893,CSE 3,A50,083646,Miranda; Gregory Joseph,22,0,50,28
1657059808917,CSE 8A,A50,083650,Miranda; Gregory Joseph,17,1,56,39
1657059814946,CSE 11,A01,083080,Cao; Yingjun,4,15,40,36
1657059820980,CSE 12,A01,083652,Krause-Levy; Sophia Louisa,23,1,120,97
1657059827011,CSE 15L,A01,083654,Morris; Justin Loren,8,0,50,42
1657059827011,CSE 15L,A02,083655,Morris; Justin Loren,9,0,50,41
1657059833032,CSE 20,A01,083657,Tran; Khoa Dang,37,0,80,43
1657059839058,CSE 21,A01,095574,Bach; Quang Tran,21,0,48,27
1657059845086,CSE 30,A01,083084,Eldon; John,4,0,80,76
1657059845086,CSE 30,B01,095061,Bhaskar; Nishant,6,0,50,44
1657059851112,CSE 100,A01,083659,Cao; Yingjun,3,4,70,67
1657059857134,CSE 134B,A01,083661,Powell; Thomas Allan,19,0,100,81
1657059863175,CSE 140,A01,083663,Gungor; Onat,14,0,85,71
1657059869198,CSE 140L,A01,083088,Eldon; John,16,0,100,84
1657059875222,CSE 175,A01,083665,Kumar; Rakesh,3,0,25,22
1657059881247,CSE 190,A00,092507,Dubnov; Shlomo,7,0,20,13
1657059887287,ECE 45,A01,083139,Congero; Spencer William,5,0,75,70
1657059893310,ECE 65,A50,083695,Saad; Andrew S,12,0,30,18
1657059893310,ECE 65,A51,095125,Saad; Andrew S,25,0,26,1
1657059899344,ECE 109,A01,091882,Touri; Behrouz,16,0,70,54
1657059905367,ECE 180,A00,083140,Abi Samra; Nicholas Camill,1,0,30,29
1657059905367,ECE 180,B00,083141,Abi Samra; Nicholas Camill,0,0,30,30
1657059911395,MATH 10A,A01,083735,Patchell; Gregory David,1,0,30,29
1657059911395,MATH 10A,A02,083736,Patchell; Gregory David,20,0,30,10
1657059911395,MATH 10A,A03,083737,Patchell; Gregory David,16,0,30,14
1657059917423,MATH 10B,A01,083207,Lim; Seonhee,7,0,34,27
1657059917423,MATH 10B,A02,083208,Lim; Seonhee,9,0,35,26
1657059917423,MATH 10B,A03,093472,Lim; Seonhee,4,0,34,30
1657059917423,MATH 10B,B01,083739,Sinha; Shubham,9,0,30,21
1657059923463,MATH 18,A01,083743,Cinel; Cameron Alexander,6,0,30,24
1657059923463,MATH 18,A02,083744,Cinel; Cameron Alexander,15,0,30,15
1657059923463,MATH 18,A03,083745,Cinel; Cameron Alexander,8,0,30,22
1657059923463,MATH 18,B01,083748,Rideout; David Porter,4,0,37,33
1657059923463,MATH 18,B02,083749,Rideout; David Porter,3,0,36,33
1657059923463,MATH 18,B03,083750,Rideout; David Porter,2,0,37,35
1657059923463,MATH 18,B04,083751,Rideout; David Porter,5,0,36,31
1657059923463,MATH 18,B05,093473,Rideout; David Porter,4,0,36,32
1657059923463,MATH 18,B06,093474,Rideout; David Porter,5,0,36,31
1657059929487,MATH 20A,A01,083754,Zheng; Zequn,12,0,40,28
1657059935519,MATH 20B,A01,083756,Briones; Jor-el Thomas Caparas,1,0,36,35
1657059935519,MATH 20B,A02,083757,Briones; Jor-el Thomas Caparas,1,0,36,35
1657059935519,MATH 20B,A03,093475,Briones; Jor-el Thomas Caparas,0,0,36,36
1657059941548,MATH 20C,A01,083760,Briones; Jor-el Thomas Caparas,1,0,35,34
1657059941548,MATH 20C,A02,083761,Briones; Jor-el Thomas Caparas,8,0,35,27
1657059941548,MATH 20C,A03,093476,Briones; Jor-el Thomas Caparas,0,1,36,36
1657059941548,MATH 20C,B01,083762,Bach; Quang Tran,0,0,30,30
1657059947572,MATH 20D,A01,083765,Tran; Brian Kha,4,0,30,26
1657059947572,MATH 20D,A02,083766,Tran; Brian Kha,5,0,30,25
1657059947572,MATH 20D,A03,083767,Tran; Brian Kha,3,0,30,27
1657059953608,MATH 20E,A01,083771,Ganguly; Soumya,5,0,32,27
1657059953608,MATH 20E,A02,083772,Ganguly; Soumya,6,0,32,26
1657059953608,MATH 20E,B01,083773,Ciotti; Benjamin,18,0,35,17
1657059953608,MATH 20E,B02,083774,Ciotti; Benjamin,17,0,35,18
1657059959638,MATH 103A,A01,083777,Greenfeld; Be'Eri,2,0,36,34
1657059959638,MATH 103A,A02,083778,Greenfeld; Be'Eri,5,0,36,31
1657059959638,MATH 103A,A03,093561,Greenfeld; Be'Eri,4,0,36,32
1657059959638,MATH 103A,B01,083779,Greenfeld; Be'Eri,6,0,36,30
1657059959638,MATH 103A,B02,083780,Greenfeld; Be'Eri,2,0,36,34
1657059959638,MATH 103A,B03,093562,Greenfeld; Be'Eri,3,0,36,33
1657059965664,MATH 105,A01,085443,Carter; Anne Toulson,14,0,35,21
1657059965664,MATH 105,A02,093477,Carter; Anne Toulson,20,0,35,15
1657059971689,MATH 109,A01,083213,Ganzberger; Geoffrey Michael,2,0,34,32
1657059971689,MATH 109,A02,083214,Ganzberger; Geoffrey Michael,2,0,34,32
1657059971689,MATH 109,A03,093478,Ganzberger; Geoffrey Michael,1,0,34,33
1657059971689,MATH 109,B01,083215,Ganzberger; Geoffrey Michael,1,0,32,31
1657059971689,MATH 109,B02,083216,Ganzberger; Geoffrey Michael,1,0,32,31
1657059971689,MATH 109,B03,093479,Ganzberger; Geoffrey Michael,6,0,32,26
1657059977717,MATH 142A,A01,083219,Chow; Bennett,6,0,32,26
1657059977717,MATH 142A,A02,083220,Chow; Bennett,10,0,32,22
1657059977717,MATH 142A,A03,093480,Chow; Bennett,7,0,32,25
1657059977717,MATH 142A,B03,093481,Chow; Bennett,7,0,32,25
1657059977717,MATH 142A,B04,093558,Chow; Bennett,11,0,32,21
1657059977717,MATH 142A,B05,093559,Chow; Bennett,6,0,32,26
1657059983747,MATH 193A,A01,083224,Rotar; Vladimir,7,0,34,27
1657059983747,MATH 193A,A02,083225,Rotar; Vladimir,5,0,34,29
1657059983747,MATH 193A,A03,083781,Rotar; Vladimir,1,0,34,33
1657059983747,MATH 193A,A04,083782,Rotar; Vladimir,6,0,34,28
1657059983747,MATH 193A,A05,093482,Rotar; Vladimir,6,0,34,28
1657059989778,MATH 197,001,091859,McAuley; Julian John,9999,0,9999,0
1657059989778,MATH 197,002,095566,Kedlaya; Kiran S.,9997,0,9999,2
1657059989778,MATH 197,003,095567,Xiao; Ming,9999,0,9999,0
1657059989778,MATH 197,004,095571,Perols; Johan Lars,9998,0,9999,1
1657059996838,COGS 9,A01,083615,Shannon; Kyle Michael,7,0,75,68
1657060002863,COGS 11,A01,083617,Boyle; Mary E. T.,20,0,48,28
1657060008975,COGS 13,A01,083071,Bastos; Amalia Pinkusfeld,9,0,71,62
1657060015000,COGS 14A,A01,092681,Semenuks; Arturs,0,1,100,100
1657060021032,COGS 14B,A01,083073,Cheng; Tzu-Han,5,0,63,58
1657060027054,COGS 17,A01,092677,Semenuks; Arturs,4,0,81,77
1657060033077,COGS 100,A01,083619,Allen; Michael Gordon,15,0,70,55
1657060039103,COGS 101A,A01,083621,Davis; Joshua Daniel,9,0,68,59
1657060045131,COGS 101B,A01,091572,Allen; Michael Gordon,8,0,65,57
1657060051155,COGS 101C,A01,083625,Delgado; Tania,17,0,35,18
1657060057178,COGS 107A,A01,083627,Boyle; Mary E. T.,13,0,60,47
1657060063202,COGS 118A,A01,083075,Gupta; Anjum,15,0,76,61
1657060069227,CSE 3,A50,083646,Miranda; Gregory Joseph,22,0,50,28
1657060075250,CSE 8A,A50,083650,Miranda; Gregory Joseph,17,1,56,39
1657060081273,CSE 11,A01,083080,Cao; Yingjun,4,15,40,36
1657060087296,CSE 12,A01,083652,Krause-Levy; Sophia Louisa,23,1,120,97
1657060093324,CSE 15L,A01,083654,Morris; Justin Loren,8,0,50,42
1657060093324,CSE 15L,A02,083655,Morris; Justin Loren,9,0,50,41
1657060099360,CSE 20,A01,083657,Tran; Khoa Dang,37,0,80,43
1657060105385,CSE 21,A01,095574,Bach; Quang Tran,21,0,48,27
1657060111411,CSE 30,A01,083084,Eldon; John,4,0,80,76
1657060111411,CSE 30,B01,095061,Bhaskar; Nishant,6,0,50,44
1657060117444,CSE 100,A01,083659,Cao; Yingjun,3,4,70,67
1657060123467,CSE 134B,A01,083661,Powell; Thomas Allan,19,0,100,81
1657060129491,CSE 140,A01,083663,Gungor; Onat,14,0,85,71
1657060135514,CSE 140L,A01,083088,Eldon; John,16,0,100,84
1657060141535,CSE 175,A01,083665,Kumar; Rakesh,3,0,25,22
1657060147560,CSE 190,A00,092507,Dubnov; Shlomo,7,0,20,13
1657060153592,ECE 45,A01,083139,Congero; Spencer William,5,0,75,70
1657060159617,ECE 65,A50,083695,Saad; Andrew S,12,0,30,18
1657060159617,ECE 65,A51,095125,Saad; Andrew S,25,0,26,1
1657060165639,ECE 109,A01,091882,Touri; Behrouz,16,0,70,54
1657060171664,ECE 180,A00,083140,Abi Samra; Nicholas Camill,1,0,30,29
1657060171664,ECE 180,B00,083141,Abi Samra; Nicholas Camill,0,0,30,30
1657060177698,MATH 10A,A01,083735,Patchell; Gregory David,1,0,30,29
1657060177698,MATH 10A,A02,083736,Patchell; Gregory David,20,0,30,10
1657060177698,MATH 10A,A03,083737,Patchell; Gregory David,16,0,30,14
1657060183721,MATH 10B,A01,083207,Lim; Seonhee,7,0,34,27
1657060183721,MATH 10B,A02,083208,Lim; Seonhee,9,0,35,26
1657060183721,MATH 10B,A03,093472,Lim; Seonhee,4,0,34,30
1657060183721,MATH 10B,B01,083739,Sinha; Shubham,9,0,30,21
1657060189760,MATH 18,A01,083743,Cinel; Cameron Alexander,6,0,30,24
1657060189760,MATH 18,A02,083744,Cinel; Cameron Alexander,15,0,30,15
1657060189760,MATH 18,A03,083745,Cinel; Cameron Alexander,8,0,30,22
1657060189760,MATH 18,B01,083748,Rideout; David Porter,4,0,37,33
1657060189760,MATH 18,B02,083749,Rideout; David Porter,3,0,36,33
1657060189760,MATH 18,B03,083750,Rideout; David Porter,2,0,37,35
1657060189760,MATH 18,B04,083751,Rideout; David Porter,5,0,36,31
1657060189760,MATH 18,B05,093473,Rideout; David Porter,4,0,36,32
1657060189760,MATH 18,B06,093474,Rideout; David Porter,5,0,36,31
1657060195783,MATH 20A,A01,083754,Zheng; Zequn,12,0,40,28
1657060201809,MATH 20B,A01,083756,Briones; Jor-el Thomas Caparas,1,0,36,35
1657060201809,MATH 20B,A02,083757,Briones; Jor-el Thomas Caparas,1,0,36,35
1657060201809,MATH 20B,A03,093475,Briones; Jor-el Thomas Caparas,0,0,36,36
1657060207842,MATH 20C,A01,083760,Briones; Jor-el Thomas Caparas,1,0,35,34
1657060207842,MATH 20C,A02,083761,Briones; Jor-el Thomas Caparas,8,0,35,27
1657060207842,MATH 20C,A03,093476,Briones; Jor-el Thomas Caparas,0,1,36,36
1657060207842,MATH 20C,B01,083762,Bach; Quang Tran,0,0,30,30
1657060213867,MATH 20D,A01,083765,Tran; Brian Kha,4,0,30,26
1657060213867,MATH 20D,A02,083766,Tran; Brian Kha,5,0,30,25
1657060213867,MATH 20D,A03,083767,Tran; Brian Kha,3,0,30,27
1657060219895,MATH 20E,A01,083771,Ganguly; Soumya,5,0,32,27
1657060219895,MATH 20E,A02,083772,Ganguly; Soumya,6,0,32,26
1657060219895,MATH 20E,B01,083773,Ciotti; Benjamin,18,0,35,17
1657060219895,MATH 20E,B02,083774,Ciotti; Benjamin,17,0,35,18
1657060225920,MATH 103A,A01,083777,Greenfeld; Be'Eri,2,0,36,34
1657060225920,MATH 103A,A02,083778,Greenfeld; Be'Eri,5,0,36,31
1657060225920,MATH 103A,A03,093561,Greenfeld; Be'Eri,4,0,36,32
1657060225920,MATH 103A,B01,083779,Greenfeld; Be'Eri,6,0,36,30
1657060225920,MATH 103A,B02,083780,Greenfeld; Be'Eri,2,0,36,34
1657060225920,MATH 103A,B03,093562,Greenfeld; Be'Eri,3,0,36,33
1657060231966,MATH 105,A01,085443,Carter; Anne Toulson,14,0,35,21
1657060231966,MATH 105,A02,093477,Carter; Anne Toulson,20,0,35,15
1657060237993,MATH 109,A01,083213,Ganzberger; Geoffrey Michael,2,0,34,32
1657060237993,MATH 109,A02,083214,Ganzberger; Geoffrey Michael,2,0,34,32
1657060237993,MATH 109,A03,093478,Ganzberger; Geoffrey Michael,1,0,34,33
1657060237993,MATH 109,B01,083215,Ganzberger; Geoffrey Michael,1,0,32,31
1657060237993,MATH 109,B02,083216,Ganzberger; Geoffrey Michael,1,0,32,31
1657060237993,MATH 109,B03,093479,Ganzberger; Geoffrey Michael,6,0,32,26
1657060244023,MATH 142A,A01,083219,Chow; Bennett,6,0,32,26
1657060244023,MATH 142A,A02,083220,Chow; Bennett,10,0,32,22
1657060244023,MATH 142A,A03,093480,Chow; Bennett,7,0,32,25
1657060244023,MATH 142A,B03,093481,Chow; Bennett,7,0,32,25
1657060244023,MATH 142A,B04,093558,Chow; Bennett,11,0,32,21
1657060244023,MATH 142A,B05,093559,Chow; Bennett,6,0,32,26
1657060250065,MATH 193A,A01,083224,Rotar; Vladimir,7,0,34,27
1657060250065,MATH 193A,A02,083225,Rotar; Vladimir,5,0,34,29
1657060250065,MATH 193A,A03,083781,Rotar; Vladimir,1,0,34,33
1657060250065,MATH 193A,A04,083782,Rotar; Vladimir,6,0,34,28
1657060250065,MATH 193A,A05,093482,Rotar; Vladimir,6,0,34,28
1657060256090,MATH 197,001,091859,McAuley; Julian John,9999,0,9999,0
1657060256090,MATH 197,002,095566,Kedlaya; Kiran S.,9997,0,9999,2
1657060256090,MATH 197,003,095567,Xiao; Ming,9999,0,9999,0
1657060256090,MATH 197,004,095571,Perols; Johan Lars,9998,0,9999,1
1657060263230,COGS 9,A01,083615,Shannon; Kyle Michael,7,0,75,68
1657060269260,COGS 11,A01,083617,Boyle; Mary E. T.,20,0,48,28
1657060275297,COGS 13,A01,083071,Bastos; Amalia Pinkusfeld,9,0,71,62
1657060281322,COGS 14A,A01,092681,Semenuks; Arturs,0,1,100,100
1657060287348,COGS 14B,A01,083073,Cheng; Tzu-Han,5,0,63,58
1657060293370,COGS 17,A01,092677,Semenuks; Arturs,4,0,81,77
1657060299398,COGS 100,A01,083619,Allen; Michael Gordon,15,0,70,55
1657060305421,COGS 101A,A01,083621,Davis; Joshua Daniel,9,0,68,59
1657060311447,COGS 101B,A01,091572,Allen; Michael Gordon,8,0,65,57
1657060317472,COGS 101C,A01,083625,Delgado; Tania,17,0,35,18
1657060323497,COGS 107A,A01,083627,Boyle; Mary E. T.,13,0,60,47
1657060329520,COGS 118A,A01,083075,Gupta; Anjum,15,0,76,61
1657060335563,CSE 3,A50,083646,Miranda; Gregory Joseph,22,0,50,28
1657060341586,CSE 8A,A50,083650,Miranda; Gregory Joseph,17,1,56,39
1657060347610,CSE 11,A01,083080,Cao; Yingjun,4,15,40,36
1657060353635,CSE 12,A01,083652,Krause-Levy; Sophia Louisa,23,1,120,97
1657060359658,CSE 15L,A01,083654,Morris; Justin Loren,8,0,50,42
1657060359658,CSE 15L,A02,083655,Morris; Justin Loren,9,0,50,41
1657060365686,CSE 20,A01,083657,Tran; Khoa Dang,37,0,80,43
1657060371711,CSE 21,A01,095574,Bach; Quang Tran,21,0,48,27
1657060377741,CSE 30,A01,083084,Eldon; John,4,0,80,76
1657060377741,CSE 30,B01,095061,Bhaskar; Nishant,6,0,50,44
1657060383762,CSE 100,A01,083659,Cao; Yingjun,3,4,70,67
1657060389784,CSE 134B,A01,083661,Powell; Thomas Allan,19,0,100,81
1657060395814,CSE 140,A01,083663,Gungor; Onat,14,0,85,71
1657060401840,CSE 140L,A01,083088,Eldon; John,16,0,100,84
1657060407866,CSE 175,A01,083665,Kumar; Rakesh,3,0,25,22
1657060413904,CSE 190,A00,092507,Dubnov; Shlomo,7,0,20,13
1657060419930,ECE 45,A01,083139,Congero; Spencer William,5,0,75,70
1657060425955,ECE 65,A50,083695,Saad; Andrew S,12,0,30,18
1657060425955,ECE 65,A51,095125,Saad; Andrew S,25,0,26,1
1657060431991,ECE 109,A01,091882,Touri; Behrouz,16,0,70,54
1657060438018,ECE 180,A00,083140,Abi Samra; Nicholas Camill,1,0,30,29
1657060438018,ECE 180,B00,083141,Abi Samra; Nicholas Camill,0,0,30,30
1657060444045,MATH 10A,A01,083735,Patchell; Gregory David,1,0,30,29
1657060444045,MATH 10A,A02,083736,Patchell; Gregory David,20,0,30,10
1657060444045,MATH 10A,A03,083737,Patchell; Gregory David,16,0,30,14
1657060450073,MATH 10B,A01,083207,Lim; Seonhee,7,0,34,27
1657060450073,MATH 10B,A02,083208,Lim; Seonhee,9,0,35,26
1657060450073,MATH 10B,A03,093472,Lim; Seonhee,4,0,34,30
1657060450073,MATH 10B,B01,083739,Sinha; Shubham,9,0,30,21
1657060456113,MATH 18,A01,083743,Cinel; Cameron Alexander,6,0,30,24
1657060456113,MATH 18,A02,083744,Cinel; Cameron Alexander,15,0,30,15
1657060456113,MATH 18,A03,083745,Cinel; Cameron Alexander,8,0,30,22
1657060456113,MATH 18,B01,083748,Rideout; David Porter,4,0,37,33
1657060456113,MATH 18,B02,083749,Rideout; David Porter,3,0,36,33
1657060456113,MATH 18,B03,083750,Rideout; David Porter,2,0,37,35
1657060456113,MATH 18,B04,083751,Rideout; David Porter,5,0,36,31
1657060456113,MATH 18,B05,093473,Rideout; David Porter,4,0,36,32
1657060456113,MATH 18,B06,093474,Rideout; David Porter,5,0,36,31
1657060462149,MATH 20A,A01,083754,Zheng; Zequn,12,0,40,28
1657060468176,MATH 20B,A01,083756,Briones; Jor-el Thomas Caparas,1,0,36,35
1657060468176,MATH 20B,A02,083757,Briones; Jor-el Thomas Caparas,1,0,36,35
1657060468176,MATH 20B,A03,093475,Briones; Jor-el Thomas Caparas,0,0,36,36
1657060474204,MATH 20C,A01,083760,Briones; Jor-el Thomas Caparas,1,0,35,34
1657060474204,MATH 20C,A02,083761,Briones; Jor-el Thomas Caparas,8,0,35,27
1657060474204,MATH 20C,A03,093476,Briones; Jor-el Thomas Caparas,0,1,36,36
1657060474204,MATH 20C,B01,083762,Bach; Quang Tran,0,0,30,30
1657060480235,MATH 20D,A01,083765,Tran; Brian Kha,4,0,30,26
1657060480235,MATH 20D,A02,083766,Tran; Brian Kha,5,0,30,25
1657060480235,MATH 20D,A03,083767,Tran; Brian Kha,3,0,30,27
1657060486263,MATH 20E,A01,083771,Ganguly; Soumya,5,0,32,27
1657060486263,MATH 20E,A02,083772,Ganguly; Soumya,6,0,32,26
1657060486263,MATH 20E,B01,083773,Ciotti; Benjamin,18,0,35,17
1657060486263,MATH 20E,B02,083774,Ciotti; Benjamin,17,0,35,18
1657060492290,MATH 103A,A01,083777,Greenfeld; Be'Eri,2,0,36,34
1657060492290,MATH 103A,A02,083778,Greenfeld; Be'Eri,5,0,36,31
1657060492290,MATH 103A,A03,093561,Greenfeld; Be'Eri,4,0,36,32
1657060492290,MATH 103A,B01,083779,Greenfeld; Be'Eri,6,0,36,30
1657060492290,MATH 103A,B02,083780,Greenfeld; Be'Eri,2,0,36,34
1657060492290,MATH 103A,B03,093562,Greenfeld; Be'Eri,3,0,36,33
1657060498316,MATH 105,A01,085443,Carter; Anne Toulson,14,0,35,21
1657060498316,MATH 105,A02,093477,Carter; Anne Toulson,20,0,35,15
1657060504339,MATH 109,A01,083213,Ganzberger; Geoffrey Michael,2,0,34,32
1657060504339,MATH 109,A02,083214,Ganzberger; Geoffrey Michael,2,0,34,32
1657060504339,MATH 109,A03,093478,Ganzberger; Geoffrey Michael,1,0,34,33
1657060504339,MATH 109,B01,083215,Ganzberger; Geoffrey Michael,1,0,32,31
1657060504339,MATH 109,B02,083216,Ganzberger; Geoffrey Michael,1,0,32,31
1657060504339,MATH 109,B03,093479,Ganzberger; Geoffrey Michael,6,0,32,26
1657060510367,MATH 142A,A01,083219,Chow; Bennett,6,0,32,26
1657060510367,MATH 142A,A02,083220,Chow; Bennett,10,0,32,22
1657060510367,MATH 142A,A03,093480,Chow; Bennett,7,0,32,25
1657060510367,MATH 142A,B03,093481,Chow; Bennett,7,0,32,25
1657060510367,MATH 142A,B04,093558,Chow; Bennett,11,0,32,21
1657060510367,MATH 142A,B05,093559,Chow; Bennett,6,0,32,26
1657060516395,MATH 193A,A01,083224,Rotar; Vladimir,7,0,34,27
1657060516395,MATH 193A,A02,083225,Rotar; Vladimir,5,0,34,29
1657060516395,MATH 193A,A03,083781,Rotar; Vladimir,1,0,34,33
1657060516395,MATH 193A,A04,083782,Rotar; Vladimir,6,0,34,28
1657060516395,MATH 193A,A05,093482,Rotar; Vladimir,6,0,34,28
1657060522422,MATH 197,001,091859,McAuley; Julian John,9999,0,9999,0
1657060522422,MATH 197,002,095566,Kedlaya; Kiran S.,9997,0,9999,2
1657060522422,MATH 197,003,095567,Xiao; Ming,9999,0,9999,0
1657060522422,MATH 197,004,095571,Perols; Johan Lars,9998,0,9999,1
1657060529486,COGS 9,A01,083615,Shannon; Kyle Michael,7,0,75,68
1657060535513,COGS 11,A01,083617,Boyle; Mary E. T.,20,0,48,28
1657060541537,COGS 13,A01,083071,Bastos; Amalia Pinkusfeld,9,0,71,62
1657060547561,COGS 14A,A01,092681,Semenuks; Arturs,0,1,100,100
1657060553585,COGS 14B,A01,083073,Cheng; Tzu-Han,5,0,63,58
1657060559608,COGS 17,A01,092677,Semenuks; Arturs,4,0,81,77
1657060565639,COGS 100,A01,083619,Allen; Michael Gordon,15,0,70,55
1657060571673,COGS 101A,A01,083621,Davis; Joshua Daniel,9,0,68,59
1657060577696,COGS 101B,A01,091572,Allen; Michael Gordon,8,0,65,57
1657060583724,COGS 101C,A01,083625,Delgado; Tania,17,0,35,18
1657060589747,COGS 107A,A01,083627,Boyle; Mary E. T.,13,0,60,47
1657060595774,COGS 118A,A01,083075,Gupta; Anjum,15,0,76,61
1657060601797,CSE 3,A50,083646,Miranda; Gregory Joseph,22,0,50,28
1657060607906,CSE 8A,A50,083650,Miranda; Gregory Joseph,17,1,56,39
1657060613929,CSE 11,A01,083080,Cao; Yingjun,4,15,40,36
1657060619953,CSE 12,A01,083652,Krause-Levy; Sophia Louisa,23,1,120,97
1657060625975,CSE 15L,A01,083654,Morris; Justin Loren,8,0,50,42
1657060625975,CSE 15L,A02,083655,Morris; Justin Loren,9,0,50,41
1657060631998,CSE 20,A01,083657,Tran; Khoa Dang,37,0,80,43
1657060638020,CSE 21,A01,095574,Bach; Quang Tran,21,0,48,27
1657060644057,CSE 30,A01,083084,Eldon; John,4,0,80,76
1657060644057,CSE 30,B01,095061,Bhaskar; Nishant,6,0,50,44
1657060650081,CSE 100,A01,083659,Cao; Yingjun,3,4,70,67
1657060656113,CSE 134B,A01,083661,Powell; Thomas Allan,19,0,100,81
1657060662140,CSE 140,A01,083663,Gungor; Onat,14,0,85,71
1657060668173,CSE 140L,A01,083088,Eldon; John,16,0,100,84
1657060674200,CSE 175,A01,083665,Kumar; Rakesh,3,0,25,22
1657060680224,CSE 190,A00,092507,Dubnov; Shlomo,7,0,20,13
1657060686250,ECE 45,A01,083139,Congero; Spencer William,5,0,75,70
1657060692276,ECE 65,A50,083695,Saad; Andrew S,12,0,30,18
1657060692276,ECE 65,A51,095125,Saad; Andrew S,25,0,26,1
1657060698308,ECE 109,A01,091882,Touri; Behrouz,16,0,70,54
1657060704333,ECE 180,A00,083140,Abi Samra; Nicholas Camill,1,0,30,29
1657060704333,ECE 180,B00,083141,Abi Samra; Nicholas Camill,0,0,30,30
1657060710358,MATH 10A,A01,083735,Patchell; Gregory David,1,0,30,29
1657060710358,MATH 10A,A02,083736,Patchell; Gregory David,20,0,30,10
1657060710358,MATH 10A,A03,083737,Patchell; Gregory David,16,0,30,14
1657060716387,MATH 10B,A01,083207,Lim; Seonhee,7,0,34,27
1657060716387,MATH 10B,A02,083208,Lim; Seonhee,9,0,35,26
1657060716387,MATH 10B,A03,093472,Lim; Seonhee,4,0,34,30
1657060716387,MATH 10B,B01,083739,Sinha; Shubham,9,0,30,21
1657060722411,MATH 18,A01,083743,Cinel; Cameron Alexander,6,0,30,24
1657060722411,MATH 18,A02,083744,Cinel; Cameron Alexander,15,0,30,15
1657060722411,MATH 18,A03,083745,Cinel; Cameron Alexander,8,0,30,22
1657060722411,MATH 18,B01,083748,Rideout; David Porter,4,0,37,33
1657060722411,MATH 18,B02,083749,Rideout; David Porter,3,0,36,33
1657060722411,MATH 18,B03,083750,Rideout; David Porter,2,0,37,35
1657060722411,MATH 18,B04,083751,Rideout; David Porter,5,0,36,31
1657060722411,MATH 18,B05,093473,Rideout; David Porter,4,0,36,32
1657060722411,MATH 18,B06,093474,Rideout; David Porter,5,0,36,31
1657060728443,MATH 20A,A01,083754,Zheng; Zequn,12,0,40,28
1657060734476,MATH 20B,A01,083756,Briones; Jor-el Thomas Caparas,1,0,36,35
1657060734476,MATH 20B,A02,083757,Briones; Jor-el Thomas Caparas,1,0,36,35
1657060734476,MATH 20B,A03,093475,Briones; Jor-el Thomas Caparas,0,0,36,36
1657060740503,MATH 20C,A01,083760,Briones; Jor-el Thomas Caparas,1,0,35,34
1657060740503,MATH 20C,A02,083761,Briones; Jor-el Thomas Caparas,8,0,35,27
1657060740503,MATH 20C,A03,093476,Briones; Jor-el Thomas Caparas,0,1,36,36
1657060740503,MATH 20C,B01,083762,Bach; Quang Tran,0,0,30,30
1657060746531,MATH 20D,A01,083765,Tran; Brian Kha,4,0,30,26
1657060746531,MATH 20D,A02,083766,Tran; Brian Kha,5,0,30,25
1657060746531,MATH 20D,A03,083767,Tran; Brian Kha,3,0,30,27
1657060752555,MATH 20E,A01,083771,Ganguly; Soumya,5,0,32,27
1657060752555,MATH 20E,A02,083772,Ganguly; Soumya,6,0,32,26
1657060752555,MATH 20E,B01,083773,Ciotti; Benjamin,18,0,35,17
1657060752555,MATH 20E,B02,083774,Ciotti; Benjamin,17,0,35,18
1657060758579,MATH 103A,A01,083777,Greenfeld; Be'Eri,2,0,36,34
1657060758579,MATH 103A,A02,083778,Greenfeld; Be'Eri,5,0,36,31
1657060758579,MATH 103A,A03,093561,Greenfeld; Be'Eri,4,0,36,32
1657060758579,MATH 103A,B01,083779,Greenfeld; Be'Eri,6,0,36,30
1657060758579,MATH 103A,B02,083780,Greenfeld; Be'Eri,2,0,36,34
1657060758579,MATH 103A,B03,093562,Greenfeld; Be'Eri,3,0,36,33
1657060764605,MATH 105,A01,085443,Carter; Anne Toulson,14,0,35,21
1657060764605,MATH 105,A02,093477,Carter; Anne Toulson,20,0,35,15
1657060770632,MATH 109,A01,083213,Ganzberger; Geoffrey Michael,2,0,34,32
1657060770632,MATH 109,A02,083214,Ganzberger; Geoffrey Michael,2,0,34,32
1657060770632,MATH 109,A03,093478,Ganzberger; Geoffrey Michael,1,0,34,33
1657060770632,MATH 109,B01,083215,Ganzberger; Geoffrey Michael,1,0,32,31
1657060770632,MATH 109,B02,083216,Ganzberger; Geoffrey Michael,1,0,32,31
1657060770632,MATH 109,B03,093479,Ganzberger; Geoffrey Michael,6,0,32,26
1657060776680,MATH 142A,A01,083219,Chow; Bennett,6,0,32,26
1657060776680,MATH 142A,A02,083220,Chow; Bennett,10,0,32,22
1657060776680,MATH 142A,A03,093480,Chow; Bennett,7,0,32,25
1657060776680,MATH 142A,B03,093481,Chow; Bennett,7,0,32,25
1657060776680,MATH 142A,B04,093558,Chow; Bennett,11,0,32,21
1657060776680,MATH 142A,B05,093559,Chow; Bennett,6,0,32,26
1657060782707,MATH 193A,A01,083224,Rotar; Vladimir,7,0,34,27
1657060782707,MATH 193A,A02,083225,Rotar; Vladimir,5,0,34,29
1657060782707,MATH 193A,A03,083781,Rotar; Vladimir,1,0,34,33
1657060782707,MATH 193A,A04,083782,Rotar; Vladimir,6,0,34,28
1657060782707,MATH 193A,A05,093482,Rotar; Vladimir,6,0,34,28
1657060788729,MATH 197,001,091859,McAuley; Julian John,9999,0,9999,0
1657060788729,MATH 197,002,095566,Kedlaya; Kiran S.,9997,0,9999,2
1657060788729,MATH 197,003,095567,Xiao; Ming,9999,0,9999,0
1657060788729,MATH 197,004,095571,Perols; Johan Lars,9998,0,9999,1
1657060795795,COGS 9,A01,083615,Shannon; Kyle Michael,7,0,75,68
1657060801821,COGS 11,A01,083617,Boyle; Mary E. T.,20,0,48,28
1657060807843,COGS 13,A01,083071,Bastos; Amalia Pinkusfeld,9,0,71,62
1657060813869,COGS 14A,A01,092681,Semenuks; Arturs,0,1,100,100
1657060819895,COGS 14B,A01,083073,Cheng; Tzu-Han,5,0,63,58
1657060825921,COGS 17,A01,092677,Semenuks; Arturs,4,0,81,77
1657060831954,COGS 100,A01,083619,Allen; Michael Gordon,15,0,70,55
1657060837987,COGS 101A,A01,083621,Davis; Joshua Daniel,9,0,68,59
1657060844010,COGS 101B,A01,091572,Allen; Michael Gordon,8,0,65,57
1657060850044,COGS 101C,A01,083625,Delgado; Tania,17,0,35,18
1657060856071,COGS 107A,A01,083627,Boyle; Mary E. T.,13,0,60,47
1657060862099,COGS 118A,A01,083075,Gupta; Anjum,15,0,76,61
1657060868123,CSE 3,A50,083646,Miranda; Gregory Joseph,22,0,50,28
1657060874147,CSE 8A,A50,083650,Miranda; Gregory Joseph,17,1,56,39
1657060880177,CSE 11,A01,083080,Cao; Yingjun,4,15,40,36
1657060886201,CSE 12,A01,083652,Krause-Levy; Sophia Louisa,23,1,120,97
1657060892228,CSE 15L,A01,083654,Morris; Justin Loren,8,0,50,42
1657060892228,CSE 15L,A02,083655,Morris; Justin Loren,9,0,50,41
1657060898252,CSE 20,A01,083657,Tran; Khoa Dang,37,0,80,43
1657060904276,CSE 21,A01,095574,Bach; Quang Tran,21,0,48,27
1657060910319,CSE 30,A01,083084,Eldon; John,4,0,80,76
1657060910319,CSE 30,B01,095061,Bhaskar; Nishant,6,0,50,44
1657060916342,CSE 100,A01,083659,Cao; Yingjun,3,4,70,67
1657060922374,CSE 134B,A01,083661,Powell; Thomas Allan,19,0,100,81
1657060928401,CSE 140,A01,083663,Gungor; Onat,14,0,85,71
1657060934425,CSE 140L,A01,083088,Eldon; John,16,0,100,84
1657060940448,CSE 175,A01,083665,Kumar; Rakesh,3,0,25,22
1657060946470,CSE 190,A00,092507,Dubnov; Shlomo,7,0,20,13
1657060952499,ECE 45,A01,083139,Congero; Spencer William,5,0,75,70
1657060958526,ECE 65,A50,083695,Saad; Andrew S,12,0,30,18
1657060958526,ECE 65,A51,095125,Saad; Andrew S,25,0,26,1
1657060964549,ECE 109,A01,091882,Touri; Behrouz,16,0,70,54
1657060970573,ECE 180,A00,083140,Abi Samra; Nicholas Camill,1,0,30,29
1657060970573,ECE 180,B00,083141,Abi Samra; Nicholas Camill,0,0,30,30
1657060976603,MATH 10A,A01,083735,Patchell; Gregory David,1,0,30,29
1657060976603,MATH 10A,A02,083736,Patchell; Gregory David,20,0,30,10
1657060976603,MATH 10A,A03,083737,Patchell; Gregory David,16,0,30,14
1657060982630,MATH 10B,A01,083207,Lim; Seonhee,7,0,34,27
1657060982630,MATH 10B,A02,083208,Lim; Seonhee,9,0,35,26
1657060982630,MATH 10B,A03,093472,Lim; Seonhee,4,0,34,30
1657060982630,MATH 10B,B01,083739,Sinha; Shubham,9,0,30,21
1657060988660,MATH 18,A01,083743,Cinel; Cameron Alexander,6,0,30,24
1657060988660,MATH 18,A02,083744,Cinel; Cameron Alexander,15,0,30,15
1657060988660,MATH 18,A03,083745,Cinel; Cameron Alexander,8,0,30,22
1657060988660,MATH 18,B01,083748,Rideout; David Porter,4,0,37,33
1657060988660,MATH 18,B02,083749,Rideout; David Porter,3,0,36,33
1657060988660,MATH 18,B03,083750,Rideout; David Porter,2,0,37,35
1657060988660,MATH 18,B04,083751,Rideout; David Porter,5,0,36,31
1657060988660,MATH 18,B05,093473,Rideout; David Porter,4,0,36,32
1657060988660,MATH 18,B06,093474,Rideout; David Porter,5,0,36,31
1657060994684,MATH 20A,A01,083754,Zheng; Zequn,12,0,40,28
1657061000712,MATH 20B,A01,083756,Briones; Jor-el Thomas Caparas,1,0,36,35
1657061000712,MATH 20B,A02,083757,Briones; Jor-el Thomas Caparas,1,0,36,35
1657061000712,MATH 20B,A03,093475,Briones; Jor-el Thomas Caparas,0,0,36,36
1657061006741,MATH 20C,A01,083760,Briones; Jor-el Thomas Caparas,1,0,35,34
1657061006741,MATH 20C,A02,083761,Briones; Jor-el Thomas Caparas,8,0,35,27
1657061006741,MATH 20C,A03,093476,Briones; Jor-el Thomas Caparas,0,1,36,36
1657061006741,MATH 20C,B01,083762,Bach; Quang Tran,0,0,30,30
1657061012766,MATH 20D,A01,083765,Tran; Brian Kha,4,0,30,26
1657061012766,MATH 20D,A02,083766,Tran; Brian Kha,5,0,30,25
1657061012766,MATH 20D,A03,083767,Tran; Brian Kha,3,0,30,27
1657061018795,MATH 20E,A01,083771,Ganguly; Soumya,5,0,32,27
1657061018795,MATH 20E,A02,083772,Ganguly; Soumya,6,0,32,26
1657061018795,MATH 20E,B01,083773,Ciotti; Benjamin,18,0,35,17
1657061018795,MATH 20E,B02,083774,Ciotti; Benjamin,17,0,35,18
1657061024819,MATH 103A,A01,083777,Greenfeld; Be'Eri,2,0,36,34
1657061024819,MATH 103A,A02,083778,Greenfeld; Be'Eri,5,0,36,31
1657061024819,MATH 103A,A03,093561,Greenfeld; Be'Eri,4,0,36,32
1657061024819,MATH 103A,B01,083779,Greenfeld; Be'Eri,6,0,36,30
1657061024819,MATH 103A,B02,083780,Greenfeld; Be'Eri,2,0,36,34
1657061024819,MATH 103A,B03,093562,Greenfeld; Be'Eri,3,0,36,33
1657061030849,MATH 105,A01,085443,Carter; Anne Toulson,14,0,35,21
1657061030849,MATH 105,A02,093477,Carter; Anne Toulson,20,0,35,15
1657061036874,MATH 109,A01,083213,Ganzberger; Geoffrey Michael,2,0,34,32
1657061036874,MATH 109,A02,083214,Ganzberger; Geoffrey Michael,2,0,34,32
1657061036874,MATH 109,A03,093478,Ganzberger; Geoffrey Michael,1,0,34,33
1657061036874,MATH 109,B01,083215,Ganzberger; Geoffrey Michael,1,0,32,31
1657061036874,MATH 109,B02,083216,Ganzberger; Geoffrey Michael,1,0,32,31
1657061036874,MATH 109,B03,093479,Ganzberger; Geoffrey Michael,6,0,32,26
1657061042899,MATH 142A,A01,083219,Chow; Bennett,6,0,32,26
1657061042899,MATH 142A,A02,083220,Chow; Bennett,10,0,32,22
1657061042899,MATH 142A,A03,093480,Chow; Bennett,7,0,32,25
1657061042899,MATH 142A,B03,093481,Chow; Bennett,7,0,32,25
1657061042899,MATH 142A,B04,093558,Chow; Bennett,11,0,32,21
1657061042899,MATH 142A,B05,093559,Chow; Bennett,6,0,32,26
1657061048928,MATH 193A,A01,083224,Rotar; Vladimir,7,0,34,27
1657061048928,MATH 193A,A02,083225,Rotar; Vladimir,5,0,34,29
1657061048928,MATH 193A,A03,083781,Rotar; Vladimir,1,0,34,33
1657061048928,MATH 193A,A04,083782,Rotar; Vladimir,6,0,34,28
1657061048928,MATH 193A,A05,093482,Rotar; Vladimir,6,0,34,28
1657061054956,MATH 197,001,091859,McAuley; Julian John,9999,0,9999,0
1657061054956,MATH 197,002,095566,Kedlaya; Kiran S.,9997,0,9999,2
1657061054956,MATH 197,003,095567,Xiao; Ming,9999,0,9999,0
1657061054956,MATH 197,004,095571,Perols; Johan Lars,9998,0,9999,1
1657061062013,COGS 9,A01,083615,Shannon; Kyle Michael,7,0,75,68
1657061068045,COGS 11,A01,083617,Boyle; Mary E. T.,20,0,48,28
1657061074078,COGS 13,A01,083071,Bastos; Amalia Pinkusfeld,9,0,71,62
1657061080107,COGS 14A,A01,092681,Semenuks; Arturs,0,1,100,100
1657061086134,COGS 14B,A01,083073,Cheng; Tzu-Han,5,0,63,58
1657061092167,COGS 17,A01,092677,Semenuks; Arturs,4,0,81,77
1657061098198,COGS 100,A01,083619,Allen; Michael Gordon,15,0,70,55
1657061104229,COGS 101A,A01,083621,Davis; Joshua Daniel,9,0,68,59
1657061110265,COGS 101B,A01,091572,Allen; Michael Gordon,8,0,65,57
1657061116294,COGS 101C,A01,083625,Delgado; Tania,17,0,35,18
1657061122322,COGS 107A,A01,083627,Boyle; Mary E. T.,13,0,60,47
1657061128349,COGS 118A,A01,083075,Gupta; Anjum,15,0,76,61
1657061134377,CSE 3,A50,083646,Miranda; Gregory Joseph,22,0,50,28
1657061140401,CSE 8A,A50,083650,Miranda; Gregory Joseph,17,1,56,39
1657061146427,CSE 11,A01,083080,Cao; Yingjun,4,15,40,36
1657061152450,CSE 12,A01,083652,Krause-Levy; Sophia Louisa,23,1,120,97
1657061158473,CSE 15L,A01,083654,Morris; Justin Loren,8,0,50,42
1657061158473,CSE 15L,A02,083655,Morris; Justin Loren,9,0,50,41
1657061164496,CSE 20,A01,083657,Tran; Khoa Dang,37,0,80,43
1657061170530,CSE 21,A01,095574,Bach; Quang Tran,21,0,48,27
1657061176567,CSE 30,A01,083084,Eldon; John,4,0,80,76
1657061176567,CSE 30,B01,095061,Bhaskar; Nishant,6,0,50,44
1657061182595,CSE 100,A01,083659,Cao; Yingjun,3,4,70,67
1657061188618,CSE 134B,A01,083661,Powell; Thomas Allan,19,0,100,81
1657061194643,CSE 140,A01,083663,Gungor; Onat,14,0,85,71
1657061200668,CSE 140L,A01,083088,Eldon; John,16,0,100,84
1657061206793,CSE 175,A01,083665,Kumar; Rakesh,3,0,25,22
1657061212815,CSE 190,A00,092507,Dubnov; Shlomo,7,0,20,13
1657061218843,ECE 45,A01,083139,Congero; Spencer William,5,0,75,70
1657061224870,ECE 65,A50,083695,Saad; Andrew S,12,0,30,18
1657061224870,ECE 65,A51,095125,Saad; Andrew S,25,0,26,1
1657061230892,ECE 109,A01,091882,Touri; Behrouz,16,0,70,54
1657061236918,ECE 180,A00,083140,Abi Samra; Nicholas Camill,1,0,30,29
1657061236918,ECE 180,B00,083141,Abi Samra; Nicholas Camill,0,0,30,30
1657061242942,MATH 10A,A01,083735,Patchell; Gregory David,1,0,30,29
1657061242942,MATH 10A,A02,083736,Patchell; Gregory David,20,0,30,10
1657061242942,MATH 10A,A03,083737,Patchell; Gregory David,16,0,30,14
1657061248972,MATH 10B,A01,083207,Lim; Seonhee,7,0,34,27
1657061248972,MATH 10B,A02,083208,Lim; Seonhee,9,0,35,26
1657061248972,MATH 10B,A03,093472,Lim; Seonhee,4,0,34,30
1657061248972,MATH 10B,B01,083739,Sinha; Shubham,9,0,30,21
1657061255014,MATH 18,A01,083743,Cinel; Cameron Alexander,6,0,30,24
1657061255014,MATH 18,A02,083744,Cinel; Cameron Alexander,15,0,30,15
1657061255014,MATH 18,A03,083745,Cinel; Cameron Alexander,8,0,30,22
1657061255014,MATH 18,B01,083748,Rideout; David Porter,4,0,37,33
1657061255014,MATH 18,B02,083749,Rideout; David Porter,3,0,36,33
1657061255014,MATH 18,B03,083750,Rideout; David Porter,2,0,37,35
1657061255014,MATH 18,B04,083751,Rideout; David Porter,5,0,36,31
1657061255014,MATH 18,B05,093473,Rideout; David Porter,4,0,36,32
1657061255014,MATH 18,B06,093474,Rideout; David Porter,5,0,36,31
1657061261041,MATH 20A,A01,083754,Zheng; Zequn,12,0,40,28
1657061267066,MATH 20B,A01,083756,Briones; Jor-el Thomas Caparas,1,0,36,35
1657061267066,MATH 20B,A02,083757,Briones; Jor-el Thomas Caparas,1,0,36,35
1657061267066,MATH 20B,A03,093475,Briones; Jor-el Thomas Caparas,0,0,36,36
1657061273089,MATH 20C,A01,083760,Briones; Jor-el Thomas Caparas,1,0,35,34
1657061273089,MATH 20C,A02,083761,Briones; Jor-el Thomas Caparas,8,0,35,27
1657061273089,MATH 20C,A03,093476,Briones; Jor-el Thomas Caparas,0,1,36,36
1657061273089,MATH 20C,B01,083762,Bach; Quang Tran,0,0,30,30
1657061279128,MATH 20D,A01,083765,Tran; Brian Kha,4,0,30,26
1657061279128,MATH 20D,A02,083766,Tran; Brian Kha,5,0,30,25
1657061279128,MATH 20D,A03,083767,Tran; Brian Kha,3,0,30,27
1657061285160,MATH 20E,A01,083771,Ganguly; Soumya,5,0,32,27
1657061285160,MATH 20E,A02,083772,Ganguly; Soumya,6,0,32,26
1657061285160,MATH 20E,B01,083773,Ciotti; Benjamin,18,0,35,17
1657061285160,MATH 20E,B02,083774,Ciotti; Benjamin,17,0,35,18
1657061291190,MATH 103A,A01,083777,Greenfeld; Be'Eri,2,0,36,34
1657061291190,MATH 103A,A02,083778,Greenfeld; Be'Eri,5,0,36,31
1657061291190,MATH 103A,A03,093561,Greenfeld; Be'Eri,4,0,36,32
1657061291190,MATH 103A,B01,083779,Greenfeld; Be'Eri,6,0,36,30
1657061291190,MATH 103A,B02,083780,Greenfeld; Be'Eri,2,0,36,34
1657061291190,MATH 103A,B03,093562,Greenfeld; Be'Eri,3,0,36,33
1657061297218,MATH 105,A01,085443,Carter; Anne Toulson,14,0,35,21
1657061297218,MATH 105,A02,093477,Carter; Anne Toulson,20,0,35,15
1657061303247,MATH 109,A01,083213,Ganzberger; Geoffrey Michael,2,0,34,32
1657061303247,MATH 109,A02,083214,Ganzberger; Geoffrey Michael,2,0,34,32
1657061303247,MATH 109,A03,093478,Ganzberger; Geoffrey Michael,1,0,34,33
1657061303247,MATH 109,B01,083215,Ganzberger; Geoffrey Michael,1,0,32,31
1657061303247,MATH 109,B02,083216,Ganzberger; Geoffrey Michael,1,0,32,31
1657061303247,MATH 109,B03,093479,Ganzberger; Geoffrey Michael,6,0,32,26
1657061309285,MATH 142A,A01,083219,Chow; Bennett,6,0,32,26
1657061309285,MATH 142A,A02,083220,Chow; Bennett,10,0,32,22
1657061309285,MATH 142A,A03,093480,Chow; Bennett,7,0,32,25
1657061309285,MATH 142A,B03,093481,Chow; Bennett,7,0,32,25
1657061309285,MATH 142A,B04,093558,Chow; Bennett,11,0,32,21
1657061309285,MATH 142A,B05,093559,Chow; Bennett,6,0,32,26
1657061315312,MATH 193A,A01,083224,Rotar; Vladimir,7,0,34,27
1657061315312,MATH 193A,A02,083225,Rotar; Vladimir,5,0,34,29
1657061315312,MATH 193A,A03,083781,Rotar; Vladimir,1,0,34,33
1657061315312,MATH 193A,A04,083782,Rotar; Vladimir,6,0,34,28
1657061315312,MATH 193A,A05,093482,Rotar; Vladimir,6,0,34,28
1657061321335,MATH 197,001,091859,McAuley; Julian John,9999,0,9999,0
1657061321335,MATH 197,002,095566,Kedlaya; Kiran S.,9997,0,9999,2
1657061321335,MATH 197,003,095567,Xiao; Ming,9999,0,9999,0
1657061321335,MATH 197,004,095571,Perols; Johan Lars,9998,0,9999,1
1657061328388,COGS 9,A01,083615,Shannon; Kyle Michael,7,0,75,68
1657061334411,COGS 11,A01,083617,Boyle; Mary E. T.,20,0,48,28
1657061340439,COGS 13,A01,083071,Bastos; Amalia Pinkusfeld,9,0,71,62
1657061346461,COGS 14A,A01,092681,Semenuks; Arturs,0,1,100,100
1657061352490,COGS 14B,A01,083073,Cheng; Tzu-Han,5,0,63,58
1657061358515,COGS 17,A01,092677,Semenuks; Arturs,4,0,81,77
1657061364540,COGS 100,A01,083619,Allen; Michael Gordon,15,0,70,55
1657061370574,COGS 101A,A01,083621,Davis; Joshua Daniel,9,0,68,59
1657061376617,COGS 101B,A01,091572,Allen; Michael Gordon,8,0,65,57
1657061382641,COGS 101C,A01,083625,Delgado; Tania,17,0,35,18
1657061388677,COGS 107A,A01,083627,Boyle; Mary E. T.,13,0,60,47
1657061394702,COGS 118A,A01,083075,Gupta; Anjum,15,0,76,61
1657061400732,CSE 3,A50,083646,Miranda; Gregory Joseph,22,0,50,28
1657061406760,CSE 8A,A50,083650,Miranda; Gregory Joseph,17,1,56,39
1657061412786,CSE 11,A01,083080,Cao; Yingjun,4,15,40,36
1657061418812,CSE 12,A01,083652,Krause-Levy; Sophia Louisa,23,1,120,97
1657061424841,CSE 15L,A01,083654,Morris; Justin Loren,8,0,50,42
1657061424841,CSE 15L,A02,083655,Morris; Justin Loren,9,0,50,41
1657061430865,CSE 20,A01,083657,Tran; Khoa Dang,37,0,80,43
1657061436894,CSE 21,A01,095574,Bach; Quang Tran,21,0,48,27
1657061442921,CSE 30,A01,083084,Eldon; John,4,0,80,76
1657061442921,CSE 30,B01,095061,Bhaskar; Nishant,6,0,50,44
1657061448947,CSE 100,A01,083659,Cao; Yingjun,3,4,70,67
1657061454979,CSE 134B,A01,083661,Powell; Thomas Allan,19,0,100,81
1657061461009,CSE 140,A01,083663,Gungor; Onat,14,0,85,71
1657061467036,CSE 140L,A01,083088,Eldon; John,16,0,100,84
1657061473061,CSE 175,A01,083665,Kumar; Rakesh,3,0,25,22
1657061479082,CSE 190,A00,092507,Dubnov; Shlomo,7,0,20,13
1657061485110,ECE 45,A01,083139,Congero; Spencer William,5,0,75,70
1657061491136,ECE 65,A50,083695,Saad; Andrew S,12,0,30,18
1657061491136,ECE 65,A51,095125,Saad; Andrew S,25,0,26,1
1657061497160,ECE 109,A01,091882,Touri; Behrouz,16,0,70,54
1657061503184,ECE 180,A00,083140,Abi Samra; Nicholas Camill,1,0,30,29
1657061503184,ECE 180,B00,083141,Abi Samra; Nicholas Camill,0,0,30,30
1657061509220,MATH 10A,A01,083735,Patchell; Gregory David,1,0,30,29
1657061509220,MATH 10A,A02,083736,Patchell; Gregory David,20,0,30,10
1657061509220,MATH 10A,A03,083737,Patchell; Gregory David,16,0,30,14
1657061515252,MATH 10B,A01,083207,Lim; Seonhee,7,0,34,27
1657061515252,MATH 10B,A02,083208,Lim; Seonhee,9,0,35,26
1657061515252,MATH 10B,A03,093472,Lim; Seonhee,4,0,34,30
1657061515252,MATH 10B,B01,083739,Sinha; Shubham,9,0,30,21
1657061521283,MATH 18,A01,083743,Cinel; Cameron Alexander,6,0,30,24
1657061521283,MATH 18,A02,083744,Cinel; Cameron Alexander,15,0,30,15
1657061521283,MATH 18,A03,083745,Cinel; Cameron Alexander,8,0,30,22
1657061521283,MATH 18,B01,083748,Rideout; David Porter,4,0,37,33
1657061521283,MATH 18,B02,083749,Rideout; David Porter,3,0,36,33
1657061521283,MATH 18,B03,083750,Rideout; David Porter,2,0,37,35
1657061521283,MATH 18,B04,083751,Rideout; David Porter,5,0,36,31
1657061521283,MATH 18,B05,093473,Rideout; David Porter,4,0,36,32
1657061521283,MATH 18,B06,093474,Rideout; David Porter,5,0,36,31
1657061527311,MATH 20A,A01,083754,Zheng; Zequn,12,0,40,28
1657061533366,MATH 20B,A01,083756,Briones; Jor-el Thomas Caparas,1,0,36,35
1657061533366,MATH 20B,A02,083757,Briones; Jor-el Thomas Caparas,1,0,36,35
1657061533366,MATH 20B,A03,093475,Briones; Jor-el Thomas Caparas,0,0,36,36
1657061539389,MATH 20C,A01,083760,Briones; Jor-el Thomas Caparas,1,0,35,34
1657061539389,MATH 20C,A02,083761,Briones; Jor-el Thomas Caparas,8,0,35,27
1657061539389,MATH 20C,A03,093476,Briones; Jor-el Thomas Caparas,0,1,36,36
1657061539389,MATH 20C,B01,083762,Bach; Quang Tran,0,0,30,30
1657061545412,MATH 20D,A01,083765,Tran; Brian Kha,4,0,30,26
1657061545412,MATH 20D,A02,083766,Tran; Brian Kha,5,0,30,25
1657061545412,MATH 20D,A03,083767,Tran; Brian Kha,3,0,30,27
1657061551453,MATH 20E,A01,083771,Ganguly; Soumya,5,0,32,27
1657061551453,MATH 20E,A02,083772,Ganguly; Soumya,6,0,32,26
1657061551453,MATH 20E,B01,083773,Ciotti; Benjamin,18,0,35,17
1657061551453,MATH 20E,B02,083774,Ciotti; Benjamin,17,0,35,18
1657061557487,MATH 103A,A01,083777,Greenfeld; Be'Eri,2,0,36,34
1657061557487,MATH 103A,A02,083778,Greenfeld; Be'Eri,5,0,36,31
1657061557487,MATH 103A,A03,093561,Greenfeld; Be'Eri,4,0,36,32
1657061557487,MATH 103A,B01,083779,Greenfeld; Be'Eri,6,0,36,30
1657061557487,MATH 103A,B02,083780,Greenfeld; Be'Eri,2,0,36,34
1657061557487,MATH 103A,B03,093562,Greenfeld; Be'Eri,3,0,36,33
1657061563508,MATH 105,A01,085443,Carter; Anne Toulson,14,0,35,21
1657061563508,MATH 105,A02,093477,Carter; Anne Toulson,20,0,35,15
1657061569531,MATH 109,A01,083213,Ganzberger; Geoffrey Michael,2,0,34,32
1657061569531,MATH 109,A02,083214,Ganzberger; Geoffrey Michael,2,0,34,32
1657061569531,MATH 109,A03,093478,Ganzberger; Geoffrey Michael,1,0,34,33
1657061569531,MATH 109,B01,083215,Ganzberger; Geoffrey Michael,1,0,32,31
1657061569531,MATH 109,B02,083216,Ganzberger; Geoffrey Michael,1,0,32,31
1657061569531,MATH 109,B03,093479,Ganzberger; Geoffrey Michael,6,0,32,26
1657061575556,MATH 142A,A01,083219,Chow; Bennett,6,0,32,26
1657061575556,MATH 142A,A02,083220,Chow; Bennett,10,0,32,22
1657061575556,MATH 142A,A03,093480,Chow; Bennett,7,0,32,25
1657061575556,MATH 142A,B03,093481,Chow; Bennett,7,0,32,25
1657061575556,MATH 142A,B04,093558,Chow; Bennett,11,0,32,21
1657061575556,MATH 142A,B05,093559,Chow; Bennett,6,0,32,26
1657061581579,MATH 193A,A01,083224,Rotar; Vladimir,7,0,34,27
1657061581579,MATH 193A,A02,083225,Rotar; Vladimir,5,0,34,29
1657061581579,MATH 193A,A03,083781,Rotar; Vladimir,1,0,34,33
1657061581579,MATH 193A,A04,083782,Rotar; Vladimir,6,0,34,28
1657061581579,MATH 193A,A05,093482,Rotar; Vladimir,6,0,34,28
1657061587609,MATH 197,001,091859,McAuley; Julian John,9999,0,9999,0
1657061587609,MATH 197,002,095566,Kedlaya; Kiran S.,9997,0,9999,2
1657061587609,MATH 197,003,095567,Xiao; Ming,9999,0,9999,0
1657061587609,MATH 197,004,095571,Perols; Johan Lars,9998,0,9999,1
1657061594673,COGS 9,A01,083615,Shannon; Kyle Michael,7,0,75,68
1657061600696,COGS 11,A01,083617,Boyle; Mary E. T.,20,0,48,28
1657061606727,COGS 13,A01,083071,Bastos; Amalia Pinkusfeld,9,0,71,62
1657061612798,COGS 14A,A01,092681,Semenuks; Arturs,0,1,100,100
1657061618826,COGS 14B,A01,083073,Cheng; Tzu-Han,5,0,63,58
1657061624853,COGS 17,A01,092677,Semenuks; Arturs,4,0,81,77
1657061630885,COGS 100,A01,083619,Allen; Michael Gordon,15,0,70,55
1657061636907,COGS 101A,A01,083621,Davis; Joshua Daniel,9,0,68,59
1657061642938,COGS 101B,A01,091572,Allen; Michael Gordon,8,0,65,57
1657061648970,COGS 101C,A01,083625,Delgado; Tania,17,0,35,18
1657061654996,COGS 107A,A01,083627,Boyle; Mary E. T.,13,0,60,47
1657061661020,COGS 118A,A01,083075,Gupta; Anjum,15,0,76,61
1657061667041,CSE 3,A50,083646,Miranda; Gregory Joseph,22,0,50,28
1657061673069,CSE 8A,A50,083650,Miranda; Gregory Joseph,17,1,56,39
1657061679112,CSE 11,A01,083080,Cao; Yingjun,4,15,40,36
1657061685138,CSE 12,A01,083652,Krause-Levy; Sophia Louisa,23,1,120,97
1657061691166,CSE 15L,A01,083654,Morris; Justin Loren,8,0,50,42
1657061691166,CSE 15L,A02,083655,Morris; Justin Loren,9,0,50,41
1657061697190,CSE 20,A01,083657,Tran; Khoa Dang,37,0,80,43
1657061703218,CSE 21,A01,095574,Bach; Quang Tran,21,0,48,27
1657061709240,CSE 30,A01,083084,Eldon; John,4,0,80,76
1657061709240,CSE 30,B01,095061,Bhaskar; Nishant,6,0,50,44
1657061715263,CSE 100,A01,083659,Cao; Yingjun,3,4,70,67
1657061721286,CSE 134B,A01,083661,Powell; Thomas Allan,19,0,100,81
1657061727314,CSE 140,A01,083663,Gungor; Onat,14,0,85,71
1657061733337,CSE 140L,A01,083088,Eldon; John,16,0,100,84
1657061739360,CSE 175,A01,083665,Kumar; Rakesh,3,0,25,22
1657061745386,CSE 190,A00,092507,Dubnov; Shlomo,7,0,20,13
1657061751417,ECE 45,A01,083139,Congero; Spencer William,5,0,75,70
1657061757444,ECE 65,A50,083695,Saad; Andrew S,12,0,30,18
1657061757444,ECE 65,A51,095125,Saad; Andrew S,25,0,26,1
1657061763472,ECE 109,A01,091882,Touri; Behrouz,16,0,70,54
1657061769495,ECE 180,A00,083140,Abi Samra; Nicholas Camill,1,0,30,29
1657061769495,ECE 180,B00,083141,Abi Samra; Nicholas Camill,0,0,30,30
1657061775520,MATH 10A,A01,083735,Patchell; Gregory David,1,0,30,29
1657061775520,MATH 10A,A02,083736,Patchell; Gregory David,20,0,30,10
1657061775520,MATH 10A,A03,083737,Patchell; Gregory David,16,0,30,14
1657061781548,MATH 10B,A01,083207,Lim; Seonhee,7,0,34,27
1657061781548,MATH 10B,A02,083208,Lim; Seonhee,9,0,35,26
1657061781548,MATH 10B,A03,093472,Lim; Seonhee,4,0,34,30
1657061781548,MATH 10B,B01,083739,Sinha; Shubham,9,0,30,21
1657061787574,MATH 18,A01,083743,Cinel; Cameron Alexander,6,0,30,24
1657061787574,MATH 18,A02,083744,Cinel; Cameron Alexander,15,0,30,15
1657061787574,MATH 18,A03,083745,Cinel; Cameron Alexander,8,0,30,22
1657061787574,MATH 18,B01,083748,Rideout; David Porter,4,0,37,33
1657061787574,MATH 18,B02,083749,Rideout; David Porter,3,0,36,33
1657061787574,MATH 18,B03,083750,Rideout; David Porter,2,0,37,35
1657061787574,MATH 18,B04,083751,Rideout; David Porter,5,0,36,31
1657061787574,MATH 18,B05,093473,Rideout; David Porter,4,0,36,32
1657061787574,MATH 18,B06,093474,Rideout; David Porter,5,0,36,31
1657061793598,MATH 20A,A01,083754,Zheng; Zequn,12,0,40,28
1657061799623,MATH 20B,A01,083756,Briones; Jor-el Thomas Caparas,1,0,36,35
1657061799623,MATH 20B,A02,083757,Briones; Jor-el Thomas Caparas,1,0,36,35
1657061799623,MATH 20B,A03,093475,Briones; Jor-el Thomas Caparas,0,0,36,36
1657061805731,MATH 20C,A01,083760,Briones; Jor-el Thomas Caparas,1,0,35,34
1657061805731,MATH 20C,A02,083761,Briones; Jor-el Thomas Caparas,8,0,35,27
1657061805731,MATH 20C,A03,093476,Briones; Jor-el Thomas Caparas,0,1,36,36
1657061805731,MATH 20C,B01,083762,Bach; Quang Tran,0,0,30,30
1657061811762,MATH 20D,A01,083765,Tran; Brian Kha,4,0,30,26
1657061811762,MATH 20D,A02,083766,Tran; Brian Kha,5,0,30,25
1657061811762,MATH 20D,A03,083767,Tran; Brian Kha,3,0,30,27
1657061817792,MATH 20E,A01,083771,Ganguly; Soumya,5,0,32,27
1657061817792,MATH 20E,A02,083772,Ganguly; Soumya,6,0,32,26
1657061817792,MATH 20E,B01,083773,Ciotti; Benjamin,18,0,35,17
1657061817792,MATH 20E,B02,083774,Ciotti; Benjamin,17,0,35,18
1657061823820,MATH 103A,A01,083777,Greenfeld; Be'Eri,2,0,36,34
1657061823820,MATH 103A,A02,083778,Greenfeld; Be'Eri,5,0,36,31
1657061823820,MATH 103A,A03,093561,Greenfeld; Be'Eri,4,0,36,32
1657061823820,MATH 103A,B01,083779,Greenfeld; Be'Eri,6,0,36,30
1657061823820,MATH 103A,B02,083780,Greenfeld; Be'Eri,2,0,36,34
1657061823820,MATH 103A,B03,093562,Greenfeld; Be'Eri,3,0,36,33
1657061829845,MATH 105,A01,085443,Carter; Anne Toulson,14,0,35,21
1657061829845,MATH 105,A02,093477,Carter; Anne Toulson,20,0,35,15
1657061835875,MATH 109,A01,083213,Ganzberger; Geoffrey Michael,2,0,34,32
1657061835875,MATH 109,A02,083214,Ganzberger; Geoffrey Michael,2,0,34,32
1657061835875,MATH 109,A03,093478,Ganzberger; Geoffrey Michael,1,0,34,33
1657061835875,MATH 109,B01,083215,Ganzberger; Geoffrey Michael,1,0,32,31
1657061835875,MATH 109,B02,083216,Ganzberger; Geoffrey Michael,1,0,32,31
1657061835875,MATH 109,B03,093479,Ganzberger; Geoffrey Michael,6,0,32,26
1657061841898,MATH 142A,A01,083219,Chow; Bennett,6,0,32,26
1657061841898,MATH 142A,A02,083220,Chow; Bennett,10,0,32,22
1657061841898,MATH 142A,A03,093480,Chow; Bennett,7,0,32,25
1657061841898,MATH 142A,B03,093481,Chow; Bennett,7,0,32,25
1657061841898,MATH 142A,B04,093558,Chow; Bennett,11,0,32,21
1657061841898,MATH 142A,B05,093559,Chow; Bennett,6,0,32,26
1657061847930,MATH 193A,A01,083224,Rotar; Vladimir,7,0,34,27
1657061847930,MATH 193A,A02,083225,Rotar; Vladimir,5,0,34,29
1657061847930,MATH 193A,A03,083781,Rotar; Vladimir,1,0,34,33
1657061847930,MATH 193A,A04,083782,Rotar; Vladimir,6,0,34,28
1657061847930,MATH 193A,A05,093482,Rotar; Vladimir,6,0,34,28
1657061853954,MATH 197,001,091859,McAuley; Julian John,9999,0,9999,0
1657061853954,MATH 197,002,095566,Kedlaya; Kiran S.,9997,0,9999,2
1657061853954,MATH 197,003,095567,Xiao; Ming,9999,0,9999,0
1657061853954,MATH 197,004,095571,Perols; Johan Lars,9998,0,9999,1
1657061861020,COGS 9,A01,083615,Shannon; Kyle Michael,7,0,75,68
1657061867042,COGS 11,A01,083617,Boyle; Mary E. T.,20,0,48,28
1657061873069,COGS 13,A01,083071,Bastos; Amalia Pinkusfeld,9,0,71,62
1657061879093,COGS 14A,A01,092681,Semenuks; Arturs,0,1,100,100
1657061885121,COGS 14B,A01,083073,Cheng; Tzu-Han,5,0,63,58
1657061891145,COGS 17,A01,092677,Semenuks; Arturs,4,0,81,77
1657061897174,COGS 100,A01,083619,Allen; Michael Gordon,15,0,70,55
1657061903197,COGS 101A,A01,083621,Davis; Joshua Daniel,9,0,68,59
1657061909227,COGS 101B,A01,091572,Allen; Michael Gordon,8,0,65,57
1657061915254,COGS 101C,A01,083625,Delgado; Tania,17,0,35,18
1657061921277,COGS 107A,A01,083627,Boyle; Mary E. T.,13,0,60,47
1657061927300,COGS 118A,A01,083075,Gupta; Anjum,15,0,76,61
1657061933326,CSE 3,A50,083646,Miranda; Gregory Joseph,22,0,50,28
1657061939357,CSE 8A,A50,083650,Miranda; Gregory Joseph,17,1,56,39
1657061945378,CSE 11,A01,083080,Cao; Yingjun,4,15,40,36
1657061951401,CSE 12,A01,083652,Krause-Levy; Sophia Louisa,23,1,120,97
1657061957424,CSE 15L,A01,083654,Morris; Justin Loren,8,0,50,42
1657061957424,CSE 15L,A02,083655,Morris; Justin Loren,9,0,50,41
1657061963447,CSE 20,A01,083657,Tran; Khoa Dang,37,0,80,43
1657061969474,CSE 21,A01,095574,Bach; Quang Tran,21,0,48,27
1657061975497,CSE 30,A01,083084,Eldon; John,4,0,80,76
1657061975497,CSE 30,B01,095061,Bhaskar; Nishant,6,0,50,44
1657061981527,CSE 100,A01,083659,Cao; Yingjun,3,4,70,67
1657061987551,CSE 134B,A01,083661,Powell; Thomas Allan,19,0,100,81
1657061993577,CSE 140,A01,083663,Gungor; Onat,14,0,85,71
1657061999599,CSE 140L,A01,083088,Eldon; John,16,0,100,84
1657062005639,CSE 175,A01,083665,Kumar; Rakesh,3,0,25,22
1657062011665,CSE 190,A00,092507,Dubnov; Shlomo,7,0,20,13
1657062017690,ECE 45,A01,083139,Congero; Spencer William,5,0,75,70
1657062023717,ECE 65,A50,083695,Saad; Andrew S,12,0,30,18
1657062023717,ECE 65,A51,095125,Saad; Andrew S,25,0,26,1
1657062029739,ECE 109,A01,091882,Touri; Behrouz,16,0,70,54
1657062035766,ECE 180,A00,083140,Abi Samra; Nicholas Camill,1,0,30,29
1657062035766,ECE 180,B00,083141,Abi Samra; Nicholas Camill,0,0,30,30
1657062041793,MATH 10A,A01,083735,Patchell; Gregory David,1,0,30,29
1657062041793,MATH 10A,A02,083736,Patchell; Gregory David,20,0,30,10
1657062041793,MATH 10A,A03,083737,Patchell; Gregory David,16,0,30,14
1657062047821,MATH 10B,A01,083207,Lim; Seonhee,7,0,34,27
1657062047821,MATH 10B,A02,083208,Lim; Seonhee,9,0,35,26
1657062047821,MATH 10B,A03,093472,Lim; Seonhee,4,0,34,30
1657062047821,MATH 10B,B01,083739,Sinha; Shubham,9,0,30,21
1657062053859,MATH 18,A01,083743,Cinel; Cameron Alexander,6,0,30,24
1657062053859,MATH 18,A02,083744,Cinel; Cameron Alexander,15,0,30,15
1657062053859,MATH 18,A03,083745,Cinel; Cameron Alexander,8,0,30,22
1657062053859,MATH 18,B01,083748,Rideout; David Porter,4,0,37,33
1657062053859,MATH 18,B02,083749,Rideout; David Porter,3,0,36,33
1657062053859,MATH 18,B03,083750,Rideout; David Porter,2,0,37,35
1657062053859,MATH 18,B04,083751,Rideout; David Porter,5,0,36,31
1657062053859,MATH 18,B05,093473,Rideout; David Porter,4,0,36,32
1657062053859,MATH 18,B06,093474,Rideout; David Porter,5,0,36,31
1657062059881,MATH 20A,A01,083754,Zheng; Zequn,12,0,40,28
1657062065926,MATH 20B,A01,083756,Briones; Jor-el Thomas Caparas,1,0,36,35
1657062065926,MATH 20B,A02,083757,Briones; Jor-el Thomas Caparas,1,0,36,35
1657062065926,MATH 20B,A03,093475,Briones; Jor-el Thomas Caparas,0,0,36,36
1657062071950,MATH 20C,A01,083760,Briones; Jor-el Thomas Caparas,1,0,35,34
1657062071950,MATH 20C,A02,083761,Briones; Jor-el Thomas Caparas,8,0,35,27
1657062071950,MATH 20C,A03,093476,Briones; Jor-el Thomas Caparas,0,1,36,36
1657062071950,MATH 20C,B01,083762,Bach; Quang Tran,0,0,30,30
1657062077989,MATH 20D,A01,083765,Tran; Brian Kha,4,0,30,26
1657062077989,MATH 20D,A02,083766,Tran; Brian Kha,5,0,30,25
1657062077989,MATH 20D,A03,083767,Tran; Brian Kha,3,0,30,27
1657062084022,MATH 20E,A01,083771,Ganguly; Soumya,5,0,32,27
1657062084022,MATH 20E,A02,083772,Ganguly; Soumya,6,0,32,26
1657062084022,MATH 20E,B01,083773,Ciotti; Benjamin,18,0,35,17
1657062084022,MATH 20E,B02,083774,Ciotti; Benjamin,17,0,35,18
1657062090046,MATH 103A,A01,083777,Greenfeld; Be'Eri,2,0,36,34
1657062090046,MATH 103A,A02,083778,Greenfeld; Be'Eri,5,0,36,31
1657062090046,MATH 103A,A03,093561,Greenfeld; Be'Eri,4,0,36,32
1657062090046,MATH 103A,B01,083779,Greenfeld; Be'Eri,6,0,36,30
1657062090046,MATH 103A,B02,083780,Greenfeld; Be'Eri,2,0,36,34
1657062090046,MATH 103A,B03,093562,Greenfeld; Be'Eri,3,0,36,33
1657062096074,MATH 105,A01,085443,Carter; Anne Toulson,14,0,35,21
1657062096074,MATH 105,A02,093477,Carter; Anne Toulson,20,0,35,15
1657062102098,MATH 109,A01,083213,Ganzberger; Geoffrey Michael,2,0,34,32
1657062102098,MATH 109,A02,083214,Ganzberger; Geoffrey Michael,2,0,34,32
1657062102098,MATH 109,A03,093478,Ganzberger; Geoffrey Michael,1,0,34,33
1657062102098,MATH 109,B01,083215,Ganzberger; Geoffrey Michael,1,0,32,31
1657062102098,MATH 109,B02,083216,Ganzberger; Geoffrey Michael,1,0,32,31
1657062102098,MATH 109,B03,093479,Ganzberger; Geoffrey Michael,6,0,32,26
1657062108146,MATH 142A,A01,083219,Chow; Bennett,6,0,32,26
1657062108146,MATH 142A,A02,083220,Chow; Bennett,10,0,32,22
1657062108146,MATH 142A,A03,093480,Chow; Bennett,7,0,32,25
1657062108146,MATH 142A,B03,093481,Chow; Bennett,7,0,32,25
1657062108146,MATH 142A,B04,093558,Chow; Bennett,11,0,32,21
1657062108146,MATH 142A,B05,093559,Chow; Bennett,6,0,32,26
1657062114180,MATH 193A,A01,083224,Rotar; Vladimir,7,0,34,27
1657062114180,MATH 193A,A02,083225,Rotar; Vladimir,5,0,34,29
1657062114180,MATH 193A,A03,083781,Rotar; Vladimir,1,0,34,33
1657062114180,MATH 193A,A04,083782,Rotar; Vladimir,6,0,34,28
1657062114180,MATH 193A,A05,093482,Rotar; Vladimir,6,0,34,28
1657062120219,MATH 197,001,091859,McAuley; Julian John,9999,0,9999,0
1657062120219,MATH 197,002,095566,Kedlaya; Kiran S.,9997,0,9999,2
1657062120219,MATH 197,003,095567,Xiao; Ming,9999,0,9999,0
1657062120219,MATH 197,004,095571,Perols; Johan Lars,9998,0,9999,1
1657062127275,COGS 9,A01,083615,Shannon; Kyle Michael,7,0,75,68
1657062133305,COGS 11,A01,083617,Boyle; Mary E. T.,20,0,48,28
1657062139334,COGS 13,A01,083071,Bastos; Amalia Pinkusfeld,9,0,71,62
1657062145360,COGS 14A,A01,092681,Semenuks; Arturs,0,1,100,100
1657062151387,COGS 14B,A01,083073,Cheng; Tzu-Han,5,0,63,58
1657062157412,COGS 17,A01,092677,Semenuks; Arturs,4,0,81,77
1657062163435,COGS 100,A01,083619,Allen; Michael Gordon,15,0,70,55
1657062169457,COGS 101A,A01,083621,Davis; Joshua Daniel,9,0,68,59
1657062175481,COGS 101B,A01,091572,Allen; Michael Gordon,8,0,65,57
1657062181516,COGS 101C,A01,083625,Delgado; Tania,17,0,35,18
1657062187546,COGS 107A,A01,083627,Boyle; Mary E. T.,13,0,60,47
1657062193586,COGS 118A,A01,083075,Gupta; Anjum,15,0,76,61
1657062199611,CSE 3,A50,083646,Miranda; Gregory Joseph,22,0,50,28
1657062205640,CSE 8A,A50,083650,Miranda; Gregory Joseph,17,1,56,39
1657062211662,CSE 11,A01,083080,Cao; Yingjun,4,15,40,36
1657062217687,CSE 12,A01,083652,Krause-Levy; Sophia Louisa,23,1,120,97
1657062223710,CSE 15L,A01,083654,Morris; Justin Loren,8,0,50,42
1657062223710,CSE 15L,A02,083655,Morris; Justin Loren,9,0,50,41
1657062229732,CSE 20,A01,083657,Tran; Khoa Dang,37,0,80,43
1657062235755,CSE 21,A01,095574,Bach; Quang Tran,21,0,48,27
1657062241781,CSE 30,A01,083084,Eldon; John,4,0,80,76
1657062241781,CSE 30,B01,095061,Bhaskar; Nishant,6,0,50,44
1657062247803,CSE 100,A01,083659,Cao; Yingjun,3,4,70,67
1657062253830,CSE 134B,A01,083661,Powell; Thomas Allan,19,0,100,81
1657062259864,CSE 140,A01,083663,Gungor; Onat,14,0,85,71
1657062265891,CSE 140L,A01,083088,Eldon; John,16,0,100,84
1657062271917,CSE 175,A01,083665,Kumar; Rakesh,3,0,25,22
1657062277951,CSE 190,A00,092507,Dubnov; Shlomo,7,0,20,13
1657062283976,ECE 45,A01,083139,Congero; Spencer William,5,0,75,70
1657062290003,ECE 65,A50,083695,Saad; Andrew S,12,0,30,18
1657062290003,ECE 65,A51,095125,Saad; Andrew S,25,0,26,1
1657062296025,ECE 109,A01,091882,Touri; Behrouz,16,0,70,54
1657062302050,ECE 180,A00,083140,Abi Samra; Nicholas Camill,1,0,30,29
1657062302050,ECE 180,B00,083141,Abi Samra; Nicholas Camill,0,0,30,30
1657062308081,MATH 10A,A01,083735,Patchell; Gregory David,1,0,30,29
1657062308081,MATH 10A,A02,083736,Patchell; Gregory David,20,0,30,10
1657062308081,MATH 10A,A03,083737,Patchell; Gregory David,16,0,30,14
1657062314105,MATH 10B,A01,083207,Lim; Seonhee,7,0,34,27
1657062314105,MATH 10B,A02,083208,Lim; Seonhee,9,0,35,26
1657062314105,MATH 10B,A03,093472,Lim; Seonhee,4,0,34,30
1657062314105,MATH 10B,B01,083739,Sinha; Shubham,9,0,30,21
1657062320130,MATH 18,A01,083743,Cinel; Cameron Alexander,6,0,30,24
1657062320130,MATH 18,A02,083744,Cinel; Cameron Alexander,15,0,30,15
1657062320130,MATH 18,A03,083745,Cinel; Cameron Alexander,8,0,30,22
1657062320130,MATH 18,B01,083748,Rideout; David Porter,4,0,37,33
1657062320130,MATH 18,B02,083749,Rideout; David Porter,3,0,36,33
1657062320130,MATH 18,B03,083750,Rideout; David Porter,2,0,37,35
1657062320130,MATH 18,B04,083751,Rideout; David Porter,5,0,36,31
1657062320130,MATH 18,B05,093473,Rideout; David Porter,4,0,36,32
1657062320130,MATH 18,B06,093474,Rideout; David Porter,5,0,36,31
1657062326156,MATH 20A,A01,083754,Zheng; Zequn,12,0,40,28
1657062332180,MATH 20B,A01,083756,Briones; Jor-el Thomas Caparas,1,0,36,35
1657062332180,MATH 20B,A02,083757,Briones; Jor-el Thomas Caparas,1,0,36,35
1657062332180,MATH 20B,A03,093475,Briones; Jor-el Thomas Caparas,0,0,36,36
1657062338207,MATH 20C,A01,083760,Briones; Jor-el Thomas Caparas,1,0,35,34
1657062338207,MATH 20C,A02,083761,Briones; Jor-el Thomas Caparas,8,0,35,27
1657062338207,MATH 20C,A03,093476,Briones; Jor-el Thomas Caparas,0,1,36,36
1657062338207,MATH 20C,B01,083762,Bach; Quang Tran,0,0,30,30
1657062344231,MATH 20D,A01,083765,Tran; Brian Kha,4,0,30,26
1657062344231,MATH 20D,A02,083766,Tran; Brian Kha,5,0,30,25
1657062344231,MATH 20D,A03,083767,Tran; Brian Kha,3,0,30,27
1657062350263,MATH 20E,A01,083771,Ganguly; Soumya,5,0,32,27
1657062350263,MATH 20E,A02,083772,Ganguly; Soumya,6,0,32,26
1657062350263,MATH 20E,B01,083773,Ciotti; Benjamin,18,0,35,17
1657062350263,MATH 20E,B02,083774,Ciotti; Benjamin,17,0,35,18
1657062356293,MATH 103A,A01,083777,Greenfeld; Be'Eri,2,0,36,34
1657062356293,MATH 103A,A02,083778,Greenfeld; Be'Eri,5,0,36,31
1657062356293,MATH 103A,A03,093561,Greenfeld; Be'Eri,4,0,36,32
1657062356293,MATH 103A,B01,083779,Greenfeld; Be'Eri,6,0,36,30
1657062356293,MATH 103A,B02,083780,Greenfeld; Be'Eri,2,0,36,34
1657062356293,MATH 103A,B03,093562,Greenfeld; Be'Eri,3,0,36,33
1657062362317,MATH 105,A01,085443,Carter; Anne Toulson,14,0,35,21
1657062362317,MATH 105,A02,093477,Carter; Anne Toulson,20,0,35,15
1657062368342,MATH 109,A01,083213,Ganzberger; Geoffrey Michael,2,0,34,32
1657062368342,MATH 109,A02,083214,Ganzberger; Geoffrey Michael,2,0,34,32
1657062368342,MATH 109,A03,093478,Ganzberger; Geoffrey Michael,1,0,34,33
1657062368342,MATH 109,B01,083215,Ganzberger; Geoffrey Michael,1,0,32,31
1657062368342,MATH 109,B02,083216,Ganzberger; Geoffrey Michael,1,0,32,31
1657062368342,MATH 109,B03,093479,Ganzberger; Geoffrey Michael,6,0,32,26
1657062374372,MATH 142A,A01,083219,Chow; Bennett,6,0,32,26
1657062374372,MATH 142A,A02,083220,Chow; Bennett,10,0,32,22
1657062374372,MATH 142A,A03,093480,Chow; Bennett,7,0,32,25
1657062374372,MATH 142A,B03,093481,Chow; Bennett,7,0,32,25
1657062374372,MATH 142A,B04,093558,Chow; Bennett,11,0,32,21
1657062374372,MATH 142A,B05,093559,Chow; Bennett,6,0,32,26
1657062380396,MATH 193A,A01,083224,Rotar; Vladimir,7,0,34,27
1657062380396,MATH 193A,A02,083225,Rotar; Vladimir,5,0,34,29
1657062380396,MATH 193A,A03,083781,Rotar; Vladimir,1,0,34,33
1657062380396,MATH 193A,A04,083782,Rotar; Vladimir,6,0,34,28
1657062380396,MATH 193A,A05,093482,Rotar; Vladimir,6,0,34,28
1657062386418,MATH 197,001,091859,McAuley; Julian John,9999,0,9999,0
1657062386418,MATH 197,002,095566,Kedlaya; Kiran S.,9997,0,9999,2
1657062386418,MATH 197,003,095567,Xiao; Ming,9999,0,9999,0
1657062386418,MATH 197,004,095571,Perols; Johan Lars,9998,0,9999,1
1657062393488,COGS 9,A01,083615,Shannon; Kyle Michael,7,0,75,68
1657062399624,COGS 11,A01,083617,Boyle; Mary E. T.,20,0,48,28
1657062405652,COGS 13,A01,083071,Bastos; Amalia Pinkusfeld,9,0,71,62
1657062411679,COGS 14A,A01,092681,Semenuks; Arturs,0,1,100,100
1657062417705,COGS 14B,A01,083073,Cheng; Tzu-Han,5,0,63,58
1657062423733,COGS 17,A01,092677,Semenuks; Arturs,4,0,81,77
1657062429770,COGS 100,A01,083619,Allen; Michael Gordon,15,0,70,55
1657062435795,COGS 101A,A01,083621,Davis; Joshua Daniel,9,0,68,59
1657062441827,COGS 101B,A01,091572,Allen; Michael Gordon,8,0,65,57
1657062447854,COGS 101C,A01,083625,Delgado; Tania,17,0,35,18
1657062453876,COGS 107A,A01,083627,Boyle; Mary E. T.,13,0,60,47
1657062459900,COGS 118A,A01,083075,Gupta; Anjum,15,0,76,61
1657062465936,CSE 3,A50,083646,Miranda; Gregory Joseph,22,0,50,28
1657062471960,CSE 8A,A50,083650,Miranda; Gregory Joseph,17,1,56,39
1657062477982,CSE 11,A01,083080,Cao; Yingjun,4,15,40,36
1657062484006,CSE 12,A01,083652,Krause-Levy; Sophia Louisa,23,1,120,97
1657062490028,CSE 15L,A01,083654,Morris; Justin Loren,8,0,50,42
1657062490028,CSE 15L,A02,083655,Morris; Justin Loren,9,0,50,41
1657062496060,CSE 20,A01,083657,Tran; Khoa Dang,37,0,80,43
1657062502099,CSE 21,A01,095574,Bach; Quang Tran,21,0,48,27
1657062508125,CSE 30,A01,083084,Eldon; John,4,0,80,76
1657062508125,CSE 30,B01,095061,Bhaskar; Nishant,6,0,50,44
1657062514147,CSE 100,A01,083659,Cao; Yingjun,3,4,70,67
1657062520174,CSE 134B,A01,083661,Powell; Thomas Allan,19,0,100,81
1657062526199,CSE 140,A01,083663,Gungor; Onat,14,0,85,71
1657062532220,CSE 140L,A01,083088,Eldon; John,16,0,100,84
1657062538247,CSE 175,A01,083665,Kumar; Rakesh,3,0,25,22
1657062544270,CSE 190,A00,092507,Dubnov; Shlomo,7,0,20,13
1657062550295,ECE 45,A01,083139,Congero; Spencer William,5,0,75,70
1657062556321,ECE 65,A50,083695,Saad; Andrew S,12,0,30,18
1657062556321,ECE 65,A51,095125,Saad; Andrew S,25,0,26,1
1657062562358,ECE 109,A01,091882,Touri; Behrouz,16,0,70,54
1657062568381,ECE 180,A00,083140,Abi Samra; Nicholas Camill,1,0,30,29
1657062568381,ECE 180,B00,083141,Abi Samra; Nicholas Camill,0,0,30,30
1657062574406,MATH 10A,A01,083735,Patchell; Gregory David,1,0,30,29
1657062574406,MATH 10A,A02,083736,Patchell; Gregory David,20,0,30,10
1657062574406,MATH 10A,A03,083737,Patchell; Gregory David,16,0,30,14
1657062580442,MATH 10B,A01,083207,Lim; Seonhee,7,0,34,27
1657062580442,MATH 10B,A02,083208,Lim; Seonhee,9,0,35,26
1657062580442,MATH 10B,A03,093472,Lim; Seonhee,4,0,34,30
1657062580442,MATH 10B,B01,083739,Sinha; Shubham,9,0,30,21
1657062586466,MATH 18,A01,083743,Cinel; Cameron Alexander,6,0,30,24
1657062586466,MATH 18,A02,083744,Cinel; Cameron Alexander,15,0,30,15
1657062586466,MATH 18,A03,083745,Cinel; Cameron Alexander,8,0,30,22
1657062586466,MATH 18,B01,083748,Rideout; David Porter,4,0,37,33
1657062586466,MATH 18,B02,083749,Rideout; David Porter,3,0,36,33
1657062586466,MATH 18,B03,083750,Rideout; David Porter,2,0,37,35
1657062586466,MATH 18,B04,083751,Rideout; David Porter,5,0,36,31
1657062586466,MATH 18,B05,093473,Rideout; David Porter,4,0,36,32
1657062586466,MATH 18,B06,093474,Rideout; David Porter,5,0,36,31
1657062592490,MATH 20A,A01,083754,Zheng; Zequn,12,0,40,28
1657062598512,MATH 20B,A01,083756,Briones; Jor-el Thomas Caparas,1,0,36,35
1657062598512,MATH 20B,A02,083757,Briones; Jor-el Thomas Caparas,1,0,36,35
1657062598512,MATH 20B,A03,093475,Briones; Jor-el Thomas Caparas,0,0,36,36
1657062604534,MATH 20C,A01,083760,Briones; Jor-el Thomas Caparas,1,0,35,34
1657062604534,MATH 20C,A02,083761,Briones; Jor-el Thomas Caparas,8,0,35,27
1657062604534,MATH 20C,A03,093476,Briones; Jor-el Thomas Caparas,0,1,36,36
1657062604534,MATH 20C,B01,083762,Bach; Quang Tran,0,0,30,30
1657062610564,MATH 20D,A01,083765,Tran; Brian Kha,4,0,30,26
1657062610564,MATH 20D,A02,083766,Tran; Brian Kha,5,0,30,25
1657062610564,MATH 20D,A03,083767,Tran; Brian Kha,3,0,30,27
1657062616590,MATH 20E,A01,083771,Ganguly; Soumya,5,0,32,27
1657062616590,MATH 20E,A02,083772,Ganguly; Soumya,6,0,32,26
1657062616590,MATH 20E,B01,083773,Ciotti; Benjamin,18,0,35,17
1657062616590,MATH 20E,B02,083774,Ciotti; Benjamin,17,0,35,18
1657062622613,MATH 103A,A01,083777,Greenfeld; Be'Eri,2,0,36,34
1657062622613,MATH 103A,A02,083778,Greenfeld; Be'Eri,5,0,36,31
1657062622613,MATH 103A,A03,093561,Greenfeld; Be'Eri,4,0,36,32
1657062622613,MATH 103A,B01,083779,Greenfeld; Be'Eri,6,0,36,30
1657062622613,MATH 103A,B02,083780,Greenfeld; Be'Eri,2,0,36,34
1657062622613,MATH 103A,B03,093562,Greenfeld; Be'Eri,3,0,36,33
1657062628640,MATH 105,A01,085443,Carter; Anne Toulson,14,0,35,21
1657062628640,MATH 105,A02,093477,Carter; Anne Toulson,20,0,35,15
1657062634672,MATH 109,A01,083213,Ganzberger; Geoffrey Michael,2,0,34,32
1657062634672,MATH 109,A02,083214,Ganzberger; Geoffrey Michael,2,0,34,32
1657062634672,MATH 109,A03,093478,Ganzberger; Geoffrey Michael,1,0,34,33
1657062634672,MATH 109,B01,083215,Ganzberger; Geoffrey Michael,1,0,32,31
1657062634672,MATH 109,B02,083216,Ganzberger; Geoffrey Michael,1,0,32,31
1657062634672,MATH 109,B03,093479,Ganzberger; Geoffrey Michael,6,0,32,26
1657062640702,MATH 142A,A01,083219,Chow; Bennett,6,0,32,26
1657062640702,MATH 142A,A02,083220,Chow; Bennett,10,0,32,22
1657062640702,MATH 142A,A03,093480,Chow; Bennett,7,0,32,25
1657062640702,MATH 142A,B03,093481,Chow; Bennett,7,0,32,25
1657062640702,MATH 142A,B04,093558,Chow; Bennett,11,0,32,21
1657062640702,MATH 142A,B05,093559,Chow; Bennett,6,0,32,26
1657062646727,MATH 193A,A01,083224,Rotar; Vladimir,7,0,34,27
1657062646727,MATH 193A,A02,083225,Rotar; Vladimir,5,0,34,29
1657062646727,MATH 193A,A03,083781,Rotar; Vladimir,1,0,34,33
1657062646727,MATH 193A,A04,083782,Rotar; Vladimir,6,0,34,28
1657062646727,MATH 193A,A05,093482,Rotar; Vladimir,6,0,34,28
1657062652749,MATH 197,001,091859,McAuley; Julian John,9999,0,9999,0
1657062652749,MATH 197,002,095566,Kedlaya; Kiran S.,9997,0,9999,2
1657062652749,MATH 197,003,095567,Xiao; Ming,9999,0,9999,0
1657062652749,MATH 197,004,095571,Perols; Johan Lars,9998,0,9999,1
1657062659813,COGS 9,A01,083615,Shannon; Kyle Michael,7,0,75,68
1657062665851,COGS 11,A01,083617,Boyle; Mary E. T.,20,0,48,28
1657062671873,COGS 13,A01,083071,Bastos; Amalia Pinkusfeld,9,0,71,62
1657062677897,COGS 14A,A01,092681,Semenuks; Arturs,0,1,100,100
1657062683921,COGS 14B,A01,083073,Cheng; Tzu-Han,5,0,63,58
1657062689948,COGS 17,A01,092677,Semenuks; Arturs,4,0,81,77
1657062695976,COGS 100,A01,083619,Allen; Michael Gordon,15,0,70,55
1657062701998,COGS 101A,A01,083621,Davis; Joshua Daniel,9,0,68,59
1657062708022,COGS 101B,A01,091572,Allen; Michael Gordon,8,0,65,57
1657062714044,COGS 101C,A01,083625,Delgado; Tania,17,0,35,18
1657062720066,COGS 107A,A01,083627,Boyle; Mary E. T.,13,0,60,47
1657062726093,COGS 118A,A01,083075,Gupta; Anjum,15,0,76,61
1657062732119,CSE 3,A50,083646,Miranda; Gregory Joseph,22,0,50,28
1657062738143,CSE 8A,A50,083650,Miranda; Gregory Joseph,17,1,56,39
1657062744165,CSE 11,A01,083080,Cao; Yingjun,4,15,40,36
1657062750189,CSE 12,A01,083652,Krause-Levy; Sophia Louisa,23,1,120,97
1657062756216,CSE 15L,A01,083654,Morris; Justin Loren,8,0,50,42
1657062756216,CSE 15L,A02,083655,Morris; Justin Loren,9,0,50,41
1657062762242,CSE 20,A01,083657,Tran; Khoa Dang,37,0,80,43
1657062768266,CSE 21,A01,095574,Bach; Quang Tran,21,0,48,27
1657062774292,CSE 30,A01,083084,Eldon; John,4,0,80,76
1657062774292,CSE 30,B01,095061,Bhaskar; Nishant,6,0,50,44
1657062780322,CSE 100,A01,083659,Cao; Yingjun,3,4,70,67
1657062786350,CSE 134B,A01,083661,Powell; Thomas Allan,19,0,100,81
1657062792376,CSE 140,A01,083663,Gungor; Onat,14,0,85,71
1657062798397,CSE 140L,A01,083088,Eldon; John,16,0,100,84
1657062804428,CSE 175,A01,083665,Kumar; Rakesh,3,0,25,22
1657062810455,CSE 190,A00,092507,Dubnov; Shlomo,7,0,20,13
1657062816481,ECE 45,A01,083139,Congero; Spencer William,5,0,75,70
1657062822506,ECE 65,A50,083695,Saad; Andrew S,12,0,30,18
1657062822506,ECE 65,A51,095125,Saad; Andrew S,25,0,26,1
1657062828533,ECE 109,A01,091882,Touri; Behrouz,16,0,70,54
1657062834558,ECE 180,A00,083140,Abi Samra; Nicholas Camill,1,0,30,29
1657062834558,ECE 180,B00,083141,Abi Samra; Nicholas Camill,0,0,30,30
1657062840586,MATH 10A,A01,083735,Patchell; Gregory David,1,0,30,29
1657062840586,MATH 10A,A02,083736,Patchell; Gregory David,20,0,30,10
1657062840586,MATH 10A,A03,083737,Patchell; Gregory David,16,0,30,14
1657062846616,MATH 10B,A01,083207,Lim; Seonhee,7,0,34,27
1657062846616,MATH 10B,A02,083208,Lim; Seonhee,9,0,35,26
1657062846616,MATH 10B,A03,093472,Lim; Seonhee,4,0,34,30
1657062846616,MATH 10B,B01,083739,Sinha; Shubham,9,0,30,21
1657062852660,MATH 18,A01,083743,Cinel; Cameron Alexander,6,0,30,24
1657062852660,MATH 18,A02,083744,Cinel; Cameron Alexander,15,0,30,15
1657062852660,MATH 18,A03,083745,Cinel; Cameron Alexander,8,0,30,22
1657062852660,MATH 18,B01,083748,Rideout; David Porter,4,0,37,33
1657062852660,MATH 18,B02,083749,Rideout; David Porter,3,0,36,33
1657062852660,MATH 18,B03,083750,Rideout; David Porter,2,0,37,35
1657062852660,MATH 18,B04,083751,Rideout; David Porter,5,0,36,31
1657062852660,MATH 18,B05,093473,Rideout; David Porter,4,0,36,32
1657062852660,MATH 18,B06,093474,Rideout; David Porter,5,0,36,31
1657062858686,MATH 20A,A01,083754,Zheng; Zequn,12,0,40,28
1657062864741,MATH 20B,A01,083756,Briones; Jor-el Thomas Caparas,1,0,36,35
1657062864741,MATH 20B,A02,083757,Briones; Jor-el Thomas Caparas,1,0,36,35
1657062864741,MATH 20B,A03,093475,Briones; Jor-el Thomas Caparas,0,0,36,36
1657062870774,MATH 20C,A01,083760,Briones; Jor-el Thomas Caparas,1,0,35,34
1657062870774,MATH 20C,A02,083761,Briones; Jor-el Thomas Caparas,8,0,35,27
1657062870774,MATH 20C,A03,093476,Briones; Jor-el Thomas Caparas,0,1,36,36
1657062870774,MATH 20C,B01,083762,Bach; Quang Tran,0,0,30,30
1657062876803,MATH 20D,A01,083765,Tran; Brian Kha,4,0,30,26
1657062876803,MATH 20D,A02,083766,Tran; Brian Kha,5,0,30,25
1657062876803,MATH 20D,A03,083767,Tran; Brian Kha,3,0,30,27
1657062882828,MATH 20E,A01,083771,Ganguly; Soumya,5,0,32,27
1657062882828,MATH 20E,A02,083772,Ganguly; Soumya,6,0,32,26
1657062882828,MATH 20E,B01,083773,Ciotti; Benjamin,18,0,35,17
1657062882828,MATH 20E,B02,083774,Ciotti; Benjamin,17,0,35,18
1657062888852,MATH 103A,A01,083777,Greenfeld; Be'Eri,2,0,36,34
1657062888852,MATH 103A,A02,083778,Greenfeld; Be'Eri,5,0,36,31
1657062888852,MATH 103A,A03,093561,Greenfeld; Be'Eri,4,0,36,32
1657062888852,MATH 103A,B01,083779,Greenfeld; Be'Eri,6,0,36,30
1657062888852,MATH 103A,B02,083780,Greenfeld; Be'Eri,2,0,36,34
1657062888852,MATH 103A,B03,093562,Greenfeld; Be'Eri,3,0,36,33
1657062894874,MATH 105,A01,085443,Carter; Anne Toulson,14,0,35,21
1657062894874,MATH 105,A02,093477,Carter; Anne Toulson,20,0,35,15
1657062900900,MATH 109,A01,083213,Ganzberger; Geoffrey Michael,2,0,34,32
1657062900900,MATH 109,A02,083214,Ganzberger; Geoffrey Michael,2,0,34,32
1657062900900,MATH 109,A03,093478,Ganzberger; Geoffrey Michael,1,0,34,33
1657062900900,MATH 109,B01,083215,Ganzberger; Geoffrey Michael,1,0,32,31
1657062900900,MATH 109,B02,083216,Ganzberger; Geoffrey Michael,1,0,32,31
1657062900900,MATH 109,B03,093479,Ganzberger; Geoffrey Michael,6,0,32,26
1657062906923,MATH 142A,A01,083219,Chow; Bennett,6,0,32,26
1657062906923,MATH 142A,A02,083220,Chow; Bennett,10,0,32,22
1657062906923,MATH 142A,A03,093480,Chow; Bennett,7,0,32,25
1657062906923,MATH 142A,B03,093481,Chow; Bennett,7,0,32,25
1657062906923,MATH 142A,B04,093558,Chow; Bennett,11,0,32,21
1657062906923,MATH 142A,B05,093559,Chow; Bennett,6,0,32,26
1657062912952,MATH 193A,A01,083224,Rotar; Vladimir,7,0,34,27
1657062912952,MATH 193A,A02,083225,Rotar; Vladimir,5,0,34,29
1657062912952,MATH 193A,A03,083781,Rotar; Vladimir,1,0,34,33
1657062912952,MATH 193A,A04,083782,Rotar; Vladimir,6,0,34,28
1657062912952,MATH 193A,A05,093482,Rotar; Vladimir,6,0,34,28
1657062918976,MATH 197,001,091859,McAuley; Julian John,9999,0,9999,0
1657062918976,MATH 197,002,095566,Kedlaya; Kiran S.,9997,0,9999,2
1657062918976,MATH 197,003,095567,Xiao; Ming,9999,0,9999,0
1657062918976,MATH 197,004,095571,Perols; Johan Lars,9998,0,9999,1
1657062926026,COGS 9,A01,083615,Shannon; Kyle Michael,7,0,75,68
1657062932058,COGS 11,A01,083617,Boyle; Mary E. T.,20,0,48,28
1657062938079,COGS 13,A01,083071,Bastos; Amalia Pinkusfeld,9,0,71,62
1657062944108,COGS 14A,A01,092681,Semenuks; Arturs,0,1,100,100
1657062950133,COGS 14B,A01,083073,Cheng; Tzu-Han,5,0,63,58
1657062956158,COGS 17,A01,092677,Semenuks; Arturs,4,0,81,77
1657062962187,COGS 100,A01,083619,Allen; Michael Gordon,15,0,70,55
1657062968215,COGS 101A,A01,083621,Davis; Joshua Daniel,9,0,68,59
1657062974245,COGS 101B,A01,091572,Allen; Michael Gordon,8,0,65,57
1657062980273,COGS 101C,A01,083625,Delgado; Tania,17,0,35,18
1657062986302,COGS 107A,A01,083627,Boyle; Mary E. T.,13,0,60,47
1657062992330,COGS 118A,A01,083075,Gupta; Anjum,15,0,76,61
1657062998482,CSE 3,A50,083646,Miranda; Gregory Joseph,22,0,50,28
1657063004505,CSE 8A,A50,083650,Miranda; Gregory Joseph,17,1,56,39
1657063010531,CSE 11,A01,083080,Cao; Yingjun,4,15,40,36
1657063016554,CSE 12,A01,083652,Krause-Levy; Sophia Louisa,23,1,120,97
1657063022576,CSE 15L,A01,083654,Morris; Justin Loren,8,0,50,42
1657063022576,CSE 15L,A02,083655,Morris; Justin Loren,9,0,50,41
1657063028599,CSE 20,A01,083657,Tran; Khoa Dang,37,0,80,43
1657063034625,CSE 21,A01,095574,Bach; Quang Tran,21,0,48,27
1657063040654,CSE 30,A01,083084,Eldon; John,4,0,80,76
1657063040654,CSE 30,B01,095061,Bhaskar; Nishant,6,0,50,44
1657063046688,CSE 100,A01,083659,Cao; Yingjun,3,4,70,67
1657063052711,CSE 134B,A01,083661,Powell; Thomas Allan,19,0,100,81
1657063058737,CSE 140,A01,083663,Gungor; Onat,14,0,85,71
1657063064775,CSE 140L,A01,083088,Eldon; John,16,0,100,84
1657063070801,CSE 175,A01,083665,Kumar; Rakesh,3,0,25,22
1657063076829,CSE 190,A00,092507,Dubnov; Shlomo,7,0,20,13
1657063082863,ECE 45,A01,083139,Congero; Spencer William,5,0,75,70
1657063088893,ECE 65,A50,083695,Saad; Andrew S,12,0,30,18
1657063088893,ECE 65,A51,095125,Saad; Andrew S,25,0,26,1
1657063094915,ECE 109,A01,091882,Touri; Behrouz,16,0,70,54
1657063100942,ECE 180,A00,083140,Abi Samra; Nicholas Camill,1,0,30,29
1657063100942,ECE 180,B00,083141,Abi Samra; Nicholas Camill,0,0,30,30
1657063106969,MATH 10A,A01,083735,Patchell; Gregory David,1,0,30,29
1657063106969,MATH 10A,A02,083736,Patchell; Gregory David,20,0,30,10
1657063106969,MATH 10A,A03,083737,Patchell; Gregory David,16,0,30,14
1657063113000,MATH 10B,A01,083207,Lim; Seonhee,7,0,34,27
1657063113000,MATH 10B,A02,083208,Lim; Seonhee,9,0,35,26
1657063113000,MATH 10B,A03,093472,Lim; Seonhee,4,0,34,30
1657063113000,MATH 10B,B01,083739,Sinha; Shubham,9,0,30,21
1657063119031,MATH 18,A01,083743,Cinel; Cameron Alexander,6,0,30,24
1657063119031,MATH 18,A02,083744,Cinel; Cameron Alexander,15,0,30,15
1657063119031,MATH 18,A03,083745,Cinel; Cameron Alexander,8,0,30,22
1657063119031,MATH 18,B01,083748,Rideout; David Porter,4,0,37,33
1657063119031,MATH 18,B02,083749,Rideout; David Porter,3,0,36,33
1657063119031,MATH 18,B03,083750,Rideout; David Porter,2,0,37,35
1657063119031,MATH 18,B04,083751,Rideout; David Porter,5,0,36,31
1657063119031,MATH 18,B05,093473,Rideout; David Porter,4,0,36,32
1657063119031,MATH 18,B06,093474,Rideout; David Porter,5,0,36,31
1657063125060,MATH 20A,A01,083754,Zheng; Zequn,12,0,40,28
1657063131083,MATH 20B,A01,083756,Briones; Jor-el Thomas Caparas,1,0,36,35
1657063131083,MATH 20B,A02,083757,Briones; Jor-el Thomas Caparas,1,0,36,35
1657063131083,MATH 20B,A03,093475,Briones; Jor-el Thomas Caparas,0,0,36,36
1657063137105,MATH 20C,A01,083760,Briones; Jor-el Thomas Caparas,1,0,35,34
1657063137105,MATH 20C,A02,083761,Briones; Jor-el Thomas Caparas,8,0,35,27
1657063137105,MATH 20C,A03,093476,Briones; Jor-el Thomas Caparas,0,1,36,36
1657063137105,MATH 20C,B01,083762,Bach; Quang Tran,0,0,30,30
1657063143131,MATH 20D,A01,083765,Tran; Brian Kha,4,0,30,26
1657063143131,MATH 20D,A02,083766,Tran; Brian Kha,5,0,30,25
1657063143131,MATH 20D,A03,083767,Tran; Brian Kha,3,0,30,27
1657063149172,MATH 20E,A01,083771,Ganguly; Soumya,5,0,32,27
1657063149172,MATH 20E,A02,083772,Ganguly; Soumya,6,0,32,26
1657063149172,MATH 20E,B01,083773,Ciotti; Benjamin,18,0,35,17
1657063149172,MATH 20E,B02,083774,Ciotti; Benjamin,17,0,35,18
1657063155195,MATH 103A,A01,083777,Greenfeld; Be'Eri,2,0,36,34
1657063155195,MATH 103A,A02,083778,Greenfeld; Be'Eri,5,0,36,31
1657063155195,MATH 103A,A03,093561,Greenfeld; Be'Eri,4,0,36,32
1657063155195,MATH 103A,B01,083779,Greenfeld; Be'Eri,6,0,36,30
1657063155195,MATH 103A,B02,083780,Greenfeld; Be'Eri,2,0,36,34
1657063155195,MATH 103A,B03,093562,Greenfeld; Be'Eri,3,0,36,33
1657063161219,MATH 105,A01,085443,Carter; Anne Toulson,14,0,35,21
1657063161219,MATH 105,A02,093477,Carter; Anne Toulson,20,0,35,15
1657063167247,MATH 109,A01,083213,Ganzberger; Geoffrey Michael,2,0,34,32
1657063167247,MATH 109,A02,083214,Ganzberger; Geoffrey Michael,2,0,34,32
1657063167247,MATH 109,A03,093478,Ganzberger; Geoffrey Michael,1,0,34,33
1657063167247,MATH 109,B01,083215,Ganzberger; Geoffrey Michael,1,0,32,31
1657063167247,MATH 109,B02,083216,Ganzberger; Geoffrey Michael,1,0,32,31
1657063167247,MATH 109,B03,093479,Ganzberger; Geoffrey Michael,6,0,32,26
1657063173276,MATH 142A,A01,083219,Chow; Bennett,6,0,32,26
1657063173276,MATH 142A,A02,083220,Chow; Bennett,10,0,32,22
1657063173276,MATH 142A,A03,093480,Chow; Bennett,7,0,32,25
1657063173276,MATH 142A,B03,093481,Chow; Bennett,7,0,32,25
1657063173276,MATH 142A,B04,093558,Chow; Bennett,11,0,32,21
1657063173276,MATH 142A,B05,093559,Chow; Bennett,6,0,32,26
1657063179301,MATH 193A,A01,083224,Rotar; Vladimir,7,0,34,27
1657063179301,MATH 193A,A02,083225,Rotar; Vladimir,5,0,34,29
1657063179301,MATH 193A,A03,083781,Rotar; Vladimir,1,0,34,33
1657063179301,MATH 193A,A04,083782,Rotar; Vladimir,6,0,34,28
1657063179301,MATH 193A,A05,093482,Rotar; Vladimir,6,0,34,28
1657063185332,MATH 197,001,091859,McAuley; Julian John,9999,0,9999,0
1657063185332,MATH 197,002,095566,Kedlaya; Kiran S.,9997,0,9999,2
1657063185332,MATH 197,003,095567,Xiao; Ming,9999,0,9999,0
1657063185332,MATH 197,004,095571,Perols; Johan Lars,9998,0,9999,1
1657063192395,COGS 9,A01,083615,Shannon; Kyle Michael,7,0,75,68
1657063198422,COGS 11,A01,083617,Boyle; Mary E. T.,21,0,48,27
1657063204450,COGS 13,A01,083071,Bastos; Amalia Pinkusfeld,9,0,71,62
1657063210481,COGS 14A,A01,092681,Semenuks; Arturs,0,1,100,100
1657063216504,COGS 14B,A01,083073,Cheng; Tzu-Han,5,0,63,58
1657063222542,COGS 17,A01,092677,Semenuks; Arturs,4,0,81,77
1657063228570,COGS 100,A01,083619,Allen; Michael Gordon,15,0,70,55
1657063234593,COGS 101A,A01,083621,Davis; Joshua Daniel,9,0,68,59
1657063240617,COGS 101B,A01,091572,Allen; Michael Gordon,8,0,65,57
1657063246643,COGS 101C,A01,083625,Delgado; Tania,17,0,35,18
1657063252674,COGS 107A,A01,083627,Boyle; Mary E. T.,13,0,60,47
1657063258700,COGS 118A,A01,083075,Gupta; Anjum,15,0,76,61
1657063264725,CSE 3,A50,083646,Miranda; Gregory Joseph,22,0,50,28
1657063270749,CSE 8A,A50,083650,Miranda; Gregory Joseph,17,1,56,39
1657063276773,CSE 11,A01,083080,Cao; Yingjun,4,15,40,36
1657063282801,CSE 12,A01,083652,Krause-Levy; Sophia Louisa,23,1,120,97
1657063288823,CSE 15L,A01,083654,Morris; Justin Loren,8,0,50,42
1657063288823,CSE 15L,A02,083655,Morris; Justin Loren,9,0,50,41
1657063294848,CSE 20,A01,083657,Tran; Khoa Dang,37,0,80,43
1657063300874,CSE 21,A01,095574,Bach; Quang Tran,21,0,48,27
1657063306902,CSE 30,A01,083084,Eldon; John,4,0,80,76
1657063306902,CSE 30,B01,095061,Bhaskar; Nishant,6,0,50,44
1657063312927,CSE 100,A01,083659,Cao; Yingjun,3,4,70,67
1657063318952,CSE 134B,A01,083661,Powell; Thomas Allan,19,0,100,81
1657063324980,CSE 140,A01,083663,Gungor; Onat,14,0,85,71
1657063331003,CSE 140L,A01,083088,Eldon; John,16,0,100,84
1657063337027,CSE 175,A01,083665,Kumar; Rakesh,3,0,25,22
1657063343051,CSE 190,A00,092507,Dubnov; Shlomo,7,0,20,13
1657063349084,ECE 45,A01,083139,Congero; Spencer William,5,0,75,70
1657063355113,ECE 65,A50,083695,Saad; Andrew S,12,0,30,18
1657063355113,ECE 65,A51,095125,Saad; Andrew S,25,0,26,1
1657063361146,ECE 109,A01,091882,Touri; Behrouz,16,0,70,54
1657063367169,ECE 180,A00,083140,Abi Samra; Nicholas Camill,1,0,30,29
1657063367169,ECE 180,B00,083141,Abi Samra; Nicholas Camill,0,0,30,30
1657063373193,MATH 10A,A01,083735,Patchell; Gregory David,1,0,30,29
1657063373193,MATH 10A,A02,083736,Patchell; Gregory David,20,0,30,10
1657063373193,MATH 10A,A03,083737,Patchell; Gregory David,16,0,30,14
1657063379230,MATH 10B,A01,083207,Lim; Seonhee,7,0,34,27
1657063379230,MATH 10B,A02,083208,Lim; Seonhee,9,0,35,26
1657063379230,MATH 10B,A03,093472,Lim; Seonhee,4,0,34,30
1657063379230,MATH 10B,B01,083739,Sinha; Shubham,9,0,30,21
1657063385255,MATH 18,A01,083743,Cinel; Cameron Alexander,6,0,30,24
1657063385255,MATH 18,A02,083744,Cinel; Cameron Alexander,15,0,30,15
1657063385255,MATH 18,A03,083745,Cinel; Cameron Alexander,8,0,30,22
1657063385255,MATH 18,B01,083748,Rideout; David Porter,4,0,37,33
1657063385255,MATH 18,B02,083749,Rideout; David Porter,3,0,36,33
1657063385255,MATH 18,B03,083750,Rideout; David Porter,2,0,37,35
1657063385255,MATH 18,B04,083751,Rideout; David Porter,5,0,36,31
1657063385255,MATH 18,B05,093473,Rideout; David Porter,4,0,36,32
1657063385255,MATH 18,B06,093474,Rideout; David Porter,5,0,36,31
1657063391278,MATH 20A,A01,083754,Zheng; Zequn,12,0,40,28
1657063397305,MATH 20B,A01,083756,Briones; Jor-el Thomas Caparas,1,0,36,35
1657063397305,MATH 20B,A02,083757,Briones; Jor-el Thomas Caparas,1,0,36,35
1657063397305,MATH 20B,A03,093475,Briones; Jor-el Thomas Caparas,0,0,36,36
1657063403329,MATH 20C,A01,083760,Briones; Jor-el Thomas Caparas,1,0,35,34
1657063403329,MATH 20C,A02,083761,Briones; Jor-el Thomas Caparas,8,0,35,27
1657063403329,MATH 20C,A03,093476,Briones; Jor-el Thomas Caparas,0,1,36,36
1657063403329,MATH 20C,B01,083762,Bach; Quang Tran,0,0,30,30
1657063409366,MATH 20D,A01,083765,Tran; Brian Kha,4,0,30,26
1657063409366,MATH 20D,A02,083766,Tran; Brian Kha,5,0,30,25
1657063409366,MATH 20D,A03,083767,Tran; Brian Kha,3,0,30,27
1657063415392,MATH 20E,A01,083771,Ganguly; Soumya,5,0,32,27
1657063415392,MATH 20E,A02,083772,Ganguly; Soumya,6,0,32,26
1657063415392,MATH 20E,B01,083773,Ciotti; Benjamin,18,0,35,17
1657063415392,MATH 20E,B02,083774,Ciotti; Benjamin,17,0,35,18
1657063421418,MATH 103A,A01,083777,Greenfeld; Be'Eri,2,0,36,34
1657063421418,MATH 103A,A02,083778,Greenfeld; Be'Eri,5,0,36,31
1657063421418,MATH 103A,A03,093561,Greenfeld; Be'Eri,4,0,36,32
1657063421418,MATH 103A,B01,083779,Greenfeld; Be'Eri,6,0,36,30
1657063421418,MATH 103A,B02,083780,Greenfeld; Be'Eri,2,0,36,34
1657063421418,MATH 103A,B03,093562,Greenfeld; Be'Eri,3,0,36,33
1657063427441,MATH 105,A01,085443,Carter; Anne Toulson,14,0,35,21
1657063427441,MATH 105,A02,093477,Carter; Anne Toulson,20,0,35,15
1657063433470,MATH 109,A01,083213,Ganzberger; Geoffrey Michael,2,0,34,32
1657063433470,MATH 109,A02,083214,Ganzberger; Geoffrey Michael,2,0,34,32
1657063433470,MATH 109,A03,093478,Ganzberger; Geoffrey Michael,1,0,34,33
1657063433470,MATH 109,B01,083215,Ganzberger; Geoffrey Michael,1,0,32,31
1657063433470,MATH 109,B02,083216,Ganzberger; Geoffrey Michael,1,0,32,31
1657063433470,MATH 109,B03,093479,Ganzberger; Geoffrey Michael,6,0,32,26
1657063439494,MATH 142A,A01,083219,Chow; Bennett,6,0,32,26
1657063439494,MATH 142A,A02,083220,Chow; Bennett,10,0,32,22
1657063439494,MATH 142A,A03,093480,Chow; Bennett,7,0,32,25
1657063439494,MATH 142A,B03,093481,Chow; Bennett,7,0,32,25
1657063439494,MATH 142A,B04,093558,Chow; Bennett,11,0,32,21
1657063439494,MATH 142A,B05,093559,Chow; Bennett,6,0,32,26
1657063445523,MATH 193A,A01,083224,Rotar; Vladimir,7,0,34,27
1657063445523,MATH 193A,A02,083225,Rotar; Vladimir,5,0,34,29
1657063445523,MATH 193A,A03,083781,Rotar; Vladimir,1,0,34,33
1657063445523,MATH 193A,A04,083782,Rotar; Vladimir,6,0,34,28
1657063445523,MATH 193A,A05,093482,Rotar; Vladimir,6,0,34,28
1657063451548,MATH 197,001,091859,McAuley; Julian John,9999,0,9999,0
1657063451548,MATH 197,002,095566,Kedlaya; Kiran S.,9997,0,9999,2
1657063451548,MATH 197,003,095567,Xiao; Ming,9999,0,9999,0
1657063451548,MATH 197,004,095571,Perols; Johan Lars,9998,0,9999,1
1657063458611,COGS 9,A01,083615,Shannon; Kyle Michael,7,0,75,68
1657063464633,COGS 11,A01,083617,Boyle; Mary E. T.,21,0,48,27
1657063470667,COGS 13,A01,083071,Bastos; Amalia Pinkusfeld,9,0,71,62
1657063476693,COGS 14A,A01,092681,Semenuks; Arturs,0,1,100,100
1657063482717,COGS 14B,A01,083073,Cheng; Tzu-Han,5,0,63,58
1657063488740,COGS 17,A01,092677,Semenuks; Arturs,4,0,81,77
1657063494762,COGS 100,A01,083619,Allen; Michael Gordon,15,0,70,55
1657063500785,COGS 101A,A01,083621,Davis; Joshua Daniel,9,0,68,59
1657063506808,COGS 101B,A01,091572,Allen; Michael Gordon,8,0,65,57
1657063512845,COGS 101C,A01,083625,Delgado; Tania,17,0,35,18
1657063518870,COGS 107A,A01,083627,Boyle; Mary E. T.,13,0,60,47
1657063524897,COGS 118A,A01,083075,Gupta; Anjum,15,0,76,61
1657063530921,CSE 3,A50,083646,Miranda; Gregory Joseph,22,0,50,28
1657063536948,CSE 8A,A50,083650,Miranda; Gregory Joseph,17,1,56,39
1657063542977,CSE 11,A01,083080,Cao; Yingjun,4,15,40,36
1657063549007,CSE 12,A01,083652,Krause-Levy; Sophia Louisa,23,1,120,97
1657063555035,CSE 15L,A01,083654,Morris; Justin Loren,8,0,50,42
1657063555035,CSE 15L,A02,083655,Morris; Justin Loren,9,0,50,41
1657063561060,CSE 20,A01,083657,Tran; Khoa Dang,37,0,80,43
1657063567087,CSE 21,A01,095574,Bach; Quang Tran,21,0,48,27
1657063573111,CSE 30,A01,083084,Eldon; John,4,0,80,76
1657063573111,CSE 30,B01,095061,Bhaskar; Nishant,6,0,50,44
1657063579139,CSE 100,A01,083659,Cao; Yingjun,3,4,70,67
1657063585163,CSE 134B,A01,083661,Powell; Thomas Allan,19,0,100,81
1657063591186,CSE 140,A01,083663,Gungor; Onat,14,0,85,71
1657063597286,CSE 140L,A01,083088,Eldon; John,16,0,100,84
1657063603311,CSE 175,A01,083665,Kumar; Rakesh,3,0,25,22
1657063609337,CSE 190,A00,092507,Dubnov; Shlomo,7,0,20,13
1657063615364,ECE 45,A01,083139,Congero; Spencer William,5,0,75,70
1657063621389,ECE 65,A50,083695,Saad; Andrew S,12,0,30,18
1657063621389,ECE 65,A51,095125,Saad; Andrew S,25,0,26,1
1657063627413,ECE 109,A01,091882,Touri; Behrouz,16,0,70,54
1657063633445,ECE 180,A00,083140,Abi Samra; Nicholas Camill,1,0,30,29
1657063633445,ECE 180,B00,083141,Abi Samra; Nicholas Camill,0,0,30,30
1657063639475,MATH 10A,A01,083735,Patchell; Gregory David,1,0,30,29
1657063639475,MATH 10A,A02,083736,Patchell; Gregory David,20,0,30,10
1657063639475,MATH 10A,A03,083737,Patchell; Gregory David,16,0,30,14
1657063645503,MATH 10B,A01,083207,Lim; Seonhee,7,0,34,27
1657063645503,MATH 10B,A02,083208,Lim; Seonhee,9,0,35,26
1657063645503,MATH 10B,A03,093472,Lim; Seonhee,4,0,34,30
1657063645503,MATH 10B,B01,083739,Sinha; Shubham,9,0,30,21
1657063651529,MATH 18,A01,083743,Cinel; Cameron Alexander,6,0,30,24
1657063651529,MATH 18,A02,083744,Cinel; Cameron Alexander,15,0,30,15
1657063651529,MATH 18,A03,083745,Cinel; Cameron Alexander,8,0,30,22
1657063651529,MATH 18,B01,083748,Rideout; David Porter,4,0,37,33
1657063651529,MATH 18,B02,083749,Rideout; David Porter,3,0,36,33
1657063651529,MATH 18,B03,083750,Rideout; David Porter,2,0,37,35
1657063651529,MATH 18,B04,083751,Rideout; David Porter,5,0,36,31
1657063651529,MATH 18,B05,093473,Rideout; David Porter,4,0,36,32
1657063651529,MATH 18,B06,093474,Rideout; David Porter,5,0,36,31
1657063657552,MATH 20A,A01,083754,Zheng; Zequn,12,0,40,28
1657063663575,MATH 20B,A01,083756,Briones; Jor-el Thomas Caparas,1,0,36,35
1657063663575,MATH 20B,A02,083757,Briones; Jor-el Thomas Caparas,1,0,36,35
1657063663575,MATH 20B,A03,093475,Briones; Jor-el Thomas Caparas,0,0,36,36
1657063669599,MATH 20C,A01,083760,Briones; Jor-el Thomas Caparas,1,0,35,34
1657063669599,MATH 20C,A02,083761,Briones; Jor-el Thomas Caparas,8,0,35,27
1657063669599,MATH 20C,A03,093476,Briones; Jor-el Thomas Caparas,0,1,36,36
1657063669599,MATH 20C,B01,083762,Bach; Quang Tran,0,0,30,30
1657063675622,MATH 20D,A01,083765,Tran; Brian Kha,4,0,30,26
1657063675622,MATH 20D,A02,083766,Tran; Brian Kha,5,0,30,25
1657063675622,MATH 20D,A03,083767,Tran; Brian Kha,3,0,30,27
1657063681651,MATH 20E,A01,083771,Ganguly; Soumya,5,0,32,27
1657063681651,MATH 20E,A02,083772,Ganguly; Soumya,6,0,32,26
1657063681651,MATH 20E,B01,083773,Ciotti; Benjamin,18,0,35,17
1657063681651,MATH 20E,B02,083774,Ciotti; Benjamin,17,0,35,18
1657063687676,MATH 103A,A01,083777,Greenfeld; Be'Eri,2,0,36,34
1657063687676,MATH 103A,A02,083778,Greenfeld; Be'Eri,5,0,36,31
1657063687676,MATH 103A,A03,093561,Greenfeld; Be'Eri,4,0,36,32
1657063687676,MATH 103A,B01,083779,Greenfeld; Be'Eri,6,0,36,30
1657063687676,MATH 103A,B02,083780,Greenfeld; Be'Eri,2,0,36,34
1657063687676,MATH 103A,B03,093562,Greenfeld; Be'Eri,3,0,36,33
1657063693707,MATH 105,A01,085443,Carter; Anne Toulson,14,0,35,21
1657063693707,MATH 105,A02,093477,Carter; Anne Toulson,20,0,35,15
1657063699741,MATH 109,A01,083213,Ganzberger; Geoffrey Michael,2,0,34,32
1657063699741,MATH 109,A02,083214,Ganzberger; Geoffrey Michael,2,0,34,32
1657063699741,MATH 109,A03,093478,Ganzberger; Geoffrey Michael,1,0,34,33
1657063699741,MATH 109,B01,083215,Ganzberger; Geoffrey Michael,1,0,32,31
1657063699741,MATH 109,B02,083216,Ganzberger; Geoffrey Michael,1,0,32,31
1657063699741,MATH 109,B03,093479,Ganzberger; Geoffrey Michael,6,0,32,26
1657063705763,MATH 142A,A01,083219,Chow; Bennett,6,0,32,26
1657063705763,MATH 142A,A02,083220,Chow; Bennett,10,0,32,22
1657063705763,MATH 142A,A03,093480,Chow; Bennett,7,0,32,25
1657063705763,MATH 142A,B03,093481,Chow; Bennett,7,0,32,25
1657063705763,MATH 142A,B04,093558,Chow; Bennett,11,0,32,21
1657063705763,MATH 142A,B05,093559,Chow; Bennett,6,0,32,26
1657063711792,MATH 193A,A01,083224,Rotar; Vladimir,7,0,34,27
1657063711792,MATH 193A,A02,083225,Rotar; Vladimir,5,0,34,29
1657063711792,MATH 193A,A03,083781,Rotar; Vladimir,1,0,34,33
1657063711792,MATH 193A,A04,083782,Rotar; Vladimir,6,0,34,28
1657063711792,MATH 193A,A05,093482,Rotar; Vladimir,6,0,34,28
1657063717813,MATH 197,001,091859,McAuley; Julian John,9999,0,9999,0
1657063717813,MATH 197,002,095566,Kedlaya; Kiran S.,9997,0,9999,2
1657063717813,MATH 197,003,095567,Xiao; Ming,9999,0,9999,0
1657063717813,MATH 197,004,095571,Perols; Johan Lars,9998,0,9999,1
1657063724932,COGS 9,A01,083615,Shannon; Kyle Michael,7,0,75,68
1657063730966,COGS 11,A01,083617,Boyle; Mary E. T.,21,0,48,27
1657063736990,COGS 13,A01,083071,Bastos; Amalia Pinkusfeld,9,0,71,62
1657063743017,COGS 14A,A01,092681,Semenuks; Arturs,0,1,100,100
1657063749045,COGS 14B,A01,083073,Cheng; Tzu-Han,5,0,63,58
1657063755068,COGS 17,A01,092677,Semenuks; Arturs,4,0,81,77
1657063761090,COGS 100,A01,083619,Allen; Michael Gordon,15,0,70,55
1657063767119,COGS 101A,A01,083621,Davis; Joshua Daniel,9,0,68,59
1657063773150,COGS 101B,A01,091572,Allen; Michael Gordon,8,0,65,57
1657063779188,COGS 101C,A01,083625,Delgado; Tania,17,0,35,18
1657063785210,COGS 107A,A01,083627,Boyle; Mary E. T.,13,0,60,47
1657063791231,COGS 118A,A01,083075,Gupta; Anjum,15,0,76,61
1657063797259,CSE 3,A50,083646,Miranda; Gregory Joseph,22,0,50,28
1657063803286,CSE 8A,A50,083650,Miranda; Gregory Joseph,17,1,56,39
1657063809312,CSE 11,A01,083080,Cao; Yingjun,4,15,40,36
1657063815336,CSE 12,A01,083652,Krause-Levy; Sophia Louisa,23,1,120,97
1657063821360,CSE 15L,A01,083654,Morris; Justin Loren,8,0,50,42
1657063821360,CSE 15L,A02,083655,Morris; Justin Loren,9,0,50,41
1657063827388,CSE 20,A01,083657,Tran; Khoa Dang,37,0,80,43
1657063833410,CSE 21,A01,095574,Bach; Quang Tran,21,0,48,27
1657063839434,CSE 30,A01,083084,Eldon; John,4,0,80,76
1657063839434,CSE 30,B01,095061,Bhaskar; Nishant,6,0,50,44
1657063845467,CSE 100,A01,083659,Cao; Yingjun,3,4,70,67
1657063851490,CSE 134B,A01,083661,Powell; Thomas Allan,19,0,100,81
1657063857516,CSE 140,A01,083663,Gungor; Onat,14,0,85,71
1657063863551,CSE 140L,A01,083088,Eldon; John,16,0,100,84
1657063869586,CSE 175,A01,083665,Kumar; Rakesh,3,0,25,22
1657063875609,CSE 190,A00,092507,Dubnov; Shlomo,7,0,20,13
1657063881633,ECE 45,A01,083139,Congero; Spencer William,5,0,75,70
1657063887670,ECE 65,A50,083695,Saad; Andrew S,12,0,30,18
1657063887670,ECE 65,A51,095125,Saad; Andrew S,25,0,26,1
1657063893699,ECE 109,A01,091882,Touri; Behrouz,16,0,70,54
1657063899726,ECE 180,A00,083140,Abi Samra; Nicholas Camill,1,0,30,29
1657063899726,ECE 180,B00,083141,Abi Samra; Nicholas Camill,0,0,30,30
1657063905755,MATH 10A,A01,083735,Patchell; Gregory David,1,0,30,29
1657063905755,MATH 10A,A02,083736,Patchell; Gregory David,20,0,30,10
1657063905755,MATH 10A,A03,083737,Patchell; Gregory David,16,0,30,14
1657063911783,MATH 10B,A01,083207,Lim; Seonhee,7,0,34,27
1657063911783,MATH 10B,A02,083208,Lim; Seonhee,9,0,35,26
1657063911783,MATH 10B,A03,093472,Lim; Seonhee,4,0,34,30
1657063911783,MATH 10B,B01,083739,Sinha; Shubham,9,0,30,21
1657063917808,MATH 18,A01,083743,Cinel; Cameron Alexander,6,0,30,24
1657063917808,MATH 18,A02,083744,Cinel; Cameron Alexander,15,0,30,15
1657063917808,MATH 18,A03,083745,Cinel; Cameron Alexander,8,0,30,22
1657063917808,MATH 18,B01,083748,Rideout; David Porter,4,0,37,33
1657063917808,MATH 18,B02,083749,Rideout; David Porter,3,0,36,33
1657063917808,MATH 18,B03,083750,Rideout; David Porter,2,0,37,35
1657063917808,MATH 18,B04,083751,Rideout; David Porter,5,0,36,31
1657063917808,MATH 18,B05,093473,Rideout; David Porter,4,0,36,32
1657063917808,MATH 18,B06,093474,Rideout; David Porter,5,0,36,31
1657063923840,MATH 20A,A01,083754,Zheng; Zequn,12,0,40,28
1657063929868,MATH 20B,A01,083756,Briones; Jor-el Thomas Caparas,1,0,36,35
1657063929868,MATH 20B,A02,083757,Briones; Jor-el Thomas Caparas,1,0,36,35
1657063929868,MATH 20B,A03,093475,Briones; Jor-el Thomas Caparas,0,0,36,36
1657063935899,MATH 20C,A01,083760,Briones; Jor-el Thomas Caparas,1,0,35,34
1657063935899,MATH 20C,A02,083761,Briones; Jor-el Thomas Caparas,8,0,35,27
1657063935899,MATH 20C,A03,093476,Briones; Jor-el Thomas Caparas,0,1,36,36
1657063935899,MATH 20C,B01,083762,Bach; Quang Tran,0,0,30,30
1657063941933,MATH 20D,A01,083765,Tran; Brian Kha,4,0,30,26
1657063941933,MATH 20D,A02,083766,Tran; Brian Kha,5,0,30,25
1657063941933,MATH 20D,A03,083767,Tran; Brian Kha,3,0,30,27
1657063947958,MATH 20E,A01,083771,Ganguly; Soumya,5,0,32,27
1657063947958,MATH 20E,A02,083772,Ganguly; Soumya,6,0,32,26
1657063947958,MATH 20E,B01,083773,Ciotti; Benjamin,18,0,35,17
1657063947958,MATH 20E,B02,083774,Ciotti; Benjamin,17,0,35,18
1657063953988,MATH 103A,A01,083777,Greenfeld; Be'Eri,2,0,36,34
1657063953988,MATH 103A,A02,083778,Greenfeld; Be'Eri,5,0,36,31
1657063953988,MATH 103A,A03,093561,Greenfeld; Be'Eri,4,0,36,32
1657063953988,MATH 103A,B01,083779,Greenfeld; Be'Eri,6,0,36,30
1657063953988,MATH 103A,B02,083780,Greenfeld; Be'Eri,2,0,36,34
1657063953988,MATH 103A,B03,093562,Greenfeld; Be'Eri,3,0,36,33
1657063960016,MATH 105,A01,085443,Carter; Anne Toulson,14,0,35,21
1657063960016,MATH 105,A02,093477,Carter; Anne Toulson,20,0,35,15
1657063966047,MATH 109,A01,083213,Ganzberger; Geoffrey Michael,2,0,34,32
1657063966047,MATH 109,A02,083214,Ganzberger; Geoffrey Michael,2,0,34,32
1657063966047,MATH 109,A03,093478,Ganzberger; Geoffrey Michael,1,0,34,33
1657063966047,MATH 109,B01,083215,Ganzberger; Geoffrey Michael,1,0,32,31
1657063966047,MATH 109,B02,083216,Ganzberger; Geoffrey Michael,1,0,32,31
1657063966047,MATH 109,B03,093479,Ganzberger; Geoffrey Michael,6,0,32,26
1657063972077,MATH 142A,A01,083219,Chow; Bennett,6,0,32,26
1657063972077,MATH 142A,A02,083220,Chow; Bennett,10,0,32,22
1657063972077,MATH 142A,A03,093480,Chow; Bennett,7,0,32,25
1657063972077,MATH 142A,B03,093481,Chow; Bennett,7,0,32,25
1657063972077,MATH 142A,B04,093558,Chow; Bennett,11,0,32,21
1657063972077,MATH 142A,B05,093559,Chow; Bennett,6,0,32,26
1657063978102,MATH 193A,A01,083224,Rotar; Vladimir,7,0,34,27
1657063978102,MATH 193A,A02,083225,Rotar; Vladimir,5,0,34,29
1657063978102,MATH 193A,A03,083781,Rotar; Vladimir,1,0,34,33
1657063978102,MATH 193A,A04,083782,Rotar; Vladimir,6,0,34,28
1657063978102,MATH 193A,A05,093482,Rotar; Vladimir,6,0,34,28
1657063984126,MATH 197,001,091859,McAuley; Julian John,9999,0,9999,0
1657063984126,MATH 197,002,095566,Kedlaya; Kiran S.,9997,0,9999,2
1657063984126,MATH 197,003,095567,Xiao; Ming,9999,0,9999,0
1657063984126,MATH 197,004,095571,Perols; Johan Lars,9998,0,9999,1
1657063991194,COGS 9,A01,083615,Shannon; Kyle Michael,7,0,75,68
1657063997230,COGS 11,A01,083617,Boyle; Mary E. T.,21,0,48,27
1657064003253,COGS 13,A01,083071,Bastos; Amalia Pinkusfeld,9,0,71,62
1657064009284,COGS 14A,A01,092681,Semenuks; Arturs,0,1,100,100
1657064015316,COGS 14B,A01,083073,Cheng; Tzu-Han,5,0,63,58
1657064021341,COGS 17,A01,092677,Semenuks; Arturs,4,0,81,77
1657064027368,COGS 100,A01,083619,Allen; Michael Gordon,15,0,70,55
1657064033394,COGS 101A,A01,083621,Davis; Joshua Daniel,9,0,68,59
1657064039420,COGS 101B,A01,091572,Allen; Michael Gordon,8,0,65,57
1657064045442,COGS 101C,A01,083625,Delgado; Tania,17,0,35,18
1657064051472,COGS 107A,A01,083627,Boyle; Mary E. T.,13,0,60,47
1657064057494,COGS 118A,A01,083075,Gupta; Anjum,15,0,76,61
1657064063522,CSE 3,A50,083646,Miranda; Gregory Joseph,22,0,50,28
1657064069547,CSE 8A,A50,083650,Miranda; Gregory Joseph,17,1,56,39
1657064075569,CSE 11,A01,083080,Cao; Yingjun,4,15,40,36
1657064081594,CSE 12,A01,083652,Krause-Levy; Sophia Louisa,23,1,120,97
1657064087621,CSE 15L,A01,083654,Morris; Justin Loren,8,0,50,42
1657064087621,CSE 15L,A02,083655,Morris; Justin Loren,9,0,50,41
1657064093649,CSE 20,A01,083657,Tran; Khoa Dang,37,0,80,43
1657064099675,CSE 21,A01,095574,Bach; Quang Tran,21,0,48,27
1657064105697,CSE 30,A01,083084,Eldon; John,4,0,80,76
1657064105697,CSE 30,B01,095061,Bhaskar; Nishant,6,0,50,44
1657064111724,CSE 100,A01,083659,Cao; Yingjun,3,4,70,67
1657064117752,CSE 134B,A01,083661,Powell; Thomas Allan,19,0,100,81
1657064123785,CSE 140,A01,083663,Gungor; Onat,14,0,85,71
1657064129812,CSE 140L,A01,083088,Eldon; John,16,0,100,84
1657064135840,CSE 175,A01,083665,Kumar; Rakesh,3,0,25,22
1657064141863,CSE 190,A00,092507,Dubnov; Shlomo,7,0,20,13
1657064147892,ECE 45,A01,083139,Congero; Spencer William,5,0,75,70
1657064153915,ECE 65,A50,083695,Saad; Andrew S,12,0,30,18
1657064153915,ECE 65,A51,095125,Saad; Andrew S,25,0,26,1
1657064159940,ECE 109,A01,091882,Touri; Behrouz,16,0,70,54
1657064165968,ECE 180,A00,083140,Abi Samra; Nicholas Camill,1,0,30,29
1657064165968,ECE 180,B00,083141,Abi Samra; Nicholas Camill,0,0,30,30
1657064171990,MATH 10A,A01,083735,Patchell; Gregory David,1,0,30,29
1657064171990,MATH 10A,A02,083736,Patchell; Gregory David,20,0,30,10
1657064171990,MATH 10A,A03,083737,Patchell; Gregory David,16,0,30,14
1657064178014,MATH 10B,A01,083207,Lim; Seonhee,7,0,34,27
1657064178014,MATH 10B,A02,083208,Lim; Seonhee,9,0,35,26
1657064178014,MATH 10B,A03,093472,Lim; Seonhee,4,0,34,30
1657064178014,MATH 10B,B01,083739,Sinha; Shubham,9,0,30,21
1657064184037,MATH 18,A01,083743,Cinel; Cameron Alexander,6,0,30,24
1657064184037,MATH 18,A02,083744,Cinel; Cameron Alexander,15,0,30,15
1657064184037,MATH 18,A03,083745,Cinel; Cameron Alexander,8,0,30,22
1657064184037,MATH 18,B01,083748,Rideout; David Porter,4,0,37,33
1657064184037,MATH 18,B02,083749,Rideout; David Porter,3,0,36,33
1657064184037,MATH 18,B03,083750,Rideout; David Porter,2,0,37,35
1657064184037,MATH 18,B04,083751,Rideout; David Porter,5,0,36,31
1657064184037,MATH 18,B05,093473,Rideout; David Porter,4,0,36,32
1657064184037,MATH 18,B06,093474,Rideout; David Porter,5,0,36,31
1657064190060,MATH 20A,A01,083754,Zheng; Zequn,12,0,40,28
1657064196232,MATH 20B,A01,083756,Briones; Jor-el Thomas Caparas,1,0,36,35
1657064196232,MATH 20B,A02,083757,Briones; Jor-el Thomas Caparas,1,0,36,35
1657064196232,MATH 20B,A03,093475,Briones; Jor-el Thomas Caparas,0,0,36,36
1657064202261,MATH 20C,A01,083760,Briones; Jor-el Thomas Caparas,1,0,35,34
1657064202261,MATH 20C,A02,083761,Briones; Jor-el Thomas Caparas,8,0,35,27
1657064202261,MATH 20C,A03,093476,Briones; Jor-el Thomas Caparas,0,1,36,36
1657064202261,MATH 20C,B01,083762,Bach; Quang Tran,0,0,30,30
1657064208288,MATH 20D,A01,083765,Tran; Brian Kha,4,0,30,26
1657064208288,MATH 20D,A02,083766,Tran; Brian Kha,5,0,30,25
1657064208288,MATH 20D,A03,083767,Tran; Brian Kha,3,0,30,27
1657064214322,MATH 20E,A01,083771,Ganguly; Soumya,5,0,32,27
1657064214322,MATH 20E,A02,083772,Ganguly; Soumya,6,0,32,26
1657064214322,MATH 20E,B01,083773,Ciotti; Benjamin,18,0,35,17
1657064214322,MATH 20E,B02,083774,Ciotti; Benjamin,17,0,35,18
1657064220356,MATH 103A,A01,083777,Greenfeld; Be'Eri,2,0,36,34
1657064220356,MATH 103A,A02,083778,Greenfeld; Be'Eri,5,0,36,31
1657064220356,MATH 103A,A03,093561,Greenfeld; Be'Eri,4,0,36,32
1657064220356,MATH 103A,B01,083779,Greenfeld; Be'Eri,6,0,36,30
1657064220356,MATH 103A,B02,083780,Greenfeld; Be'Eri,2,0,36,34
1657064220356,MATH 103A,B03,093562,Greenfeld; Be'Eri,3,0,36,33
1657064226398,MATH 105,A01,085443,Carter; Anne Toulson,14,0,35,21
1657064226398,MATH 105,A02,093477,Carter; Anne Toulson,20,0,35,15
1657064232421,MATH 109,A01,083213,Ganzberger; Geoffrey Michael,2,0,34,32
1657064232421,MATH 109,A02,083214,Ganzberger; Geoffrey Michael,2,0,34,32
1657064232421,MATH 109,A03,093478,Ganzberger; Geoffrey Michael,1,0,34,33
1657064232421,MATH 109,B01,083215,Ganzberger; Geoffrey Michael,1,0,32,31
1657064232421,MATH 109,B02,083216,Ganzberger; Geoffrey Michael,1,0,32,31
1657064232421,MATH 109,B03,093479,Ganzberger; Geoffrey Michael,6,0,32,26
1657064238448,MATH 142A,A01,083219,Chow; Bennett,6,0,32,26
1657064238448,MATH 142A,A02,083220,Chow; Bennett,10,0,32,22
1657064238448,MATH 142A,A03,093480,Chow; Bennett,7,0,32,25
1657064238448,MATH 142A,B03,093481,Chow; Bennett,7,0,32,25
1657064238448,MATH 142A,B04,093558,Chow; Bennett,11,0,32,21
1657064238448,MATH 142A,B05,093559,Chow; Bennett,6,0,32,26
1657064244472,MATH 193A,A01,083224,Rotar; Vladimir,7,0,34,27
1657064244472,MATH 193A,A02,083225,Rotar; Vladimir,5,0,34,29
1657064244472,MATH 193A,A03,083781,Rotar; Vladimir,1,0,34,33
1657064244472,MATH 193A,A04,083782,Rotar; Vladimir,6,0,34,28
1657064244472,MATH 193A,A05,093482,Rotar; Vladimir,6,0,34,28
1657064250497,MATH 197,001,091859,McAuley; Julian John,9999,0,9999,0
1657064250497,MATH 197,002,095566,Kedlaya; Kiran S.,9997,0,9999,2
1657064250497,MATH 197,003,095567,Xiao; Ming,9999,0,9999,0
1657064250497,MATH 197,004,095571,Perols; Johan Lars,9998,0,9999,1
1657064257559,COGS 9,A01,083615,Shannon; Kyle Michael,7,0,75,68
1657064263585,COGS 11,A01,083617,Boyle; Mary E. T.,21,0,48,27
1657064269609,COGS 13,A01,083071,Bastos; Amalia Pinkusfeld,9,0,71,62
1657064275632,COGS 14A,A01,092681,Semenuks; Arturs,0,1,100,100
1657064281657,COGS 14B,A01,083073,Cheng; Tzu-Han,5,0,63,58
1657064287680,COGS 17,A01,092677,Semenuks; Arturs,4,0,81,77
1657064293715,COGS 100,A01,083619,Allen; Michael Gordon,15,0,70,55
1657064299742,COGS 101A,A01,083621,Davis; Joshua Daniel,9,0,68,59
1657064305764,COGS 101B,A01,091572,Allen; Michael Gordon,8,0,65,57
1657064311788,COGS 101C,A01,083625,Delgado; Tania,17,0,35,18
1657064317813,COGS 107A,A01,083627,Boyle; Mary E. T.,13,0,60,47
1657064323841,COGS 118A,A01,083075,Gupta; Anjum,15,0,76,61
1657064329944,CSE 3,A50,083646,Miranda; Gregory Joseph,22,0,50,28
1657064335975,CSE 8A,A50,083650,Miranda; Gregory Joseph,17,1,56,39
1657064342001,CSE 11,A01,083080,Cao; Yingjun,4,15,40,36
1657064348025,CSE 12,A01,083652,Krause-Levy; Sophia Louisa,23,1,120,97
1657064354049,CSE 15L,A01,083654,Morris; Justin Loren,8,0,50,42
1657064354049,CSE 15L,A02,083655,Morris; Justin Loren,9,0,50,41
1657064360072,CSE 20,A01,083657,Tran; Khoa Dang,37,0,80,43
1657064366103,CSE 21,A01,095574,Bach; Quang Tran,21,0,48,27
1657064372127,CSE 30,A01,083084,Eldon; John,4,0,80,76
1657064372127,CSE 30,B01,095061,Bhaskar; Nishant,6,0,50,44
1657064378149,CSE 100,A01,083659,Cao; Yingjun,3,4,70,67
1657064384172,CSE 134B,A01,083661,Powell; Thomas Allan,19,0,100,81
1657064390195,CSE 140,A01,083663,Gungor; Onat,14,0,85,71
1657064396216,CSE 140L,A01,083088,Eldon; John,16,0,100,84
1657064402241,CSE 175,A01,083665,Kumar; Rakesh,3,0,25,22
1657064408266,CSE 190,A00,092507,Dubnov; Shlomo,7,0,20,13
1657064414288,ECE 45,A01,083139,Congero; Spencer William,5,0,75,70
1657064420316,ECE 65,A50,083695,Saad; Andrew S,12,0,30,18
1657064420316,ECE 65,A51,095125,Saad; Andrew S,25,0,26,1
1657064426341,ECE 109,A01,091882,Touri; Behrouz,16,0,70,54
1657064432369,ECE 180,A00,083140,Abi Samra; Nicholas Camill,1,0,30,29
1657064432369,ECE 180,B00,083141,Abi Samra; Nicholas Camill,0,0,30,30
1657064438404,MATH 10A,A01,083735,Patchell; Gregory David,1,0,30,29
1657064438404,MATH 10A,A02,083736,Patchell; Gregory David,20,0,30,10
1657064438404,MATH 10A,A03,083737,Patchell; Gregory David,16,0,30,14
1657064444433,MATH 10B,A01,083207,Lim; Seonhee,7,0,34,27
1657064444433,MATH 10B,A02,083208,Lim; Seonhee,9,0,35,26
1657064444433,MATH 10B,A03,093472,Lim; Seonhee,4,0,34,30
1657064444433,MATH 10B,B01,083739,Sinha; Shubham,9,0,30,21
1657064450463,MATH 18,A01,083743,Cinel; Cameron Alexander,6,0,30,24
1657064450463,MATH 18,A02,083744,Cinel; Cameron Alexander,15,0,30,15
1657064450463,MATH 18,A03,083745,Cinel; Cameron Alexander,8,0,30,22
1657064450463,MATH 18,B01,083748,Rideout; David Porter,4,0,37,33
1657064450463,MATH 18,B02,083749,Rideout; David Porter,3,0,36,33
1657064450463,MATH 18,B03,083750,Rideout; David Porter,2,0,37,35
1657064450463,MATH 18,B04,083751,Rideout; David Porter,5,0,36,31
1657064450463,MATH 18,B05,093473,Rideout; David Porter,4,0,36,32
1657064450463,MATH 18,B06,093474,Rideout; David Porter,5,0,36,31
1657064456486,MATH 20A,A01,083754,Zheng; Zequn,12,0,40,28
1657064462510,MATH 20B,A01,083756,Briones; Jor-el Thomas Caparas,1,0,36,35
1657064462510,MATH 20B,A02,083757,Briones; Jor-el Thomas Caparas,1,0,36,35
1657064462510,MATH 20B,A03,093475,Briones; Jor-el Thomas Caparas,0,0,36,36
1657064468538,MATH 20C,A01,083760,Briones; Jor-el Thomas Caparas,1,0,35,34
1657064468538,MATH 20C,A02,083761,Briones; Jor-el Thomas Caparas,8,0,35,27
1657064468538,MATH 20C,A03,093476,Briones; Jor-el Thomas Caparas,0,1,36,36
1657064468538,MATH 20C,B01,083762,Bach; Quang Tran,0,0,30,30
1657064474562,MATH 20D,A01,083765,Tran; Brian Kha,4,0,30,26
1657064474562,MATH 20D,A02,083766,Tran; Brian Kha,5,0,30,25
1657064474562,MATH 20D,A03,083767,Tran; Brian Kha,3,0,30,27
1657064480591,MATH 20E,A01,083771,Ganguly; Soumya,5,0,32,27
1657064480591,MATH 20E,A02,083772,Ganguly; Soumya,6,0,32,26
1657064480591,MATH 20E,B01,083773,Ciotti; Benjamin,18,0,35,17
1657064480591,MATH 20E,B02,083774,Ciotti; Benjamin,17,0,35,18
1657064486613,MATH 103A,A01,083777,Greenfeld; Be'Eri,2,0,36,34
1657064486613,MATH 103A,A02,083778,Greenfeld; Be'Eri,5,0,36,31
1657064486613,MATH 103A,A03,093561,Greenfeld; Be'Eri,4,0,36,32
1657064486613,MATH 103A,B01,083779,Greenfeld; Be'Eri,6,0,36,30
1657064486613,MATH 103A,B02,083780,Greenfeld; Be'Eri,2,0,36,34
1657064486613,MATH 103A,B03,093562,Greenfeld; Be'Eri,3,0,36,33
1657064492641,MATH 105,A01,085443,Carter; Anne Toulson,14,0,35,21
1657064492641,MATH 105,A02,093477,Carter; Anne Toulson,20,0,35,15
1657064498668,MATH 109,A01,083213,Ganzberger; Geoffrey Michael,2,0,34,32
1657064498668,MATH 109,A02,083214,Ganzberger; Geoffrey Michael,2,0,34,32
1657064498668,MATH 109,A03,093478,Ganzberger; Geoffrey Michael,1,0,34,33
1657064498668,MATH 109,B01,083215,Ganzberger; Geoffrey Michael,1,0,32,31
1657064498668,MATH 109,B02,083216,Ganzberger; Geoffrey Michael,1,0,32,31
1657064498668,MATH 109,B03,093479,Ganzberger; Geoffrey Michael,6,0,32,26
1657064504692,MATH 142A,A01,083219,Chow; Bennett,6,0,32,26
1657064504692,MATH 142A,A02,083220,Chow; Bennett,10,0,32,22
1657064504692,MATH 142A,A03,093480,Chow; Bennett,7,0,32,25
1657064504692,MATH 142A,B03,093481,Chow; Bennett,7,0,32,25
1657064504692,MATH 142A,B04,093558,Chow; Bennett,11,0,32,21
1657064504692,MATH 142A,B05,093559,Chow; Bennett,6,0,32,26
1657064510719,MATH 193A,A01,083224,Rotar; Vladimir,7,0,34,27
1657064510719,MATH 193A,A02,083225,Rotar; Vladimir,5,0,34,29
1657064510719,MATH 193A,A03,083781,Rotar; Vladimir,1,0,34,33
1657064510719,MATH 193A,A04,083782,Rotar; Vladimir,6,0,34,28
1657064510719,MATH 193A,A05,093482,Rotar; Vladimir,6,0,34,28
1657064516744,MATH 197,001,091859,McAuley; Julian John,9999,0,9999,0
1657064516744,MATH 197,002,095566,Kedlaya; Kiran S.,9997,0,9999,2
1657064516744,MATH 197,003,095567,Xiao; Ming,9999,0,9999,0
1657064516744,MATH 197,004,095571,Perols; Johan Lars,9998,0,9999,1
1657064523795,COGS 9,A01,083615,Shannon; Kyle Michael,7,0,75,68
1657064529822,COGS 11,A01,083617,Boyle; Mary E. T.,21,0,48,27
1657064535845,COGS 13,A01,083071,Bastos; Amalia Pinkusfeld,9,0,71,62
1657064541869,COGS 14A,A01,092681,Semenuks; Arturs,0,1,100,100
1657064547898,COGS 14B,A01,083073,Cheng; Tzu-Han,5,0,63,58
1657064553922,COGS 17,A01,092677,Semenuks; Arturs,4,0,81,77
1657064559948,COGS 100,A01,083619,Allen; Michael Gordon,15,0,70,55
1657064565971,COGS 101A,A01,083621,Davis; Joshua Daniel,9,0,68,59
1657064571993,COGS 101B,A01,091572,Allen; Michael Gordon,8,0,65,57
1657064578027,COGS 101C,A01,083625,Delgado; Tania,17,0,35,18
1657064584050,COGS 107A,A01,083627,Boyle; Mary E. T.,13,0,60,47
1657064590072,COGS 118A,A01,083075,Gupta; Anjum,15,0,76,61
1657064596093,CSE 3,A50,083646,Miranda; Gregory Joseph,22,0,50,28
1657064602121,CSE 8A,A50,083650,Miranda; Gregory Joseph,17,1,56,39
1657064608144,CSE 11,A01,083080,Cao; Yingjun,4,15,40,36
1657064614178,CSE 12,A01,083652,Krause-Levy; Sophia Louisa,23,1,120,97
1657064620204,CSE 15L,A01,083654,Morris; Justin Loren,8,0,50,42
1657064620204,CSE 15L,A02,083655,Morris; Justin Loren,9,0,50,41
1657064626226,CSE 20,A01,083657,Tran; Khoa Dang,37,0,80,43
1657064632248,CSE 21,A01,095574,Bach; Quang Tran,21,0,48,27
1657064638279,CSE 30,A01,083084,Eldon; John,4,0,80,76
1657064638279,CSE 30,B01,095061,Bhaskar; Nishant,6,0,50,44
1657064644303,CSE 100,A01,083659,Cao; Yingjun,3,4,70,67
1657064650326,CSE 134B,A01,083661,Powell; Thomas Allan,19,0,100,81
1657064656356,CSE 140,A01,083663,Gungor; Onat,14,0,85,71
1657064662381,CSE 140L,A01,083088,Eldon; John,16,0,100,84
1657064668404,CSE 175,A01,083665,Kumar; Rakesh,3,0,25,22
1657064674426,CSE 190,A00,092507,Dubnov; Shlomo,7,0,20,13
1657064680472,ECE 45,A01,083139,Congero; Spencer William,5,0,75,70
1657064686504,ECE 65,A50,083695,Saad; Andrew S,12,0,30,18
1657064686504,ECE 65,A51,095125,Saad; Andrew S,25,0,26,1
1657064692531,ECE 109,A01,091882,Touri; Behrouz,16,0,70,54
1657064698560,ECE 180,A00,083140,Abi Samra; Nicholas Camill,1,0,30,29
1657064698560,ECE 180,B00,083141,Abi Samra; Nicholas Camill,0,0,30,30
1657064704583,MATH 10A,A01,083735,Patchell; Gregory David,1,0,30,29
1657064704583,MATH 10A,A02,083736,Patchell; Gregory David,20,0,30,10
1657064704583,MATH 10A,A03,083737,Patchell; Gregory David,16,0,30,14
1657064710612,MATH 10B,A01,083207,Lim; Seonhee,7,0,34,27
1657064710612,MATH 10B,A02,083208,Lim; Seonhee,9,0,35,26
1657064710612,MATH 10B,A03,093472,Lim; Seonhee,4,0,34,30
1657064710612,MATH 10B,B01,083739,Sinha; Shubham,9,0,30,21
1657064716637,MATH 18,A01,083743,Cinel; Cameron Alexander,6,0,30,24
1657064716637,MATH 18,A02,083744,Cinel; Cameron Alexander,15,0,30,15
1657064716637,MATH 18,A03,083745,Cinel; Cameron Alexander,8,0,30,22
1657064716637,MATH 18,B01,083748,Rideout; David Porter,4,0,37,33
1657064716637,MATH 18,B02,083749,Rideout; David Porter,3,0,36,33
1657064716637,MATH 18,B03,083750,Rideout; David Porter,2,0,37,35
1657064716637,MATH 18,B04,083751,Rideout; David Porter,5,0,36,31
1657064716637,MATH 18,B05,093473,Rideout; David Porter,4,0,36,32
1657064716637,MATH 18,B06,093474,Rideout; David Porter,5,0,36,31
1657064722660,MATH 20A,A01,083754,Zheng; Zequn,12,0,40,28
1657064728683,MATH 20B,A01,083756,Briones; Jor-el Thomas Caparas,1,0,36,35
1657064728683,MATH 20B,A02,083757,Briones; Jor-el Thomas Caparas,1,0,36,35
1657064728683,MATH 20B,A03,093475,Briones; Jor-el Thomas Caparas,0,0,36,36
1657064734711,MATH 20C,A01,083760,Briones; Jor-el Thomas Caparas,1,0,35,34
1657064734711,MATH 20C,A02,083761,Briones; Jor-el Thomas Caparas,8,0,35,27
1657064734711,MATH 20C,A03,093476,Briones; Jor-el Thomas Caparas,0,1,36,36
1657064734711,MATH 20C,B01,083762,Bach; Quang Tran,0,0,30,30
1657064740744,MATH 20D,A01,083765,Tran; Brian Kha,4,0,30,26
1657064740744,MATH 20D,A02,083766,Tran; Brian Kha,5,0,30,25
1657064740744,MATH 20D,A03,083767,Tran; Brian Kha,3,0,30,27
1657064746775,MATH 20E,A01,083771,Ganguly; Soumya,5,0,32,27
1657064746775,MATH 20E,A02,083772,Ganguly; Soumya,6,0,32,26
1657064746775,MATH 20E,B01,083773,Ciotti; Benjamin,18,0,35,17
1657064746775,MATH 20E,B02,083774,Ciotti; Benjamin,17,0,35,18
1657064752798,MATH 103A,A01,083777,Greenfeld; Be'Eri,2,0,36,34
1657064752798,MATH 103A,A02,083778,Greenfeld; Be'Eri,5,0,36,31
1657064752798,MATH 103A,A03,093561,Greenfeld; Be'Eri,4,0,36,32
1657064752798,MATH 103A,B01,083779,Greenfeld; Be'Eri,6,0,36,30
1657064752798,MATH 103A,B02,083780,Greenfeld; Be'Eri,2,0,36,34
1657064752798,MATH 103A,B03,093562,Greenfeld; Be'Eri,3,0,36,33
1657064758821,MATH 105,A01,085443,Carter; Anne Toulson,14,0,35,21
1657064758821,MATH 105,A02,093477,Carter; Anne Toulson,20,0,35,15
1657064764844,MATH 109,A01,083213,Ganzberger; Geoffrey Michael,2,0,34,32
1657064764844,MATH 109,A02,083214,Ganzberger; Geoffrey Michael,2,0,34,32
1657064764844,MATH 109,A03,093478,Ganzberger; Geoffrey Michael,1,0,34,33
1657064764844,MATH 109,B01,083215,Ganzberger; Geoffrey Michael,1,0,32,31
1657064764844,MATH 109,B02,083216,Ganzberger; Geoffrey Michael,1,0,32,31
1657064764844,MATH 109,B03,093479,Ganzberger; Geoffrey Michael,6,0,32,26
1657064770868,MATH 142A,A01,083219,Chow; Bennett,6,0,32,26
1657064770868,MATH 142A,A02,083220,Chow; Bennett,10,0,32,22
1657064770868,MATH 142A,A03,093480,Chow; Bennett,7,0,32,25
1657064770868,MATH 142A,B03,093481,Chow; Bennett,7,0,32,25
1657064770868,MATH 142A,B04,093558,Chow; Bennett,11,0,32,21
1657064770868,MATH 142A,B05,093559,Chow; Bennett,6,0,32,26
1657064776895,MATH 193A,A01,083224,Rotar; Vladimir,7,0,34,27
1657064776895,MATH 193A,A02,083225,Rotar; Vladimir,5,0,34,29
1657064776895,MATH 193A,A03,083781,Rotar; Vladimir,1,0,34,33
1657064776895,MATH 193A,A04,083782,Rotar; Vladimir,6,0,34,28
1657064776895,MATH 193A,A05,093482,Rotar; Vladimir,6,0,34,28
1657064782933,MATH 197,001,091859,McAuley; Julian John,9999,0,9999,0
1657064782933,MATH 197,002,095566,Kedlaya; Kiran S.,9997,0,9999,2
1657064782933,MATH 197,003,095567,Xiao; Ming,9999,0,9999,0
1657064782933,MATH 197,004,095571,Perols; Johan Lars,9998,0,9999,1
1657064790090,COGS 9,A01,083615,Shannon; Kyle Michael,7,0,75,68
1657064796116,COGS 11,A01,083617,Boyle; Mary E. T.,21,0,48,27
1657064802148,COGS 13,A01,083071,Bastos; Amalia Pinkusfeld,9,0,71,62
1657064808175,COGS 14A,A01,092681,Semenuks; Arturs,0,1,100,100
1657064814206,COGS 14B,A01,083073,Cheng; Tzu-Han,5,0,63,58
1657064820233,COGS 17,A01,092677,Semenuks; Arturs,4,0,81,77
1657064826254,COGS 100,A01,083619,Allen; Michael Gordon,15,0,70,55
1657064832281,COGS 101A,A01,083621,Davis; Joshua Daniel,9,0,68,59
1657064838304,COGS 101B,A01,091572,Allen; Michael Gordon,8,0,65,57
1657064844331,COGS 101C,A01,083625,Delgado; Tania,17,0,35,18
1657064850370,COGS 107A,A01,083627,Boyle; Mary E. T.,13,0,60,47
1657064856406,COGS 118A,A01,083075,Gupta; Anjum,15,0,76,61
1657064862429,CSE 3,A50,083646,Miranda; Gregory Joseph,22,0,50,28
1657064868456,CSE 8A,A50,083650,Miranda; Gregory Joseph,17,1,56,39
1657064874480,CSE 11,A01,083080,Cao; Yingjun,4,15,40,36
1657064880504,CSE 12,A01,083652,Krause-Levy; Sophia Louisa,23,1,120,97
1657064886535,CSE 15L,A01,083654,Morris; Justin Loren,8,0,50,42
1657064886535,CSE 15L,A02,083655,Morris; Justin Loren,9,0,50,41
1657064892561,CSE 20,A01,083657,Tran; Khoa Dang,37,0,80,43
1657064898598,CSE 21,A01,095574,Bach; Quang Tran,21,0,48,27
1657064904622,CSE 30,A01,083084,Eldon; John,4,0,80,76
1657064904622,CSE 30,B01,095061,Bhaskar; Nishant,6,0,50,44
1657064910649,CSE 100,A01,083659,Cao; Yingjun,3,4,70,67
1657064929055,CSE 134B,A01,083661,Powell; Thomas Allan,19,0,100,81
1657064935079,CSE 140,A01,083663,Gungor; Onat,14,0,85,71
1657064941102,CSE 140L,A01,083088,Eldon; John,16,0,100,84
1657064947124,CSE 175,A01,083665,Kumar; Rakesh,3,0,25,22
1657064953147,CSE 190,A00,092507,Dubnov; Shlomo,7,0,20,13
1657064959179,ECE 45,A01,083139,Congero; Spencer William,5,0,75,70
1657064965207,ECE 65,A50,083695,Saad; Andrew S,12,0,30,18
1657064965207,ECE 65,A51,095125,Saad; Andrew S,25,0,26,1
1657064971239,ECE 109,A01,091882,Touri; Behrouz,16,0,70,54
1657064977260,ECE 180,A00,083140,Abi Samra; Nicholas Camill,1,0,30,29
1657064977260,ECE 180,B00,083141,Abi Samra; Nicholas Camill,0,0,30,30
1657064983288,MATH 10A,A01,083735,Patchell; Gregory David,1,0,30,29
1657064983288,MATH 10A,A02,083736,Patchell; Gregory David,20,0,30,10
1657064983288,MATH 10A,A03,083737,Patchell; Gregory David,16,0,30,14
1657064989322,MATH 10B,A01,083207,Lim; Seonhee,7,0,34,27
1657064989322,MATH 10B,A02,083208,Lim; Seonhee,9,0,35,26
1657064989322,MATH 10B,A03,093472,Lim; Seonhee,4,0,34,30
1657064989322,MATH 10B,B01,083739,Sinha; Shubham,9,0,30,21
1657064995365,MATH 18,A01,083743,Cinel; Cameron Alexander,6,0,30,24
1657064995365,MATH 18,A02,083744,Cinel; Cameron Alexander,15,0,30,15
1657064995365,MATH 18,A03,083745,Cinel; Cameron Alexander,8,0,30,22
1657064995365,MATH 18,B01,083748,Rideout; David Porter,4,0,37,33
1657064995365,MATH 18,B02,083749,Rideout; David Porter,3,0,36,33
1657064995365,MATH 18,B03,083750,Rideout; David Porter,2,0,37,35
1657064995365,MATH 18,B04,083751,Rideout; David Porter,5,0,36,31
1657064995365,MATH 18,B05,093473,Rideout; David Porter,4,0,36,32
1657064995365,MATH 18,B06,093474,Rideout; David Porter,5,0,36,31
1657065001386,MATH 20A,A01,083754,Zheng; Zequn,12,0,40,28
1657065007409,MATH 20B,A01,083756,Briones; Jor-el Thomas Caparas,1,0,36,35
1657065007409,MATH 20B,A02,083757,Briones; Jor-el Thomas Caparas,1,0,36,35
1657065007409,MATH 20B,A03,093475,Briones; Jor-el Thomas Caparas,0,0,36,36
1657065013434,MATH 20C,A01,083760,Briones; Jor-el Thomas Caparas,1,0,35,34
1657065013434,MATH 20C,A02,083761,Briones; Jor-el Thomas Caparas,8,0,35,27
1657065013434,MATH 20C,A03,093476,Briones; Jor-el Thomas Caparas,0,1,36,36
1657065013434,MATH 20C,B01,083762,Bach; Quang Tran,0,0,30,30
1657065019455,MATH 20D,A01,083765,Tran; Brian Kha,4,0,30,26
1657065019455,MATH 20D,A02,083766,Tran; Brian Kha,5,0,30,25
1657065019455,MATH 20D,A03,083767,Tran; Brian Kha,3,0,30,27
1657065025478,MATH 20E,A01,083771,Ganguly; Soumya,5,0,32,27
1657065025478,MATH 20E,A02,083772,Ganguly; Soumya,6,0,32,26
1657065025478,MATH 20E,B01,083773,Ciotti; Benjamin,18,0,35,17
1657065025478,MATH 20E,B02,083774,Ciotti; Benjamin,17,0,35,18
1657065031506,MATH 103A,A01,083777,Greenfeld; Be'Eri,2,0,36,34
1657065031506,MATH 103A,A02,083778,Greenfeld; Be'Eri,5,0,36,31
1657065031506,MATH 103A,A03,093561,Greenfeld; Be'Eri,4,0,36,32
1657065031506,MATH 103A,B01,083779,Greenfeld; Be'Eri,6,0,36,30
1657065031506,MATH 103A,B02,083780,Greenfeld; Be'Eri,2,0,36,34
1657065031506,MATH 103A,B03,093562,Greenfeld; Be'Eri,3,0,36,33
1657065037530,MATH 105,A01,085443,Carter; Anne Toulson,14,0,35,21
1657065037530,MATH 105,A02,093477,Carter; Anne Toulson,20,0,35,15
1657065043554,MATH 109,A01,083213,Ganzberger; Geoffrey Michael,2,0,34,32
1657065043554,MATH 109,A02,083214,Ganzberger; Geoffrey Michael,2,0,34,32
1657065043554,MATH 109,A03,093478,Ganzberger; Geoffrey Michael,1,0,34,33
1657065043554,MATH 109,B01,083215,Ganzberger; Geoffrey Michael,1,0,32,31
1657065043554,MATH 109,B02,083216,Ganzberger; Geoffrey Michael,1,0,32,31
1657065043554,MATH 109,B03,093479,Ganzberger; Geoffrey Michael,6,0,32,26
1657065049590,MATH 142A,A01,083219,Chow; Bennett,6,0,32,26
1657065049590,MATH 142A,A02,083220,Chow; Bennett,10,0,32,22
1657065049590,MATH 142A,A03,093480,Chow; Bennett,7,0,32,25
1657065049590,MATH 142A,B03,093481,Chow; Bennett,7,0,32,25
1657065049590,MATH 142A,B04,093558,Chow; Bennett,11,0,32,21
1657065049590,MATH 142A,B05,093559,Chow; Bennett,6,0,32,26
1657065055612,MATH 193A,A01,083224,Rotar; Vladimir,7,0,34,27
1657065055612,MATH 193A,A02,083225,Rotar; Vladimir,5,0,34,29
1657065055612,MATH 193A,A03,083781,Rotar; Vladimir,1,0,34,33
1657065055612,MATH 193A,A04,083782,Rotar; Vladimir,6,0,34,28
1657065055612,MATH 193A,A05,093482,Rotar; Vladimir,6,0,34,28
1657065061636,MATH 197,001,091859,McAuley; Julian John,9999,0,9999,0
1657065061636,MATH 197,002,095566,Kedlaya; Kiran S.,9997,0,9999,2
1657065061636,MATH 197,003,095567,Xiao; Ming,9999,0,9999,0
1657065061636,MATH 197,004,095571,Perols; Johan Lars,9998,0,9999,1
1657065068698,COGS 9,A01,083615,Shannon; Kyle Michael,7,0,75,68
1657065074727,COGS 11,A01,083617,Boyle; Mary E. T.,21,0,48,27
1657065080753,COGS 13,A01,083071,Bastos; Amalia Pinkusfeld,9,0,71,62
1657065086780,COGS 14A,A01,092681,Semenuks; Arturs,0,1,100,100
1657065092801,COGS 14B,A01,083073,Cheng; Tzu-Han,5,0,63,58
1657065098824,COGS 17,A01,092677,Semenuks; Arturs,4,0,81,77
1657065104847,COGS 100,A01,083619,Allen; Michael Gordon,15,0,70,55
1657065110871,COGS 101A,A01,083621,Davis; Joshua Daniel,9,0,68,59
1657065116897,COGS 101B,A01,091572,Allen; Michael Gordon,8,0,65,57
1657065122921,COGS 101C,A01,083625,Delgado; Tania,17,0,35,18
1657065128949,COGS 107A,A01,083627,Boyle; Mary E. T.,13,0,60,47
1657065134977,COGS 118A,A01,083075,Gupta; Anjum,15,0,76,61
1657065141005,CSE 3,A50,083646,Miranda; Gregory Joseph,22,0,50,28
1657065147031,CSE 8A,A50,083650,Miranda; Gregory Joseph,17,1,56,39
1657065153055,CSE 11,A01,083080,Cao; Yingjun,4,15,40,36
1657065159077,CSE 12,A01,083652,Krause-Levy; Sophia Louisa,23,1,120,97
1657065165102,CSE 15L,A01,083654,Morris; Justin Loren,8,0,50,42
1657065165102,CSE 15L,A02,083655,Morris; Justin Loren,9,0,50,41
1657065171125,CSE 20,A01,083657,Tran; Khoa Dang,37,0,80,43
1657065177152,CSE 21,A01,095574,Bach; Quang Tran,21,0,48,27
1657065183178,CSE 30,A01,083084,Eldon; John,4,0,80,76
1657065183178,CSE 30,B01,095061,Bhaskar; Nishant,6,0,50,44
1657065189203,CSE 100,A01,083659,Cao; Yingjun,3,4,70,67
1657065195233,CSE 134B,A01,083661,Powell; Thomas Allan,19,0,100,81
1657065201256,CSE 140,A01,083663,Gungor; Onat,14,0,85,71
1657065207283,CSE 140L,A01,083088,Eldon; John,16,0,100,84
1657065213305,CSE 175,A01,083665,Kumar; Rakesh,3,0,25,22
1657065219331,CSE 190,A00,092507,Dubnov; Shlomo,7,0,20,13
1657065225358,ECE 45,A01,083139,Congero; Spencer William,5,0,75,70
1657065231390,ECE 65,A50,083695,Saad; Andrew S,12,0,30,18
1657065231390,ECE 65,A51,095125,Saad; Andrew S,25,0,26,1
1657065237414,ECE 109,A01,091882,Touri; Behrouz,16,0,70,54
1657065243442,ECE 180,A00,083140,Abi Samra; Nicholas Camill,1,0,30,29
1657065243442,ECE 180,B00,083141,Abi Samra; Nicholas Camill,0,0,30,30
1657065249469,MATH 10A,A01,083735,Patchell; Gregory David,1,0,30,29
1657065249469,MATH 10A,A02,083736,Patchell; Gregory David,20,0,30,10
1657065249469,MATH 10A,A03,083737,Patchell; Gregory David,16,0,30,14
1657065255498,MATH 10B,A01,083207,Lim; Seonhee,7,0,34,27
1657065255498,MATH 10B,A02,083208,Lim; Seonhee,9,0,35,26
1657065255498,MATH 10B,A03,093472,Lim; Seonhee,4,0,34,30
1657065255498,MATH 10B,B01,083739,Sinha; Shubham,9,0,30,21
1657065261527,MATH 18,A01,083743,Cinel; Cameron Alexander,6,0,30,24
1657065261527,MATH 18,A02,083744,Cinel; Cameron Alexander,15,0,30,15
1657065261527,MATH 18,A03,083745,Cinel; Cameron Alexander,8,0,30,22
1657065261527,MATH 18,B01,083748,Rideout; David Porter,4,0,37,33
1657065261527,MATH 18,B02,083749,Rideout; David Porter,3,0,36,33
1657065261527,MATH 18,B03,083750,Rideout; David Porter,2,0,37,35
1657065261527,MATH 18,B04,083751,Rideout; David Porter,5,0,36,31
1657065261527,MATH 18,B05,093473,Rideout; David Porter,4,0,36,32
1657065261527,MATH 18,B06,093474,Rideout; David Porter,5,0,36,31
1657065267551,MATH 20A,A01,083754,Zheng; Zequn,12,0,40,28
1657065273578,MATH 20B,A01,083756,Briones; Jor-el Thomas Caparas,1,0,36,35
1657065273578,MATH 20B,A02,083757,Briones; Jor-el Thomas Caparas,1,0,36,35
1657065273578,MATH 20B,A03,093475,Briones; Jor-el Thomas Caparas,0,0,36,36
1657065279607,MATH 20C,A01,083760,Briones; Jor-el Thomas Caparas,1,0,35,34
1657065279607,MATH 20C,A02,083761,Briones; Jor-el Thomas Caparas,8,0,35,27
1657065279607,MATH 20C,A03,093476,Briones; Jor-el Thomas Caparas,0,1,36,36
1657065279607,MATH 20C,B01,083762,Bach; Quang Tran,0,0,30,30
1657065285634,MATH 20D,A01,083765,Tran; Brian Kha,4,0,30,26
1657065285634,MATH 20D,A02,083766,Tran; Brian Kha,5,0,30,25
1657065285634,MATH 20D,A03,083767,Tran; Brian Kha,3,0,30,27
1657065291662,MATH 20E,A01,083771,Ganguly; Soumya,5,0,32,27
1657065291662,MATH 20E,A02,083772,Ganguly; Soumya,6,0,32,26
1657065291662,MATH 20E,B01,083773,Ciotti; Benjamin,18,0,35,17
1657065291662,MATH 20E,B02,083774,Ciotti; Benjamin,17,0,35,18
1657065297686,MATH 103A,A01,083777,Greenfeld; Be'Eri,2,0,36,34
1657065297686,MATH 103A,A02,083778,Greenfeld; Be'Eri,5,0,36,31
1657065297686,MATH 103A,A03,093561,Greenfeld; Be'Eri,4,0,36,32
1657065297686,MATH 103A,B01,083779,Greenfeld; Be'Eri,6,0,36,30
1657065297686,MATH 103A,B02,083780,Greenfeld; Be'Eri,2,0,36,34
1657065297686,MATH 103A,B03,093562,Greenfeld; Be'Eri,3,0,36,33
1657065303714,MATH 105,A01,085443,Carter; Anne Toulson,14,0,35,21
1657065303714,MATH 105,A02,093477,Carter; Anne Toulson,20,0,35,15
1657065309738,MATH 109,A01,083213,Ganzberger; Geoffrey Michael,2,0,34,32
1657065309738,MATH 109,A02,083214,Ganzberger; Geoffrey Michael,2,0,34,32
1657065309738,MATH 109,A03,093478,Ganzberger; Geoffrey Michael,1,0,34,33
1657065309738,MATH 109,B01,083215,Ganzberger; Geoffrey Michael,1,0,32,31
1657065309738,MATH 109,B02,083216,Ganzberger; Geoffrey Michael,1,0,32,31
1657065309738,MATH 109,B03,093479,Ganzberger; Geoffrey Michael,6,0,32,26
1657065315768,MATH 142A,A01,083219,Chow; Bennett,6,0,32,26
1657065315768,MATH 142A,A02,083220,Chow; Bennett,10,0,32,22
1657065315768,MATH 142A,A03,093480,Chow; Bennett,7,0,32,25
1657065315768,MATH 142A,B03,093481,Chow; Bennett,7,0,32,25
1657065315768,MATH 142A,B04,093558,Chow; Bennett,11,0,32,21
1657065315768,MATH 142A,B05,093559,Chow; Bennett,6,0,32,26
1657065321796,MATH 193A,A01,083224,Rotar; Vladimir,7,0,34,27
1657065321796,MATH 193A,A02,083225,Rotar; Vladimir,5,0,34,29
1657065321796,MATH 193A,A03,083781,Rotar; Vladimir,1,0,34,33
1657065321796,MATH 193A,A04,083782,Rotar; Vladimir,6,0,34,28
1657065321796,MATH 193A,A05,093482,Rotar; Vladimir,6,0,34,28
1657065327822,MATH 197,001,091859,McAuley; Julian John,9999,0,9999,0
1657065327822,MATH 197,002,095566,Kedlaya; Kiran S.,9997,0,9999,2
1657065327822,MATH 197,003,095567,Xiao; Ming,9999,0,9999,0
1657065327822,MATH 197,004,095571,Perols; Johan Lars,9998,0,9999,1
1657065334880,COGS 9,A01,083615,Shannon; Kyle Michael,7,0,75,68
1657065340904,COGS 11,A01,083617,Boyle; Mary E. T.,21,0,48,27
1657065346926,COGS 13,A01,083071,Bastos; Amalia Pinkusfeld,9,0,71,62
1657065352949,COGS 14A,A01,092681,Semenuks; Arturs,0,1,100,100
1657065358980,COGS 14B,A01,083073,Cheng; Tzu-Han,5,0,63,58
1657065365008,COGS 17,A01,092677,Semenuks; Arturs,4,0,81,77
1657065371033,COGS 100,A01,083619,Allen; Michael Gordon,15,0,70,55
1657065377056,COGS 101A,A01,083621,Davis; Joshua Daniel,9,0,68,59
1657065383079,COGS 101B,A01,091572,Allen; Michael Gordon,8,0,65,57
1657065389102,COGS 101C,A01,083625,Delgado; Tania,17,0,35,18
1657065395127,COGS 107A,A01,083627,Boyle; Mary E. T.,13,0,60,47
1657065401255,COGS 118A,A01,083075,Gupta; Anjum,15,0,76,61
1657065407283,CSE 3,A50,083646,Miranda; Gregory Joseph,22,0,50,28
1657065413311,CSE 8A,A50,083650,Miranda; Gregory Joseph,17,1,56,39
1657065419337,CSE 11,A01,083080,Cao; Yingjun,4,15,40,36
1657065425365,CSE 12,A01,083652,Krause-Levy; Sophia Louisa,23,1,120,97
1657065431391,CSE 15L,A01,083654,Morris; Justin Loren,8,0,50,42
1657065431391,CSE 15L,A02,083655,Morris; Justin Loren,9,0,50,41
1657065437416,CSE 20,A01,083657,Tran; Khoa Dang,37,0,80,43
1657065443443,CSE 21,A01,095574,Bach; Quang Tran,21,0,48,27
1657065449467,CSE 30,A01,083084,Eldon; John,4,0,80,76
1657065449467,CSE 30,B01,095061,Bhaskar; Nishant,6,0,50,44
1657065455495,CSE 100,A01,083659,Cao; Yingjun,3,4,70,67
1657065461526,CSE 134B,A01,083661,Powell; Thomas Allan,19,0,100,81
1657065467549,CSE 140,A01,083663,Gungor; Onat,14,0,85,71
1657065473583,CSE 140L,A01,083088,Eldon; John,16,0,100,84
1657065479607,CSE 175,A01,083665,Kumar; Rakesh,3,0,25,22
1657065485638,CSE 190,A00,092507,Dubnov; Shlomo,7,0,20,13
1657065491661,ECE 45,A01,083139,Congero; Spencer William,5,0,75,70
1657065497691,ECE 65,A50,083695,Saad; Andrew S,12,0,30,18
1657065497691,ECE 65,A51,095125,Saad; Andrew S,25,0,26,1
1657065503717,ECE 109,A01,091882,Touri; Behrouz,16,0,70,54
1657065509749,ECE 180,A00,083140,Abi Samra; Nicholas Camill,1,0,30,29
1657065509749,ECE 180,B00,083141,Abi Samra; Nicholas Camill,0,0,30,30
1657065515774,MATH 10A,A01,083735,Patchell; Gregory David,1,0,30,29
1657065515774,MATH 10A,A02,083736,Patchell; Gregory David,20,0,30,10
1657065515774,MATH 10A,A03,083737,Patchell; Gregory David,16,0,30,14
1657065521801,MATH 10B,A01,083207,Lim; Seonhee,7,0,34,27
1657065521801,MATH 10B,A02,083208,Lim; Seonhee,9,0,35,26
1657065521801,MATH 10B,A03,093472,Lim; Seonhee,4,0,34,30
1657065521801,MATH 10B,B01,083739,Sinha; Shubham,9,0,30,21
1657065527825,MATH 18,A01,083743,Cinel; Cameron Alexander,6,0,30,24
1657065527825,MATH 18,A02,083744,Cinel; Cameron Alexander,15,0,30,15
1657065527825,MATH 18,A03,083745,Cinel; Cameron Alexander,8,0,30,22
1657065527825,MATH 18,B01,083748,Rideout; David Porter,4,0,37,33
1657065527825,MATH 18,B02,083749,Rideout; David Porter,3,0,36,33
1657065527825,MATH 18,B03,083750,Rideout; David Porter,2,0,37,35
1657065527825,MATH 18,B04,083751,Rideout; David Porter,5,0,36,31
1657065527825,MATH 18,B05,093473,Rideout; David Porter,4,0,36,32
1657065527825,MATH 18,B06,093474,Rideout; David Porter,5,0,36,31
1657065533852,MATH 20A,A01,083754,Zheng; Zequn,12,0,40,28
1657065539879,MATH 20B,A01,083756,Briones; Jor-el Thomas Caparas,1,0,36,35
1657065539879,MATH 20B,A02,083757,Briones; Jor-el Thomas Caparas,1,0,36,35
1657065539879,MATH 20B,A03,093475,Briones; Jor-el Thomas Caparas,0,0,36,36
1657065545909,MATH 20C,A01,083760,Briones; Jor-el Thomas Caparas,1,0,35,34
1657065545909,MATH 20C,A02,083761,Briones; Jor-el Thomas Caparas,8,0,35,27
1657065545909,MATH 20C,A03,093476,Briones; Jor-el Thomas Caparas,0,1,36,36
1657065545909,MATH 20C,B01,083762,Bach; Quang Tran,0,0,30,30
1657065551939,MATH 20D,A01,083765,Tran; Brian Kha,4,0,30,26
1657065551939,MATH 20D,A02,083766,Tran; Brian Kha,5,0,30,25
1657065551939,MATH 20D,A03,083767,Tran; Brian Kha,3,0,30,27
1657065557970,MATH 20E,A01,083771,Ganguly; Soumya,5,0,32,27
1657065557970,MATH 20E,A02,083772,Ganguly; Soumya,6,0,32,26
1657065557970,MATH 20E,B01,083773,Ciotti; Benjamin,18,0,35,17
1657065557970,MATH 20E,B02,083774,Ciotti; Benjamin,17,0,35,18
1657065563993,MATH 103A,A01,083777,Greenfeld; Be'Eri,2,0,36,34
1657065563993,MATH 103A,A02,083778,Greenfeld; Be'Eri,5,0,36,31
1657065563993,MATH 103A,A03,093561,Greenfeld; Be'Eri,4,0,36,32
1657065563993,MATH 103A,B01,083779,Greenfeld; Be'Eri,6,0,36,30
1657065563993,MATH 103A,B02,083780,Greenfeld; Be'Eri,2,0,36,34
1657065563993,MATH 103A,B03,093562,Greenfeld; Be'Eri,3,0,36,33
1657065570019,MATH 105,A01,085443,Carter; Anne Toulson,14,0,35,21
1657065570019,MATH 105,A02,093477,Carter; Anne Toulson,20,0,35,15
1657065576042,MATH 109,A01,083213,Ganzberger; Geoffrey Michael,2,0,34,32
1657065576042,MATH 109,A02,083214,Ganzberger; Geoffrey Michael,2,0,34,32
1657065576042,MATH 109,A03,093478,Ganzberger; Geoffrey Michael,1,0,34,33
1657065576042,MATH 109,B01,083215,Ganzberger; Geoffrey Michael,1,0,32,31
1657065576042,MATH 109,B02,083216,Ganzberger; Geoffrey Michael,1,0,32,31
1657065576042,MATH 109,B03,093479,Ganzberger; Geoffrey Michael,6,0,32,26
1657065582071,MATH 142A,A01,083219,Chow; Bennett,6,0,32,26
1657065582071,MATH 142A,A02,083220,Chow; Bennett,10,0,32,22
1657065582071,MATH 142A,A03,093480,Chow; Bennett,7,0,32,25
1657065582071,MATH 142A,B03,093481,Chow; Bennett,7,0,32,25
1657065582071,MATH 142A,B04,093558,Chow; Bennett,11,0,32,21
1657065582071,MATH 142A,B05,093559,Chow; Bennett,6,0,32,26
1657065588095,MATH 193A,A01,083224,Rotar; Vladimir,7,0,34,27
1657065588095,MATH 193A,A02,083225,Rotar; Vladimir,5,0,34,29
1657065588095,MATH 193A,A03,083781,Rotar; Vladimir,1,0,34,33
1657065588095,MATH 193A,A04,083782,Rotar; Vladimir,6,0,34,28
1657065588095,MATH 193A,A05,093482,Rotar; Vladimir,6,0,34,28
1657065594134,MATH 197,001,091859,McAuley; Julian John,9999,0,9999,0
1657065594134,MATH 197,002,095566,Kedlaya; Kiran S.,9997,0,9999,2
1657065594134,MATH 197,003,095567,Xiao; Ming,9999,0,9999,0
1657065594134,MATH 197,004,095571,Perols; Johan Lars,9998,0,9999,1
1657065601192,COGS 9,A01,083615,Shannon; Kyle Michael,7,0,75,68
1657065607214,COGS 11,A01,083617,Boyle; Mary E. T.,21,0,48,27
1657065613243,COGS 13,A01,083071,Bastos; Amalia Pinkusfeld,9,0,71,62
1657065619266,COGS 14A,A01,092681,Semenuks; Arturs,0,1,100,100
1657065625297,COGS 14B,A01,083073,Cheng; Tzu-Han,5,0,63,58
1657065631325,COGS 17,A01,092677,Semenuks; Arturs,4,0,81,77
1657065637348,COGS 100,A01,083619,Allen; Michael Gordon,15,0,70,55
1657065643372,COGS 101A,A01,083621,Davis; Joshua Daniel,9,0,68,59
1657065649398,COGS 101B,A01,091572,Allen; Michael Gordon,8,0,65,57
1657065655427,COGS 101C,A01,083625,Delgado; Tania,17,0,35,18
1657065661452,COGS 107A,A01,083627,Boyle; Mary E. T.,13,0,60,47
1657065667480,COGS 118A,A01,083075,Gupta; Anjum,15,0,76,61
1657065673510,CSE 3,A50,083646,Miranda; Gregory Joseph,22,0,50,28
1657065679533,CSE 8A,A50,083650,Miranda; Gregory Joseph,17,1,56,39
1657065685559,CSE 11,A01,083080,Cao; Yingjun,4,15,40,36
1657065691588,CSE 12,A01,083652,Krause-Levy; Sophia Louisa,23,1,120,97
1657065697617,CSE 15L,A01,083654,Morris; Justin Loren,8,0,50,42
1657065697617,CSE 15L,A02,083655,Morris; Justin Loren,9,0,50,41
1657065703640,CSE 20,A01,083657,Tran; Khoa Dang,37,0,80,43
1657065709663,CSE 21,A01,095574,Bach; Quang Tran,21,0,48,27
1657065715685,CSE 30,A01,083084,Eldon; John,4,0,80,76
1657065715685,CSE 30,B01,095061,Bhaskar; Nishant,6,0,50,44
1657065721719,CSE 100,A01,083659,Cao; Yingjun,3,4,70,67
1657065727745,CSE 134B,A01,083661,Powell; Thomas Allan,19,0,100,81
1657065733769,CSE 140,A01,083663,Gungor; Onat,14,0,85,71
1657065739796,CSE 140L,A01,083088,Eldon; John,16,0,100,84
1657065745818,CSE 175,A01,083665,Kumar; Rakesh,3,0,25,22
1657065751842,CSE 190,A00,092507,Dubnov; Shlomo,7,0,20,13
1657065757869,ECE 45,A01,083139,Congero; Spencer William,5,0,75,70
1657065763897,ECE 65,A50,083695,Saad; Andrew S,12,0,30,18
1657065763897,ECE 65,A51,095125,Saad; Andrew S,25,0,26,1
1657065769922,ECE 109,A01,091882,Touri; Behrouz,16,0,70,54
1657065775945,ECE 180,A00,083140,Abi Samra; Nicholas Camill,1,0,30,29
1657065775945,ECE 180,B00,083141,Abi Samra; Nicholas Camill,0,0,30,30
1657065781970,MATH 10A,A01,083735,Patchell; Gregory David,1,0,30,29
1657065781970,MATH 10A,A02,083736,Patchell; Gregory David,20,0,30,10
1657065781970,MATH 10A,A03,083737,Patchell; Gregory David,16,0,30,14
1657065787994,MATH 10B,A01,083207,Lim; Seonhee,7,0,34,27
1657065787994,MATH 10B,A02,083208,Lim; Seonhee,9,0,35,26
1657065787994,MATH 10B,A03,093472,Lim; Seonhee,4,0,34,30
1657065787994,MATH 10B,B01,083739,Sinha; Shubham,9,0,30,21
1657065794025,MATH 18,A01,083743,Cinel; Cameron Alexander,6,0,30,24
1657065794025,MATH 18,A02,083744,Cinel; Cameron Alexander,15,0,30,15
1657065794025,MATH 18,A03,083745,Cinel; Cameron Alexander,8,0,30,22
1657065794025,MATH 18,B01,083748,Rideout; David Porter,4,0,37,33
1657065794025,MATH 18,B02,083749,Rideout; David Porter,3,0,36,33
1657065794025,MATH 18,B03,083750,Rideout; David Porter,2,0,37,35
1657065794025,MATH 18,B04,083751,Rideout; David Porter,5,0,36,31
1657065794025,MATH 18,B05,093473,Rideout; David Porter,4,0,36,32
1657065794025,MATH 18,B06,093474,Rideout; David Porter,5,0,36,31
1657065800051,MATH 20A,A01,083754,Zheng; Zequn,12,0,40,28
1657065806082,MATH 20B,A01,083756,Briones; Jor-el Thomas Caparas,1,0,36,35
1657065806082,MATH 20B,A02,083757,Briones; Jor-el Thomas Caparas,1,0,36,35
1657065806082,MATH 20B,A03,093475,Briones; Jor-el Thomas Caparas,0,0,36,36
1657065812111,MATH 20C,A01,083760,Briones; Jor-el Thomas Caparas,1,0,35,34
1657065812111,MATH 20C,A02,083761,Briones; Jor-el Thomas Caparas,8,0,35,27
1657065812111,MATH 20C,A03,093476,Briones; Jor-el Thomas Caparas,0,1,36,36
1657065812111,MATH 20C,B01,083762,Bach; Quang Tran,0,0,30,30
1657065818139,MATH 20D,A01,083765,Tran; Brian Kha,4,0,30,26
1657065818139,MATH 20D,A02,083766,Tran; Brian Kha,5,0,30,25
1657065818139,MATH 20D,A03,083767,Tran; Brian Kha,3,0,30,27
1657065824163,MATH 20E,A01,083771,Ganguly; Soumya,5,0,32,27
1657065824163,MATH 20E,A02,083772,Ganguly; Soumya,6,0,32,26
1657065824163,MATH 20E,B01,083773,Ciotti; Benjamin,18,0,35,17
1657065824163,MATH 20E,B02,083774,Ciotti; Benjamin,17,0,35,18
1657065830188,MATH 103A,A01,083777,Greenfeld; Be'Eri,2,0,36,34
1657065830188,MATH 103A,A02,083778,Greenfeld; Be'Eri,5,0,36,31
1657065830188,MATH 103A,A03,093561,Greenfeld; Be'Eri,4,0,36,32
1657065830188,MATH 103A,B01,083779,Greenfeld; Be'Eri,6,0,36,30
1657065830188,MATH 103A,B02,083780,Greenfeld; Be'Eri,2,0,36,34
1657065830188,MATH 103A,B03,093562,Greenfeld; Be'Eri,3,0,36,33
1657065836219,MATH 105,A01,085443,Carter; Anne Toulson,14,0,35,21
1657065836219,MATH 105,A02,093477,Carter; Anne Toulson,20,0,35,15
1657065842244,MATH 109,A01,083213,Ganzberger; Geoffrey Michael,2,0,34,32
1657065842244,MATH 109,A02,083214,Ganzberger; Geoffrey Michael,2,0,34,32
1657065842244,MATH 109,A03,093478,Ganzberger; Geoffrey Michael,1,0,34,33
1657065842244,MATH 109,B01,083215,Ganzberger; Geoffrey Michael,1,0,32,31
1657065842244,MATH 109,B02,083216,Ganzberger; Geoffrey Michael,1,0,32,31
1657065842244,MATH 109,B03,093479,Ganzberger; Geoffrey Michael,6,0,32,26
1657065848278,MATH 142A,A01,083219,Chow; Bennett,6,0,32,26
1657065848278,MATH 142A,A02,083220,Chow; Bennett,10,0,32,22
1657065848278,MATH 142A,A03,093480,Chow; Bennett,7,0,32,25
1657065848278,MATH 142A,B03,093481,Chow; Bennett,7,0,32,25
1657065848278,MATH 142A,B04,093558,Chow; Bennett,11,0,32,21
1657065848278,MATH 142A,B05,093559,Chow; Bennett,6,0,32,26
1657065854304,MATH 193A,A01,083224,Rotar; Vladimir,7,0,34,27
1657065854304,MATH 193A,A02,083225,Rotar; Vladimir,5,0,34,29
1657065854304,MATH 193A,A03,083781,Rotar; Vladimir,1,0,34,33
1657065854304,MATH 193A,A04,083782,Rotar; Vladimir,6,0,34,28
1657065854304,MATH 193A,A05,093482,Rotar; Vladimir,6,0,34,28
1657065860329,MATH 197,001,091859,McAuley; Julian John,9999,0,9999,0
1657065860329,MATH 197,002,095566,Kedlaya; Kiran S.,9997,0,9999,2
1657065860329,MATH 197,003,095567,Xiao; Ming,9999,0,9999,0
1657065860329,MATH 197,004,095571,Perols; Johan Lars,9998,0,9999,1
1657065867386,COGS 9,A01,083615,Shannon; Kyle Michael,7,0,75,68
1657065873410,COGS 11,A01,083617,Boyle; Mary E. T.,21,0,48,27
1657065879434,COGS 13,A01,083071,Bastos; Amalia Pinkusfeld,9,0,71,62
1657065885457,COGS 14A,A01,092681,Semenuks; Arturs,0,1,100,100
1657065891480,COGS 14B,A01,083073,Cheng; Tzu-Han,5,0,63,58
1657065897507,COGS 17,A01,092677,Semenuks; Arturs,4,0,81,77
1657065903548,COGS 100,A01,083619,Allen; Michael Gordon,15,0,70,55
1657065909573,COGS 101A,A01,083621,Davis; Joshua Daniel,9,0,68,59
1657065915597,COGS 101B,A01,091572,Allen; Michael Gordon,8,0,65,57
1657065921623,COGS 101C,A01,083625,Delgado; Tania,17,0,35,18
1657065927654,COGS 107A,A01,083627,Boyle; Mary E. T.,13,0,60,47
1657065933678,COGS 118A,A01,083075,Gupta; Anjum,15,0,76,61
1657065939706,CSE 3,A50,083646,Miranda; Gregory Joseph,22,0,50,28
1657065945735,CSE 8A,A50,083650,Miranda; Gregory Joseph,17,1,56,39
1657065951759,CSE 11,A01,083080,Cao; Yingjun,4,15,40,36
1657065957783,CSE 12,A01,083652,Krause-Levy; Sophia Louisa,23,1,120,97
1657065963815,CSE 15L,A01,083654,Morris; Justin Loren,8,0,50,42
1657065963815,CSE 15L,A02,083655,Morris; Justin Loren,9,0,50,41
1657065969843,CSE 20,A01,083657,Tran; Khoa Dang,37,0,80,43
1657065975873,CSE 21,A01,095574,Bach; Quang Tran,21,0,48,27
1657065981896,CSE 30,A01,083084,Eldon; John,4,0,80,76
1657065981896,CSE 30,B01,095061,Bhaskar; Nishant,6,0,50,44
1657065987921,CSE 100,A01,083659,Cao; Yingjun,3,4,70,67
1657065993947,CSE 134B,A01,083661,Powell; Thomas Allan,19,0,100,81
1657066000044,CSE 140,A01,083663,Gungor; Onat,14,0,85,71
1657066006071,CSE 140L,A01,083088,Eldon; John,16,0,100,84
1657066012094,CSE 175,A01,083665,Kumar; Rakesh,3,0,25,22
1657066018116,CSE 190,A00,092507,Dubnov; Shlomo,7,0,20,13
1657066024147,ECE 45,A01,083139,Congero; Spencer William,5,0,75,70
1657066030173,ECE 65,A50,083695,Saad; Andrew S,12,0,30,18
1657066030173,ECE 65,A51,095125,Saad; Andrew S,25,0,26,1
1657066036200,ECE 109,A01,091882,Touri; Behrouz,16,0,70,54
1657066042224,ECE 180,A00,083140,Abi Samra; Nicholas Camill,1,0,30,29
1657066042224,ECE 180,B00,083141,Abi Samra; Nicholas Camill,0,0,30,30
1657066048252,MATH 10A,A01,083735,Patchell; Gregory David,1,0,30,29
1657066048252,MATH 10A,A02,083736,Patchell; Gregory David,20,0,30,10
1657066048252,MATH 10A,A03,083737,Patchell; Gregory David,16,0,30,14
1657066054277,MATH 10B,A01,083207,Lim; Seonhee,7,0,34,27
1657066054277,MATH 10B,A02,083208,Lim; Seonhee,9,0,35,26
1657066054277,MATH 10B,A03,093472,Lim; Seonhee,4,0,34,30
1657066054277,MATH 10B,B01,083739,Sinha; Shubham,9,0,30,21
1657066060301,MATH 18,A01,083743,Cinel; Cameron Alexander,6,0,30,24
1657066060301,MATH 18,A02,083744,Cinel; Cameron Alexander,15,0,30,15
1657066060301,MATH 18,A03,083745,Cinel; Cameron Alexander,8,0,30,22
1657066060301,MATH 18,B01,083748,Rideout; David Porter,4,0,37,33
1657066060301,MATH 18,B02,083749,Rideout; David Porter,3,0,36,33
1657066060301,MATH 18,B03,083750,Rideout; David Porter,2,0,37,35
1657066060301,MATH 18,B04,083751,Rideout; David Porter,5,0,36,31
1657066060301,MATH 18,B05,093473,Rideout; David Porter,4,0,36,32
1657066060301,MATH 18,B06,093474,Rideout; David Porter,5,0,36,31
1657066066330,MATH 20A,A01,083754,Zheng; Zequn,12,0,40,28
1657066072352,MATH 20B,A01,083756,Briones; Jor-el Thomas Caparas,1,0,36,35
1657066072352,MATH 20B,A02,083757,Briones; Jor-el Thomas Caparas,1,0,36,35
1657066072352,MATH 20B,A03,093475,Briones; Jor-el Thomas Caparas,0,0,36,36
1657066078382,MATH 20C,A01,083760,Briones; Jor-el Thomas Caparas,1,0,35,34
1657066078382,MATH 20C,A02,083761,Briones; Jor-el Thomas Caparas,8,0,35,27
1657066078382,MATH 20C,A03,093476,Briones; Jor-el Thomas Caparas,0,1,36,36
1657066078382,MATH 20C,B01,083762,Bach; Quang Tran,0,0,30,30
1657066084408,MATH 20D,A01,083765,Tran; Brian Kha,4,0,30,26
1657066084408,MATH 20D,A02,083766,Tran; Brian Kha,5,0,30,25
1657066084408,MATH 20D,A03,083767,Tran; Brian Kha,3,0,30,27
1657066090431,MATH 20E,A01,083771,Ganguly; Soumya,5,0,32,27
1657066090431,MATH 20E,A02,083772,Ganguly; Soumya,6,0,32,26
1657066090431,MATH 20E,B01,083773,Ciotti; Benjamin,18,0,35,17
1657066090431,MATH 20E,B02,083774,Ciotti; Benjamin,17,0,35,18
1657066096455,MATH 103A,A01,083777,Greenfeld; Be'Eri,2,0,36,34
1657066096455,MATH 103A,A02,083778,Greenfeld; Be'Eri,5,0,36,31
1657066096455,MATH 103A,A03,093561,Greenfeld; Be'Eri,4,0,36,32
1657066096455,MATH 103A,B01,083779,Greenfeld; Be'Eri,6,0,36,30
1657066096455,MATH 103A,B02,083780,Greenfeld; Be'Eri,2,0,36,34
1657066096455,MATH 103A,B03,093562,Greenfeld; Be'Eri,3,0,36,33
1657066102487,MATH 105,A01,085443,Carter; Anne Toulson,14,0,35,21
1657066102487,MATH 105,A02,093477,Carter; Anne Toulson,20,0,35,15
1657066108516,MATH 109,A01,083213,Ganzberger; Geoffrey Michael,2,0,34,32
1657066108516,MATH 109,A02,083214,Ganzberger; Geoffrey Michael,2,0,34,32
1657066108516,MATH 109,A03,093478,Ganzberger; Geoffrey Michael,1,0,34,33
1657066108516,MATH 109,B01,083215,Ganzberger; Geoffrey Michael,1,0,32,31
1657066108516,MATH 109,B02,083216,Ganzberger; Geoffrey Michael,1,0,32,31
1657066108516,MATH 109,B03,093479,Ganzberger; Geoffrey Michael,6,0,32,26
1657066114545,MATH 142A,A01,083219,Chow; Bennett,6,0,32,26
1657066114545,MATH 142A,A02,083220,Chow; Bennett,10,0,32,22
1657066114545,MATH 142A,A03,093480,Chow; Bennett,7,0,32,25
1657066114545,MATH 142A,B03,093481,Chow; Bennett,7,0,32,25
1657066114545,MATH 142A,B04,093558,Chow; Bennett,11,0,32,21
1657066114545,MATH 142A,B05,093559,Chow; Bennett,6,0,32,26
1657066120574,MATH 193A,A01,083224,Rotar; Vladimir,7,0,34,27
1657066120574,MATH 193A,A02,083225,Rotar; Vladimir,5,0,34,29
1657066120574,MATH 193A,A03,083781,Rotar; Vladimir,1,0,34,33
1657066120574,MATH 193A,A04,083782,Rotar; Vladimir,6,0,34,28
1657066120574,MATH 193A,A05,093482,Rotar; Vladimir,6,0,34,28
1657066126607,MATH 197,001,091859,McAuley; Julian John,9999,0,9999,0
1657066126607,MATH 197,002,095566,Kedlaya; Kiran S.,9997,0,9999,2
1657066126607,MATH 197,003,095567,Xiao; Ming,9999,0,9999,0
1657066126607,MATH 197,004,095571,Perols; Johan Lars,9998,0,9999,1
1657066133697,COGS 9,A01,083615,Shannon; Kyle Michael,7,0,75,68
1657066139719,COGS 11,A01,083617,Boyle; Mary E. T.,21,0,48,27
1657066145748,COGS 13,A01,083071,Bastos; Amalia Pinkusfeld,9,0,71,62
1657066151775,COGS 14A,A01,092681,Semenuks; Arturs,0,1,100,100
1657066157805,COGS 14B,A01,083073,Cheng; Tzu-Han,5,0,63,58
1657066163833,COGS 17,A01,092677,Semenuks; Arturs,4,0,81,77
1657066169855,COGS 100,A01,083619,Allen; Michael Gordon,15,0,70,55
1657066175880,COGS 101A,A01,083621,Davis; Joshua Daniel,9,0,68,59
1657066181904,COGS 101B,A01,091572,Allen; Michael Gordon,8,0,65,57
1657066187928,COGS 101C,A01,083625,Delgado; Tania,17,0,35,18
1657066193954,COGS 107A,A01,083627,Boyle; Mary E. T.,13,0,60,47
1657066199979,COGS 118A,A01,083075,Gupta; Anjum,15,0,76,61
1657066206004,CSE 3,A50,083646,Miranda; Gregory Joseph,22,0,50,28
1657066212028,CSE 8A,A50,083650,Miranda; Gregory Joseph,17,1,56,39
1657066218050,CSE 11,A01,083080,Cao; Yingjun,4,15,40,36
1657066224080,CSE 12,A01,083652,Krause-Levy; Sophia Louisa,23,1,120,97
1657066230110,CSE 15L,A01,083654,Morris; Justin Loren,8,0,50,42
1657066230110,CSE 15L,A02,083655,Morris; Justin Loren,9,0,50,41
1657066236132,CSE 20,A01,083657,Tran; Khoa Dang,37,0,80,43
1657066242154,CSE 21,A01,095574,Bach; Quang Tran,21,0,48,27
1657066248178,CSE 30,A01,083084,Eldon; John,4,0,80,76
1657066248178,CSE 30,B01,095061,Bhaskar; Nishant,6,0,50,44
1657066254212,CSE 100,A01,083659,Cao; Yingjun,3,4,70,67
1657066260259,CSE 134B,A01,083661,Powell; Thomas Allan,19,0,100,81
1657066266287,CSE 140,A01,083663,Gungor; Onat,14,0,85,71
1657066272311,CSE 140L,A01,083088,Eldon; John,16,0,100,84
1657066278334,CSE 175,A01,083665,Kumar; Rakesh,3,0,25,22
1657066284358,CSE 190,A00,092507,Dubnov; Shlomo,7,0,20,13
1657066290395,ECE 45,A01,083139,Congero; Spencer William,5,0,75,70
1657066296423,ECE 65,A50,083695,Saad; Andrew S,12,0,30,18
1657066296423,ECE 65,A51,095125,Saad; Andrew S,25,0,26,1
1657066302447,ECE 109,A01,091882,Touri; Behrouz,16,0,70,54
1657066308470,ECE 180,A00,083140,Abi Samra; Nicholas Camill,1,0,30,29
1657066308470,ECE 180,B00,083141,Abi Samra; Nicholas Camill,0,0,30,30
1657066314500,MATH 10A,A01,083735,Patchell; Gregory David,1,0,30,29
1657066314500,MATH 10A,A02,083736,Patchell; Gregory David,20,0,30,10
1657066314500,MATH 10A,A03,083737,Patchell; Gregory David,16,0,30,14
1657066320531,MATH 10B,A01,083207,Lim; Seonhee,7,0,34,27
1657066320531,MATH 10B,A02,083208,Lim; Seonhee,9,0,35,26
1657066320531,MATH 10B,A03,093472,Lim; Seonhee,4,0,34,30
1657066320531,MATH 10B,B01,083739,Sinha; Shubham,9,0,30,21
1657066326564,MATH 18,A01,083743,Cinel; Cameron Alexander,6,0,30,24
1657066326564,MATH 18,A02,083744,Cinel; Cameron Alexander,15,0,30,15
1657066326564,MATH 18,A03,083745,Cinel; Cameron Alexander,8,0,30,22
1657066326564,MATH 18,B01,083748,Rideout; David Porter,4,0,37,33
1657066326564,MATH 18,B02,083749,Rideout; David Porter,3,0,36,33
1657066326564,MATH 18,B03,083750,Rideout; David Porter,2,0,37,35
1657066326564,MATH 18,B04,083751,Rideout; David Porter,5,0,36,31
1657066326564,MATH 18,B05,093473,Rideout; David Porter,4,0,36,32
1657066326564,MATH 18,B06,093474,Rideout; David Porter,5,0,36,31
1657066332591,MATH 20A,A01,083754,Zheng; Zequn,12,0,40,28
1657066338637,MATH 20B,A01,083756,Briones; Jor-el Thomas Caparas,1,0,36,35
1657066338637,MATH 20B,A02,083757,Briones; Jor-el Thomas Caparas,1,0,36,35
1657066338637,MATH 20B,A03,093475,Briones; Jor-el Thomas Caparas,0,0,36,36
1657066344675,MATH 20C,A01,083760,Briones; Jor-el Thomas Caparas,1,0,35,34
1657066344675,MATH 20C,A02,083761,Briones; Jor-el Thomas Caparas,8,0,35,27
1657066344675,MATH 20C,A03,093476,Briones; Jor-el Thomas Caparas,0,1,36,36
1657066344675,MATH 20C,B01,083762,Bach; Quang Tran,0,0,30,30
1657066350706,MATH 20D,A01,083765,Tran; Brian Kha,4,0,30,26
1657066350706,MATH 20D,A02,083766,Tran; Brian Kha,5,0,30,25
1657066350706,MATH 20D,A03,083767,Tran; Brian Kha,3,0,30,27
1657066356761,MATH 20E,A01,083771,Ganguly; Soumya,5,0,32,27
1657066356761,MATH 20E,A02,083772,Ganguly; Soumya,6,0,32,26
1657066356761,MATH 20E,B01,083773,Ciotti; Benjamin,18,0,35,17
1657066356761,MATH 20E,B02,083774,Ciotti; Benjamin,17,0,35,18
1657066362793,MATH 103A,A01,083777,Greenfeld; Be'Eri,2,0,36,34
1657066362793,MATH 103A,A02,083778,Greenfeld; Be'Eri,5,0,36,31
1657066362793,MATH 103A,A03,093561,Greenfeld; Be'Eri,4,0,36,32
1657066362793,MATH 103A,B01,083779,Greenfeld; Be'Eri,6,0,36,30
1657066362793,MATH 103A,B02,083780,Greenfeld; Be'Eri,2,0,36,34
1657066362793,MATH 103A,B03,093562,Greenfeld; Be'Eri,3,0,36,33
1657066368821,MATH 105,A01,085443,Carter; Anne Toulson,14,0,35,21
1657066368821,MATH 105,A02,093477,Carter; Anne Toulson,20,0,35,15
1657066374851,MATH 109,A01,083213,Ganzberger; Geoffrey Michael,2,0,34,32
1657066374851,MATH 109,A02,083214,Ganzberger; Geoffrey Michael,2,0,34,32
1657066374851,MATH 109,A03,093478,Ganzberger; Geoffrey Michael,1,0,34,33
1657066374851,MATH 109,B01,083215,Ganzberger; Geoffrey Michael,1,0,32,31
1657066374851,MATH 109,B02,083216,Ganzberger; Geoffrey Michael,1,0,32,31
1657066374851,MATH 109,B03,093479,Ganzberger; Geoffrey Michael,6,0,32,26
1657066380876,MATH 142A,A01,083219,Chow; Bennett,6,0,32,26
1657066380876,MATH 142A,A02,083220,Chow; Bennett,10,0,32,22
1657066380876,MATH 142A,A03,093480,Chow; Bennett,7,0,32,25
1657066380876,MATH 142A,B03,093481,Chow; Bennett,7,0,32,25
1657066380876,MATH 142A,B04,093558,Chow; Bennett,11,0,32,21
1657066380876,MATH 142A,B05,093559,Chow; Bennett,6,0,32,26
1657066386900,MATH 193A,A01,083224,Rotar; Vladimir,7,0,34,27
1657066386900,MATH 193A,A02,083225,Rotar; Vladimir,5,0,34,29
1657066386900,MATH 193A,A03,083781,Rotar; Vladimir,1,0,34,33
1657066386900,MATH 193A,A04,083782,Rotar; Vladimir,6,0,34,28
1657066386900,MATH 193A,A05,093482,Rotar; Vladimir,6,0,34,28
1657066392929,MATH 197,001,091859,McAuley; Julian John,9999,0,9999,0
1657066392929,MATH 197,002,095566,Kedlaya; Kiran S.,9997,0,9999,2
1657066392929,MATH 197,003,095567,Xiao; Ming,9999,0,9999,0
1657066392929,MATH 197,004,095571,Perols; Johan Lars,9998,0,9999,1
1657066399990,COGS 9,A01,083615,Shannon; Kyle Michael,7,0,75,68
1657066406016,COGS 11,A01,083617,Boyle; Mary E. T.,21,0,48,27
1657066412038,COGS 13,A01,083071,Bastos; Amalia Pinkusfeld,9,0,71,62
1657066418062,COGS 14A,A01,092681,Semenuks; Arturs,0,1,100,100
1657066424089,COGS 14B,A01,083073,Cheng; Tzu-Han,5,0,63,58
1657066430112,COGS 17,A01,092677,Semenuks; Arturs,4,0,81,77
1657066436135,COGS 100,A01,083619,Allen; Michael Gordon,15,0,70,55
1657066442162,COGS 101A,A01,083621,Davis; Joshua Daniel,9,0,68,59
1657066448191,COGS 101B,A01,091572,Allen; Michael Gordon,8,0,65,57
1657066454217,COGS 101C,A01,083625,Delgado; Tania,17,0,35,18
1657066460250,COGS 107A,A01,083627,Boyle; Mary E. T.,13,0,60,47
1657066466275,COGS 118A,A01,083075,Gupta; Anjum,15,0,76,61
1657066472299,CSE 3,A50,083646,Miranda; Gregory Joseph,22,0,50,28
1657066478321,CSE 8A,A50,083650,Miranda; Gregory Joseph,17,1,56,39
1657066484344,CSE 11,A01,083080,Cao; Yingjun,4,15,40,36
1657066490368,CSE 12,A01,083652,Krause-Levy; Sophia Louisa,23,1,120,97
1657066496404,CSE 15L,A01,083654,Morris; Justin Loren,8,0,50,42
1657066496404,CSE 15L,A02,083655,Morris; Justin Loren,9,0,50,41
1657066502430,CSE 20,A01,083657,Tran; Khoa Dang,37,0,80,43
1657066508457,CSE 21,A01,095574,Bach; Quang Tran,21,0,48,27
1657066514484,CSE 30,A01,083084,Eldon; John,4,0,80,76
1657066514484,CSE 30,B01,095061,Bhaskar; Nishant,6,0,50,44
1657066520508,CSE 100,A01,083659,Cao; Yingjun,3,4,70,67
1657066526536,CSE 134B,A01,083661,Powell; Thomas Allan,19,0,100,81
1657066532558,CSE 140,A01,083663,Gungor; Onat,14,0,85,71
1657066538585,CSE 140L,A01,083088,Eldon; John,16,0,100,84
1657066544612,CSE 175,A01,083665,Kumar; Rakesh,3,0,25,22
1657066550635,CSE 190,A00,092507,Dubnov; Shlomo,7,0,20,13
1657066556664,ECE 45,A01,083139,Congero; Spencer William,5,0,75,70
1657066562691,ECE 65,A50,083695,Saad; Andrew S,12,0,30,18
1657066562691,ECE 65,A51,095125,Saad; Andrew S,25,0,26,1
1657066568714,ECE 109,A01,091882,Touri; Behrouz,16,0,70,54
1657066574739,ECE 180,A00,083140,Abi Samra; Nicholas Camill,1,0,30,29
1657066574739,ECE 180,B00,083141,Abi Samra; Nicholas Camill,0,0,30,30
1657066580768,MATH 10A,A01,083735,Patchell; Gregory David,1,0,30,29
1657066580768,MATH 10A,A02,083736,Patchell; Gregory David,20,0,30,10
1657066580768,MATH 10A,A03,083737,Patchell; Gregory David,16,0,30,14
1657066586792,MATH 10B,A01,083207,Lim; Seonhee,7,0,34,27
1657066586792,MATH 10B,A02,083208,Lim; Seonhee,9,0,35,26
1657066586792,MATH 10B,A03,093472,Lim; Seonhee,4,0,34,30
1657066586792,MATH 10B,B01,083739,Sinha; Shubham,9,0,30,21
1657066592817,MATH 18,A01,083743,Cinel; Cameron Alexander,6,0,30,24
1657066592817,MATH 18,A02,083744,Cinel; Cameron Alexander,15,0,30,15
1657066592817,MATH 18,A03,083745,Cinel; Cameron Alexander,8,0,30,22
1657066592817,MATH 18,B01,083748,Rideout; David Porter,4,0,37,33
1657066592817,MATH 18,B02,083749,Rideout; David Porter,3,0,36,33
1657066592817,MATH 18,B03,083750,Rideout; David Porter,2,0,37,35
1657066592817,MATH 18,B04,083751,Rideout; David Porter,5,0,36,31
1657066592817,MATH 18,B05,093473,Rideout; David Porter,4,0,36,32
1657066592817,MATH 18,B06,093474,Rideout; David Porter,5,0,36,31
1657066599076,MATH 20A,A01,083754,Zheng; Zequn,12,0,40,28
1657066605104,MATH 20B,A01,083756,Briones; Jor-el Thomas Caparas,1,0,36,35
1657066605104,MATH 20B,A02,083757,Briones; Jor-el Thomas Caparas,1,0,36,35
1657066605104,MATH 20B,A03,093475,Briones; Jor-el Thomas Caparas,0,0,36,36
1657066611133,MATH 20C,A01,083760,Briones; Jor-el Thomas Caparas,1,0,35,34
1657066611133,MATH 20C,A02,083761,Briones; Jor-el Thomas Caparas,8,0,35,27
1657066611133,MATH 20C,A03,093476,Briones; Jor-el Thomas Caparas,0,1,36,36
1657066611133,MATH 20C,B01,083762,Bach; Quang Tran,0,0,30,30
1657066617162,MATH 20D,A01,083765,Tran; Brian Kha,4,0,30,26
1657066617162,MATH 20D,A02,083766,Tran; Brian Kha,5,0,30,25
1657066617162,MATH 20D,A03,083767,Tran; Brian Kha,3,0,30,27
1657066623190,MATH 20E,A01,083771,Ganguly; Soumya,5,0,32,27
1657066623190,MATH 20E,A02,083772,Ganguly; Soumya,6,0,32,26
1657066623190,MATH 20E,B01,083773,Ciotti; Benjamin,18,0,35,17
1657066623190,MATH 20E,B02,083774,Ciotti; Benjamin,17,0,35,18
1657066629225,MATH 103A,A01,083777,Greenfeld; Be'Eri,2,0,36,34
1657066629225,MATH 103A,A02,083778,Greenfeld; Be'Eri,5,0,36,31
1657066629225,MATH 103A,A03,093561,Greenfeld; Be'Eri,4,0,36,32
1657066629225,MATH 103A,B01,083779,Greenfeld; Be'Eri,6,0,36,30
1657066629225,MATH 103A,B02,083780,Greenfeld; Be'Eri,2,0,36,34
1657066629225,MATH 103A,B03,093562,Greenfeld; Be'Eri,3,0,36,33
1657066635252,MATH 105,A01,085443,Carter; Anne Toulson,14,0,35,21
1657066635252,MATH 105,A02,093477,Carter; Anne Toulson,20,0,35,15
1657066641282,MATH 109,A01,083213,Ganzberger; Geoffrey Michael,2,0,34,32
1657066641282,MATH 109,A02,083214,Ganzberger; Geoffrey Michael,2,0,34,32
1657066641282,MATH 109,A03,093478,Ganzberger; Geoffrey Michael,1,0,34,33
1657066641282,MATH 109,B01,083215,Ganzberger; Geoffrey Michael,1,0,32,31
1657066641282,MATH 109,B02,083216,Ganzberger; Geoffrey Michael,1,0,32,31
1657066641282,MATH 109,B03,093479,Ganzberger; Geoffrey Michael,6,0,32,26
1657066647307,MATH 142A,A01,083219,Chow; Bennett,6,0,32,26
1657066647307,MATH 142A,A02,083220,Chow; Bennett,10,0,32,22
1657066647307,MATH 142A,A03,093480,Chow; Bennett,7,0,32,25
1657066647307,MATH 142A,B03,093481,Chow; Bennett,7,0,32,25
1657066647307,MATH 142A,B04,093558,Chow; Bennett,11,0,32,21
1657066647307,MATH 142A,B05,093559,Chow; Bennett,6,0,32,26
1657066653334,MATH 193A,A01,083224,Rotar; Vladimir,7,0,34,27
1657066653334,MATH 193A,A02,083225,Rotar; Vladimir,5,0,34,29
1657066653334,MATH 193A,A03,083781,Rotar; Vladimir,1,0,34,33
1657066653334,MATH 193A,A04,083782,Rotar; Vladimir,6,0,34,28
1657066653334,MATH 193A,A05,093482,Rotar; Vladimir,6,0,34,28
1657066659359,MATH 197,001,091859,McAuley; Julian John,9999,0,9999,0
1657066659359,MATH 197,002,095566,Kedlaya; Kiran S.,9997,0,9999,2
1657066659359,MATH 197,003,095567,Xiao; Ming,9999,0,9999,0
1657066659359,MATH 197,004,095571,Perols; Johan Lars,9998,0,9999,1
1657066666423,COGS 9,A01,083615,Shannon; Kyle Michael,7,0,75,68
1657066672448,COGS 11,A01,083617,Boyle; Mary E. T.,21,0,48,27
1657066678472,COGS 13,A01,083071,Bastos; Amalia Pinkusfeld,9,0,71,62
1657066684495,COGS 14A,A01,092681,Semenuks; Arturs,0,1,100,100
1657066690519,COGS 14B,A01,083073,Cheng; Tzu-Han,5,0,63,58
1657066696542,COGS 17,A01,092677,Semenuks; Arturs,4,0,81,77
1657066702568,COGS 100,A01,083619,Allen; Michael Gordon,15,0,70,55
1657066708596,COGS 101A,A01,083621,Davis; Joshua Daniel,9,0,68,59
1657066714622,COGS 101B,A01,091572,Allen; Michael Gordon,8,0,65,57
1657066720644,COGS 101C,A01,083625,Delgado; Tania,17,0,35,18
1657066726665,COGS 107A,A01,083627,Boyle; Mary E. T.,13,0,60,47
1657066732695,COGS 118A,A01,083075,Gupta; Anjum,15,0,76,61
1657066738719,CSE 3,A50,083646,Miranda; Gregory Joseph,22,0,50,28
1657066744750,CSE 8A,A50,083650,Miranda; Gregory Joseph,17,1,56,39
1657066750774,CSE 11,A01,083080,Cao; Yingjun,4,15,40,36
1657066756796,CSE 12,A01,083652,Krause-Levy; Sophia Louisa,23,1,120,97
1657066762819,CSE 15L,A01,083654,Morris; Justin Loren,8,0,50,42
1657066762819,CSE 15L,A02,083655,Morris; Justin Loren,9,0,50,41
1657066768844,CSE 20,A01,083657,Tran; Khoa Dang,37,0,80,43
1657066774871,CSE 21,A01,095574,Bach; Quang Tran,21,0,48,27
1657066780894,CSE 30,A01,083084,Eldon; John,4,0,80,76
1657066780894,CSE 30,B01,095061,Bhaskar; Nishant,6,0,50,44
1657066786917,CSE 100,A01,083659,Cao; Yingjun,3,4,70,67
1657066792950,CSE 134B,A01,083661,Powell; Thomas Allan,19,0,100,81
1657066798978,CSE 140,A01,083663,Gungor; Onat,14,0,85,71
1657066805000,CSE 140L,A01,083088,Eldon; John,16,0,100,84
1657066811026,CSE 175,A01,083665,Kumar; Rakesh,3,0,25,22
1657066817048,CSE 190,A00,092507,Dubnov; Shlomo,7,0,20,13
1657066823071,ECE 45,A01,083139,Congero; Spencer William,5,0,75,70
1657066829103,ECE 65,A50,083695,Saad; Andrew S,12,0,30,18
1657066829103,ECE 65,A51,095125,Saad; Andrew S,25,0,26,1
1657066835135,ECE 109,A01,091882,Touri; Behrouz,16,0,70,54
1657066841168,ECE 180,A00,083140,Abi Samra; Nicholas Camill,1,0,30,29
1657066841168,ECE 180,B00,083141,Abi Samra; Nicholas Camill,0,0,30,30
1657066847194,MATH 10A,A01,083735,Patchell; Gregory David,1,0,30,29
1657066847194,MATH 10A,A02,083736,Patchell; Gregory David,20,0,30,10
1657066847194,MATH 10A,A03,083737,Patchell; Gregory David,16,0,30,14
1657066853219,MATH 10B,A01,083207,Lim; Seonhee,7,0,34,27
1657066853219,MATH 10B,A02,083208,Lim; Seonhee,9,0,35,26
1657066853219,MATH 10B,A03,093472,Lim; Seonhee,4,0,34,30
1657066853219,MATH 10B,B01,083739,Sinha; Shubham,9,0,30,21
1657066859245,MATH 18,A01,083743,Cinel; Cameron Alexander,6,0,30,24
1657066859245,MATH 18,A02,083744,Cinel; Cameron Alexander,15,0,30,15
1657066859245,MATH 18,A03,083745,Cinel; Cameron Alexander,8,0,30,22
1657066859245,MATH 18,B01,083748,Rideout; David Porter,4,0,37,33
1657066859245,MATH 18,B02,083749,Rideout; David Porter,3,0,36,33
1657066859245,MATH 18,B03,083750,Rideout; David Porter,2,0,37,35
1657066859245,MATH 18,B04,083751,Rideout; David Porter,5,0,36,31
1657066859245,MATH 18,B05,093473,Rideout; David Porter,4,0,36,32
1657066859245,MATH 18,B06,093474,Rideout; David Porter,5,0,36,31
1657066865270,MATH 20A,A01,083754,Zheng; Zequn,12,0,40,28
1657066871298,MATH 20B,A01,083756,Briones; Jor-el Thomas Caparas,1,0,36,35
1657066871298,MATH 20B,A02,083757,Briones; Jor-el Thomas Caparas,1,0,36,35
1657066871298,MATH 20B,A03,093475,Briones; Jor-el Thomas Caparas,0,0,36,36
1657066877327,MATH 20C,A01,083760,Briones; Jor-el Thomas Caparas,1,0,35,34
1657066877327,MATH 20C,A02,083761,Briones; Jor-el Thomas Caparas,8,0,35,27
1657066877327,MATH 20C,A03,093476,Briones; Jor-el Thomas Caparas,0,1,36,36
1657066877327,MATH 20C,B01,083762,Bach; Quang Tran,0,0,30,30
1657066883352,MATH 20D,A01,083765,Tran; Brian Kha,4,0,30,26
1657066883352,MATH 20D,A02,083766,Tran; Brian Kha,5,0,30,25
1657066883352,MATH 20D,A03,083767,Tran; Brian Kha,3,0,30,27
1657066889374,MATH 20E,A01,083771,Ganguly; Soumya,5,0,32,27
1657066889374,MATH 20E,A02,083772,Ganguly; Soumya,6,0,32,26
1657066889374,MATH 20E,B01,083773,Ciotti; Benjamin,18,0,35,17
1657066889374,MATH 20E,B02,083774,Ciotti; Benjamin,17,0,35,18
1657066895406,MATH 103A,A01,083777,Greenfeld; Be'Eri,2,0,36,34
1657066895406,MATH 103A,A02,083778,Greenfeld; Be'Eri,5,0,36,31
1657066895406,MATH 103A,A03,093561,Greenfeld; Be'Eri,4,0,36,32
1657066895406,MATH 103A,B01,083779,Greenfeld; Be'Eri,6,0,36,30
1657066895406,MATH 103A,B02,083780,Greenfeld; Be'Eri,2,0,36,34
1657066895406,MATH 103A,B03,093562,Greenfeld; Be'Eri,3,0,36,33
1657066901436,MATH 105,A01,085443,Carter; Anne Toulson,14,0,35,21
1657066901436,MATH 105,A02,093477,Carter; Anne Toulson,20,0,35,15
1657066907462,MATH 109,A01,083213,Ganzberger; Geoffrey Michael,2,0,34,32
1657066907462,MATH 109,A02,083214,Ganzberger; Geoffrey Michael,2,0,34,32
1657066907462,MATH 109,A03,093478,Ganzberger; Geoffrey Michael,1,0,34,33
1657066907462,MATH 109,B01,083215,Ganzberger; Geoffrey Michael,1,0,32,31
1657066907462,MATH 109,B02,083216,Ganzberger; Geoffrey Michael,1,0,32,31
1657066907462,MATH 109,B03,093479,Ganzberger; Geoffrey Michael,6,0,32,26
1657066913488,MATH 142A,A01,083219,Chow; Bennett,6,0,32,26
1657066913488,MATH 142A,A02,083220,Chow; Bennett,10,0,32,22
1657066913488,MATH 142A,A03,093480,Chow; Bennett,7,0,32,25
1657066913488,MATH 142A,B03,093481,Chow; Bennett,7,0,32,25
1657066913488,MATH 142A,B04,093558,Chow; Bennett,11,0,32,21
1657066913488,MATH 142A,B05,093559,Chow; Bennett,6,0,32,26
1657066919516,MATH 193A,A01,083224,Rotar; Vladimir,7,0,34,27
1657066919516,MATH 193A,A02,083225,Rotar; Vladimir,5,0,34,29
1657066919516,MATH 193A,A03,083781,Rotar; Vladimir,1,0,34,33
1657066919516,MATH 193A,A04,083782,Rotar; Vladimir,6,0,34,28
1657066919516,MATH 193A,A05,093482,Rotar; Vladimir,6,0,34,28
1657066925544,MATH 197,001,091859,McAuley; Julian John,9999,0,9999,0
1657066925544,MATH 197,002,095566,Kedlaya; Kiran S.,9997,0,9999,2
1657066925544,MATH 197,003,095567,Xiao; Ming,9999,0,9999,0
1657066925544,MATH 197,004,095571,Perols; Johan Lars,9998,0,9999,1
1657066932599,COGS 9,A01,083615,Shannon; Kyle Michael,7,0,75,68
1657066938627,COGS 11,A01,083617,Boyle; Mary E. T.,21,0,48,27
1657066944652,COGS 13,A01,083071,Bastos; Amalia Pinkusfeld,9,0,71,62
1657066950677,COGS 14A,A01,092681,Semenuks; Arturs,0,1,100,100
1657066956705,COGS 14B,A01,083073,Cheng; Tzu-Han,5,0,63,58
1657066962729,COGS 17,A01,092677,Semenuks; Arturs,4,0,81,77
1657066968752,COGS 100,A01,083619,Allen; Michael Gordon,15,0,70,55
1657066974776,COGS 101A,A01,083621,Davis; Joshua Daniel,9,0,68,59
1657066980803,COGS 101B,A01,091572,Allen; Michael Gordon,8,0,65,57
1657066986826,COGS 101C,A01,083625,Delgado; Tania,17,0,35,18
1657066992849,COGS 107A,A01,083627,Boyle; Mary E. T.,13,0,60,47
1657066998879,COGS 118A,A01,083075,Gupta; Anjum,15,0,76,61
1657067004907,CSE 3,A50,083646,Miranda; Gregory Joseph,22,0,50,28
1657067010931,CSE 8A,A50,083650,Miranda; Gregory Joseph,17,1,56,39
1657067016958,CSE 11,A01,083080,Cao; Yingjun,4,15,40,36
1657067022980,CSE 12,A01,083652,Krause-Levy; Sophia Louisa,23,1,120,97
1657067029003,CSE 15L,A01,083654,Morris; Justin Loren,8,0,50,42
1657067029003,CSE 15L,A02,083655,Morris; Justin Loren,9,0,50,41
1657067035025,CSE 20,A01,083657,Tran; Khoa Dang,37,0,80,43
1657067041049,CSE 21,A01,095574,Bach; Quang Tran,21,0,48,27
1657067047072,CSE 30,A01,083084,Eldon; John,4,0,80,76
1657067047072,CSE 30,B01,095061,Bhaskar; Nishant,6,0,50,44
1657067053098,CSE 100,A01,083659,Cao; Yingjun,3,4,70,67
1657067059125,CSE 134B,A01,083661,Powell; Thomas Allan,19,0,100,81
1657067065148,CSE 140,A01,083663,Gungor; Onat,14,0,85,71
1657067071177,CSE 140L,A01,083088,Eldon; John,16,0,100,84
1657067077203,CSE 175,A01,083665,Kumar; Rakesh,3,0,25,22
1657067083231,CSE 190,A00,092507,Dubnov; Shlomo,7,0,20,13
1657067089254,ECE 45,A01,083139,Congero; Spencer William,5,0,75,70
1657067095281,ECE 65,A50,083695,Saad; Andrew S,12,0,30,18
1657067095281,ECE 65,A51,095125,Saad; Andrew S,25,0,26,1
1657067101308,ECE 109,A01,091882,Touri; Behrouz,16,0,70,54
1657067107331,ECE 180,A00,083140,Abi Samra; Nicholas Camill,1,0,30,29
1657067107331,ECE 180,B00,083141,Abi Samra; Nicholas Camill,0,0,30,30
1657067113355,MATH 10A,A01,083735,Patchell; Gregory David,1,0,30,29
1657067113355,MATH 10A,A02,083736,Patchell; Gregory David,20,0,30,10
1657067113355,MATH 10A,A03,083737,Patchell; Gregory David,16,0,30,14
1657067119380,MATH 10B,A01,083207,Lim; Seonhee,7,0,34,27
1657067119380,MATH 10B,A02,083208,Lim; Seonhee,9,0,35,26
1657067119380,MATH 10B,A03,093472,Lim; Seonhee,4,0,34,30
1657067119380,MATH 10B,B01,083739,Sinha; Shubham,9,0,30,21
1657067125413,MATH 18,A01,083743,Cinel; Cameron Alexander,6,0,30,24
1657067125413,MATH 18,A02,083744,Cinel; Cameron Alexander,15,0,30,15
1657067125413,MATH 18,A03,083745,Cinel; Cameron Alexander,8,0,30,22
1657067125413,MATH 18,B01,083748,Rideout; David Porter,4,0,37,33
1657067125413,MATH 18,B02,083749,Rideout; David Porter,3,0,36,33
1657067125413,MATH 18,B03,083750,Rideout; David Porter,2,0,37,35
1657067125413,MATH 18,B04,083751,Rideout; David Porter,5,0,36,31
1657067125413,MATH 18,B05,093473,Rideout; David Porter,4,0,36,32
1657067125413,MATH 18,B06,093474,Rideout; David Porter,5,0,36,31
1657067131435,MATH 20A,A01,083754,Zheng; Zequn,12,0,40,28
1657067137461,MATH 20B,A01,083756,Briones; Jor-el Thomas Caparas,1,0,36,35
1657067137461,MATH 20B,A02,083757,Briones; Jor-el Thomas Caparas,1,0,36,35
1657067137461,MATH 20B,A03,093475,Briones; Jor-el Thomas Caparas,0,0,36,36
1657067143498,MATH 20C,A01,083760,Briones; Jor-el Thomas Caparas,1,0,35,34
1657067143498,MATH 20C,A02,083761,Briones; Jor-el Thomas Caparas,8,0,35,27
1657067143498,MATH 20C,A03,093476,Briones; Jor-el Thomas Caparas,0,1,36,36
1657067143498,MATH 20C,B01,083762,Bach; Quang Tran,0,0,30,30
1657067149529,MATH 20D,A01,083765,Tran; Brian Kha,4,0,30,26
1657067149529,MATH 20D,A02,083766,Tran; Brian Kha,5,0,30,25
1657067149529,MATH 20D,A03,083767,Tran; Brian Kha,3,0,30,27
1657067155563,MATH 20E,A01,083771,Ganguly; Soumya,5,0,32,27
1657067155563,MATH 20E,A02,083772,Ganguly; Soumya,6,0,32,26
1657067155563,MATH 20E,B01,083773,Ciotti; Benjamin,18,0,35,17
1657067155563,MATH 20E,B02,083774,Ciotti; Benjamin,17,0,35,18
1657067161590,MATH 103A,A01,083777,Greenfeld; Be'Eri,2,0,36,34
1657067161590,MATH 103A,A02,083778,Greenfeld; Be'Eri,5,0,36,31
1657067161590,MATH 103A,A03,093561,Greenfeld; Be'Eri,4,0,36,32
1657067161590,MATH 103A,B01,083779,Greenfeld; Be'Eri,6,0,36,30
1657067161590,MATH 103A,B02,083780,Greenfeld; Be'Eri,2,0,36,34
1657067161590,MATH 103A,B03,093562,Greenfeld; Be'Eri,3,0,36,33
1657067167619,MATH 105,A01,085443,Carter; Anne Toulson,14,0,35,21
1657067167619,MATH 105,A02,093477,Carter; Anne Toulson,20,0,35,15
1657067173645,MATH 109,A01,083213,Ganzberger; Geoffrey Michael,2,0,34,32
1657067173645,MATH 109,A02,083214,Ganzberger; Geoffrey Michael,2,0,34,32
1657067173645,MATH 109,A03,093478,Ganzberger; Geoffrey Michael,1,0,34,33
1657067173645,MATH 109,B01,083215,Ganzberger; Geoffrey Michael,1,0,32,31
1657067173645,MATH 109,B02,083216,Ganzberger; Geoffrey Michael,1,0,32,31
1657067173645,MATH 109,B03,093479,Ganzberger; Geoffrey Michael,6,0,32,26
1657067179672,MATH 142A,A01,083219,Chow; Bennett,6,0,32,26
1657067179672,MATH 142A,A02,083220,Chow; Bennett,10,0,32,22
1657067179672,MATH 142A,A03,093480,Chow; Bennett,7,0,32,25
1657067179672,MATH 142A,B03,093481,Chow; Bennett,7,0,32,25
1657067179672,MATH 142A,B04,093558,Chow; Bennett,11,0,32,21
1657067179672,MATH 142A,B05,093559,Chow; Bennett,6,0,32,26
1657067185698,MATH 193A,A01,083224,Rotar; Vladimir,7,0,34,27
1657067185698,MATH 193A,A02,083225,Rotar; Vladimir,5,0,34,29
1657067185698,MATH 193A,A03,083781,Rotar; Vladimir,1,0,34,33
1657067185698,MATH 193A,A04,083782,Rotar; Vladimir,6,0,34,28
1657067185698,MATH 193A,A05,093482,Rotar; Vladimir,6,0,34,28
1657067191747,MATH 197,001,091859,McAuley; Julian John,9999,0,9999,0
1657067191747,MATH 197,002,095566,Kedlaya; Kiran S.,9997,0,9999,2
1657067191747,MATH 197,003,095567,Xiao; Ming,9999,0,9999,0
1657067191747,MATH 197,004,095571,Perols; Johan Lars,9998,0,9999,1
1657067198881,COGS 9,A01,083615,Shannon; Kyle Michael,7,0,75,68
1657067204909,COGS 11,A01,083617,Boyle; Mary E. T.,21,0,48,27
1657067210936,COGS 13,A01,083071,Bastos; Amalia Pinkusfeld,9,0,71,62
1657067216963,COGS 14A,A01,092681,Semenuks; Arturs,0,1,100,100
1657067222986,COGS 14B,A01,083073,Cheng; Tzu-Han,5,0,63,58
1657067229014,COGS 17,A01,092677,Semenuks; Arturs,4,0,81,77
1657067235035,COGS 100,A01,083619,Allen; Michael Gordon,15,0,70,55
1657067241059,COGS 101A,A01,083621,Davis; Joshua Daniel,9,0,68,59
1657067247084,COGS 101B,A01,091572,Allen; Michael Gordon,8,0,65,57
1657067253107,COGS 101C,A01,083625,Delgado; Tania,17,0,35,18
1657067259130,COGS 107A,A01,083627,Boyle; Mary E. T.,13,0,60,47
1657067265154,COGS 118A,A01,083075,Gupta; Anjum,15,0,76,61
1657067271182,CSE 3,A50,083646,Miranda; Gregory Joseph,22,0,50,28
1657067277205,CSE 8A,A50,083650,Miranda; Gregory Joseph,17,1,56,39
1657067283241,CSE 11,A01,083080,Cao; Yingjun,4,15,40,36
1657067289265,CSE 12,A01,083652,Krause-Levy; Sophia Louisa,23,1,120,97
1657067295290,CSE 15L,A01,083654,Morris; Justin Loren,8,0,50,42
1657067295290,CSE 15L,A02,083655,Morris; Justin Loren,9,0,50,41
1657067301321,CSE 20,A01,083657,Tran; Khoa Dang,37,0,80,43
1657067307360,CSE 21,A01,095574,Bach; Quang Tran,21,0,48,27
1657067313388,CSE 30,A01,083084,Eldon; John,4,0,80,76
1657067313388,CSE 30,B01,095061,Bhaskar; Nishant,6,0,50,44
1657067319411,CSE 100,A01,083659,Cao; Yingjun,3,4,70,67
1657067325434,CSE 134B,A01,083661,Powell; Thomas Allan,19,0,100,81
1657067331483,CSE 140,A01,083663,Gungor; Onat,14,0,85,71
1657067337511,CSE 140L,A01,083088,Eldon; John,16,0,100,84
1657067343536,CSE 175,A01,083665,Kumar; Rakesh,3,0,25,22
1657067349559,CSE 190,A00,092507,Dubnov; Shlomo,7,0,20,13
1657067355587,ECE 45,A01,083139,Congero; Spencer William,5,0,75,70
1657067361614,ECE 65,A50,083695,Saad; Andrew S,12,0,30,18
1657067361614,ECE 65,A51,095125,Saad; Andrew S,25,0,26,1
1657067367641,ECE 109,A01,091882,Touri; Behrouz,16,0,70,54
1657067373668,ECE 180,A00,083140,Abi Samra; Nicholas Camill,1,0,30,29
1657067373668,ECE 180,B00,083141,Abi Samra; Nicholas Camill,0,0,30,30
1657067379692,MATH 10A,A01,083735,Patchell; Gregory David,1,0,30,29
1657067379692,MATH 10A,A02,083736,Patchell; Gregory David,20,0,30,10
1657067379692,MATH 10A,A03,083737,Patchell; Gregory David,16,0,30,14
1657067385720,MATH 10B,A01,083207,Lim; Seonhee,7,0,34,27
1657067385720,MATH 10B,A02,083208,Lim; Seonhee,9,0,35,26
1657067385720,MATH 10B,A03,093472,Lim; Seonhee,4,0,34,30
1657067385720,MATH 10B,B01,083739,Sinha; Shubham,9,0,30,21
1657067391751,MATH 18,A01,083743,Cinel; Cameron Alexander,6,0,30,24
1657067391751,MATH 18,A02,083744,Cinel; Cameron Alexander,15,0,30,15
1657067391751,MATH 18,A03,083745,Cinel; Cameron Alexander,8,0,30,22
1657067391751,MATH 18,B01,083748,Rideout; David Porter,4,0,37,33
1657067391751,MATH 18,B02,083749,Rideout; David Porter,3,0,36,33
1657067391751,MATH 18,B03,083750,Rideout; David Porter,2,0,37,35
1657067391751,MATH 18,B04,083751,Rideout; David Porter,5,0,36,31
1657067391751,MATH 18,B05,093473,Rideout; David Porter,4,0,36,32
1657067391751,MATH 18,B06,093474,Rideout; David Porter,5,0,36,31
1657067397784,MATH 20A,A01,083754,Zheng; Zequn,12,0,40,28
1657067403811,MATH 20B,A01,083756,Briones; Jor-el Thomas Caparas,1,0,36,35
1657067403811,MATH 20B,A02,083757,Briones; Jor-el Thomas Caparas,1,0,36,35
1657067403811,MATH 20B,A03,093475,Briones; Jor-el Thomas Caparas,0,0,36,36
1657067409839,MATH 20C,A01,083760,Briones; Jor-el Thomas Caparas,1,0,35,34
1657067409839,MATH 20C,A02,083761,Briones; Jor-el Thomas Caparas,8,0,35,27
1657067409839,MATH 20C,A03,093476,Briones; Jor-el Thomas Caparas,0,1,36,36
1657067409839,MATH 20C,B01,083762,Bach; Quang Tran,0,0,30,30
1657067415872,MATH 20D,A01,083765,Tran; Brian Kha,4,0,30,26
1657067415872,MATH 20D,A02,083766,Tran; Brian Kha,5,0,30,25
1657067415872,MATH 20D,A03,083767,Tran; Brian Kha,3,0,30,27
1657067421898,MATH 20E,A01,083771,Ganguly; Soumya,5,0,32,27
1657067421898,MATH 20E,A02,083772,Ganguly; Soumya,6,0,32,26
1657067421898,MATH 20E,B01,083773,Ciotti; Benjamin,18,0,35,17
1657067421898,MATH 20E,B02,083774,Ciotti; Benjamin,17,0,35,18
1657067427933,MATH 103A,A01,083777,Greenfeld; Be'Eri,2,0,36,34
1657067427933,MATH 103A,A02,083778,Greenfeld; Be'Eri,5,0,36,31
1657067427933,MATH 103A,A03,093561,Greenfeld; Be'Eri,4,0,36,32
1657067427933,MATH 103A,B01,083779,Greenfeld; Be'Eri,6,0,36,30
1657067427933,MATH 103A,B02,083780,Greenfeld; Be'Eri,2,0,36,34
1657067427933,MATH 103A,B03,093562,Greenfeld; Be'Eri,3,0,36,33
1657067433962,MATH 105,A01,085443,Carter; Anne Toulson,14,0,35,21
1657067433962,MATH 105,A02,093477,Carter; Anne Toulson,20,0,35,15
1657067439993,MATH 109,A01,083213,Ganzberger; Geoffrey Michael,2,0,34,32
1657067439993,MATH 109,A02,083214,Ganzberger; Geoffrey Michael,2,0,34,32
1657067439993,MATH 109,A03,093478,Ganzberger; Geoffrey Michael,1,0,34,33
1657067439993,MATH 109,B01,083215,Ganzberger; Geoffrey Michael,1,0,32,31
1657067439993,MATH 109,B02,083216,Ganzberger; Geoffrey Michael,1,0,32,31
1657067439993,MATH 109,B03,093479,Ganzberger; Geoffrey Michael,6,0,32,26
1657067446017,MATH 142A,A01,083219,Chow; Bennett,6,0,32,26
1657067446017,MATH 142A,A02,083220,Chow; Bennett,10,0,32,22
1657067446017,MATH 142A,A03,093480,Chow; Bennett,7,0,32,25
1657067446017,MATH 142A,B03,093481,Chow; Bennett,7,0,32,25
1657067446017,MATH 142A,B04,093558,Chow; Bennett,11,0,32,21
1657067446017,MATH 142A,B05,093559,Chow; Bennett,6,0,32,26
1657067452044,MATH 193A,A01,083224,Rotar; Vladimir,7,0,34,27
1657067452044,MATH 193A,A02,083225,Rotar; Vladimir,5,0,34,29
1657067452044,MATH 193A,A03,083781,Rotar; Vladimir,1,0,34,33
1657067452044,MATH 193A,A04,083782,Rotar; Vladimir,6,0,34,28
1657067452044,MATH 193A,A05,093482,Rotar; Vladimir,6,0,34,28
1657067458069,MATH 197,001,091859,McAuley; Julian John,9999,0,9999,0
1657067458069,MATH 197,002,095566,Kedlaya; Kiran S.,9997,0,9999,2
1657067458069,MATH 197,003,095567,Xiao; Ming,9999,0,9999,0
1657067458069,MATH 197,004,095571,Perols; Johan Lars,9998,0,9999,1
1657067465127,COGS 9,A01,083615,Shannon; Kyle Michael,7,0,75,68
1657067471151,COGS 11,A01,083617,Boyle; Mary E. T.,21,0,48,27
1657067477179,COGS 13,A01,083071,Bastos; Amalia Pinkusfeld,9,0,71,62
1657067483203,COGS 14A,A01,092681,Semenuks; Arturs,0,1,100,100
1657067489231,COGS 14B,A01,083073,Cheng; Tzu-Han,5,0,63,58
1657067495255,COGS 17,A01,092677,Semenuks; Arturs,4,0,81,77
1657067501289,COGS 100,A01,083619,Allen; Michael Gordon,15,0,70,55
1657067507318,COGS 101A,A01,083621,Davis; Joshua Daniel,9,0,68,59
1657067513342,COGS 101B,A01,091572,Allen; Michael Gordon,8,0,65,57
1657067519369,COGS 101C,A01,083625,Delgado; Tania,17,0,35,18
1657067525392,COGS 107A,A01,083627,Boyle; Mary E. T.,13,0,60,47
1657067531416,COGS 118A,A01,083075,Gupta; Anjum,15,0,76,61
1657067537440,CSE 3,A50,083646,Miranda; Gregory Joseph,22,0,50,28
1657067543465,CSE 8A,A50,083650,Miranda; Gregory Joseph,17,1,56,39
1657067549492,CSE 11,A01,083080,Cao; Yingjun,4,15,40,36
1657067555516,CSE 12,A01,083652,Krause-Levy; Sophia Louisa,23,1,120,97
1657067561542,CSE 15L,A01,083654,Morris; Justin Loren,8,0,50,42
1657067561542,CSE 15L,A02,083655,Morris; Justin Loren,9,0,50,41
1657067567565,CSE 20,A01,083657,Tran; Khoa Dang,37,0,80,43
1657067573587,CSE 21,A01,095574,Bach; Quang Tran,21,0,48,27
1657067579613,CSE 30,A01,083084,Eldon; John,4,0,80,76
1657067579613,CSE 30,B01,095061,Bhaskar; Nishant,6,0,50,44
1657067585642,CSE 100,A01,083659,Cao; Yingjun,3,4,70,67
1657067591669,CSE 134B,A01,083661,Powell; Thomas Allan,19,0,100,81
1657067597697,CSE 140,A01,083663,Gungor; Onat,14,0,85,71
1657067603719,CSE 140L,A01,083088,Eldon; John,16,0,100,84
1657067609742,CSE 175,A01,083665,Kumar; Rakesh,3,0,25,22
1657067615769,CSE 190,A00,092507,Dubnov; Shlomo,7,0,20,13
1657067621795,ECE 45,A01,083139,Congero; Spencer William,5,0,75,70
1657067627827,ECE 65,A50,083695,Saad; Andrew S,12,0,30,18
1657067627827,ECE 65,A51,095125,Saad; Andrew S,25,0,26,1
1657067633849,ECE 109,A01,091882,Touri; Behrouz,16,0,70,54
1657067639881,ECE 180,A00,083140,Abi Samra; Nicholas Camill,1,0,30,29
1657067639881,ECE 180,B00,083141,Abi Samra; Nicholas Camill,0,0,30,30
1657067645910,MATH 10A,A01,083735,Patchell; Gregory David,1,0,30,29
1657067645910,MATH 10A,A02,083736,Patchell; Gregory David,20,0,30,10
1657067645910,MATH 10A,A03,083737,Patchell; Gregory David,16,0,30,14
1657067651937,MATH 10B,A01,083207,Lim; Seonhee,7,0,34,27
1657067651937,MATH 10B,A02,083208,Lim; Seonhee,9,0,35,26
1657067651937,MATH 10B,A03,093472,Lim; Seonhee,4,0,34,30
1657067651937,MATH 10B,B01,083739,Sinha; Shubham,9,0,30,21
1657067657969,MATH 18,A01,083743,Cinel; Cameron Alexander,6,0,30,24
1657067657969,MATH 18,A02,083744,Cinel; Cameron Alexander,15,0,30,15
1657067657969,MATH 18,A03,083745,Cinel; Cameron Alexander,8,0,30,22
1657067657969,MATH 18,B01,083748,Rideout; David Porter,4,0,37,33
1657067657969,MATH 18,B02,083749,Rideout; David Porter,3,0,36,33
1657067657969,MATH 18,B03,083750,Rideout; David Porter,2,0,37,35
1657067657969,MATH 18,B04,083751,Rideout; David Porter,5,0,36,31
1657067657969,MATH 18,B05,093473,Rideout; David Porter,4,0,36,32
1657067657969,MATH 18,B06,093474,Rideout; David Porter,5,0,36,31
1657067663996,MATH 20A,A01,083754,Zheng; Zequn,12,0,40,28
1657067670028,MATH 20B,A01,083756,Briones; Jor-el Thomas Caparas,1,0,36,35
1657067670028,MATH 20B,A02,083757,Briones; Jor-el Thomas Caparas,1,0,36,35
1657067670028,MATH 20B,A03,093475,Briones; Jor-el Thomas Caparas,0,0,36,36
1657067676056,MATH 20C,A01,083760,Briones; Jor-el Thomas Caparas,1,0,35,34
1657067676056,MATH 20C,A02,083761,Briones; Jor-el Thomas Caparas,8,0,35,27
1657067676056,MATH 20C,A03,093476,Briones; Jor-el Thomas Caparas,0,1,36,36
1657067676056,MATH 20C,B01,083762,Bach; Quang Tran,0,0,30,30
1657067682084,MATH 20D,A01,083765,Tran; Brian Kha,4,0,30,26
1657067682084,MATH 20D,A02,083766,Tran; Brian Kha,5,0,30,25
1657067682084,MATH 20D,A03,083767,Tran; Brian Kha,3,0,30,27
1657067688107,MATH 20E,A01,083771,Ganguly; Soumya,5,0,32,27
1657067688107,MATH 20E,A02,083772,Ganguly; Soumya,6,0,32,26
1657067688107,MATH 20E,B01,083773,Ciotti; Benjamin,18,0,35,17
1657067688107,MATH 20E,B02,083774,Ciotti; Benjamin,17,0,35,18
1657067694132,MATH 103A,A01,083777,Greenfeld; Be'Eri,2,0,36,34
1657067694132,MATH 103A,A02,083778,Greenfeld; Be'Eri,5,0,36,31
1657067694132,MATH 103A,A03,093561,Greenfeld; Be'Eri,4,0,36,32
1657067694132,MATH 103A,B01,083779,Greenfeld; Be'Eri,6,0,36,30
1657067694132,MATH 103A,B02,083780,Greenfeld; Be'Eri,2,0,36,34
1657067694132,MATH 103A,B03,093562,Greenfeld; Be'Eri,3,0,36,33
1657067700159,MATH 105,A01,085443,Carter; Anne Toulson,14,0,35,21
1657067700159,MATH 105,A02,093477,Carter; Anne Toulson,20,0,35,15
1657067706186,MATH 109,A01,083213,Ganzberger; Geoffrey Michael,2,0,34,32
1657067706186,MATH 109,A02,083214,Ganzberger; Geoffrey Michael,2,0,34,32
1657067706186,MATH 109,A03,093478,Ganzberger; Geoffrey Michael,1,0,34,33
1657067706186,MATH 109,B01,083215,Ganzberger; Geoffrey Michael,1,0,32,31
1657067706186,MATH 109,B02,083216,Ganzberger; Geoffrey Michael,1,0,32,31
1657067706186,MATH 109,B03,093479,Ganzberger; Geoffrey Michael,6,0,32,26
1657067712210,MATH 142A,A01,083219,Chow; Bennett,6,0,32,26
1657067712210,MATH 142A,A02,083220,Chow; Bennett,10,0,32,22
1657067712210,MATH 142A,A03,093480,Chow; Bennett,7,0,32,25
1657067712210,MATH 142A,B03,093481,Chow; Bennett,7,0,32,25
1657067712210,MATH 142A,B04,093558,Chow; Bennett,11,0,32,21
1657067712210,MATH 142A,B05,093559,Chow; Bennett,6,0,32,26
1657067718233,MATH 193A,A01,083224,Rotar; Vladimir,7,0,34,27
1657067718233,MATH 193A,A02,083225,Rotar; Vladimir,5,0,34,29
1657067718233,MATH 193A,A03,083781,Rotar; Vladimir,1,0,34,33
1657067718233,MATH 193A,A04,083782,Rotar; Vladimir,6,0,34,28
1657067718233,MATH 193A,A05,093482,Rotar; Vladimir,6,0,34,28
1657067724261,MATH 197,001,091859,McAuley; Julian John,9999,0,9999,0
1657067724261,MATH 197,002,095566,Kedlaya; Kiran S.,9997,0,9999,2
1657067724261,MATH 197,003,095567,Xiao; Ming,9999,0,9999,0
1657067724261,MATH 197,004,095571,Perols; Johan Lars,9998,0,9999,1
1657067731314,COGS 9,A01,083615,Shannon; Kyle Michael,7,0,75,68
1657067737337,COGS 11,A01,083617,Boyle; Mary E. T.,21,0,48,27
1657067743370,COGS 13,A01,083071,Bastos; Amalia Pinkusfeld,9,0,71,62
1657067749393,COGS 14A,A01,092681,Semenuks; Arturs,0,1,100,100
1657067755419,COGS 14B,A01,083073,Cheng; Tzu-Han,5,0,63,58
1657067761440,COGS 17,A01,092677,Semenuks; Arturs,4,0,81,77
1657067767464,COGS 100,A01,083619,Allen; Michael Gordon,15,0,70,55
1657067773494,COGS 101A,A01,083621,Davis; Joshua Daniel,9,0,68,59
1657067779517,COGS 101B,A01,091572,Allen; Michael Gordon,8,0,65,57
1657067785542,COGS 101C,A01,083625,Delgado; Tania,17,0,35,18
1657067791649,COGS 107A,A01,083627,Boyle; Mary E. T.,13,0,60,47
1657067797673,COGS 118A,A01,083075,Gupta; Anjum,15,0,76,61
1657067803699,CSE 3,A50,083646,Miranda; Gregory Joseph,22,0,50,28
1657067809722,CSE 8A,A50,083650,Miranda; Gregory Joseph,17,1,56,39
1657067815745,CSE 11,A01,083080,Cao; Yingjun,4,15,40,36
1657067821767,CSE 12,A01,083652,Krause-Levy; Sophia Louisa,23,1,120,97
1657067827788,CSE 15L,A01,083654,Morris; Justin Loren,8,0,50,42
1657067827788,CSE 15L,A02,083655,Morris; Justin Loren,9,0,50,41
1657067833809,CSE 20,A01,083657,Tran; Khoa Dang,37,0,80,43
1657067839834,CSE 21,A01,095574,Bach; Quang Tran,21,0,48,27
1657067845855,CSE 30,A01,083084,Eldon; John,4,0,80,76
1657067845855,CSE 30,B01,095061,Bhaskar; Nishant,6,0,50,44
1657067851879,CSE 100,A01,083659,Cao; Yingjun,3,4,70,67
1657067857904,CSE 134B,A01,083661,Powell; Thomas Allan,19,0,100,81
1657067863931,CSE 140,A01,083663,Gungor; Onat,14,0,85,71
1657067869956,CSE 140L,A01,083088,Eldon; John,16,0,100,84
1657067876063,CSE 175,A01,083665,Kumar; Rakesh,3,0,25,22
1657067882084,CSE 190,A00,092507,Dubnov; Shlomo,7,0,20,13
1657067888107,ECE 45,A01,083139,Congero; Spencer William,5,0,75,70
1657067894134,ECE 65,A50,083695,Saad; Andrew S,12,0,30,18
1657067894134,ECE 65,A51,095125,Saad; Andrew S,25,0,26,1
1657067900160,ECE 109,A01,091882,Touri; Behrouz,16,0,70,54
1657067906185,ECE 180,A00,083140,Abi Samra; Nicholas Camill,1,0,30,29
1657067906185,ECE 180,B00,083141,Abi Samra; Nicholas Camill,0,0,30,30
1657067912208,MATH 10A,A01,083735,Patchell; Gregory David,1,0,30,29
1657067912208,MATH 10A,A02,083736,Patchell; Gregory David,20,0,30,10
1657067912208,MATH 10A,A03,083737,Patchell; Gregory David,16,0,30,14
1657067918231,MATH 10B,A01,083207,Lim; Seonhee,7,0,34,27
1657067918231,MATH 10B,A02,083208,Lim; Seonhee,9,0,35,26
1657067918231,MATH 10B,A03,093472,Lim; Seonhee,4,0,34,30
1657067918231,MATH 10B,B01,083739,Sinha; Shubham,9,0,30,21
1657067924253,MATH 18,A01,083743,Cinel; Cameron Alexander,6,0,30,24
1657067924253,MATH 18,A02,083744,Cinel; Cameron Alexander,15,0,30,15
1657067924253,MATH 18,A03,083745,Cinel; Cameron Alexander,8,0,30,22
1657067924253,MATH 18,B01,083748,Rideout; David Porter,4,0,37,33
1657067924253,MATH 18,B02,083749,Rideout; David Porter,3,0,36,33
1657067924253,MATH 18,B03,083750,Rideout; David Porter,2,0,37,35
1657067924253,MATH 18,B04,083751,Rideout; David Porter,5,0,36,31
1657067924253,MATH 18,B05,093473,Rideout; David Porter,4,0,36,32
1657067924253,MATH 18,B06,093474,Rideout; David Porter,5,0,36,31
1657067930280,MATH 20A,A01,083754,Zheng; Zequn,12,0,40,28
1657067936302,MATH 20B,A01,083756,Briones; Jor-el Thomas Caparas,1,0,36,35
1657067936302,MATH 20B,A02,083757,Briones; Jor-el Thomas Caparas,1,0,36,35
1657067936302,MATH 20B,A03,093475,Briones; Jor-el Thomas Caparas,0,0,36,36
1657067942331,MATH 20C,A01,083760,Briones; Jor-el Thomas Caparas,1,0,35,34
1657067942331,MATH 20C,A02,083761,Briones; Jor-el Thomas Caparas,8,0,35,27
1657067942331,MATH 20C,A03,093476,Briones; Jor-el Thomas Caparas,0,1,36,36
1657067942331,MATH 20C,B01,083762,Bach; Quang Tran,0,0,30,30
1657067948358,MATH 20D,A01,083765,Tran; Brian Kha,4,0,30,26
1657067948358,MATH 20D,A02,083766,Tran; Brian Kha,5,0,30,25
1657067948358,MATH 20D,A03,083767,Tran; Brian Kha,3,0,30,27
1657067954391,MATH 20E,A01,083771,Ganguly; Soumya,5,0,32,27
1657067954391,MATH 20E,A02,083772,Ganguly; Soumya,6,0,32,26
1657067954391,MATH 20E,B01,083773,Ciotti; Benjamin,18,0,35,17
1657067954391,MATH 20E,B02,083774,Ciotti; Benjamin,17,0,35,18
1657067960419,MATH 103A,A01,083777,Greenfeld; Be'Eri,2,0,36,34
1657067960419,MATH 103A,A02,083778,Greenfeld; Be'Eri,5,0,36,31
1657067960419,MATH 103A,A03,093561,Greenfeld; Be'Eri,4,0,36,32
1657067960419,MATH 103A,B01,083779,Greenfeld; Be'Eri,6,0,36,30
1657067960419,MATH 103A,B02,083780,Greenfeld; Be'Eri,2,0,36,34
1657067960419,MATH 103A,B03,093562,Greenfeld; Be'Eri,3,0,36,33
1657067966442,MATH 105,A01,085443,Carter; Anne Toulson,14,0,35,21
1657067966442,MATH 105,A02,093477,Carter; Anne Toulson,20,0,35,15
1657067972466,MATH 109,A01,083213,Ganzberger; Geoffrey Michael,2,0,34,32
1657067972466,MATH 109,A02,083214,Ganzberger; Geoffrey Michael,2,0,34,32
1657067972466,MATH 109,A03,093478,Ganzberger; Geoffrey Michael,1,0,34,33
1657067972466,MATH 109,B01,083215,Ganzberger; Geoffrey Michael,1,0,32,31
1657067972466,MATH 109,B02,083216,Ganzberger; Geoffrey Michael,1,0,32,31
1657067972466,MATH 109,B03,093479,Ganzberger; Geoffrey Michael,6,0,32,26
1657067978498,MATH 142A,A01,083219,Chow; Bennett,6,0,32,26
1657067978498,MATH 142A,A02,083220,Chow; Bennett,10,0,32,22
1657067978498,MATH 142A,A03,093480,Chow; Bennett,7,0,32,25
1657067978498,MATH 142A,B03,093481,Chow; Bennett,7,0,32,25
1657067978498,MATH 142A,B04,093558,Chow; Bennett,11,0,32,21
1657067978498,MATH 142A,B05,093559,Chow; Bennett,6,0,32,26
1657067984526,MATH 193A,A01,083224,Rotar; Vladimir,7,0,34,27
1657067984526,MATH 193A,A02,083225,Rotar; Vladimir,5,0,34,29
1657067984526,MATH 193A,A03,083781,Rotar; Vladimir,1,0,34,33
1657067984526,MATH 193A,A04,083782,Rotar; Vladimir,6,0,34,28
1657067984526,MATH 193A,A05,093482,Rotar; Vladimir,6,0,34,28
1657067990549,MATH 197,001,091859,McAuley; Julian John,9999,0,9999,0
1657067990549,MATH 197,002,095566,Kedlaya; Kiran S.,9997,0,9999,2
1657067990549,MATH 197,003,095567,Xiao; Ming,9999,0,9999,0
1657067990549,MATH 197,004,095571,Perols; Johan Lars,9998,0,9999,1
1657067997609,COGS 9,A01,083615,Shannon; Kyle Michael,7,0,75,68
1657068003634,COGS 11,A01,083617,Boyle; Mary E. T.,21,0,48,27
1657068009659,COGS 13,A01,083071,Bastos; Amalia Pinkusfeld,9,0,71,62
1657068015686,COGS 14A,A01,092681,Semenuks; Arturs,0,1,100,100
1657068021709,COGS 14B,A01,083073,Cheng; Tzu-Han,5,0,63,58
1657068027731,COGS 17,A01,092677,Semenuks; Arturs,4,0,81,77
1657068033754,COGS 100,A01,083619,Allen; Michael Gordon,15,0,70,55
1657068039781,COGS 101A,A01,083621,Davis; Joshua Daniel,9,0,68,59
1657068045804,COGS 101B,A01,091572,Allen; Michael Gordon,8,0,65,57
1657068051842,COGS 101C,A01,083625,Delgado; Tania,17,0,35,18
1657068057876,COGS 107A,A01,083627,Boyle; Mary E. T.,13,0,60,47
1657068063899,COGS 118A,A01,083075,Gupta; Anjum,15,0,76,61
1657068069928,CSE 3,A50,083646,Miranda; Gregory Joseph,22,0,50,28
1657068075950,CSE 8A,A50,083650,Miranda; Gregory Joseph,17,1,56,39
1657068081973,CSE 11,A01,083080,Cao; Yingjun,4,15,40,36
1657068087995,CSE 12,A01,083652,Krause-Levy; Sophia Louisa,23,1,120,97
1657068094018,CSE 15L,A01,083654,Morris; Justin Loren,8,0,50,42
1657068094018,CSE 15L,A02,083655,Morris; Justin Loren,9,0,50,41
1657068100044,CSE 20,A01,083657,Tran; Khoa Dang,37,0,80,43
1657068106068,CSE 21,A01,095574,Bach; Quang Tran,21,0,48,27
1657068112095,CSE 30,A01,083084,Eldon; John,4,0,80,76
1657068112095,CSE 30,B01,095061,Bhaskar; Nishant,6,0,50,44
1657068118118,CSE 100,A01,083659,Cao; Yingjun,3,4,70,67
1657068124160,CSE 134B,A01,083661,Powell; Thomas Allan,19,0,100,81
1657068130191,CSE 140,A01,083663,Gungor; Onat,14,0,85,71
1657068136218,CSE 140L,A01,083088,Eldon; John,16,0,100,84
1657068142244,CSE 175,A01,083665,Kumar; Rakesh,3,0,25,22
1657068148266,CSE 190,A00,092507,Dubnov; Shlomo,7,0,20,13
1657068154293,ECE 45,A01,083139,Congero; Spencer William,5,0,75,70
1657068160320,ECE 65,A50,083695,Saad; Andrew S,12,0,30,18
1657068160320,ECE 65,A51,095125,Saad; Andrew S,25,0,26,1
1657068166346,ECE 109,A01,091882,Touri; Behrouz,16,0,70,54
1657068172373,ECE 180,A00,083140,Abi Samra; Nicholas Camill,1,0,30,29
1657068172373,ECE 180,B00,083141,Abi Samra; Nicholas Camill,0,0,30,30
1657068178394,MATH 10A,A01,083735,Patchell; Gregory David,1,0,30,29
1657068178394,MATH 10A,A02,083736,Patchell; Gregory David,20,0,30,10
1657068178394,MATH 10A,A03,083737,Patchell; Gregory David,16,0,30,14
1657068184417,MATH 10B,A01,083207,Lim; Seonhee,7,0,34,27
1657068184417,MATH 10B,A02,083208,Lim; Seonhee,9,0,35,26
1657068184417,MATH 10B,A03,093472,Lim; Seonhee,4,0,34,30
1657068184417,MATH 10B,B01,083739,Sinha; Shubham,9,0,30,21
1657068190448,MATH 18,A01,083743,Cinel; Cameron Alexander,6,0,30,24
1657068190448,MATH 18,A02,083744,Cinel; Cameron Alexander,15,0,30,15
1657068190448,MATH 18,A03,083745,Cinel; Cameron Alexander,8,0,30,22
1657068190448,MATH 18,B01,083748,Rideout; David Porter,4,0,37,33
1657068190448,MATH 18,B02,083749,Rideout; David Porter,3,0,36,33
1657068190448,MATH 18,B03,083750,Rideout; David Porter,2,0,37,35
1657068190448,MATH 18,B04,083751,Rideout; David Porter,5,0,36,31
1657068190448,MATH 18,B05,093473,Rideout; David Porter,4,0,36,32
1657068190448,MATH 18,B06,093474,Rideout; David Porter,5,0,36,31
1657068196474,MATH 20A,A01,083754,Zheng; Zequn,12,0,40,28
1657068202506,MATH 20B,A01,083756,Briones; Jor-el Thomas Caparas,1,0,36,35
1657068202506,MATH 20B,A02,083757,Briones; Jor-el Thomas Caparas,1,0,36,35
1657068202506,MATH 20B,A03,093475,Briones; Jor-el Thomas Caparas,0,0,36,36
1657068208529,MATH 20C,A01,083760,Briones; Jor-el Thomas Caparas,1,0,35,34
1657068208529,MATH 20C,A02,083761,Briones; Jor-el Thomas Caparas,8,0,35,27
1657068208529,MATH 20C,A03,093476,Briones; Jor-el Thomas Caparas,0,1,36,36
1657068208529,MATH 20C,B01,083762,Bach; Quang Tran,0,0,30,30
1657068214553,MATH 20D,A01,083765,Tran; Brian Kha,4,0,30,26
1657068214553,MATH 20D,A02,083766,Tran; Brian Kha,5,0,30,25
1657068214553,MATH 20D,A03,083767,Tran; Brian Kha,3,0,30,27
1657068220576,MATH 20E,A01,083771,Ganguly; Soumya,5,0,32,27
1657068220576,MATH 20E,A02,083772,Ganguly; Soumya,6,0,32,26
1657068220576,MATH 20E,B01,083773,Ciotti; Benjamin,18,0,35,17
1657068220576,MATH 20E,B02,083774,Ciotti; Benjamin,17,0,35,18
1657068226599,MATH 103A,A01,083777,Greenfeld; Be'Eri,2,0,36,34
1657068226599,MATH 103A,A02,083778,Greenfeld; Be'Eri,5,0,36,31
1657068226599,MATH 103A,A03,093561,Greenfeld; Be'Eri,4,0,36,32
1657068226599,MATH 103A,B01,083779,Greenfeld; Be'Eri,6,0,36,30
1657068226599,MATH 103A,B02,083780,Greenfeld; Be'Eri,2,0,36,34
1657068226599,MATH 103A,B03,093562,Greenfeld; Be'Eri,3,0,36,33
1657068232622,MATH 105,A01,085443,Carter; Anne Toulson,14,0,35,21
1657068232622,MATH 105,A02,093477,Carter; Anne Toulson,20,0,35,15
1657068238649,MATH 109,A01,083213,Ganzberger; Geoffrey Michael,2,0,34,32
1657068238649,MATH 109,A02,083214,Ganzberger; Geoffrey Michael,2,0,34,32
1657068238649,MATH 109,A03,093478,Ganzberger; Geoffrey Michael,1,0,34,33
1657068238649,MATH 109,B01,083215,Ganzberger; Geoffrey Michael,1,0,32,31
1657068238649,MATH 109,B02,083216,Ganzberger; Geoffrey Michael,1,0,32,31
1657068238649,MATH 109,B03,093479,Ganzberger; Geoffrey Michael,6,0,32,26
1657068244687,MATH 142A,A01,083219,Chow; Bennett,6,0,32,26
1657068244687,MATH 142A,A02,083220,Chow; Bennett,10,0,32,22
1657068244687,MATH 142A,A03,093480,Chow; Bennett,7,0,32,25
1657068244687,MATH 142A,B03,093481,Chow; Bennett,7,0,32,25
1657068244687,MATH 142A,B04,093558,Chow; Bennett,11,0,32,21
1657068244687,MATH 142A,B05,093559,Chow; Bennett,6,0,32,26
1657068250719,MATH 193A,A01,083224,Rotar; Vladimir,7,0,34,27
1657068250719,MATH 193A,A02,083225,Rotar; Vladimir,5,0,34,29
1657068250719,MATH 193A,A03,083781,Rotar; Vladimir,1,0,34,33
1657068250719,MATH 193A,A04,083782,Rotar; Vladimir,6,0,34,28
1657068250719,MATH 193A,A05,093482,Rotar; Vladimir,6,0,34,28
1657068256743,MATH 197,001,091859,McAuley; Julian John,9999,0,9999,0
1657068256743,MATH 197,002,095566,Kedlaya; Kiran S.,9997,0,9999,2
1657068256743,MATH 197,003,095567,Xiao; Ming,9999,0,9999,0
1657068256743,MATH 197,004,095571,Perols; Johan Lars,9998,0,9999,1
1657068263812,COGS 9,A01,083615,Shannon; Kyle Michael,7,0,75,68
1657068269835,COGS 11,A01,083617,Boyle; Mary E. T.,21,0,48,27
1657068275869,COGS 13,A01,083071,Bastos; Amalia Pinkusfeld,9,0,71,62
1657068281903,COGS 14A,A01,092681,Semenuks; Arturs,0,1,100,100
1657068287929,COGS 14B,A01,083073,Cheng; Tzu-Han,5,0,63,58
1657068293957,COGS 17,A01,092677,Semenuks; Arturs,4,0,81,77
1657068299987,COGS 100,A01,083619,Allen; Michael Gordon,15,0,70,55
1657068306010,COGS 101A,A01,083621,Davis; Joshua Daniel,9,0,68,59
1657068312036,COGS 101B,A01,091572,Allen; Michael Gordon,8,0,65,57
1657068318058,COGS 101C,A01,083625,Delgado; Tania,17,0,35,18
1657068324085,COGS 107A,A01,083627,Boyle; Mary E. T.,13,0,60,47
1657068330110,COGS 118A,A01,083075,Gupta; Anjum,15,0,76,61
1657068336139,CSE 3,A50,083646,Miranda; Gregory Joseph,22,0,50,28
1657068342162,CSE 8A,A50,083650,Miranda; Gregory Joseph,17,1,56,39
1657068348186,CSE 11,A01,083080,Cao; Yingjun,4,15,40,36
1657068354208,CSE 12,A01,083652,Krause-Levy; Sophia Louisa,23,1,120,97
1657068360244,CSE 15L,A01,083654,Morris; Justin Loren,8,0,50,42
1657068360244,CSE 15L,A02,083655,Morris; Justin Loren,9,0,50,41
1657068366278,CSE 20,A01,083657,Tran; Khoa Dang,37,0,80,43
1657068372306,CSE 21,A01,095574,Bach; Quang Tran,21,0,48,27
1657068378331,CSE 30,A01,083084,Eldon; John,4,0,80,76
1657068378331,CSE 30,B01,095061,Bhaskar; Nishant,6,0,50,44
1657068384358,CSE 100,A01,083659,Cao; Yingjun,3,4,70,67
1657068390452,CSE 134B,A01,083661,Powell; Thomas Allan,19,0,100,81
1657068396484,CSE 140,A01,083663,Gungor; Onat,14,0,85,71
1657068402508,CSE 140L,A01,083088,Eldon; John,16,0,100,84
1657068408535,CSE 175,A01,083665,Kumar; Rakesh,3,0,25,22
1657068414558,CSE 190,A00,092507,Dubnov; Shlomo,7,0,20,13
1657068420593,ECE 45,A01,083139,Congero; Spencer William,5,0,75,70
1657068426616,ECE 65,A50,083695,Saad; Andrew S,12,0,30,18
1657068426616,ECE 65,A51,095125,Saad; Andrew S,25,0,26,1
1657068432643,ECE 109,A01,091882,Touri; Behrouz,16,0,70,54
1657068438670,ECE 180,A00,083140,Abi Samra; Nicholas Camill,1,0,30,29
1657068438670,ECE 180,B00,083141,Abi Samra; Nicholas Camill,0,0,30,30
1657068444705,MATH 10A,A01,083735,Patchell; Gregory David,1,0,30,29
1657068444705,MATH 10A,A02,083736,Patchell; Gregory David,20,0,30,10
1657068444705,MATH 10A,A03,083737,Patchell; Gregory David,16,0,30,14
1657068450734,MATH 10B,A01,083207,Lim; Seonhee,7,0,34,27
1657068450734,MATH 10B,A02,083208,Lim; Seonhee,9,0,35,26
1657068450734,MATH 10B,A03,093472,Lim; Seonhee,4,0,34,30
1657068450734,MATH 10B,B01,083739,Sinha; Shubham,9,0,30,21
1657068456759,MATH 18,A01,083743,Cinel; Cameron Alexander,6,0,30,24
1657068456759,MATH 18,A02,083744,Cinel; Cameron Alexander,15,0,30,15
1657068456759,MATH 18,A03,083745,Cinel; Cameron Alexander,8,0,30,22
1657068456759,MATH 18,B01,083748,Rideout; David Porter,4,0,37,33
1657068456759,MATH 18,B02,083749,Rideout; David Porter,3,0,36,33
1657068456759,MATH 18,B03,083750,Rideout; David Porter,2,0,37,35
1657068456759,MATH 18,B04,083751,Rideout; David Porter,5,0,36,31
1657068456759,MATH 18,B05,093473,Rideout; David Porter,4,0,36,32
1657068456759,MATH 18,B06,093474,Rideout; David Porter,5,0,36,31
1657068462782,MATH 20A,A01,083754,Zheng; Zequn,12,0,40,28
1657068468806,MATH 20B,A01,083756,Briones; Jor-el Thomas Caparas,1,0,36,35
1657068468806,MATH 20B,A02,083757,Briones; Jor-el Thomas Caparas,1,0,36,35
1657068468806,MATH 20B,A03,093475,Briones; Jor-el Thomas Caparas,0,0,36,36
1657068474833,MATH 20C,A01,083760,Briones; Jor-el Thomas Caparas,1,0,35,34
1657068474833,MATH 20C,A02,083761,Briones; Jor-el Thomas Caparas,8,0,35,27
1657068474833,MATH 20C,A03,093476,Briones; Jor-el Thomas Caparas,0,1,36,36
1657068474833,MATH 20C,B01,083762,Bach; Quang Tran,0,0,30,30
1657068480874,MATH 20D,A01,083765,Tran; Brian Kha,4,0,30,26
1657068480874,MATH 20D,A02,083766,Tran; Brian Kha,5,0,30,25
1657068480874,MATH 20D,A03,083767,Tran; Brian Kha,3,0,30,27
1657068486905,MATH 20E,A01,083771,Ganguly; Soumya,5,0,32,27
1657068486905,MATH 20E,A02,083772,Ganguly; Soumya,6,0,32,26
1657068486905,MATH 20E,B01,083773,Ciotti; Benjamin,18,0,35,17
1657068486905,MATH 20E,B02,083774,Ciotti; Benjamin,17,0,35,18
1657068492929,MATH 103A,A01,083777,Greenfeld; Be'Eri,2,0,36,34
1657068492929,MATH 103A,A02,083778,Greenfeld; Be'Eri,5,0,36,31
1657068492929,MATH 103A,A03,093561,Greenfeld; Be'Eri,4,0,36,32
1657068492929,MATH 103A,B01,083779,Greenfeld; Be'Eri,6,0,36,30
1657068492929,MATH 103A,B02,083780,Greenfeld; Be'Eri,2,0,36,34
1657068492929,MATH 103A,B03,093562,Greenfeld; Be'Eri,3,0,36,33
1657068498957,MATH 105,A01,085443,Carter; Anne Toulson,14,0,35,21
1657068498957,MATH 105,A02,093477,Carter; Anne Toulson,20,0,35,15
1657068504980,MATH 109,A01,083213,Ganzberger; Geoffrey Michael,2,0,34,32
1657068504980,MATH 109,A02,083214,Ganzberger; Geoffrey Michael,2,0,34,32
1657068504980,MATH 109,A03,093478,Ganzberger; Geoffrey Michael,1,0,34,33
1657068504980,MATH 109,B01,083215,Ganzberger; Geoffrey Michael,1,0,32,31
1657068504980,MATH 109,B02,083216,Ganzberger; Geoffrey Michael,1,0,32,31
1657068504980,MATH 109,B03,093479,Ganzberger; Geoffrey Michael,6,0,32,26
1657068511004,MATH 142A,A01,083219,Chow; Bennett,6,0,32,26
1657068511004,MATH 142A,A02,083220,Chow; Bennett,10,0,32,22
1657068511004,MATH 142A,A03,093480,Chow; Bennett,7,0,32,25
1657068511004,MATH 142A,B03,093481,Chow; Bennett,7,0,32,25
1657068511004,MATH 142A,B04,093558,Chow; Bennett,11,0,32,21
1657068511004,MATH 142A,B05,093559,Chow; Bennett,6,0,32,26
1657068517032,MATH 193A,A01,083224,Rotar; Vladimir,7,0,34,27
1657068517032,MATH 193A,A02,083225,Rotar; Vladimir,5,0,34,29
1657068517032,MATH 193A,A03,083781,Rotar; Vladimir,1,0,34,33
1657068517032,MATH 193A,A04,083782,Rotar; Vladimir,6,0,34,28
1657068517032,MATH 193A,A05,093482,Rotar; Vladimir,6,0,34,28
1657068523056,MATH 197,001,091859,McAuley; Julian John,9999,0,9999,0
1657068523056,MATH 197,002,095566,Kedlaya; Kiran S.,9997,0,9999,2
1657068523056,MATH 197,003,095567,Xiao; Ming,9999,0,9999,0
1657068523056,MATH 197,004,095571,Perols; Johan Lars,9998,0,9999,1
1657068530119,COGS 9,A01,083615,Shannon; Kyle Michael,7,0,75,68
1657068536146,COGS 11,A01,083617,Boyle; Mary E. T.,21,0,48,27
1657068542175,COGS 13,A01,083071,Bastos; Amalia Pinkusfeld,9,0,71,62
1657068548202,COGS 14A,A01,092681,Semenuks; Arturs,0,1,100,100
1657068554228,COGS 14B,A01,083073,Cheng; Tzu-Han,5,0,63,58
1657068560251,COGS 17,A01,092677,Semenuks; Arturs,4,0,81,77
1657068566278,COGS 100,A01,083619,Allen; Michael Gordon,15,0,70,55
1657068572302,COGS 101A,A01,083621,Davis; Joshua Daniel,9,0,68,59
1657068578326,COGS 101B,A01,091572,Allen; Michael Gordon,8,0,65,57
1657068584349,COGS 101C,A01,083625,Delgado; Tania,17,0,35,18
1657068590372,COGS 107A,A01,083627,Boyle; Mary E. T.,13,0,60,47
1657068596396,COGS 118A,A01,083075,Gupta; Anjum,15,0,76,61
1657068602420,CSE 3,A50,083646,Miranda; Gregory Joseph,22,0,50,28
1657068608443,CSE 8A,A50,083650,Miranda; Gregory Joseph,17,1,56,39
1657068614465,CSE 11,A01,083080,Cao; Yingjun,4,15,40,36
1657068620489,CSE 12,A01,083652,Krause-Levy; Sophia Louisa,23,1,120,97
1657068626517,CSE 15L,A01,083654,Morris; Justin Loren,8,0,50,42
1657068626517,CSE 15L,A02,083655,Morris; Justin Loren,9,0,50,41
1657068632543,CSE 20,A01,083657,Tran; Khoa Dang,37,0,80,43
1657068638565,CSE 21,A01,095574,Bach; Quang Tran,21,0,48,27
1657068644594,CSE 30,A01,083084,Eldon; John,4,0,80,76
1657068644594,CSE 30,B01,095061,Bhaskar; Nishant,6,0,50,44
1657068650621,CSE 100,A01,083659,Cao; Yingjun,3,4,70,67
1657068656645,CSE 134B,A01,083661,Powell; Thomas Allan,19,0,100,81
1657068662670,CSE 140,A01,083663,Gungor; Onat,14,0,85,71
1657068668692,CSE 140L,A01,083088,Eldon; John,16,0,100,84
1657068674717,CSE 175,A01,083665,Kumar; Rakesh,3,0,25,22
1657068680740,CSE 190,A00,092507,Dubnov; Shlomo,7,0,20,13
1657068686767,ECE 45,A01,083139,Congero; Spencer William,5,0,75,70
1657068692793,ECE 65,A50,083695,Saad; Andrew S,12,0,30,18
1657068692793,ECE 65,A51,095125,Saad; Andrew S,25,0,26,1
1657068698815,ECE 109,A01,091882,Touri; Behrouz,16,0,70,54
1657068704842,ECE 180,A00,083140,Abi Samra; Nicholas Camill,1,0,30,29
1657068704842,ECE 180,B00,083141,Abi Samra; Nicholas Camill,0,0,30,30
1657068710867,MATH 10A,A01,083735,Patchell; Gregory David,1,0,30,29
1657068710867,MATH 10A,A02,083736,Patchell; Gregory David,20,0,30,10
1657068710867,MATH 10A,A03,083737,Patchell; Gregory David,16,0,30,14
1657068716891,MATH 10B,A01,083207,Lim; Seonhee,7,0,34,27
1657068716891,MATH 10B,A02,083208,Lim; Seonhee,9,0,35,26
1657068716891,MATH 10B,A03,093472,Lim; Seonhee,4,0,34,30
1657068716891,MATH 10B,B01,083739,Sinha; Shubham,9,0,30,21
1657068722913,MATH 18,A01,083743,Cinel; Cameron Alexander,6,0,30,24
1657068722913,MATH 18,A02,083744,Cinel; Cameron Alexander,15,0,30,15
1657068722913,MATH 18,A03,083745,Cinel; Cameron Alexander,8,0,30,22
1657068722913,MATH 18,B01,083748,Rideout; David Porter,4,0,37,33
1657068722913,MATH 18,B02,083749,Rideout; David Porter,3,0,36,33
1657068722913,MATH 18,B03,083750,Rideout; David Porter,2,0,37,35
1657068722913,MATH 18,B04,083751,Rideout; David Porter,5,0,36,31
1657068722913,MATH 18,B05,093473,Rideout; David Porter,4,0,36,32
1657068722913,MATH 18,B06,093474,Rideout; David Porter,5,0,36,31
1657068728940,MATH 20A,A01,083754,Zheng; Zequn,12,0,40,28
1657068734963,MATH 20B,A01,083756,Briones; Jor-el Thomas Caparas,1,0,36,35
1657068734963,MATH 20B,A02,083757,Briones; Jor-el Thomas Caparas,1,0,36,35
1657068734963,MATH 20B,A03,093475,Briones; Jor-el Thomas Caparas,0,0,36,36
1657068740992,MATH 20C,A01,083760,Briones; Jor-el Thomas Caparas,1,0,35,34
1657068740992,MATH 20C,A02,083761,Briones; Jor-el Thomas Caparas,8,0,35,27
1657068740992,MATH 20C,A03,093476,Briones; Jor-el Thomas Caparas,0,1,36,36
1657068740992,MATH 20C,B01,083762,Bach; Quang Tran,0,0,30,30
1657068747022,MATH 20D,A01,083765,Tran; Brian Kha,4,0,30,26
1657068747022,MATH 20D,A02,083766,Tran; Brian Kha,5,0,30,25
1657068747022,MATH 20D,A03,083767,Tran; Brian Kha,3,0,30,27
1657068753053,MATH 20E,A01,083771,Ganguly; Soumya,5,0,32,27
1657068753053,MATH 20E,A02,083772,Ganguly; Soumya,6,0,32,26
1657068753053,MATH 20E,B01,083773,Ciotti; Benjamin,18,0,35,17
1657068753053,MATH 20E,B02,083774,Ciotti; Benjamin,17,0,35,18
1657068759083,MATH 103A,A01,083777,Greenfeld; Be'Eri,2,0,36,34
1657068759083,MATH 103A,A02,083778,Greenfeld; Be'Eri,5,0,36,31
1657068759083,MATH 103A,A03,093561,Greenfeld; Be'Eri,4,0,36,32
1657068759083,MATH 103A,B01,083779,Greenfeld; Be'Eri,6,0,36,30
1657068759083,MATH 103A,B02,083780,Greenfeld; Be'Eri,2,0,36,34
1657068759083,MATH 103A,B03,093562,Greenfeld; Be'Eri,3,0,36,33
1657068765111,MATH 105,A01,085443,Carter; Anne Toulson,14,0,35,21
1657068765111,MATH 105,A02,093477,Carter; Anne Toulson,20,0,35,15
1657068771139,MATH 109,A01,083213,Ganzberger; Geoffrey Michael,2,0,34,32
1657068771139,MATH 109,A02,083214,Ganzberger; Geoffrey Michael,2,0,34,32
1657068771139,MATH 109,A03,093478,Ganzberger; Geoffrey Michael,1,0,34,33
1657068771139,MATH 109,B01,083215,Ganzberger; Geoffrey Michael,1,0,32,31
1657068771139,MATH 109,B02,083216,Ganzberger; Geoffrey Michael,1,0,32,31
1657068771139,MATH 109,B03,093479,Ganzberger; Geoffrey Michael,6,0,32,26
1657068777164,MATH 142A,A01,083219,Chow; Bennett,6,0,32,26
1657068777164,MATH 142A,A02,083220,Chow; Bennett,10,0,32,22
1657068777164,MATH 142A,A03,093480,Chow; Bennett,7,0,32,25
1657068777164,MATH 142A,B03,093481,Chow; Bennett,7,0,32,25
1657068777164,MATH 142A,B04,093558,Chow; Bennett,11,0,32,21
1657068777164,MATH 142A,B05,093559,Chow; Bennett,6,0,32,26
1657068783194,MATH 193A,A01,083224,Rotar; Vladimir,7,0,34,27
1657068783194,MATH 193A,A02,083225,Rotar; Vladimir,5,0,34,29
1657068783194,MATH 193A,A03,083781,Rotar; Vladimir,1,0,34,33
1657068783194,MATH 193A,A04,083782,Rotar; Vladimir,6,0,34,28
1657068783194,MATH 193A,A05,093482,Rotar; Vladimir,6,0,34,28
1657068789221,MATH 197,001,091859,McAuley; Julian John,9999,0,9999,0
1657068789221,MATH 197,002,095566,Kedlaya; Kiran S.,9997,0,9999,2
1657068789221,MATH 197,003,095567,Xiao; Ming,9999,0,9999,0
1657068789221,MATH 197,004,095571,Perols; Johan Lars,9998,0,9999,1
1657068796284,COGS 9,A01,083615,Shannon; Kyle Michael,7,0,75,68
1657068802321,COGS 11,A01,083617,Boyle; Mary E. T.,21,0,48,27
1657068808345,COGS 13,A01,083071,Bastos; Amalia Pinkusfeld,9,0,71,62
1657068814371,COGS 14A,A01,092681,Semenuks; Arturs,0,1,100,100
1657068820394,COGS 14B,A01,083073,Cheng; Tzu-Han,5,0,63,58
1657068826419,COGS 17,A01,092677,Semenuks; Arturs,4,0,81,77
1657068832446,COGS 100,A01,083619,Allen; Michael Gordon,15,0,70,55
1657068838472,COGS 101A,A01,083621,Davis; Joshua Daniel,9,0,68,59
1657068844495,COGS 101B,A01,091572,Allen; Michael Gordon,8,0,65,57
1657068850522,COGS 101C,A01,083625,Delgado; Tania,17,0,35,18
1657068856546,COGS 107A,A01,083627,Boyle; Mary E. T.,13,0,60,47
1657068862568,COGS 118A,A01,083075,Gupta; Anjum,15,0,76,61
1657068868593,CSE 3,A50,083646,Miranda; Gregory Joseph,22,0,50,28
1657068874624,CSE 8A,A50,083650,Miranda; Gregory Joseph,17,1,56,39
1657068880648,CSE 11,A01,083080,Cao; Yingjun,4,15,40,36
1657068886674,CSE 12,A01,083652,Krause-Levy; Sophia Louisa,23,1,120,97
1657068892701,CSE 15L,A01,083654,Morris; Justin Loren,8,0,50,42
1657068892701,CSE 15L,A02,083655,Morris; Justin Loren,9,0,50,41
1657068898727,CSE 20,A01,083657,Tran; Khoa Dang,37,0,80,43
1657068904761,CSE 21,A01,095574,Bach; Quang Tran,21,0,48,27
1657068910783,CSE 30,A01,083084,Eldon; John,4,0,80,76
1657068910783,CSE 30,B01,095061,Bhaskar; Nishant,6,0,50,44
1657068916807,CSE 100,A01,083659,Cao; Yingjun,3,4,70,67
1657068922833,CSE 134B,A01,083661,Powell; Thomas Allan,19,0,100,81
1657068928856,CSE 140,A01,083663,Gungor; Onat,14,0,85,71
1657068934883,CSE 140L,A01,083088,Eldon; John,16,0,100,84
1657068940911,CSE 175,A01,083665,Kumar; Rakesh,3,0,25,22
1657068946933,CSE 190,A00,092507,Dubnov; Shlomo,7,0,20,13
1657068952961,ECE 45,A01,083139,Congero; Spencer William,5,0,75,70
1657068958987,ECE 65,A50,083695,Saad; Andrew S,12,0,30,18
1657068958987,ECE 65,A51,095125,Saad; Andrew S,25,0,26,1
1657068965011,ECE 109,A01,091882,Touri; Behrouz,16,0,70,54
1657068971035,ECE 180,A00,083140,Abi Samra; Nicholas Camill,1,0,30,29
1657068971035,ECE 180,B00,083141,Abi Samra; Nicholas Camill,0,0,30,30
1657068977063,MATH 10A,A01,083735,Patchell; Gregory David,1,0,30,29
1657068977063,MATH 10A,A02,083736,Patchell; Gregory David,20,0,30,10
1657068977063,MATH 10A,A03,083737,Patchell; Gregory David,16,0,30,14
1657068983087,MATH 10B,A01,083207,Lim; Seonhee,7,0,34,27
1657068983087,MATH 10B,A02,083208,Lim; Seonhee,9,0,35,26
1657068983087,MATH 10B,A03,093472,Lim; Seonhee,4,0,34,30
1657068983087,MATH 10B,B01,083739,Sinha; Shubham,9,0,30,21
1657068989206,MATH 18,A01,083743,Cinel; Cameron Alexander,6,0,30,24
1657068989206,MATH 18,A02,083744,Cinel; Cameron Alexander,15,0,30,15
1657068989206,MATH 18,A03,083745,Cinel; Cameron Alexander,8,0,30,22
1657068989206,MATH 18,B01,083748,Rideout; David Porter,4,0,37,33
1657068989206,MATH 18,B02,083749,Rideout; David Porter,3,0,36,33
1657068989206,MATH 18,B03,083750,Rideout; David Porter,2,0,37,35
1657068989206,MATH 18,B04,083751,Rideout; David Porter,5,0,36,31
1657068989206,MATH 18,B05,093473,Rideout; David Porter,4,0,36,32
1657068989206,MATH 18,B06,093474,Rideout; David Porter,5,0,36,31
1657068995233,MATH 20A,A01,083754,Zheng; Zequn,12,0,40,28
1657069001257,MATH 20B,A01,083756,Briones; Jor-el Thomas Caparas,1,0,36,35
1657069001257,MATH 20B,A02,083757,Briones; Jor-el Thomas Caparas,1,0,36,35
1657069001257,MATH 20B,A03,093475,Briones; Jor-el Thomas Caparas,0,0,36,36
1657069007282,MATH 20C,A01,083760,Briones; Jor-el Thomas Caparas,1,0,35,34
1657069007282,MATH 20C,A02,083761,Briones; Jor-el Thomas Caparas,8,0,35,27
1657069007282,MATH 20C,A03,093476,Briones; Jor-el Thomas Caparas,0,1,36,36
1657069007282,MATH 20C,B01,083762,Bach; Quang Tran,0,0,30,30
1657069013309,MATH 20D,A01,083765,Tran; Brian Kha,4,0,30,26
1657069013309,MATH 20D,A02,083766,Tran; Brian Kha,5,0,30,25
1657069013309,MATH 20D,A03,083767,Tran; Brian Kha,3,0,30,27
1657069019332,MATH 20E,A01,083771,Ganguly; Soumya,5,0,32,27
1657069019332,MATH 20E,A02,083772,Ganguly; Soumya,6,0,32,26
1657069019332,MATH 20E,B01,083773,Ciotti; Benjamin,18,0,35,17
1657069019332,MATH 20E,B02,083774,Ciotti; Benjamin,17,0,35,18
1657069025362,MATH 103A,A01,083777,Greenfeld; Be'Eri,2,0,36,34
1657069025362,MATH 103A,A02,083778,Greenfeld; Be'Eri,5,0,36,31
1657069025362,MATH 103A,A03,093561,Greenfeld; Be'Eri,4,0,36,32
1657069025362,MATH 103A,B01,083779,Greenfeld; Be'Eri,6,0,36,30
1657069025362,MATH 103A,B02,083780,Greenfeld; Be'Eri,2,0,36,34
1657069025362,MATH 103A,B03,093562,Greenfeld; Be'Eri,3,0,36,33
1657069031385,MATH 105,A01,085443,Carter; Anne Toulson,14,0,35,21
1657069031385,MATH 105,A02,093477,Carter; Anne Toulson,20,0,35,15
1657069037411,MATH 109,A01,083213,Ganzberger; Geoffrey Michael,2,0,34,32
1657069037411,MATH 109,A02,083214,Ganzberger; Geoffrey Michael,2,0,34,32
1657069037411,MATH 109,A03,093478,Ganzberger; Geoffrey Michael,1,0,34,33
1657069037411,MATH 109,B01,083215,Ganzberger; Geoffrey Michael,1,0,32,31
1657069037411,MATH 109,B02,083216,Ganzberger; Geoffrey Michael,1,0,32,31
1657069037411,MATH 109,B03,093479,Ganzberger; Geoffrey Michael,6,0,32,26
1657069043442,MATH 142A,A01,083219,Chow; Bennett,6,0,32,26
1657069043442,MATH 142A,A02,083220,Chow; Bennett,10,0,32,22
1657069043442,MATH 142A,A03,093480,Chow; Bennett,7,0,32,25
1657069043442,MATH 142A,B03,093481,Chow; Bennett,7,0,32,25
1657069043442,MATH 142A,B04,093558,Chow; Bennett,11,0,32,21
1657069043442,MATH 142A,B05,093559,Chow; Bennett,6,0,32,26
1657069049469,MATH 193A,A01,083224,Rotar; Vladimir,7,0,34,27
1657069049469,MATH 193A,A02,083225,Rotar; Vladimir,5,0,34,29
1657069049469,MATH 193A,A03,083781,Rotar; Vladimir,1,0,34,33
1657069049469,MATH 193A,A04,083782,Rotar; Vladimir,6,0,34,28
1657069049469,MATH 193A,A05,093482,Rotar; Vladimir,6,0,34,28
1657069055491,MATH 197,001,091859,McAuley; Julian John,9999,0,9999,0
1657069055491,MATH 197,002,095566,Kedlaya; Kiran S.,9997,0,9999,2
1657069055491,MATH 197,003,095567,Xiao; Ming,9999,0,9999,0
1657069055491,MATH 197,004,095571,Perols; Johan Lars,9998,0,9999,1
1657069062548,COGS 9,A01,083615,Shannon; Kyle Michael,7,0,75,68
1657069068570,COGS 11,A01,083617,Boyle; Mary E. T.,21,0,48,27
1657069074593,COGS 13,A01,083071,Bastos; Amalia Pinkusfeld,9,0,71,62
1657069080624,COGS 14A,A01,092681,Semenuks; Arturs,0,1,100,100
1657069086646,COGS 14B,A01,083073,Cheng; Tzu-Han,5,0,63,58
1657069092667,COGS 17,A01,092677,Semenuks; Arturs,4,0,81,77
1657069098690,COGS 100,A01,083619,Allen; Michael Gordon,15,0,70,55
1657069104713,COGS 101A,A01,083621,Davis; Joshua Daniel,9,0,68,59
1657069110740,COGS 101B,A01,091572,Allen; Michael Gordon,8,0,65,57
1657069116766,COGS 101C,A01,083625,Delgado; Tania,17,0,35,18
1657069122789,COGS 107A,A01,083627,Boyle; Mary E. T.,13,0,60,47
1657069128815,COGS 118A,A01,083075,Gupta; Anjum,15,0,76,61
1657069134842,CSE 3,A50,083646,Miranda; Gregory Joseph,22,0,50,28
1657069140876,CSE 8A,A50,083650,Miranda; Gregory Joseph,17,1,56,39
1657069146903,CSE 11,A01,083080,Cao; Yingjun,4,15,40,36
1657069152930,CSE 12,A01,083652,Krause-Levy; Sophia Louisa,23,1,120,97
1657069158957,CSE 15L,A01,083654,Morris; Justin Loren,8,0,50,42
1657069158957,CSE 15L,A02,083655,Morris; Justin Loren,9,0,50,41
1657069164984,CSE 20,A01,083657,Tran; Khoa Dang,37,0,80,43
1657069171011,CSE 21,A01,095574,Bach; Quang Tran,21,0,48,27
1657069177033,CSE 30,A01,083084,Eldon; John,4,0,80,76
1657069177033,CSE 30,B01,095061,Bhaskar; Nishant,6,0,50,44
1657069183058,CSE 100,A01,083659,Cao; Yingjun,3,4,70,67
1657069189083,CSE 134B,A01,083661,Powell; Thomas Allan,19,0,100,81
1657069195107,CSE 140,A01,083663,Gungor; Onat,14,0,85,71
1657069201129,CSE 140L,A01,083088,Eldon; John,16,0,100,84
1657069207157,CSE 175,A01,083665,Kumar; Rakesh,3,0,25,22
1657069213179,CSE 190,A00,092507,Dubnov; Shlomo,7,0,20,13
1657069219201,ECE 45,A01,083139,Congero; Spencer William,5,0,75,70
1657069225224,ECE 65,A50,083695,Saad; Andrew S,12,0,30,18
1657069225224,ECE 65,A51,095125,Saad; Andrew S,25,0,26,1
1657069231254,ECE 109,A01,091882,Touri; Behrouz,16,0,70,54
1657069237282,ECE 180,A00,083140,Abi Samra; Nicholas Camill,1,0,30,29
1657069237282,ECE 180,B00,083141,Abi Samra; Nicholas Camill,0,0,30,30
1657069243306,MATH 10A,A01,083735,Patchell; Gregory David,1,0,30,29
1657069243306,MATH 10A,A02,083736,Patchell; Gregory David,20,0,30,10
1657069243306,MATH 10A,A03,083737,Patchell; Gregory David,16,0,30,14
1657069249331,MATH 10B,A01,083207,Lim; Seonhee,7,0,34,27
1657069249331,MATH 10B,A02,083208,Lim; Seonhee,9,0,35,26
1657069249331,MATH 10B,A03,093472,Lim; Seonhee,4,0,34,30
1657069249331,MATH 10B,B01,083739,Sinha; Shubham,9,0,30,21
1657069255357,MATH 18,A01,083743,Cinel; Cameron Alexander,6,0,30,24
1657069255357,MATH 18,A02,083744,Cinel; Cameron Alexander,15,0,30,15
1657069255357,MATH 18,A03,083745,Cinel; Cameron Alexander,8,0,30,22
1657069255357,MATH 18,B01,083748,Rideout; David Porter,4,0,37,33
1657069255357,MATH 18,B02,083749,Rideout; David Porter,3,0,36,33
1657069255357,MATH 18,B03,083750,Rideout; David Porter,2,0,37,35
1657069255357,MATH 18,B04,083751,Rideout; David Porter,5,0,36,31
1657069255357,MATH 18,B05,093473,Rideout; David Porter,4,0,36,32
1657069255357,MATH 18,B06,093474,Rideout; David Porter,5,0,36,31
1657069261381,MATH 20A,A01,083754,Zheng; Zequn,12,0,40,28
1657069267405,MATH 20B,A01,083756,Briones; Jor-el Thomas Caparas,1,0,36,35
1657069267405,MATH 20B,A02,083757,Briones; Jor-el Thomas Caparas,1,0,36,35
1657069267405,MATH 20B,A03,093475,Briones; Jor-el Thomas Caparas,0,0,36,36
1657069273435,MATH 20C,A01,083760,Briones; Jor-el Thomas Caparas,1,0,35,34
1657069273435,MATH 20C,A02,083761,Briones; Jor-el Thomas Caparas,8,0,35,27
1657069273435,MATH 20C,A03,093476,Briones; Jor-el Thomas Caparas,0,1,36,36
1657069273435,MATH 20C,B01,083762,Bach; Quang Tran,0,0,30,30
1657069279465,MATH 20D,A01,083765,Tran; Brian Kha,4,0,30,26
1657069279465,MATH 20D,A02,083766,Tran; Brian Kha,5,0,30,25
1657069279465,MATH 20D,A03,083767,Tran; Brian Kha,3,0,30,27
1657069285490,MATH 20E,A01,083771,Ganguly; Soumya,5,0,32,27
1657069285490,MATH 20E,A02,083772,Ganguly; Soumya,6,0,32,26
1657069285490,MATH 20E,B01,083773,Ciotti; Benjamin,18,0,35,17
1657069285490,MATH 20E,B02,083774,Ciotti; Benjamin,17,0,35,18
1657069291518,MATH 103A,A01,083777,Greenfeld; Be'Eri,2,0,36,34
1657069291518,MATH 103A,A02,083778,Greenfeld; Be'Eri,5,0,36,31
1657069291518,MATH 103A,A03,093561,Greenfeld; Be'Eri,4,0,36,32
1657069291518,MATH 103A,B01,083779,Greenfeld; Be'Eri,6,0,36,30
1657069291518,MATH 103A,B02,083780,Greenfeld; Be'Eri,2,0,36,34
1657069291518,MATH 103A,B03,093562,Greenfeld; Be'Eri,3,0,36,33
1657069297545,MATH 105,A01,085443,Carter; Anne Toulson,14,0,35,21
1657069297545,MATH 105,A02,093477,Carter; Anne Toulson,20,0,35,15
1657069303583,MATH 109,A01,083213,Ganzberger; Geoffrey Michael,2,0,34,32
1657069303583,MATH 109,A02,083214,Ganzberger; Geoffrey Michael,2,0,34,32
1657069303583,MATH 109,A03,093478,Ganzberger; Geoffrey Michael,1,0,34,33
1657069303583,MATH 109,B01,083215,Ganzberger; Geoffrey Michael,1,0,32,31
1657069303583,MATH 109,B02,083216,Ganzberger; Geoffrey Michael,1,0,32,31
1657069303583,MATH 109,B03,093479,Ganzberger; Geoffrey Michael,6,0,32,26
1657069309612,MATH 142A,A01,083219,Chow; Bennett,6,0,32,26
1657069309612,MATH 142A,A02,083220,Chow; Bennett,10,0,32,22
1657069309612,MATH 142A,A03,093480,Chow; Bennett,7,0,32,25
1657069309612,MATH 142A,B03,093481,Chow; Bennett,7,0,32,25
1657069309612,MATH 142A,B04,093558,Chow; Bennett,11,0,32,21
1657069309612,MATH 142A,B05,093559,Chow; Bennett,6,0,32,26
1657069315640,MATH 193A,A01,083224,Rotar; Vladimir,7,0,34,27
1657069315640,MATH 193A,A02,083225,Rotar; Vladimir,5,0,34,29
1657069315640,MATH 193A,A03,083781,Rotar; Vladimir,1,0,34,33
1657069315640,MATH 193A,A04,083782,Rotar; Vladimir,6,0,34,28
1657069315640,MATH 193A,A05,093482,Rotar; Vladimir,6,0,34,28
1657069321667,MATH 197,001,091859,McAuley; Julian John,9999,0,9999,0
1657069321667,MATH 197,002,095566,Kedlaya; Kiran S.,9997,0,9999,2
1657069321667,MATH 197,003,095567,Xiao; Ming,9999,0,9999,0
1657069321667,MATH 197,004,095571,Perols; Johan Lars,9998,0,9999,1
1657069328722,COGS 9,A01,083615,Shannon; Kyle Michael,7,0,75,68
1657069334748,COGS 11,A01,083617,Boyle; Mary E. T.,21,0,48,27
1657069340774,COGS 13,A01,083071,Bastos; Amalia Pinkusfeld,9,0,71,62
1657069346798,COGS 14A,A01,092681,Semenuks; Arturs,0,1,100,100
1657069352827,COGS 14B,A01,083073,Cheng; Tzu-Han,5,0,63,58
1657069358847,COGS 17,A01,092677,Semenuks; Arturs,4,0,81,77
1657069364888,COGS 100,A01,083619,Allen; Michael Gordon,15,0,70,55
1657069370911,COGS 101A,A01,083621,Davis; Joshua Daniel,9,0,68,59
1657069376935,COGS 101B,A01,091572,Allen; Michael Gordon,8,0,65,57
1657069382959,COGS 101C,A01,083625,Delgado; Tania,17,0,35,18
1657069388985,COGS 107A,A01,083627,Boyle; Mary E. T.,13,0,60,47
1657069395012,COGS 118A,A01,083075,Gupta; Anjum,15,0,76,61
1657069401034,CSE 3,A50,083646,Miranda; Gregory Joseph,22,0,50,28
1657069407063,CSE 8A,A50,083650,Miranda; Gregory Joseph,17,1,56,39
1657069413090,CSE 11,A01,083080,Cao; Yingjun,4,15,40,36
1657069419113,CSE 12,A01,083652,Krause-Levy; Sophia Louisa,23,1,120,97
1657069425141,CSE 15L,A01,083654,Morris; Justin Loren,8,0,50,42
1657069425141,CSE 15L,A02,083655,Morris; Justin Loren,9,0,50,41
1657069431164,CSE 20,A01,083657,Tran; Khoa Dang,37,0,80,43
1657069437186,CSE 21,A01,095574,Bach; Quang Tran,21,0,48,27
1657069443209,CSE 30,A01,083084,Eldon; John,4,0,80,76
1657069443209,CSE 30,B01,095061,Bhaskar; Nishant,6,0,50,44
1657069449232,CSE 100,A01,083659,Cao; Yingjun,3,4,70,67
1657069455259,CSE 134B,A01,083661,Powell; Thomas Allan,19,0,100,81
1657069461283,CSE 140,A01,083663,Gungor; Onat,14,0,85,71
1657069467310,CSE 140L,A01,083088,Eldon; John,16,0,100,84
1657069473335,CSE 175,A01,083665,Kumar; Rakesh,3,0,25,22
1657069479356,CSE 190,A00,092507,Dubnov; Shlomo,7,0,20,13
1657069485384,ECE 45,A01,083139,Congero; Spencer William,5,0,75,70
1657069491412,ECE 65,A50,083695,Saad; Andrew S,12,0,30,18
1657069491412,ECE 65,A51,095125,Saad; Andrew S,25,0,26,1
1657069497436,ECE 109,A01,091882,Touri; Behrouz,16,0,70,54
1657069503465,ECE 180,A00,083140,Abi Samra; Nicholas Camill,1,0,30,29
1657069503465,ECE 180,B00,083141,Abi Samra; Nicholas Camill,0,0,30,30
1657069509501,MATH 10A,A01,083735,Patchell; Gregory David,1,0,30,29
1657069509501,MATH 10A,A02,083736,Patchell; Gregory David,20,0,30,10
1657069509501,MATH 10A,A03,083737,Patchell; Gregory David,16,0,30,14
1657069515532,MATH 10B,A01,083207,Lim; Seonhee,7,0,34,27
1657069515532,MATH 10B,A02,083208,Lim; Seonhee,9,0,35,26
1657069515532,MATH 10B,A03,093472,Lim; Seonhee,4,0,34,30
1657069515532,MATH 10B,B01,083739,Sinha; Shubham,9,0,30,21
1657069521555,MATH 18,A01,083743,Cinel; Cameron Alexander,6,0,30,24
1657069521555,MATH 18,A02,083744,Cinel; Cameron Alexander,15,0,30,15
1657069521555,MATH 18,A03,083745,Cinel; Cameron Alexander,8,0,30,22
1657069521555,MATH 18,B01,083748,Rideout; David Porter,4,0,37,33
1657069521555,MATH 18,B02,083749,Rideout; David Porter,3,0,36,33
1657069521555,MATH 18,B03,083750,Rideout; David Porter,2,0,37,35
1657069521555,MATH 18,B04,083751,Rideout; David Porter,5,0,36,31
1657069521555,MATH 18,B05,093473,Rideout; David Porter,4,0,36,32
1657069521555,MATH 18,B06,093474,Rideout; David Porter,5,0,36,31
1657069527581,MATH 20A,A01,083754,Zheng; Zequn,12,0,40,28
1657069533610,MATH 20B,A01,083756,Briones; Jor-el Thomas Caparas,1,0,36,35
1657069533610,MATH 20B,A02,083757,Briones; Jor-el Thomas Caparas,1,0,36,35
1657069533610,MATH 20B,A03,093475,Briones; Jor-el Thomas Caparas,0,0,36,36
1657069539643,MATH 20C,A01,083760,Briones; Jor-el Thomas Caparas,1,0,35,34
1657069539643,MATH 20C,A02,083761,Briones; Jor-el Thomas Caparas,8,0,35,27
1657069539643,MATH 20C,A03,093476,Briones; Jor-el Thomas Caparas,0,1,36,36
1657069539643,MATH 20C,B01,083762,Bach; Quang Tran,0,0,30,30
1657069545666,MATH 20D,A01,083765,Tran; Brian Kha,4,0,30,26
1657069545666,MATH 20D,A02,083766,Tran; Brian Kha,5,0,30,25
1657069545666,MATH 20D,A03,083767,Tran; Brian Kha,3,0,30,27
1657069551694,MATH 20E,A01,083771,Ganguly; Soumya,5,0,32,27
1657069551694,MATH 20E,A02,083772,Ganguly; Soumya,6,0,32,26
1657069551694,MATH 20E,B01,083773,Ciotti; Benjamin,18,0,35,17
1657069551694,MATH 20E,B02,083774,Ciotti; Benjamin,17,0,35,18
1657069557718,MATH 103A,A01,083777,Greenfeld; Be'Eri,2,0,36,34
1657069557718,MATH 103A,A02,083778,Greenfeld; Be'Eri,5,0,36,31
1657069557718,MATH 103A,A03,093561,Greenfeld; Be'Eri,4,0,36,32
1657069557718,MATH 103A,B01,083779,Greenfeld; Be'Eri,6,0,36,30
1657069557718,MATH 103A,B02,083780,Greenfeld; Be'Eri,2,0,36,34
1657069557718,MATH 103A,B03,093562,Greenfeld; Be'Eri,3,0,36,33
1657069563742,MATH 105,A01,085443,Carter; Anne Toulson,14,0,35,21
1657069563742,MATH 105,A02,093477,Carter; Anne Toulson,20,0,35,15
1657069569767,MATH 109,A01,083213,Ganzberger; Geoffrey Michael,2,0,34,32
1657069569767,MATH 109,A02,083214,Ganzberger; Geoffrey Michael,2,0,34,32
1657069569767,MATH 109,A03,093478,Ganzberger; Geoffrey Michael,1,0,34,33
1657069569767,MATH 109,B01,083215,Ganzberger; Geoffrey Michael,1,0,32,31
1657069569767,MATH 109,B02,083216,Ganzberger; Geoffrey Michael,1,0,32,31
1657069569767,MATH 109,B03,093479,Ganzberger; Geoffrey Michael,6,0,32,26
1657069575801,MATH 142A,A01,083219,Chow; Bennett,6,0,32,26
1657069575801,MATH 142A,A02,083220,Chow; Bennett,10,0,32,22
1657069575801,MATH 142A,A03,093480,Chow; Bennett,7,0,32,25
1657069575801,MATH 142A,B03,093481,Chow; Bennett,7,0,32,25
1657069575801,MATH 142A,B04,093558,Chow; Bennett,11,0,32,21
1657069575801,MATH 142A,B05,093559,Chow; Bennett,6,0,32,26
1657069581827,MATH 193A,A01,083224,Rotar; Vladimir,7,0,34,27
1657069581827,MATH 193A,A02,083225,Rotar; Vladimir,5,0,34,29
1657069581827,MATH 193A,A03,083781,Rotar; Vladimir,1,0,34,33
1657069581827,MATH 193A,A04,083782,Rotar; Vladimir,6,0,34,28
1657069581827,MATH 193A,A05,093482,Rotar; Vladimir,6,0,34,28
1657069587920,MATH 197,001,091859,McAuley; Julian John,9999,0,9999,0
1657069587920,MATH 197,002,095566,Kedlaya; Kiran S.,9997,0,9999,2
1657069587920,MATH 197,003,095567,Xiao; Ming,9999,0,9999,0
1657069587920,MATH 197,004,095571,Perols; Johan Lars,9998,0,9999,1
1657069594996,COGS 9,A01,083615,Shannon; Kyle Michael,7,0,75,68
1657069601021,COGS 11,A01,083617,Boyle; Mary E. T.,21,0,48,27
1657069607047,COGS 13,A01,083071,Bastos; Amalia Pinkusfeld,9,0,71,62
1657069613078,COGS 14A,A01,092681,Semenuks; Arturs,0,1,100,100
1657069619105,COGS 14B,A01,083073,Cheng; Tzu-Han,5,0,63,58
1657069625135,COGS 17,A01,092677,Semenuks; Arturs,4,0,81,77
1657069631156,COGS 100,A01,083619,Allen; Michael Gordon,15,0,70,55
1657069637186,COGS 101A,A01,083621,Davis; Joshua Daniel,9,0,68,59
1657069643218,COGS 101B,A01,091572,Allen; Michael Gordon,8,0,65,57
1657069649246,COGS 101C,A01,083625,Delgado; Tania,17,0,35,18
1657069655282,COGS 107A,A01,083627,Boyle; Mary E. T.,13,0,60,47
1657069661305,COGS 118A,A01,083075,Gupta; Anjum,15,0,76,61
1657069667333,CSE 3,A50,083646,Miranda; Gregory Joseph,22,0,50,28
1657069673357,CSE 8A,A50,083650,Miranda; Gregory Joseph,17,1,56,39
1657069679379,CSE 11,A01,083080,Cao; Yingjun,4,15,40,36
1657069685408,CSE 12,A01,083652,Krause-Levy; Sophia Louisa,23,1,120,97
1657069691434,CSE 15L,A01,083654,Morris; Justin Loren,8,0,50,42
1657069691434,CSE 15L,A02,083655,Morris; Justin Loren,9,0,50,41
1657069697457,CSE 20,A01,083657,Tran; Khoa Dang,37,0,80,43
1657069703484,CSE 21,A01,095574,Bach; Quang Tran,21,0,48,27
1657069709511,CSE 30,A01,083084,Eldon; John,4,0,80,76
1657069709511,CSE 30,B01,095061,Bhaskar; Nishant,6,0,50,44
1657069715538,CSE 100,A01,083659,Cao; Yingjun,3,4,70,67
1657069721562,CSE 134B,A01,083661,Powell; Thomas Allan,19,0,100,81
1657069727584,CSE 140,A01,083663,Gungor; Onat,14,0,85,71
1657069733606,CSE 140L,A01,083088,Eldon; John,16,0,100,84
1657069739628,CSE 175,A01,083665,Kumar; Rakesh,3,0,25,22
1657069745654,CSE 190,A00,092507,Dubnov; Shlomo,7,0,20,13
1657069751678,ECE 45,A01,083139,Congero; Spencer William,5,0,75,70
1657069757706,ECE 65,A50,083695,Saad; Andrew S,12,0,30,18
1657069757706,ECE 65,A51,095125,Saad; Andrew S,25,0,26,1
1657069763733,ECE 109,A01,091882,Touri; Behrouz,16,0,70,54
1657069769756,ECE 180,A00,083140,Abi Samra; Nicholas Camill,1,0,30,29
1657069769756,ECE 180,B00,083141,Abi Samra; Nicholas Camill,0,0,30,30
1657069775786,MATH 10A,A01,083735,Patchell; Gregory David,1,0,30,29
1657069775786,MATH 10A,A02,083736,Patchell; Gregory David,20,0,30,10
1657069775786,MATH 10A,A03,083737,Patchell; Gregory David,16,0,30,14
1657069781814,MATH 10B,A01,083207,Lim; Seonhee,7,0,34,27
1657069781814,MATH 10B,A02,083208,Lim; Seonhee,9,0,35,26
1657069781814,MATH 10B,A03,093472,Lim; Seonhee,4,0,34,30
1657069781814,MATH 10B,B01,083739,Sinha; Shubham,9,0,30,21
1657069787846,MATH 18,A01,083743,Cinel; Cameron Alexander,6,0,30,24
1657069787846,MATH 18,A02,083744,Cinel; Cameron Alexander,15,0,30,15
1657069787846,MATH 18,A03,083745,Cinel; Cameron Alexander,8,0,30,22
1657069787846,MATH 18,B01,083748,Rideout; David Porter,4,0,37,33
1657069787846,MATH 18,B02,083749,Rideout; David Porter,3,0,36,33
1657069787846,MATH 18,B03,083750,Rideout; David Porter,2,0,37,35
1657069787846,MATH 18,B04,083751,Rideout; David Porter,5,0,36,31
1657069787846,MATH 18,B05,093473,Rideout; David Porter,4,0,36,32
1657069787846,MATH 18,B06,093474,Rideout; David Porter,5,0,36,31
1657069793870,MATH 20A,A01,083754,Zheng; Zequn,12,0,40,28
1657069799906,MATH 20B,A01,083756,Briones; Jor-el Thomas Caparas,1,0,36,35
1657069799906,MATH 20B,A02,083757,Briones; Jor-el Thomas Caparas,1,0,36,35
1657069799906,MATH 20B,A03,093475,Briones; Jor-el Thomas Caparas,0,0,36,36
1657069805935,MATH 20C,A01,083760,Briones; Jor-el Thomas Caparas,1,0,35,34
1657069805935,MATH 20C,A02,083761,Briones; Jor-el Thomas Caparas,8,0,35,27
1657069805935,MATH 20C,A03,093476,Briones; Jor-el Thomas Caparas,0,1,36,36
1657069805935,MATH 20C,B01,083762,Bach; Quang Tran,0,0,30,30
1657069811964,MATH 20D,A01,083765,Tran; Brian Kha,4,0,30,26
1657069811964,MATH 20D,A02,083766,Tran; Brian Kha,5,0,30,25
1657069811964,MATH 20D,A03,083767,Tran; Brian Kha,3,0,30,27
1657069817993,MATH 20E,A01,083771,Ganguly; Soumya,5,0,32,27
1657069817993,MATH 20E,A02,083772,Ganguly; Soumya,6,0,32,26
1657069817993,MATH 20E,B01,083773,Ciotti; Benjamin,18,0,35,17
1657069817993,MATH 20E,B02,083774,Ciotti; Benjamin,17,0,35,18
1657069824021,MATH 103A,A01,083777,Greenfeld; Be'Eri,2,0,36,34
1657069824021,MATH 103A,A02,083778,Greenfeld; Be'Eri,5,0,36,31
1657069824021,MATH 103A,A03,093561,Greenfeld; Be'Eri,4,0,36,32
1657069824021,MATH 103A,B01,083779,Greenfeld; Be'Eri,6,0,36,30
1657069824021,MATH 103A,B02,083780,Greenfeld; Be'Eri,2,0,36,34
1657069824021,MATH 103A,B03,093562,Greenfeld; Be'Eri,3,0,36,33
1657069830047,MATH 105,A01,085443,Carter; Anne Toulson,14,0,35,21
1657069830047,MATH 105,A02,093477,Carter; Anne Toulson,20,0,35,15
1657069836072,MATH 109,A01,083213,Ganzberger; Geoffrey Michael,2,0,34,32
1657069836072,MATH 109,A02,083214,Ganzberger; Geoffrey Michael,2,0,34,32
1657069836072,MATH 109,A03,093478,Ganzberger; Geoffrey Michael,1,0,34,33
1657069836072,MATH 109,B01,083215,Ganzberger; Geoffrey Michael,1,0,32,31
1657069836072,MATH 109,B02,083216,Ganzberger; Geoffrey Michael,1,0,32,31
1657069836072,MATH 109,B03,093479,Ganzberger; Geoffrey Michael,6,0,32,26
1657069842097,MATH 142A,A01,083219,Chow; Bennett,6,0,32,26
1657069842097,MATH 142A,A02,083220,Chow; Bennett,10,0,32,22
1657069842097,MATH 142A,A03,093480,Chow; Bennett,7,0,32,25
1657069842097,MATH 142A,B03,093481,Chow; Bennett,7,0,32,25
1657069842097,MATH 142A,B04,093558,Chow; Bennett,11,0,32,21
1657069842097,MATH 142A,B05,093559,Chow; Bennett,6,0,32,26
1657069848122,MATH 193A,A01,083224,Rotar; Vladimir,7,0,34,27
1657069848122,MATH 193A,A02,083225,Rotar; Vladimir,5,0,34,29
1657069848122,MATH 193A,A03,083781,Rotar; Vladimir,1,0,34,33
1657069848122,MATH 193A,A04,083782,Rotar; Vladimir,6,0,34,28
1657069848122,MATH 193A,A05,093482,Rotar; Vladimir,6,0,34,28
1657069854149,MATH 197,001,091859,McAuley; Julian John,9999,0,9999,0
1657069854149,MATH 197,002,095566,Kedlaya; Kiran S.,9997,0,9999,2
1657069854149,MATH 197,003,095567,Xiao; Ming,9999,0,9999,0
1657069854149,MATH 197,004,095571,Perols; Johan Lars,9998,0,9999,1
1657069861218,COGS 9,A01,083615,Shannon; Kyle Michael,7,0,75,68
1657069867241,COGS 11,A01,083617,Boyle; Mary E. T.,21,0,48,27
1657069873264,COGS 13,A01,083071,Bastos; Amalia Pinkusfeld,9,0,71,62
1657069879286,COGS 14A,A01,092681,Semenuks; Arturs,0,1,100,100
1657069885309,COGS 14B,A01,083073,Cheng; Tzu-Han,5,0,63,58
1657069891340,COGS 17,A01,092677,Semenuks; Arturs,4,0,81,77
1657069897364,COGS 100,A01,083619,Allen; Michael Gordon,15,0,70,55
1657069903395,COGS 101A,A01,083621,Davis; Joshua Daniel,9,0,68,59
1657069909422,COGS 101B,A01,091572,Allen; Michael Gordon,8,0,65,57
1657069915446,COGS 101C,A01,083625,Delgado; Tania,17,0,35,18
1657069921474,COGS 107A,A01,083627,Boyle; Mary E. T.,13,0,60,47
1657069927497,COGS 118A,A01,083075,Gupta; Anjum,15,0,76,61
1657069933521,CSE 3,A50,083646,Miranda; Gregory Joseph,22,0,50,28
1657069939546,CSE 8A,A50,083650,Miranda; Gregory Joseph,17,1,56,39
1657069945578,CSE 11,A01,083080,Cao; Yingjun,4,15,40,36
1657069951608,CSE 12,A01,083652,Krause-Levy; Sophia Louisa,23,1,120,97
1657069957634,CSE 15L,A01,083654,Morris; Justin Loren,8,0,50,42
1657069957634,CSE 15L,A02,083655,Morris; Justin Loren,9,0,50,41
1657069963658,CSE 20,A01,083657,Tran; Khoa Dang,37,0,80,43
1657069969683,CSE 21,A01,095574,Bach; Quang Tran,21,0,48,27
1657069975710,CSE 30,A01,083084,Eldon; John,4,0,80,76
1657069975710,CSE 30,B01,095061,Bhaskar; Nishant,6,0,50,44
1657069981736,CSE 100,A01,083659,Cao; Yingjun,3,4,70,67
1657069987758,CSE 134B,A01,083661,Powell; Thomas Allan,19,0,100,81
1657069993781,CSE 140,A01,083663,Gungor; Onat,14,0,85,71
1657069999805,CSE 140L,A01,083088,Eldon; John,16,0,100,84
1657070005826,CSE 175,A01,083665,Kumar; Rakesh,3,0,25,22
1657070011849,CSE 190,A00,092507,Dubnov; Shlomo,7,0,20,13
1657070017872,ECE 45,A01,083139,Congero; Spencer William,5,0,75,70
1657070023896,ECE 65,A50,083695,Saad; Andrew S,12,0,30,18
1657070023896,ECE 65,A51,095125,Saad; Andrew S,25,0,26,1
1657070029919,ECE 109,A01,091882,Touri; Behrouz,16,0,70,54
1657070035946,ECE 180,A00,083140,Abi Samra; Nicholas Camill,1,0,30,29
1657070035946,ECE 180,B00,083141,Abi Samra; Nicholas Camill,0,0,30,30
1657070041972,MATH 10A,A01,083735,Patchell; Gregory David,1,0,30,29
1657070041972,MATH 10A,A02,083736,Patchell; Gregory David,20,0,30,10
1657070041972,MATH 10A,A03,083737,Patchell; Gregory David,16,0,30,14
1657070047995,MATH 10B,A01,083207,Lim; Seonhee,7,0,34,27
1657070047995,MATH 10B,A02,083208,Lim; Seonhee,9,0,35,26
1657070047995,MATH 10B,A03,093472,Lim; Seonhee,4,0,34,30
1657070047995,MATH 10B,B01,083739,Sinha; Shubham,9,0,30,21
1657070054026,MATH 18,A01,083743,Cinel; Cameron Alexander,6,0,30,24
1657070054026,MATH 18,A02,083744,Cinel; Cameron Alexander,15,0,30,15
1657070054026,MATH 18,A03,083745,Cinel; Cameron Alexander,8,0,30,22
1657070054026,MATH 18,B01,083748,Rideout; David Porter,4,0,37,33
1657070054026,MATH 18,B02,083749,Rideout; David Porter,3,0,36,33
1657070054026,MATH 18,B03,083750,Rideout; David Porter,2,0,37,35
1657070054026,MATH 18,B04,083751,Rideout; David Porter,5,0,36,31
1657070054026,MATH 18,B05,093473,Rideout; David Porter,4,0,36,32
1657070054026,MATH 18,B06,093474,Rideout; David Porter,5,0,36,31
1657070060052,MATH 20A,A01,083754,Zheng; Zequn,12,0,40,28
1657070066082,MATH 20B,A01,083756,Briones; Jor-el Thomas Caparas,1,0,36,35
1657070066082,MATH 20B,A02,083757,Briones; Jor-el Thomas Caparas,1,0,36,35
1657070066082,MATH 20B,A03,093475,Briones; Jor-el Thomas Caparas,0,0,36,36
1657070072106,MATH 20C,A01,083760,Briones; Jor-el Thomas Caparas,1,0,35,34
1657070072106,MATH 20C,A02,083761,Briones; Jor-el Thomas Caparas,8,0,35,27
1657070072106,MATH 20C,A03,093476,Briones; Jor-el Thomas Caparas,0,1,36,36
1657070072106,MATH 20C,B01,083762,Bach; Quang Tran,0,0,30,30
1657070078136,MATH 20D,A01,083765,Tran; Brian Kha,4,0,30,26
1657070078136,MATH 20D,A02,083766,Tran; Brian Kha,5,0,30,25
1657070078136,MATH 20D,A03,083767,Tran; Brian Kha,3,0,30,27
1657070084165,MATH 20E,A01,083771,Ganguly; Soumya,5,0,32,27
1657070084165,MATH 20E,A02,083772,Ganguly; Soumya,6,0,32,26
1657070084165,MATH 20E,B01,083773,Ciotti; Benjamin,18,0,35,17
1657070084165,MATH 20E,B02,083774,Ciotti; Benjamin,17,0,35,18
1657070090194,MATH 103A,A01,083777,Greenfeld; Be'Eri,2,0,36,34
1657070090194,MATH 103A,A02,083778,Greenfeld; Be'Eri,5,0,36,31
1657070090194,MATH 103A,A03,093561,Greenfeld; Be'Eri,4,0,36,32
1657070090194,MATH 103A,B01,083779,Greenfeld; Be'Eri,6,0,36,30
1657070090194,MATH 103A,B02,083780,Greenfeld; Be'Eri,2,0,36,34
1657070090194,MATH 103A,B03,093562,Greenfeld; Be'Eri,3,0,36,33
1657070096217,MATH 105,A01,085443,Carter; Anne Toulson,14,0,35,21
1657070096217,MATH 105,A02,093477,Carter; Anne Toulson,20,0,35,15
1657070102247,MATH 109,A01,083213,Ganzberger; Geoffrey Michael,2,0,34,32
1657070102247,MATH 109,A02,083214,Ganzberger; Geoffrey Michael,2,0,34,32
1657070102247,MATH 109,A03,093478,Ganzberger; Geoffrey Michael,1,0,34,33
1657070102247,MATH 109,B01,083215,Ganzberger; Geoffrey Michael,1,0,32,31
1657070102247,MATH 109,B02,083216,Ganzberger; Geoffrey Michael,1,0,32,31
1657070102247,MATH 109,B03,093479,Ganzberger; Geoffrey Michael,6,0,32,26
1657070108278,MATH 142A,A01,083219,Chow; Bennett,6,0,32,26
1657070108278,MATH 142A,A02,083220,Chow; Bennett,10,0,32,22
1657070108278,MATH 142A,A03,093480,Chow; Bennett,7,0,32,25
1657070108278,MATH 142A,B03,093481,Chow; Bennett,7,0,32,25
1657070108278,MATH 142A,B04,093558,Chow; Bennett,11,0,32,21
1657070108278,MATH 142A,B05,093559,Chow; Bennett,6,0,32,26
1657070114316,MATH 193A,A01,083224,Rotar; Vladimir,7,0,34,27
1657070114316,MATH 193A,A02,083225,Rotar; Vladimir,5,0,34,29
1657070114316,MATH 193A,A03,083781,Rotar; Vladimir,1,0,34,33
1657070114316,MATH 193A,A04,083782,Rotar; Vladimir,6,0,34,28
1657070114316,MATH 193A,A05,093482,Rotar; Vladimir,6,0,34,28
1657070120340,MATH 197,001,091859,McAuley; Julian John,9999,0,9999,0
1657070120340,MATH 197,002,095566,Kedlaya; Kiran S.,9997,0,9999,2
1657070120340,MATH 197,003,095567,Xiao; Ming,9999,0,9999,0
1657070120340,MATH 197,004,095571,Perols; Johan Lars,9998,0,9999,1
1657070127403,COGS 9,A01,083615,Shannon; Kyle Michael,7,0,75,68
1657070133426,COGS 11,A01,083617,Boyle; Mary E. T.,21,0,48,27
1657070139452,COGS 13,A01,083071,Bastos; Amalia Pinkusfeld,9,0,71,62
1657070145481,COGS 14A,A01,092681,Semenuks; Arturs,0,1,100,100
1657070151503,COGS 14B,A01,083073,Cheng; Tzu-Han,5,0,63,58
1657070157531,COGS 17,A01,092677,Semenuks; Arturs,4,0,81,77
1657070163555,COGS 100,A01,083619,Allen; Michael Gordon,15,0,70,55
1657070169580,COGS 101A,A01,083621,Davis; Joshua Daniel,9,0,68,59
1657070175610,COGS 101B,A01,091572,Allen; Michael Gordon,8,0,65,57
1657070181707,COGS 101C,A01,083625,Delgado; Tania,17,0,35,18
1657070187734,COGS 107A,A01,083627,Boyle; Mary E. T.,13,0,60,47
1657070193761,COGS 118A,A01,083075,Gupta; Anjum,15,0,76,61
1657070199783,CSE 3,A50,083646,Miranda; Gregory Joseph,22,0,50,28
1657070205806,CSE 8A,A50,083650,Miranda; Gregory Joseph,17,1,56,39
1657070211834,CSE 11,A01,083080,Cao; Yingjun,4,15,40,36
1657070217856,CSE 12,A01,083652,Krause-Levy; Sophia Louisa,23,1,120,97
1657070223880,CSE 15L,A01,083654,Morris; Justin Loren,8,0,50,42
1657070223880,CSE 15L,A02,083655,Morris; Justin Loren,9,0,50,41
1657070229904,CSE 20,A01,083657,Tran; Khoa Dang,37,0,80,43
1657070235926,CSE 21,A01,095574,Bach; Quang Tran,21,0,48,27
1657070241953,CSE 30,A01,083084,Eldon; John,4,0,80,76
1657070241953,CSE 30,B01,095061,Bhaskar; Nishant,6,0,50,44
1657070247978,CSE 100,A01,083659,Cao; Yingjun,3,4,70,67
1657070254007,CSE 134B,A01,083661,Powell; Thomas Allan,19,0,100,81
1657070260029,CSE 140,A01,083663,Gungor; Onat,14,0,85,71
1657070266054,CSE 140L,A01,083088,Eldon; John,16,0,100,84
1657070272083,CSE 175,A01,083665,Kumar; Rakesh,3,0,25,22
1657070278107,CSE 190,A00,092507,Dubnov; Shlomo,7,0,20,13
1657070284133,ECE 45,A01,083139,Congero; Spencer William,5,0,75,70
1657070290156,ECE 65,A50,083695,Saad; Andrew S,12,0,30,18
1657070290156,ECE 65,A51,095125,Saad; Andrew S,25,0,26,1
1657070296179,ECE 109,A01,091882,Touri; Behrouz,16,0,70,54
1657070302202,ECE 180,A00,083140,Abi Samra; Nicholas Camill,1,0,30,29
1657070302202,ECE 180,B00,083141,Abi Samra; Nicholas Camill,0,0,30,30
1657070308227,MATH 10A,A01,083735,Patchell; Gregory David,1,0,30,29
1657070308227,MATH 10A,A02,083736,Patchell; Gregory David,20,0,30,10
1657070308227,MATH 10A,A03,083737,Patchell; Gregory David,16,0,30,14
1657070314256,MATH 10B,A01,083207,Lim; Seonhee,7,0,34,27
1657070314256,MATH 10B,A02,083208,Lim; Seonhee,9,0,35,26
1657070314256,MATH 10B,A03,093472,Lim; Seonhee,4,0,34,30
1657070314256,MATH 10B,B01,083739,Sinha; Shubham,9,0,30,21
1657070320288,MATH 18,A01,083743,Cinel; Cameron Alexander,6,0,30,24
1657070320288,MATH 18,A02,083744,Cinel; Cameron Alexander,15,0,30,15
1657070320288,MATH 18,A03,083745,Cinel; Cameron Alexander,8,0,30,22
1657070320288,MATH 18,B01,083748,Rideout; David Porter,4,0,37,33
1657070320288,MATH 18,B02,083749,Rideout; David Porter,3,0,36,33
1657070320288,MATH 18,B03,083750,Rideout; David Porter,2,0,37,35
1657070320288,MATH 18,B04,083751,Rideout; David Porter,5,0,36,31
1657070320288,MATH 18,B05,093473,Rideout; David Porter,4,0,36,32
1657070320288,MATH 18,B06,093474,Rideout; David Porter,5,0,36,31
1657070326313,MATH 20A,A01,083754,Zheng; Zequn,12,0,40,28
1657070332334,MATH 20B,A01,083756,Briones; Jor-el Thomas Caparas,1,0,36,35
1657070332334,MATH 20B,A02,083757,Briones; Jor-el Thomas Caparas,1,0,36,35
1657070332334,MATH 20B,A03,093475,Briones; Jor-el Thomas Caparas,0,0,36,36
1657070338356,MATH 20C,A01,083760,Briones; Jor-el Thomas Caparas,1,0,35,34
1657070338356,MATH 20C,A02,083761,Briones; Jor-el Thomas Caparas,8,0,35,27
1657070338356,MATH 20C,A03,093476,Briones; Jor-el Thomas Caparas,0,1,36,36
1657070338356,MATH 20C,B01,083762,Bach; Quang Tran,0,0,30,30
1657070344380,MATH 20D,A01,083765,Tran; Brian Kha,4,0,30,26
1657070344380,MATH 20D,A02,083766,Tran; Brian Kha,5,0,30,25
1657070344380,MATH 20D,A03,083767,Tran; Brian Kha,3,0,30,27
1657070350408,MATH 20E,A01,083771,Ganguly; Soumya,5,0,32,27
1657070350408,MATH 20E,A02,083772,Ganguly; Soumya,6,0,32,26
1657070350408,MATH 20E,B01,083773,Ciotti; Benjamin,18,0,35,17
1657070350408,MATH 20E,B02,083774,Ciotti; Benjamin,17,0,35,18
1657070356439,MATH 103A,A01,083777,Greenfeld; Be'Eri,2,0,36,34
1657070356439,MATH 103A,A02,083778,Greenfeld; Be'Eri,5,0,36,31
1657070356439,MATH 103A,A03,093561,Greenfeld; Be'Eri,4,0,36,32
1657070356439,MATH 103A,B01,083779,Greenfeld; Be'Eri,6,0,36,30
1657070356439,MATH 103A,B02,083780,Greenfeld; Be'Eri,2,0,36,34
1657070356439,MATH 103A,B03,093562,Greenfeld; Be'Eri,3,0,36,33
1657070362467,MATH 105,A01,085443,Carter; Anne Toulson,14,0,35,21
1657070362467,MATH 105,A02,093477,Carter; Anne Toulson,20,0,35,15
1657070368495,MATH 109,A01,083213,Ganzberger; Geoffrey Michael,2,0,34,32
1657070368495,MATH 109,A02,083214,Ganzberger; Geoffrey Michael,2,0,34,32
1657070368495,MATH 109,A03,093478,Ganzberger; Geoffrey Michael,1,0,34,33
1657070368495,MATH 109,B01,083215,Ganzberger; Geoffrey Michael,1,0,32,31
1657070368495,MATH 109,B02,083216,Ganzberger; Geoffrey Michael,1,0,32,31
1657070368495,MATH 109,B03,093479,Ganzberger; Geoffrey Michael,6,0,32,26
1657070374518,MATH 142A,A01,083219,Chow; Bennett,6,0,32,26
1657070374518,MATH 142A,A02,083220,Chow; Bennett,10,0,32,22
1657070374518,MATH 142A,A03,093480,Chow; Bennett,7,0,32,25
1657070374518,MATH 142A,B03,093481,Chow; Bennett,7,0,32,25
1657070374518,MATH 142A,B04,093558,Chow; Bennett,11,0,32,21
1657070374518,MATH 142A,B05,093559,Chow; Bennett,6,0,32,26
1657070380541,MATH 193A,A01,083224,Rotar; Vladimir,7,0,34,27
1657070380541,MATH 193A,A02,083225,Rotar; Vladimir,5,0,34,29
1657070380541,MATH 193A,A03,083781,Rotar; Vladimir,1,0,34,33
1657070380541,MATH 193A,A04,083782,Rotar; Vladimir,6,0,34,28
1657070380541,MATH 193A,A05,093482,Rotar; Vladimir,6,0,34,28
1657070386567,MATH 197,001,091859,McAuley; Julian John,9999,0,9999,0
1657070386567,MATH 197,002,095566,Kedlaya; Kiran S.,9997,0,9999,2
1657070386567,MATH 197,003,095567,Xiao; Ming,9999,0,9999,0
1657070386567,MATH 197,004,095571,Perols; Johan Lars,9998,0,9999,1
1657070393634,COGS 9,A01,083615,Shannon; Kyle Michael,7,0,75,68
1657070399662,COGS 11,A01,083617,Boyle; Mary E. T.,21,0,48,27
1657070405685,COGS 13,A01,083071,Bastos; Amalia Pinkusfeld,9,0,71,62
1657070411706,COGS 14A,A01,092681,Semenuks; Arturs,0,1,100,100
1657070417732,COGS 14B,A01,083073,Cheng; Tzu-Han,5,0,63,58
1657070423756,COGS 17,A01,092677,Semenuks; Arturs,4,0,81,77
1657070429778,COGS 100,A01,083619,Allen; Michael Gordon,15,0,70,55
1657070435800,COGS 101A,A01,083621,Davis; Joshua Daniel,9,0,68,59
1657070441831,COGS 101B,A01,091572,Allen; Michael Gordon,8,0,65,57
1657070447857,COGS 101C,A01,083625,Delgado; Tania,17,0,35,18
1657070453882,COGS 107A,A01,083627,Boyle; Mary E. T.,13,0,60,47
1657070459905,COGS 118A,A01,083075,Gupta; Anjum,15,0,76,61
1657070465932,CSE 3,A50,083646,Miranda; Gregory Joseph,22,0,50,28
1657070471957,CSE 8A,A50,083650,Miranda; Gregory Joseph,17,1,56,39
1657070477980,CSE 11,A01,083080,Cao; Yingjun,4,15,40,36
1657070484003,CSE 12,A01,083652,Krause-Levy; Sophia Louisa,23,1,120,97
1657070490033,CSE 15L,A01,083654,Morris; Justin Loren,8,0,50,42
1657070490033,CSE 15L,A02,083655,Morris; Justin Loren,9,0,50,41
1657070496059,CSE 20,A01,083657,Tran; Khoa Dang,37,0,80,43
1657070502082,CSE 21,A01,095574,Bach; Quang Tran,21,0,48,27
1657070508113,CSE 30,A01,083084,Eldon; John,4,0,80,76
1657070508113,CSE 30,B01,095061,Bhaskar; Nishant,6,0,50,44
1657070514142,CSE 100,A01,083659,Cao; Yingjun,3,4,70,67
1657070520166,CSE 134B,A01,083661,Powell; Thomas Allan,19,0,100,81
1657070526193,CSE 140,A01,083663,Gungor; Onat,14,0,85,71
1657070532215,CSE 140L,A01,083088,Eldon; John,16,0,100,84
1657070538238,CSE 175,A01,083665,Kumar; Rakesh,3,0,25,22
1657070544264,CSE 190,A00,092507,Dubnov; Shlomo,7,0,20,13
1657070550288,ECE 45,A01,083139,Congero; Spencer William,5,0,75,70
1657070556317,ECE 65,A50,083695,Saad; Andrew S,12,0,30,18
1657070556317,ECE 65,A51,095125,Saad; Andrew S,25,0,26,1
1657070562344,ECE 109,A01,091882,Touri; Behrouz,16,0,70,54
1657070568369,ECE 180,A00,083140,Abi Samra; Nicholas Camill,1,0,30,29
1657070568369,ECE 180,B00,083141,Abi Samra; Nicholas Camill,0,0,30,30
1657070574392,MATH 10A,A01,083735,Patchell; Gregory David,1,0,30,29
1657070574392,MATH 10A,A02,083736,Patchell; Gregory David,20,0,30,10
1657070574392,MATH 10A,A03,083737,Patchell; Gregory David,16,0,30,14
1657070580421,MATH 10B,A01,083207,Lim; Seonhee,7,0,34,27
1657070580421,MATH 10B,A02,083208,Lim; Seonhee,9,0,35,26
1657070580421,MATH 10B,A03,093472,Lim; Seonhee,4,0,34,30
1657070580421,MATH 10B,B01,083739,Sinha; Shubham,9,0,30,21
1657070586454,MATH 18,A01,083743,Cinel; Cameron Alexander,6,0,30,24
1657070586454,MATH 18,A02,083744,Cinel; Cameron Alexander,15,0,30,15
1657070586454,MATH 18,A03,083745,Cinel; Cameron Alexander,8,0,30,22
1657070586454,MATH 18,B01,083748,Rideout; David Porter,4,0,37,33
1657070586454,MATH 18,B02,083749,Rideout; David Porter,3,0,36,33
1657070586454,MATH 18,B03,083750,Rideout; David Porter,2,0,37,35
1657070586454,MATH 18,B04,083751,Rideout; David Porter,5,0,36,31
1657070586454,MATH 18,B05,093473,Rideout; David Porter,4,0,36,32
1657070586454,MATH 18,B06,093474,Rideout; David Porter,5,0,36,31
1657070592481,MATH 20A,A01,083754,Zheng; Zequn,12,0,40,28
1657070598508,MATH 20B,A01,083756,Briones; Jor-el Thomas Caparas,1,0,36,35
1657070598508,MATH 20B,A02,083757,Briones; Jor-el Thomas Caparas,1,0,36,35
1657070598508,MATH 20B,A03,093475,Briones; Jor-el Thomas Caparas,0,0,36,36
1657070604533,MATH 20C,A01,083760,Briones; Jor-el Thomas Caparas,1,0,35,34
1657070604533,MATH 20C,A02,083761,Briones; Jor-el Thomas Caparas,8,0,35,27
1657070604533,MATH 20C,A03,093476,Briones; Jor-el Thomas Caparas,0,1,36,36
1657070604533,MATH 20C,B01,083762,Bach; Quang Tran,0,0,30,30
1657070610557,MATH 20D,A01,083765,Tran; Brian Kha,4,0,30,26
1657070610557,MATH 20D,A02,083766,Tran; Brian Kha,5,0,30,25
1657070610557,MATH 20D,A03,083767,Tran; Brian Kha,3,0,30,27
1657070616585,MATH 20E,A01,083771,Ganguly; Soumya,5,0,32,27
1657070616585,MATH 20E,A02,083772,Ganguly; Soumya,6,0,32,26
1657070616585,MATH 20E,B01,083773,Ciotti; Benjamin,18,0,35,17
1657070616585,MATH 20E,B02,083774,Ciotti; Benjamin,17,0,35,18
1657070622610,MATH 103A,A01,083777,Greenfeld; Be'Eri,2,0,36,34
1657070622610,MATH 103A,A02,083778,Greenfeld; Be'Eri,5,0,36,31
1657070622610,MATH 103A,A03,093561,Greenfeld; Be'Eri,4,0,36,32
1657070622610,MATH 103A,B01,083779,Greenfeld; Be'Eri,6,0,36,30
1657070622610,MATH 103A,B02,083780,Greenfeld; Be'Eri,2,0,36,34
1657070622610,MATH 103A,B03,093562,Greenfeld; Be'Eri,3,0,36,33
1657070628642,MATH 105,A01,085443,Carter; Anne Toulson,14,0,35,21
1657070628642,MATH 105,A02,093477,Carter; Anne Toulson,20,0,35,15
1657070634669,MATH 109,A01,083213,Ganzberger; Geoffrey Michael,2,0,34,32
1657070634669,MATH 109,A02,083214,Ganzberger; Geoffrey Michael,2,0,34,32
1657070634669,MATH 109,A03,093478,Ganzberger; Geoffrey Michael,1,0,34,33
1657070634669,MATH 109,B01,083215,Ganzberger; Geoffrey Michael,1,0,32,31
1657070634669,MATH 109,B02,083216,Ganzberger; Geoffrey Michael,1,0,32,31
1657070634669,MATH 109,B03,093479,Ganzberger; Geoffrey Michael,6,0,32,26
1657070640702,MATH 142A,A01,083219,Chow; Bennett,6,0,32,26
1657070640702,MATH 142A,A02,083220,Chow; Bennett,10,0,32,22
1657070640702,MATH 142A,A03,093480,Chow; Bennett,7,0,32,25
1657070640702,MATH 142A,B03,093481,Chow; Bennett,7,0,32,25
1657070640702,MATH 142A,B04,093558,Chow; Bennett,11,0,32,21
1657070640702,MATH 142A,B05,093559,Chow; Bennett,6,0,32,26
1657070646730,MATH 193A,A01,083224,Rotar; Vladimir,7,0,34,27
1657070646730,MATH 193A,A02,083225,Rotar; Vladimir,5,0,34,29
1657070646730,MATH 193A,A03,083781,Rotar; Vladimir,1,0,34,33
1657070646730,MATH 193A,A04,083782,Rotar; Vladimir,6,0,34,28
1657070646730,MATH 193A,A05,093482,Rotar; Vladimir,6,0,34,28
1657070652768,MATH 197,001,091859,McAuley; Julian John,9999,0,9999,0
1657070652768,MATH 197,002,095566,Kedlaya; Kiran S.,9997,0,9999,2
1657070652768,MATH 197,003,095567,Xiao; Ming,9999,0,9999,0
1657070652768,MATH 197,004,095571,Perols; Johan Lars,9998,0,9999,1
1657070659824,COGS 9,A01,083615,Shannon; Kyle Michael,7,0,75,68
1657070665847,COGS 11,A01,083617,Boyle; Mary E. T.,21,0,48,27
1657070671870,COGS 13,A01,083071,Bastos; Amalia Pinkusfeld,9,0,71,62
1657070677902,COGS 14A,A01,092681,Semenuks; Arturs,0,1,100,100
1657070683930,COGS 14B,A01,083073,Cheng; Tzu-Han,5,0,63,58
1657070689962,COGS 17,A01,092677,Semenuks; Arturs,4,0,81,77
1657070695985,COGS 100,A01,083619,Allen; Michael Gordon,15,0,70,55
1657070702021,COGS 101A,A01,083621,Davis; Joshua Daniel,9,0,68,59
1657070708043,COGS 101B,A01,091572,Allen; Michael Gordon,8,0,65,57
1657070714067,COGS 101C,A01,083625,Delgado; Tania,17,0,35,18
1657070720094,COGS 107A,A01,083627,Boyle; Mary E. T.,13,0,60,47
1657070726120,COGS 118A,A01,083075,Gupta; Anjum,15,0,76,61
1657070732151,CSE 3,A50,083646,Miranda; Gregory Joseph,22,0,50,28
1657070738179,CSE 8A,A50,083650,Miranda; Gregory Joseph,17,1,56,39
1657070744202,CSE 11,A01,083080,Cao; Yingjun,4,15,40,36
1657070750227,CSE 12,A01,083652,Krause-Levy; Sophia Louisa,23,1,120,97
1657070756255,CSE 15L,A01,083654,Morris; Justin Loren,8,0,50,42
1657070756255,CSE 15L,A02,083655,Morris; Justin Loren,9,0,50,41
1657070762278,CSE 20,A01,083657,Tran; Khoa Dang,37,0,80,43
1657070768302,CSE 21,A01,095574,Bach; Quang Tran,21,0,48,27
1657070774327,CSE 30,A01,083084,Eldon; John,4,0,80,76
1657070774327,CSE 30,B01,095061,Bhaskar; Nishant,6,0,50,44
1657070780445,CSE 100,A01,083659,Cao; Yingjun,3,4,70,67
1657070786479,CSE 134B,A01,083661,Powell; Thomas Allan,19,0,100,81
1657070792504,CSE 140,A01,083663,Gungor; Onat,14,0,85,71
1657070798528,CSE 140L,A01,083088,Eldon; John,16,0,100,84
1657070804554,CSE 175,A01,083665,Kumar; Rakesh,3,0,25,22
1657070810576,CSE 190,A00,092507,Dubnov; Shlomo,7,0,20,13
1657070816603,ECE 45,A01,083139,Congero; Spencer William,5,0,75,70
1657070822626,ECE 65,A50,083695,Saad; Andrew S,12,0,30,18
1657070822626,ECE 65,A51,095125,Saad; Andrew S,25,0,26,1
1657070828651,ECE 109,A01,091882,Touri; Behrouz,16,0,70,54
1657070834672,ECE 180,A00,083140,Abi Samra; Nicholas Camill,1,0,30,29
1657070834672,ECE 180,B00,083141,Abi Samra; Nicholas Camill,0,0,30,30
1657070840701,MATH 10A,A01,083735,Patchell; Gregory David,1,0,30,29
1657070840701,MATH 10A,A02,083736,Patchell; Gregory David,20,0,30,10
1657070840701,MATH 10A,A03,083737,Patchell; Gregory David,16,0,30,14
1657070846724,MATH 10B,A01,083207,Lim; Seonhee,7,0,34,27
1657070846724,MATH 10B,A02,083208,Lim; Seonhee,9,0,35,26
1657070846724,MATH 10B,A03,093472,Lim; Seonhee,4,0,34,30
1657070846724,MATH 10B,B01,083739,Sinha; Shubham,9,0,30,21
1657070852750,MATH 18,A01,083743,Cinel; Cameron Alexander,6,0,30,24
1657070852750,MATH 18,A02,083744,Cinel; Cameron Alexander,15,0,30,15
1657070852750,MATH 18,A03,083745,Cinel; Cameron Alexander,8,0,30,22
1657070852750,MATH 18,B01,083748,Rideout; David Porter,4,0,37,33
1657070852750,MATH 18,B02,083749,Rideout; David Porter,3,0,36,33
1657070852750,MATH 18,B03,083750,Rideout; David Porter,2,0,37,35
1657070852750,MATH 18,B04,083751,Rideout; David Porter,5,0,36,31
1657070852750,MATH 18,B05,093473,Rideout; David Porter,4,0,36,32
1657070852750,MATH 18,B06,093474,Rideout; David Porter,5,0,36,31
1657070858778,MATH 20A,A01,083754,Zheng; Zequn,12,0,40,28
1657070864800,MATH 20B,A01,083756,Briones; Jor-el Thomas Caparas,1,0,36,35
1657070864800,MATH 20B,A02,083757,Briones; Jor-el Thomas Caparas,1,0,36,35
1657070864800,MATH 20B,A03,093475,Briones; Jor-el Thomas Caparas,0,0,36,36
1657070870824,MATH 20C,A01,083760,Briones; Jor-el Thomas Caparas,1,0,35,34
1657070870824,MATH 20C,A02,083761,Briones; Jor-el Thomas Caparas,8,0,35,27
1657070870824,MATH 20C,A03,093476,Briones; Jor-el Thomas Caparas,0,1,36,36
1657070870824,MATH 20C,B01,083762,Bach; Quang Tran,0,0,30,30
1657070876849,MATH 20D,A01,083765,Tran; Brian Kha,4,0,30,26
1657070876849,MATH 20D,A02,083766,Tran; Brian Kha,5,0,30,25
1657070876849,MATH 20D,A03,083767,Tran; Brian Kha,3,0,30,27
1657070882873,MATH 20E,A01,083771,Ganguly; Soumya,5,0,32,27
1657070882873,MATH 20E,A02,083772,Ganguly; Soumya,6,0,32,26
1657070882873,MATH 20E,B01,083773,Ciotti; Benjamin,18,0,35,17
1657070882873,MATH 20E,B02,083774,Ciotti; Benjamin,17,0,35,18
1657070888912,MATH 103A,A01,083777,Greenfeld; Be'Eri,2,0,36,34
1657070888912,MATH 103A,A02,083778,Greenfeld; Be'Eri,5,0,36,31
1657070888912,MATH 103A,A03,093561,Greenfeld; Be'Eri,4,0,36,32
1657070888912,MATH 103A,B01,083779,Greenfeld; Be'Eri,6,0,36,30
1657070888912,MATH 103A,B02,083780,Greenfeld; Be'Eri,2,0,36,34
1657070888912,MATH 103A,B03,093562,Greenfeld; Be'Eri,3,0,36,33
1657070894935,MATH 105,A01,085443,Carter; Anne Toulson,14,0,35,21
1657070894935,MATH 105,A02,093477,Carter; Anne Toulson,20,0,35,15
1657070900959,MATH 109,A01,083213,Ganzberger; Geoffrey Michael,2,0,34,32
1657070900959,MATH 109,A02,083214,Ganzberger; Geoffrey Michael,2,0,34,32
1657070900959,MATH 109,A03,093478,Ganzberger; Geoffrey Michael,1,0,34,33
1657070900959,MATH 109,B01,083215,Ganzberger; Geoffrey Michael,1,0,32,31
1657070900959,MATH 109,B02,083216,Ganzberger; Geoffrey Michael,1,0,32,31
1657070900959,MATH 109,B03,093479,Ganzberger; Geoffrey Michael,6,0,32,26
1657070906984,MATH 142A,A01,083219,Chow; Bennett,6,0,32,26
1657070906984,MATH 142A,A02,083220,Chow; Bennett,10,0,32,22
1657070906984,MATH 142A,A03,093480,Chow; Bennett,7,0,32,25
1657070906984,MATH 142A,B03,093481,Chow; Bennett,7,0,32,25
1657070906984,MATH 142A,B04,093558,Chow; Bennett,11,0,32,21
1657070906984,MATH 142A,B05,093559,Chow; Bennett,6,0,32,26
1657070913012,MATH 193A,A01,083224,Rotar; Vladimir,7,0,34,27
1657070913012,MATH 193A,A02,083225,Rotar; Vladimir,5,0,34,29
1657070913012,MATH 193A,A03,083781,Rotar; Vladimir,1,0,34,33
1657070913012,MATH 193A,A04,083782,Rotar; Vladimir,6,0,34,28
1657070913012,MATH 193A,A05,093482,Rotar; Vladimir,6,0,34,28
1657070919033,MATH 197,001,091859,McAuley; Julian John,9999,0,9999,0
1657070919033,MATH 197,002,095566,Kedlaya; Kiran S.,9997,0,9999,2
1657070919033,MATH 197,003,095567,Xiao; Ming,9999,0,9999,0
1657070919033,MATH 197,004,095571,Perols; Johan Lars,9998,0,9999,1
1657070926084,COGS 9,A01,083615,Shannon; Kyle Michael,7,0,75,68
1657070932112,COGS 11,A01,083617,Boyle; Mary E. T.,21,0,48,27
1657070938136,COGS 13,A01,083071,Bastos; Amalia Pinkusfeld,9,0,71,62
1657070944163,COGS 14A,A01,092681,Semenuks; Arturs,0,1,100,100
1657070950185,COGS 14B,A01,083073,Cheng; Tzu-Han,5,0,63,58
1657070956207,COGS 17,A01,092677,Semenuks; Arturs,4,0,81,77
1657070962229,COGS 100,A01,083619,Allen; Michael Gordon,15,0,70,55
1657070968255,COGS 101A,A01,083621,Davis; Joshua Daniel,9,0,68,59
1657070974283,COGS 101B,A01,091572,Allen; Michael Gordon,8,0,65,57
1657070980316,COGS 101C,A01,083625,Delgado; Tania,17,0,35,18
1657070986341,COGS 107A,A01,083627,Boyle; Mary E. T.,13,0,60,47
1657070992367,COGS 118A,A01,083075,Gupta; Anjum,15,0,76,61
1657070998392,CSE 3,A50,083646,Miranda; Gregory Joseph,22,0,50,28
1657071004418,CSE 8A,A50,083650,Miranda; Gregory Joseph,17,1,56,39
1657071010440,CSE 11,A01,083080,Cao; Yingjun,4,15,40,36
1657071016466,CSE 12,A01,083652,Krause-Levy; Sophia Louisa,23,1,120,97
1657071022491,CSE 15L,A01,083654,Morris; Justin Loren,8,0,50,42
1657071022491,CSE 15L,A02,083655,Morris; Justin Loren,9,0,50,41
1657071028514,CSE 20,A01,083657,Tran; Khoa Dang,37,0,80,43
1657071034541,CSE 21,A01,095574,Bach; Quang Tran,21,0,48,27
1657071040563,CSE 30,A01,083084,Eldon; John,4,0,80,76
1657071040563,CSE 30,B01,095061,Bhaskar; Nishant,6,0,50,44
1657071046585,CSE 100,A01,083659,Cao; Yingjun,3,4,70,67
1657071052611,CSE 134B,A01,083661,Powell; Thomas Allan,19,0,100,81
1657071058638,CSE 140,A01,083663,Gungor; Onat,14,0,85,71
1657071064661,CSE 140L,A01,083088,Eldon; John,16,0,100,84
1657071070687,CSE 175,A01,083665,Kumar; Rakesh,3,0,25,22
1657071076711,CSE 190,A00,092507,Dubnov; Shlomo,7,0,20,13
1657071082735,ECE 45,A01,083139,Congero; Spencer William,5,0,75,70
1657071088756,ECE 65,A50,083695,Saad; Andrew S,12,0,30,18
1657071088756,ECE 65,A51,095125,Saad; Andrew S,25,0,26,1
1657071094788,ECE 109,A01,091882,Touri; Behrouz,16,0,70,54
1657071100822,ECE 180,A00,083140,Abi Samra; Nicholas Camill,1,0,30,29
1657071100822,ECE 180,B00,083141,Abi Samra; Nicholas Camill,0,0,30,30
1657071106849,MATH 10A,A01,083735,Patchell; Gregory David,1,0,30,29
1657071106849,MATH 10A,A02,083736,Patchell; Gregory David,20,0,30,10
1657071106849,MATH 10A,A03,083737,Patchell; Gregory David,16,0,30,14
1657071112875,MATH 10B,A01,083207,Lim; Seonhee,7,0,34,27
1657071112875,MATH 10B,A02,083208,Lim; Seonhee,9,0,35,26
1657071112875,MATH 10B,A03,093472,Lim; Seonhee,4,0,34,30
1657071112875,MATH 10B,B01,083739,Sinha; Shubham,9,0,30,21
1657071118899,MATH 18,A01,083743,Cinel; Cameron Alexander,6,0,30,24
1657071118899,MATH 18,A02,083744,Cinel; Cameron Alexander,15,0,30,15
1657071118899,MATH 18,A03,083745,Cinel; Cameron Alexander,8,0,30,22
1657071118899,MATH 18,B01,083748,Rideout; David Porter,4,0,37,33
1657071118899,MATH 18,B02,083749,Rideout; David Porter,3,0,36,33
1657071118899,MATH 18,B03,083750,Rideout; David Porter,2,0,37,35
1657071118899,MATH 18,B04,083751,Rideout; David Porter,5,0,36,31
1657071118899,MATH 18,B05,093473,Rideout; David Porter,4,0,36,32
1657071118899,MATH 18,B06,093474,Rideout; David Porter,5,0,36,31
1657071124925,MATH 20A,A01,083754,Zheng; Zequn,12,0,40,28
1657071130951,MATH 20B,A01,083756,Briones; Jor-el Thomas Caparas,1,0,36,35
1657071130951,MATH 20B,A02,083757,Briones; Jor-el Thomas Caparas,1,0,36,35
1657071130951,MATH 20B,A03,093475,Briones; Jor-el Thomas Caparas,0,0,36,36
1657071137589,MATH 20C,A01,083760,Briones; Jor-el Thomas Caparas,1,0,35,34
1657071137589,MATH 20C,A02,083761,Briones; Jor-el Thomas Caparas,8,0,35,27
1657071137589,MATH 20C,A03,093476,Briones; Jor-el Thomas Caparas,0,1,36,36
1657071137589,MATH 20C,B01,083762,Bach; Quang Tran,0,0,30,30
1657071143625,MATH 20D,A01,083765,Tran; Brian Kha,4,0,30,26
1657071143625,MATH 20D,A02,083766,Tran; Brian Kha,5,0,30,25
1657071143625,MATH 20D,A03,083767,Tran; Brian Kha,3,0,30,27
1657071149653,MATH 20E,A01,083771,Ganguly; Soumya,5,0,32,27
1657071149653,MATH 20E,A02,083772,Ganguly; Soumya,6,0,32,26
1657071149653,MATH 20E,B01,083773,Ciotti; Benjamin,18,0,35,17
1657071149653,MATH 20E,B02,083774,Ciotti; Benjamin,17,0,35,18
1657071155684,MATH 103A,A01,083777,Greenfeld; Be'Eri,2,0,36,34
1657071155684,MATH 103A,A02,083778,Greenfeld; Be'Eri,5,0,36,31
1657071155684,MATH 103A,A03,093561,Greenfeld; Be'Eri,4,0,36,32
1657071155684,MATH 103A,B01,083779,Greenfeld; Be'Eri,6,0,36,30
1657071155684,MATH 103A,B02,083780,Greenfeld; Be'Eri,2,0,36,34
1657071155684,MATH 103A,B03,093562,Greenfeld; Be'Eri,3,0,36,33
1657071161712,MATH 105,A01,085443,Carter; Anne Toulson,14,0,35,21
1657071161712,MATH 105,A02,093477,Carter; Anne Toulson,20,0,35,15
1657071167742,MATH 109,A01,083213,Ganzberger; Geoffrey Michael,2,0,34,32
1657071167742,MATH 109,A02,083214,Ganzberger; Geoffrey Michael,2,0,34,32
1657071167742,MATH 109,A03,093478,Ganzberger; Geoffrey Michael,1,0,34,33
1657071167742,MATH 109,B01,083215,Ganzberger; Geoffrey Michael,1,0,32,31
1657071167742,MATH 109,B02,083216,Ganzberger; Geoffrey Michael,1,0,32,31
1657071167742,MATH 109,B03,093479,Ganzberger; Geoffrey Michael,6,0,32,26
1657071173772,MATH 142A,A01,083219,Chow; Bennett,6,0,32,26
1657071173772,MATH 142A,A02,083220,Chow; Bennett,10,0,32,22
1657071173772,MATH 142A,A03,093480,Chow; Bennett,7,0,32,25
1657071173772,MATH 142A,B03,093481,Chow; Bennett,7,0,32,25
1657071173772,MATH 142A,B04,093558,Chow; Bennett,11,0,32,21
1657071173772,MATH 142A,B05,093559,Chow; Bennett,6,0,32,26
1657071179797,MATH 193A,A01,083224,Rotar; Vladimir,7,0,34,27
1657071179797,MATH 193A,A02,083225,Rotar; Vladimir,5,0,34,29
1657071179797,MATH 193A,A03,083781,Rotar; Vladimir,1,0,34,33
1657071179797,MATH 193A,A04,083782,Rotar; Vladimir,6,0,34,28
1657071179797,MATH 193A,A05,093482,Rotar; Vladimir,6,0,34,28
1657071185822,MATH 197,001,091859,McAuley; Julian John,9999,0,9999,0
1657071185822,MATH 197,002,095566,Kedlaya; Kiran S.,9997,0,9999,2
1657071185822,MATH 197,003,095567,Xiao; Ming,9999,0,9999,0
1657071185822,MATH 197,004,095571,Perols; Johan Lars,9998,0,9999,1
1657071192873,COGS 9,A01,083615,Shannon; Kyle Michael,7,0,75,68
1657071198912,COGS 11,A01,083617,Boyle; Mary E. T.,21,0,48,27
1657071204939,COGS 13,A01,083071,Bastos; Amalia Pinkusfeld,9,0,71,62
1657071210960,COGS 14A,A01,092681,Semenuks; Arturs,0,1,100,100
1657071216986,COGS 14B,A01,083073,Cheng; Tzu-Han,5,0,63,58
1657071223010,COGS 17,A01,092677,Semenuks; Arturs,4,0,81,77
1657071229037,COGS 100,A01,083619,Allen; Michael Gordon,15,0,70,55
1657071235059,COGS 101A,A01,083621,Davis; Joshua Daniel,9,0,68,59
1657071241082,COGS 101B,A01,091572,Allen; Michael Gordon,8,0,65,57
1657071247113,COGS 101C,A01,083625,Delgado; Tania,17,0,35,18
1657071253140,COGS 107A,A01,083627,Boyle; Mary E. T.,13,0,60,47
1657071259169,COGS 118A,A01,083075,Gupta; Anjum,15,0,76,61
1657071265191,CSE 3,A50,083646,Miranda; Gregory Joseph,22,0,50,28
1657071271213,CSE 8A,A50,083650,Miranda; Gregory Joseph,17,1,56,39
1657071277247,CSE 11,A01,083080,Cao; Yingjun,4,15,40,36
1657071283272,CSE 12,A01,083652,Krause-Levy; Sophia Louisa,23,1,120,97
1657071289296,CSE 15L,A01,083654,Morris; Justin Loren,8,0,50,42
1657071289296,CSE 15L,A02,083655,Morris; Justin Loren,9,0,50,41
1657071295338,CSE 20,A01,083657,Tran; Khoa Dang,37,0,80,43
1657071301364,CSE 21,A01,095574,Bach; Quang Tran,21,0,48,27
1657071307390,CSE 30,A01,083084,Eldon; John,4,0,80,76
1657071307390,CSE 30,B01,095061,Bhaskar; Nishant,6,0,50,44
1657071313415,CSE 100,A01,083659,Cao; Yingjun,3,4,70,67
1657071319438,CSE 134B,A01,083661,Powell; Thomas Allan,19,0,100,81
1657071325460,CSE 140,A01,083663,Gungor; Onat,14,0,85,71
1657071331486,CSE 140L,A01,083088,Eldon; John,16,0,100,84
1657071337509,CSE 175,A01,083665,Kumar; Rakesh,3,0,25,22
1657071343537,CSE 190,A00,092507,Dubnov; Shlomo,7,0,20,13
1657071349560,ECE 45,A01,083139,Congero; Spencer William,5,0,75,70
1657071355599,ECE 65,A50,083695,Saad; Andrew S,12,0,30,18
1657071355599,ECE 65,A51,095125,Saad; Andrew S,25,0,26,1
1657071361623,ECE 109,A01,091882,Touri; Behrouz,16,0,70,54
1657071367645,ECE 180,A00,083140,Abi Samra; Nicholas Camill,1,0,30,29
1657071367645,ECE 180,B00,083141,Abi Samra; Nicholas Camill,0,0,30,30
1657071373674,MATH 10A,A01,083735,Patchell; Gregory David,1,0,30,29
1657071373674,MATH 10A,A02,083736,Patchell; Gregory David,20,0,30,10
1657071373674,MATH 10A,A03,083737,Patchell; Gregory David,16,0,30,14
1657071379784,MATH 10B,A01,083207,Lim; Seonhee,7,0,34,27
1657071379784,MATH 10B,A02,083208,Lim; Seonhee,9,0,35,26
1657071379784,MATH 10B,A03,093472,Lim; Seonhee,4,0,34,30
1657071379784,MATH 10B,B01,083739,Sinha; Shubham,9,0,30,21
1657071385815,MATH 18,A01,083743,Cinel; Cameron Alexander,6,0,30,24
1657071385815,MATH 18,A02,083744,Cinel; Cameron Alexander,15,0,30,15
1657071385815,MATH 18,A03,083745,Cinel; Cameron Alexander,8,0,30,22
1657071385815,MATH 18,B01,083748,Rideout; David Porter,4,0,37,33
1657071385815,MATH 18,B02,083749,Rideout; David Porter,3,0,36,33
1657071385815,MATH 18,B03,083750,Rideout; David Porter,2,0,37,35
1657071385815,MATH 18,B04,083751,Rideout; David Porter,5,0,36,31
1657071385815,MATH 18,B05,093473,Rideout; David Porter,4,0,36,32
1657071385815,MATH 18,B06,093474,Rideout; David Porter,5,0,36,31
1657071391842,MATH 20A,A01,083754,Zheng; Zequn,12,0,40,28
1657071397867,MATH 20B,A01,083756,Briones; Jor-el Thomas Caparas,1,0,36,35
1657071397867,MATH 20B,A02,083757,Briones; Jor-el Thomas Caparas,1,0,36,35
1657071397867,MATH 20B,A03,093475,Briones; Jor-el Thomas Caparas,0,0,36,36
1657071403891,MATH 20C,A01,083760,Briones; Jor-el Thomas Caparas,1,0,35,34
1657071403891,MATH 20C,A02,083761,Briones; Jor-el Thomas Caparas,8,0,35,27
1657071403891,MATH 20C,A03,093476,Briones; Jor-el Thomas Caparas,0,1,36,36
1657071403891,MATH 20C,B01,083762,Bach; Quang Tran,0,0,30,30
1657071409914,MATH 20D,A01,083765,Tran; Brian Kha,4,0,30,26
1657071409914,MATH 20D,A02,083766,Tran; Brian Kha,5,0,30,25
1657071409914,MATH 20D,A03,083767,Tran; Brian Kha,3,0,30,27
1657071415938,MATH 20E,A01,083771,Ganguly; Soumya,5,0,32,27
1657071415938,MATH 20E,A02,083772,Ganguly; Soumya,6,0,32,26
1657071415938,MATH 20E,B01,083773,Ciotti; Benjamin,18,0,35,17
1657071415938,MATH 20E,B02,083774,Ciotti; Benjamin,17,0,35,18
1657071421965,MATH 103A,A01,083777,Greenfeld; Be'Eri,2,0,36,34
1657071421965,MATH 103A,A02,083778,Greenfeld; Be'Eri,5,0,36,31
1657071421965,MATH 103A,A03,093561,Greenfeld; Be'Eri,4,0,36,32
1657071421965,MATH 103A,B01,083779,Greenfeld; Be'Eri,6,0,36,30
1657071421965,MATH 103A,B02,083780,Greenfeld; Be'Eri,2,0,36,34
1657071421965,MATH 103A,B03,093562,Greenfeld; Be'Eri,3,0,36,33
1657071427992,MATH 105,A01,085443,Carter; Anne Toulson,14,0,35,21
1657071427992,MATH 105,A02,093477,Carter; Anne Toulson,20,0,35,15
1657071434015,MATH 109,A01,083213,Ganzberger; Geoffrey Michael,2,0,34,32
1657071434015,MATH 109,A02,083214,Ganzberger; Geoffrey Michael,2,0,34,32
1657071434015,MATH 109,A03,093478,Ganzberger; Geoffrey Michael,1,0,34,33
1657071434015,MATH 109,B01,083215,Ganzberger; Geoffrey Michael,1,0,32,31
1657071434015,MATH 109,B02,083216,Ganzberger; Geoffrey Michael,1,0,32,31
1657071434015,MATH 109,B03,093479,Ganzberger; Geoffrey Michael,6,0,32,26
1657071440040,MATH 142A,A01,083219,Chow; Bennett,6,0,32,26
1657071440040,MATH 142A,A02,083220,Chow; Bennett,10,0,32,22
1657071440040,MATH 142A,A03,093480,Chow; Bennett,7,0,32,25
1657071440040,MATH 142A,B03,093481,Chow; Bennett,7,0,32,25
1657071440040,MATH 142A,B04,093558,Chow; Bennett,11,0,32,21
1657071440040,MATH 142A,B05,093559,Chow; Bennett,6,0,32,26
1657071446068,MATH 193A,A01,083224,Rotar; Vladimir,7,0,34,27
1657071446068,MATH 193A,A02,083225,Rotar; Vladimir,5,0,34,29
1657071446068,MATH 193A,A03,083781,Rotar; Vladimir,1,0,34,33
1657071446068,MATH 193A,A04,083782,Rotar; Vladimir,6,0,34,28
1657071446068,MATH 193A,A05,093482,Rotar; Vladimir,6,0,34,28
1657071452095,MATH 197,001,091859,McAuley; Julian John,9999,0,9999,0
1657071452095,MATH 197,002,095566,Kedlaya; Kiran S.,9997,0,9999,2
1657071452095,MATH 197,003,095567,Xiao; Ming,9999,0,9999,0
1657071452095,MATH 197,004,095571,Perols; Johan Lars,9998,0,9999,1
1657071459161,COGS 9,A01,083615,Shannon; Kyle Michael,7,0,75,68
1657071465184,COGS 11,A01,083617,Boyle; Mary E. T.,21,0,48,27
1657071471212,COGS 13,A01,083071,Bastos; Amalia Pinkusfeld,9,0,71,62
1657071477239,COGS 14A,A01,092681,Semenuks; Arturs,0,1,100,100
1657071483264,COGS 14B,A01,083073,Cheng; Tzu-Han,5,0,63,58
1657071489291,COGS 17,A01,092677,Semenuks; Arturs,4,0,81,77
1657071495324,COGS 100,A01,083619,Allen; Michael Gordon,15,0,70,55
1657071501349,COGS 101A,A01,083621,Davis; Joshua Daniel,9,0,68,59
1657071507374,COGS 101B,A01,091572,Allen; Michael Gordon,8,0,65,57
1657071513398,COGS 101C,A01,083625,Delgado; Tania,17,0,35,18
1657071519427,COGS 107A,A01,083627,Boyle; Mary E. T.,13,0,60,47
1657071525451,COGS 118A,A01,083075,Gupta; Anjum,15,0,76,61
1657071531478,CSE 3,A50,083646,Miranda; Gregory Joseph,22,0,50,28
1657071537502,CSE 8A,A50,083650,Miranda; Gregory Joseph,17,1,56,39
1657071543529,CSE 11,A01,083080,Cao; Yingjun,4,15,40,36
1657071549551,CSE 12,A01,083652,Krause-Levy; Sophia Louisa,23,1,120,97
1657071555577,CSE 15L,A01,083654,Morris; Justin Loren,8,0,50,42
1657071555577,CSE 15L,A02,083655,Morris; Justin Loren,9,0,50,41
1657071561604,CSE 20,A01,083657,Tran; Khoa Dang,37,0,80,43
1657071567631,CSE 21,A01,095574,Bach; Quang Tran,21,0,48,27
1657071573658,CSE 30,A01,083084,Eldon; John,4,0,80,76
1657071573658,CSE 30,B01,095061,Bhaskar; Nishant,6,0,50,44
1657071579680,CSE 100,A01,083659,Cao; Yingjun,3,4,70,67
1657071585704,CSE 134B,A01,083661,Powell; Thomas Allan,19,0,100,81
1657071591728,CSE 140,A01,083663,Gungor; Onat,14,0,85,71
1657071597755,CSE 140L,A01,083088,Eldon; John,16,0,100,84
1657071603778,CSE 175,A01,083665,Kumar; Rakesh,3,0,25,22
1657071609801,CSE 190,A00,092507,Dubnov; Shlomo,7,0,20,13
1657071615825,ECE 45,A01,083139,Congero; Spencer William,5,0,75,70
1657071621847,ECE 65,A50,083695,Saad; Andrew S,12,0,30,18
1657071621847,ECE 65,A51,095125,Saad; Andrew S,25,0,26,1
1657071627885,ECE 109,A01,091882,Touri; Behrouz,16,0,70,54
1657071633908,ECE 180,A00,083140,Abi Samra; Nicholas Camill,1,0,30,29
1657071633908,ECE 180,B00,083141,Abi Samra; Nicholas Camill,0,0,30,30
1657071639934,MATH 10A,A01,083735,Patchell; Gregory David,1,0,30,29
1657071639934,MATH 10A,A02,083736,Patchell; Gregory David,20,0,30,10
1657071639934,MATH 10A,A03,083737,Patchell; Gregory David,16,0,30,14
1657071645960,MATH 10B,A01,083207,Lim; Seonhee,7,0,34,27
1657071645960,MATH 10B,A02,083208,Lim; Seonhee,9,0,35,26
1657071645960,MATH 10B,A03,093472,Lim; Seonhee,4,0,34,30
1657071645960,MATH 10B,B01,083739,Sinha; Shubham,9,0,30,21
1657071651984,MATH 18,A01,083743,Cinel; Cameron Alexander,6,0,30,24
1657071651984,MATH 18,A02,083744,Cinel; Cameron Alexander,15,0,30,15
1657071651984,MATH 18,A03,083745,Cinel; Cameron Alexander,8,0,30,22
1657071651984,MATH 18,B01,083748,Rideout; David Porter,4,0,37,33
1657071651984,MATH 18,B02,083749,Rideout; David Porter,3,0,36,33
1657071651984,MATH 18,B03,083750,Rideout; David Porter,2,0,37,35
1657071651984,MATH 18,B04,083751,Rideout; David Porter,5,0,36,31
1657071651984,MATH 18,B05,093473,Rideout; David Porter,4,0,36,32
1657071651984,MATH 18,B06,093474,Rideout; David Porter,5,0,36,31
1657071658013,MATH 20A,A01,083754,Zheng; Zequn,12,0,40,28
1657071664036,MATH 20B,A01,083756,Briones; Jor-el Thomas Caparas,1,0,36,35
1657071664036,MATH 20B,A02,083757,Briones; Jor-el Thomas Caparas,1,0,36,35
1657071664036,MATH 20B,A03,093475,Briones; Jor-el Thomas Caparas,0,0,36,36
1657071670064,MATH 20C,A01,083760,Briones; Jor-el Thomas Caparas,1,0,35,34
1657071670064,MATH 20C,A02,083761,Briones; Jor-el Thomas Caparas,8,0,35,27
1657071670064,MATH 20C,A03,093476,Briones; Jor-el Thomas Caparas,0,1,36,36
1657071670064,MATH 20C,B01,083762,Bach; Quang Tran,0,0,30,30
1657071676091,MATH 20D,A01,083765,Tran; Brian Kha,4,0,30,26
1657071676091,MATH 20D,A02,083766,Tran; Brian Kha,5,0,30,25
1657071676091,MATH 20D,A03,083767,Tran; Brian Kha,3,0,30,27
1657071682115,MATH 20E,A01,083771,Ganguly; Soumya,5,0,32,27
1657071682115,MATH 20E,A02,083772,Ganguly; Soumya,6,0,32,26
1657071682115,MATH 20E,B01,083773,Ciotti; Benjamin,18,0,35,17
1657071682115,MATH 20E,B02,083774,Ciotti; Benjamin,17,0,35,18
1657071688153,MATH 103A,A01,083777,Greenfeld; Be'Eri,2,0,36,34
1657071688153,MATH 103A,A02,083778,Greenfeld; Be'Eri,5,0,36,31
1657071688153,MATH 103A,A03,093561,Greenfeld; Be'Eri,4,0,36,32
1657071688153,MATH 103A,B01,083779,Greenfeld; Be'Eri,6,0,36,30
1657071688153,MATH 103A,B02,083780,Greenfeld; Be'Eri,2,0,36,34
1657071688153,MATH 103A,B03,093562,Greenfeld; Be'Eri,3,0,36,33
1657071694176,MATH 105,A01,085443,Carter; Anne Toulson,14,0,35,21
1657071694176,MATH 105,A02,093477,Carter; Anne Toulson,20,0,35,15
1657071700205,MATH 109,A01,083213,Ganzberger; Geoffrey Michael,2,0,34,32
1657071700205,MATH 109,A02,083214,Ganzberger; Geoffrey Michael,2,0,34,32
1657071700205,MATH 109,A03,093478,Ganzberger; Geoffrey Michael,1,0,34,33
1657071700205,MATH 109,B01,083215,Ganzberger; Geoffrey Michael,1,0,32,31
1657071700205,MATH 109,B02,083216,Ganzberger; Geoffrey Michael,1,0,32,31
1657071700205,MATH 109,B03,093479,Ganzberger; Geoffrey Michael,6,0,32,26
1657071706229,MATH 142A,A01,083219,Chow; Bennett,6,0,32,26
1657071706229,MATH 142A,A02,083220,Chow; Bennett,10,0,32,22
1657071706229,MATH 142A,A03,093480,Chow; Bennett,7,0,32,25
1657071706229,MATH 142A,B03,093481,Chow; Bennett,7,0,32,25
1657071706229,MATH 142A,B04,093558,Chow; Bennett,11,0,32,21
1657071706229,MATH 142A,B05,093559,Chow; Bennett,6,0,32,26
1657071712268,MATH 193A,A01,083224,Rotar; Vladimir,7,0,34,27
1657071712268,MATH 193A,A02,083225,Rotar; Vladimir,5,0,34,29
1657071712268,MATH 193A,A03,083781,Rotar; Vladimir,1,0,34,33
1657071712268,MATH 193A,A04,083782,Rotar; Vladimir,6,0,34,28
1657071712268,MATH 193A,A05,093482,Rotar; Vladimir,6,0,34,28
1657071718291,MATH 197,001,091859,McAuley; Julian John,9999,0,9999,0
1657071718291,MATH 197,002,095566,Kedlaya; Kiran S.,9997,0,9999,2
1657071718291,MATH 197,003,095567,Xiao; Ming,9999,0,9999,0
1657071718291,MATH 197,004,095571,Perols; Johan Lars,9998,0,9999,1
1657071725354,COGS 9,A01,083615,Shannon; Kyle Michael,7,0,75,68
1657071731381,COGS 11,A01,083617,Boyle; Mary E. T.,21,0,48,27
1657071737409,COGS 13,A01,083071,Bastos; Amalia Pinkusfeld,9,0,71,62
1657071743437,COGS 14A,A01,092681,Semenuks; Arturs,0,1,100,100
1657071749463,COGS 14B,A01,083073,Cheng; Tzu-Han,5,0,63,58
1657071755493,COGS 17,A01,092677,Semenuks; Arturs,4,0,81,77
1657071761525,COGS 100,A01,083619,Allen; Michael Gordon,15,0,70,55
1657071767552,COGS 101A,A01,083621,Davis; Joshua Daniel,9,0,68,59
1657071773574,COGS 101B,A01,091572,Allen; Michael Gordon,8,0,65,57
1657071779600,COGS 101C,A01,083625,Delgado; Tania,17,0,35,18
1657071785627,COGS 107A,A01,083627,Boyle; Mary E. T.,13,0,60,47
1657071791651,COGS 118A,A01,083075,Gupta; Anjum,15,0,76,61
1657071797674,CSE 3,A50,083646,Miranda; Gregory Joseph,22,0,50,28
1657071803695,CSE 8A,A50,083650,Miranda; Gregory Joseph,17,1,56,39
1657071809718,CSE 11,A01,083080,Cao; Yingjun,4,15,40,36
1657071815744,CSE 12,A01,083652,Krause-Levy; Sophia Louisa,23,1,120,97
1657071821776,CSE 15L,A01,083654,Morris; Justin Loren,8,0,50,42
1657071821776,CSE 15L,A02,083655,Morris; Justin Loren,9,0,50,41
1657071827798,CSE 20,A01,083657,Tran; Khoa Dang,37,0,80,43
1657071833823,CSE 21,A01,095574,Bach; Quang Tran,21,0,48,27
1657071839850,CSE 30,A01,083084,Eldon; John,4,0,80,76
1657071839850,CSE 30,B01,095061,Bhaskar; Nishant,6,0,50,44
1657071845874,CSE 100,A01,083659,Cao; Yingjun,3,4,70,67
1657071851901,CSE 134B,A01,083661,Powell; Thomas Allan,19,0,100,81
1657071857922,CSE 140,A01,083663,Gungor; Onat,14,0,85,71
1657071863945,CSE 140L,A01,083088,Eldon; John,16,0,100,84
1657071869972,CSE 175,A01,083665,Kumar; Rakesh,3,0,25,22
1657071875994,CSE 190,A00,092507,Dubnov; Shlomo,7,0,20,13
1657071882015,ECE 45,A01,083139,Congero; Spencer William,5,0,75,70
1657071888044,ECE 65,A50,083695,Saad; Andrew S,12,0,30,18
1657071888044,ECE 65,A51,095125,Saad; Andrew S,25,0,26,1
1657071894071,ECE 109,A01,091882,Touri; Behrouz,16,0,70,54
1657071900093,ECE 180,A00,083140,Abi Samra; Nicholas Camill,1,0,30,29
1657071900093,ECE 180,B00,083141,Abi Samra; Nicholas Camill,0,0,30,30
1657071906124,MATH 10A,A01,083735,Patchell; Gregory David,1,0,30,29
1657071906124,MATH 10A,A02,083736,Patchell; Gregory David,20,0,30,10
1657071906124,MATH 10A,A03,083737,Patchell; Gregory David,16,0,30,14
1657071912147,MATH 10B,A01,083207,Lim; Seonhee,7,0,34,27
1657071912147,MATH 10B,A02,083208,Lim; Seonhee,9,0,35,26
1657071912147,MATH 10B,A03,093472,Lim; Seonhee,4,0,34,30
1657071912147,MATH 10B,B01,083739,Sinha; Shubham,9,0,30,21
1657071918170,MATH 18,A01,083743,Cinel; Cameron Alexander,6,0,30,24
1657071918170,MATH 18,A02,083744,Cinel; Cameron Alexander,15,0,30,15
1657071918170,MATH 18,A03,083745,Cinel; Cameron Alexander,8,0,30,22
1657071918170,MATH 18,B01,083748,Rideout; David Porter,4,0,37,33
1657071918170,MATH 18,B02,083749,Rideout; David Porter,3,0,36,33
1657071918170,MATH 18,B03,083750,Rideout; David Porter,2,0,37,35
1657071918170,MATH 18,B04,083751,Rideout; David Porter,5,0,36,31
1657071918170,MATH 18,B05,093473,Rideout; David Porter,4,0,36,32
1657071918170,MATH 18,B06,093474,Rideout; David Porter,5,0,36,31
1657071924200,MATH 20A,A01,083754,Zheng; Zequn,12,0,40,28
1657071930230,MATH 20B,A01,083756,Briones; Jor-el Thomas Caparas,1,0,36,35
1657071930230,MATH 20B,A02,083757,Briones; Jor-el Thomas Caparas,1,0,36,35
1657071930230,MATH 20B,A03,093475,Briones; Jor-el Thomas Caparas,0,0,36,36
1657071936254,MATH 20C,A01,083760,Briones; Jor-el Thomas Caparas,1,0,35,34
1657071936254,MATH 20C,A02,083761,Briones; Jor-el Thomas Caparas,8,0,35,27
1657071936254,MATH 20C,A03,093476,Briones; Jor-el Thomas Caparas,0,1,36,36
1657071936254,MATH 20C,B01,083762,Bach; Quang Tran,0,0,30,30
1657071942284,MATH 20D,A01,083765,Tran; Brian Kha,4,0,30,26
1657071942284,MATH 20D,A02,083766,Tran; Brian Kha,5,0,30,25
1657071942284,MATH 20D,A03,083767,Tran; Brian Kha,3,0,30,27
1657071948320,MATH 20E,A01,083771,Ganguly; Soumya,5,0,32,27
1657071948320,MATH 20E,A02,083772,Ganguly; Soumya,6,0,32,26
1657071948320,MATH 20E,B01,083773,Ciotti; Benjamin,18,0,35,17
1657071948320,MATH 20E,B02,083774,Ciotti; Benjamin,17,0,35,18
1657071954344,MATH 103A,A01,083777,Greenfeld; Be'Eri,2,0,36,34
1657071954344,MATH 103A,A02,083778,Greenfeld; Be'Eri,5,0,36,31
1657071954344,MATH 103A,A03,093561,Greenfeld; Be'Eri,4,0,36,32
1657071954344,MATH 103A,B01,083779,Greenfeld; Be'Eri,6,0,36,30
1657071954344,MATH 103A,B02,083780,Greenfeld; Be'Eri,2,0,36,34
1657071954344,MATH 103A,B03,093562,Greenfeld; Be'Eri,3,0,36,33
1657071960372,MATH 105,A01,085443,Carter; Anne Toulson,14,0,35,21
1657071960372,MATH 105,A02,093477,Carter; Anne Toulson,20,0,35,15
1657071966396,MATH 109,A01,083213,Ganzberger; Geoffrey Michael,2,0,34,32
1657071966396,MATH 109,A02,083214,Ganzberger; Geoffrey Michael,2,0,34,32
1657071966396,MATH 109,A03,093478,Ganzberger; Geoffrey Michael,1,0,34,33
1657071966396,MATH 109,B01,083215,Ganzberger; Geoffrey Michael,1,0,32,31
1657071966396,MATH 109,B02,083216,Ganzberger; Geoffrey Michael,1,0,32,31
1657071966396,MATH 109,B03,093479,Ganzberger; Geoffrey Michael,6,0,32,26
1657071972426,MATH 142A,A01,083219,Chow; Bennett,6,0,32,26
1657071972426,MATH 142A,A02,083220,Chow; Bennett,10,0,32,22
1657071972426,MATH 142A,A03,093480,Chow; Bennett,7,0,32,25
1657071972426,MATH 142A,B03,093481,Chow; Bennett,7,0,32,25
1657071972426,MATH 142A,B04,093558,Chow; Bennett,11,0,32,21
1657071972426,MATH 142A,B05,093559,Chow; Bennett,6,0,32,26
1657071978521,MATH 193A,A01,083224,Rotar; Vladimir,7,0,34,27
1657071978521,MATH 193A,A02,083225,Rotar; Vladimir,5,0,34,29
1657071978521,MATH 193A,A03,083781,Rotar; Vladimir,1,0,34,33
1657071978521,MATH 193A,A04,083782,Rotar; Vladimir,6,0,34,28
1657071978521,MATH 193A,A05,093482,Rotar; Vladimir,6,0,34,28
1657071984547,MATH 197,001,091859,McAuley; Julian John,9999,0,9999,0
1657071984547,MATH 197,002,095566,Kedlaya; Kiran S.,9997,0,9999,2
1657071984547,MATH 197,003,095567,Xiao; Ming,9999,0,9999,0
1657071984547,MATH 197,004,095571,Perols; Johan Lars,9998,0,9999,1
1657071991604,COGS 9,A01,083615,Shannon; Kyle Michael,7,0,75,68
1657071997625,COGS 11,A01,083617,Boyle; Mary E. T.,21,0,48,27
1657072003647,COGS 13,A01,083071,Bastos; Amalia Pinkusfeld,9,0,71,62
1657072009672,COGS 14A,A01,092681,Semenuks; Arturs,0,1,100,100
1657072015712,COGS 14B,A01,083073,Cheng; Tzu-Han,5,0,63,58
1657072021743,COGS 17,A01,092677,Semenuks; Arturs,4,0,81,77
1657072027766,COGS 100,A01,083619,Allen; Michael Gordon,15,0,70,55
1657072033806,COGS 101A,A01,083621,Davis; Joshua Daniel,9,0,68,59
1657072039828,COGS 101B,A01,091572,Allen; Michael Gordon,8,0,65,57
1657072045854,COGS 101C,A01,083625,Delgado; Tania,17,0,35,18
1657072051880,COGS 107A,A01,083627,Boyle; Mary E. T.,13,0,60,47
1657072057909,COGS 118A,A01,083075,Gupta; Anjum,15,0,76,61
1657072063938,CSE 3,A50,083646,Miranda; Gregory Joseph,22,0,50,28
1657072069968,CSE 8A,A50,083650,Miranda; Gregory Joseph,17,1,56,39
1657072076002,CSE 11,A01,083080,Cao; Yingjun,4,15,40,36
1657072082025,CSE 12,A01,083652,Krause-Levy; Sophia Louisa,23,1,120,97
1657072088049,CSE 15L,A01,083654,Morris; Justin Loren,8,0,50,42
1657072088049,CSE 15L,A02,083655,Morris; Justin Loren,9,0,50,41
1657072094075,CSE 20,A01,083657,Tran; Khoa Dang,37,0,80,43
1657072100096,CSE 21,A01,095574,Bach; Quang Tran,21,0,48,27
1657072106123,CSE 30,A01,083084,Eldon; John,4,0,80,76
1657072106123,CSE 30,B01,095061,Bhaskar; Nishant,6,0,50,44
1657072112147,CSE 100,A01,083659,Cao; Yingjun,3,4,70,67
1657072118175,CSE 134B,A01,083661,Powell; Thomas Allan,19,0,100,81
1657072124197,CSE 140,A01,083663,Gungor; Onat,14,0,85,71
1657072130220,CSE 140L,A01,083088,Eldon; John,16,0,100,84
1657072136245,CSE 175,A01,083665,Kumar; Rakesh,3,0,25,22
1657072142268,CSE 190,A00,092507,Dubnov; Shlomo,7,0,20,13
1657072148292,ECE 45,A01,083139,Congero; Spencer William,5,0,75,70
1657072154316,ECE 65,A50,083695,Saad; Andrew S,12,0,30,18
1657072154316,ECE 65,A51,095125,Saad; Andrew S,25,0,26,1
1657072160349,ECE 109,A01,091882,Touri; Behrouz,16,0,70,54
1657072166378,ECE 180,A00,083140,Abi Samra; Nicholas Camill,1,0,30,29
1657072166378,ECE 180,B00,083141,Abi Samra; Nicholas Camill,0,0,30,30
1657072172403,MATH 10A,A01,083735,Patchell; Gregory David,1,0,30,29
1657072172403,MATH 10A,A02,083736,Patchell; Gregory David,20,0,30,10
1657072172403,MATH 10A,A03,083737,Patchell; Gregory David,16,0,30,14
1657072178428,MATH 10B,A01,083207,Lim; Seonhee,7,0,34,27
1657072178428,MATH 10B,A02,083208,Lim; Seonhee,9,0,35,26
1657072178428,MATH 10B,A03,093472,Lim; Seonhee,4,0,34,30
1657072178428,MATH 10B,B01,083739,Sinha; Shubham,9,0,30,21
1657072184451,MATH 18,A01,083743,Cinel; Cameron Alexander,6,0,30,24
1657072184451,MATH 18,A02,083744,Cinel; Cameron Alexander,15,0,30,15
1657072184451,MATH 18,A03,083745,Cinel; Cameron Alexander,8,0,30,22
1657072184451,MATH 18,B01,083748,Rideout; David Porter,4,0,37,33
1657072184451,MATH 18,B02,083749,Rideout; David Porter,3,0,36,33
1657072184451,MATH 18,B03,083750,Rideout; David Porter,2,0,37,35
1657072184451,MATH 18,B04,083751,Rideout; David Porter,5,0,36,31
1657072184451,MATH 18,B05,093473,Rideout; David Porter,4,0,36,32
1657072184451,MATH 18,B06,093474,Rideout; David Porter,5,0,36,31
1657072190476,MATH 20A,A01,083754,Zheng; Zequn,12,0,40,28
1657072196499,MATH 20B,A01,083756,Briones; Jor-el Thomas Caparas,1,0,36,35
1657072196499,MATH 20B,A02,083757,Briones; Jor-el Thomas Caparas,1,0,36,35
1657072196499,MATH 20B,A03,093475,Briones; Jor-el Thomas Caparas,0,0,36,36
1657072202528,MATH 20C,A01,083760,Briones; Jor-el Thomas Caparas,1,0,35,34
1657072202528,MATH 20C,A02,083761,Briones; Jor-el Thomas Caparas,8,0,35,27
1657072202528,MATH 20C,A03,093476,Briones; Jor-el Thomas Caparas,0,1,36,36
1657072202528,MATH 20C,B01,083762,Bach; Quang Tran,0,0,30,30
1657072208550,MATH 20D,A01,083765,Tran; Brian Kha,4,0,30,26
1657072208550,MATH 20D,A02,083766,Tran; Brian Kha,5,0,30,25
1657072208550,MATH 20D,A03,083767,Tran; Brian Kha,3,0,30,27
1657072214576,MATH 20E,A01,083771,Ganguly; Soumya,5,0,32,27
1657072214576,MATH 20E,A02,083772,Ganguly; Soumya,6,0,32,26
1657072214576,MATH 20E,B01,083773,Ciotti; Benjamin,18,0,35,17
1657072214576,MATH 20E,B02,083774,Ciotti; Benjamin,17,0,35,18
1657072220606,MATH 103A,A01,083777,Greenfeld; Be'Eri,2,0,36,34
1657072220606,MATH 103A,A02,083778,Greenfeld; Be'Eri,5,0,36,31
1657072220606,MATH 103A,A03,093561,Greenfeld; Be'Eri,4,0,36,32
1657072220606,MATH 103A,B01,083779,Greenfeld; Be'Eri,6,0,36,30
1657072220606,MATH 103A,B02,083780,Greenfeld; Be'Eri,2,0,36,34
1657072220606,MATH 103A,B03,093562,Greenfeld; Be'Eri,3,0,36,33
1657072226638,MATH 105,A01,085443,Carter; Anne Toulson,14,0,35,21
1657072226638,MATH 105,A02,093477,Carter; Anne Toulson,20,0,35,15
1657072232663,MATH 109,A01,083213,Ganzberger; Geoffrey Michael,2,0,34,32
1657072232663,MATH 109,A02,083214,Ganzberger; Geoffrey Michael,2,0,34,32
1657072232663,MATH 109,A03,093478,Ganzberger; Geoffrey Michael,1,0,34,33
1657072232663,MATH 109,B01,083215,Ganzberger; Geoffrey Michael,1,0,32,31
1657072232663,MATH 109,B02,083216,Ganzberger; Geoffrey Michael,1,0,32,31
1657072232663,MATH 109,B03,093479,Ganzberger; Geoffrey Michael,6,0,32,26
1657072238687,MATH 142A,A01,083219,Chow; Bennett,6,0,32,26
1657072238687,MATH 142A,A02,083220,Chow; Bennett,10,0,32,22
1657072238687,MATH 142A,A03,093480,Chow; Bennett,7,0,32,25
1657072238687,MATH 142A,B03,093481,Chow; Bennett,7,0,32,25
1657072238687,MATH 142A,B04,093558,Chow; Bennett,11,0,32,21
1657072238687,MATH 142A,B05,093559,Chow; Bennett,6,0,32,26
1657072244714,MATH 193A,A01,083224,Rotar; Vladimir,7,0,34,27
1657072244714,MATH 193A,A02,083225,Rotar; Vladimir,5,0,34,29
1657072244714,MATH 193A,A03,083781,Rotar; Vladimir,1,0,34,33
1657072244714,MATH 193A,A04,083782,Rotar; Vladimir,6,0,34,28
1657072244714,MATH 193A,A05,093482,Rotar; Vladimir,6,0,34,28
1657072250737,MATH 197,001,091859,McAuley; Julian John,9999,0,9999,0
1657072250737,MATH 197,002,095566,Kedlaya; Kiran S.,9997,0,9999,2
1657072250737,MATH 197,003,095567,Xiao; Ming,9999,0,9999,0
1657072250737,MATH 197,004,095571,Perols; Johan Lars,9998,0,9999,1
1657072257793,COGS 9,A01,083615,Shannon; Kyle Michael,7,0,75,68
1657072263814,COGS 11,A01,083617,Boyle; Mary E. T.,21,0,48,27
1657072269839,COGS 13,A01,083071,Bastos; Amalia Pinkusfeld,9,0,71,62
1657072275861,COGS 14A,A01,092681,Semenuks; Arturs,0,1,100,100
1657072281888,COGS 14B,A01,083073,Cheng; Tzu-Han,5,0,63,58
1657072287911,COGS 17,A01,092677,Semenuks; Arturs,4,0,81,77
1657072293934,COGS 100,A01,083619,Allen; Michael Gordon,15,0,70,55
1657072299962,COGS 101A,A01,083621,Davis; Joshua Daniel,9,0,68,59
1657072306004,COGS 101B,A01,091572,Allen; Michael Gordon,8,0,65,57
1657072312027,COGS 101C,A01,083625,Delgado; Tania,17,0,35,18
1657072318058,COGS 107A,A01,083627,Boyle; Mary E. T.,13,0,60,47
1657072324084,COGS 118A,A01,083075,Gupta; Anjum,15,0,76,61
1657072330106,CSE 3,A50,083646,Miranda; Gregory Joseph,22,0,50,28
1657072336127,CSE 8A,A50,083650,Miranda; Gregory Joseph,17,1,56,39
1657072342151,CSE 11,A01,083080,Cao; Yingjun,4,15,40,36
1657072348175,CSE 12,A01,083652,Krause-Levy; Sophia Louisa,23,1,120,97
1657072354197,CSE 15L,A01,083654,Morris; Justin Loren,8,0,50,42
1657072354197,CSE 15L,A02,083655,Morris; Justin Loren,9,0,50,41
1657072360219,CSE 20,A01,083657,Tran; Khoa Dang,37,0,80,43
1657072366243,CSE 21,A01,095574,Bach; Quang Tran,21,0,48,27
1657072372268,CSE 30,A01,083084,Eldon; John,4,0,80,76
1657072372268,CSE 30,B01,095061,Bhaskar; Nishant,6,0,50,44
1657072378292,CSE 100,A01,083659,Cao; Yingjun,3,4,70,67
1657072384315,CSE 134B,A01,083661,Powell; Thomas Allan,19,0,100,81
1657072390339,CSE 140,A01,083663,Gungor; Onat,14,0,85,71
1657072396372,CSE 140L,A01,083088,Eldon; John,16,0,100,84
1657072402417,CSE 175,A01,083665,Kumar; Rakesh,3,0,25,22
1657072408440,CSE 190,A00,092507,Dubnov; Shlomo,7,0,20,13
1657072414464,ECE 45,A01,083139,Congero; Spencer William,5,0,75,70
1657072420487,ECE 65,A50,083695,Saad; Andrew S,12,0,30,18
1657072420487,ECE 65,A51,095125,Saad; Andrew S,25,0,26,1
1657072426518,ECE 109,A01,091882,Touri; Behrouz,16,0,70,54
1657072432542,ECE 180,A00,083140,Abi Samra; Nicholas Camill,1,0,30,29
1657072432542,ECE 180,B00,083141,Abi Samra; Nicholas Camill,0,0,30,30
1657072438564,MATH 10A,A01,083735,Patchell; Gregory David,1,0,30,29
1657072438564,MATH 10A,A02,083736,Patchell; Gregory David,20,0,30,10
1657072438564,MATH 10A,A03,083737,Patchell; Gregory David,16,0,30,14
1657072444597,MATH 10B,A01,083207,Lim; Seonhee,7,0,34,27
1657072444597,MATH 10B,A02,083208,Lim; Seonhee,9,0,35,26
1657072444597,MATH 10B,A03,093472,Lim; Seonhee,4,0,34,30
1657072444597,MATH 10B,B01,083739,Sinha; Shubham,9,0,30,21
1657072450621,MATH 18,A01,083743,Cinel; Cameron Alexander,6,0,30,24
1657072450621,MATH 18,A02,083744,Cinel; Cameron Alexander,15,0,30,15
1657072450621,MATH 18,A03,083745,Cinel; Cameron Alexander,8,0,30,22
1657072450621,MATH 18,B01,083748,Rideout; David Porter,4,0,37,33
1657072450621,MATH 18,B02,083749,Rideout; David Porter,3,0,36,33
1657072450621,MATH 18,B03,083750,Rideout; David Porter,2,0,37,35
1657072450621,MATH 18,B04,083751,Rideout; David Porter,5,0,36,31
1657072450621,MATH 18,B05,093473,Rideout; David Porter,4,0,36,32
1657072450621,MATH 18,B06,093474,Rideout; David Porter,5,0,36,31
1657072456665,MATH 20A,A01,083754,Zheng; Zequn,12,0,40,28
1657072462694,MATH 20B,A01,083756,Briones; Jor-el Thomas Caparas,1,0,36,35
1657072462694,MATH 20B,A02,083757,Briones; Jor-el Thomas Caparas,1,0,36,35
1657072462694,MATH 20B,A03,093475,Briones; Jor-el Thomas Caparas,0,0,36,36
1657072468717,MATH 20C,A01,083760,Briones; Jor-el Thomas Caparas,1,0,35,34
1657072468717,MATH 20C,A02,083761,Briones; Jor-el Thomas Caparas,8,0,35,27
1657072468717,MATH 20C,A03,093476,Briones; Jor-el Thomas Caparas,0,1,36,36
1657072468717,MATH 20C,B01,083762,Bach; Quang Tran,0,0,30,30
1657072474742,MATH 20D,A01,083765,Tran; Brian Kha,4,0,30,26
1657072474742,MATH 20D,A02,083766,Tran; Brian Kha,5,0,30,25
1657072474742,MATH 20D,A03,083767,Tran; Brian Kha,3,0,30,27
1657072480770,MATH 20E,A01,083771,Ganguly; Soumya,5,0,32,27
1657072480770,MATH 20E,A02,083772,Ganguly; Soumya,6,0,32,26
1657072480770,MATH 20E,B01,083773,Ciotti; Benjamin,18,0,35,17
1657072480770,MATH 20E,B02,083774,Ciotti; Benjamin,17,0,35,18
1657072486796,MATH 103A,A01,083777,Greenfeld; Be'Eri,2,0,36,34
1657072486796,MATH 103A,A02,083778,Greenfeld; Be'Eri,5,0,36,31
1657072486796,MATH 103A,A03,093561,Greenfeld; Be'Eri,4,0,36,32
1657072486796,MATH 103A,B01,083779,Greenfeld; Be'Eri,6,0,36,30
1657072486796,MATH 103A,B02,083780,Greenfeld; Be'Eri,2,0,36,34
1657072486796,MATH 103A,B03,093562,Greenfeld; Be'Eri,3,0,36,33
1657072492826,MATH 105,A01,085443,Carter; Anne Toulson,14,0,35,21
1657072492826,MATH 105,A02,093477,Carter; Anne Toulson,20,0,35,15
1657072498855,MATH 109,A01,083213,Ganzberger; Geoffrey Michael,2,0,34,32
1657072498855,MATH 109,A02,083214,Ganzberger; Geoffrey Michael,2,0,34,32
1657072498855,MATH 109,A03,093478,Ganzberger; Geoffrey Michael,1,0,34,33
1657072498855,MATH 109,B01,083215,Ganzberger; Geoffrey Michael,1,0,32,31
1657072498855,MATH 109,B02,083216,Ganzberger; Geoffrey Michael,1,0,32,31
1657072498855,MATH 109,B03,093479,Ganzberger; Geoffrey Michael,6,0,32,26
1657072504884,MATH 142A,A01,083219,Chow; Bennett,6,0,32,26
1657072504884,MATH 142A,A02,083220,Chow; Bennett,10,0,32,22
1657072504884,MATH 142A,A03,093480,Chow; Bennett,7,0,32,25
1657072504884,MATH 142A,B03,093481,Chow; Bennett,7,0,32,25
1657072504884,MATH 142A,B04,093558,Chow; Bennett,11,0,32,21
1657072504884,MATH 142A,B05,093559,Chow; Bennett,6,0,32,26
1657072510907,MATH 193A,A01,083224,Rotar; Vladimir,7,0,34,27
1657072510907,MATH 193A,A02,083225,Rotar; Vladimir,5,0,34,29
1657072510907,MATH 193A,A03,083781,Rotar; Vladimir,1,0,34,33
1657072510907,MATH 193A,A04,083782,Rotar; Vladimir,6,0,34,28
1657072510907,MATH 193A,A05,093482,Rotar; Vladimir,6,0,34,28
1657072516931,MATH 197,001,091859,McAuley; Julian John,9999,0,9999,0
1657072516931,MATH 197,002,095566,Kedlaya; Kiran S.,9997,0,9999,2
1657072516931,MATH 197,003,095567,Xiao; Ming,9999,0,9999,0
1657072516931,MATH 197,004,095571,Perols; Johan Lars,9998,0,9999,1
1657072523985,COGS 9,A01,083615,Shannon; Kyle Michael,7,0,75,68
1657072530012,COGS 11,A01,083617,Boyle; Mary E. T.,21,0,48,27
1657072536036,COGS 13,A01,083071,Bastos; Amalia Pinkusfeld,9,0,71,62
1657072542060,COGS 14A,A01,092681,Semenuks; Arturs,0,1,100,100
1657072548091,COGS 14B,A01,083073,Cheng; Tzu-Han,5,0,63,58
1657072554115,COGS 17,A01,092677,Semenuks; Arturs,4,0,81,77
1657072560138,COGS 100,A01,083619,Allen; Michael Gordon,15,0,70,55
1657072566163,COGS 101A,A01,083621,Davis; Joshua Daniel,9,0,68,59
1657072572281,COGS 101B,A01,091572,Allen; Michael Gordon,8,0,65,57
1657072578308,COGS 101C,A01,083625,Delgado; Tania,17,0,35,18
1657072584332,COGS 107A,A01,083627,Boyle; Mary E. T.,13,0,60,47
1657072590355,COGS 118A,A01,083075,Gupta; Anjum,15,0,76,61
1657072596386,CSE 3,A50,083646,Miranda; Gregory Joseph,22,0,50,28
1657072602412,CSE 8A,A50,083650,Miranda; Gregory Joseph,17,1,56,39
1657072608435,CSE 11,A01,083080,Cao; Yingjun,4,15,40,36
1657072614460,CSE 12,A01,083652,Krause-Levy; Sophia Louisa,23,1,120,97
1657072620486,CSE 15L,A01,083654,Morris; Justin Loren,8,0,50,42
1657072620486,CSE 15L,A02,083655,Morris; Justin Loren,9,0,50,41
1657072626512,CSE 20,A01,083657,Tran; Khoa Dang,37,0,80,43
1657072632533,CSE 21,A01,095574,Bach; Quang Tran,21,0,48,27
1657072638559,CSE 30,A01,083084,Eldon; John,4,0,80,76
1657072638559,CSE 30,B01,095061,Bhaskar; Nishant,6,0,50,44
1657072644582,CSE 100,A01,083659,Cao; Yingjun,3,4,70,67
1657072650605,CSE 134B,A01,083661,Powell; Thomas Allan,19,0,100,81
1657072656633,CSE 140,A01,083663,Gungor; Onat,14,0,85,71
1657072662665,CSE 140L,A01,083088,Eldon; John,16,0,100,84
1657072668690,CSE 175,A01,083665,Kumar; Rakesh,3,0,25,22
1657072674714,CSE 190,A00,092507,Dubnov; Shlomo,7,0,20,13
1657072680735,ECE 45,A01,083139,Congero; Spencer William,5,0,75,70
1657072686762,ECE 65,A50,083695,Saad; Andrew S,12,0,30,18
1657072686762,ECE 65,A51,095125,Saad; Andrew S,25,0,26,1
1657072692785,ECE 109,A01,091882,Touri; Behrouz,16,0,70,54
1657072698807,ECE 180,A00,083140,Abi Samra; Nicholas Camill,1,0,30,29
1657072698807,ECE 180,B00,083141,Abi Samra; Nicholas Camill,0,0,30,30
1657072704833,MATH 10A,A01,083735,Patchell; Gregory David,1,0,30,29
1657072704833,MATH 10A,A02,083736,Patchell; Gregory David,20,0,30,10
1657072704833,MATH 10A,A03,083737,Patchell; Gregory David,16,0,30,14
1657072710861,MATH 10B,A01,083207,Lim; Seonhee,7,0,34,27
1657072710861,MATH 10B,A02,083208,Lim; Seonhee,9,0,35,26
1657072710861,MATH 10B,A03,093472,Lim; Seonhee,4,0,34,30
1657072710861,MATH 10B,B01,083739,Sinha; Shubham,9,0,30,21
1657072716893,MATH 18,A01,083743,Cinel; Cameron Alexander,6,0,30,24
1657072716893,MATH 18,A02,083744,Cinel; Cameron Alexander,15,0,30,15
1657072716893,MATH 18,A03,083745,Cinel; Cameron Alexander,8,0,30,22
1657072716893,MATH 18,B01,083748,Rideout; David Porter,4,0,37,33
1657072716893,MATH 18,B02,083749,Rideout; David Porter,3,0,36,33
1657072716893,MATH 18,B03,083750,Rideout; David Porter,2,0,37,35
1657072716893,MATH 18,B04,083751,Rideout; David Porter,5,0,36,31
1657072716893,MATH 18,B05,093473,Rideout; David Porter,4,0,36,32
1657072716893,MATH 18,B06,093474,Rideout; David Porter,5,0,36,31
1657072722917,MATH 20A,A01,083754,Zheng; Zequn,12,0,40,28
1657072728939,MATH 20B,A01,083756,Briones; Jor-el Thomas Caparas,1,0,36,35
1657072728939,MATH 20B,A02,083757,Briones; Jor-el Thomas Caparas,1,0,36,35
1657072728939,MATH 20B,A03,093475,Briones; Jor-el Thomas Caparas,0,0,36,36
1657072734962,MATH 20C,A01,083760,Briones; Jor-el Thomas Caparas,1,0,35,34
1657072734962,MATH 20C,A02,083761,Briones; Jor-el Thomas Caparas,8,0,35,27
1657072734962,MATH 20C,A03,093476,Briones; Jor-el Thomas Caparas,0,1,36,36
1657072734962,MATH 20C,B01,083762,Bach; Quang Tran,0,0,30,30
1657072740987,MATH 20D,A01,083765,Tran; Brian Kha,4,0,30,26
1657072740987,MATH 20D,A02,083766,Tran; Brian Kha,5,0,30,25
1657072740987,MATH 20D,A03,083767,Tran; Brian Kha,3,0,30,27
1657072747010,MATH 20E,A01,083771,Ganguly; Soumya,5,0,32,27
1657072747010,MATH 20E,A02,083772,Ganguly; Soumya,6,0,32,26
1657072747010,MATH 20E,B01,083773,Ciotti; Benjamin,18,0,35,17
1657072747010,MATH 20E,B02,083774,Ciotti; Benjamin,17,0,35,18
1657072753034,MATH 103A,A01,083777,Greenfeld; Be'Eri,2,0,36,34
1657072753034,MATH 103A,A02,083778,Greenfeld; Be'Eri,5,0,36,31
1657072753034,MATH 103A,A03,093561,Greenfeld; Be'Eri,4,0,36,32
1657072753034,MATH 103A,B01,083779,Greenfeld; Be'Eri,6,0,36,30
1657072753034,MATH 103A,B02,083780,Greenfeld; Be'Eri,2,0,36,34
1657072753034,MATH 103A,B03,093562,Greenfeld; Be'Eri,3,0,36,33
1657072759060,MATH 105,A01,085443,Carter; Anne Toulson,14,0,35,21
1657072759060,MATH 105,A02,093477,Carter; Anne Toulson,20,0,35,15
1657072765082,MATH 109,A01,083213,Ganzberger; Geoffrey Michael,2,0,34,32
1657072765082,MATH 109,A02,083214,Ganzberger; Geoffrey Michael,2,0,34,32
1657072765082,MATH 109,A03,093478,Ganzberger; Geoffrey Michael,1,0,34,33
1657072765082,MATH 109,B01,083215,Ganzberger; Geoffrey Michael,1,0,32,31
1657072765082,MATH 109,B02,083216,Ganzberger; Geoffrey Michael,1,0,32,31
1657072765082,MATH 109,B03,093479,Ganzberger; Geoffrey Michael,6,0,32,26
1657072771111,MATH 142A,A01,083219,Chow; Bennett,6,0,32,26
1657072771111,MATH 142A,A02,083220,Chow; Bennett,10,0,32,22
1657072771111,MATH 142A,A03,093480,Chow; Bennett,7,0,32,25
1657072771111,MATH 142A,B03,093481,Chow; Bennett,7,0,32,25
1657072771111,MATH 142A,B04,093558,Chow; Bennett,11,0,32,21
1657072771111,MATH 142A,B05,093559,Chow; Bennett,6,0,32,26
1657072777142,MATH 193A,A01,083224,Rotar; Vladimir,7,0,34,27
1657072777142,MATH 193A,A02,083225,Rotar; Vladimir,5,0,34,29
1657072777142,MATH 193A,A03,083781,Rotar; Vladimir,1,0,34,33
1657072777142,MATH 193A,A04,083782,Rotar; Vladimir,6,0,34,28
1657072777142,MATH 193A,A05,093482,Rotar; Vladimir,6,0,34,28
1657072783169,MATH 197,001,091859,McAuley; Julian John,9999,0,9999,0
1657072783169,MATH 197,002,095566,Kedlaya; Kiran S.,9997,0,9999,2
1657072783169,MATH 197,003,095567,Xiao; Ming,9999,0,9999,0
1657072783169,MATH 197,004,095571,Perols; Johan Lars,9998,0,9999,1
1657072790230,COGS 9,A01,083615,Shannon; Kyle Michael,7,0,75,68
1657072796257,COGS 11,A01,083617,Boyle; Mary E. T.,21,0,48,27
1657072802280,COGS 13,A01,083071,Bastos; Amalia Pinkusfeld,9,0,71,62
1657072808302,COGS 14A,A01,092681,Semenuks; Arturs,0,1,100,100
1657072814330,COGS 14B,A01,083073,Cheng; Tzu-Han,5,0,63,58
1657072820352,COGS 17,A01,092677,Semenuks; Arturs,4,0,81,77
1657072826377,COGS 100,A01,083619,Allen; Michael Gordon,15,0,70,55
1657072832403,COGS 101A,A01,083621,Davis; Joshua Daniel,9,0,68,59
1657072838437,COGS 101B,A01,091572,Allen; Michael Gordon,8,0,65,57
1657072844462,COGS 101C,A01,083625,Delgado; Tania,17,0,35,18
1657072850491,COGS 107A,A01,083627,Boyle; Mary E. T.,13,0,60,47
1657072856523,COGS 118A,A01,083075,Gupta; Anjum,15,0,76,61
1657072862578,CSE 3,A50,083646,Miranda; Gregory Joseph,22,0,50,28
1657072868603,CSE 8A,A50,083650,Miranda; Gregory Joseph,17,1,56,39
1657072874626,CSE 11,A01,083080,Cao; Yingjun,4,15,40,36
1657072880650,CSE 12,A01,083652,Krause-Levy; Sophia Louisa,23,1,120,97
1657072886674,CSE 15L,A01,083654,Morris; Justin Loren,8,0,50,42
1657072886674,CSE 15L,A02,083655,Morris; Justin Loren,9,0,50,41
1657072892697,CSE 20,A01,083657,Tran; Khoa Dang,37,0,80,43
1657072898719,CSE 21,A01,095574,Bach; Quang Tran,21,0,48,27
1657072904744,CSE 30,A01,083084,Eldon; John,4,0,80,76
1657072904744,CSE 30,B01,095061,Bhaskar; Nishant,6,0,50,44
1657072910777,CSE 100,A01,083659,Cao; Yingjun,3,4,70,67
1657072916843,CSE 134B,A01,083661,Powell; Thomas Allan,19,0,100,81
1657072922867,CSE 140,A01,083663,Gungor; Onat,14,0,85,71
1657072928891,CSE 140L,A01,083088,Eldon; John,16,0,100,84
1657072934914,CSE 175,A01,083665,Kumar; Rakesh,3,0,25,22
1657072940937,CSE 190,A00,092507,Dubnov; Shlomo,7,0,20,13
1657072946969,ECE 45,A01,083139,Congero; Spencer William,5,0,75,70
1657072952993,ECE 65,A50,083695,Saad; Andrew S,12,0,30,18
1657072952993,ECE 65,A51,095125,Saad; Andrew S,25,0,26,1
1657072959025,ECE 109,A01,091882,Touri; Behrouz,16,0,70,54
1657072965048,ECE 180,A00,083140,Abi Samra; Nicholas Camill,1,0,30,29
1657072965048,ECE 180,B00,083141,Abi Samra; Nicholas Camill,0,0,30,30
1657072971072,MATH 10A,A01,083735,Patchell; Gregory David,1,0,30,29
1657072971072,MATH 10A,A02,083736,Patchell; Gregory David,20,0,30,10
1657072971072,MATH 10A,A03,083737,Patchell; Gregory David,16,0,30,14
1657072977098,MATH 10B,A01,083207,Lim; Seonhee,7,0,34,27
1657072977098,MATH 10B,A02,083208,Lim; Seonhee,9,0,35,26
1657072977098,MATH 10B,A03,093472,Lim; Seonhee,4,0,34,30
1657072977098,MATH 10B,B01,083739,Sinha; Shubham,9,0,30,21
1657072983122,MATH 18,A01,083743,Cinel; Cameron Alexander,6,0,30,24
1657072983122,MATH 18,A02,083744,Cinel; Cameron Alexander,15,0,30,15
1657072983122,MATH 18,A03,083745,Cinel; Cameron Alexander,8,0,30,22
1657072983122,MATH 18,B01,083748,Rideout; David Porter,4,0,37,33
1657072983122,MATH 18,B02,083749,Rideout; David Porter,3,0,36,33
1657072983122,MATH 18,B03,083750,Rideout; David Porter,2,0,37,35
1657072983122,MATH 18,B04,083751,Rideout; David Porter,5,0,36,31
1657072983122,MATH 18,B05,093473,Rideout; David Porter,4,0,36,32
1657072983122,MATH 18,B06,093474,Rideout; David Porter,5,0,36,31
1657072989146,MATH 20A,A01,083754,Zheng; Zequn,12,0,40,28
1657072995169,MATH 20B,A01,083756,Briones; Jor-el Thomas Caparas,1,0,36,35
1657072995169,MATH 20B,A02,083757,Briones; Jor-el Thomas Caparas,1,0,36,35
1657072995169,MATH 20B,A03,093475,Briones; Jor-el Thomas Caparas,0,0,36,36
1657073001198,MATH 20C,A01,083760,Briones; Jor-el Thomas Caparas,1,0,35,34
1657073001198,MATH 20C,A02,083761,Briones; Jor-el Thomas Caparas,8,0,35,27
1657073001198,MATH 20C,A03,093476,Briones; Jor-el Thomas Caparas,0,1,36,36
1657073001198,MATH 20C,B01,083762,Bach; Quang Tran,0,0,30,30
1657073007222,MATH 20D,A01,083765,Tran; Brian Kha,4,0,30,26
1657073007222,MATH 20D,A02,083766,Tran; Brian Kha,5,0,30,25
1657073007222,MATH 20D,A03,083767,Tran; Brian Kha,3,0,30,27
1657073013244,MATH 20E,A01,083771,Ganguly; Soumya,5,0,32,27
1657073013244,MATH 20E,A02,083772,Ganguly; Soumya,6,0,32,26
1657073013244,MATH 20E,B01,083773,Ciotti; Benjamin,18,0,35,17
1657073013244,MATH 20E,B02,083774,Ciotti; Benjamin,17,0,35,18
1657073019275,MATH 103A,A01,083777,Greenfeld; Be'Eri,2,0,36,34
1657073019275,MATH 103A,A02,083778,Greenfeld; Be'Eri,5,0,36,31
1657073019275,MATH 103A,A03,093561,Greenfeld; Be'Eri,4,0,36,32
1657073019275,MATH 103A,B01,083779,Greenfeld; Be'Eri,6,0,36,30
1657073019275,MATH 103A,B02,083780,Greenfeld; Be'Eri,2,0,36,34
1657073019275,MATH 103A,B03,093562,Greenfeld; Be'Eri,3,0,36,33
1657073025302,MATH 105,A01,085443,Carter; Anne Toulson,14,0,35,21
1657073025302,MATH 105,A02,093477,Carter; Anne Toulson,20,0,35,15
1657073031329,MATH 109,A01,083213,Ganzberger; Geoffrey Michael,2,0,34,32
1657073031329,MATH 109,A02,083214,Ganzberger; Geoffrey Michael,2,0,34,32
1657073031329,MATH 109,A03,093478,Ganzberger; Geoffrey Michael,1,0,34,33
1657073031329,MATH 109,B01,083215,Ganzberger; Geoffrey Michael,1,0,32,31
1657073031329,MATH 109,B02,083216,Ganzberger; Geoffrey Michael,1,0,32,31
1657073031329,MATH 109,B03,093479,Ganzberger; Geoffrey Michael,6,0,32,26
1657073037356,MATH 142A,A01,083219,Chow; Bennett,6,0,32,26
1657073037356,MATH 142A,A02,083220,Chow; Bennett,10,0,32,22
1657073037356,MATH 142A,A03,093480,Chow; Bennett,7,0,32,25
1657073037356,MATH 142A,B03,093481,Chow; Bennett,7,0,32,25
1657073037356,MATH 142A,B04,093558,Chow; Bennett,11,0,32,21
1657073037356,MATH 142A,B05,093559,Chow; Bennett,6,0,32,26
1657073043381,MATH 193A,A01,083224,Rotar; Vladimir,7,0,34,27
1657073043381,MATH 193A,A02,083225,Rotar; Vladimir,5,0,34,29
1657073043381,MATH 193A,A03,083781,Rotar; Vladimir,1,0,34,33
1657073043381,MATH 193A,A04,083782,Rotar; Vladimir,6,0,34,28
1657073043381,MATH 193A,A05,093482,Rotar; Vladimir,6,0,34,28
1657073049408,MATH 197,001,091859,McAuley; Julian John,9999,0,9999,0
1657073049408,MATH 197,002,095566,Kedlaya; Kiran S.,9997,0,9999,2
1657073049408,MATH 197,003,095567,Xiao; Ming,9999,0,9999,0
1657073049408,MATH 197,004,095571,Perols; Johan Lars,9998,0,9999,1
1657073056463,COGS 9,A01,083615,Shannon; Kyle Michael,7,0,75,68
1657073062486,COGS 11,A01,083617,Boyle; Mary E. T.,21,0,48,27
1657073068509,COGS 13,A01,083071,Bastos; Amalia Pinkusfeld,9,0,71,62
1657073074532,COGS 14A,A01,092681,Semenuks; Arturs,0,1,100,100
1657073080554,COGS 14B,A01,083073,Cheng; Tzu-Han,5,0,63,58
1657073086577,COGS 17,A01,092677,Semenuks; Arturs,4,0,81,77
1657073092599,COGS 100,A01,083619,Allen; Michael Gordon,15,0,70,55
1657073098625,COGS 101A,A01,083621,Davis; Joshua Daniel,9,0,68,59
1657073104650,COGS 101B,A01,091572,Allen; Michael Gordon,8,0,65,57
1657073110676,COGS 101C,A01,083625,Delgado; Tania,17,0,35,18
1657073116700,COGS 107A,A01,083627,Boyle; Mary E. T.,13,0,60,47
1657073122722,COGS 118A,A01,083075,Gupta; Anjum,15,0,76,61
1657073128749,CSE 3,A50,083646,Miranda; Gregory Joseph,22,0,50,28
1657073134773,CSE 8A,A50,083650,Miranda; Gregory Joseph,17,1,56,39
1657073140797,CSE 11,A01,083080,Cao; Yingjun,4,15,40,36
1657073146860,CSE 12,A01,083652,Krause-Levy; Sophia Louisa,23,1,120,97
1657073152883,CSE 15L,A01,083654,Morris; Justin Loren,8,0,50,42
1657073152883,CSE 15L,A02,083655,Morris; Justin Loren,9,0,50,41
1657073158906,CSE 20,A01,083657,Tran; Khoa Dang,37,0,80,43
1657073164929,CSE 21,A01,095574,Bach; Quang Tran,21,0,48,27
1657073171025,CSE 30,A01,083084,Eldon; John,4,0,80,76
1657073171025,CSE 30,B01,095061,Bhaskar; Nishant,6,0,50,44
1657073177048,CSE 100,A01,083659,Cao; Yingjun,3,4,70,67
1657073183079,CSE 134B,A01,083661,Powell; Thomas Allan,19,0,100,81
1657073189105,CSE 140,A01,083663,Gungor; Onat,14,0,85,71
1657073195134,CSE 140L,A01,083088,Eldon; John,16,0,100,84
1657073201159,CSE 175,A01,083665,Kumar; Rakesh,3,0,25,22
1657073207189,CSE 190,A00,092507,Dubnov; Shlomo,7,0,20,13
1657073213215,ECE 45,A01,083139,Congero; Spencer William,5,0,75,70
1657073219238,ECE 65,A50,083695,Saad; Andrew S,12,0,30,18
1657073219238,ECE 65,A51,095125,Saad; Andrew S,25,0,26,1
1657073225261,ECE 109,A01,091882,Touri; Behrouz,16,0,70,54
1657073231290,ECE 180,A00,083140,Abi Samra; Nicholas Camill,1,0,30,29
1657073231290,ECE 180,B00,083141,Abi Samra; Nicholas Camill,0,0,30,30
1657073237317,MATH 10A,A01,083735,Patchell; Gregory David,1,0,30,29
1657073237317,MATH 10A,A02,083736,Patchell; Gregory David,20,0,30,10
1657073237317,MATH 10A,A03,083737,Patchell; Gregory David,16,0,30,14
1657073243348,MATH 10B,A01,083207,Lim; Seonhee,7,0,34,27
1657073243348,MATH 10B,A02,083208,Lim; Seonhee,9,0,35,26
1657073243348,MATH 10B,A03,093472,Lim; Seonhee,4,0,34,30
1657073243348,MATH 10B,B01,083739,Sinha; Shubham,9,0,30,21
1657073249386,MATH 18,A01,083743,Cinel; Cameron Alexander,6,0,30,24
1657073249386,MATH 18,A02,083744,Cinel; Cameron Alexander,15,0,30,15
1657073249386,MATH 18,A03,083745,Cinel; Cameron Alexander,8,0,30,22
1657073249386,MATH 18,B01,083748,Rideout; David Porter,4,0,37,33
1657073249386,MATH 18,B02,083749,Rideout; David Porter,3,0,36,33
1657073249386,MATH 18,B03,083750,Rideout; David Porter,2,0,37,35
1657073249386,MATH 18,B04,083751,Rideout; David Porter,5,0,36,31
1657073249386,MATH 18,B05,093473,Rideout; David Porter,4,0,36,32
1657073249386,MATH 18,B06,093474,Rideout; David Porter,5,0,36,31
1657073255409,MATH 20A,A01,083754,Zheng; Zequn,12,0,40,28
1657073261441,MATH 20B,A01,083756,Briones; Jor-el Thomas Caparas,1,0,36,35
1657073261441,MATH 20B,A02,083757,Briones; Jor-el Thomas Caparas,1,0,36,35
1657073261441,MATH 20B,A03,093475,Briones; Jor-el Thomas Caparas,0,0,36,36
1657073267465,MATH 20C,A01,083760,Briones; Jor-el Thomas Caparas,1,0,35,34
1657073267465,MATH 20C,A02,083761,Briones; Jor-el Thomas Caparas,8,0,35,27
1657073267465,MATH 20C,A03,093476,Briones; Jor-el Thomas Caparas,0,1,36,36
1657073267465,MATH 20C,B01,083762,Bach; Quang Tran,0,0,30,30
1657073273489,MATH 20D,A01,083765,Tran; Brian Kha,4,0,30,26
1657073273489,MATH 20D,A02,083766,Tran; Brian Kha,5,0,30,25
1657073273489,MATH 20D,A03,083767,Tran; Brian Kha,3,0,30,27
1657073279512,MATH 20E,A01,083771,Ganguly; Soumya,5,0,32,27
1657073279512,MATH 20E,A02,083772,Ganguly; Soumya,6,0,32,26
1657073279512,MATH 20E,B01,083773,Ciotti; Benjamin,18,0,35,17
1657073279512,MATH 20E,B02,083774,Ciotti; Benjamin,17,0,35,18
1657073285543,MATH 103A,A01,083777,Greenfeld; Be'Eri,2,0,36,34
1657073285543,MATH 103A,A02,083778,Greenfeld; Be'Eri,5,0,36,31
1657073285543,MATH 103A,A03,093561,Greenfeld; Be'Eri,4,0,36,32
1657073285543,MATH 103A,B01,083779,Greenfeld; Be'Eri,6,0,36,30
1657073285543,MATH 103A,B02,083780,Greenfeld; Be'Eri,2,0,36,34
1657073285543,MATH 103A,B03,093562,Greenfeld; Be'Eri,3,0,36,33
1657073291576,MATH 105,A01,085443,Carter; Anne Toulson,14,0,35,21
1657073291576,MATH 105,A02,093477,Carter; Anne Toulson,20,0,35,15
1657073297605,MATH 109,A01,083213,Ganzberger; Geoffrey Michael,2,0,34,32
1657073297605,MATH 109,A02,083214,Ganzberger; Geoffrey Michael,2,0,34,32
1657073297605,MATH 109,A03,093478,Ganzberger; Geoffrey Michael,1,0,34,33
1657073297605,MATH 109,B01,083215,Ganzberger; Geoffrey Michael,1,0,32,31
1657073297605,MATH 109,B02,083216,Ganzberger; Geoffrey Michael,1,0,32,31
1657073297605,MATH 109,B03,093479,Ganzberger; Geoffrey Michael,6,0,32,26
1657073303629,MATH 142A,A01,083219,Chow; Bennett,6,0,32,26
1657073303629,MATH 142A,A02,083220,Chow; Bennett,10,0,32,22
1657073303629,MATH 142A,A03,093480,Chow; Bennett,7,0,32,25
1657073303629,MATH 142A,B03,093481,Chow; Bennett,7,0,32,25
1657073303629,MATH 142A,B04,093558,Chow; Bennett,11,0,32,21
1657073303629,MATH 142A,B05,093559,Chow; Bennett,6,0,32,26
1657073309652,MATH 193A,A01,083224,Rotar; Vladimir,7,0,34,27
1657073309652,MATH 193A,A02,083225,Rotar; Vladimir,5,0,34,29
1657073309652,MATH 193A,A03,083781,Rotar; Vladimir,1,0,34,33
1657073309652,MATH 193A,A04,083782,Rotar; Vladimir,6,0,34,28
1657073309652,MATH 193A,A05,093482,Rotar; Vladimir,6,0,34,28
1657073315691,MATH 197,001,091859,McAuley; Julian John,9999,0,9999,0
1657073315691,MATH 197,002,095566,Kedlaya; Kiran S.,9997,0,9999,2
1657073315691,MATH 197,003,095567,Xiao; Ming,9999,0,9999,0
1657073315691,MATH 197,004,095571,Perols; Johan Lars,9998,0,9999,1
1657073322744,COGS 9,A01,083615,Shannon; Kyle Michael,7,0,75,68
1657073328768,COGS 11,A01,083617,Boyle; Mary E. T.,21,0,48,27
1657073334791,COGS 13,A01,083071,Bastos; Amalia Pinkusfeld,9,0,71,62
1657073340814,COGS 14A,A01,092681,Semenuks; Arturs,0,1,100,100
1657073346837,COGS 14B,A01,083073,Cheng; Tzu-Han,5,0,63,58
1657073352870,COGS 17,A01,092677,Semenuks; Arturs,4,0,81,77
1657073358917,COGS 100,A01,083619,Allen; Michael Gordon,15,0,70,55
1657073364942,COGS 101A,A01,083621,Davis; Joshua Daniel,9,0,68,59
1657073370965,COGS 101B,A01,091572,Allen; Michael Gordon,8,0,65,57
1657073376990,COGS 101C,A01,083625,Delgado; Tania,17,0,35,18
1657073383012,COGS 107A,A01,083627,Boyle; Mary E. T.,13,0,60,47
1657073389038,COGS 118A,A01,083075,Gupta; Anjum,15,0,76,61
1657073395078,CSE 3,A50,083646,Miranda; Gregory Joseph,22,0,50,28
1657073401102,CSE 8A,A50,083650,Miranda; Gregory Joseph,17,1,56,39
1657073407128,CSE 11,A01,083080,Cao; Yingjun,4,15,40,36
1657073413158,CSE 12,A01,083652,Krause-Levy; Sophia Louisa,23,1,120,97
1657073419190,CSE 15L,A01,083654,Morris; Justin Loren,8,0,50,42
1657073419190,CSE 15L,A02,083655,Morris; Justin Loren,9,0,50,41
1657073425214,CSE 20,A01,083657,Tran; Khoa Dang,37,0,80,43
1657073431241,CSE 21,A01,095574,Bach; Quang Tran,21,0,48,27
1657073437269,CSE 30,A01,083084,Eldon; John,4,0,80,76
1657073437269,CSE 30,B01,095061,Bhaskar; Nishant,6,0,50,44
1657073443291,CSE 100,A01,083659,Cao; Yingjun,3,4,70,67
1657073449317,CSE 134B,A01,083661,Powell; Thomas Allan,19,0,100,81
1657073455342,CSE 140,A01,083663,Gungor; Onat,14,0,85,71
1657073461371,CSE 140L,A01,083088,Eldon; John,16,0,100,84
1657073467395,CSE 175,A01,083665,Kumar; Rakesh,3,0,25,22
1657073473422,CSE 190,A00,092507,Dubnov; Shlomo,7,0,20,13
1657073479447,ECE 45,A01,083139,Congero; Spencer William,5,0,75,70
1657073485475,ECE 65,A50,083695,Saad; Andrew S,12,0,30,18
1657073485475,ECE 65,A51,095125,Saad; Andrew S,25,0,26,1
1657073491510,ECE 109,A01,091882,Touri; Behrouz,16,0,70,54
1657073497540,ECE 180,A00,083140,Abi Samra; Nicholas Camill,1,0,30,29
1657073497540,ECE 180,B00,083141,Abi Samra; Nicholas Camill,0,0,30,30
1657073503567,MATH 10A,A01,083735,Patchell; Gregory David,1,0,30,29
1657073503567,MATH 10A,A02,083736,Patchell; Gregory David,20,0,30,10
1657073503567,MATH 10A,A03,083737,Patchell; Gregory David,16,0,30,14
1657073509591,MATH 10B,A01,083207,Lim; Seonhee,7,0,34,27
1657073509591,MATH 10B,A02,083208,Lim; Seonhee,9,0,35,26
1657073509591,MATH 10B,A03,093472,Lim; Seonhee,4,0,34,30
1657073509591,MATH 10B,B01,083739,Sinha; Shubham,9,0,30,21
1657073515618,MATH 18,A01,083743,Cinel; Cameron Alexander,6,0,30,24
1657073515618,MATH 18,A02,083744,Cinel; Cameron Alexander,15,0,30,15
1657073515618,MATH 18,A03,083745,Cinel; Cameron Alexander,8,0,30,22
1657073515618,MATH 18,B01,083748,Rideout; David Porter,4,0,37,33
1657073515618,MATH 18,B02,083749,Rideout; David Porter,3,0,36,33
1657073515618,MATH 18,B03,083750,Rideout; David Porter,2,0,37,35
1657073515618,MATH 18,B04,083751,Rideout; David Porter,5,0,36,31
1657073515618,MATH 18,B05,093473,Rideout; David Porter,4,0,36,32
1657073515618,MATH 18,B06,093474,Rideout; David Porter,5,0,36,31
1657073521639,MATH 20A,A01,083754,Zheng; Zequn,12,0,40,28
1657073527662,MATH 20B,A01,083756,Briones; Jor-el Thomas Caparas,1,0,36,35
1657073527662,MATH 20B,A02,083757,Briones; Jor-el Thomas Caparas,1,0,36,35
1657073527662,MATH 20B,A03,093475,Briones; Jor-el Thomas Caparas,0,0,36,36
1657073533690,MATH 20C,A01,083760,Briones; Jor-el Thomas Caparas,1,0,35,34
1657073533690,MATH 20C,A02,083761,Briones; Jor-el Thomas Caparas,8,0,35,27
1657073533690,MATH 20C,A03,093476,Briones; Jor-el Thomas Caparas,0,1,36,36
1657073533690,MATH 20C,B01,083762,Bach; Quang Tran,0,0,30,30
1657073539713,MATH 20D,A01,083765,Tran; Brian Kha,4,0,30,26
1657073539713,MATH 20D,A02,083766,Tran; Brian Kha,5,0,30,25
1657073539713,MATH 20D,A03,083767,Tran; Brian Kha,3,0,30,27
1657073545738,MATH 20E,A01,083771,Ganguly; Soumya,5,0,32,27
1657073545738,MATH 20E,A02,083772,Ganguly; Soumya,6,0,32,26
1657073545738,MATH 20E,B01,083773,Ciotti; Benjamin,18,0,35,17
1657073545738,MATH 20E,B02,083774,Ciotti; Benjamin,17,0,35,18
1657073551760,MATH 103A,A01,083777,Greenfeld; Be'Eri,2,0,36,34
1657073551760,MATH 103A,A02,083778,Greenfeld; Be'Eri,5,0,36,31
1657073551760,MATH 103A,A03,093561,Greenfeld; Be'Eri,4,0,36,32
1657073551760,MATH 103A,B01,083779,Greenfeld; Be'Eri,6,0,36,30
1657073551760,MATH 103A,B02,083780,Greenfeld; Be'Eri,2,0,36,34
1657073551760,MATH 103A,B03,093562,Greenfeld; Be'Eri,3,0,36,33
1657073557785,MATH 105,A01,085443,Carter; Anne Toulson,14,0,35,21
1657073557785,MATH 105,A02,093477,Carter; Anne Toulson,20,0,35,15
1657073563816,MATH 109,A01,083213,Ganzberger; Geoffrey Michael,2,0,34,32
1657073563816,MATH 109,A02,083214,Ganzberger; Geoffrey Michael,2,0,34,32
1657073563816,MATH 109,A03,093478,Ganzberger; Geoffrey Michael,1,0,34,33
1657073563816,MATH 109,B01,083215,Ganzberger; Geoffrey Michael,1,0,32,31
1657073563816,MATH 109,B02,083216,Ganzberger; Geoffrey Michael,1,0,32,31
1657073563816,MATH 109,B03,093479,Ganzberger; Geoffrey Michael,6,0,32,26
1657073569846,MATH 142A,A01,083219,Chow; Bennett,6,0,32,26
1657073569846,MATH 142A,A02,083220,Chow; Bennett,10,0,32,22
1657073569846,MATH 142A,A03,093480,Chow; Bennett,7,0,32,25
1657073569846,MATH 142A,B03,093481,Chow; Bennett,7,0,32,25
1657073569846,MATH 142A,B04,093558,Chow; Bennett,11,0,32,21
1657073569846,MATH 142A,B05,093559,Chow; Bennett,6,0,32,26
1657073575876,MATH 193A,A01,083224,Rotar; Vladimir,7,0,34,27
1657073575876,MATH 193A,A02,083225,Rotar; Vladimir,5,0,34,29
1657073575876,MATH 193A,A03,083781,Rotar; Vladimir,1,0,34,33
1657073575876,MATH 193A,A04,083782,Rotar; Vladimir,6,0,34,28
1657073575876,MATH 193A,A05,093482,Rotar; Vladimir,6,0,34,28
1657073581898,MATH 197,001,091859,McAuley; Julian John,9999,0,9999,0
1657073581898,MATH 197,002,095566,Kedlaya; Kiran S.,9997,0,9999,2
1657073581898,MATH 197,003,095567,Xiao; Ming,9999,0,9999,0
1657073581898,MATH 197,004,095571,Perols; Johan Lars,9998,0,9999,1
1657073588948,COGS 9,A01,083615,Shannon; Kyle Michael,7,0,75,68
1657073594985,COGS 11,A01,083617,Boyle; Mary E. T.,21,0,48,27
1657073601008,COGS 13,A01,083071,Bastos; Amalia Pinkusfeld,9,0,71,62
1657073607031,COGS 14A,A01,092681,Semenuks; Arturs,0,1,100,100
1657073613061,COGS 14B,A01,083073,Cheng; Tzu-Han,5,0,63,58
1657073619087,COGS 17,A01,092677,Semenuks; Arturs,4,0,81,77
1657073625111,COGS 100,A01,083619,Allen; Michael Gordon,15,0,70,55
1657073631136,COGS 101A,A01,083621,Davis; Joshua Daniel,9,0,68,59
1657073637159,COGS 101B,A01,091572,Allen; Michael Gordon,8,0,65,57
1657073643183,COGS 101C,A01,083625,Delgado; Tania,17,0,35,18
1657073649205,COGS 107A,A01,083627,Boyle; Mary E. T.,13,0,60,47
1657073655240,COGS 118A,A01,083075,Gupta; Anjum,15,0,76,61
1657073661267,CSE 3,A50,083646,Miranda; Gregory Joseph,22,0,50,28
1657073667298,CSE 8A,A50,083650,Miranda; Gregory Joseph,17,1,56,39
1657073673330,CSE 11,A01,083080,Cao; Yingjun,4,15,40,36
1657073679356,CSE 12,A01,083652,Krause-Levy; Sophia Louisa,23,1,120,97
1657073685379,CSE 15L,A01,083654,Morris; Justin Loren,8,0,50,42
1657073685379,CSE 15L,A02,083655,Morris; Justin Loren,9,0,50,41
1657073691407,CSE 20,A01,083657,Tran; Khoa Dang,37,0,80,43
1657073697429,CSE 21,A01,095574,Bach; Quang Tran,21,0,48,27
1657073703451,CSE 30,A01,083084,Eldon; John,4,0,80,76
1657073703451,CSE 30,B01,095061,Bhaskar; Nishant,6,0,50,44
1657073709479,CSE 100,A01,083659,Cao; Yingjun,3,4,70,67
1657073715503,CSE 134B,A01,083661,Powell; Thomas Allan,19,0,100,81
1657073721529,CSE 140,A01,083663,Gungor; Onat,14,0,85,71
1657073727556,CSE 140L,A01,083088,Eldon; John,16,0,100,84
1657073733580,CSE 175,A01,083665,Kumar; Rakesh,3,0,25,22
1657073739617,CSE 190,A00,092507,Dubnov; Shlomo,7,0,20,13
1657073745650,ECE 45,A01,083139,Congero; Spencer William,5,0,75,70
1657073751674,ECE 65,A50,083695,Saad; Andrew S,12,0,30,18
1657073751674,ECE 65,A51,095125,Saad; Andrew S,25,0,26,1
1657073757697,ECE 109,A01,091882,Touri; Behrouz,16,0,70,54
1657073763728,ECE 180,A00,083140,Abi Samra; Nicholas Camill,1,0,30,29
1657073763728,ECE 180,B00,083141,Abi Samra; Nicholas Camill,0,0,30,30
1657073769828,MATH 10A,A01,083735,Patchell; Gregory David,1,0,30,29
1657073769828,MATH 10A,A02,083736,Patchell; Gregory David,20,0,30,10
1657073769828,MATH 10A,A03,083737,Patchell; Gregory David,16,0,30,14
1657073775858,MATH 10B,A01,083207,Lim; Seonhee,7,0,34,27
1657073775858,MATH 10B,A02,083208,Lim; Seonhee,9,0,35,26
1657073775858,MATH 10B,A03,093472,Lim; Seonhee,4,0,34,30
1657073775858,MATH 10B,B01,083739,Sinha; Shubham,9,0,30,21
1657073781891,MATH 18,A01,083743,Cinel; Cameron Alexander,6,0,30,24
1657073781891,MATH 18,A02,083744,Cinel; Cameron Alexander,15,0,30,15
1657073781891,MATH 18,A03,083745,Cinel; Cameron Alexander,8,0,30,22
1657073781891,MATH 18,B01,083748,Rideout; David Porter,4,0,37,33
1657073781891,MATH 18,B02,083749,Rideout; David Porter,3,0,36,33
1657073781891,MATH 18,B03,083750,Rideout; David Porter,2,0,37,35
1657073781891,MATH 18,B04,083751,Rideout; David Porter,5,0,36,31
1657073781891,MATH 18,B05,093473,Rideout; David Porter,4,0,36,32
1657073781891,MATH 18,B06,093474,Rideout; David Porter,5,0,36,31
1657073787917,MATH 20A,A01,083754,Zheng; Zequn,12,0,40,28
1657073793944,MATH 20B,A01,083756,Briones; Jor-el Thomas Caparas,1,0,36,35
1657073793944,MATH 20B,A02,083757,Briones; Jor-el Thomas Caparas,1,0,36,35
1657073793944,MATH 20B,A03,093475,Briones; Jor-el Thomas Caparas,0,0,36,36
1657073799981,MATH 20C,A01,083760,Briones; Jor-el Thomas Caparas,1,0,35,34
1657073799981,MATH 20C,A02,083761,Briones; Jor-el Thomas Caparas,8,0,35,27
1657073799981,MATH 20C,A03,093476,Briones; Jor-el Thomas Caparas,0,1,36,36
1657073799981,MATH 20C,B01,083762,Bach; Quang Tran,0,0,30,30
1657073806005,MATH 20D,A01,083765,Tran; Brian Kha,4,0,30,26
1657073806005,MATH 20D,A02,083766,Tran; Brian Kha,5,0,30,25
1657073806005,MATH 20D,A03,083767,Tran; Brian Kha,3,0,30,27
1657073812030,MATH 20E,A01,083771,Ganguly; Soumya,5,0,32,27
1657073812030,MATH 20E,A02,083772,Ganguly; Soumya,6,0,32,26
1657073812030,MATH 20E,B01,083773,Ciotti; Benjamin,18,0,35,17
1657073812030,MATH 20E,B02,083774,Ciotti; Benjamin,17,0,35,18
1657073818062,MATH 103A,A01,083777,Greenfeld; Be'Eri,2,0,36,34
1657073818062,MATH 103A,A02,083778,Greenfeld; Be'Eri,5,0,36,31
1657073818062,MATH 103A,A03,093561,Greenfeld; Be'Eri,4,0,36,32
1657073818062,MATH 103A,B01,083779,Greenfeld; Be'Eri,6,0,36,30
1657073818062,MATH 103A,B02,083780,Greenfeld; Be'Eri,2,0,36,34
1657073818062,MATH 103A,B03,093562,Greenfeld; Be'Eri,3,0,36,33
1657073824085,MATH 105,A01,085443,Carter; Anne Toulson,14,0,35,21
1657073824085,MATH 105,A02,093477,Carter; Anne Toulson,20,0,35,15
1657073830113,MATH 109,A01,083213,Ganzberger; Geoffrey Michael,2,0,34,32
1657073830113,MATH 109,A02,083214,Ganzberger; Geoffrey Michael,2,0,34,32
1657073830113,MATH 109,A03,093478,Ganzberger; Geoffrey Michael,1,0,34,33
1657073830113,MATH 109,B01,083215,Ganzberger; Geoffrey Michael,1,0,32,31
1657073830113,MATH 109,B02,083216,Ganzberger; Geoffrey Michael,1,0,32,31
1657073830113,MATH 109,B03,093479,Ganzberger; Geoffrey Michael,6,0,32,26
1657073836143,MATH 142A,A01,083219,Chow; Bennett,6,0,32,26
1657073836143,MATH 142A,A02,083220,Chow; Bennett,10,0,32,22
1657073836143,MATH 142A,A03,093480,Chow; Bennett,7,0,32,25
1657073836143,MATH 142A,B03,093481,Chow; Bennett,7,0,32,25
1657073836143,MATH 142A,B04,093558,Chow; Bennett,11,0,32,21
1657073836143,MATH 142A,B05,093559,Chow; Bennett,6,0,32,26
1657073842171,MATH 193A,A01,083224,Rotar; Vladimir,7,0,34,27
1657073842171,MATH 193A,A02,083225,Rotar; Vladimir,5,0,34,29
1657073842171,MATH 193A,A03,083781,Rotar; Vladimir,1,0,34,33
1657073842171,MATH 193A,A04,083782,Rotar; Vladimir,6,0,34,28
1657073842171,MATH 193A,A05,093482,Rotar; Vladimir,6,0,34,28
1657073848194,MATH 197,001,091859,McAuley; Julian John,9999,0,9999,0
1657073848194,MATH 197,002,095566,Kedlaya; Kiran S.,9997,0,9999,2
1657073848194,MATH 197,003,095567,Xiao; Ming,9999,0,9999,0
1657073848194,MATH 197,004,095571,Perols; Johan Lars,9998,0,9999,1
1657073855263,COGS 9,A01,083615,Shannon; Kyle Michael,7,0,75,68
1657073861287,COGS 11,A01,083617,Boyle; Mary E. T.,21,0,48,27
1657073867313,COGS 13,A01,083071,Bastos; Amalia Pinkusfeld,9,0,71,62
1657073873341,COGS 14A,A01,092681,Semenuks; Arturs,0,1,100,100
1657073879368,COGS 14B,A01,083073,Cheng; Tzu-Han,5,0,63,58
1657073885395,COGS 17,A01,092677,Semenuks; Arturs,4,0,81,77
1657073891429,COGS 100,A01,083619,Allen; Michael Gordon,15,0,70,55
1657073897454,COGS 101A,A01,083621,Davis; Joshua Daniel,9,0,68,59
1657073903476,COGS 101B,A01,091572,Allen; Michael Gordon,8,0,65,57
1657073909502,COGS 101C,A01,083625,Delgado; Tania,17,0,35,18
1657073915526,COGS 107A,A01,083627,Boyle; Mary E. T.,13,0,60,47
1657073921553,COGS 118A,A01,083075,Gupta; Anjum,15,0,76,61
1657073927579,CSE 3,A50,083646,Miranda; Gregory Joseph,22,0,50,28
1657073933605,CSE 8A,A50,083650,Miranda; Gregory Joseph,17,1,56,39
1657073939632,CSE 11,A01,083080,Cao; Yingjun,4,15,40,36
1657073945656,CSE 12,A01,083652,Krause-Levy; Sophia Louisa,23,1,120,97
1657073951680,CSE 15L,A01,083654,Morris; Justin Loren,8,0,50,42
1657073951680,CSE 15L,A02,083655,Morris; Justin Loren,9,0,50,41
1657073957712,CSE 20,A01,083657,Tran; Khoa Dang,37,0,80,43
1657073963738,CSE 21,A01,095574,Bach; Quang Tran,21,0,48,27
1657073969762,CSE 30,A01,083084,Eldon; John,4,0,80,76
1657073969762,CSE 30,B01,095061,Bhaskar; Nishant,6,0,50,44
1657073975788,CSE 100,A01,083659,Cao; Yingjun,3,4,70,67
1657073981810,CSE 134B,A01,083661,Powell; Thomas Allan,19,0,100,81
1657073987847,CSE 140,A01,083663,Gungor; Onat,14,0,85,71
1657073993870,CSE 140L,A01,083088,Eldon; John,16,0,100,84
1657073999899,CSE 175,A01,083665,Kumar; Rakesh,3,0,25,22
1657074005925,CSE 190,A00,092507,Dubnov; Shlomo,7,0,20,13
1657074011949,ECE 45,A01,083139,Congero; Spencer William,5,0,75,70
1657074017977,ECE 65,A50,083695,Saad; Andrew S,12,0,30,18
1657074017977,ECE 65,A51,095125,Saad; Andrew S,25,0,26,1
1657074024000,ECE 109,A01,091882,Touri; Behrouz,16,0,70,54
1657074030032,ECE 180,A00,083140,Abi Samra; Nicholas Camill,1,0,30,29
1657074030032,ECE 180,B00,083141,Abi Samra; Nicholas Camill,0,0,30,30
1657074036056,MATH 10A,A01,083735,Patchell; Gregory David,1,0,30,29
1657074036056,MATH 10A,A02,083736,Patchell; Gregory David,20,0,30,10
1657074036056,MATH 10A,A03,083737,Patchell; Gregory David,16,0,30,14
1657074042083,MATH 10B,A01,083207,Lim; Seonhee,7,0,34,27
1657074042083,MATH 10B,A02,083208,Lim; Seonhee,9,0,35,26
1657074042083,MATH 10B,A03,093472,Lim; Seonhee,4,0,34,30
1657074042083,MATH 10B,B01,083739,Sinha; Shubham,9,0,30,21
1657074048116,MATH 18,A01,083743,Cinel; Cameron Alexander,6,0,30,24
1657074048116,MATH 18,A02,083744,Cinel; Cameron Alexander,15,0,30,15
1657074048116,MATH 18,A03,083745,Cinel; Cameron Alexander,8,0,30,22
1657074048116,MATH 18,B01,083748,Rideout; David Porter,4,0,37,33
1657074048116,MATH 18,B02,083749,Rideout; David Porter,3,0,36,33
1657074048116,MATH 18,B03,083750,Rideout; David Porter,2,0,37,35
1657074048116,MATH 18,B04,083751,Rideout; David Porter,5,0,36,31
1657074048116,MATH 18,B05,093473,Rideout; David Porter,4,0,36,32
1657074048116,MATH 18,B06,093474,Rideout; David Porter,5,0,36,31
1657074054140,MATH 20A,A01,083754,Zheng; Zequn,12,0,40,28
1657074060162,MATH 20B,A01,083756,Briones; Jor-el Thomas Caparas,1,0,36,35
1657074060162,MATH 20B,A02,083757,Briones; Jor-el Thomas Caparas,1,0,36,35
1657074060162,MATH 20B,A03,093475,Briones; Jor-el Thomas Caparas,0,0,36,36
1657074066190,MATH 20C,A01,083760,Briones; Jor-el Thomas Caparas,1,0,35,34
1657074066190,MATH 20C,A02,083761,Briones; Jor-el Thomas Caparas,8,0,35,27
1657074066190,MATH 20C,A03,093476,Briones; Jor-el Thomas Caparas,0,1,36,36
1657074066190,MATH 20C,B01,083762,Bach; Quang Tran,0,0,30,30
1657074072225,MATH 20D,A01,083765,Tran; Brian Kha,4,0,30,26
1657074072225,MATH 20D,A02,083766,Tran; Brian Kha,5,0,30,25
1657074072225,MATH 20D,A03,083767,Tran; Brian Kha,3,0,30,27
1657074078248,MATH 20E,A01,083771,Ganguly; Soumya,5,0,32,27
1657074078248,MATH 20E,A02,083772,Ganguly; Soumya,6,0,32,26
1657074078248,MATH 20E,B01,083773,Ciotti; Benjamin,18,0,35,17
1657074078248,MATH 20E,B02,083774,Ciotti; Benjamin,17,0,35,18
1657074084272,MATH 103A,A01,083777,Greenfeld; Be'Eri,2,0,36,34
1657074084272,MATH 103A,A02,083778,Greenfeld; Be'Eri,5,0,36,31
1657074084272,MATH 103A,A03,093561,Greenfeld; Be'Eri,4,0,36,32
1657074084272,MATH 103A,B01,083779,Greenfeld; Be'Eri,6,0,36,30
1657074084272,MATH 103A,B02,083780,Greenfeld; Be'Eri,2,0,36,34
1657074084272,MATH 103A,B03,093562,Greenfeld; Be'Eri,3,0,36,33
1657074090297,MATH 105,A01,085443,Carter; Anne Toulson,14,0,35,21
1657074090297,MATH 105,A02,093477,Carter; Anne Toulson,20,0,35,15
1657074096326,MATH 109,A01,083213,Ganzberger; Geoffrey Michael,2,0,34,32
1657074096326,MATH 109,A02,083214,Ganzberger; Geoffrey Michael,2,0,34,32
1657074096326,MATH 109,A03,093478,Ganzberger; Geoffrey Michael,1,0,34,33
1657074096326,MATH 109,B01,083215,Ganzberger; Geoffrey Michael,1,0,32,31
1657074096326,MATH 109,B02,083216,Ganzberger; Geoffrey Michael,1,0,32,31
1657074096326,MATH 109,B03,093479,Ganzberger; Geoffrey Michael,6,0,32,26
1657074102356,MATH 142A,A01,083219,Chow; Bennett,6,0,32,26
1657074102356,MATH 142A,A02,083220,Chow; Bennett,10,0,32,22
1657074102356,MATH 142A,A03,093480,Chow; Bennett,7,0,32,25
1657074102356,MATH 142A,B03,093481,Chow; Bennett,7,0,32,25
1657074102356,MATH 142A,B04,093558,Chow; Bennett,11,0,32,21
1657074102356,MATH 142A,B05,093559,Chow; Bennett,6,0,32,26
1657074108382,MATH 193A,A01,083224,Rotar; Vladimir,7,0,34,27
1657074108382,MATH 193A,A02,083225,Rotar; Vladimir,5,0,34,29
1657074108382,MATH 193A,A03,083781,Rotar; Vladimir,1,0,34,33
1657074108382,MATH 193A,A04,083782,Rotar; Vladimir,6,0,34,28
1657074108382,MATH 193A,A05,093482,Rotar; Vladimir,6,0,34,28
1657074114410,MATH 197,001,091859,McAuley; Julian John,9999,0,9999,0
1657074114410,MATH 197,002,095566,Kedlaya; Kiran S.,9997,0,9999,2
1657074114410,MATH 197,003,095567,Xiao; Ming,9999,0,9999,0
1657074114410,MATH 197,004,095571,Perols; Johan Lars,9998,0,9999,1
1657074121471,COGS 9,A01,083615,Shannon; Kyle Michael,7,0,75,68
1657074127503,COGS 11,A01,083617,Boyle; Mary E. T.,21,0,48,27
1657074133527,COGS 13,A01,083071,Bastos; Amalia Pinkusfeld,9,0,71,62
1657074139552,COGS 14A,A01,092681,Semenuks; Arturs,0,1,100,100
1657074145577,COGS 14B,A01,083073,Cheng; Tzu-Han,5,0,63,58
1657074151604,COGS 17,A01,092677,Semenuks; Arturs,4,0,81,77
1657074157626,COGS 100,A01,083619,Allen; Michael Gordon,15,0,70,55
1657074163650,COGS 101A,A01,083621,Davis; Joshua Daniel,9,0,68,59
1657074169678,COGS 101B,A01,091572,Allen; Michael Gordon,8,0,65,57
1657074175700,COGS 101C,A01,083625,Delgado; Tania,17,0,35,18
1657074181730,COGS 107A,A01,083627,Boyle; Mary E. T.,13,0,60,47
1657074187758,COGS 118A,A01,083075,Gupta; Anjum,15,0,76,61
1657074193779,CSE 3,A50,083646,Miranda; Gregory Joseph,22,0,50,28
1657074199801,CSE 8A,A50,083650,Miranda; Gregory Joseph,17,1,56,39
1657074205824,CSE 11,A01,083080,Cao; Yingjun,4,15,40,36
1657074211848,CSE 12,A01,083652,Krause-Levy; Sophia Louisa,23,1,120,97
1657074217879,CSE 15L,A01,083654,Morris; Justin Loren,8,0,50,42
1657074217879,CSE 15L,A02,083655,Morris; Justin Loren,9,0,50,41
1657074223905,CSE 20,A01,083657,Tran; Khoa Dang,37,0,80,43
1657074229933,CSE 21,A01,095574,Bach; Quang Tran,21,0,48,27
1657074235963,CSE 30,A01,083084,Eldon; John,4,0,80,76
1657074235963,CSE 30,B01,095061,Bhaskar; Nishant,6,0,50,44
1657074241985,CSE 100,A01,083659,Cao; Yingjun,3,4,70,67
1657074248007,CSE 134B,A01,083661,Powell; Thomas Allan,19,0,100,81
1657074254033,CSE 140,A01,083663,Gungor; Onat,14,0,85,71
1657074260061,CSE 140L,A01,083088,Eldon; John,16,0,100,84
1657074266091,CSE 175,A01,083665,Kumar; Rakesh,3,0,25,22
1657074272117,CSE 190,A00,092507,Dubnov; Shlomo,7,0,20,13
1657074278144,ECE 45,A01,083139,Congero; Spencer William,5,0,75,70
1657074284170,ECE 65,A50,083695,Saad; Andrew S,12,0,30,18
1657074284170,ECE 65,A51,095125,Saad; Andrew S,25,0,26,1
1657074290193,ECE 109,A01,091882,Touri; Behrouz,16,0,70,54
1657074296214,ECE 180,A00,083140,Abi Samra; Nicholas Camill,1,0,30,29
1657074296214,ECE 180,B00,083141,Abi Samra; Nicholas Camill,0,0,30,30
1657074302237,MATH 10A,A01,083735,Patchell; Gregory David,1,0,30,29
1657074302237,MATH 10A,A02,083736,Patchell; Gregory David,20,0,30,10
1657074302237,MATH 10A,A03,083737,Patchell; Gregory David,16,0,30,14
1657074308265,MATH 10B,A01,083207,Lim; Seonhee,7,0,34,27
1657074308265,MATH 10B,A02,083208,Lim; Seonhee,9,0,35,26
1657074308265,MATH 10B,A03,093472,Lim; Seonhee,4,0,34,30
1657074308265,MATH 10B,B01,083739,Sinha; Shubham,9,0,30,21
1657074314291,MATH 18,A01,083743,Cinel; Cameron Alexander,6,0,30,24
1657074314291,MATH 18,A02,083744,Cinel; Cameron Alexander,15,0,30,15
1657074314291,MATH 18,A03,083745,Cinel; Cameron Alexander,8,0,30,22
1657074314291,MATH 18,B01,083748,Rideout; David Porter,4,0,37,33
1657074314291,MATH 18,B02,083749,Rideout; David Porter,3,0,36,33
1657074314291,MATH 18,B03,083750,Rideout; David Porter,2,0,37,35
1657074314291,MATH 18,B04,083751,Rideout; David Porter,5,0,36,31
1657074314291,MATH 18,B05,093473,Rideout; David Porter,4,0,36,32
1657074314291,MATH 18,B06,093474,Rideout; David Porter,5,0,36,31
1657074320314,MATH 20A,A01,083754,Zheng; Zequn,12,0,40,28
1657074326340,MATH 20B,A01,083756,Briones; Jor-el Thomas Caparas,1,0,36,35
1657074326340,MATH 20B,A02,083757,Briones; Jor-el Thomas Caparas,1,0,36,35
1657074326340,MATH 20B,A03,093475,Briones; Jor-el Thomas Caparas,0,0,36,36
1657074332364,MATH 20C,A01,083760,Briones; Jor-el Thomas Caparas,1,0,35,34
1657074332364,MATH 20C,A02,083761,Briones; Jor-el Thomas Caparas,8,0,35,27
1657074332364,MATH 20C,A03,093476,Briones; Jor-el Thomas Caparas,0,1,36,36
1657074332364,MATH 20C,B01,083762,Bach; Quang Tran,0,0,30,30
1657074338405,MATH 20D,A01,083765,Tran; Brian Kha,4,0,30,26
1657074338405,MATH 20D,A02,083766,Tran; Brian Kha,5,0,30,25
1657074338405,MATH 20D,A03,083767,Tran; Brian Kha,3,0,30,27
1657074344429,MATH 20E,A01,083771,Ganguly; Soumya,5,0,32,27
1657074344429,MATH 20E,A02,083772,Ganguly; Soumya,6,0,32,26
1657074344429,MATH 20E,B01,083773,Ciotti; Benjamin,18,0,35,17
1657074344429,MATH 20E,B02,083774,Ciotti; Benjamin,17,0,35,18
1657074350454,MATH 103A,A01,083777,Greenfeld; Be'Eri,2,0,36,34
1657074350454,MATH 103A,A02,083778,Greenfeld; Be'Eri,5,0,36,31
1657074350454,MATH 103A,A03,093561,Greenfeld; Be'Eri,4,0,36,32
1657074350454,MATH 103A,B01,083779,Greenfeld; Be'Eri,6,0,36,30
1657074350454,MATH 103A,B02,083780,Greenfeld; Be'Eri,2,0,36,34
1657074350454,MATH 103A,B03,093562,Greenfeld; Be'Eri,3,0,36,33
1657074356477,MATH 105,A01,085443,Carter; Anne Toulson,14,0,35,21
1657074356477,MATH 105,A02,093477,Carter; Anne Toulson,20,0,35,15
1657074362502,MATH 109,A01,083213,Ganzberger; Geoffrey Michael,2,0,34,32
1657074362502,MATH 109,A02,083214,Ganzberger; Geoffrey Michael,2,0,34,32
1657074362502,MATH 109,A03,093478,Ganzberger; Geoffrey Michael,1,0,34,33
1657074362502,MATH 109,B01,083215,Ganzberger; Geoffrey Michael,1,0,32,31
1657074362502,MATH 109,B02,083216,Ganzberger; Geoffrey Michael,1,0,32,31
1657074362502,MATH 109,B03,093479,Ganzberger; Geoffrey Michael,6,0,32,26
1657074368618,MATH 142A,A01,083219,Chow; Bennett,6,0,32,26
1657074368618,MATH 142A,A02,083220,Chow; Bennett,10,0,32,22
1657074368618,MATH 142A,A03,093480,Chow; Bennett,7,0,32,25
1657074368618,MATH 142A,B03,093481,Chow; Bennett,7,0,32,25
1657074368618,MATH 142A,B04,093558,Chow; Bennett,11,0,32,21
1657074368618,MATH 142A,B05,093559,Chow; Bennett,6,0,32,26
1657074374648,MATH 193A,A01,083224,Rotar; Vladimir,7,0,34,27
1657074374648,MATH 193A,A02,083225,Rotar; Vladimir,5,0,34,29
1657074374648,MATH 193A,A03,083781,Rotar; Vladimir,1,0,34,33
1657074374648,MATH 193A,A04,083782,Rotar; Vladimir,6,0,34,28
1657074374648,MATH 193A,A05,093482,Rotar; Vladimir,6,0,34,28
1657074380672,MATH 197,001,091859,McAuley; Julian John,9999,0,9999,0
1657074380672,MATH 197,002,095566,Kedlaya; Kiran S.,9997,0,9999,2
1657074380672,MATH 197,003,095567,Xiao; Ming,9999,0,9999,0
1657074380672,MATH 197,004,095571,Perols; Johan Lars,9998,0,9999,1
1657074387723,COGS 9,A01,083615,Shannon; Kyle Michael,7,0,75,68
1657074393754,COGS 11,A01,083617,Boyle; Mary E. T.,21,0,48,27
1657074399780,COGS 13,A01,083071,Bastos; Amalia Pinkusfeld,9,0,71,62
1657074405808,COGS 14A,A01,092681,Semenuks; Arturs,0,1,100,100
1657074421661,COGS 14B,A01,083073,Cheng; Tzu-Han,5,0,63,58
1657074427682,COGS 17,A01,092677,Semenuks; Arturs,4,0,81,77
1657074433708,COGS 100,A01,083619,Allen; Michael Gordon,15,0,70,55
1657074439730,COGS 101A,A01,083621,Davis; Joshua Daniel,9,0,68,59
1657074445757,COGS 101B,A01,091572,Allen; Michael Gordon,8,0,65,57
1657074451779,COGS 101C,A01,083625,Delgado; Tania,17,0,35,18
1657074457801,COGS 107A,A01,083627,Boyle; Mary E. T.,13,0,60,47
1657074463827,COGS 118A,A01,083075,Gupta; Anjum,15,0,76,61
1657074469851,CSE 3,A50,083646,Miranda; Gregory Joseph,22,0,50,28
1657074475879,CSE 8A,A50,083650,Miranda; Gregory Joseph,17,1,56,39
1657074481906,CSE 11,A01,083080,Cao; Yingjun,4,15,40,36
1657074487930,CSE 12,A01,083652,Krause-Levy; Sophia Louisa,23,1,120,97
1657074493953,CSE 15L,A01,083654,Morris; Justin Loren,8,0,50,42
1657074493953,CSE 15L,A02,083655,Morris; Justin Loren,9,0,50,41
1657074499988,CSE 20,A01,083657,Tran; Khoa Dang,37,0,80,43
1657074506011,CSE 21,A01,095574,Bach; Quang Tran,21,0,48,27
1657074512039,CSE 30,A01,083084,Eldon; John,4,0,80,76
1657074512039,CSE 30,B01,095061,Bhaskar; Nishant,6,0,50,44
1657074518066,CSE 100,A01,083659,Cao; Yingjun,3,4,70,67
1657074524091,CSE 134B,A01,083661,Powell; Thomas Allan,19,0,100,81
1657074530113,CSE 140,A01,083663,Gungor; Onat,14,0,85,71
1657074536136,CSE 140L,A01,083088,Eldon; John,16,0,100,84
1657074542170,CSE 175,A01,083665,Kumar; Rakesh,3,0,25,22
1657074548193,CSE 190,A00,092507,Dubnov; Shlomo,7,0,20,13
1657074554217,ECE 45,A01,083139,Congero; Spencer William,5,0,75,70
1657074560244,ECE 65,A50,083695,Saad; Andrew S,12,0,30,18
1657074560244,ECE 65,A51,095125,Saad; Andrew S,25,0,26,1
1657074566266,ECE 109,A01,091882,Touri; Behrouz,16,0,70,54
1657074572289,ECE 180,A00,083140,Abi Samra; Nicholas Camill,1,0,30,29
1657074572289,ECE 180,B00,083141,Abi Samra; Nicholas Camill,0,0,30,30
1657074578311,MATH 10A,A01,083735,Patchell; Gregory David,1,0,30,29
1657074578311,MATH 10A,A02,083736,Patchell; Gregory David,20,0,30,10
1657074578311,MATH 10A,A03,083737,Patchell; Gregory David,16,0,30,14
1657074584336,MATH 10B,A01,083207,Lim; Seonhee,7,0,34,27
1657074584336,MATH 10B,A02,083208,Lim; Seonhee,9,0,35,26
1657074584336,MATH 10B,A03,093472,Lim; Seonhee,4,0,34,30
1657074584336,MATH 10B,B01,083739,Sinha; Shubham,9,0,30,21
1657074590368,MATH 18,A01,083743,Cinel; Cameron Alexander,6,0,30,24
1657074590368,MATH 18,A02,083744,Cinel; Cameron Alexander,15,0,30,15
1657074590368,MATH 18,A03,083745,Cinel; Cameron Alexander,8,0,30,22
1657074590368,MATH 18,B01,083748,Rideout; David Porter,4,0,37,33
1657074590368,MATH 18,B02,083749,Rideout; David Porter,3,0,36,33
1657074590368,MATH 18,B03,083750,Rideout; David Porter,2,0,37,35
1657074590368,MATH 18,B04,083751,Rideout; David Porter,5,0,36,31
1657074590368,MATH 18,B05,093473,Rideout; David Porter,4,0,36,32
1657074590368,MATH 18,B06,093474,Rideout; David Porter,5,0,36,31
1657074596391,MATH 20A,A01,083754,Zheng; Zequn,12,0,40,28
1657074602417,MATH 20B,A01,083756,Briones; Jor-el Thomas Caparas,1,0,36,35
1657074602417,MATH 20B,A02,083757,Briones; Jor-el Thomas Caparas,1,0,36,35
1657074602417,MATH 20B,A03,093475,Briones; Jor-el Thomas Caparas,0,0,36,36
1657074608445,MATH 20C,A01,083760,Briones; Jor-el Thomas Caparas,1,0,35,34
1657074608445,MATH 20C,A02,083761,Briones; Jor-el Thomas Caparas,8,0,35,27
1657074608445,MATH 20C,A03,093476,Briones; Jor-el Thomas Caparas,0,1,36,36
1657074608445,MATH 20C,B01,083762,Bach; Quang Tran,0,0,30,30
1657074614468,MATH 20D,A01,083765,Tran; Brian Kha,4,0,30,26
1657074614468,MATH 20D,A02,083766,Tran; Brian Kha,5,0,30,25
1657074614468,MATH 20D,A03,083767,Tran; Brian Kha,3,0,30,27
1657074620492,MATH 20E,A01,083771,Ganguly; Soumya,5,0,32,27
1657074620492,MATH 20E,A02,083772,Ganguly; Soumya,6,0,32,26
1657074620492,MATH 20E,B01,083773,Ciotti; Benjamin,18,0,35,17
1657074620492,MATH 20E,B02,083774,Ciotti; Benjamin,17,0,35,18
1657074626519,MATH 103A,A01,083777,Greenfeld; Be'Eri,2,0,36,34
1657074626519,MATH 103A,A02,083778,Greenfeld; Be'Eri,5,0,36,31
1657074626519,MATH 103A,A03,093561,Greenfeld; Be'Eri,4,0,36,32
1657074626519,MATH 103A,B01,083779,Greenfeld; Be'Eri,6,0,36,30
1657074626519,MATH 103A,B02,083780,Greenfeld; Be'Eri,2,0,36,34
1657074626519,MATH 103A,B03,093562,Greenfeld; Be'Eri,3,0,36,33
1657074632543,MATH 105,A01,085443,Carter; Anne Toulson,14,0,35,21
1657074632543,MATH 105,A02,093477,Carter; Anne Toulson,20,0,35,15
1657074638569,MATH 109,A01,083213,Ganzberger; Geoffrey Michael,2,0,34,32
1657074638569,MATH 109,A02,083214,Ganzberger; Geoffrey Michael,2,0,34,32
1657074638569,MATH 109,A03,093478,Ganzberger; Geoffrey Michael,1,0,34,33
1657074638569,MATH 109,B01,083215,Ganzberger; Geoffrey Michael,1,0,32,31
1657074638569,MATH 109,B02,083216,Ganzberger; Geoffrey Michael,1,0,32,31
1657074638569,MATH 109,B03,093479,Ganzberger; Geoffrey Michael,6,0,32,26
1657074644599,MATH 142A,A01,083219,Chow; Bennett,6,0,32,26
1657074644599,MATH 142A,A02,083220,Chow; Bennett,10,0,32,22
1657074644599,MATH 142A,A03,093480,Chow; Bennett,7,0,32,25
1657074644599,MATH 142A,B03,093481,Chow; Bennett,7,0,32,25
1657074644599,MATH 142A,B04,093558,Chow; Bennett,11,0,32,21
1657074644599,MATH 142A,B05,093559,Chow; Bennett,6,0,32,26
1657074650628,MATH 193A,A01,083224,Rotar; Vladimir,7,0,34,27
1657074650628,MATH 193A,A02,083225,Rotar; Vladimir,5,0,34,29
1657074650628,MATH 193A,A03,083781,Rotar; Vladimir,1,0,34,33
1657074650628,MATH 193A,A04,083782,Rotar; Vladimir,6,0,34,28
1657074650628,MATH 193A,A05,093482,Rotar; Vladimir,6,0,34,28
1657074656665,MATH 197,001,091859,McAuley; Julian John,9999,0,9999,0
1657074656665,MATH 197,002,095566,Kedlaya; Kiran S.,9997,0,9999,2
1657074656665,MATH 197,003,095567,Xiao; Ming,9999,0,9999,0
1657074656665,MATH 197,004,095571,Perols; Johan Lars,9998,0,9999,1
1657074663721,COGS 9,A01,083615,Shannon; Kyle Michael,7,0,75,68
1657074669748,COGS 11,A01,083617,Boyle; Mary E. T.,21,0,48,27
1657074675770,COGS 13,A01,083071,Bastos; Amalia Pinkusfeld,9,0,71,62
1657074681792,COGS 14A,A01,092681,Semenuks; Arturs,0,1,100,100
1657074687832,COGS 14B,A01,083073,Cheng; Tzu-Han,5,0,63,58
1657074693855,COGS 17,A01,092677,Semenuks; Arturs,4,0,81,77
1657074699877,COGS 100,A01,083619,Allen; Michael Gordon,15,0,70,55
1657074705901,COGS 101A,A01,083621,Davis; Joshua Daniel,9,0,68,59
1657074711925,COGS 101B,A01,091572,Allen; Michael Gordon,8,0,65,57
1657074717951,COGS 101C,A01,083625,Delgado; Tania,17,0,35,18
1657074723974,COGS 107A,A01,083627,Boyle; Mary E. T.,13,0,60,47
1657074730002,COGS 118A,A01,083075,Gupta; Anjum,15,0,76,61
1657074736028,CSE 3,A50,083646,Miranda; Gregory Joseph,22,0,50,28
1657074742052,CSE 8A,A50,083650,Miranda; Gregory Joseph,17,1,56,39
1657074748077,CSE 11,A01,083080,Cao; Yingjun,4,15,40,36
1657074754101,CSE 12,A01,083652,Krause-Levy; Sophia Louisa,23,1,120,97
1657074760123,CSE 15L,A01,083654,Morris; Justin Loren,8,0,50,42
1657074760123,CSE 15L,A02,083655,Morris; Justin Loren,9,0,50,41
1657074766150,CSE 20,A01,083657,Tran; Khoa Dang,37,0,80,43
1657074772172,CSE 21,A01,095574,Bach; Quang Tran,21,0,48,27
1657074778195,CSE 30,A01,083084,Eldon; John,4,0,80,76
1657074778195,CSE 30,B01,095061,Bhaskar; Nishant,6,0,50,44
1657074784218,CSE 100,A01,083659,Cao; Yingjun,3,4,70,67
1657074790241,CSE 134B,A01,083661,Powell; Thomas Allan,19,0,100,81
1657074796265,CSE 140,A01,083663,Gungor; Onat,14,0,85,71
1657074802289,CSE 140L,A01,083088,Eldon; John,16,0,100,84
1657074808310,CSE 175,A01,083665,Kumar; Rakesh,3,0,25,22
1657074814336,CSE 190,A00,092507,Dubnov; Shlomo,7,0,20,13
1657074820365,ECE 45,A01,083139,Congero; Spencer William,5,0,75,70
1657074826388,ECE 65,A50,083695,Saad; Andrew S,12,0,30,18
1657074826388,ECE 65,A51,095125,Saad; Andrew S,25,0,26,1
1657074832409,ECE 109,A01,091882,Touri; Behrouz,16,0,70,54
1657074838434,ECE 180,A00,083140,Abi Samra; Nicholas Camill,1,0,30,29
1657074838434,ECE 180,B00,083141,Abi Samra; Nicholas Camill,0,0,30,30
1657074844462,MATH 10A,A01,083735,Patchell; Gregory David,1,0,30,29
1657074844462,MATH 10A,A02,083736,Patchell; Gregory David,20,0,30,10
1657074844462,MATH 10A,A03,083737,Patchell; Gregory David,16,0,30,14
1657074850493,MATH 10B,A01,083207,Lim; Seonhee,7,0,34,27
1657074850493,MATH 10B,A02,083208,Lim; Seonhee,9,0,35,26
1657074850493,MATH 10B,A03,093472,Lim; Seonhee,4,0,34,30
1657074850493,MATH 10B,B01,083739,Sinha; Shubham,9,0,30,21
1657074856523,MATH 18,A01,083743,Cinel; Cameron Alexander,6,0,30,24
1657074856523,MATH 18,A02,083744,Cinel; Cameron Alexander,15,0,30,15
1657074856523,MATH 18,A03,083745,Cinel; Cameron Alexander,8,0,30,22
1657074856523,MATH 18,B01,083748,Rideout; David Porter,4,0,37,33
1657074856523,MATH 18,B02,083749,Rideout; David Porter,3,0,36,33
1657074856523,MATH 18,B03,083750,Rideout; David Porter,2,0,37,35
1657074856523,MATH 18,B04,083751,Rideout; David Porter,5,0,36,31
1657074856523,MATH 18,B05,093473,Rideout; David Porter,4,0,36,32
1657074856523,MATH 18,B06,093474,Rideout; David Porter,5,0,36,31
1657074862546,MATH 20A,A01,083754,Zheng; Zequn,12,0,40,28
1657074868572,MATH 20B,A01,083756,Briones; Jor-el Thomas Caparas,1,0,36,35
1657074868572,MATH 20B,A02,083757,Briones; Jor-el Thomas Caparas,1,0,36,35
1657074868572,MATH 20B,A03,093475,Briones; Jor-el Thomas Caparas,0,0,36,36
1657074874595,MATH 20C,A01,083760,Briones; Jor-el Thomas Caparas,1,0,35,34
1657074874595,MATH 20C,A02,083761,Briones; Jor-el Thomas Caparas,8,0,35,27
1657074874595,MATH 20C,A03,093476,Briones; Jor-el Thomas Caparas,0,1,36,36
1657074874595,MATH 20C,B01,083762,Bach; Quang Tran,0,0,30,30
1657074880619,MATH 20D,A01,083765,Tran; Brian Kha,4,0,30,26
1657074880619,MATH 20D,A02,083766,Tran; Brian Kha,5,0,30,25
1657074880619,MATH 20D,A03,083767,Tran; Brian Kha,3,0,30,27
1657074886642,MATH 20E,A01,083771,Ganguly; Soumya,5,0,32,27
1657074886642,MATH 20E,A02,083772,Ganguly; Soumya,6,0,32,26
1657074886642,MATH 20E,B01,083773,Ciotti; Benjamin,18,0,35,17
1657074886642,MATH 20E,B02,083774,Ciotti; Benjamin,17,0,35,18
1657074892667,MATH 103A,A01,083777,Greenfeld; Be'Eri,2,0,36,34
1657074892667,MATH 103A,A02,083778,Greenfeld; Be'Eri,5,0,36,31
1657074892667,MATH 103A,A03,093561,Greenfeld; Be'Eri,4,0,36,32
1657074892667,MATH 103A,B01,083779,Greenfeld; Be'Eri,6,0,36,30
1657074892667,MATH 103A,B02,083780,Greenfeld; Be'Eri,2,0,36,34
1657074892667,MATH 103A,B03,093562,Greenfeld; Be'Eri,3,0,36,33
1657074898689,MATH 105,A01,085443,Carter; Anne Toulson,14,0,35,21
1657074898689,MATH 105,A02,093477,Carter; Anne Toulson,20,0,35,15
1657074904712,MATH 109,A01,083213,Ganzberger; Geoffrey Michael,2,0,34,32
1657074904712,MATH 109,A02,083214,Ganzberger; Geoffrey Michael,2,0,34,32
1657074904712,MATH 109,A03,093478,Ganzberger; Geoffrey Michael,1,0,34,33
1657074904712,MATH 109,B01,083215,Ganzberger; Geoffrey Michael,1,0,32,31
1657074904712,MATH 109,B02,083216,Ganzberger; Geoffrey Michael,1,0,32,31
1657074904712,MATH 109,B03,093479,Ganzberger; Geoffrey Michael,6,0,32,26
1657074910740,MATH 142A,A01,083219,Chow; Bennett,6,0,32,26
1657074910740,MATH 142A,A02,083220,Chow; Bennett,10,0,32,22
1657074910740,MATH 142A,A03,093480,Chow; Bennett,7,0,32,25
1657074910740,MATH 142A,B03,093481,Chow; Bennett,7,0,32,25
1657074910740,MATH 142A,B04,093558,Chow; Bennett,11,0,32,21
1657074910740,MATH 142A,B05,093559,Chow; Bennett,6,0,32,26
1657074916764,MATH 193A,A01,083224,Rotar; Vladimir,7,0,34,27
1657074916764,MATH 193A,A02,083225,Rotar; Vladimir,5,0,34,29
1657074916764,MATH 193A,A03,083781,Rotar; Vladimir,1,0,34,33
1657074916764,MATH 193A,A04,083782,Rotar; Vladimir,6,0,34,28
1657074916764,MATH 193A,A05,093482,Rotar; Vladimir,6,0,34,28
1657074922790,MATH 197,001,091859,McAuley; Julian John,9999,0,9999,0
1657074922790,MATH 197,002,095566,Kedlaya; Kiran S.,9997,0,9999,2
1657074922790,MATH 197,003,095567,Xiao; Ming,9999,0,9999,0
1657074922790,MATH 197,004,095571,Perols; Johan Lars,9998,0,9999,1
1657074929848,COGS 9,A01,083615,Shannon; Kyle Michael,7,0,75,68
1657074935871,COGS 11,A01,083617,Boyle; Mary E. T.,21,0,48,27
1657074941895,COGS 13,A01,083071,Bastos; Amalia Pinkusfeld,9,0,71,62
1657074947919,COGS 14A,A01,092681,Semenuks; Arturs,0,1,100,100
1657074953943,COGS 14B,A01,083073,Cheng; Tzu-Han,5,0,63,58
1657074959966,COGS 17,A01,092677,Semenuks; Arturs,4,0,81,77
1657074965990,COGS 100,A01,083619,Allen; Michael Gordon,15,0,70,55
1657074972101,COGS 101A,A01,083621,Davis; Joshua Daniel,9,0,68,59
1657074978132,COGS 101B,A01,091572,Allen; Michael Gordon,8,0,65,57
1657074984156,COGS 101C,A01,083625,Delgado; Tania,17,0,35,18
1657074990177,COGS 107A,A01,083627,Boyle; Mary E. T.,13,0,60,47
1657074996205,COGS 118A,A01,083075,Gupta; Anjum,15,0,76,61
1657075002227,CSE 3,A50,083646,Miranda; Gregory Joseph,22,0,50,28
1657075008255,CSE 8A,A50,083650,Miranda; Gregory Joseph,17,1,56,39
1657075014278,CSE 11,A01,083080,Cao; Yingjun,4,15,40,36
1657075020306,CSE 12,A01,083652,Krause-Levy; Sophia Louisa,23,1,120,97
1657075026334,CSE 15L,A01,083654,Morris; Justin Loren,8,0,50,42
1657075026334,CSE 15L,A02,083655,Morris; Justin Loren,9,0,50,41
1657075032357,CSE 20,A01,083657,Tran; Khoa Dang,37,0,80,43
1657075038385,CSE 21,A01,095574,Bach; Quang Tran,21,0,48,27
1657075044410,CSE 30,A01,083084,Eldon; John,4,0,80,76
1657075044410,CSE 30,B01,095061,Bhaskar; Nishant,6,0,50,44
1657075050436,CSE 100,A01,083659,Cao; Yingjun,3,4,70,67
1657075056463,CSE 134B,A01,083661,Powell; Thomas Allan,19,0,100,81
1657075062490,CSE 140,A01,083663,Gungor; Onat,14,0,85,71
1657075068515,CSE 140L,A01,083088,Eldon; John,16,0,100,84
1657075074539,CSE 175,A01,083665,Kumar; Rakesh,3,0,25,22
1657075080561,CSE 190,A00,092507,Dubnov; Shlomo,7,0,20,13
1657075086588,ECE 45,A01,083139,Congero; Spencer William,5,0,75,70
1657075092618,ECE 65,A50,083695,Saad; Andrew S,12,0,30,18
1657075092618,ECE 65,A51,095125,Saad; Andrew S,25,0,26,1
1657075098647,ECE 109,A01,091882,Touri; Behrouz,16,0,70,54
1657075104671,ECE 180,A00,083140,Abi Samra; Nicholas Camill,1,0,30,29
1657075104671,ECE 180,B00,083141,Abi Samra; Nicholas Camill,0,0,30,30
1657075110694,MATH 10A,A01,083735,Patchell; Gregory David,1,0,30,29
1657075110694,MATH 10A,A02,083736,Patchell; Gregory David,20,0,30,10
1657075110694,MATH 10A,A03,083737,Patchell; Gregory David,16,0,30,14
1657075116718,MATH 10B,A01,083207,Lim; Seonhee,7,0,34,27
1657075116718,MATH 10B,A02,083208,Lim; Seonhee,9,0,35,26
1657075116718,MATH 10B,A03,093472,Lim; Seonhee,4,0,34,30
1657075116718,MATH 10B,B01,083739,Sinha; Shubham,9,0,30,21
1657075122749,MATH 18,A01,083743,Cinel; Cameron Alexander,6,0,30,24
1657075122749,MATH 18,A02,083744,Cinel; Cameron Alexander,15,0,30,15
1657075122749,MATH 18,A03,083745,Cinel; Cameron Alexander,8,0,30,22
1657075122749,MATH 18,B01,083748,Rideout; David Porter,4,0,37,33
1657075122749,MATH 18,B02,083749,Rideout; David Porter,3,0,36,33
1657075122749,MATH 18,B03,083750,Rideout; David Porter,2,0,37,35
1657075122749,MATH 18,B04,083751,Rideout; David Porter,5,0,36,31
1657075122749,MATH 18,B05,093473,Rideout; David Porter,4,0,36,32
1657075122749,MATH 18,B06,093474,Rideout; David Porter,5,0,36,31
1657075128784,MATH 20A,A01,083754,Zheng; Zequn,12,0,40,28
1657075134810,MATH 20B,A01,083756,Briones; Jor-el Thomas Caparas,1,0,36,35
1657075134810,MATH 20B,A02,083757,Briones; Jor-el Thomas Caparas,1,0,36,35
1657075134810,MATH 20B,A03,093475,Briones; Jor-el Thomas Caparas,0,0,36,36
1657075140837,MATH 20C,A01,083760,Briones; Jor-el Thomas Caparas,1,0,35,34
1657075140837,MATH 20C,A02,083761,Briones; Jor-el Thomas Caparas,8,0,35,27
1657075140837,MATH 20C,A03,093476,Briones; Jor-el Thomas Caparas,0,1,36,36
1657075140837,MATH 20C,B01,083762,Bach; Quang Tran,0,0,30,30
1657075146872,MATH 20D,A01,083765,Tran; Brian Kha,4,0,30,26
1657075146872,MATH 20D,A02,083766,Tran; Brian Kha,5,0,30,25
1657075146872,MATH 20D,A03,083767,Tran; Brian Kha,3,0,30,27
1657075152894,MATH 20E,A01,083771,Ganguly; Soumya,5,0,32,27
1657075152894,MATH 20E,A02,083772,Ganguly; Soumya,6,0,32,26
1657075152894,MATH 20E,B01,083773,Ciotti; Benjamin,18,0,35,17
1657075152894,MATH 20E,B02,083774,Ciotti; Benjamin,17,0,35,18
1657075158918,MATH 103A,A01,083777,Greenfeld; Be'Eri,2,0,36,34
1657075158918,MATH 103A,A02,083778,Greenfeld; Be'Eri,5,0,36,31
1657075158918,MATH 103A,A03,093561,Greenfeld; Be'Eri,4,0,36,32
1657075158918,MATH 103A,B01,083779,Greenfeld; Be'Eri,6,0,36,30
1657075158918,MATH 103A,B02,083780,Greenfeld; Be'Eri,2,0,36,34
1657075158918,MATH 103A,B03,093562,Greenfeld; Be'Eri,3,0,36,33
1657075164942,MATH 105,A01,085443,Carter; Anne Toulson,14,0,35,21
1657075164942,MATH 105,A02,093477,Carter; Anne Toulson,20,0,35,15
1657075170972,MATH 109,A01,083213,Ganzberger; Geoffrey Michael,2,0,34,32
1657075170972,MATH 109,A02,083214,Ganzberger; Geoffrey Michael,2,0,34,32
1657075170972,MATH 109,A03,093478,Ganzberger; Geoffrey Michael,1,0,34,33
1657075170972,MATH 109,B01,083215,Ganzberger; Geoffrey Michael,1,0,32,31
1657075170972,MATH 109,B02,083216,Ganzberger; Geoffrey Michael,1,0,32,31
1657075170972,MATH 109,B03,093479,Ganzberger; Geoffrey Michael,6,0,32,26
1657075177005,MATH 142A,A01,083219,Chow; Bennett,6,0,32,26
1657075177005,MATH 142A,A02,083220,Chow; Bennett,10,0,32,22
1657075177005,MATH 142A,A03,093480,Chow; Bennett,7,0,32,25
1657075177005,MATH 142A,B03,093481,Chow; Bennett,7,0,32,25
1657075177005,MATH 142A,B04,093558,Chow; Bennett,11,0,32,21
1657075177005,MATH 142A,B05,093559,Chow; Bennett,6,0,32,26
1657075183028,MATH 193A,A01,083224,Rotar; Vladimir,7,0,34,27
1657075183028,MATH 193A,A02,083225,Rotar; Vladimir,5,0,34,29
1657075183028,MATH 193A,A03,083781,Rotar; Vladimir,1,0,34,33
1657075183028,MATH 193A,A04,083782,Rotar; Vladimir,6,0,34,28
1657075183028,MATH 193A,A05,093482,Rotar; Vladimir,6,0,34,28
1657075189049,MATH 197,001,091859,McAuley; Julian John,9999,0,9999,0
1657075189049,MATH 197,002,095566,Kedlaya; Kiran S.,9997,0,9999,2
1657075189049,MATH 197,003,095567,Xiao; Ming,9999,0,9999,0
1657075189049,MATH 197,004,095571,Perols; Johan Lars,9998,0,9999,1
1657075196101,COGS 9,A01,083615,Shannon; Kyle Michael,7,0,75,68
1657075202128,COGS 11,A01,083617,Boyle; Mary E. T.,21,0,48,27
1657075208151,COGS 13,A01,083071,Bastos; Amalia Pinkusfeld,9,0,71,62
1657075214178,COGS 14A,A01,092681,Semenuks; Arturs,0,1,100,100
1657075220213,COGS 14B,A01,083073,Cheng; Tzu-Han,5,0,63,58
1657075226237,COGS 17,A01,092677,Semenuks; Arturs,4,0,81,77
1657075232261,COGS 100,A01,083619,Allen; Michael Gordon,15,0,70,55
1657075238299,COGS 101A,A01,083621,Davis; Joshua Daniel,9,0,68,59
1657075244327,COGS 101B,A01,091572,Allen; Michael Gordon,8,0,65,57
1657075250358,COGS 101C,A01,083625,Delgado; Tania,17,0,35,18
1657075256381,COGS 107A,A01,083627,Boyle; Mary E. T.,13,0,60,47
1657075262423,COGS 118A,A01,083075,Gupta; Anjum,15,0,76,61
1657075268445,CSE 3,A50,083646,Miranda; Gregory Joseph,22,0,50,28
1657075274473,CSE 8A,A50,083650,Miranda; Gregory Joseph,17,1,56,39
1657075280500,CSE 11,A01,083080,Cao; Yingjun,4,15,40,36
1657075286525,CSE 12,A01,083652,Krause-Levy; Sophia Louisa,23,1,120,97
1657075292549,CSE 15L,A01,083654,Morris; Justin Loren,8,0,50,42
1657075292549,CSE 15L,A02,083655,Morris; Justin Loren,9,0,50,41
1657075298572,CSE 20,A01,083657,Tran; Khoa Dang,37,0,80,43
1657075304606,CSE 21,A01,095574,Bach; Quang Tran,21,0,48,27
1657075310629,CSE 30,A01,083084,Eldon; John,4,0,80,76
1657075310629,CSE 30,B01,095061,Bhaskar; Nishant,6,0,50,44
1657075316652,CSE 100,A01,083659,Cao; Yingjun,3,4,70,67
1657075322674,CSE 134B,A01,083661,Powell; Thomas Allan,19,0,100,81
1657075328696,CSE 140,A01,083663,Gungor; Onat,14,0,85,71
1657075334725,CSE 140L,A01,083088,Eldon; John,16,0,100,84
1657075340751,CSE 175,A01,083665,Kumar; Rakesh,3,0,25,22
1657075346776,CSE 190,A00,092507,Dubnov; Shlomo,7,0,20,13
1657075352800,ECE 45,A01,083139,Congero; Spencer William,5,0,75,70
1657075358823,ECE 65,A50,083695,Saad; Andrew S,12,0,30,18
1657075358823,ECE 65,A51,095125,Saad; Andrew S,25,0,26,1
1657075364847,ECE 109,A01,091882,Touri; Behrouz,16,0,70,54
1657075370880,ECE 180,A00,083140,Abi Samra; Nicholas Camill,1,0,30,29
1657075370880,ECE 180,B00,083141,Abi Samra; Nicholas Camill,0,0,30,30
1657075376904,MATH 10A,A01,083735,Patchell; Gregory David,1,0,30,29
1657075376904,MATH 10A,A02,083736,Patchell; Gregory David,20,0,30,10
1657075376904,MATH 10A,A03,083737,Patchell; Gregory David,16,0,30,14
1657075382929,MATH 10B,A01,083207,Lim; Seonhee,7,0,34,27
1657075382929,MATH 10B,A02,083208,Lim; Seonhee,9,0,35,26
1657075382929,MATH 10B,A03,093472,Lim; Seonhee,4,0,34,30
1657075382929,MATH 10B,B01,083739,Sinha; Shubham,9,0,30,21
1657075388957,MATH 18,A01,083743,Cinel; Cameron Alexander,6,0,30,24
1657075388957,MATH 18,A02,083744,Cinel; Cameron Alexander,15,0,30,15
1657075388957,MATH 18,A03,083745,Cinel; Cameron Alexander,8,0,30,22
1657075388957,MATH 18,B01,083748,Rideout; David Porter,4,0,37,33
1657075388957,MATH 18,B02,083749,Rideout; David Porter,3,0,36,33
1657075388957,MATH 18,B03,083750,Rideout; David Porter,2,0,37,35
1657075388957,MATH 18,B04,083751,Rideout; David Porter,5,0,36,31
1657075388957,MATH 18,B05,093473,Rideout; David Porter,4,0,36,32
1657075388957,MATH 18,B06,093474,Rideout; David Porter,5,0,36,31
1657075394985,MATH 20A,A01,083754,Zheng; Zequn,12,0,40,28
1657075401007,MATH 20B,A01,083756,Briones; Jor-el Thomas Caparas,1,0,36,35
1657075401007,MATH 20B,A02,083757,Briones; Jor-el Thomas Caparas,1,0,36,35
1657075401007,MATH 20B,A03,093475,Briones; Jor-el Thomas Caparas,0,0,36,36
1657075407030,MATH 20C,A01,083760,Briones; Jor-el Thomas Caparas,1,0,35,34
1657075407030,MATH 20C,A02,083761,Briones; Jor-el Thomas Caparas,8,0,35,27
1657075407030,MATH 20C,A03,093476,Briones; Jor-el Thomas Caparas,0,1,36,36
1657075407030,MATH 20C,B01,083762,Bach; Quang Tran,0,0,30,30
1657075413054,MATH 20D,A01,083765,Tran; Brian Kha,4,0,30,26
1657075413054,MATH 20D,A02,083766,Tran; Brian Kha,5,0,30,25
1657075413054,MATH 20D,A03,083767,Tran; Brian Kha,3,0,30,27
1657075419081,MATH 20E,A01,083771,Ganguly; Soumya,5,0,32,27
1657075419081,MATH 20E,A02,083772,Ganguly; Soumya,6,0,32,26
1657075419081,MATH 20E,B01,083773,Ciotti; Benjamin,18,0,35,17
1657075419081,MATH 20E,B02,083774,Ciotti; Benjamin,17,0,35,18
1657075425109,MATH 103A,A01,083777,Greenfeld; Be'Eri,2,0,36,34
1657075425109,MATH 103A,A02,083778,Greenfeld; Be'Eri,5,0,36,31
1657075425109,MATH 103A,A03,093561,Greenfeld; Be'Eri,4,0,36,32
1657075425109,MATH 103A,B01,083779,Greenfeld; Be'Eri,6,0,36,30
1657075425109,MATH 103A,B02,083780,Greenfeld; Be'Eri,2,0,36,34
1657075425109,MATH 103A,B03,093562,Greenfeld; Be'Eri,3,0,36,33
1657075431131,MATH 105,A01,085443,Carter; Anne Toulson,14,0,35,21
1657075431131,MATH 105,A02,093477,Carter; Anne Toulson,20,0,35,15
1657075437159,MATH 109,A01,083213,Ganzberger; Geoffrey Michael,2,0,34,32
1657075437159,MATH 109,A02,083214,Ganzberger; Geoffrey Michael,2,0,34,32
1657075437159,MATH 109,A03,093478,Ganzberger; Geoffrey Michael,1,0,34,33
1657075437159,MATH 109,B01,083215,Ganzberger; Geoffrey Michael,1,0,32,31
1657075437159,MATH 109,B02,083216,Ganzberger; Geoffrey Michael,1,0,32,31
1657075437159,MATH 109,B03,093479,Ganzberger; Geoffrey Michael,6,0,32,26
1657075443184,MATH 142A,A01,083219,Chow; Bennett,6,0,32,26
1657075443184,MATH 142A,A02,083220,Chow; Bennett,10,0,32,22
1657075443184,MATH 142A,A03,093480,Chow; Bennett,7,0,32,25
1657075443184,MATH 142A,B03,093481,Chow; Bennett,7,0,32,25
1657075443184,MATH 142A,B04,093558,Chow; Bennett,11,0,32,21
1657075443184,MATH 142A,B05,093559,Chow; Bennett,6,0,32,26
1657075449207,MATH 193A,A01,083224,Rotar; Vladimir,7,0,34,27
1657075449207,MATH 193A,A02,083225,Rotar; Vladimir,5,0,34,29
1657075449207,MATH 193A,A03,083781,Rotar; Vladimir,1,0,34,33
1657075449207,MATH 193A,A04,083782,Rotar; Vladimir,6,0,34,28
1657075449207,MATH 193A,A05,093482,Rotar; Vladimir,6,0,34,28
1657075455231,MATH 197,001,091859,McAuley; Julian John,9999,0,9999,0
1657075455231,MATH 197,002,095566,Kedlaya; Kiran S.,9997,0,9999,2
1657075455231,MATH 197,003,095567,Xiao; Ming,9999,0,9999,0
1657075455231,MATH 197,004,095571,Perols; Johan Lars,9998,0,9999,1
1657075462283,COGS 9,A01,083615,Shannon; Kyle Michael,7,0,75,68
1657075468305,COGS 11,A01,083617,Boyle; Mary E. T.,21,0,48,27
1657075474341,COGS 13,A01,083071,Bastos; Amalia Pinkusfeld,9,0,71,62
1657075480369,COGS 14A,A01,092681,Semenuks; Arturs,0,1,100,100
1657075486392,COGS 14B,A01,083073,Cheng; Tzu-Han,5,0,63,58
1657075492427,COGS 17,A01,092677,Semenuks; Arturs,4,0,81,77
1657075498451,COGS 100,A01,083619,Allen; Michael Gordon,15,0,70,55
1657075504477,COGS 101A,A01,083621,Davis; Joshua Daniel,9,0,68,59
1657075510500,COGS 101B,A01,091572,Allen; Michael Gordon,8,0,65,57
1657075516524,COGS 101C,A01,083625,Delgado; Tania,17,0,35,18
1657075522548,COGS 107A,A01,083627,Boyle; Mary E. T.,13,0,60,47
1657075528571,COGS 118A,A01,083075,Gupta; Anjum,15,0,76,61
1657075534595,CSE 3,A50,083646,Miranda; Gregory Joseph,22,0,50,28
1657075540626,CSE 8A,A50,083650,Miranda; Gregory Joseph,17,1,56,39
1657075546649,CSE 11,A01,083080,Cao; Yingjun,4,15,40,36
1657075552672,CSE 12,A01,083652,Krause-Levy; Sophia Louisa,23,1,120,97
1657075558693,CSE 15L,A01,083654,Morris; Justin Loren,8,0,50,42
1657075558693,CSE 15L,A02,083655,Morris; Justin Loren,9,0,50,41
1657075564720,CSE 20,A01,083657,Tran; Khoa Dang,37,0,80,43
1657075570815,CSE 21,A01,095574,Bach; Quang Tran,21,0,48,27
1657075576841,CSE 30,A01,083084,Eldon; John,4,0,80,76
1657075576841,CSE 30,B01,095061,Bhaskar; Nishant,6,0,50,44
1657075582870,CSE 100,A01,083659,Cao; Yingjun,3,4,70,67
1657075588895,CSE 134B,A01,083661,Powell; Thomas Allan,19,0,100,81
1657075594924,CSE 140,A01,083663,Gungor; Onat,14,0,85,71
1657075600946,CSE 140L,A01,083088,Eldon; John,16,0,100,84
1657075606969,CSE 175,A01,083665,Kumar; Rakesh,3,0,25,22
1657075613004,CSE 190,A00,092507,Dubnov; Shlomo,7,0,20,13
1657075619042,ECE 45,A01,083139,Congero; Spencer William,5,0,75,70
1657075625065,ECE 65,A50,083695,Saad; Andrew S,12,0,30,18
1657075625065,ECE 65,A51,095125,Saad; Andrew S,25,0,26,1
1657075631091,ECE 109,A01,091882,Touri; Behrouz,16,0,70,54
1657075637117,ECE 180,A00,083140,Abi Samra; Nicholas Camill,1,0,30,29
1657075637117,ECE 180,B00,083141,Abi Samra; Nicholas Camill,0,0,30,30
1657075643144,MATH 10A,A01,083735,Patchell; Gregory David,1,0,30,29
1657075643144,MATH 10A,A02,083736,Patchell; Gregory David,20,0,30,10
1657075643144,MATH 10A,A03,083737,Patchell; Gregory David,16,0,30,14
1657075649172,MATH 10B,A01,083207,Lim; Seonhee,7,0,34,27
1657075649172,MATH 10B,A02,083208,Lim; Seonhee,9,0,35,26
1657075649172,MATH 10B,A03,093472,Lim; Seonhee,4,0,34,30
1657075649172,MATH 10B,B01,083739,Sinha; Shubham,9,0,30,21
1657075655204,MATH 18,A01,083743,Cinel; Cameron Alexander,6,0,30,24
1657075655204,MATH 18,A02,083744,Cinel; Cameron Alexander,15,0,30,15
1657075655204,MATH 18,A03,083745,Cinel; Cameron Alexander,8,0,30,22
1657075655204,MATH 18,B01,083748,Rideout; David Porter,4,0,37,33
1657075655204,MATH 18,B02,083749,Rideout; David Porter,3,0,36,33
1657075655204,MATH 18,B03,083750,Rideout; David Porter,2,0,37,35
1657075655204,MATH 18,B04,083751,Rideout; David Porter,5,0,36,31
1657075655204,MATH 18,B05,093473,Rideout; David Porter,4,0,36,32
1657075655204,MATH 18,B06,093474,Rideout; David Porter,5,0,36,31
1657075661232,MATH 20A,A01,083754,Zheng; Zequn,12,0,40,28
1657075667258,MATH 20B,A01,083756,Briones; Jor-el Thomas Caparas,1,0,36,35
1657075667258,MATH 20B,A02,083757,Briones; Jor-el Thomas Caparas,1,0,36,35
1657075667258,MATH 20B,A03,093475,Briones; Jor-el Thomas Caparas,0,0,36,36
1657075673286,MATH 20C,A01,083760,Briones; Jor-el Thomas Caparas,1,0,35,34
1657075673286,MATH 20C,A02,083761,Briones; Jor-el Thomas Caparas,8,0,35,27
1657075673286,MATH 20C,A03,093476,Briones; Jor-el Thomas Caparas,0,1,36,36
1657075673286,MATH 20C,B01,083762,Bach; Quang Tran,0,0,30,30
1657075679310,MATH 20D,A01,083765,Tran; Brian Kha,4,0,30,26
1657075679310,MATH 20D,A02,083766,Tran; Brian Kha,5,0,30,25
1657075679310,MATH 20D,A03,083767,Tran; Brian Kha,3,0,30,27
1657075685348,MATH 20E,A01,083771,Ganguly; Soumya,5,0,32,27
1657075685348,MATH 20E,A02,083772,Ganguly; Soumya,6,0,32,26
1657075685348,MATH 20E,B01,083773,Ciotti; Benjamin,18,0,35,17
1657075685348,MATH 20E,B02,083774,Ciotti; Benjamin,17,0,35,18
1657075691371,MATH 103A,A01,083777,Greenfeld; Be'Eri,2,0,36,34
1657075691371,MATH 103A,A02,083778,Greenfeld; Be'Eri,5,0,36,31
1657075691371,MATH 103A,A03,093561,Greenfeld; Be'Eri,4,0,36,32
1657075691371,MATH 103A,B01,083779,Greenfeld; Be'Eri,6,0,36,30
1657075691371,MATH 103A,B02,083780,Greenfeld; Be'Eri,2,0,36,34
1657075691371,MATH 103A,B03,093562,Greenfeld; Be'Eri,3,0,36,33
1657075697398,MATH 105,A01,085443,Carter; Anne Toulson,14,0,35,21
1657075697398,MATH 105,A02,093477,Carter; Anne Toulson,20,0,35,15
1657075703419,MATH 109,A01,083213,Ganzberger; Geoffrey Michael,2,0,34,32
1657075703419,MATH 109,A02,083214,Ganzberger; Geoffrey Michael,2,0,34,32
1657075703419,MATH 109,A03,093478,Ganzberger; Geoffrey Michael,1,0,34,33
1657075703419,MATH 109,B01,083215,Ganzberger; Geoffrey Michael,1,0,32,31
1657075703419,MATH 109,B02,083216,Ganzberger; Geoffrey Michael,1,0,32,31
1657075703419,MATH 109,B03,093479,Ganzberger; Geoffrey Michael,6,0,32,26
1657075709443,MATH 142A,A01,083219,Chow; Bennett,6,0,32,26
1657075709443,MATH 142A,A02,083220,Chow; Bennett,10,0,32,22
1657075709443,MATH 142A,A03,093480,Chow; Bennett,7,0,32,25
1657075709443,MATH 142A,B03,093481,Chow; Bennett,7,0,32,25
1657075709443,MATH 142A,B04,093558,Chow; Bennett,11,0,32,21
1657075709443,MATH 142A,B05,093559,Chow; Bennett,6,0,32,26
1657075715476,MATH 193A,A01,083224,Rotar; Vladimir,7,0,34,27
1657075715476,MATH 193A,A02,083225,Rotar; Vladimir,5,0,34,29
1657075715476,MATH 193A,A03,083781,Rotar; Vladimir,1,0,34,33
1657075715476,MATH 193A,A04,083782,Rotar; Vladimir,6,0,34,28
1657075715476,MATH 193A,A05,093482,Rotar; Vladimir,6,0,34,28
1657075721499,MATH 197,001,091859,McAuley; Julian John,9999,0,9999,0
1657075721499,MATH 197,002,095566,Kedlaya; Kiran S.,9997,0,9999,2
1657075721499,MATH 197,003,095567,Xiao; Ming,9999,0,9999,0
1657075721499,MATH 197,004,095571,Perols; Johan Lars,9998,0,9999,1
1657075728552,COGS 9,A01,083615,Shannon; Kyle Michael,7,0,75,68
1657075734588,COGS 11,A01,083617,Boyle; Mary E. T.,21,0,48,27
1657075740614,COGS 13,A01,083071,Bastos; Amalia Pinkusfeld,9,0,71,62
1657075746638,COGS 14A,A01,092681,Semenuks; Arturs,1,1,100,99
1657075752669,COGS 14B,A01,083073,Cheng; Tzu-Han,5,0,63,58
1657075758704,COGS 17,A01,092677,Semenuks; Arturs,4,0,81,77
1657075764726,COGS 100,A01,083619,Allen; Michael Gordon,15,0,70,55
1657075770752,COGS 101A,A01,083621,Davis; Joshua Daniel,9,0,68,59
1657075776779,COGS 101B,A01,091572,Allen; Michael Gordon,8,0,65,57
1657075782809,COGS 101C,A01,083625,Delgado; Tania,17,0,35,18
1657075788832,COGS 107A,A01,083627,Boyle; Mary E. T.,13,0,60,47
1657075794859,COGS 118A,A01,083075,Gupta; Anjum,15,0,76,61
1657075800882,CSE 3,A50,083646,Miranda; Gregory Joseph,22,0,50,28
1657075806904,CSE 8A,A50,083650,Miranda; Gregory Joseph,17,1,56,39
1657075812931,CSE 11,A01,083080,Cao; Yingjun,4,15,40,36
1657075818954,CSE 12,A01,083652,Krause-Levy; Sophia Louisa,23,1,120,97
1657075824982,CSE 15L,A01,083654,Morris; Justin Loren,8,0,50,42
1657075824982,CSE 15L,A02,083655,Morris; Justin Loren,9,0,50,41
1657075831005,CSE 20,A01,083657,Tran; Khoa Dang,37,0,80,43
1657075837035,CSE 21,A01,095574,Bach; Quang Tran,21,0,48,27
1657075843062,CSE 30,A01,083084,Eldon; John,4,0,80,76
1657075843062,CSE 30,B01,095061,Bhaskar; Nishant,6,0,50,44
1657075849100,CSE 100,A01,083659,Cao; Yingjun,3,4,70,67
1657075855123,CSE 134B,A01,083661,Powell; Thomas Allan,19,0,100,81
1657075861148,CSE 140,A01,083663,Gungor; Onat,14,0,85,71
1657075867171,CSE 140L,A01,083088,Eldon; John,16,0,100,84
1657075873197,CSE 175,A01,083665,Kumar; Rakesh,3,0,25,22
1657075879223,CSE 190,A00,092507,Dubnov; Shlomo,7,0,20,13
1657075885246,ECE 45,A01,083139,Congero; Spencer William,5,0,75,70
1657075891268,ECE 65,A50,083695,Saad; Andrew S,12,0,30,18
1657075891268,ECE 65,A51,095125,Saad; Andrew S,25,0,26,1
1657075897290,ECE 109,A01,091882,Touri; Behrouz,16,0,70,54
1657075903327,ECE 180,A00,083140,Abi Samra; Nicholas Camill,1,0,30,29
1657075903327,ECE 180,B00,083141,Abi Samra; Nicholas Camill,0,0,30,30
1657075909350,MATH 10A,A01,083735,Patchell; Gregory David,1,0,30,29
1657075909350,MATH 10A,A02,083736,Patchell; Gregory David,20,0,30,10
1657075909350,MATH 10A,A03,083737,Patchell; Gregory David,16,0,30,14
1657075915373,MATH 10B,A01,083207,Lim; Seonhee,7,0,34,27
1657075915373,MATH 10B,A02,083208,Lim; Seonhee,9,0,35,26
1657075915373,MATH 10B,A03,093472,Lim; Seonhee,4,0,34,30
1657075915373,MATH 10B,B01,083739,Sinha; Shubham,9,0,30,21
1657075921398,MATH 18,A01,083743,Cinel; Cameron Alexander,6,0,30,24
1657075921398,MATH 18,A02,083744,Cinel; Cameron Alexander,15,0,30,15
1657075921398,MATH 18,A03,083745,Cinel; Cameron Alexander,8,0,30,22
1657075921398,MATH 18,B01,083748,Rideout; David Porter,4,0,37,33
1657075921398,MATH 18,B02,083749,Rideout; David Porter,3,0,36,33
1657075921398,MATH 18,B03,083750,Rideout; David Porter,2,0,37,35
1657075921398,MATH 18,B04,083751,Rideout; David Porter,5,0,36,31
1657075921398,MATH 18,B05,093473,Rideout; David Porter,4,0,36,32
1657075921398,MATH 18,B06,093474,Rideout; David Porter,5,0,36,31
1657075927424,MATH 20A,A01,083754,Zheng; Zequn,12,0,40,28
1657075933448,MATH 20B,A01,083756,Briones; Jor-el Thomas Caparas,1,0,36,35
1657075933448,MATH 20B,A02,083757,Briones; Jor-el Thomas Caparas,1,0,36,35
1657075933448,MATH 20B,A03,093475,Briones; Jor-el Thomas Caparas,0,0,36,36
1657075939472,MATH 20C,A01,083760,Briones; Jor-el Thomas Caparas,1,0,35,34
1657075939472,MATH 20C,A02,083761,Briones; Jor-el Thomas Caparas,8,0,35,27
1657075939472,MATH 20C,A03,093476,Briones; Jor-el Thomas Caparas,0,1,36,36
1657075939472,MATH 20C,B01,083762,Bach; Quang Tran,0,0,30,30
1657075945500,MATH 20D,A01,083765,Tran; Brian Kha,4,0,30,26
1657075945500,MATH 20D,A02,083766,Tran; Brian Kha,5,0,30,25
1657075945500,MATH 20D,A03,083767,Tran; Brian Kha,3,0,30,27
1657075951523,MATH 20E,A01,083771,Ganguly; Soumya,5,0,32,27
1657075951523,MATH 20E,A02,083772,Ganguly; Soumya,6,0,32,26
1657075951523,MATH 20E,B01,083773,Ciotti; Benjamin,18,0,35,17
1657075951523,MATH 20E,B02,083774,Ciotti; Benjamin,17,0,35,18
1657075957547,MATH 103A,A01,083777,Greenfeld; Be'Eri,2,0,36,34
1657075957547,MATH 103A,A02,083778,Greenfeld; Be'Eri,5,0,36,31
1657075957547,MATH 103A,A03,093561,Greenfeld; Be'Eri,4,0,36,32
1657075957547,MATH 103A,B01,083779,Greenfeld; Be'Eri,6,0,36,30
1657075957547,MATH 103A,B02,083780,Greenfeld; Be'Eri,2,0,36,34
1657075957547,MATH 103A,B03,093562,Greenfeld; Be'Eri,3,0,36,33
1657075963574,MATH 105,A01,085443,Carter; Anne Toulson,14,0,35,21
1657075963574,MATH 105,A02,093477,Carter; Anne Toulson,20,0,35,15
1657075969600,MATH 109,A01,083213,Ganzberger; Geoffrey Michael,2,0,34,32
1657075969600,MATH 109,A02,083214,Ganzberger; Geoffrey Michael,2,0,34,32
1657075969600,MATH 109,A03,093478,Ganzberger; Geoffrey Michael,1,0,34,33
1657075969600,MATH 109,B01,083215,Ganzberger; Geoffrey Michael,1,0,32,31
1657075969600,MATH 109,B02,083216,Ganzberger; Geoffrey Michael,1,0,32,31
1657075969600,MATH 109,B03,093479,Ganzberger; Geoffrey Michael,6,0,32,26
1657075975628,MATH 142A,A01,083219,Chow; Bennett,6,0,32,26
1657075975628,MATH 142A,A02,083220,Chow; Bennett,10,0,32,22
1657075975628,MATH 142A,A03,093480,Chow; Bennett,7,0,32,25
1657075975628,MATH 142A,B03,093481,Chow; Bennett,7,0,32,25
1657075975628,MATH 142A,B04,093558,Chow; Bennett,11,0,32,21
1657075975628,MATH 142A,B05,093559,Chow; Bennett,6,0,32,26
1657075981650,MATH 193A,A01,083224,Rotar; Vladimir,7,0,34,27
1657075981650,MATH 193A,A02,083225,Rotar; Vladimir,5,0,34,29
1657075981650,MATH 193A,A03,083781,Rotar; Vladimir,1,0,34,33
1657075981650,MATH 193A,A04,083782,Rotar; Vladimir,6,0,34,28
1657075981650,MATH 193A,A05,093482,Rotar; Vladimir,6,0,34,28
1657075987676,MATH 197,001,091859,McAuley; Julian John,9999,0,9999,0
1657075987676,MATH 197,002,095566,Kedlaya; Kiran S.,9997,0,9999,2
1657075987676,MATH 197,003,095567,Xiao; Ming,9999,0,9999,0
1657075987676,MATH 197,004,095571,Perols; Johan Lars,9998,0,9999,1
1657075994744,COGS 9,A01,083615,Shannon; Kyle Michael,7,0,75,68
1657076000766,COGS 11,A01,083617,Boyle; Mary E. T.,21,0,48,27
1657076006793,COGS 13,A01,083071,Bastos; Amalia Pinkusfeld,9,0,71,62
1657076012816,COGS 14A,A01,092681,Semenuks; Arturs,1,1,100,99
1657076018838,COGS 14B,A01,083073,Cheng; Tzu-Han,5,0,63,58
1657076024861,COGS 17,A01,092677,Semenuks; Arturs,4,0,81,77
1657076030888,COGS 100,A01,083619,Allen; Michael Gordon,15,0,70,55
1657076036910,COGS 101A,A01,083621,Davis; Joshua Daniel,9,0,68,59
1657076042933,COGS 101B,A01,091572,Allen; Michael Gordon,8,0,65,57
1657076048954,COGS 101C,A01,083625,Delgado; Tania,17,0,35,18
1657076054981,COGS 107A,A01,083627,Boyle; Mary E. T.,13,0,60,47
1657076061008,COGS 118A,A01,083075,Gupta; Anjum,15,0,76,61
1657076067029,CSE 3,A50,083646,Miranda; Gregory Joseph,22,0,50,28
1657076073055,CSE 8A,A50,083650,Miranda; Gregory Joseph,17,1,56,39
1657076079078,CSE 11,A01,083080,Cao; Yingjun,4,15,40,36
1657076085105,CSE 12,A01,083652,Krause-Levy; Sophia Louisa,23,1,120,97
1657076091129,CSE 15L,A01,083654,Morris; Justin Loren,8,0,50,42
1657076091129,CSE 15L,A02,083655,Morris; Justin Loren,9,0,50,41
1657076097156,CSE 20,A01,083657,Tran; Khoa Dang,37,0,80,43
1657076103183,CSE 21,A01,095574,Bach; Quang Tran,21,0,48,27
1657076109208,CSE 30,A01,083084,Eldon; John,4,0,80,76
1657076109208,CSE 30,B01,095061,Bhaskar; Nishant,6,0,50,44
1657076115232,CSE 100,A01,083659,Cao; Yingjun,3,4,70,67
1657076121254,CSE 134B,A01,083661,Powell; Thomas Allan,19,0,100,81
1657076127283,CSE 140,A01,083663,Gungor; Onat,14,0,85,71
1657076133307,CSE 140L,A01,083088,Eldon; John,16,0,100,84
1657076139330,CSE 175,A01,083665,Kumar; Rakesh,3,0,25,22
1657076145354,CSE 190,A00,092507,Dubnov; Shlomo,7,0,20,13
1657076151375,ECE 45,A01,083139,Congero; Spencer William,5,0,75,70
1657076157406,ECE 65,A50,083695,Saad; Andrew S,12,0,30,18
1657076157406,ECE 65,A51,095125,Saad; Andrew S,25,0,26,1
1657076163429,ECE 109,A01,091882,Touri; Behrouz,16,0,70,54
1657076169529,ECE 180,A00,083140,Abi Samra; Nicholas Camill,1,0,30,29
1657076169529,ECE 180,B00,083141,Abi Samra; Nicholas Camill,0,0,30,30
1657076175564,MATH 10A,A01,083735,Patchell; Gregory David,1,0,30,29
1657076175564,MATH 10A,A02,083736,Patchell; Gregory David,20,0,30,10
1657076175564,MATH 10A,A03,083737,Patchell; Gregory David,16,0,30,14
1657076181586,MATH 10B,A01,083207,Lim; Seonhee,7,0,34,27
1657076181586,MATH 10B,A02,083208,Lim; Seonhee,9,0,35,26
1657076181586,MATH 10B,A03,093472,Lim; Seonhee,4,0,34,30
1657076181586,MATH 10B,B01,083739,Sinha; Shubham,9,0,30,21
1657076187610,MATH 18,A01,083743,Cinel; Cameron Alexander,6,0,30,24
1657076187610,MATH 18,A02,083744,Cinel; Cameron Alexander,15,0,30,15
1657076187610,MATH 18,A03,083745,Cinel; Cameron Alexander,8,0,30,22
1657076187610,MATH 18,B01,083748,Rideout; David Porter,4,0,37,33
1657076187610,MATH 18,B02,083749,Rideout; David Porter,3,0,36,33
1657076187610,MATH 18,B03,083750,Rideout; David Porter,2,0,37,35
1657076187610,MATH 18,B04,083751,Rideout; David Porter,5,0,36,31
1657076187610,MATH 18,B05,093473,Rideout; David Porter,4,0,36,32
1657076187610,MATH 18,B06,093474,Rideout; David Porter,5,0,36,31
1657076193642,MATH 20A,A01,083754,Zheng; Zequn,12,0,40,28
1657076199664,MATH 20B,A01,083756,Briones; Jor-el Thomas Caparas,1,0,36,35
1657076199664,MATH 20B,A02,083757,Briones; Jor-el Thomas Caparas,1,0,36,35
1657076199664,MATH 20B,A03,093475,Briones; Jor-el Thomas Caparas,0,0,36,36
1657076205688,MATH 20C,A01,083760,Briones; Jor-el Thomas Caparas,1,0,35,34
1657076205688,MATH 20C,A02,083761,Briones; Jor-el Thomas Caparas,8,0,35,27
1657076205688,MATH 20C,A03,093476,Briones; Jor-el Thomas Caparas,0,1,36,36
1657076205688,MATH 20C,B01,083762,Bach; Quang Tran,0,0,30,30
1657076211714,MATH 20D,A01,083765,Tran; Brian Kha,4,0,30,26
1657076211714,MATH 20D,A02,083766,Tran; Brian Kha,5,0,30,25
1657076211714,MATH 20D,A03,083767,Tran; Brian Kha,3,0,30,27
1657076217736,MATH 20E,A01,083771,Ganguly; Soumya,5,0,32,27
1657076217736,MATH 20E,A02,083772,Ganguly; Soumya,6,0,32,26
1657076217736,MATH 20E,B01,083773,Ciotti; Benjamin,18,0,35,17
1657076217736,MATH 20E,B02,083774,Ciotti; Benjamin,17,0,35,18
1657076223761,MATH 103A,A01,083777,Greenfeld; Be'Eri,2,0,36,34
1657076223761,MATH 103A,A02,083778,Greenfeld; Be'Eri,5,0,36,31
1657076223761,MATH 103A,A03,093561,Greenfeld; Be'Eri,4,0,36,32
1657076223761,MATH 103A,B01,083779,Greenfeld; Be'Eri,6,0,36,30
1657076223761,MATH 103A,B02,083780,Greenfeld; Be'Eri,2,0,36,34
1657076223761,MATH 103A,B03,093562,Greenfeld; Be'Eri,3,0,36,33
1657076229787,MATH 105,A01,085443,Carter; Anne Toulson,14,0,35,21
1657076229787,MATH 105,A02,093477,Carter; Anne Toulson,20,0,35,15
1657076235818,MATH 109,A01,083213,Ganzberger; Geoffrey Michael,2,0,34,32
1657076235818,MATH 109,A02,083214,Ganzberger; Geoffrey Michael,2,0,34,32
1657076235818,MATH 109,A03,093478,Ganzberger; Geoffrey Michael,1,0,34,33
1657076235818,MATH 109,B01,083215,Ganzberger; Geoffrey Michael,1,0,32,31
1657076235818,MATH 109,B02,083216,Ganzberger; Geoffrey Michael,1,0,32,31
1657076235818,MATH 109,B03,093479,Ganzberger; Geoffrey Michael,6,0,32,26
1657076241842,MATH 142A,A01,083219,Chow; Bennett,6,0,32,26
1657076241842,MATH 142A,A02,083220,Chow; Bennett,10,0,32,22
1657076241842,MATH 142A,A03,093480,Chow; Bennett,7,0,32,25
1657076241842,MATH 142A,B03,093481,Chow; Bennett,7,0,32,25
1657076241842,MATH 142A,B04,093558,Chow; Bennett,11,0,32,21
1657076241842,MATH 142A,B05,093559,Chow; Bennett,6,0,32,26
1657076247871,MATH 193A,A01,083224,Rotar; Vladimir,7,0,34,27
1657076247871,MATH 193A,A02,083225,Rotar; Vladimir,5,0,34,29
1657076247871,MATH 193A,A03,083781,Rotar; Vladimir,1,0,34,33
1657076247871,MATH 193A,A04,083782,Rotar; Vladimir,6,0,34,28
1657076247871,MATH 193A,A05,093482,Rotar; Vladimir,6,0,34,28
1657076253894,MATH 197,001,091859,McAuley; Julian John,9999,0,9999,0
1657076253894,MATH 197,002,095566,Kedlaya; Kiran S.,9997,0,9999,2
1657076253894,MATH 197,003,095567,Xiao; Ming,9999,0,9999,0
1657076253894,MATH 197,004,095571,Perols; Johan Lars,9998,0,9999,1
1657076260947,COGS 9,A01,083615,Shannon; Kyle Michael,7,0,75,68
1657076266969,COGS 11,A01,083617,Boyle; Mary E. T.,21,0,48,27
1657076272997,COGS 13,A01,083071,Bastos; Amalia Pinkusfeld,9,0,71,62
1657076279022,COGS 14A,A01,092681,Semenuks; Arturs,1,1,100,99
1657076285046,COGS 14B,A01,083073,Cheng; Tzu-Han,5,0,63,58
1657076291068,COGS 17,A01,092677,Semenuks; Arturs,4,0,81,77
1657076297094,COGS 100,A01,083619,Allen; Michael Gordon,15,0,70,55
1657076303120,COGS 101A,A01,083621,Davis; Joshua Daniel,9,0,68,59
1657076309147,COGS 101B,A01,091572,Allen; Michael Gordon,8,0,65,57
1657076315172,COGS 101C,A01,083625,Delgado; Tania,17,0,35,18
1657076321195,COGS 107A,A01,083627,Boyle; Mary E. T.,13,0,60,47
1657076327218,COGS 118A,A01,083075,Gupta; Anjum,15,0,76,61
1657076333245,CSE 3,A50,083646,Miranda; Gregory Joseph,22,0,50,28
1657076339271,CSE 8A,A50,083650,Miranda; Gregory Joseph,17,1,56,39
1657076345293,CSE 11,A01,083080,Cao; Yingjun,4,15,40,36
1657076351318,CSE 12,A01,083652,Krause-Levy; Sophia Louisa,23,1,120,97
1657076357345,CSE 15L,A01,083654,Morris; Justin Loren,8,0,50,42
1657076357345,CSE 15L,A02,083655,Morris; Justin Loren,9,0,50,41
1657076363368,CSE 20,A01,083657,Tran; Khoa Dang,37,0,80,43
1657076369396,CSE 21,A01,095574,Bach; Quang Tran,21,0,48,27
1657076375429,CSE 30,A01,083084,Eldon; John,4,0,80,76
1657076375429,CSE 30,B01,095061,Bhaskar; Nishant,6,0,50,44
1657076381455,CSE 100,A01,083659,Cao; Yingjun,3,4,70,67
1657076387483,CSE 134B,A01,083661,Powell; Thomas Allan,19,0,100,81
1657076393508,CSE 140,A01,083663,Gungor; Onat,14,0,85,71
1657076399530,CSE 140L,A01,083088,Eldon; John,16,0,100,84
1657076405557,CSE 175,A01,083665,Kumar; Rakesh,3,0,25,22
1657076411582,CSE 190,A00,092507,Dubnov; Shlomo,7,0,20,13
1657076417609,ECE 45,A01,083139,Congero; Spencer William,5,0,75,70
1657076423635,ECE 65,A50,083695,Saad; Andrew S,12,0,30,18
1657076423635,ECE 65,A51,095125,Saad; Andrew S,25,0,26,1
1657076429661,ECE 109,A01,091882,Touri; Behrouz,16,0,70,54
1657076435683,ECE 180,A00,083140,Abi Samra; Nicholas Camill,1,0,30,29
1657076435683,ECE 180,B00,083141,Abi Samra; Nicholas Camill,0,0,30,30
1657076441711,MATH 10A,A01,083735,Patchell; Gregory David,1,0,30,29
1657076441711,MATH 10A,A02,083736,Patchell; Gregory David,20,0,30,10
1657076441711,MATH 10A,A03,083737,Patchell; Gregory David,16,0,30,14
1657076447737,MATH 10B,A01,083207,Lim; Seonhee,7,0,34,27
1657076447737,MATH 10B,A02,083208,Lim; Seonhee,9,0,35,26
1657076447737,MATH 10B,A03,093472,Lim; Seonhee,4,0,34,30
1657076447737,MATH 10B,B01,083739,Sinha; Shubham,9,0,30,21
1657076453761,MATH 18,A01,083743,Cinel; Cameron Alexander,6,0,30,24
1657076453761,MATH 18,A02,083744,Cinel; Cameron Alexander,15,0,30,15
1657076453761,MATH 18,A03,083745,Cinel; Cameron Alexander,8,0,30,22
1657076453761,MATH 18,B01,083748,Rideout; David Porter,4,0,37,33
1657076453761,MATH 18,B02,083749,Rideout; David Porter,3,0,36,33
1657076453761,MATH 18,B03,083750,Rideout; David Porter,2,0,37,35
1657076453761,MATH 18,B04,083751,Rideout; David Porter,5,0,36,31
1657076453761,MATH 18,B05,093473,Rideout; David Porter,4,0,36,32
1657076453761,MATH 18,B06,093474,Rideout; David Porter,5,0,36,31
1657076459784,MATH 20A,A01,083754,Zheng; Zequn,12,0,40,28
1657076465823,MATH 20B,A01,083756,Briones; Jor-el Thomas Caparas,1,0,36,35
1657076465823,MATH 20B,A02,083757,Briones; Jor-el Thomas Caparas,1,0,36,35
1657076465823,MATH 20B,A03,093475,Briones; Jor-el Thomas Caparas,0,0,36,36
1657076471852,MATH 20C,A01,083760,Briones; Jor-el Thomas Caparas,1,0,35,34
1657076471852,MATH 20C,A02,083761,Briones; Jor-el Thomas Caparas,8,0,35,27
1657076471852,MATH 20C,A03,093476,Briones; Jor-el Thomas Caparas,0,1,36,36
1657076471852,MATH 20C,B01,083762,Bach; Quang Tran,0,0,30,30
1657076477886,MATH 20D,A01,083765,Tran; Brian Kha,4,0,30,26
1657076477886,MATH 20D,A02,083766,Tran; Brian Kha,5,0,30,25
1657076477886,MATH 20D,A03,083767,Tran; Brian Kha,3,0,30,27
1657076483909,MATH 20E,A01,083771,Ganguly; Soumya,5,0,32,27
1657076483909,MATH 20E,A02,083772,Ganguly; Soumya,6,0,32,26
1657076483909,MATH 20E,B01,083773,Ciotti; Benjamin,18,0,35,17
1657076483909,MATH 20E,B02,083774,Ciotti; Benjamin,17,0,35,18
1657076489933,MATH 103A,A01,083777,Greenfeld; Be'Eri,2,0,36,34
1657076489933,MATH 103A,A02,083778,Greenfeld; Be'Eri,5,0,36,31
1657076489933,MATH 103A,A03,093561,Greenfeld; Be'Eri,4,0,36,32
1657076489933,MATH 103A,B01,083779,Greenfeld; Be'Eri,6,0,36,30
1657076489933,MATH 103A,B02,083780,Greenfeld; Be'Eri,2,0,36,34
1657076489933,MATH 103A,B03,093562,Greenfeld; Be'Eri,3,0,36,33
1657076495960,MATH 105,A01,085443,Carter; Anne Toulson,14,0,35,21
1657076495960,MATH 105,A02,093477,Carter; Anne Toulson,20,0,35,15
1657076501984,MATH 109,A01,083213,Ganzberger; Geoffrey Michael,2,0,34,32
1657076501984,MATH 109,A02,083214,Ganzberger; Geoffrey Michael,2,0,34,32
1657076501984,MATH 109,A03,093478,Ganzberger; Geoffrey Michael,1,0,34,33
1657076501984,MATH 109,B01,083215,Ganzberger; Geoffrey Michael,1,0,32,31
1657076501984,MATH 109,B02,083216,Ganzberger; Geoffrey Michael,1,0,32,31
1657076501984,MATH 109,B03,093479,Ganzberger; Geoffrey Michael,6,0,32,26
1657076508020,MATH 142A,A01,083219,Chow; Bennett,6,0,32,26
1657076508020,MATH 142A,A02,083220,Chow; Bennett,10,0,32,22
1657076508020,MATH 142A,A03,093480,Chow; Bennett,7,0,32,25
1657076508020,MATH 142A,B03,093481,Chow; Bennett,7,0,32,25
1657076508020,MATH 142A,B04,093558,Chow; Bennett,11,0,32,21
1657076508020,MATH 142A,B05,093559,Chow; Bennett,6,0,32,26
1657076514047,MATH 193A,A01,083224,Rotar; Vladimir,7,0,34,27
1657076514047,MATH 193A,A02,083225,Rotar; Vladimir,5,0,34,29
1657076514047,MATH 193A,A03,083781,Rotar; Vladimir,1,0,34,33
1657076514047,MATH 193A,A04,083782,Rotar; Vladimir,6,0,34,28
1657076514047,MATH 193A,A05,093482,Rotar; Vladimir,6,0,34,28
1657076520070,MATH 197,001,091859,McAuley; Julian John,9999,0,9999,0
1657076520070,MATH 197,002,095566,Kedlaya; Kiran S.,9997,0,9999,2
1657076520070,MATH 197,003,095567,Xiao; Ming,9999,0,9999,0
1657076520070,MATH 197,004,095571,Perols; Johan Lars,9998,0,9999,1
1657076527129,COGS 9,A01,083615,Shannon; Kyle Michael,7,0,75,68
1657076533155,COGS 11,A01,083617,Boyle; Mary E. T.,21,0,48,27
1657076539179,COGS 13,A01,083071,Bastos; Amalia Pinkusfeld,9,0,71,62
1657076545201,COGS 14A,A01,092681,Semenuks; Arturs,1,1,100,99
1657076551235,COGS 14B,A01,083073,Cheng; Tzu-Han,5,0,63,58
1657076557263,COGS 17,A01,092677,Semenuks; Arturs,4,0,81,77
1657076563290,COGS 100,A01,083619,Allen; Michael Gordon,15,0,70,55
1657076569313,COGS 101A,A01,083621,Davis; Joshua Daniel,9,0,68,59
1657076575335,COGS 101B,A01,091572,Allen; Michael Gordon,8,0,65,57
1657076581358,COGS 101C,A01,083625,Delgado; Tania,17,0,35,18
1657076587381,COGS 107A,A01,083627,Boyle; Mary E. T.,13,0,60,47
1657076593403,COGS 118A,A01,083075,Gupta; Anjum,15,0,76,61
1657076599426,CSE 3,A50,083646,Miranda; Gregory Joseph,22,0,50,28
1657076605455,CSE 8A,A50,083650,Miranda; Gregory Joseph,17,1,56,39
1657076611477,CSE 11,A01,083080,Cao; Yingjun,4,15,40,36
1657076617500,CSE 12,A01,083652,Krause-Levy; Sophia Louisa,23,1,120,97
1657076623528,CSE 15L,A01,083654,Morris; Justin Loren,8,0,50,42
1657076623528,CSE 15L,A02,083655,Morris; Justin Loren,9,0,50,41
1657076629555,CSE 20,A01,083657,Tran; Khoa Dang,37,0,80,43
1657076635577,CSE 21,A01,095574,Bach; Quang Tran,21,0,48,27
1657076641601,CSE 30,A01,083084,Eldon; John,4,0,80,76
1657076641601,CSE 30,B01,095061,Bhaskar; Nishant,6,0,50,44
1657076647625,CSE 100,A01,083659,Cao; Yingjun,3,4,70,67
1657076653652,CSE 134B,A01,083661,Powell; Thomas Allan,19,0,100,81
1657076659675,CSE 140,A01,083663,Gungor; Onat,14,0,85,71
1657076665704,CSE 140L,A01,083088,Eldon; John,16,0,100,84
1657076671728,CSE 175,A01,083665,Kumar; Rakesh,3,0,25,22
1657076677752,CSE 190,A00,092507,Dubnov; Shlomo,7,0,20,13
1657076683778,ECE 45,A01,083139,Congero; Spencer William,5,0,75,70
1657076689799,ECE 65,A50,083695,Saad; Andrew S,12,0,30,18
1657076689799,ECE 65,A51,095125,Saad; Andrew S,25,0,26,1
1657076695824,ECE 109,A01,091882,Touri; Behrouz,16,0,70,54
1657076701851,ECE 180,A00,083140,Abi Samra; Nicholas Camill,1,0,30,29
1657076701851,ECE 180,B00,083141,Abi Samra; Nicholas Camill,0,0,30,30
1657076707878,MATH 10A,A01,083735,Patchell; Gregory David,1,0,30,29
1657076707878,MATH 10A,A02,083736,Patchell; Gregory David,20,0,30,10
1657076707878,MATH 10A,A03,083737,Patchell; Gregory David,16,0,30,14
1657076713904,MATH 10B,A01,083207,Lim; Seonhee,7,0,34,27
1657076713904,MATH 10B,A02,083208,Lim; Seonhee,9,0,35,26
1657076713904,MATH 10B,A03,093472,Lim; Seonhee,4,0,34,30
1657076713904,MATH 10B,B01,083739,Sinha; Shubham,9,0,30,21
1657076719928,MATH 18,A01,083743,Cinel; Cameron Alexander,6,0,30,24
1657076719928,MATH 18,A02,083744,Cinel; Cameron Alexander,15,0,30,15
1657076719928,MATH 18,A03,083745,Cinel; Cameron Alexander,8,0,30,22
1657076719928,MATH 18,B01,083748,Rideout; David Porter,4,0,37,33
1657076719928,MATH 18,B02,083749,Rideout; David Porter,3,0,36,33
1657076719928,MATH 18,B03,083750,Rideout; David Porter,2,0,37,35
1657076719928,MATH 18,B04,083751,Rideout; David Porter,5,0,36,31
1657076719928,MATH 18,B05,093473,Rideout; David Porter,4,0,36,32
1657076719928,MATH 18,B06,093474,Rideout; David Porter,5,0,36,31
1657076725957,MATH 20A,A01,083754,Zheng; Zequn,12,0,40,28
1657076731985,MATH 20B,A01,083756,Briones; Jor-el Thomas Caparas,1,0,36,35
1657076731985,MATH 20B,A02,083757,Briones; Jor-el Thomas Caparas,1,0,36,35
1657076731985,MATH 20B,A03,093475,Briones; Jor-el Thomas Caparas,0,0,36,36
1657076738008,MATH 20C,A01,083760,Briones; Jor-el Thomas Caparas,1,0,35,34
1657076738008,MATH 20C,A02,083761,Briones; Jor-el Thomas Caparas,8,0,35,27
1657076738008,MATH 20C,A03,093476,Briones; Jor-el Thomas Caparas,0,1,36,36
1657076738008,MATH 20C,B01,083762,Bach; Quang Tran,0,0,30,30
1657076744035,MATH 20D,A01,083765,Tran; Brian Kha,4,0,30,26
1657076744035,MATH 20D,A02,083766,Tran; Brian Kha,5,0,30,25
1657076744035,MATH 20D,A03,083767,Tran; Brian Kha,3,0,30,27
1657076750061,MATH 20E,A01,083771,Ganguly; Soumya,5,0,32,27
1657076750061,MATH 20E,A02,083772,Ganguly; Soumya,6,0,32,26
1657076750061,MATH 20E,B01,083773,Ciotti; Benjamin,18,0,35,17
1657076750061,MATH 20E,B02,083774,Ciotti; Benjamin,17,0,35,18
1657076756091,MATH 103A,A01,083777,Greenfeld; Be'Eri,2,0,36,34
1657076756091,MATH 103A,A02,083778,Greenfeld; Be'Eri,5,0,36,31
1657076756091,MATH 103A,A03,093561,Greenfeld; Be'Eri,4,0,36,32
1657076756091,MATH 103A,B01,083779,Greenfeld; Be'Eri,6,0,36,30
1657076756091,MATH 103A,B02,083780,Greenfeld; Be'Eri,2,0,36,34
1657076756091,MATH 103A,B03,093562,Greenfeld; Be'Eri,3,0,36,33
1657076762116,MATH 105,A01,085443,Carter; Anne Toulson,14,0,35,21
1657076762116,MATH 105,A02,093477,Carter; Anne Toulson,20,0,35,15
1657076768241,MATH 109,A01,083213,Ganzberger; Geoffrey Michael,2,0,34,32
1657076768241,MATH 109,A02,083214,Ganzberger; Geoffrey Michael,2,0,34,32
1657076768241,MATH 109,A03,093478,Ganzberger; Geoffrey Michael,1,0,34,33
1657076768241,MATH 109,B01,083215,Ganzberger; Geoffrey Michael,1,0,32,31
1657076768241,MATH 109,B02,083216,Ganzberger; Geoffrey Michael,1,0,32,31
1657076768241,MATH 109,B03,093479,Ganzberger; Geoffrey Michael,6,0,32,26
1657076774278,MATH 142A,A01,083219,Chow; Bennett,6,0,32,26
1657076774278,MATH 142A,A02,083220,Chow; Bennett,10,0,32,22
1657076774278,MATH 142A,A03,093480,Chow; Bennett,7,0,32,25
1657076774278,MATH 142A,B03,093481,Chow; Bennett,7,0,32,25
1657076774278,MATH 142A,B04,093558,Chow; Bennett,11,0,32,21
1657076774278,MATH 142A,B05,093559,Chow; Bennett,6,0,32,26
1657076780301,MATH 193A,A01,083224,Rotar; Vladimir,7,0,34,27
1657076780301,MATH 193A,A02,083225,Rotar; Vladimir,5,0,34,29
1657076780301,MATH 193A,A03,083781,Rotar; Vladimir,1,0,34,33
1657076780301,MATH 193A,A04,083782,Rotar; Vladimir,6,0,34,28
1657076780301,MATH 193A,A05,093482,Rotar; Vladimir,6,0,34,28
1657076786322,MATH 197,001,091859,McAuley; Julian John,9999,0,9999,0
1657076786322,MATH 197,002,095566,Kedlaya; Kiran S.,9997,0,9999,2
1657076786322,MATH 197,003,095567,Xiao; Ming,9999,0,9999,0
1657076786322,MATH 197,004,095571,Perols; Johan Lars,9998,0,9999,1
1657076793374,COGS 9,A01,083615,Shannon; Kyle Michael,7,0,75,68
1657076799397,COGS 11,A01,083617,Boyle; Mary E. T.,21,0,48,27
1657076805423,COGS 13,A01,083071,Bastos; Amalia Pinkusfeld,9,0,71,62
1657076811446,COGS 14A,A01,092681,Semenuks; Arturs,1,1,100,99
1657076817470,COGS 14B,A01,083073,Cheng; Tzu-Han,5,0,63,58
1657076823495,COGS 17,A01,092677,Semenuks; Arturs,4,0,81,77
1657076829521,COGS 100,A01,083619,Allen; Michael Gordon,15,0,70,55
1657076835545,COGS 101A,A01,083621,Davis; Joshua Daniel,9,0,68,59
1657076841566,COGS 101B,A01,091572,Allen; Michael Gordon,8,0,65,57
1657076847591,COGS 101C,A01,083625,Delgado; Tania,17,0,35,18
1657076853614,COGS 107A,A01,083627,Boyle; Mary E. T.,13,0,60,47
1657076859638,COGS 118A,A01,083075,Gupta; Anjum,15,0,76,61
1657076865669,CSE 3,A50,083646,Miranda; Gregory Joseph,22,0,50,28
1657076871705,CSE 8A,A50,083650,Miranda; Gregory Joseph,17,1,56,39
1657076877728,CSE 11,A01,083080,Cao; Yingjun,4,15,40,36
1657076883756,CSE 12,A01,083652,Krause-Levy; Sophia Louisa,23,1,120,97
1657076889784,CSE 15L,A01,083654,Morris; Justin Loren,8,0,50,42
1657076889784,CSE 15L,A02,083655,Morris; Justin Loren,9,0,50,41
1657076895807,CSE 20,A01,083657,Tran; Khoa Dang,37,0,80,43
1657076901835,CSE 21,A01,095574,Bach; Quang Tran,21,0,48,27
1657076907864,CSE 30,A01,083084,Eldon; John,4,0,80,76
1657076907864,CSE 30,B01,095061,Bhaskar; Nishant,6,0,50,44
1657076913891,CSE 100,A01,083659,Cao; Yingjun,3,4,70,67
1657076919915,CSE 134B,A01,083661,Powell; Thomas Allan,19,0,100,81
1657076925938,CSE 140,A01,083663,Gungor; Onat,14,0,85,71
1657076931963,CSE 140L,A01,083088,Eldon; John,16,0,100,84
1657076937988,CSE 175,A01,083665,Kumar; Rakesh,3,0,25,22
1657076944030,CSE 190,A00,092507,Dubnov; Shlomo,7,0,20,13
1657076950058,ECE 45,A01,083139,Congero; Spencer William,5,0,75,70
1657076956082,ECE 65,A50,083695,Saad; Andrew S,12,0,30,18
1657076956082,ECE 65,A51,095125,Saad; Andrew S,25,0,26,1
1657076962111,ECE 109,A01,091882,Touri; Behrouz,16,0,70,54
1657076968139,ECE 180,A00,083140,Abi Samra; Nicholas Camill,1,0,30,29
1657076968139,ECE 180,B00,083141,Abi Samra; Nicholas Camill,0,0,30,30
1657076974169,MATH 10A,A01,083735,Patchell; Gregory David,1,0,30,29
1657076974169,MATH 10A,A02,083736,Patchell; Gregory David,20,0,30,10
1657076974169,MATH 10A,A03,083737,Patchell; Gregory David,16,0,30,14
1657076980193,MATH 10B,A01,083207,Lim; Seonhee,7,0,34,27
1657076980193,MATH 10B,A02,083208,Lim; Seonhee,9,0,35,26
1657076980193,MATH 10B,A03,093472,Lim; Seonhee,4,0,34,30
1657076980193,MATH 10B,B01,083739,Sinha; Shubham,9,0,30,21
1657076986223,MATH 18,A01,083743,Cinel; Cameron Alexander,6,0,30,24
1657076986223,MATH 18,A02,083744,Cinel; Cameron Alexander,15,0,30,15
1657076986223,MATH 18,A03,083745,Cinel; Cameron Alexander,8,0,30,22
1657076986223,MATH 18,B01,083748,Rideout; David Porter,4,0,37,33
1657076986223,MATH 18,B02,083749,Rideout; David Porter,3,0,36,33
1657076986223,MATH 18,B03,083750,Rideout; David Porter,2,0,37,35
1657076986223,MATH 18,B04,083751,Rideout; David Porter,5,0,36,31
1657076986223,MATH 18,B05,093473,Rideout; David Porter,4,0,36,32
1657076986223,MATH 18,B06,093474,Rideout; David Porter,5,0,36,31
1657076992250,MATH 20A,A01,083754,Zheng; Zequn,12,0,40,28
1657076998273,MATH 20B,A01,083756,Briones; Jor-el Thomas Caparas,1,0,36,35
1657076998273,MATH 20B,A02,083757,Briones; Jor-el Thomas Caparas,1,0,36,35
1657076998273,MATH 20B,A03,093475,Briones; Jor-el Thomas Caparas,0,0,36,36
1657077004309,MATH 20C,A01,083760,Briones; Jor-el Thomas Caparas,1,0,35,34
1657077004309,MATH 20C,A02,083761,Briones; Jor-el Thomas Caparas,8,0,35,27
1657077004309,MATH 20C,A03,093476,Briones; Jor-el Thomas Caparas,0,1,36,36
1657077004309,MATH 20C,B01,083762,Bach; Quang Tran,0,0,30,30
1657077010336,MATH 20D,A01,083765,Tran; Brian Kha,4,0,30,26
1657077010336,MATH 20D,A02,083766,Tran; Brian Kha,5,0,30,25
1657077010336,MATH 20D,A03,083767,Tran; Brian Kha,3,0,30,27
1657077016364,MATH 20E,A01,083771,Ganguly; Soumya,5,0,32,27
1657077016364,MATH 20E,A02,083772,Ganguly; Soumya,6,0,32,26
1657077016364,MATH 20E,B01,083773,Ciotti; Benjamin,18,0,35,17
1657077016364,MATH 20E,B02,083774,Ciotti; Benjamin,17,0,35,18
1657077022388,MATH 103A,A01,083777,Greenfeld; Be'Eri,2,0,36,34
1657077022388,MATH 103A,A02,083778,Greenfeld; Be'Eri,5,0,36,31
1657077022388,MATH 103A,A03,093561,Greenfeld; Be'Eri,4,0,36,32
1657077022388,MATH 103A,B01,083779,Greenfeld; Be'Eri,6,0,36,30
1657077022388,MATH 103A,B02,083780,Greenfeld; Be'Eri,2,0,36,34
1657077022388,MATH 103A,B03,093562,Greenfeld; Be'Eri,3,0,36,33
1657077028413,MATH 105,A01,085443,Carter; Anne Toulson,14,0,35,21
1657077028413,MATH 105,A02,093477,Carter; Anne Toulson,20,0,35,15
1657077034436,MATH 109,A01,083213,Ganzberger; Geoffrey Michael,2,0,34,32
1657077034436,MATH 109,A02,083214,Ganzberger; Geoffrey Michael,2,0,34,32
1657077034436,MATH 109,A03,093478,Ganzberger; Geoffrey Michael,1,0,34,33
1657077034436,MATH 109,B01,083215,Ganzberger; Geoffrey Michael,1,0,32,31
1657077034436,MATH 109,B02,083216,Ganzberger; Geoffrey Michael,1,0,32,31
1657077034436,MATH 109,B03,093479,Ganzberger; Geoffrey Michael,6,0,32,26
1657077040461,MATH 142A,A01,083219,Chow; Bennett,6,0,32,26
1657077040461,MATH 142A,A02,083220,Chow; Bennett,10,0,32,22
1657077040461,MATH 142A,A03,093480,Chow; Bennett,7,0,32,25
1657077040461,MATH 142A,B03,093481,Chow; Bennett,8,0,32,24
1657077040461,MATH 142A,B04,093558,Chow; Bennett,11,0,32,21
1657077040461,MATH 142A,B05,093559,Chow; Bennett,6,0,32,26
1657077046489,MATH 193A,A01,083224,Rotar; Vladimir,7,0,34,27
1657077046489,MATH 193A,A02,083225,Rotar; Vladimir,5,0,34,29
1657077046489,MATH 193A,A03,083781,Rotar; Vladimir,1,0,34,33
1657077046489,MATH 193A,A04,083782,Rotar; Vladimir,6,0,34,28
1657077046489,MATH 193A,A05,093482,Rotar; Vladimir,6,0,34,28
1657077052515,MATH 197,001,091859,McAuley; Julian John,9999,0,9999,0
1657077052515,MATH 197,002,095566,Kedlaya; Kiran S.,9997,0,9999,2
1657077052515,MATH 197,003,095567,Xiao; Ming,9999,0,9999,0
1657077052515,MATH 197,004,095571,Perols; Johan Lars,9998,0,9999,1
1657077059564,COGS 9,A01,083615,Shannon; Kyle Michael,7,0,75,68
1657077065589,COGS 11,A01,083617,Boyle; Mary E. T.,21,0,48,27
1657077071616,COGS 13,A01,083071,Bastos; Amalia Pinkusfeld,9,0,71,62
1657077077639,COGS 14A,A01,092681,Semenuks; Arturs,1,1,100,99
1657077083666,COGS 14B,A01,083073,Cheng; Tzu-Han,5,0,63,58
1657077089692,COGS 17,A01,092677,Semenuks; Arturs,4,0,81,77
1657077095718,COGS 100,A01,083619,Allen; Michael Gordon,15,0,70,55
1657077101745,COGS 101A,A01,083621,Davis; Joshua Daniel,9,0,68,59
1657077107771,COGS 101B,A01,091572,Allen; Michael Gordon,8,0,65,57
1657077113795,COGS 101C,A01,083625,Delgado; Tania,17,0,35,18
1657077119823,COGS 107A,A01,083627,Boyle; Mary E. T.,13,0,60,47
1657077125849,COGS 118A,A01,083075,Gupta; Anjum,15,0,76,61
1657077131877,CSE 3,A50,083646,Miranda; Gregory Joseph,22,0,50,28
1657077137906,CSE 8A,A50,083650,Miranda; Gregory Joseph,17,1,56,39
1657077143933,CSE 11,A01,083080,Cao; Yingjun,4,15,40,36
1657077149955,CSE 12,A01,083652,Krause-Levy; Sophia Louisa,23,1,120,97
1657077155978,CSE 15L,A01,083654,Morris; Justin Loren,8,0,50,42
1657077155978,CSE 15L,A02,083655,Morris; Justin Loren,9,0,50,41
1657077162002,CSE 20,A01,083657,Tran; Khoa Dang,37,0,80,43
1657077168024,CSE 21,A01,095574,Bach; Quang Tran,21,0,48,27
1657077174047,CSE 30,A01,083084,Eldon; John,4,0,80,76
1657077174047,CSE 30,B01,095061,Bhaskar; Nishant,6,0,50,44
1657077180069,CSE 100,A01,083659,Cao; Yingjun,3,4,70,67
1657077186095,CSE 134B,A01,083661,Powell; Thomas Allan,19,0,100,81
1657077192118,CSE 140,A01,083663,Gungor; Onat,14,0,85,71
1657077198140,CSE 140L,A01,083088,Eldon; John,16,0,100,84
1657077204164,CSE 175,A01,083665,Kumar; Rakesh,3,0,25,22
1657077210193,CSE 190,A00,092507,Dubnov; Shlomo,7,0,20,13
1657077216220,ECE 45,A01,083139,Congero; Spencer William,5,0,75,70
1657077222248,ECE 65,A50,083695,Saad; Andrew S,12,0,30,18
1657077222248,ECE 65,A51,095125,Saad; Andrew S,25,0,26,1
1657077228273,ECE 109,A01,091882,Touri; Behrouz,16,0,70,54
1657077234296,ECE 180,A00,083140,Abi Samra; Nicholas Camill,1,0,30,29
1657077234296,ECE 180,B00,083141,Abi Samra; Nicholas Camill,0,0,30,30
1657077240318,MATH 10A,A01,083735,Patchell; Gregory David,1,0,30,29
1657077240318,MATH 10A,A02,083736,Patchell; Gregory David,20,0,30,10
1657077240318,MATH 10A,A03,083737,Patchell; Gregory David,16,0,30,14
1657077246341,MATH 10B,A01,083207,Lim; Seonhee,7,0,34,27
1657077246341,MATH 10B,A02,083208,Lim; Seonhee,9,0,35,26
1657077246341,MATH 10B,A03,093472,Lim; Seonhee,4,0,34,30
1657077246341,MATH 10B,B01,083739,Sinha; Shubham,9,0,30,21
1657077252370,MATH 18,A01,083743,Cinel; Cameron Alexander,6,0,30,24
1657077252370,MATH 18,A02,083744,Cinel; Cameron Alexander,15,0,30,15
1657077252370,MATH 18,A03,083745,Cinel; Cameron Alexander,8,0,30,22
1657077252370,MATH 18,B01,083748,Rideout; David Porter,4,0,37,33
1657077252370,MATH 18,B02,083749,Rideout; David Porter,3,0,36,33
1657077252370,MATH 18,B03,083750,Rideout; David Porter,2,0,37,35
1657077252370,MATH 18,B04,083751,Rideout; David Porter,5,0,36,31
1657077252370,MATH 18,B05,093473,Rideout; David Porter,4,0,36,32
1657077252370,MATH 18,B06,093474,Rideout; David Porter,5,0,36,31
1657077258396,MATH 20A,A01,083754,Zheng; Zequn,12,0,40,28
1657077264422,MATH 20B,A01,083756,Briones; Jor-el Thomas Caparas,1,0,36,35
1657077264422,MATH 20B,A02,083757,Briones; Jor-el Thomas Caparas,1,0,36,35
1657077264422,MATH 20B,A03,093475,Briones; Jor-el Thomas Caparas,0,0,36,36
1657077270454,MATH 20C,A01,083760,Briones; Jor-el Thomas Caparas,1,0,35,34
1657077270454,MATH 20C,A02,083761,Briones; Jor-el Thomas Caparas,8,0,35,27
1657077270454,MATH 20C,A03,093476,Briones; Jor-el Thomas Caparas,0,1,36,36
1657077270454,MATH 20C,B01,083762,Bach; Quang Tran,0,0,30,30
1657077276482,MATH 20D,A01,083765,Tran; Brian Kha,4,0,30,26
1657077276482,MATH 20D,A02,083766,Tran; Brian Kha,5,0,30,25
1657077276482,MATH 20D,A03,083767,Tran; Brian Kha,3,0,30,27
1657077282506,MATH 20E,A01,083771,Ganguly; Soumya,5,0,32,27
1657077282506,MATH 20E,A02,083772,Ganguly; Soumya,6,0,32,26
1657077282506,MATH 20E,B01,083773,Ciotti; Benjamin,18,0,35,17
1657077282506,MATH 20E,B02,083774,Ciotti; Benjamin,17,0,35,18
1657077288537,MATH 103A,A01,083777,Greenfeld; Be'Eri,2,0,36,34
1657077288537,MATH 103A,A02,083778,Greenfeld; Be'Eri,5,0,36,31
1657077288537,MATH 103A,A03,093561,Greenfeld; Be'Eri,4,0,36,32
1657077288537,MATH 103A,B01,083779,Greenfeld; Be'Eri,6,0,36,30
1657077288537,MATH 103A,B02,083780,Greenfeld; Be'Eri,2,0,36,34
1657077288537,MATH 103A,B03,093562,Greenfeld; Be'Eri,3,0,36,33
1657077294560,MATH 105,A01,085443,Carter; Anne Toulson,14,0,35,21
1657077294560,MATH 105,A02,093477,Carter; Anne Toulson,20,0,35,15
1657077300591,MATH 109,A01,083213,Ganzberger; Geoffrey Michael,2,0,34,32
1657077300591,MATH 109,A02,083214,Ganzberger; Geoffrey Michael,2,0,34,32
1657077300591,MATH 109,A03,093478,Ganzberger; Geoffrey Michael,1,0,34,33
1657077300591,MATH 109,B01,083215,Ganzberger; Geoffrey Michael,1,0,32,31
1657077300591,MATH 109,B02,083216,Ganzberger; Geoffrey Michael,1,0,32,31
1657077300591,MATH 109,B03,093479,Ganzberger; Geoffrey Michael,6,0,32,26
1657077306615,MATH 142A,A01,083219,Chow; Bennett,6,0,32,26
1657077306615,MATH 142A,A02,083220,Chow; Bennett,10,0,32,22
1657077306615,MATH 142A,A03,093480,Chow; Bennett,7,0,32,25
1657077306615,MATH 142A,B03,093481,Chow; Bennett,8,0,32,24
1657077306615,MATH 142A,B04,093558,Chow; Bennett,11,0,32,21
1657077306615,MATH 142A,B05,093559,Chow; Bennett,6,0,32,26
1657077312639,MATH 193A,A01,083224,Rotar; Vladimir,7,0,34,27
1657077312639,MATH 193A,A02,083225,Rotar; Vladimir,5,0,34,29
1657077312639,MATH 193A,A03,083781,Rotar; Vladimir,1,0,34,33
1657077312639,MATH 193A,A04,083782,Rotar; Vladimir,6,0,34,28
1657077312639,MATH 193A,A05,093482,Rotar; Vladimir,6,0,34,28
1657077318662,MATH 197,001,091859,McAuley; Julian John,9999,0,9999,0
1657077318662,MATH 197,002,095566,Kedlaya; Kiran S.,9997,0,9999,2
1657077318662,MATH 197,003,095567,Xiao; Ming,9999,0,9999,0
1657077318662,MATH 197,004,095571,Perols; Johan Lars,9998,0,9999,1
1657077325723,COGS 9,A01,083615,Shannon; Kyle Michael,7,0,75,68
1657077331745,COGS 11,A01,083617,Boyle; Mary E. T.,21,0,48,27
1657077337768,COGS 13,A01,083071,Bastos; Amalia Pinkusfeld,9,0,71,62
1657077343789,COGS 14A,A01,092681,Semenuks; Arturs,1,1,100,99
1657077349815,COGS 14B,A01,083073,Cheng; Tzu-Han,5,0,63,58
1657077355841,COGS 17,A01,092677,Semenuks; Arturs,4,0,81,77
1657077361957,COGS 100,A01,083619,Allen; Michael Gordon,15,0,70,55
1657077367981,COGS 101A,A01,083621,Davis; Joshua Daniel,9,0,68,59
1657077374004,COGS 101B,A01,091572,Allen; Michael Gordon,8,0,65,57
1657077380037,COGS 101C,A01,083625,Delgado; Tania,17,0,35,18
1657077386064,COGS 107A,A01,083627,Boyle; Mary E. T.,13,0,60,47
1657077392092,COGS 118A,A01,083075,Gupta; Anjum,15,0,76,61
1657077398119,CSE 3,A50,083646,Miranda; Gregory Joseph,22,0,50,28
1657077404147,CSE 8A,A50,083650,Miranda; Gregory Joseph,17,1,56,39
1657077410174,CSE 11,A01,083080,Cao; Yingjun,4,15,40,36
1657077416198,CSE 12,A01,083652,Krause-Levy; Sophia Louisa,23,1,120,97
1657077422221,CSE 15L,A01,083654,Morris; Justin Loren,8,0,50,42
1657077422221,CSE 15L,A02,083655,Morris; Justin Loren,9,0,50,41
1657077428248,CSE 20,A01,083657,Tran; Khoa Dang,37,0,80,43
1657077434272,CSE 21,A01,095574,Bach; Quang Tran,21,0,48,27
1657077440303,CSE 30,A01,083084,Eldon; John,4,0,80,76
1657077440303,CSE 30,B01,095061,Bhaskar; Nishant,6,0,50,44
1657077446330,CSE 100,A01,083659,Cao; Yingjun,3,4,70,67
1657077452353,CSE 134B,A01,083661,Powell; Thomas Allan,19,0,100,81
1657077458380,CSE 140,A01,083663,Gungor; Onat,14,0,85,71
1657077464404,CSE 140L,A01,083088,Eldon; John,16,0,100,84
1657077470426,CSE 175,A01,083665,Kumar; Rakesh,3,0,25,22
1657077476455,CSE 190,A00,092507,Dubnov; Shlomo,7,0,20,13
1657077482481,ECE 45,A01,083139,Congero; Spencer William,5,0,75,70
1657077488506,ECE 65,A50,083695,Saad; Andrew S,12,0,30,18
1657077488506,ECE 65,A51,095125,Saad; Andrew S,25,0,26,1
1657077494529,ECE 109,A01,091882,Touri; Behrouz,16,0,70,54
1657077500557,ECE 180,A00,083140,Abi Samra; Nicholas Camill,1,0,30,29
1657077500557,ECE 180,B00,083141,Abi Samra; Nicholas Camill,0,0,30,30
1657077506581,MATH 10A,A01,083735,Patchell; Gregory David,1,0,30,29
1657077506581,MATH 10A,A02,083736,Patchell; Gregory David,20,0,30,10
1657077506581,MATH 10A,A03,083737,Patchell; Gregory David,16,0,30,14
1657077512621,MATH 10B,A01,083207,Lim; Seonhee,7,0,34,27
1657077512621,MATH 10B,A02,083208,Lim; Seonhee,9,0,35,26
1657077512621,MATH 10B,A03,093472,Lim; Seonhee,4,0,34,30
1657077512621,MATH 10B,B01,083739,Sinha; Shubham,9,0,30,21
1657077518649,MATH 18,A01,083743,Cinel; Cameron Alexander,6,0,30,24
1657077518649,MATH 18,A02,083744,Cinel; Cameron Alexander,15,0,30,15
1657077518649,MATH 18,A03,083745,Cinel; Cameron Alexander,8,0,30,22
1657077518649,MATH 18,B01,083748,Rideout; David Porter,4,0,37,33
1657077518649,MATH 18,B02,083749,Rideout; David Porter,3,0,36,33
1657077518649,MATH 18,B03,083750,Rideout; David Porter,2,0,37,35
1657077518649,MATH 18,B04,083751,Rideout; David Porter,5,0,36,31
1657077518649,MATH 18,B05,093473,Rideout; David Porter,4,0,36,32
1657077518649,MATH 18,B06,093474,Rideout; David Porter,5,0,36,31
1657077524671,MATH 20A,A01,083754,Zheng; Zequn,12,0,40,28
1657077530694,MATH 20B,A01,083756,Briones; Jor-el Thomas Caparas,1,0,36,35
1657077530694,MATH 20B,A02,083757,Briones; Jor-el Thomas Caparas,1,0,36,35
1657077530694,MATH 20B,A03,093475,Briones; Jor-el Thomas Caparas,0,0,36,36
1657077536723,MATH 20C,A01,083760,Briones; Jor-el Thomas Caparas,1,0,35,34
1657077536723,MATH 20C,A02,083761,Briones; Jor-el Thomas Caparas,8,0,35,27
1657077536723,MATH 20C,A03,093476,Briones; Jor-el Thomas Caparas,0,1,36,36
1657077536723,MATH 20C,B01,083762,Bach; Quang Tran,0,0,30,30
1657077542751,MATH 20D,A01,083765,Tran; Brian Kha,4,0,30,26
1657077542751,MATH 20D,A02,083766,Tran; Brian Kha,5,0,30,25
1657077542751,MATH 20D,A03,083767,Tran; Brian Kha,3,0,30,27
1657077548781,MATH 20E,A01,083771,Ganguly; Soumya,5,0,32,27
1657077548781,MATH 20E,A02,083772,Ganguly; Soumya,6,0,32,26
1657077548781,MATH 20E,B01,083773,Ciotti; Benjamin,18,0,35,17
1657077548781,MATH 20E,B02,083774,Ciotti; Benjamin,17,0,35,18
1657077554813,MATH 103A,A01,083777,Greenfeld; Be'Eri,2,0,36,34
1657077554813,MATH 103A,A02,083778,Greenfeld; Be'Eri,5,0,36,31
1657077554813,MATH 103A,A03,093561,Greenfeld; Be'Eri,4,0,36,32
1657077554813,MATH 103A,B01,083779,Greenfeld; Be'Eri,6,0,36,30
1657077554813,MATH 103A,B02,083780,Greenfeld; Be'Eri,2,0,36,34
1657077554813,MATH 103A,B03,093562,Greenfeld; Be'Eri,3,0,36,33
1657077560842,MATH 105,A01,085443,Carter; Anne Toulson,14,0,35,21
1657077560842,MATH 105,A02,093477,Carter; Anne Toulson,20,0,35,15
1657077566870,MATH 109,A01,083213,Ganzberger; Geoffrey Michael,2,0,34,32
1657077566870,MATH 109,A02,083214,Ganzberger; Geoffrey Michael,2,0,34,32
1657077566870,MATH 109,A03,093478,Ganzberger; Geoffrey Michael,1,0,34,33
1657077566870,MATH 109,B01,083215,Ganzberger; Geoffrey Michael,1,0,32,31
1657077566870,MATH 109,B02,083216,Ganzberger; Geoffrey Michael,1,0,32,31
1657077566870,MATH 109,B03,093479,Ganzberger; Geoffrey Michael,6,0,32,26
1657077572893,MATH 142A,A01,083219,Chow; Bennett,6,0,32,26
1657077572893,MATH 142A,A02,083220,Chow; Bennett,10,0,32,22
1657077572893,MATH 142A,A03,093480,Chow; Bennett,7,0,32,25
1657077572893,MATH 142A,B03,093481,Chow; Bennett,8,0,32,24
1657077572893,MATH 142A,B04,093558,Chow; Bennett,11,0,32,21
1657077572893,MATH 142A,B05,093559,Chow; Bennett,6,0,32,26
1657077578918,MATH 193A,A01,083224,Rotar; Vladimir,7,0,34,27
1657077578918,MATH 193A,A02,083225,Rotar; Vladimir,5,0,34,29
1657077578918,MATH 193A,A03,083781,Rotar; Vladimir,1,0,34,33
1657077578918,MATH 193A,A04,083782,Rotar; Vladimir,6,0,34,28
1657077578918,MATH 193A,A05,093482,Rotar; Vladimir,6,0,34,28
1657077584943,MATH 197,001,091859,McAuley; Julian John,9999,0,9999,0
1657077584943,MATH 197,002,095566,Kedlaya; Kiran S.,9997,0,9999,2
1657077584943,MATH 197,003,095567,Xiao; Ming,9999,0,9999,0
1657077584943,MATH 197,004,095571,Perols; Johan Lars,9998,0,9999,1
1657077592004,COGS 9,A01,083615,Shannon; Kyle Michael,7,0,75,68
1657077598027,COGS 11,A01,083617,Boyle; Mary E. T.,21,0,48,27
1657077604054,COGS 13,A01,083071,Bastos; Amalia Pinkusfeld,9,0,71,62
1657077610079,COGS 14A,A01,092681,Semenuks; Arturs,1,1,100,99
1657077616103,COGS 14B,A01,083073,Cheng; Tzu-Han,5,0,63,58
1657077622125,COGS 17,A01,092677,Semenuks; Arturs,4,0,81,77
1657077628148,COGS 100,A01,083619,Allen; Michael Gordon,15,0,70,55
1657077634171,COGS 101A,A01,083621,Davis; Joshua Daniel,9,0,68,59
1657077640197,COGS 101B,A01,091572,Allen; Michael Gordon,8,0,65,57
1657077646225,COGS 101C,A01,083625,Delgado; Tania,17,0,35,18
1657077652252,COGS 107A,A01,083627,Boyle; Mary E. T.,13,0,60,47
1657077658275,COGS 118A,A01,083075,Gupta; Anjum,15,0,76,61
1657077664302,CSE 3,A50,083646,Miranda; Gregory Joseph,22,0,50,28
1657077670351,CSE 8A,A50,083650,Miranda; Gregory Joseph,17,1,56,39
1657077676374,CSE 11,A01,083080,Cao; Yingjun,4,15,40,36
1657077682398,CSE 12,A01,083652,Krause-Levy; Sophia Louisa,23,1,120,97
1657077688426,CSE 15L,A01,083654,Morris; Justin Loren,8,0,50,42
1657077688426,CSE 15L,A02,083655,Morris; Justin Loren,9,0,50,41
1657077694450,CSE 20,A01,083657,Tran; Khoa Dang,37,0,80,43
1657077700473,CSE 21,A01,095574,Bach; Quang Tran,21,0,48,27
1657077706497,CSE 30,A01,083084,Eldon; John,4,0,80,76
1657077706497,CSE 30,B01,095061,Bhaskar; Nishant,6,0,50,44
1657077712523,CSE 100,A01,083659,Cao; Yingjun,3,4,70,67
1657077718550,CSE 134B,A01,083661,Powell; Thomas Allan,19,0,100,81
1657077724580,CSE 140,A01,083663,Gungor; Onat,14,0,85,71
1657077730603,CSE 140L,A01,083088,Eldon; John,16,0,100,84
1657077736624,CSE 175,A01,083665,Kumar; Rakesh,3,0,25,22
1657077742650,CSE 190,A00,092507,Dubnov; Shlomo,7,0,20,13
1657077748673,ECE 45,A01,083139,Congero; Spencer William,5,0,75,70
1657077754699,ECE 65,A50,083695,Saad; Andrew S,12,0,30,18
1657077754699,ECE 65,A51,095125,Saad; Andrew S,25,0,26,1
1657077760727,ECE 109,A01,091882,Touri; Behrouz,16,0,70,54
1657077766750,ECE 180,A00,083140,Abi Samra; Nicholas Camill,1,0,30,29
1657077766750,ECE 180,B00,083141,Abi Samra; Nicholas Camill,0,0,30,30
1657077772773,MATH 10A,A01,083735,Patchell; Gregory David,1,0,30,29
1657077772773,MATH 10A,A02,083736,Patchell; Gregory David,20,0,30,10
1657077772773,MATH 10A,A03,083737,Patchell; Gregory David,16,0,30,14
1657077778801,MATH 10B,A01,083207,Lim; Seonhee,7,0,34,27
1657077778801,MATH 10B,A02,083208,Lim; Seonhee,9,0,35,26
1657077778801,MATH 10B,A03,093472,Lim; Seonhee,4,0,34,30
1657077778801,MATH 10B,B01,083739,Sinha; Shubham,9,0,30,21
1657077784824,MATH 18,A01,083743,Cinel; Cameron Alexander,6,0,30,24
1657077784824,MATH 18,A02,083744,Cinel; Cameron Alexander,15,0,30,15
1657077784824,MATH 18,A03,083745,Cinel; Cameron Alexander,8,0,30,22
1657077784824,MATH 18,B01,083748,Rideout; David Porter,4,0,37,33
1657077784824,MATH 18,B02,083749,Rideout; David Porter,3,0,36,33
1657077784824,MATH 18,B03,083750,Rideout; David Porter,2,0,37,35
1657077784824,MATH 18,B04,083751,Rideout; David Porter,5,0,36,31
1657077784824,MATH 18,B05,093473,Rideout; David Porter,4,0,36,32
1657077784824,MATH 18,B06,093474,Rideout; David Porter,5,0,36,31
1657077790848,MATH 20A,A01,083754,Zheng; Zequn,12,0,40,28
1657077796874,MATH 20B,A01,083756,Briones; Jor-el Thomas Caparas,1,0,36,35
1657077796874,MATH 20B,A02,083757,Briones; Jor-el Thomas Caparas,1,0,36,35
1657077796874,MATH 20B,A03,093475,Briones; Jor-el Thomas Caparas,0,0,36,36
1657077802903,MATH 20C,A01,083760,Briones; Jor-el Thomas Caparas,1,0,35,34
1657077802903,MATH 20C,A02,083761,Briones; Jor-el Thomas Caparas,8,0,35,27
1657077802903,MATH 20C,A03,093476,Briones; Jor-el Thomas Caparas,0,1,36,36
1657077802903,MATH 20C,B01,083762,Bach; Quang Tran,0,0,30,30
1657077808927,MATH 20D,A01,083765,Tran; Brian Kha,4,0,30,26
1657077808927,MATH 20D,A02,083766,Tran; Brian Kha,5,0,30,25
1657077808927,MATH 20D,A03,083767,Tran; Brian Kha,3,0,30,27
1657077814954,MATH 20E,A01,083771,Ganguly; Soumya,5,0,32,27
1657077814954,MATH 20E,A02,083772,Ganguly; Soumya,6,0,32,26
1657077814954,MATH 20E,B01,083773,Ciotti; Benjamin,18,0,35,17
1657077814954,MATH 20E,B02,083774,Ciotti; Benjamin,17,0,35,18
1657077820978,MATH 103A,A01,083777,Greenfeld; Be'Eri,2,0,36,34
1657077820978,MATH 103A,A02,083778,Greenfeld; Be'Eri,5,0,36,31
1657077820978,MATH 103A,A03,093561,Greenfeld; Be'Eri,4,0,36,32
1657077820978,MATH 103A,B01,083779,Greenfeld; Be'Eri,6,0,36,30
1657077820978,MATH 103A,B02,083780,Greenfeld; Be'Eri,2,0,36,34
1657077820978,MATH 103A,B03,093562,Greenfeld; Be'Eri,3,0,36,33
1657077827000,MATH 105,A01,085443,Carter; Anne Toulson,14,0,35,21
1657077827000,MATH 105,A02,093477,Carter; Anne Toulson,20,0,35,15
1657077833026,MATH 109,A01,083213,Ganzberger; Geoffrey Michael,2,0,34,32
1657077833026,MATH 109,A02,083214,Ganzberger; Geoffrey Michael,2,0,34,32
1657077833026,MATH 109,A03,093478,Ganzberger; Geoffrey Michael,1,0,34,33
1657077833026,MATH 109,B01,083215,Ganzberger; Geoffrey Michael,1,0,32,31
1657077833026,MATH 109,B02,083216,Ganzberger; Geoffrey Michael,1,0,32,31
1657077833026,MATH 109,B03,093479,Ganzberger; Geoffrey Michael,6,0,32,26
1657077839055,MATH 142A,A01,083219,Chow; Bennett,6,0,32,26
1657077839055,MATH 142A,A02,083220,Chow; Bennett,10,0,32,22
1657077839055,MATH 142A,A03,093480,Chow; Bennett,7,0,32,25
1657077839055,MATH 142A,B03,093481,Chow; Bennett,8,0,32,24
1657077839055,MATH 142A,B04,093558,Chow; Bennett,11,0,32,21
1657077839055,MATH 142A,B05,093559,Chow; Bennett,6,0,32,26
1657077845084,MATH 193A,A01,083224,Rotar; Vladimir,7,0,34,27
1657077845084,MATH 193A,A02,083225,Rotar; Vladimir,5,0,34,29
1657077845084,MATH 193A,A03,083781,Rotar; Vladimir,1,0,34,33
1657077845084,MATH 193A,A04,083782,Rotar; Vladimir,6,0,34,28
1657077845084,MATH 193A,A05,093482,Rotar; Vladimir,6,0,34,28
1657077851110,MATH 197,001,091859,McAuley; Julian John,9999,0,9999,0
1657077851110,MATH 197,002,095566,Kedlaya; Kiran S.,9997,0,9999,2
1657077851110,MATH 197,003,095567,Xiao; Ming,9999,0,9999,0
1657077851110,MATH 197,004,095571,Perols; Johan Lars,9998,0,9999,1
1657077858167,COGS 9,A01,083615,Shannon; Kyle Michael,7,0,75,68
1657077864191,COGS 11,A01,083617,Boyle; Mary E. T.,21,0,48,27
1657077870215,COGS 13,A01,083071,Bastos; Amalia Pinkusfeld,9,0,71,62
1657077876250,COGS 14A,A01,092681,Semenuks; Arturs,1,1,100,99
1657077882272,COGS 14B,A01,083073,Cheng; Tzu-Han,5,0,63,58
1657077888298,COGS 17,A01,092677,Semenuks; Arturs,4,0,81,77
1657077894330,COGS 100,A01,083619,Allen; Michael Gordon,15,0,70,55
1657077900358,COGS 101A,A01,083621,Davis; Joshua Daniel,9,0,68,59
1657077906381,COGS 101B,A01,091572,Allen; Michael Gordon,8,0,65,57
1657077912406,COGS 101C,A01,083625,Delgado; Tania,17,0,35,18
1657077918428,COGS 107A,A01,083627,Boyle; Mary E. T.,13,0,60,47
1657077924450,COGS 118A,A01,083075,Gupta; Anjum,15,0,76,61
1657077930474,CSE 3,A50,083646,Miranda; Gregory Joseph,22,0,50,28
1657077936497,CSE 8A,A50,083650,Miranda; Gregory Joseph,17,1,56,39
1657077942532,CSE 11,A01,083080,Cao; Yingjun,4,15,40,36
1657077948553,CSE 12,A01,083652,Krause-Levy; Sophia Louisa,23,1,120,97
1657077954581,CSE 15L,A01,083654,Morris; Justin Loren,8,0,50,42
1657077954581,CSE 15L,A02,083655,Morris; Justin Loren,9,0,50,41
1657077960682,CSE 20,A01,083657,Tran; Khoa Dang,37,0,80,43
1657077966709,CSE 21,A01,095574,Bach; Quang Tran,21,0,48,27
1657077972732,CSE 30,A01,083084,Eldon; John,4,0,80,76
1657077972732,CSE 30,B01,095061,Bhaskar; Nishant,6,0,50,44
1657077978757,CSE 100,A01,083659,Cao; Yingjun,3,4,70,67
1657077984785,CSE 134B,A01,083661,Powell; Thomas Allan,19,0,100,81
1657077990810,CSE 140,A01,083663,Gungor; Onat,14,0,85,71
1657077996841,CSE 140L,A01,083088,Eldon; John,16,0,100,84
1657078002869,CSE 175,A01,083665,Kumar; Rakesh,3,0,25,22
1657078008893,CSE 190,A00,092507,Dubnov; Shlomo,7,0,20,13
1657078014915,ECE 45,A01,083139,Congero; Spencer William,5,0,75,70
1657078020938,ECE 65,A50,083695,Saad; Andrew S,12,0,30,18
1657078020938,ECE 65,A51,095125,Saad; Andrew S,25,0,26,1
1657078026961,ECE 109,A01,091882,Touri; Behrouz,16,0,70,54
1657078032984,ECE 180,A00,083140,Abi Samra; Nicholas Camill,1,0,30,29
1657078032984,ECE 180,B00,083141,Abi Samra; Nicholas Camill,0,0,30,30
1657078039009,MATH 10A,A01,083735,Patchell; Gregory David,1,0,30,29
1657078039009,MATH 10A,A02,083736,Patchell; Gregory David,20,0,30,10
1657078039009,MATH 10A,A03,083737,Patchell; Gregory David,16,0,30,14
1657078045037,MATH 10B,A01,083207,Lim; Seonhee,7,0,34,27
1657078045037,MATH 10B,A02,083208,Lim; Seonhee,9,0,35,26
1657078045037,MATH 10B,A03,093472,Lim; Seonhee,4,0,34,30
1657078045037,MATH 10B,B01,083739,Sinha; Shubham,9,0,30,21
1657078051068,MATH 18,A01,083743,Cinel; Cameron Alexander,6,0,30,24
1657078051068,MATH 18,A02,083744,Cinel; Cameron Alexander,15,0,30,15
1657078051068,MATH 18,A03,083745,Cinel; Cameron Alexander,8,0,30,22
1657078051068,MATH 18,B01,083748,Rideout; David Porter,4,0,37,33
1657078051068,MATH 18,B02,083749,Rideout; David Porter,3,0,36,33
1657078051068,MATH 18,B03,083750,Rideout; David Porter,2,0,37,35
1657078051068,MATH 18,B04,083751,Rideout; David Porter,5,0,36,31
1657078051068,MATH 18,B05,093473,Rideout; David Porter,4,0,36,32
1657078051068,MATH 18,B06,093474,Rideout; David Porter,5,0,36,31
1657078057094,MATH 20A,A01,083754,Zheng; Zequn,12,0,40,28
1657078063123,MATH 20B,A01,083756,Briones; Jor-el Thomas Caparas,1,0,36,35
1657078063123,MATH 20B,A02,083757,Briones; Jor-el Thomas Caparas,1,0,36,35
1657078063123,MATH 20B,A03,093475,Briones; Jor-el Thomas Caparas,0,0,36,36
1657078069148,MATH 20C,A01,083760,Briones; Jor-el Thomas Caparas,1,0,35,34
1657078069148,MATH 20C,A02,083761,Briones; Jor-el Thomas Caparas,8,0,35,27
1657078069148,MATH 20C,A03,093476,Briones; Jor-el Thomas Caparas,0,1,36,36
1657078069148,MATH 20C,B01,083762,Bach; Quang Tran,0,0,30,30
1657078075182,MATH 20D,A01,083765,Tran; Brian Kha,4,0,30,26
1657078075182,MATH 20D,A02,083766,Tran; Brian Kha,5,0,30,25
1657078075182,MATH 20D,A03,083767,Tran; Brian Kha,3,0,30,27
1657078081211,MATH 20E,A01,083771,Ganguly; Soumya,5,0,32,27
1657078081211,MATH 20E,A02,083772,Ganguly; Soumya,6,0,32,26
1657078081211,MATH 20E,B01,083773,Ciotti; Benjamin,18,0,35,17
1657078081211,MATH 20E,B02,083774,Ciotti; Benjamin,17,0,35,18
1657078087235,MATH 103A,A01,083777,Greenfeld; Be'Eri,2,0,36,34
1657078087235,MATH 103A,A02,083778,Greenfeld; Be'Eri,5,0,36,31
1657078087235,MATH 103A,A03,093561,Greenfeld; Be'Eri,4,0,36,32
1657078087235,MATH 103A,B01,083779,Greenfeld; Be'Eri,6,0,36,30
1657078087235,MATH 103A,B02,083780,Greenfeld; Be'Eri,2,0,36,34
1657078087235,MATH 103A,B03,093562,Greenfeld; Be'Eri,3,0,36,33
1657078093262,MATH 105,A01,085443,Carter; Anne Toulson,14,0,35,21
1657078093262,MATH 105,A02,093477,Carter; Anne Toulson,20,0,35,15
1657078099288,MATH 109,A01,083213,Ganzberger; Geoffrey Michael,2,0,34,32
1657078099288,MATH 109,A02,083214,Ganzberger; Geoffrey Michael,2,0,34,32
1657078099288,MATH 109,A03,093478,Ganzberger; Geoffrey Michael,1,0,34,33
1657078099288,MATH 109,B01,083215,Ganzberger; Geoffrey Michael,1,0,32,31
1657078099288,MATH 109,B02,083216,Ganzberger; Geoffrey Michael,1,0,32,31
1657078099288,MATH 109,B03,093479,Ganzberger; Geoffrey Michael,6,0,32,26
1657078105312,MATH 142A,A01,083219,Chow; Bennett,6,0,32,26
1657078105312,MATH 142A,A02,083220,Chow; Bennett,10,0,32,22
1657078105312,MATH 142A,A03,093480,Chow; Bennett,7,0,32,25
1657078105312,MATH 142A,B03,093481,Chow; Bennett,8,0,32,24
1657078105312,MATH 142A,B04,093558,Chow; Bennett,11,0,32,21
1657078105312,MATH 142A,B05,093559,Chow; Bennett,6,0,32,26
1657078111336,MATH 193A,A01,083224,Rotar; Vladimir,7,0,34,27
1657078111336,MATH 193A,A02,083225,Rotar; Vladimir,5,0,34,29
1657078111336,MATH 193A,A03,083781,Rotar; Vladimir,1,0,34,33
1657078111336,MATH 193A,A04,083782,Rotar; Vladimir,6,0,34,28
1657078111336,MATH 193A,A05,093482,Rotar; Vladimir,6,0,34,28
1657078117368,MATH 197,001,091859,McAuley; Julian John,9999,0,9999,0
1657078117368,MATH 197,002,095566,Kedlaya; Kiran S.,9997,0,9999,2
1657078117368,MATH 197,003,095567,Xiao; Ming,9999,0,9999,0
1657078117368,MATH 197,004,095571,Perols; Johan Lars,9998,0,9999,1
1657078124434,COGS 9,A01,083615,Shannon; Kyle Michael,7,0,75,68
1657078130457,COGS 11,A01,083617,Boyle; Mary E. T.,21,0,48,27
1657078136485,COGS 13,A01,083071,Bastos; Amalia Pinkusfeld,9,0,71,62
1657078142509,COGS 14A,A01,092681,Semenuks; Arturs,1,1,100,99
1657078148537,COGS 14B,A01,083073,Cheng; Tzu-Han,5,0,63,58
1657078154559,COGS 17,A01,092677,Semenuks; Arturs,4,0,81,77
1657078160585,COGS 100,A01,083619,Allen; Michael Gordon,15,0,70,55
1657078166613,COGS 101A,A01,083621,Davis; Joshua Daniel,9,0,68,59
1657078172638,COGS 101B,A01,091572,Allen; Michael Gordon,8,0,65,57
1657078178663,COGS 101C,A01,083625,Delgado; Tania,17,0,35,18
1657078184689,COGS 107A,A01,083627,Boyle; Mary E. T.,13,0,60,47
1657078190712,COGS 118A,A01,083075,Gupta; Anjum,15,0,76,61
1657078196740,CSE 3,A50,083646,Miranda; Gregory Joseph,22,0,50,28
1657078202764,CSE 8A,A50,083650,Miranda; Gregory Joseph,17,1,56,39
1657078208790,CSE 11,A01,083080,Cao; Yingjun,4,15,40,36
1657078214821,CSE 12,A01,083652,Krause-Levy; Sophia Louisa,23,1,120,97
1657078220844,CSE 15L,A01,083654,Morris; Justin Loren,8,0,50,42
1657078220844,CSE 15L,A02,083655,Morris; Justin Loren,9,0,50,41
1657078226868,CSE 20,A01,083657,Tran; Khoa Dang,37,0,80,43
1657078232896,CSE 21,A01,095574,Bach; Quang Tran,21,0,48,27
1657078238923,CSE 30,A01,083084,Eldon; John,4,0,80,76
1657078238923,CSE 30,B01,095061,Bhaskar; Nishant,6,0,50,44
1657078244947,CSE 100,A01,083659,Cao; Yingjun,3,4,70,67
1657078250975,CSE 134B,A01,083661,Powell; Thomas Allan,19,0,100,81
1657078257001,CSE 140,A01,083663,Gungor; Onat,14,0,85,71
1657078263030,CSE 140L,A01,083088,Eldon; John,16,0,100,84
1657078269056,CSE 175,A01,083665,Kumar; Rakesh,3,0,25,22
1657078275084,CSE 190,A00,092507,Dubnov; Shlomo,7,0,20,13
1657078281106,ECE 45,A01,083139,Congero; Spencer William,5,0,75,70
1657078287134,ECE 65,A50,083695,Saad; Andrew S,12,0,30,18
1657078287134,ECE 65,A51,095125,Saad; Andrew S,25,0,26,1
1657078293156,ECE 109,A01,091882,Touri; Behrouz,16,0,70,54
1657078299180,ECE 180,A00,083140,Abi Samra; Nicholas Camill,1,0,30,29
1657078299180,ECE 180,B00,083141,Abi Samra; Nicholas Camill,0,0,30,30
1657078305204,MATH 10A,A01,083735,Patchell; Gregory David,1,0,30,29
1657078305204,MATH 10A,A02,083736,Patchell; Gregory David,20,0,30,10
1657078305204,MATH 10A,A03,083737,Patchell; Gregory David,16,0,30,14
1657078311229,MATH 10B,A01,083207,Lim; Seonhee,7,0,34,27
1657078311229,MATH 10B,A02,083208,Lim; Seonhee,9,0,35,26
1657078311229,MATH 10B,A03,093472,Lim; Seonhee,4,0,34,30
1657078311229,MATH 10B,B01,083739,Sinha; Shubham,9,0,30,21
1657078317255,MATH 18,A01,083743,Cinel; Cameron Alexander,6,0,30,24
1657078317255,MATH 18,A02,083744,Cinel; Cameron Alexander,15,0,30,15
1657078317255,MATH 18,A03,083745,Cinel; Cameron Alexander,8,0,30,22
1657078317255,MATH 18,B01,083748,Rideout; David Porter,4,0,37,33
1657078317255,MATH 18,B02,083749,Rideout; David Porter,3,0,36,33
1657078317255,MATH 18,B03,083750,Rideout; David Porter,2,0,37,35
1657078317255,MATH 18,B04,083751,Rideout; David Porter,5,0,36,31
1657078317255,MATH 18,B05,093473,Rideout; David Porter,4,0,36,32
1657078317255,MATH 18,B06,093474,Rideout; David Porter,5,0,36,31
1657078323276,MATH 20A,A01,083754,Zheng; Zequn,12,0,40,28
1657078329303,MATH 20B,A01,083756,Briones; Jor-el Thomas Caparas,1,0,36,35
1657078329303,MATH 20B,A02,083757,Briones; Jor-el Thomas Caparas,1,0,36,35
1657078329303,MATH 20B,A03,093475,Briones; Jor-el Thomas Caparas,0,0,36,36
1657078335324,MATH 20C,A01,083760,Briones; Jor-el Thomas Caparas,1,0,35,34
1657078335324,MATH 20C,A02,083761,Briones; Jor-el Thomas Caparas,8,0,35,27
1657078335324,MATH 20C,A03,093476,Briones; Jor-el Thomas Caparas,0,1,36,36
1657078335324,MATH 20C,B01,083762,Bach; Quang Tran,0,0,30,30
1657078341352,MATH 20D,A01,083765,Tran; Brian Kha,4,0,30,26
1657078341352,MATH 20D,A02,083766,Tran; Brian Kha,5,0,30,25
1657078341352,MATH 20D,A03,083767,Tran; Brian Kha,3,0,30,27
1657078347378,MATH 20E,A01,083771,Ganguly; Soumya,5,0,32,27
1657078347378,MATH 20E,A02,083772,Ganguly; Soumya,6,0,32,26
1657078347378,MATH 20E,B01,083773,Ciotti; Benjamin,18,0,35,17
1657078347378,MATH 20E,B02,083774,Ciotti; Benjamin,17,0,35,18
1657078353402,MATH 103A,A01,083777,Greenfeld; Be'Eri,2,0,36,34
1657078353402,MATH 103A,A02,083778,Greenfeld; Be'Eri,5,0,36,31
1657078353402,MATH 103A,A03,093561,Greenfeld; Be'Eri,4,0,36,32
1657078353402,MATH 103A,B01,083779,Greenfeld; Be'Eri,6,0,36,30
1657078353402,MATH 103A,B02,083780,Greenfeld; Be'Eri,2,0,36,34
1657078353402,MATH 103A,B03,093562,Greenfeld; Be'Eri,3,0,36,33
1657078359425,MATH 105,A01,085443,Carter; Anne Toulson,14,0,35,21
1657078359425,MATH 105,A02,093477,Carter; Anne Toulson,20,0,35,15
1657078365454,MATH 109,A01,083213,Ganzberger; Geoffrey Michael,2,0,34,32
1657078365454,MATH 109,A02,083214,Ganzberger; Geoffrey Michael,2,0,34,32
1657078365454,MATH 109,A03,093478,Ganzberger; Geoffrey Michael,1,0,34,33
1657078365454,MATH 109,B01,083215,Ganzberger; Geoffrey Michael,1,0,32,31
1657078365454,MATH 109,B02,083216,Ganzberger; Geoffrey Michael,1,0,32,31
1657078365454,MATH 109,B03,093479,Ganzberger; Geoffrey Michael,6,0,32,26
1657078371478,MATH 142A,A01,083219,Chow; Bennett,6,0,32,26
1657078371478,MATH 142A,A02,083220,Chow; Bennett,10,0,32,22
1657078371478,MATH 142A,A03,093480,Chow; Bennett,7,0,32,25
1657078371478,MATH 142A,B03,093481,Chow; Bennett,8,0,32,24
1657078371478,MATH 142A,B04,093558,Chow; Bennett,11,0,32,21
1657078371478,MATH 142A,B05,093559,Chow; Bennett,6,0,32,26
1657078377502,MATH 193A,A01,083224,Rotar; Vladimir,7,0,34,27
1657078377502,MATH 193A,A02,083225,Rotar; Vladimir,5,0,34,29
1657078377502,MATH 193A,A03,083781,Rotar; Vladimir,1,0,34,33
1657078377502,MATH 193A,A04,083782,Rotar; Vladimir,6,0,34,28
1657078377502,MATH 193A,A05,093482,Rotar; Vladimir,6,0,34,28
1657078383526,MATH 197,001,091859,McAuley; Julian John,9999,0,9999,0
1657078383526,MATH 197,002,095566,Kedlaya; Kiran S.,9997,0,9999,2
1657078383526,MATH 197,003,095567,Xiao; Ming,9999,0,9999,0
1657078383526,MATH 197,004,095571,Perols; Johan Lars,9998,0,9999,1
1657078390574,COGS 9,A01,083615,Shannon; Kyle Michael,7,0,75,68
1657078396599,COGS 11,A01,083617,Boyle; Mary E. T.,21,0,48,27
1657078402627,COGS 13,A01,083071,Bastos; Amalia Pinkusfeld,9,0,71,62
1657078408650,COGS 14A,A01,092681,Semenuks; Arturs,1,1,100,99
1657078414676,COGS 14B,A01,083073,Cheng; Tzu-Han,5,0,63,58
1657078420698,COGS 17,A01,092677,Semenuks; Arturs,4,0,81,77
1657078426734,COGS 100,A01,083619,Allen; Michael Gordon,15,0,70,55
1657078432756,COGS 101A,A01,083621,Davis; Joshua Daniel,9,0,68,59
1657078438782,COGS 101B,A01,091572,Allen; Michael Gordon,8,0,65,57
1657078444806,COGS 101C,A01,083625,Delgado; Tania,17,0,35,18
1657078450837,COGS 107A,A01,083627,Boyle; Mary E. T.,13,0,60,47
1657078456859,COGS 118A,A01,083075,Gupta; Anjum,15,0,76,61
1657078462888,CSE 3,A50,083646,Miranda; Gregory Joseph,22,0,50,28
1657078468911,CSE 8A,A50,083650,Miranda; Gregory Joseph,17,1,56,39
1657078474936,CSE 11,A01,083080,Cao; Yingjun,4,15,40,36
1657078480958,CSE 12,A01,083652,Krause-Levy; Sophia Louisa,23,1,120,97
1657078486985,CSE 15L,A01,083654,Morris; Justin Loren,8,0,50,42
1657078486985,CSE 15L,A02,083655,Morris; Justin Loren,9,0,50,41
1657078493012,CSE 20,A01,083657,Tran; Khoa Dang,37,0,80,43
1657078499033,CSE 21,A01,095574,Bach; Quang Tran,21,0,48,27
1657078505056,CSE 30,A01,083084,Eldon; John,4,0,80,76
1657078505056,CSE 30,B01,095061,Bhaskar; Nishant,6,0,50,44
1657078511082,CSE 100,A01,083659,Cao; Yingjun,3,4,70,67
1657078517107,CSE 134B,A01,083661,Powell; Thomas Allan,19,0,100,81
1657078523130,CSE 140,A01,083663,Gungor; Onat,14,0,85,71
1657078529157,CSE 140L,A01,083088,Eldon; John,16,0,100,84
1657078535179,CSE 175,A01,083665,Kumar; Rakesh,3,0,25,22
1657078541212,CSE 190,A00,092507,Dubnov; Shlomo,7,0,20,13
1657078547239,ECE 45,A01,083139,Congero; Spencer William,5,0,75,70
1657078553261,ECE 65,A50,083695,Saad; Andrew S,12,0,30,18
1657078553261,ECE 65,A51,095125,Saad; Andrew S,25,0,26,1
1657078559377,ECE 109,A01,091882,Touri; Behrouz,16,0,70,54
1657078565398,ECE 180,A00,083140,Abi Samra; Nicholas Camill,1,0,30,29
1657078565398,ECE 180,B00,083141,Abi Samra; Nicholas Camill,0,0,30,30
1657078571426,MATH 10A,A01,083735,Patchell; Gregory David,1,0,30,29
1657078571426,MATH 10A,A02,083736,Patchell; Gregory David,20,0,30,10
1657078571426,MATH 10A,A03,083737,Patchell; Gregory David,16,0,30,14
1657078577455,MATH 10B,A01,083207,Lim; Seonhee,7,0,34,27
1657078577455,MATH 10B,A02,083208,Lim; Seonhee,9,0,35,26
1657078577455,MATH 10B,A03,093472,Lim; Seonhee,4,0,34,30
1657078577455,MATH 10B,B01,083739,Sinha; Shubham,9,0,30,21
1657078583478,MATH 18,A01,083743,Cinel; Cameron Alexander,6,0,30,24
1657078583478,MATH 18,A02,083744,Cinel; Cameron Alexander,15,0,30,15
1657078583478,MATH 18,A03,083745,Cinel; Cameron Alexander,8,0,30,22
1657078583478,MATH 18,B01,083748,Rideout; David Porter,4,0,37,33
1657078583478,MATH 18,B02,083749,Rideout; David Porter,3,0,36,33
1657078583478,MATH 18,B03,083750,Rideout; David Porter,2,0,37,35
1657078583478,MATH 18,B04,083751,Rideout; David Porter,5,0,36,31
1657078583478,MATH 18,B05,093473,Rideout; David Porter,4,0,36,32
1657078583478,MATH 18,B06,093474,Rideout; David Porter,5,0,36,31
1657078589502,MATH 20A,A01,083754,Zheng; Zequn,12,0,40,28
1657078595530,MATH 20B,A01,083756,Briones; Jor-el Thomas Caparas,1,0,36,35
1657078595530,MATH 20B,A02,083757,Briones; Jor-el Thomas Caparas,1,0,36,35
1657078595530,MATH 20B,A03,093475,Briones; Jor-el Thomas Caparas,0,0,36,36
1657078601554,MATH 20C,A01,083760,Briones; Jor-el Thomas Caparas,1,0,35,34
1657078601554,MATH 20C,A02,083761,Briones; Jor-el Thomas Caparas,8,0,35,27
1657078601554,MATH 20C,A03,093476,Briones; Jor-el Thomas Caparas,0,1,36,36
1657078601554,MATH 20C,B01,083762,Bach; Quang Tran,0,0,30,30
1657078607581,MATH 20D,A01,083765,Tran; Brian Kha,4,0,30,26
1657078607581,MATH 20D,A02,083766,Tran; Brian Kha,5,0,30,25
1657078607581,MATH 20D,A03,083767,Tran; Brian Kha,3,0,30,27
1657078613604,MATH 20E,A01,083771,Ganguly; Soumya,5,0,32,27
1657078613604,MATH 20E,A02,083772,Ganguly; Soumya,6,0,32,26
1657078613604,MATH 20E,B01,083773,Ciotti; Benjamin,18,0,35,17
1657078613604,MATH 20E,B02,083774,Ciotti; Benjamin,17,0,35,18
1657078619634,MATH 103A,A01,083777,Greenfeld; Be'Eri,2,0,36,34
1657078619634,MATH 103A,A02,083778,Greenfeld; Be'Eri,5,0,36,31
1657078619634,MATH 103A,A03,093561,Greenfeld; Be'Eri,4,0,36,32
1657078619634,MATH 103A,B01,083779,Greenfeld; Be'Eri,6,0,36,30
1657078619634,MATH 103A,B02,083780,Greenfeld; Be'Eri,2,0,36,34
1657078619634,MATH 103A,B03,093562,Greenfeld; Be'Eri,3,0,36,33
1657078625658,MATH 105,A01,085443,Carter; Anne Toulson,14,0,35,21
1657078625658,MATH 105,A02,093477,Carter; Anne Toulson,20,0,35,15
1657078631687,MATH 109,A01,083213,Ganzberger; Geoffrey Michael,2,0,34,32
1657078631687,MATH 109,A02,083214,Ganzberger; Geoffrey Michael,2,0,34,32
1657078631687,MATH 109,A03,093478,Ganzberger; Geoffrey Michael,1,0,34,33
1657078631687,MATH 109,B01,083215,Ganzberger; Geoffrey Michael,1,0,32,31
1657078631687,MATH 109,B02,083216,Ganzberger; Geoffrey Michael,1,0,32,31
1657078631687,MATH 109,B03,093479,Ganzberger; Geoffrey Michael,6,0,32,26
1657078637711,MATH 142A,A01,083219,Chow; Bennett,6,0,32,26
1657078637711,MATH 142A,A02,083220,Chow; Bennett,10,0,32,22
1657078637711,MATH 142A,A03,093480,Chow; Bennett,7,0,32,25
1657078637711,MATH 142A,B03,093481,Chow; Bennett,8,0,32,24
1657078637711,MATH 142A,B04,093558,Chow; Bennett,11,0,32,21
1657078637711,MATH 142A,B05,093559,Chow; Bennett,6,0,32,26
1657078643741,MATH 193A,A01,083224,Rotar; Vladimir,7,0,34,27
1657078643741,MATH 193A,A02,083225,Rotar; Vladimir,5,0,34,29
1657078643741,MATH 193A,A03,083781,Rotar; Vladimir,1,0,34,33
1657078643741,MATH 193A,A04,083782,Rotar; Vladimir,6,0,34,28
1657078643741,MATH 193A,A05,093482,Rotar; Vladimir,6,0,34,28
1657078649764,MATH 197,001,091859,McAuley; Julian John,9999,0,9999,0
1657078649764,MATH 197,002,095566,Kedlaya; Kiran S.,9997,0,9999,2
1657078649764,MATH 197,003,095567,Xiao; Ming,9999,0,9999,0
1657078649764,MATH 197,004,095571,Perols; Johan Lars,9998,0,9999,1
1657078656826,COGS 9,A01,083615,Shannon; Kyle Michael,7,0,75,68
1657078662849,COGS 11,A01,083617,Boyle; Mary E. T.,21,0,48,27
1657078668874,COGS 13,A01,083071,Bastos; Amalia Pinkusfeld,9,0,71,62
1657078674897,COGS 14A,A01,092681,Semenuks; Arturs,1,1,100,99
1657078680920,COGS 14B,A01,083073,Cheng; Tzu-Han,5,0,63,58
1657078686958,COGS 17,A01,092677,Semenuks; Arturs,4,0,81,77
1657078692980,COGS 100,A01,083619,Allen; Michael Gordon,15,0,70,55
1657078699006,COGS 101A,A01,083621,Davis; Joshua Daniel,9,0,68,59
1657078705029,COGS 101B,A01,091572,Allen; Michael Gordon,8,0,65,57
1657078711054,COGS 101C,A01,083625,Delgado; Tania,17,0,35,18
1657078717077,COGS 107A,A01,083627,Boyle; Mary E. T.,13,0,60,47
1657078723106,COGS 118A,A01,083075,Gupta; Anjum,15,0,76,61
1657078729128,CSE 3,A50,083646,Miranda; Gregory Joseph,22,0,50,28
1657078735155,CSE 8A,A50,083650,Miranda; Gregory Joseph,17,1,56,39
1657078741180,CSE 11,A01,083080,Cao; Yingjun,4,15,40,36
1657078747209,CSE 12,A01,083652,Krause-Levy; Sophia Louisa,23,1,120,97
1657078753232,CSE 15L,A01,083654,Morris; Justin Loren,8,0,50,42
1657078753232,CSE 15L,A02,083655,Morris; Justin Loren,9,0,50,41
1657078759255,CSE 20,A01,083657,Tran; Khoa Dang,37,0,80,43
1657078765292,CSE 21,A01,095574,Bach; Quang Tran,21,0,48,27
1657078771316,CSE 30,A01,083084,Eldon; John,4,0,80,76
1657078771316,CSE 30,B01,095061,Bhaskar; Nishant,6,0,50,44
1657078777339,CSE 100,A01,083659,Cao; Yingjun,3,4,70,67
1657078783366,CSE 134B,A01,083661,Powell; Thomas Allan,19,0,100,81
1657078789389,CSE 140,A01,083663,Gungor; Onat,14,0,85,71
1657078795412,CSE 140L,A01,083088,Eldon; John,16,0,100,84
1657078801438,CSE 175,A01,083665,Kumar; Rakesh,3,0,25,22
1657078807462,CSE 190,A00,092507,Dubnov; Shlomo,7,0,20,13
1657078813491,ECE 45,A01,083139,Congero; Spencer William,5,0,75,70
1657078819514,ECE 65,A50,083695,Saad; Andrew S,12,0,30,18
1657078819514,ECE 65,A51,095125,Saad; Andrew S,25,0,26,1
1657078825536,ECE 109,A01,091882,Touri; Behrouz,16,0,70,54
1657078831561,ECE 180,A00,083140,Abi Samra; Nicholas Camill,1,0,30,29
1657078831561,ECE 180,B00,083141,Abi Samra; Nicholas Camill,0,0,30,30
1657078837583,MATH 10A,A01,083735,Patchell; Gregory David,1,0,30,29
1657078837583,MATH 10A,A02,083736,Patchell; Gregory David,20,0,30,10
1657078837583,MATH 10A,A03,083737,Patchell; Gregory David,16,0,30,14
1657078843618,MATH 10B,A01,083207,Lim; Seonhee,7,0,34,27
1657078843618,MATH 10B,A02,083208,Lim; Seonhee,9,0,35,26
1657078843618,MATH 10B,A03,093472,Lim; Seonhee,4,0,34,30
1657078843618,MATH 10B,B01,083739,Sinha; Shubham,9,0,30,21
1657078849642,MATH 18,A01,083743,Cinel; Cameron Alexander,6,0,30,24
1657078849642,MATH 18,A02,083744,Cinel; Cameron Alexander,15,0,30,15
1657078849642,MATH 18,A03,083745,Cinel; Cameron Alexander,8,0,30,22
1657078849642,MATH 18,B01,083748,Rideout; David Porter,4,0,37,33
1657078849642,MATH 18,B02,083749,Rideout; David Porter,3,0,36,33
1657078849642,MATH 18,B03,083750,Rideout; David Porter,2,0,37,35
1657078849642,MATH 18,B04,083751,Rideout; David Porter,5,0,36,31
1657078849642,MATH 18,B05,093473,Rideout; David Porter,4,0,36,32
1657078849642,MATH 18,B06,093474,Rideout; David Porter,5,0,36,31
1657078855663,MATH 20A,A01,083754,Zheng; Zequn,12,0,40,28
1657078861688,MATH 20B,A01,083756,Briones; Jor-el Thomas Caparas,1,0,36,35
1657078861688,MATH 20B,A02,083757,Briones; Jor-el Thomas Caparas,1,0,36,35
1657078861688,MATH 20B,A03,093475,Briones; Jor-el Thomas Caparas,0,0,36,36
1657078867709,MATH 20C,A01,083760,Briones; Jor-el Thomas Caparas,1,0,35,34
1657078867709,MATH 20C,A02,083761,Briones; Jor-el Thomas Caparas,8,0,35,27
1657078867709,MATH 20C,A03,093476,Briones; Jor-el Thomas Caparas,0,1,36,36
1657078867709,MATH 20C,B01,083762,Bach; Quang Tran,0,0,30,30
1657078873737,MATH 20D,A01,083765,Tran; Brian Kha,4,0,30,26
1657078873737,MATH 20D,A02,083766,Tran; Brian Kha,5,0,30,25
1657078873737,MATH 20D,A03,083767,Tran; Brian Kha,3,0,30,27
1657078879761,MATH 20E,A01,083771,Ganguly; Soumya,5,0,32,27
1657078879761,MATH 20E,A02,083772,Ganguly; Soumya,6,0,32,26
1657078879761,MATH 20E,B01,083773,Ciotti; Benjamin,18,0,35,17
1657078879761,MATH 20E,B02,083774,Ciotti; Benjamin,17,0,35,18
1657078885793,MATH 103A,A01,083777,Greenfeld; Be'Eri,2,0,36,34
1657078885793,MATH 103A,A02,083778,Greenfeld; Be'Eri,5,0,36,31
1657078885793,MATH 103A,A03,093561,Greenfeld; Be'Eri,4,0,36,32
1657078885793,MATH 103A,B01,083779,Greenfeld; Be'Eri,6,0,36,30
1657078885793,MATH 103A,B02,083780,Greenfeld; Be'Eri,2,0,36,34
1657078885793,MATH 103A,B03,093562,Greenfeld; Be'Eri,3,0,36,33
1657078891816,MATH 105,A01,085443,Carter; Anne Toulson,14,0,35,21
1657078891816,MATH 105,A02,093477,Carter; Anne Toulson,20,0,35,15
1657078897843,MATH 109,A01,083213,Ganzberger; Geoffrey Michael,2,0,34,32
1657078897843,MATH 109,A02,083214,Ganzberger; Geoffrey Michael,2,0,34,32
1657078897843,MATH 109,A03,093478,Ganzberger; Geoffrey Michael,1,0,34,33
1657078897843,MATH 109,B01,083215,Ganzberger; Geoffrey Michael,1,0,32,31
1657078897843,MATH 109,B02,083216,Ganzberger; Geoffrey Michael,1,0,32,31
1657078897843,MATH 109,B03,093479,Ganzberger; Geoffrey Michael,6,0,32,26
1657078903872,MATH 142A,A01,083219,Chow; Bennett,6,0,32,26
1657078903872,MATH 142A,A02,083220,Chow; Bennett,10,0,32,22
1657078903872,MATH 142A,A03,093480,Chow; Bennett,7,0,32,25
1657078903872,MATH 142A,B03,093481,Chow; Bennett,8,0,32,24
1657078903872,MATH 142A,B04,093558,Chow; Bennett,11,0,32,21
1657078903872,MATH 142A,B05,093559,Chow; Bennett,6,0,32,26
1657078909908,MATH 193A,A01,083224,Rotar; Vladimir,7,0,34,27
1657078909908,MATH 193A,A02,083225,Rotar; Vladimir,5,0,34,29
1657078909908,MATH 193A,A03,083781,Rotar; Vladimir,1,0,34,33
1657078909908,MATH 193A,A04,083782,Rotar; Vladimir,6,0,34,28
1657078909908,MATH 193A,A05,093482,Rotar; Vladimir,6,0,34,28
1657078915934,MATH 197,001,091859,McAuley; Julian John,9999,0,9999,0
1657078915934,MATH 197,002,095566,Kedlaya; Kiran S.,9997,0,9999,2
1657078915934,MATH 197,003,095567,Xiao; Ming,9999,0,9999,0
1657078915934,MATH 197,004,095571,Perols; Johan Lars,9998,0,9999,1
1657078922989,COGS 9,A01,083615,Shannon; Kyle Michael,7,0,75,68
1657078929017,COGS 11,A01,083617,Boyle; Mary E. T.,21,0,48,27
1657078935043,COGS 13,A01,083071,Bastos; Amalia Pinkusfeld,9,0,71,62
1657078941067,COGS 14A,A01,092681,Semenuks; Arturs,1,1,100,99
1657078947092,COGS 14B,A01,083073,Cheng; Tzu-Han,5,0,63,58
1657078953118,COGS 17,A01,092677,Semenuks; Arturs,4,0,81,77
1657078959144,COGS 100,A01,083619,Allen; Michael Gordon,15,0,70,55
1657078965167,COGS 101A,A01,083621,Davis; Joshua Daniel,9,0,68,59
1657078971191,COGS 101B,A01,091572,Allen; Michael Gordon,8,0,65,57
1657078977214,COGS 101C,A01,083625,Delgado; Tania,17,0,35,18
1657078983237,COGS 107A,A01,083627,Boyle; Mary E. T.,13,0,60,47
1657078989259,COGS 118A,A01,083075,Gupta; Anjum,15,0,76,61
1657078995282,CSE 3,A50,083646,Miranda; Gregory Joseph,22,0,50,28
1657079001309,CSE 8A,A50,083650,Miranda; Gregory Joseph,17,1,56,39
1657079007337,CSE 11,A01,083080,Cao; Yingjun,4,15,40,36
1657079013367,CSE 12,A01,083652,Krause-Levy; Sophia Louisa,23,1,120,97
1657079019390,CSE 15L,A01,083654,Morris; Justin Loren,8,0,50,42
1657079019390,CSE 15L,A02,083655,Morris; Justin Loren,9,0,50,41
1657079025415,CSE 20,A01,083657,Tran; Khoa Dang,37,0,80,43
1657079031438,CSE 21,A01,095574,Bach; Quang Tran,21,0,48,27
1657079037461,CSE 30,A01,083084,Eldon; John,4,0,80,76
1657079037461,CSE 30,B01,095061,Bhaskar; Nishant,6,0,50,44
1657079043487,CSE 100,A01,083659,Cao; Yingjun,3,4,70,67
1657079049512,CSE 134B,A01,083661,Powell; Thomas Allan,19,0,100,81
1657079055535,CSE 140,A01,083663,Gungor; Onat,14,0,85,71
1657079061561,CSE 140L,A01,083088,Eldon; John,16,0,100,84
1657079067590,CSE 175,A01,083665,Kumar; Rakesh,3,0,25,22
1657079073618,CSE 190,A00,092507,Dubnov; Shlomo,7,0,20,13
1657079079641,ECE 45,A01,083139,Congero; Spencer William,5,0,75,70
1657079085668,ECE 65,A50,083695,Saad; Andrew S,12,0,30,18
1657079085668,ECE 65,A51,095125,Saad; Andrew S,25,0,26,1
1657079091695,ECE 109,A01,091882,Touri; Behrouz,16,0,70,54
1657079097717,ECE 180,A00,083140,Abi Samra; Nicholas Camill,1,0,30,29
1657079097717,ECE 180,B00,083141,Abi Samra; Nicholas Camill,0,0,30,30
1657079103744,MATH 10A,A01,083735,Patchell; Gregory David,1,0,30,29
1657079103744,MATH 10A,A02,083736,Patchell; Gregory David,20,0,30,10
1657079103744,MATH 10A,A03,083737,Patchell; Gregory David,16,0,30,14
1657079109767,MATH 10B,A01,083207,Lim; Seonhee,7,0,34,27
1657079109767,MATH 10B,A02,083208,Lim; Seonhee,9,0,35,26
1657079109767,MATH 10B,A03,093472,Lim; Seonhee,4,0,34,30
1657079109767,MATH 10B,B01,083739,Sinha; Shubham,9,0,30,21
1657079115792,MATH 18,A01,083743,Cinel; Cameron Alexander,6,0,30,24
1657079115792,MATH 18,A02,083744,Cinel; Cameron Alexander,15,0,30,15
1657079115792,MATH 18,A03,083745,Cinel; Cameron Alexander,8,0,30,22
1657079115792,MATH 18,B01,083748,Rideout; David Porter,4,0,37,33
1657079115792,MATH 18,B02,083749,Rideout; David Porter,3,0,36,33
1657079115792,MATH 18,B03,083750,Rideout; David Porter,2,0,37,35
1657079115792,MATH 18,B04,083751,Rideout; David Porter,5,0,36,31
1657079115792,MATH 18,B05,093473,Rideout; David Porter,4,0,36,32
1657079115792,MATH 18,B06,093474,Rideout; David Porter,5,0,36,31
1657079121820,MATH 20A,A01,083754,Zheng; Zequn,12,0,40,28
1657079127848,MATH 20B,A01,083756,Briones; Jor-el Thomas Caparas,1,0,36,35
1657079127848,MATH 20B,A02,083757,Briones; Jor-el Thomas Caparas,1,0,36,35
1657079127848,MATH 20B,A03,093475,Briones; Jor-el Thomas Caparas,0,0,36,36
1657079133874,MATH 20C,A01,083760,Briones; Jor-el Thomas Caparas,1,0,35,34
1657079133874,MATH 20C,A02,083761,Briones; Jor-el Thomas Caparas,8,0,35,27
1657079133874,MATH 20C,A03,093476,Briones; Jor-el Thomas Caparas,0,1,36,36
1657079133874,MATH 20C,B01,083762,Bach; Quang Tran,0,0,30,30
1657079139899,MATH 20D,A01,083765,Tran; Brian Kha,4,0,30,26
1657079139899,MATH 20D,A02,083766,Tran; Brian Kha,5,0,30,25
1657079139899,MATH 20D,A03,083767,Tran; Brian Kha,3,0,30,27
1657079145925,MATH 20E,A01,083771,Ganguly; Soumya,5,0,32,27
1657079145925,MATH 20E,A02,083772,Ganguly; Soumya,6,0,32,26
1657079145925,MATH 20E,B01,083773,Ciotti; Benjamin,18,0,35,17
1657079145925,MATH 20E,B02,083774,Ciotti; Benjamin,17,0,35,18
1657079151953,MATH 103A,A01,083777,Greenfeld; Be'Eri,2,0,36,34
1657079151953,MATH 103A,A02,083778,Greenfeld; Be'Eri,5,0,36,31
1657079151953,MATH 103A,A03,093561,Greenfeld; Be'Eri,4,0,36,32
1657079151953,MATH 103A,B01,083779,Greenfeld; Be'Eri,6,0,36,30
1657079151953,MATH 103A,B02,083780,Greenfeld; Be'Eri,2,0,36,34
1657079151953,MATH 103A,B03,093562,Greenfeld; Be'Eri,3,0,36,33
1657079158060,MATH 105,A01,085443,Carter; Anne Toulson,14,0,35,21
1657079158060,MATH 105,A02,093477,Carter; Anne Toulson,20,0,35,15
1657079164083,MATH 109,A01,083213,Ganzberger; Geoffrey Michael,2,0,34,32
1657079164083,MATH 109,A02,083214,Ganzberger; Geoffrey Michael,2,0,34,32
1657079164083,MATH 109,A03,093478,Ganzberger; Geoffrey Michael,1,0,34,33
1657079164083,MATH 109,B01,083215,Ganzberger; Geoffrey Michael,1,0,32,31
1657079164083,MATH 109,B02,083216,Ganzberger; Geoffrey Michael,1,0,32,31
1657079164083,MATH 109,B03,093479,Ganzberger; Geoffrey Michael,6,0,32,26
1657079170105,MATH 142A,A01,083219,Chow; Bennett,6,0,32,26
1657079170105,MATH 142A,A02,083220,Chow; Bennett,10,0,32,22
1657079170105,MATH 142A,A03,093480,Chow; Bennett,7,0,32,25
1657079170105,MATH 142A,B03,093481,Chow; Bennett,8,0,32,24
1657079170105,MATH 142A,B04,093558,Chow; Bennett,11,0,32,21
1657079170105,MATH 142A,B05,093559,Chow; Bennett,6,0,32,26
1657079176130,MATH 193A,A01,083224,Rotar; Vladimir,7,0,34,27
1657079176130,MATH 193A,A02,083225,Rotar; Vladimir,5,0,34,29
1657079176130,MATH 193A,A03,083781,Rotar; Vladimir,1,0,34,33
1657079176130,MATH 193A,A04,083782,Rotar; Vladimir,6,0,34,28
1657079176130,MATH 193A,A05,093482,Rotar; Vladimir,6,0,34,28
1657079182152,MATH 197,001,091859,McAuley; Julian John,9999,0,9999,0
1657079182152,MATH 197,002,095566,Kedlaya; Kiran S.,9997,0,9999,2
1657079182152,MATH 197,003,095567,Xiao; Ming,9999,0,9999,0
1657079182152,MATH 197,004,095571,Perols; Johan Lars,9998,0,9999,1
1657079189209,COGS 9,A01,083615,Shannon; Kyle Michael,7,0,75,68
1657079195233,COGS 11,A01,083617,Boyle; Mary E. T.,21,0,48,27
1657079201256,COGS 13,A01,083071,Bastos; Amalia Pinkusfeld,9,0,71,62
1657079207279,COGS 14A,A01,092681,Semenuks; Arturs,1,1,100,99
1657079213301,COGS 14B,A01,083073,Cheng; Tzu-Han,5,0,63,58
1657079219324,COGS 17,A01,092677,Semenuks; Arturs,4,0,81,77
1657079225351,COGS 100,A01,083619,Allen; Michael Gordon,15,0,70,55
1657079231374,COGS 101A,A01,083621,Davis; Joshua Daniel,9,0,68,59
1657079237398,COGS 101B,A01,091572,Allen; Michael Gordon,8,0,65,57
1657079243420,COGS 101C,A01,083625,Delgado; Tania,17,0,35,18
1657079249445,COGS 107A,A01,083627,Boyle; Mary E. T.,13,0,60,47
1657079255468,COGS 118A,A01,083075,Gupta; Anjum,15,0,76,61
1657079261496,CSE 3,A50,083646,Miranda; Gregory Joseph,22,0,50,28
1657079267534,CSE 8A,A50,083650,Miranda; Gregory Joseph,17,1,56,39
1657079273560,CSE 11,A01,083080,Cao; Yingjun,4,15,40,36
1657079279587,CSE 12,A01,083652,Krause-Levy; Sophia Louisa,23,1,120,97
1657079285610,CSE 15L,A01,083654,Morris; Justin Loren,8,0,50,42
1657079285610,CSE 15L,A02,083655,Morris; Justin Loren,9,0,50,41
1657079291636,CSE 20,A01,083657,Tran; Khoa Dang,37,0,80,43
1657079297658,CSE 21,A01,095574,Bach; Quang Tran,21,0,48,27
1657079303681,CSE 30,A01,083084,Eldon; John,4,0,80,76
1657079303681,CSE 30,B01,095061,Bhaskar; Nishant,6,0,50,44
1657079309702,CSE 100,A01,083659,Cao; Yingjun,3,4,70,67
1657079315731,CSE 134B,A01,083661,Powell; Thomas Allan,19,0,100,81
1657079321753,CSE 140,A01,083663,Gungor; Onat,14,0,85,71
1657079327785,CSE 140L,A01,083088,Eldon; John,16,0,100,84
1657079333812,CSE 175,A01,083665,Kumar; Rakesh,3,0,25,22
1657079339834,CSE 190,A00,092507,Dubnov; Shlomo,7,0,20,13
1657079345858,ECE 45,A01,083139,Congero; Spencer William,5,0,75,70
1657079351881,ECE 65,A50,083695,Saad; Andrew S,12,0,30,18
1657079351881,ECE 65,A51,095125,Saad; Andrew S,25,0,26,1
1657079357908,ECE 109,A01,091882,Touri; Behrouz,16,0,70,54
1657079363931,ECE 180,A00,083140,Abi Samra; Nicholas Camill,1,0,30,29
1657079363931,ECE 180,B00,083141,Abi Samra; Nicholas Camill,0,0,30,30
1657079369955,MATH 10A,A01,083735,Patchell; Gregory David,1,0,30,29
1657079369955,MATH 10A,A02,083736,Patchell; Gregory David,20,0,30,10
1657079369955,MATH 10A,A03,083737,Patchell; Gregory David,16,0,30,14
1657079375979,MATH 10B,A01,083207,Lim; Seonhee,7,0,34,27
1657079375979,MATH 10B,A02,083208,Lim; Seonhee,9,0,35,26
1657079375979,MATH 10B,A03,093472,Lim; Seonhee,4,0,34,30
1657079375979,MATH 10B,B01,083739,Sinha; Shubham,9,0,30,21
1657079382004,MATH 18,A01,083743,Cinel; Cameron Alexander,6,0,30,24
1657079382004,MATH 18,A02,083744,Cinel; Cameron Alexander,15,0,30,15
1657079382004,MATH 18,A03,083745,Cinel; Cameron Alexander,8,0,30,22
1657079382004,MATH 18,B01,083748,Rideout; David Porter,4,0,37,33
1657079382004,MATH 18,B02,083749,Rideout; David Porter,3,0,36,33
1657079382004,MATH 18,B03,083750,Rideout; David Porter,2,0,37,35
1657079382004,MATH 18,B04,083751,Rideout; David Porter,5,0,36,31
1657079382004,MATH 18,B05,093473,Rideout; David Porter,4,0,36,32
1657079382004,MATH 18,B06,093474,Rideout; David Porter,5,0,36,31
1657079388031,MATH 20A,A01,083754,Zheng; Zequn,12,0,40,28
1657079394060,MATH 20B,A01,083756,Briones; Jor-el Thomas Caparas,1,0,36,35
1657079394060,MATH 20B,A02,083757,Briones; Jor-el Thomas Caparas,1,0,36,35
1657079394060,MATH 20B,A03,093475,Briones; Jor-el Thomas Caparas,0,0,36,36
1657079400089,MATH 20C,A01,083760,Briones; Jor-el Thomas Caparas,1,0,35,34
1657079400089,MATH 20C,A02,083761,Briones; Jor-el Thomas Caparas,8,0,35,27
1657079400089,MATH 20C,A03,093476,Briones; Jor-el Thomas Caparas,0,1,36,36
1657079400089,MATH 20C,B01,083762,Bach; Quang Tran,0,0,30,30
1657079406114,MATH 20D,A01,083765,Tran; Brian Kha,4,0,30,26
1657079406114,MATH 20D,A02,083766,Tran; Brian Kha,5,0,30,25
1657079406114,MATH 20D,A03,083767,Tran; Brian Kha,3,0,30,27
1657079412139,MATH 20E,A01,083771,Ganguly; Soumya,5,0,32,27
1657079412139,MATH 20E,A02,083772,Ganguly; Soumya,6,0,32,26
1657079412139,MATH 20E,B01,083773,Ciotti; Benjamin,18,0,35,17
1657079412139,MATH 20E,B02,083774,Ciotti; Benjamin,17,0,35,18
1657079418169,MATH 103A,A01,083777,Greenfeld; Be'Eri,2,0,36,34
1657079418169,MATH 103A,A02,083778,Greenfeld; Be'Eri,5,0,36,31
1657079418169,MATH 103A,A03,093561,Greenfeld; Be'Eri,4,0,36,32
1657079418169,MATH 103A,B01,083779,Greenfeld; Be'Eri,6,0,36,30
1657079418169,MATH 103A,B02,083780,Greenfeld; Be'Eri,2,0,36,34
1657079418169,MATH 103A,B03,093562,Greenfeld; Be'Eri,3,0,36,33
1657079424196,MATH 105,A01,085443,Carter; Anne Toulson,14,0,35,21
1657079424196,MATH 105,A02,093477,Carter; Anne Toulson,20,0,35,15
1657079430226,MATH 109,A01,083213,Ganzberger; Geoffrey Michael,2,0,34,32
1657079430226,MATH 109,A02,083214,Ganzberger; Geoffrey Michael,2,0,34,32
1657079430226,MATH 109,A03,093478,Ganzberger; Geoffrey Michael,1,0,34,33
1657079430226,MATH 109,B01,083215,Ganzberger; Geoffrey Michael,1,0,32,31
1657079430226,MATH 109,B02,083216,Ganzberger; Geoffrey Michael,1,0,32,31
1657079430226,MATH 109,B03,093479,Ganzberger; Geoffrey Michael,6,0,32,26
1657079436250,MATH 142A,A01,083219,Chow; Bennett,6,0,32,26
1657079436250,MATH 142A,A02,083220,Chow; Bennett,10,0,32,22
1657079436250,MATH 142A,A03,093480,Chow; Bennett,7,0,32,25
1657079436250,MATH 142A,B03,093481,Chow; Bennett,8,0,32,24
1657079436250,MATH 142A,B04,093558,Chow; Bennett,11,0,32,21
1657079436250,MATH 142A,B05,093559,Chow; Bennett,6,0,32,26
1657079442279,MATH 193A,A01,083224,Rotar; Vladimir,7,0,34,27
1657079442279,MATH 193A,A02,083225,Rotar; Vladimir,5,0,34,29
1657079442279,MATH 193A,A03,083781,Rotar; Vladimir,1,0,34,33
1657079442279,MATH 193A,A04,083782,Rotar; Vladimir,6,0,34,28
1657079442279,MATH 193A,A05,093482,Rotar; Vladimir,6,0,34,28
1657079448302,MATH 197,001,091859,McAuley; Julian John,9999,0,9999,0
1657079448302,MATH 197,002,095566,Kedlaya; Kiran S.,9997,0,9999,2
1657079448302,MATH 197,003,095567,Xiao; Ming,9999,0,9999,0
1657079448302,MATH 197,004,095571,Perols; Johan Lars,9998,0,9999,1
1657079455372,COGS 9,A01,083615,Shannon; Kyle Michael,7,0,75,68
1657079461397,COGS 11,A01,083617,Boyle; Mary E. T.,21,0,48,27
1657079467421,COGS 13,A01,083071,Bastos; Amalia Pinkusfeld,9,0,71,62
1657079473447,COGS 14A,A01,092681,Semenuks; Arturs,1,1,100,99
1657079479470,COGS 14B,A01,083073,Cheng; Tzu-Han,5,0,63,58
1657079485495,COGS 17,A01,092677,Semenuks; Arturs,4,0,81,77
1657079491530,COGS 100,A01,083619,Allen; Michael Gordon,15,0,70,55
1657079497558,COGS 101A,A01,083621,Davis; Joshua Daniel,9,0,68,59
1657079503580,COGS 101B,A01,091572,Allen; Michael Gordon,8,0,65,57
1657079509603,COGS 101C,A01,083625,Delgado; Tania,17,0,35,18
1657079515625,COGS 107A,A01,083627,Boyle; Mary E. T.,13,0,60,47
1657079521649,COGS 118A,A01,083075,Gupta; Anjum,15,0,76,61
1657079527675,CSE 3,A50,083646,Miranda; Gregory Joseph,22,0,50,28
1657079533697,CSE 8A,A50,083650,Miranda; Gregory Joseph,17,1,56,39
1657079539719,CSE 11,A01,083080,Cao; Yingjun,4,15,40,36
1657079545745,CSE 12,A01,083652,Krause-Levy; Sophia Louisa,23,1,120,97
1657079551767,CSE 15L,A01,083654,Morris; Justin Loren,8,0,50,42
1657079551767,CSE 15L,A02,083655,Morris; Justin Loren,9,0,50,41
1657079557789,CSE 20,A01,083657,Tran; Khoa Dang,37,0,80,43
1657079563810,CSE 21,A01,095574,Bach; Quang Tran,21,0,48,27
1657079569835,CSE 30,A01,083084,Eldon; John,4,0,80,76
1657079569835,CSE 30,B01,095061,Bhaskar; Nishant,6,0,50,44
1657079575860,CSE 100,A01,083659,Cao; Yingjun,3,4,70,67
1657079581887,CSE 134B,A01,083661,Powell; Thomas Allan,19,0,100,81
1657079587911,CSE 140,A01,083663,Gungor; Onat,14,0,85,71
1657079593934,CSE 140L,A01,083088,Eldon; John,16,0,100,84
1657079599956,CSE 175,A01,083665,Kumar; Rakesh,3,0,25,22
1657079605979,CSE 190,A00,092507,Dubnov; Shlomo,7,0,20,13
1657079612008,ECE 45,A01,083139,Congero; Spencer William,5,0,75,70
1657079618035,ECE 65,A50,083695,Saad; Andrew S,12,0,30,18
1657079618035,ECE 65,A51,095125,Saad; Andrew S,25,0,26,1
1657079624062,ECE 109,A01,091882,Touri; Behrouz,16,0,70,54
1657079630089,ECE 180,A00,083140,Abi Samra; Nicholas Camill,1,0,30,29
1657079630089,ECE 180,B00,083141,Abi Samra; Nicholas Camill,0,0,30,30
1657079636118,MATH 10A,A01,083735,Patchell; Gregory David,1,0,30,29
1657079636118,MATH 10A,A02,083736,Patchell; Gregory David,20,0,30,10
1657079636118,MATH 10A,A03,083737,Patchell; Gregory David,16,0,30,14
1657079642148,MATH 10B,A01,083207,Lim; Seonhee,7,0,34,27
1657079642148,MATH 10B,A02,083208,Lim; Seonhee,9,0,35,26
1657079642148,MATH 10B,A03,093472,Lim; Seonhee,4,0,34,30
1657079642148,MATH 10B,B01,083739,Sinha; Shubham,9,0,30,21
1657079648173,MATH 18,A01,083743,Cinel; Cameron Alexander,6,0,30,24
1657079648173,MATH 18,A02,083744,Cinel; Cameron Alexander,15,0,30,15
1657079648173,MATH 18,A03,083745,Cinel; Cameron Alexander,8,0,30,22
1657079648173,MATH 18,B01,083748,Rideout; David Porter,4,0,37,33
1657079648173,MATH 18,B02,083749,Rideout; David Porter,3,0,36,33
1657079648173,MATH 18,B03,083750,Rideout; David Porter,2,0,37,35
1657079648173,MATH 18,B04,083751,Rideout; David Porter,5,0,36,31
1657079648173,MATH 18,B05,093473,Rideout; David Porter,4,0,36,32
1657079648173,MATH 18,B06,093474,Rideout; David Porter,5,0,36,31
1657079654200,MATH 20A,A01,083754,Zheng; Zequn,12,0,40,28
1657079660224,MATH 20B,A01,083756,Briones; Jor-el Thomas Caparas,1,0,36,35
1657079660224,MATH 20B,A02,083757,Briones; Jor-el Thomas Caparas,1,0,36,35
1657079660224,MATH 20B,A03,093475,Briones; Jor-el Thomas Caparas,0,0,36,36
1657079666264,MATH 20C,A01,083760,Briones; Jor-el Thomas Caparas,1,0,35,34
1657079666264,MATH 20C,A02,083761,Briones; Jor-el Thomas Caparas,8,0,35,27
1657079666264,MATH 20C,A03,093476,Briones; Jor-el Thomas Caparas,0,1,36,36
1657079666264,MATH 20C,B01,083762,Bach; Quang Tran,0,0,30,30
1657079672290,MATH 20D,A01,083765,Tran; Brian Kha,4,0,30,26
1657079672290,MATH 20D,A02,083766,Tran; Brian Kha,5,0,30,25
1657079672290,MATH 20D,A03,083767,Tran; Brian Kha,3,0,30,27
1657079678315,MATH 20E,A01,083771,Ganguly; Soumya,5,0,32,27
1657079678315,MATH 20E,A02,083772,Ganguly; Soumya,6,0,32,26
1657079678315,MATH 20E,B01,083773,Ciotti; Benjamin,18,0,35,17
1657079678315,MATH 20E,B02,083774,Ciotti; Benjamin,17,0,35,18
1657079684339,MATH 103A,A01,083777,Greenfeld; Be'Eri,2,0,36,34
1657079684339,MATH 103A,A02,083778,Greenfeld; Be'Eri,5,0,36,31
1657079684339,MATH 103A,A03,093561,Greenfeld; Be'Eri,4,0,36,32
1657079684339,MATH 103A,B01,083779,Greenfeld; Be'Eri,6,0,36,30
1657079684339,MATH 103A,B02,083780,Greenfeld; Be'Eri,2,0,36,34
1657079684339,MATH 103A,B03,093562,Greenfeld; Be'Eri,3,0,36,33
1657079690362,MATH 105,A01,085443,Carter; Anne Toulson,14,0,35,21
1657079690362,MATH 105,A02,093477,Carter; Anne Toulson,20,0,35,15
1657079696392,MATH 109,A01,083213,Ganzberger; Geoffrey Michael,2,0,34,32
1657079696392,MATH 109,A02,083214,Ganzberger; Geoffrey Michael,2,0,34,32
1657079696392,MATH 109,A03,093478,Ganzberger; Geoffrey Michael,1,0,34,33
1657079696392,MATH 109,B01,083215,Ganzberger; Geoffrey Michael,1,0,32,31
1657079696392,MATH 109,B02,083216,Ganzberger; Geoffrey Michael,1,0,32,31
1657079696392,MATH 109,B03,093479,Ganzberger; Geoffrey Michael,6,0,32,26
1657079702433,MATH 142A,A01,083219,Chow; Bennett,6,0,32,26
1657079702433,MATH 142A,A02,083220,Chow; Bennett,10,0,32,22
1657079702433,MATH 142A,A03,093480,Chow; Bennett,7,0,32,25
1657079702433,MATH 142A,B03,093481,Chow; Bennett,8,0,32,24
1657079702433,MATH 142A,B04,093558,Chow; Bennett,11,0,32,21
1657079702433,MATH 142A,B05,093559,Chow; Bennett,6,0,32,26
1657079708455,MATH 193A,A01,083224,Rotar; Vladimir,7,0,34,27
1657079708455,MATH 193A,A02,083225,Rotar; Vladimir,5,0,34,29
1657079708455,MATH 193A,A03,083781,Rotar; Vladimir,1,0,34,33
1657079708455,MATH 193A,A04,083782,Rotar; Vladimir,6,0,34,28
1657079708455,MATH 193A,A05,093482,Rotar; Vladimir,6,0,34,28
1657079714483,MATH 197,001,091859,McAuley; Julian John,9999,0,9999,0
1657079714483,MATH 197,002,095566,Kedlaya; Kiran S.,9997,0,9999,2
1657079714483,MATH 197,003,095567,Xiao; Ming,9999,0,9999,0
1657079714483,MATH 197,004,095571,Perols; Johan Lars,9998,0,9999,1
1657079721533,COGS 9,A01,083615,Shannon; Kyle Michael,7,0,75,68
1657079727564,COGS 11,A01,083617,Boyle; Mary E. T.,21,0,48,27
1657079733587,COGS 13,A01,083071,Bastos; Amalia Pinkusfeld,9,0,71,62
1657079739620,COGS 14A,A01,092681,Semenuks; Arturs,1,1,100,99
1657079745655,COGS 14B,A01,083073,Cheng; Tzu-Han,5,0,63,58
1657079751764,COGS 17,A01,092677,Semenuks; Arturs,4,0,81,77
1657079757819,COGS 100,A01,083619,Allen; Michael Gordon,15,0,70,55
1657079763846,COGS 101A,A01,083621,Davis; Joshua Daniel,9,0,68,59
1657079769880,COGS 101B,A01,091572,Allen; Michael Gordon,8,0,65,57
1657079775909,COGS 101C,A01,083625,Delgado; Tania,17,0,35,18
1657079781936,COGS 107A,A01,083627,Boyle; Mary E. T.,13,0,60,47
1657079787961,COGS 118A,A01,083075,Gupta; Anjum,15,0,76,61
1657079793990,CSE 3,A50,083646,Miranda; Gregory Joseph,22,0,50,28
1657079800014,CSE 8A,A50,083650,Miranda; Gregory Joseph,17,1,56,39
1657079806038,CSE 11,A01,083080,Cao; Yingjun,4,15,40,36
1657079812073,CSE 12,A01,083652,Krause-Levy; Sophia Louisa,23,1,120,97
1657079818174,CSE 15L,A01,083654,Morris; Justin Loren,8,0,50,42
1657079818174,CSE 15L,A02,083655,Morris; Justin Loren,9,0,50,41
1657079824198,CSE 20,A01,083657,Tran; Khoa Dang,37,0,80,43
1657079830225,CSE 21,A01,095574,Bach; Quang Tran,21,0,48,27
1657079836248,CSE 30,A01,083084,Eldon; John,4,0,80,76
1657079836248,CSE 30,B01,095061,Bhaskar; Nishant,6,0,50,44
1657079842274,CSE 100,A01,083659,Cao; Yingjun,3,4,70,67
1657079848298,CSE 134B,A01,083661,Powell; Thomas Allan,19,0,100,81
1657079854323,CSE 140,A01,083663,Gungor; Onat,14,0,85,71
1657079860346,CSE 140L,A01,083088,Eldon; John,16,0,100,84
1657079866367,CSE 175,A01,083665,Kumar; Rakesh,3,0,25,22
1657079872394,CSE 190,A00,092507,Dubnov; Shlomo,7,0,20,13
1657079878418,ECE 45,A01,083139,Congero; Spencer William,5,0,75,70
1657079884442,ECE 65,A50,083695,Saad; Andrew S,12,0,30,18
1657079884442,ECE 65,A51,095125,Saad; Andrew S,25,0,26,1
1657079890464,ECE 109,A01,091882,Touri; Behrouz,16,0,70,54
1657079896488,ECE 180,A00,083140,Abi Samra; Nicholas Camill,1,0,30,29
1657079896488,ECE 180,B00,083141,Abi Samra; Nicholas Camill,0,0,30,30
1657079902516,MATH 10A,A01,083735,Patchell; Gregory David,1,0,30,29
1657079902516,MATH 10A,A02,083736,Patchell; Gregory David,20,0,30,10
1657079902516,MATH 10A,A03,083737,Patchell; Gregory David,16,0,30,14
1657079908544,MATH 10B,A01,083207,Lim; Seonhee,7,0,34,27
1657079908544,MATH 10B,A02,083208,Lim; Seonhee,9,0,35,26
1657079908544,MATH 10B,A03,093472,Lim; Seonhee,4,0,34,30
1657079908544,MATH 10B,B01,083739,Sinha; Shubham,9,0,30,21
1657079914568,MATH 18,A01,083743,Cinel; Cameron Alexander,6,0,30,24
1657079914568,MATH 18,A02,083744,Cinel; Cameron Alexander,15,0,30,15
1657079914568,MATH 18,A03,083745,Cinel; Cameron Alexander,8,0,30,22
1657079914568,MATH 18,B01,083748,Rideout; David Porter,4,0,37,33
1657079914568,MATH 18,B02,083749,Rideout; David Porter,3,0,36,33
1657079914568,MATH 18,B03,083750,Rideout; David Porter,2,0,37,35
1657079914568,MATH 18,B04,083751,Rideout; David Porter,5,0,36,31
1657079914568,MATH 18,B05,093473,Rideout; David Porter,4,0,36,32
1657079914568,MATH 18,B06,093474,Rideout; David Porter,5,0,36,31
1657079920595,MATH 20A,A01,083754,Zheng; Zequn,12,0,40,28
1657079926622,MATH 20B,A01,083756,Briones; Jor-el Thomas Caparas,1,0,36,35
1657079926622,MATH 20B,A02,083757,Briones; Jor-el Thomas Caparas,1,0,36,35
1657079926622,MATH 20B,A03,093475,Briones; Jor-el Thomas Caparas,0,0,36,36
1657079932654,MATH 20C,A01,083760,Briones; Jor-el Thomas Caparas,1,0,35,34
1657079932654,MATH 20C,A02,083761,Briones; Jor-el Thomas Caparas,8,0,35,27
1657079932654,MATH 20C,A03,093476,Briones; Jor-el Thomas Caparas,0,1,36,36
1657079932654,MATH 20C,B01,083762,Bach; Quang Tran,0,0,30,30
1657079938686,MATH 20D,A01,083765,Tran; Brian Kha,4,0,30,26
1657079938686,MATH 20D,A02,083766,Tran; Brian Kha,5,0,30,25
1657079938686,MATH 20D,A03,083767,Tran; Brian Kha,3,0,30,27
1657079944709,MATH 20E,A01,083771,Ganguly; Soumya,5,0,32,27
1657079944709,MATH 20E,A02,083772,Ganguly; Soumya,6,0,32,26
1657079944709,MATH 20E,B01,083773,Ciotti; Benjamin,18,0,35,17
1657079944709,MATH 20E,B02,083774,Ciotti; Benjamin,17,0,35,18
1657079950745,MATH 103A,A01,083777,Greenfeld; Be'Eri,2,0,36,34
1657079950745,MATH 103A,A02,083778,Greenfeld; Be'Eri,5,0,36,31
1657079950745,MATH 103A,A03,093561,Greenfeld; Be'Eri,4,0,36,32
1657079950745,MATH 103A,B01,083779,Greenfeld; Be'Eri,6,0,36,30
1657079950745,MATH 103A,B02,083780,Greenfeld; Be'Eri,2,0,36,34
1657079950745,MATH 103A,B03,093562,Greenfeld; Be'Eri,3,0,36,33
1657079956771,MATH 105,A01,085443,Carter; Anne Toulson,14,0,35,21
1657079956771,MATH 105,A02,093477,Carter; Anne Toulson,20,0,35,15
1657079962793,MATH 109,A01,083213,Ganzberger; Geoffrey Michael,2,0,34,32
1657079962793,MATH 109,A02,083214,Ganzberger; Geoffrey Michael,2,0,34,32
1657079962793,MATH 109,A03,093478,Ganzberger; Geoffrey Michael,1,0,34,33
1657079962793,MATH 109,B01,083215,Ganzberger; Geoffrey Michael,1,0,32,31
1657079962793,MATH 109,B02,083216,Ganzberger; Geoffrey Michael,1,0,32,31
1657079962793,MATH 109,B03,093479,Ganzberger; Geoffrey Michael,6,0,32,26
1657079968819,MATH 142A,A01,083219,Chow; Bennett,6,0,32,26
1657079968819,MATH 142A,A02,083220,Chow; Bennett,10,0,32,22
1657079968819,MATH 142A,A03,093480,Chow; Bennett,7,0,32,25
1657079968819,MATH 142A,B03,093481,Chow; Bennett,8,0,32,24
1657079968819,MATH 142A,B04,093558,Chow; Bennett,11,0,32,21
1657079968819,MATH 142A,B05,093559,Chow; Bennett,6,0,32,26
1657079974843,MATH 193A,A01,083224,Rotar; Vladimir,7,0,34,27
1657079974843,MATH 193A,A02,083225,Rotar; Vladimir,5,0,34,29
1657079974843,MATH 193A,A03,083781,Rotar; Vladimir,1,0,34,33
1657079974843,MATH 193A,A04,083782,Rotar; Vladimir,6,0,34,28
1657079974843,MATH 193A,A05,093482,Rotar; Vladimir,6,0,34,28
1657079980868,MATH 197,001,091859,McAuley; Julian John,9999,0,9999,0
1657079980868,MATH 197,002,095566,Kedlaya; Kiran S.,9997,0,9999,2
1657079980868,MATH 197,003,095567,Xiao; Ming,9999,0,9999,0
1657079980868,MATH 197,004,095571,Perols; Johan Lars,9998,0,9999,1
1657079987930,COGS 9,A01,083615,Shannon; Kyle Michael,7,0,75,68
1657079993954,COGS 11,A01,083617,Boyle; Mary E. T.,21,0,48,27
1657079999983,COGS 13,A01,083071,Bastos; Amalia Pinkusfeld,9,0,71,62
1657080006009,COGS 14A,A01,092681,Semenuks; Arturs,1,1,100,99
1657080012030,COGS 14B,A01,083073,Cheng; Tzu-Han,5,0,63,58
1657080018060,COGS 17,A01,092677,Semenuks; Arturs,4,0,81,77
1657080024083,COGS 100,A01,083619,Allen; Michael Gordon,15,0,70,55
1657080030106,COGS 101A,A01,083621,Davis; Joshua Daniel,9,0,68,59
1657080036135,COGS 101B,A01,091572,Allen; Michael Gordon,8,0,65,57
1657080042158,COGS 101C,A01,083625,Delgado; Tania,17,0,35,18
1657080048181,COGS 107A,A01,083627,Boyle; Mary E. T.,13,0,60,47
1657080054202,COGS 118A,A01,083075,Gupta; Anjum,15,0,76,61
1657080060233,CSE 3,A50,083646,Miranda; Gregory Joseph,22,0,50,28
1657080066256,CSE 8A,A50,083650,Miranda; Gregory Joseph,17,1,56,39
1657080072280,CSE 11,A01,083080,Cao; Yingjun,4,15,40,36
1657080078306,CSE 12,A01,083652,Krause-Levy; Sophia Louisa,23,1,120,97
1657080084382,CSE 15L,A01,083654,Morris; Justin Loren,8,0,50,42
1657080084382,CSE 15L,A02,083655,Morris; Justin Loren,9,0,50,41
1657080090406,CSE 20,A01,083657,Tran; Khoa Dang,37,0,80,43
1657080096429,CSE 21,A01,095574,Bach; Quang Tran,21,0,48,27
1657080102452,CSE 30,A01,083084,Eldon; John,4,0,80,76
1657080102452,CSE 30,B01,095061,Bhaskar; Nishant,6,0,50,44
1657080108475,CSE 100,A01,083659,Cao; Yingjun,3,4,70,67
1657080114498,CSE 134B,A01,083661,Powell; Thomas Allan,19,0,100,81
1657080120523,CSE 140,A01,083663,Gungor; Onat,14,0,85,71
1657080126545,CSE 140L,A01,083088,Eldon; John,16,0,100,84
1657080132574,CSE 175,A01,083665,Kumar; Rakesh,3,0,25,22
1657080138598,CSE 190,A00,092507,Dubnov; Shlomo,7,0,20,13
1657080144627,ECE 45,A01,083139,Congero; Spencer William,5,0,75,70
1657080150649,ECE 65,A50,083695,Saad; Andrew S,12,0,30,18
1657080150649,ECE 65,A51,095125,Saad; Andrew S,25,0,26,1
1657080156671,ECE 109,A01,091882,Touri; Behrouz,16,0,70,54
1657080162694,ECE 180,A00,083140,Abi Samra; Nicholas Camill,1,0,30,29
1657080162694,ECE 180,B00,083141,Abi Samra; Nicholas Camill,0,0,30,30
1657080168720,MATH 10A,A01,083735,Patchell; Gregory David,1,0,30,29
1657080168720,MATH 10A,A02,083736,Patchell; Gregory David,20,0,30,10
1657080168720,MATH 10A,A03,083737,Patchell; Gregory David,16,0,30,14
1657080174744,MATH 10B,A01,083207,Lim; Seonhee,7,0,34,27
1657080174744,MATH 10B,A02,083208,Lim; Seonhee,9,0,35,26
1657080174744,MATH 10B,A03,093472,Lim; Seonhee,4,0,34,30
1657080174744,MATH 10B,B01,083739,Sinha; Shubham,9,0,30,21
1657080180776,MATH 18,A01,083743,Cinel; Cameron Alexander,6,0,30,24
1657080180776,MATH 18,A02,083744,Cinel; Cameron Alexander,15,0,30,15
1657080180776,MATH 18,A03,083745,Cinel; Cameron Alexander,8,0,30,22
1657080180776,MATH 18,B01,083748,Rideout; David Porter,4,0,37,33
1657080180776,MATH 18,B02,083749,Rideout; David Porter,3,0,36,33
1657080180776,MATH 18,B03,083750,Rideout; David Porter,2,0,37,35
1657080180776,MATH 18,B04,083751,Rideout; David Porter,5,0,36,31
1657080180776,MATH 18,B05,093473,Rideout; David Porter,4,0,36,32
1657080180776,MATH 18,B06,093474,Rideout; David Porter,5,0,36,31
1657080186802,MATH 20A,A01,083754,Zheng; Zequn,12,0,40,28
1657080192832,MATH 20B,A01,083756,Briones; Jor-el Thomas Caparas,1,0,36,35
1657080192832,MATH 20B,A02,083757,Briones; Jor-el Thomas Caparas,1,0,36,35
1657080192832,MATH 20B,A03,093475,Briones; Jor-el Thomas Caparas,0,0,36,36
1657080198864,MATH 20C,A01,083760,Briones; Jor-el Thomas Caparas,1,0,35,34
1657080198864,MATH 20C,A02,083761,Briones; Jor-el Thomas Caparas,8,0,35,27
1657080198864,MATH 20C,A03,093476,Briones; Jor-el Thomas Caparas,0,1,36,36
1657080198864,MATH 20C,B01,083762,Bach; Quang Tran,0,0,30,30
1657080204886,MATH 20D,A01,083765,Tran; Brian Kha,4,0,30,26
1657080204886,MATH 20D,A02,083766,Tran; Brian Kha,5,0,30,25
1657080204886,MATH 20D,A03,083767,Tran; Brian Kha,3,0,30,27
1657080210916,MATH 20E,A01,083771,Ganguly; Soumya,5,0,32,27
1657080210916,MATH 20E,A02,083772,Ganguly; Soumya,6,0,32,26
1657080210916,MATH 20E,B01,083773,Ciotti; Benjamin,18,0,35,17
1657080210916,MATH 20E,B02,083774,Ciotti; Benjamin,17,0,35,18
1657080216938,MATH 103A,A01,083777,Greenfeld; Be'Eri,2,0,36,34
1657080216938,MATH 103A,A02,083778,Greenfeld; Be'Eri,5,0,36,31
1657080216938,MATH 103A,A03,093561,Greenfeld; Be'Eri,4,0,36,32
1657080216938,MATH 103A,B01,083779,Greenfeld; Be'Eri,6,0,36,30
1657080216938,MATH 103A,B02,083780,Greenfeld; Be'Eri,2,0,36,34
1657080216938,MATH 103A,B03,093562,Greenfeld; Be'Eri,3,0,36,33
1657080222960,MATH 105,A01,085443,Carter; Anne Toulson,14,0,35,21
1657080222960,MATH 105,A02,093477,Carter; Anne Toulson,20,0,35,15
1657080228999,MATH 109,A01,083213,Ganzberger; Geoffrey Michael,2,0,34,32
1657080228999,MATH 109,A02,083214,Ganzberger; Geoffrey Michael,2,0,34,32
1657080228999,MATH 109,A03,093478,Ganzberger; Geoffrey Michael,1,0,34,33
1657080228999,MATH 109,B01,083215,Ganzberger; Geoffrey Michael,1,0,32,31
1657080228999,MATH 109,B02,083216,Ganzberger; Geoffrey Michael,1,0,32,31
1657080228999,MATH 109,B03,093479,Ganzberger; Geoffrey Michael,6,0,32,26
1657080235032,MATH 142A,A01,083219,Chow; Bennett,6,0,32,26
1657080235032,MATH 142A,A02,083220,Chow; Bennett,10,0,32,22
1657080235032,MATH 142A,A03,093480,Chow; Bennett,7,0,32,25
1657080235032,MATH 142A,B03,093481,Chow; Bennett,8,0,32,24
1657080235032,MATH 142A,B04,093558,Chow; Bennett,11,0,32,21
1657080235032,MATH 142A,B05,093559,Chow; Bennett,6,0,32,26
1657080241059,MATH 193A,A01,083224,Rotar; Vladimir,7,0,34,27
1657080241059,MATH 193A,A02,083225,Rotar; Vladimir,5,0,34,29
1657080241059,MATH 193A,A03,083781,Rotar; Vladimir,1,0,34,33
1657080241059,MATH 193A,A04,083782,Rotar; Vladimir,6,0,34,28
1657080241059,MATH 193A,A05,093482,Rotar; Vladimir,6,0,34,28
1657080247106,MATH 197,001,091859,McAuley; Julian John,9999,0,9999,0
1657080247106,MATH 197,002,095566,Kedlaya; Kiran S.,9997,0,9999,2
1657080247106,MATH 197,003,095567,Xiao; Ming,9999,0,9999,0
1657080247106,MATH 197,004,095571,Perols; Johan Lars,9998,0,9999,1
1657080254154,COGS 9,A01,083615,Shannon; Kyle Michael,7,0,75,68
1657080260180,COGS 11,A01,083617,Boyle; Mary E. T.,21,0,48,27
1657080266203,COGS 13,A01,083071,Bastos; Amalia Pinkusfeld,9,0,71,62
1657080272226,COGS 14A,A01,092681,Semenuks; Arturs,1,1,100,99
1657080278248,COGS 14B,A01,083073,Cheng; Tzu-Han,5,0,63,58
1657080284275,COGS 17,A01,092677,Semenuks; Arturs,4,0,81,77
1657080290298,COGS 100,A01,083619,Allen; Michael Gordon,15,0,70,55
1657080296334,COGS 101A,A01,083621,Davis; Joshua Daniel,9,0,68,59
1657080302356,COGS 101B,A01,091572,Allen; Michael Gordon,8,0,65,57
1657080308383,COGS 101C,A01,083625,Delgado; Tania,17,0,35,18
1657080314405,COGS 107A,A01,083627,Boyle; Mary E. T.,13,0,60,47
1657080320427,COGS 118A,A01,083075,Gupta; Anjum,15,0,76,61
1657080326451,CSE 3,A50,083646,Miranda; Gregory Joseph,22,0,50,28
1657080332475,CSE 8A,A50,083650,Miranda; Gregory Joseph,17,1,56,39
1657080338498,CSE 11,A01,083080,Cao; Yingjun,4,15,40,36
1657080344521,CSE 12,A01,083652,Krause-Levy; Sophia Louisa,23,1,120,97
1657080350637,CSE 15L,A01,083654,Morris; Justin Loren,8,0,50,42
1657080350637,CSE 15L,A02,083655,Morris; Justin Loren,9,0,50,41
1657080356659,CSE 20,A01,083657,Tran; Khoa Dang,37,0,80,43
1657080362684,CSE 21,A01,095574,Bach; Quang Tran,21,0,48,27
1657080368712,CSE 30,A01,083084,Eldon; John,4,0,80,76
1657080368712,CSE 30,B01,095061,Bhaskar; Nishant,6,0,50,44
1657080374782,CSE 100,A01,083659,Cao; Yingjun,3,4,70,67
1657080380804,CSE 134B,A01,083661,Powell; Thomas Allan,19,0,100,81
1657080386834,CSE 140,A01,083663,Gungor; Onat,14,0,85,71
1657080392863,CSE 140L,A01,083088,Eldon; John,16,0,100,84
1657080398886,CSE 175,A01,083665,Kumar; Rakesh,3,0,25,22
1657080404909,CSE 190,A00,092507,Dubnov; Shlomo,7,0,20,13
1657080410931,ECE 45,A01,083139,Congero; Spencer William,5,0,75,70
1657080416960,ECE 65,A50,083695,Saad; Andrew S,12,0,30,18
1657080416960,ECE 65,A51,095125,Saad; Andrew S,25,0,26,1
1657080422986,ECE 109,A01,091882,Touri; Behrouz,16,0,70,54
1657080429013,ECE 180,A00,083140,Abi Samra; Nicholas Camill,1,0,30,29
1657080429013,ECE 180,B00,083141,Abi Samra; Nicholas Camill,0,0,30,30
1657080435039,MATH 10A,A01,083735,Patchell; Gregory David,1,0,30,29
1657080435039,MATH 10A,A02,083736,Patchell; Gregory David,20,0,30,10
1657080435039,MATH 10A,A03,083737,Patchell; Gregory David,16,0,30,14
1657080441067,MATH 10B,A01,083207,Lim; Seonhee,7,0,34,27
1657080441067,MATH 10B,A02,083208,Lim; Seonhee,9,0,35,26
1657080441067,MATH 10B,A03,093472,Lim; Seonhee,4,0,34,30
1657080441067,MATH 10B,B01,083739,Sinha; Shubham,9,0,30,21
1657080447098,MATH 18,A01,083743,Cinel; Cameron Alexander,6,0,30,24
1657080447098,MATH 18,A02,083744,Cinel; Cameron Alexander,15,0,30,15
1657080447098,MATH 18,A03,083745,Cinel; Cameron Alexander,8,0,30,22
1657080447098,MATH 18,B01,083748,Rideout; David Porter,4,0,37,33
1657080447098,MATH 18,B02,083749,Rideout; David Porter,3,0,36,33
1657080447098,MATH 18,B03,083750,Rideout; David Porter,2,0,37,35
1657080447098,MATH 18,B04,083751,Rideout; David Porter,5,0,36,31
1657080447098,MATH 18,B05,093473,Rideout; David Porter,4,0,36,32
1657080447098,MATH 18,B06,093474,Rideout; David Porter,5,0,36,31
1657080453131,MATH 20A,A01,083754,Zheng; Zequn,12,0,40,28
1657080459154,MATH 20B,A01,083756,Briones; Jor-el Thomas Caparas,1,0,36,35
1657080459154,MATH 20B,A02,083757,Briones; Jor-el Thomas Caparas,1,0,36,35
1657080459154,MATH 20B,A03,093475,Briones; Jor-el Thomas Caparas,0,0,36,36
1657080465179,MATH 20C,A01,083760,Briones; Jor-el Thomas Caparas,1,0,35,34
1657080465179,MATH 20C,A02,083761,Briones; Jor-el Thomas Caparas,8,0,35,27
1657080465179,MATH 20C,A03,093476,Briones; Jor-el Thomas Caparas,0,1,36,36
1657080465179,MATH 20C,B01,083762,Bach; Quang Tran,0,0,30,30
1657080471207,MATH 20D,A01,083765,Tran; Brian Kha,4,0,30,26
1657080471207,MATH 20D,A02,083766,Tran; Brian Kha,5,0,30,25
1657080471207,MATH 20D,A03,083767,Tran; Brian Kha,3,0,30,27
1657080477231,MATH 20E,A01,083771,Ganguly; Soumya,5,0,32,27
1657080477231,MATH 20E,A02,083772,Ganguly; Soumya,6,0,32,26
1657080477231,MATH 20E,B01,083773,Ciotti; Benjamin,18,0,35,17
1657080477231,MATH 20E,B02,083774,Ciotti; Benjamin,17,0,35,18
1657080483255,MATH 103A,A01,083777,Greenfeld; Be'Eri,2,0,36,34
1657080483255,MATH 103A,A02,083778,Greenfeld; Be'Eri,5,0,36,31
1657080483255,MATH 103A,A03,093561,Greenfeld; Be'Eri,4,0,36,32
1657080483255,MATH 103A,B01,083779,Greenfeld; Be'Eri,6,0,36,30
1657080483255,MATH 103A,B02,083780,Greenfeld; Be'Eri,2,0,36,34
1657080483255,MATH 103A,B03,093562,Greenfeld; Be'Eri,3,0,36,33
1657080489281,MATH 105,A01,085443,Carter; Anne Toulson,14,0,35,21
1657080489281,MATH 105,A02,093477,Carter; Anne Toulson,20,0,35,15
1657080495309,MATH 109,A01,083213,Ganzberger; Geoffrey Michael,2,0,34,32
1657080495309,MATH 109,A02,083214,Ganzberger; Geoffrey Michael,2,0,34,32
1657080495309,MATH 109,A03,093478,Ganzberger; Geoffrey Michael,1,0,34,33
1657080495309,MATH 109,B01,083215,Ganzberger; Geoffrey Michael,1,0,32,31
1657080495309,MATH 109,B02,083216,Ganzberger; Geoffrey Michael,1,0,32,31
1657080495309,MATH 109,B03,093479,Ganzberger; Geoffrey Michael,6,0,32,26
1657080501332,MATH 142A,A01,083219,Chow; Bennett,6,0,32,26
1657080501332,MATH 142A,A02,083220,Chow; Bennett,10,0,32,22
1657080501332,MATH 142A,A03,093480,Chow; Bennett,7,0,32,25
1657080501332,MATH 142A,B03,093481,Chow; Bennett,8,0,32,24
1657080501332,MATH 142A,B04,093558,Chow; Bennett,11,0,32,21
1657080501332,MATH 142A,B05,093559,Chow; Bennett,6,0,32,26
1657080507356,MATH 193A,A01,083224,Rotar; Vladimir,7,0,34,27
1657080507356,MATH 193A,A02,083225,Rotar; Vladimir,5,0,34,29
1657080507356,MATH 193A,A03,083781,Rotar; Vladimir,1,0,34,33
1657080507356,MATH 193A,A04,083782,Rotar; Vladimir,6,0,34,28
1657080507356,MATH 193A,A05,093482,Rotar; Vladimir,6,0,34,28
1657080513380,MATH 197,001,091859,McAuley; Julian John,9999,0,9999,0
1657080513380,MATH 197,002,095566,Kedlaya; Kiran S.,9997,0,9999,2
1657080513380,MATH 197,003,095567,Xiao; Ming,9999,0,9999,0
1657080513380,MATH 197,004,095571,Perols; Johan Lars,9998,0,9999,1
1657080520432,COGS 9,A01,083615,Shannon; Kyle Michael,7,0,75,68
1657080526455,COGS 11,A01,083617,Boyle; Mary E. T.,21,0,48,27
1657080532482,COGS 13,A01,083071,Bastos; Amalia Pinkusfeld,9,0,71,62
1657080538511,COGS 14A,A01,092681,Semenuks; Arturs,1,1,100,99
1657080544538,COGS 14B,A01,083073,Cheng; Tzu-Han,5,0,63,58
1657080550561,COGS 17,A01,092677,Semenuks; Arturs,4,0,81,77
1657080556593,COGS 100,A01,083619,Allen; Michael Gordon,15,0,70,55
1657080562616,COGS 101A,A01,083621,Davis; Joshua Daniel,9,0,68,59
1657080568642,COGS 101B,A01,091572,Allen; Michael Gordon,8,0,65,57
1657080574668,COGS 101C,A01,083625,Delgado; Tania,17,0,35,18
1657080580694,COGS 107A,A01,083627,Boyle; Mary E. T.,13,0,60,47
1657080586716,COGS 118A,A01,083075,Gupta; Anjum,15,0,76,61
1657080592745,CSE 3,A50,083646,Miranda; Gregory Joseph,22,0,50,28
1657080598767,CSE 8A,A50,083650,Miranda; Gregory Joseph,17,1,56,39
1657080604790,CSE 11,A01,083080,Cao; Yingjun,4,15,40,36
1657080610811,CSE 12,A01,083652,Krause-Levy; Sophia Louisa,23,1,120,97
1657080616846,CSE 15L,A01,083654,Morris; Justin Loren,8,0,50,42
1657080616846,CSE 15L,A02,083655,Morris; Justin Loren,9,0,50,41
1657080622876,CSE 20,A01,083657,Tran; Khoa Dang,37,0,80,43
1657080628899,CSE 21,A01,095574,Bach; Quang Tran,21,0,48,27
1657080634922,CSE 30,A01,083084,Eldon; John,4,0,80,76
1657080634922,CSE 30,B01,095061,Bhaskar; Nishant,6,0,50,44
1657080640945,CSE 100,A01,083659,Cao; Yingjun,3,4,70,67
1657080646968,CSE 134B,A01,083661,Powell; Thomas Allan,19,0,100,81
1657080652994,CSE 140,A01,083663,Gungor; Onat,14,0,85,71
1657080659020,CSE 140L,A01,083088,Eldon; John,16,0,100,84
1657080665042,CSE 175,A01,083665,Kumar; Rakesh,3,0,25,22
1657080671067,CSE 190,A00,092507,Dubnov; Shlomo,7,0,20,13
1657080677102,ECE 45,A01,083139,Congero; Spencer William,5,0,75,70
1657080683126,ECE 65,A50,083695,Saad; Andrew S,12,0,30,18
1657080683126,ECE 65,A51,095125,Saad; Andrew S,25,0,26,1
1657080689150,ECE 109,A01,091882,Touri; Behrouz,16,0,70,54
1657080695175,ECE 180,A00,083140,Abi Samra; Nicholas Camill,1,0,30,29
1657080695175,ECE 180,B00,083141,Abi Samra; Nicholas Camill,0,0,30,30
1657080701208,MATH 10A,A01,083735,Patchell; Gregory David,1,0,30,29
1657080701208,MATH 10A,A02,083736,Patchell; Gregory David,20,0,30,10
1657080701208,MATH 10A,A03,083737,Patchell; Gregory David,16,0,30,14
1657080707247,MATH 10B,A01,083207,Lim; Seonhee,7,0,34,27
1657080707247,MATH 10B,A02,083208,Lim; Seonhee,9,0,35,26
1657080707247,MATH 10B,A03,093472,Lim; Seonhee,4,0,34,30
1657080707247,MATH 10B,B01,083739,Sinha; Shubham,9,0,30,21
1657080713277,MATH 18,A01,083743,Cinel; Cameron Alexander,6,0,30,24
1657080713277,MATH 18,A02,083744,Cinel; Cameron Alexander,15,0,30,15
1657080713277,MATH 18,A03,083745,Cinel; Cameron Alexander,8,0,30,22
1657080713277,MATH 18,B01,083748,Rideout; David Porter,4,0,37,33
1657080713277,MATH 18,B02,083749,Rideout; David Porter,3,0,36,33
1657080713277,MATH 18,B03,083750,Rideout; David Porter,2,0,37,35
1657080713277,MATH 18,B04,083751,Rideout; David Porter,5,0,36,31
1657080713277,MATH 18,B05,093473,Rideout; David Porter,4,0,36,32
1657080713277,MATH 18,B06,093474,Rideout; David Porter,5,0,36,31
1657080719303,MATH 20A,A01,083754,Zheng; Zequn,12,0,40,28
1657080725328,MATH 20B,A01,083756,Briones; Jor-el Thomas Caparas,1,0,36,35
1657080725328,MATH 20B,A02,083757,Briones; Jor-el Thomas Caparas,1,0,36,35
1657080725328,MATH 20B,A03,093475,Briones; Jor-el Thomas Caparas,0,0,36,36
1657080731351,MATH 20C,A01,083760,Briones; Jor-el Thomas Caparas,1,0,35,34
1657080731351,MATH 20C,A02,083761,Briones; Jor-el Thomas Caparas,8,0,35,27
1657080731351,MATH 20C,A03,093476,Briones; Jor-el Thomas Caparas,0,1,36,36
1657080731351,MATH 20C,B01,083762,Bach; Quang Tran,0,0,30,30
1657080737378,MATH 20D,A01,083765,Tran; Brian Kha,4,0,30,26
1657080737378,MATH 20D,A02,083766,Tran; Brian Kha,5,0,30,25
1657080737378,MATH 20D,A03,083767,Tran; Brian Kha,3,0,30,27
1657080743401,MATH 20E,A01,083771,Ganguly; Soumya,5,0,32,27
1657080743401,MATH 20E,A02,083772,Ganguly; Soumya,6,0,32,26
1657080743401,MATH 20E,B01,083773,Ciotti; Benjamin,18,0,35,17
1657080743401,MATH 20E,B02,083774,Ciotti; Benjamin,17,0,35,18
1657080749425,MATH 103A,A01,083777,Greenfeld; Be'Eri,2,0,36,34
1657080749425,MATH 103A,A02,083778,Greenfeld; Be'Eri,5,0,36,31
1657080749425,MATH 103A,A03,093561,Greenfeld; Be'Eri,4,0,36,32
1657080749425,MATH 103A,B01,083779,Greenfeld; Be'Eri,6,0,36,30
1657080749425,MATH 103A,B02,083780,Greenfeld; Be'Eri,2,0,36,34
1657080749425,MATH 103A,B03,093562,Greenfeld; Be'Eri,3,0,36,33
1657080755452,MATH 105,A01,085443,Carter; Anne Toulson,14,0,35,21
1657080755452,MATH 105,A02,093477,Carter; Anne Toulson,20,0,35,15
1657080761475,MATH 109,A01,083213,Ganzberger; Geoffrey Michael,2,0,34,32
1657080761475,MATH 109,A02,083214,Ganzberger; Geoffrey Michael,2,0,34,32
1657080761475,MATH 109,A03,093478,Ganzberger; Geoffrey Michael,1,0,34,33
1657080761475,MATH 109,B01,083215,Ganzberger; Geoffrey Michael,1,0,32,31
1657080761475,MATH 109,B02,083216,Ganzberger; Geoffrey Michael,1,0,32,31
1657080761475,MATH 109,B03,093479,Ganzberger; Geoffrey Michael,6,0,32,26
1657080767508,MATH 142A,A01,083219,Chow; Bennett,6,0,32,26
1657080767508,MATH 142A,A02,083220,Chow; Bennett,10,0,32,22
1657080767508,MATH 142A,A03,093480,Chow; Bennett,7,0,32,25
1657080767508,MATH 142A,B03,093481,Chow; Bennett,8,0,32,24
1657080767508,MATH 142A,B04,093558,Chow; Bennett,11,0,32,21
1657080767508,MATH 142A,B05,093559,Chow; Bennett,6,0,32,26
1657080773532,MATH 193A,A01,083224,Rotar; Vladimir,7,0,34,27
1657080773532,MATH 193A,A02,083225,Rotar; Vladimir,5,0,34,29
1657080773532,MATH 193A,A03,083781,Rotar; Vladimir,1,0,34,33
1657080773532,MATH 193A,A04,083782,Rotar; Vladimir,6,0,34,28
1657080773532,MATH 193A,A05,093482,Rotar; Vladimir,6,0,34,28
1657080779555,MATH 197,001,091859,McAuley; Julian John,9999,0,9999,0
1657080779555,MATH 197,002,095566,Kedlaya; Kiran S.,9997,0,9999,2
1657080779555,MATH 197,003,095567,Xiao; Ming,9999,0,9999,0
1657080779555,MATH 197,004,095571,Perols; Johan Lars,9998,0,9999,1
1657080786609,COGS 9,A01,083615,Shannon; Kyle Michael,7,0,75,68
1657080792642,COGS 11,A01,083617,Boyle; Mary E. T.,21,0,48,27
1657080798666,COGS 13,A01,083071,Bastos; Amalia Pinkusfeld,9,0,71,62
1657080804689,COGS 14A,A01,092681,Semenuks; Arturs,1,1,100,99
1657080810711,COGS 14B,A01,083073,Cheng; Tzu-Han,5,0,63,58
1657080816738,COGS 17,A01,092677,Semenuks; Arturs,4,0,81,77
1657080822763,COGS 100,A01,083619,Allen; Michael Gordon,15,0,70,55
1657080828787,COGS 101A,A01,083621,Davis; Joshua Daniel,9,0,68,59
1657080834812,COGS 101B,A01,091572,Allen; Michael Gordon,8,0,65,57
1657080840844,COGS 101C,A01,083625,Delgado; Tania,17,0,35,18
1657080846872,COGS 107A,A01,083627,Boyle; Mary E. T.,13,0,60,47
1657080852898,COGS 118A,A01,083075,Gupta; Anjum,15,0,76,61
1657080858923,CSE 3,A50,083646,Miranda; Gregory Joseph,22,0,50,28
1657080864950,CSE 8A,A50,083650,Miranda; Gregory Joseph,17,1,56,39
1657080870975,CSE 11,A01,083080,Cao; Yingjun,4,15,40,36
1657080877002,CSE 12,A01,083652,Krause-Levy; Sophia Louisa,23,1,120,97
1657080883029,CSE 15L,A01,083654,Morris; Justin Loren,8,0,50,42
1657080883029,CSE 15L,A02,083655,Morris; Justin Loren,9,0,50,41
1657080889053,CSE 20,A01,083657,Tran; Khoa Dang,37,0,80,43
1657080895077,CSE 21,A01,095574,Bach; Quang Tran,21,0,48,27
1657080901099,CSE 30,A01,083084,Eldon; John,4,0,80,76
1657080901099,CSE 30,B01,095061,Bhaskar; Nishant,6,0,50,44
1657080907121,CSE 100,A01,083659,Cao; Yingjun,3,4,70,67
1657080913147,CSE 134B,A01,083661,Powell; Thomas Allan,19,0,100,81
1657080919172,CSE 140,A01,083663,Gungor; Onat,14,0,85,71
1657080925200,CSE 140L,A01,083088,Eldon; John,16,0,100,84
1657080931223,CSE 175,A01,083665,Kumar; Rakesh,3,0,25,22
1657080937245,CSE 190,A00,092507,Dubnov; Shlomo,7,0,20,13
1657080943269,ECE 45,A01,083139,Congero; Spencer William,5,0,75,70
1657080949384,ECE 65,A50,083695,Saad; Andrew S,12,0,30,18
1657080949384,ECE 65,A51,095125,Saad; Andrew S,25,0,26,1
1657080955418,ECE 109,A01,091882,Touri; Behrouz,16,0,70,54
1657080961441,ECE 180,A00,083140,Abi Samra; Nicholas Camill,1,0,30,29
1657080961441,ECE 180,B00,083141,Abi Samra; Nicholas Camill,0,0,30,30
1657080967464,MATH 10A,A01,083735,Patchell; Gregory David,1,0,30,29
1657080967464,MATH 10A,A02,083736,Patchell; Gregory David,20,0,30,10
1657080967464,MATH 10A,A03,083737,Patchell; Gregory David,16,0,30,14
1657080973488,MATH 10B,A01,083207,Lim; Seonhee,7,0,34,27
1657080973488,MATH 10B,A02,083208,Lim; Seonhee,9,0,35,26
1657080973488,MATH 10B,A03,093472,Lim; Seonhee,4,0,34,30
1657080973488,MATH 10B,B01,083739,Sinha; Shubham,9,0,30,21
1657080979513,MATH 18,A01,083743,Cinel; Cameron Alexander,6,0,30,24
1657080979513,MATH 18,A02,083744,Cinel; Cameron Alexander,15,0,30,15
1657080979513,MATH 18,A03,083745,Cinel; Cameron Alexander,8,0,30,22
1657080979513,MATH 18,B01,083748,Rideout; David Porter,4,0,37,33
1657080979513,MATH 18,B02,083749,Rideout; David Porter,3,0,36,33
1657080979513,MATH 18,B03,083750,Rideout; David Porter,2,0,37,35
1657080979513,MATH 18,B04,083751,Rideout; David Porter,5,0,36,31
1657080979513,MATH 18,B05,093473,Rideout; David Porter,4,0,36,32
1657080979513,MATH 18,B06,093474,Rideout; David Porter,5,0,36,31
1657080985535,MATH 20A,A01,083754,Zheng; Zequn,12,0,40,28
1657080991563,MATH 20B,A01,083756,Briones; Jor-el Thomas Caparas,1,0,36,35
1657080991563,MATH 20B,A02,083757,Briones; Jor-el Thomas Caparas,1,0,36,35
1657080991563,MATH 20B,A03,093475,Briones; Jor-el Thomas Caparas,0,0,36,36
1657080997592,MATH 20C,A01,083760,Briones; Jor-el Thomas Caparas,1,0,35,34
1657080997592,MATH 20C,A02,083761,Briones; Jor-el Thomas Caparas,8,0,35,27
1657080997592,MATH 20C,A03,093476,Briones; Jor-el Thomas Caparas,0,1,36,36
1657080997592,MATH 20C,B01,083762,Bach; Quang Tran,0,0,30,30
1657081003616,MATH 20D,A01,083765,Tran; Brian Kha,4,0,30,26
1657081003616,MATH 20D,A02,083766,Tran; Brian Kha,5,0,30,25
1657081003616,MATH 20D,A03,083767,Tran; Brian Kha,3,0,30,27
1657081009643,MATH 20E,A01,083771,Ganguly; Soumya,5,0,32,27
1657081009643,MATH 20E,A02,083772,Ganguly; Soumya,6,0,32,26
1657081009643,MATH 20E,B01,083773,Ciotti; Benjamin,18,0,35,17
1657081009643,MATH 20E,B02,083774,Ciotti; Benjamin,17,0,35,18
1657081015672,MATH 103A,A01,083777,Greenfeld; Be'Eri,2,0,36,34
1657081015672,MATH 103A,A02,083778,Greenfeld; Be'Eri,5,0,36,31
1657081015672,MATH 103A,A03,093561,Greenfeld; Be'Eri,4,0,36,32
1657081015672,MATH 103A,B01,083779,Greenfeld; Be'Eri,6,0,36,30
1657081015672,MATH 103A,B02,083780,Greenfeld; Be'Eri,2,0,36,34
1657081015672,MATH 103A,B03,093562,Greenfeld; Be'Eri,3,0,36,33
1657081021694,MATH 105,A01,085443,Carter; Anne Toulson,14,0,35,21
1657081021694,MATH 105,A02,093477,Carter; Anne Toulson,20,0,35,15
1657081027720,MATH 109,A01,083213,Ganzberger; Geoffrey Michael,2,0,34,32
1657081027720,MATH 109,A02,083214,Ganzberger; Geoffrey Michael,2,0,34,32
1657081027720,MATH 109,A03,093478,Ganzberger; Geoffrey Michael,1,0,34,33
1657081027720,MATH 109,B01,083215,Ganzberger; Geoffrey Michael,1,0,32,31
1657081027720,MATH 109,B02,083216,Ganzberger; Geoffrey Michael,1,0,32,31
1657081027720,MATH 109,B03,093479,Ganzberger; Geoffrey Michael,6,0,32,26
1657081033748,MATH 142A,A01,083219,Chow; Bennett,6,0,32,26
1657081033748,MATH 142A,A02,083220,Chow; Bennett,10,0,32,22
1657081033748,MATH 142A,A03,093480,Chow; Bennett,7,0,32,25
1657081033748,MATH 142A,B03,093481,Chow; Bennett,8,0,32,24
1657081033748,MATH 142A,B04,093558,Chow; Bennett,11,0,32,21
1657081033748,MATH 142A,B05,093559,Chow; Bennett,6,0,32,26
1657081039776,MATH 193A,A01,083224,Rotar; Vladimir,7,0,34,27
1657081039776,MATH 193A,A02,083225,Rotar; Vladimir,5,0,34,29
1657081039776,MATH 193A,A03,083781,Rotar; Vladimir,1,0,34,33
1657081039776,MATH 193A,A04,083782,Rotar; Vladimir,6,0,34,28
1657081039776,MATH 193A,A05,093482,Rotar; Vladimir,6,0,34,28
1657081045801,MATH 197,001,091859,McAuley; Julian John,9999,0,9999,0
1657081045801,MATH 197,002,095566,Kedlaya; Kiran S.,9997,0,9999,2
1657081045801,MATH 197,003,095567,Xiao; Ming,9999,0,9999,0
1657081045801,MATH 197,004,095571,Perols; Johan Lars,9998,0,9999,1
1657081052863,COGS 9,A01,083615,Shannon; Kyle Michael,7,0,75,68
1657081058890,COGS 11,A01,083617,Boyle; Mary E. T.,21,0,48,27
1657081064917,COGS 13,A01,083071,Bastos; Amalia Pinkusfeld,9,0,71,62
1657081070941,COGS 14A,A01,092681,Semenuks; Arturs,1,1,100,99
1657081076965,COGS 14B,A01,083073,Cheng; Tzu-Han,5,0,63,58
1657081082992,COGS 17,A01,092677,Semenuks; Arturs,4,0,81,77
1657081089019,COGS 100,A01,083619,Allen; Michael Gordon,15,0,70,55
1657081095046,COGS 101A,A01,083621,Davis; Joshua Daniel,9,0,68,59
1657081101070,COGS 101B,A01,091572,Allen; Michael Gordon,8,0,65,57
1657081107095,COGS 101C,A01,083625,Delgado; Tania,17,0,35,18
1657081113120,COGS 107A,A01,083627,Boyle; Mary E. T.,13,0,60,47
1657081119158,COGS 118A,A01,083075,Gupta; Anjum,15,0,76,61
1657081125180,CSE 3,A50,083646,Miranda; Gregory Joseph,22,0,50,28
1657081131208,CSE 8A,A50,083650,Miranda; Gregory Joseph,17,1,56,39
1657081137234,CSE 11,A01,083080,Cao; Yingjun,4,15,40,36
1657081143257,CSE 12,A01,083652,Krause-Levy; Sophia Louisa,23,1,120,97
1657081149283,CSE 15L,A01,083654,Morris; Justin Loren,8,0,50,42
1657081149283,CSE 15L,A02,083655,Morris; Justin Loren,9,0,50,41
1657081155306,CSE 20,A01,083657,Tran; Khoa Dang,37,0,80,43
1657081161327,CSE 21,A01,095574,Bach; Quang Tran,21,0,48,27
1657081167351,CSE 30,A01,083084,Eldon; John,4,0,80,76
1657081167351,CSE 30,B01,095061,Bhaskar; Nishant,6,0,50,44
1657081173375,CSE 100,A01,083659,Cao; Yingjun,3,4,70,67
1657081179402,CSE 134B,A01,083661,Powell; Thomas Allan,19,0,100,81
1657081185440,CSE 140,A01,083663,Gungor; Onat,14,0,85,71
1657081191463,CSE 140L,A01,083088,Eldon; John,16,0,100,84
1657081197492,CSE 175,A01,083665,Kumar; Rakesh,3,0,25,22
1657081203516,CSE 190,A00,092507,Dubnov; Shlomo,7,0,20,13
1657081209542,ECE 45,A01,083139,Congero; Spencer William,5,0,75,70
1657081215564,ECE 65,A50,083695,Saad; Andrew S,12,0,30,18
1657081215564,ECE 65,A51,095125,Saad; Andrew S,25,0,26,1
1657081221590,ECE 109,A01,091882,Touri; Behrouz,16,0,70,54
1657081227612,ECE 180,A00,083140,Abi Samra; Nicholas Camill,1,0,30,29
1657081227612,ECE 180,B00,083141,Abi Samra; Nicholas Camill,0,0,30,30
1657081233641,MATH 10A,A01,083735,Patchell; Gregory David,1,0,30,29
1657081233641,MATH 10A,A02,083736,Patchell; Gregory David,20,0,30,10
1657081233641,MATH 10A,A03,083737,Patchell; Gregory David,16,0,30,14
1657081239665,MATH 10B,A01,083207,Lim; Seonhee,7,0,34,27
1657081239665,MATH 10B,A02,083208,Lim; Seonhee,9,0,35,26
1657081239665,MATH 10B,A03,093472,Lim; Seonhee,4,0,34,30
1657081239665,MATH 10B,B01,083739,Sinha; Shubham,9,0,30,21
1657081245689,MATH 18,A01,083743,Cinel; Cameron Alexander,6,0,30,24
1657081245689,MATH 18,A02,083744,Cinel; Cameron Alexander,15,0,30,15
1657081245689,MATH 18,A03,083745,Cinel; Cameron Alexander,8,0,30,22
1657081245689,MATH 18,B01,083748,Rideout; David Porter,4,0,37,33
1657081245689,MATH 18,B02,083749,Rideout; David Porter,3,0,36,33
1657081245689,MATH 18,B03,083750,Rideout; David Porter,2,0,37,35
1657081245689,MATH 18,B04,083751,Rideout; David Porter,5,0,36,31
1657081245689,MATH 18,B05,093473,Rideout; David Porter,4,0,36,32
1657081245689,MATH 18,B06,093474,Rideout; David Porter,5,0,36,31
1657081251710,MATH 20A,A01,083754,Zheng; Zequn,12,0,40,28
1657081257733,MATH 20B,A01,083756,Briones; Jor-el Thomas Caparas,1,0,36,35
1657081257733,MATH 20B,A02,083757,Briones; Jor-el Thomas Caparas,1,0,36,35
1657081257733,MATH 20B,A03,093475,Briones; Jor-el Thomas Caparas,0,0,36,36
1657081263766,MATH 20C,A01,083760,Briones; Jor-el Thomas Caparas,1,0,35,34
1657081263766,MATH 20C,A02,083761,Briones; Jor-el Thomas Caparas,8,0,35,27
1657081263766,MATH 20C,A03,093476,Briones; Jor-el Thomas Caparas,0,1,36,36
1657081263766,MATH 20C,B01,083762,Bach; Quang Tran,0,0,30,30
1657081269794,MATH 20D,A01,083765,Tran; Brian Kha,4,0,30,26
1657081269794,MATH 20D,A02,083766,Tran; Brian Kha,5,0,30,25
1657081269794,MATH 20D,A03,083767,Tran; Brian Kha,3,0,30,27
1657081275817,MATH 20E,A01,083771,Ganguly; Soumya,5,0,32,27
1657081275817,MATH 20E,A02,083772,Ganguly; Soumya,6,0,32,26
1657081275817,MATH 20E,B01,083773,Ciotti; Benjamin,18,0,35,17
1657081275817,MATH 20E,B02,083774,Ciotti; Benjamin,17,0,35,18
1657081281841,MATH 103A,A01,083777,Greenfeld; Be'Eri,2,0,36,34
1657081281841,MATH 103A,A02,083778,Greenfeld; Be'Eri,5,0,36,31
1657081281841,MATH 103A,A03,093561,Greenfeld; Be'Eri,4,0,36,32
1657081281841,MATH 103A,B01,083779,Greenfeld; Be'Eri,6,0,36,30
1657081281841,MATH 103A,B02,083780,Greenfeld; Be'Eri,2,0,36,34
1657081281841,MATH 103A,B03,093562,Greenfeld; Be'Eri,3,0,36,33
1657081287864,MATH 105,A01,085443,Carter; Anne Toulson,14,0,35,21
1657081287864,MATH 105,A02,093477,Carter; Anne Toulson,20,0,35,15
1657081293890,MATH 109,A01,083213,Ganzberger; Geoffrey Michael,2,0,34,32
1657081293890,MATH 109,A02,083214,Ganzberger; Geoffrey Michael,2,0,34,32
1657081293890,MATH 109,A03,093478,Ganzberger; Geoffrey Michael,1,0,34,33
1657081293890,MATH 109,B01,083215,Ganzberger; Geoffrey Michael,1,0,32,31
1657081293890,MATH 109,B02,083216,Ganzberger; Geoffrey Michael,1,0,32,31
1657081293890,MATH 109,B03,093479,Ganzberger; Geoffrey Michael,6,0,32,26
1657081299914,MATH 142A,A01,083219,Chow; Bennett,6,0,32,26
1657081299914,MATH 142A,A02,083220,Chow; Bennett,10,0,32,22
1657081299914,MATH 142A,A03,093480,Chow; Bennett,7,0,32,25
1657081299914,MATH 142A,B03,093481,Chow; Bennett,8,0,32,24
1657081299914,MATH 142A,B04,093558,Chow; Bennett,11,0,32,21
1657081299914,MATH 142A,B05,093559,Chow; Bennett,6,0,32,26
1657081305942,MATH 193A,A01,083224,Rotar; Vladimir,7,0,34,27
1657081305942,MATH 193A,A02,083225,Rotar; Vladimir,5,0,34,29
1657081305942,MATH 193A,A03,083781,Rotar; Vladimir,1,0,34,33
1657081305942,MATH 193A,A04,083782,Rotar; Vladimir,6,0,34,28
1657081305942,MATH 193A,A05,093482,Rotar; Vladimir,6,0,34,28
1657081311965,MATH 197,001,091859,McAuley; Julian John,9999,0,9999,0
1657081311965,MATH 197,002,095566,Kedlaya; Kiran S.,9997,0,9999,2
1657081311965,MATH 197,003,095567,Xiao; Ming,9999,0,9999,0
1657081311965,MATH 197,004,095571,Perols; Johan Lars,9998,0,9999,1
1657081319029,COGS 9,A01,083615,Shannon; Kyle Michael,7,0,75,68
1657081325055,COGS 11,A01,083617,Boyle; Mary E. T.,21,0,48,27
1657081331081,COGS 13,A01,083071,Bastos; Amalia Pinkusfeld,9,0,71,62
1657081337103,COGS 14A,A01,092681,Semenuks; Arturs,1,1,100,99
1657081343137,COGS 14B,A01,083073,Cheng; Tzu-Han,5,0,63,58
1657081349165,COGS 17,A01,092677,Semenuks; Arturs,4,0,81,77
1657081355191,COGS 100,A01,083619,Allen; Michael Gordon,15,0,70,55
1657081361213,COGS 101A,A01,083621,Davis; Joshua Daniel,9,0,68,59
1657081367249,COGS 101B,A01,091572,Allen; Michael Gordon,8,0,65,57
1657081373275,COGS 101C,A01,083625,Delgado; Tania,17,0,35,18
1657081379300,COGS 107A,A01,083627,Boyle; Mary E. T.,13,0,60,47
1657081385328,COGS 118A,A01,083075,Gupta; Anjum,15,0,76,61
1657081391352,CSE 3,A50,083646,Miranda; Gregory Joseph,22,0,50,28
1657081397379,CSE 8A,A50,083650,Miranda; Gregory Joseph,17,1,56,39
1657081403404,CSE 11,A01,083080,Cao; Yingjun,4,15,40,36
1657081409435,CSE 12,A01,083652,Krause-Levy; Sophia Louisa,23,1,120,97
1657081415461,CSE 15L,A01,083654,Morris; Justin Loren,8,0,50,42
1657081415461,CSE 15L,A02,083655,Morris; Justin Loren,9,0,50,41
1657081421487,CSE 20,A01,083657,Tran; Khoa Dang,37,0,80,43
1657081427523,CSE 21,A01,095574,Bach; Quang Tran,21,0,48,27
1657081433551,CSE 30,A01,083084,Eldon; John,4,0,80,76
1657081433551,CSE 30,B01,095061,Bhaskar; Nishant,6,0,50,44
1657081439578,CSE 100,A01,083659,Cao; Yingjun,3,4,70,67
1657081445606,CSE 134B,A01,083661,Powell; Thomas Allan,19,0,100,81
1657081451638,CSE 140,A01,083663,Gungor; Onat,14,0,85,71
1657081457660,CSE 140L,A01,083088,Eldon; John,16,0,100,84
1657081463683,CSE 175,A01,083665,Kumar; Rakesh,3,0,25,22
1657081469709,CSE 190,A00,092507,Dubnov; Shlomo,7,0,20,13
1657081475731,ECE 45,A01,083139,Congero; Spencer William,5,0,75,70
1657081481754,ECE 65,A50,083695,Saad; Andrew S,12,0,30,18
1657081481754,ECE 65,A51,095125,Saad; Andrew S,25,0,26,1
1657081487784,ECE 109,A01,091882,Touri; Behrouz,16,0,70,54
1657081493807,ECE 180,A00,083140,Abi Samra; Nicholas Camill,1,0,30,29
1657081493807,ECE 180,B00,083141,Abi Samra; Nicholas Camill,0,0,30,30
1657081499831,MATH 10A,A01,083735,Patchell; Gregory David,1,0,30,29
1657081499831,MATH 10A,A02,083736,Patchell; Gregory David,20,0,30,10
1657081499831,MATH 10A,A03,083737,Patchell; Gregory David,16,0,30,14
1657081505854,MATH 10B,A01,083207,Lim; Seonhee,7,0,34,27
1657081505854,MATH 10B,A02,083208,Lim; Seonhee,9,0,35,26
1657081505854,MATH 10B,A03,093472,Lim; Seonhee,4,0,34,30
1657081505854,MATH 10B,B01,083739,Sinha; Shubham,9,0,30,21
1657081511899,MATH 18,A01,083743,Cinel; Cameron Alexander,6,0,30,24
1657081511899,MATH 18,A02,083744,Cinel; Cameron Alexander,15,0,30,15
1657081511899,MATH 18,A03,083745,Cinel; Cameron Alexander,8,0,30,22
1657081511899,MATH 18,B01,083748,Rideout; David Porter,4,0,37,33
1657081511899,MATH 18,B02,083749,Rideout; David Porter,3,0,36,33
1657081511899,MATH 18,B03,083750,Rideout; David Porter,2,0,37,35
1657081511899,MATH 18,B04,083751,Rideout; David Porter,5,0,36,31
1657081511899,MATH 18,B05,093473,Rideout; David Porter,4,0,36,32
1657081511899,MATH 18,B06,093474,Rideout; David Porter,5,0,36,31
1657081517921,MATH 20A,A01,083754,Zheng; Zequn,12,0,40,28
1657081523956,MATH 20B,A01,083756,Briones; Jor-el Thomas Caparas,1,0,36,35
1657081523956,MATH 20B,A02,083757,Briones; Jor-el Thomas Caparas,1,0,36,35
1657081523956,MATH 20B,A03,093475,Briones; Jor-el Thomas Caparas,0,0,36,36
1657081529984,MATH 20C,A01,083760,Briones; Jor-el Thomas Caparas,1,0,35,34
1657081529984,MATH 20C,A02,083761,Briones; Jor-el Thomas Caparas,8,0,35,27
1657081529984,MATH 20C,A03,093476,Briones; Jor-el Thomas Caparas,0,1,36,36
1657081529984,MATH 20C,B01,083762,Bach; Quang Tran,0,0,30,30
1657081536012,MATH 20D,A01,083765,Tran; Brian Kha,4,0,30,26
1657081536012,MATH 20D,A02,083766,Tran; Brian Kha,5,0,30,25
1657081536012,MATH 20D,A03,083767,Tran; Brian Kha,3,0,30,27
1657081542038,MATH 20E,A01,083771,Ganguly; Soumya,5,0,32,27
1657081542038,MATH 20E,A02,083772,Ganguly; Soumya,6,0,32,26
1657081542038,MATH 20E,B01,083773,Ciotti; Benjamin,18,0,35,17
1657081542038,MATH 20E,B02,083774,Ciotti; Benjamin,17,0,35,18
1657081548153,MATH 103A,A01,083777,Greenfeld; Be'Eri,2,0,36,34
1657081548153,MATH 103A,A02,083778,Greenfeld; Be'Eri,5,0,36,31
1657081548153,MATH 103A,A03,093561,Greenfeld; Be'Eri,4,0,36,32
1657081548153,MATH 103A,B01,083779,Greenfeld; Be'Eri,6,0,36,30
1657081548153,MATH 103A,B02,083780,Greenfeld; Be'Eri,2,0,36,34
1657081548153,MATH 103A,B03,093562,Greenfeld; Be'Eri,3,0,36,33
1657081554177,MATH 105,A01,085443,Carter; Anne Toulson,14,0,35,21
1657081554177,MATH 105,A02,093477,Carter; Anne Toulson,20,0,35,15
1657081560205,MATH 109,A01,083213,Ganzberger; Geoffrey Michael,2,0,34,32
1657081560205,MATH 109,A02,083214,Ganzberger; Geoffrey Michael,2,0,34,32
1657081560205,MATH 109,A03,093478,Ganzberger; Geoffrey Michael,1,0,34,33
1657081560205,MATH 109,B01,083215,Ganzberger; Geoffrey Michael,1,0,32,31
1657081560205,MATH 109,B02,083216,Ganzberger; Geoffrey Michael,1,0,32,31
1657081560205,MATH 109,B03,093479,Ganzberger; Geoffrey Michael,6,0,32,26
1657081566234,MATH 142A,A01,083219,Chow; Bennett,6,0,32,26
1657081566234,MATH 142A,A02,083220,Chow; Bennett,10,0,32,22
1657081566234,MATH 142A,A03,093480,Chow; Bennett,7,0,32,25
1657081566234,MATH 142A,B03,093481,Chow; Bennett,8,0,32,24
1657081566234,MATH 142A,B04,093558,Chow; Bennett,11,0,32,21
1657081566234,MATH 142A,B05,093559,Chow; Bennett,6,0,32,26
1657081572261,MATH 193A,A01,083224,Rotar; Vladimir,7,0,34,27
1657081572261,MATH 193A,A02,083225,Rotar; Vladimir,5,0,34,29
1657081572261,MATH 193A,A03,083781,Rotar; Vladimir,1,0,34,33
1657081572261,MATH 193A,A04,083782,Rotar; Vladimir,6,0,34,28
1657081572261,MATH 193A,A05,093482,Rotar; Vladimir,6,0,34,28
1657081578285,MATH 197,001,091859,McAuley; Julian John,9999,0,9999,0
1657081578285,MATH 197,002,095566,Kedlaya; Kiran S.,9997,0,9999,2
1657081578285,MATH 197,003,095567,Xiao; Ming,9999,0,9999,0
1657081578285,MATH 197,004,095571,Perols; Johan Lars,9998,0,9999,1
1657081585347,COGS 9,A01,083615,Shannon; Kyle Michael,7,0,75,68
1657081591369,COGS 11,A01,083617,Boyle; Mary E. T.,21,0,48,27
1657081597396,COGS 13,A01,083071,Bastos; Amalia Pinkusfeld,9,0,71,62
1657081603420,COGS 14A,A01,092681,Semenuks; Arturs,1,1,100,99
1657081609447,COGS 14B,A01,083073,Cheng; Tzu-Han,5,0,63,58
1657081615478,COGS 17,A01,092677,Semenuks; Arturs,4,0,81,77
1657081621505,COGS 100,A01,083619,Allen; Michael Gordon,15,0,70,55
1657081627528,COGS 101A,A01,083621,Davis; Joshua Daniel,9,0,68,59
1657081633555,COGS 101B,A01,091572,Allen; Michael Gordon,8,0,65,57
1657081639583,COGS 101C,A01,083625,Delgado; Tania,17,0,35,18
1657081645606,COGS 107A,A01,083627,Boyle; Mary E. T.,13,0,60,47
1657081651630,COGS 118A,A01,083075,Gupta; Anjum,15,0,76,61
1657081657654,CSE 3,A50,083646,Miranda; Gregory Joseph,22,0,50,28
1657081663688,CSE 8A,A50,083650,Miranda; Gregory Joseph,17,1,56,39
1657081669710,CSE 11,A01,083080,Cao; Yingjun,4,15,40,36
1657081675742,CSE 12,A01,083652,Krause-Levy; Sophia Louisa,23,1,120,97
1657081681767,CSE 15L,A01,083654,Morris; Justin Loren,9,0,50,41
1657081681767,CSE 15L,A02,083655,Morris; Justin Loren,9,0,50,41
1657081687789,CSE 20,A01,083657,Tran; Khoa Dang,37,0,80,43
1657081693812,CSE 21,A01,095574,Bach; Quang Tran,21,0,48,27
1657081699839,CSE 30,A01,083084,Eldon; John,4,0,80,76
1657081699839,CSE 30,B01,095061,Bhaskar; Nishant,6,0,50,44
1657081705863,CSE 100,A01,083659,Cao; Yingjun,3,4,70,67
1657081711889,CSE 134B,A01,083661,Powell; Thomas Allan,19,0,100,81
1657081717921,CSE 140,A01,083663,Gungor; Onat,14,0,85,71
1657081723952,CSE 140L,A01,083088,Eldon; John,16,0,100,84
1657081729975,CSE 175,A01,083665,Kumar; Rakesh,3,0,25,22
1657081735998,CSE 190,A00,092507,Dubnov; Shlomo,7,0,20,13
1657081742021,ECE 45,A01,083139,Congero; Spencer William,5,0,75,70
1657081748049,ECE 65,A50,083695,Saad; Andrew S,12,0,30,18
1657081748049,ECE 65,A51,095125,Saad; Andrew S,25,0,26,1
1657081754071,ECE 109,A01,091882,Touri; Behrouz,16,0,70,54
1657081760100,ECE 180,A00,083140,Abi Samra; Nicholas Camill,1,0,30,29
1657081760100,ECE 180,B00,083141,Abi Samra; Nicholas Camill,0,0,30,30
1657081766124,MATH 10A,A01,083735,Patchell; Gregory David,1,0,30,29
1657081766124,MATH 10A,A02,083736,Patchell; Gregory David,20,0,30,10
1657081766124,MATH 10A,A03,083737,Patchell; Gregory David,16,0,30,14
1657081772148,MATH 10B,A01,083207,Lim; Seonhee,7,0,34,27
1657081772148,MATH 10B,A02,083208,Lim; Seonhee,9,0,35,26
1657081772148,MATH 10B,A03,093472,Lim; Seonhee,4,0,34,30
1657081772148,MATH 10B,B01,083739,Sinha; Shubham,9,0,30,21
1657081778175,MATH 18,A01,083743,Cinel; Cameron Alexander,6,0,30,24
1657081778175,MATH 18,A02,083744,Cinel; Cameron Alexander,15,0,30,15
1657081778175,MATH 18,A03,083745,Cinel; Cameron Alexander,8,0,30,22
1657081778175,MATH 18,B01,083748,Rideout; David Porter,4,0,37,33
1657081778175,MATH 18,B02,083749,Rideout; David Porter,3,0,36,33
1657081778175,MATH 18,B03,083750,Rideout; David Porter,2,0,37,35
1657081778175,MATH 18,B04,083751,Rideout; David Porter,5,0,36,31
1657081778175,MATH 18,B05,093473,Rideout; David Porter,4,0,36,32
1657081778175,MATH 18,B06,093474,Rideout; David Porter,5,0,36,31
1657081784203,MATH 20A,A01,083754,Zheng; Zequn,12,0,40,28
1657081790227,MATH 20B,A01,083756,Briones; Jor-el Thomas Caparas,1,0,36,35
1657081790227,MATH 20B,A02,083757,Briones; Jor-el Thomas Caparas,1,0,36,35
1657081790227,MATH 20B,A03,093475,Briones; Jor-el Thomas Caparas,0,0,36,36
1657081796255,MATH 20C,A01,083760,Briones; Jor-el Thomas Caparas,1,0,35,34
1657081796255,MATH 20C,A02,083761,Briones; Jor-el Thomas Caparas,8,0,35,27
1657081796255,MATH 20C,A03,093476,Briones; Jor-el Thomas Caparas,0,1,36,36
1657081796255,MATH 20C,B01,083762,Bach; Quang Tran,0,0,30,30
1657081802279,MATH 20D,A01,083765,Tran; Brian Kha,4,0,30,26
1657081802279,MATH 20D,A02,083766,Tran; Brian Kha,5,0,30,25
1657081802279,MATH 20D,A03,083767,Tran; Brian Kha,3,0,30,27
1657081808303,MATH 20E,A01,083771,Ganguly; Soumya,5,0,32,27
1657081808303,MATH 20E,A02,083772,Ganguly; Soumya,6,0,32,26
1657081808303,MATH 20E,B01,083773,Ciotti; Benjamin,18,0,35,17
1657081808303,MATH 20E,B02,083774,Ciotti; Benjamin,17,0,35,18
1657081814332,MATH 103A,A01,083777,Greenfeld; Be'Eri,2,0,36,34
1657081814332,MATH 103A,A02,083778,Greenfeld; Be'Eri,5,0,36,31
1657081814332,MATH 103A,A03,093561,Greenfeld; Be'Eri,4,0,36,32
1657081814332,MATH 103A,B01,083779,Greenfeld; Be'Eri,6,0,36,30
1657081814332,MATH 103A,B02,083780,Greenfeld; Be'Eri,2,0,36,34
1657081814332,MATH 103A,B03,093562,Greenfeld; Be'Eri,3,0,36,33
1657081820355,MATH 105,A01,085443,Carter; Anne Toulson,14,0,35,21
1657081820355,MATH 105,A02,093477,Carter; Anne Toulson,20,0,35,15
1657081826384,MATH 109,A01,083213,Ganzberger; Geoffrey Michael,2,0,34,32
1657081826384,MATH 109,A02,083214,Ganzberger; Geoffrey Michael,2,0,34,32
1657081826384,MATH 109,A03,093478,Ganzberger; Geoffrey Michael,1,0,34,33
1657081826384,MATH 109,B01,083215,Ganzberger; Geoffrey Michael,1,0,32,31
1657081826384,MATH 109,B02,083216,Ganzberger; Geoffrey Michael,1,0,32,31
1657081826384,MATH 109,B03,093479,Ganzberger; Geoffrey Michael,6,0,32,26
1657081832408,MATH 142A,A01,083219,Chow; Bennett,6,0,32,26
1657081832408,MATH 142A,A02,083220,Chow; Bennett,10,0,32,22
1657081832408,MATH 142A,A03,093480,Chow; Bennett,7,0,32,25
1657081832408,MATH 142A,B03,093481,Chow; Bennett,8,0,32,24
1657081832408,MATH 142A,B04,093558,Chow; Bennett,11,0,32,21
1657081832408,MATH 142A,B05,093559,Chow; Bennett,6,0,32,26
1657081838433,MATH 193A,A01,083224,Rotar; Vladimir,7,0,34,27
1657081838433,MATH 193A,A02,083225,Rotar; Vladimir,5,0,34,29
1657081838433,MATH 193A,A03,083781,Rotar; Vladimir,1,0,34,33
1657081838433,MATH 193A,A04,083782,Rotar; Vladimir,6,0,34,28
1657081838433,MATH 193A,A05,093482,Rotar; Vladimir,6,0,34,28
1657081844457,MATH 197,001,091859,McAuley; Julian John,9999,0,9999,0
1657081844457,MATH 197,002,095566,Kedlaya; Kiran S.,9997,0,9999,2
1657081844457,MATH 197,003,095567,Xiao; Ming,9999,0,9999,0
1657081844457,MATH 197,004,095571,Perols; Johan Lars,9998,0,9999,1
1657081851515,COGS 9,A01,083615,Shannon; Kyle Michael,7,0,75,68
1657081857540,COGS 11,A01,083617,Boyle; Mary E. T.,21,0,48,27
1657081863563,COGS 13,A01,083071,Bastos; Amalia Pinkusfeld,9,0,71,62
1657081869586,COGS 14A,A01,092681,Semenuks; Arturs,1,1,100,99
1657081875623,COGS 14B,A01,083073,Cheng; Tzu-Han,5,0,63,58
1657081881653,COGS 17,A01,092677,Semenuks; Arturs,4,0,81,77
1657081887676,COGS 100,A01,083619,Allen; Michael Gordon,15,0,70,55
1657081893705,COGS 101A,A01,083621,Davis; Joshua Daniel,9,0,68,59
1657081899730,COGS 101B,A01,091572,Allen; Michael Gordon,8,0,65,57
1657081905753,COGS 101C,A01,083625,Delgado; Tania,17,0,35,18
1657081911780,COGS 107A,A01,083627,Boyle; Mary E. T.,13,0,60,47
1657081917806,COGS 118A,A01,083075,Gupta; Anjum,15,0,76,61
1657081923830,CSE 3,A50,083646,Miranda; Gregory Joseph,22,0,50,28
1657081929853,CSE 8A,A50,083650,Miranda; Gregory Joseph,17,1,56,39
1657081935885,CSE 11,A01,083080,Cao; Yingjun,4,15,40,36
1657081941908,CSE 12,A01,083652,Krause-Levy; Sophia Louisa,23,1,120,97
1657081947930,CSE 15L,A01,083654,Morris; Justin Loren,9,0,50,41
1657081947930,CSE 15L,A02,083655,Morris; Justin Loren,9,0,50,41
1657081953961,CSE 20,A01,083657,Tran; Khoa Dang,37,0,80,43
1657081959984,CSE 21,A01,095574,Bach; Quang Tran,21,0,48,27
1657081966010,CSE 30,A01,083084,Eldon; John,4,0,80,76
1657081966010,CSE 30,B01,095061,Bhaskar; Nishant,6,0,50,44
1657081972035,CSE 100,A01,083659,Cao; Yingjun,3,4,70,67
1657081978058,CSE 134B,A01,083661,Powell; Thomas Allan,19,0,100,81
1657081984082,CSE 140,A01,083663,Gungor; Onat,14,0,85,71
1657081990113,CSE 140L,A01,083088,Eldon; John,16,0,100,84
1657081996136,CSE 175,A01,083665,Kumar; Rakesh,3,0,25,22
1657082002157,CSE 190,A00,092507,Dubnov; Shlomo,7,0,20,13
1657082008185,ECE 45,A01,083139,Congero; Spencer William,5,0,75,70
1657082014212,ECE 65,A50,083695,Saad; Andrew S,12,0,30,18
1657082014212,ECE 65,A51,095125,Saad; Andrew S,25,0,26,1
1657082020244,ECE 109,A01,091882,Touri; Behrouz,16,0,70,54
1657082026266,ECE 180,A00,083140,Abi Samra; Nicholas Camill,1,0,30,29
1657082026266,ECE 180,B00,083141,Abi Samra; Nicholas Camill,0,0,30,30
1657082032289,MATH 10A,A01,083735,Patchell; Gregory David,1,0,30,29
1657082032289,MATH 10A,A02,083736,Patchell; Gregory David,20,0,30,10
1657082032289,MATH 10A,A03,083737,Patchell; Gregory David,16,0,30,14
1657082038313,MATH 10B,A01,083207,Lim; Seonhee,7,0,34,27
1657082038313,MATH 10B,A02,083208,Lim; Seonhee,9,0,35,26
1657082038313,MATH 10B,A03,093472,Lim; Seonhee,4,0,34,30
1657082038313,MATH 10B,B01,083739,Sinha; Shubham,9,0,30,21
1657082044339,MATH 18,A01,083743,Cinel; Cameron Alexander,6,0,30,24
1657082044339,MATH 18,A02,083744,Cinel; Cameron Alexander,15,0,30,15
1657082044339,MATH 18,A03,083745,Cinel; Cameron Alexander,8,0,30,22
1657082044339,MATH 18,B01,083748,Rideout; David Porter,4,0,37,33
1657082044339,MATH 18,B02,083749,Rideout; David Porter,3,0,36,33
1657082044339,MATH 18,B03,083750,Rideout; David Porter,2,0,37,35
1657082044339,MATH 18,B04,083751,Rideout; David Porter,5,0,36,31
1657082044339,MATH 18,B05,093473,Rideout; David Porter,4,0,36,32
1657082044339,MATH 18,B06,093474,Rideout; David Porter,5,0,36,31
1657082050498,MATH 20A,A01,083754,Zheng; Zequn,12,0,40,28
1657082056526,MATH 20B,A01,083756,Briones; Jor-el Thomas Caparas,1,0,36,35
1657082056526,MATH 20B,A02,083757,Briones; Jor-el Thomas Caparas,1,0,36,35
1657082056526,MATH 20B,A03,093475,Briones; Jor-el Thomas Caparas,0,0,36,36
1657082062562,MATH 20C,A01,083760,Briones; Jor-el Thomas Caparas,1,0,35,34
1657082062562,MATH 20C,A02,083761,Briones; Jor-el Thomas Caparas,8,0,35,27
1657082062562,MATH 20C,A03,093476,Briones; Jor-el Thomas Caparas,0,1,36,36
1657082062562,MATH 20C,B01,083762,Bach; Quang Tran,0,0,30,30
1657082068585,MATH 20D,A01,083765,Tran; Brian Kha,4,0,30,26
1657082068585,MATH 20D,A02,083766,Tran; Brian Kha,5,0,30,25
1657082068585,MATH 20D,A03,083767,Tran; Brian Kha,3,0,30,27
1657082074617,MATH 20E,A01,083771,Ganguly; Soumya,5,0,32,27
1657082074617,MATH 20E,A02,083772,Ganguly; Soumya,6,0,32,26
1657082074617,MATH 20E,B01,083773,Ciotti; Benjamin,18,0,35,17
1657082074617,MATH 20E,B02,083774,Ciotti; Benjamin,17,0,35,18
1657082080647,MATH 103A,A01,083777,Greenfeld; Be'Eri,2,0,36,34
1657082080647,MATH 103A,A02,083778,Greenfeld; Be'Eri,5,0,36,31
1657082080647,MATH 103A,A03,093561,Greenfeld; Be'Eri,4,0,36,32
1657082080647,MATH 103A,B01,083779,Greenfeld; Be'Eri,6,0,36,30
1657082080647,MATH 103A,B02,083780,Greenfeld; Be'Eri,2,0,36,34
1657082080647,MATH 103A,B03,093562,Greenfeld; Be'Eri,3,0,36,33
1657082086669,MATH 105,A01,085443,Carter; Anne Toulson,14,0,35,21
1657082086669,MATH 105,A02,093477,Carter; Anne Toulson,20,0,35,15
1657082092693,MATH 109,A01,083213,Ganzberger; Geoffrey Michael,2,0,34,32
1657082092693,MATH 109,A02,083214,Ganzberger; Geoffrey Michael,2,0,34,32
1657082092693,MATH 109,A03,093478,Ganzberger; Geoffrey Michael,1,0,34,33
1657082092693,MATH 109,B01,083215,Ganzberger; Geoffrey Michael,1,0,32,31
1657082092693,MATH 109,B02,083216,Ganzberger; Geoffrey Michael,1,0,32,31
1657082092693,MATH 109,B03,093479,Ganzberger; Geoffrey Michael,6,0,32,26
1657082098720,MATH 142A,A01,083219,Chow; Bennett,6,0,32,26
1657082098720,MATH 142A,A02,083220,Chow; Bennett,10,0,32,22
1657082098720,MATH 142A,A03,093480,Chow; Bennett,7,0,32,25
1657082098720,MATH 142A,B03,093481,Chow; Bennett,8,0,32,24
1657082098720,MATH 142A,B04,093558,Chow; Bennett,11,0,32,21
1657082098720,MATH 142A,B05,093559,Chow; Bennett,6,0,32,26
1657082114799,MATH 193A,A01,083224,Rotar; Vladimir,7,0,34,27
1657082114799,MATH 193A,A02,083225,Rotar; Vladimir,5,0,34,29
1657082114799,MATH 193A,A03,083781,Rotar; Vladimir,1,0,34,33
1657082114799,MATH 193A,A04,083782,Rotar; Vladimir,6,0,34,28
1657082114799,MATH 193A,A05,093482,Rotar; Vladimir,6,0,34,28
1657082120823,MATH 197,001,091859,McAuley; Julian John,9999,0,9999,0
1657082120823,MATH 197,002,095566,Kedlaya; Kiran S.,9997,0,9999,2
1657082120823,MATH 197,003,095567,Xiao; Ming,9999,0,9999,0
1657082120823,MATH 197,004,095571,Perols; Johan Lars,9998,0,9999,1
1657082127888,COGS 9,A01,083615,Shannon; Kyle Michael,7,0,75,68
1657082133915,COGS 11,A01,083617,Boyle; Mary E. T.,21,0,48,27
1657082139943,COGS 13,A01,083071,Bastos; Amalia Pinkusfeld,9,0,71,62
1657082145965,COGS 14A,A01,092681,Semenuks; Arturs,1,1,100,99
1657082152083,COGS 14B,A01,083073,Cheng; Tzu-Han,5,0,63,58
1657082158111,COGS 17,A01,092677,Semenuks; Arturs,4,0,81,77
1657082164132,COGS 100,A01,083619,Allen; Michael Gordon,15,0,70,55
1657082170156,COGS 101A,A01,083621,Davis; Joshua Daniel,9,0,68,59
1657082176183,COGS 101B,A01,091572,Allen; Michael Gordon,8,0,65,57
1657082182211,COGS 101C,A01,083625,Delgado; Tania,17,0,35,18
1657082188235,COGS 107A,A01,083627,Boyle; Mary E. T.,13,0,60,47
1657082194261,COGS 118A,A01,083075,Gupta; Anjum,15,0,76,61
1657082200298,CSE 3,A50,083646,Miranda; Gregory Joseph,22,0,50,28
1657082206324,CSE 8A,A50,083650,Miranda; Gregory Joseph,17,1,56,39
1657082212347,CSE 11,A01,083080,Cao; Yingjun,4,15,40,36
1657082218370,CSE 12,A01,083652,Krause-Levy; Sophia Louisa,23,1,120,97
1657082224394,CSE 15L,A01,083654,Morris; Justin Loren,9,0,50,41
1657082224394,CSE 15L,A02,083655,Morris; Justin Loren,9,0,50,41
1657082230417,CSE 20,A01,083657,Tran; Khoa Dang,37,0,80,43
1657082236439,CSE 21,A01,095574,Bach; Quang Tran,21,0,48,27
1657082242462,CSE 30,A01,083084,Eldon; John,4,0,80,76
1657082242462,CSE 30,B01,095061,Bhaskar; Nishant,6,0,50,44
1657082248484,CSE 100,A01,083659,Cao; Yingjun,3,4,70,67
1657082254509,CSE 134B,A01,083661,Powell; Thomas Allan,19,0,100,81
1657082260543,CSE 140,A01,083663,Gungor; Onat,14,0,85,71
1657082266569,CSE 140L,A01,083088,Eldon; John,16,0,100,84
1657082272595,CSE 175,A01,083665,Kumar; Rakesh,3,0,25,22
1657082278622,CSE 190,A00,092507,Dubnov; Shlomo,7,0,20,13
1657082284647,ECE 45,A01,083139,Congero; Spencer William,5,0,75,70
1657082290674,ECE 65,A50,083695,Saad; Andrew S,12,0,30,18
1657082290674,ECE 65,A51,095125,Saad; Andrew S,25,0,26,1
1657082296698,ECE 109,A01,091882,Touri; Behrouz,16,0,70,54
1657082302723,ECE 180,A00,083140,Abi Samra; Nicholas Camill,1,0,30,29
1657082302723,ECE 180,B00,083141,Abi Samra; Nicholas Camill,0,0,30,30
1657082308746,MATH 10A,A01,083735,Patchell; Gregory David,1,0,30,29
1657082308746,MATH 10A,A02,083736,Patchell; Gregory David,20,0,30,10
1657082308746,MATH 10A,A03,083737,Patchell; Gregory David,16,0,30,14
1657082314779,MATH 10B,A01,083207,Lim; Seonhee,7,0,34,27
1657082314779,MATH 10B,A02,083208,Lim; Seonhee,9,0,35,26
1657082314779,MATH 10B,A03,093472,Lim; Seonhee,4,0,34,30
1657082314779,MATH 10B,B01,083739,Sinha; Shubham,9,0,30,21
1657082320810,MATH 18,A01,083743,Cinel; Cameron Alexander,6,0,30,24
1657082320810,MATH 18,A02,083744,Cinel; Cameron Alexander,15,0,30,15
1657082320810,MATH 18,A03,083745,Cinel; Cameron Alexander,8,0,30,22
1657082320810,MATH 18,B01,083748,Rideout; David Porter,4,0,37,33
1657082320810,MATH 18,B02,083749,Rideout; David Porter,3,0,36,33
1657082320810,MATH 18,B03,083750,Rideout; David Porter,2,0,37,35
1657082320810,MATH 18,B04,083751,Rideout; David Porter,5,0,36,31
1657082320810,MATH 18,B05,093473,Rideout; David Porter,4,0,36,32
1657082320810,MATH 18,B06,093474,Rideout; David Porter,5,0,36,31
1657082326833,MATH 20A,A01,083754,Zheng; Zequn,12,0,40,28
1657082332856,MATH 20B,A01,083756,Briones; Jor-el Thomas Caparas,1,0,36,35
1657082332856,MATH 20B,A02,083757,Briones; Jor-el Thomas Caparas,1,0,36,35
1657082332856,MATH 20B,A03,093475,Briones; Jor-el Thomas Caparas,0,0,36,36
1657082338881,MATH 20C,A01,083760,Briones; Jor-el Thomas Caparas,1,0,35,34
1657082338881,MATH 20C,A02,083761,Briones; Jor-el Thomas Caparas,8,0,35,27
1657082338881,MATH 20C,A03,093476,Briones; Jor-el Thomas Caparas,0,1,36,36
1657082338881,MATH 20C,B01,083762,Bach; Quang Tran,0,0,30,30
1657082344907,MATH 20D,A01,083765,Tran; Brian Kha,4,0,30,26
1657082344907,MATH 20D,A02,083766,Tran; Brian Kha,5,0,30,25
1657082344907,MATH 20D,A03,083767,Tran; Brian Kha,3,0,30,27
1657082350967,MATH 20E,A01,083771,Ganguly; Soumya,5,0,32,27
1657082350967,MATH 20E,A02,083772,Ganguly; Soumya,6,0,32,26
1657082350967,MATH 20E,B01,083773,Ciotti; Benjamin,18,0,35,17
1657082350967,MATH 20E,B02,083774,Ciotti; Benjamin,17,0,35,18
1657082356991,MATH 103A,A01,083777,Greenfeld; Be'Eri,2,0,36,34
1657082356991,MATH 103A,A02,083778,Greenfeld; Be'Eri,5,0,36,31
1657082356991,MATH 103A,A03,093561,Greenfeld; Be'Eri,4,0,36,32
1657082356991,MATH 103A,B01,083779,Greenfeld; Be'Eri,6,0,36,30
1657082356991,MATH 103A,B02,083780,Greenfeld; Be'Eri,2,0,36,34
1657082356991,MATH 103A,B03,093562,Greenfeld; Be'Eri,3,0,36,33
1657082363017,MATH 105,A01,085443,Carter; Anne Toulson,14,0,35,21
1657082363017,MATH 105,A02,093477,Carter; Anne Toulson,20,0,35,15
1657082369046,MATH 109,A01,083213,Ganzberger; Geoffrey Michael,2,0,34,32
1657082369046,MATH 109,A02,083214,Ganzberger; Geoffrey Michael,2,0,34,32
1657082369046,MATH 109,A03,093478,Ganzberger; Geoffrey Michael,1,0,34,33
1657082369046,MATH 109,B01,083215,Ganzberger; Geoffrey Michael,1,0,32,31
1657082369046,MATH 109,B02,083216,Ganzberger; Geoffrey Michael,1,0,32,31
1657082369046,MATH 109,B03,093479,Ganzberger; Geoffrey Michael,6,0,32,26
1657082375077,MATH 142A,A01,083219,Chow; Bennett,6,0,32,26
1657082375077,MATH 142A,A02,083220,Chow; Bennett,10,0,32,22
1657082375077,MATH 142A,A03,093480,Chow; Bennett,7,0,32,25
1657082375077,MATH 142A,B03,093481,Chow; Bennett,8,0,32,24
1657082375077,MATH 142A,B04,093558,Chow; Bennett,11,0,32,21
1657082375077,MATH 142A,B05,093559,Chow; Bennett,6,0,32,26
1657082381105,MATH 193A,A01,083224,Rotar; Vladimir,7,0,34,27
1657082381105,MATH 193A,A02,083225,Rotar; Vladimir,5,0,34,29
1657082381105,MATH 193A,A03,083781,Rotar; Vladimir,1,0,34,33
1657082381105,MATH 193A,A04,083782,Rotar; Vladimir,6,0,34,28
1657082381105,MATH 193A,A05,093482,Rotar; Vladimir,6,0,34,28
1657082387135,MATH 197,001,091859,McAuley; Julian John,9999,0,9999,0
1657082387135,MATH 197,002,095566,Kedlaya; Kiran S.,9997,0,9999,2
1657082387135,MATH 197,003,095567,Xiao; Ming,9999,0,9999,0
1657082387135,MATH 197,004,095571,Perols; Johan Lars,9998,0,9999,1
1657082394191,COGS 9,A01,083615,Shannon; Kyle Michael,7,0,75,68
1657082400217,COGS 11,A01,083617,Boyle; Mary E. T.,21,0,48,27
1657082406247,COGS 13,A01,083071,Bastos; Amalia Pinkusfeld,9,0,71,62
1657082412277,COGS 14A,A01,092681,Semenuks; Arturs,1,1,100,99
1657082418303,COGS 14B,A01,083073,Cheng; Tzu-Han,5,0,63,58
1657082424325,COGS 17,A01,092677,Semenuks; Arturs,4,0,81,77
1657082430353,COGS 100,A01,083619,Allen; Michael Gordon,15,0,70,55
1657082436379,COGS 101A,A01,083621,Davis; Joshua Daniel,9,0,68,59
1657082442406,COGS 101B,A01,091572,Allen; Michael Gordon,8,0,65,57
1657082448429,COGS 101C,A01,083625,Delgado; Tania,17,0,35,18
1657082454454,COGS 107A,A01,083627,Boyle; Mary E. T.,13,0,60,47
1657082460488,COGS 118A,A01,083075,Gupta; Anjum,15,0,76,61
1657082466515,CSE 3,A50,083646,Miranda; Gregory Joseph,22,0,50,28
1657082472540,CSE 8A,A50,083650,Miranda; Gregory Joseph,17,1,56,39
1657082478565,CSE 11,A01,083080,Cao; Yingjun,4,15,40,36
1657082484589,CSE 12,A01,083652,Krause-Levy; Sophia Louisa,23,1,120,97
1657082490617,CSE 15L,A01,083654,Morris; Justin Loren,9,0,50,41
1657082490617,CSE 15L,A02,083655,Morris; Justin Loren,9,0,50,41
1657082496640,CSE 20,A01,083657,Tran; Khoa Dang,37,0,80,43
1657082502663,CSE 21,A01,095574,Bach; Quang Tran,21,0,48,27
1657082508691,CSE 30,A01,083084,Eldon; John,4,0,80,76
1657082508691,CSE 30,B01,095061,Bhaskar; Nishant,6,0,50,44
1657082514714,CSE 100,A01,083659,Cao; Yingjun,3,4,70,67
1657082520741,CSE 134B,A01,083661,Powell; Thomas Allan,19,0,100,81
1657082526768,CSE 140,A01,083663,Gungor; Onat,14,0,85,71
1657082532792,CSE 140L,A01,083088,Eldon; John,16,0,100,84
1657082538816,CSE 175,A01,083665,Kumar; Rakesh,3,0,25,22
1657082544841,CSE 190,A00,092507,Dubnov; Shlomo,7,0,20,13
1657082550869,ECE 45,A01,083139,Congero; Spencer William,5,0,75,70
1657082556896,ECE 65,A50,083695,Saad; Andrew S,12,0,30,18
1657082556896,ECE 65,A51,095125,Saad; Andrew S,25,0,26,1
1657082562918,ECE 109,A01,091882,Touri; Behrouz,16,0,70,54
1657082568945,ECE 180,A00,083140,Abi Samra; Nicholas Camill,1,0,30,29
1657082568945,ECE 180,B00,083141,Abi Samra; Nicholas Camill,0,0,30,30
1657082574972,MATH 10A,A01,083735,Patchell; Gregory David,1,0,30,29
1657082574972,MATH 10A,A02,083736,Patchell; Gregory David,20,0,30,10
1657082574972,MATH 10A,A03,083737,Patchell; Gregory David,16,0,30,14
1657082580999,MATH 10B,A01,083207,Lim; Seonhee,7,0,34,27
1657082580999,MATH 10B,A02,083208,Lim; Seonhee,9,0,35,26
1657082580999,MATH 10B,A03,093472,Lim; Seonhee,4,0,34,30
1657082580999,MATH 10B,B01,083739,Sinha; Shubham,9,0,30,21
1657082587022,MATH 18,A01,083743,Cinel; Cameron Alexander,6,0,30,24
1657082587022,MATH 18,A02,083744,Cinel; Cameron Alexander,15,0,30,15
1657082587022,MATH 18,A03,083745,Cinel; Cameron Alexander,8,0,30,22
1657082587022,MATH 18,B01,083748,Rideout; David Porter,4,0,37,33
1657082587022,MATH 18,B02,083749,Rideout; David Porter,3,0,36,33
1657082587022,MATH 18,B03,083750,Rideout; David Porter,2,0,37,35
1657082587022,MATH 18,B04,083751,Rideout; David Porter,5,0,36,31
1657082587022,MATH 18,B05,093473,Rideout; David Porter,4,0,36,32
1657082587022,MATH 18,B06,093474,Rideout; David Porter,5,0,36,31
1657082593046,MATH 20A,A01,083754,Zheng; Zequn,12,0,40,28
1657082599067,MATH 20B,A01,083756,Briones; Jor-el Thomas Caparas,1,0,36,35
1657082599067,MATH 20B,A02,083757,Briones; Jor-el Thomas Caparas,1,0,36,35
1657082599067,MATH 20B,A03,093475,Briones; Jor-el Thomas Caparas,0,0,36,36
1657082605091,MATH 20C,A01,083760,Briones; Jor-el Thomas Caparas,1,0,35,34
1657082605091,MATH 20C,A02,083761,Briones; Jor-el Thomas Caparas,8,0,35,27
1657082605091,MATH 20C,A03,093476,Briones; Jor-el Thomas Caparas,0,1,36,36
1657082605091,MATH 20C,B01,083762,Bach; Quang Tran,0,0,30,30
1657082611115,MATH 20D,A01,083765,Tran; Brian Kha,4,0,30,26
1657082611115,MATH 20D,A02,083766,Tran; Brian Kha,5,0,30,25
1657082611115,MATH 20D,A03,083767,Tran; Brian Kha,3,0,30,27
1657082617142,MATH 20E,A01,083771,Ganguly; Soumya,5,0,32,27
1657082617142,MATH 20E,A02,083772,Ganguly; Soumya,6,0,32,26
1657082617142,MATH 20E,B01,083773,Ciotti; Benjamin,18,0,35,17
1657082617142,MATH 20E,B02,083774,Ciotti; Benjamin,17,0,35,18
1657082623165,MATH 103A,A01,083777,Greenfeld; Be'Eri,2,0,36,34
1657082623165,MATH 103A,A02,083778,Greenfeld; Be'Eri,5,0,36,31
1657082623165,MATH 103A,A03,093561,Greenfeld; Be'Eri,4,0,36,32
1657082623165,MATH 103A,B01,083779,Greenfeld; Be'Eri,6,0,36,30
1657082623165,MATH 103A,B02,083780,Greenfeld; Be'Eri,2,0,36,34
1657082623165,MATH 103A,B03,093562,Greenfeld; Be'Eri,3,0,36,33
1657082629193,MATH 105,A01,085443,Carter; Anne Toulson,14,0,35,21
1657082629193,MATH 105,A02,093477,Carter; Anne Toulson,20,0,35,15
1657082635216,MATH 109,A01,083213,Ganzberger; Geoffrey Michael,2,0,34,32
1657082635216,MATH 109,A02,083214,Ganzberger; Geoffrey Michael,2,0,34,32
1657082635216,MATH 109,A03,093478,Ganzberger; Geoffrey Michael,1,0,34,33
1657082635216,MATH 109,B01,083215,Ganzberger; Geoffrey Michael,1,0,32,31
1657082635216,MATH 109,B02,083216,Ganzberger; Geoffrey Michael,1,0,32,31
1657082635216,MATH 109,B03,093479,Ganzberger; Geoffrey Michael,6,0,32,26
1657082641245,MATH 142A,A01,083219,Chow; Bennett,6,0,32,26
1657082641245,MATH 142A,A02,083220,Chow; Bennett,10,0,32,22
1657082641245,MATH 142A,A03,093480,Chow; Bennett,7,0,32,25
1657082641245,MATH 142A,B03,093481,Chow; Bennett,8,0,32,24
1657082641245,MATH 142A,B04,093558,Chow; Bennett,11,0,32,21
1657082641245,MATH 142A,B05,093559,Chow; Bennett,6,0,32,26
1657082647273,MATH 193A,A01,083224,Rotar; Vladimir,7,0,34,27
1657082647273,MATH 193A,A02,083225,Rotar; Vladimir,5,0,34,29
1657082647273,MATH 193A,A03,083781,Rotar; Vladimir,1,0,34,33
1657082647273,MATH 193A,A04,083782,Rotar; Vladimir,6,0,34,28
1657082647273,MATH 193A,A05,093482,Rotar; Vladimir,6,0,34,28
1657082653301,MATH 197,001,091859,McAuley; Julian John,9999,0,9999,0
1657082653301,MATH 197,002,095566,Kedlaya; Kiran S.,9997,0,9999,2
1657082653301,MATH 197,003,095567,Xiao; Ming,9999,0,9999,0
1657082653301,MATH 197,004,095571,Perols; Johan Lars,9998,0,9999,1
1657082660363,COGS 9,A01,083615,Shannon; Kyle Michael,7,0,75,68
1657082666391,COGS 11,A01,083617,Boyle; Mary E. T.,21,0,48,27
1657082672419,COGS 13,A01,083071,Bastos; Amalia Pinkusfeld,9,0,71,62
1657082678443,COGS 14A,A01,092681,Semenuks; Arturs,1,1,100,99
1657082684467,COGS 14B,A01,083073,Cheng; Tzu-Han,5,0,63,58
1657082690492,COGS 17,A01,092677,Semenuks; Arturs,4,0,81,77
1657082696521,COGS 100,A01,083619,Allen; Michael Gordon,15,0,70,55
1657082702547,COGS 101A,A01,083621,Davis; Joshua Daniel,9,0,68,59
1657082708574,COGS 101B,A01,091572,Allen; Michael Gordon,8,0,65,57
1657082714596,COGS 101C,A01,083625,Delgado; Tania,17,0,35,18
1657082720621,COGS 107A,A01,083627,Boyle; Mary E. T.,13,0,60,47
1657082726648,COGS 118A,A01,083075,Gupta; Anjum,15,0,76,61
1657082732670,CSE 3,A50,083646,Miranda; Gregory Joseph,22,0,50,28
1657082738695,CSE 8A,A50,083650,Miranda; Gregory Joseph,17,1,56,39
1657082744719,CSE 11,A01,083080,Cao; Yingjun,4,15,40,36
1657082750841,CSE 12,A01,083652,Krause-Levy; Sophia Louisa,23,1,120,97
1657082756869,CSE 15L,A01,083654,Morris; Justin Loren,9,0,50,41
1657082756869,CSE 15L,A02,083655,Morris; Justin Loren,9,0,50,41
1657082762894,CSE 20,A01,083657,Tran; Khoa Dang,37,0,80,43
1657082768920,CSE 21,A01,095574,Bach; Quang Tran,21,0,48,27
1657082774945,CSE 30,A01,083084,Eldon; John,4,0,80,76
1657082774945,CSE 30,B01,095061,Bhaskar; Nishant,6,0,50,44
1657082780972,CSE 100,A01,083659,Cao; Yingjun,3,4,70,67
1657082786998,CSE 134B,A01,083661,Powell; Thomas Allan,19,0,100,81
1657082793029,CSE 140,A01,083663,Gungor; Onat,14,0,85,71
1657082799052,CSE 140L,A01,083088,Eldon; John,16,0,100,84
1657082805077,CSE 175,A01,083665,Kumar; Rakesh,3,0,25,22
1657082811106,CSE 190,A00,092507,Dubnov; Shlomo,7,0,20,13
1657082817130,ECE 45,A01,083139,Congero; Spencer William,5,0,75,70
1657082823151,ECE 65,A50,083695,Saad; Andrew S,12,0,30,18
1657082823151,ECE 65,A51,095125,Saad; Andrew S,25,0,26,1
1657082829174,ECE 109,A01,091882,Touri; Behrouz,16,0,70,54
1657082835202,ECE 180,A00,083140,Abi Samra; Nicholas Camill,1,0,30,29
1657082835202,ECE 180,B00,083141,Abi Samra; Nicholas Camill,0,0,30,30
1657082841225,MATH 10A,A01,083735,Patchell; Gregory David,1,0,30,29
1657082841225,MATH 10A,A02,083736,Patchell; Gregory David,20,0,30,10
1657082841225,MATH 10A,A03,083737,Patchell; Gregory David,16,0,30,14
1657082847248,MATH 10B,A01,083207,Lim; Seonhee,7,0,34,27
1657082847248,MATH 10B,A02,083208,Lim; Seonhee,9,0,35,26
1657082847248,MATH 10B,A03,093472,Lim; Seonhee,4,0,34,30
1657082847248,MATH 10B,B01,083739,Sinha; Shubham,9,0,30,21
1657082853278,MATH 18,A01,083743,Cinel; Cameron Alexander,6,0,30,24
1657082853278,MATH 18,A02,083744,Cinel; Cameron Alexander,15,0,30,15
1657082853278,MATH 18,A03,083745,Cinel; Cameron Alexander,8,0,30,22
1657082853278,MATH 18,B01,083748,Rideout; David Porter,4,0,37,33
1657082853278,MATH 18,B02,083749,Rideout; David Porter,3,0,36,33
1657082853278,MATH 18,B03,083750,Rideout; David Porter,2,0,37,35
1657082853278,MATH 18,B04,083751,Rideout; David Porter,5,0,36,31
1657082853278,MATH 18,B05,093473,Rideout; David Porter,4,0,36,32
1657082853278,MATH 18,B06,093474,Rideout; David Porter,5,0,36,31
1657082859305,MATH 20A,A01,083754,Zheng; Zequn,12,0,40,28
1657082865329,MATH 20B,A01,083756,Briones; Jor-el Thomas Caparas,1,0,36,35
1657082865329,MATH 20B,A02,083757,Briones; Jor-el Thomas Caparas,1,0,36,35
1657082865329,MATH 20B,A03,093475,Briones; Jor-el Thomas Caparas,0,0,36,36
1657082871356,MATH 20C,A01,083760,Briones; Jor-el Thomas Caparas,1,0,35,34
1657082871356,MATH 20C,A02,083761,Briones; Jor-el Thomas Caparas,8,0,35,27
1657082871356,MATH 20C,A03,093476,Briones; Jor-el Thomas Caparas,0,1,36,36
1657082871356,MATH 20C,B01,083762,Bach; Quang Tran,0,0,30,30
1657082877381,MATH 20D,A01,083765,Tran; Brian Kha,4,0,30,26
1657082877381,MATH 20D,A02,083766,Tran; Brian Kha,5,0,30,25
1657082877381,MATH 20D,A03,083767,Tran; Brian Kha,3,0,30,27
1657082883404,MATH 20E,A01,083771,Ganguly; Soumya,5,0,32,27
1657082883404,MATH 20E,A02,083772,Ganguly; Soumya,6,0,32,26
1657082883404,MATH 20E,B01,083773,Ciotti; Benjamin,18,0,35,17
1657082883404,MATH 20E,B02,083774,Ciotti; Benjamin,17,0,35,18
1657082889432,MATH 103A,A01,083777,Greenfeld; Be'Eri,2,0,36,34
1657082889432,MATH 103A,A02,083778,Greenfeld; Be'Eri,5,0,36,31
1657082889432,MATH 103A,A03,093561,Greenfeld; Be'Eri,4,0,36,32
1657082889432,MATH 103A,B01,083779,Greenfeld; Be'Eri,6,0,36,30
1657082889432,MATH 103A,B02,083780,Greenfeld; Be'Eri,2,0,36,34
1657082889432,MATH 103A,B03,093562,Greenfeld; Be'Eri,3,0,36,33
1657082895456,MATH 105,A01,085443,Carter; Anne Toulson,14,0,35,21
1657082895456,MATH 105,A02,093477,Carter; Anne Toulson,20,0,35,15
1657082901483,MATH 109,A01,083213,Ganzberger; Geoffrey Michael,2,0,34,32
1657082901483,MATH 109,A02,083214,Ganzberger; Geoffrey Michael,2,0,34,32
1657082901483,MATH 109,A03,093478,Ganzberger; Geoffrey Michael,1,0,34,33
1657082901483,MATH 109,B01,083215,Ganzberger; Geoffrey Michael,1,0,32,31
1657082901483,MATH 109,B02,083216,Ganzberger; Geoffrey Michael,1,0,32,31
1657082901483,MATH 109,B03,093479,Ganzberger; Geoffrey Michael,6,0,32,26
1657082907507,MATH 142A,A01,083219,Chow; Bennett,6,0,32,26
1657082907507,MATH 142A,A02,083220,Chow; Bennett,10,0,32,22
1657082907507,MATH 142A,A03,093480,Chow; Bennett,7,0,32,25
1657082907507,MATH 142A,B03,093481,Chow; Bennett,8,0,32,24
1657082907507,MATH 142A,B04,093558,Chow; Bennett,11,0,32,21
1657082907507,MATH 142A,B05,093559,Chow; Bennett,6,0,32,26
1657082913529,MATH 193A,A01,083224,Rotar; Vladimir,7,0,34,27
1657082913529,MATH 193A,A02,083225,Rotar; Vladimir,5,0,34,29
1657082913529,MATH 193A,A03,083781,Rotar; Vladimir,1,0,34,33
1657082913529,MATH 193A,A04,083782,Rotar; Vladimir,6,0,34,28
1657082913529,MATH 193A,A05,093482,Rotar; Vladimir,6,0,34,28
1657082919550,MATH 197,001,091859,McAuley; Julian John,9999,0,9999,0
1657082919550,MATH 197,002,095566,Kedlaya; Kiran S.,9997,0,9999,2
1657082919550,MATH 197,003,095567,Xiao; Ming,9999,0,9999,0
1657082919550,MATH 197,004,095571,Perols; Johan Lars,9998,0,9999,1
1657082926619,COGS 9,A01,083615,Shannon; Kyle Michael,7,0,75,68
1657082932643,COGS 11,A01,083617,Boyle; Mary E. T.,21,0,48,27
1657082938667,COGS 13,A01,083071,Bastos; Amalia Pinkusfeld,9,0,71,62
1657082944688,COGS 14A,A01,092681,Semenuks; Arturs,1,1,100,99
1657082950718,COGS 14B,A01,083073,Cheng; Tzu-Han,5,0,63,58
1657082956741,COGS 17,A01,092677,Semenuks; Arturs,4,0,81,77
1657082962762,COGS 100,A01,083619,Allen; Michael Gordon,15,0,70,55
1657082968784,COGS 101A,A01,083621,Davis; Joshua Daniel,9,0,68,59
1657082974811,COGS 101B,A01,091572,Allen; Michael Gordon,8,0,65,57
1657082980834,COGS 101C,A01,083625,Delgado; Tania,17,0,35,18
1657082986857,COGS 107A,A01,083627,Boyle; Mary E. T.,13,0,60,47
1657082992881,COGS 118A,A01,083075,Gupta; Anjum,15,0,76,61
1657082998905,CSE 3,A50,083646,Miranda; Gregory Joseph,22,0,50,28
1657083004933,CSE 8A,A50,083650,Miranda; Gregory Joseph,17,1,56,39
1657083010956,CSE 11,A01,083080,Cao; Yingjun,4,15,40,36
1657083016983,CSE 12,A01,083652,Krause-Levy; Sophia Louisa,23,1,120,97
1657083023006,CSE 15L,A01,083654,Morris; Justin Loren,9,0,50,41
1657083023006,CSE 15L,A02,083655,Morris; Justin Loren,9,0,50,41
1657083029026,CSE 20,A01,083657,Tran; Khoa Dang,37,0,80,43
1657083035067,CSE 21,A01,095574,Bach; Quang Tran,21,0,48,27
1657083041101,CSE 30,A01,083084,Eldon; John,4,0,80,76
1657083041101,CSE 30,B01,095061,Bhaskar; Nishant,6,0,50,44
1657083047128,CSE 100,A01,083659,Cao; Yingjun,3,4,70,67
1657083053151,CSE 134B,A01,083661,Powell; Thomas Allan,19,0,100,81
1657083059175,CSE 140,A01,083663,Gungor; Onat,14,0,85,71
1657083065202,CSE 140L,A01,083088,Eldon; John,16,0,100,84
1657083071226,CSE 175,A01,083665,Kumar; Rakesh,3,0,25,22
1657083077255,CSE 190,A00,092507,Dubnov; Shlomo,7,0,20,13
1657083083278,ECE 45,A01,083139,Congero; Spencer William,5,0,75,70
1657083089307,ECE 65,A50,083695,Saad; Andrew S,12,0,30,18
1657083089307,ECE 65,A51,095125,Saad; Andrew S,25,0,26,1
1657083095346,ECE 109,A01,091882,Touri; Behrouz,16,0,70,54
1657083101370,ECE 180,A00,083140,Abi Samra; Nicholas Camill,1,0,30,29
1657083101370,ECE 180,B00,083141,Abi Samra; Nicholas Camill,0,0,30,30
1657083107398,MATH 10A,A01,083735,Patchell; Gregory David,1,0,30,29
1657083107398,MATH 10A,A02,083736,Patchell; Gregory David,20,0,30,10
1657083107398,MATH 10A,A03,083737,Patchell; Gregory David,16,0,30,14
1657083113423,MATH 10B,A01,083207,Lim; Seonhee,7,0,34,27
1657083113423,MATH 10B,A02,083208,Lim; Seonhee,9,0,35,26
1657083113423,MATH 10B,A03,093472,Lim; Seonhee,4,0,34,30
1657083113423,MATH 10B,B01,083739,Sinha; Shubham,9,0,30,21
1657083119454,MATH 18,A01,083743,Cinel; Cameron Alexander,6,0,30,24
1657083119454,MATH 18,A02,083744,Cinel; Cameron Alexander,15,0,30,15
1657083119454,MATH 18,A03,083745,Cinel; Cameron Alexander,8,0,30,22
1657083119454,MATH 18,B01,083748,Rideout; David Porter,4,0,37,33
1657083119454,MATH 18,B02,083749,Rideout; David Porter,3,0,36,33
1657083119454,MATH 18,B03,083750,Rideout; David Porter,2,0,37,35
1657083119454,MATH 18,B04,083751,Rideout; David Porter,5,0,36,31
1657083119454,MATH 18,B05,093473,Rideout; David Porter,4,0,36,32
1657083119454,MATH 18,B06,093474,Rideout; David Porter,5,0,36,31
1657083125476,MATH 20A,A01,083754,Zheng; Zequn,12,0,40,28
1657083131507,MATH 20B,A01,083756,Briones; Jor-el Thomas Caparas,1,0,36,35
1657083131507,MATH 20B,A02,083757,Briones; Jor-el Thomas Caparas,1,0,36,35
1657083131507,MATH 20B,A03,093475,Briones; Jor-el Thomas Caparas,0,0,36,36
1657083137531,MATH 20C,A01,083760,Briones; Jor-el Thomas Caparas,1,0,35,34
1657083137531,MATH 20C,A02,083761,Briones; Jor-el Thomas Caparas,8,0,35,27
1657083137531,MATH 20C,A03,093476,Briones; Jor-el Thomas Caparas,0,1,36,36
1657083137531,MATH 20C,B01,083762,Bach; Quang Tran,0,0,30,30
1657083143555,MATH 20D,A01,083765,Tran; Brian Kha,4,0,30,26
1657083143555,MATH 20D,A02,083766,Tran; Brian Kha,5,0,30,25
1657083143555,MATH 20D,A03,083767,Tran; Brian Kha,3,0,30,27
1657083149584,MATH 20E,A01,083771,Ganguly; Soumya,5,0,32,27
1657083149584,MATH 20E,A02,083772,Ganguly; Soumya,6,0,32,26
1657083149584,MATH 20E,B01,083773,Ciotti; Benjamin,18,0,35,17
1657083149584,MATH 20E,B02,083774,Ciotti; Benjamin,17,0,35,18
1657083155609,MATH 103A,A01,083777,Greenfeld; Be'Eri,2,0,36,34
1657083155609,MATH 103A,A02,083778,Greenfeld; Be'Eri,5,0,36,31
1657083155609,MATH 103A,A03,093561,Greenfeld; Be'Eri,4,0,36,32
1657083155609,MATH 103A,B01,083779,Greenfeld; Be'Eri,6,0,36,30
1657083155609,MATH 103A,B02,083780,Greenfeld; Be'Eri,2,0,36,34
1657083155609,MATH 103A,B03,093562,Greenfeld; Be'Eri,3,0,36,33
1657083161632,MATH 105,A01,085443,Carter; Anne Toulson,14,0,35,21
1657083161632,MATH 105,A02,093477,Carter; Anne Toulson,20,0,35,15
1657083167657,MATH 109,A01,083213,Ganzberger; Geoffrey Michael,2,0,34,32
1657083167657,MATH 109,A02,083214,Ganzberger; Geoffrey Michael,2,0,34,32
1657083167657,MATH 109,A03,093478,Ganzberger; Geoffrey Michael,1,0,34,33
1657083167657,MATH 109,B01,083215,Ganzberger; Geoffrey Michael,1,0,32,31
1657083167657,MATH 109,B02,083216,Ganzberger; Geoffrey Michael,1,0,32,31
1657083167657,MATH 109,B03,093479,Ganzberger; Geoffrey Michael,6,0,32,26
1657083173682,MATH 142A,A01,083219,Chow; Bennett,6,0,32,26
1657083173682,MATH 142A,A02,083220,Chow; Bennett,10,0,32,22
1657083173682,MATH 142A,A03,093480,Chow; Bennett,7,0,32,25
1657083173682,MATH 142A,B03,093481,Chow; Bennett,8,0,32,24
1657083173682,MATH 142A,B04,093558,Chow; Bennett,11,0,32,21
1657083173682,MATH 142A,B05,093559,Chow; Bennett,6,0,32,26
1657083179709,MATH 193A,A01,083224,Rotar; Vladimir,7,0,34,27
1657083179709,MATH 193A,A02,083225,Rotar; Vladimir,5,0,34,29
1657083179709,MATH 193A,A03,083781,Rotar; Vladimir,1,0,34,33
1657083179709,MATH 193A,A04,083782,Rotar; Vladimir,6,0,34,28
1657083179709,MATH 193A,A05,093482,Rotar; Vladimir,6,0,34,28
1657083185735,MATH 197,001,091859,McAuley; Julian John,9999,0,9999,0
1657083185735,MATH 197,002,095566,Kedlaya; Kiran S.,9997,0,9999,2
1657083185735,MATH 197,003,095567,Xiao; Ming,9999,0,9999,0
1657083185735,MATH 197,004,095571,Perols; Johan Lars,9998,0,9999,1
1657083192787,COGS 9,A01,083615,Shannon; Kyle Michael,7,0,75,68
1657083198810,COGS 11,A01,083617,Boyle; Mary E. T.,21,0,48,27
1657083204836,COGS 13,A01,083071,Bastos; Amalia Pinkusfeld,9,0,71,62
1657083210859,COGS 14A,A01,092681,Semenuks; Arturs,1,1,100,99
1657083216882,COGS 14B,A01,083073,Cheng; Tzu-Han,5,0,63,58
1657083222908,COGS 17,A01,092677,Semenuks; Arturs,4,0,81,77
1657083228936,COGS 100,A01,083619,Allen; Michael Gordon,15,0,70,55
1657083234959,COGS 101A,A01,083621,Davis; Joshua Daniel,9,0,68,59
1657083240982,COGS 101B,A01,091572,Allen; Michael Gordon,8,0,65,57
1657083247012,COGS 101C,A01,083625,Delgado; Tania,17,0,35,18
1657083253040,COGS 107A,A01,083627,Boyle; Mary E. T.,13,0,60,47
1657083259066,COGS 118A,A01,083075,Gupta; Anjum,15,0,76,61
1657083265096,CSE 3,A50,083646,Miranda; Gregory Joseph,22,0,50,28
1657083271124,CSE 8A,A50,083650,Miranda; Gregory Joseph,17,1,56,39
1657083277149,CSE 11,A01,083080,Cao; Yingjun,4,15,40,36
1657083283176,CSE 12,A01,083652,Krause-Levy; Sophia Louisa,23,1,120,97
1657083289204,CSE 15L,A01,083654,Morris; Justin Loren,9,0,50,41
1657083289204,CSE 15L,A02,083655,Morris; Justin Loren,9,0,50,41
1657083295231,CSE 20,A01,083657,Tran; Khoa Dang,37,0,80,43
1657083301254,CSE 21,A01,095574,Bach; Quang Tran,21,0,48,27
1657083307277,CSE 30,A01,083084,Eldon; John,4,0,80,76
1657083307277,CSE 30,B01,095061,Bhaskar; Nishant,6,0,50,44
1657083313301,CSE 100,A01,083659,Cao; Yingjun,3,4,70,67
1657083319328,CSE 134B,A01,083661,Powell; Thomas Allan,19,0,100,81
1657083325354,CSE 140,A01,083663,Gungor; Onat,14,0,85,71
1657083331381,CSE 140L,A01,083088,Eldon; John,16,0,100,84
1657083337406,CSE 175,A01,083665,Kumar; Rakesh,3,0,25,22
1657083343431,CSE 190,A00,092507,Dubnov; Shlomo,7,0,20,13
1657083349532,ECE 45,A01,083139,Congero; Spencer William,5,0,75,70
1657083355559,ECE 65,A50,083695,Saad; Andrew S,12,0,30,18
1657083355559,ECE 65,A51,095125,Saad; Andrew S,25,0,26,1
1657083361582,ECE 109,A01,091882,Touri; Behrouz,16,0,70,54
1657083367608,ECE 180,A00,083140,Abi Samra; Nicholas Camill,1,0,30,29
1657083367608,ECE 180,B00,083141,Abi Samra; Nicholas Camill,0,0,30,30
1657083373634,MATH 10A,A01,083735,Patchell; Gregory David,1,0,30,29
1657083373634,MATH 10A,A02,083736,Patchell; Gregory David,20,0,30,10
1657083373634,MATH 10A,A03,083737,Patchell; Gregory David,16,0,30,14
1657083379657,MATH 10B,A01,083207,Lim; Seonhee,7,0,34,27
1657083379657,MATH 10B,A02,083208,Lim; Seonhee,9,0,35,26
1657083379657,MATH 10B,A03,093472,Lim; Seonhee,4,0,34,30
1657083379657,MATH 10B,B01,083739,Sinha; Shubham,9,0,30,21
1657083385683,MATH 18,A01,083743,Cinel; Cameron Alexander,6,0,30,24
1657083385683,MATH 18,A02,083744,Cinel; Cameron Alexander,15,0,30,15
1657083385683,MATH 18,A03,083745,Cinel; Cameron Alexander,8,0,30,22
1657083385683,MATH 18,B01,083748,Rideout; David Porter,4,0,37,33
1657083385683,MATH 18,B02,083749,Rideout; David Porter,3,0,36,33
1657083385683,MATH 18,B03,083750,Rideout; David Porter,2,0,37,35
1657083385683,MATH 18,B04,083751,Rideout; David Porter,5,0,36,31
1657083385683,MATH 18,B05,093473,Rideout; David Porter,4,0,36,32
1657083385683,MATH 18,B06,093474,Rideout; David Porter,5,0,36,31
1657083391705,MATH 20A,A01,083754,Zheng; Zequn,12,0,40,28
1657083397732,MATH 20B,A01,083756,Briones; Jor-el Thomas Caparas,1,0,36,35
1657083397732,MATH 20B,A02,083757,Briones; Jor-el Thomas Caparas,1,0,36,35
1657083397732,MATH 20B,A03,093475,Briones; Jor-el Thomas Caparas,0,0,36,36
1657083403763,MATH 20C,A01,083760,Briones; Jor-el Thomas Caparas,1,0,35,34
1657083403763,MATH 20C,A02,083761,Briones; Jor-el Thomas Caparas,8,0,35,27
1657083403763,MATH 20C,A03,093476,Briones; Jor-el Thomas Caparas,0,1,36,36
1657083403763,MATH 20C,B01,083762,Bach; Quang Tran,0,0,30,30
1657083409788,MATH 20D,A01,083765,Tran; Brian Kha,4,0,30,26
1657083409788,MATH 20D,A02,083766,Tran; Brian Kha,5,0,30,25
1657083409788,MATH 20D,A03,083767,Tran; Brian Kha,3,0,30,27
1657083415816,MATH 20E,A01,083771,Ganguly; Soumya,5,0,32,27
1657083415816,MATH 20E,A02,083772,Ganguly; Soumya,6,0,32,26
1657083415816,MATH 20E,B01,083773,Ciotti; Benjamin,18,0,35,17
1657083415816,MATH 20E,B02,083774,Ciotti; Benjamin,17,0,35,18
1657083421841,MATH 103A,A01,083777,Greenfeld; Be'Eri,2,0,36,34
1657083421841,MATH 103A,A02,083778,Greenfeld; Be'Eri,5,0,36,31
1657083421841,MATH 103A,A03,093561,Greenfeld; Be'Eri,4,0,36,32
1657083421841,MATH 103A,B01,083779,Greenfeld; Be'Eri,6,0,36,30
1657083421841,MATH 103A,B02,083780,Greenfeld; Be'Eri,2,0,36,34
1657083421841,MATH 103A,B03,093562,Greenfeld; Be'Eri,3,0,36,33
1657083427863,MATH 105,A01,085443,Carter; Anne Toulson,14,0,35,21
1657083427863,MATH 105,A02,093477,Carter; Anne Toulson,20,0,35,15
1657083433887,MATH 109,A01,083213,Ganzberger; Geoffrey Michael,2,0,34,32
1657083433887,MATH 109,A02,083214,Ganzberger; Geoffrey Michael,2,0,34,32
1657083433887,MATH 109,A03,093478,Ganzberger; Geoffrey Michael,1,0,34,33
1657083433887,MATH 109,B01,083215,Ganzberger; Geoffrey Michael,1,0,32,31
1657083433887,MATH 109,B02,083216,Ganzberger; Geoffrey Michael,1,0,32,31
1657083433887,MATH 109,B03,093479,Ganzberger; Geoffrey Michael,6,0,32,26
1657083439912,MATH 142A,A01,083219,Chow; Bennett,6,0,32,26
1657083439912,MATH 142A,A02,083220,Chow; Bennett,10,0,32,22
1657083439912,MATH 142A,A03,093480,Chow; Bennett,7,0,32,25
1657083439912,MATH 142A,B03,093481,Chow; Bennett,8,0,32,24
1657083439912,MATH 142A,B04,093558,Chow; Bennett,11,0,32,21
1657083439912,MATH 142A,B05,093559,Chow; Bennett,6,0,32,26
1657083445955,MATH 193A,A01,083224,Rotar; Vladimir,7,0,34,27
1657083445955,MATH 193A,A02,083225,Rotar; Vladimir,5,0,34,29
1657083445955,MATH 193A,A03,083781,Rotar; Vladimir,1,0,34,33
1657083445955,MATH 193A,A04,083782,Rotar; Vladimir,6,0,34,28
1657083445955,MATH 193A,A05,093482,Rotar; Vladimir,6,0,34,28
1657083451982,MATH 197,001,091859,McAuley; Julian John,9999,0,9999,0
1657083451982,MATH 197,002,095566,Kedlaya; Kiran S.,9997,0,9999,2
1657083451982,MATH 197,003,095567,Xiao; Ming,9999,0,9999,0
1657083451982,MATH 197,004,095571,Perols; Johan Lars,9998,0,9999,1
1657083459057,COGS 9,A01,083615,Shannon; Kyle Michael,7,0,75,68
1657083465085,COGS 11,A01,083617,Boyle; Mary E. T.,21,0,48,27
1657083471112,COGS 13,A01,083071,Bastos; Amalia Pinkusfeld,9,0,71,62
1657083477134,COGS 14A,A01,092681,Semenuks; Arturs,1,1,100,99
1657083483158,COGS 14B,A01,083073,Cheng; Tzu-Han,5,0,63,58
1657083489180,COGS 17,A01,092677,Semenuks; Arturs,4,0,81,77
1657083495203,COGS 100,A01,083619,Allen; Michael Gordon,15,0,70,55
1657083501227,COGS 101A,A01,083621,Davis; Joshua Daniel,9,0,68,59
1657083507260,COGS 101B,A01,091572,Allen; Michael Gordon,8,0,65,57
1657083513282,COGS 101C,A01,083625,Delgado; Tania,17,0,35,18
1657083519304,COGS 107A,A01,083627,Boyle; Mary E. T.,13,0,60,47
1657083525328,COGS 118A,A01,083075,Gupta; Anjum,15,0,76,61
1657083531351,CSE 3,A50,083646,Miranda; Gregory Joseph,22,0,50,28
1657083537380,CSE 8A,A50,083650,Miranda; Gregory Joseph,17,1,56,39
1657083543404,CSE 11,A01,083080,Cao; Yingjun,4,15,40,36
1657083549431,CSE 12,A01,083652,Krause-Levy; Sophia Louisa,23,1,120,97
1657083555460,CSE 15L,A01,083654,Morris; Justin Loren,9,0,50,41
1657083555460,CSE 15L,A02,083655,Morris; Justin Loren,9,0,50,41
1657083561489,CSE 20,A01,083657,Tran; Khoa Dang,37,0,80,43
1657083567516,CSE 21,A01,095574,Bach; Quang Tran,21,0,48,27
1657083573543,CSE 30,A01,083084,Eldon; John,4,0,80,76
1657083573543,CSE 30,B01,095061,Bhaskar; Nishant,6,0,50,44
1657083579571,CSE 100,A01,083659,Cao; Yingjun,3,4,70,67
1657083585598,CSE 134B,A01,083661,Powell; Thomas Allan,19,0,100,81
1657083591621,CSE 140,A01,083663,Gungor; Onat,14,0,85,71
1657083597647,CSE 140L,A01,083088,Eldon; John,16,0,100,84
1657083603685,CSE 175,A01,083665,Kumar; Rakesh,3,0,25,22
1657083609711,CSE 190,A00,092507,Dubnov; Shlomo,7,0,20,13
1657083615735,ECE 45,A01,083139,Congero; Spencer William,5,0,75,70
1657083621756,ECE 65,A50,083695,Saad; Andrew S,12,0,30,18
1657083621756,ECE 65,A51,095125,Saad; Andrew S,25,0,26,1
1657083627787,ECE 109,A01,091882,Touri; Behrouz,16,0,70,54
1657083633808,ECE 180,A00,083140,Abi Samra; Nicholas Camill,1,0,30,29
1657083633808,ECE 180,B00,083141,Abi Samra; Nicholas Camill,0,0,30,30
1657083639837,MATH 10A,A01,083735,Patchell; Gregory David,1,0,30,29
1657083639837,MATH 10A,A02,083736,Patchell; Gregory David,20,0,30,10
1657083639837,MATH 10A,A03,083737,Patchell; Gregory David,16,0,30,14
1657083645865,MATH 10B,A01,083207,Lim; Seonhee,7,0,34,27
1657083645865,MATH 10B,A02,083208,Lim; Seonhee,9,0,35,26
1657083645865,MATH 10B,A03,093472,Lim; Seonhee,4,0,34,30
1657083645865,MATH 10B,B01,083739,Sinha; Shubham,9,0,30,21
1657083651889,MATH 18,A01,083743,Cinel; Cameron Alexander,6,0,30,24
1657083651889,MATH 18,A02,083744,Cinel; Cameron Alexander,15,0,30,15
1657083651889,MATH 18,A03,083745,Cinel; Cameron Alexander,8,0,30,22
1657083651889,MATH 18,B01,083748,Rideout; David Porter,4,0,37,33
1657083651889,MATH 18,B02,083749,Rideout; David Porter,3,0,36,33
1657083651889,MATH 18,B03,083750,Rideout; David Porter,2,0,37,35
1657083651889,MATH 18,B04,083751,Rideout; David Porter,5,0,36,31
1657083651889,MATH 18,B05,093473,Rideout; David Porter,4,0,36,32
1657083651889,MATH 18,B06,093474,Rideout; David Porter,5,0,36,31
1657083657913,MATH 20A,A01,083754,Zheng; Zequn,12,0,40,28
1657083663942,MATH 20B,A01,083756,Briones; Jor-el Thomas Caparas,1,0,36,35
1657083663942,MATH 20B,A02,083757,Briones; Jor-el Thomas Caparas,1,0,36,35
1657083663942,MATH 20B,A03,093475,Briones; Jor-el Thomas Caparas,0,0,36,36
1657083669975,MATH 20C,A01,083760,Briones; Jor-el Thomas Caparas,1,0,35,34
1657083669975,MATH 20C,A02,083761,Briones; Jor-el Thomas Caparas,8,0,35,27
1657083669975,MATH 20C,A03,093476,Briones; Jor-el Thomas Caparas,0,1,36,36
1657083669975,MATH 20C,B01,083762,Bach; Quang Tran,0,0,30,30
1657083675998,MATH 20D,A01,083765,Tran; Brian Kha,4,0,30,26
1657083675998,MATH 20D,A02,083766,Tran; Brian Kha,5,0,30,25
1657083675998,MATH 20D,A03,083767,Tran; Brian Kha,3,0,30,27
1657083682023,MATH 20E,A01,083771,Ganguly; Soumya,5,0,32,27
1657083682023,MATH 20E,A02,083772,Ganguly; Soumya,6,0,32,26
1657083682023,MATH 20E,B01,083773,Ciotti; Benjamin,18,0,35,17
1657083682023,MATH 20E,B02,083774,Ciotti; Benjamin,17,0,35,18
1657083688048,MATH 103A,A01,083777,Greenfeld; Be'Eri,2,0,36,34
1657083688048,MATH 103A,A02,083778,Greenfeld; Be'Eri,5,0,36,31
1657083688048,MATH 103A,A03,093561,Greenfeld; Be'Eri,4,0,36,32
1657083688048,MATH 103A,B01,083779,Greenfeld; Be'Eri,6,0,36,30
1657083688048,MATH 103A,B02,083780,Greenfeld; Be'Eri,2,0,36,34
1657083688048,MATH 103A,B03,093562,Greenfeld; Be'Eri,3,0,36,33
1657083694074,MATH 105,A01,085443,Carter; Anne Toulson,14,0,35,21
1657083694074,MATH 105,A02,093477,Carter; Anne Toulson,20,0,35,15
1657083700098,MATH 109,A01,083213,Ganzberger; Geoffrey Michael,2,0,34,32
1657083700098,MATH 109,A02,083214,Ganzberger; Geoffrey Michael,2,0,34,32
1657083700098,MATH 109,A03,093478,Ganzberger; Geoffrey Michael,1,0,34,33
1657083700098,MATH 109,B01,083215,Ganzberger; Geoffrey Michael,1,0,32,31
1657083700098,MATH 109,B02,083216,Ganzberger; Geoffrey Michael,1,0,32,31
1657083700098,MATH 109,B03,093479,Ganzberger; Geoffrey Michael,6,0,32,26
1657083706127,MATH 142A,A01,083219,Chow; Bennett,6,0,32,26
1657083706127,MATH 142A,A02,083220,Chow; Bennett,10,0,32,22
1657083706127,MATH 142A,A03,093480,Chow; Bennett,7,0,32,25
1657083706127,MATH 142A,B03,093481,Chow; Bennett,8,0,32,24
1657083706127,MATH 142A,B04,093558,Chow; Bennett,11,0,32,21
1657083706127,MATH 142A,B05,093559,Chow; Bennett,6,0,32,26
1657083712156,MATH 193A,A01,083224,Rotar; Vladimir,7,0,34,27
1657083712156,MATH 193A,A02,083225,Rotar; Vladimir,5,0,34,29
1657083712156,MATH 193A,A03,083781,Rotar; Vladimir,1,0,34,33
1657083712156,MATH 193A,A04,083782,Rotar; Vladimir,6,0,34,28
1657083712156,MATH 193A,A05,093482,Rotar; Vladimir,6,0,34,28
1657083718182,MATH 197,001,091859,McAuley; Julian John,9999,0,9999,0
1657083718182,MATH 197,002,095566,Kedlaya; Kiran S.,9997,0,9999,2
1657083718182,MATH 197,003,095567,Xiao; Ming,9999,0,9999,0
1657083718182,MATH 197,004,095571,Perols; Johan Lars,9998,0,9999,1
1657083725252,COGS 9,A01,083615,Shannon; Kyle Michael,7,0,75,68
1657083731280,COGS 11,A01,083617,Boyle; Mary E. T.,21,0,48,27
1657083737304,COGS 13,A01,083071,Bastos; Amalia Pinkusfeld,9,0,71,62
1657083743331,COGS 14A,A01,092681,Semenuks; Arturs,1,1,100,99
1657083749355,COGS 14B,A01,083073,Cheng; Tzu-Han,5,0,63,58
1657083755401,COGS 17,A01,092677,Semenuks; Arturs,4,0,81,77
1657083761424,COGS 100,A01,083619,Allen; Michael Gordon,15,0,70,55
1657083767451,COGS 101A,A01,083621,Davis; Joshua Daniel,9,0,68,59
1657083773483,COGS 101B,A01,091572,Allen; Michael Gordon,8,0,65,57
1657083779509,COGS 101C,A01,083625,Delgado; Tania,17,0,35,18
1657083785532,COGS 107A,A01,083627,Boyle; Mary E. T.,13,0,60,47
1657083791555,COGS 118A,A01,083075,Gupta; Anjum,15,0,76,61
1657083797579,CSE 3,A50,083646,Miranda; Gregory Joseph,22,0,50,28
1657083803603,CSE 8A,A50,083650,Miranda; Gregory Joseph,17,1,56,39
1657083809629,CSE 11,A01,083080,Cao; Yingjun,4,15,40,36
1657083815657,CSE 12,A01,083652,Krause-Levy; Sophia Louisa,23,1,120,97
1657083821680,CSE 15L,A01,083654,Morris; Justin Loren,9,0,50,41
1657083821680,CSE 15L,A02,083655,Morris; Justin Loren,9,0,50,41
1657083827706,CSE 20,A01,083657,Tran; Khoa Dang,37,0,80,43
1657083833728,CSE 21,A01,095574,Bach; Quang Tran,21,0,48,27
1657083839752,CSE 30,A01,083084,Eldon; John,4,0,80,76
1657083839752,CSE 30,B01,095061,Bhaskar; Nishant,6,0,50,44
1657083845783,CSE 100,A01,083659,Cao; Yingjun,3,4,70,67
1657083851810,CSE 134B,A01,083661,Powell; Thomas Allan,19,0,100,81
1657083857834,CSE 140,A01,083663,Gungor; Onat,14,0,85,71
1657083863863,CSE 140L,A01,083088,Eldon; John,16,0,100,84
1657083869890,CSE 175,A01,083665,Kumar; Rakesh,3,0,25,22
1657083875917,CSE 190,A00,092507,Dubnov; Shlomo,7,0,20,13
1657083881940,ECE 45,A01,083139,Congero; Spencer William,5,0,75,70
1657083887969,ECE 65,A50,083695,Saad; Andrew S,12,0,30,18
1657083887969,ECE 65,A51,095125,Saad; Andrew S,25,0,26,1
1657083893991,ECE 109,A01,091882,Touri; Behrouz,16,0,70,54
1657083900018,ECE 180,A00,083140,Abi Samra; Nicholas Camill,1,0,30,29
1657083900018,ECE 180,B00,083141,Abi Samra; Nicholas Camill,0,0,30,30
1657083906040,MATH 10A,A01,083735,Patchell; Gregory David,1,0,30,29
1657083906040,MATH 10A,A02,083736,Patchell; Gregory David,20,0,30,10
1657083906040,MATH 10A,A03,083737,Patchell; Gregory David,16,0,30,14
1657083912065,MATH 10B,A01,083207,Lim; Seonhee,7,0,34,27
1657083912065,MATH 10B,A02,083208,Lim; Seonhee,9,0,35,26
1657083912065,MATH 10B,A03,093472,Lim; Seonhee,4,0,34,30
1657083912065,MATH 10B,B01,083739,Sinha; Shubham,9,0,30,21
1657083918089,MATH 18,A01,083743,Cinel; Cameron Alexander,6,0,30,24
1657083918089,MATH 18,A02,083744,Cinel; Cameron Alexander,15,0,30,15
1657083918089,MATH 18,A03,083745,Cinel; Cameron Alexander,8,0,30,22
1657083918089,MATH 18,B01,083748,Rideout; David Porter,4,0,37,33
1657083918089,MATH 18,B02,083749,Rideout; David Porter,3,0,36,33
1657083918089,MATH 18,B03,083750,Rideout; David Porter,2,0,37,35
1657083918089,MATH 18,B04,083751,Rideout; David Porter,5,0,36,31
1657083918089,MATH 18,B05,093473,Rideout; David Porter,4,0,36,32
1657083918089,MATH 18,B06,093474,Rideout; David Porter,5,0,36,31
1657083924113,MATH 20A,A01,083754,Zheng; Zequn,12,0,40,28
1657083930140,MATH 20B,A01,083756,Briones; Jor-el Thomas Caparas,1,0,36,35
1657083930140,MATH 20B,A02,083757,Briones; Jor-el Thomas Caparas,1,0,36,35
1657083930140,MATH 20B,A03,093475,Briones; Jor-el Thomas Caparas,0,0,36,36
1657083936168,MATH 20C,A01,083760,Briones; Jor-el Thomas Caparas,1,0,35,34
1657083936168,MATH 20C,A02,083761,Briones; Jor-el Thomas Caparas,8,0,35,27
1657083936168,MATH 20C,A03,093476,Briones; Jor-el Thomas Caparas,0,1,36,36
1657083936168,MATH 20C,B01,083762,Bach; Quang Tran,0,0,30,30
1657083942193,MATH 20D,A01,083765,Tran; Brian Kha,4,0,30,26
1657083942193,MATH 20D,A02,083766,Tran; Brian Kha,5,0,30,25
1657083942193,MATH 20D,A03,083767,Tran; Brian Kha,3,0,30,27
1657083948311,MATH 20E,A01,083771,Ganguly; Soumya,5,0,32,27
1657083948311,MATH 20E,A02,083772,Ganguly; Soumya,6,0,32,26
1657083948311,MATH 20E,B01,083773,Ciotti; Benjamin,18,0,35,17
1657083948311,MATH 20E,B02,083774,Ciotti; Benjamin,17,0,35,18
1657083954359,MATH 103A,A01,083777,Greenfeld; Be'Eri,2,0,36,34
1657083954359,MATH 103A,A02,083778,Greenfeld; Be'Eri,5,0,36,31
1657083954359,MATH 103A,A03,093561,Greenfeld; Be'Eri,4,0,36,32
1657083954359,MATH 103A,B01,083779,Greenfeld; Be'Eri,6,0,36,30
1657083954359,MATH 103A,B02,083780,Greenfeld; Be'Eri,2,0,36,34
1657083954359,MATH 103A,B03,093562,Greenfeld; Be'Eri,3,0,36,33
1657083960384,MATH 105,A01,085443,Carter; Anne Toulson,14,0,35,21
1657083960384,MATH 105,A02,093477,Carter; Anne Toulson,20,0,35,15
1657083966409,MATH 109,A01,083213,Ganzberger; Geoffrey Michael,2,0,34,32
1657083966409,MATH 109,A02,083214,Ganzberger; Geoffrey Michael,2,0,34,32
1657083966409,MATH 109,A03,093478,Ganzberger; Geoffrey Michael,1,0,34,33
1657083966409,MATH 109,B01,083215,Ganzberger; Geoffrey Michael,1,0,32,31
1657083966409,MATH 109,B02,083216,Ganzberger; Geoffrey Michael,1,0,32,31
1657083966409,MATH 109,B03,093479,Ganzberger; Geoffrey Michael,6,0,32,26
1657083972435,MATH 142A,A01,083219,Chow; Bennett,6,0,32,26
1657083972435,MATH 142A,A02,083220,Chow; Bennett,10,0,32,22
1657083972435,MATH 142A,A03,093480,Chow; Bennett,7,0,32,25
1657083972435,MATH 142A,B03,093481,Chow; Bennett,8,0,32,24
1657083972435,MATH 142A,B04,093558,Chow; Bennett,11,0,32,21
1657083972435,MATH 142A,B05,093559,Chow; Bennett,6,0,32,26
1657083978463,MATH 193A,A01,083224,Rotar; Vladimir,7,0,34,27
1657083978463,MATH 193A,A02,083225,Rotar; Vladimir,5,0,34,29
1657083978463,MATH 193A,A03,083781,Rotar; Vladimir,1,0,34,33
1657083978463,MATH 193A,A04,083782,Rotar; Vladimir,6,0,34,28
1657083978463,MATH 193A,A05,093482,Rotar; Vladimir,6,0,34,28
1657083984485,MATH 197,001,091859,McAuley; Julian John,9999,0,9999,0
1657083984485,MATH 197,002,095566,Kedlaya; Kiran S.,9997,0,9999,2
1657083984485,MATH 197,003,095567,Xiao; Ming,9999,0,9999,0
1657083984485,MATH 197,004,095571,Perols; Johan Lars,9998,0,9999,1
1657083991546,COGS 9,A01,083615,Shannon; Kyle Michael,7,0,75,68
1657083997568,COGS 11,A01,083617,Boyle; Mary E. T.,21,0,48,27
1657084003594,COGS 13,A01,083071,Bastos; Amalia Pinkusfeld,9,0,71,62
1657084009619,COGS 14A,A01,092681,Semenuks; Arturs,1,1,100,99
1657084015641,COGS 14B,A01,083073,Cheng; Tzu-Han,5,0,63,58
1657084021672,COGS 17,A01,092677,Semenuks; Arturs,4,0,81,77
1657084027694,COGS 100,A01,083619,Allen; Michael Gordon,15,0,70,55
1657084033716,COGS 101A,A01,083621,Davis; Joshua Daniel,9,0,68,59
1657084039741,COGS 101B,A01,091572,Allen; Michael Gordon,8,0,65,57
1657084045773,COGS 101C,A01,083625,Delgado; Tania,17,0,35,18
1657084051802,COGS 107A,A01,083627,Boyle; Mary E. T.,13,0,60,47
1657084057824,COGS 118A,A01,083075,Gupta; Anjum,15,0,76,61
1657084063847,CSE 3,A50,083646,Miranda; Gregory Joseph,22,0,50,28
1657084069871,CSE 8A,A50,083650,Miranda; Gregory Joseph,17,1,56,39
1657084075895,CSE 11,A01,083080,Cao; Yingjun,4,15,40,36
1657084081923,CSE 12,A01,083652,Krause-Levy; Sophia Louisa,23,1,120,97
1657084087948,CSE 15L,A01,083654,Morris; Justin Loren,9,0,50,41
1657084087948,CSE 15L,A02,083655,Morris; Justin Loren,9,0,50,41
1657084093970,CSE 20,A01,083657,Tran; Khoa Dang,37,0,80,43
1657084099994,CSE 21,A01,095574,Bach; Quang Tran,21,0,48,27
1657084106016,CSE 30,A01,083084,Eldon; John,4,0,80,76
1657084106016,CSE 30,B01,095061,Bhaskar; Nishant,6,0,50,44
1657084112043,CSE 100,A01,083659,Cao; Yingjun,3,4,70,67
1657084118067,CSE 134B,A01,083661,Powell; Thomas Allan,19,0,100,81
1657084124093,CSE 140,A01,083663,Gungor; Onat,14,0,85,71
1657084130124,CSE 140L,A01,083088,Eldon; John,16,0,100,84
1657084136148,CSE 175,A01,083665,Kumar; Rakesh,3,0,25,22
1657084142174,CSE 190,A00,092507,Dubnov; Shlomo,7,0,20,13
1657084148221,ECE 45,A01,083139,Congero; Spencer William,5,0,75,70
1657084154247,ECE 65,A50,083695,Saad; Andrew S,12,0,30,18
1657084154247,ECE 65,A51,095125,Saad; Andrew S,25,0,26,1
1657084160275,ECE 109,A01,091882,Touri; Behrouz,16,0,70,54
1657084166298,ECE 180,A00,083140,Abi Samra; Nicholas Camill,1,0,30,29
1657084166298,ECE 180,B00,083141,Abi Samra; Nicholas Camill,0,0,30,30
1657084172323,MATH 10A,A01,083735,Patchell; Gregory David,1,0,30,29
1657084172323,MATH 10A,A02,083736,Patchell; Gregory David,20,0,30,10
1657084172323,MATH 10A,A03,083737,Patchell; Gregory David,16,0,30,14
1657084178351,MATH 10B,A01,083207,Lim; Seonhee,7,0,34,27
1657084178351,MATH 10B,A02,083208,Lim; Seonhee,9,0,35,26
1657084178351,MATH 10B,A03,093472,Lim; Seonhee,4,0,34,30
1657084178351,MATH 10B,B01,083739,Sinha; Shubham,9,0,30,21
1657084184376,MATH 18,A01,083743,Cinel; Cameron Alexander,6,0,30,24
1657084184376,MATH 18,A02,083744,Cinel; Cameron Alexander,15,0,30,15
1657084184376,MATH 18,A03,083745,Cinel; Cameron Alexander,8,0,30,22
1657084184376,MATH 18,B01,083748,Rideout; David Porter,4,0,37,33
1657084184376,MATH 18,B02,083749,Rideout; David Porter,3,0,36,33
1657084184376,MATH 18,B03,083750,Rideout; David Porter,2,0,37,35
1657084184376,MATH 18,B04,083751,Rideout; David Porter,5,0,36,31
1657084184376,MATH 18,B05,093473,Rideout; David Porter,4,0,36,32
1657084184376,MATH 18,B06,093474,Rideout; David Porter,5,0,36,31
1657084190399,MATH 20A,A01,083754,Zheng; Zequn,12,0,40,28
1657084196423,MATH 20B,A01,083756,Briones; Jor-el Thomas Caparas,1,0,36,35
1657084196423,MATH 20B,A02,083757,Briones; Jor-el Thomas Caparas,1,0,36,35
1657084196423,MATH 20B,A03,093475,Briones; Jor-el Thomas Caparas,0,0,36,36
1657084202447,MATH 20C,A01,083760,Briones; Jor-el Thomas Caparas,1,0,35,34
1657084202447,MATH 20C,A02,083761,Briones; Jor-el Thomas Caparas,8,0,35,27
1657084202447,MATH 20C,A03,093476,Briones; Jor-el Thomas Caparas,0,1,36,36
1657084202447,MATH 20C,B01,083762,Bach; Quang Tran,0,0,30,30
1657084208475,MATH 20D,A01,083765,Tran; Brian Kha,4,0,30,26
1657084208475,MATH 20D,A02,083766,Tran; Brian Kha,5,0,30,25
1657084208475,MATH 20D,A03,083767,Tran; Brian Kha,3,0,30,27
1657084214505,MATH 20E,A01,083771,Ganguly; Soumya,5,0,32,27
1657084214505,MATH 20E,A02,083772,Ganguly; Soumya,6,0,32,26
1657084214505,MATH 20E,B01,083773,Ciotti; Benjamin,18,0,35,17
1657084214505,MATH 20E,B02,083774,Ciotti; Benjamin,17,0,35,18
1657084220535,MATH 103A,A01,083777,Greenfeld; Be'Eri,2,0,36,34
1657084220535,MATH 103A,A02,083778,Greenfeld; Be'Eri,5,0,36,31
1657084220535,MATH 103A,A03,093561,Greenfeld; Be'Eri,4,0,36,32
1657084220535,MATH 103A,B01,083779,Greenfeld; Be'Eri,6,0,36,30
1657084220535,MATH 103A,B02,083780,Greenfeld; Be'Eri,2,0,36,34
1657084220535,MATH 103A,B03,093562,Greenfeld; Be'Eri,3,0,36,33
1657084226559,MATH 105,A01,085443,Carter; Anne Toulson,14,0,35,21
1657084226559,MATH 105,A02,093477,Carter; Anne Toulson,20,0,35,15
1657084232583,MATH 109,A01,083213,Ganzberger; Geoffrey Michael,2,0,34,32
1657084232583,MATH 109,A02,083214,Ganzberger; Geoffrey Michael,2,0,34,32
1657084232583,MATH 109,A03,093478,Ganzberger; Geoffrey Michael,1,0,34,33
1657084232583,MATH 109,B01,083215,Ganzberger; Geoffrey Michael,1,0,32,31
1657084232583,MATH 109,B02,083216,Ganzberger; Geoffrey Michael,1,0,32,31
1657084232583,MATH 109,B03,093479,Ganzberger; Geoffrey Michael,6,0,32,26
1657084238607,MATH 142A,A01,083219,Chow; Bennett,6,0,32,26
1657084238607,MATH 142A,A02,083220,Chow; Bennett,10,0,32,22
1657084238607,MATH 142A,A03,093480,Chow; Bennett,7,0,32,25
1657084238607,MATH 142A,B03,093481,Chow; Bennett,8,0,32,24
1657084238607,MATH 142A,B04,093558,Chow; Bennett,11,0,32,21
1657084238607,MATH 142A,B05,093559,Chow; Bennett,6,0,32,26
1657084244635,MATH 193A,A01,083224,Rotar; Vladimir,7,0,34,27
1657084244635,MATH 193A,A02,083225,Rotar; Vladimir,5,0,34,29
1657084244635,MATH 193A,A03,083781,Rotar; Vladimir,1,0,34,33
1657084244635,MATH 193A,A04,083782,Rotar; Vladimir,6,0,34,28
1657084244635,MATH 193A,A05,093482,Rotar; Vladimir,6,0,34,28
1657084250666,MATH 197,001,091859,McAuley; Julian John,9999,0,9999,0
1657084250666,MATH 197,002,095566,Kedlaya; Kiran S.,9997,0,9999,2
1657084250666,MATH 197,003,095567,Xiao; Ming,9999,0,9999,0
1657084250666,MATH 197,004,095571,Perols; Johan Lars,9998,0,9999,1
1657084257720,COGS 9,A01,083615,Shannon; Kyle Michael,7,0,75,68
1657084263745,COGS 11,A01,083617,Boyle; Mary E. T.,21,0,48,27
1657084269768,COGS 13,A01,083071,Bastos; Amalia Pinkusfeld,9,0,71,62
1657084275791,COGS 14A,A01,092681,Semenuks; Arturs,1,1,100,99
1657084281815,COGS 14B,A01,083073,Cheng; Tzu-Han,5,0,63,58
1657084287837,COGS 17,A01,092677,Semenuks; Arturs,4,0,81,77
1657084293860,COGS 100,A01,083619,Allen; Michael Gordon,15,0,70,55
1657084299887,COGS 101A,A01,083621,Davis; Joshua Daniel,9,0,68,59
1657084305913,COGS 101B,A01,091572,Allen; Michael Gordon,8,0,65,57
1657084311936,COGS 101C,A01,083625,Delgado; Tania,17,0,35,18
1657084317960,COGS 107A,A01,083627,Boyle; Mary E. T.,13,0,60,47
1657084323987,COGS 118A,A01,083075,Gupta; Anjum,15,0,76,61
1657084330014,CSE 3,A50,083646,Miranda; Gregory Joseph,22,0,50,28
1657084336042,CSE 8A,A50,083650,Miranda; Gregory Joseph,17,1,56,39
1657084342070,CSE 11,A01,083080,Cao; Yingjun,4,15,40,36
1657084348100,CSE 12,A01,083652,Krause-Levy; Sophia Louisa,23,1,120,97
1657084354128,CSE 15L,A01,083654,Morris; Justin Loren,9,0,50,41
1657084354128,CSE 15L,A02,083655,Morris; Justin Loren,9,0,50,41
1657084360156,CSE 20,A01,083657,Tran; Khoa Dang,37,0,80,43
1657084366179,CSE 21,A01,095574,Bach; Quang Tran,21,0,48,27
1657084372207,CSE 30,A01,083084,Eldon; John,4,0,80,76
1657084372207,CSE 30,B01,095061,Bhaskar; Nishant,6,0,50,44
1657084378240,CSE 100,A01,083659,Cao; Yingjun,3,4,70,67
1657084384267,CSE 134B,A01,083661,Powell; Thomas Allan,19,0,100,81
1657084390292,CSE 140,A01,083663,Gungor; Onat,14,0,85,71
1657084396317,CSE 140L,A01,083088,Eldon; John,16,0,100,84
1657084402340,CSE 175,A01,083665,Kumar; Rakesh,3,0,25,22
1657084408382,CSE 190,A00,092507,Dubnov; Shlomo,7,0,20,13
1657084414410,ECE 45,A01,083139,Congero; Spencer William,5,0,75,70
1657084420437,ECE 65,A50,083695,Saad; Andrew S,12,0,30,18
1657084420437,ECE 65,A51,095125,Saad; Andrew S,25,0,26,1
1657084426464,ECE 109,A01,091882,Touri; Behrouz,16,0,70,54
1657084432485,ECE 180,A00,083140,Abi Samra; Nicholas Camill,1,0,30,29
1657084432485,ECE 180,B00,083141,Abi Samra; Nicholas Camill,0,0,30,30
1657084438510,MATH 10A,A01,083735,Patchell; Gregory David,1,0,30,29
1657084438510,MATH 10A,A02,083736,Patchell; Gregory David,20,0,30,10
1657084438510,MATH 10A,A03,083737,Patchell; Gregory David,16,0,30,14
1657084444538,MATH 10B,A01,083207,Lim; Seonhee,7,0,34,27
1657084444538,MATH 10B,A02,083208,Lim; Seonhee,9,0,35,26
1657084444538,MATH 10B,A03,093472,Lim; Seonhee,4,0,34,30
1657084444538,MATH 10B,B01,083739,Sinha; Shubham,9,0,30,21
1657084450570,MATH 18,A01,083743,Cinel; Cameron Alexander,6,0,30,24
1657084450570,MATH 18,A02,083744,Cinel; Cameron Alexander,15,0,30,15
1657084450570,MATH 18,A03,083745,Cinel; Cameron Alexander,8,0,30,22
1657084450570,MATH 18,B01,083748,Rideout; David Porter,4,0,37,33
1657084450570,MATH 18,B02,083749,Rideout; David Porter,3,0,36,33
1657084450570,MATH 18,B03,083750,Rideout; David Porter,2,0,37,35
1657084450570,MATH 18,B04,083751,Rideout; David Porter,5,0,36,31
1657084450570,MATH 18,B05,093473,Rideout; David Porter,4,0,36,32
1657084450570,MATH 18,B06,093474,Rideout; David Porter,5,0,36,31
1657084456592,MATH 20A,A01,083754,Zheng; Zequn,12,0,40,28
1657084462614,MATH 20B,A01,083756,Briones; Jor-el Thomas Caparas,1,0,36,35
1657084462614,MATH 20B,A02,083757,Briones; Jor-el Thomas Caparas,1,0,36,35
1657084462614,MATH 20B,A03,093475,Briones; Jor-el Thomas Caparas,0,0,36,36
1657084468638,MATH 20C,A01,083760,Briones; Jor-el Thomas Caparas,1,0,35,34
1657084468638,MATH 20C,A02,083761,Briones; Jor-el Thomas Caparas,8,0,35,27
1657084468638,MATH 20C,A03,093476,Briones; Jor-el Thomas Caparas,0,1,36,36
1657084468638,MATH 20C,B01,083762,Bach; Quang Tran,0,0,30,30
1657084474662,MATH 20D,A01,083765,Tran; Brian Kha,4,0,30,26
1657084474662,MATH 20D,A02,083766,Tran; Brian Kha,5,0,30,25
1657084474662,MATH 20D,A03,083767,Tran; Brian Kha,3,0,30,27
1657084480685,MATH 20E,A01,083771,Ganguly; Soumya,5,0,32,27
1657084480685,MATH 20E,A02,083772,Ganguly; Soumya,6,0,32,26
1657084480685,MATH 20E,B01,083773,Ciotti; Benjamin,18,0,35,17
1657084480685,MATH 20E,B02,083774,Ciotti; Benjamin,17,0,35,18
1657084486709,MATH 103A,A01,083777,Greenfeld; Be'Eri,2,0,36,34
1657084486709,MATH 103A,A02,083778,Greenfeld; Be'Eri,5,0,36,31
1657084486709,MATH 103A,A03,093561,Greenfeld; Be'Eri,4,0,36,32
1657084486709,MATH 103A,B01,083779,Greenfeld; Be'Eri,6,0,36,30
1657084486709,MATH 103A,B02,083780,Greenfeld; Be'Eri,2,0,36,34
1657084486709,MATH 103A,B03,093562,Greenfeld; Be'Eri,3,0,36,33
1657084492744,MATH 105,A01,085443,Carter; Anne Toulson,14,0,35,21
1657084492744,MATH 105,A02,093477,Carter; Anne Toulson,20,0,35,15
1657084498767,MATH 109,A01,083213,Ganzberger; Geoffrey Michael,2,0,34,32
1657084498767,MATH 109,A02,083214,Ganzberger; Geoffrey Michael,2,0,34,32
1657084498767,MATH 109,A03,093478,Ganzberger; Geoffrey Michael,1,0,34,33
1657084498767,MATH 109,B01,083215,Ganzberger; Geoffrey Michael,1,0,32,31
1657084498767,MATH 109,B02,083216,Ganzberger; Geoffrey Michael,1,0,32,31
1657084498767,MATH 109,B03,093479,Ganzberger; Geoffrey Michael,6,0,32,26
1657084504793,MATH 142A,A01,083219,Chow; Bennett,6,0,32,26
1657084504793,MATH 142A,A02,083220,Chow; Bennett,10,0,32,22
1657084504793,MATH 142A,A03,093480,Chow; Bennett,7,0,32,25
1657084504793,MATH 142A,B03,093481,Chow; Bennett,8,0,32,24
1657084504793,MATH 142A,B04,093558,Chow; Bennett,11,0,32,21
1657084504793,MATH 142A,B05,093559,Chow; Bennett,6,0,32,26
1657084510815,MATH 193A,A01,083224,Rotar; Vladimir,7,0,34,27
1657084510815,MATH 193A,A02,083225,Rotar; Vladimir,5,0,34,29
1657084510815,MATH 193A,A03,083781,Rotar; Vladimir,1,0,34,33
1657084510815,MATH 193A,A04,083782,Rotar; Vladimir,6,0,34,28
1657084510815,MATH 193A,A05,093482,Rotar; Vladimir,6,0,34,28
1657084516842,MATH 197,001,091859,McAuley; Julian John,9999,0,9999,0
1657084516842,MATH 197,002,095566,Kedlaya; Kiran S.,9997,0,9999,2
1657084516842,MATH 197,003,095567,Xiao; Ming,9999,0,9999,0
1657084516842,MATH 197,004,095571,Perols; Johan Lars,9998,0,9999,1
1657084523891,COGS 9,A01,083615,Shannon; Kyle Michael,7,0,75,68
1657084529915,COGS 11,A01,083617,Boyle; Mary E. T.,21,0,48,27
1657084535938,COGS 13,A01,083071,Bastos; Amalia Pinkusfeld,9,0,71,62
1657084542035,COGS 14A,A01,092681,Semenuks; Arturs,1,1,100,99
1657084548061,COGS 14B,A01,083073,Cheng; Tzu-Han,5,0,63,58
1657084554086,COGS 17,A01,092677,Semenuks; Arturs,4,0,81,77
1657084560113,COGS 100,A01,083619,Allen; Michael Gordon,15,0,70,55
1657084566139,COGS 101A,A01,083621,Davis; Joshua Daniel,9,0,68,59
1657084572162,COGS 101B,A01,091572,Allen; Michael Gordon,8,0,65,57
1657084578190,COGS 101C,A01,083625,Delgado; Tania,17,0,35,18
1657084584214,COGS 107A,A01,083627,Boyle; Mary E. T.,13,0,60,47
1657084590241,COGS 118A,A01,083075,Gupta; Anjum,15,0,76,61
1657084596264,CSE 3,A50,083646,Miranda; Gregory Joseph,22,0,50,28
1657084602291,CSE 8A,A50,083650,Miranda; Gregory Joseph,17,1,56,39
1657084608315,CSE 11,A01,083080,Cao; Yingjun,4,15,40,36
1657084614342,CSE 12,A01,083652,Krause-Levy; Sophia Louisa,23,1,120,97
1657084620365,CSE 15L,A01,083654,Morris; Justin Loren,9,0,50,41
1657084620365,CSE 15L,A02,083655,Morris; Justin Loren,9,0,50,41
1657084626388,CSE 20,A01,083657,Tran; Khoa Dang,37,0,80,43
1657084632411,CSE 21,A01,095574,Bach; Quang Tran,21,0,48,27
1657084638434,CSE 30,A01,083084,Eldon; John,4,0,80,76
1657084638434,CSE 30,B01,095061,Bhaskar; Nishant,6,0,50,44
1657084644460,CSE 100,A01,083659,Cao; Yingjun,3,4,70,67
1657084650485,CSE 134B,A01,083661,Powell; Thomas Allan,19,0,100,81
1657084656507,CSE 140,A01,083663,Gungor; Onat,14,0,85,71
1657084662533,CSE 140L,A01,083088,Eldon; John,16,0,100,84
1657084668556,CSE 175,A01,083665,Kumar; Rakesh,3,0,25,22
1657084674581,CSE 190,A00,092507,Dubnov; Shlomo,7,0,20,13
1657084680609,ECE 45,A01,083139,Congero; Spencer William,5,0,75,70
1657084686647,ECE 65,A50,083695,Saad; Andrew S,12,0,30,18
1657084686647,ECE 65,A51,095125,Saad; Andrew S,25,0,26,1
1657084692670,ECE 109,A01,091882,Touri; Behrouz,16,0,70,54
1657084698697,ECE 180,A00,083140,Abi Samra; Nicholas Camill,1,0,30,29
1657084698697,ECE 180,B00,083141,Abi Samra; Nicholas Camill,0,0,30,30
1657084704718,MATH 10A,A01,083735,Patchell; Gregory David,1,0,30,29
1657084704718,MATH 10A,A02,083736,Patchell; Gregory David,20,0,30,10
1657084704718,MATH 10A,A03,083737,Patchell; Gregory David,16,0,30,14
1657084710746,MATH 10B,A01,083207,Lim; Seonhee,7,0,34,27
1657084710746,MATH 10B,A02,083208,Lim; Seonhee,9,0,35,26
1657084710746,MATH 10B,A03,093472,Lim; Seonhee,4,0,34,30
1657084710746,MATH 10B,B01,083739,Sinha; Shubham,9,0,30,21
1657084716772,MATH 18,A01,083743,Cinel; Cameron Alexander,6,0,30,24
1657084716772,MATH 18,A02,083744,Cinel; Cameron Alexander,15,0,30,15
1657084716772,MATH 18,A03,083745,Cinel; Cameron Alexander,8,0,30,22
1657084716772,MATH 18,B01,083748,Rideout; David Porter,4,0,37,33
1657084716772,MATH 18,B02,083749,Rideout; David Porter,3,0,36,33
1657084716772,MATH 18,B03,083750,Rideout; David Porter,2,0,37,35
1657084716772,MATH 18,B04,083751,Rideout; David Porter,5,0,36,31
1657084716772,MATH 18,B05,093473,Rideout; David Porter,4,0,36,32
1657084716772,MATH 18,B06,093474,Rideout; David Porter,5,0,36,31
1657084722796,MATH 20A,A01,083754,Zheng; Zequn,12,0,40,28
1657084728824,MATH 20B,A01,083756,Briones; Jor-el Thomas Caparas,1,0,36,35
1657084728824,MATH 20B,A02,083757,Briones; Jor-el Thomas Caparas,1,0,36,35
1657084728824,MATH 20B,A03,093475,Briones; Jor-el Thomas Caparas,0,0,36,36
1657084734853,MATH 20C,A01,083760,Briones; Jor-el Thomas Caparas,1,0,35,34
1657084734853,MATH 20C,A02,083761,Briones; Jor-el Thomas Caparas,8,0,35,27
1657084734853,MATH 20C,A03,093476,Briones; Jor-el Thomas Caparas,0,1,36,36
1657084734853,MATH 20C,B01,083762,Bach; Quang Tran,0,0,30,30
1657084740876,MATH 20D,A01,083765,Tran; Brian Kha,4,0,30,26
1657084740876,MATH 20D,A02,083766,Tran; Brian Kha,5,0,30,25
1657084740876,MATH 20D,A03,083767,Tran; Brian Kha,3,0,30,27
1657084746900,MATH 20E,A01,083771,Ganguly; Soumya,5,0,32,27
1657084746900,MATH 20E,A02,083772,Ganguly; Soumya,6,0,32,26
1657084746900,MATH 20E,B01,083773,Ciotti; Benjamin,18,0,35,17
1657084746900,MATH 20E,B02,083774,Ciotti; Benjamin,17,0,35,18
1657084752926,MATH 103A,A01,083777,Greenfeld; Be'Eri,2,0,36,34
1657084752926,MATH 103A,A02,083778,Greenfeld; Be'Eri,5,0,36,31
1657084752926,MATH 103A,A03,093561,Greenfeld; Be'Eri,4,0,36,32
1657084752926,MATH 103A,B01,083779,Greenfeld; Be'Eri,6,0,36,30
1657084752926,MATH 103A,B02,083780,Greenfeld; Be'Eri,2,0,36,34
1657084752926,MATH 103A,B03,093562,Greenfeld; Be'Eri,3,0,36,33
1657084758951,MATH 105,A01,085443,Carter; Anne Toulson,14,0,35,21
1657084758951,MATH 105,A02,093477,Carter; Anne Toulson,20,0,35,15
1657084764975,MATH 109,A01,083213,Ganzberger; Geoffrey Michael,2,0,34,32
1657084764975,MATH 109,A02,083214,Ganzberger; Geoffrey Michael,2,0,34,32
1657084764975,MATH 109,A03,093478,Ganzberger; Geoffrey Michael,1,0,34,33
1657084764975,MATH 109,B01,083215,Ganzberger; Geoffrey Michael,1,0,32,31
1657084764975,MATH 109,B02,083216,Ganzberger; Geoffrey Michael,1,0,32,31
1657084764975,MATH 109,B03,093479,Ganzberger; Geoffrey Michael,6,0,32,26
1657084771000,MATH 142A,A01,083219,Chow; Bennett,6,0,32,26
1657084771000,MATH 142A,A02,083220,Chow; Bennett,10,0,32,22
1657084771000,MATH 142A,A03,093480,Chow; Bennett,7,0,32,25
1657084771000,MATH 142A,B03,093481,Chow; Bennett,8,0,32,24
1657084771000,MATH 142A,B04,093558,Chow; Bennett,11,0,32,21
1657084771000,MATH 142A,B05,093559,Chow; Bennett,6,0,32,26
1657084777028,MATH 193A,A01,083224,Rotar; Vladimir,7,0,34,27
1657084777028,MATH 193A,A02,083225,Rotar; Vladimir,5,0,34,29
1657084777028,MATH 193A,A03,083781,Rotar; Vladimir,1,0,34,33
1657084777028,MATH 193A,A04,083782,Rotar; Vladimir,6,0,34,28
1657084777028,MATH 193A,A05,093482,Rotar; Vladimir,6,0,34,28
1657084783065,MATH 197,001,091859,McAuley; Julian John,9999,0,9999,0
1657084783065,MATH 197,002,095566,Kedlaya; Kiran S.,9997,0,9999,2
1657084783065,MATH 197,003,095567,Xiao; Ming,9999,0,9999,0
1657084783065,MATH 197,004,095571,Perols; Johan Lars,9998,0,9999,1
1657084790128,COGS 9,A01,083615,Shannon; Kyle Michael,7,0,75,68
1657084796153,COGS 11,A01,083617,Boyle; Mary E. T.,21,0,48,27
1657084802175,COGS 13,A01,083071,Bastos; Amalia Pinkusfeld,9,0,71,62
1657084808201,COGS 14A,A01,092681,Semenuks; Arturs,1,1,100,99
1657084814227,COGS 14B,A01,083073,Cheng; Tzu-Han,5,0,63,58
1657084820254,COGS 17,A01,092677,Semenuks; Arturs,4,0,81,77
1657084826286,COGS 100,A01,083619,Allen; Michael Gordon,15,0,70,55
1657084832312,COGS 101A,A01,083621,Davis; Joshua Daniel,9,0,68,59
1657084838341,COGS 101B,A01,091572,Allen; Michael Gordon,8,0,65,57
1657084844372,COGS 101C,A01,083625,Delgado; Tania,17,0,35,18
1657084850399,COGS 107A,A01,083627,Boyle; Mary E. T.,13,0,60,47
1657084856427,COGS 118A,A01,083075,Gupta; Anjum,15,0,76,61
1657084862456,CSE 3,A50,083646,Miranda; Gregory Joseph,22,0,50,28
1657084868479,CSE 8A,A50,083650,Miranda; Gregory Joseph,17,1,56,39
1657084874505,CSE 11,A01,083080,Cao; Yingjun,4,15,40,36
1657084880528,CSE 12,A01,083652,Krause-Levy; Sophia Louisa,23,1,120,97
1657084886552,CSE 15L,A01,083654,Morris; Justin Loren,9,0,50,41
1657084886552,CSE 15L,A02,083655,Morris; Justin Loren,9,0,50,41
1657084892575,CSE 20,A01,083657,Tran; Khoa Dang,37,0,80,43
1657084898601,CSE 21,A01,095574,Bach; Quang Tran,21,0,48,27
1657084904624,CSE 30,A01,083084,Eldon; John,4,0,80,76
1657084904624,CSE 30,B01,095061,Bhaskar; Nishant,6,0,50,44
1657084910649,CSE 100,A01,083659,Cao; Yingjun,3,4,70,67
1657084916674,CSE 134B,A01,083661,Powell; Thomas Allan,19,0,100,81
1657084922698,CSE 140,A01,083663,Gungor; Onat,14,0,85,71
1657084928730,CSE 140L,A01,083088,Eldon; John,16,0,100,84
1657084934767,CSE 175,A01,083665,Kumar; Rakesh,3,0,25,22
1657084940794,CSE 190,A00,092507,Dubnov; Shlomo,7,0,20,13
1657084946816,ECE 45,A01,083139,Congero; Spencer William,5,0,75,70
1657084952840,ECE 65,A50,083695,Saad; Andrew S,12,0,30,18
1657084952840,ECE 65,A51,095125,Saad; Andrew S,25,0,26,1
1657084958863,ECE 109,A01,091882,Touri; Behrouz,16,0,70,54
1657084964886,ECE 180,A00,083140,Abi Samra; Nicholas Camill,1,0,30,29
1657084964886,ECE 180,B00,083141,Abi Samra; Nicholas Camill,0,0,30,30
1657084970914,MATH 10A,A01,083735,Patchell; Gregory David,1,0,30,29
1657084970914,MATH 10A,A02,083736,Patchell; Gregory David,20,0,30,10
1657084970914,MATH 10A,A03,083737,Patchell; Gregory David,16,0,30,14
1657084976943,MATH 10B,A01,083207,Lim; Seonhee,7,0,34,27
1657084976943,MATH 10B,A02,083208,Lim; Seonhee,9,0,35,26
1657084976943,MATH 10B,A03,093472,Lim; Seonhee,4,0,34,30
1657084976943,MATH 10B,B01,083739,Sinha; Shubham,9,0,30,21
1657084982974,MATH 18,A01,083743,Cinel; Cameron Alexander,6,0,30,24
1657084982974,MATH 18,A02,083744,Cinel; Cameron Alexander,15,0,30,15
1657084982974,MATH 18,A03,083745,Cinel; Cameron Alexander,8,0,30,22
1657084982974,MATH 18,B01,083748,Rideout; David Porter,4,0,37,33
1657084982974,MATH 18,B02,083749,Rideout; David Porter,3,0,36,33
1657084982974,MATH 18,B03,083750,Rideout; David Porter,2,0,37,35
1657084982974,MATH 18,B04,083751,Rideout; David Porter,5,0,36,31
1657084982974,MATH 18,B05,093473,Rideout; David Porter,4,0,36,32
1657084982974,MATH 18,B06,093474,Rideout; David Porter,5,0,36,31
1657084989000,MATH 20A,A01,083754,Zheng; Zequn,12,0,40,28
1657084995022,MATH 20B,A01,083756,Briones; Jor-el Thomas Caparas,1,0,36,35
1657084995022,MATH 20B,A02,083757,Briones; Jor-el Thomas Caparas,1,0,36,35
1657084995022,MATH 20B,A03,093475,Briones; Jor-el Thomas Caparas,0,0,36,36
1657085001051,MATH 20C,A01,083760,Briones; Jor-el Thomas Caparas,1,0,35,34
1657085001051,MATH 20C,A02,083761,Briones; Jor-el Thomas Caparas,8,0,35,27
1657085001051,MATH 20C,A03,093476,Briones; Jor-el Thomas Caparas,0,1,36,36
1657085001051,MATH 20C,B01,083762,Bach; Quang Tran,0,0,30,30
1657085007080,MATH 20D,A01,083765,Tran; Brian Kha,4,0,30,26
1657085007080,MATH 20D,A02,083766,Tran; Brian Kha,5,0,30,25
1657085007080,MATH 20D,A03,083767,Tran; Brian Kha,3,0,30,27
1657085013109,MATH 20E,A01,083771,Ganguly; Soumya,5,0,32,27
1657085013109,MATH 20E,A02,083772,Ganguly; Soumya,6,0,32,26
1657085013109,MATH 20E,B01,083773,Ciotti; Benjamin,18,0,35,17
1657085013109,MATH 20E,B02,083774,Ciotti; Benjamin,17,0,35,18
1657085019131,MATH 103A,A01,083777,Greenfeld; Be'Eri,2,0,36,34
1657085019131,MATH 103A,A02,083778,Greenfeld; Be'Eri,5,0,36,31
1657085019131,MATH 103A,A03,093561,Greenfeld; Be'Eri,4,0,36,32
1657085019131,MATH 103A,B01,083779,Greenfeld; Be'Eri,6,0,36,30
1657085019131,MATH 103A,B02,083780,Greenfeld; Be'Eri,2,0,36,34
1657085019131,MATH 103A,B03,093562,Greenfeld; Be'Eri,3,0,36,33
1657085025170,MATH 105,A01,085443,Carter; Anne Toulson,14,0,35,21
1657085025170,MATH 105,A02,093477,Carter; Anne Toulson,20,0,35,15
1657085031198,MATH 109,A01,083213,Ganzberger; Geoffrey Michael,2,0,34,32
1657085031198,MATH 109,A02,083214,Ganzberger; Geoffrey Michael,2,0,34,32
1657085031198,MATH 109,A03,093478,Ganzberger; Geoffrey Michael,1,0,34,33
1657085031198,MATH 109,B01,083215,Ganzberger; Geoffrey Michael,1,0,32,31
1657085031198,MATH 109,B02,083216,Ganzberger; Geoffrey Michael,1,0,32,31
1657085031198,MATH 109,B03,093479,Ganzberger; Geoffrey Michael,6,0,32,26
1657085037222,MATH 142A,A01,083219,Chow; Bennett,6,0,32,26
1657085037222,MATH 142A,A02,083220,Chow; Bennett,10,0,32,22
1657085037222,MATH 142A,A03,093480,Chow; Bennett,7,0,32,25
1657085037222,MATH 142A,B03,093481,Chow; Bennett,8,0,32,24
1657085037222,MATH 142A,B04,093558,Chow; Bennett,11,0,32,21
1657085037222,MATH 142A,B05,093559,Chow; Bennett,6,0,32,26
1657085043250,MATH 193A,A01,083224,Rotar; Vladimir,7,0,34,27
1657085043250,MATH 193A,A02,083225,Rotar; Vladimir,5,0,34,29
1657085043250,MATH 193A,A03,083781,Rotar; Vladimir,1,0,34,33
1657085043250,MATH 193A,A04,083782,Rotar; Vladimir,6,0,34,28
1657085043250,MATH 193A,A05,093482,Rotar; Vladimir,6,0,34,28
1657085049281,MATH 197,001,091859,McAuley; Julian John,9999,0,9999,0
1657085049281,MATH 197,002,095566,Kedlaya; Kiran S.,9997,0,9999,2
1657085049281,MATH 197,003,095567,Xiao; Ming,9999,0,9999,0
1657085049281,MATH 197,004,095571,Perols; Johan Lars,9998,0,9999,1
1657085056347,COGS 9,A01,083615,Shannon; Kyle Michael,7,0,75,68
1657085062368,COGS 11,A01,083617,Boyle; Mary E. T.,21,0,48,27
1657085068396,COGS 13,A01,083071,Bastos; Amalia Pinkusfeld,9,0,71,62
1657085074429,COGS 14A,A01,092681,Semenuks; Arturs,1,1,100,99
1657085080453,COGS 14B,A01,083073,Cheng; Tzu-Han,5,0,63,58
1657085086481,COGS 17,A01,092677,Semenuks; Arturs,4,0,81,77
1657085092507,COGS 100,A01,083619,Allen; Michael Gordon,15,0,70,55
1657085098534,COGS 101A,A01,083621,Davis; Joshua Daniel,9,0,68,59
1657085104557,COGS 101B,A01,091572,Allen; Michael Gordon,8,0,65,57
1657085110586,COGS 101C,A01,083625,Delgado; Tania,17,0,35,18
1657085116613,COGS 107A,A01,083627,Boyle; Mary E. T.,13,0,60,47
1657085122639,COGS 118A,A01,083075,Gupta; Anjum,15,0,76,61
1657085128662,CSE 3,A50,083646,Miranda; Gregory Joseph,22,0,50,28
1657085134690,CSE 8A,A50,083650,Miranda; Gregory Joseph,17,1,56,39
1657085140790,CSE 11,A01,083080,Cao; Yingjun,4,15,40,36
1657085146813,CSE 12,A01,083652,Krause-Levy; Sophia Louisa,23,1,120,97
1657085152846,CSE 15L,A01,083654,Morris; Justin Loren,9,0,50,41
1657085152846,CSE 15L,A02,083655,Morris; Justin Loren,9,0,50,41
1657085158871,CSE 20,A01,083657,Tran; Khoa Dang,37,0,80,43
1657085164894,CSE 21,A01,095574,Bach; Quang Tran,21,0,48,27
1657085170918,CSE 30,A01,083084,Eldon; John,4,0,80,76
1657085170918,CSE 30,B01,095061,Bhaskar; Nishant,6,0,50,44
1657085176941,CSE 100,A01,083659,Cao; Yingjun,3,4,70,67
1657085182968,CSE 134B,A01,083661,Powell; Thomas Allan,19,0,100,81
1657085188993,CSE 140,A01,083663,Gungor; Onat,14,0,85,71
1657085195018,CSE 140L,A01,083088,Eldon; John,16,0,100,84
1657085201041,CSE 175,A01,083665,Kumar; Rakesh,3,0,25,22
1657085207066,CSE 190,A00,092507,Dubnov; Shlomo,7,0,20,13
1657085213092,ECE 45,A01,083139,Congero; Spencer William,5,0,75,70
1657085219117,ECE 65,A50,083695,Saad; Andrew S,12,0,30,18
1657085219117,ECE 65,A51,095125,Saad; Andrew S,25,0,26,1
1657085225153,ECE 109,A01,091882,Touri; Behrouz,16,0,70,54
1657085231175,ECE 180,A00,083140,Abi Samra; Nicholas Camill,1,0,30,29
1657085231175,ECE 180,B00,083141,Abi Samra; Nicholas Camill,0,0,30,30
1657085237211,MATH 10A,A01,083735,Patchell; Gregory David,1,0,30,29
1657085237211,MATH 10A,A02,083736,Patchell; Gregory David,20,0,30,10
1657085237211,MATH 10A,A03,083737,Patchell; Gregory David,16,0,30,14
1657085243241,MATH 10B,A01,083207,Lim; Seonhee,7,0,34,27
1657085243241,MATH 10B,A02,083208,Lim; Seonhee,9,0,35,26
1657085243241,MATH 10B,A03,093472,Lim; Seonhee,4,0,34,30
1657085243241,MATH 10B,B01,083739,Sinha; Shubham,9,0,30,21
1657085249269,MATH 18,A01,083743,Cinel; Cameron Alexander,6,0,30,24
1657085249269,MATH 18,A02,083744,Cinel; Cameron Alexander,15,0,30,15
1657085249269,MATH 18,A03,083745,Cinel; Cameron Alexander,8,0,30,22
1657085249269,MATH 18,B01,083748,Rideout; David Porter,4,0,37,33
1657085249269,MATH 18,B02,083749,Rideout; David Porter,3,0,36,33
1657085249269,MATH 18,B03,083750,Rideout; David Porter,2,0,37,35
1657085249269,MATH 18,B04,083751,Rideout; David Porter,5,0,36,31
1657085249269,MATH 18,B05,093473,Rideout; David Porter,4,0,36,32
1657085249269,MATH 18,B06,093474,Rideout; David Porter,5,0,36,31
1657085255296,MATH 20A,A01,083754,Zheng; Zequn,12,0,40,28
1657085261321,MATH 20B,A01,083756,Briones; Jor-el Thomas Caparas,1,0,36,35
1657085261321,MATH 20B,A02,083757,Briones; Jor-el Thomas Caparas,1,0,36,35
1657085261321,MATH 20B,A03,093475,Briones; Jor-el Thomas Caparas,0,0,36,36
1657085267345,MATH 20C,A01,083760,Briones; Jor-el Thomas Caparas,1,0,35,34
1657085267345,MATH 20C,A02,083761,Briones; Jor-el Thomas Caparas,8,0,35,27
1657085267345,MATH 20C,A03,093476,Briones; Jor-el Thomas Caparas,0,1,36,36
1657085267345,MATH 20C,B01,083762,Bach; Quang Tran,0,0,30,30
1657085273373,MATH 20D,A01,083765,Tran; Brian Kha,4,0,30,26
1657085273373,MATH 20D,A02,083766,Tran; Brian Kha,5,0,30,25
1657085273373,MATH 20D,A03,083767,Tran; Brian Kha,3,0,30,27
1657085279398,MATH 20E,A01,083771,Ganguly; Soumya,5,0,32,27
1657085279398,MATH 20E,A02,083772,Ganguly; Soumya,6,0,32,26
1657085279398,MATH 20E,B01,083773,Ciotti; Benjamin,18,0,35,17
1657085279398,MATH 20E,B02,083774,Ciotti; Benjamin,17,0,35,18
1657085285432,MATH 103A,A01,083777,Greenfeld; Be'Eri,2,0,36,34
1657085285432,MATH 103A,A02,083778,Greenfeld; Be'Eri,5,0,36,31
1657085285432,MATH 103A,A03,093561,Greenfeld; Be'Eri,4,0,36,32
1657085285432,MATH 103A,B01,083779,Greenfeld; Be'Eri,6,0,36,30
1657085285432,MATH 103A,B02,083780,Greenfeld; Be'Eri,2,0,36,34
1657085285432,MATH 103A,B03,093562,Greenfeld; Be'Eri,3,0,36,33
1657085291459,MATH 105,A01,085443,Carter; Anne Toulson,14,0,35,21
1657085291459,MATH 105,A02,093477,Carter; Anne Toulson,20,0,35,15
1657085297482,MATH 109,A01,083213,Ganzberger; Geoffrey Michael,2,0,34,32
1657085297482,MATH 109,A02,083214,Ganzberger; Geoffrey Michael,2,0,34,32
1657085297482,MATH 109,A03,093478,Ganzberger; Geoffrey Michael,1,0,34,33
1657085297482,MATH 109,B01,083215,Ganzberger; Geoffrey Michael,1,0,32,31
1657085297482,MATH 109,B02,083216,Ganzberger; Geoffrey Michael,1,0,32,31
1657085297482,MATH 109,B03,093479,Ganzberger; Geoffrey Michael,6,0,32,26
1657085303507,MATH 142A,A01,083219,Chow; Bennett,6,0,32,26
1657085303507,MATH 142A,A02,083220,Chow; Bennett,10,0,32,22
1657085303507,MATH 142A,A03,093480,Chow; Bennett,7,0,32,25
1657085303507,MATH 142A,B03,093481,Chow; Bennett,8,0,32,24
1657085303507,MATH 142A,B04,093558,Chow; Bennett,11,0,32,21
1657085303507,MATH 142A,B05,093559,Chow; Bennett,6,0,32,26
1657085309536,MATH 193A,A01,083224,Rotar; Vladimir,7,0,34,27
1657085309536,MATH 193A,A02,083225,Rotar; Vladimir,5,0,34,29
1657085309536,MATH 193A,A03,083781,Rotar; Vladimir,1,0,34,33
1657085309536,MATH 193A,A04,083782,Rotar; Vladimir,6,0,34,28
1657085309536,MATH 193A,A05,093482,Rotar; Vladimir,6,0,34,28
1657085315563,MATH 197,001,091859,McAuley; Julian John,9999,0,9999,0
1657085315563,MATH 197,002,095566,Kedlaya; Kiran S.,9997,0,9999,2
1657085315563,MATH 197,003,095567,Xiao; Ming,9999,0,9999,0
1657085315563,MATH 197,004,095571,Perols; Johan Lars,9998,0,9999,1
1657085322618,COGS 9,A01,083615,Shannon; Kyle Michael,7,0,75,68
1657085328643,COGS 11,A01,083617,Boyle; Mary E. T.,21,0,48,27
1657085334674,COGS 13,A01,083071,Bastos; Amalia Pinkusfeld,9,0,71,62
1657085340699,COGS 14A,A01,092681,Semenuks; Arturs,1,1,100,99
1657085346730,COGS 14B,A01,083073,Cheng; Tzu-Han,5,0,63,58
1657085352752,COGS 17,A01,092677,Semenuks; Arturs,4,0,81,77
1657085358784,COGS 100,A01,083619,Allen; Michael Gordon,15,0,70,55
1657085364809,COGS 101A,A01,083621,Davis; Joshua Daniel,9,0,68,59
1657085370833,COGS 101B,A01,091572,Allen; Michael Gordon,8,0,65,57
1657085376860,COGS 101C,A01,083625,Delgado; Tania,17,0,35,18
1657085382884,COGS 107A,A01,083627,Boyle; Mary E. T.,13,0,60,47
1657085388911,COGS 118A,A01,083075,Gupta; Anjum,15,0,76,61
1657085394936,CSE 3,A50,083646,Miranda; Gregory Joseph,22,0,50,28
1657085400964,CSE 8A,A50,083650,Miranda; Gregory Joseph,17,1,56,39
1657085406986,CSE 11,A01,083080,Cao; Yingjun,4,15,40,36
1657085413023,CSE 12,A01,083652,Krause-Levy; Sophia Louisa,23,1,120,97
1657085419049,CSE 15L,A01,083654,Morris; Justin Loren,9,0,50,41
1657085419049,CSE 15L,A02,083655,Morris; Justin Loren,9,0,50,41
1657085425076,CSE 20,A01,083657,Tran; Khoa Dang,37,0,80,43
1657085431099,CSE 21,A01,095574,Bach; Quang Tran,21,0,48,27
1657085437126,CSE 30,A01,083084,Eldon; John,4,0,80,76
1657085437126,CSE 30,B01,095061,Bhaskar; Nishant,6,0,50,44
1657085443153,CSE 100,A01,083659,Cao; Yingjun,3,4,70,67
1657085449176,CSE 134B,A01,083661,Powell; Thomas Allan,19,0,100,81
1657085455204,CSE 140,A01,083663,Gungor; Onat,14,0,85,71
1657085461230,CSE 140L,A01,083088,Eldon; John,16,0,100,84
1657085467261,CSE 175,A01,083665,Kumar; Rakesh,3,0,25,22
1657085473292,CSE 190,A00,092507,Dubnov; Shlomo,7,0,20,13
1657085479324,ECE 45,A01,083139,Congero; Spencer William,5,0,75,70
1657085485348,ECE 65,A50,083695,Saad; Andrew S,12,0,30,18
1657085485348,ECE 65,A51,095125,Saad; Andrew S,25,0,26,1
1657085491372,ECE 109,A01,091882,Touri; Behrouz,16,0,70,54
1657085497397,ECE 180,A00,083140,Abi Samra; Nicholas Camill,1,0,30,29
1657085497397,ECE 180,B00,083141,Abi Samra; Nicholas Camill,0,0,30,30
1657085503426,MATH 10A,A01,083735,Patchell; Gregory David,1,0,30,29
1657085503426,MATH 10A,A02,083736,Patchell; Gregory David,20,0,30,10
1657085503426,MATH 10A,A03,083737,Patchell; Gregory David,16,0,30,14
1657085509452,MATH 10B,A01,083207,Lim; Seonhee,7,0,34,27
1657085509452,MATH 10B,A02,083208,Lim; Seonhee,9,0,35,26
1657085509452,MATH 10B,A03,093472,Lim; Seonhee,4,0,34,30
1657085509452,MATH 10B,B01,083739,Sinha; Shubham,9,0,30,21
1657085515476,MATH 18,A01,083743,Cinel; Cameron Alexander,6,0,30,24
1657085515476,MATH 18,A02,083744,Cinel; Cameron Alexander,15,0,30,15
1657085515476,MATH 18,A03,083745,Cinel; Cameron Alexander,8,0,30,22
1657085515476,MATH 18,B01,083748,Rideout; David Porter,4,0,37,33
1657085515476,MATH 18,B02,083749,Rideout; David Porter,3,0,36,33
1657085515476,MATH 18,B03,083750,Rideout; David Porter,2,0,37,35
1657085515476,MATH 18,B04,083751,Rideout; David Porter,5,0,36,31
1657085515476,MATH 18,B05,093473,Rideout; David Porter,4,0,36,32
1657085515476,MATH 18,B06,093474,Rideout; David Porter,5,0,36,31
1657085521514,MATH 20A,A01,083754,Zheng; Zequn,12,0,40,28
1657085527543,MATH 20B,A01,083756,Briones; Jor-el Thomas Caparas,1,0,36,35
1657085527543,MATH 20B,A02,083757,Briones; Jor-el Thomas Caparas,1,0,36,35
1657085527543,MATH 20B,A03,093475,Briones; Jor-el Thomas Caparas,0,0,36,36
1657085533568,MATH 20C,A01,083760,Briones; Jor-el Thomas Caparas,1,0,35,34
1657085533568,MATH 20C,A02,083761,Briones; Jor-el Thomas Caparas,8,0,35,27
1657085533568,MATH 20C,A03,093476,Briones; Jor-el Thomas Caparas,0,1,36,36
1657085533568,MATH 20C,B01,083762,Bach; Quang Tran,0,0,30,30
1657085539591,MATH 20D,A01,083765,Tran; Brian Kha,4,0,30,26
1657085539591,MATH 20D,A02,083766,Tran; Brian Kha,5,0,30,25
1657085539591,MATH 20D,A03,083767,Tran; Brian Kha,3,0,30,27
1657085545616,MATH 20E,A01,083771,Ganguly; Soumya,5,0,32,27
1657085545616,MATH 20E,A02,083772,Ganguly; Soumya,6,0,32,26
1657085545616,MATH 20E,B01,083773,Ciotti; Benjamin,18,0,35,17
1657085545616,MATH 20E,B02,083774,Ciotti; Benjamin,17,0,35,18
1657085551641,MATH 103A,A01,083777,Greenfeld; Be'Eri,2,0,36,34
1657085551641,MATH 103A,A02,083778,Greenfeld; Be'Eri,5,0,36,31
1657085551641,MATH 103A,A03,093561,Greenfeld; Be'Eri,4,0,36,32
1657085551641,MATH 103A,B01,083779,Greenfeld; Be'Eri,6,0,36,30
1657085551641,MATH 103A,B02,083780,Greenfeld; Be'Eri,2,0,36,34
1657085551641,MATH 103A,B03,093562,Greenfeld; Be'Eri,3,0,36,33
1657085557667,MATH 105,A01,085443,Carter; Anne Toulson,14,0,35,21
1657085557667,MATH 105,A02,093477,Carter; Anne Toulson,20,0,35,15
1657085563692,MATH 109,A01,083213,Ganzberger; Geoffrey Michael,2,0,34,32
1657085563692,MATH 109,A02,083214,Ganzberger; Geoffrey Michael,2,0,34,32
1657085563692,MATH 109,A03,093478,Ganzberger; Geoffrey Michael,1,0,34,33
1657085563692,MATH 109,B01,083215,Ganzberger; Geoffrey Michael,1,0,32,31
1657085563692,MATH 109,B02,083216,Ganzberger; Geoffrey Michael,1,0,32,31
1657085563692,MATH 109,B03,093479,Ganzberger; Geoffrey Michael,6,0,32,26
1657085569720,MATH 142A,A01,083219,Chow; Bennett,6,0,32,26
1657085569720,MATH 142A,A02,083220,Chow; Bennett,10,0,32,22
1657085569720,MATH 142A,A03,093480,Chow; Bennett,7,0,32,25
1657085569720,MATH 142A,B03,093481,Chow; Bennett,8,0,32,24
1657085569720,MATH 142A,B04,093558,Chow; Bennett,11,0,32,21
1657085569720,MATH 142A,B05,093559,Chow; Bennett,6,0,32,26
1657085575744,MATH 193A,A01,083224,Rotar; Vladimir,7,0,34,27
1657085575744,MATH 193A,A02,083225,Rotar; Vladimir,5,0,34,29
1657085575744,MATH 193A,A03,083781,Rotar; Vladimir,1,0,34,33
1657085575744,MATH 193A,A04,083782,Rotar; Vladimir,6,0,34,28
1657085575744,MATH 193A,A05,093482,Rotar; Vladimir,6,0,34,28
1657085581769,MATH 197,001,091859,McAuley; Julian John,9999,0,9999,0
1657085581769,MATH 197,002,095566,Kedlaya; Kiran S.,9997,0,9999,2
1657085581769,MATH 197,003,095567,Xiao; Ming,9999,0,9999,0
1657085581769,MATH 197,004,095571,Perols; Johan Lars,9998,0,9999,1
1657085588832,COGS 9,A01,083615,Shannon; Kyle Michael,7,0,75,68
1657085594856,COGS 11,A01,083617,Boyle; Mary E. T.,21,0,48,27
1657085600883,COGS 13,A01,083071,Bastos; Amalia Pinkusfeld,9,0,71,62
1657085606909,COGS 14A,A01,092681,Semenuks; Arturs,1,1,100,99
1657085612934,COGS 14B,A01,083073,Cheng; Tzu-Han,5,0,63,58
1657085618969,COGS 17,A01,092677,Semenuks; Arturs,4,0,81,77
1657085624992,COGS 100,A01,083619,Allen; Michael Gordon,15,0,70,55
1657085631015,COGS 101A,A01,083621,Davis; Joshua Daniel,9,0,68,59
1657085637045,COGS 101B,A01,091572,Allen; Michael Gordon,8,0,65,57
1657085643069,COGS 101C,A01,083625,Delgado; Tania,17,0,35,18
1657085649096,COGS 107A,A01,083627,Boyle; Mary E. T.,13,0,60,47
1657085655131,COGS 118A,A01,083075,Gupta; Anjum,15,0,76,61
1657085661153,CSE 3,A50,083646,Miranda; Gregory Joseph,22,0,50,28
1657085667177,CSE 8A,A50,083650,Miranda; Gregory Joseph,17,1,56,39
1657085673203,CSE 11,A01,083080,Cao; Yingjun,4,15,40,36
1657085679226,CSE 12,A01,083652,Krause-Levy; Sophia Louisa,23,1,120,97
1657085685254,CSE 15L,A01,083654,Morris; Justin Loren,9,0,50,41
1657085685254,CSE 15L,A02,083655,Morris; Justin Loren,9,0,50,41
1657085691277,CSE 20,A01,083657,Tran; Khoa Dang,37,0,80,43
1657085697305,CSE 21,A01,095574,Bach; Quang Tran,21,0,48,27
1657085703330,CSE 30,A01,083084,Eldon; John,4,0,80,76
1657085703330,CSE 30,B01,095061,Bhaskar; Nishant,6,0,50,44
1657085709354,CSE 100,A01,083659,Cao; Yingjun,3,4,70,67
1657085715378,CSE 134B,A01,083661,Powell; Thomas Allan,19,0,100,81
1657085721400,CSE 140,A01,083663,Gungor; Onat,14,0,85,71
1657085727424,CSE 140L,A01,083088,Eldon; John,16,0,100,84
1657085733450,CSE 175,A01,083665,Kumar; Rakesh,3,0,25,22
1657085739565,CSE 190,A00,092507,Dubnov; Shlomo,7,0,20,13
1657085745591,ECE 45,A01,083139,Congero; Spencer William,5,0,75,70
1657085751620,ECE 65,A50,083695,Saad; Andrew S,12,0,30,18
1657085751620,ECE 65,A51,095125,Saad; Andrew S,25,0,26,1
1657085757642,ECE 109,A01,091882,Touri; Behrouz,16,0,70,54
1657085763665,ECE 180,A00,083140,Abi Samra; Nicholas Camill,1,0,30,29
1657085763665,ECE 180,B00,083141,Abi Samra; Nicholas Camill,0,0,30,30
1657085769693,MATH 10A,A01,083735,Patchell; Gregory David,1,0,30,29
1657085769693,MATH 10A,A02,083736,Patchell; Gregory David,20,0,30,10
1657085769693,MATH 10A,A03,083737,Patchell; Gregory David,16,0,30,14
1657085775722,MATH 10B,A01,083207,Lim; Seonhee,7,0,34,27
1657085775722,MATH 10B,A02,083208,Lim; Seonhee,9,0,35,26
1657085775722,MATH 10B,A03,093472,Lim; Seonhee,4,0,34,30
1657085775722,MATH 10B,B01,083739,Sinha; Shubham,9,0,30,21
1657085781746,MATH 18,A01,083743,Cinel; Cameron Alexander,6,0,30,24
1657085781746,MATH 18,A02,083744,Cinel; Cameron Alexander,15,0,30,15
1657085781746,MATH 18,A03,083745,Cinel; Cameron Alexander,8,0,30,22
1657085781746,MATH 18,B01,083748,Rideout; David Porter,4,0,37,33
1657085781746,MATH 18,B02,083749,Rideout; David Porter,3,0,36,33
1657085781746,MATH 18,B03,083750,Rideout; David Porter,2,0,37,35
1657085781746,MATH 18,B04,083751,Rideout; David Porter,5,0,36,31
1657085781746,MATH 18,B05,093473,Rideout; David Porter,4,0,36,32
1657085781746,MATH 18,B06,093474,Rideout; David Porter,5,0,36,31
1657085787781,MATH 20A,A01,083754,Zheng; Zequn,12,0,40,28
1657085793809,MATH 20B,A01,083756,Briones; Jor-el Thomas Caparas,1,0,36,35
1657085793809,MATH 20B,A02,083757,Briones; Jor-el Thomas Caparas,1,0,36,35
1657085793809,MATH 20B,A03,093475,Briones; Jor-el Thomas Caparas,0,0,36,36
1657085799832,MATH 20C,A01,083760,Briones; Jor-el Thomas Caparas,1,0,35,34
1657085799832,MATH 20C,A02,083761,Briones; Jor-el Thomas Caparas,8,0,35,27
1657085799832,MATH 20C,A03,093476,Briones; Jor-el Thomas Caparas,0,1,36,36
1657085799832,MATH 20C,B01,083762,Bach; Quang Tran,0,0,30,30
1657085805857,MATH 20D,A01,083765,Tran; Brian Kha,4,0,30,26
1657085805857,MATH 20D,A02,083766,Tran; Brian Kha,5,0,30,25
1657085805857,MATH 20D,A03,083767,Tran; Brian Kha,3,0,30,27
1657085811880,MATH 20E,A01,083771,Ganguly; Soumya,6,0,32,26
1657085811880,MATH 20E,A02,083772,Ganguly; Soumya,6,0,32,26
1657085811880,MATH 20E,B01,083773,Ciotti; Benjamin,18,0,35,17
1657085811880,MATH 20E,B02,083774,Ciotti; Benjamin,17,0,35,18
1657085817917,MATH 103A,A01,083777,Greenfeld; Be'Eri,2,0,36,34
1657085817917,MATH 103A,A02,083778,Greenfeld; Be'Eri,5,0,36,31
1657085817917,MATH 103A,A03,093561,Greenfeld; Be'Eri,4,0,36,32
1657085817917,MATH 103A,B01,083779,Greenfeld; Be'Eri,6,0,36,30
1657085817917,MATH 103A,B02,083780,Greenfeld; Be'Eri,2,0,36,34
1657085817917,MATH 103A,B03,093562,Greenfeld; Be'Eri,3,0,36,33
1657085823944,MATH 105,A01,085443,Carter; Anne Toulson,14,0,35,21
1657085823944,MATH 105,A02,093477,Carter; Anne Toulson,20,0,35,15
1657085829966,MATH 109,A01,083213,Ganzberger; Geoffrey Michael,2,0,34,32
1657085829966,MATH 109,A02,083214,Ganzberger; Geoffrey Michael,2,0,34,32
1657085829966,MATH 109,A03,093478,Ganzberger; Geoffrey Michael,1,0,34,33
1657085829966,MATH 109,B01,083215,Ganzberger; Geoffrey Michael,1,0,32,31
1657085829966,MATH 109,B02,083216,Ganzberger; Geoffrey Michael,1,0,32,31
1657085829966,MATH 109,B03,093479,Ganzberger; Geoffrey Michael,6,0,32,26
1657085835991,MATH 142A,A01,083219,Chow; Bennett,6,0,32,26
1657085835991,MATH 142A,A02,083220,Chow; Bennett,10,0,32,22
1657085835991,MATH 142A,A03,093480,Chow; Bennett,7,0,32,25
1657085835991,MATH 142A,B03,093481,Chow; Bennett,8,0,32,24
1657085835991,MATH 142A,B04,093558,Chow; Bennett,11,0,32,21
1657085835991,MATH 142A,B05,093559,Chow; Bennett,6,0,32,26
1657085842015,MATH 193A,A01,083224,Rotar; Vladimir,7,0,34,27
1657085842015,MATH 193A,A02,083225,Rotar; Vladimir,5,0,34,29
1657085842015,MATH 193A,A03,083781,Rotar; Vladimir,1,0,34,33
1657085842015,MATH 193A,A04,083782,Rotar; Vladimir,6,0,34,28
1657085842015,MATH 193A,A05,093482,Rotar; Vladimir,6,0,34,28
1657085848038,MATH 197,001,091859,McAuley; Julian John,9999,0,9999,0
1657085848038,MATH 197,002,095566,Kedlaya; Kiran S.,9997,0,9999,2
1657085848038,MATH 197,003,095567,Xiao; Ming,9999,0,9999,0
1657085848038,MATH 197,004,095571,Perols; Johan Lars,9998,0,9999,1
1657085855089,COGS 9,A01,083615,Shannon; Kyle Michael,7,0,75,68
1657085861125,COGS 11,A01,083617,Boyle; Mary E. T.,21,0,48,27
1657085867148,COGS 13,A01,083071,Bastos; Amalia Pinkusfeld,9,0,71,62
1657085873171,COGS 14A,A01,092681,Semenuks; Arturs,1,1,100,99
1657085879194,COGS 14B,A01,083073,Cheng; Tzu-Han,5,0,63,58
1657085885219,COGS 17,A01,092677,Semenuks; Arturs,4,0,81,77
1657085891245,COGS 100,A01,083619,Allen; Michael Gordon,15,0,70,55
1657085897274,COGS 101A,A01,083621,Davis; Joshua Daniel,9,0,68,59
1657085903297,COGS 101B,A01,091572,Allen; Michael Gordon,8,0,65,57
1657085909320,COGS 101C,A01,083625,Delgado; Tania,17,0,35,18
1657085915343,COGS 107A,A01,083627,Boyle; Mary E. T.,13,0,60,47
1657085921364,COGS 118A,A01,083075,Gupta; Anjum,15,0,76,61
1657085927391,CSE 3,A50,083646,Miranda; Gregory Joseph,22,0,50,28
1657085933416,CSE 8A,A50,083650,Miranda; Gregory Joseph,17,1,56,39
1657085939444,CSE 11,A01,083080,Cao; Yingjun,4,15,40,36
1657085945467,CSE 12,A01,083652,Krause-Levy; Sophia Louisa,23,1,120,97
1657085951495,CSE 15L,A01,083654,Morris; Justin Loren,9,0,50,41
1657085951495,CSE 15L,A02,083655,Morris; Justin Loren,9,0,50,41
1657085957519,CSE 20,A01,083657,Tran; Khoa Dang,37,0,80,43
1657085963554,CSE 21,A01,095574,Bach; Quang Tran,21,0,48,27
1657085969581,CSE 30,A01,083084,Eldon; John,4,0,80,76
1657085969581,CSE 30,B01,095061,Bhaskar; Nishant,6,0,50,44
1657085975604,CSE 100,A01,083659,Cao; Yingjun,3,4,70,67
1657085981637,CSE 134B,A01,083661,Powell; Thomas Allan,19,0,100,81
1657085987668,CSE 140,A01,083663,Gungor; Onat,14,0,85,71
1657085993701,CSE 140L,A01,083088,Eldon; John,16,0,100,84
1657085999726,CSE 175,A01,083665,Kumar; Rakesh,3,0,25,22
1657086005752,CSE 190,A00,092507,Dubnov; Shlomo,7,0,20,13
1657086011779,ECE 45,A01,083139,Congero; Spencer William,5,0,75,70
1657086017815,ECE 65,A50,083695,Saad; Andrew S,12,0,30,18
1657086017815,ECE 65,A51,095125,Saad; Andrew S,25,0,26,1
1657086023842,ECE 109,A01,091882,Touri; Behrouz,16,0,70,54
1657086029866,ECE 180,A00,083140,Abi Samra; Nicholas Camill,1,0,30,29
1657086029866,ECE 180,B00,083141,Abi Samra; Nicholas Camill,0,0,30,30
1657086035889,MATH 10A,A01,083735,Patchell; Gregory David,1,0,30,29
1657086035889,MATH 10A,A02,083736,Patchell; Gregory David,20,0,30,10
1657086035889,MATH 10A,A03,083737,Patchell; Gregory David,16,0,30,14
1657086041919,MATH 10B,A01,083207,Lim; Seonhee,7,0,34,27
1657086041919,MATH 10B,A02,083208,Lim; Seonhee,9,0,35,26
1657086041919,MATH 10B,A03,093472,Lim; Seonhee,4,0,34,30
1657086041919,MATH 10B,B01,083739,Sinha; Shubham,9,0,30,21
1657086047944,MATH 18,A01,083743,Cinel; Cameron Alexander,6,0,30,24
1657086047944,MATH 18,A02,083744,Cinel; Cameron Alexander,15,0,30,15
1657086047944,MATH 18,A03,083745,Cinel; Cameron Alexander,8,0,30,22
1657086047944,MATH 18,B01,083748,Rideout; David Porter,4,0,37,33
1657086047944,MATH 18,B02,083749,Rideout; David Porter,3,0,36,33
1657086047944,MATH 18,B03,083750,Rideout; David Porter,2,0,37,35
1657086047944,MATH 18,B04,083751,Rideout; David Porter,5,0,36,31
1657086047944,MATH 18,B05,093473,Rideout; David Porter,4,0,36,32
1657086047944,MATH 18,B06,093474,Rideout; David Porter,5,0,36,31
1657086053967,MATH 20A,A01,083754,Zheng; Zequn,12,0,40,28
1657086059994,MATH 20B,A01,083756,Briones; Jor-el Thomas Caparas,1,0,36,35
1657086059994,MATH 20B,A02,083757,Briones; Jor-el Thomas Caparas,1,0,36,35
1657086059994,MATH 20B,A03,093475,Briones; Jor-el Thomas Caparas,0,0,36,36
1657086066022,MATH 20C,A01,083760,Briones; Jor-el Thomas Caparas,1,0,35,34
1657086066022,MATH 20C,A02,083761,Briones; Jor-el Thomas Caparas,8,0,35,27
1657086066022,MATH 20C,A03,093476,Briones; Jor-el Thomas Caparas,0,1,36,36
1657086066022,MATH 20C,B01,083762,Bach; Quang Tran,0,0,30,30
1657086072049,MATH 20D,A01,083765,Tran; Brian Kha,4,0,30,26
1657086072049,MATH 20D,A02,083766,Tran; Brian Kha,5,0,30,25
1657086072049,MATH 20D,A03,083767,Tran; Brian Kha,3,0,30,27
1657086078073,MATH 20E,A01,083771,Ganguly; Soumya,6,0,32,26
1657086078073,MATH 20E,A02,083772,Ganguly; Soumya,6,0,32,26
1657086078073,MATH 20E,B01,083773,Ciotti; Benjamin,18,0,35,17
1657086078073,MATH 20E,B02,083774,Ciotti; Benjamin,17,0,35,18
1657086084095,MATH 103A,A01,083777,Greenfeld; Be'Eri,2,0,36,34
1657086084095,MATH 103A,A02,083778,Greenfeld; Be'Eri,5,0,36,31
1657086084095,MATH 103A,A03,093561,Greenfeld; Be'Eri,4,0,36,32
1657086084095,MATH 103A,B01,083779,Greenfeld; Be'Eri,6,0,36,30
1657086084095,MATH 103A,B02,083780,Greenfeld; Be'Eri,2,0,36,34
1657086084095,MATH 103A,B03,093562,Greenfeld; Be'Eri,3,0,36,33
1657086090118,MATH 105,A01,085443,Carter; Anne Toulson,14,0,35,21
1657086090118,MATH 105,A02,093477,Carter; Anne Toulson,20,0,35,15
1657086096147,MATH 109,A01,083213,Ganzberger; Geoffrey Michael,2,0,34,32
1657086096147,MATH 109,A02,083214,Ganzberger; Geoffrey Michael,2,0,34,32
1657086096147,MATH 109,A03,093478,Ganzberger; Geoffrey Michael,1,0,34,33
1657086096147,MATH 109,B01,083215,Ganzberger; Geoffrey Michael,1,0,32,31
1657086096147,MATH 109,B02,083216,Ganzberger; Geoffrey Michael,1,0,32,31
1657086096147,MATH 109,B03,093479,Ganzberger; Geoffrey Michael,6,0,32,26
1657086102171,MATH 142A,A01,083219,Chow; Bennett,6,0,32,26
1657086102171,MATH 142A,A02,083220,Chow; Bennett,10,0,32,22
1657086102171,MATH 142A,A03,093480,Chow; Bennett,7,0,32,25
1657086102171,MATH 142A,B03,093481,Chow; Bennett,8,0,32,24
1657086102171,MATH 142A,B04,093558,Chow; Bennett,11,0,32,21
1657086102171,MATH 142A,B05,093559,Chow; Bennett,6,0,32,26
1657086108205,MATH 193A,A01,083224,Rotar; Vladimir,7,0,34,27
1657086108205,MATH 193A,A02,083225,Rotar; Vladimir,5,0,34,29
1657086108205,MATH 193A,A03,083781,Rotar; Vladimir,1,0,34,33
1657086108205,MATH 193A,A04,083782,Rotar; Vladimir,6,0,34,28
1657086108205,MATH 193A,A05,093482,Rotar; Vladimir,6,0,34,28
1657086114228,MATH 197,001,091859,McAuley; Julian John,9999,0,9999,0
1657086114228,MATH 197,002,095566,Kedlaya; Kiran S.,9997,0,9999,2
1657086114228,MATH 197,003,095567,Xiao; Ming,9999,0,9999,0
1657086114228,MATH 197,004,095571,Perols; Johan Lars,9998,0,9999,1
1657086121295,COGS 9,A01,083615,Shannon; Kyle Michael,7,0,75,68
1657086127324,COGS 11,A01,083617,Boyle; Mary E. T.,21,0,48,27
1657086133352,COGS 13,A01,083071,Bastos; Amalia Pinkusfeld,9,0,71,62
1657086139379,COGS 14A,A01,092681,Semenuks; Arturs,1,1,100,99
1657086145401,COGS 14B,A01,083073,Cheng; Tzu-Han,5,0,63,58
1657086151424,COGS 17,A01,092677,Semenuks; Arturs,4,0,81,77
1657086157448,COGS 100,A01,083619,Allen; Michael Gordon,15,0,70,55
1657086163492,COGS 101A,A01,083621,Davis; Joshua Daniel,9,0,68,59
1657086169521,COGS 101B,A01,091572,Allen; Michael Gordon,8,0,65,57
1657086175556,COGS 101C,A01,083625,Delgado; Tania,17,0,35,18
1657086181582,COGS 107A,A01,083627,Boyle; Mary E. T.,13,0,60,47
1657086187605,COGS 118A,A01,083075,Gupta; Anjum,15,0,76,61
1657086193630,CSE 3,A50,083646,Miranda; Gregory Joseph,22,0,50,28
1657086199658,CSE 8A,A50,083650,Miranda; Gregory Joseph,17,1,56,39
1657086205680,CSE 11,A01,083080,Cao; Yingjun,4,15,40,36
1657086211701,CSE 12,A01,083652,Krause-Levy; Sophia Louisa,23,1,120,97
1657086217723,CSE 15L,A01,083654,Morris; Justin Loren,9,0,50,41
1657086217723,CSE 15L,A02,083655,Morris; Justin Loren,9,0,50,41
1657086223746,CSE 20,A01,083657,Tran; Khoa Dang,37,0,80,43
1657086229768,CSE 21,A01,095574,Bach; Quang Tran,21,0,48,27
1657086235795,CSE 30,A01,083084,Eldon; John,4,0,80,76
1657086235795,CSE 30,B01,095061,Bhaskar; Nishant,6,0,50,44
1657086241822,CSE 100,A01,083659,Cao; Yingjun,3,4,70,67
1657086247843,CSE 134B,A01,083661,Powell; Thomas Allan,19,0,100,81
1657086253866,CSE 140,A01,083663,Gungor; Onat,14,0,85,71
1657086259890,CSE 140L,A01,083088,Eldon; John,16,0,100,84
1657086265914,CSE 175,A01,083665,Kumar; Rakesh,3,0,25,22
1657086271936,CSE 190,A00,092507,Dubnov; Shlomo,7,0,20,13
1657086277961,ECE 45,A01,083139,Congero; Spencer William,5,0,75,70
1657086283986,ECE 65,A50,083695,Saad; Andrew S,12,0,30,18
1657086283986,ECE 65,A51,095125,Saad; Andrew S,25,0,26,1
1657086290008,ECE 109,A01,091882,Touri; Behrouz,16,0,70,54
1657086296030,ECE 180,A00,083140,Abi Samra; Nicholas Camill,1,0,30,29
1657086296030,ECE 180,B00,083141,Abi Samra; Nicholas Camill,0,0,30,30
1657086302057,MATH 10A,A01,083735,Patchell; Gregory David,1,0,30,29
1657086302057,MATH 10A,A02,083736,Patchell; Gregory David,20,0,30,10
1657086302057,MATH 10A,A03,083737,Patchell; Gregory David,16,0,30,14
1657086308080,MATH 10B,A01,083207,Lim; Seonhee,7,0,34,27
1657086308080,MATH 10B,A02,083208,Lim; Seonhee,9,0,35,26
1657086308080,MATH 10B,A03,093472,Lim; Seonhee,4,0,34,30
1657086308080,MATH 10B,B01,083739,Sinha; Shubham,9,0,30,21
1657086314109,MATH 18,A01,083743,Cinel; Cameron Alexander,6,0,30,24
1657086314109,MATH 18,A02,083744,Cinel; Cameron Alexander,15,0,30,15
1657086314109,MATH 18,A03,083745,Cinel; Cameron Alexander,8,0,30,22
1657086314109,MATH 18,B01,083748,Rideout; David Porter,4,0,37,33
1657086314109,MATH 18,B02,083749,Rideout; David Porter,3,0,36,33
1657086314109,MATH 18,B03,083750,Rideout; David Porter,2,0,37,35
1657086314109,MATH 18,B04,083751,Rideout; David Porter,5,0,36,31
1657086314109,MATH 18,B05,093473,Rideout; David Porter,4,0,36,32
1657086314109,MATH 18,B06,093474,Rideout; David Porter,5,0,36,31
1657086320136,MATH 20A,A01,083754,Zheng; Zequn,12,0,40,28
1657086326160,MATH 20B,A01,083756,Briones; Jor-el Thomas Caparas,1,0,36,35
1657086326160,MATH 20B,A02,083757,Briones; Jor-el Thomas Caparas,1,0,36,35
1657086326160,MATH 20B,A03,093475,Briones; Jor-el Thomas Caparas,0,0,36,36
1657086332185,MATH 20C,A01,083760,Briones; Jor-el Thomas Caparas,1,0,35,34
1657086332185,MATH 20C,A02,083761,Briones; Jor-el Thomas Caparas,8,0,35,27
1657086332185,MATH 20C,A03,093476,Briones; Jor-el Thomas Caparas,0,1,36,36
1657086332185,MATH 20C,B01,083762,Bach; Quang Tran,0,0,30,30
1657086338325,MATH 20D,A01,083765,Tran; Brian Kha,4,0,30,26
1657086338325,MATH 20D,A02,083766,Tran; Brian Kha,5,0,30,25
1657086338325,MATH 20D,A03,083767,Tran; Brian Kha,3,0,30,27
1657086344349,MATH 20E,A01,083771,Ganguly; Soumya,6,0,32,26
1657086344349,MATH 20E,A02,083772,Ganguly; Soumya,6,0,32,26
1657086344349,MATH 20E,B01,083773,Ciotti; Benjamin,18,0,35,17
1657086344349,MATH 20E,B02,083774,Ciotti; Benjamin,17,0,35,18
1657086350378,MATH 103A,A01,083777,Greenfeld; Be'Eri,2,0,36,34
1657086350378,MATH 103A,A02,083778,Greenfeld; Be'Eri,5,0,36,31
1657086350378,MATH 103A,A03,093561,Greenfeld; Be'Eri,4,0,36,32
1657086350378,MATH 103A,B01,083779,Greenfeld; Be'Eri,6,0,36,30
1657086350378,MATH 103A,B02,083780,Greenfeld; Be'Eri,2,0,36,34
1657086350378,MATH 103A,B03,093562,Greenfeld; Be'Eri,3,0,36,33
1657086356401,MATH 105,A01,085443,Carter; Anne Toulson,14,0,35,21
1657086356401,MATH 105,A02,093477,Carter; Anne Toulson,20,0,35,15
1657086362430,MATH 109,A01,083213,Ganzberger; Geoffrey Michael,2,0,34,32
1657086362430,MATH 109,A02,083214,Ganzberger; Geoffrey Michael,2,0,34,32
1657086362430,MATH 109,A03,093478,Ganzberger; Geoffrey Michael,1,0,34,33
1657086362430,MATH 109,B01,083215,Ganzberger; Geoffrey Michael,1,0,32,31
1657086362430,MATH 109,B02,083216,Ganzberger; Geoffrey Michael,1,0,32,31
1657086362430,MATH 109,B03,093479,Ganzberger; Geoffrey Michael,6,0,32,26
1657086368459,MATH 142A,A01,083219,Chow; Bennett,6,0,32,26
1657086368459,MATH 142A,A02,083220,Chow; Bennett,10,0,32,22
1657086368459,MATH 142A,A03,093480,Chow; Bennett,7,0,32,25
1657086368459,MATH 142A,B03,093481,Chow; Bennett,8,0,32,24
1657086368459,MATH 142A,B04,093558,Chow; Bennett,11,0,32,21
1657086368459,MATH 142A,B05,093559,Chow; Bennett,6,0,32,26
1657086374485,MATH 193A,A01,083224,Rotar; Vladimir,7,0,34,27
1657086374485,MATH 193A,A02,083225,Rotar; Vladimir,5,0,34,29
1657086374485,MATH 193A,A03,083781,Rotar; Vladimir,1,0,34,33
1657086374485,MATH 193A,A04,083782,Rotar; Vladimir,6,0,34,28
1657086374485,MATH 193A,A05,093482,Rotar; Vladimir,6,0,34,28
1657086380520,MATH 197,001,091859,McAuley; Julian John,9999,0,9999,0
1657086380520,MATH 197,002,095566,Kedlaya; Kiran S.,9997,0,9999,2
1657086380520,MATH 197,003,095567,Xiao; Ming,9999,0,9999,0
1657086380520,MATH 197,004,095571,Perols; Johan Lars,9998,0,9999,1
1657086387582,COGS 9,A01,083615,Shannon; Kyle Michael,7,0,75,68
1657086393609,COGS 11,A01,083617,Boyle; Mary E. T.,21,0,48,27
1657086399636,COGS 13,A01,083071,Bastos; Amalia Pinkusfeld,9,0,71,62
1657086405662,COGS 14A,A01,092681,Semenuks; Arturs,1,1,100,99
1657086411685,COGS 14B,A01,083073,Cheng; Tzu-Han,5,0,63,58
1657086417710,COGS 17,A01,092677,Semenuks; Arturs,4,0,81,77
1657086423734,COGS 100,A01,083619,Allen; Michael Gordon,15,0,70,55
1657086429760,COGS 101A,A01,083621,Davis; Joshua Daniel,9,0,68,59
1657086435784,COGS 101B,A01,091572,Allen; Michael Gordon,8,0,65,57
1657086441811,COGS 101C,A01,083625,Delgado; Tania,17,0,35,18
1657086447833,COGS 107A,A01,083627,Boyle; Mary E. T.,13,0,60,47
1657086453857,COGS 118A,A01,083075,Gupta; Anjum,15,0,76,61
1657086459881,CSE 3,A50,083646,Miranda; Gregory Joseph,22,0,50,28
1657086465905,CSE 8A,A50,083650,Miranda; Gregory Joseph,17,1,56,39
1657086471930,CSE 11,A01,083080,Cao; Yingjun,4,15,40,36
1657086477957,CSE 12,A01,083652,Krause-Levy; Sophia Louisa,23,1,120,97
1657086483981,CSE 15L,A01,083654,Morris; Justin Loren,9,0,50,41
1657086483981,CSE 15L,A02,083655,Morris; Justin Loren,9,0,50,41
1657086490008,CSE 20,A01,083657,Tran; Khoa Dang,37,0,80,43
1657086496031,CSE 21,A01,095574,Bach; Quang Tran,21,0,48,27
1657086502054,CSE 30,A01,083084,Eldon; John,4,0,80,76
1657086502054,CSE 30,B01,095061,Bhaskar; Nishant,6,0,50,44
1657086508081,CSE 100,A01,083659,Cao; Yingjun,3,4,70,67
1657086514103,CSE 134B,A01,083661,Powell; Thomas Allan,19,0,100,81
1657086520125,CSE 140,A01,083663,Gungor; Onat,14,0,85,71
1657086526150,CSE 140L,A01,083088,Eldon; John,16,0,100,84
1657086532184,CSE 175,A01,083665,Kumar; Rakesh,3,0,25,22
1657086538210,CSE 190,A00,092507,Dubnov; Shlomo,7,0,20,13
1657086544234,ECE 45,A01,083139,Congero; Spencer William,5,0,75,70
1657086550266,ECE 65,A50,083695,Saad; Andrew S,12,0,30,18
1657086550266,ECE 65,A51,095125,Saad; Andrew S,25,0,26,1
1657086556300,ECE 109,A01,091882,Touri; Behrouz,16,0,70,54
1657086562323,ECE 180,A00,083140,Abi Samra; Nicholas Camill,1,0,30,29
1657086562323,ECE 180,B00,083141,Abi Samra; Nicholas Camill,0,0,30,30
1657086568350,MATH 10A,A01,083735,Patchell; Gregory David,1,0,30,29
1657086568350,MATH 10A,A02,083736,Patchell; Gregory David,20,0,30,10
1657086568350,MATH 10A,A03,083737,Patchell; Gregory David,16,0,30,14
1657086574374,MATH 10B,A01,083207,Lim; Seonhee,7,0,34,27
1657086574374,MATH 10B,A02,083208,Lim; Seonhee,9,0,35,26
1657086574374,MATH 10B,A03,093472,Lim; Seonhee,5,0,34,29
1657086574374,MATH 10B,B01,083739,Sinha; Shubham,9,0,30,21
1657086580400,MATH 18,A01,083743,Cinel; Cameron Alexander,6,0,30,24
1657086580400,MATH 18,A02,083744,Cinel; Cameron Alexander,15,0,30,15
1657086580400,MATH 18,A03,083745,Cinel; Cameron Alexander,8,0,30,22
1657086580400,MATH 18,B01,083748,Rideout; David Porter,4,0,37,33
1657086580400,MATH 18,B02,083749,Rideout; David Porter,3,0,36,33
1657086580400,MATH 18,B03,083750,Rideout; David Porter,2,0,37,35
1657086580400,MATH 18,B04,083751,Rideout; David Porter,5,0,36,31
1657086580400,MATH 18,B05,093473,Rideout; David Porter,4,0,36,32
1657086580400,MATH 18,B06,093474,Rideout; David Porter,5,0,36,31
1657086586430,MATH 20A,A01,083754,Zheng; Zequn,12,0,40,28
1657086592453,MATH 20B,A01,083756,Briones; Jor-el Thomas Caparas,1,0,36,35
1657086592453,MATH 20B,A02,083757,Briones; Jor-el Thomas Caparas,1,0,36,35
1657086592453,MATH 20B,A03,093475,Briones; Jor-el Thomas Caparas,0,0,36,36
1657086598478,MATH 20C,A01,083760,Briones; Jor-el Thomas Caparas,1,0,35,34
1657086598478,MATH 20C,A02,083761,Briones; Jor-el Thomas Caparas,8,0,35,27
1657086598478,MATH 20C,A03,093476,Briones; Jor-el Thomas Caparas,0,1,36,36
1657086598478,MATH 20C,B01,083762,Bach; Quang Tran,0,0,30,30
1657086604501,MATH 20D,A01,083765,Tran; Brian Kha,4,0,30,26
1657086604501,MATH 20D,A02,083766,Tran; Brian Kha,5,0,30,25
1657086604501,MATH 20D,A03,083767,Tran; Brian Kha,3,0,30,27
1657086610525,MATH 20E,A01,083771,Ganguly; Soumya,6,0,32,26
1657086610525,MATH 20E,A02,083772,Ganguly; Soumya,6,0,32,26
1657086610525,MATH 20E,B01,083773,Ciotti; Benjamin,18,0,35,17
1657086610525,MATH 20E,B02,083774,Ciotti; Benjamin,17,0,35,18
1657086616548,MATH 103A,A01,083777,Greenfeld; Be'Eri,2,0,36,34
1657086616548,MATH 103A,A02,083778,Greenfeld; Be'Eri,5,0,36,31
1657086616548,MATH 103A,A03,093561,Greenfeld; Be'Eri,4,0,36,32
1657086616548,MATH 103A,B01,083779,Greenfeld; Be'Eri,6,0,36,30
1657086616548,MATH 103A,B02,083780,Greenfeld; Be'Eri,2,0,36,34
1657086616548,MATH 103A,B03,093562,Greenfeld; Be'Eri,3,0,36,33
1657086622575,MATH 105,A01,085443,Carter; Anne Toulson,14,0,35,21
1657086622575,MATH 105,A02,093477,Carter; Anne Toulson,20,0,35,15
1657086628596,MATH 109,A01,083213,Ganzberger; Geoffrey Michael,2,0,34,32
1657086628596,MATH 109,A02,083214,Ganzberger; Geoffrey Michael,2,0,34,32
1657086628596,MATH 109,A03,093478,Ganzberger; Geoffrey Michael,1,0,34,33
1657086628596,MATH 109,B01,083215,Ganzberger; Geoffrey Michael,1,0,32,31
1657086628596,MATH 109,B02,083216,Ganzberger; Geoffrey Michael,1,0,32,31
1657086628596,MATH 109,B03,093479,Ganzberger; Geoffrey Michael,6,0,32,26
1657086634621,MATH 142A,A01,083219,Chow; Bennett,6,0,32,26
1657086634621,MATH 142A,A02,083220,Chow; Bennett,10,0,32,22
1657086634621,MATH 142A,A03,093480,Chow; Bennett,7,0,32,25
1657086634621,MATH 142A,B03,093481,Chow; Bennett,8,0,32,24
1657086634621,MATH 142A,B04,093558,Chow; Bennett,11,0,32,21
1657086634621,MATH 142A,B05,093559,Chow; Bennett,6,0,32,26
1657086640645,MATH 193A,A01,083224,Rotar; Vladimir,7,0,34,27
1657086640645,MATH 193A,A02,083225,Rotar; Vladimir,5,0,34,29
1657086640645,MATH 193A,A03,083781,Rotar; Vladimir,1,0,34,33
1657086640645,MATH 193A,A04,083782,Rotar; Vladimir,6,0,34,28
1657086640645,MATH 193A,A05,093482,Rotar; Vladimir,6,0,34,28
1657086646672,MATH 197,001,091859,McAuley; Julian John,9999,0,9999,0
1657086646672,MATH 197,002,095566,Kedlaya; Kiran S.,9997,0,9999,2
1657086646672,MATH 197,003,095567,Xiao; Ming,9999,0,9999,0
1657086646672,MATH 197,004,095571,Perols; Johan Lars,9998,0,9999,1
1657086653737,COGS 9,A01,083615,Shannon; Kyle Michael,7,0,75,68
1657086659768,COGS 11,A01,083617,Boyle; Mary E. T.,21,0,48,27
1657086665793,COGS 13,A01,083071,Bastos; Amalia Pinkusfeld,9,0,71,62
1657086671819,COGS 14A,A01,092681,Semenuks; Arturs,1,1,100,99
1657086677846,COGS 14B,A01,083073,Cheng; Tzu-Han,5,0,63,58
1657086683868,COGS 17,A01,092677,Semenuks; Arturs,4,0,81,77
1657086689892,COGS 100,A01,083619,Allen; Michael Gordon,15,0,70,55
1657086695915,COGS 101A,A01,083621,Davis; Joshua Daniel,9,0,68,59
1657086701939,COGS 101B,A01,091572,Allen; Michael Gordon,8,0,65,57
1657086707967,COGS 101C,A01,083625,Delgado; Tania,17,0,35,18
1657086713990,COGS 107A,A01,083627,Boyle; Mary E. T.,13,0,60,47
1657086720014,COGS 118A,A01,083075,Gupta; Anjum,15,0,76,61
1657086726040,CSE 3,A50,083646,Miranda; Gregory Joseph,22,0,50,28
1657086732063,CSE 8A,A50,083650,Miranda; Gregory Joseph,17,1,56,39
1657086738087,CSE 11,A01,083080,Cao; Yingjun,4,15,40,36
1657086744110,CSE 12,A01,083652,Krause-Levy; Sophia Louisa,23,1,120,97
1657086750137,CSE 15L,A01,083654,Morris; Justin Loren,9,0,50,41
1657086750137,CSE 15L,A02,083655,Morris; Justin Loren,9,0,50,41
1657086756160,CSE 20,A01,083657,Tran; Khoa Dang,37,0,80,43
1657086762182,CSE 21,A01,095574,Bach; Quang Tran,21,0,48,27
1657086768209,CSE 30,A01,083084,Eldon; John,4,0,80,76
1657086768209,CSE 30,B01,095061,Bhaskar; Nishant,6,0,50,44
1657086774235,CSE 100,A01,083659,Cao; Yingjun,3,4,70,67
1657086780268,CSE 134B,A01,083661,Powell; Thomas Allan,19,0,100,81
1657086786295,CSE 140,A01,083663,Gungor; Onat,14,0,85,71
1657086792320,CSE 140L,A01,083088,Eldon; John,16,0,100,84
1657086798346,CSE 175,A01,083665,Kumar; Rakesh,3,0,25,22
1657086804368,CSE 190,A00,092507,Dubnov; Shlomo,7,0,20,13
1657086810390,ECE 45,A01,083139,Congero; Spencer William,5,0,75,70
1657086816414,ECE 65,A50,083695,Saad; Andrew S,12,0,30,18
1657086816414,ECE 65,A51,095125,Saad; Andrew S,25,0,26,1
1657086822438,ECE 109,A01,091882,Touri; Behrouz,16,0,70,54
1657086828465,ECE 180,A00,083140,Abi Samra; Nicholas Camill,1,0,30,29
1657086828465,ECE 180,B00,083141,Abi Samra; Nicholas Camill,0,0,30,30
1657086834490,MATH 10A,A01,083735,Patchell; Gregory David,1,0,30,29
1657086834490,MATH 10A,A02,083736,Patchell; Gregory David,20,0,30,10
1657086834490,MATH 10A,A03,083737,Patchell; Gregory David,16,0,30,14
1657086840514,MATH 10B,A01,083207,Lim; Seonhee,7,0,34,27
1657086840514,MATH 10B,A02,083208,Lim; Seonhee,9,0,35,26
1657086840514,MATH 10B,A03,093472,Lim; Seonhee,5,0,34,29
1657086840514,MATH 10B,B01,083739,Sinha; Shubham,9,0,30,21
1657086846539,MATH 18,A01,083743,Cinel; Cameron Alexander,6,0,30,24
1657086846539,MATH 18,A02,083744,Cinel; Cameron Alexander,15,0,30,15
1657086846539,MATH 18,A03,083745,Cinel; Cameron Alexander,8,0,30,22
1657086846539,MATH 18,B01,083748,Rideout; David Porter,4,0,37,33
1657086846539,MATH 18,B02,083749,Rideout; David Porter,3,0,36,33
1657086846539,MATH 18,B03,083750,Rideout; David Porter,2,0,37,35
1657086846539,MATH 18,B04,083751,Rideout; David Porter,5,0,36,31
1657086846539,MATH 18,B05,093473,Rideout; David Porter,4,0,36,32
1657086846539,MATH 18,B06,093474,Rideout; David Porter,5,0,36,31
1657086852563,MATH 20A,A01,083754,Zheng; Zequn,12,0,40,28
1657086858588,MATH 20B,A01,083756,Briones; Jor-el Thomas Caparas,1,0,36,35
1657086858588,MATH 20B,A02,083757,Briones; Jor-el Thomas Caparas,1,0,36,35
1657086858588,MATH 20B,A03,093475,Briones; Jor-el Thomas Caparas,0,0,36,36
1657086864630,MATH 20C,A01,083760,Briones; Jor-el Thomas Caparas,1,0,35,34
1657086864630,MATH 20C,A02,083761,Briones; Jor-el Thomas Caparas,8,0,35,27
1657086864630,MATH 20C,A03,093476,Briones; Jor-el Thomas Caparas,0,1,36,36
1657086864630,MATH 20C,B01,083762,Bach; Quang Tran,0,0,30,30
1657086870653,MATH 20D,A01,083765,Tran; Brian Kha,4,0,30,26
1657086870653,MATH 20D,A02,083766,Tran; Brian Kha,5,0,30,25
1657086870653,MATH 20D,A03,083767,Tran; Brian Kha,3,0,30,27
1657086876678,MATH 20E,A01,083771,Ganguly; Soumya,6,0,32,26
1657086876678,MATH 20E,A02,083772,Ganguly; Soumya,6,0,32,26
1657086876678,MATH 20E,B01,083773,Ciotti; Benjamin,18,0,35,17
1657086876678,MATH 20E,B02,083774,Ciotti; Benjamin,17,0,35,18
1657086882713,MATH 103A,A01,083777,Greenfeld; Be'Eri,2,0,36,34
1657086882713,MATH 103A,A02,083778,Greenfeld; Be'Eri,5,0,36,31
1657086882713,MATH 103A,A03,093561,Greenfeld; Be'Eri,4,0,36,32
1657086882713,MATH 103A,B01,083779,Greenfeld; Be'Eri,6,0,36,30
1657086882713,MATH 103A,B02,083780,Greenfeld; Be'Eri,2,0,36,34
1657086882713,MATH 103A,B03,093562,Greenfeld; Be'Eri,3,0,36,33
1657086888735,MATH 105,A01,085443,Carter; Anne Toulson,14,0,35,21
1657086888735,MATH 105,A02,093477,Carter; Anne Toulson,20,0,35,15
1657086894759,MATH 109,A01,083213,Ganzberger; Geoffrey Michael,2,0,34,32
1657086894759,MATH 109,A02,083214,Ganzberger; Geoffrey Michael,2,0,34,32
1657086894759,MATH 109,A03,093478,Ganzberger; Geoffrey Michael,1,0,34,33
1657086894759,MATH 109,B01,083215,Ganzberger; Geoffrey Michael,1,0,32,31
1657086894759,MATH 109,B02,083216,Ganzberger; Geoffrey Michael,1,0,32,31
1657086894759,MATH 109,B03,093479,Ganzberger; Geoffrey Michael,6,0,32,26
1657086900788,MATH 142A,A01,083219,Chow; Bennett,6,0,32,26
1657086900788,MATH 142A,A02,083220,Chow; Bennett,10,0,32,22
1657086900788,MATH 142A,A03,093480,Chow; Bennett,7,0,32,25
1657086900788,MATH 142A,B03,093481,Chow; Bennett,8,0,32,24
1657086900788,MATH 142A,B04,093558,Chow; Bennett,11,0,32,21
1657086900788,MATH 142A,B05,093559,Chow; Bennett,6,0,32,26
1657086906812,MATH 193A,A01,083224,Rotar; Vladimir,7,0,34,27
1657086906812,MATH 193A,A02,083225,Rotar; Vladimir,5,0,34,29
1657086906812,MATH 193A,A03,083781,Rotar; Vladimir,1,0,34,33
1657086906812,MATH 193A,A04,083782,Rotar; Vladimir,6,0,34,28
1657086906812,MATH 193A,A05,093482,Rotar; Vladimir,6,0,34,28
1657086912834,MATH 197,001,091859,McAuley; Julian John,9999,0,9999,0
1657086912834,MATH 197,002,095566,Kedlaya; Kiran S.,9997,0,9999,2
1657086912834,MATH 197,003,095567,Xiao; Ming,9999,0,9999,0
1657086912834,MATH 197,004,095571,Perols; Johan Lars,9998,0,9999,1
1657086919893,COGS 9,A01,083615,Shannon; Kyle Michael,7,0,75,68
1657086925921,COGS 11,A01,083617,Boyle; Mary E. T.,21,0,48,27
1657086932040,COGS 13,A01,083071,Bastos; Amalia Pinkusfeld,9,0,71,62
1657086938063,COGS 14A,A01,092681,Semenuks; Arturs,1,1,100,99
1657086944091,COGS 14B,A01,083073,Cheng; Tzu-Han,5,0,63,58
1657086950122,COGS 17,A01,092677,Semenuks; Arturs,4,0,81,77
1657086956151,COGS 100,A01,083619,Allen; Michael Gordon,15,0,70,55
1657086962177,COGS 101A,A01,083621,Davis; Joshua Daniel,9,0,68,59
1657086968204,COGS 101B,A01,091572,Allen; Michael Gordon,8,0,65,57
1657086974227,COGS 101C,A01,083625,Delgado; Tania,17,0,35,18
1657086980247,COGS 107A,A01,083627,Boyle; Mary E. T.,13,0,60,47
1657086986269,COGS 118A,A01,083075,Gupta; Anjum,15,0,76,61
1657086992299,CSE 3,A50,083646,Miranda; Gregory Joseph,22,0,50,28
1657086998325,CSE 8A,A50,083650,Miranda; Gregory Joseph,17,1,56,39
1657087004350,CSE 11,A01,083080,Cao; Yingjun,4,15,40,36
1657087010378,CSE 12,A01,083652,Krause-Levy; Sophia Louisa,23,1,120,97
1657087016414,CSE 15L,A01,083654,Morris; Justin Loren,9,0,50,41
1657087016414,CSE 15L,A02,083655,Morris; Justin Loren,9,0,50,41
1657087022447,CSE 20,A01,083657,Tran; Khoa Dang,37,0,80,43
1657087028471,CSE 21,A01,095574,Bach; Quang Tran,21,0,48,27
1657087034503,CSE 30,A01,083084,Eldon; John,4,0,80,76
1657087034503,CSE 30,B01,095061,Bhaskar; Nishant,6,0,50,44
1657087040529,CSE 100,A01,083659,Cao; Yingjun,3,4,70,67
1657087046552,CSE 134B,A01,083661,Powell; Thomas Allan,19,0,100,81
1657087052574,CSE 140,A01,083663,Gungor; Onat,14,0,85,71
1657087058613,CSE 140L,A01,083088,Eldon; John,16,0,100,84
1657087064639,CSE 175,A01,083665,Kumar; Rakesh,3,0,25,22
1657087070666,CSE 190,A00,092507,Dubnov; Shlomo,7,0,20,13
1657087076692,ECE 45,A01,083139,Congero; Spencer William,5,0,75,70
1657087082718,ECE 65,A50,083695,Saad; Andrew S,12,0,30,18
1657087082718,ECE 65,A51,095125,Saad; Andrew S,25,0,26,1
1657087088745,ECE 109,A01,091882,Touri; Behrouz,16,0,70,54
1657087094771,ECE 180,A00,083140,Abi Samra; Nicholas Camill,1,0,30,29
1657087094771,ECE 180,B00,083141,Abi Samra; Nicholas Camill,0,0,30,30
1657087100794,MATH 10A,A01,083735,Patchell; Gregory David,1,0,30,29
1657087100794,MATH 10A,A02,083736,Patchell; Gregory David,20,0,30,10
1657087100794,MATH 10A,A03,083737,Patchell; Gregory David,16,0,30,14
1657087106820,MATH 10B,A01,083207,Lim; Seonhee,7,0,34,27
1657087106820,MATH 10B,A02,083208,Lim; Seonhee,9,0,35,26
1657087106820,MATH 10B,A03,093472,Lim; Seonhee,5,0,34,29
1657087106820,MATH 10B,B01,083739,Sinha; Shubham,9,0,30,21
1657087112844,MATH 18,A01,083743,Cinel; Cameron Alexander,6,0,30,24
1657087112844,MATH 18,A02,083744,Cinel; Cameron Alexander,15,0,30,15
1657087112844,MATH 18,A03,083745,Cinel; Cameron Alexander,8,0,30,22
1657087112844,MATH 18,B01,083748,Rideout; David Porter,4,0,37,33
1657087112844,MATH 18,B02,083749,Rideout; David Porter,3,0,36,33
1657087112844,MATH 18,B03,083750,Rideout; David Porter,2,0,37,35
1657087112844,MATH 18,B04,083751,Rideout; David Porter,5,0,36,31
1657087112844,MATH 18,B05,093473,Rideout; David Porter,4,0,36,32
1657087112844,MATH 18,B06,093474,Rideout; David Porter,5,0,36,31
1657087118869,MATH 20A,A01,083754,Zheng; Zequn,12,0,40,28
1657087124892,MATH 20B,A01,083756,Briones; Jor-el Thomas Caparas,1,0,36,35
1657087124892,MATH 20B,A02,083757,Briones; Jor-el Thomas Caparas,1,0,36,35
1657087124892,MATH 20B,A03,093475,Briones; Jor-el Thomas Caparas,0,0,36,36
1657087130920,MATH 20C,A01,083760,Briones; Jor-el Thomas Caparas,1,0,35,34
1657087130920,MATH 20C,A02,083761,Briones; Jor-el Thomas Caparas,8,0,35,27
1657087130920,MATH 20C,A03,093476,Briones; Jor-el Thomas Caparas,0,1,36,36
1657087130920,MATH 20C,B01,083762,Bach; Quang Tran,0,0,30,30
1657087136949,MATH 20D,A01,083765,Tran; Brian Kha,4,0,30,26
1657087136949,MATH 20D,A02,083766,Tran; Brian Kha,5,0,30,25
1657087136949,MATH 20D,A03,083767,Tran; Brian Kha,3,0,30,27
1657087142977,MATH 20E,A01,083771,Ganguly; Soumya,6,0,32,26
1657087142977,MATH 20E,A02,083772,Ganguly; Soumya,6,0,32,26
1657087142977,MATH 20E,B01,083773,Ciotti; Benjamin,18,0,35,17
1657087142977,MATH 20E,B02,083774,Ciotti; Benjamin,17,0,35,18
1657087149001,MATH 103A,A01,083777,Greenfeld; Be'Eri,2,0,36,34
1657087149001,MATH 103A,A02,083778,Greenfeld; Be'Eri,5,0,36,31
1657087149001,MATH 103A,A03,093561,Greenfeld; Be'Eri,4,0,36,32
1657087149001,MATH 103A,B01,083779,Greenfeld; Be'Eri,6,0,36,30
1657087149001,MATH 103A,B02,083780,Greenfeld; Be'Eri,2,0,36,34
1657087149001,MATH 103A,B03,093562,Greenfeld; Be'Eri,3,0,36,33
1657087155024,MATH 105,A01,085443,Carter; Anne Toulson,14,0,35,21
1657087155024,MATH 105,A02,093477,Carter; Anne Toulson,20,0,35,15
1657087161053,MATH 109,A01,083213,Ganzberger; Geoffrey Michael,2,0,34,32
1657087161053,MATH 109,A02,083214,Ganzberger; Geoffrey Michael,2,0,34,32
1657087161053,MATH 109,A03,093478,Ganzberger; Geoffrey Michael,1,0,34,33
1657087161053,MATH 109,B01,083215,Ganzberger; Geoffrey Michael,1,0,32,31
1657087161053,MATH 109,B02,083216,Ganzberger; Geoffrey Michael,1,0,32,31
1657087161053,MATH 109,B03,093479,Ganzberger; Geoffrey Michael,6,0,32,26
1657087167080,MATH 142A,A01,083219,Chow; Bennett,6,0,32,26
1657087167080,MATH 142A,A02,083220,Chow; Bennett,10,0,32,22
1657087167080,MATH 142A,A03,093480,Chow; Bennett,7,0,32,25
1657087167080,MATH 142A,B03,093481,Chow; Bennett,8,0,32,24
1657087167080,MATH 142A,B04,093558,Chow; Bennett,11,0,32,21
1657087167080,MATH 142A,B05,093559,Chow; Bennett,6,0,32,26
1657087173106,MATH 193A,A01,083224,Rotar; Vladimir,7,0,34,27
1657087173106,MATH 193A,A02,083225,Rotar; Vladimir,5,0,34,29
1657087173106,MATH 193A,A03,083781,Rotar; Vladimir,1,0,34,33
1657087173106,MATH 193A,A04,083782,Rotar; Vladimir,6,0,34,28
1657087173106,MATH 193A,A05,093482,Rotar; Vladimir,6,0,34,28
1657087179131,MATH 197,001,091859,McAuley; Julian John,9999,0,9999,0
1657087179131,MATH 197,002,095566,Kedlaya; Kiran S.,9997,0,9999,2
1657087179131,MATH 197,003,095567,Xiao; Ming,9999,0,9999,0
1657087179131,MATH 197,004,095571,Perols; Johan Lars,9998,0,9999,1
1657087186193,COGS 9,A01,083615,Shannon; Kyle Michael,7,0,75,68
1657087192216,COGS 11,A01,083617,Boyle; Mary E. T.,21,0,48,27
1657087198243,COGS 13,A01,083071,Bastos; Amalia Pinkusfeld,9,0,71,62
1657087204266,COGS 14A,A01,092681,Semenuks; Arturs,1,1,100,99
1657087210293,COGS 14B,A01,083073,Cheng; Tzu-Han,5,0,63,58
1657087216317,COGS 17,A01,092677,Semenuks; Arturs,4,0,81,77
1657087222345,COGS 100,A01,083619,Allen; Michael Gordon,15,0,70,55
1657087228369,COGS 101A,A01,083621,Davis; Joshua Daniel,9,0,68,59
1657087234394,COGS 101B,A01,091572,Allen; Michael Gordon,8,0,65,57
1657087240422,COGS 101C,A01,083625,Delgado; Tania,17,0,35,18
1657087246449,COGS 107A,A01,083627,Boyle; Mary E. T.,13,0,60,47
1657087252474,COGS 118A,A01,083075,Gupta; Anjum,15,0,76,61
1657087258506,CSE 3,A50,083646,Miranda; Gregory Joseph,22,0,50,28
1657087264536,CSE 8A,A50,083650,Miranda; Gregory Joseph,17,1,56,39
1657087270569,CSE 11,A01,083080,Cao; Yingjun,4,15,40,36
1657087276597,CSE 12,A01,083652,Krause-Levy; Sophia Louisa,23,1,120,97
1657087282624,CSE 15L,A01,083654,Morris; Justin Loren,9,0,50,41
1657087282624,CSE 15L,A02,083655,Morris; Justin Loren,9,0,50,41
1657087288653,CSE 20,A01,083657,Tran; Khoa Dang,37,0,80,43
1657087294677,CSE 21,A01,095574,Bach; Quang Tran,21,0,48,27
1657087300703,CSE 30,A01,083084,Eldon; John,4,0,80,76
1657087300703,CSE 30,B01,095061,Bhaskar; Nishant,6,0,50,44
1657087306726,CSE 100,A01,083659,Cao; Yingjun,3,4,70,67
1657087312751,CSE 134B,A01,083661,Powell; Thomas Allan,19,0,100,81
1657087318774,CSE 140,A01,083663,Gungor; Onat,14,0,85,71
1657087324797,CSE 140L,A01,083088,Eldon; John,16,0,100,84
1657087330823,CSE 175,A01,083665,Kumar; Rakesh,3,0,25,22
1657087336847,CSE 190,A00,092507,Dubnov; Shlomo,7,0,20,13
1657087342873,ECE 45,A01,083139,Congero; Spencer William,5,0,75,70
1657087348899,ECE 65,A50,083695,Saad; Andrew S,12,0,30,18
1657087348899,ECE 65,A51,095125,Saad; Andrew S,25,0,26,1
1657087354930,ECE 109,A01,091882,Touri; Behrouz,16,0,70,54
1657087360955,ECE 180,A00,083140,Abi Samra; Nicholas Camill,1,0,30,29
1657087360955,ECE 180,B00,083141,Abi Samra; Nicholas Camill,0,0,30,30
1657087366980,MATH 10A,A01,083735,Patchell; Gregory David,1,0,30,29
1657087366980,MATH 10A,A02,083736,Patchell; Gregory David,20,0,30,10
1657087366980,MATH 10A,A03,083737,Patchell; Gregory David,16,0,30,14
1657087373027,MATH 10B,A01,083207,Lim; Seonhee,7,0,34,27
1657087373027,MATH 10B,A02,083208,Lim; Seonhee,9,0,35,26
1657087373027,MATH 10B,A03,093472,Lim; Seonhee,5,0,34,29
1657087373027,MATH 10B,B01,083739,Sinha; Shubham,9,0,30,21
1657087379067,MATH 18,A01,083743,Cinel; Cameron Alexander,6,0,30,24
1657087379067,MATH 18,A02,083744,Cinel; Cameron Alexander,15,0,30,15
1657087379067,MATH 18,A03,083745,Cinel; Cameron Alexander,8,0,30,22
1657087379067,MATH 18,B01,083748,Rideout; David Porter,4,0,37,33
1657087379067,MATH 18,B02,083749,Rideout; David Porter,3,0,36,33
1657087379067,MATH 18,B03,083750,Rideout; David Porter,2,0,37,35
1657087379067,MATH 18,B04,083751,Rideout; David Porter,5,0,36,31
1657087379067,MATH 18,B05,093473,Rideout; David Porter,4,0,36,32
1657087379067,MATH 18,B06,093474,Rideout; David Porter,5,0,36,31
1657087385098,MATH 20A,A01,083754,Zheng; Zequn,12,0,40,28
1657087391132,MATH 20B,A01,083756,Briones; Jor-el Thomas Caparas,1,0,36,35
1657087391132,MATH 20B,A02,083757,Briones; Jor-el Thomas Caparas,1,0,36,35
1657087391132,MATH 20B,A03,093475,Briones; Jor-el Thomas Caparas,0,0,36,36
1657087397155,MATH 20C,A01,083760,Briones; Jor-el Thomas Caparas,1,0,35,34
1657087397155,MATH 20C,A02,083761,Briones; Jor-el Thomas Caparas,8,0,35,27
1657087397155,MATH 20C,A03,093476,Briones; Jor-el Thomas Caparas,0,1,36,36
1657087397155,MATH 20C,B01,083762,Bach; Quang Tran,0,0,30,30
1657087403179,MATH 20D,A01,083765,Tran; Brian Kha,4,0,30,26
1657087403179,MATH 20D,A02,083766,Tran; Brian Kha,5,0,30,25
1657087403179,MATH 20D,A03,083767,Tran; Brian Kha,3,0,30,27
1657087409203,MATH 20E,A01,083771,Ganguly; Soumya,6,0,32,26
1657087409203,MATH 20E,A02,083772,Ganguly; Soumya,6,0,32,26
1657087409203,MATH 20E,B01,083773,Ciotti; Benjamin,18,0,35,17
1657087409203,MATH 20E,B02,083774,Ciotti; Benjamin,17,0,35,18
1657087415229,MATH 103A,A01,083777,Greenfeld; Be'Eri,2,0,36,34
1657087415229,MATH 103A,A02,083778,Greenfeld; Be'Eri,5,0,36,31
1657087415229,MATH 103A,A03,093561,Greenfeld; Be'Eri,4,0,36,32
1657087415229,MATH 103A,B01,083779,Greenfeld; Be'Eri,6,0,36,30
1657087415229,MATH 103A,B02,083780,Greenfeld; Be'Eri,2,0,36,34
1657087415229,MATH 103A,B03,093562,Greenfeld; Be'Eri,3,0,36,33
1657087421253,MATH 105,A01,085443,Carter; Anne Toulson,14,0,35,21
1657087421253,MATH 105,A02,093477,Carter; Anne Toulson,20,0,35,15
1657087427278,MATH 109,A01,083213,Ganzberger; Geoffrey Michael,2,0,34,32
1657087427278,MATH 109,A02,083214,Ganzberger; Geoffrey Michael,2,0,34,32
1657087427278,MATH 109,A03,093478,Ganzberger; Geoffrey Michael,1,0,34,33
1657087427278,MATH 109,B01,083215,Ganzberger; Geoffrey Michael,1,0,32,31
1657087427278,MATH 109,B02,083216,Ganzberger; Geoffrey Michael,1,0,32,31
1657087427278,MATH 109,B03,093479,Ganzberger; Geoffrey Michael,6,0,32,26
1657087433331,MATH 142A,A01,083219,Chow; Bennett,6,0,32,26
1657087433331,MATH 142A,A02,083220,Chow; Bennett,10,0,32,22
1657087433331,MATH 142A,A03,093480,Chow; Bennett,7,0,32,25
1657087433331,MATH 142A,B03,093481,Chow; Bennett,8,0,32,24
1657087433331,MATH 142A,B04,093558,Chow; Bennett,11,0,32,21
1657087433331,MATH 142A,B05,093559,Chow; Bennett,6,0,32,26
1657087439358,MATH 193A,A01,083224,Rotar; Vladimir,7,0,34,27
1657087439358,MATH 193A,A02,083225,Rotar; Vladimir,5,0,34,29
1657087439358,MATH 193A,A03,083781,Rotar; Vladimir,1,0,34,33
1657087439358,MATH 193A,A04,083782,Rotar; Vladimir,6,0,34,28
1657087439358,MATH 193A,A05,093482,Rotar; Vladimir,6,0,34,28
1657087445381,MATH 197,001,091859,McAuley; Julian John,9999,0,9999,0
1657087445381,MATH 197,002,095566,Kedlaya; Kiran S.,9997,0,9999,2
1657087445381,MATH 197,003,095567,Xiao; Ming,9999,0,9999,0
1657087445381,MATH 197,004,095571,Perols; Johan Lars,9998,0,9999,1
1657087452445,COGS 9,A01,083615,Shannon; Kyle Michael,7,0,75,68
1657087458477,COGS 11,A01,083617,Boyle; Mary E. T.,21,0,48,27
1657087464506,COGS 13,A01,083071,Bastos; Amalia Pinkusfeld,9,0,71,62
1657087470531,COGS 14A,A01,092681,Semenuks; Arturs,1,1,100,99
1657087476558,COGS 14B,A01,083073,Cheng; Tzu-Han,5,0,63,58
1657087482581,COGS 17,A01,092677,Semenuks; Arturs,4,0,81,77
1657087488605,COGS 100,A01,083619,Allen; Michael Gordon,15,0,70,55
1657087494640,COGS 101A,A01,083621,Davis; Joshua Daniel,9,0,68,59
1657087500661,COGS 101B,A01,091572,Allen; Michael Gordon,8,0,65,57
1657087506687,COGS 101C,A01,083625,Delgado; Tania,17,0,35,18
1657087512710,COGS 107A,A01,083627,Boyle; Mary E. T.,13,0,60,47
1657087518732,COGS 118A,A01,083075,Gupta; Anjum,15,0,76,61
1657087524763,CSE 3,A50,083646,Miranda; Gregory Joseph,22,0,50,28
1657087530875,CSE 8A,A50,083650,Miranda; Gregory Joseph,17,1,56,39
1657087536900,CSE 11,A01,083080,Cao; Yingjun,4,15,40,36
1657087542932,CSE 12,A01,083652,Krause-Levy; Sophia Louisa,23,1,120,97
1657087548955,CSE 15L,A01,083654,Morris; Justin Loren,9,0,50,41
1657087548955,CSE 15L,A02,083655,Morris; Justin Loren,9,0,50,41
1657087554980,CSE 20,A01,083657,Tran; Khoa Dang,37,0,80,43
1657087561005,CSE 21,A01,095574,Bach; Quang Tran,21,0,48,27
1657087567029,CSE 30,A01,083084,Eldon; John,4,0,80,76
1657087567029,CSE 30,B01,095061,Bhaskar; Nishant,6,0,50,44
1657087573054,CSE 100,A01,083659,Cao; Yingjun,3,4,70,67
1657087579081,CSE 134B,A01,083661,Powell; Thomas Allan,19,0,100,81
1657087585110,CSE 140,A01,083663,Gungor; Onat,14,0,85,71
1657087591133,CSE 140L,A01,083088,Eldon; John,16,0,100,84
1657087597157,CSE 175,A01,083665,Kumar; Rakesh,3,0,25,22
1657087603207,CSE 190,A00,092507,Dubnov; Shlomo,7,0,20,13
1657087609237,ECE 45,A01,083139,Congero; Spencer William,5,0,75,70
1657087615261,ECE 65,A50,083695,Saad; Andrew S,12,0,30,18
1657087615261,ECE 65,A51,095125,Saad; Andrew S,25,0,26,1
1657087621289,ECE 109,A01,091882,Touri; Behrouz,16,0,70,54
1657087627317,ECE 180,A00,083140,Abi Samra; Nicholas Camill,1,0,30,29
1657087627317,ECE 180,B00,083141,Abi Samra; Nicholas Camill,0,0,30,30
1657087633343,MATH 10A,A01,083735,Patchell; Gregory David,1,0,30,29
1657087633343,MATH 10A,A02,083736,Patchell; Gregory David,20,0,30,10
1657087633343,MATH 10A,A03,083737,Patchell; Gregory David,16,0,30,14
1657087639372,MATH 10B,A01,083207,Lim; Seonhee,7,0,34,27
1657087639372,MATH 10B,A02,083208,Lim; Seonhee,9,0,35,26
1657087639372,MATH 10B,A03,093472,Lim; Seonhee,5,0,34,29
1657087639372,MATH 10B,B01,083739,Sinha; Shubham,9,0,30,21
1657087645399,MATH 18,A01,083743,Cinel; Cameron Alexander,6,0,30,24
1657087645399,MATH 18,A02,083744,Cinel; Cameron Alexander,15,0,30,15
1657087645399,MATH 18,A03,083745,Cinel; Cameron Alexander,8,0,30,22
1657087645399,MATH 18,B01,083748,Rideout; David Porter,4,0,37,33
1657087645399,MATH 18,B02,083749,Rideout; David Porter,3,0,36,33
1657087645399,MATH 18,B03,083750,Rideout; David Porter,2,0,37,35
1657087645399,MATH 18,B04,083751,Rideout; David Porter,5,0,36,31
1657087645399,MATH 18,B05,093473,Rideout; David Porter,4,0,36,32
1657087645399,MATH 18,B06,093474,Rideout; David Porter,5,0,36,31
1657087651427,MATH 20A,A01,083754,Zheng; Zequn,12,0,40,28
1657087657473,MATH 20B,A01,083756,Briones; Jor-el Thomas Caparas,1,0,36,35
1657087657473,MATH 20B,A02,083757,Briones; Jor-el Thomas Caparas,1,0,36,35
1657087657473,MATH 20B,A03,093475,Briones; Jor-el Thomas Caparas,0,0,36,36
1657087663503,MATH 20C,A01,083760,Briones; Jor-el Thomas Caparas,1,0,35,34
1657087663503,MATH 20C,A02,083761,Briones; Jor-el Thomas Caparas,8,0,35,27
1657087663503,MATH 20C,A03,093476,Briones; Jor-el Thomas Caparas,0,1,36,36
1657087663503,MATH 20C,B01,083762,Bach; Quang Tran,0,0,30,30
1657087669538,MATH 20D,A01,083765,Tran; Brian Kha,4,0,30,26
1657087669538,MATH 20D,A02,083766,Tran; Brian Kha,5,0,30,25
1657087669538,MATH 20D,A03,083767,Tran; Brian Kha,3,0,30,27
1657087675565,MATH 20E,A01,083771,Ganguly; Soumya,6,0,32,26
1657087675565,MATH 20E,A02,083772,Ganguly; Soumya,6,0,32,26
1657087675565,MATH 20E,B01,083773,Ciotti; Benjamin,18,0,35,17
1657087675565,MATH 20E,B02,083774,Ciotti; Benjamin,17,0,35,18
1657087681588,MATH 103A,A01,083777,Greenfeld; Be'Eri,2,0,36,34
1657087681588,MATH 103A,A02,083778,Greenfeld; Be'Eri,5,0,36,31
1657087681588,MATH 103A,A03,093561,Greenfeld; Be'Eri,4,0,36,32
1657087681588,MATH 103A,B01,083779,Greenfeld; Be'Eri,6,0,36,30
1657087681588,MATH 103A,B02,083780,Greenfeld; Be'Eri,2,0,36,34
1657087681588,MATH 103A,B03,093562,Greenfeld; Be'Eri,3,0,36,33
1657087687612,MATH 105,A01,085443,Carter; Anne Toulson,14,0,35,21
1657087687612,MATH 105,A02,093477,Carter; Anne Toulson,20,0,35,15
1657087693640,MATH 109,A01,083213,Ganzberger; Geoffrey Michael,2,0,34,32
1657087693640,MATH 109,A02,083214,Ganzberger; Geoffrey Michael,2,0,34,32
1657087693640,MATH 109,A03,093478,Ganzberger; Geoffrey Michael,1,0,34,33
1657087693640,MATH 109,B01,083215,Ganzberger; Geoffrey Michael,1,0,32,31
1657087693640,MATH 109,B02,083216,Ganzberger; Geoffrey Michael,1,0,32,31
1657087693640,MATH 109,B03,093479,Ganzberger; Geoffrey Michael,6,0,32,26
1657087699671,MATH 142A,A01,083219,Chow; Bennett,6,0,32,26
1657087699671,MATH 142A,A02,083220,Chow; Bennett,10,0,32,22
1657087699671,MATH 142A,A03,093480,Chow; Bennett,7,0,32,25
1657087699671,MATH 142A,B03,093481,Chow; Bennett,8,0,32,24
1657087699671,MATH 142A,B04,093558,Chow; Bennett,11,0,32,21
1657087699671,MATH 142A,B05,093559,Chow; Bennett,6,0,32,26
1657087705698,MATH 193A,A01,083224,Rotar; Vladimir,7,0,34,27
1657087705698,MATH 193A,A02,083225,Rotar; Vladimir,5,0,34,29
1657087705698,MATH 193A,A03,083781,Rotar; Vladimir,1,0,34,33
1657087705698,MATH 193A,A04,083782,Rotar; Vladimir,6,0,34,28
1657087705698,MATH 193A,A05,093482,Rotar; Vladimir,6,0,34,28
1657087711722,MATH 197,001,091859,McAuley; Julian John,9999,0,9999,0
1657087711722,MATH 197,002,095566,Kedlaya; Kiran S.,9997,0,9999,2
1657087711722,MATH 197,003,095567,Xiao; Ming,9999,0,9999,0
1657087711722,MATH 197,004,095571,Perols; Johan Lars,9998,0,9999,1
1657087718773,COGS 9,A01,083615,Shannon; Kyle Michael,7,0,75,68
1657087724800,COGS 11,A01,083617,Boyle; Mary E. T.,21,0,48,27
1657087730830,COGS 13,A01,083071,Bastos; Amalia Pinkusfeld,9,0,71,62
1657087736856,COGS 14A,A01,092681,Semenuks; Arturs,1,1,100,99
1657087742881,COGS 14B,A01,083073,Cheng; Tzu-Han,5,0,63,58
1657087748904,COGS 17,A01,092677,Semenuks; Arturs,4,0,81,77
1657087754928,COGS 100,A01,083619,Allen; Michael Gordon,15,0,70,55
1657087760951,COGS 101A,A01,083621,Davis; Joshua Daniel,9,0,68,59
1657087766975,COGS 101B,A01,091572,Allen; Michael Gordon,8,0,65,57
1657087772997,COGS 101C,A01,083625,Delgado; Tania,17,0,35,18
1657087779021,COGS 107A,A01,083627,Boyle; Mary E. T.,13,0,60,47
1657087785043,COGS 118A,A01,083075,Gupta; Anjum,15,0,76,61
1657087791072,CSE 3,A50,083646,Miranda; Gregory Joseph,22,0,50,28
1657087797096,CSE 8A,A50,083650,Miranda; Gregory Joseph,17,1,56,39
1657087803123,CSE 11,A01,083080,Cao; Yingjun,4,15,40,36
1657087809145,CSE 12,A01,083652,Krause-Levy; Sophia Louisa,23,1,120,97
1657087815169,CSE 15L,A01,083654,Morris; Justin Loren,9,0,50,41
1657087815169,CSE 15L,A02,083655,Morris; Justin Loren,9,0,50,41
1657087821193,CSE 20,A01,083657,Tran; Khoa Dang,37,0,80,43
1657087827218,CSE 21,A01,095574,Bach; Quang Tran,21,0,48,27
1657087833242,CSE 30,A01,083084,Eldon; John,4,0,80,76
1657087833242,CSE 30,B01,095061,Bhaskar; Nishant,6,0,50,44
1657087839269,CSE 100,A01,083659,Cao; Yingjun,3,4,70,67
1657087845301,CSE 134B,A01,083661,Powell; Thomas Allan,19,0,100,81
1657087851324,CSE 140,A01,083663,Gungor; Onat,14,0,85,71
1657087857351,CSE 140L,A01,083088,Eldon; John,16,0,100,84
1657087863376,CSE 175,A01,083665,Kumar; Rakesh,3,0,25,22
1657087869403,CSE 190,A00,092507,Dubnov; Shlomo,7,0,20,13
1657087875437,ECE 45,A01,083139,Congero; Spencer William,5,0,75,70
1657087881462,ECE 65,A50,083695,Saad; Andrew S,12,0,30,18
1657087881462,ECE 65,A51,095125,Saad; Andrew S,25,0,26,1
1657087887489,ECE 109,A01,091882,Touri; Behrouz,16,0,70,54
1657087893513,ECE 180,A00,083140,Abi Samra; Nicholas Camill,1,0,30,29
1657087893513,ECE 180,B00,083141,Abi Samra; Nicholas Camill,0,0,30,30
1657087899547,MATH 10A,A01,083735,Patchell; Gregory David,1,0,30,29
1657087899547,MATH 10A,A02,083736,Patchell; Gregory David,20,0,30,10
1657087899547,MATH 10A,A03,083737,Patchell; Gregory David,16,0,30,14
1657087905572,MATH 10B,A01,083207,Lim; Seonhee,7,0,34,27
1657087905572,MATH 10B,A02,083208,Lim; Seonhee,9,0,35,26
1657087905572,MATH 10B,A03,093472,Lim; Seonhee,5,0,34,29
1657087905572,MATH 10B,B01,083739,Sinha; Shubham,9,0,30,21
1657087911597,MATH 18,A01,083743,Cinel; Cameron Alexander,6,0,30,24
1657087911597,MATH 18,A02,083744,Cinel; Cameron Alexander,15,0,30,15
1657087911597,MATH 18,A03,083745,Cinel; Cameron Alexander,8,0,30,22
1657087911597,MATH 18,B01,083748,Rideout; David Porter,4,0,37,33
1657087911597,MATH 18,B02,083749,Rideout; David Porter,3,0,36,33
1657087911597,MATH 18,B03,083750,Rideout; David Porter,2,0,37,35
1657087911597,MATH 18,B04,083751,Rideout; David Porter,5,0,36,31
1657087911597,MATH 18,B05,093473,Rideout; David Porter,4,0,36,32
1657087911597,MATH 18,B06,093474,Rideout; David Porter,5,0,36,31
1657087917620,MATH 20A,A01,083754,Zheng; Zequn,12,0,40,28
1657087923648,MATH 20B,A01,083756,Briones; Jor-el Thomas Caparas,1,0,36,35
1657087923648,MATH 20B,A02,083757,Briones; Jor-el Thomas Caparas,1,0,36,35
1657087923648,MATH 20B,A03,093475,Briones; Jor-el Thomas Caparas,0,0,36,36
1657087929672,MATH 20C,A01,083760,Briones; Jor-el Thomas Caparas,1,0,35,34
1657087929672,MATH 20C,A02,083761,Briones; Jor-el Thomas Caparas,8,0,35,27
1657087929672,MATH 20C,A03,093476,Briones; Jor-el Thomas Caparas,0,1,36,36
1657087929672,MATH 20C,B01,083762,Bach; Quang Tran,0,0,30,30
1657087935696,MATH 20D,A01,083765,Tran; Brian Kha,4,0,30,26
1657087935696,MATH 20D,A02,083766,Tran; Brian Kha,5,0,30,25
1657087935696,MATH 20D,A03,083767,Tran; Brian Kha,3,0,30,27
1657087941725,MATH 20E,A01,083771,Ganguly; Soumya,6,0,32,26
1657087941725,MATH 20E,A02,083772,Ganguly; Soumya,6,0,32,26
1657087941725,MATH 20E,B01,083773,Ciotti; Benjamin,18,0,35,17
1657087941725,MATH 20E,B02,083774,Ciotti; Benjamin,17,0,35,18
1657087947755,MATH 103A,A01,083777,Greenfeld; Be'Eri,2,0,36,34
1657087947755,MATH 103A,A02,083778,Greenfeld; Be'Eri,5,0,36,31
1657087947755,MATH 103A,A03,093561,Greenfeld; Be'Eri,4,0,36,32
1657087947755,MATH 103A,B01,083779,Greenfeld; Be'Eri,6,0,36,30
1657087947755,MATH 103A,B02,083780,Greenfeld; Be'Eri,2,0,36,34
1657087947755,MATH 103A,B03,093562,Greenfeld; Be'Eri,3,0,36,33
1657087953779,MATH 105,A01,085443,Carter; Anne Toulson,14,0,35,21
1657087953779,MATH 105,A02,093477,Carter; Anne Toulson,20,0,35,15
1657087959803,MATH 109,A01,083213,Ganzberger; Geoffrey Michael,2,0,34,32
1657087959803,MATH 109,A02,083214,Ganzberger; Geoffrey Michael,2,0,34,32
1657087959803,MATH 109,A03,093478,Ganzberger; Geoffrey Michael,1,0,34,33
1657087959803,MATH 109,B01,083215,Ganzberger; Geoffrey Michael,1,0,32,31
1657087959803,MATH 109,B02,083216,Ganzberger; Geoffrey Michael,1,0,32,31
1657087959803,MATH 109,B03,093479,Ganzberger; Geoffrey Michael,6,0,32,26
1657087965828,MATH 142A,A01,083219,Chow; Bennett,6,0,32,26
1657087965828,MATH 142A,A02,083220,Chow; Bennett,10,0,32,22
1657087965828,MATH 142A,A03,093480,Chow; Bennett,7,0,32,25
1657087965828,MATH 142A,B03,093481,Chow; Bennett,8,0,32,24
1657087965828,MATH 142A,B04,093558,Chow; Bennett,11,0,32,21
1657087965828,MATH 142A,B05,093559,Chow; Bennett,6,0,32,26
1657087971853,MATH 193A,A01,083224,Rotar; Vladimir,7,0,34,27
1657087971853,MATH 193A,A02,083225,Rotar; Vladimir,5,0,34,29
1657087971853,MATH 193A,A03,083781,Rotar; Vladimir,1,0,34,33
1657087971853,MATH 193A,A04,083782,Rotar; Vladimir,6,0,34,28
1657087971853,MATH 193A,A05,093482,Rotar; Vladimir,6,0,34,28
1657087977875,MATH 197,001,091859,McAuley; Julian John,9999,0,9999,0
1657087977875,MATH 197,002,095566,Kedlaya; Kiran S.,9997,0,9999,2
1657087977875,MATH 197,003,095567,Xiao; Ming,9999,0,9999,0
1657087977875,MATH 197,004,095571,Perols; Johan Lars,9998,0,9999,1
1657087984927,COGS 9,A01,083615,Shannon; Kyle Michael,7,0,75,68
1657087990948,COGS 11,A01,083617,Boyle; Mary E. T.,21,0,48,27
1657087996975,COGS 13,A01,083071,Bastos; Amalia Pinkusfeld,9,0,71,62
1657088002998,COGS 14A,A01,092681,Semenuks; Arturs,1,1,100,99
1657088009020,COGS 14B,A01,083073,Cheng; Tzu-Han,5,0,63,58
1657088015048,COGS 17,A01,092677,Semenuks; Arturs,4,0,81,77
1657088021071,COGS 100,A01,083619,Allen; Michael Gordon,15,0,70,55
1657088027099,COGS 101A,A01,083621,Davis; Joshua Daniel,9,0,68,59
1657088033126,COGS 101B,A01,091572,Allen; Michael Gordon,8,0,65,57
1657088039148,COGS 101C,A01,083625,Delgado; Tania,17,0,35,18
1657088045170,COGS 107A,A01,083627,Boyle; Mary E. T.,13,0,60,47
1657088051193,COGS 118A,A01,083075,Gupta; Anjum,15,0,76,61
1657088057226,CSE 3,A50,083646,Miranda; Gregory Joseph,22,0,50,28
1657088063253,CSE 8A,A50,083650,Miranda; Gregory Joseph,17,1,56,39
1657088069280,CSE 11,A01,083080,Cao; Yingjun,4,15,40,36
1657088075303,CSE 12,A01,083652,Krause-Levy; Sophia Louisa,23,1,120,97
1657088081328,CSE 15L,A01,083654,Morris; Justin Loren,9,0,50,41
1657088081328,CSE 15L,A02,083655,Morris; Justin Loren,9,0,50,41
1657088087352,CSE 20,A01,083657,Tran; Khoa Dang,37,0,80,43
1657088093375,CSE 21,A01,095574,Bach; Quang Tran,21,0,48,27
1657088099403,CSE 30,A01,083084,Eldon; John,4,0,80,76
1657088099403,CSE 30,B01,095061,Bhaskar; Nishant,6,0,50,44
1657088105425,CSE 100,A01,083659,Cao; Yingjun,3,4,70,67
1657088111452,CSE 134B,A01,083661,Powell; Thomas Allan,19,0,100,81
1657088117475,CSE 140,A01,083663,Gungor; Onat,14,0,85,71
1657088123503,CSE 140L,A01,083088,Eldon; John,16,0,100,84
1657088129624,CSE 175,A01,083665,Kumar; Rakesh,3,0,25,22
1657088135647,CSE 190,A00,092507,Dubnov; Shlomo,7,0,20,13
1657088141669,ECE 45,A01,083139,Congero; Spencer William,5,0,75,70
1657088147697,ECE 65,A50,083695,Saad; Andrew S,12,0,30,18
1657088147697,ECE 65,A51,095125,Saad; Andrew S,25,0,26,1
1657088153721,ECE 109,A01,091882,Touri; Behrouz,16,0,70,54
1657088159749,ECE 180,A00,083140,Abi Samra; Nicholas Camill,1,0,30,29
1657088159749,ECE 180,B00,083141,Abi Samra; Nicholas Camill,0,0,30,30
1657088165771,MATH 10A,A01,083735,Patchell; Gregory David,1,0,30,29
1657088165771,MATH 10A,A02,083736,Patchell; Gregory David,20,0,30,10
1657088165771,MATH 10A,A03,083737,Patchell; Gregory David,16,0,30,14
1657088171796,MATH 10B,A01,083207,Lim; Seonhee,7,0,34,27
1657088171796,MATH 10B,A02,083208,Lim; Seonhee,9,0,35,26
1657088171796,MATH 10B,A03,093472,Lim; Seonhee,5,0,34,29
1657088171796,MATH 10B,B01,083739,Sinha; Shubham,9,0,30,21
1657088177836,MATH 18,A01,083743,Cinel; Cameron Alexander,6,0,30,24
1657088177836,MATH 18,A02,083744,Cinel; Cameron Alexander,15,0,30,15
1657088177836,MATH 18,A03,083745,Cinel; Cameron Alexander,8,0,30,22
1657088177836,MATH 18,B01,083748,Rideout; David Porter,4,0,37,33
1657088177836,MATH 18,B02,083749,Rideout; David Porter,3,0,36,33
1657088177836,MATH 18,B03,083750,Rideout; David Porter,2,0,37,35
1657088177836,MATH 18,B04,083751,Rideout; David Porter,5,0,36,31
1657088177836,MATH 18,B05,093473,Rideout; David Porter,4,0,36,32
1657088177836,MATH 18,B06,093474,Rideout; David Porter,5,0,36,31
1657088183869,MATH 20A,A01,083754,Zheng; Zequn,12,0,40,28
1657088189896,MATH 20B,A01,083756,Briones; Jor-el Thomas Caparas,1,0,36,35
1657088189896,MATH 20B,A02,083757,Briones; Jor-el Thomas Caparas,1,0,36,35
1657088189896,MATH 20B,A03,093475,Briones; Jor-el Thomas Caparas,0,0,36,36
1657088195926,MATH 20C,A01,083760,Briones; Jor-el Thomas Caparas,1,0,35,34
1657088195926,MATH 20C,A02,083761,Briones; Jor-el Thomas Caparas,8,0,35,27
1657088195926,MATH 20C,A03,093476,Briones; Jor-el Thomas Caparas,0,1,36,36
1657088195926,MATH 20C,B01,083762,Bach; Quang Tran,0,0,30,30
1657088201947,MATH 20D,A01,083765,Tran; Brian Kha,4,0,30,26
1657088201947,MATH 20D,A02,083766,Tran; Brian Kha,5,0,30,25
1657088201947,MATH 20D,A03,083767,Tran; Brian Kha,3,0,30,27
1657088207978,MATH 20E,A01,083771,Ganguly; Soumya,6,0,32,26
1657088207978,MATH 20E,A02,083772,Ganguly; Soumya,6,0,32,26
1657088207978,MATH 20E,B01,083773,Ciotti; Benjamin,18,0,35,17
1657088207978,MATH 20E,B02,083774,Ciotti; Benjamin,17,0,35,18
1657088214008,MATH 103A,A01,083777,Greenfeld; Be'Eri,2,0,36,34
1657088214008,MATH 103A,A02,083778,Greenfeld; Be'Eri,5,0,36,31
1657088214008,MATH 103A,A03,093561,Greenfeld; Be'Eri,4,0,36,32
1657088214008,MATH 103A,B01,083779,Greenfeld; Be'Eri,6,0,36,30
1657088214008,MATH 103A,B02,083780,Greenfeld; Be'Eri,2,0,36,34
1657088214008,MATH 103A,B03,093562,Greenfeld; Be'Eri,3,0,36,33
1657088220036,MATH 105,A01,085443,Carter; Anne Toulson,14,0,35,21
1657088220036,MATH 105,A02,093477,Carter; Anne Toulson,20,0,35,15
1657088226061,MATH 109,A01,083213,Ganzberger; Geoffrey Michael,2,0,34,32
1657088226061,MATH 109,A02,083214,Ganzberger; Geoffrey Michael,2,0,34,32
1657088226061,MATH 109,A03,093478,Ganzberger; Geoffrey Michael,1,0,34,33
1657088226061,MATH 109,B01,083215,Ganzberger; Geoffrey Michael,1,0,32,31
1657088226061,MATH 109,B02,083216,Ganzberger; Geoffrey Michael,1,0,32,31
1657088226061,MATH 109,B03,093479,Ganzberger; Geoffrey Michael,6,0,32,26
1657088232091,MATH 142A,A01,083219,Chow; Bennett,6,0,32,26
1657088232091,MATH 142A,A02,083220,Chow; Bennett,10,0,32,22
1657088232091,MATH 142A,A03,093480,Chow; Bennett,7,0,32,25
1657088232091,MATH 142A,B03,093481,Chow; Bennett,8,0,32,24
1657088232091,MATH 142A,B04,093558,Chow; Bennett,11,0,32,21
1657088232091,MATH 142A,B05,093559,Chow; Bennett,6,0,32,26
1657088238116,MATH 193A,A01,083224,Rotar; Vladimir,7,0,34,27
1657088238116,MATH 193A,A02,083225,Rotar; Vladimir,5,0,34,29
1657088238116,MATH 193A,A03,083781,Rotar; Vladimir,1,0,34,33
1657088238116,MATH 193A,A04,083782,Rotar; Vladimir,6,0,34,28
1657088238116,MATH 193A,A05,093482,Rotar; Vladimir,6,0,34,28
1657088244143,MATH 197,001,091859,McAuley; Julian John,9999,0,9999,0
1657088244143,MATH 197,002,095566,Kedlaya; Kiran S.,9997,0,9999,2
1657088244143,MATH 197,003,095567,Xiao; Ming,9999,0,9999,0
1657088244143,MATH 197,004,095571,Perols; Johan Lars,9998,0,9999,1
1657088251206,COGS 9,A01,083615,Shannon; Kyle Michael,7,0,75,68
1657088257229,COGS 11,A01,083617,Boyle; Mary E. T.,21,0,48,27
1657088263253,COGS 13,A01,083071,Bastos; Amalia Pinkusfeld,9,0,71,62
1657088269277,COGS 14A,A01,092681,Semenuks; Arturs,1,1,100,99
1657088275300,COGS 14B,A01,083073,Cheng; Tzu-Han,5,0,63,58
1657088281326,COGS 17,A01,092677,Semenuks; Arturs,4,0,81,77
1657088287354,COGS 100,A01,083619,Allen; Michael Gordon,15,0,70,55
1657088293377,COGS 101A,A01,083621,Davis; Joshua Daniel,9,0,68,59
1657088299404,COGS 101B,A01,091572,Allen; Michael Gordon,8,0,65,57
1657088305431,COGS 101C,A01,083625,Delgado; Tania,17,0,35,18
1657088311454,COGS 107A,A01,083627,Boyle; Mary E. T.,13,0,60,47
1657088317481,COGS 118A,A01,083075,Gupta; Anjum,15,0,76,61
1657088323510,CSE 3,A50,083646,Miranda; Gregory Joseph,22,0,50,28
1657088329532,CSE 8A,A50,083650,Miranda; Gregory Joseph,17,1,56,39
1657088335556,CSE 11,A01,083080,Cao; Yingjun,4,15,40,36
1657088341580,CSE 12,A01,083652,Krause-Levy; Sophia Louisa,23,1,120,97
1657088347634,CSE 15L,A01,083654,Morris; Justin Loren,9,0,50,41
1657088347634,CSE 15L,A02,083655,Morris; Justin Loren,9,0,50,41
1657088353662,CSE 20,A01,083657,Tran; Khoa Dang,37,0,80,43
1657088359691,CSE 21,A01,095574,Bach; Quang Tran,21,0,48,27
1657088365719,CSE 30,A01,083084,Eldon; John,4,0,80,76
1657088365719,CSE 30,B01,095061,Bhaskar; Nishant,6,0,50,44
1657088371746,CSE 100,A01,083659,Cao; Yingjun,3,4,70,67
1657088377772,CSE 134B,A01,083661,Powell; Thomas Allan,19,0,100,81
1657088383796,CSE 140,A01,083663,Gungor; Onat,14,0,85,71
1657088389820,CSE 140L,A01,083088,Eldon; John,16,0,100,84
1657088395848,CSE 175,A01,083665,Kumar; Rakesh,3,0,25,22
1657088401876,CSE 190,A00,092507,Dubnov; Shlomo,7,0,20,13
1657088407929,ECE 45,A01,083139,Congero; Spencer William,5,0,75,70
1657088413952,ECE 65,A50,083695,Saad; Andrew S,12,0,30,18
1657088413952,ECE 65,A51,095125,Saad; Andrew S,25,0,26,1
1657088419977,ECE 109,A01,091882,Touri; Behrouz,16,0,70,54
1657088425999,ECE 180,A00,083140,Abi Samra; Nicholas Camill,1,0,30,29
1657088425999,ECE 180,B00,083141,Abi Samra; Nicholas Camill,0,0,30,30
1657088432026,MATH 10A,A01,083735,Patchell; Gregory David,1,0,30,29
1657088432026,MATH 10A,A02,083736,Patchell; Gregory David,20,0,30,10
1657088432026,MATH 10A,A03,083737,Patchell; Gregory David,16,0,30,14
1657088438049,MATH 10B,A01,083207,Lim; Seonhee,7,0,34,27
1657088438049,MATH 10B,A02,083208,Lim; Seonhee,9,0,35,26
1657088438049,MATH 10B,A03,093472,Lim; Seonhee,5,0,34,29
1657088438049,MATH 10B,B01,083739,Sinha; Shubham,9,0,30,21
1657088444075,MATH 18,A01,083743,Cinel; Cameron Alexander,6,0,30,24
1657088444075,MATH 18,A02,083744,Cinel; Cameron Alexander,15,0,30,15
1657088444075,MATH 18,A03,083745,Cinel; Cameron Alexander,8,0,30,22
1657088444075,MATH 18,B01,083748,Rideout; David Porter,4,0,37,33
1657088444075,MATH 18,B02,083749,Rideout; David Porter,3,0,36,33
1657088444075,MATH 18,B03,083750,Rideout; David Porter,2,0,37,35
1657088444075,MATH 18,B04,083751,Rideout; David Porter,5,0,36,31
1657088444075,MATH 18,B05,093473,Rideout; David Porter,4,0,36,32
1657088444075,MATH 18,B06,093474,Rideout; David Porter,5,0,36,31
1657088450099,MATH 20A,A01,083754,Zheng; Zequn,12,0,40,28
1657088456128,MATH 20B,A01,083756,Briones; Jor-el Thomas Caparas,1,0,36,35
1657088456128,MATH 20B,A02,083757,Briones; Jor-el Thomas Caparas,1,0,36,35
1657088456128,MATH 20B,A03,093475,Briones; Jor-el Thomas Caparas,0,0,36,36
1657088462154,MATH 20C,A01,083760,Briones; Jor-el Thomas Caparas,1,0,35,34
1657088462154,MATH 20C,A02,083761,Briones; Jor-el Thomas Caparas,8,0,35,27
1657088462154,MATH 20C,A03,093476,Briones; Jor-el Thomas Caparas,0,1,36,36
1657088462154,MATH 20C,B01,083762,Bach; Quang Tran,0,0,30,30
1657088468178,MATH 20D,A01,083765,Tran; Brian Kha,4,0,30,26
1657088468178,MATH 20D,A02,083766,Tran; Brian Kha,5,0,30,25
1657088468178,MATH 20D,A03,083767,Tran; Brian Kha,3,0,30,27
1657088474207,MATH 20E,A01,083771,Ganguly; Soumya,6,0,32,26
1657088474207,MATH 20E,A02,083772,Ganguly; Soumya,6,0,32,26
1657088474207,MATH 20E,B01,083773,Ciotti; Benjamin,18,0,35,17
1657088474207,MATH 20E,B02,083774,Ciotti; Benjamin,17,0,35,18
1657088480238,MATH 103A,A01,083777,Greenfeld; Be'Eri,2,0,36,34
1657088480238,MATH 103A,A02,083778,Greenfeld; Be'Eri,5,0,36,31
1657088480238,MATH 103A,A03,093561,Greenfeld; Be'Eri,4,0,36,32
1657088480238,MATH 103A,B01,083779,Greenfeld; Be'Eri,6,0,36,30
1657088480238,MATH 103A,B02,083780,Greenfeld; Be'Eri,2,0,36,34
1657088480238,MATH 103A,B03,093562,Greenfeld; Be'Eri,3,0,36,33
1657088486269,MATH 105,A01,085443,Carter; Anne Toulson,14,0,35,21
1657088486269,MATH 105,A02,093477,Carter; Anne Toulson,20,0,35,15
1657088492293,MATH 109,A01,083213,Ganzberger; Geoffrey Michael,2,0,34,32
1657088492293,MATH 109,A02,083214,Ganzberger; Geoffrey Michael,2,0,34,32
1657088492293,MATH 109,A03,093478,Ganzberger; Geoffrey Michael,1,0,34,33
1657088492293,MATH 109,B01,083215,Ganzberger; Geoffrey Michael,1,0,32,31
1657088492293,MATH 109,B02,083216,Ganzberger; Geoffrey Michael,1,0,32,31
1657088492293,MATH 109,B03,093479,Ganzberger; Geoffrey Michael,6,0,32,26
1657088498326,MATH 142A,A01,083219,Chow; Bennett,6,0,32,26
1657088498326,MATH 142A,A02,083220,Chow; Bennett,10,0,32,22
1657088498326,MATH 142A,A03,093480,Chow; Bennett,7,0,32,25
1657088498326,MATH 142A,B03,093481,Chow; Bennett,8,0,32,24
1657088498326,MATH 142A,B04,093558,Chow; Bennett,11,0,32,21
1657088498326,MATH 142A,B05,093559,Chow; Bennett,6,0,32,26
1657088504358,MATH 193A,A01,083224,Rotar; Vladimir,7,0,34,27
1657088504358,MATH 193A,A02,083225,Rotar; Vladimir,5,0,34,29
1657088504358,MATH 193A,A03,083781,Rotar; Vladimir,1,0,34,33
1657088504358,MATH 193A,A04,083782,Rotar; Vladimir,6,0,34,28
1657088504358,MATH 193A,A05,093482,Rotar; Vladimir,6,0,34,28
1657088510383,MATH 197,001,091859,McAuley; Julian John,9999,0,9999,0
1657088510383,MATH 197,002,095566,Kedlaya; Kiran S.,9997,0,9999,2
1657088510383,MATH 197,003,095567,Xiao; Ming,9999,0,9999,0
1657088510383,MATH 197,004,095571,Perols; Johan Lars,9998,0,9999,1
1657088517442,COGS 9,A01,083615,Shannon; Kyle Michael,7,0,75,68
1657088523466,COGS 11,A01,083617,Boyle; Mary E. T.,21,0,48,27
1657088529490,COGS 13,A01,083071,Bastos; Amalia Pinkusfeld,9,0,71,62
1657088535515,COGS 14A,A01,092681,Semenuks; Arturs,1,1,100,99
1657088541537,COGS 14B,A01,083073,Cheng; Tzu-Han,5,0,63,58
1657088547581,COGS 17,A01,092677,Semenuks; Arturs,4,0,81,77
1657088553611,COGS 100,A01,083619,Allen; Michael Gordon,15,0,70,55
1657088559635,COGS 101A,A01,083621,Davis; Joshua Daniel,9,0,68,59
1657088565658,COGS 101B,A01,091572,Allen; Michael Gordon,8,0,65,57
1657088571681,COGS 101C,A01,083625,Delgado; Tania,17,0,35,18
1657088577705,COGS 107A,A01,083627,Boyle; Mary E. T.,13,0,60,47
1657088583728,COGS 118A,A01,083075,Gupta; Anjum,15,0,76,61
1657088589756,CSE 3,A50,083646,Miranda; Gregory Joseph,22,0,50,28
1657088595783,CSE 8A,A50,083650,Miranda; Gregory Joseph,17,1,56,39
1657088601819,CSE 11,A01,083080,Cao; Yingjun,4,15,40,36
1657088607848,CSE 12,A01,083652,Krause-Levy; Sophia Louisa,23,1,120,97
1657088613874,CSE 15L,A01,083654,Morris; Justin Loren,9,0,50,41
1657088613874,CSE 15L,A02,083655,Morris; Justin Loren,9,0,50,41
1657088619902,CSE 20,A01,083657,Tran; Khoa Dang,37,0,80,43
1657088625925,CSE 21,A01,095574,Bach; Quang Tran,21,0,48,27
1657088631950,CSE 30,A01,083084,Eldon; John,4,0,80,76
1657088631950,CSE 30,B01,095061,Bhaskar; Nishant,6,0,50,44
1657088637975,CSE 100,A01,083659,Cao; Yingjun,3,4,70,67
1657088644003,CSE 134B,A01,083661,Powell; Thomas Allan,19,0,100,81
1657088650027,CSE 140,A01,083663,Gungor; Onat,14,0,85,71
1657088656056,CSE 140L,A01,083088,Eldon; John,16,0,100,84
1657088662080,CSE 175,A01,083665,Kumar; Rakesh,3,0,25,22
1657088668110,CSE 190,A00,092507,Dubnov; Shlomo,7,0,20,13
1657088674134,ECE 45,A01,083139,Congero; Spencer William,5,0,75,70
1657088680166,ECE 65,A50,083695,Saad; Andrew S,12,0,30,18
1657088680166,ECE 65,A51,095125,Saad; Andrew S,25,0,26,1
1657088686188,ECE 109,A01,091882,Touri; Behrouz,16,0,70,54
1657088692214,ECE 180,A00,083140,Abi Samra; Nicholas Camill,1,0,30,29
1657088692214,ECE 180,B00,083141,Abi Samra; Nicholas Camill,0,0,30,30
1657088698243,MATH 10A,A01,083735,Patchell; Gregory David,1,0,30,29
1657088698243,MATH 10A,A02,083736,Patchell; Gregory David,20,0,30,10
1657088698243,MATH 10A,A03,083737,Patchell; Gregory David,16,0,30,14
1657088704268,MATH 10B,A01,083207,Lim; Seonhee,7,0,34,27
1657088704268,MATH 10B,A02,083208,Lim; Seonhee,9,0,35,26
1657088704268,MATH 10B,A03,093472,Lim; Seonhee,5,0,34,29
1657088704268,MATH 10B,B01,083739,Sinha; Shubham,9,0,30,21
1657088710298,MATH 18,A01,083743,Cinel; Cameron Alexander,6,0,30,24
1657088710298,MATH 18,A02,083744,Cinel; Cameron Alexander,15,0,30,15
1657088710298,MATH 18,A03,083745,Cinel; Cameron Alexander,8,0,30,22
1657088710298,MATH 18,B01,083748,Rideout; David Porter,4,0,37,33
1657088710298,MATH 18,B02,083749,Rideout; David Porter,3,0,36,33
1657088710298,MATH 18,B03,083750,Rideout; David Porter,2,0,37,35
1657088710298,MATH 18,B04,083751,Rideout; David Porter,5,0,36,31
1657088710298,MATH 18,B05,093473,Rideout; David Porter,4,0,36,32
1657088710298,MATH 18,B06,093474,Rideout; David Porter,5,0,36,31
1657088716323,MATH 20A,A01,083754,Zheng; Zequn,12,0,40,28
1657088722346,MATH 20B,A01,083756,Briones; Jor-el Thomas Caparas,1,0,36,35
1657088722346,MATH 20B,A02,083757,Briones; Jor-el Thomas Caparas,1,0,36,35
1657088722346,MATH 20B,A03,093475,Briones; Jor-el Thomas Caparas,0,0,36,36
1657088728450,MATH 20C,A01,083760,Briones; Jor-el Thomas Caparas,1,0,35,34
1657088728450,MATH 20C,A02,083761,Briones; Jor-el Thomas Caparas,8,0,35,27
1657088728450,MATH 20C,A03,093476,Briones; Jor-el Thomas Caparas,0,1,36,36
1657088728450,MATH 20C,B01,083762,Bach; Quang Tran,0,0,30,30
1657088734478,MATH 20D,A01,083765,Tran; Brian Kha,4,0,30,26
1657088734478,MATH 20D,A02,083766,Tran; Brian Kha,5,0,30,25
1657088734478,MATH 20D,A03,083767,Tran; Brian Kha,3,0,30,27
1657088740510,MATH 20E,A01,083771,Ganguly; Soumya,6,0,32,26
1657088740510,MATH 20E,A02,083772,Ganguly; Soumya,6,0,32,26
1657088740510,MATH 20E,B01,083773,Ciotti; Benjamin,18,0,35,17
1657088740510,MATH 20E,B02,083774,Ciotti; Benjamin,17,0,35,18
1657088746536,MATH 103A,A01,083777,Greenfeld; Be'Eri,2,0,36,34
1657088746536,MATH 103A,A02,083778,Greenfeld; Be'Eri,5,0,36,31
1657088746536,MATH 103A,A03,093561,Greenfeld; Be'Eri,4,0,36,32
1657088746536,MATH 103A,B01,083779,Greenfeld; Be'Eri,6,0,36,30
1657088746536,MATH 103A,B02,083780,Greenfeld; Be'Eri,2,0,36,34
1657088746536,MATH 103A,B03,093562,Greenfeld; Be'Eri,3,0,36,33
1657088752564,MATH 105,A01,085443,Carter; Anne Toulson,14,0,35,21
1657088752564,MATH 105,A02,093477,Carter; Anne Toulson,20,0,35,15
1657088758588,MATH 109,A01,083213,Ganzberger; Geoffrey Michael,2,0,34,32
1657088758588,MATH 109,A02,083214,Ganzberger; Geoffrey Michael,2,0,34,32
1657088758588,MATH 109,A03,093478,Ganzberger; Geoffrey Michael,1,0,34,33
1657088758588,MATH 109,B01,083215,Ganzberger; Geoffrey Michael,1,0,32,31
1657088758588,MATH 109,B02,083216,Ganzberger; Geoffrey Michael,1,0,32,31
1657088758588,MATH 109,B03,093479,Ganzberger; Geoffrey Michael,6,0,32,26
1657088764613,MATH 142A,A01,083219,Chow; Bennett,6,0,32,26
1657088764613,MATH 142A,A02,083220,Chow; Bennett,10,0,32,22
1657088764613,MATH 142A,A03,093480,Chow; Bennett,7,0,32,25
1657088764613,MATH 142A,B03,093481,Chow; Bennett,8,0,32,24
1657088764613,MATH 142A,B04,093558,Chow; Bennett,11,0,32,21
1657088764613,MATH 142A,B05,093559,Chow; Bennett,6,0,32,26
1657088770638,MATH 193A,A01,083224,Rotar; Vladimir,7,0,34,27
1657088770638,MATH 193A,A02,083225,Rotar; Vladimir,5,0,34,29
1657088770638,MATH 193A,A03,083781,Rotar; Vladimir,1,0,34,33
1657088770638,MATH 193A,A04,083782,Rotar; Vladimir,6,0,34,28
1657088770638,MATH 193A,A05,093482,Rotar; Vladimir,6,0,34,28
1657088776660,MATH 197,001,091859,McAuley; Julian John,9999,0,9999,0
1657088776660,MATH 197,002,095566,Kedlaya; Kiran S.,9997,0,9999,2
1657088776660,MATH 197,003,095567,Xiao; Ming,9999,0,9999,0
1657088776660,MATH 197,004,095571,Perols; Johan Lars,9998,0,9999,1
1657088783719,COGS 9,A01,083615,Shannon; Kyle Michael,7,0,75,68
1657088789750,COGS 11,A01,083617,Boyle; Mary E. T.,21,0,48,27
1657088795799,COGS 13,A01,083071,Bastos; Amalia Pinkusfeld,9,0,71,62
1657088801822,COGS 14A,A01,092681,Semenuks; Arturs,1,1,100,99
1657088807846,COGS 14B,A01,083073,Cheng; Tzu-Han,5,0,63,58
1657088813871,COGS 17,A01,092677,Semenuks; Arturs,4,0,81,77
1657088819893,COGS 100,A01,083619,Allen; Michael Gordon,15,0,70,55
1657088825921,COGS 101A,A01,083621,Davis; Joshua Daniel,9,0,68,59
1657088831944,COGS 101B,A01,091572,Allen; Michael Gordon,8,0,65,57
1657088837970,COGS 101C,A01,083625,Delgado; Tania,17,0,35,18
1657088843994,COGS 107A,A01,083627,Boyle; Mary E. T.,13,0,60,47
1657088850022,COGS 118A,A01,083075,Gupta; Anjum,15,0,76,61
1657088856049,CSE 3,A50,083646,Miranda; Gregory Joseph,22,0,50,28
1657088862078,CSE 8A,A50,083650,Miranda; Gregory Joseph,17,1,56,39
1657088868104,CSE 11,A01,083080,Cao; Yingjun,4,15,40,36
1657088874129,CSE 12,A01,083652,Krause-Levy; Sophia Louisa,23,1,120,97
1657088880155,CSE 15L,A01,083654,Morris; Justin Loren,9,0,50,41
1657088880155,CSE 15L,A02,083655,Morris; Justin Loren,9,0,50,41
1657088886185,CSE 20,A01,083657,Tran; Khoa Dang,37,0,80,43
1657088892208,CSE 21,A01,095574,Bach; Quang Tran,21,0,48,27
1657088898235,CSE 30,A01,083084,Eldon; John,4,0,80,76
1657088898235,CSE 30,B01,095061,Bhaskar; Nishant,6,0,50,44
1657088904259,CSE 100,A01,083659,Cao; Yingjun,3,4,70,67
1657088910285,CSE 134B,A01,083661,Powell; Thomas Allan,19,0,100,81
1657088916307,CSE 140,A01,083663,Gungor; Onat,14,0,85,71
1657088922346,CSE 140L,A01,083088,Eldon; John,16,0,100,84
1657088928389,CSE 175,A01,083665,Kumar; Rakesh,3,0,25,22
1657088934414,CSE 190,A00,092507,Dubnov; Shlomo,7,0,20,13
1657088940436,ECE 45,A01,083139,Congero; Spencer William,5,0,75,70
1657088946463,ECE 65,A50,083695,Saad; Andrew S,12,0,30,18
1657088946463,ECE 65,A51,095125,Saad; Andrew S,25,0,26,1
1657088952505,ECE 109,A01,091882,Touri; Behrouz,16,0,70,54
1657088958532,ECE 180,A00,083140,Abi Samra; Nicholas Camill,1,0,30,29
1657088958532,ECE 180,B00,083141,Abi Samra; Nicholas Camill,0,0,30,30
1657088964557,MATH 10A,A01,083735,Patchell; Gregory David,1,0,30,29
1657088964557,MATH 10A,A02,083736,Patchell; Gregory David,20,0,30,10
1657088964557,MATH 10A,A03,083737,Patchell; Gregory David,16,0,30,14
1657088970581,MATH 10B,A01,083207,Lim; Seonhee,7,0,34,27
1657088970581,MATH 10B,A02,083208,Lim; Seonhee,9,0,35,26
1657088970581,MATH 10B,A03,093472,Lim; Seonhee,5,0,34,29
1657088970581,MATH 10B,B01,083739,Sinha; Shubham,9,0,30,21
1657088976606,MATH 18,A01,083743,Cinel; Cameron Alexander,6,0,30,24
1657088976606,MATH 18,A02,083744,Cinel; Cameron Alexander,15,0,30,15
1657088976606,MATH 18,A03,083745,Cinel; Cameron Alexander,8,0,30,22
1657088976606,MATH 18,B01,083748,Rideout; David Porter,4,0,37,33
1657088976606,MATH 18,B02,083749,Rideout; David Porter,3,0,36,33
1657088976606,MATH 18,B03,083750,Rideout; David Porter,2,0,37,35
1657088976606,MATH 18,B04,083751,Rideout; David Porter,5,0,36,31
1657088976606,MATH 18,B05,093473,Rideout; David Porter,4,0,36,32
1657088976606,MATH 18,B06,093474,Rideout; David Porter,5,0,36,31
1657088982634,MATH 20A,A01,083754,Zheng; Zequn,12,0,40,28
1657088988659,MATH 20B,A01,083756,Briones; Jor-el Thomas Caparas,1,0,36,35
1657088988659,MATH 20B,A02,083757,Briones; Jor-el Thomas Caparas,1,0,36,35
1657088988659,MATH 20B,A03,093475,Briones; Jor-el Thomas Caparas,0,0,36,36
1657088994684,MATH 20C,A01,083760,Briones; Jor-el Thomas Caparas,1,0,35,34
1657088994684,MATH 20C,A02,083761,Briones; Jor-el Thomas Caparas,8,0,35,27
1657088994684,MATH 20C,A03,093476,Briones; Jor-el Thomas Caparas,0,1,36,36
1657088994684,MATH 20C,B01,083762,Bach; Quang Tran,0,0,30,30
1657089000720,MATH 20D,A01,083765,Tran; Brian Kha,4,0,30,26
1657089000720,MATH 20D,A02,083766,Tran; Brian Kha,5,0,30,25
1657089000720,MATH 20D,A03,083767,Tran; Brian Kha,3,0,30,27
1657089006744,MATH 20E,A01,083771,Ganguly; Soumya,6,0,32,26
1657089006744,MATH 20E,A02,083772,Ganguly; Soumya,6,0,32,26
1657089006744,MATH 20E,B01,083773,Ciotti; Benjamin,18,0,35,17
1657089006744,MATH 20E,B02,083774,Ciotti; Benjamin,17,0,35,18
1657089012776,MATH 103A,A01,083777,Greenfeld; Be'Eri,2,0,36,34
1657089012776,MATH 103A,A02,083778,Greenfeld; Be'Eri,5,0,36,31
1657089012776,MATH 103A,A03,093561,Greenfeld; Be'Eri,4,0,36,32
1657089012776,MATH 103A,B01,083779,Greenfeld; Be'Eri,6,0,36,30
1657089012776,MATH 103A,B02,083780,Greenfeld; Be'Eri,2,0,36,34
1657089012776,MATH 103A,B03,093562,Greenfeld; Be'Eri,3,0,36,33
1657089018803,MATH 105,A01,085443,Carter; Anne Toulson,14,0,35,21
1657089018803,MATH 105,A02,093477,Carter; Anne Toulson,20,0,35,15
1657089024828,MATH 109,A01,083213,Ganzberger; Geoffrey Michael,2,0,34,32
1657089024828,MATH 109,A02,083214,Ganzberger; Geoffrey Michael,2,0,34,32
1657089024828,MATH 109,A03,093478,Ganzberger; Geoffrey Michael,1,0,34,33
1657089024828,MATH 109,B01,083215,Ganzberger; Geoffrey Michael,1,0,32,31
1657089024828,MATH 109,B02,083216,Ganzberger; Geoffrey Michael,1,0,32,31
1657089024828,MATH 109,B03,093479,Ganzberger; Geoffrey Michael,6,0,32,26
1657089030861,MATH 142A,A01,083219,Chow; Bennett,6,0,32,26
1657089030861,MATH 142A,A02,083220,Chow; Bennett,10,0,32,22
1657089030861,MATH 142A,A03,093480,Chow; Bennett,7,0,32,25
1657089030861,MATH 142A,B03,093481,Chow; Bennett,8,0,32,24
1657089030861,MATH 142A,B04,093558,Chow; Bennett,11,0,32,21
1657089030861,MATH 142A,B05,093559,Chow; Bennett,6,0,32,26
1657089036884,MATH 193A,A01,083224,Rotar; Vladimir,7,0,34,27
1657089036884,MATH 193A,A02,083225,Rotar; Vladimir,5,0,34,29
1657089036884,MATH 193A,A03,083781,Rotar; Vladimir,1,0,34,33
1657089036884,MATH 193A,A04,083782,Rotar; Vladimir,6,0,34,28
1657089036884,MATH 193A,A05,093482,Rotar; Vladimir,6,0,34,28
1657089042908,MATH 197,001,091859,McAuley; Julian John,9999,0,9999,0
1657089042908,MATH 197,002,095566,Kedlaya; Kiran S.,9997,0,9999,2
1657089042908,MATH 197,003,095567,Xiao; Ming,9999,0,9999,0
1657089042908,MATH 197,004,095571,Perols; Johan Lars,9998,0,9999,1
1657089049971,COGS 9,A01,083615,Shannon; Kyle Michael,7,0,75,68
1657089056000,COGS 11,A01,083617,Boyle; Mary E. T.,21,0,48,27
1657089062023,COGS 13,A01,083071,Bastos; Amalia Pinkusfeld,9,0,71,62
1657089068051,COGS 14A,A01,092681,Semenuks; Arturs,1,1,100,99
1657089074085,COGS 14B,A01,083073,Cheng; Tzu-Han,5,0,63,58
1657089080113,COGS 17,A01,092677,Semenuks; Arturs,4,0,81,77
1657089086154,COGS 100,A01,083619,Allen; Michael Gordon,15,0,70,55
1657089092178,COGS 101A,A01,083621,Davis; Joshua Daniel,9,0,68,59
1657089098202,COGS 101B,A01,091572,Allen; Michael Gordon,8,0,65,57
1657089104229,COGS 101C,A01,083625,Delgado; Tania,17,0,35,18
1657089110254,COGS 107A,A01,083627,Boyle; Mary E. T.,13,0,60,47
1657089116277,COGS 118A,A01,083075,Gupta; Anjum,15,0,76,61
1657089122331,CSE 3,A50,083646,Miranda; Gregory Joseph,22,0,50,28
1657089128359,CSE 8A,A50,083650,Miranda; Gregory Joseph,17,1,56,39
1657089134382,CSE 11,A01,083080,Cao; Yingjun,4,15,40,36
1657089140413,CSE 12,A01,083652,Krause-Levy; Sophia Louisa,23,1,120,97
1657089146440,CSE 15L,A01,083654,Morris; Justin Loren,9,0,50,41
1657089146440,CSE 15L,A02,083655,Morris; Justin Loren,9,0,50,41
1657089152477,CSE 20,A01,083657,Tran; Khoa Dang,37,0,80,43
1657089158515,CSE 21,A01,095574,Bach; Quang Tran,21,0,48,27
1657089164543,CSE 30,A01,083084,Eldon; John,4,0,80,76
1657089164543,CSE 30,B01,095061,Bhaskar; Nishant,6,0,50,44
1657089170567,CSE 100,A01,083659,Cao; Yingjun,3,4,70,67
1657089176590,CSE 134B,A01,083661,Powell; Thomas Allan,19,0,100,81
1657089182618,CSE 140,A01,083663,Gungor; Onat,14,0,85,71
1657089188656,CSE 140L,A01,083088,Eldon; John,16,0,100,84
1657089194695,CSE 175,A01,083665,Kumar; Rakesh,3,0,25,22
1657089200719,CSE 190,A00,092507,Dubnov; Shlomo,7,0,20,13
1657089206746,ECE 45,A01,083139,Congero; Spencer William,5,0,75,70
1657089212769,ECE 65,A50,083695,Saad; Andrew S,12,0,30,18
1657089212769,ECE 65,A51,095125,Saad; Andrew S,25,0,26,1
1657089218795,ECE 109,A01,091882,Touri; Behrouz,16,0,70,54
1657089224820,ECE 180,A00,083140,Abi Samra; Nicholas Camill,1,0,30,29
1657089224820,ECE 180,B00,083141,Abi Samra; Nicholas Camill,0,0,30,30
1657089230845,MATH 10A,A01,083735,Patchell; Gregory David,1,0,30,29
1657089230845,MATH 10A,A02,083736,Patchell; Gregory David,20,0,30,10
1657089230845,MATH 10A,A03,083737,Patchell; Gregory David,16,0,30,14
1657089236870,MATH 10B,A01,083207,Lim; Seonhee,7,0,34,27
1657089236870,MATH 10B,A02,083208,Lim; Seonhee,9,0,35,26
1657089236870,MATH 10B,A03,093472,Lim; Seonhee,5,0,34,29
1657089236870,MATH 10B,B01,083739,Sinha; Shubham,9,0,30,21
1657089242896,MATH 18,A01,083743,Cinel; Cameron Alexander,6,0,30,24
1657089242896,MATH 18,A02,083744,Cinel; Cameron Alexander,15,0,30,15
1657089242896,MATH 18,A03,083745,Cinel; Cameron Alexander,8,0,30,22
1657089242896,MATH 18,B01,083748,Rideout; David Porter,4,0,37,33
1657089242896,MATH 18,B02,083749,Rideout; David Porter,3,0,36,33
1657089242896,MATH 18,B03,083750,Rideout; David Porter,2,0,37,35
1657089242896,MATH 18,B04,083751,Rideout; David Porter,5,0,36,31
1657089242896,MATH 18,B05,093473,Rideout; David Porter,4,0,36,32
1657089242896,MATH 18,B06,093474,Rideout; David Porter,5,0,36,31
1657089248953,MATH 20A,A01,083754,Zheng; Zequn,12,0,40,28
1657089254980,MATH 20B,A01,083756,Briones; Jor-el Thomas Caparas,1,0,36,35
1657089254980,MATH 20B,A02,083757,Briones; Jor-el Thomas Caparas,1,0,36,35
1657089254980,MATH 20B,A03,093475,Briones; Jor-el Thomas Caparas,0,0,36,36
1657089261010,MATH 20C,A01,083760,Briones; Jor-el Thomas Caparas,1,0,35,34
1657089261010,MATH 20C,A02,083761,Briones; Jor-el Thomas Caparas,8,0,35,27
1657089261010,MATH 20C,A03,093476,Briones; Jor-el Thomas Caparas,0,1,36,36
1657089261010,MATH 20C,B01,083762,Bach; Quang Tran,0,0,30,30
1657089267036,MATH 20D,A01,083765,Tran; Brian Kha,4,0,30,26
1657089267036,MATH 20D,A02,083766,Tran; Brian Kha,5,0,30,25
1657089267036,MATH 20D,A03,083767,Tran; Brian Kha,3,0,30,27
1657089273065,MATH 20E,A01,083771,Ganguly; Soumya,6,0,32,26
1657089273065,MATH 20E,A02,083772,Ganguly; Soumya,6,0,32,26
1657089273065,MATH 20E,B01,083773,Ciotti; Benjamin,18,0,35,17
1657089273065,MATH 20E,B02,083774,Ciotti; Benjamin,17,0,35,18
1657089279090,MATH 103A,A01,083777,Greenfeld; Be'Eri,2,0,36,34
1657089279090,MATH 103A,A02,083778,Greenfeld; Be'Eri,5,0,36,31
1657089279090,MATH 103A,A03,093561,Greenfeld; Be'Eri,4,0,36,32
1657089279090,MATH 103A,B01,083779,Greenfeld; Be'Eri,6,0,36,30
1657089279090,MATH 103A,B02,083780,Greenfeld; Be'Eri,2,0,36,34
1657089279090,MATH 103A,B03,093562,Greenfeld; Be'Eri,3,0,36,33
1657089285123,MATH 105,A01,085443,Carter; Anne Toulson,14,0,35,21
1657089285123,MATH 105,A02,093477,Carter; Anne Toulson,20,0,35,15
1657089291155,MATH 109,A01,083213,Ganzberger; Geoffrey Michael,2,0,34,32
1657089291155,MATH 109,A02,083214,Ganzberger; Geoffrey Michael,2,0,34,32
1657089291155,MATH 109,A03,093478,Ganzberger; Geoffrey Michael,1,0,34,33
1657089291155,MATH 109,B01,083215,Ganzberger; Geoffrey Michael,1,0,32,31
1657089291155,MATH 109,B02,083216,Ganzberger; Geoffrey Michael,1,0,32,31
1657089291155,MATH 109,B03,093479,Ganzberger; Geoffrey Michael,6,0,32,26
1657089297183,MATH 142A,A01,083219,Chow; Bennett,6,0,32,26
1657089297183,MATH 142A,A02,083220,Chow; Bennett,10,0,32,22
1657089297183,MATH 142A,A03,093480,Chow; Bennett,7,0,32,25
1657089297183,MATH 142A,B03,093481,Chow; Bennett,8,0,32,24
1657089297183,MATH 142A,B04,093558,Chow; Bennett,11,0,32,21
1657089297183,MATH 142A,B05,093559,Chow; Bennett,6,0,32,26
1657089303208,MATH 193A,A01,083224,Rotar; Vladimir,7,0,34,27
1657089303208,MATH 193A,A02,083225,Rotar; Vladimir,5,0,34,29
1657089303208,MATH 193A,A03,083781,Rotar; Vladimir,1,0,34,33
1657089303208,MATH 193A,A04,083782,Rotar; Vladimir,6,0,34,28
1657089303208,MATH 193A,A05,093482,Rotar; Vladimir,6,0,34,28
1657089309230,MATH 197,001,091859,McAuley; Julian John,9999,0,9999,0
1657089309230,MATH 197,002,095566,Kedlaya; Kiran S.,9997,0,9999,2
1657089309230,MATH 197,003,095567,Xiao; Ming,9999,0,9999,0
1657089309230,MATH 197,004,095571,Perols; Johan Lars,9998,0,9999,1
1657089316283,COGS 9,A01,083615,Shannon; Kyle Michael,7,0,75,68
1657089322393,COGS 11,A01,083617,Boyle; Mary E. T.,21,0,48,27
1657089328421,COGS 13,A01,083071,Bastos; Amalia Pinkusfeld,9,0,71,62
1657089334448,COGS 14A,A01,092681,Semenuks; Arturs,1,1,100,99
1657089340494,COGS 14B,A01,083073,Cheng; Tzu-Han,5,0,63,58
1657089346520,COGS 17,A01,092677,Semenuks; Arturs,4,0,81,77
1657089352545,COGS 100,A01,083619,Allen; Michael Gordon,15,0,70,55
1657089358574,COGS 101A,A01,083621,Davis; Joshua Daniel,9,0,68,59
1657089364601,COGS 101B,A01,091572,Allen; Michael Gordon,8,0,65,57
1657089370627,COGS 101C,A01,083625,Delgado; Tania,17,0,35,18
1657089376649,COGS 107A,A01,083627,Boyle; Mary E. T.,13,0,60,47
1657089382674,COGS 118A,A01,083075,Gupta; Anjum,15,0,76,61
1657089388697,CSE 3,A50,083646,Miranda; Gregory Joseph,22,0,50,28
1657089394739,CSE 8A,A50,083650,Miranda; Gregory Joseph,17,1,56,39
1657089400768,CSE 11,A01,083080,Cao; Yingjun,4,15,40,36
1657089406789,CSE 12,A01,083652,Krause-Levy; Sophia Louisa,23,1,120,97
1657089412818,CSE 15L,A01,083654,Morris; Justin Loren,9,0,50,41
1657089412818,CSE 15L,A02,083655,Morris; Justin Loren,9,0,50,41
1657089418843,CSE 20,A01,083657,Tran; Khoa Dang,37,0,80,43
1657089424867,CSE 21,A01,095574,Bach; Quang Tran,21,0,48,27
1657089430891,CSE 30,A01,083084,Eldon; John,4,0,80,76
1657089430891,CSE 30,B01,095061,Bhaskar; Nishant,6,0,50,44
1657089436913,CSE 100,A01,083659,Cao; Yingjun,3,4,70,67
1657089442936,CSE 134B,A01,083661,Powell; Thomas Allan,19,0,100,81
1657089448962,CSE 140,A01,083663,Gungor; Onat,14,0,85,71
1657089454984,CSE 140L,A01,083088,Eldon; John,16,0,100,84
1657089461008,CSE 175,A01,083665,Kumar; Rakesh,3,0,25,22
1657089467035,CSE 190,A00,092507,Dubnov; Shlomo,7,0,20,13
1657089473060,ECE 45,A01,083139,Congero; Spencer William,5,0,75,70
1657089479088,ECE 65,A50,083695,Saad; Andrew S,12,0,30,18
1657089479088,ECE 65,A51,095125,Saad; Andrew S,25,0,26,1
1657089485116,ECE 109,A01,091882,Touri; Behrouz,16,0,70,54
1657089491137,ECE 180,A00,083140,Abi Samra; Nicholas Camill,1,0,30,29
1657089491137,ECE 180,B00,083141,Abi Samra; Nicholas Camill,0,0,30,30
1657089497164,MATH 10A,A01,083735,Patchell; Gregory David,1,0,30,29
1657089497164,MATH 10A,A02,083736,Patchell; Gregory David,20,0,30,10
1657089497164,MATH 10A,A03,083737,Patchell; Gregory David,16,0,30,14
1657089503188,MATH 10B,A01,083207,Lim; Seonhee,7,0,34,27
1657089503188,MATH 10B,A02,083208,Lim; Seonhee,9,0,35,26
1657089503188,MATH 10B,A03,093472,Lim; Seonhee,5,0,34,29
1657089503188,MATH 10B,B01,083739,Sinha; Shubham,9,0,30,21
1657089509213,MATH 18,A01,083743,Cinel; Cameron Alexander,6,0,30,24
1657089509213,MATH 18,A02,083744,Cinel; Cameron Alexander,15,0,30,15
1657089509213,MATH 18,A03,083745,Cinel; Cameron Alexander,8,0,30,22
1657089509213,MATH 18,B01,083748,Rideout; David Porter,4,0,37,33
1657089509213,MATH 18,B02,083749,Rideout; David Porter,3,0,36,33
1657089509213,MATH 18,B03,083750,Rideout; David Porter,2,0,37,35
1657089509213,MATH 18,B04,083751,Rideout; David Porter,5,0,36,31
1657089509213,MATH 18,B05,093473,Rideout; David Porter,4,0,36,32
1657089509213,MATH 18,B06,093474,Rideout; David Porter,5,0,36,31
1657089515244,MATH 20A,A01,083754,Zheng; Zequn,12,0,40,28
1657089521270,MATH 20B,A01,083756,Briones; Jor-el Thomas Caparas,1,0,36,35
1657089521270,MATH 20B,A02,083757,Briones; Jor-el Thomas Caparas,1,0,36,35
1657089521270,MATH 20B,A03,093475,Briones; Jor-el Thomas Caparas,0,0,36,36
1657089527295,MATH 20C,A01,083760,Briones; Jor-el Thomas Caparas,1,0,35,34
1657089527295,MATH 20C,A02,083761,Briones; Jor-el Thomas Caparas,8,0,35,27
1657089527295,MATH 20C,A03,093476,Briones; Jor-el Thomas Caparas,0,1,36,36
1657089527295,MATH 20C,B01,083762,Bach; Quang Tran,0,0,30,30
1657089533324,MATH 20D,A01,083765,Tran; Brian Kha,4,0,30,26
1657089533324,MATH 20D,A02,083766,Tran; Brian Kha,5,0,30,25
1657089533324,MATH 20D,A03,083767,Tran; Brian Kha,3,0,30,27
1657089539351,MATH 20E,A01,083771,Ganguly; Soumya,6,0,32,26
1657089539351,MATH 20E,A02,083772,Ganguly; Soumya,6,0,32,26
1657089539351,MATH 20E,B01,083773,Ciotti; Benjamin,18,0,35,17
1657089539351,MATH 20E,B02,083774,Ciotti; Benjamin,17,0,35,18
1657089545375,MATH 103A,A01,083777,Greenfeld; Be'Eri,2,0,36,34
1657089545375,MATH 103A,A02,083778,Greenfeld; Be'Eri,5,0,36,31
1657089545375,MATH 103A,A03,093561,Greenfeld; Be'Eri,4,0,36,32
1657089545375,MATH 103A,B01,083779,Greenfeld; Be'Eri,6,0,36,30
1657089545375,MATH 103A,B02,083780,Greenfeld; Be'Eri,2,0,36,34
1657089545375,MATH 103A,B03,093562,Greenfeld; Be'Eri,3,0,36,33
1657089551397,MATH 105,A01,085443,Carter; Anne Toulson,14,0,35,21
1657089551397,MATH 105,A02,093477,Carter; Anne Toulson,20,0,35,15
1657089557421,MATH 109,A01,083213,Ganzberger; Geoffrey Michael,2,0,34,32
1657089557421,MATH 109,A02,083214,Ganzberger; Geoffrey Michael,2,0,34,32
1657089557421,MATH 109,A03,093478,Ganzberger; Geoffrey Michael,1,0,34,33
1657089557421,MATH 109,B01,083215,Ganzberger; Geoffrey Michael,1,0,32,31
1657089557421,MATH 109,B02,083216,Ganzberger; Geoffrey Michael,1,0,32,31
1657089557421,MATH 109,B03,093479,Ganzberger; Geoffrey Michael,6,0,32,26
1657089563454,MATH 142A,A01,083219,Chow; Bennett,6,0,32,26
1657089563454,MATH 142A,A02,083220,Chow; Bennett,10,0,32,22
1657089563454,MATH 142A,A03,093480,Chow; Bennett,7,0,32,25
1657089563454,MATH 142A,B03,093481,Chow; Bennett,8,0,32,24
1657089563454,MATH 142A,B04,093558,Chow; Bennett,11,0,32,21
1657089563454,MATH 142A,B05,093559,Chow; Bennett,6,0,32,26
1657089569477,MATH 193A,A01,083224,Rotar; Vladimir,7,0,34,27
1657089569477,MATH 193A,A02,083225,Rotar; Vladimir,5,0,34,29
1657089569477,MATH 193A,A03,083781,Rotar; Vladimir,1,0,34,33
1657089569477,MATH 193A,A04,083782,Rotar; Vladimir,6,0,34,28
1657089569477,MATH 193A,A05,093482,Rotar; Vladimir,6,0,34,28
1657089575503,MATH 197,001,091859,McAuley; Julian John,9999,0,9999,0
1657089575503,MATH 197,002,095566,Kedlaya; Kiran S.,9997,0,9999,2
1657089575503,MATH 197,003,095567,Xiao; Ming,9999,0,9999,0
1657089575503,MATH 197,004,095571,Perols; Johan Lars,9998,0,9999,1
1657089582568,COGS 9,A01,083615,Shannon; Kyle Michael,7,0,75,68
1657089588590,COGS 11,A01,083617,Boyle; Mary E. T.,21,0,48,27
1657089594612,COGS 13,A01,083071,Bastos; Amalia Pinkusfeld,9,0,71,62
1657089600640,COGS 14A,A01,092681,Semenuks; Arturs,1,1,100,99
1657089606675,COGS 14B,A01,083073,Cheng; Tzu-Han,5,0,63,58
1657089612699,COGS 17,A01,092677,Semenuks; Arturs,4,0,81,77
1657089618722,COGS 100,A01,083619,Allen; Michael Gordon,15,0,70,55
1657089624750,COGS 101A,A01,083621,Davis; Joshua Daniel,9,0,68,59
1657089630777,COGS 101B,A01,091572,Allen; Michael Gordon,8,0,65,57
1657089636799,COGS 101C,A01,083625,Delgado; Tania,17,0,35,18
1657089642822,COGS 107A,A01,083627,Boyle; Mary E. T.,13,0,60,47
1657089648884,COGS 118A,A01,083075,Gupta; Anjum,15,0,76,61
1657089654912,CSE 3,A50,083646,Miranda; Gregory Joseph,22,0,50,28
1657089660935,CSE 8A,A50,083650,Miranda; Gregory Joseph,17,1,56,39
1657089666965,CSE 11,A01,083080,Cao; Yingjun,4,15,40,36
1657089672988,CSE 12,A01,083652,Krause-Levy; Sophia Louisa,23,1,120,97
1657089679022,CSE 15L,A01,083654,Morris; Justin Loren,9,0,50,41
1657089679022,CSE 15L,A02,083655,Morris; Justin Loren,9,0,50,41
1657089685044,CSE 20,A01,083657,Tran; Khoa Dang,37,0,80,43
1657089691067,CSE 21,A01,095574,Bach; Quang Tran,21,0,48,27
1657089697089,CSE 30,A01,083084,Eldon; John,4,0,80,76
1657089697089,CSE 30,B01,095061,Bhaskar; Nishant,6,0,50,44
1657089703111,CSE 100,A01,083659,Cao; Yingjun,3,4,70,67
1657089709133,CSE 134B,A01,083661,Powell; Thomas Allan,19,0,100,81
1657089715174,CSE 140,A01,083663,Gungor; Onat,14,0,85,71
1657089721198,CSE 140L,A01,083088,Eldon; John,16,0,100,84
1657089727221,CSE 175,A01,083665,Kumar; Rakesh,3,0,25,22
1657089733245,CSE 190,A00,092507,Dubnov; Shlomo,7,0,20,13
1657089739272,ECE 45,A01,083139,Congero; Spencer William,5,0,75,70
1657089745301,ECE 65,A50,083695,Saad; Andrew S,12,0,30,18
1657089745301,ECE 65,A51,095125,Saad; Andrew S,25,0,26,1
1657089751325,ECE 109,A01,091882,Touri; Behrouz,16,0,70,54
1657089757352,ECE 180,A00,083140,Abi Samra; Nicholas Camill,1,0,30,29
1657089757352,ECE 180,B00,083141,Abi Samra; Nicholas Camill,0,0,30,30
1657089763375,MATH 10A,A01,083735,Patchell; Gregory David,1,0,30,29
1657089763375,MATH 10A,A02,083736,Patchell; Gregory David,20,0,30,10
1657089763375,MATH 10A,A03,083737,Patchell; Gregory David,16,0,30,14
1657089769405,MATH 10B,A01,083207,Lim; Seonhee,7,0,34,27
1657089769405,MATH 10B,A02,083208,Lim; Seonhee,9,0,35,26
1657089769405,MATH 10B,A03,093472,Lim; Seonhee,5,0,34,29
1657089769405,MATH 10B,B01,083739,Sinha; Shubham,9,0,30,21
1657089775437,MATH 18,A01,083743,Cinel; Cameron Alexander,6,0,30,24
1657089775437,MATH 18,A02,083744,Cinel; Cameron Alexander,15,0,30,15
1657089775437,MATH 18,A03,083745,Cinel; Cameron Alexander,8,0,30,22
1657089775437,MATH 18,B01,083748,Rideout; David Porter,4,0,37,33
1657089775437,MATH 18,B02,083749,Rideout; David Porter,3,0,36,33
1657089775437,MATH 18,B03,083750,Rideout; David Porter,2,0,37,35
1657089775437,MATH 18,B04,083751,Rideout; David Porter,5,0,36,31
1657089775437,MATH 18,B05,093473,Rideout; David Porter,4,0,36,32
1657089775437,MATH 18,B06,093474,Rideout; David Porter,5,0,36,31
1657089781467,MATH 20A,A01,083754,Zheng; Zequn,12,0,40,28
1657089787502,MATH 20B,A01,083756,Briones; Jor-el Thomas Caparas,1,0,36,35
1657089787502,MATH 20B,A02,083757,Briones; Jor-el Thomas Caparas,1,0,36,35
1657089787502,MATH 20B,A03,093475,Briones; Jor-el Thomas Caparas,0,0,36,36
1657089793528,MATH 20C,A01,083760,Briones; Jor-el Thomas Caparas,1,0,35,34
1657089793528,MATH 20C,A02,083761,Briones; Jor-el Thomas Caparas,8,0,35,27
1657089793528,MATH 20C,A03,093476,Briones; Jor-el Thomas Caparas,0,1,36,36
1657089793528,MATH 20C,B01,083762,Bach; Quang Tran,0,0,30,30
1657089799551,MATH 20D,A01,083765,Tran; Brian Kha,4,0,30,26
1657089799551,MATH 20D,A02,083766,Tran; Brian Kha,5,0,30,25
1657089799551,MATH 20D,A03,083767,Tran; Brian Kha,3,0,30,27
1657089805579,MATH 20E,A01,083771,Ganguly; Soumya,6,0,32,26
1657089805579,MATH 20E,A02,083772,Ganguly; Soumya,6,0,32,26
1657089805579,MATH 20E,B01,083773,Ciotti; Benjamin,18,0,35,17
1657089805579,MATH 20E,B02,083774,Ciotti; Benjamin,17,0,35,18
1657089811601,MATH 103A,A01,083777,Greenfeld; Be'Eri,2,0,36,34
1657089811601,MATH 103A,A02,083778,Greenfeld; Be'Eri,5,0,36,31
1657089811601,MATH 103A,A03,093561,Greenfeld; Be'Eri,4,0,36,32
1657089811601,MATH 103A,B01,083779,Greenfeld; Be'Eri,6,0,36,30
1657089811601,MATH 103A,B02,083780,Greenfeld; Be'Eri,2,0,36,34
1657089811601,MATH 103A,B03,093562,Greenfeld; Be'Eri,3,0,36,33
1657089817634,MATH 105,A01,085443,Carter; Anne Toulson,14,0,35,21
1657089817634,MATH 105,A02,093477,Carter; Anne Toulson,20,0,35,15
1657089823658,MATH 109,A01,083213,Ganzberger; Geoffrey Michael,2,0,34,32
1657089823658,MATH 109,A02,083214,Ganzberger; Geoffrey Michael,2,0,34,32
1657089823658,MATH 109,A03,093478,Ganzberger; Geoffrey Michael,1,0,34,33
1657089823658,MATH 109,B01,083215,Ganzberger; Geoffrey Michael,1,0,32,31
1657089823658,MATH 109,B02,083216,Ganzberger; Geoffrey Michael,1,0,32,31
1657089823658,MATH 109,B03,093479,Ganzberger; Geoffrey Michael,6,0,32,26
1657089829681,MATH 142A,A01,083219,Chow; Bennett,6,0,32,26
1657089829681,MATH 142A,A02,083220,Chow; Bennett,10,0,32,22
1657089829681,MATH 142A,A03,093480,Chow; Bennett,7,0,32,25
1657089829681,MATH 142A,B03,093481,Chow; Bennett,8,0,32,24
1657089829681,MATH 142A,B04,093558,Chow; Bennett,11,0,32,21
1657089829681,MATH 142A,B05,093559,Chow; Bennett,6,0,32,26
1657089835704,MATH 193A,A01,083224,Rotar; Vladimir,7,0,34,27
1657089835704,MATH 193A,A02,083225,Rotar; Vladimir,5,0,34,29
1657089835704,MATH 193A,A03,083781,Rotar; Vladimir,1,0,34,33
1657089835704,MATH 193A,A04,083782,Rotar; Vladimir,6,0,34,28
1657089835704,MATH 193A,A05,093482,Rotar; Vladimir,6,0,34,28
1657089841729,MATH 197,001,091859,McAuley; Julian John,9999,0,9999,0
1657089841729,MATH 197,002,095566,Kedlaya; Kiran S.,9997,0,9999,2
1657089841729,MATH 197,003,095567,Xiao; Ming,9999,0,9999,0
1657089841729,MATH 197,004,095571,Perols; Johan Lars,9998,0,9999,1
1657089848786,COGS 9,A01,083615,Shannon; Kyle Michael,7,0,75,68
1657089854812,COGS 11,A01,083617,Boyle; Mary E. T.,21,0,48,27
1657089860837,COGS 13,A01,083071,Bastos; Amalia Pinkusfeld,9,0,71,62
1657089866864,COGS 14A,A01,092681,Semenuks; Arturs,1,1,100,99
1657089872886,COGS 14B,A01,083073,Cheng; Tzu-Han,5,0,63,58
1657089878908,COGS 17,A01,092677,Semenuks; Arturs,4,0,81,77
1657089884935,COGS 100,A01,083619,Allen; Michael Gordon,15,0,70,55
1657089890964,COGS 101A,A01,083621,Davis; Joshua Daniel,9,0,68,59
1657089896989,COGS 101B,A01,091572,Allen; Michael Gordon,8,0,65,57
1657089903010,COGS 101C,A01,083625,Delgado; Tania,17,0,35,18
1657089909033,COGS 107A,A01,083627,Boyle; Mary E. T.,13,0,60,47
1657089915061,COGS 118A,A01,083075,Gupta; Anjum,15,0,76,61
1657089921163,CSE 3,A50,083646,Miranda; Gregory Joseph,22,0,50,28
1657089927188,CSE 8A,A50,083650,Miranda; Gregory Joseph,17,1,56,39
1657089933215,CSE 11,A01,083080,Cao; Yingjun,4,15,40,36
1657089939239,CSE 12,A01,083652,Krause-Levy; Sophia Louisa,23,1,120,97
1657089945262,CSE 15L,A01,083654,Morris; Justin Loren,9,0,50,41
1657089945262,CSE 15L,A02,083655,Morris; Justin Loren,9,0,50,41
1657089951287,CSE 20,A01,083657,Tran; Khoa Dang,37,0,80,43
1657089957313,CSE 21,A01,095574,Bach; Quang Tran,21,0,48,27
1657089963337,CSE 30,A01,083084,Eldon; John,4,0,80,76
1657089963337,CSE 30,B01,095061,Bhaskar; Nishant,6,0,50,44
1657089969359,CSE 100,A01,083659,Cao; Yingjun,3,4,70,67
1657089975386,CSE 134B,A01,083661,Powell; Thomas Allan,19,0,100,81
1657089981412,CSE 140,A01,083663,Gungor; Onat,14,0,85,71
1657089987436,CSE 140L,A01,083088,Eldon; John,16,0,100,84
1657089993462,CSE 175,A01,083665,Kumar; Rakesh,3,0,25,22
1657089999489,CSE 190,A00,092507,Dubnov; Shlomo,7,0,20,13
1657090005517,ECE 45,A01,083139,Congero; Spencer William,5,0,75,70
1657090011544,ECE 65,A50,083695,Saad; Andrew S,12,0,30,18
1657090011544,ECE 65,A51,095125,Saad; Andrew S,25,0,26,1
1657090017568,ECE 109,A01,091882,Touri; Behrouz,16,0,70,54
1657090023596,ECE 180,A00,083140,Abi Samra; Nicholas Camill,1,0,30,29
1657090023596,ECE 180,B00,083141,Abi Samra; Nicholas Camill,0,0,30,30
1657090029625,MATH 10A,A01,083735,Patchell; Gregory David,1,0,30,29
1657090029625,MATH 10A,A02,083736,Patchell; Gregory David,20,0,30,10
1657090029625,MATH 10A,A03,083737,Patchell; Gregory David,16,0,30,14
1657090035649,MATH 10B,A01,083207,Lim; Seonhee,7,0,34,27
1657090035649,MATH 10B,A02,083208,Lim; Seonhee,9,0,35,26
1657090035649,MATH 10B,A03,093472,Lim; Seonhee,5,0,34,29
1657090035649,MATH 10B,B01,083739,Sinha; Shubham,9,0,30,21
1657090041679,MATH 18,A01,083743,Cinel; Cameron Alexander,6,0,30,24
1657090041679,MATH 18,A02,083744,Cinel; Cameron Alexander,15,0,30,15
1657090041679,MATH 18,A03,083745,Cinel; Cameron Alexander,8,0,30,22
1657090041679,MATH 18,B01,083748,Rideout; David Porter,4,0,37,33
1657090041679,MATH 18,B02,083749,Rideout; David Porter,3,0,36,33
1657090041679,MATH 18,B03,083750,Rideout; David Porter,2,0,37,35
1657090041679,MATH 18,B04,083751,Rideout; David Porter,5,0,36,31
1657090041679,MATH 18,B05,093473,Rideout; David Porter,4,0,36,32
1657090041679,MATH 18,B06,093474,Rideout; David Porter,5,0,36,31
1657090047703,MATH 20A,A01,083754,Zheng; Zequn,12,0,40,28
1657090053730,MATH 20B,A01,083756,Briones; Jor-el Thomas Caparas,1,0,36,35
1657090053730,MATH 20B,A02,083757,Briones; Jor-el Thomas Caparas,1,0,36,35
1657090053730,MATH 20B,A03,093475,Briones; Jor-el Thomas Caparas,0,0,36,36
1657090059759,MATH 20C,A01,083760,Briones; Jor-el Thomas Caparas,1,0,35,34
1657090059759,MATH 20C,A02,083761,Briones; Jor-el Thomas Caparas,8,0,35,27
1657090059759,MATH 20C,A03,093476,Briones; Jor-el Thomas Caparas,0,1,36,36
1657090059759,MATH 20C,B01,083762,Bach; Quang Tran,0,0,30,30
1657090065783,MATH 20D,A01,083765,Tran; Brian Kha,4,0,30,26
1657090065783,MATH 20D,A02,083766,Tran; Brian Kha,5,0,30,25
1657090065783,MATH 20D,A03,083767,Tran; Brian Kha,3,0,30,27
1657090071807,MATH 20E,A01,083771,Ganguly; Soumya,6,0,32,26
1657090071807,MATH 20E,A02,083772,Ganguly; Soumya,6,0,32,26
1657090071807,MATH 20E,B01,083773,Ciotti; Benjamin,18,0,35,17
1657090071807,MATH 20E,B02,083774,Ciotti; Benjamin,17,0,35,18
1657090077830,MATH 103A,A01,083777,Greenfeld; Be'Eri,2,0,36,34
1657090077830,MATH 103A,A02,083778,Greenfeld; Be'Eri,5,0,36,31
1657090077830,MATH 103A,A03,093561,Greenfeld; Be'Eri,4,0,36,32
1657090077830,MATH 103A,B01,083779,Greenfeld; Be'Eri,6,0,36,30
1657090077830,MATH 103A,B02,083780,Greenfeld; Be'Eri,2,0,36,34
1657090077830,MATH 103A,B03,093562,Greenfeld; Be'Eri,3,0,36,33
1657090083857,MATH 105,A01,085443,Carter; Anne Toulson,14,0,35,21
1657090083857,MATH 105,A02,093477,Carter; Anne Toulson,20,0,35,15
1657090089885,MATH 109,A01,083213,Ganzberger; Geoffrey Michael,2,0,34,32
1657090089885,MATH 109,A02,083214,Ganzberger; Geoffrey Michael,2,0,34,32
1657090089885,MATH 109,A03,093478,Ganzberger; Geoffrey Michael,1,0,34,33
1657090089885,MATH 109,B01,083215,Ganzberger; Geoffrey Michael,1,0,32,31
1657090089885,MATH 109,B02,083216,Ganzberger; Geoffrey Michael,1,0,32,31
1657090089885,MATH 109,B03,093479,Ganzberger; Geoffrey Michael,6,0,32,26
1657090095909,MATH 142A,A01,083219,Chow; Bennett,6,0,32,26
1657090095909,MATH 142A,A02,083220,Chow; Bennett,10,0,32,22
1657090095909,MATH 142A,A03,093480,Chow; Bennett,7,0,32,25
1657090095909,MATH 142A,B03,093481,Chow; Bennett,8,0,32,24
1657090095909,MATH 142A,B04,093558,Chow; Bennett,11,0,32,21
1657090095909,MATH 142A,B05,093559,Chow; Bennett,6,0,32,26
1657090101932,MATH 193A,A01,083224,Rotar; Vladimir,7,0,34,27
1657090101932,MATH 193A,A02,083225,Rotar; Vladimir,5,0,34,29
1657090101932,MATH 193A,A03,083781,Rotar; Vladimir,1,0,34,33
1657090101932,MATH 193A,A04,083782,Rotar; Vladimir,6,0,34,28
1657090101932,MATH 193A,A05,093482,Rotar; Vladimir,6,0,34,28
1657090107954,MATH 197,001,091859,McAuley; Julian John,9999,0,9999,0
1657090107954,MATH 197,002,095566,Kedlaya; Kiran S.,9997,0,9999,2
1657090107954,MATH 197,003,095567,Xiao; Ming,9999,0,9999,0
1657090107954,MATH 197,004,095571,Perols; Johan Lars,9998,0,9999,1
1657090115022,COGS 9,A01,083615,Shannon; Kyle Michael,7,0,75,68
1657090121044,COGS 11,A01,083617,Boyle; Mary E. T.,21,0,48,27
1657090127068,COGS 13,A01,083071,Bastos; Amalia Pinkusfeld,9,0,71,62
1657090133099,COGS 14A,A01,092681,Semenuks; Arturs,1,1,100,99
1657090139122,COGS 14B,A01,083073,Cheng; Tzu-Han,5,0,63,58
1657090145148,COGS 17,A01,092677,Semenuks; Arturs,4,0,81,77
1657090151176,COGS 100,A01,083619,Allen; Michael Gordon,15,0,70,55
1657090157223,COGS 101A,A01,083621,Davis; Joshua Daniel,9,0,68,59
1657090163246,COGS 101B,A01,091572,Allen; Michael Gordon,8,0,65,57
1657090169268,COGS 101C,A01,083625,Delgado; Tania,17,0,35,18
1657090175291,COGS 107A,A01,083627,Boyle; Mary E. T.,13,0,60,47
1657090181315,COGS 118A,A01,083075,Gupta; Anjum,15,0,76,61
1657090187347,CSE 3,A50,083646,Miranda; Gregory Joseph,22,0,50,28
1657090193374,CSE 8A,A50,083650,Miranda; Gregory Joseph,17,1,56,39
1657090199401,CSE 11,A01,083080,Cao; Yingjun,4,15,40,36
1657090205423,CSE 12,A01,083652,Krause-Levy; Sophia Louisa,23,1,120,97
1657090211452,CSE 15L,A01,083654,Morris; Justin Loren,9,0,50,41
1657090211452,CSE 15L,A02,083655,Morris; Justin Loren,9,0,50,41
1657090217478,CSE 20,A01,083657,Tran; Khoa Dang,37,0,80,43
1657090223502,CSE 21,A01,095574,Bach; Quang Tran,21,0,48,27
1657090229528,CSE 30,A01,083084,Eldon; John,4,0,80,76
1657090229528,CSE 30,B01,095061,Bhaskar; Nishant,6,0,50,44
1657090235554,CSE 100,A01,083659,Cao; Yingjun,3,4,70,67
1657090241578,CSE 134B,A01,083661,Powell; Thomas Allan,19,0,100,81
1657090247601,CSE 140,A01,083663,Gungor; Onat,14,0,85,71
1657090253625,CSE 140L,A01,083088,Eldon; John,16,0,100,84
1657090259648,CSE 175,A01,083665,Kumar; Rakesh,3,0,25,22
1657090265672,CSE 190,A00,092507,Dubnov; Shlomo,7,0,20,13
1657090271712,ECE 45,A01,083139,Congero; Spencer William,5,0,75,70
1657090277739,ECE 65,A50,083695,Saad; Andrew S,12,0,30,18
1657090277739,ECE 65,A51,095125,Saad; Andrew S,25,0,26,1
1657090283765,ECE 109,A01,091882,Touri; Behrouz,16,0,70,54
1657090289792,ECE 180,A00,083140,Abi Samra; Nicholas Camill,1,0,30,29
1657090289792,ECE 180,B00,083141,Abi Samra; Nicholas Camill,0,0,30,30
1657090295816,MATH 10A,A01,083735,Patchell; Gregory David,1,0,30,29
1657090295816,MATH 10A,A02,083736,Patchell; Gregory David,20,0,30,10
1657090295816,MATH 10A,A03,083737,Patchell; Gregory David,16,0,30,14
1657090301844,MATH 10B,A01,083207,Lim; Seonhee,7,0,34,27
1657090301844,MATH 10B,A02,083208,Lim; Seonhee,9,0,35,26
1657090301844,MATH 10B,A03,093472,Lim; Seonhee,5,0,34,29
1657090301844,MATH 10B,B01,083739,Sinha; Shubham,9,0,30,21
1657090307882,MATH 18,A01,083743,Cinel; Cameron Alexander,6,0,30,24
1657090307882,MATH 18,A02,083744,Cinel; Cameron Alexander,15,0,30,15
1657090307882,MATH 18,A03,083745,Cinel; Cameron Alexander,8,0,30,22
1657090307882,MATH 18,B01,083748,Rideout; David Porter,4,0,37,33
1657090307882,MATH 18,B02,083749,Rideout; David Porter,3,0,36,33
1657090307882,MATH 18,B03,083750,Rideout; David Porter,2,0,37,35
1657090307882,MATH 18,B04,083751,Rideout; David Porter,5,0,36,31
1657090307882,MATH 18,B05,093473,Rideout; David Porter,4,0,36,32
1657090307882,MATH 18,B06,093474,Rideout; David Porter,5,0,36,31
1657090313909,MATH 20A,A01,083754,Zheng; Zequn,12,0,40,28
1657090319935,MATH 20B,A01,083756,Briones; Jor-el Thomas Caparas,1,0,36,35
1657090319935,MATH 20B,A02,083757,Briones; Jor-el Thomas Caparas,1,0,36,35
1657090319935,MATH 20B,A03,093475,Briones; Jor-el Thomas Caparas,0,0,36,36
1657090325959,MATH 20C,A01,083760,Briones; Jor-el Thomas Caparas,1,0,35,34
1657090325959,MATH 20C,A02,083761,Briones; Jor-el Thomas Caparas,8,0,35,27
1657090325959,MATH 20C,A03,093476,Briones; Jor-el Thomas Caparas,0,1,36,36
1657090325959,MATH 20C,B01,083762,Bach; Quang Tran,0,0,30,30
1657090331986,MATH 20D,A01,083765,Tran; Brian Kha,4,0,30,26
1657090331986,MATH 20D,A02,083766,Tran; Brian Kha,5,0,30,25
1657090331986,MATH 20D,A03,083767,Tran; Brian Kha,3,0,30,27
1657090338010,MATH 20E,A01,083771,Ganguly; Soumya,6,0,32,26
1657090338010,MATH 20E,A02,083772,Ganguly; Soumya,6,0,32,26
1657090338010,MATH 20E,B01,083773,Ciotti; Benjamin,18,0,35,17
1657090338010,MATH 20E,B02,083774,Ciotti; Benjamin,17,0,35,18
1657090344038,MATH 103A,A01,083777,Greenfeld; Be'Eri,2,0,36,34
1657090344038,MATH 103A,A02,083778,Greenfeld; Be'Eri,5,0,36,31
1657090344038,MATH 103A,A03,093561,Greenfeld; Be'Eri,4,0,36,32
1657090344038,MATH 103A,B01,083779,Greenfeld; Be'Eri,6,0,36,30
1657090344038,MATH 103A,B02,083780,Greenfeld; Be'Eri,2,0,36,34
1657090344038,MATH 103A,B03,093562,Greenfeld; Be'Eri,3,0,36,33
1657090350066,MATH 105,A01,085443,Carter; Anne Toulson,14,0,35,21
1657090350066,MATH 105,A02,093477,Carter; Anne Toulson,20,0,35,15
1657090356089,MATH 109,A01,083213,Ganzberger; Geoffrey Michael,2,0,34,32
1657090356089,MATH 109,A02,083214,Ganzberger; Geoffrey Michael,2,0,34,32
1657090356089,MATH 109,A03,093478,Ganzberger; Geoffrey Michael,1,0,34,33
1657090356089,MATH 109,B01,083215,Ganzberger; Geoffrey Michael,1,0,32,31
1657090356089,MATH 109,B02,083216,Ganzberger; Geoffrey Michael,1,0,32,31
1657090356089,MATH 109,B03,093479,Ganzberger; Geoffrey Michael,6,0,32,26
1657090362124,MATH 142A,A01,083219,Chow; Bennett,6,0,32,26
1657090362124,MATH 142A,A02,083220,Chow; Bennett,10,0,32,22
1657090362124,MATH 142A,A03,093480,Chow; Bennett,7,0,32,25
1657090362124,MATH 142A,B03,093481,Chow; Bennett,8,0,32,24
1657090362124,MATH 142A,B04,093558,Chow; Bennett,11,0,32,21
1657090362124,MATH 142A,B05,093559,Chow; Bennett,6,0,32,26
1657090368149,MATH 193A,A01,083224,Rotar; Vladimir,7,0,34,27
1657090368149,MATH 193A,A02,083225,Rotar; Vladimir,5,0,34,29
1657090368149,MATH 193A,A03,083781,Rotar; Vladimir,1,0,34,33
1657090368149,MATH 193A,A04,083782,Rotar; Vladimir,6,0,34,28
1657090368149,MATH 193A,A05,093482,Rotar; Vladimir,6,0,34,28
1657090374172,MATH 197,001,091859,McAuley; Julian John,9999,0,9999,0
1657090374172,MATH 197,002,095566,Kedlaya; Kiran S.,9997,0,9999,2
1657090374172,MATH 197,003,095567,Xiao; Ming,9999,0,9999,0
1657090374172,MATH 197,004,095571,Perols; Johan Lars,9998,0,9999,1
1657090381237,COGS 9,A01,083615,Shannon; Kyle Michael,7,0,75,68
1657090387262,COGS 11,A01,083617,Boyle; Mary E. T.,21,0,48,27
1657090393288,COGS 13,A01,083071,Bastos; Amalia Pinkusfeld,9,0,71,62
1657090399314,COGS 14A,A01,092681,Semenuks; Arturs,1,1,100,99
1657090405337,COGS 14B,A01,083073,Cheng; Tzu-Han,5,0,63,58
1657090411371,COGS 17,A01,092677,Semenuks; Arturs,4,0,81,77
1657090417399,COGS 100,A01,083619,Allen; Michael Gordon,15,0,70,55
1657090423421,COGS 101A,A01,083621,Davis; Joshua Daniel,9,0,68,59
1657090429442,COGS 101B,A01,091572,Allen; Michael Gordon,8,0,65,57
1657090435468,COGS 101C,A01,083625,Delgado; Tania,17,0,35,18
1657090441492,COGS 107A,A01,083627,Boyle; Mary E. T.,13,0,60,47
1657090447515,COGS 118A,A01,083075,Gupta; Anjum,15,0,76,61
1657090453542,CSE 3,A50,083646,Miranda; Gregory Joseph,22,0,50,28
1657090459571,CSE 8A,A50,083650,Miranda; Gregory Joseph,17,1,56,39
1657090465596,CSE 11,A01,083080,Cao; Yingjun,4,15,40,36
1657090471631,CSE 12,A01,083652,Krause-Levy; Sophia Louisa,23,1,120,97
1657090477656,CSE 15L,A01,083654,Morris; Justin Loren,9,0,50,41
1657090477656,CSE 15L,A02,083655,Morris; Justin Loren,9,0,50,41
1657090483679,CSE 20,A01,083657,Tran; Khoa Dang,37,0,80,43
1657090489706,CSE 21,A01,095574,Bach; Quang Tran,21,0,48,27
1657090495733,CSE 30,A01,083084,Eldon; John,4,0,80,76
1657090495733,CSE 30,B01,095061,Bhaskar; Nishant,6,0,50,44
1657090501762,CSE 100,A01,083659,Cao; Yingjun,3,4,70,67
1657090507788,CSE 134B,A01,083661,Powell; Thomas Allan,19,0,100,81
1657090513811,CSE 140,A01,083663,Gungor; Onat,14,0,85,71
1657090519906,CSE 140L,A01,083088,Eldon; John,16,0,100,84
1657090525930,CSE 175,A01,083665,Kumar; Rakesh,3,0,25,22
1657090531955,CSE 190,A00,092507,Dubnov; Shlomo,7,0,20,13
1657090537981,ECE 45,A01,083139,Congero; Spencer William,5,0,75,70
1657090544005,ECE 65,A50,083695,Saad; Andrew S,12,0,30,18
1657090544005,ECE 65,A51,095125,Saad; Andrew S,25,0,26,1
1657090550029,ECE 109,A01,091882,Touri; Behrouz,16,0,70,54
1657090556053,ECE 180,A00,083140,Abi Samra; Nicholas Camill,1,0,30,29
1657090556053,ECE 180,B00,083141,Abi Samra; Nicholas Camill,0,0,30,30
1657090562080,MATH 10A,A01,083735,Patchell; Gregory David,1,0,30,29
1657090562080,MATH 10A,A02,083736,Patchell; Gregory David,20,0,30,10
1657090562080,MATH 10A,A03,083737,Patchell; Gregory David,16,0,30,14
1657090568109,MATH 10B,A01,083207,Lim; Seonhee,7,0,34,27
1657090568109,MATH 10B,A02,083208,Lim; Seonhee,9,0,35,26
1657090568109,MATH 10B,A03,093472,Lim; Seonhee,5,0,34,29
1657090568109,MATH 10B,B01,083739,Sinha; Shubham,9,0,30,21
1657090574134,MATH 18,A01,083743,Cinel; Cameron Alexander,6,0,30,24
1657090574134,MATH 18,A02,083744,Cinel; Cameron Alexander,15,0,30,15
1657090574134,MATH 18,A03,083745,Cinel; Cameron Alexander,8,0,30,22
1657090574134,MATH 18,B01,083748,Rideout; David Porter,4,0,37,33
1657090574134,MATH 18,B02,083749,Rideout; David Porter,3,0,36,33
1657090574134,MATH 18,B03,083750,Rideout; David Porter,2,0,37,35
1657090574134,MATH 18,B04,083751,Rideout; David Porter,5,0,36,31
1657090574134,MATH 18,B05,093473,Rideout; David Porter,4,0,36,32
1657090574134,MATH 18,B06,093474,Rideout; David Porter,5,0,36,31
1657090580158,MATH 20A,A01,083754,Zheng; Zequn,12,0,40,28
1657090586186,MATH 20B,A01,083756,Briones; Jor-el Thomas Caparas,1,0,36,35
1657090586186,MATH 20B,A02,083757,Briones; Jor-el Thomas Caparas,1,0,36,35
1657090586186,MATH 20B,A03,093475,Briones; Jor-el Thomas Caparas,0,0,36,36
1657090592215,MATH 20C,A01,083760,Briones; Jor-el Thomas Caparas,1,0,35,34
1657090592215,MATH 20C,A02,083761,Briones; Jor-el Thomas Caparas,8,0,35,27
1657090592215,MATH 20C,A03,093476,Briones; Jor-el Thomas Caparas,0,1,36,36
1657090592215,MATH 20C,B01,083762,Bach; Quang Tran,0,0,30,30
1657090598244,MATH 20D,A01,083765,Tran; Brian Kha,4,0,30,26
1657090598244,MATH 20D,A02,083766,Tran; Brian Kha,5,0,30,25
1657090598244,MATH 20D,A03,083767,Tran; Brian Kha,3,0,30,27
1657090604269,MATH 20E,A01,083771,Ganguly; Soumya,6,0,32,26
1657090604269,MATH 20E,A02,083772,Ganguly; Soumya,6,0,32,26
1657090604269,MATH 20E,B01,083773,Ciotti; Benjamin,18,0,35,17
1657090604269,MATH 20E,B02,083774,Ciotti; Benjamin,17,0,35,18
1657090610299,MATH 103A,A01,083777,Greenfeld; Be'Eri,2,0,36,34
1657090610299,MATH 103A,A02,083778,Greenfeld; Be'Eri,5,0,36,31
1657090610299,MATH 103A,A03,093561,Greenfeld; Be'Eri,4,0,36,32
1657090610299,MATH 103A,B01,083779,Greenfeld; Be'Eri,6,0,36,30
1657090610299,MATH 103A,B02,083780,Greenfeld; Be'Eri,2,0,36,34
1657090610299,MATH 103A,B03,093562,Greenfeld; Be'Eri,3,0,36,33
1657090616324,MATH 105,A01,085443,Carter; Anne Toulson,14,0,35,21
1657090616324,MATH 105,A02,093477,Carter; Anne Toulson,20,0,35,15
1657090622348,MATH 109,A01,083213,Ganzberger; Geoffrey Michael,2,0,34,32
1657090622348,MATH 109,A02,083214,Ganzberger; Geoffrey Michael,2,0,34,32
1657090622348,MATH 109,A03,093478,Ganzberger; Geoffrey Michael,1,0,34,33
1657090622348,MATH 109,B01,083215,Ganzberger; Geoffrey Michael,1,0,32,31
1657090622348,MATH 109,B02,083216,Ganzberger; Geoffrey Michael,1,0,32,31
1657090622348,MATH 109,B03,093479,Ganzberger; Geoffrey Michael,6,0,32,26
1657090628374,MATH 142A,A01,083219,Chow; Bennett,6,0,32,26
1657090628374,MATH 142A,A02,083220,Chow; Bennett,10,0,32,22
1657090628374,MATH 142A,A03,093480,Chow; Bennett,7,0,32,25
1657090628374,MATH 142A,B03,093481,Chow; Bennett,8,0,32,24
1657090628374,MATH 142A,B04,093558,Chow; Bennett,11,0,32,21
1657090628374,MATH 142A,B05,093559,Chow; Bennett,6,0,32,26
1657090634398,MATH 193A,A01,083224,Rotar; Vladimir,7,0,34,27
1657090634398,MATH 193A,A02,083225,Rotar; Vladimir,5,0,34,29
1657090634398,MATH 193A,A03,083781,Rotar; Vladimir,1,0,34,33
1657090634398,MATH 193A,A04,083782,Rotar; Vladimir,6,0,34,28
1657090634398,MATH 193A,A05,093482,Rotar; Vladimir,6,0,34,28
1657090640425,MATH 197,001,091859,McAuley; Julian John,9999,0,9999,0
1657090640425,MATH 197,002,095566,Kedlaya; Kiran S.,9997,0,9999,2
1657090640425,MATH 197,003,095567,Xiao; Ming,9999,0,9999,0
1657090640425,MATH 197,004,095571,Perols; Johan Lars,9998,0,9999,1
1657090647488,COGS 9,A01,083615,Shannon; Kyle Michael,7,0,75,68
1657090653515,COGS 11,A01,083617,Boyle; Mary E. T.,21,0,48,27
1657090659539,COGS 13,A01,083071,Bastos; Amalia Pinkusfeld,9,0,71,62
1657090665565,COGS 14A,A01,092681,Semenuks; Arturs,1,1,100,99
1657090671592,COGS 14B,A01,083073,Cheng; Tzu-Han,5,0,63,58
1657090677616,COGS 17,A01,092677,Semenuks; Arturs,4,0,81,77
1657090683641,COGS 100,A01,083619,Allen; Michael Gordon,15,0,70,55
1657090689664,COGS 101A,A01,083621,Davis; Joshua Daniel,9,0,68,59
1657090695686,COGS 101B,A01,091572,Allen; Michael Gordon,8,0,65,57
1657090701712,COGS 101C,A01,083625,Delgado; Tania,17,0,35,18
1657090707736,COGS 107A,A01,083627,Boyle; Mary E. T.,13,0,60,47
1657090713759,COGS 118A,A01,083075,Gupta; Anjum,15,0,76,61
1657090719783,CSE 3,A50,083646,Miranda; Gregory Joseph,22,0,50,28
1657090725807,CSE 8A,A50,083650,Miranda; Gregory Joseph,17,1,56,39
1657090731829,CSE 11,A01,083080,Cao; Yingjun,4,15,40,36
1657090737853,CSE 12,A01,083652,Krause-Levy; Sophia Louisa,23,1,120,97
1657090743880,CSE 15L,A01,083654,Morris; Justin Loren,9,0,50,41
1657090743880,CSE 15L,A02,083655,Morris; Justin Loren,9,0,50,41
1657090749907,CSE 20,A01,083657,Tran; Khoa Dang,37,0,80,43
1657090755929,CSE 21,A01,095574,Bach; Quang Tran,21,0,48,27
1657090761953,CSE 30,A01,083084,Eldon; John,4,0,80,76
1657090761953,CSE 30,B01,095061,Bhaskar; Nishant,6,0,50,44
1657090767976,CSE 100,A01,083659,Cao; Yingjun,3,4,70,67
1657090774000,CSE 134B,A01,083661,Powell; Thomas Allan,19,0,100,81
1657090780026,CSE 140,A01,083663,Gungor; Onat,14,0,85,71
1657090786051,CSE 140L,A01,083088,Eldon; John,16,0,100,84
1657090792077,CSE 175,A01,083665,Kumar; Rakesh,3,0,25,22
1657090798099,CSE 190,A00,092507,Dubnov; Shlomo,7,0,20,13
1657090804125,ECE 45,A01,083139,Congero; Spencer William,5,0,75,70
1657090810148,ECE 65,A50,083695,Saad; Andrew S,12,0,30,18
1657090810148,ECE 65,A51,095125,Saad; Andrew S,25,0,26,1
1657090816172,ECE 109,A01,091882,Touri; Behrouz,16,0,70,54
1657090822201,ECE 180,A00,083140,Abi Samra; Nicholas Camill,1,0,30,29
1657090822201,ECE 180,B00,083141,Abi Samra; Nicholas Camill,0,0,30,30
1657090828223,MATH 10A,A01,083735,Patchell; Gregory David,1,0,30,29
1657090828223,MATH 10A,A02,083736,Patchell; Gregory David,20,0,30,10
1657090828223,MATH 10A,A03,083737,Patchell; Gregory David,16,0,30,14
1657090834247,MATH 10B,A01,083207,Lim; Seonhee,7,0,34,27
1657090834247,MATH 10B,A02,083208,Lim; Seonhee,9,0,35,26
1657090834247,MATH 10B,A03,093472,Lim; Seonhee,5,0,34,29
1657090834247,MATH 10B,B01,083739,Sinha; Shubham,9,0,30,21
1657090840287,MATH 18,A01,083743,Cinel; Cameron Alexander,6,0,30,24
1657090840287,MATH 18,A02,083744,Cinel; Cameron Alexander,15,0,30,15
1657090840287,MATH 18,A03,083745,Cinel; Cameron Alexander,8,0,30,22
1657090840287,MATH 18,B01,083748,Rideout; David Porter,4,0,37,33
1657090840287,MATH 18,B02,083749,Rideout; David Porter,3,0,36,33
1657090840287,MATH 18,B03,083750,Rideout; David Porter,2,0,37,35
1657090840287,MATH 18,B04,083751,Rideout; David Porter,5,0,36,31
1657090840287,MATH 18,B05,093473,Rideout; David Porter,4,0,36,32
1657090840287,MATH 18,B06,093474,Rideout; David Porter,5,0,36,31
1657090846310,MATH 20A,A01,083754,Zheng; Zequn,12,0,40,28
1657090852341,MATH 20B,A01,083756,Briones; Jor-el Thomas Caparas,1,0,36,35
1657090852341,MATH 20B,A02,083757,Briones; Jor-el Thomas Caparas,1,0,36,35
1657090852341,MATH 20B,A03,093475,Briones; Jor-el Thomas Caparas,0,0,36,36
1657090858373,MATH 20C,A01,083760,Briones; Jor-el Thomas Caparas,1,0,35,34
1657090858373,MATH 20C,A02,083761,Briones; Jor-el Thomas Caparas,8,0,35,27
1657090858373,MATH 20C,A03,093476,Briones; Jor-el Thomas Caparas,0,1,36,36
1657090858373,MATH 20C,B01,083762,Bach; Quang Tran,0,0,30,30
1657090864397,MATH 20D,A01,083765,Tran; Brian Kha,4,0,30,26
1657090864397,MATH 20D,A02,083766,Tran; Brian Kha,5,0,30,25
1657090864397,MATH 20D,A03,083767,Tran; Brian Kha,3,0,30,27
1657090870421,MATH 20E,A01,083771,Ganguly; Soumya,6,0,32,26
1657090870421,MATH 20E,A02,083772,Ganguly; Soumya,6,0,32,26
1657090870421,MATH 20E,B01,083773,Ciotti; Benjamin,18,0,35,17
1657090870421,MATH 20E,B02,083774,Ciotti; Benjamin,17,0,35,18
1657090876447,MATH 103A,A01,083777,Greenfeld; Be'Eri,2,0,36,34
1657090876447,MATH 103A,A02,083778,Greenfeld; Be'Eri,5,0,36,31
1657090876447,MATH 103A,A03,093561,Greenfeld; Be'Eri,4,0,36,32
1657090876447,MATH 103A,B01,083779,Greenfeld; Be'Eri,6,0,36,30
1657090876447,MATH 103A,B02,083780,Greenfeld; Be'Eri,2,0,36,34
1657090876447,MATH 103A,B03,093562,Greenfeld; Be'Eri,3,0,36,33
1657090882476,MATH 105,A01,085443,Carter; Anne Toulson,14,0,35,21
1657090882476,MATH 105,A02,093477,Carter; Anne Toulson,20,0,35,15
1657090888507,MATH 109,A01,083213,Ganzberger; Geoffrey Michael,2,0,34,32
1657090888507,MATH 109,A02,083214,Ganzberger; Geoffrey Michael,2,0,34,32
1657090888507,MATH 109,A03,093478,Ganzberger; Geoffrey Michael,1,0,34,33
1657090888507,MATH 109,B01,083215,Ganzberger; Geoffrey Michael,1,0,32,31
1657090888507,MATH 109,B02,083216,Ganzberger; Geoffrey Michael,1,0,32,31
1657090888507,MATH 109,B03,093479,Ganzberger; Geoffrey Michael,6,0,32,26
1657090894532,MATH 142A,A01,083219,Chow; Bennett,6,0,32,26
1657090894532,MATH 142A,A02,083220,Chow; Bennett,10,0,32,22
1657090894532,MATH 142A,A03,093480,Chow; Bennett,7,0,32,25
1657090894532,MATH 142A,B03,093481,Chow; Bennett,8,0,32,24
1657090894532,MATH 142A,B04,093558,Chow; Bennett,11,0,32,21
1657090894532,MATH 142A,B05,093559,Chow; Bennett,6,0,32,26
1657090900556,MATH 193A,A01,083224,Rotar; Vladimir,7,0,34,27
1657090900556,MATH 193A,A02,083225,Rotar; Vladimir,5,0,34,29
1657090900556,MATH 193A,A03,083781,Rotar; Vladimir,1,0,34,33
1657090900556,MATH 193A,A04,083782,Rotar; Vladimir,6,0,34,28
1657090900556,MATH 193A,A05,093482,Rotar; Vladimir,6,0,34,28
1657090906583,MATH 197,001,091859,McAuley; Julian John,9999,0,9999,0
1657090906583,MATH 197,002,095566,Kedlaya; Kiran S.,9997,0,9999,2
1657090906583,MATH 197,003,095567,Xiao; Ming,9999,0,9999,0
1657090906583,MATH 197,004,095571,Perols; Johan Lars,9998,0,9999,1
1657090913660,COGS 9,A01,083615,Shannon; Kyle Michael,7,0,75,68
1657090919689,COGS 11,A01,083617,Boyle; Mary E. T.,21,0,48,27
1657090925711,COGS 13,A01,083071,Bastos; Amalia Pinkusfeld,9,0,71,62
1657090931734,COGS 14A,A01,092681,Semenuks; Arturs,1,1,100,99
1657090937757,COGS 14B,A01,083073,Cheng; Tzu-Han,5,0,63,58
1657090943783,COGS 17,A01,092677,Semenuks; Arturs,4,0,81,77
1657090949810,COGS 100,A01,083619,Allen; Michael Gordon,15,0,70,55
1657090955840,COGS 101A,A01,083621,Davis; Joshua Daniel,9,0,68,59
1657090961871,COGS 101B,A01,091572,Allen; Michael Gordon,8,0,65,57
1657090967898,COGS 101C,A01,083625,Delgado; Tania,17,0,35,18
1657090973928,COGS 107A,A01,083627,Boyle; Mary E. T.,13,0,60,47
1657090979967,COGS 118A,A01,083075,Gupta; Anjum,15,0,76,61
1657090985991,CSE 3,A50,083646,Miranda; Gregory Joseph,22,0,50,28
1657090992022,CSE 8A,A50,083650,Miranda; Gregory Joseph,17,1,56,39
1657090998044,CSE 11,A01,083080,Cao; Yingjun,4,15,40,36
1657091004068,CSE 12,A01,083652,Krause-Levy; Sophia Louisa,23,1,120,97
1657091010091,CSE 15L,A01,083654,Morris; Justin Loren,9,0,50,41
1657091010091,CSE 15L,A02,083655,Morris; Justin Loren,9,0,50,41
1657091016114,CSE 20,A01,083657,Tran; Khoa Dang,37,0,80,43
1657091022137,CSE 21,A01,095574,Bach; Quang Tran,21,0,48,27
1657091028161,CSE 30,A01,083084,Eldon; John,4,0,80,76
1657091028161,CSE 30,B01,095061,Bhaskar; Nishant,6,0,50,44
1657091034189,CSE 100,A01,083659,Cao; Yingjun,4,4,70,66
1657091040227,CSE 134B,A01,083661,Powell; Thomas Allan,19,0,100,81
1657091046254,CSE 140,A01,083663,Gungor; Onat,14,0,85,71
1657091052276,CSE 140L,A01,083088,Eldon; John,16,0,100,84
1657091058318,CSE 175,A01,083665,Kumar; Rakesh,3,0,25,22
1657091064346,CSE 190,A00,092507,Dubnov; Shlomo,7,0,20,13
1657091070375,ECE 45,A01,083139,Congero; Spencer William,5,0,75,70
1657091076399,ECE 65,A50,083695,Saad; Andrew S,12,0,30,18
1657091076399,ECE 65,A51,095125,Saad; Andrew S,25,0,26,1
1657091082421,ECE 109,A01,091882,Touri; Behrouz,16,0,70,54
1657091088444,ECE 180,A00,083140,Abi Samra; Nicholas Camill,1,0,30,29
1657091088444,ECE 180,B00,083141,Abi Samra; Nicholas Camill,0,0,30,30
1657091094469,MATH 10A,A01,083735,Patchell; Gregory David,1,0,30,29
1657091094469,MATH 10A,A02,083736,Patchell; Gregory David,20,0,30,10
1657091094469,MATH 10A,A03,083737,Patchell; Gregory David,16,0,30,14
1657091100493,MATH 10B,A01,083207,Lim; Seonhee,7,0,34,27
1657091100493,MATH 10B,A02,083208,Lim; Seonhee,9,0,35,26
1657091100493,MATH 10B,A03,093472,Lim; Seonhee,5,0,34,29
1657091100493,MATH 10B,B01,083739,Sinha; Shubham,9,0,30,21
1657091106518,MATH 18,A01,083743,Cinel; Cameron Alexander,6,0,30,24
1657091106518,MATH 18,A02,083744,Cinel; Cameron Alexander,15,0,30,15
1657091106518,MATH 18,A03,083745,Cinel; Cameron Alexander,8,0,30,22
1657091106518,MATH 18,B01,083748,Rideout; David Porter,4,0,37,33
1657091106518,MATH 18,B02,083749,Rideout; David Porter,3,0,36,33
1657091106518,MATH 18,B03,083750,Rideout; David Porter,2,0,37,35
1657091106518,MATH 18,B04,083751,Rideout; David Porter,5,0,36,31
1657091106518,MATH 18,B05,093473,Rideout; David Porter,4,0,36,32
1657091106518,MATH 18,B06,093474,Rideout; David Porter,5,0,36,31
1657091112549,MATH 20A,A01,083754,Zheng; Zequn,12,0,40,28
1657091118648,MATH 20B,A01,083756,Briones; Jor-el Thomas Caparas,1,0,36,35
1657091118648,MATH 20B,A02,083757,Briones; Jor-el Thomas Caparas,1,0,36,35
1657091118648,MATH 20B,A03,093475,Briones; Jor-el Thomas Caparas,0,0,36,36
1657091124672,MATH 20C,A01,083760,Briones; Jor-el Thomas Caparas,1,0,35,34
1657091124672,MATH 20C,A02,083761,Briones; Jor-el Thomas Caparas,8,0,35,27
1657091124672,MATH 20C,A03,093476,Briones; Jor-el Thomas Caparas,0,1,36,36
1657091124672,MATH 20C,B01,083762,Bach; Quang Tran,0,0,30,30
1657091130702,MATH 20D,A01,083765,Tran; Brian Kha,4,0,30,26
1657091130702,MATH 20D,A02,083766,Tran; Brian Kha,5,0,30,25
1657091130702,MATH 20D,A03,083767,Tran; Brian Kha,3,0,30,27
1657091136727,MATH 20E,A01,083771,Ganguly; Soumya,6,0,32,26
1657091136727,MATH 20E,A02,083772,Ganguly; Soumya,6,0,32,26
1657091136727,MATH 20E,B01,083773,Ciotti; Benjamin,18,0,35,17
1657091136727,MATH 20E,B02,083774,Ciotti; Benjamin,17,0,35,18
1657091142760,MATH 103A,A01,083777,Greenfeld; Be'Eri,2,0,36,34
1657091142760,MATH 103A,A02,083778,Greenfeld; Be'Eri,5,0,36,31
1657091142760,MATH 103A,A03,093561,Greenfeld; Be'Eri,4,0,36,32
1657091142760,MATH 103A,B01,083779,Greenfeld; Be'Eri,6,0,36,30
1657091142760,MATH 103A,B02,083780,Greenfeld; Be'Eri,2,0,36,34
1657091142760,MATH 103A,B03,093562,Greenfeld; Be'Eri,3,0,36,33
1657091148787,MATH 105,A01,085443,Carter; Anne Toulson,14,0,35,21
1657091148787,MATH 105,A02,093477,Carter; Anne Toulson,20,0,35,15
1657091154812,MATH 109,A01,083213,Ganzberger; Geoffrey Michael,2,0,34,32
1657091154812,MATH 109,A02,083214,Ganzberger; Geoffrey Michael,2,0,34,32
1657091154812,MATH 109,A03,093478,Ganzberger; Geoffrey Michael,1,0,34,33
1657091154812,MATH 109,B01,083215,Ganzberger; Geoffrey Michael,1,0,32,31
1657091154812,MATH 109,B02,083216,Ganzberger; Geoffrey Michael,1,0,32,31
1657091154812,MATH 109,B03,093479,Ganzberger; Geoffrey Michael,6,0,32,26
1657091160843,MATH 142A,A01,083219,Chow; Bennett,6,0,32,26
1657091160843,MATH 142A,A02,083220,Chow; Bennett,10,0,32,22
1657091160843,MATH 142A,A03,093480,Chow; Bennett,7,0,32,25
1657091160843,MATH 142A,B03,093481,Chow; Bennett,8,0,32,24
1657091160843,MATH 142A,B04,093558,Chow; Bennett,11,0,32,21
1657091160843,MATH 142A,B05,093559,Chow; Bennett,6,0,32,26
1657091166869,MATH 193A,A01,083224,Rotar; Vladimir,7,0,34,27
1657091166869,MATH 193A,A02,083225,Rotar; Vladimir,5,0,34,29
1657091166869,MATH 193A,A03,083781,Rotar; Vladimir,1,0,34,33
1657091166869,MATH 193A,A04,083782,Rotar; Vladimir,6,0,34,28
1657091166869,MATH 193A,A05,093482,Rotar; Vladimir,6,0,34,28
1657091172895,MATH 197,001,091859,McAuley; Julian John,9999,0,9999,0
1657091172895,MATH 197,002,095566,Kedlaya; Kiran S.,9997,0,9999,2
1657091172895,MATH 197,003,095567,Xiao; Ming,9999,0,9999,0
1657091172895,MATH 197,004,095571,Perols; Johan Lars,9998,0,9999,1
1657091179968,COGS 9,A01,083615,Shannon; Kyle Michael,7,0,75,68
1657091185993,COGS 11,A01,083617,Boyle; Mary E. T.,21,0,48,27
1657091192021,COGS 13,A01,083071,Bastos; Amalia Pinkusfeld,9,0,71,62
1657091198047,COGS 14A,A01,092681,Semenuks; Arturs,1,1,100,99
1657091204070,COGS 14B,A01,083073,Cheng; Tzu-Han,5,0,63,58
1657091210098,COGS 17,A01,092677,Semenuks; Arturs,4,0,81,77
1657091216122,COGS 100,A01,083619,Allen; Michael Gordon,15,0,70,55
1657091222152,COGS 101A,A01,083621,Davis; Joshua Daniel,9,0,68,59
1657091228174,COGS 101B,A01,091572,Allen; Michael Gordon,8,0,65,57
1657091234203,COGS 101C,A01,083625,Delgado; Tania,17,0,35,18
1657091240230,COGS 107A,A01,083627,Boyle; Mary E. T.,13,0,60,47
1657091246254,COGS 118A,A01,083075,Gupta; Anjum,15,0,76,61
1657091252278,CSE 3,A50,083646,Miranda; Gregory Joseph,22,0,50,28
1657091258307,CSE 8A,A50,083650,Miranda; Gregory Joseph,17,1,56,39
1657091264336,CSE 11,A01,083080,Cao; Yingjun,4,15,40,36
1657091270365,CSE 12,A01,083652,Krause-Levy; Sophia Louisa,23,1,120,97
1657091276394,CSE 15L,A01,083654,Morris; Justin Loren,9,0,50,41
1657091276394,CSE 15L,A02,083655,Morris; Justin Loren,9,0,50,41
1657091282423,CSE 20,A01,083657,Tran; Khoa Dang,37,0,80,43
1657091288452,CSE 21,A01,095574,Bach; Quang Tran,21,0,48,27
1657091294475,CSE 30,A01,083084,Eldon; John,4,0,80,76
1657091294475,CSE 30,B01,095061,Bhaskar; Nishant,6,0,50,44
1657091300499,CSE 100,A01,083659,Cao; Yingjun,4,4,70,66
1657091306525,CSE 134B,A01,083661,Powell; Thomas Allan,19,0,100,81
1657091312551,CSE 140,A01,083663,Gungor; Onat,14,0,85,71
1657091318577,CSE 140L,A01,083088,Eldon; John,16,0,100,84
1657091324601,CSE 175,A01,083665,Kumar; Rakesh,3,0,25,22
1657091330642,CSE 190,A00,092507,Dubnov; Shlomo,7,0,20,13
1657091336664,ECE 45,A01,083139,Congero; Spencer William,5,0,75,70
1657091342687,ECE 65,A50,083695,Saad; Andrew S,12,0,30,18
1657091342687,ECE 65,A51,095125,Saad; Andrew S,25,0,26,1
1657091348711,ECE 109,A01,091882,Touri; Behrouz,16,0,70,54
1657091354738,ECE 180,A00,083140,Abi Samra; Nicholas Camill,1,0,30,29
1657091354738,ECE 180,B00,083141,Abi Samra; Nicholas Camill,0,0,30,30
1657091360762,MATH 10A,A01,083735,Patchell; Gregory David,1,0,30,29
1657091360762,MATH 10A,A02,083736,Patchell; Gregory David,20,0,30,10
1657091360762,MATH 10A,A03,083737,Patchell; Gregory David,16,0,30,14
1657091366786,MATH 10B,A01,083207,Lim; Seonhee,7,0,34,27
1657091366786,MATH 10B,A02,083208,Lim; Seonhee,9,0,35,26
1657091366786,MATH 10B,A03,093472,Lim; Seonhee,5,0,34,29
1657091366786,MATH 10B,B01,083739,Sinha; Shubham,9,0,30,21
1657091372808,MATH 18,A01,083743,Cinel; Cameron Alexander,6,0,30,24
1657091372808,MATH 18,A02,083744,Cinel; Cameron Alexander,15,0,30,15
1657091372808,MATH 18,A03,083745,Cinel; Cameron Alexander,8,0,30,22
1657091372808,MATH 18,B01,083748,Rideout; David Porter,4,0,37,33
1657091372808,MATH 18,B02,083749,Rideout; David Porter,3,0,36,33
1657091372808,MATH 18,B03,083750,Rideout; David Porter,2,0,37,35
1657091372808,MATH 18,B04,083751,Rideout; David Porter,5,0,36,31
1657091372808,MATH 18,B05,093473,Rideout; David Porter,4,0,36,32
1657091372808,MATH 18,B06,093474,Rideout; David Porter,5,0,36,31
1657091378836,MATH 20A,A01,083754,Zheng; Zequn,12,0,40,28
1657091384874,MATH 20B,A01,083756,Briones; Jor-el Thomas Caparas,1,0,36,35
1657091384874,MATH 20B,A02,083757,Briones; Jor-el Thomas Caparas,1,0,36,35
1657091384874,MATH 20B,A03,093475,Briones; Jor-el Thomas Caparas,0,0,36,36
1657091390902,MATH 20C,A01,083760,Briones; Jor-el Thomas Caparas,1,0,35,34
1657091390902,MATH 20C,A02,083761,Briones; Jor-el Thomas Caparas,8,0,35,27
1657091390902,MATH 20C,A03,093476,Briones; Jor-el Thomas Caparas,0,1,36,36
1657091390902,MATH 20C,B01,083762,Bach; Quang Tran,0,0,30,30
1657091396934,MATH 20D,A01,083765,Tran; Brian Kha,4,0,30,26
1657091396934,MATH 20D,A02,083766,Tran; Brian Kha,5,0,30,25
1657091396934,MATH 20D,A03,083767,Tran; Brian Kha,3,0,30,27
1657091402962,MATH 20E,A01,083771,Ganguly; Soumya,6,0,32,26
1657091402962,MATH 20E,A02,083772,Ganguly; Soumya,6,0,32,26
1657091402962,MATH 20E,B01,083773,Ciotti; Benjamin,18,0,35,17
1657091402962,MATH 20E,B02,083774,Ciotti; Benjamin,17,0,35,18
1657091408987,MATH 103A,A01,083777,Greenfeld; Be'Eri,2,0,36,34
1657091408987,MATH 103A,A02,083778,Greenfeld; Be'Eri,5,0,36,31
1657091408987,MATH 103A,A03,093561,Greenfeld; Be'Eri,4,0,36,32
1657091408987,MATH 103A,B01,083779,Greenfeld; Be'Eri,6,0,36,30
1657091408987,MATH 103A,B02,083780,Greenfeld; Be'Eri,2,0,36,34
1657091408987,MATH 103A,B03,093562,Greenfeld; Be'Eri,3,0,36,33
1657091415009,MATH 105,A01,085443,Carter; Anne Toulson,14,0,35,21
1657091415009,MATH 105,A02,093477,Carter; Anne Toulson,20,0,35,15
1657091421035,MATH 109,A01,083213,Ganzberger; Geoffrey Michael,2,0,34,32
1657091421035,MATH 109,A02,083214,Ganzberger; Geoffrey Michael,2,0,34,32
1657091421035,MATH 109,A03,093478,Ganzberger; Geoffrey Michael,1,0,34,33
1657091421035,MATH 109,B01,083215,Ganzberger; Geoffrey Michael,1,0,32,31
1657091421035,MATH 109,B02,083216,Ganzberger; Geoffrey Michael,1,0,32,31
1657091421035,MATH 109,B03,093479,Ganzberger; Geoffrey Michael,6,0,32,26
1657091427069,MATH 142A,A01,083219,Chow; Bennett,6,0,32,26
1657091427069,MATH 142A,A02,083220,Chow; Bennett,10,0,32,22
1657091427069,MATH 142A,A03,093480,Chow; Bennett,7,0,32,25
1657091427069,MATH 142A,B03,093481,Chow; Bennett,8,0,32,24
1657091427069,MATH 142A,B04,093558,Chow; Bennett,11,0,32,21
1657091427069,MATH 142A,B05,093559,Chow; Bennett,6,0,32,26
1657091433097,MATH 193A,A01,083224,Rotar; Vladimir,7,0,34,27
1657091433097,MATH 193A,A02,083225,Rotar; Vladimir,5,0,34,29
1657091433097,MATH 193A,A03,083781,Rotar; Vladimir,1,0,34,33
1657091433097,MATH 193A,A04,083782,Rotar; Vladimir,6,0,34,28
1657091433097,MATH 193A,A05,093482,Rotar; Vladimir,6,0,34,28
1657091439124,MATH 197,001,091859,McAuley; Julian John,9999,0,9999,0
1657091439124,MATH 197,002,095566,Kedlaya; Kiran S.,9997,0,9999,2
1657091439124,MATH 197,003,095567,Xiao; Ming,9999,0,9999,0
1657091439124,MATH 197,004,095571,Perols; Johan Lars,9998,0,9999,1
1657091446176,COGS 9,A01,083615,Shannon; Kyle Michael,7,0,75,68
1657091452205,COGS 11,A01,083617,Boyle; Mary E. T.,21,0,48,27
1657091458232,COGS 13,A01,083071,Bastos; Amalia Pinkusfeld,9,0,71,62
1657091464257,COGS 14A,A01,092681,Semenuks; Arturs,1,1,100,99
1657091470287,COGS 14B,A01,083073,Cheng; Tzu-Han,6,0,63,57
1657091476329,COGS 17,A01,092677,Semenuks; Arturs,4,0,81,77
1657091482358,COGS 100,A01,083619,Allen; Michael Gordon,15,0,70,55
1657091488389,COGS 101A,A01,083621,Davis; Joshua Daniel,9,0,68,59
1657091494418,COGS 101B,A01,091572,Allen; Michael Gordon,8,0,65,57
1657091500442,COGS 101C,A01,083625,Delgado; Tania,17,0,35,18
1657091506473,COGS 107A,A01,083627,Boyle; Mary E. T.,13,0,60,47
1657091512498,COGS 118A,A01,083075,Gupta; Anjum,15,0,76,61
1657091518534,CSE 3,A50,083646,Miranda; Gregory Joseph,22,0,50,28
1657091524569,CSE 8A,A50,083650,Miranda; Gregory Joseph,17,1,56,39
1657091530596,CSE 11,A01,083080,Cao; Yingjun,4,15,40,36
1657091536636,CSE 12,A01,083652,Krause-Levy; Sophia Louisa,23,1,120,97
1657091542663,CSE 15L,A01,083654,Morris; Justin Loren,9,0,50,41
1657091542663,CSE 15L,A02,083655,Morris; Justin Loren,9,0,50,41
1657091548688,CSE 20,A01,083657,Tran; Khoa Dang,37,0,80,43
1657091554714,CSE 21,A01,095574,Bach; Quang Tran,21,0,48,27
1657091560738,CSE 30,A01,083084,Eldon; John,4,0,80,76
1657091560738,CSE 30,B01,095061,Bhaskar; Nishant,6,0,50,44
1657091566765,CSE 100,A01,083659,Cao; Yingjun,4,4,70,66
1657091572788,CSE 134B,A01,083661,Powell; Thomas Allan,19,0,100,81
1657091578813,CSE 140,A01,083663,Gungor; Onat,14,0,85,71
1657091584837,CSE 140L,A01,083088,Eldon; John,16,0,100,84
1657091590861,CSE 175,A01,083665,Kumar; Rakesh,3,0,25,22
1657091596886,CSE 190,A00,092507,Dubnov; Shlomo,7,0,20,13
1657091602918,ECE 45,A01,083139,Congero; Spencer William,5,0,75,70
1657091608947,ECE 65,A50,083695,Saad; Andrew S,12,0,30,18
1657091608947,ECE 65,A51,095125,Saad; Andrew S,25,0,26,1
1657091614971,ECE 109,A01,091882,Touri; Behrouz,16,0,70,54
1657091620999,ECE 180,A00,083140,Abi Samra; Nicholas Camill,1,0,30,29
1657091620999,ECE 180,B00,083141,Abi Samra; Nicholas Camill,0,0,30,30
1657091627035,MATH 10A,A01,083735,Patchell; Gregory David,1,0,30,29
1657091627035,MATH 10A,A02,083736,Patchell; Gregory David,20,0,30,10
1657091627035,MATH 10A,A03,083737,Patchell; Gregory David,16,0,30,14
1657091633068,MATH 10B,A01,083207,Lim; Seonhee,7,0,34,27
1657091633068,MATH 10B,A02,083208,Lim; Seonhee,9,0,35,26
1657091633068,MATH 10B,A03,093472,Lim; Seonhee,5,0,34,29
1657091633068,MATH 10B,B01,083739,Sinha; Shubham,9,0,30,21
1657091639102,MATH 18,A01,083743,Cinel; Cameron Alexander,6,0,30,24
1657091639102,MATH 18,A02,083744,Cinel; Cameron Alexander,15,0,30,15
1657091639102,MATH 18,A03,083745,Cinel; Cameron Alexander,8,0,30,22
1657091639102,MATH 18,B01,083748,Rideout; David Porter,4,0,37,33
1657091639102,MATH 18,B02,083749,Rideout; David Porter,3,0,36,33
1657091639102,MATH 18,B03,083750,Rideout; David Porter,2,0,37,35
1657091639102,MATH 18,B04,083751,Rideout; David Porter,5,0,36,31
1657091639102,MATH 18,B05,093473,Rideout; David Porter,4,0,36,32
1657091639102,MATH 18,B06,093474,Rideout; David Porter,5,0,36,31
1657091645126,MATH 20A,A01,083754,Zheng; Zequn,12,0,40,28
1657091651149,MATH 20B,A01,083756,Briones; Jor-el Thomas Caparas,1,0,36,35
1657091651149,MATH 20B,A02,083757,Briones; Jor-el Thomas Caparas,1,0,36,35
1657091651149,MATH 20B,A03,093475,Briones; Jor-el Thomas Caparas,0,0,36,36
1657091657173,MATH 20C,A01,083760,Briones; Jor-el Thomas Caparas,1,0,35,34
1657091657173,MATH 20C,A02,083761,Briones; Jor-el Thomas Caparas,8,0,35,27
1657091657173,MATH 20C,A03,093476,Briones; Jor-el Thomas Caparas,0,1,36,36
1657091657173,MATH 20C,B01,083762,Bach; Quang Tran,0,0,30,30
1657091663205,MATH 20D,A01,083765,Tran; Brian Kha,4,0,30,26
1657091663205,MATH 20D,A02,083766,Tran; Brian Kha,5,0,30,25
1657091663205,MATH 20D,A03,083767,Tran; Brian Kha,3,0,30,27
1657091669230,MATH 20E,A01,083771,Ganguly; Soumya,6,0,32,26
1657091669230,MATH 20E,A02,083772,Ganguly; Soumya,6,0,32,26
1657091669230,MATH 20E,B01,083773,Ciotti; Benjamin,18,0,35,17
1657091669230,MATH 20E,B02,083774,Ciotti; Benjamin,17,0,35,18
1657091675252,MATH 103A,A01,083777,Greenfeld; Be'Eri,2,0,36,34
1657091675252,MATH 103A,A02,083778,Greenfeld; Be'Eri,5,0,36,31
1657091675252,MATH 103A,A03,093561,Greenfeld; Be'Eri,4,0,36,32
1657091675252,MATH 103A,B01,083779,Greenfeld; Be'Eri,6,0,36,30
1657091675252,MATH 103A,B02,083780,Greenfeld; Be'Eri,2,0,36,34
1657091675252,MATH 103A,B03,093562,Greenfeld; Be'Eri,3,0,36,33
1657091681282,MATH 105,A01,085443,Carter; Anne Toulson,14,0,35,21
1657091681282,MATH 105,A02,093477,Carter; Anne Toulson,20,0,35,15
1657091687312,MATH 109,A01,083213,Ganzberger; Geoffrey Michael,2,0,34,32
1657091687312,MATH 109,A02,083214,Ganzberger; Geoffrey Michael,3,0,34,31
1657091687312,MATH 109,A03,093478,Ganzberger; Geoffrey Michael,1,0,34,33
1657091687312,MATH 109,B01,083215,Ganzberger; Geoffrey Michael,1,0,32,31
1657091687312,MATH 109,B02,083216,Ganzberger; Geoffrey Michael,1,0,32,31
1657091687312,MATH 109,B03,093479,Ganzberger; Geoffrey Michael,6,0,32,26
1657091693336,MATH 142A,A01,083219,Chow; Bennett,6,0,32,26
1657091693336,MATH 142A,A02,083220,Chow; Bennett,10,0,32,22
1657091693336,MATH 142A,A03,093480,Chow; Bennett,7,0,32,25
1657091693336,MATH 142A,B03,093481,Chow; Bennett,8,0,32,24
1657091693336,MATH 142A,B04,093558,Chow; Bennett,11,0,32,21
1657091693336,MATH 142A,B05,093559,Chow; Bennett,6,0,32,26
1657091699373,MATH 193A,A01,083224,Rotar; Vladimir,7,0,34,27
1657091699373,MATH 193A,A02,083225,Rotar; Vladimir,5,0,34,29
1657091699373,MATH 193A,A03,083781,Rotar; Vladimir,1,0,34,33
1657091699373,MATH 193A,A04,083782,Rotar; Vladimir,6,0,34,28
1657091699373,MATH 193A,A05,093482,Rotar; Vladimir,6,0,34,28
1657091705396,MATH 197,001,091859,McAuley; Julian John,9999,0,9999,0
1657091705396,MATH 197,002,095566,Kedlaya; Kiran S.,9997,0,9999,2
1657091705396,MATH 197,003,095567,Xiao; Ming,9999,0,9999,0
1657091705396,MATH 197,004,095571,Perols; Johan Lars,9998,0,9999,1
1657091712563,COGS 9,A01,083615,Shannon; Kyle Michael,7,0,75,68
1657091718589,COGS 11,A01,083617,Boyle; Mary E. T.,21,0,48,27
1657091724617,COGS 13,A01,083071,Bastos; Amalia Pinkusfeld,9,0,71,62
1657091730640,COGS 14A,A01,092681,Semenuks; Arturs,1,1,100,99
1657091736667,COGS 14B,A01,083073,Cheng; Tzu-Han,6,0,63,57
1657091742697,COGS 17,A01,092677,Semenuks; Arturs,4,0,81,77
1657091748727,COGS 100,A01,083619,Allen; Michael Gordon,15,0,70,55
1657091754752,COGS 101A,A01,083621,Davis; Joshua Daniel,9,0,68,59
1657091760775,COGS 101B,A01,091572,Allen; Michael Gordon,8,0,65,57
1657091766806,COGS 101C,A01,083625,Delgado; Tania,17,0,35,18
1657091772830,COGS 107A,A01,083627,Boyle; Mary E. T.,13,0,60,47
1657091778855,COGS 118A,A01,083075,Gupta; Anjum,15,0,76,61
1657091784887,CSE 3,A50,083646,Miranda; Gregory Joseph,22,0,50,28
1657091790915,CSE 8A,A50,083650,Miranda; Gregory Joseph,17,1,56,39
1657091796939,CSE 11,A01,083080,Cao; Yingjun,4,15,40,36
1657091802966,CSE 12,A01,083652,Krause-Levy; Sophia Louisa,23,1,120,97
1657091808997,CSE 15L,A01,083654,Morris; Justin Loren,9,0,50,41
1657091808997,CSE 15L,A02,083655,Morris; Justin Loren,9,0,50,41
1657091815022,CSE 20,A01,083657,Tran; Khoa Dang,37,0,80,43
1657091821046,CSE 21,A01,095574,Bach; Quang Tran,21,0,48,27
1657091827074,CSE 30,A01,083084,Eldon; John,4,0,80,76
1657091827074,CSE 30,B01,095061,Bhaskar; Nishant,6,0,50,44
1657091833098,CSE 100,A01,083659,Cao; Yingjun,4,4,70,66
1657091839124,CSE 134B,A01,083661,Powell; Thomas Allan,19,0,100,81
1657091845151,CSE 140,A01,083663,Gungor; Onat,14,0,85,71
1657091851185,CSE 140L,A01,083088,Eldon; John,16,0,100,84
1657091857207,CSE 175,A01,083665,Kumar; Rakesh,3,0,25,22
1657091863233,CSE 190,A00,092507,Dubnov; Shlomo,7,0,20,13
1657091869257,ECE 45,A01,083139,Congero; Spencer William,5,0,75,70
1657091875288,ECE 65,A50,083695,Saad; Andrew S,12,0,30,18
1657091875288,ECE 65,A51,095125,Saad; Andrew S,25,0,26,1
1657091881323,ECE 109,A01,091882,Touri; Behrouz,16,0,70,54
1657091887356,ECE 180,A00,083140,Abi Samra; Nicholas Camill,1,0,30,29
1657091887356,ECE 180,B00,083141,Abi Samra; Nicholas Camill,0,0,30,30
1657091893382,MATH 10A,A01,083735,Patchell; Gregory David,1,0,30,29
1657091893382,MATH 10A,A02,083736,Patchell; Gregory David,20,0,30,10
1657091893382,MATH 10A,A03,083737,Patchell; Gregory David,16,0,30,14
1657091899410,MATH 10B,A01,083207,Lim; Seonhee,7,0,34,27
1657091899410,MATH 10B,A02,083208,Lim; Seonhee,9,0,35,26
1657091899410,MATH 10B,A03,093472,Lim; Seonhee,5,0,34,29
1657091899410,MATH 10B,B01,083739,Sinha; Shubham,9,0,30,21
1657091905497,MATH 18,A01,083743,Cinel; Cameron Alexander,6,0,30,24
1657091905497,MATH 18,A02,083744,Cinel; Cameron Alexander,15,0,30,15
1657091905497,MATH 18,A03,083745,Cinel; Cameron Alexander,8,0,30,22
1657091905497,MATH 18,B01,083748,Rideout; David Porter,4,0,37,33
1657091905497,MATH 18,B02,083749,Rideout; David Porter,3,0,36,33
1657091905497,MATH 18,B03,083750,Rideout; David Porter,2,0,37,35
1657091905497,MATH 18,B04,083751,Rideout; David Porter,5,0,36,31
1657091905497,MATH 18,B05,093473,Rideout; David Porter,4,0,36,32
1657091905497,MATH 18,B06,093474,Rideout; David Porter,5,0,36,31
1657091911537,MATH 20A,A01,083754,Zheng; Zequn,12,0,40,28
1657091917563,MATH 20B,A01,083756,Briones; Jor-el Thomas Caparas,1,0,36,35
1657091917563,MATH 20B,A02,083757,Briones; Jor-el Thomas Caparas,1,0,36,35
1657091917563,MATH 20B,A03,093475,Briones; Jor-el Thomas Caparas,0,0,36,36
1657091923596,MATH 20C,A01,083760,Briones; Jor-el Thomas Caparas,1,0,35,34
1657091923596,MATH 20C,A02,083761,Briones; Jor-el Thomas Caparas,8,0,35,27
1657091923596,MATH 20C,A03,093476,Briones; Jor-el Thomas Caparas,0,1,36,36
1657091923596,MATH 20C,B01,083762,Bach; Quang Tran,0,0,30,30
1657091929619,MATH 20D,A01,083765,Tran; Brian Kha,4,0,30,26
1657091929619,MATH 20D,A02,083766,Tran; Brian Kha,5,0,30,25
1657091929619,MATH 20D,A03,083767,Tran; Brian Kha,3,0,30,27
1657091935645,MATH 20E,A01,083771,Ganguly; Soumya,6,0,32,26
1657091935645,MATH 20E,A02,083772,Ganguly; Soumya,6,0,32,26
1657091935645,MATH 20E,B01,083773,Ciotti; Benjamin,18,0,35,17
1657091935645,MATH 20E,B02,083774,Ciotti; Benjamin,17,0,35,18
1657091941678,MATH 103A,A01,083777,Greenfeld; Be'Eri,2,0,36,34
1657091941678,MATH 103A,A02,083778,Greenfeld; Be'Eri,5,0,36,31
1657091941678,MATH 103A,A03,093561,Greenfeld; Be'Eri,4,0,36,32
1657091941678,MATH 103A,B01,083779,Greenfeld; Be'Eri,6,0,36,30
1657091941678,MATH 103A,B02,083780,Greenfeld; Be'Eri,2,0,36,34
1657091941678,MATH 103A,B03,093562,Greenfeld; Be'Eri,3,0,36,33
1657091947707,MATH 105,A01,085443,Carter; Anne Toulson,14,0,35,21
1657091947707,MATH 105,A02,093477,Carter; Anne Toulson,20,0,35,15
1657091953738,MATH 109,A01,083213,Ganzberger; Geoffrey Michael,2,0,34,32
1657091953738,MATH 109,A02,083214,Ganzberger; Geoffrey Michael,3,0,34,31
1657091953738,MATH 109,A03,093478,Ganzberger; Geoffrey Michael,1,0,34,33
1657091953738,MATH 109,B01,083215,Ganzberger; Geoffrey Michael,1,0,32,31
1657091953738,MATH 109,B02,083216,Ganzberger; Geoffrey Michael,1,0,32,31
1657091953738,MATH 109,B03,093479,Ganzberger; Geoffrey Michael,6,0,32,26
1657091959763,MATH 142A,A01,083219,Chow; Bennett,6,0,32,26
1657091959763,MATH 142A,A02,083220,Chow; Bennett,10,0,32,22
1657091959763,MATH 142A,A03,093480,Chow; Bennett,7,0,32,25
1657091959763,MATH 142A,B03,093481,Chow; Bennett,8,0,32,24
1657091959763,MATH 142A,B04,093558,Chow; Bennett,11,0,32,21
1657091959763,MATH 142A,B05,093559,Chow; Bennett,6,0,32,26
1657091965793,MATH 193A,A01,083224,Rotar; Vladimir,7,0,34,27
1657091965793,MATH 193A,A02,083225,Rotar; Vladimir,5,0,34,29
1657091965793,MATH 193A,A03,083781,Rotar; Vladimir,1,0,34,33
1657091965793,MATH 193A,A04,083782,Rotar; Vladimir,6,0,34,28
1657091965793,MATH 193A,A05,093482,Rotar; Vladimir,6,0,34,28
1657091971822,MATH 197,001,091859,McAuley; Julian John,9999,0,9999,0
1657091971822,MATH 197,002,095566,Kedlaya; Kiran S.,9997,0,9999,2
1657091971822,MATH 197,003,095567,Xiao; Ming,9999,0,9999,0
1657091971822,MATH 197,004,095571,Perols; Johan Lars,9998,0,9999,1
1657091978896,COGS 9,A01,083615,Shannon; Kyle Michael,7,0,75,68
1657091984926,COGS 11,A01,083617,Boyle; Mary E. T.,21,0,48,27
1657091990958,COGS 13,A01,083071,Bastos; Amalia Pinkusfeld,9,0,71,62
1657091996983,COGS 14A,A01,092681,Semenuks; Arturs,1,1,100,99
1657092003007,COGS 14B,A01,083073,Cheng; Tzu-Han,6,0,63,57
1657092009031,COGS 17,A01,092677,Semenuks; Arturs,4,0,81,77
1657092015057,COGS 100,A01,083619,Allen; Michael Gordon,15,0,70,55
1657092021084,COGS 101A,A01,083621,Davis; Joshua Daniel,9,0,68,59
1657092027108,COGS 101B,A01,091572,Allen; Michael Gordon,8,0,65,57
1657092033141,COGS 101C,A01,083625,Delgado; Tania,17,0,35,18
1657092039172,COGS 107A,A01,083627,Boyle; Mary E. T.,13,0,60,47
1657092045209,COGS 118A,A01,083075,Gupta; Anjum,15,0,76,61
1657092051239,CSE 3,A50,083646,Miranda; Gregory Joseph,22,0,50,28
1657092057264,CSE 8A,A50,083650,Miranda; Gregory Joseph,17,1,56,39
1657092063292,CSE 11,A01,083080,Cao; Yingjun,4,15,40,36
1657092069316,CSE 12,A01,083652,Krause-Levy; Sophia Louisa,23,1,120,97
1657092075339,CSE 15L,A01,083654,Morris; Justin Loren,9,0,50,41
1657092075339,CSE 15L,A02,083655,Morris; Justin Loren,9,0,50,41
1657092081365,CSE 20,A01,083657,Tran; Khoa Dang,37,0,80,43
1657092087389,CSE 21,A01,095574,Bach; Quang Tran,21,0,48,27
1657092093413,CSE 30,A01,083084,Eldon; John,4,0,80,76
1657092093413,CSE 30,B01,095061,Bhaskar; Nishant,6,0,50,44
1657092099446,CSE 100,A01,083659,Cao; Yingjun,4,4,70,66
1657092105473,CSE 134B,A01,083661,Powell; Thomas Allan,19,0,100,81
1657092111501,CSE 140,A01,083663,Gungor; Onat,14,0,85,71
1657092117526,CSE 140L,A01,083088,Eldon; John,16,0,100,84
1657092123554,CSE 175,A01,083665,Kumar; Rakesh,3,0,25,22
1657092129577,CSE 190,A00,092507,Dubnov; Shlomo,7,0,20,13
1657092135601,ECE 45,A01,083139,Congero; Spencer William,5,0,75,70
1657092141632,ECE 65,A50,083695,Saad; Andrew S,12,0,30,18
1657092141632,ECE 65,A51,095125,Saad; Andrew S,25,0,26,1
1657092147663,ECE 109,A01,091882,Touri; Behrouz,16,0,70,54
1657092153689,ECE 180,A00,083140,Abi Samra; Nicholas Camill,1,0,30,29
1657092153689,ECE 180,B00,083141,Abi Samra; Nicholas Camill,0,0,30,30
1657092159726,MATH 10A,A01,083735,Patchell; Gregory David,1,0,30,29
1657092159726,MATH 10A,A02,083736,Patchell; Gregory David,20,0,30,10
1657092159726,MATH 10A,A03,083737,Patchell; Gregory David,16,0,30,14
1657092165754,MATH 10B,A01,083207,Lim; Seonhee,7,0,34,27
1657092165754,MATH 10B,A02,083208,Lim; Seonhee,9,0,35,26
1657092165754,MATH 10B,A03,093472,Lim; Seonhee,5,0,34,29
1657092165754,MATH 10B,B01,083739,Sinha; Shubham,9,0,30,21
1657092171781,MATH 18,A01,083743,Cinel; Cameron Alexander,6,0,30,24
1657092171781,MATH 18,A02,083744,Cinel; Cameron Alexander,15,0,30,15
1657092171781,MATH 18,A03,083745,Cinel; Cameron Alexander,8,0,30,22
1657092171781,MATH 18,B01,083748,Rideout; David Porter,4,0,37,33
1657092171781,MATH 18,B02,083749,Rideout; David Porter,3,0,36,33
1657092171781,MATH 18,B03,083750,Rideout; David Porter,2,0,37,35
1657092171781,MATH 18,B04,083751,Rideout; David Porter,5,0,36,31
1657092171781,MATH 18,B05,093473,Rideout; David Porter,4,0,36,32
1657092171781,MATH 18,B06,093474,Rideout; David Porter,5,0,36,31
1657092177804,MATH 20A,A01,083754,Zheng; Zequn,12,0,40,28
1657092183832,MATH 20B,A01,083756,Briones; Jor-el Thomas Caparas,1,0,36,35
1657092183832,MATH 20B,A02,083757,Briones; Jor-el Thomas Caparas,1,0,36,35
1657092183832,MATH 20B,A03,093475,Briones; Jor-el Thomas Caparas,0,0,36,36
1657092189855,MATH 20C,A01,083760,Briones; Jor-el Thomas Caparas,1,0,35,34
1657092189855,MATH 20C,A02,083761,Briones; Jor-el Thomas Caparas,8,0,35,27
1657092189855,MATH 20C,A03,093476,Briones; Jor-el Thomas Caparas,0,1,36,36
1657092189855,MATH 20C,B01,083762,Bach; Quang Tran,0,0,30,30
1657092195880,MATH 20D,A01,083765,Tran; Brian Kha,4,0,30,26
1657092195880,MATH 20D,A02,083766,Tran; Brian Kha,5,0,30,25
1657092195880,MATH 20D,A03,083767,Tran; Brian Kha,3,0,30,27
1657092201904,MATH 20E,A01,083771,Ganguly; Soumya,6,0,32,26
1657092201904,MATH 20E,A02,083772,Ganguly; Soumya,6,0,32,26
1657092201904,MATH 20E,B01,083773,Ciotti; Benjamin,18,0,35,17
1657092201904,MATH 20E,B02,083774,Ciotti; Benjamin,17,0,35,18
1657092207930,MATH 103A,A01,083777,Greenfeld; Be'Eri,2,0,36,34
1657092207930,MATH 103A,A02,083778,Greenfeld; Be'Eri,5,0,36,31
1657092207930,MATH 103A,A03,093561,Greenfeld; Be'Eri,4,0,36,32
1657092207930,MATH 103A,B01,083779,Greenfeld; Be'Eri,6,0,36,30
1657092207930,MATH 103A,B02,083780,Greenfeld; Be'Eri,2,0,36,34
1657092207930,MATH 103A,B03,093562,Greenfeld; Be'Eri,3,0,36,33
1657092213954,MATH 105,A01,085443,Carter; Anne Toulson,14,0,35,21
1657092213954,MATH 105,A02,093477,Carter; Anne Toulson,20,0,35,15
1657092219979,MATH 109,A01,083213,Ganzberger; Geoffrey Michael,2,0,34,32
1657092219979,MATH 109,A02,083214,Ganzberger; Geoffrey Michael,3,0,34,31
1657092219979,MATH 109,A03,093478,Ganzberger; Geoffrey Michael,1,0,34,33
1657092219979,MATH 109,B01,083215,Ganzberger; Geoffrey Michael,1,0,32,31
1657092219979,MATH 109,B02,083216,Ganzberger; Geoffrey Michael,1,0,32,31
1657092219979,MATH 109,B03,093479,Ganzberger; Geoffrey Michael,6,0,32,26
1657092226004,MATH 142A,A01,083219,Chow; Bennett,6,0,32,26
1657092226004,MATH 142A,A02,083220,Chow; Bennett,10,0,32,22
1657092226004,MATH 142A,A03,093480,Chow; Bennett,7,0,32,25
1657092226004,MATH 142A,B03,093481,Chow; Bennett,8,0,32,24
1657092226004,MATH 142A,B04,093558,Chow; Bennett,11,0,32,21
1657092226004,MATH 142A,B05,093559,Chow; Bennett,6,0,32,26
1657092232029,MATH 193A,A01,083224,Rotar; Vladimir,7,0,34,27
1657092232029,MATH 193A,A02,083225,Rotar; Vladimir,5,0,34,29
1657092232029,MATH 193A,A03,083781,Rotar; Vladimir,1,0,34,33
1657092232029,MATH 193A,A04,083782,Rotar; Vladimir,6,0,34,28
1657092232029,MATH 193A,A05,093482,Rotar; Vladimir,6,0,34,28
1657092238055,MATH 197,001,091859,McAuley; Julian John,9999,0,9999,0
1657092238055,MATH 197,002,095566,Kedlaya; Kiran S.,9997,0,9999,2
1657092238055,MATH 197,003,095567,Xiao; Ming,9999,0,9999,0
1657092238055,MATH 197,004,095571,Perols; Johan Lars,9998,0,9999,1
1657092245128,COGS 9,A01,083615,Shannon; Kyle Michael,7,0,75,68
1657092251158,COGS 11,A01,083617,Boyle; Mary E. T.,21,0,48,27
1657092257188,COGS 13,A01,083071,Bastos; Amalia Pinkusfeld,9,0,71,62
1657092263212,COGS 14A,A01,092681,Semenuks; Arturs,1,1,100,99
1657092269241,COGS 14B,A01,083073,Cheng; Tzu-Han,6,0,63,57
1657092275267,COGS 17,A01,092677,Semenuks; Arturs,4,0,81,77
1657092281293,COGS 100,A01,083619,Allen; Michael Gordon,15,0,70,55
1657092287318,COGS 101A,A01,083621,Davis; Joshua Daniel,9,0,68,59
1657092293348,COGS 101B,A01,091572,Allen; Michael Gordon,8,0,65,57
1657092299373,COGS 101C,A01,083625,Delgado; Tania,17,0,35,18
1657092305397,COGS 107A,A01,083627,Boyle; Mary E. T.,13,0,60,47
1657092311514,COGS 118A,A01,083075,Gupta; Anjum,15,0,76,61
1657092317554,CSE 3,A50,083646,Miranda; Gregory Joseph,22,0,50,28
1657092323577,CSE 8A,A50,083650,Miranda; Gregory Joseph,17,1,56,39
1657092329604,CSE 11,A01,083080,Cao; Yingjun,4,15,40,36
1657092335627,CSE 12,A01,083652,Krause-Levy; Sophia Louisa,23,1,120,97
1657092341662,CSE 15L,A01,083654,Morris; Justin Loren,9,0,50,41
1657092341662,CSE 15L,A02,083655,Morris; Justin Loren,9,0,50,41
1657092347691,CSE 20,A01,083657,Tran; Khoa Dang,37,0,80,43
1657092353728,CSE 21,A01,095574,Bach; Quang Tran,21,0,48,27
1657092359753,CSE 30,A01,083084,Eldon; John,4,0,80,76
1657092359753,CSE 30,B01,095061,Bhaskar; Nishant,6,0,50,44
1657092365782,CSE 100,A01,083659,Cao; Yingjun,4,4,70,66
1657092371805,CSE 134B,A01,083661,Powell; Thomas Allan,19,0,100,81
1657092377829,CSE 140,A01,083663,Gungor; Onat,14,0,85,71
1657092383853,CSE 140L,A01,083088,Eldon; John,16,0,100,84
1657092389882,CSE 175,A01,083665,Kumar; Rakesh,3,0,25,22
1657092395906,CSE 190,A00,092507,Dubnov; Shlomo,7,0,20,13
1657092401929,ECE 45,A01,083139,Congero; Spencer William,5,0,75,70
1657092407958,ECE 65,A50,083695,Saad; Andrew S,12,0,30,18
1657092407958,ECE 65,A51,095125,Saad; Andrew S,25,0,26,1
1657092413980,ECE 109,A01,091882,Touri; Behrouz,16,0,70,54
1657092420004,ECE 180,A00,083140,Abi Samra; Nicholas Camill,1,0,30,29
1657092420004,ECE 180,B00,083141,Abi Samra; Nicholas Camill,0,0,30,30
1657092426031,MATH 10A,A01,083735,Patchell; Gregory David,1,0,30,29
1657092426031,MATH 10A,A02,083736,Patchell; Gregory David,20,0,30,10
1657092426031,MATH 10A,A03,083737,Patchell; Gregory David,16,0,30,14
1657092432056,MATH 10B,A01,083207,Lim; Seonhee,7,0,34,27
1657092432056,MATH 10B,A02,083208,Lim; Seonhee,9,0,35,26
1657092432056,MATH 10B,A03,093472,Lim; Seonhee,5,0,34,29
1657092432056,MATH 10B,B01,083739,Sinha; Shubham,9,0,30,21
1657092438081,MATH 18,A01,083743,Cinel; Cameron Alexander,6,0,30,24
1657092438081,MATH 18,A02,083744,Cinel; Cameron Alexander,15,0,30,15
1657092438081,MATH 18,A03,083745,Cinel; Cameron Alexander,8,0,30,22
1657092438081,MATH 18,B01,083748,Rideout; David Porter,4,0,37,33
1657092438081,MATH 18,B02,083749,Rideout; David Porter,3,0,36,33
1657092438081,MATH 18,B03,083750,Rideout; David Porter,2,0,37,35
1657092438081,MATH 18,B04,083751,Rideout; David Porter,5,0,36,31
1657092438081,MATH 18,B05,093473,Rideout; David Porter,4,0,36,32
1657092438081,MATH 18,B06,093474,Rideout; David Porter,5,0,36,31
1657092444106,MATH 20A,A01,083754,Zheng; Zequn,12,0,40,28
1657092450130,MATH 20B,A01,083756,Briones; Jor-el Thomas Caparas,1,0,36,35
1657092450130,MATH 20B,A02,083757,Briones; Jor-el Thomas Caparas,1,0,36,35
1657092450130,MATH 20B,A03,093475,Briones; Jor-el Thomas Caparas,0,0,36,36
1657092456158,MATH 20C,A01,083760,Briones; Jor-el Thomas Caparas,1,0,35,34
1657092456158,MATH 20C,A02,083761,Briones; Jor-el Thomas Caparas,8,0,35,27
1657092456158,MATH 20C,A03,093476,Briones; Jor-el Thomas Caparas,0,1,36,36
1657092456158,MATH 20C,B01,083762,Bach; Quang Tran,0,0,30,30
1657092462183,MATH 20D,A01,083765,Tran; Brian Kha,4,0,30,26
1657092462183,MATH 20D,A02,083766,Tran; Brian Kha,5,0,30,25
1657092462183,MATH 20D,A03,083767,Tran; Brian Kha,3,0,30,27
1657092468215,MATH 20E,A01,083771,Ganguly; Soumya,6,0,32,26
1657092468215,MATH 20E,A02,083772,Ganguly; Soumya,6,0,32,26
1657092468215,MATH 20E,B01,083773,Ciotti; Benjamin,18,0,35,17
1657092468215,MATH 20E,B02,083774,Ciotti; Benjamin,17,0,35,18
1657092474244,MATH 103A,A01,083777,Greenfeld; Be'Eri,2,0,36,34
1657092474244,MATH 103A,A02,083778,Greenfeld; Be'Eri,5,0,36,31
1657092474244,MATH 103A,A03,093561,Greenfeld; Be'Eri,4,0,36,32
1657092474244,MATH 103A,B01,083779,Greenfeld; Be'Eri,6,0,36,30
1657092474244,MATH 103A,B02,083780,Greenfeld; Be'Eri,2,0,36,34
1657092474244,MATH 103A,B03,093562,Greenfeld; Be'Eri,3,0,36,33
1657092480273,MATH 105,A01,085443,Carter; Anne Toulson,14,0,35,21
1657092480273,MATH 105,A02,093477,Carter; Anne Toulson,20,0,35,15
1657092486296,MATH 109,A01,083213,Ganzberger; Geoffrey Michael,2,0,34,32
1657092486296,MATH 109,A02,083214,Ganzberger; Geoffrey Michael,3,0,34,31
1657092486296,MATH 109,A03,093478,Ganzberger; Geoffrey Michael,1,0,34,33
1657092486296,MATH 109,B01,083215,Ganzberger; Geoffrey Michael,1,0,32,31
1657092486296,MATH 109,B02,083216,Ganzberger; Geoffrey Michael,1,0,32,31
1657092486296,MATH 109,B03,093479,Ganzberger; Geoffrey Michael,6,0,32,26
1657092492323,MATH 142A,A01,083219,Chow; Bennett,6,0,32,26
1657092492323,MATH 142A,A02,083220,Chow; Bennett,10,0,32,22
1657092492323,MATH 142A,A03,093480,Chow; Bennett,7,0,32,25
1657092492323,MATH 142A,B03,093481,Chow; Bennett,8,0,32,24
1657092492323,MATH 142A,B04,093558,Chow; Bennett,11,0,32,21
1657092492323,MATH 142A,B05,093559,Chow; Bennett,6,0,32,26
1657092498348,MATH 193A,A01,083224,Rotar; Vladimir,7,0,34,27
1657092498348,MATH 193A,A02,083225,Rotar; Vladimir,5,0,34,29
1657092498348,MATH 193A,A03,083781,Rotar; Vladimir,1,0,34,33
1657092498348,MATH 193A,A04,083782,Rotar; Vladimir,6,0,34,28
1657092498348,MATH 193A,A05,093482,Rotar; Vladimir,6,0,34,28
1657092504373,MATH 197,001,091859,McAuley; Julian John,9999,0,9999,0
1657092504373,MATH 197,002,095566,Kedlaya; Kiran S.,9997,0,9999,2
1657092504373,MATH 197,003,095567,Xiao; Ming,9999,0,9999,0
1657092504373,MATH 197,004,095571,Perols; Johan Lars,9998,0,9999,1
1657092511438,COGS 9,A01,083615,Shannon; Kyle Michael,7,0,75,68
1657092517461,COGS 11,A01,083617,Boyle; Mary E. T.,21,0,48,27
1657092523484,COGS 13,A01,083071,Bastos; Amalia Pinkusfeld,9,0,71,62
1657092529514,COGS 14A,A01,092681,Semenuks; Arturs,1,1,100,99
1657092535537,COGS 14B,A01,083073,Cheng; Tzu-Han,6,0,63,57
1657092541561,COGS 17,A01,092677,Semenuks; Arturs,4,0,81,77
1657092547586,COGS 100,A01,083619,Allen; Michael Gordon,15,0,70,55
1657092553607,COGS 101A,A01,083621,Davis; Joshua Daniel,9,0,68,59
1657092559634,COGS 101B,A01,091572,Allen; Michael Gordon,8,0,65,57
1657092565662,COGS 101C,A01,083625,Delgado; Tania,17,0,35,18
1657092571683,COGS 107A,A01,083627,Boyle; Mary E. T.,13,0,60,47
1657092577707,COGS 118A,A01,083075,Gupta; Anjum,15,0,76,61
1657092583732,CSE 3,A50,083646,Miranda; Gregory Joseph,22,0,50,28
1657092589755,CSE 8A,A50,083650,Miranda; Gregory Joseph,17,1,56,39
1657092595777,CSE 11,A01,083080,Cao; Yingjun,4,15,40,36
1657092601800,CSE 12,A01,083652,Krause-Levy; Sophia Louisa,23,1,120,97
1657092607830,CSE 15L,A01,083654,Morris; Justin Loren,9,0,50,41
1657092607830,CSE 15L,A02,083655,Morris; Justin Loren,9,0,50,41
1657092613852,CSE 20,A01,083657,Tran; Khoa Dang,37,0,80,43
1657092619878,CSE 21,A01,095574,Bach; Quang Tran,21,0,48,27
1657092625913,CSE 30,A01,083084,Eldon; John,4,0,80,76
1657092625913,CSE 30,B01,095061,Bhaskar; Nishant,6,0,50,44
1657092631936,CSE 100,A01,083659,Cao; Yingjun,4,4,70,66
1657092637958,CSE 134B,A01,083661,Powell; Thomas Allan,19,0,100,81
1657092643984,CSE 140,A01,083663,Gungor; Onat,14,0,85,71
1657092650009,CSE 140L,A01,083088,Eldon; John,16,0,100,84
1657092656035,CSE 175,A01,083665,Kumar; Rakesh,3,0,25,22
1657092662060,CSE 190,A00,092507,Dubnov; Shlomo,7,0,20,13
1657092668090,ECE 45,A01,083139,Congero; Spencer William,5,0,75,70
1657092674123,ECE 65,A50,083695,Saad; Andrew S,12,0,30,18
1657092674123,ECE 65,A51,095125,Saad; Andrew S,25,0,26,1
1657092680149,ECE 109,A01,091882,Touri; Behrouz,16,0,70,54
1657092686183,ECE 180,A00,083140,Abi Samra; Nicholas Camill,1,0,30,29
1657092686183,ECE 180,B00,083141,Abi Samra; Nicholas Camill,0,0,30,30
1657092692213,MATH 10A,A01,083735,Patchell; Gregory David,1,0,30,29
1657092692213,MATH 10A,A02,083736,Patchell; Gregory David,20,0,30,10
1657092692213,MATH 10A,A03,083737,Patchell; Gregory David,16,0,30,14
1657092698244,MATH 10B,A01,083207,Lim; Seonhee,7,0,34,27
1657092698244,MATH 10B,A02,083208,Lim; Seonhee,9,0,35,26
1657092698244,MATH 10B,A03,093472,Lim; Seonhee,5,0,34,29
1657092698244,MATH 10B,B01,083739,Sinha; Shubham,9,0,30,21
1657092704271,MATH 18,A01,083743,Cinel; Cameron Alexander,6,0,30,24
1657092704271,MATH 18,A02,083744,Cinel; Cameron Alexander,15,0,30,15
1657092704271,MATH 18,A03,083745,Cinel; Cameron Alexander,8,0,30,22
1657092704271,MATH 18,B01,083748,Rideout; David Porter,4,0,37,33
1657092704271,MATH 18,B02,083749,Rideout; David Porter,3,0,36,33
1657092704271,MATH 18,B03,083750,Rideout; David Porter,2,0,37,35
1657092704271,MATH 18,B04,083751,Rideout; David Porter,5,0,36,31
1657092704271,MATH 18,B05,093473,Rideout; David Porter,4,0,36,32
1657092704271,MATH 18,B06,093474,Rideout; David Porter,5,0,36,31
1657092710298,MATH 20A,A01,083754,Zheng; Zequn,12,0,40,28
1657092716323,MATH 20B,A01,083756,Briones; Jor-el Thomas Caparas,1,0,36,35
1657092716323,MATH 20B,A02,083757,Briones; Jor-el Thomas Caparas,1,0,36,35
1657092716323,MATH 20B,A03,093475,Briones; Jor-el Thomas Caparas,0,0,36,36
1657092722347,MATH 20C,A01,083760,Briones; Jor-el Thomas Caparas,1,0,35,34
1657092722347,MATH 20C,A02,083761,Briones; Jor-el Thomas Caparas,8,0,35,27
1657092722347,MATH 20C,A03,093476,Briones; Jor-el Thomas Caparas,0,1,36,36
1657092722347,MATH 20C,B01,083762,Bach; Quang Tran,0,0,30,30
1657092728392,MATH 20D,A01,083765,Tran; Brian Kha,4,0,30,26
1657092728392,MATH 20D,A02,083766,Tran; Brian Kha,5,0,30,25
1657092728392,MATH 20D,A03,083767,Tran; Brian Kha,3,0,30,27
1657092734424,MATH 20E,A01,083771,Ganguly; Soumya,6,0,32,26
1657092734424,MATH 20E,A02,083772,Ganguly; Soumya,6,0,32,26
1657092734424,MATH 20E,B01,083773,Ciotti; Benjamin,18,0,35,17
1657092734424,MATH 20E,B02,083774,Ciotti; Benjamin,17,0,35,18
1657092740453,MATH 103A,A01,083777,Greenfeld; Be'Eri,2,0,36,34
1657092740453,MATH 103A,A02,083778,Greenfeld; Be'Eri,5,0,36,31
1657092740453,MATH 103A,A03,093561,Greenfeld; Be'Eri,4,0,36,32
1657092740453,MATH 103A,B01,083779,Greenfeld; Be'Eri,6,0,36,30
1657092740453,MATH 103A,B02,083780,Greenfeld; Be'Eri,2,0,36,34
1657092740453,MATH 103A,B03,093562,Greenfeld; Be'Eri,3,0,36,33
1657092746486,MATH 105,A01,085443,Carter; Anne Toulson,14,0,35,21
1657092746486,MATH 105,A02,093477,Carter; Anne Toulson,20,0,35,15
1657092752512,MATH 109,A01,083213,Ganzberger; Geoffrey Michael,2,0,34,32
1657092752512,MATH 109,A02,083214,Ganzberger; Geoffrey Michael,3,0,34,31
1657092752512,MATH 109,A03,093478,Ganzberger; Geoffrey Michael,1,0,34,33
1657092752512,MATH 109,B01,083215,Ganzberger; Geoffrey Michael,1,0,32,31
1657092752512,MATH 109,B02,083216,Ganzberger; Geoffrey Michael,1,0,32,31
1657092752512,MATH 109,B03,093479,Ganzberger; Geoffrey Michael,6,0,32,26
1657092758540,MATH 142A,A01,083219,Chow; Bennett,6,0,32,26
1657092758540,MATH 142A,A02,083220,Chow; Bennett,10,0,32,22
1657092758540,MATH 142A,A03,093480,Chow; Bennett,7,0,32,25
1657092758540,MATH 142A,B03,093481,Chow; Bennett,8,0,32,24
1657092758540,MATH 142A,B04,093558,Chow; Bennett,11,0,32,21
1657092758540,MATH 142A,B05,093559,Chow; Bennett,6,0,32,26
1657092764568,MATH 193A,A01,083224,Rotar; Vladimir,7,0,34,27
1657092764568,MATH 193A,A02,083225,Rotar; Vladimir,5,0,34,29
1657092764568,MATH 193A,A03,083781,Rotar; Vladimir,1,0,34,33
1657092764568,MATH 193A,A04,083782,Rotar; Vladimir,6,0,34,28
1657092764568,MATH 193A,A05,093482,Rotar; Vladimir,6,0,34,28
1657092770594,MATH 197,001,091859,McAuley; Julian John,9999,0,9999,0
1657092770594,MATH 197,002,095566,Kedlaya; Kiran S.,9997,0,9999,2
1657092770594,MATH 197,003,095567,Xiao; Ming,9999,0,9999,0
1657092770594,MATH 197,004,095571,Perols; Johan Lars,9998,0,9999,1
1657092777676,COGS 9,A01,083615,Shannon; Kyle Michael,7,0,75,68
1657092783707,COGS 11,A01,083617,Boyle; Mary E. T.,21,0,48,27
1657092789733,COGS 13,A01,083071,Bastos; Amalia Pinkusfeld,9,0,71,62
1657092795757,COGS 14A,A01,092681,Semenuks; Arturs,1,1,100,99
1657092801780,COGS 14B,A01,083073,Cheng; Tzu-Han,6,0,63,57
1657092807804,COGS 17,A01,092677,Semenuks; Arturs,4,0,81,77
1657092813838,COGS 100,A01,083619,Allen; Michael Gordon,15,0,70,55
1657092819868,COGS 101A,A01,083621,Davis; Joshua Daniel,9,0,68,59
1657092825894,COGS 101B,A01,091572,Allen; Michael Gordon,8,0,65,57
1657092831923,COGS 101C,A01,083625,Delgado; Tania,17,0,35,18
1657092837947,COGS 107A,A01,083627,Boyle; Mary E. T.,13,0,60,47
1657092843972,COGS 118A,A01,083075,Gupta; Anjum,15,0,76,61
1657092850007,CSE 3,A50,083646,Miranda; Gregory Joseph,22,0,50,28
1657092856034,CSE 8A,A50,083650,Miranda; Gregory Joseph,17,1,56,39
1657092866811,CSE 11,A01,083080,Cao; Yingjun,4,15,40,36
1657092872844,CSE 12,A01,083652,Krause-Levy; Sophia Louisa,23,1,120,97
1657092878868,CSE 15L,A01,083654,Morris; Justin Loren,9,0,50,41
1657092878868,CSE 15L,A02,083655,Morris; Justin Loren,9,0,50,41
1657092884897,CSE 20,A01,083657,Tran; Khoa Dang,37,0,80,43
1657092890923,CSE 21,A01,095574,Bach; Quang Tran,21,0,48,27
1657092896956,CSE 30,A01,083084,Eldon; John,4,0,80,76
1657092896956,CSE 30,B01,095061,Bhaskar; Nishant,6,0,50,44
1657092902987,CSE 100,A01,083659,Cao; Yingjun,4,4,70,66
1657092909012,CSE 134B,A01,083661,Powell; Thomas Allan,19,0,100,81
1657092915112,CSE 140,A01,083663,Gungor; Onat,14,0,85,71
1657092921136,CSE 140L,A01,083088,Eldon; John,16,0,100,84
1657092927163,CSE 175,A01,083665,Kumar; Rakesh,3,0,25,22
1657092933195,CSE 190,A00,092507,Dubnov; Shlomo,7,0,20,13
1657092939235,ECE 45,A01,083139,Congero; Spencer William,5,0,75,70
1657092945267,ECE 65,A50,083695,Saad; Andrew S,12,0,30,18
1657092945267,ECE 65,A51,095125,Saad; Andrew S,25,0,26,1
1657092951296,ECE 109,A01,091882,Touri; Behrouz,16,0,70,54
1657092957326,ECE 180,A00,083140,Abi Samra; Nicholas Camill,1,0,30,29
1657092957326,ECE 180,B00,083141,Abi Samra; Nicholas Camill,0,0,30,30
1657092963352,MATH 10A,A01,083735,Patchell; Gregory David,1,0,30,29
1657092963352,MATH 10A,A02,083736,Patchell; Gregory David,20,0,30,10
1657092963352,MATH 10A,A03,083737,Patchell; Gregory David,16,0,30,14
1657092969388,MATH 10B,A01,083207,Lim; Seonhee,7,0,34,27
1657092969388,MATH 10B,A02,083208,Lim; Seonhee,9,0,35,26
1657092969388,MATH 10B,A03,093472,Lim; Seonhee,5,0,34,29
1657092969388,MATH 10B,B01,083739,Sinha; Shubham,9,0,30,21
1657092975429,MATH 18,A01,083743,Cinel; Cameron Alexander,6,0,30,24
1657092975429,MATH 18,A02,083744,Cinel; Cameron Alexander,15,0,30,15
1657092975429,MATH 18,A03,083745,Cinel; Cameron Alexander,8,0,30,22
1657092975429,MATH 18,B01,083748,Rideout; David Porter,4,0,37,33
1657092975429,MATH 18,B02,083749,Rideout; David Porter,3,0,36,33
1657092975429,MATH 18,B03,083750,Rideout; David Porter,2,0,37,35
1657092975429,MATH 18,B04,083751,Rideout; David Porter,5,0,36,31
1657092975429,MATH 18,B05,093473,Rideout; David Porter,4,0,36,32
1657092975429,MATH 18,B06,093474,Rideout; David Porter,5,0,36,31
1657092981453,MATH 20A,A01,083754,Zheng; Zequn,12,0,40,28
1657092987485,MATH 20B,A01,083756,Briones; Jor-el Thomas Caparas,1,0,36,35
1657092987485,MATH 20B,A02,083757,Briones; Jor-el Thomas Caparas,1,0,36,35
1657092987485,MATH 20B,A03,093475,Briones; Jor-el Thomas Caparas,0,0,36,36
1657092993511,MATH 20C,A01,083760,Briones; Jor-el Thomas Caparas,1,0,35,34
1657092993511,MATH 20C,A02,083761,Briones; Jor-el Thomas Caparas,8,0,35,27
1657092993511,MATH 20C,A03,093476,Briones; Jor-el Thomas Caparas,0,1,36,36
1657092993511,MATH 20C,B01,083762,Bach; Quang Tran,0,0,30,30
1657092999544,MATH 20D,A01,083765,Tran; Brian Kha,4,0,30,26
1657092999544,MATH 20D,A02,083766,Tran; Brian Kha,5,0,30,25
1657092999544,MATH 20D,A03,083767,Tran; Brian Kha,3,0,30,27
1657093005579,MATH 20E,A01,083771,Ganguly; Soumya,6,0,32,26
1657093005579,MATH 20E,A02,083772,Ganguly; Soumya,6,0,32,26
1657093005579,MATH 20E,B01,083773,Ciotti; Benjamin,18,0,35,17
1657093005579,MATH 20E,B02,083774,Ciotti; Benjamin,17,0,35,18
1657093011607,MATH 103A,A01,083777,Greenfeld; Be'Eri,2,0,36,34
1657093011607,MATH 103A,A02,083778,Greenfeld; Be'Eri,5,0,36,31
1657093011607,MATH 103A,A03,093561,Greenfeld; Be'Eri,4,0,36,32
1657093011607,MATH 103A,B01,083779,Greenfeld; Be'Eri,6,0,36,30
1657093011607,MATH 103A,B02,083780,Greenfeld; Be'Eri,2,0,36,34
1657093011607,MATH 103A,B03,093562,Greenfeld; Be'Eri,3,0,36,33
1657093017638,MATH 105,A01,085443,Carter; Anne Toulson,14,0,35,21
1657093017638,MATH 105,A02,093477,Carter; Anne Toulson,20,0,35,15
1657093023663,MATH 109,A01,083213,Ganzberger; Geoffrey Michael,2,0,34,32
1657093023663,MATH 109,A02,083214,Ganzberger; Geoffrey Michael,3,0,34,31
1657093023663,MATH 109,A03,093478,Ganzberger; Geoffrey Michael,1,0,34,33
1657093023663,MATH 109,B01,083215,Ganzberger; Geoffrey Michael,1,0,32,31
1657093023663,MATH 109,B02,083216,Ganzberger; Geoffrey Michael,1,0,32,31
1657093023663,MATH 109,B03,093479,Ganzberger; Geoffrey Michael,6,0,32,26
1657093029697,MATH 142A,A01,083219,Chow; Bennett,6,0,32,26
1657093029697,MATH 142A,A02,083220,Chow; Bennett,10,0,32,22
1657093029697,MATH 142A,A03,093480,Chow; Bennett,7,0,32,25
1657093029697,MATH 142A,B03,093481,Chow; Bennett,8,0,32,24
1657093029697,MATH 142A,B04,093558,Chow; Bennett,11,0,32,21
1657093029697,MATH 142A,B05,093559,Chow; Bennett,6,0,32,26
1657093035725,MATH 193A,A01,083224,Rotar; Vladimir,7,0,34,27
1657093035725,MATH 193A,A02,083225,Rotar; Vladimir,5,0,34,29
1657093035725,MATH 193A,A03,083781,Rotar; Vladimir,1,0,34,33
1657093035725,MATH 193A,A04,083782,Rotar; Vladimir,6,0,34,28
1657093035725,MATH 193A,A05,093482,Rotar; Vladimir,6,0,34,28
1657093041751,MATH 197,001,091859,McAuley; Julian John,9999,0,9999,0
1657093041751,MATH 197,002,095566,Kedlaya; Kiran S.,9997,0,9999,2
1657093041751,MATH 197,003,095567,Xiao; Ming,9999,0,9999,0
1657093041751,MATH 197,004,095571,Perols; Johan Lars,9998,0,9999,1
1657093048877,COGS 9,A01,083615,Shannon; Kyle Michael,7,0,75,68
1657093054909,COGS 11,A01,083617,Boyle; Mary E. T.,21,0,48,27
1657093060934,COGS 13,A01,083071,Bastos; Amalia Pinkusfeld,9,0,71,62
1657093066962,COGS 14A,A01,092681,Semenuks; Arturs,1,1,100,99
1657093072991,COGS 14B,A01,083073,Cheng; Tzu-Han,6,0,63,57
1657093079022,COGS 17,A01,092677,Semenuks; Arturs,4,0,81,77
1657093085050,COGS 100,A01,083619,Allen; Michael Gordon,15,0,70,55
1657093091081,COGS 101A,A01,083621,Davis; Joshua Daniel,9,0,68,59
1657093097105,COGS 101B,A01,091572,Allen; Michael Gordon,8,0,65,57
1657093103130,COGS 101C,A01,083625,Delgado; Tania,17,0,35,18
1657093109158,COGS 107A,A01,083627,Boyle; Mary E. T.,13,0,60,47
1657093115181,COGS 118A,A01,083075,Gupta; Anjum,15,0,76,61
1657093121206,CSE 3,A50,083646,Miranda; Gregory Joseph,22,0,50,28
1657093127237,CSE 8A,A50,083650,Miranda; Gregory Joseph,17,1,56,39
1657093133264,CSE 11,A01,083080,Cao; Yingjun,4,15,40,36
1657093139317,CSE 12,A01,083652,Krause-Levy; Sophia Louisa,23,1,120,97
1657093145340,CSE 15L,A01,083654,Morris; Justin Loren,9,0,50,41
1657093145340,CSE 15L,A02,083655,Morris; Justin Loren,9,0,50,41
1657093151370,CSE 20,A01,083657,Tran; Khoa Dang,37,0,80,43
1657093157402,CSE 21,A01,095574,Bach; Quang Tran,21,0,48,27
1657093163438,CSE 30,A01,083084,Eldon; John,4,0,80,76
1657093163438,CSE 30,B01,095061,Bhaskar; Nishant,6,0,50,44
1657093169467,CSE 100,A01,083659,Cao; Yingjun,4,4,70,66
1657093175497,CSE 134B,A01,083661,Powell; Thomas Allan,19,0,100,81
1657093181526,CSE 140,A01,083663,Gungor; Onat,14,0,85,71
1657093187556,CSE 140L,A01,083088,Eldon; John,16,0,100,84
1657093193581,CSE 175,A01,083665,Kumar; Rakesh,3,0,25,22
1657093199611,CSE 190,A00,092507,Dubnov; Shlomo,7,0,20,13
1657093205643,ECE 45,A01,083139,Congero; Spencer William,5,0,75,70
1657093211680,ECE 65,A50,083695,Saad; Andrew S,12,0,30,18
1657093211680,ECE 65,A51,095125,Saad; Andrew S,25,0,26,1
1657093217707,ECE 109,A01,091882,Touri; Behrouz,16,0,70,54
1657093223732,ECE 180,A00,083140,Abi Samra; Nicholas Camill,1,0,30,29
1657093223732,ECE 180,B00,083141,Abi Samra; Nicholas Camill,0,0,30,30
1657093229765,MATH 10A,A01,083735,Patchell; Gregory David,1,0,30,29
1657093229765,MATH 10A,A02,083736,Patchell; Gregory David,20,0,30,10
1657093229765,MATH 10A,A03,083737,Patchell; Gregory David,16,0,30,14
1657093235797,MATH 10B,A01,083207,Lim; Seonhee,7,0,34,27
1657093235797,MATH 10B,A02,083208,Lim; Seonhee,9,0,35,26
1657093235797,MATH 10B,A03,093472,Lim; Seonhee,5,0,34,29
1657093235797,MATH 10B,B01,083739,Sinha; Shubham,9,0,30,21
1657093241834,MATH 18,A01,083743,Cinel; Cameron Alexander,6,0,30,24
1657093241834,MATH 18,A02,083744,Cinel; Cameron Alexander,15,0,30,15
1657093241834,MATH 18,A03,083745,Cinel; Cameron Alexander,8,0,30,22
1657093241834,MATH 18,B01,083748,Rideout; David Porter,4,0,37,33
1657093241834,MATH 18,B02,083749,Rideout; David Porter,3,0,36,33
1657093241834,MATH 18,B03,083750,Rideout; David Porter,2,0,37,35
1657093241834,MATH 18,B04,083751,Rideout; David Porter,5,0,36,31
1657093241834,MATH 18,B05,093473,Rideout; David Porter,4,0,36,32
1657093241834,MATH 18,B06,093474,Rideout; David Porter,5,0,36,31
1657093247859,MATH 20A,A01,083754,Zheng; Zequn,12,0,40,28
1657093253898,MATH 20B,A01,083756,Briones; Jor-el Thomas Caparas,1,0,36,35
1657093253898,MATH 20B,A02,083757,Briones; Jor-el Thomas Caparas,1,0,36,35
1657093253898,MATH 20B,A03,093475,Briones; Jor-el Thomas Caparas,0,0,36,36
1657093259928,MATH 20C,A01,083760,Briones; Jor-el Thomas Caparas,1,0,35,34
1657093259928,MATH 20C,A02,083761,Briones; Jor-el Thomas Caparas,8,0,35,27
1657093259928,MATH 20C,A03,093476,Briones; Jor-el Thomas Caparas,0,1,36,36
1657093259928,MATH 20C,B01,083762,Bach; Quang Tran,0,0,30,30
1657093265962,MATH 20D,A01,083765,Tran; Brian Kha,4,0,30,26
1657093265962,MATH 20D,A02,083766,Tran; Brian Kha,5,0,30,25
1657093265962,MATH 20D,A03,083767,Tran; Brian Kha,3,0,30,27
1657093271990,MATH 20E,A01,083771,Ganguly; Soumya,6,0,32,26
1657093271990,MATH 20E,A02,083772,Ganguly; Soumya,6,0,32,26
1657093271990,MATH 20E,B01,083773,Ciotti; Benjamin,18,0,35,17
1657093271990,MATH 20E,B02,083774,Ciotti; Benjamin,17,0,35,18
1657093278018,MATH 103A,A01,083777,Greenfeld; Be'Eri,2,0,36,34
1657093278018,MATH 103A,A02,083778,Greenfeld; Be'Eri,5,0,36,31
1657093278018,MATH 103A,A03,093561,Greenfeld; Be'Eri,4,0,36,32
1657093278018,MATH 103A,B01,083779,Greenfeld; Be'Eri,6,0,36,30
1657093278018,MATH 103A,B02,083780,Greenfeld; Be'Eri,2,0,36,34
1657093278018,MATH 103A,B03,093562,Greenfeld; Be'Eri,3,0,36,33
1657093284042,MATH 105,A01,085443,Carter; Anne Toulson,14,0,35,21
1657093284042,MATH 105,A02,093477,Carter; Anne Toulson,20,0,35,15
1657093290068,MATH 109,A01,083213,Ganzberger; Geoffrey Michael,2,0,34,32
1657093290068,MATH 109,A02,083214,Ganzberger; Geoffrey Michael,3,0,34,31
1657093290068,MATH 109,A03,093478,Ganzberger; Geoffrey Michael,1,0,34,33
1657093290068,MATH 109,B01,083215,Ganzberger; Geoffrey Michael,1,0,32,31
1657093290068,MATH 109,B02,083216,Ganzberger; Geoffrey Michael,1,0,32,31
1657093290068,MATH 109,B03,093479,Ganzberger; Geoffrey Michael,6,0,32,26
1657093296095,MATH 142A,A01,083219,Chow; Bennett,6,0,32,26
1657093296095,MATH 142A,A02,083220,Chow; Bennett,10,0,32,22
1657093296095,MATH 142A,A03,093480,Chow; Bennett,7,0,32,25
1657093296095,MATH 142A,B03,093481,Chow; Bennett,8,0,32,24
1657093296095,MATH 142A,B04,093558,Chow; Bennett,11,0,32,21
1657093296095,MATH 142A,B05,093559,Chow; Bennett,6,0,32,26
1657093302125,MATH 193A,A01,083224,Rotar; Vladimir,7,0,34,27
1657093302125,MATH 193A,A02,083225,Rotar; Vladimir,5,0,34,29
1657093302125,MATH 193A,A03,083781,Rotar; Vladimir,1,0,34,33
1657093302125,MATH 193A,A04,083782,Rotar; Vladimir,6,0,34,28
1657093302125,MATH 193A,A05,093482,Rotar; Vladimir,6,0,34,28
1657093308151,MATH 197,001,091859,McAuley; Julian John,9999,0,9999,0
1657093308151,MATH 197,002,095566,Kedlaya; Kiran S.,9997,0,9999,2
1657093308151,MATH 197,003,095567,Xiao; Ming,9999,0,9999,0
1657093308151,MATH 197,004,095571,Perols; Johan Lars,9998,0,9999,1
1657093315240,COGS 9,A01,083615,Shannon; Kyle Michael,7,0,75,68
1657093321271,COGS 11,A01,083617,Boyle; Mary E. T.,21,0,48,27
1657093327295,COGS 13,A01,083071,Bastos; Amalia Pinkusfeld,9,0,71,62
1657093333321,COGS 14A,A01,092681,Semenuks; Arturs,1,1,100,99
1657093339348,COGS 14B,A01,083073,Cheng; Tzu-Han,6,0,63,57
1657093345374,COGS 17,A01,092677,Semenuks; Arturs,4,0,81,77
1657093351404,COGS 100,A01,083619,Allen; Michael Gordon,15,0,70,55
1657093357433,COGS 101A,A01,083621,Davis; Joshua Daniel,9,0,68,59
1657093363458,COGS 101B,A01,091572,Allen; Michael Gordon,8,0,65,57
1657093369489,COGS 101C,A01,083625,Delgado; Tania,17,0,35,18
1657093375513,COGS 107A,A01,083627,Boyle; Mary E. T.,13,0,60,47
1657093381538,COGS 118A,A01,083075,Gupta; Anjum,15,0,76,61
1657093387570,CSE 3,A50,083646,Miranda; Gregory Joseph,22,0,50,28
1657093393600,CSE 8A,A50,083650,Miranda; Gregory Joseph,17,1,56,39
1657093399626,CSE 11,A01,083080,Cao; Yingjun,4,15,40,36
1657093405659,CSE 12,A01,083652,Krause-Levy; Sophia Louisa,23,1,120,97
1657093411683,CSE 15L,A01,083654,Morris; Justin Loren,9,0,50,41
1657093411683,CSE 15L,A02,083655,Morris; Justin Loren,9,0,50,41
1657093417712,CSE 20,A01,083657,Tran; Khoa Dang,37,0,80,43
1657093423736,CSE 21,A01,095574,Bach; Quang Tran,21,0,48,27
1657093429763,CSE 30,A01,083084,Eldon; John,4,0,80,76
1657093429763,CSE 30,B01,095061,Bhaskar; Nishant,6,0,50,44
1657093435792,CSE 100,A01,083659,Cao; Yingjun,4,4,70,66
1657093441819,CSE 134B,A01,083661,Powell; Thomas Allan,19,0,100,81
1657093447850,CSE 140,A01,083663,Gungor; Onat,14,0,85,71
1657093453884,CSE 140L,A01,083088,Eldon; John,16,0,100,84
1657093459911,CSE 175,A01,083665,Kumar; Rakesh,3,0,25,22
1657093465943,CSE 190,A00,092507,Dubnov; Shlomo,7,0,20,13
1657093471970,ECE 45,A01,083139,Congero; Spencer William,5,0,75,70
1657093478012,ECE 65,A50,083695,Saad; Andrew S,12,0,30,18
1657093478012,ECE 65,A51,095125,Saad; Andrew S,25,0,26,1
1657093484042,ECE 109,A01,091882,Touri; Behrouz,16,0,70,54
1657093490076,ECE 180,A00,083140,Abi Samra; Nicholas Camill,1,0,30,29
1657093490076,ECE 180,B00,083141,Abi Samra; Nicholas Camill,0,0,30,30
1657093496111,MATH 10A,A01,083735,Patchell; Gregory David,1,0,30,29
1657093496111,MATH 10A,A02,083736,Patchell; Gregory David,20,0,30,10
1657093496111,MATH 10A,A03,083737,Patchell; Gregory David,16,0,30,14
1657093502143,MATH 10B,A01,083207,Lim; Seonhee,7,0,34,27
1657093502143,MATH 10B,A02,083208,Lim; Seonhee,9,0,35,26
1657093502143,MATH 10B,A03,093472,Lim; Seonhee,5,0,34,29
1657093502143,MATH 10B,B01,083739,Sinha; Shubham,9,0,30,21
1657093508181,MATH 18,A01,083743,Cinel; Cameron Alexander,6,0,30,24
1657093508181,MATH 18,A02,083744,Cinel; Cameron Alexander,15,0,30,15
1657093508181,MATH 18,A03,083745,Cinel; Cameron Alexander,8,0,30,22
1657093508181,MATH 18,B01,083748,Rideout; David Porter,4,0,37,33
1657093508181,MATH 18,B02,083749,Rideout; David Porter,3,0,36,33
1657093508181,MATH 18,B03,083750,Rideout; David Porter,2,0,37,35
1657093508181,MATH 18,B04,083751,Rideout; David Porter,5,0,36,31
1657093508181,MATH 18,B05,093473,Rideout; David Porter,4,0,36,32
1657093508181,MATH 18,B06,093474,Rideout; David Porter,5,0,36,31
1657093514296,MATH 20A,A01,083754,Zheng; Zequn,12,0,40,28
1657093520329,MATH 20B,A01,083756,Briones; Jor-el Thomas Caparas,1,0,36,35
1657093520329,MATH 20B,A02,083757,Briones; Jor-el Thomas Caparas,1,0,36,35
1657093520329,MATH 20B,A03,093475,Briones; Jor-el Thomas Caparas,0,0,36,36
1657093526355,MATH 20C,A01,083760,Briones; Jor-el Thomas Caparas,1,0,35,34
1657093526355,MATH 20C,A02,083761,Briones; Jor-el Thomas Caparas,8,0,35,27
1657093526355,MATH 20C,A03,093476,Briones; Jor-el Thomas Caparas,0,1,36,36
1657093526355,MATH 20C,B01,083762,Bach; Quang Tran,0,0,30,30
1657093532379,MATH 20D,A01,083765,Tran; Brian Kha,4,0,30,26
1657093532379,MATH 20D,A02,083766,Tran; Brian Kha,5,0,30,25
1657093532379,MATH 20D,A03,083767,Tran; Brian Kha,3,0,30,27
1657093538407,MATH 20E,A01,083771,Ganguly; Soumya,6,0,32,26
1657093538407,MATH 20E,A02,083772,Ganguly; Soumya,6,0,32,26
1657093538407,MATH 20E,B01,083773,Ciotti; Benjamin,18,0,35,17
1657093538407,MATH 20E,B02,083774,Ciotti; Benjamin,17,0,35,18
1657093544445,MATH 103A,A01,083777,Greenfeld; Be'Eri,2,0,36,34
1657093544445,MATH 103A,A02,083778,Greenfeld; Be'Eri,5,0,36,31
1657093544445,MATH 103A,A03,093561,Greenfeld; Be'Eri,4,0,36,32
1657093544445,MATH 103A,B01,083779,Greenfeld; Be'Eri,6,0,36,30
1657093544445,MATH 103A,B02,083780,Greenfeld; Be'Eri,2,0,36,34
1657093544445,MATH 103A,B03,093562,Greenfeld; Be'Eri,3,0,36,33
1657093550473,MATH 105,A01,085443,Carter; Anne Toulson,14,0,35,21
1657093550473,MATH 105,A02,093477,Carter; Anne Toulson,20,0,35,15
1657093556501,MATH 109,A01,083213,Ganzberger; Geoffrey Michael,2,0,34,32
1657093556501,MATH 109,A02,083214,Ganzberger; Geoffrey Michael,3,0,34,31
1657093556501,MATH 109,A03,093478,Ganzberger; Geoffrey Michael,1,0,34,33
1657093556501,MATH 109,B01,083215,Ganzberger; Geoffrey Michael,1,0,32,31
1657093556501,MATH 109,B02,083216,Ganzberger; Geoffrey Michael,1,0,32,31
1657093556501,MATH 109,B03,093479,Ganzberger; Geoffrey Michael,6,0,32,26
1657093562549,MATH 142A,A01,083219,Chow; Bennett,6,0,32,26
1657093562549,MATH 142A,A02,083220,Chow; Bennett,10,0,32,22
1657093562549,MATH 142A,A03,093480,Chow; Bennett,7,0,32,25
1657093562549,MATH 142A,B03,093481,Chow; Bennett,8,0,32,24
1657093562549,MATH 142A,B04,093558,Chow; Bennett,11,0,32,21
1657093562549,MATH 142A,B05,093559,Chow; Bennett,6,0,32,26
1657093568584,MATH 193A,A01,083224,Rotar; Vladimir,7,0,34,27
1657093568584,MATH 193A,A02,083225,Rotar; Vladimir,5,0,34,29
1657093568584,MATH 193A,A03,083781,Rotar; Vladimir,1,0,34,33
1657093568584,MATH 193A,A04,083782,Rotar; Vladimir,6,0,34,28
1657093568584,MATH 193A,A05,093482,Rotar; Vladimir,6,0,34,28
1657093574609,MATH 197,001,091859,McAuley; Julian John,9999,0,9999,0
1657093574609,MATH 197,002,095566,Kedlaya; Kiran S.,9997,0,9999,2
1657093574609,MATH 197,003,095567,Xiao; Ming,9999,0,9999,0
1657093574609,MATH 197,004,095571,Perols; Johan Lars,9998,0,9999,1
1657093581688,COGS 9,A01,083615,Shannon; Kyle Michael,7,0,75,68
1657093587714,COGS 11,A01,083617,Boyle; Mary E. T.,21,0,48,27
1657093593744,COGS 13,A01,083071,Bastos; Amalia Pinkusfeld,9,0,71,62
1657093599775,COGS 14A,A01,092681,Semenuks; Arturs,1,1,100,99
1657093605800,COGS 14B,A01,083073,Cheng; Tzu-Han,6,0,63,57
1657093611831,COGS 17,A01,092677,Semenuks; Arturs,4,0,81,77
1657093617865,COGS 100,A01,083619,Allen; Michael Gordon,15,0,70,55
1657093623894,COGS 101A,A01,083621,Davis; Joshua Daniel,9,0,68,59
1657093629919,COGS 101B,A01,091572,Allen; Michael Gordon,8,0,65,57
1657093635944,COGS 101C,A01,083625,Delgado; Tania,17,0,35,18
1657093641974,COGS 107A,A01,083627,Boyle; Mary E. T.,13,0,60,47
1657093648003,COGS 118A,A01,083075,Gupta; Anjum,15,0,76,61
1657093654036,CSE 3,A50,083646,Miranda; Gregory Joseph,22,0,50,28
1657093660062,CSE 8A,A50,083650,Miranda; Gregory Joseph,17,1,56,39
1657093666086,CSE 11,A01,083080,Cao; Yingjun,4,15,40,36
1657093672118,CSE 12,A01,083652,Krause-Levy; Sophia Louisa,23,1,120,97
1657093678144,CSE 15L,A01,083654,Morris; Justin Loren,9,0,50,41
1657093678144,CSE 15L,A02,083655,Morris; Justin Loren,9,0,50,41
1657093684169,CSE 20,A01,083657,Tran; Khoa Dang,37,0,80,43
1657093690194,CSE 21,A01,095574,Bach; Quang Tran,21,0,48,27
1657093696220,CSE 30,A01,083084,Eldon; John,4,0,80,76
1657093696220,CSE 30,B01,095061,Bhaskar; Nishant,6,0,50,44
1657093702248,CSE 100,A01,083659,Cao; Yingjun,4,4,70,66
1657093708279,CSE 134B,A01,083661,Powell; Thomas Allan,19,0,100,81
1657093714312,CSE 140,A01,083663,Gungor; Onat,14,0,85,71
1657093720340,CSE 140L,A01,083088,Eldon; John,16,0,100,84
1657093726371,CSE 175,A01,083665,Kumar; Rakesh,3,0,25,22
1657093732402,CSE 190,A00,092507,Dubnov; Shlomo,7,0,20,13
1657093738428,ECE 45,A01,083139,Congero; Spencer William,5,0,75,70
1657093744464,ECE 65,A50,083695,Saad; Andrew S,12,0,30,18
1657093744464,ECE 65,A51,095125,Saad; Andrew S,25,0,26,1
1657093750496,ECE 109,A01,091882,Touri; Behrouz,16,0,70,54
1657093756528,ECE 180,A00,083140,Abi Samra; Nicholas Camill,1,0,30,29
1657093756528,ECE 180,B00,083141,Abi Samra; Nicholas Camill,0,0,30,30
1657093762566,MATH 10A,A01,083735,Patchell; Gregory David,1,0,30,29
1657093762566,MATH 10A,A02,083736,Patchell; Gregory David,20,0,30,10
1657093762566,MATH 10A,A03,083737,Patchell; Gregory David,16,0,30,14
1657093768594,MATH 10B,A01,083207,Lim; Seonhee,7,0,34,27
1657093768594,MATH 10B,A02,083208,Lim; Seonhee,9,0,35,26
1657093768594,MATH 10B,A03,093472,Lim; Seonhee,5,0,34,29
1657093768594,MATH 10B,B01,083739,Sinha; Shubham,9,0,30,21
1657093774636,MATH 18,A01,083743,Cinel; Cameron Alexander,6,0,30,24
1657093774636,MATH 18,A02,083744,Cinel; Cameron Alexander,15,0,30,15
1657093774636,MATH 18,A03,083745,Cinel; Cameron Alexander,8,0,30,22
1657093774636,MATH 18,B01,083748,Rideout; David Porter,4,0,37,33
1657093774636,MATH 18,B02,083749,Rideout; David Porter,3,0,36,33
1657093774636,MATH 18,B03,083750,Rideout; David Porter,2,0,37,35
1657093774636,MATH 18,B04,083751,Rideout; David Porter,5,0,36,31
1657093774636,MATH 18,B05,093473,Rideout; David Porter,4,0,36,32
1657093774636,MATH 18,B06,093474,Rideout; David Porter,5,0,36,31
1657093780670,MATH 20A,A01,083754,Zheng; Zequn,12,0,40,28
1657093786704,MATH 20B,A01,083756,Briones; Jor-el Thomas Caparas,1,0,36,35
1657093786704,MATH 20B,A02,083757,Briones; Jor-el Thomas Caparas,1,0,36,35
1657093786704,MATH 20B,A03,093475,Briones; Jor-el Thomas Caparas,0,0,36,36
1657093792731,MATH 20C,A01,083760,Briones; Jor-el Thomas Caparas,1,0,35,34
1657093792731,MATH 20C,A02,083761,Briones; Jor-el Thomas Caparas,8,0,35,27
1657093792731,MATH 20C,A03,093476,Briones; Jor-el Thomas Caparas,0,1,36,36
1657093792731,MATH 20C,B01,083762,Bach; Quang Tran,0,0,30,30
1657093798755,MATH 20D,A01,083765,Tran; Brian Kha,4,0,30,26
1657093798755,MATH 20D,A02,083766,Tran; Brian Kha,5,0,30,25
1657093798755,MATH 20D,A03,083767,Tran; Brian Kha,3,0,30,27
1657093804782,MATH 20E,A01,083771,Ganguly; Soumya,6,0,32,26
1657093804782,MATH 20E,A02,083772,Ganguly; Soumya,6,0,32,26
1657093804782,MATH 20E,B01,083773,Ciotti; Benjamin,18,0,35,17
1657093804782,MATH 20E,B02,083774,Ciotti; Benjamin,17,0,35,18
1657093810827,MATH 103A,A01,083777,Greenfeld; Be'Eri,2,0,36,34
1657093810827,MATH 103A,A02,083778,Greenfeld; Be'Eri,5,0,36,31
1657093810827,MATH 103A,A03,093561,Greenfeld; Be'Eri,4,0,36,32
1657093810827,MATH 103A,B01,083779,Greenfeld; Be'Eri,6,0,36,30
1657093810827,MATH 103A,B02,083780,Greenfeld; Be'Eri,2,0,36,34
1657093810827,MATH 103A,B03,093562,Greenfeld; Be'Eri,3,0,36,33
1657093816855,MATH 105,A01,085443,Carter; Anne Toulson,14,0,35,21
1657093816855,MATH 105,A02,093477,Carter; Anne Toulson,20,0,35,15
1657093822880,MATH 109,A01,083213,Ganzberger; Geoffrey Michael,2,0,34,32
1657093822880,MATH 109,A02,083214,Ganzberger; Geoffrey Michael,3,0,34,31
1657093822880,MATH 109,A03,093478,Ganzberger; Geoffrey Michael,1,0,34,33
1657093822880,MATH 109,B01,083215,Ganzberger; Geoffrey Michael,1,0,32,31
1657093822880,MATH 109,B02,083216,Ganzberger; Geoffrey Michael,1,0,32,31
1657093822880,MATH 109,B03,093479,Ganzberger; Geoffrey Michael,6,0,32,26
1657093828907,MATH 142A,A01,083219,Chow; Bennett,6,0,32,26
1657093828907,MATH 142A,A02,083220,Chow; Bennett,10,0,32,22
1657093828907,MATH 142A,A03,093480,Chow; Bennett,7,0,32,25
1657093828907,MATH 142A,B03,093481,Chow; Bennett,8,0,32,24
1657093828907,MATH 142A,B04,093558,Chow; Bennett,11,0,32,21
1657093828907,MATH 142A,B05,093559,Chow; Bennett,6,0,32,26
1657093834940,MATH 193A,A01,083224,Rotar; Vladimir,7,0,34,27
1657093834940,MATH 193A,A02,083225,Rotar; Vladimir,5,0,34,29
1657093834940,MATH 193A,A03,083781,Rotar; Vladimir,1,0,34,33
1657093834940,MATH 193A,A04,083782,Rotar; Vladimir,6,0,34,28
1657093834940,MATH 193A,A05,093482,Rotar; Vladimir,6,0,34,28
1657093840969,MATH 197,001,091859,McAuley; Julian John,9999,0,9999,0
1657093840969,MATH 197,002,095566,Kedlaya; Kiran S.,9997,0,9999,2
1657093840969,MATH 197,003,095567,Xiao; Ming,9999,0,9999,0
1657093840969,MATH 197,004,095571,Perols; Johan Lars,9998,0,9999,1
1657093848053,COGS 9,A01,083615,Shannon; Kyle Michael,7,0,75,68
1657093854079,COGS 11,A01,083617,Boyle; Mary E. T.,21,0,48,27
1657093860104,COGS 13,A01,083071,Bastos; Amalia Pinkusfeld,9,0,71,62
1657093866135,COGS 14A,A01,092681,Semenuks; Arturs,1,1,100,99
1657093872169,COGS 14B,A01,083073,Cheng; Tzu-Han,6,0,63,57
1657093878197,COGS 17,A01,092677,Semenuks; Arturs,4,0,81,77
1657093884225,COGS 100,A01,083619,Allen; Michael Gordon,15,0,70,55
1657093890253,COGS 101A,A01,083621,Davis; Joshua Daniel,9,0,68,59
1657093896278,COGS 101B,A01,091572,Allen; Michael Gordon,8,0,65,57
1657093902304,COGS 101C,A01,083625,Delgado; Tania,17,0,35,18
1657093908326,COGS 107A,A01,083627,Boyle; Mary E. T.,13,0,60,47
1657093914350,COGS 118A,A01,083075,Gupta; Anjum,15,0,76,61
1657093920376,CSE 3,A50,083646,Miranda; Gregory Joseph,22,0,50,28
1657093926401,CSE 8A,A50,083650,Miranda; Gregory Joseph,17,1,56,39
1657093932424,CSE 11,A01,083080,Cao; Yingjun,4,15,40,36
1657093938456,CSE 12,A01,083652,Krause-Levy; Sophia Louisa,23,1,120,97
1657093944489,CSE 15L,A01,083654,Morris; Justin Loren,9,0,50,41
1657093944489,CSE 15L,A02,083655,Morris; Justin Loren,9,0,50,41
1657093950514,CSE 20,A01,083657,Tran; Khoa Dang,37,0,80,43
1657093956540,CSE 21,A01,095574,Bach; Quang Tran,21,0,48,27
1657093962573,CSE 30,A01,083084,Eldon; John,4,0,80,76
1657093962573,CSE 30,B01,095061,Bhaskar; Nishant,6,0,50,44
1657093968606,CSE 100,A01,083659,Cao; Yingjun,4,4,70,66
1657093974641,CSE 134B,A01,083661,Powell; Thomas Allan,19,0,100,81
1657093980672,CSE 140,A01,083663,Gungor; Onat,14,0,85,71
1657093986710,CSE 140L,A01,083088,Eldon; John,16,0,100,84
1657093992739,CSE 175,A01,083665,Kumar; Rakesh,3,0,25,22
1657093998762,CSE 190,A00,092507,Dubnov; Shlomo,7,0,20,13
1657094004787,ECE 45,A01,083139,Congero; Spencer William,5,0,75,70
1657094010819,ECE 65,A50,083695,Saad; Andrew S,12,0,30,18
1657094010819,ECE 65,A51,095125,Saad; Andrew S,25,0,26,1
1657094016847,ECE 109,A01,091882,Touri; Behrouz,16,0,70,54
1657094022873,ECE 180,A00,083140,Abi Samra; Nicholas Camill,1,0,30,29
1657094022873,ECE 180,B00,083141,Abi Samra; Nicholas Camill,0,0,30,30
1657094028901,MATH 10A,A01,083735,Patchell; Gregory David,1,0,30,29
1657094028901,MATH 10A,A02,083736,Patchell; Gregory David,20,0,30,10
1657094028901,MATH 10A,A03,083737,Patchell; Gregory David,16,0,30,14
1657094034943,MATH 10B,A01,083207,Lim; Seonhee,7,0,34,27
1657094034943,MATH 10B,A02,083208,Lim; Seonhee,9,0,35,26
1657094034943,MATH 10B,A03,093472,Lim; Seonhee,5,0,34,29
1657094034943,MATH 10B,B01,083739,Sinha; Shubham,9,0,30,21
1657094040973,MATH 18,A01,083743,Cinel; Cameron Alexander,6,0,30,24
1657094040973,MATH 18,A02,083744,Cinel; Cameron Alexander,15,0,30,15
1657094040973,MATH 18,A03,083745,Cinel; Cameron Alexander,8,0,30,22
1657094040973,MATH 18,B01,083748,Rideout; David Porter,4,0,37,33
1657094040973,MATH 18,B02,083749,Rideout; David Porter,3,0,36,33
1657094040973,MATH 18,B03,083750,Rideout; David Porter,2,0,37,35
1657094040973,MATH 18,B04,083751,Rideout; David Porter,5,0,36,31
1657094040973,MATH 18,B05,093473,Rideout; David Porter,4,0,36,32
1657094040973,MATH 18,B06,093474,Rideout; David Porter,5,0,36,31
1657094046999,MATH 20A,A01,083754,Zheng; Zequn,12,0,40,28
1657094053023,MATH 20B,A01,083756,Briones; Jor-el Thomas Caparas,1,0,36,35
1657094053023,MATH 20B,A02,083757,Briones; Jor-el Thomas Caparas,1,0,36,35
1657094053023,MATH 20B,A03,093475,Briones; Jor-el Thomas Caparas,0,0,36,36
1657094059057,MATH 20C,A01,083760,Briones; Jor-el Thomas Caparas,1,0,35,34
1657094059057,MATH 20C,A02,083761,Briones; Jor-el Thomas Caparas,8,0,35,27
1657094059057,MATH 20C,A03,093476,Briones; Jor-el Thomas Caparas,0,1,36,36
1657094059057,MATH 20C,B01,083762,Bach; Quang Tran,0,0,30,30
1657094065089,MATH 20D,A01,083765,Tran; Brian Kha,4,0,30,26
1657094065089,MATH 20D,A02,083766,Tran; Brian Kha,5,0,30,25
1657094065089,MATH 20D,A03,083767,Tran; Brian Kha,3,0,30,27
1657094071125,MATH 20E,A01,083771,Ganguly; Soumya,6,0,32,26
1657094071125,MATH 20E,A02,083772,Ganguly; Soumya,6,0,32,26
1657094071125,MATH 20E,B01,083773,Ciotti; Benjamin,18,0,35,17
1657094071125,MATH 20E,B02,083774,Ciotti; Benjamin,17,0,35,18
1657094077161,MATH 103A,A01,083777,Greenfeld; Be'Eri,2,0,36,34
1657094077161,MATH 103A,A02,083778,Greenfeld; Be'Eri,5,0,36,31
1657094077161,MATH 103A,A03,093561,Greenfeld; Be'Eri,4,0,36,32
1657094077161,MATH 103A,B01,083779,Greenfeld; Be'Eri,6,0,36,30
1657094077161,MATH 103A,B02,083780,Greenfeld; Be'Eri,2,0,36,34
1657094077161,MATH 103A,B03,093562,Greenfeld; Be'Eri,3,0,36,33
1657094083191,MATH 105,A01,085443,Carter; Anne Toulson,14,0,35,21
1657094083191,MATH 105,A02,093477,Carter; Anne Toulson,20,0,35,15
1657094089224,MATH 109,A01,083213,Ganzberger; Geoffrey Michael,2,0,34,32
1657094089224,MATH 109,A02,083214,Ganzberger; Geoffrey Michael,3,0,34,31
1657094089224,MATH 109,A03,093478,Ganzberger; Geoffrey Michael,1,0,34,33
1657094089224,MATH 109,B01,083215,Ganzberger; Geoffrey Michael,1,0,32,31
1657094089224,MATH 109,B02,083216,Ganzberger; Geoffrey Michael,1,0,32,31
1657094089224,MATH 109,B03,093479,Ganzberger; Geoffrey Michael,6,0,32,26
1657094095251,MATH 142A,A01,083219,Chow; Bennett,6,0,32,26
1657094095251,MATH 142A,A02,083220,Chow; Bennett,10,0,32,22
1657094095251,MATH 142A,A03,093480,Chow; Bennett,7,0,32,25
1657094095251,MATH 142A,B03,093481,Chow; Bennett,8,0,32,24
1657094095251,MATH 142A,B04,093558,Chow; Bennett,11,0,32,21
1657094095251,MATH 142A,B05,093559,Chow; Bennett,6,0,32,26
1657094101274,MATH 193A,A01,083224,Rotar; Vladimir,7,0,34,27
1657094101274,MATH 193A,A02,083225,Rotar; Vladimir,5,0,34,29
1657094101274,MATH 193A,A03,083781,Rotar; Vladimir,1,0,34,33
1657094101274,MATH 193A,A04,083782,Rotar; Vladimir,6,0,34,28
1657094101274,MATH 193A,A05,093482,Rotar; Vladimir,6,0,34,28
1657094107299,MATH 197,001,091859,McAuley; Julian John,9999,0,9999,0
1657094107299,MATH 197,002,095566,Kedlaya; Kiran S.,9997,0,9999,2
1657094107299,MATH 197,003,095567,Xiao; Ming,9999,0,9999,0
1657094107299,MATH 197,004,095571,Perols; Johan Lars,9998,0,9999,1
1657094114465,COGS 9,A01,083615,Shannon; Kyle Michael,7,0,75,68
1657094120489,COGS 11,A01,083617,Boyle; Mary E. T.,21,0,48,27
1657094126512,COGS 13,A01,083071,Bastos; Amalia Pinkusfeld,9,0,71,62
1657094132536,COGS 14A,A01,092681,Semenuks; Arturs,1,1,100,99
1657094138560,COGS 14B,A01,083073,Cheng; Tzu-Han,6,0,63,57
1657094144584,COGS 17,A01,092677,Semenuks; Arturs,4,0,81,77
1657094150614,COGS 100,A01,083619,Allen; Michael Gordon,15,0,70,55
1657094156641,COGS 101A,A01,083621,Davis; Joshua Daniel,9,0,68,59
1657094162665,COGS 101B,A01,091572,Allen; Michael Gordon,8,0,65,57
1657094168690,COGS 101C,A01,083625,Delgado; Tania,17,0,35,18
1657094174714,COGS 107A,A01,083627,Boyle; Mary E. T.,13,0,60,47
1657094180736,COGS 118A,A01,083075,Gupta; Anjum,15,0,76,61
1657094186762,CSE 3,A50,083646,Miranda; Gregory Joseph,22,0,50,28
1657094192792,CSE 8A,A50,083650,Miranda; Gregory Joseph,17,1,56,39
1657094198818,CSE 11,A01,083080,Cao; Yingjun,4,15,40,36
1657094204847,CSE 12,A01,083652,Krause-Levy; Sophia Louisa,23,1,120,97
1657094210876,CSE 15L,A01,083654,Morris; Justin Loren,9,0,50,41
1657094210876,CSE 15L,A02,083655,Morris; Justin Loren,9,0,50,41
1657094216901,CSE 20,A01,083657,Tran; Khoa Dang,37,0,80,43
1657094222933,CSE 21,A01,095574,Bach; Quang Tran,21,0,48,27
1657094228963,CSE 30,A01,083084,Eldon; John,4,0,80,76
1657094228963,CSE 30,B01,095061,Bhaskar; Nishant,6,0,50,44
1657094234988,CSE 100,A01,083659,Cao; Yingjun,4,4,70,66
1657094241011,CSE 134B,A01,083661,Powell; Thomas Allan,19,0,100,81
1657094247037,CSE 140,A01,083663,Gungor; Onat,14,0,85,71
1657094253060,CSE 140L,A01,083088,Eldon; John,16,0,100,84
1657094259089,CSE 175,A01,083665,Kumar; Rakesh,3,0,25,22
1657094265112,CSE 190,A00,092507,Dubnov; Shlomo,7,0,20,13
1657094271144,ECE 45,A01,083139,Congero; Spencer William,5,0,75,70
1657094277171,ECE 65,A50,083695,Saad; Andrew S,12,0,30,18
1657094277171,ECE 65,A51,095125,Saad; Andrew S,25,0,26,1
1657094283198,ECE 109,A01,091882,Touri; Behrouz,16,0,70,54
1657094289246,ECE 180,A00,083140,Abi Samra; Nicholas Camill,1,0,30,29
1657094289246,ECE 180,B00,083141,Abi Samra; Nicholas Camill,0,0,30,30
1657094295292,MATH 10A,A01,083735,Patchell; Gregory David,1,0,30,29
1657094295292,MATH 10A,A02,083736,Patchell; Gregory David,20,0,30,10
1657094295292,MATH 10A,A03,083737,Patchell; Gregory David,16,0,30,14
1657094301322,MATH 10B,A01,083207,Lim; Seonhee,7,0,34,27
1657094301322,MATH 10B,A02,083208,Lim; Seonhee,9,0,35,26
1657094301322,MATH 10B,A03,093472,Lim; Seonhee,5,0,34,29
1657094301322,MATH 10B,B01,083739,Sinha; Shubham,9,0,30,21
1657094307359,MATH 18,A01,083743,Cinel; Cameron Alexander,6,0,30,24
1657094307359,MATH 18,A02,083744,Cinel; Cameron Alexander,15,0,30,15
1657094307359,MATH 18,A03,083745,Cinel; Cameron Alexander,8,0,30,22
1657094307359,MATH 18,B01,083748,Rideout; David Porter,4,0,37,33
1657094307359,MATH 18,B02,083749,Rideout; David Porter,3,0,36,33
1657094307359,MATH 18,B03,083750,Rideout; David Porter,2,0,37,35
1657094307359,MATH 18,B04,083751,Rideout; David Porter,5,0,36,31
1657094307359,MATH 18,B05,093473,Rideout; David Porter,4,0,36,32
1657094307359,MATH 18,B06,093474,Rideout; David Porter,5,0,36,31
1657094313382,MATH 20A,A01,083754,Zheng; Zequn,12,0,40,28
1657094319409,MATH 20B,A01,083756,Briones; Jor-el Thomas Caparas,1,0,36,35
1657094319409,MATH 20B,A02,083757,Briones; Jor-el Thomas Caparas,1,0,36,35
1657094319409,MATH 20B,A03,093475,Briones; Jor-el Thomas Caparas,0,0,36,36
1657094325434,MATH 20C,A01,083760,Briones; Jor-el Thomas Caparas,1,0,35,34
1657094325434,MATH 20C,A02,083761,Briones; Jor-el Thomas Caparas,8,0,35,27
1657094325434,MATH 20C,A03,093476,Briones; Jor-el Thomas Caparas,0,1,36,36
1657094325434,MATH 20C,B01,083762,Bach; Quang Tran,0,0,30,30
1657094331457,MATH 20D,A01,083765,Tran; Brian Kha,4,0,30,26
1657094331457,MATH 20D,A02,083766,Tran; Brian Kha,5,0,30,25
1657094331457,MATH 20D,A03,083767,Tran; Brian Kha,3,0,30,27
1657094337483,MATH 20E,A01,083771,Ganguly; Soumya,6,0,32,26
1657094337483,MATH 20E,A02,083772,Ganguly; Soumya,6,0,32,26
1657094337483,MATH 20E,B01,083773,Ciotti; Benjamin,18,0,35,17
1657094337483,MATH 20E,B02,083774,Ciotti; Benjamin,17,0,35,18
1657094343509,MATH 103A,A01,083777,Greenfeld; Be'Eri,2,0,36,34
1657094343509,MATH 103A,A02,083778,Greenfeld; Be'Eri,5,0,36,31
1657094343509,MATH 103A,A03,093561,Greenfeld; Be'Eri,4,0,36,32
1657094343509,MATH 103A,B01,083779,Greenfeld; Be'Eri,6,0,36,30
1657094343509,MATH 103A,B02,083780,Greenfeld; Be'Eri,2,0,36,34
1657094343509,MATH 103A,B03,093562,Greenfeld; Be'Eri,3,0,36,33
1657094349534,MATH 105,A01,085443,Carter; Anne Toulson,14,0,35,21
1657094349534,MATH 105,A02,093477,Carter; Anne Toulson,20,0,35,15
1657094355559,MATH 109,A01,083213,Ganzberger; Geoffrey Michael,2,0,34,32
1657094355559,MATH 109,A02,083214,Ganzberger; Geoffrey Michael,3,0,34,31
1657094355559,MATH 109,A03,093478,Ganzberger; Geoffrey Michael,1,0,34,33
1657094355559,MATH 109,B01,083215,Ganzberger; Geoffrey Michael,1,0,32,31
1657094355559,MATH 109,B02,083216,Ganzberger; Geoffrey Michael,1,0,32,31
1657094355559,MATH 109,B03,093479,Ganzberger; Geoffrey Michael,6,0,32,26
1657094361586,MATH 142A,A01,083219,Chow; Bennett,6,0,32,26
1657094361586,MATH 142A,A02,083220,Chow; Bennett,10,0,32,22
1657094361586,MATH 142A,A03,093480,Chow; Bennett,7,0,32,25
1657094361586,MATH 142A,B03,093481,Chow; Bennett,8,0,32,24
1657094361586,MATH 142A,B04,093558,Chow; Bennett,11,0,32,21
1657094361586,MATH 142A,B05,093559,Chow; Bennett,6,0,32,26
1657094367610,MATH 193A,A01,083224,Rotar; Vladimir,7,0,34,27
1657094367610,MATH 193A,A02,083225,Rotar; Vladimir,5,0,34,29
1657094367610,MATH 193A,A03,083781,Rotar; Vladimir,1,0,34,33
1657094367610,MATH 193A,A04,083782,Rotar; Vladimir,6,0,34,28
1657094367610,MATH 193A,A05,093482,Rotar; Vladimir,6,0,34,28
1657094373634,MATH 197,001,091859,McAuley; Julian John,9999,0,9999,0
1657094373634,MATH 197,002,095566,Kedlaya; Kiran S.,9997,0,9999,2
1657094373634,MATH 197,003,095567,Xiao; Ming,9999,0,9999,0
1657094373634,MATH 197,004,095571,Perols; Johan Lars,9998,0,9999,1
1657094380700,COGS 9,A01,083615,Shannon; Kyle Michael,7,0,75,68
1657094386724,COGS 11,A01,083617,Boyle; Mary E. T.,21,0,48,27
1657094392749,COGS 13,A01,083071,Bastos; Amalia Pinkusfeld,9,0,71,62
1657094398778,COGS 14A,A01,092681,Semenuks; Arturs,1,1,100,99
1657094404803,COGS 14B,A01,083073,Cheng; Tzu-Han,6,0,63,57
1657094410831,COGS 17,A01,092677,Semenuks; Arturs,4,0,81,77
1657094416856,COGS 100,A01,083619,Allen; Michael Gordon,15,0,70,55
1657094422884,COGS 101A,A01,083621,Davis; Joshua Daniel,9,0,68,59
1657094428907,COGS 101B,A01,091572,Allen; Michael Gordon,8,0,65,57
1657094434939,COGS 101C,A01,083625,Delgado; Tania,17,0,35,18
1657094440966,COGS 107A,A01,083627,Boyle; Mary E. T.,13,0,60,47
1657094446990,COGS 118A,A01,083075,Gupta; Anjum,15,0,76,61
1657094453020,CSE 3,A50,083646,Miranda; Gregory Joseph,22,0,50,28
1657094459048,CSE 8A,A50,083650,Miranda; Gregory Joseph,17,1,56,39
1657094465071,CSE 11,A01,083080,Cao; Yingjun,4,15,40,36
1657094471096,CSE 12,A01,083652,Krause-Levy; Sophia Louisa,23,1,120,97
1657094477124,CSE 15L,A01,083654,Morris; Justin Loren,9,0,50,41
1657094477124,CSE 15L,A02,083655,Morris; Justin Loren,9,0,50,41
1657094483154,CSE 20,A01,083657,Tran; Khoa Dang,37,0,80,43
1657094489186,CSE 21,A01,095574,Bach; Quang Tran,21,0,48,27
1657094495212,CSE 30,A01,083084,Eldon; John,4,0,80,76
1657094495212,CSE 30,B01,095061,Bhaskar; Nishant,6,0,50,44
1657094501243,CSE 100,A01,083659,Cao; Yingjun,4,4,70,66
1657094507268,CSE 134B,A01,083661,Powell; Thomas Allan,19,0,100,81
1657094513293,CSE 140,A01,083663,Gungor; Onat,14,0,85,71
1657094519319,CSE 140L,A01,083088,Eldon; John,16,0,100,84
1657094525344,CSE 175,A01,083665,Kumar; Rakesh,3,0,25,22
1657094531369,CSE 190,A00,092507,Dubnov; Shlomo,7,0,20,13
1657094537394,ECE 45,A01,083139,Congero; Spencer William,5,0,75,70
1657094543419,ECE 65,A50,083695,Saad; Andrew S,12,0,30,18
1657094543419,ECE 65,A51,095125,Saad; Andrew S,25,0,26,1
1657094549450,ECE 109,A01,091882,Touri; Behrouz,16,0,70,54
1657094555476,ECE 180,A00,083140,Abi Samra; Nicholas Camill,1,0,30,29
1657094555476,ECE 180,B00,083141,Abi Samra; Nicholas Camill,0,0,30,30
1657094561503,MATH 10A,A01,083735,Patchell; Gregory David,1,0,30,29
1657094561503,MATH 10A,A02,083736,Patchell; Gregory David,20,0,30,10
1657094561503,MATH 10A,A03,083737,Patchell; Gregory David,16,0,30,14
1657094567537,MATH 10B,A01,083207,Lim; Seonhee,7,0,34,27
1657094567537,MATH 10B,A02,083208,Lim; Seonhee,9,0,35,26
1657094567537,MATH 10B,A03,093472,Lim; Seonhee,5,0,34,29
1657094567537,MATH 10B,B01,083739,Sinha; Shubham,9,0,30,21
1657094573572,MATH 18,A01,083743,Cinel; Cameron Alexander,6,0,30,24
1657094573572,MATH 18,A02,083744,Cinel; Cameron Alexander,15,0,30,15
1657094573572,MATH 18,A03,083745,Cinel; Cameron Alexander,8,0,30,22
1657094573572,MATH 18,B01,083748,Rideout; David Porter,4,0,37,33
1657094573572,MATH 18,B02,083749,Rideout; David Porter,3,0,36,33
1657094573572,MATH 18,B03,083750,Rideout; David Porter,2,0,37,35
1657094573572,MATH 18,B04,083751,Rideout; David Porter,5,0,36,31
1657094573572,MATH 18,B05,093473,Rideout; David Porter,4,0,36,32
1657094573572,MATH 18,B06,093474,Rideout; David Porter,5,0,36,31
1657094579597,MATH 20A,A01,083754,Zheng; Zequn,12,0,40,28
1657094585623,MATH 20B,A01,083756,Briones; Jor-el Thomas Caparas,1,0,36,35
1657094585623,MATH 20B,A02,083757,Briones; Jor-el Thomas Caparas,1,0,36,35
1657094585623,MATH 20B,A03,093475,Briones; Jor-el Thomas Caparas,0,0,36,36
1657094591648,MATH 20C,A01,083760,Briones; Jor-el Thomas Caparas,1,0,35,34
1657094591648,MATH 20C,A02,083761,Briones; Jor-el Thomas Caparas,8,0,35,27
1657094591648,MATH 20C,A03,093476,Briones; Jor-el Thomas Caparas,0,1,36,36
1657094591648,MATH 20C,B01,083762,Bach; Quang Tran,0,0,30,30
1657094597683,MATH 20D,A01,083765,Tran; Brian Kha,4,0,30,26
1657094597683,MATH 20D,A02,083766,Tran; Brian Kha,5,0,30,25
1657094597683,MATH 20D,A03,083767,Tran; Brian Kha,3,0,30,27
1657094603708,MATH 20E,A01,083771,Ganguly; Soumya,6,0,32,26
1657094603708,MATH 20E,A02,083772,Ganguly; Soumya,6,0,32,26
1657094603708,MATH 20E,B01,083773,Ciotti; Benjamin,18,0,35,17
1657094603708,MATH 20E,B02,083774,Ciotti; Benjamin,17,0,35,18
1657094609741,MATH 103A,A01,083777,Greenfeld; Be'Eri,2,0,36,34
1657094609741,MATH 103A,A02,083778,Greenfeld; Be'Eri,5,0,36,31
1657094609741,MATH 103A,A03,093561,Greenfeld; Be'Eri,4,0,36,32
1657094609741,MATH 103A,B01,083779,Greenfeld; Be'Eri,6,0,36,30
1657094609741,MATH 103A,B02,083780,Greenfeld; Be'Eri,2,0,36,34
1657094609741,MATH 103A,B03,093562,Greenfeld; Be'Eri,3,0,36,33
1657094615776,MATH 105,A01,085443,Carter; Anne Toulson,14,0,35,21
1657094615776,MATH 105,A02,093477,Carter; Anne Toulson,20,0,35,15
1657094621808,MATH 109,A01,083213,Ganzberger; Geoffrey Michael,2,0,34,32
1657094621808,MATH 109,A02,083214,Ganzberger; Geoffrey Michael,3,0,34,31
1657094621808,MATH 109,A03,093478,Ganzberger; Geoffrey Michael,1,0,34,33
1657094621808,MATH 109,B01,083215,Ganzberger; Geoffrey Michael,1,0,32,31
1657094621808,MATH 109,B02,083216,Ganzberger; Geoffrey Michael,1,0,32,31
1657094621808,MATH 109,B03,093479,Ganzberger; Geoffrey Michael,6,0,32,26
1657094627844,MATH 142A,A01,083219,Chow; Bennett,6,0,32,26
1657094627844,MATH 142A,A02,083220,Chow; Bennett,10,0,32,22
1657094627844,MATH 142A,A03,093480,Chow; Bennett,7,0,32,25
1657094627844,MATH 142A,B03,093481,Chow; Bennett,8,0,32,24
1657094627844,MATH 142A,B04,093558,Chow; Bennett,11,0,32,21
1657094627844,MATH 142A,B05,093559,Chow; Bennett,6,0,32,26
1657094633875,MATH 193A,A01,083224,Rotar; Vladimir,7,0,34,27
1657094633875,MATH 193A,A02,083225,Rotar; Vladimir,5,0,34,29
1657094633875,MATH 193A,A03,083781,Rotar; Vladimir,1,0,34,33
1657094633875,MATH 193A,A04,083782,Rotar; Vladimir,6,0,34,28
1657094633875,MATH 193A,A05,093482,Rotar; Vladimir,6,0,34,28
1657094639904,MATH 197,001,091859,McAuley; Julian John,9999,0,9999,0
1657094639904,MATH 197,002,095566,Kedlaya; Kiran S.,9997,0,9999,2
1657094639904,MATH 197,003,095567,Xiao; Ming,9999,0,9999,0
1657094639904,MATH 197,004,095571,Perols; Johan Lars,9998,0,9999,1
1657094646983,COGS 9,A01,083615,Shannon; Kyle Michael,7,0,75,68
1657094653006,COGS 11,A01,083617,Boyle; Mary E. T.,21,0,48,27
1657094659034,COGS 13,A01,083071,Bastos; Amalia Pinkusfeld,9,0,71,62
1657094665064,COGS 14A,A01,092681,Semenuks; Arturs,1,1,100,99
1657094671093,COGS 14B,A01,083073,Cheng; Tzu-Han,6,0,63,57
1657094677117,COGS 17,A01,092677,Semenuks; Arturs,4,0,81,77
1657094683147,COGS 100,A01,083619,Allen; Michael Gordon,15,0,70,55
1657094689170,COGS 101A,A01,083621,Davis; Joshua Daniel,9,0,68,59
1657094695197,COGS 101B,A01,091572,Allen; Michael Gordon,8,0,65,57
1657094701227,COGS 101C,A01,083625,Delgado; Tania,17,0,35,18
1657094707328,COGS 107A,A01,083627,Boyle; Mary E. T.,13,0,60,47
1657094713355,COGS 118A,A01,083075,Gupta; Anjum,15,0,76,61
1657094719386,CSE 3,A50,083646,Miranda; Gregory Joseph,22,0,50,28
1657094725410,CSE 8A,A50,083650,Miranda; Gregory Joseph,17,1,56,39
1657094731434,CSE 11,A01,083080,Cao; Yingjun,4,15,40,36
1657094737459,CSE 12,A01,083652,Krause-Levy; Sophia Louisa,23,1,120,97
1657094743483,CSE 15L,A01,083654,Morris; Justin Loren,9,0,50,41
1657094743483,CSE 15L,A02,083655,Morris; Justin Loren,9,0,50,41
1657094749510,CSE 20,A01,083657,Tran; Khoa Dang,37,0,80,43
1657094755539,CSE 21,A01,095574,Bach; Quang Tran,21,0,48,27
1657094761571,CSE 30,A01,083084,Eldon; John,4,0,80,76
1657094761571,CSE 30,B01,095061,Bhaskar; Nishant,6,0,50,44
1657094767600,CSE 100,A01,083659,Cao; Yingjun,4,4,70,66
1657094773627,CSE 134B,A01,083661,Powell; Thomas Allan,19,0,100,81
1657094779655,CSE 140,A01,083663,Gungor; Onat,14,0,85,71
1657094785681,CSE 140L,A01,083088,Eldon; John,16,0,100,84
1657094791706,CSE 175,A01,083665,Kumar; Rakesh,3,0,25,22
1657094797731,CSE 190,A00,092507,Dubnov; Shlomo,7,0,20,13
1657094803756,ECE 45,A01,083139,Congero; Spencer William,5,0,75,70
1657094809783,ECE 65,A50,083695,Saad; Andrew S,12,0,30,18
1657094809783,ECE 65,A51,095125,Saad; Andrew S,25,0,26,1
1657094815806,ECE 109,A01,091882,Touri; Behrouz,16,0,70,54
1657094821829,ECE 180,A00,083140,Abi Samra; Nicholas Camill,1,0,30,29
1657094821829,ECE 180,B00,083141,Abi Samra; Nicholas Camill,0,0,30,30
1657094827854,MATH 10A,A01,083735,Patchell; Gregory David,1,0,30,29
1657094827854,MATH 10A,A02,083736,Patchell; Gregory David,20,0,30,10
1657094827854,MATH 10A,A03,083737,Patchell; Gregory David,16,0,30,14
1657094833883,MATH 10B,A01,083207,Lim; Seonhee,7,0,34,27
1657094833883,MATH 10B,A02,083208,Lim; Seonhee,9,0,35,26
1657094833883,MATH 10B,A03,093472,Lim; Seonhee,5,0,34,29
1657094833883,MATH 10B,B01,083739,Sinha; Shubham,9,0,30,21
1657094839912,MATH 18,A01,083743,Cinel; Cameron Alexander,6,0,30,24
1657094839912,MATH 18,A02,083744,Cinel; Cameron Alexander,15,0,30,15
1657094839912,MATH 18,A03,083745,Cinel; Cameron Alexander,8,0,30,22
1657094839912,MATH 18,B01,083748,Rideout; David Porter,4,0,37,33
1657094839912,MATH 18,B02,083749,Rideout; David Porter,3,0,36,33
1657094839912,MATH 18,B03,083750,Rideout; David Porter,2,0,37,35
1657094839912,MATH 18,B04,083751,Rideout; David Porter,5,0,36,31
1657094839912,MATH 18,B05,093473,Rideout; David Porter,4,0,36,32
1657094839912,MATH 18,B06,093474,Rideout; David Porter,5,0,36,31
1657094845942,MATH 20A,A01,083754,Zheng; Zequn,12,0,40,28
1657094851971,MATH 20B,A01,083756,Briones; Jor-el Thomas Caparas,1,0,36,35
1657094851971,MATH 20B,A02,083757,Briones; Jor-el Thomas Caparas,1,0,36,35
1657094851971,MATH 20B,A03,093475,Briones; Jor-el Thomas Caparas,0,0,36,36
1657094858002,MATH 20C,A01,083760,Briones; Jor-el Thomas Caparas,1,0,35,34
1657094858002,MATH 20C,A02,083761,Briones; Jor-el Thomas Caparas,8,0,35,27
1657094858002,MATH 20C,A03,093476,Briones; Jor-el Thomas Caparas,0,1,36,36
1657094858002,MATH 20C,B01,083762,Bach; Quang Tran,0,0,30,30
1657094864036,MATH 20D,A01,083765,Tran; Brian Kha,4,0,30,26
1657094864036,MATH 20D,A02,083766,Tran; Brian Kha,5,0,30,25
1657094864036,MATH 20D,A03,083767,Tran; Brian Kha,3,0,30,27
1657094870062,MATH 20E,A01,083771,Ganguly; Soumya,6,0,32,26
1657094870062,MATH 20E,A02,083772,Ganguly; Soumya,6,0,32,26
1657094870062,MATH 20E,B01,083773,Ciotti; Benjamin,18,0,35,17
1657094870062,MATH 20E,B02,083774,Ciotti; Benjamin,17,0,35,18
1657094876091,MATH 103A,A01,083777,Greenfeld; Be'Eri,2,0,36,34
1657094876091,MATH 103A,A02,083778,Greenfeld; Be'Eri,5,0,36,31
1657094876091,MATH 103A,A03,093561,Greenfeld; Be'Eri,4,0,36,32
1657094876091,MATH 103A,B01,083779,Greenfeld; Be'Eri,6,0,36,30
1657094876091,MATH 103A,B02,083780,Greenfeld; Be'Eri,2,0,36,34
1657094876091,MATH 103A,B03,093562,Greenfeld; Be'Eri,3,0,36,33
1657094882117,MATH 105,A01,085443,Carter; Anne Toulson,14,0,35,21
1657094882117,MATH 105,A02,093477,Carter; Anne Toulson,20,0,35,15
1657094888146,MATH 109,A01,083213,Ganzberger; Geoffrey Michael,2,0,34,32
1657094888146,MATH 109,A02,083214,Ganzberger; Geoffrey Michael,3,0,34,31
1657094888146,MATH 109,A03,093478,Ganzberger; Geoffrey Michael,1,0,34,33
1657094888146,MATH 109,B01,083215,Ganzberger; Geoffrey Michael,1,0,32,31
1657094888146,MATH 109,B02,083216,Ganzberger; Geoffrey Michael,1,0,32,31
1657094888146,MATH 109,B03,093479,Ganzberger; Geoffrey Michael,6,0,32,26
1657094894171,MATH 142A,A01,083219,Chow; Bennett,6,0,32,26
1657094894171,MATH 142A,A02,083220,Chow; Bennett,10,0,32,22
1657094894171,MATH 142A,A03,093480,Chow; Bennett,7,0,32,25
1657094894171,MATH 142A,B03,093481,Chow; Bennett,8,0,32,24
1657094894171,MATH 142A,B04,093558,Chow; Bennett,11,0,32,21
1657094894171,MATH 142A,B05,093559,Chow; Bennett,6,0,32,26
1657094900201,MATH 193A,A01,083224,Rotar; Vladimir,7,0,34,27
1657094900201,MATH 193A,A02,083225,Rotar; Vladimir,5,0,34,29
1657094900201,MATH 193A,A03,083781,Rotar; Vladimir,1,0,34,33
1657094900201,MATH 193A,A04,083782,Rotar; Vladimir,6,0,34,28
1657094900201,MATH 193A,A05,093482,Rotar; Vladimir,6,0,34,28
1657094906224,MATH 197,001,091859,McAuley; Julian John,9999,0,9999,0
1657094906224,MATH 197,002,095566,Kedlaya; Kiran S.,9997,0,9999,2
1657094906224,MATH 197,003,095567,Xiao; Ming,9999,0,9999,0
1657094906224,MATH 197,004,095571,Perols; Johan Lars,9998,0,9999,1
1657094913286,COGS 9,A01,083615,Shannon; Kyle Michael,7,0,75,68
1657094919309,COGS 11,A01,083617,Boyle; Mary E. T.,21,0,48,27
1657094925337,COGS 13,A01,083071,Bastos; Amalia Pinkusfeld,9,0,71,62
1657094931362,COGS 14A,A01,092681,Semenuks; Arturs,1,1,100,99
1657094937391,COGS 14B,A01,083073,Cheng; Tzu-Han,6,0,63,57
1657094943415,COGS 17,A01,092677,Semenuks; Arturs,4,0,81,77
1657094949440,COGS 100,A01,083619,Allen; Michael Gordon,15,0,70,55
1657094955465,COGS 101A,A01,083621,Davis; Joshua Daniel,9,0,68,59
1657094961489,COGS 101B,A01,091572,Allen; Michael Gordon,8,0,65,57
1657094967514,COGS 101C,A01,083625,Delgado; Tania,17,0,35,18
1657094973541,COGS 107A,A01,083627,Boyle; Mary E. T.,13,0,60,47
1657094979569,COGS 118A,A01,083075,Gupta; Anjum,15,0,76,61
1657094985593,CSE 3,A50,083646,Miranda; Gregory Joseph,22,0,50,28
1657094991618,CSE 8A,A50,083650,Miranda; Gregory Joseph,17,1,56,39
1657094997643,CSE 11,A01,083080,Cao; Yingjun,4,15,40,36
1657095003668,CSE 12,A01,083652,Krause-Levy; Sophia Louisa,23,1,120,97
1657095009692,CSE 15L,A01,083654,Morris; Justin Loren,9,0,50,41
1657095009692,CSE 15L,A02,083655,Morris; Justin Loren,9,0,50,41
1657095015716,CSE 20,A01,083657,Tran; Khoa Dang,37,0,80,43
1657095021740,CSE 21,A01,095574,Bach; Quang Tran,21,0,48,27
1657095027766,CSE 30,A01,083084,Eldon; John,4,0,80,76
1657095027766,CSE 30,B01,095061,Bhaskar; Nishant,6,0,50,44
1657095033795,CSE 100,A01,083659,Cao; Yingjun,4,4,70,66
1657095039820,CSE 134B,A01,083661,Powell; Thomas Allan,19,0,100,81
1657095045845,CSE 140,A01,083663,Gungor; Onat,14,0,85,71
1657095051874,CSE 140L,A01,083088,Eldon; John,16,0,100,84
1657095057900,CSE 175,A01,083665,Kumar; Rakesh,3,0,25,22
1657095063925,CSE 190,A00,092507,Dubnov; Shlomo,7,0,20,13
1657095069950,ECE 45,A01,083139,Congero; Spencer William,5,0,75,70
1657095075975,ECE 65,A50,083695,Saad; Andrew S,12,0,30,18
1657095075975,ECE 65,A51,095125,Saad; Andrew S,25,0,26,1
1657095082006,ECE 109,A01,091882,Touri; Behrouz,16,0,70,54
1657095088042,ECE 180,A00,083140,Abi Samra; Nicholas Camill,1,0,30,29
1657095088042,ECE 180,B00,083141,Abi Samra; Nicholas Camill,0,0,30,30
1657095094068,MATH 10A,A01,083735,Patchell; Gregory David,1,0,30,29
1657095094068,MATH 10A,A02,083736,Patchell; Gregory David,20,0,30,10
1657095094068,MATH 10A,A03,083737,Patchell; Gregory David,16,0,30,14
1657095100106,MATH 10B,A01,083207,Lim; Seonhee,7,0,34,27
1657095100106,MATH 10B,A02,083208,Lim; Seonhee,9,0,35,26
1657095100106,MATH 10B,A03,093472,Lim; Seonhee,5,0,34,29
1657095100106,MATH 10B,B01,083739,Sinha; Shubham,9,0,30,21
1657095106134,MATH 18,A01,083743,Cinel; Cameron Alexander,6,0,30,24
1657095106134,MATH 18,A02,083744,Cinel; Cameron Alexander,15,0,30,15
1657095106134,MATH 18,A03,083745,Cinel; Cameron Alexander,8,0,30,22
1657095106134,MATH 18,B01,083748,Rideout; David Porter,4,0,37,33
1657095106134,MATH 18,B02,083749,Rideout; David Porter,3,0,36,33
1657095106134,MATH 18,B03,083750,Rideout; David Porter,2,0,37,35
1657095106134,MATH 18,B04,083751,Rideout; David Porter,5,0,36,31
1657095106134,MATH 18,B05,093473,Rideout; David Porter,4,0,36,32
1657095106134,MATH 18,B06,093474,Rideout; David Porter,5,0,36,31
1657095112158,MATH 20A,A01,083754,Zheng; Zequn,12,0,40,28
1657095118185,MATH 20B,A01,083756,Briones; Jor-el Thomas Caparas,1,0,36,35
1657095118185,MATH 20B,A02,083757,Briones; Jor-el Thomas Caparas,1,0,36,35
1657095118185,MATH 20B,A03,093475,Briones; Jor-el Thomas Caparas,0,0,36,36
1657095124219,MATH 20C,A01,083760,Briones; Jor-el Thomas Caparas,1,0,35,34
1657095124219,MATH 20C,A02,083761,Briones; Jor-el Thomas Caparas,8,0,35,27
1657095124219,MATH 20C,A03,093476,Briones; Jor-el Thomas Caparas,0,1,36,36
1657095124219,MATH 20C,B01,083762,Bach; Quang Tran,0,0,30,30
1657095130251,MATH 20D,A01,083765,Tran; Brian Kha,4,0,30,26
1657095130251,MATH 20D,A02,083766,Tran; Brian Kha,5,0,30,25
1657095130251,MATH 20D,A03,083767,Tran; Brian Kha,3,0,30,27
1657095136284,MATH 20E,A01,083771,Ganguly; Soumya,6,0,32,26
1657095136284,MATH 20E,A02,083772,Ganguly; Soumya,6,0,32,26
1657095136284,MATH 20E,B01,083773,Ciotti; Benjamin,18,0,35,17
1657095136284,MATH 20E,B02,083774,Ciotti; Benjamin,17,0,35,18
1657095142309,MATH 103A,A01,083777,Greenfeld; Be'Eri,2,0,36,34
1657095142309,MATH 103A,A02,083778,Greenfeld; Be'Eri,5,0,36,31
1657095142309,MATH 103A,A03,093561,Greenfeld; Be'Eri,4,0,36,32
1657095142309,MATH 103A,B01,083779,Greenfeld; Be'Eri,6,0,36,30
1657095142309,MATH 103A,B02,083780,Greenfeld; Be'Eri,2,0,36,34
1657095142309,MATH 103A,B03,093562,Greenfeld; Be'Eri,3,0,36,33
1657095148337,MATH 105,A01,085443,Carter; Anne Toulson,14,0,35,21
1657095148337,MATH 105,A02,093477,Carter; Anne Toulson,20,0,35,15
1657095154364,MATH 109,A01,083213,Ganzberger; Geoffrey Michael,2,0,34,32
1657095154364,MATH 109,A02,083214,Ganzberger; Geoffrey Michael,3,0,34,31
1657095154364,MATH 109,A03,093478,Ganzberger; Geoffrey Michael,1,0,34,33
1657095154364,MATH 109,B01,083215,Ganzberger; Geoffrey Michael,1,0,32,31
1657095154364,MATH 109,B02,083216,Ganzberger; Geoffrey Michael,1,0,32,31
1657095154364,MATH 109,B03,093479,Ganzberger; Geoffrey Michael,6,0,32,26
1657095160391,MATH 142A,A01,083219,Chow; Bennett,6,0,32,26
1657095160391,MATH 142A,A02,083220,Chow; Bennett,10,0,32,22
1657095160391,MATH 142A,A03,093480,Chow; Bennett,7,0,32,25
1657095160391,MATH 142A,B03,093481,Chow; Bennett,8,0,32,24
1657095160391,MATH 142A,B04,093558,Chow; Bennett,11,0,32,21
1657095160391,MATH 142A,B05,093559,Chow; Bennett,6,0,32,26
1657095166420,MATH 193A,A01,083224,Rotar; Vladimir,7,0,34,27
1657095166420,MATH 193A,A02,083225,Rotar; Vladimir,5,0,34,29
1657095166420,MATH 193A,A03,083781,Rotar; Vladimir,1,0,34,33
1657095166420,MATH 193A,A04,083782,Rotar; Vladimir,6,0,34,28
1657095166420,MATH 193A,A05,093482,Rotar; Vladimir,6,0,34,28
1657095172452,MATH 197,001,091859,McAuley; Julian John,9999,0,9999,0
1657095172452,MATH 197,002,095566,Kedlaya; Kiran S.,9997,0,9999,2
1657095172452,MATH 197,003,095567,Xiao; Ming,9999,0,9999,0
1657095172452,MATH 197,004,095571,Perols; Johan Lars,9998,0,9999,1
1657095179526,COGS 9,A01,083615,Shannon; Kyle Michael,7,0,75,68
1657095185551,COGS 11,A01,083617,Boyle; Mary E. T.,21,0,48,27
1657095191576,COGS 13,A01,083071,Bastos; Amalia Pinkusfeld,9,0,71,62
1657095197602,COGS 14A,A01,092681,Semenuks; Arturs,1,1,100,99
1657095203625,COGS 14B,A01,083073,Cheng; Tzu-Han,6,0,63,57
1657095209649,COGS 17,A01,092677,Semenuks; Arturs,4,0,81,77
1657095215673,COGS 100,A01,083619,Allen; Michael Gordon,15,0,70,55
1657095221732,COGS 101A,A01,083621,Davis; Joshua Daniel,9,0,68,59
1657095227773,COGS 101B,A01,091572,Allen; Michael Gordon,8,0,65,57
1657095233798,COGS 101C,A01,083625,Delgado; Tania,17,0,35,18
1657095239822,COGS 107A,A01,083627,Boyle; Mary E. T.,13,0,60,47
1657095245857,COGS 118A,A01,083075,Gupta; Anjum,15,0,76,61
1657095251883,CSE 3,A50,083646,Miranda; Gregory Joseph,22,0,50,28
1657095257908,CSE 8A,A50,083650,Miranda; Gregory Joseph,17,1,56,39
1657095263936,CSE 11,A01,083080,Cao; Yingjun,4,15,40,36
1657095269967,CSE 12,A01,083652,Krause-Levy; Sophia Louisa,23,1,120,97
1657095275990,CSE 15L,A01,083654,Morris; Justin Loren,9,0,50,41
1657095275990,CSE 15L,A02,083655,Morris; Justin Loren,9,0,50,41
1657095282017,CSE 20,A01,083657,Tran; Khoa Dang,37,0,80,43
1657095288041,CSE 21,A01,095574,Bach; Quang Tran,21,0,48,27
1657095294074,CSE 30,A01,083084,Eldon; John,4,0,80,76
1657095294074,CSE 30,B01,095061,Bhaskar; Nishant,6,0,50,44
1657095300104,CSE 100,A01,083659,Cao; Yingjun,4,4,70,66
1657095306200,CSE 134B,A01,083661,Powell; Thomas Allan,19,0,100,81
1657095312224,CSE 140,A01,083663,Gungor; Onat,14,0,85,71
1657095318247,CSE 140L,A01,083088,Eldon; John,16,0,100,84
1657095324270,CSE 175,A01,083665,Kumar; Rakesh,3,0,25,22
1657095330297,CSE 190,A00,092507,Dubnov; Shlomo,7,0,20,13
1657095336323,ECE 45,A01,083139,Congero; Spencer William,5,0,75,70
1657095342349,ECE 65,A50,083695,Saad; Andrew S,12,0,30,18
1657095342349,ECE 65,A51,095125,Saad; Andrew S,25,0,26,1
1657095348373,ECE 109,A01,091882,Touri; Behrouz,16,0,70,54
1657095354397,ECE 180,A00,083140,Abi Samra; Nicholas Camill,1,0,30,29
1657095354397,ECE 180,B00,083141,Abi Samra; Nicholas Camill,0,0,30,30
1657095360424,MATH 10A,A01,083735,Patchell; Gregory David,1,0,30,29
1657095360424,MATH 10A,A02,083736,Patchell; Gregory David,20,0,30,10
1657095360424,MATH 10A,A03,083737,Patchell; Gregory David,16,0,30,14
1657095366461,MATH 10B,A01,083207,Lim; Seonhee,7,0,34,27
1657095366461,MATH 10B,A02,083208,Lim; Seonhee,9,0,35,26
1657095366461,MATH 10B,A03,093472,Lim; Seonhee,5,0,34,29
1657095366461,MATH 10B,B01,083739,Sinha; Shubham,9,0,30,21
1657095372489,MATH 18,A01,083743,Cinel; Cameron Alexander,6,0,30,24
1657095372489,MATH 18,A02,083744,Cinel; Cameron Alexander,15,0,30,15
1657095372489,MATH 18,A03,083745,Cinel; Cameron Alexander,8,0,30,22
1657095372489,MATH 18,B01,083748,Rideout; David Porter,4,0,37,33
1657095372489,MATH 18,B02,083749,Rideout; David Porter,3,0,36,33
1657095372489,MATH 18,B03,083750,Rideout; David Porter,2,0,37,35
1657095372489,MATH 18,B04,083751,Rideout; David Porter,5,0,36,31
1657095372489,MATH 18,B05,093473,Rideout; David Porter,4,0,36,32
1657095372489,MATH 18,B06,093474,Rideout; David Porter,5,0,36,31
1657095378519,MATH 20A,A01,083754,Zheng; Zequn,12,0,40,28
1657095384554,MATH 20B,A01,083756,Briones; Jor-el Thomas Caparas,1,0,36,35
1657095384554,MATH 20B,A02,083757,Briones; Jor-el Thomas Caparas,1,0,36,35
1657095384554,MATH 20B,A03,093475,Briones; Jor-el Thomas Caparas,0,0,36,36
1657095390584,MATH 20C,A01,083760,Briones; Jor-el Thomas Caparas,1,0,35,34
1657095390584,MATH 20C,A02,083761,Briones; Jor-el Thomas Caparas,8,0,35,27
1657095390584,MATH 20C,A03,093476,Briones; Jor-el Thomas Caparas,0,1,36,36
1657095390584,MATH 20C,B01,083762,Bach; Quang Tran,0,0,30,30
1657095396616,MATH 20D,A01,083765,Tran; Brian Kha,4,0,30,26
1657095396616,MATH 20D,A02,083766,Tran; Brian Kha,5,0,30,25
1657095396616,MATH 20D,A03,083767,Tran; Brian Kha,3,0,30,27
1657095402652,MATH 20E,A01,083771,Ganguly; Soumya,6,0,32,26
1657095402652,MATH 20E,A02,083772,Ganguly; Soumya,6,0,32,26
1657095402652,MATH 20E,B01,083773,Ciotti; Benjamin,18,0,35,17
1657095402652,MATH 20E,B02,083774,Ciotti; Benjamin,17,0,35,18
1657095408677,MATH 103A,A01,083777,Greenfeld; Be'Eri,2,0,36,34
1657095408677,MATH 103A,A02,083778,Greenfeld; Be'Eri,5,0,36,31
1657095408677,MATH 103A,A03,093561,Greenfeld; Be'Eri,4,0,36,32
1657095408677,MATH 103A,B01,083779,Greenfeld; Be'Eri,6,0,36,30
1657095408677,MATH 103A,B02,083780,Greenfeld; Be'Eri,2,0,36,34
1657095408677,MATH 103A,B03,093562,Greenfeld; Be'Eri,3,0,36,33
1657095414702,MATH 105,A01,085443,Carter; Anne Toulson,14,0,35,21
1657095414702,MATH 105,A02,093477,Carter; Anne Toulson,20,0,35,15
1657095420734,MATH 109,A01,083213,Ganzberger; Geoffrey Michael,2,0,34,32
1657095420734,MATH 109,A02,083214,Ganzberger; Geoffrey Michael,3,0,34,31
1657095420734,MATH 109,A03,093478,Ganzberger; Geoffrey Michael,1,0,34,33
1657095420734,MATH 109,B01,083215,Ganzberger; Geoffrey Michael,1,0,32,31
1657095420734,MATH 109,B02,083216,Ganzberger; Geoffrey Michael,1,0,32,31
1657095420734,MATH 109,B03,093479,Ganzberger; Geoffrey Michael,6,0,32,26
1657095426766,MATH 142A,A01,083219,Chow; Bennett,6,0,32,26
1657095426766,MATH 142A,A02,083220,Chow; Bennett,10,0,32,22
1657095426766,MATH 142A,A03,093480,Chow; Bennett,7,0,32,25
1657095426766,MATH 142A,B03,093481,Chow; Bennett,8,0,32,24
1657095426766,MATH 142A,B04,093558,Chow; Bennett,11,0,32,21
1657095426766,MATH 142A,B05,093559,Chow; Bennett,6,0,32,26
1657095432789,MATH 193A,A01,083224,Rotar; Vladimir,7,0,34,27
1657095432789,MATH 193A,A02,083225,Rotar; Vladimir,5,0,34,29
1657095432789,MATH 193A,A03,083781,Rotar; Vladimir,1,0,34,33
1657095432789,MATH 193A,A04,083782,Rotar; Vladimir,6,0,34,28
1657095432789,MATH 193A,A05,093482,Rotar; Vladimir,6,0,34,28
1657095438818,MATH 197,001,091859,McAuley; Julian John,9999,0,9999,0
1657095438818,MATH 197,002,095566,Kedlaya; Kiran S.,9997,0,9999,2
1657095438818,MATH 197,003,095567,Xiao; Ming,9999,0,9999,0
1657095438818,MATH 197,004,095571,Perols; Johan Lars,9998,0,9999,1
1657095445882,COGS 9,A01,083615,Shannon; Kyle Michael,7,0,75,68
1657095451903,COGS 11,A01,083617,Boyle; Mary E. T.,21,0,48,27
1657095457931,COGS 13,A01,083071,Bastos; Amalia Pinkusfeld,9,0,71,62
1657095463952,COGS 14A,A01,092681,Semenuks; Arturs,1,1,100,99
1657095469978,COGS 14B,A01,083073,Cheng; Tzu-Han,6,0,63,57
1657095476004,COGS 17,A01,092677,Semenuks; Arturs,4,0,81,77
1657095482032,COGS 100,A01,083619,Allen; Michael Gordon,15,0,70,55
1657095488063,COGS 101A,A01,083621,Davis; Joshua Daniel,9,0,68,59
1657095494102,COGS 101B,A01,091572,Allen; Michael Gordon,8,0,65,57
1657095500129,COGS 101C,A01,083625,Delgado; Tania,17,0,35,18
1657095506152,COGS 107A,A01,083627,Boyle; Mary E. T.,13,0,60,47
1657095512181,COGS 118A,A01,083075,Gupta; Anjum,15,0,76,61
1657095518206,CSE 3,A50,083646,Miranda; Gregory Joseph,22,0,50,28
1657095524231,CSE 8A,A50,083650,Miranda; Gregory Joseph,17,1,56,39
1657095530254,CSE 11,A01,083080,Cao; Yingjun,4,15,40,36
1657095536284,CSE 12,A01,083652,Krause-Levy; Sophia Louisa,23,1,120,97
1657095542307,CSE 15L,A01,083654,Morris; Justin Loren,9,0,50,41
1657095542307,CSE 15L,A02,083655,Morris; Justin Loren,9,0,50,41
1657095548336,CSE 20,A01,083657,Tran; Khoa Dang,37,0,80,43
1657095554361,CSE 21,A01,095574,Bach; Quang Tran,21,0,48,27
1657095560386,CSE 30,A01,083084,Eldon; John,4,0,80,76
1657095560386,CSE 30,B01,095061,Bhaskar; Nishant,6,0,50,44
1657095566409,CSE 100,A01,083659,Cao; Yingjun,4,4,70,66
1657095572437,CSE 134B,A01,083661,Powell; Thomas Allan,19,0,100,81
1657095578465,CSE 140,A01,083663,Gungor; Onat,14,0,85,71
1657095584492,CSE 140L,A01,083088,Eldon; John,16,0,100,84
1657095590515,CSE 175,A01,083665,Kumar; Rakesh,3,0,25,22
1657095596543,CSE 190,A00,092507,Dubnov; Shlomo,7,0,20,13
1657095602567,ECE 45,A01,083139,Congero; Spencer William,5,0,75,70
1657095608592,ECE 65,A50,083695,Saad; Andrew S,12,0,30,18
1657095608592,ECE 65,A51,095125,Saad; Andrew S,25,0,26,1
1657095614620,ECE 109,A01,091882,Touri; Behrouz,16,0,70,54
1657095620645,ECE 180,A00,083140,Abi Samra; Nicholas Camill,1,0,30,29
1657095620645,ECE 180,B00,083141,Abi Samra; Nicholas Camill,0,0,30,30
1657095626669,MATH 10A,A01,083735,Patchell; Gregory David,1,0,30,29
1657095626669,MATH 10A,A02,083736,Patchell; Gregory David,20,0,30,10
1657095626669,MATH 10A,A03,083737,Patchell; Gregory David,16,0,30,14
1657095632702,MATH 10B,A01,083207,Lim; Seonhee,7,0,34,27
1657095632702,MATH 10B,A02,083208,Lim; Seonhee,9,0,35,26
1657095632702,MATH 10B,A03,093472,Lim; Seonhee,5,0,34,29
1657095632702,MATH 10B,B01,083739,Sinha; Shubham,9,0,30,21
1657095638727,MATH 18,A01,083743,Cinel; Cameron Alexander,6,0,30,24
1657095638727,MATH 18,A02,083744,Cinel; Cameron Alexander,15,0,30,15
1657095638727,MATH 18,A03,083745,Cinel; Cameron Alexander,8,0,30,22
1657095638727,MATH 18,B01,083748,Rideout; David Porter,4,0,37,33
1657095638727,MATH 18,B02,083749,Rideout; David Porter,3,0,36,33
1657095638727,MATH 18,B03,083750,Rideout; David Porter,2,0,37,35
1657095638727,MATH 18,B04,083751,Rideout; David Porter,5,0,36,31
1657095638727,MATH 18,B05,093473,Rideout; David Porter,4,0,36,32
1657095638727,MATH 18,B06,093474,Rideout; David Porter,5,0,36,31
1657095644752,MATH 20A,A01,083754,Zheng; Zequn,12,0,40,28
1657095650780,MATH 20B,A01,083756,Briones; Jor-el Thomas Caparas,1,0,36,35
1657095650780,MATH 20B,A02,083757,Briones; Jor-el Thomas Caparas,1,0,36,35
1657095650780,MATH 20B,A03,093475,Briones; Jor-el Thomas Caparas,0,0,36,36
1657095656805,MATH 20C,A01,083760,Briones; Jor-el Thomas Caparas,1,0,35,34
1657095656805,MATH 20C,A02,083761,Briones; Jor-el Thomas Caparas,8,0,35,27
1657095656805,MATH 20C,A03,093476,Briones; Jor-el Thomas Caparas,0,1,36,36
1657095656805,MATH 20C,B01,083762,Bach; Quang Tran,0,0,30,30
1657095662829,MATH 20D,A01,083765,Tran; Brian Kha,4,0,30,26
1657095662829,MATH 20D,A02,083766,Tran; Brian Kha,5,0,30,25
1657095662829,MATH 20D,A03,083767,Tran; Brian Kha,3,0,30,27
1657095668861,MATH 20E,A01,083771,Ganguly; Soumya,6,0,32,26
1657095668861,MATH 20E,A02,083772,Ganguly; Soumya,6,0,32,26
1657095668861,MATH 20E,B01,083773,Ciotti; Benjamin,18,0,35,17
1657095668861,MATH 20E,B02,083774,Ciotti; Benjamin,17,0,35,18
1657095674886,MATH 103A,A01,083777,Greenfeld; Be'Eri,2,0,36,34
1657095674886,MATH 103A,A02,083778,Greenfeld; Be'Eri,5,0,36,31
1657095674886,MATH 103A,A03,093561,Greenfeld; Be'Eri,4,0,36,32
1657095674886,MATH 103A,B01,083779,Greenfeld; Be'Eri,6,0,36,30
1657095674886,MATH 103A,B02,083780,Greenfeld; Be'Eri,2,0,36,34
1657095674886,MATH 103A,B03,093562,Greenfeld; Be'Eri,3,0,36,33
1657095680917,MATH 105,A01,085443,Carter; Anne Toulson,14,0,35,21
1657095680917,MATH 105,A02,093477,Carter; Anne Toulson,20,0,35,15
1657095686948,MATH 109,A01,083213,Ganzberger; Geoffrey Michael,2,0,34,32
1657095686948,MATH 109,A02,083214,Ganzberger; Geoffrey Michael,3,0,34,31
1657095686948,MATH 109,A03,093478,Ganzberger; Geoffrey Michael,1,0,34,33
1657095686948,MATH 109,B01,083215,Ganzberger; Geoffrey Michael,1,0,32,31
1657095686948,MATH 109,B02,083216,Ganzberger; Geoffrey Michael,1,0,32,31
1657095686948,MATH 109,B03,093479,Ganzberger; Geoffrey Michael,6,0,32,26
1657095692973,MATH 142A,A01,083219,Chow; Bennett,6,0,32,26
1657095692973,MATH 142A,A02,083220,Chow; Bennett,10,0,32,22
1657095692973,MATH 142A,A03,093480,Chow; Bennett,7,0,32,25
1657095692973,MATH 142A,B03,093481,Chow; Bennett,8,0,32,24
1657095692973,MATH 142A,B04,093558,Chow; Bennett,11,0,32,21
1657095692973,MATH 142A,B05,093559,Chow; Bennett,6,0,32,26
1657095699018,MATH 193A,A01,083224,Rotar; Vladimir,7,0,34,27
1657095699018,MATH 193A,A02,083225,Rotar; Vladimir,5,0,34,29
1657095699018,MATH 193A,A03,083781,Rotar; Vladimir,1,0,34,33
1657095699018,MATH 193A,A04,083782,Rotar; Vladimir,6,0,34,28
1657095699018,MATH 193A,A05,093482,Rotar; Vladimir,6,0,34,28
1657095705044,MATH 197,001,091859,McAuley; Julian John,9999,0,9999,0
1657095705044,MATH 197,002,095566,Kedlaya; Kiran S.,9997,0,9999,2
1657095705044,MATH 197,003,095567,Xiao; Ming,9999,0,9999,0
1657095705044,MATH 197,004,095571,Perols; Johan Lars,9998,0,9999,1
1657095712115,COGS 9,A01,083615,Shannon; Kyle Michael,7,0,75,68
1657095718138,COGS 11,A01,083617,Boyle; Mary E. T.,21,0,48,27
1657095724170,COGS 13,A01,083071,Bastos; Amalia Pinkusfeld,9,0,71,62
1657095730194,COGS 14A,A01,092681,Semenuks; Arturs,1,1,100,99
1657095736223,COGS 14B,A01,083073,Cheng; Tzu-Han,6,0,63,57
1657095742247,COGS 17,A01,092677,Semenuks; Arturs,4,0,81,77
1657095748277,COGS 100,A01,083619,Allen; Michael Gordon,15,0,70,55
1657095754311,COGS 101A,A01,083621,Davis; Joshua Daniel,9,0,68,59
1657095760339,COGS 101B,A01,091572,Allen; Michael Gordon,8,0,65,57
1657095766365,COGS 101C,A01,083625,Delgado; Tania,17,0,35,18
1657095772395,COGS 107A,A01,083627,Boyle; Mary E. T.,13,0,60,47
1657095778427,COGS 118A,A01,083075,Gupta; Anjum,15,0,76,61
1657095784464,CSE 3,A50,083646,Miranda; Gregory Joseph,22,0,50,28
1657095790488,CSE 8A,A50,083650,Miranda; Gregory Joseph,17,1,56,39
1657095796516,CSE 11,A01,083080,Cao; Yingjun,4,15,40,36
1657095802541,CSE 12,A01,083652,Krause-Levy; Sophia Louisa,23,1,120,97
1657095808566,CSE 15L,A01,083654,Morris; Justin Loren,9,0,50,41
1657095808566,CSE 15L,A02,083655,Morris; Justin Loren,9,0,50,41
1657095814595,CSE 20,A01,083657,Tran; Khoa Dang,37,0,80,43
1657095820625,CSE 21,A01,095574,Bach; Quang Tran,21,0,48,27
1657095826659,CSE 30,A01,083084,Eldon; John,4,0,80,76
1657095826659,CSE 30,B01,095061,Bhaskar; Nishant,6,0,50,44
1657095832685,CSE 100,A01,083659,Cao; Yingjun,4,4,70,66
1657095838716,CSE 134B,A01,083661,Powell; Thomas Allan,19,0,100,81
1657095844745,CSE 140,A01,083663,Gungor; Onat,14,0,85,71
1657095850768,CSE 140L,A01,083088,Eldon; John,16,0,100,84
1657095856792,CSE 175,A01,083665,Kumar; Rakesh,3,0,25,22
1657095862817,CSE 190,A00,092507,Dubnov; Shlomo,7,0,20,13
1657095868849,ECE 45,A01,083139,Congero; Spencer William,5,0,75,70
1657095874876,ECE 65,A50,083695,Saad; Andrew S,12,0,30,18
1657095874876,ECE 65,A51,095125,Saad; Andrew S,25,0,26,1
1657095880906,ECE 109,A01,091882,Touri; Behrouz,16,0,70,54
1657095886935,ECE 180,A00,083140,Abi Samra; Nicholas Camill,1,0,30,29
1657095886935,ECE 180,B00,083141,Abi Samra; Nicholas Camill,0,0,30,30
1657095892962,MATH 10A,A01,083735,Patchell; Gregory David,1,0,30,29
1657095892962,MATH 10A,A02,083736,Patchell; Gregory David,20,0,30,10
1657095892962,MATH 10A,A03,083737,Patchell; Gregory David,16,0,30,14
1657095898994,MATH 10B,A01,083207,Lim; Seonhee,7,0,34,27
1657095898994,MATH 10B,A02,083208,Lim; Seonhee,9,0,35,26
1657095898994,MATH 10B,A03,093472,Lim; Seonhee,5,0,34,29
1657095898994,MATH 10B,B01,083739,Sinha; Shubham,9,0,30,21
1657095905098,MATH 18,A01,083743,Cinel; Cameron Alexander,6,0,30,24
1657095905098,MATH 18,A02,083744,Cinel; Cameron Alexander,15,0,30,15
1657095905098,MATH 18,A03,083745,Cinel; Cameron Alexander,8,0,30,22
1657095905098,MATH 18,B01,083748,Rideout; David Porter,4,0,37,33
1657095905098,MATH 18,B02,083749,Rideout; David Porter,3,0,36,33
1657095905098,MATH 18,B03,083750,Rideout; David Porter,2,0,37,35
1657095905098,MATH 18,B04,083751,Rideout; David Porter,5,0,36,31
1657095905098,MATH 18,B05,093473,Rideout; David Porter,4,0,36,32
1657095905098,MATH 18,B06,093474,Rideout; David Porter,5,0,36,31
1657095911125,MATH 20A,A01,083754,Zheng; Zequn,12,0,40,28
1657095917152,MATH 20B,A01,083756,Briones; Jor-el Thomas Caparas,1,0,36,35
1657095917152,MATH 20B,A02,083757,Briones; Jor-el Thomas Caparas,1,0,36,35
1657095917152,MATH 20B,A03,093475,Briones; Jor-el Thomas Caparas,0,0,36,36
1657095923178,MATH 20C,A01,083760,Briones; Jor-el Thomas Caparas,1,0,35,34
1657095923178,MATH 20C,A02,083761,Briones; Jor-el Thomas Caparas,8,0,35,27
1657095923178,MATH 20C,A03,093476,Briones; Jor-el Thomas Caparas,0,1,36,36
1657095923178,MATH 20C,B01,083762,Bach; Quang Tran,0,0,30,30
1657095929211,MATH 20D,A01,083765,Tran; Brian Kha,4,0,30,26
1657095929211,MATH 20D,A02,083766,Tran; Brian Kha,5,0,30,25
1657095929211,MATH 20D,A03,083767,Tran; Brian Kha,3,0,30,27
1657095935246,MATH 20E,A01,083771,Ganguly; Soumya,6,0,32,26
1657095935246,MATH 20E,A02,083772,Ganguly; Soumya,6,0,32,26
1657095935246,MATH 20E,B01,083773,Ciotti; Benjamin,18,0,35,17
1657095935246,MATH 20E,B02,083774,Ciotti; Benjamin,17,0,35,18
1657095941274,MATH 103A,A01,083777,Greenfeld; Be'Eri,2,0,36,34
1657095941274,MATH 103A,A02,083778,Greenfeld; Be'Eri,5,0,36,31
1657095941274,MATH 103A,A03,093561,Greenfeld; Be'Eri,4,0,36,32
1657095941274,MATH 103A,B01,083779,Greenfeld; Be'Eri,6,0,36,30
1657095941274,MATH 103A,B02,083780,Greenfeld; Be'Eri,2,0,36,34
1657095941274,MATH 103A,B03,093562,Greenfeld; Be'Eri,3,0,36,33
1657095947305,MATH 105,A01,085443,Carter; Anne Toulson,14,0,35,21
1657095947305,MATH 105,A02,093477,Carter; Anne Toulson,20,0,35,15
1657095953330,MATH 109,A01,083213,Ganzberger; Geoffrey Michael,2,0,34,32
1657095953330,MATH 109,A02,083214,Ganzberger; Geoffrey Michael,3,0,34,31
1657095953330,MATH 109,A03,093478,Ganzberger; Geoffrey Michael,1,0,34,33
1657095953330,MATH 109,B01,083215,Ganzberger; Geoffrey Michael,1,0,32,31
1657095953330,MATH 109,B02,083216,Ganzberger; Geoffrey Michael,1,0,32,31
1657095953330,MATH 109,B03,093479,Ganzberger; Geoffrey Michael,6,0,32,26
1657095959353,MATH 142A,A01,083219,Chow; Bennett,6,0,32,26
1657095959353,MATH 142A,A02,083220,Chow; Bennett,10,0,32,22
1657095959353,MATH 142A,A03,093480,Chow; Bennett,7,0,32,25
1657095959353,MATH 142A,B03,093481,Chow; Bennett,8,0,32,24
1657095959353,MATH 142A,B04,093558,Chow; Bennett,11,0,32,21
1657095959353,MATH 142A,B05,093559,Chow; Bennett,6,0,32,26
1657095965376,MATH 193A,A01,083224,Rotar; Vladimir,7,0,34,27
1657095965376,MATH 193A,A02,083225,Rotar; Vladimir,5,0,34,29
1657095965376,MATH 193A,A03,083781,Rotar; Vladimir,1,0,34,33
1657095965376,MATH 193A,A04,083782,Rotar; Vladimir,6,0,34,28
1657095965376,MATH 193A,A05,093482,Rotar; Vladimir,6,0,34,28
1657095971400,MATH 197,001,091859,McAuley; Julian John,9999,0,9999,0
1657095971400,MATH 197,002,095566,Kedlaya; Kiran S.,9997,0,9999,2
1657095971400,MATH 197,003,095567,Xiao; Ming,9999,0,9999,0
1657095971400,MATH 197,004,095571,Perols; Johan Lars,9998,0,9999,1
1657095978461,COGS 9,A01,083615,Shannon; Kyle Michael,7,0,75,68
1657095984486,COGS 11,A01,083617,Boyle; Mary E. T.,21,0,48,27
1657095990516,COGS 13,A01,083071,Bastos; Amalia Pinkusfeld,9,0,71,62
1657095996542,COGS 14A,A01,092681,Semenuks; Arturs,1,1,100,99
1657096002574,COGS 14B,A01,083073,Cheng; Tzu-Han,6,0,63,57
1657096008599,COGS 17,A01,092677,Semenuks; Arturs,4,0,81,77
1657096014630,COGS 100,A01,083619,Allen; Michael Gordon,15,0,70,55
1657096020661,COGS 101A,A01,083621,Davis; Joshua Daniel,9,0,68,59
1657096026687,COGS 101B,A01,091572,Allen; Michael Gordon,8,0,65,57
1657096032718,COGS 101C,A01,083625,Delgado; Tania,17,0,35,18
1657096038744,COGS 107A,A01,083627,Boyle; Mary E. T.,13,0,60,47
1657096044768,COGS 118A,A01,083075,Gupta; Anjum,15,0,76,61
1657096050800,CSE 3,A50,083646,Miranda; Gregory Joseph,22,0,50,28
1657096056824,CSE 8A,A50,083650,Miranda; Gregory Joseph,17,1,56,39
1657096062852,CSE 11,A01,083080,Cao; Yingjun,4,15,40,36
1657096068890,CSE 12,A01,083652,Krause-Levy; Sophia Louisa,23,1,120,97
1657096074918,CSE 15L,A01,083654,Morris; Justin Loren,9,0,50,41
1657096074918,CSE 15L,A02,083655,Morris; Justin Loren,9,0,50,41
1657096080947,CSE 20,A01,083657,Tran; Khoa Dang,37,0,80,43
1657096086972,CSE 21,A01,095574,Bach; Quang Tran,21,0,48,27
1657096093000,CSE 30,A01,083084,Eldon; John,4,0,80,76
1657096093000,CSE 30,B01,095061,Bhaskar; Nishant,6,0,50,44
1657096099042,CSE 100,A01,083659,Cao; Yingjun,4,4,70,66
1657096105077,CSE 134B,A01,083661,Powell; Thomas Allan,19,0,100,81
1657096111111,CSE 140,A01,083663,Gungor; Onat,14,0,85,71
1657096117139,CSE 140L,A01,083088,Eldon; John,16,0,100,84
1657096123174,CSE 175,A01,083665,Kumar; Rakesh,3,0,25,22
1657096129196,CSE 190,A00,092507,Dubnov; Shlomo,7,0,20,13
1657096135222,ECE 45,A01,083139,Congero; Spencer William,5,0,75,70
1657096141250,ECE 65,A50,083695,Saad; Andrew S,12,0,30,18
1657096141250,ECE 65,A51,095125,Saad; Andrew S,25,0,26,1
1657096147274,ECE 109,A01,091882,Touri; Behrouz,16,0,70,54
1657096153300,ECE 180,A00,083140,Abi Samra; Nicholas Camill,1,0,30,29
1657096153300,ECE 180,B00,083141,Abi Samra; Nicholas Camill,0,0,30,30
1657096159327,MATH 10A,A01,083735,Patchell; Gregory David,1,0,30,29
1657096159327,MATH 10A,A02,083736,Patchell; Gregory David,20,0,30,10
1657096159327,MATH 10A,A03,083737,Patchell; Gregory David,16,0,30,14
1657096165355,MATH 10B,A01,083207,Lim; Seonhee,7,0,34,27
1657096165355,MATH 10B,A02,083208,Lim; Seonhee,9,0,35,26
1657096165355,MATH 10B,A03,093472,Lim; Seonhee,5,0,34,29
1657096165355,MATH 10B,B01,083739,Sinha; Shubham,9,0,30,21
1657096171395,MATH 18,A01,083743,Cinel; Cameron Alexander,6,0,30,24
1657096171395,MATH 18,A02,083744,Cinel; Cameron Alexander,15,0,30,15
1657096171395,MATH 18,A03,083745,Cinel; Cameron Alexander,8,0,30,22
1657096171395,MATH 18,B01,083748,Rideout; David Porter,4,0,37,33
1657096171395,MATH 18,B02,083749,Rideout; David Porter,3,0,36,33
1657096171395,MATH 18,B03,083750,Rideout; David Porter,2,0,37,35
1657096171395,MATH 18,B04,083751,Rideout; David Porter,5,0,36,31
1657096171395,MATH 18,B05,093473,Rideout; David Porter,4,0,36,32
1657096171395,MATH 18,B06,093474,Rideout; David Porter,5,0,36,31
1657096177420,MATH 20A,A01,083754,Zheng; Zequn,12,0,40,28
1657096183448,MATH 20B,A01,083756,Briones; Jor-el Thomas Caparas,1,0,36,35
1657096183448,MATH 20B,A02,083757,Briones; Jor-el Thomas Caparas,1,0,36,35
1657096183448,MATH 20B,A03,093475,Briones; Jor-el Thomas Caparas,0,0,36,36
1657096189481,MATH 20C,A01,083760,Briones; Jor-el Thomas Caparas,1,0,35,34
1657096189481,MATH 20C,A02,083761,Briones; Jor-el Thomas Caparas,8,0,35,27
1657096189481,MATH 20C,A03,093476,Briones; Jor-el Thomas Caparas,0,1,36,36
1657096189481,MATH 20C,B01,083762,Bach; Quang Tran,0,0,30,30
1657096195511,MATH 20D,A01,083765,Tran; Brian Kha,4,0,30,26
1657096195511,MATH 20D,A02,083766,Tran; Brian Kha,5,0,30,25
1657096195511,MATH 20D,A03,083767,Tran; Brian Kha,3,0,30,27
1657096201539,MATH 20E,A01,083771,Ganguly; Soumya,6,0,32,26
1657096201539,MATH 20E,A02,083772,Ganguly; Soumya,6,0,32,26
1657096201539,MATH 20E,B01,083773,Ciotti; Benjamin,18,0,35,17
1657096201539,MATH 20E,B02,083774,Ciotti; Benjamin,17,0,35,18
1657096207579,MATH 103A,A01,083777,Greenfeld; Be'Eri,2,0,36,34
1657096207579,MATH 103A,A02,083778,Greenfeld; Be'Eri,5,0,36,31
1657096207579,MATH 103A,A03,093561,Greenfeld; Be'Eri,4,0,36,32
1657096207579,MATH 103A,B01,083779,Greenfeld; Be'Eri,6,0,36,30
1657096207579,MATH 103A,B02,083780,Greenfeld; Be'Eri,2,0,36,34
1657096207579,MATH 103A,B03,093562,Greenfeld; Be'Eri,3,0,36,33
1657096213608,MATH 105,A01,085443,Carter; Anne Toulson,14,0,35,21
1657096213608,MATH 105,A02,093477,Carter; Anne Toulson,20,0,35,15
1657096219631,MATH 109,A01,083213,Ganzberger; Geoffrey Michael,2,0,34,32
1657096219631,MATH 109,A02,083214,Ganzberger; Geoffrey Michael,3,0,34,31
1657096219631,MATH 109,A03,093478,Ganzberger; Geoffrey Michael,1,0,34,33
1657096219631,MATH 109,B01,083215,Ganzberger; Geoffrey Michael,1,0,32,31
1657096219631,MATH 109,B02,083216,Ganzberger; Geoffrey Michael,1,0,32,31
1657096219631,MATH 109,B03,093479,Ganzberger; Geoffrey Michael,6,0,32,26
1657096225665,MATH 142A,A01,083219,Chow; Bennett,6,0,32,26
1657096225665,MATH 142A,A02,083220,Chow; Bennett,10,0,32,22
1657096225665,MATH 142A,A03,093480,Chow; Bennett,7,0,32,25
1657096225665,MATH 142A,B03,093481,Chow; Bennett,8,0,32,24
1657096225665,MATH 142A,B04,093558,Chow; Bennett,11,0,32,21
1657096225665,MATH 142A,B05,093559,Chow; Bennett,6,0,32,26
1657096231690,MATH 193A,A01,083224,Rotar; Vladimir,7,0,34,27
1657096231690,MATH 193A,A02,083225,Rotar; Vladimir,5,0,34,29
1657096231690,MATH 193A,A03,083781,Rotar; Vladimir,1,0,34,33
1657096231690,MATH 193A,A04,083782,Rotar; Vladimir,6,0,34,28
1657096231690,MATH 193A,A05,093482,Rotar; Vladimir,6,0,34,28
1657096237718,MATH 197,001,091859,McAuley; Julian John,9999,0,9999,0
1657096237718,MATH 197,002,095566,Kedlaya; Kiran S.,9997,0,9999,2
1657096237718,MATH 197,003,095567,Xiao; Ming,9999,0,9999,0
1657096237718,MATH 197,004,095571,Perols; Johan Lars,9998,0,9999,1
1657096244804,COGS 9,A01,083615,Shannon; Kyle Michael,7,0,75,68
1657096250828,COGS 11,A01,083617,Boyle; Mary E. T.,21,0,48,27
1657096256852,COGS 13,A01,083071,Bastos; Amalia Pinkusfeld,9,0,71,62
1657096262878,COGS 14A,A01,092681,Semenuks; Arturs,1,1,100,99
1657096268909,COGS 14B,A01,083073,Cheng; Tzu-Han,6,0,63,57
1657096274932,COGS 17,A01,092677,Semenuks; Arturs,4,0,81,77
1657096280957,COGS 100,A01,083619,Allen; Michael Gordon,15,0,70,55
1657096286987,COGS 101A,A01,083621,Davis; Joshua Daniel,9,0,68,59
1657096293016,COGS 101B,A01,091572,Allen; Michael Gordon,8,0,65,57
1657096299049,COGS 101C,A01,083625,Delgado; Tania,17,0,35,18
1657096305074,COGS 107A,A01,083627,Boyle; Mary E. T.,13,0,60,47
1657096311097,COGS 118A,A01,083075,Gupta; Anjum,15,0,76,61
1657096317123,CSE 3,A50,083646,Miranda; Gregory Joseph,22,0,50,28
1657096323147,CSE 8A,A50,083650,Miranda; Gregory Joseph,17,1,56,39
1657096329179,CSE 11,A01,083080,Cao; Yingjun,4,15,40,36
1657096335209,CSE 12,A01,083652,Krause-Levy; Sophia Louisa,23,1,120,97
1657096341240,CSE 15L,A01,083654,Morris; Justin Loren,9,0,50,41
1657096341240,CSE 15L,A02,083655,Morris; Justin Loren,9,0,50,41
1657096347265,CSE 20,A01,083657,Tran; Khoa Dang,37,0,80,43
1657096353296,CSE 21,A01,095574,Bach; Quang Tran,21,0,48,27
1657096359322,CSE 30,A01,083084,Eldon; John,4,0,80,76
1657096359322,CSE 30,B01,095061,Bhaskar; Nishant,6,0,50,44
1657096365346,CSE 100,A01,083659,Cao; Yingjun,4,4,70,66
1657096371377,CSE 134B,A01,083661,Powell; Thomas Allan,19,0,100,81
1657096377402,CSE 140,A01,083663,Gungor; Onat,14,0,85,71
1657096383438,CSE 140L,A01,083088,Eldon; John,16,0,100,84
1657096389469,CSE 175,A01,083665,Kumar; Rakesh,3,0,25,22
1657096395500,CSE 190,A00,092507,Dubnov; Shlomo,7,0,20,13
1657096401533,ECE 45,A01,083139,Congero; Spencer William,5,0,75,70
1657096407569,ECE 65,A50,083695,Saad; Andrew S,12,0,30,18
1657096407569,ECE 65,A51,095125,Saad; Andrew S,25,0,26,1
1657096413618,ECE 109,A01,091882,Touri; Behrouz,16,0,70,54
1657096419642,ECE 180,A00,083140,Abi Samra; Nicholas Camill,1,0,30,29
1657096419642,ECE 180,B00,083141,Abi Samra; Nicholas Camill,0,0,30,30
1657096425676,MATH 10A,A01,083735,Patchell; Gregory David,1,0,30,29
1657096425676,MATH 10A,A02,083736,Patchell; Gregory David,20,0,30,10
1657096425676,MATH 10A,A03,083737,Patchell; Gregory David,16,0,30,14
1657096431707,MATH 10B,A01,083207,Lim; Seonhee,7,0,34,27
1657096431707,MATH 10B,A02,083208,Lim; Seonhee,9,0,35,26
1657096431707,MATH 10B,A03,093472,Lim; Seonhee,5,0,34,29
1657096431707,MATH 10B,B01,083739,Sinha; Shubham,9,0,30,21
1657096437757,MATH 18,A01,083743,Cinel; Cameron Alexander,6,0,30,24
1657096437757,MATH 18,A02,083744,Cinel; Cameron Alexander,15,0,30,15
1657096437757,MATH 18,A03,083745,Cinel; Cameron Alexander,8,0,30,22
1657096437757,MATH 18,B01,083748,Rideout; David Porter,4,0,37,33
1657096437757,MATH 18,B02,083749,Rideout; David Porter,3,0,36,33
1657096437757,MATH 18,B03,083750,Rideout; David Porter,2,0,37,35
1657096437757,MATH 18,B04,083751,Rideout; David Porter,5,0,36,31
1657096437757,MATH 18,B05,093473,Rideout; David Porter,4,0,36,32
1657096437757,MATH 18,B06,093474,Rideout; David Porter,5,0,36,31
1657096443783,MATH 20A,A01,083754,Zheng; Zequn,12,0,40,28
1657096449817,MATH 20B,A01,083756,Briones; Jor-el Thomas Caparas,1,0,36,35
1657096449817,MATH 20B,A02,083757,Briones; Jor-el Thomas Caparas,1,0,36,35
1657096449817,MATH 20B,A03,093475,Briones; Jor-el Thomas Caparas,0,0,36,36
1657096455850,MATH 20C,A01,083760,Briones; Jor-el Thomas Caparas,1,0,35,34
1657096455850,MATH 20C,A02,083761,Briones; Jor-el Thomas Caparas,8,0,35,27
1657096455850,MATH 20C,A03,093476,Briones; Jor-el Thomas Caparas,0,1,36,36
1657096455850,MATH 20C,B01,083762,Bach; Quang Tran,0,0,30,30
1657096461876,MATH 20D,A01,083765,Tran; Brian Kha,4,0,30,26
1657096461876,MATH 20D,A02,083766,Tran; Brian Kha,5,0,30,25
1657096461876,MATH 20D,A03,083767,Tran; Brian Kha,3,0,30,27
1657096467903,MATH 20E,A01,083771,Ganguly; Soumya,6,0,32,26
1657096467903,MATH 20E,A02,083772,Ganguly; Soumya,6,0,32,26
1657096467903,MATH 20E,B01,083773,Ciotti; Benjamin,18,0,35,17
1657096467903,MATH 20E,B02,083774,Ciotti; Benjamin,17,0,35,18
1657096473931,MATH 103A,A01,083777,Greenfeld; Be'Eri,2,0,36,34
1657096473931,MATH 103A,A02,083778,Greenfeld; Be'Eri,5,0,36,31
1657096473931,MATH 103A,A03,093561,Greenfeld; Be'Eri,4,0,36,32
1657096473931,MATH 103A,B01,083779,Greenfeld; Be'Eri,6,0,36,30
1657096473931,MATH 103A,B02,083780,Greenfeld; Be'Eri,2,0,36,34
1657096473931,MATH 103A,B03,093562,Greenfeld; Be'Eri,3,0,36,33
1657096479956,MATH 105,A01,085443,Carter; Anne Toulson,14,0,35,21
1657096479956,MATH 105,A02,093477,Carter; Anne Toulson,20,0,35,15
1657096485981,MATH 109,A01,083213,Ganzberger; Geoffrey Michael,2,0,34,32
1657096485981,MATH 109,A02,083214,Ganzberger; Geoffrey Michael,3,0,34,31
1657096485981,MATH 109,A03,093478,Ganzberger; Geoffrey Michael,1,0,34,33
1657096485981,MATH 109,B01,083215,Ganzberger; Geoffrey Michael,1,0,32,31
1657096485981,MATH 109,B02,083216,Ganzberger; Geoffrey Michael,1,0,32,31
1657096485981,MATH 109,B03,093479,Ganzberger; Geoffrey Michael,6,0,32,26
1657096492012,MATH 142A,A01,083219,Chow; Bennett,6,0,32,26
1657096492012,MATH 142A,A02,083220,Chow; Bennett,10,0,32,22
1657096492012,MATH 142A,A03,093480,Chow; Bennett,7,0,32,25
1657096492012,MATH 142A,B03,093481,Chow; Bennett,8,0,32,24
1657096492012,MATH 142A,B04,093558,Chow; Bennett,11,0,32,21
1657096492012,MATH 142A,B05,093559,Chow; Bennett,6,0,32,26
1657096498039,MATH 193A,A01,083224,Rotar; Vladimir,7,0,34,27
1657096498039,MATH 193A,A02,083225,Rotar; Vladimir,5,0,34,29
1657096498039,MATH 193A,A03,083781,Rotar; Vladimir,1,0,34,33
1657096498039,MATH 193A,A04,083782,Rotar; Vladimir,6,0,34,28
1657096498039,MATH 193A,A05,093482,Rotar; Vladimir,6,0,34,28
1657096504142,MATH 197,001,091859,McAuley; Julian John,9999,0,9999,0
1657096504142,MATH 197,002,095566,Kedlaya; Kiran S.,9997,0,9999,2
1657096504142,MATH 197,003,095567,Xiao; Ming,9999,0,9999,0
1657096504142,MATH 197,004,095571,Perols; Johan Lars,9998,0,9999,1
1657096511225,COGS 9,A01,083615,Shannon; Kyle Michael,7,0,75,68
1657096517251,COGS 11,A01,083617,Boyle; Mary E. T.,21,0,48,27
1657096523275,COGS 13,A01,083071,Bastos; Amalia Pinkusfeld,9,0,71,62
1657096529301,COGS 14A,A01,092681,Semenuks; Arturs,1,1,100,99
1657096535325,COGS 14B,A01,083073,Cheng; Tzu-Han,6,0,63,57
1657096541362,COGS 17,A01,092677,Semenuks; Arturs,4,0,81,77
1657096547391,COGS 100,A01,083619,Allen; Michael Gordon,15,0,70,55
1657096553416,COGS 101A,A01,083621,Davis; Joshua Daniel,9,0,68,59
1657096559442,COGS 101B,A01,091572,Allen; Michael Gordon,8,0,65,57
1657096565471,COGS 101C,A01,083625,Delgado; Tania,17,0,35,18
1657096571494,COGS 107A,A01,083627,Boyle; Mary E. T.,13,0,60,47
1657096577517,COGS 118A,A01,083075,Gupta; Anjum,15,0,76,61
1657096583542,CSE 3,A50,083646,Miranda; Gregory Joseph,22,0,50,28
1657096589567,CSE 8A,A50,083650,Miranda; Gregory Joseph,17,1,56,39
1657096595592,CSE 11,A01,083080,Cao; Yingjun,4,15,40,36
1657096601616,CSE 12,A01,083652,Krause-Levy; Sophia Louisa,23,1,120,97
1657096607641,CSE 15L,A01,083654,Morris; Justin Loren,9,0,50,41
1657096607641,CSE 15L,A02,083655,Morris; Justin Loren,9,0,50,41
1657096613666,CSE 20,A01,083657,Tran; Khoa Dang,37,0,80,43
1657096619692,CSE 21,A01,095574,Bach; Quang Tran,21,0,48,27
1657096625723,CSE 30,A01,083084,Eldon; John,4,0,80,76
1657096625723,CSE 30,B01,095061,Bhaskar; Nishant,6,0,50,44
1657096631747,CSE 100,A01,083659,Cao; Yingjun,4,4,70,66
1657096637769,CSE 134B,A01,083661,Powell; Thomas Allan,19,0,100,81
1657096643793,CSE 140,A01,083663,Gungor; Onat,14,0,85,71
1657096649819,CSE 140L,A01,083088,Eldon; John,16,0,100,84
1657096655848,CSE 175,A01,083665,Kumar; Rakesh,3,0,25,22
1657096661872,CSE 190,A00,092507,Dubnov; Shlomo,7,0,20,13
1657096667903,ECE 45,A01,083139,Congero; Spencer William,5,0,75,70
1657096673929,ECE 65,A50,083695,Saad; Andrew S,12,0,30,18
1657096673929,ECE 65,A51,095125,Saad; Andrew S,25,0,26,1
1657096679953,ECE 109,A01,091882,Touri; Behrouz,16,0,70,54
1657096685980,ECE 180,A00,083140,Abi Samra; Nicholas Camill,1,0,30,29
1657096685980,ECE 180,B00,083141,Abi Samra; Nicholas Camill,0,0,30,30
1657096692004,MATH 10A,A01,083735,Patchell; Gregory David,1,0,30,29
1657096692004,MATH 10A,A02,083736,Patchell; Gregory David,20,0,30,10
1657096692004,MATH 10A,A03,083737,Patchell; Gregory David,16,0,30,14
1657096698029,MATH 10B,A01,083207,Lim; Seonhee,7,0,34,27
1657096698029,MATH 10B,A02,083208,Lim; Seonhee,9,0,35,26
1657096698029,MATH 10B,A03,093472,Lim; Seonhee,5,0,34,29
1657096698029,MATH 10B,B01,083739,Sinha; Shubham,9,0,30,21
1657096704059,MATH 18,A01,083743,Cinel; Cameron Alexander,6,0,30,24
1657096704059,MATH 18,A02,083744,Cinel; Cameron Alexander,15,0,30,15
1657096704059,MATH 18,A03,083745,Cinel; Cameron Alexander,8,0,30,22
1657096704059,MATH 18,B01,083748,Rideout; David Porter,4,0,37,33
1657096704059,MATH 18,B02,083749,Rideout; David Porter,3,0,36,33
1657096704059,MATH 18,B03,083750,Rideout; David Porter,2,0,37,35
1657096704059,MATH 18,B04,083751,Rideout; David Porter,5,0,36,31
1657096704059,MATH 18,B05,093473,Rideout; David Porter,4,0,36,32
1657096704059,MATH 18,B06,093474,Rideout; David Porter,5,0,36,31
1657096710086,MATH 20A,A01,083754,Zheng; Zequn,12,0,40,28
1657096716113,MATH 20B,A01,083756,Briones; Jor-el Thomas Caparas,1,0,36,35
1657096716113,MATH 20B,A02,083757,Briones; Jor-el Thomas Caparas,1,0,36,35
1657096716113,MATH 20B,A03,093475,Briones; Jor-el Thomas Caparas,0,0,36,36
1657096722142,MATH 20C,A01,083760,Briones; Jor-el Thomas Caparas,1,0,35,34
1657096722142,MATH 20C,A02,083761,Briones; Jor-el Thomas Caparas,8,0,35,27
1657096722142,MATH 20C,A03,093476,Briones; Jor-el Thomas Caparas,0,1,36,36
1657096722142,MATH 20C,B01,083762,Bach; Quang Tran,0,0,30,30
1657096728182,MATH 20D,A01,083765,Tran; Brian Kha,4,0,30,26
1657096728182,MATH 20D,A02,083766,Tran; Brian Kha,5,0,30,25
1657096728182,MATH 20D,A03,083767,Tran; Brian Kha,3,0,30,27
1657096734209,MATH 20E,A01,083771,Ganguly; Soumya,6,0,32,26
1657096734209,MATH 20E,A02,083772,Ganguly; Soumya,6,0,32,26
1657096734209,MATH 20E,B01,083773,Ciotti; Benjamin,18,0,35,17
1657096734209,MATH 20E,B02,083774,Ciotti; Benjamin,17,0,35,18
1657096740232,MATH 103A,A01,083777,Greenfeld; Be'Eri,2,0,36,34
1657096740232,MATH 103A,A02,083778,Greenfeld; Be'Eri,5,0,36,31
1657096740232,MATH 103A,A03,093561,Greenfeld; Be'Eri,4,0,36,32
1657096740232,MATH 103A,B01,083779,Greenfeld; Be'Eri,6,0,36,30
1657096740232,MATH 103A,B02,083780,Greenfeld; Be'Eri,2,0,36,34
1657096740232,MATH 103A,B03,093562,Greenfeld; Be'Eri,3,0,36,33
1657096746256,MATH 105,A01,085443,Carter; Anne Toulson,14,0,35,21
1657096746256,MATH 105,A02,093477,Carter; Anne Toulson,20,0,35,15
1657096752281,MATH 109,A01,083213,Ganzberger; Geoffrey Michael,2,0,34,32
1657096752281,MATH 109,A02,083214,Ganzberger; Geoffrey Michael,3,0,34,31
1657096752281,MATH 109,A03,093478,Ganzberger; Geoffrey Michael,1,0,34,33
1657096752281,MATH 109,B01,083215,Ganzberger; Geoffrey Michael,1,0,32,31
1657096752281,MATH 109,B02,083216,Ganzberger; Geoffrey Michael,1,0,32,31
1657096752281,MATH 109,B03,093479,Ganzberger; Geoffrey Michael,6,0,32,26
1657096758308,MATH 142A,A01,083219,Chow; Bennett,6,0,32,26
1657096758308,MATH 142A,A02,083220,Chow; Bennett,10,0,32,22
1657096758308,MATH 142A,A03,093480,Chow; Bennett,7,0,32,25
1657096758308,MATH 142A,B03,093481,Chow; Bennett,8,0,32,24
1657096758308,MATH 142A,B04,093558,Chow; Bennett,11,0,32,21
1657096758308,MATH 142A,B05,093559,Chow; Bennett,6,0,32,26
1657096764332,MATH 193A,A01,083224,Rotar; Vladimir,7,0,34,27
1657096764332,MATH 193A,A02,083225,Rotar; Vladimir,5,0,34,29
1657096764332,MATH 193A,A03,083781,Rotar; Vladimir,1,0,34,33
1657096764332,MATH 193A,A04,083782,Rotar; Vladimir,6,0,34,28
1657096764332,MATH 193A,A05,093482,Rotar; Vladimir,6,0,34,28
1657096770359,MATH 197,001,091859,McAuley; Julian John,9999,0,9999,0
1657096770359,MATH 197,002,095566,Kedlaya; Kiran S.,9997,0,9999,2
1657096770359,MATH 197,003,095567,Xiao; Ming,9999,0,9999,0
1657096770359,MATH 197,004,095571,Perols; Johan Lars,9998,0,9999,1
1657096777424,COGS 9,A01,083615,Shannon; Kyle Michael,7,0,75,68
1657096783446,COGS 11,A01,083617,Boyle; Mary E. T.,21,0,48,27
1657096789473,COGS 13,A01,083071,Bastos; Amalia Pinkusfeld,9,0,71,62
1657096795497,COGS 14A,A01,092681,Semenuks; Arturs,1,1,100,99
1657096801521,COGS 14B,A01,083073,Cheng; Tzu-Han,6,0,63,57
1657096807548,COGS 17,A01,092677,Semenuks; Arturs,4,0,81,77
1657096813573,COGS 100,A01,083619,Allen; Michael Gordon,15,0,70,55
1657096819597,COGS 101A,A01,083621,Davis; Joshua Daniel,9,0,68,59
1657096825625,COGS 101B,A01,091572,Allen; Michael Gordon,8,0,65,57
1657096831649,COGS 101C,A01,083625,Delgado; Tania,17,0,35,18
1657096837675,COGS 107A,A01,083627,Boyle; Mary E. T.,13,0,60,47
1657096843700,COGS 118A,A01,083075,Gupta; Anjum,15,0,76,61
1657096849729,CSE 3,A50,083646,Miranda; Gregory Joseph,22,0,50,28
1657096855758,CSE 8A,A50,083650,Miranda; Gregory Joseph,17,1,56,39
1657096861779,CSE 11,A01,083080,Cao; Yingjun,4,15,40,36
1657096867804,CSE 12,A01,083652,Krause-Levy; Sophia Louisa,23,1,120,97
1657096873827,CSE 15L,A01,083654,Morris; Justin Loren,9,0,50,41
1657096873827,CSE 15L,A02,083655,Morris; Justin Loren,9,0,50,41
1657096879855,CSE 20,A01,083657,Tran; Khoa Dang,37,0,80,43
1657096885878,CSE 21,A01,095574,Bach; Quang Tran,21,0,48,27
1657096891901,CSE 30,A01,083084,Eldon; John,4,0,80,76
1657096891901,CSE 30,B01,095061,Bhaskar; Nishant,6,0,50,44
1657096897926,CSE 100,A01,083659,Cao; Yingjun,4,4,70,66
1657096903961,CSE 134B,A01,083661,Powell; Thomas Allan,19,0,100,81
1657096909987,CSE 140,A01,083663,Gungor; Onat,14,0,85,71
1657096916011,CSE 140L,A01,083088,Eldon; John,16,0,100,84
1657096922035,CSE 175,A01,083665,Kumar; Rakesh,3,0,25,22
1657096928061,CSE 190,A00,092507,Dubnov; Shlomo,7,0,20,13
1657096934091,ECE 45,A01,083139,Congero; Spencer William,5,0,75,70
1657096940134,ECE 65,A50,083695,Saad; Andrew S,12,0,30,18
1657096940134,ECE 65,A51,095125,Saad; Andrew S,25,0,26,1
1657096946164,ECE 109,A01,091882,Touri; Behrouz,16,0,70,54
1657096952190,ECE 180,A00,083140,Abi Samra; Nicholas Camill,1,0,30,29
1657096952190,ECE 180,B00,083141,Abi Samra; Nicholas Camill,0,0,30,30
1657096958217,MATH 10A,A01,083735,Patchell; Gregory David,1,0,30,29
1657096958217,MATH 10A,A02,083736,Patchell; Gregory David,20,0,30,10
1657096958217,MATH 10A,A03,083737,Patchell; Gregory David,16,0,30,14
1657096964257,MATH 10B,A01,083207,Lim; Seonhee,7,0,34,27
1657096964257,MATH 10B,A02,083208,Lim; Seonhee,9,0,35,26
1657096964257,MATH 10B,A03,093472,Lim; Seonhee,5,0,34,29
1657096964257,MATH 10B,B01,083739,Sinha; Shubham,9,0,30,21
1657096970285,MATH 18,A01,083743,Cinel; Cameron Alexander,6,0,30,24
1657096970285,MATH 18,A02,083744,Cinel; Cameron Alexander,15,0,30,15
1657096970285,MATH 18,A03,083745,Cinel; Cameron Alexander,8,0,30,22
1657096970285,MATH 18,B01,083748,Rideout; David Porter,4,0,37,33
1657096970285,MATH 18,B02,083749,Rideout; David Porter,3,0,36,33
1657096970285,MATH 18,B03,083750,Rideout; David Porter,2,0,37,35
1657096970285,MATH 18,B04,083751,Rideout; David Porter,5,0,36,31
1657096970285,MATH 18,B05,093473,Rideout; David Porter,4,0,36,32
1657096970285,MATH 18,B06,093474,Rideout; David Porter,5,0,36,31
1657096976309,MATH 20A,A01,083754,Zheng; Zequn,12,0,40,28
1657096982335,MATH 20B,A01,083756,Briones; Jor-el Thomas Caparas,1,0,36,35
1657096982335,MATH 20B,A02,083757,Briones; Jor-el Thomas Caparas,1,0,36,35
1657096982335,MATH 20B,A03,093475,Briones; Jor-el Thomas Caparas,0,0,36,36
1657096988359,MATH 20C,A01,083760,Briones; Jor-el Thomas Caparas,1,0,35,34
1657096988359,MATH 20C,A02,083761,Briones; Jor-el Thomas Caparas,8,0,35,27
1657096988359,MATH 20C,A03,093476,Briones; Jor-el Thomas Caparas,0,1,36,36
1657096988359,MATH 20C,B01,083762,Bach; Quang Tran,0,0,30,30
1657096994389,MATH 20D,A01,083765,Tran; Brian Kha,4,0,30,26
1657096994389,MATH 20D,A02,083766,Tran; Brian Kha,5,0,30,25
1657096994389,MATH 20D,A03,083767,Tran; Brian Kha,3,0,30,27
1657097000416,MATH 20E,A01,083771,Ganguly; Soumya,6,0,32,26
1657097000416,MATH 20E,A02,083772,Ganguly; Soumya,6,0,32,26
1657097000416,MATH 20E,B01,083773,Ciotti; Benjamin,18,0,35,17
1657097000416,MATH 20E,B02,083774,Ciotti; Benjamin,17,0,35,18
1657097006452,MATH 103A,A01,083777,Greenfeld; Be'Eri,2,0,36,34
1657097006452,MATH 103A,A02,083778,Greenfeld; Be'Eri,5,0,36,31
1657097006452,MATH 103A,A03,093561,Greenfeld; Be'Eri,4,0,36,32
1657097006452,MATH 103A,B01,083779,Greenfeld; Be'Eri,6,0,36,30
1657097006452,MATH 103A,B02,083780,Greenfeld; Be'Eri,2,0,36,34
1657097006452,MATH 103A,B03,093562,Greenfeld; Be'Eri,3,0,36,33
1657097012482,MATH 105,A01,085443,Carter; Anne Toulson,14,0,35,21
1657097012482,MATH 105,A02,093477,Carter; Anne Toulson,20,0,35,15
1657097018509,MATH 109,A01,083213,Ganzberger; Geoffrey Michael,2,0,34,32
1657097018509,MATH 109,A02,083214,Ganzberger; Geoffrey Michael,3,0,34,31
1657097018509,MATH 109,A03,093478,Ganzberger; Geoffrey Michael,1,0,34,33
1657097018509,MATH 109,B01,083215,Ganzberger; Geoffrey Michael,1,0,32,31
1657097018509,MATH 109,B02,083216,Ganzberger; Geoffrey Michael,1,0,32,31
1657097018509,MATH 109,B03,093479,Ganzberger; Geoffrey Michael,6,0,32,26
1657097024534,MATH 142A,A01,083219,Chow; Bennett,6,0,32,26
1657097024534,MATH 142A,A02,083220,Chow; Bennett,10,0,32,22
1657097024534,MATH 142A,A03,093480,Chow; Bennett,7,0,32,25
1657097024534,MATH 142A,B03,093481,Chow; Bennett,8,0,32,24
1657097024534,MATH 142A,B04,093558,Chow; Bennett,11,0,32,21
1657097024534,MATH 142A,B05,093559,Chow; Bennett,6,0,32,26
1657097030562,MATH 193A,A01,083224,Rotar; Vladimir,7,0,34,27
1657097030562,MATH 193A,A02,083225,Rotar; Vladimir,5,0,34,29
1657097030562,MATH 193A,A03,083781,Rotar; Vladimir,1,0,34,33
1657097030562,MATH 193A,A04,083782,Rotar; Vladimir,6,0,34,28
1657097030562,MATH 193A,A05,093482,Rotar; Vladimir,6,0,34,28
1657097036587,MATH 197,001,091859,McAuley; Julian John,9999,0,9999,0
1657097036587,MATH 197,002,095566,Kedlaya; Kiran S.,9997,0,9999,2
1657097036587,MATH 197,003,095567,Xiao; Ming,9999,0,9999,0
1657097036587,MATH 197,004,095571,Perols; Johan Lars,9998,0,9999,1
1657097043672,COGS 9,A01,083615,Shannon; Kyle Michael,7,0,75,68
1657097049700,COGS 11,A01,083617,Boyle; Mary E. T.,21,0,48,27
1657097055733,COGS 13,A01,083071,Bastos; Amalia Pinkusfeld,9,0,71,62
1657097061758,COGS 14A,A01,092681,Semenuks; Arturs,1,1,100,99
1657097067782,COGS 14B,A01,083073,Cheng; Tzu-Han,6,0,63,57
1657097073806,COGS 17,A01,092677,Semenuks; Arturs,4,0,81,77
1657097079832,COGS 100,A01,083619,Allen; Michael Gordon,15,0,70,55
1657097085857,COGS 101A,A01,083621,Davis; Joshua Daniel,9,0,68,59
1657097091892,COGS 101B,A01,091572,Allen; Michael Gordon,8,0,65,57
1657097097988,COGS 101C,A01,083625,Delgado; Tania,17,0,35,18
1657097104014,COGS 107A,A01,083627,Boyle; Mary E. T.,13,0,60,47
1657097110048,COGS 118A,A01,083075,Gupta; Anjum,15,0,76,61
1657097116073,CSE 3,A50,083646,Miranda; Gregory Joseph,22,0,50,28
1657097122096,CSE 8A,A50,083650,Miranda; Gregory Joseph,17,1,56,39
1657097128123,CSE 11,A01,083080,Cao; Yingjun,4,15,40,36
1657097134158,CSE 12,A01,083652,Krause-Levy; Sophia Louisa,23,1,120,97
1657097140195,CSE 15L,A01,083654,Morris; Justin Loren,9,0,50,41
1657097140195,CSE 15L,A02,083655,Morris; Justin Loren,9,0,50,41
1657097146222,CSE 20,A01,083657,Tran; Khoa Dang,37,0,80,43
1657097152246,CSE 21,A01,095574,Bach; Quang Tran,21,0,48,27
1657097158276,CSE 30,A01,083084,Eldon; John,4,0,80,76
1657097158276,CSE 30,B01,095061,Bhaskar; Nishant,6,0,50,44
1657097164300,CSE 100,A01,083659,Cao; Yingjun,4,4,70,66
1657097170328,CSE 134B,A01,083661,Powell; Thomas Allan,19,0,100,81
1657097176356,CSE 140,A01,083663,Gungor; Onat,14,0,85,71
1657097182380,CSE 140L,A01,083088,Eldon; John,16,0,100,84
1657097188405,CSE 175,A01,083665,Kumar; Rakesh,3,0,25,22
1657097194430,CSE 190,A00,092507,Dubnov; Shlomo,7,0,20,13
1657097200461,ECE 45,A01,083139,Congero; Spencer William,5,0,75,70
1657097206494,ECE 65,A50,083695,Saad; Andrew S,12,0,30,18
1657097206494,ECE 65,A51,095125,Saad; Andrew S,25,0,26,1
1657097212519,ECE 109,A01,091882,Touri; Behrouz,16,0,70,54
1657097218552,ECE 180,A00,083140,Abi Samra; Nicholas Camill,1,0,30,29
1657097218552,ECE 180,B00,083141,Abi Samra; Nicholas Camill,0,0,30,30
1657097224588,MATH 10A,A01,083735,Patchell; Gregory David,1,0,30,29
1657097224588,MATH 10A,A02,083736,Patchell; Gregory David,20,0,30,10
1657097224588,MATH 10A,A03,083737,Patchell; Gregory David,16,0,30,14
1657097230613,MATH 10B,A01,083207,Lim; Seonhee,7,0,34,27
1657097230613,MATH 10B,A02,083208,Lim; Seonhee,9,0,35,26
1657097230613,MATH 10B,A03,093472,Lim; Seonhee,5,0,34,29
1657097230613,MATH 10B,B01,083739,Sinha; Shubham,9,0,30,21
1657097236641,MATH 18,A01,083743,Cinel; Cameron Alexander,6,0,30,24
1657097236641,MATH 18,A02,083744,Cinel; Cameron Alexander,15,0,30,15
1657097236641,MATH 18,A03,083745,Cinel; Cameron Alexander,8,0,30,22
1657097236641,MATH 18,B01,083748,Rideout; David Porter,4,0,37,33
1657097236641,MATH 18,B02,083749,Rideout; David Porter,3,0,36,33
1657097236641,MATH 18,B03,083750,Rideout; David Porter,2,0,37,35
1657097236641,MATH 18,B04,083751,Rideout; David Porter,5,0,36,31
1657097236641,MATH 18,B05,093473,Rideout; David Porter,4,0,36,32
1657097236641,MATH 18,B06,093474,Rideout; David Porter,5,0,36,31
1657097242664,MATH 20A,A01,083754,Zheng; Zequn,12,0,40,28
1657097248695,MATH 20B,A01,083756,Briones; Jor-el Thomas Caparas,1,0,36,35
1657097248695,MATH 20B,A02,083757,Briones; Jor-el Thomas Caparas,1,0,36,35
1657097248695,MATH 20B,A03,093475,Briones; Jor-el Thomas Caparas,0,0,36,36
1657097254718,MATH 20C,A01,083760,Briones; Jor-el Thomas Caparas,1,0,35,34
1657097254718,MATH 20C,A02,083761,Briones; Jor-el Thomas Caparas,8,0,35,27
1657097254718,MATH 20C,A03,093476,Briones; Jor-el Thomas Caparas,0,1,36,36
1657097254718,MATH 20C,B01,083762,Bach; Quang Tran,0,0,30,30
1657097260742,MATH 20D,A01,083765,Tran; Brian Kha,4,0,30,26
1657097260742,MATH 20D,A02,083766,Tran; Brian Kha,5,0,30,25
1657097260742,MATH 20D,A03,083767,Tran; Brian Kha,3,0,30,27
1657097266773,MATH 20E,A01,083771,Ganguly; Soumya,6,0,32,26
1657097266773,MATH 20E,A02,083772,Ganguly; Soumya,6,0,32,26
1657097266773,MATH 20E,B01,083773,Ciotti; Benjamin,18,0,35,17
1657097266773,MATH 20E,B02,083774,Ciotti; Benjamin,17,0,35,18
1657097272807,MATH 103A,A01,083777,Greenfeld; Be'Eri,2,0,36,34
1657097272807,MATH 103A,A02,083778,Greenfeld; Be'Eri,5,0,36,31
1657097272807,MATH 103A,A03,093561,Greenfeld; Be'Eri,4,0,36,32
1657097272807,MATH 103A,B01,083779,Greenfeld; Be'Eri,6,0,36,30
1657097272807,MATH 103A,B02,083780,Greenfeld; Be'Eri,2,0,36,34
1657097272807,MATH 103A,B03,093562,Greenfeld; Be'Eri,3,0,36,33
1657097278832,MATH 105,A01,085443,Carter; Anne Toulson,14,0,35,21
1657097278832,MATH 105,A02,093477,Carter; Anne Toulson,20,0,35,15
1657097284863,MATH 109,A01,083213,Ganzberger; Geoffrey Michael,2,0,34,32
1657097284863,MATH 109,A02,083214,Ganzberger; Geoffrey Michael,3,0,34,31
1657097284863,MATH 109,A03,093478,Ganzberger; Geoffrey Michael,1,0,34,33
1657097284863,MATH 109,B01,083215,Ganzberger; Geoffrey Michael,1,0,32,31
1657097284863,MATH 109,B02,083216,Ganzberger; Geoffrey Michael,1,0,32,31
1657097284863,MATH 109,B03,093479,Ganzberger; Geoffrey Michael,6,0,32,26
1657097290887,MATH 142A,A01,083219,Chow; Bennett,6,0,32,26
1657097290887,MATH 142A,A02,083220,Chow; Bennett,10,0,32,22
1657097290887,MATH 142A,A03,093480,Chow; Bennett,7,0,32,25
1657097290887,MATH 142A,B03,093481,Chow; Bennett,8,0,32,24
1657097290887,MATH 142A,B04,093558,Chow; Bennett,11,0,32,21
1657097290887,MATH 142A,B05,093559,Chow; Bennett,6,0,32,26
1657097296911,MATH 193A,A01,083224,Rotar; Vladimir,7,0,34,27
1657097296911,MATH 193A,A02,083225,Rotar; Vladimir,5,0,34,29
1657097296911,MATH 193A,A03,083781,Rotar; Vladimir,1,0,34,33
1657097296911,MATH 193A,A04,083782,Rotar; Vladimir,6,0,34,28
1657097296911,MATH 193A,A05,093482,Rotar; Vladimir,6,0,34,28
1657097302933,MATH 197,001,091859,McAuley; Julian John,9999,0,9999,0
1657097302933,MATH 197,002,095566,Kedlaya; Kiran S.,9997,0,9999,2
1657097302933,MATH 197,003,095567,Xiao; Ming,9999,0,9999,0
1657097302933,MATH 197,004,095571,Perols; Johan Lars,9998,0,9999,1
1657097310008,COGS 9,A01,083615,Shannon; Kyle Michael,7,0,75,68
1657097316033,COGS 11,A01,083617,Boyle; Mary E. T.,21,0,48,27
1657097322060,COGS 13,A01,083071,Bastos; Amalia Pinkusfeld,9,0,71,62
1657097328086,COGS 14A,A01,092681,Semenuks; Arturs,1,1,100,99
1657097334109,COGS 14B,A01,083073,Cheng; Tzu-Han,6,0,63,57
1657097340131,COGS 17,A01,092677,Semenuks; Arturs,4,0,81,77
1657097346161,COGS 100,A01,083619,Allen; Michael Gordon,15,0,70,55
1657097352185,COGS 101A,A01,083621,Davis; Joshua Daniel,9,0,68,59
1657097358210,COGS 101B,A01,091572,Allen; Michael Gordon,8,0,65,57
1657097364234,COGS 101C,A01,083625,Delgado; Tania,17,0,35,18
1657097370266,COGS 107A,A01,083627,Boyle; Mary E. T.,13,0,60,47
1657097376293,COGS 118A,A01,083075,Gupta; Anjum,15,0,76,61
1657097382319,CSE 3,A50,083646,Miranda; Gregory Joseph,22,0,50,28
1657097388348,CSE 8A,A50,083650,Miranda; Gregory Joseph,17,1,56,39
1657097394370,CSE 11,A01,083080,Cao; Yingjun,4,15,40,36
1657097400394,CSE 12,A01,083652,Krause-Levy; Sophia Louisa,23,1,120,97
1657097406421,CSE 15L,A01,083654,Morris; Justin Loren,9,0,50,41
1657097406421,CSE 15L,A02,083655,Morris; Justin Loren,9,0,50,41
1657097412448,CSE 20,A01,083657,Tran; Khoa Dang,37,0,80,43
1657097418473,CSE 21,A01,095574,Bach; Quang Tran,21,0,48,27
1657097424498,CSE 30,A01,083084,Eldon; John,4,0,80,76
1657097424498,CSE 30,B01,095061,Bhaskar; Nishant,6,0,50,44
1657097430522,CSE 100,A01,083659,Cao; Yingjun,4,4,70,66
1657097436546,CSE 134B,A01,083661,Powell; Thomas Allan,19,0,100,81
1657097442572,CSE 140,A01,083663,Gungor; Onat,14,0,85,71
1657097448597,CSE 140L,A01,083088,Eldon; John,16,0,100,84
1657097454622,CSE 175,A01,083665,Kumar; Rakesh,3,0,25,22
1657097460651,CSE 190,A00,092507,Dubnov; Shlomo,7,0,20,13
1657097466681,ECE 45,A01,083139,Congero; Spencer William,5,0,75,70
1657097472716,ECE 65,A50,083695,Saad; Andrew S,12,0,30,18
1657097472716,ECE 65,A51,095125,Saad; Andrew S,25,0,26,1
1657097478740,ECE 109,A01,091882,Touri; Behrouz,16,0,70,54
1657097484778,ECE 180,A00,083140,Abi Samra; Nicholas Camill,1,0,30,29
1657097484778,ECE 180,B00,083141,Abi Samra; Nicholas Camill,0,0,30,30
1657097490811,MATH 10A,A01,083735,Patchell; Gregory David,1,0,30,29
1657097490811,MATH 10A,A02,083736,Patchell; Gregory David,20,0,30,10
1657097490811,MATH 10A,A03,083737,Patchell; Gregory David,16,0,30,14
1657097496850,MATH 10B,A01,083207,Lim; Seonhee,7,0,34,27
1657097496850,MATH 10B,A02,083208,Lim; Seonhee,9,0,35,26
1657097496850,MATH 10B,A03,093472,Lim; Seonhee,5,0,34,29
1657097496850,MATH 10B,B01,083739,Sinha; Shubham,9,0,30,21
1657097502888,MATH 18,A01,083743,Cinel; Cameron Alexander,6,0,30,24
1657097502888,MATH 18,A02,083744,Cinel; Cameron Alexander,15,0,30,15
1657097502888,MATH 18,A03,083745,Cinel; Cameron Alexander,8,0,30,22
1657097502888,MATH 18,B01,083748,Rideout; David Porter,4,0,37,33
1657097502888,MATH 18,B02,083749,Rideout; David Porter,3,0,36,33
1657097502888,MATH 18,B03,083750,Rideout; David Porter,2,0,37,35
1657097502888,MATH 18,B04,083751,Rideout; David Porter,5,0,36,31
1657097502888,MATH 18,B05,093473,Rideout; David Porter,4,0,36,32
1657097502888,MATH 18,B06,093474,Rideout; David Porter,5,0,36,31
1657097508913,MATH 20A,A01,083754,Zheng; Zequn,12,0,40,28
1657097514954,MATH 20B,A01,083756,Briones; Jor-el Thomas Caparas,1,0,36,35
1657097514954,MATH 20B,A02,083757,Briones; Jor-el Thomas Caparas,1,0,36,35
1657097514954,MATH 20B,A03,093475,Briones; Jor-el Thomas Caparas,0,0,36,36
1657097520993,MATH 20C,A01,083760,Briones; Jor-el Thomas Caparas,1,0,35,34
1657097520993,MATH 20C,A02,083761,Briones; Jor-el Thomas Caparas,8,0,35,27
1657097520993,MATH 20C,A03,093476,Briones; Jor-el Thomas Caparas,0,1,36,36
1657097520993,MATH 20C,B01,083762,Bach; Quang Tran,0,0,30,30
1657097527023,MATH 20D,A01,083765,Tran; Brian Kha,4,0,30,26
1657097527023,MATH 20D,A02,083766,Tran; Brian Kha,5,0,30,25
1657097527023,MATH 20D,A03,083767,Tran; Brian Kha,3,0,30,27
1657097533048,MATH 20E,A01,083771,Ganguly; Soumya,6,0,32,26
1657097533048,MATH 20E,A02,083772,Ganguly; Soumya,6,0,32,26
1657097533048,MATH 20E,B01,083773,Ciotti; Benjamin,18,0,35,17
1657097533048,MATH 20E,B02,083774,Ciotti; Benjamin,17,0,35,18
1657097539074,MATH 103A,A01,083777,Greenfeld; Be'Eri,2,0,36,34
1657097539074,MATH 103A,A02,083778,Greenfeld; Be'Eri,5,0,36,31
1657097539074,MATH 103A,A03,093561,Greenfeld; Be'Eri,4,0,36,32
1657097539074,MATH 103A,B01,083779,Greenfeld; Be'Eri,6,0,36,30
1657097539074,MATH 103A,B02,083780,Greenfeld; Be'Eri,2,0,36,34
1657097539074,MATH 103A,B03,093562,Greenfeld; Be'Eri,3,0,36,33
1657097545096,MATH 105,A01,085443,Carter; Anne Toulson,14,0,35,21
1657097545096,MATH 105,A02,093477,Carter; Anne Toulson,20,0,35,15
1657097551121,MATH 109,A01,083213,Ganzberger; Geoffrey Michael,2,0,34,32
1657097551121,MATH 109,A02,083214,Ganzberger; Geoffrey Michael,3,0,34,31
1657097551121,MATH 109,A03,093478,Ganzberger; Geoffrey Michael,1,0,34,33
1657097551121,MATH 109,B01,083215,Ganzberger; Geoffrey Michael,1,0,32,31
1657097551121,MATH 109,B02,083216,Ganzberger; Geoffrey Michael,1,0,32,31
1657097551121,MATH 109,B03,093479,Ganzberger; Geoffrey Michael,6,0,32,26
1657097557144,MATH 142A,A01,083219,Chow; Bennett,6,0,32,26
1657097557144,MATH 142A,A02,083220,Chow; Bennett,10,0,32,22
1657097557144,MATH 142A,A03,093480,Chow; Bennett,7,0,32,25
1657097557144,MATH 142A,B03,093481,Chow; Bennett,8,0,32,24
1657097557144,MATH 142A,B04,093558,Chow; Bennett,11,0,32,21
1657097557144,MATH 142A,B05,093559,Chow; Bennett,6,0,32,26
1657097563175,MATH 193A,A01,083224,Rotar; Vladimir,7,0,34,27
1657097563175,MATH 193A,A02,083225,Rotar; Vladimir,5,0,34,29
1657097563175,MATH 193A,A03,083781,Rotar; Vladimir,1,0,34,33
1657097563175,MATH 193A,A04,083782,Rotar; Vladimir,6,0,34,28
1657097563175,MATH 193A,A05,093482,Rotar; Vladimir,6,0,34,28
1657097569201,MATH 197,001,091859,McAuley; Julian John,9999,0,9999,0
1657097569201,MATH 197,002,095566,Kedlaya; Kiran S.,9997,0,9999,2
1657097569201,MATH 197,003,095567,Xiao; Ming,9999,0,9999,0
1657097569201,MATH 197,004,095571,Perols; Johan Lars,9998,0,9999,1
1657097576270,COGS 9,A01,083615,Shannon; Kyle Michael,7,0,75,68
1657097582293,COGS 11,A01,083617,Boyle; Mary E. T.,21,0,48,27
1657097588317,COGS 13,A01,083071,Bastos; Amalia Pinkusfeld,9,0,71,62
1657097594340,COGS 14A,A01,092681,Semenuks; Arturs,1,1,100,99
1657097600365,COGS 14B,A01,083073,Cheng; Tzu-Han,6,0,63,57
1657097606391,COGS 17,A01,092677,Semenuks; Arturs,4,0,81,77
1657097612414,COGS 100,A01,083619,Allen; Michael Gordon,15,0,70,55
1657097618438,COGS 101A,A01,083621,Davis; Joshua Daniel,9,0,68,59
1657097624459,COGS 101B,A01,091572,Allen; Michael Gordon,8,0,65,57
1657097630491,COGS 101C,A01,083625,Delgado; Tania,17,0,35,18
1657097636517,COGS 107A,A01,083627,Boyle; Mary E. T.,13,0,60,47
1657097642547,COGS 118A,A01,083075,Gupta; Anjum,15,0,76,61
1657097648576,CSE 3,A50,083646,Miranda; Gregory Joseph,22,0,50,28
1657097654598,CSE 8A,A50,083650,Miranda; Gregory Joseph,17,1,56,39
1657097660622,CSE 11,A01,083080,Cao; Yingjun,4,15,40,36
1657097666644,CSE 12,A01,083652,Krause-Levy; Sophia Louisa,23,1,120,97
1657097672669,CSE 15L,A01,083654,Morris; Justin Loren,9,0,50,41
1657097672669,CSE 15L,A02,083655,Morris; Justin Loren,9,0,50,41
1657097678692,CSE 20,A01,083657,Tran; Khoa Dang,37,0,80,43
1657097684716,CSE 21,A01,095574,Bach; Quang Tran,21,0,48,27
1657097690743,CSE 30,A01,083084,Eldon; John,4,0,80,76
1657097690743,CSE 30,B01,095061,Bhaskar; Nishant,6,0,50,44
1657097696858,CSE 100,A01,083659,Cao; Yingjun,4,4,70,66
1657097702896,CSE 134B,A01,083661,Powell; Thomas Allan,19,0,100,81
1657097708923,CSE 140,A01,083663,Gungor; Onat,14,0,85,71
1657097714950,CSE 140L,A01,083088,Eldon; John,16,0,100,84
1657097720972,CSE 175,A01,083665,Kumar; Rakesh,3,0,25,22
1657097726998,CSE 190,A00,092507,Dubnov; Shlomo,7,0,20,13
1657097733024,ECE 45,A01,083139,Congero; Spencer William,5,0,75,70
1657097739055,ECE 65,A50,083695,Saad; Andrew S,12,0,30,18
1657097739055,ECE 65,A51,095125,Saad; Andrew S,25,0,26,1
1657097745078,ECE 109,A01,091882,Touri; Behrouz,16,0,70,54
1657097751134,ECE 180,A00,083140,Abi Samra; Nicholas Camill,1,0,30,29
1657097751134,ECE 180,B00,083141,Abi Samra; Nicholas Camill,0,0,30,30
1657097757174,MATH 10A,A01,083735,Patchell; Gregory David,1,0,30,29
1657097757174,MATH 10A,A02,083736,Patchell; Gregory David,20,0,30,10
1657097757174,MATH 10A,A03,083737,Patchell; Gregory David,16,0,30,14
1657097763200,MATH 10B,A01,083207,Lim; Seonhee,7,0,34,27
1657097763200,MATH 10B,A02,083208,Lim; Seonhee,9,0,35,26
1657097763200,MATH 10B,A03,093472,Lim; Seonhee,5,0,34,29
1657097763200,MATH 10B,B01,083739,Sinha; Shubham,9,0,30,21
1657097769236,MATH 18,A01,083743,Cinel; Cameron Alexander,6,0,30,24
1657097769236,MATH 18,A02,083744,Cinel; Cameron Alexander,15,0,30,15
1657097769236,MATH 18,A03,083745,Cinel; Cameron Alexander,8,0,30,22
1657097769236,MATH 18,B01,083748,Rideout; David Porter,4,0,37,33
1657097769236,MATH 18,B02,083749,Rideout; David Porter,3,0,36,33
1657097769236,MATH 18,B03,083750,Rideout; David Porter,2,0,37,35
1657097769236,MATH 18,B04,083751,Rideout; David Porter,5,0,36,31
1657097769236,MATH 18,B05,093473,Rideout; David Porter,4,0,36,32
1657097769236,MATH 18,B06,093474,Rideout; David Porter,5,0,36,31
1657097775267,MATH 20A,A01,083754,Zheng; Zequn,12,0,40,28
1657097781304,MATH 20B,A01,083756,Briones; Jor-el Thomas Caparas,1,0,36,35
1657097781304,MATH 20B,A02,083757,Briones; Jor-el Thomas Caparas,1,0,36,35
1657097781304,MATH 20B,A03,093475,Briones; Jor-el Thomas Caparas,0,0,36,36
1657097787334,MATH 20C,A01,083760,Briones; Jor-el Thomas Caparas,1,0,35,34
1657097787334,MATH 20C,A02,083761,Briones; Jor-el Thomas Caparas,8,0,35,27
1657097787334,MATH 20C,A03,093476,Briones; Jor-el Thomas Caparas,0,1,36,36
1657097787334,MATH 20C,B01,083762,Bach; Quang Tran,0,0,30,30
1657097793365,MATH 20D,A01,083765,Tran; Brian Kha,4,0,30,26
1657097793365,MATH 20D,A02,083766,Tran; Brian Kha,5,0,30,25
1657097793365,MATH 20D,A03,083767,Tran; Brian Kha,3,0,30,27
1657097799397,MATH 20E,A01,083771,Ganguly; Soumya,6,0,32,26
1657097799397,MATH 20E,A02,083772,Ganguly; Soumya,6,0,32,26
1657097799397,MATH 20E,B01,083773,Ciotti; Benjamin,18,0,35,17
1657097799397,MATH 20E,B02,083774,Ciotti; Benjamin,17,0,35,18
1657097805427,MATH 103A,A01,083777,Greenfeld; Be'Eri,2,0,36,34
1657097805427,MATH 103A,A02,083778,Greenfeld; Be'Eri,5,0,36,31
1657097805427,MATH 103A,A03,093561,Greenfeld; Be'Eri,4,0,36,32
1657097805427,MATH 103A,B01,083779,Greenfeld; Be'Eri,6,0,36,30
1657097805427,MATH 103A,B02,083780,Greenfeld; Be'Eri,2,0,36,34
1657097805427,MATH 103A,B03,093562,Greenfeld; Be'Eri,3,0,36,33
1657097811450,MATH 105,A01,085443,Carter; Anne Toulson,14,0,35,21
1657097811450,MATH 105,A02,093477,Carter; Anne Toulson,20,0,35,15
1657097817474,MATH 109,A01,083213,Ganzberger; Geoffrey Michael,2,0,34,32
1657097817474,MATH 109,A02,083214,Ganzberger; Geoffrey Michael,3,0,34,31
1657097817474,MATH 109,A03,093478,Ganzberger; Geoffrey Michael,1,0,34,33
1657097817474,MATH 109,B01,083215,Ganzberger; Geoffrey Michael,1,0,32,31
1657097817474,MATH 109,B02,083216,Ganzberger; Geoffrey Michael,1,0,32,31
1657097817474,MATH 109,B03,093479,Ganzberger; Geoffrey Michael,6,0,32,26
1657097823500,MATH 142A,A01,083219,Chow; Bennett,6,0,32,26
1657097823500,MATH 142A,A02,083220,Chow; Bennett,10,0,32,22
1657097823500,MATH 142A,A03,093480,Chow; Bennett,7,0,32,25
1657097823500,MATH 142A,B03,093481,Chow; Bennett,8,0,32,24
1657097823500,MATH 142A,B04,093558,Chow; Bennett,11,0,32,21
1657097823500,MATH 142A,B05,093559,Chow; Bennett,6,0,32,26
1657097829526,MATH 193A,A01,083224,Rotar; Vladimir,7,0,34,27
1657097829526,MATH 193A,A02,083225,Rotar; Vladimir,5,0,34,29
1657097829526,MATH 193A,A03,083781,Rotar; Vladimir,1,0,34,33
1657097829526,MATH 193A,A04,083782,Rotar; Vladimir,6,0,34,28
1657097829526,MATH 193A,A05,093482,Rotar; Vladimir,6,0,34,28
1657097835550,MATH 197,001,091859,McAuley; Julian John,9999,0,9999,0
1657097835550,MATH 197,002,095566,Kedlaya; Kiran S.,9997,0,9999,2
1657097835550,MATH 197,003,095567,Xiao; Ming,9999,0,9999,0
1657097835550,MATH 197,004,095571,Perols; Johan Lars,9998,0,9999,1
1657097842623,COGS 9,A01,083615,Shannon; Kyle Michael,7,0,75,68
1657097848646,COGS 11,A01,083617,Boyle; Mary E. T.,21,0,48,27
1657097854677,COGS 13,A01,083071,Bastos; Amalia Pinkusfeld,9,0,71,62
1657097860704,COGS 14A,A01,092681,Semenuks; Arturs,1,1,100,99
1657097866734,COGS 14B,A01,083073,Cheng; Tzu-Han,6,0,63,57
1657097872759,COGS 17,A01,092677,Semenuks; Arturs,4,0,81,77
1657097878783,COGS 100,A01,083619,Allen; Michael Gordon,15,0,70,55
1657097884807,COGS 101A,A01,083621,Davis; Joshua Daniel,9,0,68,59
1657097890833,COGS 101B,A01,091572,Allen; Michael Gordon,8,0,65,57
1657097896862,COGS 101C,A01,083625,Delgado; Tania,17,0,35,18
1657097902890,COGS 107A,A01,083627,Boyle; Mary E. T.,13,0,60,47
1657097908916,COGS 118A,A01,083075,Gupta; Anjum,15,0,76,61
1657097914945,CSE 3,A50,083646,Miranda; Gregory Joseph,22,0,50,28
1657097920975,CSE 8A,A50,083650,Miranda; Gregory Joseph,17,1,56,39
1657097927002,CSE 11,A01,083080,Cao; Yingjun,4,15,40,36
1657097933027,CSE 12,A01,083652,Krause-Levy; Sophia Louisa,23,1,120,97
1657097939055,CSE 15L,A01,083654,Morris; Justin Loren,9,0,50,41
1657097939055,CSE 15L,A02,083655,Morris; Justin Loren,9,0,50,41
1657097945082,CSE 20,A01,083657,Tran; Khoa Dang,37,0,80,43
1657097951104,CSE 21,A01,095574,Bach; Quang Tran,21,0,48,27
1657097957126,CSE 30,A01,083084,Eldon; John,4,0,80,76
1657097957126,CSE 30,B01,095061,Bhaskar; Nishant,6,0,50,44
1657097963153,CSE 100,A01,083659,Cao; Yingjun,4,4,70,66
1657097969176,CSE 134B,A01,083661,Powell; Thomas Allan,19,0,100,81
1657097975202,CSE 140,A01,083663,Gungor; Onat,14,0,85,71
1657097981230,CSE 140L,A01,083088,Eldon; John,16,0,100,84
1657097987253,CSE 175,A01,083665,Kumar; Rakesh,3,0,25,22
1657097993279,CSE 190,A00,092507,Dubnov; Shlomo,7,0,20,13
1657097999304,ECE 45,A01,083139,Congero; Spencer William,5,0,75,70
1657098005332,ECE 65,A50,083695,Saad; Andrew S,12,0,30,18
1657098005332,ECE 65,A51,095125,Saad; Andrew S,25,0,26,1
1657098011359,ECE 109,A01,091882,Touri; Behrouz,16,0,70,54
1657098017381,ECE 180,A00,083140,Abi Samra; Nicholas Camill,1,0,30,29
1657098017381,ECE 180,B00,083141,Abi Samra; Nicholas Camill,0,0,30,30
1657098023405,MATH 10A,A01,083735,Patchell; Gregory David,1,0,30,29
1657098023405,MATH 10A,A02,083736,Patchell; Gregory David,20,0,30,10
1657098023405,MATH 10A,A03,083737,Patchell; Gregory David,16,0,30,14
1657098029434,MATH 10B,A01,083207,Lim; Seonhee,7,0,34,27
1657098029434,MATH 10B,A02,083208,Lim; Seonhee,9,0,35,26
1657098029434,MATH 10B,A03,093472,Lim; Seonhee,5,0,34,29
1657098029434,MATH 10B,B01,083739,Sinha; Shubham,9,0,30,21
1657098035457,MATH 18,A01,083743,Cinel; Cameron Alexander,6,0,30,24
1657098035457,MATH 18,A02,083744,Cinel; Cameron Alexander,15,0,30,15
1657098035457,MATH 18,A03,083745,Cinel; Cameron Alexander,8,0,30,22
1657098035457,MATH 18,B01,083748,Rideout; David Porter,4,0,37,33
1657098035457,MATH 18,B02,083749,Rideout; David Porter,3,0,36,33
1657098035457,MATH 18,B03,083750,Rideout; David Porter,2,0,37,35
1657098035457,MATH 18,B04,083751,Rideout; David Porter,5,0,36,31
1657098035457,MATH 18,B05,093473,Rideout; David Porter,4,0,36,32
1657098035457,MATH 18,B06,093474,Rideout; David Porter,5,0,36,31
1657098041484,MATH 20A,A01,083754,Zheng; Zequn,12,0,40,28
1657098047509,MATH 20B,A01,083756,Briones; Jor-el Thomas Caparas,1,0,36,35
1657098047509,MATH 20B,A02,083757,Briones; Jor-el Thomas Caparas,1,0,36,35
1657098047509,MATH 20B,A03,093475,Briones; Jor-el Thomas Caparas,0,0,36,36
1657098053533,MATH 20C,A01,083760,Briones; Jor-el Thomas Caparas,1,0,35,34
1657098053533,MATH 20C,A02,083761,Briones; Jor-el Thomas Caparas,8,0,35,27
1657098053533,MATH 20C,A03,093476,Briones; Jor-el Thomas Caparas,0,1,36,36
1657098053533,MATH 20C,B01,083762,Bach; Quang Tran,0,0,30,30
1657098059556,MATH 20D,A01,083765,Tran; Brian Kha,4,0,30,26
1657098059556,MATH 20D,A02,083766,Tran; Brian Kha,5,0,30,25
1657098059556,MATH 20D,A03,083767,Tran; Brian Kha,3,0,30,27
1657098065595,MATH 20E,A01,083771,Ganguly; Soumya,6,0,32,26
1657098065595,MATH 20E,A02,083772,Ganguly; Soumya,6,0,32,26
1657098065595,MATH 20E,B01,083773,Ciotti; Benjamin,18,0,35,17
1657098065595,MATH 20E,B02,083774,Ciotti; Benjamin,17,0,35,18
1657098071631,MATH 103A,A01,083777,Greenfeld; Be'Eri,2,0,36,34
1657098071631,MATH 103A,A02,083778,Greenfeld; Be'Eri,5,0,36,31
1657098071631,MATH 103A,A03,093561,Greenfeld; Be'Eri,4,0,36,32
1657098071631,MATH 103A,B01,083779,Greenfeld; Be'Eri,6,0,36,30
1657098071631,MATH 103A,B02,083780,Greenfeld; Be'Eri,2,0,36,34
1657098071631,MATH 103A,B03,093562,Greenfeld; Be'Eri,3,0,36,33
1657098077659,MATH 105,A01,085443,Carter; Anne Toulson,14,0,35,21
1657098077659,MATH 105,A02,093477,Carter; Anne Toulson,20,0,35,15
1657098083690,MATH 109,A01,083213,Ganzberger; Geoffrey Michael,2,0,34,32
1657098083690,MATH 109,A02,083214,Ganzberger; Geoffrey Michael,3,0,34,31
1657098083690,MATH 109,A03,093478,Ganzberger; Geoffrey Michael,1,0,34,33
1657098083690,MATH 109,B01,083215,Ganzberger; Geoffrey Michael,1,0,32,31
1657098083690,MATH 109,B02,083216,Ganzberger; Geoffrey Michael,1,0,32,31
1657098083690,MATH 109,B03,093479,Ganzberger; Geoffrey Michael,6,0,32,26
1657098089721,MATH 142A,A01,083219,Chow; Bennett,6,0,32,26
1657098089721,MATH 142A,A02,083220,Chow; Bennett,10,0,32,22
1657098089721,MATH 142A,A03,093480,Chow; Bennett,7,0,32,25
1657098089721,MATH 142A,B03,093481,Chow; Bennett,8,0,32,24
1657098089721,MATH 142A,B04,093558,Chow; Bennett,11,0,32,21
1657098089721,MATH 142A,B05,093559,Chow; Bennett,6,0,32,26
1657098095747,MATH 193A,A01,083224,Rotar; Vladimir,7,0,34,27
1657098095747,MATH 193A,A02,083225,Rotar; Vladimir,5,0,34,29
1657098095747,MATH 193A,A03,083781,Rotar; Vladimir,1,0,34,33
1657098095747,MATH 193A,A04,083782,Rotar; Vladimir,6,0,34,28
1657098095747,MATH 193A,A05,093482,Rotar; Vladimir,6,0,34,28
1657098101770,MATH 197,001,091859,McAuley; Julian John,9999,0,9999,0
1657098101770,MATH 197,002,095566,Kedlaya; Kiran S.,9997,0,9999,2
1657098101770,MATH 197,003,095567,Xiao; Ming,9999,0,9999,0
1657098101770,MATH 197,004,095571,Perols; Johan Lars,9998,0,9999,1
1657098108837,COGS 9,A01,083615,Shannon; Kyle Michael,7,0,75,68
1657098114867,COGS 11,A01,083617,Boyle; Mary E. T.,21,0,48,27
1657098120890,COGS 13,A01,083071,Bastos; Amalia Pinkusfeld,9,0,71,62
1657098126920,COGS 14A,A01,092681,Semenuks; Arturs,1,1,100,99
1657098132943,COGS 14B,A01,083073,Cheng; Tzu-Han,6,0,63,57
1657098138967,COGS 17,A01,092677,Semenuks; Arturs,4,0,81,77
1657098144990,COGS 100,A01,083619,Allen; Michael Gordon,15,0,70,55
1657098151013,COGS 101A,A01,083621,Davis; Joshua Daniel,9,0,68,59
1657098157037,COGS 101B,A01,091572,Allen; Michael Gordon,8,0,65,57
1657098163064,COGS 101C,A01,083625,Delgado; Tania,17,0,35,18
1657098169087,COGS 107A,A01,083627,Boyle; Mary E. T.,13,0,60,47
1657098175111,COGS 118A,A01,083075,Gupta; Anjum,15,0,76,61
1657098181139,CSE 3,A50,083646,Miranda; Gregory Joseph,22,0,50,28
1657098187168,CSE 8A,A50,083650,Miranda; Gregory Joseph,17,1,56,39
1657098193191,CSE 11,A01,083080,Cao; Yingjun,4,15,40,36
1657098199214,CSE 12,A01,083652,Krause-Levy; Sophia Louisa,23,1,120,97
1657098205242,CSE 15L,A01,083654,Morris; Justin Loren,9,0,50,41
1657098205242,CSE 15L,A02,083655,Morris; Justin Loren,9,0,50,41
1657098211266,CSE 20,A01,083657,Tran; Khoa Dang,37,0,80,43
1657098217292,CSE 21,A01,095574,Bach; Quang Tran,21,0,48,27
1657098223322,CSE 30,A01,083084,Eldon; John,4,0,80,76
1657098223322,CSE 30,B01,095061,Bhaskar; Nishant,6,0,50,44
1657098229350,CSE 100,A01,083659,Cao; Yingjun,4,4,70,66
1657098235375,CSE 134B,A01,083661,Powell; Thomas Allan,19,0,100,81
1657098241398,CSE 140,A01,083663,Gungor; Onat,14,0,85,71
1657098247426,CSE 140L,A01,083088,Eldon; John,16,0,100,84
1657098253450,CSE 175,A01,083665,Kumar; Rakesh,3,0,25,22
1657098259478,CSE 190,A00,092507,Dubnov; Shlomo,7,0,20,13
1657098265504,ECE 45,A01,083139,Congero; Spencer William,5,0,75,70
1657098271528,ECE 65,A50,083695,Saad; Andrew S,12,0,30,18
1657098271528,ECE 65,A51,095125,Saad; Andrew S,25,0,26,1
1657098277552,ECE 109,A01,091882,Touri; Behrouz,16,0,70,54
1657098283580,ECE 180,A00,083140,Abi Samra; Nicholas Camill,1,0,30,29
1657098283580,ECE 180,B00,083141,Abi Samra; Nicholas Camill,0,0,30,30
1657098289620,MATH 10A,A01,083735,Patchell; Gregory David,1,0,30,29
1657098289620,MATH 10A,A02,083736,Patchell; Gregory David,20,0,30,10
1657098289620,MATH 10A,A03,083737,Patchell; Gregory David,16,0,30,14
1657098295749,MATH 10B,A01,083207,Lim; Seonhee,7,0,34,27
1657098295749,MATH 10B,A02,083208,Lim; Seonhee,9,0,35,26
1657098295749,MATH 10B,A03,093472,Lim; Seonhee,5,0,34,29
1657098295749,MATH 10B,B01,083739,Sinha; Shubham,9,0,30,21
1657098301776,MATH 18,A01,083743,Cinel; Cameron Alexander,6,0,30,24
1657098301776,MATH 18,A02,083744,Cinel; Cameron Alexander,15,0,30,15
1657098301776,MATH 18,A03,083745,Cinel; Cameron Alexander,8,0,30,22
1657098301776,MATH 18,B01,083748,Rideout; David Porter,4,0,37,33
1657098301776,MATH 18,B02,083749,Rideout; David Porter,3,0,36,33
1657098301776,MATH 18,B03,083750,Rideout; David Porter,2,0,37,35
1657098301776,MATH 18,B04,083751,Rideout; David Porter,5,0,36,31
1657098301776,MATH 18,B05,093473,Rideout; David Porter,4,0,36,32
1657098301776,MATH 18,B06,093474,Rideout; David Porter,5,0,36,31
1657098307806,MATH 20A,A01,083754,Zheng; Zequn,12,0,40,28
1657098313831,MATH 20B,A01,083756,Briones; Jor-el Thomas Caparas,1,0,36,35
1657098313831,MATH 20B,A02,083757,Briones; Jor-el Thomas Caparas,1,0,36,35
1657098313831,MATH 20B,A03,093475,Briones; Jor-el Thomas Caparas,0,0,36,36
1657098319861,MATH 20C,A01,083760,Briones; Jor-el Thomas Caparas,1,0,35,34
1657098319861,MATH 20C,A02,083761,Briones; Jor-el Thomas Caparas,8,0,35,27
1657098319861,MATH 20C,A03,093476,Briones; Jor-el Thomas Caparas,0,1,36,36
1657098319861,MATH 20C,B01,083762,Bach; Quang Tran,0,0,30,30
1657098325885,MATH 20D,A01,083765,Tran; Brian Kha,4,0,30,26
1657098325885,MATH 20D,A02,083766,Tran; Brian Kha,5,0,30,25
1657098325885,MATH 20D,A03,083767,Tran; Brian Kha,3,0,30,27
1657098331912,MATH 20E,A01,083771,Ganguly; Soumya,6,0,32,26
1657098331912,MATH 20E,A02,083772,Ganguly; Soumya,6,0,32,26
1657098331912,MATH 20E,B01,083773,Ciotti; Benjamin,18,0,35,17
1657098331912,MATH 20E,B02,083774,Ciotti; Benjamin,17,0,35,18
1657098337936,MATH 103A,A01,083777,Greenfeld; Be'Eri,2,0,36,34
1657098337936,MATH 103A,A02,083778,Greenfeld; Be'Eri,5,0,36,31
1657098337936,MATH 103A,A03,093561,Greenfeld; Be'Eri,4,0,36,32
1657098337936,MATH 103A,B01,083779,Greenfeld; Be'Eri,6,0,36,30
1657098337936,MATH 103A,B02,083780,Greenfeld; Be'Eri,2,0,36,34
1657098337936,MATH 103A,B03,093562,Greenfeld; Be'Eri,3,0,36,33
1657098343962,MATH 105,A01,085443,Carter; Anne Toulson,14,0,35,21
1657098343962,MATH 105,A02,093477,Carter; Anne Toulson,20,0,35,15
1657098349994,MATH 109,A01,083213,Ganzberger; Geoffrey Michael,2,0,34,32
1657098349994,MATH 109,A02,083214,Ganzberger; Geoffrey Michael,3,0,34,31
1657098349994,MATH 109,A03,093478,Ganzberger; Geoffrey Michael,1,0,34,33
1657098349994,MATH 109,B01,083215,Ganzberger; Geoffrey Michael,1,0,32,31
1657098349994,MATH 109,B02,083216,Ganzberger; Geoffrey Michael,1,0,32,31
1657098349994,MATH 109,B03,093479,Ganzberger; Geoffrey Michael,6,0,32,26
1657098356023,MATH 142A,A01,083219,Chow; Bennett,6,0,32,26
1657098356023,MATH 142A,A02,083220,Chow; Bennett,10,0,32,22
1657098356023,MATH 142A,A03,093480,Chow; Bennett,7,0,32,25
1657098356023,MATH 142A,B03,093481,Chow; Bennett,8,0,32,24
1657098356023,MATH 142A,B04,093558,Chow; Bennett,11,0,32,21
1657098356023,MATH 142A,B05,093559,Chow; Bennett,6,0,32,26
1657098362049,MATH 193A,A01,083224,Rotar; Vladimir,7,0,34,27
1657098362049,MATH 193A,A02,083225,Rotar; Vladimir,5,0,34,29
1657098362049,MATH 193A,A03,083781,Rotar; Vladimir,1,0,34,33
1657098362049,MATH 193A,A04,083782,Rotar; Vladimir,6,0,34,28
1657098362049,MATH 193A,A05,093482,Rotar; Vladimir,6,0,34,28
1657098368073,MATH 197,001,091859,McAuley; Julian John,9999,0,9999,0
1657098368073,MATH 197,002,095566,Kedlaya; Kiran S.,9997,0,9999,2
1657098368073,MATH 197,003,095567,Xiao; Ming,9999,0,9999,0
1657098368073,MATH 197,004,095571,Perols; Johan Lars,9998,0,9999,1
1657098375138,COGS 9,A01,083615,Shannon; Kyle Michael,7,0,75,68
1657098381160,COGS 11,A01,083617,Boyle; Mary E. T.,21,0,48,27
1657098387188,COGS 13,A01,083071,Bastos; Amalia Pinkusfeld,9,0,71,62
1657098393212,COGS 14A,A01,092681,Semenuks; Arturs,1,1,100,99
1657098399237,COGS 14B,A01,083073,Cheng; Tzu-Han,6,0,63,57
1657098405260,COGS 17,A01,092677,Semenuks; Arturs,4,0,81,77
1657098411290,COGS 100,A01,083619,Allen; Michael Gordon,15,0,70,55
1657098417316,COGS 101A,A01,083621,Davis; Joshua Daniel,9,0,68,59
1657098423342,COGS 101B,A01,091572,Allen; Michael Gordon,8,0,65,57
1657098429367,COGS 101C,A01,083625,Delgado; Tania,17,0,35,18
1657098435390,COGS 107A,A01,083627,Boyle; Mary E. T.,13,0,60,47
1657098441419,COGS 118A,A01,083075,Gupta; Anjum,15,0,76,61
1657098447443,CSE 3,A50,083646,Miranda; Gregory Joseph,22,0,50,28
1657098453471,CSE 8A,A50,083650,Miranda; Gregory Joseph,17,1,56,39
1657098459499,CSE 11,A01,083080,Cao; Yingjun,4,15,40,36
1657098465529,CSE 12,A01,083652,Krause-Levy; Sophia Louisa,23,1,120,97
1657098471556,CSE 15L,A01,083654,Morris; Justin Loren,9,0,50,41
1657098471556,CSE 15L,A02,083655,Morris; Justin Loren,9,0,50,41
1657098477580,CSE 20,A01,083657,Tran; Khoa Dang,37,0,80,43
1657098483605,CSE 21,A01,095574,Bach; Quang Tran,21,0,48,27
1657098489629,CSE 30,A01,083084,Eldon; John,4,0,80,76
1657098489629,CSE 30,B01,095061,Bhaskar; Nishant,6,0,50,44
1657098495709,CSE 100,A01,083659,Cao; Yingjun,4,4,70,66
1657098501731,CSE 134B,A01,083661,Powell; Thomas Allan,19,0,100,81
1657098507757,CSE 140,A01,083663,Gungor; Onat,14,0,85,71
1657098513784,CSE 140L,A01,083088,Eldon; John,16,0,100,84
1657098519811,CSE 175,A01,083665,Kumar; Rakesh,3,0,25,22
1657098525833,CSE 190,A00,092507,Dubnov; Shlomo,7,0,20,13
1657098531857,ECE 45,A01,083139,Congero; Spencer William,5,0,75,70
1657098537880,ECE 65,A50,083695,Saad; Andrew S,12,0,30,18
1657098537880,ECE 65,A51,095125,Saad; Andrew S,25,0,26,1
1657098543906,ECE 109,A01,091882,Touri; Behrouz,16,0,70,54
1657098549931,ECE 180,A00,083140,Abi Samra; Nicholas Camill,1,0,30,29
1657098549931,ECE 180,B00,083141,Abi Samra; Nicholas Camill,0,0,30,30
1657098555954,MATH 10A,A01,083735,Patchell; Gregory David,1,0,30,29
1657098555954,MATH 10A,A02,083736,Patchell; Gregory David,20,0,30,10
1657098555954,MATH 10A,A03,083737,Patchell; Gregory David,16,0,30,14
1657098561977,MATH 10B,A01,083207,Lim; Seonhee,7,0,34,27
1657098561977,MATH 10B,A02,083208,Lim; Seonhee,9,0,35,26
1657098561977,MATH 10B,A03,093472,Lim; Seonhee,5,0,34,29
1657098561977,MATH 10B,B01,083739,Sinha; Shubham,9,0,30,21
1657098568015,MATH 18,A01,083743,Cinel; Cameron Alexander,6,0,30,24
1657098568015,MATH 18,A02,083744,Cinel; Cameron Alexander,15,0,30,15
1657098568015,MATH 18,A03,083745,Cinel; Cameron Alexander,8,0,30,22
1657098568015,MATH 18,B01,083748,Rideout; David Porter,4,0,37,33
1657098568015,MATH 18,B02,083749,Rideout; David Porter,3,0,36,33
1657098568015,MATH 18,B03,083750,Rideout; David Porter,2,0,37,35
1657098568015,MATH 18,B04,083751,Rideout; David Porter,5,0,36,31
1657098568015,MATH 18,B05,093473,Rideout; David Porter,4,0,36,32
1657098568015,MATH 18,B06,093474,Rideout; David Porter,5,0,36,31
1657098574038,MATH 20A,A01,083754,Zheng; Zequn,12,0,40,28
1657098580063,MATH 20B,A01,083756,Briones; Jor-el Thomas Caparas,1,0,36,35
1657098580063,MATH 20B,A02,083757,Briones; Jor-el Thomas Caparas,1,0,36,35
1657098580063,MATH 20B,A03,093475,Briones; Jor-el Thomas Caparas,0,0,36,36
1657098586091,MATH 20C,A01,083760,Briones; Jor-el Thomas Caparas,1,0,35,34
1657098586091,MATH 20C,A02,083761,Briones; Jor-el Thomas Caparas,8,0,35,27
1657098586091,MATH 20C,A03,093476,Briones; Jor-el Thomas Caparas,0,1,36,36
1657098586091,MATH 20C,B01,083762,Bach; Quang Tran,0,0,30,30
1657098592116,MATH 20D,A01,083765,Tran; Brian Kha,4,0,30,26
1657098592116,MATH 20D,A02,083766,Tran; Brian Kha,5,0,30,25
1657098592116,MATH 20D,A03,083767,Tran; Brian Kha,3,0,30,27
1657098598146,MATH 20E,A01,083771,Ganguly; Soumya,6,0,32,26
1657098598146,MATH 20E,A02,083772,Ganguly; Soumya,6,0,32,26
1657098598146,MATH 20E,B01,083773,Ciotti; Benjamin,18,0,35,17
1657098598146,MATH 20E,B02,083774,Ciotti; Benjamin,17,0,35,18
1657098604181,MATH 103A,A01,083777,Greenfeld; Be'Eri,2,0,36,34
1657098604181,MATH 103A,A02,083778,Greenfeld; Be'Eri,5,0,36,31
1657098604181,MATH 103A,A03,093561,Greenfeld; Be'Eri,4,0,36,32
1657098604181,MATH 103A,B01,083779,Greenfeld; Be'Eri,6,0,36,30
1657098604181,MATH 103A,B02,083780,Greenfeld; Be'Eri,2,0,36,34
1657098604181,MATH 103A,B03,093562,Greenfeld; Be'Eri,3,0,36,33
1657098610204,MATH 105,A01,085443,Carter; Anne Toulson,14,0,35,21
1657098610204,MATH 105,A02,093477,Carter; Anne Toulson,20,0,35,15
1657098616232,MATH 109,A01,083213,Ganzberger; Geoffrey Michael,2,0,34,32
1657098616232,MATH 109,A02,083214,Ganzberger; Geoffrey Michael,3,0,34,31
1657098616232,MATH 109,A03,093478,Ganzberger; Geoffrey Michael,1,0,34,33
1657098616232,MATH 109,B01,083215,Ganzberger; Geoffrey Michael,1,0,32,31
1657098616232,MATH 109,B02,083216,Ganzberger; Geoffrey Michael,1,0,32,31
1657098616232,MATH 109,B03,093479,Ganzberger; Geoffrey Michael,6,0,32,26
1657098622272,MATH 142A,A01,083219,Chow; Bennett,6,0,32,26
1657098622272,MATH 142A,A02,083220,Chow; Bennett,10,0,32,22
1657098622272,MATH 142A,A03,093480,Chow; Bennett,7,0,32,25
1657098622272,MATH 142A,B03,093481,Chow; Bennett,8,0,32,24
1657098622272,MATH 142A,B04,093558,Chow; Bennett,11,0,32,21
1657098622272,MATH 142A,B05,093559,Chow; Bennett,6,0,32,26
1657098628297,MATH 193A,A01,083224,Rotar; Vladimir,7,0,34,27
1657098628297,MATH 193A,A02,083225,Rotar; Vladimir,5,0,34,29
1657098628297,MATH 193A,A03,083781,Rotar; Vladimir,1,0,34,33
1657098628297,MATH 193A,A04,083782,Rotar; Vladimir,6,0,34,28
1657098628297,MATH 193A,A05,093482,Rotar; Vladimir,6,0,34,28
1657098634321,MATH 197,001,091859,McAuley; Julian John,9999,0,9999,0
1657098634321,MATH 197,002,095566,Kedlaya; Kiran S.,9997,0,9999,2
1657098634321,MATH 197,003,095567,Xiao; Ming,9999,0,9999,0
1657098634321,MATH 197,004,095571,Perols; Johan Lars,9998,0,9999,1
1657098641392,COGS 9,A01,083615,Shannon; Kyle Michael,7,0,75,68
1657098647415,COGS 11,A01,083617,Boyle; Mary E. T.,21,0,48,27
1657098653442,COGS 13,A01,083071,Bastos; Amalia Pinkusfeld,9,0,71,62
1657098659471,COGS 14A,A01,092681,Semenuks; Arturs,1,1,100,99
1657098665498,COGS 14B,A01,083073,Cheng; Tzu-Han,6,0,63,57
1657098671521,COGS 17,A01,092677,Semenuks; Arturs,4,0,81,77
1657098677546,COGS 100,A01,083619,Allen; Michael Gordon,15,0,70,55
1657098683575,COGS 101A,A01,083621,Davis; Joshua Daniel,9,0,68,59
1657098689598,COGS 101B,A01,091572,Allen; Michael Gordon,8,0,65,57
1657098695621,COGS 101C,A01,083625,Delgado; Tania,17,0,35,18
1657098701645,COGS 107A,A01,083627,Boyle; Mary E. T.,13,0,60,47
1657098707675,COGS 118A,A01,083075,Gupta; Anjum,15,0,76,61
1657098713697,CSE 3,A50,083646,Miranda; Gregory Joseph,22,0,50,28
1657098719722,CSE 8A,A50,083650,Miranda; Gregory Joseph,17,1,56,39
1657098725745,CSE 11,A01,083080,Cao; Yingjun,4,15,40,36
1657098731771,CSE 12,A01,083652,Krause-Levy; Sophia Louisa,23,1,120,97
1657098737798,CSE 15L,A01,083654,Morris; Justin Loren,9,0,50,41
1657098737798,CSE 15L,A02,083655,Morris; Justin Loren,9,0,50,41
1657098743825,CSE 20,A01,083657,Tran; Khoa Dang,37,0,80,43
1657098749852,CSE 21,A01,095574,Bach; Quang Tran,21,0,48,27
1657098755879,CSE 30,A01,083084,Eldon; John,4,0,80,76
1657098755879,CSE 30,B01,095061,Bhaskar; Nishant,6,0,50,44
1657098761906,CSE 100,A01,083659,Cao; Yingjun,4,4,70,66
1657098767931,CSE 134B,A01,083661,Powell; Thomas Allan,19,0,100,81
1657098773953,CSE 140,A01,083663,Gungor; Onat,14,0,85,71
1657098779979,CSE 140L,A01,083088,Eldon; John,16,0,100,84
1657098786006,CSE 175,A01,083665,Kumar; Rakesh,3,0,25,22
1657098792030,CSE 190,A00,092507,Dubnov; Shlomo,7,0,20,13
1657098798060,ECE 45,A01,083139,Congero; Spencer William,5,0,75,70
1657098804084,ECE 65,A50,083695,Saad; Andrew S,12,0,30,18
1657098804084,ECE 65,A51,095125,Saad; Andrew S,25,0,26,1
1657098810107,ECE 109,A01,091882,Touri; Behrouz,16,0,70,54
1657098816129,ECE 180,A00,083140,Abi Samra; Nicholas Camill,1,0,30,29
1657098816129,ECE 180,B00,083141,Abi Samra; Nicholas Camill,0,0,30,30
1657098822152,MATH 10A,A01,083735,Patchell; Gregory David,1,0,30,29
1657098822152,MATH 10A,A02,083736,Patchell; Gregory David,20,0,30,10
1657098822152,MATH 10A,A03,083737,Patchell; Gregory David,16,0,30,14
1657098828177,MATH 10B,A01,083207,Lim; Seonhee,7,0,34,27
1657098828177,MATH 10B,A02,083208,Lim; Seonhee,9,0,35,26
1657098828177,MATH 10B,A03,093472,Lim; Seonhee,5,0,34,29
1657098828177,MATH 10B,B01,083739,Sinha; Shubham,9,0,30,21
1657098834209,MATH 18,A01,083743,Cinel; Cameron Alexander,6,0,30,24
1657098834209,MATH 18,A02,083744,Cinel; Cameron Alexander,15,0,30,15
1657098834209,MATH 18,A03,083745,Cinel; Cameron Alexander,8,0,30,22
1657098834209,MATH 18,B01,083748,Rideout; David Porter,4,0,37,33
1657098834209,MATH 18,B02,083749,Rideout; David Porter,3,0,36,33
1657098834209,MATH 18,B03,083750,Rideout; David Porter,2,0,37,35
1657098834209,MATH 18,B04,083751,Rideout; David Porter,5,0,36,31
1657098834209,MATH 18,B05,093473,Rideout; David Porter,4,0,36,32
1657098834209,MATH 18,B06,093474,Rideout; David Porter,5,0,36,31
1657098840232,MATH 20A,A01,083754,Zheng; Zequn,12,0,40,28
1657098846255,MATH 20B,A01,083756,Briones; Jor-el Thomas Caparas,1,0,36,35
1657098846255,MATH 20B,A02,083757,Briones; Jor-el Thomas Caparas,1,0,36,35
1657098846255,MATH 20B,A03,093475,Briones; Jor-el Thomas Caparas,0,0,36,36
1657098852278,MATH 20C,A01,083760,Briones; Jor-el Thomas Caparas,1,0,35,34
1657098852278,MATH 20C,A02,083761,Briones; Jor-el Thomas Caparas,8,0,35,27
1657098852278,MATH 20C,A03,093476,Briones; Jor-el Thomas Caparas,0,1,36,36
1657098852278,MATH 20C,B01,083762,Bach; Quang Tran,0,0,30,30
1657098858304,MATH 20D,A01,083765,Tran; Brian Kha,4,0,30,26
1657098858304,MATH 20D,A02,083766,Tran; Brian Kha,5,0,30,25
1657098858304,MATH 20D,A03,083767,Tran; Brian Kha,3,0,30,27
1657098864341,MATH 20E,A01,083771,Ganguly; Soumya,6,0,32,26
1657098864341,MATH 20E,A02,083772,Ganguly; Soumya,6,0,32,26
1657098864341,MATH 20E,B01,083773,Ciotti; Benjamin,18,0,35,17
1657098864341,MATH 20E,B02,083774,Ciotti; Benjamin,17,0,35,18
1657098870372,MATH 103A,A01,083777,Greenfeld; Be'Eri,2,0,36,34
1657098870372,MATH 103A,A02,083778,Greenfeld; Be'Eri,5,0,36,31
1657098870372,MATH 103A,A03,093561,Greenfeld; Be'Eri,4,0,36,32
1657098870372,MATH 103A,B01,083779,Greenfeld; Be'Eri,6,0,36,30
1657098870372,MATH 103A,B02,083780,Greenfeld; Be'Eri,2,0,36,34
1657098870372,MATH 103A,B03,093562,Greenfeld; Be'Eri,3,0,36,33
1657098876399,MATH 105,A01,085443,Carter; Anne Toulson,14,0,35,21
1657098876399,MATH 105,A02,093477,Carter; Anne Toulson,20,0,35,15
1657098882424,MATH 109,A01,083213,Ganzberger; Geoffrey Michael,2,0,34,32
1657098882424,MATH 109,A02,083214,Ganzberger; Geoffrey Michael,3,0,34,31
1657098882424,MATH 109,A03,093478,Ganzberger; Geoffrey Michael,1,0,34,33
1657098882424,MATH 109,B01,083215,Ganzberger; Geoffrey Michael,1,0,32,31
1657098882424,MATH 109,B02,083216,Ganzberger; Geoffrey Michael,1,0,32,31
1657098882424,MATH 109,B03,093479,Ganzberger; Geoffrey Michael,6,0,32,26
1657098888455,MATH 142A,A01,083219,Chow; Bennett,6,0,32,26
1657098888455,MATH 142A,A02,083220,Chow; Bennett,10,0,32,22
1657098888455,MATH 142A,A03,093480,Chow; Bennett,7,0,32,25
1657098888455,MATH 142A,B03,093481,Chow; Bennett,8,0,32,24
1657098888455,MATH 142A,B04,093558,Chow; Bennett,11,0,32,21
1657098888455,MATH 142A,B05,093559,Chow; Bennett,6,0,32,26
1657098894556,MATH 193A,A01,083224,Rotar; Vladimir,7,0,34,27
1657098894556,MATH 193A,A02,083225,Rotar; Vladimir,5,0,34,29
1657098894556,MATH 193A,A03,083781,Rotar; Vladimir,1,0,34,33
1657098894556,MATH 193A,A04,083782,Rotar; Vladimir,6,0,34,28
1657098894556,MATH 193A,A05,093482,Rotar; Vladimir,6,0,34,28
1657098900584,MATH 197,001,091859,McAuley; Julian John,9999,0,9999,0
1657098900584,MATH 197,002,095566,Kedlaya; Kiran S.,9997,0,9999,2
1657098900584,MATH 197,003,095567,Xiao; Ming,9999,0,9999,0
1657098900584,MATH 197,004,095571,Perols; Johan Lars,9998,0,9999,1
1657098907653,COGS 9,A01,083615,Shannon; Kyle Michael,7,0,75,68
1657098913679,COGS 11,A01,083617,Boyle; Mary E. T.,21,0,48,27
1657098919703,COGS 13,A01,083071,Bastos; Amalia Pinkusfeld,9,0,71,62
1657098925733,COGS 14A,A01,092681,Semenuks; Arturs,1,1,100,99
1657098931758,COGS 14B,A01,083073,Cheng; Tzu-Han,6,0,63,57
1657098937780,COGS 17,A01,092677,Semenuks; Arturs,4,0,81,77
1657098943803,COGS 100,A01,083619,Allen; Michael Gordon,15,0,70,55
1657098949832,COGS 101A,A01,083621,Davis; Joshua Daniel,9,0,68,59
1657098955857,COGS 101B,A01,091572,Allen; Michael Gordon,8,0,65,57
1657098961881,COGS 101C,A01,083625,Delgado; Tania,17,0,35,18
1657098967905,COGS 107A,A01,083627,Boyle; Mary E. T.,13,0,60,47
1657098973929,COGS 118A,A01,083075,Gupta; Anjum,15,0,76,61
1657098979952,CSE 3,A50,083646,Miranda; Gregory Joseph,22,0,50,28
1657098985977,CSE 8A,A50,083650,Miranda; Gregory Joseph,17,1,56,39
1657098992014,CSE 11,A01,083080,Cao; Yingjun,4,15,40,36
1657098998040,CSE 12,A01,083652,Krause-Levy; Sophia Louisa,23,1,120,97
1657099004069,CSE 15L,A01,083654,Morris; Justin Loren,9,0,50,41
1657099004069,CSE 15L,A02,083655,Morris; Justin Loren,9,0,50,41
1657099010092,CSE 20,A01,083657,Tran; Khoa Dang,37,0,80,43
1657099016114,CSE 21,A01,095574,Bach; Quang Tran,21,0,48,27
1657099022139,CSE 30,A01,083084,Eldon; John,4,0,80,76
1657099022139,CSE 30,B01,095061,Bhaskar; Nishant,6,0,50,44
1657099028166,CSE 100,A01,083659,Cao; Yingjun,4,4,70,66
1657099034193,CSE 134B,A01,083661,Powell; Thomas Allan,19,0,100,81
1657099040217,CSE 140,A01,083663,Gungor; Onat,14,0,85,71
1657099046241,CSE 140L,A01,083088,Eldon; John,16,0,100,84
1657099052268,CSE 175,A01,083665,Kumar; Rakesh,3,0,25,22
1657099058292,CSE 190,A00,092507,Dubnov; Shlomo,7,0,20,13
1657099064316,ECE 45,A01,083139,Congero; Spencer William,5,0,75,70
1657099070341,ECE 65,A50,083695,Saad; Andrew S,12,0,30,18
1657099070341,ECE 65,A51,095125,Saad; Andrew S,25,0,26,1
1657099076369,ECE 109,A01,091882,Touri; Behrouz,16,0,70,54
1657099082398,ECE 180,A00,083140,Abi Samra; Nicholas Camill,1,0,30,29
1657099082398,ECE 180,B00,083141,Abi Samra; Nicholas Camill,0,0,30,30
1657099088422,MATH 10A,A01,083735,Patchell; Gregory David,1,0,30,29
1657099088422,MATH 10A,A02,083736,Patchell; Gregory David,20,0,30,10
1657099088422,MATH 10A,A03,083737,Patchell; Gregory David,16,0,30,14
1657099094451,MATH 10B,A01,083207,Lim; Seonhee,7,0,34,27
1657099094451,MATH 10B,A02,083208,Lim; Seonhee,9,0,35,26
1657099094451,MATH 10B,A03,093472,Lim; Seonhee,5,0,34,29
1657099094451,MATH 10B,B01,083739,Sinha; Shubham,9,0,30,21
1657099100484,MATH 18,A01,083743,Cinel; Cameron Alexander,6,0,30,24
1657099100484,MATH 18,A02,083744,Cinel; Cameron Alexander,15,0,30,15
1657099100484,MATH 18,A03,083745,Cinel; Cameron Alexander,8,0,30,22
1657099100484,MATH 18,B01,083748,Rideout; David Porter,4,0,37,33
1657099100484,MATH 18,B02,083749,Rideout; David Porter,3,0,36,33
1657099100484,MATH 18,B03,083750,Rideout; David Porter,2,0,37,35
1657099100484,MATH 18,B04,083751,Rideout; David Porter,5,0,36,31
1657099100484,MATH 18,B05,093473,Rideout; David Porter,4,0,36,32
1657099100484,MATH 18,B06,093474,Rideout; David Porter,5,0,36,31
1657099106515,MATH 20A,A01,083754,Zheng; Zequn,12,0,40,28
1657099112538,MATH 20B,A01,083756,Briones; Jor-el Thomas Caparas,1,0,36,35
1657099112538,MATH 20B,A02,083757,Briones; Jor-el Thomas Caparas,1,0,36,35
1657099112538,MATH 20B,A03,093475,Briones; Jor-el Thomas Caparas,0,0,36,36
1657099118569,MATH 20C,A01,083760,Briones; Jor-el Thomas Caparas,1,0,35,34
1657099118569,MATH 20C,A02,083761,Briones; Jor-el Thomas Caparas,8,0,35,27
1657099118569,MATH 20C,A03,093476,Briones; Jor-el Thomas Caparas,0,1,36,36
1657099118569,MATH 20C,B01,083762,Bach; Quang Tran,0,0,30,30
1657099124595,MATH 20D,A01,083765,Tran; Brian Kha,4,0,30,26
1657099124595,MATH 20D,A02,083766,Tran; Brian Kha,5,0,30,25
1657099124595,MATH 20D,A03,083767,Tran; Brian Kha,3,0,30,27
1657099130619,MATH 20E,A01,083771,Ganguly; Soumya,6,0,32,26
1657099130619,MATH 20E,A02,083772,Ganguly; Soumya,6,0,32,26
1657099130619,MATH 20E,B01,083773,Ciotti; Benjamin,18,0,35,17
1657099130619,MATH 20E,B02,083774,Ciotti; Benjamin,17,0,35,18
1657099136648,MATH 103A,A01,083777,Greenfeld; Be'Eri,2,0,36,34
1657099136648,MATH 103A,A02,083778,Greenfeld; Be'Eri,5,0,36,31
1657099136648,MATH 103A,A03,093561,Greenfeld; Be'Eri,4,0,36,32
1657099136648,MATH 103A,B01,083779,Greenfeld; Be'Eri,6,0,36,30
1657099136648,MATH 103A,B02,083780,Greenfeld; Be'Eri,2,0,36,34
1657099136648,MATH 103A,B03,093562,Greenfeld; Be'Eri,3,0,36,33
1657099142671,MATH 105,A01,085443,Carter; Anne Toulson,14,0,35,21
1657099142671,MATH 105,A02,093477,Carter; Anne Toulson,20,0,35,15
1657099148699,MATH 109,A01,083213,Ganzberger; Geoffrey Michael,2,0,34,32
1657099148699,MATH 109,A02,083214,Ganzberger; Geoffrey Michael,3,0,34,31
1657099148699,MATH 109,A03,093478,Ganzberger; Geoffrey Michael,1,0,34,33
1657099148699,MATH 109,B01,083215,Ganzberger; Geoffrey Michael,1,0,32,31
1657099148699,MATH 109,B02,083216,Ganzberger; Geoffrey Michael,1,0,32,31
1657099148699,MATH 109,B03,093479,Ganzberger; Geoffrey Michael,6,0,32,26
1657099154723,MATH 142A,A01,083219,Chow; Bennett,6,0,32,26
1657099154723,MATH 142A,A02,083220,Chow; Bennett,10,0,32,22
1657099154723,MATH 142A,A03,093480,Chow; Bennett,7,0,32,25
1657099154723,MATH 142A,B03,093481,Chow; Bennett,8,0,32,24
1657099154723,MATH 142A,B04,093558,Chow; Bennett,11,0,32,21
1657099154723,MATH 142A,B05,093559,Chow; Bennett,6,0,32,26
1657099160748,MATH 193A,A01,083224,Rotar; Vladimir,7,0,34,27
1657099160748,MATH 193A,A02,083225,Rotar; Vladimir,5,0,34,29
1657099160748,MATH 193A,A03,083781,Rotar; Vladimir,1,0,34,33
1657099160748,MATH 193A,A04,083782,Rotar; Vladimir,6,0,34,28
1657099160748,MATH 193A,A05,093482,Rotar; Vladimir,6,0,34,28
1657099166776,MATH 197,001,091859,McAuley; Julian John,9999,0,9999,0
1657099166776,MATH 197,002,095566,Kedlaya; Kiran S.,9997,0,9999,2
1657099166776,MATH 197,003,095567,Xiao; Ming,9999,0,9999,0
1657099166776,MATH 197,004,095571,Perols; Johan Lars,9998,0,9999,1
1657099173836,COGS 9,A01,083615,Shannon; Kyle Michael,7,0,75,68
1657099179864,COGS 11,A01,083617,Boyle; Mary E. T.,21,0,48,27
1657099185890,COGS 13,A01,083071,Bastos; Amalia Pinkusfeld,9,0,71,62
1657099191918,COGS 14A,A01,092681,Semenuks; Arturs,1,1,100,99
1657099197945,COGS 14B,A01,083073,Cheng; Tzu-Han,6,0,63,57
1657099203968,COGS 17,A01,092677,Semenuks; Arturs,4,0,81,77
1657099209991,COGS 100,A01,083619,Allen; Michael Gordon,15,0,70,55
1657099216020,COGS 101A,A01,083621,Davis; Joshua Daniel,9,0,68,59
1657099222042,COGS 101B,A01,091572,Allen; Michael Gordon,8,0,65,57
1657099228070,COGS 101C,A01,083625,Delgado; Tania,17,0,35,18
1657099234092,COGS 107A,A01,083627,Boyle; Mary E. T.,13,0,60,47
1657099240119,COGS 118A,A01,083075,Gupta; Anjum,15,0,76,61
1657099246144,CSE 3,A50,083646,Miranda; Gregory Joseph,22,0,50,28
1657099252166,CSE 8A,A50,083650,Miranda; Gregory Joseph,17,1,56,39
1657099258203,CSE 11,A01,083080,Cao; Yingjun,4,15,40,36
1657099264226,CSE 12,A01,083652,Krause-Levy; Sophia Louisa,23,1,120,97
1657099270249,CSE 15L,A01,083654,Morris; Justin Loren,9,0,50,41
1657099270249,CSE 15L,A02,083655,Morris; Justin Loren,9,0,50,41
1657099276276,CSE 20,A01,083657,Tran; Khoa Dang,37,0,80,43
1657099282303,CSE 21,A01,095574,Bach; Quang Tran,21,0,48,27
1657099288326,CSE 30,A01,083084,Eldon; John,4,0,80,76
1657099288326,CSE 30,B01,095061,Bhaskar; Nishant,6,0,50,44
1657099294349,CSE 100,A01,083659,Cao; Yingjun,4,4,70,66
1657099300377,CSE 134B,A01,083661,Powell; Thomas Allan,19,0,100,81
1657099306402,CSE 140,A01,083663,Gungor; Onat,14,0,85,71
1657099312431,CSE 140L,A01,083088,Eldon; John,16,0,100,84
1657099318458,CSE 175,A01,083665,Kumar; Rakesh,3,0,25,22
1657099324493,CSE 190,A00,092507,Dubnov; Shlomo,7,0,20,13
1657099330521,ECE 45,A01,083139,Congero; Spencer William,5,0,75,70
1657099336546,ECE 65,A50,083695,Saad; Andrew S,12,0,30,18
1657099336546,ECE 65,A51,095125,Saad; Andrew S,25,0,26,1
1657099342576,ECE 109,A01,091882,Touri; Behrouz,16,0,70,54
1657099348600,ECE 180,A00,083140,Abi Samra; Nicholas Camill,1,0,30,29
1657099348600,ECE 180,B00,083141,Abi Samra; Nicholas Camill,0,0,30,30
1657099354628,MATH 10A,A01,083735,Patchell; Gregory David,1,0,30,29
1657099354628,MATH 10A,A02,083736,Patchell; Gregory David,20,0,30,10
1657099354628,MATH 10A,A03,083737,Patchell; Gregory David,16,0,30,14
1657099360664,MATH 10B,A01,083207,Lim; Seonhee,7,0,34,27
1657099360664,MATH 10B,A02,083208,Lim; Seonhee,9,0,35,26
1657099360664,MATH 10B,A03,093472,Lim; Seonhee,5,0,34,29
1657099360664,MATH 10B,B01,083739,Sinha; Shubham,9,0,30,21
1657099366688,MATH 18,A01,083743,Cinel; Cameron Alexander,6,0,30,24
1657099366688,MATH 18,A02,083744,Cinel; Cameron Alexander,15,0,30,15
1657099366688,MATH 18,A03,083745,Cinel; Cameron Alexander,8,0,30,22
1657099366688,MATH 18,B01,083748,Rideout; David Porter,4,0,37,33
1657099366688,MATH 18,B02,083749,Rideout; David Porter,3,0,36,33
1657099366688,MATH 18,B03,083750,Rideout; David Porter,2,0,37,35
1657099366688,MATH 18,B04,083751,Rideout; David Porter,5,0,36,31
1657099366688,MATH 18,B05,093473,Rideout; David Porter,4,0,36,32
1657099366688,MATH 18,B06,093474,Rideout; David Porter,5,0,36,31
1657099372712,MATH 20A,A01,083754,Zheng; Zequn,12,0,40,28
1657099378735,MATH 20B,A01,083756,Briones; Jor-el Thomas Caparas,1,0,36,35
1657099378735,MATH 20B,A02,083757,Briones; Jor-el Thomas Caparas,1,0,36,35
1657099378735,MATH 20B,A03,093475,Briones; Jor-el Thomas Caparas,0,0,36,36
1657099384761,MATH 20C,A01,083760,Briones; Jor-el Thomas Caparas,1,0,35,34
1657099384761,MATH 20C,A02,083761,Briones; Jor-el Thomas Caparas,8,0,35,27
1657099384761,MATH 20C,A03,093476,Briones; Jor-el Thomas Caparas,0,1,36,36
1657099384761,MATH 20C,B01,083762,Bach; Quang Tran,0,0,30,30
1657099390786,MATH 20D,A01,083765,Tran; Brian Kha,4,0,30,26
1657099390786,MATH 20D,A02,083766,Tran; Brian Kha,5,0,30,25
1657099390786,MATH 20D,A03,083767,Tran; Brian Kha,3,0,30,27
1657099396816,MATH 20E,A01,083771,Ganguly; Soumya,6,0,32,26
1657099396816,MATH 20E,A02,083772,Ganguly; Soumya,6,0,32,26
1657099396816,MATH 20E,B01,083773,Ciotti; Benjamin,18,0,35,17
1657099396816,MATH 20E,B02,083774,Ciotti; Benjamin,17,0,35,18
1657099402857,MATH 103A,A01,083777,Greenfeld; Be'Eri,2,0,36,34
1657099402857,MATH 103A,A02,083778,Greenfeld; Be'Eri,5,0,36,31
1657099402857,MATH 103A,A03,093561,Greenfeld; Be'Eri,4,0,36,32
1657099402857,MATH 103A,B01,083779,Greenfeld; Be'Eri,6,0,36,30
1657099402857,MATH 103A,B02,083780,Greenfeld; Be'Eri,2,0,36,34
1657099402857,MATH 103A,B03,093562,Greenfeld; Be'Eri,3,0,36,33
1657099408886,MATH 105,A01,085443,Carter; Anne Toulson,14,0,35,21
1657099408886,MATH 105,A02,093477,Carter; Anne Toulson,20,0,35,15
1657099414914,MATH 109,A01,083213,Ganzberger; Geoffrey Michael,2,0,34,32
1657099414914,MATH 109,A02,083214,Ganzberger; Geoffrey Michael,3,0,34,31
1657099414914,MATH 109,A03,093478,Ganzberger; Geoffrey Michael,1,0,34,33
1657099414914,MATH 109,B01,083215,Ganzberger; Geoffrey Michael,1,0,32,31
1657099414914,MATH 109,B02,083216,Ganzberger; Geoffrey Michael,1,0,32,31
1657099414914,MATH 109,B03,093479,Ganzberger; Geoffrey Michael,6,0,32,26
1657099420944,MATH 142A,A01,083219,Chow; Bennett,6,0,32,26
1657099420944,MATH 142A,A02,083220,Chow; Bennett,10,0,32,22
1657099420944,MATH 142A,A03,093480,Chow; Bennett,7,0,32,25
1657099420944,MATH 142A,B03,093481,Chow; Bennett,8,0,32,24
1657099420944,MATH 142A,B04,093558,Chow; Bennett,11,0,32,21
1657099420944,MATH 142A,B05,093559,Chow; Bennett,6,0,32,26
1657099426972,MATH 193A,A01,083224,Rotar; Vladimir,7,0,34,27
1657099426972,MATH 193A,A02,083225,Rotar; Vladimir,5,0,34,29
1657099426972,MATH 193A,A03,083781,Rotar; Vladimir,1,0,34,33
1657099426972,MATH 193A,A04,083782,Rotar; Vladimir,6,0,34,28
1657099426972,MATH 193A,A05,093482,Rotar; Vladimir,6,0,34,28
1657099432997,MATH 197,001,091859,McAuley; Julian John,9999,0,9999,0
1657099432997,MATH 197,002,095566,Kedlaya; Kiran S.,9997,0,9999,2
1657099432997,MATH 197,003,095567,Xiao; Ming,9999,0,9999,0
1657099432997,MATH 197,004,095571,Perols; Johan Lars,9998,0,9999,1
1657099440065,COGS 9,A01,083615,Shannon; Kyle Michael,7,0,75,68
1657099446092,COGS 11,A01,083617,Boyle; Mary E. T.,21,0,48,27
1657099452114,COGS 13,A01,083071,Bastos; Amalia Pinkusfeld,9,0,71,62
1657099458142,COGS 14A,A01,092681,Semenuks; Arturs,1,1,100,99
1657099464165,COGS 14B,A01,083073,Cheng; Tzu-Han,6,0,63,57
1657099470188,COGS 17,A01,092677,Semenuks; Arturs,4,0,81,77
1657099476212,COGS 100,A01,083619,Allen; Michael Gordon,15,0,70,55
1657099482239,COGS 101A,A01,083621,Davis; Joshua Daniel,9,0,68,59
1657099488337,COGS 101B,A01,091572,Allen; Michael Gordon,8,0,65,57
1657099494361,COGS 101C,A01,083625,Delgado; Tania,17,0,35,18
1657099500386,COGS 107A,A01,083627,Boyle; Mary E. T.,13,0,60,47
1657099506409,COGS 118A,A01,083075,Gupta; Anjum,15,0,76,61
1657099512439,CSE 3,A50,083646,Miranda; Gregory Joseph,22,0,50,28
1657099518464,CSE 8A,A50,083650,Miranda; Gregory Joseph,17,1,56,39
1657099524492,CSE 11,A01,083080,Cao; Yingjun,4,15,40,36
1657099530516,CSE 12,A01,083652,Krause-Levy; Sophia Louisa,23,1,120,97
1657099536539,CSE 15L,A01,083654,Morris; Justin Loren,9,0,50,41
1657099536539,CSE 15L,A02,083655,Morris; Justin Loren,9,0,50,41
1657099542562,CSE 20,A01,083657,Tran; Khoa Dang,37,0,80,43
1657099548587,CSE 21,A01,095574,Bach; Quang Tran,21,0,48,27
1657099554611,CSE 30,A01,083084,Eldon; John,4,0,80,76
1657099554611,CSE 30,B01,095061,Bhaskar; Nishant,6,0,50,44
1657099560634,CSE 100,A01,083659,Cao; Yingjun,4,4,70,66
1657099566660,CSE 134B,A01,083661,Powell; Thomas Allan,19,0,100,81
1657099572683,CSE 140,A01,083663,Gungor; Onat,14,0,85,71
1657099578709,CSE 140L,A01,083088,Eldon; John,16,0,100,84
1657099584734,CSE 175,A01,083665,Kumar; Rakesh,3,0,25,22
1657099590758,CSE 190,A00,092507,Dubnov; Shlomo,7,0,20,13
1657099596783,ECE 45,A01,083139,Congero; Spencer William,5,0,75,70
1657099602812,ECE 65,A50,083695,Saad; Andrew S,12,0,30,18
1657099602812,ECE 65,A51,095125,Saad; Andrew S,25,0,26,1
1657099608836,ECE 109,A01,091882,Touri; Behrouz,16,0,70,54
1657099614860,ECE 180,A00,083140,Abi Samra; Nicholas Camill,1,0,30,29
1657099614860,ECE 180,B00,083141,Abi Samra; Nicholas Camill,0,0,30,30
1657099620889,MATH 10A,A01,083735,Patchell; Gregory David,1,0,30,29
1657099620889,MATH 10A,A02,083736,Patchell; Gregory David,20,0,30,10
1657099620889,MATH 10A,A03,083737,Patchell; Gregory David,16,0,30,14
1657099626917,MATH 10B,A01,083207,Lim; Seonhee,7,0,34,27
1657099626917,MATH 10B,A02,083208,Lim; Seonhee,9,0,35,26
1657099626917,MATH 10B,A03,093472,Lim; Seonhee,5,0,34,29
1657099626917,MATH 10B,B01,083739,Sinha; Shubham,9,0,30,21
1657099632946,MATH 18,A01,083743,Cinel; Cameron Alexander,6,0,30,24
1657099632946,MATH 18,A02,083744,Cinel; Cameron Alexander,15,0,30,15
1657099632946,MATH 18,A03,083745,Cinel; Cameron Alexander,8,0,30,22
1657099632946,MATH 18,B01,083748,Rideout; David Porter,4,0,37,33
1657099632946,MATH 18,B02,083749,Rideout; David Porter,3,0,36,33
1657099632946,MATH 18,B03,083750,Rideout; David Porter,2,0,37,35
1657099632946,MATH 18,B04,083751,Rideout; David Porter,5,0,36,31
1657099632946,MATH 18,B05,093473,Rideout; David Porter,4,0,36,32
1657099632946,MATH 18,B06,093474,Rideout; David Porter,5,0,36,31
1657099638970,MATH 20A,A01,083754,Zheng; Zequn,12,0,40,28
1657099644994,MATH 20B,A01,083756,Briones; Jor-el Thomas Caparas,1,0,36,35
1657099644994,MATH 20B,A02,083757,Briones; Jor-el Thomas Caparas,1,0,36,35
1657099644994,MATH 20B,A03,093475,Briones; Jor-el Thomas Caparas,0,0,36,36
1657099651018,MATH 20C,A01,083760,Briones; Jor-el Thomas Caparas,1,0,35,34
1657099651018,MATH 20C,A02,083761,Briones; Jor-el Thomas Caparas,8,0,35,27
1657099651018,MATH 20C,A03,093476,Briones; Jor-el Thomas Caparas,0,1,36,36
1657099651018,MATH 20C,B01,083762,Bach; Quang Tran,0,0,30,30
1657099657044,MATH 20D,A01,083765,Tran; Brian Kha,4,0,30,26
1657099657044,MATH 20D,A02,083766,Tran; Brian Kha,5,0,30,25
1657099657044,MATH 20D,A03,083767,Tran; Brian Kha,3,0,30,27
1657099663068,MATH 20E,A01,083771,Ganguly; Soumya,6,0,32,26
1657099663068,MATH 20E,A02,083772,Ganguly; Soumya,6,0,32,26
1657099663068,MATH 20E,B01,083773,Ciotti; Benjamin,18,0,35,17
1657099663068,MATH 20E,B02,083774,Ciotti; Benjamin,17,0,35,18
1657099669092,MATH 103A,A01,083777,Greenfeld; Be'Eri,2,0,36,34
1657099669092,MATH 103A,A02,083778,Greenfeld; Be'Eri,5,0,36,31
1657099669092,MATH 103A,A03,093561,Greenfeld; Be'Eri,4,0,36,32
1657099669092,MATH 103A,B01,083779,Greenfeld; Be'Eri,6,0,36,30
1657099669092,MATH 103A,B02,083780,Greenfeld; Be'Eri,2,0,36,34
1657099669092,MATH 103A,B03,093562,Greenfeld; Be'Eri,3,0,36,33
1657099675115,MATH 105,A01,085443,Carter; Anne Toulson,14,0,35,21
1657099675115,MATH 105,A02,093477,Carter; Anne Toulson,20,0,35,15
1657099681144,MATH 109,A01,083213,Ganzberger; Geoffrey Michael,2,0,34,32
1657099681144,MATH 109,A02,083214,Ganzberger; Geoffrey Michael,3,0,34,31
1657099681144,MATH 109,A03,093478,Ganzberger; Geoffrey Michael,1,0,34,33
1657099681144,MATH 109,B01,083215,Ganzberger; Geoffrey Michael,1,0,32,31
1657099681144,MATH 109,B02,083216,Ganzberger; Geoffrey Michael,1,0,32,31
1657099681144,MATH 109,B03,093479,Ganzberger; Geoffrey Michael,6,0,32,26
1657099687174,MATH 142A,A01,083219,Chow; Bennett,6,0,32,26
1657099687174,MATH 142A,A02,083220,Chow; Bennett,10,0,32,22
1657099687174,MATH 142A,A03,093480,Chow; Bennett,7,0,32,25
1657099687174,MATH 142A,B03,093481,Chow; Bennett,8,0,32,24
1657099687174,MATH 142A,B04,093558,Chow; Bennett,11,0,32,21
1657099687174,MATH 142A,B05,093559,Chow; Bennett,6,0,32,26
1657099693201,MATH 193A,A01,083224,Rotar; Vladimir,7,0,34,27
1657099693201,MATH 193A,A02,083225,Rotar; Vladimir,5,0,34,29
1657099693201,MATH 193A,A03,083781,Rotar; Vladimir,1,0,34,33
1657099693201,MATH 193A,A04,083782,Rotar; Vladimir,6,0,34,28
1657099693201,MATH 193A,A05,093482,Rotar; Vladimir,6,0,34,28
1657099699227,MATH 197,001,091859,McAuley; Julian John,9999,0,9999,0
1657099699227,MATH 197,002,095566,Kedlaya; Kiran S.,9997,0,9999,2
1657099699227,MATH 197,003,095567,Xiao; Ming,9999,0,9999,0
1657099699227,MATH 197,004,095571,Perols; Johan Lars,9998,0,9999,1
1657099706282,COGS 9,A01,083615,Shannon; Kyle Michael,7,0,75,68
1657099712306,COGS 11,A01,083617,Boyle; Mary E. T.,21,0,48,27
1657099718331,COGS 13,A01,083071,Bastos; Amalia Pinkusfeld,9,0,71,62
1657099724356,COGS 14A,A01,092681,Semenuks; Arturs,1,1,100,99
1657099730380,COGS 14B,A01,083073,Cheng; Tzu-Han,6,0,63,57
1657099736407,COGS 17,A01,092677,Semenuks; Arturs,4,0,81,77
1657099742431,COGS 100,A01,083619,Allen; Michael Gordon,15,0,70,55
1657099748455,COGS 101A,A01,083621,Davis; Joshua Daniel,9,0,68,59
1657099754482,COGS 101B,A01,091572,Allen; Michael Gordon,8,0,65,57
1657099760509,COGS 101C,A01,083625,Delgado; Tania,17,0,35,18
1657099766532,COGS 107A,A01,083627,Boyle; Mary E. T.,13,0,60,47
1657099772559,COGS 118A,A01,083075,Gupta; Anjum,15,0,76,61
1657099778588,CSE 3,A50,083646,Miranda; Gregory Joseph,22,0,50,28
1657099784612,CSE 8A,A50,083650,Miranda; Gregory Joseph,17,1,56,39
1657099790636,CSE 11,A01,083080,Cao; Yingjun,4,15,40,36
1657099796662,CSE 12,A01,083652,Krause-Levy; Sophia Louisa,23,1,120,97
1657099802685,CSE 15L,A01,083654,Morris; Justin Loren,9,0,50,41
1657099802685,CSE 15L,A02,083655,Morris; Justin Loren,9,0,50,41
1657099808714,CSE 20,A01,083657,Tran; Khoa Dang,37,0,80,43
1657099814743,CSE 21,A01,095574,Bach; Quang Tran,21,0,48,27
1657099820773,CSE 30,A01,083084,Eldon; John,4,0,80,76
1657099820773,CSE 30,B01,095061,Bhaskar; Nishant,6,0,50,44
1657099826801,CSE 100,A01,083659,Cao; Yingjun,4,4,70,66
1657099832831,CSE 134B,A01,083661,Powell; Thomas Allan,19,0,100,81
1657099838857,CSE 140,A01,083663,Gungor; Onat,14,0,85,71
1657099845081,CSE 140L,A01,083088,Eldon; John,16,0,100,84
1657099851108,CSE 175,A01,083665,Kumar; Rakesh,3,0,25,22
1657099857134,CSE 190,A00,092507,Dubnov; Shlomo,7,0,20,13
1657099863164,ECE 45,A01,083139,Congero; Spencer William,5,0,75,70
1657099869196,ECE 65,A50,083695,Saad; Andrew S,12,0,30,18
1657099869196,ECE 65,A51,095125,Saad; Andrew S,25,0,26,1
1657099875222,ECE 109,A01,091882,Touri; Behrouz,16,0,70,54
1657099881248,ECE 180,A00,083140,Abi Samra; Nicholas Camill,1,0,30,29
1657099881248,ECE 180,B00,083141,Abi Samra; Nicholas Camill,0,0,30,30
1657099887286,MATH 10A,A01,083735,Patchell; Gregory David,1,0,30,29
1657099887286,MATH 10A,A02,083736,Patchell; Gregory David,20,0,30,10
1657099887286,MATH 10A,A03,083737,Patchell; Gregory David,16,0,30,14
1657099893313,MATH 10B,A01,083207,Lim; Seonhee,7,0,34,27
1657099893313,MATH 10B,A02,083208,Lim; Seonhee,9,0,35,26
1657099893313,MATH 10B,A03,093472,Lim; Seonhee,5,0,34,29
1657099893313,MATH 10B,B01,083739,Sinha; Shubham,9,0,30,21
1657099899349,MATH 18,A01,083743,Cinel; Cameron Alexander,6,0,30,24
1657099899349,MATH 18,A02,083744,Cinel; Cameron Alexander,15,0,30,15
1657099899349,MATH 18,A03,083745,Cinel; Cameron Alexander,8,0,30,22
1657099899349,MATH 18,B01,083748,Rideout; David Porter,4,0,37,33
1657099899349,MATH 18,B02,083749,Rideout; David Porter,3,0,36,33
1657099899349,MATH 18,B03,083750,Rideout; David Porter,2,0,37,35
1657099899349,MATH 18,B04,083751,Rideout; David Porter,5,0,36,31
1657099899349,MATH 18,B05,093473,Rideout; David Porter,4,0,36,32
1657099899349,MATH 18,B06,093474,Rideout; David Porter,5,0,36,31
1657099905374,MATH 20A,A01,083754,Zheng; Zequn,12,0,40,28
1657099911398,MATH 20B,A01,083756,Briones; Jor-el Thomas Caparas,1,0,36,35
1657099911398,MATH 20B,A02,083757,Briones; Jor-el Thomas Caparas,1,0,36,35
1657099911398,MATH 20B,A03,093475,Briones; Jor-el Thomas Caparas,0,0,36,36
1657099917429,MATH 20C,A01,083760,Briones; Jor-el Thomas Caparas,1,0,35,34
1657099917429,MATH 20C,A02,083761,Briones; Jor-el Thomas Caparas,8,0,35,27
1657099917429,MATH 20C,A03,093476,Briones; Jor-el Thomas Caparas,0,1,36,36
1657099917429,MATH 20C,B01,083762,Bach; Quang Tran,0,0,30,30
1657099923462,MATH 20D,A01,083765,Tran; Brian Kha,4,0,30,26
1657099923462,MATH 20D,A02,083766,Tran; Brian Kha,5,0,30,25
1657099923462,MATH 20D,A03,083767,Tran; Brian Kha,3,0,30,27
1657099929487,MATH 20E,A01,083771,Ganguly; Soumya,6,0,32,26
1657099929487,MATH 20E,A02,083772,Ganguly; Soumya,6,0,32,26
1657099929487,MATH 20E,B01,083773,Ciotti; Benjamin,18,0,35,17
1657099929487,MATH 20E,B02,083774,Ciotti; Benjamin,17,0,35,18
1657099935523,MATH 103A,A01,083777,Greenfeld; Be'Eri,2,0,36,34
1657099935523,MATH 103A,A02,083778,Greenfeld; Be'Eri,5,0,36,31
1657099935523,MATH 103A,A03,093561,Greenfeld; Be'Eri,4,0,36,32
1657099935523,MATH 103A,B01,083779,Greenfeld; Be'Eri,6,0,36,30
1657099935523,MATH 103A,B02,083780,Greenfeld; Be'Eri,2,0,36,34
1657099935523,MATH 103A,B03,093562,Greenfeld; Be'Eri,3,0,36,33
1657099941553,MATH 105,A01,085443,Carter; Anne Toulson,14,0,35,21
1657099941553,MATH 105,A02,093477,Carter; Anne Toulson,20,0,35,15
1657099947577,MATH 109,A01,083213,Ganzberger; Geoffrey Michael,2,0,34,32
1657099947577,MATH 109,A02,083214,Ganzberger; Geoffrey Michael,3,0,34,31
1657099947577,MATH 109,A03,093478,Ganzberger; Geoffrey Michael,1,0,34,33
1657099947577,MATH 109,B01,083215,Ganzberger; Geoffrey Michael,1,0,32,31
1657099947577,MATH 109,B02,083216,Ganzberger; Geoffrey Michael,1,0,32,31
1657099947577,MATH 109,B03,093479,Ganzberger; Geoffrey Michael,6,0,32,26
1657099953603,MATH 142A,A01,083219,Chow; Bennett,6,0,32,26
1657099953603,MATH 142A,A02,083220,Chow; Bennett,10,0,32,22
1657099953603,MATH 142A,A03,093480,Chow; Bennett,7,0,32,25
1657099953603,MATH 142A,B03,093481,Chow; Bennett,8,0,32,24
1657099953603,MATH 142A,B04,093558,Chow; Bennett,11,0,32,21
1657099953603,MATH 142A,B05,093559,Chow; Bennett,6,0,32,26
1657099959628,MATH 193A,A01,083224,Rotar; Vladimir,7,0,34,27
1657099959628,MATH 193A,A02,083225,Rotar; Vladimir,5,0,34,29
1657099959628,MATH 193A,A03,083781,Rotar; Vladimir,1,0,34,33
1657099959628,MATH 193A,A04,083782,Rotar; Vladimir,6,0,34,28
1657099959628,MATH 193A,A05,093482,Rotar; Vladimir,6,0,34,28
1657099965652,MATH 197,001,091859,McAuley; Julian John,9999,0,9999,0
1657099965652,MATH 197,002,095566,Kedlaya; Kiran S.,9997,0,9999,2
1657099965652,MATH 197,003,095567,Xiao; Ming,9999,0,9999,0
1657099965652,MATH 197,004,095571,Perols; Johan Lars,9998,0,9999,1
1657099972712,COGS 9,A01,083615,Shannon; Kyle Michael,7,0,75,68
1657099978743,COGS 11,A01,083617,Boyle; Mary E. T.,21,0,48,27
1657099984770,COGS 13,A01,083071,Bastos; Amalia Pinkusfeld,9,0,71,62
1657099990806,COGS 14A,A01,092681,Semenuks; Arturs,1,1,100,99
1657099996830,COGS 14B,A01,083073,Cheng; Tzu-Han,6,0,63,57
1657100002859,COGS 17,A01,092677,Semenuks; Arturs,4,0,81,77
1657100008889,COGS 100,A01,083619,Allen; Michael Gordon,15,0,70,55
1657100014919,COGS 101A,A01,083621,Davis; Joshua Daniel,9,0,68,59
1657100020942,COGS 101B,A01,091572,Allen; Michael Gordon,8,0,65,57
1657100026967,COGS 101C,A01,083625,Delgado; Tania,17,0,35,18
1657100032996,COGS 107A,A01,083627,Boyle; Mary E. T.,13,0,60,47
1657100039019,COGS 118A,A01,083075,Gupta; Anjum,15,0,76,61
1657100045046,CSE 3,A50,083646,Miranda; Gregory Joseph,22,0,50,28
1657100051076,CSE 8A,A50,083650,Miranda; Gregory Joseph,17,1,56,39
1657100057109,CSE 11,A01,083080,Cao; Yingjun,4,15,40,36
1657100063141,CSE 12,A01,083652,Krause-Levy; Sophia Louisa,23,1,120,97
1657100069164,CSE 15L,A01,083654,Morris; Justin Loren,9,0,50,41
1657100069164,CSE 15L,A02,083655,Morris; Justin Loren,9,0,50,41
1657100075188,CSE 20,A01,083657,Tran; Khoa Dang,37,0,80,43
1657100081219,CSE 21,A01,095574,Bach; Quang Tran,21,0,48,27
1657100087342,CSE 30,A01,083084,Eldon; John,4,0,80,76
1657100087342,CSE 30,B01,095061,Bhaskar; Nishant,6,0,50,44
1657100093368,CSE 100,A01,083659,Cao; Yingjun,4,4,70,66
1657100099393,CSE 134B,A01,083661,Powell; Thomas Allan,19,0,100,81
1657100105444,CSE 140,A01,083663,Gungor; Onat,14,0,85,71
1657100111472,CSE 140L,A01,083088,Eldon; John,16,0,100,84
1657100117498,CSE 175,A01,083665,Kumar; Rakesh,3,0,25,22
1657100123531,CSE 190,A00,092507,Dubnov; Shlomo,7,0,20,13
1657100129559,ECE 45,A01,083139,Congero; Spencer William,5,0,75,70
1657100135587,ECE 65,A50,083695,Saad; Andrew S,12,0,30,18
1657100135587,ECE 65,A51,095125,Saad; Andrew S,25,0,26,1
1657100141611,ECE 109,A01,091882,Touri; Behrouz,16,0,70,54
1657100147641,ECE 180,A00,083140,Abi Samra; Nicholas Camill,1,0,30,29
1657100147641,ECE 180,B00,083141,Abi Samra; Nicholas Camill,0,0,30,30
1657100153675,MATH 10A,A01,083735,Patchell; Gregory David,1,0,30,29
1657100153675,MATH 10A,A02,083736,Patchell; Gregory David,20,0,30,10
1657100153675,MATH 10A,A03,083737,Patchell; Gregory David,16,0,30,14
1657100159704,MATH 10B,A01,083207,Lim; Seonhee,7,0,34,27
1657100159704,MATH 10B,A02,083208,Lim; Seonhee,9,0,35,26
1657100159704,MATH 10B,A03,093472,Lim; Seonhee,5,0,34,29
1657100159704,MATH 10B,B01,083739,Sinha; Shubham,9,0,30,21
1657100165735,MATH 18,A01,083743,Cinel; Cameron Alexander,6,0,30,24
1657100165735,MATH 18,A02,083744,Cinel; Cameron Alexander,15,0,30,15
1657100165735,MATH 18,A03,083745,Cinel; Cameron Alexander,8,0,30,22
1657100165735,MATH 18,B01,083748,Rideout; David Porter,4,0,37,33
1657100165735,MATH 18,B02,083749,Rideout; David Porter,3,0,36,33
1657100165735,MATH 18,B03,083750,Rideout; David Porter,2,0,37,35
1657100165735,MATH 18,B04,083751,Rideout; David Porter,5,0,36,31
1657100165735,MATH 18,B05,093473,Rideout; David Porter,4,0,36,32
1657100165735,MATH 18,B06,093474,Rideout; David Porter,5,0,36,31
1657100171767,MATH 20A,A01,083754,Zheng; Zequn,12,0,40,28
1657100177801,MATH 20B,A01,083756,Briones; Jor-el Thomas Caparas,1,0,36,35
1657100177801,MATH 20B,A02,083757,Briones; Jor-el Thomas Caparas,1,0,36,35
1657100177801,MATH 20B,A03,093475,Briones; Jor-el Thomas Caparas,0,0,36,36
1657100183837,MATH 20C,A01,083760,Briones; Jor-el Thomas Caparas,1,0,35,34
1657100183837,MATH 20C,A02,083761,Briones; Jor-el Thomas Caparas,8,0,35,27
1657100183837,MATH 20C,A03,093476,Briones; Jor-el Thomas Caparas,0,1,36,36
1657100183837,MATH 20C,B01,083762,Bach; Quang Tran,0,0,30,30
1657100189867,MATH 20D,A01,083765,Tran; Brian Kha,4,0,30,26
1657100189867,MATH 20D,A02,083766,Tran; Brian Kha,5,0,30,25
1657100189867,MATH 20D,A03,083767,Tran; Brian Kha,3,0,30,27
1657100195904,MATH 20E,A01,083771,Ganguly; Soumya,6,0,32,26
1657100195904,MATH 20E,A02,083772,Ganguly; Soumya,6,0,32,26
1657100195904,MATH 20E,B01,083773,Ciotti; Benjamin,18,0,35,17
1657100195904,MATH 20E,B02,083774,Ciotti; Benjamin,17,0,35,18
1657100201940,MATH 103A,A01,083777,Greenfeld; Be'Eri,2,0,36,34
1657100201940,MATH 103A,A02,083778,Greenfeld; Be'Eri,5,0,36,31
1657100201940,MATH 103A,A03,093561,Greenfeld; Be'Eri,4,0,36,32
1657100201940,MATH 103A,B01,083779,Greenfeld; Be'Eri,6,0,36,30
1657100201940,MATH 103A,B02,083780,Greenfeld; Be'Eri,2,0,36,34
1657100201940,MATH 103A,B03,093562,Greenfeld; Be'Eri,3,0,36,33
1657100207965,MATH 105,A01,085443,Carter; Anne Toulson,14,0,35,21
1657100207965,MATH 105,A02,093477,Carter; Anne Toulson,20,0,35,15
1657100213999,MATH 109,A01,083213,Ganzberger; Geoffrey Michael,2,0,34,32
1657100213999,MATH 109,A02,083214,Ganzberger; Geoffrey Michael,3,0,34,31
1657100213999,MATH 109,A03,093478,Ganzberger; Geoffrey Michael,1,0,34,33
1657100213999,MATH 109,B01,083215,Ganzberger; Geoffrey Michael,1,0,32,31
1657100213999,MATH 109,B02,083216,Ganzberger; Geoffrey Michael,1,0,32,31
1657100213999,MATH 109,B03,093479,Ganzberger; Geoffrey Michael,6,0,32,26
1657100220028,MATH 142A,A01,083219,Chow; Bennett,6,0,32,26
1657100220028,MATH 142A,A02,083220,Chow; Bennett,10,0,32,22
1657100220028,MATH 142A,A03,093480,Chow; Bennett,7,0,32,25
1657100220028,MATH 142A,B03,093481,Chow; Bennett,8,0,32,24
1657100220028,MATH 142A,B04,093558,Chow; Bennett,11,0,32,21
1657100220028,MATH 142A,B05,093559,Chow; Bennett,6,0,32,26
1657100226053,MATH 193A,A01,083224,Rotar; Vladimir,7,0,34,27
1657100226053,MATH 193A,A02,083225,Rotar; Vladimir,5,0,34,29
1657100226053,MATH 193A,A03,083781,Rotar; Vladimir,1,0,34,33
1657100226053,MATH 193A,A04,083782,Rotar; Vladimir,6,0,34,28
1657100226053,MATH 193A,A05,093482,Rotar; Vladimir,6,0,34,28
1657100232080,MATH 197,001,091859,McAuley; Julian John,9999,0,9999,0
1657100232080,MATH 197,002,095566,Kedlaya; Kiran S.,9997,0,9999,2
1657100232080,MATH 197,003,095567,Xiao; Ming,9999,0,9999,0
1657100232080,MATH 197,004,095571,Perols; Johan Lars,9998,0,9999,1
1657100239189,COGS 9,A01,083615,Shannon; Kyle Michael,7,0,75,68
1657100245232,COGS 11,A01,083617,Boyle; Mary E. T.,21,0,48,27
1657100251263,COGS 13,A01,083071,Bastos; Amalia Pinkusfeld,9,0,71,62
1657100257290,COGS 14A,A01,092681,Semenuks; Arturs,1,1,100,99
1657100263320,COGS 14B,A01,083073,Cheng; Tzu-Han,6,0,63,57
1657100269343,COGS 17,A01,092677,Semenuks; Arturs,4,0,81,77
1657100275374,COGS 100,A01,083619,Allen; Michael Gordon,15,0,70,55
1657100281400,COGS 101A,A01,083621,Davis; Joshua Daniel,9,0,68,59
1657100287429,COGS 101B,A01,091572,Allen; Michael Gordon,8,0,65,57
1657100293459,COGS 101C,A01,083625,Delgado; Tania,17,0,35,18
1657100299486,COGS 107A,A01,083627,Boyle; Mary E. T.,13,0,60,47
1657100305517,COGS 118A,A01,083075,Gupta; Anjum,15,0,76,61
1657100311543,CSE 3,A50,083646,Miranda; Gregory Joseph,22,0,50,28
1657100317567,CSE 8A,A50,083650,Miranda; Gregory Joseph,17,1,56,39
1657100323591,CSE 11,A01,083080,Cao; Yingjun,4,15,40,36
1657100329617,CSE 12,A01,083652,Krause-Levy; Sophia Louisa,23,1,120,97
1657100335647,CSE 15L,A01,083654,Morris; Justin Loren,9,0,50,41
1657100335647,CSE 15L,A02,083655,Morris; Justin Loren,9,0,50,41
1657100341670,CSE 20,A01,083657,Tran; Khoa Dang,37,0,80,43
1657100347709,CSE 21,A01,095574,Bach; Quang Tran,21,0,48,27
1657100353744,CSE 30,A01,083084,Eldon; John,4,0,80,76
1657100353744,CSE 30,B01,095061,Bhaskar; Nishant,6,0,50,44
1657100359767,CSE 100,A01,083659,Cao; Yingjun,4,4,70,66
1657100365790,CSE 134B,A01,083661,Powell; Thomas Allan,19,0,100,81
1657100371818,CSE 140,A01,083663,Gungor; Onat,14,0,85,71
1657100377847,CSE 140L,A01,083088,Eldon; John,16,0,100,84
1657100383872,CSE 175,A01,083665,Kumar; Rakesh,3,0,25,22
1657100389901,CSE 190,A00,092507,Dubnov; Shlomo,7,0,20,13
1657100395927,ECE 45,A01,083139,Congero; Spencer William,5,0,75,70
1657100401959,ECE 65,A50,083695,Saad; Andrew S,12,0,30,18
1657100401959,ECE 65,A51,095125,Saad; Andrew S,25,0,26,1
1657100407984,ECE 109,A01,091882,Touri; Behrouz,16,0,70,54
1657100414009,ECE 180,A00,083140,Abi Samra; Nicholas Camill,1,0,30,29
1657100414009,ECE 180,B00,083141,Abi Samra; Nicholas Camill,0,0,30,30
1657100420036,MATH 10A,A01,083735,Patchell; Gregory David,1,0,30,29
1657100420036,MATH 10A,A02,083736,Patchell; Gregory David,20,0,30,10
1657100420036,MATH 10A,A03,083737,Patchell; Gregory David,16,0,30,14
1657100426066,MATH 10B,A01,083207,Lim; Seonhee,7,0,34,27
1657100426066,MATH 10B,A02,083208,Lim; Seonhee,9,0,35,26
1657100426066,MATH 10B,A03,093472,Lim; Seonhee,5,0,34,29
1657100426066,MATH 10B,B01,083739,Sinha; Shubham,9,0,30,21
1657100432093,MATH 18,A01,083743,Cinel; Cameron Alexander,6,0,30,24
1657100432093,MATH 18,A02,083744,Cinel; Cameron Alexander,15,0,30,15
1657100432093,MATH 18,A03,083745,Cinel; Cameron Alexander,8,0,30,22
1657100432093,MATH 18,B01,083748,Rideout; David Porter,4,0,37,33
1657100432093,MATH 18,B02,083749,Rideout; David Porter,3,0,36,33
1657100432093,MATH 18,B03,083750,Rideout; David Porter,2,0,37,35
1657100432093,MATH 18,B04,083751,Rideout; David Porter,5,0,36,31
1657100432093,MATH 18,B05,093473,Rideout; David Porter,4,0,36,32
1657100432093,MATH 18,B06,093474,Rideout; David Porter,5,0,36,31
1657100438117,MATH 20A,A01,083754,Zheng; Zequn,12,0,40,28
1657100444143,MATH 20B,A01,083756,Briones; Jor-el Thomas Caparas,1,0,36,35
1657100444143,MATH 20B,A02,083757,Briones; Jor-el Thomas Caparas,1,0,36,35
1657100444143,MATH 20B,A03,093475,Briones; Jor-el Thomas Caparas,0,0,36,36
1657100450168,MATH 20C,A01,083760,Briones; Jor-el Thomas Caparas,1,0,35,34
1657100450168,MATH 20C,A02,083761,Briones; Jor-el Thomas Caparas,8,0,35,27
1657100450168,MATH 20C,A03,093476,Briones; Jor-el Thomas Caparas,0,1,36,36
1657100450168,MATH 20C,B01,083762,Bach; Quang Tran,0,0,30,30
1657100456212,MATH 20D,A01,083765,Tran; Brian Kha,4,0,30,26
1657100456212,MATH 20D,A02,083766,Tran; Brian Kha,5,0,30,25
1657100456212,MATH 20D,A03,083767,Tran; Brian Kha,3,0,30,27
1657100462240,MATH 20E,A01,083771,Ganguly; Soumya,6,0,32,26
1657100462240,MATH 20E,A02,083772,Ganguly; Soumya,6,0,32,26
1657100462240,MATH 20E,B01,083773,Ciotti; Benjamin,18,0,35,17
1657100462240,MATH 20E,B02,083774,Ciotti; Benjamin,17,0,35,18
1657100468275,MATH 103A,A01,083777,Greenfeld; Be'Eri,2,0,36,34
1657100468275,MATH 103A,A02,083778,Greenfeld; Be'Eri,5,0,36,31
1657100468275,MATH 103A,A03,093561,Greenfeld; Be'Eri,4,0,36,32
1657100468275,MATH 103A,B01,083779,Greenfeld; Be'Eri,6,0,36,30
1657100468275,MATH 103A,B02,083780,Greenfeld; Be'Eri,2,0,36,34
1657100468275,MATH 103A,B03,093562,Greenfeld; Be'Eri,3,0,36,33
1657100474303,MATH 105,A01,085443,Carter; Anne Toulson,14,0,35,21
1657100474303,MATH 105,A02,093477,Carter; Anne Toulson,20,0,35,15
1657100480330,MATH 109,A01,083213,Ganzberger; Geoffrey Michael,2,0,34,32
1657100480330,MATH 109,A02,083214,Ganzberger; Geoffrey Michael,3,0,34,31
1657100480330,MATH 109,A03,093478,Ganzberger; Geoffrey Michael,1,0,34,33
1657100480330,MATH 109,B01,083215,Ganzberger; Geoffrey Michael,1,0,32,31
1657100480330,MATH 109,B02,083216,Ganzberger; Geoffrey Michael,1,0,32,31
1657100480330,MATH 109,B03,093479,Ganzberger; Geoffrey Michael,6,0,32,26
1657100486358,MATH 142A,A01,083219,Chow; Bennett,6,0,32,26
1657100486358,MATH 142A,A02,083220,Chow; Bennett,10,0,32,22
1657100486358,MATH 142A,A03,093480,Chow; Bennett,7,0,32,25
1657100486358,MATH 142A,B03,093481,Chow; Bennett,8,0,32,24
1657100486358,MATH 142A,B04,093558,Chow; Bennett,11,0,32,21
1657100486358,MATH 142A,B05,093559,Chow; Bennett,6,0,32,26
1657100492392,MATH 193A,A01,083224,Rotar; Vladimir,7,0,34,27
1657100492392,MATH 193A,A02,083225,Rotar; Vladimir,5,0,34,29
1657100492392,MATH 193A,A03,083781,Rotar; Vladimir,1,0,34,33
1657100492392,MATH 193A,A04,083782,Rotar; Vladimir,6,0,34,28
1657100492392,MATH 193A,A05,093482,Rotar; Vladimir,6,0,34,28
1657100498417,MATH 197,001,091859,McAuley; Julian John,9999,0,9999,0
1657100498417,MATH 197,002,095566,Kedlaya; Kiran S.,9997,0,9999,2
1657100498417,MATH 197,003,095567,Xiao; Ming,9999,0,9999,0
1657100498417,MATH 197,004,095571,Perols; Johan Lars,9998,0,9999,1
1657100505517,COGS 9,A01,083615,Shannon; Kyle Michael,7,0,75,68
1657100511542,COGS 11,A01,083617,Boyle; Mary E. T.,21,0,48,27
1657100517569,COGS 13,A01,083071,Bastos; Amalia Pinkusfeld,9,0,71,62
1657100523616,COGS 14A,A01,092681,Semenuks; Arturs,1,1,100,99
1657100529641,COGS 14B,A01,083073,Cheng; Tzu-Han,6,0,63,57
1657100535668,COGS 17,A01,092677,Semenuks; Arturs,4,0,81,77
1657100541698,COGS 100,A01,083619,Allen; Michael Gordon,15,0,70,55
1657100547725,COGS 101A,A01,083621,Davis; Joshua Daniel,9,0,68,59
1657100553754,COGS 101B,A01,091572,Allen; Michael Gordon,8,0,65,57
1657100559788,COGS 101C,A01,083625,Delgado; Tania,17,0,35,18
1657100565815,COGS 107A,A01,083627,Boyle; Mary E. T.,13,0,60,47
1657100571842,COGS 118A,A01,083075,Gupta; Anjum,15,0,76,61
1657100577871,CSE 3,A50,083646,Miranda; Gregory Joseph,22,0,50,28
1657100583898,CSE 8A,A50,083650,Miranda; Gregory Joseph,17,1,56,39
1657100589926,CSE 11,A01,083080,Cao; Yingjun,4,15,40,36
1657100595949,CSE 12,A01,083652,Krause-Levy; Sophia Louisa,23,1,120,97
1657100601975,CSE 15L,A01,083654,Morris; Justin Loren,9,0,50,41
1657100601975,CSE 15L,A02,083655,Morris; Justin Loren,9,0,50,41
1657100608008,CSE 20,A01,083657,Tran; Khoa Dang,37,0,80,43
1657100614033,CSE 21,A01,095574,Bach; Quang Tran,21,0,48,27
1657100620071,CSE 30,A01,083084,Eldon; John,4,0,80,76
1657100620071,CSE 30,B01,095061,Bhaskar; Nishant,6,0,50,44
1657100626097,CSE 100,A01,083659,Cao; Yingjun,4,4,70,66
1657100632133,CSE 134B,A01,083661,Powell; Thomas Allan,19,0,100,81
1657100638165,CSE 140,A01,083663,Gungor; Onat,14,0,85,71
1657100644191,CSE 140L,A01,083088,Eldon; John,16,0,100,84
1657100651049,CSE 175,A01,083665,Kumar; Rakesh,3,0,25,22
1657100657075,CSE 190,A00,092507,Dubnov; Shlomo,7,0,20,13
1657100663100,ECE 45,A01,083139,Congero; Spencer William,5,0,75,70
1657100669127,ECE 65,A50,083695,Saad; Andrew S,12,0,30,18
1657100669127,ECE 65,A51,095125,Saad; Andrew S,25,0,26,1
1657100675155,ECE 109,A01,091882,Touri; Behrouz,16,0,70,54
1657100681201,ECE 180,A00,083140,Abi Samra; Nicholas Camill,1,0,30,29
1657100681201,ECE 180,B00,083141,Abi Samra; Nicholas Camill,0,0,30,30
1657100687332,MATH 10A,A01,083735,Patchell; Gregory David,1,0,30,29
1657100687332,MATH 10A,A02,083736,Patchell; Gregory David,20,0,30,10
1657100687332,MATH 10A,A03,083737,Patchell; Gregory David,16,0,30,14
1657100693404,MATH 10B,A01,083207,Lim; Seonhee,7,0,34,27
1657100693404,MATH 10B,A02,083208,Lim; Seonhee,9,0,35,26
1657100693404,MATH 10B,A03,093472,Lim; Seonhee,5,0,34,29
1657100693404,MATH 10B,B01,083739,Sinha; Shubham,9,0,30,21
1657100699431,MATH 18,A01,083743,Cinel; Cameron Alexander,6,0,30,24
1657100699431,MATH 18,A02,083744,Cinel; Cameron Alexander,15,0,30,15
1657100699431,MATH 18,A03,083745,Cinel; Cameron Alexander,8,0,30,22
1657100699431,MATH 18,B01,083748,Rideout; David Porter,4,0,37,33
1657100699431,MATH 18,B02,083749,Rideout; David Porter,3,0,36,33
1657100699431,MATH 18,B03,083750,Rideout; David Porter,2,0,37,35
1657100699431,MATH 18,B04,083751,Rideout; David Porter,5,0,36,31
1657100699431,MATH 18,B05,093473,Rideout; David Porter,4,0,36,32
1657100699431,MATH 18,B06,093474,Rideout; David Porter,5,0,36,31
1657100705455,MATH 20A,A01,083754,Zheng; Zequn,12,0,40,28
1657100711481,MATH 20B,A01,083756,Briones; Jor-el Thomas Caparas,1,0,36,35
1657100711481,MATH 20B,A02,083757,Briones; Jor-el Thomas Caparas,1,0,36,35
1657100711481,MATH 20B,A03,093475,Briones; Jor-el Thomas Caparas,0,0,36,36
1657100717506,MATH 20C,A01,083760,Briones; Jor-el Thomas Caparas,1,0,35,34
1657100717506,MATH 20C,A02,083761,Briones; Jor-el Thomas Caparas,8,0,35,27
1657100717506,MATH 20C,A03,093476,Briones; Jor-el Thomas Caparas,0,1,36,36
1657100717506,MATH 20C,B01,083762,Bach; Quang Tran,0,0,30,30
1657100723540,MATH 20D,A01,083765,Tran; Brian Kha,4,0,30,26
1657100723540,MATH 20D,A02,083766,Tran; Brian Kha,5,0,30,25
1657100723540,MATH 20D,A03,083767,Tran; Brian Kha,3,0,30,27
1657100729582,MATH 20E,A01,083771,Ganguly; Soumya,6,0,32,26
1657100729582,MATH 20E,A02,083772,Ganguly; Soumya,6,0,32,26
1657100729582,MATH 20E,B01,083773,Ciotti; Benjamin,18,0,35,17
1657100729582,MATH 20E,B02,083774,Ciotti; Benjamin,17,0,35,18
1657100735625,MATH 103A,A01,083777,Greenfeld; Be'Eri,2,0,36,34
1657100735625,MATH 103A,A02,083778,Greenfeld; Be'Eri,5,0,36,31
1657100735625,MATH 103A,A03,093561,Greenfeld; Be'Eri,4,0,36,32
1657100735625,MATH 103A,B01,083779,Greenfeld; Be'Eri,6,0,36,30
1657100735625,MATH 103A,B02,083780,Greenfeld; Be'Eri,2,0,36,34
1657100735625,MATH 103A,B03,093562,Greenfeld; Be'Eri,3,0,36,33
1657100741654,MATH 105,A01,085443,Carter; Anne Toulson,14,0,35,21
1657100741654,MATH 105,A02,093477,Carter; Anne Toulson,20,0,35,15
1657100747693,MATH 109,A01,083213,Ganzberger; Geoffrey Michael,2,0,34,32
1657100747693,MATH 109,A02,083214,Ganzberger; Geoffrey Michael,3,0,34,31
1657100747693,MATH 109,A03,093478,Ganzberger; Geoffrey Michael,1,0,34,33
1657100747693,MATH 109,B01,083215,Ganzberger; Geoffrey Michael,1,0,32,31
1657100747693,MATH 109,B02,083216,Ganzberger; Geoffrey Michael,1,0,32,31
1657100747693,MATH 109,B03,093479,Ganzberger; Geoffrey Michael,6,0,32,26
1657100753739,MATH 142A,A01,083219,Chow; Bennett,6,0,32,26
1657100753739,MATH 142A,A02,083220,Chow; Bennett,10,0,32,22
1657100753739,MATH 142A,A03,093480,Chow; Bennett,7,0,32,25
1657100753739,MATH 142A,B03,093481,Chow; Bennett,8,0,32,24
1657100753739,MATH 142A,B04,093558,Chow; Bennett,11,0,32,21
1657100753739,MATH 142A,B05,093559,Chow; Bennett,6,0,32,26
1657100759780,MATH 193A,A01,083224,Rotar; Vladimir,7,0,34,27
1657100759780,MATH 193A,A02,083225,Rotar; Vladimir,5,0,34,29
1657100759780,MATH 193A,A03,083781,Rotar; Vladimir,1,0,34,33
1657100759780,MATH 193A,A04,083782,Rotar; Vladimir,6,0,34,28
1657100759780,MATH 193A,A05,093482,Rotar; Vladimir,6,0,34,28
1657100765810,MATH 197,001,091859,McAuley; Julian John,9999,0,9999,0
1657100765810,MATH 197,002,095566,Kedlaya; Kiran S.,9997,0,9999,2
1657100765810,MATH 197,003,095567,Xiao; Ming,9999,0,9999,0
1657100765810,MATH 197,004,095571,Perols; Johan Lars,9998,0,9999,1
1657100772896,COGS 9,A01,083615,Shannon; Kyle Michael,7,0,75,68
1657100778926,COGS 11,A01,083617,Boyle; Mary E. T.,21,0,48,27
1657100784955,COGS 13,A01,083071,Bastos; Amalia Pinkusfeld,9,0,71,62
1657100790986,COGS 14A,A01,092681,Semenuks; Arturs,1,1,100,99
1657100797009,COGS 14B,A01,083073,Cheng; Tzu-Han,6,0,63,57
1657100803046,COGS 17,A01,092677,Semenuks; Arturs,4,0,81,77
1657100809074,COGS 100,A01,083619,Allen; Michael Gordon,15,0,70,55
1657100815098,COGS 101A,A01,083621,Davis; Joshua Daniel,9,0,68,59
1657100821121,COGS 101B,A01,091572,Allen; Michael Gordon,8,0,65,57
1657100827146,COGS 101C,A01,083625,Delgado; Tania,17,0,35,18
1657100833174,COGS 107A,A01,083627,Boyle; Mary E. T.,13,0,60,47
1657100839206,COGS 118A,A01,083075,Gupta; Anjum,15,0,76,61
1657100845231,CSE 3,A50,083646,Miranda; Gregory Joseph,22,0,50,28
1657100851255,CSE 8A,A50,083650,Miranda; Gregory Joseph,17,1,56,39
1657100857283,CSE 11,A01,083080,Cao; Yingjun,4,15,40,36
1657100863314,CSE 12,A01,083652,Krause-Levy; Sophia Louisa,23,1,120,97
1657100869340,CSE 15L,A01,083654,Morris; Justin Loren,9,0,50,41
1657100869340,CSE 15L,A02,083655,Morris; Justin Loren,9,0,50,41
1657100875365,CSE 20,A01,083657,Tran; Khoa Dang,37,0,80,43
1657100881399,CSE 21,A01,095574,Bach; Quang Tran,21,0,48,27
1657100887424,CSE 30,A01,083084,Eldon; John,4,0,80,76
1657100887424,CSE 30,B01,095061,Bhaskar; Nishant,6,0,50,44
1657100893450,CSE 100,A01,083659,Cao; Yingjun,4,4,70,66
1657100899475,CSE 134B,A01,083661,Powell; Thomas Allan,19,0,100,81
1657100905500,CSE 140,A01,083663,Gungor; Onat,14,0,85,71
1657100911526,CSE 140L,A01,083088,Eldon; John,16,0,100,84
1657100917550,CSE 175,A01,083665,Kumar; Rakesh,3,0,25,22
1657100923574,CSE 190,A00,092507,Dubnov; Shlomo,7,0,20,13
1657100929607,ECE 45,A01,083139,Congero; Spencer William,5,0,75,70
1657100935632,ECE 65,A50,083695,Saad; Andrew S,12,0,30,18
1657100935632,ECE 65,A51,095125,Saad; Andrew S,25,0,26,1
1657100941656,ECE 109,A01,091882,Touri; Behrouz,16,0,70,54
1657100947681,ECE 180,A00,083140,Abi Samra; Nicholas Camill,1,0,30,29
1657100947681,ECE 180,B00,083141,Abi Samra; Nicholas Camill,0,0,30,30
1657100953709,MATH 10A,A01,083735,Patchell; Gregory David,1,0,30,29
1657100953709,MATH 10A,A02,083736,Patchell; Gregory David,20,0,30,10
1657100953709,MATH 10A,A03,083737,Patchell; Gregory David,16,0,30,14
1657100959736,MATH 10B,A01,083207,Lim; Seonhee,7,0,34,27
1657100959736,MATH 10B,A02,083208,Lim; Seonhee,9,0,35,26
1657100959736,MATH 10B,A03,093472,Lim; Seonhee,5,0,34,29
1657100959736,MATH 10B,B01,083739,Sinha; Shubham,9,0,30,21
1657100965763,MATH 18,A01,083743,Cinel; Cameron Alexander,6,0,30,24
1657100965763,MATH 18,A02,083744,Cinel; Cameron Alexander,15,0,30,15
1657100965763,MATH 18,A03,083745,Cinel; Cameron Alexander,8,0,30,22
1657100965763,MATH 18,B01,083748,Rideout; David Porter,4,0,37,33
1657100965763,MATH 18,B02,083749,Rideout; David Porter,3,0,36,33
1657100965763,MATH 18,B03,083750,Rideout; David Porter,2,0,37,35
1657100965763,MATH 18,B04,083751,Rideout; David Porter,5,0,36,31
1657100965763,MATH 18,B05,093473,Rideout; David Porter,4,0,36,32
1657100965763,MATH 18,B06,093474,Rideout; David Porter,5,0,36,31
1657100971787,MATH 20A,A01,083754,Zheng; Zequn,12,0,40,28
1657100977831,MATH 20B,A01,083756,Briones; Jor-el Thomas Caparas,1,0,36,35
1657100977831,MATH 20B,A02,083757,Briones; Jor-el Thomas Caparas,1,0,36,35
1657100977831,MATH 20B,A03,093475,Briones; Jor-el Thomas Caparas,0,0,36,36
1657100983857,MATH 20C,A01,083760,Briones; Jor-el Thomas Caparas,1,0,35,34
1657100983857,MATH 20C,A02,083761,Briones; Jor-el Thomas Caparas,8,0,35,27
1657100983857,MATH 20C,A03,093476,Briones; Jor-el Thomas Caparas,0,1,36,36
1657100983857,MATH 20C,B01,083762,Bach; Quang Tran,0,0,30,30
1657100989888,MATH 20D,A01,083765,Tran; Brian Kha,4,0,30,26
1657100989888,MATH 20D,A02,083766,Tran; Brian Kha,5,0,30,25
1657100989888,MATH 20D,A03,083767,Tran; Brian Kha,3,0,30,27
1657100995914,MATH 20E,A01,083771,Ganguly; Soumya,6,0,32,26
1657100995914,MATH 20E,A02,083772,Ganguly; Soumya,6,0,32,26
1657100995914,MATH 20E,B01,083773,Ciotti; Benjamin,18,0,35,17
1657100995914,MATH 20E,B02,083774,Ciotti; Benjamin,17,0,35,18
1657101001949,MATH 103A,A01,083777,Greenfeld; Be'Eri,2,0,36,34
1657101001949,MATH 103A,A02,083778,Greenfeld; Be'Eri,5,0,36,31
1657101001949,MATH 103A,A03,093561,Greenfeld; Be'Eri,4,0,36,32
1657101001949,MATH 103A,B01,083779,Greenfeld; Be'Eri,6,0,36,30
1657101001949,MATH 103A,B02,083780,Greenfeld; Be'Eri,2,0,36,34
1657101001949,MATH 103A,B03,093562,Greenfeld; Be'Eri,3,0,36,33
1657101007980,MATH 105,A01,085443,Carter; Anne Toulson,14,0,35,21
1657101007980,MATH 105,A02,093477,Carter; Anne Toulson,20,0,35,15
1657101014005,MATH 109,A01,083213,Ganzberger; Geoffrey Michael,2,0,34,32
1657101014005,MATH 109,A02,083214,Ganzberger; Geoffrey Michael,3,0,34,31
1657101014005,MATH 109,A03,093478,Ganzberger; Geoffrey Michael,1,0,34,33
1657101014005,MATH 109,B01,083215,Ganzberger; Geoffrey Michael,1,0,32,31
1657101014005,MATH 109,B02,083216,Ganzberger; Geoffrey Michael,1,0,32,31
1657101014005,MATH 109,B03,093479,Ganzberger; Geoffrey Michael,6,0,32,26
1657101020071,MATH 142A,A01,083219,Chow; Bennett,6,0,32,26
1657101020071,MATH 142A,A02,083220,Chow; Bennett,10,0,32,22
1657101020071,MATH 142A,A03,093480,Chow; Bennett,7,0,32,25
1657101020071,MATH 142A,B03,093481,Chow; Bennett,8,0,32,24
1657101020071,MATH 142A,B04,093558,Chow; Bennett,11,0,32,21
1657101020071,MATH 142A,B05,093559,Chow; Bennett,6,0,32,26
1657101026104,MATH 193A,A01,083224,Rotar; Vladimir,7,0,34,27
1657101026104,MATH 193A,A02,083225,Rotar; Vladimir,5,0,34,29
1657101026104,MATH 193A,A03,083781,Rotar; Vladimir,1,0,34,33
1657101026104,MATH 193A,A04,083782,Rotar; Vladimir,6,0,34,28
1657101026104,MATH 193A,A05,093482,Rotar; Vladimir,6,0,34,28
1657101032133,MATH 197,001,091859,McAuley; Julian John,9999,0,9999,0
1657101032133,MATH 197,002,095566,Kedlaya; Kiran S.,9997,0,9999,2
1657101032133,MATH 197,003,095567,Xiao; Ming,9999,0,9999,0
1657101032133,MATH 197,004,095571,Perols; Johan Lars,9998,0,9999,1
1657101039213,COGS 9,A01,083615,Shannon; Kyle Michael,7,0,75,68
1657101045245,COGS 11,A01,083617,Boyle; Mary E. T.,21,0,48,27
1657101051270,COGS 13,A01,083071,Bastos; Amalia Pinkusfeld,9,0,71,62
1657101057293,COGS 14A,A01,092681,Semenuks; Arturs,1,1,100,99
1657101063334,COGS 14B,A01,083073,Cheng; Tzu-Han,6,0,63,57
1657101069359,COGS 17,A01,092677,Semenuks; Arturs,4,0,81,77
1657101075384,COGS 100,A01,083619,Allen; Michael Gordon,15,0,70,55
1657101081409,COGS 101A,A01,083621,Davis; Joshua Daniel,9,0,68,59
1657101087432,COGS 101B,A01,091572,Allen; Michael Gordon,8,0,65,57
1657101093463,COGS 101C,A01,083625,Delgado; Tania,17,0,35,18
1657101099487,COGS 107A,A01,083627,Boyle; Mary E. T.,13,0,60,47
1657101105512,COGS 118A,A01,083075,Gupta; Anjum,15,0,76,61
1657101111544,CSE 3,A50,083646,Miranda; Gregory Joseph,22,0,50,28
1657101117568,CSE 8A,A50,083650,Miranda; Gregory Joseph,17,1,56,39
1657101123592,CSE 11,A01,083080,Cao; Yingjun,4,15,40,36
1657101129622,CSE 12,A01,083652,Krause-Levy; Sophia Louisa,23,1,120,97
1657101135654,CSE 15L,A01,083654,Morris; Justin Loren,9,0,50,41
1657101135654,CSE 15L,A02,083655,Morris; Justin Loren,9,0,50,41
1657101141678,CSE 20,A01,083657,Tran; Khoa Dang,37,0,80,43
1657101147707,CSE 21,A01,095574,Bach; Quang Tran,21,0,48,27
1657101153732,CSE 30,A01,083084,Eldon; John,4,0,80,76
1657101153732,CSE 30,B01,095061,Bhaskar; Nishant,6,0,50,44
1657101159757,CSE 100,A01,083659,Cao; Yingjun,4,4,70,66
1657101165786,CSE 134B,A01,083661,Powell; Thomas Allan,19,0,100,81
1657101171813,CSE 140,A01,083663,Gungor; Onat,14,0,85,71
1657101177837,CSE 140L,A01,083088,Eldon; John,16,0,100,84
1657101183863,CSE 175,A01,083665,Kumar; Rakesh,3,0,25,22
1657101189888,CSE 190,A00,092507,Dubnov; Shlomo,7,0,20,13
1657101195911,ECE 45,A01,083139,Congero; Spencer William,5,0,75,70
1657101201942,ECE 65,A50,083695,Saad; Andrew S,12,0,30,18
1657101201942,ECE 65,A51,095125,Saad; Andrew S,25,0,26,1
1657101207966,ECE 109,A01,091882,Touri; Behrouz,16,0,70,54
1657101213991,ECE 180,A00,083140,Abi Samra; Nicholas Camill,1,0,30,29
1657101213991,ECE 180,B00,083141,Abi Samra; Nicholas Camill,0,0,30,30
1657101220016,MATH 10A,A01,083735,Patchell; Gregory David,1,0,30,29
1657101220016,MATH 10A,A02,083736,Patchell; Gregory David,20,0,30,10
1657101220016,MATH 10A,A03,083737,Patchell; Gregory David,16,0,30,14
1657101226045,MATH 10B,A01,083207,Lim; Seonhee,7,0,34,27
1657101226045,MATH 10B,A02,083208,Lim; Seonhee,9,0,35,26
1657101226045,MATH 10B,A03,093472,Lim; Seonhee,5,0,34,29
1657101226045,MATH 10B,B01,083739,Sinha; Shubham,9,0,30,21
1657101232081,MATH 18,A01,083743,Cinel; Cameron Alexander,6,0,30,24
1657101232081,MATH 18,A02,083744,Cinel; Cameron Alexander,15,0,30,15
1657101232081,MATH 18,A03,083745,Cinel; Cameron Alexander,8,0,30,22
1657101232081,MATH 18,B01,083748,Rideout; David Porter,4,0,37,33
1657101232081,MATH 18,B02,083749,Rideout; David Porter,3,0,36,33
1657101232081,MATH 18,B03,083750,Rideout; David Porter,2,0,37,35
1657101232081,MATH 18,B04,083751,Rideout; David Porter,5,0,36,31
1657101232081,MATH 18,B05,093473,Rideout; David Porter,4,0,36,32
1657101232081,MATH 18,B06,093474,Rideout; David Porter,5,0,36,31
1657101238113,MATH 20A,A01,083754,Zheng; Zequn,12,0,40,28
1657101244138,MATH 20B,A01,083756,Briones; Jor-el Thomas Caparas,1,0,36,35
1657101244138,MATH 20B,A02,083757,Briones; Jor-el Thomas Caparas,1,0,36,35
1657101244138,MATH 20B,A03,093475,Briones; Jor-el Thomas Caparas,0,0,36,36
1657101250169,MATH 20C,A01,083760,Briones; Jor-el Thomas Caparas,1,0,35,34
1657101250169,MATH 20C,A02,083761,Briones; Jor-el Thomas Caparas,8,0,35,27
1657101250169,MATH 20C,A03,093476,Briones; Jor-el Thomas Caparas,0,1,36,36
1657101250169,MATH 20C,B01,083762,Bach; Quang Tran,0,0,30,30
1657101256198,MATH 20D,A01,083765,Tran; Brian Kha,4,0,30,26
1657101256198,MATH 20D,A02,083766,Tran; Brian Kha,5,0,30,25
1657101256198,MATH 20D,A03,083767,Tran; Brian Kha,3,0,30,27
1657101262232,MATH 20E,A01,083771,Ganguly; Soumya,6,0,32,26
1657101262232,MATH 20E,A02,083772,Ganguly; Soumya,6,0,32,26
1657101262232,MATH 20E,B01,083773,Ciotti; Benjamin,18,0,35,17
1657101262232,MATH 20E,B02,083774,Ciotti; Benjamin,17,0,35,18
1657101268256,MATH 103A,A01,083777,Greenfeld; Be'Eri,2,0,36,34
1657101268256,MATH 103A,A02,083778,Greenfeld; Be'Eri,5,0,36,31
1657101268256,MATH 103A,A03,093561,Greenfeld; Be'Eri,4,0,36,32
1657101268256,MATH 103A,B01,083779,Greenfeld; Be'Eri,6,0,36,30
1657101268256,MATH 103A,B02,083780,Greenfeld; Be'Eri,2,0,36,34
1657101268256,MATH 103A,B03,093562,Greenfeld; Be'Eri,3,0,36,33
1657101274280,MATH 105,A01,085443,Carter; Anne Toulson,14,0,35,21
1657101274280,MATH 105,A02,093477,Carter; Anne Toulson,20,0,35,15
1657101280313,MATH 109,A01,083213,Ganzberger; Geoffrey Michael,2,0,34,32
1657101280313,MATH 109,A02,083214,Ganzberger; Geoffrey Michael,3,0,34,31
1657101280313,MATH 109,A03,093478,Ganzberger; Geoffrey Michael,1,0,34,33
1657101280313,MATH 109,B01,083215,Ganzberger; Geoffrey Michael,1,0,32,31
1657101280313,MATH 109,B02,083216,Ganzberger; Geoffrey Michael,1,0,32,31
1657101280313,MATH 109,B03,093479,Ganzberger; Geoffrey Michael,6,0,32,26
1657101286430,MATH 142A,A01,083219,Chow; Bennett,6,0,32,26
1657101286430,MATH 142A,A02,083220,Chow; Bennett,10,0,32,22
1657101286430,MATH 142A,A03,093480,Chow; Bennett,7,0,32,25
1657101286430,MATH 142A,B03,093481,Chow; Bennett,8,0,32,24
1657101286430,MATH 142A,B04,093558,Chow; Bennett,11,0,32,21
1657101286430,MATH 142A,B05,093559,Chow; Bennett,6,0,32,26
1657101292459,MATH 193A,A01,083224,Rotar; Vladimir,7,0,34,27
1657101292459,MATH 193A,A02,083225,Rotar; Vladimir,5,0,34,29
1657101292459,MATH 193A,A03,083781,Rotar; Vladimir,1,0,34,33
1657101292459,MATH 193A,A04,083782,Rotar; Vladimir,6,0,34,28
1657101292459,MATH 193A,A05,093482,Rotar; Vladimir,6,0,34,28
1657101298488,MATH 197,001,091859,McAuley; Julian John,9999,0,9999,0
1657101298488,MATH 197,002,095566,Kedlaya; Kiran S.,9997,0,9999,2
1657101298488,MATH 197,003,095567,Xiao; Ming,9999,0,9999,0
1657101298488,MATH 197,004,095571,Perols; Johan Lars,9998,0,9999,1
1657101305558,COGS 9,A01,083615,Shannon; Kyle Michael,7,0,75,68
1657101311596,COGS 11,A01,083617,Boyle; Mary E. T.,21,0,48,27
1657101317626,COGS 13,A01,083071,Bastos; Amalia Pinkusfeld,9,0,71,62
1657101323656,COGS 14A,A01,092681,Semenuks; Arturs,1,1,100,99
1657101329681,COGS 14B,A01,083073,Cheng; Tzu-Han,6,0,63,57
1657101335709,COGS 17,A01,092677,Semenuks; Arturs,4,0,81,77
1657101341735,COGS 100,A01,083619,Allen; Michael Gordon,15,0,70,55
1657101347760,COGS 101A,A01,083621,Davis; Joshua Daniel,9,0,68,59
1657101353783,COGS 101B,A01,091572,Allen; Michael Gordon,8,0,65,57
1657101359815,COGS 101C,A01,083625,Delgado; Tania,17,0,35,18
1657101365843,COGS 107A,A01,083627,Boyle; Mary E. T.,13,0,60,47
1657101371867,COGS 118A,A01,083075,Gupta; Anjum,15,0,76,61
1657101377892,CSE 3,A50,083646,Miranda; Gregory Joseph,22,0,50,28
1657101383916,CSE 8A,A50,083650,Miranda; Gregory Joseph,17,1,56,39
1657101389946,CSE 11,A01,083080,Cao; Yingjun,4,15,40,36
1657101395973,CSE 12,A01,083652,Krause-Levy; Sophia Louisa,23,1,120,97
1657101401999,CSE 15L,A01,083654,Morris; Justin Loren,9,0,50,41
1657101401999,CSE 15L,A02,083655,Morris; Justin Loren,9,0,50,41
1657101408030,CSE 20,A01,083657,Tran; Khoa Dang,37,0,80,43
1657101414061,CSE 21,A01,095574,Bach; Quang Tran,21,0,48,27
1657101420088,CSE 30,A01,083084,Eldon; John,4,0,80,76
1657101420088,CSE 30,B01,095061,Bhaskar; Nishant,6,0,50,44
1657101426119,CSE 100,A01,083659,Cao; Yingjun,4,4,70,66
1657101432143,CSE 134B,A01,083661,Powell; Thomas Allan,19,0,100,81
1657101438167,CSE 140,A01,083663,Gungor; Onat,14,0,85,71
1657101444192,CSE 140L,A01,083088,Eldon; John,16,0,100,84
1657101450215,CSE 175,A01,083665,Kumar; Rakesh,3,0,25,22
1657101456240,CSE 190,A00,092507,Dubnov; Shlomo,7,0,20,13
1657101462269,ECE 45,A01,083139,Congero; Spencer William,5,0,75,70
1657101468306,ECE 65,A50,083695,Saad; Andrew S,12,0,30,18
1657101468306,ECE 65,A51,095125,Saad; Andrew S,25,0,26,1
1657101474332,ECE 109,A01,091882,Touri; Behrouz,16,0,70,54
1657101480379,ECE 180,A00,083140,Abi Samra; Nicholas Camill,1,0,30,29
1657101480379,ECE 180,B00,083141,Abi Samra; Nicholas Camill,0,0,30,30
1657101486407,MATH 10A,A01,083735,Patchell; Gregory David,1,0,30,29
1657101486407,MATH 10A,A02,083736,Patchell; Gregory David,20,0,30,10
1657101486407,MATH 10A,A03,083737,Patchell; Gregory David,16,0,30,14
1657101492445,MATH 10B,A01,083207,Lim; Seonhee,7,0,34,27
1657101492445,MATH 10B,A02,083208,Lim; Seonhee,9,0,35,26
1657101492445,MATH 10B,A03,093472,Lim; Seonhee,5,0,34,29
1657101492445,MATH 10B,B01,083739,Sinha; Shubham,9,0,30,21
1657101498492,MATH 18,A01,083743,Cinel; Cameron Alexander,6,0,30,24
1657101498492,MATH 18,A02,083744,Cinel; Cameron Alexander,15,0,30,15
1657101498492,MATH 18,A03,083745,Cinel; Cameron Alexander,8,0,30,22
1657101498492,MATH 18,B01,083748,Rideout; David Porter,4,0,37,33
1657101498492,MATH 18,B02,083749,Rideout; David Porter,3,0,36,33
1657101498492,MATH 18,B03,083750,Rideout; David Porter,2,0,37,35
1657101498492,MATH 18,B04,083751,Rideout; David Porter,5,0,36,31
1657101498492,MATH 18,B05,093473,Rideout; David Porter,4,0,36,32
1657101498492,MATH 18,B06,093474,Rideout; David Porter,5,0,36,31
1657101504523,MATH 20A,A01,083754,Zheng; Zequn,12,0,40,28
1657101510551,MATH 20B,A01,083756,Briones; Jor-el Thomas Caparas,1,0,36,35
1657101510551,MATH 20B,A02,083757,Briones; Jor-el Thomas Caparas,1,0,36,35
1657101510551,MATH 20B,A03,093475,Briones; Jor-el Thomas Caparas,0,0,36,36
1657101516578,MATH 20C,A01,083760,Briones; Jor-el Thomas Caparas,1,0,35,34
1657101516578,MATH 20C,A02,083761,Briones; Jor-el Thomas Caparas,8,0,35,27
1657101516578,MATH 20C,A03,093476,Briones; Jor-el Thomas Caparas,0,1,36,36
1657101516578,MATH 20C,B01,083762,Bach; Quang Tran,0,0,30,30
1657101522604,MATH 20D,A01,083765,Tran; Brian Kha,4,0,30,26
1657101522604,MATH 20D,A02,083766,Tran; Brian Kha,5,0,30,25
1657101522604,MATH 20D,A03,083767,Tran; Brian Kha,3,0,30,27
1657101528641,MATH 20E,A01,083771,Ganguly; Soumya,6,0,32,26
1657101528641,MATH 20E,A02,083772,Ganguly; Soumya,6,0,32,26
1657101528641,MATH 20E,B01,083773,Ciotti; Benjamin,18,0,35,17
1657101528641,MATH 20E,B02,083774,Ciotti; Benjamin,17,0,35,18
1657101534680,MATH 103A,A01,083777,Greenfeld; Be'Eri,2,0,36,34
1657101534680,MATH 103A,A02,083778,Greenfeld; Be'Eri,5,0,36,31
1657101534680,MATH 103A,A03,093561,Greenfeld; Be'Eri,4,0,36,32
1657101534680,MATH 103A,B01,083779,Greenfeld; Be'Eri,6,0,36,30
1657101534680,MATH 103A,B02,083780,Greenfeld; Be'Eri,2,0,36,34
1657101534680,MATH 103A,B03,093562,Greenfeld; Be'Eri,3,0,36,33
1657101540714,MATH 105,A01,085443,Carter; Anne Toulson,14,0,35,21
1657101540714,MATH 105,A02,093477,Carter; Anne Toulson,20,0,35,15
1657101546746,MATH 109,A01,083213,Ganzberger; Geoffrey Michael,2,0,34,32
1657101546746,MATH 109,A02,083214,Ganzberger; Geoffrey Michael,3,0,34,31
1657101546746,MATH 109,A03,093478,Ganzberger; Geoffrey Michael,1,0,34,33
1657101546746,MATH 109,B01,083215,Ganzberger; Geoffrey Michael,1,0,32,31
1657101546746,MATH 109,B02,083216,Ganzberger; Geoffrey Michael,1,0,32,31
1657101546746,MATH 109,B03,093479,Ganzberger; Geoffrey Michael,6,0,32,26
1657101552780,MATH 142A,A01,083219,Chow; Bennett,6,0,32,26
1657101552780,MATH 142A,A02,083220,Chow; Bennett,10,0,32,22
1657101552780,MATH 142A,A03,093480,Chow; Bennett,7,0,32,25
1657101552780,MATH 142A,B03,093481,Chow; Bennett,8,0,32,24
1657101552780,MATH 142A,B04,093558,Chow; Bennett,11,0,32,21
1657101552780,MATH 142A,B05,093559,Chow; Bennett,6,0,32,26
1657101558808,MATH 193A,A01,083224,Rotar; Vladimir,7,0,34,27
1657101558808,MATH 193A,A02,083225,Rotar; Vladimir,5,0,34,29
1657101558808,MATH 193A,A03,083781,Rotar; Vladimir,1,0,34,33
1657101558808,MATH 193A,A04,083782,Rotar; Vladimir,6,0,34,28
1657101558808,MATH 193A,A05,093482,Rotar; Vladimir,6,0,34,28
1657101564834,MATH 197,001,091859,McAuley; Julian John,9999,0,9999,0
1657101564834,MATH 197,002,095566,Kedlaya; Kiran S.,9997,0,9999,2
1657101564834,MATH 197,003,095567,Xiao; Ming,9999,0,9999,0
1657101564834,MATH 197,004,095571,Perols; Johan Lars,9998,0,9999,1
1657101571927,COGS 9,A01,083615,Shannon; Kyle Michael,7,0,75,68
1657101577960,COGS 11,A01,083617,Boyle; Mary E. T.,21,0,48,27
1657101583986,COGS 13,A01,083071,Bastos; Amalia Pinkusfeld,9,0,71,62
1657101590026,COGS 14A,A01,092681,Semenuks; Arturs,1,1,100,99
1657101596052,COGS 14B,A01,083073,Cheng; Tzu-Han,6,0,63,57
1657101602100,COGS 17,A01,092677,Semenuks; Arturs,4,0,81,77
1657101608124,COGS 100,A01,083619,Allen; Michael Gordon,15,0,70,55
1657101614156,COGS 101A,A01,083621,Davis; Joshua Daniel,9,0,68,59
1657101620182,COGS 101B,A01,091572,Allen; Michael Gordon,8,0,65,57
1657101626212,COGS 101C,A01,083625,Delgado; Tania,17,0,35,18
1657101632241,COGS 107A,A01,083627,Boyle; Mary E. T.,13,0,60,47
1657101638276,COGS 118A,A01,083075,Gupta; Anjum,15,0,76,61
1657101644311,CSE 3,A50,083646,Miranda; Gregory Joseph,22,0,50,28
1657101650337,CSE 8A,A50,083650,Miranda; Gregory Joseph,17,1,56,39
1657101656363,CSE 11,A01,083080,Cao; Yingjun,4,15,40,36
1657101662389,CSE 12,A01,083652,Krause-Levy; Sophia Louisa,23,1,120,97
1657101668419,CSE 15L,A01,083654,Morris; Justin Loren,9,0,50,41
1657101668419,CSE 15L,A02,083655,Morris; Justin Loren,9,0,50,41
1657101674449,CSE 20,A01,083657,Tran; Khoa Dang,37,0,80,43
1657101680483,CSE 21,A01,095574,Bach; Quang Tran,21,0,48,27
1657101686510,CSE 30,A01,083084,Eldon; John,4,0,80,76
1657101686510,CSE 30,B01,095061,Bhaskar; Nishant,6,0,50,44
1657101692543,CSE 100,A01,083659,Cao; Yingjun,4,4,70,66
1657101698573,CSE 134B,A01,083661,Powell; Thomas Allan,19,0,100,81
1657101704596,CSE 140,A01,083663,Gungor; Onat,14,0,85,71
1657101710620,CSE 140L,A01,083088,Eldon; John,16,0,100,84
1657101716663,CSE 175,A01,083665,Kumar; Rakesh,3,0,25,22
1657101722686,CSE 190,A00,092507,Dubnov; Shlomo,7,0,20,13
1657101728711,ECE 45,A01,083139,Congero; Spencer William,5,0,75,70
1657101734742,ECE 65,A50,083695,Saad; Andrew S,12,0,30,18
1657101734742,ECE 65,A51,095125,Saad; Andrew S,25,0,26,1
1657101740766,ECE 109,A01,091882,Touri; Behrouz,16,0,70,54
1657101746798,ECE 180,A00,083140,Abi Samra; Nicholas Camill,1,0,30,29
1657101746798,ECE 180,B00,083141,Abi Samra; Nicholas Camill,0,0,30,30
1657101752831,MATH 10A,A01,083735,Patchell; Gregory David,1,0,30,29
1657101752831,MATH 10A,A02,083736,Patchell; Gregory David,20,0,30,10
1657101752831,MATH 10A,A03,083737,Patchell; Gregory David,16,0,30,14
1657101758867,MATH 10B,A01,083207,Lim; Seonhee,7,0,34,27
1657101758867,MATH 10B,A02,083208,Lim; Seonhee,9,0,35,26
1657101758867,MATH 10B,A03,093472,Lim; Seonhee,5,0,34,29
1657101758867,MATH 10B,B01,083739,Sinha; Shubham,9,0,30,21
1657101764895,MATH 18,A01,083743,Cinel; Cameron Alexander,6,0,30,24
1657101764895,MATH 18,A02,083744,Cinel; Cameron Alexander,15,0,30,15
1657101764895,MATH 18,A03,083745,Cinel; Cameron Alexander,8,0,30,22
1657101764895,MATH 18,B01,083748,Rideout; David Porter,4,0,37,33
1657101764895,MATH 18,B02,083749,Rideout; David Porter,3,0,36,33
1657101764895,MATH 18,B03,083750,Rideout; David Porter,2,0,37,35
1657101764895,MATH 18,B04,083751,Rideout; David Porter,5,0,36,31
1657101764895,MATH 18,B05,093473,Rideout; David Porter,4,0,36,32
1657101764895,MATH 18,B06,093474,Rideout; David Porter,5,0,36,31
1657101770919,MATH 20A,A01,083754,Zheng; Zequn,12,0,40,28
1657101776944,MATH 20B,A01,083756,Briones; Jor-el Thomas Caparas,1,0,36,35
1657101776944,MATH 20B,A02,083757,Briones; Jor-el Thomas Caparas,1,0,36,35
1657101776944,MATH 20B,A03,093475,Briones; Jor-el Thomas Caparas,0,0,36,36
1657101782975,MATH 20C,A01,083760,Briones; Jor-el Thomas Caparas,1,0,35,34
1657101782975,MATH 20C,A02,083761,Briones; Jor-el Thomas Caparas,8,0,35,27
1657101782975,MATH 20C,A03,093476,Briones; Jor-el Thomas Caparas,0,1,36,36
1657101782975,MATH 20C,B01,083762,Bach; Quang Tran,0,0,30,30
1657101788999,MATH 20D,A01,083765,Tran; Brian Kha,4,0,30,26
1657101788999,MATH 20D,A02,083766,Tran; Brian Kha,5,0,30,25
1657101788999,MATH 20D,A03,083767,Tran; Brian Kha,3,0,30,27
1657101795032,MATH 20E,A01,083771,Ganguly; Soumya,6,0,32,26
1657101795032,MATH 20E,A02,083772,Ganguly; Soumya,6,0,32,26
1657101795032,MATH 20E,B01,083773,Ciotti; Benjamin,18,0,35,17
1657101795032,MATH 20E,B02,083774,Ciotti; Benjamin,17,0,35,18
1657101801064,MATH 103A,A01,083777,Greenfeld; Be'Eri,2,0,36,34
1657101801064,MATH 103A,A02,083778,Greenfeld; Be'Eri,5,0,36,31
1657101801064,MATH 103A,A03,093561,Greenfeld; Be'Eri,4,0,36,32
1657101801064,MATH 103A,B01,083779,Greenfeld; Be'Eri,6,0,36,30
1657101801064,MATH 103A,B02,083780,Greenfeld; Be'Eri,2,0,36,34
1657101801064,MATH 103A,B03,093562,Greenfeld; Be'Eri,3,0,36,33
1657101807093,MATH 105,A01,085443,Carter; Anne Toulson,14,0,35,21
1657101807093,MATH 105,A02,093477,Carter; Anne Toulson,20,0,35,15
1657101813118,MATH 109,A01,083213,Ganzberger; Geoffrey Michael,2,0,34,32
1657101813118,MATH 109,A02,083214,Ganzberger; Geoffrey Michael,3,0,34,31
1657101813118,MATH 109,A03,093478,Ganzberger; Geoffrey Michael,1,0,34,33
1657101813118,MATH 109,B01,083215,Ganzberger; Geoffrey Michael,1,0,32,31
1657101813118,MATH 109,B02,083216,Ganzberger; Geoffrey Michael,1,0,32,31
1657101813118,MATH 109,B03,093479,Ganzberger; Geoffrey Michael,6,0,32,26
1657101819144,MATH 142A,A01,083219,Chow; Bennett,6,0,32,26
1657101819144,MATH 142A,A02,083220,Chow; Bennett,10,0,32,22
1657101819144,MATH 142A,A03,093480,Chow; Bennett,7,0,32,25
1657101819144,MATH 142A,B03,093481,Chow; Bennett,8,0,32,24
1657101819144,MATH 142A,B04,093558,Chow; Bennett,11,0,32,21
1657101819144,MATH 142A,B05,093559,Chow; Bennett,6,0,32,26
1657101825167,MATH 193A,A01,083224,Rotar; Vladimir,7,0,34,27
1657101825167,MATH 193A,A02,083225,Rotar; Vladimir,5,0,34,29
1657101825167,MATH 193A,A03,083781,Rotar; Vladimir,1,0,34,33
1657101825167,MATH 193A,A04,083782,Rotar; Vladimir,6,0,34,28
1657101825167,MATH 193A,A05,093482,Rotar; Vladimir,6,0,34,28
1657101831194,MATH 197,001,091859,McAuley; Julian John,9999,0,9999,0
1657101831194,MATH 197,002,095566,Kedlaya; Kiran S.,9997,0,9999,2
1657101831194,MATH 197,003,095567,Xiao; Ming,9999,0,9999,0
1657101831194,MATH 197,004,095571,Perols; Johan Lars,9998,0,9999,1
1657101838263,COGS 9,A01,083615,Shannon; Kyle Michael,7,0,75,68
1657101844288,COGS 11,A01,083617,Boyle; Mary E. T.,21,0,48,27
1657101850314,COGS 13,A01,083071,Bastos; Amalia Pinkusfeld,9,0,71,62
1657101856344,COGS 14A,A01,092681,Semenuks; Arturs,1,1,100,99
1657101862373,COGS 14B,A01,083073,Cheng; Tzu-Han,6,0,63,57
1657101868399,COGS 17,A01,092677,Semenuks; Arturs,4,0,81,77
1657101874431,COGS 100,A01,083619,Allen; Michael Gordon,15,0,70,55
1657101880531,COGS 101A,A01,083621,Davis; Joshua Daniel,9,0,68,59
1657101886555,COGS 101B,A01,091572,Allen; Michael Gordon,8,0,65,57
1657101892579,COGS 101C,A01,083625,Delgado; Tania,17,0,35,18
1657101898605,COGS 107A,A01,083627,Boyle; Mary E. T.,13,0,60,47
1657101904628,COGS 118A,A01,083075,Gupta; Anjum,15,0,76,61
1657101910651,CSE 3,A50,083646,Miranda; Gregory Joseph,22,0,50,28
1657101916678,CSE 8A,A50,083650,Miranda; Gregory Joseph,17,1,56,39
1657101922717,CSE 11,A01,083080,Cao; Yingjun,4,15,40,36
1657101928750,CSE 12,A01,083652,Krause-Levy; Sophia Louisa,23,1,120,97
1657101934777,CSE 15L,A01,083654,Morris; Justin Loren,9,0,50,41
1657101934777,CSE 15L,A02,083655,Morris; Justin Loren,9,0,50,41
1657101940801,CSE 20,A01,083657,Tran; Khoa Dang,37,0,80,43
1657101946839,CSE 21,A01,095574,Bach; Quang Tran,21,0,48,27
1657101952870,CSE 30,A01,083084,Eldon; John,4,0,80,76
1657101952870,CSE 30,B01,095061,Bhaskar; Nishant,6,0,50,44
1657101958898,CSE 100,A01,083659,Cao; Yingjun,4,4,70,66
1657101964927,CSE 134B,A01,083661,Powell; Thomas Allan,19,0,100,81
1657101970950,CSE 140,A01,083663,Gungor; Onat,14,0,85,71
1657101976971,CSE 140L,A01,083088,Eldon; John,16,0,100,84
1657101982995,CSE 175,A01,083665,Kumar; Rakesh,3,0,25,22
1657101989021,CSE 190,A00,092507,Dubnov; Shlomo,7,0,20,13
1657101995058,ECE 45,A01,083139,Congero; Spencer William,5,0,75,70
1657102001088,ECE 65,A50,083695,Saad; Andrew S,12,0,30,18
1657102001088,ECE 65,A51,095125,Saad; Andrew S,25,0,26,1
1657102007128,ECE 109,A01,091882,Touri; Behrouz,16,0,70,54
1657102013159,ECE 180,A00,083140,Abi Samra; Nicholas Camill,1,0,30,29
1657102013159,ECE 180,B00,083141,Abi Samra; Nicholas Camill,0,0,30,30
1657102019184,MATH 10A,A01,083735,Patchell; Gregory David,1,0,30,29
1657102019184,MATH 10A,A02,083736,Patchell; Gregory David,20,0,30,10
1657102019184,MATH 10A,A03,083737,Patchell; Gregory David,16,0,30,14
1657102025211,MATH 10B,A01,083207,Lim; Seonhee,7,0,34,27
1657102025211,MATH 10B,A02,083208,Lim; Seonhee,9,0,35,26
1657102025211,MATH 10B,A03,093472,Lim; Seonhee,5,0,34,29
1657102025211,MATH 10B,B01,083739,Sinha; Shubham,9,0,30,21
1657102031244,MATH 18,A01,083743,Cinel; Cameron Alexander,6,0,30,24
1657102031244,MATH 18,A02,083744,Cinel; Cameron Alexander,15,0,30,15
1657102031244,MATH 18,A03,083745,Cinel; Cameron Alexander,8,0,30,22
1657102031244,MATH 18,B01,083748,Rideout; David Porter,4,0,37,33
1657102031244,MATH 18,B02,083749,Rideout; David Porter,3,0,36,33
1657102031244,MATH 18,B03,083750,Rideout; David Porter,2,0,37,35
1657102031244,MATH 18,B04,083751,Rideout; David Porter,5,0,36,31
1657102031244,MATH 18,B05,093473,Rideout; David Porter,4,0,36,32
1657102031244,MATH 18,B06,093474,Rideout; David Porter,5,0,36,31
1657102037267,MATH 20A,A01,083754,Zheng; Zequn,12,0,40,28
1657102043292,MATH 20B,A01,083756,Briones; Jor-el Thomas Caparas,1,0,36,35
1657102043292,MATH 20B,A02,083757,Briones; Jor-el Thomas Caparas,1,0,36,35
1657102043292,MATH 20B,A03,093475,Briones; Jor-el Thomas Caparas,0,0,36,36
1657102049332,MATH 20C,A01,083760,Briones; Jor-el Thomas Caparas,1,0,35,34
1657102049332,MATH 20C,A02,083761,Briones; Jor-el Thomas Caparas,8,0,35,27
1657102049332,MATH 20C,A03,093476,Briones; Jor-el Thomas Caparas,0,1,36,36
1657102049332,MATH 20C,B01,083762,Bach; Quang Tran,0,0,30,30
1657102055363,MATH 20D,A01,083765,Tran; Brian Kha,4,0,30,26
1657102055363,MATH 20D,A02,083766,Tran; Brian Kha,5,0,30,25
1657102055363,MATH 20D,A03,083767,Tran; Brian Kha,3,0,30,27
1657102061389,MATH 20E,A01,083771,Ganguly; Soumya,6,0,32,26
1657102061389,MATH 20E,A02,083772,Ganguly; Soumya,6,0,32,26
1657102061389,MATH 20E,B01,083773,Ciotti; Benjamin,18,0,35,17
1657102061389,MATH 20E,B02,083774,Ciotti; Benjamin,17,0,35,18
1657102067426,MATH 103A,A01,083777,Greenfeld; Be'Eri,2,0,36,34
1657102067426,MATH 103A,A02,083778,Greenfeld; Be'Eri,5,0,36,31
1657102067426,MATH 103A,A03,093561,Greenfeld; Be'Eri,4,0,36,32
1657102067426,MATH 103A,B01,083779,Greenfeld; Be'Eri,6,0,36,30
1657102067426,MATH 103A,B02,083780,Greenfeld; Be'Eri,2,0,36,34
1657102067426,MATH 103A,B03,093562,Greenfeld; Be'Eri,3,0,36,33
1657102073451,MATH 105,A01,085443,Carter; Anne Toulson,14,0,35,21
1657102073451,MATH 105,A02,093477,Carter; Anne Toulson,20,0,35,15
1657102079477,MATH 109,A01,083213,Ganzberger; Geoffrey Michael,2,0,34,32
1657102079477,MATH 109,A02,083214,Ganzberger; Geoffrey Michael,3,0,34,31
1657102079477,MATH 109,A03,093478,Ganzberger; Geoffrey Michael,1,0,34,33
1657102079477,MATH 109,B01,083215,Ganzberger; Geoffrey Michael,1,0,32,31
1657102079477,MATH 109,B02,083216,Ganzberger; Geoffrey Michael,1,0,32,31
1657102079477,MATH 109,B03,093479,Ganzberger; Geoffrey Michael,6,0,32,26
1657102085511,MATH 142A,A01,083219,Chow; Bennett,6,0,32,26
1657102085511,MATH 142A,A02,083220,Chow; Bennett,10,0,32,22
1657102085511,MATH 142A,A03,093480,Chow; Bennett,7,0,32,25
1657102085511,MATH 142A,B03,093481,Chow; Bennett,8,0,32,24
1657102085511,MATH 142A,B04,093558,Chow; Bennett,11,0,32,21
1657102085511,MATH 142A,B05,093559,Chow; Bennett,6,0,32,26
1657102091544,MATH 193A,A01,083224,Rotar; Vladimir,7,0,34,27
1657102091544,MATH 193A,A02,083225,Rotar; Vladimir,5,0,34,29
1657102091544,MATH 193A,A03,083781,Rotar; Vladimir,1,0,34,33
1657102091544,MATH 193A,A04,083782,Rotar; Vladimir,6,0,34,28
1657102091544,MATH 193A,A05,093482,Rotar; Vladimir,6,0,34,28
1657102097574,MATH 197,001,091859,McAuley; Julian John,9999,0,9999,0
1657102097574,MATH 197,002,095566,Kedlaya; Kiran S.,9997,0,9999,2
1657102097574,MATH 197,003,095567,Xiao; Ming,9999,0,9999,0
1657102097574,MATH 197,004,095571,Perols; Johan Lars,9998,0,9999,1
1657102104663,COGS 9,A01,083615,Shannon; Kyle Michael,7,0,75,68
1657102110693,COGS 11,A01,083617,Boyle; Mary E. T.,21,0,48,27
1657102116723,COGS 13,A01,083071,Bastos; Amalia Pinkusfeld,9,0,71,62
1657102122749,COGS 14A,A01,092681,Semenuks; Arturs,1,1,100,99
1657102128772,COGS 14B,A01,083073,Cheng; Tzu-Han,6,0,63,57
1657102134796,COGS 17,A01,092677,Semenuks; Arturs,4,0,81,77
1657102140821,COGS 100,A01,083619,Allen; Michael Gordon,15,0,70,55
1657102146847,COGS 101A,A01,083621,Davis; Joshua Daniel,9,0,68,59
1657102152874,COGS 101B,A01,091572,Allen; Michael Gordon,8,0,65,57
1657102158905,COGS 101C,A01,083625,Delgado; Tania,17,0,35,18
1657102164928,COGS 107A,A01,083627,Boyle; Mary E. T.,13,0,60,47
1657102170955,COGS 118A,A01,083075,Gupta; Anjum,15,0,76,61
1657102176980,CSE 3,A50,083646,Miranda; Gregory Joseph,22,0,50,28
1657102183007,CSE 8A,A50,083650,Miranda; Gregory Joseph,17,1,56,39
1657102189030,CSE 11,A01,083080,Cao; Yingjun,4,15,40,36
1657102195054,CSE 12,A01,083652,Krause-Levy; Sophia Louisa,23,1,120,97
1657102201078,CSE 15L,A01,083654,Morris; Justin Loren,9,0,50,41
1657102201078,CSE 15L,A02,083655,Morris; Justin Loren,9,0,50,41
1657102207107,CSE 20,A01,083657,Tran; Khoa Dang,37,0,80,43
1657102213134,CSE 21,A01,095574,Bach; Quang Tran,21,0,48,27
1657102219156,CSE 30,A01,083084,Eldon; John,4,0,80,76
1657102219156,CSE 30,B01,095061,Bhaskar; Nishant,6,0,50,44
1657102225183,CSE 100,A01,083659,Cao; Yingjun,4,4,70,66
1657102231227,CSE 134B,A01,083661,Powell; Thomas Allan,19,0,100,81
1657102237254,CSE 140,A01,083663,Gungor; Onat,14,0,85,71
1657102243278,CSE 140L,A01,083088,Eldon; John,16,0,100,84
1657102249301,CSE 175,A01,083665,Kumar; Rakesh,3,0,25,22
1657102255329,CSE 190,A00,092507,Dubnov; Shlomo,7,0,20,13
1657102261351,ECE 45,A01,083139,Congero; Spencer William,5,0,75,70
1657102267374,ECE 65,A50,083695,Saad; Andrew S,12,0,30,18
1657102267374,ECE 65,A51,095125,Saad; Andrew S,25,0,26,1
1657102273398,ECE 109,A01,091882,Touri; Behrouz,16,0,70,54
1657102279427,ECE 180,A00,083140,Abi Samra; Nicholas Camill,1,0,30,29
1657102279427,ECE 180,B00,083141,Abi Samra; Nicholas Camill,0,0,30,30
1657102285449,MATH 10A,A01,083735,Patchell; Gregory David,1,0,30,29
1657102285449,MATH 10A,A02,083736,Patchell; Gregory David,20,0,30,10
1657102285449,MATH 10A,A03,083737,Patchell; Gregory David,16,0,30,14
1657102291479,MATH 10B,A01,083207,Lim; Seonhee,7,0,34,27
1657102291479,MATH 10B,A02,083208,Lim; Seonhee,9,0,35,26
1657102291479,MATH 10B,A03,093472,Lim; Seonhee,5,0,34,29
1657102291479,MATH 10B,B01,083739,Sinha; Shubham,9,0,30,21
1657102297504,MATH 18,A01,083743,Cinel; Cameron Alexander,6,0,30,24
1657102297504,MATH 18,A02,083744,Cinel; Cameron Alexander,15,0,30,15
1657102297504,MATH 18,A03,083745,Cinel; Cameron Alexander,8,0,30,22
1657102297504,MATH 18,B01,083748,Rideout; David Porter,4,0,37,33
1657102297504,MATH 18,B02,083749,Rideout; David Porter,3,0,36,33
1657102297504,MATH 18,B03,083750,Rideout; David Porter,2,0,37,35
1657102297504,MATH 18,B04,083751,Rideout; David Porter,5,0,36,31
1657102297504,MATH 18,B05,093473,Rideout; David Porter,4,0,36,32
1657102297504,MATH 18,B06,093474,Rideout; David Porter,5,0,36,31
1657102303527,MATH 20A,A01,083754,Zheng; Zequn,12,0,40,28
1657102309552,MATH 20B,A01,083756,Briones; Jor-el Thomas Caparas,1,0,36,35
1657102309552,MATH 20B,A02,083757,Briones; Jor-el Thomas Caparas,1,0,36,35
1657102309552,MATH 20B,A03,093475,Briones; Jor-el Thomas Caparas,0,0,36,36
1657102315580,MATH 20C,A01,083760,Briones; Jor-el Thomas Caparas,1,0,35,34
1657102315580,MATH 20C,A02,083761,Briones; Jor-el Thomas Caparas,8,0,35,27
1657102315580,MATH 20C,A03,093476,Briones; Jor-el Thomas Caparas,0,1,36,36
1657102315580,MATH 20C,B01,083762,Bach; Quang Tran,0,0,30,30
1657102321607,MATH 20D,A01,083765,Tran; Brian Kha,4,0,30,26
1657102321607,MATH 20D,A02,083766,Tran; Brian Kha,5,0,30,25
1657102321607,MATH 20D,A03,083767,Tran; Brian Kha,3,0,30,27
1657102327635,MATH 20E,A01,083771,Ganguly; Soumya,6,0,32,26
1657102327635,MATH 20E,A02,083772,Ganguly; Soumya,6,0,32,26
1657102327635,MATH 20E,B01,083773,Ciotti; Benjamin,18,0,35,17
1657102327635,MATH 20E,B02,083774,Ciotti; Benjamin,17,0,35,18
1657102333665,MATH 103A,A01,083777,Greenfeld; Be'Eri,2,0,36,34
1657102333665,MATH 103A,A02,083778,Greenfeld; Be'Eri,5,0,36,31
1657102333665,MATH 103A,A03,093561,Greenfeld; Be'Eri,4,0,36,32
1657102333665,MATH 103A,B01,083779,Greenfeld; Be'Eri,6,0,36,30
1657102333665,MATH 103A,B02,083780,Greenfeld; Be'Eri,2,0,36,34
1657102333665,MATH 103A,B03,093562,Greenfeld; Be'Eri,3,0,36,33
1657102339693,MATH 105,A01,085443,Carter; Anne Toulson,14,0,35,21
1657102339693,MATH 105,A02,093477,Carter; Anne Toulson,20,0,35,15
1657102345723,MATH 109,A01,083213,Ganzberger; Geoffrey Michael,2,0,34,32
1657102345723,MATH 109,A02,083214,Ganzberger; Geoffrey Michael,3,0,34,31
1657102345723,MATH 109,A03,093478,Ganzberger; Geoffrey Michael,1,0,34,33
1657102345723,MATH 109,B01,083215,Ganzberger; Geoffrey Michael,1,0,32,31
1657102345723,MATH 109,B02,083216,Ganzberger; Geoffrey Michael,1,0,32,31
1657102345723,MATH 109,B03,093479,Ganzberger; Geoffrey Michael,6,0,32,26
1657102351745,MATH 142A,A01,083219,Chow; Bennett,6,0,32,26
1657102351745,MATH 142A,A02,083220,Chow; Bennett,10,0,32,22
1657102351745,MATH 142A,A03,093480,Chow; Bennett,7,0,32,25
1657102351745,MATH 142A,B03,093481,Chow; Bennett,8,0,32,24
1657102351745,MATH 142A,B04,093558,Chow; Bennett,11,0,32,21
1657102351745,MATH 142A,B05,093559,Chow; Bennett,6,0,32,26
1657102357773,MATH 193A,A01,083224,Rotar; Vladimir,7,0,34,27
1657102357773,MATH 193A,A02,083225,Rotar; Vladimir,5,0,34,29
1657102357773,MATH 193A,A03,083781,Rotar; Vladimir,1,0,34,33
1657102357773,MATH 193A,A04,083782,Rotar; Vladimir,6,0,34,28
1657102357773,MATH 193A,A05,093482,Rotar; Vladimir,6,0,34,28
1657102363796,MATH 197,001,091859,McAuley; Julian John,9999,0,9999,0
1657102363796,MATH 197,002,095566,Kedlaya; Kiran S.,9997,0,9999,2
1657102363796,MATH 197,003,095567,Xiao; Ming,9999,0,9999,0
1657102363796,MATH 197,004,095571,Perols; Johan Lars,9998,0,9999,1
1657102370864,COGS 9,A01,083615,Shannon; Kyle Michael,7,0,75,68
1657102376889,COGS 11,A01,083617,Boyle; Mary E. T.,21,0,48,27
1657102382918,COGS 13,A01,083071,Bastos; Amalia Pinkusfeld,9,0,71,62
1657102388945,COGS 14A,A01,092681,Semenuks; Arturs,1,1,100,99
1657102394972,COGS 14B,A01,083073,Cheng; Tzu-Han,6,0,63,57
1657102401001,COGS 17,A01,092677,Semenuks; Arturs,4,0,81,77
1657102407027,COGS 100,A01,083619,Allen; Michael Gordon,15,0,70,55
1657102413052,COGS 101A,A01,083621,Davis; Joshua Daniel,9,0,68,59
1657102419081,COGS 101B,A01,091572,Allen; Michael Gordon,8,0,65,57
1657102425104,COGS 101C,A01,083625,Delgado; Tania,17,0,35,18
1657102431130,COGS 107A,A01,083627,Boyle; Mary E. T.,13,0,60,47
1657102437159,COGS 118A,A01,083075,Gupta; Anjum,15,0,76,61
1657102443189,CSE 3,A50,083646,Miranda; Gregory Joseph,22,0,50,28
1657102449215,CSE 8A,A50,083650,Miranda; Gregory Joseph,17,1,56,39
1657102455242,CSE 11,A01,083080,Cao; Yingjun,4,15,40,36
1657102461266,CSE 12,A01,083652,Krause-Levy; Sophia Louisa,23,1,120,97
1657102467291,CSE 15L,A01,083654,Morris; Justin Loren,9,0,50,41
1657102467291,CSE 15L,A02,083655,Morris; Justin Loren,9,0,50,41
1657102473326,CSE 20,A01,083657,Tran; Khoa Dang,37,0,80,43
1657102479428,CSE 21,A01,095574,Bach; Quang Tran,21,0,48,27
1657102485468,CSE 30,A01,083084,Eldon; John,4,0,80,76
1657102485468,CSE 30,B01,095061,Bhaskar; Nishant,6,0,50,44
1657102491498,CSE 100,A01,083659,Cao; Yingjun,4,4,70,66
1657102497521,CSE 134B,A01,083661,Powell; Thomas Allan,19,0,100,81
1657102503545,CSE 140,A01,083663,Gungor; Onat,14,0,85,71
1657102509569,CSE 140L,A01,083088,Eldon; John,16,0,100,84
1657102515599,CSE 175,A01,083665,Kumar; Rakesh,3,0,25,22
1657102521627,CSE 190,A00,092507,Dubnov; Shlomo,7,0,20,13
1657102527666,ECE 45,A01,083139,Congero; Spencer William,5,0,75,70
1657102533691,ECE 65,A50,083695,Saad; Andrew S,12,0,30,18
1657102533691,ECE 65,A51,095125,Saad; Andrew S,25,0,26,1
1657102539718,ECE 109,A01,091882,Touri; Behrouz,16,0,70,54
1657102545743,ECE 180,A00,083140,Abi Samra; Nicholas Camill,1,0,30,29
1657102545743,ECE 180,B00,083141,Abi Samra; Nicholas Camill,0,0,30,30
1657102551774,MATH 10A,A01,083735,Patchell; Gregory David,1,0,30,29
1657102551774,MATH 10A,A02,083736,Patchell; Gregory David,20,0,30,10
1657102551774,MATH 10A,A03,083737,Patchell; Gregory David,16,0,30,14
1657102557800,MATH 10B,A01,083207,Lim; Seonhee,7,0,34,27
1657102557800,MATH 10B,A02,083208,Lim; Seonhee,9,0,35,26
1657102557800,MATH 10B,A03,093472,Lim; Seonhee,5,0,34,29
1657102557800,MATH 10B,B01,083739,Sinha; Shubham,9,0,30,21
1657102563836,MATH 18,A01,083743,Cinel; Cameron Alexander,6,0,30,24
1657102563836,MATH 18,A02,083744,Cinel; Cameron Alexander,15,0,30,15
1657102563836,MATH 18,A03,083745,Cinel; Cameron Alexander,8,0,30,22
1657102563836,MATH 18,B01,083748,Rideout; David Porter,4,0,37,33
1657102563836,MATH 18,B02,083749,Rideout; David Porter,3,0,36,33
1657102563836,MATH 18,B03,083750,Rideout; David Porter,2,0,37,35
1657102563836,MATH 18,B04,083751,Rideout; David Porter,5,0,36,31
1657102563836,MATH 18,B05,093473,Rideout; David Porter,4,0,36,32
1657102563836,MATH 18,B06,093474,Rideout; David Porter,5,0,36,31
1657102569859,MATH 20A,A01,083754,Zheng; Zequn,12,0,40,28
1657102575891,MATH 20B,A01,083756,Briones; Jor-el Thomas Caparas,1,0,36,35
1657102575891,MATH 20B,A02,083757,Briones; Jor-el Thomas Caparas,1,0,36,35
1657102575891,MATH 20B,A03,093475,Briones; Jor-el Thomas Caparas,0,0,36,36
1657102581920,MATH 20C,A01,083760,Briones; Jor-el Thomas Caparas,1,0,35,34
1657102581920,MATH 20C,A02,083761,Briones; Jor-el Thomas Caparas,8,0,35,27
1657102581920,MATH 20C,A03,093476,Briones; Jor-el Thomas Caparas,0,1,36,36
1657102581920,MATH 20C,B01,083762,Bach; Quang Tran,0,0,30,30
1657102587943,MATH 20D,A01,083765,Tran; Brian Kha,4,0,30,26
1657102587943,MATH 20D,A02,083766,Tran; Brian Kha,5,0,30,25
1657102587943,MATH 20D,A03,083767,Tran; Brian Kha,3,0,30,27
1657102593977,MATH 20E,A01,083771,Ganguly; Soumya,6,0,32,26
1657102593977,MATH 20E,A02,083772,Ganguly; Soumya,6,0,32,26
1657102593977,MATH 20E,B01,083773,Ciotti; Benjamin,18,0,35,17
1657102593977,MATH 20E,B02,083774,Ciotti; Benjamin,17,0,35,18
1657102600005,MATH 103A,A01,083777,Greenfeld; Be'Eri,2,0,36,34
1657102600005,MATH 103A,A02,083778,Greenfeld; Be'Eri,5,0,36,31
1657102600005,MATH 103A,A03,093561,Greenfeld; Be'Eri,4,0,36,32
1657102600005,MATH 103A,B01,083779,Greenfeld; Be'Eri,6,0,36,30
1657102600005,MATH 103A,B02,083780,Greenfeld; Be'Eri,2,0,36,34
1657102600005,MATH 103A,B03,093562,Greenfeld; Be'Eri,3,0,36,33
1657102606029,MATH 105,A01,085443,Carter; Anne Toulson,14,0,35,21
1657102606029,MATH 105,A02,093477,Carter; Anne Toulson,20,0,35,15
1657102612052,MATH 109,A01,083213,Ganzberger; Geoffrey Michael,2,0,34,32
1657102612052,MATH 109,A02,083214,Ganzberger; Geoffrey Michael,3,0,34,31
1657102612052,MATH 109,A03,093478,Ganzberger; Geoffrey Michael,1,0,34,33
1657102612052,MATH 109,B01,083215,Ganzberger; Geoffrey Michael,1,0,32,31
1657102612052,MATH 109,B02,083216,Ganzberger; Geoffrey Michael,1,0,32,31
1657102612052,MATH 109,B03,093479,Ganzberger; Geoffrey Michael,6,0,32,26
1657102618090,MATH 142A,A01,083219,Chow; Bennett,6,0,32,26
1657102618090,MATH 142A,A02,083220,Chow; Bennett,10,0,32,22
1657102618090,MATH 142A,A03,093480,Chow; Bennett,7,0,32,25
1657102618090,MATH 142A,B03,093481,Chow; Bennett,8,0,32,24
1657102618090,MATH 142A,B04,093558,Chow; Bennett,11,0,32,21
1657102618090,MATH 142A,B05,093559,Chow; Bennett,6,0,32,26
1657102624113,MATH 193A,A01,083224,Rotar; Vladimir,7,0,34,27
1657102624113,MATH 193A,A02,083225,Rotar; Vladimir,5,0,34,29
1657102624113,MATH 193A,A03,083781,Rotar; Vladimir,1,0,34,33
1657102624113,MATH 193A,A04,083782,Rotar; Vladimir,6,0,34,28
1657102624113,MATH 193A,A05,093482,Rotar; Vladimir,6,0,34,28
1657102630138,MATH 197,001,091859,McAuley; Julian John,9999,0,9999,0
1657102630138,MATH 197,002,095566,Kedlaya; Kiran S.,9997,0,9999,2
1657102630138,MATH 197,003,095567,Xiao; Ming,9999,0,9999,0
1657102630138,MATH 197,004,095571,Perols; Johan Lars,9998,0,9999,1
1657102637221,COGS 9,A01,083615,Shannon; Kyle Michael,7,0,75,68
1657102643244,COGS 11,A01,083617,Boyle; Mary E. T.,21,0,48,27
1657102649268,COGS 13,A01,083071,Bastos; Amalia Pinkusfeld,9,0,71,62
1657102655293,COGS 14A,A01,092681,Semenuks; Arturs,1,1,100,99
1657102661321,COGS 14B,A01,083073,Cheng; Tzu-Han,6,0,63,57
1657102667348,COGS 17,A01,092677,Semenuks; Arturs,4,0,81,77
1657102673377,COGS 100,A01,083619,Allen; Michael Gordon,15,0,70,55
1657102679408,COGS 101A,A01,083621,Davis; Joshua Daniel,9,0,68,59
1657102685431,COGS 101B,A01,091572,Allen; Michael Gordon,8,0,65,57
1657102691454,COGS 101C,A01,083625,Delgado; Tania,17,0,35,18
1657102697482,COGS 107A,A01,083627,Boyle; Mary E. T.,13,0,60,47
1657102703507,COGS 118A,A01,083075,Gupta; Anjum,15,0,76,61
1657102709532,CSE 3,A50,083646,Miranda; Gregory Joseph,22,0,50,28
1657102715561,CSE 8A,A50,083650,Miranda; Gregory Joseph,17,1,56,39
1657102721583,CSE 11,A01,083080,Cao; Yingjun,4,15,40,36
1657102727610,CSE 12,A01,083652,Krause-Levy; Sophia Louisa,23,1,120,97
1657102733634,CSE 15L,A01,083654,Morris; Justin Loren,9,0,50,41
1657102733634,CSE 15L,A02,083655,Morris; Justin Loren,9,0,50,41
1657102739658,CSE 20,A01,083657,Tran; Khoa Dang,37,0,80,43
1657102745681,CSE 21,A01,095574,Bach; Quang Tran,21,0,48,27
1657102751704,CSE 30,A01,083084,Eldon; John,4,0,80,76
1657102751704,CSE 30,B01,095061,Bhaskar; Nishant,6,0,50,44
1657102757731,CSE 100,A01,083659,Cao; Yingjun,4,4,70,66
1657102763755,CSE 134B,A01,083661,Powell; Thomas Allan,19,0,100,81
1657102769783,CSE 140,A01,083663,Gungor; Onat,14,0,85,71
1657102775810,CSE 140L,A01,083088,Eldon; John,16,0,100,84
1657102781837,CSE 175,A01,083665,Kumar; Rakesh,3,0,25,22
1657102787861,CSE 190,A00,092507,Dubnov; Shlomo,7,0,20,13
1657102793885,ECE 45,A01,083139,Congero; Spencer William,5,0,75,70
1657102799915,ECE 65,A50,083695,Saad; Andrew S,12,0,30,18
1657102799915,ECE 65,A51,095125,Saad; Andrew S,25,0,26,1
1657102805939,ECE 109,A01,091882,Touri; Behrouz,16,0,70,54
1657102811962,ECE 180,A00,083140,Abi Samra; Nicholas Camill,1,0,30,29
1657102811962,ECE 180,B00,083141,Abi Samra; Nicholas Camill,0,0,30,30
1657102817987,MATH 10A,A01,083735,Patchell; Gregory David,1,0,30,29
1657102817987,MATH 10A,A02,083736,Patchell; Gregory David,20,0,30,10
1657102817987,MATH 10A,A03,083737,Patchell; Gregory David,16,0,30,14
1657102824010,MATH 10B,A01,083207,Lim; Seonhee,7,0,34,27
1657102824010,MATH 10B,A02,083208,Lim; Seonhee,9,0,35,26
1657102824010,MATH 10B,A03,093472,Lim; Seonhee,5,0,34,29
1657102824010,MATH 10B,B01,083739,Sinha; Shubham,9,0,30,21
1657102830035,MATH 18,A01,083743,Cinel; Cameron Alexander,6,0,30,24
1657102830035,MATH 18,A02,083744,Cinel; Cameron Alexander,15,0,30,15
1657102830035,MATH 18,A03,083745,Cinel; Cameron Alexander,8,0,30,22
1657102830035,MATH 18,B01,083748,Rideout; David Porter,4,0,37,33
1657102830035,MATH 18,B02,083749,Rideout; David Porter,3,0,36,33
1657102830035,MATH 18,B03,083750,Rideout; David Porter,2,0,37,35
1657102830035,MATH 18,B04,083751,Rideout; David Porter,5,0,36,31
1657102830035,MATH 18,B05,093473,Rideout; David Porter,4,0,36,32
1657102830035,MATH 18,B06,093474,Rideout; David Porter,5,0,36,31
1657102836065,MATH 20A,A01,083754,Zheng; Zequn,12,0,40,28
1657102842088,MATH 20B,A01,083756,Briones; Jor-el Thomas Caparas,1,0,36,35
1657102842088,MATH 20B,A02,083757,Briones; Jor-el Thomas Caparas,1,0,36,35
1657102842088,MATH 20B,A03,093475,Briones; Jor-el Thomas Caparas,0,0,36,36
1657102848111,MATH 20C,A01,083760,Briones; Jor-el Thomas Caparas,1,0,35,34
1657102848111,MATH 20C,A02,083761,Briones; Jor-el Thomas Caparas,8,0,35,27
1657102848111,MATH 20C,A03,093476,Briones; Jor-el Thomas Caparas,0,1,36,36
1657102848111,MATH 20C,B01,083762,Bach; Quang Tran,0,0,30,30
1657102854142,MATH 20D,A01,083765,Tran; Brian Kha,4,0,30,26
1657102854142,MATH 20D,A02,083766,Tran; Brian Kha,5,0,30,25
1657102854142,MATH 20D,A03,083767,Tran; Brian Kha,3,0,30,27
1657102860173,MATH 20E,A01,083771,Ganguly; Soumya,6,0,32,26
1657102860173,MATH 20E,A02,083772,Ganguly; Soumya,6,0,32,26
1657102860173,MATH 20E,B01,083773,Ciotti; Benjamin,18,0,35,17
1657102860173,MATH 20E,B02,083774,Ciotti; Benjamin,17,0,35,18
1657102866207,MATH 103A,A01,083777,Greenfeld; Be'Eri,2,0,36,34
1657102866207,MATH 103A,A02,083778,Greenfeld; Be'Eri,5,0,36,31
1657102866207,MATH 103A,A03,093561,Greenfeld; Be'Eri,4,0,36,32
1657102866207,MATH 103A,B01,083779,Greenfeld; Be'Eri,6,0,36,30
1657102866207,MATH 103A,B02,083780,Greenfeld; Be'Eri,2,0,36,34
1657102866207,MATH 103A,B03,093562,Greenfeld; Be'Eri,3,0,36,33
1657102872233,MATH 105,A01,085443,Carter; Anne Toulson,14,0,35,21
1657102872233,MATH 105,A02,093477,Carter; Anne Toulson,20,0,35,15
1657102878257,MATH 109,A01,083213,Ganzberger; Geoffrey Michael,2,0,34,32
1657102878257,MATH 109,A02,083214,Ganzberger; Geoffrey Michael,3,0,34,31
1657102878257,MATH 109,A03,093478,Ganzberger; Geoffrey Michael,1,0,34,33
1657102878257,MATH 109,B01,083215,Ganzberger; Geoffrey Michael,1,0,32,31
1657102878257,MATH 109,B02,083216,Ganzberger; Geoffrey Michael,1,0,32,31
1657102878257,MATH 109,B03,093479,Ganzberger; Geoffrey Michael,6,0,32,26
1657102884282,MATH 142A,A01,083219,Chow; Bennett,6,0,32,26
1657102884282,MATH 142A,A02,083220,Chow; Bennett,10,0,32,22
1657102884282,MATH 142A,A03,093480,Chow; Bennett,7,0,32,25
1657102884282,MATH 142A,B03,093481,Chow; Bennett,8,0,32,24
1657102884282,MATH 142A,B04,093558,Chow; Bennett,11,0,32,21
1657102884282,MATH 142A,B05,093559,Chow; Bennett,6,0,32,26
1657102890307,MATH 193A,A01,083224,Rotar; Vladimir,7,0,34,27
1657102890307,MATH 193A,A02,083225,Rotar; Vladimir,5,0,34,29
1657102890307,MATH 193A,A03,083781,Rotar; Vladimir,1,0,34,33
1657102890307,MATH 193A,A04,083782,Rotar; Vladimir,6,0,34,28
1657102890307,MATH 193A,A05,093482,Rotar; Vladimir,6,0,34,28
1657102896333,MATH 197,001,091859,McAuley; Julian John,9999,0,9999,0
1657102896333,MATH 197,002,095566,Kedlaya; Kiran S.,9997,0,9999,2
1657102896333,MATH 197,003,095567,Xiao; Ming,9999,0,9999,0
1657102896333,MATH 197,004,095571,Perols; Johan Lars,9998,0,9999,1
1657102903400,COGS 9,A01,083615,Shannon; Kyle Michael,7,0,75,68
1657102909428,COGS 11,A01,083617,Boyle; Mary E. T.,21,0,48,27
1657102915452,COGS 13,A01,083071,Bastos; Amalia Pinkusfeld,9,0,71,62
1657102921481,COGS 14A,A01,092681,Semenuks; Arturs,1,1,100,99
1657102927504,COGS 14B,A01,083073,Cheng; Tzu-Han,6,0,63,57
1657102933526,COGS 17,A01,092677,Semenuks; Arturs,4,0,81,77
1657102939572,COGS 100,A01,083619,Allen; Michael Gordon,15,0,70,55
1657102945595,COGS 101A,A01,083621,Davis; Joshua Daniel,9,0,68,59
1657102951621,COGS 101B,A01,091572,Allen; Michael Gordon,8,0,65,57
1657102957648,COGS 101C,A01,083625,Delgado; Tania,17,0,35,18
1657102963671,COGS 107A,A01,083627,Boyle; Mary E. T.,13,0,60,47
1657102969693,COGS 118A,A01,083075,Gupta; Anjum,15,0,76,61
1657102975715,CSE 3,A50,083646,Miranda; Gregory Joseph,22,0,50,28
1657102981741,CSE 8A,A50,083650,Miranda; Gregory Joseph,17,1,56,39
1657102987767,CSE 11,A01,083080,Cao; Yingjun,4,15,40,36
1657102993790,CSE 12,A01,083652,Krause-Levy; Sophia Louisa,23,1,120,97
1657102999816,CSE 15L,A01,083654,Morris; Justin Loren,9,0,50,41
1657102999816,CSE 15L,A02,083655,Morris; Justin Loren,9,0,50,41
1657103005838,CSE 20,A01,083657,Tran; Khoa Dang,37,0,80,43
1657103011865,CSE 21,A01,095574,Bach; Quang Tran,21,0,48,27
1657103017891,CSE 30,A01,083084,Eldon; John,4,0,80,76
1657103017891,CSE 30,B01,095061,Bhaskar; Nishant,6,0,50,44
1657103023915,CSE 100,A01,083659,Cao; Yingjun,4,4,70,66
1657103029938,CSE 134B,A01,083661,Powell; Thomas Allan,19,0,100,81
1657103035961,CSE 140,A01,083663,Gungor; Onat,14,0,85,71
1657103041988,CSE 140L,A01,083088,Eldon; John,16,0,100,84
1657103048014,CSE 175,A01,083665,Kumar; Rakesh,3,0,25,22
1657103054042,CSE 190,A00,092507,Dubnov; Shlomo,7,0,20,13
1657103060067,ECE 45,A01,083139,Congero; Spencer William,5,0,75,70
1657103066096,ECE 65,A50,083695,Saad; Andrew S,12,0,30,18
1657103066096,ECE 65,A51,095125,Saad; Andrew S,25,0,26,1
1657103072119,ECE 109,A01,091882,Touri; Behrouz,16,0,70,54
1657103078220,ECE 180,A00,083140,Abi Samra; Nicholas Camill,1,0,30,29
1657103078220,ECE 180,B00,083141,Abi Samra; Nicholas Camill,0,0,30,30
1657103084246,MATH 10A,A01,083735,Patchell; Gregory David,1,0,30,29
1657103084246,MATH 10A,A02,083736,Patchell; Gregory David,20,0,30,10
1657103084246,MATH 10A,A03,083737,Patchell; Gregory David,16,0,30,14
1657103090270,MATH 10B,A01,083207,Lim; Seonhee,7,0,34,27
1657103090270,MATH 10B,A02,083208,Lim; Seonhee,9,0,35,26
1657103090270,MATH 10B,A03,093472,Lim; Seonhee,5,0,34,29
1657103090270,MATH 10B,B01,083739,Sinha; Shubham,9,0,30,21
1657103096302,MATH 18,A01,083743,Cinel; Cameron Alexander,6,0,30,24
1657103096302,MATH 18,A02,083744,Cinel; Cameron Alexander,15,0,30,15
1657103096302,MATH 18,A03,083745,Cinel; Cameron Alexander,8,0,30,22
1657103096302,MATH 18,B01,083748,Rideout; David Porter,4,0,37,33
1657103096302,MATH 18,B02,083749,Rideout; David Porter,3,0,36,33
1657103096302,MATH 18,B03,083750,Rideout; David Porter,2,0,37,35
1657103096302,MATH 18,B04,083751,Rideout; David Porter,5,0,36,31
1657103096302,MATH 18,B05,093473,Rideout; David Porter,4,0,36,32
1657103096302,MATH 18,B06,093474,Rideout; David Porter,5,0,36,31
1657103102327,MATH 20A,A01,083754,Zheng; Zequn,12,0,40,28
1657103108365,MATH 20B,A01,083756,Briones; Jor-el Thomas Caparas,1,0,36,35
1657103108365,MATH 20B,A02,083757,Briones; Jor-el Thomas Caparas,1,0,36,35
1657103108365,MATH 20B,A03,093475,Briones; Jor-el Thomas Caparas,0,0,36,36
1657103114390,MATH 20C,A01,083760,Briones; Jor-el Thomas Caparas,1,0,35,34
1657103114390,MATH 20C,A02,083761,Briones; Jor-el Thomas Caparas,8,0,35,27
1657103114390,MATH 20C,A03,093476,Briones; Jor-el Thomas Caparas,0,1,36,36
1657103114390,MATH 20C,B01,083762,Bach; Quang Tran,0,0,30,30
1657103120416,MATH 20D,A01,083765,Tran; Brian Kha,4,0,30,26
1657103120416,MATH 20D,A02,083766,Tran; Brian Kha,5,0,30,25
1657103120416,MATH 20D,A03,083767,Tran; Brian Kha,3,0,30,27
1657103126451,MATH 20E,A01,083771,Ganguly; Soumya,6,0,32,26
1657103126451,MATH 20E,A02,083772,Ganguly; Soumya,6,0,32,26
1657103126451,MATH 20E,B01,083773,Ciotti; Benjamin,18,0,35,17
1657103126451,MATH 20E,B02,083774,Ciotti; Benjamin,17,0,35,18
1657103132482,MATH 103A,A01,083777,Greenfeld; Be'Eri,2,0,36,34
1657103132482,MATH 103A,A02,083778,Greenfeld; Be'Eri,5,0,36,31
1657103132482,MATH 103A,A03,093561,Greenfeld; Be'Eri,4,0,36,32
1657103132482,MATH 103A,B01,083779,Greenfeld; Be'Eri,6,0,36,30
1657103132482,MATH 103A,B02,083780,Greenfeld; Be'Eri,2,0,36,34
1657103132482,MATH 103A,B03,093562,Greenfeld; Be'Eri,3,0,36,33
1657103138506,MATH 105,A01,085443,Carter; Anne Toulson,14,0,35,21
1657103138506,MATH 105,A02,093477,Carter; Anne Toulson,20,0,35,15
1657103144533,MATH 109,A01,083213,Ganzberger; Geoffrey Michael,2,0,34,32
1657103144533,MATH 109,A02,083214,Ganzberger; Geoffrey Michael,3,0,34,31
1657103144533,MATH 109,A03,093478,Ganzberger; Geoffrey Michael,1,0,34,33
1657103144533,MATH 109,B01,083215,Ganzberger; Geoffrey Michael,1,0,32,31
1657103144533,MATH 109,B02,083216,Ganzberger; Geoffrey Michael,1,0,32,31
1657103144533,MATH 109,B03,093479,Ganzberger; Geoffrey Michael,6,0,32,26
1657103150567,MATH 142A,A01,083219,Chow; Bennett,6,0,32,26
1657103150567,MATH 142A,A02,083220,Chow; Bennett,10,0,32,22
1657103150567,MATH 142A,A03,093480,Chow; Bennett,7,0,32,25
1657103150567,MATH 142A,B03,093481,Chow; Bennett,8,0,32,24
1657103150567,MATH 142A,B04,093558,Chow; Bennett,11,0,32,21
1657103150567,MATH 142A,B05,093559,Chow; Bennett,6,0,32,26
1657103156596,MATH 193A,A01,083224,Rotar; Vladimir,7,0,34,27
1657103156596,MATH 193A,A02,083225,Rotar; Vladimir,5,0,34,29
1657103156596,MATH 193A,A03,083781,Rotar; Vladimir,1,0,34,33
1657103156596,MATH 193A,A04,083782,Rotar; Vladimir,6,0,34,28
1657103156596,MATH 193A,A05,093482,Rotar; Vladimir,6,0,34,28
1657103162619,MATH 197,001,091859,McAuley; Julian John,9999,0,9999,0
1657103162619,MATH 197,002,095566,Kedlaya; Kiran S.,9997,0,9999,2
1657103162619,MATH 197,003,095567,Xiao; Ming,9999,0,9999,0
1657103162619,MATH 197,004,095571,Perols; Johan Lars,9998,0,9999,1
1657103169700,COGS 9,A01,083615,Shannon; Kyle Michael,7,0,75,68
1657103175727,COGS 11,A01,083617,Boyle; Mary E. T.,21,0,48,27
1657103181751,COGS 13,A01,083071,Bastos; Amalia Pinkusfeld,9,0,71,62
1657103187776,COGS 14A,A01,092681,Semenuks; Arturs,1,1,100,99
1657103193801,COGS 14B,A01,083073,Cheng; Tzu-Han,6,0,63,57
1657103199828,COGS 17,A01,092677,Semenuks; Arturs,4,0,81,77
1657103205852,COGS 100,A01,083619,Allen; Michael Gordon,15,0,70,55
1657103211875,COGS 101A,A01,083621,Davis; Joshua Daniel,9,0,68,59
1657103217899,COGS 101B,A01,091572,Allen; Michael Gordon,8,0,65,57
1657103223925,COGS 101C,A01,083625,Delgado; Tania,17,0,35,18
1657103229949,COGS 107A,A01,083627,Boyle; Mary E. T.,13,0,60,47
1657103235973,COGS 118A,A01,083075,Gupta; Anjum,15,0,76,61
1657103241999,CSE 3,A50,083646,Miranda; Gregory Joseph,22,0,50,28
1657103248023,CSE 8A,A50,083650,Miranda; Gregory Joseph,17,1,56,39
1657103254050,CSE 11,A01,083080,Cao; Yingjun,4,15,40,36
1657103260074,CSE 12,A01,083652,Krause-Levy; Sophia Louisa,23,1,120,97
1657103266098,CSE 15L,A01,083654,Morris; Justin Loren,9,0,50,41
1657103266098,CSE 15L,A02,083655,Morris; Justin Loren,9,0,50,41
1657103272124,CSE 20,A01,083657,Tran; Khoa Dang,37,0,80,43
1657103278158,CSE 21,A01,095574,Bach; Quang Tran,21,0,48,27
1657103284189,CSE 30,A01,083084,Eldon; John,4,0,80,76
1657103284189,CSE 30,B01,095061,Bhaskar; Nishant,6,0,50,44
1657103290215,CSE 100,A01,083659,Cao; Yingjun,4,4,70,66
1657103296237,CSE 134B,A01,083661,Powell; Thomas Allan,19,0,100,81
1657103302264,CSE 140,A01,083663,Gungor; Onat,14,0,85,71
1657103308291,CSE 140L,A01,083088,Eldon; John,16,0,100,84
1657103314317,CSE 175,A01,083665,Kumar; Rakesh,3,0,25,22
1657103320341,CSE 190,A00,092507,Dubnov; Shlomo,7,0,20,13
1657103326370,ECE 45,A01,083139,Congero; Spencer William,5,0,75,70
1657103332407,ECE 65,A50,083695,Saad; Andrew S,12,0,30,18
1657103332407,ECE 65,A51,095125,Saad; Andrew S,25,0,26,1
1657103338434,ECE 109,A01,091882,Touri; Behrouz,16,0,70,54
1657103344456,ECE 180,A00,083140,Abi Samra; Nicholas Camill,1,0,30,29
1657103344456,ECE 180,B00,083141,Abi Samra; Nicholas Camill,0,0,30,30
1657103350481,MATH 10A,A01,083735,Patchell; Gregory David,1,0,30,29
1657103350481,MATH 10A,A02,083736,Patchell; Gregory David,20,0,30,10
1657103350481,MATH 10A,A03,083737,Patchell; Gregory David,16,0,30,14
1657103356518,MATH 10B,A01,083207,Lim; Seonhee,7,0,34,27
1657103356518,MATH 10B,A02,083208,Lim; Seonhee,9,0,35,26
1657103356518,MATH 10B,A03,093472,Lim; Seonhee,5,0,34,29
1657103356518,MATH 10B,B01,083739,Sinha; Shubham,9,0,30,21
1657103362551,MATH 18,A01,083743,Cinel; Cameron Alexander,6,0,30,24
1657103362551,MATH 18,A02,083744,Cinel; Cameron Alexander,15,0,30,15
1657103362551,MATH 18,A03,083745,Cinel; Cameron Alexander,8,0,30,22
1657103362551,MATH 18,B01,083748,Rideout; David Porter,4,0,37,33
1657103362551,MATH 18,B02,083749,Rideout; David Porter,3,0,36,33
1657103362551,MATH 18,B03,083750,Rideout; David Porter,2,0,37,35
1657103362551,MATH 18,B04,083751,Rideout; David Porter,5,0,36,31
1657103362551,MATH 18,B05,093473,Rideout; David Porter,4,0,36,32
1657103362551,MATH 18,B06,093474,Rideout; David Porter,5,0,36,31
1657103368574,MATH 20A,A01,083754,Zheng; Zequn,12,0,40,28
1657103374601,MATH 20B,A01,083756,Briones; Jor-el Thomas Caparas,1,0,36,35
1657103374601,MATH 20B,A02,083757,Briones; Jor-el Thomas Caparas,1,0,36,35
1657103374601,MATH 20B,A03,093475,Briones; Jor-el Thomas Caparas,0,0,36,36
1657103380627,MATH 20C,A01,083760,Briones; Jor-el Thomas Caparas,1,0,35,34
1657103380627,MATH 20C,A02,083761,Briones; Jor-el Thomas Caparas,8,0,35,27
1657103380627,MATH 20C,A03,093476,Briones; Jor-el Thomas Caparas,0,1,36,36
1657103380627,MATH 20C,B01,083762,Bach; Quang Tran,0,0,30,30
1657103386653,MATH 20D,A01,083765,Tran; Brian Kha,4,0,30,26
1657103386653,MATH 20D,A02,083766,Tran; Brian Kha,5,0,30,25
1657103386653,MATH 20D,A03,083767,Tran; Brian Kha,3,0,30,27
1657103392694,MATH 20E,A01,083771,Ganguly; Soumya,6,0,32,26
1657103392694,MATH 20E,A02,083772,Ganguly; Soumya,6,0,32,26
1657103392694,MATH 20E,B01,083773,Ciotti; Benjamin,18,0,35,17
1657103392694,MATH 20E,B02,083774,Ciotti; Benjamin,17,0,35,18
1657103398717,MATH 103A,A01,083777,Greenfeld; Be'Eri,2,0,36,34
1657103398717,MATH 103A,A02,083778,Greenfeld; Be'Eri,5,0,36,31
1657103398717,MATH 103A,A03,093561,Greenfeld; Be'Eri,4,0,36,32
1657103398717,MATH 103A,B01,083779,Greenfeld; Be'Eri,6,0,36,30
1657103398717,MATH 103A,B02,083780,Greenfeld; Be'Eri,2,0,36,34
1657103398717,MATH 103A,B03,093562,Greenfeld; Be'Eri,3,0,36,33
1657103404748,MATH 105,A01,085443,Carter; Anne Toulson,14,0,35,21
1657103404748,MATH 105,A02,093477,Carter; Anne Toulson,20,0,35,15
1657103410769,MATH 109,A01,083213,Ganzberger; Geoffrey Michael,2,0,34,32
1657103410769,MATH 109,A02,083214,Ganzberger; Geoffrey Michael,3,0,34,31
1657103410769,MATH 109,A03,093478,Ganzberger; Geoffrey Michael,1,0,34,33
1657103410769,MATH 109,B01,083215,Ganzberger; Geoffrey Michael,1,0,32,31
1657103410769,MATH 109,B02,083216,Ganzberger; Geoffrey Michael,1,0,32,31
1657103410769,MATH 109,B03,093479,Ganzberger; Geoffrey Michael,6,0,32,26
1657103416792,MATH 142A,A01,083219,Chow; Bennett,6,0,32,26
1657103416792,MATH 142A,A02,083220,Chow; Bennett,10,0,32,22
1657103416792,MATH 142A,A03,093480,Chow; Bennett,7,0,32,25
1657103416792,MATH 142A,B03,093481,Chow; Bennett,8,0,32,24
1657103416792,MATH 142A,B04,093558,Chow; Bennett,11,0,32,21
1657103416792,MATH 142A,B05,093559,Chow; Bennett,6,0,32,26
1657103422816,MATH 193A,A01,083224,Rotar; Vladimir,7,0,34,27
1657103422816,MATH 193A,A02,083225,Rotar; Vladimir,5,0,34,29
1657103422816,MATH 193A,A03,083781,Rotar; Vladimir,1,0,34,33
1657103422816,MATH 193A,A04,083782,Rotar; Vladimir,6,0,34,28
1657103422816,MATH 193A,A05,093482,Rotar; Vladimir,6,0,34,28
1657103428845,MATH 197,001,091859,McAuley; Julian John,9999,0,9999,0
1657103428845,MATH 197,002,095566,Kedlaya; Kiran S.,9997,0,9999,2
1657103428845,MATH 197,003,095567,Xiao; Ming,9999,0,9999,0
1657103428845,MATH 197,004,095571,Perols; Johan Lars,9998,0,9999,1
1657103435914,COGS 9,A01,083615,Shannon; Kyle Michael,7,0,75,68
1657103441939,COGS 11,A01,083617,Boyle; Mary E. T.,21,0,48,27
1657103447966,COGS 13,A01,083071,Bastos; Amalia Pinkusfeld,9,0,71,62
1657103453990,COGS 14A,A01,092681,Semenuks; Arturs,1,1,100,99
1657103460017,COGS 14B,A01,083073,Cheng; Tzu-Han,6,0,63,57
1657103466045,COGS 17,A01,092677,Semenuks; Arturs,4,0,81,77
1657103472074,COGS 100,A01,083619,Allen; Michael Gordon,15,0,70,55
1657103478099,COGS 101A,A01,083621,Davis; Joshua Daniel,9,0,68,59
1657103484129,COGS 101B,A01,091572,Allen; Michael Gordon,8,0,65,57
1657103490165,COGS 101C,A01,083625,Delgado; Tania,17,0,35,18
1657103496195,COGS 107A,A01,083627,Boyle; Mary E. T.,13,0,60,47
1657103502220,COGS 118A,A01,083075,Gupta; Anjum,15,0,76,61
1657103508249,CSE 3,A50,083646,Miranda; Gregory Joseph,22,0,50,28
1657103514274,CSE 8A,A50,083650,Miranda; Gregory Joseph,17,1,56,39
1657103520304,CSE 11,A01,083080,Cao; Yingjun,4,15,40,36
1657103526333,CSE 12,A01,083652,Krause-Levy; Sophia Louisa,23,1,120,97
1657103532363,CSE 15L,A01,083654,Morris; Justin Loren,9,0,50,41
1657103532363,CSE 15L,A02,083655,Morris; Justin Loren,9,0,50,41
1657103538393,CSE 20,A01,083657,Tran; Khoa Dang,37,0,80,43
1657103544419,CSE 21,A01,095574,Bach; Quang Tran,21,0,48,27
1657103550454,CSE 30,A01,083084,Eldon; John,4,0,80,76
1657103550454,CSE 30,B01,095061,Bhaskar; Nishant,6,0,50,44
1657103556479,CSE 100,A01,083659,Cao; Yingjun,4,4,70,66
1657103562504,CSE 134B,A01,083661,Powell; Thomas Allan,19,0,100,81
1657103568562,CSE 140,A01,083663,Gungor; Onat,14,0,85,71
1657103574587,CSE 140L,A01,083088,Eldon; John,16,0,100,84
1657103580611,CSE 175,A01,083665,Kumar; Rakesh,3,0,25,22
1657103586636,CSE 190,A00,092507,Dubnov; Shlomo,7,0,20,13
1657103592663,ECE 45,A01,083139,Congero; Spencer William,5,0,75,70
1657103598691,ECE 65,A50,083695,Saad; Andrew S,12,0,30,18
1657103598691,ECE 65,A51,095125,Saad; Andrew S,25,0,26,1
1657103604721,ECE 109,A01,091882,Touri; Behrouz,16,0,70,54
1657103610750,ECE 180,A00,083140,Abi Samra; Nicholas Camill,1,0,30,29
1657103610750,ECE 180,B00,083141,Abi Samra; Nicholas Camill,0,0,30,30
1657103616788,MATH 10A,A01,083735,Patchell; Gregory David,1,0,30,29
1657103616788,MATH 10A,A02,083736,Patchell; Gregory David,20,0,30,10
1657103616788,MATH 10A,A03,083737,Patchell; Gregory David,16,0,30,14
1657103622815,MATH 10B,A01,083207,Lim; Seonhee,7,0,34,27
1657103622815,MATH 10B,A02,083208,Lim; Seonhee,9,0,35,26
1657103622815,MATH 10B,A03,093472,Lim; Seonhee,5,0,34,29
1657103622815,MATH 10B,B01,083739,Sinha; Shubham,9,0,30,21
1657103628840,MATH 18,A01,083743,Cinel; Cameron Alexander,6,0,30,24
1657103628840,MATH 18,A02,083744,Cinel; Cameron Alexander,15,0,30,15
1657103628840,MATH 18,A03,083745,Cinel; Cameron Alexander,8,0,30,22
1657103628840,MATH 18,B01,083748,Rideout; David Porter,4,0,37,33
1657103628840,MATH 18,B02,083749,Rideout; David Porter,3,0,36,33
1657103628840,MATH 18,B03,083750,Rideout; David Porter,2,0,37,35
1657103628840,MATH 18,B04,083751,Rideout; David Porter,5,0,36,31
1657103628840,MATH 18,B05,093473,Rideout; David Porter,4,0,36,32
1657103628840,MATH 18,B06,093474,Rideout; David Porter,5,0,36,31
1657103634870,MATH 20A,A01,083754,Zheng; Zequn,12,0,40,28
1657103640896,MATH 20B,A01,083756,Briones; Jor-el Thomas Caparas,1,0,36,35
1657103640896,MATH 20B,A02,083757,Briones; Jor-el Thomas Caparas,1,0,36,35
1657103640896,MATH 20B,A03,093475,Briones; Jor-el Thomas Caparas,0,0,36,36
1657103646921,MATH 20C,A01,083760,Briones; Jor-el Thomas Caparas,1,0,35,34
1657103646921,MATH 20C,A02,083761,Briones; Jor-el Thomas Caparas,8,0,35,27
1657103646921,MATH 20C,A03,093476,Briones; Jor-el Thomas Caparas,0,1,36,36
1657103646921,MATH 20C,B01,083762,Bach; Quang Tran,0,0,30,30
1657103652945,MATH 20D,A01,083765,Tran; Brian Kha,4,0,30,26
1657103652945,MATH 20D,A02,083766,Tran; Brian Kha,5,0,30,25
1657103652945,MATH 20D,A03,083767,Tran; Brian Kha,3,0,30,27
1657103658970,MATH 20E,A01,083771,Ganguly; Soumya,6,0,32,26
1657103658970,MATH 20E,A02,083772,Ganguly; Soumya,6,0,32,26
1657103658970,MATH 20E,B01,083773,Ciotti; Benjamin,18,0,35,17
1657103658970,MATH 20E,B02,083774,Ciotti; Benjamin,17,0,35,18
1657103664993,MATH 103A,A01,083777,Greenfeld; Be'Eri,2,0,36,34
1657103664993,MATH 103A,A02,083778,Greenfeld; Be'Eri,5,0,36,31
1657103664993,MATH 103A,A03,093561,Greenfeld; Be'Eri,4,0,36,32
1657103664993,MATH 103A,B01,083779,Greenfeld; Be'Eri,6,0,36,30
1657103664993,MATH 103A,B02,083780,Greenfeld; Be'Eri,2,0,36,34
1657103664993,MATH 103A,B03,093562,Greenfeld; Be'Eri,3,0,36,33
1657103671018,MATH 105,A01,085443,Carter; Anne Toulson,14,0,35,21
1657103671018,MATH 105,A02,093477,Carter; Anne Toulson,20,0,35,15
1657103677123,MATH 109,A01,083213,Ganzberger; Geoffrey Michael,2,0,34,32
1657103677123,MATH 109,A02,083214,Ganzberger; Geoffrey Michael,3,0,34,31
1657103677123,MATH 109,A03,093478,Ganzberger; Geoffrey Michael,1,0,34,33
1657103677123,MATH 109,B01,083215,Ganzberger; Geoffrey Michael,1,0,32,31
1657103677123,MATH 109,B02,083216,Ganzberger; Geoffrey Michael,1,0,32,31
1657103677123,MATH 109,B03,093479,Ganzberger; Geoffrey Michael,6,0,32,26
1657103683148,MATH 142A,A01,083219,Chow; Bennett,6,0,32,26
1657103683148,MATH 142A,A02,083220,Chow; Bennett,10,0,32,22
1657103683148,MATH 142A,A03,093480,Chow; Bennett,7,0,32,25
1657103683148,MATH 142A,B03,093481,Chow; Bennett,8,0,32,24
1657103683148,MATH 142A,B04,093558,Chow; Bennett,11,0,32,21
1657103683148,MATH 142A,B05,093559,Chow; Bennett,6,0,32,26
1657103689174,MATH 193A,A01,083224,Rotar; Vladimir,7,0,34,27
1657103689174,MATH 193A,A02,083225,Rotar; Vladimir,5,0,34,29
1657103689174,MATH 193A,A03,083781,Rotar; Vladimir,1,0,34,33
1657103689174,MATH 193A,A04,083782,Rotar; Vladimir,6,0,34,28
1657103689174,MATH 193A,A05,093482,Rotar; Vladimir,6,0,34,28
1657103695201,MATH 197,001,091859,McAuley; Julian John,9999,0,9999,0
1657103695201,MATH 197,002,095566,Kedlaya; Kiran S.,9997,0,9999,2
1657103695201,MATH 197,003,095567,Xiao; Ming,9999,0,9999,0
1657103695201,MATH 197,004,095571,Perols; Johan Lars,9998,0,9999,1
1657103702269,COGS 9,A01,083615,Shannon; Kyle Michael,7,0,75,68
1657103708292,COGS 11,A01,083617,Boyle; Mary E. T.,21,0,48,27
1657103714317,COGS 13,A01,083071,Bastos; Amalia Pinkusfeld,9,0,71,62
1657103720342,COGS 14A,A01,092681,Semenuks; Arturs,1,1,100,99
1657103726366,COGS 14B,A01,083073,Cheng; Tzu-Han,6,0,63,57
1657103732391,COGS 17,A01,092677,Semenuks; Arturs,4,0,81,77
1657103738415,COGS 100,A01,083619,Allen; Michael Gordon,15,0,70,55
1657103744440,COGS 101A,A01,083621,Davis; Joshua Daniel,9,0,68,59
1657103750465,COGS 101B,A01,091572,Allen; Michael Gordon,8,0,65,57
1657103756495,COGS 101C,A01,083625,Delgado; Tania,17,0,35,18
1657103762519,COGS 107A,A01,083627,Boyle; Mary E. T.,13,0,60,47
1657103768544,COGS 118A,A01,083075,Gupta; Anjum,15,0,76,61
1657103774587,CSE 3,A50,083646,Miranda; Gregory Joseph,22,0,50,28
1657103780612,CSE 8A,A50,083650,Miranda; Gregory Joseph,17,1,56,39
1657103786638,CSE 11,A01,083080,Cao; Yingjun,4,15,40,36
1657103792668,CSE 12,A01,083652,Krause-Levy; Sophia Louisa,23,1,120,97
1657103798698,CSE 15L,A01,083654,Morris; Justin Loren,9,0,50,41
1657103798698,CSE 15L,A02,083655,Morris; Justin Loren,9,0,50,41
1657103804724,CSE 20,A01,083657,Tran; Khoa Dang,37,0,80,43
1657103810760,CSE 21,A01,095574,Bach; Quang Tran,21,0,48,27
1657103816787,CSE 30,A01,083084,Eldon; John,4,0,80,76
1657103816787,CSE 30,B01,095061,Bhaskar; Nishant,6,0,50,44
1657103822811,CSE 100,A01,083659,Cao; Yingjun,4,4,70,66
1657103828842,CSE 134B,A01,083661,Powell; Thomas Allan,19,0,100,81
1657103834866,CSE 140,A01,083663,Gungor; Onat,14,0,85,71
1657103840895,CSE 140L,A01,083088,Eldon; John,16,0,100,84
1657103846920,CSE 175,A01,083665,Kumar; Rakesh,3,0,25,22
1657103852945,CSE 190,A00,092507,Dubnov; Shlomo,7,0,20,13
1657103859005,ECE 45,A01,083139,Congero; Spencer William,5,0,75,70
1657103865038,ECE 65,A50,083695,Saad; Andrew S,12,0,30,18
1657103865038,ECE 65,A51,095125,Saad; Andrew S,25,0,26,1
1657103871069,ECE 109,A01,091882,Touri; Behrouz,16,0,70,54
1657103877094,ECE 180,A00,083140,Abi Samra; Nicholas Camill,1,0,30,29
1657103877094,ECE 180,B00,083141,Abi Samra; Nicholas Camill,0,0,30,30
1657103883120,MATH 10A,A01,083735,Patchell; Gregory David,1,0,30,29
1657103883120,MATH 10A,A02,083736,Patchell; Gregory David,20,0,30,10
1657103883120,MATH 10A,A03,083737,Patchell; Gregory David,16,0,30,14
1657103889147,MATH 10B,A01,083207,Lim; Seonhee,7,0,34,27
1657103889147,MATH 10B,A02,083208,Lim; Seonhee,9,0,35,26
1657103889147,MATH 10B,A03,093472,Lim; Seonhee,5,0,34,29
1657103889147,MATH 10B,B01,083739,Sinha; Shubham,9,0,30,21
1657103895178,MATH 18,A01,083743,Cinel; Cameron Alexander,6,0,30,24
1657103895178,MATH 18,A02,083744,Cinel; Cameron Alexander,15,0,30,15
1657103895178,MATH 18,A03,083745,Cinel; Cameron Alexander,8,0,30,22
1657103895178,MATH 18,B01,083748,Rideout; David Porter,4,0,37,33
1657103895178,MATH 18,B02,083749,Rideout; David Porter,3,0,36,33
1657103895178,MATH 18,B03,083750,Rideout; David Porter,2,0,37,35
1657103895178,MATH 18,B04,083751,Rideout; David Porter,5,0,36,31
1657103895178,MATH 18,B05,093473,Rideout; David Porter,4,0,36,32
1657103895178,MATH 18,B06,093474,Rideout; David Porter,5,0,36,31
1657103901203,MATH 20A,A01,083754,Zheng; Zequn,12,0,40,28
1657103907229,MATH 20B,A01,083756,Briones; Jor-el Thomas Caparas,1,0,36,35
1657103907229,MATH 20B,A02,083757,Briones; Jor-el Thomas Caparas,1,0,36,35
1657103907229,MATH 20B,A03,093475,Briones; Jor-el Thomas Caparas,0,0,36,36
1657103913260,MATH 20C,A01,083760,Briones; Jor-el Thomas Caparas,1,0,35,34
1657103913260,MATH 20C,A02,083761,Briones; Jor-el Thomas Caparas,8,0,35,27
1657103913260,MATH 20C,A03,093476,Briones; Jor-el Thomas Caparas,0,1,36,36
1657103913260,MATH 20C,B01,083762,Bach; Quang Tran,0,0,30,30
1657103919295,MATH 20D,A01,083765,Tran; Brian Kha,4,0,30,26
1657103919295,MATH 20D,A02,083766,Tran; Brian Kha,5,0,30,25
1657103919295,MATH 20D,A03,083767,Tran; Brian Kha,3,0,30,27
1657103925326,MATH 20E,A01,083771,Ganguly; Soumya,6,0,32,26
1657103925326,MATH 20E,A02,083772,Ganguly; Soumya,6,0,32,26
1657103925326,MATH 20E,B01,083773,Ciotti; Benjamin,18,0,35,17
1657103925326,MATH 20E,B02,083774,Ciotti; Benjamin,17,0,35,18
1657103931354,MATH 103A,A01,083777,Greenfeld; Be'Eri,2,0,36,34
1657103931354,MATH 103A,A02,083778,Greenfeld; Be'Eri,5,0,36,31
1657103931354,MATH 103A,A03,093561,Greenfeld; Be'Eri,4,0,36,32
1657103931354,MATH 103A,B01,083779,Greenfeld; Be'Eri,6,0,36,30
1657103931354,MATH 103A,B02,083780,Greenfeld; Be'Eri,2,0,36,34
1657103931354,MATH 103A,B03,093562,Greenfeld; Be'Eri,3,0,36,33
1657103937386,MATH 105,A01,085443,Carter; Anne Toulson,14,0,35,21
1657103937386,MATH 105,A02,093477,Carter; Anne Toulson,20,0,35,15
1657103943424,MATH 109,A01,083213,Ganzberger; Geoffrey Michael,2,0,34,32
1657103943424,MATH 109,A02,083214,Ganzberger; Geoffrey Michael,3,0,34,31
1657103943424,MATH 109,A03,093478,Ganzberger; Geoffrey Michael,1,0,34,33
1657103943424,MATH 109,B01,083215,Ganzberger; Geoffrey Michael,1,0,32,31
1657103943424,MATH 109,B02,083216,Ganzberger; Geoffrey Michael,1,0,32,31
1657103943424,MATH 109,B03,093479,Ganzberger; Geoffrey Michael,6,0,32,26
1657103949449,MATH 142A,A01,083219,Chow; Bennett,6,0,32,26
1657103949449,MATH 142A,A02,083220,Chow; Bennett,10,0,32,22
1657103949449,MATH 142A,A03,093480,Chow; Bennett,7,0,32,25
1657103949449,MATH 142A,B03,093481,Chow; Bennett,8,0,32,24
1657103949449,MATH 142A,B04,093558,Chow; Bennett,11,0,32,21
1657103949449,MATH 142A,B05,093559,Chow; Bennett,6,0,32,26
1657103955473,MATH 193A,A01,083224,Rotar; Vladimir,7,0,34,27
1657103955473,MATH 193A,A02,083225,Rotar; Vladimir,5,0,34,29
1657103955473,MATH 193A,A03,083781,Rotar; Vladimir,1,0,34,33
1657103955473,MATH 193A,A04,083782,Rotar; Vladimir,6,0,34,28
1657103955473,MATH 193A,A05,093482,Rotar; Vladimir,6,0,34,28
1657103961498,MATH 197,001,091859,McAuley; Julian John,9999,0,9999,0
1657103961498,MATH 197,002,095566,Kedlaya; Kiran S.,9997,0,9999,2
1657103961498,MATH 197,003,095567,Xiao; Ming,9999,0,9999,0
1657103961498,MATH 197,004,095571,Perols; Johan Lars,9998,0,9999,1
1657103968574,COGS 9,A01,083615,Shannon; Kyle Michael,7,0,75,68
1657103974598,COGS 11,A01,083617,Boyle; Mary E. T.,21,0,48,27
1657103980622,COGS 13,A01,083071,Bastos; Amalia Pinkusfeld,9,0,71,62
1657103986650,COGS 14A,A01,092681,Semenuks; Arturs,1,1,100,99
1657103992681,COGS 14B,A01,083073,Cheng; Tzu-Han,6,0,63,57
1657103998707,COGS 17,A01,092677,Semenuks; Arturs,4,0,81,77
1657104004730,COGS 100,A01,083619,Allen; Michael Gordon,15,0,70,55
1657104010761,COGS 101A,A01,083621,Davis; Joshua Daniel,9,0,68,59
1657104016785,COGS 101B,A01,091572,Allen; Michael Gordon,8,0,65,57
1657104022808,COGS 101C,A01,083625,Delgado; Tania,17,0,35,18
1657104028831,COGS 107A,A01,083627,Boyle; Mary E. T.,13,0,60,47
1657104034861,COGS 118A,A01,083075,Gupta; Anjum,15,0,76,61
1657104040893,CSE 3,A50,083646,Miranda; Gregory Joseph,22,0,50,28
1657104046918,CSE 8A,A50,083650,Miranda; Gregory Joseph,17,1,56,39
1657104052943,CSE 11,A01,083080,Cao; Yingjun,4,15,40,36
1657104058972,CSE 12,A01,083652,Krause-Levy; Sophia Louisa,23,1,120,97
1657104065004,CSE 15L,A01,083654,Morris; Justin Loren,9,0,50,41
1657104065004,CSE 15L,A02,083655,Morris; Justin Loren,9,0,50,41
1657104071030,CSE 20,A01,083657,Tran; Khoa Dang,37,0,80,43
1657104077061,CSE 21,A01,095574,Bach; Quang Tran,21,0,48,27
1657104083093,CSE 30,A01,083084,Eldon; John,4,0,80,76
1657104083093,CSE 30,B01,095061,Bhaskar; Nishant,6,0,50,44
1657104089122,CSE 100,A01,083659,Cao; Yingjun,4,4,70,66
1657104095147,CSE 134B,A01,083661,Powell; Thomas Allan,19,0,100,81
1657104101180,CSE 140,A01,083663,Gungor; Onat,14,0,85,71
1657104107208,CSE 140L,A01,083088,Eldon; John,16,0,100,84
1657104113235,CSE 175,A01,083665,Kumar; Rakesh,3,0,25,22
1657104119260,CSE 190,A00,092507,Dubnov; Shlomo,7,0,20,13
1657104125298,ECE 45,A01,083139,Congero; Spencer William,5,0,75,70
1657104131323,ECE 65,A50,083695,Saad; Andrew S,12,0,30,18
1657104131323,ECE 65,A51,095125,Saad; Andrew S,25,0,26,1
1657104137349,ECE 109,A01,091882,Touri; Behrouz,16,0,70,54
1657104143374,ECE 180,A00,083140,Abi Samra; Nicholas Camill,1,0,30,29
1657104143374,ECE 180,B00,083141,Abi Samra; Nicholas Camill,0,0,30,30
1657104149402,MATH 10A,A01,083735,Patchell; Gregory David,1,0,30,29
1657104149402,MATH 10A,A02,083736,Patchell; Gregory David,20,0,30,10
1657104149402,MATH 10A,A03,083737,Patchell; Gregory David,16,0,30,14
1657104155440,MATH 10B,A01,083207,Lim; Seonhee,7,0,34,27
1657104155440,MATH 10B,A02,083208,Lim; Seonhee,9,0,35,26
1657104155440,MATH 10B,A03,093472,Lim; Seonhee,5,0,34,29
1657104155440,MATH 10B,B01,083739,Sinha; Shubham,9,0,30,21
1657104161471,MATH 18,A01,083743,Cinel; Cameron Alexander,6,0,30,24
1657104161471,MATH 18,A02,083744,Cinel; Cameron Alexander,15,0,30,15
1657104161471,MATH 18,A03,083745,Cinel; Cameron Alexander,8,0,30,22
1657104161471,MATH 18,B01,083748,Rideout; David Porter,4,0,37,33
1657104161471,MATH 18,B02,083749,Rideout; David Porter,3,0,36,33
1657104161471,MATH 18,B03,083750,Rideout; David Porter,2,0,37,35
1657104161471,MATH 18,B04,083751,Rideout; David Porter,5,0,36,31
1657104161471,MATH 18,B05,093473,Rideout; David Porter,4,0,36,32
1657104161471,MATH 18,B06,093474,Rideout; David Porter,5,0,36,31
1657104167503,MATH 20A,A01,083754,Zheng; Zequn,12,0,40,28
1657104173529,MATH 20B,A01,083756,Briones; Jor-el Thomas Caparas,1,0,36,35
1657104173529,MATH 20B,A02,083757,Briones; Jor-el Thomas Caparas,1,0,36,35
1657104173529,MATH 20B,A03,093475,Briones; Jor-el Thomas Caparas,0,0,36,36
1657104179556,MATH 20C,A01,083760,Briones; Jor-el Thomas Caparas,1,0,35,34
1657104179556,MATH 20C,A02,083761,Briones; Jor-el Thomas Caparas,8,0,35,27
1657104179556,MATH 20C,A03,093476,Briones; Jor-el Thomas Caparas,0,1,36,36
1657104179556,MATH 20C,B01,083762,Bach; Quang Tran,0,0,30,30
1657104185604,MATH 20D,A01,083765,Tran; Brian Kha,4,0,30,26
1657104185604,MATH 20D,A02,083766,Tran; Brian Kha,5,0,30,25
1657104185604,MATH 20D,A03,083767,Tran; Brian Kha,3,0,30,27
1657104191632,MATH 20E,A01,083771,Ganguly; Soumya,6,0,32,26
1657104191632,MATH 20E,A02,083772,Ganguly; Soumya,6,0,32,26
1657104191632,MATH 20E,B01,083773,Ciotti; Benjamin,18,0,35,17
1657104191632,MATH 20E,B02,083774,Ciotti; Benjamin,17,0,35,18
1657104197659,MATH 103A,A01,083777,Greenfeld; Be'Eri,2,0,36,34
1657104197659,MATH 103A,A02,083778,Greenfeld; Be'Eri,5,0,36,31
1657104197659,MATH 103A,A03,093561,Greenfeld; Be'Eri,4,0,36,32
1657104197659,MATH 103A,B01,083779,Greenfeld; Be'Eri,6,0,36,30
1657104197659,MATH 103A,B02,083780,Greenfeld; Be'Eri,2,0,36,34
1657104197659,MATH 103A,B03,093562,Greenfeld; Be'Eri,3,0,36,33
1657104203700,MATH 105,A01,085443,Carter; Anne Toulson,14,0,35,21
1657104203700,MATH 105,A02,093477,Carter; Anne Toulson,20,0,35,15
1657104209727,MATH 109,A01,083213,Ganzberger; Geoffrey Michael,2,0,34,32
1657104209727,MATH 109,A02,083214,Ganzberger; Geoffrey Michael,3,0,34,31
1657104209727,MATH 109,A03,093478,Ganzberger; Geoffrey Michael,1,0,34,33
1657104209727,MATH 109,B01,083215,Ganzberger; Geoffrey Michael,1,0,32,31
1657104209727,MATH 109,B02,083216,Ganzberger; Geoffrey Michael,1,0,32,31
1657104209727,MATH 109,B03,093479,Ganzberger; Geoffrey Michael,6,0,32,26
1657104215751,MATH 142A,A01,083219,Chow; Bennett,6,0,32,26
1657104215751,MATH 142A,A02,083220,Chow; Bennett,10,0,32,22
1657104215751,MATH 142A,A03,093480,Chow; Bennett,7,0,32,25
1657104215751,MATH 142A,B03,093481,Chow; Bennett,8,0,32,24
1657104215751,MATH 142A,B04,093558,Chow; Bennett,11,0,32,21
1657104215751,MATH 142A,B05,093559,Chow; Bennett,6,0,32,26
1657104221785,MATH 193A,A01,083224,Rotar; Vladimir,7,0,34,27
1657104221785,MATH 193A,A02,083225,Rotar; Vladimir,5,0,34,29
1657104221785,MATH 193A,A03,083781,Rotar; Vladimir,1,0,34,33
1657104221785,MATH 193A,A04,083782,Rotar; Vladimir,6,0,34,28
1657104221785,MATH 193A,A05,093482,Rotar; Vladimir,6,0,34,28
1657104227809,MATH 197,001,091859,McAuley; Julian John,9999,0,9999,0
1657104227809,MATH 197,002,095566,Kedlaya; Kiran S.,9997,0,9999,2
1657104227809,MATH 197,003,095567,Xiao; Ming,9999,0,9999,0
1657104227809,MATH 197,004,095571,Perols; Johan Lars,9998,0,9999,1
1657104234894,COGS 9,A01,083615,Shannon; Kyle Michael,7,0,75,68
1657104240925,COGS 11,A01,083617,Boyle; Mary E. T.,21,0,48,27
1657104246951,COGS 13,A01,083071,Bastos; Amalia Pinkusfeld,9,0,71,62
1657104252983,COGS 14A,A01,092681,Semenuks; Arturs,1,1,100,99
1657104259008,COGS 14B,A01,083073,Cheng; Tzu-Han,6,0,63,57
1657104265038,COGS 17,A01,092677,Semenuks; Arturs,4,0,81,77
1657104271143,COGS 100,A01,083619,Allen; Michael Gordon,15,0,70,55
1657104277176,COGS 101A,A01,083621,Davis; Joshua Daniel,9,0,68,59
1657104283205,COGS 101B,A01,091572,Allen; Michael Gordon,8,0,65,57
1657104289237,COGS 101C,A01,083625,Delgado; Tania,17,0,35,18
1657104295265,COGS 107A,A01,083627,Boyle; Mary E. T.,13,0,60,47
1657104301289,COGS 118A,A01,083075,Gupta; Anjum,15,0,76,61
1657104307322,CSE 3,A50,083646,Miranda; Gregory Joseph,22,0,50,28
1657104313358,CSE 8A,A50,083650,Miranda; Gregory Joseph,17,1,56,39
1657104319384,CSE 11,A01,083080,Cao; Yingjun,4,15,40,36
1657104325415,CSE 12,A01,083652,Krause-Levy; Sophia Louisa,23,1,120,97
1657104331447,CSE 15L,A01,083654,Morris; Justin Loren,9,0,50,41
1657104331447,CSE 15L,A02,083655,Morris; Justin Loren,9,0,50,41
1657104337472,CSE 20,A01,083657,Tran; Khoa Dang,37,0,80,43
1657104343502,CSE 21,A01,095574,Bach; Quang Tran,21,0,48,27
1657104349535,CSE 30,A01,083084,Eldon; John,4,0,80,76
1657104349535,CSE 30,B01,095061,Bhaskar; Nishant,6,0,50,44
1657104355561,CSE 100,A01,083659,Cao; Yingjun,4,4,70,66
1657104361591,CSE 134B,A01,083661,Powell; Thomas Allan,19,0,100,81
1657104367615,CSE 140,A01,083663,Gungor; Onat,14,0,85,71
1657104373639,CSE 140L,A01,083088,Eldon; John,16,0,100,84
1657104379665,CSE 175,A01,083665,Kumar; Rakesh,3,0,25,22
1657104385690,CSE 190,A00,092507,Dubnov; Shlomo,7,0,20,13
1657104391716,ECE 45,A01,083139,Congero; Spencer William,5,0,75,70
1657104397740,ECE 65,A50,083695,Saad; Andrew S,12,0,30,18
1657104397740,ECE 65,A51,095125,Saad; Andrew S,25,0,26,1
1657104403767,ECE 109,A01,091882,Touri; Behrouz,16,0,70,54
1657104409797,ECE 180,A00,083140,Abi Samra; Nicholas Camill,1,0,30,29
1657104409797,ECE 180,B00,083141,Abi Samra; Nicholas Camill,0,0,30,30
1657104415823,MATH 10A,A01,083735,Patchell; Gregory David,1,0,30,29
1657104415823,MATH 10A,A02,083736,Patchell; Gregory David,20,0,30,10
1657104415823,MATH 10A,A03,083737,Patchell; Gregory David,16,0,30,14
1657104421850,MATH 10B,A01,083207,Lim; Seonhee,7,0,34,27
1657104421850,MATH 10B,A02,083208,Lim; Seonhee,9,0,35,26
1657104421850,MATH 10B,A03,093472,Lim; Seonhee,5,0,34,29
1657104421850,MATH 10B,B01,083739,Sinha; Shubham,9,0,30,21
1657104427877,MATH 18,A01,083743,Cinel; Cameron Alexander,6,0,30,24
1657104427877,MATH 18,A02,083744,Cinel; Cameron Alexander,15,0,30,15
1657104427877,MATH 18,A03,083745,Cinel; Cameron Alexander,8,0,30,22
1657104427877,MATH 18,B01,083748,Rideout; David Porter,4,0,37,33
1657104427877,MATH 18,B02,083749,Rideout; David Porter,3,0,36,33
1657104427877,MATH 18,B03,083750,Rideout; David Porter,2,0,37,35
1657104427877,MATH 18,B04,083751,Rideout; David Porter,5,0,36,31
1657104427877,MATH 18,B05,093473,Rideout; David Porter,4,0,36,32
1657104427877,MATH 18,B06,093474,Rideout; David Porter,5,0,36,31
1657104433903,MATH 20A,A01,083754,Zheng; Zequn,12,0,40,28
1657104439936,MATH 20B,A01,083756,Briones; Jor-el Thomas Caparas,1,0,36,35
1657104439936,MATH 20B,A02,083757,Briones; Jor-el Thomas Caparas,1,0,36,35
1657104439936,MATH 20B,A03,093475,Briones; Jor-el Thomas Caparas,0,0,36,36
1657104445963,MATH 20C,A01,083760,Briones; Jor-el Thomas Caparas,1,0,35,34
1657104445963,MATH 20C,A02,083761,Briones; Jor-el Thomas Caparas,8,0,35,27
1657104445963,MATH 20C,A03,093476,Briones; Jor-el Thomas Caparas,0,1,36,36
1657104445963,MATH 20C,B01,083762,Bach; Quang Tran,0,0,30,30
1657104451995,MATH 20D,A01,083765,Tran; Brian Kha,4,0,30,26
1657104451995,MATH 20D,A02,083766,Tran; Brian Kha,5,0,30,25
1657104451995,MATH 20D,A03,083767,Tran; Brian Kha,3,0,30,27
1657104458032,MATH 20E,A01,083771,Ganguly; Soumya,6,0,32,26
1657104458032,MATH 20E,A02,083772,Ganguly; Soumya,6,0,32,26
1657104458032,MATH 20E,B01,083773,Ciotti; Benjamin,18,0,35,17
1657104458032,MATH 20E,B02,083774,Ciotti; Benjamin,17,0,35,18
1657104464062,MATH 103A,A01,083777,Greenfeld; Be'Eri,2,0,36,34
1657104464062,MATH 103A,A02,083778,Greenfeld; Be'Eri,5,0,36,31
1657104464062,MATH 103A,A03,093561,Greenfeld; Be'Eri,4,0,36,32
1657104464062,MATH 103A,B01,083779,Greenfeld; Be'Eri,6,0,36,30
1657104464062,MATH 103A,B02,083780,Greenfeld; Be'Eri,2,0,36,34
1657104464062,MATH 103A,B03,093562,Greenfeld; Be'Eri,3,0,36,33
1657104470089,MATH 105,A01,085443,Carter; Anne Toulson,14,0,35,21
1657104470089,MATH 105,A02,093477,Carter; Anne Toulson,20,0,35,15
1657104476116,MATH 109,A01,083213,Ganzberger; Geoffrey Michael,2,0,34,32
1657104476116,MATH 109,A02,083214,Ganzberger; Geoffrey Michael,3,0,34,31
1657104476116,MATH 109,A03,093478,Ganzberger; Geoffrey Michael,1,0,34,33
1657104476116,MATH 109,B01,083215,Ganzberger; Geoffrey Michael,1,0,32,31
1657104476116,MATH 109,B02,083216,Ganzberger; Geoffrey Michael,1,0,32,31
1657104476116,MATH 109,B03,093479,Ganzberger; Geoffrey Michael,6,0,32,26
1657104482143,MATH 142A,A01,083219,Chow; Bennett,6,0,32,26
1657104482143,MATH 142A,A02,083220,Chow; Bennett,10,0,32,22
1657104482143,MATH 142A,A03,093480,Chow; Bennett,7,0,32,25
1657104482143,MATH 142A,B03,093481,Chow; Bennett,8,0,32,24
1657104482143,MATH 142A,B04,093558,Chow; Bennett,11,0,32,21
1657104482143,MATH 142A,B05,093559,Chow; Bennett,6,0,32,26
1657104488169,MATH 193A,A01,083224,Rotar; Vladimir,7,0,34,27
1657104488169,MATH 193A,A02,083225,Rotar; Vladimir,5,0,34,29
1657104488169,MATH 193A,A03,083781,Rotar; Vladimir,1,0,34,33
1657104488169,MATH 193A,A04,083782,Rotar; Vladimir,6,0,34,28
1657104488169,MATH 193A,A05,093482,Rotar; Vladimir,6,0,34,28
1657104494195,MATH 197,001,091859,McAuley; Julian John,9999,0,9999,0
1657104494195,MATH 197,002,095566,Kedlaya; Kiran S.,9997,0,9999,2
1657104494195,MATH 197,003,095567,Xiao; Ming,9999,0,9999,0
1657104494195,MATH 197,004,095571,Perols; Johan Lars,9998,0,9999,1
1657104501263,COGS 9,A01,083615,Shannon; Kyle Michael,7,0,75,68
1657104507287,COGS 11,A01,083617,Boyle; Mary E. T.,21,0,48,27
1657104513319,COGS 13,A01,083071,Bastos; Amalia Pinkusfeld,9,0,71,62
1657104519354,COGS 14A,A01,092681,Semenuks; Arturs,1,1,100,99
1657104525379,COGS 14B,A01,083073,Cheng; Tzu-Han,6,0,63,57
1657104531403,COGS 17,A01,092677,Semenuks; Arturs,4,0,81,77
1657104537438,COGS 100,A01,083619,Allen; Michael Gordon,15,0,70,55
1657104543468,COGS 101A,A01,083621,Davis; Joshua Daniel,9,0,68,59
1657104549494,COGS 101B,A01,091572,Allen; Michael Gordon,8,0,65,57
1657104555523,COGS 101C,A01,083625,Delgado; Tania,17,0,35,18
1657104561549,COGS 107A,A01,083627,Boyle; Mary E. T.,13,0,60,47
1657104567574,COGS 118A,A01,083075,Gupta; Anjum,15,0,76,61
1657104573607,CSE 3,A50,083646,Miranda; Gregory Joseph,22,0,50,28
1657104579630,CSE 8A,A50,083650,Miranda; Gregory Joseph,17,1,56,39
1657104585655,CSE 11,A01,083080,Cao; Yingjun,4,15,40,36
1657104591686,CSE 12,A01,083652,Krause-Levy; Sophia Louisa,23,1,120,97
1657104597711,CSE 15L,A01,083654,Morris; Justin Loren,9,0,50,41
1657104597711,CSE 15L,A02,083655,Morris; Justin Loren,9,0,50,41
1657104603737,CSE 20,A01,083657,Tran; Khoa Dang,37,0,80,43
1657104609761,CSE 21,A01,095574,Bach; Quang Tran,21,0,48,27
1657104615787,CSE 30,A01,083084,Eldon; John,4,0,80,76
1657104615787,CSE 30,B01,095061,Bhaskar; Nishant,6,0,50,44
1657104621812,CSE 100,A01,083659,Cao; Yingjun,4,4,70,66
1657104627844,CSE 134B,A01,083661,Powell; Thomas Allan,19,0,100,81
1657104633874,CSE 140,A01,083663,Gungor; Onat,14,0,85,71
1657104639899,CSE 140L,A01,083088,Eldon; John,16,0,100,84
1657104645926,CSE 175,A01,083665,Kumar; Rakesh,3,0,25,22
1657104651952,CSE 190,A00,092507,Dubnov; Shlomo,7,0,20,13
1657104657978,ECE 45,A01,083139,Congero; Spencer William,5,0,75,70
1657104664015,ECE 65,A50,083695,Saad; Andrew S,12,0,30,18
1657104664015,ECE 65,A51,095125,Saad; Andrew S,25,0,26,1
1657104670050,ECE 109,A01,091882,Touri; Behrouz,16,0,70,54
1657104676080,ECE 180,A00,083140,Abi Samra; Nicholas Camill,1,0,30,29
1657104676080,ECE 180,B00,083141,Abi Samra; Nicholas Camill,0,0,30,30
1657104682106,MATH 10A,A01,083735,Patchell; Gregory David,1,0,30,29
1657104682106,MATH 10A,A02,083736,Patchell; Gregory David,20,0,30,10
1657104682106,MATH 10A,A03,083737,Patchell; Gregory David,16,0,30,14
1657104688164,MATH 10B,A01,083207,Lim; Seonhee,7,0,34,27
1657104688164,MATH 10B,A02,083208,Lim; Seonhee,9,0,35,26
1657104688164,MATH 10B,A03,093472,Lim; Seonhee,5,0,34,29
1657104688164,MATH 10B,B01,083739,Sinha; Shubham,9,0,30,21
1657104694203,MATH 18,A01,083743,Cinel; Cameron Alexander,6,0,30,24
1657104694203,MATH 18,A02,083744,Cinel; Cameron Alexander,15,0,30,15
1657104694203,MATH 18,A03,083745,Cinel; Cameron Alexander,8,0,30,22
1657104694203,MATH 18,B01,083748,Rideout; David Porter,4,0,37,33
1657104694203,MATH 18,B02,083749,Rideout; David Porter,3,0,36,33
1657104694203,MATH 18,B03,083750,Rideout; David Porter,2,0,37,35
1657104694203,MATH 18,B04,083751,Rideout; David Porter,5,0,36,31
1657104694203,MATH 18,B05,093473,Rideout; David Porter,4,0,36,32
1657104694203,MATH 18,B06,093474,Rideout; David Porter,5,0,36,31
1657104700226,MATH 20A,A01,083754,Zheng; Zequn,12,0,40,28
1657104706261,MATH 20B,A01,083756,Briones; Jor-el Thomas Caparas,1,0,36,35
1657104706261,MATH 20B,A02,083757,Briones; Jor-el Thomas Caparas,1,0,36,35
1657104706261,MATH 20B,A03,093475,Briones; Jor-el Thomas Caparas,0,0,36,36
1657104712296,MATH 20C,A01,083760,Briones; Jor-el Thomas Caparas,1,0,35,34
1657104712296,MATH 20C,A02,083761,Briones; Jor-el Thomas Caparas,8,0,35,27
1657104712296,MATH 20C,A03,093476,Briones; Jor-el Thomas Caparas,0,1,36,36
1657104712296,MATH 20C,B01,083762,Bach; Quang Tran,0,0,30,30
1657104718321,MATH 20D,A01,083765,Tran; Brian Kha,4,0,30,26
1657104718321,MATH 20D,A02,083766,Tran; Brian Kha,5,0,30,25
1657104718321,MATH 20D,A03,083767,Tran; Brian Kha,3,0,30,27
1657104724373,MATH 20E,A01,083771,Ganguly; Soumya,6,0,32,26
1657104724373,MATH 20E,A02,083772,Ganguly; Soumya,6,0,32,26
1657104724373,MATH 20E,B01,083773,Ciotti; Benjamin,18,0,35,17
1657104724373,MATH 20E,B02,083774,Ciotti; Benjamin,17,0,35,18
1657104730398,MATH 103A,A01,083777,Greenfeld; Be'Eri,2,0,36,34
1657104730398,MATH 103A,A02,083778,Greenfeld; Be'Eri,5,0,36,31
1657104730398,MATH 103A,A03,093561,Greenfeld; Be'Eri,4,0,36,32
1657104730398,MATH 103A,B01,083779,Greenfeld; Be'Eri,6,0,36,30
1657104730398,MATH 103A,B02,083780,Greenfeld; Be'Eri,2,0,36,34
1657104730398,MATH 103A,B03,093562,Greenfeld; Be'Eri,3,0,36,33
1657104736427,MATH 105,A01,085443,Carter; Anne Toulson,14,0,35,21
1657104736427,MATH 105,A02,093477,Carter; Anne Toulson,20,0,35,15
1657104742452,MATH 109,A01,083213,Ganzberger; Geoffrey Michael,2,0,34,32
1657104742452,MATH 109,A02,083214,Ganzberger; Geoffrey Michael,3,0,34,31
1657104742452,MATH 109,A03,093478,Ganzberger; Geoffrey Michael,1,0,34,33
1657104742452,MATH 109,B01,083215,Ganzberger; Geoffrey Michael,1,0,32,31
1657104742452,MATH 109,B02,083216,Ganzberger; Geoffrey Michael,1,0,32,31
1657104742452,MATH 109,B03,093479,Ganzberger; Geoffrey Michael,6,0,32,26
1657104748478,MATH 142A,A01,083219,Chow; Bennett,6,0,32,26
1657104748478,MATH 142A,A02,083220,Chow; Bennett,10,0,32,22
1657104748478,MATH 142A,A03,093480,Chow; Bennett,7,0,32,25
1657104748478,MATH 142A,B03,093481,Chow; Bennett,8,0,32,24
1657104748478,MATH 142A,B04,093558,Chow; Bennett,11,0,32,21
1657104748478,MATH 142A,B05,093559,Chow; Bennett,6,0,32,26
1657104754505,MATH 193A,A01,083224,Rotar; Vladimir,7,0,34,27
1657104754505,MATH 193A,A02,083225,Rotar; Vladimir,5,0,34,29
1657104754505,MATH 193A,A03,083781,Rotar; Vladimir,1,0,34,33
1657104754505,MATH 193A,A04,083782,Rotar; Vladimir,6,0,34,28
1657104754505,MATH 193A,A05,093482,Rotar; Vladimir,6,0,34,28
1657104760535,MATH 197,001,091859,McAuley; Julian John,9999,0,9999,0
1657104760535,MATH 197,002,095566,Kedlaya; Kiran S.,9997,0,9999,2
1657104760535,MATH 197,003,095567,Xiao; Ming,9999,0,9999,0
1657104760535,MATH 197,004,095571,Perols; Johan Lars,9998,0,9999,1
1657104767637,COGS 9,A01,083615,Shannon; Kyle Michael,7,0,75,68
1657104773669,COGS 11,A01,083617,Boyle; Mary E. T.,21,0,48,27
1657104779696,COGS 13,A01,083071,Bastos; Amalia Pinkusfeld,9,0,71,62
1657104785724,COGS 14A,A01,092681,Semenuks; Arturs,1,1,100,99
1657104791750,COGS 14B,A01,083073,Cheng; Tzu-Han,6,0,63,57
1657104797777,COGS 17,A01,092677,Semenuks; Arturs,4,0,81,77
1657104803802,COGS 100,A01,083619,Allen; Michael Gordon,15,0,70,55
1657104809834,COGS 101A,A01,083621,Davis; Joshua Daniel,9,0,68,59
1657104815864,COGS 101B,A01,091572,Allen; Michael Gordon,8,0,65,57
1657104821889,COGS 101C,A01,083625,Delgado; Tania,17,0,35,18
1657104827914,COGS 107A,A01,083627,Boyle; Mary E. T.,13,0,60,47
1657104833939,COGS 118A,A01,083075,Gupta; Anjum,15,0,76,61
1657104839966,CSE 3,A50,083646,Miranda; Gregory Joseph,22,0,50,28
1657104845991,CSE 8A,A50,083650,Miranda; Gregory Joseph,17,1,56,39
1657104852022,CSE 11,A01,083080,Cao; Yingjun,4,15,40,36
1657104858048,CSE 12,A01,083652,Krause-Levy; Sophia Louisa,23,1,120,97
1657104864073,CSE 15L,A01,083654,Morris; Justin Loren,9,0,50,41
1657104864073,CSE 15L,A02,083655,Morris; Justin Loren,9,0,50,41
1657104870195,CSE 20,A01,083657,Tran; Khoa Dang,37,0,80,43
1657104876225,CSE 21,A01,095574,Bach; Quang Tran,21,0,48,27
1657104882252,CSE 30,A01,083084,Eldon; John,4,0,80,76
1657104882252,CSE 30,B01,095061,Bhaskar; Nishant,6,0,50,44
1657104888276,CSE 100,A01,083659,Cao; Yingjun,4,4,70,66
1657104894301,CSE 134B,A01,083661,Powell; Thomas Allan,19,0,100,81
1657104900324,CSE 140,A01,083663,Gungor; Onat,14,0,85,71
1657104906352,CSE 140L,A01,083088,Eldon; John,16,0,100,84
1657104912381,CSE 175,A01,083665,Kumar; Rakesh,3,0,25,22
1657104918410,CSE 190,A00,092507,Dubnov; Shlomo,7,0,20,13
1657104924436,ECE 45,A01,083139,Congero; Spencer William,5,0,75,70
1657104930468,ECE 65,A50,083695,Saad; Andrew S,12,0,30,18
1657104930468,ECE 65,A51,095125,Saad; Andrew S,25,0,26,1
1657104936499,ECE 109,A01,091882,Touri; Behrouz,16,0,70,54
1657104942523,ECE 180,A00,083140,Abi Samra; Nicholas Camill,1,0,30,29
1657104942523,ECE 180,B00,083141,Abi Samra; Nicholas Camill,0,0,30,30
1657104948559,MATH 10A,A01,083735,Patchell; Gregory David,1,0,30,29
1657104948559,MATH 10A,A02,083736,Patchell; Gregory David,20,0,30,10
1657104948559,MATH 10A,A03,083737,Patchell; Gregory David,16,0,30,14
1657104954587,MATH 10B,A01,083207,Lim; Seonhee,7,0,34,27
1657104954587,MATH 10B,A02,083208,Lim; Seonhee,9,0,35,26
1657104954587,MATH 10B,A03,093472,Lim; Seonhee,5,0,34,29
1657104954587,MATH 10B,B01,083739,Sinha; Shubham,9,0,30,21
1657104960625,MATH 18,A01,083743,Cinel; Cameron Alexander,6,0,30,24
1657104960625,MATH 18,A02,083744,Cinel; Cameron Alexander,15,0,30,15
1657104960625,MATH 18,A03,083745,Cinel; Cameron Alexander,8,0,30,22
1657104960625,MATH 18,B01,083748,Rideout; David Porter,4,0,37,33
1657104960625,MATH 18,B02,083749,Rideout; David Porter,3,0,36,33
1657104960625,MATH 18,B03,083750,Rideout; David Porter,2,0,37,35
1657104960625,MATH 18,B04,083751,Rideout; David Porter,5,0,36,31
1657104960625,MATH 18,B05,093473,Rideout; David Porter,4,0,36,32
1657104960625,MATH 18,B06,093474,Rideout; David Porter,5,0,36,31
1657104966651,MATH 20A,A01,083754,Zheng; Zequn,12,0,40,28
1657104972679,MATH 20B,A01,083756,Briones; Jor-el Thomas Caparas,1,0,36,35
1657104972679,MATH 20B,A02,083757,Briones; Jor-el Thomas Caparas,1,0,36,35
1657104972679,MATH 20B,A03,093475,Briones; Jor-el Thomas Caparas,0,0,36,36
1657104978704,MATH 20C,A01,083760,Briones; Jor-el Thomas Caparas,1,0,35,34
1657104978704,MATH 20C,A02,083761,Briones; Jor-el Thomas Caparas,8,0,35,27
1657104978704,MATH 20C,A03,093476,Briones; Jor-el Thomas Caparas,0,1,36,36
1657104978704,MATH 20C,B01,083762,Bach; Quang Tran,0,0,30,30
1657104984741,MATH 20D,A01,083765,Tran; Brian Kha,4,0,30,26
1657104984741,MATH 20D,A02,083766,Tran; Brian Kha,5,0,30,25
1657104984741,MATH 20D,A03,083767,Tran; Brian Kha,3,0,30,27
1657104990771,MATH 20E,A01,083771,Ganguly; Soumya,6,0,32,26
1657104990771,MATH 20E,A02,083772,Ganguly; Soumya,6,0,32,26
1657104990771,MATH 20E,B01,083773,Ciotti; Benjamin,18,0,35,17
1657104990771,MATH 20E,B02,083774,Ciotti; Benjamin,17,0,35,18
1657104996803,MATH 103A,A01,083777,Greenfeld; Be'Eri,2,0,36,34
1657104996803,MATH 103A,A02,083778,Greenfeld; Be'Eri,5,0,36,31
1657104996803,MATH 103A,A03,093561,Greenfeld; Be'Eri,4,0,36,32
1657104996803,MATH 103A,B01,083779,Greenfeld; Be'Eri,6,0,36,30
1657104996803,MATH 103A,B02,083780,Greenfeld; Be'Eri,2,0,36,34
1657104996803,MATH 103A,B03,093562,Greenfeld; Be'Eri,3,0,36,33
1657105002837,MATH 105,A01,085443,Carter; Anne Toulson,14,0,35,21
1657105002837,MATH 105,A02,093477,Carter; Anne Toulson,20,0,35,15
1657105008872,MATH 109,A01,083213,Ganzberger; Geoffrey Michael,2,0,34,32
1657105008872,MATH 109,A02,083214,Ganzberger; Geoffrey Michael,3,0,34,31
1657105008872,MATH 109,A03,093478,Ganzberger; Geoffrey Michael,1,0,34,33
1657105008872,MATH 109,B01,083215,Ganzberger; Geoffrey Michael,1,0,32,31
1657105008872,MATH 109,B02,083216,Ganzberger; Geoffrey Michael,1,0,32,31
1657105008872,MATH 109,B03,093479,Ganzberger; Geoffrey Michael,6,0,32,26
1657105014906,MATH 142A,A01,083219,Chow; Bennett,6,0,32,26
1657105014906,MATH 142A,A02,083220,Chow; Bennett,10,0,32,22
1657105014906,MATH 142A,A03,093480,Chow; Bennett,7,0,32,25
1657105014906,MATH 142A,B03,093481,Chow; Bennett,8,0,32,24
1657105014906,MATH 142A,B04,093558,Chow; Bennett,11,0,32,21
1657105014906,MATH 142A,B05,093559,Chow; Bennett,6,0,32,26
1657105020932,MATH 193A,A01,083224,Rotar; Vladimir,7,0,34,27
1657105020932,MATH 193A,A02,083225,Rotar; Vladimir,5,0,34,29
1657105020932,MATH 193A,A03,083781,Rotar; Vladimir,1,0,34,33
1657105020932,MATH 193A,A04,083782,Rotar; Vladimir,6,0,34,28
1657105020932,MATH 193A,A05,093482,Rotar; Vladimir,6,0,34,28
1657105026965,MATH 197,001,091859,McAuley; Julian John,9999,0,9999,0
1657105026965,MATH 197,002,095566,Kedlaya; Kiran S.,9997,0,9999,2
1657105026965,MATH 197,003,095567,Xiao; Ming,9999,0,9999,0
1657105026965,MATH 197,004,095571,Perols; Johan Lars,9998,0,9999,1
1657105034036,COGS 9,A01,083615,Shannon; Kyle Michael,7,0,75,68
1657105040064,COGS 11,A01,083617,Boyle; Mary E. T.,21,0,48,27
1657105046094,COGS 13,A01,083071,Bastos; Amalia Pinkusfeld,9,0,71,62
1657105052122,COGS 14A,A01,092681,Semenuks; Arturs,1,1,100,99
1657105058148,COGS 14B,A01,083073,Cheng; Tzu-Han,6,0,63,57
1657105064172,COGS 17,A01,092677,Semenuks; Arturs,4,0,81,77
1657105070209,COGS 100,A01,083619,Allen; Michael Gordon,15,0,70,55
1657105076241,COGS 101A,A01,083621,Davis; Joshua Daniel,9,0,68,59
1657105082270,COGS 101B,A01,091572,Allen; Michael Gordon,8,0,65,57
1657105088304,COGS 101C,A01,083625,Delgado; Tania,17,0,35,18
1657105094329,COGS 107A,A01,083627,Boyle; Mary E. T.,13,0,60,47
1657105100353,COGS 118A,A01,083075,Gupta; Anjum,15,0,76,61
1657105106387,CSE 3,A50,083646,Miranda; Gregory Joseph,22,0,50,28
1657105112415,CSE 8A,A50,083650,Miranda; Gregory Joseph,17,1,56,39
1657105118441,CSE 11,A01,083080,Cao; Yingjun,4,15,40,36
1657105124478,CSE 12,A01,083652,Krause-Levy; Sophia Louisa,23,1,120,97
1657105130502,CSE 15L,A01,083654,Morris; Justin Loren,9,0,50,41
1657105130502,CSE 15L,A02,083655,Morris; Justin Loren,9,0,50,41
1657105136545,CSE 20,A01,083657,Tran; Khoa Dang,37,0,80,43
1657105142569,CSE 21,A01,095574,Bach; Quang Tran,21,0,48,27
1657105148595,CSE 30,A01,083084,Eldon; John,4,0,80,76
1657105148595,CSE 30,B01,095061,Bhaskar; Nishant,6,0,50,44
1657105154619,CSE 100,A01,083659,Cao; Yingjun,4,4,70,66
1657105160645,CSE 134B,A01,083661,Powell; Thomas Allan,19,0,100,81
1657105166669,CSE 140,A01,083663,Gungor; Onat,14,0,85,71
1657105172709,CSE 140L,A01,083088,Eldon; John,16,0,100,84
1657105178738,CSE 175,A01,083665,Kumar; Rakesh,3,0,25,22
1657105184762,CSE 190,A00,092507,Dubnov; Shlomo,7,0,20,13
1657105190788,ECE 45,A01,083139,Congero; Spencer William,5,0,75,70
1657105196813,ECE 65,A50,083695,Saad; Andrew S,12,0,30,18
1657105196813,ECE 65,A51,095125,Saad; Andrew S,25,0,26,1
1657105202837,ECE 109,A01,091882,Touri; Behrouz,16,0,70,54
1657105208870,ECE 180,A00,083140,Abi Samra; Nicholas Camill,1,0,30,29
1657105208870,ECE 180,B00,083141,Abi Samra; Nicholas Camill,0,0,30,30
1657105214897,MATH 10A,A01,083735,Patchell; Gregory David,1,0,30,29
1657105214897,MATH 10A,A02,083736,Patchell; Gregory David,20,0,30,10
1657105214897,MATH 10A,A03,083737,Patchell; Gregory David,16,0,30,14
1657105220940,MATH 10B,A01,083207,Lim; Seonhee,7,0,34,27
1657105220940,MATH 10B,A02,083208,Lim; Seonhee,9,0,35,26
1657105220940,MATH 10B,A03,093472,Lim; Seonhee,5,0,34,29
1657105220940,MATH 10B,B01,083739,Sinha; Shubham,9,0,30,21
1657105226968,MATH 18,A01,083743,Cinel; Cameron Alexander,6,0,30,24
1657105226968,MATH 18,A02,083744,Cinel; Cameron Alexander,15,0,30,15
1657105226968,MATH 18,A03,083745,Cinel; Cameron Alexander,8,0,30,22
1657105226968,MATH 18,B01,083748,Rideout; David Porter,4,0,37,33
1657105226968,MATH 18,B02,083749,Rideout; David Porter,3,0,36,33
1657105226968,MATH 18,B03,083750,Rideout; David Porter,2,0,37,35
1657105226968,MATH 18,B04,083751,Rideout; David Porter,5,0,36,31
1657105226968,MATH 18,B05,093473,Rideout; David Porter,4,0,36,32
1657105226968,MATH 18,B06,093474,Rideout; David Porter,5,0,36,31
1657105232992,MATH 20A,A01,083754,Zheng; Zequn,12,0,40,28
1657105239021,MATH 20B,A01,083756,Briones; Jor-el Thomas Caparas,1,0,36,35
1657105239021,MATH 20B,A02,083757,Briones; Jor-el Thomas Caparas,1,0,36,35
1657105239021,MATH 20B,A03,093475,Briones; Jor-el Thomas Caparas,0,0,36,36
1657105245047,MATH 20C,A01,083760,Briones; Jor-el Thomas Caparas,1,0,35,34
1657105245047,MATH 20C,A02,083761,Briones; Jor-el Thomas Caparas,8,0,35,27
1657105245047,MATH 20C,A03,093476,Briones; Jor-el Thomas Caparas,0,1,36,36
1657105245047,MATH 20C,B01,083762,Bach; Quang Tran,0,0,30,30
1657105251076,MATH 20D,A01,083765,Tran; Brian Kha,4,0,30,26
1657105251076,MATH 20D,A02,083766,Tran; Brian Kha,5,0,30,25
1657105251076,MATH 20D,A03,083767,Tran; Brian Kha,3,0,30,27
1657105257101,MATH 20E,A01,083771,Ganguly; Soumya,6,0,32,26
1657105257101,MATH 20E,A02,083772,Ganguly; Soumya,6,0,32,26
1657105257101,MATH 20E,B01,083773,Ciotti; Benjamin,18,0,35,17
1657105257101,MATH 20E,B02,083774,Ciotti; Benjamin,17,0,35,18
1657105263134,MATH 103A,A01,083777,Greenfeld; Be'Eri,2,0,36,34
1657105263134,MATH 103A,A02,083778,Greenfeld; Be'Eri,5,0,36,31
1657105263134,MATH 103A,A03,093561,Greenfeld; Be'Eri,4,0,36,32
1657105263134,MATH 103A,B01,083779,Greenfeld; Be'Eri,6,0,36,30
1657105263134,MATH 103A,B02,083780,Greenfeld; Be'Eri,2,0,36,34
1657105263134,MATH 103A,B03,093562,Greenfeld; Be'Eri,3,0,36,33
1657105269163,MATH 105,A01,085443,Carter; Anne Toulson,14,0,35,21
1657105269163,MATH 105,A02,093477,Carter; Anne Toulson,20,0,35,15
1657105275189,MATH 109,A01,083213,Ganzberger; Geoffrey Michael,2,0,34,32
1657105275189,MATH 109,A02,083214,Ganzberger; Geoffrey Michael,3,0,34,31
1657105275189,MATH 109,A03,093478,Ganzberger; Geoffrey Michael,1,0,34,33
1657105275189,MATH 109,B01,083215,Ganzberger; Geoffrey Michael,1,0,32,31
1657105275189,MATH 109,B02,083216,Ganzberger; Geoffrey Michael,1,0,32,31
1657105275189,MATH 109,B03,093479,Ganzberger; Geoffrey Michael,6,0,32,26
1657105281214,MATH 142A,A01,083219,Chow; Bennett,6,0,32,26
1657105281214,MATH 142A,A02,083220,Chow; Bennett,10,0,32,22
1657105281214,MATH 142A,A03,093480,Chow; Bennett,7,0,32,25
1657105281214,MATH 142A,B03,093481,Chow; Bennett,8,0,32,24
1657105281214,MATH 142A,B04,093558,Chow; Bennett,11,0,32,21
1657105281214,MATH 142A,B05,093559,Chow; Bennett,6,0,32,26
1657105287238,MATH 193A,A01,083224,Rotar; Vladimir,7,0,34,27
1657105287238,MATH 193A,A02,083225,Rotar; Vladimir,5,0,34,29
1657105287238,MATH 193A,A03,083781,Rotar; Vladimir,1,0,34,33
1657105287238,MATH 193A,A04,083782,Rotar; Vladimir,6,0,34,28
1657105287238,MATH 193A,A05,093482,Rotar; Vladimir,6,0,34,28
1657105293264,MATH 197,001,091859,McAuley; Julian John,9999,0,9999,0
1657105293264,MATH 197,002,095566,Kedlaya; Kiran S.,9997,0,9999,2
1657105293264,MATH 197,003,095567,Xiao; Ming,9999,0,9999,0
1657105293264,MATH 197,004,095571,Perols; Johan Lars,9998,0,9999,1
1657105300321,COGS 9,A01,083615,Shannon; Kyle Michael,7,0,75,68
1657105306344,COGS 11,A01,083617,Boyle; Mary E. T.,21,0,48,27
1657105312371,COGS 13,A01,083071,Bastos; Amalia Pinkusfeld,9,0,71,62
1657105318397,COGS 14A,A01,092681,Semenuks; Arturs,1,1,100,99
1657105324423,COGS 14B,A01,083073,Cheng; Tzu-Han,6,0,63,57
1657105330450,COGS 17,A01,092677,Semenuks; Arturs,4,0,81,77
1657105336477,COGS 100,A01,083619,Allen; Michael Gordon,15,0,70,55
1657105342500,COGS 101A,A01,083621,Davis; Joshua Daniel,9,0,68,59
1657105348522,COGS 101B,A01,091572,Allen; Michael Gordon,8,0,65,57
1657105354544,COGS 101C,A01,083625,Delgado; Tania,17,0,35,18
1657105360568,COGS 107A,A01,083627,Boyle; Mary E. T.,13,0,60,47
1657105366592,COGS 118A,A01,083075,Gupta; Anjum,15,0,76,61
1657105372623,CSE 3,A50,083646,Miranda; Gregory Joseph,22,0,50,28
1657105378651,CSE 8A,A50,083650,Miranda; Gregory Joseph,17,1,56,39
1657105384673,CSE 11,A01,083080,Cao; Yingjun,4,15,40,36
1657105390695,CSE 12,A01,083652,Krause-Levy; Sophia Louisa,23,1,120,97
1657105396720,CSE 15L,A01,083654,Morris; Justin Loren,9,0,50,41
1657105396720,CSE 15L,A02,083655,Morris; Justin Loren,9,0,50,41
1657105402747,CSE 20,A01,083657,Tran; Khoa Dang,37,0,80,43
1657105408771,CSE 21,A01,095574,Bach; Quang Tran,21,0,48,27
1657105414897,CSE 30,A01,083084,Eldon; John,4,0,80,76
1657105414897,CSE 30,B01,095061,Bhaskar; Nishant,6,0,50,44
1657105420936,CSE 100,A01,083659,Cao; Yingjun,4,4,70,66
1657105426960,CSE 134B,A01,083661,Powell; Thomas Allan,19,0,100,81
1657105432987,CSE 140,A01,083663,Gungor; Onat,14,0,85,71
1657105439012,CSE 140L,A01,083088,Eldon; John,16,0,100,84
1657105445040,CSE 175,A01,083665,Kumar; Rakesh,3,0,25,22
1657105451070,CSE 190,A00,092507,Dubnov; Shlomo,7,0,20,13
1657105457094,ECE 45,A01,083139,Congero; Spencer William,5,0,75,70
1657105463134,ECE 65,A50,083695,Saad; Andrew S,12,0,30,18
1657105463134,ECE 65,A51,095125,Saad; Andrew S,25,0,26,1
1657105469158,ECE 109,A01,091882,Touri; Behrouz,16,0,70,54
1657105475182,ECE 180,A00,083140,Abi Samra; Nicholas Camill,1,0,30,29
1657105475182,ECE 180,B00,083141,Abi Samra; Nicholas Camill,0,0,30,30
1657105481213,MATH 10A,A01,083735,Patchell; Gregory David,1,0,30,29
1657105481213,MATH 10A,A02,083736,Patchell; Gregory David,20,0,30,10
1657105481213,MATH 10A,A03,083737,Patchell; Gregory David,16,0,30,14
