time,subj_course_id,sec_code,sec_id,prof,available,waitlist,total,enrolled_ct
1657278838689,COGS 9,A01,083615,Shannon; Kyle Michael,8,0,75,67
1657278844720,COGS 11,A01,083617,Boyle; Mary E. T.,22,0,48,26
1657278850758,COGS 13,A01,083071,Bastos; Amalia Pinkusfeld,9,0,71,62
1657278856801,COGS 14A,A01,092681,Semenuks; Arturs,2,1,100,98
1657278862837,COGS 14B,A01,083073,Cheng; Tzu-Han,6,0,63,57
1657278868872,COGS 17,A01,092677,Semenuks; Arturs,5,0,81,76
1657278874909,COGS 100,A01,083619,Allen; Michael Gordon,16,0,70,54
1657278880946,COGS 101A,A01,083621,Davis; Joshua Daniel,9,0,68,59
1657278886977,COGS 101B,A01,091572,Allen; Michael Gordon,11,0,65,54
1657278893011,COGS 101C,A01,083625,Delgado; Tania,17,0,35,18
1657278899044,COGS 107A,A01,083627,Boyle; Mary E. T.,13,0,60,47
1657278905070,COGS 118A,A01,083075,Gupta; Anjum,18,0,76,58
1657278911109,CSE 3,A50,083646,Miranda; Gregory Joseph,24,0,50,26
1657278917144,CSE 8A,A50,083650,Miranda; Gregory Joseph,17,1,56,39
1657278923176,CSE 11,A01,083080,Cao; Yingjun,5,15,40,35
1657278929210,CSE 12,A01,083652,Krause-Levy; Sophia Louisa,26,1,120,94
1657278935244,CSE 15L,A01,083654,Morris; Justin Loren,9,0,50,41
1657278935244,CSE 15L,A02,083655,Morris; Justin Loren,9,0,50,41
1657278941276,CSE 20,A01,083657,Tran; Khoa Dang,38,0,80,42
1657278947312,CSE 21,A01,095574,Bach; Quang Tran,22,0,48,26
1657278953346,CSE 30,A01,083084,Eldon; John,4,0,80,76
1657278953346,CSE 30,B01,095061,Bhaskar; Nishant,8,0,50,42
1657278959389,CSE 100,A01,083659,Cao; Yingjun,4,4,70,66
1657278965473,CSE 134B,A01,083661,Powell; Thomas Allan,21,0,100,79
1657278971511,CSE 140,A01,083663,Gungor; Onat,13,0,85,72
1657278977548,CSE 140L,A01,083088,Eldon; John,19,0,100,81
1657278983591,CSE 175,A01,083665,Kumar; Rakesh,3,0,25,22
1657278989629,CSE 190,A00,092507,Dubnov; Shlomo,7,0,20,13
1657278995659,ECE 45,A01,083139,Congero; Spencer William,5,0,75,70
1657279001701,ECE 65,A50,083695,Saad; Andrew S,12,0,30,18
1657279001701,ECE 65,A51,095125,Saad; Andrew S,25,0,26,1
1657279007733,ECE 109,A01,091882,Touri; Behrouz,19,0,70,51
1657279013804,ECE 180,A00,083140,Abi Samra; Nicholas Camill,1,0,30,29
1657279013804,ECE 180,B00,083141,Abi Samra; Nicholas Camill,0,0,30,30
1657279019839,MATH 10A,A01,083735,Patchell; Gregory David,2,0,30,28
1657279019839,MATH 10A,A02,083736,Patchell; Gregory David,20,0,30,10
1657279019839,MATH 10A,A03,083737,Patchell; Gregory David,16,0,30,14
1657279025885,MATH 10B,A01,083207,Lim; Seonhee,7,0,34,27
1657279025885,MATH 10B,A02,083208,Lim; Seonhee,9,0,35,26
1657279025885,MATH 10B,A03,093472,Lim; Seonhee,5,0,34,29
1657279025885,MATH 10B,B01,083739,Sinha; Shubham,11,0,30,19
1657279031937,MATH 18,A01,083743,Cinel; Cameron Alexander,6,0,30,24
1657279031937,MATH 18,A02,083744,Cinel; Cameron Alexander,17,0,30,13
1657279031937,MATH 18,A03,083745,Cinel; Cameron Alexander,8,0,30,22
1657279031937,MATH 18,B01,083748,Rideout; David Porter,4,0,37,33
1657279031937,MATH 18,B02,083749,Rideout; David Porter,4,0,36,32
1657279031937,MATH 18,B03,083750,Rideout; David Porter,2,0,37,35
1657279031937,MATH 18,B04,083751,Rideout; David Porter,6,0,36,30
1657279031937,MATH 18,B05,093473,Rideout; David Porter,5,0,36,31
1657279031937,MATH 18,B06,093474,Rideout; David Porter,5,0,36,31
1657279037973,MATH 20A,A01,083754,Zheng; Zequn,14,0,40,26
1657279044008,MATH 20B,A01,083756,Briones; Jor-el Thomas Caparas,3,0,36,33
1657279044008,MATH 20B,A02,083757,Briones; Jor-el Thomas Caparas,1,0,36,35
1657279044008,MATH 20B,A03,093475,Briones; Jor-el Thomas Caparas,2,0,36,34
1657279050050,MATH 20C,A01,083760,Briones; Jor-el Thomas Caparas,1,0,35,34
1657279050050,MATH 20C,A02,083761,Briones; Jor-el Thomas Caparas,8,0,35,27
1657279050050,MATH 20C,A03,093476,Briones; Jor-el Thomas Caparas,0,1,36,36
1657279050050,MATH 20C,B01,083762,Bach; Quang Tran,1,0,30,29
1657279056092,MATH 20D,A01,083765,Tran; Brian Kha,5,0,30,25
1657279056092,MATH 20D,A02,083766,Tran; Brian Kha,5,0,30,25
1657279056092,MATH 20D,A03,083767,Tran; Brian Kha,4,0,30,26
1657279062123,MATH 20E,A01,083771,Ganguly; Soumya,7,0,32,25
1657279062123,MATH 20E,A02,083772,Ganguly; Soumya,7,0,32,25
1657279062123,MATH 20E,B01,083773,Ciotti; Benjamin,19,0,35,16
1657279062123,MATH 20E,B02,083774,Ciotti; Benjamin,17,0,35,18
1657279068174,MATH 103A,A01,083777,Greenfeld; Be'Eri,3,0,36,33
1657279068174,MATH 103A,A02,083778,Greenfeld; Be'Eri,5,0,36,31
1657279068174,MATH 103A,A03,093561,Greenfeld; Be'Eri,4,0,36,32
1657279068174,MATH 103A,B01,083779,Greenfeld; Be'Eri,6,0,36,30
1657279068174,MATH 103A,B02,083780,Greenfeld; Be'Eri,3,0,36,33
1657279068174,MATH 103A,B03,093562,Greenfeld; Be'Eri,3,0,36,33
1657279074212,MATH 105,A01,085443,Carter; Anne Toulson,15,0,35,20
1657279074212,MATH 105,A02,093477,Carter; Anne Toulson,20,0,35,15
1657279080248,MATH 109,A01,083213,Ganzberger; Geoffrey Michael,2,0,34,32
1657279080248,MATH 109,A02,083214,Ganzberger; Geoffrey Michael,4,0,34,30
1657279080248,MATH 109,A03,093478,Ganzberger; Geoffrey Michael,2,0,34,32
1657279080248,MATH 109,B01,083215,Ganzberger; Geoffrey Michael,1,0,32,31
1657279080248,MATH 109,B02,083216,Ganzberger; Geoffrey Michael,1,0,32,31
1657279080248,MATH 109,B03,093479,Ganzberger; Geoffrey Michael,8,0,32,24
1657279086283,MATH 142A,A01,083219,Chow; Bennett,7,0,32,25
1657279086283,MATH 142A,A02,083220,Chow; Bennett,10,0,32,22
1657279086283,MATH 142A,A03,093480,Chow; Bennett,7,0,32,25
1657279086283,MATH 142A,B03,093481,Chow; Bennett,8,0,32,24
1657279086283,MATH 142A,B04,093558,Chow; Bennett,12,0,32,20
1657279086283,MATH 142A,B05,093559,Chow; Bennett,6,0,32,26
1657279092315,MATH 193A,A01,083224,Rotar; Vladimir,7,0,34,27
1657279092315,MATH 193A,A02,083225,Rotar; Vladimir,6,0,34,28
1657279092315,MATH 193A,A03,083781,Rotar; Vladimir,2,0,34,32
1657279092315,MATH 193A,A04,083782,Rotar; Vladimir,8,0,34,26
1657279092315,MATH 193A,A05,093482,Rotar; Vladimir,6,0,34,28
1657279098344,MATH 197,001,091859,McAuley; Julian John,9999,0,9999,0
1657279098344,MATH 197,002,095566,Kedlaya; Kiran S.,9997,0,9999,2
1657279098344,MATH 197,003,095567,Xiao; Ming,9999,0,9999,0
1657279098344,MATH 197,004,095571,Perols; Johan Lars,9998,0,9999,1
1657279105498,COGS 9,A01,083615,Shannon; Kyle Michael,8,0,75,67
1657279111525,COGS 11,A01,083617,Boyle; Mary E. T.,22,0,48,26
1657279117559,COGS 13,A01,083071,Bastos; Amalia Pinkusfeld,9,0,71,62
1657279123596,COGS 14A,A01,092681,Semenuks; Arturs,2,1,100,98
1657279129631,COGS 14B,A01,083073,Cheng; Tzu-Han,6,0,63,57
1657279135664,COGS 17,A01,092677,Semenuks; Arturs,5,0,81,76
1657279141692,COGS 100,A01,083619,Allen; Michael Gordon,16,0,70,54
1657279147721,COGS 101A,A01,083621,Davis; Joshua Daniel,9,0,68,59
1657279158475,COGS 101B,A01,091572,Allen; Michael Gordon,11,0,65,54
1657279164510,COGS 101C,A01,083625,Delgado; Tania,17,0,35,18
1657279178954,COGS 107A,A01,083627,Boyle; Mary E. T.,13,0,60,47
1657279184989,COGS 118A,A01,083075,Gupta; Anjum,18,0,76,58
1657279191041,CSE 3,A50,083646,Miranda; Gregory Joseph,24,0,50,26
1657279197374,CSE 8A,A50,083650,Miranda; Gregory Joseph,17,1,56,39
1657279203416,CSE 11,A01,083080,Cao; Yingjun,5,15,40,35
1657279209446,CSE 12,A01,083652,Krause-Levy; Sophia Louisa,26,1,120,94
1657279215491,CSE 15L,A01,083654,Morris; Justin Loren,9,0,50,41
1657279215491,CSE 15L,A02,083655,Morris; Justin Loren,9,0,50,41
1657279221526,CSE 20,A01,083657,Tran; Khoa Dang,38,0,80,42
1657279227559,CSE 21,A01,095574,Bach; Quang Tran,22,0,48,26
1657279233604,CSE 30,A01,083084,Eldon; John,4,0,80,76
1657279233604,CSE 30,B01,095061,Bhaskar; Nishant,8,0,50,42
1657279239638,CSE 100,A01,083659,Cao; Yingjun,4,4,70,66
1657279245669,CSE 134B,A01,083661,Powell; Thomas Allan,21,0,100,79
1657279251702,CSE 140,A01,083663,Gungor; Onat,13,0,85,72
1657279257738,CSE 140L,A01,083088,Eldon; John,19,0,100,81
1657279263773,CSE 175,A01,083665,Kumar; Rakesh,3,0,25,22
1657279269806,CSE 190,A00,092507,Dubnov; Shlomo,7,0,20,13
1657279275846,ECE 45,A01,083139,Congero; Spencer William,5,0,75,70
1657279281880,ECE 65,A50,083695,Saad; Andrew S,12,0,30,18
1657279281880,ECE 65,A51,095125,Saad; Andrew S,25,0,26,1
1657279287914,ECE 109,A01,091882,Touri; Behrouz,19,0,70,51
1657279293951,ECE 180,A00,083140,Abi Samra; Nicholas Camill,1,0,30,29
1657279293951,ECE 180,B00,083141,Abi Samra; Nicholas Camill,0,0,30,30
1657279299985,MATH 10A,A01,083735,Patchell; Gregory David,2,0,30,28
1657279299985,MATH 10A,A02,083736,Patchell; Gregory David,20,0,30,10
1657279299985,MATH 10A,A03,083737,Patchell; Gregory David,16,0,30,14
1657279306031,MATH 10B,A01,083207,Lim; Seonhee,7,0,34,27
1657279306031,MATH 10B,A02,083208,Lim; Seonhee,9,0,35,26
1657279306031,MATH 10B,A03,093472,Lim; Seonhee,5,0,34,29
1657279306031,MATH 10B,B01,083739,Sinha; Shubham,11,0,30,19
1657279312080,MATH 18,A01,083743,Cinel; Cameron Alexander,6,0,30,24
1657279312080,MATH 18,A02,083744,Cinel; Cameron Alexander,17,0,30,13
1657279312080,MATH 18,A03,083745,Cinel; Cameron Alexander,8,0,30,22
1657279312080,MATH 18,B01,083748,Rideout; David Porter,4,0,37,33
1657279312080,MATH 18,B02,083749,Rideout; David Porter,4,0,36,32
1657279312080,MATH 18,B03,083750,Rideout; David Porter,2,0,37,35
1657279312080,MATH 18,B04,083751,Rideout; David Porter,6,0,36,30
1657279312080,MATH 18,B05,093473,Rideout; David Porter,5,0,36,31
1657279312080,MATH 18,B06,093474,Rideout; David Porter,5,0,36,31
1657279318112,MATH 20A,A01,083754,Zheng; Zequn,14,0,40,26
1657279324154,MATH 20B,A01,083756,Briones; Jor-el Thomas Caparas,3,0,36,33
1657279324154,MATH 20B,A02,083757,Briones; Jor-el Thomas Caparas,1,0,36,35
1657279324154,MATH 20B,A03,093475,Briones; Jor-el Thomas Caparas,2,0,36,34
1657279330195,MATH 20C,A01,083760,Briones; Jor-el Thomas Caparas,1,0,35,34
1657279330195,MATH 20C,A02,083761,Briones; Jor-el Thomas Caparas,8,0,35,27
1657279330195,MATH 20C,A03,093476,Briones; Jor-el Thomas Caparas,0,1,36,36
1657279330195,MATH 20C,B01,083762,Bach; Quang Tran,1,0,30,29
1657279336234,MATH 20D,A01,083765,Tran; Brian Kha,5,0,30,25
1657279336234,MATH 20D,A02,083766,Tran; Brian Kha,5,0,30,25
1657279336234,MATH 20D,A03,083767,Tran; Brian Kha,4,0,30,26
1657279342268,MATH 20E,A01,083771,Ganguly; Soumya,7,0,32,25
1657279342268,MATH 20E,A02,083772,Ganguly; Soumya,7,0,32,25
1657279342268,MATH 20E,B01,083773,Ciotti; Benjamin,19,0,35,16
1657279342268,MATH 20E,B02,083774,Ciotti; Benjamin,17,0,35,18
1657279348304,MATH 103A,A01,083777,Greenfeld; Be'Eri,3,0,36,33
1657279348304,MATH 103A,A02,083778,Greenfeld; Be'Eri,5,0,36,31
1657279348304,MATH 103A,A03,093561,Greenfeld; Be'Eri,4,0,36,32
1657279348304,MATH 103A,B01,083779,Greenfeld; Be'Eri,6,0,36,30
1657279348304,MATH 103A,B02,083780,Greenfeld; Be'Eri,3,0,36,33
1657279348304,MATH 103A,B03,093562,Greenfeld; Be'Eri,3,0,36,33
1657279354336,MATH 105,A01,085443,Carter; Anne Toulson,15,0,35,20
1657279354336,MATH 105,A02,093477,Carter; Anne Toulson,20,0,35,15
1657279360376,MATH 109,A01,083213,Ganzberger; Geoffrey Michael,2,0,34,32
1657279360376,MATH 109,A02,083214,Ganzberger; Geoffrey Michael,4,0,34,30
1657279360376,MATH 109,A03,093478,Ganzberger; Geoffrey Michael,2,0,34,32
1657279360376,MATH 109,B01,083215,Ganzberger; Geoffrey Michael,1,0,32,31
1657279360376,MATH 109,B02,083216,Ganzberger; Geoffrey Michael,1,0,32,31
1657279360376,MATH 109,B03,093479,Ganzberger; Geoffrey Michael,8,0,32,24
1657279366407,MATH 142A,A01,083219,Chow; Bennett,7,0,32,25
1657279366407,MATH 142A,A02,083220,Chow; Bennett,10,0,32,22
1657279366407,MATH 142A,A03,093480,Chow; Bennett,7,0,32,25
1657279366407,MATH 142A,B03,093481,Chow; Bennett,8,0,32,24
1657279366407,MATH 142A,B04,093558,Chow; Bennett,12,0,32,20
1657279366407,MATH 142A,B05,093559,Chow; Bennett,6,0,32,26
1657279372449,MATH 193A,A01,083224,Rotar; Vladimir,7,0,34,27
1657279372449,MATH 193A,A02,083225,Rotar; Vladimir,6,0,34,28
1657279372449,MATH 193A,A03,083781,Rotar; Vladimir,2,0,34,32
1657279372449,MATH 193A,A04,083782,Rotar; Vladimir,8,0,34,26
1657279372449,MATH 193A,A05,093482,Rotar; Vladimir,6,0,34,28
1657279378487,MATH 197,001,091859,McAuley; Julian John,9999,0,9999,0
1657279378487,MATH 197,002,095566,Kedlaya; Kiran S.,9997,0,9999,2
1657279378487,MATH 197,003,095567,Xiao; Ming,9999,0,9999,0
1657279378487,MATH 197,004,095571,Perols; Johan Lars,9998,0,9999,1
1657279385575,COGS 9,A01,083615,Shannon; Kyle Michael,8,0,75,67
1657279391612,COGS 11,A01,083617,Boyle; Mary E. T.,22,0,48,26
1657279397645,COGS 13,A01,083071,Bastos; Amalia Pinkusfeld,9,0,71,62
1657279403681,COGS 14A,A01,092681,Semenuks; Arturs,2,1,100,98
1657279409716,COGS 14B,A01,083073,Cheng; Tzu-Han,6,0,63,57
1657279415767,COGS 17,A01,092677,Semenuks; Arturs,5,0,81,76
1657279421796,COGS 100,A01,083619,Allen; Michael Gordon,16,0,70,54
1657279427903,COGS 101A,A01,083621,Davis; Joshua Daniel,9,0,68,59
1657279433932,COGS 101B,A01,091572,Allen; Michael Gordon,11,0,65,54
1657279439962,COGS 101C,A01,083625,Delgado; Tania,17,0,35,18
1657279445990,COGS 107A,A01,083627,Boyle; Mary E. T.,13,0,60,47
1657279452024,COGS 118A,A01,083075,Gupta; Anjum,18,0,76,58
1657279458063,CSE 3,A50,083646,Miranda; Gregory Joseph,24,0,50,26
1657279464095,CSE 8A,A50,083650,Miranda; Gregory Joseph,17,1,56,39
1657279470129,CSE 11,A01,083080,Cao; Yingjun,5,15,40,35
1657279476159,CSE 12,A01,083652,Krause-Levy; Sophia Louisa,26,1,120,94
1657279482193,CSE 15L,A01,083654,Morris; Justin Loren,9,0,50,41
1657279482193,CSE 15L,A02,083655,Morris; Justin Loren,9,0,50,41
1657279488229,CSE 20,A01,083657,Tran; Khoa Dang,38,0,80,42
1657279494266,CSE 21,A01,095574,Bach; Quang Tran,22,0,48,26
1657279500297,CSE 30,A01,083084,Eldon; John,4,0,80,76
1657279500297,CSE 30,B01,095061,Bhaskar; Nishant,8,0,50,42
1657279506327,CSE 100,A01,083659,Cao; Yingjun,4,4,70,66
1657279512359,CSE 134B,A01,083661,Powell; Thomas Allan,21,0,100,79
1657279518389,CSE 140,A01,083663,Gungor; Onat,13,0,85,72
1657279524422,CSE 140L,A01,083088,Eldon; John,19,0,100,81
1657279530452,CSE 175,A01,083665,Kumar; Rakesh,3,0,25,22
1657279536482,CSE 190,A00,092507,Dubnov; Shlomo,7,0,20,13
1657279542509,ECE 45,A01,083139,Congero; Spencer William,5,0,75,70
1657279548538,ECE 65,A50,083695,Saad; Andrew S,12,0,30,18
1657279548538,ECE 65,A51,095125,Saad; Andrew S,25,0,26,1
1657279554567,ECE 109,A01,091882,Touri; Behrouz,19,0,70,51
1657279560597,ECE 180,A00,083140,Abi Samra; Nicholas Camill,1,0,30,29
1657279560597,ECE 180,B00,083141,Abi Samra; Nicholas Camill,0,0,30,30
1657279566627,MATH 10A,A01,083735,Patchell; Gregory David,2,0,30,28
1657279566627,MATH 10A,A02,083736,Patchell; Gregory David,20,0,30,10
1657279566627,MATH 10A,A03,083737,Patchell; Gregory David,16,0,30,14
1657279572665,MATH 10B,A01,083207,Lim; Seonhee,7,0,34,27
1657279572665,MATH 10B,A02,083208,Lim; Seonhee,9,0,35,26
1657279572665,MATH 10B,A03,093472,Lim; Seonhee,5,0,34,29
1657279572665,MATH 10B,B01,083739,Sinha; Shubham,11,0,30,19
1657279578695,MATH 18,A01,083743,Cinel; Cameron Alexander,6,0,30,24
1657279578695,MATH 18,A02,083744,Cinel; Cameron Alexander,17,0,30,13
1657279578695,MATH 18,A03,083745,Cinel; Cameron Alexander,8,0,30,22
1657279578695,MATH 18,B01,083748,Rideout; David Porter,4,0,37,33
1657279578695,MATH 18,B02,083749,Rideout; David Porter,4,0,36,32
1657279578695,MATH 18,B03,083750,Rideout; David Porter,2,0,37,35
1657279578695,MATH 18,B04,083751,Rideout; David Porter,6,0,36,30
1657279578695,MATH 18,B05,093473,Rideout; David Porter,5,0,36,31
1657279578695,MATH 18,B06,093474,Rideout; David Porter,5,0,36,31
1657279584730,MATH 20A,A01,083754,Zheng; Zequn,14,0,40,26
1657279590761,MATH 20B,A01,083756,Briones; Jor-el Thomas Caparas,3,0,36,33
1657279590761,MATH 20B,A02,083757,Briones; Jor-el Thomas Caparas,1,0,36,35
1657279590761,MATH 20B,A03,093475,Briones; Jor-el Thomas Caparas,2,0,36,34
1657279596793,MATH 20C,A01,083760,Briones; Jor-el Thomas Caparas,1,0,35,34
1657279596793,MATH 20C,A02,083761,Briones; Jor-el Thomas Caparas,8,0,35,27
1657279596793,MATH 20C,A03,093476,Briones; Jor-el Thomas Caparas,0,1,36,36
1657279596793,MATH 20C,B01,083762,Bach; Quang Tran,1,0,30,29
1657279602827,MATH 20D,A01,083765,Tran; Brian Kha,5,0,30,25
1657279602827,MATH 20D,A02,083766,Tran; Brian Kha,5,0,30,25
1657279602827,MATH 20D,A03,083767,Tran; Brian Kha,4,0,30,26
1657279608865,MATH 20E,A01,083771,Ganguly; Soumya,7,0,32,25
1657279608865,MATH 20E,A02,083772,Ganguly; Soumya,7,0,32,25
1657279608865,MATH 20E,B01,083773,Ciotti; Benjamin,19,0,35,16
1657279608865,MATH 20E,B02,083774,Ciotti; Benjamin,17,0,35,18
1657279614905,MATH 103A,A01,083777,Greenfeld; Be'Eri,3,0,36,33
1657279614905,MATH 103A,A02,083778,Greenfeld; Be'Eri,5,0,36,31
1657279614905,MATH 103A,A03,093561,Greenfeld; Be'Eri,4,0,36,32
1657279614905,MATH 103A,B01,083779,Greenfeld; Be'Eri,6,0,36,30
1657279614905,MATH 103A,B02,083780,Greenfeld; Be'Eri,3,0,36,33
1657279614905,MATH 103A,B03,093562,Greenfeld; Be'Eri,3,0,36,33
1657279620941,MATH 105,A01,085443,Carter; Anne Toulson,15,0,35,20
1657279620941,MATH 105,A02,093477,Carter; Anne Toulson,20,0,35,15
1657279626970,MATH 109,A01,083213,Ganzberger; Geoffrey Michael,2,0,34,32
1657279626970,MATH 109,A02,083214,Ganzberger; Geoffrey Michael,4,0,34,30
1657279626970,MATH 109,A03,093478,Ganzberger; Geoffrey Michael,2,0,34,32
1657279626970,MATH 109,B01,083215,Ganzberger; Geoffrey Michael,1,0,32,31
1657279626970,MATH 109,B02,083216,Ganzberger; Geoffrey Michael,1,0,32,31
1657279626970,MATH 109,B03,093479,Ganzberger; Geoffrey Michael,8,0,32,24
1657279633001,MATH 142A,A01,083219,Chow; Bennett,7,0,32,25
1657279633001,MATH 142A,A02,083220,Chow; Bennett,10,0,32,22
1657279633001,MATH 142A,A03,093480,Chow; Bennett,7,0,32,25
1657279633001,MATH 142A,B03,093481,Chow; Bennett,8,0,32,24
1657279633001,MATH 142A,B04,093558,Chow; Bennett,12,0,32,20
1657279633001,MATH 142A,B05,093559,Chow; Bennett,6,0,32,26
1657279639030,MATH 193A,A01,083224,Rotar; Vladimir,7,0,34,27
1657279639030,MATH 193A,A02,083225,Rotar; Vladimir,6,0,34,28
1657279639030,MATH 193A,A03,083781,Rotar; Vladimir,2,0,34,32
1657279639030,MATH 193A,A04,083782,Rotar; Vladimir,8,0,34,26
1657279639030,MATH 193A,A05,093482,Rotar; Vladimir,6,0,34,28
1657279645077,MATH 197,001,091859,McAuley; Julian John,9999,0,9999,0
1657279645077,MATH 197,002,095566,Kedlaya; Kiran S.,9997,0,9999,2
1657279645077,MATH 197,003,095567,Xiao; Ming,9999,0,9999,0
1657279645077,MATH 197,004,095571,Perols; Johan Lars,9998,0,9999,1
1657279652156,COGS 9,A01,083615,Shannon; Kyle Michael,8,0,75,67
1657279658189,COGS 11,A01,083617,Boyle; Mary E. T.,22,0,48,26
1657279664221,COGS 13,A01,083071,Bastos; Amalia Pinkusfeld,9,0,71,62
1657279670251,COGS 14A,A01,092681,Semenuks; Arturs,2,1,100,98
1657279676286,COGS 14B,A01,083073,Cheng; Tzu-Han,6,0,63,57
1657279682313,COGS 17,A01,092677,Semenuks; Arturs,5,0,81,76
1657279688345,COGS 100,A01,083619,Allen; Michael Gordon,16,0,70,54
1657279694381,COGS 101A,A01,083621,Davis; Joshua Daniel,9,0,68,59
1657279700416,COGS 101B,A01,091572,Allen; Michael Gordon,11,0,65,54
1657279706452,COGS 101C,A01,083625,Delgado; Tania,17,0,35,18
1657279712486,COGS 107A,A01,083627,Boyle; Mary E. T.,13,0,60,47
1657279718514,COGS 118A,A01,083075,Gupta; Anjum,18,0,76,58
1657279724543,CSE 3,A50,083646,Miranda; Gregory Joseph,24,0,50,26
1657279730570,CSE 8A,A50,083650,Miranda; Gregory Joseph,17,1,56,39
1657279736600,CSE 11,A01,083080,Cao; Yingjun,5,15,40,35
1657279742634,CSE 12,A01,083652,Krause-Levy; Sophia Louisa,26,1,120,94
1657279748668,CSE 15L,A01,083654,Morris; Justin Loren,9,0,50,41
1657279748668,CSE 15L,A02,083655,Morris; Justin Loren,9,0,50,41
1657279754705,CSE 20,A01,083657,Tran; Khoa Dang,38,0,80,42
1657279760735,CSE 21,A01,095574,Bach; Quang Tran,22,0,48,26
1657279766767,CSE 30,A01,083084,Eldon; John,4,0,80,76
1657279766767,CSE 30,B01,095061,Bhaskar; Nishant,8,0,50,42
1657279772796,CSE 100,A01,083659,Cao; Yingjun,4,4,70,66
1657279778825,CSE 134B,A01,083661,Powell; Thomas Allan,21,0,100,79
1657279784855,CSE 140,A01,083663,Gungor; Onat,13,0,85,72
1657279790884,CSE 140L,A01,083088,Eldon; John,19,0,100,81
1657279796916,CSE 175,A01,083665,Kumar; Rakesh,3,0,25,22
1657279802947,CSE 190,A00,092507,Dubnov; Shlomo,7,0,20,13
1657279808980,ECE 45,A01,083139,Congero; Spencer William,5,0,75,70
1657279815009,ECE 65,A50,083695,Saad; Andrew S,12,0,30,18
1657279815009,ECE 65,A51,095125,Saad; Andrew S,25,0,26,1
1657279821035,ECE 109,A01,091882,Touri; Behrouz,19,0,70,51
1657279827065,ECE 180,A00,083140,Abi Samra; Nicholas Camill,1,0,30,29
1657279827065,ECE 180,B00,083141,Abi Samra; Nicholas Camill,0,0,30,30
1657279833092,MATH 10A,A01,083735,Patchell; Gregory David,2,0,30,28
1657279833092,MATH 10A,A02,083736,Patchell; Gregory David,20,0,30,10
1657279833092,MATH 10A,A03,083737,Patchell; Gregory David,16,0,30,14
1657279839130,MATH 10B,A01,083207,Lim; Seonhee,7,0,34,27
1657279839130,MATH 10B,A02,083208,Lim; Seonhee,9,0,35,26
1657279839130,MATH 10B,A03,093472,Lim; Seonhee,5,0,34,29
1657279839130,MATH 10B,B01,083739,Sinha; Shubham,11,0,30,19
1657279845166,MATH 18,A01,083743,Cinel; Cameron Alexander,6,0,30,24
1657279845166,MATH 18,A02,083744,Cinel; Cameron Alexander,17,0,30,13
1657279845166,MATH 18,A03,083745,Cinel; Cameron Alexander,8,0,30,22
1657279845166,MATH 18,B01,083748,Rideout; David Porter,4,0,37,33
1657279845166,MATH 18,B02,083749,Rideout; David Porter,4,0,36,32
1657279845166,MATH 18,B03,083750,Rideout; David Porter,2,0,37,35
1657279845166,MATH 18,B04,083751,Rideout; David Porter,6,0,36,30
1657279845166,MATH 18,B05,093473,Rideout; David Porter,5,0,36,31
1657279845166,MATH 18,B06,093474,Rideout; David Porter,5,0,36,31
1657279851198,MATH 20A,A01,083754,Zheng; Zequn,14,0,40,26
1657279857236,MATH 20B,A01,083756,Briones; Jor-el Thomas Caparas,3,0,36,33
1657279857236,MATH 20B,A02,083757,Briones; Jor-el Thomas Caparas,1,0,36,35
1657279857236,MATH 20B,A03,093475,Briones; Jor-el Thomas Caparas,2,0,36,34
1657279863267,MATH 20C,A01,083760,Briones; Jor-el Thomas Caparas,1,0,35,34
1657279863267,MATH 20C,A02,083761,Briones; Jor-el Thomas Caparas,8,0,35,27
1657279863267,MATH 20C,A03,093476,Briones; Jor-el Thomas Caparas,0,1,36,36
1657279863267,MATH 20C,B01,083762,Bach; Quang Tran,1,0,30,29
1657279869305,MATH 20D,A01,083765,Tran; Brian Kha,5,0,30,25
1657279869305,MATH 20D,A02,083766,Tran; Brian Kha,5,0,30,25
1657279869305,MATH 20D,A03,083767,Tran; Brian Kha,4,0,30,26
1657279875343,MATH 20E,A01,083771,Ganguly; Soumya,7,0,32,25
1657279875343,MATH 20E,A02,083772,Ganguly; Soumya,7,0,32,25
1657279875343,MATH 20E,B01,083773,Ciotti; Benjamin,19,0,35,16
1657279875343,MATH 20E,B02,083774,Ciotti; Benjamin,17,0,35,18
1657279881389,MATH 103A,A01,083777,Greenfeld; Be'Eri,3,0,36,33
1657279881389,MATH 103A,A02,083778,Greenfeld; Be'Eri,5,0,36,31
1657279881389,MATH 103A,A03,093561,Greenfeld; Be'Eri,4,0,36,32
1657279881389,MATH 103A,B01,083779,Greenfeld; Be'Eri,6,0,36,30
1657279881389,MATH 103A,B02,083780,Greenfeld; Be'Eri,3,0,36,33
1657279881389,MATH 103A,B03,093562,Greenfeld; Be'Eri,3,0,36,33
1657279887418,MATH 105,A01,085443,Carter; Anne Toulson,15,0,35,20
1657279887418,MATH 105,A02,093477,Carter; Anne Toulson,20,0,35,15
1657279893452,MATH 109,A01,083213,Ganzberger; Geoffrey Michael,2,0,34,32
1657279893452,MATH 109,A02,083214,Ganzberger; Geoffrey Michael,4,0,34,30
1657279893452,MATH 109,A03,093478,Ganzberger; Geoffrey Michael,2,0,34,32
1657279893452,MATH 109,B01,083215,Ganzberger; Geoffrey Michael,1,0,32,31
1657279893452,MATH 109,B02,083216,Ganzberger; Geoffrey Michael,1,0,32,31
1657279893452,MATH 109,B03,093479,Ganzberger; Geoffrey Michael,8,0,32,24
1657279899492,MATH 142A,A01,083219,Chow; Bennett,7,0,32,25
1657279899492,MATH 142A,A02,083220,Chow; Bennett,10,0,32,22
1657279899492,MATH 142A,A03,093480,Chow; Bennett,7,0,32,25
1657279899492,MATH 142A,B03,093481,Chow; Bennett,8,0,32,24
1657279899492,MATH 142A,B04,093558,Chow; Bennett,12,0,32,20
1657279899492,MATH 142A,B05,093559,Chow; Bennett,6,0,32,26
1657279905527,MATH 193A,A01,083224,Rotar; Vladimir,7,0,34,27
1657279905527,MATH 193A,A02,083225,Rotar; Vladimir,6,0,34,28
1657279905527,MATH 193A,A03,083781,Rotar; Vladimir,2,0,34,32
1657279905527,MATH 193A,A04,083782,Rotar; Vladimir,8,0,34,26
1657279905527,MATH 193A,A05,093482,Rotar; Vladimir,6,0,34,28
1657279911559,MATH 197,001,091859,McAuley; Julian John,9999,0,9999,0
1657279911559,MATH 197,002,095566,Kedlaya; Kiran S.,9997,0,9999,2
1657279911559,MATH 197,003,095567,Xiao; Ming,9999,0,9999,0
1657279911559,MATH 197,004,095571,Perols; Johan Lars,9998,0,9999,1
1657279918633,COGS 9,A01,083615,Shannon; Kyle Michael,8,0,75,67
1657279924660,COGS 11,A01,083617,Boyle; Mary E. T.,22,0,48,26
1657279930697,COGS 13,A01,083071,Bastos; Amalia Pinkusfeld,9,0,71,62
1657279936728,COGS 14A,A01,092681,Semenuks; Arturs,2,1,100,98
1657279942754,COGS 14B,A01,083073,Cheng; Tzu-Han,6,0,63,57
1657279948786,COGS 17,A01,092677,Semenuks; Arturs,5,0,81,76
1657279954812,COGS 100,A01,083619,Allen; Michael Gordon,16,0,70,54
1657279960842,COGS 101A,A01,083621,Davis; Joshua Daniel,9,0,68,59
1657279966869,COGS 101B,A01,091572,Allen; Michael Gordon,11,0,65,54
1657279972898,COGS 101C,A01,083625,Delgado; Tania,17,0,35,18
1657279978944,COGS 107A,A01,083627,Boyle; Mary E. T.,13,0,60,47
1657279984976,COGS 118A,A01,083075,Gupta; Anjum,18,0,76,58
1657279991006,CSE 3,A50,083646,Miranda; Gregory Joseph,24,0,50,26
1657279997035,CSE 8A,A50,083650,Miranda; Gregory Joseph,17,1,56,39
1657280003063,CSE 11,A01,083080,Cao; Yingjun,5,15,40,35
1657280009091,CSE 12,A01,083652,Krause-Levy; Sophia Louisa,26,1,120,94
1657280015118,CSE 15L,A01,083654,Morris; Justin Loren,9,0,50,41
1657280015118,CSE 15L,A02,083655,Morris; Justin Loren,9,0,50,41
1657280021152,CSE 20,A01,083657,Tran; Khoa Dang,38,0,80,42
1657280027273,CSE 21,A01,095574,Bach; Quang Tran,22,0,48,26
1657280033311,CSE 30,A01,083084,Eldon; John,4,0,80,76
1657280033311,CSE 30,B01,095061,Bhaskar; Nishant,8,0,50,42
1657280039348,CSE 100,A01,083659,Cao; Yingjun,4,4,70,66
1657280045385,CSE 134B,A01,083661,Powell; Thomas Allan,21,0,100,79
1657280051413,CSE 140,A01,083663,Gungor; Onat,13,0,85,72
1657280057446,CSE 140L,A01,083088,Eldon; John,19,0,100,81
1657280063471,CSE 175,A01,083665,Kumar; Rakesh,3,0,25,22
1657280069497,CSE 190,A00,092507,Dubnov; Shlomo,7,0,20,13
1657280075526,ECE 45,A01,083139,Congero; Spencer William,5,0,75,70
1657280081556,ECE 65,A50,083695,Saad; Andrew S,12,0,30,18
1657280081556,ECE 65,A51,095125,Saad; Andrew S,25,0,26,1
1657280087585,ECE 109,A01,091882,Touri; Behrouz,19,0,70,51
1657280093616,ECE 180,A00,083140,Abi Samra; Nicholas Camill,1,0,30,29
1657280093616,ECE 180,B00,083141,Abi Samra; Nicholas Camill,0,0,30,30
1657280099655,MATH 10A,A01,083735,Patchell; Gregory David,2,0,30,28
1657280099655,MATH 10A,A02,083736,Patchell; Gregory David,20,0,30,10
1657280099655,MATH 10A,A03,083737,Patchell; Gregory David,16,0,30,14
1657280105697,MATH 10B,A01,083207,Lim; Seonhee,7,0,34,27
1657280105697,MATH 10B,A02,083208,Lim; Seonhee,9,0,35,26
1657280105697,MATH 10B,A03,093472,Lim; Seonhee,5,0,34,29
1657280105697,MATH 10B,B01,083739,Sinha; Shubham,11,0,30,19
1657280111727,MATH 18,A01,083743,Cinel; Cameron Alexander,6,0,30,24
1657280111727,MATH 18,A02,083744,Cinel; Cameron Alexander,17,0,30,13
1657280111727,MATH 18,A03,083745,Cinel; Cameron Alexander,8,0,30,22
1657280111727,MATH 18,B01,083748,Rideout; David Porter,4,0,37,33
1657280111727,MATH 18,B02,083749,Rideout; David Porter,4,0,36,32
1657280111727,MATH 18,B03,083750,Rideout; David Porter,2,0,37,35
1657280111727,MATH 18,B04,083751,Rideout; David Porter,6,0,36,30
1657280111727,MATH 18,B05,093473,Rideout; David Porter,5,0,36,31
1657280111727,MATH 18,B06,093474,Rideout; David Porter,5,0,36,31
1657280117754,MATH 20A,A01,083754,Zheng; Zequn,14,0,40,26
1657280123790,MATH 20B,A01,083756,Briones; Jor-el Thomas Caparas,3,0,36,33
1657280123790,MATH 20B,A02,083757,Briones; Jor-el Thomas Caparas,1,0,36,35
1657280123790,MATH 20B,A03,093475,Briones; Jor-el Thomas Caparas,2,0,36,34
1657280129830,MATH 20C,A01,083760,Briones; Jor-el Thomas Caparas,1,0,35,34
1657280129830,MATH 20C,A02,083761,Briones; Jor-el Thomas Caparas,8,0,35,27
1657280129830,MATH 20C,A03,093476,Briones; Jor-el Thomas Caparas,0,1,36,36
1657280129830,MATH 20C,B01,083762,Bach; Quang Tran,1,0,30,29
1657280135865,MATH 20D,A01,083765,Tran; Brian Kha,5,0,30,25
1657280135865,MATH 20D,A02,083766,Tran; Brian Kha,5,0,30,25
1657280135865,MATH 20D,A03,083767,Tran; Brian Kha,4,0,30,26
1657280141908,MATH 20E,A01,083771,Ganguly; Soumya,7,0,32,25
1657280141908,MATH 20E,A02,083772,Ganguly; Soumya,7,0,32,25
1657280141908,MATH 20E,B01,083773,Ciotti; Benjamin,19,0,35,16
1657280141908,MATH 20E,B02,083774,Ciotti; Benjamin,17,0,35,18
1657280147938,MATH 103A,A01,083777,Greenfeld; Be'Eri,3,0,36,33
1657280147938,MATH 103A,A02,083778,Greenfeld; Be'Eri,5,0,36,31
1657280147938,MATH 103A,A03,093561,Greenfeld; Be'Eri,4,0,36,32
1657280147938,MATH 103A,B01,083779,Greenfeld; Be'Eri,6,0,36,30
1657280147938,MATH 103A,B02,083780,Greenfeld; Be'Eri,3,0,36,33
1657280147938,MATH 103A,B03,093562,Greenfeld; Be'Eri,3,0,36,33
1657280153967,MATH 105,A01,085443,Carter; Anne Toulson,15,0,35,20
1657280153967,MATH 105,A02,093477,Carter; Anne Toulson,20,0,35,15
1657280160001,MATH 109,A01,083213,Ganzberger; Geoffrey Michael,2,0,34,32
1657280160001,MATH 109,A02,083214,Ganzberger; Geoffrey Michael,4,0,34,30
1657280160001,MATH 109,A03,093478,Ganzberger; Geoffrey Michael,2,0,34,32
1657280160001,MATH 109,B01,083215,Ganzberger; Geoffrey Michael,1,0,32,31
1657280160001,MATH 109,B02,083216,Ganzberger; Geoffrey Michael,1,0,32,31
1657280160001,MATH 109,B03,093479,Ganzberger; Geoffrey Michael,8,0,32,24
1657280166032,MATH 142A,A01,083219,Chow; Bennett,7,0,32,25
1657280166032,MATH 142A,A02,083220,Chow; Bennett,10,0,32,22
1657280166032,MATH 142A,A03,093480,Chow; Bennett,7,0,32,25
1657280166032,MATH 142A,B03,093481,Chow; Bennett,8,0,32,24
1657280166032,MATH 142A,B04,093558,Chow; Bennett,12,0,32,20
1657280166032,MATH 142A,B05,093559,Chow; Bennett,6,0,32,26
1657280172064,MATH 193A,A01,083224,Rotar; Vladimir,7,0,34,27
1657280172064,MATH 193A,A02,083225,Rotar; Vladimir,6,0,34,28
1657280172064,MATH 193A,A03,083781,Rotar; Vladimir,2,0,34,32
1657280172064,MATH 193A,A04,083782,Rotar; Vladimir,8,0,34,26
1657280172064,MATH 193A,A05,093482,Rotar; Vladimir,6,0,34,28
1657280178097,MATH 197,001,091859,McAuley; Julian John,9999,0,9999,0
1657280178097,MATH 197,002,095566,Kedlaya; Kiran S.,9997,0,9999,2
1657280178097,MATH 197,003,095567,Xiao; Ming,9999,0,9999,0
1657280178097,MATH 197,004,095571,Perols; Johan Lars,9998,0,9999,1
1657280185180,COGS 9,A01,083615,Shannon; Kyle Michael,8,0,75,67
1657280191206,COGS 11,A01,083617,Boyle; Mary E. T.,22,0,48,26
1657280197237,COGS 13,A01,083071,Bastos; Amalia Pinkusfeld,9,0,71,62
1657280203264,COGS 14A,A01,092681,Semenuks; Arturs,2,1,100,98
1657280209293,COGS 14B,A01,083073,Cheng; Tzu-Han,6,0,63,57
1657280215325,COGS 17,A01,092677,Semenuks; Arturs,5,0,81,76
1657280221351,COGS 100,A01,083619,Allen; Michael Gordon,16,0,70,54
1657280227385,COGS 101A,A01,083621,Davis; Joshua Daniel,9,0,68,59
1657280233413,COGS 101B,A01,091572,Allen; Michael Gordon,11,0,65,54
1657280239449,COGS 101C,A01,083625,Delgado; Tania,17,0,35,18
1657280245482,COGS 107A,A01,083627,Boyle; Mary E. T.,13,0,60,47
1657280251513,COGS 118A,A01,083075,Gupta; Anjum,18,0,76,58
1657280257544,CSE 3,A50,083646,Miranda; Gregory Joseph,24,0,50,26
1657280263572,CSE 8A,A50,083650,Miranda; Gregory Joseph,17,1,56,39
1657280269601,CSE 11,A01,083080,Cao; Yingjun,5,15,40,35
1657280275636,CSE 12,A01,083652,Krause-Levy; Sophia Louisa,26,1,120,94
1657280281668,CSE 15L,A01,083654,Morris; Justin Loren,9,0,50,41
1657280281668,CSE 15L,A02,083655,Morris; Justin Loren,9,0,50,41
1657280287700,CSE 20,A01,083657,Tran; Khoa Dang,38,0,80,42
1657280293727,CSE 21,A01,095574,Bach; Quang Tran,22,0,48,26
1657280299764,CSE 30,A01,083084,Eldon; John,4,0,80,76
1657280299764,CSE 30,B01,095061,Bhaskar; Nishant,8,0,50,42
1657280305790,CSE 100,A01,083659,Cao; Yingjun,4,4,70,66
1657280311821,CSE 134B,A01,083661,Powell; Thomas Allan,21,0,100,79
1657280317844,CSE 140,A01,083663,Gungor; Onat,13,0,85,72
1657280323879,CSE 140L,A01,083088,Eldon; John,19,0,100,81
1657280329911,CSE 175,A01,083665,Kumar; Rakesh,3,0,25,22
1657280335936,CSE 190,A00,092507,Dubnov; Shlomo,7,0,20,13
1657280341970,ECE 45,A01,083139,Congero; Spencer William,5,0,75,70
1657280347996,ECE 65,A50,083695,Saad; Andrew S,12,0,30,18
1657280347996,ECE 65,A51,095125,Saad; Andrew S,25,0,26,1
1657280354024,ECE 109,A01,091882,Touri; Behrouz,19,0,70,51
1657280360058,ECE 180,A00,083140,Abi Samra; Nicholas Camill,1,0,30,29
1657280360058,ECE 180,B00,083141,Abi Samra; Nicholas Camill,0,0,30,30
1657280366090,MATH 10A,A01,083735,Patchell; Gregory David,2,0,30,28
1657280366090,MATH 10A,A02,083736,Patchell; Gregory David,20,0,30,10
1657280366090,MATH 10A,A03,083737,Patchell; Gregory David,16,0,30,14
1657280372131,MATH 10B,A01,083207,Lim; Seonhee,7,0,34,27
1657280372131,MATH 10B,A02,083208,Lim; Seonhee,9,0,35,26
1657280372131,MATH 10B,A03,093472,Lim; Seonhee,5,0,34,29
1657280372131,MATH 10B,B01,083739,Sinha; Shubham,11,0,30,19
1657280378174,MATH 18,A01,083743,Cinel; Cameron Alexander,6,0,30,24
1657280378174,MATH 18,A02,083744,Cinel; Cameron Alexander,17,0,30,13
1657280378174,MATH 18,A03,083745,Cinel; Cameron Alexander,8,0,30,22
1657280378174,MATH 18,B01,083748,Rideout; David Porter,4,0,37,33
1657280378174,MATH 18,B02,083749,Rideout; David Porter,4,0,36,32
1657280378174,MATH 18,B03,083750,Rideout; David Porter,2,0,37,35
1657280378174,MATH 18,B04,083751,Rideout; David Porter,6,0,36,30
1657280378174,MATH 18,B05,093473,Rideout; David Porter,5,0,36,31
1657280378174,MATH 18,B06,093474,Rideout; David Porter,5,0,36,31
1657280384206,MATH 20A,A01,083754,Zheng; Zequn,14,0,40,26
1657280390235,MATH 20B,A01,083756,Briones; Jor-el Thomas Caparas,3,0,36,33
1657280390235,MATH 20B,A02,083757,Briones; Jor-el Thomas Caparas,1,0,36,35
1657280390235,MATH 20B,A03,093475,Briones; Jor-el Thomas Caparas,2,0,36,34
1657280396272,MATH 20C,A01,083760,Briones; Jor-el Thomas Caparas,1,0,35,34
1657280396272,MATH 20C,A02,083761,Briones; Jor-el Thomas Caparas,8,0,35,27
1657280396272,MATH 20C,A03,093476,Briones; Jor-el Thomas Caparas,0,1,36,36
1657280396272,MATH 20C,B01,083762,Bach; Quang Tran,1,0,30,29
1657280402306,MATH 20D,A01,083765,Tran; Brian Kha,5,0,30,25
1657280402306,MATH 20D,A02,083766,Tran; Brian Kha,5,0,30,25
1657280402306,MATH 20D,A03,083767,Tran; Brian Kha,4,0,30,26
1657280408336,MATH 20E,A01,083771,Ganguly; Soumya,7,0,32,25
1657280408336,MATH 20E,A02,083772,Ganguly; Soumya,7,0,32,25
1657280408336,MATH 20E,B01,083773,Ciotti; Benjamin,19,0,35,16
1657280408336,MATH 20E,B02,083774,Ciotti; Benjamin,17,0,35,18
1657280414377,MATH 103A,A01,083777,Greenfeld; Be'Eri,3,0,36,33
1657280414377,MATH 103A,A02,083778,Greenfeld; Be'Eri,5,0,36,31
1657280414377,MATH 103A,A03,093561,Greenfeld; Be'Eri,4,0,36,32
1657280414377,MATH 103A,B01,083779,Greenfeld; Be'Eri,6,0,36,30
1657280414377,MATH 103A,B02,083780,Greenfeld; Be'Eri,3,0,36,33
1657280414377,MATH 103A,B03,093562,Greenfeld; Be'Eri,3,0,36,33
1657280420406,MATH 105,A01,085443,Carter; Anne Toulson,15,0,35,20
1657280420406,MATH 105,A02,093477,Carter; Anne Toulson,20,0,35,15
1657280426436,MATH 109,A01,083213,Ganzberger; Geoffrey Michael,2,0,34,32
1657280426436,MATH 109,A02,083214,Ganzberger; Geoffrey Michael,4,0,34,30
1657280426436,MATH 109,A03,093478,Ganzberger; Geoffrey Michael,2,0,34,32
1657280426436,MATH 109,B01,083215,Ganzberger; Geoffrey Michael,1,0,32,31
1657280426436,MATH 109,B02,083216,Ganzberger; Geoffrey Michael,1,0,32,31
1657280426436,MATH 109,B03,093479,Ganzberger; Geoffrey Michael,8,0,32,24
1657280432467,MATH 142A,A01,083219,Chow; Bennett,7,0,32,25
1657280432467,MATH 142A,A02,083220,Chow; Bennett,10,0,32,22
1657280432467,MATH 142A,A03,093480,Chow; Bennett,7,0,32,25
1657280432467,MATH 142A,B03,093481,Chow; Bennett,8,0,32,24
1657280432467,MATH 142A,B04,093558,Chow; Bennett,12,0,32,20
1657280432467,MATH 142A,B05,093559,Chow; Bennett,6,0,32,26
1657280438500,MATH 193A,A01,083224,Rotar; Vladimir,7,0,34,27
1657280438500,MATH 193A,A02,083225,Rotar; Vladimir,6,0,34,28
1657280438500,MATH 193A,A03,083781,Rotar; Vladimir,2,0,34,32
1657280438500,MATH 193A,A04,083782,Rotar; Vladimir,8,0,34,26
1657280438500,MATH 193A,A05,093482,Rotar; Vladimir,6,0,34,28
1657280444530,MATH 197,001,091859,McAuley; Julian John,9999,0,9999,0
1657280444530,MATH 197,002,095566,Kedlaya; Kiran S.,9997,0,9999,2
1657280444530,MATH 197,003,095567,Xiao; Ming,9999,0,9999,0
1657280444530,MATH 197,004,095571,Perols; Johan Lars,9998,0,9999,1
1657280451620,COGS 9,A01,083615,Shannon; Kyle Michael,8,0,75,67
1657280457650,COGS 11,A01,083617,Boyle; Mary E. T.,22,0,48,26
1657280463677,COGS 13,A01,083071,Bastos; Amalia Pinkusfeld,9,0,71,62
1657280469703,COGS 14A,A01,092681,Semenuks; Arturs,2,1,100,98
1657280475732,COGS 14B,A01,083073,Cheng; Tzu-Han,6,0,63,57
1657280481758,COGS 17,A01,092677,Semenuks; Arturs,5,0,81,76
1657280487787,COGS 100,A01,083619,Allen; Michael Gordon,16,0,70,54
1657280493820,COGS 101A,A01,083621,Davis; Joshua Daniel,9,0,68,59
1657280499848,COGS 101B,A01,091572,Allen; Michael Gordon,11,0,65,54
1657280505882,COGS 101C,A01,083625,Delgado; Tania,17,0,35,18
1657280511910,COGS 107A,A01,083627,Boyle; Mary E. T.,13,0,60,47
1657280517940,COGS 118A,A01,083075,Gupta; Anjum,18,0,76,58
1657280523968,CSE 3,A50,083646,Miranda; Gregory Joseph,24,0,50,26
1657280530002,CSE 8A,A50,083650,Miranda; Gregory Joseph,17,1,56,39
1657280536034,CSE 11,A01,083080,Cao; Yingjun,5,15,40,35
1657280542063,CSE 12,A01,083652,Krause-Levy; Sophia Louisa,26,1,120,94
1657280548092,CSE 15L,A01,083654,Morris; Justin Loren,9,0,50,41
1657280548092,CSE 15L,A02,083655,Morris; Justin Loren,9,0,50,41
1657280554125,CSE 20,A01,083657,Tran; Khoa Dang,38,0,80,42
1657280560153,CSE 21,A01,095574,Bach; Quang Tran,22,0,48,26
1657280566184,CSE 30,A01,083084,Eldon; John,4,0,80,76
1657280566184,CSE 30,B01,095061,Bhaskar; Nishant,8,0,50,42
1657280572215,CSE 100,A01,083659,Cao; Yingjun,4,4,70,66
1657280578246,CSE 134B,A01,083661,Powell; Thomas Allan,21,0,100,79
1657280584280,CSE 140,A01,083663,Gungor; Onat,13,0,85,72
1657280590307,CSE 140L,A01,083088,Eldon; John,19,0,100,81
1657280596345,CSE 175,A01,083665,Kumar; Rakesh,3,0,25,22
1657280602379,CSE 190,A00,092507,Dubnov; Shlomo,7,0,20,13
1657280608419,ECE 45,A01,083139,Congero; Spencer William,5,0,75,70
1657280614454,ECE 65,A50,083695,Saad; Andrew S,12,0,30,18
1657280614454,ECE 65,A51,095125,Saad; Andrew S,25,0,26,1
1657280620483,ECE 109,A01,091882,Touri; Behrouz,19,0,70,51
1657280626604,ECE 180,A00,083140,Abi Samra; Nicholas Camill,1,0,30,29
1657280626604,ECE 180,B00,083141,Abi Samra; Nicholas Camill,0,0,30,30
1657280632634,MATH 10A,A01,083735,Patchell; Gregory David,2,0,30,28
1657280632634,MATH 10A,A02,083736,Patchell; Gregory David,20,0,30,10
1657280632634,MATH 10A,A03,083737,Patchell; Gregory David,16,0,30,14
1657280638664,MATH 10B,A01,083207,Lim; Seonhee,7,0,34,27
1657280638664,MATH 10B,A02,083208,Lim; Seonhee,9,0,35,26
1657280638664,MATH 10B,A03,093472,Lim; Seonhee,5,0,34,29
1657280638664,MATH 10B,B01,083739,Sinha; Shubham,11,0,30,19
1657280644705,MATH 18,A01,083743,Cinel; Cameron Alexander,6,0,30,24
1657280644705,MATH 18,A02,083744,Cinel; Cameron Alexander,17,0,30,13
1657280644705,MATH 18,A03,083745,Cinel; Cameron Alexander,8,0,30,22
1657280644705,MATH 18,B01,083748,Rideout; David Porter,4,0,37,33
1657280644705,MATH 18,B02,083749,Rideout; David Porter,4,0,36,32
1657280644705,MATH 18,B03,083750,Rideout; David Porter,2,0,37,35
1657280644705,MATH 18,B04,083751,Rideout; David Porter,6,0,36,30
1657280644705,MATH 18,B05,093473,Rideout; David Porter,5,0,36,31
1657280644705,MATH 18,B06,093474,Rideout; David Porter,5,0,36,31
1657280650734,MATH 20A,A01,083754,Zheng; Zequn,14,0,40,26
1657280656761,MATH 20B,A01,083756,Briones; Jor-el Thomas Caparas,3,0,36,33
1657280656761,MATH 20B,A02,083757,Briones; Jor-el Thomas Caparas,1,0,36,35
1657280656761,MATH 20B,A03,093475,Briones; Jor-el Thomas Caparas,2,0,36,34
1657280662791,MATH 20C,A01,083760,Briones; Jor-el Thomas Caparas,1,0,35,34
1657280662791,MATH 20C,A02,083761,Briones; Jor-el Thomas Caparas,8,0,35,27
1657280662791,MATH 20C,A03,093476,Briones; Jor-el Thomas Caparas,0,1,36,36
1657280662791,MATH 20C,B01,083762,Bach; Quang Tran,1,0,30,29
1657280668818,MATH 20D,A01,083765,Tran; Brian Kha,5,0,30,25
1657280668818,MATH 20D,A02,083766,Tran; Brian Kha,5,0,30,25
1657280668818,MATH 20D,A03,083767,Tran; Brian Kha,4,0,30,26
1657280674857,MATH 20E,A01,083771,Ganguly; Soumya,7,0,32,25
1657280674857,MATH 20E,A02,083772,Ganguly; Soumya,7,0,32,25
1657280674857,MATH 20E,B01,083773,Ciotti; Benjamin,19,0,35,16
1657280674857,MATH 20E,B02,083774,Ciotti; Benjamin,17,0,35,18
1657280680888,MATH 103A,A01,083777,Greenfeld; Be'Eri,3,0,36,33
1657280680888,MATH 103A,A02,083778,Greenfeld; Be'Eri,5,0,36,31
1657280680888,MATH 103A,A03,093561,Greenfeld; Be'Eri,4,0,36,32
1657280680888,MATH 103A,B01,083779,Greenfeld; Be'Eri,6,0,36,30
1657280680888,MATH 103A,B02,083780,Greenfeld; Be'Eri,3,0,36,33
1657280680888,MATH 103A,B03,093562,Greenfeld; Be'Eri,3,0,36,33
1657280686938,MATH 105,A01,085443,Carter; Anne Toulson,15,0,35,20
1657280686938,MATH 105,A02,093477,Carter; Anne Toulson,20,0,35,15
1657280692964,MATH 109,A01,083213,Ganzberger; Geoffrey Michael,2,0,34,32
1657280692964,MATH 109,A02,083214,Ganzberger; Geoffrey Michael,4,0,34,30
1657280692964,MATH 109,A03,093478,Ganzberger; Geoffrey Michael,2,0,34,32
1657280692964,MATH 109,B01,083215,Ganzberger; Geoffrey Michael,1,0,32,31
1657280692964,MATH 109,B02,083216,Ganzberger; Geoffrey Michael,1,0,32,31
1657280692964,MATH 109,B03,093479,Ganzberger; Geoffrey Michael,8,0,32,24
1657280699002,MATH 142A,A01,083219,Chow; Bennett,7,0,32,25
1657280699002,MATH 142A,A02,083220,Chow; Bennett,10,0,32,22
1657280699002,MATH 142A,A03,093480,Chow; Bennett,7,0,32,25
1657280699002,MATH 142A,B03,093481,Chow; Bennett,8,0,32,24
1657280699002,MATH 142A,B04,093558,Chow; Bennett,12,0,32,20
1657280699002,MATH 142A,B05,093559,Chow; Bennett,6,0,32,26
1657280705041,MATH 193A,A01,083224,Rotar; Vladimir,7,0,34,27
1657280705041,MATH 193A,A02,083225,Rotar; Vladimir,6,0,34,28
1657280705041,MATH 193A,A03,083781,Rotar; Vladimir,2,0,34,32
1657280705041,MATH 193A,A04,083782,Rotar; Vladimir,8,0,34,26
1657280705041,MATH 193A,A05,093482,Rotar; Vladimir,6,0,34,28
1657280711069,MATH 197,001,091859,McAuley; Julian John,9999,0,9999,0
1657280711069,MATH 197,002,095566,Kedlaya; Kiran S.,9997,0,9999,2
1657280711069,MATH 197,003,095567,Xiao; Ming,9999,0,9999,0
1657280711069,MATH 197,004,095571,Perols; Johan Lars,9998,0,9999,1
1657280718147,COGS 9,A01,083615,Shannon; Kyle Michael,8,0,75,67
1657280724177,COGS 11,A01,083617,Boyle; Mary E. T.,22,0,48,26
1657280730205,COGS 13,A01,083071,Bastos; Amalia Pinkusfeld,9,0,71,62
1657280736240,COGS 14A,A01,092681,Semenuks; Arturs,2,1,100,98
1657280742276,COGS 14B,A01,083073,Cheng; Tzu-Han,6,0,63,57
1657280748304,COGS 17,A01,092677,Semenuks; Arturs,5,0,81,76
1657280754342,COGS 100,A01,083619,Allen; Michael Gordon,16,0,70,54
1657280760372,COGS 101A,A01,083621,Davis; Joshua Daniel,9,0,68,59
1657280766401,COGS 101B,A01,091572,Allen; Michael Gordon,11,0,65,54
1657280772429,COGS 101C,A01,083625,Delgado; Tania,17,0,35,18
1657280778462,COGS 107A,A01,083627,Boyle; Mary E. T.,13,0,60,47
1657280784496,COGS 118A,A01,083075,Gupta; Anjum,18,0,76,58
1657280790533,CSE 3,A50,083646,Miranda; Gregory Joseph,24,0,50,26
1657280796568,CSE 8A,A50,083650,Miranda; Gregory Joseph,17,1,56,39
1657280802601,CSE 11,A01,083080,Cao; Yingjun,5,15,40,35
1657280808630,CSE 12,A01,083652,Krause-Levy; Sophia Louisa,26,1,120,94
1657280814661,CSE 15L,A01,083654,Morris; Justin Loren,9,0,50,41
1657280814661,CSE 15L,A02,083655,Morris; Justin Loren,9,0,50,41
1657280820687,CSE 20,A01,083657,Tran; Khoa Dang,38,0,80,42
1657280826713,CSE 21,A01,095574,Bach; Quang Tran,22,0,48,26
1657280832741,CSE 30,A01,083084,Eldon; John,4,0,80,76
1657280832741,CSE 30,B01,095061,Bhaskar; Nishant,8,0,50,42
1657280838770,CSE 100,A01,083659,Cao; Yingjun,4,4,70,66
1657280844803,CSE 134B,A01,083661,Powell; Thomas Allan,21,0,100,79
1657280850832,CSE 140,A01,083663,Gungor; Onat,13,0,85,72
1657280856860,CSE 140L,A01,083088,Eldon; John,19,0,100,81
1657280862892,CSE 175,A01,083665,Kumar; Rakesh,3,0,25,22
1657280868925,CSE 190,A00,092507,Dubnov; Shlomo,7,0,20,13
1657280874953,ECE 45,A01,083139,Congero; Spencer William,5,0,75,70
1657280880988,ECE 65,A50,083695,Saad; Andrew S,12,0,30,18
1657280880988,ECE 65,A51,095125,Saad; Andrew S,25,0,26,1
1657280887016,ECE 109,A01,091882,Touri; Behrouz,19,0,70,51
1657280893049,ECE 180,A00,083140,Abi Samra; Nicholas Camill,1,0,30,29
1657280893049,ECE 180,B00,083141,Abi Samra; Nicholas Camill,0,0,30,30
1657280899084,MATH 10A,A01,083735,Patchell; Gregory David,2,0,30,28
1657280899084,MATH 10A,A02,083736,Patchell; Gregory David,20,0,30,10
1657280899084,MATH 10A,A03,083737,Patchell; Gregory David,16,0,30,14
1657280905122,MATH 10B,A01,083207,Lim; Seonhee,7,0,34,27
1657280905122,MATH 10B,A02,083208,Lim; Seonhee,9,0,35,26
1657280905122,MATH 10B,A03,093472,Lim; Seonhee,5,0,34,29
1657280905122,MATH 10B,B01,083739,Sinha; Shubham,11,0,30,19
1657280911152,MATH 18,A01,083743,Cinel; Cameron Alexander,6,0,30,24
1657280911152,MATH 18,A02,083744,Cinel; Cameron Alexander,17,0,30,13
1657280911152,MATH 18,A03,083745,Cinel; Cameron Alexander,8,0,30,22
1657280911152,MATH 18,B01,083748,Rideout; David Porter,4,0,37,33
1657280911152,MATH 18,B02,083749,Rideout; David Porter,4,0,36,32
1657280911152,MATH 18,B03,083750,Rideout; David Porter,2,0,37,35
1657280911152,MATH 18,B04,083751,Rideout; David Porter,6,0,36,30
1657280911152,MATH 18,B05,093473,Rideout; David Porter,5,0,36,31
1657280911152,MATH 18,B06,093474,Rideout; David Porter,5,0,36,31
1657280917179,MATH 20A,A01,083754,Zheng; Zequn,14,0,40,26
1657280923217,MATH 20B,A01,083756,Briones; Jor-el Thomas Caparas,3,0,36,33
1657280923217,MATH 20B,A02,083757,Briones; Jor-el Thomas Caparas,1,0,36,35
1657280923217,MATH 20B,A03,093475,Briones; Jor-el Thomas Caparas,2,0,36,34
1657280929245,MATH 20C,A01,083760,Briones; Jor-el Thomas Caparas,1,0,35,34
1657280929245,MATH 20C,A02,083761,Briones; Jor-el Thomas Caparas,8,0,35,27
1657280929245,MATH 20C,A03,093476,Briones; Jor-el Thomas Caparas,0,1,36,36
1657280929245,MATH 20C,B01,083762,Bach; Quang Tran,1,0,30,29
1657280935275,MATH 20D,A01,083765,Tran; Brian Kha,5,0,30,25
1657280935275,MATH 20D,A02,083766,Tran; Brian Kha,5,0,30,25
1657280935275,MATH 20D,A03,083767,Tran; Brian Kha,4,0,30,26
1657280941303,MATH 20E,A01,083771,Ganguly; Soumya,7,0,32,25
1657280941303,MATH 20E,A02,083772,Ganguly; Soumya,7,0,32,25
1657280941303,MATH 20E,B01,083773,Ciotti; Benjamin,19,0,35,16
1657280941303,MATH 20E,B02,083774,Ciotti; Benjamin,17,0,35,18
1657280947341,MATH 103A,A01,083777,Greenfeld; Be'Eri,3,0,36,33
1657280947341,MATH 103A,A02,083778,Greenfeld; Be'Eri,5,0,36,31
1657280947341,MATH 103A,A03,093561,Greenfeld; Be'Eri,4,0,36,32
1657280947341,MATH 103A,B01,083779,Greenfeld; Be'Eri,6,0,36,30
1657280947341,MATH 103A,B02,083780,Greenfeld; Be'Eri,3,0,36,33
1657280947341,MATH 103A,B03,093562,Greenfeld; Be'Eri,3,0,36,33
1657280953373,MATH 105,A01,085443,Carter; Anne Toulson,15,0,35,20
1657280953373,MATH 105,A02,093477,Carter; Anne Toulson,20,0,35,15
1657280959401,MATH 109,A01,083213,Ganzberger; Geoffrey Michael,2,0,34,32
1657280959401,MATH 109,A02,083214,Ganzberger; Geoffrey Michael,4,0,34,30
1657280959401,MATH 109,A03,093478,Ganzberger; Geoffrey Michael,2,0,34,32
1657280959401,MATH 109,B01,083215,Ganzberger; Geoffrey Michael,1,0,32,31
1657280959401,MATH 109,B02,083216,Ganzberger; Geoffrey Michael,1,0,32,31
1657280959401,MATH 109,B03,093479,Ganzberger; Geoffrey Michael,8,0,32,24
1657280965430,MATH 142A,A01,083219,Chow; Bennett,7,0,32,25
1657280965430,MATH 142A,A02,083220,Chow; Bennett,10,0,32,22
1657280965430,MATH 142A,A03,093480,Chow; Bennett,7,0,32,25
1657280965430,MATH 142A,B03,093481,Chow; Bennett,8,0,32,24
1657280965430,MATH 142A,B04,093558,Chow; Bennett,12,0,32,20
1657280965430,MATH 142A,B05,093559,Chow; Bennett,6,0,32,26
1657280971462,MATH 193A,A01,083224,Rotar; Vladimir,7,0,34,27
1657280971462,MATH 193A,A02,083225,Rotar; Vladimir,6,0,34,28
1657280971462,MATH 193A,A03,083781,Rotar; Vladimir,2,0,34,32
1657280971462,MATH 193A,A04,083782,Rotar; Vladimir,8,0,34,26
1657280971462,MATH 193A,A05,093482,Rotar; Vladimir,6,0,34,28
1657280977491,MATH 197,001,091859,McAuley; Julian John,9999,0,9999,0
1657280977491,MATH 197,002,095566,Kedlaya; Kiran S.,9997,0,9999,2
1657280977491,MATH 197,003,095567,Xiao; Ming,9999,0,9999,0
1657280977491,MATH 197,004,095571,Perols; Johan Lars,9998,0,9999,1
1657280984566,COGS 9,A01,083615,Shannon; Kyle Michael,8,0,75,67
1657280990595,COGS 11,A01,083617,Boyle; Mary E. T.,22,0,48,26
1657280996627,COGS 13,A01,083071,Bastos; Amalia Pinkusfeld,9,0,71,62
1657281002654,COGS 14A,A01,092681,Semenuks; Arturs,2,1,100,98
1657281008683,COGS 14B,A01,083073,Cheng; Tzu-Han,6,0,63,57
1657281014711,COGS 17,A01,092677,Semenuks; Arturs,5,0,81,76
1657281020738,COGS 100,A01,083619,Allen; Michael Gordon,16,0,70,54
1657281026769,COGS 101A,A01,083621,Davis; Joshua Daniel,9,0,68,59
1657281032797,COGS 101B,A01,091572,Allen; Michael Gordon,11,0,65,54
1657281038830,COGS 101C,A01,083625,Delgado; Tania,17,0,35,18
1657281044862,COGS 107A,A01,083627,Boyle; Mary E. T.,13,0,60,47
1657281050892,COGS 118A,A01,083075,Gupta; Anjum,18,0,76,58
1657281056923,CSE 3,A50,083646,Miranda; Gregory Joseph,24,0,50,26
1657281062953,CSE 8A,A50,083650,Miranda; Gregory Joseph,17,1,56,39
1657281068977,CSE 11,A01,083080,Cao; Yingjun,5,15,40,35
1657281075005,CSE 12,A01,083652,Krause-Levy; Sophia Louisa,26,1,120,94
1657281081034,CSE 15L,A01,083654,Morris; Justin Loren,9,0,50,41
1657281081034,CSE 15L,A02,083655,Morris; Justin Loren,9,0,50,41
1657281087066,CSE 20,A01,083657,Tran; Khoa Dang,38,0,80,42
1657281093094,CSE 21,A01,095574,Bach; Quang Tran,22,0,48,26
1657281099125,CSE 30,A01,083084,Eldon; John,4,0,80,76
1657281099125,CSE 30,B01,095061,Bhaskar; Nishant,8,0,50,42
1657281105154,CSE 100,A01,083659,Cao; Yingjun,4,4,70,66
1657281111187,CSE 134B,A01,083661,Powell; Thomas Allan,21,0,100,79
1657281117221,CSE 140,A01,083663,Gungor; Onat,13,0,85,72
1657281123250,CSE 140L,A01,083088,Eldon; John,19,0,100,81
1657281129281,CSE 175,A01,083665,Kumar; Rakesh,3,0,25,22
1657281135309,CSE 190,A00,092507,Dubnov; Shlomo,7,0,20,13
1657281141338,ECE 45,A01,083139,Congero; Spencer William,5,0,75,70
1657281147374,ECE 65,A50,083695,Saad; Andrew S,12,0,30,18
1657281147374,ECE 65,A51,095125,Saad; Andrew S,25,0,26,1
1657281153402,ECE 109,A01,091882,Touri; Behrouz,19,0,70,51
1657281159431,ECE 180,A00,083140,Abi Samra; Nicholas Camill,1,0,30,29
1657281159431,ECE 180,B00,083141,Abi Samra; Nicholas Camill,0,0,30,30
1657281165468,MATH 10A,A01,083735,Patchell; Gregory David,2,0,30,28
1657281165468,MATH 10A,A02,083736,Patchell; Gregory David,20,0,30,10
1657281165468,MATH 10A,A03,083737,Patchell; Gregory David,16,0,30,14
1657281171498,MATH 10B,A01,083207,Lim; Seonhee,7,0,34,27
1657281171498,MATH 10B,A02,083208,Lim; Seonhee,9,0,35,26
1657281171498,MATH 10B,A03,093472,Lim; Seonhee,5,0,34,29
1657281171498,MATH 10B,B01,083739,Sinha; Shubham,11,0,30,19
1657281177531,MATH 18,A01,083743,Cinel; Cameron Alexander,6,0,30,24
1657281177531,MATH 18,A02,083744,Cinel; Cameron Alexander,17,0,30,13
1657281177531,MATH 18,A03,083745,Cinel; Cameron Alexander,8,0,30,22
1657281177531,MATH 18,B01,083748,Rideout; David Porter,4,0,37,33
1657281177531,MATH 18,B02,083749,Rideout; David Porter,4,0,36,32
1657281177531,MATH 18,B03,083750,Rideout; David Porter,2,0,37,35
1657281177531,MATH 18,B04,083751,Rideout; David Porter,6,0,36,30
1657281177531,MATH 18,B05,093473,Rideout; David Porter,5,0,36,31
1657281177531,MATH 18,B06,093474,Rideout; David Porter,5,0,36,31
1657281183560,MATH 20A,A01,083754,Zheng; Zequn,14,0,40,26
1657281189596,MATH 20B,A01,083756,Briones; Jor-el Thomas Caparas,3,0,36,33
1657281189596,MATH 20B,A02,083757,Briones; Jor-el Thomas Caparas,1,0,36,35
1657281189596,MATH 20B,A03,093475,Briones; Jor-el Thomas Caparas,2,0,36,34
1657281195624,MATH 20C,A01,083760,Briones; Jor-el Thomas Caparas,1,0,35,34
1657281195624,MATH 20C,A02,083761,Briones; Jor-el Thomas Caparas,8,0,35,27
1657281195624,MATH 20C,A03,093476,Briones; Jor-el Thomas Caparas,0,1,36,36
1657281195624,MATH 20C,B01,083762,Bach; Quang Tran,1,0,30,29
1657281201653,MATH 20D,A01,083765,Tran; Brian Kha,5,0,30,25
1657281201653,MATH 20D,A02,083766,Tran; Brian Kha,5,0,30,25
1657281201653,MATH 20D,A03,083767,Tran; Brian Kha,4,0,30,26
1657281207685,MATH 20E,A01,083771,Ganguly; Soumya,7,0,32,25
1657281207685,MATH 20E,A02,083772,Ganguly; Soumya,7,0,32,25
1657281207685,MATH 20E,B01,083773,Ciotti; Benjamin,19,0,35,16
1657281207685,MATH 20E,B02,083774,Ciotti; Benjamin,17,0,35,18
1657281213717,MATH 103A,A01,083777,Greenfeld; Be'Eri,3,0,36,33
1657281213717,MATH 103A,A02,083778,Greenfeld; Be'Eri,5,0,36,31
1657281213717,MATH 103A,A03,093561,Greenfeld; Be'Eri,4,0,36,32
1657281213717,MATH 103A,B01,083779,Greenfeld; Be'Eri,6,0,36,30
1657281213717,MATH 103A,B02,083780,Greenfeld; Be'Eri,3,0,36,33
1657281213717,MATH 103A,B03,093562,Greenfeld; Be'Eri,3,0,36,33
1657281219748,MATH 105,A01,085443,Carter; Anne Toulson,15,0,35,20
1657281219748,MATH 105,A02,093477,Carter; Anne Toulson,20,0,35,15
1657281225858,MATH 109,A01,083213,Ganzberger; Geoffrey Michael,2,0,34,32
1657281225858,MATH 109,A02,083214,Ganzberger; Geoffrey Michael,4,0,34,30
1657281225858,MATH 109,A03,093478,Ganzberger; Geoffrey Michael,2,0,34,32
1657281225858,MATH 109,B01,083215,Ganzberger; Geoffrey Michael,1,0,32,31
1657281225858,MATH 109,B02,083216,Ganzberger; Geoffrey Michael,1,0,32,31
1657281225858,MATH 109,B03,093479,Ganzberger; Geoffrey Michael,8,0,32,24
1657281231891,MATH 142A,A01,083219,Chow; Bennett,7,0,32,25
1657281231891,MATH 142A,A02,083220,Chow; Bennett,10,0,32,22
1657281231891,MATH 142A,A03,093480,Chow; Bennett,7,0,32,25
1657281231891,MATH 142A,B03,093481,Chow; Bennett,8,0,32,24
1657281231891,MATH 142A,B04,093558,Chow; Bennett,12,0,32,20
1657281231891,MATH 142A,B05,093559,Chow; Bennett,6,0,32,26
1657281237923,MATH 193A,A01,083224,Rotar; Vladimir,7,0,34,27
1657281237923,MATH 193A,A02,083225,Rotar; Vladimir,6,0,34,28
1657281237923,MATH 193A,A03,083781,Rotar; Vladimir,2,0,34,32
1657281237923,MATH 193A,A04,083782,Rotar; Vladimir,8,0,34,26
1657281237923,MATH 193A,A05,093482,Rotar; Vladimir,6,0,34,28
1657281243959,MATH 197,001,091859,McAuley; Julian John,9999,0,9999,0
1657281243959,MATH 197,002,095566,Kedlaya; Kiran S.,9997,0,9999,2
1657281243959,MATH 197,003,095567,Xiao; Ming,9999,0,9999,0
1657281243959,MATH 197,004,095571,Perols; Johan Lars,9998,0,9999,1
1657281251049,COGS 9,A01,083615,Shannon; Kyle Michael,8,0,75,67
1657281257081,COGS 11,A01,083617,Boyle; Mary E. T.,22,0,48,26
1657281263108,COGS 13,A01,083071,Bastos; Amalia Pinkusfeld,9,0,71,62
1657281269143,COGS 14A,A01,092681,Semenuks; Arturs,2,1,100,98
1657281275170,COGS 14B,A01,083073,Cheng; Tzu-Han,6,0,63,57
1657281281197,COGS 17,A01,092677,Semenuks; Arturs,5,0,81,76
1657281287226,COGS 100,A01,083619,Allen; Michael Gordon,16,0,70,54
1657281293257,COGS 101A,A01,083621,Davis; Joshua Daniel,9,0,68,59
1657281299284,COGS 101B,A01,091572,Allen; Michael Gordon,11,0,65,54
1657281305316,COGS 101C,A01,083625,Delgado; Tania,17,0,35,18
1657281311347,COGS 107A,A01,083627,Boyle; Mary E. T.,13,0,60,47
1657281317381,COGS 118A,A01,083075,Gupta; Anjum,18,0,76,58
1657281323411,CSE 3,A50,083646,Miranda; Gregory Joseph,24,0,50,26
1657281329450,CSE 8A,A50,083650,Miranda; Gregory Joseph,17,1,56,39
1657281335476,CSE 11,A01,083080,Cao; Yingjun,5,15,40,35
1657281341508,CSE 12,A01,083652,Krause-Levy; Sophia Louisa,26,1,120,94
1657281347541,CSE 15L,A01,083654,Morris; Justin Loren,9,0,50,41
1657281347541,CSE 15L,A02,083655,Morris; Justin Loren,9,0,50,41
1657281353570,CSE 20,A01,083657,Tran; Khoa Dang,38,0,80,42
1657281359596,CSE 21,A01,095574,Bach; Quang Tran,22,0,48,26
1657281365625,CSE 30,A01,083084,Eldon; John,4,0,80,76
1657281365625,CSE 30,B01,095061,Bhaskar; Nishant,8,0,50,42
1657281371651,CSE 100,A01,083659,Cao; Yingjun,4,4,70,66
1657281377681,CSE 134B,A01,083661,Powell; Thomas Allan,21,0,100,79
1657281383712,CSE 140,A01,083663,Gungor; Onat,13,0,85,72
1657281389739,CSE 140L,A01,083088,Eldon; John,19,0,100,81
1657281395765,CSE 175,A01,083665,Kumar; Rakesh,3,0,25,22
1657281401798,CSE 190,A00,092507,Dubnov; Shlomo,7,0,20,13
1657281407833,ECE 45,A01,083139,Congero; Spencer William,5,0,75,70
1657281413861,ECE 65,A50,083695,Saad; Andrew S,12,0,30,18
1657281413861,ECE 65,A51,095125,Saad; Andrew S,25,0,26,1
1657281419889,ECE 109,A01,091882,Touri; Behrouz,19,0,70,51
1657281425916,ECE 180,A00,083140,Abi Samra; Nicholas Camill,1,0,30,29
1657281425916,ECE 180,B00,083141,Abi Samra; Nicholas Camill,0,0,30,30
1657281431945,MATH 10A,A01,083735,Patchell; Gregory David,2,0,30,28
1657281431945,MATH 10A,A02,083736,Patchell; Gregory David,20,0,30,10
1657281431945,MATH 10A,A03,083737,Patchell; Gregory David,16,0,30,14
1657281437977,MATH 10B,A01,083207,Lim; Seonhee,7,0,34,27
1657281437977,MATH 10B,A02,083208,Lim; Seonhee,9,0,35,26
1657281437977,MATH 10B,A03,093472,Lim; Seonhee,5,0,34,29
1657281437977,MATH 10B,B01,083739,Sinha; Shubham,11,0,30,19
1657281444009,MATH 18,A01,083743,Cinel; Cameron Alexander,6,0,30,24
1657281444009,MATH 18,A02,083744,Cinel; Cameron Alexander,17,0,30,13
1657281444009,MATH 18,A03,083745,Cinel; Cameron Alexander,8,0,30,22
1657281444009,MATH 18,B01,083748,Rideout; David Porter,4,0,37,33
1657281444009,MATH 18,B02,083749,Rideout; David Porter,4,0,36,32
1657281444009,MATH 18,B03,083750,Rideout; David Porter,2,0,37,35
1657281444009,MATH 18,B04,083751,Rideout; David Porter,6,0,36,30
1657281444009,MATH 18,B05,093473,Rideout; David Porter,5,0,36,31
1657281444009,MATH 18,B06,093474,Rideout; David Porter,5,0,36,31
1657281450039,MATH 20A,A01,083754,Zheng; Zequn,14,0,40,26
1657281456079,MATH 20B,A01,083756,Briones; Jor-el Thomas Caparas,3,0,36,33
1657281456079,MATH 20B,A02,083757,Briones; Jor-el Thomas Caparas,1,0,36,35
1657281456079,MATH 20B,A03,093475,Briones; Jor-el Thomas Caparas,2,0,36,34
1657281462106,MATH 20C,A01,083760,Briones; Jor-el Thomas Caparas,1,0,35,34
1657281462106,MATH 20C,A02,083761,Briones; Jor-el Thomas Caparas,8,0,35,27
1657281462106,MATH 20C,A03,093476,Briones; Jor-el Thomas Caparas,0,1,36,36
1657281462106,MATH 20C,B01,083762,Bach; Quang Tran,1,0,30,29
1657281468141,MATH 20D,A01,083765,Tran; Brian Kha,5,0,30,25
1657281468141,MATH 20D,A02,083766,Tran; Brian Kha,5,0,30,25
1657281468141,MATH 20D,A03,083767,Tran; Brian Kha,4,0,30,26
1657281474179,MATH 20E,A01,083771,Ganguly; Soumya,7,0,32,25
1657281474179,MATH 20E,A02,083772,Ganguly; Soumya,7,0,32,25
1657281474179,MATH 20E,B01,083773,Ciotti; Benjamin,19,0,35,16
1657281474179,MATH 20E,B02,083774,Ciotti; Benjamin,17,0,35,18
1657281480214,MATH 103A,A01,083777,Greenfeld; Be'Eri,3,0,36,33
1657281480214,MATH 103A,A02,083778,Greenfeld; Be'Eri,5,0,36,31
1657281480214,MATH 103A,A03,093561,Greenfeld; Be'Eri,4,0,36,32
1657281480214,MATH 103A,B01,083779,Greenfeld; Be'Eri,6,0,36,30
1657281480214,MATH 103A,B02,083780,Greenfeld; Be'Eri,3,0,36,33
1657281480214,MATH 103A,B03,093562,Greenfeld; Be'Eri,3,0,36,33
1657281486249,MATH 105,A01,085443,Carter; Anne Toulson,15,0,35,20
1657281486249,MATH 105,A02,093477,Carter; Anne Toulson,20,0,35,15
1657281492280,MATH 109,A01,083213,Ganzberger; Geoffrey Michael,2,0,34,32
1657281492280,MATH 109,A02,083214,Ganzberger; Geoffrey Michael,4,0,34,30
1657281492280,MATH 109,A03,093478,Ganzberger; Geoffrey Michael,2,0,34,32
1657281492280,MATH 109,B01,083215,Ganzberger; Geoffrey Michael,1,0,32,31
1657281492280,MATH 109,B02,083216,Ganzberger; Geoffrey Michael,1,0,32,31
1657281492280,MATH 109,B03,093479,Ganzberger; Geoffrey Michael,8,0,32,24
1657281498321,MATH 142A,A01,083219,Chow; Bennett,7,0,32,25
1657281498321,MATH 142A,A02,083220,Chow; Bennett,10,0,32,22
1657281498321,MATH 142A,A03,093480,Chow; Bennett,7,0,32,25
1657281498321,MATH 142A,B03,093481,Chow; Bennett,8,0,32,24
1657281498321,MATH 142A,B04,093558,Chow; Bennett,12,0,32,20
1657281498321,MATH 142A,B05,093559,Chow; Bennett,6,0,32,26
1657281504347,MATH 193A,A01,083224,Rotar; Vladimir,7,0,34,27
1657281504347,MATH 193A,A02,083225,Rotar; Vladimir,6,0,34,28
1657281504347,MATH 193A,A03,083781,Rotar; Vladimir,2,0,34,32
1657281504347,MATH 193A,A04,083782,Rotar; Vladimir,8,0,34,26
1657281504347,MATH 193A,A05,093482,Rotar; Vladimir,6,0,34,28
1657281510382,MATH 197,001,091859,McAuley; Julian John,9999,0,9999,0
1657281510382,MATH 197,002,095566,Kedlaya; Kiran S.,9997,0,9999,2
1657281510382,MATH 197,003,095567,Xiao; Ming,9999,0,9999,0
1657281510382,MATH 197,004,095571,Perols; Johan Lars,9998,0,9999,1
1657281517456,COGS 9,A01,083615,Shannon; Kyle Michael,8,0,75,67
1657281523489,COGS 11,A01,083617,Boyle; Mary E. T.,22,0,48,26
1657281529513,COGS 13,A01,083071,Bastos; Amalia Pinkusfeld,9,0,71,62
1657281535539,COGS 14A,A01,092681,Semenuks; Arturs,2,1,100,98
1657281541569,COGS 14B,A01,083073,Cheng; Tzu-Han,6,0,63,57
1657281547594,COGS 17,A01,092677,Semenuks; Arturs,5,0,81,76
1657281553627,COGS 100,A01,083619,Allen; Michael Gordon,16,0,70,54
1657281559660,COGS 101A,A01,083621,Davis; Joshua Daniel,9,0,68,59
1657281565692,COGS 101B,A01,091572,Allen; Michael Gordon,11,0,65,54
1657281571718,COGS 101C,A01,083625,Delgado; Tania,17,0,35,18
1657281577748,COGS 107A,A01,083627,Boyle; Mary E. T.,13,0,60,47
1657281583772,COGS 118A,A01,083075,Gupta; Anjum,18,0,76,58
1657281589806,CSE 3,A50,083646,Miranda; Gregory Joseph,24,0,50,26
1657281595835,CSE 8A,A50,083650,Miranda; Gregory Joseph,17,1,56,39
1657281601877,CSE 11,A01,083080,Cao; Yingjun,5,15,40,35
1657281607902,CSE 12,A01,083652,Krause-Levy; Sophia Louisa,26,1,120,94
1657281613931,CSE 15L,A01,083654,Morris; Justin Loren,9,0,50,41
1657281613931,CSE 15L,A02,083655,Morris; Justin Loren,9,0,50,41
1657281619958,CSE 20,A01,083657,Tran; Khoa Dang,38,0,80,42
1657281625982,CSE 21,A01,095574,Bach; Quang Tran,22,0,48,26
1657281632007,CSE 30,A01,083084,Eldon; John,4,0,80,76
1657281632007,CSE 30,B01,095061,Bhaskar; Nishant,8,0,50,42
1657281638034,CSE 100,A01,083659,Cao; Yingjun,4,4,70,66
1657281644070,CSE 134B,A01,083661,Powell; Thomas Allan,21,0,100,79
1657281650095,CSE 140,A01,083663,Gungor; Onat,13,0,85,72
1657281656126,CSE 140L,A01,083088,Eldon; John,19,0,100,81
1657281662313,CSE 175,A01,083665,Kumar; Rakesh,3,0,25,22
1657281668339,CSE 190,A00,092507,Dubnov; Shlomo,7,0,20,13
1657281674363,ECE 45,A01,083139,Congero; Spencer William,5,0,75,70
1657281680397,ECE 65,A50,083695,Saad; Andrew S,12,0,30,18
1657281680397,ECE 65,A51,095125,Saad; Andrew S,25,0,26,1
1657281686423,ECE 109,A01,091882,Touri; Behrouz,19,0,70,51
1657281692448,ECE 180,A00,083140,Abi Samra; Nicholas Camill,1,0,30,29
1657281692448,ECE 180,B00,083141,Abi Samra; Nicholas Camill,0,0,30,30
1657281698475,MATH 10A,A01,083735,Patchell; Gregory David,2,0,30,28
1657281698475,MATH 10A,A02,083736,Patchell; Gregory David,20,0,30,10
1657281698475,MATH 10A,A03,083737,Patchell; Gregory David,16,0,30,14
1657281704511,MATH 10B,A01,083207,Lim; Seonhee,7,0,34,27
1657281704511,MATH 10B,A02,083208,Lim; Seonhee,9,0,35,26
1657281704511,MATH 10B,A03,093472,Lim; Seonhee,5,0,34,29
1657281704511,MATH 10B,B01,083739,Sinha; Shubham,11,0,30,19
1657281710551,MATH 18,A01,083743,Cinel; Cameron Alexander,6,0,30,24
1657281710551,MATH 18,A02,083744,Cinel; Cameron Alexander,17,0,30,13
1657281710551,MATH 18,A03,083745,Cinel; Cameron Alexander,8,0,30,22
1657281710551,MATH 18,B01,083748,Rideout; David Porter,4,0,37,33
1657281710551,MATH 18,B02,083749,Rideout; David Porter,4,0,36,32
1657281710551,MATH 18,B03,083750,Rideout; David Porter,2,0,37,35
1657281710551,MATH 18,B04,083751,Rideout; David Porter,6,0,36,30
1657281710551,MATH 18,B05,093473,Rideout; David Porter,5,0,36,31
1657281710551,MATH 18,B06,093474,Rideout; David Porter,5,0,36,31
1657281716576,MATH 20A,A01,083754,Zheng; Zequn,14,0,40,26
1657281722604,MATH 20B,A01,083756,Briones; Jor-el Thomas Caparas,3,0,36,33
1657281722604,MATH 20B,A02,083757,Briones; Jor-el Thomas Caparas,1,0,36,35
1657281722604,MATH 20B,A03,093475,Briones; Jor-el Thomas Caparas,2,0,36,34
1657281728640,MATH 20C,A01,083760,Briones; Jor-el Thomas Caparas,1,0,35,34
1657281728640,MATH 20C,A02,083761,Briones; Jor-el Thomas Caparas,8,0,35,27
1657281728640,MATH 20C,A03,093476,Briones; Jor-el Thomas Caparas,0,1,36,36
1657281728640,MATH 20C,B01,083762,Bach; Quang Tran,1,0,30,29
1657281734667,MATH 20D,A01,083765,Tran; Brian Kha,5,0,30,25
1657281734667,MATH 20D,A02,083766,Tran; Brian Kha,5,0,30,25
1657281734667,MATH 20D,A03,083767,Tran; Brian Kha,4,0,30,26
1657281740694,MATH 20E,A01,083771,Ganguly; Soumya,7,0,32,25
1657281740694,MATH 20E,A02,083772,Ganguly; Soumya,7,0,32,25
1657281740694,MATH 20E,B01,083773,Ciotti; Benjamin,19,0,35,16
1657281740694,MATH 20E,B02,083774,Ciotti; Benjamin,17,0,35,18
1657281746731,MATH 103A,A01,083777,Greenfeld; Be'Eri,3,0,36,33
1657281746731,MATH 103A,A02,083778,Greenfeld; Be'Eri,5,0,36,31
1657281746731,MATH 103A,A03,093561,Greenfeld; Be'Eri,4,0,36,32
1657281746731,MATH 103A,B01,083779,Greenfeld; Be'Eri,6,0,36,30
1657281746731,MATH 103A,B02,083780,Greenfeld; Be'Eri,3,0,36,33
1657281746731,MATH 103A,B03,093562,Greenfeld; Be'Eri,3,0,36,33
1657281752756,MATH 105,A01,085443,Carter; Anne Toulson,15,0,35,20
1657281752756,MATH 105,A02,093477,Carter; Anne Toulson,20,0,35,15
1657281758790,MATH 109,A01,083213,Ganzberger; Geoffrey Michael,2,0,34,32
1657281758790,MATH 109,A02,083214,Ganzberger; Geoffrey Michael,4,0,34,30
1657281758790,MATH 109,A03,093478,Ganzberger; Geoffrey Michael,2,0,34,32
1657281758790,MATH 109,B01,083215,Ganzberger; Geoffrey Michael,1,0,32,31
1657281758790,MATH 109,B02,083216,Ganzberger; Geoffrey Michael,1,0,32,31
1657281758790,MATH 109,B03,093479,Ganzberger; Geoffrey Michael,8,0,32,24
1657281764820,MATH 142A,A01,083219,Chow; Bennett,7,0,32,25
1657281764820,MATH 142A,A02,083220,Chow; Bennett,10,0,32,22
1657281764820,MATH 142A,A03,093480,Chow; Bennett,7,0,32,25
1657281764820,MATH 142A,B03,093481,Chow; Bennett,8,0,32,24
1657281764820,MATH 142A,B04,093558,Chow; Bennett,12,0,32,20
1657281764820,MATH 142A,B05,093559,Chow; Bennett,6,0,32,26
1657281770848,MATH 193A,A01,083224,Rotar; Vladimir,7,0,34,27
1657281770848,MATH 193A,A02,083225,Rotar; Vladimir,6,0,34,28
1657281770848,MATH 193A,A03,083781,Rotar; Vladimir,2,0,34,32
1657281770848,MATH 193A,A04,083782,Rotar; Vladimir,8,0,34,26
1657281770848,MATH 193A,A05,093482,Rotar; Vladimir,6,0,34,28
1657281776876,MATH 197,001,091859,McAuley; Julian John,9999,0,9999,0
1657281776876,MATH 197,002,095566,Kedlaya; Kiran S.,9997,0,9999,2
1657281776876,MATH 197,003,095567,Xiao; Ming,9999,0,9999,0
1657281776876,MATH 197,004,095571,Perols; Johan Lars,9998,0,9999,1
1657281783970,COGS 9,A01,083615,Shannon; Kyle Michael,8,0,75,67
1657281790004,COGS 11,A01,083617,Boyle; Mary E. T.,22,0,48,26
1657281796030,COGS 13,A01,083071,Bastos; Amalia Pinkusfeld,9,0,71,62
1657281802062,COGS 14A,A01,092681,Semenuks; Arturs,2,1,100,98
1657281808090,COGS 14B,A01,083073,Cheng; Tzu-Han,6,0,63,57
1657281814117,COGS 17,A01,092677,Semenuks; Arturs,5,0,81,76
1657281820216,COGS 100,A01,083619,Allen; Michael Gordon,16,0,70,54
1657281826251,COGS 101A,A01,083621,Davis; Joshua Daniel,9,0,68,59
1657281832278,COGS 101B,A01,091572,Allen; Michael Gordon,11,0,65,54
1657281838303,COGS 101C,A01,083625,Delgado; Tania,17,0,35,18
1657281844330,COGS 107A,A01,083627,Boyle; Mary E. T.,13,0,60,47
1657281850363,COGS 118A,A01,083075,Gupta; Anjum,18,0,76,58
1657281856400,CSE 3,A50,083646,Miranda; Gregory Joseph,24,0,50,26
1657281862431,CSE 8A,A50,083650,Miranda; Gregory Joseph,17,1,56,39
1657281868464,CSE 11,A01,083080,Cao; Yingjun,5,15,40,35
1657281874492,CSE 12,A01,083652,Krause-Levy; Sophia Louisa,26,1,120,94
1657281880520,CSE 15L,A01,083654,Morris; Justin Loren,9,0,50,41
1657281880520,CSE 15L,A02,083655,Morris; Justin Loren,9,0,50,41
1657281886547,CSE 20,A01,083657,Tran; Khoa Dang,38,0,80,42
1657281892575,CSE 21,A01,095574,Bach; Quang Tran,22,0,48,26
1657281898614,CSE 30,A01,083084,Eldon; John,4,0,80,76
1657281898614,CSE 30,B01,095061,Bhaskar; Nishant,8,0,50,42
1657281904643,CSE 100,A01,083659,Cao; Yingjun,4,4,70,66
1657281910687,CSE 134B,A01,083661,Powell; Thomas Allan,21,0,100,79
1657281916722,CSE 140,A01,083663,Gungor; Onat,13,0,85,72
1657281922762,CSE 140L,A01,083088,Eldon; John,19,0,100,81
1657281928789,CSE 175,A01,083665,Kumar; Rakesh,3,0,25,22
1657281934821,CSE 190,A00,092507,Dubnov; Shlomo,7,0,20,13
1657281940848,ECE 45,A01,083139,Congero; Spencer William,5,0,75,70
1657281946886,ECE 65,A50,083695,Saad; Andrew S,12,0,30,18
1657281946886,ECE 65,A51,095125,Saad; Andrew S,25,0,26,1
1657281952917,ECE 109,A01,091882,Touri; Behrouz,19,0,70,51
1657281958943,ECE 180,A00,083140,Abi Samra; Nicholas Camill,1,0,30,29
1657281958943,ECE 180,B00,083141,Abi Samra; Nicholas Camill,0,0,30,30
1657281964988,MATH 10A,A01,083735,Patchell; Gregory David,2,0,30,28
1657281964988,MATH 10A,A02,083736,Patchell; Gregory David,20,0,30,10
1657281964988,MATH 10A,A03,083737,Patchell; Gregory David,16,0,30,14
1657281971025,MATH 10B,A01,083207,Lim; Seonhee,7,0,34,27
1657281971025,MATH 10B,A02,083208,Lim; Seonhee,9,0,35,26
1657281971025,MATH 10B,A03,093472,Lim; Seonhee,5,0,34,29
1657281971025,MATH 10B,B01,083739,Sinha; Shubham,11,0,30,19
1657281977064,MATH 18,A01,083743,Cinel; Cameron Alexander,6,0,30,24
1657281977064,MATH 18,A02,083744,Cinel; Cameron Alexander,17,0,30,13
1657281977064,MATH 18,A03,083745,Cinel; Cameron Alexander,8,0,30,22
1657281977064,MATH 18,B01,083748,Rideout; David Porter,4,0,37,33
1657281977064,MATH 18,B02,083749,Rideout; David Porter,4,0,36,32
1657281977064,MATH 18,B03,083750,Rideout; David Porter,2,0,37,35
1657281977064,MATH 18,B04,083751,Rideout; David Porter,6,0,36,30
1657281977064,MATH 18,B05,093473,Rideout; David Porter,5,0,36,31
1657281977064,MATH 18,B06,093474,Rideout; David Porter,5,0,36,31
1657281983125,MATH 20A,A01,083754,Zheng; Zequn,14,0,40,26
1657281989153,MATH 20B,A01,083756,Briones; Jor-el Thomas Caparas,3,0,36,33
1657281989153,MATH 20B,A02,083757,Briones; Jor-el Thomas Caparas,1,0,36,35
1657281989153,MATH 20B,A03,093475,Briones; Jor-el Thomas Caparas,2,0,36,34
1657281995188,MATH 20C,A01,083760,Briones; Jor-el Thomas Caparas,1,0,35,34
1657281995188,MATH 20C,A02,083761,Briones; Jor-el Thomas Caparas,8,0,35,27
1657281995188,MATH 20C,A03,093476,Briones; Jor-el Thomas Caparas,0,1,36,36
1657281995188,MATH 20C,B01,083762,Bach; Quang Tran,1,0,30,29
1657282001216,MATH 20D,A01,083765,Tran; Brian Kha,5,0,30,25
1657282001216,MATH 20D,A02,083766,Tran; Brian Kha,5,0,30,25
1657282001216,MATH 20D,A03,083767,Tran; Brian Kha,4,0,30,26
1657282007244,MATH 20E,A01,083771,Ganguly; Soumya,7,0,32,25
1657282007244,MATH 20E,A02,083772,Ganguly; Soumya,7,0,32,25
1657282007244,MATH 20E,B01,083773,Ciotti; Benjamin,19,0,35,16
1657282007244,MATH 20E,B02,083774,Ciotti; Benjamin,17,0,35,18
1657282013283,MATH 103A,A01,083777,Greenfeld; Be'Eri,3,0,36,33
1657282013283,MATH 103A,A02,083778,Greenfeld; Be'Eri,5,0,36,31
1657282013283,MATH 103A,A03,093561,Greenfeld; Be'Eri,4,0,36,32
1657282013283,MATH 103A,B01,083779,Greenfeld; Be'Eri,6,0,36,30
1657282013283,MATH 103A,B02,083780,Greenfeld; Be'Eri,3,0,36,33
1657282013283,MATH 103A,B03,093562,Greenfeld; Be'Eri,3,0,36,33
1657282019316,MATH 105,A01,085443,Carter; Anne Toulson,15,0,35,20
1657282019316,MATH 105,A02,093477,Carter; Anne Toulson,20,0,35,15
1657282025343,MATH 109,A01,083213,Ganzberger; Geoffrey Michael,2,0,34,32
1657282025343,MATH 109,A02,083214,Ganzberger; Geoffrey Michael,4,0,34,30
1657282025343,MATH 109,A03,093478,Ganzberger; Geoffrey Michael,2,0,34,32
1657282025343,MATH 109,B01,083215,Ganzberger; Geoffrey Michael,1,0,32,31
1657282025343,MATH 109,B02,083216,Ganzberger; Geoffrey Michael,1,0,32,31
1657282025343,MATH 109,B03,093479,Ganzberger; Geoffrey Michael,8,0,32,24
1657282031391,MATH 142A,A01,083219,Chow; Bennett,7,0,32,25
1657282031391,MATH 142A,A02,083220,Chow; Bennett,10,0,32,22
1657282031391,MATH 142A,A03,093480,Chow; Bennett,7,0,32,25
1657282031391,MATH 142A,B03,093481,Chow; Bennett,8,0,32,24
1657282031391,MATH 142A,B04,093558,Chow; Bennett,12,0,32,20
1657282031391,MATH 142A,B05,093559,Chow; Bennett,6,0,32,26
1657282037418,MATH 193A,A01,083224,Rotar; Vladimir,7,0,34,27
1657282037418,MATH 193A,A02,083225,Rotar; Vladimir,6,0,34,28
1657282037418,MATH 193A,A03,083781,Rotar; Vladimir,2,0,34,32
1657282037418,MATH 193A,A04,083782,Rotar; Vladimir,8,0,34,26
1657282037418,MATH 193A,A05,093482,Rotar; Vladimir,6,0,34,28
1657282043445,MATH 197,001,091859,McAuley; Julian John,9999,0,9999,0
1657282043445,MATH 197,002,095566,Kedlaya; Kiran S.,9997,0,9999,2
1657282043445,MATH 197,003,095567,Xiao; Ming,9999,0,9999,0
1657282043445,MATH 197,004,095571,Perols; Johan Lars,9998,0,9999,1
1657282050507,COGS 9,A01,083615,Shannon; Kyle Michael,8,0,75,67
1657282056544,COGS 11,A01,083617,Boyle; Mary E. T.,22,0,48,26
1657282062580,COGS 13,A01,083071,Bastos; Amalia Pinkusfeld,9,0,71,62
1657282068609,COGS 14A,A01,092681,Semenuks; Arturs,2,1,100,98
1657282074643,COGS 14B,A01,083073,Cheng; Tzu-Han,6,0,63,57
1657282080680,COGS 17,A01,092677,Semenuks; Arturs,5,0,81,76
1657282086717,COGS 100,A01,083619,Allen; Michael Gordon,16,0,70,54
1657282092747,COGS 101A,A01,083621,Davis; Joshua Daniel,9,0,68,59
1657282098773,COGS 101B,A01,091572,Allen; Michael Gordon,11,0,65,54
1657282104817,COGS 101C,A01,083625,Delgado; Tania,17,0,35,18
1657282110847,COGS 107A,A01,083627,Boyle; Mary E. T.,13,0,60,47
1657282116872,COGS 118A,A01,083075,Gupta; Anjum,18,0,76,58
1657282122908,CSE 3,A50,083646,Miranda; Gregory Joseph,24,0,50,26
1657282128940,CSE 8A,A50,083650,Miranda; Gregory Joseph,17,1,56,39
1657282134971,CSE 11,A01,083080,Cao; Yingjun,5,15,40,35
1657282141004,CSE 12,A01,083652,Krause-Levy; Sophia Louisa,26,1,120,94
1657282147036,CSE 15L,A01,083654,Morris; Justin Loren,9,0,50,41
1657282147036,CSE 15L,A02,083655,Morris; Justin Loren,9,0,50,41
1657282153070,CSE 20,A01,083657,Tran; Khoa Dang,38,0,80,42
1657282159099,CSE 21,A01,095574,Bach; Quang Tran,22,0,48,26
1657282165137,CSE 30,A01,083084,Eldon; John,4,0,80,76
1657282165137,CSE 30,B01,095061,Bhaskar; Nishant,8,0,50,42
1657282171176,CSE 100,A01,083659,Cao; Yingjun,4,4,70,66
1657282177221,CSE 134B,A01,083661,Powell; Thomas Allan,21,0,100,79
1657282183256,CSE 140,A01,083663,Gungor; Onat,13,0,85,72
1657282189282,CSE 140L,A01,083088,Eldon; John,19,0,100,81
1657282195321,CSE 175,A01,083665,Kumar; Rakesh,3,0,25,22
1657282201352,CSE 190,A00,092507,Dubnov; Shlomo,7,0,20,13
1657282207404,ECE 45,A01,083139,Congero; Spencer William,5,0,75,70
1657282213437,ECE 65,A50,083695,Saad; Andrew S,12,0,30,18
1657282213437,ECE 65,A51,095125,Saad; Andrew S,25,0,26,1
1657282219463,ECE 109,A01,091882,Touri; Behrouz,19,0,70,51
1657282225495,ECE 180,A00,083140,Abi Samra; Nicholas Camill,1,0,30,29
1657282225495,ECE 180,B00,083141,Abi Samra; Nicholas Camill,0,0,30,30
1657282231520,MATH 10A,A01,083735,Patchell; Gregory David,2,0,30,28
1657282231520,MATH 10A,A02,083736,Patchell; Gregory David,20,0,30,10
1657282231520,MATH 10A,A03,083737,Patchell; Gregory David,16,0,30,14
1657282237555,MATH 10B,A01,083207,Lim; Seonhee,7,0,34,27
1657282237555,MATH 10B,A02,083208,Lim; Seonhee,9,0,35,26
1657282237555,MATH 10B,A03,093472,Lim; Seonhee,5,0,34,29
1657282237555,MATH 10B,B01,083739,Sinha; Shubham,11,0,30,19
1657282243598,MATH 18,A01,083743,Cinel; Cameron Alexander,6,0,30,24
1657282243598,MATH 18,A02,083744,Cinel; Cameron Alexander,17,0,30,13
1657282243598,MATH 18,A03,083745,Cinel; Cameron Alexander,8,0,30,22
1657282243598,MATH 18,B01,083748,Rideout; David Porter,4,0,37,33
1657282243598,MATH 18,B02,083749,Rideout; David Porter,4,0,36,32
1657282243598,MATH 18,B03,083750,Rideout; David Porter,2,0,37,35
1657282243598,MATH 18,B04,083751,Rideout; David Porter,6,0,36,30
1657282243598,MATH 18,B05,093473,Rideout; David Porter,5,0,36,31
1657282243598,MATH 18,B06,093474,Rideout; David Porter,5,0,36,31
1657282249635,MATH 20A,A01,083754,Zheng; Zequn,14,0,40,26
1657282255664,MATH 20B,A01,083756,Briones; Jor-el Thomas Caparas,3,0,36,33
1657282255664,MATH 20B,A02,083757,Briones; Jor-el Thomas Caparas,1,0,36,35
1657282255664,MATH 20B,A03,093475,Briones; Jor-el Thomas Caparas,2,0,36,34
1657282261691,MATH 20C,A01,083760,Briones; Jor-el Thomas Caparas,1,0,35,34
1657282261691,MATH 20C,A02,083761,Briones; Jor-el Thomas Caparas,8,0,35,27
1657282261691,MATH 20C,A03,093476,Briones; Jor-el Thomas Caparas,0,1,36,36
1657282261691,MATH 20C,B01,083762,Bach; Quang Tran,1,0,30,29
1657282267727,MATH 20D,A01,083765,Tran; Brian Kha,5,0,30,25
1657282267727,MATH 20D,A02,083766,Tran; Brian Kha,5,0,30,25
1657282267727,MATH 20D,A03,083767,Tran; Brian Kha,4,0,30,26
1657282273760,MATH 20E,A01,083771,Ganguly; Soumya,7,0,32,25
1657282273760,MATH 20E,A02,083772,Ganguly; Soumya,7,0,32,25
1657282273760,MATH 20E,B01,083773,Ciotti; Benjamin,19,0,35,16
1657282273760,MATH 20E,B02,083774,Ciotti; Benjamin,17,0,35,18
1657282279805,MATH 103A,A01,083777,Greenfeld; Be'Eri,3,0,36,33
1657282279805,MATH 103A,A02,083778,Greenfeld; Be'Eri,5,0,36,31
1657282279805,MATH 103A,A03,093561,Greenfeld; Be'Eri,4,0,36,32
1657282279805,MATH 103A,B01,083779,Greenfeld; Be'Eri,6,0,36,30
1657282279805,MATH 103A,B02,083780,Greenfeld; Be'Eri,3,0,36,33
1657282279805,MATH 103A,B03,093562,Greenfeld; Be'Eri,3,0,36,33
1657282285848,MATH 105,A01,085443,Carter; Anne Toulson,15,0,35,20
1657282285848,MATH 105,A02,093477,Carter; Anne Toulson,20,0,35,15
1657282291875,MATH 109,A01,083213,Ganzberger; Geoffrey Michael,2,0,34,32
1657282291875,MATH 109,A02,083214,Ganzberger; Geoffrey Michael,4,0,34,30
1657282291875,MATH 109,A03,093478,Ganzberger; Geoffrey Michael,2,0,34,32
1657282291875,MATH 109,B01,083215,Ganzberger; Geoffrey Michael,1,0,32,31
1657282291875,MATH 109,B02,083216,Ganzberger; Geoffrey Michael,1,0,32,31
1657282291875,MATH 109,B03,093479,Ganzberger; Geoffrey Michael,8,0,32,24
1657282297922,MATH 142A,A01,083219,Chow; Bennett,7,0,32,25
1657282297922,MATH 142A,A02,083220,Chow; Bennett,10,0,32,22
1657282297922,MATH 142A,A03,093480,Chow; Bennett,7,0,32,25
1657282297922,MATH 142A,B03,093481,Chow; Bennett,8,0,32,24
1657282297922,MATH 142A,B04,093558,Chow; Bennett,12,0,32,20
1657282297922,MATH 142A,B05,093559,Chow; Bennett,6,0,32,26
1657282303947,MATH 193A,A01,083224,Rotar; Vladimir,7,0,34,27
1657282303947,MATH 193A,A02,083225,Rotar; Vladimir,6,0,34,28
1657282303947,MATH 193A,A03,083781,Rotar; Vladimir,2,0,34,32
1657282303947,MATH 193A,A04,083782,Rotar; Vladimir,8,0,34,26
1657282303947,MATH 193A,A05,093482,Rotar; Vladimir,6,0,34,28
1657282309974,MATH 197,001,091859,McAuley; Julian John,9999,0,9999,0
1657282309974,MATH 197,002,095566,Kedlaya; Kiran S.,9997,0,9999,2
1657282309974,MATH 197,003,095567,Xiao; Ming,9999,0,9999,0
1657282309974,MATH 197,004,095571,Perols; Johan Lars,9998,0,9999,1
1657282317048,COGS 9,A01,083615,Shannon; Kyle Michael,8,0,75,67
1657282323073,COGS 11,A01,083617,Boyle; Mary E. T.,22,0,48,26
1657282329117,COGS 13,A01,083071,Bastos; Amalia Pinkusfeld,9,0,71,62
1657282335155,COGS 14A,A01,092681,Semenuks; Arturs,2,1,100,98
1657282341190,COGS 14B,A01,083073,Cheng; Tzu-Han,6,0,63,57
1657282347221,COGS 17,A01,092677,Semenuks; Arturs,5,0,81,76
1657282353248,COGS 100,A01,083619,Allen; Michael Gordon,16,0,70,54
1657282359280,COGS 101A,A01,083621,Davis; Joshua Daniel,9,0,68,59
1657282365316,COGS 101B,A01,091572,Allen; Michael Gordon,11,0,65,54
1657282371348,COGS 101C,A01,083625,Delgado; Tania,17,0,35,18
1657282377384,COGS 107A,A01,083627,Boyle; Mary E. T.,13,0,60,47
1657282383409,COGS 118A,A01,083075,Gupta; Anjum,18,0,76,58
1657282389447,CSE 3,A50,083646,Miranda; Gregory Joseph,24,0,50,26
1657282395482,CSE 8A,A50,083650,Miranda; Gregory Joseph,17,1,56,39
1657282401511,CSE 11,A01,083080,Cao; Yingjun,5,15,40,35
1657282407543,CSE 12,A01,083652,Krause-Levy; Sophia Louisa,26,1,120,94
1657282413584,CSE 15L,A01,083654,Morris; Justin Loren,9,0,50,41
1657282413584,CSE 15L,A02,083655,Morris; Justin Loren,9,0,50,41
1657282419696,CSE 20,A01,083657,Tran; Khoa Dang,38,0,80,42
1657282425727,CSE 21,A01,095574,Bach; Quang Tran,22,0,48,26
1657282431756,CSE 30,A01,083084,Eldon; John,4,0,80,76
1657282431756,CSE 30,B01,095061,Bhaskar; Nishant,8,0,50,42
1657282437783,CSE 100,A01,083659,Cao; Yingjun,4,4,70,66
1657282443808,CSE 134B,A01,083661,Powell; Thomas Allan,21,0,100,79
1657282449835,CSE 140,A01,083663,Gungor; Onat,13,0,85,72
1657282455872,CSE 140L,A01,083088,Eldon; John,19,0,100,81
1657282461897,CSE 175,A01,083665,Kumar; Rakesh,3,0,25,22
1657282467924,CSE 190,A00,092507,Dubnov; Shlomo,7,0,20,13
1657282473950,ECE 45,A01,083139,Congero; Spencer William,5,0,75,70
1657282479989,ECE 65,A50,083695,Saad; Andrew S,12,0,30,18
1657282479989,ECE 65,A51,095125,Saad; Andrew S,25,0,26,1
1657282486016,ECE 109,A01,091882,Touri; Behrouz,19,0,70,51
1657282492045,ECE 180,A00,083140,Abi Samra; Nicholas Camill,1,0,30,29
1657282492045,ECE 180,B00,083141,Abi Samra; Nicholas Camill,0,0,30,30
1657282498117,MATH 10A,A01,083735,Patchell; Gregory David,2,0,30,28
1657282498117,MATH 10A,A02,083736,Patchell; Gregory David,20,0,30,10
1657282498117,MATH 10A,A03,083737,Patchell; Gregory David,16,0,30,14
1657282504154,MATH 10B,A01,083207,Lim; Seonhee,7,0,34,27
1657282504154,MATH 10B,A02,083208,Lim; Seonhee,9,0,35,26
1657282504154,MATH 10B,A03,093472,Lim; Seonhee,5,0,34,29
1657282504154,MATH 10B,B01,083739,Sinha; Shubham,11,0,30,19
1657282510192,MATH 18,A01,083743,Cinel; Cameron Alexander,6,0,30,24
1657282510192,MATH 18,A02,083744,Cinel; Cameron Alexander,17,0,30,13
1657282510192,MATH 18,A03,083745,Cinel; Cameron Alexander,8,0,30,22
1657282510192,MATH 18,B01,083748,Rideout; David Porter,4,0,37,33
1657282510192,MATH 18,B02,083749,Rideout; David Porter,4,0,36,32
1657282510192,MATH 18,B03,083750,Rideout; David Porter,2,0,37,35
1657282510192,MATH 18,B04,083751,Rideout; David Porter,6,0,36,30
1657282510192,MATH 18,B05,093473,Rideout; David Porter,5,0,36,31
1657282510192,MATH 18,B06,093474,Rideout; David Porter,5,0,36,31
1657282516218,MATH 20A,A01,083754,Zheng; Zequn,14,0,40,26
1657282522247,MATH 20B,A01,083756,Briones; Jor-el Thomas Caparas,3,0,36,33
1657282522247,MATH 20B,A02,083757,Briones; Jor-el Thomas Caparas,1,0,36,35
1657282522247,MATH 20B,A03,093475,Briones; Jor-el Thomas Caparas,2,0,36,34
1657282528273,MATH 20C,A01,083760,Briones; Jor-el Thomas Caparas,1,0,35,34
1657282528273,MATH 20C,A02,083761,Briones; Jor-el Thomas Caparas,8,0,35,27
1657282528273,MATH 20C,A03,093476,Briones; Jor-el Thomas Caparas,0,1,36,36
1657282528273,MATH 20C,B01,083762,Bach; Quang Tran,1,0,30,29
1657282534301,MATH 20D,A01,083765,Tran; Brian Kha,5,0,30,25
1657282534301,MATH 20D,A02,083766,Tran; Brian Kha,5,0,30,25
1657282534301,MATH 20D,A03,083767,Tran; Brian Kha,4,0,30,26
1657282540328,MATH 20E,A01,083771,Ganguly; Soumya,7,0,32,25
1657282540328,MATH 20E,A02,083772,Ganguly; Soumya,7,0,32,25
1657282540328,MATH 20E,B01,083773,Ciotti; Benjamin,19,0,35,16
1657282540328,MATH 20E,B02,083774,Ciotti; Benjamin,17,0,35,18
1657282546357,MATH 103A,A01,083777,Greenfeld; Be'Eri,3,0,36,33
1657282546357,MATH 103A,A02,083778,Greenfeld; Be'Eri,5,0,36,31
1657282546357,MATH 103A,A03,093561,Greenfeld; Be'Eri,4,0,36,32
1657282546357,MATH 103A,B01,083779,Greenfeld; Be'Eri,6,0,36,30
1657282546357,MATH 103A,B02,083780,Greenfeld; Be'Eri,3,0,36,33
1657282546357,MATH 103A,B03,093562,Greenfeld; Be'Eri,3,0,36,33
1657282552389,MATH 105,A01,085443,Carter; Anne Toulson,15,0,35,20
1657282552389,MATH 105,A02,093477,Carter; Anne Toulson,20,0,35,15
1657282558417,MATH 109,A01,083213,Ganzberger; Geoffrey Michael,2,0,34,32
1657282558417,MATH 109,A02,083214,Ganzberger; Geoffrey Michael,4,0,34,30
1657282558417,MATH 109,A03,093478,Ganzberger; Geoffrey Michael,2,0,34,32
1657282558417,MATH 109,B01,083215,Ganzberger; Geoffrey Michael,1,0,32,31
1657282558417,MATH 109,B02,083216,Ganzberger; Geoffrey Michael,1,0,32,31
1657282558417,MATH 109,B03,093479,Ganzberger; Geoffrey Michael,8,0,32,24
1657282564448,MATH 142A,A01,083219,Chow; Bennett,7,0,32,25
1657282564448,MATH 142A,A02,083220,Chow; Bennett,10,0,32,22
1657282564448,MATH 142A,A03,093480,Chow; Bennett,7,0,32,25
1657282564448,MATH 142A,B03,093481,Chow; Bennett,8,0,32,24
1657282564448,MATH 142A,B04,093558,Chow; Bennett,12,0,32,20
1657282564448,MATH 142A,B05,093559,Chow; Bennett,6,0,32,26
1657282570474,MATH 193A,A01,083224,Rotar; Vladimir,7,0,34,27
1657282570474,MATH 193A,A02,083225,Rotar; Vladimir,6,0,34,28
1657282570474,MATH 193A,A03,083781,Rotar; Vladimir,2,0,34,32
1657282570474,MATH 193A,A04,083782,Rotar; Vladimir,8,0,34,26
1657282570474,MATH 193A,A05,093482,Rotar; Vladimir,6,0,34,28
1657282576504,MATH 197,001,091859,McAuley; Julian John,9999,0,9999,0
1657282576504,MATH 197,002,095566,Kedlaya; Kiran S.,9997,0,9999,2
1657282576504,MATH 197,003,095567,Xiao; Ming,9999,0,9999,0
1657282576504,MATH 197,004,095571,Perols; Johan Lars,9998,0,9999,1
1657282583577,COGS 9,A01,083615,Shannon; Kyle Michael,8,0,75,67
1657282589611,COGS 11,A01,083617,Boyle; Mary E. T.,22,0,48,26
1657282595642,COGS 13,A01,083071,Bastos; Amalia Pinkusfeld,9,0,71,62
1657282601669,COGS 14A,A01,092681,Semenuks; Arturs,2,1,100,98
1657282607694,COGS 14B,A01,083073,Cheng; Tzu-Han,6,0,63,57
1657282613721,COGS 17,A01,092677,Semenuks; Arturs,5,0,81,76
1657282619766,COGS 100,A01,083619,Allen; Michael Gordon,16,0,70,54
1657282625797,COGS 101A,A01,083621,Davis; Joshua Daniel,9,0,68,59
1657282631832,COGS 101B,A01,091572,Allen; Michael Gordon,11,0,65,54
1657282637860,COGS 101C,A01,083625,Delgado; Tania,17,0,35,18
1657282643888,COGS 107A,A01,083627,Boyle; Mary E. T.,13,0,60,47
1657282649914,COGS 118A,A01,083075,Gupta; Anjum,18,0,76,58
1657282655948,CSE 3,A50,083646,Miranda; Gregory Joseph,24,0,50,26
1657282661975,CSE 8A,A50,083650,Miranda; Gregory Joseph,17,1,56,39
1657282668000,CSE 11,A01,083080,Cao; Yingjun,5,15,40,35
1657282674042,CSE 12,A01,083652,Krause-Levy; Sophia Louisa,26,1,120,94
1657282680075,CSE 15L,A01,083654,Morris; Justin Loren,9,0,50,41
1657282680075,CSE 15L,A02,083655,Morris; Justin Loren,9,0,50,41
1657282686108,CSE 20,A01,083657,Tran; Khoa Dang,38,0,80,42
1657282692134,CSE 21,A01,095574,Bach; Quang Tran,22,0,48,26
1657282698161,CSE 30,A01,083084,Eldon; John,4,0,80,76
1657282698161,CSE 30,B01,095061,Bhaskar; Nishant,8,0,50,42
1657282704193,CSE 100,A01,083659,Cao; Yingjun,4,4,70,66
1657282710225,CSE 134B,A01,083661,Powell; Thomas Allan,21,0,100,79
1657282716255,CSE 140,A01,083663,Gungor; Onat,13,0,85,72
1657282722282,CSE 140L,A01,083088,Eldon; John,19,0,100,81
1657282728320,CSE 175,A01,083665,Kumar; Rakesh,3,0,25,22
1657282734359,CSE 190,A00,092507,Dubnov; Shlomo,7,0,20,13
1657282740396,ECE 45,A01,083139,Congero; Spencer William,5,0,75,70
1657282746433,ECE 65,A50,083695,Saad; Andrew S,12,0,30,18
1657282746433,ECE 65,A51,095125,Saad; Andrew S,25,0,26,1
1657282752464,ECE 109,A01,091882,Touri; Behrouz,19,0,70,51
1657282758496,ECE 180,A00,083140,Abi Samra; Nicholas Camill,1,0,30,29
1657282758496,ECE 180,B00,083141,Abi Samra; Nicholas Camill,0,0,30,30
1657282764522,MATH 10A,A01,083735,Patchell; Gregory David,2,0,30,28
1657282764522,MATH 10A,A02,083736,Patchell; Gregory David,20,0,30,10
1657282764522,MATH 10A,A03,083737,Patchell; Gregory David,16,0,30,14
1657282770551,MATH 10B,A01,083207,Lim; Seonhee,7,0,34,27
1657282770551,MATH 10B,A02,083208,Lim; Seonhee,9,0,35,26
1657282770551,MATH 10B,A03,093472,Lim; Seonhee,5,0,34,29
1657282770551,MATH 10B,B01,083739,Sinha; Shubham,11,0,30,19
1657282776581,MATH 18,A01,083743,Cinel; Cameron Alexander,6,0,30,24
1657282776581,MATH 18,A02,083744,Cinel; Cameron Alexander,17,0,30,13
1657282776581,MATH 18,A03,083745,Cinel; Cameron Alexander,8,0,30,22
1657282776581,MATH 18,B01,083748,Rideout; David Porter,4,0,37,33
1657282776581,MATH 18,B02,083749,Rideout; David Porter,4,0,36,32
1657282776581,MATH 18,B03,083750,Rideout; David Porter,2,0,37,35
1657282776581,MATH 18,B04,083751,Rideout; David Porter,6,0,36,30
1657282776581,MATH 18,B05,093473,Rideout; David Porter,5,0,36,31
1657282776581,MATH 18,B06,093474,Rideout; David Porter,5,0,36,31
1657282782614,MATH 20A,A01,083754,Zheng; Zequn,14,0,40,26
1657282788642,MATH 20B,A01,083756,Briones; Jor-el Thomas Caparas,3,0,36,33
1657282788642,MATH 20B,A02,083757,Briones; Jor-el Thomas Caparas,1,0,36,35
1657282788642,MATH 20B,A03,093475,Briones; Jor-el Thomas Caparas,2,0,36,34
1657282794670,MATH 20C,A01,083760,Briones; Jor-el Thomas Caparas,1,0,35,34
1657282794670,MATH 20C,A02,083761,Briones; Jor-el Thomas Caparas,8,0,35,27
1657282794670,MATH 20C,A03,093476,Briones; Jor-el Thomas Caparas,0,1,36,36
1657282794670,MATH 20C,B01,083762,Bach; Quang Tran,1,0,30,29
1657282800698,MATH 20D,A01,083765,Tran; Brian Kha,5,0,30,25
1657282800698,MATH 20D,A02,083766,Tran; Brian Kha,5,0,30,25
1657282800698,MATH 20D,A03,083767,Tran; Brian Kha,4,0,30,26
1657282806737,MATH 20E,A01,083771,Ganguly; Soumya,7,0,32,25
1657282806737,MATH 20E,A02,083772,Ganguly; Soumya,7,0,32,25
1657282806737,MATH 20E,B01,083773,Ciotti; Benjamin,19,0,35,16
1657282806737,MATH 20E,B02,083774,Ciotti; Benjamin,17,0,35,18
1657282812770,MATH 103A,A01,083777,Greenfeld; Be'Eri,3,0,36,33
1657282812770,MATH 103A,A02,083778,Greenfeld; Be'Eri,5,0,36,31
1657282812770,MATH 103A,A03,093561,Greenfeld; Be'Eri,4,0,36,32
1657282812770,MATH 103A,B01,083779,Greenfeld; Be'Eri,6,0,36,30
1657282812770,MATH 103A,B02,083780,Greenfeld; Be'Eri,3,0,36,33
1657282812770,MATH 103A,B03,093562,Greenfeld; Be'Eri,3,0,36,33
1657282818803,MATH 105,A01,085443,Carter; Anne Toulson,15,0,35,20
1657282818803,MATH 105,A02,093477,Carter; Anne Toulson,20,0,35,15
1657282824835,MATH 109,A01,083213,Ganzberger; Geoffrey Michael,2,0,34,32
1657282824835,MATH 109,A02,083214,Ganzberger; Geoffrey Michael,4,0,34,30
1657282824835,MATH 109,A03,093478,Ganzberger; Geoffrey Michael,2,0,34,32
1657282824835,MATH 109,B01,083215,Ganzberger; Geoffrey Michael,1,0,32,31
1657282824835,MATH 109,B02,083216,Ganzberger; Geoffrey Michael,1,0,32,31
1657282824835,MATH 109,B03,093479,Ganzberger; Geoffrey Michael,8,0,32,24
1657282830880,MATH 142A,A01,083219,Chow; Bennett,7,0,32,25
1657282830880,MATH 142A,A02,083220,Chow; Bennett,10,0,32,22
1657282830880,MATH 142A,A03,093480,Chow; Bennett,7,0,32,25
1657282830880,MATH 142A,B03,093481,Chow; Bennett,8,0,32,24
1657282830880,MATH 142A,B04,093558,Chow; Bennett,12,0,32,20
1657282830880,MATH 142A,B05,093559,Chow; Bennett,6,0,32,26
1657282836907,MATH 193A,A01,083224,Rotar; Vladimir,7,0,34,27
1657282836907,MATH 193A,A02,083225,Rotar; Vladimir,6,0,34,28
1657282836907,MATH 193A,A03,083781,Rotar; Vladimir,2,0,34,32
1657282836907,MATH 193A,A04,083782,Rotar; Vladimir,8,0,34,26
1657282836907,MATH 193A,A05,093482,Rotar; Vladimir,6,0,34,28
1657282842944,MATH 197,001,091859,McAuley; Julian John,9999,0,9999,0
1657282842944,MATH 197,002,095566,Kedlaya; Kiran S.,9997,0,9999,2
1657282842944,MATH 197,003,095567,Xiao; Ming,9999,0,9999,0
1657282842944,MATH 197,004,095571,Perols; Johan Lars,9998,0,9999,1
1657282850013,COGS 9,A01,083615,Shannon; Kyle Michael,8,0,75,67
1657282856043,COGS 11,A01,083617,Boyle; Mary E. T.,22,0,48,26
1657282862068,COGS 13,A01,083071,Bastos; Amalia Pinkusfeld,9,0,71,62
1657282868099,COGS 14A,A01,092681,Semenuks; Arturs,2,1,100,98
1657282874131,COGS 14B,A01,083073,Cheng; Tzu-Han,6,0,63,57
1657282880160,COGS 17,A01,092677,Semenuks; Arturs,5,0,81,76
1657282886184,COGS 100,A01,083619,Allen; Michael Gordon,16,0,70,54
1657282892212,COGS 101A,A01,083621,Davis; Joshua Daniel,9,0,68,59
1657282898243,COGS 101B,A01,091572,Allen; Michael Gordon,11,0,65,54
1657282904271,COGS 101C,A01,083625,Delgado; Tania,17,0,35,18
1657282910301,COGS 107A,A01,083627,Boyle; Mary E. T.,13,0,60,47
1657282916344,COGS 118A,A01,083075,Gupta; Anjum,18,0,76,58
1657282922378,CSE 3,A50,083646,Miranda; Gregory Joseph,24,0,50,26
1657282928409,CSE 8A,A50,083650,Miranda; Gregory Joseph,17,1,56,39
1657282934435,CSE 11,A01,083080,Cao; Yingjun,5,15,40,35
1657282940463,CSE 12,A01,083652,Krause-Levy; Sophia Louisa,26,1,120,94
1657282946489,CSE 15L,A01,083654,Morris; Justin Loren,9,0,50,41
1657282946489,CSE 15L,A02,083655,Morris; Justin Loren,9,0,50,41
1657282952514,CSE 20,A01,083657,Tran; Khoa Dang,38,0,80,42
1657282958548,CSE 21,A01,095574,Bach; Quang Tran,22,0,48,26
1657282964575,CSE 30,A01,083084,Eldon; John,4,0,80,76
1657282964575,CSE 30,B01,095061,Bhaskar; Nishant,8,0,50,42
1657282970601,CSE 100,A01,083659,Cao; Yingjun,4,4,70,66
1657282976627,CSE 134B,A01,083661,Powell; Thomas Allan,21,0,100,79
1657282982652,CSE 140,A01,083663,Gungor; Onat,13,0,85,72
1657282988676,CSE 140L,A01,083088,Eldon; John,19,0,100,81
1657282994705,CSE 175,A01,083665,Kumar; Rakesh,3,0,25,22
1657283000731,CSE 190,A00,092507,Dubnov; Shlomo,7,0,20,13
1657283006754,ECE 45,A01,083139,Congero; Spencer William,5,0,75,70
1657283012780,ECE 65,A50,083695,Saad; Andrew S,12,0,30,18
1657283012780,ECE 65,A51,095125,Saad; Andrew S,25,0,26,1
1657283018878,ECE 109,A01,091882,Touri; Behrouz,19,0,70,51
1657283024908,ECE 180,A00,083140,Abi Samra; Nicholas Camill,1,0,30,29
1657283024908,ECE 180,B00,083141,Abi Samra; Nicholas Camill,0,0,30,30
1657283030944,MATH 10A,A01,083735,Patchell; Gregory David,2,0,30,28
1657283030944,MATH 10A,A02,083736,Patchell; Gregory David,20,0,30,10
1657283030944,MATH 10A,A03,083737,Patchell; Gregory David,16,0,30,14
1657283036977,MATH 10B,A01,083207,Lim; Seonhee,7,0,34,27
1657283036977,MATH 10B,A02,083208,Lim; Seonhee,9,0,35,26
1657283036977,MATH 10B,A03,093472,Lim; Seonhee,5,0,34,29
1657283036977,MATH 10B,B01,083739,Sinha; Shubham,11,0,30,19
1657283043003,MATH 18,A01,083743,Cinel; Cameron Alexander,6,0,30,24
1657283043003,MATH 18,A02,083744,Cinel; Cameron Alexander,17,0,30,13
1657283043003,MATH 18,A03,083745,Cinel; Cameron Alexander,8,0,30,22
1657283043003,MATH 18,B01,083748,Rideout; David Porter,4,0,37,33
1657283043003,MATH 18,B02,083749,Rideout; David Porter,4,0,36,32
1657283043003,MATH 18,B03,083750,Rideout; David Porter,2,0,37,35
1657283043003,MATH 18,B04,083751,Rideout; David Porter,6,0,36,30
1657283043003,MATH 18,B05,093473,Rideout; David Porter,5,0,36,31
1657283043003,MATH 18,B06,093474,Rideout; David Porter,5,0,36,31
1657283049032,MATH 20A,A01,083754,Zheng; Zequn,14,0,40,26
1657283055067,MATH 20B,A01,083756,Briones; Jor-el Thomas Caparas,3,0,36,33
1657283055067,MATH 20B,A02,083757,Briones; Jor-el Thomas Caparas,1,0,36,35
1657283055067,MATH 20B,A03,093475,Briones; Jor-el Thomas Caparas,2,0,36,34
1657283061094,MATH 20C,A01,083760,Briones; Jor-el Thomas Caparas,1,0,35,34
1657283061094,MATH 20C,A02,083761,Briones; Jor-el Thomas Caparas,8,0,35,27
1657283061094,MATH 20C,A03,093476,Briones; Jor-el Thomas Caparas,0,1,36,36
1657283061094,MATH 20C,B01,083762,Bach; Quang Tran,1,0,30,29
1657283067120,MATH 20D,A01,083765,Tran; Brian Kha,5,0,30,25
1657283067120,MATH 20D,A02,083766,Tran; Brian Kha,5,0,30,25
1657283067120,MATH 20D,A03,083767,Tran; Brian Kha,4,0,30,26
1657283073154,MATH 20E,A01,083771,Ganguly; Soumya,7,0,32,25
1657283073154,MATH 20E,A02,083772,Ganguly; Soumya,7,0,32,25
1657283073154,MATH 20E,B01,083773,Ciotti; Benjamin,19,0,35,16
1657283073154,MATH 20E,B02,083774,Ciotti; Benjamin,17,0,35,18
1657283079181,MATH 103A,A01,083777,Greenfeld; Be'Eri,3,0,36,33
1657283079181,MATH 103A,A02,083778,Greenfeld; Be'Eri,5,0,36,31
1657283079181,MATH 103A,A03,093561,Greenfeld; Be'Eri,4,0,36,32
1657283079181,MATH 103A,B01,083779,Greenfeld; Be'Eri,6,0,36,30
1657283079181,MATH 103A,B02,083780,Greenfeld; Be'Eri,3,0,36,33
1657283079181,MATH 103A,B03,093562,Greenfeld; Be'Eri,3,0,36,33
1657283085212,MATH 105,A01,085443,Carter; Anne Toulson,15,0,35,20
1657283085212,MATH 105,A02,093477,Carter; Anne Toulson,20,0,35,15
1657283091236,MATH 109,A01,083213,Ganzberger; Geoffrey Michael,2,0,34,32
1657283091236,MATH 109,A02,083214,Ganzberger; Geoffrey Michael,4,0,34,30
1657283091236,MATH 109,A03,093478,Ganzberger; Geoffrey Michael,2,0,34,32
1657283091236,MATH 109,B01,083215,Ganzberger; Geoffrey Michael,1,0,32,31
1657283091236,MATH 109,B02,083216,Ganzberger; Geoffrey Michael,1,0,32,31
1657283091236,MATH 109,B03,093479,Ganzberger; Geoffrey Michael,8,0,32,24
1657283097261,MATH 142A,A01,083219,Chow; Bennett,7,0,32,25
1657283097261,MATH 142A,A02,083220,Chow; Bennett,10,0,32,22
1657283097261,MATH 142A,A03,093480,Chow; Bennett,7,0,32,25
1657283097261,MATH 142A,B03,093481,Chow; Bennett,8,0,32,24
1657283097261,MATH 142A,B04,093558,Chow; Bennett,12,0,32,20
1657283097261,MATH 142A,B05,093559,Chow; Bennett,6,0,32,26
1657283103292,MATH 193A,A01,083224,Rotar; Vladimir,7,0,34,27
1657283103292,MATH 193A,A02,083225,Rotar; Vladimir,6,0,34,28
1657283103292,MATH 193A,A03,083781,Rotar; Vladimir,2,0,34,32
1657283103292,MATH 193A,A04,083782,Rotar; Vladimir,8,0,34,26
1657283103292,MATH 193A,A05,093482,Rotar; Vladimir,6,0,34,28
1657283109335,MATH 197,001,091859,McAuley; Julian John,9999,0,9999,0
1657283109335,MATH 197,002,095566,Kedlaya; Kiran S.,9997,0,9999,2
1657283109335,MATH 197,003,095567,Xiao; Ming,9999,0,9999,0
1657283109335,MATH 197,004,095571,Perols; Johan Lars,9998,0,9999,1
1657283116390,COGS 9,A01,083615,Shannon; Kyle Michael,8,0,75,67
1657283122426,COGS 11,A01,083617,Boyle; Mary E. T.,22,0,48,26
1657283128456,COGS 13,A01,083071,Bastos; Amalia Pinkusfeld,9,0,71,62
1657283134484,COGS 14A,A01,092681,Semenuks; Arturs,2,1,100,98
1657283140512,COGS 14B,A01,083073,Cheng; Tzu-Han,6,0,63,57
1657283146538,COGS 17,A01,092677,Semenuks; Arturs,5,0,81,76
1657283152563,COGS 100,A01,083619,Allen; Michael Gordon,16,0,70,54
1657283158587,COGS 101A,A01,083621,Davis; Joshua Daniel,9,0,68,59
1657283164620,COGS 101B,A01,091572,Allen; Michael Gordon,11,0,65,54
1657283170645,COGS 101C,A01,083625,Delgado; Tania,17,0,35,18
1657283176671,COGS 107A,A01,083627,Boyle; Mary E. T.,13,0,60,47
1657283182695,COGS 118A,A01,083075,Gupta; Anjum,18,0,76,58
1657283188720,CSE 3,A50,083646,Miranda; Gregory Joseph,24,0,50,26
1657283194753,CSE 8A,A50,083650,Miranda; Gregory Joseph,17,1,56,39
1657283200782,CSE 11,A01,083080,Cao; Yingjun,5,15,40,35
1657283206806,CSE 12,A01,083652,Krause-Levy; Sophia Louisa,26,1,120,94
1657283212835,CSE 15L,A01,083654,Morris; Justin Loren,9,0,50,41
1657283212835,CSE 15L,A02,083655,Morris; Justin Loren,9,0,50,41
1657283218859,CSE 20,A01,083657,Tran; Khoa Dang,38,0,80,42
1657283224891,CSE 21,A01,095574,Bach; Quang Tran,22,0,48,26
1657283230921,CSE 30,A01,083084,Eldon; John,4,0,80,76
1657283230921,CSE 30,B01,095061,Bhaskar; Nishant,8,0,50,42
1657283236949,CSE 100,A01,083659,Cao; Yingjun,4,4,70,66
1657283242978,CSE 134B,A01,083661,Powell; Thomas Allan,21,0,100,79
1657283249002,CSE 140,A01,083663,Gungor; Onat,13,0,85,72
1657283255028,CSE 140L,A01,083088,Eldon; John,19,0,100,81
1657283261058,CSE 175,A01,083665,Kumar; Rakesh,3,0,25,22
1657283267092,CSE 190,A00,092507,Dubnov; Shlomo,7,0,20,13
1657283273121,ECE 45,A01,083139,Congero; Spencer William,5,0,75,70
1657283279147,ECE 65,A50,083695,Saad; Andrew S,12,0,30,18
1657283279147,ECE 65,A51,095125,Saad; Andrew S,25,0,26,1
1657283285175,ECE 109,A01,091882,Touri; Behrouz,19,0,70,51
1657283291205,ECE 180,A00,083140,Abi Samra; Nicholas Camill,1,0,30,29
1657283291205,ECE 180,B00,083141,Abi Samra; Nicholas Camill,0,0,30,30
1657283297235,MATH 10A,A01,083735,Patchell; Gregory David,2,0,30,28
1657283297235,MATH 10A,A02,083736,Patchell; Gregory David,20,0,30,10
1657283297235,MATH 10A,A03,083737,Patchell; Gregory David,16,0,30,14
1657283303260,MATH 10B,A01,083207,Lim; Seonhee,7,0,34,27
1657283303260,MATH 10B,A02,083208,Lim; Seonhee,9,0,35,26
1657283303260,MATH 10B,A03,093472,Lim; Seonhee,5,0,34,29
1657283303260,MATH 10B,B01,083739,Sinha; Shubham,11,0,30,19
1657283309288,MATH 18,A01,083743,Cinel; Cameron Alexander,6,0,30,24
1657283309288,MATH 18,A02,083744,Cinel; Cameron Alexander,17,0,30,13
1657283309288,MATH 18,A03,083745,Cinel; Cameron Alexander,8,0,30,22
1657283309288,MATH 18,B01,083748,Rideout; David Porter,4,0,37,33
1657283309288,MATH 18,B02,083749,Rideout; David Porter,4,0,36,32
1657283309288,MATH 18,B03,083750,Rideout; David Porter,2,0,37,35
1657283309288,MATH 18,B04,083751,Rideout; David Porter,6,0,36,30
1657283309288,MATH 18,B05,093473,Rideout; David Porter,5,0,36,31
1657283309288,MATH 18,B06,093474,Rideout; David Porter,5,0,36,31
1657283315316,MATH 20A,A01,083754,Zheng; Zequn,14,0,40,26
1657283321347,MATH 20B,A01,083756,Briones; Jor-el Thomas Caparas,3,0,36,33
1657283321347,MATH 20B,A02,083757,Briones; Jor-el Thomas Caparas,1,0,36,35
1657283321347,MATH 20B,A03,093475,Briones; Jor-el Thomas Caparas,2,0,36,34
1657283327377,MATH 20C,A01,083760,Briones; Jor-el Thomas Caparas,1,0,35,34
1657283327377,MATH 20C,A02,083761,Briones; Jor-el Thomas Caparas,8,0,35,27
1657283327377,MATH 20C,A03,093476,Briones; Jor-el Thomas Caparas,0,1,36,36
1657283327377,MATH 20C,B01,083762,Bach; Quang Tran,1,0,30,29
1657283333402,MATH 20D,A01,083765,Tran; Brian Kha,5,0,30,25
1657283333402,MATH 20D,A02,083766,Tran; Brian Kha,5,0,30,25
1657283333402,MATH 20D,A03,083767,Tran; Brian Kha,4,0,30,26
1657283339438,MATH 20E,A01,083771,Ganguly; Soumya,7,0,32,25
1657283339438,MATH 20E,A02,083772,Ganguly; Soumya,7,0,32,25
1657283339438,MATH 20E,B01,083773,Ciotti; Benjamin,19,0,35,16
1657283339438,MATH 20E,B02,083774,Ciotti; Benjamin,17,0,35,18
1657283345469,MATH 103A,A01,083777,Greenfeld; Be'Eri,3,0,36,33
1657283345469,MATH 103A,A02,083778,Greenfeld; Be'Eri,5,0,36,31
1657283345469,MATH 103A,A03,093561,Greenfeld; Be'Eri,4,0,36,32
1657283345469,MATH 103A,B01,083779,Greenfeld; Be'Eri,6,0,36,30
1657283345469,MATH 103A,B02,083780,Greenfeld; Be'Eri,3,0,36,33
1657283345469,MATH 103A,B03,093562,Greenfeld; Be'Eri,3,0,36,33
1657283351502,MATH 105,A01,085443,Carter; Anne Toulson,15,0,35,20
1657283351502,MATH 105,A02,093477,Carter; Anne Toulson,20,0,35,15
1657283357529,MATH 109,A01,083213,Ganzberger; Geoffrey Michael,2,0,34,32
1657283357529,MATH 109,A02,083214,Ganzberger; Geoffrey Michael,4,0,34,30
1657283357529,MATH 109,A03,093478,Ganzberger; Geoffrey Michael,2,0,34,32
1657283357529,MATH 109,B01,083215,Ganzberger; Geoffrey Michael,1,0,32,31
1657283357529,MATH 109,B02,083216,Ganzberger; Geoffrey Michael,1,0,32,31
1657283357529,MATH 109,B03,093479,Ganzberger; Geoffrey Michael,8,0,32,24
1657283363577,MATH 142A,A01,083219,Chow; Bennett,7,0,32,25
1657283363577,MATH 142A,A02,083220,Chow; Bennett,10,0,32,22
1657283363577,MATH 142A,A03,093480,Chow; Bennett,7,0,32,25
1657283363577,MATH 142A,B03,093481,Chow; Bennett,8,0,32,24
1657283363577,MATH 142A,B04,093558,Chow; Bennett,12,0,32,20
1657283363577,MATH 142A,B05,093559,Chow; Bennett,6,0,32,26
1657283369608,MATH 193A,A01,083224,Rotar; Vladimir,7,0,34,27
1657283369608,MATH 193A,A02,083225,Rotar; Vladimir,6,0,34,28
1657283369608,MATH 193A,A03,083781,Rotar; Vladimir,2,0,34,32
1657283369608,MATH 193A,A04,083782,Rotar; Vladimir,8,0,34,26
1657283369608,MATH 193A,A05,093482,Rotar; Vladimir,6,0,34,28
1657283375640,MATH 197,001,091859,McAuley; Julian John,9999,0,9999,0
1657283375640,MATH 197,002,095566,Kedlaya; Kiran S.,9997,0,9999,2
1657283375640,MATH 197,003,095567,Xiao; Ming,9999,0,9999,0
1657283375640,MATH 197,004,095571,Perols; Johan Lars,9998,0,9999,1
1657283382729,COGS 9,A01,083615,Shannon; Kyle Michael,8,0,75,67
1657283388756,COGS 11,A01,083617,Boyle; Mary E. T.,22,0,48,26
1657283394783,COGS 13,A01,083071,Bastos; Amalia Pinkusfeld,9,0,71,62
1657283400812,COGS 14A,A01,092681,Semenuks; Arturs,2,1,100,98
1657283406838,COGS 14B,A01,083073,Cheng; Tzu-Han,6,0,63,57
1657283412864,COGS 17,A01,092677,Semenuks; Arturs,5,0,81,76
1657283418893,COGS 100,A01,083619,Allen; Michael Gordon,16,0,70,54
1657283424929,COGS 101A,A01,083621,Davis; Joshua Daniel,9,0,68,59
1657283430975,COGS 101B,A01,091572,Allen; Michael Gordon,11,0,65,54
1657283437015,COGS 101C,A01,083625,Delgado; Tania,17,0,35,18
1657283443047,COGS 107A,A01,083627,Boyle; Mary E. T.,13,0,60,47
1657283449078,COGS 118A,A01,083075,Gupta; Anjum,18,0,76,58
1657283455106,CSE 3,A50,083646,Miranda; Gregory Joseph,24,0,50,26
1657283461132,CSE 8A,A50,083650,Miranda; Gregory Joseph,17,1,56,39
1657283467160,CSE 11,A01,083080,Cao; Yingjun,5,15,40,35
1657283473189,CSE 12,A01,083652,Krause-Levy; Sophia Louisa,26,1,120,94
1657283479223,CSE 15L,A01,083654,Morris; Justin Loren,9,0,50,41
1657283479223,CSE 15L,A02,083655,Morris; Justin Loren,9,0,50,41
1657283485254,CSE 20,A01,083657,Tran; Khoa Dang,38,0,80,42
1657283491287,CSE 21,A01,095574,Bach; Quang Tran,22,0,48,26
1657283497320,CSE 30,A01,083084,Eldon; John,4,0,80,76
1657283497320,CSE 30,B01,095061,Bhaskar; Nishant,8,0,50,42
1657283503356,CSE 100,A01,083659,Cao; Yingjun,4,4,70,66
1657283509387,CSE 134B,A01,083661,Powell; Thomas Allan,21,0,100,79
1657283515415,CSE 140,A01,083663,Gungor; Onat,13,0,85,72
1657283521440,CSE 140L,A01,083088,Eldon; John,19,0,100,81
1657283527476,CSE 175,A01,083665,Kumar; Rakesh,3,0,25,22
1657283533507,CSE 190,A00,092507,Dubnov; Shlomo,7,0,20,13
1657283539544,ECE 45,A01,083139,Congero; Spencer William,5,0,75,70
1657283545582,ECE 65,A50,083695,Saad; Andrew S,12,0,30,18
1657283545582,ECE 65,A51,095125,Saad; Andrew S,25,0,26,1
1657283551615,ECE 109,A01,091882,Touri; Behrouz,19,0,70,51
1657283557639,ECE 180,A00,083140,Abi Samra; Nicholas Camill,1,0,30,29
1657283557639,ECE 180,B00,083141,Abi Samra; Nicholas Camill,0,0,30,30
1657283563673,MATH 10A,A01,083735,Patchell; Gregory David,2,0,30,28
1657283563673,MATH 10A,A02,083736,Patchell; Gregory David,20,0,30,10
1657283563673,MATH 10A,A03,083737,Patchell; Gregory David,16,0,30,14
1657283569703,MATH 10B,A01,083207,Lim; Seonhee,7,0,34,27
1657283569703,MATH 10B,A02,083208,Lim; Seonhee,9,0,35,26
1657283569703,MATH 10B,A03,093472,Lim; Seonhee,5,0,34,29
1657283569703,MATH 10B,B01,083739,Sinha; Shubham,11,0,30,19
1657283575734,MATH 18,A01,083743,Cinel; Cameron Alexander,6,0,30,24
1657283575734,MATH 18,A02,083744,Cinel; Cameron Alexander,17,0,30,13
1657283575734,MATH 18,A03,083745,Cinel; Cameron Alexander,8,0,30,22
1657283575734,MATH 18,B01,083748,Rideout; David Porter,4,0,37,33
1657283575734,MATH 18,B02,083749,Rideout; David Porter,4,0,36,32
1657283575734,MATH 18,B03,083750,Rideout; David Porter,2,0,37,35
1657283575734,MATH 18,B04,083751,Rideout; David Porter,6,0,36,30
1657283575734,MATH 18,B05,093473,Rideout; David Porter,5,0,36,31
1657283575734,MATH 18,B06,093474,Rideout; David Porter,5,0,36,31
1657283581762,MATH 20A,A01,083754,Zheng; Zequn,14,0,40,26
1657283587788,MATH 20B,A01,083756,Briones; Jor-el Thomas Caparas,3,0,36,33
1657283587788,MATH 20B,A02,083757,Briones; Jor-el Thomas Caparas,1,0,36,35
1657283587788,MATH 20B,A03,093475,Briones; Jor-el Thomas Caparas,2,0,36,34
1657283593812,MATH 20C,A01,083760,Briones; Jor-el Thomas Caparas,1,0,35,34
1657283593812,MATH 20C,A02,083761,Briones; Jor-el Thomas Caparas,8,0,35,27
1657283593812,MATH 20C,A03,093476,Briones; Jor-el Thomas Caparas,0,1,36,36
1657283593812,MATH 20C,B01,083762,Bach; Quang Tran,1,0,30,29
1657283599845,MATH 20D,A01,083765,Tran; Brian Kha,5,0,30,25
1657283599845,MATH 20D,A02,083766,Tran; Brian Kha,5,0,30,25
1657283599845,MATH 20D,A03,083767,Tran; Brian Kha,4,0,30,26
1657283605874,MATH 20E,A01,083771,Ganguly; Soumya,7,0,32,25
1657283605874,MATH 20E,A02,083772,Ganguly; Soumya,7,0,32,25
1657283605874,MATH 20E,B01,083773,Ciotti; Benjamin,19,0,35,16
1657283605874,MATH 20E,B02,083774,Ciotti; Benjamin,17,0,35,18
1657283611902,MATH 103A,A01,083777,Greenfeld; Be'Eri,3,0,36,33
1657283611902,MATH 103A,A02,083778,Greenfeld; Be'Eri,5,0,36,31
1657283611902,MATH 103A,A03,093561,Greenfeld; Be'Eri,4,0,36,32
1657283611902,MATH 103A,B01,083779,Greenfeld; Be'Eri,6,0,36,30
1657283611902,MATH 103A,B02,083780,Greenfeld; Be'Eri,3,0,36,33
1657283611902,MATH 103A,B03,093562,Greenfeld; Be'Eri,3,0,36,33
1657283618029,MATH 105,A01,085443,Carter; Anne Toulson,15,0,35,20
1657283618029,MATH 105,A02,093477,Carter; Anne Toulson,20,0,35,15
1657283624057,MATH 109,A01,083213,Ganzberger; Geoffrey Michael,2,0,34,32
1657283624057,MATH 109,A02,083214,Ganzberger; Geoffrey Michael,4,0,34,30
1657283624057,MATH 109,A03,093478,Ganzberger; Geoffrey Michael,2,0,34,32
1657283624057,MATH 109,B01,083215,Ganzberger; Geoffrey Michael,1,0,32,31
1657283624057,MATH 109,B02,083216,Ganzberger; Geoffrey Michael,1,0,32,31
1657283624057,MATH 109,B03,093479,Ganzberger; Geoffrey Michael,8,0,32,24
1657283630084,MATH 142A,A01,083219,Chow; Bennett,7,0,32,25
1657283630084,MATH 142A,A02,083220,Chow; Bennett,10,0,32,22
1657283630084,MATH 142A,A03,093480,Chow; Bennett,7,0,32,25
1657283630084,MATH 142A,B03,093481,Chow; Bennett,8,0,32,24
1657283630084,MATH 142A,B04,093558,Chow; Bennett,12,0,32,20
1657283630084,MATH 142A,B05,093559,Chow; Bennett,6,0,32,26
1657283636117,MATH 193A,A01,083224,Rotar; Vladimir,7,0,34,27
1657283636117,MATH 193A,A02,083225,Rotar; Vladimir,6,0,34,28
1657283636117,MATH 193A,A03,083781,Rotar; Vladimir,2,0,34,32
1657283636117,MATH 193A,A04,083782,Rotar; Vladimir,8,0,34,26
1657283636117,MATH 193A,A05,093482,Rotar; Vladimir,6,0,34,28
1657283642144,MATH 197,001,091859,McAuley; Julian John,9999,0,9999,0
1657283642144,MATH 197,002,095566,Kedlaya; Kiran S.,9997,0,9999,2
1657283642144,MATH 197,003,095567,Xiao; Ming,9999,0,9999,0
1657283642144,MATH 197,004,095571,Perols; Johan Lars,9998,0,9999,1
1657283649214,COGS 9,A01,083615,Shannon; Kyle Michael,8,0,75,67
1657283655239,COGS 11,A01,083617,Boyle; Mary E. T.,22,0,48,26
1657283661272,COGS 13,A01,083071,Bastos; Amalia Pinkusfeld,9,0,71,62
1657283667307,COGS 14A,A01,092681,Semenuks; Arturs,2,1,100,98
1657283673337,COGS 14B,A01,083073,Cheng; Tzu-Han,6,0,63,57
1657283679363,COGS 17,A01,092677,Semenuks; Arturs,5,0,81,76
1657283685393,COGS 100,A01,083619,Allen; Michael Gordon,16,0,70,54
1657283691420,COGS 101A,A01,083621,Davis; Joshua Daniel,9,0,68,59
1657283697445,COGS 101B,A01,091572,Allen; Michael Gordon,11,0,65,54
1657283703476,COGS 101C,A01,083625,Delgado; Tania,17,0,35,18
1657283709500,COGS 107A,A01,083627,Boyle; Mary E. T.,13,0,60,47
1657283715527,COGS 118A,A01,083075,Gupta; Anjum,18,0,76,58
1657283721568,CSE 3,A50,083646,Miranda; Gregory Joseph,24,0,50,26
1657283727595,CSE 8A,A50,083650,Miranda; Gregory Joseph,17,1,56,39
1657283733622,CSE 11,A01,083080,Cao; Yingjun,5,15,40,35
1657283739656,CSE 12,A01,083652,Krause-Levy; Sophia Louisa,26,1,120,94
1657283745683,CSE 15L,A01,083654,Morris; Justin Loren,9,0,50,41
1657283745683,CSE 15L,A02,083655,Morris; Justin Loren,9,0,50,41
1657283751711,CSE 20,A01,083657,Tran; Khoa Dang,38,0,80,42
1657283757737,CSE 21,A01,095574,Bach; Quang Tran,22,0,48,26
1657283763770,CSE 30,A01,083084,Eldon; John,4,0,80,76
1657283763770,CSE 30,B01,095061,Bhaskar; Nishant,8,0,50,42
1657283769795,CSE 100,A01,083659,Cao; Yingjun,4,4,70,66
1657283775829,CSE 134B,A01,083661,Powell; Thomas Allan,21,0,100,79
1657283781862,CSE 140,A01,083663,Gungor; Onat,13,0,85,72
1657283787907,CSE 140L,A01,083088,Eldon; John,19,0,100,81
1657283793940,CSE 175,A01,083665,Kumar; Rakesh,3,0,25,22
1657283799973,CSE 190,A00,092507,Dubnov; Shlomo,7,0,20,13
1657283806002,ECE 45,A01,083139,Congero; Spencer William,5,0,75,70
1657283812037,ECE 65,A50,083695,Saad; Andrew S,12,0,30,18
1657283812037,ECE 65,A51,095125,Saad; Andrew S,25,0,26,1
1657283818063,ECE 109,A01,091882,Touri; Behrouz,19,0,70,51
1657283824091,ECE 180,A00,083140,Abi Samra; Nicholas Camill,1,0,30,29
1657283824091,ECE 180,B00,083141,Abi Samra; Nicholas Camill,0,0,30,30
1657283830122,MATH 10A,A01,083735,Patchell; Gregory David,2,0,30,28
1657283830122,MATH 10A,A02,083736,Patchell; Gregory David,20,0,30,10
1657283830122,MATH 10A,A03,083737,Patchell; Gregory David,16,0,30,14
1657283836153,MATH 10B,A01,083207,Lim; Seonhee,7,0,34,27
1657283836153,MATH 10B,A02,083208,Lim; Seonhee,9,0,35,26
1657283836153,MATH 10B,A03,093472,Lim; Seonhee,5,0,34,29
1657283836153,MATH 10B,B01,083739,Sinha; Shubham,11,0,30,19
1657283842193,MATH 18,A01,083743,Cinel; Cameron Alexander,6,0,30,24
1657283842193,MATH 18,A02,083744,Cinel; Cameron Alexander,17,0,30,13
1657283842193,MATH 18,A03,083745,Cinel; Cameron Alexander,8,0,30,22
1657283842193,MATH 18,B01,083748,Rideout; David Porter,4,0,37,33
1657283842193,MATH 18,B02,083749,Rideout; David Porter,4,0,36,32
1657283842193,MATH 18,B03,083750,Rideout; David Porter,2,0,37,35
1657283842193,MATH 18,B04,083751,Rideout; David Porter,6,0,36,30
1657283842193,MATH 18,B05,093473,Rideout; David Porter,5,0,36,31
1657283842193,MATH 18,B06,093474,Rideout; David Porter,5,0,36,31
1657283848224,MATH 20A,A01,083754,Zheng; Zequn,14,0,40,26
1657283854254,MATH 20B,A01,083756,Briones; Jor-el Thomas Caparas,3,0,36,33
1657283854254,MATH 20B,A02,083757,Briones; Jor-el Thomas Caparas,1,0,36,35
1657283854254,MATH 20B,A03,093475,Briones; Jor-el Thomas Caparas,2,0,36,34
1657283860300,MATH 20C,A01,083760,Briones; Jor-el Thomas Caparas,1,0,35,34
1657283860300,MATH 20C,A02,083761,Briones; Jor-el Thomas Caparas,8,0,35,27
1657283860300,MATH 20C,A03,093476,Briones; Jor-el Thomas Caparas,0,1,36,36
1657283860300,MATH 20C,B01,083762,Bach; Quang Tran,1,0,30,29
1657283866329,MATH 20D,A01,083765,Tran; Brian Kha,5,0,30,25
1657283866329,MATH 20D,A02,083766,Tran; Brian Kha,5,0,30,25
1657283866329,MATH 20D,A03,083767,Tran; Brian Kha,4,0,30,26
1657283872360,MATH 20E,A01,083771,Ganguly; Soumya,7,0,32,25
1657283872360,MATH 20E,A02,083772,Ganguly; Soumya,7,0,32,25
1657283872360,MATH 20E,B01,083773,Ciotti; Benjamin,19,0,35,16
1657283872360,MATH 20E,B02,083774,Ciotti; Benjamin,17,0,35,18
1657283878404,MATH 103A,A01,083777,Greenfeld; Be'Eri,3,0,36,33
1657283878404,MATH 103A,A02,083778,Greenfeld; Be'Eri,5,0,36,31
1657283878404,MATH 103A,A03,093561,Greenfeld; Be'Eri,4,0,36,32
1657283878404,MATH 103A,B01,083779,Greenfeld; Be'Eri,6,0,36,30
1657283878404,MATH 103A,B02,083780,Greenfeld; Be'Eri,3,0,36,33
1657283878404,MATH 103A,B03,093562,Greenfeld; Be'Eri,3,0,36,33
1657283884442,MATH 105,A01,085443,Carter; Anne Toulson,15,0,35,20
1657283884442,MATH 105,A02,093477,Carter; Anne Toulson,20,0,35,15
1657283890479,MATH 109,A01,083213,Ganzberger; Geoffrey Michael,2,0,34,32
1657283890479,MATH 109,A02,083214,Ganzberger; Geoffrey Michael,4,0,34,30
1657283890479,MATH 109,A03,093478,Ganzberger; Geoffrey Michael,2,0,34,32
1657283890479,MATH 109,B01,083215,Ganzberger; Geoffrey Michael,1,0,32,31
1657283890479,MATH 109,B02,083216,Ganzberger; Geoffrey Michael,1,0,32,31
1657283890479,MATH 109,B03,093479,Ganzberger; Geoffrey Michael,8,0,32,24
1657283896505,MATH 142A,A01,083219,Chow; Bennett,7,0,32,25
1657283896505,MATH 142A,A02,083220,Chow; Bennett,10,0,32,22
1657283896505,MATH 142A,A03,093480,Chow; Bennett,7,0,32,25
1657283896505,MATH 142A,B03,093481,Chow; Bennett,8,0,32,24
1657283896505,MATH 142A,B04,093558,Chow; Bennett,12,0,32,20
1657283896505,MATH 142A,B05,093559,Chow; Bennett,6,0,32,26
1657283902538,MATH 193A,A01,083224,Rotar; Vladimir,7,0,34,27
1657283902538,MATH 193A,A02,083225,Rotar; Vladimir,6,0,34,28
1657283902538,MATH 193A,A03,083781,Rotar; Vladimir,2,0,34,32
1657283902538,MATH 193A,A04,083782,Rotar; Vladimir,8,0,34,26
1657283902538,MATH 193A,A05,093482,Rotar; Vladimir,6,0,34,28
1657283908569,MATH 197,001,091859,McAuley; Julian John,9999,0,9999,0
1657283908569,MATH 197,002,095566,Kedlaya; Kiran S.,9997,0,9999,2
1657283908569,MATH 197,003,095567,Xiao; Ming,9999,0,9999,0
1657283908569,MATH 197,004,095571,Perols; Johan Lars,9998,0,9999,1
1657283915645,COGS 9,A01,083615,Shannon; Kyle Michael,8,0,75,67
1657283921677,COGS 11,A01,083617,Boyle; Mary E. T.,22,0,48,26
1657283927705,COGS 13,A01,083071,Bastos; Amalia Pinkusfeld,9,0,71,62
1657283933740,COGS 14A,A01,092681,Semenuks; Arturs,2,1,100,98
1657283939766,COGS 14B,A01,083073,Cheng; Tzu-Han,6,0,63,57
1657283945793,COGS 17,A01,092677,Semenuks; Arturs,5,0,81,76
1657283951820,COGS 100,A01,083619,Allen; Michael Gordon,16,0,70,54
1657283957848,COGS 101A,A01,083621,Davis; Joshua Daniel,9,0,68,59
1657283963876,COGS 101B,A01,091572,Allen; Michael Gordon,11,0,65,54
1657283969913,COGS 101C,A01,083625,Delgado; Tania,17,0,35,18
1657283975941,COGS 107A,A01,083627,Boyle; Mary E. T.,13,0,60,47
1657283981971,COGS 118A,A01,083075,Gupta; Anjum,18,0,76,58
1657283988009,CSE 3,A50,083646,Miranda; Gregory Joseph,24,0,50,26
1657283994039,CSE 8A,A50,083650,Miranda; Gregory Joseph,17,1,56,39
1657284000068,CSE 11,A01,083080,Cao; Yingjun,5,15,40,35
1657284006113,CSE 12,A01,083652,Krause-Levy; Sophia Louisa,26,1,120,94
1657284012138,CSE 15L,A01,083654,Morris; Justin Loren,9,0,50,41
1657284012138,CSE 15L,A02,083655,Morris; Justin Loren,9,0,50,41
1657284018169,CSE 20,A01,083657,Tran; Khoa Dang,38,0,80,42
1657284024196,CSE 21,A01,095574,Bach; Quang Tran,22,0,48,26
1657284030224,CSE 30,A01,083084,Eldon; John,4,0,80,76
1657284030224,CSE 30,B01,095061,Bhaskar; Nishant,8,0,50,42
1657284036252,CSE 100,A01,083659,Cao; Yingjun,4,4,70,66
1657284042281,CSE 134B,A01,083661,Powell; Thomas Allan,21,0,100,79
1657284048313,CSE 140,A01,083663,Gungor; Onat,13,0,85,72
1657284054343,CSE 140L,A01,083088,Eldon; John,19,0,100,81
1657284060370,CSE 175,A01,083665,Kumar; Rakesh,3,0,25,22
1657284066398,CSE 190,A00,092507,Dubnov; Shlomo,7,0,20,13
1657284072432,ECE 45,A01,083139,Congero; Spencer William,5,0,75,70
1657284078468,ECE 65,A50,083695,Saad; Andrew S,12,0,30,18
1657284078468,ECE 65,A51,095125,Saad; Andrew S,25,0,26,1
1657284084500,ECE 109,A01,091882,Touri; Behrouz,19,0,70,51
1657284090531,ECE 180,A00,083140,Abi Samra; Nicholas Camill,1,0,30,29
1657284090531,ECE 180,B00,083141,Abi Samra; Nicholas Camill,0,0,30,30
1657284096580,MATH 10A,A01,083735,Patchell; Gregory David,2,0,30,28
1657284096580,MATH 10A,A02,083736,Patchell; Gregory David,20,0,30,10
1657284096580,MATH 10A,A03,083737,Patchell; Gregory David,16,0,30,14
1657284102609,MATH 10B,A01,083207,Lim; Seonhee,7,0,34,27
1657284102609,MATH 10B,A02,083208,Lim; Seonhee,9,0,35,26
1657284102609,MATH 10B,A03,093472,Lim; Seonhee,5,0,34,29
1657284102609,MATH 10B,B01,083739,Sinha; Shubham,11,0,30,19
1657284108639,MATH 18,A01,083743,Cinel; Cameron Alexander,6,0,30,24
1657284108639,MATH 18,A02,083744,Cinel; Cameron Alexander,17,0,30,13
1657284108639,MATH 18,A03,083745,Cinel; Cameron Alexander,8,0,30,22
1657284108639,MATH 18,B01,083748,Rideout; David Porter,4,0,37,33
1657284108639,MATH 18,B02,083749,Rideout; David Porter,4,0,36,32
1657284108639,MATH 18,B03,083750,Rideout; David Porter,2,0,37,35
1657284108639,MATH 18,B04,083751,Rideout; David Porter,6,0,36,30
1657284108639,MATH 18,B05,093473,Rideout; David Porter,5,0,36,31
1657284108639,MATH 18,B06,093474,Rideout; David Porter,5,0,36,31
1657284114667,MATH 20A,A01,083754,Zheng; Zequn,14,0,40,26
1657284120694,MATH 20B,A01,083756,Briones; Jor-el Thomas Caparas,3,0,36,33
1657284120694,MATH 20B,A02,083757,Briones; Jor-el Thomas Caparas,1,0,36,35
1657284120694,MATH 20B,A03,093475,Briones; Jor-el Thomas Caparas,2,0,36,34
1657284126719,MATH 20C,A01,083760,Briones; Jor-el Thomas Caparas,1,0,35,34
1657284126719,MATH 20C,A02,083761,Briones; Jor-el Thomas Caparas,8,0,35,27
1657284126719,MATH 20C,A03,093476,Briones; Jor-el Thomas Caparas,0,1,36,36
1657284126719,MATH 20C,B01,083762,Bach; Quang Tran,1,0,30,29
1657284132749,MATH 20D,A01,083765,Tran; Brian Kha,5,0,30,25
1657284132749,MATH 20D,A02,083766,Tran; Brian Kha,5,0,30,25
1657284132749,MATH 20D,A03,083767,Tran; Brian Kha,4,0,30,26
1657284138778,MATH 20E,A01,083771,Ganguly; Soumya,7,0,32,25
1657284138778,MATH 20E,A02,083772,Ganguly; Soumya,7,0,32,25
1657284138778,MATH 20E,B01,083773,Ciotti; Benjamin,19,0,35,16
1657284138778,MATH 20E,B02,083774,Ciotti; Benjamin,17,0,35,18
1657284144809,MATH 103A,A01,083777,Greenfeld; Be'Eri,3,0,36,33
1657284144809,MATH 103A,A02,083778,Greenfeld; Be'Eri,5,0,36,31
1657284144809,MATH 103A,A03,093561,Greenfeld; Be'Eri,4,0,36,32
1657284144809,MATH 103A,B01,083779,Greenfeld; Be'Eri,6,0,36,30
1657284144809,MATH 103A,B02,083780,Greenfeld; Be'Eri,3,0,36,33
1657284144809,MATH 103A,B03,093562,Greenfeld; Be'Eri,3,0,36,33
1657284150841,MATH 105,A01,085443,Carter; Anne Toulson,15,0,35,20
1657284150841,MATH 105,A02,093477,Carter; Anne Toulson,20,0,35,15
1657284156869,MATH 109,A01,083213,Ganzberger; Geoffrey Michael,2,0,34,32
1657284156869,MATH 109,A02,083214,Ganzberger; Geoffrey Michael,4,0,34,30
1657284156869,MATH 109,A03,093478,Ganzberger; Geoffrey Michael,2,0,34,32
1657284156869,MATH 109,B01,083215,Ganzberger; Geoffrey Michael,1,0,32,31
1657284156869,MATH 109,B02,083216,Ganzberger; Geoffrey Michael,1,0,32,31
1657284156869,MATH 109,B03,093479,Ganzberger; Geoffrey Michael,8,0,32,24
1657284162902,MATH 142A,A01,083219,Chow; Bennett,7,0,32,25
1657284162902,MATH 142A,A02,083220,Chow; Bennett,10,0,32,22
1657284162902,MATH 142A,A03,093480,Chow; Bennett,7,0,32,25
1657284162902,MATH 142A,B03,093481,Chow; Bennett,8,0,32,24
1657284162902,MATH 142A,B04,093558,Chow; Bennett,12,0,32,20
1657284162902,MATH 142A,B05,093559,Chow; Bennett,6,0,32,26
1657284168931,MATH 193A,A01,083224,Rotar; Vladimir,7,0,34,27
1657284168931,MATH 193A,A02,083225,Rotar; Vladimir,6,0,34,28
1657284168931,MATH 193A,A03,083781,Rotar; Vladimir,2,0,34,32
1657284168931,MATH 193A,A04,083782,Rotar; Vladimir,8,0,34,26
1657284168931,MATH 193A,A05,093482,Rotar; Vladimir,6,0,34,28
1657284174968,MATH 197,001,091859,McAuley; Julian John,9999,0,9999,0
1657284174968,MATH 197,002,095566,Kedlaya; Kiran S.,9997,0,9999,2
1657284174968,MATH 197,003,095567,Xiao; Ming,9999,0,9999,0
1657284174968,MATH 197,004,095571,Perols; Johan Lars,9998,0,9999,1
1657284182036,COGS 9,A01,083615,Shannon; Kyle Michael,8,0,75,67
1657284188062,COGS 11,A01,083617,Boyle; Mary E. T.,22,0,48,26
1657284194087,COGS 13,A01,083071,Bastos; Amalia Pinkusfeld,9,0,71,62
1657284200111,COGS 14A,A01,092681,Semenuks; Arturs,2,1,100,98
1657284206144,COGS 14B,A01,083073,Cheng; Tzu-Han,6,0,63,57
1657284212261,COGS 17,A01,092677,Semenuks; Arturs,5,0,81,76
1657284218292,COGS 100,A01,083619,Allen; Michael Gordon,16,0,70,54
1657284224323,COGS 101A,A01,083621,Davis; Joshua Daniel,9,0,68,59
1657284230349,COGS 101B,A01,091572,Allen; Michael Gordon,11,0,65,54
1657284236378,COGS 101C,A01,083625,Delgado; Tania,17,0,35,18
1657284242404,COGS 107A,A01,083627,Boyle; Mary E. T.,13,0,60,47
1657284248434,COGS 118A,A01,083075,Gupta; Anjum,18,0,76,58
1657284254462,CSE 3,A50,083646,Miranda; Gregory Joseph,24,0,50,26
1657284260486,CSE 8A,A50,083650,Miranda; Gregory Joseph,17,1,56,39
1657284266511,CSE 11,A01,083080,Cao; Yingjun,5,15,40,35
1657284272538,CSE 12,A01,083652,Krause-Levy; Sophia Louisa,26,1,120,94
1657284278569,CSE 15L,A01,083654,Morris; Justin Loren,9,0,50,41
1657284278569,CSE 15L,A02,083655,Morris; Justin Loren,9,0,50,41
1657284284595,CSE 20,A01,083657,Tran; Khoa Dang,38,0,80,42
1657284290621,CSE 21,A01,095574,Bach; Quang Tran,22,0,48,26
1657284296654,CSE 30,A01,083084,Eldon; John,4,0,80,76
1657284296654,CSE 30,B01,095061,Bhaskar; Nishant,8,0,50,42
1657284302683,CSE 100,A01,083659,Cao; Yingjun,4,4,70,66
1657284308710,CSE 134B,A01,083661,Powell; Thomas Allan,21,0,100,79
1657284314736,CSE 140,A01,083663,Gungor; Onat,13,0,85,72
1657284320762,CSE 140L,A01,083088,Eldon; John,19,0,100,81
1657284326786,CSE 175,A01,083665,Kumar; Rakesh,3,0,25,22
1657284332813,CSE 190,A00,092507,Dubnov; Shlomo,7,0,20,13
1657284338843,ECE 45,A01,083139,Congero; Spencer William,5,0,75,70
1657284344872,ECE 65,A50,083695,Saad; Andrew S,12,0,30,18
1657284344872,ECE 65,A51,095125,Saad; Andrew S,25,0,26,1
1657284350899,ECE 109,A01,091882,Touri; Behrouz,19,0,70,51
1657284356942,ECE 180,A00,083140,Abi Samra; Nicholas Camill,1,0,30,29
1657284356942,ECE 180,B00,083141,Abi Samra; Nicholas Camill,0,0,30,30
1657284362977,MATH 10A,A01,083735,Patchell; Gregory David,2,0,30,28
1657284362977,MATH 10A,A02,083736,Patchell; Gregory David,20,0,30,10
1657284362977,MATH 10A,A03,083737,Patchell; Gregory David,16,0,30,14
1657284369004,MATH 10B,A01,083207,Lim; Seonhee,7,0,34,27
1657284369004,MATH 10B,A02,083208,Lim; Seonhee,9,0,35,26
1657284369004,MATH 10B,A03,093472,Lim; Seonhee,5,0,34,29
1657284369004,MATH 10B,B01,083739,Sinha; Shubham,11,0,30,19
1657284375035,MATH 18,A01,083743,Cinel; Cameron Alexander,6,0,30,24
1657284375035,MATH 18,A02,083744,Cinel; Cameron Alexander,17,0,30,13
1657284375035,MATH 18,A03,083745,Cinel; Cameron Alexander,8,0,30,22
1657284375035,MATH 18,B01,083748,Rideout; David Porter,4,0,37,33
1657284375035,MATH 18,B02,083749,Rideout; David Porter,4,0,36,32
1657284375035,MATH 18,B03,083750,Rideout; David Porter,2,0,37,35
1657284375035,MATH 18,B04,083751,Rideout; David Porter,6,0,36,30
1657284375035,MATH 18,B05,093473,Rideout; David Porter,5,0,36,31
1657284375035,MATH 18,B06,093474,Rideout; David Porter,5,0,36,31
1657284381067,MATH 20A,A01,083754,Zheng; Zequn,14,0,40,26
1657284387096,MATH 20B,A01,083756,Briones; Jor-el Thomas Caparas,3,0,36,33
1657284387096,MATH 20B,A02,083757,Briones; Jor-el Thomas Caparas,1,0,36,35
1657284387096,MATH 20B,A03,093475,Briones; Jor-el Thomas Caparas,2,0,36,34
1657284393130,MATH 20C,A01,083760,Briones; Jor-el Thomas Caparas,1,0,35,34
1657284393130,MATH 20C,A02,083761,Briones; Jor-el Thomas Caparas,8,0,35,27
1657284393130,MATH 20C,A03,093476,Briones; Jor-el Thomas Caparas,0,1,36,36
1657284393130,MATH 20C,B01,083762,Bach; Quang Tran,1,0,30,29
1657284399169,MATH 20D,A01,083765,Tran; Brian Kha,5,0,30,25
1657284399169,MATH 20D,A02,083766,Tran; Brian Kha,5,0,30,25
1657284399169,MATH 20D,A03,083767,Tran; Brian Kha,4,0,30,26
1657284405199,MATH 20E,A01,083771,Ganguly; Soumya,7,0,32,25
1657284405199,MATH 20E,A02,083772,Ganguly; Soumya,7,0,32,25
1657284405199,MATH 20E,B01,083773,Ciotti; Benjamin,19,0,35,16
1657284405199,MATH 20E,B02,083774,Ciotti; Benjamin,17,0,35,18
1657284411230,MATH 103A,A01,083777,Greenfeld; Be'Eri,3,0,36,33
1657284411230,MATH 103A,A02,083778,Greenfeld; Be'Eri,5,0,36,31
1657284411230,MATH 103A,A03,093561,Greenfeld; Be'Eri,4,0,36,32
1657284411230,MATH 103A,B01,083779,Greenfeld; Be'Eri,6,0,36,30
1657284411230,MATH 103A,B02,083780,Greenfeld; Be'Eri,3,0,36,33
1657284411230,MATH 103A,B03,093562,Greenfeld; Be'Eri,3,0,36,33
1657284417268,MATH 105,A01,085443,Carter; Anne Toulson,15,0,35,20
1657284417268,MATH 105,A02,093477,Carter; Anne Toulson,20,0,35,15
1657284423302,MATH 109,A01,083213,Ganzberger; Geoffrey Michael,2,0,34,32
1657284423302,MATH 109,A02,083214,Ganzberger; Geoffrey Michael,4,0,34,30
1657284423302,MATH 109,A03,093478,Ganzberger; Geoffrey Michael,2,0,34,32
1657284423302,MATH 109,B01,083215,Ganzberger; Geoffrey Michael,1,0,32,31
1657284423302,MATH 109,B02,083216,Ganzberger; Geoffrey Michael,1,0,32,31
1657284423302,MATH 109,B03,093479,Ganzberger; Geoffrey Michael,8,0,32,24
1657284429344,MATH 142A,A01,083219,Chow; Bennett,7,0,32,25
1657284429344,MATH 142A,A02,083220,Chow; Bennett,10,0,32,22
1657284429344,MATH 142A,A03,093480,Chow; Bennett,7,0,32,25
1657284429344,MATH 142A,B03,093481,Chow; Bennett,8,0,32,24
1657284429344,MATH 142A,B04,093558,Chow; Bennett,12,0,32,20
1657284429344,MATH 142A,B05,093559,Chow; Bennett,6,0,32,26
1657284435370,MATH 193A,A01,083224,Rotar; Vladimir,7,0,34,27
1657284435370,MATH 193A,A02,083225,Rotar; Vladimir,6,0,34,28
1657284435370,MATH 193A,A03,083781,Rotar; Vladimir,2,0,34,32
1657284435370,MATH 193A,A04,083782,Rotar; Vladimir,8,0,34,26
1657284435370,MATH 193A,A05,093482,Rotar; Vladimir,6,0,34,28
1657284441404,MATH 197,001,091859,McAuley; Julian John,9999,0,9999,0
1657284441404,MATH 197,002,095566,Kedlaya; Kiran S.,9997,0,9999,2
1657284441404,MATH 197,003,095567,Xiao; Ming,9999,0,9999,0
1657284441404,MATH 197,004,095571,Perols; Johan Lars,9998,0,9999,1
1657284448484,COGS 9,A01,083615,Shannon; Kyle Michael,8,0,75,67
1657284454509,COGS 11,A01,083617,Boyle; Mary E. T.,22,0,48,26
1657284460540,COGS 13,A01,083071,Bastos; Amalia Pinkusfeld,9,0,71,62
1657284466574,COGS 14A,A01,092681,Semenuks; Arturs,2,1,100,98
1657284472600,COGS 14B,A01,083073,Cheng; Tzu-Han,6,0,63,57
1657284478623,COGS 17,A01,092677,Semenuks; Arturs,5,0,81,76
1657284484658,COGS 100,A01,083619,Allen; Michael Gordon,16,0,70,54
1657284490683,COGS 101A,A01,083621,Davis; Joshua Daniel,9,0,68,59
1657284496706,COGS 101B,A01,091572,Allen; Michael Gordon,11,0,65,54
1657284502738,COGS 101C,A01,083625,Delgado; Tania,17,0,35,18
1657284508763,COGS 107A,A01,083627,Boyle; Mary E. T.,13,0,60,47
1657284514792,COGS 118A,A01,083075,Gupta; Anjum,18,0,76,58
1657284520819,CSE 3,A50,083646,Miranda; Gregory Joseph,24,0,50,26
1657284526846,CSE 8A,A50,083650,Miranda; Gregory Joseph,17,1,56,39
1657284532872,CSE 11,A01,083080,Cao; Yingjun,5,15,40,35
1657284538909,CSE 12,A01,083652,Krause-Levy; Sophia Louisa,26,1,120,94
1657284544942,CSE 15L,A01,083654,Morris; Justin Loren,9,0,50,41
1657284544942,CSE 15L,A02,083655,Morris; Justin Loren,9,0,50,41
1657284550980,CSE 20,A01,083657,Tran; Khoa Dang,38,0,80,42
1657284557013,CSE 21,A01,095574,Bach; Quang Tran,22,0,48,26
1657284563052,CSE 30,A01,083084,Eldon; John,4,0,80,76
1657284563052,CSE 30,B01,095061,Bhaskar; Nishant,8,0,50,42
1657284569083,CSE 100,A01,083659,Cao; Yingjun,4,4,70,66
1657284575109,CSE 134B,A01,083661,Powell; Thomas Allan,21,0,100,79
1657284581142,CSE 140,A01,083663,Gungor; Onat,13,0,85,72
1657284587167,CSE 140L,A01,083088,Eldon; John,19,0,100,81
1657284593198,CSE 175,A01,083665,Kumar; Rakesh,3,0,25,22
1657284599226,CSE 190,A00,092507,Dubnov; Shlomo,7,0,20,13
1657284605255,ECE 45,A01,083139,Congero; Spencer William,5,0,75,70
1657284611285,ECE 65,A50,083695,Saad; Andrew S,12,0,30,18
1657284611285,ECE 65,A51,095125,Saad; Andrew S,25,0,26,1
1657284617315,ECE 109,A01,091882,Touri; Behrouz,19,0,70,51
1657284623347,ECE 180,A00,083140,Abi Samra; Nicholas Camill,1,0,30,29
1657284623347,ECE 180,B00,083141,Abi Samra; Nicholas Camill,0,0,30,30
1657284629383,MATH 10A,A01,083735,Patchell; Gregory David,2,0,30,28
1657284629383,MATH 10A,A02,083736,Patchell; Gregory David,20,0,30,10
1657284629383,MATH 10A,A03,083737,Patchell; Gregory David,16,0,30,14
1657284635421,MATH 10B,A01,083207,Lim; Seonhee,7,0,34,27
1657284635421,MATH 10B,A02,083208,Lim; Seonhee,9,0,35,26
1657284635421,MATH 10B,A03,093472,Lim; Seonhee,5,0,34,29
1657284635421,MATH 10B,B01,083739,Sinha; Shubham,11,0,30,19
1657284641450,MATH 18,A01,083743,Cinel; Cameron Alexander,6,0,30,24
1657284641450,MATH 18,A02,083744,Cinel; Cameron Alexander,17,0,30,13
1657284641450,MATH 18,A03,083745,Cinel; Cameron Alexander,8,0,30,22
1657284641450,MATH 18,B01,083748,Rideout; David Porter,4,0,37,33
1657284641450,MATH 18,B02,083749,Rideout; David Porter,4,0,36,32
1657284641450,MATH 18,B03,083750,Rideout; David Porter,2,0,37,35
1657284641450,MATH 18,B04,083751,Rideout; David Porter,6,0,36,30
1657284641450,MATH 18,B05,093473,Rideout; David Porter,5,0,36,31
1657284641450,MATH 18,B06,093474,Rideout; David Porter,5,0,36,31
1657284647484,MATH 20A,A01,083754,Zheng; Zequn,14,0,40,26
1657284653521,MATH 20B,A01,083756,Briones; Jor-el Thomas Caparas,3,0,36,33
1657284653521,MATH 20B,A02,083757,Briones; Jor-el Thomas Caparas,1,0,36,35
1657284653521,MATH 20B,A03,093475,Briones; Jor-el Thomas Caparas,2,0,36,34
1657284659548,MATH 20C,A01,083760,Briones; Jor-el Thomas Caparas,1,0,35,34
1657284659548,MATH 20C,A02,083761,Briones; Jor-el Thomas Caparas,8,0,35,27
1657284659548,MATH 20C,A03,093476,Briones; Jor-el Thomas Caparas,0,1,36,36
1657284659548,MATH 20C,B01,083762,Bach; Quang Tran,1,0,30,29
1657284665579,MATH 20D,A01,083765,Tran; Brian Kha,5,0,30,25
1657284665579,MATH 20D,A02,083766,Tran; Brian Kha,5,0,30,25
1657284665579,MATH 20D,A03,083767,Tran; Brian Kha,4,0,30,26
1657284671614,MATH 20E,A01,083771,Ganguly; Soumya,7,0,32,25
1657284671614,MATH 20E,A02,083772,Ganguly; Soumya,7,0,32,25
1657284671614,MATH 20E,B01,083773,Ciotti; Benjamin,19,0,35,16
1657284671614,MATH 20E,B02,083774,Ciotti; Benjamin,17,0,35,18
1657284677644,MATH 103A,A01,083777,Greenfeld; Be'Eri,3,0,36,33
1657284677644,MATH 103A,A02,083778,Greenfeld; Be'Eri,5,0,36,31
1657284677644,MATH 103A,A03,093561,Greenfeld; Be'Eri,4,0,36,32
1657284677644,MATH 103A,B01,083779,Greenfeld; Be'Eri,6,0,36,30
1657284677644,MATH 103A,B02,083780,Greenfeld; Be'Eri,3,0,36,33
1657284677644,MATH 103A,B03,093562,Greenfeld; Be'Eri,3,0,36,33
1657284683674,MATH 105,A01,085443,Carter; Anne Toulson,15,0,35,20
1657284683674,MATH 105,A02,093477,Carter; Anne Toulson,20,0,35,15
1657284689709,MATH 109,A01,083213,Ganzberger; Geoffrey Michael,2,0,34,32
1657284689709,MATH 109,A02,083214,Ganzberger; Geoffrey Michael,4,0,34,30
1657284689709,MATH 109,A03,093478,Ganzberger; Geoffrey Michael,2,0,34,32
1657284689709,MATH 109,B01,083215,Ganzberger; Geoffrey Michael,1,0,32,31
1657284689709,MATH 109,B02,083216,Ganzberger; Geoffrey Michael,1,0,32,31
1657284689709,MATH 109,B03,093479,Ganzberger; Geoffrey Michael,8,0,32,24
1657284695738,MATH 142A,A01,083219,Chow; Bennett,7,0,32,25
1657284695738,MATH 142A,A02,083220,Chow; Bennett,10,0,32,22
1657284695738,MATH 142A,A03,093480,Chow; Bennett,7,0,32,25
1657284695738,MATH 142A,B03,093481,Chow; Bennett,8,0,32,24
1657284695738,MATH 142A,B04,093558,Chow; Bennett,12,0,32,20
1657284695738,MATH 142A,B05,093559,Chow; Bennett,6,0,32,26
1657284701766,MATH 193A,A01,083224,Rotar; Vladimir,7,0,34,27
1657284701766,MATH 193A,A02,083225,Rotar; Vladimir,6,0,34,28
1657284701766,MATH 193A,A03,083781,Rotar; Vladimir,2,0,34,32
1657284701766,MATH 193A,A04,083782,Rotar; Vladimir,8,0,34,26
1657284701766,MATH 193A,A05,093482,Rotar; Vladimir,6,0,34,28
1657284707795,MATH 197,001,091859,McAuley; Julian John,9999,0,9999,0
1657284707795,MATH 197,002,095566,Kedlaya; Kiran S.,9997,0,9999,2
1657284707795,MATH 197,003,095567,Xiao; Ming,9999,0,9999,0
1657284707795,MATH 197,004,095571,Perols; Johan Lars,9998,0,9999,1
1657284714874,COGS 9,A01,083615,Shannon; Kyle Michael,8,0,75,67
1657284720906,COGS 11,A01,083617,Boyle; Mary E. T.,22,0,48,26
1657284726940,COGS 13,A01,083071,Bastos; Amalia Pinkusfeld,9,0,71,62
1657284732969,COGS 14A,A01,092681,Semenuks; Arturs,2,1,100,98
1657284739000,COGS 14B,A01,083073,Cheng; Tzu-Han,6,0,63,57
1657284745033,COGS 17,A01,092677,Semenuks; Arturs,5,0,81,76
1657284751068,COGS 100,A01,083619,Allen; Michael Gordon,16,0,70,54
1657284757095,COGS 101A,A01,083621,Davis; Joshua Daniel,9,0,68,59
1657284763126,COGS 101B,A01,091572,Allen; Michael Gordon,11,0,65,54
1657284769159,COGS 101C,A01,083625,Delgado; Tania,17,0,35,18
1657284775191,COGS 107A,A01,083627,Boyle; Mary E. T.,13,0,60,47
1657284781220,COGS 118A,A01,083075,Gupta; Anjum,18,0,76,58
1657284787257,CSE 3,A50,083646,Miranda; Gregory Joseph,24,0,50,26
1657284793295,CSE 8A,A50,083650,Miranda; Gregory Joseph,17,1,56,39
1657284799321,CSE 11,A01,083080,Cao; Yingjun,5,15,40,35
1657284805349,CSE 12,A01,083652,Krause-Levy; Sophia Louisa,26,1,120,94
1657284811465,CSE 15L,A01,083654,Morris; Justin Loren,9,0,50,41
1657284811465,CSE 15L,A02,083655,Morris; Justin Loren,9,0,50,41
1657284817490,CSE 20,A01,083657,Tran; Khoa Dang,38,0,80,42
1657284823518,CSE 21,A01,095574,Bach; Quang Tran,22,0,48,26
1657284829555,CSE 30,A01,083084,Eldon; John,4,0,80,76
1657284829555,CSE 30,B01,095061,Bhaskar; Nishant,8,0,50,42
1657284835591,CSE 100,A01,083659,Cao; Yingjun,4,4,70,66
1657284841615,CSE 134B,A01,083661,Powell; Thomas Allan,21,0,100,79
1657284847644,CSE 140,A01,083663,Gungor; Onat,13,0,85,72
1657284853671,CSE 140L,A01,083088,Eldon; John,19,0,100,81
1657284859695,CSE 175,A01,083665,Kumar; Rakesh,3,0,25,22
1657284865722,CSE 190,A00,092507,Dubnov; Shlomo,7,0,20,13
1657284871756,ECE 45,A01,083139,Congero; Spencer William,5,0,75,70
1657284877791,ECE 65,A50,083695,Saad; Andrew S,12,0,30,18
1657284877791,ECE 65,A51,095125,Saad; Andrew S,25,0,26,1
1657284883826,ECE 109,A01,091882,Touri; Behrouz,19,0,70,51
1657284889871,ECE 180,A00,083140,Abi Samra; Nicholas Camill,1,0,30,29
1657284889871,ECE 180,B00,083141,Abi Samra; Nicholas Camill,0,0,30,30
1657284895899,MATH 10A,A01,083735,Patchell; Gregory David,2,0,30,28
1657284895899,MATH 10A,A02,083736,Patchell; Gregory David,20,0,30,10
1657284895899,MATH 10A,A03,083737,Patchell; Gregory David,16,0,30,14
1657284901940,MATH 10B,A01,083207,Lim; Seonhee,7,0,34,27
1657284901940,MATH 10B,A02,083208,Lim; Seonhee,9,0,35,26
1657284901940,MATH 10B,A03,093472,Lim; Seonhee,5,0,34,29
1657284901940,MATH 10B,B01,083739,Sinha; Shubham,11,0,30,19
1657284907980,MATH 18,A01,083743,Cinel; Cameron Alexander,6,0,30,24
1657284907980,MATH 18,A02,083744,Cinel; Cameron Alexander,17,0,30,13
1657284907980,MATH 18,A03,083745,Cinel; Cameron Alexander,8,0,30,22
1657284907980,MATH 18,B01,083748,Rideout; David Porter,4,0,37,33
1657284907980,MATH 18,B02,083749,Rideout; David Porter,4,0,36,32
1657284907980,MATH 18,B03,083750,Rideout; David Porter,2,0,37,35
1657284907980,MATH 18,B04,083751,Rideout; David Porter,6,0,36,30
1657284907980,MATH 18,B05,093473,Rideout; David Porter,5,0,36,31
1657284907980,MATH 18,B06,093474,Rideout; David Porter,5,0,36,31
1657284914006,MATH 20A,A01,083754,Zheng; Zequn,14,0,40,26
1657284920032,MATH 20B,A01,083756,Briones; Jor-el Thomas Caparas,3,0,36,33
1657284920032,MATH 20B,A02,083757,Briones; Jor-el Thomas Caparas,1,0,36,35
1657284920032,MATH 20B,A03,093475,Briones; Jor-el Thomas Caparas,2,0,36,34
1657284926058,MATH 20C,A01,083760,Briones; Jor-el Thomas Caparas,1,0,35,34
1657284926058,MATH 20C,A02,083761,Briones; Jor-el Thomas Caparas,8,0,35,27
1657284926058,MATH 20C,A03,093476,Briones; Jor-el Thomas Caparas,0,1,36,36
1657284926058,MATH 20C,B01,083762,Bach; Quang Tran,1,0,30,29
1657284932090,MATH 20D,A01,083765,Tran; Brian Kha,5,0,30,25
1657284932090,MATH 20D,A02,083766,Tran; Brian Kha,5,0,30,25
1657284932090,MATH 20D,A03,083767,Tran; Brian Kha,4,0,30,26
1657284938118,MATH 20E,A01,083771,Ganguly; Soumya,7,0,32,25
1657284938118,MATH 20E,A02,083772,Ganguly; Soumya,7,0,32,25
1657284938118,MATH 20E,B01,083773,Ciotti; Benjamin,19,0,35,16
1657284938118,MATH 20E,B02,083774,Ciotti; Benjamin,17,0,35,18
1657284944156,MATH 103A,A01,083777,Greenfeld; Be'Eri,3,0,36,33
1657284944156,MATH 103A,A02,083778,Greenfeld; Be'Eri,5,0,36,31
1657284944156,MATH 103A,A03,093561,Greenfeld; Be'Eri,4,0,36,32
1657284944156,MATH 103A,B01,083779,Greenfeld; Be'Eri,6,0,36,30
1657284944156,MATH 103A,B02,083780,Greenfeld; Be'Eri,3,0,36,33
1657284944156,MATH 103A,B03,093562,Greenfeld; Be'Eri,3,0,36,33
1657284950189,MATH 105,A01,085443,Carter; Anne Toulson,15,0,35,20
1657284950189,MATH 105,A02,093477,Carter; Anne Toulson,20,0,35,15
1657284956217,MATH 109,A01,083213,Ganzberger; Geoffrey Michael,2,0,34,32
1657284956217,MATH 109,A02,083214,Ganzberger; Geoffrey Michael,4,0,34,30
1657284956217,MATH 109,A03,093478,Ganzberger; Geoffrey Michael,2,0,34,32
1657284956217,MATH 109,B01,083215,Ganzberger; Geoffrey Michael,1,0,32,31
1657284956217,MATH 109,B02,083216,Ganzberger; Geoffrey Michael,1,0,32,31
1657284956217,MATH 109,B03,093479,Ganzberger; Geoffrey Michael,8,0,32,24
1657284962243,MATH 142A,A01,083219,Chow; Bennett,7,0,32,25
1657284962243,MATH 142A,A02,083220,Chow; Bennett,10,0,32,22
1657284962243,MATH 142A,A03,093480,Chow; Bennett,7,0,32,25
1657284962243,MATH 142A,B03,093481,Chow; Bennett,8,0,32,24
1657284962243,MATH 142A,B04,093558,Chow; Bennett,12,0,32,20
1657284962243,MATH 142A,B05,093559,Chow; Bennett,6,0,32,26
1657284968277,MATH 193A,A01,083224,Rotar; Vladimir,7,0,34,27
1657284968277,MATH 193A,A02,083225,Rotar; Vladimir,6,0,34,28
1657284968277,MATH 193A,A03,083781,Rotar; Vladimir,2,0,34,32
1657284968277,MATH 193A,A04,083782,Rotar; Vladimir,8,0,34,26
1657284968277,MATH 193A,A05,093482,Rotar; Vladimir,6,0,34,28
1657284974310,MATH 197,001,091859,McAuley; Julian John,9999,0,9999,0
1657284974310,MATH 197,002,095566,Kedlaya; Kiran S.,9997,0,9999,2
1657284974310,MATH 197,003,095567,Xiao; Ming,9999,0,9999,0
1657284974310,MATH 197,004,095571,Perols; Johan Lars,9998,0,9999,1
1657284981398,COGS 9,A01,083615,Shannon; Kyle Michael,8,0,75,67
1657284987444,COGS 11,A01,083617,Boyle; Mary E. T.,22,0,48,26
1657284993473,COGS 13,A01,083071,Bastos; Amalia Pinkusfeld,9,0,71,62
1657284999498,COGS 14A,A01,092681,Semenuks; Arturs,2,1,100,98
1657285005523,COGS 14B,A01,083073,Cheng; Tzu-Han,6,0,63,57
1657285011548,COGS 17,A01,092677,Semenuks; Arturs,5,0,81,76
1657285017585,COGS 100,A01,083619,Allen; Michael Gordon,16,0,70,54
1657285023613,COGS 101A,A01,083621,Davis; Joshua Daniel,9,0,68,59
1657285029639,COGS 101B,A01,091572,Allen; Michael Gordon,11,0,65,54
1657285035665,COGS 101C,A01,083625,Delgado; Tania,17,0,35,18
1657285041696,COGS 107A,A01,083627,Boyle; Mary E. T.,13,0,60,47
1657285047723,COGS 118A,A01,083075,Gupta; Anjum,18,0,76,58
1657285053763,CSE 3,A50,083646,Miranda; Gregory Joseph,24,0,50,26
1657285059794,CSE 8A,A50,083650,Miranda; Gregory Joseph,17,1,56,39
1657285065819,CSE 11,A01,083080,Cao; Yingjun,5,15,40,35
1657285071858,CSE 12,A01,083652,Krause-Levy; Sophia Louisa,26,1,120,94
1657285077893,CSE 15L,A01,083654,Morris; Justin Loren,9,0,50,41
1657285077893,CSE 15L,A02,083655,Morris; Justin Loren,9,0,50,41
1657285083918,CSE 20,A01,083657,Tran; Khoa Dang,38,0,80,42
1657285089944,CSE 21,A01,095574,Bach; Quang Tran,22,0,48,26
1657285095971,CSE 30,A01,083084,Eldon; John,4,0,80,76
1657285095971,CSE 30,B01,095061,Bhaskar; Nishant,8,0,50,42
1657285102002,CSE 100,A01,083659,Cao; Yingjun,4,4,70,66
1657285108027,CSE 134B,A01,083661,Powell; Thomas Allan,21,0,100,79
1657285114070,CSE 140,A01,083663,Gungor; Onat,13,0,85,72
1657285120097,CSE 140L,A01,083088,Eldon; John,19,0,100,81
1657285126127,CSE 175,A01,083665,Kumar; Rakesh,3,0,25,22
1657285132157,CSE 190,A00,092507,Dubnov; Shlomo,7,0,20,13
1657285138196,ECE 45,A01,083139,Congero; Spencer William,5,0,75,70
1657285144230,ECE 65,A50,083695,Saad; Andrew S,12,0,30,18
1657285144230,ECE 65,A51,095125,Saad; Andrew S,25,0,26,1
1657285150259,ECE 109,A01,091882,Touri; Behrouz,19,0,70,51
1657285156288,ECE 180,A00,083140,Abi Samra; Nicholas Camill,1,0,30,29
1657285156288,ECE 180,B00,083141,Abi Samra; Nicholas Camill,0,0,30,30
1657285162314,MATH 10A,A01,083735,Patchell; Gregory David,2,0,30,28
1657285162314,MATH 10A,A02,083736,Patchell; Gregory David,20,0,30,10
1657285162314,MATH 10A,A03,083737,Patchell; Gregory David,16,0,30,14
1657285168351,MATH 10B,A01,083207,Lim; Seonhee,7,0,34,27
1657285168351,MATH 10B,A02,083208,Lim; Seonhee,9,0,35,26
1657285168351,MATH 10B,A03,093472,Lim; Seonhee,5,0,34,29
1657285168351,MATH 10B,B01,083739,Sinha; Shubham,11,0,30,19
1657285174388,MATH 18,A01,083743,Cinel; Cameron Alexander,6,0,30,24
1657285174388,MATH 18,A02,083744,Cinel; Cameron Alexander,17,0,30,13
1657285174388,MATH 18,A03,083745,Cinel; Cameron Alexander,8,0,30,22
1657285174388,MATH 18,B01,083748,Rideout; David Porter,4,0,37,33
1657285174388,MATH 18,B02,083749,Rideout; David Porter,4,0,36,32
1657285174388,MATH 18,B03,083750,Rideout; David Porter,2,0,37,35
1657285174388,MATH 18,B04,083751,Rideout; David Porter,6,0,36,30
1657285174388,MATH 18,B05,093473,Rideout; David Porter,5,0,36,31
1657285174388,MATH 18,B06,093474,Rideout; David Porter,5,0,36,31
1657285180417,MATH 20A,A01,083754,Zheng; Zequn,14,0,40,26
1657285186441,MATH 20B,A01,083756,Briones; Jor-el Thomas Caparas,3,0,36,33
1657285186441,MATH 20B,A02,083757,Briones; Jor-el Thomas Caparas,1,0,36,35
1657285186441,MATH 20B,A03,093475,Briones; Jor-el Thomas Caparas,2,0,36,34
1657285192488,MATH 20C,A01,083760,Briones; Jor-el Thomas Caparas,1,0,35,34
1657285192488,MATH 20C,A02,083761,Briones; Jor-el Thomas Caparas,8,0,35,27
1657285192488,MATH 20C,A03,093476,Briones; Jor-el Thomas Caparas,0,1,36,36
1657285192488,MATH 20C,B01,083762,Bach; Quang Tran,1,0,30,29
1657285198520,MATH 20D,A01,083765,Tran; Brian Kha,5,0,30,25
1657285198520,MATH 20D,A02,083766,Tran; Brian Kha,5,0,30,25
1657285198520,MATH 20D,A03,083767,Tran; Brian Kha,4,0,30,26
1657285204546,MATH 20E,A01,083771,Ganguly; Soumya,7,0,32,25
1657285204546,MATH 20E,A02,083772,Ganguly; Soumya,7,0,32,25
1657285204546,MATH 20E,B01,083773,Ciotti; Benjamin,19,0,35,16
1657285204546,MATH 20E,B02,083774,Ciotti; Benjamin,17,0,35,18
1657285210584,MATH 103A,A01,083777,Greenfeld; Be'Eri,3,0,36,33
1657285210584,MATH 103A,A02,083778,Greenfeld; Be'Eri,5,0,36,31
1657285210584,MATH 103A,A03,093561,Greenfeld; Be'Eri,4,0,36,32
1657285210584,MATH 103A,B01,083779,Greenfeld; Be'Eri,6,0,36,30
1657285210584,MATH 103A,B02,083780,Greenfeld; Be'Eri,3,0,36,33
1657285210584,MATH 103A,B03,093562,Greenfeld; Be'Eri,3,0,36,33
1657285216609,MATH 105,A01,085443,Carter; Anne Toulson,15,0,35,20
1657285216609,MATH 105,A02,093477,Carter; Anne Toulson,20,0,35,15
1657285222644,MATH 109,A01,083213,Ganzberger; Geoffrey Michael,2,0,34,32
1657285222644,MATH 109,A02,083214,Ganzberger; Geoffrey Michael,4,0,34,30
1657285222644,MATH 109,A03,093478,Ganzberger; Geoffrey Michael,2,0,34,32
1657285222644,MATH 109,B01,083215,Ganzberger; Geoffrey Michael,1,0,32,31
1657285222644,MATH 109,B02,083216,Ganzberger; Geoffrey Michael,1,0,32,31
1657285222644,MATH 109,B03,093479,Ganzberger; Geoffrey Michael,8,0,32,24
1657285228672,MATH 142A,A01,083219,Chow; Bennett,7,0,32,25
1657285228672,MATH 142A,A02,083220,Chow; Bennett,10,0,32,22
1657285228672,MATH 142A,A03,093480,Chow; Bennett,7,0,32,25
1657285228672,MATH 142A,B03,093481,Chow; Bennett,8,0,32,24
1657285228672,MATH 142A,B04,093558,Chow; Bennett,12,0,32,20
1657285228672,MATH 142A,B05,093559,Chow; Bennett,6,0,32,26
1657285234719,MATH 193A,A01,083224,Rotar; Vladimir,7,0,34,27
1657285234719,MATH 193A,A02,083225,Rotar; Vladimir,6,0,34,28
1657285234719,MATH 193A,A03,083781,Rotar; Vladimir,2,0,34,32
1657285234719,MATH 193A,A04,083782,Rotar; Vladimir,8,0,34,26
1657285234719,MATH 193A,A05,093482,Rotar; Vladimir,6,0,34,28
1657285240745,MATH 197,001,091859,McAuley; Julian John,9999,0,9999,0
1657285240745,MATH 197,002,095566,Kedlaya; Kiran S.,9997,0,9999,2
1657285240745,MATH 197,003,095567,Xiao; Ming,9999,0,9999,0
1657285240745,MATH 197,004,095571,Perols; Johan Lars,9998,0,9999,1
1657285247826,COGS 9,A01,083615,Shannon; Kyle Michael,8,0,75,67
1657285253857,COGS 11,A01,083617,Boyle; Mary E. T.,22,0,48,26
1657285259888,COGS 13,A01,083071,Bastos; Amalia Pinkusfeld,9,0,71,62
1657285265923,COGS 14A,A01,092681,Semenuks; Arturs,2,1,100,98
1657285271954,COGS 14B,A01,083073,Cheng; Tzu-Han,6,0,63,57
1657285277989,COGS 17,A01,092677,Semenuks; Arturs,5,0,81,76
1657285284017,COGS 100,A01,083619,Allen; Michael Gordon,16,0,70,54
1657285290048,COGS 101A,A01,083621,Davis; Joshua Daniel,9,0,68,59
1657285296077,COGS 101B,A01,091572,Allen; Michael Gordon,11,0,65,54
1657285302110,COGS 101C,A01,083625,Delgado; Tania,17,0,35,18
1657285308141,COGS 107A,A01,083627,Boyle; Mary E. T.,13,0,60,47
1657285314179,COGS 118A,A01,083075,Gupta; Anjum,18,0,76,58
1657285320207,CSE 3,A50,083646,Miranda; Gregory Joseph,24,0,50,26
1657285326241,CSE 8A,A50,083650,Miranda; Gregory Joseph,17,1,56,39
1657285332269,CSE 11,A01,083080,Cao; Yingjun,5,15,40,35
1657285338304,CSE 12,A01,083652,Krause-Levy; Sophia Louisa,26,1,120,94
1657285344332,CSE 15L,A01,083654,Morris; Justin Loren,9,0,50,41
1657285344332,CSE 15L,A02,083655,Morris; Justin Loren,9,0,50,41
1657285350373,CSE 20,A01,083657,Tran; Khoa Dang,38,0,80,42
1657285356400,CSE 21,A01,095574,Bach; Quang Tran,22,0,48,26
1657285362427,CSE 30,A01,083084,Eldon; John,4,0,80,76
1657285362427,CSE 30,B01,095061,Bhaskar; Nishant,8,0,50,42
1657285368454,CSE 100,A01,083659,Cao; Yingjun,4,4,70,66
1657285374498,CSE 134B,A01,083661,Powell; Thomas Allan,21,0,100,79
1657285380521,CSE 140,A01,083663,Gungor; Onat,13,0,85,72
1657285386550,CSE 140L,A01,083088,Eldon; John,19,0,100,81
1657285392578,CSE 175,A01,083665,Kumar; Rakesh,3,0,25,22
1657285398612,CSE 190,A00,092507,Dubnov; Shlomo,7,0,20,13
1657285404651,ECE 45,A01,083139,Congero; Spencer William,5,0,75,70
1657285410751,ECE 65,A50,083695,Saad; Andrew S,12,0,30,18
1657285410751,ECE 65,A51,095125,Saad; Andrew S,25,0,26,1
1657285416777,ECE 109,A01,091882,Touri; Behrouz,19,0,70,51
1657285422804,ECE 180,A00,083140,Abi Samra; Nicholas Camill,1,0,30,29
1657285422804,ECE 180,B00,083141,Abi Samra; Nicholas Camill,0,0,30,30
1657285428841,MATH 10A,A01,083735,Patchell; Gregory David,2,0,30,28
1657285428841,MATH 10A,A02,083736,Patchell; Gregory David,20,0,30,10
1657285428841,MATH 10A,A03,083737,Patchell; Gregory David,16,0,30,14
1657285434871,MATH 10B,A01,083207,Lim; Seonhee,7,0,34,27
1657285434871,MATH 10B,A02,083208,Lim; Seonhee,9,0,35,26
1657285434871,MATH 10B,A03,093472,Lim; Seonhee,5,0,34,29
1657285434871,MATH 10B,B01,083739,Sinha; Shubham,11,0,30,19
1657285440900,MATH 18,A01,083743,Cinel; Cameron Alexander,6,0,30,24
1657285440900,MATH 18,A02,083744,Cinel; Cameron Alexander,17,0,30,13
1657285440900,MATH 18,A03,083745,Cinel; Cameron Alexander,8,0,30,22
1657285440900,MATH 18,B01,083748,Rideout; David Porter,4,0,37,33
1657285440900,MATH 18,B02,083749,Rideout; David Porter,4,0,36,32
1657285440900,MATH 18,B03,083750,Rideout; David Porter,2,0,37,35
1657285440900,MATH 18,B04,083751,Rideout; David Porter,6,0,36,30
1657285440900,MATH 18,B05,093473,Rideout; David Porter,5,0,36,31
1657285440900,MATH 18,B06,093474,Rideout; David Porter,5,0,36,31
1657285446935,MATH 20A,A01,083754,Zheng; Zequn,14,0,40,26
1657285452964,MATH 20B,A01,083756,Briones; Jor-el Thomas Caparas,3,0,36,33
1657285452964,MATH 20B,A02,083757,Briones; Jor-el Thomas Caparas,1,0,36,35
1657285452964,MATH 20B,A03,093475,Briones; Jor-el Thomas Caparas,2,0,36,34
1657285458991,MATH 20C,A01,083760,Briones; Jor-el Thomas Caparas,1,0,35,34
1657285458991,MATH 20C,A02,083761,Briones; Jor-el Thomas Caparas,8,0,35,27
1657285458991,MATH 20C,A03,093476,Briones; Jor-el Thomas Caparas,0,1,36,36
1657285458991,MATH 20C,B01,083762,Bach; Quang Tran,1,0,30,29
1657285465027,MATH 20D,A01,083765,Tran; Brian Kha,5,0,30,25
1657285465027,MATH 20D,A02,083766,Tran; Brian Kha,5,0,30,25
1657285465027,MATH 20D,A03,083767,Tran; Brian Kha,4,0,30,26
1657285471055,MATH 20E,A01,083771,Ganguly; Soumya,7,0,32,25
1657285471055,MATH 20E,A02,083772,Ganguly; Soumya,7,0,32,25
1657285471055,MATH 20E,B01,083773,Ciotti; Benjamin,19,0,35,16
1657285471055,MATH 20E,B02,083774,Ciotti; Benjamin,17,0,35,18
1657285477085,MATH 103A,A01,083777,Greenfeld; Be'Eri,3,0,36,33
1657285477085,MATH 103A,A02,083778,Greenfeld; Be'Eri,5,0,36,31
1657285477085,MATH 103A,A03,093561,Greenfeld; Be'Eri,4,0,36,32
1657285477085,MATH 103A,B01,083779,Greenfeld; Be'Eri,6,0,36,30
1657285477085,MATH 103A,B02,083780,Greenfeld; Be'Eri,3,0,36,33
1657285477085,MATH 103A,B03,093562,Greenfeld; Be'Eri,3,0,36,33
1657285483116,MATH 105,A01,085443,Carter; Anne Toulson,15,0,35,20
1657285483116,MATH 105,A02,093477,Carter; Anne Toulson,20,0,35,15
1657285489145,MATH 109,A01,083213,Ganzberger; Geoffrey Michael,2,0,34,32
1657285489145,MATH 109,A02,083214,Ganzberger; Geoffrey Michael,4,0,34,30
1657285489145,MATH 109,A03,093478,Ganzberger; Geoffrey Michael,2,0,34,32
1657285489145,MATH 109,B01,083215,Ganzberger; Geoffrey Michael,1,0,32,31
1657285489145,MATH 109,B02,083216,Ganzberger; Geoffrey Michael,1,0,32,31
1657285489145,MATH 109,B03,093479,Ganzberger; Geoffrey Michael,8,0,32,24
1657285495174,MATH 142A,A01,083219,Chow; Bennett,7,0,32,25
1657285495174,MATH 142A,A02,083220,Chow; Bennett,10,0,32,22
1657285495174,MATH 142A,A03,093480,Chow; Bennett,7,0,32,25
1657285495174,MATH 142A,B03,093481,Chow; Bennett,8,0,32,24
1657285495174,MATH 142A,B04,093558,Chow; Bennett,12,0,32,20
1657285495174,MATH 142A,B05,093559,Chow; Bennett,6,0,32,26
1657285501218,MATH 193A,A01,083224,Rotar; Vladimir,7,0,34,27
1657285501218,MATH 193A,A02,083225,Rotar; Vladimir,6,0,34,28
1657285501218,MATH 193A,A03,083781,Rotar; Vladimir,2,0,34,32
1657285501218,MATH 193A,A04,083782,Rotar; Vladimir,8,0,34,26
1657285501218,MATH 193A,A05,093482,Rotar; Vladimir,6,0,34,28
1657285507244,MATH 197,001,091859,McAuley; Julian John,9999,0,9999,0
1657285507244,MATH 197,002,095566,Kedlaya; Kiran S.,9997,0,9999,2
1657285507244,MATH 197,003,095567,Xiao; Ming,9999,0,9999,0
1657285507244,MATH 197,004,095571,Perols; Johan Lars,9998,0,9999,1
1657285514316,COGS 9,A01,083615,Shannon; Kyle Michael,8,0,75,67
1657285520342,COGS 11,A01,083617,Boyle; Mary E. T.,22,0,48,26
1657285526369,COGS 13,A01,083071,Bastos; Amalia Pinkusfeld,9,0,71,62
1657285532407,COGS 14A,A01,092681,Semenuks; Arturs,2,1,100,98
1657285538439,COGS 14B,A01,083073,Cheng; Tzu-Han,6,0,63,57
1657285544465,COGS 17,A01,092677,Semenuks; Arturs,5,0,81,76
1657285550512,COGS 100,A01,083619,Allen; Michael Gordon,16,0,70,54
1657285556543,COGS 101A,A01,083621,Davis; Joshua Daniel,9,0,68,59
1657285562570,COGS 101B,A01,091572,Allen; Michael Gordon,11,0,65,54
1657285568611,COGS 101C,A01,083625,Delgado; Tania,17,0,35,18
1657285574648,COGS 107A,A01,083627,Boyle; Mary E. T.,13,0,60,47
1657285580683,COGS 118A,A01,083075,Gupta; Anjum,18,0,76,58
1657285586736,CSE 3,A50,083646,Miranda; Gregory Joseph,24,0,50,26
1657285592761,CSE 8A,A50,083650,Miranda; Gregory Joseph,17,1,56,39
1657285598784,CSE 11,A01,083080,Cao; Yingjun,5,15,40,35
1657285604811,CSE 12,A01,083652,Krause-Levy; Sophia Louisa,26,1,120,94
1657285610837,CSE 15L,A01,083654,Morris; Justin Loren,9,0,50,41
1657285610837,CSE 15L,A02,083655,Morris; Justin Loren,9,0,50,41
1657285616862,CSE 20,A01,083657,Tran; Khoa Dang,38,0,80,42
1657285622890,CSE 21,A01,095574,Bach; Quang Tran,22,0,48,26
1657285628915,CSE 30,A01,083084,Eldon; John,4,0,80,76
1657285628915,CSE 30,B01,095061,Bhaskar; Nishant,8,0,50,42
1657285634943,CSE 100,A01,083659,Cao; Yingjun,4,4,70,66
1657285640969,CSE 134B,A01,083661,Powell; Thomas Allan,21,0,100,79
1657285646997,CSE 140,A01,083663,Gungor; Onat,13,0,85,72
1657285653027,CSE 140L,A01,083088,Eldon; John,19,0,100,81
1657285659052,CSE 175,A01,083665,Kumar; Rakesh,3,0,25,22
1657285665083,CSE 190,A00,092507,Dubnov; Shlomo,7,0,20,13
1657285671123,ECE 45,A01,083139,Congero; Spencer William,5,0,75,70
1657285677157,ECE 65,A50,083695,Saad; Andrew S,12,0,30,18
1657285677157,ECE 65,A51,095125,Saad; Andrew S,25,0,26,1
1657285683186,ECE 109,A01,091882,Touri; Behrouz,19,0,70,51
1657285689213,ECE 180,A00,083140,Abi Samra; Nicholas Camill,1,0,30,29
1657285689213,ECE 180,B00,083141,Abi Samra; Nicholas Camill,0,0,30,30
1657285695250,MATH 10A,A01,083735,Patchell; Gregory David,2,0,30,28
1657285695250,MATH 10A,A02,083736,Patchell; Gregory David,20,0,30,10
1657285695250,MATH 10A,A03,083737,Patchell; Gregory David,16,0,30,14
1657285701286,MATH 10B,A01,083207,Lim; Seonhee,7,0,34,27
1657285701286,MATH 10B,A02,083208,Lim; Seonhee,9,0,35,26
1657285701286,MATH 10B,A03,093472,Lim; Seonhee,5,0,34,29
1657285701286,MATH 10B,B01,083739,Sinha; Shubham,11,0,30,19
1657285707314,MATH 18,A01,083743,Cinel; Cameron Alexander,6,0,30,24
1657285707314,MATH 18,A02,083744,Cinel; Cameron Alexander,17,0,30,13
1657285707314,MATH 18,A03,083745,Cinel; Cameron Alexander,8,0,30,22
1657285707314,MATH 18,B01,083748,Rideout; David Porter,4,0,37,33
1657285707314,MATH 18,B02,083749,Rideout; David Porter,4,0,36,32
1657285707314,MATH 18,B03,083750,Rideout; David Porter,2,0,37,35
1657285707314,MATH 18,B04,083751,Rideout; David Porter,6,0,36,30
1657285707314,MATH 18,B05,093473,Rideout; David Porter,5,0,36,31
1657285707314,MATH 18,B06,093474,Rideout; David Porter,5,0,36,31
1657285713349,MATH 20A,A01,083754,Zheng; Zequn,14,0,40,26
1657285719393,MATH 20B,A01,083756,Briones; Jor-el Thomas Caparas,3,0,36,33
1657285719393,MATH 20B,A02,083757,Briones; Jor-el Thomas Caparas,1,0,36,35
1657285719393,MATH 20B,A03,093475,Briones; Jor-el Thomas Caparas,2,0,36,34
1657285725418,MATH 20C,A01,083760,Briones; Jor-el Thomas Caparas,1,0,35,34
1657285725418,MATH 20C,A02,083761,Briones; Jor-el Thomas Caparas,8,0,35,27
1657285725418,MATH 20C,A03,093476,Briones; Jor-el Thomas Caparas,0,1,36,36
1657285725418,MATH 20C,B01,083762,Bach; Quang Tran,1,0,30,29
1657285731442,MATH 20D,A01,083765,Tran; Brian Kha,5,0,30,25
1657285731442,MATH 20D,A02,083766,Tran; Brian Kha,5,0,30,25
1657285731442,MATH 20D,A03,083767,Tran; Brian Kha,4,0,30,26
1657285737469,MATH 20E,A01,083771,Ganguly; Soumya,7,0,32,25
1657285737469,MATH 20E,A02,083772,Ganguly; Soumya,7,0,32,25
1657285737469,MATH 20E,B01,083773,Ciotti; Benjamin,19,0,35,16
1657285737469,MATH 20E,B02,083774,Ciotti; Benjamin,17,0,35,18
1657285743508,MATH 103A,A01,083777,Greenfeld; Be'Eri,3,0,36,33
1657285743508,MATH 103A,A02,083778,Greenfeld; Be'Eri,5,0,36,31
1657285743508,MATH 103A,A03,093561,Greenfeld; Be'Eri,4,0,36,32
1657285743508,MATH 103A,B01,083779,Greenfeld; Be'Eri,6,0,36,30
1657285743508,MATH 103A,B02,083780,Greenfeld; Be'Eri,3,0,36,33
1657285743508,MATH 103A,B03,093562,Greenfeld; Be'Eri,3,0,36,33
1657285749538,MATH 105,A01,085443,Carter; Anne Toulson,15,0,35,20
1657285749538,MATH 105,A02,093477,Carter; Anne Toulson,20,0,35,15
1657285755572,MATH 109,A01,083213,Ganzberger; Geoffrey Michael,2,0,34,32
1657285755572,MATH 109,A02,083214,Ganzberger; Geoffrey Michael,4,0,34,30
1657285755572,MATH 109,A03,093478,Ganzberger; Geoffrey Michael,2,0,34,32
1657285755572,MATH 109,B01,083215,Ganzberger; Geoffrey Michael,1,0,32,31
1657285755572,MATH 109,B02,083216,Ganzberger; Geoffrey Michael,1,0,32,31
1657285755572,MATH 109,B03,093479,Ganzberger; Geoffrey Michael,8,0,32,24
1657285761600,MATH 142A,A01,083219,Chow; Bennett,7,0,32,25
1657285761600,MATH 142A,A02,083220,Chow; Bennett,10,0,32,22
1657285761600,MATH 142A,A03,093480,Chow; Bennett,7,0,32,25
1657285761600,MATH 142A,B03,093481,Chow; Bennett,8,0,32,24
1657285761600,MATH 142A,B04,093558,Chow; Bennett,12,0,32,20
1657285761600,MATH 142A,B05,093559,Chow; Bennett,6,0,32,26
1657285767631,MATH 193A,A01,083224,Rotar; Vladimir,7,0,34,27
1657285767631,MATH 193A,A02,083225,Rotar; Vladimir,6,0,34,28
1657285767631,MATH 193A,A03,083781,Rotar; Vladimir,2,0,34,32
1657285767631,MATH 193A,A04,083782,Rotar; Vladimir,8,0,34,26
1657285767631,MATH 193A,A05,093482,Rotar; Vladimir,6,0,34,28
1657285773656,MATH 197,001,091859,McAuley; Julian John,9999,0,9999,0
1657285773656,MATH 197,002,095566,Kedlaya; Kiran S.,9997,0,9999,2
1657285773656,MATH 197,003,095567,Xiao; Ming,9999,0,9999,0
1657285773656,MATH 197,004,095571,Perols; Johan Lars,9998,0,9999,1
1657285780733,COGS 9,A01,083615,Shannon; Kyle Michael,8,0,75,67
1657285786763,COGS 11,A01,083617,Boyle; Mary E. T.,22,0,48,26
1657285792789,COGS 13,A01,083071,Bastos; Amalia Pinkusfeld,9,0,71,62
1657285798817,COGS 14A,A01,092681,Semenuks; Arturs,2,1,100,98
1657285804842,COGS 14B,A01,083073,Cheng; Tzu-Han,6,0,63,57
1657285810865,COGS 17,A01,092677,Semenuks; Arturs,5,0,81,76
1657285816899,COGS 100,A01,083619,Allen; Michael Gordon,16,0,70,54
1657285822925,COGS 101A,A01,083621,Davis; Joshua Daniel,9,0,68,59
1657285828954,COGS 101B,A01,091572,Allen; Michael Gordon,11,0,65,54
1657285834986,COGS 101C,A01,083625,Delgado; Tania,17,0,35,18
1657285841012,COGS 107A,A01,083627,Boyle; Mary E. T.,13,0,60,47
1657285847044,COGS 118A,A01,083075,Gupta; Anjum,18,0,76,58
1657285853075,CSE 3,A50,083646,Miranda; Gregory Joseph,24,0,50,26
1657285859104,CSE 8A,A50,083650,Miranda; Gregory Joseph,17,1,56,39
1657285865129,CSE 11,A01,083080,Cao; Yingjun,5,15,40,35
1657285871162,CSE 12,A01,083652,Krause-Levy; Sophia Louisa,26,1,120,94
1657285877201,CSE 15L,A01,083654,Morris; Justin Loren,9,0,50,41
1657285877201,CSE 15L,A02,083655,Morris; Justin Loren,9,0,50,41
1657285883226,CSE 20,A01,083657,Tran; Khoa Dang,38,0,80,42
1657285889251,CSE 21,A01,095574,Bach; Quang Tran,22,0,48,26
1657285895277,CSE 30,A01,083084,Eldon; John,4,0,80,76
1657285895277,CSE 30,B01,095061,Bhaskar; Nishant,8,0,50,42
1657285901305,CSE 100,A01,083659,Cao; Yingjun,4,4,70,66
1657285907334,CSE 134B,A01,083661,Powell; Thomas Allan,21,0,100,79
1657285913363,CSE 140,A01,083663,Gungor; Onat,13,0,85,72
1657285919395,CSE 140L,A01,083088,Eldon; John,19,0,100,81
1657285925419,CSE 175,A01,083665,Kumar; Rakesh,3,0,25,22
1657285931446,CSE 190,A00,092507,Dubnov; Shlomo,7,0,20,13
1657285937476,ECE 45,A01,083139,Congero; Spencer William,5,0,75,70
1657285943502,ECE 65,A50,083695,Saad; Andrew S,12,0,30,18
1657285943502,ECE 65,A51,095125,Saad; Andrew S,25,0,26,1
1657285949531,ECE 109,A01,091882,Touri; Behrouz,19,0,70,51
1657285955559,ECE 180,A00,083140,Abi Samra; Nicholas Camill,1,0,30,29
1657285955559,ECE 180,B00,083141,Abi Samra; Nicholas Camill,0,0,30,30
1657285961583,MATH 10A,A01,083735,Patchell; Gregory David,2,0,30,28
1657285961583,MATH 10A,A02,083736,Patchell; Gregory David,20,0,30,10
1657285961583,MATH 10A,A03,083737,Patchell; Gregory David,16,0,30,14
1657285967614,MATH 10B,A01,083207,Lim; Seonhee,7,0,34,27
1657285967614,MATH 10B,A02,083208,Lim; Seonhee,9,0,35,26
1657285967614,MATH 10B,A03,093472,Lim; Seonhee,5,0,34,29
1657285967614,MATH 10B,B01,083739,Sinha; Shubham,11,0,30,19
1657285973642,MATH 18,A01,083743,Cinel; Cameron Alexander,6,0,30,24
1657285973642,MATH 18,A02,083744,Cinel; Cameron Alexander,17,0,30,13
1657285973642,MATH 18,A03,083745,Cinel; Cameron Alexander,8,0,30,22
1657285973642,MATH 18,B01,083748,Rideout; David Porter,4,0,37,33
1657285973642,MATH 18,B02,083749,Rideout; David Porter,4,0,36,32
1657285973642,MATH 18,B03,083750,Rideout; David Porter,2,0,37,35
1657285973642,MATH 18,B04,083751,Rideout; David Porter,6,0,36,30
1657285973642,MATH 18,B05,093473,Rideout; David Porter,5,0,36,31
1657285973642,MATH 18,B06,093474,Rideout; David Porter,5,0,36,31
1657285979670,MATH 20A,A01,083754,Zheng; Zequn,14,0,40,26
1657285985695,MATH 20B,A01,083756,Briones; Jor-el Thomas Caparas,3,0,36,33
1657285985695,MATH 20B,A02,083757,Briones; Jor-el Thomas Caparas,1,0,36,35
1657285985695,MATH 20B,A03,093475,Briones; Jor-el Thomas Caparas,2,0,36,34
1657285991734,MATH 20C,A01,083760,Briones; Jor-el Thomas Caparas,1,0,35,34
1657285991734,MATH 20C,A02,083761,Briones; Jor-el Thomas Caparas,8,0,35,27
1657285991734,MATH 20C,A03,093476,Briones; Jor-el Thomas Caparas,0,1,36,36
1657285991734,MATH 20C,B01,083762,Bach; Quang Tran,1,0,30,29
1657285997765,MATH 20D,A01,083765,Tran; Brian Kha,5,0,30,25
1657285997765,MATH 20D,A02,083766,Tran; Brian Kha,5,0,30,25
1657285997765,MATH 20D,A03,083767,Tran; Brian Kha,4,0,30,26
1657286003794,MATH 20E,A01,083771,Ganguly; Soumya,7,0,32,25
1657286003794,MATH 20E,A02,083772,Ganguly; Soumya,7,0,32,25
1657286003794,MATH 20E,B01,083773,Ciotti; Benjamin,19,0,35,16
1657286003794,MATH 20E,B02,083774,Ciotti; Benjamin,17,0,35,18
1657286009891,MATH 103A,A01,083777,Greenfeld; Be'Eri,3,0,36,33
1657286009891,MATH 103A,A02,083778,Greenfeld; Be'Eri,5,0,36,31
1657286009891,MATH 103A,A03,093561,Greenfeld; Be'Eri,4,0,36,32
1657286009891,MATH 103A,B01,083779,Greenfeld; Be'Eri,6,0,36,30
1657286009891,MATH 103A,B02,083780,Greenfeld; Be'Eri,3,0,36,33
1657286009891,MATH 103A,B03,093562,Greenfeld; Be'Eri,3,0,36,33
1657286015922,MATH 105,A01,085443,Carter; Anne Toulson,15,0,35,20
1657286015922,MATH 105,A02,093477,Carter; Anne Toulson,20,0,35,15
1657286021948,MATH 109,A01,083213,Ganzberger; Geoffrey Michael,2,0,34,32
1657286021948,MATH 109,A02,083214,Ganzberger; Geoffrey Michael,4,0,34,30
1657286021948,MATH 109,A03,093478,Ganzberger; Geoffrey Michael,2,0,34,32
1657286021948,MATH 109,B01,083215,Ganzberger; Geoffrey Michael,1,0,32,31
1657286021948,MATH 109,B02,083216,Ganzberger; Geoffrey Michael,1,0,32,31
1657286021948,MATH 109,B03,093479,Ganzberger; Geoffrey Michael,8,0,32,24
1657286027973,MATH 142A,A01,083219,Chow; Bennett,7,0,32,25
1657286027973,MATH 142A,A02,083220,Chow; Bennett,10,0,32,22
1657286027973,MATH 142A,A03,093480,Chow; Bennett,7,0,32,25
1657286027973,MATH 142A,B03,093481,Chow; Bennett,8,0,32,24
1657286027973,MATH 142A,B04,093558,Chow; Bennett,12,0,32,20
1657286027973,MATH 142A,B05,093559,Chow; Bennett,6,0,32,26
1657286034008,MATH 193A,A01,083224,Rotar; Vladimir,7,0,34,27
1657286034008,MATH 193A,A02,083225,Rotar; Vladimir,6,0,34,28
1657286034008,MATH 193A,A03,083781,Rotar; Vladimir,2,0,34,32
1657286034008,MATH 193A,A04,083782,Rotar; Vladimir,8,0,34,26
1657286034008,MATH 193A,A05,093482,Rotar; Vladimir,6,0,34,28
1657286040036,MATH 197,001,091859,McAuley; Julian John,9999,0,9999,0
1657286040036,MATH 197,002,095566,Kedlaya; Kiran S.,9997,0,9999,2
1657286040036,MATH 197,003,095567,Xiao; Ming,9999,0,9999,0
1657286040036,MATH 197,004,095571,Perols; Johan Lars,9998,0,9999,1
1657286047111,COGS 9,A01,083615,Shannon; Kyle Michael,8,0,75,67
1657286053134,COGS 11,A01,083617,Boyle; Mary E. T.,22,0,48,26
1657286059163,COGS 13,A01,083071,Bastos; Amalia Pinkusfeld,9,0,71,62
1657286065196,COGS 14A,A01,092681,Semenuks; Arturs,2,1,100,98
1657286071225,COGS 14B,A01,083073,Cheng; Tzu-Han,6,0,63,57
1657286077250,COGS 17,A01,092677,Semenuks; Arturs,5,0,81,76
1657286083275,COGS 100,A01,083619,Allen; Michael Gordon,16,0,70,54
1657286089303,COGS 101A,A01,083621,Davis; Joshua Daniel,9,0,68,59
1657286095332,COGS 101B,A01,091572,Allen; Michael Gordon,11,0,65,54
1657286101365,COGS 101C,A01,083625,Delgado; Tania,17,0,35,18
1657286107388,COGS 107A,A01,083627,Boyle; Mary E. T.,13,0,60,47
1657286113417,COGS 118A,A01,083075,Gupta; Anjum,18,0,76,58
1657286119445,CSE 3,A50,083646,Miranda; Gregory Joseph,24,0,50,26
1657286125473,CSE 8A,A50,083650,Miranda; Gregory Joseph,17,1,56,39
1657286131496,CSE 11,A01,083080,Cao; Yingjun,5,15,40,35
1657286137521,CSE 12,A01,083652,Krause-Levy; Sophia Louisa,26,1,120,94
1657286143546,CSE 15L,A01,083654,Morris; Justin Loren,9,0,50,41
1657286143546,CSE 15L,A02,083655,Morris; Justin Loren,9,0,50,41
1657286149573,CSE 20,A01,083657,Tran; Khoa Dang,38,0,80,42
1657286155606,CSE 21,A01,095574,Bach; Quang Tran,22,0,48,26
1657286161631,CSE 30,A01,083084,Eldon; John,4,0,80,76
1657286161631,CSE 30,B01,095061,Bhaskar; Nishant,8,0,50,42
1657286167658,CSE 100,A01,083659,Cao; Yingjun,4,4,70,66
1657286173684,CSE 134B,A01,083661,Powell; Thomas Allan,21,0,100,79
1657286179716,CSE 140,A01,083663,Gungor; Onat,13,0,85,72
1657286185745,CSE 140L,A01,083088,Eldon; John,19,0,100,81
1657286191768,CSE 175,A01,083665,Kumar; Rakesh,3,0,25,22
1657286197792,CSE 190,A00,092507,Dubnov; Shlomo,7,0,20,13
1657286203816,ECE 45,A01,083139,Congero; Spencer William,5,0,75,70
1657286209840,ECE 65,A50,083695,Saad; Andrew S,12,0,30,18
1657286209840,ECE 65,A51,095125,Saad; Andrew S,25,0,26,1
1657286215873,ECE 109,A01,091882,Touri; Behrouz,19,0,70,51
1657286221899,ECE 180,A00,083140,Abi Samra; Nicholas Camill,1,0,30,29
1657286221899,ECE 180,B00,083141,Abi Samra; Nicholas Camill,0,0,30,30
1657286227924,MATH 10A,A01,083735,Patchell; Gregory David,2,0,30,28
1657286227924,MATH 10A,A02,083736,Patchell; Gregory David,20,0,30,10
1657286227924,MATH 10A,A03,083737,Patchell; Gregory David,16,0,30,14
1657286233958,MATH 10B,A01,083207,Lim; Seonhee,7,0,34,27
1657286233958,MATH 10B,A02,083208,Lim; Seonhee,9,0,35,26
1657286233958,MATH 10B,A03,093472,Lim; Seonhee,5,0,34,29
1657286233958,MATH 10B,B01,083739,Sinha; Shubham,11,0,30,19
1657286239995,MATH 18,A01,083743,Cinel; Cameron Alexander,6,0,30,24
1657286239995,MATH 18,A02,083744,Cinel; Cameron Alexander,17,0,30,13
1657286239995,MATH 18,A03,083745,Cinel; Cameron Alexander,8,0,30,22
1657286239995,MATH 18,B01,083748,Rideout; David Porter,4,0,37,33
1657286239995,MATH 18,B02,083749,Rideout; David Porter,4,0,36,32
1657286239995,MATH 18,B03,083750,Rideout; David Porter,2,0,37,35
1657286239995,MATH 18,B04,083751,Rideout; David Porter,6,0,36,30
1657286239995,MATH 18,B05,093473,Rideout; David Porter,5,0,36,31
1657286239995,MATH 18,B06,093474,Rideout; David Porter,5,0,36,31
1657286246020,MATH 20A,A01,083754,Zheng; Zequn,14,0,40,26
1657286252054,MATH 20B,A01,083756,Briones; Jor-el Thomas Caparas,3,0,36,33
1657286252054,MATH 20B,A02,083757,Briones; Jor-el Thomas Caparas,1,0,36,35
1657286252054,MATH 20B,A03,093475,Briones; Jor-el Thomas Caparas,2,0,36,34
1657286258080,MATH 20C,A01,083760,Briones; Jor-el Thomas Caparas,1,0,35,34
1657286258080,MATH 20C,A02,083761,Briones; Jor-el Thomas Caparas,8,0,35,27
1657286258080,MATH 20C,A03,093476,Briones; Jor-el Thomas Caparas,0,1,36,36
1657286258080,MATH 20C,B01,083762,Bach; Quang Tran,1,0,30,29
1657286264105,MATH 20D,A01,083765,Tran; Brian Kha,5,0,30,25
1657286264105,MATH 20D,A02,083766,Tran; Brian Kha,5,0,30,25
1657286264105,MATH 20D,A03,083767,Tran; Brian Kha,4,0,30,26
1657286270133,MATH 20E,A01,083771,Ganguly; Soumya,7,0,32,25
1657286270133,MATH 20E,A02,083772,Ganguly; Soumya,7,0,32,25
1657286270133,MATH 20E,B01,083773,Ciotti; Benjamin,19,0,35,16
1657286270133,MATH 20E,B02,083774,Ciotti; Benjamin,17,0,35,18
1657286276160,MATH 103A,A01,083777,Greenfeld; Be'Eri,3,0,36,33
1657286276160,MATH 103A,A02,083778,Greenfeld; Be'Eri,5,0,36,31
1657286276160,MATH 103A,A03,093561,Greenfeld; Be'Eri,4,0,36,32
1657286276160,MATH 103A,B01,083779,Greenfeld; Be'Eri,6,0,36,30
1657286276160,MATH 103A,B02,083780,Greenfeld; Be'Eri,3,0,36,33
1657286276160,MATH 103A,B03,093562,Greenfeld; Be'Eri,3,0,36,33
1657286282188,MATH 105,A01,085443,Carter; Anne Toulson,15,0,35,20
1657286282188,MATH 105,A02,093477,Carter; Anne Toulson,20,0,35,15
1657286288212,MATH 109,A01,083213,Ganzberger; Geoffrey Michael,2,0,34,32
1657286288212,MATH 109,A02,083214,Ganzberger; Geoffrey Michael,4,0,34,30
1657286288212,MATH 109,A03,093478,Ganzberger; Geoffrey Michael,2,0,34,32
1657286288212,MATH 109,B01,083215,Ganzberger; Geoffrey Michael,1,0,32,31
1657286288212,MATH 109,B02,083216,Ganzberger; Geoffrey Michael,1,0,32,31
1657286288212,MATH 109,B03,093479,Ganzberger; Geoffrey Michael,8,0,32,24
1657286294246,MATH 142A,A01,083219,Chow; Bennett,7,0,32,25
1657286294246,MATH 142A,A02,083220,Chow; Bennett,10,0,32,22
1657286294246,MATH 142A,A03,093480,Chow; Bennett,7,0,32,25
1657286294246,MATH 142A,B03,093481,Chow; Bennett,8,0,32,24
1657286294246,MATH 142A,B04,093558,Chow; Bennett,12,0,32,20
1657286294246,MATH 142A,B05,093559,Chow; Bennett,6,0,32,26
1657286300276,MATH 193A,A01,083224,Rotar; Vladimir,7,0,34,27
1657286300276,MATH 193A,A02,083225,Rotar; Vladimir,6,0,34,28
1657286300276,MATH 193A,A03,083781,Rotar; Vladimir,2,0,34,32
1657286300276,MATH 193A,A04,083782,Rotar; Vladimir,8,0,34,26
1657286300276,MATH 193A,A05,093482,Rotar; Vladimir,6,0,34,28
1657286306303,MATH 197,001,091859,McAuley; Julian John,9999,0,9999,0
1657286306303,MATH 197,002,095566,Kedlaya; Kiran S.,9997,0,9999,2
1657286306303,MATH 197,003,095567,Xiao; Ming,9999,0,9999,0
1657286306303,MATH 197,004,095571,Perols; Johan Lars,9998,0,9999,1
1657286313390,COGS 9,A01,083615,Shannon; Kyle Michael,8,0,75,67
1657286319418,COGS 11,A01,083617,Boyle; Mary E. T.,22,0,48,26
1657286325448,COGS 13,A01,083071,Bastos; Amalia Pinkusfeld,9,0,71,62
1657286331474,COGS 14A,A01,092681,Semenuks; Arturs,2,1,100,98
1657286337504,COGS 14B,A01,083073,Cheng; Tzu-Han,6,0,63,57
1657286343530,COGS 17,A01,092677,Semenuks; Arturs,5,0,81,76
1657286349553,COGS 100,A01,083619,Allen; Michael Gordon,16,0,70,54
1657286355593,COGS 101A,A01,083621,Davis; Joshua Daniel,9,0,68,59
1657286361622,COGS 101B,A01,091572,Allen; Michael Gordon,11,0,65,54
1657286367650,COGS 101C,A01,083625,Delgado; Tania,17,0,35,18
1657286373678,COGS 107A,A01,083627,Boyle; Mary E. T.,13,0,60,47
1657286379704,COGS 118A,A01,083075,Gupta; Anjum,18,0,76,58
1657286385729,CSE 3,A50,083646,Miranda; Gregory Joseph,24,0,50,26
1657286391761,CSE 8A,A50,083650,Miranda; Gregory Joseph,17,1,56,39
1657286397785,CSE 11,A01,083080,Cao; Yingjun,5,15,40,35
1657286403812,CSE 12,A01,083652,Krause-Levy; Sophia Louisa,26,1,120,94
1657286409848,CSE 15L,A01,083654,Morris; Justin Loren,9,0,50,41
1657286409848,CSE 15L,A02,083655,Morris; Justin Loren,9,0,50,41
1657286415874,CSE 20,A01,083657,Tran; Khoa Dang,38,0,80,42
1657286421899,CSE 21,A01,095574,Bach; Quang Tran,22,0,48,26
1657286427925,CSE 30,A01,083084,Eldon; John,4,0,80,76
1657286427925,CSE 30,B01,095061,Bhaskar; Nishant,8,0,50,42
1657286433951,CSE 100,A01,083659,Cao; Yingjun,4,4,70,66
1657286439972,CSE 134B,A01,083661,Powell; Thomas Allan,21,0,100,79
1657286445997,CSE 140,A01,083663,Gungor; Onat,13,0,85,72
1657286452024,CSE 140L,A01,083088,Eldon; John,19,0,100,81
1657286458049,CSE 175,A01,083665,Kumar; Rakesh,3,0,25,22
1657286464079,CSE 190,A00,092507,Dubnov; Shlomo,7,0,20,13
1657286470104,ECE 45,A01,083139,Congero; Spencer William,5,0,75,70
1657286476136,ECE 65,A50,083695,Saad; Andrew S,12,0,30,18
1657286476136,ECE 65,A51,095125,Saad; Andrew S,25,0,26,1
1657286482168,ECE 109,A01,091882,Touri; Behrouz,19,0,70,51
1657286488195,ECE 180,A00,083140,Abi Samra; Nicholas Camill,1,0,30,29
1657286488195,ECE 180,B00,083141,Abi Samra; Nicholas Camill,0,0,30,30
1657286494225,MATH 10A,A01,083735,Patchell; Gregory David,2,0,30,28
1657286494225,MATH 10A,A02,083736,Patchell; Gregory David,20,0,30,10
1657286494225,MATH 10A,A03,083737,Patchell; Gregory David,16,0,30,14
1657286500258,MATH 10B,A01,083207,Lim; Seonhee,7,0,34,27
1657286500258,MATH 10B,A02,083208,Lim; Seonhee,9,0,35,26
1657286500258,MATH 10B,A03,093472,Lim; Seonhee,5,0,34,29
1657286500258,MATH 10B,B01,083739,Sinha; Shubham,11,0,30,19
1657286506291,MATH 18,A01,083743,Cinel; Cameron Alexander,6,0,30,24
1657286506291,MATH 18,A02,083744,Cinel; Cameron Alexander,17,0,30,13
1657286506291,MATH 18,A03,083745,Cinel; Cameron Alexander,8,0,30,22
1657286506291,MATH 18,B01,083748,Rideout; David Porter,4,0,37,33
1657286506291,MATH 18,B02,083749,Rideout; David Porter,4,0,36,32
1657286506291,MATH 18,B03,083750,Rideout; David Porter,2,0,37,35
1657286506291,MATH 18,B04,083751,Rideout; David Porter,6,0,36,30
1657286506291,MATH 18,B05,093473,Rideout; David Porter,5,0,36,31
1657286506291,MATH 18,B06,093474,Rideout; David Porter,5,0,36,31
1657286512320,MATH 20A,A01,083754,Zheng; Zequn,14,0,40,26
1657286518354,MATH 20B,A01,083756,Briones; Jor-el Thomas Caparas,3,0,36,33
1657286518354,MATH 20B,A02,083757,Briones; Jor-el Thomas Caparas,1,0,36,35
1657286518354,MATH 20B,A03,093475,Briones; Jor-el Thomas Caparas,2,0,36,34
1657286524384,MATH 20C,A01,083760,Briones; Jor-el Thomas Caparas,1,0,35,34
1657286524384,MATH 20C,A02,083761,Briones; Jor-el Thomas Caparas,8,0,35,27
1657286524384,MATH 20C,A03,093476,Briones; Jor-el Thomas Caparas,0,1,36,36
1657286524384,MATH 20C,B01,083762,Bach; Quang Tran,1,0,30,29
1657286530409,MATH 20D,A01,083765,Tran; Brian Kha,5,0,30,25
1657286530409,MATH 20D,A02,083766,Tran; Brian Kha,5,0,30,25
1657286530409,MATH 20D,A03,083767,Tran; Brian Kha,4,0,30,26
1657286536439,MATH 20E,A01,083771,Ganguly; Soumya,7,0,32,25
1657286536439,MATH 20E,A02,083772,Ganguly; Soumya,7,0,32,25
1657286536439,MATH 20E,B01,083773,Ciotti; Benjamin,19,0,35,16
1657286536439,MATH 20E,B02,083774,Ciotti; Benjamin,17,0,35,18
1657286542465,MATH 103A,A01,083777,Greenfeld; Be'Eri,3,0,36,33
1657286542465,MATH 103A,A02,083778,Greenfeld; Be'Eri,5,0,36,31
1657286542465,MATH 103A,A03,093561,Greenfeld; Be'Eri,4,0,36,32
1657286542465,MATH 103A,B01,083779,Greenfeld; Be'Eri,6,0,36,30
1657286542465,MATH 103A,B02,083780,Greenfeld; Be'Eri,3,0,36,33
1657286542465,MATH 103A,B03,093562,Greenfeld; Be'Eri,3,0,36,33
1657286548494,MATH 105,A01,085443,Carter; Anne Toulson,15,0,35,20
1657286548494,MATH 105,A02,093477,Carter; Anne Toulson,20,0,35,15
1657286554522,MATH 109,A01,083213,Ganzberger; Geoffrey Michael,2,0,34,32
1657286554522,MATH 109,A02,083214,Ganzberger; Geoffrey Michael,4,0,34,30
1657286554522,MATH 109,A03,093478,Ganzberger; Geoffrey Michael,2,0,34,32
1657286554522,MATH 109,B01,083215,Ganzberger; Geoffrey Michael,1,0,32,31
1657286554522,MATH 109,B02,083216,Ganzberger; Geoffrey Michael,1,0,32,31
1657286554522,MATH 109,B03,093479,Ganzberger; Geoffrey Michael,8,0,32,24
1657286560547,MATH 142A,A01,083219,Chow; Bennett,7,0,32,25
1657286560547,MATH 142A,A02,083220,Chow; Bennett,10,0,32,22
1657286560547,MATH 142A,A03,093480,Chow; Bennett,7,0,32,25
1657286560547,MATH 142A,B03,093481,Chow; Bennett,8,0,32,24
1657286560547,MATH 142A,B04,093558,Chow; Bennett,12,0,32,20
1657286560547,MATH 142A,B05,093559,Chow; Bennett,6,0,32,26
1657286566573,MATH 193A,A01,083224,Rotar; Vladimir,7,0,34,27
1657286566573,MATH 193A,A02,083225,Rotar; Vladimir,6,0,34,28
1657286566573,MATH 193A,A03,083781,Rotar; Vladimir,2,0,34,32
1657286566573,MATH 193A,A04,083782,Rotar; Vladimir,8,0,34,26
1657286566573,MATH 193A,A05,093482,Rotar; Vladimir,6,0,34,28
1657286572598,MATH 197,001,091859,McAuley; Julian John,9999,0,9999,0
1657286572598,MATH 197,002,095566,Kedlaya; Kiran S.,9997,0,9999,2
1657286572598,MATH 197,003,095567,Xiao; Ming,9999,0,9999,0
1657286572598,MATH 197,004,095571,Perols; Johan Lars,9998,0,9999,1
1657286579662,COGS 9,A01,083615,Shannon; Kyle Michael,8,0,75,67
1657286585687,COGS 11,A01,083617,Boyle; Mary E. T.,22,0,48,26
1657286591715,COGS 13,A01,083071,Bastos; Amalia Pinkusfeld,9,0,71,62
1657286597739,COGS 14A,A01,092681,Semenuks; Arturs,2,1,100,98
1657286603839,COGS 14B,A01,083073,Cheng; Tzu-Han,6,0,63,57
1657286609881,COGS 17,A01,092677,Semenuks; Arturs,5,0,81,76
1657286615905,COGS 100,A01,083619,Allen; Michael Gordon,16,0,70,54
1657286621933,COGS 101A,A01,083621,Davis; Joshua Daniel,9,0,68,59
1657286627956,COGS 101B,A01,091572,Allen; Michael Gordon,11,0,65,54
1657286633980,COGS 101C,A01,083625,Delgado; Tania,17,0,35,18
1657286640010,COGS 107A,A01,083627,Boyle; Mary E. T.,13,0,60,47
1657286646036,COGS 118A,A01,083075,Gupta; Anjum,18,0,76,58
1657286652068,CSE 3,A50,083646,Miranda; Gregory Joseph,24,0,50,26
1657286658098,CSE 8A,A50,083650,Miranda; Gregory Joseph,17,1,56,39
1657286664121,CSE 11,A01,083080,Cao; Yingjun,5,15,40,35
1657286670147,CSE 12,A01,083652,Krause-Levy; Sophia Louisa,26,1,120,94
1657286676171,CSE 15L,A01,083654,Morris; Justin Loren,9,0,50,41
1657286676171,CSE 15L,A02,083655,Morris; Justin Loren,9,0,50,41
1657286682202,CSE 20,A01,083657,Tran; Khoa Dang,38,0,80,42
1657286688232,CSE 21,A01,095574,Bach; Quang Tran,22,0,48,26
1657286694260,CSE 30,A01,083084,Eldon; John,4,0,80,76
1657286694260,CSE 30,B01,095061,Bhaskar; Nishant,8,0,50,42
1657286700290,CSE 100,A01,083659,Cao; Yingjun,4,4,70,66
1657286706314,CSE 134B,A01,083661,Powell; Thomas Allan,21,0,100,79
1657286712338,CSE 140,A01,083663,Gungor; Onat,13,0,85,72
1657286718361,CSE 140L,A01,083088,Eldon; John,19,0,100,81
1657286724390,CSE 175,A01,083665,Kumar; Rakesh,3,0,25,22
1657286730415,CSE 190,A00,092507,Dubnov; Shlomo,7,0,20,13
1657286736441,ECE 45,A01,083139,Congero; Spencer William,5,0,75,70
1657286742467,ECE 65,A50,083695,Saad; Andrew S,12,0,30,18
1657286742467,ECE 65,A51,095125,Saad; Andrew S,25,0,26,1
1657286748492,ECE 109,A01,091882,Touri; Behrouz,19,0,70,51
1657286754516,ECE 180,A00,083140,Abi Samra; Nicholas Camill,1,0,30,29
1657286754516,ECE 180,B00,083141,Abi Samra; Nicholas Camill,0,0,30,30
1657286760549,MATH 10A,A01,083735,Patchell; Gregory David,2,0,30,28
1657286760549,MATH 10A,A02,083736,Patchell; Gregory David,20,0,30,10
1657286760549,MATH 10A,A03,083737,Patchell; Gregory David,16,0,30,14
1657286766577,MATH 10B,A01,083207,Lim; Seonhee,7,0,34,27
1657286766577,MATH 10B,A02,083208,Lim; Seonhee,9,0,35,26
1657286766577,MATH 10B,A03,093472,Lim; Seonhee,5,0,34,29
1657286766577,MATH 10B,B01,083739,Sinha; Shubham,11,0,30,19
1657286772624,MATH 18,A01,083743,Cinel; Cameron Alexander,6,0,30,24
1657286772624,MATH 18,A02,083744,Cinel; Cameron Alexander,17,0,30,13
1657286772624,MATH 18,A03,083745,Cinel; Cameron Alexander,8,0,30,22
1657286772624,MATH 18,B01,083748,Rideout; David Porter,4,0,37,33
1657286772624,MATH 18,B02,083749,Rideout; David Porter,4,0,36,32
1657286772624,MATH 18,B03,083750,Rideout; David Porter,2,0,37,35
1657286772624,MATH 18,B04,083751,Rideout; David Porter,6,0,36,30
1657286772624,MATH 18,B05,093473,Rideout; David Porter,5,0,36,31
1657286772624,MATH 18,B06,093474,Rideout; David Porter,5,0,36,31
1657286778655,MATH 20A,A01,083754,Zheng; Zequn,14,0,40,26
1657286784681,MATH 20B,A01,083756,Briones; Jor-el Thomas Caparas,3,0,36,33
1657286784681,MATH 20B,A02,083757,Briones; Jor-el Thomas Caparas,1,0,36,35
1657286784681,MATH 20B,A03,093475,Briones; Jor-el Thomas Caparas,2,0,36,34
1657286790712,MATH 20C,A01,083760,Briones; Jor-el Thomas Caparas,1,0,35,34
1657286790712,MATH 20C,A02,083761,Briones; Jor-el Thomas Caparas,8,0,35,27
1657286790712,MATH 20C,A03,093476,Briones; Jor-el Thomas Caparas,0,1,36,36
1657286790712,MATH 20C,B01,083762,Bach; Quang Tran,1,0,30,29
1657286796744,MATH 20D,A01,083765,Tran; Brian Kha,5,0,30,25
1657286796744,MATH 20D,A02,083766,Tran; Brian Kha,5,0,30,25
1657286796744,MATH 20D,A03,083767,Tran; Brian Kha,4,0,30,26
1657286802772,MATH 20E,A01,083771,Ganguly; Soumya,7,0,32,25
1657286802772,MATH 20E,A02,083772,Ganguly; Soumya,7,0,32,25
1657286802772,MATH 20E,B01,083773,Ciotti; Benjamin,19,0,35,16
1657286802772,MATH 20E,B02,083774,Ciotti; Benjamin,17,0,35,18
1657286808803,MATH 103A,A01,083777,Greenfeld; Be'Eri,3,0,36,33
1657286808803,MATH 103A,A02,083778,Greenfeld; Be'Eri,5,0,36,31
1657286808803,MATH 103A,A03,093561,Greenfeld; Be'Eri,4,0,36,32
1657286808803,MATH 103A,B01,083779,Greenfeld; Be'Eri,6,0,36,30
1657286808803,MATH 103A,B02,083780,Greenfeld; Be'Eri,3,0,36,33
1657286808803,MATH 103A,B03,093562,Greenfeld; Be'Eri,3,0,36,33
1657286814835,MATH 105,A01,085443,Carter; Anne Toulson,15,0,35,20
1657286814835,MATH 105,A02,093477,Carter; Anne Toulson,20,0,35,15
1657286820861,MATH 109,A01,083213,Ganzberger; Geoffrey Michael,2,0,34,32
1657286820861,MATH 109,A02,083214,Ganzberger; Geoffrey Michael,4,0,34,30
1657286820861,MATH 109,A03,093478,Ganzberger; Geoffrey Michael,2,0,34,32
1657286820861,MATH 109,B01,083215,Ganzberger; Geoffrey Michael,1,0,32,31
1657286820861,MATH 109,B02,083216,Ganzberger; Geoffrey Michael,1,0,32,31
1657286820861,MATH 109,B03,093479,Ganzberger; Geoffrey Michael,8,0,32,24
1657286826894,MATH 142A,A01,083219,Chow; Bennett,7,0,32,25
1657286826894,MATH 142A,A02,083220,Chow; Bennett,10,0,32,22
1657286826894,MATH 142A,A03,093480,Chow; Bennett,7,0,32,25
1657286826894,MATH 142A,B03,093481,Chow; Bennett,8,0,32,24
1657286826894,MATH 142A,B04,093558,Chow; Bennett,12,0,32,20
1657286826894,MATH 142A,B05,093559,Chow; Bennett,6,0,32,26
1657286832921,MATH 193A,A01,083224,Rotar; Vladimir,7,0,34,27
1657286832921,MATH 193A,A02,083225,Rotar; Vladimir,6,0,34,28
1657286832921,MATH 193A,A03,083781,Rotar; Vladimir,2,0,34,32
1657286832921,MATH 193A,A04,083782,Rotar; Vladimir,8,0,34,26
1657286832921,MATH 193A,A05,093482,Rotar; Vladimir,6,0,34,28
1657286838949,MATH 197,001,091859,McAuley; Julian John,9999,0,9999,0
1657286838949,MATH 197,002,095566,Kedlaya; Kiran S.,9997,0,9999,2
1657286838949,MATH 197,003,095567,Xiao; Ming,9999,0,9999,0
1657286838949,MATH 197,004,095571,Perols; Johan Lars,9998,0,9999,1
1657286846015,COGS 9,A01,083615,Shannon; Kyle Michael,8,0,75,67
1657286852043,COGS 11,A01,083617,Boyle; Mary E. T.,22,0,48,26
1657286858075,COGS 13,A01,083071,Bastos; Amalia Pinkusfeld,9,0,71,62
1657286864101,COGS 14A,A01,092681,Semenuks; Arturs,2,1,100,98
1657286870131,COGS 14B,A01,083073,Cheng; Tzu-Han,6,0,63,57
1657286876159,COGS 17,A01,092677,Semenuks; Arturs,5,0,81,76
1657286882184,COGS 100,A01,083619,Allen; Michael Gordon,16,0,70,54
1657286888209,COGS 101A,A01,083621,Davis; Joshua Daniel,9,0,68,59
1657286894234,COGS 101B,A01,091572,Allen; Michael Gordon,11,0,65,54
1657286900259,COGS 101C,A01,083625,Delgado; Tania,17,0,35,18
1657286906286,COGS 107A,A01,083627,Boyle; Mary E. T.,13,0,60,47
1657286912314,COGS 118A,A01,083075,Gupta; Anjum,18,0,76,58
1657286918340,CSE 3,A50,083646,Miranda; Gregory Joseph,24,0,50,26
1657286924363,CSE 8A,A50,083650,Miranda; Gregory Joseph,17,1,56,39
1657286930392,CSE 11,A01,083080,Cao; Yingjun,5,15,40,35
1657286936423,CSE 12,A01,083652,Krause-Levy; Sophia Louisa,26,1,120,94
1657286942448,CSE 15L,A01,083654,Morris; Justin Loren,9,0,50,41
1657286942448,CSE 15L,A02,083655,Morris; Justin Loren,9,0,50,41
1657286948471,CSE 20,A01,083657,Tran; Khoa Dang,38,0,80,42
1657286954500,CSE 21,A01,095574,Bach; Quang Tran,22,0,48,26
1657286960526,CSE 30,A01,083084,Eldon; John,4,0,80,76
1657286960526,CSE 30,B01,095061,Bhaskar; Nishant,8,0,50,42
1657286966555,CSE 100,A01,083659,Cao; Yingjun,4,4,70,66
1657286972582,CSE 134B,A01,083661,Powell; Thomas Allan,21,0,100,79
1657286978607,CSE 140,A01,083663,Gungor; Onat,13,0,85,72
1657286984634,CSE 140L,A01,083088,Eldon; John,19,0,100,81
1657286990658,CSE 175,A01,083665,Kumar; Rakesh,3,0,25,22
1657286996684,CSE 190,A00,092507,Dubnov; Shlomo,7,0,20,13
1657287002727,ECE 45,A01,083139,Congero; Spencer William,5,0,75,70
1657287008754,ECE 65,A50,083695,Saad; Andrew S,12,0,30,18
1657287008754,ECE 65,A51,095125,Saad; Andrew S,25,0,26,1
1657287014779,ECE 109,A01,091882,Touri; Behrouz,19,0,70,51
1657287020808,ECE 180,A00,083140,Abi Samra; Nicholas Camill,1,0,30,29
1657287020808,ECE 180,B00,083141,Abi Samra; Nicholas Camill,0,0,30,30
1657287026838,MATH 10A,A01,083735,Patchell; Gregory David,2,0,30,28
1657287026838,MATH 10A,A02,083736,Patchell; Gregory David,20,0,30,10
1657287026838,MATH 10A,A03,083737,Patchell; Gregory David,16,0,30,14
1657287032867,MATH 10B,A01,083207,Lim; Seonhee,7,0,34,27
1657287032867,MATH 10B,A02,083208,Lim; Seonhee,9,0,35,26
1657287032867,MATH 10B,A03,093472,Lim; Seonhee,5,0,34,29
1657287032867,MATH 10B,B01,083739,Sinha; Shubham,11,0,30,19
1657287038900,MATH 18,A01,083743,Cinel; Cameron Alexander,6,0,30,24
1657287038900,MATH 18,A02,083744,Cinel; Cameron Alexander,17,0,30,13
1657287038900,MATH 18,A03,083745,Cinel; Cameron Alexander,8,0,30,22
1657287038900,MATH 18,B01,083748,Rideout; David Porter,4,0,37,33
1657287038900,MATH 18,B02,083749,Rideout; David Porter,4,0,36,32
1657287038900,MATH 18,B03,083750,Rideout; David Porter,2,0,37,35
1657287038900,MATH 18,B04,083751,Rideout; David Porter,6,0,36,30
1657287038900,MATH 18,B05,093473,Rideout; David Porter,5,0,36,31
1657287038900,MATH 18,B06,093474,Rideout; David Porter,5,0,36,31
1657287044925,MATH 20A,A01,083754,Zheng; Zequn,14,0,40,26
1657287050950,MATH 20B,A01,083756,Briones; Jor-el Thomas Caparas,3,0,36,33
1657287050950,MATH 20B,A02,083757,Briones; Jor-el Thomas Caparas,1,0,36,35
1657287050950,MATH 20B,A03,093475,Briones; Jor-el Thomas Caparas,2,0,36,34
1657287056980,MATH 20C,A01,083760,Briones; Jor-el Thomas Caparas,1,0,35,34
1657287056980,MATH 20C,A02,083761,Briones; Jor-el Thomas Caparas,8,0,35,27
1657287056980,MATH 20C,A03,093476,Briones; Jor-el Thomas Caparas,0,1,36,36
1657287056980,MATH 20C,B01,083762,Bach; Quang Tran,1,0,30,29
1657287063015,MATH 20D,A01,083765,Tran; Brian Kha,5,0,30,25
1657287063015,MATH 20D,A02,083766,Tran; Brian Kha,5,0,30,25
1657287063015,MATH 20D,A03,083767,Tran; Brian Kha,4,0,30,26
1657287069040,MATH 20E,A01,083771,Ganguly; Soumya,7,0,32,25
1657287069040,MATH 20E,A02,083772,Ganguly; Soumya,7,0,32,25
1657287069040,MATH 20E,B01,083773,Ciotti; Benjamin,19,0,35,16
1657287069040,MATH 20E,B02,083774,Ciotti; Benjamin,17,0,35,18
1657287075077,MATH 103A,A01,083777,Greenfeld; Be'Eri,3,0,36,33
1657287075077,MATH 103A,A02,083778,Greenfeld; Be'Eri,5,0,36,31
1657287075077,MATH 103A,A03,093561,Greenfeld; Be'Eri,4,0,36,32
1657287075077,MATH 103A,B01,083779,Greenfeld; Be'Eri,6,0,36,30
1657287075077,MATH 103A,B02,083780,Greenfeld; Be'Eri,3,0,36,33
1657287075077,MATH 103A,B03,093562,Greenfeld; Be'Eri,3,0,36,33
1657287081102,MATH 105,A01,085443,Carter; Anne Toulson,15,0,35,20
1657287081102,MATH 105,A02,093477,Carter; Anne Toulson,20,0,35,15
1657287087151,MATH 109,A01,083213,Ganzberger; Geoffrey Michael,2,0,34,32
1657287087151,MATH 109,A02,083214,Ganzberger; Geoffrey Michael,4,0,34,30
1657287087151,MATH 109,A03,093478,Ganzberger; Geoffrey Michael,2,0,34,32
1657287087151,MATH 109,B01,083215,Ganzberger; Geoffrey Michael,1,0,32,31
1657287087151,MATH 109,B02,083216,Ganzberger; Geoffrey Michael,1,0,32,31
1657287087151,MATH 109,B03,093479,Ganzberger; Geoffrey Michael,8,0,32,24
1657287093188,MATH 142A,A01,083219,Chow; Bennett,7,0,32,25
1657287093188,MATH 142A,A02,083220,Chow; Bennett,10,0,32,22
1657287093188,MATH 142A,A03,093480,Chow; Bennett,7,0,32,25
1657287093188,MATH 142A,B03,093481,Chow; Bennett,8,0,32,24
1657287093188,MATH 142A,B04,093558,Chow; Bennett,12,0,32,20
1657287093188,MATH 142A,B05,093559,Chow; Bennett,6,0,32,26
1657287099216,MATH 193A,A01,083224,Rotar; Vladimir,7,0,34,27
1657287099216,MATH 193A,A02,083225,Rotar; Vladimir,6,0,34,28
1657287099216,MATH 193A,A03,083781,Rotar; Vladimir,2,0,34,32
1657287099216,MATH 193A,A04,083782,Rotar; Vladimir,8,0,34,26
1657287099216,MATH 193A,A05,093482,Rotar; Vladimir,6,0,34,28
1657287105242,MATH 197,001,091859,McAuley; Julian John,9999,0,9999,0
1657287105242,MATH 197,002,095566,Kedlaya; Kiran S.,9997,0,9999,2
1657287105242,MATH 197,003,095567,Xiao; Ming,9999,0,9999,0
1657287105242,MATH 197,004,095571,Perols; Johan Lars,9998,0,9999,1
1657287112303,COGS 9,A01,083615,Shannon; Kyle Michael,8,0,75,67
1657287118333,COGS 11,A01,083617,Boyle; Mary E. T.,22,0,48,26
1657287124365,COGS 13,A01,083071,Bastos; Amalia Pinkusfeld,9,0,71,62
1657287130395,COGS 14A,A01,092681,Semenuks; Arturs,2,1,100,98
1657287136424,COGS 14B,A01,083073,Cheng; Tzu-Han,6,0,63,57
1657287142461,COGS 17,A01,092677,Semenuks; Arturs,5,0,81,76
1657287148492,COGS 100,A01,083619,Allen; Michael Gordon,16,0,70,54
1657287154521,COGS 101A,A01,083621,Davis; Joshua Daniel,9,0,68,59
1657287160548,COGS 101B,A01,091572,Allen; Michael Gordon,11,0,65,54
1657287166575,COGS 101C,A01,083625,Delgado; Tania,17,0,35,18
1657287172606,COGS 107A,A01,083627,Boyle; Mary E. T.,13,0,60,47
1657287178634,COGS 118A,A01,083075,Gupta; Anjum,18,0,76,58
1657287184658,CSE 3,A50,083646,Miranda; Gregory Joseph,24,0,50,26
1657287190687,CSE 8A,A50,083650,Miranda; Gregory Joseph,17,1,56,39
1657287196715,CSE 11,A01,083080,Cao; Yingjun,5,15,40,35
1657287202852,CSE 12,A01,083652,Krause-Levy; Sophia Louisa,26,1,120,94
1657287208876,CSE 15L,A01,083654,Morris; Justin Loren,9,0,50,41
1657287208876,CSE 15L,A02,083655,Morris; Justin Loren,9,0,50,41
1657287214908,CSE 20,A01,083657,Tran; Khoa Dang,38,0,80,42
1657287220931,CSE 21,A01,095574,Bach; Quang Tran,22,0,48,26
1657287226972,CSE 30,A01,083084,Eldon; John,4,0,80,76
1657287226972,CSE 30,B01,095061,Bhaskar; Nishant,8,0,50,42
1657287232996,CSE 100,A01,083659,Cao; Yingjun,4,4,70,66
1657287239024,CSE 134B,A01,083661,Powell; Thomas Allan,21,0,100,79
1657287245049,CSE 140,A01,083663,Gungor; Onat,13,0,85,72
1657287251087,CSE 140L,A01,083088,Eldon; John,19,0,100,81
1657287257115,CSE 175,A01,083665,Kumar; Rakesh,3,0,25,22
1657287263141,CSE 190,A00,092507,Dubnov; Shlomo,7,0,20,13
1657287269167,ECE 45,A01,083139,Congero; Spencer William,5,0,75,70
1657287275193,ECE 65,A50,083695,Saad; Andrew S,12,0,30,18
1657287275193,ECE 65,A51,095125,Saad; Andrew S,25,0,26,1
1657287281222,ECE 109,A01,091882,Touri; Behrouz,19,0,70,51
1657287287247,ECE 180,A00,083140,Abi Samra; Nicholas Camill,1,0,30,29
1657287287247,ECE 180,B00,083141,Abi Samra; Nicholas Camill,0,0,30,30
1657287293273,MATH 10A,A01,083735,Patchell; Gregory David,2,0,30,28
1657287293273,MATH 10A,A02,083736,Patchell; Gregory David,20,0,30,10
1657287293273,MATH 10A,A03,083737,Patchell; Gregory David,16,0,30,14
1657287299302,MATH 10B,A01,083207,Lim; Seonhee,7,0,34,27
1657287299302,MATH 10B,A02,083208,Lim; Seonhee,9,0,35,26
1657287299302,MATH 10B,A03,093472,Lim; Seonhee,5,0,34,29
1657287299302,MATH 10B,B01,083739,Sinha; Shubham,11,0,30,19
1657287305334,MATH 18,A01,083743,Cinel; Cameron Alexander,6,0,30,24
1657287305334,MATH 18,A02,083744,Cinel; Cameron Alexander,17,0,30,13
1657287305334,MATH 18,A03,083745,Cinel; Cameron Alexander,8,0,30,22
1657287305334,MATH 18,B01,083748,Rideout; David Porter,4,0,37,33
1657287305334,MATH 18,B02,083749,Rideout; David Porter,4,0,36,32
1657287305334,MATH 18,B03,083750,Rideout; David Porter,2,0,37,35
1657287305334,MATH 18,B04,083751,Rideout; David Porter,6,0,36,30
1657287305334,MATH 18,B05,093473,Rideout; David Porter,5,0,36,31
1657287305334,MATH 18,B06,093474,Rideout; David Porter,5,0,36,31
1657287311358,MATH 20A,A01,083754,Zheng; Zequn,14,0,40,26
1657287317383,MATH 20B,A01,083756,Briones; Jor-el Thomas Caparas,3,0,36,33
1657287317383,MATH 20B,A02,083757,Briones; Jor-el Thomas Caparas,1,0,36,35
1657287317383,MATH 20B,A03,093475,Briones; Jor-el Thomas Caparas,2,0,36,34
1657287323410,MATH 20C,A01,083760,Briones; Jor-el Thomas Caparas,1,0,35,34
1657287323410,MATH 20C,A02,083761,Briones; Jor-el Thomas Caparas,8,0,35,27
1657287323410,MATH 20C,A03,093476,Briones; Jor-el Thomas Caparas,0,1,36,36
1657287323410,MATH 20C,B01,083762,Bach; Quang Tran,1,0,30,29
1657287329441,MATH 20D,A01,083765,Tran; Brian Kha,5,0,30,25
1657287329441,MATH 20D,A02,083766,Tran; Brian Kha,5,0,30,25
1657287329441,MATH 20D,A03,083767,Tran; Brian Kha,4,0,30,26
1657287335468,MATH 20E,A01,083771,Ganguly; Soumya,7,0,32,25
1657287335468,MATH 20E,A02,083772,Ganguly; Soumya,7,0,32,25
1657287335468,MATH 20E,B01,083773,Ciotti; Benjamin,19,0,35,16
1657287335468,MATH 20E,B02,083774,Ciotti; Benjamin,17,0,35,18
1657287341498,MATH 103A,A01,083777,Greenfeld; Be'Eri,3,0,36,33
1657287341498,MATH 103A,A02,083778,Greenfeld; Be'Eri,5,0,36,31
1657287341498,MATH 103A,A03,093561,Greenfeld; Be'Eri,4,0,36,32
1657287341498,MATH 103A,B01,083779,Greenfeld; Be'Eri,6,0,36,30
1657287341498,MATH 103A,B02,083780,Greenfeld; Be'Eri,3,0,36,33
1657287341498,MATH 103A,B03,093562,Greenfeld; Be'Eri,3,0,36,33
1657287347521,MATH 105,A01,085443,Carter; Anne Toulson,15,0,35,20
1657287347521,MATH 105,A02,093477,Carter; Anne Toulson,20,0,35,15
1657287353556,MATH 109,A01,083213,Ganzberger; Geoffrey Michael,2,0,34,32
1657287353556,MATH 109,A02,083214,Ganzberger; Geoffrey Michael,4,0,34,30
1657287353556,MATH 109,A03,093478,Ganzberger; Geoffrey Michael,2,0,34,32
1657287353556,MATH 109,B01,083215,Ganzberger; Geoffrey Michael,1,0,32,31
1657287353556,MATH 109,B02,083216,Ganzberger; Geoffrey Michael,1,0,32,31
1657287353556,MATH 109,B03,093479,Ganzberger; Geoffrey Michael,8,0,32,24
1657287359588,MATH 142A,A01,083219,Chow; Bennett,7,0,32,25
1657287359588,MATH 142A,A02,083220,Chow; Bennett,10,0,32,22
1657287359588,MATH 142A,A03,093480,Chow; Bennett,7,0,32,25
1657287359588,MATH 142A,B03,093481,Chow; Bennett,8,0,32,24
1657287359588,MATH 142A,B04,093558,Chow; Bennett,12,0,32,20
1657287359588,MATH 142A,B05,093559,Chow; Bennett,6,0,32,26
1657287365613,MATH 193A,A01,083224,Rotar; Vladimir,7,0,34,27
1657287365613,MATH 193A,A02,083225,Rotar; Vladimir,6,0,34,28
1657287365613,MATH 193A,A03,083781,Rotar; Vladimir,2,0,34,32
1657287365613,MATH 193A,A04,083782,Rotar; Vladimir,8,0,34,26
1657287365613,MATH 193A,A05,093482,Rotar; Vladimir,6,0,34,28
1657287371644,MATH 197,001,091859,McAuley; Julian John,9999,0,9999,0
1657287371644,MATH 197,002,095566,Kedlaya; Kiran S.,9997,0,9999,2
1657287371644,MATH 197,003,095567,Xiao; Ming,9999,0,9999,0
1657287371644,MATH 197,004,095571,Perols; Johan Lars,9998,0,9999,1
1657287378703,COGS 9,A01,083615,Shannon; Kyle Michael,8,0,75,67
1657287384727,COGS 11,A01,083617,Boyle; Mary E. T.,22,0,48,26
1657287390755,COGS 13,A01,083071,Bastos; Amalia Pinkusfeld,9,0,71,62
1657287396785,COGS 14A,A01,092681,Semenuks; Arturs,2,1,100,98
1657287402809,COGS 14B,A01,083073,Cheng; Tzu-Han,6,0,63,57
1657287408836,COGS 17,A01,092677,Semenuks; Arturs,5,0,81,76
1657287414863,COGS 100,A01,083619,Allen; Michael Gordon,16,0,70,54
1657287420892,COGS 101A,A01,083621,Davis; Joshua Daniel,9,0,68,59
1657287426915,COGS 101B,A01,091572,Allen; Michael Gordon,11,0,65,54
1657287432939,COGS 101C,A01,083625,Delgado; Tania,17,0,35,18
1657287438968,COGS 107A,A01,083627,Boyle; Mary E. T.,13,0,60,47
1657287444992,COGS 118A,A01,083075,Gupta; Anjum,18,0,76,58
1657287451018,CSE 3,A50,083646,Miranda; Gregory Joseph,24,0,50,26
1657287457048,CSE 8A,A50,083650,Miranda; Gregory Joseph,17,1,56,39
1657287463082,CSE 11,A01,083080,Cao; Yingjun,5,15,40,35
1657287469107,CSE 12,A01,083652,Krause-Levy; Sophia Louisa,26,1,120,94
1657287475135,CSE 15L,A01,083654,Morris; Justin Loren,9,0,50,41
1657287475135,CSE 15L,A02,083655,Morris; Justin Loren,9,0,50,41
1657287481162,CSE 20,A01,083657,Tran; Khoa Dang,38,0,80,42
1657287487185,CSE 21,A01,095574,Bach; Quang Tran,22,0,48,26
1657287493211,CSE 30,A01,083084,Eldon; John,4,0,80,76
1657287493211,CSE 30,B01,095061,Bhaskar; Nishant,8,0,50,42
1657287499234,CSE 100,A01,083659,Cao; Yingjun,4,4,70,66
1657287505261,CSE 134B,A01,083661,Powell; Thomas Allan,21,0,100,79
1657287511284,CSE 140,A01,083663,Gungor; Onat,13,0,85,72
1657287517311,CSE 140L,A01,083088,Eldon; John,19,0,100,81
1657287523342,CSE 175,A01,083665,Kumar; Rakesh,3,0,25,22
1657287529365,CSE 190,A00,092507,Dubnov; Shlomo,7,0,20,13
1657287535391,ECE 45,A01,083139,Congero; Spencer William,5,0,75,70
1657287541420,ECE 65,A50,083695,Saad; Andrew S,12,0,30,18
1657287541420,ECE 65,A51,095125,Saad; Andrew S,25,0,26,1
1657287547442,ECE 109,A01,091882,Touri; Behrouz,19,0,70,51
1657287553466,ECE 180,A00,083140,Abi Samra; Nicholas Camill,1,0,30,29
1657287553466,ECE 180,B00,083141,Abi Samra; Nicholas Camill,0,0,30,30
1657287559499,MATH 10A,A01,083735,Patchell; Gregory David,2,0,30,28
1657287559499,MATH 10A,A02,083736,Patchell; Gregory David,20,0,30,10
1657287559499,MATH 10A,A03,083737,Patchell; Gregory David,16,0,30,14
1657287565526,MATH 10B,A01,083207,Lim; Seonhee,7,0,34,27
1657287565526,MATH 10B,A02,083208,Lim; Seonhee,9,0,35,26
1657287565526,MATH 10B,A03,093472,Lim; Seonhee,5,0,34,29
1657287565526,MATH 10B,B01,083739,Sinha; Shubham,11,0,30,19
1657287571560,MATH 18,A01,083743,Cinel; Cameron Alexander,6,0,30,24
1657287571560,MATH 18,A02,083744,Cinel; Cameron Alexander,17,0,30,13
1657287571560,MATH 18,A03,083745,Cinel; Cameron Alexander,8,0,30,22
1657287571560,MATH 18,B01,083748,Rideout; David Porter,4,0,37,33
1657287571560,MATH 18,B02,083749,Rideout; David Porter,4,0,36,32
1657287571560,MATH 18,B03,083750,Rideout; David Porter,2,0,37,35
1657287571560,MATH 18,B04,083751,Rideout; David Porter,6,0,36,30
1657287571560,MATH 18,B05,093473,Rideout; David Porter,5,0,36,31
1657287571560,MATH 18,B06,093474,Rideout; David Porter,5,0,36,31
1657287577585,MATH 20A,A01,083754,Zheng; Zequn,14,0,40,26
1657287583614,MATH 20B,A01,083756,Briones; Jor-el Thomas Caparas,3,0,36,33
1657287583614,MATH 20B,A02,083757,Briones; Jor-el Thomas Caparas,1,0,36,35
1657287583614,MATH 20B,A03,093475,Briones; Jor-el Thomas Caparas,2,0,36,34
1657287589641,MATH 20C,A01,083760,Briones; Jor-el Thomas Caparas,1,0,35,34
1657287589641,MATH 20C,A02,083761,Briones; Jor-el Thomas Caparas,8,0,35,27
1657287589641,MATH 20C,A03,093476,Briones; Jor-el Thomas Caparas,0,1,36,36
1657287589641,MATH 20C,B01,083762,Bach; Quang Tran,1,0,30,29
1657287595664,MATH 20D,A01,083765,Tran; Brian Kha,5,0,30,25
1657287595664,MATH 20D,A02,083766,Tran; Brian Kha,5,0,30,25
1657287595664,MATH 20D,A03,083767,Tran; Brian Kha,4,0,30,26
1657287601702,MATH 20E,A01,083771,Ganguly; Soumya,7,0,32,25
1657287601702,MATH 20E,A02,083772,Ganguly; Soumya,7,0,32,25
1657287601702,MATH 20E,B01,083773,Ciotti; Benjamin,19,0,35,16
1657287601702,MATH 20E,B02,083774,Ciotti; Benjamin,17,0,35,18
1657287607727,MATH 103A,A01,083777,Greenfeld; Be'Eri,3,0,36,33
1657287607727,MATH 103A,A02,083778,Greenfeld; Be'Eri,5,0,36,31
1657287607727,MATH 103A,A03,093561,Greenfeld; Be'Eri,4,0,36,32
1657287607727,MATH 103A,B01,083779,Greenfeld; Be'Eri,6,0,36,30
1657287607727,MATH 103A,B02,083780,Greenfeld; Be'Eri,3,0,36,33
1657287607727,MATH 103A,B03,093562,Greenfeld; Be'Eri,3,0,36,33
1657287613762,MATH 105,A01,085443,Carter; Anne Toulson,15,0,35,20
1657287613762,MATH 105,A02,093477,Carter; Anne Toulson,20,0,35,15
1657287619786,MATH 109,A01,083213,Ganzberger; Geoffrey Michael,2,0,34,32
1657287619786,MATH 109,A02,083214,Ganzberger; Geoffrey Michael,4,0,34,30
1657287619786,MATH 109,A03,093478,Ganzberger; Geoffrey Michael,2,0,34,32
1657287619786,MATH 109,B01,083215,Ganzberger; Geoffrey Michael,1,0,32,31
1657287619786,MATH 109,B02,083216,Ganzberger; Geoffrey Michael,1,0,32,31
1657287619786,MATH 109,B03,093479,Ganzberger; Geoffrey Michael,8,0,32,24
1657287625810,MATH 142A,A01,083219,Chow; Bennett,7,0,32,25
1657287625810,MATH 142A,A02,083220,Chow; Bennett,10,0,32,22
1657287625810,MATH 142A,A03,093480,Chow; Bennett,7,0,32,25
1657287625810,MATH 142A,B03,093481,Chow; Bennett,8,0,32,24
1657287625810,MATH 142A,B04,093558,Chow; Bennett,12,0,32,20
1657287625810,MATH 142A,B05,093559,Chow; Bennett,6,0,32,26
1657287631832,MATH 193A,A01,083224,Rotar; Vladimir,7,0,34,27
1657287631832,MATH 193A,A02,083225,Rotar; Vladimir,6,0,34,28
1657287631832,MATH 193A,A03,083781,Rotar; Vladimir,2,0,34,32
1657287631832,MATH 193A,A04,083782,Rotar; Vladimir,8,0,34,26
1657287631832,MATH 193A,A05,093482,Rotar; Vladimir,6,0,34,28
1657287637863,MATH 197,001,091859,McAuley; Julian John,9999,0,9999,0
1657287637863,MATH 197,002,095566,Kedlaya; Kiran S.,9997,0,9999,2
1657287637863,MATH 197,003,095567,Xiao; Ming,9999,0,9999,0
1657287637863,MATH 197,004,095571,Perols; Johan Lars,9998,0,9999,1
1657287644933,COGS 9,A01,083615,Shannon; Kyle Michael,8,0,75,67
1657287650957,COGS 11,A01,083617,Boyle; Mary E. T.,22,0,48,26
1657287656980,COGS 13,A01,083071,Bastos; Amalia Pinkusfeld,9,0,71,62
1657287663004,COGS 14A,A01,092681,Semenuks; Arturs,2,1,100,98
1657287669030,COGS 14B,A01,083073,Cheng; Tzu-Han,6,0,63,57
1657287675054,COGS 17,A01,092677,Semenuks; Arturs,5,0,81,76
1657287681078,COGS 100,A01,083619,Allen; Michael Gordon,16,0,70,54
1657287687107,COGS 101A,A01,083621,Davis; Joshua Daniel,9,0,68,59
1657287693134,COGS 101B,A01,091572,Allen; Michael Gordon,11,0,65,54
1657287699183,COGS 101C,A01,083625,Delgado; Tania,17,0,35,18
1657287705209,COGS 107A,A01,083627,Boyle; Mary E. T.,13,0,60,47
1657287711234,COGS 118A,A01,083075,Gupta; Anjum,18,0,76,58
1657287717258,CSE 3,A50,083646,Miranda; Gregory Joseph,24,0,50,26
1657287723283,CSE 8A,A50,083650,Miranda; Gregory Joseph,17,1,56,39
1657287729308,CSE 11,A01,083080,Cao; Yingjun,5,15,40,35
1657287735336,CSE 12,A01,083652,Krause-Levy; Sophia Louisa,26,1,120,94
1657287741365,CSE 15L,A01,083654,Morris; Justin Loren,9,0,50,41
1657287741365,CSE 15L,A02,083655,Morris; Justin Loren,9,0,50,41
1657287747389,CSE 20,A01,083657,Tran; Khoa Dang,38,0,80,42
1657287753414,CSE 21,A01,095574,Bach; Quang Tran,22,0,48,26
1657287759439,CSE 30,A01,083084,Eldon; John,4,0,80,76
1657287759439,CSE 30,B01,095061,Bhaskar; Nishant,8,0,50,42
1657287765467,CSE 100,A01,083659,Cao; Yingjun,4,4,70,66
1657287771491,CSE 134B,A01,083661,Powell; Thomas Allan,21,0,100,79
1657287777514,CSE 140,A01,083663,Gungor; Onat,13,0,85,72
1657287783542,CSE 140L,A01,083088,Eldon; John,19,0,100,81
1657287789565,CSE 175,A01,083665,Kumar; Rakesh,3,0,25,22
1657287795591,CSE 190,A00,092507,Dubnov; Shlomo,7,0,20,13
1657287801718,ECE 45,A01,083139,Congero; Spencer William,5,0,75,70
1657287807741,ECE 65,A50,083695,Saad; Andrew S,12,0,30,18
1657287807741,ECE 65,A51,095125,Saad; Andrew S,25,0,26,1
1657287813768,ECE 109,A01,091882,Touri; Behrouz,19,0,70,51
1657287819800,ECE 180,A00,083140,Abi Samra; Nicholas Camill,1,0,30,29
1657287819800,ECE 180,B00,083141,Abi Samra; Nicholas Camill,0,0,30,30
1657287825827,MATH 10A,A01,083735,Patchell; Gregory David,2,0,30,28
1657287825827,MATH 10A,A02,083736,Patchell; Gregory David,20,0,30,10
1657287825827,MATH 10A,A03,083737,Patchell; Gregory David,16,0,30,14
1657287831853,MATH 10B,A01,083207,Lim; Seonhee,7,0,34,27
1657287831853,MATH 10B,A02,083208,Lim; Seonhee,9,0,35,26
1657287831853,MATH 10B,A03,093472,Lim; Seonhee,5,0,34,29
1657287831853,MATH 10B,B01,083739,Sinha; Shubham,11,0,30,19
1657287837883,MATH 18,A01,083743,Cinel; Cameron Alexander,6,0,30,24
1657287837883,MATH 18,A02,083744,Cinel; Cameron Alexander,17,0,30,13
1657287837883,MATH 18,A03,083745,Cinel; Cameron Alexander,8,0,30,22
1657287837883,MATH 18,B01,083748,Rideout; David Porter,4,0,37,33
1657287837883,MATH 18,B02,083749,Rideout; David Porter,4,0,36,32
1657287837883,MATH 18,B03,083750,Rideout; David Porter,2,0,37,35
1657287837883,MATH 18,B04,083751,Rideout; David Porter,6,0,36,30
1657287837883,MATH 18,B05,093473,Rideout; David Porter,5,0,36,31
1657287837883,MATH 18,B06,093474,Rideout; David Porter,5,0,36,31
1657287843909,MATH 20A,A01,083754,Zheng; Zequn,14,0,40,26
1657287849934,MATH 20B,A01,083756,Briones; Jor-el Thomas Caparas,3,0,36,33
1657287849934,MATH 20B,A02,083757,Briones; Jor-el Thomas Caparas,1,0,36,35
1657287849934,MATH 20B,A03,093475,Briones; Jor-el Thomas Caparas,2,0,36,34
1657287855963,MATH 20C,A01,083760,Briones; Jor-el Thomas Caparas,1,0,35,34
1657287855963,MATH 20C,A02,083761,Briones; Jor-el Thomas Caparas,8,0,35,27
1657287855963,MATH 20C,A03,093476,Briones; Jor-el Thomas Caparas,0,1,36,36
1657287855963,MATH 20C,B01,083762,Bach; Quang Tran,1,0,30,29
1657287861992,MATH 20D,A01,083765,Tran; Brian Kha,5,0,30,25
1657287861992,MATH 20D,A02,083766,Tran; Brian Kha,5,0,30,25
1657287861992,MATH 20D,A03,083767,Tran; Brian Kha,4,0,30,26
1657287868024,MATH 20E,A01,083771,Ganguly; Soumya,7,0,32,25
1657287868024,MATH 20E,A02,083772,Ganguly; Soumya,7,0,32,25
1657287868024,MATH 20E,B01,083773,Ciotti; Benjamin,19,0,35,16
1657287868024,MATH 20E,B02,083774,Ciotti; Benjamin,17,0,35,18
1657287874054,MATH 103A,A01,083777,Greenfeld; Be'Eri,3,0,36,33
1657287874054,MATH 103A,A02,083778,Greenfeld; Be'Eri,5,0,36,31
1657287874054,MATH 103A,A03,093561,Greenfeld; Be'Eri,4,0,36,32
1657287874054,MATH 103A,B01,083779,Greenfeld; Be'Eri,6,0,36,30
1657287874054,MATH 103A,B02,083780,Greenfeld; Be'Eri,3,0,36,33
1657287874054,MATH 103A,B03,093562,Greenfeld; Be'Eri,3,0,36,33
1657287880079,MATH 105,A01,085443,Carter; Anne Toulson,15,0,35,20
1657287880079,MATH 105,A02,093477,Carter; Anne Toulson,20,0,35,15
1657287886113,MATH 109,A01,083213,Ganzberger; Geoffrey Michael,2,0,34,32
1657287886113,MATH 109,A02,083214,Ganzberger; Geoffrey Michael,4,0,34,30
1657287886113,MATH 109,A03,093478,Ganzberger; Geoffrey Michael,2,0,34,32
1657287886113,MATH 109,B01,083215,Ganzberger; Geoffrey Michael,1,0,32,31
1657287886113,MATH 109,B02,083216,Ganzberger; Geoffrey Michael,1,0,32,31
1657287886113,MATH 109,B03,093479,Ganzberger; Geoffrey Michael,8,0,32,24
1657287892140,MATH 142A,A01,083219,Chow; Bennett,7,0,32,25
1657287892140,MATH 142A,A02,083220,Chow; Bennett,10,0,32,22
1657287892140,MATH 142A,A03,093480,Chow; Bennett,7,0,32,25
1657287892140,MATH 142A,B03,093481,Chow; Bennett,8,0,32,24
1657287892140,MATH 142A,B04,093558,Chow; Bennett,12,0,32,20
1657287892140,MATH 142A,B05,093559,Chow; Bennett,6,0,32,26
1657287898165,MATH 193A,A01,083224,Rotar; Vladimir,7,0,34,27
1657287898165,MATH 193A,A02,083225,Rotar; Vladimir,6,0,34,28
1657287898165,MATH 193A,A03,083781,Rotar; Vladimir,2,0,34,32
1657287898165,MATH 193A,A04,083782,Rotar; Vladimir,8,0,34,26
1657287898165,MATH 193A,A05,093482,Rotar; Vladimir,6,0,34,28
1657287904189,MATH 197,001,091859,McAuley; Julian John,9999,0,9999,0
1657287904189,MATH 197,002,095566,Kedlaya; Kiran S.,9997,0,9999,2
1657287904189,MATH 197,003,095567,Xiao; Ming,9999,0,9999,0
1657287904189,MATH 197,004,095571,Perols; Johan Lars,9998,0,9999,1
1657287911253,COGS 9,A01,083615,Shannon; Kyle Michael,8,0,75,67
1657287917286,COGS 11,A01,083617,Boyle; Mary E. T.,22,0,48,26
1657287923320,COGS 13,A01,083071,Bastos; Amalia Pinkusfeld,9,0,71,62
1657287929347,COGS 14A,A01,092681,Semenuks; Arturs,2,1,100,98
1657287935383,COGS 14B,A01,083073,Cheng; Tzu-Han,6,0,63,57
1657287941410,COGS 17,A01,092677,Semenuks; Arturs,5,0,81,76
1657287947440,COGS 100,A01,083619,Allen; Michael Gordon,16,0,70,54
1657287953469,COGS 101A,A01,083621,Davis; Joshua Daniel,9,0,68,59
1657287959500,COGS 101B,A01,091572,Allen; Michael Gordon,11,0,65,54
1657287965523,COGS 101C,A01,083625,Delgado; Tania,17,0,35,18
1657287971548,COGS 107A,A01,083627,Boyle; Mary E. T.,13,0,60,47
1657287977572,COGS 118A,A01,083075,Gupta; Anjum,18,0,76,58
1657287983601,CSE 3,A50,083646,Miranda; Gregory Joseph,24,0,50,26
1657287989626,CSE 8A,A50,083650,Miranda; Gregory Joseph,17,1,56,39
1657287995648,CSE 11,A01,083080,Cao; Yingjun,5,15,40,35
1657288001671,CSE 12,A01,083652,Krause-Levy; Sophia Louisa,26,1,120,94
1657288007713,CSE 15L,A01,083654,Morris; Justin Loren,9,0,50,41
1657288007713,CSE 15L,A02,083655,Morris; Justin Loren,9,0,50,41
1657288013740,CSE 20,A01,083657,Tran; Khoa Dang,38,0,80,42
1657288019769,CSE 21,A01,095574,Bach; Quang Tran,22,0,48,26
1657288025797,CSE 30,A01,083084,Eldon; John,4,0,80,76
1657288025797,CSE 30,B01,095061,Bhaskar; Nishant,8,0,50,42
1657288031830,CSE 100,A01,083659,Cao; Yingjun,4,4,70,66
1657288037856,CSE 134B,A01,083661,Powell; Thomas Allan,21,0,100,79
1657288043882,CSE 140,A01,083663,Gungor; Onat,13,0,85,72
1657288049907,CSE 140L,A01,083088,Eldon; John,19,0,100,81
1657288055930,CSE 175,A01,083665,Kumar; Rakesh,3,0,25,22
1657288061959,CSE 190,A00,092507,Dubnov; Shlomo,7,0,20,13
1657288067982,ECE 45,A01,083139,Congero; Spencer William,5,0,75,70
1657288074011,ECE 65,A50,083695,Saad; Andrew S,12,0,30,18
1657288074011,ECE 65,A51,095125,Saad; Andrew S,25,0,26,1
1657288080040,ECE 109,A01,091882,Touri; Behrouz,19,0,70,51
1657288086069,ECE 180,A00,083140,Abi Samra; Nicholas Camill,1,0,30,29
1657288086069,ECE 180,B00,083141,Abi Samra; Nicholas Camill,0,0,30,30
1657288092092,MATH 10A,A01,083735,Patchell; Gregory David,2,0,30,28
1657288092092,MATH 10A,A02,083736,Patchell; Gregory David,20,0,30,10
1657288092092,MATH 10A,A03,083737,Patchell; Gregory David,16,0,30,14
1657288098116,MATH 10B,A01,083207,Lim; Seonhee,7,0,34,27
1657288098116,MATH 10B,A02,083208,Lim; Seonhee,9,0,35,26
1657288098116,MATH 10B,A03,093472,Lim; Seonhee,5,0,34,29
1657288098116,MATH 10B,B01,083739,Sinha; Shubham,11,0,30,19
1657288104141,MATH 18,A01,083743,Cinel; Cameron Alexander,6,0,30,24
1657288104141,MATH 18,A02,083744,Cinel; Cameron Alexander,17,0,30,13
1657288104141,MATH 18,A03,083745,Cinel; Cameron Alexander,8,0,30,22
1657288104141,MATH 18,B01,083748,Rideout; David Porter,4,0,37,33
1657288104141,MATH 18,B02,083749,Rideout; David Porter,4,0,36,32
1657288104141,MATH 18,B03,083750,Rideout; David Porter,2,0,37,35
1657288104141,MATH 18,B04,083751,Rideout; David Porter,6,0,36,30
1657288104141,MATH 18,B05,093473,Rideout; David Porter,5,0,36,31
1657288104141,MATH 18,B06,093474,Rideout; David Porter,5,0,36,31
1657288110166,MATH 20A,A01,083754,Zheng; Zequn,14,0,40,26
1657288116189,MATH 20B,A01,083756,Briones; Jor-el Thomas Caparas,3,0,36,33
1657288116189,MATH 20B,A02,083757,Briones; Jor-el Thomas Caparas,1,0,36,35
1657288116189,MATH 20B,A03,093475,Briones; Jor-el Thomas Caparas,2,0,36,34
1657288122219,MATH 20C,A01,083760,Briones; Jor-el Thomas Caparas,1,0,35,34
1657288122219,MATH 20C,A02,083761,Briones; Jor-el Thomas Caparas,8,0,35,27
1657288122219,MATH 20C,A03,093476,Briones; Jor-el Thomas Caparas,0,1,36,36
1657288122219,MATH 20C,B01,083762,Bach; Quang Tran,1,0,30,29
1657288128250,MATH 20D,A01,083765,Tran; Brian Kha,5,0,30,25
1657288128250,MATH 20D,A02,083766,Tran; Brian Kha,5,0,30,25
1657288128250,MATH 20D,A03,083767,Tran; Brian Kha,4,0,30,26
1657288134280,MATH 20E,A01,083771,Ganguly; Soumya,7,0,32,25
1657288134280,MATH 20E,A02,083772,Ganguly; Soumya,7,0,32,25
1657288134280,MATH 20E,B01,083773,Ciotti; Benjamin,19,0,35,16
1657288134280,MATH 20E,B02,083774,Ciotti; Benjamin,17,0,35,18
1657288140306,MATH 103A,A01,083777,Greenfeld; Be'Eri,3,0,36,33
1657288140306,MATH 103A,A02,083778,Greenfeld; Be'Eri,5,0,36,31
1657288140306,MATH 103A,A03,093561,Greenfeld; Be'Eri,4,0,36,32
1657288140306,MATH 103A,B01,083779,Greenfeld; Be'Eri,6,0,36,30
1657288140306,MATH 103A,B02,083780,Greenfeld; Be'Eri,3,0,36,33
1657288140306,MATH 103A,B03,093562,Greenfeld; Be'Eri,3,0,36,33
1657288146331,MATH 105,A01,085443,Carter; Anne Toulson,15,0,35,20
1657288146331,MATH 105,A02,093477,Carter; Anne Toulson,20,0,35,15
1657288152364,MATH 109,A01,083213,Ganzberger; Geoffrey Michael,2,0,34,32
1657288152364,MATH 109,A02,083214,Ganzberger; Geoffrey Michael,4,0,34,30
1657288152364,MATH 109,A03,093478,Ganzberger; Geoffrey Michael,2,0,34,32
1657288152364,MATH 109,B01,083215,Ganzberger; Geoffrey Michael,1,0,32,31
1657288152364,MATH 109,B02,083216,Ganzberger; Geoffrey Michael,1,0,32,31
1657288152364,MATH 109,B03,093479,Ganzberger; Geoffrey Michael,8,0,32,24
1657288158405,MATH 142A,A01,083219,Chow; Bennett,7,0,32,25
1657288158405,MATH 142A,A02,083220,Chow; Bennett,10,0,32,22
1657288158405,MATH 142A,A03,093480,Chow; Bennett,7,0,32,25
1657288158405,MATH 142A,B03,093481,Chow; Bennett,8,0,32,24
1657288158405,MATH 142A,B04,093558,Chow; Bennett,12,0,32,20
1657288158405,MATH 142A,B05,093559,Chow; Bennett,6,0,32,26
1657288164444,MATH 193A,A01,083224,Rotar; Vladimir,7,0,34,27
1657288164444,MATH 193A,A02,083225,Rotar; Vladimir,6,0,34,28
1657288164444,MATH 193A,A03,083781,Rotar; Vladimir,2,0,34,32
1657288164444,MATH 193A,A04,083782,Rotar; Vladimir,8,0,34,26
1657288164444,MATH 193A,A05,093482,Rotar; Vladimir,6,0,34,28
1657288170472,MATH 197,001,091859,McAuley; Julian John,9999,0,9999,0
1657288170472,MATH 197,002,095566,Kedlaya; Kiran S.,9997,0,9999,2
1657288170472,MATH 197,003,095567,Xiao; Ming,9999,0,9999,0
1657288170472,MATH 197,004,095571,Perols; Johan Lars,9998,0,9999,1
1657288177542,COGS 9,A01,083615,Shannon; Kyle Michael,8,0,75,67
1657288183570,COGS 11,A01,083617,Boyle; Mary E. T.,22,0,48,26
1657288189596,COGS 13,A01,083071,Bastos; Amalia Pinkusfeld,9,0,71,62
1657288195622,COGS 14A,A01,092681,Semenuks; Arturs,2,1,100,98
1657288201663,COGS 14B,A01,083073,Cheng; Tzu-Han,6,0,63,57
1657288207686,COGS 17,A01,092677,Semenuks; Arturs,5,0,81,76
1657288213719,COGS 100,A01,083619,Allen; Michael Gordon,16,0,70,54
1657288219741,COGS 101A,A01,083621,Davis; Joshua Daniel,9,0,68,59
1657288225856,COGS 101B,A01,091572,Allen; Michael Gordon,11,0,65,54
1657288231890,COGS 101C,A01,083625,Delgado; Tania,17,0,35,18
1657288237921,COGS 107A,A01,083627,Boyle; Mary E. T.,13,0,60,47
1657288243954,COGS 118A,A01,083075,Gupta; Anjum,18,0,76,58
1657288249980,CSE 3,A50,083646,Miranda; Gregory Joseph,24,0,50,26
1657288256006,CSE 8A,A50,083650,Miranda; Gregory Joseph,17,1,56,39
1657288262036,CSE 11,A01,083080,Cao; Yingjun,5,15,40,35
1657288268067,CSE 12,A01,083652,Krause-Levy; Sophia Louisa,26,1,120,94
1657288274096,CSE 15L,A01,083654,Morris; Justin Loren,9,0,50,41
1657288274096,CSE 15L,A02,083655,Morris; Justin Loren,9,0,50,41
1657288280128,CSE 20,A01,083657,Tran; Khoa Dang,38,0,80,42
1657288286151,CSE 21,A01,095574,Bach; Quang Tran,22,0,48,26
1657288292175,CSE 30,A01,083084,Eldon; John,4,0,80,76
1657288292175,CSE 30,B01,095061,Bhaskar; Nishant,8,0,50,42
1657288298202,CSE 100,A01,083659,Cao; Yingjun,4,4,70,66
1657288304227,CSE 134B,A01,083661,Powell; Thomas Allan,21,0,100,79
1657288310249,CSE 140,A01,083663,Gungor; Onat,13,0,85,72
1657288316275,CSE 140L,A01,083088,Eldon; John,19,0,100,81
1657288322300,CSE 175,A01,083665,Kumar; Rakesh,3,0,25,22
1657288328324,CSE 190,A00,092507,Dubnov; Shlomo,7,0,20,13
1657288334349,ECE 45,A01,083139,Congero; Spencer William,5,0,75,70
1657288340373,ECE 65,A50,083695,Saad; Andrew S,12,0,30,18
1657288340373,ECE 65,A51,095125,Saad; Andrew S,25,0,26,1
1657288346415,ECE 109,A01,091882,Touri; Behrouz,19,0,70,51
1657288352441,ECE 180,A00,083140,Abi Samra; Nicholas Camill,1,0,30,29
1657288352441,ECE 180,B00,083141,Abi Samra; Nicholas Camill,0,0,30,30
1657288358466,MATH 10A,A01,083735,Patchell; Gregory David,2,0,30,28
1657288358466,MATH 10A,A02,083736,Patchell; Gregory David,20,0,30,10
1657288358466,MATH 10A,A03,083737,Patchell; Gregory David,16,0,30,14
1657288364493,MATH 10B,A01,083207,Lim; Seonhee,7,0,34,27
1657288364493,MATH 10B,A02,083208,Lim; Seonhee,9,0,35,26
1657288364493,MATH 10B,A03,093472,Lim; Seonhee,5,0,34,29
1657288364493,MATH 10B,B01,083739,Sinha; Shubham,11,0,30,19
1657288370526,MATH 18,A01,083743,Cinel; Cameron Alexander,6,0,30,24
1657288370526,MATH 18,A02,083744,Cinel; Cameron Alexander,17,0,30,13
1657288370526,MATH 18,A03,083745,Cinel; Cameron Alexander,8,0,30,22
1657288370526,MATH 18,B01,083748,Rideout; David Porter,4,0,37,33
1657288370526,MATH 18,B02,083749,Rideout; David Porter,4,0,36,32
1657288370526,MATH 18,B03,083750,Rideout; David Porter,2,0,37,35
1657288370526,MATH 18,B04,083751,Rideout; David Porter,6,0,36,30
1657288370526,MATH 18,B05,093473,Rideout; David Porter,5,0,36,31
1657288370526,MATH 18,B06,093474,Rideout; David Porter,5,0,36,31
1657288376549,MATH 20A,A01,083754,Zheng; Zequn,14,0,40,26
1657288382574,MATH 20B,A01,083756,Briones; Jor-el Thomas Caparas,3,0,36,33
1657288382574,MATH 20B,A02,083757,Briones; Jor-el Thomas Caparas,1,0,36,35
1657288382574,MATH 20B,A03,093475,Briones; Jor-el Thomas Caparas,2,0,36,34
1657288388605,MATH 20C,A01,083760,Briones; Jor-el Thomas Caparas,1,0,35,34
1657288388605,MATH 20C,A02,083761,Briones; Jor-el Thomas Caparas,8,0,35,27
1657288388605,MATH 20C,A03,093476,Briones; Jor-el Thomas Caparas,0,1,36,36
1657288388605,MATH 20C,B01,083762,Bach; Quang Tran,1,0,30,29
1657288394634,MATH 20D,A01,083765,Tran; Brian Kha,5,0,30,25
1657288394634,MATH 20D,A02,083766,Tran; Brian Kha,5,0,30,25
1657288394634,MATH 20D,A03,083767,Tran; Brian Kha,4,0,30,26
1657288400738,MATH 20E,A01,083771,Ganguly; Soumya,7,0,32,25
1657288400738,MATH 20E,A02,083772,Ganguly; Soumya,7,0,32,25
1657288400738,MATH 20E,B01,083773,Ciotti; Benjamin,19,0,35,16
1657288400738,MATH 20E,B02,083774,Ciotti; Benjamin,17,0,35,18
1657288406763,MATH 103A,A01,083777,Greenfeld; Be'Eri,3,0,36,33
1657288406763,MATH 103A,A02,083778,Greenfeld; Be'Eri,5,0,36,31
1657288406763,MATH 103A,A03,093561,Greenfeld; Be'Eri,4,0,36,32
1657288406763,MATH 103A,B01,083779,Greenfeld; Be'Eri,6,0,36,30
1657288406763,MATH 103A,B02,083780,Greenfeld; Be'Eri,3,0,36,33
1657288406763,MATH 103A,B03,093562,Greenfeld; Be'Eri,3,0,36,33
1657288412789,MATH 105,A01,085443,Carter; Anne Toulson,15,0,35,20
1657288412789,MATH 105,A02,093477,Carter; Anne Toulson,20,0,35,15
1657288418814,MATH 109,A01,083213,Ganzberger; Geoffrey Michael,2,0,34,32
1657288418814,MATH 109,A02,083214,Ganzberger; Geoffrey Michael,4,0,34,30
1657288418814,MATH 109,A03,093478,Ganzberger; Geoffrey Michael,2,0,34,32
1657288418814,MATH 109,B01,083215,Ganzberger; Geoffrey Michael,1,0,32,31
1657288418814,MATH 109,B02,083216,Ganzberger; Geoffrey Michael,1,0,32,31
1657288418814,MATH 109,B03,093479,Ganzberger; Geoffrey Michael,8,0,32,24
1657288424837,MATH 142A,A01,083219,Chow; Bennett,7,0,32,25
1657288424837,MATH 142A,A02,083220,Chow; Bennett,10,0,32,22
1657288424837,MATH 142A,A03,093480,Chow; Bennett,7,0,32,25
1657288424837,MATH 142A,B03,093481,Chow; Bennett,8,0,32,24
1657288424837,MATH 142A,B04,093558,Chow; Bennett,12,0,32,20
1657288424837,MATH 142A,B05,093559,Chow; Bennett,6,0,32,26
1657288430862,MATH 193A,A01,083224,Rotar; Vladimir,7,0,34,27
1657288430862,MATH 193A,A02,083225,Rotar; Vladimir,6,0,34,28
1657288430862,MATH 193A,A03,083781,Rotar; Vladimir,2,0,34,32
1657288430862,MATH 193A,A04,083782,Rotar; Vladimir,8,0,34,26
1657288430862,MATH 193A,A05,093482,Rotar; Vladimir,6,0,34,28
1657288436889,MATH 197,001,091859,McAuley; Julian John,9999,0,9999,0
1657288436889,MATH 197,002,095566,Kedlaya; Kiran S.,9997,0,9999,2
1657288436889,MATH 197,003,095567,Xiao; Ming,9999,0,9999,0
1657288436889,MATH 197,004,095571,Perols; Johan Lars,9998,0,9999,1
1657288443955,COGS 9,A01,083615,Shannon; Kyle Michael,8,0,75,67
1657288449983,COGS 11,A01,083617,Boyle; Mary E. T.,22,0,48,26
1657288456009,COGS 13,A01,083071,Bastos; Amalia Pinkusfeld,9,0,71,62
1657288462037,COGS 14A,A01,092681,Semenuks; Arturs,2,1,100,98
1657288468061,COGS 14B,A01,083073,Cheng; Tzu-Han,6,0,63,57
1657288474085,COGS 17,A01,092677,Semenuks; Arturs,5,0,81,76
1657288480114,COGS 100,A01,083619,Allen; Michael Gordon,16,0,70,54
1657288486138,COGS 101A,A01,083621,Davis; Joshua Daniel,9,0,68,59
1657288492160,COGS 101B,A01,091572,Allen; Michael Gordon,11,0,65,54
1657288498188,COGS 101C,A01,083625,Delgado; Tania,17,0,35,18
1657288504211,COGS 107A,A01,083627,Boyle; Mary E. T.,13,0,60,47
1657288510239,COGS 118A,A01,083075,Gupta; Anjum,18,0,76,58
1657288516273,CSE 3,A50,083646,Miranda; Gregory Joseph,24,0,50,26
1657288522314,CSE 8A,A50,083650,Miranda; Gregory Joseph,17,1,56,39
1657288528339,CSE 11,A01,083080,Cao; Yingjun,5,15,40,35
1657288534366,CSE 12,A01,083652,Krause-Levy; Sophia Louisa,26,1,120,94
1657288540391,CSE 15L,A01,083654,Morris; Justin Loren,9,0,50,41
1657288540391,CSE 15L,A02,083655,Morris; Justin Loren,9,0,50,41
1657288546419,CSE 20,A01,083657,Tran; Khoa Dang,38,0,80,42
1657288552441,CSE 21,A01,095574,Bach; Quang Tran,22,0,48,26
1657288558466,CSE 30,A01,083084,Eldon; John,4,0,80,76
1657288558466,CSE 30,B01,095061,Bhaskar; Nishant,8,0,50,42
1657288564492,CSE 100,A01,083659,Cao; Yingjun,4,4,70,66
1657288570519,CSE 134B,A01,083661,Powell; Thomas Allan,21,0,100,79
1657288576543,CSE 140,A01,083663,Gungor; Onat,13,0,85,72
1657288582567,CSE 140L,A01,083088,Eldon; John,19,0,100,81
1657288588591,CSE 175,A01,083665,Kumar; Rakesh,3,0,25,22
1657288594617,CSE 190,A00,092507,Dubnov; Shlomo,7,0,20,13
1657288600653,ECE 45,A01,083139,Congero; Spencer William,5,0,75,70
1657288606677,ECE 65,A50,083695,Saad; Andrew S,12,0,30,18
1657288606677,ECE 65,A51,095125,Saad; Andrew S,25,0,26,1
1657288612700,ECE 109,A01,091882,Touri; Behrouz,19,0,70,51
1657288618729,ECE 180,A00,083140,Abi Samra; Nicholas Camill,1,0,30,29
1657288618729,ECE 180,B00,083141,Abi Samra; Nicholas Camill,0,0,30,30
1657288624752,MATH 10A,A01,083735,Patchell; Gregory David,2,0,30,28
1657288624752,MATH 10A,A02,083736,Patchell; Gregory David,20,0,30,10
1657288624752,MATH 10A,A03,083737,Patchell; Gregory David,16,0,30,14
1657288630781,MATH 10B,A01,083207,Lim; Seonhee,7,0,34,27
1657288630781,MATH 10B,A02,083208,Lim; Seonhee,9,0,35,26
1657288630781,MATH 10B,A03,093472,Lim; Seonhee,5,0,34,29
1657288630781,MATH 10B,B01,083739,Sinha; Shubham,11,0,30,19
1657288636805,MATH 18,A01,083743,Cinel; Cameron Alexander,6,0,30,24
1657288636805,MATH 18,A02,083744,Cinel; Cameron Alexander,17,0,30,13
1657288636805,MATH 18,A03,083745,Cinel; Cameron Alexander,8,0,30,22
1657288636805,MATH 18,B01,083748,Rideout; David Porter,4,0,37,33
1657288636805,MATH 18,B02,083749,Rideout; David Porter,4,0,36,32
1657288636805,MATH 18,B03,083750,Rideout; David Porter,2,0,37,35
1657288636805,MATH 18,B04,083751,Rideout; David Porter,6,0,36,30
1657288636805,MATH 18,B05,093473,Rideout; David Porter,5,0,36,31
1657288636805,MATH 18,B06,093474,Rideout; David Porter,5,0,36,31
1657288642829,MATH 20A,A01,083754,Zheng; Zequn,14,0,40,26
1657288648860,MATH 20B,A01,083756,Briones; Jor-el Thomas Caparas,3,0,36,33
1657288648860,MATH 20B,A02,083757,Briones; Jor-el Thomas Caparas,1,0,36,35
1657288648860,MATH 20B,A03,093475,Briones; Jor-el Thomas Caparas,2,0,36,34
1657288654889,MATH 20C,A01,083760,Briones; Jor-el Thomas Caparas,1,0,35,34
1657288654889,MATH 20C,A02,083761,Briones; Jor-el Thomas Caparas,8,0,35,27
1657288654889,MATH 20C,A03,093476,Briones; Jor-el Thomas Caparas,0,1,36,36
1657288654889,MATH 20C,B01,083762,Bach; Quang Tran,1,0,30,29
1657288660911,MATH 20D,A01,083765,Tran; Brian Kha,5,0,30,25
1657288660911,MATH 20D,A02,083766,Tran; Brian Kha,5,0,30,25
1657288660911,MATH 20D,A03,083767,Tran; Brian Kha,4,0,30,26
1657288666941,MATH 20E,A01,083771,Ganguly; Soumya,7,0,32,25
1657288666941,MATH 20E,A02,083772,Ganguly; Soumya,7,0,32,25
1657288666941,MATH 20E,B01,083773,Ciotti; Benjamin,19,0,35,16
1657288666941,MATH 20E,B02,083774,Ciotti; Benjamin,17,0,35,18
1657288672971,MATH 103A,A01,083777,Greenfeld; Be'Eri,3,0,36,33
1657288672971,MATH 103A,A02,083778,Greenfeld; Be'Eri,5,0,36,31
1657288672971,MATH 103A,A03,093561,Greenfeld; Be'Eri,4,0,36,32
1657288672971,MATH 103A,B01,083779,Greenfeld; Be'Eri,6,0,36,30
1657288672971,MATH 103A,B02,083780,Greenfeld; Be'Eri,3,0,36,33
1657288672971,MATH 103A,B03,093562,Greenfeld; Be'Eri,3,0,36,33
1657288679010,MATH 105,A01,085443,Carter; Anne Toulson,15,0,35,20
1657288679010,MATH 105,A02,093477,Carter; Anne Toulson,20,0,35,15
1657288685034,MATH 109,A01,083213,Ganzberger; Geoffrey Michael,2,0,34,32
1657288685034,MATH 109,A02,083214,Ganzberger; Geoffrey Michael,4,0,34,30
1657288685034,MATH 109,A03,093478,Ganzberger; Geoffrey Michael,2,0,34,32
1657288685034,MATH 109,B01,083215,Ganzberger; Geoffrey Michael,1,0,32,31
1657288685034,MATH 109,B02,083216,Ganzberger; Geoffrey Michael,1,0,32,31
1657288685034,MATH 109,B03,093479,Ganzberger; Geoffrey Michael,8,0,32,24
1657288691074,MATH 142A,A01,083219,Chow; Bennett,7,0,32,25
1657288691074,MATH 142A,A02,083220,Chow; Bennett,10,0,32,22
1657288691074,MATH 142A,A03,093480,Chow; Bennett,7,0,32,25
1657288691074,MATH 142A,B03,093481,Chow; Bennett,8,0,32,24
1657288691074,MATH 142A,B04,093558,Chow; Bennett,12,0,32,20
1657288691074,MATH 142A,B05,093559,Chow; Bennett,6,0,32,26
1657288697101,MATH 193A,A01,083224,Rotar; Vladimir,7,0,34,27
1657288697101,MATH 193A,A02,083225,Rotar; Vladimir,6,0,34,28
1657288697101,MATH 193A,A03,083781,Rotar; Vladimir,2,0,34,32
1657288697101,MATH 193A,A04,083782,Rotar; Vladimir,8,0,34,26
1657288697101,MATH 193A,A05,093482,Rotar; Vladimir,6,0,34,28
1657288703136,MATH 197,001,091859,McAuley; Julian John,9999,0,9999,0
1657288703136,MATH 197,002,095566,Kedlaya; Kiran S.,9997,0,9999,2
1657288703136,MATH 197,003,095567,Xiao; Ming,9999,0,9999,0
1657288703136,MATH 197,004,095571,Perols; Johan Lars,9998,0,9999,1
1657288710195,COGS 9,A01,083615,Shannon; Kyle Michael,8,0,75,67
1657288716224,COGS 11,A01,083617,Boyle; Mary E. T.,22,0,48,26
1657288722247,COGS 13,A01,083071,Bastos; Amalia Pinkusfeld,9,0,71,62
1657288728274,COGS 14A,A01,092681,Semenuks; Arturs,2,1,100,98
1657288734297,COGS 14B,A01,083073,Cheng; Tzu-Han,6,0,63,57
1657288740327,COGS 17,A01,092677,Semenuks; Arturs,5,0,81,76
1657288746355,COGS 100,A01,083619,Allen; Michael Gordon,16,0,70,54
1657288752383,COGS 101A,A01,083621,Davis; Joshua Daniel,9,0,68,59
1657288758410,COGS 101B,A01,091572,Allen; Michael Gordon,11,0,65,54
1657288764433,COGS 101C,A01,083625,Delgado; Tania,17,0,35,18
1657288770457,COGS 107A,A01,083627,Boyle; Mary E. T.,13,0,60,47
1657288776495,COGS 118A,A01,083075,Gupta; Anjum,18,0,76,58
1657288782532,CSE 3,A50,083646,Miranda; Gregory Joseph,24,0,50,26
1657288788557,CSE 8A,A50,083650,Miranda; Gregory Joseph,17,1,56,39
1657288794581,CSE 11,A01,083080,Cao; Yingjun,5,15,40,35
1657288800608,CSE 12,A01,083652,Krause-Levy; Sophia Louisa,26,1,120,94
1657288806632,CSE 15L,A01,083654,Morris; Justin Loren,9,0,50,41
1657288806632,CSE 15L,A02,083655,Morris; Justin Loren,9,0,50,41
1657288812660,CSE 20,A01,083657,Tran; Khoa Dang,38,0,80,42
1657288818697,CSE 21,A01,095574,Bach; Quang Tran,22,0,48,26
1657288824725,CSE 30,A01,083084,Eldon; John,4,0,80,76
1657288824725,CSE 30,B01,095061,Bhaskar; Nishant,8,0,50,42
1657288830756,CSE 100,A01,083659,Cao; Yingjun,4,4,70,66
1657288836782,CSE 134B,A01,083661,Powell; Thomas Allan,21,0,100,79
1657288842808,CSE 140,A01,083663,Gungor; Onat,13,0,85,72
1657288848834,CSE 140L,A01,083088,Eldon; John,19,0,100,81
1657288854857,CSE 175,A01,083665,Kumar; Rakesh,3,0,25,22
1657288860890,CSE 190,A00,092507,Dubnov; Shlomo,7,0,20,13
1657288866915,ECE 45,A01,083139,Congero; Spencer William,5,0,75,70
1657288872946,ECE 65,A50,083695,Saad; Andrew S,12,0,30,18
1657288872946,ECE 65,A51,095125,Saad; Andrew S,25,0,26,1
1657288878975,ECE 109,A01,091882,Touri; Behrouz,19,0,70,51
1657288885005,ECE 180,A00,083140,Abi Samra; Nicholas Camill,1,0,30,29
1657288885005,ECE 180,B00,083141,Abi Samra; Nicholas Camill,0,0,30,30
1657288891030,MATH 10A,A01,083735,Patchell; Gregory David,2,0,30,28
1657288891030,MATH 10A,A02,083736,Patchell; Gregory David,20,0,30,10
1657288891030,MATH 10A,A03,083737,Patchell; Gregory David,16,0,30,14
1657288897059,MATH 10B,A01,083207,Lim; Seonhee,7,0,34,27
1657288897059,MATH 10B,A02,083208,Lim; Seonhee,9,0,35,26
1657288897059,MATH 10B,A03,093472,Lim; Seonhee,5,0,34,29
1657288897059,MATH 10B,B01,083739,Sinha; Shubham,11,0,30,19
1657288903097,MATH 18,A01,083743,Cinel; Cameron Alexander,6,0,30,24
1657288903097,MATH 18,A02,083744,Cinel; Cameron Alexander,17,0,30,13
1657288903097,MATH 18,A03,083745,Cinel; Cameron Alexander,8,0,30,22
1657288903097,MATH 18,B01,083748,Rideout; David Porter,4,0,37,33
1657288903097,MATH 18,B02,083749,Rideout; David Porter,4,0,36,32
1657288903097,MATH 18,B03,083750,Rideout; David Porter,2,0,37,35
1657288903097,MATH 18,B04,083751,Rideout; David Porter,6,0,36,30
1657288903097,MATH 18,B05,093473,Rideout; David Porter,5,0,36,31
1657288903097,MATH 18,B06,093474,Rideout; David Porter,5,0,36,31
1657288909128,MATH 20A,A01,083754,Zheng; Zequn,14,0,40,26
1657288915164,MATH 20B,A01,083756,Briones; Jor-el Thomas Caparas,3,0,36,33
1657288915164,MATH 20B,A02,083757,Briones; Jor-el Thomas Caparas,1,0,36,35
1657288915164,MATH 20B,A03,093475,Briones; Jor-el Thomas Caparas,2,0,36,34
1657288921190,MATH 20C,A01,083760,Briones; Jor-el Thomas Caparas,1,0,35,34
1657288921190,MATH 20C,A02,083761,Briones; Jor-el Thomas Caparas,8,0,35,27
1657288921190,MATH 20C,A03,093476,Briones; Jor-el Thomas Caparas,0,1,36,36
1657288921190,MATH 20C,B01,083762,Bach; Quang Tran,1,0,30,29
1657288927218,MATH 20D,A01,083765,Tran; Brian Kha,5,0,30,25
1657288927218,MATH 20D,A02,083766,Tran; Brian Kha,5,0,30,25
1657288927218,MATH 20D,A03,083767,Tran; Brian Kha,4,0,30,26
1657288933245,MATH 20E,A01,083771,Ganguly; Soumya,7,0,32,25
1657288933245,MATH 20E,A02,083772,Ganguly; Soumya,7,0,32,25
1657288933245,MATH 20E,B01,083773,Ciotti; Benjamin,19,0,35,16
1657288933245,MATH 20E,B02,083774,Ciotti; Benjamin,17,0,35,18
1657288939277,MATH 103A,A01,083777,Greenfeld; Be'Eri,3,0,36,33
1657288939277,MATH 103A,A02,083778,Greenfeld; Be'Eri,5,0,36,31
1657288939277,MATH 103A,A03,093561,Greenfeld; Be'Eri,4,0,36,32
1657288939277,MATH 103A,B01,083779,Greenfeld; Be'Eri,6,0,36,30
1657288939277,MATH 103A,B02,083780,Greenfeld; Be'Eri,3,0,36,33
1657288939277,MATH 103A,B03,093562,Greenfeld; Be'Eri,3,0,36,33
1657288945308,MATH 105,A01,085443,Carter; Anne Toulson,15,0,35,20
1657288945308,MATH 105,A02,093477,Carter; Anne Toulson,20,0,35,15
1657288951342,MATH 109,A01,083213,Ganzberger; Geoffrey Michael,2,0,34,32
1657288951342,MATH 109,A02,083214,Ganzberger; Geoffrey Michael,4,0,34,30
1657288951342,MATH 109,A03,093478,Ganzberger; Geoffrey Michael,2,0,34,32
1657288951342,MATH 109,B01,083215,Ganzberger; Geoffrey Michael,1,0,32,31
1657288951342,MATH 109,B02,083216,Ganzberger; Geoffrey Michael,1,0,32,31
1657288951342,MATH 109,B03,093479,Ganzberger; Geoffrey Michael,8,0,32,24
1657288957370,MATH 142A,A01,083219,Chow; Bennett,7,0,32,25
1657288957370,MATH 142A,A02,083220,Chow; Bennett,10,0,32,22
1657288957370,MATH 142A,A03,093480,Chow; Bennett,7,0,32,25
1657288957370,MATH 142A,B03,093481,Chow; Bennett,8,0,32,24
1657288957370,MATH 142A,B04,093558,Chow; Bennett,12,0,32,20
1657288957370,MATH 142A,B05,093559,Chow; Bennett,6,0,32,26
1657288963397,MATH 193A,A01,083224,Rotar; Vladimir,7,0,34,27
1657288963397,MATH 193A,A02,083225,Rotar; Vladimir,6,0,34,28
1657288963397,MATH 193A,A03,083781,Rotar; Vladimir,2,0,34,32
1657288963397,MATH 193A,A04,083782,Rotar; Vladimir,8,0,34,26
1657288963397,MATH 193A,A05,093482,Rotar; Vladimir,6,0,34,28
1657288969424,MATH 197,001,091859,McAuley; Julian John,9999,0,9999,0
1657288969424,MATH 197,002,095566,Kedlaya; Kiran S.,9997,0,9999,2
1657288969424,MATH 197,003,095567,Xiao; Ming,9999,0,9999,0
1657288969424,MATH 197,004,095571,Perols; Johan Lars,9998,0,9999,1
1657288976493,COGS 9,A01,083615,Shannon; Kyle Michael,8,0,75,67
1657288982521,COGS 11,A01,083617,Boyle; Mary E. T.,22,0,48,26
1657288988551,COGS 13,A01,083071,Bastos; Amalia Pinkusfeld,9,0,71,62
1657288994678,COGS 14A,A01,092681,Semenuks; Arturs,2,1,100,98
1657289000708,COGS 14B,A01,083073,Cheng; Tzu-Han,6,0,63,57
1657289006740,COGS 17,A01,092677,Semenuks; Arturs,5,0,81,76
1657289012771,COGS 100,A01,083619,Allen; Michael Gordon,16,0,70,54
1657289018813,COGS 101A,A01,083621,Davis; Joshua Daniel,9,0,68,59
1657289024842,COGS 101B,A01,091572,Allen; Michael Gordon,11,0,65,54
1657289030871,COGS 101C,A01,083625,Delgado; Tania,17,0,35,18
1657289036914,COGS 107A,A01,083627,Boyle; Mary E. T.,13,0,60,47
1657289042953,COGS 118A,A01,083075,Gupta; Anjum,18,0,76,58
1657289048996,CSE 3,A50,083646,Miranda; Gregory Joseph,24,0,50,26
1657289055023,CSE 8A,A50,083650,Miranda; Gregory Joseph,17,1,56,39
1657289061054,CSE 11,A01,083080,Cao; Yingjun,5,15,40,35
1657289067086,CSE 12,A01,083652,Krause-Levy; Sophia Louisa,26,1,120,94
1657289073135,CSE 15L,A01,083654,Morris; Justin Loren,9,0,50,41
1657289073135,CSE 15L,A02,083655,Morris; Justin Loren,9,0,50,41
1657289079161,CSE 20,A01,083657,Tran; Khoa Dang,38,0,80,42
1657289085185,CSE 21,A01,095574,Bach; Quang Tran,22,0,48,26
1657289091216,CSE 30,A01,083084,Eldon; John,4,0,80,76
1657289091216,CSE 30,B01,095061,Bhaskar; Nishant,8,0,50,42
1657289097245,CSE 100,A01,083659,Cao; Yingjun,4,4,70,66
1657289103269,CSE 134B,A01,083661,Powell; Thomas Allan,21,0,100,79
1657289109293,CSE 140,A01,083663,Gungor; Onat,13,0,85,72
1657289115328,CSE 140L,A01,083088,Eldon; John,19,0,100,81
1657289121364,CSE 175,A01,083665,Kumar; Rakesh,3,0,25,22
1657289127389,CSE 190,A00,092507,Dubnov; Shlomo,7,0,20,13
1657289133417,ECE 45,A01,083139,Congero; Spencer William,5,0,75,70
1657289139453,ECE 65,A50,083695,Saad; Andrew S,12,0,30,18
1657289139453,ECE 65,A51,095125,Saad; Andrew S,25,0,26,1
1657289145476,ECE 109,A01,091882,Touri; Behrouz,19,0,70,51
1657289151500,ECE 180,A00,083140,Abi Samra; Nicholas Camill,1,0,30,29
1657289151500,ECE 180,B00,083141,Abi Samra; Nicholas Camill,0,0,30,30
1657289157527,MATH 10A,A01,083735,Patchell; Gregory David,2,0,30,28
1657289157527,MATH 10A,A02,083736,Patchell; Gregory David,20,0,30,10
1657289157527,MATH 10A,A03,083737,Patchell; Gregory David,16,0,30,14
1657289163561,MATH 10B,A01,083207,Lim; Seonhee,7,0,34,27
1657289163561,MATH 10B,A02,083208,Lim; Seonhee,9,0,35,26
1657289163561,MATH 10B,A03,093472,Lim; Seonhee,5,0,34,29
1657289163561,MATH 10B,B01,083739,Sinha; Shubham,11,0,30,19
1657289169585,MATH 18,A01,083743,Cinel; Cameron Alexander,6,0,30,24
1657289169585,MATH 18,A02,083744,Cinel; Cameron Alexander,17,0,30,13
1657289169585,MATH 18,A03,083745,Cinel; Cameron Alexander,8,0,30,22
1657289169585,MATH 18,B01,083748,Rideout; David Porter,4,0,37,33
1657289169585,MATH 18,B02,083749,Rideout; David Porter,4,0,36,32
1657289169585,MATH 18,B03,083750,Rideout; David Porter,2,0,37,35
1657289169585,MATH 18,B04,083751,Rideout; David Porter,6,0,36,30
1657289169585,MATH 18,B05,093473,Rideout; David Porter,5,0,36,31
1657289169585,MATH 18,B06,093474,Rideout; David Porter,5,0,36,31
1657289175624,MATH 20A,A01,083754,Zheng; Zequn,14,0,40,26
1657289181652,MATH 20B,A01,083756,Briones; Jor-el Thomas Caparas,3,0,36,33
1657289181652,MATH 20B,A02,083757,Briones; Jor-el Thomas Caparas,1,0,36,35
1657289181652,MATH 20B,A03,093475,Briones; Jor-el Thomas Caparas,2,0,36,34
1657289187675,MATH 20C,A01,083760,Briones; Jor-el Thomas Caparas,1,0,35,34
1657289187675,MATH 20C,A02,083761,Briones; Jor-el Thomas Caparas,8,0,35,27
1657289187675,MATH 20C,A03,093476,Briones; Jor-el Thomas Caparas,0,1,36,36
1657289187675,MATH 20C,B01,083762,Bach; Quang Tran,1,0,30,29
1657289193702,MATH 20D,A01,083765,Tran; Brian Kha,5,0,30,25
1657289193702,MATH 20D,A02,083766,Tran; Brian Kha,5,0,30,25
1657289193702,MATH 20D,A03,083767,Tran; Brian Kha,4,0,30,26
1657289199741,MATH 20E,A01,083771,Ganguly; Soumya,7,0,32,25
1657289199741,MATH 20E,A02,083772,Ganguly; Soumya,7,0,32,25
1657289199741,MATH 20E,B01,083773,Ciotti; Benjamin,19,0,35,16
1657289199741,MATH 20E,B02,083774,Ciotti; Benjamin,17,0,35,18
1657289205775,MATH 103A,A01,083777,Greenfeld; Be'Eri,3,0,36,33
1657289205775,MATH 103A,A02,083778,Greenfeld; Be'Eri,5,0,36,31
1657289205775,MATH 103A,A03,093561,Greenfeld; Be'Eri,4,0,36,32
1657289205775,MATH 103A,B01,083779,Greenfeld; Be'Eri,6,0,36,30
1657289205775,MATH 103A,B02,083780,Greenfeld; Be'Eri,3,0,36,33
1657289205775,MATH 103A,B03,093562,Greenfeld; Be'Eri,3,0,36,33
1657289211804,MATH 105,A01,085443,Carter; Anne Toulson,15,0,35,20
1657289211804,MATH 105,A02,093477,Carter; Anne Toulson,20,0,35,15
1657289217830,MATH 109,A01,083213,Ganzberger; Geoffrey Michael,2,0,34,32
1657289217830,MATH 109,A02,083214,Ganzberger; Geoffrey Michael,4,0,34,30
1657289217830,MATH 109,A03,093478,Ganzberger; Geoffrey Michael,2,0,34,32
1657289217830,MATH 109,B01,083215,Ganzberger; Geoffrey Michael,1,0,32,31
1657289217830,MATH 109,B02,083216,Ganzberger; Geoffrey Michael,1,0,32,31
1657289217830,MATH 109,B03,093479,Ganzberger; Geoffrey Michael,8,0,32,24
1657289223857,MATH 142A,A01,083219,Chow; Bennett,7,0,32,25
1657289223857,MATH 142A,A02,083220,Chow; Bennett,10,0,32,22
1657289223857,MATH 142A,A03,093480,Chow; Bennett,7,0,32,25
1657289223857,MATH 142A,B03,093481,Chow; Bennett,8,0,32,24
1657289223857,MATH 142A,B04,093558,Chow; Bennett,12,0,32,20
1657289223857,MATH 142A,B05,093559,Chow; Bennett,6,0,32,26
1657289229887,MATH 193A,A01,083224,Rotar; Vladimir,7,0,34,27
1657289229887,MATH 193A,A02,083225,Rotar; Vladimir,6,0,34,28
1657289229887,MATH 193A,A03,083781,Rotar; Vladimir,2,0,34,32
1657289229887,MATH 193A,A04,083782,Rotar; Vladimir,8,0,34,26
1657289229887,MATH 193A,A05,093482,Rotar; Vladimir,6,0,34,28
1657289235912,MATH 197,001,091859,McAuley; Julian John,9999,0,9999,0
1657289235912,MATH 197,002,095566,Kedlaya; Kiran S.,9997,0,9999,2
1657289235912,MATH 197,003,095567,Xiao; Ming,9999,0,9999,0
1657289235912,MATH 197,004,095571,Perols; Johan Lars,9998,0,9999,1
1657289242973,COGS 9,A01,083615,Shannon; Kyle Michael,8,0,75,67
1657289249001,COGS 11,A01,083617,Boyle; Mary E. T.,22,0,48,26
1657289255030,COGS 13,A01,083071,Bastos; Amalia Pinkusfeld,9,0,71,62
1657289261058,COGS 14A,A01,092681,Semenuks; Arturs,2,1,100,98
1657289267087,COGS 14B,A01,083073,Cheng; Tzu-Han,6,0,63,57
1657289273113,COGS 17,A01,092677,Semenuks; Arturs,5,0,81,76
1657289279152,COGS 100,A01,083619,Allen; Michael Gordon,16,0,70,54
1657289285177,COGS 101A,A01,083621,Davis; Joshua Daniel,9,0,68,59
1657289291202,COGS 101B,A01,091572,Allen; Michael Gordon,11,0,65,54
1657289297225,COGS 101C,A01,083625,Delgado; Tania,17,0,35,18
1657289303248,COGS 107A,A01,083627,Boyle; Mary E. T.,13,0,60,47
1657289309283,COGS 118A,A01,083075,Gupta; Anjum,18,0,76,58
1657289315311,CSE 3,A50,083646,Miranda; Gregory Joseph,24,0,50,26
1657289321333,CSE 8A,A50,083650,Miranda; Gregory Joseph,17,1,56,39
1657289327367,CSE 11,A01,083080,Cao; Yingjun,5,15,40,35
1657289333389,CSE 12,A01,083652,Krause-Levy; Sophia Louisa,26,1,120,94
1657289339413,CSE 15L,A01,083654,Morris; Justin Loren,9,0,50,41
1657289339413,CSE 15L,A02,083655,Morris; Justin Loren,9,0,50,41
1657289345443,CSE 20,A01,083657,Tran; Khoa Dang,38,0,80,42
1657289351474,CSE 21,A01,095574,Bach; Quang Tran,22,0,48,26
1657289357502,CSE 30,A01,083084,Eldon; John,4,0,80,76
1657289357502,CSE 30,B01,095061,Bhaskar; Nishant,8,0,50,42
1657289363527,CSE 100,A01,083659,Cao; Yingjun,4,4,70,66
1657289369552,CSE 134B,A01,083661,Powell; Thomas Allan,21,0,100,79
1657289375575,CSE 140,A01,083663,Gungor; Onat,13,0,85,72
1657289381612,CSE 140L,A01,083088,Eldon; John,19,0,100,81
1657289387635,CSE 175,A01,083665,Kumar; Rakesh,3,0,25,22
1657289393661,CSE 190,A00,092507,Dubnov; Shlomo,7,0,20,13
1657289399685,ECE 45,A01,083139,Congero; Spencer William,5,0,75,70
1657289405709,ECE 65,A50,083695,Saad; Andrew S,12,0,30,18
1657289405709,ECE 65,A51,095125,Saad; Andrew S,25,0,26,1
1657289411736,ECE 109,A01,091882,Touri; Behrouz,19,0,70,51
1657289417764,ECE 180,A00,083140,Abi Samra; Nicholas Camill,1,0,30,29
1657289417764,ECE 180,B00,083141,Abi Samra; Nicholas Camill,0,0,30,30
1657289423790,MATH 10A,A01,083735,Patchell; Gregory David,2,0,30,28
1657289423790,MATH 10A,A02,083736,Patchell; Gregory David,20,0,30,10
1657289423790,MATH 10A,A03,083737,Patchell; Gregory David,16,0,30,14
1657289429814,MATH 10B,A01,083207,Lim; Seonhee,7,0,34,27
1657289429814,MATH 10B,A02,083208,Lim; Seonhee,9,0,35,26
1657289429814,MATH 10B,A03,093472,Lim; Seonhee,5,0,34,29
1657289429814,MATH 10B,B01,083739,Sinha; Shubham,11,0,30,19
1657289435845,MATH 18,A01,083743,Cinel; Cameron Alexander,6,0,30,24
1657289435845,MATH 18,A02,083744,Cinel; Cameron Alexander,17,0,30,13
1657289435845,MATH 18,A03,083745,Cinel; Cameron Alexander,8,0,30,22
1657289435845,MATH 18,B01,083748,Rideout; David Porter,4,0,37,33
1657289435845,MATH 18,B02,083749,Rideout; David Porter,4,0,36,32
1657289435845,MATH 18,B03,083750,Rideout; David Porter,2,0,37,35
1657289435845,MATH 18,B04,083751,Rideout; David Porter,6,0,36,30
1657289435845,MATH 18,B05,093473,Rideout; David Porter,5,0,36,31
1657289435845,MATH 18,B06,093474,Rideout; David Porter,5,0,36,31
1657289441873,MATH 20A,A01,083754,Zheng; Zequn,14,0,40,26
1657289447902,MATH 20B,A01,083756,Briones; Jor-el Thomas Caparas,3,0,36,33
1657289447902,MATH 20B,A02,083757,Briones; Jor-el Thomas Caparas,1,0,36,35
1657289447902,MATH 20B,A03,093475,Briones; Jor-el Thomas Caparas,2,0,36,34
1657289453926,MATH 20C,A01,083760,Briones; Jor-el Thomas Caparas,1,0,35,34
1657289453926,MATH 20C,A02,083761,Briones; Jor-el Thomas Caparas,8,0,35,27
1657289453926,MATH 20C,A03,093476,Briones; Jor-el Thomas Caparas,0,1,36,36
1657289453926,MATH 20C,B01,083762,Bach; Quang Tran,1,0,30,29
1657289459954,MATH 20D,A01,083765,Tran; Brian Kha,5,0,30,25
1657289459954,MATH 20D,A02,083766,Tran; Brian Kha,5,0,30,25
1657289459954,MATH 20D,A03,083767,Tran; Brian Kha,4,0,30,26
1657289465987,MATH 20E,A01,083771,Ganguly; Soumya,7,0,32,25
1657289465987,MATH 20E,A02,083772,Ganguly; Soumya,7,0,32,25
1657289465987,MATH 20E,B01,083773,Ciotti; Benjamin,19,0,35,16
1657289465987,MATH 20E,B02,083774,Ciotti; Benjamin,17,0,35,18
1657289472011,MATH 103A,A01,083777,Greenfeld; Be'Eri,3,0,36,33
1657289472011,MATH 103A,A02,083778,Greenfeld; Be'Eri,5,0,36,31
1657289472011,MATH 103A,A03,093561,Greenfeld; Be'Eri,4,0,36,32
1657289472011,MATH 103A,B01,083779,Greenfeld; Be'Eri,6,0,36,30
1657289472011,MATH 103A,B02,083780,Greenfeld; Be'Eri,3,0,36,33
1657289472011,MATH 103A,B03,093562,Greenfeld; Be'Eri,3,0,36,33
1657289478036,MATH 105,A01,085443,Carter; Anne Toulson,15,0,35,20
1657289478036,MATH 105,A02,093477,Carter; Anne Toulson,20,0,35,15
1657289484062,MATH 109,A01,083213,Ganzberger; Geoffrey Michael,2,0,34,32
1657289484062,MATH 109,A02,083214,Ganzberger; Geoffrey Michael,4,0,34,30
1657289484062,MATH 109,A03,093478,Ganzberger; Geoffrey Michael,2,0,34,32
1657289484062,MATH 109,B01,083215,Ganzberger; Geoffrey Michael,1,0,32,31
1657289484062,MATH 109,B02,083216,Ganzberger; Geoffrey Michael,1,0,32,31
1657289484062,MATH 109,B03,093479,Ganzberger; Geoffrey Michael,8,0,32,24
1657289490107,MATH 142A,A01,083219,Chow; Bennett,7,0,32,25
1657289490107,MATH 142A,A02,083220,Chow; Bennett,10,0,32,22
1657289490107,MATH 142A,A03,093480,Chow; Bennett,7,0,32,25
1657289490107,MATH 142A,B03,093481,Chow; Bennett,8,0,32,24
1657289490107,MATH 142A,B04,093558,Chow; Bennett,12,0,32,20
1657289490107,MATH 142A,B05,093559,Chow; Bennett,6,0,32,26
1657289496131,MATH 193A,A01,083224,Rotar; Vladimir,7,0,34,27
1657289496131,MATH 193A,A02,083225,Rotar; Vladimir,6,0,34,28
1657289496131,MATH 193A,A03,083781,Rotar; Vladimir,2,0,34,32
1657289496131,MATH 193A,A04,083782,Rotar; Vladimir,8,0,34,26
1657289496131,MATH 193A,A05,093482,Rotar; Vladimir,6,0,34,28
1657289502157,MATH 197,001,091859,McAuley; Julian John,9999,0,9999,0
1657289502157,MATH 197,002,095566,Kedlaya; Kiran S.,9997,0,9999,2
1657289502157,MATH 197,003,095567,Xiao; Ming,9999,0,9999,0
1657289502157,MATH 197,004,095571,Perols; Johan Lars,9998,0,9999,1
1657289509224,COGS 9,A01,083615,Shannon; Kyle Michael,8,0,75,67
1657289515251,COGS 11,A01,083617,Boyle; Mary E. T.,22,0,48,26
1657289521275,COGS 13,A01,083071,Bastos; Amalia Pinkusfeld,9,0,71,62
1657289527303,COGS 14A,A01,092681,Semenuks; Arturs,2,1,100,98
1657289533343,COGS 14B,A01,083073,Cheng; Tzu-Han,6,0,63,57
1657289539370,COGS 17,A01,092677,Semenuks; Arturs,5,0,81,76
1657289545414,COGS 100,A01,083619,Allen; Michael Gordon,16,0,70,54
1657289551440,COGS 101A,A01,083621,Davis; Joshua Daniel,9,0,68,59
1657289557466,COGS 101B,A01,091572,Allen; Michael Gordon,11,0,65,54
1657289563492,COGS 101C,A01,083625,Delgado; Tania,17,0,35,18
1657289569524,COGS 107A,A01,083627,Boyle; Mary E. T.,13,0,60,47
1657289575551,COGS 118A,A01,083075,Gupta; Anjum,18,0,76,58
1657289581577,CSE 3,A50,083646,Miranda; Gregory Joseph,24,0,50,26
1657289587608,CSE 8A,A50,083650,Miranda; Gregory Joseph,17,1,56,39
1657289593733,CSE 11,A01,083080,Cao; Yingjun,5,15,40,35
1657289599757,CSE 12,A01,083652,Krause-Levy; Sophia Louisa,26,1,120,94
1657289605781,CSE 15L,A01,083654,Morris; Justin Loren,9,0,50,41
1657289605781,CSE 15L,A02,083655,Morris; Justin Loren,9,0,50,41
1657289611805,CSE 20,A01,083657,Tran; Khoa Dang,38,0,80,42
1657289617831,CSE 21,A01,095574,Bach; Quang Tran,22,0,48,26
1657289623856,CSE 30,A01,083084,Eldon; John,4,0,80,76
1657289623856,CSE 30,B01,095061,Bhaskar; Nishant,8,0,50,42
1657289629880,CSE 100,A01,083659,Cao; Yingjun,4,4,70,66
1657289635915,CSE 134B,A01,083661,Powell; Thomas Allan,21,0,100,79
1657289641938,CSE 140,A01,083663,Gungor; Onat,13,0,85,72
1657289647962,CSE 140L,A01,083088,Eldon; John,19,0,100,81
1657289653992,CSE 175,A01,083665,Kumar; Rakesh,3,0,25,22
1657289660028,CSE 190,A00,092507,Dubnov; Shlomo,7,0,20,13
1657289666063,ECE 45,A01,083139,Congero; Spencer William,5,0,75,70
1657289672094,ECE 65,A50,083695,Saad; Andrew S,12,0,30,18
1657289672094,ECE 65,A51,095125,Saad; Andrew S,25,0,26,1
1657289678121,ECE 109,A01,091882,Touri; Behrouz,19,0,70,51
1657289684147,ECE 180,A00,083140,Abi Samra; Nicholas Camill,1,0,30,29
1657289684147,ECE 180,B00,083141,Abi Samra; Nicholas Camill,0,0,30,30
1657289690172,MATH 10A,A01,083735,Patchell; Gregory David,2,0,30,28
1657289690172,MATH 10A,A02,083736,Patchell; Gregory David,20,0,30,10
1657289690172,MATH 10A,A03,083737,Patchell; Gregory David,16,0,30,14
1657289696198,MATH 10B,A01,083207,Lim; Seonhee,7,0,34,27
1657289696198,MATH 10B,A02,083208,Lim; Seonhee,9,0,35,26
1657289696198,MATH 10B,A03,093472,Lim; Seonhee,5,0,34,29
1657289696198,MATH 10B,B01,083739,Sinha; Shubham,11,0,30,19
1657289702237,MATH 18,A01,083743,Cinel; Cameron Alexander,6,0,30,24
1657289702237,MATH 18,A02,083744,Cinel; Cameron Alexander,17,0,30,13
1657289702237,MATH 18,A03,083745,Cinel; Cameron Alexander,8,0,30,22
1657289702237,MATH 18,B01,083748,Rideout; David Porter,4,0,37,33
1657289702237,MATH 18,B02,083749,Rideout; David Porter,4,0,36,32
1657289702237,MATH 18,B03,083750,Rideout; David Porter,2,0,37,35
1657289702237,MATH 18,B04,083751,Rideout; David Porter,6,0,36,30
1657289702237,MATH 18,B05,093473,Rideout; David Porter,5,0,36,31
1657289702237,MATH 18,B06,093474,Rideout; David Porter,5,0,36,31
1657289708264,MATH 20A,A01,083754,Zheng; Zequn,14,0,40,26
1657289714293,MATH 20B,A01,083756,Briones; Jor-el Thomas Caparas,3,0,36,33
1657289714293,MATH 20B,A02,083757,Briones; Jor-el Thomas Caparas,1,0,36,35
1657289714293,MATH 20B,A03,093475,Briones; Jor-el Thomas Caparas,2,0,36,34
1657289720318,MATH 20C,A01,083760,Briones; Jor-el Thomas Caparas,1,0,35,34
1657289720318,MATH 20C,A02,083761,Briones; Jor-el Thomas Caparas,8,0,35,27
1657289720318,MATH 20C,A03,093476,Briones; Jor-el Thomas Caparas,0,1,36,36
1657289720318,MATH 20C,B01,083762,Bach; Quang Tran,1,0,30,29
1657289726344,MATH 20D,A01,083765,Tran; Brian Kha,5,0,30,25
1657289726344,MATH 20D,A02,083766,Tran; Brian Kha,5,0,30,25
1657289726344,MATH 20D,A03,083767,Tran; Brian Kha,4,0,30,26
1657289732373,MATH 20E,A01,083771,Ganguly; Soumya,7,0,32,25
1657289732373,MATH 20E,A02,083772,Ganguly; Soumya,7,0,32,25
1657289732373,MATH 20E,B01,083773,Ciotti; Benjamin,19,0,35,16
1657289732373,MATH 20E,B02,083774,Ciotti; Benjamin,17,0,35,18
1657289738404,MATH 103A,A01,083777,Greenfeld; Be'Eri,3,0,36,33
1657289738404,MATH 103A,A02,083778,Greenfeld; Be'Eri,5,0,36,31
1657289738404,MATH 103A,A03,093561,Greenfeld; Be'Eri,4,0,36,32
1657289738404,MATH 103A,B01,083779,Greenfeld; Be'Eri,6,0,36,30
1657289738404,MATH 103A,B02,083780,Greenfeld; Be'Eri,3,0,36,33
1657289738404,MATH 103A,B03,093562,Greenfeld; Be'Eri,3,0,36,33
1657289744428,MATH 105,A01,085443,Carter; Anne Toulson,15,0,35,20
1657289744428,MATH 105,A02,093477,Carter; Anne Toulson,20,0,35,15
1657289750452,MATH 109,A01,083213,Ganzberger; Geoffrey Michael,2,0,34,32
1657289750452,MATH 109,A02,083214,Ganzberger; Geoffrey Michael,4,0,34,30
1657289750452,MATH 109,A03,093478,Ganzberger; Geoffrey Michael,2,0,34,32
1657289750452,MATH 109,B01,083215,Ganzberger; Geoffrey Michael,1,0,32,31
1657289750452,MATH 109,B02,083216,Ganzberger; Geoffrey Michael,1,0,32,31
1657289750452,MATH 109,B03,093479,Ganzberger; Geoffrey Michael,8,0,32,24
1657289756476,MATH 142A,A01,083219,Chow; Bennett,7,0,32,25
1657289756476,MATH 142A,A02,083220,Chow; Bennett,10,0,32,22
1657289756476,MATH 142A,A03,093480,Chow; Bennett,7,0,32,25
1657289756476,MATH 142A,B03,093481,Chow; Bennett,8,0,32,24
1657289756476,MATH 142A,B04,093558,Chow; Bennett,12,0,32,20
1657289756476,MATH 142A,B05,093559,Chow; Bennett,6,0,32,26
1657289762514,MATH 193A,A01,083224,Rotar; Vladimir,7,0,34,27
1657289762514,MATH 193A,A02,083225,Rotar; Vladimir,6,0,34,28
1657289762514,MATH 193A,A03,083781,Rotar; Vladimir,2,0,34,32
1657289762514,MATH 193A,A04,083782,Rotar; Vladimir,8,0,34,26
1657289762514,MATH 193A,A05,093482,Rotar; Vladimir,6,0,34,28
1657289768538,MATH 197,001,091859,McAuley; Julian John,9999,0,9999,0
1657289768538,MATH 197,002,095566,Kedlaya; Kiran S.,9997,0,9999,2
1657289768538,MATH 197,003,095567,Xiao; Ming,9999,0,9999,0
1657289768538,MATH 197,004,095571,Perols; Johan Lars,9998,0,9999,1
1657289775598,COGS 9,A01,083615,Shannon; Kyle Michael,8,0,75,67
1657289781623,COGS 11,A01,083617,Boyle; Mary E. T.,22,0,48,26
1657289787648,COGS 13,A01,083071,Bastos; Amalia Pinkusfeld,9,0,71,62
1657289793672,COGS 14A,A01,092681,Semenuks; Arturs,2,1,100,98
1657289799698,COGS 14B,A01,083073,Cheng; Tzu-Han,6,0,63,57
1657289805722,COGS 17,A01,092677,Semenuks; Arturs,5,0,81,76
1657289811748,COGS 100,A01,083619,Allen; Michael Gordon,16,0,70,54
1657289817776,COGS 101A,A01,083621,Davis; Joshua Daniel,9,0,68,59
1657289823803,COGS 101B,A01,091572,Allen; Michael Gordon,11,0,65,54
1657289829827,COGS 101C,A01,083625,Delgado; Tania,17,0,35,18
1657289835857,COGS 107A,A01,083627,Boyle; Mary E. T.,13,0,60,47
1657289841885,COGS 118A,A01,083075,Gupta; Anjum,18,0,76,58
1657289847914,CSE 3,A50,083646,Miranda; Gregory Joseph,24,0,50,26
1657289853943,CSE 8A,A50,083650,Miranda; Gregory Joseph,17,1,56,39
1657289859967,CSE 11,A01,083080,Cao; Yingjun,5,15,40,35
1657289865998,CSE 12,A01,083652,Krause-Levy; Sophia Louisa,26,1,120,94
1657289872031,CSE 15L,A01,083654,Morris; Justin Loren,9,0,50,41
1657289872031,CSE 15L,A02,083655,Morris; Justin Loren,9,0,50,41
1657289878068,CSE 20,A01,083657,Tran; Khoa Dang,38,0,80,42
1657289884096,CSE 21,A01,095574,Bach; Quang Tran,22,0,48,26
1657289890120,CSE 30,A01,083084,Eldon; John,4,0,80,76
1657289890120,CSE 30,B01,095061,Bhaskar; Nishant,8,0,50,42
1657289896145,CSE 100,A01,083659,Cao; Yingjun,4,4,70,66
1657289902170,CSE 134B,A01,083661,Powell; Thomas Allan,21,0,100,79
1657289908193,CSE 140,A01,083663,Gungor; Onat,13,0,85,72
1657289914219,CSE 140L,A01,083088,Eldon; John,19,0,100,81
1657289920241,CSE 175,A01,083665,Kumar; Rakesh,3,0,25,22
1657289926265,CSE 190,A00,092507,Dubnov; Shlomo,7,0,20,13
1657289932291,ECE 45,A01,083139,Congero; Spencer William,5,0,75,70
1657289938318,ECE 65,A50,083695,Saad; Andrew S,12,0,30,18
1657289938318,ECE 65,A51,095125,Saad; Andrew S,25,0,26,1
1657289944343,ECE 109,A01,091882,Touri; Behrouz,19,0,70,51
1657289950366,ECE 180,A00,083140,Abi Samra; Nicholas Camill,1,0,30,29
1657289950366,ECE 180,B00,083141,Abi Samra; Nicholas Camill,0,0,30,30
1657289956393,MATH 10A,A01,083735,Patchell; Gregory David,2,0,30,28
1657289956393,MATH 10A,A02,083736,Patchell; Gregory David,20,0,30,10
1657289956393,MATH 10A,A03,083737,Patchell; Gregory David,16,0,30,14
1657289962420,MATH 10B,A01,083207,Lim; Seonhee,7,0,34,27
1657289962420,MATH 10B,A02,083208,Lim; Seonhee,9,0,35,26
1657289962420,MATH 10B,A03,093472,Lim; Seonhee,5,0,34,29
1657289962420,MATH 10B,B01,083739,Sinha; Shubham,11,0,30,19
1657289968444,MATH 18,A01,083743,Cinel; Cameron Alexander,6,0,30,24
1657289968444,MATH 18,A02,083744,Cinel; Cameron Alexander,17,0,30,13
1657289968444,MATH 18,A03,083745,Cinel; Cameron Alexander,8,0,30,22
1657289968444,MATH 18,B01,083748,Rideout; David Porter,4,0,37,33
1657289968444,MATH 18,B02,083749,Rideout; David Porter,4,0,36,32
1657289968444,MATH 18,B03,083750,Rideout; David Porter,2,0,37,35
1657289968444,MATH 18,B04,083751,Rideout; David Porter,6,0,36,30
1657289968444,MATH 18,B05,093473,Rideout; David Porter,5,0,36,31
1657289968444,MATH 18,B06,093474,Rideout; David Porter,5,0,36,31
1657289974474,MATH 20A,A01,083754,Zheng; Zequn,14,0,40,26
1657289980497,MATH 20B,A01,083756,Briones; Jor-el Thomas Caparas,3,0,36,33
1657289980497,MATH 20B,A02,083757,Briones; Jor-el Thomas Caparas,1,0,36,35
1657289980497,MATH 20B,A03,093475,Briones; Jor-el Thomas Caparas,2,0,36,34
1657289986530,MATH 20C,A01,083760,Briones; Jor-el Thomas Caparas,1,0,35,34
1657289986530,MATH 20C,A02,083761,Briones; Jor-el Thomas Caparas,8,0,35,27
1657289986530,MATH 20C,A03,093476,Briones; Jor-el Thomas Caparas,0,1,36,36
1657289986530,MATH 20C,B01,083762,Bach; Quang Tran,1,0,30,29
1657289992559,MATH 20D,A01,083765,Tran; Brian Kha,5,0,30,25
1657289992559,MATH 20D,A02,083766,Tran; Brian Kha,5,0,30,25
1657289992559,MATH 20D,A03,083767,Tran; Brian Kha,4,0,30,26
1657289998583,MATH 20E,A01,083771,Ganguly; Soumya,7,0,32,25
1657289998583,MATH 20E,A02,083772,Ganguly; Soumya,7,0,32,25
1657289998583,MATH 20E,B01,083773,Ciotti; Benjamin,19,0,35,16
1657289998583,MATH 20E,B02,083774,Ciotti; Benjamin,17,0,35,18
1657290004608,MATH 103A,A01,083777,Greenfeld; Be'Eri,3,0,36,33
1657290004608,MATH 103A,A02,083778,Greenfeld; Be'Eri,5,0,36,31
1657290004608,MATH 103A,A03,093561,Greenfeld; Be'Eri,4,0,36,32
1657290004608,MATH 103A,B01,083779,Greenfeld; Be'Eri,6,0,36,30
1657290004608,MATH 103A,B02,083780,Greenfeld; Be'Eri,3,0,36,33
1657290004608,MATH 103A,B03,093562,Greenfeld; Be'Eri,3,0,36,33
1657290010648,MATH 105,A01,085443,Carter; Anne Toulson,15,0,35,20
1657290010648,MATH 105,A02,093477,Carter; Anne Toulson,20,0,35,15
1657290016674,MATH 109,A01,083213,Ganzberger; Geoffrey Michael,2,0,34,32
1657290016674,MATH 109,A02,083214,Ganzberger; Geoffrey Michael,4,0,34,30
1657290016674,MATH 109,A03,093478,Ganzberger; Geoffrey Michael,2,0,34,32
1657290016674,MATH 109,B01,083215,Ganzberger; Geoffrey Michael,1,0,32,31
1657290016674,MATH 109,B02,083216,Ganzberger; Geoffrey Michael,1,0,32,31
1657290016674,MATH 109,B03,093479,Ganzberger; Geoffrey Michael,8,0,32,24
1657290022698,MATH 142A,A01,083219,Chow; Bennett,7,0,32,25
1657290022698,MATH 142A,A02,083220,Chow; Bennett,10,0,32,22
1657290022698,MATH 142A,A03,093480,Chow; Bennett,7,0,32,25
1657290022698,MATH 142A,B03,093481,Chow; Bennett,8,0,32,24
1657290022698,MATH 142A,B04,093558,Chow; Bennett,12,0,32,20
1657290022698,MATH 142A,B05,093559,Chow; Bennett,6,0,32,26
1657290028727,MATH 193A,A01,083224,Rotar; Vladimir,7,0,34,27
1657290028727,MATH 193A,A02,083225,Rotar; Vladimir,6,0,34,28
1657290028727,MATH 193A,A03,083781,Rotar; Vladimir,2,0,34,32
1657290028727,MATH 193A,A04,083782,Rotar; Vladimir,8,0,34,26
1657290028727,MATH 193A,A05,093482,Rotar; Vladimir,6,0,34,28
1657290034751,MATH 197,001,091859,McAuley; Julian John,9999,0,9999,0
1657290034751,MATH 197,002,095566,Kedlaya; Kiran S.,9997,0,9999,2
1657290034751,MATH 197,003,095567,Xiao; Ming,9999,0,9999,0
1657290034751,MATH 197,004,095571,Perols; Johan Lars,9998,0,9999,1
1657290041807,COGS 9,A01,083615,Shannon; Kyle Michael,8,0,75,67
1657290047835,COGS 11,A01,083617,Boyle; Mary E. T.,22,0,48,26
1657290053859,COGS 13,A01,083071,Bastos; Amalia Pinkusfeld,9,0,71,62
1657290059885,COGS 14A,A01,092681,Semenuks; Arturs,2,1,100,98
1657290065914,COGS 14B,A01,083073,Cheng; Tzu-Han,6,0,63,57
1657290071946,COGS 17,A01,092677,Semenuks; Arturs,5,0,81,76
1657290077976,COGS 100,A01,083619,Allen; Michael Gordon,16,0,70,54
1657290084001,COGS 101A,A01,083621,Davis; Joshua Daniel,9,0,68,59
1657290090024,COGS 101B,A01,091572,Allen; Michael Gordon,11,0,65,54
1657290096049,COGS 101C,A01,083625,Delgado; Tania,17,0,35,18
1657290102074,COGS 107A,A01,083627,Boyle; Mary E. T.,13,0,60,47
1657290108099,COGS 118A,A01,083075,Gupta; Anjum,18,0,76,58
1657290114123,CSE 3,A50,083646,Miranda; Gregory Joseph,24,0,50,26
1657290120146,CSE 8A,A50,083650,Miranda; Gregory Joseph,17,1,56,39
1657290126173,CSE 11,A01,083080,Cao; Yingjun,5,15,40,35
1657290132198,CSE 12,A01,083652,Krause-Levy; Sophia Louisa,26,1,120,94
1657290138230,CSE 15L,A01,083654,Morris; Justin Loren,9,0,50,41
1657290138230,CSE 15L,A02,083655,Morris; Justin Loren,9,0,50,41
1657290144256,CSE 20,A01,083657,Tran; Khoa Dang,38,0,80,42
1657290150296,CSE 21,A01,095574,Bach; Quang Tran,22,0,48,26
1657290156321,CSE 30,A01,083084,Eldon; John,4,0,80,76
1657290156321,CSE 30,B01,095061,Bhaskar; Nishant,8,0,50,42
1657290162345,CSE 100,A01,083659,Cao; Yingjun,4,4,70,66
1657290168372,CSE 134B,A01,083661,Powell; Thomas Allan,21,0,100,79
1657290174399,CSE 140,A01,083663,Gungor; Onat,13,0,85,72
1657290180429,CSE 140L,A01,083088,Eldon; John,19,0,100,81
1657290186452,CSE 175,A01,083665,Kumar; Rakesh,3,0,25,22
1657290192567,CSE 190,A00,092507,Dubnov; Shlomo,7,0,20,13
1657290198591,ECE 45,A01,083139,Congero; Spencer William,5,0,75,70
1657290204614,ECE 65,A50,083695,Saad; Andrew S,12,0,30,18
1657290204614,ECE 65,A51,095125,Saad; Andrew S,25,0,26,1
1657290210638,ECE 109,A01,091882,Touri; Behrouz,19,0,70,51
1657290216661,ECE 180,A00,083140,Abi Samra; Nicholas Camill,1,0,30,29
1657290216661,ECE 180,B00,083141,Abi Samra; Nicholas Camill,0,0,30,30
1657290222692,MATH 10A,A01,083735,Patchell; Gregory David,2,0,30,28
1657290222692,MATH 10A,A02,083736,Patchell; Gregory David,20,0,30,10
1657290222692,MATH 10A,A03,083737,Patchell; Gregory David,16,0,30,14
1657290228723,MATH 10B,A01,083207,Lim; Seonhee,7,0,34,27
1657290228723,MATH 10B,A02,083208,Lim; Seonhee,9,0,35,26
1657290228723,MATH 10B,A03,093472,Lim; Seonhee,5,0,34,29
1657290228723,MATH 10B,B01,083739,Sinha; Shubham,11,0,30,19
1657290234748,MATH 18,A01,083743,Cinel; Cameron Alexander,6,0,30,24
1657290234748,MATH 18,A02,083744,Cinel; Cameron Alexander,17,0,30,13
1657290234748,MATH 18,A03,083745,Cinel; Cameron Alexander,8,0,30,22
1657290234748,MATH 18,B01,083748,Rideout; David Porter,4,0,37,33
1657290234748,MATH 18,B02,083749,Rideout; David Porter,4,0,36,32
1657290234748,MATH 18,B03,083750,Rideout; David Porter,2,0,37,35
1657290234748,MATH 18,B04,083751,Rideout; David Porter,6,0,36,30
1657290234748,MATH 18,B05,093473,Rideout; David Porter,5,0,36,31
1657290234748,MATH 18,B06,093474,Rideout; David Porter,5,0,36,31
1657290240784,MATH 20A,A01,083754,Zheng; Zequn,14,0,40,26
1657290246806,MATH 20B,A01,083756,Briones; Jor-el Thomas Caparas,3,0,36,33
1657290246806,MATH 20B,A02,083757,Briones; Jor-el Thomas Caparas,1,0,36,35
1657290246806,MATH 20B,A03,093475,Briones; Jor-el Thomas Caparas,2,0,36,34
1657290252830,MATH 20C,A01,083760,Briones; Jor-el Thomas Caparas,1,0,35,34
1657290252830,MATH 20C,A02,083761,Briones; Jor-el Thomas Caparas,8,0,35,27
1657290252830,MATH 20C,A03,093476,Briones; Jor-el Thomas Caparas,0,1,36,36
1657290252830,MATH 20C,B01,083762,Bach; Quang Tran,1,0,30,29
1657290258861,MATH 20D,A01,083765,Tran; Brian Kha,5,0,30,25
1657290258861,MATH 20D,A02,083766,Tran; Brian Kha,5,0,30,25
1657290258861,MATH 20D,A03,083767,Tran; Brian Kha,4,0,30,26
1657290264884,MATH 20E,A01,083771,Ganguly; Soumya,7,0,32,25
1657290264884,MATH 20E,A02,083772,Ganguly; Soumya,7,0,32,25
1657290264884,MATH 20E,B01,083773,Ciotti; Benjamin,19,0,35,16
1657290264884,MATH 20E,B02,083774,Ciotti; Benjamin,17,0,35,18
1657290270915,MATH 103A,A01,083777,Greenfeld; Be'Eri,3,0,36,33
1657290270915,MATH 103A,A02,083778,Greenfeld; Be'Eri,5,0,36,31
1657290270915,MATH 103A,A03,093561,Greenfeld; Be'Eri,4,0,36,32
1657290270915,MATH 103A,B01,083779,Greenfeld; Be'Eri,6,0,36,30
1657290270915,MATH 103A,B02,083780,Greenfeld; Be'Eri,3,0,36,33
1657290270915,MATH 103A,B03,093562,Greenfeld; Be'Eri,3,0,36,33
1657290276941,MATH 105,A01,085443,Carter; Anne Toulson,15,0,35,20
1657290276941,MATH 105,A02,093477,Carter; Anne Toulson,20,0,35,15
1657290282967,MATH 109,A01,083213,Ganzberger; Geoffrey Michael,2,0,34,32
1657290282967,MATH 109,A02,083214,Ganzberger; Geoffrey Michael,4,0,34,30
1657290282967,MATH 109,A03,093478,Ganzberger; Geoffrey Michael,2,0,34,32
1657290282967,MATH 109,B01,083215,Ganzberger; Geoffrey Michael,1,0,32,31
1657290282967,MATH 109,B02,083216,Ganzberger; Geoffrey Michael,1,0,32,31
1657290282967,MATH 109,B03,093479,Ganzberger; Geoffrey Michael,8,0,32,24
1657290288991,MATH 142A,A01,083219,Chow; Bennett,7,0,32,25
1657290288991,MATH 142A,A02,083220,Chow; Bennett,10,0,32,22
1657290288991,MATH 142A,A03,093480,Chow; Bennett,7,0,32,25
1657290288991,MATH 142A,B03,093481,Chow; Bennett,8,0,32,24
1657290288991,MATH 142A,B04,093558,Chow; Bennett,12,0,32,20
1657290288991,MATH 142A,B05,093559,Chow; Bennett,6,0,32,26
1657290295015,MATH 193A,A01,083224,Rotar; Vladimir,7,0,34,27
1657290295015,MATH 193A,A02,083225,Rotar; Vladimir,6,0,34,28
1657290295015,MATH 193A,A03,083781,Rotar; Vladimir,2,0,34,32
1657290295015,MATH 193A,A04,083782,Rotar; Vladimir,8,0,34,26
1657290295015,MATH 193A,A05,093482,Rotar; Vladimir,6,0,34,28
1657290301048,MATH 197,001,091859,McAuley; Julian John,9999,0,9999,0
1657290301048,MATH 197,002,095566,Kedlaya; Kiran S.,9997,0,9999,2
1657290301048,MATH 197,003,095567,Xiao; Ming,9999,0,9999,0
1657290301048,MATH 197,004,095571,Perols; Johan Lars,9998,0,9999,1
1657290308110,COGS 9,A01,083615,Shannon; Kyle Michael,8,0,75,67
1657290314135,COGS 11,A01,083617,Boyle; Mary E. T.,22,0,48,26
1657290320159,COGS 13,A01,083071,Bastos; Amalia Pinkusfeld,9,0,71,62
1657290326181,COGS 14A,A01,092681,Semenuks; Arturs,2,1,100,98
1657290332209,COGS 14B,A01,083073,Cheng; Tzu-Han,6,0,63,57
1657290338235,COGS 17,A01,092677,Semenuks; Arturs,5,0,81,76
1657290344259,COGS 100,A01,083619,Allen; Michael Gordon,16,0,70,54
1657290350283,COGS 101A,A01,083621,Davis; Joshua Daniel,9,0,68,59
1657290356317,COGS 101B,A01,091572,Allen; Michael Gordon,11,0,65,54
1657290362345,COGS 101C,A01,083625,Delgado; Tania,17,0,35,18
1657290368373,COGS 107A,A01,083627,Boyle; Mary E. T.,13,0,60,47
1657290374401,COGS 118A,A01,083075,Gupta; Anjum,18,0,76,58
1657290380430,CSE 3,A50,083646,Miranda; Gregory Joseph,24,0,50,26
1657290386455,CSE 8A,A50,083650,Miranda; Gregory Joseph,17,1,56,39
1657290392482,CSE 11,A01,083080,Cao; Yingjun,5,15,40,35
1657290398505,CSE 12,A01,083652,Krause-Levy; Sophia Louisa,26,1,120,94
1657290404532,CSE 15L,A01,083654,Morris; Justin Loren,9,0,50,41
1657290404532,CSE 15L,A02,083655,Morris; Justin Loren,9,0,50,41
1657290410575,CSE 20,A01,083657,Tran; Khoa Dang,38,0,80,42
1657290416602,CSE 21,A01,095574,Bach; Quang Tran,22,0,48,26
1657290422624,CSE 30,A01,083084,Eldon; John,4,0,80,76
1657290422624,CSE 30,B01,095061,Bhaskar; Nishant,8,0,50,42
1657290428664,CSE 100,A01,083659,Cao; Yingjun,4,4,70,66
1657290434693,CSE 134B,A01,083661,Powell; Thomas Allan,21,0,100,79
1657290440722,CSE 140,A01,083663,Gungor; Onat,13,0,85,72
1657290446752,CSE 140L,A01,083088,Eldon; John,19,0,100,81
1657290452774,CSE 175,A01,083665,Kumar; Rakesh,3,0,25,22
1657290458800,CSE 190,A00,092507,Dubnov; Shlomo,7,0,20,13
1657290464828,ECE 45,A01,083139,Congero; Spencer William,5,0,75,70
1657290470851,ECE 65,A50,083695,Saad; Andrew S,12,0,30,18
1657290470851,ECE 65,A51,095125,Saad; Andrew S,25,0,26,1
1657290476888,ECE 109,A01,091882,Touri; Behrouz,19,0,70,51
1657290482914,ECE 180,A00,083140,Abi Samra; Nicholas Camill,1,0,30,29
1657290482914,ECE 180,B00,083141,Abi Samra; Nicholas Camill,0,0,30,30
1657290488938,MATH 10A,A01,083735,Patchell; Gregory David,2,0,30,28
1657290488938,MATH 10A,A02,083736,Patchell; Gregory David,20,0,30,10
1657290488938,MATH 10A,A03,083737,Patchell; Gregory David,16,0,30,14
1657290494962,MATH 10B,A01,083207,Lim; Seonhee,7,0,34,27
1657290494962,MATH 10B,A02,083208,Lim; Seonhee,9,0,35,26
1657290494962,MATH 10B,A03,093472,Lim; Seonhee,5,0,34,29
1657290494962,MATH 10B,B01,083739,Sinha; Shubham,11,0,30,19
1657290500987,MATH 18,A01,083743,Cinel; Cameron Alexander,6,0,30,24
1657290500987,MATH 18,A02,083744,Cinel; Cameron Alexander,17,0,30,13
1657290500987,MATH 18,A03,083745,Cinel; Cameron Alexander,8,0,30,22
1657290500987,MATH 18,B01,083748,Rideout; David Porter,4,0,37,33
1657290500987,MATH 18,B02,083749,Rideout; David Porter,4,0,36,32
1657290500987,MATH 18,B03,083750,Rideout; David Porter,2,0,37,35
1657290500987,MATH 18,B04,083751,Rideout; David Porter,6,0,36,30
1657290500987,MATH 18,B05,093473,Rideout; David Porter,5,0,36,31
1657290500987,MATH 18,B06,093474,Rideout; David Porter,5,0,36,31
1657290507009,MATH 20A,A01,083754,Zheng; Zequn,14,0,40,26
1657290513034,MATH 20B,A01,083756,Briones; Jor-el Thomas Caparas,3,0,36,33
1657290513034,MATH 20B,A02,083757,Briones; Jor-el Thomas Caparas,1,0,36,35
1657290513034,MATH 20B,A03,093475,Briones; Jor-el Thomas Caparas,2,0,36,34
1657290519067,MATH 20C,A01,083760,Briones; Jor-el Thomas Caparas,1,0,35,34
1657290519067,MATH 20C,A02,083761,Briones; Jor-el Thomas Caparas,8,0,35,27
1657290519067,MATH 20C,A03,093476,Briones; Jor-el Thomas Caparas,0,1,36,36
1657290519067,MATH 20C,B01,083762,Bach; Quang Tran,1,0,30,29
1657290525091,MATH 20D,A01,083765,Tran; Brian Kha,5,0,30,25
1657290525091,MATH 20D,A02,083766,Tran; Brian Kha,5,0,30,25
1657290525091,MATH 20D,A03,083767,Tran; Brian Kha,4,0,30,26
1657290531120,MATH 20E,A01,083771,Ganguly; Soumya,7,0,32,25
1657290531120,MATH 20E,A02,083772,Ganguly; Soumya,7,0,32,25
1657290531120,MATH 20E,B01,083773,Ciotti; Benjamin,19,0,35,16
1657290531120,MATH 20E,B02,083774,Ciotti; Benjamin,17,0,35,18
1657290537148,MATH 103A,A01,083777,Greenfeld; Be'Eri,3,0,36,33
1657290537148,MATH 103A,A02,083778,Greenfeld; Be'Eri,5,0,36,31
1657290537148,MATH 103A,A03,093561,Greenfeld; Be'Eri,4,0,36,32
1657290537148,MATH 103A,B01,083779,Greenfeld; Be'Eri,6,0,36,30
1657290537148,MATH 103A,B02,083780,Greenfeld; Be'Eri,3,0,36,33
1657290537148,MATH 103A,B03,093562,Greenfeld; Be'Eri,3,0,36,33
1657290543174,MATH 105,A01,085443,Carter; Anne Toulson,15,0,35,20
1657290543174,MATH 105,A02,093477,Carter; Anne Toulson,20,0,35,15
1657290549203,MATH 109,A01,083213,Ganzberger; Geoffrey Michael,2,0,34,32
1657290549203,MATH 109,A02,083214,Ganzberger; Geoffrey Michael,4,0,34,30
1657290549203,MATH 109,A03,093478,Ganzberger; Geoffrey Michael,2,0,34,32
1657290549203,MATH 109,B01,083215,Ganzberger; Geoffrey Michael,1,0,32,31
1657290549203,MATH 109,B02,083216,Ganzberger; Geoffrey Michael,1,0,32,31
1657290549203,MATH 109,B03,093479,Ganzberger; Geoffrey Michael,8,0,32,24
1657290555230,MATH 142A,A01,083219,Chow; Bennett,7,0,32,25
1657290555230,MATH 142A,A02,083220,Chow; Bennett,10,0,32,22
1657290555230,MATH 142A,A03,093480,Chow; Bennett,7,0,32,25
1657290555230,MATH 142A,B03,093481,Chow; Bennett,8,0,32,24
1657290555230,MATH 142A,B04,093558,Chow; Bennett,12,0,32,20
1657290555230,MATH 142A,B05,093559,Chow; Bennett,6,0,32,26
1657290561257,MATH 193A,A01,083224,Rotar; Vladimir,7,0,34,27
1657290561257,MATH 193A,A02,083225,Rotar; Vladimir,6,0,34,28
1657290561257,MATH 193A,A03,083781,Rotar; Vladimir,2,0,34,32
1657290561257,MATH 193A,A04,083782,Rotar; Vladimir,8,0,34,26
1657290561257,MATH 193A,A05,093482,Rotar; Vladimir,6,0,34,28
1657290567282,MATH 197,001,091859,McAuley; Julian John,9999,0,9999,0
1657290567282,MATH 197,002,095566,Kedlaya; Kiran S.,9997,0,9999,2
1657290567282,MATH 197,003,095567,Xiao; Ming,9999,0,9999,0
1657290567282,MATH 197,004,095571,Perols; Johan Lars,9998,0,9999,1
1657290574337,COGS 9,A01,083615,Shannon; Kyle Michael,8,0,75,67
1657290580361,COGS 11,A01,083617,Boyle; Mary E. T.,22,0,48,26
1657290586386,COGS 13,A01,083071,Bastos; Amalia Pinkusfeld,9,0,71,62
1657290592416,COGS 14A,A01,092681,Semenuks; Arturs,2,1,100,98
1657290598440,COGS 14B,A01,083073,Cheng; Tzu-Han,6,0,63,57
1657290604477,COGS 17,A01,092677,Semenuks; Arturs,5,0,81,76
1657290610501,COGS 100,A01,083619,Allen; Michael Gordon,16,0,70,54
1657290616562,COGS 101A,A01,083621,Davis; Joshua Daniel,9,0,68,59
1657290622586,COGS 101B,A01,091572,Allen; Michael Gordon,11,0,65,54
1657290628608,COGS 101C,A01,083625,Delgado; Tania,17,0,35,18
1657290634644,COGS 107A,A01,083627,Boyle; Mary E. T.,13,0,60,47
1657290640676,COGS 118A,A01,083075,Gupta; Anjum,18,0,76,58
1657290646709,CSE 3,A50,083646,Miranda; Gregory Joseph,24,0,50,26
1657290652735,CSE 8A,A50,083650,Miranda; Gregory Joseph,17,1,56,39
1657290658757,CSE 11,A01,083080,Cao; Yingjun,5,15,40,35
1657290664784,CSE 12,A01,083652,Krause-Levy; Sophia Louisa,26,1,120,94
1657290670810,CSE 15L,A01,083654,Morris; Justin Loren,9,0,50,41
1657290670810,CSE 15L,A02,083655,Morris; Justin Loren,9,0,50,41
1657290676832,CSE 20,A01,083657,Tran; Khoa Dang,38,0,80,42
1657290682857,CSE 21,A01,095574,Bach; Quang Tran,22,0,48,26
1657290688884,CSE 30,A01,083084,Eldon; John,4,0,80,76
1657290688884,CSE 30,B01,095061,Bhaskar; Nishant,8,0,50,42
1657290694911,CSE 100,A01,083659,Cao; Yingjun,4,4,70,66
1657290700938,CSE 134B,A01,083661,Powell; Thomas Allan,21,0,100,79
1657290706963,CSE 140,A01,083663,Gungor; Onat,13,0,85,72
1657290712987,CSE 140L,A01,083088,Eldon; John,19,0,100,81
1657290719010,CSE 175,A01,083665,Kumar; Rakesh,3,0,25,22
1657290725033,CSE 190,A00,092507,Dubnov; Shlomo,7,0,20,13
1657290731060,ECE 45,A01,083139,Congero; Spencer William,5,0,75,70
1657290737084,ECE 65,A50,083695,Saad; Andrew S,12,0,30,18
1657290737084,ECE 65,A51,095125,Saad; Andrew S,25,0,26,1
1657290743111,ECE 109,A01,091882,Touri; Behrouz,19,0,70,51
1657290749136,ECE 180,A00,083140,Abi Samra; Nicholas Camill,1,0,30,29
1657290749136,ECE 180,B00,083141,Abi Samra; Nicholas Camill,0,0,30,30
1657290755162,MATH 10A,A01,083735,Patchell; Gregory David,2,0,30,28
1657290755162,MATH 10A,A02,083736,Patchell; Gregory David,20,0,30,10
1657290755162,MATH 10A,A03,083737,Patchell; Gregory David,16,0,30,14
1657290761197,MATH 10B,A01,083207,Lim; Seonhee,7,0,34,27
1657290761197,MATH 10B,A02,083208,Lim; Seonhee,9,0,35,26
1657290761197,MATH 10B,A03,093472,Lim; Seonhee,5,0,34,29
1657290761197,MATH 10B,B01,083739,Sinha; Shubham,11,0,30,19
1657290767222,MATH 18,A01,083743,Cinel; Cameron Alexander,6,0,30,24
1657290767222,MATH 18,A02,083744,Cinel; Cameron Alexander,17,0,30,13
1657290767222,MATH 18,A03,083745,Cinel; Cameron Alexander,8,0,30,22
1657290767222,MATH 18,B01,083748,Rideout; David Porter,4,0,37,33
1657290767222,MATH 18,B02,083749,Rideout; David Porter,4,0,36,32
1657290767222,MATH 18,B03,083750,Rideout; David Porter,2,0,37,35
1657290767222,MATH 18,B04,083751,Rideout; David Porter,6,0,36,30
1657290767222,MATH 18,B05,093473,Rideout; David Porter,5,0,36,31
1657290767222,MATH 18,B06,093474,Rideout; David Porter,5,0,36,31
1657290773273,MATH 20A,A01,083754,Zheng; Zequn,14,0,40,26
1657290779298,MATH 20B,A01,083756,Briones; Jor-el Thomas Caparas,3,0,36,33
1657290779298,MATH 20B,A02,083757,Briones; Jor-el Thomas Caparas,1,0,36,35
1657290779298,MATH 20B,A03,093475,Briones; Jor-el Thomas Caparas,2,0,36,34
1657290785328,MATH 20C,A01,083760,Briones; Jor-el Thomas Caparas,1,0,35,34
1657290785328,MATH 20C,A02,083761,Briones; Jor-el Thomas Caparas,8,0,35,27
1657290785328,MATH 20C,A03,093476,Briones; Jor-el Thomas Caparas,0,1,36,36
1657290785328,MATH 20C,B01,083762,Bach; Quang Tran,1,0,30,29
1657290791425,MATH 20D,A01,083765,Tran; Brian Kha,5,0,30,25
1657290791425,MATH 20D,A02,083766,Tran; Brian Kha,5,0,30,25
1657290791425,MATH 20D,A03,083767,Tran; Brian Kha,4,0,30,26
1657290797449,MATH 20E,A01,083771,Ganguly; Soumya,7,0,32,25
1657290797449,MATH 20E,A02,083772,Ganguly; Soumya,7,0,32,25
1657290797449,MATH 20E,B01,083773,Ciotti; Benjamin,19,0,35,16
1657290797449,MATH 20E,B02,083774,Ciotti; Benjamin,17,0,35,18
1657290803493,MATH 103A,A01,083777,Greenfeld; Be'Eri,3,0,36,33
1657290803493,MATH 103A,A02,083778,Greenfeld; Be'Eri,5,0,36,31
1657290803493,MATH 103A,A03,093561,Greenfeld; Be'Eri,4,0,36,32
1657290803493,MATH 103A,B01,083779,Greenfeld; Be'Eri,6,0,36,30
1657290803493,MATH 103A,B02,083780,Greenfeld; Be'Eri,3,0,36,33
1657290803493,MATH 103A,B03,093562,Greenfeld; Be'Eri,3,0,36,33
1657290809515,MATH 105,A01,085443,Carter; Anne Toulson,15,0,35,20
1657290809515,MATH 105,A02,093477,Carter; Anne Toulson,20,0,35,15
1657290815545,MATH 109,A01,083213,Ganzberger; Geoffrey Michael,2,0,34,32
1657290815545,MATH 109,A02,083214,Ganzberger; Geoffrey Michael,4,0,34,30
1657290815545,MATH 109,A03,093478,Ganzberger; Geoffrey Michael,2,0,34,32
1657290815545,MATH 109,B01,083215,Ganzberger; Geoffrey Michael,1,0,32,31
1657290815545,MATH 109,B02,083216,Ganzberger; Geoffrey Michael,1,0,32,31
1657290815545,MATH 109,B03,093479,Ganzberger; Geoffrey Michael,8,0,32,24
1657290821574,MATH 142A,A01,083219,Chow; Bennett,7,0,32,25
1657290821574,MATH 142A,A02,083220,Chow; Bennett,10,0,32,22
1657290821574,MATH 142A,A03,093480,Chow; Bennett,7,0,32,25
1657290821574,MATH 142A,B03,093481,Chow; Bennett,8,0,32,24
1657290821574,MATH 142A,B04,093558,Chow; Bennett,12,0,32,20
1657290821574,MATH 142A,B05,093559,Chow; Bennett,6,0,32,26
1657290827597,MATH 193A,A01,083224,Rotar; Vladimir,7,0,34,27
1657290827597,MATH 193A,A02,083225,Rotar; Vladimir,6,0,34,28
1657290827597,MATH 193A,A03,083781,Rotar; Vladimir,2,0,34,32
1657290827597,MATH 193A,A04,083782,Rotar; Vladimir,8,0,34,26
1657290827597,MATH 193A,A05,093482,Rotar; Vladimir,6,0,34,28
1657290833621,MATH 197,001,091859,McAuley; Julian John,9999,0,9999,0
1657290833621,MATH 197,002,095566,Kedlaya; Kiran S.,9997,0,9999,2
1657290833621,MATH 197,003,095567,Xiao; Ming,9999,0,9999,0
1657290833621,MATH 197,004,095571,Perols; Johan Lars,9998,0,9999,1
1657290840676,COGS 9,A01,083615,Shannon; Kyle Michael,8,0,75,67
1657290846704,COGS 11,A01,083617,Boyle; Mary E. T.,22,0,48,26
1657290852730,COGS 13,A01,083071,Bastos; Amalia Pinkusfeld,9,0,71,62
1657290858759,COGS 14A,A01,092681,Semenuks; Arturs,2,1,100,98
1657290864787,COGS 14B,A01,083073,Cheng; Tzu-Han,6,0,63,57
1657290870811,COGS 17,A01,092677,Semenuks; Arturs,5,0,81,76
1657290876834,COGS 100,A01,083619,Allen; Michael Gordon,16,0,70,54
1657290882858,COGS 101A,A01,083621,Davis; Joshua Daniel,9,0,68,59
1657290888882,COGS 101B,A01,091572,Allen; Michael Gordon,11,0,65,54
1657290894911,COGS 101C,A01,083625,Delgado; Tania,17,0,35,18
1657290900968,COGS 107A,A01,083627,Boyle; Mary E. T.,13,0,60,47
1657290907001,COGS 118A,A01,083075,Gupta; Anjum,18,0,76,58
1657290913025,CSE 3,A50,083646,Miranda; Gregory Joseph,24,0,50,26
1657290919050,CSE 8A,A50,083650,Miranda; Gregory Joseph,17,1,56,39
1657290925077,CSE 11,A01,083080,Cao; Yingjun,5,15,40,35
1657290931104,CSE 12,A01,083652,Krause-Levy; Sophia Louisa,26,1,120,94
1657290937131,CSE 15L,A01,083654,Morris; Justin Loren,9,0,50,41
1657290937131,CSE 15L,A02,083655,Morris; Justin Loren,9,0,50,41
1657290943158,CSE 20,A01,083657,Tran; Khoa Dang,38,0,80,42
1657290949193,CSE 21,A01,095574,Bach; Quang Tran,22,0,48,26
1657290955216,CSE 30,A01,083084,Eldon; John,4,0,80,76
1657290955216,CSE 30,B01,095061,Bhaskar; Nishant,8,0,50,42
1657290961241,CSE 100,A01,083659,Cao; Yingjun,4,4,70,66
1657290967264,CSE 134B,A01,083661,Powell; Thomas Allan,21,0,100,79
1657290973287,CSE 140,A01,083663,Gungor; Onat,13,0,85,72
1657290979312,CSE 140L,A01,083088,Eldon; John,19,0,100,81
1657290985336,CSE 175,A01,083665,Kumar; Rakesh,3,0,25,22
1657290991363,CSE 190,A00,092507,Dubnov; Shlomo,7,0,20,13
1657290997386,ECE 45,A01,083139,Congero; Spencer William,5,0,75,70
1657291003411,ECE 65,A50,083695,Saad; Andrew S,12,0,30,18
1657291003411,ECE 65,A51,095125,Saad; Andrew S,25,0,26,1
1657291009438,ECE 109,A01,091882,Touri; Behrouz,19,0,70,51
1657291015462,ECE 180,A00,083140,Abi Samra; Nicholas Camill,1,0,30,29
1657291015462,ECE 180,B00,083141,Abi Samra; Nicholas Camill,0,0,30,30
1657291021489,MATH 10A,A01,083735,Patchell; Gregory David,2,0,30,28
1657291021489,MATH 10A,A02,083736,Patchell; Gregory David,20,0,30,10
1657291021489,MATH 10A,A03,083737,Patchell; Gregory David,16,0,30,14
1657291027518,MATH 10B,A01,083207,Lim; Seonhee,7,0,34,27
1657291027518,MATH 10B,A02,083208,Lim; Seonhee,9,0,35,26
1657291027518,MATH 10B,A03,093472,Lim; Seonhee,5,0,34,29
1657291027518,MATH 10B,B01,083739,Sinha; Shubham,11,0,30,19
1657291033560,MATH 18,A01,083743,Cinel; Cameron Alexander,6,0,30,24
1657291033560,MATH 18,A02,083744,Cinel; Cameron Alexander,17,0,30,13
1657291033560,MATH 18,A03,083745,Cinel; Cameron Alexander,8,0,30,22
1657291033560,MATH 18,B01,083748,Rideout; David Porter,4,0,37,33
1657291033560,MATH 18,B02,083749,Rideout; David Porter,4,0,36,32
1657291033560,MATH 18,B03,083750,Rideout; David Porter,2,0,37,35
1657291033560,MATH 18,B04,083751,Rideout; David Porter,6,0,36,30
1657291033560,MATH 18,B05,093473,Rideout; David Porter,5,0,36,31
1657291033560,MATH 18,B06,093474,Rideout; David Porter,5,0,36,31
1657291039584,MATH 20A,A01,083754,Zheng; Zequn,14,0,40,26
1657291045618,MATH 20B,A01,083756,Briones; Jor-el Thomas Caparas,3,0,36,33
1657291045618,MATH 20B,A02,083757,Briones; Jor-el Thomas Caparas,1,0,36,35
1657291045618,MATH 20B,A03,093475,Briones; Jor-el Thomas Caparas,2,0,36,34
1657291051646,MATH 20C,A01,083760,Briones; Jor-el Thomas Caparas,1,0,35,34
1657291051646,MATH 20C,A02,083761,Briones; Jor-el Thomas Caparas,8,0,35,27
1657291051646,MATH 20C,A03,093476,Briones; Jor-el Thomas Caparas,0,1,36,36
1657291051646,MATH 20C,B01,083762,Bach; Quang Tran,1,0,30,29
1657291057681,MATH 20D,A01,083765,Tran; Brian Kha,5,0,30,25
1657291057681,MATH 20D,A02,083766,Tran; Brian Kha,5,0,30,25
1657291057681,MATH 20D,A03,083767,Tran; Brian Kha,4,0,30,26
1657291063711,MATH 20E,A01,083771,Ganguly; Soumya,7,0,32,25
1657291063711,MATH 20E,A02,083772,Ganguly; Soumya,7,0,32,25
1657291063711,MATH 20E,B01,083773,Ciotti; Benjamin,19,0,35,16
1657291063711,MATH 20E,B02,083774,Ciotti; Benjamin,17,0,35,18
1657291069733,MATH 103A,A01,083777,Greenfeld; Be'Eri,3,0,36,33
1657291069733,MATH 103A,A02,083778,Greenfeld; Be'Eri,5,0,36,31
1657291069733,MATH 103A,A03,093561,Greenfeld; Be'Eri,4,0,36,32
1657291069733,MATH 103A,B01,083779,Greenfeld; Be'Eri,6,0,36,30
1657291069733,MATH 103A,B02,083780,Greenfeld; Be'Eri,3,0,36,33
1657291069733,MATH 103A,B03,093562,Greenfeld; Be'Eri,3,0,36,33
1657291075765,MATH 105,A01,085443,Carter; Anne Toulson,15,0,35,20
1657291075765,MATH 105,A02,093477,Carter; Anne Toulson,20,0,35,15
1657291081795,MATH 109,A01,083213,Ganzberger; Geoffrey Michael,2,0,34,32
1657291081795,MATH 109,A02,083214,Ganzberger; Geoffrey Michael,4,0,34,30
1657291081795,MATH 109,A03,093478,Ganzberger; Geoffrey Michael,2,0,34,32
1657291081795,MATH 109,B01,083215,Ganzberger; Geoffrey Michael,1,0,32,31
1657291081795,MATH 109,B02,083216,Ganzberger; Geoffrey Michael,1,0,32,31
1657291081795,MATH 109,B03,093479,Ganzberger; Geoffrey Michael,8,0,32,24
1657291087829,MATH 142A,A01,083219,Chow; Bennett,7,0,32,25
1657291087829,MATH 142A,A02,083220,Chow; Bennett,10,0,32,22
1657291087829,MATH 142A,A03,093480,Chow; Bennett,7,0,32,25
1657291087829,MATH 142A,B03,093481,Chow; Bennett,8,0,32,24
1657291087829,MATH 142A,B04,093558,Chow; Bennett,12,0,32,20
1657291087829,MATH 142A,B05,093559,Chow; Bennett,6,0,32,26
1657291093852,MATH 193A,A01,083224,Rotar; Vladimir,7,0,34,27
1657291093852,MATH 193A,A02,083225,Rotar; Vladimir,6,0,34,28
1657291093852,MATH 193A,A03,083781,Rotar; Vladimir,2,0,34,32
1657291093852,MATH 193A,A04,083782,Rotar; Vladimir,8,0,34,26
1657291093852,MATH 193A,A05,093482,Rotar; Vladimir,6,0,34,28
1657291099875,MATH 197,001,091859,McAuley; Julian John,9999,0,9999,0
1657291099875,MATH 197,002,095566,Kedlaya; Kiran S.,9997,0,9999,2
1657291099875,MATH 197,003,095567,Xiao; Ming,9999,0,9999,0
1657291099875,MATH 197,004,095571,Perols; Johan Lars,9998,0,9999,1
1657291106929,COGS 9,A01,083615,Shannon; Kyle Michael,8,0,75,67
1657291112958,COGS 11,A01,083617,Boyle; Mary E. T.,22,0,48,26
1657291118982,COGS 13,A01,083071,Bastos; Amalia Pinkusfeld,9,0,71,62
1657291125009,COGS 14A,A01,092681,Semenuks; Arturs,2,1,100,98
1657291131032,COGS 14B,A01,083073,Cheng; Tzu-Han,6,0,63,57
1657291137057,COGS 17,A01,092677,Semenuks; Arturs,5,0,81,76
1657291143083,COGS 100,A01,083619,Allen; Michael Gordon,16,0,70,54
1657291149111,COGS 101A,A01,083621,Davis; Joshua Daniel,9,0,68,59
1657291155136,COGS 101B,A01,091572,Allen; Michael Gordon,11,0,65,54
1657291161165,COGS 101C,A01,083625,Delgado; Tania,17,0,35,18
1657291167190,COGS 107A,A01,083627,Boyle; Mary E. T.,13,0,60,47
1657291173212,COGS 118A,A01,083075,Gupta; Anjum,18,0,76,58
1657291179240,CSE 3,A50,083646,Miranda; Gregory Joseph,24,0,50,26
1657291185265,CSE 8A,A50,083650,Miranda; Gregory Joseph,17,1,56,39
1657291191309,CSE 11,A01,083080,Cao; Yingjun,5,15,40,35
1657291197338,CSE 12,A01,083652,Krause-Levy; Sophia Louisa,26,1,120,94
1657291203361,CSE 15L,A01,083654,Morris; Justin Loren,9,0,50,41
1657291203361,CSE 15L,A02,083655,Morris; Justin Loren,9,0,50,41
1657291209385,CSE 20,A01,083657,Tran; Khoa Dang,38,0,80,42
1657291215413,CSE 21,A01,095574,Bach; Quang Tran,22,0,48,26
1657291221444,CSE 30,A01,083084,Eldon; John,4,0,80,76
1657291221444,CSE 30,B01,095061,Bhaskar; Nishant,8,0,50,42
1657291227474,CSE 100,A01,083659,Cao; Yingjun,4,4,70,66
1657291233503,CSE 134B,A01,083661,Powell; Thomas Allan,21,0,100,79
1657291239527,CSE 140,A01,083663,Gungor; Onat,13,0,85,72
1657291245552,CSE 140L,A01,083088,Eldon; John,19,0,100,81
1657291251591,CSE 175,A01,083665,Kumar; Rakesh,3,0,25,22
1657291257615,CSE 190,A00,092507,Dubnov; Shlomo,7,0,20,13
1657291263639,ECE 45,A01,083139,Congero; Spencer William,5,0,75,70
1657291269668,ECE 65,A50,083695,Saad; Andrew S,12,0,30,18
1657291269668,ECE 65,A51,095125,Saad; Andrew S,25,0,26,1
1657291275696,ECE 109,A01,091882,Touri; Behrouz,19,0,70,51
1657291281719,ECE 180,A00,083140,Abi Samra; Nicholas Camill,1,0,30,29
1657291281719,ECE 180,B00,083141,Abi Samra; Nicholas Camill,0,0,30,30
1657291287744,MATH 10A,A01,083735,Patchell; Gregory David,2,0,30,28
1657291287744,MATH 10A,A02,083736,Patchell; Gregory David,20,0,30,10
1657291287744,MATH 10A,A03,083737,Patchell; Gregory David,16,0,30,14
1657291293773,MATH 10B,A01,083207,Lim; Seonhee,7,0,34,27
1657291293773,MATH 10B,A02,083208,Lim; Seonhee,9,0,35,26
1657291293773,MATH 10B,A03,093472,Lim; Seonhee,5,0,34,29
1657291293773,MATH 10B,B01,083739,Sinha; Shubham,11,0,30,19
1657291299800,MATH 18,A01,083743,Cinel; Cameron Alexander,6,0,30,24
1657291299800,MATH 18,A02,083744,Cinel; Cameron Alexander,17,0,30,13
1657291299800,MATH 18,A03,083745,Cinel; Cameron Alexander,8,0,30,22
1657291299800,MATH 18,B01,083748,Rideout; David Porter,4,0,37,33
1657291299800,MATH 18,B02,083749,Rideout; David Porter,4,0,36,32
1657291299800,MATH 18,B03,083750,Rideout; David Porter,2,0,37,35
1657291299800,MATH 18,B04,083751,Rideout; David Porter,6,0,36,30
1657291299800,MATH 18,B05,093473,Rideout; David Porter,5,0,36,31
1657291299800,MATH 18,B06,093474,Rideout; David Porter,5,0,36,31
1657291305828,MATH 20A,A01,083754,Zheng; Zequn,14,0,40,26
1657291311856,MATH 20B,A01,083756,Briones; Jor-el Thomas Caparas,3,0,36,33
1657291311856,MATH 20B,A02,083757,Briones; Jor-el Thomas Caparas,1,0,36,35
1657291311856,MATH 20B,A03,093475,Briones; Jor-el Thomas Caparas,2,0,36,34
1657291317884,MATH 20C,A01,083760,Briones; Jor-el Thomas Caparas,1,0,35,34
1657291317884,MATH 20C,A02,083761,Briones; Jor-el Thomas Caparas,8,0,35,27
1657291317884,MATH 20C,A03,093476,Briones; Jor-el Thomas Caparas,0,1,36,36
1657291317884,MATH 20C,B01,083762,Bach; Quang Tran,1,0,30,29
1657291323909,MATH 20D,A01,083765,Tran; Brian Kha,5,0,30,25
1657291323909,MATH 20D,A02,083766,Tran; Brian Kha,5,0,30,25
1657291323909,MATH 20D,A03,083767,Tran; Brian Kha,4,0,30,26
1657291329934,MATH 20E,A01,083771,Ganguly; Soumya,7,0,32,25
1657291329934,MATH 20E,A02,083772,Ganguly; Soumya,7,0,32,25
1657291329934,MATH 20E,B01,083773,Ciotti; Benjamin,19,0,35,16
1657291329934,MATH 20E,B02,083774,Ciotti; Benjamin,17,0,35,18
1657291335973,MATH 103A,A01,083777,Greenfeld; Be'Eri,3,0,36,33
1657291335973,MATH 103A,A02,083778,Greenfeld; Be'Eri,5,0,36,31
1657291335973,MATH 103A,A03,093561,Greenfeld; Be'Eri,4,0,36,32
1657291335973,MATH 103A,B01,083779,Greenfeld; Be'Eri,6,0,36,30
1657291335973,MATH 103A,B02,083780,Greenfeld; Be'Eri,3,0,36,33
1657291335973,MATH 103A,B03,093562,Greenfeld; Be'Eri,3,0,36,33
1657291342004,MATH 105,A01,085443,Carter; Anne Toulson,15,0,35,20
1657291342004,MATH 105,A02,093477,Carter; Anne Toulson,20,0,35,15
1657291348034,MATH 109,A01,083213,Ganzberger; Geoffrey Michael,2,0,34,32
1657291348034,MATH 109,A02,083214,Ganzberger; Geoffrey Michael,4,0,34,30
1657291348034,MATH 109,A03,093478,Ganzberger; Geoffrey Michael,2,0,34,32
1657291348034,MATH 109,B01,083215,Ganzberger; Geoffrey Michael,1,0,32,31
1657291348034,MATH 109,B02,083216,Ganzberger; Geoffrey Michael,1,0,32,31
1657291348034,MATH 109,B03,093479,Ganzberger; Geoffrey Michael,8,0,32,24
1657291354064,MATH 142A,A01,083219,Chow; Bennett,7,0,32,25
1657291354064,MATH 142A,A02,083220,Chow; Bennett,10,0,32,22
1657291354064,MATH 142A,A03,093480,Chow; Bennett,7,0,32,25
1657291354064,MATH 142A,B03,093481,Chow; Bennett,8,0,32,24
1657291354064,MATH 142A,B04,093558,Chow; Bennett,12,0,32,20
1657291354064,MATH 142A,B05,093559,Chow; Bennett,6,0,32,26
1657291360091,MATH 193A,A01,083224,Rotar; Vladimir,7,0,34,27
1657291360091,MATH 193A,A02,083225,Rotar; Vladimir,6,0,34,28
1657291360091,MATH 193A,A03,083781,Rotar; Vladimir,2,0,34,32
1657291360091,MATH 193A,A04,083782,Rotar; Vladimir,8,0,34,26
1657291360091,MATH 193A,A05,093482,Rotar; Vladimir,6,0,34,28
1657291366125,MATH 197,001,091859,McAuley; Julian John,9999,0,9999,0
1657291366125,MATH 197,002,095566,Kedlaya; Kiran S.,9997,0,9999,2
1657291366125,MATH 197,003,095567,Xiao; Ming,9999,0,9999,0
1657291366125,MATH 197,004,095571,Perols; Johan Lars,9998,0,9999,1
1657291373198,COGS 9,A01,083615,Shannon; Kyle Michael,8,0,75,67
1657291379223,COGS 11,A01,083617,Boyle; Mary E. T.,22,0,48,26
1657291385319,COGS 13,A01,083071,Bastos; Amalia Pinkusfeld,9,0,71,62
1657291391344,COGS 14A,A01,092681,Semenuks; Arturs,2,1,100,98
1657291397368,COGS 14B,A01,083073,Cheng; Tzu-Han,6,0,63,57
1657291403396,COGS 17,A01,092677,Semenuks; Arturs,5,0,81,76
1657291409420,COGS 100,A01,083619,Allen; Michael Gordon,16,0,70,54
1657291415441,COGS 101A,A01,083621,Davis; Joshua Daniel,9,0,68,59
1657291421468,COGS 101B,A01,091572,Allen; Michael Gordon,11,0,65,54
1657291427498,COGS 101C,A01,083625,Delgado; Tania,17,0,35,18
1657291433520,COGS 107A,A01,083627,Boyle; Mary E. T.,13,0,60,47
1657291439544,COGS 118A,A01,083075,Gupta; Anjum,18,0,76,58
1657291445575,CSE 3,A50,083646,Miranda; Gregory Joseph,24,0,50,26
1657291451598,CSE 8A,A50,083650,Miranda; Gregory Joseph,17,1,56,39
1657291457623,CSE 11,A01,083080,Cao; Yingjun,5,15,40,35
1657291463651,CSE 12,A01,083652,Krause-Levy; Sophia Louisa,26,1,120,94
1657291469675,CSE 15L,A01,083654,Morris; Justin Loren,9,0,50,41
1657291469675,CSE 15L,A02,083655,Morris; Justin Loren,9,0,50,41
1657291475701,CSE 20,A01,083657,Tran; Khoa Dang,38,0,80,42
1657291481725,CSE 21,A01,095574,Bach; Quang Tran,22,0,48,26
1657291487755,CSE 30,A01,083084,Eldon; John,4,0,80,76
1657291487755,CSE 30,B01,095061,Bhaskar; Nishant,8,0,50,42
1657291493780,CSE 100,A01,083659,Cao; Yingjun,4,4,70,66
1657291499807,CSE 134B,A01,083661,Powell; Thomas Allan,21,0,100,79
1657291505838,CSE 140,A01,083663,Gungor; Onat,13,0,85,72
1657291511866,CSE 140L,A01,083088,Eldon; John,19,0,100,81
1657291517891,CSE 175,A01,083665,Kumar; Rakesh,3,0,25,22
1657291523915,CSE 190,A00,092507,Dubnov; Shlomo,7,0,20,13
1657291529947,ECE 45,A01,083139,Congero; Spencer William,5,0,75,70
1657291535986,ECE 65,A50,083695,Saad; Andrew S,12,0,30,18
1657291535986,ECE 65,A51,095125,Saad; Andrew S,25,0,26,1
1657291542010,ECE 109,A01,091882,Touri; Behrouz,19,0,70,51
1657291548038,ECE 180,A00,083140,Abi Samra; Nicholas Camill,1,0,30,29
1657291548038,ECE 180,B00,083141,Abi Samra; Nicholas Camill,0,0,30,30
1657291554065,MATH 10A,A01,083735,Patchell; Gregory David,2,0,30,28
1657291554065,MATH 10A,A02,083736,Patchell; Gregory David,20,0,30,10
1657291554065,MATH 10A,A03,083737,Patchell; Gregory David,16,0,30,14
1657291560090,MATH 10B,A01,083207,Lim; Seonhee,7,0,34,27
1657291560090,MATH 10B,A02,083208,Lim; Seonhee,9,0,35,26
1657291560090,MATH 10B,A03,093472,Lim; Seonhee,5,0,34,29
1657291560090,MATH 10B,B01,083739,Sinha; Shubham,11,0,30,19
1657291566117,MATH 18,A01,083743,Cinel; Cameron Alexander,6,0,30,24
1657291566117,MATH 18,A02,083744,Cinel; Cameron Alexander,17,0,30,13
1657291566117,MATH 18,A03,083745,Cinel; Cameron Alexander,8,0,30,22
1657291566117,MATH 18,B01,083748,Rideout; David Porter,4,0,37,33
1657291566117,MATH 18,B02,083749,Rideout; David Porter,4,0,36,32
1657291566117,MATH 18,B03,083750,Rideout; David Porter,2,0,37,35
1657291566117,MATH 18,B04,083751,Rideout; David Porter,6,0,36,30
1657291566117,MATH 18,B05,093473,Rideout; David Porter,5,0,36,31
1657291566117,MATH 18,B06,093474,Rideout; David Porter,5,0,36,31
1657291572143,MATH 20A,A01,083754,Zheng; Zequn,14,0,40,26
1657291578168,MATH 20B,A01,083756,Briones; Jor-el Thomas Caparas,3,0,36,33
1657291578168,MATH 20B,A02,083757,Briones; Jor-el Thomas Caparas,1,0,36,35
1657291578168,MATH 20B,A03,093475,Briones; Jor-el Thomas Caparas,2,0,36,34
1657291584199,MATH 20C,A01,083760,Briones; Jor-el Thomas Caparas,1,0,35,34
1657291584199,MATH 20C,A02,083761,Briones; Jor-el Thomas Caparas,8,0,35,27
1657291584199,MATH 20C,A03,093476,Briones; Jor-el Thomas Caparas,0,1,36,36
1657291584199,MATH 20C,B01,083762,Bach; Quang Tran,1,0,30,29
1657291590233,MATH 20D,A01,083765,Tran; Brian Kha,5,0,30,25
1657291590233,MATH 20D,A02,083766,Tran; Brian Kha,5,0,30,25
1657291590233,MATH 20D,A03,083767,Tran; Brian Kha,4,0,30,26
1657291596265,MATH 20E,A01,083771,Ganguly; Soumya,7,0,32,25
1657291596265,MATH 20E,A02,083772,Ganguly; Soumya,7,0,32,25
1657291596265,MATH 20E,B01,083773,Ciotti; Benjamin,19,0,35,16
1657291596265,MATH 20E,B02,083774,Ciotti; Benjamin,17,0,35,18
1657291602295,MATH 103A,A01,083777,Greenfeld; Be'Eri,3,0,36,33
1657291602295,MATH 103A,A02,083778,Greenfeld; Be'Eri,5,0,36,31
1657291602295,MATH 103A,A03,093561,Greenfeld; Be'Eri,4,0,36,32
1657291602295,MATH 103A,B01,083779,Greenfeld; Be'Eri,6,0,36,30
1657291602295,MATH 103A,B02,083780,Greenfeld; Be'Eri,3,0,36,33
1657291602295,MATH 103A,B03,093562,Greenfeld; Be'Eri,3,0,36,33
1657291608318,MATH 105,A01,085443,Carter; Anne Toulson,15,0,35,20
1657291608318,MATH 105,A02,093477,Carter; Anne Toulson,20,0,35,15
1657291614349,MATH 109,A01,083213,Ganzberger; Geoffrey Michael,2,0,34,32
1657291614349,MATH 109,A02,083214,Ganzberger; Geoffrey Michael,4,0,34,30
1657291614349,MATH 109,A03,093478,Ganzberger; Geoffrey Michael,2,0,34,32
1657291614349,MATH 109,B01,083215,Ganzberger; Geoffrey Michael,1,0,32,31
1657291614349,MATH 109,B02,083216,Ganzberger; Geoffrey Michael,1,0,32,31
1657291614349,MATH 109,B03,093479,Ganzberger; Geoffrey Michael,8,0,32,24
1657291620379,MATH 142A,A01,083219,Chow; Bennett,7,0,32,25
1657291620379,MATH 142A,A02,083220,Chow; Bennett,10,0,32,22
1657291620379,MATH 142A,A03,093480,Chow; Bennett,7,0,32,25
1657291620379,MATH 142A,B03,093481,Chow; Bennett,8,0,32,24
1657291620379,MATH 142A,B04,093558,Chow; Bennett,12,0,32,20
1657291620379,MATH 142A,B05,093559,Chow; Bennett,6,0,32,26
1657291626409,MATH 193A,A01,083224,Rotar; Vladimir,7,0,34,27
1657291626409,MATH 193A,A02,083225,Rotar; Vladimir,6,0,34,28
1657291626409,MATH 193A,A03,083781,Rotar; Vladimir,2,0,34,32
1657291626409,MATH 193A,A04,083782,Rotar; Vladimir,8,0,34,26
1657291626409,MATH 193A,A05,093482,Rotar; Vladimir,6,0,34,28
1657291632437,MATH 197,001,091859,McAuley; Julian John,9999,0,9999,0
1657291632437,MATH 197,002,095566,Kedlaya; Kiran S.,9997,0,9999,2
1657291632437,MATH 197,003,095567,Xiao; Ming,9999,0,9999,0
1657291632437,MATH 197,004,095571,Perols; Johan Lars,9998,0,9999,1
1657291639501,COGS 9,A01,083615,Shannon; Kyle Michael,8,0,75,67
1657291645524,COGS 11,A01,083617,Boyle; Mary E. T.,22,0,48,26
1657291651554,COGS 13,A01,083071,Bastos; Amalia Pinkusfeld,9,0,71,62
1657291657582,COGS 14A,A01,092681,Semenuks; Arturs,2,1,100,98
1657291663607,COGS 14B,A01,083073,Cheng; Tzu-Han,6,0,63,57
1657291669633,COGS 17,A01,092677,Semenuks; Arturs,5,0,81,76
1657291675673,COGS 100,A01,083619,Allen; Michael Gordon,16,0,70,54
1657291681697,COGS 101A,A01,083621,Davis; Joshua Daniel,9,0,68,59
1657291687723,COGS 101B,A01,091572,Allen; Michael Gordon,11,0,65,54
1657291693746,COGS 101C,A01,083625,Delgado; Tania,17,0,35,18
1657291699770,COGS 107A,A01,083627,Boyle; Mary E. T.,13,0,60,47
1657291705796,COGS 118A,A01,083075,Gupta; Anjum,18,0,76,58
1657291711821,CSE 3,A50,083646,Miranda; Gregory Joseph,24,0,50,26
1657291717847,CSE 8A,A50,083650,Miranda; Gregory Joseph,17,1,56,39
1657291723882,CSE 11,A01,083080,Cao; Yingjun,5,15,40,35
1657291729908,CSE 12,A01,083652,Krause-Levy; Sophia Louisa,26,1,120,94
1657291735935,CSE 15L,A01,083654,Morris; Justin Loren,9,0,50,41
1657291735935,CSE 15L,A02,083655,Morris; Justin Loren,9,0,50,41
1657291741962,CSE 20,A01,083657,Tran; Khoa Dang,38,0,80,42
1657291747986,CSE 21,A01,095574,Bach; Quang Tran,22,0,48,26
1657291754014,CSE 30,A01,083084,Eldon; John,4,0,80,76
1657291754014,CSE 30,B01,095061,Bhaskar; Nishant,8,0,50,42
1657291760041,CSE 100,A01,083659,Cao; Yingjun,4,4,70,66
1657291766065,CSE 134B,A01,083661,Powell; Thomas Allan,21,0,100,79
1657291772092,CSE 140,A01,083663,Gungor; Onat,13,0,85,72
1657291778118,CSE 140L,A01,083088,Eldon; John,19,0,100,81
1657291784143,CSE 175,A01,083665,Kumar; Rakesh,3,0,25,22
1657291790168,CSE 190,A00,092507,Dubnov; Shlomo,7,0,20,13
1657291796202,ECE 45,A01,083139,Congero; Spencer William,5,0,75,70
1657291802231,ECE 65,A50,083695,Saad; Andrew S,12,0,30,18
1657291802231,ECE 65,A51,095125,Saad; Andrew S,25,0,26,1
1657291808254,ECE 109,A01,091882,Touri; Behrouz,19,0,70,51
1657291814278,ECE 180,A00,083140,Abi Samra; Nicholas Camill,1,0,30,29
1657291814278,ECE 180,B00,083141,Abi Samra; Nicholas Camill,0,0,30,30
1657291820306,MATH 10A,A01,083735,Patchell; Gregory David,2,0,30,28
1657291820306,MATH 10A,A02,083736,Patchell; Gregory David,20,0,30,10
1657291820306,MATH 10A,A03,083737,Patchell; Gregory David,16,0,30,14
1657291826329,MATH 10B,A01,083207,Lim; Seonhee,7,0,34,27
1657291826329,MATH 10B,A02,083208,Lim; Seonhee,9,0,35,26
1657291826329,MATH 10B,A03,093472,Lim; Seonhee,5,0,34,29
1657291826329,MATH 10B,B01,083739,Sinha; Shubham,11,0,30,19
1657291832361,MATH 18,A01,083743,Cinel; Cameron Alexander,6,0,30,24
1657291832361,MATH 18,A02,083744,Cinel; Cameron Alexander,17,0,30,13
1657291832361,MATH 18,A03,083745,Cinel; Cameron Alexander,8,0,30,22
1657291832361,MATH 18,B01,083748,Rideout; David Porter,4,0,37,33
1657291832361,MATH 18,B02,083749,Rideout; David Porter,4,0,36,32
1657291832361,MATH 18,B03,083750,Rideout; David Porter,2,0,37,35
1657291832361,MATH 18,B04,083751,Rideout; David Porter,6,0,36,30
1657291832361,MATH 18,B05,093473,Rideout; David Porter,5,0,36,31
1657291832361,MATH 18,B06,093474,Rideout; David Porter,5,0,36,31
1657291838389,MATH 20A,A01,083754,Zheng; Zequn,14,0,40,26
1657291844421,MATH 20B,A01,083756,Briones; Jor-el Thomas Caparas,3,0,36,33
1657291844421,MATH 20B,A02,083757,Briones; Jor-el Thomas Caparas,1,0,36,35
1657291844421,MATH 20B,A03,093475,Briones; Jor-el Thomas Caparas,2,0,36,34
1657291850446,MATH 20C,A01,083760,Briones; Jor-el Thomas Caparas,1,0,35,34
1657291850446,MATH 20C,A02,083761,Briones; Jor-el Thomas Caparas,8,0,35,27
1657291850446,MATH 20C,A03,093476,Briones; Jor-el Thomas Caparas,0,1,36,36
1657291850446,MATH 20C,B01,083762,Bach; Quang Tran,1,0,30,29
1657291856470,MATH 20D,A01,083765,Tran; Brian Kha,5,0,30,25
1657291856470,MATH 20D,A02,083766,Tran; Brian Kha,5,0,30,25
1657291856470,MATH 20D,A03,083767,Tran; Brian Kha,4,0,30,26
1657291862500,MATH 20E,A01,083771,Ganguly; Soumya,7,0,32,25
1657291862500,MATH 20E,A02,083772,Ganguly; Soumya,7,0,32,25
1657291862500,MATH 20E,B01,083773,Ciotti; Benjamin,19,0,35,16
1657291862500,MATH 20E,B02,083774,Ciotti; Benjamin,17,0,35,18
1657291868526,MATH 103A,A01,083777,Greenfeld; Be'Eri,3,0,36,33
1657291868526,MATH 103A,A02,083778,Greenfeld; Be'Eri,5,0,36,31
1657291868526,MATH 103A,A03,093561,Greenfeld; Be'Eri,4,0,36,32
1657291868526,MATH 103A,B01,083779,Greenfeld; Be'Eri,6,0,36,30
1657291868526,MATH 103A,B02,083780,Greenfeld; Be'Eri,3,0,36,33
1657291868526,MATH 103A,B03,093562,Greenfeld; Be'Eri,3,0,36,33
1657291874556,MATH 105,A01,085443,Carter; Anne Toulson,15,0,35,20
1657291874556,MATH 105,A02,093477,Carter; Anne Toulson,20,0,35,15
1657291880580,MATH 109,A01,083213,Ganzberger; Geoffrey Michael,2,0,34,32
1657291880580,MATH 109,A02,083214,Ganzberger; Geoffrey Michael,4,0,34,30
1657291880580,MATH 109,A03,093478,Ganzberger; Geoffrey Michael,2,0,34,32
1657291880580,MATH 109,B01,083215,Ganzberger; Geoffrey Michael,1,0,32,31
1657291880580,MATH 109,B02,083216,Ganzberger; Geoffrey Michael,1,0,32,31
1657291880580,MATH 109,B03,093479,Ganzberger; Geoffrey Michael,8,0,32,24
1657291886611,MATH 142A,A01,083219,Chow; Bennett,7,0,32,25
1657291886611,MATH 142A,A02,083220,Chow; Bennett,10,0,32,22
1657291886611,MATH 142A,A03,093480,Chow; Bennett,7,0,32,25
1657291886611,MATH 142A,B03,093481,Chow; Bennett,8,0,32,24
1657291886611,MATH 142A,B04,093558,Chow; Bennett,12,0,32,20
1657291886611,MATH 142A,B05,093559,Chow; Bennett,6,0,32,26
1657291892640,MATH 193A,A01,083224,Rotar; Vladimir,7,0,34,27
1657291892640,MATH 193A,A02,083225,Rotar; Vladimir,6,0,34,28
1657291892640,MATH 193A,A03,083781,Rotar; Vladimir,2,0,34,32
1657291892640,MATH 193A,A04,083782,Rotar; Vladimir,8,0,34,26
1657291892640,MATH 193A,A05,093482,Rotar; Vladimir,6,0,34,28
1657291898667,MATH 197,001,091859,McAuley; Julian John,9999,0,9999,0
1657291898667,MATH 197,002,095566,Kedlaya; Kiran S.,9997,0,9999,2
1657291898667,MATH 197,003,095567,Xiao; Ming,9999,0,9999,0
1657291898667,MATH 197,004,095571,Perols; Johan Lars,9998,0,9999,1
1657291905721,COGS 9,A01,083615,Shannon; Kyle Michael,8,0,75,67
1657291911743,COGS 11,A01,083617,Boyle; Mary E. T.,22,0,48,26
1657291917768,COGS 13,A01,083071,Bastos; Amalia Pinkusfeld,9,0,71,62
1657291923794,COGS 14A,A01,092681,Semenuks; Arturs,2,1,100,98
1657291929825,COGS 14B,A01,083073,Cheng; Tzu-Han,6,0,63,57
1657291935850,COGS 17,A01,092677,Semenuks; Arturs,5,0,81,76
1657291941873,COGS 100,A01,083619,Allen; Michael Gordon,16,0,70,54
1657291947898,COGS 101A,A01,083621,Davis; Joshua Daniel,9,0,68,59
1657291953926,COGS 101B,A01,091572,Allen; Michael Gordon,11,0,65,54
1657291959950,COGS 101C,A01,083625,Delgado; Tania,17,0,35,18
1657291965976,COGS 107A,A01,083627,Boyle; Mary E. T.,13,0,60,47
1657291972000,COGS 118A,A01,083075,Gupta; Anjum,18,0,76,58
1657291978022,CSE 3,A50,083646,Miranda; Gregory Joseph,24,0,50,26
1657291984129,CSE 8A,A50,083650,Miranda; Gregory Joseph,17,1,56,39
1657291990151,CSE 11,A01,083080,Cao; Yingjun,5,15,40,35
1657291996174,CSE 12,A01,083652,Krause-Levy; Sophia Louisa,26,1,120,94
1657292002197,CSE 15L,A01,083654,Morris; Justin Loren,9,0,50,41
1657292002197,CSE 15L,A02,083655,Morris; Justin Loren,9,0,50,41
1657292008219,CSE 20,A01,083657,Tran; Khoa Dang,38,0,80,42
1657292014247,CSE 21,A01,095574,Bach; Quang Tran,22,0,48,26
1657292020271,CSE 30,A01,083084,Eldon; John,4,0,80,76
1657292020271,CSE 30,B01,095061,Bhaskar; Nishant,8,0,50,42
1657292026295,CSE 100,A01,083659,Cao; Yingjun,4,4,70,66
1657292032318,CSE 134B,A01,083661,Powell; Thomas Allan,21,0,100,79
1657292038344,CSE 140,A01,083663,Gungor; Onat,13,0,85,72
1657292044370,CSE 140L,A01,083088,Eldon; John,19,0,100,81
1657292050393,CSE 175,A01,083665,Kumar; Rakesh,3,0,25,22
1657292056418,CSE 190,A00,092507,Dubnov; Shlomo,7,0,20,13
1657292062449,ECE 45,A01,083139,Congero; Spencer William,5,0,75,70
1657292068479,ECE 65,A50,083695,Saad; Andrew S,12,0,30,18
1657292068479,ECE 65,A51,095125,Saad; Andrew S,25,0,26,1
1657292074507,ECE 109,A01,091882,Touri; Behrouz,19,0,70,51
1657292080534,ECE 180,A00,083140,Abi Samra; Nicholas Camill,1,0,30,29
1657292080534,ECE 180,B00,083141,Abi Samra; Nicholas Camill,0,0,30,30
1657292086567,MATH 10A,A01,083735,Patchell; Gregory David,2,0,30,28
1657292086567,MATH 10A,A02,083736,Patchell; Gregory David,20,0,30,10
1657292086567,MATH 10A,A03,083737,Patchell; Gregory David,16,0,30,14
1657292092601,MATH 10B,A01,083207,Lim; Seonhee,7,0,34,27
1657292092601,MATH 10B,A02,083208,Lim; Seonhee,9,0,35,26
1657292092601,MATH 10B,A03,093472,Lim; Seonhee,5,0,34,29
1657292092601,MATH 10B,B01,083739,Sinha; Shubham,11,0,30,19
1657292098625,MATH 18,A01,083743,Cinel; Cameron Alexander,6,0,30,24
1657292098625,MATH 18,A02,083744,Cinel; Cameron Alexander,17,0,30,13
1657292098625,MATH 18,A03,083745,Cinel; Cameron Alexander,8,0,30,22
1657292098625,MATH 18,B01,083748,Rideout; David Porter,4,0,37,33
1657292098625,MATH 18,B02,083749,Rideout; David Porter,4,0,36,32
1657292098625,MATH 18,B03,083750,Rideout; David Porter,2,0,37,35
1657292098625,MATH 18,B04,083751,Rideout; David Porter,6,0,36,30
1657292098625,MATH 18,B05,093473,Rideout; David Porter,5,0,36,31
1657292098625,MATH 18,B06,093474,Rideout; David Porter,5,0,36,31
1657292104648,MATH 20A,A01,083754,Zheng; Zequn,14,0,40,26
1657292110677,MATH 20B,A01,083756,Briones; Jor-el Thomas Caparas,3,0,36,33
1657292110677,MATH 20B,A02,083757,Briones; Jor-el Thomas Caparas,1,0,36,35
1657292110677,MATH 20B,A03,093475,Briones; Jor-el Thomas Caparas,2,0,36,34
1657292116700,MATH 20C,A01,083760,Briones; Jor-el Thomas Caparas,1,0,35,34
1657292116700,MATH 20C,A02,083761,Briones; Jor-el Thomas Caparas,8,0,35,27
1657292116700,MATH 20C,A03,093476,Briones; Jor-el Thomas Caparas,0,1,36,36
1657292116700,MATH 20C,B01,083762,Bach; Quang Tran,1,0,30,29
1657292122725,MATH 20D,A01,083765,Tran; Brian Kha,5,0,30,25
1657292122725,MATH 20D,A02,083766,Tran; Brian Kha,5,0,30,25
1657292122725,MATH 20D,A03,083767,Tran; Brian Kha,4,0,30,26
1657292128752,MATH 20E,A01,083771,Ganguly; Soumya,7,0,32,25
1657292128752,MATH 20E,A02,083772,Ganguly; Soumya,7,0,32,25
1657292128752,MATH 20E,B01,083773,Ciotti; Benjamin,19,0,35,16
1657292128752,MATH 20E,B02,083774,Ciotti; Benjamin,17,0,35,18
1657292134776,MATH 103A,A01,083777,Greenfeld; Be'Eri,3,0,36,33
1657292134776,MATH 103A,A02,083778,Greenfeld; Be'Eri,5,0,36,31
1657292134776,MATH 103A,A03,093561,Greenfeld; Be'Eri,4,0,36,32
1657292134776,MATH 103A,B01,083779,Greenfeld; Be'Eri,6,0,36,30
1657292134776,MATH 103A,B02,083780,Greenfeld; Be'Eri,3,0,36,33
1657292134776,MATH 103A,B03,093562,Greenfeld; Be'Eri,3,0,36,33
1657292140798,MATH 105,A01,085443,Carter; Anne Toulson,15,0,35,20
1657292140798,MATH 105,A02,093477,Carter; Anne Toulson,20,0,35,15
1657292146821,MATH 109,A01,083213,Ganzberger; Geoffrey Michael,2,0,34,32
1657292146821,MATH 109,A02,083214,Ganzberger; Geoffrey Michael,4,0,34,30
1657292146821,MATH 109,A03,093478,Ganzberger; Geoffrey Michael,2,0,34,32
1657292146821,MATH 109,B01,083215,Ganzberger; Geoffrey Michael,1,0,32,31
1657292146821,MATH 109,B02,083216,Ganzberger; Geoffrey Michael,1,0,32,31
1657292146821,MATH 109,B03,093479,Ganzberger; Geoffrey Michael,8,0,32,24
1657292152844,MATH 142A,A01,083219,Chow; Bennett,7,0,32,25
1657292152844,MATH 142A,A02,083220,Chow; Bennett,10,0,32,22
1657292152844,MATH 142A,A03,093480,Chow; Bennett,7,0,32,25
1657292152844,MATH 142A,B03,093481,Chow; Bennett,8,0,32,24
1657292152844,MATH 142A,B04,093558,Chow; Bennett,12,0,32,20
1657292152844,MATH 142A,B05,093559,Chow; Bennett,6,0,32,26
1657292158872,MATH 193A,A01,083224,Rotar; Vladimir,7,0,34,27
1657292158872,MATH 193A,A02,083225,Rotar; Vladimir,6,0,34,28
1657292158872,MATH 193A,A03,083781,Rotar; Vladimir,2,0,34,32
1657292158872,MATH 193A,A04,083782,Rotar; Vladimir,8,0,34,26
1657292158872,MATH 193A,A05,093482,Rotar; Vladimir,6,0,34,28
1657292164898,MATH 197,001,091859,McAuley; Julian John,9999,0,9999,0
1657292164898,MATH 197,002,095566,Kedlaya; Kiran S.,9997,0,9999,2
1657292164898,MATH 197,003,095567,Xiao; Ming,9999,0,9999,0
1657292164898,MATH 197,004,095571,Perols; Johan Lars,9998,0,9999,1
1657292171982,COGS 9,A01,083615,Shannon; Kyle Michael,8,0,75,67
1657292178006,COGS 11,A01,083617,Boyle; Mary E. T.,22,0,48,26
1657292184028,COGS 13,A01,083071,Bastos; Amalia Pinkusfeld,9,0,71,62
1657292190055,COGS 14A,A01,092681,Semenuks; Arturs,2,1,100,98
1657292196077,COGS 14B,A01,083073,Cheng; Tzu-Han,6,0,63,57
1657292202104,COGS 17,A01,092677,Semenuks; Arturs,5,0,81,76
1657292208129,COGS 100,A01,083619,Allen; Michael Gordon,16,0,70,54
1657292214154,COGS 101A,A01,083621,Davis; Joshua Daniel,9,0,68,59
1657292220191,COGS 101B,A01,091572,Allen; Michael Gordon,11,0,65,54
1657292226220,COGS 101C,A01,083625,Delgado; Tania,17,0,35,18
1657292232244,COGS 107A,A01,083627,Boyle; Mary E. T.,13,0,60,47
1657292238266,COGS 118A,A01,083075,Gupta; Anjum,18,0,76,58
1657292244289,CSE 3,A50,083646,Miranda; Gregory Joseph,24,0,50,26
1657292250313,CSE 8A,A50,083650,Miranda; Gregory Joseph,17,1,56,39
1657292256354,CSE 11,A01,083080,Cao; Yingjun,5,15,40,35
1657292262377,CSE 12,A01,083652,Krause-Levy; Sophia Louisa,26,1,120,94
1657292268401,CSE 15L,A01,083654,Morris; Justin Loren,9,0,50,41
1657292268401,CSE 15L,A02,083655,Morris; Justin Loren,9,0,50,41
1657292274428,CSE 20,A01,083657,Tran; Khoa Dang,38,0,80,42
1657292280466,CSE 21,A01,095574,Bach; Quang Tran,22,0,48,26
1657292286489,CSE 30,A01,083084,Eldon; John,4,0,80,76
1657292286489,CSE 30,B01,095061,Bhaskar; Nishant,8,0,50,42
1657292292516,CSE 100,A01,083659,Cao; Yingjun,4,4,70,66
1657292298543,CSE 134B,A01,083661,Powell; Thomas Allan,21,0,100,79
1657292304569,CSE 140,A01,083663,Gungor; Onat,13,0,85,72
1657292310597,CSE 140L,A01,083088,Eldon; John,19,0,100,81
1657292316623,CSE 175,A01,083665,Kumar; Rakesh,3,0,25,22
1657292322645,CSE 190,A00,092507,Dubnov; Shlomo,7,0,20,13
1657292328673,ECE 45,A01,083139,Congero; Spencer William,5,0,75,70
1657292334701,ECE 65,A50,083695,Saad; Andrew S,12,0,30,18
1657292334701,ECE 65,A51,095125,Saad; Andrew S,25,0,26,1
1657292340725,ECE 109,A01,091882,Touri; Behrouz,19,0,70,51
1657292346758,ECE 180,A00,083140,Abi Samra; Nicholas Camill,1,0,30,29
1657292346758,ECE 180,B00,083141,Abi Samra; Nicholas Camill,0,0,30,30
1657292352793,MATH 10A,A01,083735,Patchell; Gregory David,2,0,30,28
1657292352793,MATH 10A,A02,083736,Patchell; Gregory David,20,0,30,10
1657292352793,MATH 10A,A03,083737,Patchell; Gregory David,16,0,30,14
1657292358822,MATH 10B,A01,083207,Lim; Seonhee,7,0,34,27
1657292358822,MATH 10B,A02,083208,Lim; Seonhee,9,0,35,26
1657292358822,MATH 10B,A03,093472,Lim; Seonhee,5,0,34,29
1657292358822,MATH 10B,B01,083739,Sinha; Shubham,11,0,30,19
1657292364847,MATH 18,A01,083743,Cinel; Cameron Alexander,6,0,30,24
1657292364847,MATH 18,A02,083744,Cinel; Cameron Alexander,17,0,30,13
1657292364847,MATH 18,A03,083745,Cinel; Cameron Alexander,8,0,30,22
1657292364847,MATH 18,B01,083748,Rideout; David Porter,4,0,37,33
1657292364847,MATH 18,B02,083749,Rideout; David Porter,4,0,36,32
1657292364847,MATH 18,B03,083750,Rideout; David Porter,2,0,37,35
1657292364847,MATH 18,B04,083751,Rideout; David Porter,6,0,36,30
1657292364847,MATH 18,B05,093473,Rideout; David Porter,5,0,36,31
1657292364847,MATH 18,B06,093474,Rideout; David Porter,5,0,36,31
1657292370870,MATH 20A,A01,083754,Zheng; Zequn,14,0,40,26
1657292376893,MATH 20B,A01,083756,Briones; Jor-el Thomas Caparas,3,0,36,33
1657292376893,MATH 20B,A02,083757,Briones; Jor-el Thomas Caparas,1,0,36,35
1657292376893,MATH 20B,A03,093475,Briones; Jor-el Thomas Caparas,2,0,36,34
1657292382933,MATH 20C,A01,083760,Briones; Jor-el Thomas Caparas,1,0,35,34
1657292382933,MATH 20C,A02,083761,Briones; Jor-el Thomas Caparas,8,0,35,27
1657292382933,MATH 20C,A03,093476,Briones; Jor-el Thomas Caparas,0,1,36,36
1657292382933,MATH 20C,B01,083762,Bach; Quang Tran,1,0,30,29
1657292388962,MATH 20D,A01,083765,Tran; Brian Kha,5,0,30,25
1657292388962,MATH 20D,A02,083766,Tran; Brian Kha,5,0,30,25
1657292388962,MATH 20D,A03,083767,Tran; Brian Kha,4,0,30,26
1657292394986,MATH 20E,A01,083771,Ganguly; Soumya,7,0,32,25
1657292394986,MATH 20E,A02,083772,Ganguly; Soumya,7,0,32,25
1657292394986,MATH 20E,B01,083773,Ciotti; Benjamin,19,0,35,16
1657292394986,MATH 20E,B02,083774,Ciotti; Benjamin,17,0,35,18
1657292401011,MATH 103A,A01,083777,Greenfeld; Be'Eri,3,0,36,33
1657292401011,MATH 103A,A02,083778,Greenfeld; Be'Eri,5,0,36,31
1657292401011,MATH 103A,A03,093561,Greenfeld; Be'Eri,4,0,36,32
1657292401011,MATH 103A,B01,083779,Greenfeld; Be'Eri,6,0,36,30
1657292401011,MATH 103A,B02,083780,Greenfeld; Be'Eri,3,0,36,33
1657292401011,MATH 103A,B03,093562,Greenfeld; Be'Eri,3,0,36,33
1657292407038,MATH 105,A01,085443,Carter; Anne Toulson,15,0,35,20
1657292407038,MATH 105,A02,093477,Carter; Anne Toulson,20,0,35,15
1657292413067,MATH 109,A01,083213,Ganzberger; Geoffrey Michael,2,0,34,32
1657292413067,MATH 109,A02,083214,Ganzberger; Geoffrey Michael,4,0,34,30
1657292413067,MATH 109,A03,093478,Ganzberger; Geoffrey Michael,2,0,34,32
1657292413067,MATH 109,B01,083215,Ganzberger; Geoffrey Michael,1,0,32,31
1657292413067,MATH 109,B02,083216,Ganzberger; Geoffrey Michael,1,0,32,31
1657292413067,MATH 109,B03,093479,Ganzberger; Geoffrey Michael,8,0,32,24
1657292419109,MATH 142A,A01,083219,Chow; Bennett,7,0,32,25
1657292419109,MATH 142A,A02,083220,Chow; Bennett,10,0,32,22
1657292419109,MATH 142A,A03,093480,Chow; Bennett,7,0,32,25
1657292419109,MATH 142A,B03,093481,Chow; Bennett,8,0,32,24
1657292419109,MATH 142A,B04,093558,Chow; Bennett,12,0,32,20
1657292419109,MATH 142A,B05,093559,Chow; Bennett,6,0,32,26
1657292425137,MATH 193A,A01,083224,Rotar; Vladimir,7,0,34,27
1657292425137,MATH 193A,A02,083225,Rotar; Vladimir,6,0,34,28
1657292425137,MATH 193A,A03,083781,Rotar; Vladimir,2,0,34,32
1657292425137,MATH 193A,A04,083782,Rotar; Vladimir,8,0,34,26
1657292425137,MATH 193A,A05,093482,Rotar; Vladimir,6,0,34,28
1657292431161,MATH 197,001,091859,McAuley; Julian John,9999,0,9999,0
1657292431161,MATH 197,002,095566,Kedlaya; Kiran S.,9997,0,9999,2
1657292431161,MATH 197,003,095567,Xiao; Ming,9999,0,9999,0
1657292431161,MATH 197,004,095571,Perols; Johan Lars,9998,0,9999,1
1657292438230,COGS 9,A01,083615,Shannon; Kyle Michael,8,0,75,67
1657292444253,COGS 11,A01,083617,Boyle; Mary E. T.,22,0,48,26
1657292450278,COGS 13,A01,083071,Bastos; Amalia Pinkusfeld,9,0,71,62
1657292456301,COGS 14A,A01,092681,Semenuks; Arturs,2,1,100,98
1657292462328,COGS 14B,A01,083073,Cheng; Tzu-Han,6,0,63,57
1657292468358,COGS 17,A01,092677,Semenuks; Arturs,5,0,81,76
1657292474381,COGS 100,A01,083619,Allen; Michael Gordon,16,0,70,54
1657292480407,COGS 101A,A01,083621,Davis; Joshua Daniel,9,0,68,59
1657292486429,COGS 101B,A01,091572,Allen; Michael Gordon,11,0,65,54
1657292492453,COGS 101C,A01,083625,Delgado; Tania,17,0,35,18
1657292498475,COGS 107A,A01,083627,Boyle; Mary E. T.,13,0,60,47
1657292504500,COGS 118A,A01,083075,Gupta; Anjum,18,0,76,58
1657292510535,CSE 3,A50,083646,Miranda; Gregory Joseph,24,0,50,26
1657292516562,CSE 8A,A50,083650,Miranda; Gregory Joseph,17,1,56,39
1657292522590,CSE 11,A01,083080,Cao; Yingjun,5,15,40,35
1657292528619,CSE 12,A01,083652,Krause-Levy; Sophia Louisa,26,1,120,94
1657292534646,CSE 15L,A01,083654,Morris; Justin Loren,9,0,50,41
1657292534646,CSE 15L,A02,083655,Morris; Justin Loren,9,0,50,41
1657292540674,CSE 20,A01,083657,Tran; Khoa Dang,38,0,80,42
1657292546701,CSE 21,A01,095574,Bach; Quang Tran,22,0,48,26
1657292552729,CSE 30,A01,083084,Eldon; John,4,0,80,76
1657292552729,CSE 30,B01,095061,Bhaskar; Nishant,8,0,50,42
1657292558756,CSE 100,A01,083659,Cao; Yingjun,4,4,70,66
1657292564784,CSE 134B,A01,083661,Powell; Thomas Allan,21,0,100,79
1657292570808,CSE 140,A01,083663,Gungor; Onat,13,0,85,72
1657292576835,CSE 140L,A01,083088,Eldon; John,19,0,100,81
1657292582934,CSE 175,A01,083665,Kumar; Rakesh,3,0,25,22
1657292588960,CSE 190,A00,092507,Dubnov; Shlomo,7,0,20,13
1657292594993,ECE 45,A01,083139,Congero; Spencer William,5,0,75,70
1657292601023,ECE 65,A50,083695,Saad; Andrew S,12,0,30,18
1657292601023,ECE 65,A51,095125,Saad; Andrew S,25,0,26,1
1657292607049,ECE 109,A01,091882,Touri; Behrouz,19,0,70,51
1657292613076,ECE 180,A00,083140,Abi Samra; Nicholas Camill,1,0,30,29
1657292613076,ECE 180,B00,083141,Abi Samra; Nicholas Camill,0,0,30,30
1657292619101,MATH 10A,A01,083735,Patchell; Gregory David,2,0,30,28
1657292619101,MATH 10A,A02,083736,Patchell; Gregory David,20,0,30,10
1657292619101,MATH 10A,A03,083737,Patchell; Gregory David,16,0,30,14
1657292625129,MATH 10B,A01,083207,Lim; Seonhee,7,0,34,27
1657292625129,MATH 10B,A02,083208,Lim; Seonhee,9,0,35,26
1657292625129,MATH 10B,A03,093472,Lim; Seonhee,5,0,34,29
1657292625129,MATH 10B,B01,083739,Sinha; Shubham,11,0,30,19
1657292631153,MATH 18,A01,083743,Cinel; Cameron Alexander,6,0,30,24
1657292631153,MATH 18,A02,083744,Cinel; Cameron Alexander,17,0,30,13
1657292631153,MATH 18,A03,083745,Cinel; Cameron Alexander,8,0,30,22
1657292631153,MATH 18,B01,083748,Rideout; David Porter,4,0,37,33
1657292631153,MATH 18,B02,083749,Rideout; David Porter,4,0,36,32
1657292631153,MATH 18,B03,083750,Rideout; David Porter,2,0,37,35
1657292631153,MATH 18,B04,083751,Rideout; David Porter,6,0,36,30
1657292631153,MATH 18,B05,093473,Rideout; David Porter,5,0,36,31
1657292631153,MATH 18,B06,093474,Rideout; David Porter,5,0,36,31
1657292637182,MATH 20A,A01,083754,Zheng; Zequn,14,0,40,26
1657292643205,MATH 20B,A01,083756,Briones; Jor-el Thomas Caparas,3,0,36,33
1657292643205,MATH 20B,A02,083757,Briones; Jor-el Thomas Caparas,1,0,36,35
1657292643205,MATH 20B,A03,093475,Briones; Jor-el Thomas Caparas,2,0,36,34
1657292649228,MATH 20C,A01,083760,Briones; Jor-el Thomas Caparas,1,0,35,34
1657292649228,MATH 20C,A02,083761,Briones; Jor-el Thomas Caparas,8,0,35,27
1657292649228,MATH 20C,A03,093476,Briones; Jor-el Thomas Caparas,0,1,36,36
1657292649228,MATH 20C,B01,083762,Bach; Quang Tran,1,0,30,29
1657292655253,MATH 20D,A01,083765,Tran; Brian Kha,5,0,30,25
1657292655253,MATH 20D,A02,083766,Tran; Brian Kha,5,0,30,25
1657292655253,MATH 20D,A03,083767,Tran; Brian Kha,4,0,30,26
1657292661277,MATH 20E,A01,083771,Ganguly; Soumya,7,0,32,25
1657292661277,MATH 20E,A02,083772,Ganguly; Soumya,7,0,32,25
1657292661277,MATH 20E,B01,083773,Ciotti; Benjamin,19,0,35,16
1657292661277,MATH 20E,B02,083774,Ciotti; Benjamin,17,0,35,18
1657292667307,MATH 103A,A01,083777,Greenfeld; Be'Eri,3,0,36,33
1657292667307,MATH 103A,A02,083778,Greenfeld; Be'Eri,5,0,36,31
1657292667307,MATH 103A,A03,093561,Greenfeld; Be'Eri,4,0,36,32
1657292667307,MATH 103A,B01,083779,Greenfeld; Be'Eri,6,0,36,30
1657292667307,MATH 103A,B02,083780,Greenfeld; Be'Eri,3,0,36,33
1657292667307,MATH 103A,B03,093562,Greenfeld; Be'Eri,3,0,36,33
1657292673339,MATH 105,A01,085443,Carter; Anne Toulson,15,0,35,20
1657292673339,MATH 105,A02,093477,Carter; Anne Toulson,20,0,35,15
1657292679364,MATH 109,A01,083213,Ganzberger; Geoffrey Michael,2,0,34,32
1657292679364,MATH 109,A02,083214,Ganzberger; Geoffrey Michael,4,0,34,30
1657292679364,MATH 109,A03,093478,Ganzberger; Geoffrey Michael,2,0,34,32
1657292679364,MATH 109,B01,083215,Ganzberger; Geoffrey Michael,1,0,32,31
1657292679364,MATH 109,B02,083216,Ganzberger; Geoffrey Michael,1,0,32,31
1657292679364,MATH 109,B03,093479,Ganzberger; Geoffrey Michael,8,0,32,24
1657292685394,MATH 142A,A01,083219,Chow; Bennett,7,0,32,25
1657292685394,MATH 142A,A02,083220,Chow; Bennett,10,0,32,22
1657292685394,MATH 142A,A03,093480,Chow; Bennett,7,0,32,25
1657292685394,MATH 142A,B03,093481,Chow; Bennett,8,0,32,24
1657292685394,MATH 142A,B04,093558,Chow; Bennett,12,0,32,20
1657292685394,MATH 142A,B05,093559,Chow; Bennett,6,0,32,26
1657292691419,MATH 193A,A01,083224,Rotar; Vladimir,7,0,34,27
1657292691419,MATH 193A,A02,083225,Rotar; Vladimir,6,0,34,28
1657292691419,MATH 193A,A03,083781,Rotar; Vladimir,2,0,34,32
1657292691419,MATH 193A,A04,083782,Rotar; Vladimir,8,0,34,26
1657292691419,MATH 193A,A05,093482,Rotar; Vladimir,6,0,34,28
1657292697443,MATH 197,001,091859,McAuley; Julian John,9999,0,9999,0
1657292697443,MATH 197,002,095566,Kedlaya; Kiran S.,9997,0,9999,2
1657292697443,MATH 197,003,095567,Xiao; Ming,9999,0,9999,0
1657292697443,MATH 197,004,095571,Perols; Johan Lars,9998,0,9999,1
1657292704512,COGS 9,A01,083615,Shannon; Kyle Michael,8,0,75,67
1657292710537,COGS 11,A01,083617,Boyle; Mary E. T.,22,0,48,26
1657292716572,COGS 13,A01,083071,Bastos; Amalia Pinkusfeld,9,0,71,62
1657292722597,COGS 14A,A01,092681,Semenuks; Arturs,2,1,100,98
1657292728622,COGS 14B,A01,083073,Cheng; Tzu-Han,6,0,63,57
1657292734648,COGS 17,A01,092677,Semenuks; Arturs,5,0,81,76
1657292740676,COGS 100,A01,083619,Allen; Michael Gordon,16,0,70,54
1657292746709,COGS 101A,A01,083621,Davis; Joshua Daniel,9,0,68,59
1657292752732,COGS 101B,A01,091572,Allen; Michael Gordon,11,0,65,54
1657292758759,COGS 101C,A01,083625,Delgado; Tania,17,0,35,18
1657292764781,COGS 107A,A01,083627,Boyle; Mary E. T.,13,0,60,47
1657292770804,COGS 118A,A01,083075,Gupta; Anjum,18,0,76,58
1657292776827,CSE 3,A50,083646,Miranda; Gregory Joseph,24,0,50,26
1657292782851,CSE 8A,A50,083650,Miranda; Gregory Joseph,17,1,56,39
1657292788878,CSE 11,A01,083080,Cao; Yingjun,5,15,40,35
1657292794906,CSE 12,A01,083652,Krause-Levy; Sophia Louisa,26,1,120,94
1657292800928,CSE 15L,A01,083654,Morris; Justin Loren,9,0,50,41
1657292800928,CSE 15L,A02,083655,Morris; Justin Loren,9,0,50,41
1657292806956,CSE 20,A01,083657,Tran; Khoa Dang,38,0,80,42
1657292812979,CSE 21,A01,095574,Bach; Quang Tran,22,0,48,26
1657292819010,CSE 30,A01,083084,Eldon; John,4,0,80,76
1657292819010,CSE 30,B01,095061,Bhaskar; Nishant,8,0,50,42
1657292825036,CSE 100,A01,083659,Cao; Yingjun,4,4,70,66
1657292831062,CSE 134B,A01,083661,Powell; Thomas Allan,21,0,100,79
1657292837099,CSE 140,A01,083663,Gungor; Onat,13,0,85,72
1657292843128,CSE 140L,A01,083088,Eldon; John,19,0,100,81
1657292849151,CSE 175,A01,083665,Kumar; Rakesh,3,0,25,22
1657292855175,CSE 190,A00,092507,Dubnov; Shlomo,7,0,20,13
1657292861204,ECE 45,A01,083139,Congero; Spencer William,5,0,75,70
1657292867230,ECE 65,A50,083695,Saad; Andrew S,12,0,30,18
1657292867230,ECE 65,A51,095125,Saad; Andrew S,25,0,26,1
1657292873257,ECE 109,A01,091882,Touri; Behrouz,19,0,70,51
1657292879284,ECE 180,A00,083140,Abi Samra; Nicholas Camill,1,0,30,29
1657292879284,ECE 180,B00,083141,Abi Samra; Nicholas Camill,0,0,30,30
1657292885308,MATH 10A,A01,083735,Patchell; Gregory David,2,0,30,28
1657292885308,MATH 10A,A02,083736,Patchell; Gregory David,20,0,30,10
1657292885308,MATH 10A,A03,083737,Patchell; Gregory David,16,0,30,14
1657292891342,MATH 10B,A01,083207,Lim; Seonhee,7,0,34,27
1657292891342,MATH 10B,A02,083208,Lim; Seonhee,9,0,35,26
1657292891342,MATH 10B,A03,093472,Lim; Seonhee,5,0,34,29
1657292891342,MATH 10B,B01,083739,Sinha; Shubham,11,0,30,19
1657292897367,MATH 18,A01,083743,Cinel; Cameron Alexander,6,0,30,24
1657292897367,MATH 18,A02,083744,Cinel; Cameron Alexander,17,0,30,13
1657292897367,MATH 18,A03,083745,Cinel; Cameron Alexander,8,0,30,22
1657292897367,MATH 18,B01,083748,Rideout; David Porter,4,0,37,33
1657292897367,MATH 18,B02,083749,Rideout; David Porter,4,0,36,32
1657292897367,MATH 18,B03,083750,Rideout; David Porter,2,0,37,35
1657292897367,MATH 18,B04,083751,Rideout; David Porter,6,0,36,30
1657292897367,MATH 18,B05,093473,Rideout; David Porter,5,0,36,31
1657292897367,MATH 18,B06,093474,Rideout; David Porter,5,0,36,31
1657292903389,MATH 20A,A01,083754,Zheng; Zequn,14,0,40,26
1657292909425,MATH 20B,A01,083756,Briones; Jor-el Thomas Caparas,3,0,36,33
1657292909425,MATH 20B,A02,083757,Briones; Jor-el Thomas Caparas,1,0,36,35
1657292909425,MATH 20B,A03,093475,Briones; Jor-el Thomas Caparas,2,0,36,34
1657292915454,MATH 20C,A01,083760,Briones; Jor-el Thomas Caparas,1,0,35,34
1657292915454,MATH 20C,A02,083761,Briones; Jor-el Thomas Caparas,8,0,35,27
1657292915454,MATH 20C,A03,093476,Briones; Jor-el Thomas Caparas,0,1,36,36
1657292915454,MATH 20C,B01,083762,Bach; Quang Tran,1,0,30,29
1657292921484,MATH 20D,A01,083765,Tran; Brian Kha,5,0,30,25
1657292921484,MATH 20D,A02,083766,Tran; Brian Kha,5,0,30,25
1657292921484,MATH 20D,A03,083767,Tran; Brian Kha,4,0,30,26
1657292927507,MATH 20E,A01,083771,Ganguly; Soumya,7,0,32,25
1657292927507,MATH 20E,A02,083772,Ganguly; Soumya,7,0,32,25
1657292927507,MATH 20E,B01,083773,Ciotti; Benjamin,19,0,35,16
1657292927507,MATH 20E,B02,083774,Ciotti; Benjamin,17,0,35,18
1657292933536,MATH 103A,A01,083777,Greenfeld; Be'Eri,3,0,36,33
1657292933536,MATH 103A,A02,083778,Greenfeld; Be'Eri,5,0,36,31
1657292933536,MATH 103A,A03,093561,Greenfeld; Be'Eri,4,0,36,32
1657292933536,MATH 103A,B01,083779,Greenfeld; Be'Eri,6,0,36,30
1657292933536,MATH 103A,B02,083780,Greenfeld; Be'Eri,3,0,36,33
1657292933536,MATH 103A,B03,093562,Greenfeld; Be'Eri,3,0,36,33
1657292939572,MATH 105,A01,085443,Carter; Anne Toulson,15,0,35,20
1657292939572,MATH 105,A02,093477,Carter; Anne Toulson,20,0,35,15
1657292945600,MATH 109,A01,083213,Ganzberger; Geoffrey Michael,2,0,34,32
1657292945600,MATH 109,A02,083214,Ganzberger; Geoffrey Michael,4,0,34,30
1657292945600,MATH 109,A03,093478,Ganzberger; Geoffrey Michael,2,0,34,32
1657292945600,MATH 109,B01,083215,Ganzberger; Geoffrey Michael,1,0,32,31
1657292945600,MATH 109,B02,083216,Ganzberger; Geoffrey Michael,1,0,32,31
1657292945600,MATH 109,B03,093479,Ganzberger; Geoffrey Michael,8,0,32,24
1657292951629,MATH 142A,A01,083219,Chow; Bennett,7,0,32,25
1657292951629,MATH 142A,A02,083220,Chow; Bennett,10,0,32,22
1657292951629,MATH 142A,A03,093480,Chow; Bennett,7,0,32,25
1657292951629,MATH 142A,B03,093481,Chow; Bennett,8,0,32,24
1657292951629,MATH 142A,B04,093558,Chow; Bennett,12,0,32,20
1657292951629,MATH 142A,B05,093559,Chow; Bennett,6,0,32,26
1657292957653,MATH 193A,A01,083224,Rotar; Vladimir,7,0,34,27
1657292957653,MATH 193A,A02,083225,Rotar; Vladimir,6,0,34,28
1657292957653,MATH 193A,A03,083781,Rotar; Vladimir,2,0,34,32
1657292957653,MATH 193A,A04,083782,Rotar; Vladimir,8,0,34,26
1657292957653,MATH 193A,A05,093482,Rotar; Vladimir,6,0,34,28
1657292963677,MATH 197,001,091859,McAuley; Julian John,9999,0,9999,0
1657292963677,MATH 197,002,095566,Kedlaya; Kiran S.,9997,0,9999,2
1657292963677,MATH 197,003,095567,Xiao; Ming,9999,0,9999,0
1657292963677,MATH 197,004,095571,Perols; Johan Lars,9998,0,9999,1
1657292970738,COGS 9,A01,083615,Shannon; Kyle Michael,8,0,75,67
1657292976762,COGS 11,A01,083617,Boyle; Mary E. T.,22,0,48,26
1657292982786,COGS 13,A01,083071,Bastos; Amalia Pinkusfeld,9,0,71,62
1657292988810,COGS 14A,A01,092681,Semenuks; Arturs,2,1,100,98
1657292994834,COGS 14B,A01,083073,Cheng; Tzu-Han,6,0,63,57
1657293000858,COGS 17,A01,092677,Semenuks; Arturs,5,0,81,76
1657293006882,COGS 100,A01,083619,Allen; Michael Gordon,16,0,70,54
1657293012908,COGS 101A,A01,083621,Davis; Joshua Daniel,9,0,68,59
1657293018936,COGS 101B,A01,091572,Allen; Michael Gordon,11,0,65,54
1657293024967,COGS 101C,A01,083625,Delgado; Tania,17,0,35,18
1657293030990,COGS 107A,A01,083627,Boyle; Mary E. T.,13,0,60,47
1657293037017,COGS 118A,A01,083075,Gupta; Anjum,18,0,76,58
1657293043041,CSE 3,A50,083646,Miranda; Gregory Joseph,24,0,50,26
1657293049070,CSE 8A,A50,083650,Miranda; Gregory Joseph,17,1,56,39
1657293055095,CSE 11,A01,083080,Cao; Yingjun,5,15,40,35
1657293061121,CSE 12,A01,083652,Krause-Levy; Sophia Louisa,26,1,120,94
1657293067148,CSE 15L,A01,083654,Morris; Justin Loren,9,0,50,41
1657293067148,CSE 15L,A02,083655,Morris; Justin Loren,9,0,50,41
1657293073172,CSE 20,A01,083657,Tran; Khoa Dang,38,0,80,42
1657293079200,CSE 21,A01,095574,Bach; Quang Tran,22,0,48,26
1657293085225,CSE 30,A01,083084,Eldon; John,4,0,80,76
1657293085225,CSE 30,B01,095061,Bhaskar; Nishant,8,0,50,42
1657293091251,CSE 100,A01,083659,Cao; Yingjun,4,4,70,66
1657293097279,CSE 134B,A01,083661,Powell; Thomas Allan,21,0,100,79
1657293103307,CSE 140,A01,083663,Gungor; Onat,13,0,85,72
1657293109335,CSE 140L,A01,083088,Eldon; John,19,0,100,81
1657293115365,CSE 175,A01,083665,Kumar; Rakesh,3,0,25,22
1657293121392,CSE 190,A00,092507,Dubnov; Shlomo,7,0,20,13
1657293127421,ECE 45,A01,083139,Congero; Spencer William,5,0,75,70
1657293133452,ECE 65,A50,083695,Saad; Andrew S,12,0,30,18
1657293133452,ECE 65,A51,095125,Saad; Andrew S,25,0,26,1
1657293139478,ECE 109,A01,091882,Touri; Behrouz,19,0,70,51
1657293145502,ECE 180,A00,083140,Abi Samra; Nicholas Camill,1,0,30,29
1657293145502,ECE 180,B00,083141,Abi Samra; Nicholas Camill,0,0,30,30
1657293151526,MATH 10A,A01,083735,Patchell; Gregory David,2,0,30,28
1657293151526,MATH 10A,A02,083736,Patchell; Gregory David,20,0,30,10
1657293151526,MATH 10A,A03,083737,Patchell; Gregory David,16,0,30,14
1657293157557,MATH 10B,A01,083207,Lim; Seonhee,7,0,34,27
1657293157557,MATH 10B,A02,083208,Lim; Seonhee,9,0,35,26
1657293157557,MATH 10B,A03,093472,Lim; Seonhee,5,0,34,29
1657293157557,MATH 10B,B01,083739,Sinha; Shubham,11,0,30,19
1657293163587,MATH 18,A01,083743,Cinel; Cameron Alexander,6,0,30,24
1657293163587,MATH 18,A02,083744,Cinel; Cameron Alexander,17,0,30,13
1657293163587,MATH 18,A03,083745,Cinel; Cameron Alexander,8,0,30,22
1657293163587,MATH 18,B01,083748,Rideout; David Porter,4,0,37,33
1657293163587,MATH 18,B02,083749,Rideout; David Porter,4,0,36,32
1657293163587,MATH 18,B03,083750,Rideout; David Porter,2,0,37,35
1657293163587,MATH 18,B04,083751,Rideout; David Porter,6,0,36,30
1657293163587,MATH 18,B05,093473,Rideout; David Porter,5,0,36,31
1657293163587,MATH 18,B06,093474,Rideout; David Porter,5,0,36,31
1657293169611,MATH 20A,A01,083754,Zheng; Zequn,14,0,40,26
1657293175635,MATH 20B,A01,083756,Briones; Jor-el Thomas Caparas,3,0,36,33
1657293175635,MATH 20B,A02,083757,Briones; Jor-el Thomas Caparas,1,0,36,35
1657293175635,MATH 20B,A03,093475,Briones; Jor-el Thomas Caparas,2,0,36,34
1657293181750,MATH 20C,A01,083760,Briones; Jor-el Thomas Caparas,1,0,35,34
1657293181750,MATH 20C,A02,083761,Briones; Jor-el Thomas Caparas,8,0,35,27
1657293181750,MATH 20C,A03,093476,Briones; Jor-el Thomas Caparas,0,1,36,36
1657293181750,MATH 20C,B01,083762,Bach; Quang Tran,1,0,30,29
1657293187772,MATH 20D,A01,083765,Tran; Brian Kha,5,0,30,25
1657293187772,MATH 20D,A02,083766,Tran; Brian Kha,5,0,30,25
1657293187772,MATH 20D,A03,083767,Tran; Brian Kha,4,0,30,26
1657293193797,MATH 20E,A01,083771,Ganguly; Soumya,7,0,32,25
1657293193797,MATH 20E,A02,083772,Ganguly; Soumya,7,0,32,25
1657293193797,MATH 20E,B01,083773,Ciotti; Benjamin,19,0,35,16
1657293193797,MATH 20E,B02,083774,Ciotti; Benjamin,17,0,35,18
1657293199823,MATH 103A,A01,083777,Greenfeld; Be'Eri,3,0,36,33
1657293199823,MATH 103A,A02,083778,Greenfeld; Be'Eri,5,0,36,31
1657293199823,MATH 103A,A03,093561,Greenfeld; Be'Eri,4,0,36,32
1657293199823,MATH 103A,B01,083779,Greenfeld; Be'Eri,6,0,36,30
1657293199823,MATH 103A,B02,083780,Greenfeld; Be'Eri,3,0,36,33
1657293199823,MATH 103A,B03,093562,Greenfeld; Be'Eri,3,0,36,33
1657293205846,MATH 105,A01,085443,Carter; Anne Toulson,15,0,35,20
1657293205846,MATH 105,A02,093477,Carter; Anne Toulson,20,0,35,15
1657293211876,MATH 109,A01,083213,Ganzberger; Geoffrey Michael,2,0,34,32
1657293211876,MATH 109,A02,083214,Ganzberger; Geoffrey Michael,4,0,34,30
1657293211876,MATH 109,A03,093478,Ganzberger; Geoffrey Michael,2,0,34,32
1657293211876,MATH 109,B01,083215,Ganzberger; Geoffrey Michael,1,0,32,31
1657293211876,MATH 109,B02,083216,Ganzberger; Geoffrey Michael,1,0,32,31
1657293211876,MATH 109,B03,093479,Ganzberger; Geoffrey Michael,8,0,32,24
1657293217913,MATH 142A,A01,083219,Chow; Bennett,7,0,32,25
1657293217913,MATH 142A,A02,083220,Chow; Bennett,10,0,32,22
1657293217913,MATH 142A,A03,093480,Chow; Bennett,7,0,32,25
1657293217913,MATH 142A,B03,093481,Chow; Bennett,8,0,32,24
1657293217913,MATH 142A,B04,093558,Chow; Bennett,12,0,32,20
1657293217913,MATH 142A,B05,093559,Chow; Bennett,6,0,32,26
1657293223937,MATH 193A,A01,083224,Rotar; Vladimir,7,0,34,27
1657293223937,MATH 193A,A02,083225,Rotar; Vladimir,6,0,34,28
1657293223937,MATH 193A,A03,083781,Rotar; Vladimir,2,0,34,32
1657293223937,MATH 193A,A04,083782,Rotar; Vladimir,8,0,34,26
1657293223937,MATH 193A,A05,093482,Rotar; Vladimir,6,0,34,28
1657293229964,MATH 197,001,091859,McAuley; Julian John,9999,0,9999,0
1657293229964,MATH 197,002,095566,Kedlaya; Kiran S.,9997,0,9999,2
1657293229964,MATH 197,003,095567,Xiao; Ming,9999,0,9999,0
1657293229964,MATH 197,004,095571,Perols; Johan Lars,9998,0,9999,1
1657293237023,COGS 9,A01,083615,Shannon; Kyle Michael,8,0,75,67
1657293243046,COGS 11,A01,083617,Boyle; Mary E. T.,22,0,48,26
1657293249077,COGS 13,A01,083071,Bastos; Amalia Pinkusfeld,9,0,71,62
1657293255103,COGS 14A,A01,092681,Semenuks; Arturs,2,1,100,98
1657293261134,COGS 14B,A01,083073,Cheng; Tzu-Han,6,0,63,57
1657293267160,COGS 17,A01,092677,Semenuks; Arturs,5,0,81,76
1657293273191,COGS 100,A01,083619,Allen; Michael Gordon,16,0,70,54
1657293279219,COGS 101A,A01,083621,Davis; Joshua Daniel,9,0,68,59
1657293285248,COGS 101B,A01,091572,Allen; Michael Gordon,11,0,65,54
1657293291282,COGS 101C,A01,083625,Delgado; Tania,17,0,35,18
1657293297306,COGS 107A,A01,083627,Boyle; Mary E. T.,13,0,60,47
1657293303339,COGS 118A,A01,083075,Gupta; Anjum,18,0,76,58
1657293309363,CSE 3,A50,083646,Miranda; Gregory Joseph,24,0,50,26
1657293315389,CSE 8A,A50,083650,Miranda; Gregory Joseph,17,1,56,39
1657293321412,CSE 11,A01,083080,Cao; Yingjun,5,15,40,35
1657293327440,CSE 12,A01,083652,Krause-Levy; Sophia Louisa,26,1,120,94
1657293333466,CSE 15L,A01,083654,Morris; Justin Loren,9,0,50,41
1657293333466,CSE 15L,A02,083655,Morris; Justin Loren,9,0,50,41
1657293339496,CSE 20,A01,083657,Tran; Khoa Dang,38,0,80,42
1657293345519,CSE 21,A01,095574,Bach; Quang Tran,22,0,48,26
1657293351544,CSE 30,A01,083084,Eldon; John,4,0,80,76
1657293351544,CSE 30,B01,095061,Bhaskar; Nishant,8,0,50,42
1657293357573,CSE 100,A01,083659,Cao; Yingjun,4,4,70,66
1657293363602,CSE 134B,A01,083661,Powell; Thomas Allan,21,0,100,79
1657293369624,CSE 140,A01,083663,Gungor; Onat,13,0,85,72
1657293375649,CSE 140L,A01,083088,Eldon; John,19,0,100,81
1657293381677,CSE 175,A01,083665,Kumar; Rakesh,3,0,25,22
1657293387700,CSE 190,A00,092507,Dubnov; Shlomo,7,0,20,13
1657293393735,ECE 45,A01,083139,Congero; Spencer William,6,0,75,69
1657293399757,ECE 65,A50,083695,Saad; Andrew S,12,0,30,18
1657293399757,ECE 65,A51,095125,Saad; Andrew S,25,0,26,1
1657293405781,ECE 109,A01,091882,Touri; Behrouz,19,0,70,51
1657293411804,ECE 180,A00,083140,Abi Samra; Nicholas Camill,1,0,30,29
1657293411804,ECE 180,B00,083141,Abi Samra; Nicholas Camill,0,0,30,30
1657293417833,MATH 10A,A01,083735,Patchell; Gregory David,2,0,30,28
1657293417833,MATH 10A,A02,083736,Patchell; Gregory David,20,0,30,10
1657293417833,MATH 10A,A03,083737,Patchell; Gregory David,16,0,30,14
1657293423858,MATH 10B,A01,083207,Lim; Seonhee,7,0,34,27
1657293423858,MATH 10B,A02,083208,Lim; Seonhee,9,0,35,26
1657293423858,MATH 10B,A03,093472,Lim; Seonhee,5,0,34,29
1657293423858,MATH 10B,B01,083739,Sinha; Shubham,11,0,30,19
1657293429883,MATH 18,A01,083743,Cinel; Cameron Alexander,6,0,30,24
1657293429883,MATH 18,A02,083744,Cinel; Cameron Alexander,17,0,30,13
1657293429883,MATH 18,A03,083745,Cinel; Cameron Alexander,8,0,30,22
1657293429883,MATH 18,B01,083748,Rideout; David Porter,4,0,37,33
1657293429883,MATH 18,B02,083749,Rideout; David Porter,4,0,36,32
1657293429883,MATH 18,B03,083750,Rideout; David Porter,2,0,37,35
1657293429883,MATH 18,B04,083751,Rideout; David Porter,6,0,36,30
1657293429883,MATH 18,B05,093473,Rideout; David Porter,5,0,36,31
1657293429883,MATH 18,B06,093474,Rideout; David Porter,5,0,36,31
1657293435910,MATH 20A,A01,083754,Zheng; Zequn,14,0,40,26
1657293441941,MATH 20B,A01,083756,Briones; Jor-el Thomas Caparas,3,0,36,33
1657293441941,MATH 20B,A02,083757,Briones; Jor-el Thomas Caparas,1,0,36,35
1657293441941,MATH 20B,A03,093475,Briones; Jor-el Thomas Caparas,2,0,36,34
1657293447966,MATH 20C,A01,083760,Briones; Jor-el Thomas Caparas,1,0,35,34
1657293447966,MATH 20C,A02,083761,Briones; Jor-el Thomas Caparas,8,0,35,27
1657293447966,MATH 20C,A03,093476,Briones; Jor-el Thomas Caparas,0,1,36,36
1657293447966,MATH 20C,B01,083762,Bach; Quang Tran,1,0,30,29
1657293453997,MATH 20D,A01,083765,Tran; Brian Kha,5,0,30,25
1657293453997,MATH 20D,A02,083766,Tran; Brian Kha,5,0,30,25
1657293453997,MATH 20D,A03,083767,Tran; Brian Kha,4,0,30,26
1657293460026,MATH 20E,A01,083771,Ganguly; Soumya,7,0,32,25
1657293460026,MATH 20E,A02,083772,Ganguly; Soumya,7,0,32,25
1657293460026,MATH 20E,B01,083773,Ciotti; Benjamin,19,0,35,16
1657293460026,MATH 20E,B02,083774,Ciotti; Benjamin,17,0,35,18
1657293466051,MATH 103A,A01,083777,Greenfeld; Be'Eri,3,0,36,33
1657293466051,MATH 103A,A02,083778,Greenfeld; Be'Eri,5,0,36,31
1657293466051,MATH 103A,A03,093561,Greenfeld; Be'Eri,4,0,36,32
1657293466051,MATH 103A,B01,083779,Greenfeld; Be'Eri,6,0,36,30
1657293466051,MATH 103A,B02,083780,Greenfeld; Be'Eri,3,0,36,33
1657293466051,MATH 103A,B03,093562,Greenfeld; Be'Eri,3,0,36,33
1657293472076,MATH 105,A01,085443,Carter; Anne Toulson,15,0,35,20
1657293472076,MATH 105,A02,093477,Carter; Anne Toulson,20,0,35,15
1657293478104,MATH 109,A01,083213,Ganzberger; Geoffrey Michael,2,0,34,32
1657293478104,MATH 109,A02,083214,Ganzberger; Geoffrey Michael,4,0,34,30
1657293478104,MATH 109,A03,093478,Ganzberger; Geoffrey Michael,2,0,34,32
1657293478104,MATH 109,B01,083215,Ganzberger; Geoffrey Michael,1,0,32,31
1657293478104,MATH 109,B02,083216,Ganzberger; Geoffrey Michael,1,0,32,31
1657293478104,MATH 109,B03,093479,Ganzberger; Geoffrey Michael,8,0,32,24
1657293484133,MATH 142A,A01,083219,Chow; Bennett,7,0,32,25
1657293484133,MATH 142A,A02,083220,Chow; Bennett,10,0,32,22
1657293484133,MATH 142A,A03,093480,Chow; Bennett,7,0,32,25
1657293484133,MATH 142A,B03,093481,Chow; Bennett,8,0,32,24
1657293484133,MATH 142A,B04,093558,Chow; Bennett,12,0,32,20
1657293484133,MATH 142A,B05,093559,Chow; Bennett,6,0,32,26
1657293490164,MATH 193A,A01,083224,Rotar; Vladimir,7,0,34,27
1657293490164,MATH 193A,A02,083225,Rotar; Vladimir,6,0,34,28
1657293490164,MATH 193A,A03,083781,Rotar; Vladimir,2,0,34,32
1657293490164,MATH 193A,A04,083782,Rotar; Vladimir,8,0,34,26
1657293490164,MATH 193A,A05,093482,Rotar; Vladimir,6,0,34,28
1657293496191,MATH 197,001,091859,McAuley; Julian John,9999,0,9999,0
1657293496191,MATH 197,002,095566,Kedlaya; Kiran S.,9997,0,9999,2
1657293496191,MATH 197,003,095567,Xiao; Ming,9999,0,9999,0
1657293496191,MATH 197,004,095571,Perols; Johan Lars,9998,0,9999,1
1657293503244,COGS 9,A01,083615,Shannon; Kyle Michael,8,0,75,67
1657293509272,COGS 11,A01,083617,Boyle; Mary E. T.,22,0,48,26
1657293515301,COGS 13,A01,083071,Bastos; Amalia Pinkusfeld,9,0,71,62
1657293521331,COGS 14A,A01,092681,Semenuks; Arturs,2,1,100,98
1657293527360,COGS 14B,A01,083073,Cheng; Tzu-Han,6,0,63,57
1657293533401,COGS 17,A01,092677,Semenuks; Arturs,5,0,81,76
1657293539429,COGS 100,A01,083619,Allen; Michael Gordon,16,0,70,54
1657293545461,COGS 101A,A01,083621,Davis; Joshua Daniel,9,0,68,59
1657293551495,COGS 101B,A01,091572,Allen; Michael Gordon,11,0,65,54
1657293557518,COGS 101C,A01,083625,Delgado; Tania,17,0,35,18
1657293563541,COGS 107A,A01,083627,Boyle; Mary E. T.,13,0,60,47
1657293569566,COGS 118A,A01,083075,Gupta; Anjum,18,0,76,58
1657293575595,CSE 3,A50,083646,Miranda; Gregory Joseph,24,0,50,26
1657293581623,CSE 8A,A50,083650,Miranda; Gregory Joseph,17,1,56,39
1657293587646,CSE 11,A01,083080,Cao; Yingjun,5,15,40,35
1657293593675,CSE 12,A01,083652,Krause-Levy; Sophia Louisa,26,1,120,94
1657293599700,CSE 15L,A01,083654,Morris; Justin Loren,9,0,50,41
1657293599700,CSE 15L,A02,083655,Morris; Justin Loren,9,0,50,41
1657293605726,CSE 20,A01,083657,Tran; Khoa Dang,38,0,80,42
1657293611750,CSE 21,A01,095574,Bach; Quang Tran,22,0,48,26
1657293617775,CSE 30,A01,083084,Eldon; John,4,0,80,76
1657293617775,CSE 30,B01,095061,Bhaskar; Nishant,8,0,50,42
1657293623803,CSE 100,A01,083659,Cao; Yingjun,4,4,70,66
1657293629829,CSE 134B,A01,083661,Powell; Thomas Allan,21,0,100,79
1657293635852,CSE 140,A01,083663,Gungor; Onat,13,0,85,72
1657293641880,CSE 140L,A01,083088,Eldon; John,19,0,100,81
1657293647904,CSE 175,A01,083665,Kumar; Rakesh,3,0,25,22
1657293653926,CSE 190,A00,092507,Dubnov; Shlomo,7,0,20,13
1657293659952,ECE 45,A01,083139,Congero; Spencer William,6,0,75,69
1657293665976,ECE 65,A50,083695,Saad; Andrew S,12,0,30,18
1657293665976,ECE 65,A51,095125,Saad; Andrew S,25,0,26,1
1657293672004,ECE 109,A01,091882,Touri; Behrouz,19,0,70,51
1657293678028,ECE 180,A00,083140,Abi Samra; Nicholas Camill,1,0,30,29
1657293678028,ECE 180,B00,083141,Abi Samra; Nicholas Camill,0,0,30,30
1657293684053,MATH 10A,A01,083735,Patchell; Gregory David,2,0,30,28
1657293684053,MATH 10A,A02,083736,Patchell; Gregory David,20,0,30,10
1657293684053,MATH 10A,A03,083737,Patchell; Gregory David,16,0,30,14
1657293690078,MATH 10B,A01,083207,Lim; Seonhee,7,0,34,27
1657293690078,MATH 10B,A02,083208,Lim; Seonhee,9,0,35,26
1657293690078,MATH 10B,A03,093472,Lim; Seonhee,5,0,34,29
1657293690078,MATH 10B,B01,083739,Sinha; Shubham,11,0,30,19
1657293696102,MATH 18,A01,083743,Cinel; Cameron Alexander,6,0,30,24
1657293696102,MATH 18,A02,083744,Cinel; Cameron Alexander,17,0,30,13
1657293696102,MATH 18,A03,083745,Cinel; Cameron Alexander,8,0,30,22
1657293696102,MATH 18,B01,083748,Rideout; David Porter,4,0,37,33
1657293696102,MATH 18,B02,083749,Rideout; David Porter,4,0,36,32
1657293696102,MATH 18,B03,083750,Rideout; David Porter,2,0,37,35
1657293696102,MATH 18,B04,083751,Rideout; David Porter,6,0,36,30
1657293696102,MATH 18,B05,093473,Rideout; David Porter,5,0,36,31
1657293696102,MATH 18,B06,093474,Rideout; David Porter,5,0,36,31
1657293702127,MATH 20A,A01,083754,Zheng; Zequn,14,0,40,26
1657293708155,MATH 20B,A01,083756,Briones; Jor-el Thomas Caparas,3,0,36,33
1657293708155,MATH 20B,A02,083757,Briones; Jor-el Thomas Caparas,1,0,36,35
1657293708155,MATH 20B,A03,093475,Briones; Jor-el Thomas Caparas,2,0,36,34
1657293714179,MATH 20C,A01,083760,Briones; Jor-el Thomas Caparas,1,0,35,34
1657293714179,MATH 20C,A02,083761,Briones; Jor-el Thomas Caparas,8,0,35,27
1657293714179,MATH 20C,A03,093476,Briones; Jor-el Thomas Caparas,0,1,36,36
1657293714179,MATH 20C,B01,083762,Bach; Quang Tran,1,0,30,29
1657293720202,MATH 20D,A01,083765,Tran; Brian Kha,5,0,30,25
1657293720202,MATH 20D,A02,083766,Tran; Brian Kha,5,0,30,25
1657293720202,MATH 20D,A03,083767,Tran; Brian Kha,4,0,30,26
1657293726239,MATH 20E,A01,083771,Ganguly; Soumya,7,0,32,25
1657293726239,MATH 20E,A02,083772,Ganguly; Soumya,7,0,32,25
1657293726239,MATH 20E,B01,083773,Ciotti; Benjamin,19,0,35,16
1657293726239,MATH 20E,B02,083774,Ciotti; Benjamin,17,0,35,18
1657293732266,MATH 103A,A01,083777,Greenfeld; Be'Eri,3,0,36,33
1657293732266,MATH 103A,A02,083778,Greenfeld; Be'Eri,5,0,36,31
1657293732266,MATH 103A,A03,093561,Greenfeld; Be'Eri,4,0,36,32
1657293732266,MATH 103A,B01,083779,Greenfeld; Be'Eri,6,0,36,30
1657293732266,MATH 103A,B02,083780,Greenfeld; Be'Eri,3,0,36,33
1657293732266,MATH 103A,B03,093562,Greenfeld; Be'Eri,3,0,36,33
1657293738294,MATH 105,A01,085443,Carter; Anne Toulson,15,0,35,20
1657293738294,MATH 105,A02,093477,Carter; Anne Toulson,20,0,35,15
1657293744327,MATH 109,A01,083213,Ganzberger; Geoffrey Michael,2,0,34,32
1657293744327,MATH 109,A02,083214,Ganzberger; Geoffrey Michael,4,0,34,30
1657293744327,MATH 109,A03,093478,Ganzberger; Geoffrey Michael,2,0,34,32
1657293744327,MATH 109,B01,083215,Ganzberger; Geoffrey Michael,1,0,32,31
1657293744327,MATH 109,B02,083216,Ganzberger; Geoffrey Michael,1,0,32,31
1657293744327,MATH 109,B03,093479,Ganzberger; Geoffrey Michael,8,0,32,24
1657293750352,MATH 142A,A01,083219,Chow; Bennett,7,0,32,25
1657293750352,MATH 142A,A02,083220,Chow; Bennett,10,0,32,22
1657293750352,MATH 142A,A03,093480,Chow; Bennett,7,0,32,25
1657293750352,MATH 142A,B03,093481,Chow; Bennett,8,0,32,24
1657293750352,MATH 142A,B04,093558,Chow; Bennett,12,0,32,20
1657293750352,MATH 142A,B05,093559,Chow; Bennett,6,0,32,26
1657293756387,MATH 193A,A01,083224,Rotar; Vladimir,7,0,34,27
1657293756387,MATH 193A,A02,083225,Rotar; Vladimir,6,0,34,28
1657293756387,MATH 193A,A03,083781,Rotar; Vladimir,2,0,34,32
1657293756387,MATH 193A,A04,083782,Rotar; Vladimir,8,0,34,26
1657293756387,MATH 193A,A05,093482,Rotar; Vladimir,6,0,34,28
1657293762413,MATH 197,001,091859,McAuley; Julian John,9999,0,9999,0
1657293762413,MATH 197,002,095566,Kedlaya; Kiran S.,9997,0,9999,2
1657293762413,MATH 197,003,095567,Xiao; Ming,9999,0,9999,0
1657293762413,MATH 197,004,095571,Perols; Johan Lars,9998,0,9999,1
1657293769467,COGS 9,A01,083615,Shannon; Kyle Michael,8,0,75,67
1657293775583,COGS 11,A01,083617,Boyle; Mary E. T.,22,0,48,26
1657293781607,COGS 13,A01,083071,Bastos; Amalia Pinkusfeld,9,0,71,62
1657293787631,COGS 14A,A01,092681,Semenuks; Arturs,2,1,100,98
1657293793662,COGS 14B,A01,083073,Cheng; Tzu-Han,6,0,63,57
1657293799690,COGS 17,A01,092677,Semenuks; Arturs,5,0,81,76
1657293805715,COGS 100,A01,083619,Allen; Michael Gordon,16,0,70,54
1657293811745,COGS 101A,A01,083621,Davis; Joshua Daniel,9,0,68,59
1657293817770,COGS 101B,A01,091572,Allen; Michael Gordon,11,0,65,54
1657293823800,COGS 101C,A01,083625,Delgado; Tania,17,0,35,18
1657293829838,COGS 107A,A01,083627,Boyle; Mary E. T.,13,0,60,47
1657293835861,COGS 118A,A01,083075,Gupta; Anjum,18,0,76,58
1657293841887,CSE 3,A50,083646,Miranda; Gregory Joseph,24,0,50,26
1657293847912,CSE 8A,A50,083650,Miranda; Gregory Joseph,17,1,56,39
1657293853938,CSE 11,A01,083080,Cao; Yingjun,5,15,40,35
1657293859962,CSE 12,A01,083652,Krause-Levy; Sophia Louisa,26,1,120,94
1657293865986,CSE 15L,A01,083654,Morris; Justin Loren,9,0,50,41
1657293865986,CSE 15L,A02,083655,Morris; Justin Loren,9,0,50,41
1657293872016,CSE 20,A01,083657,Tran; Khoa Dang,38,0,80,42
1657293878041,CSE 21,A01,095574,Bach; Quang Tran,22,0,48,26
1657293884067,CSE 30,A01,083084,Eldon; John,4,0,80,76
1657293884067,CSE 30,B01,095061,Bhaskar; Nishant,8,0,50,42
1657293890094,CSE 100,A01,083659,Cao; Yingjun,4,4,70,66
1657293896118,CSE 134B,A01,083661,Powell; Thomas Allan,21,0,100,79
1657293902144,CSE 140,A01,083663,Gungor; Onat,13,0,85,72
1657293908167,CSE 140L,A01,083088,Eldon; John,19,0,100,81
1657293914191,CSE 175,A01,083665,Kumar; Rakesh,3,0,25,22
1657293920225,CSE 190,A00,092507,Dubnov; Shlomo,7,0,20,13
1657293926253,ECE 45,A01,083139,Congero; Spencer William,6,0,75,69
1657293932277,ECE 65,A50,083695,Saad; Andrew S,12,0,30,18
1657293932277,ECE 65,A51,095125,Saad; Andrew S,25,0,26,1
1657293938309,ECE 109,A01,091882,Touri; Behrouz,19,0,70,51
1657293944337,ECE 180,A00,083140,Abi Samra; Nicholas Camill,1,0,30,29
1657293944337,ECE 180,B00,083141,Abi Samra; Nicholas Camill,0,0,30,30
1657293950365,MATH 10A,A01,083735,Patchell; Gregory David,2,0,30,28
1657293950365,MATH 10A,A02,083736,Patchell; Gregory David,20,0,30,10
1657293950365,MATH 10A,A03,083737,Patchell; Gregory David,16,0,30,14
1657293956401,MATH 10B,A01,083207,Lim; Seonhee,7,0,34,27
1657293956401,MATH 10B,A02,083208,Lim; Seonhee,9,0,35,26
1657293956401,MATH 10B,A03,093472,Lim; Seonhee,5,0,34,29
1657293956401,MATH 10B,B01,083739,Sinha; Shubham,11,0,30,19
1657293962428,MATH 18,A01,083743,Cinel; Cameron Alexander,6,0,30,24
1657293962428,MATH 18,A02,083744,Cinel; Cameron Alexander,17,0,30,13
1657293962428,MATH 18,A03,083745,Cinel; Cameron Alexander,8,0,30,22
1657293962428,MATH 18,B01,083748,Rideout; David Porter,4,0,37,33
1657293962428,MATH 18,B02,083749,Rideout; David Porter,4,0,36,32
1657293962428,MATH 18,B03,083750,Rideout; David Porter,2,0,37,35
1657293962428,MATH 18,B04,083751,Rideout; David Porter,6,0,36,30
1657293962428,MATH 18,B05,093473,Rideout; David Porter,5,0,36,31
1657293962428,MATH 18,B06,093474,Rideout; David Porter,5,0,36,31
1657293968450,MATH 20A,A01,083754,Zheng; Zequn,14,0,40,26
1657293974475,MATH 20B,A01,083756,Briones; Jor-el Thomas Caparas,3,0,36,33
1657293974475,MATH 20B,A02,083757,Briones; Jor-el Thomas Caparas,1,0,36,35
1657293974475,MATH 20B,A03,093475,Briones; Jor-el Thomas Caparas,2,0,36,34
1657293980503,MATH 20C,A01,083760,Briones; Jor-el Thomas Caparas,1,0,35,34
1657293980503,MATH 20C,A02,083761,Briones; Jor-el Thomas Caparas,8,0,35,27
1657293980503,MATH 20C,A03,093476,Briones; Jor-el Thomas Caparas,0,1,36,36
1657293980503,MATH 20C,B01,083762,Bach; Quang Tran,1,0,30,29
1657293986528,MATH 20D,A01,083765,Tran; Brian Kha,5,0,30,25
1657293986528,MATH 20D,A02,083766,Tran; Brian Kha,5,0,30,25
1657293986528,MATH 20D,A03,083767,Tran; Brian Kha,4,0,30,26
1657293992562,MATH 20E,A01,083771,Ganguly; Soumya,7,0,32,25
1657293992562,MATH 20E,A02,083772,Ganguly; Soumya,7,0,32,25
1657293992562,MATH 20E,B01,083773,Ciotti; Benjamin,19,0,35,16
1657293992562,MATH 20E,B02,083774,Ciotti; Benjamin,17,0,35,18
1657293998594,MATH 103A,A01,083777,Greenfeld; Be'Eri,3,0,36,33
1657293998594,MATH 103A,A02,083778,Greenfeld; Be'Eri,5,0,36,31
1657293998594,MATH 103A,A03,093561,Greenfeld; Be'Eri,4,0,36,32
1657293998594,MATH 103A,B01,083779,Greenfeld; Be'Eri,6,0,36,30
1657293998594,MATH 103A,B02,083780,Greenfeld; Be'Eri,3,0,36,33
1657293998594,MATH 103A,B03,093562,Greenfeld; Be'Eri,3,0,36,33
1657294004620,MATH 105,A01,085443,Carter; Anne Toulson,15,0,35,20
1657294004620,MATH 105,A02,093477,Carter; Anne Toulson,20,0,35,15
1657294010652,MATH 109,A01,083213,Ganzberger; Geoffrey Michael,2,0,34,32
1657294010652,MATH 109,A02,083214,Ganzberger; Geoffrey Michael,4,0,34,30
1657294010652,MATH 109,A03,093478,Ganzberger; Geoffrey Michael,2,0,34,32
1657294010652,MATH 109,B01,083215,Ganzberger; Geoffrey Michael,1,0,32,31
1657294010652,MATH 109,B02,083216,Ganzberger; Geoffrey Michael,1,0,32,31
1657294010652,MATH 109,B03,093479,Ganzberger; Geoffrey Michael,8,0,32,24
1657294016707,MATH 142A,A01,083219,Chow; Bennett,7,0,32,25
1657294016707,MATH 142A,A02,083220,Chow; Bennett,10,0,32,22
1657294016707,MATH 142A,A03,093480,Chow; Bennett,7,0,32,25
1657294016707,MATH 142A,B03,093481,Chow; Bennett,8,0,32,24
1657294016707,MATH 142A,B04,093558,Chow; Bennett,12,0,32,20
1657294016707,MATH 142A,B05,093559,Chow; Bennett,6,0,32,26
1657294022733,MATH 193A,A01,083224,Rotar; Vladimir,7,0,34,27
1657294022733,MATH 193A,A02,083225,Rotar; Vladimir,6,0,34,28
1657294022733,MATH 193A,A03,083781,Rotar; Vladimir,2,0,34,32
1657294022733,MATH 193A,A04,083782,Rotar; Vladimir,8,0,34,26
1657294022733,MATH 193A,A05,093482,Rotar; Vladimir,6,0,34,28
1657294028762,MATH 197,001,091859,McAuley; Julian John,9999,0,9999,0
1657294028762,MATH 197,002,095566,Kedlaya; Kiran S.,9997,0,9999,2
1657294028762,MATH 197,003,095567,Xiao; Ming,9999,0,9999,0
1657294028762,MATH 197,004,095571,Perols; Johan Lars,9998,0,9999,1
1657294035819,COGS 9,A01,083615,Shannon; Kyle Michael,8,0,75,67
1657294041846,COGS 11,A01,083617,Boyle; Mary E. T.,22,0,48,26
1657294047878,COGS 13,A01,083071,Bastos; Amalia Pinkusfeld,9,0,71,62
1657294053906,COGS 14A,A01,092681,Semenuks; Arturs,2,1,100,98
1657294059934,COGS 14B,A01,083073,Cheng; Tzu-Han,6,0,63,57
1657294065958,COGS 17,A01,092677,Semenuks; Arturs,5,0,81,76
1657294071986,COGS 100,A01,083619,Allen; Michael Gordon,16,0,70,54
1657294078013,COGS 101A,A01,083621,Davis; Joshua Daniel,9,0,68,59
1657294084040,COGS 101B,A01,091572,Allen; Michael Gordon,11,0,65,54
1657294090067,COGS 101C,A01,083625,Delgado; Tania,17,0,35,18
1657294096092,COGS 107A,A01,083627,Boyle; Mary E. T.,13,0,60,47
1657294102114,COGS 118A,A01,083075,Gupta; Anjum,18,0,76,58
1657294108139,CSE 3,A50,083646,Miranda; Gregory Joseph,24,0,50,26
1657294114174,CSE 8A,A50,083650,Miranda; Gregory Joseph,17,1,56,39
1657294120205,CSE 11,A01,083080,Cao; Yingjun,5,15,40,35
1657294126232,CSE 12,A01,083652,Krause-Levy; Sophia Louisa,26,1,120,94
1657294132259,CSE 15L,A01,083654,Morris; Justin Loren,9,0,50,41
1657294132259,CSE 15L,A02,083655,Morris; Justin Loren,9,0,50,41
1657294138286,CSE 20,A01,083657,Tran; Khoa Dang,38,0,80,42
1657294144322,CSE 21,A01,095574,Bach; Quang Tran,22,0,48,26
1657294150348,CSE 30,A01,083084,Eldon; John,4,0,80,76
1657294150348,CSE 30,B01,095061,Bhaskar; Nishant,8,0,50,42
1657294156372,CSE 100,A01,083659,Cao; Yingjun,4,4,70,66
1657294162411,CSE 134B,A01,083661,Powell; Thomas Allan,21,0,100,79
1657294168442,CSE 140,A01,083663,Gungor; Onat,13,0,85,72
1657294174470,CSE 140L,A01,083088,Eldon; John,19,0,100,81
1657294180502,CSE 175,A01,083665,Kumar; Rakesh,3,0,25,22
1657294186526,CSE 190,A00,092507,Dubnov; Shlomo,7,0,20,13
1657294192551,ECE 45,A01,083139,Congero; Spencer William,6,0,75,69
1657294198578,ECE 65,A50,083695,Saad; Andrew S,12,0,30,18
1657294198578,ECE 65,A51,095125,Saad; Andrew S,25,0,26,1
1657294204601,ECE 109,A01,091882,Touri; Behrouz,19,0,70,51
1657294210624,ECE 180,A00,083140,Abi Samra; Nicholas Camill,1,0,30,29
1657294210624,ECE 180,B00,083141,Abi Samra; Nicholas Camill,0,0,30,30
1657294216651,MATH 10A,A01,083735,Patchell; Gregory David,2,0,30,28
1657294216651,MATH 10A,A02,083736,Patchell; Gregory David,20,0,30,10
1657294216651,MATH 10A,A03,083737,Patchell; Gregory David,16,0,30,14
1657294222681,MATH 10B,A01,083207,Lim; Seonhee,7,0,34,27
1657294222681,MATH 10B,A02,083208,Lim; Seonhee,9,0,35,26
1657294222681,MATH 10B,A03,093472,Lim; Seonhee,5,0,34,29
1657294222681,MATH 10B,B01,083739,Sinha; Shubham,11,0,30,19
1657294228713,MATH 18,A01,083743,Cinel; Cameron Alexander,6,0,30,24
1657294228713,MATH 18,A02,083744,Cinel; Cameron Alexander,17,0,30,13
1657294228713,MATH 18,A03,083745,Cinel; Cameron Alexander,8,0,30,22
1657294228713,MATH 18,B01,083748,Rideout; David Porter,4,0,37,33
1657294228713,MATH 18,B02,083749,Rideout; David Porter,4,0,36,32
1657294228713,MATH 18,B03,083750,Rideout; David Porter,2,0,37,35
1657294228713,MATH 18,B04,083751,Rideout; David Porter,6,0,36,30
1657294228713,MATH 18,B05,093473,Rideout; David Porter,5,0,36,31
1657294228713,MATH 18,B06,093474,Rideout; David Porter,5,0,36,31
1657294234740,MATH 20A,A01,083754,Zheng; Zequn,14,0,40,26
1657294240767,MATH 20B,A01,083756,Briones; Jor-el Thomas Caparas,3,0,36,33
1657294240767,MATH 20B,A02,083757,Briones; Jor-el Thomas Caparas,1,0,36,35
1657294240767,MATH 20B,A03,093475,Briones; Jor-el Thomas Caparas,2,0,36,34
1657294246795,MATH 20C,A01,083760,Briones; Jor-el Thomas Caparas,1,0,35,34
1657294246795,MATH 20C,A02,083761,Briones; Jor-el Thomas Caparas,8,0,35,27
1657294246795,MATH 20C,A03,093476,Briones; Jor-el Thomas Caparas,0,1,36,36
1657294246795,MATH 20C,B01,083762,Bach; Quang Tran,1,0,30,29
1657294252823,MATH 20D,A01,083765,Tran; Brian Kha,5,0,30,25
1657294252823,MATH 20D,A02,083766,Tran; Brian Kha,5,0,30,25
1657294252823,MATH 20D,A03,083767,Tran; Brian Kha,4,0,30,26
1657294258846,MATH 20E,A01,083771,Ganguly; Soumya,7,0,32,25
1657294258846,MATH 20E,A02,083772,Ganguly; Soumya,7,0,32,25
1657294258846,MATH 20E,B01,083773,Ciotti; Benjamin,19,0,35,16
1657294258846,MATH 20E,B02,083774,Ciotti; Benjamin,17,0,35,18
1657294264874,MATH 103A,A01,083777,Greenfeld; Be'Eri,3,0,36,33
1657294264874,MATH 103A,A02,083778,Greenfeld; Be'Eri,5,0,36,31
1657294264874,MATH 103A,A03,093561,Greenfeld; Be'Eri,4,0,36,32
1657294264874,MATH 103A,B01,083779,Greenfeld; Be'Eri,6,0,36,30
1657294264874,MATH 103A,B02,083780,Greenfeld; Be'Eri,3,0,36,33
1657294264874,MATH 103A,B03,093562,Greenfeld; Be'Eri,3,0,36,33
1657294270902,MATH 105,A01,085443,Carter; Anne Toulson,15,0,35,20
1657294270902,MATH 105,A02,093477,Carter; Anne Toulson,20,0,35,15
1657294276925,MATH 109,A01,083213,Ganzberger; Geoffrey Michael,2,0,34,32
1657294276925,MATH 109,A02,083214,Ganzberger; Geoffrey Michael,4,0,34,30
1657294276925,MATH 109,A03,093478,Ganzberger; Geoffrey Michael,2,0,34,32
1657294276925,MATH 109,B01,083215,Ganzberger; Geoffrey Michael,1,0,32,31
1657294276925,MATH 109,B02,083216,Ganzberger; Geoffrey Michael,1,0,32,31
1657294276925,MATH 109,B03,093479,Ganzberger; Geoffrey Michael,8,0,32,24
1657294282950,MATH 142A,A01,083219,Chow; Bennett,7,0,32,25
1657294282950,MATH 142A,A02,083220,Chow; Bennett,10,0,32,22
1657294282950,MATH 142A,A03,093480,Chow; Bennett,7,0,32,25
1657294282950,MATH 142A,B03,093481,Chow; Bennett,8,0,32,24
1657294282950,MATH 142A,B04,093558,Chow; Bennett,12,0,32,20
1657294282950,MATH 142A,B05,093559,Chow; Bennett,6,0,32,26
1657294288976,MATH 193A,A01,083224,Rotar; Vladimir,7,0,34,27
1657294288976,MATH 193A,A02,083225,Rotar; Vladimir,6,0,34,28
1657294288976,MATH 193A,A03,083781,Rotar; Vladimir,2,0,34,32
1657294288976,MATH 193A,A04,083782,Rotar; Vladimir,8,0,34,26
1657294288976,MATH 193A,A05,093482,Rotar; Vladimir,6,0,34,28
1657294295000,MATH 197,001,091859,McAuley; Julian John,9999,0,9999,0
1657294295000,MATH 197,002,095566,Kedlaya; Kiran S.,9997,0,9999,2
1657294295000,MATH 197,003,095567,Xiao; Ming,9999,0,9999,0
1657294295000,MATH 197,004,095571,Perols; Johan Lars,9998,0,9999,1
1657294302060,COGS 9,A01,083615,Shannon; Kyle Michael,8,0,75,67
1657294308089,COGS 11,A01,083617,Boyle; Mary E. T.,22,0,48,26
1657294314114,COGS 13,A01,083071,Bastos; Amalia Pinkusfeld,9,0,71,62
1657294320142,COGS 14A,A01,092681,Semenuks; Arturs,2,1,100,98
1657294326165,COGS 14B,A01,083073,Cheng; Tzu-Han,6,0,63,57
1657294332190,COGS 17,A01,092677,Semenuks; Arturs,5,0,81,76
1657294338216,COGS 100,A01,083619,Allen; Michael Gordon,16,0,70,54
1657294344239,COGS 101A,A01,083621,Davis; Joshua Daniel,9,0,68,59
1657294350262,COGS 101B,A01,091572,Allen; Michael Gordon,11,0,65,54
1657294356285,COGS 101C,A01,083625,Delgado; Tania,17,0,35,18
1657294362313,COGS 107A,A01,083627,Boyle; Mary E. T.,13,0,60,47
1657294368350,COGS 118A,A01,083075,Gupta; Anjum,18,0,76,58
1657294374464,CSE 3,A50,083646,Miranda; Gregory Joseph,24,0,50,26
1657294380491,CSE 8A,A50,083650,Miranda; Gregory Joseph,17,1,56,39
1657294386517,CSE 11,A01,083080,Cao; Yingjun,5,15,40,35
1657294392541,CSE 12,A01,083652,Krause-Levy; Sophia Louisa,26,1,120,94
1657294398564,CSE 15L,A01,083654,Morris; Justin Loren,9,0,50,41
1657294398564,CSE 15L,A02,083655,Morris; Justin Loren,9,0,50,41
1657294404588,CSE 20,A01,083657,Tran; Khoa Dang,38,0,80,42
1657294410618,CSE 21,A01,095574,Bach; Quang Tran,22,0,48,26
1657294416649,CSE 30,A01,083084,Eldon; John,4,0,80,76
1657294416649,CSE 30,B01,095061,Bhaskar; Nishant,8,0,50,42
1657294422676,CSE 100,A01,083659,Cao; Yingjun,4,4,70,66
1657294428699,CSE 134B,A01,083661,Powell; Thomas Allan,21,0,100,79
1657294434732,CSE 140,A01,083663,Gungor; Onat,13,0,85,72
1657294440756,CSE 140L,A01,083088,Eldon; John,19,0,100,81
1657294446785,CSE 175,A01,083665,Kumar; Rakesh,3,0,25,22
1657294452810,CSE 190,A00,092507,Dubnov; Shlomo,7,0,20,13
1657294458838,ECE 45,A01,083139,Congero; Spencer William,6,0,75,69
1657294464863,ECE 65,A50,083695,Saad; Andrew S,12,0,30,18
1657294464863,ECE 65,A51,095125,Saad; Andrew S,25,0,26,1
1657294470888,ECE 109,A01,091882,Touri; Behrouz,19,0,70,51
1657294476919,ECE 180,A00,083140,Abi Samra; Nicholas Camill,1,0,30,29
1657294476919,ECE 180,B00,083141,Abi Samra; Nicholas Camill,0,0,30,30
1657294482943,MATH 10A,A01,083735,Patchell; Gregory David,2,0,30,28
1657294482943,MATH 10A,A02,083736,Patchell; Gregory David,20,0,30,10
1657294482943,MATH 10A,A03,083737,Patchell; Gregory David,16,0,30,14
1657294488971,MATH 10B,A01,083207,Lim; Seonhee,7,0,34,27
1657294488971,MATH 10B,A02,083208,Lim; Seonhee,9,0,35,26
1657294488971,MATH 10B,A03,093472,Lim; Seonhee,5,0,34,29
1657294488971,MATH 10B,B01,083739,Sinha; Shubham,11,0,30,19
1657294495003,MATH 18,A01,083743,Cinel; Cameron Alexander,6,0,30,24
1657294495003,MATH 18,A02,083744,Cinel; Cameron Alexander,17,0,30,13
1657294495003,MATH 18,A03,083745,Cinel; Cameron Alexander,8,0,30,22
1657294495003,MATH 18,B01,083748,Rideout; David Porter,4,0,37,33
1657294495003,MATH 18,B02,083749,Rideout; David Porter,4,0,36,32
1657294495003,MATH 18,B03,083750,Rideout; David Porter,2,0,37,35
1657294495003,MATH 18,B04,083751,Rideout; David Porter,6,0,36,30
1657294495003,MATH 18,B05,093473,Rideout; David Porter,5,0,36,31
1657294495003,MATH 18,B06,093474,Rideout; David Porter,5,0,36,31
1657294501032,MATH 20A,A01,083754,Zheng; Zequn,14,0,40,26
1657294507060,MATH 20B,A01,083756,Briones; Jor-el Thomas Caparas,3,0,36,33
1657294507060,MATH 20B,A02,083757,Briones; Jor-el Thomas Caparas,1,0,36,35
1657294507060,MATH 20B,A03,093475,Briones; Jor-el Thomas Caparas,2,0,36,34
1657294513089,MATH 20C,A01,083760,Briones; Jor-el Thomas Caparas,1,0,35,34
1657294513089,MATH 20C,A02,083761,Briones; Jor-el Thomas Caparas,8,0,35,27
1657294513089,MATH 20C,A03,093476,Briones; Jor-el Thomas Caparas,0,1,36,36
1657294513089,MATH 20C,B01,083762,Bach; Quang Tran,1,0,30,29
1657294519117,MATH 20D,A01,083765,Tran; Brian Kha,5,0,30,25
1657294519117,MATH 20D,A02,083766,Tran; Brian Kha,5,0,30,25
1657294519117,MATH 20D,A03,083767,Tran; Brian Kha,4,0,30,26
1657294525149,MATH 20E,A01,083771,Ganguly; Soumya,7,0,32,25
1657294525149,MATH 20E,A02,083772,Ganguly; Soumya,7,0,32,25
1657294525149,MATH 20E,B01,083773,Ciotti; Benjamin,19,0,35,16
1657294525149,MATH 20E,B02,083774,Ciotti; Benjamin,17,0,35,18
1657294531172,MATH 103A,A01,083777,Greenfeld; Be'Eri,3,0,36,33
1657294531172,MATH 103A,A02,083778,Greenfeld; Be'Eri,5,0,36,31
1657294531172,MATH 103A,A03,093561,Greenfeld; Be'Eri,4,0,36,32
1657294531172,MATH 103A,B01,083779,Greenfeld; Be'Eri,6,0,36,30
1657294531172,MATH 103A,B02,083780,Greenfeld; Be'Eri,3,0,36,33
1657294531172,MATH 103A,B03,093562,Greenfeld; Be'Eri,3,0,36,33
1657294537198,MATH 105,A01,085443,Carter; Anne Toulson,15,0,35,20
1657294537198,MATH 105,A02,093477,Carter; Anne Toulson,20,0,35,15
1657294543227,MATH 109,A01,083213,Ganzberger; Geoffrey Michael,2,0,34,32
1657294543227,MATH 109,A02,083214,Ganzberger; Geoffrey Michael,4,0,34,30
1657294543227,MATH 109,A03,093478,Ganzberger; Geoffrey Michael,2,0,34,32
1657294543227,MATH 109,B01,083215,Ganzberger; Geoffrey Michael,1,0,32,31
1657294543227,MATH 109,B02,083216,Ganzberger; Geoffrey Michael,1,0,32,31
1657294543227,MATH 109,B03,093479,Ganzberger; Geoffrey Michael,8,0,32,24
1657294549257,MATH 142A,A01,083219,Chow; Bennett,7,0,32,25
1657294549257,MATH 142A,A02,083220,Chow; Bennett,10,0,32,22
1657294549257,MATH 142A,A03,093480,Chow; Bennett,7,0,32,25
1657294549257,MATH 142A,B03,093481,Chow; Bennett,8,0,32,24
1657294549257,MATH 142A,B04,093558,Chow; Bennett,12,0,32,20
1657294549257,MATH 142A,B05,093559,Chow; Bennett,6,0,32,26
1657294555281,MATH 193A,A01,083224,Rotar; Vladimir,7,0,34,27
1657294555281,MATH 193A,A02,083225,Rotar; Vladimir,6,0,34,28
1657294555281,MATH 193A,A03,083781,Rotar; Vladimir,2,0,34,32
1657294555281,MATH 193A,A04,083782,Rotar; Vladimir,8,0,34,26
1657294555281,MATH 193A,A05,093482,Rotar; Vladimir,6,0,34,28
1657294561302,MATH 197,001,091859,McAuley; Julian John,9999,0,9999,0
1657294561302,MATH 197,002,095566,Kedlaya; Kiran S.,9997,0,9999,2
1657294561302,MATH 197,003,095567,Xiao; Ming,9999,0,9999,0
1657294561302,MATH 197,004,095571,Perols; Johan Lars,9998,0,9999,1
1657294568366,COGS 9,A01,083615,Shannon; Kyle Michael,8,0,75,67
1657294574393,COGS 11,A01,083617,Boyle; Mary E. T.,22,0,48,26
1657294580414,COGS 13,A01,083071,Bastos; Amalia Pinkusfeld,9,0,71,62
1657294586441,COGS 14A,A01,092681,Semenuks; Arturs,2,1,100,98
1657294592468,COGS 14B,A01,083073,Cheng; Tzu-Han,6,0,63,57
1657294598494,COGS 17,A01,092677,Semenuks; Arturs,5,0,81,76
1657294604528,COGS 100,A01,083619,Allen; Michael Gordon,16,0,70,54
1657294610552,COGS 101A,A01,083621,Davis; Joshua Daniel,9,0,68,59
1657294616577,COGS 101B,A01,091572,Allen; Michael Gordon,11,0,65,54
1657294622603,COGS 101C,A01,083625,Delgado; Tania,17,0,35,18
1657294628627,COGS 107A,A01,083627,Boyle; Mary E. T.,13,0,60,47
1657294634651,COGS 118A,A01,083075,Gupta; Anjum,18,0,76,58
1657294640675,CSE 3,A50,083646,Miranda; Gregory Joseph,24,0,50,26
1657294646703,CSE 8A,A50,083650,Miranda; Gregory Joseph,17,1,56,39
1657294652730,CSE 11,A01,083080,Cao; Yingjun,5,15,40,35
1657294658754,CSE 12,A01,083652,Krause-Levy; Sophia Louisa,26,1,120,94
1657294664782,CSE 15L,A01,083654,Morris; Justin Loren,9,0,50,41
1657294664782,CSE 15L,A02,083655,Morris; Justin Loren,9,0,50,41
1657294670805,CSE 20,A01,083657,Tran; Khoa Dang,38,0,80,42
1657294676832,CSE 21,A01,095574,Bach; Quang Tran,22,0,48,26
1657294682861,CSE 30,A01,083084,Eldon; John,4,0,80,76
1657294682861,CSE 30,B01,095061,Bhaskar; Nishant,8,0,50,42
1657294688890,CSE 100,A01,083659,Cao; Yingjun,4,4,70,66
1657294694915,CSE 134B,A01,083661,Powell; Thomas Allan,21,0,100,79
1657294700940,CSE 140,A01,083663,Gungor; Onat,13,0,85,72
1657294706967,CSE 140L,A01,083088,Eldon; John,19,0,100,81
1657294712993,CSE 175,A01,083665,Kumar; Rakesh,3,0,25,22
1657294719015,CSE 190,A00,092507,Dubnov; Shlomo,7,0,20,13
1657294725039,ECE 45,A01,083139,Congero; Spencer William,6,0,75,69
1657294731061,ECE 65,A50,083695,Saad; Andrew S,12,0,30,18
1657294731061,ECE 65,A51,095125,Saad; Andrew S,25,0,26,1
1657294737087,ECE 109,A01,091882,Touri; Behrouz,19,0,70,51
1657294743111,ECE 180,A00,083140,Abi Samra; Nicholas Camill,1,0,30,29
1657294743111,ECE 180,B00,083141,Abi Samra; Nicholas Camill,0,0,30,30
1657294749135,MATH 10A,A01,083735,Patchell; Gregory David,2,0,30,28
1657294749135,MATH 10A,A02,083736,Patchell; Gregory David,20,0,30,10
1657294749135,MATH 10A,A03,083737,Patchell; Gregory David,16,0,30,14
1657294755159,MATH 10B,A01,083207,Lim; Seonhee,7,0,34,27
1657294755159,MATH 10B,A02,083208,Lim; Seonhee,9,0,35,26
1657294755159,MATH 10B,A03,093472,Lim; Seonhee,5,0,34,29
1657294755159,MATH 10B,B01,083739,Sinha; Shubham,11,0,30,19
1657294761189,MATH 18,A01,083743,Cinel; Cameron Alexander,6,0,30,24
1657294761189,MATH 18,A02,083744,Cinel; Cameron Alexander,17,0,30,13
1657294761189,MATH 18,A03,083745,Cinel; Cameron Alexander,8,0,30,22
1657294761189,MATH 18,B01,083748,Rideout; David Porter,4,0,37,33
1657294761189,MATH 18,B02,083749,Rideout; David Porter,4,0,36,32
1657294761189,MATH 18,B03,083750,Rideout; David Porter,2,0,37,35
1657294761189,MATH 18,B04,083751,Rideout; David Porter,6,0,36,30
1657294761189,MATH 18,B05,093473,Rideout; David Porter,5,0,36,31
1657294761189,MATH 18,B06,093474,Rideout; David Porter,5,0,36,31
1657294767215,MATH 20A,A01,083754,Zheng; Zequn,14,0,40,26
1657294773244,MATH 20B,A01,083756,Briones; Jor-el Thomas Caparas,3,0,36,33
1657294773244,MATH 20B,A02,083757,Briones; Jor-el Thomas Caparas,1,0,36,35
1657294773244,MATH 20B,A03,093475,Briones; Jor-el Thomas Caparas,2,0,36,34
1657294779267,MATH 20C,A01,083760,Briones; Jor-el Thomas Caparas,1,0,35,34
1657294779267,MATH 20C,A02,083761,Briones; Jor-el Thomas Caparas,8,0,35,27
1657294779267,MATH 20C,A03,093476,Briones; Jor-el Thomas Caparas,0,1,36,36
1657294779267,MATH 20C,B01,083762,Bach; Quang Tran,1,0,30,29
1657294785290,MATH 20D,A01,083765,Tran; Brian Kha,5,0,30,25
1657294785290,MATH 20D,A02,083766,Tran; Brian Kha,5,0,30,25
1657294785290,MATH 20D,A03,083767,Tran; Brian Kha,4,0,30,26
1657294791321,MATH 20E,A01,083771,Ganguly; Soumya,7,0,32,25
1657294791321,MATH 20E,A02,083772,Ganguly; Soumya,7,0,32,25
1657294791321,MATH 20E,B01,083773,Ciotti; Benjamin,19,0,35,16
1657294791321,MATH 20E,B02,083774,Ciotti; Benjamin,17,0,35,18
1657294797350,MATH 103A,A01,083777,Greenfeld; Be'Eri,3,0,36,33
1657294797350,MATH 103A,A02,083778,Greenfeld; Be'Eri,5,0,36,31
1657294797350,MATH 103A,A03,093561,Greenfeld; Be'Eri,4,0,36,32
1657294797350,MATH 103A,B01,083779,Greenfeld; Be'Eri,6,0,36,30
1657294797350,MATH 103A,B02,083780,Greenfeld; Be'Eri,3,0,36,33
1657294797350,MATH 103A,B03,093562,Greenfeld; Be'Eri,3,0,36,33
1657294803376,MATH 105,A01,085443,Carter; Anne Toulson,15,0,35,20
1657294803376,MATH 105,A02,093477,Carter; Anne Toulson,20,0,35,15
1657294809406,MATH 109,A01,083213,Ganzberger; Geoffrey Michael,2,0,34,32
1657294809406,MATH 109,A02,083214,Ganzberger; Geoffrey Michael,4,0,34,30
1657294809406,MATH 109,A03,093478,Ganzberger; Geoffrey Michael,2,0,34,32
1657294809406,MATH 109,B01,083215,Ganzberger; Geoffrey Michael,1,0,32,31
1657294809406,MATH 109,B02,083216,Ganzberger; Geoffrey Michael,1,0,32,31
1657294809406,MATH 109,B03,093479,Ganzberger; Geoffrey Michael,8,0,32,24
1657294815437,MATH 142A,A01,083219,Chow; Bennett,7,0,32,25
1657294815437,MATH 142A,A02,083220,Chow; Bennett,10,0,32,22
1657294815437,MATH 142A,A03,093480,Chow; Bennett,7,0,32,25
1657294815437,MATH 142A,B03,093481,Chow; Bennett,8,0,32,24
1657294815437,MATH 142A,B04,093558,Chow; Bennett,12,0,32,20
1657294815437,MATH 142A,B05,093559,Chow; Bennett,6,0,32,26
1657294821462,MATH 193A,A01,083224,Rotar; Vladimir,7,0,34,27
1657294821462,MATH 193A,A02,083225,Rotar; Vladimir,6,0,34,28
1657294821462,MATH 193A,A03,083781,Rotar; Vladimir,2,0,34,32
1657294821462,MATH 193A,A04,083782,Rotar; Vladimir,8,0,34,26
1657294821462,MATH 193A,A05,093482,Rotar; Vladimir,6,0,34,28
1657294827489,MATH 197,001,091859,McAuley; Julian John,9999,0,9999,0
1657294827489,MATH 197,002,095566,Kedlaya; Kiran S.,9997,0,9999,2
1657294827489,MATH 197,003,095567,Xiao; Ming,9999,0,9999,0
1657294827489,MATH 197,004,095571,Perols; Johan Lars,9998,0,9999,1
1657294834541,COGS 9,A01,083615,Shannon; Kyle Michael,8,0,75,67
1657294840583,COGS 11,A01,083617,Boyle; Mary E. T.,22,0,48,26
1657294846613,COGS 13,A01,083071,Bastos; Amalia Pinkusfeld,9,0,71,62
1657294852643,COGS 14A,A01,092681,Semenuks; Arturs,2,1,100,98
1657294858673,COGS 14B,A01,083073,Cheng; Tzu-Han,6,0,63,57
1657294864697,COGS 17,A01,092677,Semenuks; Arturs,5,0,81,76
1657294870726,COGS 100,A01,083619,Allen; Michael Gordon,16,0,70,54
1657294876747,COGS 101A,A01,083621,Davis; Joshua Daniel,9,0,68,59
1657294882771,COGS 101B,A01,091572,Allen; Michael Gordon,11,0,65,54
1657294888797,COGS 101C,A01,083625,Delgado; Tania,17,0,35,18
1657294894819,COGS 107A,A01,083627,Boyle; Mary E. T.,13,0,60,47
1657294900841,COGS 118A,A01,083075,Gupta; Anjum,18,0,76,58
1657294906868,CSE 3,A50,083646,Miranda; Gregory Joseph,24,0,50,26
1657294912898,CSE 8A,A50,083650,Miranda; Gregory Joseph,17,1,56,39
1657294918922,CSE 11,A01,083080,Cao; Yingjun,5,15,40,35
1657294924947,CSE 12,A01,083652,Krause-Levy; Sophia Louisa,26,1,120,94
1657294930975,CSE 15L,A01,083654,Morris; Justin Loren,9,0,50,41
1657294930975,CSE 15L,A02,083655,Morris; Justin Loren,9,0,50,41
1657294937008,CSE 20,A01,083657,Tran; Khoa Dang,38,0,80,42
1657294943031,CSE 21,A01,095574,Bach; Quang Tran,22,0,48,26
1657294949065,CSE 30,A01,083084,Eldon; John,4,0,80,76
1657294949065,CSE 30,B01,095061,Bhaskar; Nishant,8,0,50,42
1657294955089,CSE 100,A01,083659,Cao; Yingjun,4,4,70,66
1657294961113,CSE 134B,A01,083661,Powell; Thomas Allan,21,0,100,79
1657294967139,CSE 140,A01,083663,Gungor; Onat,13,0,85,72
1657294973239,CSE 140L,A01,083088,Eldon; John,19,0,100,81
1657294979268,CSE 175,A01,083665,Kumar; Rakesh,3,0,25,22
1657294985298,CSE 190,A00,092507,Dubnov; Shlomo,7,0,20,13
1657294991325,ECE 45,A01,083139,Congero; Spencer William,6,0,75,69
1657294997350,ECE 65,A50,083695,Saad; Andrew S,12,0,30,18
1657294997350,ECE 65,A51,095125,Saad; Andrew S,25,0,26,1
1657295003383,ECE 109,A01,091882,Touri; Behrouz,19,0,70,51
1657295009411,ECE 180,A00,083140,Abi Samra; Nicholas Camill,1,0,30,29
1657295009411,ECE 180,B00,083141,Abi Samra; Nicholas Camill,0,0,30,30
1657295015452,MATH 10A,A01,083735,Patchell; Gregory David,2,0,30,28
1657295015452,MATH 10A,A02,083736,Patchell; Gregory David,20,0,30,10
1657295015452,MATH 10A,A03,083737,Patchell; Gregory David,16,0,30,14
1657295021479,MATH 10B,A01,083207,Lim; Seonhee,7,0,34,27
1657295021479,MATH 10B,A02,083208,Lim; Seonhee,9,0,35,26
1657295021479,MATH 10B,A03,093472,Lim; Seonhee,5,0,34,29
1657295021479,MATH 10B,B01,083739,Sinha; Shubham,11,0,30,19
1657295027504,MATH 18,A01,083743,Cinel; Cameron Alexander,6,0,30,24
1657295027504,MATH 18,A02,083744,Cinel; Cameron Alexander,17,0,30,13
1657295027504,MATH 18,A03,083745,Cinel; Cameron Alexander,8,0,30,22
1657295027504,MATH 18,B01,083748,Rideout; David Porter,4,0,37,33
1657295027504,MATH 18,B02,083749,Rideout; David Porter,4,0,36,32
1657295027504,MATH 18,B03,083750,Rideout; David Porter,2,0,37,35
1657295027504,MATH 18,B04,083751,Rideout; David Porter,6,0,36,30
1657295027504,MATH 18,B05,093473,Rideout; David Porter,5,0,36,31
1657295027504,MATH 18,B06,093474,Rideout; David Porter,5,0,36,31
1657295033526,MATH 20A,A01,083754,Zheng; Zequn,14,0,40,26
1657295039549,MATH 20B,A01,083756,Briones; Jor-el Thomas Caparas,3,0,36,33
1657295039549,MATH 20B,A02,083757,Briones; Jor-el Thomas Caparas,1,0,36,35
1657295039549,MATH 20B,A03,093475,Briones; Jor-el Thomas Caparas,2,0,36,34
1657295045579,MATH 20C,A01,083760,Briones; Jor-el Thomas Caparas,1,0,35,34
1657295045579,MATH 20C,A02,083761,Briones; Jor-el Thomas Caparas,8,0,35,27
1657295045579,MATH 20C,A03,093476,Briones; Jor-el Thomas Caparas,0,1,36,36
1657295045579,MATH 20C,B01,083762,Bach; Quang Tran,1,0,30,29
1657295051604,MATH 20D,A01,083765,Tran; Brian Kha,5,0,30,25
1657295051604,MATH 20D,A02,083766,Tran; Brian Kha,5,0,30,25
1657295051604,MATH 20D,A03,083767,Tran; Brian Kha,4,0,30,26
1657295057632,MATH 20E,A01,083771,Ganguly; Soumya,7,0,32,25
1657295057632,MATH 20E,A02,083772,Ganguly; Soumya,7,0,32,25
1657295057632,MATH 20E,B01,083773,Ciotti; Benjamin,19,0,35,16
1657295057632,MATH 20E,B02,083774,Ciotti; Benjamin,17,0,35,18
1657295063662,MATH 103A,A01,083777,Greenfeld; Be'Eri,3,0,36,33
1657295063662,MATH 103A,A02,083778,Greenfeld; Be'Eri,5,0,36,31
1657295063662,MATH 103A,A03,093561,Greenfeld; Be'Eri,4,0,36,32
1657295063662,MATH 103A,B01,083779,Greenfeld; Be'Eri,6,0,36,30
1657295063662,MATH 103A,B02,083780,Greenfeld; Be'Eri,3,0,36,33
1657295063662,MATH 103A,B03,093562,Greenfeld; Be'Eri,3,0,36,33
1657295069691,MATH 105,A01,085443,Carter; Anne Toulson,15,0,35,20
1657295069691,MATH 105,A02,093477,Carter; Anne Toulson,20,0,35,15
1657295075719,MATH 109,A01,083213,Ganzberger; Geoffrey Michael,2,0,34,32
1657295075719,MATH 109,A02,083214,Ganzberger; Geoffrey Michael,4,0,34,30
1657295075719,MATH 109,A03,093478,Ganzberger; Geoffrey Michael,2,0,34,32
1657295075719,MATH 109,B01,083215,Ganzberger; Geoffrey Michael,1,0,32,31
1657295075719,MATH 109,B02,083216,Ganzberger; Geoffrey Michael,1,0,32,31
1657295075719,MATH 109,B03,093479,Ganzberger; Geoffrey Michael,8,0,32,24
1657295081747,MATH 142A,A01,083219,Chow; Bennett,7,0,32,25
1657295081747,MATH 142A,A02,083220,Chow; Bennett,10,0,32,22
1657295081747,MATH 142A,A03,093480,Chow; Bennett,7,0,32,25
1657295081747,MATH 142A,B03,093481,Chow; Bennett,8,0,32,24
1657295081747,MATH 142A,B04,093558,Chow; Bennett,12,0,32,20
1657295081747,MATH 142A,B05,093559,Chow; Bennett,6,0,32,26
1657295087773,MATH 193A,A01,083224,Rotar; Vladimir,7,0,34,27
1657295087773,MATH 193A,A02,083225,Rotar; Vladimir,6,0,34,28
1657295087773,MATH 193A,A03,083781,Rotar; Vladimir,2,0,34,32
1657295087773,MATH 193A,A04,083782,Rotar; Vladimir,8,0,34,26
1657295087773,MATH 193A,A05,093482,Rotar; Vladimir,6,0,34,28
1657295093799,MATH 197,001,091859,McAuley; Julian John,9999,0,9999,0
1657295093799,MATH 197,002,095566,Kedlaya; Kiran S.,9997,0,9999,2
1657295093799,MATH 197,003,095567,Xiao; Ming,9999,0,9999,0
1657295093799,MATH 197,004,095571,Perols; Johan Lars,9998,0,9999,1
1657295100866,COGS 9,A01,083615,Shannon; Kyle Michael,8,0,75,67
1657295106888,COGS 11,A01,083617,Boyle; Mary E. T.,22,0,48,26
1657295112915,COGS 13,A01,083071,Bastos; Amalia Pinkusfeld,9,0,71,62
1657295118939,COGS 14A,A01,092681,Semenuks; Arturs,2,1,100,98
1657295124966,COGS 14B,A01,083073,Cheng; Tzu-Han,6,0,63,57
1657295131001,COGS 17,A01,092677,Semenuks; Arturs,5,0,81,76
1657295137023,COGS 100,A01,083619,Allen; Michael Gordon,16,0,70,54
1657295143046,COGS 101A,A01,083621,Davis; Joshua Daniel,9,0,68,59
1657295149069,COGS 101B,A01,091572,Allen; Michael Gordon,11,0,65,54
1657295155098,COGS 101C,A01,083625,Delgado; Tania,17,0,35,18
1657295161136,COGS 107A,A01,083627,Boyle; Mary E. T.,13,0,60,47
1657295167163,COGS 118A,A01,083075,Gupta; Anjum,18,0,76,58
1657295173188,CSE 3,A50,083646,Miranda; Gregory Joseph,24,0,50,26
1657295179211,CSE 8A,A50,083650,Miranda; Gregory Joseph,17,1,56,39
1657295185242,CSE 11,A01,083080,Cao; Yingjun,5,15,40,35
1657295191265,CSE 12,A01,083652,Krause-Levy; Sophia Louisa,26,1,120,94
1657295197291,CSE 15L,A01,083654,Morris; Justin Loren,9,0,50,41
1657295197291,CSE 15L,A02,083655,Morris; Justin Loren,9,0,50,41
1657295203328,CSE 20,A01,083657,Tran; Khoa Dang,38,0,80,42
1657295209355,CSE 21,A01,095574,Bach; Quang Tran,22,0,48,26
1657295215379,CSE 30,A01,083084,Eldon; John,4,0,80,76
1657295215379,CSE 30,B01,095061,Bhaskar; Nishant,8,0,50,42
1657295221404,CSE 100,A01,083659,Cao; Yingjun,4,4,70,66
1657295227434,CSE 134B,A01,083661,Powell; Thomas Allan,21,0,100,79
1657295233461,CSE 140,A01,083663,Gungor; Onat,13,0,85,72
1657295239484,CSE 140L,A01,083088,Eldon; John,19,0,100,81
1657295245508,CSE 175,A01,083665,Kumar; Rakesh,3,0,25,22
1657295251545,CSE 190,A00,092507,Dubnov; Shlomo,7,0,20,13
1657295257571,ECE 45,A01,083139,Congero; Spencer William,6,0,75,69
1657295263599,ECE 65,A50,083695,Saad; Andrew S,12,0,30,18
1657295263599,ECE 65,A51,095125,Saad; Andrew S,25,0,26,1
1657295269626,ECE 109,A01,091882,Touri; Behrouz,19,0,70,51
1657295275649,ECE 180,A00,083140,Abi Samra; Nicholas Camill,1,0,30,29
1657295275649,ECE 180,B00,083141,Abi Samra; Nicholas Camill,0,0,30,30
1657295281685,MATH 10A,A01,083735,Patchell; Gregory David,2,0,30,28
1657295281685,MATH 10A,A02,083736,Patchell; Gregory David,20,0,30,10
1657295281685,MATH 10A,A03,083737,Patchell; Gregory David,16,0,30,14
1657295287713,MATH 10B,A01,083207,Lim; Seonhee,7,0,34,27
1657295287713,MATH 10B,A02,083208,Lim; Seonhee,9,0,35,26
1657295287713,MATH 10B,A03,093472,Lim; Seonhee,5,0,34,29
1657295287713,MATH 10B,B01,083739,Sinha; Shubham,11,0,30,19
1657295293747,MATH 18,A01,083743,Cinel; Cameron Alexander,6,0,30,24
1657295293747,MATH 18,A02,083744,Cinel; Cameron Alexander,17,0,30,13
1657295293747,MATH 18,A03,083745,Cinel; Cameron Alexander,8,0,30,22
1657295293747,MATH 18,B01,083748,Rideout; David Porter,4,0,37,33
1657295293747,MATH 18,B02,083749,Rideout; David Porter,4,0,36,32
1657295293747,MATH 18,B03,083750,Rideout; David Porter,2,0,37,35
1657295293747,MATH 18,B04,083751,Rideout; David Porter,6,0,36,30
1657295293747,MATH 18,B05,093473,Rideout; David Porter,5,0,36,31
1657295293747,MATH 18,B06,093474,Rideout; David Porter,5,0,36,31
1657295299768,MATH 20A,A01,083754,Zheng; Zequn,14,0,40,26
1657295305795,MATH 20B,A01,083756,Briones; Jor-el Thomas Caparas,3,0,36,33
1657295305795,MATH 20B,A02,083757,Briones; Jor-el Thomas Caparas,1,0,36,35
1657295305795,MATH 20B,A03,093475,Briones; Jor-el Thomas Caparas,2,0,36,34
1657295311818,MATH 20C,A01,083760,Briones; Jor-el Thomas Caparas,1,0,35,34
1657295311818,MATH 20C,A02,083761,Briones; Jor-el Thomas Caparas,8,0,35,27
1657295311818,MATH 20C,A03,093476,Briones; Jor-el Thomas Caparas,0,1,36,36
1657295311818,MATH 20C,B01,083762,Bach; Quang Tran,1,0,30,29
1657295317842,MATH 20D,A01,083765,Tran; Brian Kha,5,0,30,25
1657295317842,MATH 20D,A02,083766,Tran; Brian Kha,5,0,30,25
1657295317842,MATH 20D,A03,083767,Tran; Brian Kha,4,0,30,26
1657295323869,MATH 20E,A01,083771,Ganguly; Soumya,7,0,32,25
1657295323869,MATH 20E,A02,083772,Ganguly; Soumya,6,0,32,26
1657295323869,MATH 20E,B01,083773,Ciotti; Benjamin,19,0,35,16
1657295323869,MATH 20E,B02,083774,Ciotti; Benjamin,17,0,35,18
1657295329895,MATH 103A,A01,083777,Greenfeld; Be'Eri,3,0,36,33
1657295329895,MATH 103A,A02,083778,Greenfeld; Be'Eri,5,0,36,31
1657295329895,MATH 103A,A03,093561,Greenfeld; Be'Eri,4,0,36,32
1657295329895,MATH 103A,B01,083779,Greenfeld; Be'Eri,6,0,36,30
1657295329895,MATH 103A,B02,083780,Greenfeld; Be'Eri,3,0,36,33
1657295329895,MATH 103A,B03,093562,Greenfeld; Be'Eri,3,0,36,33
1657295335920,MATH 105,A01,085443,Carter; Anne Toulson,15,0,35,20
1657295335920,MATH 105,A02,093477,Carter; Anne Toulson,20,0,35,15
1657295341948,MATH 109,A01,083213,Ganzberger; Geoffrey Michael,2,0,34,32
1657295341948,MATH 109,A02,083214,Ganzberger; Geoffrey Michael,4,0,34,30
1657295341948,MATH 109,A03,093478,Ganzberger; Geoffrey Michael,2,0,34,32
1657295341948,MATH 109,B01,083215,Ganzberger; Geoffrey Michael,1,0,32,31
1657295341948,MATH 109,B02,083216,Ganzberger; Geoffrey Michael,1,0,32,31
1657295341948,MATH 109,B03,093479,Ganzberger; Geoffrey Michael,8,0,32,24
1657295347971,MATH 142A,A01,083219,Chow; Bennett,7,0,32,25
1657295347971,MATH 142A,A02,083220,Chow; Bennett,10,0,32,22
1657295347971,MATH 142A,A03,093480,Chow; Bennett,7,0,32,25
1657295347971,MATH 142A,B03,093481,Chow; Bennett,8,0,32,24
1657295347971,MATH 142A,B04,093558,Chow; Bennett,12,0,32,20
1657295347971,MATH 142A,B05,093559,Chow; Bennett,6,0,32,26
1657295354003,MATH 193A,A01,083224,Rotar; Vladimir,7,0,34,27
1657295354003,MATH 193A,A02,083225,Rotar; Vladimir,6,0,34,28
1657295354003,MATH 193A,A03,083781,Rotar; Vladimir,2,0,34,32
1657295354003,MATH 193A,A04,083782,Rotar; Vladimir,8,0,34,26
1657295354003,MATH 193A,A05,093482,Rotar; Vladimir,6,0,34,28
1657295360028,MATH 197,001,091859,McAuley; Julian John,9999,0,9999,0
1657295360028,MATH 197,002,095566,Kedlaya; Kiran S.,9997,0,9999,2
1657295360028,MATH 197,003,095567,Xiao; Ming,9999,0,9999,0
1657295360028,MATH 197,004,095571,Perols; Johan Lars,9998,0,9999,1
1657295367094,COGS 9,A01,083615,Shannon; Kyle Michael,8,0,75,67
1657295373127,COGS 11,A01,083617,Boyle; Mary E. T.,22,0,48,26
1657295379150,COGS 13,A01,083071,Bastos; Amalia Pinkusfeld,9,0,71,62
1657295385178,COGS 14A,A01,092681,Semenuks; Arturs,2,1,100,98
1657295391205,COGS 14B,A01,083073,Cheng; Tzu-Han,6,0,63,57
1657295397229,COGS 17,A01,092677,Semenuks; Arturs,5,0,81,76
1657295403252,COGS 100,A01,083619,Allen; Michael Gordon,16,0,70,54
1657295409277,COGS 101A,A01,083621,Davis; Joshua Daniel,9,0,68,59
1657295415303,COGS 101B,A01,091572,Allen; Michael Gordon,11,0,65,54
1657295421330,COGS 101C,A01,083625,Delgado; Tania,17,0,35,18
1657295427355,COGS 107A,A01,083627,Boyle; Mary E. T.,13,0,60,47
1657295433382,COGS 118A,A01,083075,Gupta; Anjum,18,0,76,58
1657295439419,CSE 3,A50,083646,Miranda; Gregory Joseph,24,0,50,26
1657295445442,CSE 8A,A50,083650,Miranda; Gregory Joseph,17,1,56,39
1657295451467,CSE 11,A01,083080,Cao; Yingjun,5,15,40,35
1657295457492,CSE 12,A01,083652,Krause-Levy; Sophia Louisa,26,1,120,94
1657295463517,CSE 15L,A01,083654,Morris; Justin Loren,9,0,50,41
1657295463517,CSE 15L,A02,083655,Morris; Justin Loren,9,0,50,41
1657295469539,CSE 20,A01,083657,Tran; Khoa Dang,38,0,80,42
1657295475564,CSE 21,A01,095574,Bach; Quang Tran,22,0,48,26
1657295481599,CSE 30,A01,083084,Eldon; John,4,0,80,76
1657295481599,CSE 30,B01,095061,Bhaskar; Nishant,8,0,50,42
1657295487626,CSE 100,A01,083659,Cao; Yingjun,4,4,70,66
1657295493649,CSE 134B,A01,083661,Powell; Thomas Allan,21,0,100,79
1657295499672,CSE 140,A01,083663,Gungor; Onat,13,0,85,72
1657295505702,CSE 140L,A01,083088,Eldon; John,19,0,100,81
1657295511725,CSE 175,A01,083665,Kumar; Rakesh,3,0,25,22
1657295517761,CSE 190,A00,092507,Dubnov; Shlomo,7,0,20,13
1657295523790,ECE 45,A01,083139,Congero; Spencer William,6,0,75,69
1657295529815,ECE 65,A50,083695,Saad; Andrew S,12,0,30,18
1657295529815,ECE 65,A51,095125,Saad; Andrew S,25,0,26,1
1657295535840,ECE 109,A01,091882,Touri; Behrouz,19,0,70,51
1657295541864,ECE 180,A00,083140,Abi Samra; Nicholas Camill,1,0,30,29
1657295541864,ECE 180,B00,083141,Abi Samra; Nicholas Camill,0,0,30,30
1657295547892,MATH 10A,A01,083735,Patchell; Gregory David,2,0,30,28
1657295547892,MATH 10A,A02,083736,Patchell; Gregory David,20,0,30,10
1657295547892,MATH 10A,A03,083737,Patchell; Gregory David,16,0,30,14
1657295553922,MATH 10B,A01,083207,Lim; Seonhee,7,0,34,27
1657295553922,MATH 10B,A02,083208,Lim; Seonhee,9,0,35,26
1657295553922,MATH 10B,A03,093472,Lim; Seonhee,5,0,34,29
1657295553922,MATH 10B,B01,083739,Sinha; Shubham,11,0,30,19
1657295559953,MATH 18,A01,083743,Cinel; Cameron Alexander,6,0,30,24
1657295559953,MATH 18,A02,083744,Cinel; Cameron Alexander,17,0,30,13
1657295559953,MATH 18,A03,083745,Cinel; Cameron Alexander,8,0,30,22
1657295559953,MATH 18,B01,083748,Rideout; David Porter,4,0,37,33
1657295559953,MATH 18,B02,083749,Rideout; David Porter,4,0,36,32
1657295559953,MATH 18,B03,083750,Rideout; David Porter,2,0,37,35
1657295559953,MATH 18,B04,083751,Rideout; David Porter,6,0,36,30
1657295559953,MATH 18,B05,093473,Rideout; David Porter,5,0,36,31
1657295559953,MATH 18,B06,093474,Rideout; David Porter,5,0,36,31
1657295565976,MATH 20A,A01,083754,Zheng; Zequn,14,0,40,26
1657295572093,MATH 20B,A01,083756,Briones; Jor-el Thomas Caparas,3,0,36,33
1657295572093,MATH 20B,A02,083757,Briones; Jor-el Thomas Caparas,1,0,36,35
1657295572093,MATH 20B,A03,093475,Briones; Jor-el Thomas Caparas,2,0,36,34
1657295578116,MATH 20C,A01,083760,Briones; Jor-el Thomas Caparas,1,0,35,34
1657295578116,MATH 20C,A02,083761,Briones; Jor-el Thomas Caparas,8,0,35,27
1657295578116,MATH 20C,A03,093476,Briones; Jor-el Thomas Caparas,0,1,36,36
1657295578116,MATH 20C,B01,083762,Bach; Quang Tran,1,0,30,29
1657295584140,MATH 20D,A01,083765,Tran; Brian Kha,5,0,30,25
1657295584140,MATH 20D,A02,083766,Tran; Brian Kha,5,0,30,25
1657295584140,MATH 20D,A03,083767,Tran; Brian Kha,4,0,30,26
1657295590168,MATH 20E,A01,083771,Ganguly; Soumya,7,0,32,25
1657295590168,MATH 20E,A02,083772,Ganguly; Soumya,6,0,32,26
1657295590168,MATH 20E,B01,083773,Ciotti; Benjamin,19,0,35,16
1657295590168,MATH 20E,B02,083774,Ciotti; Benjamin,17,0,35,18
1657295596197,MATH 103A,A01,083777,Greenfeld; Be'Eri,3,0,36,33
1657295596197,MATH 103A,A02,083778,Greenfeld; Be'Eri,5,0,36,31
1657295596197,MATH 103A,A03,093561,Greenfeld; Be'Eri,4,0,36,32
1657295596197,MATH 103A,B01,083779,Greenfeld; Be'Eri,6,0,36,30
1657295596197,MATH 103A,B02,083780,Greenfeld; Be'Eri,3,0,36,33
1657295596197,MATH 103A,B03,093562,Greenfeld; Be'Eri,3,0,36,33
1657295602220,MATH 105,A01,085443,Carter; Anne Toulson,15,0,35,20
1657295602220,MATH 105,A02,093477,Carter; Anne Toulson,20,0,35,15
1657295608261,MATH 109,A01,083213,Ganzberger; Geoffrey Michael,2,0,34,32
1657295608261,MATH 109,A02,083214,Ganzberger; Geoffrey Michael,4,0,34,30
1657295608261,MATH 109,A03,093478,Ganzberger; Geoffrey Michael,2,0,34,32
1657295608261,MATH 109,B01,083215,Ganzberger; Geoffrey Michael,1,0,32,31
1657295608261,MATH 109,B02,083216,Ganzberger; Geoffrey Michael,1,0,32,31
1657295608261,MATH 109,B03,093479,Ganzberger; Geoffrey Michael,8,0,32,24
1657295614294,MATH 142A,A01,083219,Chow; Bennett,7,0,32,25
1657295614294,MATH 142A,A02,083220,Chow; Bennett,10,0,32,22
1657295614294,MATH 142A,A03,093480,Chow; Bennett,7,0,32,25
1657295614294,MATH 142A,B03,093481,Chow; Bennett,8,0,32,24
1657295614294,MATH 142A,B04,093558,Chow; Bennett,12,0,32,20
1657295614294,MATH 142A,B05,093559,Chow; Bennett,6,0,32,26
1657295620318,MATH 193A,A01,083224,Rotar; Vladimir,7,0,34,27
1657295620318,MATH 193A,A02,083225,Rotar; Vladimir,6,0,34,28
1657295620318,MATH 193A,A03,083781,Rotar; Vladimir,2,0,34,32
1657295620318,MATH 193A,A04,083782,Rotar; Vladimir,8,0,34,26
1657295620318,MATH 193A,A05,093482,Rotar; Vladimir,6,0,34,28
1657295626344,MATH 197,001,091859,McAuley; Julian John,9999,0,9999,0
1657295626344,MATH 197,002,095566,Kedlaya; Kiran S.,9997,0,9999,2
1657295626344,MATH 197,003,095567,Xiao; Ming,9999,0,9999,0
1657295626344,MATH 197,004,095571,Perols; Johan Lars,9998,0,9999,1
1657295633410,COGS 9,A01,083615,Shannon; Kyle Michael,8,0,75,67
1657295639436,COGS 11,A01,083617,Boyle; Mary E. T.,22,0,48,26
1657295645460,COGS 13,A01,083071,Bastos; Amalia Pinkusfeld,9,0,71,62
1657295651505,COGS 14A,A01,092681,Semenuks; Arturs,2,1,100,98
1657295657536,COGS 14B,A01,083073,Cheng; Tzu-Han,6,0,63,57
1657295663564,COGS 17,A01,092677,Semenuks; Arturs,5,0,81,76
1657295669590,COGS 100,A01,083619,Allen; Michael Gordon,16,0,70,54
1657295675613,COGS 101A,A01,083621,Davis; Joshua Daniel,9,0,68,59
1657295681639,COGS 101B,A01,091572,Allen; Michael Gordon,11,0,65,54
1657295687661,COGS 101C,A01,083625,Delgado; Tania,17,0,35,18
1657295693685,COGS 107A,A01,083627,Boyle; Mary E. T.,13,0,60,47
1657295699708,COGS 118A,A01,083075,Gupta; Anjum,18,0,76,58
1657295705731,CSE 3,A50,083646,Miranda; Gregory Joseph,24,0,50,26
1657295711756,CSE 8A,A50,083650,Miranda; Gregory Joseph,17,1,56,39
1657295717779,CSE 11,A01,083080,Cao; Yingjun,5,15,40,35
1657295723802,CSE 12,A01,083652,Krause-Levy; Sophia Louisa,26,1,120,94
1657295729824,CSE 15L,A01,083654,Morris; Justin Loren,9,0,50,41
1657295729824,CSE 15L,A02,083655,Morris; Justin Loren,9,0,50,41
1657295735847,CSE 20,A01,083657,Tran; Khoa Dang,38,0,80,42
1657295741875,CSE 21,A01,095574,Bach; Quang Tran,22,0,48,26
1657295747908,CSE 30,A01,083084,Eldon; John,4,0,80,76
1657295747908,CSE 30,B01,095061,Bhaskar; Nishant,8,0,50,42
1657295753931,CSE 100,A01,083659,Cao; Yingjun,4,4,70,66
1657295759956,CSE 134B,A01,083661,Powell; Thomas Allan,21,0,100,79
1657295765983,CSE 140,A01,083663,Gungor; Onat,13,0,85,72
1657295772010,CSE 140L,A01,083088,Eldon; John,19,0,100,81
1657295778033,CSE 175,A01,083665,Kumar; Rakesh,3,0,25,22
1657295784057,CSE 190,A00,092507,Dubnov; Shlomo,7,0,20,13
1657295790079,ECE 45,A01,083139,Congero; Spencer William,6,0,75,69
1657295796105,ECE 65,A50,083695,Saad; Andrew S,12,0,30,18
1657295796105,ECE 65,A51,095125,Saad; Andrew S,25,0,26,1
1657295802137,ECE 109,A01,091882,Touri; Behrouz,19,0,70,51
1657295808160,ECE 180,A00,083140,Abi Samra; Nicholas Camill,1,0,30,29
1657295808160,ECE 180,B00,083141,Abi Samra; Nicholas Camill,0,0,30,30
1657295814190,MATH 10A,A01,083735,Patchell; Gregory David,2,0,30,28
1657295814190,MATH 10A,A02,083736,Patchell; Gregory David,20,0,30,10
1657295814190,MATH 10A,A03,083737,Patchell; Gregory David,16,0,30,14
1657295820221,MATH 10B,A01,083207,Lim; Seonhee,7,0,34,27
1657295820221,MATH 10B,A02,083208,Lim; Seonhee,9,0,35,26
1657295820221,MATH 10B,A03,093472,Lim; Seonhee,5,0,34,29
1657295820221,MATH 10B,B01,083739,Sinha; Shubham,11,0,30,19
1657295826257,MATH 18,A01,083743,Cinel; Cameron Alexander,6,0,30,24
1657295826257,MATH 18,A02,083744,Cinel; Cameron Alexander,17,0,30,13
1657295826257,MATH 18,A03,083745,Cinel; Cameron Alexander,8,0,30,22
1657295826257,MATH 18,B01,083748,Rideout; David Porter,4,0,37,33
1657295826257,MATH 18,B02,083749,Rideout; David Porter,4,0,36,32
1657295826257,MATH 18,B03,083750,Rideout; David Porter,2,0,37,35
1657295826257,MATH 18,B04,083751,Rideout; David Porter,6,0,36,30
1657295826257,MATH 18,B05,093473,Rideout; David Porter,5,0,36,31
1657295826257,MATH 18,B06,093474,Rideout; David Porter,5,0,36,31
1657295832287,MATH 20A,A01,083754,Zheng; Zequn,14,0,40,26
1657295838310,MATH 20B,A01,083756,Briones; Jor-el Thomas Caparas,3,0,36,33
1657295838310,MATH 20B,A02,083757,Briones; Jor-el Thomas Caparas,1,0,36,35
1657295838310,MATH 20B,A03,093475,Briones; Jor-el Thomas Caparas,2,0,36,34
1657295844335,MATH 20C,A01,083760,Briones; Jor-el Thomas Caparas,1,0,35,34
1657295844335,MATH 20C,A02,083761,Briones; Jor-el Thomas Caparas,8,0,35,27
1657295844335,MATH 20C,A03,093476,Briones; Jor-el Thomas Caparas,0,1,36,36
1657295844335,MATH 20C,B01,083762,Bach; Quang Tran,1,0,30,29
1657295850359,MATH 20D,A01,083765,Tran; Brian Kha,5,0,30,25
1657295850359,MATH 20D,A02,083766,Tran; Brian Kha,5,0,30,25
1657295850359,MATH 20D,A03,083767,Tran; Brian Kha,4,0,30,26
1657295856387,MATH 20E,A01,083771,Ganguly; Soumya,7,0,32,25
1657295856387,MATH 20E,A02,083772,Ganguly; Soumya,6,0,32,26
1657295856387,MATH 20E,B01,083773,Ciotti; Benjamin,19,0,35,16
1657295856387,MATH 20E,B02,083774,Ciotti; Benjamin,17,0,35,18
1657295862417,MATH 103A,A01,083777,Greenfeld; Be'Eri,3,0,36,33
1657295862417,MATH 103A,A02,083778,Greenfeld; Be'Eri,5,0,36,31
1657295862417,MATH 103A,A03,093561,Greenfeld; Be'Eri,4,0,36,32
1657295862417,MATH 103A,B01,083779,Greenfeld; Be'Eri,6,0,36,30
1657295862417,MATH 103A,B02,083780,Greenfeld; Be'Eri,3,0,36,33
1657295862417,MATH 103A,B03,093562,Greenfeld; Be'Eri,3,0,36,33
1657295868447,MATH 105,A01,085443,Carter; Anne Toulson,15,0,35,20
1657295868447,MATH 105,A02,093477,Carter; Anne Toulson,20,0,35,15
1657295874472,MATH 109,A01,083213,Ganzberger; Geoffrey Michael,2,0,34,32
1657295874472,MATH 109,A02,083214,Ganzberger; Geoffrey Michael,4,0,34,30
1657295874472,MATH 109,A03,093478,Ganzberger; Geoffrey Michael,2,0,34,32
1657295874472,MATH 109,B01,083215,Ganzberger; Geoffrey Michael,1,0,32,31
1657295874472,MATH 109,B02,083216,Ganzberger; Geoffrey Michael,1,0,32,31
1657295874472,MATH 109,B03,093479,Ganzberger; Geoffrey Michael,8,0,32,24
1657295880501,MATH 142A,A01,083219,Chow; Bennett,7,0,32,25
1657295880501,MATH 142A,A02,083220,Chow; Bennett,10,0,32,22
1657295880501,MATH 142A,A03,093480,Chow; Bennett,7,0,32,25
1657295880501,MATH 142A,B03,093481,Chow; Bennett,8,0,32,24
1657295880501,MATH 142A,B04,093558,Chow; Bennett,12,0,32,20
1657295880501,MATH 142A,B05,093559,Chow; Bennett,6,0,32,26
1657295886534,MATH 193A,A01,083224,Rotar; Vladimir,7,0,34,27
1657295886534,MATH 193A,A02,083225,Rotar; Vladimir,6,0,34,28
1657295886534,MATH 193A,A03,083781,Rotar; Vladimir,2,0,34,32
1657295886534,MATH 193A,A04,083782,Rotar; Vladimir,8,0,34,26
1657295886534,MATH 193A,A05,093482,Rotar; Vladimir,6,0,34,28
1657295892561,MATH 197,001,091859,McAuley; Julian John,9999,0,9999,0
1657295892561,MATH 197,002,095566,Kedlaya; Kiran S.,9997,0,9999,2
1657295892561,MATH 197,003,095567,Xiao; Ming,9999,0,9999,0
1657295892561,MATH 197,004,095571,Perols; Johan Lars,9998,0,9999,1
1657295899622,COGS 9,A01,083615,Shannon; Kyle Michael,8,0,75,67
1657295905645,COGS 11,A01,083617,Boyle; Mary E. T.,22,0,48,26
1657295911670,COGS 13,A01,083071,Bastos; Amalia Pinkusfeld,9,0,71,62
1657295917697,COGS 14A,A01,092681,Semenuks; Arturs,2,1,100,98
1657295923723,COGS 14B,A01,083073,Cheng; Tzu-Han,6,0,63,57
1657295929756,COGS 17,A01,092677,Semenuks; Arturs,5,0,81,76
1657295935781,COGS 100,A01,083619,Allen; Michael Gordon,16,0,70,54
1657295941807,COGS 101A,A01,083621,Davis; Joshua Daniel,9,0,68,59
1657295947829,COGS 101B,A01,091572,Allen; Michael Gordon,11,0,65,54
1657295953860,COGS 101C,A01,083625,Delgado; Tania,17,0,35,18
1657295959884,COGS 107A,A01,083627,Boyle; Mary E. T.,13,0,60,47
1657295965908,COGS 118A,A01,083075,Gupta; Anjum,18,0,76,58
1657295971941,CSE 3,A50,083646,Miranda; Gregory Joseph,24,0,50,26
1657295977971,CSE 8A,A50,083650,Miranda; Gregory Joseph,17,1,56,39
1657295983995,CSE 11,A01,083080,Cao; Yingjun,5,15,40,35
1657295990020,CSE 12,A01,083652,Krause-Levy; Sophia Louisa,26,1,120,94
1657295996046,CSE 15L,A01,083654,Morris; Justin Loren,9,0,50,41
1657295996046,CSE 15L,A02,083655,Morris; Justin Loren,9,0,50,41
1657296002077,CSE 20,A01,083657,Tran; Khoa Dang,38,0,80,42
1657296008104,CSE 21,A01,095574,Bach; Quang Tran,22,0,48,26
1657296014131,CSE 30,A01,083084,Eldon; John,4,0,80,76
1657296014131,CSE 30,B01,095061,Bhaskar; Nishant,8,0,50,42
1657296020161,CSE 100,A01,083659,Cao; Yingjun,4,4,70,66
1657296026184,CSE 134B,A01,083661,Powell; Thomas Allan,21,0,100,79
1657296032211,CSE 140,A01,083663,Gungor; Onat,13,0,85,72
1657296038238,CSE 140L,A01,083088,Eldon; John,20,0,100,80
1657296044271,CSE 175,A01,083665,Kumar; Rakesh,3,0,25,22
1657296050295,CSE 190,A00,092507,Dubnov; Shlomo,7,0,20,13
1657296056318,ECE 45,A01,083139,Congero; Spencer William,6,0,75,69
1657296062348,ECE 65,A50,083695,Saad; Andrew S,12,0,30,18
1657296062348,ECE 65,A51,095125,Saad; Andrew S,25,0,26,1
1657296068383,ECE 109,A01,091882,Touri; Behrouz,19,0,70,51
1657296074418,ECE 180,A00,083140,Abi Samra; Nicholas Camill,1,0,30,29
1657296074418,ECE 180,B00,083141,Abi Samra; Nicholas Camill,0,0,30,30
1657296080452,MATH 10A,A01,083735,Patchell; Gregory David,2,0,30,28
1657296080452,MATH 10A,A02,083736,Patchell; Gregory David,20,0,30,10
1657296080452,MATH 10A,A03,083737,Patchell; Gregory David,16,0,30,14
1657296086477,MATH 10B,A01,083207,Lim; Seonhee,7,0,34,27
1657296086477,MATH 10B,A02,083208,Lim; Seonhee,9,0,35,26
1657296086477,MATH 10B,A03,093472,Lim; Seonhee,5,0,34,29
1657296086477,MATH 10B,B01,083739,Sinha; Shubham,11,0,30,19
1657296092508,MATH 18,A01,083743,Cinel; Cameron Alexander,6,0,30,24
1657296092508,MATH 18,A02,083744,Cinel; Cameron Alexander,17,0,30,13
1657296092508,MATH 18,A03,083745,Cinel; Cameron Alexander,8,0,30,22
1657296092508,MATH 18,B01,083748,Rideout; David Porter,4,0,37,33
1657296092508,MATH 18,B02,083749,Rideout; David Porter,4,0,36,32
1657296092508,MATH 18,B03,083750,Rideout; David Porter,2,0,37,35
1657296092508,MATH 18,B04,083751,Rideout; David Porter,6,0,36,30
1657296092508,MATH 18,B05,093473,Rideout; David Porter,5,0,36,31
1657296092508,MATH 18,B06,093474,Rideout; David Porter,5,0,36,31
1657296098535,MATH 20A,A01,083754,Zheng; Zequn,14,0,40,26
1657296104561,MATH 20B,A01,083756,Briones; Jor-el Thomas Caparas,3,0,36,33
1657296104561,MATH 20B,A02,083757,Briones; Jor-el Thomas Caparas,1,0,36,35
1657296104561,MATH 20B,A03,093475,Briones; Jor-el Thomas Caparas,2,0,36,34
1657296110584,MATH 20C,A01,083760,Briones; Jor-el Thomas Caparas,1,0,35,34
1657296110584,MATH 20C,A02,083761,Briones; Jor-el Thomas Caparas,8,0,35,27
1657296110584,MATH 20C,A03,093476,Briones; Jor-el Thomas Caparas,0,1,36,36
1657296110584,MATH 20C,B01,083762,Bach; Quang Tran,1,0,30,29
1657296116608,MATH 20D,A01,083765,Tran; Brian Kha,5,0,30,25
1657296116608,MATH 20D,A02,083766,Tran; Brian Kha,5,0,30,25
1657296116608,MATH 20D,A03,083767,Tran; Brian Kha,4,0,30,26
1657296122640,MATH 20E,A01,083771,Ganguly; Soumya,7,0,32,25
1657296122640,MATH 20E,A02,083772,Ganguly; Soumya,6,0,32,26
1657296122640,MATH 20E,B01,083773,Ciotti; Benjamin,19,0,35,16
1657296122640,MATH 20E,B02,083774,Ciotti; Benjamin,17,0,35,18
1657296128665,MATH 103A,A01,083777,Greenfeld; Be'Eri,3,0,36,33
1657296128665,MATH 103A,A02,083778,Greenfeld; Be'Eri,5,0,36,31
1657296128665,MATH 103A,A03,093561,Greenfeld; Be'Eri,4,0,36,32
1657296128665,MATH 103A,B01,083779,Greenfeld; Be'Eri,6,0,36,30
1657296128665,MATH 103A,B02,083780,Greenfeld; Be'Eri,3,0,36,33
1657296128665,MATH 103A,B03,093562,Greenfeld; Be'Eri,3,0,36,33
1657296134698,MATH 105,A01,085443,Carter; Anne Toulson,15,0,35,20
1657296134698,MATH 105,A02,093477,Carter; Anne Toulson,20,0,35,15
1657296140722,MATH 109,A01,083213,Ganzberger; Geoffrey Michael,2,0,34,32
1657296140722,MATH 109,A02,083214,Ganzberger; Geoffrey Michael,4,0,34,30
1657296140722,MATH 109,A03,093478,Ganzberger; Geoffrey Michael,2,0,34,32
1657296140722,MATH 109,B01,083215,Ganzberger; Geoffrey Michael,1,0,32,31
1657296140722,MATH 109,B02,083216,Ganzberger; Geoffrey Michael,1,0,32,31
1657296140722,MATH 109,B03,093479,Ganzberger; Geoffrey Michael,8,0,32,24
1657296146752,MATH 142A,A01,083219,Chow; Bennett,7,0,32,25
1657296146752,MATH 142A,A02,083220,Chow; Bennett,10,0,32,22
1657296146752,MATH 142A,A03,093480,Chow; Bennett,7,0,32,25
1657296146752,MATH 142A,B03,093481,Chow; Bennett,8,0,32,24
1657296146752,MATH 142A,B04,093558,Chow; Bennett,12,0,32,20
1657296146752,MATH 142A,B05,093559,Chow; Bennett,6,0,32,26
1657296152775,MATH 193A,A01,083224,Rotar; Vladimir,7,0,34,27
1657296152775,MATH 193A,A02,083225,Rotar; Vladimir,6,0,34,28
1657296152775,MATH 193A,A03,083781,Rotar; Vladimir,2,0,34,32
1657296152775,MATH 193A,A04,083782,Rotar; Vladimir,8,0,34,26
1657296152775,MATH 193A,A05,093482,Rotar; Vladimir,6,0,34,28
1657296158799,MATH 197,001,091859,McAuley; Julian John,9999,0,9999,0
1657296158799,MATH 197,002,095566,Kedlaya; Kiran S.,9997,0,9999,2
1657296158799,MATH 197,003,095567,Xiao; Ming,9999,0,9999,0
1657296158799,MATH 197,004,095571,Perols; Johan Lars,9998,0,9999,1
1657296165934,COGS 9,A01,083615,Shannon; Kyle Michael,8,0,75,67
1657296171958,COGS 11,A01,083617,Boyle; Mary E. T.,22,0,48,26
1657296177982,COGS 13,A01,083071,Bastos; Amalia Pinkusfeld,9,0,71,62
1657296184005,COGS 14A,A01,092681,Semenuks; Arturs,2,1,100,98
1657296190030,COGS 14B,A01,083073,Cheng; Tzu-Han,6,0,63,57
1657296196054,COGS 17,A01,092677,Semenuks; Arturs,5,0,81,76
1657296202084,COGS 100,A01,083619,Allen; Michael Gordon,16,0,70,54
1657296208111,COGS 101A,A01,083621,Davis; Joshua Daniel,9,0,68,59
1657296214138,COGS 101B,A01,091572,Allen; Michael Gordon,11,0,65,54
1657296220167,COGS 101C,A01,083625,Delgado; Tania,17,0,35,18
1657296226194,COGS 107A,A01,083627,Boyle; Mary E. T.,13,0,60,47
1657296232219,COGS 118A,A01,083075,Gupta; Anjum,18,0,76,58
1657296238246,CSE 3,A50,083646,Miranda; Gregory Joseph,24,0,50,26
1657296244273,CSE 8A,A50,083650,Miranda; Gregory Joseph,17,1,56,39
1657296250295,CSE 11,A01,083080,Cao; Yingjun,5,15,40,35
1657296256319,CSE 12,A01,083652,Krause-Levy; Sophia Louisa,26,1,120,94
1657296262346,CSE 15L,A01,083654,Morris; Justin Loren,9,0,50,41
1657296262346,CSE 15L,A02,083655,Morris; Justin Loren,9,0,50,41
1657296268374,CSE 20,A01,083657,Tran; Khoa Dang,38,0,80,42
1657296274397,CSE 21,A01,095574,Bach; Quang Tran,22,0,48,26
1657296280423,CSE 30,A01,083084,Eldon; John,4,0,80,76
1657296280423,CSE 30,B01,095061,Bhaskar; Nishant,8,0,50,42
1657296286447,CSE 100,A01,083659,Cao; Yingjun,4,4,70,66
1657296292470,CSE 134B,A01,083661,Powell; Thomas Allan,21,0,100,79
1657296298496,CSE 140,A01,083663,Gungor; Onat,13,0,85,72
1657296304520,CSE 140L,A01,083088,Eldon; John,20,0,100,80
1657296310544,CSE 175,A01,083665,Kumar; Rakesh,3,0,25,22
1657296316570,CSE 190,A00,092507,Dubnov; Shlomo,7,0,20,13
1657296322594,ECE 45,A01,083139,Congero; Spencer William,6,0,75,69
1657296328618,ECE 65,A50,083695,Saad; Andrew S,12,0,30,18
1657296328618,ECE 65,A51,095125,Saad; Andrew S,25,0,26,1
1657296334642,ECE 109,A01,091882,Touri; Behrouz,19,0,70,51
1657296340680,ECE 180,A00,083140,Abi Samra; Nicholas Camill,1,0,30,29
1657296340680,ECE 180,B00,083141,Abi Samra; Nicholas Camill,0,0,30,30
1657296346705,MATH 10A,A01,083735,Patchell; Gregory David,2,0,30,28
1657296346705,MATH 10A,A02,083736,Patchell; Gregory David,20,0,30,10
1657296346705,MATH 10A,A03,083737,Patchell; Gregory David,16,0,30,14
1657296352731,MATH 10B,A01,083207,Lim; Seonhee,7,0,34,27
1657296352731,MATH 10B,A02,083208,Lim; Seonhee,9,0,35,26
1657296352731,MATH 10B,A03,093472,Lim; Seonhee,5,0,34,29
1657296352731,MATH 10B,B01,083739,Sinha; Shubham,11,0,30,19
1657296358756,MATH 18,A01,083743,Cinel; Cameron Alexander,6,0,30,24
1657296358756,MATH 18,A02,083744,Cinel; Cameron Alexander,17,0,30,13
1657296358756,MATH 18,A03,083745,Cinel; Cameron Alexander,8,0,30,22
1657296358756,MATH 18,B01,083748,Rideout; David Porter,4,0,37,33
1657296358756,MATH 18,B02,083749,Rideout; David Porter,4,0,36,32
1657296358756,MATH 18,B03,083750,Rideout; David Porter,2,0,37,35
1657296358756,MATH 18,B04,083751,Rideout; David Porter,6,0,36,30
1657296358756,MATH 18,B05,093473,Rideout; David Porter,5,0,36,31
1657296358756,MATH 18,B06,093474,Rideout; David Porter,5,0,36,31
1657296364779,MATH 20A,A01,083754,Zheng; Zequn,14,0,40,26
1657296370805,MATH 20B,A01,083756,Briones; Jor-el Thomas Caparas,3,0,36,33
1657296370805,MATH 20B,A02,083757,Briones; Jor-el Thomas Caparas,1,0,36,35
1657296370805,MATH 20B,A03,093475,Briones; Jor-el Thomas Caparas,2,0,36,34
1657296376835,MATH 20C,A01,083760,Briones; Jor-el Thomas Caparas,1,0,35,34
1657296376835,MATH 20C,A02,083761,Briones; Jor-el Thomas Caparas,8,0,35,27
1657296376835,MATH 20C,A03,093476,Briones; Jor-el Thomas Caparas,0,1,36,36
1657296376835,MATH 20C,B01,083762,Bach; Quang Tran,1,0,30,29
1657296382858,MATH 20D,A01,083765,Tran; Brian Kha,5,0,30,25
1657296382858,MATH 20D,A02,083766,Tran; Brian Kha,5,0,30,25
1657296382858,MATH 20D,A03,083767,Tran; Brian Kha,4,0,30,26
1657296388882,MATH 20E,A01,083771,Ganguly; Soumya,7,0,32,25
1657296388882,MATH 20E,A02,083772,Ganguly; Soumya,6,0,32,26
1657296388882,MATH 20E,B01,083773,Ciotti; Benjamin,19,0,35,16
1657296388882,MATH 20E,B02,083774,Ciotti; Benjamin,17,0,35,18
1657296394914,MATH 103A,A01,083777,Greenfeld; Be'Eri,3,0,36,33
1657296394914,MATH 103A,A02,083778,Greenfeld; Be'Eri,5,0,36,31
1657296394914,MATH 103A,A03,093561,Greenfeld; Be'Eri,4,0,36,32
1657296394914,MATH 103A,B01,083779,Greenfeld; Be'Eri,6,0,36,30
1657296394914,MATH 103A,B02,083780,Greenfeld; Be'Eri,3,0,36,33
1657296394914,MATH 103A,B03,093562,Greenfeld; Be'Eri,3,0,36,33
1657296400937,MATH 105,A01,085443,Carter; Anne Toulson,15,0,35,20
1657296400937,MATH 105,A02,093477,Carter; Anne Toulson,20,0,35,15
1657296406965,MATH 109,A01,083213,Ganzberger; Geoffrey Michael,2,0,34,32
1657296406965,MATH 109,A02,083214,Ganzberger; Geoffrey Michael,4,0,34,30
1657296406965,MATH 109,A03,093478,Ganzberger; Geoffrey Michael,2,0,34,32
1657296406965,MATH 109,B01,083215,Ganzberger; Geoffrey Michael,1,0,32,31
1657296406965,MATH 109,B02,083216,Ganzberger; Geoffrey Michael,1,0,32,31
1657296406965,MATH 109,B03,093479,Ganzberger; Geoffrey Michael,8,0,32,24
1657296412990,MATH 142A,A01,083219,Chow; Bennett,7,0,32,25
1657296412990,MATH 142A,A02,083220,Chow; Bennett,10,0,32,22
1657296412990,MATH 142A,A03,093480,Chow; Bennett,7,0,32,25
1657296412990,MATH 142A,B03,093481,Chow; Bennett,8,0,32,24
1657296412990,MATH 142A,B04,093558,Chow; Bennett,12,0,32,20
1657296412990,MATH 142A,B05,093559,Chow; Bennett,6,0,32,26
1657296419018,MATH 193A,A01,083224,Rotar; Vladimir,7,0,34,27
1657296419018,MATH 193A,A02,083225,Rotar; Vladimir,6,0,34,28
1657296419018,MATH 193A,A03,083781,Rotar; Vladimir,2,0,34,32
1657296419018,MATH 193A,A04,083782,Rotar; Vladimir,8,0,34,26
1657296419018,MATH 193A,A05,093482,Rotar; Vladimir,6,0,34,28
1657296425051,MATH 197,001,091859,McAuley; Julian John,9999,0,9999,0
1657296425051,MATH 197,002,095566,Kedlaya; Kiran S.,9997,0,9999,2
1657296425051,MATH 197,003,095567,Xiao; Ming,9999,0,9999,0
1657296425051,MATH 197,004,095571,Perols; Johan Lars,9998,0,9999,1
1657296432104,COGS 9,A01,083615,Shannon; Kyle Michael,8,0,75,67
1657296438132,COGS 11,A01,083617,Boyle; Mary E. T.,22,0,48,26
1657296444161,COGS 13,A01,083071,Bastos; Amalia Pinkusfeld,9,0,71,62
1657296450196,COGS 14A,A01,092681,Semenuks; Arturs,2,1,100,98
1657296456223,COGS 14B,A01,083073,Cheng; Tzu-Han,6,0,63,57
1657296462251,COGS 17,A01,092677,Semenuks; Arturs,5,0,81,76
1657296468274,COGS 100,A01,083619,Allen; Michael Gordon,16,0,70,54
1657296474302,COGS 101A,A01,083621,Davis; Joshua Daniel,9,0,68,59
1657296480336,COGS 101B,A01,091572,Allen; Michael Gordon,11,0,65,54
1657296486361,COGS 101C,A01,083625,Delgado; Tania,17,0,35,18
1657296492388,COGS 107A,A01,083627,Boyle; Mary E. T.,13,0,60,47
1657296498411,COGS 118A,A01,083075,Gupta; Anjum,18,0,76,58
1657296504448,CSE 3,A50,083646,Miranda; Gregory Joseph,24,0,50,26
1657296510473,CSE 8A,A50,083650,Miranda; Gregory Joseph,17,1,56,39
1657296516495,CSE 11,A01,083080,Cao; Yingjun,5,15,40,35
1657296522517,CSE 12,A01,083652,Krause-Levy; Sophia Louisa,26,1,120,94
1657296528550,CSE 15L,A01,083654,Morris; Justin Loren,9,0,50,41
1657296528550,CSE 15L,A02,083655,Morris; Justin Loren,9,0,50,41
1657296534577,CSE 20,A01,083657,Tran; Khoa Dang,38,0,80,42
1657296540600,CSE 21,A01,095574,Bach; Quang Tran,22,0,48,26
1657296546625,CSE 30,A01,083084,Eldon; John,4,0,80,76
1657296546625,CSE 30,B01,095061,Bhaskar; Nishant,8,0,50,42
1657296552650,CSE 100,A01,083659,Cao; Yingjun,4,4,70,66
1657296558674,CSE 134B,A01,083661,Powell; Thomas Allan,21,0,100,79
1657296564701,CSE 140,A01,083663,Gungor; Onat,13,0,85,72
1657296570726,CSE 140L,A01,083088,Eldon; John,20,0,100,80
1657296576752,CSE 175,A01,083665,Kumar; Rakesh,3,0,25,22
1657296582792,CSE 190,A00,092507,Dubnov; Shlomo,7,0,20,13
1657296588824,ECE 45,A01,083139,Congero; Spencer William,6,0,75,69
1657296594852,ECE 65,A50,083695,Saad; Andrew S,12,0,30,18
1657296594852,ECE 65,A51,095125,Saad; Andrew S,25,0,26,1
1657296600882,ECE 109,A01,091882,Touri; Behrouz,19,0,70,51
1657296606905,ECE 180,A00,083140,Abi Samra; Nicholas Camill,1,0,30,29
1657296606905,ECE 180,B00,083141,Abi Samra; Nicholas Camill,0,0,30,30
1657296612944,MATH 10A,A01,083735,Patchell; Gregory David,2,0,30,28
1657296612944,MATH 10A,A02,083736,Patchell; Gregory David,20,0,30,10
1657296612944,MATH 10A,A03,083737,Patchell; Gregory David,16,0,30,14
1657296618973,MATH 10B,A01,083207,Lim; Seonhee,7,0,34,27
1657296618973,MATH 10B,A02,083208,Lim; Seonhee,9,0,35,26
1657296618973,MATH 10B,A03,093472,Lim; Seonhee,5,0,34,29
1657296618973,MATH 10B,B01,083739,Sinha; Shubham,11,0,30,19
1657296624999,MATH 18,A01,083743,Cinel; Cameron Alexander,6,0,30,24
1657296624999,MATH 18,A02,083744,Cinel; Cameron Alexander,17,0,30,13
1657296624999,MATH 18,A03,083745,Cinel; Cameron Alexander,8,0,30,22
1657296624999,MATH 18,B01,083748,Rideout; David Porter,4,0,37,33
1657296624999,MATH 18,B02,083749,Rideout; David Porter,4,0,36,32
1657296624999,MATH 18,B03,083750,Rideout; David Porter,2,0,37,35
1657296624999,MATH 18,B04,083751,Rideout; David Porter,6,0,36,30
1657296624999,MATH 18,B05,093473,Rideout; David Porter,5,0,36,31
1657296624999,MATH 18,B06,093474,Rideout; David Porter,5,0,36,31
1657296631021,MATH 20A,A01,083754,Zheng; Zequn,14,0,40,26
1657296637048,MATH 20B,A01,083756,Briones; Jor-el Thomas Caparas,3,0,36,33
1657296637048,MATH 20B,A02,083757,Briones; Jor-el Thomas Caparas,1,0,36,35
1657296637048,MATH 20B,A03,093475,Briones; Jor-el Thomas Caparas,2,0,36,34
1657296643072,MATH 20C,A01,083760,Briones; Jor-el Thomas Caparas,1,0,35,34
1657296643072,MATH 20C,A02,083761,Briones; Jor-el Thomas Caparas,8,0,35,27
1657296643072,MATH 20C,A03,093476,Briones; Jor-el Thomas Caparas,0,1,36,36
1657296643072,MATH 20C,B01,083762,Bach; Quang Tran,1,0,30,29
1657296649107,MATH 20D,A01,083765,Tran; Brian Kha,5,0,30,25
1657296649107,MATH 20D,A02,083766,Tran; Brian Kha,5,0,30,25
1657296649107,MATH 20D,A03,083767,Tran; Brian Kha,4,0,30,26
1657296655138,MATH 20E,A01,083771,Ganguly; Soumya,7,0,32,25
1657296655138,MATH 20E,A02,083772,Ganguly; Soumya,6,0,32,26
1657296655138,MATH 20E,B01,083773,Ciotti; Benjamin,19,0,35,16
1657296655138,MATH 20E,B02,083774,Ciotti; Benjamin,17,0,35,18
1657296661163,MATH 103A,A01,083777,Greenfeld; Be'Eri,3,0,36,33
1657296661163,MATH 103A,A02,083778,Greenfeld; Be'Eri,5,0,36,31
1657296661163,MATH 103A,A03,093561,Greenfeld; Be'Eri,4,0,36,32
1657296661163,MATH 103A,B01,083779,Greenfeld; Be'Eri,6,0,36,30
1657296661163,MATH 103A,B02,083780,Greenfeld; Be'Eri,3,0,36,33
1657296661163,MATH 103A,B03,093562,Greenfeld; Be'Eri,3,0,36,33
1657296667186,MATH 105,A01,085443,Carter; Anne Toulson,15,0,35,20
1657296667186,MATH 105,A02,093477,Carter; Anne Toulson,20,0,35,15
1657296673211,MATH 109,A01,083213,Ganzberger; Geoffrey Michael,2,0,34,32
1657296673211,MATH 109,A02,083214,Ganzberger; Geoffrey Michael,4,0,34,30
1657296673211,MATH 109,A03,093478,Ganzberger; Geoffrey Michael,2,0,34,32
1657296673211,MATH 109,B01,083215,Ganzberger; Geoffrey Michael,1,0,32,31
1657296673211,MATH 109,B02,083216,Ganzberger; Geoffrey Michael,1,0,32,31
1657296673211,MATH 109,B03,093479,Ganzberger; Geoffrey Michael,8,0,32,24
1657296679235,MATH 142A,A01,083219,Chow; Bennett,7,0,32,25
1657296679235,MATH 142A,A02,083220,Chow; Bennett,10,0,32,22
1657296679235,MATH 142A,A03,093480,Chow; Bennett,7,0,32,25
1657296679235,MATH 142A,B03,093481,Chow; Bennett,8,0,32,24
1657296679235,MATH 142A,B04,093558,Chow; Bennett,12,0,32,20
1657296679235,MATH 142A,B05,093559,Chow; Bennett,6,0,32,26
1657296685260,MATH 193A,A01,083224,Rotar; Vladimir,7,0,34,27
1657296685260,MATH 193A,A02,083225,Rotar; Vladimir,6,0,34,28
1657296685260,MATH 193A,A03,083781,Rotar; Vladimir,2,0,34,32
1657296685260,MATH 193A,A04,083782,Rotar; Vladimir,8,0,34,26
1657296685260,MATH 193A,A05,093482,Rotar; Vladimir,6,0,34,28
1657296691281,MATH 197,001,091859,McAuley; Julian John,9999,0,9999,0
1657296691281,MATH 197,002,095566,Kedlaya; Kiran S.,9997,0,9999,2
1657296691281,MATH 197,003,095567,Xiao; Ming,9999,0,9999,0
1657296691281,MATH 197,004,095571,Perols; Johan Lars,9998,0,9999,1
1657296698338,COGS 9,A01,083615,Shannon; Kyle Michael,8,0,75,67
1657296704369,COGS 11,A01,083617,Boyle; Mary E. T.,22,0,48,26
1657296710392,COGS 13,A01,083071,Bastos; Amalia Pinkusfeld,9,0,71,62
1657296716423,COGS 14A,A01,092681,Semenuks; Arturs,2,1,100,98
1657296722447,COGS 14B,A01,083073,Cheng; Tzu-Han,6,0,63,57
1657296728469,COGS 17,A01,092677,Semenuks; Arturs,5,0,81,76
1657296734510,COGS 100,A01,083619,Allen; Michael Gordon,16,0,70,54
1657296740531,COGS 101A,A01,083621,Davis; Joshua Daniel,9,0,68,59
1657296746565,COGS 101B,A01,091572,Allen; Michael Gordon,11,0,65,54
1657296752593,COGS 101C,A01,083625,Delgado; Tania,17,0,35,18
1657296758615,COGS 107A,A01,083627,Boyle; Mary E. T.,13,0,60,47
1657296764715,COGS 118A,A01,083075,Gupta; Anjum,18,0,76,58
1657296770739,CSE 3,A50,083646,Miranda; Gregory Joseph,24,0,50,26
1657296776789,CSE 8A,A50,083650,Miranda; Gregory Joseph,17,1,56,39
1657296782812,CSE 11,A01,083080,Cao; Yingjun,5,15,40,35
1657296788835,CSE 12,A01,083652,Krause-Levy; Sophia Louisa,26,1,120,94
1657296794858,CSE 15L,A01,083654,Morris; Justin Loren,9,0,50,41
1657296794858,CSE 15L,A02,083655,Morris; Justin Loren,9,0,50,41
1657296800885,CSE 20,A01,083657,Tran; Khoa Dang,38,0,80,42
1657296806910,CSE 21,A01,095574,Bach; Quang Tran,22,0,48,26
1657296812940,CSE 30,A01,083084,Eldon; John,4,0,80,76
1657296812940,CSE 30,B01,095061,Bhaskar; Nishant,8,0,50,42
1657296818973,CSE 100,A01,083659,Cao; Yingjun,4,4,70,66
1657296824995,CSE 134B,A01,083661,Powell; Thomas Allan,21,0,100,79
1657296831020,CSE 140,A01,083663,Gungor; Onat,13,0,85,72
1657296837045,CSE 140L,A01,083088,Eldon; John,20,0,100,80
1657296843079,CSE 175,A01,083665,Kumar; Rakesh,3,0,25,22
1657296849103,CSE 190,A00,092507,Dubnov; Shlomo,7,0,20,13
1657296855127,ECE 45,A01,083139,Congero; Spencer William,6,0,75,69
1657296861151,ECE 65,A50,083695,Saad; Andrew S,12,0,30,18
1657296861151,ECE 65,A51,095125,Saad; Andrew S,25,0,26,1
1657296867175,ECE 109,A01,091882,Touri; Behrouz,19,0,70,51
1657296873213,ECE 180,A00,083140,Abi Samra; Nicholas Camill,1,0,30,29
1657296873213,ECE 180,B00,083141,Abi Samra; Nicholas Camill,0,0,30,30
1657296879247,MATH 10A,A01,083735,Patchell; Gregory David,2,0,30,28
1657296879247,MATH 10A,A02,083736,Patchell; Gregory David,20,0,30,10
1657296879247,MATH 10A,A03,083737,Patchell; Gregory David,16,0,30,14
1657296885279,MATH 10B,A01,083207,Lim; Seonhee,7,0,34,27
1657296885279,MATH 10B,A02,083208,Lim; Seonhee,9,0,35,26
1657296885279,MATH 10B,A03,093472,Lim; Seonhee,5,0,34,29
1657296885279,MATH 10B,B01,083739,Sinha; Shubham,11,0,30,19
1657296891319,MATH 18,A01,083743,Cinel; Cameron Alexander,6,0,30,24
1657296891319,MATH 18,A02,083744,Cinel; Cameron Alexander,17,0,30,13
1657296891319,MATH 18,A03,083745,Cinel; Cameron Alexander,8,0,30,22
1657296891319,MATH 18,B01,083748,Rideout; David Porter,4,0,37,33
1657296891319,MATH 18,B02,083749,Rideout; David Porter,4,0,36,32
1657296891319,MATH 18,B03,083750,Rideout; David Porter,2,0,37,35
1657296891319,MATH 18,B04,083751,Rideout; David Porter,6,0,36,30
1657296891319,MATH 18,B05,093473,Rideout; David Porter,5,0,36,31
1657296891319,MATH 18,B06,093474,Rideout; David Porter,5,0,36,31
1657296897342,MATH 20A,A01,083754,Zheng; Zequn,14,0,40,26
1657296903366,MATH 20B,A01,083756,Briones; Jor-el Thomas Caparas,3,0,36,33
1657296903366,MATH 20B,A02,083757,Briones; Jor-el Thomas Caparas,1,0,36,35
1657296903366,MATH 20B,A03,093475,Briones; Jor-el Thomas Caparas,2,0,36,34
1657296909404,MATH 20C,A01,083760,Briones; Jor-el Thomas Caparas,1,0,35,34
1657296909404,MATH 20C,A02,083761,Briones; Jor-el Thomas Caparas,8,0,35,27
1657296909404,MATH 20C,A03,093476,Briones; Jor-el Thomas Caparas,0,1,36,36
1657296909404,MATH 20C,B01,083762,Bach; Quang Tran,1,0,30,29
1657296915442,MATH 20D,A01,083765,Tran; Brian Kha,5,0,30,25
1657296915442,MATH 20D,A02,083766,Tran; Brian Kha,5,0,30,25
1657296915442,MATH 20D,A03,083767,Tran; Brian Kha,4,0,30,26
1657296921466,MATH 20E,A01,083771,Ganguly; Soumya,7,0,32,25
1657296921466,MATH 20E,A02,083772,Ganguly; Soumya,6,0,32,26
1657296921466,MATH 20E,B01,083773,Ciotti; Benjamin,19,0,35,16
1657296921466,MATH 20E,B02,083774,Ciotti; Benjamin,17,0,35,18
1657296927493,MATH 103A,A01,083777,Greenfeld; Be'Eri,3,0,36,33
1657296927493,MATH 103A,A02,083778,Greenfeld; Be'Eri,5,0,36,31
1657296927493,MATH 103A,A03,093561,Greenfeld; Be'Eri,4,0,36,32
1657296927493,MATH 103A,B01,083779,Greenfeld; Be'Eri,6,0,36,30
1657296927493,MATH 103A,B02,083780,Greenfeld; Be'Eri,3,0,36,33
1657296927493,MATH 103A,B03,093562,Greenfeld; Be'Eri,3,0,36,33
1657296933523,MATH 105,A01,085443,Carter; Anne Toulson,15,0,35,20
1657296933523,MATH 105,A02,093477,Carter; Anne Toulson,20,0,35,15
1657296939553,MATH 109,A01,083213,Ganzberger; Geoffrey Michael,2,0,34,32
1657296939553,MATH 109,A02,083214,Ganzberger; Geoffrey Michael,4,0,34,30
1657296939553,MATH 109,A03,093478,Ganzberger; Geoffrey Michael,2,0,34,32
1657296939553,MATH 109,B01,083215,Ganzberger; Geoffrey Michael,1,0,32,31
1657296939553,MATH 109,B02,083216,Ganzberger; Geoffrey Michael,1,0,32,31
1657296939553,MATH 109,B03,093479,Ganzberger; Geoffrey Michael,8,0,32,24
1657296945576,MATH 142A,A01,083219,Chow; Bennett,7,0,32,25
1657296945576,MATH 142A,A02,083220,Chow; Bennett,10,0,32,22
1657296945576,MATH 142A,A03,093480,Chow; Bennett,7,0,32,25
1657296945576,MATH 142A,B03,093481,Chow; Bennett,8,0,32,24
1657296945576,MATH 142A,B04,093558,Chow; Bennett,12,0,32,20
1657296945576,MATH 142A,B05,093559,Chow; Bennett,6,0,32,26
1657296951604,MATH 193A,A01,083224,Rotar; Vladimir,7,0,34,27
1657296951604,MATH 193A,A02,083225,Rotar; Vladimir,6,0,34,28
1657296951604,MATH 193A,A03,083781,Rotar; Vladimir,2,0,34,32
1657296951604,MATH 193A,A04,083782,Rotar; Vladimir,8,0,34,26
1657296951604,MATH 193A,A05,093482,Rotar; Vladimir,6,0,34,28
1657296957632,MATH 197,001,091859,McAuley; Julian John,9999,0,9999,0
1657296957632,MATH 197,002,095566,Kedlaya; Kiran S.,9997,0,9999,2
1657296957632,MATH 197,003,095567,Xiao; Ming,9999,0,9999,0
1657296957632,MATH 197,004,095571,Perols; Johan Lars,9998,0,9999,1
1657296964687,COGS 9,A01,083615,Shannon; Kyle Michael,8,0,75,67
1657296970715,COGS 11,A01,083617,Boyle; Mary E. T.,22,0,48,26
1657296976738,COGS 13,A01,083071,Bastos; Amalia Pinkusfeld,9,0,71,62
1657296982762,COGS 14A,A01,092681,Semenuks; Arturs,2,1,100,98
1657296988783,COGS 14B,A01,083073,Cheng; Tzu-Han,6,0,63,57
1657296994819,COGS 17,A01,092677,Semenuks; Arturs,5,0,81,76
1657297000842,COGS 100,A01,083619,Allen; Michael Gordon,16,0,70,54
1657297006865,COGS 101A,A01,083621,Davis; Joshua Daniel,9,0,68,59
1657297012891,COGS 101B,A01,091572,Allen; Michael Gordon,11,0,65,54
1657297018916,COGS 101C,A01,083625,Delgado; Tania,17,0,35,18
1657297024939,COGS 107A,A01,083627,Boyle; Mary E. T.,13,0,60,47
1657297030962,COGS 118A,A01,083075,Gupta; Anjum,18,0,76,58
1657297037002,CSE 3,A50,083646,Miranda; Gregory Joseph,24,0,50,26
1657297043027,CSE 8A,A50,083650,Miranda; Gregory Joseph,17,1,56,39
1657297049050,CSE 11,A01,083080,Cao; Yingjun,5,15,40,35
1657297055089,CSE 12,A01,083652,Krause-Levy; Sophia Louisa,26,1,120,94
1657297061113,CSE 15L,A01,083654,Morris; Justin Loren,9,0,50,41
1657297061113,CSE 15L,A02,083655,Morris; Justin Loren,9,0,50,41
1657297067144,CSE 20,A01,083657,Tran; Khoa Dang,38,0,80,42
1657297073169,CSE 21,A01,095574,Bach; Quang Tran,22,0,48,26
1657297079193,CSE 30,A01,083084,Eldon; John,4,0,80,76
1657297079193,CSE 30,B01,095061,Bhaskar; Nishant,8,0,50,42
1657297085218,CSE 100,A01,083659,Cao; Yingjun,4,4,70,66
1657297091249,CSE 134B,A01,083661,Powell; Thomas Allan,21,0,100,79
1657297097273,CSE 140,A01,083663,Gungor; Onat,13,0,85,72
1657297103299,CSE 140L,A01,083088,Eldon; John,20,0,100,80
1657297109325,CSE 175,A01,083665,Kumar; Rakesh,3,0,25,22
1657297115353,CSE 190,A00,092507,Dubnov; Shlomo,7,0,20,13
1657297121384,ECE 45,A01,083139,Congero; Spencer William,6,0,75,69
1657297127412,ECE 65,A50,083695,Saad; Andrew S,12,0,30,18
1657297127412,ECE 65,A51,095125,Saad; Andrew S,25,0,26,1
1657297133435,ECE 109,A01,091882,Touri; Behrouz,19,0,70,51
1657297139461,ECE 180,A00,083140,Abi Samra; Nicholas Camill,1,0,30,29
1657297139461,ECE 180,B00,083141,Abi Samra; Nicholas Camill,0,0,30,30
1657297145495,MATH 10A,A01,083735,Patchell; Gregory David,2,0,30,28
1657297145495,MATH 10A,A02,083736,Patchell; Gregory David,20,0,30,10
1657297145495,MATH 10A,A03,083737,Patchell; Gregory David,16,0,30,14
1657297151522,MATH 10B,A01,083207,Lim; Seonhee,7,0,34,27
1657297151522,MATH 10B,A02,083208,Lim; Seonhee,9,0,35,26
1657297151522,MATH 10B,A03,093472,Lim; Seonhee,5,0,34,29
1657297151522,MATH 10B,B01,083739,Sinha; Shubham,11,0,30,19
1657297157559,MATH 18,A01,083743,Cinel; Cameron Alexander,6,0,30,24
1657297157559,MATH 18,A02,083744,Cinel; Cameron Alexander,17,0,30,13
1657297157559,MATH 18,A03,083745,Cinel; Cameron Alexander,8,0,30,22
1657297157559,MATH 18,B01,083748,Rideout; David Porter,4,0,37,33
1657297157559,MATH 18,B02,083749,Rideout; David Porter,4,0,36,32
1657297157559,MATH 18,B03,083750,Rideout; David Porter,2,0,37,35
1657297157559,MATH 18,B04,083751,Rideout; David Porter,6,0,36,30
1657297157559,MATH 18,B05,093473,Rideout; David Porter,5,0,36,31
1657297157559,MATH 18,B06,093474,Rideout; David Porter,5,0,36,31
1657297163583,MATH 20A,A01,083754,Zheng; Zequn,14,0,40,26
1657297169612,MATH 20B,A01,083756,Briones; Jor-el Thomas Caparas,3,0,36,33
1657297169612,MATH 20B,A02,083757,Briones; Jor-el Thomas Caparas,1,0,36,35
1657297169612,MATH 20B,A03,093475,Briones; Jor-el Thomas Caparas,2,0,36,34
1657297175639,MATH 20C,A01,083760,Briones; Jor-el Thomas Caparas,1,0,35,34
1657297175639,MATH 20C,A02,083761,Briones; Jor-el Thomas Caparas,8,0,35,27
1657297175639,MATH 20C,A03,093476,Briones; Jor-el Thomas Caparas,0,1,36,36
1657297175639,MATH 20C,B01,083762,Bach; Quang Tran,1,0,30,29
1657297181668,MATH 20D,A01,083765,Tran; Brian Kha,5,0,30,25
1657297181668,MATH 20D,A02,083766,Tran; Brian Kha,5,0,30,25
1657297181668,MATH 20D,A03,083767,Tran; Brian Kha,4,0,30,26
1657297187692,MATH 20E,A01,083771,Ganguly; Soumya,7,0,32,25
1657297187692,MATH 20E,A02,083772,Ganguly; Soumya,6,0,32,26
1657297187692,MATH 20E,B01,083773,Ciotti; Benjamin,19,0,35,16
1657297187692,MATH 20E,B02,083774,Ciotti; Benjamin,17,0,35,18
1657297193746,MATH 103A,A01,083777,Greenfeld; Be'Eri,3,0,36,33
1657297193746,MATH 103A,A02,083778,Greenfeld; Be'Eri,5,0,36,31
1657297193746,MATH 103A,A03,093561,Greenfeld; Be'Eri,4,0,36,32
1657297193746,MATH 103A,B01,083779,Greenfeld; Be'Eri,6,0,36,30
1657297193746,MATH 103A,B02,083780,Greenfeld; Be'Eri,3,0,36,33
1657297193746,MATH 103A,B03,093562,Greenfeld; Be'Eri,3,0,36,33
1657297199774,MATH 105,A01,085443,Carter; Anne Toulson,15,0,35,20
1657297199774,MATH 105,A02,093477,Carter; Anne Toulson,20,0,35,15
1657297205803,MATH 109,A01,083213,Ganzberger; Geoffrey Michael,2,0,34,32
1657297205803,MATH 109,A02,083214,Ganzberger; Geoffrey Michael,4,0,34,30
1657297205803,MATH 109,A03,093478,Ganzberger; Geoffrey Michael,2,0,34,32
1657297205803,MATH 109,B01,083215,Ganzberger; Geoffrey Michael,1,0,32,31
1657297205803,MATH 109,B02,083216,Ganzberger; Geoffrey Michael,1,0,32,31
1657297205803,MATH 109,B03,093479,Ganzberger; Geoffrey Michael,8,0,32,24
1657297211834,MATH 142A,A01,083219,Chow; Bennett,7,0,32,25
1657297211834,MATH 142A,A02,083220,Chow; Bennett,10,0,32,22
1657297211834,MATH 142A,A03,093480,Chow; Bennett,7,0,32,25
1657297211834,MATH 142A,B03,093481,Chow; Bennett,8,0,32,24
1657297211834,MATH 142A,B04,093558,Chow; Bennett,12,0,32,20
1657297211834,MATH 142A,B05,093559,Chow; Bennett,6,0,32,26
1657297217857,MATH 193A,A01,083224,Rotar; Vladimir,7,0,34,27
1657297217857,MATH 193A,A02,083225,Rotar; Vladimir,6,0,34,28
1657297217857,MATH 193A,A03,083781,Rotar; Vladimir,2,0,34,32
1657297217857,MATH 193A,A04,083782,Rotar; Vladimir,8,0,34,26
1657297217857,MATH 193A,A05,093482,Rotar; Vladimir,6,0,34,28
1657297223880,MATH 197,001,091859,McAuley; Julian John,9999,0,9999,0
1657297223880,MATH 197,002,095566,Kedlaya; Kiran S.,9997,0,9999,2
1657297223880,MATH 197,003,095567,Xiao; Ming,9999,0,9999,0
1657297223880,MATH 197,004,095571,Perols; Johan Lars,9998,0,9999,1
1657297230949,COGS 9,A01,083615,Shannon; Kyle Michael,8,0,75,67
1657297236994,COGS 11,A01,083617,Boyle; Mary E. T.,22,0,48,26
1657297243023,COGS 13,A01,083071,Bastos; Amalia Pinkusfeld,9,0,71,62
1657297249050,COGS 14A,A01,092681,Semenuks; Arturs,2,1,100,98
1657297255074,COGS 14B,A01,083073,Cheng; Tzu-Han,6,0,63,57
1657297261096,COGS 17,A01,092677,Semenuks; Arturs,5,0,81,76
1657297267134,COGS 100,A01,083619,Allen; Michael Gordon,16,0,70,54
1657297273173,COGS 101A,A01,083621,Davis; Joshua Daniel,9,0,68,59
1657297279195,COGS 101B,A01,091572,Allen; Michael Gordon,11,0,65,54
1657297285219,COGS 101C,A01,083625,Delgado; Tania,17,0,35,18
1657297291242,COGS 107A,A01,083627,Boyle; Mary E. T.,13,0,60,47
1657297297272,COGS 118A,A01,083075,Gupta; Anjum,18,0,76,58
1657297303302,CSE 3,A50,083646,Miranda; Gregory Joseph,24,0,50,26
1657297309326,CSE 8A,A50,083650,Miranda; Gregory Joseph,17,1,56,39
1657297315374,CSE 11,A01,083080,Cao; Yingjun,5,15,40,35
1657297321411,CSE 12,A01,083652,Krause-Levy; Sophia Louisa,26,1,120,94
1657297327433,CSE 15L,A01,083654,Morris; Justin Loren,9,0,50,41
1657297327433,CSE 15L,A02,083655,Morris; Justin Loren,9,0,50,41
1657297333458,CSE 20,A01,083657,Tran; Khoa Dang,38,0,80,42
1657297339491,CSE 21,A01,095574,Bach; Quang Tran,22,0,48,26
1657297345515,CSE 30,A01,083084,Eldon; John,4,0,80,76
1657297345515,CSE 30,B01,095061,Bhaskar; Nishant,8,0,50,42
1657297351539,CSE 100,A01,083659,Cao; Yingjun,4,4,70,66
1657297357568,CSE 134B,A01,083661,Powell; Thomas Allan,21,0,100,79
1657297363685,CSE 140,A01,083663,Gungor; Onat,13,0,85,72
1657297369728,CSE 140L,A01,083088,Eldon; John,20,0,100,80
1657297375750,CSE 175,A01,083665,Kumar; Rakesh,3,0,25,22
1657297381776,CSE 190,A00,092507,Dubnov; Shlomo,7,0,20,13
1657297387799,ECE 45,A01,083139,Congero; Spencer William,6,0,75,69
1657297393822,ECE 65,A50,083695,Saad; Andrew S,12,0,30,18
1657297393822,ECE 65,A51,095125,Saad; Andrew S,25,0,26,1
1657297399849,ECE 109,A01,091882,Touri; Behrouz,19,0,70,51
1657297405871,ECE 180,A00,083140,Abi Samra; Nicholas Camill,1,0,30,29
1657297405871,ECE 180,B00,083141,Abi Samra; Nicholas Camill,0,0,30,30
1657297411896,MATH 10A,A01,083735,Patchell; Gregory David,2,0,30,28
1657297411896,MATH 10A,A02,083736,Patchell; Gregory David,20,0,30,10
1657297411896,MATH 10A,A03,083737,Patchell; Gregory David,16,0,30,14
1657297417919,MATH 10B,A01,083207,Lim; Seonhee,7,0,34,27
1657297417919,MATH 10B,A02,083208,Lim; Seonhee,9,0,35,26
1657297417919,MATH 10B,A03,093472,Lim; Seonhee,5,0,34,29
1657297417919,MATH 10B,B01,083739,Sinha; Shubham,11,0,30,19
1657297423944,MATH 18,A01,083743,Cinel; Cameron Alexander,6,0,30,24
1657297423944,MATH 18,A02,083744,Cinel; Cameron Alexander,17,0,30,13
1657297423944,MATH 18,A03,083745,Cinel; Cameron Alexander,8,0,30,22
1657297423944,MATH 18,B01,083748,Rideout; David Porter,4,0,37,33
1657297423944,MATH 18,B02,083749,Rideout; David Porter,4,0,36,32
1657297423944,MATH 18,B03,083750,Rideout; David Porter,2,0,37,35
1657297423944,MATH 18,B04,083751,Rideout; David Porter,6,0,36,30
1657297423944,MATH 18,B05,093473,Rideout; David Porter,5,0,36,31
1657297423944,MATH 18,B06,093474,Rideout; David Porter,5,0,36,31
1657297429967,MATH 20A,A01,083754,Zheng; Zequn,14,0,40,26
1657297435991,MATH 20B,A01,083756,Briones; Jor-el Thomas Caparas,3,0,36,33
1657297435991,MATH 20B,A02,083757,Briones; Jor-el Thomas Caparas,1,0,36,35
1657297435991,MATH 20B,A03,093475,Briones; Jor-el Thomas Caparas,2,0,36,34
1657297442014,MATH 20C,A01,083760,Briones; Jor-el Thomas Caparas,1,0,35,34
1657297442014,MATH 20C,A02,083761,Briones; Jor-el Thomas Caparas,8,0,35,27
1657297442014,MATH 20C,A03,093476,Briones; Jor-el Thomas Caparas,0,1,36,36
1657297442014,MATH 20C,B01,083762,Bach; Quang Tran,1,0,30,29
1657297448040,MATH 20D,A01,083765,Tran; Brian Kha,5,0,30,25
1657297448040,MATH 20D,A02,083766,Tran; Brian Kha,5,0,30,25
1657297448040,MATH 20D,A03,083767,Tran; Brian Kha,4,0,30,26
1657297454067,MATH 20E,A01,083771,Ganguly; Soumya,7,0,32,25
1657297454067,MATH 20E,A02,083772,Ganguly; Soumya,6,0,32,26
1657297454067,MATH 20E,B01,083773,Ciotti; Benjamin,19,0,35,16
1657297454067,MATH 20E,B02,083774,Ciotti; Benjamin,17,0,35,18
1657297460092,MATH 103A,A01,083777,Greenfeld; Be'Eri,3,0,36,33
1657297460092,MATH 103A,A02,083778,Greenfeld; Be'Eri,5,0,36,31
1657297460092,MATH 103A,A03,093561,Greenfeld; Be'Eri,4,0,36,32
1657297460092,MATH 103A,B01,083779,Greenfeld; Be'Eri,6,0,36,30
1657297460092,MATH 103A,B02,083780,Greenfeld; Be'Eri,4,0,36,32
1657297460092,MATH 103A,B03,093562,Greenfeld; Be'Eri,3,0,36,33
1657297466113,MATH 105,A01,085443,Carter; Anne Toulson,15,0,35,20
1657297466113,MATH 105,A02,093477,Carter; Anne Toulson,20,0,35,15
1657297472137,MATH 109,A01,083213,Ganzberger; Geoffrey Michael,2,0,34,32
1657297472137,MATH 109,A02,083214,Ganzberger; Geoffrey Michael,4,0,34,30
1657297472137,MATH 109,A03,093478,Ganzberger; Geoffrey Michael,2,0,34,32
1657297472137,MATH 109,B01,083215,Ganzberger; Geoffrey Michael,1,0,32,31
1657297472137,MATH 109,B02,083216,Ganzberger; Geoffrey Michael,1,0,32,31
1657297472137,MATH 109,B03,093479,Ganzberger; Geoffrey Michael,8,0,32,24
1657297478174,MATH 142A,A01,083219,Chow; Bennett,7,0,32,25
1657297478174,MATH 142A,A02,083220,Chow; Bennett,10,0,32,22
1657297478174,MATH 142A,A03,093480,Chow; Bennett,7,0,32,25
1657297478174,MATH 142A,B03,093481,Chow; Bennett,8,0,32,24
1657297478174,MATH 142A,B04,093558,Chow; Bennett,12,0,32,20
1657297478174,MATH 142A,B05,093559,Chow; Bennett,6,0,32,26
1657297484197,MATH 193A,A01,083224,Rotar; Vladimir,7,0,34,27
1657297484197,MATH 193A,A02,083225,Rotar; Vladimir,6,0,34,28
1657297484197,MATH 193A,A03,083781,Rotar; Vladimir,2,0,34,32
1657297484197,MATH 193A,A04,083782,Rotar; Vladimir,8,0,34,26
1657297484197,MATH 193A,A05,093482,Rotar; Vladimir,6,0,34,28
1657297490223,MATH 197,001,091859,McAuley; Julian John,9999,0,9999,0
1657297490223,MATH 197,002,095566,Kedlaya; Kiran S.,9997,0,9999,2
1657297490223,MATH 197,003,095567,Xiao; Ming,9999,0,9999,0
1657297490223,MATH 197,004,095571,Perols; Johan Lars,9998,0,9999,1
1657297497284,COGS 9,A01,083615,Shannon; Kyle Michael,8,0,75,67
1657297503316,COGS 11,A01,083617,Boyle; Mary E. T.,22,0,48,26
1657297509338,COGS 13,A01,083071,Bastos; Amalia Pinkusfeld,9,0,71,62
1657297515365,COGS 14A,A01,092681,Semenuks; Arturs,2,1,100,98
1657297521387,COGS 14B,A01,083073,Cheng; Tzu-Han,6,0,63,57
1657297527415,COGS 17,A01,092677,Semenuks; Arturs,5,0,81,76
1657297533442,COGS 100,A01,083619,Allen; Michael Gordon,16,0,70,54
1657297539470,COGS 101A,A01,083621,Davis; Joshua Daniel,9,0,68,59
1657297545492,COGS 101B,A01,091572,Allen; Michael Gordon,11,0,65,54
1657297551515,COGS 101C,A01,083625,Delgado; Tania,17,0,35,18
1657297557542,COGS 107A,A01,083627,Boyle; Mary E. T.,13,0,60,47
1657297563577,COGS 118A,A01,083075,Gupta; Anjum,18,0,76,58
1657297569617,CSE 3,A50,083646,Miranda; Gregory Joseph,24,0,50,26
1657297575641,CSE 8A,A50,083650,Miranda; Gregory Joseph,17,1,56,39
1657297581675,CSE 11,A01,083080,Cao; Yingjun,5,15,40,35
1657297587708,CSE 12,A01,083652,Krause-Levy; Sophia Louisa,26,1,120,94
1657297593733,CSE 15L,A01,083654,Morris; Justin Loren,9,0,50,41
1657297593733,CSE 15L,A02,083655,Morris; Justin Loren,9,0,50,41
1657297599758,CSE 20,A01,083657,Tran; Khoa Dang,38,0,80,42
1657297605781,CSE 21,A01,095574,Bach; Quang Tran,22,0,48,26
1657297611806,CSE 30,A01,083084,Eldon; John,4,0,80,76
1657297611806,CSE 30,B01,095061,Bhaskar; Nishant,9,0,50,41
1657297617833,CSE 100,A01,083659,Cao; Yingjun,4,4,70,66
1657297623862,CSE 134B,A01,083661,Powell; Thomas Allan,21,0,100,79
1657297629899,CSE 140,A01,083663,Gungor; Onat,13,0,85,72
1657297635920,CSE 140L,A01,083088,Eldon; John,20,0,100,80
1657297641957,CSE 175,A01,083665,Kumar; Rakesh,3,0,25,22
1657297647980,CSE 190,A00,092507,Dubnov; Shlomo,7,0,20,13
1657297654007,ECE 45,A01,083139,Congero; Spencer William,6,0,75,69
1657297660032,ECE 65,A50,083695,Saad; Andrew S,12,0,30,18
1657297660032,ECE 65,A51,095125,Saad; Andrew S,25,0,26,1
1657297666071,ECE 109,A01,091882,Touri; Behrouz,19,0,70,51
1657297672095,ECE 180,A00,083140,Abi Samra; Nicholas Camill,1,0,30,29
1657297672095,ECE 180,B00,083141,Abi Samra; Nicholas Camill,0,0,30,30
1657297678126,MATH 10A,A01,083735,Patchell; Gregory David,2,0,30,28
1657297678126,MATH 10A,A02,083736,Patchell; Gregory David,20,0,30,10
1657297678126,MATH 10A,A03,083737,Patchell; Gregory David,16,0,30,14
1657297684149,MATH 10B,A01,083207,Lim; Seonhee,7,0,34,27
1657297684149,MATH 10B,A02,083208,Lim; Seonhee,9,0,35,26
1657297684149,MATH 10B,A03,093472,Lim; Seonhee,5,0,34,29
1657297684149,MATH 10B,B01,083739,Sinha; Shubham,11,0,30,19
1657297690180,MATH 18,A01,083743,Cinel; Cameron Alexander,6,0,30,24
1657297690180,MATH 18,A02,083744,Cinel; Cameron Alexander,17,0,30,13
1657297690180,MATH 18,A03,083745,Cinel; Cameron Alexander,8,0,30,22
1657297690180,MATH 18,B01,083748,Rideout; David Porter,4,0,37,33
1657297690180,MATH 18,B02,083749,Rideout; David Porter,4,0,36,32
1657297690180,MATH 18,B03,083750,Rideout; David Porter,2,0,37,35
1657297690180,MATH 18,B04,083751,Rideout; David Porter,6,0,36,30
1657297690180,MATH 18,B05,093473,Rideout; David Porter,5,0,36,31
1657297690180,MATH 18,B06,093474,Rideout; David Porter,5,0,36,31
1657297696202,MATH 20A,A01,083754,Zheng; Zequn,14,0,40,26
1657297702225,MATH 20B,A01,083756,Briones; Jor-el Thomas Caparas,3,0,36,33
1657297702225,MATH 20B,A02,083757,Briones; Jor-el Thomas Caparas,1,0,36,35
1657297702225,MATH 20B,A03,093475,Briones; Jor-el Thomas Caparas,2,0,36,34
1657297708251,MATH 20C,A01,083760,Briones; Jor-el Thomas Caparas,1,0,35,34
1657297708251,MATH 20C,A02,083761,Briones; Jor-el Thomas Caparas,8,0,35,27
1657297708251,MATH 20C,A03,093476,Briones; Jor-el Thomas Caparas,0,1,36,36
1657297708251,MATH 20C,B01,083762,Bach; Quang Tran,1,0,30,29
1657297714284,MATH 20D,A01,083765,Tran; Brian Kha,5,0,30,25
1657297714284,MATH 20D,A02,083766,Tran; Brian Kha,5,0,30,25
1657297714284,MATH 20D,A03,083767,Tran; Brian Kha,4,0,30,26
1657297720312,MATH 20E,A01,083771,Ganguly; Soumya,7,0,32,25
1657297720312,MATH 20E,A02,083772,Ganguly; Soumya,6,0,32,26
1657297720312,MATH 20E,B01,083773,Ciotti; Benjamin,19,0,35,16
1657297720312,MATH 20E,B02,083774,Ciotti; Benjamin,17,0,35,18
1657297726344,MATH 103A,A01,083777,Greenfeld; Be'Eri,3,0,36,33
1657297726344,MATH 103A,A02,083778,Greenfeld; Be'Eri,5,0,36,31
1657297726344,MATH 103A,A03,093561,Greenfeld; Be'Eri,4,0,36,32
1657297726344,MATH 103A,B01,083779,Greenfeld; Be'Eri,6,0,36,30
1657297726344,MATH 103A,B02,083780,Greenfeld; Be'Eri,4,0,36,32
1657297726344,MATH 103A,B03,093562,Greenfeld; Be'Eri,3,0,36,33
1657297732367,MATH 105,A01,085443,Carter; Anne Toulson,15,0,35,20
1657297732367,MATH 105,A02,093477,Carter; Anne Toulson,20,0,35,15
1657297738389,MATH 109,A01,083213,Ganzberger; Geoffrey Michael,2,0,34,32
1657297738389,MATH 109,A02,083214,Ganzberger; Geoffrey Michael,4,0,34,30
1657297738389,MATH 109,A03,093478,Ganzberger; Geoffrey Michael,2,0,34,32
1657297738389,MATH 109,B01,083215,Ganzberger; Geoffrey Michael,1,0,32,31
1657297738389,MATH 109,B02,083216,Ganzberger; Geoffrey Michael,1,0,32,31
1657297738389,MATH 109,B03,093479,Ganzberger; Geoffrey Michael,8,0,32,24
1657297744416,MATH 142A,A01,083219,Chow; Bennett,7,0,32,25
1657297744416,MATH 142A,A02,083220,Chow; Bennett,10,0,32,22
1657297744416,MATH 142A,A03,093480,Chow; Bennett,7,0,32,25
1657297744416,MATH 142A,B03,093481,Chow; Bennett,8,0,32,24
1657297744416,MATH 142A,B04,093558,Chow; Bennett,12,0,32,20
1657297744416,MATH 142A,B05,093559,Chow; Bennett,6,0,32,26
1657297750440,MATH 193A,A01,083224,Rotar; Vladimir,7,0,34,27
1657297750440,MATH 193A,A02,083225,Rotar; Vladimir,6,0,34,28
1657297750440,MATH 193A,A03,083781,Rotar; Vladimir,2,0,34,32
1657297750440,MATH 193A,A04,083782,Rotar; Vladimir,8,0,34,26
1657297750440,MATH 193A,A05,093482,Rotar; Vladimir,6,0,34,28
1657297756461,MATH 197,001,091859,McAuley; Julian John,9999,0,9999,0
1657297756461,MATH 197,002,095566,Kedlaya; Kiran S.,9997,0,9999,2
1657297756461,MATH 197,003,095567,Xiao; Ming,9999,0,9999,0
1657297756461,MATH 197,004,095571,Perols; Johan Lars,9998,0,9999,1
1657297763520,COGS 9,A01,083615,Shannon; Kyle Michael,8,0,75,67
1657297769549,COGS 11,A01,083617,Boyle; Mary E. T.,22,0,48,26
1657297775574,COGS 13,A01,083071,Bastos; Amalia Pinkusfeld,9,0,71,62
1657297781599,COGS 14A,A01,092681,Semenuks; Arturs,2,1,100,98
1657297787622,COGS 14B,A01,083073,Cheng; Tzu-Han,6,0,63,57
1657297793647,COGS 17,A01,092677,Semenuks; Arturs,5,0,81,76
1657297799670,COGS 100,A01,083619,Allen; Michael Gordon,16,0,70,54
1657297805695,COGS 101A,A01,083621,Davis; Joshua Daniel,9,0,68,59
1657297811719,COGS 101B,A01,091572,Allen; Michael Gordon,11,0,65,54
1657297817744,COGS 101C,A01,083625,Delgado; Tania,17,0,35,18
1657297823767,COGS 107A,A01,083627,Boyle; Mary E. T.,13,0,60,47
1657297829791,COGS 118A,A01,083075,Gupta; Anjum,18,0,76,58
1657297835813,CSE 3,A50,083646,Miranda; Gregory Joseph,24,0,50,26
1657297841836,CSE 8A,A50,083650,Miranda; Gregory Joseph,17,1,56,39
1657297847858,CSE 11,A01,083080,Cao; Yingjun,5,15,40,35
1657297853882,CSE 12,A01,083652,Krause-Levy; Sophia Louisa,26,1,120,94
1657297859909,CSE 15L,A01,083654,Morris; Justin Loren,9,0,50,41
1657297859909,CSE 15L,A02,083655,Morris; Justin Loren,9,0,50,41
1657297865933,CSE 20,A01,083657,Tran; Khoa Dang,38,0,80,42
1657297871960,CSE 21,A01,095574,Bach; Quang Tran,22,0,48,26
1657297877982,CSE 30,A01,083084,Eldon; John,4,0,80,76
1657297877982,CSE 30,B01,095061,Bhaskar; Nishant,9,0,50,41
1657297884009,CSE 100,A01,083659,Cao; Yingjun,4,4,70,66
1657297890032,CSE 134B,A01,083661,Powell; Thomas Allan,21,0,100,79
1657297896055,CSE 140,A01,083663,Gungor; Onat,13,0,85,72
1657297902107,CSE 140L,A01,083088,Eldon; John,20,0,100,80
1657297908131,CSE 175,A01,083665,Kumar; Rakesh,3,0,25,22
1657297914160,CSE 190,A00,092507,Dubnov; Shlomo,7,0,20,13
1657297920183,ECE 45,A01,083139,Congero; Spencer William,6,0,75,69
1657297926212,ECE 65,A50,083695,Saad; Andrew S,12,0,30,18
1657297926212,ECE 65,A51,095125,Saad; Andrew S,25,0,26,1
1657297932238,ECE 109,A01,091882,Touri; Behrouz,19,0,70,51
1657297938267,ECE 180,A00,083140,Abi Samra; Nicholas Camill,1,0,30,29
1657297938267,ECE 180,B00,083141,Abi Samra; Nicholas Camill,0,0,30,30
1657297944293,MATH 10A,A01,083735,Patchell; Gregory David,2,0,30,28
1657297944293,MATH 10A,A02,083736,Patchell; Gregory David,20,0,30,10
1657297944293,MATH 10A,A03,083737,Patchell; Gregory David,16,0,30,14
1657297950316,MATH 10B,A01,083207,Lim; Seonhee,7,0,34,27
1657297950316,MATH 10B,A02,083208,Lim; Seonhee,9,0,35,26
1657297950316,MATH 10B,A03,093472,Lim; Seonhee,5,0,34,29
1657297950316,MATH 10B,B01,083739,Sinha; Shubham,11,0,30,19
1657297956346,MATH 18,A01,083743,Cinel; Cameron Alexander,6,0,30,24
1657297956346,MATH 18,A02,083744,Cinel; Cameron Alexander,17,0,30,13
1657297956346,MATH 18,A03,083745,Cinel; Cameron Alexander,8,0,30,22
1657297956346,MATH 18,B01,083748,Rideout; David Porter,4,0,37,33
1657297956346,MATH 18,B02,083749,Rideout; David Porter,4,0,36,32
1657297956346,MATH 18,B03,083750,Rideout; David Porter,2,0,37,35
1657297956346,MATH 18,B04,083751,Rideout; David Porter,6,0,36,30
1657297956346,MATH 18,B05,093473,Rideout; David Porter,5,0,36,31
1657297956346,MATH 18,B06,093474,Rideout; David Porter,5,0,36,31
1657297962462,MATH 20A,A01,083754,Zheng; Zequn,14,0,40,26
1657297968489,MATH 20B,A01,083756,Briones; Jor-el Thomas Caparas,3,0,36,33
1657297968489,MATH 20B,A02,083757,Briones; Jor-el Thomas Caparas,1,0,36,35
1657297968489,MATH 20B,A03,093475,Briones; Jor-el Thomas Caparas,2,0,36,34
1657297974525,MATH 20C,A01,083760,Briones; Jor-el Thomas Caparas,1,0,35,34
1657297974525,MATH 20C,A02,083761,Briones; Jor-el Thomas Caparas,8,0,35,27
1657297974525,MATH 20C,A03,093476,Briones; Jor-el Thomas Caparas,0,1,36,36
1657297974525,MATH 20C,B01,083762,Bach; Quang Tran,1,0,30,29
1657297980552,MATH 20D,A01,083765,Tran; Brian Kha,5,0,30,25
1657297980552,MATH 20D,A02,083766,Tran; Brian Kha,5,0,30,25
1657297980552,MATH 20D,A03,083767,Tran; Brian Kha,4,0,30,26
1657297986576,MATH 20E,A01,083771,Ganguly; Soumya,7,0,32,25
1657297986576,MATH 20E,A02,083772,Ganguly; Soumya,6,0,32,26
1657297986576,MATH 20E,B01,083773,Ciotti; Benjamin,19,0,35,16
1657297986576,MATH 20E,B02,083774,Ciotti; Benjamin,17,0,35,18
1657297992605,MATH 103A,A01,083777,Greenfeld; Be'Eri,3,0,36,33
1657297992605,MATH 103A,A02,083778,Greenfeld; Be'Eri,5,0,36,31
1657297992605,MATH 103A,A03,093561,Greenfeld; Be'Eri,4,0,36,32
1657297992605,MATH 103A,B01,083779,Greenfeld; Be'Eri,6,0,36,30
1657297992605,MATH 103A,B02,083780,Greenfeld; Be'Eri,4,0,36,32
1657297992605,MATH 103A,B03,093562,Greenfeld; Be'Eri,3,0,36,33
1657297998630,MATH 105,A01,085443,Carter; Anne Toulson,15,0,35,20
1657297998630,MATH 105,A02,093477,Carter; Anne Toulson,20,0,35,15
1657298004660,MATH 109,A01,083213,Ganzberger; Geoffrey Michael,2,0,34,32
1657298004660,MATH 109,A02,083214,Ganzberger; Geoffrey Michael,4,0,34,30
1657298004660,MATH 109,A03,093478,Ganzberger; Geoffrey Michael,2,0,34,32
1657298004660,MATH 109,B01,083215,Ganzberger; Geoffrey Michael,1,0,32,31
1657298004660,MATH 109,B02,083216,Ganzberger; Geoffrey Michael,1,0,32,31
1657298004660,MATH 109,B03,093479,Ganzberger; Geoffrey Michael,8,0,32,24
1657298010684,MATH 142A,A01,083219,Chow; Bennett,7,0,32,25
1657298010684,MATH 142A,A02,083220,Chow; Bennett,10,0,32,22
1657298010684,MATH 142A,A03,093480,Chow; Bennett,7,0,32,25
1657298010684,MATH 142A,B03,093481,Chow; Bennett,8,0,32,24
1657298010684,MATH 142A,B04,093558,Chow; Bennett,12,0,32,20
1657298010684,MATH 142A,B05,093559,Chow; Bennett,6,0,32,26
1657298016720,MATH 193A,A01,083224,Rotar; Vladimir,7,0,34,27
1657298016720,MATH 193A,A02,083225,Rotar; Vladimir,6,0,34,28
1657298016720,MATH 193A,A03,083781,Rotar; Vladimir,2,0,34,32
1657298016720,MATH 193A,A04,083782,Rotar; Vladimir,8,0,34,26
1657298016720,MATH 193A,A05,093482,Rotar; Vladimir,6,0,34,28
1657298022746,MATH 197,001,091859,McAuley; Julian John,9999,0,9999,0
1657298022746,MATH 197,002,095566,Kedlaya; Kiran S.,9997,0,9999,2
1657298022746,MATH 197,003,095567,Xiao; Ming,9999,0,9999,0
1657298022746,MATH 197,004,095571,Perols; Johan Lars,9998,0,9999,1
1657298029801,COGS 9,A01,083615,Shannon; Kyle Michael,8,0,75,67
1657298035824,COGS 11,A01,083617,Boyle; Mary E. T.,22,0,48,26
1657298041846,COGS 13,A01,083071,Bastos; Amalia Pinkusfeld,9,0,71,62
1657298047872,COGS 14A,A01,092681,Semenuks; Arturs,2,1,100,98
1657298053898,COGS 14B,A01,083073,Cheng; Tzu-Han,6,0,63,57
1657298059924,COGS 17,A01,092677,Semenuks; Arturs,5,0,81,76
1657298065950,COGS 100,A01,083619,Allen; Michael Gordon,16,0,70,54
1657298071974,COGS 101A,A01,083621,Davis; Joshua Daniel,9,0,68,59
1657298078004,COGS 101B,A01,091572,Allen; Michael Gordon,11,0,65,54
1657298084033,COGS 101C,A01,083625,Delgado; Tania,17,0,35,18
1657298090061,COGS 107A,A01,083627,Boyle; Mary E. T.,13,0,60,47
1657298096089,COGS 118A,A01,083075,Gupta; Anjum,18,0,76,58
1657298102112,CSE 3,A50,083646,Miranda; Gregory Joseph,24,0,50,26
1657298108139,CSE 8A,A50,083650,Miranda; Gregory Joseph,17,1,56,39
1657298114161,CSE 11,A01,083080,Cao; Yingjun,5,15,40,35
1657298120188,CSE 12,A01,083652,Krause-Levy; Sophia Louisa,26,1,120,94
1657298126210,CSE 15L,A01,083654,Morris; Justin Loren,9,0,50,41
1657298126210,CSE 15L,A02,083655,Morris; Justin Loren,9,0,50,41
1657298132242,CSE 20,A01,083657,Tran; Khoa Dang,38,0,80,42
1657298138266,CSE 21,A01,095574,Bach; Quang Tran,22,0,48,26
1657298144290,CSE 30,A01,083084,Eldon; John,4,0,80,76
1657298144290,CSE 30,B01,095061,Bhaskar; Nishant,9,0,50,41
1657298150316,CSE 100,A01,083659,Cao; Yingjun,4,4,70,66
1657298156341,CSE 134B,A01,083661,Powell; Thomas Allan,21,0,100,79
1657298162365,CSE 140,A01,083663,Gungor; Onat,13,0,85,72
1657298168398,CSE 140L,A01,083088,Eldon; John,20,0,100,80
1657298174422,CSE 175,A01,083665,Kumar; Rakesh,3,0,25,22
1657298180445,CSE 190,A00,092507,Dubnov; Shlomo,7,0,20,13
1657298186483,ECE 45,A01,083139,Congero; Spencer William,6,0,75,69
1657298192506,ECE 65,A50,083695,Saad; Andrew S,12,0,30,18
1657298192506,ECE 65,A51,095125,Saad; Andrew S,25,0,26,1
1657298198528,ECE 109,A01,091882,Touri; Behrouz,19,0,70,51
1657298204553,ECE 180,A00,083140,Abi Samra; Nicholas Camill,1,0,30,29
1657298204553,ECE 180,B00,083141,Abi Samra; Nicholas Camill,0,0,30,30
1657298210575,MATH 10A,A01,083735,Patchell; Gregory David,2,0,30,28
1657298210575,MATH 10A,A02,083736,Patchell; Gregory David,20,0,30,10
1657298210575,MATH 10A,A03,083737,Patchell; Gregory David,16,0,30,14
1657298216606,MATH 10B,A01,083207,Lim; Seonhee,7,0,34,27
1657298216606,MATH 10B,A02,083208,Lim; Seonhee,9,0,35,26
1657298216606,MATH 10B,A03,093472,Lim; Seonhee,5,0,34,29
1657298216606,MATH 10B,B01,083739,Sinha; Shubham,11,0,30,19
1657298222637,MATH 18,A01,083743,Cinel; Cameron Alexander,6,0,30,24
1657298222637,MATH 18,A02,083744,Cinel; Cameron Alexander,17,0,30,13
1657298222637,MATH 18,A03,083745,Cinel; Cameron Alexander,8,0,30,22
1657298222637,MATH 18,B01,083748,Rideout; David Porter,4,0,37,33
1657298222637,MATH 18,B02,083749,Rideout; David Porter,4,0,36,32
1657298222637,MATH 18,B03,083750,Rideout; David Porter,2,0,37,35
1657298222637,MATH 18,B04,083751,Rideout; David Porter,6,0,36,30
1657298222637,MATH 18,B05,093473,Rideout; David Porter,5,0,36,31
1657298222637,MATH 18,B06,093474,Rideout; David Porter,5,0,36,31
1657298228666,MATH 20A,A01,083754,Zheng; Zequn,14,0,40,26
1657298234689,MATH 20B,A01,083756,Briones; Jor-el Thomas Caparas,3,0,36,33
1657298234689,MATH 20B,A02,083757,Briones; Jor-el Thomas Caparas,1,0,36,35
1657298234689,MATH 20B,A03,093475,Briones; Jor-el Thomas Caparas,2,0,36,34
1657298240717,MATH 20C,A01,083760,Briones; Jor-el Thomas Caparas,1,0,35,34
1657298240717,MATH 20C,A02,083761,Briones; Jor-el Thomas Caparas,8,0,35,27
1657298240717,MATH 20C,A03,093476,Briones; Jor-el Thomas Caparas,0,1,36,36
1657298240717,MATH 20C,B01,083762,Bach; Quang Tran,1,0,30,29
1657298246753,MATH 20D,A01,083765,Tran; Brian Kha,5,0,30,25
1657298246753,MATH 20D,A02,083766,Tran; Brian Kha,5,0,30,25
1657298246753,MATH 20D,A03,083767,Tran; Brian Kha,4,0,30,26
1657298252778,MATH 20E,A01,083771,Ganguly; Soumya,7,0,32,25
1657298252778,MATH 20E,A02,083772,Ganguly; Soumya,6,0,32,26
1657298252778,MATH 20E,B01,083773,Ciotti; Benjamin,19,0,35,16
1657298252778,MATH 20E,B02,083774,Ciotti; Benjamin,17,0,35,18
1657298258801,MATH 103A,A01,083777,Greenfeld; Be'Eri,3,0,36,33
1657298258801,MATH 103A,A02,083778,Greenfeld; Be'Eri,5,0,36,31
1657298258801,MATH 103A,A03,093561,Greenfeld; Be'Eri,4,0,36,32
1657298258801,MATH 103A,B01,083779,Greenfeld; Be'Eri,6,0,36,30
1657298258801,MATH 103A,B02,083780,Greenfeld; Be'Eri,4,0,36,32
1657298258801,MATH 103A,B03,093562,Greenfeld; Be'Eri,3,0,36,33
1657298264829,MATH 105,A01,085443,Carter; Anne Toulson,15,0,35,20
1657298264829,MATH 105,A02,093477,Carter; Anne Toulson,20,0,35,15
1657298270858,MATH 109,A01,083213,Ganzberger; Geoffrey Michael,2,0,34,32
1657298270858,MATH 109,A02,083214,Ganzberger; Geoffrey Michael,4,0,34,30
1657298270858,MATH 109,A03,093478,Ganzberger; Geoffrey Michael,2,0,34,32
1657298270858,MATH 109,B01,083215,Ganzberger; Geoffrey Michael,1,0,32,31
1657298270858,MATH 109,B02,083216,Ganzberger; Geoffrey Michael,1,0,32,31
1657298270858,MATH 109,B03,093479,Ganzberger; Geoffrey Michael,8,0,32,24
1657298276888,MATH 142A,A01,083219,Chow; Bennett,7,0,32,25
1657298276888,MATH 142A,A02,083220,Chow; Bennett,10,0,32,22
1657298276888,MATH 142A,A03,093480,Chow; Bennett,7,0,32,25
1657298276888,MATH 142A,B03,093481,Chow; Bennett,8,0,32,24
1657298276888,MATH 142A,B04,093558,Chow; Bennett,12,0,32,20
1657298276888,MATH 142A,B05,093559,Chow; Bennett,6,0,32,26
1657298282914,MATH 193A,A01,083224,Rotar; Vladimir,7,0,34,27
1657298282914,MATH 193A,A02,083225,Rotar; Vladimir,6,0,34,28
1657298282914,MATH 193A,A03,083781,Rotar; Vladimir,2,0,34,32
1657298282914,MATH 193A,A04,083782,Rotar; Vladimir,8,0,34,26
1657298282914,MATH 193A,A05,093482,Rotar; Vladimir,6,0,34,28
1657298288947,MATH 197,001,091859,McAuley; Julian John,9999,0,9999,0
1657298288947,MATH 197,002,095566,Kedlaya; Kiran S.,9997,0,9999,2
1657298288947,MATH 197,003,095567,Xiao; Ming,9999,0,9999,0
1657298288947,MATH 197,004,095571,Perols; Johan Lars,9998,0,9999,1
1657298296004,COGS 9,A01,083615,Shannon; Kyle Michael,8,0,75,67
1657298302031,COGS 11,A01,083617,Boyle; Mary E. T.,22,0,48,26
1657298308054,COGS 13,A01,083071,Bastos; Amalia Pinkusfeld,9,0,71,62
1657298314082,COGS 14A,A01,092681,Semenuks; Arturs,2,1,100,98
1657298320107,COGS 14B,A01,083073,Cheng; Tzu-Han,6,0,63,57
1657298326154,COGS 17,A01,092677,Semenuks; Arturs,5,0,81,76
1657298332189,COGS 100,A01,083619,Allen; Michael Gordon,16,0,70,54
1657298338212,COGS 101A,A01,083621,Davis; Joshua Daniel,9,0,68,59
1657298344235,COGS 101B,A01,091572,Allen; Michael Gordon,11,0,65,54
1657298350262,COGS 101C,A01,083625,Delgado; Tania,17,0,35,18
1657298356288,COGS 107A,A01,083627,Boyle; Mary E. T.,13,0,60,47
1657298362313,COGS 118A,A01,083075,Gupta; Anjum,18,0,76,58
1657298368338,CSE 3,A50,083646,Miranda; Gregory Joseph,24,0,50,26
1657298374362,CSE 8A,A50,083650,Miranda; Gregory Joseph,17,1,56,39
1657298380386,CSE 11,A01,083080,Cao; Yingjun,5,15,40,35
1657298386414,CSE 12,A01,083652,Krause-Levy; Sophia Louisa,26,1,120,94
1657298392446,CSE 15L,A01,083654,Morris; Justin Loren,9,0,50,41
1657298392446,CSE 15L,A02,083655,Morris; Justin Loren,9,0,50,41
1657298398469,CSE 20,A01,083657,Tran; Khoa Dang,38,0,80,42
1657298404492,CSE 21,A01,095574,Bach; Quang Tran,22,0,48,26
1657298410514,CSE 30,A01,083084,Eldon; John,4,0,80,76
1657298410514,CSE 30,B01,095061,Bhaskar; Nishant,9,0,50,41
1657298416536,CSE 100,A01,083659,Cao; Yingjun,4,4,70,66
1657298422566,CSE 134B,A01,083661,Powell; Thomas Allan,21,0,100,79
1657298428591,CSE 140,A01,083663,Gungor; Onat,13,0,85,72
1657298434617,CSE 140L,A01,083088,Eldon; John,20,0,100,80
1657298440655,CSE 175,A01,083665,Kumar; Rakesh,3,0,25,22
1657298446677,CSE 190,A00,092507,Dubnov; Shlomo,7,0,20,13
1657298452699,ECE 45,A01,083139,Congero; Spencer William,6,0,75,69
1657298458721,ECE 65,A50,083695,Saad; Andrew S,12,0,30,18
1657298458721,ECE 65,A51,095125,Saad; Andrew S,25,0,26,1
1657298464748,ECE 109,A01,091882,Touri; Behrouz,19,0,70,51
1657298470771,ECE 180,A00,083140,Abi Samra; Nicholas Camill,1,0,30,29
1657298470771,ECE 180,B00,083141,Abi Samra; Nicholas Camill,0,0,30,30
1657298476795,MATH 10A,A01,083735,Patchell; Gregory David,2,0,30,28
1657298476795,MATH 10A,A02,083736,Patchell; Gregory David,20,0,30,10
1657298476795,MATH 10A,A03,083737,Patchell; Gregory David,16,0,30,14
1657298482820,MATH 10B,A01,083207,Lim; Seonhee,7,0,34,27
1657298482820,MATH 10B,A02,083208,Lim; Seonhee,9,0,35,26
1657298482820,MATH 10B,A03,093472,Lim; Seonhee,5,0,34,29
1657298482820,MATH 10B,B01,083739,Sinha; Shubham,11,0,30,19
1657298488845,MATH 18,A01,083743,Cinel; Cameron Alexander,6,0,30,24
1657298488845,MATH 18,A02,083744,Cinel; Cameron Alexander,17,0,30,13
1657298488845,MATH 18,A03,083745,Cinel; Cameron Alexander,8,0,30,22
1657298488845,MATH 18,B01,083748,Rideout; David Porter,4,0,37,33
1657298488845,MATH 18,B02,083749,Rideout; David Porter,4,0,36,32
1657298488845,MATH 18,B03,083750,Rideout; David Porter,2,0,37,35
1657298488845,MATH 18,B04,083751,Rideout; David Porter,6,0,36,30
1657298488845,MATH 18,B05,093473,Rideout; David Porter,5,0,36,31
1657298488845,MATH 18,B06,093474,Rideout; David Porter,5,0,36,31
1657298494873,MATH 20A,A01,083754,Zheng; Zequn,14,0,40,26
1657298500898,MATH 20B,A01,083756,Briones; Jor-el Thomas Caparas,3,0,36,33
1657298500898,MATH 20B,A02,083757,Briones; Jor-el Thomas Caparas,1,0,36,35
1657298500898,MATH 20B,A03,093475,Briones; Jor-el Thomas Caparas,2,0,36,34
1657298506923,MATH 20C,A01,083760,Briones; Jor-el Thomas Caparas,1,0,35,34
1657298506923,MATH 20C,A02,083761,Briones; Jor-el Thomas Caparas,8,0,35,27
1657298506923,MATH 20C,A03,093476,Briones; Jor-el Thomas Caparas,0,1,36,36
1657298506923,MATH 20C,B01,083762,Bach; Quang Tran,1,0,30,29
1657298512948,MATH 20D,A01,083765,Tran; Brian Kha,5,0,30,25
1657298512948,MATH 20D,A02,083766,Tran; Brian Kha,5,0,30,25
1657298512948,MATH 20D,A03,083767,Tran; Brian Kha,4,0,30,26
1657298518976,MATH 20E,A01,083771,Ganguly; Soumya,7,0,32,25
1657298518976,MATH 20E,A02,083772,Ganguly; Soumya,6,0,32,26
1657298518976,MATH 20E,B01,083773,Ciotti; Benjamin,19,0,35,16
1657298518976,MATH 20E,B02,083774,Ciotti; Benjamin,17,0,35,18
1657298525008,MATH 103A,A01,083777,Greenfeld; Be'Eri,3,0,36,33
1657298525008,MATH 103A,A02,083778,Greenfeld; Be'Eri,5,0,36,31
1657298525008,MATH 103A,A03,093561,Greenfeld; Be'Eri,4,0,36,32
1657298525008,MATH 103A,B01,083779,Greenfeld; Be'Eri,6,0,36,30
1657298525008,MATH 103A,B02,083780,Greenfeld; Be'Eri,4,0,36,32
1657298525008,MATH 103A,B03,093562,Greenfeld; Be'Eri,3,0,36,33
1657298531036,MATH 105,A01,085443,Carter; Anne Toulson,15,0,35,20
1657298531036,MATH 105,A02,093477,Carter; Anne Toulson,20,0,35,15
1657298537069,MATH 109,A01,083213,Ganzberger; Geoffrey Michael,2,0,34,32
1657298537069,MATH 109,A02,083214,Ganzberger; Geoffrey Michael,4,0,34,30
1657298537069,MATH 109,A03,093478,Ganzberger; Geoffrey Michael,2,0,34,32
1657298537069,MATH 109,B01,083215,Ganzberger; Geoffrey Michael,1,0,32,31
1657298537069,MATH 109,B02,083216,Ganzberger; Geoffrey Michael,1,0,32,31
1657298537069,MATH 109,B03,093479,Ganzberger; Geoffrey Michael,8,0,32,24
1657298543092,MATH 142A,A01,083219,Chow; Bennett,7,0,32,25
1657298543092,MATH 142A,A02,083220,Chow; Bennett,10,0,32,22
1657298543092,MATH 142A,A03,093480,Chow; Bennett,7,0,32,25
1657298543092,MATH 142A,B03,093481,Chow; Bennett,8,0,32,24
1657298543092,MATH 142A,B04,093558,Chow; Bennett,12,0,32,20
1657298543092,MATH 142A,B05,093559,Chow; Bennett,6,0,32,26
1657298549121,MATH 193A,A01,083224,Rotar; Vladimir,7,0,34,27
1657298549121,MATH 193A,A02,083225,Rotar; Vladimir,6,0,34,28
1657298549121,MATH 193A,A03,083781,Rotar; Vladimir,2,0,34,32
1657298549121,MATH 193A,A04,083782,Rotar; Vladimir,8,0,34,26
1657298549121,MATH 193A,A05,093482,Rotar; Vladimir,6,0,34,28
1657298555144,MATH 197,001,091859,McAuley; Julian John,9999,0,9999,0
1657298555144,MATH 197,002,095566,Kedlaya; Kiran S.,9997,0,9999,2
1657298555144,MATH 197,003,095567,Xiao; Ming,9999,0,9999,0
1657298555144,MATH 197,004,095571,Perols; Johan Lars,9998,0,9999,1
1657298562299,COGS 9,A01,083615,Shannon; Kyle Michael,8,0,75,67
1657298568332,COGS 11,A01,083617,Boyle; Mary E. T.,22,0,48,26
1657298574360,COGS 13,A01,083071,Bastos; Amalia Pinkusfeld,9,0,71,62
1657298580395,COGS 14A,A01,092681,Semenuks; Arturs,2,1,100,98
1657298586423,COGS 14B,A01,083073,Cheng; Tzu-Han,6,0,63,57
1657298592445,COGS 17,A01,092677,Semenuks; Arturs,5,0,81,76
1657298598477,COGS 100,A01,083619,Allen; Michael Gordon,16,0,70,54
1657298604500,COGS 101A,A01,083621,Davis; Joshua Daniel,9,0,68,59
1657298610526,COGS 101B,A01,091572,Allen; Michael Gordon,11,0,65,54
1657298616550,COGS 101C,A01,083625,Delgado; Tania,17,0,35,18
1657298622572,COGS 107A,A01,083627,Boyle; Mary E. T.,13,0,60,47
1657298628608,COGS 118A,A01,083075,Gupta; Anjum,18,0,76,58
1657298634630,CSE 3,A50,083646,Miranda; Gregory Joseph,24,0,50,26
1657298640670,CSE 8A,A50,083650,Miranda; Gregory Joseph,17,1,56,39
1657298646702,CSE 11,A01,083080,Cao; Yingjun,5,15,40,35
1657298652729,CSE 12,A01,083652,Krause-Levy; Sophia Louisa,26,1,120,94
1657298658753,CSE 15L,A01,083654,Morris; Justin Loren,9,0,50,41
1657298658753,CSE 15L,A02,083655,Morris; Justin Loren,9,0,50,41
1657298664789,CSE 20,A01,083657,Tran; Khoa Dang,38,0,80,42
1657298670811,CSE 21,A01,095574,Bach; Quang Tran,22,0,48,26
1657298676845,CSE 30,A01,083084,Eldon; John,4,0,80,76
1657298676845,CSE 30,B01,095061,Bhaskar; Nishant,9,0,50,41
1657298682877,CSE 100,A01,083659,Cao; Yingjun,4,4,70,66
1657298688902,CSE 134B,A01,083661,Powell; Thomas Allan,21,0,100,79
1657298694924,CSE 140,A01,083663,Gungor; Onat,13,0,85,72
1657298700960,CSE 140L,A01,083088,Eldon; John,20,0,100,80
1657298706983,CSE 175,A01,083665,Kumar; Rakesh,3,0,25,22
1657298713015,CSE 190,A00,092507,Dubnov; Shlomo,7,0,20,13
1657298719045,ECE 45,A01,083139,Congero; Spencer William,6,0,75,69
1657298725078,ECE 65,A50,083695,Saad; Andrew S,12,0,30,18
1657298725078,ECE 65,A51,095125,Saad; Andrew S,25,0,26,1
1657298731108,ECE 109,A01,091882,Touri; Behrouz,19,0,70,51
1657298737131,ECE 180,A00,083140,Abi Samra; Nicholas Camill,1,0,30,29
1657298737131,ECE 180,B00,083141,Abi Samra; Nicholas Camill,0,0,30,30
1657298743167,MATH 10A,A01,083735,Patchell; Gregory David,2,0,30,28
1657298743167,MATH 10A,A02,083736,Patchell; Gregory David,20,0,30,10
1657298743167,MATH 10A,A03,083737,Patchell; Gregory David,16,0,30,14
1657298749192,MATH 10B,A01,083207,Lim; Seonhee,7,0,34,27
1657298749192,MATH 10B,A02,083208,Lim; Seonhee,9,0,35,26
1657298749192,MATH 10B,A03,093472,Lim; Seonhee,6,0,34,28
1657298749192,MATH 10B,B01,083739,Sinha; Shubham,11,0,30,19
1657298755217,MATH 18,A01,083743,Cinel; Cameron Alexander,6,0,30,24
1657298755217,MATH 18,A02,083744,Cinel; Cameron Alexander,17,0,30,13
1657298755217,MATH 18,A03,083745,Cinel; Cameron Alexander,8,0,30,22
1657298755217,MATH 18,B01,083748,Rideout; David Porter,4,0,37,33
1657298755217,MATH 18,B02,083749,Rideout; David Porter,4,0,36,32
1657298755217,MATH 18,B03,083750,Rideout; David Porter,2,0,37,35
1657298755217,MATH 18,B04,083751,Rideout; David Porter,6,0,36,30
1657298755217,MATH 18,B05,093473,Rideout; David Porter,5,0,36,31
1657298755217,MATH 18,B06,093474,Rideout; David Porter,5,0,36,31
1657298761242,MATH 20A,A01,083754,Zheng; Zequn,14,0,40,26
1657298767267,MATH 20B,A01,083756,Briones; Jor-el Thomas Caparas,3,0,36,33
1657298767267,MATH 20B,A02,083757,Briones; Jor-el Thomas Caparas,1,0,36,35
1657298767267,MATH 20B,A03,093475,Briones; Jor-el Thomas Caparas,2,0,36,34
1657298773294,MATH 20C,A01,083760,Briones; Jor-el Thomas Caparas,1,0,35,34
1657298773294,MATH 20C,A02,083761,Briones; Jor-el Thomas Caparas,8,0,35,27
1657298773294,MATH 20C,A03,093476,Briones; Jor-el Thomas Caparas,0,1,36,36
1657298773294,MATH 20C,B01,083762,Bach; Quang Tran,1,0,30,29
1657298779317,MATH 20D,A01,083765,Tran; Brian Kha,5,0,30,25
1657298779317,MATH 20D,A02,083766,Tran; Brian Kha,5,0,30,25
1657298779317,MATH 20D,A03,083767,Tran; Brian Kha,4,0,30,26
1657298785346,MATH 20E,A01,083771,Ganguly; Soumya,7,0,32,25
1657298785346,MATH 20E,A02,083772,Ganguly; Soumya,6,0,32,26
1657298785346,MATH 20E,B01,083773,Ciotti; Benjamin,19,0,35,16
1657298785346,MATH 20E,B02,083774,Ciotti; Benjamin,17,0,35,18
1657298791378,MATH 103A,A01,083777,Greenfeld; Be'Eri,3,0,36,33
1657298791378,MATH 103A,A02,083778,Greenfeld; Be'Eri,5,0,36,31
1657298791378,MATH 103A,A03,093561,Greenfeld; Be'Eri,4,0,36,32
1657298791378,MATH 103A,B01,083779,Greenfeld; Be'Eri,6,0,36,30
1657298791378,MATH 103A,B02,083780,Greenfeld; Be'Eri,4,0,36,32
1657298791378,MATH 103A,B03,093562,Greenfeld; Be'Eri,3,0,36,33
1657298797404,MATH 105,A01,085443,Carter; Anne Toulson,15,0,35,20
1657298797404,MATH 105,A02,093477,Carter; Anne Toulson,20,0,35,15
1657298803429,MATH 109,A01,083213,Ganzberger; Geoffrey Michael,2,0,34,32
1657298803429,MATH 109,A02,083214,Ganzberger; Geoffrey Michael,4,0,34,30
1657298803429,MATH 109,A03,093478,Ganzberger; Geoffrey Michael,2,0,34,32
1657298803429,MATH 109,B01,083215,Ganzberger; Geoffrey Michael,1,0,32,31
1657298803429,MATH 109,B02,083216,Ganzberger; Geoffrey Michael,1,0,32,31
1657298803429,MATH 109,B03,093479,Ganzberger; Geoffrey Michael,8,0,32,24
1657298809466,MATH 142A,A01,083219,Chow; Bennett,7,0,32,25
1657298809466,MATH 142A,A02,083220,Chow; Bennett,10,0,32,22
1657298809466,MATH 142A,A03,093480,Chow; Bennett,7,0,32,25
1657298809466,MATH 142A,B03,093481,Chow; Bennett,8,0,32,24
1657298809466,MATH 142A,B04,093558,Chow; Bennett,12,0,32,20
1657298809466,MATH 142A,B05,093559,Chow; Bennett,6,0,32,26
1657298815509,MATH 193A,A01,083224,Rotar; Vladimir,7,0,34,27
1657298815509,MATH 193A,A02,083225,Rotar; Vladimir,6,0,34,28
1657298815509,MATH 193A,A03,083781,Rotar; Vladimir,2,0,34,32
1657298815509,MATH 193A,A04,083782,Rotar; Vladimir,8,0,34,26
1657298815509,MATH 193A,A05,093482,Rotar; Vladimir,6,0,34,28
1657298821532,MATH 197,001,091859,McAuley; Julian John,9999,0,9999,0
1657298821532,MATH 197,002,095566,Kedlaya; Kiran S.,9997,0,9999,2
1657298821532,MATH 197,003,095567,Xiao; Ming,9999,0,9999,0
1657298821532,MATH 197,004,095571,Perols; Johan Lars,9998,0,9999,1
1657298828595,COGS 9,A01,083615,Shannon; Kyle Michael,8,0,75,67
1657298834629,COGS 11,A01,083617,Boyle; Mary E. T.,22,0,48,26
1657298840659,COGS 13,A01,083071,Bastos; Amalia Pinkusfeld,9,0,71,62
1657298846686,COGS 14A,A01,092681,Semenuks; Arturs,2,1,100,98
1657298852710,COGS 14B,A01,083073,Cheng; Tzu-Han,6,0,63,57
1657298858734,COGS 17,A01,092677,Semenuks; Arturs,5,0,81,76
1657298864774,COGS 100,A01,083619,Allen; Michael Gordon,16,0,70,54
1657298870802,COGS 101A,A01,083621,Davis; Joshua Daniel,9,0,68,59
1657298876829,COGS 101B,A01,091572,Allen; Michael Gordon,11,0,65,54
1657298882856,COGS 101C,A01,083625,Delgado; Tania,17,0,35,18
1657298888879,COGS 107A,A01,083627,Boyle; Mary E. T.,13,0,60,47
1657298894903,COGS 118A,A01,083075,Gupta; Anjum,18,0,76,58
1657298900925,CSE 3,A50,083646,Miranda; Gregory Joseph,24,0,50,26
1657298906947,CSE 8A,A50,083650,Miranda; Gregory Joseph,17,1,56,39
1657298912968,CSE 11,A01,083080,Cao; Yingjun,5,15,40,35
1657298918994,CSE 12,A01,083652,Krause-Levy; Sophia Louisa,26,1,120,94
1657298925019,CSE 15L,A01,083654,Morris; Justin Loren,9,0,50,41
1657298925019,CSE 15L,A02,083655,Morris; Justin Loren,9,0,50,41
1657298931048,CSE 20,A01,083657,Tran; Khoa Dang,38,0,80,42
1657298937070,CSE 21,A01,095574,Bach; Quang Tran,22,0,48,26
1657298943093,CSE 30,A01,083084,Eldon; John,4,0,80,76
1657298943093,CSE 30,B01,095061,Bhaskar; Nishant,9,0,50,41
1657298949125,CSE 100,A01,083659,Cao; Yingjun,4,4,70,66
1657298955151,CSE 134B,A01,083661,Powell; Thomas Allan,21,0,100,79
1657298961177,CSE 140,A01,083663,Gungor; Onat,13,0,85,72
1657298967200,CSE 140L,A01,083088,Eldon; John,20,0,100,80
1657298973222,CSE 175,A01,083665,Kumar; Rakesh,3,0,25,22
1657298979249,CSE 190,A00,092507,Dubnov; Shlomo,7,0,20,13
1657298985276,ECE 45,A01,083139,Congero; Spencer William,6,0,75,69
1657298991308,ECE 65,A50,083695,Saad; Andrew S,12,0,30,18
1657298991308,ECE 65,A51,095125,Saad; Andrew S,25,0,26,1
1657298997341,ECE 109,A01,091882,Touri; Behrouz,19,0,70,51
1657299003369,ECE 180,A00,083140,Abi Samra; Nicholas Camill,1,0,30,29
1657299003369,ECE 180,B00,083141,Abi Samra; Nicholas Camill,0,0,30,30
1657299009396,MATH 10A,A01,083735,Patchell; Gregory David,2,0,30,28
1657299009396,MATH 10A,A02,083736,Patchell; Gregory David,20,0,30,10
1657299009396,MATH 10A,A03,083737,Patchell; Gregory David,16,0,30,14
1657299015418,MATH 10B,A01,083207,Lim; Seonhee,7,0,34,27
1657299015418,MATH 10B,A02,083208,Lim; Seonhee,9,0,35,26
1657299015418,MATH 10B,A03,093472,Lim; Seonhee,6,0,34,28
1657299015418,MATH 10B,B01,083739,Sinha; Shubham,11,0,30,19
1657299021453,MATH 18,A01,083743,Cinel; Cameron Alexander,6,0,30,24
1657299021453,MATH 18,A02,083744,Cinel; Cameron Alexander,17,0,30,13
1657299021453,MATH 18,A03,083745,Cinel; Cameron Alexander,8,0,30,22
1657299021453,MATH 18,B01,083748,Rideout; David Porter,4,0,37,33
1657299021453,MATH 18,B02,083749,Rideout; David Porter,4,0,36,32
1657299021453,MATH 18,B03,083750,Rideout; David Porter,2,0,37,35
1657299021453,MATH 18,B04,083751,Rideout; David Porter,6,0,36,30
1657299021453,MATH 18,B05,093473,Rideout; David Porter,5,0,36,31
1657299021453,MATH 18,B06,093474,Rideout; David Porter,5,0,36,31
1657299027479,MATH 20A,A01,083754,Zheng; Zequn,14,0,40,26
1657299033513,MATH 20B,A01,083756,Briones; Jor-el Thomas Caparas,3,0,36,33
1657299033513,MATH 20B,A02,083757,Briones; Jor-el Thomas Caparas,1,0,36,35
1657299033513,MATH 20B,A03,093475,Briones; Jor-el Thomas Caparas,2,0,36,34
1657299039547,MATH 20C,A01,083760,Briones; Jor-el Thomas Caparas,1,0,35,34
1657299039547,MATH 20C,A02,083761,Briones; Jor-el Thomas Caparas,8,0,35,27
1657299039547,MATH 20C,A03,093476,Briones; Jor-el Thomas Caparas,0,1,36,36
1657299039547,MATH 20C,B01,083762,Bach; Quang Tran,1,0,30,29
1657299045571,MATH 20D,A01,083765,Tran; Brian Kha,5,0,30,25
1657299045571,MATH 20D,A02,083766,Tran; Brian Kha,5,0,30,25
1657299045571,MATH 20D,A03,083767,Tran; Brian Kha,4,0,30,26
1657299051593,MATH 20E,A01,083771,Ganguly; Soumya,7,0,32,25
1657299051593,MATH 20E,A02,083772,Ganguly; Soumya,6,0,32,26
1657299051593,MATH 20E,B01,083773,Ciotti; Benjamin,19,0,35,16
1657299051593,MATH 20E,B02,083774,Ciotti; Benjamin,17,0,35,18
1657299057617,MATH 103A,A01,083777,Greenfeld; Be'Eri,3,0,36,33
1657299057617,MATH 103A,A02,083778,Greenfeld; Be'Eri,5,0,36,31
1657299057617,MATH 103A,A03,093561,Greenfeld; Be'Eri,4,0,36,32
1657299057617,MATH 103A,B01,083779,Greenfeld; Be'Eri,6,0,36,30
1657299057617,MATH 103A,B02,083780,Greenfeld; Be'Eri,4,0,36,32
1657299057617,MATH 103A,B03,093562,Greenfeld; Be'Eri,3,0,36,33
1657299063640,MATH 105,A01,085443,Carter; Anne Toulson,15,0,35,20
1657299063640,MATH 105,A02,093477,Carter; Anne Toulson,20,0,35,15
1657299069662,MATH 109,A01,083213,Ganzberger; Geoffrey Michael,2,0,34,32
1657299069662,MATH 109,A02,083214,Ganzberger; Geoffrey Michael,4,0,34,30
1657299069662,MATH 109,A03,093478,Ganzberger; Geoffrey Michael,2,0,34,32
1657299069662,MATH 109,B01,083215,Ganzberger; Geoffrey Michael,1,0,32,31
1657299069662,MATH 109,B02,083216,Ganzberger; Geoffrey Michael,1,0,32,31
1657299069662,MATH 109,B03,093479,Ganzberger; Geoffrey Michael,8,0,32,24
1657299075691,MATH 142A,A01,083219,Chow; Bennett,7,0,32,25
1657299075691,MATH 142A,A02,083220,Chow; Bennett,10,0,32,22
1657299075691,MATH 142A,A03,093480,Chow; Bennett,7,0,32,25
1657299075691,MATH 142A,B03,093481,Chow; Bennett,8,0,32,24
1657299075691,MATH 142A,B04,093558,Chow; Bennett,12,0,32,20
1657299075691,MATH 142A,B05,093559,Chow; Bennett,6,0,32,26
1657299081719,MATH 193A,A01,083224,Rotar; Vladimir,7,0,34,27
1657299081719,MATH 193A,A02,083225,Rotar; Vladimir,6,0,34,28
1657299081719,MATH 193A,A03,083781,Rotar; Vladimir,2,0,34,32
1657299081719,MATH 193A,A04,083782,Rotar; Vladimir,8,0,34,26
1657299081719,MATH 193A,A05,093482,Rotar; Vladimir,6,0,34,28
1657299087742,MATH 197,001,091859,McAuley; Julian John,9999,0,9999,0
1657299087742,MATH 197,002,095566,Kedlaya; Kiran S.,9997,0,9999,2
1657299087742,MATH 197,003,095567,Xiao; Ming,9999,0,9999,0
1657299087742,MATH 197,004,095571,Perols; Johan Lars,9998,0,9999,1
1657299094803,COGS 9,A01,083615,Shannon; Kyle Michael,8,0,75,67
1657299100828,COGS 11,A01,083617,Boyle; Mary E. T.,22,0,48,26
1657299106853,COGS 13,A01,083071,Bastos; Amalia Pinkusfeld,9,0,71,62
1657299112879,COGS 14A,A01,092681,Semenuks; Arturs,2,1,100,98
1657299118905,COGS 14B,A01,083073,Cheng; Tzu-Han,6,0,63,57
1657299124930,COGS 17,A01,092677,Semenuks; Arturs,5,0,81,76
1657299130959,COGS 100,A01,083619,Allen; Michael Gordon,16,0,70,54
1657299136985,COGS 101A,A01,083621,Davis; Joshua Daniel,9,0,68,59
1657299143007,COGS 101B,A01,091572,Allen; Michael Gordon,11,0,65,54
1657299149041,COGS 101C,A01,083625,Delgado; Tania,17,0,35,18
1657299155135,COGS 107A,A01,083627,Boyle; Mary E. T.,13,0,60,47
1657299161172,COGS 118A,A01,083075,Gupta; Anjum,18,0,76,58
1657299167199,CSE 3,A50,083646,Miranda; Gregory Joseph,24,0,50,26
1657299173227,CSE 8A,A50,083650,Miranda; Gregory Joseph,17,1,56,39
1657299179256,CSE 11,A01,083080,Cao; Yingjun,5,15,40,35
1657299185284,CSE 12,A01,083652,Krause-Levy; Sophia Louisa,26,1,120,94
1657299191306,CSE 15L,A01,083654,Morris; Justin Loren,9,0,50,41
1657299191306,CSE 15L,A02,083655,Morris; Justin Loren,9,0,50,41
1657299197338,CSE 20,A01,083657,Tran; Khoa Dang,38,0,80,42
1657299203386,CSE 21,A01,095574,Bach; Quang Tran,22,0,48,26
1657299209409,CSE 30,A01,083084,Eldon; John,4,0,80,76
1657299209409,CSE 30,B01,095061,Bhaskar; Nishant,9,0,50,41
1657299215431,CSE 100,A01,083659,Cao; Yingjun,4,4,70,66
1657299221455,CSE 134B,A01,083661,Powell; Thomas Allan,21,0,100,79
1657299227479,CSE 140,A01,083663,Gungor; Onat,13,0,85,72
1657299233501,CSE 140L,A01,083088,Eldon; John,20,0,100,80
1657299239525,CSE 175,A01,083665,Kumar; Rakesh,3,0,25,22
1657299245546,CSE 190,A00,092507,Dubnov; Shlomo,7,0,20,13
1657299251569,ECE 45,A01,083139,Congero; Spencer William,6,0,75,69
1657299257596,ECE 65,A50,083695,Saad; Andrew S,12,0,30,18
1657299257596,ECE 65,A51,095125,Saad; Andrew S,25,0,26,1
1657299263621,ECE 109,A01,091882,Touri; Behrouz,19,0,70,51
1657299269647,ECE 180,A00,083140,Abi Samra; Nicholas Camill,1,0,30,29
1657299269647,ECE 180,B00,083141,Abi Samra; Nicholas Camill,0,0,30,30
1657299275681,MATH 10A,A01,083735,Patchell; Gregory David,2,0,30,28
1657299275681,MATH 10A,A02,083736,Patchell; Gregory David,20,0,30,10
1657299275681,MATH 10A,A03,083737,Patchell; Gregory David,16,0,30,14
1657299281706,MATH 10B,A01,083207,Lim; Seonhee,7,0,34,27
1657299281706,MATH 10B,A02,083208,Lim; Seonhee,9,0,35,26
1657299281706,MATH 10B,A03,093472,Lim; Seonhee,6,0,34,28
1657299281706,MATH 10B,B01,083739,Sinha; Shubham,11,0,30,19
1657299287731,MATH 18,A01,083743,Cinel; Cameron Alexander,6,0,30,24
1657299287731,MATH 18,A02,083744,Cinel; Cameron Alexander,17,0,30,13
1657299287731,MATH 18,A03,083745,Cinel; Cameron Alexander,8,0,30,22
1657299287731,MATH 18,B01,083748,Rideout; David Porter,4,0,37,33
1657299287731,MATH 18,B02,083749,Rideout; David Porter,4,0,36,32
1657299287731,MATH 18,B03,083750,Rideout; David Porter,2,0,37,35
1657299287731,MATH 18,B04,083751,Rideout; David Porter,6,0,36,30
1657299287731,MATH 18,B05,093473,Rideout; David Porter,5,0,36,31
1657299287731,MATH 18,B06,093474,Rideout; David Porter,5,0,36,31
1657299293754,MATH 20A,A01,083754,Zheng; Zequn,14,0,40,26
1657299299778,MATH 20B,A01,083756,Briones; Jor-el Thomas Caparas,3,0,36,33
1657299299778,MATH 20B,A02,083757,Briones; Jor-el Thomas Caparas,1,0,36,35
1657299299778,MATH 20B,A03,093475,Briones; Jor-el Thomas Caparas,2,0,36,34
1657299305806,MATH 20C,A01,083760,Briones; Jor-el Thomas Caparas,1,0,35,34
1657299305806,MATH 20C,A02,083761,Briones; Jor-el Thomas Caparas,8,0,35,27
1657299305806,MATH 20C,A03,093476,Briones; Jor-el Thomas Caparas,0,1,36,36
1657299305806,MATH 20C,B01,083762,Bach; Quang Tran,1,0,30,29
1657299311828,MATH 20D,A01,083765,Tran; Brian Kha,5,0,30,25
1657299311828,MATH 20D,A02,083766,Tran; Brian Kha,5,0,30,25
1657299311828,MATH 20D,A03,083767,Tran; Brian Kha,4,0,30,26
1657299317851,MATH 20E,A01,083771,Ganguly; Soumya,7,0,32,25
1657299317851,MATH 20E,A02,083772,Ganguly; Soumya,6,0,32,26
1657299317851,MATH 20E,B01,083773,Ciotti; Benjamin,19,0,35,16
1657299317851,MATH 20E,B02,083774,Ciotti; Benjamin,17,0,35,18
1657299323873,MATH 103A,A01,083777,Greenfeld; Be'Eri,3,0,36,33
1657299323873,MATH 103A,A02,083778,Greenfeld; Be'Eri,5,0,36,31
1657299323873,MATH 103A,A03,093561,Greenfeld; Be'Eri,4,0,36,32
1657299323873,MATH 103A,B01,083779,Greenfeld; Be'Eri,6,0,36,30
1657299323873,MATH 103A,B02,083780,Greenfeld; Be'Eri,4,0,36,32
1657299323873,MATH 103A,B03,093562,Greenfeld; Be'Eri,3,0,36,33
1657299329896,MATH 105,A01,085443,Carter; Anne Toulson,15,0,35,20
1657299329896,MATH 105,A02,093477,Carter; Anne Toulson,20,0,35,15
1657299335920,MATH 109,A01,083213,Ganzberger; Geoffrey Michael,2,0,34,32
1657299335920,MATH 109,A02,083214,Ganzberger; Geoffrey Michael,4,0,34,30
1657299335920,MATH 109,A03,093478,Ganzberger; Geoffrey Michael,2,0,34,32
1657299335920,MATH 109,B01,083215,Ganzberger; Geoffrey Michael,1,0,32,31
1657299335920,MATH 109,B02,083216,Ganzberger; Geoffrey Michael,1,0,32,31
1657299335920,MATH 109,B03,093479,Ganzberger; Geoffrey Michael,8,0,32,24
1657299341964,MATH 142A,A01,083219,Chow; Bennett,7,0,32,25
1657299341964,MATH 142A,A02,083220,Chow; Bennett,10,0,32,22
1657299341964,MATH 142A,A03,093480,Chow; Bennett,7,0,32,25
1657299341964,MATH 142A,B03,093481,Chow; Bennett,8,0,32,24
1657299341964,MATH 142A,B04,093558,Chow; Bennett,12,0,32,20
1657299341964,MATH 142A,B05,093559,Chow; Bennett,6,0,32,26
1657299347986,MATH 193A,A01,083224,Rotar; Vladimir,7,0,34,27
1657299347986,MATH 193A,A02,083225,Rotar; Vladimir,6,0,34,28
1657299347986,MATH 193A,A03,083781,Rotar; Vladimir,2,0,34,32
1657299347986,MATH 193A,A04,083782,Rotar; Vladimir,8,0,34,26
1657299347986,MATH 193A,A05,093482,Rotar; Vladimir,6,0,34,28
1657299354009,MATH 197,001,091859,McAuley; Julian John,9999,0,9999,0
1657299354009,MATH 197,002,095566,Kedlaya; Kiran S.,9997,0,9999,2
1657299354009,MATH 197,003,095567,Xiao; Ming,9999,0,9999,0
1657299354009,MATH 197,004,095571,Perols; Johan Lars,9998,0,9999,1
1657299361063,COGS 9,A01,083615,Shannon; Kyle Michael,8,0,75,67
1657299367096,COGS 11,A01,083617,Boyle; Mary E. T.,22,0,48,26
1657299373121,COGS 13,A01,083071,Bastos; Amalia Pinkusfeld,9,0,71,62
1657299379153,COGS 14A,A01,092681,Semenuks; Arturs,2,1,100,98
1657299385176,COGS 14B,A01,083073,Cheng; Tzu-Han,6,0,63,57
1657299391199,COGS 17,A01,092677,Semenuks; Arturs,5,0,81,76
1657299397227,COGS 100,A01,083619,Allen; Michael Gordon,16,0,70,54
1657299403252,COGS 101A,A01,083621,Davis; Joshua Daniel,9,0,68,59
1657299409274,COGS 101B,A01,091572,Allen; Michael Gordon,11,0,65,54
1657299415295,COGS 101C,A01,083625,Delgado; Tania,17,0,35,18
1657299421319,COGS 107A,A01,083627,Boyle; Mary E. T.,13,0,60,47
1657299427357,COGS 118A,A01,083075,Gupta; Anjum,18,0,76,58
1657299433381,CSE 3,A50,083646,Miranda; Gregory Joseph,24,0,50,26
1657299439402,CSE 8A,A50,083650,Miranda; Gregory Joseph,17,1,56,39
1657299445425,CSE 11,A01,083080,Cao; Yingjun,5,15,40,35
1657299451461,CSE 12,A01,083652,Krause-Levy; Sophia Louisa,26,1,120,94
1657299457483,CSE 15L,A01,083654,Morris; Justin Loren,9,0,50,41
1657299457483,CSE 15L,A02,083655,Morris; Justin Loren,9,0,50,41
1657299463506,CSE 20,A01,083657,Tran; Khoa Dang,38,0,80,42
1657299469527,CSE 21,A01,095574,Bach; Quang Tran,22,0,48,26
1657299475561,CSE 30,A01,083084,Eldon; John,4,0,80,76
1657299475561,CSE 30,B01,095061,Bhaskar; Nishant,9,0,50,41
1657299481595,CSE 100,A01,083659,Cao; Yingjun,4,4,70,66
1657299487620,CSE 134B,A01,083661,Powell; Thomas Allan,21,0,100,79
1657299493645,CSE 140,A01,083663,Gungor; Onat,13,0,85,72
1657299499668,CSE 140L,A01,083088,Eldon; John,20,0,100,80
1657299505691,CSE 175,A01,083665,Kumar; Rakesh,3,0,25,22
1657299511717,CSE 190,A00,092507,Dubnov; Shlomo,7,0,20,13
1657299517739,ECE 45,A01,083139,Congero; Spencer William,6,0,75,69
1657299523761,ECE 65,A50,083695,Saad; Andrew S,12,0,30,18
1657299523761,ECE 65,A51,095125,Saad; Andrew S,25,0,26,1
1657299529794,ECE 109,A01,091882,Touri; Behrouz,19,0,70,51
1657299535817,ECE 180,A00,083140,Abi Samra; Nicholas Camill,1,0,30,29
1657299535817,ECE 180,B00,083141,Abi Samra; Nicholas Camill,0,0,30,30
1657299541838,MATH 10A,A01,083735,Patchell; Gregory David,2,0,30,28
1657299541838,MATH 10A,A02,083736,Patchell; Gregory David,20,0,30,10
1657299541838,MATH 10A,A03,083737,Patchell; Gregory David,16,0,30,14
1657299547874,MATH 10B,A01,083207,Lim; Seonhee,7,0,34,27
1657299547874,MATH 10B,A02,083208,Lim; Seonhee,9,0,35,26
1657299547874,MATH 10B,A03,093472,Lim; Seonhee,6,0,34,28
1657299547874,MATH 10B,B01,083739,Sinha; Shubham,11,0,30,19
1657299553907,MATH 18,A01,083743,Cinel; Cameron Alexander,6,0,30,24
1657299553907,MATH 18,A02,083744,Cinel; Cameron Alexander,17,0,30,13
1657299553907,MATH 18,A03,083745,Cinel; Cameron Alexander,8,0,30,22
1657299553907,MATH 18,B01,083748,Rideout; David Porter,4,0,37,33
1657299553907,MATH 18,B02,083749,Rideout; David Porter,4,0,36,32
1657299553907,MATH 18,B03,083750,Rideout; David Porter,2,0,37,35
1657299553907,MATH 18,B04,083751,Rideout; David Porter,6,0,36,30
1657299553907,MATH 18,B05,093473,Rideout; David Porter,5,0,36,31
1657299553907,MATH 18,B06,093474,Rideout; David Porter,5,0,36,31
1657299559930,MATH 20A,A01,083754,Zheng; Zequn,14,0,40,26
1657299565962,MATH 20B,A01,083756,Briones; Jor-el Thomas Caparas,3,0,36,33
1657299565962,MATH 20B,A02,083757,Briones; Jor-el Thomas Caparas,1,0,36,35
1657299565962,MATH 20B,A03,093475,Briones; Jor-el Thomas Caparas,2,0,36,34
1657299571985,MATH 20C,A01,083760,Briones; Jor-el Thomas Caparas,1,0,35,34
1657299571985,MATH 20C,A02,083761,Briones; Jor-el Thomas Caparas,8,0,35,27
1657299571985,MATH 20C,A03,093476,Briones; Jor-el Thomas Caparas,0,1,36,36
1657299571985,MATH 20C,B01,083762,Bach; Quang Tran,1,0,30,29
1657299578010,MATH 20D,A01,083765,Tran; Brian Kha,5,0,30,25
1657299578010,MATH 20D,A02,083766,Tran; Brian Kha,5,0,30,25
1657299578010,MATH 20D,A03,083767,Tran; Brian Kha,4,0,30,26
1657299584038,MATH 20E,A01,083771,Ganguly; Soumya,7,0,32,25
1657299584038,MATH 20E,A02,083772,Ganguly; Soumya,6,0,32,26
1657299584038,MATH 20E,B01,083773,Ciotti; Benjamin,19,0,35,16
1657299584038,MATH 20E,B02,083774,Ciotti; Benjamin,17,0,35,18
1657299590067,MATH 103A,A01,083777,Greenfeld; Be'Eri,3,0,36,33
1657299590067,MATH 103A,A02,083778,Greenfeld; Be'Eri,5,0,36,31
1657299590067,MATH 103A,A03,093561,Greenfeld; Be'Eri,4,0,36,32
1657299590067,MATH 103A,B01,083779,Greenfeld; Be'Eri,6,0,36,30
1657299590067,MATH 103A,B02,083780,Greenfeld; Be'Eri,4,0,36,32
1657299590067,MATH 103A,B03,093562,Greenfeld; Be'Eri,3,0,36,33
1657299596109,MATH 105,A01,085443,Carter; Anne Toulson,15,0,35,20
1657299596109,MATH 105,A02,093477,Carter; Anne Toulson,20,0,35,15
1657299602139,MATH 109,A01,083213,Ganzberger; Geoffrey Michael,2,0,34,32
1657299602139,MATH 109,A02,083214,Ganzberger; Geoffrey Michael,4,0,34,30
1657299602139,MATH 109,A03,093478,Ganzberger; Geoffrey Michael,2,0,34,32
1657299602139,MATH 109,B01,083215,Ganzberger; Geoffrey Michael,1,0,32,31
1657299602139,MATH 109,B02,083216,Ganzberger; Geoffrey Michael,1,0,32,31
1657299602139,MATH 109,B03,093479,Ganzberger; Geoffrey Michael,8,0,32,24
1657299608161,MATH 142A,A01,083219,Chow; Bennett,7,0,32,25
1657299608161,MATH 142A,A02,083220,Chow; Bennett,10,0,32,22
1657299608161,MATH 142A,A03,093480,Chow; Bennett,7,0,32,25
1657299608161,MATH 142A,B03,093481,Chow; Bennett,8,0,32,24
1657299608161,MATH 142A,B04,093558,Chow; Bennett,12,0,32,20
1657299608161,MATH 142A,B05,093559,Chow; Bennett,6,0,32,26
1657299614184,MATH 193A,A01,083224,Rotar; Vladimir,7,0,34,27
1657299614184,MATH 193A,A02,083225,Rotar; Vladimir,6,0,34,28
1657299614184,MATH 193A,A03,083781,Rotar; Vladimir,2,0,34,32
1657299614184,MATH 193A,A04,083782,Rotar; Vladimir,8,0,34,26
1657299614184,MATH 193A,A05,093482,Rotar; Vladimir,6,0,34,28
1657299620209,MATH 197,001,091859,McAuley; Julian John,9999,0,9999,0
1657299620209,MATH 197,002,095566,Kedlaya; Kiran S.,9997,0,9999,2
1657299620209,MATH 197,003,095567,Xiao; Ming,9999,0,9999,0
1657299620209,MATH 197,004,095571,Perols; Johan Lars,9998,0,9999,1
1657299627271,COGS 9,A01,083615,Shannon; Kyle Michael,8,0,75,67
1657299633295,COGS 11,A01,083617,Boyle; Mary E. T.,22,0,48,26
1657299639317,COGS 13,A01,083071,Bastos; Amalia Pinkusfeld,9,0,71,62
1657299645354,COGS 14A,A01,092681,Semenuks; Arturs,2,1,100,98
1657299651376,COGS 14B,A01,083073,Cheng; Tzu-Han,6,0,63,57
1657299657402,COGS 17,A01,092677,Semenuks; Arturs,5,0,81,76
1657299663424,COGS 100,A01,083619,Allen; Michael Gordon,16,0,70,54
1657299669447,COGS 101A,A01,083621,Davis; Joshua Daniel,9,0,68,59
1657299675472,COGS 101B,A01,091572,Allen; Michael Gordon,11,0,65,54
1657299681495,COGS 101C,A01,083625,Delgado; Tania,17,0,35,18
1657299687519,COGS 107A,A01,083627,Boyle; Mary E. T.,13,0,60,47
1657299693541,COGS 118A,A01,083075,Gupta; Anjum,18,0,76,58
1657299699570,CSE 3,A50,083646,Miranda; Gregory Joseph,24,0,50,26
1657299705594,CSE 8A,A50,083650,Miranda; Gregory Joseph,17,1,56,39
1657299711624,CSE 11,A01,083080,Cao; Yingjun,5,15,40,35
1657299717649,CSE 12,A01,083652,Krause-Levy; Sophia Louisa,26,1,120,94
1657299723672,CSE 15L,A01,083654,Morris; Justin Loren,9,0,50,41
1657299723672,CSE 15L,A02,083655,Morris; Justin Loren,9,0,50,41
1657299729700,CSE 20,A01,083657,Tran; Khoa Dang,38,0,80,42
1657299735723,CSE 21,A01,095574,Bach; Quang Tran,22,0,48,26
1657299741765,CSE 30,A01,083084,Eldon; John,4,0,80,76
1657299741765,CSE 30,B01,095061,Bhaskar; Nishant,9,0,50,41
1657299747795,CSE 100,A01,083659,Cao; Yingjun,4,4,70,66
1657299753903,CSE 134B,A01,083661,Powell; Thomas Allan,21,0,100,79
1657299759931,CSE 140,A01,083663,Gungor; Onat,13,0,85,72
1657299765969,CSE 140L,A01,083088,Eldon; John,20,0,100,80
1657299771994,CSE 175,A01,083665,Kumar; Rakesh,3,0,25,22
1657299778021,CSE 190,A00,092507,Dubnov; Shlomo,7,0,20,13
1657299784049,ECE 45,A01,083139,Congero; Spencer William,6,0,75,69
1657299790075,ECE 65,A50,083695,Saad; Andrew S,12,0,30,18
1657299790075,ECE 65,A51,095125,Saad; Andrew S,25,0,26,1
1657299796098,ECE 109,A01,091882,Touri; Behrouz,19,0,70,51
1657299802124,ECE 180,A00,083140,Abi Samra; Nicholas Camill,1,0,30,29
1657299802124,ECE 180,B00,083141,Abi Samra; Nicholas Camill,0,0,30,30
1657299808147,MATH 10A,A01,083735,Patchell; Gregory David,2,0,30,28
1657299808147,MATH 10A,A02,083736,Patchell; Gregory David,20,0,30,10
1657299808147,MATH 10A,A03,083737,Patchell; Gregory David,16,0,30,14
1657299814180,MATH 10B,A01,083207,Lim; Seonhee,7,0,34,27
1657299814180,MATH 10B,A02,083208,Lim; Seonhee,9,0,35,26
1657299814180,MATH 10B,A03,093472,Lim; Seonhee,6,0,34,28
1657299814180,MATH 10B,B01,083739,Sinha; Shubham,11,0,30,19
1657299820212,MATH 18,A01,083743,Cinel; Cameron Alexander,6,0,30,24
1657299820212,MATH 18,A02,083744,Cinel; Cameron Alexander,17,0,30,13
1657299820212,MATH 18,A03,083745,Cinel; Cameron Alexander,8,0,30,22
1657299820212,MATH 18,B01,083748,Rideout; David Porter,4,0,37,33
1657299820212,MATH 18,B02,083749,Rideout; David Porter,4,0,36,32
1657299820212,MATH 18,B03,083750,Rideout; David Porter,2,0,37,35
1657299820212,MATH 18,B04,083751,Rideout; David Porter,6,0,36,30
1657299820212,MATH 18,B05,093473,Rideout; David Porter,5,0,36,31
1657299820212,MATH 18,B06,093474,Rideout; David Porter,5,0,36,31
1657299826235,MATH 20A,A01,083754,Zheng; Zequn,14,0,40,26
1657299832258,MATH 20B,A01,083756,Briones; Jor-el Thomas Caparas,3,0,36,33
1657299832258,MATH 20B,A02,083757,Briones; Jor-el Thomas Caparas,1,0,36,35
1657299832258,MATH 20B,A03,093475,Briones; Jor-el Thomas Caparas,2,0,36,34
1657299838286,MATH 20C,A01,083760,Briones; Jor-el Thomas Caparas,1,0,35,34
1657299838286,MATH 20C,A02,083761,Briones; Jor-el Thomas Caparas,8,0,35,27
1657299838286,MATH 20C,A03,093476,Briones; Jor-el Thomas Caparas,0,1,36,36
1657299838286,MATH 20C,B01,083762,Bach; Quang Tran,1,0,30,29
1657299844323,MATH 20D,A01,083765,Tran; Brian Kha,5,0,30,25
1657299844323,MATH 20D,A02,083766,Tran; Brian Kha,5,0,30,25
1657299844323,MATH 20D,A03,083767,Tran; Brian Kha,4,0,30,26
1657299850349,MATH 20E,A01,083771,Ganguly; Soumya,7,0,32,25
1657299850349,MATH 20E,A02,083772,Ganguly; Soumya,6,0,32,26
1657299850349,MATH 20E,B01,083773,Ciotti; Benjamin,19,0,35,16
1657299850349,MATH 20E,B02,083774,Ciotti; Benjamin,17,0,35,18
1657299856373,MATH 103A,A01,083777,Greenfeld; Be'Eri,3,0,36,33
1657299856373,MATH 103A,A02,083778,Greenfeld; Be'Eri,5,0,36,31
1657299856373,MATH 103A,A03,093561,Greenfeld; Be'Eri,4,0,36,32
1657299856373,MATH 103A,B01,083779,Greenfeld; Be'Eri,6,0,36,30
1657299856373,MATH 103A,B02,083780,Greenfeld; Be'Eri,4,0,36,32
1657299856373,MATH 103A,B03,093562,Greenfeld; Be'Eri,3,0,36,33
1657299862396,MATH 105,A01,085443,Carter; Anne Toulson,15,0,35,20
1657299862396,MATH 105,A02,093477,Carter; Anne Toulson,20,0,35,15
1657299868430,MATH 109,A01,083213,Ganzberger; Geoffrey Michael,2,0,34,32
1657299868430,MATH 109,A02,083214,Ganzberger; Geoffrey Michael,4,0,34,30
1657299868430,MATH 109,A03,093478,Ganzberger; Geoffrey Michael,2,0,34,32
1657299868430,MATH 109,B01,083215,Ganzberger; Geoffrey Michael,1,0,32,31
1657299868430,MATH 109,B02,083216,Ganzberger; Geoffrey Michael,1,0,32,31
1657299868430,MATH 109,B03,093479,Ganzberger; Geoffrey Michael,8,0,32,24
1657299874455,MATH 142A,A01,083219,Chow; Bennett,7,0,32,25
1657299874455,MATH 142A,A02,083220,Chow; Bennett,10,0,32,22
1657299874455,MATH 142A,A03,093480,Chow; Bennett,7,0,32,25
1657299874455,MATH 142A,B03,093481,Chow; Bennett,8,0,32,24
1657299874455,MATH 142A,B04,093558,Chow; Bennett,12,0,32,20
1657299874455,MATH 142A,B05,093559,Chow; Bennett,6,0,32,26
1657299880479,MATH 193A,A01,083224,Rotar; Vladimir,7,0,34,27
1657299880479,MATH 193A,A02,083225,Rotar; Vladimir,6,0,34,28
1657299880479,MATH 193A,A03,083781,Rotar; Vladimir,2,0,34,32
1657299880479,MATH 193A,A04,083782,Rotar; Vladimir,8,0,34,26
1657299880479,MATH 193A,A05,093482,Rotar; Vladimir,6,0,34,28
1657299886505,MATH 197,001,091859,McAuley; Julian John,9999,0,9999,0
1657299886505,MATH 197,002,095566,Kedlaya; Kiran S.,9997,0,9999,2
1657299886505,MATH 197,003,095567,Xiao; Ming,9999,0,9999,0
1657299886505,MATH 197,004,095571,Perols; Johan Lars,9998,0,9999,1
1657299893571,COGS 9,A01,083615,Shannon; Kyle Michael,8,0,75,67
1657299899606,COGS 11,A01,083617,Boyle; Mary E. T.,22,0,48,26
1657299905630,COGS 13,A01,083071,Bastos; Amalia Pinkusfeld,9,0,71,62
1657299911653,COGS 14A,A01,092681,Semenuks; Arturs,2,1,100,98
1657299917679,COGS 14B,A01,083073,Cheng; Tzu-Han,6,0,63,57
1657299923703,COGS 17,A01,092677,Semenuks; Arturs,5,0,81,76
1657299929744,COGS 100,A01,083619,Allen; Michael Gordon,16,0,70,54
1657299935778,COGS 101A,A01,083621,Davis; Joshua Daniel,9,0,68,59
1657299941801,COGS 101B,A01,091572,Allen; Michael Gordon,11,0,65,54
1657299947828,COGS 101C,A01,083625,Delgado; Tania,17,0,35,18
1657299953852,COGS 107A,A01,083627,Boyle; Mary E. T.,13,0,60,47
1657299959878,COGS 118A,A01,083075,Gupta; Anjum,18,0,76,58
1657299965905,CSE 3,A50,083646,Miranda; Gregory Joseph,24,0,50,26
1657299971931,CSE 8A,A50,083650,Miranda; Gregory Joseph,17,1,56,39
1657299977955,CSE 11,A01,083080,Cao; Yingjun,5,15,40,35
1657299983979,CSE 12,A01,083652,Krause-Levy; Sophia Louisa,26,1,120,94
1657299990003,CSE 15L,A01,083654,Morris; Justin Loren,9,0,50,41
1657299990003,CSE 15L,A02,083655,Morris; Justin Loren,9,0,50,41
1657299996044,CSE 20,A01,083657,Tran; Khoa Dang,38,0,80,42
1657300002066,CSE 21,A01,095574,Bach; Quang Tran,22,0,48,26
1657300008091,CSE 30,A01,083084,Eldon; John,4,0,80,76
1657300008091,CSE 30,B01,095061,Bhaskar; Nishant,9,0,50,41
1657300014114,CSE 100,A01,083659,Cao; Yingjun,4,4,70,66
1657300020141,CSE 134B,A01,083661,Powell; Thomas Allan,21,0,100,79
1657300026167,CSE 140,A01,083663,Gungor; Onat,13,0,85,72
1657300032193,CSE 140L,A01,083088,Eldon; John,20,0,100,80
1657300038216,CSE 175,A01,083665,Kumar; Rakesh,3,0,25,22
1657300044237,CSE 190,A00,092507,Dubnov; Shlomo,7,0,20,13
1657300050265,ECE 45,A01,083139,Congero; Spencer William,6,0,75,69
1657300056288,ECE 65,A50,083695,Saad; Andrew S,12,0,30,18
1657300056288,ECE 65,A51,095125,Saad; Andrew S,25,0,26,1
1657300062316,ECE 109,A01,091882,Touri; Behrouz,19,0,70,51
1657300068343,ECE 180,A00,083140,Abi Samra; Nicholas Camill,1,0,30,29
1657300068343,ECE 180,B00,083141,Abi Samra; Nicholas Camill,0,0,30,30
1657300074371,MATH 10A,A01,083735,Patchell; Gregory David,2,0,30,28
1657300074371,MATH 10A,A02,083736,Patchell; Gregory David,20,0,30,10
1657300074371,MATH 10A,A03,083737,Patchell; Gregory David,16,0,30,14
1657300080395,MATH 10B,A01,083207,Lim; Seonhee,7,0,34,27
1657300080395,MATH 10B,A02,083208,Lim; Seonhee,9,0,35,26
1657300080395,MATH 10B,A03,093472,Lim; Seonhee,6,0,34,28
1657300080395,MATH 10B,B01,083739,Sinha; Shubham,11,0,30,19
1657300086428,MATH 18,A01,083743,Cinel; Cameron Alexander,6,0,30,24
1657300086428,MATH 18,A02,083744,Cinel; Cameron Alexander,17,0,30,13
1657300086428,MATH 18,A03,083745,Cinel; Cameron Alexander,8,0,30,22
1657300086428,MATH 18,B01,083748,Rideout; David Porter,4,0,37,33
1657300086428,MATH 18,B02,083749,Rideout; David Porter,4,0,36,32
1657300086428,MATH 18,B03,083750,Rideout; David Porter,2,0,37,35
1657300086428,MATH 18,B04,083751,Rideout; David Porter,6,0,36,30
1657300086428,MATH 18,B05,093473,Rideout; David Porter,5,0,36,31
1657300086428,MATH 18,B06,093474,Rideout; David Porter,5,0,36,31
1657300092456,MATH 20A,A01,083754,Zheng; Zequn,14,0,40,26
1657300098482,MATH 20B,A01,083756,Briones; Jor-el Thomas Caparas,3,0,36,33
1657300098482,MATH 20B,A02,083757,Briones; Jor-el Thomas Caparas,1,0,36,35
1657300098482,MATH 20B,A03,093475,Briones; Jor-el Thomas Caparas,2,0,36,34
1657300104509,MATH 20C,A01,083760,Briones; Jor-el Thomas Caparas,1,0,35,34
1657300104509,MATH 20C,A02,083761,Briones; Jor-el Thomas Caparas,8,0,35,27
1657300104509,MATH 20C,A03,093476,Briones; Jor-el Thomas Caparas,0,1,36,36
1657300104509,MATH 20C,B01,083762,Bach; Quang Tran,1,0,30,29
1657300110536,MATH 20D,A01,083765,Tran; Brian Kha,5,0,30,25
1657300110536,MATH 20D,A02,083766,Tran; Brian Kha,5,0,30,25
1657300110536,MATH 20D,A03,083767,Tran; Brian Kha,4,0,30,26
1657300116563,MATH 20E,A01,083771,Ganguly; Soumya,7,0,32,25
1657300116563,MATH 20E,A02,083772,Ganguly; Soumya,6,0,32,26
1657300116563,MATH 20E,B01,083773,Ciotti; Benjamin,19,0,35,16
1657300116563,MATH 20E,B02,083774,Ciotti; Benjamin,17,0,35,18
1657300122601,MATH 103A,A01,083777,Greenfeld; Be'Eri,3,0,36,33
1657300122601,MATH 103A,A02,083778,Greenfeld; Be'Eri,5,0,36,31
1657300122601,MATH 103A,A03,093561,Greenfeld; Be'Eri,4,0,36,32
1657300122601,MATH 103A,B01,083779,Greenfeld; Be'Eri,6,0,36,30
1657300122601,MATH 103A,B02,083780,Greenfeld; Be'Eri,4,0,36,32
1657300122601,MATH 103A,B03,093562,Greenfeld; Be'Eri,3,0,36,33
1657300128629,MATH 105,A01,085443,Carter; Anne Toulson,15,0,35,20
1657300128629,MATH 105,A02,093477,Carter; Anne Toulson,20,0,35,15
1657300134652,MATH 109,A01,083213,Ganzberger; Geoffrey Michael,2,0,34,32
1657300134652,MATH 109,A02,083214,Ganzberger; Geoffrey Michael,4,0,34,30
1657300134652,MATH 109,A03,093478,Ganzberger; Geoffrey Michael,2,0,34,32
1657300134652,MATH 109,B01,083215,Ganzberger; Geoffrey Michael,1,0,32,31
1657300134652,MATH 109,B02,083216,Ganzberger; Geoffrey Michael,1,0,32,31
1657300134652,MATH 109,B03,093479,Ganzberger; Geoffrey Michael,8,0,32,24
1657300140683,MATH 142A,A01,083219,Chow; Bennett,7,0,32,25
1657300140683,MATH 142A,A02,083220,Chow; Bennett,10,0,32,22
1657300140683,MATH 142A,A03,093480,Chow; Bennett,7,0,32,25
1657300140683,MATH 142A,B03,093481,Chow; Bennett,8,0,32,24
1657300140683,MATH 142A,B04,093558,Chow; Bennett,12,0,32,20
1657300140683,MATH 142A,B05,093559,Chow; Bennett,6,0,32,26
1657300146706,MATH 193A,A01,083224,Rotar; Vladimir,7,0,34,27
1657300146706,MATH 193A,A02,083225,Rotar; Vladimir,6,0,34,28
1657300146706,MATH 193A,A03,083781,Rotar; Vladimir,2,0,34,32
1657300146706,MATH 193A,A04,083782,Rotar; Vladimir,8,0,34,26
1657300146706,MATH 193A,A05,093482,Rotar; Vladimir,6,0,34,28
1657300152728,MATH 197,001,091859,McAuley; Julian John,9999,0,9999,0
1657300152728,MATH 197,002,095566,Kedlaya; Kiran S.,9997,0,9999,2
1657300152728,MATH 197,003,095567,Xiao; Ming,9999,0,9999,0
1657300152728,MATH 197,004,095571,Perols; Johan Lars,9998,0,9999,1
1657300159792,COGS 9,A01,083615,Shannon; Kyle Michael,8,0,75,67
1657300165813,COGS 11,A01,083617,Boyle; Mary E. T.,22,0,48,26
1657300171840,COGS 13,A01,083071,Bastos; Amalia Pinkusfeld,9,0,71,62
1657300177867,COGS 14A,A01,092681,Semenuks; Arturs,2,1,100,98
1657300183892,COGS 14B,A01,083073,Cheng; Tzu-Han,6,0,63,57
1657300189915,COGS 17,A01,092677,Semenuks; Arturs,5,0,81,76
1657300195940,COGS 100,A01,083619,Allen; Michael Gordon,16,0,70,54
1657300201965,COGS 101A,A01,083621,Davis; Joshua Daniel,9,0,68,59
1657300207989,COGS 101B,A01,091572,Allen; Michael Gordon,11,0,65,54
1657300214014,COGS 101C,A01,083625,Delgado; Tania,17,0,35,18
1657300220040,COGS 107A,A01,083627,Boyle; Mary E. T.,13,0,60,47
1657300226064,COGS 118A,A01,083075,Gupta; Anjum,18,0,76,58
1657300232090,CSE 3,A50,083646,Miranda; Gregory Joseph,24,0,50,26
1657300238114,CSE 8A,A50,083650,Miranda; Gregory Joseph,17,1,56,39
1657300244141,CSE 11,A01,083080,Cao; Yingjun,5,15,40,35
1657300250165,CSE 12,A01,083652,Krause-Levy; Sophia Louisa,26,1,120,94
1657300256188,CSE 15L,A01,083654,Morris; Justin Loren,9,0,50,41
1657300256188,CSE 15L,A02,083655,Morris; Justin Loren,9,0,50,41
1657300262213,CSE 20,A01,083657,Tran; Khoa Dang,38,0,80,42
1657300268236,CSE 21,A01,095574,Bach; Quang Tran,22,0,48,26
1657300274261,CSE 30,A01,083084,Eldon; John,4,0,80,76
1657300274261,CSE 30,B01,095061,Bhaskar; Nishant,9,0,50,41
1657300280288,CSE 100,A01,083659,Cao; Yingjun,4,4,70,66
1657300286321,CSE 134B,A01,083661,Powell; Thomas Allan,21,0,100,79
1657300292347,CSE 140,A01,083663,Gungor; Onat,13,0,85,72
1657300298378,CSE 140L,A01,083088,Eldon; John,20,0,100,80
1657300304401,CSE 175,A01,083665,Kumar; Rakesh,3,0,25,22
1657300310427,CSE 190,A00,092507,Dubnov; Shlomo,7,0,20,13
1657300316454,ECE 45,A01,083139,Congero; Spencer William,6,0,75,69
1657300322478,ECE 65,A50,083695,Saad; Andrew S,12,0,30,18
1657300322478,ECE 65,A51,095125,Saad; Andrew S,25,0,26,1
1657300328501,ECE 109,A01,091882,Touri; Behrouz,19,0,70,51
1657300334524,ECE 180,A00,083140,Abi Samra; Nicholas Camill,1,0,30,29
1657300334524,ECE 180,B00,083141,Abi Samra; Nicholas Camill,0,0,30,30
1657300340552,MATH 10A,A01,083735,Patchell; Gregory David,2,0,30,28
1657300340552,MATH 10A,A02,083736,Patchell; Gregory David,20,0,30,10
1657300340552,MATH 10A,A03,083737,Patchell; Gregory David,16,0,30,14
1657300346581,MATH 10B,A01,083207,Lim; Seonhee,7,0,34,27
1657300346581,MATH 10B,A02,083208,Lim; Seonhee,9,0,35,26
1657300346581,MATH 10B,A03,093472,Lim; Seonhee,6,0,34,28
1657300346581,MATH 10B,B01,083739,Sinha; Shubham,11,0,30,19
1657300352709,MATH 18,A01,083743,Cinel; Cameron Alexander,6,0,30,24
1657300352709,MATH 18,A02,083744,Cinel; Cameron Alexander,17,0,30,13
1657300352709,MATH 18,A03,083745,Cinel; Cameron Alexander,8,0,30,22
1657300352709,MATH 18,B01,083748,Rideout; David Porter,4,0,37,33
1657300352709,MATH 18,B02,083749,Rideout; David Porter,4,0,36,32
1657300352709,MATH 18,B03,083750,Rideout; David Porter,2,0,37,35
1657300352709,MATH 18,B04,083751,Rideout; David Porter,6,0,36,30
1657300352709,MATH 18,B05,093473,Rideout; David Porter,5,0,36,31
1657300352709,MATH 18,B06,093474,Rideout; David Porter,5,0,36,31
1657300358733,MATH 20A,A01,083754,Zheng; Zequn,14,0,40,26
1657300364757,MATH 20B,A01,083756,Briones; Jor-el Thomas Caparas,3,0,36,33
1657300364757,MATH 20B,A02,083757,Briones; Jor-el Thomas Caparas,1,0,36,35
1657300364757,MATH 20B,A03,093475,Briones; Jor-el Thomas Caparas,2,0,36,34
1657300370781,MATH 20C,A01,083760,Briones; Jor-el Thomas Caparas,1,0,35,34
1657300370781,MATH 20C,A02,083761,Briones; Jor-el Thomas Caparas,8,0,35,27
1657300370781,MATH 20C,A03,093476,Briones; Jor-el Thomas Caparas,0,1,36,36
1657300370781,MATH 20C,B01,083762,Bach; Quang Tran,1,0,30,29
1657300376811,MATH 20D,A01,083765,Tran; Brian Kha,5,0,30,25
1657300376811,MATH 20D,A02,083766,Tran; Brian Kha,5,0,30,25
1657300376811,MATH 20D,A03,083767,Tran; Brian Kha,4,0,30,26
1657300382851,MATH 20E,A01,083771,Ganguly; Soumya,7,0,32,25
1657300382851,MATH 20E,A02,083772,Ganguly; Soumya,6,0,32,26
1657300382851,MATH 20E,B01,083773,Ciotti; Benjamin,19,0,35,16
1657300382851,MATH 20E,B02,083774,Ciotti; Benjamin,17,0,35,18
1657300388901,MATH 103A,A01,083777,Greenfeld; Be'Eri,3,0,36,33
1657300388901,MATH 103A,A02,083778,Greenfeld; Be'Eri,5,0,36,31
1657300388901,MATH 103A,A03,093561,Greenfeld; Be'Eri,4,0,36,32
1657300388901,MATH 103A,B01,083779,Greenfeld; Be'Eri,6,0,36,30
1657300388901,MATH 103A,B02,083780,Greenfeld; Be'Eri,4,0,36,32
1657300388901,MATH 103A,B03,093562,Greenfeld; Be'Eri,3,0,36,33
1657300394929,MATH 105,A01,085443,Carter; Anne Toulson,15,0,35,20
1657300394929,MATH 105,A02,093477,Carter; Anne Toulson,20,0,35,15
1657300400952,MATH 109,A01,083213,Ganzberger; Geoffrey Michael,2,0,34,32
1657300400952,MATH 109,A02,083214,Ganzberger; Geoffrey Michael,4,0,34,30
1657300400952,MATH 109,A03,093478,Ganzberger; Geoffrey Michael,2,0,34,32
1657300400952,MATH 109,B01,083215,Ganzberger; Geoffrey Michael,1,0,32,31
1657300400952,MATH 109,B02,083216,Ganzberger; Geoffrey Michael,1,0,32,31
1657300400952,MATH 109,B03,093479,Ganzberger; Geoffrey Michael,8,0,32,24
1657300406979,MATH 142A,A01,083219,Chow; Bennett,7,0,32,25
1657300406979,MATH 142A,A02,083220,Chow; Bennett,10,0,32,22
1657300406979,MATH 142A,A03,093480,Chow; Bennett,7,0,32,25
1657300406979,MATH 142A,B03,093481,Chow; Bennett,8,0,32,24
1657300406979,MATH 142A,B04,093558,Chow; Bennett,12,0,32,20
1657300406979,MATH 142A,B05,093559,Chow; Bennett,6,0,32,26
1657300413003,MATH 193A,A01,083224,Rotar; Vladimir,7,0,34,27
1657300413003,MATH 193A,A02,083225,Rotar; Vladimir,6,0,34,28
1657300413003,MATH 193A,A03,083781,Rotar; Vladimir,2,0,34,32
1657300413003,MATH 193A,A04,083782,Rotar; Vladimir,8,0,34,26
1657300413003,MATH 193A,A05,093482,Rotar; Vladimir,6,0,34,28
1657300419033,MATH 197,001,091859,McAuley; Julian John,9999,0,9999,0
1657300419033,MATH 197,002,095566,Kedlaya; Kiran S.,9997,0,9999,2
1657300419033,MATH 197,003,095567,Xiao; Ming,9999,0,9999,0
1657300419033,MATH 197,004,095571,Perols; Johan Lars,9998,0,9999,1
1657300426099,COGS 9,A01,083615,Shannon; Kyle Michael,8,0,75,67
1657300432125,COGS 11,A01,083617,Boyle; Mary E. T.,22,0,48,26
1657300438151,COGS 13,A01,083071,Bastos; Amalia Pinkusfeld,9,0,71,62
1657300444173,COGS 14A,A01,092681,Semenuks; Arturs,2,1,100,98
1657300450201,COGS 14B,A01,083073,Cheng; Tzu-Han,6,0,63,57
1657300456224,COGS 17,A01,092677,Semenuks; Arturs,5,0,81,76
1657300462252,COGS 100,A01,083619,Allen; Michael Gordon,16,0,70,54
1657300468280,COGS 101A,A01,083621,Davis; Joshua Daniel,9,0,68,59
1657300474305,COGS 101B,A01,091572,Allen; Michael Gordon,11,0,65,54
1657300480332,COGS 101C,A01,083625,Delgado; Tania,17,0,35,18
1657300486361,COGS 107A,A01,083627,Boyle; Mary E. T.,13,0,60,47
1657300492384,COGS 118A,A01,083075,Gupta; Anjum,18,0,76,58
1657300498409,CSE 3,A50,083646,Miranda; Gregory Joseph,24,0,50,26
1657300504443,CSE 8A,A50,083650,Miranda; Gregory Joseph,17,1,56,39
1657300510466,CSE 11,A01,083080,Cao; Yingjun,5,15,40,35
1657300516489,CSE 12,A01,083652,Krause-Levy; Sophia Louisa,26,1,120,94
1657300522561,CSE 15L,A01,083654,Morris; Justin Loren,9,0,50,41
1657300522561,CSE 15L,A02,083655,Morris; Justin Loren,9,0,50,41
1657300528589,CSE 20,A01,083657,Tran; Khoa Dang,38,0,80,42
1657300534613,CSE 21,A01,095574,Bach; Quang Tran,22,0,48,26
1657300540638,CSE 30,A01,083084,Eldon; John,4,0,80,76
1657300540638,CSE 30,B01,095061,Bhaskar; Nishant,9,0,50,41
1657300546660,CSE 100,A01,083659,Cao; Yingjun,4,4,70,66
1657300552686,CSE 134B,A01,083661,Powell; Thomas Allan,21,0,100,79
1657300558709,CSE 140,A01,083663,Gungor; Onat,13,0,85,72
1657300564732,CSE 140L,A01,083088,Eldon; John,20,0,100,80
1657300570755,CSE 175,A01,083665,Kumar; Rakesh,3,0,25,22
1657300576780,CSE 190,A00,092507,Dubnov; Shlomo,7,0,20,13
1657300582811,ECE 45,A01,083139,Congero; Spencer William,6,0,75,69
1657300588835,ECE 65,A50,083695,Saad; Andrew S,12,0,30,18
1657300588835,ECE 65,A51,095125,Saad; Andrew S,25,0,26,1
1657300594859,ECE 109,A01,091882,Touri; Behrouz,19,0,70,51
1657300600884,ECE 180,A00,083140,Abi Samra; Nicholas Camill,1,0,30,29
1657300600884,ECE 180,B00,083141,Abi Samra; Nicholas Camill,0,0,30,30
1657300606919,MATH 10A,A01,083735,Patchell; Gregory David,2,0,30,28
1657300606919,MATH 10A,A02,083736,Patchell; Gregory David,20,0,30,10
1657300606919,MATH 10A,A03,083737,Patchell; Gregory David,16,0,30,14
1657300612943,MATH 10B,A01,083207,Lim; Seonhee,7,0,34,27
1657300612943,MATH 10B,A02,083208,Lim; Seonhee,9,0,35,26
1657300612943,MATH 10B,A03,093472,Lim; Seonhee,6,0,34,28
1657300612943,MATH 10B,B01,083739,Sinha; Shubham,11,0,30,19
1657300618976,MATH 18,A01,083743,Cinel; Cameron Alexander,6,0,30,24
1657300618976,MATH 18,A02,083744,Cinel; Cameron Alexander,17,0,30,13
1657300618976,MATH 18,A03,083745,Cinel; Cameron Alexander,8,0,30,22
1657300618976,MATH 18,B01,083748,Rideout; David Porter,4,0,37,33
1657300618976,MATH 18,B02,083749,Rideout; David Porter,4,0,36,32
1657300618976,MATH 18,B03,083750,Rideout; David Porter,2,0,37,35
1657300618976,MATH 18,B04,083751,Rideout; David Porter,6,0,36,30
1657300618976,MATH 18,B05,093473,Rideout; David Porter,5,0,36,31
1657300618976,MATH 18,B06,093474,Rideout; David Porter,5,0,36,31
1657300625001,MATH 20A,A01,083754,Zheng; Zequn,14,0,40,26
1657300631030,MATH 20B,A01,083756,Briones; Jor-el Thomas Caparas,3,0,36,33
1657300631030,MATH 20B,A02,083757,Briones; Jor-el Thomas Caparas,1,0,36,35
1657300631030,MATH 20B,A03,093475,Briones; Jor-el Thomas Caparas,2,0,36,34
1657300637058,MATH 20C,A01,083760,Briones; Jor-el Thomas Caparas,1,0,35,34
1657300637058,MATH 20C,A02,083761,Briones; Jor-el Thomas Caparas,8,0,35,27
1657300637058,MATH 20C,A03,093476,Briones; Jor-el Thomas Caparas,0,1,36,36
1657300637058,MATH 20C,B01,083762,Bach; Quang Tran,1,0,30,29
1657300643083,MATH 20D,A01,083765,Tran; Brian Kha,5,0,30,25
1657300643083,MATH 20D,A02,083766,Tran; Brian Kha,5,0,30,25
1657300643083,MATH 20D,A03,083767,Tran; Brian Kha,4,0,30,26
1657300649112,MATH 20E,A01,083771,Ganguly; Soumya,7,0,32,25
1657300649112,MATH 20E,A02,083772,Ganguly; Soumya,6,0,32,26
1657300649112,MATH 20E,B01,083773,Ciotti; Benjamin,19,0,35,16
1657300649112,MATH 20E,B02,083774,Ciotti; Benjamin,17,0,35,18
1657300655137,MATH 103A,A01,083777,Greenfeld; Be'Eri,3,0,36,33
1657300655137,MATH 103A,A02,083778,Greenfeld; Be'Eri,5,0,36,31
1657300655137,MATH 103A,A03,093561,Greenfeld; Be'Eri,4,0,36,32
1657300655137,MATH 103A,B01,083779,Greenfeld; Be'Eri,6,0,36,30
1657300655137,MATH 103A,B02,083780,Greenfeld; Be'Eri,4,0,36,32
1657300655137,MATH 103A,B03,093562,Greenfeld; Be'Eri,3,0,36,33
1657300661161,MATH 105,A01,085443,Carter; Anne Toulson,15,0,35,20
1657300661161,MATH 105,A02,093477,Carter; Anne Toulson,20,0,35,15
1657300667190,MATH 109,A01,083213,Ganzberger; Geoffrey Michael,2,0,34,32
1657300667190,MATH 109,A02,083214,Ganzberger; Geoffrey Michael,4,0,34,30
1657300667190,MATH 109,A03,093478,Ganzberger; Geoffrey Michael,2,0,34,32
1657300667190,MATH 109,B01,083215,Ganzberger; Geoffrey Michael,1,0,32,31
1657300667190,MATH 109,B02,083216,Ganzberger; Geoffrey Michael,1,0,32,31
1657300667190,MATH 109,B03,093479,Ganzberger; Geoffrey Michael,8,0,32,24
1657300673218,MATH 142A,A01,083219,Chow; Bennett,7,0,32,25
1657300673218,MATH 142A,A02,083220,Chow; Bennett,10,0,32,22
1657300673218,MATH 142A,A03,093480,Chow; Bennett,7,0,32,25
1657300673218,MATH 142A,B03,093481,Chow; Bennett,8,0,32,24
1657300673218,MATH 142A,B04,093558,Chow; Bennett,12,0,32,20
1657300673218,MATH 142A,B05,093559,Chow; Bennett,6,0,32,26
1657300679258,MATH 193A,A01,083224,Rotar; Vladimir,7,0,34,27
1657300679258,MATH 193A,A02,083225,Rotar; Vladimir,6,0,34,28
1657300679258,MATH 193A,A03,083781,Rotar; Vladimir,2,0,34,32
1657300679258,MATH 193A,A04,083782,Rotar; Vladimir,8,0,34,26
1657300679258,MATH 193A,A05,093482,Rotar; Vladimir,6,0,34,28
1657300685281,MATH 197,001,091859,McAuley; Julian John,9999,0,9999,0
1657300685281,MATH 197,002,095566,Kedlaya; Kiran S.,9997,0,9999,2
1657300685281,MATH 197,003,095567,Xiao; Ming,9999,0,9999,0
1657300685281,MATH 197,004,095571,Perols; Johan Lars,9998,0,9999,1
1657300692344,COGS 9,A01,083615,Shannon; Kyle Michael,8,0,75,67
1657300698366,COGS 11,A01,083617,Boyle; Mary E. T.,22,0,48,26
1657300704398,COGS 13,A01,083071,Bastos; Amalia Pinkusfeld,9,0,71,62
1657300710424,COGS 14A,A01,092681,Semenuks; Arturs,2,1,100,98
1657300716447,COGS 14B,A01,083073,Cheng; Tzu-Han,6,0,63,57
1657300722473,COGS 17,A01,092677,Semenuks; Arturs,5,0,81,76
1657300728495,COGS 100,A01,083619,Allen; Michael Gordon,16,0,70,54
1657300734523,COGS 101A,A01,083621,Davis; Joshua Daniel,9,0,68,59
1657300740550,COGS 101B,A01,091572,Allen; Michael Gordon,11,0,65,54
1657300746574,COGS 101C,A01,083625,Delgado; Tania,17,0,35,18
1657300752596,COGS 107A,A01,083627,Boyle; Mary E. T.,13,0,60,47
1657300758620,COGS 118A,A01,083075,Gupta; Anjum,18,0,76,58
1657300764666,CSE 3,A50,083646,Miranda; Gregory Joseph,24,0,50,26
1657300770688,CSE 8A,A50,083650,Miranda; Gregory Joseph,17,1,56,39
1657300776712,CSE 11,A01,083080,Cao; Yingjun,5,15,40,35
1657300782745,CSE 12,A01,083652,Krause-Levy; Sophia Louisa,26,1,120,94
1657300788771,CSE 15L,A01,083654,Morris; Justin Loren,9,0,50,41
1657300788771,CSE 15L,A02,083655,Morris; Justin Loren,9,0,50,41
1657300794798,CSE 20,A01,083657,Tran; Khoa Dang,38,0,80,42
1657300800821,CSE 21,A01,095574,Bach; Quang Tran,22,0,48,26
1657300806844,CSE 30,A01,083084,Eldon; John,4,0,80,76
1657300806844,CSE 30,B01,095061,Bhaskar; Nishant,9,0,50,41
1657300812870,CSE 100,A01,083659,Cao; Yingjun,4,4,70,66
1657300818891,CSE 134B,A01,083661,Powell; Thomas Allan,21,0,100,79
1657300824918,CSE 140,A01,083663,Gungor; Onat,13,0,85,72
1657300830946,CSE 140L,A01,083088,Eldon; John,20,0,100,80
1657300836969,CSE 175,A01,083665,Kumar; Rakesh,3,0,25,22
1657300842991,CSE 190,A00,092507,Dubnov; Shlomo,7,0,20,13
1657300849017,ECE 45,A01,083139,Congero; Spencer William,6,0,75,69
1657300855039,ECE 65,A50,083695,Saad; Andrew S,12,0,30,18
1657300855039,ECE 65,A51,095125,Saad; Andrew S,25,0,26,1
1657300861067,ECE 109,A01,091882,Touri; Behrouz,19,0,70,51
1657300867090,ECE 180,A00,083140,Abi Samra; Nicholas Camill,1,0,30,29
1657300867090,ECE 180,B00,083141,Abi Samra; Nicholas Camill,0,0,30,30
1657300873114,MATH 10A,A01,083735,Patchell; Gregory David,2,0,30,28
1657300873114,MATH 10A,A02,083736,Patchell; Gregory David,20,0,30,10
1657300873114,MATH 10A,A03,083737,Patchell; Gregory David,16,0,30,14
1657300879156,MATH 10B,A01,083207,Lim; Seonhee,7,0,34,27
1657300879156,MATH 10B,A02,083208,Lim; Seonhee,9,0,35,26
1657300879156,MATH 10B,A03,093472,Lim; Seonhee,6,0,34,28
1657300879156,MATH 10B,B01,083739,Sinha; Shubham,11,0,30,19
1657300885188,MATH 18,A01,083743,Cinel; Cameron Alexander,6,0,30,24
1657300885188,MATH 18,A02,083744,Cinel; Cameron Alexander,17,0,30,13
1657300885188,MATH 18,A03,083745,Cinel; Cameron Alexander,8,0,30,22
1657300885188,MATH 18,B01,083748,Rideout; David Porter,4,0,37,33
1657300885188,MATH 18,B02,083749,Rideout; David Porter,4,0,36,32
1657300885188,MATH 18,B03,083750,Rideout; David Porter,2,0,37,35
1657300885188,MATH 18,B04,083751,Rideout; David Porter,6,0,36,30
1657300885188,MATH 18,B05,093473,Rideout; David Porter,5,0,36,31
1657300885188,MATH 18,B06,093474,Rideout; David Porter,5,0,36,31
1657300891211,MATH 20A,A01,083754,Zheng; Zequn,14,0,40,26
1657300897240,MATH 20B,A01,083756,Briones; Jor-el Thomas Caparas,3,0,36,33
1657300897240,MATH 20B,A02,083757,Briones; Jor-el Thomas Caparas,1,0,36,35
1657300897240,MATH 20B,A03,093475,Briones; Jor-el Thomas Caparas,2,0,36,34
1657300903280,MATH 20C,A01,083760,Briones; Jor-el Thomas Caparas,1,0,35,34
1657300903280,MATH 20C,A02,083761,Briones; Jor-el Thomas Caparas,8,0,35,27
1657300903280,MATH 20C,A03,093476,Briones; Jor-el Thomas Caparas,0,1,36,36
1657300903280,MATH 20C,B01,083762,Bach; Quang Tran,1,0,30,29
1657300909314,MATH 20D,A01,083765,Tran; Brian Kha,5,0,30,25
1657300909314,MATH 20D,A02,083766,Tran; Brian Kha,5,0,30,25
1657300909314,MATH 20D,A03,083767,Tran; Brian Kha,4,0,30,26
1657300915359,MATH 20E,A01,083771,Ganguly; Soumya,7,0,32,25
1657300915359,MATH 20E,A02,083772,Ganguly; Soumya,6,0,32,26
1657300915359,MATH 20E,B01,083773,Ciotti; Benjamin,19,0,35,16
1657300915359,MATH 20E,B02,083774,Ciotti; Benjamin,17,0,35,18
1657300931161,MATH 103A,A01,083777,Greenfeld; Be'Eri,3,0,36,33
1657300931161,MATH 103A,A02,083778,Greenfeld; Be'Eri,5,0,36,31
1657300931161,MATH 103A,A03,093561,Greenfeld; Be'Eri,4,0,36,32
1657300931161,MATH 103A,B01,083779,Greenfeld; Be'Eri,6,0,36,30
1657300931161,MATH 103A,B02,083780,Greenfeld; Be'Eri,4,0,36,32
1657300931161,MATH 103A,B03,093562,Greenfeld; Be'Eri,3,0,36,33
1657300937183,MATH 105,A01,085443,Carter; Anne Toulson,15,0,35,20
1657300937183,MATH 105,A02,093477,Carter; Anne Toulson,20,0,35,15
1657300943206,MATH 109,A01,083213,Ganzberger; Geoffrey Michael,2,0,34,32
1657300943206,MATH 109,A02,083214,Ganzberger; Geoffrey Michael,4,0,34,30
1657300943206,MATH 109,A03,093478,Ganzberger; Geoffrey Michael,2,0,34,32
1657300943206,MATH 109,B01,083215,Ganzberger; Geoffrey Michael,1,0,32,31
1657300943206,MATH 109,B02,083216,Ganzberger; Geoffrey Michael,1,0,32,31
1657300943206,MATH 109,B03,093479,Ganzberger; Geoffrey Michael,8,0,32,24
1657300949232,MATH 142A,A01,083219,Chow; Bennett,7,0,32,25
1657300949232,MATH 142A,A02,083220,Chow; Bennett,10,0,32,22
1657300949232,MATH 142A,A03,093480,Chow; Bennett,7,0,32,25
1657300949232,MATH 142A,B03,093481,Chow; Bennett,8,0,32,24
1657300949232,MATH 142A,B04,093558,Chow; Bennett,12,0,32,20
1657300949232,MATH 142A,B05,093559,Chow; Bennett,6,0,32,26
1657300955257,MATH 193A,A01,083224,Rotar; Vladimir,7,0,34,27
1657300955257,MATH 193A,A02,083225,Rotar; Vladimir,6,0,34,28
1657300955257,MATH 193A,A03,083781,Rotar; Vladimir,2,0,34,32
1657300955257,MATH 193A,A04,083782,Rotar; Vladimir,8,0,34,26
1657300955257,MATH 193A,A05,093482,Rotar; Vladimir,6,0,34,28
1657300961373,MATH 197,001,091859,McAuley; Julian John,9999,0,9999,0
1657300961373,MATH 197,002,095566,Kedlaya; Kiran S.,9997,0,9999,2
1657300961373,MATH 197,003,095567,Xiao; Ming,9999,0,9999,0
1657300961373,MATH 197,004,095571,Perols; Johan Lars,9998,0,9999,1
1657300968429,COGS 9,A01,083615,Shannon; Kyle Michael,8,0,75,67
1657300974454,COGS 11,A01,083617,Boyle; Mary E. T.,22,0,48,26
1657300980486,COGS 13,A01,083071,Bastos; Amalia Pinkusfeld,9,0,71,62
1657300986508,COGS 14A,A01,092681,Semenuks; Arturs,2,1,100,98
1657300992531,COGS 14B,A01,083073,Cheng; Tzu-Han,6,0,63,57
1657300998556,COGS 17,A01,092677,Semenuks; Arturs,5,0,81,76
1657301004581,COGS 100,A01,083619,Allen; Michael Gordon,16,0,70,54
1657301010608,COGS 101A,A01,083621,Davis; Joshua Daniel,9,0,68,59
1657301016632,COGS 101B,A01,091572,Allen; Michael Gordon,11,0,65,54
1657301022660,COGS 101C,A01,083625,Delgado; Tania,17,0,35,18
1657301028691,COGS 107A,A01,083627,Boyle; Mary E. T.,13,0,60,47
1657301034721,COGS 118A,A01,083075,Gupta; Anjum,18,0,76,58
1657301040744,CSE 3,A50,083646,Miranda; Gregory Joseph,24,0,50,26
1657301046777,CSE 8A,A50,083650,Miranda; Gregory Joseph,17,1,56,39
1657301052803,CSE 11,A01,083080,Cao; Yingjun,5,15,40,35
1657301058838,CSE 12,A01,083652,Krause-Levy; Sophia Louisa,26,1,120,94
1657301064869,CSE 15L,A01,083654,Morris; Justin Loren,9,0,50,41
1657301064869,CSE 15L,A02,083655,Morris; Justin Loren,9,0,50,41
1657301070893,CSE 20,A01,083657,Tran; Khoa Dang,38,0,80,42
1657301076926,CSE 21,A01,095574,Bach; Quang Tran,22,0,48,26
1657301082950,CSE 30,A01,083084,Eldon; John,4,0,80,76
1657301082950,CSE 30,B01,095061,Bhaskar; Nishant,9,0,50,41
1657301088977,CSE 100,A01,083659,Cao; Yingjun,4,4,70,66
1657301095000,CSE 134B,A01,083661,Powell; Thomas Allan,21,0,100,79
1657301101024,CSE 140,A01,083663,Gungor; Onat,13,0,85,72
1657301107050,CSE 140L,A01,083088,Eldon; John,20,0,100,80
1657301113084,CSE 175,A01,083665,Kumar; Rakesh,3,0,25,22
1657301119107,CSE 190,A00,092507,Dubnov; Shlomo,7,0,20,13
1657301125133,ECE 45,A01,083139,Congero; Spencer William,6,0,75,69
1657301131161,ECE 65,A50,083695,Saad; Andrew S,12,0,30,18
1657301131161,ECE 65,A51,095125,Saad; Andrew S,25,0,26,1
1657301137191,ECE 109,A01,091882,Touri; Behrouz,19,0,70,51
1657301143218,ECE 180,A00,083140,Abi Samra; Nicholas Camill,1,0,30,29
1657301143218,ECE 180,B00,083141,Abi Samra; Nicholas Camill,0,0,30,30
1657301149242,MATH 10A,A01,083735,Patchell; Gregory David,2,0,30,28
1657301149242,MATH 10A,A02,083736,Patchell; Gregory David,20,0,30,10
1657301149242,MATH 10A,A03,083737,Patchell; Gregory David,16,0,30,14
1657301155267,MATH 10B,A01,083207,Lim; Seonhee,7,0,34,27
1657301155267,MATH 10B,A02,083208,Lim; Seonhee,9,0,35,26
1657301155267,MATH 10B,A03,093472,Lim; Seonhee,6,0,34,28
1657301155267,MATH 10B,B01,083739,Sinha; Shubham,11,0,30,19
1657301161300,MATH 18,A01,083743,Cinel; Cameron Alexander,6,0,30,24
1657301161300,MATH 18,A02,083744,Cinel; Cameron Alexander,17,0,30,13
1657301161300,MATH 18,A03,083745,Cinel; Cameron Alexander,8,0,30,22
1657301161300,MATH 18,B01,083748,Rideout; David Porter,4,0,37,33
1657301161300,MATH 18,B02,083749,Rideout; David Porter,4,0,36,32
1657301161300,MATH 18,B03,083750,Rideout; David Porter,2,0,37,35
1657301161300,MATH 18,B04,083751,Rideout; David Porter,6,0,36,30
1657301161300,MATH 18,B05,093473,Rideout; David Porter,5,0,36,31
1657301161300,MATH 18,B06,093474,Rideout; David Porter,5,0,36,31
1657301167329,MATH 20A,A01,083754,Zheng; Zequn,14,0,40,26
1657301173359,MATH 20B,A01,083756,Briones; Jor-el Thomas Caparas,3,0,36,33
1657301173359,MATH 20B,A02,083757,Briones; Jor-el Thomas Caparas,1,0,36,35
1657301173359,MATH 20B,A03,093475,Briones; Jor-el Thomas Caparas,2,0,36,34
1657301179387,MATH 20C,A01,083760,Briones; Jor-el Thomas Caparas,1,0,35,34
1657301179387,MATH 20C,A02,083761,Briones; Jor-el Thomas Caparas,8,0,35,27
1657301179387,MATH 20C,A03,093476,Briones; Jor-el Thomas Caparas,0,1,36,36
1657301179387,MATH 20C,B01,083762,Bach; Quang Tran,1,0,30,29
1657301185414,MATH 20D,A01,083765,Tran; Brian Kha,5,0,30,25
1657301185414,MATH 20D,A02,083766,Tran; Brian Kha,5,0,30,25
1657301185414,MATH 20D,A03,083767,Tran; Brian Kha,4,0,30,26
1657301191441,MATH 20E,A01,083771,Ganguly; Soumya,7,0,32,25
1657301191441,MATH 20E,A02,083772,Ganguly; Soumya,6,0,32,26
1657301191441,MATH 20E,B01,083773,Ciotti; Benjamin,19,0,35,16
1657301191441,MATH 20E,B02,083774,Ciotti; Benjamin,17,0,35,18
1657301197489,MATH 103A,A01,083777,Greenfeld; Be'Eri,3,0,36,33
1657301197489,MATH 103A,A02,083778,Greenfeld; Be'Eri,5,0,36,31
1657301197489,MATH 103A,A03,093561,Greenfeld; Be'Eri,4,0,36,32
1657301197489,MATH 103A,B01,083779,Greenfeld; Be'Eri,6,0,36,30
1657301197489,MATH 103A,B02,083780,Greenfeld; Be'Eri,4,0,36,32
1657301197489,MATH 103A,B03,093562,Greenfeld; Be'Eri,3,0,36,33
1657301203520,MATH 105,A01,085443,Carter; Anne Toulson,15,0,35,20
1657301203520,MATH 105,A02,093477,Carter; Anne Toulson,20,0,35,15
1657301209544,MATH 109,A01,083213,Ganzberger; Geoffrey Michael,2,0,34,32
1657301209544,MATH 109,A02,083214,Ganzberger; Geoffrey Michael,4,0,34,30
1657301209544,MATH 109,A03,093478,Ganzberger; Geoffrey Michael,2,0,34,32
1657301209544,MATH 109,B01,083215,Ganzberger; Geoffrey Michael,1,0,32,31
1657301209544,MATH 109,B02,083216,Ganzberger; Geoffrey Michael,1,0,32,31
1657301209544,MATH 109,B03,093479,Ganzberger; Geoffrey Michael,8,0,32,24
1657301215579,MATH 142A,A01,083219,Chow; Bennett,7,0,32,25
1657301215579,MATH 142A,A02,083220,Chow; Bennett,10,0,32,22
1657301215579,MATH 142A,A03,093480,Chow; Bennett,7,0,32,25
1657301215579,MATH 142A,B03,093481,Chow; Bennett,8,0,32,24
1657301215579,MATH 142A,B04,093558,Chow; Bennett,12,0,32,20
1657301215579,MATH 142A,B05,093559,Chow; Bennett,6,0,32,26
1657301221602,MATH 193A,A01,083224,Rotar; Vladimir,7,0,34,27
1657301221602,MATH 193A,A02,083225,Rotar; Vladimir,6,0,34,28
1657301221602,MATH 193A,A03,083781,Rotar; Vladimir,2,0,34,32
1657301221602,MATH 193A,A04,083782,Rotar; Vladimir,8,0,34,26
1657301221602,MATH 193A,A05,093482,Rotar; Vladimir,6,0,34,28
1657301227632,MATH 197,001,091859,McAuley; Julian John,9999,0,9999,0
1657301227632,MATH 197,002,095566,Kedlaya; Kiran S.,9997,0,9999,2
1657301227632,MATH 197,003,095567,Xiao; Ming,9999,0,9999,0
1657301227632,MATH 197,004,095571,Perols; Johan Lars,9998,0,9999,1
1657301234684,COGS 9,A01,083615,Shannon; Kyle Michael,8,0,75,67
1657301240707,COGS 11,A01,083617,Boyle; Mary E. T.,22,0,48,26
1657301246735,COGS 13,A01,083071,Bastos; Amalia Pinkusfeld,10,0,71,61
1657301252759,COGS 14A,A01,092681,Semenuks; Arturs,2,1,100,98
1657301258781,COGS 14B,A01,083073,Cheng; Tzu-Han,6,0,63,57
1657301264807,COGS 17,A01,092677,Semenuks; Arturs,5,0,81,76
1657301270832,COGS 100,A01,083619,Allen; Michael Gordon,16,0,70,54
1657301276875,COGS 101A,A01,083621,Davis; Joshua Daniel,9,0,68,59
1657301282902,COGS 101B,A01,091572,Allen; Michael Gordon,11,0,65,54
1657301288924,COGS 101C,A01,083625,Delgado; Tania,17,0,35,18
1657301294947,COGS 107A,A01,083627,Boyle; Mary E. T.,13,0,60,47
1657301300970,COGS 118A,A01,083075,Gupta; Anjum,18,0,76,58
1657301306998,CSE 3,A50,083646,Miranda; Gregory Joseph,24,0,50,26
1657301313022,CSE 8A,A50,083650,Miranda; Gregory Joseph,17,1,56,39
1657301319048,CSE 11,A01,083080,Cao; Yingjun,5,15,40,35
1657301325075,CSE 12,A01,083652,Krause-Levy; Sophia Louisa,26,1,120,94
1657301331097,CSE 15L,A01,083654,Morris; Justin Loren,9,0,50,41
1657301331097,CSE 15L,A02,083655,Morris; Justin Loren,9,0,50,41
1657301337125,CSE 20,A01,083657,Tran; Khoa Dang,38,0,80,42
1657301343153,CSE 21,A01,095574,Bach; Quang Tran,22,0,48,26
1657301349180,CSE 30,A01,083084,Eldon; John,4,0,80,76
1657301349180,CSE 30,B01,095061,Bhaskar; Nishant,9,0,50,41
1657301355205,CSE 100,A01,083659,Cao; Yingjun,4,4,70,66
1657301361232,CSE 134B,A01,083661,Powell; Thomas Allan,21,0,100,79
1657301367254,CSE 140,A01,083663,Gungor; Onat,13,0,85,72
1657301373283,CSE 140L,A01,083088,Eldon; John,20,0,100,80
1657301379306,CSE 175,A01,083665,Kumar; Rakesh,3,0,25,22
1657301385328,CSE 190,A00,092507,Dubnov; Shlomo,7,0,20,13
1657301391351,ECE 45,A01,083139,Congero; Spencer William,6,0,75,69
1657301397386,ECE 65,A50,083695,Saad; Andrew S,12,0,30,18
1657301397386,ECE 65,A51,095125,Saad; Andrew S,25,0,26,1
1657301403408,ECE 109,A01,091882,Touri; Behrouz,19,0,70,51
1657301409453,ECE 180,A00,083140,Abi Samra; Nicholas Camill,1,0,30,29
1657301409453,ECE 180,B00,083141,Abi Samra; Nicholas Camill,0,0,30,30
1657301415477,MATH 10A,A01,083735,Patchell; Gregory David,2,0,30,28
1657301415477,MATH 10A,A02,083736,Patchell; Gregory David,20,0,30,10
1657301415477,MATH 10A,A03,083737,Patchell; Gregory David,16,0,30,14
1657301421501,MATH 10B,A01,083207,Lim; Seonhee,7,0,34,27
1657301421501,MATH 10B,A02,083208,Lim; Seonhee,9,0,35,26
1657301421501,MATH 10B,A03,093472,Lim; Seonhee,6,0,34,28
1657301421501,MATH 10B,B01,083739,Sinha; Shubham,11,0,30,19
1657301427530,MATH 18,A01,083743,Cinel; Cameron Alexander,6,0,30,24
1657301427530,MATH 18,A02,083744,Cinel; Cameron Alexander,17,0,30,13
1657301427530,MATH 18,A03,083745,Cinel; Cameron Alexander,8,0,30,22
1657301427530,MATH 18,B01,083748,Rideout; David Porter,4,0,37,33
1657301427530,MATH 18,B02,083749,Rideout; David Porter,4,0,36,32
1657301427530,MATH 18,B03,083750,Rideout; David Porter,2,0,37,35
1657301427530,MATH 18,B04,083751,Rideout; David Porter,6,0,36,30
1657301427530,MATH 18,B05,093473,Rideout; David Porter,5,0,36,31
1657301427530,MATH 18,B06,093474,Rideout; David Porter,5,0,36,31
1657301433553,MATH 20A,A01,083754,Zheng; Zequn,14,0,40,26
1657301439576,MATH 20B,A01,083756,Briones; Jor-el Thomas Caparas,3,0,36,33
1657301439576,MATH 20B,A02,083757,Briones; Jor-el Thomas Caparas,1,0,36,35
1657301439576,MATH 20B,A03,093475,Briones; Jor-el Thomas Caparas,2,0,36,34
1657301445605,MATH 20C,A01,083760,Briones; Jor-el Thomas Caparas,1,0,35,34
1657301445605,MATH 20C,A02,083761,Briones; Jor-el Thomas Caparas,8,0,35,27
1657301445605,MATH 20C,A03,093476,Briones; Jor-el Thomas Caparas,0,1,36,36
1657301445605,MATH 20C,B01,083762,Bach; Quang Tran,1,0,30,29
1657301451630,MATH 20D,A01,083765,Tran; Brian Kha,5,0,30,25
1657301451630,MATH 20D,A02,083766,Tran; Brian Kha,5,0,30,25
1657301451630,MATH 20D,A03,083767,Tran; Brian Kha,4,0,30,26
1657301457662,MATH 20E,A01,083771,Ganguly; Soumya,7,0,32,25
1657301457662,MATH 20E,A02,083772,Ganguly; Soumya,6,0,32,26
1657301457662,MATH 20E,B01,083773,Ciotti; Benjamin,19,0,35,16
1657301457662,MATH 20E,B02,083774,Ciotti; Benjamin,17,0,35,18
1657301463690,MATH 103A,A01,083777,Greenfeld; Be'Eri,3,0,36,33
1657301463690,MATH 103A,A02,083778,Greenfeld; Be'Eri,5,0,36,31
1657301463690,MATH 103A,A03,093561,Greenfeld; Be'Eri,4,0,36,32
1657301463690,MATH 103A,B01,083779,Greenfeld; Be'Eri,6,0,36,30
1657301463690,MATH 103A,B02,083780,Greenfeld; Be'Eri,4,0,36,32
1657301463690,MATH 103A,B03,093562,Greenfeld; Be'Eri,3,0,36,33
1657301469724,MATH 105,A01,085443,Carter; Anne Toulson,15,0,35,20
1657301469724,MATH 105,A02,093477,Carter; Anne Toulson,20,0,35,15
1657301475750,MATH 109,A01,083213,Ganzberger; Geoffrey Michael,2,0,34,32
1657301475750,MATH 109,A02,083214,Ganzberger; Geoffrey Michael,4,0,34,30
1657301475750,MATH 109,A03,093478,Ganzberger; Geoffrey Michael,2,0,34,32
1657301475750,MATH 109,B01,083215,Ganzberger; Geoffrey Michael,1,0,32,31
1657301475750,MATH 109,B02,083216,Ganzberger; Geoffrey Michael,1,0,32,31
1657301475750,MATH 109,B03,093479,Ganzberger; Geoffrey Michael,8,0,32,24
1657301481777,MATH 142A,A01,083219,Chow; Bennett,7,0,32,25
1657301481777,MATH 142A,A02,083220,Chow; Bennett,10,0,32,22
1657301481777,MATH 142A,A03,093480,Chow; Bennett,7,0,32,25
1657301481777,MATH 142A,B03,093481,Chow; Bennett,8,0,32,24
1657301481777,MATH 142A,B04,093558,Chow; Bennett,12,0,32,20
1657301481777,MATH 142A,B05,093559,Chow; Bennett,6,0,32,26
1657301487801,MATH 193A,A01,083224,Rotar; Vladimir,7,0,34,27
1657301487801,MATH 193A,A02,083225,Rotar; Vladimir,6,0,34,28
1657301487801,MATH 193A,A03,083781,Rotar; Vladimir,2,0,34,32
1657301487801,MATH 193A,A04,083782,Rotar; Vladimir,8,0,34,26
1657301487801,MATH 193A,A05,093482,Rotar; Vladimir,6,0,34,28
1657301493824,MATH 197,001,091859,McAuley; Julian John,9999,0,9999,0
1657301493824,MATH 197,002,095566,Kedlaya; Kiran S.,9997,0,9999,2
1657301493824,MATH 197,003,095567,Xiao; Ming,9999,0,9999,0
1657301493824,MATH 197,004,095571,Perols; Johan Lars,9998,0,9999,1
1657301500896,COGS 9,A01,083615,Shannon; Kyle Michael,8,0,75,67
1657301506920,COGS 11,A01,083617,Boyle; Mary E. T.,22,0,48,26
1657301512946,COGS 13,A01,083071,Bastos; Amalia Pinkusfeld,10,0,71,61
1657301518987,COGS 14A,A01,092681,Semenuks; Arturs,2,1,100,98
1657301525022,COGS 14B,A01,083073,Cheng; Tzu-Han,6,0,63,57
1657301531045,COGS 17,A01,092677,Semenuks; Arturs,5,0,81,76
1657301537068,COGS 100,A01,083619,Allen; Michael Gordon,16,0,70,54
1657301543096,COGS 101A,A01,083621,Davis; Joshua Daniel,9,0,68,59
1657301549118,COGS 101B,A01,091572,Allen; Michael Gordon,11,0,65,54
1657301555235,COGS 101C,A01,083625,Delgado; Tania,17,0,35,18
1657301561264,COGS 107A,A01,083627,Boyle; Mary E. T.,13,0,60,47
1657301567286,COGS 118A,A01,083075,Gupta; Anjum,18,0,76,58
1657301573309,CSE 3,A50,083646,Miranda; Gregory Joseph,24,0,50,26
1657301579341,CSE 8A,A50,083650,Miranda; Gregory Joseph,17,1,56,39
1657301585362,CSE 11,A01,083080,Cao; Yingjun,5,15,40,35
1657301591384,CSE 12,A01,083652,Krause-Levy; Sophia Louisa,26,1,120,94
1657301597410,CSE 15L,A01,083654,Morris; Justin Loren,9,0,50,41
1657301597410,CSE 15L,A02,083655,Morris; Justin Loren,9,0,50,41
1657301603434,CSE 20,A01,083657,Tran; Khoa Dang,38,0,80,42
1657301609471,CSE 21,A01,095574,Bach; Quang Tran,22,0,48,26
1657301615499,CSE 30,A01,083084,Eldon; John,4,0,80,76
1657301615499,CSE 30,B01,095061,Bhaskar; Nishant,9,0,50,41
1657301621527,CSE 100,A01,083659,Cao; Yingjun,4,4,70,66
1657301627557,CSE 134B,A01,083661,Powell; Thomas Allan,21,0,100,79
1657301633585,CSE 140,A01,083663,Gungor; Onat,13,0,85,72
1657301639610,CSE 140L,A01,083088,Eldon; John,20,0,100,80
1657301645638,CSE 175,A01,083665,Kumar; Rakesh,3,0,25,22
1657301651663,CSE 190,A00,092507,Dubnov; Shlomo,7,0,20,13
1657301657689,ECE 45,A01,083139,Congero; Spencer William,6,0,75,69
1657301663717,ECE 65,A50,083695,Saad; Andrew S,12,0,30,18
1657301663717,ECE 65,A51,095125,Saad; Andrew S,25,0,26,1
1657301669745,ECE 109,A01,091882,Touri; Behrouz,19,0,70,51
1657301675773,ECE 180,A00,083140,Abi Samra; Nicholas Camill,1,0,30,29
1657301675773,ECE 180,B00,083141,Abi Samra; Nicholas Camill,0,0,30,30
1657301681809,MATH 10A,A01,083735,Patchell; Gregory David,2,0,30,28
1657301681809,MATH 10A,A02,083736,Patchell; Gregory David,20,0,30,10
1657301681809,MATH 10A,A03,083737,Patchell; Gregory David,16,0,30,14
1657301687836,MATH 10B,A01,083207,Lim; Seonhee,7,0,34,27
1657301687836,MATH 10B,A02,083208,Lim; Seonhee,9,0,35,26
1657301687836,MATH 10B,A03,093472,Lim; Seonhee,6,0,34,28
1657301687836,MATH 10B,B01,083739,Sinha; Shubham,11,0,30,19
1657301693862,MATH 18,A01,083743,Cinel; Cameron Alexander,6,0,30,24
1657301693862,MATH 18,A02,083744,Cinel; Cameron Alexander,17,0,30,13
1657301693862,MATH 18,A03,083745,Cinel; Cameron Alexander,8,0,30,22
1657301693862,MATH 18,B01,083748,Rideout; David Porter,4,0,37,33
1657301693862,MATH 18,B02,083749,Rideout; David Porter,4,0,36,32
1657301693862,MATH 18,B03,083750,Rideout; David Porter,2,0,37,35
1657301693862,MATH 18,B04,083751,Rideout; David Porter,6,0,36,30
1657301693862,MATH 18,B05,093473,Rideout; David Porter,5,0,36,31
1657301693862,MATH 18,B06,093474,Rideout; David Porter,5,0,36,31
1657301699892,MATH 20A,A01,083754,Zheng; Zequn,14,0,40,26
1657301705921,MATH 20B,A01,083756,Briones; Jor-el Thomas Caparas,3,0,36,33
1657301705921,MATH 20B,A02,083757,Briones; Jor-el Thomas Caparas,1,0,36,35
1657301705921,MATH 20B,A03,093475,Briones; Jor-el Thomas Caparas,2,0,36,34
1657301711945,MATH 20C,A01,083760,Briones; Jor-el Thomas Caparas,1,0,35,34
1657301711945,MATH 20C,A02,083761,Briones; Jor-el Thomas Caparas,8,0,35,27
1657301711945,MATH 20C,A03,093476,Briones; Jor-el Thomas Caparas,0,1,36,36
1657301711945,MATH 20C,B01,083762,Bach; Quang Tran,1,0,30,29
1657301717973,MATH 20D,A01,083765,Tran; Brian Kha,5,0,30,25
1657301717973,MATH 20D,A02,083766,Tran; Brian Kha,5,0,30,25
1657301717973,MATH 20D,A03,083767,Tran; Brian Kha,4,0,30,26
1657301724005,MATH 20E,A01,083771,Ganguly; Soumya,7,0,32,25
1657301724005,MATH 20E,A02,083772,Ganguly; Soumya,6,0,32,26
1657301724005,MATH 20E,B01,083773,Ciotti; Benjamin,19,0,35,16
1657301724005,MATH 20E,B02,083774,Ciotti; Benjamin,17,0,35,18
1657301730028,MATH 103A,A01,083777,Greenfeld; Be'Eri,3,0,36,33
1657301730028,MATH 103A,A02,083778,Greenfeld; Be'Eri,5,0,36,31
1657301730028,MATH 103A,A03,093561,Greenfeld; Be'Eri,4,0,36,32
1657301730028,MATH 103A,B01,083779,Greenfeld; Be'Eri,6,0,36,30
1657301730028,MATH 103A,B02,083780,Greenfeld; Be'Eri,4,0,36,32
1657301730028,MATH 103A,B03,093562,Greenfeld; Be'Eri,3,0,36,33
1657301736057,MATH 105,A01,085443,Carter; Anne Toulson,15,0,35,20
1657301736057,MATH 105,A02,093477,Carter; Anne Toulson,20,0,35,15
1657301742086,MATH 109,A01,083213,Ganzberger; Geoffrey Michael,2,0,34,32
1657301742086,MATH 109,A02,083214,Ganzberger; Geoffrey Michael,4,0,34,30
1657301742086,MATH 109,A03,093478,Ganzberger; Geoffrey Michael,2,0,34,32
1657301742086,MATH 109,B01,083215,Ganzberger; Geoffrey Michael,1,0,32,31
1657301742086,MATH 109,B02,083216,Ganzberger; Geoffrey Michael,1,0,32,31
1657301742086,MATH 109,B03,093479,Ganzberger; Geoffrey Michael,8,0,32,24
1657301748112,MATH 142A,A01,083219,Chow; Bennett,7,0,32,25
1657301748112,MATH 142A,A02,083220,Chow; Bennett,10,0,32,22
1657301748112,MATH 142A,A03,093480,Chow; Bennett,7,0,32,25
1657301748112,MATH 142A,B03,093481,Chow; Bennett,8,0,32,24
1657301748112,MATH 142A,B04,093558,Chow; Bennett,12,0,32,20
1657301748112,MATH 142A,B05,093559,Chow; Bennett,6,0,32,26
1657301754135,MATH 193A,A01,083224,Rotar; Vladimir,7,0,34,27
1657301754135,MATH 193A,A02,083225,Rotar; Vladimir,6,0,34,28
1657301754135,MATH 193A,A03,083781,Rotar; Vladimir,2,0,34,32
1657301754135,MATH 193A,A04,083782,Rotar; Vladimir,8,0,34,26
1657301754135,MATH 193A,A05,093482,Rotar; Vladimir,6,0,34,28
1657301760159,MATH 197,001,091859,McAuley; Julian John,9999,0,9999,0
1657301760159,MATH 197,002,095566,Kedlaya; Kiran S.,9997,0,9999,2
1657301760159,MATH 197,003,095567,Xiao; Ming,9999,0,9999,0
1657301760159,MATH 197,004,095571,Perols; Johan Lars,9998,0,9999,1
1657301767215,COGS 9,A01,083615,Shannon; Kyle Michael,8,0,75,67
1657301773249,COGS 11,A01,083617,Boyle; Mary E. T.,22,0,48,26
1657301779277,COGS 13,A01,083071,Bastos; Amalia Pinkusfeld,10,0,71,61
1657301785298,COGS 14A,A01,092681,Semenuks; Arturs,2,1,100,98
1657301791330,COGS 14B,A01,083073,Cheng; Tzu-Han,6,0,63,57
1657301797354,COGS 17,A01,092677,Semenuks; Arturs,5,0,81,76
1657301803375,COGS 100,A01,083619,Allen; Michael Gordon,16,0,70,54
1657301809398,COGS 101A,A01,083621,Davis; Joshua Daniel,9,0,68,59
1657301815422,COGS 101B,A01,091572,Allen; Michael Gordon,11,0,65,54
1657301821453,COGS 101C,A01,083625,Delgado; Tania,17,0,35,18
1657301827475,COGS 107A,A01,083627,Boyle; Mary E. T.,13,0,60,47
1657301833498,COGS 118A,A01,083075,Gupta; Anjum,18,0,76,58
1657301839523,CSE 3,A50,083646,Miranda; Gregory Joseph,24,0,50,26
1657301845549,CSE 8A,A50,083650,Miranda; Gregory Joseph,17,1,56,39
1657301851576,CSE 11,A01,083080,Cao; Yingjun,5,15,40,35
1657301857598,CSE 12,A01,083652,Krause-Levy; Sophia Louisa,26,1,120,94
1657301863637,CSE 15L,A01,083654,Morris; Justin Loren,9,0,50,41
1657301863637,CSE 15L,A02,083655,Morris; Justin Loren,9,0,50,41
1657301869663,CSE 20,A01,083657,Tran; Khoa Dang,38,0,80,42
1657301875688,CSE 21,A01,095574,Bach; Quang Tran,22,0,48,26
1657301881711,CSE 30,A01,083084,Eldon; John,4,0,80,76
1657301881711,CSE 30,B01,095061,Bhaskar; Nishant,9,0,50,41
1657301887737,CSE 100,A01,083659,Cao; Yingjun,4,4,70,66
1657301893769,CSE 134B,A01,083661,Powell; Thomas Allan,21,0,100,79
1657301899791,CSE 140,A01,083663,Gungor; Onat,13,0,85,72
1657301905815,CSE 140L,A01,083088,Eldon; John,20,0,100,80
1657301911849,CSE 175,A01,083665,Kumar; Rakesh,3,0,25,22
1657301917870,CSE 190,A00,092507,Dubnov; Shlomo,7,0,20,13
1657301923895,ECE 45,A01,083139,Congero; Spencer William,6,0,75,69
1657301929923,ECE 65,A50,083695,Saad; Andrew S,12,0,30,18
1657301929923,ECE 65,A51,095125,Saad; Andrew S,25,0,26,1
1657301935951,ECE 109,A01,091882,Touri; Behrouz,19,0,70,51
1657301941974,ECE 180,A00,083140,Abi Samra; Nicholas Camill,1,0,30,29
1657301941974,ECE 180,B00,083141,Abi Samra; Nicholas Camill,0,0,30,30
1657301947997,MATH 10A,A01,083735,Patchell; Gregory David,2,0,30,28
1657301947997,MATH 10A,A02,083736,Patchell; Gregory David,20,0,30,10
1657301947997,MATH 10A,A03,083737,Patchell; Gregory David,16,0,30,14
1657301954024,MATH 10B,A01,083207,Lim; Seonhee,7,0,34,27
1657301954024,MATH 10B,A02,083208,Lim; Seonhee,9,0,35,26
1657301954024,MATH 10B,A03,093472,Lim; Seonhee,6,0,34,28
1657301954024,MATH 10B,B01,083739,Sinha; Shubham,11,0,30,19
1657301960051,MATH 18,A01,083743,Cinel; Cameron Alexander,6,0,30,24
1657301960051,MATH 18,A02,083744,Cinel; Cameron Alexander,17,0,30,13
1657301960051,MATH 18,A03,083745,Cinel; Cameron Alexander,8,0,30,22
1657301960051,MATH 18,B01,083748,Rideout; David Porter,4,0,37,33
1657301960051,MATH 18,B02,083749,Rideout; David Porter,4,0,36,32
1657301960051,MATH 18,B03,083750,Rideout; David Porter,2,0,37,35
1657301960051,MATH 18,B04,083751,Rideout; David Porter,6,0,36,30
1657301960051,MATH 18,B05,093473,Rideout; David Porter,5,0,36,31
1657301960051,MATH 18,B06,093474,Rideout; David Porter,5,0,36,31
1657301966076,MATH 20A,A01,083754,Zheng; Zequn,14,0,40,26
1657301972099,MATH 20B,A01,083756,Briones; Jor-el Thomas Caparas,3,0,36,33
1657301972099,MATH 20B,A02,083757,Briones; Jor-el Thomas Caparas,1,0,36,35
1657301972099,MATH 20B,A03,093475,Briones; Jor-el Thomas Caparas,2,0,36,34
1657301978125,MATH 20C,A01,083760,Briones; Jor-el Thomas Caparas,1,0,35,34
1657301978125,MATH 20C,A02,083761,Briones; Jor-el Thomas Caparas,8,0,35,27
1657301978125,MATH 20C,A03,093476,Briones; Jor-el Thomas Caparas,0,1,36,36
1657301978125,MATH 20C,B01,083762,Bach; Quang Tran,1,0,30,29
1657301984154,MATH 20D,A01,083765,Tran; Brian Kha,5,0,30,25
1657301984154,MATH 20D,A02,083766,Tran; Brian Kha,5,0,30,25
1657301984154,MATH 20D,A03,083767,Tran; Brian Kha,4,0,30,26
1657301990176,MATH 20E,A01,083771,Ganguly; Soumya,7,0,32,25
1657301990176,MATH 20E,A02,083772,Ganguly; Soumya,6,0,32,26
1657301990176,MATH 20E,B01,083773,Ciotti; Benjamin,19,0,35,16
1657301990176,MATH 20E,B02,083774,Ciotti; Benjamin,17,0,35,18
1657301996206,MATH 103A,A01,083777,Greenfeld; Be'Eri,3,0,36,33
1657301996206,MATH 103A,A02,083778,Greenfeld; Be'Eri,5,0,36,31
1657301996206,MATH 103A,A03,093561,Greenfeld; Be'Eri,4,0,36,32
1657301996206,MATH 103A,B01,083779,Greenfeld; Be'Eri,6,0,36,30
1657301996206,MATH 103A,B02,083780,Greenfeld; Be'Eri,4,0,36,32
1657301996206,MATH 103A,B03,093562,Greenfeld; Be'Eri,3,0,36,33
1657302002230,MATH 105,A01,085443,Carter; Anne Toulson,15,0,35,20
1657302002230,MATH 105,A02,093477,Carter; Anne Toulson,20,0,35,15
1657302008266,MATH 109,A01,083213,Ganzberger; Geoffrey Michael,2,0,34,32
1657302008266,MATH 109,A02,083214,Ganzberger; Geoffrey Michael,4,0,34,30
1657302008266,MATH 109,A03,093478,Ganzberger; Geoffrey Michael,2,0,34,32
1657302008266,MATH 109,B01,083215,Ganzberger; Geoffrey Michael,1,0,32,31
1657302008266,MATH 109,B02,083216,Ganzberger; Geoffrey Michael,1,0,32,31
1657302008266,MATH 109,B03,093479,Ganzberger; Geoffrey Michael,8,0,32,24
1657302014295,MATH 142A,A01,083219,Chow; Bennett,7,0,32,25
1657302014295,MATH 142A,A02,083220,Chow; Bennett,10,0,32,22
1657302014295,MATH 142A,A03,093480,Chow; Bennett,7,0,32,25
1657302014295,MATH 142A,B03,093481,Chow; Bennett,8,0,32,24
1657302014295,MATH 142A,B04,093558,Chow; Bennett,12,0,32,20
1657302014295,MATH 142A,B05,093559,Chow; Bennett,6,0,32,26
1657302020323,MATH 193A,A01,083224,Rotar; Vladimir,7,0,34,27
1657302020323,MATH 193A,A02,083225,Rotar; Vladimir,6,0,34,28
1657302020323,MATH 193A,A03,083781,Rotar; Vladimir,2,0,34,32
1657302020323,MATH 193A,A04,083782,Rotar; Vladimir,8,0,34,26
1657302020323,MATH 193A,A05,093482,Rotar; Vladimir,6,0,34,28
1657302026348,MATH 197,001,091859,McAuley; Julian John,9999,0,9999,0
1657302026348,MATH 197,002,095566,Kedlaya; Kiran S.,9997,0,9999,2
1657302026348,MATH 197,003,095567,Xiao; Ming,9999,0,9999,0
1657302026348,MATH 197,004,095571,Perols; Johan Lars,9998,0,9999,1
1657302033404,COGS 9,A01,083615,Shannon; Kyle Michael,8,0,75,67
1657302039427,COGS 11,A01,083617,Boyle; Mary E. T.,22,0,48,26
1657302045450,COGS 13,A01,083071,Bastos; Amalia Pinkusfeld,10,0,71,61
1657302051477,COGS 14A,A01,092681,Semenuks; Arturs,2,1,100,98
1657302057503,COGS 14B,A01,083073,Cheng; Tzu-Han,6,0,63,57
1657302063542,COGS 17,A01,092677,Semenuks; Arturs,5,0,81,76
1657302069569,COGS 100,A01,083619,Allen; Michael Gordon,16,0,70,54
1657302075596,COGS 101A,A01,083621,Davis; Joshua Daniel,9,0,68,59
1657302081640,COGS 101B,A01,091572,Allen; Michael Gordon,11,0,65,54
1657302087665,COGS 101C,A01,083625,Delgado; Tania,17,0,35,18
1657302093703,COGS 107A,A01,083627,Boyle; Mary E. T.,13,0,60,47
1657302099724,COGS 118A,A01,083075,Gupta; Anjum,18,0,76,58
1657302105756,CSE 3,A50,083646,Miranda; Gregory Joseph,24,0,50,26
1657302111779,CSE 8A,A50,083650,Miranda; Gregory Joseph,17,1,56,39
1657302117803,CSE 11,A01,083080,Cao; Yingjun,5,15,40,35
1657302123830,CSE 12,A01,083652,Krause-Levy; Sophia Louisa,26,1,120,94
1657302129859,CSE 15L,A01,083654,Morris; Justin Loren,9,0,50,41
1657302129859,CSE 15L,A02,083655,Morris; Justin Loren,9,0,50,41
1657302135886,CSE 20,A01,083657,Tran; Khoa Dang,38,0,80,42
1657302141912,CSE 21,A01,095574,Bach; Quang Tran,22,0,48,26
1657302147963,CSE 30,A01,083084,Eldon; John,4,0,80,76
1657302147963,CSE 30,B01,095061,Bhaskar; Nishant,9,0,50,41
1657302154067,CSE 100,A01,083659,Cao; Yingjun,4,4,70,66
1657302160091,CSE 134B,A01,083661,Powell; Thomas Allan,21,0,100,79
1657302166116,CSE 140,A01,083663,Gungor; Onat,13,0,85,72
1657302172142,CSE 140L,A01,083088,Eldon; John,20,0,100,80
1657302178171,CSE 175,A01,083665,Kumar; Rakesh,3,0,25,22
1657302184197,CSE 190,A00,092507,Dubnov; Shlomo,7,0,20,13
1657302190223,ECE 45,A01,083139,Congero; Spencer William,6,0,75,69
1657302196250,ECE 65,A50,083695,Saad; Andrew S,12,0,30,18
1657302196250,ECE 65,A51,095125,Saad; Andrew S,25,0,26,1
1657302202274,ECE 109,A01,091882,Touri; Behrouz,19,0,70,51
1657302208299,ECE 180,A00,083140,Abi Samra; Nicholas Camill,1,0,30,29
1657302208299,ECE 180,B00,083141,Abi Samra; Nicholas Camill,0,0,30,30
1657302214322,MATH 10A,A01,083735,Patchell; Gregory David,2,0,30,28
1657302214322,MATH 10A,A02,083736,Patchell; Gregory David,20,0,30,10
1657302214322,MATH 10A,A03,083737,Patchell; Gregory David,16,0,30,14
1657302220344,MATH 10B,A01,083207,Lim; Seonhee,7,0,34,27
1657302220344,MATH 10B,A02,083208,Lim; Seonhee,9,0,35,26
1657302220344,MATH 10B,A03,093472,Lim; Seonhee,6,0,34,28
1657302220344,MATH 10B,B01,083739,Sinha; Shubham,11,0,30,19
1657302226369,MATH 18,A01,083743,Cinel; Cameron Alexander,6,0,30,24
1657302226369,MATH 18,A02,083744,Cinel; Cameron Alexander,17,0,30,13
1657302226369,MATH 18,A03,083745,Cinel; Cameron Alexander,8,0,30,22
1657302226369,MATH 18,B01,083748,Rideout; David Porter,4,0,37,33
1657302226369,MATH 18,B02,083749,Rideout; David Porter,4,0,36,32
1657302226369,MATH 18,B03,083750,Rideout; David Porter,2,0,37,35
1657302226369,MATH 18,B04,083751,Rideout; David Porter,6,0,36,30
1657302226369,MATH 18,B05,093473,Rideout; David Porter,5,0,36,31
1657302226369,MATH 18,B06,093474,Rideout; David Porter,5,0,36,31
1657302232393,MATH 20A,A01,083754,Zheng; Zequn,14,0,40,26
1657302238419,MATH 20B,A01,083756,Briones; Jor-el Thomas Caparas,3,0,36,33
1657302238419,MATH 20B,A02,083757,Briones; Jor-el Thomas Caparas,1,0,36,35
1657302238419,MATH 20B,A03,093475,Briones; Jor-el Thomas Caparas,2,0,36,34
1657302244448,MATH 20C,A01,083760,Briones; Jor-el Thomas Caparas,1,0,35,34
1657302244448,MATH 20C,A02,083761,Briones; Jor-el Thomas Caparas,8,0,35,27
1657302244448,MATH 20C,A03,093476,Briones; Jor-el Thomas Caparas,0,1,36,36
1657302244448,MATH 20C,B01,083762,Bach; Quang Tran,1,0,30,29
1657302250472,MATH 20D,A01,083765,Tran; Brian Kha,5,0,30,25
1657302250472,MATH 20D,A02,083766,Tran; Brian Kha,5,0,30,25
1657302250472,MATH 20D,A03,083767,Tran; Brian Kha,4,0,30,26
1657302256495,MATH 20E,A01,083771,Ganguly; Soumya,7,0,32,25
1657302256495,MATH 20E,A02,083772,Ganguly; Soumya,6,0,32,26
1657302256495,MATH 20E,B01,083773,Ciotti; Benjamin,19,0,35,16
1657302256495,MATH 20E,B02,083774,Ciotti; Benjamin,17,0,35,18
1657302262516,MATH 103A,A01,083777,Greenfeld; Be'Eri,3,0,36,33
1657302262516,MATH 103A,A02,083778,Greenfeld; Be'Eri,5,0,36,31
1657302262516,MATH 103A,A03,093561,Greenfeld; Be'Eri,4,0,36,32
1657302262516,MATH 103A,B01,083779,Greenfeld; Be'Eri,6,0,36,30
1657302262516,MATH 103A,B02,083780,Greenfeld; Be'Eri,4,0,36,32
1657302262516,MATH 103A,B03,093562,Greenfeld; Be'Eri,3,0,36,33
1657302268539,MATH 105,A01,085443,Carter; Anne Toulson,15,0,35,20
1657302268539,MATH 105,A02,093477,Carter; Anne Toulson,20,0,35,15
1657302274561,MATH 109,A01,083213,Ganzberger; Geoffrey Michael,2,0,34,32
1657302274561,MATH 109,A02,083214,Ganzberger; Geoffrey Michael,4,0,34,30
1657302274561,MATH 109,A03,093478,Ganzberger; Geoffrey Michael,2,0,34,32
1657302274561,MATH 109,B01,083215,Ganzberger; Geoffrey Michael,1,0,32,31
1657302274561,MATH 109,B02,083216,Ganzberger; Geoffrey Michael,1,0,32,31
1657302274561,MATH 109,B03,093479,Ganzberger; Geoffrey Michael,8,0,32,24
1657302280585,MATH 142A,A01,083219,Chow; Bennett,7,0,32,25
1657302280585,MATH 142A,A02,083220,Chow; Bennett,10,0,32,22
1657302280585,MATH 142A,A03,093480,Chow; Bennett,7,0,32,25
1657302280585,MATH 142A,B03,093481,Chow; Bennett,8,0,32,24
1657302280585,MATH 142A,B04,093558,Chow; Bennett,12,0,32,20
1657302280585,MATH 142A,B05,093559,Chow; Bennett,6,0,32,26
1657302286607,MATH 193A,A01,083224,Rotar; Vladimir,7,0,34,27
1657302286607,MATH 193A,A02,083225,Rotar; Vladimir,6,0,34,28
1657302286607,MATH 193A,A03,083781,Rotar; Vladimir,2,0,34,32
1657302286607,MATH 193A,A04,083782,Rotar; Vladimir,8,0,34,26
1657302286607,MATH 193A,A05,093482,Rotar; Vladimir,6,0,34,28
1657302292629,MATH 197,001,091859,McAuley; Julian John,9999,0,9999,0
1657302292629,MATH 197,002,095566,Kedlaya; Kiran S.,9997,0,9999,2
1657302292629,MATH 197,003,095567,Xiao; Ming,9999,0,9999,0
1657302292629,MATH 197,004,095571,Perols; Johan Lars,9998,0,9999,1
1657302299704,COGS 9,A01,083615,Shannon; Kyle Michael,8,0,75,67
1657302305729,COGS 11,A01,083617,Boyle; Mary E. T.,22,0,48,26
1657302311755,COGS 13,A01,083071,Bastos; Amalia Pinkusfeld,10,0,71,61
1657302317778,COGS 14A,A01,092681,Semenuks; Arturs,2,1,100,98
1657302323805,COGS 14B,A01,083073,Cheng; Tzu-Han,6,0,63,57
1657302329829,COGS 17,A01,092677,Semenuks; Arturs,5,0,81,76
1657302335851,COGS 100,A01,083619,Allen; Michael Gordon,16,0,70,54
1657302341879,COGS 101A,A01,083621,Davis; Joshua Daniel,9,0,68,59
1657302347901,COGS 101B,A01,091572,Allen; Michael Gordon,11,0,65,54
1657302353932,COGS 101C,A01,083625,Delgado; Tania,17,0,35,18
1657302359961,COGS 107A,A01,083627,Boyle; Mary E. T.,13,0,60,47
1657302365988,COGS 118A,A01,083075,Gupta; Anjum,18,0,76,58
1657302372010,CSE 3,A50,083646,Miranda; Gregory Joseph,24,0,50,26
1657302378033,CSE 8A,A50,083650,Miranda; Gregory Joseph,17,1,56,39
1657302384061,CSE 11,A01,083080,Cao; Yingjun,5,15,40,35
1657302390089,CSE 12,A01,083652,Krause-Levy; Sophia Louisa,26,1,120,94
1657302396120,CSE 15L,A01,083654,Morris; Justin Loren,9,0,50,41
1657302396120,CSE 15L,A02,083655,Morris; Justin Loren,9,0,50,41
1657302402143,CSE 20,A01,083657,Tran; Khoa Dang,38,0,80,42
1657302408167,CSE 21,A01,095574,Bach; Quang Tran,22,0,48,26
1657302414190,CSE 30,A01,083084,Eldon; John,4,0,80,76
1657302414190,CSE 30,B01,095061,Bhaskar; Nishant,9,0,50,41
1657302420215,CSE 100,A01,083659,Cao; Yingjun,4,4,70,66
1657302426238,CSE 134B,A01,083661,Powell; Thomas Allan,21,0,100,79
1657302432264,CSE 140,A01,083663,Gungor; Onat,13,0,85,72
1657302438292,CSE 140L,A01,083088,Eldon; John,20,0,100,80
1657302444317,CSE 175,A01,083665,Kumar; Rakesh,3,0,25,22
1657302450346,CSE 190,A00,092507,Dubnov; Shlomo,7,0,20,13
1657302456371,ECE 45,A01,083139,Congero; Spencer William,6,0,75,69
1657302462393,ECE 65,A50,083695,Saad; Andrew S,12,0,30,18
1657302462393,ECE 65,A51,095125,Saad; Andrew S,25,0,26,1
1657302468418,ECE 109,A01,091882,Touri; Behrouz,19,0,70,51
1657302474439,ECE 180,A00,083140,Abi Samra; Nicholas Camill,1,0,30,29
1657302474439,ECE 180,B00,083141,Abi Samra; Nicholas Camill,0,0,30,30
1657302480463,MATH 10A,A01,083735,Patchell; Gregory David,2,0,30,28
1657302480463,MATH 10A,A02,083736,Patchell; Gregory David,20,0,30,10
1657302480463,MATH 10A,A03,083737,Patchell; Gregory David,16,0,30,14
1657302486487,MATH 10B,A01,083207,Lim; Seonhee,7,0,34,27
1657302486487,MATH 10B,A02,083208,Lim; Seonhee,9,0,35,26
1657302486487,MATH 10B,A03,093472,Lim; Seonhee,6,0,34,28
1657302486487,MATH 10B,B01,083739,Sinha; Shubham,11,0,30,19
1657302492510,MATH 18,A01,083743,Cinel; Cameron Alexander,6,0,30,24
1657302492510,MATH 18,A02,083744,Cinel; Cameron Alexander,17,0,30,13
1657302492510,MATH 18,A03,083745,Cinel; Cameron Alexander,8,0,30,22
1657302492510,MATH 18,B01,083748,Rideout; David Porter,4,0,37,33
1657302492510,MATH 18,B02,083749,Rideout; David Porter,4,0,36,32
1657302492510,MATH 18,B03,083750,Rideout; David Porter,2,0,37,35
1657302492510,MATH 18,B04,083751,Rideout; David Porter,6,0,36,30
1657302492510,MATH 18,B05,093473,Rideout; David Porter,5,0,36,31
1657302492510,MATH 18,B06,093474,Rideout; David Porter,5,0,36,31
1657302498531,MATH 20A,A01,083754,Zheng; Zequn,14,0,40,26
1657302504558,MATH 20B,A01,083756,Briones; Jor-el Thomas Caparas,3,0,36,33
1657302504558,MATH 20B,A02,083757,Briones; Jor-el Thomas Caparas,1,0,36,35
1657302504558,MATH 20B,A03,093475,Briones; Jor-el Thomas Caparas,2,0,36,34
1657302510581,MATH 20C,A01,083760,Briones; Jor-el Thomas Caparas,1,0,35,34
1657302510581,MATH 20C,A02,083761,Briones; Jor-el Thomas Caparas,8,0,35,27
1657302510581,MATH 20C,A03,093476,Briones; Jor-el Thomas Caparas,0,1,36,36
1657302510581,MATH 20C,B01,083762,Bach; Quang Tran,1,0,30,29
1657302516603,MATH 20D,A01,083765,Tran; Brian Kha,5,0,30,25
1657302516603,MATH 20D,A02,083766,Tran; Brian Kha,5,0,30,25
1657302516603,MATH 20D,A03,083767,Tran; Brian Kha,4,0,30,26
1657302522638,MATH 20E,A01,083771,Ganguly; Soumya,7,0,32,25
1657302522638,MATH 20E,A02,083772,Ganguly; Soumya,6,0,32,26
1657302522638,MATH 20E,B01,083773,Ciotti; Benjamin,19,0,35,16
1657302522638,MATH 20E,B02,083774,Ciotti; Benjamin,17,0,35,18
1657302528667,MATH 103A,A01,083777,Greenfeld; Be'Eri,3,0,36,33
1657302528667,MATH 103A,A02,083778,Greenfeld; Be'Eri,5,0,36,31
1657302528667,MATH 103A,A03,093561,Greenfeld; Be'Eri,4,0,36,32
1657302528667,MATH 103A,B01,083779,Greenfeld; Be'Eri,6,0,36,30
1657302528667,MATH 103A,B02,083780,Greenfeld; Be'Eri,4,0,36,32
1657302528667,MATH 103A,B03,093562,Greenfeld; Be'Eri,3,0,36,33
1657302534692,MATH 105,A01,085443,Carter; Anne Toulson,15,0,35,20
1657302534692,MATH 105,A02,093477,Carter; Anne Toulson,20,0,35,15
1657302540723,MATH 109,A01,083213,Ganzberger; Geoffrey Michael,2,0,34,32
1657302540723,MATH 109,A02,083214,Ganzberger; Geoffrey Michael,4,0,34,30
1657302540723,MATH 109,A03,093478,Ganzberger; Geoffrey Michael,2,0,34,32
1657302540723,MATH 109,B01,083215,Ganzberger; Geoffrey Michael,1,0,32,31
1657302540723,MATH 109,B02,083216,Ganzberger; Geoffrey Michael,1,0,32,31
1657302540723,MATH 109,B03,093479,Ganzberger; Geoffrey Michael,8,0,32,24
1657302546756,MATH 142A,A01,083219,Chow; Bennett,7,0,32,25
1657302546756,MATH 142A,A02,083220,Chow; Bennett,10,0,32,22
1657302546756,MATH 142A,A03,093480,Chow; Bennett,7,0,32,25
1657302546756,MATH 142A,B03,093481,Chow; Bennett,8,0,32,24
1657302546756,MATH 142A,B04,093558,Chow; Bennett,12,0,32,20
1657302546756,MATH 142A,B05,093559,Chow; Bennett,6,0,32,26
1657302552779,MATH 193A,A01,083224,Rotar; Vladimir,7,0,34,27
1657302552779,MATH 193A,A02,083225,Rotar; Vladimir,7,0,34,27
1657302552779,MATH 193A,A03,083781,Rotar; Vladimir,2,0,34,32
1657302552779,MATH 193A,A04,083782,Rotar; Vladimir,8,0,34,26
1657302552779,MATH 193A,A05,093482,Rotar; Vladimir,7,0,34,27
1657302558802,MATH 197,001,091859,McAuley; Julian John,9999,0,9999,0
1657302558802,MATH 197,002,095566,Kedlaya; Kiran S.,9997,0,9999,2
1657302558802,MATH 197,003,095567,Xiao; Ming,9999,0,9999,0
1657302558802,MATH 197,004,095571,Perols; Johan Lars,9998,0,9999,1
1657302565862,COGS 9,A01,083615,Shannon; Kyle Michael,8,0,75,67
1657302571887,COGS 11,A01,083617,Boyle; Mary E. T.,22,0,48,26
1657302577913,COGS 13,A01,083071,Bastos; Amalia Pinkusfeld,10,0,71,61
1657302583939,COGS 14A,A01,092681,Semenuks; Arturs,2,1,100,98
1657302589969,COGS 14B,A01,083073,Cheng; Tzu-Han,6,0,63,57
1657302595992,COGS 17,A01,092677,Semenuks; Arturs,5,0,81,76
1657302602018,COGS 100,A01,083619,Allen; Michael Gordon,16,0,70,54
1657302608044,COGS 101A,A01,083621,Davis; Joshua Daniel,9,0,68,59
1657302614070,COGS 101B,A01,091572,Allen; Michael Gordon,11,0,65,54
1657302620094,COGS 101C,A01,083625,Delgado; Tania,17,0,35,18
1657302626118,COGS 107A,A01,083627,Boyle; Mary E. T.,13,0,60,47
1657302632144,COGS 118A,A01,083075,Gupta; Anjum,18,0,76,58
1657302638167,CSE 3,A50,083646,Miranda; Gregory Joseph,24,0,50,26
1657302644196,CSE 8A,A50,083650,Miranda; Gregory Joseph,17,1,56,39
1657302650218,CSE 11,A01,083080,Cao; Yingjun,5,15,40,35
1657302656242,CSE 12,A01,083652,Krause-Levy; Sophia Louisa,26,1,120,94
1657302662264,CSE 15L,A01,083654,Morris; Justin Loren,9,0,50,41
1657302662264,CSE 15L,A02,083655,Morris; Justin Loren,9,0,50,41
1657302668290,CSE 20,A01,083657,Tran; Khoa Dang,38,0,80,42
1657302674317,CSE 21,A01,095574,Bach; Quang Tran,22,0,48,26
1657302680339,CSE 30,A01,083084,Eldon; John,4,0,80,76
1657302680339,CSE 30,B01,095061,Bhaskar; Nishant,9,0,50,41
1657302686370,CSE 100,A01,083659,Cao; Yingjun,4,4,70,66
1657302692398,CSE 134B,A01,083661,Powell; Thomas Allan,21,0,100,79
1657302698420,CSE 140,A01,083663,Gungor; Onat,13,0,85,72
1657302704446,CSE 140L,A01,083088,Eldon; John,20,0,100,80
1657302710469,CSE 175,A01,083665,Kumar; Rakesh,3,0,25,22
1657302716493,CSE 190,A00,092507,Dubnov; Shlomo,7,0,20,13
1657302722516,ECE 45,A01,083139,Congero; Spencer William,6,0,75,69
1657302728543,ECE 65,A50,083695,Saad; Andrew S,12,0,30,18
1657302728543,ECE 65,A51,095125,Saad; Andrew S,25,0,26,1
1657302734566,ECE 109,A01,091882,Touri; Behrouz,19,0,70,51
1657302740589,ECE 180,A00,083140,Abi Samra; Nicholas Camill,1,0,30,29
1657302740589,ECE 180,B00,083141,Abi Samra; Nicholas Camill,0,0,30,30
1657302746617,MATH 10A,A01,083735,Patchell; Gregory David,2,0,30,28
1657302746617,MATH 10A,A02,083736,Patchell; Gregory David,20,0,30,10
1657302746617,MATH 10A,A03,083737,Patchell; Gregory David,16,0,30,14
1657302752733,MATH 10B,A01,083207,Lim; Seonhee,7,0,34,27
1657302752733,MATH 10B,A02,083208,Lim; Seonhee,9,0,35,26
1657302752733,MATH 10B,A03,093472,Lim; Seonhee,6,0,34,28
1657302752733,MATH 10B,B01,083739,Sinha; Shubham,11,0,30,19
1657302758758,MATH 18,A01,083743,Cinel; Cameron Alexander,6,0,30,24
1657302758758,MATH 18,A02,083744,Cinel; Cameron Alexander,17,0,30,13
1657302758758,MATH 18,A03,083745,Cinel; Cameron Alexander,8,0,30,22
1657302758758,MATH 18,B01,083748,Rideout; David Porter,4,0,37,33
1657302758758,MATH 18,B02,083749,Rideout; David Porter,4,0,36,32
1657302758758,MATH 18,B03,083750,Rideout; David Porter,2,0,37,35
1657302758758,MATH 18,B04,083751,Rideout; David Porter,6,0,36,30
1657302758758,MATH 18,B05,093473,Rideout; David Porter,5,0,36,31
1657302758758,MATH 18,B06,093474,Rideout; David Porter,5,0,36,31
1657302764784,MATH 20A,A01,083754,Zheng; Zequn,14,0,40,26
1657302770807,MATH 20B,A01,083756,Briones; Jor-el Thomas Caparas,3,0,36,33
1657302770807,MATH 20B,A02,083757,Briones; Jor-el Thomas Caparas,1,0,36,35
1657302770807,MATH 20B,A03,093475,Briones; Jor-el Thomas Caparas,2,0,36,34
1657302776847,MATH 20C,A01,083760,Briones; Jor-el Thomas Caparas,1,0,35,34
1657302776847,MATH 20C,A02,083761,Briones; Jor-el Thomas Caparas,8,0,35,27
1657302776847,MATH 20C,A03,093476,Briones; Jor-el Thomas Caparas,0,1,36,36
1657302776847,MATH 20C,B01,083762,Bach; Quang Tran,1,0,30,29
1657302782872,MATH 20D,A01,083765,Tran; Brian Kha,5,0,30,25
1657302782872,MATH 20D,A02,083766,Tran; Brian Kha,5,0,30,25
1657302782872,MATH 20D,A03,083767,Tran; Brian Kha,4,0,30,26
1657302788900,MATH 20E,A01,083771,Ganguly; Soumya,7,0,32,25
1657302788900,MATH 20E,A02,083772,Ganguly; Soumya,6,0,32,26
1657302788900,MATH 20E,B01,083773,Ciotti; Benjamin,19,0,35,16
1657302788900,MATH 20E,B02,083774,Ciotti; Benjamin,17,0,35,18
1657302794926,MATH 103A,A01,083777,Greenfeld; Be'Eri,3,0,36,33
1657302794926,MATH 103A,A02,083778,Greenfeld; Be'Eri,5,0,36,31
1657302794926,MATH 103A,A03,093561,Greenfeld; Be'Eri,4,0,36,32
1657302794926,MATH 103A,B01,083779,Greenfeld; Be'Eri,6,0,36,30
1657302794926,MATH 103A,B02,083780,Greenfeld; Be'Eri,4,0,36,32
1657302794926,MATH 103A,B03,093562,Greenfeld; Be'Eri,3,0,36,33
1657302800949,MATH 105,A01,085443,Carter; Anne Toulson,15,0,35,20
1657302800949,MATH 105,A02,093477,Carter; Anne Toulson,20,0,35,15
1657302806978,MATH 109,A01,083213,Ganzberger; Geoffrey Michael,2,0,34,32
1657302806978,MATH 109,A02,083214,Ganzberger; Geoffrey Michael,4,0,34,30
1657302806978,MATH 109,A03,093478,Ganzberger; Geoffrey Michael,2,0,34,32
1657302806978,MATH 109,B01,083215,Ganzberger; Geoffrey Michael,1,0,32,31
1657302806978,MATH 109,B02,083216,Ganzberger; Geoffrey Michael,1,0,32,31
1657302806978,MATH 109,B03,093479,Ganzberger; Geoffrey Michael,8,0,32,24
1657302813001,MATH 142A,A01,083219,Chow; Bennett,7,0,32,25
1657302813001,MATH 142A,A02,083220,Chow; Bennett,10,0,32,22
1657302813001,MATH 142A,A03,093480,Chow; Bennett,7,0,32,25
1657302813001,MATH 142A,B03,093481,Chow; Bennett,8,0,32,24
1657302813001,MATH 142A,B04,093558,Chow; Bennett,12,0,32,20
1657302813001,MATH 142A,B05,093559,Chow; Bennett,6,0,32,26
1657302819024,MATH 193A,A01,083224,Rotar; Vladimir,7,0,34,27
1657302819024,MATH 193A,A02,083225,Rotar; Vladimir,7,0,34,27
1657302819024,MATH 193A,A03,083781,Rotar; Vladimir,2,0,34,32
1657302819024,MATH 193A,A04,083782,Rotar; Vladimir,8,0,34,26
1657302819024,MATH 193A,A05,093482,Rotar; Vladimir,7,0,34,27
1657302825056,MATH 197,001,091859,McAuley; Julian John,9999,0,9999,0
1657302825056,MATH 197,002,095566,Kedlaya; Kiran S.,9997,0,9999,2
1657302825056,MATH 197,003,095567,Xiao; Ming,9999,0,9999,0
1657302825056,MATH 197,004,095571,Perols; Johan Lars,9998,0,9999,1
1657302832121,COGS 9,A01,083615,Shannon; Kyle Michael,8,0,75,67
1657302838143,COGS 11,A01,083617,Boyle; Mary E. T.,22,0,48,26
1657302844167,COGS 13,A01,083071,Bastos; Amalia Pinkusfeld,10,0,71,61
1657302850193,COGS 14A,A01,092681,Semenuks; Arturs,2,1,100,98
1657302856221,COGS 14B,A01,083073,Cheng; Tzu-Han,6,0,63,57
1657302862248,COGS 17,A01,092677,Semenuks; Arturs,5,0,81,76
1657302868270,COGS 100,A01,083619,Allen; Michael Gordon,16,0,70,54
1657302874302,COGS 101A,A01,083621,Davis; Joshua Daniel,9,0,68,59
1657302880329,COGS 101B,A01,091572,Allen; Michael Gordon,11,0,65,54
1657302886356,COGS 101C,A01,083625,Delgado; Tania,17,0,35,18
1657302892379,COGS 107A,A01,083627,Boyle; Mary E. T.,13,0,60,47
1657302898401,COGS 118A,A01,083075,Gupta; Anjum,18,0,76,58
1657302904440,CSE 3,A50,083646,Miranda; Gregory Joseph,24,0,50,26
1657302910463,CSE 8A,A50,083650,Miranda; Gregory Joseph,17,1,56,39
1657302916489,CSE 11,A01,083080,Cao; Yingjun,5,15,40,35
1657302922511,CSE 12,A01,083652,Krause-Levy; Sophia Louisa,26,1,120,94
1657302928533,CSE 15L,A01,083654,Morris; Justin Loren,9,0,50,41
1657302928533,CSE 15L,A02,083655,Morris; Justin Loren,9,0,50,41
1657302934555,CSE 20,A01,083657,Tran; Khoa Dang,38,0,80,42
1657302940582,CSE 21,A01,095574,Bach; Quang Tran,22,0,48,26
1657302946612,CSE 30,A01,083084,Eldon; John,4,0,80,76
1657302946612,CSE 30,B01,095061,Bhaskar; Nishant,9,0,50,41
1657302952639,CSE 100,A01,083659,Cao; Yingjun,4,4,70,66
1657302958664,CSE 134B,A01,083661,Powell; Thomas Allan,21,0,100,79
1657302964691,CSE 140,A01,083663,Gungor; Onat,13,0,85,72
1657302970713,CSE 140L,A01,083088,Eldon; John,20,0,100,80
1657302976741,CSE 175,A01,083665,Kumar; Rakesh,3,0,25,22
1657302982763,CSE 190,A00,092507,Dubnov; Shlomo,7,0,20,13
1657302988795,ECE 45,A01,083139,Congero; Spencer William,6,0,75,69
1657302994818,ECE 65,A50,083695,Saad; Andrew S,12,0,30,18
1657302994818,ECE 65,A51,095125,Saad; Andrew S,25,0,26,1
1657303000845,ECE 109,A01,091882,Touri; Behrouz,19,0,70,51
1657303006868,ECE 180,A00,083140,Abi Samra; Nicholas Camill,1,0,30,29
1657303006868,ECE 180,B00,083141,Abi Samra; Nicholas Camill,0,0,30,30
1657303012894,MATH 10A,A01,083735,Patchell; Gregory David,2,0,30,28
1657303012894,MATH 10A,A02,083736,Patchell; Gregory David,20,0,30,10
1657303012894,MATH 10A,A03,083737,Patchell; Gregory David,16,0,30,14
1657303018918,MATH 10B,A01,083207,Lim; Seonhee,7,0,34,27
1657303018918,MATH 10B,A02,083208,Lim; Seonhee,9,0,35,26
1657303018918,MATH 10B,A03,093472,Lim; Seonhee,6,0,34,28
1657303018918,MATH 10B,B01,083739,Sinha; Shubham,11,0,30,19
1657303024943,MATH 18,A01,083743,Cinel; Cameron Alexander,6,0,30,24
1657303024943,MATH 18,A02,083744,Cinel; Cameron Alexander,17,0,30,13
1657303024943,MATH 18,A03,083745,Cinel; Cameron Alexander,8,0,30,22
1657303024943,MATH 18,B01,083748,Rideout; David Porter,4,0,37,33
1657303024943,MATH 18,B02,083749,Rideout; David Porter,4,0,36,32
1657303024943,MATH 18,B03,083750,Rideout; David Porter,2,0,37,35
1657303024943,MATH 18,B04,083751,Rideout; David Porter,6,0,36,30
1657303024943,MATH 18,B05,093473,Rideout; David Porter,5,0,36,31
1657303024943,MATH 18,B06,093474,Rideout; David Porter,5,0,36,31
1657303030966,MATH 20A,A01,083754,Zheng; Zequn,14,0,40,26
1657303036989,MATH 20B,A01,083756,Briones; Jor-el Thomas Caparas,3,0,36,33
1657303036989,MATH 20B,A02,083757,Briones; Jor-el Thomas Caparas,1,0,36,35
1657303036989,MATH 20B,A03,093475,Briones; Jor-el Thomas Caparas,2,0,36,34
1657303043016,MATH 20C,A01,083760,Briones; Jor-el Thomas Caparas,1,0,35,34
1657303043016,MATH 20C,A02,083761,Briones; Jor-el Thomas Caparas,8,0,35,27
1657303043016,MATH 20C,A03,093476,Briones; Jor-el Thomas Caparas,0,1,36,36
1657303043016,MATH 20C,B01,083762,Bach; Quang Tran,1,0,30,29
1657303049046,MATH 20D,A01,083765,Tran; Brian Kha,5,0,30,25
1657303049046,MATH 20D,A02,083766,Tran; Brian Kha,5,0,30,25
1657303049046,MATH 20D,A03,083767,Tran; Brian Kha,4,0,30,26
1657303055081,MATH 20E,A01,083771,Ganguly; Soumya,7,0,32,25
1657303055081,MATH 20E,A02,083772,Ganguly; Soumya,6,0,32,26
1657303055081,MATH 20E,B01,083773,Ciotti; Benjamin,19,0,35,16
1657303055081,MATH 20E,B02,083774,Ciotti; Benjamin,17,0,35,18
1657303061106,MATH 103A,A01,083777,Greenfeld; Be'Eri,3,0,36,33
1657303061106,MATH 103A,A02,083778,Greenfeld; Be'Eri,5,0,36,31
1657303061106,MATH 103A,A03,093561,Greenfeld; Be'Eri,4,0,36,32
1657303061106,MATH 103A,B01,083779,Greenfeld; Be'Eri,6,0,36,30
1657303061106,MATH 103A,B02,083780,Greenfeld; Be'Eri,4,0,36,32
1657303061106,MATH 103A,B03,093562,Greenfeld; Be'Eri,3,0,36,33
1657303067130,MATH 105,A01,085443,Carter; Anne Toulson,15,0,35,20
1657303067130,MATH 105,A02,093477,Carter; Anne Toulson,20,0,35,15
1657303073161,MATH 109,A01,083213,Ganzberger; Geoffrey Michael,2,0,34,32
1657303073161,MATH 109,A02,083214,Ganzberger; Geoffrey Michael,4,0,34,30
1657303073161,MATH 109,A03,093478,Ganzberger; Geoffrey Michael,2,0,34,32
1657303073161,MATH 109,B01,083215,Ganzberger; Geoffrey Michael,1,0,32,31
1657303073161,MATH 109,B02,083216,Ganzberger; Geoffrey Michael,1,0,32,31
1657303073161,MATH 109,B03,093479,Ganzberger; Geoffrey Michael,8,0,32,24
1657303079192,MATH 142A,A01,083219,Chow; Bennett,7,0,32,25
1657303079192,MATH 142A,A02,083220,Chow; Bennett,10,0,32,22
1657303079192,MATH 142A,A03,093480,Chow; Bennett,7,0,32,25
1657303079192,MATH 142A,B03,093481,Chow; Bennett,8,0,32,24
1657303079192,MATH 142A,B04,093558,Chow; Bennett,12,0,32,20
1657303079192,MATH 142A,B05,093559,Chow; Bennett,6,0,32,26
1657303085215,MATH 193A,A01,083224,Rotar; Vladimir,7,0,34,27
1657303085215,MATH 193A,A02,083225,Rotar; Vladimir,7,0,34,27
1657303085215,MATH 193A,A03,083781,Rotar; Vladimir,2,0,34,32
1657303085215,MATH 193A,A04,083782,Rotar; Vladimir,8,0,34,26
1657303085215,MATH 193A,A05,093482,Rotar; Vladimir,7,0,34,27
1657303091241,MATH 197,001,091859,McAuley; Julian John,9999,0,9999,0
1657303091241,MATH 197,002,095566,Kedlaya; Kiran S.,9997,0,9999,2
1657303091241,MATH 197,003,095567,Xiao; Ming,9999,0,9999,0
1657303091241,MATH 197,004,095571,Perols; Johan Lars,9998,0,9999,1
1657303098304,COGS 9,A01,083615,Shannon; Kyle Michael,8,0,75,67
1657303104332,COGS 11,A01,083617,Boyle; Mary E. T.,22,0,48,26
1657303110356,COGS 13,A01,083071,Bastos; Amalia Pinkusfeld,10,0,71,61
1657303116379,COGS 14A,A01,092681,Semenuks; Arturs,2,1,100,98
1657303122402,COGS 14B,A01,083073,Cheng; Tzu-Han,6,0,63,57
1657303128450,COGS 17,A01,092677,Semenuks; Arturs,5,0,81,76
1657303134472,COGS 100,A01,083619,Allen; Michael Gordon,16,0,70,54
1657303140495,COGS 101A,A01,083621,Davis; Joshua Daniel,9,0,68,59
1657303146518,COGS 101B,A01,091572,Allen; Michael Gordon,11,0,65,54
1657303152545,COGS 101C,A01,083625,Delgado; Tania,17,0,35,18
1657303158576,COGS 107A,A01,083627,Boyle; Mary E. T.,13,0,60,47
1657303164605,COGS 118A,A01,083075,Gupta; Anjum,18,0,76,58
1657303170629,CSE 3,A50,083646,Miranda; Gregory Joseph,24,0,50,26
1657303176653,CSE 8A,A50,083650,Miranda; Gregory Joseph,17,1,56,39
1657303182674,CSE 11,A01,083080,Cao; Yingjun,5,15,40,35
1657303188698,CSE 12,A01,083652,Krause-Levy; Sophia Louisa,26,1,120,94
1657303194721,CSE 15L,A01,083654,Morris; Justin Loren,9,0,50,41
1657303194721,CSE 15L,A02,083655,Morris; Justin Loren,9,0,50,41
1657303200761,CSE 20,A01,083657,Tran; Khoa Dang,38,0,80,42
1657303206783,CSE 21,A01,095574,Bach; Quang Tran,22,0,48,26
1657303212806,CSE 30,A01,083084,Eldon; John,4,0,80,76
1657303212806,CSE 30,B01,095061,Bhaskar; Nishant,9,0,50,41
1657303218832,CSE 100,A01,083659,Cao; Yingjun,4,4,70,66
1657303224861,CSE 134B,A01,083661,Powell; Thomas Allan,21,0,100,79
1657303230883,CSE 140,A01,083663,Gungor; Onat,13,0,85,72
1657303236915,CSE 140L,A01,083088,Eldon; John,20,0,100,80
1657303242945,CSE 175,A01,083665,Kumar; Rakesh,3,0,25,22
1657303248971,CSE 190,A00,092507,Dubnov; Shlomo,7,0,20,13
1657303254994,ECE 45,A01,083139,Congero; Spencer William,6,0,75,69
1657303261017,ECE 65,A50,083695,Saad; Andrew S,12,0,30,18
1657303261017,ECE 65,A51,095125,Saad; Andrew S,25,0,26,1
1657303267053,ECE 109,A01,091882,Touri; Behrouz,19,0,70,51
1657303273074,ECE 180,A00,083140,Abi Samra; Nicholas Camill,1,0,30,29
1657303273074,ECE 180,B00,083141,Abi Samra; Nicholas Camill,0,0,30,30
1657303279101,MATH 10A,A01,083735,Patchell; Gregory David,2,0,30,28
1657303279101,MATH 10A,A02,083736,Patchell; Gregory David,20,0,30,10
1657303279101,MATH 10A,A03,083737,Patchell; Gregory David,16,0,30,14
1657303285143,MATH 10B,A01,083207,Lim; Seonhee,7,0,34,27
1657303285143,MATH 10B,A02,083208,Lim; Seonhee,9,0,35,26
1657303285143,MATH 10B,A03,093472,Lim; Seonhee,6,0,34,28
1657303285143,MATH 10B,B01,083739,Sinha; Shubham,11,0,30,19
1657303291174,MATH 18,A01,083743,Cinel; Cameron Alexander,6,0,30,24
1657303291174,MATH 18,A02,083744,Cinel; Cameron Alexander,17,0,30,13
1657303291174,MATH 18,A03,083745,Cinel; Cameron Alexander,8,0,30,22
1657303291174,MATH 18,B01,083748,Rideout; David Porter,4,0,37,33
1657303291174,MATH 18,B02,083749,Rideout; David Porter,4,0,36,32
1657303291174,MATH 18,B03,083750,Rideout; David Porter,2,0,37,35
1657303291174,MATH 18,B04,083751,Rideout; David Porter,6,0,36,30
1657303291174,MATH 18,B05,093473,Rideout; David Porter,5,0,36,31
1657303291174,MATH 18,B06,093474,Rideout; David Porter,5,0,36,31
1657303297195,MATH 20A,A01,083754,Zheng; Zequn,14,0,40,26
1657303303218,MATH 20B,A01,083756,Briones; Jor-el Thomas Caparas,3,0,36,33
1657303303218,MATH 20B,A02,083757,Briones; Jor-el Thomas Caparas,1,0,36,35
1657303303218,MATH 20B,A03,093475,Briones; Jor-el Thomas Caparas,2,0,36,34
1657303309241,MATH 20C,A01,083760,Briones; Jor-el Thomas Caparas,1,0,35,34
1657303309241,MATH 20C,A02,083761,Briones; Jor-el Thomas Caparas,8,0,35,27
1657303309241,MATH 20C,A03,093476,Briones; Jor-el Thomas Caparas,0,1,36,36
1657303309241,MATH 20C,B01,083762,Bach; Quang Tran,1,0,30,29
1657303315271,MATH 20D,A01,083765,Tran; Brian Kha,5,0,30,25
1657303315271,MATH 20D,A02,083766,Tran; Brian Kha,5,0,30,25
1657303315271,MATH 20D,A03,083767,Tran; Brian Kha,4,0,30,26
1657303321299,MATH 20E,A01,083771,Ganguly; Soumya,7,0,32,25
1657303321299,MATH 20E,A02,083772,Ganguly; Soumya,6,0,32,26
1657303321299,MATH 20E,B01,083773,Ciotti; Benjamin,19,0,35,16
1657303321299,MATH 20E,B02,083774,Ciotti; Benjamin,17,0,35,18
1657303327336,MATH 103A,A01,083777,Greenfeld; Be'Eri,3,0,36,33
1657303327336,MATH 103A,A02,083778,Greenfeld; Be'Eri,5,0,36,31
1657303327336,MATH 103A,A03,093561,Greenfeld; Be'Eri,4,0,36,32
1657303327336,MATH 103A,B01,083779,Greenfeld; Be'Eri,6,0,36,30
1657303327336,MATH 103A,B02,083780,Greenfeld; Be'Eri,4,0,36,32
1657303327336,MATH 103A,B03,093562,Greenfeld; Be'Eri,3,0,36,33
1657303333365,MATH 105,A01,085443,Carter; Anne Toulson,15,0,35,20
1657303333365,MATH 105,A02,093477,Carter; Anne Toulson,20,0,35,15
1657303339391,MATH 109,A01,083213,Ganzberger; Geoffrey Michael,2,0,34,32
1657303339391,MATH 109,A02,083214,Ganzberger; Geoffrey Michael,4,0,34,30
1657303339391,MATH 109,A03,093478,Ganzberger; Geoffrey Michael,2,0,34,32
1657303339391,MATH 109,B01,083215,Ganzberger; Geoffrey Michael,1,0,32,31
1657303339391,MATH 109,B02,083216,Ganzberger; Geoffrey Michael,1,0,32,31
1657303339391,MATH 109,B03,093479,Ganzberger; Geoffrey Michael,8,0,32,24
1657303345415,MATH 142A,A01,083219,Chow; Bennett,7,0,32,25
1657303345415,MATH 142A,A02,083220,Chow; Bennett,10,0,32,22
1657303345415,MATH 142A,A03,093480,Chow; Bennett,7,0,32,25
1657303345415,MATH 142A,B03,093481,Chow; Bennett,8,0,32,24
1657303345415,MATH 142A,B04,093558,Chow; Bennett,12,0,32,20
1657303345415,MATH 142A,B05,093559,Chow; Bennett,6,0,32,26
1657303351536,MATH 193A,A01,083224,Rotar; Vladimir,7,0,34,27
1657303351536,MATH 193A,A02,083225,Rotar; Vladimir,7,0,34,27
1657303351536,MATH 193A,A03,083781,Rotar; Vladimir,2,0,34,32
1657303351536,MATH 193A,A04,083782,Rotar; Vladimir,8,0,34,26
1657303351536,MATH 193A,A05,093482,Rotar; Vladimir,7,0,34,27
1657303357557,MATH 197,001,091859,McAuley; Julian John,9999,0,9999,0
1657303357557,MATH 197,002,095566,Kedlaya; Kiran S.,9997,0,9999,2
1657303357557,MATH 197,003,095567,Xiao; Ming,9999,0,9999,0
1657303357557,MATH 197,004,095571,Perols; Johan Lars,9998,0,9999,1
1657303364618,COGS 9,A01,083615,Shannon; Kyle Michael,8,0,75,67
1657303370640,COGS 11,A01,083617,Boyle; Mary E. T.,22,0,48,26
1657303376663,COGS 13,A01,083071,Bastos; Amalia Pinkusfeld,10,0,71,61
1657303382686,COGS 14A,A01,092681,Semenuks; Arturs,2,1,100,98
1657303388714,COGS 14B,A01,083073,Cheng; Tzu-Han,6,0,63,57
1657303394739,COGS 17,A01,092677,Semenuks; Arturs,5,0,81,76
1657303400764,COGS 100,A01,083619,Allen; Michael Gordon,16,0,70,54
1657303406792,COGS 101A,A01,083621,Davis; Joshua Daniel,9,0,68,59
1657303412814,COGS 101B,A01,091572,Allen; Michael Gordon,11,0,65,54
1657303418838,COGS 101C,A01,083625,Delgado; Tania,17,0,35,18
1657303424860,COGS 107A,A01,083627,Boyle; Mary E. T.,13,0,60,47
1657303430882,COGS 118A,A01,083075,Gupta; Anjum,18,0,76,58
1657303436908,CSE 3,A50,083646,Miranda; Gregory Joseph,24,0,50,26
1657303442937,CSE 8A,A50,083650,Miranda; Gregory Joseph,17,1,56,39
1657303448972,CSE 11,A01,083080,Cao; Yingjun,5,15,40,35
1657303455006,CSE 12,A01,083652,Krause-Levy; Sophia Louisa,26,1,120,94
1657303461034,CSE 15L,A01,083654,Morris; Justin Loren,9,0,50,41
1657303461034,CSE 15L,A02,083655,Morris; Justin Loren,9,0,50,41
1657303467055,CSE 20,A01,083657,Tran; Khoa Dang,38,0,80,42
1657303473081,CSE 21,A01,095574,Bach; Quang Tran,22,0,48,26
1657303479104,CSE 30,A01,083084,Eldon; John,4,0,80,76
1657303479104,CSE 30,B01,095061,Bhaskar; Nishant,9,0,50,41
1657303485137,CSE 100,A01,083659,Cao; Yingjun,4,4,70,66
1657303491166,CSE 134B,A01,083661,Powell; Thomas Allan,21,0,100,79
1657303497190,CSE 140,A01,083663,Gungor; Onat,13,0,85,72
1657303503216,CSE 140L,A01,083088,Eldon; John,20,0,100,80
1657303509237,CSE 175,A01,083665,Kumar; Rakesh,3,0,25,22
1657303515260,CSE 190,A00,092507,Dubnov; Shlomo,7,0,20,13
1657303521283,ECE 45,A01,083139,Congero; Spencer William,6,0,75,69
1657303527305,ECE 65,A50,083695,Saad; Andrew S,12,0,30,18
1657303527305,ECE 65,A51,095125,Saad; Andrew S,25,0,26,1
1657303533330,ECE 109,A01,091882,Touri; Behrouz,19,0,70,51
1657303539354,ECE 180,A00,083140,Abi Samra; Nicholas Camill,1,0,30,29
1657303539354,ECE 180,B00,083141,Abi Samra; Nicholas Camill,0,0,30,30
1657303545376,MATH 10A,A01,083735,Patchell; Gregory David,2,0,30,28
1657303545376,MATH 10A,A02,083736,Patchell; Gregory David,20,0,30,10
1657303545376,MATH 10A,A03,083737,Patchell; Gregory David,16,0,30,14
1657303551413,MATH 10B,A01,083207,Lim; Seonhee,7,0,34,27
1657303551413,MATH 10B,A02,083208,Lim; Seonhee,9,0,35,26
1657303551413,MATH 10B,A03,093472,Lim; Seonhee,7,0,34,27
1657303551413,MATH 10B,B01,083739,Sinha; Shubham,11,0,30,19
1657303557436,MATH 18,A01,083743,Cinel; Cameron Alexander,6,0,30,24
1657303557436,MATH 18,A02,083744,Cinel; Cameron Alexander,17,0,30,13
1657303557436,MATH 18,A03,083745,Cinel; Cameron Alexander,8,0,30,22
1657303557436,MATH 18,B01,083748,Rideout; David Porter,4,0,37,33
1657303557436,MATH 18,B02,083749,Rideout; David Porter,4,0,36,32
1657303557436,MATH 18,B03,083750,Rideout; David Porter,2,0,37,35
1657303557436,MATH 18,B04,083751,Rideout; David Porter,6,0,36,30
1657303557436,MATH 18,B05,093473,Rideout; David Porter,5,0,36,31
1657303557436,MATH 18,B06,093474,Rideout; David Porter,5,0,36,31
1657303563462,MATH 20A,A01,083754,Zheng; Zequn,14,0,40,26
1657303569485,MATH 20B,A01,083756,Briones; Jor-el Thomas Caparas,3,0,36,33
1657303569485,MATH 20B,A02,083757,Briones; Jor-el Thomas Caparas,1,0,36,35
1657303569485,MATH 20B,A03,093475,Briones; Jor-el Thomas Caparas,2,0,36,34
1657303575510,MATH 20C,A01,083760,Briones; Jor-el Thomas Caparas,1,0,35,34
1657303575510,MATH 20C,A02,083761,Briones; Jor-el Thomas Caparas,8,0,35,27
1657303575510,MATH 20C,A03,093476,Briones; Jor-el Thomas Caparas,0,1,36,36
1657303575510,MATH 20C,B01,083762,Bach; Quang Tran,1,0,30,29
1657303581544,MATH 20D,A01,083765,Tran; Brian Kha,5,0,30,25
1657303581544,MATH 20D,A02,083766,Tran; Brian Kha,5,0,30,25
1657303581544,MATH 20D,A03,083767,Tran; Brian Kha,4,0,30,26
1657303587586,MATH 20E,A01,083771,Ganguly; Soumya,7,0,32,25
1657303587586,MATH 20E,A02,083772,Ganguly; Soumya,6,0,32,26
1657303587586,MATH 20E,B01,083773,Ciotti; Benjamin,19,0,35,16
1657303587586,MATH 20E,B02,083774,Ciotti; Benjamin,17,0,35,18
1657303593630,MATH 103A,A01,083777,Greenfeld; Be'Eri,3,0,36,33
1657303593630,MATH 103A,A02,083778,Greenfeld; Be'Eri,5,0,36,31
1657303593630,MATH 103A,A03,093561,Greenfeld; Be'Eri,4,0,36,32
1657303593630,MATH 103A,B01,083779,Greenfeld; Be'Eri,6,0,36,30
1657303593630,MATH 103A,B02,083780,Greenfeld; Be'Eri,4,0,36,32
1657303593630,MATH 103A,B03,093562,Greenfeld; Be'Eri,3,0,36,33
1657303599662,MATH 105,A01,085443,Carter; Anne Toulson,15,0,35,20
1657303599662,MATH 105,A02,093477,Carter; Anne Toulson,20,0,35,15
1657303605693,MATH 109,A01,083213,Ganzberger; Geoffrey Michael,2,0,34,32
1657303605693,MATH 109,A02,083214,Ganzberger; Geoffrey Michael,4,0,34,30
1657303605693,MATH 109,A03,093478,Ganzberger; Geoffrey Michael,2,0,34,32
1657303605693,MATH 109,B01,083215,Ganzberger; Geoffrey Michael,1,0,32,31
1657303605693,MATH 109,B02,083216,Ganzberger; Geoffrey Michael,1,0,32,31
1657303605693,MATH 109,B03,093479,Ganzberger; Geoffrey Michael,8,0,32,24
1657303611720,MATH 142A,A01,083219,Chow; Bennett,7,0,32,25
1657303611720,MATH 142A,A02,083220,Chow; Bennett,10,0,32,22
1657303611720,MATH 142A,A03,093480,Chow; Bennett,7,0,32,25
1657303611720,MATH 142A,B03,093481,Chow; Bennett,8,0,32,24
1657303611720,MATH 142A,B04,093558,Chow; Bennett,12,0,32,20
1657303611720,MATH 142A,B05,093559,Chow; Bennett,6,0,32,26
1657303617743,MATH 193A,A01,083224,Rotar; Vladimir,7,0,34,27
1657303617743,MATH 193A,A02,083225,Rotar; Vladimir,7,0,34,27
1657303617743,MATH 193A,A03,083781,Rotar; Vladimir,3,0,34,31
1657303617743,MATH 193A,A04,083782,Rotar; Vladimir,8,0,34,26
1657303617743,MATH 193A,A05,093482,Rotar; Vladimir,7,0,34,27
1657303623769,MATH 197,001,091859,McAuley; Julian John,9999,0,9999,0
1657303623769,MATH 197,002,095566,Kedlaya; Kiran S.,9997,0,9999,2
1657303623769,MATH 197,003,095567,Xiao; Ming,9999,0,9999,0
1657303623769,MATH 197,004,095571,Perols; Johan Lars,9998,0,9999,1
1657303630822,COGS 9,A01,083615,Shannon; Kyle Michael,8,0,75,67
1657303636846,COGS 11,A01,083617,Boyle; Mary E. T.,22,0,48,26
1657303642868,COGS 13,A01,083071,Bastos; Amalia Pinkusfeld,10,0,71,61
1657303648895,COGS 14A,A01,092681,Semenuks; Arturs,2,1,100,98
1657303654928,COGS 14B,A01,083073,Cheng; Tzu-Han,6,0,63,57
1657303660966,COGS 17,A01,092677,Semenuks; Arturs,5,0,81,76
1657303666993,COGS 100,A01,083619,Allen; Michael Gordon,16,0,70,54
1657303673015,COGS 101A,A01,083621,Davis; Joshua Daniel,9,0,68,59
1657303679042,COGS 101B,A01,091572,Allen; Michael Gordon,11,0,65,54
1657303685065,COGS 101C,A01,083625,Delgado; Tania,17,0,35,18
1657303691091,COGS 107A,A01,083627,Boyle; Mary E. T.,13,0,60,47
1657303697114,COGS 118A,A01,083075,Gupta; Anjum,18,0,76,58
1657303703136,CSE 3,A50,083646,Miranda; Gregory Joseph,24,0,50,26
1657303709160,CSE 8A,A50,083650,Miranda; Gregory Joseph,17,1,56,39
1657303715183,CSE 11,A01,083080,Cao; Yingjun,5,15,40,35
1657303721210,CSE 12,A01,083652,Krause-Levy; Sophia Louisa,26,1,120,94
1657303727236,CSE 15L,A01,083654,Morris; Justin Loren,9,0,50,41
1657303727236,CSE 15L,A02,083655,Morris; Justin Loren,9,0,50,41
1657303733259,CSE 20,A01,083657,Tran; Khoa Dang,38,0,80,42
1657303739285,CSE 21,A01,095574,Bach; Quang Tran,22,0,48,26
1657303745310,CSE 30,A01,083084,Eldon; John,4,0,80,76
1657303745310,CSE 30,B01,095061,Bhaskar; Nishant,9,0,50,41
1657303751336,CSE 100,A01,083659,Cao; Yingjun,4,4,70,66
1657303757362,CSE 134B,A01,083661,Powell; Thomas Allan,21,0,100,79
1657303763386,CSE 140,A01,083663,Gungor; Onat,13,0,85,72
1657303769408,CSE 140L,A01,083088,Eldon; John,20,0,100,80
1657303775431,CSE 175,A01,083665,Kumar; Rakesh,3,0,25,22
1657303781467,CSE 190,A00,092507,Dubnov; Shlomo,7,0,20,13
1657303787493,ECE 45,A01,083139,Congero; Spencer William,6,0,75,69
1657303793516,ECE 65,A50,083695,Saad; Andrew S,12,0,30,18
1657303793516,ECE 65,A51,095125,Saad; Andrew S,25,0,26,1
1657303799539,ECE 109,A01,091882,Touri; Behrouz,19,0,70,51
1657303805562,ECE 180,A00,083140,Abi Samra; Nicholas Camill,1,0,30,29
1657303805562,ECE 180,B00,083141,Abi Samra; Nicholas Camill,0,0,30,30
1657303811589,MATH 10A,A01,083735,Patchell; Gregory David,2,0,30,28
1657303811589,MATH 10A,A02,083736,Patchell; Gregory David,20,0,30,10
1657303811589,MATH 10A,A03,083737,Patchell; Gregory David,16,0,30,14
1657303817613,MATH 10B,A01,083207,Lim; Seonhee,7,0,34,27
1657303817613,MATH 10B,A02,083208,Lim; Seonhee,9,0,35,26
1657303817613,MATH 10B,A03,093472,Lim; Seonhee,7,0,34,27
1657303817613,MATH 10B,B01,083739,Sinha; Shubham,11,0,30,19
1657303823639,MATH 18,A01,083743,Cinel; Cameron Alexander,6,0,30,24
1657303823639,MATH 18,A02,083744,Cinel; Cameron Alexander,17,0,30,13
1657303823639,MATH 18,A03,083745,Cinel; Cameron Alexander,8,0,30,22
1657303823639,MATH 18,B01,083748,Rideout; David Porter,4,0,37,33
1657303823639,MATH 18,B02,083749,Rideout; David Porter,4,0,36,32
1657303823639,MATH 18,B03,083750,Rideout; David Porter,2,0,37,35
1657303823639,MATH 18,B04,083751,Rideout; David Porter,6,0,36,30
1657303823639,MATH 18,B05,093473,Rideout; David Porter,5,0,36,31
1657303823639,MATH 18,B06,093474,Rideout; David Porter,5,0,36,31
1657303829667,MATH 20A,A01,083754,Zheng; Zequn,14,0,40,26
1657303835690,MATH 20B,A01,083756,Briones; Jor-el Thomas Caparas,3,0,36,33
1657303835690,MATH 20B,A02,083757,Briones; Jor-el Thomas Caparas,1,0,36,35
1657303835690,MATH 20B,A03,093475,Briones; Jor-el Thomas Caparas,2,0,36,34
1657303841713,MATH 20C,A01,083760,Briones; Jor-el Thomas Caparas,1,0,35,34
1657303841713,MATH 20C,A02,083761,Briones; Jor-el Thomas Caparas,8,0,35,27
1657303841713,MATH 20C,A03,093476,Briones; Jor-el Thomas Caparas,0,1,36,36
1657303841713,MATH 20C,B01,083762,Bach; Quang Tran,1,0,30,29
1657303847737,MATH 20D,A01,083765,Tran; Brian Kha,5,0,30,25
1657303847737,MATH 20D,A02,083766,Tran; Brian Kha,5,0,30,25
1657303847737,MATH 20D,A03,083767,Tran; Brian Kha,4,0,30,26
1657303853762,MATH 20E,A01,083771,Ganguly; Soumya,7,0,32,25
1657303853762,MATH 20E,A02,083772,Ganguly; Soumya,6,0,32,26
1657303853762,MATH 20E,B01,083773,Ciotti; Benjamin,19,0,35,16
1657303853762,MATH 20E,B02,083774,Ciotti; Benjamin,17,0,35,18
1657303859786,MATH 103A,A01,083777,Greenfeld; Be'Eri,3,0,36,33
1657303859786,MATH 103A,A02,083778,Greenfeld; Be'Eri,5,0,36,31
1657303859786,MATH 103A,A03,093561,Greenfeld; Be'Eri,4,0,36,32
1657303859786,MATH 103A,B01,083779,Greenfeld; Be'Eri,6,0,36,30
1657303859786,MATH 103A,B02,083780,Greenfeld; Be'Eri,4,0,36,32
1657303859786,MATH 103A,B03,093562,Greenfeld; Be'Eri,3,0,36,33
1657303865809,MATH 105,A01,085443,Carter; Anne Toulson,15,0,35,20
1657303865809,MATH 105,A02,093477,Carter; Anne Toulson,20,0,35,15
1657303871838,MATH 109,A01,083213,Ganzberger; Geoffrey Michael,2,0,34,32
1657303871838,MATH 109,A02,083214,Ganzberger; Geoffrey Michael,4,0,34,30
1657303871838,MATH 109,A03,093478,Ganzberger; Geoffrey Michael,2,0,34,32
1657303871838,MATH 109,B01,083215,Ganzberger; Geoffrey Michael,1,0,32,31
1657303871838,MATH 109,B02,083216,Ganzberger; Geoffrey Michael,1,0,32,31
1657303871838,MATH 109,B03,093479,Ganzberger; Geoffrey Michael,8,0,32,24
1657303877866,MATH 142A,A01,083219,Chow; Bennett,7,0,32,25
1657303877866,MATH 142A,A02,083220,Chow; Bennett,10,0,32,22
1657303877866,MATH 142A,A03,093480,Chow; Bennett,7,0,32,25
1657303877866,MATH 142A,B03,093481,Chow; Bennett,8,0,32,24
1657303877866,MATH 142A,B04,093558,Chow; Bennett,12,0,32,20
1657303877866,MATH 142A,B05,093559,Chow; Bennett,6,0,32,26
1657303883889,MATH 193A,A01,083224,Rotar; Vladimir,7,0,34,27
1657303883889,MATH 193A,A02,083225,Rotar; Vladimir,7,0,34,27
1657303883889,MATH 193A,A03,083781,Rotar; Vladimir,3,0,34,31
1657303883889,MATH 193A,A04,083782,Rotar; Vladimir,8,0,34,26
1657303883889,MATH 193A,A05,093482,Rotar; Vladimir,7,0,34,27
1657303889914,MATH 197,001,091859,McAuley; Julian John,9999,0,9999,0
1657303889914,MATH 197,002,095566,Kedlaya; Kiran S.,9997,0,9999,2
1657303889914,MATH 197,003,095567,Xiao; Ming,9999,0,9999,0
1657303889914,MATH 197,004,095571,Perols; Johan Lars,9998,0,9999,1
1657303896978,COGS 9,A01,083615,Shannon; Kyle Michael,8,0,75,67
1657303903008,COGS 11,A01,083617,Boyle; Mary E. T.,22,0,48,26
1657303909036,COGS 13,A01,083071,Bastos; Amalia Pinkusfeld,10,0,71,61
1657303915065,COGS 14A,A01,092681,Semenuks; Arturs,2,1,100,98
1657303921094,COGS 14B,A01,083073,Cheng; Tzu-Han,6,0,63,57
1657303927116,COGS 17,A01,092677,Semenuks; Arturs,5,0,81,76
1657303933147,COGS 100,A01,083619,Allen; Michael Gordon,16,0,70,54
1657303939172,COGS 101A,A01,083621,Davis; Joshua Daniel,9,0,68,59
1657303945289,COGS 101B,A01,091572,Allen; Michael Gordon,11,0,65,54
1657303951329,COGS 101C,A01,083625,Delgado; Tania,17,0,35,18
1657303957352,COGS 107A,A01,083627,Boyle; Mary E. T.,13,0,60,47
1657303963375,COGS 118A,A01,083075,Gupta; Anjum,18,0,76,58
1657303969403,CSE 3,A50,083646,Miranda; Gregory Joseph,24,0,50,26
1657303975427,CSE 8A,A50,083650,Miranda; Gregory Joseph,17,1,56,39
1657303981455,CSE 11,A01,083080,Cao; Yingjun,5,15,40,35
1657303987479,CSE 12,A01,083652,Krause-Levy; Sophia Louisa,26,1,120,94
1657303993504,CSE 15L,A01,083654,Morris; Justin Loren,9,0,50,41
1657303993504,CSE 15L,A02,083655,Morris; Justin Loren,9,0,50,41
1657303999526,CSE 20,A01,083657,Tran; Khoa Dang,38,0,80,42
1657304005553,CSE 21,A01,095574,Bach; Quang Tran,22,0,48,26
1657304011581,CSE 30,A01,083084,Eldon; John,4,0,80,76
1657304011581,CSE 30,B01,095061,Bhaskar; Nishant,9,0,50,41
1657304017606,CSE 100,A01,083659,Cao; Yingjun,4,4,70,66
1657304023634,CSE 134B,A01,083661,Powell; Thomas Allan,21,0,100,79
1657304029660,CSE 140,A01,083663,Gungor; Onat,13,0,85,72
1657304035683,CSE 140L,A01,083088,Eldon; John,20,0,100,80
1657304041706,CSE 175,A01,083665,Kumar; Rakesh,3,0,25,22
1657304047732,CSE 190,A00,092507,Dubnov; Shlomo,7,0,20,13
1657304053763,ECE 45,A01,083139,Congero; Spencer William,6,0,75,69
1657304059786,ECE 65,A50,083695,Saad; Andrew S,12,0,30,18
1657304059786,ECE 65,A51,095125,Saad; Andrew S,25,0,26,1
1657304065812,ECE 109,A01,091882,Touri; Behrouz,19,0,70,51
1657304071852,ECE 180,A00,083140,Abi Samra; Nicholas Camill,1,0,30,29
1657304071852,ECE 180,B00,083141,Abi Samra; Nicholas Camill,0,0,30,30
1657304077878,MATH 10A,A01,083735,Patchell; Gregory David,2,0,30,28
1657304077878,MATH 10A,A02,083736,Patchell; Gregory David,20,0,30,10
1657304077878,MATH 10A,A03,083737,Patchell; Gregory David,16,0,30,14
1657304083901,MATH 10B,A01,083207,Lim; Seonhee,7,0,34,27
1657304083901,MATH 10B,A02,083208,Lim; Seonhee,9,0,35,26
1657304083901,MATH 10B,A03,093472,Lim; Seonhee,7,0,34,27
1657304083901,MATH 10B,B01,083739,Sinha; Shubham,11,0,30,19
1657304089932,MATH 18,A01,083743,Cinel; Cameron Alexander,6,0,30,24
1657304089932,MATH 18,A02,083744,Cinel; Cameron Alexander,17,0,30,13
1657304089932,MATH 18,A03,083745,Cinel; Cameron Alexander,8,0,30,22
1657304089932,MATH 18,B01,083748,Rideout; David Porter,4,0,37,33
1657304089932,MATH 18,B02,083749,Rideout; David Porter,4,0,36,32
1657304089932,MATH 18,B03,083750,Rideout; David Porter,2,0,37,35
1657304089932,MATH 18,B04,083751,Rideout; David Porter,6,0,36,30
1657304089932,MATH 18,B05,093473,Rideout; David Porter,5,0,36,31
1657304089932,MATH 18,B06,093474,Rideout; David Porter,5,0,36,31
1657304095959,MATH 20A,A01,083754,Zheng; Zequn,14,0,40,26
1657304101982,MATH 20B,A01,083756,Briones; Jor-el Thomas Caparas,3,0,36,33
1657304101982,MATH 20B,A02,083757,Briones; Jor-el Thomas Caparas,1,0,36,35
1657304101982,MATH 20B,A03,093475,Briones; Jor-el Thomas Caparas,2,0,36,34
1657304108017,MATH 20C,A01,083760,Briones; Jor-el Thomas Caparas,1,0,35,34
1657304108017,MATH 20C,A02,083761,Briones; Jor-el Thomas Caparas,8,0,35,27
1657304108017,MATH 20C,A03,093476,Briones; Jor-el Thomas Caparas,0,1,36,36
1657304108017,MATH 20C,B01,083762,Bach; Quang Tran,1,0,30,29
1657304114133,MATH 20D,A01,083765,Tran; Brian Kha,5,0,30,25
1657304114133,MATH 20D,A02,083766,Tran; Brian Kha,5,0,30,25
1657304114133,MATH 20D,A03,083767,Tran; Brian Kha,4,0,30,26
1657304120161,MATH 20E,A01,083771,Ganguly; Soumya,7,0,32,25
1657304120161,MATH 20E,A02,083772,Ganguly; Soumya,6,0,32,26
1657304120161,MATH 20E,B01,083773,Ciotti; Benjamin,19,0,35,16
1657304120161,MATH 20E,B02,083774,Ciotti; Benjamin,17,0,35,18
1657304126191,MATH 103A,A01,083777,Greenfeld; Be'Eri,3,0,36,33
1657304126191,MATH 103A,A02,083778,Greenfeld; Be'Eri,5,0,36,31
1657304126191,MATH 103A,A03,093561,Greenfeld; Be'Eri,4,0,36,32
1657304126191,MATH 103A,B01,083779,Greenfeld; Be'Eri,6,0,36,30
1657304126191,MATH 103A,B02,083780,Greenfeld; Be'Eri,4,0,36,32
1657304126191,MATH 103A,B03,093562,Greenfeld; Be'Eri,3,0,36,33
1657304132215,MATH 105,A01,085443,Carter; Anne Toulson,15,0,35,20
1657304132215,MATH 105,A02,093477,Carter; Anne Toulson,20,0,35,15
1657304138237,MATH 109,A01,083213,Ganzberger; Geoffrey Michael,2,0,34,32
1657304138237,MATH 109,A02,083214,Ganzberger; Geoffrey Michael,4,0,34,30
1657304138237,MATH 109,A03,093478,Ganzberger; Geoffrey Michael,2,0,34,32
1657304138237,MATH 109,B01,083215,Ganzberger; Geoffrey Michael,1,0,32,31
1657304138237,MATH 109,B02,083216,Ganzberger; Geoffrey Michael,1,0,32,31
1657304138237,MATH 109,B03,093479,Ganzberger; Geoffrey Michael,8,0,32,24
1657304144267,MATH 142A,A01,083219,Chow; Bennett,7,0,32,25
1657304144267,MATH 142A,A02,083220,Chow; Bennett,10,0,32,22
1657304144267,MATH 142A,A03,093480,Chow; Bennett,7,0,32,25
1657304144267,MATH 142A,B03,093481,Chow; Bennett,8,0,32,24
1657304144267,MATH 142A,B04,093558,Chow; Bennett,12,0,32,20
1657304144267,MATH 142A,B05,093559,Chow; Bennett,6,0,32,26
1657304150290,MATH 193A,A01,083224,Rotar; Vladimir,7,0,34,27
1657304150290,MATH 193A,A02,083225,Rotar; Vladimir,7,0,34,27
1657304150290,MATH 193A,A03,083781,Rotar; Vladimir,3,0,34,31
1657304150290,MATH 193A,A04,083782,Rotar; Vladimir,8,0,34,26
1657304150290,MATH 193A,A05,093482,Rotar; Vladimir,7,0,34,27
1657304156313,MATH 197,001,091859,McAuley; Julian John,9999,0,9999,0
1657304156313,MATH 197,002,095566,Kedlaya; Kiran S.,9997,0,9999,2
1657304156313,MATH 197,003,095567,Xiao; Ming,9999,0,9999,0
1657304156313,MATH 197,004,095571,Perols; Johan Lars,9998,0,9999,1
1657304163378,COGS 9,A01,083615,Shannon; Kyle Michael,8,0,75,67
1657304169410,COGS 11,A01,083617,Boyle; Mary E. T.,22,0,48,26
1657304175434,COGS 13,A01,083071,Bastos; Amalia Pinkusfeld,10,0,71,61
1657304181476,COGS 14A,A01,092681,Semenuks; Arturs,2,1,100,98
1657304187512,COGS 14B,A01,083073,Cheng; Tzu-Han,6,0,63,57
1657304193539,COGS 17,A01,092677,Semenuks; Arturs,5,0,81,76
1657304199564,COGS 100,A01,083619,Allen; Michael Gordon,16,0,70,54
1657304205587,COGS 101A,A01,083621,Davis; Joshua Daniel,9,0,68,59
1657304211614,COGS 101B,A01,091572,Allen; Michael Gordon,11,0,65,54
1657304217639,COGS 101C,A01,083625,Delgado; Tania,17,0,35,18
1657304223665,COGS 107A,A01,083627,Boyle; Mary E. T.,13,0,60,47
1657304229689,COGS 118A,A01,083075,Gupta; Anjum,18,0,76,58
1657304235721,CSE 3,A50,083646,Miranda; Gregory Joseph,24,0,50,26
1657304241753,CSE 8A,A50,083650,Miranda; Gregory Joseph,17,1,56,39
1657304247777,CSE 11,A01,083080,Cao; Yingjun,5,15,40,35
1657304253799,CSE 12,A01,083652,Krause-Levy; Sophia Louisa,26,1,120,94
1657304259831,CSE 15L,A01,083654,Morris; Justin Loren,9,0,50,41
1657304259831,CSE 15L,A02,083655,Morris; Justin Loren,9,0,50,41
1657304265852,CSE 20,A01,083657,Tran; Khoa Dang,38,0,80,42
1657304271879,CSE 21,A01,095574,Bach; Quang Tran,22,0,48,26
1657304277907,CSE 30,A01,083084,Eldon; John,4,0,80,76
1657304277907,CSE 30,B01,095061,Bhaskar; Nishant,9,0,50,41
1657304283944,CSE 100,A01,083659,Cao; Yingjun,4,4,70,66
1657304289967,CSE 134B,A01,083661,Powell; Thomas Allan,21,0,100,79
1657304295991,CSE 140,A01,083663,Gungor; Onat,13,0,85,72
1657304302018,CSE 140L,A01,083088,Eldon; John,20,0,100,80
1657304308041,CSE 175,A01,083665,Kumar; Rakesh,3,0,25,22
1657304314065,CSE 190,A00,092507,Dubnov; Shlomo,7,0,20,13
1657304320092,ECE 45,A01,083139,Congero; Spencer William,6,0,75,69
1657304326115,ECE 65,A50,083695,Saad; Andrew S,12,0,30,18
1657304326115,ECE 65,A51,095125,Saad; Andrew S,25,0,26,1
1657304332141,ECE 109,A01,091882,Touri; Behrouz,19,0,70,51
1657304338165,ECE 180,A00,083140,Abi Samra; Nicholas Camill,1,0,30,29
1657304338165,ECE 180,B00,083141,Abi Samra; Nicholas Camill,0,0,30,30
1657304344193,MATH 10A,A01,083735,Patchell; Gregory David,2,0,30,28
1657304344193,MATH 10A,A02,083736,Patchell; Gregory David,20,0,30,10
1657304344193,MATH 10A,A03,083737,Patchell; Gregory David,16,0,30,14
1657304350216,MATH 10B,A01,083207,Lim; Seonhee,7,0,34,27
1657304350216,MATH 10B,A02,083208,Lim; Seonhee,9,0,35,26
1657304350216,MATH 10B,A03,093472,Lim; Seonhee,7,0,34,27
1657304350216,MATH 10B,B01,083739,Sinha; Shubham,11,0,30,19
1657304356240,MATH 18,A01,083743,Cinel; Cameron Alexander,6,0,30,24
1657304356240,MATH 18,A02,083744,Cinel; Cameron Alexander,17,0,30,13
1657304356240,MATH 18,A03,083745,Cinel; Cameron Alexander,8,0,30,22
1657304356240,MATH 18,B01,083748,Rideout; David Porter,4,0,37,33
1657304356240,MATH 18,B02,083749,Rideout; David Porter,4,0,36,32
1657304356240,MATH 18,B03,083750,Rideout; David Porter,2,0,37,35
1657304356240,MATH 18,B04,083751,Rideout; David Porter,6,0,36,30
1657304356240,MATH 18,B05,093473,Rideout; David Porter,5,0,36,31
1657304356240,MATH 18,B06,093474,Rideout; David Porter,5,0,36,31
1657304362263,MATH 20A,A01,083754,Zheng; Zequn,14,0,40,26
1657304368292,MATH 20B,A01,083756,Briones; Jor-el Thomas Caparas,3,0,36,33
1657304368292,MATH 20B,A02,083757,Briones; Jor-el Thomas Caparas,1,0,36,35
1657304368292,MATH 20B,A03,093475,Briones; Jor-el Thomas Caparas,2,0,36,34
1657304374320,MATH 20C,A01,083760,Briones; Jor-el Thomas Caparas,1,0,35,34
1657304374320,MATH 20C,A02,083761,Briones; Jor-el Thomas Caparas,8,0,35,27
1657304374320,MATH 20C,A03,093476,Briones; Jor-el Thomas Caparas,0,1,36,36
1657304374320,MATH 20C,B01,083762,Bach; Quang Tran,1,0,30,29
1657304380348,MATH 20D,A01,083765,Tran; Brian Kha,5,0,30,25
1657304380348,MATH 20D,A02,083766,Tran; Brian Kha,5,0,30,25
1657304380348,MATH 20D,A03,083767,Tran; Brian Kha,4,0,30,26
1657304386371,MATH 20E,A01,083771,Ganguly; Soumya,7,0,32,25
1657304386371,MATH 20E,A02,083772,Ganguly; Soumya,6,0,32,26
1657304386371,MATH 20E,B01,083773,Ciotti; Benjamin,19,0,35,16
1657304386371,MATH 20E,B02,083774,Ciotti; Benjamin,17,0,35,18
1657304392394,MATH 103A,A01,083777,Greenfeld; Be'Eri,3,0,36,33
1657304392394,MATH 103A,A02,083778,Greenfeld; Be'Eri,5,0,36,31
1657304392394,MATH 103A,A03,093561,Greenfeld; Be'Eri,4,0,36,32
1657304392394,MATH 103A,B01,083779,Greenfeld; Be'Eri,6,0,36,30
1657304392394,MATH 103A,B02,083780,Greenfeld; Be'Eri,4,0,36,32
1657304392394,MATH 103A,B03,093562,Greenfeld; Be'Eri,3,0,36,33
1657304398421,MATH 105,A01,085443,Carter; Anne Toulson,15,0,35,20
1657304398421,MATH 105,A02,093477,Carter; Anne Toulson,20,0,35,15
1657304404450,MATH 109,A01,083213,Ganzberger; Geoffrey Michael,2,0,34,32
1657304404450,MATH 109,A02,083214,Ganzberger; Geoffrey Michael,4,0,34,30
1657304404450,MATH 109,A03,093478,Ganzberger; Geoffrey Michael,2,0,34,32
1657304404450,MATH 109,B01,083215,Ganzberger; Geoffrey Michael,1,0,32,31
1657304404450,MATH 109,B02,083216,Ganzberger; Geoffrey Michael,1,0,32,31
1657304404450,MATH 109,B03,093479,Ganzberger; Geoffrey Michael,8,0,32,24
1657304410481,MATH 142A,A01,083219,Chow; Bennett,7,0,32,25
1657304410481,MATH 142A,A02,083220,Chow; Bennett,10,0,32,22
1657304410481,MATH 142A,A03,093480,Chow; Bennett,7,0,32,25
1657304410481,MATH 142A,B03,093481,Chow; Bennett,8,0,32,24
1657304410481,MATH 142A,B04,093558,Chow; Bennett,12,0,32,20
1657304410481,MATH 142A,B05,093559,Chow; Bennett,6,0,32,26
1657304416504,MATH 193A,A01,083224,Rotar; Vladimir,7,0,34,27
1657304416504,MATH 193A,A02,083225,Rotar; Vladimir,7,0,34,27
1657304416504,MATH 193A,A03,083781,Rotar; Vladimir,3,0,34,31
1657304416504,MATH 193A,A04,083782,Rotar; Vladimir,8,0,34,26
1657304416504,MATH 193A,A05,093482,Rotar; Vladimir,7,0,34,27
1657304422529,MATH 197,001,091859,McAuley; Julian John,9999,0,9999,0
1657304422529,MATH 197,002,095566,Kedlaya; Kiran S.,9997,0,9999,2
1657304422529,MATH 197,003,095567,Xiao; Ming,9999,0,9999,0
1657304422529,MATH 197,004,095571,Perols; Johan Lars,9998,0,9999,1
1657304429590,COGS 9,A01,083615,Shannon; Kyle Michael,8,0,75,67
1657304435613,COGS 11,A01,083617,Boyle; Mary E. T.,22,0,48,26
1657304441646,COGS 13,A01,083071,Bastos; Amalia Pinkusfeld,10,0,71,61
1657304447673,COGS 14A,A01,092681,Semenuks; Arturs,2,1,100,98
1657304453713,COGS 14B,A01,083073,Cheng; Tzu-Han,6,0,63,57
1657304459748,COGS 17,A01,092677,Semenuks; Arturs,5,0,81,76
1657304465771,COGS 100,A01,083619,Allen; Michael Gordon,16,0,70,54
1657304471798,COGS 101A,A01,083621,Davis; Joshua Daniel,9,0,68,59
1657304477829,COGS 101B,A01,091572,Allen; Michael Gordon,11,0,65,54
1657304483866,COGS 101C,A01,083625,Delgado; Tania,17,0,35,18
1657304489888,COGS 107A,A01,083627,Boyle; Mary E. T.,13,0,60,47
1657304495911,COGS 118A,A01,083075,Gupta; Anjum,18,0,76,58
1657304501940,CSE 3,A50,083646,Miranda; Gregory Joseph,24,0,50,26
1657304507974,CSE 8A,A50,083650,Miranda; Gregory Joseph,17,1,56,39
1657304514005,CSE 11,A01,083080,Cao; Yingjun,5,15,40,35
1657304520031,CSE 12,A01,083652,Krause-Levy; Sophia Louisa,26,1,120,94
1657304526055,CSE 15L,A01,083654,Morris; Justin Loren,9,0,50,41
1657304526055,CSE 15L,A02,083655,Morris; Justin Loren,9,0,50,41
1657304532077,CSE 20,A01,083657,Tran; Khoa Dang,38,0,80,42
1657304538101,CSE 21,A01,095574,Bach; Quang Tran,22,0,48,26
1657304544212,CSE 30,A01,083084,Eldon; John,4,0,80,76
1657304544212,CSE 30,B01,095061,Bhaskar; Nishant,9,0,50,41
1657304550249,CSE 100,A01,083659,Cao; Yingjun,4,4,70,66
1657304556273,CSE 134B,A01,083661,Powell; Thomas Allan,21,0,100,79
1657304562300,CSE 140,A01,083663,Gungor; Onat,13,0,85,72
1657304568323,CSE 140L,A01,083088,Eldon; John,20,0,100,80
1657304574345,CSE 175,A01,083665,Kumar; Rakesh,3,0,25,22
1657304580368,CSE 190,A00,092507,Dubnov; Shlomo,7,0,20,13
1657304586391,ECE 45,A01,083139,Congero; Spencer William,6,0,75,69
1657304592428,ECE 65,A50,083695,Saad; Andrew S,12,0,30,18
1657304592428,ECE 65,A51,095125,Saad; Andrew S,25,0,26,1
1657304598451,ECE 109,A01,091882,Touri; Behrouz,19,0,70,51
1657304604473,ECE 180,A00,083140,Abi Samra; Nicholas Camill,1,0,30,29
1657304604473,ECE 180,B00,083141,Abi Samra; Nicholas Camill,0,0,30,30
1657304610500,MATH 10A,A01,083735,Patchell; Gregory David,2,0,30,28
1657304610500,MATH 10A,A02,083736,Patchell; Gregory David,20,0,30,10
1657304610500,MATH 10A,A03,083737,Patchell; Gregory David,16,0,30,14
1657304616532,MATH 10B,A01,083207,Lim; Seonhee,7,0,34,27
1657304616532,MATH 10B,A02,083208,Lim; Seonhee,9,0,35,26
1657304616532,MATH 10B,A03,093472,Lim; Seonhee,7,0,34,27
1657304616532,MATH 10B,B01,083739,Sinha; Shubham,11,0,30,19
1657304622558,MATH 18,A01,083743,Cinel; Cameron Alexander,6,0,30,24
1657304622558,MATH 18,A02,083744,Cinel; Cameron Alexander,17,0,30,13
1657304622558,MATH 18,A03,083745,Cinel; Cameron Alexander,8,0,30,22
1657304622558,MATH 18,B01,083748,Rideout; David Porter,4,0,37,33
1657304622558,MATH 18,B02,083749,Rideout; David Porter,4,0,36,32
1657304622558,MATH 18,B03,083750,Rideout; David Porter,2,0,37,35
1657304622558,MATH 18,B04,083751,Rideout; David Porter,6,0,36,30
1657304622558,MATH 18,B05,093473,Rideout; David Porter,5,0,36,31
1657304622558,MATH 18,B06,093474,Rideout; David Porter,5,0,36,31
1657304628587,MATH 20A,A01,083754,Zheng; Zequn,14,0,40,26
1657304634613,MATH 20B,A01,083756,Briones; Jor-el Thomas Caparas,3,0,36,33
1657304634613,MATH 20B,A02,083757,Briones; Jor-el Thomas Caparas,1,0,36,35
1657304634613,MATH 20B,A03,093475,Briones; Jor-el Thomas Caparas,2,0,36,34
1657304640636,MATH 20C,A01,083760,Briones; Jor-el Thomas Caparas,1,0,35,34
1657304640636,MATH 20C,A02,083761,Briones; Jor-el Thomas Caparas,8,0,35,27
1657304640636,MATH 20C,A03,093476,Briones; Jor-el Thomas Caparas,0,1,36,36
1657304640636,MATH 20C,B01,083762,Bach; Quang Tran,1,0,30,29
1657304646668,MATH 20D,A01,083765,Tran; Brian Kha,5,0,30,25
1657304646668,MATH 20D,A02,083766,Tran; Brian Kha,5,0,30,25
1657304646668,MATH 20D,A03,083767,Tran; Brian Kha,4,0,30,26
1657304652695,MATH 20E,A01,083771,Ganguly; Soumya,7,0,32,25
1657304652695,MATH 20E,A02,083772,Ganguly; Soumya,6,0,32,26
1657304652695,MATH 20E,B01,083773,Ciotti; Benjamin,19,0,35,16
1657304652695,MATH 20E,B02,083774,Ciotti; Benjamin,17,0,35,18
1657304658719,MATH 103A,A01,083777,Greenfeld; Be'Eri,3,0,36,33
1657304658719,MATH 103A,A02,083778,Greenfeld; Be'Eri,5,0,36,31
1657304658719,MATH 103A,A03,093561,Greenfeld; Be'Eri,4,0,36,32
1657304658719,MATH 103A,B01,083779,Greenfeld; Be'Eri,6,0,36,30
1657304658719,MATH 103A,B02,083780,Greenfeld; Be'Eri,4,0,36,32
1657304658719,MATH 103A,B03,093562,Greenfeld; Be'Eri,3,0,36,33
1657304664742,MATH 105,A01,085443,Carter; Anne Toulson,15,0,35,20
1657304664742,MATH 105,A02,093477,Carter; Anne Toulson,20,0,35,15
1657304670777,MATH 109,A01,083213,Ganzberger; Geoffrey Michael,2,0,34,32
1657304670777,MATH 109,A02,083214,Ganzberger; Geoffrey Michael,4,0,34,30
1657304670777,MATH 109,A03,093478,Ganzberger; Geoffrey Michael,2,0,34,32
1657304670777,MATH 109,B01,083215,Ganzberger; Geoffrey Michael,1,0,32,31
1657304670777,MATH 109,B02,083216,Ganzberger; Geoffrey Michael,1,0,32,31
1657304670777,MATH 109,B03,093479,Ganzberger; Geoffrey Michael,8,0,32,24
1657304676812,MATH 142A,A01,083219,Chow; Bennett,7,0,32,25
1657304676812,MATH 142A,A02,083220,Chow; Bennett,10,0,32,22
1657304676812,MATH 142A,A03,093480,Chow; Bennett,7,0,32,25
1657304676812,MATH 142A,B03,093481,Chow; Bennett,8,0,32,24
1657304676812,MATH 142A,B04,093558,Chow; Bennett,12,0,32,20
1657304676812,MATH 142A,B05,093559,Chow; Bennett,6,0,32,26
1657304682840,MATH 193A,A01,083224,Rotar; Vladimir,7,0,34,27
1657304682840,MATH 193A,A02,083225,Rotar; Vladimir,7,0,34,27
1657304682840,MATH 193A,A03,083781,Rotar; Vladimir,3,0,34,31
1657304682840,MATH 193A,A04,083782,Rotar; Vladimir,8,0,34,26
1657304682840,MATH 193A,A05,093482,Rotar; Vladimir,7,0,34,27
1657304688863,MATH 197,001,091859,McAuley; Julian John,9999,0,9999,0
1657304688863,MATH 197,002,095566,Kedlaya; Kiran S.,9997,0,9999,2
1657304688863,MATH 197,003,095567,Xiao; Ming,9999,0,9999,0
1657304688863,MATH 197,004,095571,Perols; Johan Lars,9998,0,9999,1
1657304695926,COGS 9,A01,083615,Shannon; Kyle Michael,8,0,75,67
1657304701950,COGS 11,A01,083617,Boyle; Mary E. T.,22,0,48,26
1657304707973,COGS 13,A01,083071,Bastos; Amalia Pinkusfeld,10,0,71,61
1657304713999,COGS 14A,A01,092681,Semenuks; Arturs,2,1,100,98
1657304720026,COGS 14B,A01,083073,Cheng; Tzu-Han,6,0,63,57
1657304726049,COGS 17,A01,092677,Semenuks; Arturs,5,0,81,76
1657304732074,COGS 100,A01,083619,Allen; Michael Gordon,16,0,70,54
1657304738104,COGS 101A,A01,083621,Davis; Joshua Daniel,9,0,68,59
1657304744131,COGS 101B,A01,091572,Allen; Michael Gordon,11,0,65,54
1657304750152,COGS 101C,A01,083625,Delgado; Tania,17,0,35,18
1657304756176,COGS 107A,A01,083627,Boyle; Mary E. T.,13,0,60,47
1657304762202,COGS 118A,A01,083075,Gupta; Anjum,18,0,76,58
1657304768237,CSE 3,A50,083646,Miranda; Gregory Joseph,24,0,50,26
1657304774264,CSE 8A,A50,083650,Miranda; Gregory Joseph,17,1,56,39
1657304780287,CSE 11,A01,083080,Cao; Yingjun,6,15,40,34
1657304786309,CSE 12,A01,083652,Krause-Levy; Sophia Louisa,26,1,120,94
1657304792335,CSE 15L,A01,083654,Morris; Justin Loren,9,0,50,41
1657304792335,CSE 15L,A02,083655,Morris; Justin Loren,9,0,50,41
1657304798361,CSE 20,A01,083657,Tran; Khoa Dang,38,0,80,42
1657304804383,CSE 21,A01,095574,Bach; Quang Tran,22,0,48,26
1657304810407,CSE 30,A01,083084,Eldon; John,4,0,80,76
1657304810407,CSE 30,B01,095061,Bhaskar; Nishant,9,0,50,41
1657304816431,CSE 100,A01,083659,Cao; Yingjun,4,4,70,66
1657304822459,CSE 134B,A01,083661,Powell; Thomas Allan,21,0,100,79
1657304828481,CSE 140,A01,083663,Gungor; Onat,13,0,85,72
1657304834504,CSE 140L,A01,083088,Eldon; John,20,0,100,80
1657304840526,CSE 175,A01,083665,Kumar; Rakesh,3,0,25,22
1657304846550,CSE 190,A00,092507,Dubnov; Shlomo,7,0,20,13
1657304852578,ECE 45,A01,083139,Congero; Spencer William,6,0,75,69
1657304858603,ECE 65,A50,083695,Saad; Andrew S,12,0,30,18
1657304858603,ECE 65,A51,095125,Saad; Andrew S,25,0,26,1
1657304864630,ECE 109,A01,091882,Touri; Behrouz,19,0,70,51
1657304870652,ECE 180,A00,083140,Abi Samra; Nicholas Camill,1,0,30,29
1657304870652,ECE 180,B00,083141,Abi Samra; Nicholas Camill,0,0,30,30
1657304876674,MATH 10A,A01,083735,Patchell; Gregory David,2,0,30,28
1657304876674,MATH 10A,A02,083736,Patchell; Gregory David,20,0,30,10
1657304876674,MATH 10A,A03,083737,Patchell; Gregory David,16,0,30,14
1657304882703,MATH 10B,A01,083207,Lim; Seonhee,7,0,34,27
1657304882703,MATH 10B,A02,083208,Lim; Seonhee,9,0,35,26
1657304882703,MATH 10B,A03,093472,Lim; Seonhee,7,0,34,27
1657304882703,MATH 10B,B01,083739,Sinha; Shubham,11,0,30,19
1657304888740,MATH 18,A01,083743,Cinel; Cameron Alexander,6,0,30,24
1657304888740,MATH 18,A02,083744,Cinel; Cameron Alexander,17,0,30,13
1657304888740,MATH 18,A03,083745,Cinel; Cameron Alexander,8,0,30,22
1657304888740,MATH 18,B01,083748,Rideout; David Porter,4,0,37,33
1657304888740,MATH 18,B02,083749,Rideout; David Porter,4,0,36,32
1657304888740,MATH 18,B03,083750,Rideout; David Porter,2,0,37,35
1657304888740,MATH 18,B04,083751,Rideout; David Porter,6,0,36,30
1657304888740,MATH 18,B05,093473,Rideout; David Porter,5,0,36,31
1657304888740,MATH 18,B06,093474,Rideout; David Porter,5,0,36,31
1657304894763,MATH 20A,A01,083754,Zheng; Zequn,14,0,40,26
1657304900789,MATH 20B,A01,083756,Briones; Jor-el Thomas Caparas,3,0,36,33
1657304900789,MATH 20B,A02,083757,Briones; Jor-el Thomas Caparas,1,0,36,35
1657304900789,MATH 20B,A03,093475,Briones; Jor-el Thomas Caparas,2,0,36,34
1657304906832,MATH 20C,A01,083760,Briones; Jor-el Thomas Caparas,1,0,35,34
1657304906832,MATH 20C,A02,083761,Briones; Jor-el Thomas Caparas,8,0,35,27
1657304906832,MATH 20C,A03,093476,Briones; Jor-el Thomas Caparas,0,1,36,36
1657304906832,MATH 20C,B01,083762,Bach; Quang Tran,1,0,30,29
1657304912869,MATH 20D,A01,083765,Tran; Brian Kha,5,0,30,25
1657304912869,MATH 20D,A02,083766,Tran; Brian Kha,5,0,30,25
1657304912869,MATH 20D,A03,083767,Tran; Brian Kha,4,0,30,26
1657304918897,MATH 20E,A01,083771,Ganguly; Soumya,7,0,32,25
1657304918897,MATH 20E,A02,083772,Ganguly; Soumya,6,0,32,26
1657304918897,MATH 20E,B01,083773,Ciotti; Benjamin,19,0,35,16
1657304918897,MATH 20E,B02,083774,Ciotti; Benjamin,17,0,35,18
1657304924927,MATH 103A,A01,083777,Greenfeld; Be'Eri,3,0,36,33
1657304924927,MATH 103A,A02,083778,Greenfeld; Be'Eri,5,0,36,31
1657304924927,MATH 103A,A03,093561,Greenfeld; Be'Eri,4,0,36,32
1657304924927,MATH 103A,B01,083779,Greenfeld; Be'Eri,6,0,36,30
1657304924927,MATH 103A,B02,083780,Greenfeld; Be'Eri,4,0,36,32
1657304924927,MATH 103A,B03,093562,Greenfeld; Be'Eri,3,0,36,33
1657304930953,MATH 105,A01,085443,Carter; Anne Toulson,15,0,35,20
1657304930953,MATH 105,A02,093477,Carter; Anne Toulson,20,0,35,15
1657304936980,MATH 109,A01,083213,Ganzberger; Geoffrey Michael,2,0,34,32
1657304936980,MATH 109,A02,083214,Ganzberger; Geoffrey Michael,4,0,34,30
1657304936980,MATH 109,A03,093478,Ganzberger; Geoffrey Michael,2,0,34,32
1657304936980,MATH 109,B01,083215,Ganzberger; Geoffrey Michael,1,0,32,31
1657304936980,MATH 109,B02,083216,Ganzberger; Geoffrey Michael,1,0,32,31
1657304936980,MATH 109,B03,093479,Ganzberger; Geoffrey Michael,8,0,32,24
1657304943009,MATH 142A,A01,083219,Chow; Bennett,7,0,32,25
1657304943009,MATH 142A,A02,083220,Chow; Bennett,10,0,32,22
1657304943009,MATH 142A,A03,093480,Chow; Bennett,7,0,32,25
1657304943009,MATH 142A,B03,093481,Chow; Bennett,8,0,32,24
1657304943009,MATH 142A,B04,093558,Chow; Bennett,12,0,32,20
1657304943009,MATH 142A,B05,093559,Chow; Bennett,6,0,32,26
1657304949032,MATH 193A,A01,083224,Rotar; Vladimir,7,0,34,27
1657304949032,MATH 193A,A02,083225,Rotar; Vladimir,7,0,34,27
1657304949032,MATH 193A,A03,083781,Rotar; Vladimir,3,0,34,31
1657304949032,MATH 193A,A04,083782,Rotar; Vladimir,8,0,34,26
1657304949032,MATH 193A,A05,093482,Rotar; Vladimir,7,0,34,27
1657304955055,MATH 197,001,091859,McAuley; Julian John,9999,0,9999,0
1657304955055,MATH 197,002,095566,Kedlaya; Kiran S.,9997,0,9999,2
1657304955055,MATH 197,003,095567,Xiao; Ming,9999,0,9999,0
1657304955055,MATH 197,004,095571,Perols; Johan Lars,9998,0,9999,1
1657304962109,COGS 9,A01,083615,Shannon; Kyle Michael,8,0,75,67
1657304968135,COGS 11,A01,083617,Boyle; Mary E. T.,22,0,48,26
1657304974167,COGS 13,A01,083071,Bastos; Amalia Pinkusfeld,10,0,71,61
1657304980197,COGS 14A,A01,092681,Semenuks; Arturs,2,1,100,98
1657304986223,COGS 14B,A01,083073,Cheng; Tzu-Han,6,0,63,57
1657304992250,COGS 17,A01,092677,Semenuks; Arturs,5,0,81,76
1657304998279,COGS 100,A01,083619,Allen; Michael Gordon,16,0,70,54
1657305004302,COGS 101A,A01,083621,Davis; Joshua Daniel,9,0,68,59
1657305010329,COGS 101B,A01,091572,Allen; Michael Gordon,11,0,65,54
1657305016356,COGS 101C,A01,083625,Delgado; Tania,17,0,35,18
1657305022383,COGS 107A,A01,083627,Boyle; Mary E. T.,13,0,60,47
1657305028407,COGS 118A,A01,083075,Gupta; Anjum,18,0,76,58
1657305034442,CSE 3,A50,083646,Miranda; Gregory Joseph,24,0,50,26
1657305040463,CSE 8A,A50,083650,Miranda; Gregory Joseph,17,1,56,39
1657305046489,CSE 11,A01,083080,Cao; Yingjun,6,15,40,34
1657305052511,CSE 12,A01,083652,Krause-Levy; Sophia Louisa,26,1,120,94
1657305058541,CSE 15L,A01,083654,Morris; Justin Loren,9,0,50,41
1657305058541,CSE 15L,A02,083655,Morris; Justin Loren,9,0,50,41
1657305064567,CSE 20,A01,083657,Tran; Khoa Dang,38,0,80,42
1657305070593,CSE 21,A01,095574,Bach; Quang Tran,22,0,48,26
1657305076616,CSE 30,A01,083084,Eldon; John,4,0,80,76
1657305076616,CSE 30,B01,095061,Bhaskar; Nishant,9,0,50,41
1657305082648,CSE 100,A01,083659,Cao; Yingjun,4,4,70,66
1657305088674,CSE 134B,A01,083661,Powell; Thomas Allan,21,0,100,79
1657305094701,CSE 140,A01,083663,Gungor; Onat,13,0,85,72
1657305100734,CSE 140L,A01,083088,Eldon; John,20,0,100,80
1657305106757,CSE 175,A01,083665,Kumar; Rakesh,3,0,25,22
1657305112780,CSE 190,A00,092507,Dubnov; Shlomo,7,0,20,13
1657305118802,ECE 45,A01,083139,Congero; Spencer William,6,0,75,69
1657305124831,ECE 65,A50,083695,Saad; Andrew S,12,0,30,18
1657305124831,ECE 65,A51,095125,Saad; Andrew S,25,0,26,1
1657305130860,ECE 109,A01,091882,Touri; Behrouz,19,0,70,51
1657305136884,ECE 180,A00,083140,Abi Samra; Nicholas Camill,1,0,30,29
1657305136884,ECE 180,B00,083141,Abi Samra; Nicholas Camill,0,0,30,30
1657305143005,MATH 10A,A01,083735,Patchell; Gregory David,2,0,30,28
1657305143005,MATH 10A,A02,083736,Patchell; Gregory David,20,0,30,10
1657305143005,MATH 10A,A03,083737,Patchell; Gregory David,16,0,30,14
1657305149027,MATH 10B,A01,083207,Lim; Seonhee,7,0,34,27
1657305149027,MATH 10B,A02,083208,Lim; Seonhee,9,0,35,26
1657305149027,MATH 10B,A03,093472,Lim; Seonhee,7,0,34,27
1657305149027,MATH 10B,B01,083739,Sinha; Shubham,11,0,30,19
1657305155058,MATH 18,A01,083743,Cinel; Cameron Alexander,6,0,30,24
1657305155058,MATH 18,A02,083744,Cinel; Cameron Alexander,17,0,30,13
1657305155058,MATH 18,A03,083745,Cinel; Cameron Alexander,8,0,30,22
1657305155058,MATH 18,B01,083748,Rideout; David Porter,4,0,37,33
1657305155058,MATH 18,B02,083749,Rideout; David Porter,4,0,36,32
1657305155058,MATH 18,B03,083750,Rideout; David Porter,2,0,37,35
1657305155058,MATH 18,B04,083751,Rideout; David Porter,6,0,36,30
1657305155058,MATH 18,B05,093473,Rideout; David Porter,5,0,36,31
1657305155058,MATH 18,B06,093474,Rideout; David Porter,5,0,36,31
1657305161084,MATH 20A,A01,083754,Zheng; Zequn,14,0,40,26
1657305167115,MATH 20B,A01,083756,Briones; Jor-el Thomas Caparas,3,0,36,33
1657305167115,MATH 20B,A02,083757,Briones; Jor-el Thomas Caparas,1,0,36,35
1657305167115,MATH 20B,A03,093475,Briones; Jor-el Thomas Caparas,2,0,36,34
1657305173142,MATH 20C,A01,083760,Briones; Jor-el Thomas Caparas,1,0,35,34
1657305173142,MATH 20C,A02,083761,Briones; Jor-el Thomas Caparas,8,0,35,27
1657305173142,MATH 20C,A03,093476,Briones; Jor-el Thomas Caparas,0,1,36,36
1657305173142,MATH 20C,B01,083762,Bach; Quang Tran,1,0,30,29
1657305179166,MATH 20D,A01,083765,Tran; Brian Kha,5,0,30,25
1657305179166,MATH 20D,A02,083766,Tran; Brian Kha,5,0,30,25
1657305179166,MATH 20D,A03,083767,Tran; Brian Kha,4,0,30,26
1657305185199,MATH 20E,A01,083771,Ganguly; Soumya,7,0,32,25
1657305185199,MATH 20E,A02,083772,Ganguly; Soumya,6,0,32,26
1657305185199,MATH 20E,B01,083773,Ciotti; Benjamin,19,0,35,16
1657305185199,MATH 20E,B02,083774,Ciotti; Benjamin,17,0,35,18
1657305191236,MATH 103A,A01,083777,Greenfeld; Be'Eri,3,0,36,33
1657305191236,MATH 103A,A02,083778,Greenfeld; Be'Eri,5,0,36,31
1657305191236,MATH 103A,A03,093561,Greenfeld; Be'Eri,4,0,36,32
1657305191236,MATH 103A,B01,083779,Greenfeld; Be'Eri,6,0,36,30
1657305191236,MATH 103A,B02,083780,Greenfeld; Be'Eri,4,0,36,32
1657305191236,MATH 103A,B03,093562,Greenfeld; Be'Eri,3,0,36,33
1657305197258,MATH 105,A01,085443,Carter; Anne Toulson,15,0,35,20
1657305197258,MATH 105,A02,093477,Carter; Anne Toulson,20,0,35,15
1657305203287,MATH 109,A01,083213,Ganzberger; Geoffrey Michael,2,0,34,32
1657305203287,MATH 109,A02,083214,Ganzberger; Geoffrey Michael,4,0,34,30
1657305203287,MATH 109,A03,093478,Ganzberger; Geoffrey Michael,2,0,34,32
1657305203287,MATH 109,B01,083215,Ganzberger; Geoffrey Michael,1,0,32,31
1657305203287,MATH 109,B02,083216,Ganzberger; Geoffrey Michael,1,0,32,31
1657305203287,MATH 109,B03,093479,Ganzberger; Geoffrey Michael,8,0,32,24
1657305209316,MATH 142A,A01,083219,Chow; Bennett,7,0,32,25
1657305209316,MATH 142A,A02,083220,Chow; Bennett,10,0,32,22
1657305209316,MATH 142A,A03,093480,Chow; Bennett,7,0,32,25
1657305209316,MATH 142A,B03,093481,Chow; Bennett,8,0,32,24
1657305209316,MATH 142A,B04,093558,Chow; Bennett,12,0,32,20
1657305209316,MATH 142A,B05,093559,Chow; Bennett,6,0,32,26
1657305215341,MATH 193A,A01,083224,Rotar; Vladimir,7,0,34,27
1657305215341,MATH 193A,A02,083225,Rotar; Vladimir,7,0,34,27
1657305215341,MATH 193A,A03,083781,Rotar; Vladimir,3,0,34,31
1657305215341,MATH 193A,A04,083782,Rotar; Vladimir,8,0,34,26
1657305215341,MATH 193A,A05,093482,Rotar; Vladimir,8,0,34,26
1657305221365,MATH 197,001,091859,McAuley; Julian John,9999,0,9999,0
1657305221365,MATH 197,002,095566,Kedlaya; Kiran S.,9997,0,9999,2
1657305221365,MATH 197,003,095567,Xiao; Ming,9999,0,9999,0
1657305221365,MATH 197,004,095571,Perols; Johan Lars,9998,0,9999,1
1657305228440,COGS 9,A01,083615,Shannon; Kyle Michael,8,0,75,67
1657305234463,COGS 11,A01,083617,Boyle; Mary E. T.,22,0,48,26
1657305240495,COGS 13,A01,083071,Bastos; Amalia Pinkusfeld,10,0,71,61
1657305246530,COGS 14A,A01,092681,Semenuks; Arturs,2,1,100,98
1657305252567,COGS 14B,A01,083073,Cheng; Tzu-Han,6,0,63,57
1657305258595,COGS 17,A01,092677,Semenuks; Arturs,5,0,81,76
1657305264616,COGS 100,A01,083619,Allen; Michael Gordon,16,0,70,54
1657305270648,COGS 101A,A01,083621,Davis; Joshua Daniel,9,0,68,59
1657305276671,COGS 101B,A01,091572,Allen; Michael Gordon,11,0,65,54
1657305282697,COGS 101C,A01,083625,Delgado; Tania,17,0,35,18
1657305288720,COGS 107A,A01,083627,Boyle; Mary E. T.,13,0,60,47
1657305294743,COGS 118A,A01,083075,Gupta; Anjum,18,0,76,58
1657305300766,CSE 3,A50,083646,Miranda; Gregory Joseph,24,0,50,26
1657305306789,CSE 8A,A50,083650,Miranda; Gregory Joseph,17,1,56,39
1657305312819,CSE 11,A01,083080,Cao; Yingjun,6,15,40,34
1657305318852,CSE 12,A01,083652,Krause-Levy; Sophia Louisa,26,1,120,94
1657305324876,CSE 15L,A01,083654,Morris; Justin Loren,9,0,50,41
1657305324876,CSE 15L,A02,083655,Morris; Justin Loren,9,0,50,41
1657305330899,CSE 20,A01,083657,Tran; Khoa Dang,38,0,80,42
1657305336937,CSE 21,A01,095574,Bach; Quang Tran,22,0,48,26
1657305342959,CSE 30,A01,083084,Eldon; John,4,0,80,76
1657305342959,CSE 30,B01,095061,Bhaskar; Nishant,9,0,50,41
1657305348985,CSE 100,A01,083659,Cao; Yingjun,4,4,70,66
1657305355008,CSE 134B,A01,083661,Powell; Thomas Allan,21,0,100,79
1657305361035,CSE 140,A01,083663,Gungor; Onat,13,0,85,72
1657305367056,CSE 140L,A01,083088,Eldon; John,20,0,100,80
1657305373090,CSE 175,A01,083665,Kumar; Rakesh,3,0,25,22
1657305379112,CSE 190,A00,092507,Dubnov; Shlomo,7,0,20,13
1657305385152,ECE 45,A01,083139,Congero; Spencer William,6,0,75,69
1657305391174,ECE 65,A50,083695,Saad; Andrew S,12,0,30,18
1657305391174,ECE 65,A51,095125,Saad; Andrew S,25,0,26,1
1657305397199,ECE 109,A01,091882,Touri; Behrouz,19,0,70,51
1657305403222,ECE 180,A00,083140,Abi Samra; Nicholas Camill,1,0,30,29
1657305403222,ECE 180,B00,083141,Abi Samra; Nicholas Camill,0,0,30,30
1657305409246,MATH 10A,A01,083735,Patchell; Gregory David,2,0,30,28
1657305409246,MATH 10A,A02,083736,Patchell; Gregory David,20,0,30,10
1657305409246,MATH 10A,A03,083737,Patchell; Gregory David,16,0,30,14
1657305415274,MATH 10B,A01,083207,Lim; Seonhee,7,0,34,27
1657305415274,MATH 10B,A02,083208,Lim; Seonhee,9,0,35,26
1657305415274,MATH 10B,A03,093472,Lim; Seonhee,7,0,34,27
1657305415274,MATH 10B,B01,083739,Sinha; Shubham,11,0,30,19
1657305421297,MATH 18,A01,083743,Cinel; Cameron Alexander,6,0,30,24
1657305421297,MATH 18,A02,083744,Cinel; Cameron Alexander,17,0,30,13
1657305421297,MATH 18,A03,083745,Cinel; Cameron Alexander,8,0,30,22
1657305421297,MATH 18,B01,083748,Rideout; David Porter,4,0,37,33
1657305421297,MATH 18,B02,083749,Rideout; David Porter,4,0,36,32
1657305421297,MATH 18,B03,083750,Rideout; David Porter,2,0,37,35
1657305421297,MATH 18,B04,083751,Rideout; David Porter,6,0,36,30
1657305421297,MATH 18,B05,093473,Rideout; David Porter,5,0,36,31
1657305421297,MATH 18,B06,093474,Rideout; David Porter,5,0,36,31
1657305427322,MATH 20A,A01,083754,Zheng; Zequn,14,0,40,26
1657305433348,MATH 20B,A01,083756,Briones; Jor-el Thomas Caparas,3,0,36,33
1657305433348,MATH 20B,A02,083757,Briones; Jor-el Thomas Caparas,1,0,36,35
1657305433348,MATH 20B,A03,093475,Briones; Jor-el Thomas Caparas,2,0,36,34
1657305439375,MATH 20C,A01,083760,Briones; Jor-el Thomas Caparas,1,0,35,34
1657305439375,MATH 20C,A02,083761,Briones; Jor-el Thomas Caparas,8,0,35,27
1657305439375,MATH 20C,A03,093476,Briones; Jor-el Thomas Caparas,0,1,36,36
1657305439375,MATH 20C,B01,083762,Bach; Quang Tran,1,0,30,29
1657305445409,MATH 20D,A01,083765,Tran; Brian Kha,5,0,30,25
1657305445409,MATH 20D,A02,083766,Tran; Brian Kha,5,0,30,25
1657305445409,MATH 20D,A03,083767,Tran; Brian Kha,4,0,30,26
1657305451432,MATH 20E,A01,083771,Ganguly; Soumya,7,0,32,25
1657305451432,MATH 20E,A02,083772,Ganguly; Soumya,6,0,32,26
1657305451432,MATH 20E,B01,083773,Ciotti; Benjamin,19,0,35,16
1657305451432,MATH 20E,B02,083774,Ciotti; Benjamin,17,0,35,18
1657305457455,MATH 103A,A01,083777,Greenfeld; Be'Eri,3,0,36,33
1657305457455,MATH 103A,A02,083778,Greenfeld; Be'Eri,5,0,36,31
1657305457455,MATH 103A,A03,093561,Greenfeld; Be'Eri,4,0,36,32
1657305457455,MATH 103A,B01,083779,Greenfeld; Be'Eri,6,0,36,30
1657305457455,MATH 103A,B02,083780,Greenfeld; Be'Eri,4,0,36,32
1657305457455,MATH 103A,B03,093562,Greenfeld; Be'Eri,3,0,36,33
1657305463476,MATH 105,A01,085443,Carter; Anne Toulson,15,0,35,20
1657305463476,MATH 105,A02,093477,Carter; Anne Toulson,20,0,35,15
1657305469500,MATH 109,A01,083213,Ganzberger; Geoffrey Michael,2,0,34,32
1657305469500,MATH 109,A02,083214,Ganzberger; Geoffrey Michael,4,0,34,30
1657305469500,MATH 109,A03,093478,Ganzberger; Geoffrey Michael,2,0,34,32
1657305469500,MATH 109,B01,083215,Ganzberger; Geoffrey Michael,1,0,32,31
1657305469500,MATH 109,B02,083216,Ganzberger; Geoffrey Michael,1,0,32,31
1657305469500,MATH 109,B03,093479,Ganzberger; Geoffrey Michael,8,0,32,24
1657305475522,MATH 142A,A01,083219,Chow; Bennett,7,0,32,25
1657305475522,MATH 142A,A02,083220,Chow; Bennett,10,0,32,22
1657305475522,MATH 142A,A03,093480,Chow; Bennett,7,0,32,25
1657305475522,MATH 142A,B03,093481,Chow; Bennett,8,0,32,24
1657305475522,MATH 142A,B04,093558,Chow; Bennett,12,0,32,20
1657305475522,MATH 142A,B05,093559,Chow; Bennett,6,0,32,26
1657305481543,MATH 193A,A01,083224,Rotar; Vladimir,7,0,34,27
1657305481543,MATH 193A,A02,083225,Rotar; Vladimir,7,0,34,27
1657305481543,MATH 193A,A03,083781,Rotar; Vladimir,3,0,34,31
1657305481543,MATH 193A,A04,083782,Rotar; Vladimir,8,0,34,26
1657305481543,MATH 193A,A05,093482,Rotar; Vladimir,8,0,34,26
1657305487568,MATH 197,001,091859,McAuley; Julian John,9999,0,9999,0
1657305487568,MATH 197,002,095566,Kedlaya; Kiran S.,9997,0,9999,2
1657305487568,MATH 197,003,095567,Xiao; Ming,9999,0,9999,0
1657305487568,MATH 197,004,095571,Perols; Johan Lars,9998,0,9999,1
1657305494626,COGS 9,A01,083615,Shannon; Kyle Michael,8,0,75,67
1657305500648,COGS 11,A01,083617,Boyle; Mary E. T.,22,0,48,26
1657305506675,COGS 13,A01,083071,Bastos; Amalia Pinkusfeld,10,0,71,61
1657305512699,COGS 14A,A01,092681,Semenuks; Arturs,2,1,100,98
1657305518723,COGS 14B,A01,083073,Cheng; Tzu-Han,6,0,63,57
1657305524754,COGS 17,A01,092677,Semenuks; Arturs,5,0,81,76
1657305530776,COGS 100,A01,083619,Allen; Michael Gordon,16,0,70,54
1657305536801,COGS 101A,A01,083621,Davis; Joshua Daniel,9,0,68,59
1657305542821,COGS 101B,A01,091572,Allen; Michael Gordon,11,0,65,54
1657305548847,COGS 101C,A01,083625,Delgado; Tania,17,0,35,18
1657305554869,COGS 107A,A01,083627,Boyle; Mary E. T.,13,0,60,47
1657305560907,COGS 118A,A01,083075,Gupta; Anjum,18,0,76,58
1657305566936,CSE 3,A50,083646,Miranda; Gregory Joseph,24,0,50,26
1657305572957,CSE 8A,A50,083650,Miranda; Gregory Joseph,17,1,56,39
1657305578992,CSE 11,A01,083080,Cao; Yingjun,6,15,40,34
1657305585016,CSE 12,A01,083652,Krause-Levy; Sophia Louisa,26,1,120,94
1657305591037,CSE 15L,A01,083654,Morris; Justin Loren,9,0,50,41
1657305591037,CSE 15L,A02,083655,Morris; Justin Loren,9,0,50,41
1657305597066,CSE 20,A01,083657,Tran; Khoa Dang,38,0,80,42
1657305603091,CSE 21,A01,095574,Bach; Quang Tran,22,0,48,26
1657305609115,CSE 30,A01,083084,Eldon; John,4,0,80,76
1657305609115,CSE 30,B01,095061,Bhaskar; Nishant,9,0,50,41
1657305615155,CSE 100,A01,083659,Cao; Yingjun,4,4,70,66
1657305621182,CSE 134B,A01,083661,Powell; Thomas Allan,21,0,100,79
1657305627202,CSE 140,A01,083663,Gungor; Onat,13,0,85,72
1657305633228,CSE 140L,A01,083088,Eldon; John,20,0,100,80
1657305639250,CSE 175,A01,083665,Kumar; Rakesh,3,0,25,22
1657305645275,CSE 190,A00,092507,Dubnov; Shlomo,7,0,20,13
1657305651300,ECE 45,A01,083139,Congero; Spencer William,6,0,75,69
1657305657334,ECE 65,A50,083695,Saad; Andrew S,12,0,30,18
1657305657334,ECE 65,A51,095125,Saad; Andrew S,25,0,26,1
1657305663366,ECE 109,A01,091882,Touri; Behrouz,19,0,70,51
1657305669389,ECE 180,A00,083140,Abi Samra; Nicholas Camill,1,0,30,29
1657305669389,ECE 180,B00,083141,Abi Samra; Nicholas Camill,0,0,30,30
1657305675438,MATH 10A,A01,083735,Patchell; Gregory David,2,0,30,28
1657305675438,MATH 10A,A02,083736,Patchell; Gregory David,20,0,30,10
1657305675438,MATH 10A,A03,083737,Patchell; Gregory David,16,0,30,14
1657305681470,MATH 10B,A01,083207,Lim; Seonhee,7,0,34,27
1657305681470,MATH 10B,A02,083208,Lim; Seonhee,9,0,35,26
1657305681470,MATH 10B,A03,093472,Lim; Seonhee,7,0,34,27
1657305681470,MATH 10B,B01,083739,Sinha; Shubham,11,0,30,19
1657305687501,MATH 18,A01,083743,Cinel; Cameron Alexander,6,0,30,24
1657305687501,MATH 18,A02,083744,Cinel; Cameron Alexander,17,0,30,13
1657305687501,MATH 18,A03,083745,Cinel; Cameron Alexander,8,0,30,22
1657305687501,MATH 18,B01,083748,Rideout; David Porter,4,0,37,33
1657305687501,MATH 18,B02,083749,Rideout; David Porter,4,0,36,32
1657305687501,MATH 18,B03,083750,Rideout; David Porter,2,0,37,35
1657305687501,MATH 18,B04,083751,Rideout; David Porter,6,0,36,30
1657305687501,MATH 18,B05,093473,Rideout; David Porter,5,0,36,31
1657305687501,MATH 18,B06,093474,Rideout; David Porter,5,0,36,31
1657305693524,MATH 20A,A01,083754,Zheng; Zequn,14,0,40,26
1657305699557,MATH 20B,A01,083756,Briones; Jor-el Thomas Caparas,3,0,36,33
1657305699557,MATH 20B,A02,083757,Briones; Jor-el Thomas Caparas,1,0,36,35
1657305699557,MATH 20B,A03,093475,Briones; Jor-el Thomas Caparas,2,0,36,34
1657305705595,MATH 20C,A01,083760,Briones; Jor-el Thomas Caparas,1,0,35,34
1657305705595,MATH 20C,A02,083761,Briones; Jor-el Thomas Caparas,8,0,35,27
1657305705595,MATH 20C,A03,093476,Briones; Jor-el Thomas Caparas,0,1,36,36
1657305705595,MATH 20C,B01,083762,Bach; Quang Tran,1,0,30,29
1657305711618,MATH 20D,A01,083765,Tran; Brian Kha,5,0,30,25
1657305711618,MATH 20D,A02,083766,Tran; Brian Kha,5,0,30,25
1657305711618,MATH 20D,A03,083767,Tran; Brian Kha,4,0,30,26
1657305717640,MATH 20E,A01,083771,Ganguly; Soumya,7,0,32,25
1657305717640,MATH 20E,A02,083772,Ganguly; Soumya,6,0,32,26
1657305717640,MATH 20E,B01,083773,Ciotti; Benjamin,19,0,35,16
1657305717640,MATH 20E,B02,083774,Ciotti; Benjamin,17,0,35,18
1657305723675,MATH 103A,A01,083777,Greenfeld; Be'Eri,3,0,36,33
1657305723675,MATH 103A,A02,083778,Greenfeld; Be'Eri,5,0,36,31
1657305723675,MATH 103A,A03,093561,Greenfeld; Be'Eri,4,0,36,32
1657305723675,MATH 103A,B01,083779,Greenfeld; Be'Eri,6,0,36,30
1657305723675,MATH 103A,B02,083780,Greenfeld; Be'Eri,4,0,36,32
1657305723675,MATH 103A,B03,093562,Greenfeld; Be'Eri,3,0,36,33
1657305729702,MATH 105,A01,085443,Carter; Anne Toulson,15,0,35,20
1657305729702,MATH 105,A02,093477,Carter; Anne Toulson,20,0,35,15
1657305735727,MATH 109,A01,083213,Ganzberger; Geoffrey Michael,2,0,34,32
1657305735727,MATH 109,A02,083214,Ganzberger; Geoffrey Michael,4,0,34,30
1657305735727,MATH 109,A03,093478,Ganzberger; Geoffrey Michael,2,0,34,32
1657305735727,MATH 109,B01,083215,Ganzberger; Geoffrey Michael,1,0,32,31
1657305735727,MATH 109,B02,083216,Ganzberger; Geoffrey Michael,1,0,32,31
1657305735727,MATH 109,B03,093479,Ganzberger; Geoffrey Michael,8,0,32,24
1657305741837,MATH 142A,A01,083219,Chow; Bennett,7,0,32,25
1657305741837,MATH 142A,A02,083220,Chow; Bennett,10,0,32,22
1657305741837,MATH 142A,A03,093480,Chow; Bennett,7,0,32,25
1657305741837,MATH 142A,B03,093481,Chow; Bennett,8,0,32,24
1657305741837,MATH 142A,B04,093558,Chow; Bennett,12,0,32,20
1657305741837,MATH 142A,B05,093559,Chow; Bennett,6,0,32,26
1657305747861,MATH 193A,A01,083224,Rotar; Vladimir,7,0,34,27
1657305747861,MATH 193A,A02,083225,Rotar; Vladimir,7,0,34,27
1657305747861,MATH 193A,A03,083781,Rotar; Vladimir,3,0,34,31
1657305747861,MATH 193A,A04,083782,Rotar; Vladimir,8,0,34,26
1657305747861,MATH 193A,A05,093482,Rotar; Vladimir,8,0,34,26
1657305753888,MATH 197,001,091859,McAuley; Julian John,9999,0,9999,0
1657305753888,MATH 197,002,095566,Kedlaya; Kiran S.,9997,0,9999,2
1657305753888,MATH 197,003,095567,Xiao; Ming,9999,0,9999,0
1657305753888,MATH 197,004,095571,Perols; Johan Lars,9998,0,9999,1
1657305760944,COGS 9,A01,083615,Shannon; Kyle Michael,8,0,75,67
1657305766972,COGS 11,A01,083617,Boyle; Mary E. T.,22,0,48,26
1657305773015,COGS 13,A01,083071,Bastos; Amalia Pinkusfeld,10,0,71,61
1657305779041,COGS 14A,A01,092681,Semenuks; Arturs,2,1,100,98
1657305785067,COGS 14B,A01,083073,Cheng; Tzu-Han,6,0,63,57
1657305791090,COGS 17,A01,092677,Semenuks; Arturs,5,0,81,76
1657305797112,COGS 100,A01,083619,Allen; Michael Gordon,16,0,70,54
1657305803135,COGS 101A,A01,083621,Davis; Joshua Daniel,9,0,68,59
1657305809166,COGS 101B,A01,091572,Allen; Michael Gordon,11,0,65,54
1657305815192,COGS 101C,A01,083625,Delgado; Tania,17,0,35,18
1657305821214,COGS 107A,A01,083627,Boyle; Mary E. T.,13,0,60,47
1657305827240,COGS 118A,A01,083075,Gupta; Anjum,18,0,76,58
1657305833263,CSE 3,A50,083646,Miranda; Gregory Joseph,24,0,50,26
1657305839290,CSE 8A,A50,083650,Miranda; Gregory Joseph,17,1,56,39
1657305845316,CSE 11,A01,083080,Cao; Yingjun,6,15,40,34
1657305851347,CSE 12,A01,083652,Krause-Levy; Sophia Louisa,26,1,120,94
1657305857375,CSE 15L,A01,083654,Morris; Justin Loren,9,0,50,41
1657305857375,CSE 15L,A02,083655,Morris; Justin Loren,9,0,50,41
1657305863408,CSE 20,A01,083657,Tran; Khoa Dang,38,0,80,42
1657305869443,CSE 21,A01,095574,Bach; Quang Tran,22,0,48,26
1657305875467,CSE 30,A01,083084,Eldon; John,4,0,80,76
1657305875467,CSE 30,B01,095061,Bhaskar; Nishant,9,0,50,41
1657305881493,CSE 100,A01,083659,Cao; Yingjun,4,4,70,66
1657305887526,CSE 134B,A01,083661,Powell; Thomas Allan,21,0,100,79
1657305893551,CSE 140,A01,083663,Gungor; Onat,13,0,85,72
1657305899582,CSE 140L,A01,083088,Eldon; John,20,0,100,80
1657305905609,CSE 175,A01,083665,Kumar; Rakesh,3,0,25,22
1657305911632,CSE 190,A00,092507,Dubnov; Shlomo,7,0,20,13
1657305917656,ECE 45,A01,083139,Congero; Spencer William,6,0,75,69
1657305923683,ECE 65,A50,083695,Saad; Andrew S,12,0,30,18
1657305923683,ECE 65,A51,095125,Saad; Andrew S,25,0,26,1
1657305929705,ECE 109,A01,091882,Touri; Behrouz,19,0,70,51
1657305935727,ECE 180,A00,083140,Abi Samra; Nicholas Camill,1,0,30,29
1657305935727,ECE 180,B00,083141,Abi Samra; Nicholas Camill,0,0,30,30
1657305941753,MATH 10A,A01,083735,Patchell; Gregory David,2,0,30,28
1657305941753,MATH 10A,A02,083736,Patchell; Gregory David,20,0,30,10
1657305941753,MATH 10A,A03,083737,Patchell; Gregory David,16,0,30,14
1657305947780,MATH 10B,A01,083207,Lim; Seonhee,7,0,34,27
1657305947780,MATH 10B,A02,083208,Lim; Seonhee,9,0,35,26
1657305947780,MATH 10B,A03,093472,Lim; Seonhee,7,0,34,27
1657305947780,MATH 10B,B01,083739,Sinha; Shubham,11,0,30,19
1657305953810,MATH 18,A01,083743,Cinel; Cameron Alexander,6,0,30,24
1657305953810,MATH 18,A02,083744,Cinel; Cameron Alexander,17,0,30,13
1657305953810,MATH 18,A03,083745,Cinel; Cameron Alexander,8,0,30,22
1657305953810,MATH 18,B01,083748,Rideout; David Porter,4,0,37,33
1657305953810,MATH 18,B02,083749,Rideout; David Porter,4,0,36,32
1657305953810,MATH 18,B03,083750,Rideout; David Porter,2,0,37,35
1657305953810,MATH 18,B04,083751,Rideout; David Porter,6,0,36,30
1657305953810,MATH 18,B05,093473,Rideout; David Porter,5,0,36,31
1657305953810,MATH 18,B06,093474,Rideout; David Porter,5,0,36,31
1657305959835,MATH 20A,A01,083754,Zheng; Zequn,14,0,40,26
1657305965859,MATH 20B,A01,083756,Briones; Jor-el Thomas Caparas,3,0,36,33
1657305965859,MATH 20B,A02,083757,Briones; Jor-el Thomas Caparas,1,0,36,35
1657305965859,MATH 20B,A03,093475,Briones; Jor-el Thomas Caparas,2,0,36,34
1657305971882,MATH 20C,A01,083760,Briones; Jor-el Thomas Caparas,1,0,35,34
1657305971882,MATH 20C,A02,083761,Briones; Jor-el Thomas Caparas,8,0,35,27
1657305971882,MATH 20C,A03,093476,Briones; Jor-el Thomas Caparas,0,1,36,36
1657305971882,MATH 20C,B01,083762,Bach; Quang Tran,1,0,30,29
1657305977906,MATH 20D,A01,083765,Tran; Brian Kha,5,0,30,25
1657305977906,MATH 20D,A02,083766,Tran; Brian Kha,5,0,30,25
1657305977906,MATH 20D,A03,083767,Tran; Brian Kha,4,0,30,26
1657305983934,MATH 20E,A01,083771,Ganguly; Soumya,7,0,32,25
1657305983934,MATH 20E,A02,083772,Ganguly; Soumya,6,0,32,26
1657305983934,MATH 20E,B01,083773,Ciotti; Benjamin,19,0,35,16
1657305983934,MATH 20E,B02,083774,Ciotti; Benjamin,17,0,35,18
1657305989957,MATH 103A,A01,083777,Greenfeld; Be'Eri,3,0,36,33
1657305989957,MATH 103A,A02,083778,Greenfeld; Be'Eri,5,0,36,31
1657305989957,MATH 103A,A03,093561,Greenfeld; Be'Eri,4,0,36,32
1657305989957,MATH 103A,B01,083779,Greenfeld; Be'Eri,6,0,36,30
1657305989957,MATH 103A,B02,083780,Greenfeld; Be'Eri,4,0,36,32
1657305989957,MATH 103A,B03,093562,Greenfeld; Be'Eri,3,0,36,33
1657305995988,MATH 105,A01,085443,Carter; Anne Toulson,15,0,35,20
1657305995988,MATH 105,A02,093477,Carter; Anne Toulson,20,0,35,15
1657306002016,MATH 109,A01,083213,Ganzberger; Geoffrey Michael,2,0,34,32
1657306002016,MATH 109,A02,083214,Ganzberger; Geoffrey Michael,4,0,34,30
1657306002016,MATH 109,A03,093478,Ganzberger; Geoffrey Michael,2,0,34,32
1657306002016,MATH 109,B01,083215,Ganzberger; Geoffrey Michael,1,0,32,31
1657306002016,MATH 109,B02,083216,Ganzberger; Geoffrey Michael,1,0,32,31
1657306002016,MATH 109,B03,093479,Ganzberger; Geoffrey Michael,8,0,32,24
1657306008044,MATH 142A,A01,083219,Chow; Bennett,7,0,32,25
1657306008044,MATH 142A,A02,083220,Chow; Bennett,10,0,32,22
1657306008044,MATH 142A,A03,093480,Chow; Bennett,7,0,32,25
1657306008044,MATH 142A,B03,093481,Chow; Bennett,8,0,32,24
1657306008044,MATH 142A,B04,093558,Chow; Bennett,12,0,32,20
1657306008044,MATH 142A,B05,093559,Chow; Bennett,6,0,32,26
1657306014069,MATH 193A,A01,083224,Rotar; Vladimir,7,0,34,27
1657306014069,MATH 193A,A02,083225,Rotar; Vladimir,7,0,34,27
1657306014069,MATH 193A,A03,083781,Rotar; Vladimir,3,0,34,31
1657306014069,MATH 193A,A04,083782,Rotar; Vladimir,8,0,34,26
1657306014069,MATH 193A,A05,093482,Rotar; Vladimir,8,0,34,26
1657306020094,MATH 197,001,091859,McAuley; Julian John,9999,0,9999,0
1657306020094,MATH 197,002,095566,Kedlaya; Kiran S.,9997,0,9999,2
1657306020094,MATH 197,003,095567,Xiao; Ming,9999,0,9999,0
1657306020094,MATH 197,004,095571,Perols; Johan Lars,9998,0,9999,1
1657306027161,COGS 9,A01,083615,Shannon; Kyle Michael,8,0,75,67
1657306033187,COGS 11,A01,083617,Boyle; Mary E. T.,22,0,48,26
1657306039215,COGS 13,A01,083071,Bastos; Amalia Pinkusfeld,10,0,71,61
1657306045256,COGS 14A,A01,092681,Semenuks; Arturs,2,1,100,98
1657306051282,COGS 14B,A01,083073,Cheng; Tzu-Han,6,0,63,57
1657306057305,COGS 17,A01,092677,Semenuks; Arturs,5,0,81,76
1657306063327,COGS 100,A01,083619,Allen; Michael Gordon,16,0,70,54
1657306069354,COGS 101A,A01,083621,Davis; Joshua Daniel,9,0,68,59
1657306075381,COGS 101B,A01,091572,Allen; Michael Gordon,11,0,65,54
1657306081404,COGS 101C,A01,083625,Delgado; Tania,17,0,35,18
1657306087428,COGS 107A,A01,083627,Boyle; Mary E. T.,13,0,60,47
1657306093451,COGS 118A,A01,083075,Gupta; Anjum,18,0,76,58
1657306099474,CSE 3,A50,083646,Miranda; Gregory Joseph,24,0,50,26
1657306105501,CSE 8A,A50,083650,Miranda; Gregory Joseph,17,1,56,39
1657306111526,CSE 11,A01,083080,Cao; Yingjun,6,15,40,34
1657306117555,CSE 12,A01,083652,Krause-Levy; Sophia Louisa,26,1,120,94
1657306123580,CSE 15L,A01,083654,Morris; Justin Loren,9,0,50,41
1657306123580,CSE 15L,A02,083655,Morris; Justin Loren,9,0,50,41
1657306129602,CSE 20,A01,083657,Tran; Khoa Dang,38,0,80,42
1657306135624,CSE 21,A01,095574,Bach; Quang Tran,22,0,48,26
1657306141646,CSE 30,A01,083084,Eldon; John,4,0,80,76
1657306141646,CSE 30,B01,095061,Bhaskar; Nishant,9,0,50,41
1657306147668,CSE 100,A01,083659,Cao; Yingjun,4,4,70,66
1657306153694,CSE 134B,A01,083661,Powell; Thomas Allan,21,0,100,79
1657306159721,CSE 140,A01,083663,Gungor; Onat,13,0,85,72
1657306165748,CSE 140L,A01,083088,Eldon; John,20,0,100,80
1657306171773,CSE 175,A01,083665,Kumar; Rakesh,3,0,25,22
1657306177798,CSE 190,A00,092507,Dubnov; Shlomo,7,0,20,13
1657306183821,ECE 45,A01,083139,Congero; Spencer William,6,0,75,69
1657306189844,ECE 65,A50,083695,Saad; Andrew S,12,0,30,18
1657306189844,ECE 65,A51,095125,Saad; Andrew S,25,0,26,1
1657306195870,ECE 109,A01,091882,Touri; Behrouz,19,0,70,51
1657306201893,ECE 180,A00,083140,Abi Samra; Nicholas Camill,1,0,30,29
1657306201893,ECE 180,B00,083141,Abi Samra; Nicholas Camill,0,0,30,30
1657306207919,MATH 10A,A01,083735,Patchell; Gregory David,2,0,30,28
1657306207919,MATH 10A,A02,083736,Patchell; Gregory David,20,0,30,10
1657306207919,MATH 10A,A03,083737,Patchell; Gregory David,16,0,30,14
1657306213944,MATH 10B,A01,083207,Lim; Seonhee,7,0,34,27
1657306213944,MATH 10B,A02,083208,Lim; Seonhee,9,0,35,26
1657306213944,MATH 10B,A03,093472,Lim; Seonhee,7,0,34,27
1657306213944,MATH 10B,B01,083739,Sinha; Shubham,11,0,30,19
1657306219970,MATH 18,A01,083743,Cinel; Cameron Alexander,6,0,30,24
1657306219970,MATH 18,A02,083744,Cinel; Cameron Alexander,17,0,30,13
1657306219970,MATH 18,A03,083745,Cinel; Cameron Alexander,8,0,30,22
1657306219970,MATH 18,B01,083748,Rideout; David Porter,4,0,37,33
1657306219970,MATH 18,B02,083749,Rideout; David Porter,4,0,36,32
1657306219970,MATH 18,B03,083750,Rideout; David Porter,2,0,37,35
1657306219970,MATH 18,B04,083751,Rideout; David Porter,6,0,36,30
1657306219970,MATH 18,B05,093473,Rideout; David Porter,5,0,36,31
1657306219970,MATH 18,B06,093474,Rideout; David Porter,5,0,36,31
1657306225993,MATH 20A,A01,083754,Zheng; Zequn,14,0,40,26
1657306232016,MATH 20B,A01,083756,Briones; Jor-el Thomas Caparas,3,0,36,33
1657306232016,MATH 20B,A02,083757,Briones; Jor-el Thomas Caparas,1,0,36,35
1657306232016,MATH 20B,A03,093475,Briones; Jor-el Thomas Caparas,2,0,36,34
1657306238040,MATH 20C,A01,083760,Briones; Jor-el Thomas Caparas,1,0,35,34
1657306238040,MATH 20C,A02,083761,Briones; Jor-el Thomas Caparas,8,0,35,27
1657306238040,MATH 20C,A03,093476,Briones; Jor-el Thomas Caparas,0,1,36,36
1657306238040,MATH 20C,B01,083762,Bach; Quang Tran,1,0,30,29
1657306244063,MATH 20D,A01,083765,Tran; Brian Kha,5,0,30,25
1657306244063,MATH 20D,A02,083766,Tran; Brian Kha,5,0,30,25
1657306244063,MATH 20D,A03,083767,Tran; Brian Kha,4,0,30,26
1657306250089,MATH 20E,A01,083771,Ganguly; Soumya,7,0,32,25
1657306250089,MATH 20E,A02,083772,Ganguly; Soumya,6,0,32,26
1657306250089,MATH 20E,B01,083773,Ciotti; Benjamin,19,0,35,16
1657306250089,MATH 20E,B02,083774,Ciotti; Benjamin,17,0,35,18
1657306256112,MATH 103A,A01,083777,Greenfeld; Be'Eri,3,0,36,33
1657306256112,MATH 103A,A02,083778,Greenfeld; Be'Eri,5,0,36,31
1657306256112,MATH 103A,A03,093561,Greenfeld; Be'Eri,4,0,36,32
1657306256112,MATH 103A,B01,083779,Greenfeld; Be'Eri,6,0,36,30
1657306256112,MATH 103A,B02,083780,Greenfeld; Be'Eri,4,0,36,32
1657306256112,MATH 103A,B03,093562,Greenfeld; Be'Eri,3,0,36,33
1657306262142,MATH 105,A01,085443,Carter; Anne Toulson,15,0,35,20
1657306262142,MATH 105,A02,093477,Carter; Anne Toulson,20,0,35,15
1657306268164,MATH 109,A01,083213,Ganzberger; Geoffrey Michael,2,0,34,32
1657306268164,MATH 109,A02,083214,Ganzberger; Geoffrey Michael,4,0,34,30
1657306268164,MATH 109,A03,093478,Ganzberger; Geoffrey Michael,2,0,34,32
1657306268164,MATH 109,B01,083215,Ganzberger; Geoffrey Michael,1,0,32,31
1657306268164,MATH 109,B02,083216,Ganzberger; Geoffrey Michael,1,0,32,31
1657306268164,MATH 109,B03,093479,Ganzberger; Geoffrey Michael,8,0,32,24
1657306274192,MATH 142A,A01,083219,Chow; Bennett,7,0,32,25
1657306274192,MATH 142A,A02,083220,Chow; Bennett,10,0,32,22
1657306274192,MATH 142A,A03,093480,Chow; Bennett,7,0,32,25
1657306274192,MATH 142A,B03,093481,Chow; Bennett,8,0,32,24
1657306274192,MATH 142A,B04,093558,Chow; Bennett,12,0,32,20
1657306274192,MATH 142A,B05,093559,Chow; Bennett,6,0,32,26
1657306280215,MATH 193A,A01,083224,Rotar; Vladimir,7,0,34,27
1657306280215,MATH 193A,A02,083225,Rotar; Vladimir,7,0,34,27
1657306280215,MATH 193A,A03,083781,Rotar; Vladimir,3,0,34,31
1657306280215,MATH 193A,A04,083782,Rotar; Vladimir,8,0,34,26
1657306280215,MATH 193A,A05,093482,Rotar; Vladimir,8,0,34,26
1657306286240,MATH 197,001,091859,McAuley; Julian John,9999,0,9999,0
1657306286240,MATH 197,002,095566,Kedlaya; Kiran S.,9997,0,9999,2
1657306286240,MATH 197,003,095567,Xiao; Ming,9999,0,9999,0
1657306286240,MATH 197,004,095571,Perols; Johan Lars,9998,0,9999,1
1657306293302,COGS 9,A01,083615,Shannon; Kyle Michael,8,0,75,67
1657306299329,COGS 11,A01,083617,Boyle; Mary E. T.,22,0,48,26
1657306305359,COGS 13,A01,083071,Bastos; Amalia Pinkusfeld,10,0,71,61
1657306311386,COGS 14A,A01,092681,Semenuks; Arturs,2,1,100,98
1657306317418,COGS 14B,A01,083073,Cheng; Tzu-Han,6,0,63,57
1657306323440,COGS 17,A01,092677,Semenuks; Arturs,5,0,81,76
1657306329468,COGS 100,A01,083619,Allen; Michael Gordon,16,0,70,54
1657306335584,COGS 101A,A01,083621,Davis; Joshua Daniel,9,0,68,59
1657306341611,COGS 101B,A01,091572,Allen; Michael Gordon,11,0,65,54
1657306347633,COGS 101C,A01,083625,Delgado; Tania,17,0,35,18
1657306353656,COGS 107A,A01,083627,Boyle; Mary E. T.,13,0,60,47
1657306359682,COGS 118A,A01,083075,Gupta; Anjum,18,0,76,58
1657306365712,CSE 3,A50,083646,Miranda; Gregory Joseph,24,0,50,26
1657306371744,CSE 8A,A50,083650,Miranda; Gregory Joseph,17,1,56,39
1657306377770,CSE 11,A01,083080,Cao; Yingjun,6,15,40,34
1657306383796,CSE 12,A01,083652,Krause-Levy; Sophia Louisa,26,1,120,94
1657306389821,CSE 15L,A01,083654,Morris; Justin Loren,9,0,50,41
1657306389821,CSE 15L,A02,083655,Morris; Justin Loren,9,0,50,41
1657306395844,CSE 20,A01,083657,Tran; Khoa Dang,38,0,80,42
1657306401866,CSE 21,A01,095574,Bach; Quang Tran,22,0,48,26
1657306407905,CSE 30,A01,083084,Eldon; John,4,0,80,76
1657306407905,CSE 30,B01,095061,Bhaskar; Nishant,9,0,50,41
1657306413932,CSE 100,A01,083659,Cao; Yingjun,4,4,70,66
1657306419954,CSE 134B,A01,083661,Powell; Thomas Allan,21,0,100,79
1657306425984,CSE 140,A01,083663,Gungor; Onat,13,0,85,72
1657306432009,CSE 140L,A01,083088,Eldon; John,20,0,100,80
1657306438033,CSE 175,A01,083665,Kumar; Rakesh,3,0,25,22
1657306444058,CSE 190,A00,092507,Dubnov; Shlomo,7,0,20,13
1657306450085,ECE 45,A01,083139,Congero; Spencer William,6,0,75,69
1657306456113,ECE 65,A50,083695,Saad; Andrew S,12,0,30,18
1657306456113,ECE 65,A51,095125,Saad; Andrew S,25,0,26,1
1657306462137,ECE 109,A01,091882,Touri; Behrouz,19,0,70,51
1657306468160,ECE 180,A00,083140,Abi Samra; Nicholas Camill,1,0,30,29
1657306468160,ECE 180,B00,083141,Abi Samra; Nicholas Camill,0,0,30,30
1657306474190,MATH 10A,A01,083735,Patchell; Gregory David,2,0,30,28
1657306474190,MATH 10A,A02,083736,Patchell; Gregory David,20,0,30,10
1657306474190,MATH 10A,A03,083737,Patchell; Gregory David,16,0,30,14
1657306480213,MATH 10B,A01,083207,Lim; Seonhee,7,0,34,27
1657306480213,MATH 10B,A02,083208,Lim; Seonhee,9,0,35,26
1657306480213,MATH 10B,A03,093472,Lim; Seonhee,7,0,34,27
1657306480213,MATH 10B,B01,083739,Sinha; Shubham,11,0,30,19
1657306486237,MATH 18,A01,083743,Cinel; Cameron Alexander,6,0,30,24
1657306486237,MATH 18,A02,083744,Cinel; Cameron Alexander,17,0,30,13
1657306486237,MATH 18,A03,083745,Cinel; Cameron Alexander,8,0,30,22
1657306486237,MATH 18,B01,083748,Rideout; David Porter,4,0,37,33
1657306486237,MATH 18,B02,083749,Rideout; David Porter,4,0,36,32
1657306486237,MATH 18,B03,083750,Rideout; David Porter,2,0,37,35
1657306486237,MATH 18,B04,083751,Rideout; David Porter,6,0,36,30
1657306486237,MATH 18,B05,093473,Rideout; David Porter,5,0,36,31
1657306486237,MATH 18,B06,093474,Rideout; David Porter,5,0,36,31
1657306492259,MATH 20A,A01,083754,Zheng; Zequn,14,0,40,26
1657306498286,MATH 20B,A01,083756,Briones; Jor-el Thomas Caparas,3,0,36,33
1657306498286,MATH 20B,A02,083757,Briones; Jor-el Thomas Caparas,1,0,36,35
1657306498286,MATH 20B,A03,093475,Briones; Jor-el Thomas Caparas,2,0,36,34
1657306504314,MATH 20C,A01,083760,Briones; Jor-el Thomas Caparas,1,0,35,34
1657306504314,MATH 20C,A02,083761,Briones; Jor-el Thomas Caparas,8,0,35,27
1657306504314,MATH 20C,A03,093476,Briones; Jor-el Thomas Caparas,0,1,36,36
1657306504314,MATH 20C,B01,083762,Bach; Quang Tran,1,0,30,29
1657306510335,MATH 20D,A01,083765,Tran; Brian Kha,5,0,30,25
1657306510335,MATH 20D,A02,083766,Tran; Brian Kha,5,0,30,25
1657306510335,MATH 20D,A03,083767,Tran; Brian Kha,4,0,30,26
1657306516366,MATH 20E,A01,083771,Ganguly; Soumya,7,0,32,25
1657306516366,MATH 20E,A02,083772,Ganguly; Soumya,6,0,32,26
1657306516366,MATH 20E,B01,083773,Ciotti; Benjamin,19,0,35,16
1657306516366,MATH 20E,B02,083774,Ciotti; Benjamin,17,0,35,18
1657306522395,MATH 103A,A01,083777,Greenfeld; Be'Eri,3,0,36,33
1657306522395,MATH 103A,A02,083778,Greenfeld; Be'Eri,5,0,36,31
1657306522395,MATH 103A,A03,093561,Greenfeld; Be'Eri,4,0,36,32
1657306522395,MATH 103A,B01,083779,Greenfeld; Be'Eri,6,0,36,30
1657306522395,MATH 103A,B02,083780,Greenfeld; Be'Eri,4,0,36,32
1657306522395,MATH 103A,B03,093562,Greenfeld; Be'Eri,3,0,36,33
1657306528427,MATH 105,A01,085443,Carter; Anne Toulson,15,0,35,20
1657306528427,MATH 105,A02,093477,Carter; Anne Toulson,20,0,35,15
1657306534450,MATH 109,A01,083213,Ganzberger; Geoffrey Michael,2,0,34,32
1657306534450,MATH 109,A02,083214,Ganzberger; Geoffrey Michael,4,0,34,30
1657306534450,MATH 109,A03,093478,Ganzberger; Geoffrey Michael,2,0,34,32
1657306534450,MATH 109,B01,083215,Ganzberger; Geoffrey Michael,1,0,32,31
1657306534450,MATH 109,B02,083216,Ganzberger; Geoffrey Michael,1,0,32,31
1657306534450,MATH 109,B03,093479,Ganzberger; Geoffrey Michael,8,0,32,24
1657306540473,MATH 142A,A01,083219,Chow; Bennett,7,0,32,25
1657306540473,MATH 142A,A02,083220,Chow; Bennett,10,0,32,22
1657306540473,MATH 142A,A03,093480,Chow; Bennett,7,0,32,25
1657306540473,MATH 142A,B03,093481,Chow; Bennett,8,0,32,24
1657306540473,MATH 142A,B04,093558,Chow; Bennett,12,0,32,20
1657306540473,MATH 142A,B05,093559,Chow; Bennett,6,0,32,26
1657306546499,MATH 193A,A01,083224,Rotar; Vladimir,7,0,34,27
1657306546499,MATH 193A,A02,083225,Rotar; Vladimir,7,0,34,27
1657306546499,MATH 193A,A03,083781,Rotar; Vladimir,3,0,34,31
1657306546499,MATH 193A,A04,083782,Rotar; Vladimir,8,0,34,26
1657306546499,MATH 193A,A05,093482,Rotar; Vladimir,8,0,34,26
1657306552531,MATH 197,001,091859,McAuley; Julian John,9999,0,9999,0
1657306552531,MATH 197,002,095566,Kedlaya; Kiran S.,9997,0,9999,2
1657306552531,MATH 197,003,095567,Xiao; Ming,9999,0,9999,0
1657306552531,MATH 197,004,095571,Perols; Johan Lars,9998,0,9999,1
1657306559601,COGS 9,A01,083615,Shannon; Kyle Michael,8,0,75,67
1657306565628,COGS 11,A01,083617,Boyle; Mary E. T.,22,0,48,26
1657306571652,COGS 13,A01,083071,Bastos; Amalia Pinkusfeld,10,0,71,61
1657306577684,COGS 14A,A01,092681,Semenuks; Arturs,2,1,100,98
1657306583707,COGS 14B,A01,083073,Cheng; Tzu-Han,6,0,63,57
1657306589728,COGS 17,A01,092677,Semenuks; Arturs,5,0,81,76
1657306595754,COGS 100,A01,083619,Allen; Michael Gordon,16,0,70,54
1657306601780,COGS 101A,A01,083621,Davis; Joshua Daniel,9,0,68,59
1657306607813,COGS 101B,A01,091572,Allen; Michael Gordon,11,0,65,54
1657306613842,COGS 101C,A01,083625,Delgado; Tania,17,0,35,18
1657306619868,COGS 107A,A01,083627,Boyle; Mary E. T.,13,0,60,47
1657306625894,COGS 118A,A01,083075,Gupta; Anjum,18,0,76,58
1657306631921,CSE 3,A50,083646,Miranda; Gregory Joseph,24,0,50,26
1657306637943,CSE 8A,A50,083650,Miranda; Gregory Joseph,17,1,56,39
1657306643968,CSE 11,A01,083080,Cao; Yingjun,6,15,40,34
1657306649990,CSE 12,A01,083652,Krause-Levy; Sophia Louisa,26,1,120,94
1657306656012,CSE 15L,A01,083654,Morris; Justin Loren,9,0,50,41
1657306656012,CSE 15L,A02,083655,Morris; Justin Loren,9,0,50,41
1657306662039,CSE 20,A01,083657,Tran; Khoa Dang,38,0,80,42
1657306668061,CSE 21,A01,095574,Bach; Quang Tran,22,0,48,26
1657306674084,CSE 30,A01,083084,Eldon; John,4,0,80,76
1657306674084,CSE 30,B01,095061,Bhaskar; Nishant,9,0,50,41
1657306680106,CSE 100,A01,083659,Cao; Yingjun,4,4,70,66
1657306686128,CSE 134B,A01,083661,Powell; Thomas Allan,21,0,100,79
1657306692154,CSE 140,A01,083663,Gungor; Onat,13,0,85,72
1657306698182,CSE 140L,A01,083088,Eldon; John,20,0,100,80
1657306704204,CSE 175,A01,083665,Kumar; Rakesh,3,0,25,22
1657306710228,CSE 190,A00,092507,Dubnov; Shlomo,7,0,20,13
1657306716258,ECE 45,A01,083139,Congero; Spencer William,6,0,75,69
1657306722281,ECE 65,A50,083695,Saad; Andrew S,12,0,30,18
1657306722281,ECE 65,A51,095125,Saad; Andrew S,25,0,26,1
1657306728306,ECE 109,A01,091882,Touri; Behrouz,19,0,70,51
1657306734328,ECE 180,A00,083140,Abi Samra; Nicholas Camill,1,0,30,29
1657306734328,ECE 180,B00,083141,Abi Samra; Nicholas Camill,0,0,30,30
1657306740351,MATH 10A,A01,083735,Patchell; Gregory David,2,0,30,28
1657306740351,MATH 10A,A02,083736,Patchell; Gregory David,20,0,30,10
1657306740351,MATH 10A,A03,083737,Patchell; Gregory David,16,0,30,14
1657306746379,MATH 10B,A01,083207,Lim; Seonhee,7,0,34,27
1657306746379,MATH 10B,A02,083208,Lim; Seonhee,9,0,35,26
1657306746379,MATH 10B,A03,093472,Lim; Seonhee,7,0,34,27
1657306746379,MATH 10B,B01,083739,Sinha; Shubham,11,0,30,19
1657306752410,MATH 18,A01,083743,Cinel; Cameron Alexander,6,0,30,24
1657306752410,MATH 18,A02,083744,Cinel; Cameron Alexander,17,0,30,13
1657306752410,MATH 18,A03,083745,Cinel; Cameron Alexander,8,0,30,22
1657306752410,MATH 18,B01,083748,Rideout; David Porter,4,0,37,33
1657306752410,MATH 18,B02,083749,Rideout; David Porter,4,0,36,32
1657306752410,MATH 18,B03,083750,Rideout; David Porter,2,0,37,35
1657306752410,MATH 18,B04,083751,Rideout; David Porter,6,0,36,30
1657306752410,MATH 18,B05,093473,Rideout; David Porter,5,0,36,31
1657306752410,MATH 18,B06,093474,Rideout; David Porter,5,0,36,31
1657306758432,MATH 20A,A01,083754,Zheng; Zequn,14,0,40,26
1657306764460,MATH 20B,A01,083756,Briones; Jor-el Thomas Caparas,3,0,36,33
1657306764460,MATH 20B,A02,083757,Briones; Jor-el Thomas Caparas,1,0,36,35
1657306764460,MATH 20B,A03,093475,Briones; Jor-el Thomas Caparas,2,0,36,34
1657306770482,MATH 20C,A01,083760,Briones; Jor-el Thomas Caparas,1,0,35,34
1657306770482,MATH 20C,A02,083761,Briones; Jor-el Thomas Caparas,8,0,35,27
1657306770482,MATH 20C,A03,093476,Briones; Jor-el Thomas Caparas,0,1,36,36
1657306770482,MATH 20C,B01,083762,Bach; Quang Tran,1,0,30,29
1657306776506,MATH 20D,A01,083765,Tran; Brian Kha,5,0,30,25
1657306776506,MATH 20D,A02,083766,Tran; Brian Kha,5,0,30,25
1657306776506,MATH 20D,A03,083767,Tran; Brian Kha,4,0,30,26
1657306782538,MATH 20E,A01,083771,Ganguly; Soumya,7,0,32,25
1657306782538,MATH 20E,A02,083772,Ganguly; Soumya,6,0,32,26
1657306782538,MATH 20E,B01,083773,Ciotti; Benjamin,19,0,35,16
1657306782538,MATH 20E,B02,083774,Ciotti; Benjamin,17,0,35,18
1657306788571,MATH 103A,A01,083777,Greenfeld; Be'Eri,3,0,36,33
1657306788571,MATH 103A,A02,083778,Greenfeld; Be'Eri,5,0,36,31
1657306788571,MATH 103A,A03,093561,Greenfeld; Be'Eri,4,0,36,32
1657306788571,MATH 103A,B01,083779,Greenfeld; Be'Eri,6,0,36,30
1657306788571,MATH 103A,B02,083780,Greenfeld; Be'Eri,4,0,36,32
1657306788571,MATH 103A,B03,093562,Greenfeld; Be'Eri,3,0,36,33
1657306794593,MATH 105,A01,085443,Carter; Anne Toulson,15,0,35,20
1657306794593,MATH 105,A02,093477,Carter; Anne Toulson,20,0,35,15
1657306800634,MATH 109,A01,083213,Ganzberger; Geoffrey Michael,2,0,34,32
1657306800634,MATH 109,A02,083214,Ganzberger; Geoffrey Michael,4,0,34,30
1657306800634,MATH 109,A03,093478,Ganzberger; Geoffrey Michael,2,0,34,32
1657306800634,MATH 109,B01,083215,Ganzberger; Geoffrey Michael,1,0,32,31
1657306800634,MATH 109,B02,083216,Ganzberger; Geoffrey Michael,1,0,32,31
1657306800634,MATH 109,B03,093479,Ganzberger; Geoffrey Michael,8,0,32,24
1657306806657,MATH 142A,A01,083219,Chow; Bennett,7,0,32,25
1657306806657,MATH 142A,A02,083220,Chow; Bennett,10,0,32,22
1657306806657,MATH 142A,A03,093480,Chow; Bennett,7,0,32,25
1657306806657,MATH 142A,B03,093481,Chow; Bennett,8,0,32,24
1657306806657,MATH 142A,B04,093558,Chow; Bennett,12,0,32,20
1657306806657,MATH 142A,B05,093559,Chow; Bennett,6,0,32,26
1657306812685,MATH 193A,A01,083224,Rotar; Vladimir,7,0,34,27
1657306812685,MATH 193A,A02,083225,Rotar; Vladimir,7,0,34,27
1657306812685,MATH 193A,A03,083781,Rotar; Vladimir,3,0,34,31
1657306812685,MATH 193A,A04,083782,Rotar; Vladimir,8,0,34,26
1657306812685,MATH 193A,A05,093482,Rotar; Vladimir,8,0,34,26
1657306818710,MATH 197,001,091859,McAuley; Julian John,9999,0,9999,0
1657306818710,MATH 197,002,095566,Kedlaya; Kiran S.,9997,0,9999,2
1657306818710,MATH 197,003,095567,Xiao; Ming,9999,0,9999,0
1657306818710,MATH 197,004,095571,Perols; Johan Lars,9998,0,9999,1
1657306825778,COGS 9,A01,083615,Shannon; Kyle Michael,8,0,75,67
1657306831803,COGS 11,A01,083617,Boyle; Mary E. T.,22,0,48,26
1657306837827,COGS 13,A01,083071,Bastos; Amalia Pinkusfeld,10,0,71,61
1657306843849,COGS 14A,A01,092681,Semenuks; Arturs,2,1,100,98
1657306849874,COGS 14B,A01,083073,Cheng; Tzu-Han,6,0,63,57
1657306855897,COGS 17,A01,092677,Semenuks; Arturs,5,0,81,76
1657306861927,COGS 100,A01,083619,Allen; Michael Gordon,16,0,70,54
1657306867954,COGS 101A,A01,083621,Davis; Joshua Daniel,9,0,68,59
1657306873988,COGS 101B,A01,091572,Allen; Michael Gordon,11,0,65,54
1657306880023,COGS 101C,A01,083625,Delgado; Tania,17,0,35,18
1657306886064,COGS 107A,A01,083627,Boyle; Mary E. T.,13,0,60,47
1657306892087,COGS 118A,A01,083075,Gupta; Anjum,18,0,76,58
1657306898124,CSE 3,A50,083646,Miranda; Gregory Joseph,24,0,50,26
1657306904148,CSE 8A,A50,083650,Miranda; Gregory Joseph,17,1,56,39
1657306910172,CSE 11,A01,083080,Cao; Yingjun,6,15,40,34
1657306916201,CSE 12,A01,083652,Krause-Levy; Sophia Louisa,26,1,120,94
1657306922225,CSE 15L,A01,083654,Morris; Justin Loren,9,0,50,41
1657306922225,CSE 15L,A02,083655,Morris; Justin Loren,9,0,50,41
1657306928254,CSE 20,A01,083657,Tran; Khoa Dang,38,0,80,42
1657306934360,CSE 21,A01,095574,Bach; Quang Tran,22,0,48,26
1657306940388,CSE 30,A01,083084,Eldon; John,4,0,80,76
1657306940388,CSE 30,B01,095061,Bhaskar; Nishant,9,0,50,41
1657306946412,CSE 100,A01,083659,Cao; Yingjun,4,4,70,66
1657306952439,CSE 134B,A01,083661,Powell; Thomas Allan,21,0,100,79
1657306958465,CSE 140,A01,083663,Gungor; Onat,13,0,85,72
1657306964491,CSE 140L,A01,083088,Eldon; John,20,0,100,80
1657306970516,CSE 175,A01,083665,Kumar; Rakesh,3,0,25,22
1657306976539,CSE 190,A00,092507,Dubnov; Shlomo,7,0,20,13
1657306982569,ECE 45,A01,083139,Congero; Spencer William,6,0,75,69
1657306988591,ECE 65,A50,083695,Saad; Andrew S,12,0,30,18
1657306988591,ECE 65,A51,095125,Saad; Andrew S,25,0,26,1
1657306994613,ECE 109,A01,091882,Touri; Behrouz,19,0,70,51
1657307000635,ECE 180,A00,083140,Abi Samra; Nicholas Camill,1,0,30,29
1657307000635,ECE 180,B00,083141,Abi Samra; Nicholas Camill,0,0,30,30
1657307006666,MATH 10A,A01,083735,Patchell; Gregory David,2,0,30,28
1657307006666,MATH 10A,A02,083736,Patchell; Gregory David,20,0,30,10
1657307006666,MATH 10A,A03,083737,Patchell; Gregory David,16,0,30,14
1657307012690,MATH 10B,A01,083207,Lim; Seonhee,7,0,34,27
1657307012690,MATH 10B,A02,083208,Lim; Seonhee,9,0,35,26
1657307012690,MATH 10B,A03,093472,Lim; Seonhee,7,0,34,27
1657307012690,MATH 10B,B01,083739,Sinha; Shubham,11,0,30,19
1657307018715,MATH 18,A01,083743,Cinel; Cameron Alexander,6,0,30,24
1657307018715,MATH 18,A02,083744,Cinel; Cameron Alexander,17,0,30,13
1657307018715,MATH 18,A03,083745,Cinel; Cameron Alexander,8,0,30,22
1657307018715,MATH 18,B01,083748,Rideout; David Porter,4,0,37,33
1657307018715,MATH 18,B02,083749,Rideout; David Porter,4,0,36,32
1657307018715,MATH 18,B03,083750,Rideout; David Porter,3,0,37,34
1657307018715,MATH 18,B04,083751,Rideout; David Porter,6,0,36,30
1657307018715,MATH 18,B05,093473,Rideout; David Porter,5,0,36,31
1657307018715,MATH 18,B06,093474,Rideout; David Porter,5,0,36,31
1657307024737,MATH 20A,A01,083754,Zheng; Zequn,14,0,40,26
1657307030763,MATH 20B,A01,083756,Briones; Jor-el Thomas Caparas,3,0,36,33
1657307030763,MATH 20B,A02,083757,Briones; Jor-el Thomas Caparas,1,0,36,35
1657307030763,MATH 20B,A03,093475,Briones; Jor-el Thomas Caparas,2,0,36,34
1657307036796,MATH 20C,A01,083760,Briones; Jor-el Thomas Caparas,1,0,35,34
1657307036796,MATH 20C,A02,083761,Briones; Jor-el Thomas Caparas,8,0,35,27
1657307036796,MATH 20C,A03,093476,Briones; Jor-el Thomas Caparas,0,1,36,36
1657307036796,MATH 20C,B01,083762,Bach; Quang Tran,1,0,30,29
1657307042819,MATH 20D,A01,083765,Tran; Brian Kha,5,0,30,25
1657307042819,MATH 20D,A02,083766,Tran; Brian Kha,5,0,30,25
1657307042819,MATH 20D,A03,083767,Tran; Brian Kha,4,0,30,26
1657307048842,MATH 20E,A01,083771,Ganguly; Soumya,7,0,32,25
1657307048842,MATH 20E,A02,083772,Ganguly; Soumya,6,0,32,26
1657307048842,MATH 20E,B01,083773,Ciotti; Benjamin,19,0,35,16
1657307048842,MATH 20E,B02,083774,Ciotti; Benjamin,17,0,35,18
1657307054871,MATH 103A,A01,083777,Greenfeld; Be'Eri,3,0,36,33
1657307054871,MATH 103A,A02,083778,Greenfeld; Be'Eri,5,0,36,31
1657307054871,MATH 103A,A03,093561,Greenfeld; Be'Eri,4,0,36,32
1657307054871,MATH 103A,B01,083779,Greenfeld; Be'Eri,6,0,36,30
1657307054871,MATH 103A,B02,083780,Greenfeld; Be'Eri,4,0,36,32
1657307054871,MATH 103A,B03,093562,Greenfeld; Be'Eri,3,0,36,33
1657307060898,MATH 105,A01,085443,Carter; Anne Toulson,15,0,35,20
1657307060898,MATH 105,A02,093477,Carter; Anne Toulson,20,0,35,15
1657307066925,MATH 109,A01,083213,Ganzberger; Geoffrey Michael,2,0,34,32
1657307066925,MATH 109,A02,083214,Ganzberger; Geoffrey Michael,4,0,34,30
1657307066925,MATH 109,A03,093478,Ganzberger; Geoffrey Michael,2,0,34,32
1657307066925,MATH 109,B01,083215,Ganzberger; Geoffrey Michael,1,0,32,31
1657307066925,MATH 109,B02,083216,Ganzberger; Geoffrey Michael,1,0,32,31
1657307066925,MATH 109,B03,093479,Ganzberger; Geoffrey Michael,8,0,32,24
1657307072950,MATH 142A,A01,083219,Chow; Bennett,7,0,32,25
1657307072950,MATH 142A,A02,083220,Chow; Bennett,10,0,32,22
1657307072950,MATH 142A,A03,093480,Chow; Bennett,7,0,32,25
1657307072950,MATH 142A,B03,093481,Chow; Bennett,8,0,32,24
1657307072950,MATH 142A,B04,093558,Chow; Bennett,12,0,32,20
1657307072950,MATH 142A,B05,093559,Chow; Bennett,6,0,32,26
1657307078974,MATH 193A,A01,083224,Rotar; Vladimir,7,0,34,27
1657307078974,MATH 193A,A02,083225,Rotar; Vladimir,7,0,34,27
1657307078974,MATH 193A,A03,083781,Rotar; Vladimir,3,0,34,31
1657307078974,MATH 193A,A04,083782,Rotar; Vladimir,8,0,34,26
1657307078974,MATH 193A,A05,093482,Rotar; Vladimir,8,0,34,26
1657307085005,MATH 197,001,091859,McAuley; Julian John,9999,0,9999,0
1657307085005,MATH 197,002,095566,Kedlaya; Kiran S.,9997,0,9999,2
1657307085005,MATH 197,003,095567,Xiao; Ming,9999,0,9999,0
1657307085005,MATH 197,004,095571,Perols; Johan Lars,9998,0,9999,1
1657307092055,COGS 9,A01,083615,Shannon; Kyle Michael,8,0,75,67
1657307098079,COGS 11,A01,083617,Boyle; Mary E. T.,22,0,48,26
1657307104137,COGS 13,A01,083071,Bastos; Amalia Pinkusfeld,10,0,71,61
1657307110160,COGS 14A,A01,092681,Semenuks; Arturs,2,1,100,98
1657307116198,COGS 14B,A01,083073,Cheng; Tzu-Han,6,0,63,57
1657307122230,COGS 17,A01,092677,Semenuks; Arturs,5,0,81,76
1657307128259,COGS 100,A01,083619,Allen; Michael Gordon,16,0,70,54
1657307134280,COGS 101A,A01,083621,Davis; Joshua Daniel,9,0,68,59
1657307140303,COGS 101B,A01,091572,Allen; Michael Gordon,11,0,65,54
1657307146342,COGS 101C,A01,083625,Delgado; Tania,17,0,35,18
1657307152369,COGS 107A,A01,083627,Boyle; Mary E. T.,13,0,60,47
1657307158396,COGS 118A,A01,083075,Gupta; Anjum,18,0,76,58
1657307164418,CSE 3,A50,083646,Miranda; Gregory Joseph,24,0,50,26
1657307170442,CSE 8A,A50,083650,Miranda; Gregory Joseph,17,1,56,39
1657307176468,CSE 11,A01,083080,Cao; Yingjun,6,15,40,34
1657307182490,CSE 12,A01,083652,Krause-Levy; Sophia Louisa,26,1,120,94
1657307188523,CSE 15L,A01,083654,Morris; Justin Loren,9,0,50,41
1657307188523,CSE 15L,A02,083655,Morris; Justin Loren,9,0,50,41
1657307194550,CSE 20,A01,083657,Tran; Khoa Dang,38,0,80,42
1657307200576,CSE 21,A01,095574,Bach; Quang Tran,22,0,48,26
1657307206600,CSE 30,A01,083084,Eldon; John,4,0,80,76
1657307206600,CSE 30,B01,095061,Bhaskar; Nishant,9,0,50,41
1657307212622,CSE 100,A01,083659,Cao; Yingjun,4,4,70,66
1657307218645,CSE 134B,A01,083661,Powell; Thomas Allan,21,0,100,79
1657307224673,CSE 140,A01,083663,Gungor; Onat,13,0,85,72
1657307230698,CSE 140L,A01,083088,Eldon; John,20,0,100,80
1657307236731,CSE 175,A01,083665,Kumar; Rakesh,3,0,25,22
1657307242755,CSE 190,A00,092507,Dubnov; Shlomo,7,0,20,13
1657307248783,ECE 45,A01,083139,Congero; Spencer William,6,0,75,69
1657307254815,ECE 65,A50,083695,Saad; Andrew S,12,0,30,18
1657307254815,ECE 65,A51,095125,Saad; Andrew S,25,0,26,1
1657307260836,ECE 109,A01,091882,Touri; Behrouz,19,0,70,51
1657307266858,ECE 180,A00,083140,Abi Samra; Nicholas Camill,1,0,30,29
1657307266858,ECE 180,B00,083141,Abi Samra; Nicholas Camill,0,0,30,30
1657307272884,MATH 10A,A01,083735,Patchell; Gregory David,2,0,30,28
1657307272884,MATH 10A,A02,083736,Patchell; Gregory David,20,0,30,10
1657307272884,MATH 10A,A03,083737,Patchell; Gregory David,16,0,30,14
1657307278912,MATH 10B,A01,083207,Lim; Seonhee,7,0,34,27
1657307278912,MATH 10B,A02,083208,Lim; Seonhee,9,0,35,26
1657307278912,MATH 10B,A03,093472,Lim; Seonhee,7,0,34,27
1657307278912,MATH 10B,B01,083739,Sinha; Shubham,11,0,30,19
1657307284941,MATH 18,A01,083743,Cinel; Cameron Alexander,6,0,30,24
1657307284941,MATH 18,A02,083744,Cinel; Cameron Alexander,17,0,30,13
1657307284941,MATH 18,A03,083745,Cinel; Cameron Alexander,8,0,30,22
1657307284941,MATH 18,B01,083748,Rideout; David Porter,4,0,37,33
1657307284941,MATH 18,B02,083749,Rideout; David Porter,4,0,36,32
1657307284941,MATH 18,B03,083750,Rideout; David Porter,3,0,37,34
1657307284941,MATH 18,B04,083751,Rideout; David Porter,6,0,36,30
1657307284941,MATH 18,B05,093473,Rideout; David Porter,5,0,36,31
1657307284941,MATH 18,B06,093474,Rideout; David Porter,5,0,36,31
1657307290966,MATH 20A,A01,083754,Zheng; Zequn,14,0,40,26
1657307296994,MATH 20B,A01,083756,Briones; Jor-el Thomas Caparas,3,0,36,33
1657307296994,MATH 20B,A02,083757,Briones; Jor-el Thomas Caparas,1,0,36,35
1657307296994,MATH 20B,A03,093475,Briones; Jor-el Thomas Caparas,2,0,36,34
1657307303017,MATH 20C,A01,083760,Briones; Jor-el Thomas Caparas,1,0,35,34
1657307303017,MATH 20C,A02,083761,Briones; Jor-el Thomas Caparas,8,0,35,27
1657307303017,MATH 20C,A03,093476,Briones; Jor-el Thomas Caparas,0,1,36,36
1657307303017,MATH 20C,B01,083762,Bach; Quang Tran,1,0,30,29
1657307309040,MATH 20D,A01,083765,Tran; Brian Kha,5,0,30,25
1657307309040,MATH 20D,A02,083766,Tran; Brian Kha,5,0,30,25
1657307309040,MATH 20D,A03,083767,Tran; Brian Kha,4,0,30,26
1657307315068,MATH 20E,A01,083771,Ganguly; Soumya,7,0,32,25
1657307315068,MATH 20E,A02,083772,Ganguly; Soumya,6,0,32,26
1657307315068,MATH 20E,B01,083773,Ciotti; Benjamin,19,0,35,16
1657307315068,MATH 20E,B02,083774,Ciotti; Benjamin,17,0,35,18
1657307321101,MATH 103A,A01,083777,Greenfeld; Be'Eri,3,0,36,33
1657307321101,MATH 103A,A02,083778,Greenfeld; Be'Eri,5,0,36,31
1657307321101,MATH 103A,A03,093561,Greenfeld; Be'Eri,4,0,36,32
1657307321101,MATH 103A,B01,083779,Greenfeld; Be'Eri,6,0,36,30
1657307321101,MATH 103A,B02,083780,Greenfeld; Be'Eri,4,0,36,32
1657307321101,MATH 103A,B03,093562,Greenfeld; Be'Eri,3,0,36,33
1657307327124,MATH 105,A01,085443,Carter; Anne Toulson,15,0,35,20
1657307327124,MATH 105,A02,093477,Carter; Anne Toulson,20,0,35,15
1657307333151,MATH 109,A01,083213,Ganzberger; Geoffrey Michael,2,0,34,32
1657307333151,MATH 109,A02,083214,Ganzberger; Geoffrey Michael,4,0,34,30
1657307333151,MATH 109,A03,093478,Ganzberger; Geoffrey Michael,2,0,34,32
1657307333151,MATH 109,B01,083215,Ganzberger; Geoffrey Michael,1,0,32,31
1657307333151,MATH 109,B02,083216,Ganzberger; Geoffrey Michael,1,0,32,31
1657307333151,MATH 109,B03,093479,Ganzberger; Geoffrey Michael,8,0,32,24
1657307339183,MATH 142A,A01,083219,Chow; Bennett,7,0,32,25
1657307339183,MATH 142A,A02,083220,Chow; Bennett,10,0,32,22
1657307339183,MATH 142A,A03,093480,Chow; Bennett,7,0,32,25
1657307339183,MATH 142A,B03,093481,Chow; Bennett,8,0,32,24
1657307339183,MATH 142A,B04,093558,Chow; Bennett,12,0,32,20
1657307339183,MATH 142A,B05,093559,Chow; Bennett,6,0,32,26
1657307345206,MATH 193A,A01,083224,Rotar; Vladimir,7,0,34,27
1657307345206,MATH 193A,A02,083225,Rotar; Vladimir,7,0,34,27
1657307345206,MATH 193A,A03,083781,Rotar; Vladimir,3,0,34,31
1657307345206,MATH 193A,A04,083782,Rotar; Vladimir,8,0,34,26
1657307345206,MATH 193A,A05,093482,Rotar; Vladimir,8,0,34,26
1657307351229,MATH 197,001,091859,McAuley; Julian John,9999,0,9999,0
1657307351229,MATH 197,002,095566,Kedlaya; Kiran S.,9997,0,9999,2
1657307351229,MATH 197,003,095567,Xiao; Ming,9999,0,9999,0
1657307351229,MATH 197,004,095571,Perols; Johan Lars,9998,0,9999,1
1657307358286,COGS 9,A01,083615,Shannon; Kyle Michael,8,0,75,67
1657307364308,COGS 11,A01,083617,Boyle; Mary E. T.,22,0,48,26
1657307370339,COGS 13,A01,083071,Bastos; Amalia Pinkusfeld,10,0,71,61
1657307376363,COGS 14A,A01,092681,Semenuks; Arturs,2,1,100,98
1657307382387,COGS 14B,A01,083073,Cheng; Tzu-Han,6,0,63,57
1657307388414,COGS 17,A01,092677,Semenuks; Arturs,5,0,81,76
1657307394440,COGS 100,A01,083619,Allen; Michael Gordon,16,0,70,54
1657307400469,COGS 101A,A01,083621,Davis; Joshua Daniel,9,0,68,59
1657307406491,COGS 101B,A01,091572,Allen; Michael Gordon,11,0,65,54
1657307412531,COGS 101C,A01,083625,Delgado; Tania,17,0,35,18
1657307418553,COGS 107A,A01,083627,Boyle; Mary E. T.,13,0,60,47
1657307424575,COGS 118A,A01,083075,Gupta; Anjum,18,0,76,58
1657307430608,CSE 3,A50,083646,Miranda; Gregory Joseph,24,0,50,26
1657307436640,CSE 8A,A50,083650,Miranda; Gregory Joseph,17,1,56,39
1657307442666,CSE 11,A01,083080,Cao; Yingjun,6,15,40,34
1657307448692,CSE 12,A01,083652,Krause-Levy; Sophia Louisa,26,1,120,94
1657307454733,CSE 15L,A01,083654,Morris; Justin Loren,9,0,50,41
1657307454733,CSE 15L,A02,083655,Morris; Justin Loren,9,0,50,41
1657307460756,CSE 20,A01,083657,Tran; Khoa Dang,38,0,80,42
1657307466783,CSE 21,A01,095574,Bach; Quang Tran,22,0,48,26
1657307472808,CSE 30,A01,083084,Eldon; John,4,0,80,76
1657307472808,CSE 30,B01,095061,Bhaskar; Nishant,9,0,50,41
1657307478836,CSE 100,A01,083659,Cao; Yingjun,4,4,70,66
1657307484863,CSE 134B,A01,083661,Powell; Thomas Allan,21,0,100,79
1657307490887,CSE 140,A01,083663,Gungor; Onat,13,0,85,72
1657307496908,CSE 140L,A01,083088,Eldon; John,20,0,100,80
1657307502932,CSE 175,A01,083665,Kumar; Rakesh,3,0,25,22
1657307508955,CSE 190,A00,092507,Dubnov; Shlomo,7,0,20,13
1657307514984,ECE 45,A01,083139,Congero; Spencer William,6,0,75,69
1657307521012,ECE 65,A50,083695,Saad; Andrew S,12,0,30,18
1657307521012,ECE 65,A51,095125,Saad; Andrew S,25,0,26,1
1657307527045,ECE 109,A01,091882,Touri; Behrouz,19,0,70,51
1657307533152,ECE 180,A00,083140,Abi Samra; Nicholas Camill,1,0,30,29
1657307533152,ECE 180,B00,083141,Abi Samra; Nicholas Camill,0,0,30,30
1657307539175,MATH 10A,A01,083735,Patchell; Gregory David,2,0,30,28
1657307539175,MATH 10A,A02,083736,Patchell; Gregory David,20,0,30,10
1657307539175,MATH 10A,A03,083737,Patchell; Gregory David,16,0,30,14
1657307545204,MATH 10B,A01,083207,Lim; Seonhee,7,0,34,27
1657307545204,MATH 10B,A02,083208,Lim; Seonhee,9,0,35,26
1657307545204,MATH 10B,A03,093472,Lim; Seonhee,7,0,34,27
1657307545204,MATH 10B,B01,083739,Sinha; Shubham,11,0,30,19
1657307551228,MATH 18,A01,083743,Cinel; Cameron Alexander,6,0,30,24
1657307551228,MATH 18,A02,083744,Cinel; Cameron Alexander,17,0,30,13
1657307551228,MATH 18,A03,083745,Cinel; Cameron Alexander,8,0,30,22
1657307551228,MATH 18,B01,083748,Rideout; David Porter,4,0,37,33
1657307551228,MATH 18,B02,083749,Rideout; David Porter,4,0,36,32
1657307551228,MATH 18,B03,083750,Rideout; David Porter,3,0,37,34
1657307551228,MATH 18,B04,083751,Rideout; David Porter,6,0,36,30
1657307551228,MATH 18,B05,093473,Rideout; David Porter,5,0,36,31
1657307551228,MATH 18,B06,093474,Rideout; David Porter,5,0,36,31
1657307557251,MATH 20A,A01,083754,Zheng; Zequn,14,0,40,26
1657307563278,MATH 20B,A01,083756,Briones; Jor-el Thomas Caparas,3,0,36,33
1657307563278,MATH 20B,A02,083757,Briones; Jor-el Thomas Caparas,1,0,36,35
1657307563278,MATH 20B,A03,093475,Briones; Jor-el Thomas Caparas,2,0,36,34
1657307569302,MATH 20C,A01,083760,Briones; Jor-el Thomas Caparas,1,0,35,34
1657307569302,MATH 20C,A02,083761,Briones; Jor-el Thomas Caparas,8,0,35,27
1657307569302,MATH 20C,A03,093476,Briones; Jor-el Thomas Caparas,0,1,36,36
1657307569302,MATH 20C,B01,083762,Bach; Quang Tran,1,0,30,29
1657307575327,MATH 20D,A01,083765,Tran; Brian Kha,5,0,30,25
1657307575327,MATH 20D,A02,083766,Tran; Brian Kha,5,0,30,25
1657307575327,MATH 20D,A03,083767,Tran; Brian Kha,4,0,30,26
1657307581355,MATH 20E,A01,083771,Ganguly; Soumya,7,0,32,25
1657307581355,MATH 20E,A02,083772,Ganguly; Soumya,6,0,32,26
1657307581355,MATH 20E,B01,083773,Ciotti; Benjamin,19,0,35,16
1657307581355,MATH 20E,B02,083774,Ciotti; Benjamin,17,0,35,18
1657307587385,MATH 103A,A01,083777,Greenfeld; Be'Eri,3,0,36,33
1657307587385,MATH 103A,A02,083778,Greenfeld; Be'Eri,5,0,36,31
1657307587385,MATH 103A,A03,093561,Greenfeld; Be'Eri,4,0,36,32
1657307587385,MATH 103A,B01,083779,Greenfeld; Be'Eri,6,0,36,30
1657307587385,MATH 103A,B02,083780,Greenfeld; Be'Eri,4,0,36,32
1657307587385,MATH 103A,B03,093562,Greenfeld; Be'Eri,3,0,36,33
1657307593421,MATH 105,A01,085443,Carter; Anne Toulson,15,0,35,20
1657307593421,MATH 105,A02,093477,Carter; Anne Toulson,20,0,35,15
1657307599451,MATH 109,A01,083213,Ganzberger; Geoffrey Michael,2,0,34,32
1657307599451,MATH 109,A02,083214,Ganzberger; Geoffrey Michael,4,0,34,30
1657307599451,MATH 109,A03,093478,Ganzberger; Geoffrey Michael,2,0,34,32
1657307599451,MATH 109,B01,083215,Ganzberger; Geoffrey Michael,1,0,32,31
1657307599451,MATH 109,B02,083216,Ganzberger; Geoffrey Michael,1,0,32,31
1657307599451,MATH 109,B03,093479,Ganzberger; Geoffrey Michael,8,0,32,24
1657307605474,MATH 142A,A01,083219,Chow; Bennett,7,0,32,25
1657307605474,MATH 142A,A02,083220,Chow; Bennett,10,0,32,22
1657307605474,MATH 142A,A03,093480,Chow; Bennett,7,0,32,25
1657307605474,MATH 142A,B03,093481,Chow; Bennett,8,0,32,24
1657307605474,MATH 142A,B04,093558,Chow; Bennett,12,0,32,20
1657307605474,MATH 142A,B05,093559,Chow; Bennett,6,0,32,26
1657307611509,MATH 193A,A01,083224,Rotar; Vladimir,7,0,34,27
1657307611509,MATH 193A,A02,083225,Rotar; Vladimir,7,0,34,27
1657307611509,MATH 193A,A03,083781,Rotar; Vladimir,3,0,34,31
1657307611509,MATH 193A,A04,083782,Rotar; Vladimir,8,0,34,26
1657307611509,MATH 193A,A05,093482,Rotar; Vladimir,8,0,34,26
1657307617540,MATH 197,001,091859,McAuley; Julian John,9999,0,9999,0
1657307617540,MATH 197,002,095566,Kedlaya; Kiran S.,9997,0,9999,2
1657307617540,MATH 197,003,095567,Xiao; Ming,9999,0,9999,0
1657307617540,MATH 197,004,095571,Perols; Johan Lars,9998,0,9999,1
1657307624603,COGS 9,A01,083615,Shannon; Kyle Michael,8,0,75,67
1657307630636,COGS 11,A01,083617,Boyle; Mary E. T.,22,0,48,26
1657307636658,COGS 13,A01,083071,Bastos; Amalia Pinkusfeld,10,0,71,61
1657307642686,COGS 14A,A01,092681,Semenuks; Arturs,2,1,100,98
1657307648712,COGS 14B,A01,083073,Cheng; Tzu-Han,6,0,63,57
1657307654741,COGS 17,A01,092677,Semenuks; Arturs,5,0,81,76
1657307660763,COGS 100,A01,083619,Allen; Michael Gordon,16,0,70,54
1657307666787,COGS 101A,A01,083621,Davis; Joshua Daniel,9,0,68,59
1657307672814,COGS 101B,A01,091572,Allen; Michael Gordon,11,0,65,54
1657307678842,COGS 101C,A01,083625,Delgado; Tania,17,0,35,18
1657307684866,COGS 107A,A01,083627,Boyle; Mary E. T.,13,0,60,47
1657307690893,COGS 118A,A01,083075,Gupta; Anjum,18,0,76,58
1657307696919,CSE 3,A50,083646,Miranda; Gregory Joseph,24,0,50,26
1657307702942,CSE 8A,A50,083650,Miranda; Gregory Joseph,17,1,56,39
1657307708965,CSE 11,A01,083080,Cao; Yingjun,6,15,40,34
1657307714988,CSE 12,A01,083652,Krause-Levy; Sophia Louisa,26,1,120,94
1657307721014,CSE 15L,A01,083654,Morris; Justin Loren,9,0,50,41
1657307721014,CSE 15L,A02,083655,Morris; Justin Loren,9,0,50,41
1657307727036,CSE 20,A01,083657,Tran; Khoa Dang,38,0,80,42
1657307733066,CSE 21,A01,095574,Bach; Quang Tran,22,0,48,26
1657307739089,CSE 30,A01,083084,Eldon; John,4,0,80,76
1657307739089,CSE 30,B01,095061,Bhaskar; Nishant,9,0,50,41
1657307745123,CSE 100,A01,083659,Cao; Yingjun,4,4,70,66
1657307751147,CSE 134B,A01,083661,Powell; Thomas Allan,21,0,100,79
1657307757171,CSE 140,A01,083663,Gungor; Onat,13,0,85,72
1657307763196,CSE 140L,A01,083088,Eldon; John,20,0,100,80
1657307769222,CSE 175,A01,083665,Kumar; Rakesh,3,0,25,22
1657307775245,CSE 190,A00,092507,Dubnov; Shlomo,7,0,20,13
1657307781266,ECE 45,A01,083139,Congero; Spencer William,6,0,75,69
1657307787301,ECE 65,A50,083695,Saad; Andrew S,12,0,30,18
1657307787301,ECE 65,A51,095125,Saad; Andrew S,25,0,26,1
1657307793324,ECE 109,A01,091882,Touri; Behrouz,19,0,70,51
1657307799347,ECE 180,A00,083140,Abi Samra; Nicholas Camill,1,0,30,29
1657307799347,ECE 180,B00,083141,Abi Samra; Nicholas Camill,0,0,30,30
1657307805377,MATH 10A,A01,083735,Patchell; Gregory David,2,0,30,28
1657307805377,MATH 10A,A02,083736,Patchell; Gregory David,20,0,30,10
1657307805377,MATH 10A,A03,083737,Patchell; Gregory David,16,0,30,14
1657307811401,MATH 10B,A01,083207,Lim; Seonhee,7,0,34,27
1657307811401,MATH 10B,A02,083208,Lim; Seonhee,9,0,35,26
1657307811401,MATH 10B,A03,093472,Lim; Seonhee,7,0,34,27
1657307811401,MATH 10B,B01,083739,Sinha; Shubham,11,0,30,19
1657307817435,MATH 18,A01,083743,Cinel; Cameron Alexander,6,0,30,24
1657307817435,MATH 18,A02,083744,Cinel; Cameron Alexander,17,0,30,13
1657307817435,MATH 18,A03,083745,Cinel; Cameron Alexander,8,0,30,22
1657307817435,MATH 18,B01,083748,Rideout; David Porter,4,0,37,33
1657307817435,MATH 18,B02,083749,Rideout; David Porter,4,0,36,32
1657307817435,MATH 18,B03,083750,Rideout; David Porter,3,0,37,34
1657307817435,MATH 18,B04,083751,Rideout; David Porter,6,0,36,30
1657307817435,MATH 18,B05,093473,Rideout; David Porter,5,0,36,31
1657307817435,MATH 18,B06,093474,Rideout; David Porter,5,0,36,31
1657307823461,MATH 20A,A01,083754,Zheng; Zequn,14,0,40,26
1657307829489,MATH 20B,A01,083756,Briones; Jor-el Thomas Caparas,3,0,36,33
1657307829489,MATH 20B,A02,083757,Briones; Jor-el Thomas Caparas,1,0,36,35
1657307829489,MATH 20B,A03,093475,Briones; Jor-el Thomas Caparas,2,0,36,34
1657307835512,MATH 20C,A01,083760,Briones; Jor-el Thomas Caparas,1,0,35,34
1657307835512,MATH 20C,A02,083761,Briones; Jor-el Thomas Caparas,8,0,35,27
1657307835512,MATH 20C,A03,093476,Briones; Jor-el Thomas Caparas,0,1,36,36
1657307835512,MATH 20C,B01,083762,Bach; Quang Tran,1,0,30,29
1657307841542,MATH 20D,A01,083765,Tran; Brian Kha,5,0,30,25
1657307841542,MATH 20D,A02,083766,Tran; Brian Kha,5,0,30,25
1657307841542,MATH 20D,A03,083767,Tran; Brian Kha,4,0,30,26
1657307847570,MATH 20E,A01,083771,Ganguly; Soumya,7,0,32,25
1657307847570,MATH 20E,A02,083772,Ganguly; Soumya,6,0,32,26
1657307847570,MATH 20E,B01,083773,Ciotti; Benjamin,19,0,35,16
1657307847570,MATH 20E,B02,083774,Ciotti; Benjamin,17,0,35,18
1657307853599,MATH 103A,A01,083777,Greenfeld; Be'Eri,3,0,36,33
1657307853599,MATH 103A,A02,083778,Greenfeld; Be'Eri,5,0,36,31
1657307853599,MATH 103A,A03,093561,Greenfeld; Be'Eri,4,0,36,32
1657307853599,MATH 103A,B01,083779,Greenfeld; Be'Eri,6,0,36,30
1657307853599,MATH 103A,B02,083780,Greenfeld; Be'Eri,4,0,36,32
1657307853599,MATH 103A,B03,093562,Greenfeld; Be'Eri,3,0,36,33
1657307859632,MATH 105,A01,085443,Carter; Anne Toulson,15,0,35,20
1657307859632,MATH 105,A02,093477,Carter; Anne Toulson,20,0,35,15
1657307865655,MATH 109,A01,083213,Ganzberger; Geoffrey Michael,2,0,34,32
1657307865655,MATH 109,A02,083214,Ganzberger; Geoffrey Michael,4,0,34,30
1657307865655,MATH 109,A03,093478,Ganzberger; Geoffrey Michael,2,0,34,32
1657307865655,MATH 109,B01,083215,Ganzberger; Geoffrey Michael,1,0,32,31
1657307865655,MATH 109,B02,083216,Ganzberger; Geoffrey Michael,1,0,32,31
1657307865655,MATH 109,B03,093479,Ganzberger; Geoffrey Michael,8,0,32,24
1657307871684,MATH 142A,A01,083219,Chow; Bennett,7,0,32,25
1657307871684,MATH 142A,A02,083220,Chow; Bennett,10,0,32,22
1657307871684,MATH 142A,A03,093480,Chow; Bennett,7,0,32,25
1657307871684,MATH 142A,B03,093481,Chow; Bennett,8,0,32,24
1657307871684,MATH 142A,B04,093558,Chow; Bennett,12,0,32,20
1657307871684,MATH 142A,B05,093559,Chow; Bennett,6,0,32,26
1657307877716,MATH 193A,A01,083224,Rotar; Vladimir,7,0,34,27
1657307877716,MATH 193A,A02,083225,Rotar; Vladimir,7,0,34,27
1657307877716,MATH 193A,A03,083781,Rotar; Vladimir,3,0,34,31
1657307877716,MATH 193A,A04,083782,Rotar; Vladimir,8,0,34,26
1657307877716,MATH 193A,A05,093482,Rotar; Vladimir,8,0,34,26
1657307883743,MATH 197,001,091859,McAuley; Julian John,9999,0,9999,0
1657307883743,MATH 197,002,095566,Kedlaya; Kiran S.,9997,0,9999,2
1657307883743,MATH 197,003,095567,Xiao; Ming,9999,0,9999,0
1657307883743,MATH 197,004,095571,Perols; Johan Lars,9998,0,9999,1
1657307890800,COGS 9,A01,083615,Shannon; Kyle Michael,8,0,75,67
1657307906094,COGS 11,A01,083617,Boyle; Mary E. T.,22,0,48,26
1657307912127,COGS 13,A01,083071,Bastos; Amalia Pinkusfeld,10,0,71,61
1657307918154,COGS 14A,A01,092681,Semenuks; Arturs,2,1,100,98
1657307924180,COGS 14B,A01,083073,Cheng; Tzu-Han,6,0,63,57
1657307930208,COGS 17,A01,092677,Semenuks; Arturs,5,0,81,76
1657307936242,COGS 100,A01,083619,Allen; Michael Gordon,16,0,70,54
1657307942264,COGS 101A,A01,083621,Davis; Joshua Daniel,9,0,68,59
1657307948288,COGS 101B,A01,091572,Allen; Michael Gordon,11,0,65,54
1657307954314,COGS 101C,A01,083625,Delgado; Tania,17,0,35,18
1657307960337,COGS 107A,A01,083627,Boyle; Mary E. T.,13,0,60,47
1657307966364,COGS 118A,A01,083075,Gupta; Anjum,18,0,76,58
1657307972392,CSE 3,A50,083646,Miranda; Gregory Joseph,24,0,50,26
1657307978420,CSE 8A,A50,083650,Miranda; Gregory Joseph,17,1,56,39
1657307984447,CSE 11,A01,083080,Cao; Yingjun,6,15,40,34
1657307990475,CSE 12,A01,083652,Krause-Levy; Sophia Louisa,26,1,120,94
1657307996500,CSE 15L,A01,083654,Morris; Justin Loren,9,0,50,41
1657307996500,CSE 15L,A02,083655,Morris; Justin Loren,9,0,50,41
1657308002523,CSE 20,A01,083657,Tran; Khoa Dang,38,0,80,42
1657308008549,CSE 21,A01,095574,Bach; Quang Tran,22,0,48,26
1657308014571,CSE 30,A01,083084,Eldon; John,4,0,80,76
1657308014571,CSE 30,B01,095061,Bhaskar; Nishant,9,0,50,41
1657308020597,CSE 100,A01,083659,Cao; Yingjun,4,4,70,66
1657308026625,CSE 134B,A01,083661,Powell; Thomas Allan,21,0,100,79
1657308032647,CSE 140,A01,083663,Gungor; Onat,13,0,85,72
1657308038673,CSE 140L,A01,083088,Eldon; John,20,0,100,80
1657308044700,CSE 175,A01,083665,Kumar; Rakesh,3,0,25,22
1657308050724,CSE 190,A00,092507,Dubnov; Shlomo,7,0,20,13
1657308056755,ECE 45,A01,083139,Congero; Spencer William,6,0,75,69
1657308062779,ECE 65,A50,083695,Saad; Andrew S,12,0,30,18
1657308062779,ECE 65,A51,095125,Saad; Andrew S,25,0,26,1
1657308068801,ECE 109,A01,091882,Touri; Behrouz,19,0,70,51
1657308074824,ECE 180,A00,083140,Abi Samra; Nicholas Camill,1,0,30,29
1657308074824,ECE 180,B00,083141,Abi Samra; Nicholas Camill,0,0,30,30
1657308080850,MATH 10A,A01,083735,Patchell; Gregory David,2,0,30,28
1657308080850,MATH 10A,A02,083736,Patchell; Gregory David,20,0,30,10
1657308080850,MATH 10A,A03,083737,Patchell; Gregory David,16,0,30,14
1657308086880,MATH 10B,A01,083207,Lim; Seonhee,7,0,34,27
1657308086880,MATH 10B,A02,083208,Lim; Seonhee,9,0,35,26
1657308086880,MATH 10B,A03,093472,Lim; Seonhee,7,0,34,27
1657308086880,MATH 10B,B01,083739,Sinha; Shubham,11,0,30,19
1657308092906,MATH 18,A01,083743,Cinel; Cameron Alexander,6,0,30,24
1657308092906,MATH 18,A02,083744,Cinel; Cameron Alexander,17,0,30,13
1657308092906,MATH 18,A03,083745,Cinel; Cameron Alexander,8,0,30,22
1657308092906,MATH 18,B01,083748,Rideout; David Porter,4,0,37,33
1657308092906,MATH 18,B02,083749,Rideout; David Porter,4,0,36,32
1657308092906,MATH 18,B03,083750,Rideout; David Porter,3,0,37,34
1657308092906,MATH 18,B04,083751,Rideout; David Porter,6,0,36,30
1657308092906,MATH 18,B05,093473,Rideout; David Porter,5,0,36,31
1657308092906,MATH 18,B06,093474,Rideout; David Porter,5,0,36,31
1657308098932,MATH 20A,A01,083754,Zheng; Zequn,14,0,40,26
1657308104956,MATH 20B,A01,083756,Briones; Jor-el Thomas Caparas,3,0,36,33
1657308104956,MATH 20B,A02,083757,Briones; Jor-el Thomas Caparas,1,0,36,35
1657308104956,MATH 20B,A03,093475,Briones; Jor-el Thomas Caparas,2,0,36,34
1657308110980,MATH 20C,A01,083760,Briones; Jor-el Thomas Caparas,1,0,35,34
1657308110980,MATH 20C,A02,083761,Briones; Jor-el Thomas Caparas,8,0,35,27
1657308110980,MATH 20C,A03,093476,Briones; Jor-el Thomas Caparas,0,1,36,36
1657308110980,MATH 20C,B01,083762,Bach; Quang Tran,1,0,30,29
1657308117011,MATH 20D,A01,083765,Tran; Brian Kha,5,0,30,25
1657308117011,MATH 20D,A02,083766,Tran; Brian Kha,5,0,30,25
1657308117011,MATH 20D,A03,083767,Tran; Brian Kha,4,0,30,26
1657308123044,MATH 20E,A01,083771,Ganguly; Soumya,7,0,32,25
1657308123044,MATH 20E,A02,083772,Ganguly; Soumya,6,0,32,26
1657308123044,MATH 20E,B01,083773,Ciotti; Benjamin,19,0,35,16
1657308123044,MATH 20E,B02,083774,Ciotti; Benjamin,17,0,35,18
1657308129068,MATH 103A,A01,083777,Greenfeld; Be'Eri,3,0,36,33
1657308129068,MATH 103A,A02,083778,Greenfeld; Be'Eri,5,0,36,31
1657308129068,MATH 103A,A03,093561,Greenfeld; Be'Eri,4,0,36,32
1657308129068,MATH 103A,B01,083779,Greenfeld; Be'Eri,6,0,36,30
1657308129068,MATH 103A,B02,083780,Greenfeld; Be'Eri,4,0,36,32
1657308129068,MATH 103A,B03,093562,Greenfeld; Be'Eri,3,0,36,33
1657308135098,MATH 105,A01,085443,Carter; Anne Toulson,15,0,35,20
1657308135098,MATH 105,A02,093477,Carter; Anne Toulson,20,0,35,15
1657308141214,MATH 109,A01,083213,Ganzberger; Geoffrey Michael,2,0,34,32
1657308141214,MATH 109,A02,083214,Ganzberger; Geoffrey Michael,4,0,34,30
1657308141214,MATH 109,A03,093478,Ganzberger; Geoffrey Michael,2,0,34,32
1657308141214,MATH 109,B01,083215,Ganzberger; Geoffrey Michael,1,0,32,31
1657308141214,MATH 109,B02,083216,Ganzberger; Geoffrey Michael,1,0,32,31
1657308141214,MATH 109,B03,093479,Ganzberger; Geoffrey Michael,8,0,32,24
1657308147244,MATH 142A,A01,083219,Chow; Bennett,7,0,32,25
1657308147244,MATH 142A,A02,083220,Chow; Bennett,10,0,32,22
1657308147244,MATH 142A,A03,093480,Chow; Bennett,7,0,32,25
1657308147244,MATH 142A,B03,093481,Chow; Bennett,8,0,32,24
1657308147244,MATH 142A,B04,093558,Chow; Bennett,12,0,32,20
1657308147244,MATH 142A,B05,093559,Chow; Bennett,6,0,32,26
1657308153282,MATH 193A,A01,083224,Rotar; Vladimir,7,0,34,27
1657308153282,MATH 193A,A02,083225,Rotar; Vladimir,7,0,34,27
1657308153282,MATH 193A,A03,083781,Rotar; Vladimir,3,0,34,31
1657308153282,MATH 193A,A04,083782,Rotar; Vladimir,8,0,34,26
1657308153282,MATH 193A,A05,093482,Rotar; Vladimir,8,0,34,26
1657308159306,MATH 197,001,091859,McAuley; Julian John,9999,0,9999,0
1657308159306,MATH 197,002,095566,Kedlaya; Kiran S.,9997,0,9999,2
1657308159306,MATH 197,003,095567,Xiao; Ming,9999,0,9999,0
1657308159306,MATH 197,004,095571,Perols; Johan Lars,9998,0,9999,1
1657308166373,COGS 9,A01,083615,Shannon; Kyle Michael,8,0,75,67
1657308172398,COGS 11,A01,083617,Boyle; Mary E. T.,22,0,48,26
1657308178433,COGS 13,A01,083071,Bastos; Amalia Pinkusfeld,10,0,71,61
1657308184467,COGS 14A,A01,092681,Semenuks; Arturs,2,1,100,98
1657308190491,COGS 14B,A01,083073,Cheng; Tzu-Han,6,0,63,57
1657308196514,COGS 17,A01,092677,Semenuks; Arturs,5,0,81,76
1657308202544,COGS 100,A01,083619,Allen; Michael Gordon,16,0,70,54
1657308208568,COGS 101A,A01,083621,Davis; Joshua Daniel,9,0,68,59
1657308214597,COGS 101B,A01,091572,Allen; Michael Gordon,11,0,65,54
1657308220619,COGS 101C,A01,083625,Delgado; Tania,17,0,35,18
1657308226642,COGS 107A,A01,083627,Boyle; Mary E. T.,13,0,60,47
1657308232664,COGS 118A,A01,083075,Gupta; Anjum,18,0,76,58
1657308238687,CSE 3,A50,083646,Miranda; Gregory Joseph,24,0,50,26
1657308244710,CSE 8A,A50,083650,Miranda; Gregory Joseph,17,1,56,39
1657308250737,CSE 11,A01,083080,Cao; Yingjun,6,15,40,34
1657308256763,CSE 12,A01,083652,Krause-Levy; Sophia Louisa,26,1,120,94
1657308262785,CSE 15L,A01,083654,Morris; Justin Loren,9,0,50,41
1657308262785,CSE 15L,A02,083655,Morris; Justin Loren,9,0,50,41
1657308268808,CSE 20,A01,083657,Tran; Khoa Dang,38,0,80,42
1657308274833,CSE 21,A01,095574,Bach; Quang Tran,22,0,48,26
1657308280857,CSE 30,A01,083084,Eldon; John,4,0,80,76
1657308280857,CSE 30,B01,095061,Bhaskar; Nishant,9,0,50,41
1657308286882,CSE 100,A01,083659,Cao; Yingjun,4,4,70,66
1657308292910,CSE 134B,A01,083661,Powell; Thomas Allan,21,0,100,79
1657308298938,CSE 140,A01,083663,Gungor; Onat,13,0,85,72
1657308304962,CSE 140L,A01,083088,Eldon; John,20,0,100,80
1657308310987,CSE 175,A01,083665,Kumar; Rakesh,3,0,25,22
1657308317014,CSE 190,A00,092507,Dubnov; Shlomo,7,0,20,13
1657308323038,ECE 45,A01,083139,Congero; Spencer William,6,0,75,69
1657308329061,ECE 65,A50,083695,Saad; Andrew S,12,0,30,18
1657308329061,ECE 65,A51,095125,Saad; Andrew S,25,0,26,1
1657308335084,ECE 109,A01,091882,Touri; Behrouz,19,0,70,51
1657308341106,ECE 180,A00,083140,Abi Samra; Nicholas Camill,1,0,30,29
1657308341106,ECE 180,B00,083141,Abi Samra; Nicholas Camill,0,0,30,30
1657308347130,MATH 10A,A01,083735,Patchell; Gregory David,2,0,30,28
1657308347130,MATH 10A,A02,083736,Patchell; Gregory David,20,0,30,10
1657308347130,MATH 10A,A03,083737,Patchell; Gregory David,16,0,30,14
1657308353152,MATH 10B,A01,083207,Lim; Seonhee,7,0,34,27
1657308353152,MATH 10B,A02,083208,Lim; Seonhee,9,0,35,26
1657308353152,MATH 10B,A03,093472,Lim; Seonhee,7,0,34,27
1657308353152,MATH 10B,B01,083739,Sinha; Shubham,11,0,30,19
1657308359182,MATH 18,A01,083743,Cinel; Cameron Alexander,6,0,30,24
1657308359182,MATH 18,A02,083744,Cinel; Cameron Alexander,17,0,30,13
1657308359182,MATH 18,A03,083745,Cinel; Cameron Alexander,8,0,30,22
1657308359182,MATH 18,B01,083748,Rideout; David Porter,4,0,37,33
1657308359182,MATH 18,B02,083749,Rideout; David Porter,4,0,36,32
1657308359182,MATH 18,B03,083750,Rideout; David Porter,3,0,37,34
1657308359182,MATH 18,B04,083751,Rideout; David Porter,6,0,36,30
1657308359182,MATH 18,B05,093473,Rideout; David Porter,5,0,36,31
1657308359182,MATH 18,B06,093474,Rideout; David Porter,5,0,36,31
1657308365205,MATH 20A,A01,083754,Zheng; Zequn,14,0,40,26
1657308371229,MATH 20B,A01,083756,Briones; Jor-el Thomas Caparas,3,0,36,33
1657308371229,MATH 20B,A02,083757,Briones; Jor-el Thomas Caparas,1,0,36,35
1657308371229,MATH 20B,A03,093475,Briones; Jor-el Thomas Caparas,2,0,36,34
1657308377256,MATH 20C,A01,083760,Briones; Jor-el Thomas Caparas,1,0,35,34
1657308377256,MATH 20C,A02,083761,Briones; Jor-el Thomas Caparas,8,0,35,27
1657308377256,MATH 20C,A03,093476,Briones; Jor-el Thomas Caparas,0,1,36,36
1657308377256,MATH 20C,B01,083762,Bach; Quang Tran,1,0,30,29
1657308383279,MATH 20D,A01,083765,Tran; Brian Kha,5,0,30,25
1657308383279,MATH 20D,A02,083766,Tran; Brian Kha,5,0,30,25
1657308383279,MATH 20D,A03,083767,Tran; Brian Kha,4,0,30,26
1657308389303,MATH 20E,A01,083771,Ganguly; Soumya,7,0,32,25
1657308389303,MATH 20E,A02,083772,Ganguly; Soumya,6,0,32,26
1657308389303,MATH 20E,B01,083773,Ciotti; Benjamin,19,0,35,16
1657308389303,MATH 20E,B02,083774,Ciotti; Benjamin,17,0,35,18
1657308395334,MATH 103A,A01,083777,Greenfeld; Be'Eri,3,0,36,33
1657308395334,MATH 103A,A02,083778,Greenfeld; Be'Eri,5,0,36,31
1657308395334,MATH 103A,A03,093561,Greenfeld; Be'Eri,4,0,36,32
1657308395334,MATH 103A,B01,083779,Greenfeld; Be'Eri,6,0,36,30
1657308395334,MATH 103A,B02,083780,Greenfeld; Be'Eri,4,0,36,32
1657308395334,MATH 103A,B03,093562,Greenfeld; Be'Eri,3,0,36,33
1657308401357,MATH 105,A01,085443,Carter; Anne Toulson,15,0,35,20
1657308401357,MATH 105,A02,093477,Carter; Anne Toulson,20,0,35,15
1657308407379,MATH 109,A01,083213,Ganzberger; Geoffrey Michael,2,0,34,32
1657308407379,MATH 109,A02,083214,Ganzberger; Geoffrey Michael,4,0,34,30
1657308407379,MATH 109,A03,093478,Ganzberger; Geoffrey Michael,2,0,34,32
1657308407379,MATH 109,B01,083215,Ganzberger; Geoffrey Michael,1,0,32,31
1657308407379,MATH 109,B02,083216,Ganzberger; Geoffrey Michael,1,0,32,31
1657308407379,MATH 109,B03,093479,Ganzberger; Geoffrey Michael,8,0,32,24
1657308413403,MATH 142A,A01,083219,Chow; Bennett,7,0,32,25
1657308413403,MATH 142A,A02,083220,Chow; Bennett,10,0,32,22
1657308413403,MATH 142A,A03,093480,Chow; Bennett,7,0,32,25
1657308413403,MATH 142A,B03,093481,Chow; Bennett,8,0,32,24
1657308413403,MATH 142A,B04,093558,Chow; Bennett,12,0,32,20
1657308413403,MATH 142A,B05,093559,Chow; Bennett,6,0,32,26
1657308419428,MATH 193A,A01,083224,Rotar; Vladimir,7,0,34,27
1657308419428,MATH 193A,A02,083225,Rotar; Vladimir,7,0,34,27
1657308419428,MATH 193A,A03,083781,Rotar; Vladimir,3,0,34,31
1657308419428,MATH 193A,A04,083782,Rotar; Vladimir,8,0,34,26
1657308419428,MATH 193A,A05,093482,Rotar; Vladimir,8,0,34,26
1657308425459,MATH 197,001,091859,McAuley; Julian John,9999,0,9999,0
1657308425459,MATH 197,002,095566,Kedlaya; Kiran S.,9997,0,9999,2
1657308425459,MATH 197,003,095567,Xiao; Ming,9999,0,9999,0
1657308425459,MATH 197,004,095571,Perols; Johan Lars,9998,0,9999,1
1657308432509,COGS 9,A01,083615,Shannon; Kyle Michael,8,0,75,67
1657308438536,COGS 11,A01,083617,Boyle; Mary E. T.,22,0,48,26
1657308444558,COGS 13,A01,083071,Bastos; Amalia Pinkusfeld,10,0,71,61
1657308450582,COGS 14A,A01,092681,Semenuks; Arturs,2,1,100,98
1657308456606,COGS 14B,A01,083073,Cheng; Tzu-Han,6,0,63,57
1657308462633,COGS 17,A01,092677,Semenuks; Arturs,5,0,81,76
1657308468657,COGS 100,A01,083619,Allen; Michael Gordon,16,0,70,54
1657308474685,COGS 101A,A01,083621,Davis; Joshua Daniel,9,0,68,59
1657308480712,COGS 101B,A01,091572,Allen; Michael Gordon,11,0,65,54
1657308486752,COGS 101C,A01,083625,Delgado; Tania,17,0,35,18
1657308492779,COGS 107A,A01,083627,Boyle; Mary E. T.,13,0,60,47
1657308498821,COGS 118A,A01,083075,Gupta; Anjum,18,0,76,58
1657308504844,CSE 3,A50,083646,Miranda; Gregory Joseph,24,0,50,26
1657308510880,CSE 8A,A50,083650,Miranda; Gregory Joseph,17,1,56,39
1657308516905,CSE 11,A01,083080,Cao; Yingjun,6,15,40,34
1657308522933,CSE 12,A01,083652,Krause-Levy; Sophia Louisa,26,1,120,94
1657308528957,CSE 15L,A01,083654,Morris; Justin Loren,9,0,50,41
1657308528957,CSE 15L,A02,083655,Morris; Justin Loren,9,0,50,41
1657308534979,CSE 20,A01,083657,Tran; Khoa Dang,38,0,80,42
1657308541003,CSE 21,A01,095574,Bach; Quang Tran,22,0,48,26
1657308547030,CSE 30,A01,083084,Eldon; John,4,0,80,76
1657308547030,CSE 30,B01,095061,Bhaskar; Nishant,9,0,50,41
1657308553055,CSE 100,A01,083659,Cao; Yingjun,4,4,70,66
1657308559079,CSE 134B,A01,083661,Powell; Thomas Allan,21,0,100,79
1657308565108,CSE 140,A01,083663,Gungor; Onat,13,0,85,72
1657308571131,CSE 140L,A01,083088,Eldon; John,20,0,100,80
1657308577160,CSE 175,A01,083665,Kumar; Rakesh,3,0,25,22
1657308583185,CSE 190,A00,092507,Dubnov; Shlomo,7,0,20,13
1657308589214,ECE 45,A01,083139,Congero; Spencer William,6,0,75,69
1657308595240,ECE 65,A50,083695,Saad; Andrew S,12,0,30,18
1657308595240,ECE 65,A51,095125,Saad; Andrew S,25,0,26,1
1657308601271,ECE 109,A01,091882,Touri; Behrouz,19,0,70,51
1657308607298,ECE 180,A00,083140,Abi Samra; Nicholas Camill,1,0,30,29
1657308607298,ECE 180,B00,083141,Abi Samra; Nicholas Camill,0,0,30,30
1657308613322,MATH 10A,A01,083735,Patchell; Gregory David,2,0,30,28
1657308613322,MATH 10A,A02,083736,Patchell; Gregory David,20,0,30,10
1657308613322,MATH 10A,A03,083737,Patchell; Gregory David,16,0,30,14
1657308619357,MATH 10B,A01,083207,Lim; Seonhee,7,0,34,27
1657308619357,MATH 10B,A02,083208,Lim; Seonhee,9,0,35,26
1657308619357,MATH 10B,A03,093472,Lim; Seonhee,7,0,34,27
1657308619357,MATH 10B,B01,083739,Sinha; Shubham,11,0,30,19
1657308625388,MATH 18,A01,083743,Cinel; Cameron Alexander,6,0,30,24
1657308625388,MATH 18,A02,083744,Cinel; Cameron Alexander,17,0,30,13
1657308625388,MATH 18,A03,083745,Cinel; Cameron Alexander,8,0,30,22
1657308625388,MATH 18,B01,083748,Rideout; David Porter,4,0,37,33
1657308625388,MATH 18,B02,083749,Rideout; David Porter,4,0,36,32
1657308625388,MATH 18,B03,083750,Rideout; David Porter,3,0,37,34
1657308625388,MATH 18,B04,083751,Rideout; David Porter,6,0,36,30
1657308625388,MATH 18,B05,093473,Rideout; David Porter,5,0,36,31
1657308625388,MATH 18,B06,093474,Rideout; David Porter,5,0,36,31
1657308631412,MATH 20A,A01,083754,Zheng; Zequn,14,0,40,26
1657308637437,MATH 20B,A01,083756,Briones; Jor-el Thomas Caparas,3,0,36,33
1657308637437,MATH 20B,A02,083757,Briones; Jor-el Thomas Caparas,1,0,36,35
1657308637437,MATH 20B,A03,093475,Briones; Jor-el Thomas Caparas,2,0,36,34
1657308643465,MATH 20C,A01,083760,Briones; Jor-el Thomas Caparas,1,0,35,34
1657308643465,MATH 20C,A02,083761,Briones; Jor-el Thomas Caparas,8,0,35,27
1657308643465,MATH 20C,A03,093476,Briones; Jor-el Thomas Caparas,0,1,36,36
1657308643465,MATH 20C,B01,083762,Bach; Quang Tran,1,0,30,29
1657308649493,MATH 20D,A01,083765,Tran; Brian Kha,5,0,30,25
1657308649493,MATH 20D,A02,083766,Tran; Brian Kha,5,0,30,25
1657308649493,MATH 20D,A03,083767,Tran; Brian Kha,4,0,30,26
1657308655516,MATH 20E,A01,083771,Ganguly; Soumya,7,0,32,25
1657308655516,MATH 20E,A02,083772,Ganguly; Soumya,6,0,32,26
1657308655516,MATH 20E,B01,083773,Ciotti; Benjamin,19,0,35,16
1657308655516,MATH 20E,B02,083774,Ciotti; Benjamin,17,0,35,18
1657308661542,MATH 103A,A01,083777,Greenfeld; Be'Eri,3,0,36,33
1657308661542,MATH 103A,A02,083778,Greenfeld; Be'Eri,5,0,36,31
1657308661542,MATH 103A,A03,093561,Greenfeld; Be'Eri,4,0,36,32
1657308661542,MATH 103A,B01,083779,Greenfeld; Be'Eri,6,0,36,30
1657308661542,MATH 103A,B02,083780,Greenfeld; Be'Eri,4,0,36,32
1657308661542,MATH 103A,B03,093562,Greenfeld; Be'Eri,3,0,36,33
1657308667570,MATH 105,A01,085443,Carter; Anne Toulson,15,0,35,20
1657308667570,MATH 105,A02,093477,Carter; Anne Toulson,20,0,35,15
1657308673595,MATH 109,A01,083213,Ganzberger; Geoffrey Michael,2,0,34,32
1657308673595,MATH 109,A02,083214,Ganzberger; Geoffrey Michael,4,0,34,30
1657308673595,MATH 109,A03,093478,Ganzberger; Geoffrey Michael,2,0,34,32
1657308673595,MATH 109,B01,083215,Ganzberger; Geoffrey Michael,1,0,32,31
1657308673595,MATH 109,B02,083216,Ganzberger; Geoffrey Michael,1,0,32,31
1657308673595,MATH 109,B03,093479,Ganzberger; Geoffrey Michael,8,0,32,24
1657308679634,MATH 142A,A01,083219,Chow; Bennett,7,0,32,25
1657308679634,MATH 142A,A02,083220,Chow; Bennett,10,0,32,22
1657308679634,MATH 142A,A03,093480,Chow; Bennett,7,0,32,25
1657308679634,MATH 142A,B03,093481,Chow; Bennett,8,0,32,24
1657308679634,MATH 142A,B04,093558,Chow; Bennett,12,0,32,20
1657308679634,MATH 142A,B05,093559,Chow; Bennett,6,0,32,26
1657308685660,MATH 193A,A01,083224,Rotar; Vladimir,7,0,34,27
1657308685660,MATH 193A,A02,083225,Rotar; Vladimir,7,0,34,27
1657308685660,MATH 193A,A03,083781,Rotar; Vladimir,3,0,34,31
1657308685660,MATH 193A,A04,083782,Rotar; Vladimir,8,0,34,26
1657308685660,MATH 193A,A05,093482,Rotar; Vladimir,8,0,34,26
1657308691684,MATH 197,001,091859,McAuley; Julian John,9999,0,9999,0
1657308691684,MATH 197,002,095566,Kedlaya; Kiran S.,9997,0,9999,2
1657308691684,MATH 197,003,095567,Xiao; Ming,9999,0,9999,0
1657308691684,MATH 197,004,095571,Perols; Johan Lars,9998,0,9999,1
1657308698745,COGS 9,A01,083615,Shannon; Kyle Michael,8,0,75,67
1657308704768,COGS 11,A01,083617,Boyle; Mary E. T.,22,0,48,26
1657308710796,COGS 13,A01,083071,Bastos; Amalia Pinkusfeld,10,0,71,61
1657308716822,COGS 14A,A01,092681,Semenuks; Arturs,2,1,100,98
1657308722847,COGS 14B,A01,083073,Cheng; Tzu-Han,6,0,63,57
1657308728874,COGS 17,A01,092677,Semenuks; Arturs,5,0,81,76
1657308735008,COGS 100,A01,083619,Allen; Michael Gordon,16,0,70,54
1657308741034,COGS 101A,A01,083621,Davis; Joshua Daniel,9,0,68,59
1657308747061,COGS 101B,A01,091572,Allen; Michael Gordon,11,0,65,54
1657308753089,COGS 101C,A01,083625,Delgado; Tania,17,0,35,18
1657308759129,COGS 107A,A01,083627,Boyle; Mary E. T.,13,0,60,47
1657308766208,COGS 118A,A01,083075,Gupta; Anjum,18,0,76,58
1657308772269,CSE 3,A50,083646,Miranda; Gregory Joseph,24,0,50,26
1657308778296,CSE 8A,A50,083650,Miranda; Gregory Joseph,17,1,56,39
1657308784325,CSE 11,A01,083080,Cao; Yingjun,6,15,40,34
1657308790349,CSE 12,A01,083652,Krause-Levy; Sophia Louisa,26,1,120,94
1657308796377,CSE 15L,A01,083654,Morris; Justin Loren,9,0,50,41
1657308796377,CSE 15L,A02,083655,Morris; Justin Loren,9,0,50,41
1657308802402,CSE 20,A01,083657,Tran; Khoa Dang,38,0,80,42
1657308808423,CSE 21,A01,095574,Bach; Quang Tran,22,0,48,26
1657308814446,CSE 30,A01,083084,Eldon; John,4,0,80,76
1657308814446,CSE 30,B01,095061,Bhaskar; Nishant,9,0,50,41
1657308820472,CSE 100,A01,083659,Cao; Yingjun,4,4,70,66
1657308826502,CSE 134B,A01,083661,Powell; Thomas Allan,21,0,100,79
1657308832524,CSE 140,A01,083663,Gungor; Onat,13,0,85,72
1657308838546,CSE 140L,A01,083088,Eldon; John,20,0,100,80
1657308844568,CSE 175,A01,083665,Kumar; Rakesh,3,0,25,22
1657308850595,CSE 190,A00,092507,Dubnov; Shlomo,7,0,20,13
1657308856616,ECE 45,A01,083139,Congero; Spencer William,6,0,75,69
1657308862646,ECE 65,A50,083695,Saad; Andrew S,12,0,30,18
1657308862646,ECE 65,A51,095125,Saad; Andrew S,25,0,26,1
1657308868667,ECE 109,A01,091882,Touri; Behrouz,19,0,70,51
1657308874696,ECE 180,A00,083140,Abi Samra; Nicholas Camill,1,0,30,29
1657308874696,ECE 180,B00,083141,Abi Samra; Nicholas Camill,0,0,30,30
1657308880718,MATH 10A,A01,083735,Patchell; Gregory David,2,0,30,28
1657308880718,MATH 10A,A02,083736,Patchell; Gregory David,20,0,30,10
1657308880718,MATH 10A,A03,083737,Patchell; Gregory David,16,0,30,14
1657308886742,MATH 10B,A01,083207,Lim; Seonhee,7,0,34,27
1657308886742,MATH 10B,A02,083208,Lim; Seonhee,9,0,35,26
1657308886742,MATH 10B,A03,093472,Lim; Seonhee,7,0,34,27
1657308886742,MATH 10B,B01,083739,Sinha; Shubham,11,0,30,19
1657308892766,MATH 18,A01,083743,Cinel; Cameron Alexander,6,0,30,24
1657308892766,MATH 18,A02,083744,Cinel; Cameron Alexander,17,0,30,13
1657308892766,MATH 18,A03,083745,Cinel; Cameron Alexander,8,0,30,22
1657308892766,MATH 18,B01,083748,Rideout; David Porter,4,0,37,33
1657308892766,MATH 18,B02,083749,Rideout; David Porter,4,0,36,32
1657308892766,MATH 18,B03,083750,Rideout; David Porter,3,0,37,34
1657308892766,MATH 18,B04,083751,Rideout; David Porter,6,0,36,30
1657308892766,MATH 18,B05,093473,Rideout; David Porter,5,0,36,31
1657308892766,MATH 18,B06,093474,Rideout; David Porter,5,0,36,31
1657308898789,MATH 20A,A01,083754,Zheng; Zequn,14,0,40,26
1657308904812,MATH 20B,A01,083756,Briones; Jor-el Thomas Caparas,3,0,36,33
1657308904812,MATH 20B,A02,083757,Briones; Jor-el Thomas Caparas,1,0,36,35
1657308904812,MATH 20B,A03,093475,Briones; Jor-el Thomas Caparas,2,0,36,34
1657308910834,MATH 20C,A01,083760,Briones; Jor-el Thomas Caparas,1,0,35,34
1657308910834,MATH 20C,A02,083761,Briones; Jor-el Thomas Caparas,8,0,35,27
1657308910834,MATH 20C,A03,093476,Briones; Jor-el Thomas Caparas,0,1,36,36
1657308910834,MATH 20C,B01,083762,Bach; Quang Tran,1,0,30,29
1657308916859,MATH 20D,A01,083765,Tran; Brian Kha,5,0,30,25
1657308916859,MATH 20D,A02,083766,Tran; Brian Kha,5,0,30,25
1657308916859,MATH 20D,A03,083767,Tran; Brian Kha,4,0,30,26
1657308922890,MATH 20E,A01,083771,Ganguly; Soumya,7,0,32,25
1657308922890,MATH 20E,A02,083772,Ganguly; Soumya,6,0,32,26
1657308922890,MATH 20E,B01,083773,Ciotti; Benjamin,19,0,35,16
1657308922890,MATH 20E,B02,083774,Ciotti; Benjamin,17,0,35,18
1657308928914,MATH 103A,A01,083777,Greenfeld; Be'Eri,3,0,36,33
1657308928914,MATH 103A,A02,083778,Greenfeld; Be'Eri,5,0,36,31
1657308928914,MATH 103A,A03,093561,Greenfeld; Be'Eri,4,0,36,32
1657308928914,MATH 103A,B01,083779,Greenfeld; Be'Eri,6,0,36,30
1657308928914,MATH 103A,B02,083780,Greenfeld; Be'Eri,4,0,36,32
1657308928914,MATH 103A,B03,093562,Greenfeld; Be'Eri,3,0,36,33
1657308934938,MATH 105,A01,085443,Carter; Anne Toulson,15,0,35,20
1657308934938,MATH 105,A02,093477,Carter; Anne Toulson,20,0,35,15
1657308940961,MATH 109,A01,083213,Ganzberger; Geoffrey Michael,2,0,34,32
1657308940961,MATH 109,A02,083214,Ganzberger; Geoffrey Michael,4,0,34,30
1657308940961,MATH 109,A03,093478,Ganzberger; Geoffrey Michael,2,0,34,32
1657308940961,MATH 109,B01,083215,Ganzberger; Geoffrey Michael,1,0,32,31
1657308940961,MATH 109,B02,083216,Ganzberger; Geoffrey Michael,1,0,32,31
1657308940961,MATH 109,B03,093479,Ganzberger; Geoffrey Michael,8,0,32,24
1657308946994,MATH 142A,A01,083219,Chow; Bennett,7,0,32,25
1657308946994,MATH 142A,A02,083220,Chow; Bennett,10,0,32,22
1657308946994,MATH 142A,A03,093480,Chow; Bennett,7,0,32,25
1657308946994,MATH 142A,B03,093481,Chow; Bennett,8,0,32,24
1657308946994,MATH 142A,B04,093558,Chow; Bennett,12,0,32,20
1657308946994,MATH 142A,B05,093559,Chow; Bennett,6,0,32,26
1657308953019,MATH 193A,A01,083224,Rotar; Vladimir,7,0,34,27
1657308953019,MATH 193A,A02,083225,Rotar; Vladimir,7,0,34,27
1657308953019,MATH 193A,A03,083781,Rotar; Vladimir,3,0,34,31
1657308953019,MATH 193A,A04,083782,Rotar; Vladimir,8,0,34,26
1657308953019,MATH 193A,A05,093482,Rotar; Vladimir,8,0,34,26
1657308959050,MATH 197,001,091859,McAuley; Julian John,9999,0,9999,0
1657308959050,MATH 197,002,095566,Kedlaya; Kiran S.,9997,0,9999,2
1657308959050,MATH 197,003,095567,Xiao; Ming,9999,0,9999,0
1657308959050,MATH 197,004,095571,Perols; Johan Lars,9998,0,9999,1
1657308966106,COGS 9,A01,083615,Shannon; Kyle Michael,8,0,75,67
1657308972130,COGS 11,A01,083617,Boyle; Mary E. T.,22,0,48,26
1657308978166,COGS 13,A01,083071,Bastos; Amalia Pinkusfeld,10,0,71,61
1657308984205,COGS 14A,A01,092681,Semenuks; Arturs,2,1,100,98
1657308990233,COGS 14B,A01,083073,Cheng; Tzu-Han,6,0,63,57
1657308996259,COGS 17,A01,092677,Semenuks; Arturs,5,0,81,76
1657309002286,COGS 100,A01,083619,Allen; Michael Gordon,16,0,70,54
1657309008309,COGS 101A,A01,083621,Davis; Joshua Daniel,9,0,68,59
1657309014332,COGS 101B,A01,091572,Allen; Michael Gordon,11,0,65,54
1657309020359,COGS 101C,A01,083625,Delgado; Tania,17,0,35,18
1657309026382,COGS 107A,A01,083627,Boyle; Mary E. T.,13,0,60,47
1657309032409,COGS 118A,A01,083075,Gupta; Anjum,18,0,76,58
1657309038436,CSE 3,A50,083646,Miranda; Gregory Joseph,24,0,50,26
1657309044474,CSE 8A,A50,083650,Miranda; Gregory Joseph,17,1,56,39
1657309050496,CSE 11,A01,083080,Cao; Yingjun,6,15,40,34
1657309056522,CSE 12,A01,083652,Krause-Levy; Sophia Louisa,26,1,120,94
1657309062554,CSE 15L,A01,083654,Morris; Justin Loren,9,0,50,41
1657309062554,CSE 15L,A02,083655,Morris; Justin Loren,9,0,50,41
1657309068585,CSE 20,A01,083657,Tran; Khoa Dang,38,0,80,42
1657309074608,CSE 21,A01,095574,Bach; Quang Tran,22,0,48,26
1657309080639,CSE 30,A01,083084,Eldon; John,4,0,80,76
1657309080639,CSE 30,B01,095061,Bhaskar; Nishant,9,0,50,41
1657309086675,CSE 100,A01,083659,Cao; Yingjun,4,4,70,66
1657309092701,CSE 134B,A01,083661,Powell; Thomas Allan,21,0,100,79
1657309098727,CSE 140,A01,083663,Gungor; Onat,13,0,85,72
1657309104749,CSE 140L,A01,083088,Eldon; John,20,0,100,80
1657309110775,CSE 175,A01,083665,Kumar; Rakesh,3,0,25,22
1657309116799,CSE 190,A00,092507,Dubnov; Shlomo,7,0,20,13
1657309122823,ECE 45,A01,083139,Congero; Spencer William,6,0,75,69
1657309128845,ECE 65,A50,083695,Saad; Andrew S,12,0,30,18
1657309128845,ECE 65,A51,095125,Saad; Andrew S,25,0,26,1
1657309134871,ECE 109,A01,091882,Touri; Behrouz,19,0,70,51
1657309140892,ECE 180,A00,083140,Abi Samra; Nicholas Camill,1,0,30,29
1657309140892,ECE 180,B00,083141,Abi Samra; Nicholas Camill,0,0,30,30
1657309146914,MATH 10A,A01,083735,Patchell; Gregory David,2,0,30,28
1657309146914,MATH 10A,A02,083736,Patchell; Gregory David,20,0,30,10
1657309146914,MATH 10A,A03,083737,Patchell; Gregory David,16,0,30,14
1657309152937,MATH 10B,A01,083207,Lim; Seonhee,7,0,34,27
1657309152937,MATH 10B,A02,083208,Lim; Seonhee,9,0,35,26
1657309152937,MATH 10B,A03,093472,Lim; Seonhee,7,0,34,27
1657309152937,MATH 10B,B01,083739,Sinha; Shubham,11,0,30,19
1657309158962,MATH 18,A01,083743,Cinel; Cameron Alexander,6,0,30,24
1657309158962,MATH 18,A02,083744,Cinel; Cameron Alexander,17,0,30,13
1657309158962,MATH 18,A03,083745,Cinel; Cameron Alexander,8,0,30,22
1657309158962,MATH 18,B01,083748,Rideout; David Porter,4,0,37,33
1657309158962,MATH 18,B02,083749,Rideout; David Porter,4,0,36,32
1657309158962,MATH 18,B03,083750,Rideout; David Porter,3,0,37,34
1657309158962,MATH 18,B04,083751,Rideout; David Porter,6,0,36,30
1657309158962,MATH 18,B05,093473,Rideout; David Porter,5,0,36,31
1657309158962,MATH 18,B06,093474,Rideout; David Porter,5,0,36,31
1657309164988,MATH 20A,A01,083754,Zheng; Zequn,14,0,40,26
1657309171017,MATH 20B,A01,083756,Briones; Jor-el Thomas Caparas,3,0,36,33
1657309171017,MATH 20B,A02,083757,Briones; Jor-el Thomas Caparas,1,0,36,35
1657309171017,MATH 20B,A03,093475,Briones; Jor-el Thomas Caparas,2,0,36,34
1657309177039,MATH 20C,A01,083760,Briones; Jor-el Thomas Caparas,1,0,35,34
1657309177039,MATH 20C,A02,083761,Briones; Jor-el Thomas Caparas,8,0,35,27
1657309177039,MATH 20C,A03,093476,Briones; Jor-el Thomas Caparas,0,1,36,36
1657309177039,MATH 20C,B01,083762,Bach; Quang Tran,1,0,30,29
1657309183061,MATH 20D,A01,083765,Tran; Brian Kha,5,0,30,25
1657309183061,MATH 20D,A02,083766,Tran; Brian Kha,5,0,30,25
1657309183061,MATH 20D,A03,083767,Tran; Brian Kha,4,0,30,26
1657309189084,MATH 20E,A01,083771,Ganguly; Soumya,7,0,32,25
1657309189084,MATH 20E,A02,083772,Ganguly; Soumya,6,0,32,26
1657309189084,MATH 20E,B01,083773,Ciotti; Benjamin,19,0,35,16
1657309189084,MATH 20E,B02,083774,Ciotti; Benjamin,17,0,35,18
1657309195114,MATH 103A,A01,083777,Greenfeld; Be'Eri,3,0,36,33
1657309195114,MATH 103A,A02,083778,Greenfeld; Be'Eri,5,0,36,31
1657309195114,MATH 103A,A03,093561,Greenfeld; Be'Eri,4,0,36,32
1657309195114,MATH 103A,B01,083779,Greenfeld; Be'Eri,6,0,36,30
1657309195114,MATH 103A,B02,083780,Greenfeld; Be'Eri,4,0,36,32
1657309195114,MATH 103A,B03,093562,Greenfeld; Be'Eri,3,0,36,33
1657309201136,MATH 105,A01,085443,Carter; Anne Toulson,15,0,35,20
1657309201136,MATH 105,A02,093477,Carter; Anne Toulson,20,0,35,15
1657309207166,MATH 109,A01,083213,Ganzberger; Geoffrey Michael,2,0,34,32
1657309207166,MATH 109,A02,083214,Ganzberger; Geoffrey Michael,4,0,34,30
1657309207166,MATH 109,A03,093478,Ganzberger; Geoffrey Michael,2,0,34,32
1657309207166,MATH 109,B01,083215,Ganzberger; Geoffrey Michael,1,0,32,31
1657309207166,MATH 109,B02,083216,Ganzberger; Geoffrey Michael,1,0,32,31
1657309207166,MATH 109,B03,093479,Ganzberger; Geoffrey Michael,8,0,32,24
1657309213190,MATH 142A,A01,083219,Chow; Bennett,7,0,32,25
1657309213190,MATH 142A,A02,083220,Chow; Bennett,10,0,32,22
1657309213190,MATH 142A,A03,093480,Chow; Bennett,7,0,32,25
1657309213190,MATH 142A,B03,093481,Chow; Bennett,8,0,32,24
1657309213190,MATH 142A,B04,093558,Chow; Bennett,13,0,32,19
1657309213190,MATH 142A,B05,093559,Chow; Bennett,6,0,32,26
1657309219212,MATH 193A,A01,083224,Rotar; Vladimir,7,0,34,27
1657309219212,MATH 193A,A02,083225,Rotar; Vladimir,7,0,34,27
1657309219212,MATH 193A,A03,083781,Rotar; Vladimir,3,0,34,31
1657309219212,MATH 193A,A04,083782,Rotar; Vladimir,8,0,34,26
1657309219212,MATH 193A,A05,093482,Rotar; Vladimir,8,0,34,26
1657309225234,MATH 197,001,091859,McAuley; Julian John,9999,0,9999,0
1657309225234,MATH 197,002,095566,Kedlaya; Kiran S.,9997,0,9999,2
1657309225234,MATH 197,003,095567,Xiao; Ming,9999,0,9999,0
1657309225234,MATH 197,004,095571,Perols; Johan Lars,9998,0,9999,1
1657309232291,COGS 9,A01,083615,Shannon; Kyle Michael,8,0,75,67
1657309238313,COGS 11,A01,083617,Boyle; Mary E. T.,22,0,48,26
1657309244342,COGS 13,A01,083071,Bastos; Amalia Pinkusfeld,10,0,71,61
1657309250367,COGS 14A,A01,092681,Semenuks; Arturs,2,1,100,98
1657309256390,COGS 14B,A01,083073,Cheng; Tzu-Han,6,0,63,57
1657309262418,COGS 17,A01,092677,Semenuks; Arturs,5,0,81,76
1657309268454,COGS 100,A01,083619,Allen; Michael Gordon,16,0,70,54
1657309274480,COGS 101A,A01,083621,Davis; Joshua Daniel,9,0,68,59
1657309280503,COGS 101B,A01,091572,Allen; Michael Gordon,11,0,65,54
1657309286529,COGS 101C,A01,083625,Delgado; Tania,17,0,35,18
1657309292555,COGS 107A,A01,083627,Boyle; Mary E. T.,13,0,60,47
1657309298576,COGS 118A,A01,083075,Gupta; Anjum,18,0,76,58
1657309304604,CSE 3,A50,083646,Miranda; Gregory Joseph,24,0,50,26
1657309310635,CSE 8A,A50,083650,Miranda; Gregory Joseph,17,1,56,39
1657309316664,CSE 11,A01,083080,Cao; Yingjun,6,15,40,34
1657309322693,CSE 12,A01,083652,Krause-Levy; Sophia Louisa,26,1,120,94
1657309328728,CSE 15L,A01,083654,Morris; Justin Loren,9,0,50,41
1657309328728,CSE 15L,A02,083655,Morris; Justin Loren,9,0,50,41
1657309334843,CSE 20,A01,083657,Tran; Khoa Dang,38,0,80,42
1657309340868,CSE 21,A01,095574,Bach; Quang Tran,22,0,48,26
1657309346898,CSE 30,A01,083084,Eldon; John,4,0,80,76
1657309346898,CSE 30,B01,095061,Bhaskar; Nishant,9,0,50,41
1657309352921,CSE 100,A01,083659,Cao; Yingjun,4,4,70,66
1657309358951,CSE 134B,A01,083661,Powell; Thomas Allan,21,0,100,79
1657309364973,CSE 140,A01,083663,Gungor; Onat,13,0,85,72
1657309371004,CSE 140L,A01,083088,Eldon; John,20,0,100,80
1657309377026,CSE 175,A01,083665,Kumar; Rakesh,3,0,25,22
1657309383058,CSE 190,A00,092507,Dubnov; Shlomo,7,0,20,13
1657309389084,ECE 45,A01,083139,Congero; Spencer William,6,0,75,69
1657309395109,ECE 65,A50,083695,Saad; Andrew S,12,0,30,18
1657309395109,ECE 65,A51,095125,Saad; Andrew S,25,0,26,1
1657309401135,ECE 109,A01,091882,Touri; Behrouz,19,0,70,51
1657309407171,ECE 180,A00,083140,Abi Samra; Nicholas Camill,1,0,30,29
1657309407171,ECE 180,B00,083141,Abi Samra; Nicholas Camill,0,0,30,30
1657309413198,MATH 10A,A01,083735,Patchell; Gregory David,2,0,30,28
1657309413198,MATH 10A,A02,083736,Patchell; Gregory David,20,0,30,10
1657309413198,MATH 10A,A03,083737,Patchell; Gregory David,16,0,30,14
1657309419234,MATH 10B,A01,083207,Lim; Seonhee,7,0,34,27
1657309419234,MATH 10B,A02,083208,Lim; Seonhee,9,0,35,26
1657309419234,MATH 10B,A03,093472,Lim; Seonhee,7,0,34,27
1657309419234,MATH 10B,B01,083739,Sinha; Shubham,11,0,30,19
1657309425268,MATH 18,A01,083743,Cinel; Cameron Alexander,6,0,30,24
1657309425268,MATH 18,A02,083744,Cinel; Cameron Alexander,17,0,30,13
1657309425268,MATH 18,A03,083745,Cinel; Cameron Alexander,8,0,30,22
1657309425268,MATH 18,B01,083748,Rideout; David Porter,4,0,37,33
1657309425268,MATH 18,B02,083749,Rideout; David Porter,4,0,36,32
1657309425268,MATH 18,B03,083750,Rideout; David Porter,3,0,37,34
1657309425268,MATH 18,B04,083751,Rideout; David Porter,6,0,36,30
1657309425268,MATH 18,B05,093473,Rideout; David Porter,5,0,36,31
1657309425268,MATH 18,B06,093474,Rideout; David Porter,5,0,36,31
1657309431291,MATH 20A,A01,083754,Zheng; Zequn,14,0,40,26
1657309437324,MATH 20B,A01,083756,Briones; Jor-el Thomas Caparas,3,0,36,33
1657309437324,MATH 20B,A02,083757,Briones; Jor-el Thomas Caparas,1,0,36,35
1657309437324,MATH 20B,A03,093475,Briones; Jor-el Thomas Caparas,2,0,36,34
1657309443347,MATH 20C,A01,083760,Briones; Jor-el Thomas Caparas,1,0,35,34
1657309443347,MATH 20C,A02,083761,Briones; Jor-el Thomas Caparas,8,0,35,27
1657309443347,MATH 20C,A03,093476,Briones; Jor-el Thomas Caparas,0,1,36,36
1657309443347,MATH 20C,B01,083762,Bach; Quang Tran,1,0,30,29
1657309449380,MATH 20D,A01,083765,Tran; Brian Kha,5,0,30,25
1657309449380,MATH 20D,A02,083766,Tran; Brian Kha,5,0,30,25
1657309449380,MATH 20D,A03,083767,Tran; Brian Kha,4,0,30,26
1657309455406,MATH 20E,A01,083771,Ganguly; Soumya,7,0,32,25
1657309455406,MATH 20E,A02,083772,Ganguly; Soumya,6,0,32,26
1657309455406,MATH 20E,B01,083773,Ciotti; Benjamin,19,0,35,16
1657309455406,MATH 20E,B02,083774,Ciotti; Benjamin,17,0,35,18
1657309461429,MATH 103A,A01,083777,Greenfeld; Be'Eri,3,0,36,33
1657309461429,MATH 103A,A02,083778,Greenfeld; Be'Eri,5,0,36,31
1657309461429,MATH 103A,A03,093561,Greenfeld; Be'Eri,4,0,36,32
1657309461429,MATH 103A,B01,083779,Greenfeld; Be'Eri,6,0,36,30
1657309461429,MATH 103A,B02,083780,Greenfeld; Be'Eri,4,0,36,32
1657309461429,MATH 103A,B03,093562,Greenfeld; Be'Eri,3,0,36,33
1657309467459,MATH 105,A01,085443,Carter; Anne Toulson,15,0,35,20
1657309467459,MATH 105,A02,093477,Carter; Anne Toulson,20,0,35,15
1657309473482,MATH 109,A01,083213,Ganzberger; Geoffrey Michael,2,0,34,32
1657309473482,MATH 109,A02,083214,Ganzberger; Geoffrey Michael,4,0,34,30
1657309473482,MATH 109,A03,093478,Ganzberger; Geoffrey Michael,2,0,34,32
1657309473482,MATH 109,B01,083215,Ganzberger; Geoffrey Michael,1,0,32,31
1657309473482,MATH 109,B02,083216,Ganzberger; Geoffrey Michael,1,0,32,31
1657309473482,MATH 109,B03,093479,Ganzberger; Geoffrey Michael,8,0,32,24
1657309479513,MATH 142A,A01,083219,Chow; Bennett,7,0,32,25
1657309479513,MATH 142A,A02,083220,Chow; Bennett,10,0,32,22
1657309479513,MATH 142A,A03,093480,Chow; Bennett,7,0,32,25
1657309479513,MATH 142A,B03,093481,Chow; Bennett,8,0,32,24
1657309479513,MATH 142A,B04,093558,Chow; Bennett,13,0,32,19
1657309479513,MATH 142A,B05,093559,Chow; Bennett,6,0,32,26
1657309485537,MATH 193A,A01,083224,Rotar; Vladimir,7,0,34,27
1657309485537,MATH 193A,A02,083225,Rotar; Vladimir,7,0,34,27
1657309485537,MATH 193A,A03,083781,Rotar; Vladimir,3,0,34,31
1657309485537,MATH 193A,A04,083782,Rotar; Vladimir,8,0,34,26
1657309485537,MATH 193A,A05,093482,Rotar; Vladimir,8,0,34,26
1657309491562,MATH 197,001,091859,McAuley; Julian John,9999,0,9999,0
1657309491562,MATH 197,002,095566,Kedlaya; Kiran S.,9997,0,9999,2
1657309491562,MATH 197,003,095567,Xiao; Ming,9999,0,9999,0
1657309491562,MATH 197,004,095571,Perols; Johan Lars,9998,0,9999,1
1657309498627,COGS 9,A01,083615,Shannon; Kyle Michael,8,0,75,67
1657309504658,COGS 11,A01,083617,Boyle; Mary E. T.,22,0,48,26
1657309510685,COGS 13,A01,083071,Bastos; Amalia Pinkusfeld,10,0,71,61
1657309516707,COGS 14A,A01,092681,Semenuks; Arturs,2,1,100,98
1657309522729,COGS 14B,A01,083073,Cheng; Tzu-Han,6,0,63,57
1657309528750,COGS 17,A01,092677,Semenuks; Arturs,5,0,81,76
1657309534783,COGS 100,A01,083619,Allen; Michael Gordon,16,0,70,54
1657309540814,COGS 101A,A01,083621,Davis; Joshua Daniel,9,0,68,59
1657309546837,COGS 101B,A01,091572,Allen; Michael Gordon,11,0,65,54
1657309552863,COGS 101C,A01,083625,Delgado; Tania,17,0,35,18
1657309558889,COGS 107A,A01,083627,Boyle; Mary E. T.,13,0,60,47
1657309564917,COGS 118A,A01,083075,Gupta; Anjum,18,0,76,58
1657309570940,CSE 3,A50,083646,Miranda; Gregory Joseph,24,0,50,26
1657309576963,CSE 8A,A50,083650,Miranda; Gregory Joseph,17,1,56,39
1657309582986,CSE 11,A01,083080,Cao; Yingjun,6,15,40,34
1657309589014,CSE 12,A01,083652,Krause-Levy; Sophia Louisa,26,1,120,94
1657309595041,CSE 15L,A01,083654,Morris; Justin Loren,9,0,50,41
1657309595041,CSE 15L,A02,083655,Morris; Justin Loren,9,0,50,41
1657309601072,CSE 20,A01,083657,Tran; Khoa Dang,38,0,80,42
1657309607095,CSE 21,A01,095574,Bach; Quang Tran,22,0,48,26
1657309613120,CSE 30,A01,083084,Eldon; John,4,0,80,76
1657309613120,CSE 30,B01,095061,Bhaskar; Nishant,9,0,50,41
1657309619143,CSE 100,A01,083659,Cao; Yingjun,4,4,70,66
1657309625177,CSE 134B,A01,083661,Powell; Thomas Allan,21,0,100,79
1657309631199,CSE 140,A01,083663,Gungor; Onat,13,0,85,72
1657309637226,CSE 140L,A01,083088,Eldon; John,20,0,100,80
1657309643260,CSE 175,A01,083665,Kumar; Rakesh,3,0,25,22
1657309649287,CSE 190,A00,092507,Dubnov; Shlomo,7,0,20,13
1657309655316,ECE 45,A01,083139,Congero; Spencer William,6,0,75,69
1657309661344,ECE 65,A50,083695,Saad; Andrew S,12,0,30,18
1657309661344,ECE 65,A51,095125,Saad; Andrew S,25,0,26,1
1657309667382,ECE 109,A01,091882,Touri; Behrouz,19,0,70,51
1657309673409,ECE 180,A00,083140,Abi Samra; Nicholas Camill,1,0,30,29
1657309673409,ECE 180,B00,083141,Abi Samra; Nicholas Camill,0,0,30,30
1657309679437,MATH 10A,A01,083735,Patchell; Gregory David,2,0,30,28
1657309679437,MATH 10A,A02,083736,Patchell; Gregory David,20,0,30,10
1657309679437,MATH 10A,A03,083737,Patchell; Gregory David,16,0,30,14
1657309685460,MATH 10B,A01,083207,Lim; Seonhee,7,0,34,27
1657309685460,MATH 10B,A02,083208,Lim; Seonhee,9,0,35,26
1657309685460,MATH 10B,A03,093472,Lim; Seonhee,7,0,34,27
1657309685460,MATH 10B,B01,083739,Sinha; Shubham,11,0,30,19
1657309691491,MATH 18,A01,083743,Cinel; Cameron Alexander,6,0,30,24
1657309691491,MATH 18,A02,083744,Cinel; Cameron Alexander,17,0,30,13
1657309691491,MATH 18,A03,083745,Cinel; Cameron Alexander,8,0,30,22
1657309691491,MATH 18,B01,083748,Rideout; David Porter,4,0,37,33
1657309691491,MATH 18,B02,083749,Rideout; David Porter,4,0,36,32
1657309691491,MATH 18,B03,083750,Rideout; David Porter,3,0,37,34
1657309691491,MATH 18,B04,083751,Rideout; David Porter,6,0,36,30
1657309691491,MATH 18,B05,093473,Rideout; David Porter,5,0,36,31
1657309691491,MATH 18,B06,093474,Rideout; David Porter,5,0,36,31
1657309697519,MATH 20A,A01,083754,Zheng; Zequn,14,0,40,26
1657309703547,MATH 20B,A01,083756,Briones; Jor-el Thomas Caparas,3,0,36,33
1657309703547,MATH 20B,A02,083757,Briones; Jor-el Thomas Caparas,1,0,36,35
1657309703547,MATH 20B,A03,093475,Briones; Jor-el Thomas Caparas,2,0,36,34
1657309709571,MATH 20C,A01,083760,Briones; Jor-el Thomas Caparas,1,0,35,34
1657309709571,MATH 20C,A02,083761,Briones; Jor-el Thomas Caparas,8,0,35,27
1657309709571,MATH 20C,A03,093476,Briones; Jor-el Thomas Caparas,0,1,36,36
1657309709571,MATH 20C,B01,083762,Bach; Quang Tran,1,0,30,29
1657309715611,MATH 20D,A01,083765,Tran; Brian Kha,5,0,30,25
1657309715611,MATH 20D,A02,083766,Tran; Brian Kha,5,0,30,25
1657309715611,MATH 20D,A03,083767,Tran; Brian Kha,4,0,30,26
1657309721643,MATH 20E,A01,083771,Ganguly; Soumya,7,0,32,25
1657309721643,MATH 20E,A02,083772,Ganguly; Soumya,6,0,32,26
1657309721643,MATH 20E,B01,083773,Ciotti; Benjamin,19,0,35,16
1657309721643,MATH 20E,B02,083774,Ciotti; Benjamin,17,0,35,18
1657309727671,MATH 103A,A01,083777,Greenfeld; Be'Eri,3,0,36,33
1657309727671,MATH 103A,A02,083778,Greenfeld; Be'Eri,5,0,36,31
1657309727671,MATH 103A,A03,093561,Greenfeld; Be'Eri,4,0,36,32
1657309727671,MATH 103A,B01,083779,Greenfeld; Be'Eri,6,0,36,30
1657309727671,MATH 103A,B02,083780,Greenfeld; Be'Eri,4,0,36,32
1657309727671,MATH 103A,B03,093562,Greenfeld; Be'Eri,3,0,36,33
1657309733697,MATH 105,A01,085443,Carter; Anne Toulson,15,0,35,20
1657309733697,MATH 105,A02,093477,Carter; Anne Toulson,20,0,35,15
1657309739726,MATH 109,A01,083213,Ganzberger; Geoffrey Michael,2,0,34,32
1657309739726,MATH 109,A02,083214,Ganzberger; Geoffrey Michael,4,0,34,30
1657309739726,MATH 109,A03,093478,Ganzberger; Geoffrey Michael,2,0,34,32
1657309739726,MATH 109,B01,083215,Ganzberger; Geoffrey Michael,1,0,32,31
1657309739726,MATH 109,B02,083216,Ganzberger; Geoffrey Michael,1,0,32,31
1657309739726,MATH 109,B03,093479,Ganzberger; Geoffrey Michael,8,0,32,24
1657309745748,MATH 142A,A01,083219,Chow; Bennett,7,0,32,25
1657309745748,MATH 142A,A02,083220,Chow; Bennett,10,0,32,22
1657309745748,MATH 142A,A03,093480,Chow; Bennett,7,0,32,25
1657309745748,MATH 142A,B03,093481,Chow; Bennett,8,0,32,24
1657309745748,MATH 142A,B04,093558,Chow; Bennett,13,0,32,19
1657309745748,MATH 142A,B05,093559,Chow; Bennett,6,0,32,26
1657309751788,MATH 193A,A01,083224,Rotar; Vladimir,7,0,34,27
1657309751788,MATH 193A,A02,083225,Rotar; Vladimir,7,0,34,27
1657309751788,MATH 193A,A03,083781,Rotar; Vladimir,3,0,34,31
1657309751788,MATH 193A,A04,083782,Rotar; Vladimir,8,0,34,26
1657309751788,MATH 193A,A05,093482,Rotar; Vladimir,8,0,34,26
1657309757810,MATH 197,001,091859,McAuley; Julian John,9999,0,9999,0
1657309757810,MATH 197,002,095566,Kedlaya; Kiran S.,9997,0,9999,2
1657309757810,MATH 197,003,095567,Xiao; Ming,9999,0,9999,0
1657309757810,MATH 197,004,095571,Perols; Johan Lars,9998,0,9999,1
1657309764873,COGS 9,A01,083615,Shannon; Kyle Michael,8,0,75,67
1657309770895,COGS 11,A01,083617,Boyle; Mary E. T.,22,0,48,26
1657309776917,COGS 13,A01,083071,Bastos; Amalia Pinkusfeld,10,0,71,61
1657309782940,COGS 14A,A01,092681,Semenuks; Arturs,2,1,100,98
1657309788964,COGS 14B,A01,083073,Cheng; Tzu-Han,6,0,63,57
1657309794986,COGS 17,A01,092677,Semenuks; Arturs,5,0,81,76
1657309801009,COGS 100,A01,083619,Allen; Michael Gordon,16,0,70,54
1657309807039,COGS 101A,A01,083621,Davis; Joshua Daniel,9,0,68,59
1657309813062,COGS 101B,A01,091572,Allen; Michael Gordon,11,0,65,54
1657309819095,COGS 101C,A01,083625,Delgado; Tania,17,0,35,18
1657309825119,COGS 107A,A01,083627,Boyle; Mary E. T.,13,0,60,47
1657309831147,COGS 118A,A01,083075,Gupta; Anjum,18,0,76,58
1657309837178,CSE 3,A50,083646,Miranda; Gregory Joseph,24,0,50,26
1657309843201,CSE 8A,A50,083650,Miranda; Gregory Joseph,17,1,56,39
1657309849222,CSE 11,A01,083080,Cao; Yingjun,6,15,40,34
1657309855245,CSE 12,A01,083652,Krause-Levy; Sophia Louisa,26,1,120,94
1657309861267,CSE 15L,A01,083654,Morris; Justin Loren,9,0,50,41
1657309861267,CSE 15L,A02,083655,Morris; Justin Loren,9,0,50,41
1657309867295,CSE 20,A01,083657,Tran; Khoa Dang,38,0,80,42
1657309873318,CSE 21,A01,095574,Bach; Quang Tran,22,0,48,26
1657309879341,CSE 30,A01,083084,Eldon; John,4,0,80,76
1657309879341,CSE 30,B01,095061,Bhaskar; Nishant,9,0,50,41
1657309885364,CSE 100,A01,083659,Cao; Yingjun,4,4,70,66
1657309891391,CSE 134B,A01,083661,Powell; Thomas Allan,21,0,100,79
1657309897417,CSE 140,A01,083663,Gungor; Onat,13,0,85,72
1657309903447,CSE 140L,A01,083088,Eldon; John,20,0,100,80
1657309909474,CSE 175,A01,083665,Kumar; Rakesh,3,0,25,22
1657309915495,CSE 190,A00,092507,Dubnov; Shlomo,7,0,20,13
1657309921521,ECE 45,A01,083139,Congero; Spencer William,6,0,75,69
1657309927548,ECE 65,A50,083695,Saad; Andrew S,12,0,30,18
1657309927548,ECE 65,A51,095125,Saad; Andrew S,25,0,26,1
1657309933667,ECE 109,A01,091882,Touri; Behrouz,19,0,70,51
1657309939690,ECE 180,A00,083140,Abi Samra; Nicholas Camill,1,0,30,29
1657309939690,ECE 180,B00,083141,Abi Samra; Nicholas Camill,0,0,30,30
1657309945713,MATH 10A,A01,083735,Patchell; Gregory David,2,0,30,28
1657309945713,MATH 10A,A02,083736,Patchell; Gregory David,20,0,30,10
1657309945713,MATH 10A,A03,083737,Patchell; Gregory David,16,0,30,14
1657309951736,MATH 10B,A01,083207,Lim; Seonhee,7,0,34,27
1657309951736,MATH 10B,A02,083208,Lim; Seonhee,9,0,35,26
1657309951736,MATH 10B,A03,093472,Lim; Seonhee,7,0,34,27
1657309951736,MATH 10B,B01,083739,Sinha; Shubham,11,0,30,19
1657309957759,MATH 18,A01,083743,Cinel; Cameron Alexander,6,0,30,24
1657309957759,MATH 18,A02,083744,Cinel; Cameron Alexander,17,0,30,13
1657309957759,MATH 18,A03,083745,Cinel; Cameron Alexander,8,0,30,22
1657309957759,MATH 18,B01,083748,Rideout; David Porter,4,0,37,33
1657309957759,MATH 18,B02,083749,Rideout; David Porter,4,0,36,32
1657309957759,MATH 18,B03,083750,Rideout; David Porter,3,0,37,34
1657309957759,MATH 18,B04,083751,Rideout; David Porter,6,0,36,30
1657309957759,MATH 18,B05,093473,Rideout; David Porter,5,0,36,31
1657309957759,MATH 18,B06,093474,Rideout; David Porter,5,0,36,31
1657309963783,MATH 20A,A01,083754,Zheng; Zequn,14,0,40,26
1657309969805,MATH 20B,A01,083756,Briones; Jor-el Thomas Caparas,3,0,36,33
1657309969805,MATH 20B,A02,083757,Briones; Jor-el Thomas Caparas,1,0,36,35
1657309969805,MATH 20B,A03,093475,Briones; Jor-el Thomas Caparas,2,0,36,34
1657309975842,MATH 20C,A01,083760,Briones; Jor-el Thomas Caparas,1,0,35,34
1657309975842,MATH 20C,A02,083761,Briones; Jor-el Thomas Caparas,8,0,35,27
1657309975842,MATH 20C,A03,093476,Briones; Jor-el Thomas Caparas,0,1,36,36
1657309975842,MATH 20C,B01,083762,Bach; Quang Tran,1,0,30,29
1657309981865,MATH 20D,A01,083765,Tran; Brian Kha,5,0,30,25
1657309981865,MATH 20D,A02,083766,Tran; Brian Kha,5,0,30,25
1657309981865,MATH 20D,A03,083767,Tran; Brian Kha,4,0,30,26
1657309987888,MATH 20E,A01,083771,Ganguly; Soumya,7,0,32,25
1657309987888,MATH 20E,A02,083772,Ganguly; Soumya,6,0,32,26
1657309987888,MATH 20E,B01,083773,Ciotti; Benjamin,19,0,35,16
1657309987888,MATH 20E,B02,083774,Ciotti; Benjamin,17,0,35,18
1657309993910,MATH 103A,A01,083777,Greenfeld; Be'Eri,3,0,36,33
1657309993910,MATH 103A,A02,083778,Greenfeld; Be'Eri,5,0,36,31
1657309993910,MATH 103A,A03,093561,Greenfeld; Be'Eri,4,0,36,32
1657309993910,MATH 103A,B01,083779,Greenfeld; Be'Eri,6,0,36,30
1657309993910,MATH 103A,B02,083780,Greenfeld; Be'Eri,4,0,36,32
1657309993910,MATH 103A,B03,093562,Greenfeld; Be'Eri,3,0,36,33
1657309999933,MATH 105,A01,085443,Carter; Anne Toulson,15,0,35,20
1657309999933,MATH 105,A02,093477,Carter; Anne Toulson,20,0,35,15
1657310005955,MATH 109,A01,083213,Ganzberger; Geoffrey Michael,2,0,34,32
1657310005955,MATH 109,A02,083214,Ganzberger; Geoffrey Michael,4,0,34,30
1657310005955,MATH 109,A03,093478,Ganzberger; Geoffrey Michael,2,0,34,32
1657310005955,MATH 109,B01,083215,Ganzberger; Geoffrey Michael,1,0,32,31
1657310005955,MATH 109,B02,083216,Ganzberger; Geoffrey Michael,1,0,32,31
1657310005955,MATH 109,B03,093479,Ganzberger; Geoffrey Michael,8,0,32,24
1657310011985,MATH 142A,A01,083219,Chow; Bennett,7,0,32,25
1657310011985,MATH 142A,A02,083220,Chow; Bennett,10,0,32,22
1657310011985,MATH 142A,A03,093480,Chow; Bennett,7,0,32,25
1657310011985,MATH 142A,B03,093481,Chow; Bennett,8,0,32,24
1657310011985,MATH 142A,B04,093558,Chow; Bennett,13,0,32,19
1657310011985,MATH 142A,B05,093559,Chow; Bennett,6,0,32,26
1657310018008,MATH 193A,A01,083224,Rotar; Vladimir,7,0,34,27
1657310018008,MATH 193A,A02,083225,Rotar; Vladimir,7,0,34,27
1657310018008,MATH 193A,A03,083781,Rotar; Vladimir,3,0,34,31
1657310018008,MATH 193A,A04,083782,Rotar; Vladimir,8,0,34,26
1657310018008,MATH 193A,A05,093482,Rotar; Vladimir,8,0,34,26
1657310024040,MATH 197,001,091859,McAuley; Julian John,9999,0,9999,0
1657310024040,MATH 197,002,095566,Kedlaya; Kiran S.,9997,0,9999,2
1657310024040,MATH 197,003,095567,Xiao; Ming,9999,0,9999,0
1657310024040,MATH 197,004,095571,Perols; Johan Lars,9998,0,9999,1
1657310031092,COGS 9,A01,083615,Shannon; Kyle Michael,8,0,75,67
1657310037118,COGS 11,A01,083617,Boyle; Mary E. T.,22,0,48,26
1657310043146,COGS 13,A01,083071,Bastos; Amalia Pinkusfeld,10,0,71,61
1657310049188,COGS 14A,A01,092681,Semenuks; Arturs,2,1,100,98
1657310055214,COGS 14B,A01,083073,Cheng; Tzu-Han,6,0,63,57
1657310061243,COGS 17,A01,092677,Semenuks; Arturs,5,0,81,76
1657310067276,COGS 100,A01,083619,Allen; Michael Gordon,16,0,70,54
1657310073299,COGS 101A,A01,083621,Davis; Joshua Daniel,9,0,68,59
1657310079324,COGS 101B,A01,091572,Allen; Michael Gordon,11,0,65,54
1657310085354,COGS 101C,A01,083625,Delgado; Tania,17,0,35,18
1657310091383,COGS 107A,A01,083627,Boyle; Mary E. T.,13,0,60,47
1657310097410,COGS 118A,A01,083075,Gupta; Anjum,18,0,76,58
1657310103437,CSE 3,A50,083646,Miranda; Gregory Joseph,24,0,50,26
1657310109478,CSE 8A,A50,083650,Miranda; Gregory Joseph,17,1,56,39
1657310115503,CSE 11,A01,083080,Cao; Yingjun,6,15,40,34
1657310121531,CSE 12,A01,083652,Krause-Levy; Sophia Louisa,26,1,120,94
1657310127552,CSE 15L,A01,083654,Morris; Justin Loren,9,0,50,41
1657310127552,CSE 15L,A02,083655,Morris; Justin Loren,9,0,50,41
1657310133594,CSE 20,A01,083657,Tran; Khoa Dang,38,0,80,42
1657310139626,CSE 21,A01,095574,Bach; Quang Tran,22,0,48,26
1657310145653,CSE 30,A01,083084,Eldon; John,4,0,80,76
1657310145653,CSE 30,B01,095061,Bhaskar; Nishant,9,0,50,41
1657310151676,CSE 100,A01,083659,Cao; Yingjun,4,4,70,66
1657310157705,CSE 134B,A01,083661,Powell; Thomas Allan,21,0,100,79
1657310163727,CSE 140,A01,083663,Gungor; Onat,13,0,85,72
1657310169760,CSE 140L,A01,083088,Eldon; John,20,0,100,80
1657310175785,CSE 175,A01,083665,Kumar; Rakesh,3,0,25,22
1657310181811,CSE 190,A00,092507,Dubnov; Shlomo,7,0,20,13
1657310187847,ECE 45,A01,083139,Congero; Spencer William,6,0,75,69
1657310193874,ECE 65,A50,083695,Saad; Andrew S,12,0,30,18
1657310193874,ECE 65,A51,095125,Saad; Andrew S,25,0,26,1
1657310199899,ECE 109,A01,091882,Touri; Behrouz,19,0,70,51
1657310205930,ECE 180,A00,083140,Abi Samra; Nicholas Camill,1,0,30,29
1657310205930,ECE 180,B00,083141,Abi Samra; Nicholas Camill,0,0,30,30
1657310211966,MATH 10A,A01,083735,Patchell; Gregory David,2,0,30,28
1657310211966,MATH 10A,A02,083736,Patchell; Gregory David,20,0,30,10
1657310211966,MATH 10A,A03,083737,Patchell; Gregory David,16,0,30,14
1657310217991,MATH 10B,A01,083207,Lim; Seonhee,7,0,34,27
1657310217991,MATH 10B,A02,083208,Lim; Seonhee,9,0,35,26
1657310217991,MATH 10B,A03,093472,Lim; Seonhee,7,0,34,27
1657310217991,MATH 10B,B01,083739,Sinha; Shubham,11,0,30,19
1657310224015,MATH 18,A01,083743,Cinel; Cameron Alexander,6,0,30,24
1657310224015,MATH 18,A02,083744,Cinel; Cameron Alexander,17,0,30,13
1657310224015,MATH 18,A03,083745,Cinel; Cameron Alexander,8,0,30,22
1657310224015,MATH 18,B01,083748,Rideout; David Porter,4,0,37,33
1657310224015,MATH 18,B02,083749,Rideout; David Porter,4,0,36,32
1657310224015,MATH 18,B03,083750,Rideout; David Porter,3,0,37,34
1657310224015,MATH 18,B04,083751,Rideout; David Porter,6,0,36,30
1657310224015,MATH 18,B05,093473,Rideout; David Porter,5,0,36,31
1657310224015,MATH 18,B06,093474,Rideout; David Porter,5,0,36,31
1657310230048,MATH 20A,A01,083754,Zheng; Zequn,14,0,40,26
1657310236077,MATH 20B,A01,083756,Briones; Jor-el Thomas Caparas,3,0,36,33
1657310236077,MATH 20B,A02,083757,Briones; Jor-el Thomas Caparas,1,0,36,35
1657310236077,MATH 20B,A03,093475,Briones; Jor-el Thomas Caparas,2,0,36,34
1657310242110,MATH 20C,A01,083760,Briones; Jor-el Thomas Caparas,1,0,35,34
1657310242110,MATH 20C,A02,083761,Briones; Jor-el Thomas Caparas,8,0,35,27
1657310242110,MATH 20C,A03,093476,Briones; Jor-el Thomas Caparas,0,1,36,36
1657310242110,MATH 20C,B01,083762,Bach; Quang Tran,1,0,30,29
1657310248134,MATH 20D,A01,083765,Tran; Brian Kha,5,0,30,25
1657310248134,MATH 20D,A02,083766,Tran; Brian Kha,5,0,30,25
1657310248134,MATH 20D,A03,083767,Tran; Brian Kha,4,0,30,26
1657310254169,MATH 20E,A01,083771,Ganguly; Soumya,7,0,32,25
1657310254169,MATH 20E,A02,083772,Ganguly; Soumya,6,0,32,26
1657310254169,MATH 20E,B01,083773,Ciotti; Benjamin,19,0,35,16
1657310254169,MATH 20E,B02,083774,Ciotti; Benjamin,17,0,35,18
1657310260193,MATH 103A,A01,083777,Greenfeld; Be'Eri,3,0,36,33
1657310260193,MATH 103A,A02,083778,Greenfeld; Be'Eri,5,0,36,31
1657310260193,MATH 103A,A03,093561,Greenfeld; Be'Eri,4,0,36,32
1657310260193,MATH 103A,B01,083779,Greenfeld; Be'Eri,6,0,36,30
1657310260193,MATH 103A,B02,083780,Greenfeld; Be'Eri,4,0,36,32
1657310260193,MATH 103A,B03,093562,Greenfeld; Be'Eri,3,0,36,33
1657310266232,MATH 105,A01,085443,Carter; Anne Toulson,15,0,35,20
1657310266232,MATH 105,A02,093477,Carter; Anne Toulson,20,0,35,15
1657310272260,MATH 109,A01,083213,Ganzberger; Geoffrey Michael,2,0,34,32
1657310272260,MATH 109,A02,083214,Ganzberger; Geoffrey Michael,4,0,34,30
1657310272260,MATH 109,A03,093478,Ganzberger; Geoffrey Michael,2,0,34,32
1657310272260,MATH 109,B01,083215,Ganzberger; Geoffrey Michael,1,0,32,31
1657310272260,MATH 109,B02,083216,Ganzberger; Geoffrey Michael,1,0,32,31
1657310272260,MATH 109,B03,093479,Ganzberger; Geoffrey Michael,8,0,32,24
1657310278302,MATH 142A,A01,083219,Chow; Bennett,7,0,32,25
1657310278302,MATH 142A,A02,083220,Chow; Bennett,10,0,32,22
1657310278302,MATH 142A,A03,093480,Chow; Bennett,7,0,32,25
1657310278302,MATH 142A,B03,093481,Chow; Bennett,8,0,32,24
1657310278302,MATH 142A,B04,093558,Chow; Bennett,13,0,32,19
1657310278302,MATH 142A,B05,093559,Chow; Bennett,6,0,32,26
1657310284329,MATH 193A,A01,083224,Rotar; Vladimir,7,0,34,27
1657310284329,MATH 193A,A02,083225,Rotar; Vladimir,7,0,34,27
1657310284329,MATH 193A,A03,083781,Rotar; Vladimir,3,0,34,31
1657310284329,MATH 193A,A04,083782,Rotar; Vladimir,8,0,34,26
1657310284329,MATH 193A,A05,093482,Rotar; Vladimir,8,0,34,26
1657310290351,MATH 197,001,091859,McAuley; Julian John,9999,0,9999,0
1657310290351,MATH 197,002,095566,Kedlaya; Kiran S.,9997,0,9999,2
1657310290351,MATH 197,003,095567,Xiao; Ming,9999,0,9999,0
1657310290351,MATH 197,004,095571,Perols; Johan Lars,9998,0,9999,1
1657310297408,COGS 9,A01,083615,Shannon; Kyle Michael,8,0,75,67
1657310303429,COGS 11,A01,083617,Boyle; Mary E. T.,22,0,48,26
1657310309458,COGS 13,A01,083071,Bastos; Amalia Pinkusfeld,10,0,71,61
1657310315486,COGS 14A,A01,092681,Semenuks; Arturs,2,1,100,98
1657310321508,COGS 14B,A01,083073,Cheng; Tzu-Han,6,0,63,57
1657310327535,COGS 17,A01,092677,Semenuks; Arturs,5,0,81,76
1657310333575,COGS 100,A01,083619,Allen; Michael Gordon,16,0,70,54
1657310339602,COGS 101A,A01,083621,Davis; Joshua Daniel,9,0,68,59
1657310345630,COGS 101B,A01,091572,Allen; Michael Gordon,11,0,65,54
1657310351654,COGS 101C,A01,083625,Delgado; Tania,17,0,35,18
1657310357692,COGS 107A,A01,083627,Boyle; Mary E. T.,13,0,60,47
1657310363730,COGS 118A,A01,083075,Gupta; Anjum,18,0,76,58
1657310369755,CSE 3,A50,083646,Miranda; Gregory Joseph,24,0,50,26
1657310375791,CSE 8A,A50,083650,Miranda; Gregory Joseph,17,1,56,39
1657310381814,CSE 11,A01,083080,Cao; Yingjun,6,15,40,34
1657310387838,CSE 12,A01,083652,Krause-Levy; Sophia Louisa,26,1,120,94
1657310393871,CSE 15L,A01,083654,Morris; Justin Loren,9,0,50,41
1657310393871,CSE 15L,A02,083655,Morris; Justin Loren,9,0,50,41
1657310399898,CSE 20,A01,083657,Tran; Khoa Dang,38,0,80,42
1657310405935,CSE 21,A01,095574,Bach; Quang Tran,22,0,48,26
1657310411965,CSE 30,A01,083084,Eldon; John,4,0,80,76
1657310411965,CSE 30,B01,095061,Bhaskar; Nishant,9,0,50,41
1657310417988,CSE 100,A01,083659,Cao; Yingjun,4,4,70,66
1657310424012,CSE 134B,A01,083661,Powell; Thomas Allan,21,0,100,79
1657310430037,CSE 140,A01,083663,Gungor; Onat,13,0,85,72
1657310436062,CSE 140L,A01,083088,Eldon; John,20,0,100,80
1657310442085,CSE 175,A01,083665,Kumar; Rakesh,3,0,25,22
1657310448110,CSE 190,A00,092507,Dubnov; Shlomo,7,0,20,13
1657310454134,ECE 45,A01,083139,Congero; Spencer William,6,0,75,69
1657310460162,ECE 65,A50,083695,Saad; Andrew S,12,0,30,18
1657310460162,ECE 65,A51,095125,Saad; Andrew S,25,0,26,1
1657310466183,ECE 109,A01,091882,Touri; Behrouz,19,0,70,51
1657310472210,ECE 180,A00,083140,Abi Samra; Nicholas Camill,1,0,30,29
1657310472210,ECE 180,B00,083141,Abi Samra; Nicholas Camill,0,0,30,30
1657310478247,MATH 10A,A01,083735,Patchell; Gregory David,2,0,30,28
1657310478247,MATH 10A,A02,083736,Patchell; Gregory David,20,0,30,10
1657310478247,MATH 10A,A03,083737,Patchell; Gregory David,16,0,30,14
1657310484271,MATH 10B,A01,083207,Lim; Seonhee,7,0,34,27
1657310484271,MATH 10B,A02,083208,Lim; Seonhee,9,0,35,26
1657310484271,MATH 10B,A03,093472,Lim; Seonhee,7,0,34,27
1657310484271,MATH 10B,B01,083739,Sinha; Shubham,11,0,30,19
1657310490304,MATH 18,A01,083743,Cinel; Cameron Alexander,6,0,30,24
1657310490304,MATH 18,A02,083744,Cinel; Cameron Alexander,17,0,30,13
1657310490304,MATH 18,A03,083745,Cinel; Cameron Alexander,8,0,30,22
1657310490304,MATH 18,B01,083748,Rideout; David Porter,4,0,37,33
1657310490304,MATH 18,B02,083749,Rideout; David Porter,4,0,36,32
1657310490304,MATH 18,B03,083750,Rideout; David Porter,3,0,37,34
1657310490304,MATH 18,B04,083751,Rideout; David Porter,6,0,36,30
1657310490304,MATH 18,B05,093473,Rideout; David Porter,5,0,36,31
1657310490304,MATH 18,B06,093474,Rideout; David Porter,5,0,36,31
1657310496326,MATH 20A,A01,083754,Zheng; Zequn,14,0,40,26
1657310502349,MATH 20B,A01,083756,Briones; Jor-el Thomas Caparas,3,0,36,33
1657310502349,MATH 20B,A02,083757,Briones; Jor-el Thomas Caparas,1,0,36,35
1657310502349,MATH 20B,A03,093475,Briones; Jor-el Thomas Caparas,2,0,36,34
1657310508386,MATH 20C,A01,083760,Briones; Jor-el Thomas Caparas,1,0,35,34
1657310508386,MATH 20C,A02,083761,Briones; Jor-el Thomas Caparas,8,0,35,27
1657310508386,MATH 20C,A03,093476,Briones; Jor-el Thomas Caparas,0,1,36,36
1657310508386,MATH 20C,B01,083762,Bach; Quang Tran,1,0,30,29
1657310514414,MATH 20D,A01,083765,Tran; Brian Kha,5,0,30,25
1657310514414,MATH 20D,A02,083766,Tran; Brian Kha,5,0,30,25
1657310514414,MATH 20D,A03,083767,Tran; Brian Kha,4,0,30,26
1657310520445,MATH 20E,A01,083771,Ganguly; Soumya,7,0,32,25
1657310520445,MATH 20E,A02,083772,Ganguly; Soumya,6,0,32,26
1657310520445,MATH 20E,B01,083773,Ciotti; Benjamin,19,0,35,16
1657310520445,MATH 20E,B02,083774,Ciotti; Benjamin,17,0,35,18
1657310526472,MATH 103A,A01,083777,Greenfeld; Be'Eri,3,0,36,33
1657310526472,MATH 103A,A02,083778,Greenfeld; Be'Eri,5,0,36,31
1657310526472,MATH 103A,A03,093561,Greenfeld; Be'Eri,4,0,36,32
1657310526472,MATH 103A,B01,083779,Greenfeld; Be'Eri,6,0,36,30
1657310526472,MATH 103A,B02,083780,Greenfeld; Be'Eri,4,0,36,32
1657310526472,MATH 103A,B03,093562,Greenfeld; Be'Eri,3,0,36,33
1657310532575,MATH 105,A01,085443,Carter; Anne Toulson,15,0,35,20
1657310532575,MATH 105,A02,093477,Carter; Anne Toulson,20,0,35,15
1657310538608,MATH 109,A01,083213,Ganzberger; Geoffrey Michael,2,0,34,32
1657310538608,MATH 109,A02,083214,Ganzberger; Geoffrey Michael,4,0,34,30
1657310538608,MATH 109,A03,093478,Ganzberger; Geoffrey Michael,2,0,34,32
1657310538608,MATH 109,B01,083215,Ganzberger; Geoffrey Michael,1,0,32,31
1657310538608,MATH 109,B02,083216,Ganzberger; Geoffrey Michael,1,0,32,31
1657310538608,MATH 109,B03,093479,Ganzberger; Geoffrey Michael,8,0,32,24
1657310544683,MATH 142A,A01,083219,Chow; Bennett,7,0,32,25
1657310544683,MATH 142A,A02,083220,Chow; Bennett,10,0,32,22
1657310544683,MATH 142A,A03,093480,Chow; Bennett,7,0,32,25
1657310544683,MATH 142A,B03,093481,Chow; Bennett,8,0,32,24
1657310544683,MATH 142A,B04,093558,Chow; Bennett,13,0,32,19
1657310544683,MATH 142A,B05,093559,Chow; Bennett,6,0,32,26
1657310550707,MATH 193A,A01,083224,Rotar; Vladimir,7,0,34,27
1657310550707,MATH 193A,A02,083225,Rotar; Vladimir,7,0,34,27
1657310550707,MATH 193A,A03,083781,Rotar; Vladimir,3,0,34,31
1657310550707,MATH 193A,A04,083782,Rotar; Vladimir,8,0,34,26
1657310550707,MATH 193A,A05,093482,Rotar; Vladimir,8,0,34,26
1657310556737,MATH 197,001,091859,McAuley; Julian John,9999,0,9999,0
1657310556737,MATH 197,002,095566,Kedlaya; Kiran S.,9997,0,9999,2
1657310556737,MATH 197,003,095567,Xiao; Ming,9999,0,9999,0
1657310556737,MATH 197,004,095571,Perols; Johan Lars,9998,0,9999,1
1657310563792,COGS 9,A01,083615,Shannon; Kyle Michael,8,0,75,67
1657310569814,COGS 11,A01,083617,Boyle; Mary E. T.,22,0,48,26
1657310575852,COGS 13,A01,083071,Bastos; Amalia Pinkusfeld,10,0,71,61
1657310581879,COGS 14A,A01,092681,Semenuks; Arturs,2,1,100,98
1657310587904,COGS 14B,A01,083073,Cheng; Tzu-Han,6,0,63,57
1657310593927,COGS 17,A01,092677,Semenuks; Arturs,5,0,81,76
1657310599954,COGS 100,A01,083619,Allen; Michael Gordon,16,0,70,54
1657310605997,COGS 101A,A01,083621,Davis; Joshua Daniel,9,0,68,59
1657310612030,COGS 101B,A01,091572,Allen; Michael Gordon,11,0,65,54
1657310618052,COGS 101C,A01,083625,Delgado; Tania,17,0,35,18
1657310624076,COGS 107A,A01,083627,Boyle; Mary E. T.,13,0,60,47
1657310630099,COGS 118A,A01,083075,Gupta; Anjum,18,0,76,58
1657310636123,CSE 3,A50,083646,Miranda; Gregory Joseph,24,0,50,26
1657310642146,CSE 8A,A50,083650,Miranda; Gregory Joseph,17,1,56,39
1657310648175,CSE 11,A01,083080,Cao; Yingjun,6,15,40,34
1657310654204,CSE 12,A01,083652,Krause-Levy; Sophia Louisa,26,1,120,94
1657310660232,CSE 15L,A01,083654,Morris; Justin Loren,9,0,50,41
1657310660232,CSE 15L,A02,083655,Morris; Justin Loren,9,0,50,41
1657310666259,CSE 20,A01,083657,Tran; Khoa Dang,38,0,80,42
1657310672295,CSE 21,A01,095574,Bach; Quang Tran,22,0,48,26
1657310678323,CSE 30,A01,083084,Eldon; John,4,0,80,76
1657310678323,CSE 30,B01,095061,Bhaskar; Nishant,9,0,50,41
1657310684345,CSE 100,A01,083659,Cao; Yingjun,4,4,70,66
1657310690373,CSE 134B,A01,083661,Powell; Thomas Allan,21,0,100,79
1657310696402,CSE 140,A01,083663,Gungor; Onat,13,0,85,72
1657310702429,CSE 140L,A01,083088,Eldon; John,20,0,100,80
1657310708458,CSE 175,A01,083665,Kumar; Rakesh,3,0,25,22
1657310714479,CSE 190,A00,092507,Dubnov; Shlomo,7,0,20,13
1657310720512,ECE 45,A01,083139,Congero; Spencer William,6,0,75,69
1657310726539,ECE 65,A50,083695,Saad; Andrew S,12,0,30,18
1657310726539,ECE 65,A51,095125,Saad; Andrew S,25,0,26,1
1657310732572,ECE 109,A01,091882,Touri; Behrouz,19,0,70,51
1657310738595,ECE 180,A00,083140,Abi Samra; Nicholas Camill,1,0,30,29
1657310738595,ECE 180,B00,083141,Abi Samra; Nicholas Camill,0,0,30,30
1657310744621,MATH 10A,A01,083735,Patchell; Gregory David,2,0,30,28
1657310744621,MATH 10A,A02,083736,Patchell; Gregory David,20,0,30,10
1657310744621,MATH 10A,A03,083737,Patchell; Gregory David,16,0,30,14
1657310750654,MATH 10B,A01,083207,Lim; Seonhee,7,0,34,27
1657310750654,MATH 10B,A02,083208,Lim; Seonhee,9,0,35,26
1657310750654,MATH 10B,A03,093472,Lim; Seonhee,7,0,34,27
1657310750654,MATH 10B,B01,083739,Sinha; Shubham,11,0,30,19
1657310756690,MATH 18,A01,083743,Cinel; Cameron Alexander,6,0,30,24
1657310756690,MATH 18,A02,083744,Cinel; Cameron Alexander,17,0,30,13
1657310756690,MATH 18,A03,083745,Cinel; Cameron Alexander,8,0,30,22
1657310756690,MATH 18,B01,083748,Rideout; David Porter,4,0,37,33
1657310756690,MATH 18,B02,083749,Rideout; David Porter,4,0,36,32
1657310756690,MATH 18,B03,083750,Rideout; David Porter,3,0,37,34
1657310756690,MATH 18,B04,083751,Rideout; David Porter,6,0,36,30
1657310756690,MATH 18,B05,093473,Rideout; David Porter,5,0,36,31
1657310756690,MATH 18,B06,093474,Rideout; David Porter,5,0,36,31
1657310762713,MATH 20A,A01,083754,Zheng; Zequn,14,0,40,26
1657310768741,MATH 20B,A01,083756,Briones; Jor-el Thomas Caparas,4,0,36,32
1657310768741,MATH 20B,A02,083757,Briones; Jor-el Thomas Caparas,1,0,36,35
1657310768741,MATH 20B,A03,093475,Briones; Jor-el Thomas Caparas,2,0,36,34
1657310774763,MATH 20C,A01,083760,Briones; Jor-el Thomas Caparas,1,0,35,34
1657310774763,MATH 20C,A02,083761,Briones; Jor-el Thomas Caparas,8,0,35,27
1657310774763,MATH 20C,A03,093476,Briones; Jor-el Thomas Caparas,0,1,36,36
1657310774763,MATH 20C,B01,083762,Bach; Quang Tran,1,0,30,29
1657310780798,MATH 20D,A01,083765,Tran; Brian Kha,5,0,30,25
1657310780798,MATH 20D,A02,083766,Tran; Brian Kha,5,0,30,25
1657310780798,MATH 20D,A03,083767,Tran; Brian Kha,4,0,30,26
1657310786826,MATH 20E,A01,083771,Ganguly; Soumya,7,0,32,25
1657310786826,MATH 20E,A02,083772,Ganguly; Soumya,6,0,32,26
1657310786826,MATH 20E,B01,083773,Ciotti; Benjamin,19,0,35,16
1657310786826,MATH 20E,B02,083774,Ciotti; Benjamin,17,0,35,18
1657310792865,MATH 103A,A01,083777,Greenfeld; Be'Eri,3,0,36,33
1657310792865,MATH 103A,A02,083778,Greenfeld; Be'Eri,5,0,36,31
1657310792865,MATH 103A,A03,093561,Greenfeld; Be'Eri,4,0,36,32
1657310792865,MATH 103A,B01,083779,Greenfeld; Be'Eri,6,0,36,30
1657310792865,MATH 103A,B02,083780,Greenfeld; Be'Eri,4,0,36,32
1657310792865,MATH 103A,B03,093562,Greenfeld; Be'Eri,3,0,36,33
1657310798894,MATH 105,A01,085443,Carter; Anne Toulson,15,0,35,20
1657310798894,MATH 105,A02,093477,Carter; Anne Toulson,20,0,35,15
1657310804919,MATH 109,A01,083213,Ganzberger; Geoffrey Michael,2,0,34,32
1657310804919,MATH 109,A02,083214,Ganzberger; Geoffrey Michael,4,0,34,30
1657310804919,MATH 109,A03,093478,Ganzberger; Geoffrey Michael,2,0,34,32
1657310804919,MATH 109,B01,083215,Ganzberger; Geoffrey Michael,1,0,32,31
1657310804919,MATH 109,B02,083216,Ganzberger; Geoffrey Michael,1,0,32,31
1657310804919,MATH 109,B03,093479,Ganzberger; Geoffrey Michael,8,0,32,24
1657310810949,MATH 142A,A01,083219,Chow; Bennett,7,0,32,25
1657310810949,MATH 142A,A02,083220,Chow; Bennett,10,0,32,22
1657310810949,MATH 142A,A03,093480,Chow; Bennett,7,0,32,25
1657310810949,MATH 142A,B03,093481,Chow; Bennett,8,0,32,24
1657310810949,MATH 142A,B04,093558,Chow; Bennett,13,0,32,19
1657310810949,MATH 142A,B05,093559,Chow; Bennett,6,0,32,26
1657310816979,MATH 193A,A01,083224,Rotar; Vladimir,7,0,34,27
1657310816979,MATH 193A,A02,083225,Rotar; Vladimir,7,0,34,27
1657310816979,MATH 193A,A03,083781,Rotar; Vladimir,3,0,34,31
1657310816979,MATH 193A,A04,083782,Rotar; Vladimir,8,0,34,26
1657310816979,MATH 193A,A05,093482,Rotar; Vladimir,8,0,34,26
1657310823006,MATH 197,001,091859,McAuley; Julian John,9999,0,9999,0
1657310823006,MATH 197,002,095566,Kedlaya; Kiran S.,9997,0,9999,2
1657310823006,MATH 197,003,095567,Xiao; Ming,9999,0,9999,0
1657310823006,MATH 197,004,095571,Perols; Johan Lars,9998,0,9999,1
1657310830076,COGS 9,A01,083615,Shannon; Kyle Michael,8,0,75,67
1657310836115,COGS 11,A01,083617,Boyle; Mary E. T.,22,0,48,26
1657310842139,COGS 13,A01,083071,Bastos; Amalia Pinkusfeld,10,0,71,61
1657310848180,COGS 14A,A01,092681,Semenuks; Arturs,2,1,100,98
1657310854210,COGS 14B,A01,083073,Cheng; Tzu-Han,6,0,63,57
1657310860239,COGS 17,A01,092677,Semenuks; Arturs,5,0,81,76
1657310866266,COGS 100,A01,083619,Allen; Michael Gordon,16,0,70,54
1657310872297,COGS 101A,A01,083621,Davis; Joshua Daniel,9,0,68,59
1657310878338,COGS 101B,A01,091572,Allen; Michael Gordon,11,0,65,54
1657310884365,COGS 101C,A01,083625,Delgado; Tania,17,0,35,18
1657310890389,COGS 107A,A01,083627,Boyle; Mary E. T.,13,0,60,47
1657310896416,COGS 118A,A01,083075,Gupta; Anjum,17,0,76,59
1657310902444,CSE 3,A50,083646,Miranda; Gregory Joseph,24,0,50,26
1657310908471,CSE 8A,A50,083650,Miranda; Gregory Joseph,17,1,56,39
1657310914494,CSE 11,A01,083080,Cao; Yingjun,6,15,40,34
1657310920519,CSE 12,A01,083652,Krause-Levy; Sophia Louisa,26,1,120,94
1657310926568,CSE 15L,A01,083654,Morris; Justin Loren,9,0,50,41
1657310926568,CSE 15L,A02,083655,Morris; Justin Loren,9,0,50,41
1657310932595,CSE 20,A01,083657,Tran; Khoa Dang,38,0,80,42
1657310938622,CSE 21,A01,095574,Bach; Quang Tran,22,0,48,26
1657310944646,CSE 30,A01,083084,Eldon; John,4,0,80,76
1657310944646,CSE 30,B01,095061,Bhaskar; Nishant,9,0,50,41
1657310950675,CSE 100,A01,083659,Cao; Yingjun,4,4,70,66
1657310956697,CSE 134B,A01,083661,Powell; Thomas Allan,21,0,100,79
1657310962729,CSE 140,A01,083663,Gungor; Onat,13,0,85,72
1657310968752,CSE 140L,A01,083088,Eldon; John,20,0,100,80
1657310974783,CSE 175,A01,083665,Kumar; Rakesh,3,0,25,22
1657310980809,CSE 190,A00,092507,Dubnov; Shlomo,7,0,20,13
1657310986834,ECE 45,A01,083139,Congero; Spencer William,6,0,75,69
1657310992859,ECE 65,A50,083695,Saad; Andrew S,12,0,30,18
1657310992859,ECE 65,A51,095125,Saad; Andrew S,25,0,26,1
1657310998893,ECE 109,A01,091882,Touri; Behrouz,19,0,70,51
1657311004936,ECE 180,A00,083140,Abi Samra; Nicholas Camill,1,0,30,29
1657311004936,ECE 180,B00,083141,Abi Samra; Nicholas Camill,0,0,30,30
1657311010965,MATH 10A,A01,083735,Patchell; Gregory David,2,0,30,28
1657311010965,MATH 10A,A02,083736,Patchell; Gregory David,20,0,30,10
1657311010965,MATH 10A,A03,083737,Patchell; Gregory David,16,0,30,14
1657311016988,MATH 10B,A01,083207,Lim; Seonhee,7,0,34,27
1657311016988,MATH 10B,A02,083208,Lim; Seonhee,9,0,35,26
1657311016988,MATH 10B,A03,093472,Lim; Seonhee,7,0,34,27
1657311016988,MATH 10B,B01,083739,Sinha; Shubham,11,0,30,19
1657311023017,MATH 18,A01,083743,Cinel; Cameron Alexander,6,0,30,24
1657311023017,MATH 18,A02,083744,Cinel; Cameron Alexander,17,0,30,13
1657311023017,MATH 18,A03,083745,Cinel; Cameron Alexander,8,0,30,22
1657311023017,MATH 18,B01,083748,Rideout; David Porter,4,0,37,33
1657311023017,MATH 18,B02,083749,Rideout; David Porter,4,0,36,32
1657311023017,MATH 18,B03,083750,Rideout; David Porter,3,0,37,34
1657311023017,MATH 18,B04,083751,Rideout; David Porter,6,0,36,30
1657311023017,MATH 18,B05,093473,Rideout; David Porter,5,0,36,31
1657311023017,MATH 18,B06,093474,Rideout; David Porter,5,0,36,31
1657311029046,MATH 20A,A01,083754,Zheng; Zequn,14,0,40,26
1657311035074,MATH 20B,A01,083756,Briones; Jor-el Thomas Caparas,4,0,36,32
1657311035074,MATH 20B,A02,083757,Briones; Jor-el Thomas Caparas,1,0,36,35
1657311035074,MATH 20B,A03,093475,Briones; Jor-el Thomas Caparas,2,0,36,34
1657311041099,MATH 20C,A01,083760,Briones; Jor-el Thomas Caparas,1,0,35,34
1657311041099,MATH 20C,A02,083761,Briones; Jor-el Thomas Caparas,8,0,35,27
1657311041099,MATH 20C,A03,093476,Briones; Jor-el Thomas Caparas,0,1,36,36
1657311041099,MATH 20C,B01,083762,Bach; Quang Tran,1,0,30,29
1657311047122,MATH 20D,A01,083765,Tran; Brian Kha,5,0,30,25
1657311047122,MATH 20D,A02,083766,Tran; Brian Kha,5,0,30,25
1657311047122,MATH 20D,A03,083767,Tran; Brian Kha,4,0,30,26
1657311053152,MATH 20E,A01,083771,Ganguly; Soumya,7,0,32,25
1657311053152,MATH 20E,A02,083772,Ganguly; Soumya,6,0,32,26
1657311053152,MATH 20E,B01,083773,Ciotti; Benjamin,19,0,35,16
1657311053152,MATH 20E,B02,083774,Ciotti; Benjamin,17,0,35,18
1657311059177,MATH 103A,A01,083777,Greenfeld; Be'Eri,3,0,36,33
1657311059177,MATH 103A,A02,083778,Greenfeld; Be'Eri,5,0,36,31
1657311059177,MATH 103A,A03,093561,Greenfeld; Be'Eri,4,0,36,32
1657311059177,MATH 103A,B01,083779,Greenfeld; Be'Eri,6,0,36,30
1657311059177,MATH 103A,B02,083780,Greenfeld; Be'Eri,4,0,36,32
1657311059177,MATH 103A,B03,093562,Greenfeld; Be'Eri,3,0,36,33
1657311065205,MATH 105,A01,085443,Carter; Anne Toulson,15,0,35,20
1657311065205,MATH 105,A02,093477,Carter; Anne Toulson,20,0,35,15
1657311071227,MATH 109,A01,083213,Ganzberger; Geoffrey Michael,2,0,34,32
1657311071227,MATH 109,A02,083214,Ganzberger; Geoffrey Michael,4,0,34,30
1657311071227,MATH 109,A03,093478,Ganzberger; Geoffrey Michael,2,0,34,32
1657311071227,MATH 109,B01,083215,Ganzberger; Geoffrey Michael,1,0,32,31
1657311071227,MATH 109,B02,083216,Ganzberger; Geoffrey Michael,1,0,32,31
1657311071227,MATH 109,B03,093479,Ganzberger; Geoffrey Michael,8,0,32,24
1657311077253,MATH 142A,A01,083219,Chow; Bennett,7,0,32,25
1657311077253,MATH 142A,A02,083220,Chow; Bennett,10,0,32,22
1657311077253,MATH 142A,A03,093480,Chow; Bennett,7,0,32,25
1657311077253,MATH 142A,B03,093481,Chow; Bennett,8,0,32,24
1657311077253,MATH 142A,B04,093558,Chow; Bennett,13,0,32,19
1657311077253,MATH 142A,B05,093559,Chow; Bennett,6,0,32,26
1657311083276,MATH 193A,A01,083224,Rotar; Vladimir,7,0,34,27
1657311083276,MATH 193A,A02,083225,Rotar; Vladimir,7,0,34,27
1657311083276,MATH 193A,A03,083781,Rotar; Vladimir,3,0,34,31
1657311083276,MATH 193A,A04,083782,Rotar; Vladimir,8,0,34,26
1657311083276,MATH 193A,A05,093482,Rotar; Vladimir,8,0,34,26
1657311089300,MATH 197,001,091859,McAuley; Julian John,9999,0,9999,0
1657311089300,MATH 197,002,095566,Kedlaya; Kiran S.,9997,0,9999,2
1657311089300,MATH 197,003,095567,Xiao; Ming,9999,0,9999,0
1657311089300,MATH 197,004,095571,Perols; Johan Lars,9998,0,9999,1
1657311096356,COGS 9,A01,083615,Shannon; Kyle Michael,8,0,75,67
1657311102381,COGS 11,A01,083617,Boyle; Mary E. T.,22,0,48,26
1657311108411,COGS 13,A01,083071,Bastos; Amalia Pinkusfeld,10,0,71,61
1657311114435,COGS 14A,A01,092681,Semenuks; Arturs,2,1,100,98
1657311120466,COGS 14B,A01,083073,Cheng; Tzu-Han,6,0,63,57
1657311126586,COGS 17,A01,092677,Semenuks; Arturs,5,0,81,76
1657311132609,COGS 100,A01,083619,Allen; Michael Gordon,16,0,70,54
1657311138647,COGS 101A,A01,083621,Davis; Joshua Daniel,9,0,68,59
1657311144673,COGS 101B,A01,091572,Allen; Michael Gordon,11,0,65,54
1657311150697,COGS 101C,A01,083625,Delgado; Tania,17,0,35,18
1657311156720,COGS 107A,A01,083627,Boyle; Mary E. T.,13,0,60,47
1657311162747,COGS 118A,A01,083075,Gupta; Anjum,17,0,76,59
1657311168782,CSE 3,A50,083646,Miranda; Gregory Joseph,24,0,50,26
1657311174809,CSE 8A,A50,083650,Miranda; Gregory Joseph,17,1,56,39
1657311180835,CSE 11,A01,083080,Cao; Yingjun,6,15,40,34
1657311186859,CSE 12,A01,083652,Krause-Levy; Sophia Louisa,26,1,120,94
1657311192892,CSE 15L,A01,083654,Morris; Justin Loren,9,0,50,41
1657311192892,CSE 15L,A02,083655,Morris; Justin Loren,9,0,50,41
1657311198918,CSE 20,A01,083657,Tran; Khoa Dang,38,0,80,42
1657311204941,CSE 21,A01,095574,Bach; Quang Tran,22,0,48,26
1657311210964,CSE 30,A01,083084,Eldon; John,4,0,80,76
1657311210964,CSE 30,B01,095061,Bhaskar; Nishant,9,0,50,41
1657311217004,CSE 100,A01,083659,Cao; Yingjun,4,4,70,66
1657311223044,CSE 134B,A01,083661,Powell; Thomas Allan,21,0,100,79
1657311229075,CSE 140,A01,083663,Gungor; Onat,13,0,85,72
1657311235102,CSE 140L,A01,083088,Eldon; John,21,0,100,79
1657311241124,CSE 175,A01,083665,Kumar; Rakesh,3,0,25,22
1657311247149,CSE 190,A00,092507,Dubnov; Shlomo,7,0,20,13
1657311253185,ECE 45,A01,083139,Congero; Spencer William,6,0,75,69
1657311259212,ECE 65,A50,083695,Saad; Andrew S,12,0,30,18
1657311259212,ECE 65,A51,095125,Saad; Andrew S,25,0,26,1
1657311265241,ECE 109,A01,091882,Touri; Behrouz,19,0,70,51
1657311271267,ECE 180,A00,083140,Abi Samra; Nicholas Camill,1,0,30,29
1657311271267,ECE 180,B00,083141,Abi Samra; Nicholas Camill,0,0,30,30
1657311277296,MATH 10A,A01,083735,Patchell; Gregory David,2,0,30,28
1657311277296,MATH 10A,A02,083736,Patchell; Gregory David,20,0,30,10
1657311277296,MATH 10A,A03,083737,Patchell; Gregory David,16,0,30,14
1657311283331,MATH 10B,A01,083207,Lim; Seonhee,7,0,34,27
1657311283331,MATH 10B,A02,083208,Lim; Seonhee,9,0,35,26
1657311283331,MATH 10B,A03,093472,Lim; Seonhee,7,0,34,27
1657311283331,MATH 10B,B01,083739,Sinha; Shubham,11,0,30,19
1657311289363,MATH 18,A01,083743,Cinel; Cameron Alexander,6,0,30,24
1657311289363,MATH 18,A02,083744,Cinel; Cameron Alexander,17,0,30,13
1657311289363,MATH 18,A03,083745,Cinel; Cameron Alexander,8,0,30,22
1657311289363,MATH 18,B01,083748,Rideout; David Porter,4,0,37,33
1657311289363,MATH 18,B02,083749,Rideout; David Porter,5,0,36,31
1657311289363,MATH 18,B03,083750,Rideout; David Porter,3,0,37,34
1657311289363,MATH 18,B04,083751,Rideout; David Porter,6,0,36,30
1657311289363,MATH 18,B05,093473,Rideout; David Porter,5,0,36,31
1657311289363,MATH 18,B06,093474,Rideout; David Porter,5,0,36,31
1657311295394,MATH 20A,A01,083754,Zheng; Zequn,14,0,40,26
1657311301422,MATH 20B,A01,083756,Briones; Jor-el Thomas Caparas,4,0,36,32
1657311301422,MATH 20B,A02,083757,Briones; Jor-el Thomas Caparas,1,0,36,35
1657311301422,MATH 20B,A03,093475,Briones; Jor-el Thomas Caparas,2,0,36,34
1657311307452,MATH 20C,A01,083760,Briones; Jor-el Thomas Caparas,1,0,35,34
1657311307452,MATH 20C,A02,083761,Briones; Jor-el Thomas Caparas,8,0,35,27
1657311307452,MATH 20C,A03,093476,Briones; Jor-el Thomas Caparas,0,1,36,36
1657311307452,MATH 20C,B01,083762,Bach; Quang Tran,1,0,30,29
1657311313478,MATH 20D,A01,083765,Tran; Brian Kha,5,0,30,25
1657311313478,MATH 20D,A02,083766,Tran; Brian Kha,5,0,30,25
1657311313478,MATH 20D,A03,083767,Tran; Brian Kha,4,0,30,26
1657311319501,MATH 20E,A01,083771,Ganguly; Soumya,7,0,32,25
1657311319501,MATH 20E,A02,083772,Ganguly; Soumya,6,0,32,26
1657311319501,MATH 20E,B01,083773,Ciotti; Benjamin,19,0,35,16
1657311319501,MATH 20E,B02,083774,Ciotti; Benjamin,17,0,35,18
1657311325536,MATH 103A,A01,083777,Greenfeld; Be'Eri,3,0,36,33
1657311325536,MATH 103A,A02,083778,Greenfeld; Be'Eri,5,0,36,31
1657311325536,MATH 103A,A03,093561,Greenfeld; Be'Eri,4,0,36,32
1657311325536,MATH 103A,B01,083779,Greenfeld; Be'Eri,6,0,36,30
1657311325536,MATH 103A,B02,083780,Greenfeld; Be'Eri,4,0,36,32
1657311325536,MATH 103A,B03,093562,Greenfeld; Be'Eri,3,0,36,33
1657311331562,MATH 105,A01,085443,Carter; Anne Toulson,15,0,35,20
1657311331562,MATH 105,A02,093477,Carter; Anne Toulson,20,0,35,15
1657311337585,MATH 109,A01,083213,Ganzberger; Geoffrey Michael,2,0,34,32
1657311337585,MATH 109,A02,083214,Ganzberger; Geoffrey Michael,4,0,34,30
1657311337585,MATH 109,A03,093478,Ganzberger; Geoffrey Michael,2,0,34,32
1657311337585,MATH 109,B01,083215,Ganzberger; Geoffrey Michael,1,0,32,31
1657311337585,MATH 109,B02,083216,Ganzberger; Geoffrey Michael,1,0,32,31
1657311337585,MATH 109,B03,093479,Ganzberger; Geoffrey Michael,8,0,32,24
1657311343609,MATH 142A,A01,083219,Chow; Bennett,7,0,32,25
1657311343609,MATH 142A,A02,083220,Chow; Bennett,10,0,32,22
1657311343609,MATH 142A,A03,093480,Chow; Bennett,7,0,32,25
1657311343609,MATH 142A,B03,093481,Chow; Bennett,8,0,32,24
1657311343609,MATH 142A,B04,093558,Chow; Bennett,13,0,32,19
1657311343609,MATH 142A,B05,093559,Chow; Bennett,6,0,32,26
1657311349644,MATH 193A,A01,083224,Rotar; Vladimir,7,0,34,27
1657311349644,MATH 193A,A02,083225,Rotar; Vladimir,7,0,34,27
1657311349644,MATH 193A,A03,083781,Rotar; Vladimir,3,0,34,31
1657311349644,MATH 193A,A04,083782,Rotar; Vladimir,8,0,34,26
1657311349644,MATH 193A,A05,093482,Rotar; Vladimir,8,0,34,26
1657311355670,MATH 197,001,091859,McAuley; Julian John,9999,0,9999,0
1657311355670,MATH 197,002,095566,Kedlaya; Kiran S.,9997,0,9999,2
1657311355670,MATH 197,003,095567,Xiao; Ming,9999,0,9999,0
1657311355670,MATH 197,004,095571,Perols; Johan Lars,9998,0,9999,1
1657311362744,COGS 9,A01,083615,Shannon; Kyle Michael,8,0,75,67
1657311368769,COGS 11,A01,083617,Boyle; Mary E. T.,22,0,48,26
1657311374793,COGS 13,A01,083071,Bastos; Amalia Pinkusfeld,10,0,71,61
1657311380827,COGS 14A,A01,092681,Semenuks; Arturs,2,1,100,98
1657311386849,COGS 14B,A01,083073,Cheng; Tzu-Han,6,0,63,57
1657311392872,COGS 17,A01,092677,Semenuks; Arturs,5,0,81,76
1657311398908,COGS 100,A01,083619,Allen; Michael Gordon,16,0,70,54
1657311404933,COGS 101A,A01,083621,Davis; Joshua Daniel,9,0,68,59
1657311410955,COGS 101B,A01,091572,Allen; Michael Gordon,11,0,65,54
1657311416981,COGS 101C,A01,083625,Delgado; Tania,17,0,35,18
1657311423007,COGS 107A,A01,083627,Boyle; Mary E. T.,13,0,60,47
1657311429034,COGS 118A,A01,083075,Gupta; Anjum,17,0,76,59
1657311435062,CSE 3,A50,083646,Miranda; Gregory Joseph,24,0,50,26
1657311441086,CSE 8A,A50,083650,Miranda; Gregory Joseph,17,1,56,39
1657311447110,CSE 11,A01,083080,Cao; Yingjun,6,15,40,34
1657311453133,CSE 12,A01,083652,Krause-Levy; Sophia Louisa,27,1,120,93
1657311459169,CSE 15L,A01,083654,Morris; Justin Loren,9,0,50,41
1657311459169,CSE 15L,A02,083655,Morris; Justin Loren,9,0,50,41
1657311465194,CSE 20,A01,083657,Tran; Khoa Dang,38,0,80,42
1657311471229,CSE 21,A01,095574,Bach; Quang Tran,22,0,48,26
1657311477262,CSE 30,A01,083084,Eldon; John,4,0,80,76
1657311477262,CSE 30,B01,095061,Bhaskar; Nishant,9,0,50,41
1657311483288,CSE 100,A01,083659,Cao; Yingjun,4,4,70,66
1657311489316,CSE 134B,A01,083661,Powell; Thomas Allan,21,0,100,79
1657311495340,CSE 140,A01,083663,Gungor; Onat,13,0,85,72
1657311501362,CSE 140L,A01,083088,Eldon; John,21,0,100,79
1657311507388,CSE 175,A01,083665,Kumar; Rakesh,3,0,25,22
1657311513410,CSE 190,A00,092507,Dubnov; Shlomo,7,0,20,13
1657311519444,ECE 45,A01,083139,Congero; Spencer William,6,0,75,69
1657311525473,ECE 65,A50,083695,Saad; Andrew S,12,0,30,18
1657311525473,ECE 65,A51,095125,Saad; Andrew S,25,0,26,1
1657311531517,ECE 109,A01,091882,Touri; Behrouz,19,0,70,51
1657311537543,ECE 180,A00,083140,Abi Samra; Nicholas Camill,1,0,30,29
1657311537543,ECE 180,B00,083141,Abi Samra; Nicholas Camill,0,0,30,30
1657311543566,MATH 10A,A01,083735,Patchell; Gregory David,2,0,30,28
1657311543566,MATH 10A,A02,083736,Patchell; Gregory David,20,0,30,10
1657311543566,MATH 10A,A03,083737,Patchell; Gregory David,16,0,30,14
1657311549588,MATH 10B,A01,083207,Lim; Seonhee,7,0,34,27
1657311549588,MATH 10B,A02,083208,Lim; Seonhee,9,0,35,26
1657311549588,MATH 10B,A03,093472,Lim; Seonhee,7,0,34,27
1657311549588,MATH 10B,B01,083739,Sinha; Shubham,11,0,30,19
1657311555615,MATH 18,A01,083743,Cinel; Cameron Alexander,6,0,30,24
1657311555615,MATH 18,A02,083744,Cinel; Cameron Alexander,17,0,30,13
1657311555615,MATH 18,A03,083745,Cinel; Cameron Alexander,8,0,30,22
1657311555615,MATH 18,B01,083748,Rideout; David Porter,4,0,37,33
1657311555615,MATH 18,B02,083749,Rideout; David Porter,5,0,36,31
1657311555615,MATH 18,B03,083750,Rideout; David Porter,3,0,37,34
1657311555615,MATH 18,B04,083751,Rideout; David Porter,6,0,36,30
1657311555615,MATH 18,B05,093473,Rideout; David Porter,5,0,36,31
1657311555615,MATH 18,B06,093474,Rideout; David Porter,5,0,36,31
1657311561642,MATH 20A,A01,083754,Zheng; Zequn,14,0,40,26
1657311567671,MATH 20B,A01,083756,Briones; Jor-el Thomas Caparas,4,0,36,32
1657311567671,MATH 20B,A02,083757,Briones; Jor-el Thomas Caparas,1,0,36,35
1657311567671,MATH 20B,A03,093475,Briones; Jor-el Thomas Caparas,2,0,36,34
1657311573694,MATH 20C,A01,083760,Briones; Jor-el Thomas Caparas,1,0,35,34
1657311573694,MATH 20C,A02,083761,Briones; Jor-el Thomas Caparas,8,0,35,27
1657311573694,MATH 20C,A03,093476,Briones; Jor-el Thomas Caparas,0,1,36,36
1657311573694,MATH 20C,B01,083762,Bach; Quang Tran,1,0,30,29
1657311579723,MATH 20D,A01,083765,Tran; Brian Kha,5,0,30,25
1657311579723,MATH 20D,A02,083766,Tran; Brian Kha,5,0,30,25
1657311579723,MATH 20D,A03,083767,Tran; Brian Kha,4,0,30,26
1657311585748,MATH 20E,A01,083771,Ganguly; Soumya,7,0,32,25
1657311585748,MATH 20E,A02,083772,Ganguly; Soumya,6,0,32,26
1657311585748,MATH 20E,B01,083773,Ciotti; Benjamin,19,0,35,16
1657311585748,MATH 20E,B02,083774,Ciotti; Benjamin,17,0,35,18
1657311591775,MATH 103A,A01,083777,Greenfeld; Be'Eri,3,0,36,33
1657311591775,MATH 103A,A02,083778,Greenfeld; Be'Eri,5,0,36,31
1657311591775,MATH 103A,A03,093561,Greenfeld; Be'Eri,4,0,36,32
1657311591775,MATH 103A,B01,083779,Greenfeld; Be'Eri,6,0,36,30
1657311591775,MATH 103A,B02,083780,Greenfeld; Be'Eri,4,0,36,32
1657311591775,MATH 103A,B03,093562,Greenfeld; Be'Eri,3,0,36,33
1657311597800,MATH 105,A01,085443,Carter; Anne Toulson,15,0,35,20
1657311597800,MATH 105,A02,093477,Carter; Anne Toulson,20,0,35,15
1657311603824,MATH 109,A01,083213,Ganzberger; Geoffrey Michael,2,0,34,32
1657311603824,MATH 109,A02,083214,Ganzberger; Geoffrey Michael,4,0,34,30
1657311603824,MATH 109,A03,093478,Ganzberger; Geoffrey Michael,2,0,34,32
1657311603824,MATH 109,B01,083215,Ganzberger; Geoffrey Michael,1,0,32,31
1657311603824,MATH 109,B02,083216,Ganzberger; Geoffrey Michael,1,0,32,31
1657311603824,MATH 109,B03,093479,Ganzberger; Geoffrey Michael,8,0,32,24
1657311609847,MATH 142A,A01,083219,Chow; Bennett,7,0,32,25
1657311609847,MATH 142A,A02,083220,Chow; Bennett,10,0,32,22
1657311609847,MATH 142A,A03,093480,Chow; Bennett,7,0,32,25
1657311609847,MATH 142A,B03,093481,Chow; Bennett,8,0,32,24
1657311609847,MATH 142A,B04,093558,Chow; Bennett,13,0,32,19
1657311609847,MATH 142A,B05,093559,Chow; Bennett,6,0,32,26
1657311615876,MATH 193A,A01,083224,Rotar; Vladimir,7,0,34,27
1657311615876,MATH 193A,A02,083225,Rotar; Vladimir,7,0,34,27
1657311615876,MATH 193A,A03,083781,Rotar; Vladimir,3,0,34,31
1657311615876,MATH 193A,A04,083782,Rotar; Vladimir,8,0,34,26
1657311615876,MATH 193A,A05,093482,Rotar; Vladimir,8,0,34,26
1657311621904,MATH 197,001,091859,McAuley; Julian John,9999,0,9999,0
1657311621904,MATH 197,002,095566,Kedlaya; Kiran S.,9997,0,9999,2
1657311621904,MATH 197,003,095567,Xiao; Ming,9999,0,9999,0
1657311621904,MATH 197,004,095571,Perols; Johan Lars,9998,0,9999,1
1657311628980,COGS 9,A01,083615,Shannon; Kyle Michael,8,0,75,67
1657311635005,COGS 11,A01,083617,Boyle; Mary E. T.,22,0,48,26
1657311641032,COGS 13,A01,083071,Bastos; Amalia Pinkusfeld,10,0,71,61
1657311647057,COGS 14A,A01,092681,Semenuks; Arturs,2,1,100,98
1657311653084,COGS 14B,A01,083073,Cheng; Tzu-Han,6,0,63,57
1657311659114,COGS 17,A01,092677,Semenuks; Arturs,5,0,81,76
1657311665148,COGS 100,A01,083619,Allen; Michael Gordon,16,0,70,54
1657311671172,COGS 101A,A01,083621,Davis; Joshua Daniel,9,0,68,59
1657311677194,COGS 101B,A01,091572,Allen; Michael Gordon,11,0,65,54
1657311683216,COGS 101C,A01,083625,Delgado; Tania,17,0,35,18
1657311689243,COGS 107A,A01,083627,Boyle; Mary E. T.,13,0,60,47
1657311695277,COGS 118A,A01,083075,Gupta; Anjum,17,0,76,59
1657311701310,CSE 3,A50,083646,Miranda; Gregory Joseph,24,0,50,26
1657311707344,CSE 8A,A50,083650,Miranda; Gregory Joseph,17,1,56,39
1657311713374,CSE 11,A01,083080,Cao; Yingjun,6,15,40,34
1657311719408,CSE 12,A01,083652,Krause-Levy; Sophia Louisa,27,1,120,93
1657311725512,CSE 15L,A01,083654,Morris; Justin Loren,9,0,50,41
1657311725512,CSE 15L,A02,083655,Morris; Justin Loren,9,0,50,41
1657311731559,CSE 20,A01,083657,Tran; Khoa Dang,38,0,80,42
1657311737590,CSE 21,A01,095574,Bach; Quang Tran,22,0,48,26
1657311743617,CSE 30,A01,083084,Eldon; John,4,0,80,76
1657311743617,CSE 30,B01,095061,Bhaskar; Nishant,9,0,50,41
1657311749643,CSE 100,A01,083659,Cao; Yingjun,4,4,70,66
1657311755669,CSE 134B,A01,083661,Powell; Thomas Allan,21,0,100,79
1657311761692,CSE 140,A01,083663,Gungor; Onat,13,0,85,72
1657311767720,CSE 140L,A01,083088,Eldon; John,21,0,100,79
1657311773743,CSE 175,A01,083665,Kumar; Rakesh,3,0,25,22
1657311779770,CSE 190,A00,092507,Dubnov; Shlomo,7,0,20,13
1657311785793,ECE 45,A01,083139,Congero; Spencer William,6,0,75,69
1657311791820,ECE 65,A50,083695,Saad; Andrew S,12,0,30,18
1657311791820,ECE 65,A51,095125,Saad; Andrew S,25,0,26,1
1657311797845,ECE 109,A01,091882,Touri; Behrouz,19,0,70,51
1657311803873,ECE 180,A00,083140,Abi Samra; Nicholas Camill,1,0,30,29
1657311803873,ECE 180,B00,083141,Abi Samra; Nicholas Camill,0,0,30,30
1657311809902,MATH 10A,A01,083735,Patchell; Gregory David,2,0,30,28
1657311809902,MATH 10A,A02,083736,Patchell; Gregory David,20,0,30,10
1657311809902,MATH 10A,A03,083737,Patchell; Gregory David,16,0,30,14
1657311815929,MATH 10B,A01,083207,Lim; Seonhee,7,0,34,27
1657311815929,MATH 10B,A02,083208,Lim; Seonhee,9,0,35,26
1657311815929,MATH 10B,A03,093472,Lim; Seonhee,7,0,34,27
1657311815929,MATH 10B,B01,083739,Sinha; Shubham,11,0,30,19
1657311821958,MATH 18,A01,083743,Cinel; Cameron Alexander,6,0,30,24
1657311821958,MATH 18,A02,083744,Cinel; Cameron Alexander,17,0,30,13
1657311821958,MATH 18,A03,083745,Cinel; Cameron Alexander,8,0,30,22
1657311821958,MATH 18,B01,083748,Rideout; David Porter,4,0,37,33
1657311821958,MATH 18,B02,083749,Rideout; David Porter,5,0,36,31
1657311821958,MATH 18,B03,083750,Rideout; David Porter,3,0,37,34
1657311821958,MATH 18,B04,083751,Rideout; David Porter,6,0,36,30
1657311821958,MATH 18,B05,093473,Rideout; David Porter,5,0,36,31
1657311821958,MATH 18,B06,093474,Rideout; David Porter,5,0,36,31
1657311828007,MATH 20A,A01,083754,Zheng; Zequn,14,0,40,26
1657311834030,MATH 20B,A01,083756,Briones; Jor-el Thomas Caparas,4,0,36,32
1657311834030,MATH 20B,A02,083757,Briones; Jor-el Thomas Caparas,1,0,36,35
1657311834030,MATH 20B,A03,093475,Briones; Jor-el Thomas Caparas,2,0,36,34
1657311840055,MATH 20C,A01,083760,Briones; Jor-el Thomas Caparas,1,0,35,34
1657311840055,MATH 20C,A02,083761,Briones; Jor-el Thomas Caparas,8,0,35,27
1657311840055,MATH 20C,A03,093476,Briones; Jor-el Thomas Caparas,0,1,36,36
1657311840055,MATH 20C,B01,083762,Bach; Quang Tran,1,0,30,29
1657311846090,MATH 20D,A01,083765,Tran; Brian Kha,5,0,30,25
1657311846090,MATH 20D,A02,083766,Tran; Brian Kha,5,0,30,25
1657311846090,MATH 20D,A03,083767,Tran; Brian Kha,4,0,30,26
1657311852117,MATH 20E,A01,083771,Ganguly; Soumya,7,0,32,25
1657311852117,MATH 20E,A02,083772,Ganguly; Soumya,6,0,32,26
1657311852117,MATH 20E,B01,083773,Ciotti; Benjamin,19,0,35,16
1657311852117,MATH 20E,B02,083774,Ciotti; Benjamin,17,0,35,18
1657311858142,MATH 103A,A01,083777,Greenfeld; Be'Eri,3,0,36,33
1657311858142,MATH 103A,A02,083778,Greenfeld; Be'Eri,5,0,36,31
1657311858142,MATH 103A,A03,093561,Greenfeld; Be'Eri,4,0,36,32
1657311858142,MATH 103A,B01,083779,Greenfeld; Be'Eri,6,0,36,30
1657311858142,MATH 103A,B02,083780,Greenfeld; Be'Eri,4,0,36,32
1657311858142,MATH 103A,B03,093562,Greenfeld; Be'Eri,3,0,36,33
1657311864167,MATH 105,A01,085443,Carter; Anne Toulson,15,0,35,20
1657311864167,MATH 105,A02,093477,Carter; Anne Toulson,20,0,35,15
1657311870200,MATH 109,A01,083213,Ganzberger; Geoffrey Michael,2,0,34,32
1657311870200,MATH 109,A02,083214,Ganzberger; Geoffrey Michael,4,0,34,30
1657311870200,MATH 109,A03,093478,Ganzberger; Geoffrey Michael,2,0,34,32
1657311870200,MATH 109,B01,083215,Ganzberger; Geoffrey Michael,1,0,32,31
1657311870200,MATH 109,B02,083216,Ganzberger; Geoffrey Michael,1,0,32,31
1657311870200,MATH 109,B03,093479,Ganzberger; Geoffrey Michael,8,0,32,24
1657311876237,MATH 142A,A01,083219,Chow; Bennett,7,0,32,25
1657311876237,MATH 142A,A02,083220,Chow; Bennett,10,0,32,22
1657311876237,MATH 142A,A03,093480,Chow; Bennett,7,0,32,25
1657311876237,MATH 142A,B03,093481,Chow; Bennett,8,0,32,24
1657311876237,MATH 142A,B04,093558,Chow; Bennett,13,0,32,19
1657311876237,MATH 142A,B05,093559,Chow; Bennett,6,0,32,26
1657311882261,MATH 193A,A01,083224,Rotar; Vladimir,7,0,34,27
1657311882261,MATH 193A,A02,083225,Rotar; Vladimir,7,0,34,27
1657311882261,MATH 193A,A03,083781,Rotar; Vladimir,3,0,34,31
1657311882261,MATH 193A,A04,083782,Rotar; Vladimir,8,0,34,26
1657311882261,MATH 193A,A05,093482,Rotar; Vladimir,8,0,34,26
1657311888284,MATH 197,001,091859,McAuley; Julian John,9999,0,9999,0
1657311888284,MATH 197,002,095566,Kedlaya; Kiran S.,9997,0,9999,2
1657311888284,MATH 197,003,095567,Xiao; Ming,9999,0,9999,0
1657311888284,MATH 197,004,095571,Perols; Johan Lars,9998,0,9999,1
1657311895341,COGS 9,A01,083615,Shannon; Kyle Michael,8,0,75,67
1657311901388,COGS 11,A01,083617,Boyle; Mary E. T.,22,0,48,26
1657311907410,COGS 13,A01,083071,Bastos; Amalia Pinkusfeld,10,0,71,61
1657311913436,COGS 14A,A01,092681,Semenuks; Arturs,2,1,100,98
1657311919459,COGS 14B,A01,083073,Cheng; Tzu-Han,6,0,63,57
1657311925485,COGS 17,A01,092677,Semenuks; Arturs,5,0,81,76
1657311931517,COGS 100,A01,083619,Allen; Michael Gordon,16,0,70,54
1657311937543,COGS 101A,A01,083621,Davis; Joshua Daniel,9,0,68,59
1657311943581,COGS 101B,A01,091572,Allen; Michael Gordon,11,0,65,54
1657311949611,COGS 101C,A01,083625,Delgado; Tania,17,0,35,18
1657311955643,COGS 107A,A01,083627,Boyle; Mary E. T.,13,0,60,47
1657311961668,COGS 118A,A01,083075,Gupta; Anjum,17,0,76,59
1657311967703,CSE 3,A50,083646,Miranda; Gregory Joseph,24,0,50,26
1657311973736,CSE 8A,A50,083650,Miranda; Gregory Joseph,17,1,56,39
1657311979760,CSE 11,A01,083080,Cao; Yingjun,6,15,40,34
1657311985784,CSE 12,A01,083652,Krause-Levy; Sophia Louisa,27,1,120,93
1657311991810,CSE 15L,A01,083654,Morris; Justin Loren,9,0,50,41
1657311991810,CSE 15L,A02,083655,Morris; Justin Loren,9,0,50,41
1657311997841,CSE 20,A01,083657,Tran; Khoa Dang,38,0,80,42
1657312003868,CSE 21,A01,095574,Bach; Quang Tran,22,0,48,26
1657312009892,CSE 30,A01,083084,Eldon; John,4,0,80,76
1657312009892,CSE 30,B01,095061,Bhaskar; Nishant,9,0,50,41
1657312015913,CSE 100,A01,083659,Cao; Yingjun,4,4,70,66
1657312021935,CSE 134B,A01,083661,Powell; Thomas Allan,21,0,100,79
1657312027957,CSE 140,A01,083663,Gungor; Onat,13,0,85,72
1657312033981,CSE 140L,A01,083088,Eldon; John,21,0,100,79
1657312040004,CSE 175,A01,083665,Kumar; Rakesh,3,0,25,22
1657312046027,CSE 190,A00,092507,Dubnov; Shlomo,7,0,20,13
1657312052056,ECE 45,A01,083139,Congero; Spencer William,6,0,75,69
1657312058093,ECE 65,A50,083695,Saad; Andrew S,12,0,30,18
1657312058093,ECE 65,A51,095125,Saad; Andrew S,25,0,26,1
1657312064116,ECE 109,A01,091882,Touri; Behrouz,19,0,70,51
1657312070141,ECE 180,A00,083140,Abi Samra; Nicholas Camill,1,0,30,29
1657312070141,ECE 180,B00,083141,Abi Samra; Nicholas Camill,0,0,30,30
1657312076179,MATH 10A,A01,083735,Patchell; Gregory David,2,0,30,28
1657312076179,MATH 10A,A02,083736,Patchell; Gregory David,20,0,30,10
1657312076179,MATH 10A,A03,083737,Patchell; Gregory David,16,0,30,14
1657312082201,MATH 10B,A01,083207,Lim; Seonhee,7,0,34,27
1657312082201,MATH 10B,A02,083208,Lim; Seonhee,9,0,35,26
1657312082201,MATH 10B,A03,093472,Lim; Seonhee,7,0,34,27
1657312082201,MATH 10B,B01,083739,Sinha; Shubham,11,0,30,19
1657312088225,MATH 18,A01,083743,Cinel; Cameron Alexander,6,0,30,24
1657312088225,MATH 18,A02,083744,Cinel; Cameron Alexander,17,0,30,13
1657312088225,MATH 18,A03,083745,Cinel; Cameron Alexander,8,0,30,22
1657312088225,MATH 18,B01,083748,Rideout; David Porter,4,0,37,33
1657312088225,MATH 18,B02,083749,Rideout; David Porter,5,0,36,31
1657312088225,MATH 18,B03,083750,Rideout; David Porter,3,0,37,34
1657312088225,MATH 18,B04,083751,Rideout; David Porter,6,0,36,30
1657312088225,MATH 18,B05,093473,Rideout; David Porter,5,0,36,31
1657312088225,MATH 18,B06,093474,Rideout; David Porter,5,0,36,31
1657312094251,MATH 20A,A01,083754,Zheng; Zequn,14,0,40,26
1657312100275,MATH 20B,A01,083756,Briones; Jor-el Thomas Caparas,4,0,36,32
1657312100275,MATH 20B,A02,083757,Briones; Jor-el Thomas Caparas,1,0,36,35
1657312100275,MATH 20B,A03,093475,Briones; Jor-el Thomas Caparas,2,0,36,34
1657312106298,MATH 20C,A01,083760,Briones; Jor-el Thomas Caparas,1,0,35,34
1657312106298,MATH 20C,A02,083761,Briones; Jor-el Thomas Caparas,8,0,35,27
1657312106298,MATH 20C,A03,093476,Briones; Jor-el Thomas Caparas,0,1,36,36
1657312106298,MATH 20C,B01,083762,Bach; Quang Tran,1,0,30,29
1657312112332,MATH 20D,A01,083765,Tran; Brian Kha,5,0,30,25
1657312112332,MATH 20D,A02,083766,Tran; Brian Kha,5,0,30,25
1657312112332,MATH 20D,A03,083767,Tran; Brian Kha,4,0,30,26
1657312118370,MATH 20E,A01,083771,Ganguly; Soumya,7,0,32,25
1657312118370,MATH 20E,A02,083772,Ganguly; Soumya,6,0,32,26
1657312118370,MATH 20E,B01,083773,Ciotti; Benjamin,19,0,35,16
1657312118370,MATH 20E,B02,083774,Ciotti; Benjamin,17,0,35,18
1657312124396,MATH 103A,A01,083777,Greenfeld; Be'Eri,3,0,36,33
1657312124396,MATH 103A,A02,083778,Greenfeld; Be'Eri,5,0,36,31
1657312124396,MATH 103A,A03,093561,Greenfeld; Be'Eri,4,0,36,32
1657312124396,MATH 103A,B01,083779,Greenfeld; Be'Eri,6,0,36,30
1657312124396,MATH 103A,B02,083780,Greenfeld; Be'Eri,4,0,36,32
1657312124396,MATH 103A,B03,093562,Greenfeld; Be'Eri,3,0,36,33
1657312130426,MATH 105,A01,085443,Carter; Anne Toulson,15,0,35,20
1657312130426,MATH 105,A02,093477,Carter; Anne Toulson,20,0,35,15
1657312136459,MATH 109,A01,083213,Ganzberger; Geoffrey Michael,2,0,34,32
1657312136459,MATH 109,A02,083214,Ganzberger; Geoffrey Michael,4,0,34,30
1657312136459,MATH 109,A03,093478,Ganzberger; Geoffrey Michael,2,0,34,32
1657312136459,MATH 109,B01,083215,Ganzberger; Geoffrey Michael,1,0,32,31
1657312136459,MATH 109,B02,083216,Ganzberger; Geoffrey Michael,1,0,32,31
1657312136459,MATH 109,B03,093479,Ganzberger; Geoffrey Michael,8,0,32,24
1657312142488,MATH 142A,A01,083219,Chow; Bennett,7,0,32,25
1657312142488,MATH 142A,A02,083220,Chow; Bennett,10,0,32,22
1657312142488,MATH 142A,A03,093480,Chow; Bennett,7,0,32,25
1657312142488,MATH 142A,B03,093481,Chow; Bennett,8,0,32,24
1657312142488,MATH 142A,B04,093558,Chow; Bennett,13,0,32,19
1657312142488,MATH 142A,B05,093559,Chow; Bennett,6,0,32,26
1657312148522,MATH 193A,A01,083224,Rotar; Vladimir,7,0,34,27
1657312148522,MATH 193A,A02,083225,Rotar; Vladimir,7,0,34,27
1657312148522,MATH 193A,A03,083781,Rotar; Vladimir,3,0,34,31
1657312148522,MATH 193A,A04,083782,Rotar; Vladimir,8,0,34,26
1657312148522,MATH 193A,A05,093482,Rotar; Vladimir,8,0,34,26
1657312154547,MATH 197,001,091859,McAuley; Julian John,9999,0,9999,0
1657312154547,MATH 197,002,095566,Kedlaya; Kiran S.,9997,0,9999,2
1657312154547,MATH 197,003,095567,Xiao; Ming,9999,0,9999,0
1657312154547,MATH 197,004,095571,Perols; Johan Lars,9998,0,9999,1
1657312161613,COGS 9,A01,083615,Shannon; Kyle Michael,8,0,75,67
1657312167636,COGS 11,A01,083617,Boyle; Mary E. T.,22,0,48,26
1657312173658,COGS 13,A01,083071,Bastos; Amalia Pinkusfeld,10,0,71,61
1657312179686,COGS 14A,A01,092681,Semenuks; Arturs,2,1,100,98
1657312185713,COGS 14B,A01,083073,Cheng; Tzu-Han,6,0,63,57
1657312191739,COGS 17,A01,092677,Semenuks; Arturs,5,0,81,76
1657312197786,COGS 100,A01,083619,Allen; Michael Gordon,16,0,70,54
1657312203809,COGS 101A,A01,083621,Davis; Joshua Daniel,9,0,68,59
1657312209836,COGS 101B,A01,091572,Allen; Michael Gordon,11,0,65,54
1657312215858,COGS 101C,A01,083625,Delgado; Tania,17,0,35,18
1657312221880,COGS 107A,A01,083627,Boyle; Mary E. T.,13,0,60,47
1657312227917,COGS 118A,A01,083075,Gupta; Anjum,17,0,76,59
1657312233944,CSE 3,A50,083646,Miranda; Gregory Joseph,24,0,50,26
1657312239975,CSE 8A,A50,083650,Miranda; Gregory Joseph,17,1,56,39
1657312246003,CSE 11,A01,083080,Cao; Yingjun,6,15,40,34
1657312252031,CSE 12,A01,083652,Krause-Levy; Sophia Louisa,27,1,120,93
1657312258062,CSE 15L,A01,083654,Morris; Justin Loren,9,0,50,41
1657312258062,CSE 15L,A02,083655,Morris; Justin Loren,9,0,50,41
1657312264085,CSE 20,A01,083657,Tran; Khoa Dang,38,0,80,42
1657312270123,CSE 21,A01,095574,Bach; Quang Tran,22,0,48,26
1657312276149,CSE 30,A01,083084,Eldon; John,4,0,80,76
1657312276149,CSE 30,B01,095061,Bhaskar; Nishant,9,0,50,41
1657312282175,CSE 100,A01,083659,Cao; Yingjun,4,4,70,66
1657312288197,CSE 134B,A01,083661,Powell; Thomas Allan,21,0,100,79
1657312294220,CSE 140,A01,083663,Gungor; Onat,13,0,85,72
1657312300242,CSE 140L,A01,083088,Eldon; John,21,0,100,79
1657312306274,CSE 175,A01,083665,Kumar; Rakesh,3,0,25,22
1657312312297,CSE 190,A00,092507,Dubnov; Shlomo,7,0,20,13
1657312318326,ECE 45,A01,083139,Congero; Spencer William,6,0,75,69
1657312324437,ECE 65,A50,083695,Saad; Andrew S,12,0,30,18
1657312324437,ECE 65,A51,095125,Saad; Andrew S,25,0,26,1
1657312330462,ECE 109,A01,091882,Touri; Behrouz,19,0,70,51
1657312336484,ECE 180,A00,083140,Abi Samra; Nicholas Camill,1,0,30,29
1657312336484,ECE 180,B00,083141,Abi Samra; Nicholas Camill,0,0,30,30
1657312342510,MATH 10A,A01,083735,Patchell; Gregory David,2,0,30,28
1657312342510,MATH 10A,A02,083736,Patchell; Gregory David,20,0,30,10
1657312342510,MATH 10A,A03,083737,Patchell; Gregory David,16,0,30,14
1657312348533,MATH 10B,A01,083207,Lim; Seonhee,7,0,34,27
1657312348533,MATH 10B,A02,083208,Lim; Seonhee,9,0,35,26
1657312348533,MATH 10B,A03,093472,Lim; Seonhee,7,0,34,27
1657312348533,MATH 10B,B01,083739,Sinha; Shubham,11,0,30,19
1657312354574,MATH 18,A01,083743,Cinel; Cameron Alexander,6,0,30,24
1657312354574,MATH 18,A02,083744,Cinel; Cameron Alexander,17,0,30,13
1657312354574,MATH 18,A03,083745,Cinel; Cameron Alexander,8,0,30,22
1657312354574,MATH 18,B01,083748,Rideout; David Porter,4,0,37,33
1657312354574,MATH 18,B02,083749,Rideout; David Porter,5,0,36,31
1657312354574,MATH 18,B03,083750,Rideout; David Porter,3,0,37,34
1657312354574,MATH 18,B04,083751,Rideout; David Porter,6,0,36,30
1657312354574,MATH 18,B05,093473,Rideout; David Porter,5,0,36,31
1657312354574,MATH 18,B06,093474,Rideout; David Porter,5,0,36,31
1657312360598,MATH 20A,A01,083754,Zheng; Zequn,14,0,40,26
1657312366621,MATH 20B,A01,083756,Briones; Jor-el Thomas Caparas,4,0,36,32
1657312366621,MATH 20B,A02,083757,Briones; Jor-el Thomas Caparas,1,0,36,35
1657312366621,MATH 20B,A03,093475,Briones; Jor-el Thomas Caparas,2,0,36,34
1657312372644,MATH 20C,A01,083760,Briones; Jor-el Thomas Caparas,1,0,35,34
1657312372644,MATH 20C,A02,083761,Briones; Jor-el Thomas Caparas,8,0,35,27
1657312372644,MATH 20C,A03,093476,Briones; Jor-el Thomas Caparas,0,1,36,36
1657312372644,MATH 20C,B01,083762,Bach; Quang Tran,1,0,30,29
1657312378672,MATH 20D,A01,083765,Tran; Brian Kha,5,0,30,25
1657312378672,MATH 20D,A02,083766,Tran; Brian Kha,5,0,30,25
1657312378672,MATH 20D,A03,083767,Tran; Brian Kha,4,0,30,26
1657312384704,MATH 20E,A01,083771,Ganguly; Soumya,7,0,32,25
1657312384704,MATH 20E,A02,083772,Ganguly; Soumya,6,0,32,26
1657312384704,MATH 20E,B01,083773,Ciotti; Benjamin,19,0,35,16
1657312384704,MATH 20E,B02,083774,Ciotti; Benjamin,17,0,35,18
1657312390732,MATH 103A,A01,083777,Greenfeld; Be'Eri,3,0,36,33
1657312390732,MATH 103A,A02,083778,Greenfeld; Be'Eri,5,0,36,31
1657312390732,MATH 103A,A03,093561,Greenfeld; Be'Eri,4,0,36,32
1657312390732,MATH 103A,B01,083779,Greenfeld; Be'Eri,6,0,36,30
1657312390732,MATH 103A,B02,083780,Greenfeld; Be'Eri,4,0,36,32
1657312390732,MATH 103A,B03,093562,Greenfeld; Be'Eri,3,0,36,33
1657312396766,MATH 105,A01,085443,Carter; Anne Toulson,15,0,35,20
1657312396766,MATH 105,A02,093477,Carter; Anne Toulson,20,0,35,15
1657312402800,MATH 109,A01,083213,Ganzberger; Geoffrey Michael,2,0,34,32
1657312402800,MATH 109,A02,083214,Ganzberger; Geoffrey Michael,4,0,34,30
1657312402800,MATH 109,A03,093478,Ganzberger; Geoffrey Michael,2,0,34,32
1657312402800,MATH 109,B01,083215,Ganzberger; Geoffrey Michael,1,0,32,31
1657312402800,MATH 109,B02,083216,Ganzberger; Geoffrey Michael,1,0,32,31
1657312402800,MATH 109,B03,093479,Ganzberger; Geoffrey Michael,8,0,32,24
1657312408827,MATH 142A,A01,083219,Chow; Bennett,7,0,32,25
1657312408827,MATH 142A,A02,083220,Chow; Bennett,10,0,32,22
1657312408827,MATH 142A,A03,093480,Chow; Bennett,7,0,32,25
1657312408827,MATH 142A,B03,093481,Chow; Bennett,8,0,32,24
1657312408827,MATH 142A,B04,093558,Chow; Bennett,13,0,32,19
1657312408827,MATH 142A,B05,093559,Chow; Bennett,6,0,32,26
1657312414854,MATH 193A,A01,083224,Rotar; Vladimir,7,0,34,27
1657312414854,MATH 193A,A02,083225,Rotar; Vladimir,7,0,34,27
1657312414854,MATH 193A,A03,083781,Rotar; Vladimir,3,0,34,31
1657312414854,MATH 193A,A04,083782,Rotar; Vladimir,8,0,34,26
1657312414854,MATH 193A,A05,093482,Rotar; Vladimir,8,0,34,26
1657312420877,MATH 197,001,091859,McAuley; Julian John,9999,0,9999,0
1657312420877,MATH 197,002,095566,Kedlaya; Kiran S.,9997,0,9999,2
1657312420877,MATH 197,003,095567,Xiao; Ming,9999,0,9999,0
1657312420877,MATH 197,004,095571,Perols; Johan Lars,9998,0,9999,1
1657312427946,COGS 9,A01,083615,Shannon; Kyle Michael,8,0,75,67
1657312433985,COGS 11,A01,083617,Boyle; Mary E. T.,22,0,48,26
1657312440023,COGS 13,A01,083071,Bastos; Amalia Pinkusfeld,10,0,71,61
1657312446057,COGS 14A,A01,092681,Semenuks; Arturs,2,1,100,98
1657312452080,COGS 14B,A01,083073,Cheng; Tzu-Han,6,0,63,57
1657312458104,COGS 17,A01,092677,Semenuks; Arturs,5,0,81,76
1657312464129,COGS 100,A01,083619,Allen; Michael Gordon,16,0,70,54
1657312470159,COGS 101A,A01,083621,Davis; Joshua Daniel,9,0,68,59
1657312476181,COGS 101B,A01,091572,Allen; Michael Gordon,11,0,65,54
1657312482204,COGS 101C,A01,083625,Delgado; Tania,17,0,35,18
1657312488227,COGS 107A,A01,083627,Boyle; Mary E. T.,13,0,60,47
1657312494254,COGS 118A,A01,083075,Gupta; Anjum,17,0,76,59
1657312500276,CSE 3,A50,083646,Miranda; Gregory Joseph,24,0,50,26
1657312506303,CSE 8A,A50,083650,Miranda; Gregory Joseph,17,1,56,39
1657312512326,CSE 11,A01,083080,Cao; Yingjun,6,15,40,34
1657312518357,CSE 12,A01,083652,Krause-Levy; Sophia Louisa,27,1,120,93
1657312524384,CSE 15L,A01,083654,Morris; Justin Loren,9,0,50,41
1657312524384,CSE 15L,A02,083655,Morris; Justin Loren,9,0,50,41
1657312530407,CSE 20,A01,083657,Tran; Khoa Dang,38,0,80,42
1657312536434,CSE 21,A01,095574,Bach; Quang Tran,22,0,48,26
1657312542457,CSE 30,A01,083084,Eldon; John,4,0,80,76
1657312542457,CSE 30,B01,095061,Bhaskar; Nishant,9,0,50,41
1657312548496,CSE 100,A01,083659,Cao; Yingjun,4,4,70,66
1657312554526,CSE 134B,A01,083661,Powell; Thomas Allan,21,0,100,79
1657312560548,CSE 140,A01,083663,Gungor; Onat,13,0,85,72
1657312566580,CSE 140L,A01,083088,Eldon; John,21,0,100,79
1657312572609,CSE 175,A01,083665,Kumar; Rakesh,3,0,25,22
1657312578638,CSE 190,A00,092507,Dubnov; Shlomo,7,0,20,13
1657312584675,ECE 45,A01,083139,Congero; Spencer William,6,0,75,69
1657312590702,ECE 65,A50,083695,Saad; Andrew S,12,0,30,18
1657312590702,ECE 65,A51,095125,Saad; Andrew S,25,0,26,1
1657312596727,ECE 109,A01,091882,Touri; Behrouz,19,0,70,51
1657312602750,ECE 180,A00,083140,Abi Samra; Nicholas Camill,1,0,30,29
1657312602750,ECE 180,B00,083141,Abi Samra; Nicholas Camill,0,0,30,30
1657312608774,MATH 10A,A01,083735,Patchell; Gregory David,2,0,30,28
1657312608774,MATH 10A,A02,083736,Patchell; Gregory David,20,0,30,10
1657312608774,MATH 10A,A03,083737,Patchell; Gregory David,16,0,30,14
1657312614817,MATH 10B,A01,083207,Lim; Seonhee,7,0,34,27
1657312614817,MATH 10B,A02,083208,Lim; Seonhee,9,0,35,26
1657312614817,MATH 10B,A03,093472,Lim; Seonhee,7,0,34,27
1657312614817,MATH 10B,B01,083739,Sinha; Shubham,11,0,30,19
1657312620842,MATH 18,A01,083743,Cinel; Cameron Alexander,6,0,30,24
1657312620842,MATH 18,A02,083744,Cinel; Cameron Alexander,17,0,30,13
1657312620842,MATH 18,A03,083745,Cinel; Cameron Alexander,8,0,30,22
1657312620842,MATH 18,B01,083748,Rideout; David Porter,4,0,37,33
1657312620842,MATH 18,B02,083749,Rideout; David Porter,5,0,36,31
1657312620842,MATH 18,B03,083750,Rideout; David Porter,3,0,37,34
1657312620842,MATH 18,B04,083751,Rideout; David Porter,6,0,36,30
1657312620842,MATH 18,B05,093473,Rideout; David Porter,5,0,36,31
1657312620842,MATH 18,B06,093474,Rideout; David Porter,5,0,36,31
1657312626865,MATH 20A,A01,083754,Zheng; Zequn,14,0,40,26
1657312632886,MATH 20B,A01,083756,Briones; Jor-el Thomas Caparas,4,0,36,32
1657312632886,MATH 20B,A02,083757,Briones; Jor-el Thomas Caparas,1,0,36,35
1657312632886,MATH 20B,A03,093475,Briones; Jor-el Thomas Caparas,2,0,36,34
1657312638916,MATH 20C,A01,083760,Briones; Jor-el Thomas Caparas,1,0,35,34
1657312638916,MATH 20C,A02,083761,Briones; Jor-el Thomas Caparas,8,0,35,27
1657312638916,MATH 20C,A03,093476,Briones; Jor-el Thomas Caparas,0,1,36,36
1657312638916,MATH 20C,B01,083762,Bach; Quang Tran,1,0,30,29
1657312644951,MATH 20D,A01,083765,Tran; Brian Kha,5,0,30,25
1657312644951,MATH 20D,A02,083766,Tran; Brian Kha,5,0,30,25
1657312644951,MATH 20D,A03,083767,Tran; Brian Kha,4,0,30,26
1657312650978,MATH 20E,A01,083771,Ganguly; Soumya,7,0,32,25
1657312650978,MATH 20E,A02,083772,Ganguly; Soumya,6,0,32,26
1657312650978,MATH 20E,B01,083773,Ciotti; Benjamin,19,0,35,16
1657312650978,MATH 20E,B02,083774,Ciotti; Benjamin,17,0,35,18
1657312657009,MATH 103A,A01,083777,Greenfeld; Be'Eri,3,0,36,33
1657312657009,MATH 103A,A02,083778,Greenfeld; Be'Eri,5,0,36,31
1657312657009,MATH 103A,A03,093561,Greenfeld; Be'Eri,4,0,36,32
1657312657009,MATH 103A,B01,083779,Greenfeld; Be'Eri,6,0,36,30
1657312657009,MATH 103A,B02,083780,Greenfeld; Be'Eri,4,0,36,32
1657312657009,MATH 103A,B03,093562,Greenfeld; Be'Eri,3,0,36,33
1657312663032,MATH 105,A01,085443,Carter; Anne Toulson,15,0,35,20
1657312663032,MATH 105,A02,093477,Carter; Anne Toulson,20,0,35,15
1657312669061,MATH 109,A01,083213,Ganzberger; Geoffrey Michael,2,0,34,32
1657312669061,MATH 109,A02,083214,Ganzberger; Geoffrey Michael,4,0,34,30
1657312669061,MATH 109,A03,093478,Ganzberger; Geoffrey Michael,2,0,34,32
1657312669061,MATH 109,B01,083215,Ganzberger; Geoffrey Michael,1,0,32,31
1657312669061,MATH 109,B02,083216,Ganzberger; Geoffrey Michael,1,0,32,31
1657312669061,MATH 109,B03,093479,Ganzberger; Geoffrey Michael,8,0,32,24
1657312675100,MATH 142A,A01,083219,Chow; Bennett,7,0,32,25
1657312675100,MATH 142A,A02,083220,Chow; Bennett,10,0,32,22
1657312675100,MATH 142A,A03,093480,Chow; Bennett,7,0,32,25
1657312675100,MATH 142A,B03,093481,Chow; Bennett,8,0,32,24
1657312675100,MATH 142A,B04,093558,Chow; Bennett,13,0,32,19
1657312675100,MATH 142A,B05,093559,Chow; Bennett,6,0,32,26
1657312681127,MATH 193A,A01,083224,Rotar; Vladimir,7,0,34,27
1657312681127,MATH 193A,A02,083225,Rotar; Vladimir,7,0,34,27
1657312681127,MATH 193A,A03,083781,Rotar; Vladimir,3,0,34,31
1657312681127,MATH 193A,A04,083782,Rotar; Vladimir,8,0,34,26
1657312681127,MATH 193A,A05,093482,Rotar; Vladimir,8,0,34,26
1657312687150,MATH 197,001,091859,McAuley; Julian John,9999,0,9999,0
1657312687150,MATH 197,002,095566,Kedlaya; Kiran S.,9997,0,9999,2
1657312687150,MATH 197,003,095567,Xiao; Ming,9999,0,9999,0
1657312687150,MATH 197,004,095571,Perols; Johan Lars,9998,0,9999,1
1657312694215,COGS 9,A01,083615,Shannon; Kyle Michael,8,0,75,67
1657312700246,COGS 11,A01,083617,Boyle; Mary E. T.,22,0,48,26
1657312706286,COGS 13,A01,083071,Bastos; Amalia Pinkusfeld,10,0,71,61
1657312712309,COGS 14A,A01,092681,Semenuks; Arturs,2,1,100,98
1657312718343,COGS 14B,A01,083073,Cheng; Tzu-Han,6,0,63,57
1657312724366,COGS 17,A01,092677,Semenuks; Arturs,5,0,81,76
1657312730387,COGS 100,A01,083619,Allen; Michael Gordon,16,0,70,54
1657312736422,COGS 101A,A01,083621,Davis; Joshua Daniel,9,0,68,59
1657312742445,COGS 101B,A01,091572,Allen; Michael Gordon,11,0,65,54
1657312748468,COGS 101C,A01,083625,Delgado; Tania,17,0,35,18
1657312754493,COGS 107A,A01,083627,Boyle; Mary E. T.,13,0,60,47
1657312760516,COGS 118A,A01,083075,Gupta; Anjum,17,0,76,59
1657312766537,CSE 3,A50,083646,Miranda; Gregory Joseph,24,0,50,26
1657312772569,CSE 8A,A50,083650,Miranda; Gregory Joseph,17,1,56,39
1657312778596,CSE 11,A01,083080,Cao; Yingjun,6,15,40,34
1657312784622,CSE 12,A01,083652,Krause-Levy; Sophia Louisa,27,1,120,93
1657312790649,CSE 15L,A01,083654,Morris; Justin Loren,9,0,50,41
1657312790649,CSE 15L,A02,083655,Morris; Justin Loren,9,0,50,41
1657312796673,CSE 20,A01,083657,Tran; Khoa Dang,38,0,80,42
1657312802695,CSE 21,A01,095574,Bach; Quang Tran,22,0,48,26
1657312808744,CSE 30,A01,083084,Eldon; John,4,0,80,76
1657312808744,CSE 30,B01,095061,Bhaskar; Nishant,9,0,50,41
1657312814766,CSE 100,A01,083659,Cao; Yingjun,4,4,70,66
1657312820796,CSE 134B,A01,083661,Powell; Thomas Allan,21,0,100,79
1657312826826,CSE 140,A01,083663,Gungor; Onat,14,0,85,71
1657312832849,CSE 140L,A01,083088,Eldon; John,21,0,100,79
1657312838884,CSE 175,A01,083665,Kumar; Rakesh,3,0,25,22
1657312844907,CSE 190,A00,092507,Dubnov; Shlomo,7,0,20,13
1657312850937,ECE 45,A01,083139,Congero; Spencer William,6,0,75,69
1657312856961,ECE 65,A50,083695,Saad; Andrew S,12,0,30,18
1657312856961,ECE 65,A51,095125,Saad; Andrew S,25,0,26,1
1657312862985,ECE 109,A01,091882,Touri; Behrouz,19,0,70,51
1657312869022,ECE 180,A00,083140,Abi Samra; Nicholas Camill,1,0,30,29
1657312869022,ECE 180,B00,083141,Abi Samra; Nicholas Camill,0,0,30,30
1657312875047,MATH 10A,A01,083735,Patchell; Gregory David,2,0,30,28
1657312875047,MATH 10A,A02,083736,Patchell; Gregory David,20,0,30,10
1657312875047,MATH 10A,A03,083737,Patchell; Gregory David,16,0,30,14
1657312881070,MATH 10B,A01,083207,Lim; Seonhee,7,0,34,27
1657312881070,MATH 10B,A02,083208,Lim; Seonhee,9,0,35,26
1657312881070,MATH 10B,A03,093472,Lim; Seonhee,7,0,34,27
1657312881070,MATH 10B,B01,083739,Sinha; Shubham,11,0,30,19
1657312887098,MATH 18,A01,083743,Cinel; Cameron Alexander,6,0,30,24
1657312887098,MATH 18,A02,083744,Cinel; Cameron Alexander,17,0,30,13
1657312887098,MATH 18,A03,083745,Cinel; Cameron Alexander,8,0,30,22
1657312887098,MATH 18,B01,083748,Rideout; David Porter,4,0,37,33
1657312887098,MATH 18,B02,083749,Rideout; David Porter,5,0,36,31
1657312887098,MATH 18,B03,083750,Rideout; David Porter,3,0,37,34
1657312887098,MATH 18,B04,083751,Rideout; David Porter,6,0,36,30
1657312887098,MATH 18,B05,093473,Rideout; David Porter,5,0,36,31
1657312887098,MATH 18,B06,093474,Rideout; David Porter,5,0,36,31
1657312893123,MATH 20A,A01,083754,Zheng; Zequn,14,0,40,26
1657312899152,MATH 20B,A01,083756,Briones; Jor-el Thomas Caparas,4,0,36,32
1657312899152,MATH 20B,A02,083757,Briones; Jor-el Thomas Caparas,1,0,36,35
1657312899152,MATH 20B,A03,093475,Briones; Jor-el Thomas Caparas,2,0,36,34
1657312905173,MATH 20C,A01,083760,Briones; Jor-el Thomas Caparas,1,0,35,34
1657312905173,MATH 20C,A02,083761,Briones; Jor-el Thomas Caparas,8,0,35,27
1657312905173,MATH 20C,A03,093476,Briones; Jor-el Thomas Caparas,0,1,36,36
1657312905173,MATH 20C,B01,083762,Bach; Quang Tran,1,0,30,29
1657312911213,MATH 20D,A01,083765,Tran; Brian Kha,5,0,30,25
1657312911213,MATH 20D,A02,083766,Tran; Brian Kha,5,0,30,25
1657312911213,MATH 20D,A03,083767,Tran; Brian Kha,4,0,30,26
1657312917243,MATH 20E,A01,083771,Ganguly; Soumya,7,0,32,25
1657312917243,MATH 20E,A02,083772,Ganguly; Soumya,6,0,32,26
1657312917243,MATH 20E,B01,083773,Ciotti; Benjamin,19,0,35,16
1657312917243,MATH 20E,B02,083774,Ciotti; Benjamin,17,0,35,18
1657312923359,MATH 103A,A01,083777,Greenfeld; Be'Eri,3,0,36,33
1657312923359,MATH 103A,A02,083778,Greenfeld; Be'Eri,5,0,36,31
1657312923359,MATH 103A,A03,093561,Greenfeld; Be'Eri,4,0,36,32
1657312923359,MATH 103A,B01,083779,Greenfeld; Be'Eri,6,0,36,30
1657312923359,MATH 103A,B02,083780,Greenfeld; Be'Eri,4,0,36,32
1657312923359,MATH 103A,B03,093562,Greenfeld; Be'Eri,3,0,36,33
1657312929398,MATH 105,A01,085443,Carter; Anne Toulson,15,0,35,20
1657312929398,MATH 105,A02,093477,Carter; Anne Toulson,20,0,35,15
1657312935442,MATH 109,A01,083213,Ganzberger; Geoffrey Michael,2,0,34,32
1657312935442,MATH 109,A02,083214,Ganzberger; Geoffrey Michael,4,0,34,30
1657312935442,MATH 109,A03,093478,Ganzberger; Geoffrey Michael,2,0,34,32
1657312935442,MATH 109,B01,083215,Ganzberger; Geoffrey Michael,1,0,32,31
1657312935442,MATH 109,B02,083216,Ganzberger; Geoffrey Michael,1,0,32,31
1657312935442,MATH 109,B03,093479,Ganzberger; Geoffrey Michael,8,0,32,24
1657312941480,MATH 142A,A01,083219,Chow; Bennett,7,0,32,25
1657312941480,MATH 142A,A02,083220,Chow; Bennett,10,0,32,22
1657312941480,MATH 142A,A03,093480,Chow; Bennett,7,0,32,25
1657312941480,MATH 142A,B03,093481,Chow; Bennett,8,0,32,24
1657312941480,MATH 142A,B04,093558,Chow; Bennett,13,0,32,19
1657312941480,MATH 142A,B05,093559,Chow; Bennett,6,0,32,26
1657312947514,MATH 193A,A01,083224,Rotar; Vladimir,7,0,34,27
1657312947514,MATH 193A,A02,083225,Rotar; Vladimir,7,0,34,27
1657312947514,MATH 193A,A03,083781,Rotar; Vladimir,3,0,34,31
1657312947514,MATH 193A,A04,083782,Rotar; Vladimir,8,0,34,26
1657312947514,MATH 193A,A05,093482,Rotar; Vladimir,8,0,34,26
1657312953538,MATH 197,001,091859,McAuley; Julian John,9999,0,9999,0
1657312953538,MATH 197,002,095566,Kedlaya; Kiran S.,9997,0,9999,2
1657312953538,MATH 197,003,095567,Xiao; Ming,9999,0,9999,0
1657312953538,MATH 197,004,095571,Perols; Johan Lars,9998,0,9999,1
1657312960599,COGS 9,A01,083615,Shannon; Kyle Michael,8,0,75,67
1657312966626,COGS 11,A01,083617,Boyle; Mary E. T.,22,0,48,26
1657312972652,COGS 13,A01,083071,Bastos; Amalia Pinkusfeld,10,0,71,61
1657312978676,COGS 14A,A01,092681,Semenuks; Arturs,2,1,100,98
1657312984700,COGS 14B,A01,083073,Cheng; Tzu-Han,6,0,63,57
1657312990731,COGS 17,A01,092677,Semenuks; Arturs,5,0,81,76
1657312996756,COGS 100,A01,083619,Allen; Michael Gordon,16,0,70,54
1657313002780,COGS 101A,A01,083621,Davis; Joshua Daniel,9,0,68,59
1657313008812,COGS 101B,A01,091572,Allen; Michael Gordon,11,0,65,54
1657313014838,COGS 101C,A01,083625,Delgado; Tania,17,0,35,18
1657313020869,COGS 107A,A01,083627,Boyle; Mary E. T.,13,0,60,47
1657313026903,COGS 118A,A01,083075,Gupta; Anjum,17,0,76,59
1657313032930,CSE 3,A50,083646,Miranda; Gregory Joseph,24,0,50,26
1657313038959,CSE 8A,A50,083650,Miranda; Gregory Joseph,17,1,56,39
1657313044984,CSE 11,A01,083080,Cao; Yingjun,6,15,40,34
1657313051015,CSE 12,A01,083652,Krause-Levy; Sophia Louisa,27,1,120,93
1657313057037,CSE 15L,A01,083654,Morris; Justin Loren,9,0,50,41
1657313057037,CSE 15L,A02,083655,Morris; Justin Loren,9,0,50,41
1657313063060,CSE 20,A01,083657,Tran; Khoa Dang,38,0,80,42
1657313069093,CSE 21,A01,095574,Bach; Quang Tran,22,0,48,26
1657313075120,CSE 30,A01,083084,Eldon; John,4,0,80,76
1657313075120,CSE 30,B01,095061,Bhaskar; Nishant,9,0,50,41
1657313081142,CSE 100,A01,083659,Cao; Yingjun,4,4,70,66
1657313087167,CSE 134B,A01,083661,Powell; Thomas Allan,21,0,100,79
1657313093197,CSE 140,A01,083663,Gungor; Onat,14,0,85,71
1657313099228,CSE 140L,A01,083088,Eldon; John,21,0,100,79
1657313105257,CSE 175,A01,083665,Kumar; Rakesh,3,0,25,22
1657313111279,CSE 190,A00,092507,Dubnov; Shlomo,7,0,20,13
1657313117305,ECE 45,A01,083139,Congero; Spencer William,6,0,75,69
1657313123332,ECE 65,A50,083695,Saad; Andrew S,12,0,30,18
1657313123332,ECE 65,A51,095125,Saad; Andrew S,25,0,26,1
1657313129372,ECE 109,A01,091882,Touri; Behrouz,19,0,70,51
1657313135397,ECE 180,A00,083140,Abi Samra; Nicholas Camill,1,0,30,29
1657313135397,ECE 180,B00,083141,Abi Samra; Nicholas Camill,0,0,30,30
1657313141428,MATH 10A,A01,083735,Patchell; Gregory David,2,0,30,28
1657313141428,MATH 10A,A02,083736,Patchell; Gregory David,20,0,30,10
1657313141428,MATH 10A,A03,083737,Patchell; Gregory David,16,0,30,14
1657313147451,MATH 10B,A01,083207,Lim; Seonhee,7,0,34,27
1657313147451,MATH 10B,A02,083208,Lim; Seonhee,9,0,35,26
1657313147451,MATH 10B,A03,093472,Lim; Seonhee,7,0,34,27
1657313147451,MATH 10B,B01,083739,Sinha; Shubham,11,0,30,19
1657313153485,MATH 18,A01,083743,Cinel; Cameron Alexander,6,0,30,24
1657313153485,MATH 18,A02,083744,Cinel; Cameron Alexander,17,0,30,13
1657313153485,MATH 18,A03,083745,Cinel; Cameron Alexander,8,0,30,22
1657313153485,MATH 18,B01,083748,Rideout; David Porter,4,0,37,33
1657313153485,MATH 18,B02,083749,Rideout; David Porter,5,0,36,31
1657313153485,MATH 18,B03,083750,Rideout; David Porter,3,0,37,34
1657313153485,MATH 18,B04,083751,Rideout; David Porter,6,0,36,30
1657313153485,MATH 18,B05,093473,Rideout; David Porter,5,0,36,31
1657313153485,MATH 18,B06,093474,Rideout; David Porter,5,0,36,31
1657313159514,MATH 20A,A01,083754,Zheng; Zequn,14,0,40,26
1657313165544,MATH 20B,A01,083756,Briones; Jor-el Thomas Caparas,4,0,36,32
1657313165544,MATH 20B,A02,083757,Briones; Jor-el Thomas Caparas,1,0,36,35
1657313165544,MATH 20B,A03,093475,Briones; Jor-el Thomas Caparas,2,0,36,34
1657313171570,MATH 20C,A01,083760,Briones; Jor-el Thomas Caparas,1,0,35,34
1657313171570,MATH 20C,A02,083761,Briones; Jor-el Thomas Caparas,8,0,35,27
1657313171570,MATH 20C,A03,093476,Briones; Jor-el Thomas Caparas,0,1,36,36
1657313171570,MATH 20C,B01,083762,Bach; Quang Tran,1,0,30,29
1657313177600,MATH 20D,A01,083765,Tran; Brian Kha,5,0,30,25
1657313177600,MATH 20D,A02,083766,Tran; Brian Kha,5,0,30,25
1657313177600,MATH 20D,A03,083767,Tran; Brian Kha,4,0,30,26
1657313183634,MATH 20E,A01,083771,Ganguly; Soumya,7,0,32,25
1657313183634,MATH 20E,A02,083772,Ganguly; Soumya,6,0,32,26
1657313183634,MATH 20E,B01,083773,Ciotti; Benjamin,19,0,35,16
1657313183634,MATH 20E,B02,083774,Ciotti; Benjamin,17,0,35,18
1657313189665,MATH 103A,A01,083777,Greenfeld; Be'Eri,3,0,36,33
1657313189665,MATH 103A,A02,083778,Greenfeld; Be'Eri,5,0,36,31
1657313189665,MATH 103A,A03,093561,Greenfeld; Be'Eri,4,0,36,32
1657313189665,MATH 103A,B01,083779,Greenfeld; Be'Eri,6,0,36,30
1657313189665,MATH 103A,B02,083780,Greenfeld; Be'Eri,4,0,36,32
1657313189665,MATH 103A,B03,093562,Greenfeld; Be'Eri,3,0,36,33
1657313195689,MATH 105,A01,085443,Carter; Anne Toulson,15,0,35,20
1657313195689,MATH 105,A02,093477,Carter; Anne Toulson,20,0,35,15
1657313201716,MATH 109,A01,083213,Ganzberger; Geoffrey Michael,2,0,34,32
1657313201716,MATH 109,A02,083214,Ganzberger; Geoffrey Michael,4,0,34,30
1657313201716,MATH 109,A03,093478,Ganzberger; Geoffrey Michael,2,0,34,32
1657313201716,MATH 109,B01,083215,Ganzberger; Geoffrey Michael,1,0,32,31
1657313201716,MATH 109,B02,083216,Ganzberger; Geoffrey Michael,1,0,32,31
1657313201716,MATH 109,B03,093479,Ganzberger; Geoffrey Michael,8,0,32,24
1657313207749,MATH 142A,A01,083219,Chow; Bennett,7,0,32,25
1657313207749,MATH 142A,A02,083220,Chow; Bennett,10,0,32,22
1657313207749,MATH 142A,A03,093480,Chow; Bennett,7,0,32,25
1657313207749,MATH 142A,B03,093481,Chow; Bennett,8,0,32,24
1657313207749,MATH 142A,B04,093558,Chow; Bennett,13,0,32,19
1657313207749,MATH 142A,B05,093559,Chow; Bennett,6,0,32,26
1657313213778,MATH 193A,A01,083224,Rotar; Vladimir,7,0,34,27
1657313213778,MATH 193A,A02,083225,Rotar; Vladimir,7,0,34,27
1657313213778,MATH 193A,A03,083781,Rotar; Vladimir,3,0,34,31
1657313213778,MATH 193A,A04,083782,Rotar; Vladimir,8,0,34,26
1657313213778,MATH 193A,A05,093482,Rotar; Vladimir,8,0,34,26
1657313219804,MATH 197,001,091859,McAuley; Julian John,9999,0,9999,0
1657313219804,MATH 197,002,095566,Kedlaya; Kiran S.,9997,0,9999,2
1657313219804,MATH 197,003,095567,Xiao; Ming,9999,0,9999,0
1657313219804,MATH 197,004,095571,Perols; Johan Lars,9998,0,9999,1
1657313226865,COGS 9,A01,083615,Shannon; Kyle Michael,8,0,75,67
1657313232902,COGS 11,A01,083617,Boyle; Mary E. T.,22,0,48,26
1657313238929,COGS 13,A01,083071,Bastos; Amalia Pinkusfeld,10,0,71,61
1657313244953,COGS 14A,A01,092681,Semenuks; Arturs,2,1,100,98
1657313250976,COGS 14B,A01,083073,Cheng; Tzu-Han,6,0,63,57
1657313257010,COGS 17,A01,092677,Semenuks; Arturs,5,0,81,76
1657313263042,COGS 100,A01,083619,Allen; Michael Gordon,16,0,70,54
1657313269067,COGS 101A,A01,083621,Davis; Joshua Daniel,9,0,68,59
1657313275103,COGS 101B,A01,091572,Allen; Michael Gordon,11,0,65,54
1657313281128,COGS 101C,A01,083625,Delgado; Tania,17,0,35,18
1657313287152,COGS 107A,A01,083627,Boyle; Mary E. T.,13,0,60,47
1657313293174,COGS 118A,A01,083075,Gupta; Anjum,17,0,76,59
1657313299202,CSE 3,A50,083646,Miranda; Gregory Joseph,24,0,50,26
1657313305230,CSE 8A,A50,083650,Miranda; Gregory Joseph,17,1,56,39
1657313311262,CSE 11,A01,083080,Cao; Yingjun,6,15,40,34
1657313317284,CSE 12,A01,083652,Krause-Levy; Sophia Louisa,27,1,120,93
1657313323307,CSE 15L,A01,083654,Morris; Justin Loren,9,0,50,41
1657313323307,CSE 15L,A02,083655,Morris; Justin Loren,9,0,50,41
1657313329339,CSE 20,A01,083657,Tran; Khoa Dang,38,0,80,42
1657313335362,CSE 21,A01,095574,Bach; Quang Tran,22,0,48,26
1657313341394,CSE 30,A01,083084,Eldon; John,4,0,80,76
1657313341394,CSE 30,B01,095061,Bhaskar; Nishant,9,0,50,41
1657313347425,CSE 100,A01,083659,Cao; Yingjun,4,4,70,66
1657313353447,CSE 134B,A01,083661,Powell; Thomas Allan,21,0,100,79
1657313359472,CSE 140,A01,083663,Gungor; Onat,14,0,85,71
1657313365494,CSE 140L,A01,083088,Eldon; John,21,0,100,79
1657313371517,CSE 175,A01,083665,Kumar; Rakesh,3,0,25,22
1657313377541,CSE 190,A00,092507,Dubnov; Shlomo,7,0,20,13
1657313383565,ECE 45,A01,083139,Congero; Spencer William,6,0,75,69
1657313389589,ECE 65,A50,083695,Saad; Andrew S,12,0,30,18
1657313389589,ECE 65,A51,095125,Saad; Andrew S,25,0,26,1
1657313395616,ECE 109,A01,091882,Touri; Behrouz,19,0,70,51
1657313401639,ECE 180,A00,083140,Abi Samra; Nicholas Camill,1,0,30,29
1657313401639,ECE 180,B00,083141,Abi Samra; Nicholas Camill,0,0,30,30
1657313407661,MATH 10A,A01,083735,Patchell; Gregory David,2,0,30,28
1657313407661,MATH 10A,A02,083736,Patchell; Gregory David,20,0,30,10
1657313407661,MATH 10A,A03,083737,Patchell; Gregory David,16,0,30,14
1657313413690,MATH 10B,A01,083207,Lim; Seonhee,7,0,34,27
1657313413690,MATH 10B,A02,083208,Lim; Seonhee,9,0,35,26
1657313413690,MATH 10B,A03,093472,Lim; Seonhee,7,0,34,27
1657313413690,MATH 10B,B01,083739,Sinha; Shubham,11,0,30,19
1657313419714,MATH 18,A01,083743,Cinel; Cameron Alexander,6,0,30,24
1657313419714,MATH 18,A02,083744,Cinel; Cameron Alexander,17,0,30,13
1657313419714,MATH 18,A03,083745,Cinel; Cameron Alexander,9,0,30,21
1657313419714,MATH 18,B01,083748,Rideout; David Porter,4,0,37,33
1657313419714,MATH 18,B02,083749,Rideout; David Porter,5,0,36,31
1657313419714,MATH 18,B03,083750,Rideout; David Porter,3,0,37,34
1657313419714,MATH 18,B04,083751,Rideout; David Porter,6,0,36,30
1657313419714,MATH 18,B05,093473,Rideout; David Porter,5,0,36,31
1657313419714,MATH 18,B06,093474,Rideout; David Porter,5,0,36,31
1657313425737,MATH 20A,A01,083754,Zheng; Zequn,14,0,40,26
1657313431765,MATH 20B,A01,083756,Briones; Jor-el Thomas Caparas,4,0,36,32
1657313431765,MATH 20B,A02,083757,Briones; Jor-el Thomas Caparas,1,0,36,35
1657313431765,MATH 20B,A03,093475,Briones; Jor-el Thomas Caparas,2,0,36,34
1657313437794,MATH 20C,A01,083760,Briones; Jor-el Thomas Caparas,1,0,35,34
1657313437794,MATH 20C,A02,083761,Briones; Jor-el Thomas Caparas,8,0,35,27
1657313437794,MATH 20C,A03,093476,Briones; Jor-el Thomas Caparas,0,1,36,36
1657313437794,MATH 20C,B01,083762,Bach; Quang Tran,1,0,30,29
1657313443825,MATH 20D,A01,083765,Tran; Brian Kha,5,0,30,25
1657313443825,MATH 20D,A02,083766,Tran; Brian Kha,5,0,30,25
1657313443825,MATH 20D,A03,083767,Tran; Brian Kha,4,0,30,26
1657313449851,MATH 20E,A01,083771,Ganguly; Soumya,7,0,32,25
1657313449851,MATH 20E,A02,083772,Ganguly; Soumya,6,0,32,26
1657313449851,MATH 20E,B01,083773,Ciotti; Benjamin,19,0,35,16
1657313449851,MATH 20E,B02,083774,Ciotti; Benjamin,17,0,35,18
1657313455874,MATH 103A,A01,083777,Greenfeld; Be'Eri,3,0,36,33
1657313455874,MATH 103A,A02,083778,Greenfeld; Be'Eri,5,0,36,31
1657313455874,MATH 103A,A03,093561,Greenfeld; Be'Eri,4,0,36,32
1657313455874,MATH 103A,B01,083779,Greenfeld; Be'Eri,6,0,36,30
1657313455874,MATH 103A,B02,083780,Greenfeld; Be'Eri,4,0,36,32
1657313455874,MATH 103A,B03,093562,Greenfeld; Be'Eri,3,0,36,33
1657313461898,MATH 105,A01,085443,Carter; Anne Toulson,15,0,35,20
1657313461898,MATH 105,A02,093477,Carter; Anne Toulson,20,0,35,15
1657313467924,MATH 109,A01,083213,Ganzberger; Geoffrey Michael,2,0,34,32
1657313467924,MATH 109,A02,083214,Ganzberger; Geoffrey Michael,4,0,34,30
1657313467924,MATH 109,A03,093478,Ganzberger; Geoffrey Michael,2,0,34,32
1657313467924,MATH 109,B01,083215,Ganzberger; Geoffrey Michael,1,0,32,31
1657313467924,MATH 109,B02,083216,Ganzberger; Geoffrey Michael,1,0,32,31
1657313467924,MATH 109,B03,093479,Ganzberger; Geoffrey Michael,8,0,32,24
1657313473960,MATH 142A,A01,083219,Chow; Bennett,7,0,32,25
1657313473960,MATH 142A,A02,083220,Chow; Bennett,10,0,32,22
1657313473960,MATH 142A,A03,093480,Chow; Bennett,7,0,32,25
1657313473960,MATH 142A,B03,093481,Chow; Bennett,8,0,32,24
1657313473960,MATH 142A,B04,093558,Chow; Bennett,13,0,32,19
1657313473960,MATH 142A,B05,093559,Chow; Bennett,6,0,32,26
1657313479988,MATH 193A,A01,083224,Rotar; Vladimir,7,0,34,27
1657313479988,MATH 193A,A02,083225,Rotar; Vladimir,7,0,34,27
1657313479988,MATH 193A,A03,083781,Rotar; Vladimir,3,0,34,31
1657313479988,MATH 193A,A04,083782,Rotar; Vladimir,8,0,34,26
1657313479988,MATH 193A,A05,093482,Rotar; Vladimir,8,0,34,26
1657313486014,MATH 197,001,091859,McAuley; Julian John,9999,0,9999,0
1657313486014,MATH 197,002,095566,Kedlaya; Kiran S.,9997,0,9999,2
1657313486014,MATH 197,003,095567,Xiao; Ming,9999,0,9999,0
1657313486014,MATH 197,004,095571,Perols; Johan Lars,9998,0,9999,1
1657313493094,COGS 9,A01,083615,Shannon; Kyle Michael,8,0,75,67
1657313499124,COGS 11,A01,083617,Boyle; Mary E. T.,22,0,48,26
1657313505153,COGS 13,A01,083071,Bastos; Amalia Pinkusfeld,10,0,71,61
1657313511175,COGS 14A,A01,092681,Semenuks; Arturs,2,1,100,98
1657313517296,COGS 14B,A01,083073,Cheng; Tzu-Han,6,0,63,57
1657313523323,COGS 17,A01,092677,Semenuks; Arturs,5,0,81,76
1657313529355,COGS 100,A01,083619,Allen; Michael Gordon,16,0,70,54
1657313535385,COGS 101A,A01,083621,Davis; Joshua Daniel,9,0,68,59
1657313541415,COGS 101B,A01,091572,Allen; Michael Gordon,11,0,65,54
1657313547440,COGS 101C,A01,083625,Delgado; Tania,17,0,35,18
1657313553467,COGS 107A,A01,083627,Boyle; Mary E. T.,13,0,60,47
1657313559490,COGS 118A,A01,083075,Gupta; Anjum,17,0,76,59
1657313565536,CSE 3,A50,083646,Miranda; Gregory Joseph,24,0,50,26
1657313571564,CSE 8A,A50,083650,Miranda; Gregory Joseph,17,1,56,39
1657313577592,CSE 11,A01,083080,Cao; Yingjun,6,15,40,34
1657313583617,CSE 12,A01,083652,Krause-Levy; Sophia Louisa,27,1,120,93
1657313589656,CSE 15L,A01,083654,Morris; Justin Loren,9,0,50,41
1657313589656,CSE 15L,A02,083655,Morris; Justin Loren,9,0,50,41
1657313595682,CSE 20,A01,083657,Tran; Khoa Dang,38,0,80,42
1657313601704,CSE 21,A01,095574,Bach; Quang Tran,22,0,48,26
1657313607728,CSE 30,A01,083084,Eldon; John,4,0,80,76
1657313607728,CSE 30,B01,095061,Bhaskar; Nishant,9,0,50,41
1657313613757,CSE 100,A01,083659,Cao; Yingjun,4,4,70,66
1657313619780,CSE 134B,A01,083661,Powell; Thomas Allan,21,0,100,79
1657313625803,CSE 140,A01,083663,Gungor; Onat,14,0,85,71
1657313631830,CSE 140L,A01,083088,Eldon; John,21,0,100,79
1657313637855,CSE 175,A01,083665,Kumar; Rakesh,3,0,25,22
1657313643878,CSE 190,A00,092507,Dubnov; Shlomo,7,0,20,13
1657313649912,ECE 45,A01,083139,Congero; Spencer William,6,0,75,69
1657313655948,ECE 65,A50,083695,Saad; Andrew S,12,0,30,18
1657313655948,ECE 65,A51,095125,Saad; Andrew S,25,0,26,1
1657313661974,ECE 109,A01,091882,Touri; Behrouz,19,0,70,51
1657313668003,ECE 180,A00,083140,Abi Samra; Nicholas Camill,1,0,30,29
1657313668003,ECE 180,B00,083141,Abi Samra; Nicholas Camill,0,0,30,30
1657313674031,MATH 10A,A01,083735,Patchell; Gregory David,2,0,30,28
1657313674031,MATH 10A,A02,083736,Patchell; Gregory David,20,0,30,10
1657313674031,MATH 10A,A03,083737,Patchell; Gregory David,16,0,30,14
1657313680054,MATH 10B,A01,083207,Lim; Seonhee,7,0,34,27
1657313680054,MATH 10B,A02,083208,Lim; Seonhee,9,0,35,26
1657313680054,MATH 10B,A03,093472,Lim; Seonhee,7,0,34,27
1657313680054,MATH 10B,B01,083739,Sinha; Shubham,11,0,30,19
1657313686084,MATH 18,A01,083743,Cinel; Cameron Alexander,6,0,30,24
1657313686084,MATH 18,A02,083744,Cinel; Cameron Alexander,17,0,30,13
1657313686084,MATH 18,A03,083745,Cinel; Cameron Alexander,9,0,30,21
1657313686084,MATH 18,B01,083748,Rideout; David Porter,4,0,37,33
1657313686084,MATH 18,B02,083749,Rideout; David Porter,5,0,36,31
1657313686084,MATH 18,B03,083750,Rideout; David Porter,3,0,37,34
1657313686084,MATH 18,B04,083751,Rideout; David Porter,6,0,36,30
1657313686084,MATH 18,B05,093473,Rideout; David Porter,5,0,36,31
1657313686084,MATH 18,B06,093474,Rideout; David Porter,5,0,36,31
1657313692107,MATH 20A,A01,083754,Zheng; Zequn,14,0,40,26
1657313698130,MATH 20B,A01,083756,Briones; Jor-el Thomas Caparas,4,0,36,32
1657313698130,MATH 20B,A02,083757,Briones; Jor-el Thomas Caparas,1,0,36,35
1657313698130,MATH 20B,A03,093475,Briones; Jor-el Thomas Caparas,2,0,36,34
1657313704171,MATH 20C,A01,083760,Briones; Jor-el Thomas Caparas,1,0,35,34
1657313704171,MATH 20C,A02,083761,Briones; Jor-el Thomas Caparas,8,0,35,27
1657313704171,MATH 20C,A03,093476,Briones; Jor-el Thomas Caparas,0,1,36,36
1657313704171,MATH 20C,B01,083762,Bach; Quang Tran,1,0,30,29
1657313710195,MATH 20D,A01,083765,Tran; Brian Kha,5,0,30,25
1657313710195,MATH 20D,A02,083766,Tran; Brian Kha,5,0,30,25
1657313710195,MATH 20D,A03,083767,Tran; Brian Kha,4,0,30,26
1657313716219,MATH 20E,A01,083771,Ganguly; Soumya,7,0,32,25
1657313716219,MATH 20E,A02,083772,Ganguly; Soumya,6,0,32,26
1657313716219,MATH 20E,B01,083773,Ciotti; Benjamin,19,0,35,16
1657313716219,MATH 20E,B02,083774,Ciotti; Benjamin,17,0,35,18
1657313722242,MATH 103A,A01,083777,Greenfeld; Be'Eri,3,0,36,33
1657313722242,MATH 103A,A02,083778,Greenfeld; Be'Eri,5,0,36,31
1657313722242,MATH 103A,A03,093561,Greenfeld; Be'Eri,4,0,36,32
1657313722242,MATH 103A,B01,083779,Greenfeld; Be'Eri,6,0,36,30
1657313722242,MATH 103A,B02,083780,Greenfeld; Be'Eri,4,0,36,32
1657313722242,MATH 103A,B03,093562,Greenfeld; Be'Eri,3,0,36,33
1657313728281,MATH 105,A01,085443,Carter; Anne Toulson,15,0,35,20
1657313728281,MATH 105,A02,093477,Carter; Anne Toulson,20,0,35,15
1657313734305,MATH 109,A01,083213,Ganzberger; Geoffrey Michael,2,0,34,32
1657313734305,MATH 109,A02,083214,Ganzberger; Geoffrey Michael,4,0,34,30
1657313734305,MATH 109,A03,093478,Ganzberger; Geoffrey Michael,2,0,34,32
1657313734305,MATH 109,B01,083215,Ganzberger; Geoffrey Michael,1,0,32,31
1657313734305,MATH 109,B02,083216,Ganzberger; Geoffrey Michael,1,0,32,31
1657313734305,MATH 109,B03,093479,Ganzberger; Geoffrey Michael,8,0,32,24
1657313740328,MATH 142A,A01,083219,Chow; Bennett,7,0,32,25
1657313740328,MATH 142A,A02,083220,Chow; Bennett,10,0,32,22
1657313740328,MATH 142A,A03,093480,Chow; Bennett,7,0,32,25
1657313740328,MATH 142A,B03,093481,Chow; Bennett,8,0,32,24
1657313740328,MATH 142A,B04,093558,Chow; Bennett,13,0,32,19
1657313740328,MATH 142A,B05,093559,Chow; Bennett,6,0,32,26
1657313746368,MATH 193A,A01,083224,Rotar; Vladimir,7,0,34,27
1657313746368,MATH 193A,A02,083225,Rotar; Vladimir,7,0,34,27
1657313746368,MATH 193A,A03,083781,Rotar; Vladimir,3,0,34,31
1657313746368,MATH 193A,A04,083782,Rotar; Vladimir,8,0,34,26
1657313746368,MATH 193A,A05,093482,Rotar; Vladimir,8,0,34,26
1657313752395,MATH 197,001,091859,McAuley; Julian John,9999,0,9999,0
1657313752395,MATH 197,002,095566,Kedlaya; Kiran S.,9997,0,9999,2
1657313752395,MATH 197,003,095567,Xiao; Ming,9999,0,9999,0
1657313752395,MATH 197,004,095571,Perols; Johan Lars,9998,0,9999,1
1657313759457,COGS 9,A01,083615,Shannon; Kyle Michael,8,0,75,67
1657313765497,COGS 11,A01,083617,Boyle; Mary E. T.,22,0,48,26
1657313771520,COGS 13,A01,083071,Bastos; Amalia Pinkusfeld,10,0,71,61
1657313777548,COGS 14A,A01,092681,Semenuks; Arturs,2,1,100,98
1657313783576,COGS 14B,A01,083073,Cheng; Tzu-Han,6,0,63,57
1657313789599,COGS 17,A01,092677,Semenuks; Arturs,5,0,81,76
1657313795627,COGS 100,A01,083619,Allen; Michael Gordon,16,0,70,54
1657313801649,COGS 101A,A01,083621,Davis; Joshua Daniel,9,0,68,59
1657313807672,COGS 101B,A01,091572,Allen; Michael Gordon,11,0,65,54
1657313813703,COGS 101C,A01,083625,Delgado; Tania,17,0,35,18
1657313819728,COGS 107A,A01,083627,Boyle; Mary E. T.,13,0,60,47
1657313825754,COGS 118A,A01,083075,Gupta; Anjum,17,0,76,59
1657313831788,CSE 3,A50,083646,Miranda; Gregory Joseph,24,0,50,26
1657313837810,CSE 8A,A50,083650,Miranda; Gregory Joseph,17,1,56,39
1657313843910,CSE 11,A01,083080,Cao; Yingjun,6,15,40,34
1657313849936,CSE 12,A01,083652,Krause-Levy; Sophia Louisa,27,1,120,93
1657313855974,CSE 15L,A01,083654,Morris; Justin Loren,9,0,50,41
1657313855974,CSE 15L,A02,083655,Morris; Justin Loren,9,0,50,41
1657313861997,CSE 20,A01,083657,Tran; Khoa Dang,38,0,80,42
1657313868021,CSE 21,A01,095574,Bach; Quang Tran,22,0,48,26
1657313874054,CSE 30,A01,083084,Eldon; John,4,0,80,76
1657313874054,CSE 30,B01,095061,Bhaskar; Nishant,9,0,50,41
1657313880095,CSE 100,A01,083659,Cao; Yingjun,4,4,70,66
1657313886129,CSE 134B,A01,083661,Powell; Thomas Allan,21,0,100,79
1657313892156,CSE 140,A01,083663,Gungor; Onat,14,0,85,71
1657313898186,CSE 140L,A01,083088,Eldon; John,21,0,100,79
1657313904210,CSE 175,A01,083665,Kumar; Rakesh,3,0,25,22
1657313910239,CSE 190,A00,092507,Dubnov; Shlomo,7,0,20,13
1657313916266,ECE 45,A01,083139,Congero; Spencer William,6,0,75,69
1657313922298,ECE 65,A50,083695,Saad; Andrew S,12,0,30,18
1657313922298,ECE 65,A51,095125,Saad; Andrew S,25,0,26,1
1657313928321,ECE 109,A01,091882,Touri; Behrouz,19,0,70,51
1657313934354,ECE 180,A00,083140,Abi Samra; Nicholas Camill,1,0,30,29
1657313934354,ECE 180,B00,083141,Abi Samra; Nicholas Camill,0,0,30,30
1657313940387,MATH 10A,A01,083735,Patchell; Gregory David,2,0,30,28
1657313940387,MATH 10A,A02,083736,Patchell; Gregory David,20,0,30,10
1657313940387,MATH 10A,A03,083737,Patchell; Gregory David,16,0,30,14
1657313946410,MATH 10B,A01,083207,Lim; Seonhee,7,0,34,27
1657313946410,MATH 10B,A02,083208,Lim; Seonhee,9,0,35,26
1657313946410,MATH 10B,A03,093472,Lim; Seonhee,7,0,34,27
1657313946410,MATH 10B,B01,083739,Sinha; Shubham,11,0,30,19
1657313952443,MATH 18,A01,083743,Cinel; Cameron Alexander,6,0,30,24
1657313952443,MATH 18,A02,083744,Cinel; Cameron Alexander,17,0,30,13
1657313952443,MATH 18,A03,083745,Cinel; Cameron Alexander,9,0,30,21
1657313952443,MATH 18,B01,083748,Rideout; David Porter,4,0,37,33
1657313952443,MATH 18,B02,083749,Rideout; David Porter,5,0,36,31
1657313952443,MATH 18,B03,083750,Rideout; David Porter,3,0,37,34
1657313952443,MATH 18,B04,083751,Rideout; David Porter,6,0,36,30
1657313952443,MATH 18,B05,093473,Rideout; David Porter,5,0,36,31
1657313952443,MATH 18,B06,093474,Rideout; David Porter,5,0,36,31
1657313958467,MATH 20A,A01,083754,Zheng; Zequn,14,0,40,26
1657313964495,MATH 20B,A01,083756,Briones; Jor-el Thomas Caparas,4,0,36,32
1657313964495,MATH 20B,A02,083757,Briones; Jor-el Thomas Caparas,1,0,36,35
1657313964495,MATH 20B,A03,093475,Briones; Jor-el Thomas Caparas,2,0,36,34
1657313970521,MATH 20C,A01,083760,Briones; Jor-el Thomas Caparas,1,0,35,34
1657313970521,MATH 20C,A02,083761,Briones; Jor-el Thomas Caparas,8,0,35,27
1657313970521,MATH 20C,A03,093476,Briones; Jor-el Thomas Caparas,0,1,36,36
1657313970521,MATH 20C,B01,083762,Bach; Quang Tran,1,0,30,29
1657313976543,MATH 20D,A01,083765,Tran; Brian Kha,5,0,30,25
1657313976543,MATH 20D,A02,083766,Tran; Brian Kha,5,0,30,25
1657313976543,MATH 20D,A03,083767,Tran; Brian Kha,4,0,30,26
1657313982567,MATH 20E,A01,083771,Ganguly; Soumya,7,0,32,25
1657313982567,MATH 20E,A02,083772,Ganguly; Soumya,6,0,32,26
1657313982567,MATH 20E,B01,083773,Ciotti; Benjamin,19,0,35,16
1657313982567,MATH 20E,B02,083774,Ciotti; Benjamin,17,0,35,18
1657313988603,MATH 103A,A01,083777,Greenfeld; Be'Eri,3,0,36,33
1657313988603,MATH 103A,A02,083778,Greenfeld; Be'Eri,5,0,36,31
1657313988603,MATH 103A,A03,093561,Greenfeld; Be'Eri,4,0,36,32
1657313988603,MATH 103A,B01,083779,Greenfeld; Be'Eri,6,0,36,30
1657313988603,MATH 103A,B02,083780,Greenfeld; Be'Eri,4,0,36,32
1657313988603,MATH 103A,B03,093562,Greenfeld; Be'Eri,3,0,36,33
1657313994625,MATH 105,A01,085443,Carter; Anne Toulson,15,0,35,20
1657313994625,MATH 105,A02,093477,Carter; Anne Toulson,20,0,35,15
1657314000662,MATH 109,A01,083213,Ganzberger; Geoffrey Michael,2,0,34,32
1657314000662,MATH 109,A02,083214,Ganzberger; Geoffrey Michael,4,0,34,30
1657314000662,MATH 109,A03,093478,Ganzberger; Geoffrey Michael,2,0,34,32
1657314000662,MATH 109,B01,083215,Ganzberger; Geoffrey Michael,1,0,32,31
1657314000662,MATH 109,B02,083216,Ganzberger; Geoffrey Michael,1,0,32,31
1657314000662,MATH 109,B03,093479,Ganzberger; Geoffrey Michael,8,0,32,24
1657314006731,MATH 142A,A01,083219,Chow; Bennett,7,0,32,25
1657314006731,MATH 142A,A02,083220,Chow; Bennett,10,0,32,22
1657314006731,MATH 142A,A03,093480,Chow; Bennett,7,0,32,25
1657314006731,MATH 142A,B03,093481,Chow; Bennett,8,0,32,24
1657314006731,MATH 142A,B04,093558,Chow; Bennett,13,0,32,19
1657314006731,MATH 142A,B05,093559,Chow; Bennett,6,0,32,26
1657314012762,MATH 193A,A01,083224,Rotar; Vladimir,7,0,34,27
1657314012762,MATH 193A,A02,083225,Rotar; Vladimir,7,0,34,27
1657314012762,MATH 193A,A03,083781,Rotar; Vladimir,3,0,34,31
1657314012762,MATH 193A,A04,083782,Rotar; Vladimir,8,0,34,26
1657314012762,MATH 193A,A05,093482,Rotar; Vladimir,8,0,34,26
1657314018785,MATH 197,001,091859,McAuley; Julian John,9999,0,9999,0
1657314018785,MATH 197,002,095566,Kedlaya; Kiran S.,9997,0,9999,2
1657314018785,MATH 197,003,095567,Xiao; Ming,9999,0,9999,0
1657314018785,MATH 197,004,095571,Perols; Johan Lars,9998,0,9999,1
1657314025839,COGS 9,A01,083615,Shannon; Kyle Michael,8,0,75,67
1657314031865,COGS 11,A01,083617,Boyle; Mary E. T.,22,0,48,26
1657314037889,COGS 13,A01,083071,Bastos; Amalia Pinkusfeld,10,0,71,61
1657314043911,COGS 14A,A01,092681,Semenuks; Arturs,2,1,100,98
1657314049939,COGS 14B,A01,083073,Cheng; Tzu-Han,6,0,63,57
1657314055960,COGS 17,A01,092677,Semenuks; Arturs,5,0,81,76
1657314061984,COGS 100,A01,083619,Allen; Michael Gordon,16,0,70,54
1657314068005,COGS 101A,A01,083621,Davis; Joshua Daniel,9,0,68,59
1657314074027,COGS 101B,A01,091572,Allen; Michael Gordon,11,0,65,54
1657314080065,COGS 101C,A01,083625,Delgado; Tania,17,0,35,18
1657314086086,COGS 107A,A01,083627,Boyle; Mary E. T.,13,0,60,47
1657314092110,COGS 118A,A01,083075,Gupta; Anjum,17,0,76,59
1657314098159,CSE 3,A50,083646,Miranda; Gregory Joseph,24,0,50,26
1657314104197,CSE 8A,A50,083650,Miranda; Gregory Joseph,17,1,56,39
1657314110221,CSE 11,A01,083080,Cao; Yingjun,6,15,40,34
1657314116316,CSE 12,A01,083652,Krause-Levy; Sophia Louisa,27,1,120,93
1657314122340,CSE 15L,A01,083654,Morris; Justin Loren,9,0,50,41
1657314122340,CSE 15L,A02,083655,Morris; Justin Loren,9,0,50,41
1657314128362,CSE 20,A01,083657,Tran; Khoa Dang,38,0,80,42
1657314134386,CSE 21,A01,095574,Bach; Quang Tran,22,0,48,26
1657314140412,CSE 30,A01,083084,Eldon; John,4,0,80,76
1657314140412,CSE 30,B01,095061,Bhaskar; Nishant,9,0,50,41
1657314146437,CSE 100,A01,083659,Cao; Yingjun,4,4,70,66
1657314152466,CSE 134B,A01,083661,Powell; Thomas Allan,21,0,100,79
1657314158489,CSE 140,A01,083663,Gungor; Onat,14,0,85,71
1657314164511,CSE 140L,A01,083088,Eldon; John,21,0,100,79
1657314170536,CSE 175,A01,083665,Kumar; Rakesh,3,0,25,22
1657314176568,CSE 190,A00,092507,Dubnov; Shlomo,7,0,20,13
1657314182595,ECE 45,A01,083139,Congero; Spencer William,6,0,75,69
1657314188633,ECE 65,A50,083695,Saad; Andrew S,12,0,30,18
1657314188633,ECE 65,A51,095125,Saad; Andrew S,25,0,26,1
1657314194656,ECE 109,A01,091882,Touri; Behrouz,19,0,70,51
1657314200689,ECE 180,A00,083140,Abi Samra; Nicholas Camill,1,0,30,29
1657314200689,ECE 180,B00,083141,Abi Samra; Nicholas Camill,0,0,30,30
1657314206715,MATH 10A,A01,083735,Patchell; Gregory David,2,0,30,28
1657314206715,MATH 10A,A02,083736,Patchell; Gregory David,20,0,30,10
1657314206715,MATH 10A,A03,083737,Patchell; Gregory David,16,0,30,14
1657314212744,MATH 10B,A01,083207,Lim; Seonhee,7,0,34,27
1657314212744,MATH 10B,A02,083208,Lim; Seonhee,9,0,35,26
1657314212744,MATH 10B,A03,093472,Lim; Seonhee,7,0,34,27
1657314212744,MATH 10B,B01,083739,Sinha; Shubham,11,0,30,19
1657314218773,MATH 18,A01,083743,Cinel; Cameron Alexander,6,0,30,24
1657314218773,MATH 18,A02,083744,Cinel; Cameron Alexander,17,0,30,13
1657314218773,MATH 18,A03,083745,Cinel; Cameron Alexander,9,0,30,21
1657314218773,MATH 18,B01,083748,Rideout; David Porter,4,0,37,33
1657314218773,MATH 18,B02,083749,Rideout; David Porter,5,0,36,31
1657314218773,MATH 18,B03,083750,Rideout; David Porter,3,0,37,34
1657314218773,MATH 18,B04,083751,Rideout; David Porter,6,0,36,30
1657314218773,MATH 18,B05,093473,Rideout; David Porter,5,0,36,31
1657314218773,MATH 18,B06,093474,Rideout; David Porter,5,0,36,31
1657314224795,MATH 20A,A01,083754,Zheng; Zequn,14,0,40,26
1657314230820,MATH 20B,A01,083756,Briones; Jor-el Thomas Caparas,4,0,36,32
1657314230820,MATH 20B,A02,083757,Briones; Jor-el Thomas Caparas,1,0,36,35
1657314230820,MATH 20B,A03,093475,Briones; Jor-el Thomas Caparas,2,0,36,34
1657314236845,MATH 20C,A01,083760,Briones; Jor-el Thomas Caparas,1,0,35,34
1657314236845,MATH 20C,A02,083761,Briones; Jor-el Thomas Caparas,8,0,35,27
1657314236845,MATH 20C,A03,093476,Briones; Jor-el Thomas Caparas,0,1,36,36
1657314236845,MATH 20C,B01,083762,Bach; Quang Tran,1,0,30,29
1657314242869,MATH 20D,A01,083765,Tran; Brian Kha,5,0,30,25
1657314242869,MATH 20D,A02,083766,Tran; Brian Kha,5,0,30,25
1657314242869,MATH 20D,A03,083767,Tran; Brian Kha,4,0,30,26
1657314248897,MATH 20E,A01,083771,Ganguly; Soumya,7,0,32,25
1657314248897,MATH 20E,A02,083772,Ganguly; Soumya,6,0,32,26
1657314248897,MATH 20E,B01,083773,Ciotti; Benjamin,19,0,35,16
1657314248897,MATH 20E,B02,083774,Ciotti; Benjamin,17,0,35,18
1657314254920,MATH 103A,A01,083777,Greenfeld; Be'Eri,3,0,36,33
1657314254920,MATH 103A,A02,083778,Greenfeld; Be'Eri,5,0,36,31
1657314254920,MATH 103A,A03,093561,Greenfeld; Be'Eri,4,0,36,32
1657314254920,MATH 103A,B01,083779,Greenfeld; Be'Eri,6,0,36,30
1657314254920,MATH 103A,B02,083780,Greenfeld; Be'Eri,4,0,36,32
1657314254920,MATH 103A,B03,093562,Greenfeld; Be'Eri,3,0,36,33
1657314260947,MATH 105,A01,085443,Carter; Anne Toulson,15,0,35,20
1657314260947,MATH 105,A02,093477,Carter; Anne Toulson,20,0,35,15
1657314266992,MATH 109,A01,083213,Ganzberger; Geoffrey Michael,2,0,34,32
1657314266992,MATH 109,A02,083214,Ganzberger; Geoffrey Michael,4,0,34,30
1657314266992,MATH 109,A03,093478,Ganzberger; Geoffrey Michael,2,0,34,32
1657314266992,MATH 109,B01,083215,Ganzberger; Geoffrey Michael,1,0,32,31
1657314266992,MATH 109,B02,083216,Ganzberger; Geoffrey Michael,1,0,32,31
1657314266992,MATH 109,B03,093479,Ganzberger; Geoffrey Michael,8,0,32,24
1657314273021,MATH 142A,A01,083219,Chow; Bennett,7,0,32,25
1657314273021,MATH 142A,A02,083220,Chow; Bennett,10,0,32,22
1657314273021,MATH 142A,A03,093480,Chow; Bennett,7,0,32,25
1657314273021,MATH 142A,B03,093481,Chow; Bennett,8,0,32,24
1657314273021,MATH 142A,B04,093558,Chow; Bennett,13,0,32,19
1657314273021,MATH 142A,B05,093559,Chow; Bennett,6,0,32,26
1657314279046,MATH 193A,A01,083224,Rotar; Vladimir,7,0,34,27
1657314279046,MATH 193A,A02,083225,Rotar; Vladimir,7,0,34,27
1657314279046,MATH 193A,A03,083781,Rotar; Vladimir,3,0,34,31
1657314279046,MATH 193A,A04,083782,Rotar; Vladimir,8,0,34,26
1657314279046,MATH 193A,A05,093482,Rotar; Vladimir,8,0,34,26
1657314285082,MATH 197,001,091859,McAuley; Julian John,9999,0,9999,0
1657314285082,MATH 197,002,095566,Kedlaya; Kiran S.,9997,0,9999,2
1657314285082,MATH 197,003,095567,Xiao; Ming,9999,0,9999,0
1657314285082,MATH 197,004,095571,Perols; Johan Lars,9998,0,9999,1
1657314292140,COGS 9,A01,083615,Shannon; Kyle Michael,8,0,75,67
1657314298164,COGS 11,A01,083617,Boyle; Mary E. T.,22,0,48,26
1657314304191,COGS 13,A01,083071,Bastos; Amalia Pinkusfeld,10,0,71,61
1657314310216,COGS 14A,A01,092681,Semenuks; Arturs,2,1,100,98
1657314316243,COGS 14B,A01,083073,Cheng; Tzu-Han,6,0,63,57
1657314322268,COGS 17,A01,092677,Semenuks; Arturs,5,0,81,76
1657314328293,COGS 100,A01,083619,Allen; Michael Gordon,16,0,70,54
1657314334316,COGS 101A,A01,083621,Davis; Joshua Daniel,9,0,68,59
1657314340339,COGS 101B,A01,091572,Allen; Michael Gordon,11,0,65,54
1657314346362,COGS 101C,A01,083625,Delgado; Tania,17,0,35,18
1657314352384,COGS 107A,A01,083627,Boyle; Mary E. T.,13,0,60,47
1657314358409,COGS 118A,A01,083075,Gupta; Anjum,17,0,76,59
1657314364439,CSE 3,A50,083646,Miranda; Gregory Joseph,24,0,50,26
1657314370466,CSE 8A,A50,083650,Miranda; Gregory Joseph,17,1,56,39
1657314376493,CSE 11,A01,083080,Cao; Yingjun,6,15,40,34
1657314382514,CSE 12,A01,083652,Krause-Levy; Sophia Louisa,27,1,120,93
1657314388538,CSE 15L,A01,083654,Morris; Justin Loren,9,0,50,41
1657314388538,CSE 15L,A02,083655,Morris; Justin Loren,9,0,50,41
1657314394570,CSE 20,A01,083657,Tran; Khoa Dang,38,0,80,42
1657314400592,CSE 21,A01,095574,Bach; Quang Tran,22,0,48,26
1657314406616,CSE 30,A01,083084,Eldon; John,4,0,80,76
1657314406616,CSE 30,B01,095061,Bhaskar; Nishant,9,0,50,41
1657314412644,CSE 100,A01,083659,Cao; Yingjun,4,4,70,66
1657314418666,CSE 134B,A01,083661,Powell; Thomas Allan,21,0,100,79
1657314424706,CSE 140,A01,083663,Gungor; Onat,14,0,85,71
1657314430744,CSE 140L,A01,083088,Eldon; John,21,0,100,79
1657314436766,CSE 175,A01,083665,Kumar; Rakesh,3,0,25,22
1657314442789,CSE 190,A00,092507,Dubnov; Shlomo,7,0,20,13
1657314448811,ECE 45,A01,083139,Congero; Spencer William,6,0,75,69
1657314454833,ECE 65,A50,083695,Saad; Andrew S,12,0,30,18
1657314454833,ECE 65,A51,095125,Saad; Andrew S,25,0,26,1
1657314460856,ECE 109,A01,091882,Touri; Behrouz,19,0,70,51
1657314466881,ECE 180,A00,083140,Abi Samra; Nicholas Camill,1,0,30,29
1657314466881,ECE 180,B00,083141,Abi Samra; Nicholas Camill,0,0,30,30
1657314472904,MATH 10A,A01,083735,Patchell; Gregory David,2,0,30,28
1657314472904,MATH 10A,A02,083736,Patchell; Gregory David,20,0,30,10
1657314472904,MATH 10A,A03,083737,Patchell; Gregory David,16,0,30,14
1657314478928,MATH 10B,A01,083207,Lim; Seonhee,7,0,34,27
1657314478928,MATH 10B,A02,083208,Lim; Seonhee,9,0,35,26
1657314478928,MATH 10B,A03,093472,Lim; Seonhee,7,0,34,27
1657314478928,MATH 10B,B01,083739,Sinha; Shubham,11,0,30,19
1657314484960,MATH 18,A01,083743,Cinel; Cameron Alexander,6,0,30,24
1657314484960,MATH 18,A02,083744,Cinel; Cameron Alexander,17,0,30,13
1657314484960,MATH 18,A03,083745,Cinel; Cameron Alexander,9,0,30,21
1657314484960,MATH 18,B01,083748,Rideout; David Porter,4,0,37,33
1657314484960,MATH 18,B02,083749,Rideout; David Porter,5,0,36,31
1657314484960,MATH 18,B03,083750,Rideout; David Porter,3,0,37,34
1657314484960,MATH 18,B04,083751,Rideout; David Porter,6,0,36,30
1657314484960,MATH 18,B05,093473,Rideout; David Porter,5,0,36,31
1657314484960,MATH 18,B06,093474,Rideout; David Porter,5,0,36,31
1657314490991,MATH 20A,A01,083754,Zheng; Zequn,14,0,40,26
1657314497014,MATH 20B,A01,083756,Briones; Jor-el Thomas Caparas,4,0,36,32
1657314497014,MATH 20B,A02,083757,Briones; Jor-el Thomas Caparas,1,0,36,35
1657314497014,MATH 20B,A03,093475,Briones; Jor-el Thomas Caparas,2,0,36,34
1657314503037,MATH 20C,A01,083760,Briones; Jor-el Thomas Caparas,1,0,35,34
1657314503037,MATH 20C,A02,083761,Briones; Jor-el Thomas Caparas,8,0,35,27
1657314503037,MATH 20C,A03,093476,Briones; Jor-el Thomas Caparas,0,1,36,36
1657314503037,MATH 20C,B01,083762,Bach; Quang Tran,1,0,30,29
1657314509061,MATH 20D,A01,083765,Tran; Brian Kha,5,0,30,25
1657314509061,MATH 20D,A02,083766,Tran; Brian Kha,5,0,30,25
1657314509061,MATH 20D,A03,083767,Tran; Brian Kha,4,0,30,26
1657314515086,MATH 20E,A01,083771,Ganguly; Soumya,7,0,32,25
1657314515086,MATH 20E,A02,083772,Ganguly; Soumya,6,0,32,26
1657314515086,MATH 20E,B01,083773,Ciotti; Benjamin,19,0,35,16
1657314515086,MATH 20E,B02,083774,Ciotti; Benjamin,17,0,35,18
1657314521111,MATH 103A,A01,083777,Greenfeld; Be'Eri,3,0,36,33
1657314521111,MATH 103A,A02,083778,Greenfeld; Be'Eri,5,0,36,31
1657314521111,MATH 103A,A03,093561,Greenfeld; Be'Eri,4,0,36,32
1657314521111,MATH 103A,B01,083779,Greenfeld; Be'Eri,6,0,36,30
1657314521111,MATH 103A,B02,083780,Greenfeld; Be'Eri,4,0,36,32
1657314521111,MATH 103A,B03,093562,Greenfeld; Be'Eri,3,0,36,33
1657314527142,MATH 105,A01,085443,Carter; Anne Toulson,15,0,35,20
1657314527142,MATH 105,A02,093477,Carter; Anne Toulson,20,0,35,15
1657314533168,MATH 109,A01,083213,Ganzberger; Geoffrey Michael,2,0,34,32
1657314533168,MATH 109,A02,083214,Ganzberger; Geoffrey Michael,4,0,34,30
1657314533168,MATH 109,A03,093478,Ganzberger; Geoffrey Michael,2,0,34,32
1657314533168,MATH 109,B01,083215,Ganzberger; Geoffrey Michael,1,0,32,31
1657314533168,MATH 109,B02,083216,Ganzberger; Geoffrey Michael,1,0,32,31
1657314533168,MATH 109,B03,093479,Ganzberger; Geoffrey Michael,8,0,32,24
1657314539191,MATH 142A,A01,083219,Chow; Bennett,7,0,32,25
1657314539191,MATH 142A,A02,083220,Chow; Bennett,10,0,32,22
1657314539191,MATH 142A,A03,093480,Chow; Bennett,7,0,32,25
1657314539191,MATH 142A,B03,093481,Chow; Bennett,8,0,32,24
1657314539191,MATH 142A,B04,093558,Chow; Bennett,13,0,32,19
1657314539191,MATH 142A,B05,093559,Chow; Bennett,6,0,32,26
1657314545220,MATH 193A,A01,083224,Rotar; Vladimir,7,0,34,27
1657314545220,MATH 193A,A02,083225,Rotar; Vladimir,7,0,34,27
1657314545220,MATH 193A,A03,083781,Rotar; Vladimir,3,0,34,31
1657314545220,MATH 193A,A04,083782,Rotar; Vladimir,8,0,34,26
1657314545220,MATH 193A,A05,093482,Rotar; Vladimir,8,0,34,26
1657314551243,MATH 197,001,091859,McAuley; Julian John,9999,0,9999,0
1657314551243,MATH 197,002,095566,Kedlaya; Kiran S.,9997,0,9999,2
1657314551243,MATH 197,003,095567,Xiao; Ming,9999,0,9999,0
1657314551243,MATH 197,004,095571,Perols; Johan Lars,9998,0,9999,1
1657314558303,COGS 9,A01,083615,Shannon; Kyle Michael,8,0,75,67
1657314564324,COGS 11,A01,083617,Boyle; Mary E. T.,22,0,48,26
1657314570361,COGS 13,A01,083071,Bastos; Amalia Pinkusfeld,10,0,71,61
1657314576384,COGS 14A,A01,092681,Semenuks; Arturs,3,1,100,97
1657314582406,COGS 14B,A01,083073,Cheng; Tzu-Han,6,0,63,57
1657314588429,COGS 17,A01,092677,Semenuks; Arturs,5,0,81,76
1657314594457,COGS 100,A01,083619,Allen; Michael Gordon,16,0,70,54
1657314600483,COGS 101A,A01,083621,Davis; Joshua Daniel,9,0,68,59
1657314606517,COGS 101B,A01,091572,Allen; Michael Gordon,11,0,65,54
1657314612540,COGS 101C,A01,083625,Delgado; Tania,17,0,35,18
1657314618566,COGS 107A,A01,083627,Boyle; Mary E. T.,13,0,60,47
1657314624596,COGS 118A,A01,083075,Gupta; Anjum,17,0,76,59
1657314630617,CSE 3,A50,083646,Miranda; Gregory Joseph,24,0,50,26
1657314636648,CSE 8A,A50,083650,Miranda; Gregory Joseph,17,1,56,39
1657314642673,CSE 11,A01,083080,Cao; Yingjun,6,15,40,34
1657314648700,CSE 12,A01,083652,Krause-Levy; Sophia Louisa,27,1,120,93
1657314654721,CSE 15L,A01,083654,Morris; Justin Loren,9,0,50,41
1657314654721,CSE 15L,A02,083655,Morris; Justin Loren,9,0,50,41
1657314660747,CSE 20,A01,083657,Tran; Khoa Dang,38,0,80,42
1657314666771,CSE 21,A01,095574,Bach; Quang Tran,22,0,48,26
1657314672797,CSE 30,A01,083084,Eldon; John,4,0,80,76
1657314672797,CSE 30,B01,095061,Bhaskar; Nishant,9,0,50,41
1657314678822,CSE 100,A01,083659,Cao; Yingjun,4,4,70,66
1657314684849,CSE 134B,A01,083661,Powell; Thomas Allan,21,0,100,79
1657314690882,CSE 140,A01,083663,Gungor; Onat,14,0,85,71
1657314696905,CSE 140L,A01,083088,Eldon; John,21,0,100,79
1657314702927,CSE 175,A01,083665,Kumar; Rakesh,3,0,25,22
1657314708949,CSE 190,A00,092507,Dubnov; Shlomo,7,0,20,13
1657314715041,ECE 45,A01,083139,Congero; Spencer William,6,0,75,69
1657314721069,ECE 65,A50,083695,Saad; Andrew S,12,0,30,18
1657314721069,ECE 65,A51,095125,Saad; Andrew S,25,0,26,1
1657314727091,ECE 109,A01,091882,Touri; Behrouz,19,0,70,51
1657314733121,ECE 180,A00,083140,Abi Samra; Nicholas Camill,1,0,30,29
1657314733121,ECE 180,B00,083141,Abi Samra; Nicholas Camill,0,0,30,30
1657314739150,MATH 10A,A01,083735,Patchell; Gregory David,2,0,30,28
1657314739150,MATH 10A,A02,083736,Patchell; Gregory David,20,0,30,10
1657314739150,MATH 10A,A03,083737,Patchell; Gregory David,16,0,30,14
1657314745176,MATH 10B,A01,083207,Lim; Seonhee,7,0,34,27
1657314745176,MATH 10B,A02,083208,Lim; Seonhee,9,0,35,26
1657314745176,MATH 10B,A03,093472,Lim; Seonhee,7,0,34,27
1657314745176,MATH 10B,B01,083739,Sinha; Shubham,11,0,30,19
1657314751207,MATH 18,A01,083743,Cinel; Cameron Alexander,6,0,30,24
1657314751207,MATH 18,A02,083744,Cinel; Cameron Alexander,17,0,30,13
1657314751207,MATH 18,A03,083745,Cinel; Cameron Alexander,9,0,30,21
1657314751207,MATH 18,B01,083748,Rideout; David Porter,4,0,37,33
1657314751207,MATH 18,B02,083749,Rideout; David Porter,5,0,36,31
1657314751207,MATH 18,B03,083750,Rideout; David Porter,3,0,37,34
1657314751207,MATH 18,B04,083751,Rideout; David Porter,6,0,36,30
1657314751207,MATH 18,B05,093473,Rideout; David Porter,5,0,36,31
1657314751207,MATH 18,B06,093474,Rideout; David Porter,5,0,36,31
1657314757234,MATH 20A,A01,083754,Zheng; Zequn,14,0,40,26
1657314763262,MATH 20B,A01,083756,Briones; Jor-el Thomas Caparas,4,0,36,32
1657314763262,MATH 20B,A02,083757,Briones; Jor-el Thomas Caparas,1,0,36,35
1657314763262,MATH 20B,A03,093475,Briones; Jor-el Thomas Caparas,2,0,36,34
1657314769289,MATH 20C,A01,083760,Briones; Jor-el Thomas Caparas,1,0,35,34
1657314769289,MATH 20C,A02,083761,Briones; Jor-el Thomas Caparas,8,0,35,27
1657314769289,MATH 20C,A03,093476,Briones; Jor-el Thomas Caparas,0,1,36,36
1657314769289,MATH 20C,B01,083762,Bach; Quang Tran,1,0,30,29
1657314775318,MATH 20D,A01,083765,Tran; Brian Kha,5,0,30,25
1657314775318,MATH 20D,A02,083766,Tran; Brian Kha,5,0,30,25
1657314775318,MATH 20D,A03,083767,Tran; Brian Kha,4,0,30,26
1657314781349,MATH 20E,A01,083771,Ganguly; Soumya,7,0,32,25
1657314781349,MATH 20E,A02,083772,Ganguly; Soumya,6,0,32,26
1657314781349,MATH 20E,B01,083773,Ciotti; Benjamin,19,0,35,16
1657314781349,MATH 20E,B02,083774,Ciotti; Benjamin,17,0,35,18
1657314787379,MATH 103A,A01,083777,Greenfeld; Be'Eri,3,0,36,33
1657314787379,MATH 103A,A02,083778,Greenfeld; Be'Eri,5,0,36,31
1657314787379,MATH 103A,A03,093561,Greenfeld; Be'Eri,4,0,36,32
1657314787379,MATH 103A,B01,083779,Greenfeld; Be'Eri,6,0,36,30
1657314787379,MATH 103A,B02,083780,Greenfeld; Be'Eri,4,0,36,32
1657314787379,MATH 103A,B03,093562,Greenfeld; Be'Eri,3,0,36,33
1657314793401,MATH 105,A01,085443,Carter; Anne Toulson,15,0,35,20
1657314793401,MATH 105,A02,093477,Carter; Anne Toulson,20,0,35,15
1657314799443,MATH 109,A01,083213,Ganzberger; Geoffrey Michael,2,0,34,32
1657314799443,MATH 109,A02,083214,Ganzberger; Geoffrey Michael,4,0,34,30
1657314799443,MATH 109,A03,093478,Ganzberger; Geoffrey Michael,2,0,34,32
1657314799443,MATH 109,B01,083215,Ganzberger; Geoffrey Michael,1,0,32,31
1657314799443,MATH 109,B02,083216,Ganzberger; Geoffrey Michael,1,0,32,31
1657314799443,MATH 109,B03,093479,Ganzberger; Geoffrey Michael,8,0,32,24
1657314805471,MATH 142A,A01,083219,Chow; Bennett,7,0,32,25
1657314805471,MATH 142A,A02,083220,Chow; Bennett,10,0,32,22
1657314805471,MATH 142A,A03,093480,Chow; Bennett,7,0,32,25
1657314805471,MATH 142A,B03,093481,Chow; Bennett,8,0,32,24
1657314805471,MATH 142A,B04,093558,Chow; Bennett,13,0,32,19
1657314805471,MATH 142A,B05,093559,Chow; Bennett,6,0,32,26
1657314811499,MATH 193A,A01,083224,Rotar; Vladimir,7,0,34,27
1657314811499,MATH 193A,A02,083225,Rotar; Vladimir,7,0,34,27
1657314811499,MATH 193A,A03,083781,Rotar; Vladimir,3,0,34,31
1657314811499,MATH 193A,A04,083782,Rotar; Vladimir,8,0,34,26
1657314811499,MATH 193A,A05,093482,Rotar; Vladimir,8,0,34,26
1657314817522,MATH 197,001,091859,McAuley; Julian John,9999,0,9999,0
1657314817522,MATH 197,002,095566,Kedlaya; Kiran S.,9997,0,9999,2
1657314817522,MATH 197,003,095567,Xiao; Ming,9999,0,9999,0
1657314817522,MATH 197,004,095571,Perols; Johan Lars,9998,0,9999,1
1657314824579,COGS 9,A01,083615,Shannon; Kyle Michael,8,0,75,67
1657314830604,COGS 11,A01,083617,Boyle; Mary E. T.,22,0,48,26
1657314836628,COGS 13,A01,083071,Bastos; Amalia Pinkusfeld,10,0,71,61
1657314842654,COGS 14A,A01,092681,Semenuks; Arturs,3,1,100,97
1657314848680,COGS 14B,A01,083073,Cheng; Tzu-Han,6,0,63,57
1657314854702,COGS 17,A01,092677,Semenuks; Arturs,5,0,81,76
1657314860733,COGS 100,A01,083619,Allen; Michael Gordon,16,0,70,54
1657314866757,COGS 101A,A01,083621,Davis; Joshua Daniel,9,0,68,59
1657314872780,COGS 101B,A01,091572,Allen; Michael Gordon,11,0,65,54
1657314878803,COGS 101C,A01,083625,Delgado; Tania,17,0,35,18
1657314884873,COGS 107A,A01,083627,Boyle; Mary E. T.,13,0,60,47
1657314890897,COGS 118A,A01,083075,Gupta; Anjum,18,0,76,58
1657314896921,CSE 3,A50,083646,Miranda; Gregory Joseph,24,0,50,26
1657314902943,CSE 8A,A50,083650,Miranda; Gregory Joseph,17,1,56,39
1657314908977,CSE 11,A01,083080,Cao; Yingjun,6,15,40,34
1657314914999,CSE 12,A01,083652,Krause-Levy; Sophia Louisa,27,1,120,93
1657314921026,CSE 15L,A01,083654,Morris; Justin Loren,9,0,50,41
1657314921026,CSE 15L,A02,083655,Morris; Justin Loren,9,0,50,41
1657314927053,CSE 20,A01,083657,Tran; Khoa Dang,38,0,80,42
1657314933077,CSE 21,A01,095574,Bach; Quang Tran,22,0,48,26
1657314939106,CSE 30,A01,083084,Eldon; John,4,0,80,76
1657314939106,CSE 30,B01,095061,Bhaskar; Nishant,9,0,50,41
1657314945129,CSE 100,A01,083659,Cao; Yingjun,4,4,70,66
1657314951152,CSE 134B,A01,083661,Powell; Thomas Allan,21,0,100,79
1657314957176,CSE 140,A01,083663,Gungor; Onat,14,0,85,71
1657314963204,CSE 140L,A01,083088,Eldon; John,21,0,100,79
1657314969226,CSE 175,A01,083665,Kumar; Rakesh,3,0,25,22
1657314975251,CSE 190,A00,092507,Dubnov; Shlomo,7,0,20,13
1657314981273,ECE 45,A01,083139,Congero; Spencer William,6,0,75,69
1657314987308,ECE 65,A50,083695,Saad; Andrew S,12,0,30,18
1657314987308,ECE 65,A51,095125,Saad; Andrew S,25,0,26,1
1657314993334,ECE 109,A01,091882,Touri; Behrouz,19,0,70,51
1657314999358,ECE 180,A00,083140,Abi Samra; Nicholas Camill,1,0,30,29
1657314999358,ECE 180,B00,083141,Abi Samra; Nicholas Camill,0,0,30,30
1657315005382,MATH 10A,A01,083735,Patchell; Gregory David,2,0,30,28
1657315005382,MATH 10A,A02,083736,Patchell; Gregory David,20,0,30,10
1657315005382,MATH 10A,A03,083737,Patchell; Gregory David,16,0,30,14
1657315011410,MATH 10B,A01,083207,Lim; Seonhee,7,0,34,27
1657315011410,MATH 10B,A02,083208,Lim; Seonhee,9,0,35,26
1657315011410,MATH 10B,A03,093472,Lim; Seonhee,7,0,34,27
1657315011410,MATH 10B,B01,083739,Sinha; Shubham,11,0,30,19
1657315017435,MATH 18,A01,083743,Cinel; Cameron Alexander,6,0,30,24
1657315017435,MATH 18,A02,083744,Cinel; Cameron Alexander,17,0,30,13
1657315017435,MATH 18,A03,083745,Cinel; Cameron Alexander,9,0,30,21
1657315017435,MATH 18,B01,083748,Rideout; David Porter,4,0,37,33
1657315017435,MATH 18,B02,083749,Rideout; David Porter,5,0,36,31
1657315017435,MATH 18,B03,083750,Rideout; David Porter,3,0,37,34
1657315017435,MATH 18,B04,083751,Rideout; David Porter,6,0,36,30
1657315017435,MATH 18,B05,093473,Rideout; David Porter,5,0,36,31
1657315017435,MATH 18,B06,093474,Rideout; David Porter,5,0,36,31
1657315023465,MATH 20A,A01,083754,Zheng; Zequn,14,0,40,26
1657315029499,MATH 20B,A01,083756,Briones; Jor-el Thomas Caparas,4,0,36,32
1657315029499,MATH 20B,A02,083757,Briones; Jor-el Thomas Caparas,1,0,36,35
1657315029499,MATH 20B,A03,093475,Briones; Jor-el Thomas Caparas,2,0,36,34
1657315035523,MATH 20C,A01,083760,Briones; Jor-el Thomas Caparas,1,0,35,34
1657315035523,MATH 20C,A02,083761,Briones; Jor-el Thomas Caparas,8,0,35,27
1657315035523,MATH 20C,A03,093476,Briones; Jor-el Thomas Caparas,0,1,36,36
1657315035523,MATH 20C,B01,083762,Bach; Quang Tran,1,0,30,29
1657315041547,MATH 20D,A01,083765,Tran; Brian Kha,5,0,30,25
1657315041547,MATH 20D,A02,083766,Tran; Brian Kha,5,0,30,25
1657315041547,MATH 20D,A03,083767,Tran; Brian Kha,4,0,30,26
1657315047575,MATH 20E,A01,083771,Ganguly; Soumya,7,0,32,25
1657315047575,MATH 20E,A02,083772,Ganguly; Soumya,6,0,32,26
1657315047575,MATH 20E,B01,083773,Ciotti; Benjamin,19,0,35,16
1657315047575,MATH 20E,B02,083774,Ciotti; Benjamin,17,0,35,18
1657315053615,MATH 103A,A01,083777,Greenfeld; Be'Eri,3,0,36,33
1657315053615,MATH 103A,A02,083778,Greenfeld; Be'Eri,5,0,36,31
1657315053615,MATH 103A,A03,093561,Greenfeld; Be'Eri,4,0,36,32
1657315053615,MATH 103A,B01,083779,Greenfeld; Be'Eri,6,0,36,30
1657315053615,MATH 103A,B02,083780,Greenfeld; Be'Eri,4,0,36,32
1657315053615,MATH 103A,B03,093562,Greenfeld; Be'Eri,3,0,36,33
1657315059637,MATH 105,A01,085443,Carter; Anne Toulson,15,0,35,20
1657315059637,MATH 105,A02,093477,Carter; Anne Toulson,20,0,35,15
1657315065666,MATH 109,A01,083213,Ganzberger; Geoffrey Michael,2,0,34,32
1657315065666,MATH 109,A02,083214,Ganzberger; Geoffrey Michael,4,0,34,30
1657315065666,MATH 109,A03,093478,Ganzberger; Geoffrey Michael,2,0,34,32
1657315065666,MATH 109,B01,083215,Ganzberger; Geoffrey Michael,1,0,32,31
1657315065666,MATH 109,B02,083216,Ganzberger; Geoffrey Michael,1,0,32,31
1657315065666,MATH 109,B03,093479,Ganzberger; Geoffrey Michael,8,0,32,24
1657315071699,MATH 142A,A01,083219,Chow; Bennett,7,0,32,25
1657315071699,MATH 142A,A02,083220,Chow; Bennett,10,0,32,22
1657315071699,MATH 142A,A03,093480,Chow; Bennett,7,0,32,25
1657315071699,MATH 142A,B03,093481,Chow; Bennett,8,0,32,24
1657315071699,MATH 142A,B04,093558,Chow; Bennett,13,0,32,19
1657315071699,MATH 142A,B05,093559,Chow; Bennett,6,0,32,26
1657315077723,MATH 193A,A01,083224,Rotar; Vladimir,7,0,34,27
1657315077723,MATH 193A,A02,083225,Rotar; Vladimir,7,0,34,27
1657315077723,MATH 193A,A03,083781,Rotar; Vladimir,3,0,34,31
1657315077723,MATH 193A,A04,083782,Rotar; Vladimir,8,0,34,26
1657315077723,MATH 193A,A05,093482,Rotar; Vladimir,9,0,34,25
1657315083761,MATH 197,001,091859,McAuley; Julian John,9999,0,9999,0
1657315083761,MATH 197,002,095566,Kedlaya; Kiran S.,9997,0,9999,2
1657315083761,MATH 197,003,095567,Xiao; Ming,9999,0,9999,0
1657315083761,MATH 197,004,095571,Perols; Johan Lars,9998,0,9999,1
1657315090824,COGS 9,A01,083615,Shannon; Kyle Michael,8,0,75,67
1657315096849,COGS 11,A01,083617,Boyle; Mary E. T.,22,0,48,26
1657315102872,COGS 13,A01,083071,Bastos; Amalia Pinkusfeld,10,0,71,61
1657315108895,COGS 14A,A01,092681,Semenuks; Arturs,3,1,100,97
1657315114917,COGS 14B,A01,083073,Cheng; Tzu-Han,6,0,63,57
1657315120941,COGS 17,A01,092677,Semenuks; Arturs,6,0,81,75
1657315126964,COGS 100,A01,083619,Allen; Michael Gordon,16,0,70,54
1657315132986,COGS 101A,A01,083621,Davis; Joshua Daniel,9,0,68,59
1657315139011,COGS 101B,A01,091572,Allen; Michael Gordon,11,0,65,54
1657315145039,COGS 101C,A01,083625,Delgado; Tania,17,0,35,18
1657315151066,COGS 107A,A01,083627,Boyle; Mary E. T.,13,0,60,47
1657315157097,COGS 118A,A01,083075,Gupta; Anjum,18,0,76,58
1657315163127,CSE 3,A50,083646,Miranda; Gregory Joseph,24,0,50,26
1657315169164,CSE 8A,A50,083650,Miranda; Gregory Joseph,17,1,56,39
1657315175190,CSE 11,A01,083080,Cao; Yingjun,6,15,40,34
1657315181217,CSE 12,A01,083652,Krause-Levy; Sophia Louisa,27,1,120,93
1657315187242,CSE 15L,A01,083654,Morris; Justin Loren,9,0,50,41
1657315187242,CSE 15L,A02,083655,Morris; Justin Loren,9,0,50,41
1657315193268,CSE 20,A01,083657,Tran; Khoa Dang,38,0,80,42
1657315199294,CSE 21,A01,095574,Bach; Quang Tran,22,0,48,26
1657315205318,CSE 30,A01,083084,Eldon; John,4,0,80,76
1657315205318,CSE 30,B01,095061,Bhaskar; Nishant,9,0,50,41
1657315211341,CSE 100,A01,083659,Cao; Yingjun,4,4,70,66
1657315217368,CSE 134B,A01,083661,Powell; Thomas Allan,21,0,100,79
1657315223391,CSE 140,A01,083663,Gungor; Onat,14,0,85,71
1657315229422,CSE 140L,A01,083088,Eldon; John,21,0,100,79
1657315235453,CSE 175,A01,083665,Kumar; Rakesh,3,0,25,22
1657315241476,CSE 190,A00,092507,Dubnov; Shlomo,7,0,20,13
1657315247506,ECE 45,A01,083139,Congero; Spencer William,6,0,75,69
1657315253528,ECE 65,A50,083695,Saad; Andrew S,12,0,30,18
1657315253528,ECE 65,A51,095125,Saad; Andrew S,25,0,26,1
1657315259551,ECE 109,A01,091882,Touri; Behrouz,19,0,70,51
1657315265582,ECE 180,A00,083140,Abi Samra; Nicholas Camill,1,0,30,29
1657315265582,ECE 180,B00,083141,Abi Samra; Nicholas Camill,0,0,30,30
1657315271605,MATH 10A,A01,083735,Patchell; Gregory David,2,0,30,28
1657315271605,MATH 10A,A02,083736,Patchell; Gregory David,20,0,30,10
1657315271605,MATH 10A,A03,083737,Patchell; Gregory David,16,0,30,14
1657315277628,MATH 10B,A01,083207,Lim; Seonhee,7,0,34,27
1657315277628,MATH 10B,A02,083208,Lim; Seonhee,9,0,35,26
1657315277628,MATH 10B,A03,093472,Lim; Seonhee,7,0,34,27
1657315277628,MATH 10B,B01,083739,Sinha; Shubham,11,0,30,19
1657315283652,MATH 18,A01,083743,Cinel; Cameron Alexander,6,0,30,24
1657315283652,MATH 18,A02,083744,Cinel; Cameron Alexander,17,0,30,13
1657315283652,MATH 18,A03,083745,Cinel; Cameron Alexander,9,0,30,21
1657315283652,MATH 18,B01,083748,Rideout; David Porter,4,0,37,33
1657315283652,MATH 18,B02,083749,Rideout; David Porter,5,0,36,31
1657315283652,MATH 18,B03,083750,Rideout; David Porter,3,0,37,34
1657315283652,MATH 18,B04,083751,Rideout; David Porter,6,0,36,30
1657315283652,MATH 18,B05,093473,Rideout; David Porter,5,0,36,31
1657315283652,MATH 18,B06,093474,Rideout; David Porter,5,0,36,31
1657315289677,MATH 20A,A01,083754,Zheng; Zequn,14,0,40,26
1657315295704,MATH 20B,A01,083756,Briones; Jor-el Thomas Caparas,4,0,36,32
1657315295704,MATH 20B,A02,083757,Briones; Jor-el Thomas Caparas,1,0,36,35
1657315295704,MATH 20B,A03,093475,Briones; Jor-el Thomas Caparas,2,0,36,34
1657315301732,MATH 20C,A01,083760,Briones; Jor-el Thomas Caparas,1,0,35,34
1657315301732,MATH 20C,A02,083761,Briones; Jor-el Thomas Caparas,8,0,35,27
1657315301732,MATH 20C,A03,093476,Briones; Jor-el Thomas Caparas,0,1,36,36
1657315301732,MATH 20C,B01,083762,Bach; Quang Tran,1,0,30,29
1657315307759,MATH 20D,A01,083765,Tran; Brian Kha,5,0,30,25
1657315307759,MATH 20D,A02,083766,Tran; Brian Kha,5,0,30,25
1657315307759,MATH 20D,A03,083767,Tran; Brian Kha,4,0,30,26
1657315313869,MATH 20E,A01,083771,Ganguly; Soumya,7,0,32,25
1657315313869,MATH 20E,A02,083772,Ganguly; Soumya,6,0,32,26
1657315313869,MATH 20E,B01,083773,Ciotti; Benjamin,19,0,35,16
1657315313869,MATH 20E,B02,083774,Ciotti; Benjamin,17,0,35,18
1657315319899,MATH 103A,A01,083777,Greenfeld; Be'Eri,3,0,36,33
1657315319899,MATH 103A,A02,083778,Greenfeld; Be'Eri,5,0,36,31
1657315319899,MATH 103A,A03,093561,Greenfeld; Be'Eri,4,0,36,32
1657315319899,MATH 103A,B01,083779,Greenfeld; Be'Eri,6,0,36,30
1657315319899,MATH 103A,B02,083780,Greenfeld; Be'Eri,4,0,36,32
1657315319899,MATH 103A,B03,093562,Greenfeld; Be'Eri,3,0,36,33
1657315325926,MATH 105,A01,085443,Carter; Anne Toulson,15,0,35,20
1657315325926,MATH 105,A02,093477,Carter; Anne Toulson,20,0,35,15
1657315331955,MATH 109,A01,083213,Ganzberger; Geoffrey Michael,2,0,34,32
1657315331955,MATH 109,A02,083214,Ganzberger; Geoffrey Michael,4,0,34,30
1657315331955,MATH 109,A03,093478,Ganzberger; Geoffrey Michael,2,0,34,32
1657315331955,MATH 109,B01,083215,Ganzberger; Geoffrey Michael,1,0,32,31
1657315331955,MATH 109,B02,083216,Ganzberger; Geoffrey Michael,1,0,32,31
1657315331955,MATH 109,B03,093479,Ganzberger; Geoffrey Michael,8,0,32,24
1657315337985,MATH 142A,A01,083219,Chow; Bennett,7,0,32,25
1657315337985,MATH 142A,A02,083220,Chow; Bennett,10,0,32,22
1657315337985,MATH 142A,A03,093480,Chow; Bennett,7,0,32,25
1657315337985,MATH 142A,B03,093481,Chow; Bennett,8,0,32,24
1657315337985,MATH 142A,B04,093558,Chow; Bennett,13,0,32,19
1657315337985,MATH 142A,B05,093559,Chow; Bennett,6,0,32,26
1657315344016,MATH 193A,A01,083224,Rotar; Vladimir,7,0,34,27
1657315344016,MATH 193A,A02,083225,Rotar; Vladimir,7,0,34,27
1657315344016,MATH 193A,A03,083781,Rotar; Vladimir,3,0,34,31
1657315344016,MATH 193A,A04,083782,Rotar; Vladimir,8,0,34,26
1657315344016,MATH 193A,A05,093482,Rotar; Vladimir,9,0,34,25
1657315350046,MATH 197,001,091859,McAuley; Julian John,9999,0,9999,0
1657315350046,MATH 197,002,095566,Kedlaya; Kiran S.,9997,0,9999,2
1657315350046,MATH 197,003,095567,Xiao; Ming,9999,0,9999,0
1657315350046,MATH 197,004,095571,Perols; Johan Lars,9998,0,9999,1
1657315357096,COGS 9,A01,083615,Shannon; Kyle Michael,8,0,75,67
1657315363122,COGS 11,A01,083617,Boyle; Mary E. T.,22,0,48,26
1657315369148,COGS 13,A01,083071,Bastos; Amalia Pinkusfeld,10,0,71,61
1657315375177,COGS 14A,A01,092681,Semenuks; Arturs,3,1,100,97
1657315381203,COGS 14B,A01,083073,Cheng; Tzu-Han,6,0,63,57
1657315387226,COGS 17,A01,092677,Semenuks; Arturs,6,0,81,75
1657315393250,COGS 100,A01,083619,Allen; Michael Gordon,16,0,70,54
1657315399274,COGS 101A,A01,083621,Davis; Joshua Daniel,9,0,68,59
1657315405295,COGS 101B,A01,091572,Allen; Michael Gordon,11,0,65,54
1657315411323,COGS 101C,A01,083625,Delgado; Tania,17,0,35,18
1657315417347,COGS 107A,A01,083627,Boyle; Mary E. T.,13,0,60,47
1657315423380,COGS 118A,A01,083075,Gupta; Anjum,18,0,76,58
1657315429402,CSE 3,A50,083646,Miranda; Gregory Joseph,24,0,50,26
1657315435425,CSE 8A,A50,083650,Miranda; Gregory Joseph,17,1,56,39
1657315441447,CSE 11,A01,083080,Cao; Yingjun,6,15,40,34
1657315447469,CSE 12,A01,083652,Krause-Levy; Sophia Louisa,27,1,120,93
1657315453491,CSE 15L,A01,083654,Morris; Justin Loren,9,0,50,41
1657315453491,CSE 15L,A02,083655,Morris; Justin Loren,9,0,50,41
1657315459513,CSE 20,A01,083657,Tran; Khoa Dang,38,0,80,42
1657315465536,CSE 21,A01,095574,Bach; Quang Tran,22,0,48,26
1657315471563,CSE 30,A01,083084,Eldon; John,4,0,80,76
1657315471563,CSE 30,B01,095061,Bhaskar; Nishant,9,0,50,41
1657315477586,CSE 100,A01,083659,Cao; Yingjun,4,4,70,66
1657315483608,CSE 134B,A01,083661,Powell; Thomas Allan,21,0,100,79
1657315489636,CSE 140,A01,083663,Gungor; Onat,14,0,85,71
1657315495659,CSE 140L,A01,083088,Eldon; John,21,0,100,79
1657315501692,CSE 175,A01,083665,Kumar; Rakesh,3,0,25,22
1657315507714,CSE 190,A00,092507,Dubnov; Shlomo,7,0,20,13
1657315513736,ECE 45,A01,083139,Congero; Spencer William,6,0,75,69
1657315519761,ECE 65,A50,083695,Saad; Andrew S,12,0,30,18
1657315519761,ECE 65,A51,095125,Saad; Andrew S,25,0,26,1
1657315525784,ECE 109,A01,091882,Touri; Behrouz,19,0,70,51
1657315531812,ECE 180,A00,083140,Abi Samra; Nicholas Camill,1,0,30,29
1657315531812,ECE 180,B00,083141,Abi Samra; Nicholas Camill,0,0,30,30
1657315537835,MATH 10A,A01,083735,Patchell; Gregory David,2,0,30,28
1657315537835,MATH 10A,A02,083736,Patchell; Gregory David,20,0,30,10
1657315537835,MATH 10A,A03,083737,Patchell; Gregory David,16,0,30,14
1657315543863,MATH 10B,A01,083207,Lim; Seonhee,7,0,34,27
1657315543863,MATH 10B,A02,083208,Lim; Seonhee,9,0,35,26
1657315543863,MATH 10B,A03,093472,Lim; Seonhee,7,0,34,27
1657315543863,MATH 10B,B01,083739,Sinha; Shubham,11,0,30,19
1657315549887,MATH 18,A01,083743,Cinel; Cameron Alexander,6,0,30,24
1657315549887,MATH 18,A02,083744,Cinel; Cameron Alexander,17,0,30,13
1657315549887,MATH 18,A03,083745,Cinel; Cameron Alexander,9,0,30,21
1657315549887,MATH 18,B01,083748,Rideout; David Porter,4,0,37,33
1657315549887,MATH 18,B02,083749,Rideout; David Porter,5,0,36,31
1657315549887,MATH 18,B03,083750,Rideout; David Porter,3,0,37,34
1657315549887,MATH 18,B04,083751,Rideout; David Porter,6,0,36,30
1657315549887,MATH 18,B05,093473,Rideout; David Porter,5,0,36,31
1657315549887,MATH 18,B06,093474,Rideout; David Porter,5,0,36,31
1657315555911,MATH 20A,A01,083754,Zheng; Zequn,14,0,40,26
1657315561942,MATH 20B,A01,083756,Briones; Jor-el Thomas Caparas,4,0,36,32
1657315561942,MATH 20B,A02,083757,Briones; Jor-el Thomas Caparas,1,0,36,35
1657315561942,MATH 20B,A03,093475,Briones; Jor-el Thomas Caparas,2,0,36,34
1657315567966,MATH 20C,A01,083760,Briones; Jor-el Thomas Caparas,1,0,35,34
1657315567966,MATH 20C,A02,083761,Briones; Jor-el Thomas Caparas,8,0,35,27
1657315567966,MATH 20C,A03,093476,Briones; Jor-el Thomas Caparas,0,1,36,36
1657315567966,MATH 20C,B01,083762,Bach; Quang Tran,1,0,30,29
1657315573988,MATH 20D,A01,083765,Tran; Brian Kha,5,0,30,25
1657315573988,MATH 20D,A02,083766,Tran; Brian Kha,5,0,30,25
1657315573988,MATH 20D,A03,083767,Tran; Brian Kha,4,0,30,26
1657315580028,MATH 20E,A01,083771,Ganguly; Soumya,7,0,32,25
1657315580028,MATH 20E,A02,083772,Ganguly; Soumya,6,0,32,26
1657315580028,MATH 20E,B01,083773,Ciotti; Benjamin,19,0,35,16
1657315580028,MATH 20E,B02,083774,Ciotti; Benjamin,17,0,35,18
1657315586057,MATH 103A,A01,083777,Greenfeld; Be'Eri,3,0,36,33
1657315586057,MATH 103A,A02,083778,Greenfeld; Be'Eri,5,0,36,31
1657315586057,MATH 103A,A03,093561,Greenfeld; Be'Eri,4,0,36,32
1657315586057,MATH 103A,B01,083779,Greenfeld; Be'Eri,6,0,36,30
1657315586057,MATH 103A,B02,083780,Greenfeld; Be'Eri,4,0,36,32
1657315586057,MATH 103A,B03,093562,Greenfeld; Be'Eri,3,0,36,33
1657315592086,MATH 105,A01,085443,Carter; Anne Toulson,15,0,35,20
1657315592086,MATH 105,A02,093477,Carter; Anne Toulson,20,0,35,15
1657315598120,MATH 109,A01,083213,Ganzberger; Geoffrey Michael,2,0,34,32
1657315598120,MATH 109,A02,083214,Ganzberger; Geoffrey Michael,4,0,34,30
1657315598120,MATH 109,A03,093478,Ganzberger; Geoffrey Michael,2,0,34,32
1657315598120,MATH 109,B01,083215,Ganzberger; Geoffrey Michael,1,0,32,31
1657315598120,MATH 109,B02,083216,Ganzberger; Geoffrey Michael,1,0,32,31
1657315598120,MATH 109,B03,093479,Ganzberger; Geoffrey Michael,8,0,32,24
1657315604142,MATH 142A,A01,083219,Chow; Bennett,7,0,32,25
1657315604142,MATH 142A,A02,083220,Chow; Bennett,10,0,32,22
1657315604142,MATH 142A,A03,093480,Chow; Bennett,7,0,32,25
1657315604142,MATH 142A,B03,093481,Chow; Bennett,8,0,32,24
1657315604142,MATH 142A,B04,093558,Chow; Bennett,13,0,32,19
1657315604142,MATH 142A,B05,093559,Chow; Bennett,6,0,32,26
1657315610167,MATH 193A,A01,083224,Rotar; Vladimir,7,0,34,27
1657315610167,MATH 193A,A02,083225,Rotar; Vladimir,7,0,34,27
1657315610167,MATH 193A,A03,083781,Rotar; Vladimir,3,0,34,31
1657315610167,MATH 193A,A04,083782,Rotar; Vladimir,8,0,34,26
1657315610167,MATH 193A,A05,093482,Rotar; Vladimir,9,0,34,25
1657315616194,MATH 197,001,091859,McAuley; Julian John,9999,0,9999,0
1657315616194,MATH 197,002,095566,Kedlaya; Kiran S.,9997,0,9999,2
1657315616194,MATH 197,003,095567,Xiao; Ming,9999,0,9999,0
1657315616194,MATH 197,004,095571,Perols; Johan Lars,9998,0,9999,1
1657315623249,COGS 9,A01,083615,Shannon; Kyle Michael,8,0,75,67
1657315629291,COGS 11,A01,083617,Boyle; Mary E. T.,22,0,48,26
1657315635314,COGS 13,A01,083071,Bastos; Amalia Pinkusfeld,10,0,71,61
1657315641339,COGS 14A,A01,092681,Semenuks; Arturs,3,1,100,97
1657315647370,COGS 14B,A01,083073,Cheng; Tzu-Han,6,0,63,57
1657315653407,COGS 17,A01,092677,Semenuks; Arturs,6,0,81,75
1657315659434,COGS 100,A01,083619,Allen; Michael Gordon,16,0,70,54
1657315665460,COGS 101A,A01,083621,Davis; Joshua Daniel,9,0,68,59
1657315671489,COGS 101B,A01,091572,Allen; Michael Gordon,11,0,65,54
1657315677531,COGS 101C,A01,083625,Delgado; Tania,17,0,35,18
1657315683553,COGS 107A,A01,083627,Boyle; Mary E. T.,13,0,60,47
1657315689580,COGS 118A,A01,083075,Gupta; Anjum,18,0,76,58
1657315695610,CSE 3,A50,083646,Miranda; Gregory Joseph,24,0,50,26
1657315701638,CSE 8A,A50,083650,Miranda; Gregory Joseph,17,1,56,39
1657315707660,CSE 11,A01,083080,Cao; Yingjun,6,15,40,34
1657315713688,CSE 12,A01,083652,Krause-Levy; Sophia Louisa,27,1,120,93
1657315719715,CSE 15L,A01,083654,Morris; Justin Loren,9,0,50,41
1657315719715,CSE 15L,A02,083655,Morris; Justin Loren,9,0,50,41
1657315725742,CSE 20,A01,083657,Tran; Khoa Dang,38,0,80,42
1657315731766,CSE 21,A01,095574,Bach; Quang Tran,22,0,48,26
1657315737791,CSE 30,A01,083084,Eldon; John,4,0,80,76
1657315737791,CSE 30,B01,095061,Bhaskar; Nishant,9,0,50,41
1657315743816,CSE 100,A01,083659,Cao; Yingjun,4,4,70,66
1657315749850,CSE 134B,A01,083661,Powell; Thomas Allan,21,0,100,79
1657315755876,CSE 140,A01,083663,Gungor; Onat,14,0,85,71
1657315761922,CSE 140L,A01,083088,Eldon; John,21,0,100,79
1657315767951,CSE 175,A01,083665,Kumar; Rakesh,3,0,25,22
1657315773974,CSE 190,A00,092507,Dubnov; Shlomo,7,0,20,13
1657315780001,ECE 45,A01,083139,Congero; Spencer William,6,0,75,69
1657315786028,ECE 65,A50,083695,Saad; Andrew S,12,0,30,18
1657315786028,ECE 65,A51,095125,Saad; Andrew S,25,0,26,1
1657315792050,ECE 109,A01,091882,Touri; Behrouz,19,0,70,51
1657315798072,ECE 180,A00,083140,Abi Samra; Nicholas Camill,1,0,30,29
1657315798072,ECE 180,B00,083141,Abi Samra; Nicholas Camill,0,0,30,30
1657315804095,MATH 10A,A01,083735,Patchell; Gregory David,2,0,30,28
1657315804095,MATH 10A,A02,083736,Patchell; Gregory David,20,0,30,10
1657315804095,MATH 10A,A03,083737,Patchell; Gregory David,16,0,30,14
1657315810120,MATH 10B,A01,083207,Lim; Seonhee,7,0,34,27
1657315810120,MATH 10B,A02,083208,Lim; Seonhee,9,0,35,26
1657315810120,MATH 10B,A03,093472,Lim; Seonhee,7,0,34,27
1657315810120,MATH 10B,B01,083739,Sinha; Shubham,11,0,30,19
1657315816145,MATH 18,A01,083743,Cinel; Cameron Alexander,6,0,30,24
1657315816145,MATH 18,A02,083744,Cinel; Cameron Alexander,17,0,30,13
1657315816145,MATH 18,A03,083745,Cinel; Cameron Alexander,9,0,30,21
1657315816145,MATH 18,B01,083748,Rideout; David Porter,4,0,37,33
1657315816145,MATH 18,B02,083749,Rideout; David Porter,5,0,36,31
1657315816145,MATH 18,B03,083750,Rideout; David Porter,3,0,37,34
1657315816145,MATH 18,B04,083751,Rideout; David Porter,6,0,36,30
1657315816145,MATH 18,B05,093473,Rideout; David Porter,5,0,36,31
1657315816145,MATH 18,B06,093474,Rideout; David Porter,5,0,36,31
1657315822173,MATH 20A,A01,083754,Zheng; Zequn,14,0,40,26
1657315828196,MATH 20B,A01,083756,Briones; Jor-el Thomas Caparas,4,0,36,32
1657315828196,MATH 20B,A02,083757,Briones; Jor-el Thomas Caparas,1,0,36,35
1657315828196,MATH 20B,A03,093475,Briones; Jor-el Thomas Caparas,2,0,36,34
1657315834225,MATH 20C,A01,083760,Briones; Jor-el Thomas Caparas,1,0,35,34
1657315834225,MATH 20C,A02,083761,Briones; Jor-el Thomas Caparas,8,0,35,27
1657315834225,MATH 20C,A03,093476,Briones; Jor-el Thomas Caparas,0,1,36,36
1657315834225,MATH 20C,B01,083762,Bach; Quang Tran,1,0,30,29
1657315840252,MATH 20D,A01,083765,Tran; Brian Kha,5,0,30,25
1657315840252,MATH 20D,A02,083766,Tran; Brian Kha,5,0,30,25
1657315840252,MATH 20D,A03,083767,Tran; Brian Kha,4,0,30,26
1657315846276,MATH 20E,A01,083771,Ganguly; Soumya,7,0,32,25
1657315846276,MATH 20E,A02,083772,Ganguly; Soumya,6,0,32,26
1657315846276,MATH 20E,B01,083773,Ciotti; Benjamin,19,0,35,16
1657315846276,MATH 20E,B02,083774,Ciotti; Benjamin,17,0,35,18
1657315852303,MATH 103A,A01,083777,Greenfeld; Be'Eri,3,0,36,33
1657315852303,MATH 103A,A02,083778,Greenfeld; Be'Eri,5,0,36,31
1657315852303,MATH 103A,A03,093561,Greenfeld; Be'Eri,4,0,36,32
1657315852303,MATH 103A,B01,083779,Greenfeld; Be'Eri,6,0,36,30
1657315852303,MATH 103A,B02,083780,Greenfeld; Be'Eri,4,0,36,32
1657315852303,MATH 103A,B03,093562,Greenfeld; Be'Eri,3,0,36,33
1657315858328,MATH 105,A01,085443,Carter; Anne Toulson,15,0,35,20
1657315858328,MATH 105,A02,093477,Carter; Anne Toulson,20,0,35,15
1657315864352,MATH 109,A01,083213,Ganzberger; Geoffrey Michael,2,0,34,32
1657315864352,MATH 109,A02,083214,Ganzberger; Geoffrey Michael,4,0,34,30
1657315864352,MATH 109,A03,093478,Ganzberger; Geoffrey Michael,2,0,34,32
1657315864352,MATH 109,B01,083215,Ganzberger; Geoffrey Michael,1,0,32,31
1657315864352,MATH 109,B02,083216,Ganzberger; Geoffrey Michael,1,0,32,31
1657315864352,MATH 109,B03,093479,Ganzberger; Geoffrey Michael,8,0,32,24
1657315870377,MATH 142A,A01,083219,Chow; Bennett,7,0,32,25
1657315870377,MATH 142A,A02,083220,Chow; Bennett,10,0,32,22
1657315870377,MATH 142A,A03,093480,Chow; Bennett,7,0,32,25
1657315870377,MATH 142A,B03,093481,Chow; Bennett,8,0,32,24
1657315870377,MATH 142A,B04,093558,Chow; Bennett,13,0,32,19
1657315870377,MATH 142A,B05,093559,Chow; Bennett,6,0,32,26
1657315876404,MATH 193A,A01,083224,Rotar; Vladimir,7,0,34,27
1657315876404,MATH 193A,A02,083225,Rotar; Vladimir,7,0,34,27
1657315876404,MATH 193A,A03,083781,Rotar; Vladimir,3,0,34,31
1657315876404,MATH 193A,A04,083782,Rotar; Vladimir,8,0,34,26
1657315876404,MATH 193A,A05,093482,Rotar; Vladimir,9,0,34,25
1657315882427,MATH 197,001,091859,McAuley; Julian John,9999,0,9999,0
1657315882427,MATH 197,002,095566,Kedlaya; Kiran S.,9997,0,9999,2
1657315882427,MATH 197,003,095567,Xiao; Ming,9999,0,9999,0
1657315882427,MATH 197,004,095571,Perols; Johan Lars,9998,0,9999,1
1657315889480,COGS 9,A01,083615,Shannon; Kyle Michael,8,0,75,67
1657315895512,COGS 11,A01,083617,Boyle; Mary E. T.,22,0,48,26
1657315901542,COGS 13,A01,083071,Bastos; Amalia Pinkusfeld,10,0,71,61
1657315907637,COGS 14A,A01,092681,Semenuks; Arturs,3,1,100,97
1657315913661,COGS 14B,A01,083073,Cheng; Tzu-Han,6,0,63,57
1657315919688,COGS 17,A01,092677,Semenuks; Arturs,6,0,81,75
1657315925721,COGS 100,A01,083619,Allen; Michael Gordon,16,0,70,54
1657315931744,COGS 101A,A01,083621,Davis; Joshua Daniel,9,0,68,59
1657315937768,COGS 101B,A01,091572,Allen; Michael Gordon,11,0,65,54
1657315943796,COGS 101C,A01,083625,Delgado; Tania,17,0,35,18
1657315949830,COGS 107A,A01,083627,Boyle; Mary E. T.,13,0,60,47
1657315955877,COGS 118A,A01,083075,Gupta; Anjum,18,0,76,58
1657315961900,CSE 3,A50,083646,Miranda; Gregory Joseph,24,0,50,26
1657315967928,CSE 8A,A50,083650,Miranda; Gregory Joseph,17,1,56,39
1657315973950,CSE 11,A01,083080,Cao; Yingjun,6,15,40,34
1657315979978,CSE 12,A01,083652,Krause-Levy; Sophia Louisa,27,1,120,93
1657315986006,CSE 15L,A01,083654,Morris; Justin Loren,9,0,50,41
1657315986006,CSE 15L,A02,083655,Morris; Justin Loren,9,0,50,41
1657315992040,CSE 20,A01,083657,Tran; Khoa Dang,38,0,80,42
1657315998073,CSE 21,A01,095574,Bach; Quang Tran,22,0,48,26
1657316004104,CSE 30,A01,083084,Eldon; John,4,0,80,76
1657316004104,CSE 30,B01,095061,Bhaskar; Nishant,9,0,50,41
1657316010128,CSE 100,A01,083659,Cao; Yingjun,4,4,70,66
1657316016151,CSE 134B,A01,083661,Powell; Thomas Allan,21,0,100,79
1657316022177,CSE 140,A01,083663,Gungor; Onat,14,0,85,71
1657316028202,CSE 140L,A01,083088,Eldon; John,21,0,100,79
1657316034226,CSE 175,A01,083665,Kumar; Rakesh,3,0,25,22
1657316040248,CSE 190,A00,092507,Dubnov; Shlomo,7,0,20,13
1657316046274,ECE 45,A01,083139,Congero; Spencer William,6,0,75,69
1657316052297,ECE 65,A50,083695,Saad; Andrew S,12,0,30,18
1657316052297,ECE 65,A51,095125,Saad; Andrew S,25,0,26,1
1657316058325,ECE 109,A01,091882,Touri; Behrouz,19,0,70,51
1657316064348,ECE 180,A00,083140,Abi Samra; Nicholas Camill,1,0,30,29
1657316064348,ECE 180,B00,083141,Abi Samra; Nicholas Camill,0,0,30,30
1657316070372,MATH 10A,A01,083735,Patchell; Gregory David,2,0,30,28
1657316070372,MATH 10A,A02,083736,Patchell; Gregory David,20,0,30,10
1657316070372,MATH 10A,A03,083737,Patchell; Gregory David,16,0,30,14
1657316076399,MATH 10B,A01,083207,Lim; Seonhee,7,0,34,27
1657316076399,MATH 10B,A02,083208,Lim; Seonhee,9,0,35,26
1657316076399,MATH 10B,A03,093472,Lim; Seonhee,7,0,34,27
1657316076399,MATH 10B,B01,083739,Sinha; Shubham,11,0,30,19
1657316082432,MATH 18,A01,083743,Cinel; Cameron Alexander,6,0,30,24
1657316082432,MATH 18,A02,083744,Cinel; Cameron Alexander,17,0,30,13
1657316082432,MATH 18,A03,083745,Cinel; Cameron Alexander,9,0,30,21
1657316082432,MATH 18,B01,083748,Rideout; David Porter,4,0,37,33
1657316082432,MATH 18,B02,083749,Rideout; David Porter,5,0,36,31
1657316082432,MATH 18,B03,083750,Rideout; David Porter,3,0,37,34
1657316082432,MATH 18,B04,083751,Rideout; David Porter,6,0,36,30
1657316082432,MATH 18,B05,093473,Rideout; David Porter,6,0,36,30
1657316082432,MATH 18,B06,093474,Rideout; David Porter,5,0,36,31
1657316088477,MATH 20A,A01,083754,Zheng; Zequn,14,0,40,26
1657316094499,MATH 20B,A01,083756,Briones; Jor-el Thomas Caparas,4,0,36,32
1657316094499,MATH 20B,A02,083757,Briones; Jor-el Thomas Caparas,1,0,36,35
1657316094499,MATH 20B,A03,093475,Briones; Jor-el Thomas Caparas,2,0,36,34
1657316100526,MATH 20C,A01,083760,Briones; Jor-el Thomas Caparas,1,0,35,34
1657316100526,MATH 20C,A02,083761,Briones; Jor-el Thomas Caparas,8,0,35,27
1657316100526,MATH 20C,A03,093476,Briones; Jor-el Thomas Caparas,0,1,36,36
1657316100526,MATH 20C,B01,083762,Bach; Quang Tran,1,0,30,29
1657316106552,MATH 20D,A01,083765,Tran; Brian Kha,5,0,30,25
1657316106552,MATH 20D,A02,083766,Tran; Brian Kha,5,0,30,25
1657316106552,MATH 20D,A03,083767,Tran; Brian Kha,4,0,30,26
1657316112576,MATH 20E,A01,083771,Ganguly; Soumya,7,0,32,25
1657316112576,MATH 20E,A02,083772,Ganguly; Soumya,6,0,32,26
1657316112576,MATH 20E,B01,083773,Ciotti; Benjamin,19,0,35,16
1657316112576,MATH 20E,B02,083774,Ciotti; Benjamin,17,0,35,18
1657316118603,MATH 103A,A01,083777,Greenfeld; Be'Eri,3,0,36,33
1657316118603,MATH 103A,A02,083778,Greenfeld; Be'Eri,5,0,36,31
1657316118603,MATH 103A,A03,093561,Greenfeld; Be'Eri,4,0,36,32
1657316118603,MATH 103A,B01,083779,Greenfeld; Be'Eri,6,0,36,30
1657316118603,MATH 103A,B02,083780,Greenfeld; Be'Eri,4,0,36,32
1657316118603,MATH 103A,B03,093562,Greenfeld; Be'Eri,3,0,36,33
1657316124629,MATH 105,A01,085443,Carter; Anne Toulson,15,0,35,20
1657316124629,MATH 105,A02,093477,Carter; Anne Toulson,20,0,35,15
1657316130656,MATH 109,A01,083213,Ganzberger; Geoffrey Michael,2,0,34,32
1657316130656,MATH 109,A02,083214,Ganzberger; Geoffrey Michael,4,0,34,30
1657316130656,MATH 109,A03,093478,Ganzberger; Geoffrey Michael,2,0,34,32
1657316130656,MATH 109,B01,083215,Ganzberger; Geoffrey Michael,1,0,32,31
1657316130656,MATH 109,B02,083216,Ganzberger; Geoffrey Michael,1,0,32,31
1657316130656,MATH 109,B03,093479,Ganzberger; Geoffrey Michael,8,0,32,24
1657316136690,MATH 142A,A01,083219,Chow; Bennett,7,0,32,25
1657316136690,MATH 142A,A02,083220,Chow; Bennett,10,0,32,22
1657316136690,MATH 142A,A03,093480,Chow; Bennett,7,0,32,25
1657316136690,MATH 142A,B03,093481,Chow; Bennett,8,0,32,24
1657316136690,MATH 142A,B04,093558,Chow; Bennett,13,0,32,19
1657316136690,MATH 142A,B05,093559,Chow; Bennett,6,0,32,26
1657316142714,MATH 193A,A01,083224,Rotar; Vladimir,7,0,34,27
1657316142714,MATH 193A,A02,083225,Rotar; Vladimir,7,0,34,27
1657316142714,MATH 193A,A03,083781,Rotar; Vladimir,3,0,34,31
1657316142714,MATH 193A,A04,083782,Rotar; Vladimir,8,0,34,26
1657316142714,MATH 193A,A05,093482,Rotar; Vladimir,9,0,34,25
1657316148745,MATH 197,001,091859,McAuley; Julian John,9999,0,9999,0
1657316148745,MATH 197,002,095566,Kedlaya; Kiran S.,9997,0,9999,2
1657316148745,MATH 197,003,095567,Xiao; Ming,9999,0,9999,0
1657316148745,MATH 197,004,095571,Perols; Johan Lars,9998,0,9999,1
1657316155805,COGS 9,A01,083615,Shannon; Kyle Michael,8,0,75,67
1657316161832,COGS 11,A01,083617,Boyle; Mary E. T.,22,0,48,26
1657316167854,COGS 13,A01,083071,Bastos; Amalia Pinkusfeld,10,0,71,61
1657316173883,COGS 14A,A01,092681,Semenuks; Arturs,3,1,100,97
1657316179912,COGS 14B,A01,083073,Cheng; Tzu-Han,6,0,63,57
1657316185938,COGS 17,A01,092677,Semenuks; Arturs,6,0,81,75
1657316191960,COGS 100,A01,083619,Allen; Michael Gordon,16,0,70,54
1657316197984,COGS 101A,A01,083621,Davis; Joshua Daniel,9,0,68,59
1657316204011,COGS 101B,A01,091572,Allen; Michael Gordon,11,0,65,54
1657316210053,COGS 101C,A01,083625,Delgado; Tania,17,0,35,18
1657316216076,COGS 107A,A01,083627,Boyle; Mary E. T.,13,0,60,47
1657316222104,COGS 118A,A01,083075,Gupta; Anjum,18,0,76,58
1657316228132,CSE 3,A50,083646,Miranda; Gregory Joseph,24,0,50,26
1657316234211,CSE 8A,A50,083650,Miranda; Gregory Joseph,17,1,56,39
1657316240241,CSE 11,A01,083080,Cao; Yingjun,6,15,40,34
1657316246264,CSE 12,A01,083652,Krause-Levy; Sophia Louisa,27,1,120,93
1657316252287,CSE 15L,A01,083654,Morris; Justin Loren,9,0,50,41
1657316252287,CSE 15L,A02,083655,Morris; Justin Loren,9,0,50,41
1657316258310,CSE 20,A01,083657,Tran; Khoa Dang,38,0,80,42
1657316264332,CSE 21,A01,095574,Bach; Quang Tran,22,0,48,26
1657316270356,CSE 30,A01,083084,Eldon; John,4,0,80,76
1657316270356,CSE 30,B01,095061,Bhaskar; Nishant,9,0,50,41
1657316276378,CSE 100,A01,083659,Cao; Yingjun,4,4,70,66
1657316282400,CSE 134B,A01,083661,Powell; Thomas Allan,21,0,100,79
1657316288422,CSE 140,A01,083663,Gungor; Onat,14,0,85,71
1657316294451,CSE 140L,A01,083088,Eldon; John,21,0,100,79
1657316300473,CSE 175,A01,083665,Kumar; Rakesh,3,0,25,22
1657316306499,CSE 190,A00,092507,Dubnov; Shlomo,7,0,20,13
1657316312521,ECE 45,A01,083139,Congero; Spencer William,6,0,75,69
1657316318542,ECE 65,A50,083695,Saad; Andrew S,12,0,30,18
1657316318542,ECE 65,A51,095125,Saad; Andrew S,25,0,26,1
1657316324568,ECE 109,A01,091882,Touri; Behrouz,19,0,70,51
1657316330609,ECE 180,A00,083140,Abi Samra; Nicholas Camill,1,0,30,29
1657316330609,ECE 180,B00,083141,Abi Samra; Nicholas Camill,0,0,30,30
1657316336634,MATH 10A,A01,083735,Patchell; Gregory David,2,0,30,28
1657316336634,MATH 10A,A02,083736,Patchell; Gregory David,20,0,30,10
1657316336634,MATH 10A,A03,083737,Patchell; Gregory David,16,0,30,14
1657316342664,MATH 10B,A01,083207,Lim; Seonhee,7,0,34,27
1657316342664,MATH 10B,A02,083208,Lim; Seonhee,9,0,35,26
1657316342664,MATH 10B,A03,093472,Lim; Seonhee,7,0,34,27
1657316342664,MATH 10B,B01,083739,Sinha; Shubham,11,0,30,19
1657316348703,MATH 18,A01,083743,Cinel; Cameron Alexander,6,0,30,24
1657316348703,MATH 18,A02,083744,Cinel; Cameron Alexander,17,0,30,13
1657316348703,MATH 18,A03,083745,Cinel; Cameron Alexander,9,0,30,21
1657316348703,MATH 18,B01,083748,Rideout; David Porter,4,0,37,33
1657316348703,MATH 18,B02,083749,Rideout; David Porter,5,0,36,31
1657316348703,MATH 18,B03,083750,Rideout; David Porter,3,0,37,34
1657316348703,MATH 18,B04,083751,Rideout; David Porter,6,0,36,30
1657316348703,MATH 18,B05,093473,Rideout; David Porter,6,0,36,30
1657316348703,MATH 18,B06,093474,Rideout; David Porter,5,0,36,31
1657316354734,MATH 20A,A01,083754,Zheng; Zequn,14,0,40,26
1657316360757,MATH 20B,A01,083756,Briones; Jor-el Thomas Caparas,4,0,36,32
1657316360757,MATH 20B,A02,083757,Briones; Jor-el Thomas Caparas,1,0,36,35
1657316360757,MATH 20B,A03,093475,Briones; Jor-el Thomas Caparas,2,0,36,34
1657316366779,MATH 20C,A01,083760,Briones; Jor-el Thomas Caparas,1,0,35,34
1657316366779,MATH 20C,A02,083761,Briones; Jor-el Thomas Caparas,8,0,35,27
1657316366779,MATH 20C,A03,093476,Briones; Jor-el Thomas Caparas,0,1,36,36
1657316366779,MATH 20C,B01,083762,Bach; Quang Tran,1,0,30,29
1657316372809,MATH 20D,A01,083765,Tran; Brian Kha,5,0,30,25
1657316372809,MATH 20D,A02,083766,Tran; Brian Kha,5,0,30,25
1657316372809,MATH 20D,A03,083767,Tran; Brian Kha,4,0,30,26
1657316378830,MATH 20E,A01,083771,Ganguly; Soumya,7,0,32,25
1657316378830,MATH 20E,A02,083772,Ganguly; Soumya,6,0,32,26
1657316378830,MATH 20E,B01,083773,Ciotti; Benjamin,19,0,35,16
1657316378830,MATH 20E,B02,083774,Ciotti; Benjamin,17,0,35,18
1657316384859,MATH 103A,A01,083777,Greenfeld; Be'Eri,3,0,36,33
1657316384859,MATH 103A,A02,083778,Greenfeld; Be'Eri,5,0,36,31
1657316384859,MATH 103A,A03,093561,Greenfeld; Be'Eri,4,0,36,32
1657316384859,MATH 103A,B01,083779,Greenfeld; Be'Eri,6,0,36,30
1657316384859,MATH 103A,B02,083780,Greenfeld; Be'Eri,4,0,36,32
1657316384859,MATH 103A,B03,093562,Greenfeld; Be'Eri,3,0,36,33
1657316390886,MATH 105,A01,085443,Carter; Anne Toulson,15,0,35,20
1657316390886,MATH 105,A02,093477,Carter; Anne Toulson,20,0,35,15
1657316396908,MATH 109,A01,083213,Ganzberger; Geoffrey Michael,2,0,34,32
1657316396908,MATH 109,A02,083214,Ganzberger; Geoffrey Michael,4,0,34,30
1657316396908,MATH 109,A03,093478,Ganzberger; Geoffrey Michael,2,0,34,32
1657316396908,MATH 109,B01,083215,Ganzberger; Geoffrey Michael,1,0,32,31
1657316396908,MATH 109,B02,083216,Ganzberger; Geoffrey Michael,1,0,32,31
1657316396908,MATH 109,B03,093479,Ganzberger; Geoffrey Michael,8,0,32,24
1657316402939,MATH 142A,A01,083219,Chow; Bennett,7,0,32,25
1657316402939,MATH 142A,A02,083220,Chow; Bennett,10,0,32,22
1657316402939,MATH 142A,A03,093480,Chow; Bennett,7,0,32,25
1657316402939,MATH 142A,B03,093481,Chow; Bennett,8,0,32,24
1657316402939,MATH 142A,B04,093558,Chow; Bennett,13,0,32,19
1657316402939,MATH 142A,B05,093559,Chow; Bennett,6,0,32,26
1657316408969,MATH 193A,A01,083224,Rotar; Vladimir,7,0,34,27
1657316408969,MATH 193A,A02,083225,Rotar; Vladimir,7,0,34,27
1657316408969,MATH 193A,A03,083781,Rotar; Vladimir,3,0,34,31
1657316408969,MATH 193A,A04,083782,Rotar; Vladimir,8,0,34,26
1657316408969,MATH 193A,A05,093482,Rotar; Vladimir,9,0,34,25
1657316414991,MATH 197,001,091859,McAuley; Julian John,9999,0,9999,0
1657316414991,MATH 197,002,095566,Kedlaya; Kiran S.,9997,0,9999,2
1657316414991,MATH 197,003,095567,Xiao; Ming,9999,0,9999,0
1657316414991,MATH 197,004,095571,Perols; Johan Lars,9998,0,9999,1
1657316422044,COGS 9,A01,083615,Shannon; Kyle Michael,8,0,75,67
1657316428066,COGS 11,A01,083617,Boyle; Mary E. T.,22,0,48,26
1657316434087,COGS 13,A01,083071,Bastos; Amalia Pinkusfeld,10,0,71,61
1657316440112,COGS 14A,A01,092681,Semenuks; Arturs,3,1,100,97
1657316446136,COGS 14B,A01,083073,Cheng; Tzu-Han,6,0,63,57
1657316452158,COGS 17,A01,092677,Semenuks; Arturs,6,0,81,75
1657316458181,COGS 100,A01,083619,Allen; Michael Gordon,16,0,70,54
1657316464204,COGS 101A,A01,083621,Davis; Joshua Daniel,9,0,68,59
1657316470226,COGS 101B,A01,091572,Allen; Michael Gordon,11,0,65,54
1657316476253,COGS 101C,A01,083625,Delgado; Tania,17,0,35,18
1657316482274,COGS 107A,A01,083627,Boyle; Mary E. T.,13,0,60,47
1657316488315,COGS 118A,A01,083075,Gupta; Anjum,18,0,76,58
1657316494337,CSE 3,A50,083646,Miranda; Gregory Joseph,24,0,50,26
1657316500365,CSE 8A,A50,083650,Miranda; Gregory Joseph,17,1,56,39
1657316506460,CSE 11,A01,083080,Cao; Yingjun,6,15,40,34
1657316512489,CSE 12,A01,083652,Krause-Levy; Sophia Louisa,27,1,120,93
1657316518514,CSE 15L,A01,083654,Morris; Justin Loren,9,0,50,41
1657316518514,CSE 15L,A02,083655,Morris; Justin Loren,9,0,50,41
1657316524554,CSE 20,A01,083657,Tran; Khoa Dang,38,0,80,42
1657316530577,CSE 21,A01,095574,Bach; Quang Tran,22,0,48,26
1657316536600,CSE 30,A01,083084,Eldon; John,4,0,80,76
1657316536600,CSE 30,B01,095061,Bhaskar; Nishant,9,0,50,41
1657316542627,CSE 100,A01,083659,Cao; Yingjun,4,4,70,66
1657316548664,CSE 134B,A01,083661,Powell; Thomas Allan,21,0,100,79
1657316554685,CSE 140,A01,083663,Gungor; Onat,14,0,85,71
1657316560711,CSE 140L,A01,083088,Eldon; John,21,0,100,79
1657316566743,CSE 175,A01,083665,Kumar; Rakesh,3,0,25,22
1657316572765,CSE 190,A00,092507,Dubnov; Shlomo,7,0,20,13
1657316578799,ECE 45,A01,083139,Congero; Spencer William,6,0,75,69
1657316584822,ECE 65,A50,083695,Saad; Andrew S,12,0,30,18
1657316584822,ECE 65,A51,095125,Saad; Andrew S,25,0,26,1
1657316590843,ECE 109,A01,091882,Touri; Behrouz,19,0,70,51
1657316596868,ECE 180,A00,083140,Abi Samra; Nicholas Camill,1,0,30,29
1657316596868,ECE 180,B00,083141,Abi Samra; Nicholas Camill,0,0,30,30
1657316602893,MATH 10A,A01,083735,Patchell; Gregory David,2,0,30,28
1657316602893,MATH 10A,A02,083736,Patchell; Gregory David,20,0,30,10
1657316602893,MATH 10A,A03,083737,Patchell; Gregory David,16,0,30,14
1657316608923,MATH 10B,A01,083207,Lim; Seonhee,7,0,34,27
1657316608923,MATH 10B,A02,083208,Lim; Seonhee,9,0,35,26
1657316608923,MATH 10B,A03,093472,Lim; Seonhee,7,0,34,27
1657316608923,MATH 10B,B01,083739,Sinha; Shubham,11,0,30,19
1657316614953,MATH 18,A01,083743,Cinel; Cameron Alexander,6,0,30,24
1657316614953,MATH 18,A02,083744,Cinel; Cameron Alexander,17,0,30,13
1657316614953,MATH 18,A03,083745,Cinel; Cameron Alexander,9,0,30,21
1657316614953,MATH 18,B01,083748,Rideout; David Porter,4,0,37,33
1657316614953,MATH 18,B02,083749,Rideout; David Porter,5,0,36,31
1657316614953,MATH 18,B03,083750,Rideout; David Porter,3,0,37,34
1657316614953,MATH 18,B04,083751,Rideout; David Porter,6,0,36,30
1657316614953,MATH 18,B05,093473,Rideout; David Porter,6,0,36,30
1657316614953,MATH 18,B06,093474,Rideout; David Porter,5,0,36,31
1657316620980,MATH 20A,A01,083754,Zheng; Zequn,14,0,40,26
1657316627004,MATH 20B,A01,083756,Briones; Jor-el Thomas Caparas,4,0,36,32
1657316627004,MATH 20B,A02,083757,Briones; Jor-el Thomas Caparas,1,0,36,35
1657316627004,MATH 20B,A03,093475,Briones; Jor-el Thomas Caparas,2,0,36,34
1657316633031,MATH 20C,A01,083760,Briones; Jor-el Thomas Caparas,1,0,35,34
1657316633031,MATH 20C,A02,083761,Briones; Jor-el Thomas Caparas,8,0,35,27
1657316633031,MATH 20C,A03,093476,Briones; Jor-el Thomas Caparas,0,1,36,36
1657316633031,MATH 20C,B01,083762,Bach; Quang Tran,1,0,30,29
1657316639053,MATH 20D,A01,083765,Tran; Brian Kha,5,0,30,25
1657316639053,MATH 20D,A02,083766,Tran; Brian Kha,5,0,30,25
1657316639053,MATH 20D,A03,083767,Tran; Brian Kha,4,0,30,26
1657316645081,MATH 20E,A01,083771,Ganguly; Soumya,7,0,32,25
1657316645081,MATH 20E,A02,083772,Ganguly; Soumya,6,0,32,26
1657316645081,MATH 20E,B01,083773,Ciotti; Benjamin,19,0,35,16
1657316645081,MATH 20E,B02,083774,Ciotti; Benjamin,17,0,35,18
1657316651112,MATH 103A,A01,083777,Greenfeld; Be'Eri,3,0,36,33
1657316651112,MATH 103A,A02,083778,Greenfeld; Be'Eri,5,0,36,31
1657316651112,MATH 103A,A03,093561,Greenfeld; Be'Eri,4,0,36,32
1657316651112,MATH 103A,B01,083779,Greenfeld; Be'Eri,6,0,36,30
1657316651112,MATH 103A,B02,083780,Greenfeld; Be'Eri,4,0,36,32
1657316651112,MATH 103A,B03,093562,Greenfeld; Be'Eri,3,0,36,33
1657316657134,MATH 105,A01,085443,Carter; Anne Toulson,15,0,35,20
1657316657134,MATH 105,A02,093477,Carter; Anne Toulson,20,0,35,15
1657316663169,MATH 109,A01,083213,Ganzberger; Geoffrey Michael,2,0,34,32
1657316663169,MATH 109,A02,083214,Ganzberger; Geoffrey Michael,4,0,34,30
1657316663169,MATH 109,A03,093478,Ganzberger; Geoffrey Michael,2,0,34,32
1657316663169,MATH 109,B01,083215,Ganzberger; Geoffrey Michael,1,0,32,31
1657316663169,MATH 109,B02,083216,Ganzberger; Geoffrey Michael,1,0,32,31
1657316663169,MATH 109,B03,093479,Ganzberger; Geoffrey Michael,8,0,32,24
1657316669191,MATH 142A,A01,083219,Chow; Bennett,7,0,32,25
1657316669191,MATH 142A,A02,083220,Chow; Bennett,10,0,32,22
1657316669191,MATH 142A,A03,093480,Chow; Bennett,7,0,32,25
1657316669191,MATH 142A,B03,093481,Chow; Bennett,8,0,32,24
1657316669191,MATH 142A,B04,093558,Chow; Bennett,13,0,32,19
1657316669191,MATH 142A,B05,093559,Chow; Bennett,6,0,32,26
1657316675219,MATH 193A,A01,083224,Rotar; Vladimir,7,0,34,27
1657316675219,MATH 193A,A02,083225,Rotar; Vladimir,7,0,34,27
1657316675219,MATH 193A,A03,083781,Rotar; Vladimir,3,0,34,31
1657316675219,MATH 193A,A04,083782,Rotar; Vladimir,8,0,34,26
1657316675219,MATH 193A,A05,093482,Rotar; Vladimir,9,0,34,25
1657316681247,MATH 197,001,091859,McAuley; Julian John,9999,0,9999,0
1657316681247,MATH 197,002,095566,Kedlaya; Kiran S.,9997,0,9999,2
1657316681247,MATH 197,003,095567,Xiao; Ming,9999,0,9999,0
1657316681247,MATH 197,004,095571,Perols; Johan Lars,9998,0,9999,1
1657316688315,COGS 9,A01,083615,Shannon; Kyle Michael,8,0,75,67
1657316694338,COGS 11,A01,083617,Boyle; Mary E. T.,22,0,48,26
1657316700365,COGS 13,A01,083071,Bastos; Amalia Pinkusfeld,10,0,71,61
1657316706391,COGS 14A,A01,092681,Semenuks; Arturs,3,1,100,97
1657316712418,COGS 14B,A01,083073,Cheng; Tzu-Han,6,0,63,57
1657316718440,COGS 17,A01,092677,Semenuks; Arturs,6,0,81,75
1657316724463,COGS 100,A01,083619,Allen; Michael Gordon,16,0,70,54
1657316730498,COGS 101A,A01,083621,Davis; Joshua Daniel,9,0,68,59
1657316736532,COGS 101B,A01,091572,Allen; Michael Gordon,11,0,65,54
1657316742555,COGS 101C,A01,083625,Delgado; Tania,17,0,35,18
1657316748582,COGS 107A,A01,083627,Boyle; Mary E. T.,13,0,60,47
1657316754607,COGS 118A,A01,083075,Gupta; Anjum,18,0,76,58
1657316760635,CSE 3,A50,083646,Miranda; Gregory Joseph,24,0,50,26
1657316766660,CSE 8A,A50,083650,Miranda; Gregory Joseph,17,1,56,39
1657316772690,CSE 11,A01,083080,Cao; Yingjun,6,15,40,34
1657316778718,CSE 12,A01,083652,Krause-Levy; Sophia Louisa,27,1,120,93
1657316784751,CSE 15L,A01,083654,Morris; Justin Loren,9,0,50,41
1657316784751,CSE 15L,A02,083655,Morris; Justin Loren,9,0,50,41
1657316790779,CSE 20,A01,083657,Tran; Khoa Dang,38,0,80,42
1657316796801,CSE 21,A01,095574,Bach; Quang Tran,22,0,48,26
1657316802828,CSE 30,A01,083084,Eldon; John,4,0,80,76
1657316802828,CSE 30,B01,095061,Bhaskar; Nishant,9,0,50,41
1657316808851,CSE 100,A01,083659,Cao; Yingjun,4,4,70,66
1657316814875,CSE 134B,A01,083661,Powell; Thomas Allan,21,0,100,79
1657316820902,CSE 140,A01,083663,Gungor; Onat,14,0,85,71
1657316826936,CSE 140L,A01,083088,Eldon; John,21,0,100,79
1657316832963,CSE 175,A01,083665,Kumar; Rakesh,3,0,25,22
1657316838992,CSE 190,A00,092507,Dubnov; Shlomo,7,0,20,13
1657316845025,ECE 45,A01,083139,Congero; Spencer William,6,0,75,69
1657316851053,ECE 65,A50,083695,Saad; Andrew S,12,0,30,18
1657316851053,ECE 65,A51,095125,Saad; Andrew S,25,0,26,1
1657316857075,ECE 109,A01,091882,Touri; Behrouz,19,0,70,51
1657316863099,ECE 180,A00,083140,Abi Samra; Nicholas Camill,1,0,30,29
1657316863099,ECE 180,B00,083141,Abi Samra; Nicholas Camill,0,0,30,30
1657316869124,MATH 10A,A01,083735,Patchell; Gregory David,2,0,30,28
1657316869124,MATH 10A,A02,083736,Patchell; Gregory David,20,0,30,10
1657316869124,MATH 10A,A03,083737,Patchell; Gregory David,16,0,30,14
1657316875153,MATH 10B,A01,083207,Lim; Seonhee,7,0,34,27
1657316875153,MATH 10B,A02,083208,Lim; Seonhee,9,0,35,26
1657316875153,MATH 10B,A03,093472,Lim; Seonhee,7,0,34,27
1657316875153,MATH 10B,B01,083739,Sinha; Shubham,11,0,30,19
1657316881176,MATH 18,A01,083743,Cinel; Cameron Alexander,6,0,30,24
1657316881176,MATH 18,A02,083744,Cinel; Cameron Alexander,17,0,30,13
1657316881176,MATH 18,A03,083745,Cinel; Cameron Alexander,9,0,30,21
1657316881176,MATH 18,B01,083748,Rideout; David Porter,4,0,37,33
1657316881176,MATH 18,B02,083749,Rideout; David Porter,5,0,36,31
1657316881176,MATH 18,B03,083750,Rideout; David Porter,3,0,37,34
1657316881176,MATH 18,B04,083751,Rideout; David Porter,6,0,36,30
1657316881176,MATH 18,B05,093473,Rideout; David Porter,6,0,36,30
1657316881176,MATH 18,B06,093474,Rideout; David Porter,5,0,36,31
1657316887201,MATH 20A,A01,083754,Zheng; Zequn,14,0,40,26
1657316893229,MATH 20B,A01,083756,Briones; Jor-el Thomas Caparas,4,0,36,32
1657316893229,MATH 20B,A02,083757,Briones; Jor-el Thomas Caparas,1,0,36,35
1657316893229,MATH 20B,A03,093475,Briones; Jor-el Thomas Caparas,2,0,36,34
1657316899251,MATH 20C,A01,083760,Briones; Jor-el Thomas Caparas,1,0,35,34
1657316899251,MATH 20C,A02,083761,Briones; Jor-el Thomas Caparas,8,0,35,27
1657316899251,MATH 20C,A03,093476,Briones; Jor-el Thomas Caparas,0,1,36,36
1657316899251,MATH 20C,B01,083762,Bach; Quang Tran,1,0,30,29
1657316905283,MATH 20D,A01,083765,Tran; Brian Kha,5,0,30,25
1657316905283,MATH 20D,A02,083766,Tran; Brian Kha,5,0,30,25
1657316905283,MATH 20D,A03,083767,Tran; Brian Kha,4,0,30,26
1657316911320,MATH 20E,A01,083771,Ganguly; Soumya,7,0,32,25
1657316911320,MATH 20E,A02,083772,Ganguly; Soumya,6,0,32,26
1657316911320,MATH 20E,B01,083773,Ciotti; Benjamin,19,0,35,16
1657316911320,MATH 20E,B02,083774,Ciotti; Benjamin,17,0,35,18
1657316917349,MATH 103A,A01,083777,Greenfeld; Be'Eri,3,0,36,33
1657316917349,MATH 103A,A02,083778,Greenfeld; Be'Eri,5,0,36,31
1657316917349,MATH 103A,A03,093561,Greenfeld; Be'Eri,4,0,36,32
1657316917349,MATH 103A,B01,083779,Greenfeld; Be'Eri,6,0,36,30
1657316917349,MATH 103A,B02,083780,Greenfeld; Be'Eri,4,0,36,32
1657316917349,MATH 103A,B03,093562,Greenfeld; Be'Eri,3,0,36,33
1657316923371,MATH 105,A01,085443,Carter; Anne Toulson,15,0,35,20
1657316923371,MATH 105,A02,093477,Carter; Anne Toulson,20,0,35,15
1657316929398,MATH 109,A01,083213,Ganzberger; Geoffrey Michael,2,0,34,32
1657316929398,MATH 109,A02,083214,Ganzberger; Geoffrey Michael,4,0,34,30
1657316929398,MATH 109,A03,093478,Ganzberger; Geoffrey Michael,2,0,34,32
1657316929398,MATH 109,B01,083215,Ganzberger; Geoffrey Michael,1,0,32,31
1657316929398,MATH 109,B02,083216,Ganzberger; Geoffrey Michael,1,0,32,31
1657316929398,MATH 109,B03,093479,Ganzberger; Geoffrey Michael,8,0,32,24
1657316935421,MATH 142A,A01,083219,Chow; Bennett,7,0,32,25
1657316935421,MATH 142A,A02,083220,Chow; Bennett,10,0,32,22
1657316935421,MATH 142A,A03,093480,Chow; Bennett,7,0,32,25
1657316935421,MATH 142A,B03,093481,Chow; Bennett,8,0,32,24
1657316935421,MATH 142A,B04,093558,Chow; Bennett,13,0,32,19
1657316935421,MATH 142A,B05,093559,Chow; Bennett,6,0,32,26
1657316941445,MATH 193A,A01,083224,Rotar; Vladimir,7,0,34,27
1657316941445,MATH 193A,A02,083225,Rotar; Vladimir,7,0,34,27
1657316941445,MATH 193A,A03,083781,Rotar; Vladimir,3,0,34,31
1657316941445,MATH 193A,A04,083782,Rotar; Vladimir,8,0,34,26
1657316941445,MATH 193A,A05,093482,Rotar; Vladimir,9,0,34,25
1657316947472,MATH 197,001,091859,McAuley; Julian John,9999,0,9999,0
1657316947472,MATH 197,002,095566,Kedlaya; Kiran S.,9997,0,9999,2
1657316947472,MATH 197,003,095567,Xiao; Ming,9999,0,9999,0
1657316947472,MATH 197,004,095571,Perols; Johan Lars,9998,0,9999,1
1657316954535,COGS 9,A01,083615,Shannon; Kyle Michael,8,0,75,67
1657316960569,COGS 11,A01,083617,Boyle; Mary E. T.,22,0,48,26
1657316966590,COGS 13,A01,083071,Bastos; Amalia Pinkusfeld,10,0,71,61
1657316972614,COGS 14A,A01,092681,Semenuks; Arturs,3,1,100,97
1657316978640,COGS 14B,A01,083073,Cheng; Tzu-Han,6,0,63,57
1657316984668,COGS 17,A01,092677,Semenuks; Arturs,6,0,81,75
1657316990692,COGS 100,A01,083619,Allen; Michael Gordon,16,0,70,54
1657316996715,COGS 101A,A01,083621,Davis; Joshua Daniel,9,0,68,59
1657317002744,COGS 101B,A01,091572,Allen; Michael Gordon,11,0,65,54
1657317008766,COGS 101C,A01,083625,Delgado; Tania,17,0,35,18
1657317014788,COGS 107A,A01,083627,Boyle; Mary E. T.,13,0,60,47
1657317020822,COGS 118A,A01,083075,Gupta; Anjum,18,0,76,58
1657317026847,CSE 3,A50,083646,Miranda; Gregory Joseph,24,0,50,26
1657317032879,CSE 8A,A50,083650,Miranda; Gregory Joseph,17,1,56,39
1657317038900,CSE 11,A01,083080,Cao; Yingjun,6,15,40,34
1657317044933,CSE 12,A01,083652,Krause-Levy; Sophia Louisa,27,1,120,93
1657317050972,CSE 15L,A01,083654,Morris; Justin Loren,9,0,50,41
1657317050972,CSE 15L,A02,083655,Morris; Justin Loren,9,0,50,41
1657317057000,CSE 20,A01,083657,Tran; Khoa Dang,38,0,80,42
1657317063022,CSE 21,A01,095574,Bach; Quang Tran,22,0,48,26
1657317069046,CSE 30,A01,083084,Eldon; John,4,0,80,76
1657317069046,CSE 30,B01,095061,Bhaskar; Nishant,9,0,50,41
1657317075070,CSE 100,A01,083659,Cao; Yingjun,4,4,70,66
1657317081094,CSE 134B,A01,083661,Powell; Thomas Allan,21,0,100,79
1657317087120,CSE 140,A01,083663,Gungor; Onat,14,0,85,71
1657317093143,CSE 140L,A01,083088,Eldon; John,21,0,100,79
1657317099168,CSE 175,A01,083665,Kumar; Rakesh,3,0,25,22
1657317105288,CSE 190,A00,092507,Dubnov; Shlomo,7,0,20,13
1657317111314,ECE 45,A01,083139,Congero; Spencer William,6,0,75,69
1657317117337,ECE 65,A50,083695,Saad; Andrew S,12,0,30,18
1657317117337,ECE 65,A51,095125,Saad; Andrew S,25,0,26,1
1657317123365,ECE 109,A01,091882,Touri; Behrouz,19,0,70,51
1657317129407,ECE 180,A00,083140,Abi Samra; Nicholas Camill,1,0,30,29
1657317129407,ECE 180,B00,083141,Abi Samra; Nicholas Camill,0,0,30,30
1657317135432,MATH 10A,A01,083735,Patchell; Gregory David,2,0,30,28
1657317135432,MATH 10A,A02,083736,Patchell; Gregory David,20,0,30,10
1657317135432,MATH 10A,A03,083737,Patchell; Gregory David,16,0,30,14
1657317141466,MATH 10B,A01,083207,Lim; Seonhee,7,0,34,27
1657317141466,MATH 10B,A02,083208,Lim; Seonhee,9,0,35,26
1657317141466,MATH 10B,A03,093472,Lim; Seonhee,7,0,34,27
1657317141466,MATH 10B,B01,083739,Sinha; Shubham,11,0,30,19
1657317147496,MATH 18,A01,083743,Cinel; Cameron Alexander,6,0,30,24
1657317147496,MATH 18,A02,083744,Cinel; Cameron Alexander,17,0,30,13
1657317147496,MATH 18,A03,083745,Cinel; Cameron Alexander,9,0,30,21
1657317147496,MATH 18,B01,083748,Rideout; David Porter,4,0,37,33
1657317147496,MATH 18,B02,083749,Rideout; David Porter,5,0,36,31
1657317147496,MATH 18,B03,083750,Rideout; David Porter,3,0,37,34
1657317147496,MATH 18,B04,083751,Rideout; David Porter,6,0,36,30
1657317147496,MATH 18,B05,093473,Rideout; David Porter,6,0,36,30
1657317147496,MATH 18,B06,093474,Rideout; David Porter,5,0,36,31
1657317159576,MATH 20A,A01,083754,Zheng; Zequn,14,0,40,26
1657317165604,MATH 20B,A01,083756,Briones; Jor-el Thomas Caparas,4,0,36,32
1657317165604,MATH 20B,A02,083757,Briones; Jor-el Thomas Caparas,1,0,36,35
1657317165604,MATH 20B,A03,093475,Briones; Jor-el Thomas Caparas,2,0,36,34
1657317171634,MATH 20C,A01,083760,Briones; Jor-el Thomas Caparas,1,0,35,34
1657317171634,MATH 20C,A02,083761,Briones; Jor-el Thomas Caparas,8,0,35,27
1657317171634,MATH 20C,A03,093476,Briones; Jor-el Thomas Caparas,0,1,36,36
1657317171634,MATH 20C,B01,083762,Bach; Quang Tran,1,0,30,29
1657317177659,MATH 20D,A01,083765,Tran; Brian Kha,5,0,30,25
1657317177659,MATH 20D,A02,083766,Tran; Brian Kha,5,0,30,25
1657317177659,MATH 20D,A03,083767,Tran; Brian Kha,4,0,30,26
1657317183690,MATH 20E,A01,083771,Ganguly; Soumya,7,0,32,25
1657317183690,MATH 20E,A02,083772,Ganguly; Soumya,6,0,32,26
1657317183690,MATH 20E,B01,083773,Ciotti; Benjamin,19,0,35,16
1657317183690,MATH 20E,B02,083774,Ciotti; Benjamin,17,0,35,18
1657317189714,MATH 103A,A01,083777,Greenfeld; Be'Eri,3,0,36,33
1657317189714,MATH 103A,A02,083778,Greenfeld; Be'Eri,5,0,36,31
1657317189714,MATH 103A,A03,093561,Greenfeld; Be'Eri,4,0,36,32
1657317189714,MATH 103A,B01,083779,Greenfeld; Be'Eri,6,0,36,30
1657317189714,MATH 103A,B02,083780,Greenfeld; Be'Eri,4,0,36,32
1657317189714,MATH 103A,B03,093562,Greenfeld; Be'Eri,3,0,36,33
1657317195746,MATH 105,A01,085443,Carter; Anne Toulson,15,0,35,20
1657317195746,MATH 105,A02,093477,Carter; Anne Toulson,20,0,35,15
1657317201772,MATH 109,A01,083213,Ganzberger; Geoffrey Michael,2,0,34,32
1657317201772,MATH 109,A02,083214,Ganzberger; Geoffrey Michael,4,0,34,30
1657317201772,MATH 109,A03,093478,Ganzberger; Geoffrey Michael,2,0,34,32
1657317201772,MATH 109,B01,083215,Ganzberger; Geoffrey Michael,1,0,32,31
1657317201772,MATH 109,B02,083216,Ganzberger; Geoffrey Michael,1,0,32,31
1657317201772,MATH 109,B03,093479,Ganzberger; Geoffrey Michael,8,0,32,24
1657317207803,MATH 142A,A01,083219,Chow; Bennett,7,0,32,25
1657317207803,MATH 142A,A02,083220,Chow; Bennett,10,0,32,22
1657317207803,MATH 142A,A03,093480,Chow; Bennett,7,0,32,25
1657317207803,MATH 142A,B03,093481,Chow; Bennett,8,0,32,24
1657317207803,MATH 142A,B04,093558,Chow; Bennett,13,0,32,19
1657317207803,MATH 142A,B05,093559,Chow; Bennett,6,0,32,26
1657317213828,MATH 193A,A01,083224,Rotar; Vladimir,7,0,34,27
1657317213828,MATH 193A,A02,083225,Rotar; Vladimir,7,0,34,27
1657317213828,MATH 193A,A03,083781,Rotar; Vladimir,3,0,34,31
1657317213828,MATH 193A,A04,083782,Rotar; Vladimir,8,0,34,26
1657317213828,MATH 193A,A05,093482,Rotar; Vladimir,9,0,34,25
1657317219854,MATH 197,001,091859,McAuley; Julian John,9999,0,9999,0
1657317219854,MATH 197,002,095566,Kedlaya; Kiran S.,9997,0,9999,2
1657317219854,MATH 197,003,095567,Xiao; Ming,9999,0,9999,0
1657317219854,MATH 197,004,095571,Perols; Johan Lars,9998,0,9999,1
1657317226917,COGS 9,A01,083615,Shannon; Kyle Michael,8,0,75,67
1657317232942,COGS 11,A01,083617,Boyle; Mary E. T.,22,0,48,26
1657317238965,COGS 13,A01,083071,Bastos; Amalia Pinkusfeld,10,0,71,61
1657317244987,COGS 14A,A01,092681,Semenuks; Arturs,3,1,100,97
1657317251019,COGS 14B,A01,083073,Cheng; Tzu-Han,6,0,63,57
1657317257046,COGS 17,A01,092677,Semenuks; Arturs,6,0,81,75
1657317263076,COGS 100,A01,083619,Allen; Michael Gordon,16,0,70,54
1657317269099,COGS 101A,A01,083621,Davis; Joshua Daniel,9,0,68,59
1657317275125,COGS 101B,A01,091572,Allen; Michael Gordon,11,0,65,54
1657317281158,COGS 101C,A01,083625,Delgado; Tania,17,0,35,18
1657317287181,COGS 107A,A01,083627,Boyle; Mary E. T.,13,0,60,47
1657317293215,COGS 118A,A01,083075,Gupta; Anjum,18,0,76,58
1657317299243,CSE 3,A50,083646,Miranda; Gregory Joseph,24,0,50,26
1657317305273,CSE 8A,A50,083650,Miranda; Gregory Joseph,17,1,56,39
1657317311296,CSE 11,A01,083080,Cao; Yingjun,6,15,40,34
1657317317322,CSE 12,A01,083652,Krause-Levy; Sophia Louisa,27,1,120,93
1657317323348,CSE 15L,A01,083654,Morris; Justin Loren,9,0,50,41
1657317323348,CSE 15L,A02,083655,Morris; Justin Loren,9,0,50,41
1657317329375,CSE 20,A01,083657,Tran; Khoa Dang,38,0,80,42
1657317335401,CSE 21,A01,095574,Bach; Quang Tran,22,0,48,26
1657317341425,CSE 30,A01,083084,Eldon; John,4,0,80,76
1657317341425,CSE 30,B01,095061,Bhaskar; Nishant,9,0,50,41
1657317347453,CSE 100,A01,083659,Cao; Yingjun,4,4,70,66
1657317353480,CSE 134B,A01,083661,Powell; Thomas Allan,21,0,100,79
1657317359503,CSE 140,A01,083663,Gungor; Onat,14,0,85,71
1657317365527,CSE 140L,A01,083088,Eldon; John,21,0,100,79
1657317371561,CSE 175,A01,083665,Kumar; Rakesh,3,0,25,22
1657317377584,CSE 190,A00,092507,Dubnov; Shlomo,7,0,20,13
1657317383608,ECE 45,A01,083139,Congero; Spencer William,6,0,75,69
1657317389632,ECE 65,A50,083695,Saad; Andrew S,12,0,30,18
1657317389632,ECE 65,A51,095125,Saad; Andrew S,25,0,26,1
1657317395654,ECE 109,A01,091882,Touri; Behrouz,19,0,70,51
1657317401680,ECE 180,A00,083140,Abi Samra; Nicholas Camill,1,0,30,29
1657317401680,ECE 180,B00,083141,Abi Samra; Nicholas Camill,0,0,30,30
1657317407708,MATH 10A,A01,083735,Patchell; Gregory David,2,0,30,28
1657317407708,MATH 10A,A02,083736,Patchell; Gregory David,20,0,30,10
1657317407708,MATH 10A,A03,083737,Patchell; Gregory David,16,0,30,14
1657317413738,MATH 10B,A01,083207,Lim; Seonhee,7,0,34,27
1657317413738,MATH 10B,A02,083208,Lim; Seonhee,9,0,35,26
1657317413738,MATH 10B,A03,093472,Lim; Seonhee,7,0,34,27
1657317413738,MATH 10B,B01,083739,Sinha; Shubham,11,0,30,19
1657317419765,MATH 18,A01,083743,Cinel; Cameron Alexander,6,0,30,24
1657317419765,MATH 18,A02,083744,Cinel; Cameron Alexander,17,0,30,13
1657317419765,MATH 18,A03,083745,Cinel; Cameron Alexander,9,0,30,21
1657317419765,MATH 18,B01,083748,Rideout; David Porter,4,0,37,33
1657317419765,MATH 18,B02,083749,Rideout; David Porter,5,0,36,31
1657317419765,MATH 18,B03,083750,Rideout; David Porter,3,0,37,34
1657317419765,MATH 18,B04,083751,Rideout; David Porter,6,0,36,30
1657317419765,MATH 18,B05,093473,Rideout; David Porter,6,0,36,30
1657317419765,MATH 18,B06,093474,Rideout; David Porter,5,0,36,31
1657317425789,MATH 20A,A01,083754,Zheng; Zequn,14,0,40,26
1657317431812,MATH 20B,A01,083756,Briones; Jor-el Thomas Caparas,4,0,36,32
1657317431812,MATH 20B,A02,083757,Briones; Jor-el Thomas Caparas,1,0,36,35
1657317431812,MATH 20B,A03,093475,Briones; Jor-el Thomas Caparas,2,0,36,34
1657317437841,MATH 20C,A01,083760,Briones; Jor-el Thomas Caparas,1,0,35,34
1657317437841,MATH 20C,A02,083761,Briones; Jor-el Thomas Caparas,8,0,35,27
1657317437841,MATH 20C,A03,093476,Briones; Jor-el Thomas Caparas,0,1,36,36
1657317437841,MATH 20C,B01,083762,Bach; Quang Tran,1,0,30,29
1657317443866,MATH 20D,A01,083765,Tran; Brian Kha,5,0,30,25
1657317443866,MATH 20D,A02,083766,Tran; Brian Kha,5,0,30,25
1657317443866,MATH 20D,A03,083767,Tran; Brian Kha,4,0,30,26
1657317449897,MATH 20E,A01,083771,Ganguly; Soumya,7,0,32,25
1657317449897,MATH 20E,A02,083772,Ganguly; Soumya,6,0,32,26
1657317449897,MATH 20E,B01,083773,Ciotti; Benjamin,19,0,35,16
1657317449897,MATH 20E,B02,083774,Ciotti; Benjamin,17,0,35,18
1657317455921,MATH 103A,A01,083777,Greenfeld; Be'Eri,3,0,36,33
1657317455921,MATH 103A,A02,083778,Greenfeld; Be'Eri,5,0,36,31
1657317455921,MATH 103A,A03,093561,Greenfeld; Be'Eri,4,0,36,32
1657317455921,MATH 103A,B01,083779,Greenfeld; Be'Eri,6,0,36,30
1657317455921,MATH 103A,B02,083780,Greenfeld; Be'Eri,4,0,36,32
1657317455921,MATH 103A,B03,093562,Greenfeld; Be'Eri,3,0,36,33
1657317461944,MATH 105,A01,085443,Carter; Anne Toulson,15,0,35,20
1657317461944,MATH 105,A02,093477,Carter; Anne Toulson,20,0,35,15
1657317467975,MATH 109,A01,083213,Ganzberger; Geoffrey Michael,2,0,34,32
1657317467975,MATH 109,A02,083214,Ganzberger; Geoffrey Michael,4,0,34,30
1657317467975,MATH 109,A03,093478,Ganzberger; Geoffrey Michael,2,0,34,32
1657317467975,MATH 109,B01,083215,Ganzberger; Geoffrey Michael,1,0,32,31
1657317467975,MATH 109,B02,083216,Ganzberger; Geoffrey Michael,1,0,32,31
1657317467975,MATH 109,B03,093479,Ganzberger; Geoffrey Michael,8,0,32,24
1657317474004,MATH 142A,A01,083219,Chow; Bennett,7,0,32,25
1657317474004,MATH 142A,A02,083220,Chow; Bennett,10,0,32,22
1657317474004,MATH 142A,A03,093480,Chow; Bennett,7,0,32,25
1657317474004,MATH 142A,B03,093481,Chow; Bennett,8,0,32,24
1657317474004,MATH 142A,B04,093558,Chow; Bennett,13,0,32,19
1657317474004,MATH 142A,B05,093559,Chow; Bennett,6,0,32,26
1657317480028,MATH 193A,A01,083224,Rotar; Vladimir,7,0,34,27
1657317480028,MATH 193A,A02,083225,Rotar; Vladimir,7,0,34,27
1657317480028,MATH 193A,A03,083781,Rotar; Vladimir,3,0,34,31
1657317480028,MATH 193A,A04,083782,Rotar; Vladimir,8,0,34,26
1657317480028,MATH 193A,A05,093482,Rotar; Vladimir,9,0,34,25
1657317486056,MATH 197,001,091859,McAuley; Julian John,9999,0,9999,0
1657317486056,MATH 197,002,095566,Kedlaya; Kiran S.,9997,0,9999,2
1657317486056,MATH 197,003,095567,Xiao; Ming,9999,0,9999,0
1657317486056,MATH 197,004,095571,Perols; Johan Lars,9998,0,9999,1
1657317493112,COGS 9,A01,083615,Shannon; Kyle Michael,8,0,75,67
1657317499134,COGS 11,A01,083617,Boyle; Mary E. T.,22,0,48,26
1657317505157,COGS 13,A01,083071,Bastos; Amalia Pinkusfeld,10,0,71,61
1657317511191,COGS 14A,A01,092681,Semenuks; Arturs,3,1,100,97
1657317517218,COGS 14B,A01,083073,Cheng; Tzu-Han,6,0,63,57
1657317523251,COGS 17,A01,092677,Semenuks; Arturs,6,0,81,75
1657317529273,COGS 100,A01,083619,Allen; Michael Gordon,16,0,70,54
1657317535296,COGS 101A,A01,083621,Davis; Joshua Daniel,9,0,68,59
1657317541319,COGS 101B,A01,091572,Allen; Michael Gordon,11,0,65,54
1657317547349,COGS 101C,A01,083625,Delgado; Tania,17,0,35,18
1657317553374,COGS 107A,A01,083627,Boyle; Mary E. T.,13,0,60,47
1657317559400,COGS 118A,A01,083075,Gupta; Anjum,18,0,76,58
1657317565437,CSE 3,A50,083646,Miranda; Gregory Joseph,24,0,50,26
1657317571462,CSE 8A,A50,083650,Miranda; Gregory Joseph,17,1,56,39
1657317577486,CSE 11,A01,083080,Cao; Yingjun,6,15,40,34
1657317583509,CSE 12,A01,083652,Krause-Levy; Sophia Louisa,27,1,120,93
1657317589542,CSE 15L,A01,083654,Morris; Justin Loren,9,0,50,41
1657317589542,CSE 15L,A02,083655,Morris; Justin Loren,9,0,50,41
1657317595565,CSE 20,A01,083657,Tran; Khoa Dang,38,0,80,42
1657317601587,CSE 21,A01,095574,Bach; Quang Tran,22,0,48,26
1657317607614,CSE 30,A01,083084,Eldon; John,4,0,80,76
1657317607614,CSE 30,B01,095061,Bhaskar; Nishant,9,0,50,41
1657317613639,CSE 100,A01,083659,Cao; Yingjun,4,4,70,66
1657317619667,CSE 134B,A01,083661,Powell; Thomas Allan,22,0,100,78
1657317625702,CSE 140,A01,083663,Gungor; Onat,14,0,85,71
1657317631725,CSE 140L,A01,083088,Eldon; John,21,0,100,79
1657317637758,CSE 175,A01,083665,Kumar; Rakesh,3,0,25,22
1657317643791,CSE 190,A00,092507,Dubnov; Shlomo,7,0,20,13
1657317649812,ECE 45,A01,083139,Congero; Spencer William,6,0,75,69
1657317655838,ECE 65,A50,083695,Saad; Andrew S,12,0,30,18
1657317655838,ECE 65,A51,095125,Saad; Andrew S,25,0,26,1
1657317661863,ECE 109,A01,091882,Touri; Behrouz,19,0,70,51
1657317667895,ECE 180,A00,083140,Abi Samra; Nicholas Camill,1,0,30,29
1657317667895,ECE 180,B00,083141,Abi Samra; Nicholas Camill,0,0,30,30
1657317673923,MATH 10A,A01,083735,Patchell; Gregory David,2,0,30,28
1657317673923,MATH 10A,A02,083736,Patchell; Gregory David,20,0,30,10
1657317673923,MATH 10A,A03,083737,Patchell; Gregory David,16,0,30,14
1657317679947,MATH 10B,A01,083207,Lim; Seonhee,7,0,34,27
1657317679947,MATH 10B,A02,083208,Lim; Seonhee,9,0,35,26
1657317679947,MATH 10B,A03,093472,Lim; Seonhee,7,0,34,27
1657317679947,MATH 10B,B01,083739,Sinha; Shubham,11,0,30,19
1657317685970,MATH 18,A01,083743,Cinel; Cameron Alexander,6,0,30,24
1657317685970,MATH 18,A02,083744,Cinel; Cameron Alexander,17,0,30,13
1657317685970,MATH 18,A03,083745,Cinel; Cameron Alexander,9,0,30,21
1657317685970,MATH 18,B01,083748,Rideout; David Porter,4,0,37,33
1657317685970,MATH 18,B02,083749,Rideout; David Porter,5,0,36,31
1657317685970,MATH 18,B03,083750,Rideout; David Porter,3,0,37,34
1657317685970,MATH 18,B04,083751,Rideout; David Porter,6,0,36,30
1657317685970,MATH 18,B05,093473,Rideout; David Porter,6,0,36,30
1657317685970,MATH 18,B06,093474,Rideout; David Porter,5,0,36,31
1657317691995,MATH 20A,A01,083754,Zheng; Zequn,14,0,40,26
1657317698046,MATH 20B,A01,083756,Briones; Jor-el Thomas Caparas,4,0,36,32
1657317698046,MATH 20B,A02,083757,Briones; Jor-el Thomas Caparas,1,0,36,35
1657317698046,MATH 20B,A03,093475,Briones; Jor-el Thomas Caparas,2,0,36,34
1657317704089,MATH 20C,A01,083760,Briones; Jor-el Thomas Caparas,1,0,35,34
1657317704089,MATH 20C,A02,083761,Briones; Jor-el Thomas Caparas,8,0,35,27
1657317704089,MATH 20C,A03,093476,Briones; Jor-el Thomas Caparas,0,1,36,36
1657317704089,MATH 20C,B01,083762,Bach; Quang Tran,1,0,30,29
1657317710187,MATH 20D,A01,083765,Tran; Brian Kha,5,0,30,25
1657317710187,MATH 20D,A02,083766,Tran; Brian Kha,5,0,30,25
1657317710187,MATH 20D,A03,083767,Tran; Brian Kha,4,0,30,26
1657317716216,MATH 20E,A01,083771,Ganguly; Soumya,7,0,32,25
1657317716216,MATH 20E,A02,083772,Ganguly; Soumya,6,0,32,26
1657317716216,MATH 20E,B01,083773,Ciotti; Benjamin,19,0,35,16
1657317716216,MATH 20E,B02,083774,Ciotti; Benjamin,17,0,35,18
1657317722246,MATH 103A,A01,083777,Greenfeld; Be'Eri,3,0,36,33
1657317722246,MATH 103A,A02,083778,Greenfeld; Be'Eri,5,0,36,31
1657317722246,MATH 103A,A03,093561,Greenfeld; Be'Eri,4,0,36,32
1657317722246,MATH 103A,B01,083779,Greenfeld; Be'Eri,6,0,36,30
1657317722246,MATH 103A,B02,083780,Greenfeld; Be'Eri,4,0,36,32
1657317722246,MATH 103A,B03,093562,Greenfeld; Be'Eri,3,0,36,33
1657317728273,MATH 105,A01,085443,Carter; Anne Toulson,15,0,35,20
1657317728273,MATH 105,A02,093477,Carter; Anne Toulson,20,0,35,15
1657317734299,MATH 109,A01,083213,Ganzberger; Geoffrey Michael,2,0,34,32
1657317734299,MATH 109,A02,083214,Ganzberger; Geoffrey Michael,4,0,34,30
1657317734299,MATH 109,A03,093478,Ganzberger; Geoffrey Michael,2,0,34,32
1657317734299,MATH 109,B01,083215,Ganzberger; Geoffrey Michael,1,0,32,31
1657317734299,MATH 109,B02,083216,Ganzberger; Geoffrey Michael,1,0,32,31
1657317734299,MATH 109,B03,093479,Ganzberger; Geoffrey Michael,8,0,32,24
1657317740323,MATH 142A,A01,083219,Chow; Bennett,7,0,32,25
1657317740323,MATH 142A,A02,083220,Chow; Bennett,10,0,32,22
1657317740323,MATH 142A,A03,093480,Chow; Bennett,7,0,32,25
1657317740323,MATH 142A,B03,093481,Chow; Bennett,8,0,32,24
1657317740323,MATH 142A,B04,093558,Chow; Bennett,13,0,32,19
1657317740323,MATH 142A,B05,093559,Chow; Bennett,6,0,32,26
1657317746350,MATH 193A,A01,083224,Rotar; Vladimir,7,0,34,27
1657317746350,MATH 193A,A02,083225,Rotar; Vladimir,7,0,34,27
1657317746350,MATH 193A,A03,083781,Rotar; Vladimir,3,0,34,31
1657317746350,MATH 193A,A04,083782,Rotar; Vladimir,8,0,34,26
1657317746350,MATH 193A,A05,093482,Rotar; Vladimir,9,0,34,25
1657317752382,MATH 197,001,091859,McAuley; Julian John,9999,0,9999,0
1657317752382,MATH 197,002,095566,Kedlaya; Kiran S.,9997,0,9999,2
1657317752382,MATH 197,003,095567,Xiao; Ming,9999,0,9999,0
1657317752382,MATH 197,004,095571,Perols; Johan Lars,9998,0,9999,1
1657317759449,COGS 9,A01,083615,Shannon; Kyle Michael,8,0,75,67
1657317765484,COGS 11,A01,083617,Boyle; Mary E. T.,22,0,48,26
1657317771507,COGS 13,A01,083071,Bastos; Amalia Pinkusfeld,10,0,71,61
1657317777534,COGS 14A,A01,092681,Semenuks; Arturs,3,1,100,97
1657317783556,COGS 14B,A01,083073,Cheng; Tzu-Han,6,0,63,57
1657317789579,COGS 17,A01,092677,Semenuks; Arturs,6,0,81,75
1657317795605,COGS 100,A01,083619,Allen; Michael Gordon,16,0,70,54
1657317801639,COGS 101A,A01,083621,Davis; Joshua Daniel,9,0,68,59
1657317807667,COGS 101B,A01,091572,Allen; Michael Gordon,11,0,65,54
1657317813692,COGS 101C,A01,083625,Delgado; Tania,17,0,35,18
1657317819714,COGS 107A,A01,083627,Boyle; Mary E. T.,13,0,60,47
1657317825739,COGS 118A,A01,083075,Gupta; Anjum,18,0,76,58
1657317831763,CSE 3,A50,083646,Miranda; Gregory Joseph,24,0,50,26
1657317837784,CSE 8A,A50,083650,Miranda; Gregory Joseph,17,1,56,39
1657317843811,CSE 11,A01,083080,Cao; Yingjun,6,15,40,34
1657317849836,CSE 12,A01,083652,Krause-Levy; Sophia Louisa,28,1,120,92
1657317855872,CSE 15L,A01,083654,Morris; Justin Loren,9,0,50,41
1657317855872,CSE 15L,A02,083655,Morris; Justin Loren,9,0,50,41
1657317861898,CSE 20,A01,083657,Tran; Khoa Dang,38,0,80,42
1657317867925,CSE 21,A01,095574,Bach; Quang Tran,22,0,48,26
1657317873953,CSE 30,A01,083084,Eldon; John,4,0,80,76
1657317873953,CSE 30,B01,095061,Bhaskar; Nishant,9,0,50,41
1657317879976,CSE 100,A01,083659,Cao; Yingjun,4,4,70,66
1657317886000,CSE 134B,A01,083661,Powell; Thomas Allan,22,0,100,78
1657317892024,CSE 140,A01,083663,Gungor; Onat,14,0,85,71
1657317898051,CSE 140L,A01,083088,Eldon; John,21,0,100,79
1657317904078,CSE 175,A01,083665,Kumar; Rakesh,3,0,25,22
1657317910101,CSE 190,A00,092507,Dubnov; Shlomo,7,0,20,13
1657317916128,ECE 45,A01,083139,Congero; Spencer William,6,0,75,69
1657317922160,ECE 65,A50,083695,Saad; Andrew S,12,0,30,18
1657317922160,ECE 65,A51,095125,Saad; Andrew S,25,0,26,1
1657317928184,ECE 109,A01,091882,Touri; Behrouz,19,0,70,51
1657317934216,ECE 180,A00,083140,Abi Samra; Nicholas Camill,1,0,30,29
1657317934216,ECE 180,B00,083141,Abi Samra; Nicholas Camill,0,0,30,30
1657317940243,MATH 10A,A01,083735,Patchell; Gregory David,2,0,30,28
1657317940243,MATH 10A,A02,083736,Patchell; Gregory David,20,0,30,10
1657317940243,MATH 10A,A03,083737,Patchell; Gregory David,16,0,30,14
1657317946265,MATH 10B,A01,083207,Lim; Seonhee,7,0,34,27
1657317946265,MATH 10B,A02,083208,Lim; Seonhee,9,0,35,26
1657317946265,MATH 10B,A03,093472,Lim; Seonhee,7,0,34,27
1657317946265,MATH 10B,B01,083739,Sinha; Shubham,11,0,30,19
1657317952291,MATH 18,A01,083743,Cinel; Cameron Alexander,6,0,30,24
1657317952291,MATH 18,A02,083744,Cinel; Cameron Alexander,17,0,30,13
1657317952291,MATH 18,A03,083745,Cinel; Cameron Alexander,9,0,30,21
1657317952291,MATH 18,B01,083748,Rideout; David Porter,4,0,37,33
1657317952291,MATH 18,B02,083749,Rideout; David Porter,5,0,36,31
1657317952291,MATH 18,B03,083750,Rideout; David Porter,3,0,37,34
1657317952291,MATH 18,B04,083751,Rideout; David Porter,6,0,36,30
1657317952291,MATH 18,B05,093473,Rideout; David Porter,6,0,36,30
1657317952291,MATH 18,B06,093474,Rideout; David Porter,5,0,36,31
1657317958315,MATH 20A,A01,083754,Zheng; Zequn,14,0,40,26
1657317964338,MATH 20B,A01,083756,Briones; Jor-el Thomas Caparas,4,0,36,32
1657317964338,MATH 20B,A02,083757,Briones; Jor-el Thomas Caparas,1,0,36,35
1657317964338,MATH 20B,A03,093475,Briones; Jor-el Thomas Caparas,2,0,36,34
1657317970366,MATH 20C,A01,083760,Briones; Jor-el Thomas Caparas,1,0,35,34
1657317970366,MATH 20C,A02,083761,Briones; Jor-el Thomas Caparas,8,0,35,27
1657317970366,MATH 20C,A03,093476,Briones; Jor-el Thomas Caparas,0,1,36,36
1657317970366,MATH 20C,B01,083762,Bach; Quang Tran,1,0,30,29
1657317976394,MATH 20D,A01,083765,Tran; Brian Kha,5,0,30,25
1657317976394,MATH 20D,A02,083766,Tran; Brian Kha,5,0,30,25
1657317976394,MATH 20D,A03,083767,Tran; Brian Kha,4,0,30,26
1657317982419,MATH 20E,A01,083771,Ganguly; Soumya,7,0,32,25
1657317982419,MATH 20E,A02,083772,Ganguly; Soumya,6,0,32,26
1657317982419,MATH 20E,B01,083773,Ciotti; Benjamin,19,0,35,16
1657317982419,MATH 20E,B02,083774,Ciotti; Benjamin,17,0,35,18
1657317988457,MATH 103A,A01,083777,Greenfeld; Be'Eri,3,0,36,33
1657317988457,MATH 103A,A02,083778,Greenfeld; Be'Eri,5,0,36,31
1657317988457,MATH 103A,A03,093561,Greenfeld; Be'Eri,4,0,36,32
1657317988457,MATH 103A,B01,083779,Greenfeld; Be'Eri,6,0,36,30
1657317988457,MATH 103A,B02,083780,Greenfeld; Be'Eri,4,0,36,32
1657317988457,MATH 103A,B03,093562,Greenfeld; Be'Eri,3,0,36,33
1657317994486,MATH 105,A01,085443,Carter; Anne Toulson,15,0,35,20
1657317994486,MATH 105,A02,093477,Carter; Anne Toulson,20,0,35,15
1657318000528,MATH 109,A01,083213,Ganzberger; Geoffrey Michael,2,0,34,32
1657318000528,MATH 109,A02,083214,Ganzberger; Geoffrey Michael,4,0,34,30
1657318000528,MATH 109,A03,093478,Ganzberger; Geoffrey Michael,2,0,34,32
1657318000528,MATH 109,B01,083215,Ganzberger; Geoffrey Michael,1,0,32,31
1657318000528,MATH 109,B02,083216,Ganzberger; Geoffrey Michael,1,0,32,31
1657318000528,MATH 109,B03,093479,Ganzberger; Geoffrey Michael,8,0,32,24
1657318006554,MATH 142A,A01,083219,Chow; Bennett,7,0,32,25
1657318006554,MATH 142A,A02,083220,Chow; Bennett,10,0,32,22
1657318006554,MATH 142A,A03,093480,Chow; Bennett,7,0,32,25
1657318006554,MATH 142A,B03,093481,Chow; Bennett,8,0,32,24
1657318006554,MATH 142A,B04,093558,Chow; Bennett,13,0,32,19
1657318006554,MATH 142A,B05,093559,Chow; Bennett,6,0,32,26
1657318012584,MATH 193A,A01,083224,Rotar; Vladimir,7,0,34,27
1657318012584,MATH 193A,A02,083225,Rotar; Vladimir,7,0,34,27
1657318012584,MATH 193A,A03,083781,Rotar; Vladimir,3,0,34,31
1657318012584,MATH 193A,A04,083782,Rotar; Vladimir,8,0,34,26
1657318012584,MATH 193A,A05,093482,Rotar; Vladimir,9,0,34,25
1657318018609,MATH 197,001,091859,McAuley; Julian John,9999,0,9999,0
1657318018609,MATH 197,002,095566,Kedlaya; Kiran S.,9997,0,9999,2
1657318018609,MATH 197,003,095567,Xiao; Ming,9999,0,9999,0
1657318018609,MATH 197,004,095571,Perols; Johan Lars,9998,0,9999,1
1657318025675,COGS 9,A01,083615,Shannon; Kyle Michael,8,0,75,67
1657318031697,COGS 11,A01,083617,Boyle; Mary E. T.,22,0,48,26
1657318037721,COGS 13,A01,083071,Bastos; Amalia Pinkusfeld,10,0,71,61
1657318043747,COGS 14A,A01,092681,Semenuks; Arturs,3,1,100,97
1657318049774,COGS 14B,A01,083073,Cheng; Tzu-Han,6,0,63,57
1657318055818,COGS 17,A01,092677,Semenuks; Arturs,6,0,81,75
1657318061848,COGS 100,A01,083619,Allen; Michael Gordon,16,0,70,54
1657318067873,COGS 101A,A01,083621,Davis; Joshua Daniel,9,0,68,59
1657318073897,COGS 101B,A01,091572,Allen; Michael Gordon,11,0,65,54
1657318079924,COGS 101C,A01,083625,Delgado; Tania,17,0,35,18
1657318085955,COGS 107A,A01,083627,Boyle; Mary E. T.,13,0,60,47
1657318091985,COGS 118A,A01,083075,Gupta; Anjum,18,0,76,58
1657318098009,CSE 3,A50,083646,Miranda; Gregory Joseph,24,0,50,26
1657318104041,CSE 8A,A50,083650,Miranda; Gregory Joseph,17,1,56,39
1657318110068,CSE 11,A01,083080,Cao; Yingjun,6,15,40,34
1657318116094,CSE 12,A01,083652,Krause-Levy; Sophia Louisa,28,1,120,92
1657318122117,CSE 15L,A01,083654,Morris; Justin Loren,9,0,50,41
1657318122117,CSE 15L,A02,083655,Morris; Justin Loren,9,0,50,41
1657318128144,CSE 20,A01,083657,Tran; Khoa Dang,38,0,80,42
1657318134167,CSE 21,A01,095574,Bach; Quang Tran,22,0,48,26
1657318140193,CSE 30,A01,083084,Eldon; John,4,0,80,76
1657318140193,CSE 30,B01,095061,Bhaskar; Nishant,9,0,50,41
1657318146215,CSE 100,A01,083659,Cao; Yingjun,4,4,70,66
1657318152238,CSE 134B,A01,083661,Powell; Thomas Allan,22,0,100,78
1657318158278,CSE 140,A01,083663,Gungor; Onat,14,0,85,71
1657318164302,CSE 140L,A01,083088,Eldon; John,21,0,100,79
1657318170332,CSE 175,A01,083665,Kumar; Rakesh,3,0,25,22
1657318176359,CSE 190,A00,092507,Dubnov; Shlomo,7,0,20,13
1657318182382,ECE 45,A01,083139,Congero; Spencer William,6,0,75,69
1657318188410,ECE 65,A50,083695,Saad; Andrew S,12,0,30,18
1657318188410,ECE 65,A51,095125,Saad; Andrew S,25,0,26,1
1657318194434,ECE 109,A01,091882,Touri; Behrouz,19,0,70,51
1657318200471,ECE 180,A00,083140,Abi Samra; Nicholas Camill,1,0,30,29
1657318200471,ECE 180,B00,083141,Abi Samra; Nicholas Camill,0,0,30,30
1657318206498,MATH 10A,A01,083735,Patchell; Gregory David,2,0,30,28
1657318206498,MATH 10A,A02,083736,Patchell; Gregory David,20,0,30,10
1657318206498,MATH 10A,A03,083737,Patchell; Gregory David,16,0,30,14
1657318212522,MATH 10B,A01,083207,Lim; Seonhee,7,0,34,27
1657318212522,MATH 10B,A02,083208,Lim; Seonhee,9,0,35,26
1657318212522,MATH 10B,A03,093472,Lim; Seonhee,7,0,34,27
1657318212522,MATH 10B,B01,083739,Sinha; Shubham,11,0,30,19
1657318218565,MATH 18,A01,083743,Cinel; Cameron Alexander,6,0,30,24
1657318218565,MATH 18,A02,083744,Cinel; Cameron Alexander,17,0,30,13
1657318218565,MATH 18,A03,083745,Cinel; Cameron Alexander,9,0,30,21
1657318218565,MATH 18,B01,083748,Rideout; David Porter,4,0,37,33
1657318218565,MATH 18,B02,083749,Rideout; David Porter,5,0,36,31
1657318218565,MATH 18,B03,083750,Rideout; David Porter,3,0,37,34
1657318218565,MATH 18,B04,083751,Rideout; David Porter,6,0,36,30
1657318218565,MATH 18,B05,093473,Rideout; David Porter,6,0,36,30
1657318218565,MATH 18,B06,093474,Rideout; David Porter,5,0,36,31
1657318224591,MATH 20A,A01,083754,Zheng; Zequn,14,0,40,26
1657318230615,MATH 20B,A01,083756,Briones; Jor-el Thomas Caparas,4,0,36,32
1657318230615,MATH 20B,A02,083757,Briones; Jor-el Thomas Caparas,1,0,36,35
1657318230615,MATH 20B,A03,093475,Briones; Jor-el Thomas Caparas,2,0,36,34
1657318236641,MATH 20C,A01,083760,Briones; Jor-el Thomas Caparas,1,0,35,34
1657318236641,MATH 20C,A02,083761,Briones; Jor-el Thomas Caparas,8,0,35,27
1657318236641,MATH 20C,A03,093476,Briones; Jor-el Thomas Caparas,0,1,36,36
1657318236641,MATH 20C,B01,083762,Bach; Quang Tran,1,0,30,29
1657318242677,MATH 20D,A01,083765,Tran; Brian Kha,5,0,30,25
1657318242677,MATH 20D,A02,083766,Tran; Brian Kha,5,0,30,25
1657318242677,MATH 20D,A03,083767,Tran; Brian Kha,4,0,30,26
1657318248710,MATH 20E,A01,083771,Ganguly; Soumya,7,0,32,25
1657318248710,MATH 20E,A02,083772,Ganguly; Soumya,6,0,32,26
1657318248710,MATH 20E,B01,083773,Ciotti; Benjamin,19,0,35,16
1657318248710,MATH 20E,B02,083774,Ciotti; Benjamin,17,0,35,18
1657318254739,MATH 103A,A01,083777,Greenfeld; Be'Eri,3,0,36,33
1657318254739,MATH 103A,A02,083778,Greenfeld; Be'Eri,5,0,36,31
1657318254739,MATH 103A,A03,093561,Greenfeld; Be'Eri,4,0,36,32
1657318254739,MATH 103A,B01,083779,Greenfeld; Be'Eri,6,0,36,30
1657318254739,MATH 103A,B02,083780,Greenfeld; Be'Eri,4,0,36,32
1657318254739,MATH 103A,B03,093562,Greenfeld; Be'Eri,3,0,36,33
1657318260765,MATH 105,A01,085443,Carter; Anne Toulson,15,0,35,20
1657318260765,MATH 105,A02,093477,Carter; Anne Toulson,20,0,35,15
1657318266789,MATH 109,A01,083213,Ganzberger; Geoffrey Michael,2,0,34,32
1657318266789,MATH 109,A02,083214,Ganzberger; Geoffrey Michael,4,0,34,30
1657318266789,MATH 109,A03,093478,Ganzberger; Geoffrey Michael,2,0,34,32
1657318266789,MATH 109,B01,083215,Ganzberger; Geoffrey Michael,1,0,32,31
1657318266789,MATH 109,B02,083216,Ganzberger; Geoffrey Michael,1,0,32,31
1657318266789,MATH 109,B03,093479,Ganzberger; Geoffrey Michael,8,0,32,24
1657318272819,MATH 142A,A01,083219,Chow; Bennett,7,0,32,25
1657318272819,MATH 142A,A02,083220,Chow; Bennett,10,0,32,22
1657318272819,MATH 142A,A03,093480,Chow; Bennett,7,0,32,25
1657318272819,MATH 142A,B03,093481,Chow; Bennett,8,0,32,24
1657318272819,MATH 142A,B04,093558,Chow; Bennett,13,0,32,19
1657318272819,MATH 142A,B05,093559,Chow; Bennett,6,0,32,26
1657318278842,MATH 193A,A01,083224,Rotar; Vladimir,7,0,34,27
1657318278842,MATH 193A,A02,083225,Rotar; Vladimir,7,0,34,27
1657318278842,MATH 193A,A03,083781,Rotar; Vladimir,3,0,34,31
1657318278842,MATH 193A,A04,083782,Rotar; Vladimir,8,0,34,26
1657318278842,MATH 193A,A05,093482,Rotar; Vladimir,9,0,34,25
1657318284864,MATH 197,001,091859,McAuley; Julian John,9999,0,9999,0
1657318284864,MATH 197,002,095566,Kedlaya; Kiran S.,9997,0,9999,2
1657318284864,MATH 197,003,095567,Xiao; Ming,9999,0,9999,0
1657318284864,MATH 197,004,095571,Perols; Johan Lars,9998,0,9999,1
1657318291926,COGS 9,A01,083615,Shannon; Kyle Michael,8,0,75,67
1657318297952,COGS 11,A01,083617,Boyle; Mary E. T.,22,0,48,26
1657318304056,COGS 13,A01,083071,Bastos; Amalia Pinkusfeld,10,0,71,61
1657318310079,COGS 14A,A01,092681,Semenuks; Arturs,3,1,100,97
1657318316109,COGS 14B,A01,083073,Cheng; Tzu-Han,6,0,63,57
1657318322139,COGS 17,A01,092677,Semenuks; Arturs,6,0,81,75
1657318328164,COGS 100,A01,083619,Allen; Michael Gordon,16,0,70,54
1657318334186,COGS 101A,A01,083621,Davis; Joshua Daniel,9,0,68,59
1657318340216,COGS 101B,A01,091572,Allen; Michael Gordon,11,0,65,54
1657318346245,COGS 101C,A01,083625,Delgado; Tania,17,0,35,18
1657318352268,COGS 107A,A01,083627,Boyle; Mary E. T.,13,0,60,47
1657318358296,COGS 118A,A01,083075,Gupta; Anjum,18,0,76,58
1657318364322,CSE 3,A50,083646,Miranda; Gregory Joseph,24,0,50,26
1657318370350,CSE 8A,A50,083650,Miranda; Gregory Joseph,17,1,56,39
1657318376375,CSE 11,A01,083080,Cao; Yingjun,6,15,40,34
1657318382398,CSE 12,A01,083652,Krause-Levy; Sophia Louisa,28,1,120,92
1657318388421,CSE 15L,A01,083654,Morris; Justin Loren,9,0,50,41
1657318388421,CSE 15L,A02,083655,Morris; Justin Loren,9,0,50,41
1657318394443,CSE 20,A01,083657,Tran; Khoa Dang,38,0,80,42
1657318400468,CSE 21,A01,095574,Bach; Quang Tran,22,0,48,26
1657318406491,CSE 30,A01,083084,Eldon; John,4,0,80,76
1657318406491,CSE 30,B01,095061,Bhaskar; Nishant,9,0,50,41
1657318412513,CSE 100,A01,083659,Cao; Yingjun,4,4,70,66
1657318418538,CSE 134B,A01,083661,Powell; Thomas Allan,22,0,100,78
1657318424560,CSE 140,A01,083663,Gungor; Onat,14,0,85,71
1657318430588,CSE 140L,A01,083088,Eldon; John,21,0,100,79
1657318436612,CSE 175,A01,083665,Kumar; Rakesh,3,0,25,22
1657318442644,CSE 190,A00,092507,Dubnov; Shlomo,7,0,20,13
1657318448670,ECE 45,A01,083139,Congero; Spencer William,6,0,75,69
1657318454697,ECE 65,A50,083695,Saad; Andrew S,12,0,30,18
1657318454697,ECE 65,A51,095125,Saad; Andrew S,25,0,26,1
1657318460722,ECE 109,A01,091882,Touri; Behrouz,19,0,70,51
1657318466762,ECE 180,A00,083140,Abi Samra; Nicholas Camill,1,0,30,29
1657318466762,ECE 180,B00,083141,Abi Samra; Nicholas Camill,0,0,30,30
1657318472789,MATH 10A,A01,083735,Patchell; Gregory David,2,0,30,28
1657318472789,MATH 10A,A02,083736,Patchell; Gregory David,20,0,30,10
1657318472789,MATH 10A,A03,083737,Patchell; Gregory David,16,0,30,14
1657318478814,MATH 10B,A01,083207,Lim; Seonhee,7,0,34,27
1657318478814,MATH 10B,A02,083208,Lim; Seonhee,9,0,35,26
1657318478814,MATH 10B,A03,093472,Lim; Seonhee,7,0,34,27
1657318478814,MATH 10B,B01,083739,Sinha; Shubham,11,0,30,19
1657318484845,MATH 18,A01,083743,Cinel; Cameron Alexander,6,0,30,24
1657318484845,MATH 18,A02,083744,Cinel; Cameron Alexander,17,0,30,13
1657318484845,MATH 18,A03,083745,Cinel; Cameron Alexander,9,0,30,21
1657318484845,MATH 18,B01,083748,Rideout; David Porter,4,0,37,33
1657318484845,MATH 18,B02,083749,Rideout; David Porter,5,0,36,31
1657318484845,MATH 18,B03,083750,Rideout; David Porter,3,0,37,34
1657318484845,MATH 18,B04,083751,Rideout; David Porter,6,0,36,30
1657318484845,MATH 18,B05,093473,Rideout; David Porter,6,0,36,30
1657318484845,MATH 18,B06,093474,Rideout; David Porter,5,0,36,31
1657318490884,MATH 20A,A01,083754,Zheng; Zequn,14,0,40,26
1657318496937,MATH 20B,A01,083756,Briones; Jor-el Thomas Caparas,4,0,36,32
1657318496937,MATH 20B,A02,083757,Briones; Jor-el Thomas Caparas,1,0,36,35
1657318496937,MATH 20B,A03,093475,Briones; Jor-el Thomas Caparas,2,0,36,34
1657318502960,MATH 20C,A01,083760,Briones; Jor-el Thomas Caparas,1,0,35,34
1657318502960,MATH 20C,A02,083761,Briones; Jor-el Thomas Caparas,8,0,35,27
1657318502960,MATH 20C,A03,093476,Briones; Jor-el Thomas Caparas,0,1,36,36
1657318502960,MATH 20C,B01,083762,Bach; Quang Tran,1,0,30,29
1657318508987,MATH 20D,A01,083765,Tran; Brian Kha,5,0,30,25
1657318508987,MATH 20D,A02,083766,Tran; Brian Kha,5,0,30,25
1657318508987,MATH 20D,A03,083767,Tran; Brian Kha,4,0,30,26
1657318515016,MATH 20E,A01,083771,Ganguly; Soumya,7,0,32,25
1657318515016,MATH 20E,A02,083772,Ganguly; Soumya,6,0,32,26
1657318515016,MATH 20E,B01,083773,Ciotti; Benjamin,19,0,35,16
1657318515016,MATH 20E,B02,083774,Ciotti; Benjamin,17,0,35,18
1657318521039,MATH 103A,A01,083777,Greenfeld; Be'Eri,3,0,36,33
1657318521039,MATH 103A,A02,083778,Greenfeld; Be'Eri,5,0,36,31
1657318521039,MATH 103A,A03,093561,Greenfeld; Be'Eri,4,0,36,32
1657318521039,MATH 103A,B01,083779,Greenfeld; Be'Eri,6,0,36,30
1657318521039,MATH 103A,B02,083780,Greenfeld; Be'Eri,4,0,36,32
1657318521039,MATH 103A,B03,093562,Greenfeld; Be'Eri,3,0,36,33
1657318527060,MATH 105,A01,085443,Carter; Anne Toulson,15,0,35,20
1657318527060,MATH 105,A02,093477,Carter; Anne Toulson,20,0,35,15
1657318533091,MATH 109,A01,083213,Ganzberger; Geoffrey Michael,2,0,34,32
1657318533091,MATH 109,A02,083214,Ganzberger; Geoffrey Michael,4,0,34,30
1657318533091,MATH 109,A03,093478,Ganzberger; Geoffrey Michael,2,0,34,32
1657318533091,MATH 109,B01,083215,Ganzberger; Geoffrey Michael,1,0,32,31
1657318533091,MATH 109,B02,083216,Ganzberger; Geoffrey Michael,1,0,32,31
1657318533091,MATH 109,B03,093479,Ganzberger; Geoffrey Michael,8,0,32,24
1657318539114,MATH 142A,A01,083219,Chow; Bennett,7,0,32,25
1657318539114,MATH 142A,A02,083220,Chow; Bennett,10,0,32,22
1657318539114,MATH 142A,A03,093480,Chow; Bennett,7,0,32,25
1657318539114,MATH 142A,B03,093481,Chow; Bennett,8,0,32,24
1657318539114,MATH 142A,B04,093558,Chow; Bennett,13,0,32,19
1657318539114,MATH 142A,B05,093559,Chow; Bennett,6,0,32,26
1657318545147,MATH 193A,A01,083224,Rotar; Vladimir,7,0,34,27
1657318545147,MATH 193A,A02,083225,Rotar; Vladimir,7,0,34,27
1657318545147,MATH 193A,A03,083781,Rotar; Vladimir,3,0,34,31
1657318545147,MATH 193A,A04,083782,Rotar; Vladimir,8,0,34,26
1657318545147,MATH 193A,A05,093482,Rotar; Vladimir,9,0,34,25
1657318551171,MATH 197,001,091859,McAuley; Julian John,9999,0,9999,0
1657318551171,MATH 197,002,095566,Kedlaya; Kiran S.,9997,0,9999,2
1657318551171,MATH 197,003,095567,Xiao; Ming,9999,0,9999,0
1657318551171,MATH 197,004,095571,Perols; Johan Lars,9998,0,9999,1
1657318558245,COGS 9,A01,083615,Shannon; Kyle Michael,8,0,75,67
1657318564272,COGS 11,A01,083617,Boyle; Mary E. T.,22,0,48,26
1657318570296,COGS 13,A01,083071,Bastos; Amalia Pinkusfeld,10,0,71,61
1657318576322,COGS 14A,A01,092681,Semenuks; Arturs,3,1,100,97
1657318582352,COGS 14B,A01,083073,Cheng; Tzu-Han,6,0,63,57
1657318588377,COGS 17,A01,092677,Semenuks; Arturs,6,0,81,75
1657318594402,COGS 100,A01,083619,Allen; Michael Gordon,16,0,70,54
1657318600428,COGS 101A,A01,083621,Davis; Joshua Daniel,9,0,68,59
1657318606463,COGS 101B,A01,091572,Allen; Michael Gordon,11,0,65,54
1657318612486,COGS 101C,A01,083625,Delgado; Tania,17,0,35,18
1657318618518,COGS 107A,A01,083627,Boyle; Mary E. T.,13,0,60,47
1657318624545,COGS 118A,A01,083075,Gupta; Anjum,18,0,76,58
1657318630573,CSE 3,A50,083646,Miranda; Gregory Joseph,24,0,50,26
1657318636602,CSE 8A,A50,083650,Miranda; Gregory Joseph,17,1,56,39
1657318642625,CSE 11,A01,083080,Cao; Yingjun,6,15,40,34
1657318648652,CSE 12,A01,083652,Krause-Levy; Sophia Louisa,28,1,120,92
1657318654675,CSE 15L,A01,083654,Morris; Justin Loren,9,0,50,41
1657318654675,CSE 15L,A02,083655,Morris; Justin Loren,9,0,50,41
1657318660707,CSE 20,A01,083657,Tran; Khoa Dang,38,0,80,42
1657318666733,CSE 21,A01,095574,Bach; Quang Tran,22,0,48,26
1657318672759,CSE 30,A01,083084,Eldon; John,4,0,80,76
1657318672759,CSE 30,B01,095061,Bhaskar; Nishant,9,0,50,41
1657318678786,CSE 100,A01,083659,Cao; Yingjun,4,4,70,66
1657318684808,CSE 134B,A01,083661,Powell; Thomas Allan,22,0,100,78
1657318690830,CSE 140,A01,083663,Gungor; Onat,14,0,85,71
1657318696856,CSE 140L,A01,083088,Eldon; John,21,0,100,79
1657318702879,CSE 175,A01,083665,Kumar; Rakesh,3,0,25,22
1657318708903,CSE 190,A00,092507,Dubnov; Shlomo,7,0,20,13
1657318714930,ECE 45,A01,083139,Congero; Spencer William,6,0,75,69
1657318720954,ECE 65,A50,083695,Saad; Andrew S,12,0,30,18
1657318720954,ECE 65,A51,095125,Saad; Andrew S,25,0,26,1
1657318726977,ECE 109,A01,091882,Touri; Behrouz,19,0,70,51
1657318733003,ECE 180,A00,083140,Abi Samra; Nicholas Camill,1,0,30,29
1657318733003,ECE 180,B00,083141,Abi Samra; Nicholas Camill,0,0,30,30
1657318739026,MATH 10A,A01,083735,Patchell; Gregory David,2,0,30,28
1657318739026,MATH 10A,A02,083736,Patchell; Gregory David,20,0,30,10
1657318739026,MATH 10A,A03,083737,Patchell; Gregory David,16,0,30,14
1657318745050,MATH 10B,A01,083207,Lim; Seonhee,7,0,34,27
1657318745050,MATH 10B,A02,083208,Lim; Seonhee,9,0,35,26
1657318745050,MATH 10B,A03,093472,Lim; Seonhee,7,0,34,27
1657318745050,MATH 10B,B01,083739,Sinha; Shubham,11,0,30,19
1657318751082,MATH 18,A01,083743,Cinel; Cameron Alexander,6,0,30,24
1657318751082,MATH 18,A02,083744,Cinel; Cameron Alexander,17,0,30,13
1657318751082,MATH 18,A03,083745,Cinel; Cameron Alexander,9,0,30,21
1657318751082,MATH 18,B01,083748,Rideout; David Porter,4,0,37,33
1657318751082,MATH 18,B02,083749,Rideout; David Porter,5,0,36,31
1657318751082,MATH 18,B03,083750,Rideout; David Porter,3,0,37,34
1657318751082,MATH 18,B04,083751,Rideout; David Porter,6,0,36,30
1657318751082,MATH 18,B05,093473,Rideout; David Porter,6,0,36,30
1657318751082,MATH 18,B06,093474,Rideout; David Porter,5,0,36,31
1657318757112,MATH 20A,A01,083754,Zheng; Zequn,14,0,40,26
1657318763136,MATH 20B,A01,083756,Briones; Jor-el Thomas Caparas,4,0,36,32
1657318763136,MATH 20B,A02,083757,Briones; Jor-el Thomas Caparas,1,0,36,35
1657318763136,MATH 20B,A03,093475,Briones; Jor-el Thomas Caparas,2,0,36,34
1657318769165,MATH 20C,A01,083760,Briones; Jor-el Thomas Caparas,1,0,35,34
1657318769165,MATH 20C,A02,083761,Briones; Jor-el Thomas Caparas,8,0,35,27
1657318769165,MATH 20C,A03,093476,Briones; Jor-el Thomas Caparas,0,1,36,36
1657318769165,MATH 20C,B01,083762,Bach; Quang Tran,1,0,30,29
1657318775194,MATH 20D,A01,083765,Tran; Brian Kha,5,0,30,25
1657318775194,MATH 20D,A02,083766,Tran; Brian Kha,5,0,30,25
1657318775194,MATH 20D,A03,083767,Tran; Brian Kha,4,0,30,26
1657318781219,MATH 20E,A01,083771,Ganguly; Soumya,7,0,32,25
1657318781219,MATH 20E,A02,083772,Ganguly; Soumya,6,0,32,26
1657318781219,MATH 20E,B01,083773,Ciotti; Benjamin,19,0,35,16
1657318781219,MATH 20E,B02,083774,Ciotti; Benjamin,17,0,35,18
1657318787244,MATH 103A,A01,083777,Greenfeld; Be'Eri,3,0,36,33
1657318787244,MATH 103A,A02,083778,Greenfeld; Be'Eri,5,0,36,31
1657318787244,MATH 103A,A03,093561,Greenfeld; Be'Eri,4,0,36,32
1657318787244,MATH 103A,B01,083779,Greenfeld; Be'Eri,6,0,36,30
1657318787244,MATH 103A,B02,083780,Greenfeld; Be'Eri,4,0,36,32
1657318787244,MATH 103A,B03,093562,Greenfeld; Be'Eri,3,0,36,33
1657318793273,MATH 105,A01,085443,Carter; Anne Toulson,15,0,35,20
1657318793273,MATH 105,A02,093477,Carter; Anne Toulson,20,0,35,15
1657318799297,MATH 109,A01,083213,Ganzberger; Geoffrey Michael,2,0,34,32
1657318799297,MATH 109,A02,083214,Ganzberger; Geoffrey Michael,4,0,34,30
1657318799297,MATH 109,A03,093478,Ganzberger; Geoffrey Michael,2,0,34,32
1657318799297,MATH 109,B01,083215,Ganzberger; Geoffrey Michael,1,0,32,31
1657318799297,MATH 109,B02,083216,Ganzberger; Geoffrey Michael,1,0,32,31
1657318799297,MATH 109,B03,093479,Ganzberger; Geoffrey Michael,8,0,32,24
1657318805321,MATH 142A,A01,083219,Chow; Bennett,7,0,32,25
1657318805321,MATH 142A,A02,083220,Chow; Bennett,10,0,32,22
1657318805321,MATH 142A,A03,093480,Chow; Bennett,7,0,32,25
1657318805321,MATH 142A,B03,093481,Chow; Bennett,8,0,32,24
1657318805321,MATH 142A,B04,093558,Chow; Bennett,13,0,32,19
1657318805321,MATH 142A,B05,093559,Chow; Bennett,6,0,32,26
1657318811344,MATH 193A,A01,083224,Rotar; Vladimir,7,0,34,27
1657318811344,MATH 193A,A02,083225,Rotar; Vladimir,7,0,34,27
1657318811344,MATH 193A,A03,083781,Rotar; Vladimir,3,0,34,31
1657318811344,MATH 193A,A04,083782,Rotar; Vladimir,8,0,34,26
1657318811344,MATH 193A,A05,093482,Rotar; Vladimir,9,0,34,25
1657318817376,MATH 197,001,091859,McAuley; Julian John,9999,0,9999,0
1657318817376,MATH 197,002,095566,Kedlaya; Kiran S.,9997,0,9999,2
1657318817376,MATH 197,003,095567,Xiao; Ming,9999,0,9999,0
1657318817376,MATH 197,004,095571,Perols; Johan Lars,9998,0,9999,1
1657318824437,COGS 9,A01,083615,Shannon; Kyle Michael,8,0,75,67
1657318830463,COGS 11,A01,083617,Boyle; Mary E. T.,22,0,48,26
1657318836487,COGS 13,A01,083071,Bastos; Amalia Pinkusfeld,10,0,71,61
1657318842512,COGS 14A,A01,092681,Semenuks; Arturs,3,1,100,97
1657318848534,COGS 14B,A01,083073,Cheng; Tzu-Han,6,0,63,57
1657318854559,COGS 17,A01,092677,Semenuks; Arturs,6,0,81,75
1657318860595,COGS 100,A01,083619,Allen; Michael Gordon,16,0,70,54
1657318866630,COGS 101A,A01,083621,Davis; Joshua Daniel,9,0,68,59
1657318872663,COGS 101B,A01,091572,Allen; Michael Gordon,11,0,65,54
1657318878686,COGS 101C,A01,083625,Delgado; Tania,17,0,35,18
1657318884707,COGS 107A,A01,083627,Boyle; Mary E. T.,13,0,60,47
1657318890740,COGS 118A,A01,083075,Gupta; Anjum,18,0,76,58
1657318896764,CSE 3,A50,083646,Miranda; Gregory Joseph,24,0,50,26
1657318902859,CSE 8A,A50,083650,Miranda; Gregory Joseph,17,1,56,39
1657318908886,CSE 11,A01,083080,Cao; Yingjun,6,15,40,34
1657318914910,CSE 12,A01,083652,Krause-Levy; Sophia Louisa,28,1,120,92
1657318920940,CSE 15L,A01,083654,Morris; Justin Loren,9,0,50,41
1657318920940,CSE 15L,A02,083655,Morris; Justin Loren,9,0,50,41
1657318926966,CSE 20,A01,083657,Tran; Khoa Dang,38,0,80,42
1657318932993,CSE 21,A01,095574,Bach; Quang Tran,22,0,48,26
1657318939019,CSE 30,A01,083084,Eldon; John,4,0,80,76
1657318939019,CSE 30,B01,095061,Bhaskar; Nishant,9,0,50,41
1657318945048,CSE 100,A01,083659,Cao; Yingjun,4,4,70,66
1657318951072,CSE 134B,A01,083661,Powell; Thomas Allan,22,0,100,78
1657318957095,CSE 140,A01,083663,Gungor; Onat,14,0,85,71
1657318963119,CSE 140L,A01,083088,Eldon; John,21,0,100,79
1657318969151,CSE 175,A01,083665,Kumar; Rakesh,3,0,25,22
1657318975174,CSE 190,A00,092507,Dubnov; Shlomo,7,0,20,13
1657318981198,ECE 45,A01,083139,Congero; Spencer William,6,0,75,69
1657318987230,ECE 65,A50,083695,Saad; Andrew S,12,0,30,18
1657318987230,ECE 65,A51,095125,Saad; Andrew S,25,0,26,1
1657318993256,ECE 109,A01,091882,Touri; Behrouz,19,0,70,51
1657318999279,ECE 180,A00,083140,Abi Samra; Nicholas Camill,1,0,30,29
1657318999279,ECE 180,B00,083141,Abi Samra; Nicholas Camill,0,0,30,30
1657319005305,MATH 10A,A01,083735,Patchell; Gregory David,2,0,30,28
1657319005305,MATH 10A,A02,083736,Patchell; Gregory David,20,0,30,10
1657319005305,MATH 10A,A03,083737,Patchell; Gregory David,16,0,30,14
1657319011334,MATH 10B,A01,083207,Lim; Seonhee,7,0,34,27
1657319011334,MATH 10B,A02,083208,Lim; Seonhee,9,0,35,26
1657319011334,MATH 10B,A03,093472,Lim; Seonhee,7,0,34,27
1657319011334,MATH 10B,B01,083739,Sinha; Shubham,11,0,30,19
1657319017360,MATH 18,A01,083743,Cinel; Cameron Alexander,6,0,30,24
1657319017360,MATH 18,A02,083744,Cinel; Cameron Alexander,17,0,30,13
1657319017360,MATH 18,A03,083745,Cinel; Cameron Alexander,9,0,30,21
1657319017360,MATH 18,B01,083748,Rideout; David Porter,4,0,37,33
1657319017360,MATH 18,B02,083749,Rideout; David Porter,5,0,36,31
1657319017360,MATH 18,B03,083750,Rideout; David Porter,3,0,37,34
1657319017360,MATH 18,B04,083751,Rideout; David Porter,6,0,36,30
1657319017360,MATH 18,B05,093473,Rideout; David Porter,6,0,36,30
1657319017360,MATH 18,B06,093474,Rideout; David Porter,5,0,36,31
1657319023384,MATH 20A,A01,083754,Zheng; Zequn,14,0,40,26
1657319029417,MATH 20B,A01,083756,Briones; Jor-el Thomas Caparas,4,0,36,32
1657319029417,MATH 20B,A02,083757,Briones; Jor-el Thomas Caparas,1,0,36,35
1657319029417,MATH 20B,A03,093475,Briones; Jor-el Thomas Caparas,2,0,36,34
1657319035442,MATH 20C,A01,083760,Briones; Jor-el Thomas Caparas,1,0,35,34
1657319035442,MATH 20C,A02,083761,Briones; Jor-el Thomas Caparas,8,0,35,27
1657319035442,MATH 20C,A03,093476,Briones; Jor-el Thomas Caparas,0,1,36,36
1657319035442,MATH 20C,B01,083762,Bach; Quang Tran,1,0,30,29
1657319041471,MATH 20D,A01,083765,Tran; Brian Kha,5,0,30,25
1657319041471,MATH 20D,A02,083766,Tran; Brian Kha,5,0,30,25
1657319041471,MATH 20D,A03,083767,Tran; Brian Kha,4,0,30,26
1657319047496,MATH 20E,A01,083771,Ganguly; Soumya,7,0,32,25
1657319047496,MATH 20E,A02,083772,Ganguly; Soumya,6,0,32,26
1657319047496,MATH 20E,B01,083773,Ciotti; Benjamin,19,0,35,16
1657319047496,MATH 20E,B02,083774,Ciotti; Benjamin,17,0,35,18
1657319053524,MATH 103A,A01,083777,Greenfeld; Be'Eri,3,0,36,33
1657319053524,MATH 103A,A02,083778,Greenfeld; Be'Eri,5,0,36,31
1657319053524,MATH 103A,A03,093561,Greenfeld; Be'Eri,4,0,36,32
1657319053524,MATH 103A,B01,083779,Greenfeld; Be'Eri,6,0,36,30
1657319053524,MATH 103A,B02,083780,Greenfeld; Be'Eri,4,0,36,32
1657319053524,MATH 103A,B03,093562,Greenfeld; Be'Eri,3,0,36,33
1657319059546,MATH 105,A01,085443,Carter; Anne Toulson,15,0,35,20
1657319059546,MATH 105,A02,093477,Carter; Anne Toulson,20,0,35,15
1657319065570,MATH 109,A01,083213,Ganzberger; Geoffrey Michael,2,0,34,32
1657319065570,MATH 109,A02,083214,Ganzberger; Geoffrey Michael,4,0,34,30
1657319065570,MATH 109,A03,093478,Ganzberger; Geoffrey Michael,2,0,34,32
1657319065570,MATH 109,B01,083215,Ganzberger; Geoffrey Michael,1,0,32,31
1657319065570,MATH 109,B02,083216,Ganzberger; Geoffrey Michael,1,0,32,31
1657319065570,MATH 109,B03,093479,Ganzberger; Geoffrey Michael,8,0,32,24
1657319071602,MATH 142A,A01,083219,Chow; Bennett,7,0,32,25
1657319071602,MATH 142A,A02,083220,Chow; Bennett,10,0,32,22
1657319071602,MATH 142A,A03,093480,Chow; Bennett,7,0,32,25
1657319071602,MATH 142A,B03,093481,Chow; Bennett,8,0,32,24
1657319071602,MATH 142A,B04,093558,Chow; Bennett,13,0,32,19
1657319071602,MATH 142A,B05,093559,Chow; Bennett,6,0,32,26
1657319077629,MATH 193A,A01,083224,Rotar; Vladimir,7,0,34,27
1657319077629,MATH 193A,A02,083225,Rotar; Vladimir,7,0,34,27
1657319077629,MATH 193A,A03,083781,Rotar; Vladimir,3,0,34,31
1657319077629,MATH 193A,A04,083782,Rotar; Vladimir,8,0,34,26
1657319077629,MATH 193A,A05,093482,Rotar; Vladimir,9,0,34,25
1657319083664,MATH 197,001,091859,McAuley; Julian John,9999,0,9999,0
1657319083664,MATH 197,002,095566,Kedlaya; Kiran S.,9997,0,9999,2
1657319083664,MATH 197,003,095567,Xiao; Ming,9999,0,9999,0
1657319083664,MATH 197,004,095571,Perols; Johan Lars,9998,0,9999,1
1657319090730,COGS 9,A01,083615,Shannon; Kyle Michael,8,0,75,67
1657319096752,COGS 11,A01,083617,Boyle; Mary E. T.,22,0,48,26
1657319102774,COGS 13,A01,083071,Bastos; Amalia Pinkusfeld,10,0,71,61
1657319108795,COGS 14A,A01,092681,Semenuks; Arturs,3,1,100,97
1657319114819,COGS 14B,A01,083073,Cheng; Tzu-Han,6,0,63,57
1657319120842,COGS 17,A01,092677,Semenuks; Arturs,6,0,81,75
1657319126865,COGS 100,A01,083619,Allen; Michael Gordon,16,0,70,54
1657319132888,COGS 101A,A01,083621,Davis; Joshua Daniel,9,0,68,59
1657319138915,COGS 101B,A01,091572,Allen; Michael Gordon,11,0,65,54
1657319144939,COGS 101C,A01,083625,Delgado; Tania,17,0,35,18
1657319150962,COGS 107A,A01,083627,Boyle; Mary E. T.,13,0,60,47
1657319156986,COGS 118A,A01,083075,Gupta; Anjum,18,0,76,58
1657319163012,CSE 3,A50,083646,Miranda; Gregory Joseph,24,0,50,26
1657319169041,CSE 8A,A50,083650,Miranda; Gregory Joseph,17,1,56,39
1657319175065,CSE 11,A01,083080,Cao; Yingjun,6,15,40,34
1657319181091,CSE 12,A01,083652,Krause-Levy; Sophia Louisa,28,1,120,92
1657319187118,CSE 15L,A01,083654,Morris; Justin Loren,9,0,50,41
1657319187118,CSE 15L,A02,083655,Morris; Justin Loren,9,0,50,41
1657319193143,CSE 20,A01,083657,Tran; Khoa Dang,38,0,80,42
1657319199186,CSE 21,A01,095574,Bach; Quang Tran,22,0,48,26
1657319205224,CSE 30,A01,083084,Eldon; John,4,0,80,76
1657319205224,CSE 30,B01,095061,Bhaskar; Nishant,9,0,50,41
1657319211247,CSE 100,A01,083659,Cao; Yingjun,4,4,70,66
1657319217269,CSE 134B,A01,083661,Powell; Thomas Allan,22,0,100,78
1657319223292,CSE 140,A01,083663,Gungor; Onat,14,0,85,71
1657319229320,CSE 140L,A01,083088,Eldon; John,21,0,100,79
1657319235344,CSE 175,A01,083665,Kumar; Rakesh,3,0,25,22
1657319241367,CSE 190,A00,092507,Dubnov; Shlomo,7,0,20,13
1657319247389,ECE 45,A01,083139,Congero; Spencer William,6,0,75,69
1657319253421,ECE 65,A50,083695,Saad; Andrew S,12,0,30,18
1657319253421,ECE 65,A51,095125,Saad; Andrew S,25,0,26,1
1657319259444,ECE 109,A01,091882,Touri; Behrouz,19,0,70,51
1657319265467,ECE 180,A00,083140,Abi Samra; Nicholas Camill,1,0,30,29
1657319265467,ECE 180,B00,083141,Abi Samra; Nicholas Camill,0,0,30,30
1657319271491,MATH 10A,A01,083735,Patchell; Gregory David,2,0,30,28
1657319271491,MATH 10A,A02,083736,Patchell; Gregory David,20,0,30,10
1657319271491,MATH 10A,A03,083737,Patchell; Gregory David,16,0,30,14
1657319277514,MATH 10B,A01,083207,Lim; Seonhee,7,0,34,27
1657319277514,MATH 10B,A02,083208,Lim; Seonhee,9,0,35,26
1657319277514,MATH 10B,A03,093472,Lim; Seonhee,7,0,34,27
1657319277514,MATH 10B,B01,083739,Sinha; Shubham,11,0,30,19
1657319283539,MATH 18,A01,083743,Cinel; Cameron Alexander,6,0,30,24
1657319283539,MATH 18,A02,083744,Cinel; Cameron Alexander,17,0,30,13
1657319283539,MATH 18,A03,083745,Cinel; Cameron Alexander,9,0,30,21
1657319283539,MATH 18,B01,083748,Rideout; David Porter,4,0,37,33
1657319283539,MATH 18,B02,083749,Rideout; David Porter,5,0,36,31
1657319283539,MATH 18,B03,083750,Rideout; David Porter,3,0,37,34
1657319283539,MATH 18,B04,083751,Rideout; David Porter,6,0,36,30
1657319283539,MATH 18,B05,093473,Rideout; David Porter,6,0,36,30
1657319283539,MATH 18,B06,093474,Rideout; David Porter,5,0,36,31
1657319289565,MATH 20A,A01,083754,Zheng; Zequn,14,0,40,26
1657319295591,MATH 20B,A01,083756,Briones; Jor-el Thomas Caparas,4,0,36,32
1657319295591,MATH 20B,A02,083757,Briones; Jor-el Thomas Caparas,1,0,36,35
1657319295591,MATH 20B,A03,093475,Briones; Jor-el Thomas Caparas,2,0,36,34
1657319301618,MATH 20C,A01,083760,Briones; Jor-el Thomas Caparas,1,0,35,34
1657319301618,MATH 20C,A02,083761,Briones; Jor-el Thomas Caparas,8,0,35,27
1657319301618,MATH 20C,A03,093476,Briones; Jor-el Thomas Caparas,0,1,36,36
1657319301618,MATH 20C,B01,083762,Bach; Quang Tran,1,0,30,29
1657319307642,MATH 20D,A01,083765,Tran; Brian Kha,5,0,30,25
1657319307642,MATH 20D,A02,083766,Tran; Brian Kha,5,0,30,25
1657319307642,MATH 20D,A03,083767,Tran; Brian Kha,4,0,30,26
1657319313665,MATH 20E,A01,083771,Ganguly; Soumya,7,0,32,25
1657319313665,MATH 20E,A02,083772,Ganguly; Soumya,6,0,32,26
1657319313665,MATH 20E,B01,083773,Ciotti; Benjamin,19,0,35,16
1657319313665,MATH 20E,B02,083774,Ciotti; Benjamin,17,0,35,18
1657319319690,MATH 103A,A01,083777,Greenfeld; Be'Eri,3,0,36,33
1657319319690,MATH 103A,A02,083778,Greenfeld; Be'Eri,5,0,36,31
1657319319690,MATH 103A,A03,093561,Greenfeld; Be'Eri,4,0,36,32
1657319319690,MATH 103A,B01,083779,Greenfeld; Be'Eri,6,0,36,30
1657319319690,MATH 103A,B02,083780,Greenfeld; Be'Eri,4,0,36,32
1657319319690,MATH 103A,B03,093562,Greenfeld; Be'Eri,3,0,36,33
1657319325715,MATH 105,A01,085443,Carter; Anne Toulson,15,0,35,20
1657319325715,MATH 105,A02,093477,Carter; Anne Toulson,20,0,35,15
1657319331742,MATH 109,A01,083213,Ganzberger; Geoffrey Michael,2,0,34,32
1657319331742,MATH 109,A02,083214,Ganzberger; Geoffrey Michael,4,0,34,30
1657319331742,MATH 109,A03,093478,Ganzberger; Geoffrey Michael,2,0,34,32
1657319331742,MATH 109,B01,083215,Ganzberger; Geoffrey Michael,1,0,32,31
1657319331742,MATH 109,B02,083216,Ganzberger; Geoffrey Michael,1,0,32,31
1657319331742,MATH 109,B03,093479,Ganzberger; Geoffrey Michael,8,0,32,24
1657319337765,MATH 142A,A01,083219,Chow; Bennett,7,0,32,25
1657319337765,MATH 142A,A02,083220,Chow; Bennett,10,0,32,22
1657319337765,MATH 142A,A03,093480,Chow; Bennett,7,0,32,25
1657319337765,MATH 142A,B03,093481,Chow; Bennett,8,0,32,24
1657319337765,MATH 142A,B04,093558,Chow; Bennett,13,0,32,19
1657319337765,MATH 142A,B05,093559,Chow; Bennett,6,0,32,26
1657319343794,MATH 193A,A01,083224,Rotar; Vladimir,7,0,34,27
1657319343794,MATH 193A,A02,083225,Rotar; Vladimir,7,0,34,27
1657319343794,MATH 193A,A03,083781,Rotar; Vladimir,3,0,34,31
1657319343794,MATH 193A,A04,083782,Rotar; Vladimir,8,0,34,26
1657319343794,MATH 193A,A05,093482,Rotar; Vladimir,9,0,34,25
1657319349821,MATH 197,001,091859,McAuley; Julian John,9999,0,9999,0
1657319349821,MATH 197,002,095566,Kedlaya; Kiran S.,9997,0,9999,2
1657319349821,MATH 197,003,095567,Xiao; Ming,9999,0,9999,0
1657319349821,MATH 197,004,095571,Perols; Johan Lars,9998,0,9999,1
1657319356879,COGS 9,A01,083615,Shannon; Kyle Michael,8,0,75,67
1657319362907,COGS 11,A01,083617,Boyle; Mary E. T.,22,0,48,26
1657319368939,COGS 13,A01,083071,Bastos; Amalia Pinkusfeld,10,0,71,61
1657319374963,COGS 14A,A01,092681,Semenuks; Arturs,3,1,100,97
1657319380987,COGS 14B,A01,083073,Cheng; Tzu-Han,6,0,63,57
1657319387010,COGS 17,A01,092677,Semenuks; Arturs,6,0,81,75
1657319393033,COGS 100,A01,083619,Allen; Michael Gordon,16,0,70,54
1657319399060,COGS 101A,A01,083621,Davis; Joshua Daniel,9,0,68,59
1657319405086,COGS 101B,A01,091572,Allen; Michael Gordon,11,0,65,54
1657319411107,COGS 101C,A01,083625,Delgado; Tania,17,0,35,18
1657319417132,COGS 107A,A01,083627,Boyle; Mary E. T.,13,0,60,47
1657319423166,COGS 118A,A01,083075,Gupta; Anjum,18,0,76,58
1657319429199,CSE 3,A50,083646,Miranda; Gregory Joseph,24,0,50,26
1657319435226,CSE 8A,A50,083650,Miranda; Gregory Joseph,17,1,56,39
1657319441255,CSE 11,A01,083080,Cao; Yingjun,6,15,40,34
1657319447280,CSE 12,A01,083652,Krause-Levy; Sophia Louisa,28,1,120,92
1657319453307,CSE 15L,A01,083654,Morris; Justin Loren,9,0,50,41
1657319453307,CSE 15L,A02,083655,Morris; Justin Loren,9,0,50,41
1657319459334,CSE 20,A01,083657,Tran; Khoa Dang,38,0,80,42
1657319465364,CSE 21,A01,095574,Bach; Quang Tran,22,0,48,26
1657319471392,CSE 30,A01,083084,Eldon; John,4,0,80,76
1657319471392,CSE 30,B01,095061,Bhaskar; Nishant,9,0,50,41
1657319477417,CSE 100,A01,083659,Cao; Yingjun,4,4,70,66
1657319483440,CSE 134B,A01,083661,Powell; Thomas Allan,22,0,100,78
1657319489464,CSE 140,A01,083663,Gungor; Onat,14,0,85,71
1657319495487,CSE 140L,A01,083088,Eldon; John,21,0,100,79
1657319501591,CSE 175,A01,083665,Kumar; Rakesh,3,0,25,22
1657319507615,CSE 190,A00,092507,Dubnov; Shlomo,7,0,20,13
1657319513642,ECE 45,A01,083139,Congero; Spencer William,6,0,75,69
1657319519671,ECE 65,A50,083695,Saad; Andrew S,12,0,30,18
1657319519671,ECE 65,A51,095125,Saad; Andrew S,25,0,26,1
1657319525694,ECE 109,A01,091882,Touri; Behrouz,19,0,70,51
1657319531721,ECE 180,A00,083140,Abi Samra; Nicholas Camill,1,0,30,29
1657319531721,ECE 180,B00,083141,Abi Samra; Nicholas Camill,0,0,30,30
1657319537749,MATH 10A,A01,083735,Patchell; Gregory David,2,0,30,28
1657319537749,MATH 10A,A02,083736,Patchell; Gregory David,20,0,30,10
1657319537749,MATH 10A,A03,083737,Patchell; Gregory David,16,0,30,14
1657319543775,MATH 10B,A01,083207,Lim; Seonhee,7,0,34,27
1657319543775,MATH 10B,A02,083208,Lim; Seonhee,9,0,35,26
1657319543775,MATH 10B,A03,093472,Lim; Seonhee,7,0,34,27
1657319543775,MATH 10B,B01,083739,Sinha; Shubham,11,0,30,19
1657319549802,MATH 18,A01,083743,Cinel; Cameron Alexander,6,0,30,24
1657319549802,MATH 18,A02,083744,Cinel; Cameron Alexander,17,0,30,13
1657319549802,MATH 18,A03,083745,Cinel; Cameron Alexander,9,0,30,21
1657319549802,MATH 18,B01,083748,Rideout; David Porter,4,0,37,33
1657319549802,MATH 18,B02,083749,Rideout; David Porter,5,0,36,31
1657319549802,MATH 18,B03,083750,Rideout; David Porter,3,0,37,34
1657319549802,MATH 18,B04,083751,Rideout; David Porter,6,0,36,30
1657319549802,MATH 18,B05,093473,Rideout; David Porter,6,0,36,30
1657319549802,MATH 18,B06,093474,Rideout; David Porter,5,0,36,31
1657319555824,MATH 20A,A01,083754,Zheng; Zequn,14,0,40,26
1657319561849,MATH 20B,A01,083756,Briones; Jor-el Thomas Caparas,4,0,36,32
1657319561849,MATH 20B,A02,083757,Briones; Jor-el Thomas Caparas,1,0,36,35
1657319561849,MATH 20B,A03,093475,Briones; Jor-el Thomas Caparas,2,0,36,34
1657319567898,MATH 20C,A01,083760,Briones; Jor-el Thomas Caparas,1,0,35,34
1657319567898,MATH 20C,A02,083761,Briones; Jor-el Thomas Caparas,8,0,35,27
1657319567898,MATH 20C,A03,093476,Briones; Jor-el Thomas Caparas,0,1,36,36
1657319567898,MATH 20C,B01,083762,Bach; Quang Tran,1,0,30,29
1657319573922,MATH 20D,A01,083765,Tran; Brian Kha,5,0,30,25
1657319573922,MATH 20D,A02,083766,Tran; Brian Kha,5,0,30,25
1657319573922,MATH 20D,A03,083767,Tran; Brian Kha,4,0,30,26
1657319579960,MATH 20E,A01,083771,Ganguly; Soumya,7,0,32,25
1657319579960,MATH 20E,A02,083772,Ganguly; Soumya,6,0,32,26
1657319579960,MATH 20E,B01,083773,Ciotti; Benjamin,19,0,35,16
1657319579960,MATH 20E,B02,083774,Ciotti; Benjamin,17,0,35,18
1657319585991,MATH 103A,A01,083777,Greenfeld; Be'Eri,3,0,36,33
1657319585991,MATH 103A,A02,083778,Greenfeld; Be'Eri,5,0,36,31
1657319585991,MATH 103A,A03,093561,Greenfeld; Be'Eri,4,0,36,32
1657319585991,MATH 103A,B01,083779,Greenfeld; Be'Eri,6,0,36,30
1657319585991,MATH 103A,B02,083780,Greenfeld; Be'Eri,4,0,36,32
1657319585991,MATH 103A,B03,093562,Greenfeld; Be'Eri,3,0,36,33
1657319592018,MATH 105,A01,085443,Carter; Anne Toulson,15,0,35,20
1657319592018,MATH 105,A02,093477,Carter; Anne Toulson,20,0,35,15
1657319598046,MATH 109,A01,083213,Ganzberger; Geoffrey Michael,2,0,34,32
1657319598046,MATH 109,A02,083214,Ganzberger; Geoffrey Michael,4,0,34,30
1657319598046,MATH 109,A03,093478,Ganzberger; Geoffrey Michael,2,0,34,32
1657319598046,MATH 109,B01,083215,Ganzberger; Geoffrey Michael,1,0,32,31
1657319598046,MATH 109,B02,083216,Ganzberger; Geoffrey Michael,1,0,32,31
1657319598046,MATH 109,B03,093479,Ganzberger; Geoffrey Michael,8,0,32,24
1657319604071,MATH 142A,A01,083219,Chow; Bennett,7,0,32,25
1657319604071,MATH 142A,A02,083220,Chow; Bennett,10,0,32,22
1657319604071,MATH 142A,A03,093480,Chow; Bennett,7,0,32,25
1657319604071,MATH 142A,B03,093481,Chow; Bennett,8,0,32,24
1657319604071,MATH 142A,B04,093558,Chow; Bennett,13,0,32,19
1657319604071,MATH 142A,B05,093559,Chow; Bennett,6,0,32,26
1657319610098,MATH 193A,A01,083224,Rotar; Vladimir,7,0,34,27
1657319610098,MATH 193A,A02,083225,Rotar; Vladimir,7,0,34,27
1657319610098,MATH 193A,A03,083781,Rotar; Vladimir,3,0,34,31
1657319610098,MATH 193A,A04,083782,Rotar; Vladimir,8,0,34,26
1657319610098,MATH 193A,A05,093482,Rotar; Vladimir,9,0,34,25
1657319616121,MATH 197,001,091859,McAuley; Julian John,9999,0,9999,0
1657319616121,MATH 197,002,095566,Kedlaya; Kiran S.,9997,0,9999,2
1657319616121,MATH 197,003,095567,Xiao; Ming,9999,0,9999,0
1657319616121,MATH 197,004,095571,Perols; Johan Lars,9998,0,9999,1
1657319623206,COGS 9,A01,083615,Shannon; Kyle Michael,8,0,75,67
1657319629230,COGS 11,A01,083617,Boyle; Mary E. T.,22,0,48,26
1657319635268,COGS 13,A01,083071,Bastos; Amalia Pinkusfeld,10,0,71,61
1657319641291,COGS 14A,A01,092681,Semenuks; Arturs,3,1,100,97
1657319647313,COGS 14B,A01,083073,Cheng; Tzu-Han,6,0,63,57
1657319653340,COGS 17,A01,092677,Semenuks; Arturs,6,0,81,75
1657319659363,COGS 100,A01,083619,Allen; Michael Gordon,16,0,70,54
1657319665392,COGS 101A,A01,083621,Davis; Joshua Daniel,9,0,68,59
1657319671416,COGS 101B,A01,091572,Allen; Michael Gordon,11,0,65,54
1657319677446,COGS 101C,A01,083625,Delgado; Tania,17,0,35,18
1657319683473,COGS 107A,A01,083627,Boyle; Mary E. T.,13,0,60,47
1657319689499,COGS 118A,A01,083075,Gupta; Anjum,18,0,76,58
1657319695528,CSE 3,A50,083646,Miranda; Gregory Joseph,24,0,50,26
1657319701554,CSE 8A,A50,083650,Miranda; Gregory Joseph,17,1,56,39
1657319707577,CSE 11,A01,083080,Cao; Yingjun,6,15,40,34
1657319713602,CSE 12,A01,083652,Krause-Levy; Sophia Louisa,28,1,120,92
1657319719636,CSE 15L,A01,083654,Morris; Justin Loren,9,0,50,41
1657319719636,CSE 15L,A02,083655,Morris; Justin Loren,9,0,50,41
1657319725659,CSE 20,A01,083657,Tran; Khoa Dang,38,0,80,42
1657319731682,CSE 21,A01,095574,Bach; Quang Tran,22,0,48,26
1657319737705,CSE 30,A01,083084,Eldon; John,4,0,80,76
1657319737705,CSE 30,B01,095061,Bhaskar; Nishant,9,0,50,41
1657319743726,CSE 100,A01,083659,Cao; Yingjun,4,4,70,66
1657319749752,CSE 134B,A01,083661,Powell; Thomas Allan,22,0,100,78
1657319755775,CSE 140,A01,083663,Gungor; Onat,14,0,85,71
1657319761800,CSE 140L,A01,083088,Eldon; John,21,0,100,79
1657319767824,CSE 175,A01,083665,Kumar; Rakesh,3,0,25,22
1657319773850,CSE 190,A00,092507,Dubnov; Shlomo,7,0,20,13
1657319779875,ECE 45,A01,083139,Congero; Spencer William,6,0,75,69
1657319785903,ECE 65,A50,083695,Saad; Andrew S,12,0,30,18
1657319785903,ECE 65,A51,095125,Saad; Andrew S,25,0,26,1
1657319791929,ECE 109,A01,091882,Touri; Behrouz,19,0,70,51
1657319797956,ECE 180,A00,083140,Abi Samra; Nicholas Camill,1,0,30,29
1657319797956,ECE 180,B00,083141,Abi Samra; Nicholas Camill,0,0,30,30
1657319804000,MATH 10A,A01,083735,Patchell; Gregory David,2,0,30,28
1657319804000,MATH 10A,A02,083736,Patchell; Gregory David,20,0,30,10
1657319804000,MATH 10A,A03,083737,Patchell; Gregory David,16,0,30,14
1657319810028,MATH 10B,A01,083207,Lim; Seonhee,7,0,34,27
1657319810028,MATH 10B,A02,083208,Lim; Seonhee,9,0,35,26
1657319810028,MATH 10B,A03,093472,Lim; Seonhee,7,0,34,27
1657319810028,MATH 10B,B01,083739,Sinha; Shubham,11,0,30,19
1657319816061,MATH 18,A01,083743,Cinel; Cameron Alexander,6,0,30,24
1657319816061,MATH 18,A02,083744,Cinel; Cameron Alexander,17,0,30,13
1657319816061,MATH 18,A03,083745,Cinel; Cameron Alexander,9,0,30,21
1657319816061,MATH 18,B01,083748,Rideout; David Porter,4,0,37,33
1657319816061,MATH 18,B02,083749,Rideout; David Porter,5,0,36,31
1657319816061,MATH 18,B03,083750,Rideout; David Porter,3,0,37,34
1657319816061,MATH 18,B04,083751,Rideout; David Porter,6,0,36,30
1657319816061,MATH 18,B05,093473,Rideout; David Porter,6,0,36,30
1657319816061,MATH 18,B06,093474,Rideout; David Porter,5,0,36,31
1657319822085,MATH 20A,A01,083754,Zheng; Zequn,14,0,40,26
1657319828115,MATH 20B,A01,083756,Briones; Jor-el Thomas Caparas,4,0,36,32
1657319828115,MATH 20B,A02,083757,Briones; Jor-el Thomas Caparas,1,0,36,35
1657319828115,MATH 20B,A03,093475,Briones; Jor-el Thomas Caparas,2,0,36,34
1657319834154,MATH 20C,A01,083760,Briones; Jor-el Thomas Caparas,1,0,35,34
1657319834154,MATH 20C,A02,083761,Briones; Jor-el Thomas Caparas,8,0,35,27
1657319834154,MATH 20C,A03,093476,Briones; Jor-el Thomas Caparas,0,1,36,36
1657319834154,MATH 20C,B01,083762,Bach; Quang Tran,1,0,30,29
1657319840209,MATH 20D,A01,083765,Tran; Brian Kha,5,0,30,25
1657319840209,MATH 20D,A02,083766,Tran; Brian Kha,5,0,30,25
1657319840209,MATH 20D,A03,083767,Tran; Brian Kha,4,0,30,26
1657319846245,MATH 20E,A01,083771,Ganguly; Soumya,7,0,32,25
1657319846245,MATH 20E,A02,083772,Ganguly; Soumya,6,0,32,26
1657319846245,MATH 20E,B01,083773,Ciotti; Benjamin,19,0,35,16
1657319846245,MATH 20E,B02,083774,Ciotti; Benjamin,17,0,35,18
1657319852274,MATH 103A,A01,083777,Greenfeld; Be'Eri,3,0,36,33
1657319852274,MATH 103A,A02,083778,Greenfeld; Be'Eri,5,0,36,31
1657319852274,MATH 103A,A03,093561,Greenfeld; Be'Eri,4,0,36,32
1657319852274,MATH 103A,B01,083779,Greenfeld; Be'Eri,6,0,36,30
1657319852274,MATH 103A,B02,083780,Greenfeld; Be'Eri,4,0,36,32
1657319852274,MATH 103A,B03,093562,Greenfeld; Be'Eri,3,0,36,33
1657319858297,MATH 105,A01,085443,Carter; Anne Toulson,15,0,35,20
1657319858297,MATH 105,A02,093477,Carter; Anne Toulson,20,0,35,15
1657319864325,MATH 109,A01,083213,Ganzberger; Geoffrey Michael,2,0,34,32
1657319864325,MATH 109,A02,083214,Ganzberger; Geoffrey Michael,4,0,34,30
1657319864325,MATH 109,A03,093478,Ganzberger; Geoffrey Michael,2,0,34,32
1657319864325,MATH 109,B01,083215,Ganzberger; Geoffrey Michael,1,0,32,31
1657319864325,MATH 109,B02,083216,Ganzberger; Geoffrey Michael,1,0,32,31
1657319864325,MATH 109,B03,093479,Ganzberger; Geoffrey Michael,8,0,32,24
1657319870348,MATH 142A,A01,083219,Chow; Bennett,7,0,32,25
1657319870348,MATH 142A,A02,083220,Chow; Bennett,10,0,32,22
1657319870348,MATH 142A,A03,093480,Chow; Bennett,7,0,32,25
1657319870348,MATH 142A,B03,093481,Chow; Bennett,8,0,32,24
1657319870348,MATH 142A,B04,093558,Chow; Bennett,13,0,32,19
1657319870348,MATH 142A,B05,093559,Chow; Bennett,6,0,32,26
1657319876373,MATH 193A,A01,083224,Rotar; Vladimir,7,0,34,27
1657319876373,MATH 193A,A02,083225,Rotar; Vladimir,7,0,34,27
1657319876373,MATH 193A,A03,083781,Rotar; Vladimir,3,0,34,31
1657319876373,MATH 193A,A04,083782,Rotar; Vladimir,8,0,34,26
1657319876373,MATH 193A,A05,093482,Rotar; Vladimir,9,0,34,25
1657319882396,MATH 197,001,091859,McAuley; Julian John,9999,0,9999,0
1657319882396,MATH 197,002,095566,Kedlaya; Kiran S.,9997,0,9999,2
1657319882396,MATH 197,003,095567,Xiao; Ming,9999,0,9999,0
1657319882396,MATH 197,004,095571,Perols; Johan Lars,9998,0,9999,1
1657319889451,COGS 9,A01,083615,Shannon; Kyle Michael,8,0,75,67
1657319895473,COGS 11,A01,083617,Boyle; Mary E. T.,22,0,48,26
1657319901496,COGS 13,A01,083071,Bastos; Amalia Pinkusfeld,10,0,71,61
1657319907523,COGS 14A,A01,092681,Semenuks; Arturs,3,1,100,97
1657319913551,COGS 14B,A01,083073,Cheng; Tzu-Han,6,0,63,57
1657319919576,COGS 17,A01,092677,Semenuks; Arturs,6,0,81,75
1657319925598,COGS 100,A01,083619,Allen; Michael Gordon,16,0,70,54
1657319931622,COGS 101A,A01,083621,Davis; Joshua Daniel,9,0,68,59
1657319937645,COGS 101B,A01,091572,Allen; Michael Gordon,11,0,65,54
1657319943669,COGS 101C,A01,083625,Delgado; Tania,17,0,35,18
1657319949709,COGS 107A,A01,083627,Boyle; Mary E. T.,13,0,60,47
1657319955731,COGS 118A,A01,083075,Gupta; Anjum,18,0,76,58
1657319961755,CSE 3,A50,083646,Miranda; Gregory Joseph,24,0,50,26
1657319967776,CSE 8A,A50,083650,Miranda; Gregory Joseph,17,1,56,39
1657319973803,CSE 11,A01,083080,Cao; Yingjun,6,15,40,34
1657319979832,CSE 12,A01,083652,Krause-Levy; Sophia Louisa,28,1,120,92
1657319985880,CSE 15L,A01,083654,Morris; Justin Loren,9,0,50,41
1657319985880,CSE 15L,A02,083655,Morris; Justin Loren,9,0,50,41
1657319991903,CSE 20,A01,083657,Tran; Khoa Dang,38,0,80,42
1657319997929,CSE 21,A01,095574,Bach; Quang Tran,22,0,48,26
1657320003963,CSE 30,A01,083084,Eldon; John,4,0,80,76
1657320003963,CSE 30,B01,095061,Bhaskar; Nishant,9,0,50,41
1657320010025,CSE 100,A01,083659,Cao; Yingjun,4,4,70,66
1657320016048,CSE 134B,A01,083661,Powell; Thomas Allan,22,0,100,78
1657320022070,CSE 140,A01,083663,Gungor; Onat,14,0,85,71
1657320028092,CSE 140L,A01,083088,Eldon; John,21,0,100,79
1657320034115,CSE 175,A01,083665,Kumar; Rakesh,3,0,25,22
1657320040151,CSE 190,A00,092507,Dubnov; Shlomo,7,0,20,13
1657320046191,ECE 45,A01,083139,Congero; Spencer William,6,0,75,69
1657320052215,ECE 65,A50,083695,Saad; Andrew S,12,0,30,18
1657320052215,ECE 65,A51,095125,Saad; Andrew S,25,0,26,1
1657320058238,ECE 109,A01,091882,Touri; Behrouz,19,0,70,51
1657320064261,ECE 180,A00,083140,Abi Samra; Nicholas Camill,1,0,30,29
1657320064261,ECE 180,B00,083141,Abi Samra; Nicholas Camill,0,0,30,30
1657320070284,MATH 10A,A01,083735,Patchell; Gregory David,2,0,30,28
1657320070284,MATH 10A,A02,083736,Patchell; Gregory David,20,0,30,10
1657320070284,MATH 10A,A03,083737,Patchell; Gregory David,16,0,30,14
1657320076313,MATH 10B,A01,083207,Lim; Seonhee,7,0,34,27
1657320076313,MATH 10B,A02,083208,Lim; Seonhee,9,0,35,26
1657320076313,MATH 10B,A03,093472,Lim; Seonhee,7,0,34,27
1657320076313,MATH 10B,B01,083739,Sinha; Shubham,11,0,30,19
1657320082343,MATH 18,A01,083743,Cinel; Cameron Alexander,6,0,30,24
1657320082343,MATH 18,A02,083744,Cinel; Cameron Alexander,17,0,30,13
1657320082343,MATH 18,A03,083745,Cinel; Cameron Alexander,9,0,30,21
1657320082343,MATH 18,B01,083748,Rideout; David Porter,4,0,37,33
1657320082343,MATH 18,B02,083749,Rideout; David Porter,5,0,36,31
1657320082343,MATH 18,B03,083750,Rideout; David Porter,3,0,37,34
1657320082343,MATH 18,B04,083751,Rideout; David Porter,6,0,36,30
1657320082343,MATH 18,B05,093473,Rideout; David Porter,6,0,36,30
1657320082343,MATH 18,B06,093474,Rideout; David Porter,5,0,36,31
1657320088364,MATH 20A,A01,083754,Zheng; Zequn,14,0,40,26
1657320094389,MATH 20B,A01,083756,Briones; Jor-el Thomas Caparas,4,0,36,32
1657320094389,MATH 20B,A02,083757,Briones; Jor-el Thomas Caparas,1,0,36,35
1657320094389,MATH 20B,A03,093475,Briones; Jor-el Thomas Caparas,2,0,36,34
1657320100491,MATH 20C,A01,083760,Briones; Jor-el Thomas Caparas,1,0,35,34
1657320100491,MATH 20C,A02,083761,Briones; Jor-el Thomas Caparas,8,0,35,27
1657320100491,MATH 20C,A03,093476,Briones; Jor-el Thomas Caparas,0,1,36,36
1657320100491,MATH 20C,B01,083762,Bach; Quang Tran,1,0,30,29
1657320106515,MATH 20D,A01,083765,Tran; Brian Kha,5,0,30,25
1657320106515,MATH 20D,A02,083766,Tran; Brian Kha,5,0,30,25
1657320106515,MATH 20D,A03,083767,Tran; Brian Kha,4,0,30,26
1657320112538,MATH 20E,A01,083771,Ganguly; Soumya,7,0,32,25
1657320112538,MATH 20E,A02,083772,Ganguly; Soumya,6,0,32,26
1657320112538,MATH 20E,B01,083773,Ciotti; Benjamin,19,0,35,16
1657320112538,MATH 20E,B02,083774,Ciotti; Benjamin,17,0,35,18
1657320118568,MATH 103A,A01,083777,Greenfeld; Be'Eri,3,0,36,33
1657320118568,MATH 103A,A02,083778,Greenfeld; Be'Eri,5,0,36,31
1657320118568,MATH 103A,A03,093561,Greenfeld; Be'Eri,4,0,36,32
1657320118568,MATH 103A,B01,083779,Greenfeld; Be'Eri,6,0,36,30
1657320118568,MATH 103A,B02,083780,Greenfeld; Be'Eri,4,0,36,32
1657320118568,MATH 103A,B03,093562,Greenfeld; Be'Eri,3,0,36,33
1657320124594,MATH 105,A01,085443,Carter; Anne Toulson,15,0,35,20
1657320124594,MATH 105,A02,093477,Carter; Anne Toulson,20,0,35,15
1657320130622,MATH 109,A01,083213,Ganzberger; Geoffrey Michael,2,0,34,32
1657320130622,MATH 109,A02,083214,Ganzberger; Geoffrey Michael,4,0,34,30
1657320130622,MATH 109,A03,093478,Ganzberger; Geoffrey Michael,2,0,34,32
1657320130622,MATH 109,B01,083215,Ganzberger; Geoffrey Michael,1,0,32,31
1657320130622,MATH 109,B02,083216,Ganzberger; Geoffrey Michael,1,0,32,31
1657320130622,MATH 109,B03,093479,Ganzberger; Geoffrey Michael,8,0,32,24
1657320136648,MATH 142A,A01,083219,Chow; Bennett,7,0,32,25
1657320136648,MATH 142A,A02,083220,Chow; Bennett,10,0,32,22
1657320136648,MATH 142A,A03,093480,Chow; Bennett,7,0,32,25
1657320136648,MATH 142A,B03,093481,Chow; Bennett,8,0,32,24
1657320136648,MATH 142A,B04,093558,Chow; Bennett,13,0,32,19
1657320136648,MATH 142A,B05,093559,Chow; Bennett,6,0,32,26
1657320142674,MATH 193A,A01,083224,Rotar; Vladimir,7,0,34,27
1657320142674,MATH 193A,A02,083225,Rotar; Vladimir,7,0,34,27
1657320142674,MATH 193A,A03,083781,Rotar; Vladimir,3,0,34,31
1657320142674,MATH 193A,A04,083782,Rotar; Vladimir,8,0,34,26
1657320142674,MATH 193A,A05,093482,Rotar; Vladimir,9,0,34,25
1657320148700,MATH 197,001,091859,McAuley; Julian John,9999,0,9999,0
1657320148700,MATH 197,002,095566,Kedlaya; Kiran S.,9997,0,9999,2
1657320148700,MATH 197,003,095567,Xiao; Ming,9999,0,9999,0
1657320148700,MATH 197,004,095571,Perols; Johan Lars,9998,0,9999,1
1657320155750,COGS 9,A01,083615,Shannon; Kyle Michael,8,0,75,67
1657320161774,COGS 11,A01,083617,Boyle; Mary E. T.,22,0,48,26
1657320167810,COGS 13,A01,083071,Bastos; Amalia Pinkusfeld,10,0,71,61
1657320173834,COGS 14A,A01,092681,Semenuks; Arturs,3,1,100,97
1657320179868,COGS 14B,A01,083073,Cheng; Tzu-Han,6,0,63,57
1657320185889,COGS 17,A01,092677,Semenuks; Arturs,6,0,81,75
1657320191915,COGS 100,A01,083619,Allen; Michael Gordon,16,0,70,54
1657320197941,COGS 101A,A01,083621,Davis; Joshua Daniel,9,0,68,59
1657320203966,COGS 101B,A01,091572,Allen; Michael Gordon,11,0,65,54
1657320209989,COGS 101C,A01,083625,Delgado; Tania,17,0,35,18
1657320216023,COGS 107A,A01,083627,Boyle; Mary E. T.,13,0,60,47
1657320222048,COGS 118A,A01,083075,Gupta; Anjum,18,0,76,58
1657320228082,CSE 3,A50,083646,Miranda; Gregory Joseph,24,0,50,26
1657320234112,CSE 8A,A50,083650,Miranda; Gregory Joseph,17,1,56,39
1657320240143,CSE 11,A01,083080,Cao; Yingjun,6,15,40,34
1657320246170,CSE 12,A01,083652,Krause-Levy; Sophia Louisa,28,1,120,92
1657320252202,CSE 15L,A01,083654,Morris; Justin Loren,9,0,50,41
1657320252202,CSE 15L,A02,083655,Morris; Justin Loren,9,0,50,41
1657320258225,CSE 20,A01,083657,Tran; Khoa Dang,38,0,80,42
1657320264248,CSE 21,A01,095574,Bach; Quang Tran,22,0,48,26
1657320270280,CSE 30,A01,083084,Eldon; John,4,0,80,76
1657320270280,CSE 30,B01,095061,Bhaskar; Nishant,9,0,50,41
1657320276307,CSE 100,A01,083659,Cao; Yingjun,4,4,70,66
1657320282337,CSE 134B,A01,083661,Powell; Thomas Allan,22,0,100,78
1657320288359,CSE 140,A01,083663,Gungor; Onat,14,0,85,71
1657320294385,CSE 140L,A01,083088,Eldon; John,21,0,100,79
1657320300412,CSE 175,A01,083665,Kumar; Rakesh,3,0,25,22
1657320306434,CSE 190,A00,092507,Dubnov; Shlomo,7,0,20,13
1657320312456,ECE 45,A01,083139,Congero; Spencer William,6,0,75,69
1657320318478,ECE 65,A50,083695,Saad; Andrew S,12,0,30,18
1657320318478,ECE 65,A51,095125,Saad; Andrew S,25,0,26,1
1657320324503,ECE 109,A01,091882,Touri; Behrouz,19,0,70,51
1657320330532,ECE 180,A00,083140,Abi Samra; Nicholas Camill,1,0,30,29
1657320330532,ECE 180,B00,083141,Abi Samra; Nicholas Camill,0,0,30,30
1657320336561,MATH 10A,A01,083735,Patchell; Gregory David,2,0,30,28
1657320336561,MATH 10A,A02,083736,Patchell; Gregory David,20,0,30,10
1657320336561,MATH 10A,A03,083737,Patchell; Gregory David,16,0,30,14
1657320342587,MATH 10B,A01,083207,Lim; Seonhee,7,0,34,27
1657320342587,MATH 10B,A02,083208,Lim; Seonhee,9,0,35,26
1657320342587,MATH 10B,A03,093472,Lim; Seonhee,7,0,34,27
1657320342587,MATH 10B,B01,083739,Sinha; Shubham,11,0,30,19
1657320348611,MATH 18,A01,083743,Cinel; Cameron Alexander,6,0,30,24
1657320348611,MATH 18,A02,083744,Cinel; Cameron Alexander,17,0,30,13
1657320348611,MATH 18,A03,083745,Cinel; Cameron Alexander,9,0,30,21
1657320348611,MATH 18,B01,083748,Rideout; David Porter,4,0,37,33
1657320348611,MATH 18,B02,083749,Rideout; David Porter,5,0,36,31
1657320348611,MATH 18,B03,083750,Rideout; David Porter,3,0,37,34
1657320348611,MATH 18,B04,083751,Rideout; David Porter,6,0,36,30
1657320348611,MATH 18,B05,093473,Rideout; David Porter,6,0,36,30
1657320348611,MATH 18,B06,093474,Rideout; David Porter,5,0,36,31
1657320354642,MATH 20A,A01,083754,Zheng; Zequn,14,0,40,26
1657320360665,MATH 20B,A01,083756,Briones; Jor-el Thomas Caparas,4,0,36,32
1657320360665,MATH 20B,A02,083757,Briones; Jor-el Thomas Caparas,1,0,36,35
1657320360665,MATH 20B,A03,093475,Briones; Jor-el Thomas Caparas,2,0,36,34
1657320366693,MATH 20C,A01,083760,Briones; Jor-el Thomas Caparas,1,0,35,34
1657320366693,MATH 20C,A02,083761,Briones; Jor-el Thomas Caparas,8,0,35,27
1657320366693,MATH 20C,A03,093476,Briones; Jor-el Thomas Caparas,0,1,36,36
1657320366693,MATH 20C,B01,083762,Bach; Quang Tran,1,0,30,29
1657320372729,MATH 20D,A01,083765,Tran; Brian Kha,5,0,30,25
1657320372729,MATH 20D,A02,083766,Tran; Brian Kha,5,0,30,25
1657320372729,MATH 20D,A03,083767,Tran; Brian Kha,4,0,30,26
1657320378752,MATH 20E,A01,083771,Ganguly; Soumya,7,0,32,25
1657320378752,MATH 20E,A02,083772,Ganguly; Soumya,6,0,32,26
1657320378752,MATH 20E,B01,083773,Ciotti; Benjamin,19,0,35,16
1657320378752,MATH 20E,B02,083774,Ciotti; Benjamin,17,0,35,18
1657320384775,MATH 103A,A01,083777,Greenfeld; Be'Eri,3,0,36,33
1657320384775,MATH 103A,A02,083778,Greenfeld; Be'Eri,5,0,36,31
1657320384775,MATH 103A,A03,093561,Greenfeld; Be'Eri,4,0,36,32
1657320384775,MATH 103A,B01,083779,Greenfeld; Be'Eri,6,0,36,30
1657320384775,MATH 103A,B02,083780,Greenfeld; Be'Eri,4,0,36,32
1657320384775,MATH 103A,B03,093562,Greenfeld; Be'Eri,3,0,36,33
1657320390797,MATH 105,A01,085443,Carter; Anne Toulson,15,0,35,20
1657320390797,MATH 105,A02,093477,Carter; Anne Toulson,20,0,35,15
1657320396825,MATH 109,A01,083213,Ganzberger; Geoffrey Michael,2,0,34,32
1657320396825,MATH 109,A02,083214,Ganzberger; Geoffrey Michael,4,0,34,30
1657320396825,MATH 109,A03,093478,Ganzberger; Geoffrey Michael,2,0,34,32
1657320396825,MATH 109,B01,083215,Ganzberger; Geoffrey Michael,1,0,32,31
1657320396825,MATH 109,B02,083216,Ganzberger; Geoffrey Michael,1,0,32,31
1657320396825,MATH 109,B03,093479,Ganzberger; Geoffrey Michael,8,0,32,24
1657320402856,MATH 142A,A01,083219,Chow; Bennett,7,0,32,25
1657320402856,MATH 142A,A02,083220,Chow; Bennett,10,0,32,22
1657320402856,MATH 142A,A03,093480,Chow; Bennett,7,0,32,25
1657320402856,MATH 142A,B03,093481,Chow; Bennett,8,0,32,24
1657320402856,MATH 142A,B04,093558,Chow; Bennett,13,0,32,19
1657320402856,MATH 142A,B05,093559,Chow; Bennett,6,0,32,26
1657320408879,MATH 193A,A01,083224,Rotar; Vladimir,7,0,34,27
1657320408879,MATH 193A,A02,083225,Rotar; Vladimir,7,0,34,27
1657320408879,MATH 193A,A03,083781,Rotar; Vladimir,3,0,34,31
1657320408879,MATH 193A,A04,083782,Rotar; Vladimir,8,0,34,26
1657320408879,MATH 193A,A05,093482,Rotar; Vladimir,9,0,34,25
1657320414903,MATH 197,001,091859,McAuley; Julian John,9999,0,9999,0
1657320414903,MATH 197,002,095566,Kedlaya; Kiran S.,9997,0,9999,2
1657320414903,MATH 197,003,095567,Xiao; Ming,9999,0,9999,0
1657320414903,MATH 197,004,095571,Perols; Johan Lars,9998,0,9999,1
1657320421963,COGS 9,A01,083615,Shannon; Kyle Michael,8,0,75,67
1657320427987,COGS 11,A01,083617,Boyle; Mary E. T.,22,0,48,26
1657320434012,COGS 13,A01,083071,Bastos; Amalia Pinkusfeld,10,0,71,61
1657320440037,COGS 14A,A01,092681,Semenuks; Arturs,3,1,100,97
1657320446063,COGS 14B,A01,083073,Cheng; Tzu-Han,6,0,63,57
1657320452104,COGS 17,A01,092677,Semenuks; Arturs,6,0,81,75
1657320458129,COGS 100,A01,083619,Allen; Michael Gordon,16,0,70,54
1657320464152,COGS 101A,A01,083621,Davis; Joshua Daniel,9,0,68,59
1657320470175,COGS 101B,A01,091572,Allen; Michael Gordon,11,0,65,54
1657320476200,COGS 101C,A01,083625,Delgado; Tania,17,0,35,18
1657320482229,COGS 107A,A01,083627,Boyle; Mary E. T.,13,0,60,47
1657320488264,COGS 118A,A01,083075,Gupta; Anjum,18,0,76,58
1657320494287,CSE 3,A50,083646,Miranda; Gregory Joseph,24,0,50,26
1657320500321,CSE 8A,A50,083650,Miranda; Gregory Joseph,17,1,56,39
1657320506345,CSE 11,A01,083080,Cao; Yingjun,6,15,40,34
1657320512367,CSE 12,A01,083652,Krause-Levy; Sophia Louisa,28,1,120,92
1657320518393,CSE 15L,A01,083654,Morris; Justin Loren,9,0,50,41
1657320518393,CSE 15L,A02,083655,Morris; Justin Loren,9,0,50,41
1657320524417,CSE 20,A01,083657,Tran; Khoa Dang,38,0,80,42
1657320530444,CSE 21,A01,095574,Bach; Quang Tran,22,0,48,26
1657320536466,CSE 30,A01,083084,Eldon; John,4,0,80,76
1657320536466,CSE 30,B01,095061,Bhaskar; Nishant,9,0,50,41
1657320542489,CSE 100,A01,083659,Cao; Yingjun,4,4,70,66
1657320548515,CSE 134B,A01,083661,Powell; Thomas Allan,22,0,100,78
1657320554537,CSE 140,A01,083663,Gungor; Onat,14,0,85,71
1657320560558,CSE 140L,A01,083088,Eldon; John,21,0,100,79
1657320566583,CSE 175,A01,083665,Kumar; Rakesh,3,0,25,22
1657320572607,CSE 190,A00,092507,Dubnov; Shlomo,7,0,20,13
1657320578630,ECE 45,A01,083139,Congero; Spencer William,6,0,75,69
1657320584652,ECE 65,A50,083695,Saad; Andrew S,12,0,30,18
1657320584652,ECE 65,A51,095125,Saad; Andrew S,24,0,26,2
1657320590676,ECE 109,A01,091882,Touri; Behrouz,19,0,70,51
1657320596699,ECE 180,A00,083140,Abi Samra; Nicholas Camill,1,0,30,29
1657320596699,ECE 180,B00,083141,Abi Samra; Nicholas Camill,0,0,30,30
1657320602723,MATH 10A,A01,083735,Patchell; Gregory David,2,0,30,28
1657320602723,MATH 10A,A02,083736,Patchell; Gregory David,20,0,30,10
1657320602723,MATH 10A,A03,083737,Patchell; Gregory David,16,0,30,14
1657320608761,MATH 10B,A01,083207,Lim; Seonhee,7,0,34,27
1657320608761,MATH 10B,A02,083208,Lim; Seonhee,9,0,35,26
1657320608761,MATH 10B,A03,093472,Lim; Seonhee,7,0,34,27
1657320608761,MATH 10B,B01,083739,Sinha; Shubham,11,0,30,19
1657320614791,MATH 18,A01,083743,Cinel; Cameron Alexander,6,0,30,24
1657320614791,MATH 18,A02,083744,Cinel; Cameron Alexander,17,0,30,13
1657320614791,MATH 18,A03,083745,Cinel; Cameron Alexander,9,0,30,21
1657320614791,MATH 18,B01,083748,Rideout; David Porter,4,0,37,33
1657320614791,MATH 18,B02,083749,Rideout; David Porter,5,0,36,31
1657320614791,MATH 18,B03,083750,Rideout; David Porter,3,0,37,34
1657320614791,MATH 18,B04,083751,Rideout; David Porter,6,0,36,30
1657320614791,MATH 18,B05,093473,Rideout; David Porter,6,0,36,30
1657320614791,MATH 18,B06,093474,Rideout; David Porter,5,0,36,31
1657320620814,MATH 20A,A01,083754,Zheng; Zequn,14,0,40,26
1657320626856,MATH 20B,A01,083756,Briones; Jor-el Thomas Caparas,4,0,36,32
1657320626856,MATH 20B,A02,083757,Briones; Jor-el Thomas Caparas,1,0,36,35
1657320626856,MATH 20B,A03,093475,Briones; Jor-el Thomas Caparas,2,0,36,34
1657320632880,MATH 20C,A01,083760,Briones; Jor-el Thomas Caparas,1,0,35,34
1657320632880,MATH 20C,A02,083761,Briones; Jor-el Thomas Caparas,8,0,35,27
1657320632880,MATH 20C,A03,093476,Briones; Jor-el Thomas Caparas,0,1,36,36
1657320632880,MATH 20C,B01,083762,Bach; Quang Tran,1,0,30,29
1657320638906,MATH 20D,A01,083765,Tran; Brian Kha,5,0,30,25
1657320638906,MATH 20D,A02,083766,Tran; Brian Kha,5,0,30,25
1657320638906,MATH 20D,A03,083767,Tran; Brian Kha,4,0,30,26
1657320644935,MATH 20E,A01,083771,Ganguly; Soumya,7,0,32,25
1657320644935,MATH 20E,A02,083772,Ganguly; Soumya,6,0,32,26
1657320644935,MATH 20E,B01,083773,Ciotti; Benjamin,19,0,35,16
1657320644935,MATH 20E,B02,083774,Ciotti; Benjamin,17,0,35,18
1657320650962,MATH 103A,A01,083777,Greenfeld; Be'Eri,3,0,36,33
1657320650962,MATH 103A,A02,083778,Greenfeld; Be'Eri,5,0,36,31
1657320650962,MATH 103A,A03,093561,Greenfeld; Be'Eri,4,0,36,32
1657320650962,MATH 103A,B01,083779,Greenfeld; Be'Eri,6,0,36,30
1657320650962,MATH 103A,B02,083780,Greenfeld; Be'Eri,4,0,36,32
1657320650962,MATH 103A,B03,093562,Greenfeld; Be'Eri,3,0,36,33
1657320656989,MATH 105,A01,085443,Carter; Anne Toulson,15,0,35,20
1657320656989,MATH 105,A02,093477,Carter; Anne Toulson,20,0,35,15
1657320663013,MATH 109,A01,083213,Ganzberger; Geoffrey Michael,2,0,34,32
1657320663013,MATH 109,A02,083214,Ganzberger; Geoffrey Michael,4,0,34,30
1657320663013,MATH 109,A03,093478,Ganzberger; Geoffrey Michael,2,0,34,32
1657320663013,MATH 109,B01,083215,Ganzberger; Geoffrey Michael,1,0,32,31
1657320663013,MATH 109,B02,083216,Ganzberger; Geoffrey Michael,1,0,32,31
1657320663013,MATH 109,B03,093479,Ganzberger; Geoffrey Michael,8,0,32,24
1657320669042,MATH 142A,A01,083219,Chow; Bennett,7,0,32,25
1657320669042,MATH 142A,A02,083220,Chow; Bennett,10,0,32,22
1657320669042,MATH 142A,A03,093480,Chow; Bennett,7,0,32,25
1657320669042,MATH 142A,B03,093481,Chow; Bennett,8,0,32,24
1657320669042,MATH 142A,B04,093558,Chow; Bennett,13,0,32,19
1657320669042,MATH 142A,B05,093559,Chow; Bennett,6,0,32,26
1657320675067,MATH 193A,A01,083224,Rotar; Vladimir,7,0,34,27
1657320675067,MATH 193A,A02,083225,Rotar; Vladimir,7,0,34,27
1657320675067,MATH 193A,A03,083781,Rotar; Vladimir,3,0,34,31
1657320675067,MATH 193A,A04,083782,Rotar; Vladimir,8,0,34,26
1657320675067,MATH 193A,A05,093482,Rotar; Vladimir,9,0,34,25
1657320681115,MATH 197,001,091859,McAuley; Julian John,9999,0,9999,0
1657320681115,MATH 197,002,095566,Kedlaya; Kiran S.,9997,0,9999,2
1657320681115,MATH 197,003,095567,Xiao; Ming,9999,0,9999,0
1657320681115,MATH 197,004,095571,Perols; Johan Lars,9998,0,9999,1
1657320688184,COGS 9,A01,083615,Shannon; Kyle Michael,8,0,75,67
1657320694294,COGS 11,A01,083617,Boyle; Mary E. T.,22,0,48,26
1657320700316,COGS 13,A01,083071,Bastos; Amalia Pinkusfeld,10,0,71,61
1657320706342,COGS 14A,A01,092681,Semenuks; Arturs,3,1,100,97
1657320712370,COGS 14B,A01,083073,Cheng; Tzu-Han,6,0,63,57
1657320718392,COGS 17,A01,092677,Semenuks; Arturs,6,0,81,75
1657320724418,COGS 100,A01,083619,Allen; Michael Gordon,16,0,70,54
1657320730441,COGS 101A,A01,083621,Davis; Joshua Daniel,9,0,68,59
1657320736468,COGS 101B,A01,091572,Allen; Michael Gordon,11,0,65,54
1657320742494,COGS 101C,A01,083625,Delgado; Tania,17,0,35,18
1657320748520,COGS 107A,A01,083627,Boyle; Mary E. T.,13,0,60,47
1657320754547,COGS 118A,A01,083075,Gupta; Anjum,18,0,76,58
1657320760575,CSE 3,A50,083646,Miranda; Gregory Joseph,24,0,50,26
1657320766608,CSE 8A,A50,083650,Miranda; Gregory Joseph,17,1,56,39
1657320772634,CSE 11,A01,083080,Cao; Yingjun,6,15,40,34
1657320778657,CSE 12,A01,083652,Krause-Levy; Sophia Louisa,28,1,120,92
1657320784681,CSE 15L,A01,083654,Morris; Justin Loren,9,0,50,41
1657320784681,CSE 15L,A02,083655,Morris; Justin Loren,9,0,50,41
1657320790709,CSE 20,A01,083657,Tran; Khoa Dang,38,0,80,42
1657320796737,CSE 21,A01,095574,Bach; Quang Tran,22,0,48,26
1657320802762,CSE 30,A01,083084,Eldon; John,4,0,80,76
1657320802762,CSE 30,B01,095061,Bhaskar; Nishant,9,0,50,41
1657320808788,CSE 100,A01,083659,Cao; Yingjun,4,4,70,66
1657320814813,CSE 134B,A01,083661,Powell; Thomas Allan,22,0,100,78
1657320820836,CSE 140,A01,083663,Gungor; Onat,14,0,85,71
1657320826862,CSE 140L,A01,083088,Eldon; John,21,0,100,79
1657320832888,CSE 175,A01,083665,Kumar; Rakesh,3,0,25,22
1657320838913,CSE 190,A00,092507,Dubnov; Shlomo,7,0,20,13
1657320844936,ECE 45,A01,083139,Congero; Spencer William,6,0,75,69
1657320850965,ECE 65,A50,083695,Saad; Andrew S,12,0,30,18
1657320850965,ECE 65,A51,095125,Saad; Andrew S,24,0,26,2
1657320856992,ECE 109,A01,091882,Touri; Behrouz,19,0,70,51
1657320863018,ECE 180,A00,083140,Abi Samra; Nicholas Camill,1,0,30,29
1657320863018,ECE 180,B00,083141,Abi Samra; Nicholas Camill,0,0,30,30
1657320869047,MATH 10A,A01,083735,Patchell; Gregory David,2,0,30,28
1657320869047,MATH 10A,A02,083736,Patchell; Gregory David,20,0,30,10
1657320869047,MATH 10A,A03,083737,Patchell; Gregory David,16,0,30,14
1657320875089,MATH 10B,A01,083207,Lim; Seonhee,7,0,34,27
1657320875089,MATH 10B,A02,083208,Lim; Seonhee,9,0,35,26
1657320875089,MATH 10B,A03,093472,Lim; Seonhee,7,0,34,27
1657320875089,MATH 10B,B01,083739,Sinha; Shubham,11,0,30,19
1657320881126,MATH 18,A01,083743,Cinel; Cameron Alexander,6,0,30,24
1657320881126,MATH 18,A02,083744,Cinel; Cameron Alexander,17,0,30,13
1657320881126,MATH 18,A03,083745,Cinel; Cameron Alexander,9,0,30,21
1657320881126,MATH 18,B01,083748,Rideout; David Porter,4,0,37,33
1657320881126,MATH 18,B02,083749,Rideout; David Porter,5,0,36,31
1657320881126,MATH 18,B03,083750,Rideout; David Porter,3,0,37,34
1657320881126,MATH 18,B04,083751,Rideout; David Porter,6,0,36,30
1657320881126,MATH 18,B05,093473,Rideout; David Porter,6,0,36,30
1657320881126,MATH 18,B06,093474,Rideout; David Porter,5,0,36,31
1657320887155,MATH 20A,A01,083754,Zheng; Zequn,14,0,40,26
1657320893179,MATH 20B,A01,083756,Briones; Jor-el Thomas Caparas,4,0,36,32
1657320893179,MATH 20B,A02,083757,Briones; Jor-el Thomas Caparas,1,0,36,35
1657320893179,MATH 20B,A03,093475,Briones; Jor-el Thomas Caparas,2,0,36,34
1657320899201,MATH 20C,A01,083760,Briones; Jor-el Thomas Caparas,1,0,35,34
1657320899201,MATH 20C,A02,083761,Briones; Jor-el Thomas Caparas,8,0,35,27
1657320899201,MATH 20C,A03,093476,Briones; Jor-el Thomas Caparas,0,1,36,36
1657320899201,MATH 20C,B01,083762,Bach; Quang Tran,1,0,30,29
1657320905226,MATH 20D,A01,083765,Tran; Brian Kha,5,0,30,25
1657320905226,MATH 20D,A02,083766,Tran; Brian Kha,5,0,30,25
1657320905226,MATH 20D,A03,083767,Tran; Brian Kha,4,0,30,26
1657320911252,MATH 20E,A01,083771,Ganguly; Soumya,7,0,32,25
1657320911252,MATH 20E,A02,083772,Ganguly; Soumya,6,0,32,26
1657320911252,MATH 20E,B01,083773,Ciotti; Benjamin,19,0,35,16
1657320911252,MATH 20E,B02,083774,Ciotti; Benjamin,17,0,35,18
1657320917278,MATH 103A,A01,083777,Greenfeld; Be'Eri,3,0,36,33
1657320917278,MATH 103A,A02,083778,Greenfeld; Be'Eri,5,0,36,31
1657320917278,MATH 103A,A03,093561,Greenfeld; Be'Eri,4,0,36,32
1657320917278,MATH 103A,B01,083779,Greenfeld; Be'Eri,6,0,36,30
1657320917278,MATH 103A,B02,083780,Greenfeld; Be'Eri,4,0,36,32
1657320917278,MATH 103A,B03,093562,Greenfeld; Be'Eri,3,0,36,33
1657320923306,MATH 105,A01,085443,Carter; Anne Toulson,15,0,35,20
1657320923306,MATH 105,A02,093477,Carter; Anne Toulson,20,0,35,15
1657320929338,MATH 109,A01,083213,Ganzberger; Geoffrey Michael,2,0,34,32
1657320929338,MATH 109,A02,083214,Ganzberger; Geoffrey Michael,4,0,34,30
1657320929338,MATH 109,A03,093478,Ganzberger; Geoffrey Michael,2,0,34,32
1657320929338,MATH 109,B01,083215,Ganzberger; Geoffrey Michael,1,0,32,31
1657320929338,MATH 109,B02,083216,Ganzberger; Geoffrey Michael,1,0,32,31
1657320929338,MATH 109,B03,093479,Ganzberger; Geoffrey Michael,8,0,32,24
1657320935367,MATH 142A,A01,083219,Chow; Bennett,7,0,32,25
1657320935367,MATH 142A,A02,083220,Chow; Bennett,10,0,32,22
1657320935367,MATH 142A,A03,093480,Chow; Bennett,7,0,32,25
1657320935367,MATH 142A,B03,093481,Chow; Bennett,8,0,32,24
1657320935367,MATH 142A,B04,093558,Chow; Bennett,13,0,32,19
1657320935367,MATH 142A,B05,093559,Chow; Bennett,6,0,32,26
1657320941408,MATH 193A,A01,083224,Rotar; Vladimir,7,0,34,27
1657320941408,MATH 193A,A02,083225,Rotar; Vladimir,7,0,34,27
1657320941408,MATH 193A,A03,083781,Rotar; Vladimir,3,0,34,31
1657320941408,MATH 193A,A04,083782,Rotar; Vladimir,8,0,34,26
1657320941408,MATH 193A,A05,093482,Rotar; Vladimir,9,0,34,25
1657320947432,MATH 197,001,091859,McAuley; Julian John,9999,0,9999,0
1657320947432,MATH 197,002,095566,Kedlaya; Kiran S.,9997,0,9999,2
1657320947432,MATH 197,003,095567,Xiao; Ming,9999,0,9999,0
1657320947432,MATH 197,004,095571,Perols; Johan Lars,9998,0,9999,1
1657320954486,COGS 9,A01,083615,Shannon; Kyle Michael,8,0,75,67
1657320960520,COGS 11,A01,083617,Boyle; Mary E. T.,22,0,48,26
1657320966565,COGS 13,A01,083071,Bastos; Amalia Pinkusfeld,10,0,71,61
1657320972597,COGS 14A,A01,092681,Semenuks; Arturs,3,1,100,97
1657320978624,COGS 14B,A01,083073,Cheng; Tzu-Han,6,0,63,57
1657320984650,COGS 17,A01,092677,Semenuks; Arturs,6,0,81,75
1657320990678,COGS 100,A01,083619,Allen; Michael Gordon,16,0,70,54
1657320996707,COGS 101A,A01,083621,Davis; Joshua Daniel,9,0,68,59
1657321002739,COGS 101B,A01,091572,Allen; Michael Gordon,11,0,65,54
1657321008764,COGS 101C,A01,083625,Delgado; Tania,17,0,35,18
1657321014790,COGS 107A,A01,083627,Boyle; Mary E. T.,13,0,60,47
1657321020814,COGS 118A,A01,083075,Gupta; Anjum,18,0,76,58
1657321026843,CSE 3,A50,083646,Miranda; Gregory Joseph,24,0,50,26
1657321032871,CSE 8A,A50,083650,Miranda; Gregory Joseph,17,1,56,39
1657321038894,CSE 11,A01,083080,Cao; Yingjun,6,15,40,34
1657321044917,CSE 12,A01,083652,Krause-Levy; Sophia Louisa,28,1,120,92
1657321050939,CSE 15L,A01,083654,Morris; Justin Loren,9,0,50,41
1657321050939,CSE 15L,A02,083655,Morris; Justin Loren,9,0,50,41
1657321056961,CSE 20,A01,083657,Tran; Khoa Dang,38,0,80,42
1657321062985,CSE 21,A01,095574,Bach; Quang Tran,22,0,48,26
1657321069022,CSE 30,A01,083084,Eldon; John,4,0,80,76
1657321069022,CSE 30,B01,095061,Bhaskar; Nishant,9,0,50,41
1657321075051,CSE 100,A01,083659,Cao; Yingjun,4,4,70,66
1657321081073,CSE 134B,A01,083661,Powell; Thomas Allan,22,0,100,78
1657321087101,CSE 140,A01,083663,Gungor; Onat,14,0,85,71
1657321093128,CSE 140L,A01,083088,Eldon; John,21,0,100,79
1657321099153,CSE 175,A01,083665,Kumar; Rakesh,3,0,25,22
1657321105179,CSE 190,A00,092507,Dubnov; Shlomo,7,0,20,13
1657321111218,ECE 45,A01,083139,Congero; Spencer William,6,0,75,69
1657321117258,ECE 65,A50,083695,Saad; Andrew S,12,0,30,18
1657321117258,ECE 65,A51,095125,Saad; Andrew S,24,0,26,2
1657321123289,ECE 109,A01,091882,Touri; Behrouz,19,0,70,51
1657321129316,ECE 180,A00,083140,Abi Samra; Nicholas Camill,1,0,30,29
1657321129316,ECE 180,B00,083141,Abi Samra; Nicholas Camill,0,0,30,30
1657321135343,MATH 10A,A01,083735,Patchell; Gregory David,2,0,30,28
1657321135343,MATH 10A,A02,083736,Patchell; Gregory David,20,0,30,10
1657321135343,MATH 10A,A03,083737,Patchell; Gregory David,16,0,30,14
1657321141370,MATH 10B,A01,083207,Lim; Seonhee,7,0,34,27
1657321141370,MATH 10B,A02,083208,Lim; Seonhee,9,0,35,26
1657321141370,MATH 10B,A03,093472,Lim; Seonhee,7,0,34,27
1657321141370,MATH 10B,B01,083739,Sinha; Shubham,11,0,30,19
1657321147398,MATH 18,A01,083743,Cinel; Cameron Alexander,6,0,30,24
1657321147398,MATH 18,A02,083744,Cinel; Cameron Alexander,17,0,30,13
1657321147398,MATH 18,A03,083745,Cinel; Cameron Alexander,9,0,30,21
1657321147398,MATH 18,B01,083748,Rideout; David Porter,4,0,37,33
1657321147398,MATH 18,B02,083749,Rideout; David Porter,5,0,36,31
1657321147398,MATH 18,B03,083750,Rideout; David Porter,3,0,37,34
1657321147398,MATH 18,B04,083751,Rideout; David Porter,6,0,36,30
1657321147398,MATH 18,B05,093473,Rideout; David Porter,6,0,36,30
1657321147398,MATH 18,B06,093474,Rideout; David Porter,5,0,36,31
1657321153438,MATH 20A,A01,083754,Zheng; Zequn,14,0,40,26
1657321159466,MATH 20B,A01,083756,Briones; Jor-el Thomas Caparas,4,0,36,32
1657321159466,MATH 20B,A02,083757,Briones; Jor-el Thomas Caparas,1,0,36,35
1657321159466,MATH 20B,A03,093475,Briones; Jor-el Thomas Caparas,2,0,36,34
1657321165488,MATH 20C,A01,083760,Briones; Jor-el Thomas Caparas,1,0,35,34
1657321165488,MATH 20C,A02,083761,Briones; Jor-el Thomas Caparas,8,0,35,27
1657321165488,MATH 20C,A03,093476,Briones; Jor-el Thomas Caparas,0,1,36,36
1657321165488,MATH 20C,B01,083762,Bach; Quang Tran,1,0,30,29
1657321171518,MATH 20D,A01,083765,Tran; Brian Kha,5,0,30,25
1657321171518,MATH 20D,A02,083766,Tran; Brian Kha,5,0,30,25
1657321171518,MATH 20D,A03,083767,Tran; Brian Kha,4,0,30,26
1657321177565,MATH 20E,A01,083771,Ganguly; Soumya,7,0,32,25
1657321177565,MATH 20E,A02,083772,Ganguly; Soumya,6,0,32,26
1657321177565,MATH 20E,B01,083773,Ciotti; Benjamin,19,0,35,16
1657321177565,MATH 20E,B02,083774,Ciotti; Benjamin,17,0,35,18
1657321183606,MATH 103A,A01,083777,Greenfeld; Be'Eri,3,0,36,33
1657321183606,MATH 103A,A02,083778,Greenfeld; Be'Eri,5,0,36,31
1657321183606,MATH 103A,A03,093561,Greenfeld; Be'Eri,4,0,36,32
1657321183606,MATH 103A,B01,083779,Greenfeld; Be'Eri,6,0,36,30
1657321183606,MATH 103A,B02,083780,Greenfeld; Be'Eri,4,0,36,32
1657321183606,MATH 103A,B03,093562,Greenfeld; Be'Eri,3,0,36,33
1657321189628,MATH 105,A01,085443,Carter; Anne Toulson,15,0,35,20
1657321189628,MATH 105,A02,093477,Carter; Anne Toulson,20,0,35,15
1657321195651,MATH 109,A01,083213,Ganzberger; Geoffrey Michael,2,0,34,32
1657321195651,MATH 109,A02,083214,Ganzberger; Geoffrey Michael,4,0,34,30
1657321195651,MATH 109,A03,093478,Ganzberger; Geoffrey Michael,2,0,34,32
1657321195651,MATH 109,B01,083215,Ganzberger; Geoffrey Michael,1,0,32,31
1657321195651,MATH 109,B02,083216,Ganzberger; Geoffrey Michael,1,0,32,31
1657321195651,MATH 109,B03,093479,Ganzberger; Geoffrey Michael,8,0,32,24
1657321201680,MATH 142A,A01,083219,Chow; Bennett,7,0,32,25
1657321201680,MATH 142A,A02,083220,Chow; Bennett,10,0,32,22
1657321201680,MATH 142A,A03,093480,Chow; Bennett,7,0,32,25
1657321201680,MATH 142A,B03,093481,Chow; Bennett,8,0,32,24
1657321201680,MATH 142A,B04,093558,Chow; Bennett,13,0,32,19
1657321201680,MATH 142A,B05,093559,Chow; Bennett,6,0,32,26
1657321207704,MATH 193A,A01,083224,Rotar; Vladimir,7,0,34,27
1657321207704,MATH 193A,A02,083225,Rotar; Vladimir,7,0,34,27
1657321207704,MATH 193A,A03,083781,Rotar; Vladimir,3,0,34,31
1657321207704,MATH 193A,A04,083782,Rotar; Vladimir,8,0,34,26
1657321207704,MATH 193A,A05,093482,Rotar; Vladimir,9,0,34,25
1657321213728,MATH 197,001,091859,McAuley; Julian John,9999,0,9999,0
1657321213728,MATH 197,002,095566,Kedlaya; Kiran S.,9997,0,9999,2
1657321213728,MATH 197,003,095567,Xiao; Ming,9999,0,9999,0
1657321213728,MATH 197,004,095571,Perols; Johan Lars,9998,0,9999,1
1657321220781,COGS 9,A01,083615,Shannon; Kyle Michael,8,0,75,67
1657321226809,COGS 11,A01,083617,Boyle; Mary E. T.,22,0,48,26
1657321232836,COGS 13,A01,083071,Bastos; Amalia Pinkusfeld,11,0,71,60
1657321238860,COGS 14A,A01,092681,Semenuks; Arturs,3,1,100,97
1657321244883,COGS 14B,A01,083073,Cheng; Tzu-Han,6,0,63,57
1657321250914,COGS 17,A01,092677,Semenuks; Arturs,6,0,81,75
1657321256947,COGS 100,A01,083619,Allen; Michael Gordon,16,0,70,54
1657321262968,COGS 101A,A01,083621,Davis; Joshua Daniel,9,0,68,59
1657321268990,COGS 101B,A01,091572,Allen; Michael Gordon,11,0,65,54
1657321275014,COGS 101C,A01,083625,Delgado; Tania,17,0,35,18
1657321281038,COGS 107A,A01,083627,Boyle; Mary E. T.,13,0,60,47
1657321287078,COGS 118A,A01,083075,Gupta; Anjum,18,0,76,58
1657321293171,CSE 3,A50,083646,Miranda; Gregory Joseph,24,0,50,26
1657321299197,CSE 8A,A50,083650,Miranda; Gregory Joseph,17,1,56,39
1657321305223,CSE 11,A01,083080,Cao; Yingjun,6,15,40,34
1657321311254,CSE 12,A01,083652,Krause-Levy; Sophia Louisa,28,1,120,92
1657321317276,CSE 15L,A01,083654,Morris; Justin Loren,9,0,50,41
1657321317276,CSE 15L,A02,083655,Morris; Justin Loren,9,0,50,41
1657321323312,CSE 20,A01,083657,Tran; Khoa Dang,38,0,80,42
1657321329348,CSE 21,A01,095574,Bach; Quang Tran,22,0,48,26
1657321335371,CSE 30,A01,083084,Eldon; John,4,0,80,76
1657321335371,CSE 30,B01,095061,Bhaskar; Nishant,9,0,50,41
1657321341394,CSE 100,A01,083659,Cao; Yingjun,4,4,70,66
1657321347421,CSE 134B,A01,083661,Powell; Thomas Allan,22,0,100,78
1657321353447,CSE 140,A01,083663,Gungor; Onat,14,0,85,71
1657321359492,CSE 140L,A01,083088,Eldon; John,21,0,100,79
1657321365516,CSE 175,A01,083665,Kumar; Rakesh,3,0,25,22
1657321371538,CSE 190,A00,092507,Dubnov; Shlomo,7,0,20,13
1657321377563,ECE 45,A01,083139,Congero; Spencer William,6,0,75,69
1657321383587,ECE 65,A50,083695,Saad; Andrew S,12,0,30,18
1657321383587,ECE 65,A51,095125,Saad; Andrew S,24,0,26,2
1657321389609,ECE 109,A01,091882,Touri; Behrouz,19,0,70,51
1657321395645,ECE 180,A00,083140,Abi Samra; Nicholas Camill,1,0,30,29
1657321395645,ECE 180,B00,083141,Abi Samra; Nicholas Camill,0,0,30,30
1657321401670,MATH 10A,A01,083735,Patchell; Gregory David,2,0,30,28
1657321401670,MATH 10A,A02,083736,Patchell; Gregory David,20,0,30,10
1657321401670,MATH 10A,A03,083737,Patchell; Gregory David,16,0,30,14
1657321407693,MATH 10B,A01,083207,Lim; Seonhee,7,0,34,27
1657321407693,MATH 10B,A02,083208,Lim; Seonhee,9,0,35,26
1657321407693,MATH 10B,A03,093472,Lim; Seonhee,7,0,34,27
1657321407693,MATH 10B,B01,083739,Sinha; Shubham,11,0,30,19
1657321413719,MATH 18,A01,083743,Cinel; Cameron Alexander,6,0,30,24
1657321413719,MATH 18,A02,083744,Cinel; Cameron Alexander,17,0,30,13
1657321413719,MATH 18,A03,083745,Cinel; Cameron Alexander,9,0,30,21
1657321413719,MATH 18,B01,083748,Rideout; David Porter,4,0,37,33
1657321413719,MATH 18,B02,083749,Rideout; David Porter,5,0,36,31
1657321413719,MATH 18,B03,083750,Rideout; David Porter,3,0,37,34
1657321413719,MATH 18,B04,083751,Rideout; David Porter,6,0,36,30
1657321413719,MATH 18,B05,093473,Rideout; David Porter,6,0,36,30
1657321413719,MATH 18,B06,093474,Rideout; David Porter,5,0,36,31
1657321419746,MATH 20A,A01,083754,Zheng; Zequn,14,0,40,26
1657321425769,MATH 20B,A01,083756,Briones; Jor-el Thomas Caparas,4,0,36,32
1657321425769,MATH 20B,A02,083757,Briones; Jor-el Thomas Caparas,1,0,36,35
1657321425769,MATH 20B,A03,093475,Briones; Jor-el Thomas Caparas,2,0,36,34
1657321431790,MATH 20C,A01,083760,Briones; Jor-el Thomas Caparas,1,0,35,34
1657321431790,MATH 20C,A02,083761,Briones; Jor-el Thomas Caparas,8,0,35,27
1657321431790,MATH 20C,A03,093476,Briones; Jor-el Thomas Caparas,0,1,36,36
1657321431790,MATH 20C,B01,083762,Bach; Quang Tran,1,0,30,29
1657321437813,MATH 20D,A01,083765,Tran; Brian Kha,5,0,30,25
1657321437813,MATH 20D,A02,083766,Tran; Brian Kha,5,0,30,25
1657321437813,MATH 20D,A03,083767,Tran; Brian Kha,4,0,30,26
1657321443842,MATH 20E,A01,083771,Ganguly; Soumya,7,0,32,25
1657321443842,MATH 20E,A02,083772,Ganguly; Soumya,6,0,32,26
1657321443842,MATH 20E,B01,083773,Ciotti; Benjamin,19,0,35,16
1657321443842,MATH 20E,B02,083774,Ciotti; Benjamin,17,0,35,18
1657321449871,MATH 103A,A01,083777,Greenfeld; Be'Eri,3,0,36,33
1657321449871,MATH 103A,A02,083778,Greenfeld; Be'Eri,5,0,36,31
1657321449871,MATH 103A,A03,093561,Greenfeld; Be'Eri,4,0,36,32
1657321449871,MATH 103A,B01,083779,Greenfeld; Be'Eri,6,0,36,30
1657321449871,MATH 103A,B02,083780,Greenfeld; Be'Eri,4,0,36,32
1657321449871,MATH 103A,B03,093562,Greenfeld; Be'Eri,3,0,36,33
1657321455895,MATH 105,A01,085443,Carter; Anne Toulson,15,0,35,20
1657321455895,MATH 105,A02,093477,Carter; Anne Toulson,20,0,35,15
1657321461918,MATH 109,A01,083213,Ganzberger; Geoffrey Michael,2,0,34,32
1657321461918,MATH 109,A02,083214,Ganzberger; Geoffrey Michael,4,0,34,30
1657321461918,MATH 109,A03,093478,Ganzberger; Geoffrey Michael,2,0,34,32
1657321461918,MATH 109,B01,083215,Ganzberger; Geoffrey Michael,1,0,32,31
1657321461918,MATH 109,B02,083216,Ganzberger; Geoffrey Michael,1,0,32,31
1657321461918,MATH 109,B03,093479,Ganzberger; Geoffrey Michael,8,0,32,24
1657321467959,MATH 142A,A01,083219,Chow; Bennett,7,0,32,25
1657321467959,MATH 142A,A02,083220,Chow; Bennett,10,0,32,22
1657321467959,MATH 142A,A03,093480,Chow; Bennett,7,0,32,25
1657321467959,MATH 142A,B03,093481,Chow; Bennett,8,0,32,24
1657321467959,MATH 142A,B04,093558,Chow; Bennett,13,0,32,19
1657321467959,MATH 142A,B05,093559,Chow; Bennett,6,0,32,26
1657321473989,MATH 193A,A01,083224,Rotar; Vladimir,7,0,34,27
1657321473989,MATH 193A,A02,083225,Rotar; Vladimir,7,0,34,27
1657321473989,MATH 193A,A03,083781,Rotar; Vladimir,3,0,34,31
1657321473989,MATH 193A,A04,083782,Rotar; Vladimir,8,0,34,26
1657321473989,MATH 193A,A05,093482,Rotar; Vladimir,9,0,34,25
1657321480015,MATH 197,001,091859,McAuley; Julian John,9999,0,9999,0
1657321480015,MATH 197,002,095566,Kedlaya; Kiran S.,9997,0,9999,2
1657321480015,MATH 197,003,095567,Xiao; Ming,9999,0,9999,0
1657321480015,MATH 197,004,095571,Perols; Johan Lars,9998,0,9999,1
1657321487072,COGS 9,A01,083615,Shannon; Kyle Michael,8,0,75,67
1657321493097,COGS 11,A01,083617,Boyle; Mary E. T.,22,0,48,26
1657321499117,COGS 13,A01,083071,Bastos; Amalia Pinkusfeld,11,0,71,60
1657321505152,COGS 14A,A01,092681,Semenuks; Arturs,3,1,100,97
1657321511175,COGS 14B,A01,083073,Cheng; Tzu-Han,6,0,63,57
1657321517198,COGS 17,A01,092677,Semenuks; Arturs,6,0,81,75
1657321523220,COGS 100,A01,083619,Allen; Michael Gordon,16,0,70,54
1657321529242,COGS 101A,A01,083621,Davis; Joshua Daniel,9,0,68,59
1657321535265,COGS 101B,A01,091572,Allen; Michael Gordon,11,0,65,54
1657321541290,COGS 101C,A01,083625,Delgado; Tania,17,0,35,18
1657321547315,COGS 107A,A01,083627,Boyle; Mary E. T.,13,0,60,47
1657321553341,COGS 118A,A01,083075,Gupta; Anjum,18,0,76,58
1657321559364,CSE 3,A50,083646,Miranda; Gregory Joseph,24,0,50,26
1657321565386,CSE 8A,A50,083650,Miranda; Gregory Joseph,17,1,56,39
1657321571415,CSE 11,A01,083080,Cao; Yingjun,6,15,40,34
1657321577448,CSE 12,A01,083652,Krause-Levy; Sophia Louisa,28,1,120,92
1657321583476,CSE 15L,A01,083654,Morris; Justin Loren,9,0,50,41
1657321583476,CSE 15L,A02,083655,Morris; Justin Loren,9,0,50,41
1657321589498,CSE 20,A01,083657,Tran; Khoa Dang,38,0,80,42
1657321595522,CSE 21,A01,095574,Bach; Quang Tran,22,0,48,26
1657321601551,CSE 30,A01,083084,Eldon; John,4,0,80,76
1657321601551,CSE 30,B01,095061,Bhaskar; Nishant,9,0,50,41
1657321607574,CSE 100,A01,083659,Cao; Yingjun,4,4,70,66
1657321613596,CSE 134B,A01,083661,Powell; Thomas Allan,22,0,100,78
1657321619624,CSE 140,A01,083663,Gungor; Onat,14,0,85,71
1657321625646,CSE 140L,A01,083088,Eldon; John,21,0,100,79
1657321631672,CSE 175,A01,083665,Kumar; Rakesh,3,0,25,22
1657321637702,CSE 190,A00,092507,Dubnov; Shlomo,7,0,20,13
1657321643726,ECE 45,A01,083139,Congero; Spencer William,6,0,75,69
1657321649748,ECE 65,A50,083695,Saad; Andrew S,12,0,30,18
1657321649748,ECE 65,A51,095125,Saad; Andrew S,24,0,26,2
1657321655773,ECE 109,A01,091882,Touri; Behrouz,19,0,70,51
1657321661803,ECE 180,A00,083140,Abi Samra; Nicholas Camill,1,0,30,29
1657321661803,ECE 180,B00,083141,Abi Samra; Nicholas Camill,0,0,30,30
1657321667826,MATH 10A,A01,083735,Patchell; Gregory David,2,0,30,28
1657321667826,MATH 10A,A02,083736,Patchell; Gregory David,20,0,30,10
1657321667826,MATH 10A,A03,083737,Patchell; Gregory David,16,0,30,14
1657321673851,MATH 10B,A01,083207,Lim; Seonhee,7,0,34,27
1657321673851,MATH 10B,A02,083208,Lim; Seonhee,9,0,35,26
1657321673851,MATH 10B,A03,093472,Lim; Seonhee,7,0,34,27
1657321673851,MATH 10B,B01,083739,Sinha; Shubham,11,0,30,19
1657321679882,MATH 18,A01,083743,Cinel; Cameron Alexander,6,0,30,24
1657321679882,MATH 18,A02,083744,Cinel; Cameron Alexander,17,0,30,13
1657321679882,MATH 18,A03,083745,Cinel; Cameron Alexander,9,0,30,21
1657321679882,MATH 18,B01,083748,Rideout; David Porter,4,0,37,33
1657321679882,MATH 18,B02,083749,Rideout; David Porter,5,0,36,31
1657321679882,MATH 18,B03,083750,Rideout; David Porter,3,0,37,34
1657321679882,MATH 18,B04,083751,Rideout; David Porter,6,0,36,30
1657321679882,MATH 18,B05,093473,Rideout; David Porter,6,0,36,30
1657321679882,MATH 18,B06,093474,Rideout; David Porter,5,0,36,31
1657321685904,MATH 20A,A01,083754,Zheng; Zequn,14,0,40,26
1657321691927,MATH 20B,A01,083756,Briones; Jor-el Thomas Caparas,4,0,36,32
1657321691927,MATH 20B,A02,083757,Briones; Jor-el Thomas Caparas,1,0,36,35
1657321691927,MATH 20B,A03,093475,Briones; Jor-el Thomas Caparas,2,0,36,34
1657321697962,MATH 20C,A01,083760,Briones; Jor-el Thomas Caparas,1,0,35,34
1657321697962,MATH 20C,A02,083761,Briones; Jor-el Thomas Caparas,8,0,35,27
1657321697962,MATH 20C,A03,093476,Briones; Jor-el Thomas Caparas,0,1,36,36
1657321697962,MATH 20C,B01,083762,Bach; Quang Tran,1,0,30,29
1657321703987,MATH 20D,A01,083765,Tran; Brian Kha,5,0,30,25
1657321703987,MATH 20D,A02,083766,Tran; Brian Kha,5,0,30,25
1657321703987,MATH 20D,A03,083767,Tran; Brian Kha,4,0,30,26
1657321710009,MATH 20E,A01,083771,Ganguly; Soumya,7,0,32,25
1657321710009,MATH 20E,A02,083772,Ganguly; Soumya,6,0,32,26
1657321710009,MATH 20E,B01,083773,Ciotti; Benjamin,19,0,35,16
1657321710009,MATH 20E,B02,083774,Ciotti; Benjamin,17,0,35,18
1657321716039,MATH 103A,A01,083777,Greenfeld; Be'Eri,3,0,36,33
1657321716039,MATH 103A,A02,083778,Greenfeld; Be'Eri,5,0,36,31
1657321716039,MATH 103A,A03,093561,Greenfeld; Be'Eri,4,0,36,32
1657321716039,MATH 103A,B01,083779,Greenfeld; Be'Eri,6,0,36,30
1657321716039,MATH 103A,B02,083780,Greenfeld; Be'Eri,4,0,36,32
1657321716039,MATH 103A,B03,093562,Greenfeld; Be'Eri,3,0,36,33
1657321722068,MATH 105,A01,085443,Carter; Anne Toulson,15,0,35,20
1657321722068,MATH 105,A02,093477,Carter; Anne Toulson,20,0,35,15
1657321728092,MATH 109,A01,083213,Ganzberger; Geoffrey Michael,2,0,34,32
1657321728092,MATH 109,A02,083214,Ganzberger; Geoffrey Michael,4,0,34,30
1657321728092,MATH 109,A03,093478,Ganzberger; Geoffrey Michael,2,0,34,32
1657321728092,MATH 109,B01,083215,Ganzberger; Geoffrey Michael,1,0,32,31
1657321728092,MATH 109,B02,083216,Ganzberger; Geoffrey Michael,1,0,32,31
1657321728092,MATH 109,B03,093479,Ganzberger; Geoffrey Michael,8,0,32,24
1657321734116,MATH 142A,A01,083219,Chow; Bennett,7,0,32,25
1657321734116,MATH 142A,A02,083220,Chow; Bennett,10,0,32,22
1657321734116,MATH 142A,A03,093480,Chow; Bennett,7,0,32,25
1657321734116,MATH 142A,B03,093481,Chow; Bennett,8,0,32,24
1657321734116,MATH 142A,B04,093558,Chow; Bennett,13,0,32,19
1657321734116,MATH 142A,B05,093559,Chow; Bennett,6,0,32,26
1657321740146,MATH 193A,A01,083224,Rotar; Vladimir,7,0,34,27
1657321740146,MATH 193A,A02,083225,Rotar; Vladimir,7,0,34,27
1657321740146,MATH 193A,A03,083781,Rotar; Vladimir,3,0,34,31
1657321740146,MATH 193A,A04,083782,Rotar; Vladimir,8,0,34,26
1657321740146,MATH 193A,A05,093482,Rotar; Vladimir,9,0,34,25
1657321746168,MATH 197,001,091859,McAuley; Julian John,9999,0,9999,0
1657321746168,MATH 197,002,095566,Kedlaya; Kiran S.,9997,0,9999,2
1657321746168,MATH 197,003,095567,Xiao; Ming,9999,0,9999,0
1657321746168,MATH 197,004,095571,Perols; Johan Lars,9998,0,9999,1
1657321753216,COGS 9,A01,083615,Shannon; Kyle Michael,8,0,75,67
1657321759238,COGS 11,A01,083617,Boyle; Mary E. T.,22,0,48,26
1657321765262,COGS 13,A01,083071,Bastos; Amalia Pinkusfeld,11,0,71,60
1657321771288,COGS 14A,A01,092681,Semenuks; Arturs,3,1,100,97
1657321777314,COGS 14B,A01,083073,Cheng; Tzu-Han,6,0,63,57
1657321783345,COGS 17,A01,092677,Semenuks; Arturs,6,0,81,75
1657321789367,COGS 100,A01,083619,Allen; Michael Gordon,16,0,70,54
1657321795393,COGS 101A,A01,083621,Davis; Joshua Daniel,9,0,68,59
1657321801418,COGS 101B,A01,091572,Allen; Michael Gordon,11,0,65,54
1657321807442,COGS 101C,A01,083625,Delgado; Tania,17,0,35,18
1657321813469,COGS 107A,A01,083627,Boyle; Mary E. T.,13,0,60,47
1657321819501,COGS 118A,A01,083075,Gupta; Anjum,18,0,76,58
1657321825526,CSE 3,A50,083646,Miranda; Gregory Joseph,24,0,50,26
1657321831549,CSE 8A,A50,083650,Miranda; Gregory Joseph,17,1,56,39
1657321837572,CSE 11,A01,083080,Cao; Yingjun,6,15,40,34
1657321843594,CSE 12,A01,083652,Krause-Levy; Sophia Louisa,28,1,120,92
1657321849615,CSE 15L,A01,083654,Morris; Justin Loren,9,0,50,41
1657321849615,CSE 15L,A02,083655,Morris; Justin Loren,9,0,50,41
1657321855636,CSE 20,A01,083657,Tran; Khoa Dang,38,0,80,42
1657321861659,CSE 21,A01,095574,Bach; Quang Tran,22,0,48,26
1657321867685,CSE 30,A01,083084,Eldon; John,4,0,80,76
1657321867685,CSE 30,B01,095061,Bhaskar; Nishant,9,0,50,41
1657321873709,CSE 100,A01,083659,Cao; Yingjun,4,4,70,66
1657321879733,CSE 134B,A01,083661,Powell; Thomas Allan,22,0,100,78
1657321885766,CSE 140,A01,083663,Gungor; Onat,14,0,85,71
1657321891866,CSE 140L,A01,083088,Eldon; John,21,0,100,79
1657321897906,CSE 175,A01,083665,Kumar; Rakesh,3,0,25,22
1657321903932,CSE 190,A00,092507,Dubnov; Shlomo,7,0,20,13
1657321909956,ECE 45,A01,083139,Congero; Spencer William,6,0,75,69
1657321915984,ECE 65,A50,083695,Saad; Andrew S,12,0,30,18
1657321915984,ECE 65,A51,095125,Saad; Andrew S,24,0,26,2
1657321922010,ECE 109,A01,091882,Touri; Behrouz,19,0,70,51
1657321928033,ECE 180,A00,083140,Abi Samra; Nicholas Camill,1,0,30,29
1657321928033,ECE 180,B00,083141,Abi Samra; Nicholas Camill,0,0,30,30
1657321934055,MATH 10A,A01,083735,Patchell; Gregory David,2,0,30,28
1657321934055,MATH 10A,A02,083736,Patchell; Gregory David,20,0,30,10
1657321934055,MATH 10A,A03,083737,Patchell; Gregory David,16,0,30,14
1657321940090,MATH 10B,A01,083207,Lim; Seonhee,7,0,34,27
1657321940090,MATH 10B,A02,083208,Lim; Seonhee,9,0,35,26
1657321940090,MATH 10B,A03,093472,Lim; Seonhee,7,0,34,27
1657321940090,MATH 10B,B01,083739,Sinha; Shubham,11,0,30,19
1657321946131,MATH 18,A01,083743,Cinel; Cameron Alexander,6,0,30,24
1657321946131,MATH 18,A02,083744,Cinel; Cameron Alexander,17,0,30,13
1657321946131,MATH 18,A03,083745,Cinel; Cameron Alexander,9,0,30,21
1657321946131,MATH 18,B01,083748,Rideout; David Porter,4,0,37,33
1657321946131,MATH 18,B02,083749,Rideout; David Porter,5,0,36,31
1657321946131,MATH 18,B03,083750,Rideout; David Porter,3,0,37,34
1657321946131,MATH 18,B04,083751,Rideout; David Porter,6,0,36,30
1657321946131,MATH 18,B05,093473,Rideout; David Porter,6,0,36,30
1657321946131,MATH 18,B06,093474,Rideout; David Porter,5,0,36,31
1657321952158,MATH 20A,A01,083754,Zheng; Zequn,14,0,40,26
1657321958183,MATH 20B,A01,083756,Briones; Jor-el Thomas Caparas,4,0,36,32
1657321958183,MATH 20B,A02,083757,Briones; Jor-el Thomas Caparas,1,0,36,35
1657321958183,MATH 20B,A03,093475,Briones; Jor-el Thomas Caparas,2,0,36,34
1657321964211,MATH 20C,A01,083760,Briones; Jor-el Thomas Caparas,1,0,35,34
1657321964211,MATH 20C,A02,083761,Briones; Jor-el Thomas Caparas,8,0,35,27
1657321964211,MATH 20C,A03,093476,Briones; Jor-el Thomas Caparas,0,1,36,36
1657321964211,MATH 20C,B01,083762,Bach; Quang Tran,1,0,30,29
1657321970239,MATH 20D,A01,083765,Tran; Brian Kha,5,0,30,25
1657321970239,MATH 20D,A02,083766,Tran; Brian Kha,5,0,30,25
1657321970239,MATH 20D,A03,083767,Tran; Brian Kha,4,0,30,26
1657321976261,MATH 20E,A01,083771,Ganguly; Soumya,7,0,32,25
1657321976261,MATH 20E,A02,083772,Ganguly; Soumya,6,0,32,26
1657321976261,MATH 20E,B01,083773,Ciotti; Benjamin,19,0,35,16
1657321976261,MATH 20E,B02,083774,Ciotti; Benjamin,17,0,35,18
1657321982292,MATH 103A,A01,083777,Greenfeld; Be'Eri,3,0,36,33
1657321982292,MATH 103A,A02,083778,Greenfeld; Be'Eri,5,0,36,31
1657321982292,MATH 103A,A03,093561,Greenfeld; Be'Eri,4,0,36,32
1657321982292,MATH 103A,B01,083779,Greenfeld; Be'Eri,6,0,36,30
1657321982292,MATH 103A,B02,083780,Greenfeld; Be'Eri,4,0,36,32
1657321982292,MATH 103A,B03,093562,Greenfeld; Be'Eri,3,0,36,33
1657321988329,MATH 105,A01,085443,Carter; Anne Toulson,15,0,35,20
1657321988329,MATH 105,A02,093477,Carter; Anne Toulson,20,0,35,15
1657321994361,MATH 109,A01,083213,Ganzberger; Geoffrey Michael,2,0,34,32
1657321994361,MATH 109,A02,083214,Ganzberger; Geoffrey Michael,4,0,34,30
1657321994361,MATH 109,A03,093478,Ganzberger; Geoffrey Michael,2,0,34,32
1657321994361,MATH 109,B01,083215,Ganzberger; Geoffrey Michael,1,0,32,31
1657321994361,MATH 109,B02,083216,Ganzberger; Geoffrey Michael,1,0,32,31
1657321994361,MATH 109,B03,093479,Ganzberger; Geoffrey Michael,8,0,32,24
1657322000388,MATH 142A,A01,083219,Chow; Bennett,7,0,32,25
1657322000388,MATH 142A,A02,083220,Chow; Bennett,10,0,32,22
1657322000388,MATH 142A,A03,093480,Chow; Bennett,7,0,32,25
1657322000388,MATH 142A,B03,093481,Chow; Bennett,8,0,32,24
1657322000388,MATH 142A,B04,093558,Chow; Bennett,13,0,32,19
1657322000388,MATH 142A,B05,093559,Chow; Bennett,6,0,32,26
1657322006416,MATH 193A,A01,083224,Rotar; Vladimir,7,0,34,27
1657322006416,MATH 193A,A02,083225,Rotar; Vladimir,7,0,34,27
1657322006416,MATH 193A,A03,083781,Rotar; Vladimir,3,0,34,31
1657322006416,MATH 193A,A04,083782,Rotar; Vladimir,8,0,34,26
1657322006416,MATH 193A,A05,093482,Rotar; Vladimir,9,0,34,25
1657322012443,MATH 197,001,091859,McAuley; Julian John,9999,0,9999,0
1657322012443,MATH 197,002,095566,Kedlaya; Kiran S.,9997,0,9999,2
1657322012443,MATH 197,003,095567,Xiao; Ming,9999,0,9999,0
1657322012443,MATH 197,004,095571,Perols; Johan Lars,9998,0,9999,1
1657322019507,COGS 9,A01,083615,Shannon; Kyle Michael,8,0,75,67
1657322025537,COGS 11,A01,083617,Boyle; Mary E. T.,22,0,48,26
1657322031560,COGS 13,A01,083071,Bastos; Amalia Pinkusfeld,11,0,71,60
1657322037583,COGS 14A,A01,092681,Semenuks; Arturs,3,1,100,97
1657322043610,COGS 14B,A01,083073,Cheng; Tzu-Han,6,0,63,57
1657322049633,COGS 17,A01,092677,Semenuks; Arturs,6,0,81,75
1657322055658,COGS 100,A01,083619,Allen; Michael Gordon,16,0,70,54
1657322061682,COGS 101A,A01,083621,Davis; Joshua Daniel,9,0,68,59
1657322067709,COGS 101B,A01,091572,Allen; Michael Gordon,11,0,65,54
1657322073737,COGS 101C,A01,083625,Delgado; Tania,17,0,35,18
1657322079763,COGS 107A,A01,083627,Boyle; Mary E. T.,13,0,60,47
1657322085793,COGS 118A,A01,083075,Gupta; Anjum,18,0,76,58
1657322091821,CSE 3,A50,083646,Miranda; Gregory Joseph,24,0,50,26
1657322097848,CSE 8A,A50,083650,Miranda; Gregory Joseph,17,1,56,39
1657322103881,CSE 11,A01,083080,Cao; Yingjun,6,15,40,34
1657322109903,CSE 12,A01,083652,Krause-Levy; Sophia Louisa,28,1,120,92
1657322115943,CSE 15L,A01,083654,Morris; Justin Loren,9,0,50,41
1657322115943,CSE 15L,A02,083655,Morris; Justin Loren,9,0,50,41
1657322121970,CSE 20,A01,083657,Tran; Khoa Dang,38,0,80,42
1657322127997,CSE 21,A01,095574,Bach; Quang Tran,22,0,48,26
1657322134025,CSE 30,A01,083084,Eldon; John,4,0,80,76
1657322134025,CSE 30,B01,095061,Bhaskar; Nishant,9,0,50,41
1657322140048,CSE 100,A01,083659,Cao; Yingjun,4,4,70,66
1657322146071,CSE 134B,A01,083661,Powell; Thomas Allan,22,0,100,78
1657322152097,CSE 140,A01,083663,Gungor; Onat,14,0,85,71
1657322158122,CSE 140L,A01,083088,Eldon; John,21,0,100,79
1657322164147,CSE 175,A01,083665,Kumar; Rakesh,3,0,25,22
1657322170174,CSE 190,A00,092507,Dubnov; Shlomo,7,0,20,13
1657322176196,ECE 45,A01,083139,Congero; Spencer William,6,0,75,69
1657322182219,ECE 65,A50,083695,Saad; Andrew S,12,0,30,18
1657322182219,ECE 65,A51,095125,Saad; Andrew S,24,0,26,2
1657322188243,ECE 109,A01,091882,Touri; Behrouz,19,0,70,51
1657322194279,ECE 180,A00,083140,Abi Samra; Nicholas Camill,1,0,30,29
1657322194279,ECE 180,B00,083141,Abi Samra; Nicholas Camill,0,0,30,30
1657322200304,MATH 10A,A01,083735,Patchell; Gregory David,2,0,30,28
1657322200304,MATH 10A,A02,083736,Patchell; Gregory David,20,0,30,10
1657322200304,MATH 10A,A03,083737,Patchell; Gregory David,16,0,30,14
1657322206328,MATH 10B,A01,083207,Lim; Seonhee,7,0,34,27
1657322206328,MATH 10B,A02,083208,Lim; Seonhee,9,0,35,26
1657322206328,MATH 10B,A03,093472,Lim; Seonhee,7,0,34,27
1657322206328,MATH 10B,B01,083739,Sinha; Shubham,11,0,30,19
1657322212358,MATH 18,A01,083743,Cinel; Cameron Alexander,6,0,30,24
1657322212358,MATH 18,A02,083744,Cinel; Cameron Alexander,17,0,30,13
1657322212358,MATH 18,A03,083745,Cinel; Cameron Alexander,9,0,30,21
1657322212358,MATH 18,B01,083748,Rideout; David Porter,4,0,37,33
1657322212358,MATH 18,B02,083749,Rideout; David Porter,5,0,36,31
1657322212358,MATH 18,B03,083750,Rideout; David Porter,3,0,37,34
1657322212358,MATH 18,B04,083751,Rideout; David Porter,6,0,36,30
1657322212358,MATH 18,B05,093473,Rideout; David Porter,6,0,36,30
1657322212358,MATH 18,B06,093474,Rideout; David Porter,6,0,36,30
1657322218389,MATH 20A,A01,083754,Zheng; Zequn,14,0,40,26
1657322224411,MATH 20B,A01,083756,Briones; Jor-el Thomas Caparas,4,0,36,32
1657322224411,MATH 20B,A02,083757,Briones; Jor-el Thomas Caparas,1,0,36,35
1657322224411,MATH 20B,A03,093475,Briones; Jor-el Thomas Caparas,2,0,36,34
1657322230438,MATH 20C,A01,083760,Briones; Jor-el Thomas Caparas,1,0,35,34
1657322230438,MATH 20C,A02,083761,Briones; Jor-el Thomas Caparas,8,0,35,27
1657322230438,MATH 20C,A03,093476,Briones; Jor-el Thomas Caparas,0,1,36,36
1657322230438,MATH 20C,B01,083762,Bach; Quang Tran,1,0,30,29
1657322236463,MATH 20D,A01,083765,Tran; Brian Kha,5,0,30,25
1657322236463,MATH 20D,A02,083766,Tran; Brian Kha,5,0,30,25
1657322236463,MATH 20D,A03,083767,Tran; Brian Kha,4,0,30,26
1657322242487,MATH 20E,A01,083771,Ganguly; Soumya,7,0,32,25
1657322242487,MATH 20E,A02,083772,Ganguly; Soumya,6,0,32,26
1657322242487,MATH 20E,B01,083773,Ciotti; Benjamin,19,0,35,16
1657322242487,MATH 20E,B02,083774,Ciotti; Benjamin,17,0,35,18
1657322248511,MATH 103A,A01,083777,Greenfeld; Be'Eri,3,0,36,33
1657322248511,MATH 103A,A02,083778,Greenfeld; Be'Eri,5,0,36,31
1657322248511,MATH 103A,A03,093561,Greenfeld; Be'Eri,4,0,36,32
1657322248511,MATH 103A,B01,083779,Greenfeld; Be'Eri,6,0,36,30
1657322248511,MATH 103A,B02,083780,Greenfeld; Be'Eri,4,0,36,32
1657322248511,MATH 103A,B03,093562,Greenfeld; Be'Eri,3,0,36,33
1657322254533,MATH 105,A01,085443,Carter; Anne Toulson,15,0,35,20
1657322254533,MATH 105,A02,093477,Carter; Anne Toulson,20,0,35,15
1657322260560,MATH 109,A01,083213,Ganzberger; Geoffrey Michael,2,0,34,32
1657322260560,MATH 109,A02,083214,Ganzberger; Geoffrey Michael,4,0,34,30
1657322260560,MATH 109,A03,093478,Ganzberger; Geoffrey Michael,2,0,34,32
1657322260560,MATH 109,B01,083215,Ganzberger; Geoffrey Michael,1,0,32,31
1657322260560,MATH 109,B02,083216,Ganzberger; Geoffrey Michael,1,0,32,31
1657322260560,MATH 109,B03,093479,Ganzberger; Geoffrey Michael,8,0,32,24
1657322266590,MATH 142A,A01,083219,Chow; Bennett,7,0,32,25
1657322266590,MATH 142A,A02,083220,Chow; Bennett,10,0,32,22
1657322266590,MATH 142A,A03,093480,Chow; Bennett,7,0,32,25
1657322266590,MATH 142A,B03,093481,Chow; Bennett,8,0,32,24
1657322266590,MATH 142A,B04,093558,Chow; Bennett,13,0,32,19
1657322266590,MATH 142A,B05,093559,Chow; Bennett,6,0,32,26
1657322272619,MATH 193A,A01,083224,Rotar; Vladimir,7,0,34,27
1657322272619,MATH 193A,A02,083225,Rotar; Vladimir,7,0,34,27
1657322272619,MATH 193A,A03,083781,Rotar; Vladimir,3,0,34,31
1657322272619,MATH 193A,A04,083782,Rotar; Vladimir,8,0,34,26
1657322272619,MATH 193A,A05,093482,Rotar; Vladimir,9,0,34,25
1657322278650,MATH 197,001,091859,McAuley; Julian John,9999,0,9999,0
1657322278650,MATH 197,002,095566,Kedlaya; Kiran S.,9997,0,9999,2
1657322278650,MATH 197,003,095567,Xiao; Ming,9999,0,9999,0
1657322278650,MATH 197,004,095571,Perols; Johan Lars,9998,0,9999,1
1657322285714,COGS 9,A01,083615,Shannon; Kyle Michael,8,0,75,67
1657322291742,COGS 11,A01,083617,Boyle; Mary E. T.,22,0,48,26
1657322297766,COGS 13,A01,083071,Bastos; Amalia Pinkusfeld,11,0,71,60
1657322303795,COGS 14A,A01,092681,Semenuks; Arturs,3,1,100,97
1657322309818,COGS 14B,A01,083073,Cheng; Tzu-Han,6,0,63,57
1657322315843,COGS 17,A01,092677,Semenuks; Arturs,6,0,81,75
1657322321868,COGS 100,A01,083619,Allen; Michael Gordon,16,0,70,54
1657322327894,COGS 101A,A01,083621,Davis; Joshua Daniel,9,0,68,59
1657322333917,COGS 101B,A01,091572,Allen; Michael Gordon,11,0,65,54
1657322339940,COGS 101C,A01,083625,Delgado; Tania,17,0,35,18
1657322345963,COGS 107A,A01,083627,Boyle; Mary E. T.,13,0,60,47
1657322351988,COGS 118A,A01,083075,Gupta; Anjum,18,0,76,58
1657322358013,CSE 3,A50,083646,Miranda; Gregory Joseph,24,0,50,26
1657322364035,CSE 8A,A50,083650,Miranda; Gregory Joseph,17,1,56,39
1657322370062,CSE 11,A01,083080,Cao; Yingjun,6,15,40,34
1657322376085,CSE 12,A01,083652,Krause-Levy; Sophia Louisa,28,1,120,92
1657322382108,CSE 15L,A01,083654,Morris; Justin Loren,9,0,50,41
1657322382108,CSE 15L,A02,083655,Morris; Justin Loren,9,0,50,41
1657322388130,CSE 20,A01,083657,Tran; Khoa Dang,38,0,80,42
1657322394158,CSE 21,A01,095574,Bach; Quang Tran,22,0,48,26
1657322400187,CSE 30,A01,083084,Eldon; John,4,0,80,76
1657322400187,CSE 30,B01,095061,Bhaskar; Nishant,9,0,50,41
1657322406220,CSE 100,A01,083659,Cao; Yingjun,4,4,70,66
1657322412247,CSE 134B,A01,083661,Powell; Thomas Allan,22,0,100,78
1657322418278,CSE 140,A01,083663,Gungor; Onat,14,0,85,71
1657322424302,CSE 140L,A01,083088,Eldon; John,21,0,100,79
1657322430326,CSE 175,A01,083665,Kumar; Rakesh,3,0,25,22
1657322436355,CSE 190,A00,092507,Dubnov; Shlomo,7,0,20,13
1657322442383,ECE 45,A01,083139,Congero; Spencer William,6,0,75,69
1657322448408,ECE 65,A50,083695,Saad; Andrew S,12,0,30,18
1657322448408,ECE 65,A51,095125,Saad; Andrew S,24,0,26,2
1657322454436,ECE 109,A01,091882,Touri; Behrouz,19,0,70,51
1657322460470,ECE 180,A00,083140,Abi Samra; Nicholas Camill,1,0,30,29
1657322460470,ECE 180,B00,083141,Abi Samra; Nicholas Camill,0,0,30,30
1657322466492,MATH 10A,A01,083735,Patchell; Gregory David,2,0,30,28
1657322466492,MATH 10A,A02,083736,Patchell; Gregory David,20,0,30,10
1657322466492,MATH 10A,A03,083737,Patchell; Gregory David,16,0,30,14
1657322472524,MATH 10B,A01,083207,Lim; Seonhee,7,0,34,27
1657322472524,MATH 10B,A02,083208,Lim; Seonhee,9,0,35,26
1657322472524,MATH 10B,A03,093472,Lim; Seonhee,7,0,34,27
1657322472524,MATH 10B,B01,083739,Sinha; Shubham,11,0,30,19
1657322478555,MATH 18,A01,083743,Cinel; Cameron Alexander,6,0,30,24
1657322478555,MATH 18,A02,083744,Cinel; Cameron Alexander,17,0,30,13
1657322478555,MATH 18,A03,083745,Cinel; Cameron Alexander,9,0,30,21
1657322478555,MATH 18,B01,083748,Rideout; David Porter,4,0,37,33
1657322478555,MATH 18,B02,083749,Rideout; David Porter,5,0,36,31
1657322478555,MATH 18,B03,083750,Rideout; David Porter,3,0,37,34
1657322478555,MATH 18,B04,083751,Rideout; David Porter,6,0,36,30
1657322478555,MATH 18,B05,093473,Rideout; David Porter,6,0,36,30
1657322478555,MATH 18,B06,093474,Rideout; David Porter,6,0,36,30
1657322484580,MATH 20A,A01,083754,Zheng; Zequn,14,0,40,26
1657322490704,MATH 20B,A01,083756,Briones; Jor-el Thomas Caparas,4,0,36,32
1657322490704,MATH 20B,A02,083757,Briones; Jor-el Thomas Caparas,1,0,36,35
1657322490704,MATH 20B,A03,093475,Briones; Jor-el Thomas Caparas,2,0,36,34
1657322496733,MATH 20C,A01,083760,Briones; Jor-el Thomas Caparas,1,0,35,34
1657322496733,MATH 20C,A02,083761,Briones; Jor-el Thomas Caparas,8,0,35,27
1657322496733,MATH 20C,A03,093476,Briones; Jor-el Thomas Caparas,0,1,36,36
1657322496733,MATH 20C,B01,083762,Bach; Quang Tran,1,0,30,29
1657322502761,MATH 20D,A01,083765,Tran; Brian Kha,5,0,30,25
1657322502761,MATH 20D,A02,083766,Tran; Brian Kha,5,0,30,25
1657322502761,MATH 20D,A03,083767,Tran; Brian Kha,4,0,30,26
1657322508788,MATH 20E,A01,083771,Ganguly; Soumya,7,0,32,25
1657322508788,MATH 20E,A02,083772,Ganguly; Soumya,6,0,32,26
1657322508788,MATH 20E,B01,083773,Ciotti; Benjamin,19,0,35,16
1657322508788,MATH 20E,B02,083774,Ciotti; Benjamin,17,0,35,18
1657322514811,MATH 103A,A01,083777,Greenfeld; Be'Eri,3,0,36,33
1657322514811,MATH 103A,A02,083778,Greenfeld; Be'Eri,5,0,36,31
1657322514811,MATH 103A,A03,093561,Greenfeld; Be'Eri,4,0,36,32
1657322514811,MATH 103A,B01,083779,Greenfeld; Be'Eri,6,0,36,30
1657322514811,MATH 103A,B02,083780,Greenfeld; Be'Eri,4,0,36,32
1657322514811,MATH 103A,B03,093562,Greenfeld; Be'Eri,3,0,36,33
1657322520849,MATH 105,A01,085443,Carter; Anne Toulson,15,0,35,20
1657322520849,MATH 105,A02,093477,Carter; Anne Toulson,20,0,35,15
1657322526878,MATH 109,A01,083213,Ganzberger; Geoffrey Michael,2,0,34,32
1657322526878,MATH 109,A02,083214,Ganzberger; Geoffrey Michael,4,0,34,30
1657322526878,MATH 109,A03,093478,Ganzberger; Geoffrey Michael,2,0,34,32
1657322526878,MATH 109,B01,083215,Ganzberger; Geoffrey Michael,1,0,32,31
1657322526878,MATH 109,B02,083216,Ganzberger; Geoffrey Michael,1,0,32,31
1657322526878,MATH 109,B03,093479,Ganzberger; Geoffrey Michael,8,0,32,24
1657322532902,MATH 142A,A01,083219,Chow; Bennett,7,0,32,25
1657322532902,MATH 142A,A02,083220,Chow; Bennett,10,0,32,22
1657322532902,MATH 142A,A03,093480,Chow; Bennett,7,0,32,25
1657322532902,MATH 142A,B03,093481,Chow; Bennett,8,0,32,24
1657322532902,MATH 142A,B04,093558,Chow; Bennett,13,0,32,19
1657322532902,MATH 142A,B05,093559,Chow; Bennett,6,0,32,26
1657322538931,MATH 193A,A01,083224,Rotar; Vladimir,7,0,34,27
1657322538931,MATH 193A,A02,083225,Rotar; Vladimir,7,0,34,27
1657322538931,MATH 193A,A03,083781,Rotar; Vladimir,3,0,34,31
1657322538931,MATH 193A,A04,083782,Rotar; Vladimir,8,0,34,26
1657322538931,MATH 193A,A05,093482,Rotar; Vladimir,9,0,34,25
1657322544959,MATH 197,001,091859,McAuley; Julian John,9999,0,9999,0
1657322544959,MATH 197,002,095566,Kedlaya; Kiran S.,9997,0,9999,2
1657322544959,MATH 197,003,095567,Xiao; Ming,9999,0,9999,0
1657322544959,MATH 197,004,095571,Perols; Johan Lars,9998,0,9999,1
1657322552020,COGS 9,A01,083615,Shannon; Kyle Michael,8,0,75,67
1657322558044,COGS 11,A01,083617,Boyle; Mary E. T.,22,0,48,26
1657322564070,COGS 13,A01,083071,Bastos; Amalia Pinkusfeld,11,0,71,60
1657322570093,COGS 14A,A01,092681,Semenuks; Arturs,3,1,100,97
1657322576121,COGS 14B,A01,083073,Cheng; Tzu-Han,6,0,63,57
1657322582145,COGS 17,A01,092677,Semenuks; Arturs,6,0,81,75
1657322588174,COGS 100,A01,083619,Allen; Michael Gordon,16,0,70,54
1657322594197,COGS 101A,A01,083621,Davis; Joshua Daniel,9,0,68,59
1657322600219,COGS 101B,A01,091572,Allen; Michael Gordon,11,0,65,54
1657322606241,COGS 101C,A01,083625,Delgado; Tania,17,0,35,18
1657322612267,COGS 107A,A01,083627,Boyle; Mary E. T.,13,0,60,47
1657322618290,COGS 118A,A01,083075,Gupta; Anjum,19,0,76,57
1657322624316,CSE 3,A50,083646,Miranda; Gregory Joseph,24,0,50,26
1657322630340,CSE 8A,A50,083650,Miranda; Gregory Joseph,17,1,56,39
1657322636372,CSE 11,A01,083080,Cao; Yingjun,6,15,40,34
1657322642395,CSE 12,A01,083652,Krause-Levy; Sophia Louisa,28,1,120,92
1657322648427,CSE 15L,A01,083654,Morris; Justin Loren,9,0,50,41
1657322648427,CSE 15L,A02,083655,Morris; Justin Loren,9,0,50,41
1657322654452,CSE 20,A01,083657,Tran; Khoa Dang,38,0,80,42
1657322660478,CSE 21,A01,095574,Bach; Quang Tran,22,0,48,26
1657322666501,CSE 30,A01,083084,Eldon; John,4,0,80,76
1657322666501,CSE 30,B01,095061,Bhaskar; Nishant,9,0,50,41
1657322672527,CSE 100,A01,083659,Cao; Yingjun,4,4,70,66
1657322678554,CSE 134B,A01,083661,Powell; Thomas Allan,22,0,100,78
1657322684579,CSE 140,A01,083663,Gungor; Onat,14,0,85,71
1657322690603,CSE 140L,A01,083088,Eldon; John,21,0,100,79
1657322696629,CSE 175,A01,083665,Kumar; Rakesh,3,0,25,22
1657322702653,CSE 190,A00,092507,Dubnov; Shlomo,7,0,20,13
1657322708679,ECE 45,A01,083139,Congero; Spencer William,6,0,75,69
1657322714711,ECE 65,A50,083695,Saad; Andrew S,12,0,30,18
1657322714711,ECE 65,A51,095125,Saad; Andrew S,24,0,26,2
1657322720741,ECE 109,A01,091882,Touri; Behrouz,19,0,70,51
1657322726781,ECE 180,A00,083140,Abi Samra; Nicholas Camill,1,0,30,29
1657322726781,ECE 180,B00,083141,Abi Samra; Nicholas Camill,0,0,30,30
1657322732808,MATH 10A,A01,083735,Patchell; Gregory David,2,0,30,28
1657322732808,MATH 10A,A02,083736,Patchell; Gregory David,20,0,30,10
1657322732808,MATH 10A,A03,083737,Patchell; Gregory David,16,0,30,14
1657322738835,MATH 10B,A01,083207,Lim; Seonhee,7,0,34,27
1657322738835,MATH 10B,A02,083208,Lim; Seonhee,9,0,35,26
1657322738835,MATH 10B,A03,093472,Lim; Seonhee,7,0,34,27
1657322738835,MATH 10B,B01,083739,Sinha; Shubham,11,0,30,19
1657322744862,MATH 18,A01,083743,Cinel; Cameron Alexander,6,0,30,24
1657322744862,MATH 18,A02,083744,Cinel; Cameron Alexander,17,0,30,13
1657322744862,MATH 18,A03,083745,Cinel; Cameron Alexander,9,0,30,21
1657322744862,MATH 18,B01,083748,Rideout; David Porter,4,0,37,33
1657322744862,MATH 18,B02,083749,Rideout; David Porter,5,0,36,31
1657322744862,MATH 18,B03,083750,Rideout; David Porter,3,0,37,34
1657322744862,MATH 18,B04,083751,Rideout; David Porter,6,0,36,30
1657322744862,MATH 18,B05,093473,Rideout; David Porter,6,0,36,30
1657322744862,MATH 18,B06,093474,Rideout; David Porter,6,0,36,30
1657322750885,MATH 20A,A01,083754,Zheng; Zequn,14,0,40,26
1657322756913,MATH 20B,A01,083756,Briones; Jor-el Thomas Caparas,4,0,36,32
1657322756913,MATH 20B,A02,083757,Briones; Jor-el Thomas Caparas,1,0,36,35
1657322756913,MATH 20B,A03,093475,Briones; Jor-el Thomas Caparas,2,0,36,34
1657322762938,MATH 20C,A01,083760,Briones; Jor-el Thomas Caparas,1,0,35,34
1657322762938,MATH 20C,A02,083761,Briones; Jor-el Thomas Caparas,8,0,35,27
1657322762938,MATH 20C,A03,093476,Briones; Jor-el Thomas Caparas,0,1,36,36
1657322762938,MATH 20C,B01,083762,Bach; Quang Tran,1,0,30,29
1657322768965,MATH 20D,A01,083765,Tran; Brian Kha,5,0,30,25
1657322768965,MATH 20D,A02,083766,Tran; Brian Kha,5,0,30,25
1657322768965,MATH 20D,A03,083767,Tran; Brian Kha,4,0,30,26
1657322774989,MATH 20E,A01,083771,Ganguly; Soumya,7,0,32,25
1657322774989,MATH 20E,A02,083772,Ganguly; Soumya,6,0,32,26
1657322774989,MATH 20E,B01,083773,Ciotti; Benjamin,19,0,35,16
1657322774989,MATH 20E,B02,083774,Ciotti; Benjamin,17,0,35,18
1657322781017,MATH 103A,A01,083777,Greenfeld; Be'Eri,3,0,36,33
1657322781017,MATH 103A,A02,083778,Greenfeld; Be'Eri,5,0,36,31
1657322781017,MATH 103A,A03,093561,Greenfeld; Be'Eri,4,0,36,32
1657322781017,MATH 103A,B01,083779,Greenfeld; Be'Eri,6,0,36,30
1657322781017,MATH 103A,B02,083780,Greenfeld; Be'Eri,4,0,36,32
1657322781017,MATH 103A,B03,093562,Greenfeld; Be'Eri,3,0,36,33
1657322787045,MATH 105,A01,085443,Carter; Anne Toulson,15,0,35,20
1657322787045,MATH 105,A02,093477,Carter; Anne Toulson,20,0,35,15
1657322793067,MATH 109,A01,083213,Ganzberger; Geoffrey Michael,2,0,34,32
1657322793067,MATH 109,A02,083214,Ganzberger; Geoffrey Michael,4,0,34,30
1657322793067,MATH 109,A03,093478,Ganzberger; Geoffrey Michael,2,0,34,32
1657322793067,MATH 109,B01,083215,Ganzberger; Geoffrey Michael,1,0,32,31
1657322793067,MATH 109,B02,083216,Ganzberger; Geoffrey Michael,1,0,32,31
1657322793067,MATH 109,B03,093479,Ganzberger; Geoffrey Michael,8,0,32,24
1657322799090,MATH 142A,A01,083219,Chow; Bennett,7,0,32,25
1657322799090,MATH 142A,A02,083220,Chow; Bennett,10,0,32,22
1657322799090,MATH 142A,A03,093480,Chow; Bennett,7,0,32,25
1657322799090,MATH 142A,B03,093481,Chow; Bennett,8,0,32,24
1657322799090,MATH 142A,B04,093558,Chow; Bennett,13,0,32,19
1657322799090,MATH 142A,B05,093559,Chow; Bennett,6,0,32,26
1657322805118,MATH 193A,A01,083224,Rotar; Vladimir,7,0,34,27
1657322805118,MATH 193A,A02,083225,Rotar; Vladimir,7,0,34,27
1657322805118,MATH 193A,A03,083781,Rotar; Vladimir,3,0,34,31
1657322805118,MATH 193A,A04,083782,Rotar; Vladimir,8,0,34,26
1657322805118,MATH 193A,A05,093482,Rotar; Vladimir,9,0,34,25
1657322811143,MATH 197,001,091859,McAuley; Julian John,9999,0,9999,0
1657322811143,MATH 197,002,095566,Kedlaya; Kiran S.,9997,0,9999,2
1657322811143,MATH 197,003,095567,Xiao; Ming,9999,0,9999,0
1657322811143,MATH 197,004,095571,Perols; Johan Lars,9998,0,9999,1
1657322818212,COGS 9,A01,083615,Shannon; Kyle Michael,8,0,75,67
1657322824236,COGS 11,A01,083617,Boyle; Mary E. T.,22,0,48,26
1657322830265,COGS 13,A01,083071,Bastos; Amalia Pinkusfeld,11,0,71,60
1657322836288,COGS 14A,A01,092681,Semenuks; Arturs,3,1,100,97
1657322842311,COGS 14B,A01,083073,Cheng; Tzu-Han,6,0,63,57
1657322848334,COGS 17,A01,092677,Semenuks; Arturs,6,0,81,75
1657322854361,COGS 100,A01,083619,Allen; Michael Gordon,16,0,70,54
1657322860395,COGS 101A,A01,083621,Davis; Joshua Daniel,9,0,68,59
1657322866420,COGS 101B,A01,091572,Allen; Michael Gordon,11,0,65,54
1657322872453,COGS 101C,A01,083625,Delgado; Tania,17,0,35,18
1657322878480,COGS 107A,A01,083627,Boyle; Mary E. T.,13,0,60,47
1657322884506,COGS 118A,A01,083075,Gupta; Anjum,19,0,76,57
1657322890534,CSE 3,A50,083646,Miranda; Gregory Joseph,24,0,50,26
1657322896557,CSE 8A,A50,083650,Miranda; Gregory Joseph,17,1,56,39
1657322902619,CSE 11,A01,083080,Cao; Yingjun,6,15,40,34
1657322908646,CSE 12,A01,083652,Krause-Levy; Sophia Louisa,28,1,120,92
1657322914671,CSE 15L,A01,083654,Morris; Justin Loren,9,0,50,41
1657322914671,CSE 15L,A02,083655,Morris; Justin Loren,9,0,50,41
1657322920696,CSE 20,A01,083657,Tran; Khoa Dang,38,0,80,42
1657322926718,CSE 21,A01,095574,Bach; Quang Tran,22,0,48,26
1657322932740,CSE 30,A01,083084,Eldon; John,4,0,80,76
1657322932740,CSE 30,B01,095061,Bhaskar; Nishant,9,0,50,41
1657322938761,CSE 100,A01,083659,Cao; Yingjun,4,4,70,66
1657322944784,CSE 134B,A01,083661,Powell; Thomas Allan,22,0,100,78
1657322950812,CSE 140,A01,083663,Gungor; Onat,14,0,85,71
1657322956837,CSE 140L,A01,083088,Eldon; John,21,0,100,79
1657322962863,CSE 175,A01,083665,Kumar; Rakesh,3,0,25,22
1657322968885,CSE 190,A00,092507,Dubnov; Shlomo,7,0,20,13
1657322974909,ECE 45,A01,083139,Congero; Spencer William,6,0,75,69
1657322980932,ECE 65,A50,083695,Saad; Andrew S,12,0,30,18
1657322980932,ECE 65,A51,095125,Saad; Andrew S,24,0,26,2
1657322986957,ECE 109,A01,091882,Touri; Behrouz,19,0,70,51
1657322992979,ECE 180,A00,083140,Abi Samra; Nicholas Camill,1,0,30,29
1657322992979,ECE 180,B00,083141,Abi Samra; Nicholas Camill,0,0,30,30
1657322999006,MATH 10A,A01,083735,Patchell; Gregory David,2,0,30,28
1657322999006,MATH 10A,A02,083736,Patchell; Gregory David,20,0,30,10
1657322999006,MATH 10A,A03,083737,Patchell; Gregory David,16,0,30,14
1657323005035,MATH 10B,A01,083207,Lim; Seonhee,7,0,34,27
1657323005035,MATH 10B,A02,083208,Lim; Seonhee,9,0,35,26
1657323005035,MATH 10B,A03,093472,Lim; Seonhee,7,0,34,27
1657323005035,MATH 10B,B01,083739,Sinha; Shubham,11,0,30,19
1657323011060,MATH 18,A01,083743,Cinel; Cameron Alexander,6,0,30,24
1657323011060,MATH 18,A02,083744,Cinel; Cameron Alexander,17,0,30,13
1657323011060,MATH 18,A03,083745,Cinel; Cameron Alexander,9,0,30,21
1657323011060,MATH 18,B01,083748,Rideout; David Porter,4,0,37,33
1657323011060,MATH 18,B02,083749,Rideout; David Porter,5,0,36,31
1657323011060,MATH 18,B03,083750,Rideout; David Porter,3,0,37,34
1657323011060,MATH 18,B04,083751,Rideout; David Porter,6,0,36,30
1657323011060,MATH 18,B05,093473,Rideout; David Porter,6,0,36,30
1657323011060,MATH 18,B06,093474,Rideout; David Porter,6,0,36,30
1657323017083,MATH 20A,A01,083754,Zheng; Zequn,14,0,40,26
1657323023109,MATH 20B,A01,083756,Briones; Jor-el Thomas Caparas,4,0,36,32
1657323023109,MATH 20B,A02,083757,Briones; Jor-el Thomas Caparas,1,0,36,35
1657323023109,MATH 20B,A03,093475,Briones; Jor-el Thomas Caparas,2,0,36,34
1657323029139,MATH 20C,A01,083760,Briones; Jor-el Thomas Caparas,1,0,35,34
1657323029139,MATH 20C,A02,083761,Briones; Jor-el Thomas Caparas,8,0,35,27
1657323029139,MATH 20C,A03,093476,Briones; Jor-el Thomas Caparas,0,1,36,36
1657323029139,MATH 20C,B01,083762,Bach; Quang Tran,1,0,30,29
1657323035162,MATH 20D,A01,083765,Tran; Brian Kha,5,0,30,25
1657323035162,MATH 20D,A02,083766,Tran; Brian Kha,5,0,30,25
1657323035162,MATH 20D,A03,083767,Tran; Brian Kha,4,0,30,26
1657323041186,MATH 20E,A01,083771,Ganguly; Soumya,7,0,32,25
1657323041186,MATH 20E,A02,083772,Ganguly; Soumya,6,0,32,26
1657323041186,MATH 20E,B01,083773,Ciotti; Benjamin,19,0,35,16
1657323041186,MATH 20E,B02,083774,Ciotti; Benjamin,17,0,35,18
1657323047215,MATH 103A,A01,083777,Greenfeld; Be'Eri,3,0,36,33
1657323047215,MATH 103A,A02,083778,Greenfeld; Be'Eri,5,0,36,31
1657323047215,MATH 103A,A03,093561,Greenfeld; Be'Eri,4,0,36,32
1657323047215,MATH 103A,B01,083779,Greenfeld; Be'Eri,6,0,36,30
1657323047215,MATH 103A,B02,083780,Greenfeld; Be'Eri,4,0,36,32
1657323047215,MATH 103A,B03,093562,Greenfeld; Be'Eri,3,0,36,33
1657323053239,MATH 105,A01,085443,Carter; Anne Toulson,15,0,35,20
1657323053239,MATH 105,A02,093477,Carter; Anne Toulson,20,0,35,15
1657323059273,MATH 109,A01,083213,Ganzberger; Geoffrey Michael,2,0,34,32
1657323059273,MATH 109,A02,083214,Ganzberger; Geoffrey Michael,4,0,34,30
1657323059273,MATH 109,A03,093478,Ganzberger; Geoffrey Michael,2,0,34,32
1657323059273,MATH 109,B01,083215,Ganzberger; Geoffrey Michael,1,0,32,31
1657323059273,MATH 109,B02,083216,Ganzberger; Geoffrey Michael,1,0,32,31
1657323059273,MATH 109,B03,093479,Ganzberger; Geoffrey Michael,8,0,32,24
1657323065298,MATH 142A,A01,083219,Chow; Bennett,7,0,32,25
1657323065298,MATH 142A,A02,083220,Chow; Bennett,10,0,32,22
1657323065298,MATH 142A,A03,093480,Chow; Bennett,7,0,32,25
1657323065298,MATH 142A,B03,093481,Chow; Bennett,8,0,32,24
1657323065298,MATH 142A,B04,093558,Chow; Bennett,13,0,32,19
1657323065298,MATH 142A,B05,093559,Chow; Bennett,6,0,32,26
1657323071326,MATH 193A,A01,083224,Rotar; Vladimir,7,0,34,27
1657323071326,MATH 193A,A02,083225,Rotar; Vladimir,7,0,34,27
1657323071326,MATH 193A,A03,083781,Rotar; Vladimir,3,0,34,31
1657323071326,MATH 193A,A04,083782,Rotar; Vladimir,8,0,34,26
1657323071326,MATH 193A,A05,093482,Rotar; Vladimir,9,0,34,25
1657323077350,MATH 197,001,091859,McAuley; Julian John,9999,0,9999,0
1657323077350,MATH 197,002,095566,Kedlaya; Kiran S.,9997,0,9999,2
1657323077350,MATH 197,003,095567,Xiao; Ming,9999,0,9999,0
1657323077350,MATH 197,004,095571,Perols; Johan Lars,9998,0,9999,1
1657323084504,COGS 9,A01,083615,Shannon; Kyle Michael,8,0,75,67
1657323090528,COGS 11,A01,083617,Boyle; Mary E. T.,22,0,48,26
1657323096553,COGS 13,A01,083071,Bastos; Amalia Pinkusfeld,11,0,71,60
1657323102577,COGS 14A,A01,092681,Semenuks; Arturs,3,1,100,97
1657323108611,COGS 14B,A01,083073,Cheng; Tzu-Han,6,0,63,57
1657323114642,COGS 17,A01,092677,Semenuks; Arturs,6,0,81,75
1657323120669,COGS 100,A01,083619,Allen; Michael Gordon,16,0,70,54
1657323126692,COGS 101A,A01,083621,Davis; Joshua Daniel,9,0,68,59
1657323132720,COGS 101B,A01,091572,Allen; Michael Gordon,11,0,65,54
1657323138744,COGS 101C,A01,083625,Delgado; Tania,17,0,35,18
1657323144775,COGS 107A,A01,083627,Boyle; Mary E. T.,13,0,60,47
1657323150797,COGS 118A,A01,083075,Gupta; Anjum,19,0,76,57
1657323156821,CSE 3,A50,083646,Miranda; Gregory Joseph,24,0,50,26
1657323162858,CSE 8A,A50,083650,Miranda; Gregory Joseph,17,1,56,39
1657323168882,CSE 11,A01,083080,Cao; Yingjun,6,15,40,34
1657323174909,CSE 12,A01,083652,Krause-Levy; Sophia Louisa,28,1,120,92
1657323180934,CSE 15L,A01,083654,Morris; Justin Loren,9,0,50,41
1657323180934,CSE 15L,A02,083655,Morris; Justin Loren,9,0,50,41
1657323186958,CSE 20,A01,083657,Tran; Khoa Dang,38,0,80,42
1657323192980,CSE 21,A01,095574,Bach; Quang Tran,22,0,48,26
1657323199009,CSE 30,A01,083084,Eldon; John,4,0,80,76
1657323199009,CSE 30,B01,095061,Bhaskar; Nishant,9,0,50,41
1657323205038,CSE 100,A01,083659,Cao; Yingjun,4,4,70,66
1657323211068,CSE 134B,A01,083661,Powell; Thomas Allan,22,0,100,78
1657323217090,CSE 140,A01,083663,Gungor; Onat,14,0,85,71
1657323223114,CSE 140L,A01,083088,Eldon; John,21,0,100,79
1657323229145,CSE 175,A01,083665,Kumar; Rakesh,3,0,25,22
1657323235169,CSE 190,A00,092507,Dubnov; Shlomo,7,0,20,13
1657323241202,ECE 45,A01,083139,Congero; Spencer William,6,0,75,69
1657323247230,ECE 65,A50,083695,Saad; Andrew S,12,0,30,18
1657323247230,ECE 65,A51,095125,Saad; Andrew S,24,0,26,2
1657323253261,ECE 109,A01,091882,Touri; Behrouz,19,0,70,51
1657323259283,ECE 180,A00,083140,Abi Samra; Nicholas Camill,1,0,30,29
1657323259283,ECE 180,B00,083141,Abi Samra; Nicholas Camill,0,0,30,30
1657323265308,MATH 10A,A01,083735,Patchell; Gregory David,2,0,30,28
1657323265308,MATH 10A,A02,083736,Patchell; Gregory David,20,0,30,10
1657323265308,MATH 10A,A03,083737,Patchell; Gregory David,16,0,30,14
1657323271334,MATH 10B,A01,083207,Lim; Seonhee,7,0,34,27
1657323271334,MATH 10B,A02,083208,Lim; Seonhee,9,0,35,26
1657323271334,MATH 10B,A03,093472,Lim; Seonhee,7,0,34,27
1657323271334,MATH 10B,B01,083739,Sinha; Shubham,11,0,30,19
1657323277357,MATH 18,A01,083743,Cinel; Cameron Alexander,6,0,30,24
1657323277357,MATH 18,A02,083744,Cinel; Cameron Alexander,17,0,30,13
1657323277357,MATH 18,A03,083745,Cinel; Cameron Alexander,9,0,30,21
1657323277357,MATH 18,B01,083748,Rideout; David Porter,4,0,37,33
1657323277357,MATH 18,B02,083749,Rideout; David Porter,5,0,36,31
1657323277357,MATH 18,B03,083750,Rideout; David Porter,3,0,37,34
1657323277357,MATH 18,B04,083751,Rideout; David Porter,6,0,36,30
1657323277357,MATH 18,B05,093473,Rideout; David Porter,6,0,36,30
1657323277357,MATH 18,B06,093474,Rideout; David Porter,6,0,36,30
1657323283386,MATH 20A,A01,083754,Zheng; Zequn,14,0,40,26
1657323289415,MATH 20B,A01,083756,Briones; Jor-el Thomas Caparas,4,0,36,32
1657323289415,MATH 20B,A02,083757,Briones; Jor-el Thomas Caparas,1,0,36,35
1657323289415,MATH 20B,A03,093475,Briones; Jor-el Thomas Caparas,2,0,36,34
1657323295446,MATH 20C,A01,083760,Briones; Jor-el Thomas Caparas,1,0,35,34
1657323295446,MATH 20C,A02,083761,Briones; Jor-el Thomas Caparas,8,0,35,27
1657323295446,MATH 20C,A03,093476,Briones; Jor-el Thomas Caparas,0,1,36,36
1657323295446,MATH 20C,B01,083762,Bach; Quang Tran,1,0,30,29
1657323301469,MATH 20D,A01,083765,Tran; Brian Kha,5,0,30,25
1657323301469,MATH 20D,A02,083766,Tran; Brian Kha,5,0,30,25
1657323301469,MATH 20D,A03,083767,Tran; Brian Kha,4,0,30,26
1657323307498,MATH 20E,A01,083771,Ganguly; Soumya,7,0,32,25
1657323307498,MATH 20E,A02,083772,Ganguly; Soumya,6,0,32,26
1657323307498,MATH 20E,B01,083773,Ciotti; Benjamin,19,0,35,16
1657323307498,MATH 20E,B02,083774,Ciotti; Benjamin,17,0,35,18
1657323313528,MATH 103A,A01,083777,Greenfeld; Be'Eri,3,0,36,33
1657323313528,MATH 103A,A02,083778,Greenfeld; Be'Eri,5,0,36,31
1657323313528,MATH 103A,A03,093561,Greenfeld; Be'Eri,4,0,36,32
1657323313528,MATH 103A,B01,083779,Greenfeld; Be'Eri,6,0,36,30
1657323313528,MATH 103A,B02,083780,Greenfeld; Be'Eri,4,0,36,32
1657323313528,MATH 103A,B03,093562,Greenfeld; Be'Eri,3,0,36,33
1657323319554,MATH 105,A01,085443,Carter; Anne Toulson,15,0,35,20
1657323319554,MATH 105,A02,093477,Carter; Anne Toulson,20,0,35,15
1657323325583,MATH 109,A01,083213,Ganzberger; Geoffrey Michael,2,0,34,32
1657323325583,MATH 109,A02,083214,Ganzberger; Geoffrey Michael,4,0,34,30
1657323325583,MATH 109,A03,093478,Ganzberger; Geoffrey Michael,2,0,34,32
1657323325583,MATH 109,B01,083215,Ganzberger; Geoffrey Michael,1,0,32,31
1657323325583,MATH 109,B02,083216,Ganzberger; Geoffrey Michael,1,0,32,31
1657323325583,MATH 109,B03,093479,Ganzberger; Geoffrey Michael,8,0,32,24
1657323331607,MATH 142A,A01,083219,Chow; Bennett,7,0,32,25
1657323331607,MATH 142A,A02,083220,Chow; Bennett,10,0,32,22
1657323331607,MATH 142A,A03,093480,Chow; Bennett,7,0,32,25
1657323331607,MATH 142A,B03,093481,Chow; Bennett,8,0,32,24
1657323331607,MATH 142A,B04,093558,Chow; Bennett,13,0,32,19
1657323331607,MATH 142A,B05,093559,Chow; Bennett,6,0,32,26
1657323337634,MATH 193A,A01,083224,Rotar; Vladimir,7,0,34,27
1657323337634,MATH 193A,A02,083225,Rotar; Vladimir,7,0,34,27
1657323337634,MATH 193A,A03,083781,Rotar; Vladimir,3,0,34,31
1657323337634,MATH 193A,A04,083782,Rotar; Vladimir,8,0,34,26
1657323337634,MATH 193A,A05,093482,Rotar; Vladimir,9,0,34,25
1657323343656,MATH 197,001,091859,McAuley; Julian John,9999,0,9999,0
1657323343656,MATH 197,002,095566,Kedlaya; Kiran S.,9997,0,9999,2
1657323343656,MATH 197,003,095567,Xiao; Ming,9999,0,9999,0
1657323343656,MATH 197,004,095571,Perols; Johan Lars,9998,0,9999,1
1657323350712,COGS 9,A01,083615,Shannon; Kyle Michael,8,0,75,67
1657323356742,COGS 11,A01,083617,Boyle; Mary E. T.,22,0,48,26
1657323362766,COGS 13,A01,083071,Bastos; Amalia Pinkusfeld,11,0,71,60
1657323368800,COGS 14A,A01,092681,Semenuks; Arturs,3,1,100,97
1657323374827,COGS 14B,A01,083073,Cheng; Tzu-Han,6,0,63,57
1657323380854,COGS 17,A01,092677,Semenuks; Arturs,6,0,81,75
1657323386889,COGS 100,A01,083619,Allen; Michael Gordon,16,0,70,54
1657323392915,COGS 101A,A01,083621,Davis; Joshua Daniel,9,0,68,59
1657323398938,COGS 101B,A01,091572,Allen; Michael Gordon,11,0,65,54
1657323404962,COGS 101C,A01,083625,Delgado; Tania,17,0,35,18
1657323410985,COGS 107A,A01,083627,Boyle; Mary E. T.,13,0,60,47
1657323417007,COGS 118A,A01,083075,Gupta; Anjum,19,0,76,57
1657323423029,CSE 3,A50,083646,Miranda; Gregory Joseph,24,0,50,26
1657323429056,CSE 8A,A50,083650,Miranda; Gregory Joseph,17,1,56,39
1657323435081,CSE 11,A01,083080,Cao; Yingjun,6,15,40,34
1657323441104,CSE 12,A01,083652,Krause-Levy; Sophia Louisa,28,1,120,92
1657323447136,CSE 15L,A01,083654,Morris; Justin Loren,9,0,50,41
1657323447136,CSE 15L,A02,083655,Morris; Justin Loren,9,0,50,41
1657323453158,CSE 20,A01,083657,Tran; Khoa Dang,38,0,80,42
1657323459179,CSE 21,A01,095574,Bach; Quang Tran,22,0,48,26
1657323465208,CSE 30,A01,083084,Eldon; John,4,0,80,76
1657323465208,CSE 30,B01,095061,Bhaskar; Nishant,9,0,50,41
1657323471231,CSE 100,A01,083659,Cao; Yingjun,4,4,70,66
1657323477258,CSE 134B,A01,083661,Powell; Thomas Allan,22,0,100,78
1657323483279,CSE 140,A01,083663,Gungor; Onat,14,0,85,71
1657323489302,CSE 140L,A01,083088,Eldon; John,21,0,100,79
1657323495328,CSE 175,A01,083665,Kumar; Rakesh,3,0,25,22
1657323501350,CSE 190,A00,092507,Dubnov; Shlomo,7,0,20,13
1657323507379,ECE 45,A01,083139,Congero; Spencer William,6,0,75,69
1657323513407,ECE 65,A50,083695,Saad; Andrew S,12,0,30,18
1657323513407,ECE 65,A51,095125,Saad; Andrew S,24,0,26,2
1657323519430,ECE 109,A01,091882,Touri; Behrouz,19,0,70,51
1657323525461,ECE 180,A00,083140,Abi Samra; Nicholas Camill,1,0,30,29
1657323525461,ECE 180,B00,083141,Abi Samra; Nicholas Camill,0,0,30,30
1657323531491,MATH 10A,A01,083735,Patchell; Gregory David,2,0,30,28
1657323531491,MATH 10A,A02,083736,Patchell; Gregory David,20,0,30,10
1657323531491,MATH 10A,A03,083737,Patchell; Gregory David,16,0,30,14
1657323537513,MATH 10B,A01,083207,Lim; Seonhee,7,0,34,27
1657323537513,MATH 10B,A02,083208,Lim; Seonhee,9,0,35,26
1657323537513,MATH 10B,A03,093472,Lim; Seonhee,7,0,34,27
1657323537513,MATH 10B,B01,083739,Sinha; Shubham,11,0,30,19
1657323543542,MATH 18,A01,083743,Cinel; Cameron Alexander,6,0,30,24
1657323543542,MATH 18,A02,083744,Cinel; Cameron Alexander,17,0,30,13
1657323543542,MATH 18,A03,083745,Cinel; Cameron Alexander,9,0,30,21
1657323543542,MATH 18,B01,083748,Rideout; David Porter,4,0,37,33
1657323543542,MATH 18,B02,083749,Rideout; David Porter,5,0,36,31
1657323543542,MATH 18,B03,083750,Rideout; David Porter,3,0,37,34
1657323543542,MATH 18,B04,083751,Rideout; David Porter,6,0,36,30
1657323543542,MATH 18,B05,093473,Rideout; David Porter,6,0,36,30
1657323543542,MATH 18,B06,093474,Rideout; David Porter,6,0,36,30
1657323549567,MATH 20A,A01,083754,Zheng; Zequn,14,0,40,26
1657323555591,MATH 20B,A01,083756,Briones; Jor-el Thomas Caparas,4,0,36,32
1657323555591,MATH 20B,A02,083757,Briones; Jor-el Thomas Caparas,1,0,36,35
1657323555591,MATH 20B,A03,093475,Briones; Jor-el Thomas Caparas,2,0,36,34
1657323561614,MATH 20C,A01,083760,Briones; Jor-el Thomas Caparas,1,0,35,34
1657323561614,MATH 20C,A02,083761,Briones; Jor-el Thomas Caparas,8,0,35,27
1657323561614,MATH 20C,A03,093476,Briones; Jor-el Thomas Caparas,0,1,36,36
1657323561614,MATH 20C,B01,083762,Bach; Quang Tran,1,0,30,29
1657323567638,MATH 20D,A01,083765,Tran; Brian Kha,5,0,30,25
1657323567638,MATH 20D,A02,083766,Tran; Brian Kha,5,0,30,25
1657323567638,MATH 20D,A03,083767,Tran; Brian Kha,4,0,30,26
1657323573666,MATH 20E,A01,083771,Ganguly; Soumya,7,0,32,25
1657323573666,MATH 20E,A02,083772,Ganguly; Soumya,6,0,32,26
1657323573666,MATH 20E,B01,083773,Ciotti; Benjamin,20,0,35,15
1657323573666,MATH 20E,B02,083774,Ciotti; Benjamin,17,0,35,18
1657323579696,MATH 103A,A01,083777,Greenfeld; Be'Eri,3,0,36,33
1657323579696,MATH 103A,A02,083778,Greenfeld; Be'Eri,5,0,36,31
1657323579696,MATH 103A,A03,093561,Greenfeld; Be'Eri,4,0,36,32
1657323579696,MATH 103A,B01,083779,Greenfeld; Be'Eri,6,0,36,30
1657323579696,MATH 103A,B02,083780,Greenfeld; Be'Eri,4,0,36,32
1657323579696,MATH 103A,B03,093562,Greenfeld; Be'Eri,3,0,36,33
1657323585725,MATH 105,A01,085443,Carter; Anne Toulson,15,0,35,20
1657323585725,MATH 105,A02,093477,Carter; Anne Toulson,20,0,35,15
1657323591749,MATH 109,A01,083213,Ganzberger; Geoffrey Michael,2,0,34,32
1657323591749,MATH 109,A02,083214,Ganzberger; Geoffrey Michael,4,0,34,30
1657323591749,MATH 109,A03,093478,Ganzberger; Geoffrey Michael,2,0,34,32
1657323591749,MATH 109,B01,083215,Ganzberger; Geoffrey Michael,1,0,32,31
1657323591749,MATH 109,B02,083216,Ganzberger; Geoffrey Michael,1,0,32,31
1657323591749,MATH 109,B03,093479,Ganzberger; Geoffrey Michael,8,0,32,24
1657323597780,MATH 142A,A01,083219,Chow; Bennett,7,0,32,25
1657323597780,MATH 142A,A02,083220,Chow; Bennett,10,0,32,22
1657323597780,MATH 142A,A03,093480,Chow; Bennett,7,0,32,25
1657323597780,MATH 142A,B03,093481,Chow; Bennett,8,0,32,24
1657323597780,MATH 142A,B04,093558,Chow; Bennett,13,0,32,19
1657323597780,MATH 142A,B05,093559,Chow; Bennett,6,0,32,26
1657323603804,MATH 193A,A01,083224,Rotar; Vladimir,7,0,34,27
1657323603804,MATH 193A,A02,083225,Rotar; Vladimir,7,0,34,27
1657323603804,MATH 193A,A03,083781,Rotar; Vladimir,3,0,34,31
1657323603804,MATH 193A,A04,083782,Rotar; Vladimir,8,0,34,26
1657323603804,MATH 193A,A05,093482,Rotar; Vladimir,9,0,34,25
1657323609829,MATH 197,001,091859,McAuley; Julian John,9999,0,9999,0
1657323609829,MATH 197,002,095566,Kedlaya; Kiran S.,9997,0,9999,2
1657323609829,MATH 197,003,095567,Xiao; Ming,9999,0,9999,0
1657323609829,MATH 197,004,095571,Perols; Johan Lars,9998,0,9999,1
1657323616896,COGS 9,A01,083615,Shannon; Kyle Michael,8,0,75,67
1657323622924,COGS 11,A01,083617,Boyle; Mary E. T.,22,0,48,26
1657323628951,COGS 13,A01,083071,Bastos; Amalia Pinkusfeld,11,0,71,60
1657323634982,COGS 14A,A01,092681,Semenuks; Arturs,3,1,100,97
1657323641008,COGS 14B,A01,083073,Cheng; Tzu-Han,6,0,63,57
1657323647040,COGS 17,A01,092677,Semenuks; Arturs,6,0,81,75
1657323653066,COGS 100,A01,083619,Allen; Michael Gordon,16,0,70,54
1657323659090,COGS 101A,A01,083621,Davis; Joshua Daniel,9,0,68,59
1657323665113,COGS 101B,A01,091572,Allen; Michael Gordon,11,0,65,54
1657323671144,COGS 101C,A01,083625,Delgado; Tania,17,0,35,18
1657323677171,COGS 107A,A01,083627,Boyle; Mary E. T.,13,0,60,47
1657323683279,COGS 118A,A01,083075,Gupta; Anjum,19,0,76,57
1657323689306,CSE 3,A50,083646,Miranda; Gregory Joseph,24,0,50,26
1657323695327,CSE 8A,A50,083650,Miranda; Gregory Joseph,17,1,56,39
1657323701353,CSE 11,A01,083080,Cao; Yingjun,6,15,40,34
1657323707380,CSE 12,A01,083652,Krause-Levy; Sophia Louisa,28,1,120,92
1657323713403,CSE 15L,A01,083654,Morris; Justin Loren,9,0,50,41
1657323713403,CSE 15L,A02,083655,Morris; Justin Loren,9,0,50,41
1657323719426,CSE 20,A01,083657,Tran; Khoa Dang,38,0,80,42
1657323725449,CSE 21,A01,095574,Bach; Quang Tran,22,0,48,26
1657323731472,CSE 30,A01,083084,Eldon; John,4,0,80,76
1657323731472,CSE 30,B01,095061,Bhaskar; Nishant,9,0,50,41
1657323737496,CSE 100,A01,083659,Cao; Yingjun,4,4,70,66
1657323743523,CSE 134B,A01,083661,Powell; Thomas Allan,22,0,100,78
1657323749545,CSE 140,A01,083663,Gungor; Onat,14,0,85,71
1657323755570,CSE 140L,A01,083088,Eldon; John,21,0,100,79
1657323761592,CSE 175,A01,083665,Kumar; Rakesh,3,0,25,22
1657323767616,CSE 190,A00,092507,Dubnov; Shlomo,7,0,20,13
1657323773638,ECE 45,A01,083139,Congero; Spencer William,6,0,75,69
1657323779659,ECE 65,A50,083695,Saad; Andrew S,12,0,30,18
1657323779659,ECE 65,A51,095125,Saad; Andrew S,24,0,26,2
1657323785682,ECE 109,A01,091882,Touri; Behrouz,19,0,70,51
1657323791704,ECE 180,A00,083140,Abi Samra; Nicholas Camill,1,0,30,29
1657323791704,ECE 180,B00,083141,Abi Samra; Nicholas Camill,0,0,30,30
1657323797726,MATH 10A,A01,083735,Patchell; Gregory David,2,0,30,28
1657323797726,MATH 10A,A02,083736,Patchell; Gregory David,20,0,30,10
1657323797726,MATH 10A,A03,083737,Patchell; Gregory David,16,0,30,14
1657323803750,MATH 10B,A01,083207,Lim; Seonhee,7,0,34,27
1657323803750,MATH 10B,A02,083208,Lim; Seonhee,9,0,35,26
1657323803750,MATH 10B,A03,093472,Lim; Seonhee,7,0,34,27
1657323803750,MATH 10B,B01,083739,Sinha; Shubham,11,0,30,19
1657323809775,MATH 18,A01,083743,Cinel; Cameron Alexander,6,0,30,24
1657323809775,MATH 18,A02,083744,Cinel; Cameron Alexander,17,0,30,13
1657323809775,MATH 18,A03,083745,Cinel; Cameron Alexander,9,0,30,21
1657323809775,MATH 18,B01,083748,Rideout; David Porter,4,0,37,33
1657323809775,MATH 18,B02,083749,Rideout; David Porter,5,0,36,31
1657323809775,MATH 18,B03,083750,Rideout; David Porter,3,0,37,34
1657323809775,MATH 18,B04,083751,Rideout; David Porter,6,0,36,30
1657323809775,MATH 18,B05,093473,Rideout; David Porter,6,0,36,30
1657323809775,MATH 18,B06,093474,Rideout; David Porter,6,0,36,30
1657323815796,MATH 20A,A01,083754,Zheng; Zequn,14,0,40,26
1657323821819,MATH 20B,A01,083756,Briones; Jor-el Thomas Caparas,4,0,36,32
1657323821819,MATH 20B,A02,083757,Briones; Jor-el Thomas Caparas,1,0,36,35
1657323821819,MATH 20B,A03,093475,Briones; Jor-el Thomas Caparas,2,0,36,34
1657323827846,MATH 20C,A01,083760,Briones; Jor-el Thomas Caparas,1,0,35,34
1657323827846,MATH 20C,A02,083761,Briones; Jor-el Thomas Caparas,8,0,35,27
1657323827846,MATH 20C,A03,093476,Briones; Jor-el Thomas Caparas,0,1,36,36
1657323827846,MATH 20C,B01,083762,Bach; Quang Tran,1,0,30,29
1657323833869,MATH 20D,A01,083765,Tran; Brian Kha,5,0,30,25
1657323833869,MATH 20D,A02,083766,Tran; Brian Kha,5,0,30,25
1657323833869,MATH 20D,A03,083767,Tran; Brian Kha,4,0,30,26
1657323839892,MATH 20E,A01,083771,Ganguly; Soumya,7,0,32,25
1657323839892,MATH 20E,A02,083772,Ganguly; Soumya,6,0,32,26
1657323839892,MATH 20E,B01,083773,Ciotti; Benjamin,20,0,35,15
1657323839892,MATH 20E,B02,083774,Ciotti; Benjamin,17,0,35,18
1657323845924,MATH 103A,A01,083777,Greenfeld; Be'Eri,3,0,36,33
1657323845924,MATH 103A,A02,083778,Greenfeld; Be'Eri,5,0,36,31
1657323845924,MATH 103A,A03,093561,Greenfeld; Be'Eri,4,0,36,32
1657323845924,MATH 103A,B01,083779,Greenfeld; Be'Eri,6,0,36,30
1657323845924,MATH 103A,B02,083780,Greenfeld; Be'Eri,4,0,36,32
1657323845924,MATH 103A,B03,093562,Greenfeld; Be'Eri,3,0,36,33
1657323851953,MATH 105,A01,085443,Carter; Anne Toulson,15,0,35,20
1657323851953,MATH 105,A02,093477,Carter; Anne Toulson,20,0,35,15
1657323857979,MATH 109,A01,083213,Ganzberger; Geoffrey Michael,2,0,34,32
1657323857979,MATH 109,A02,083214,Ganzberger; Geoffrey Michael,4,0,34,30
1657323857979,MATH 109,A03,093478,Ganzberger; Geoffrey Michael,2,0,34,32
1657323857979,MATH 109,B01,083215,Ganzberger; Geoffrey Michael,1,0,32,31
1657323857979,MATH 109,B02,083216,Ganzberger; Geoffrey Michael,1,0,32,31
1657323857979,MATH 109,B03,093479,Ganzberger; Geoffrey Michael,8,0,32,24
1657323864008,MATH 142A,A01,083219,Chow; Bennett,7,0,32,25
1657323864008,MATH 142A,A02,083220,Chow; Bennett,10,0,32,22
1657323864008,MATH 142A,A03,093480,Chow; Bennett,7,0,32,25
1657323864008,MATH 142A,B03,093481,Chow; Bennett,8,0,32,24
1657323864008,MATH 142A,B04,093558,Chow; Bennett,13,0,32,19
1657323864008,MATH 142A,B05,093559,Chow; Bennett,6,0,32,26
1657323870033,MATH 193A,A01,083224,Rotar; Vladimir,7,0,34,27
1657323870033,MATH 193A,A02,083225,Rotar; Vladimir,7,0,34,27
1657323870033,MATH 193A,A03,083781,Rotar; Vladimir,3,0,34,31
1657323870033,MATH 193A,A04,083782,Rotar; Vladimir,8,0,34,26
1657323870033,MATH 193A,A05,093482,Rotar; Vladimir,9,0,34,25
1657323876060,MATH 197,001,091859,McAuley; Julian John,9999,0,9999,0
1657323876060,MATH 197,002,095566,Kedlaya; Kiran S.,9997,0,9999,2
1657323876060,MATH 197,003,095567,Xiao; Ming,9999,0,9999,0
1657323876060,MATH 197,004,095571,Perols; Johan Lars,9998,0,9999,1
1657323883111,COGS 9,A01,083615,Shannon; Kyle Michael,8,0,75,67
1657323889138,COGS 11,A01,083617,Boyle; Mary E. T.,22,0,48,26
1657323895165,COGS 13,A01,083071,Bastos; Amalia Pinkusfeld,11,0,71,60
1657323901189,COGS 14A,A01,092681,Semenuks; Arturs,3,1,100,97
1657323907212,COGS 14B,A01,083073,Cheng; Tzu-Han,6,0,63,57
1657323913235,COGS 17,A01,092677,Semenuks; Arturs,6,0,81,75
1657323919259,COGS 100,A01,083619,Allen; Michael Gordon,16,0,70,54
1657323925284,COGS 101A,A01,083621,Davis; Joshua Daniel,9,0,68,59
1657323931308,COGS 101B,A01,091572,Allen; Michael Gordon,11,0,65,54
1657323937335,COGS 101C,A01,083625,Delgado; Tania,17,0,35,18
1657323943358,COGS 107A,A01,083627,Boyle; Mary E. T.,13,0,60,47
1657323949381,COGS 118A,A01,083075,Gupta; Anjum,19,0,76,57
1657323955403,CSE 3,A50,083646,Miranda; Gregory Joseph,24,0,50,26
1657323961428,CSE 8A,A50,083650,Miranda; Gregory Joseph,17,1,56,39
1657323967455,CSE 11,A01,083080,Cao; Yingjun,6,15,40,34
1657323973483,CSE 12,A01,083652,Krause-Levy; Sophia Louisa,28,1,120,92
1657323979506,CSE 15L,A01,083654,Morris; Justin Loren,9,0,50,41
1657323979506,CSE 15L,A02,083655,Morris; Justin Loren,9,0,50,41
1657323985543,CSE 20,A01,083657,Tran; Khoa Dang,38,0,80,42
1657323991565,CSE 21,A01,095574,Bach; Quang Tran,22,0,48,26
1657323997593,CSE 30,A01,083084,Eldon; John,4,0,80,76
1657323997593,CSE 30,B01,095061,Bhaskar; Nishant,9,0,50,41
1657324003616,CSE 100,A01,083659,Cao; Yingjun,4,4,70,66
1657324009639,CSE 134B,A01,083661,Powell; Thomas Allan,22,0,100,78
1657324015666,CSE 140,A01,083663,Gungor; Onat,14,0,85,71
1657324021693,CSE 140L,A01,083088,Eldon; John,21,0,100,79
1657324027716,CSE 175,A01,083665,Kumar; Rakesh,3,0,25,22
1657324033740,CSE 190,A00,092507,Dubnov; Shlomo,7,0,20,13
1657324039762,ECE 45,A01,083139,Congero; Spencer William,6,0,75,69
1657324045788,ECE 65,A50,083695,Saad; Andrew S,12,0,30,18
1657324045788,ECE 65,A51,095125,Saad; Andrew S,24,0,26,2
1657324051813,ECE 109,A01,091882,Touri; Behrouz,19,0,70,51
1657324057836,ECE 180,A00,083140,Abi Samra; Nicholas Camill,1,0,30,29
1657324057836,ECE 180,B00,083141,Abi Samra; Nicholas Camill,0,0,30,30
1657324063877,MATH 10A,A01,083735,Patchell; Gregory David,2,0,30,28
1657324063877,MATH 10A,A02,083736,Patchell; Gregory David,20,0,30,10
1657324063877,MATH 10A,A03,083737,Patchell; Gregory David,16,0,30,14
1657324069906,MATH 10B,A01,083207,Lim; Seonhee,7,0,34,27
1657324069906,MATH 10B,A02,083208,Lim; Seonhee,9,0,35,26
1657324069906,MATH 10B,A03,093472,Lim; Seonhee,7,0,34,27
1657324069906,MATH 10B,B01,083739,Sinha; Shubham,11,0,30,19
1657324075936,MATH 18,A01,083743,Cinel; Cameron Alexander,6,0,30,24
1657324075936,MATH 18,A02,083744,Cinel; Cameron Alexander,17,0,30,13
1657324075936,MATH 18,A03,083745,Cinel; Cameron Alexander,9,0,30,21
1657324075936,MATH 18,B01,083748,Rideout; David Porter,4,0,37,33
1657324075936,MATH 18,B02,083749,Rideout; David Porter,5,0,36,31
1657324075936,MATH 18,B03,083750,Rideout; David Porter,3,0,37,34
1657324075936,MATH 18,B04,083751,Rideout; David Porter,6,0,36,30
1657324075936,MATH 18,B05,093473,Rideout; David Porter,6,0,36,30
1657324075936,MATH 18,B06,093474,Rideout; David Porter,6,0,36,30
1657324081959,MATH 20A,A01,083754,Zheng; Zequn,14,0,40,26
1657324087988,MATH 20B,A01,083756,Briones; Jor-el Thomas Caparas,4,0,36,32
1657324087988,MATH 20B,A02,083757,Briones; Jor-el Thomas Caparas,1,0,36,35
1657324087988,MATH 20B,A03,093475,Briones; Jor-el Thomas Caparas,2,0,36,34
1657324094010,MATH 20C,A01,083760,Briones; Jor-el Thomas Caparas,1,0,35,34
1657324094010,MATH 20C,A02,083761,Briones; Jor-el Thomas Caparas,8,0,35,27
1657324094010,MATH 20C,A03,093476,Briones; Jor-el Thomas Caparas,0,1,36,36
1657324094010,MATH 20C,B01,083762,Bach; Quang Tran,1,0,30,29
1657324100032,MATH 20D,A01,083765,Tran; Brian Kha,5,0,30,25
1657324100032,MATH 20D,A02,083766,Tran; Brian Kha,5,0,30,25
1657324100032,MATH 20D,A03,083767,Tran; Brian Kha,4,0,30,26
1657324106060,MATH 20E,A01,083771,Ganguly; Soumya,7,0,32,25
1657324106060,MATH 20E,A02,083772,Ganguly; Soumya,6,0,32,26
1657324106060,MATH 20E,B01,083773,Ciotti; Benjamin,20,0,35,15
1657324106060,MATH 20E,B02,083774,Ciotti; Benjamin,17,0,35,18
1657324112084,MATH 103A,A01,083777,Greenfeld; Be'Eri,3,0,36,33
1657324112084,MATH 103A,A02,083778,Greenfeld; Be'Eri,5,0,36,31
1657324112084,MATH 103A,A03,093561,Greenfeld; Be'Eri,4,0,36,32
1657324112084,MATH 103A,B01,083779,Greenfeld; Be'Eri,6,0,36,30
1657324112084,MATH 103A,B02,083780,Greenfeld; Be'Eri,4,0,36,32
1657324112084,MATH 103A,B03,093562,Greenfeld; Be'Eri,3,0,36,33
1657324118114,MATH 105,A01,085443,Carter; Anne Toulson,15,0,35,20
1657324118114,MATH 105,A02,093477,Carter; Anne Toulson,20,0,35,15
1657324124138,MATH 109,A01,083213,Ganzberger; Geoffrey Michael,2,0,34,32
1657324124138,MATH 109,A02,083214,Ganzberger; Geoffrey Michael,4,0,34,30
1657324124138,MATH 109,A03,093478,Ganzberger; Geoffrey Michael,2,0,34,32
1657324124138,MATH 109,B01,083215,Ganzberger; Geoffrey Michael,1,0,32,31
1657324124138,MATH 109,B02,083216,Ganzberger; Geoffrey Michael,1,0,32,31
1657324124138,MATH 109,B03,093479,Ganzberger; Geoffrey Michael,8,0,32,24
1657324130163,MATH 142A,A01,083219,Chow; Bennett,7,0,32,25
1657324130163,MATH 142A,A02,083220,Chow; Bennett,10,0,32,22
1657324130163,MATH 142A,A03,093480,Chow; Bennett,7,0,32,25
1657324130163,MATH 142A,B03,093481,Chow; Bennett,8,0,32,24
1657324130163,MATH 142A,B04,093558,Chow; Bennett,13,0,32,19
1657324130163,MATH 142A,B05,093559,Chow; Bennett,6,0,32,26
1657324136194,MATH 193A,A01,083224,Rotar; Vladimir,7,0,34,27
1657324136194,MATH 193A,A02,083225,Rotar; Vladimir,7,0,34,27
1657324136194,MATH 193A,A03,083781,Rotar; Vladimir,3,0,34,31
1657324136194,MATH 193A,A04,083782,Rotar; Vladimir,8,0,34,26
1657324136194,MATH 193A,A05,093482,Rotar; Vladimir,9,0,34,25
1657324142221,MATH 197,001,091859,McAuley; Julian John,9999,0,9999,0
1657324142221,MATH 197,002,095566,Kedlaya; Kiran S.,9997,0,9999,2
1657324142221,MATH 197,003,095567,Xiao; Ming,9999,0,9999,0
1657324142221,MATH 197,004,095571,Perols; Johan Lars,9998,0,9999,1
1657324149293,COGS 9,A01,083615,Shannon; Kyle Michael,8,0,75,67
1657324155317,COGS 11,A01,083617,Boyle; Mary E. T.,22,0,48,26
1657324161345,COGS 13,A01,083071,Bastos; Amalia Pinkusfeld,11,0,71,60
1657324167369,COGS 14A,A01,092681,Semenuks; Arturs,3,1,100,97
1657324173394,COGS 14B,A01,083073,Cheng; Tzu-Han,6,0,63,57
1657324179419,COGS 17,A01,092677,Semenuks; Arturs,6,0,81,75
1657324185442,COGS 100,A01,083619,Allen; Michael Gordon,16,0,70,54
1657324191475,COGS 101A,A01,083621,Davis; Joshua Daniel,9,0,68,59
1657324197498,COGS 101B,A01,091572,Allen; Michael Gordon,11,0,65,54
1657324203522,COGS 101C,A01,083625,Delgado; Tania,17,0,35,18
1657324209559,COGS 107A,A01,083627,Boyle; Mary E. T.,13,0,60,47
1657324215591,COGS 118A,A01,083075,Gupta; Anjum,19,0,76,57
1657324221613,CSE 3,A50,083646,Miranda; Gregory Joseph,24,0,50,26
1657324227637,CSE 8A,A50,083650,Miranda; Gregory Joseph,17,1,56,39
1657324233663,CSE 11,A01,083080,Cao; Yingjun,6,15,40,34
1657324239691,CSE 12,A01,083652,Krause-Levy; Sophia Louisa,28,1,120,92
1657324245714,CSE 15L,A01,083654,Morris; Justin Loren,9,0,50,41
1657324245714,CSE 15L,A02,083655,Morris; Justin Loren,9,0,50,41
1657324251740,CSE 20,A01,083657,Tran; Khoa Dang,38,0,80,42
1657324257764,CSE 21,A01,095574,Bach; Quang Tran,22,0,48,26
1657324263787,CSE 30,A01,083084,Eldon; John,4,0,80,76
1657324263787,CSE 30,B01,095061,Bhaskar; Nishant,9,0,50,41
1657324269810,CSE 100,A01,083659,Cao; Yingjun,4,4,70,66
1657324275840,CSE 134B,A01,083661,Powell; Thomas Allan,22,0,100,78
1657324281940,CSE 140,A01,083663,Gungor; Onat,14,0,85,71
1657324287966,CSE 140L,A01,083088,Eldon; John,21,0,100,79
1657324293991,CSE 175,A01,083665,Kumar; Rakesh,3,0,25,22
1657324300017,CSE 190,A00,092507,Dubnov; Shlomo,7,0,20,13
1657324312166,ECE 45,A01,083139,Congero; Spencer William,6,0,75,69
1657324318189,ECE 65,A50,083695,Saad; Andrew S,12,0,30,18
1657324318189,ECE 65,A51,095125,Saad; Andrew S,24,0,26,2
1657324324211,ECE 109,A01,091882,Touri; Behrouz,19,0,70,51
1657324330236,ECE 180,A00,083140,Abi Samra; Nicholas Camill,1,0,30,29
1657324330236,ECE 180,B00,083141,Abi Samra; Nicholas Camill,0,0,30,30
1657324336261,MATH 10A,A01,083735,Patchell; Gregory David,2,0,30,28
1657324336261,MATH 10A,A02,083736,Patchell; Gregory David,20,0,30,10
1657324336261,MATH 10A,A03,083737,Patchell; Gregory David,16,0,30,14
1657324342287,MATH 10B,A01,083207,Lim; Seonhee,7,0,34,27
1657324342287,MATH 10B,A02,083208,Lim; Seonhee,9,0,35,26
1657324342287,MATH 10B,A03,093472,Lim; Seonhee,7,0,34,27
1657324342287,MATH 10B,B01,083739,Sinha; Shubham,11,0,30,19
1657324348311,MATH 18,A01,083743,Cinel; Cameron Alexander,6,0,30,24
1657324348311,MATH 18,A02,083744,Cinel; Cameron Alexander,17,0,30,13
1657324348311,MATH 18,A03,083745,Cinel; Cameron Alexander,9,0,30,21
1657324348311,MATH 18,B01,083748,Rideout; David Porter,4,0,37,33
1657324348311,MATH 18,B02,083749,Rideout; David Porter,5,0,36,31
1657324348311,MATH 18,B03,083750,Rideout; David Porter,3,0,37,34
1657324348311,MATH 18,B04,083751,Rideout; David Porter,6,0,36,30
1657324348311,MATH 18,B05,093473,Rideout; David Porter,6,0,36,30
1657324348311,MATH 18,B06,093474,Rideout; David Porter,6,0,36,30
1657324354342,MATH 20A,A01,083754,Zheng; Zequn,14,0,40,26
1657324360368,MATH 20B,A01,083756,Briones; Jor-el Thomas Caparas,4,0,36,32
1657324360368,MATH 20B,A02,083757,Briones; Jor-el Thomas Caparas,1,0,36,35
1657324360368,MATH 20B,A03,093475,Briones; Jor-el Thomas Caparas,2,0,36,34
1657324366392,MATH 20C,A01,083760,Briones; Jor-el Thomas Caparas,1,0,35,34
1657324366392,MATH 20C,A02,083761,Briones; Jor-el Thomas Caparas,8,0,35,27
1657324366392,MATH 20C,A03,093476,Briones; Jor-el Thomas Caparas,0,1,36,36
1657324366392,MATH 20C,B01,083762,Bach; Quang Tran,1,0,30,29
1657324372460,MATH 20D,A01,083765,Tran; Brian Kha,5,0,30,25
1657324372460,MATH 20D,A02,083766,Tran; Brian Kha,5,0,30,25
1657324372460,MATH 20D,A03,083767,Tran; Brian Kha,4,0,30,26
1657324378490,MATH 20E,A01,083771,Ganguly; Soumya,7,0,32,25
1657324378490,MATH 20E,A02,083772,Ganguly; Soumya,6,0,32,26
1657324378490,MATH 20E,B01,083773,Ciotti; Benjamin,20,0,35,15
1657324378490,MATH 20E,B02,083774,Ciotti; Benjamin,17,0,35,18
1657324384521,MATH 103A,A01,083777,Greenfeld; Be'Eri,3,0,36,33
1657324384521,MATH 103A,A02,083778,Greenfeld; Be'Eri,5,0,36,31
1657324384521,MATH 103A,A03,093561,Greenfeld; Be'Eri,4,0,36,32
1657324384521,MATH 103A,B01,083779,Greenfeld; Be'Eri,6,0,36,30
1657324384521,MATH 103A,B02,083780,Greenfeld; Be'Eri,4,0,36,32
1657324384521,MATH 103A,B03,093562,Greenfeld; Be'Eri,3,0,36,33
1657324390547,MATH 105,A01,085443,Carter; Anne Toulson,15,0,35,20
1657324390547,MATH 105,A02,093477,Carter; Anne Toulson,20,0,35,15
1657324396569,MATH 109,A01,083213,Ganzberger; Geoffrey Michael,2,0,34,32
1657324396569,MATH 109,A02,083214,Ganzberger; Geoffrey Michael,4,0,34,30
1657324396569,MATH 109,A03,093478,Ganzberger; Geoffrey Michael,2,0,34,32
1657324396569,MATH 109,B01,083215,Ganzberger; Geoffrey Michael,1,0,32,31
1657324396569,MATH 109,B02,083216,Ganzberger; Geoffrey Michael,1,0,32,31
1657324396569,MATH 109,B03,093479,Ganzberger; Geoffrey Michael,8,0,32,24
1657324402593,MATH 142A,A01,083219,Chow; Bennett,7,0,32,25
1657324402593,MATH 142A,A02,083220,Chow; Bennett,10,0,32,22
1657324402593,MATH 142A,A03,093480,Chow; Bennett,7,0,32,25
1657324402593,MATH 142A,B03,093481,Chow; Bennett,8,0,32,24
1657324402593,MATH 142A,B04,093558,Chow; Bennett,13,0,32,19
1657324402593,MATH 142A,B05,093559,Chow; Bennett,6,0,32,26
1657324408624,MATH 193A,A01,083224,Rotar; Vladimir,7,0,34,27
1657324408624,MATH 193A,A02,083225,Rotar; Vladimir,7,0,34,27
1657324408624,MATH 193A,A03,083781,Rotar; Vladimir,3,0,34,31
1657324408624,MATH 193A,A04,083782,Rotar; Vladimir,8,0,34,26
1657324408624,MATH 193A,A05,093482,Rotar; Vladimir,9,0,34,25
1657324414652,MATH 197,001,091859,McAuley; Julian John,9999,0,9999,0
1657324414652,MATH 197,002,095566,Kedlaya; Kiran S.,9997,0,9999,2
1657324414652,MATH 197,003,095567,Xiao; Ming,9999,0,9999,0
1657324414652,MATH 197,004,095571,Perols; Johan Lars,9998,0,9999,1
1657324421707,COGS 9,A01,083615,Shannon; Kyle Michael,8,0,75,67
1657324427731,COGS 11,A01,083617,Boyle; Mary E. T.,22,0,48,26
1657324433756,COGS 13,A01,083071,Bastos; Amalia Pinkusfeld,11,0,71,60
1657324439779,COGS 14A,A01,092681,Semenuks; Arturs,3,1,100,97
1657324445806,COGS 14B,A01,083073,Cheng; Tzu-Han,6,0,63,57
1657324451832,COGS 17,A01,092677,Semenuks; Arturs,6,0,81,75
1657324457864,COGS 100,A01,083619,Allen; Michael Gordon,16,0,70,54
1657324463888,COGS 101A,A01,083621,Davis; Joshua Daniel,9,0,68,59
1657324469915,COGS 101B,A01,091572,Allen; Michael Gordon,11,0,65,54
1657324475948,COGS 101C,A01,083625,Delgado; Tania,17,0,35,18
1657324481973,COGS 107A,A01,083627,Boyle; Mary E. T.,13,0,60,47
1657324487996,COGS 118A,A01,083075,Gupta; Anjum,19,0,76,57
1657324494023,CSE 3,A50,083646,Miranda; Gregory Joseph,24,0,50,26
1657324500048,CSE 8A,A50,083650,Miranda; Gregory Joseph,17,1,56,39
1657324506074,CSE 11,A01,083080,Cao; Yingjun,6,15,40,34
1657324512100,CSE 12,A01,083652,Krause-Levy; Sophia Louisa,28,1,120,92
1657324518128,CSE 15L,A01,083654,Morris; Justin Loren,9,0,50,41
1657324518128,CSE 15L,A02,083655,Morris; Justin Loren,9,0,50,41
1657324524165,CSE 20,A01,083657,Tran; Khoa Dang,38,0,80,42
1657324530194,CSE 21,A01,095574,Bach; Quang Tran,22,0,48,26
1657324536222,CSE 30,A01,083084,Eldon; John,4,0,80,76
1657324536222,CSE 30,B01,095061,Bhaskar; Nishant,9,0,50,41
1657324542256,CSE 100,A01,083659,Cao; Yingjun,4,4,70,66
1657324548281,CSE 134B,A01,083661,Powell; Thomas Allan,22,0,100,78
1657324554304,CSE 140,A01,083663,Gungor; Onat,14,0,85,71
1657324560327,CSE 140L,A01,083088,Eldon; John,21,0,100,79
1657324566354,CSE 175,A01,083665,Kumar; Rakesh,3,0,25,22
1657324572377,CSE 190,A00,092507,Dubnov; Shlomo,7,0,20,13
1657324578400,ECE 45,A01,083139,Congero; Spencer William,6,0,75,69
1657324584422,ECE 65,A50,083695,Saad; Andrew S,12,0,30,18
1657324584422,ECE 65,A51,095125,Saad; Andrew S,24,0,26,2
1657324590448,ECE 109,A01,091882,Touri; Behrouz,19,0,70,51
1657324596471,ECE 180,A00,083140,Abi Samra; Nicholas Camill,1,0,30,29
1657324596471,ECE 180,B00,083141,Abi Samra; Nicholas Camill,0,0,30,30
1657324602493,MATH 10A,A01,083735,Patchell; Gregory David,2,0,30,28
1657324602493,MATH 10A,A02,083736,Patchell; Gregory David,20,0,30,10
1657324602493,MATH 10A,A03,083737,Patchell; Gregory David,16,0,30,14
1657324608516,MATH 10B,A01,083207,Lim; Seonhee,7,0,34,27
1657324608516,MATH 10B,A02,083208,Lim; Seonhee,9,0,35,26
1657324608516,MATH 10B,A03,093472,Lim; Seonhee,7,0,34,27
1657324608516,MATH 10B,B01,083739,Sinha; Shubham,11,0,30,19
1657324614540,MATH 18,A01,083743,Cinel; Cameron Alexander,6,0,30,24
1657324614540,MATH 18,A02,083744,Cinel; Cameron Alexander,17,0,30,13
1657324614540,MATH 18,A03,083745,Cinel; Cameron Alexander,9,0,30,21
1657324614540,MATH 18,B01,083748,Rideout; David Porter,4,0,37,33
1657324614540,MATH 18,B02,083749,Rideout; David Porter,5,0,36,31
1657324614540,MATH 18,B03,083750,Rideout; David Porter,3,0,37,34
1657324614540,MATH 18,B04,083751,Rideout; David Porter,6,0,36,30
1657324614540,MATH 18,B05,093473,Rideout; David Porter,6,0,36,30
1657324614540,MATH 18,B06,093474,Rideout; David Porter,6,0,36,30
1657324620566,MATH 20A,A01,083754,Zheng; Zequn,14,0,40,26
1657324626599,MATH 20B,A01,083756,Briones; Jor-el Thomas Caparas,4,0,36,32
1657324626599,MATH 20B,A02,083757,Briones; Jor-el Thomas Caparas,1,0,36,35
1657324626599,MATH 20B,A03,093475,Briones; Jor-el Thomas Caparas,2,0,36,34
1657324632627,MATH 20C,A01,083760,Briones; Jor-el Thomas Caparas,1,0,35,34
1657324632627,MATH 20C,A02,083761,Briones; Jor-el Thomas Caparas,8,0,35,27
1657324632627,MATH 20C,A03,093476,Briones; Jor-el Thomas Caparas,0,1,36,36
1657324632627,MATH 20C,B01,083762,Bach; Quang Tran,1,0,30,29
1657324638655,MATH 20D,A01,083765,Tran; Brian Kha,5,0,30,25
1657324638655,MATH 20D,A02,083766,Tran; Brian Kha,5,0,30,25
1657324638655,MATH 20D,A03,083767,Tran; Brian Kha,4,0,30,26
1657324644683,MATH 20E,A01,083771,Ganguly; Soumya,7,0,32,25
1657324644683,MATH 20E,A02,083772,Ganguly; Soumya,6,0,32,26
1657324644683,MATH 20E,B01,083773,Ciotti; Benjamin,20,0,35,15
1657324644683,MATH 20E,B02,083774,Ciotti; Benjamin,17,0,35,18
1657324650715,MATH 103A,A01,083777,Greenfeld; Be'Eri,3,0,36,33
1657324650715,MATH 103A,A02,083778,Greenfeld; Be'Eri,5,0,36,31
1657324650715,MATH 103A,A03,093561,Greenfeld; Be'Eri,4,0,36,32
1657324650715,MATH 103A,B01,083779,Greenfeld; Be'Eri,6,0,36,30
1657324650715,MATH 103A,B02,083780,Greenfeld; Be'Eri,4,0,36,32
1657324650715,MATH 103A,B03,093562,Greenfeld; Be'Eri,3,0,36,33
1657324656745,MATH 105,A01,085443,Carter; Anne Toulson,15,0,35,20
1657324656745,MATH 105,A02,093477,Carter; Anne Toulson,20,0,35,15
1657324662773,MATH 109,A01,083213,Ganzberger; Geoffrey Michael,2,0,34,32
1657324662773,MATH 109,A02,083214,Ganzberger; Geoffrey Michael,4,0,34,30
1657324662773,MATH 109,A03,093478,Ganzberger; Geoffrey Michael,2,0,34,32
1657324662773,MATH 109,B01,083215,Ganzberger; Geoffrey Michael,1,0,32,31
1657324662773,MATH 109,B02,083216,Ganzberger; Geoffrey Michael,1,0,32,31
1657324662773,MATH 109,B03,093479,Ganzberger; Geoffrey Michael,8,0,32,24
1657324668801,MATH 142A,A01,083219,Chow; Bennett,7,0,32,25
1657324668801,MATH 142A,A02,083220,Chow; Bennett,10,0,32,22
1657324668801,MATH 142A,A03,093480,Chow; Bennett,7,0,32,25
1657324668801,MATH 142A,B03,093481,Chow; Bennett,8,0,32,24
1657324668801,MATH 142A,B04,093558,Chow; Bennett,13,0,32,19
1657324668801,MATH 142A,B05,093559,Chow; Bennett,6,0,32,26
1657324674825,MATH 193A,A01,083224,Rotar; Vladimir,7,0,34,27
1657324674825,MATH 193A,A02,083225,Rotar; Vladimir,7,0,34,27
1657324674825,MATH 193A,A03,083781,Rotar; Vladimir,3,0,34,31
1657324674825,MATH 193A,A04,083782,Rotar; Vladimir,8,0,34,26
1657324674825,MATH 193A,A05,093482,Rotar; Vladimir,9,0,34,25
1657324680852,MATH 197,001,091859,McAuley; Julian John,9999,0,9999,0
1657324680852,MATH 197,002,095566,Kedlaya; Kiran S.,9997,0,9999,2
1657324680852,MATH 197,003,095567,Xiao; Ming,9999,0,9999,0
1657324680852,MATH 197,004,095571,Perols; Johan Lars,9998,0,9999,1
1657324687920,COGS 9,A01,083615,Shannon; Kyle Michael,8,0,75,67
1657324693953,COGS 11,A01,083617,Boyle; Mary E. T.,22,0,48,26
1657324699977,COGS 13,A01,083071,Bastos; Amalia Pinkusfeld,11,0,71,60
1657324706000,COGS 14A,A01,092681,Semenuks; Arturs,3,1,100,97
1657324712031,COGS 14B,A01,083073,Cheng; Tzu-Han,6,0,63,57
1657324718057,COGS 17,A01,092677,Semenuks; Arturs,6,0,81,75
1657324724080,COGS 100,A01,083619,Allen; Michael Gordon,16,0,70,54
1657324730104,COGS 101A,A01,083621,Davis; Joshua Daniel,9,0,68,59
1657324736130,COGS 101B,A01,091572,Allen; Michael Gordon,11,0,65,54
1657324742160,COGS 101C,A01,083625,Delgado; Tania,17,0,35,18
1657324748183,COGS 107A,A01,083627,Boyle; Mary E. T.,13,0,60,47
1657324754208,COGS 118A,A01,083075,Gupta; Anjum,19,0,76,57
1657324760231,CSE 3,A50,083646,Miranda; Gregory Joseph,24,0,50,26
1657324766258,CSE 8A,A50,083650,Miranda; Gregory Joseph,17,1,56,39
1657324772281,CSE 11,A01,083080,Cao; Yingjun,6,15,40,34
1657324778307,CSE 12,A01,083652,Krause-Levy; Sophia Louisa,28,1,120,92
1657324784330,CSE 15L,A01,083654,Morris; Justin Loren,9,0,50,41
1657324784330,CSE 15L,A02,083655,Morris; Justin Loren,9,0,50,41
1657324790352,CSE 20,A01,083657,Tran; Khoa Dang,38,0,80,42
1657324796380,CSE 21,A01,095574,Bach; Quang Tran,22,0,48,26
1657324802408,CSE 30,A01,083084,Eldon; John,4,0,80,76
1657324802408,CSE 30,B01,095061,Bhaskar; Nishant,9,0,50,41
1657324808431,CSE 100,A01,083659,Cao; Yingjun,4,4,70,66
1657324814465,CSE 134B,A01,083661,Powell; Thomas Allan,22,0,100,78
1657324820503,CSE 140,A01,083663,Gungor; Onat,14,0,85,71
1657324826526,CSE 140L,A01,083088,Eldon; John,21,0,100,79
1657324832562,CSE 175,A01,083665,Kumar; Rakesh,3,0,25,22
1657324838584,CSE 190,A00,092507,Dubnov; Shlomo,7,0,20,13
1657324844611,ECE 45,A01,083139,Congero; Spencer William,6,0,75,69
1657324850637,ECE 65,A50,083695,Saad; Andrew S,12,0,30,18
1657324850637,ECE 65,A51,095125,Saad; Andrew S,24,0,26,2
1657324856664,ECE 109,A01,091882,Touri; Behrouz,19,0,70,51
1657324862702,ECE 180,A00,083140,Abi Samra; Nicholas Camill,1,0,30,29
1657324862702,ECE 180,B00,083141,Abi Samra; Nicholas Camill,0,0,30,30
1657324868726,MATH 10A,A01,083735,Patchell; Gregory David,2,0,30,28
1657324868726,MATH 10A,A02,083736,Patchell; Gregory David,20,0,30,10
1657324868726,MATH 10A,A03,083737,Patchell; Gregory David,16,0,30,14
1657324874748,MATH 10B,A01,083207,Lim; Seonhee,7,0,34,27
1657324874748,MATH 10B,A02,083208,Lim; Seonhee,9,0,35,26
1657324874748,MATH 10B,A03,093472,Lim; Seonhee,7,0,34,27
1657324874748,MATH 10B,B01,083739,Sinha; Shubham,11,0,30,19
1657324880779,MATH 18,A01,083743,Cinel; Cameron Alexander,6,0,30,24
1657324880779,MATH 18,A02,083744,Cinel; Cameron Alexander,17,0,30,13
1657324880779,MATH 18,A03,083745,Cinel; Cameron Alexander,9,0,30,21
1657324880779,MATH 18,B01,083748,Rideout; David Porter,4,0,37,33
1657324880779,MATH 18,B02,083749,Rideout; David Porter,5,0,36,31
1657324880779,MATH 18,B03,083750,Rideout; David Porter,3,0,37,34
1657324880779,MATH 18,B04,083751,Rideout; David Porter,6,0,36,30
1657324880779,MATH 18,B05,093473,Rideout; David Porter,6,0,36,30
1657324880779,MATH 18,B06,093474,Rideout; David Porter,6,0,36,30
1657324886897,MATH 20A,A01,083754,Zheng; Zequn,14,0,40,26
1657324892930,MATH 20B,A01,083756,Briones; Jor-el Thomas Caparas,4,0,36,32
1657324892930,MATH 20B,A02,083757,Briones; Jor-el Thomas Caparas,1,0,36,35
1657324892930,MATH 20B,A03,093475,Briones; Jor-el Thomas Caparas,2,0,36,34
1657324898968,MATH 20C,A01,083760,Briones; Jor-el Thomas Caparas,1,0,35,34
1657324898968,MATH 20C,A02,083761,Briones; Jor-el Thomas Caparas,8,0,35,27
1657324898968,MATH 20C,A03,093476,Briones; Jor-el Thomas Caparas,0,1,36,36
1657324898968,MATH 20C,B01,083762,Bach; Quang Tran,1,0,30,29
1657324905001,MATH 20D,A01,083765,Tran; Brian Kha,5,0,30,25
1657324905001,MATH 20D,A02,083766,Tran; Brian Kha,5,0,30,25
1657324905001,MATH 20D,A03,083767,Tran; Brian Kha,4,0,30,26
1657324911028,MATH 20E,A01,083771,Ganguly; Soumya,7,0,32,25
1657324911028,MATH 20E,A02,083772,Ganguly; Soumya,6,0,32,26
1657324911028,MATH 20E,B01,083773,Ciotti; Benjamin,20,0,35,15
1657324911028,MATH 20E,B02,083774,Ciotti; Benjamin,17,0,35,18
1657324917054,MATH 103A,A01,083777,Greenfeld; Be'Eri,3,0,36,33
1657324917054,MATH 103A,A02,083778,Greenfeld; Be'Eri,5,0,36,31
1657324917054,MATH 103A,A03,093561,Greenfeld; Be'Eri,4,0,36,32
1657324917054,MATH 103A,B01,083779,Greenfeld; Be'Eri,6,0,36,30
1657324917054,MATH 103A,B02,083780,Greenfeld; Be'Eri,4,0,36,32
1657324917054,MATH 103A,B03,093562,Greenfeld; Be'Eri,3,0,36,33
1657324923076,MATH 105,A01,085443,Carter; Anne Toulson,15,0,35,20
1657324923076,MATH 105,A02,093477,Carter; Anne Toulson,20,0,35,15
1657324929104,MATH 109,A01,083213,Ganzberger; Geoffrey Michael,2,0,34,32
1657324929104,MATH 109,A02,083214,Ganzberger; Geoffrey Michael,4,0,34,30
1657324929104,MATH 109,A03,093478,Ganzberger; Geoffrey Michael,2,0,34,32
1657324929104,MATH 109,B01,083215,Ganzberger; Geoffrey Michael,1,0,32,31
1657324929104,MATH 109,B02,083216,Ganzberger; Geoffrey Michael,1,0,32,31
1657324929104,MATH 109,B03,093479,Ganzberger; Geoffrey Michael,8,0,32,24
1657324935139,MATH 142A,A01,083219,Chow; Bennett,7,0,32,25
1657324935139,MATH 142A,A02,083220,Chow; Bennett,10,0,32,22
1657324935139,MATH 142A,A03,093480,Chow; Bennett,7,0,32,25
1657324935139,MATH 142A,B03,093481,Chow; Bennett,8,0,32,24
1657324935139,MATH 142A,B04,093558,Chow; Bennett,13,0,32,19
1657324935139,MATH 142A,B05,093559,Chow; Bennett,6,0,32,26
1657324941163,MATH 193A,A01,083224,Rotar; Vladimir,7,0,34,27
1657324941163,MATH 193A,A02,083225,Rotar; Vladimir,7,0,34,27
1657324941163,MATH 193A,A03,083781,Rotar; Vladimir,3,0,34,31
1657324941163,MATH 193A,A04,083782,Rotar; Vladimir,8,0,34,26
1657324941163,MATH 193A,A05,093482,Rotar; Vladimir,9,0,34,25
1657324947186,MATH 197,001,091859,McAuley; Julian John,9999,0,9999,0
1657324947186,MATH 197,002,095566,Kedlaya; Kiran S.,9997,0,9999,2
1657324947186,MATH 197,003,095567,Xiao; Ming,9999,0,9999,0
1657324947186,MATH 197,004,095571,Perols; Johan Lars,9998,0,9999,1
1657324954243,COGS 9,A01,083615,Shannon; Kyle Michael,8,0,75,67
1657324960267,COGS 11,A01,083617,Boyle; Mary E. T.,22,0,48,26
1657324966291,COGS 13,A01,083071,Bastos; Amalia Pinkusfeld,11,0,71,60
1657324972322,COGS 14A,A01,092681,Semenuks; Arturs,3,1,100,97
1657324978345,COGS 14B,A01,083073,Cheng; Tzu-Han,6,0,63,57
1657324984374,COGS 17,A01,092677,Semenuks; Arturs,6,0,81,75
1657324990397,COGS 100,A01,083619,Allen; Michael Gordon,16,0,70,54
1657324996419,COGS 101A,A01,083621,Davis; Joshua Daniel,9,0,68,59
1657325002444,COGS 101B,A01,091572,Allen; Michael Gordon,11,0,65,54
1657325008468,COGS 101C,A01,083625,Delgado; Tania,17,0,35,18
1657325014490,COGS 107A,A01,083627,Boyle; Mary E. T.,13,0,60,47
1657325020521,COGS 118A,A01,083075,Gupta; Anjum,19,0,76,57
1657325026545,CSE 3,A50,083646,Miranda; Gregory Joseph,24,0,50,26
1657325032574,CSE 8A,A50,083650,Miranda; Gregory Joseph,17,1,56,39
1657325038604,CSE 11,A01,083080,Cao; Yingjun,6,15,40,34
1657325044631,CSE 12,A01,083652,Krause-Levy; Sophia Louisa,28,1,120,92
1657325050660,CSE 15L,A01,083654,Morris; Justin Loren,9,0,50,41
1657325050660,CSE 15L,A02,083655,Morris; Justin Loren,9,0,50,41
1657325056682,CSE 20,A01,083657,Tran; Khoa Dang,38,0,80,42
1657325062712,CSE 21,A01,095574,Bach; Quang Tran,22,0,48,26
1657325068740,CSE 30,A01,083084,Eldon; John,4,0,80,76
1657325068740,CSE 30,B01,095061,Bhaskar; Nishant,9,0,50,41
1657325074770,CSE 100,A01,083659,Cao; Yingjun,4,4,70,66
1657325080791,CSE 134B,A01,083661,Powell; Thomas Allan,22,0,100,78
1657325086813,CSE 140,A01,083663,Gungor; Onat,14,0,85,71
1657325092839,CSE 140L,A01,083088,Eldon; John,21,0,100,79
1657325098866,CSE 175,A01,083665,Kumar; Rakesh,3,0,25,22
1657325104895,CSE 190,A00,092507,Dubnov; Shlomo,7,0,20,13
1657325110918,ECE 45,A01,083139,Congero; Spencer William,6,0,75,69
1657325116945,ECE 65,A50,083695,Saad; Andrew S,12,0,30,18
1657325116945,ECE 65,A51,095125,Saad; Andrew S,24,0,26,2
1657325122971,ECE 109,A01,091882,Touri; Behrouz,19,0,70,51
1657325128997,ECE 180,A00,083140,Abi Samra; Nicholas Camill,1,0,30,29
1657325128997,ECE 180,B00,083141,Abi Samra; Nicholas Camill,0,0,30,30
1657325135020,MATH 10A,A01,083735,Patchell; Gregory David,2,0,30,28
1657325135020,MATH 10A,A02,083736,Patchell; Gregory David,20,0,30,10
1657325135020,MATH 10A,A03,083737,Patchell; Gregory David,16,0,30,14
1657325141050,MATH 10B,A01,083207,Lim; Seonhee,7,0,34,27
1657325141050,MATH 10B,A02,083208,Lim; Seonhee,9,0,35,26
1657325141050,MATH 10B,A03,093472,Lim; Seonhee,7,0,34,27
1657325141050,MATH 10B,B01,083739,Sinha; Shubham,11,0,30,19
1657325147081,MATH 18,A01,083743,Cinel; Cameron Alexander,6,0,30,24
1657325147081,MATH 18,A02,083744,Cinel; Cameron Alexander,17,0,30,13
1657325147081,MATH 18,A03,083745,Cinel; Cameron Alexander,9,0,30,21
1657325147081,MATH 18,B01,083748,Rideout; David Porter,4,0,37,33
1657325147081,MATH 18,B02,083749,Rideout; David Porter,5,0,36,31
1657325147081,MATH 18,B03,083750,Rideout; David Porter,3,0,37,34
1657325147081,MATH 18,B04,083751,Rideout; David Porter,6,0,36,30
1657325147081,MATH 18,B05,093473,Rideout; David Porter,6,0,36,30
1657325147081,MATH 18,B06,093474,Rideout; David Porter,6,0,36,30
1657325153108,MATH 20A,A01,083754,Zheng; Zequn,14,0,40,26
1657325159132,MATH 20B,A01,083756,Briones; Jor-el Thomas Caparas,4,0,36,32
1657325159132,MATH 20B,A02,083757,Briones; Jor-el Thomas Caparas,1,0,36,35
1657325159132,MATH 20B,A03,093475,Briones; Jor-el Thomas Caparas,2,0,36,34
1657325165155,MATH 20C,A01,083760,Briones; Jor-el Thomas Caparas,1,0,35,34
1657325165155,MATH 20C,A02,083761,Briones; Jor-el Thomas Caparas,8,0,35,27
1657325165155,MATH 20C,A03,093476,Briones; Jor-el Thomas Caparas,0,1,36,36
1657325165155,MATH 20C,B01,083762,Bach; Quang Tran,1,0,30,29
1657325171179,MATH 20D,A01,083765,Tran; Brian Kha,5,0,30,25
1657325171179,MATH 20D,A02,083766,Tran; Brian Kha,5,0,30,25
1657325171179,MATH 20D,A03,083767,Tran; Brian Kha,4,0,30,26
1657325177210,MATH 20E,A01,083771,Ganguly; Soumya,7,0,32,25
1657325177210,MATH 20E,A02,083772,Ganguly; Soumya,6,0,32,26
1657325177210,MATH 20E,B01,083773,Ciotti; Benjamin,20,0,35,15
1657325177210,MATH 20E,B02,083774,Ciotti; Benjamin,17,0,35,18
1657325183240,MATH 103A,A01,083777,Greenfeld; Be'Eri,3,0,36,33
1657325183240,MATH 103A,A02,083778,Greenfeld; Be'Eri,5,0,36,31
1657325183240,MATH 103A,A03,093561,Greenfeld; Be'Eri,4,0,36,32
1657325183240,MATH 103A,B01,083779,Greenfeld; Be'Eri,6,0,36,30
1657325183240,MATH 103A,B02,083780,Greenfeld; Be'Eri,4,0,36,32
1657325183240,MATH 103A,B03,093562,Greenfeld; Be'Eri,3,0,36,33
1657325189269,MATH 105,A01,085443,Carter; Anne Toulson,15,0,35,20
1657325189269,MATH 105,A02,093477,Carter; Anne Toulson,20,0,35,15
1657325195297,MATH 109,A01,083213,Ganzberger; Geoffrey Michael,2,0,34,32
1657325195297,MATH 109,A02,083214,Ganzberger; Geoffrey Michael,4,0,34,30
1657325195297,MATH 109,A03,093478,Ganzberger; Geoffrey Michael,2,0,34,32
1657325195297,MATH 109,B01,083215,Ganzberger; Geoffrey Michael,1,0,32,31
1657325195297,MATH 109,B02,083216,Ganzberger; Geoffrey Michael,1,0,32,31
1657325195297,MATH 109,B03,093479,Ganzberger; Geoffrey Michael,8,0,32,24
1657325201329,MATH 142A,A01,083219,Chow; Bennett,7,0,32,25
1657325201329,MATH 142A,A02,083220,Chow; Bennett,10,0,32,22
1657325201329,MATH 142A,A03,093480,Chow; Bennett,7,0,32,25
1657325201329,MATH 142A,B03,093481,Chow; Bennett,8,0,32,24
1657325201329,MATH 142A,B04,093558,Chow; Bennett,13,0,32,19
1657325201329,MATH 142A,B05,093559,Chow; Bennett,6,0,32,26
1657325207351,MATH 193A,A01,083224,Rotar; Vladimir,7,0,34,27
1657325207351,MATH 193A,A02,083225,Rotar; Vladimir,7,0,34,27
1657325207351,MATH 193A,A03,083781,Rotar; Vladimir,3,0,34,31
1657325207351,MATH 193A,A04,083782,Rotar; Vladimir,8,0,34,26
1657325207351,MATH 193A,A05,093482,Rotar; Vladimir,9,0,34,25
1657325213374,MATH 197,001,091859,McAuley; Julian John,9999,0,9999,0
1657325213374,MATH 197,002,095566,Kedlaya; Kiran S.,9997,0,9999,2
1657325213374,MATH 197,003,095567,Xiao; Ming,9999,0,9999,0
1657325213374,MATH 197,004,095571,Perols; Johan Lars,9998,0,9999,1
1657325220441,COGS 9,A01,083615,Shannon; Kyle Michael,8,0,75,67
1657325226468,COGS 11,A01,083617,Boyle; Mary E. T.,22,0,48,26
1657325232496,COGS 13,A01,083071,Bastos; Amalia Pinkusfeld,11,0,71,60
1657325238519,COGS 14A,A01,092681,Semenuks; Arturs,3,1,100,97
1657325244551,COGS 14B,A01,083073,Cheng; Tzu-Han,6,0,63,57
1657325250576,COGS 17,A01,092677,Semenuks; Arturs,6,0,81,75
1657325256604,COGS 100,A01,083619,Allen; Michael Gordon,16,0,70,54
1657325262632,COGS 101A,A01,083621,Davis; Joshua Daniel,9,0,68,59
1657325268679,COGS 101B,A01,091572,Allen; Michael Gordon,11,0,65,54
1657325274709,COGS 101C,A01,083625,Delgado; Tania,17,0,35,18
1657325280744,COGS 107A,A01,083627,Boyle; Mary E. T.,13,0,60,47
1657325286769,COGS 118A,A01,083075,Gupta; Anjum,19,0,76,57
1657325292793,CSE 3,A50,083646,Miranda; Gregory Joseph,24,0,50,26
1657325298815,CSE 8A,A50,083650,Miranda; Gregory Joseph,17,1,56,39
1657325304843,CSE 11,A01,083080,Cao; Yingjun,6,15,40,34
1657325310870,CSE 12,A01,083652,Krause-Levy; Sophia Louisa,28,1,120,92
1657325316896,CSE 15L,A01,083654,Morris; Justin Loren,9,0,50,41
1657325316896,CSE 15L,A02,083655,Morris; Justin Loren,9,0,50,41
1657325322922,CSE 20,A01,083657,Tran; Khoa Dang,38,0,80,42
1657325328951,CSE 21,A01,095574,Bach; Quang Tran,22,0,48,26
1657325334973,CSE 30,A01,083084,Eldon; John,4,0,80,76
1657325334973,CSE 30,B01,095061,Bhaskar; Nishant,9,0,50,41
1657325340997,CSE 100,A01,083659,Cao; Yingjun,4,4,70,66
1657325347020,CSE 134B,A01,083661,Powell; Thomas Allan,22,0,100,78
1657325353041,CSE 140,A01,083663,Gungor; Onat,14,0,85,71
1657325359071,CSE 140L,A01,083088,Eldon; John,21,0,100,79
1657325365097,CSE 175,A01,083665,Kumar; Rakesh,3,0,25,22
1657325371120,CSE 190,A00,092507,Dubnov; Shlomo,7,0,20,13
1657325377143,ECE 45,A01,083139,Congero; Spencer William,6,0,75,69
1657325383165,ECE 65,A50,083695,Saad; Andrew S,12,0,30,18
1657325383165,ECE 65,A51,095125,Saad; Andrew S,24,0,26,2
1657325389188,ECE 109,A01,091882,Touri; Behrouz,19,0,70,51
1657325395212,ECE 180,A00,083140,Abi Samra; Nicholas Camill,1,0,30,29
1657325395212,ECE 180,B00,083141,Abi Samra; Nicholas Camill,0,0,30,30
1657325401240,MATH 10A,A01,083735,Patchell; Gregory David,2,0,30,28
1657325401240,MATH 10A,A02,083736,Patchell; Gregory David,20,0,30,10
1657325401240,MATH 10A,A03,083737,Patchell; Gregory David,16,0,30,14
1657325407271,MATH 10B,A01,083207,Lim; Seonhee,7,0,34,27
1657325407271,MATH 10B,A02,083208,Lim; Seonhee,9,0,35,26
1657325407271,MATH 10B,A03,093472,Lim; Seonhee,7,0,34,27
1657325407271,MATH 10B,B01,083739,Sinha; Shubham,11,0,30,19
1657325413304,MATH 18,A01,083743,Cinel; Cameron Alexander,6,0,30,24
1657325413304,MATH 18,A02,083744,Cinel; Cameron Alexander,17,0,30,13
1657325413304,MATH 18,A03,083745,Cinel; Cameron Alexander,9,0,30,21
1657325413304,MATH 18,B01,083748,Rideout; David Porter,4,0,37,33
1657325413304,MATH 18,B02,083749,Rideout; David Porter,5,0,36,31
1657325413304,MATH 18,B03,083750,Rideout; David Porter,3,0,37,34
1657325413304,MATH 18,B04,083751,Rideout; David Porter,6,0,36,30
1657325413304,MATH 18,B05,093473,Rideout; David Porter,6,0,36,30
1657325413304,MATH 18,B06,093474,Rideout; David Porter,6,0,36,30
1657325419327,MATH 20A,A01,083754,Zheng; Zequn,14,0,40,26
1657325425352,MATH 20B,A01,083756,Briones; Jor-el Thomas Caparas,4,0,36,32
1657325425352,MATH 20B,A02,083757,Briones; Jor-el Thomas Caparas,1,0,36,35
1657325425352,MATH 20B,A03,093475,Briones; Jor-el Thomas Caparas,2,0,36,34
1657325431377,MATH 20C,A01,083760,Briones; Jor-el Thomas Caparas,1,0,35,34
1657325431377,MATH 20C,A02,083761,Briones; Jor-el Thomas Caparas,8,0,35,27
1657325431377,MATH 20C,A03,093476,Briones; Jor-el Thomas Caparas,0,1,36,36
1657325431377,MATH 20C,B01,083762,Bach; Quang Tran,1,0,30,29
1657325437405,MATH 20D,A01,083765,Tran; Brian Kha,5,0,30,25
1657325437405,MATH 20D,A02,083766,Tran; Brian Kha,5,0,30,25
1657325437405,MATH 20D,A03,083767,Tran; Brian Kha,4,0,30,26
1657325443435,MATH 20E,A01,083771,Ganguly; Soumya,7,0,32,25
1657325443435,MATH 20E,A02,083772,Ganguly; Soumya,6,0,32,26
1657325443435,MATH 20E,B01,083773,Ciotti; Benjamin,20,0,35,15
1657325443435,MATH 20E,B02,083774,Ciotti; Benjamin,17,0,35,18
1657325449461,MATH 103A,A01,083777,Greenfeld; Be'Eri,3,0,36,33
1657325449461,MATH 103A,A02,083778,Greenfeld; Be'Eri,5,0,36,31
1657325449461,MATH 103A,A03,093561,Greenfeld; Be'Eri,4,0,36,32
1657325449461,MATH 103A,B01,083779,Greenfeld; Be'Eri,6,0,36,30
1657325449461,MATH 103A,B02,083780,Greenfeld; Be'Eri,4,0,36,32
1657325449461,MATH 103A,B03,093562,Greenfeld; Be'Eri,3,0,36,33
1657325455483,MATH 105,A01,085443,Carter; Anne Toulson,15,0,35,20
1657325455483,MATH 105,A02,093477,Carter; Anne Toulson,20,0,35,15
1657325461507,MATH 109,A01,083213,Ganzberger; Geoffrey Michael,2,0,34,32
1657325461507,MATH 109,A02,083214,Ganzberger; Geoffrey Michael,4,0,34,30
1657325461507,MATH 109,A03,093478,Ganzberger; Geoffrey Michael,2,0,34,32
1657325461507,MATH 109,B01,083215,Ganzberger; Geoffrey Michael,1,0,32,31
1657325461507,MATH 109,B02,083216,Ganzberger; Geoffrey Michael,1,0,32,31
1657325461507,MATH 109,B03,093479,Ganzberger; Geoffrey Michael,8,0,32,24
1657325467530,MATH 142A,A01,083219,Chow; Bennett,7,0,32,25
1657325467530,MATH 142A,A02,083220,Chow; Bennett,10,0,32,22
1657325467530,MATH 142A,A03,093480,Chow; Bennett,7,0,32,25
1657325467530,MATH 142A,B03,093481,Chow; Bennett,8,0,32,24
1657325467530,MATH 142A,B04,093558,Chow; Bennett,13,0,32,19
1657325467530,MATH 142A,B05,093559,Chow; Bennett,6,0,32,26
1657325473559,MATH 193A,A01,083224,Rotar; Vladimir,7,0,34,27
1657325473559,MATH 193A,A02,083225,Rotar; Vladimir,7,0,34,27
1657325473559,MATH 193A,A03,083781,Rotar; Vladimir,3,0,34,31
1657325473559,MATH 193A,A04,083782,Rotar; Vladimir,8,0,34,26
1657325473559,MATH 193A,A05,093482,Rotar; Vladimir,9,0,34,25
1657325479583,MATH 197,001,091859,McAuley; Julian John,9999,0,9999,0
1657325479583,MATH 197,002,095566,Kedlaya; Kiran S.,9997,0,9999,2
1657325479583,MATH 197,003,095567,Xiao; Ming,9999,0,9999,0
1657325479583,MATH 197,004,095571,Perols; Johan Lars,9998,0,9999,1
1657325486724,COGS 9,A01,083615,Shannon; Kyle Michael,8,0,75,67
1657325492748,COGS 11,A01,083617,Boyle; Mary E. T.,22,0,48,26
1657325498777,COGS 13,A01,083071,Bastos; Amalia Pinkusfeld,11,0,71,60
1657325504803,COGS 14A,A01,092681,Semenuks; Arturs,3,1,100,97
1657325510828,COGS 14B,A01,083073,Cheng; Tzu-Han,6,0,63,57
1657325516858,COGS 17,A01,092677,Semenuks; Arturs,6,0,81,75
1657325522882,COGS 100,A01,083619,Allen; Michael Gordon,16,0,70,54
1657325528908,COGS 101A,A01,083621,Davis; Joshua Daniel,9,0,68,59
1657325534937,COGS 101B,A01,091572,Allen; Michael Gordon,11,0,65,54
1657325540965,COGS 101C,A01,083625,Delgado; Tania,17,0,35,18
1657325546990,COGS 107A,A01,083627,Boyle; Mary E. T.,13,0,60,47
1657325553012,COGS 118A,A01,083075,Gupta; Anjum,19,0,76,57
1657325559036,CSE 3,A50,083646,Miranda; Gregory Joseph,24,0,50,26
1657325565060,CSE 8A,A50,083650,Miranda; Gregory Joseph,17,1,56,39
1657325571082,CSE 11,A01,083080,Cao; Yingjun,6,15,40,34
1657325577109,CSE 12,A01,083652,Krause-Levy; Sophia Louisa,28,1,120,92
1657325583140,CSE 15L,A01,083654,Morris; Justin Loren,9,0,50,41
1657325583140,CSE 15L,A02,083655,Morris; Justin Loren,9,0,50,41
1657325589163,CSE 20,A01,083657,Tran; Khoa Dang,38,0,80,42
1657325595192,CSE 21,A01,095574,Bach; Quang Tran,22,0,48,26
1657325601215,CSE 30,A01,083084,Eldon; John,4,0,80,76
1657325601215,CSE 30,B01,095061,Bhaskar; Nishant,9,0,50,41
1657325607248,CSE 100,A01,083659,Cao; Yingjun,4,4,70,66
1657325613286,CSE 134B,A01,083661,Powell; Thomas Allan,22,0,100,78
1657325619311,CSE 140,A01,083663,Gungor; Onat,14,0,85,71
1657325625334,CSE 140L,A01,083088,Eldon; John,21,0,100,79
1657325631357,CSE 175,A01,083665,Kumar; Rakesh,3,0,25,22
1657325637383,CSE 190,A00,092507,Dubnov; Shlomo,7,0,20,13
1657325643405,ECE 45,A01,083139,Congero; Spencer William,6,0,75,69
1657325649429,ECE 65,A50,083695,Saad; Andrew S,12,0,30,18
1657325649429,ECE 65,A51,095125,Saad; Andrew S,24,0,26,2
1657325655460,ECE 109,A01,091882,Touri; Behrouz,19,0,70,51
1657325661482,ECE 180,A00,083140,Abi Samra; Nicholas Camill,1,0,30,29
1657325661482,ECE 180,B00,083141,Abi Samra; Nicholas Camill,0,0,30,30
1657325667512,MATH 10A,A01,083735,Patchell; Gregory David,2,0,30,28
1657325667512,MATH 10A,A02,083736,Patchell; Gregory David,20,0,30,10
1657325667512,MATH 10A,A03,083737,Patchell; Gregory David,16,0,30,14
1657325673540,MATH 10B,A01,083207,Lim; Seonhee,7,0,34,27
1657325673540,MATH 10B,A02,083208,Lim; Seonhee,9,0,35,26
1657325673540,MATH 10B,A03,093472,Lim; Seonhee,7,0,34,27
1657325673540,MATH 10B,B01,083739,Sinha; Shubham,11,0,30,19
1657325679566,MATH 18,A01,083743,Cinel; Cameron Alexander,6,0,30,24
1657325679566,MATH 18,A02,083744,Cinel; Cameron Alexander,17,0,30,13
1657325679566,MATH 18,A03,083745,Cinel; Cameron Alexander,9,0,30,21
1657325679566,MATH 18,B01,083748,Rideout; David Porter,4,0,37,33
1657325679566,MATH 18,B02,083749,Rideout; David Porter,5,0,36,31
1657325679566,MATH 18,B03,083750,Rideout; David Porter,3,0,37,34
1657325679566,MATH 18,B04,083751,Rideout; David Porter,6,0,36,30
1657325679566,MATH 18,B05,093473,Rideout; David Porter,6,0,36,30
1657325679566,MATH 18,B06,093474,Rideout; David Porter,6,0,36,30
1657325685592,MATH 20A,A01,083754,Zheng; Zequn,14,0,40,26
1657325691619,MATH 20B,A01,083756,Briones; Jor-el Thomas Caparas,4,0,36,32
1657325691619,MATH 20B,A02,083757,Briones; Jor-el Thomas Caparas,1,0,36,35
1657325691619,MATH 20B,A03,093475,Briones; Jor-el Thomas Caparas,2,0,36,34
1657325697647,MATH 20C,A01,083760,Briones; Jor-el Thomas Caparas,1,0,35,34
1657325697647,MATH 20C,A02,083761,Briones; Jor-el Thomas Caparas,8,0,35,27
1657325697647,MATH 20C,A03,093476,Briones; Jor-el Thomas Caparas,0,1,36,36
1657325697647,MATH 20C,B01,083762,Bach; Quang Tran,1,0,30,29
1657325703670,MATH 20D,A01,083765,Tran; Brian Kha,5,0,30,25
1657325703670,MATH 20D,A02,083766,Tran; Brian Kha,5,0,30,25
1657325703670,MATH 20D,A03,083767,Tran; Brian Kha,4,0,30,26
1657325709693,MATH 20E,A01,083771,Ganguly; Soumya,7,0,32,25
1657325709693,MATH 20E,A02,083772,Ganguly; Soumya,6,0,32,26
1657325709693,MATH 20E,B01,083773,Ciotti; Benjamin,20,0,35,15
1657325709693,MATH 20E,B02,083774,Ciotti; Benjamin,17,0,35,18
1657325715720,MATH 103A,A01,083777,Greenfeld; Be'Eri,3,0,36,33
1657325715720,MATH 103A,A02,083778,Greenfeld; Be'Eri,5,0,36,31
1657325715720,MATH 103A,A03,093561,Greenfeld; Be'Eri,4,0,36,32
1657325715720,MATH 103A,B01,083779,Greenfeld; Be'Eri,6,0,36,30
1657325715720,MATH 103A,B02,083780,Greenfeld; Be'Eri,4,0,36,32
1657325715720,MATH 103A,B03,093562,Greenfeld; Be'Eri,3,0,36,33
1657325721744,MATH 105,A01,085443,Carter; Anne Toulson,15,0,35,20
1657325721744,MATH 105,A02,093477,Carter; Anne Toulson,20,0,35,15
1657325727765,MATH 109,A01,083213,Ganzberger; Geoffrey Michael,2,0,34,32
1657325727765,MATH 109,A02,083214,Ganzberger; Geoffrey Michael,4,0,34,30
1657325727765,MATH 109,A03,093478,Ganzberger; Geoffrey Michael,2,0,34,32
1657325727765,MATH 109,B01,083215,Ganzberger; Geoffrey Michael,1,0,32,31
1657325727765,MATH 109,B02,083216,Ganzberger; Geoffrey Michael,1,0,32,31
1657325727765,MATH 109,B03,093479,Ganzberger; Geoffrey Michael,8,0,32,24
1657325733789,MATH 142A,A01,083219,Chow; Bennett,7,0,32,25
1657325733789,MATH 142A,A02,083220,Chow; Bennett,10,0,32,22
1657325733789,MATH 142A,A03,093480,Chow; Bennett,7,0,32,25
1657325733789,MATH 142A,B03,093481,Chow; Bennett,8,0,32,24
1657325733789,MATH 142A,B04,093558,Chow; Bennett,13,0,32,19
1657325733789,MATH 142A,B05,093559,Chow; Bennett,6,0,32,26
1657325739818,MATH 193A,A01,083224,Rotar; Vladimir,7,0,34,27
1657325739818,MATH 193A,A02,083225,Rotar; Vladimir,7,0,34,27
1657325739818,MATH 193A,A03,083781,Rotar; Vladimir,3,0,34,31
1657325739818,MATH 193A,A04,083782,Rotar; Vladimir,8,0,34,26
1657325739818,MATH 193A,A05,093482,Rotar; Vladimir,9,0,34,25
1657325745840,MATH 197,001,091859,McAuley; Julian John,9999,0,9999,0
1657325745840,MATH 197,002,095566,Kedlaya; Kiran S.,9997,0,9999,2
1657325745840,MATH 197,003,095567,Xiao; Ming,9999,0,9999,0
1657325745840,MATH 197,004,095571,Perols; Johan Lars,9998,0,9999,1
1657325752893,COGS 9,A01,083615,Shannon; Kyle Michael,8,0,75,67
1657325758916,COGS 11,A01,083617,Boyle; Mary E. T.,22,0,48,26
1657325764950,COGS 13,A01,083071,Bastos; Amalia Pinkusfeld,11,0,71,60
1657325770974,COGS 14A,A01,092681,Semenuks; Arturs,3,1,100,97
1657325776999,COGS 14B,A01,083073,Cheng; Tzu-Han,6,0,63,57
1657325783026,COGS 17,A01,092677,Semenuks; Arturs,6,0,81,75
1657325789049,COGS 100,A01,083619,Allen; Michael Gordon,16,0,70,54
1657325795071,COGS 101A,A01,083621,Davis; Joshua Daniel,9,0,68,59
1657325801095,COGS 101B,A01,091572,Allen; Michael Gordon,11,0,65,54
1657325807122,COGS 101C,A01,083625,Delgado; Tania,17,0,35,18
1657325813148,COGS 107A,A01,083627,Boyle; Mary E. T.,13,0,60,47
1657325819177,COGS 118A,A01,083075,Gupta; Anjum,19,0,76,57
1657325825206,CSE 3,A50,083646,Miranda; Gregory Joseph,24,0,50,26
1657325831233,CSE 8A,A50,083650,Miranda; Gregory Joseph,17,1,56,39
1657325837259,CSE 11,A01,083080,Cao; Yingjun,6,15,40,34
1657325843282,CSE 12,A01,083652,Krause-Levy; Sophia Louisa,28,1,120,92
1657325849308,CSE 15L,A01,083654,Morris; Justin Loren,9,0,50,41
1657325849308,CSE 15L,A02,083655,Morris; Justin Loren,9,0,50,41
1657325855336,CSE 20,A01,083657,Tran; Khoa Dang,38,0,80,42
1657325861368,CSE 21,A01,095574,Bach; Quang Tran,22,0,48,26
1657325867391,CSE 30,A01,083084,Eldon; John,4,0,80,76
1657325867391,CSE 30,B01,095061,Bhaskar; Nishant,9,0,50,41
1657325873419,CSE 100,A01,083659,Cao; Yingjun,4,4,70,66
1657325879444,CSE 134B,A01,083661,Powell; Thomas Allan,22,0,100,78
1657325885469,CSE 140,A01,083663,Gungor; Onat,14,0,85,71
1657325891493,CSE 140L,A01,083088,Eldon; John,21,0,100,79
1657325897516,CSE 175,A01,083665,Kumar; Rakesh,3,0,25,22
1657325903539,CSE 190,A00,092507,Dubnov; Shlomo,7,0,20,13
1657325909562,ECE 45,A01,083139,Congero; Spencer William,6,0,75,69
1657325915589,ECE 65,A50,083695,Saad; Andrew S,12,0,30,18
1657325915589,ECE 65,A51,095125,Saad; Andrew S,24,0,26,2
1657325921616,ECE 109,A01,091882,Touri; Behrouz,19,0,70,51
1657325927642,ECE 180,A00,083140,Abi Samra; Nicholas Camill,1,0,30,29
1657325927642,ECE 180,B00,083141,Abi Samra; Nicholas Camill,0,0,30,30
1657325933666,MATH 10A,A01,083735,Patchell; Gregory David,2,0,30,28
1657325933666,MATH 10A,A02,083736,Patchell; Gregory David,20,0,30,10
1657325933666,MATH 10A,A03,083737,Patchell; Gregory David,16,0,30,14
1657325939688,MATH 10B,A01,083207,Lim; Seonhee,7,0,34,27
1657325939688,MATH 10B,A02,083208,Lim; Seonhee,9,0,35,26
1657325939688,MATH 10B,A03,093472,Lim; Seonhee,7,0,34,27
1657325939688,MATH 10B,B01,083739,Sinha; Shubham,11,0,30,19
1657325945717,MATH 18,A01,083743,Cinel; Cameron Alexander,6,0,30,24
1657325945717,MATH 18,A02,083744,Cinel; Cameron Alexander,17,0,30,13
1657325945717,MATH 18,A03,083745,Cinel; Cameron Alexander,9,0,30,21
1657325945717,MATH 18,B01,083748,Rideout; David Porter,4,0,37,33
1657325945717,MATH 18,B02,083749,Rideout; David Porter,5,0,36,31
1657325945717,MATH 18,B03,083750,Rideout; David Porter,3,0,37,34
1657325945717,MATH 18,B04,083751,Rideout; David Porter,6,0,36,30
1657325945717,MATH 18,B05,093473,Rideout; David Porter,6,0,36,30
1657325945717,MATH 18,B06,093474,Rideout; David Porter,6,0,36,30
1657325951741,MATH 20A,A01,083754,Zheng; Zequn,14,0,40,26
1657325957768,MATH 20B,A01,083756,Briones; Jor-el Thomas Caparas,4,0,36,32
1657325957768,MATH 20B,A02,083757,Briones; Jor-el Thomas Caparas,1,0,36,35
1657325957768,MATH 20B,A03,093475,Briones; Jor-el Thomas Caparas,2,0,36,34
1657325963791,MATH 20C,A01,083760,Briones; Jor-el Thomas Caparas,1,0,35,34
1657325963791,MATH 20C,A02,083761,Briones; Jor-el Thomas Caparas,8,0,35,27
1657325963791,MATH 20C,A03,093476,Briones; Jor-el Thomas Caparas,0,1,36,36
1657325963791,MATH 20C,B01,083762,Bach; Quang Tran,1,0,30,29
1657325969815,MATH 20D,A01,083765,Tran; Brian Kha,5,0,30,25
1657325969815,MATH 20D,A02,083766,Tran; Brian Kha,5,0,30,25
1657325969815,MATH 20D,A03,083767,Tran; Brian Kha,4,0,30,26
1657325975843,MATH 20E,A01,083771,Ganguly; Soumya,7,0,32,25
1657325975843,MATH 20E,A02,083772,Ganguly; Soumya,6,0,32,26
1657325975843,MATH 20E,B01,083773,Ciotti; Benjamin,20,0,35,15
1657325975843,MATH 20E,B02,083774,Ciotti; Benjamin,17,0,35,18
1657325981868,MATH 103A,A01,083777,Greenfeld; Be'Eri,3,0,36,33
1657325981868,MATH 103A,A02,083778,Greenfeld; Be'Eri,5,0,36,31
1657325981868,MATH 103A,A03,093561,Greenfeld; Be'Eri,4,0,36,32
1657325981868,MATH 103A,B01,083779,Greenfeld; Be'Eri,6,0,36,30
1657325981868,MATH 103A,B02,083780,Greenfeld; Be'Eri,4,0,36,32
1657325981868,MATH 103A,B03,093562,Greenfeld; Be'Eri,3,0,36,33
1657325987891,MATH 105,A01,085443,Carter; Anne Toulson,15,0,35,20
1657325987891,MATH 105,A02,093477,Carter; Anne Toulson,20,0,35,15
1657325993914,MATH 109,A01,083213,Ganzberger; Geoffrey Michael,2,0,34,32
1657325993914,MATH 109,A02,083214,Ganzberger; Geoffrey Michael,4,0,34,30
1657325993914,MATH 109,A03,093478,Ganzberger; Geoffrey Michael,2,0,34,32
1657325993914,MATH 109,B01,083215,Ganzberger; Geoffrey Michael,1,0,32,31
1657325993914,MATH 109,B02,083216,Ganzberger; Geoffrey Michael,1,0,32,31
1657325993914,MATH 109,B03,093479,Ganzberger; Geoffrey Michael,8,0,32,24
1657325999938,MATH 142A,A01,083219,Chow; Bennett,7,0,32,25
1657325999938,MATH 142A,A02,083220,Chow; Bennett,10,0,32,22
1657325999938,MATH 142A,A03,093480,Chow; Bennett,7,0,32,25
1657325999938,MATH 142A,B03,093481,Chow; Bennett,8,0,32,24
1657325999938,MATH 142A,B04,093558,Chow; Bennett,13,0,32,19
1657325999938,MATH 142A,B05,093559,Chow; Bennett,6,0,32,26
1657326005971,MATH 193A,A01,083224,Rotar; Vladimir,7,0,34,27
1657326005971,MATH 193A,A02,083225,Rotar; Vladimir,7,0,34,27
1657326005971,MATH 193A,A03,083781,Rotar; Vladimir,3,0,34,31
1657326005971,MATH 193A,A04,083782,Rotar; Vladimir,8,0,34,26
1657326005971,MATH 193A,A05,093482,Rotar; Vladimir,9,0,34,25
1657326012008,MATH 197,001,091859,McAuley; Julian John,9999,0,9999,0
1657326012008,MATH 197,002,095566,Kedlaya; Kiran S.,9997,0,9999,2
1657326012008,MATH 197,003,095567,Xiao; Ming,9999,0,9999,0
1657326012008,MATH 197,004,095571,Perols; Johan Lars,9998,0,9999,1
1657326019060,COGS 9,A01,083615,Shannon; Kyle Michael,8,0,75,67
1657326025091,COGS 11,A01,083617,Boyle; Mary E. T.,22,0,48,26
1657326031114,COGS 13,A01,083071,Bastos; Amalia Pinkusfeld,11,0,71,60
1657326037137,COGS 14A,A01,092681,Semenuks; Arturs,3,1,100,97
1657326043171,COGS 14B,A01,083073,Cheng; Tzu-Han,6,0,63,57
1657326049198,COGS 17,A01,092677,Semenuks; Arturs,6,0,81,75
1657326055227,COGS 100,A01,083619,Allen; Michael Gordon,16,0,70,54
1657326061252,COGS 101A,A01,083621,Davis; Joshua Daniel,9,0,68,59
1657326067274,COGS 101B,A01,091572,Allen; Michael Gordon,11,0,65,54
1657326073306,COGS 101C,A01,083625,Delgado; Tania,17,0,35,18
1657326079401,COGS 107A,A01,083627,Boyle; Mary E. T.,13,0,60,47
1657326085431,COGS 118A,A01,083075,Gupta; Anjum,19,0,76,57
1657326091455,CSE 3,A50,083646,Miranda; Gregory Joseph,24,0,50,26
1657326097481,CSE 8A,A50,083650,Miranda; Gregory Joseph,17,1,56,39
1657326103519,CSE 11,A01,083080,Cao; Yingjun,6,15,40,34
1657326109546,CSE 12,A01,083652,Krause-Levy; Sophia Louisa,28,1,120,92
1657326115571,CSE 15L,A01,083654,Morris; Justin Loren,9,0,50,41
1657326115571,CSE 15L,A02,083655,Morris; Justin Loren,9,0,50,41
1657326121597,CSE 20,A01,083657,Tran; Khoa Dang,38,0,80,42
1657326127622,CSE 21,A01,095574,Bach; Quang Tran,22,0,48,26
1657326133655,CSE 30,A01,083084,Eldon; John,4,0,80,76
1657326133655,CSE 30,B01,095061,Bhaskar; Nishant,9,0,50,41
1657326139679,CSE 100,A01,083659,Cao; Yingjun,4,4,70,66
1657326145706,CSE 134B,A01,083661,Powell; Thomas Allan,22,0,100,78
1657326151733,CSE 140,A01,083663,Gungor; Onat,14,0,85,71
1657326157754,CSE 140L,A01,083088,Eldon; John,21,0,100,79
1657326163775,CSE 175,A01,083665,Kumar; Rakesh,3,0,25,22
1657326169797,CSE 190,A00,092507,Dubnov; Shlomo,7,0,20,13
1657326175833,ECE 45,A01,083139,Congero; Spencer William,6,0,75,69
1657326181860,ECE 65,A50,083695,Saad; Andrew S,12,0,30,18
1657326181860,ECE 65,A51,095125,Saad; Andrew S,24,0,26,2
1657326187885,ECE 109,A01,091882,Touri; Behrouz,19,0,70,51
1657326193908,ECE 180,A00,083140,Abi Samra; Nicholas Camill,1,0,30,29
1657326193908,ECE 180,B00,083141,Abi Samra; Nicholas Camill,0,0,30,30
1657326199936,MATH 10A,A01,083735,Patchell; Gregory David,2,0,30,28
1657326199936,MATH 10A,A02,083736,Patchell; Gregory David,20,0,30,10
1657326199936,MATH 10A,A03,083737,Patchell; Gregory David,16,0,30,14
1657326205960,MATH 10B,A01,083207,Lim; Seonhee,7,0,34,27
1657326205960,MATH 10B,A02,083208,Lim; Seonhee,9,0,35,26
1657326205960,MATH 10B,A03,093472,Lim; Seonhee,7,0,34,27
1657326205960,MATH 10B,B01,083739,Sinha; Shubham,11,0,30,19
1657326211983,MATH 18,A01,083743,Cinel; Cameron Alexander,6,0,30,24
1657326211983,MATH 18,A02,083744,Cinel; Cameron Alexander,17,0,30,13
1657326211983,MATH 18,A03,083745,Cinel; Cameron Alexander,9,0,30,21
1657326211983,MATH 18,B01,083748,Rideout; David Porter,4,0,37,33
1657326211983,MATH 18,B02,083749,Rideout; David Porter,5,0,36,31
1657326211983,MATH 18,B03,083750,Rideout; David Porter,3,0,37,34
1657326211983,MATH 18,B04,083751,Rideout; David Porter,6,0,36,30
1657326211983,MATH 18,B05,093473,Rideout; David Porter,6,0,36,30
1657326211983,MATH 18,B06,093474,Rideout; David Porter,6,0,36,30
1657326218007,MATH 20A,A01,083754,Zheng; Zequn,14,0,40,26
1657326224036,MATH 20B,A01,083756,Briones; Jor-el Thomas Caparas,4,0,36,32
1657326224036,MATH 20B,A02,083757,Briones; Jor-el Thomas Caparas,1,0,36,35
1657326224036,MATH 20B,A03,093475,Briones; Jor-el Thomas Caparas,2,0,36,34
1657326230062,MATH 20C,A01,083760,Briones; Jor-el Thomas Caparas,1,0,35,34
1657326230062,MATH 20C,A02,083761,Briones; Jor-el Thomas Caparas,8,0,35,27
1657326230062,MATH 20C,A03,093476,Briones; Jor-el Thomas Caparas,0,1,36,36
1657326230062,MATH 20C,B01,083762,Bach; Quang Tran,1,0,30,29
1657326236090,MATH 20D,A01,083765,Tran; Brian Kha,5,0,30,25
1657326236090,MATH 20D,A02,083766,Tran; Brian Kha,5,0,30,25
1657326236090,MATH 20D,A03,083767,Tran; Brian Kha,4,0,30,26
1657326242139,MATH 20E,A01,083771,Ganguly; Soumya,7,0,32,25
1657326242139,MATH 20E,A02,083772,Ganguly; Soumya,6,0,32,26
1657326242139,MATH 20E,B01,083773,Ciotti; Benjamin,20,0,35,15
1657326242139,MATH 20E,B02,083774,Ciotti; Benjamin,17,0,35,18
1657326248162,MATH 103A,A01,083777,Greenfeld; Be'Eri,3,0,36,33
1657326248162,MATH 103A,A02,083778,Greenfeld; Be'Eri,5,0,36,31
1657326248162,MATH 103A,A03,093561,Greenfeld; Be'Eri,4,0,36,32
1657326248162,MATH 103A,B01,083779,Greenfeld; Be'Eri,6,0,36,30
1657326248162,MATH 103A,B02,083780,Greenfeld; Be'Eri,4,0,36,32
1657326248162,MATH 103A,B03,093562,Greenfeld; Be'Eri,3,0,36,33
1657326254189,MATH 105,A01,085443,Carter; Anne Toulson,15,0,35,20
1657326254189,MATH 105,A02,093477,Carter; Anne Toulson,20,0,35,15
1657326260215,MATH 109,A01,083213,Ganzberger; Geoffrey Michael,2,0,34,32
1657326260215,MATH 109,A02,083214,Ganzberger; Geoffrey Michael,4,0,34,30
1657326260215,MATH 109,A03,093478,Ganzberger; Geoffrey Michael,2,0,34,32
1657326260215,MATH 109,B01,083215,Ganzberger; Geoffrey Michael,1,0,32,31
1657326260215,MATH 109,B02,083216,Ganzberger; Geoffrey Michael,1,0,32,31
1657326260215,MATH 109,B03,093479,Ganzberger; Geoffrey Michael,8,0,32,24
1657326266243,MATH 142A,A01,083219,Chow; Bennett,7,0,32,25
1657326266243,MATH 142A,A02,083220,Chow; Bennett,10,0,32,22
1657326266243,MATH 142A,A03,093480,Chow; Bennett,7,0,32,25
1657326266243,MATH 142A,B03,093481,Chow; Bennett,8,0,32,24
1657326266243,MATH 142A,B04,093558,Chow; Bennett,13,0,32,19
1657326266243,MATH 142A,B05,093559,Chow; Bennett,6,0,32,26
1657326272279,MATH 193A,A01,083224,Rotar; Vladimir,7,0,34,27
1657326272279,MATH 193A,A02,083225,Rotar; Vladimir,7,0,34,27
1657326272279,MATH 193A,A03,083781,Rotar; Vladimir,3,0,34,31
1657326272279,MATH 193A,A04,083782,Rotar; Vladimir,8,0,34,26
1657326272279,MATH 193A,A05,093482,Rotar; Vladimir,9,0,34,25
1657326278302,MATH 197,001,091859,McAuley; Julian John,9999,0,9999,0
1657326278302,MATH 197,002,095566,Kedlaya; Kiran S.,9997,0,9999,2
1657326278302,MATH 197,003,095567,Xiao; Ming,9999,0,9999,0
1657326278302,MATH 197,004,095571,Perols; Johan Lars,9998,0,9999,1
1657326285378,COGS 9,A01,083615,Shannon; Kyle Michael,8,0,75,67
1657326291405,COGS 11,A01,083617,Boyle; Mary E. T.,22,0,48,26
1657326297428,COGS 13,A01,083071,Bastos; Amalia Pinkusfeld,11,0,71,60
1657326303453,COGS 14A,A01,092681,Semenuks; Arturs,3,1,100,97
1657326309476,COGS 14B,A01,083073,Cheng; Tzu-Han,6,0,63,57
1657326315498,COGS 17,A01,092677,Semenuks; Arturs,6,0,81,75
1657326321522,COGS 100,A01,083619,Allen; Michael Gordon,16,0,70,54
1657326327544,COGS 101A,A01,083621,Davis; Joshua Daniel,9,0,68,59
1657326333567,COGS 101B,A01,091572,Allen; Michael Gordon,11,0,65,54
1657326339594,COGS 101C,A01,083625,Delgado; Tania,17,0,35,18
1657326345617,COGS 107A,A01,083627,Boyle; Mary E. T.,13,0,60,47
1657326351643,COGS 118A,A01,083075,Gupta; Anjum,19,0,76,57
1657326357670,CSE 3,A50,083646,Miranda; Gregory Joseph,24,0,50,26
1657326363693,CSE 8A,A50,083650,Miranda; Gregory Joseph,17,1,56,39
1657326369715,CSE 11,A01,083080,Cao; Yingjun,6,15,40,34
1657326375742,CSE 12,A01,083652,Krause-Levy; Sophia Louisa,28,1,120,92
1657326381767,CSE 15L,A01,083654,Morris; Justin Loren,9,0,50,41
1657326381767,CSE 15L,A02,083655,Morris; Justin Loren,9,0,50,41
1657326387790,CSE 20,A01,083657,Tran; Khoa Dang,38,0,80,42
1657326393812,CSE 21,A01,095574,Bach; Quang Tran,22,0,48,26
1657326399839,CSE 30,A01,083084,Eldon; John,4,0,80,76
1657326399839,CSE 30,B01,095061,Bhaskar; Nishant,9,0,50,41
1657326405864,CSE 100,A01,083659,Cao; Yingjun,4,4,70,66
1657326411888,CSE 134B,A01,083661,Powell; Thomas Allan,22,0,100,78
1657326417912,CSE 140,A01,083663,Gungor; Onat,14,0,85,71
1657326423935,CSE 140L,A01,083088,Eldon; John,21,0,100,79
1657326429957,CSE 175,A01,083665,Kumar; Rakesh,3,0,25,22
1657326435982,CSE 190,A00,092507,Dubnov; Shlomo,7,0,20,13
1657326442008,ECE 45,A01,083139,Congero; Spencer William,6,0,75,69
1657326448031,ECE 65,A50,083695,Saad; Andrew S,12,0,30,18
1657326448031,ECE 65,A51,095125,Saad; Andrew S,24,0,26,2
1657326454057,ECE 109,A01,091882,Touri; Behrouz,19,0,70,51
1657326460080,ECE 180,A00,083140,Abi Samra; Nicholas Camill,1,0,30,29
1657326460080,ECE 180,B00,083141,Abi Samra; Nicholas Camill,0,0,30,30
1657326466103,MATH 10A,A01,083735,Patchell; Gregory David,2,0,30,28
1657326466103,MATH 10A,A02,083736,Patchell; Gregory David,20,0,30,10
1657326466103,MATH 10A,A03,083737,Patchell; Gregory David,16,0,30,14
1657326472127,MATH 10B,A01,083207,Lim; Seonhee,7,0,34,27
1657326472127,MATH 10B,A02,083208,Lim; Seonhee,9,0,35,26
1657326472127,MATH 10B,A03,093472,Lim; Seonhee,7,0,34,27
1657326472127,MATH 10B,B01,083739,Sinha; Shubham,11,0,30,19
1657326478158,MATH 18,A01,083743,Cinel; Cameron Alexander,6,0,30,24
1657326478158,MATH 18,A02,083744,Cinel; Cameron Alexander,17,0,30,13
1657326478158,MATH 18,A03,083745,Cinel; Cameron Alexander,9,0,30,21
1657326478158,MATH 18,B01,083748,Rideout; David Porter,4,0,37,33
1657326478158,MATH 18,B02,083749,Rideout; David Porter,5,0,36,31
1657326478158,MATH 18,B03,083750,Rideout; David Porter,3,0,37,34
1657326478158,MATH 18,B04,083751,Rideout; David Porter,6,0,36,30
1657326478158,MATH 18,B05,093473,Rideout; David Porter,6,0,36,30
1657326478158,MATH 18,B06,093474,Rideout; David Porter,6,0,36,30
1657326484183,MATH 20A,A01,083754,Zheng; Zequn,14,0,40,26
1657326490206,MATH 20B,A01,083756,Briones; Jor-el Thomas Caparas,4,0,36,32
1657326490206,MATH 20B,A02,083757,Briones; Jor-el Thomas Caparas,1,0,36,35
1657326490206,MATH 20B,A03,093475,Briones; Jor-el Thomas Caparas,2,0,36,34
1657326496233,MATH 20C,A01,083760,Briones; Jor-el Thomas Caparas,1,0,35,34
1657326496233,MATH 20C,A02,083761,Briones; Jor-el Thomas Caparas,8,0,35,27
1657326496233,MATH 20C,A03,093476,Briones; Jor-el Thomas Caparas,0,1,36,36
1657326496233,MATH 20C,B01,083762,Bach; Quang Tran,1,0,30,29
1657326502255,MATH 20D,A01,083765,Tran; Brian Kha,5,0,30,25
1657326502255,MATH 20D,A02,083766,Tran; Brian Kha,5,0,30,25
1657326502255,MATH 20D,A03,083767,Tran; Brian Kha,4,0,30,26
1657326508282,MATH 20E,A01,083771,Ganguly; Soumya,7,0,32,25
1657326508282,MATH 20E,A02,083772,Ganguly; Soumya,6,0,32,26
1657326508282,MATH 20E,B01,083773,Ciotti; Benjamin,20,0,35,15
1657326508282,MATH 20E,B02,083774,Ciotti; Benjamin,17,0,35,18
1657326514306,MATH 103A,A01,083777,Greenfeld; Be'Eri,3,0,36,33
1657326514306,MATH 103A,A02,083778,Greenfeld; Be'Eri,5,0,36,31
1657326514306,MATH 103A,A03,093561,Greenfeld; Be'Eri,4,0,36,32
1657326514306,MATH 103A,B01,083779,Greenfeld; Be'Eri,6,0,36,30
1657326514306,MATH 103A,B02,083780,Greenfeld; Be'Eri,4,0,36,32
1657326514306,MATH 103A,B03,093562,Greenfeld; Be'Eri,3,0,36,33
1657326520333,MATH 105,A01,085443,Carter; Anne Toulson,15,0,35,20
1657326520333,MATH 105,A02,093477,Carter; Anne Toulson,20,0,35,15
1657326526364,MATH 109,A01,083213,Ganzberger; Geoffrey Michael,2,0,34,32
1657326526364,MATH 109,A02,083214,Ganzberger; Geoffrey Michael,4,0,34,30
1657326526364,MATH 109,A03,093478,Ganzberger; Geoffrey Michael,2,0,34,32
1657326526364,MATH 109,B01,083215,Ganzberger; Geoffrey Michael,1,0,32,31
1657326526364,MATH 109,B02,083216,Ganzberger; Geoffrey Michael,1,0,32,31
1657326526364,MATH 109,B03,093479,Ganzberger; Geoffrey Michael,8,0,32,24
1657326532387,MATH 142A,A01,083219,Chow; Bennett,7,0,32,25
1657326532387,MATH 142A,A02,083220,Chow; Bennett,10,0,32,22
1657326532387,MATH 142A,A03,093480,Chow; Bennett,7,0,32,25
1657326532387,MATH 142A,B03,093481,Chow; Bennett,8,0,32,24
1657326532387,MATH 142A,B04,093558,Chow; Bennett,13,0,32,19
1657326532387,MATH 142A,B05,093559,Chow; Bennett,6,0,32,26
1657326538410,MATH 193A,A01,083224,Rotar; Vladimir,7,0,34,27
1657326538410,MATH 193A,A02,083225,Rotar; Vladimir,7,0,34,27
1657326538410,MATH 193A,A03,083781,Rotar; Vladimir,3,0,34,31
1657326538410,MATH 193A,A04,083782,Rotar; Vladimir,8,0,34,26
1657326538410,MATH 193A,A05,093482,Rotar; Vladimir,9,0,34,25
1657326544433,MATH 197,001,091859,McAuley; Julian John,9999,0,9999,0
1657326544433,MATH 197,002,095566,Kedlaya; Kiran S.,9997,0,9999,2
1657326544433,MATH 197,003,095567,Xiao; Ming,9999,0,9999,0
1657326544433,MATH 197,004,095571,Perols; Johan Lars,9998,0,9999,1
1657326551499,COGS 9,A01,083615,Shannon; Kyle Michael,8,0,75,67
1657326557525,COGS 11,A01,083617,Boyle; Mary E. T.,22,0,48,26
1657326563547,COGS 13,A01,083071,Bastos; Amalia Pinkusfeld,11,0,71,60
1657326569569,COGS 14A,A01,092681,Semenuks; Arturs,3,1,100,97
1657326575592,COGS 14B,A01,083073,Cheng; Tzu-Han,6,0,63,57
1657326581615,COGS 17,A01,092677,Semenuks; Arturs,6,0,81,75
1657326587643,COGS 100,A01,083619,Allen; Michael Gordon,16,0,70,54
1657326593667,COGS 101A,A01,083621,Davis; Joshua Daniel,9,0,68,59
1657326599692,COGS 101B,A01,091572,Allen; Michael Gordon,11,0,65,54
1657326605717,COGS 101C,A01,083625,Delgado; Tania,17,0,35,18
1657326611739,COGS 107A,A01,083627,Boyle; Mary E. T.,13,0,60,47
1657326617769,COGS 118A,A01,083075,Gupta; Anjum,19,0,76,57
1657326623795,CSE 3,A50,083646,Miranda; Gregory Joseph,24,0,50,26
1657326629820,CSE 8A,A50,083650,Miranda; Gregory Joseph,17,1,56,39
1657326635844,CSE 11,A01,083080,Cao; Yingjun,6,15,40,34
1657326641867,CSE 12,A01,083652,Krause-Levy; Sophia Louisa,28,1,120,92
1657326647903,CSE 15L,A01,083654,Morris; Justin Loren,9,0,50,41
1657326647903,CSE 15L,A02,083655,Morris; Justin Loren,9,0,50,41
1657326653927,CSE 20,A01,083657,Tran; Khoa Dang,38,0,80,42
1657326659954,CSE 21,A01,095574,Bach; Quang Tran,22,0,48,26
1657326665983,CSE 30,A01,083084,Eldon; John,4,0,80,76
1657326665983,CSE 30,B01,095061,Bhaskar; Nishant,9,0,50,41
1657326672007,CSE 100,A01,083659,Cao; Yingjun,4,4,70,66
1657326678128,CSE 134B,A01,083661,Powell; Thomas Allan,22,0,100,78
1657326684152,CSE 140,A01,083663,Gungor; Onat,14,0,85,71
1657326690177,CSE 140L,A01,083088,Eldon; John,21,0,100,79
1657326696205,CSE 175,A01,083665,Kumar; Rakesh,3,0,25,22
1657326702232,CSE 190,A00,092507,Dubnov; Shlomo,7,0,20,13
1657326708255,ECE 45,A01,083139,Congero; Spencer William,6,0,75,69
1657326714278,ECE 65,A50,083695,Saad; Andrew S,12,0,30,18
1657326714278,ECE 65,A51,095125,Saad; Andrew S,24,0,26,2
1657326720302,ECE 109,A01,091882,Touri; Behrouz,19,0,70,51
1657326726326,ECE 180,A00,083140,Abi Samra; Nicholas Camill,1,0,30,29
1657326726326,ECE 180,B00,083141,Abi Samra; Nicholas Camill,0,0,30,30
1657326732352,MATH 10A,A01,083735,Patchell; Gregory David,2,0,30,28
1657326732352,MATH 10A,A02,083736,Patchell; Gregory David,20,0,30,10
1657326732352,MATH 10A,A03,083737,Patchell; Gregory David,16,0,30,14
1657326738381,MATH 10B,A01,083207,Lim; Seonhee,7,0,34,27
1657326738381,MATH 10B,A02,083208,Lim; Seonhee,9,0,35,26
1657326738381,MATH 10B,A03,093472,Lim; Seonhee,7,0,34,27
1657326738381,MATH 10B,B01,083739,Sinha; Shubham,11,0,30,19
1657326744412,MATH 18,A01,083743,Cinel; Cameron Alexander,6,0,30,24
1657326744412,MATH 18,A02,083744,Cinel; Cameron Alexander,17,0,30,13
1657326744412,MATH 18,A03,083745,Cinel; Cameron Alexander,9,0,30,21
1657326744412,MATH 18,B01,083748,Rideout; David Porter,4,0,37,33
1657326744412,MATH 18,B02,083749,Rideout; David Porter,5,0,36,31
1657326744412,MATH 18,B03,083750,Rideout; David Porter,3,0,37,34
1657326744412,MATH 18,B04,083751,Rideout; David Porter,6,0,36,30
1657326744412,MATH 18,B05,093473,Rideout; David Porter,6,0,36,30
1657326744412,MATH 18,B06,093474,Rideout; David Porter,6,0,36,30
1657326750439,MATH 20A,A01,083754,Zheng; Zequn,14,0,40,26
1657326756463,MATH 20B,A01,083756,Briones; Jor-el Thomas Caparas,4,0,36,32
1657326756463,MATH 20B,A02,083757,Briones; Jor-el Thomas Caparas,1,0,36,35
1657326756463,MATH 20B,A03,093475,Briones; Jor-el Thomas Caparas,2,0,36,34
1657326762490,MATH 20C,A01,083760,Briones; Jor-el Thomas Caparas,1,0,35,34
1657326762490,MATH 20C,A02,083761,Briones; Jor-el Thomas Caparas,8,0,35,27
1657326762490,MATH 20C,A03,093476,Briones; Jor-el Thomas Caparas,0,1,36,36
1657326762490,MATH 20C,B01,083762,Bach; Quang Tran,1,0,30,29
1657326768517,MATH 20D,A01,083765,Tran; Brian Kha,5,0,30,25
1657326768517,MATH 20D,A02,083766,Tran; Brian Kha,5,0,30,25
1657326768517,MATH 20D,A03,083767,Tran; Brian Kha,4,0,30,26
1657326774543,MATH 20E,A01,083771,Ganguly; Soumya,7,0,32,25
1657326774543,MATH 20E,A02,083772,Ganguly; Soumya,6,0,32,26
1657326774543,MATH 20E,B01,083773,Ciotti; Benjamin,20,0,35,15
1657326774543,MATH 20E,B02,083774,Ciotti; Benjamin,17,0,35,18
1657326780578,MATH 103A,A01,083777,Greenfeld; Be'Eri,3,0,36,33
1657326780578,MATH 103A,A02,083778,Greenfeld; Be'Eri,5,0,36,31
1657326780578,MATH 103A,A03,093561,Greenfeld; Be'Eri,4,0,36,32
1657326780578,MATH 103A,B01,083779,Greenfeld; Be'Eri,6,0,36,30
1657326780578,MATH 103A,B02,083780,Greenfeld; Be'Eri,4,0,36,32
1657326780578,MATH 103A,B03,093562,Greenfeld; Be'Eri,3,0,36,33
1657326786603,MATH 105,A01,085443,Carter; Anne Toulson,15,0,35,20
1657326786603,MATH 105,A02,093477,Carter; Anne Toulson,20,0,35,15
1657326792626,MATH 109,A01,083213,Ganzberger; Geoffrey Michael,2,0,34,32
1657326792626,MATH 109,A02,083214,Ganzberger; Geoffrey Michael,4,0,34,30
1657326792626,MATH 109,A03,093478,Ganzberger; Geoffrey Michael,2,0,34,32
1657326792626,MATH 109,B01,083215,Ganzberger; Geoffrey Michael,1,0,32,31
1657326792626,MATH 109,B02,083216,Ganzberger; Geoffrey Michael,1,0,32,31
1657326792626,MATH 109,B03,093479,Ganzberger; Geoffrey Michael,8,0,32,24
1657326798658,MATH 142A,A01,083219,Chow; Bennett,7,0,32,25
1657326798658,MATH 142A,A02,083220,Chow; Bennett,10,0,32,22
1657326798658,MATH 142A,A03,093480,Chow; Bennett,7,0,32,25
1657326798658,MATH 142A,B03,093481,Chow; Bennett,8,0,32,24
1657326798658,MATH 142A,B04,093558,Chow; Bennett,13,0,32,19
1657326798658,MATH 142A,B05,093559,Chow; Bennett,6,0,32,26
1657326804685,MATH 193A,A01,083224,Rotar; Vladimir,7,0,34,27
1657326804685,MATH 193A,A02,083225,Rotar; Vladimir,7,0,34,27
1657326804685,MATH 193A,A03,083781,Rotar; Vladimir,3,0,34,31
1657326804685,MATH 193A,A04,083782,Rotar; Vladimir,8,0,34,26
1657326804685,MATH 193A,A05,093482,Rotar; Vladimir,9,0,34,25
1657326810709,MATH 197,001,091859,McAuley; Julian John,9999,0,9999,0
1657326810709,MATH 197,002,095566,Kedlaya; Kiran S.,9997,0,9999,2
1657326810709,MATH 197,003,095567,Xiao; Ming,9999,0,9999,0
1657326810709,MATH 197,004,095571,Perols; Johan Lars,9998,0,9999,1
1657326817774,COGS 9,A01,083615,Shannon; Kyle Michael,8,0,75,67
1657326823796,COGS 11,A01,083617,Boyle; Mary E. T.,22,0,48,26
1657326829823,COGS 13,A01,083071,Bastos; Amalia Pinkusfeld,11,0,71,60
1657326835845,COGS 14A,A01,092681,Semenuks; Arturs,3,1,100,97
1657326841868,COGS 14B,A01,083073,Cheng; Tzu-Han,6,0,63,57
1657326847899,COGS 17,A01,092677,Semenuks; Arturs,6,0,81,75
1657326853925,COGS 100,A01,083619,Allen; Michael Gordon,16,0,70,54
1657326859948,COGS 101A,A01,083621,Davis; Joshua Daniel,9,0,68,59
1657326865970,COGS 101B,A01,091572,Allen; Michael Gordon,11,0,65,54
1657326871996,COGS 101C,A01,083625,Delgado; Tania,17,0,35,18
1657326878024,COGS 107A,A01,083627,Boyle; Mary E. T.,13,0,60,47
1657326884047,COGS 118A,A01,083075,Gupta; Anjum,19,0,76,57
1657326890071,CSE 3,A50,083646,Miranda; Gregory Joseph,24,0,50,26
1657326896096,CSE 8A,A50,083650,Miranda; Gregory Joseph,17,1,56,39
1657326902119,CSE 11,A01,083080,Cao; Yingjun,6,15,40,34
1657326908146,CSE 12,A01,083652,Krause-Levy; Sophia Louisa,28,1,120,92
1657326914173,CSE 15L,A01,083654,Morris; Justin Loren,9,0,50,41
1657326914173,CSE 15L,A02,083655,Morris; Justin Loren,9,0,50,41
1657326920196,CSE 20,A01,083657,Tran; Khoa Dang,38,0,80,42
1657326926223,CSE 21,A01,095574,Bach; Quang Tran,22,0,48,26
1657326932248,CSE 30,A01,083084,Eldon; John,4,0,80,76
1657326932248,CSE 30,B01,095061,Bhaskar; Nishant,9,0,50,41
1657326938273,CSE 100,A01,083659,Cao; Yingjun,4,4,70,66
1657326944297,CSE 134B,A01,083661,Powell; Thomas Allan,22,0,100,78
1657326950323,CSE 140,A01,083663,Gungor; Onat,14,0,85,71
1657326956346,CSE 140L,A01,083088,Eldon; John,21,0,100,79
1657326962369,CSE 175,A01,083665,Kumar; Rakesh,3,0,25,22
1657326968395,CSE 190,A00,092507,Dubnov; Shlomo,7,0,20,13
1657326974430,ECE 45,A01,083139,Congero; Spencer William,6,0,75,69
1657326980457,ECE 65,A50,083695,Saad; Andrew S,12,0,30,18
1657326980457,ECE 65,A51,095125,Saad; Andrew S,24,0,26,2
1657326986482,ECE 109,A01,091882,Touri; Behrouz,19,0,70,51
1657326992509,ECE 180,A00,083140,Abi Samra; Nicholas Camill,1,0,30,29
1657326992509,ECE 180,B00,083141,Abi Samra; Nicholas Camill,0,0,30,30
1657326998535,MATH 10A,A01,083735,Patchell; Gregory David,2,0,30,28
1657326998535,MATH 10A,A02,083736,Patchell; Gregory David,20,0,30,10
1657326998535,MATH 10A,A03,083737,Patchell; Gregory David,16,0,30,14
1657327004558,MATH 10B,A01,083207,Lim; Seonhee,7,0,34,27
1657327004558,MATH 10B,A02,083208,Lim; Seonhee,9,0,35,26
1657327004558,MATH 10B,A03,093472,Lim; Seonhee,7,0,34,27
1657327004558,MATH 10B,B01,083739,Sinha; Shubham,12,0,30,18
1657327010589,MATH 18,A01,083743,Cinel; Cameron Alexander,6,0,30,24
1657327010589,MATH 18,A02,083744,Cinel; Cameron Alexander,17,0,30,13
1657327010589,MATH 18,A03,083745,Cinel; Cameron Alexander,9,0,30,21
1657327010589,MATH 18,B01,083748,Rideout; David Porter,4,0,37,33
1657327010589,MATH 18,B02,083749,Rideout; David Porter,5,0,36,31
1657327010589,MATH 18,B03,083750,Rideout; David Porter,3,0,37,34
1657327010589,MATH 18,B04,083751,Rideout; David Porter,6,0,36,30
1657327010589,MATH 18,B05,093473,Rideout; David Porter,6,0,36,30
1657327010589,MATH 18,B06,093474,Rideout; David Porter,6,0,36,30
1657327016611,MATH 20A,A01,083754,Zheng; Zequn,14,0,40,26
1657327022639,MATH 20B,A01,083756,Briones; Jor-el Thomas Caparas,4,0,36,32
1657327022639,MATH 20B,A02,083757,Briones; Jor-el Thomas Caparas,1,0,36,35
1657327022639,MATH 20B,A03,093475,Briones; Jor-el Thomas Caparas,2,0,36,34
1657327028674,MATH 20C,A01,083760,Briones; Jor-el Thomas Caparas,1,0,35,34
1657327028674,MATH 20C,A02,083761,Briones; Jor-el Thomas Caparas,8,0,35,27
1657327028674,MATH 20C,A03,093476,Briones; Jor-el Thomas Caparas,0,1,36,36
1657327028674,MATH 20C,B01,083762,Bach; Quang Tran,1,0,30,29
1657327034701,MATH 20D,A01,083765,Tran; Brian Kha,5,0,30,25
1657327034701,MATH 20D,A02,083766,Tran; Brian Kha,5,0,30,25
1657327034701,MATH 20D,A03,083767,Tran; Brian Kha,4,0,30,26
1657327040723,MATH 20E,A01,083771,Ganguly; Soumya,7,0,32,25
1657327040723,MATH 20E,A02,083772,Ganguly; Soumya,6,0,32,26
1657327040723,MATH 20E,B01,083773,Ciotti; Benjamin,20,0,35,15
1657327040723,MATH 20E,B02,083774,Ciotti; Benjamin,17,0,35,18
1657327046746,MATH 103A,A01,083777,Greenfeld; Be'Eri,3,0,36,33
1657327046746,MATH 103A,A02,083778,Greenfeld; Be'Eri,5,0,36,31
1657327046746,MATH 103A,A03,093561,Greenfeld; Be'Eri,4,0,36,32
1657327046746,MATH 103A,B01,083779,Greenfeld; Be'Eri,6,0,36,30
1657327046746,MATH 103A,B02,083780,Greenfeld; Be'Eri,4,0,36,32
1657327046746,MATH 103A,B03,093562,Greenfeld; Be'Eri,3,0,36,33
1657327052776,MATH 105,A01,085443,Carter; Anne Toulson,15,0,35,20
1657327052776,MATH 105,A02,093477,Carter; Anne Toulson,20,0,35,15
1657327058798,MATH 109,A01,083213,Ganzberger; Geoffrey Michael,2,0,34,32
1657327058798,MATH 109,A02,083214,Ganzberger; Geoffrey Michael,4,0,34,30
1657327058798,MATH 109,A03,093478,Ganzberger; Geoffrey Michael,2,0,34,32
1657327058798,MATH 109,B01,083215,Ganzberger; Geoffrey Michael,1,0,32,31
1657327058798,MATH 109,B02,083216,Ganzberger; Geoffrey Michael,1,0,32,31
1657327058798,MATH 109,B03,093479,Ganzberger; Geoffrey Michael,8,0,32,24
1657327064832,MATH 142A,A01,083219,Chow; Bennett,7,0,32,25
1657327064832,MATH 142A,A02,083220,Chow; Bennett,10,0,32,22
1657327064832,MATH 142A,A03,093480,Chow; Bennett,7,0,32,25
1657327064832,MATH 142A,B03,093481,Chow; Bennett,8,0,32,24
1657327064832,MATH 142A,B04,093558,Chow; Bennett,13,0,32,19
1657327064832,MATH 142A,B05,093559,Chow; Bennett,6,0,32,26
1657327070854,MATH 193A,A01,083224,Rotar; Vladimir,7,0,34,27
1657327070854,MATH 193A,A02,083225,Rotar; Vladimir,7,0,34,27
1657327070854,MATH 193A,A03,083781,Rotar; Vladimir,3,0,34,31
1657327070854,MATH 193A,A04,083782,Rotar; Vladimir,8,0,34,26
1657327070854,MATH 193A,A05,093482,Rotar; Vladimir,9,0,34,25
1657327076880,MATH 197,001,091859,McAuley; Julian John,9999,0,9999,0
1657327076880,MATH 197,002,095566,Kedlaya; Kiran S.,9997,0,9999,2
1657327076880,MATH 197,003,095567,Xiao; Ming,9999,0,9999,0
1657327076880,MATH 197,004,095571,Perols; Johan Lars,9998,0,9999,1
1657327083941,COGS 9,A01,083615,Shannon; Kyle Michael,8,0,75,67
1657327089962,COGS 11,A01,083617,Boyle; Mary E. T.,22,0,48,26
1657327095985,COGS 13,A01,083071,Bastos; Amalia Pinkusfeld,11,0,71,60
1657327102007,COGS 14A,A01,092681,Semenuks; Arturs,3,1,100,97
1657327108031,COGS 14B,A01,083073,Cheng; Tzu-Han,6,0,63,57
1657327114056,COGS 17,A01,092677,Semenuks; Arturs,6,0,81,75
1657327120080,COGS 100,A01,083619,Allen; Michael Gordon,16,0,70,54
1657327126103,COGS 101A,A01,083621,Davis; Joshua Daniel,9,0,68,59
1657327132136,COGS 101B,A01,091572,Allen; Michael Gordon,11,0,65,54
1657327138162,COGS 101C,A01,083625,Delgado; Tania,17,0,35,18
1657327144185,COGS 107A,A01,083627,Boyle; Mary E. T.,13,0,60,47
1657327150207,COGS 118A,A01,083075,Gupta; Anjum,19,0,76,57
1657327156230,CSE 3,A50,083646,Miranda; Gregory Joseph,24,0,50,26
1657327162251,CSE 8A,A50,083650,Miranda; Gregory Joseph,17,1,56,39
1657327168273,CSE 11,A01,083080,Cao; Yingjun,6,15,40,34
1657327174295,CSE 12,A01,083652,Krause-Levy; Sophia Louisa,28,1,120,92
1657327180317,CSE 15L,A01,083654,Morris; Justin Loren,9,0,50,41
1657327180317,CSE 15L,A02,083655,Morris; Justin Loren,9,0,50,41
1657327186343,CSE 20,A01,083657,Tran; Khoa Dang,38,0,80,42
1657327192366,CSE 21,A01,095574,Bach; Quang Tran,22,0,48,26
1657327198406,CSE 30,A01,083084,Eldon; John,4,0,80,76
1657327198406,CSE 30,B01,095061,Bhaskar; Nishant,9,0,50,41
1657327204431,CSE 100,A01,083659,Cao; Yingjun,4,4,70,66
1657327210457,CSE 134B,A01,083661,Powell; Thomas Allan,22,0,100,78
1657327216478,CSE 140,A01,083663,Gungor; Onat,14,0,85,71
1657327222500,CSE 140L,A01,083088,Eldon; John,21,0,100,79
1657327228523,CSE 175,A01,083665,Kumar; Rakesh,3,0,25,22
1657327234547,CSE 190,A00,092507,Dubnov; Shlomo,7,0,20,13
1657327240569,ECE 45,A01,083139,Congero; Spencer William,6,0,75,69
1657327246594,ECE 65,A50,083695,Saad; Andrew S,12,0,30,18
1657327246594,ECE 65,A51,095125,Saad; Andrew S,24,0,26,2
1657327252621,ECE 109,A01,091882,Touri; Behrouz,19,0,70,51
1657327258647,ECE 180,A00,083140,Abi Samra; Nicholas Camill,1,0,30,29
1657327258647,ECE 180,B00,083141,Abi Samra; Nicholas Camill,0,0,30,30
1657327264674,MATH 10A,A01,083735,Patchell; Gregory David,2,0,30,28
1657327264674,MATH 10A,A02,083736,Patchell; Gregory David,20,0,30,10
1657327264674,MATH 10A,A03,083737,Patchell; Gregory David,16,0,30,14
1657327270696,MATH 10B,A01,083207,Lim; Seonhee,7,0,34,27
1657327270696,MATH 10B,A02,083208,Lim; Seonhee,9,0,35,26
1657327270696,MATH 10B,A03,093472,Lim; Seonhee,7,0,34,27
1657327270696,MATH 10B,B01,083739,Sinha; Shubham,12,0,30,18
1657327276810,MATH 18,A01,083743,Cinel; Cameron Alexander,6,0,30,24
1657327276810,MATH 18,A02,083744,Cinel; Cameron Alexander,17,0,30,13
1657327276810,MATH 18,A03,083745,Cinel; Cameron Alexander,9,0,30,21
1657327276810,MATH 18,B01,083748,Rideout; David Porter,4,0,37,33
1657327276810,MATH 18,B02,083749,Rideout; David Porter,5,0,36,31
1657327276810,MATH 18,B03,083750,Rideout; David Porter,3,0,37,34
1657327276810,MATH 18,B04,083751,Rideout; David Porter,6,0,36,30
1657327276810,MATH 18,B05,093473,Rideout; David Porter,6,0,36,30
1657327276810,MATH 18,B06,093474,Rideout; David Porter,6,0,36,30
1657327282833,MATH 20A,A01,083754,Zheng; Zequn,14,0,40,26
1657327288856,MATH 20B,A01,083756,Briones; Jor-el Thomas Caparas,4,0,36,32
1657327288856,MATH 20B,A02,083757,Briones; Jor-el Thomas Caparas,1,0,36,35
1657327288856,MATH 20B,A03,093475,Briones; Jor-el Thomas Caparas,2,0,36,34
1657327294879,MATH 20C,A01,083760,Briones; Jor-el Thomas Caparas,1,0,35,34
1657327294879,MATH 20C,A02,083761,Briones; Jor-el Thomas Caparas,8,0,35,27
1657327294879,MATH 20C,A03,093476,Briones; Jor-el Thomas Caparas,0,1,36,36
1657327294879,MATH 20C,B01,083762,Bach; Quang Tran,1,0,30,29
1657327300901,MATH 20D,A01,083765,Tran; Brian Kha,5,0,30,25
1657327300901,MATH 20D,A02,083766,Tran; Brian Kha,5,0,30,25
1657327300901,MATH 20D,A03,083767,Tran; Brian Kha,4,0,30,26
1657327306924,MATH 20E,A01,083771,Ganguly; Soumya,7,0,32,25
1657327306924,MATH 20E,A02,083772,Ganguly; Soumya,6,0,32,26
1657327306924,MATH 20E,B01,083773,Ciotti; Benjamin,20,0,35,15
1657327306924,MATH 20E,B02,083774,Ciotti; Benjamin,17,0,35,18
1657327312946,MATH 103A,A01,083777,Greenfeld; Be'Eri,3,0,36,33
1657327312946,MATH 103A,A02,083778,Greenfeld; Be'Eri,5,0,36,31
1657327312946,MATH 103A,A03,093561,Greenfeld; Be'Eri,4,0,36,32
1657327312946,MATH 103A,B01,083779,Greenfeld; Be'Eri,6,0,36,30
1657327312946,MATH 103A,B02,083780,Greenfeld; Be'Eri,4,0,36,32
1657327312946,MATH 103A,B03,093562,Greenfeld; Be'Eri,3,0,36,33
1657327318969,MATH 105,A01,085443,Carter; Anne Toulson,15,0,35,20
1657327318969,MATH 105,A02,093477,Carter; Anne Toulson,20,0,35,15
1657327324995,MATH 109,A01,083213,Ganzberger; Geoffrey Michael,2,0,34,32
1657327324995,MATH 109,A02,083214,Ganzberger; Geoffrey Michael,4,0,34,30
1657327324995,MATH 109,A03,093478,Ganzberger; Geoffrey Michael,2,0,34,32
1657327324995,MATH 109,B01,083215,Ganzberger; Geoffrey Michael,1,0,32,31
1657327324995,MATH 109,B02,083216,Ganzberger; Geoffrey Michael,1,0,32,31
1657327324995,MATH 109,B03,093479,Ganzberger; Geoffrey Michael,8,0,32,24
1657327331024,MATH 142A,A01,083219,Chow; Bennett,7,0,32,25
1657327331024,MATH 142A,A02,083220,Chow; Bennett,10,0,32,22
1657327331024,MATH 142A,A03,093480,Chow; Bennett,7,0,32,25
1657327331024,MATH 142A,B03,093481,Chow; Bennett,8,0,32,24
1657327331024,MATH 142A,B04,093558,Chow; Bennett,13,0,32,19
1657327331024,MATH 142A,B05,093559,Chow; Bennett,6,0,32,26
1657327337050,MATH 193A,A01,083224,Rotar; Vladimir,7,0,34,27
1657327337050,MATH 193A,A02,083225,Rotar; Vladimir,7,0,34,27
1657327337050,MATH 193A,A03,083781,Rotar; Vladimir,3,0,34,31
1657327337050,MATH 193A,A04,083782,Rotar; Vladimir,8,0,34,26
1657327337050,MATH 193A,A05,093482,Rotar; Vladimir,9,0,34,25
1657327343075,MATH 197,001,091859,McAuley; Julian John,9999,0,9999,0
1657327343075,MATH 197,002,095566,Kedlaya; Kiran S.,9997,0,9999,2
1657327343075,MATH 197,003,095567,Xiao; Ming,9999,0,9999,0
1657327343075,MATH 197,004,095571,Perols; Johan Lars,9998,0,9999,1
1657327350166,COGS 9,A01,083615,Shannon; Kyle Michael,8,0,75,67
1657327356188,COGS 11,A01,083617,Boyle; Mary E. T.,22,0,48,26
1657327362211,COGS 13,A01,083071,Bastos; Amalia Pinkusfeld,11,0,71,60
1657327368238,COGS 14A,A01,092681,Semenuks; Arturs,3,1,100,97
1657327374261,COGS 14B,A01,083073,Cheng; Tzu-Han,6,0,63,57
1657327380288,COGS 17,A01,092677,Semenuks; Arturs,6,0,81,75
1657327386315,COGS 100,A01,083619,Allen; Michael Gordon,16,0,70,54
1657327392343,COGS 101A,A01,083621,Davis; Joshua Daniel,9,0,68,59
1657327398369,COGS 101B,A01,091572,Allen; Michael Gordon,11,0,65,54
1657327404396,COGS 101C,A01,083625,Delgado; Tania,17,0,35,18
1657327410417,COGS 107A,A01,083627,Boyle; Mary E. T.,13,0,60,47
1657327416440,COGS 118A,A01,083075,Gupta; Anjum,19,0,76,57
1657327422468,CSE 3,A50,083646,Miranda; Gregory Joseph,24,0,50,26
1657327428490,CSE 8A,A50,083650,Miranda; Gregory Joseph,17,1,56,39
1657327434517,CSE 11,A01,083080,Cao; Yingjun,6,15,40,34
1657327440540,CSE 12,A01,083652,Krause-Levy; Sophia Louisa,28,1,120,92
1657327446565,CSE 15L,A01,083654,Morris; Justin Loren,9,0,50,41
1657327446565,CSE 15L,A02,083655,Morris; Justin Loren,9,0,50,41
1657327452587,CSE 20,A01,083657,Tran; Khoa Dang,38,0,80,42
1657327458614,CSE 21,A01,095574,Bach; Quang Tran,22,0,48,26
1657327464640,CSE 30,A01,083084,Eldon; John,4,0,80,76
1657327464640,CSE 30,B01,095061,Bhaskar; Nishant,9,0,50,41
1657327470666,CSE 100,A01,083659,Cao; Yingjun,4,4,70,66
1657327476692,CSE 134B,A01,083661,Powell; Thomas Allan,22,0,100,78
1657327482715,CSE 140,A01,083663,Gungor; Onat,14,0,85,71
1657327488749,CSE 140L,A01,083088,Eldon; John,21,0,100,79
1657327494781,CSE 175,A01,083665,Kumar; Rakesh,3,0,25,22
1657327500803,CSE 190,A00,092507,Dubnov; Shlomo,7,0,20,13
1657327506829,ECE 45,A01,083139,Congero; Spencer William,6,0,75,69
1657327512866,ECE 65,A50,083695,Saad; Andrew S,12,0,30,18
1657327512866,ECE 65,A51,095125,Saad; Andrew S,24,0,26,2
1657327518889,ECE 109,A01,091882,Touri; Behrouz,19,0,70,51
1657327524911,ECE 180,A00,083140,Abi Samra; Nicholas Camill,1,0,30,29
1657327524911,ECE 180,B00,083141,Abi Samra; Nicholas Camill,0,0,30,30
1657327530939,MATH 10A,A01,083735,Patchell; Gregory David,2,0,30,28
1657327530939,MATH 10A,A02,083736,Patchell; Gregory David,20,0,30,10
1657327530939,MATH 10A,A03,083737,Patchell; Gregory David,16,0,30,14
1657327536978,MATH 10B,A01,083207,Lim; Seonhee,7,0,34,27
1657327536978,MATH 10B,A02,083208,Lim; Seonhee,9,0,35,26
1657327536978,MATH 10B,A03,093472,Lim; Seonhee,7,0,34,27
1657327536978,MATH 10B,B01,083739,Sinha; Shubham,12,0,30,18
1657327543011,MATH 18,A01,083743,Cinel; Cameron Alexander,6,0,30,24
1657327543011,MATH 18,A02,083744,Cinel; Cameron Alexander,17,0,30,13
1657327543011,MATH 18,A03,083745,Cinel; Cameron Alexander,9,0,30,21
1657327543011,MATH 18,B01,083748,Rideout; David Porter,4,0,37,33
1657327543011,MATH 18,B02,083749,Rideout; David Porter,5,0,36,31
1657327543011,MATH 18,B03,083750,Rideout; David Porter,3,0,37,34
1657327543011,MATH 18,B04,083751,Rideout; David Porter,6,0,36,30
1657327543011,MATH 18,B05,093473,Rideout; David Porter,6,0,36,30
1657327543011,MATH 18,B06,093474,Rideout; David Porter,6,0,36,30
1657327549037,MATH 20A,A01,083754,Zheng; Zequn,14,0,40,26
1657327555060,MATH 20B,A01,083756,Briones; Jor-el Thomas Caparas,4,0,36,32
1657327555060,MATH 20B,A02,083757,Briones; Jor-el Thomas Caparas,1,0,36,35
1657327555060,MATH 20B,A03,093475,Briones; Jor-el Thomas Caparas,2,0,36,34
1657327561090,MATH 20C,A01,083760,Briones; Jor-el Thomas Caparas,1,0,35,34
1657327561090,MATH 20C,A02,083761,Briones; Jor-el Thomas Caparas,8,0,35,27
1657327561090,MATH 20C,A03,093476,Briones; Jor-el Thomas Caparas,0,1,36,36
1657327561090,MATH 20C,B01,083762,Bach; Quang Tran,1,0,30,29
1657327567117,MATH 20D,A01,083765,Tran; Brian Kha,5,0,30,25
1657327567117,MATH 20D,A02,083766,Tran; Brian Kha,5,0,30,25
1657327567117,MATH 20D,A03,083767,Tran; Brian Kha,4,0,30,26
1657327573150,MATH 20E,A01,083771,Ganguly; Soumya,7,0,32,25
1657327573150,MATH 20E,A02,083772,Ganguly; Soumya,6,0,32,26
1657327573150,MATH 20E,B01,083773,Ciotti; Benjamin,20,0,35,15
1657327573150,MATH 20E,B02,083774,Ciotti; Benjamin,17,0,35,18
1657327579178,MATH 103A,A01,083777,Greenfeld; Be'Eri,3,0,36,33
1657327579178,MATH 103A,A02,083778,Greenfeld; Be'Eri,5,0,36,31
1657327579178,MATH 103A,A03,093561,Greenfeld; Be'Eri,4,0,36,32
1657327579178,MATH 103A,B01,083779,Greenfeld; Be'Eri,6,0,36,30
1657327579178,MATH 103A,B02,083780,Greenfeld; Be'Eri,4,0,36,32
1657327579178,MATH 103A,B03,093562,Greenfeld; Be'Eri,3,0,36,33
1657327585211,MATH 105,A01,085443,Carter; Anne Toulson,15,0,35,20
1657327585211,MATH 105,A02,093477,Carter; Anne Toulson,20,0,35,15
1657327591235,MATH 109,A01,083213,Ganzberger; Geoffrey Michael,2,0,34,32
1657327591235,MATH 109,A02,083214,Ganzberger; Geoffrey Michael,4,0,34,30
1657327591235,MATH 109,A03,093478,Ganzberger; Geoffrey Michael,2,0,34,32
1657327591235,MATH 109,B01,083215,Ganzberger; Geoffrey Michael,1,0,32,31
1657327591235,MATH 109,B02,083216,Ganzberger; Geoffrey Michael,1,0,32,31
1657327591235,MATH 109,B03,093479,Ganzberger; Geoffrey Michael,8,0,32,24
1657327597261,MATH 142A,A01,083219,Chow; Bennett,7,0,32,25
1657327597261,MATH 142A,A02,083220,Chow; Bennett,10,0,32,22
1657327597261,MATH 142A,A03,093480,Chow; Bennett,7,0,32,25
1657327597261,MATH 142A,B03,093481,Chow; Bennett,8,0,32,24
1657327597261,MATH 142A,B04,093558,Chow; Bennett,13,0,32,19
1657327597261,MATH 142A,B05,093559,Chow; Bennett,6,0,32,26
1657327603283,MATH 193A,A01,083224,Rotar; Vladimir,7,0,34,27
1657327603283,MATH 193A,A02,083225,Rotar; Vladimir,7,0,34,27
1657327603283,MATH 193A,A03,083781,Rotar; Vladimir,3,0,34,31
1657327603283,MATH 193A,A04,083782,Rotar; Vladimir,8,0,34,26
1657327603283,MATH 193A,A05,093482,Rotar; Vladimir,9,0,34,25
1657327609310,MATH 197,001,091859,McAuley; Julian John,9999,0,9999,0
1657327609310,MATH 197,002,095566,Kedlaya; Kiran S.,9997,0,9999,2
1657327609310,MATH 197,003,095567,Xiao; Ming,9999,0,9999,0
1657327609310,MATH 197,004,095571,Perols; Johan Lars,9998,0,9999,1
1657327616372,COGS 9,A01,083615,Shannon; Kyle Michael,8,0,75,67
1657327622395,COGS 11,A01,083617,Boyle; Mary E. T.,22,0,48,26
1657327628435,COGS 13,A01,083071,Bastos; Amalia Pinkusfeld,11,0,71,60
1657327634461,COGS 14A,A01,092681,Semenuks; Arturs,3,1,100,97
1657327640492,COGS 14B,A01,083073,Cheng; Tzu-Han,6,0,63,57
1657327646517,COGS 17,A01,092677,Semenuks; Arturs,6,0,81,75
1657327652540,COGS 100,A01,083619,Allen; Michael Gordon,16,0,70,54
1657327658563,COGS 101A,A01,083621,Davis; Joshua Daniel,9,0,68,59
1657327664590,COGS 101B,A01,091572,Allen; Michael Gordon,11,0,65,54
1657327670616,COGS 101C,A01,083625,Delgado; Tania,17,0,35,18
1657327676639,COGS 107A,A01,083627,Boyle; Mary E. T.,13,0,60,47
1657327682662,COGS 118A,A01,083075,Gupta; Anjum,19,0,76,57
1657327688690,CSE 3,A50,083646,Miranda; Gregory Joseph,24,0,50,26
1657327694713,CSE 8A,A50,083650,Miranda; Gregory Joseph,17,1,56,39
1657327700736,CSE 11,A01,083080,Cao; Yingjun,6,15,40,34
1657327706758,CSE 12,A01,083652,Krause-Levy; Sophia Louisa,28,1,120,92
1657327712787,CSE 15L,A01,083654,Morris; Justin Loren,9,0,50,41
1657327712787,CSE 15L,A02,083655,Morris; Justin Loren,9,0,50,41
1657327718811,CSE 20,A01,083657,Tran; Khoa Dang,38,0,80,42
1657327724844,CSE 21,A01,095574,Bach; Quang Tran,22,0,48,26
1657327730867,CSE 30,A01,083084,Eldon; John,4,0,80,76
1657327730867,CSE 30,B01,095061,Bhaskar; Nishant,9,0,50,41
1657327736892,CSE 100,A01,083659,Cao; Yingjun,4,4,70,66
1657327742921,CSE 134B,A01,083661,Powell; Thomas Allan,22,0,100,78
1657327748942,CSE 140,A01,083663,Gungor; Onat,14,0,85,71
1657327754969,CSE 140L,A01,083088,Eldon; John,21,0,100,79
1657327760994,CSE 175,A01,083665,Kumar; Rakesh,3,0,25,22
1657327767017,CSE 190,A00,092507,Dubnov; Shlomo,7,0,20,13
1657327773041,ECE 45,A01,083139,Congero; Spencer William,6,0,75,69
1657327779064,ECE 65,A50,083695,Saad; Andrew S,12,0,30,18
1657327779064,ECE 65,A51,095125,Saad; Andrew S,24,0,26,2
1657327785091,ECE 109,A01,091882,Touri; Behrouz,19,0,70,51
1657327791117,ECE 180,A00,083140,Abi Samra; Nicholas Camill,1,0,30,29
1657327791117,ECE 180,B00,083141,Abi Samra; Nicholas Camill,0,0,30,30
1657327797143,MATH 10A,A01,083735,Patchell; Gregory David,2,0,30,28
1657327797143,MATH 10A,A02,083736,Patchell; Gregory David,20,0,30,10
1657327797143,MATH 10A,A03,083737,Patchell; Gregory David,16,0,30,14
1657327803173,MATH 10B,A01,083207,Lim; Seonhee,7,0,34,27
1657327803173,MATH 10B,A02,083208,Lim; Seonhee,9,0,35,26
1657327803173,MATH 10B,A03,093472,Lim; Seonhee,7,0,34,27
1657327803173,MATH 10B,B01,083739,Sinha; Shubham,12,0,30,18
1657327809197,MATH 18,A01,083743,Cinel; Cameron Alexander,6,0,30,24
1657327809197,MATH 18,A02,083744,Cinel; Cameron Alexander,17,0,30,13
1657327809197,MATH 18,A03,083745,Cinel; Cameron Alexander,9,0,30,21
1657327809197,MATH 18,B01,083748,Rideout; David Porter,4,0,37,33
1657327809197,MATH 18,B02,083749,Rideout; David Porter,5,0,36,31
1657327809197,MATH 18,B03,083750,Rideout; David Porter,3,0,37,34
1657327809197,MATH 18,B04,083751,Rideout; David Porter,6,0,36,30
1657327809197,MATH 18,B05,093473,Rideout; David Porter,6,0,36,30
1657327809197,MATH 18,B06,093474,Rideout; David Porter,6,0,36,30
1657327815223,MATH 20A,A01,083754,Zheng; Zequn,14,0,40,26
1657327821247,MATH 20B,A01,083756,Briones; Jor-el Thomas Caparas,4,0,36,32
1657327821247,MATH 20B,A02,083757,Briones; Jor-el Thomas Caparas,1,0,36,35
1657327821247,MATH 20B,A03,093475,Briones; Jor-el Thomas Caparas,2,0,36,34
1657327827276,MATH 20C,A01,083760,Briones; Jor-el Thomas Caparas,1,0,35,34
1657327827276,MATH 20C,A02,083761,Briones; Jor-el Thomas Caparas,8,0,35,27
1657327827276,MATH 20C,A03,093476,Briones; Jor-el Thomas Caparas,0,1,36,36
1657327827276,MATH 20C,B01,083762,Bach; Quang Tran,1,0,30,29
1657327833301,MATH 20D,A01,083765,Tran; Brian Kha,5,0,30,25
1657327833301,MATH 20D,A02,083766,Tran; Brian Kha,5,0,30,25
1657327833301,MATH 20D,A03,083767,Tran; Brian Kha,4,0,30,26
1657327839326,MATH 20E,A01,083771,Ganguly; Soumya,7,0,32,25
1657327839326,MATH 20E,A02,083772,Ganguly; Soumya,6,0,32,26
1657327839326,MATH 20E,B01,083773,Ciotti; Benjamin,20,0,35,15
1657327839326,MATH 20E,B02,083774,Ciotti; Benjamin,17,0,35,18
1657327845357,MATH 103A,A01,083777,Greenfeld; Be'Eri,3,0,36,33
1657327845357,MATH 103A,A02,083778,Greenfeld; Be'Eri,5,0,36,31
1657327845357,MATH 103A,A03,093561,Greenfeld; Be'Eri,4,0,36,32
1657327845357,MATH 103A,B01,083779,Greenfeld; Be'Eri,6,0,36,30
1657327845357,MATH 103A,B02,083780,Greenfeld; Be'Eri,4,0,36,32
1657327845357,MATH 103A,B03,093562,Greenfeld; Be'Eri,3,0,36,33
1657327851383,MATH 105,A01,085443,Carter; Anne Toulson,15,0,35,20
1657327851383,MATH 105,A02,093477,Carter; Anne Toulson,20,0,35,15
1657327857408,MATH 109,A01,083213,Ganzberger; Geoffrey Michael,2,0,34,32
1657327857408,MATH 109,A02,083214,Ganzberger; Geoffrey Michael,4,0,34,30
1657327857408,MATH 109,A03,093478,Ganzberger; Geoffrey Michael,2,0,34,32
1657327857408,MATH 109,B01,083215,Ganzberger; Geoffrey Michael,1,0,32,31
1657327857408,MATH 109,B02,083216,Ganzberger; Geoffrey Michael,1,0,32,31
1657327857408,MATH 109,B03,093479,Ganzberger; Geoffrey Michael,8,0,32,24
1657327863439,MATH 142A,A01,083219,Chow; Bennett,7,0,32,25
1657327863439,MATH 142A,A02,083220,Chow; Bennett,10,0,32,22
1657327863439,MATH 142A,A03,093480,Chow; Bennett,7,0,32,25
1657327863439,MATH 142A,B03,093481,Chow; Bennett,8,0,32,24
1657327863439,MATH 142A,B04,093558,Chow; Bennett,13,0,32,19
1657327863439,MATH 142A,B05,093559,Chow; Bennett,6,0,32,26
1657327869464,MATH 193A,A01,083224,Rotar; Vladimir,7,0,34,27
1657327869464,MATH 193A,A02,083225,Rotar; Vladimir,7,0,34,27
1657327869464,MATH 193A,A03,083781,Rotar; Vladimir,3,0,34,31
1657327869464,MATH 193A,A04,083782,Rotar; Vladimir,8,0,34,26
1657327869464,MATH 193A,A05,093482,Rotar; Vladimir,9,0,34,25
1657327875560,MATH 197,001,091859,McAuley; Julian John,9999,0,9999,0
1657327875560,MATH 197,002,095566,Kedlaya; Kiran S.,9997,0,9999,2
1657327875560,MATH 197,003,095567,Xiao; Ming,9999,0,9999,0
1657327875560,MATH 197,004,095571,Perols; Johan Lars,9998,0,9999,1
1657327882620,COGS 9,A01,083615,Shannon; Kyle Michael,8,0,75,67
1657327888660,COGS 11,A01,083617,Boyle; Mary E. T.,22,0,48,26
1657327894685,COGS 13,A01,083071,Bastos; Amalia Pinkusfeld,11,0,71,60
1657327900708,COGS 14A,A01,092681,Semenuks; Arturs,3,1,100,97
1657327906734,COGS 14B,A01,083073,Cheng; Tzu-Han,6,0,63,57
1657327912757,COGS 17,A01,092677,Semenuks; Arturs,6,0,81,75
1657327918782,COGS 100,A01,083619,Allen; Michael Gordon,16,0,70,54
1657327924808,COGS 101A,A01,083621,Davis; Joshua Daniel,9,0,68,59
1657327930836,COGS 101B,A01,091572,Allen; Michael Gordon,11,0,65,54
1657327936863,COGS 101C,A01,083625,Delgado; Tania,17,0,35,18
1657327942886,COGS 107A,A01,083627,Boyle; Mary E. T.,13,0,60,47
1657327948909,COGS 118A,A01,083075,Gupta; Anjum,19,0,76,57
1657327954933,CSE 3,A50,083646,Miranda; Gregory Joseph,24,0,50,26
1657327960956,CSE 8A,A50,083650,Miranda; Gregory Joseph,17,1,56,39
1657327966978,CSE 11,A01,083080,Cao; Yingjun,6,15,40,34
1657327973002,CSE 12,A01,083652,Krause-Levy; Sophia Louisa,28,1,120,92
1657327979028,CSE 15L,A01,083654,Morris; Justin Loren,9,0,50,41
1657327979028,CSE 15L,A02,083655,Morris; Justin Loren,9,0,50,41
1657327985053,CSE 20,A01,083657,Tran; Khoa Dang,39,0,80,41
1657327991088,CSE 21,A01,095574,Bach; Quang Tran,22,0,48,26
1657327997111,CSE 30,A01,083084,Eldon; John,4,0,80,76
1657327997111,CSE 30,B01,095061,Bhaskar; Nishant,9,0,50,41
1657328003136,CSE 100,A01,083659,Cao; Yingjun,4,4,70,66
1657328009166,CSE 134B,A01,083661,Powell; Thomas Allan,22,0,100,78
1657328015188,CSE 140,A01,083663,Gungor; Onat,14,0,85,71
1657328021217,CSE 140L,A01,083088,Eldon; John,21,0,100,79
1657328027243,CSE 175,A01,083665,Kumar; Rakesh,3,0,25,22
1657328033270,CSE 190,A00,092507,Dubnov; Shlomo,7,0,20,13
1657328039302,ECE 45,A01,083139,Congero; Spencer William,6,0,75,69
1657328045342,ECE 65,A50,083695,Saad; Andrew S,12,0,30,18
1657328045342,ECE 65,A51,095125,Saad; Andrew S,24,0,26,2
1657328051369,ECE 109,A01,091882,Touri; Behrouz,19,0,70,51
1657328057392,ECE 180,A00,083140,Abi Samra; Nicholas Camill,1,0,30,29
1657328057392,ECE 180,B00,083141,Abi Samra; Nicholas Camill,0,0,30,30
1657328063421,MATH 10A,A01,083735,Patchell; Gregory David,2,0,30,28
1657328063421,MATH 10A,A02,083736,Patchell; Gregory David,20,0,30,10
1657328063421,MATH 10A,A03,083737,Patchell; Gregory David,16,0,30,14
1657328069450,MATH 10B,A01,083207,Lim; Seonhee,7,0,34,27
1657328069450,MATH 10B,A02,083208,Lim; Seonhee,9,0,35,26
1657328069450,MATH 10B,A03,093472,Lim; Seonhee,7,0,34,27
1657328069450,MATH 10B,B01,083739,Sinha; Shubham,12,0,30,18
1657328075479,MATH 18,A01,083743,Cinel; Cameron Alexander,6,0,30,24
1657328075479,MATH 18,A02,083744,Cinel; Cameron Alexander,17,0,30,13
1657328075479,MATH 18,A03,083745,Cinel; Cameron Alexander,9,0,30,21
1657328075479,MATH 18,B01,083748,Rideout; David Porter,4,0,37,33
1657328075479,MATH 18,B02,083749,Rideout; David Porter,5,0,36,31
1657328075479,MATH 18,B03,083750,Rideout; David Porter,3,0,37,34
1657328075479,MATH 18,B04,083751,Rideout; David Porter,6,0,36,30
1657328075479,MATH 18,B05,093473,Rideout; David Porter,6,0,36,30
1657328075479,MATH 18,B06,093474,Rideout; David Porter,6,0,36,30
1657328081503,MATH 20A,A01,083754,Zheng; Zequn,14,0,40,26
1657328087526,MATH 20B,A01,083756,Briones; Jor-el Thomas Caparas,4,0,36,32
1657328087526,MATH 20B,A02,083757,Briones; Jor-el Thomas Caparas,1,0,36,35
1657328087526,MATH 20B,A03,093475,Briones; Jor-el Thomas Caparas,2,0,36,34
1657328093554,MATH 20C,A01,083760,Briones; Jor-el Thomas Caparas,1,0,35,34
1657328093554,MATH 20C,A02,083761,Briones; Jor-el Thomas Caparas,8,0,35,27
1657328093554,MATH 20C,A03,093476,Briones; Jor-el Thomas Caparas,0,1,36,36
1657328093554,MATH 20C,B01,083762,Bach; Quang Tran,1,0,30,29
1657328099576,MATH 20D,A01,083765,Tran; Brian Kha,5,0,30,25
1657328099576,MATH 20D,A02,083766,Tran; Brian Kha,5,0,30,25
1657328099576,MATH 20D,A03,083767,Tran; Brian Kha,4,0,30,26
1657328105600,MATH 20E,A01,083771,Ganguly; Soumya,7,0,32,25
1657328105600,MATH 20E,A02,083772,Ganguly; Soumya,6,0,32,26
1657328105600,MATH 20E,B01,083773,Ciotti; Benjamin,20,0,35,15
1657328105600,MATH 20E,B02,083774,Ciotti; Benjamin,17,0,35,18
1657328111643,MATH 103A,A01,083777,Greenfeld; Be'Eri,3,0,36,33
1657328111643,MATH 103A,A02,083778,Greenfeld; Be'Eri,5,0,36,31
1657328111643,MATH 103A,A03,093561,Greenfeld; Be'Eri,4,0,36,32
1657328111643,MATH 103A,B01,083779,Greenfeld; Be'Eri,6,0,36,30
1657328111643,MATH 103A,B02,083780,Greenfeld; Be'Eri,4,0,36,32
1657328111643,MATH 103A,B03,093562,Greenfeld; Be'Eri,3,0,36,33
1657328117665,MATH 105,A01,085443,Carter; Anne Toulson,15,0,35,20
1657328117665,MATH 105,A02,093477,Carter; Anne Toulson,20,0,35,15
1657328123688,MATH 109,A01,083213,Ganzberger; Geoffrey Michael,2,0,34,32
1657328123688,MATH 109,A02,083214,Ganzberger; Geoffrey Michael,4,0,34,30
1657328123688,MATH 109,A03,093478,Ganzberger; Geoffrey Michael,2,0,34,32
1657328123688,MATH 109,B01,083215,Ganzberger; Geoffrey Michael,1,0,32,31
1657328123688,MATH 109,B02,083216,Ganzberger; Geoffrey Michael,1,0,32,31
1657328123688,MATH 109,B03,093479,Ganzberger; Geoffrey Michael,8,0,32,24
1657328129717,MATH 142A,A01,083219,Chow; Bennett,7,0,32,25
1657328129717,MATH 142A,A02,083220,Chow; Bennett,10,0,32,22
1657328129717,MATH 142A,A03,093480,Chow; Bennett,7,0,32,25
1657328129717,MATH 142A,B03,093481,Chow; Bennett,8,0,32,24
1657328129717,MATH 142A,B04,093558,Chow; Bennett,13,0,32,19
1657328129717,MATH 142A,B05,093559,Chow; Bennett,6,0,32,26
1657328135751,MATH 193A,A01,083224,Rotar; Vladimir,7,0,34,27
1657328135751,MATH 193A,A02,083225,Rotar; Vladimir,7,0,34,27
1657328135751,MATH 193A,A03,083781,Rotar; Vladimir,3,0,34,31
1657328135751,MATH 193A,A04,083782,Rotar; Vladimir,8,0,34,26
1657328135751,MATH 193A,A05,093482,Rotar; Vladimir,9,0,34,25
1657328141775,MATH 197,001,091859,McAuley; Julian John,9999,0,9999,0
1657328141775,MATH 197,002,095566,Kedlaya; Kiran S.,9997,0,9999,2
1657328141775,MATH 197,003,095567,Xiao; Ming,9999,0,9999,0
1657328141775,MATH 197,004,095571,Perols; Johan Lars,9998,0,9999,1
1657328148846,COGS 9,A01,083615,Shannon; Kyle Michael,8,0,75,67
1657328154871,COGS 11,A01,083617,Boyle; Mary E. T.,22,0,48,26
1657328160898,COGS 13,A01,083071,Bastos; Amalia Pinkusfeld,11,0,71,60
1657328166929,COGS 14A,A01,092681,Semenuks; Arturs,3,1,100,97
1657328172967,COGS 14B,A01,083073,Cheng; Tzu-Han,6,0,63,57
1657328178994,COGS 17,A01,092677,Semenuks; Arturs,6,0,81,75
1657328185017,COGS 100,A01,083619,Allen; Michael Gordon,16,0,70,54
1657328191041,COGS 101A,A01,083621,Davis; Joshua Daniel,9,0,68,59
1657328197066,COGS 101B,A01,091572,Allen; Michael Gordon,11,0,65,54
1657328203090,COGS 101C,A01,083625,Delgado; Tania,17,0,35,18
1657328209121,COGS 107A,A01,083627,Boyle; Mary E. T.,13,0,60,47
1657328215144,COGS 118A,A01,083075,Gupta; Anjum,19,0,76,57
1657328221181,CSE 3,A50,083646,Miranda; Gregory Joseph,24,0,50,26
1657328227204,CSE 8A,A50,083650,Miranda; Gregory Joseph,17,1,56,39
1657328233228,CSE 11,A01,083080,Cao; Yingjun,6,15,40,34
1657328239256,CSE 12,A01,083652,Krause-Levy; Sophia Louisa,28,1,120,92
1657328245291,CSE 15L,A01,083654,Morris; Justin Loren,9,0,50,41
1657328245291,CSE 15L,A02,083655,Morris; Justin Loren,9,0,50,41
1657328251314,CSE 20,A01,083657,Tran; Khoa Dang,39,0,80,41
1657328257343,CSE 21,A01,095574,Bach; Quang Tran,22,0,48,26
1657328263370,CSE 30,A01,083084,Eldon; John,4,0,80,76
1657328263370,CSE 30,B01,095061,Bhaskar; Nishant,9,0,50,41
1657328269392,CSE 100,A01,083659,Cao; Yingjun,4,4,70,66
1657328275418,CSE 134B,A01,083661,Powell; Thomas Allan,22,0,100,78
1657328281441,CSE 140,A01,083663,Gungor; Onat,14,0,85,71
1657328287466,CSE 140L,A01,083088,Eldon; John,21,0,100,79
1657328293487,CSE 175,A01,083665,Kumar; Rakesh,3,0,25,22
1657328299512,CSE 190,A00,092507,Dubnov; Shlomo,7,0,20,13
1657328305542,ECE 45,A01,083139,Congero; Spencer William,6,0,75,69
1657328311565,ECE 65,A50,083695,Saad; Andrew S,12,0,30,18
1657328311565,ECE 65,A51,095125,Saad; Andrew S,24,0,26,2
1657328317590,ECE 109,A01,091882,Touri; Behrouz,19,0,70,51
1657328323612,ECE 180,A00,083140,Abi Samra; Nicholas Camill,1,0,30,29
1657328323612,ECE 180,B00,083141,Abi Samra; Nicholas Camill,0,0,30,30
1657328329639,MATH 10A,A01,083735,Patchell; Gregory David,2,0,30,28
1657328329639,MATH 10A,A02,083736,Patchell; Gregory David,20,0,30,10
1657328329639,MATH 10A,A03,083737,Patchell; Gregory David,16,0,30,14
1657328335668,MATH 10B,A01,083207,Lim; Seonhee,7,0,34,27
1657328335668,MATH 10B,A02,083208,Lim; Seonhee,9,0,35,26
1657328335668,MATH 10B,A03,093472,Lim; Seonhee,7,0,34,27
1657328335668,MATH 10B,B01,083739,Sinha; Shubham,12,0,30,18
1657328341693,MATH 18,A01,083743,Cinel; Cameron Alexander,6,0,30,24
1657328341693,MATH 18,A02,083744,Cinel; Cameron Alexander,17,0,30,13
1657328341693,MATH 18,A03,083745,Cinel; Cameron Alexander,9,0,30,21
1657328341693,MATH 18,B01,083748,Rideout; David Porter,4,0,37,33
1657328341693,MATH 18,B02,083749,Rideout; David Porter,5,0,36,31
1657328341693,MATH 18,B03,083750,Rideout; David Porter,3,0,37,34
1657328341693,MATH 18,B04,083751,Rideout; David Porter,6,0,36,30
1657328341693,MATH 18,B05,093473,Rideout; David Porter,6,0,36,30
1657328341693,MATH 18,B06,093474,Rideout; David Porter,6,0,36,30
1657328347718,MATH 20A,A01,083754,Zheng; Zequn,14,0,40,26
1657328353741,MATH 20B,A01,083756,Briones; Jor-el Thomas Caparas,4,0,36,32
1657328353741,MATH 20B,A02,083757,Briones; Jor-el Thomas Caparas,1,0,36,35
1657328353741,MATH 20B,A03,093475,Briones; Jor-el Thomas Caparas,2,0,36,34
1657328359767,MATH 20C,A01,083760,Briones; Jor-el Thomas Caparas,1,0,35,34
1657328359767,MATH 20C,A02,083761,Briones; Jor-el Thomas Caparas,8,0,35,27
1657328359767,MATH 20C,A03,093476,Briones; Jor-el Thomas Caparas,0,1,36,36
1657328359767,MATH 20C,B01,083762,Bach; Quang Tran,1,0,30,29
1657328365790,MATH 20D,A01,083765,Tran; Brian Kha,5,0,30,25
1657328365790,MATH 20D,A02,083766,Tran; Brian Kha,5,0,30,25
1657328365790,MATH 20D,A03,083767,Tran; Brian Kha,4,0,30,26
1657328371813,MATH 20E,A01,083771,Ganguly; Soumya,7,0,32,25
1657328371813,MATH 20E,A02,083772,Ganguly; Soumya,6,0,32,26
1657328371813,MATH 20E,B01,083773,Ciotti; Benjamin,20,0,35,15
1657328371813,MATH 20E,B02,083774,Ciotti; Benjamin,17,0,35,18
1657328377842,MATH 103A,A01,083777,Greenfeld; Be'Eri,3,0,36,33
1657328377842,MATH 103A,A02,083778,Greenfeld; Be'Eri,5,0,36,31
1657328377842,MATH 103A,A03,093561,Greenfeld; Be'Eri,4,0,36,32
1657328377842,MATH 103A,B01,083779,Greenfeld; Be'Eri,6,0,36,30
1657328377842,MATH 103A,B02,083780,Greenfeld; Be'Eri,4,0,36,32
1657328377842,MATH 103A,B03,093562,Greenfeld; Be'Eri,3,0,36,33
1657328383865,MATH 105,A01,085443,Carter; Anne Toulson,15,0,35,20
1657328383865,MATH 105,A02,093477,Carter; Anne Toulson,20,0,35,15
1657328389890,MATH 109,A01,083213,Ganzberger; Geoffrey Michael,2,0,34,32
1657328389890,MATH 109,A02,083214,Ganzberger; Geoffrey Michael,4,0,34,30
1657328389890,MATH 109,A03,093478,Ganzberger; Geoffrey Michael,2,0,34,32
1657328389890,MATH 109,B01,083215,Ganzberger; Geoffrey Michael,1,0,32,31
1657328389890,MATH 109,B02,083216,Ganzberger; Geoffrey Michael,1,0,32,31
1657328389890,MATH 109,B03,093479,Ganzberger; Geoffrey Michael,8,0,32,24
1657328395926,MATH 142A,A01,083219,Chow; Bennett,7,0,32,25
1657328395926,MATH 142A,A02,083220,Chow; Bennett,10,0,32,22
1657328395926,MATH 142A,A03,093480,Chow; Bennett,7,0,32,25
1657328395926,MATH 142A,B03,093481,Chow; Bennett,8,0,32,24
1657328395926,MATH 142A,B04,093558,Chow; Bennett,13,0,32,19
1657328395926,MATH 142A,B05,093559,Chow; Bennett,6,0,32,26
1657328401954,MATH 193A,A01,083224,Rotar; Vladimir,7,0,34,27
1657328401954,MATH 193A,A02,083225,Rotar; Vladimir,7,0,34,27
1657328401954,MATH 193A,A03,083781,Rotar; Vladimir,3,0,34,31
1657328401954,MATH 193A,A04,083782,Rotar; Vladimir,8,0,34,26
1657328401954,MATH 193A,A05,093482,Rotar; Vladimir,9,0,34,25
1657328407982,MATH 197,001,091859,McAuley; Julian John,9999,0,9999,0
1657328407982,MATH 197,002,095566,Kedlaya; Kiran S.,9997,0,9999,2
1657328407982,MATH 197,003,095567,Xiao; Ming,9999,0,9999,0
1657328407982,MATH 197,004,095571,Perols; Johan Lars,9998,0,9999,1
1657328415044,COGS 9,A01,083615,Shannon; Kyle Michael,8,0,75,67
1657328421072,COGS 11,A01,083617,Boyle; Mary E. T.,22,0,48,26
1657328427095,COGS 13,A01,083071,Bastos; Amalia Pinkusfeld,11,0,71,60
1657328433123,COGS 14A,A01,092681,Semenuks; Arturs,3,1,100,97
1657328439161,COGS 14B,A01,083073,Cheng; Tzu-Han,6,0,63,57
1657328445184,COGS 17,A01,092677,Semenuks; Arturs,6,0,81,75
1657328451214,COGS 100,A01,083619,Allen; Michael Gordon,16,0,70,54
1657328457240,COGS 101A,A01,083621,Davis; Joshua Daniel,9,0,68,59
1657328463262,COGS 101B,A01,091572,Allen; Michael Gordon,11,0,65,54
1657328469374,COGS 101C,A01,083625,Delgado; Tania,17,0,35,18
1657328475398,COGS 107A,A01,083627,Boyle; Mary E. T.,13,0,60,47
1657328481425,COGS 118A,A01,083075,Gupta; Anjum,19,0,76,57
1657328487448,CSE 3,A50,083646,Miranda; Gregory Joseph,24,0,50,26
1657328493476,CSE 8A,A50,083650,Miranda; Gregory Joseph,17,1,56,39
1657328499499,CSE 11,A01,083080,Cao; Yingjun,6,15,40,34
1657328505521,CSE 12,A01,083652,Krause-Levy; Sophia Louisa,28,1,120,92
1657328511546,CSE 15L,A01,083654,Morris; Justin Loren,9,0,50,41
1657328511546,CSE 15L,A02,083655,Morris; Justin Loren,9,0,50,41
1657328517568,CSE 20,A01,083657,Tran; Khoa Dang,39,0,80,41
1657328523595,CSE 21,A01,095574,Bach; Quang Tran,22,0,48,26
1657328529622,CSE 30,A01,083084,Eldon; John,4,0,80,76
1657328529622,CSE 30,B01,095061,Bhaskar; Nishant,9,0,50,41
1657328535666,CSE 100,A01,083659,Cao; Yingjun,4,4,70,66
1657328541690,CSE 134B,A01,083661,Powell; Thomas Allan,22,0,100,78
1657328547717,CSE 140,A01,083663,Gungor; Onat,14,0,85,71
1657328553741,CSE 140L,A01,083088,Eldon; John,21,0,100,79
1657328559764,CSE 175,A01,083665,Kumar; Rakesh,3,0,25,22
1657328565787,CSE 190,A00,092507,Dubnov; Shlomo,7,0,20,13
1657328571811,ECE 45,A01,083139,Congero; Spencer William,6,0,75,69
1657328577838,ECE 65,A50,083695,Saad; Andrew S,12,0,30,18
1657328577838,ECE 65,A51,095125,Saad; Andrew S,24,0,26,2
1657328583866,ECE 109,A01,091882,Touri; Behrouz,19,0,70,51
1657328589892,ECE 180,A00,083140,Abi Samra; Nicholas Camill,1,0,30,29
1657328589892,ECE 180,B00,083141,Abi Samra; Nicholas Camill,0,0,30,30
1657328595921,MATH 10A,A01,083735,Patchell; Gregory David,2,0,30,28
1657328595921,MATH 10A,A02,083736,Patchell; Gregory David,20,0,30,10
1657328595921,MATH 10A,A03,083737,Patchell; Gregory David,16,0,30,14
1657328601943,MATH 10B,A01,083207,Lim; Seonhee,7,0,34,27
1657328601943,MATH 10B,A02,083208,Lim; Seonhee,9,0,35,26
1657328601943,MATH 10B,A03,093472,Lim; Seonhee,7,0,34,27
1657328601943,MATH 10B,B01,083739,Sinha; Shubham,12,0,30,18
1657328607968,MATH 18,A01,083743,Cinel; Cameron Alexander,6,0,30,24
1657328607968,MATH 18,A02,083744,Cinel; Cameron Alexander,17,0,30,13
1657328607968,MATH 18,A03,083745,Cinel; Cameron Alexander,9,0,30,21
1657328607968,MATH 18,B01,083748,Rideout; David Porter,4,0,37,33
1657328607968,MATH 18,B02,083749,Rideout; David Porter,5,0,36,31
1657328607968,MATH 18,B03,083750,Rideout; David Porter,3,0,37,34
1657328607968,MATH 18,B04,083751,Rideout; David Porter,6,0,36,30
1657328607968,MATH 18,B05,093473,Rideout; David Porter,6,0,36,30
1657328607968,MATH 18,B06,093474,Rideout; David Porter,6,0,36,30
1657328613990,MATH 20A,A01,083754,Zheng; Zequn,14,0,40,26
1657328620013,MATH 20B,A01,083756,Briones; Jor-el Thomas Caparas,4,0,36,32
1657328620013,MATH 20B,A02,083757,Briones; Jor-el Thomas Caparas,1,0,36,35
1657328620013,MATH 20B,A03,093475,Briones; Jor-el Thomas Caparas,2,0,36,34
1657328626049,MATH 20C,A01,083760,Briones; Jor-el Thomas Caparas,1,0,35,34
1657328626049,MATH 20C,A02,083761,Briones; Jor-el Thomas Caparas,8,0,35,27
1657328626049,MATH 20C,A03,093476,Briones; Jor-el Thomas Caparas,0,1,36,36
1657328626049,MATH 20C,B01,083762,Bach; Quang Tran,1,0,30,29
1657328632071,MATH 20D,A01,083765,Tran; Brian Kha,5,0,30,25
1657328632071,MATH 20D,A02,083766,Tran; Brian Kha,5,0,30,25
1657328632071,MATH 20D,A03,083767,Tran; Brian Kha,4,0,30,26
1657328638100,MATH 20E,A01,083771,Ganguly; Soumya,7,0,32,25
1657328638100,MATH 20E,A02,083772,Ganguly; Soumya,6,0,32,26
1657328638100,MATH 20E,B01,083773,Ciotti; Benjamin,20,0,35,15
1657328638100,MATH 20E,B02,083774,Ciotti; Benjamin,17,0,35,18
1657328644124,MATH 103A,A01,083777,Greenfeld; Be'Eri,3,0,36,33
1657328644124,MATH 103A,A02,083778,Greenfeld; Be'Eri,5,0,36,31
1657328644124,MATH 103A,A03,093561,Greenfeld; Be'Eri,4,0,36,32
1657328644124,MATH 103A,B01,083779,Greenfeld; Be'Eri,6,0,36,30
1657328644124,MATH 103A,B02,083780,Greenfeld; Be'Eri,4,0,36,32
1657328644124,MATH 103A,B03,093562,Greenfeld; Be'Eri,3,0,36,33
1657328650155,MATH 105,A01,085443,Carter; Anne Toulson,15,0,35,20
1657328650155,MATH 105,A02,093477,Carter; Anne Toulson,20,0,35,15
1657328656193,MATH 109,A01,083213,Ganzberger; Geoffrey Michael,2,0,34,32
1657328656193,MATH 109,A02,083214,Ganzberger; Geoffrey Michael,4,0,34,30
1657328656193,MATH 109,A03,093478,Ganzberger; Geoffrey Michael,2,0,34,32
1657328656193,MATH 109,B01,083215,Ganzberger; Geoffrey Michael,1,0,32,31
1657328656193,MATH 109,B02,083216,Ganzberger; Geoffrey Michael,1,0,32,31
1657328656193,MATH 109,B03,093479,Ganzberger; Geoffrey Michael,8,0,32,24
1657328662218,MATH 142A,A01,083219,Chow; Bennett,7,0,32,25
1657328662218,MATH 142A,A02,083220,Chow; Bennett,10,0,32,22
1657328662218,MATH 142A,A03,093480,Chow; Bennett,7,0,32,25
1657328662218,MATH 142A,B03,093481,Chow; Bennett,8,0,32,24
1657328662218,MATH 142A,B04,093558,Chow; Bennett,13,0,32,19
1657328662218,MATH 142A,B05,093559,Chow; Bennett,6,0,32,26
1657328668242,MATH 193A,A01,083224,Rotar; Vladimir,7,0,34,27
1657328668242,MATH 193A,A02,083225,Rotar; Vladimir,7,0,34,27
1657328668242,MATH 193A,A03,083781,Rotar; Vladimir,3,0,34,31
1657328668242,MATH 193A,A04,083782,Rotar; Vladimir,8,0,34,26
1657328668242,MATH 193A,A05,093482,Rotar; Vladimir,9,0,34,25
1657328674269,MATH 197,001,091859,McAuley; Julian John,9999,0,9999,0
1657328674269,MATH 197,002,095566,Kedlaya; Kiran S.,9997,0,9999,2
1657328674269,MATH 197,003,095567,Xiao; Ming,9999,0,9999,0
1657328674269,MATH 197,004,095571,Perols; Johan Lars,9998,0,9999,1
1657328681323,COGS 9,A01,083615,Shannon; Kyle Michael,8,0,75,67
1657328687345,COGS 11,A01,083617,Boyle; Mary E. T.,22,0,48,26
1657328693371,COGS 13,A01,083071,Bastos; Amalia Pinkusfeld,11,0,71,60
1657328699394,COGS 14A,A01,092681,Semenuks; Arturs,3,1,100,97
1657328705420,COGS 14B,A01,083073,Cheng; Tzu-Han,6,0,63,57
1657328711444,COGS 17,A01,092677,Semenuks; Arturs,6,0,81,75
1657328717467,COGS 100,A01,083619,Allen; Michael Gordon,16,0,70,54
1657328723488,COGS 101A,A01,083621,Davis; Joshua Daniel,9,0,68,59
1657328729512,COGS 101B,A01,091572,Allen; Michael Gordon,11,0,65,54
1657328735541,COGS 101C,A01,083625,Delgado; Tania,17,0,35,18
1657328741567,COGS 107A,A01,083627,Boyle; Mary E. T.,13,0,60,47
1657328747594,COGS 118A,A01,083075,Gupta; Anjum,19,0,76,57
1657328753623,CSE 3,A50,083646,Miranda; Gregory Joseph,24,0,50,26
1657328759650,CSE 8A,A50,083650,Miranda; Gregory Joseph,17,1,56,39
1657328765676,CSE 11,A01,083080,Cao; Yingjun,6,15,40,34
1657328771709,CSE 12,A01,083652,Krause-Levy; Sophia Louisa,28,1,120,92
1657328777735,CSE 15L,A01,083654,Morris; Justin Loren,9,0,50,41
1657328777735,CSE 15L,A02,083655,Morris; Justin Loren,9,0,50,41
1657328783759,CSE 20,A01,083657,Tran; Khoa Dang,39,0,80,41
1657328789781,CSE 21,A01,095574,Bach; Quang Tran,22,0,48,26
1657328795810,CSE 30,A01,083084,Eldon; John,4,0,80,76
1657328795810,CSE 30,B01,095061,Bhaskar; Nishant,9,0,50,41
1657328801833,CSE 100,A01,083659,Cao; Yingjun,4,4,70,66
1657328807860,CSE 134B,A01,083661,Powell; Thomas Allan,22,0,100,78
1657328813886,CSE 140,A01,083663,Gungor; Onat,14,0,85,71
1657328819910,CSE 140L,A01,083088,Eldon; John,21,0,100,79
1657328825935,CSE 175,A01,083665,Kumar; Rakesh,3,0,25,22
1657328831958,CSE 190,A00,092507,Dubnov; Shlomo,7,0,20,13
1657328837982,ECE 45,A01,083139,Congero; Spencer William,6,0,75,69
1657328844010,ECE 65,A50,083695,Saad; Andrew S,12,0,30,18
1657328844010,ECE 65,A51,095125,Saad; Andrew S,24,0,26,2
1657328850044,ECE 109,A01,091882,Touri; Behrouz,19,0,70,51
1657328856067,ECE 180,A00,083140,Abi Samra; Nicholas Camill,1,0,30,29
1657328856067,ECE 180,B00,083141,Abi Samra; Nicholas Camill,0,0,30,30
1657328862095,MATH 10A,A01,083735,Patchell; Gregory David,2,0,30,28
1657328862095,MATH 10A,A02,083736,Patchell; Gregory David,20,0,30,10
1657328862095,MATH 10A,A03,083737,Patchell; Gregory David,16,0,30,14
1657328868119,MATH 10B,A01,083207,Lim; Seonhee,7,0,34,27
1657328868119,MATH 10B,A02,083208,Lim; Seonhee,9,0,35,26
1657328868119,MATH 10B,A03,093472,Lim; Seonhee,7,0,34,27
1657328868119,MATH 10B,B01,083739,Sinha; Shubham,12,0,30,18
1657328874149,MATH 18,A01,083743,Cinel; Cameron Alexander,6,0,30,24
1657328874149,MATH 18,A02,083744,Cinel; Cameron Alexander,17,0,30,13
1657328874149,MATH 18,A03,083745,Cinel; Cameron Alexander,9,0,30,21
1657328874149,MATH 18,B01,083748,Rideout; David Porter,4,0,37,33
1657328874149,MATH 18,B02,083749,Rideout; David Porter,5,0,36,31
1657328874149,MATH 18,B03,083750,Rideout; David Porter,3,0,37,34
1657328874149,MATH 18,B04,083751,Rideout; David Porter,6,0,36,30
1657328874149,MATH 18,B05,093473,Rideout; David Porter,6,0,36,30
1657328874149,MATH 18,B06,093474,Rideout; David Porter,6,0,36,30
1657328880179,MATH 20A,A01,083754,Zheng; Zequn,14,0,40,26
1657328886227,MATH 20B,A01,083756,Briones; Jor-el Thomas Caparas,4,0,36,32
1657328886227,MATH 20B,A02,083757,Briones; Jor-el Thomas Caparas,1,0,36,35
1657328886227,MATH 20B,A03,093475,Briones; Jor-el Thomas Caparas,2,0,36,34
1657328892249,MATH 20C,A01,083760,Briones; Jor-el Thomas Caparas,1,0,35,34
1657328892249,MATH 20C,A02,083761,Briones; Jor-el Thomas Caparas,8,0,35,27
1657328892249,MATH 20C,A03,093476,Briones; Jor-el Thomas Caparas,0,1,36,36
1657328892249,MATH 20C,B01,083762,Bach; Quang Tran,1,0,30,29
1657328898277,MATH 20D,A01,083765,Tran; Brian Kha,5,0,30,25
1657328898277,MATH 20D,A02,083766,Tran; Brian Kha,5,0,30,25
1657328898277,MATH 20D,A03,083767,Tran; Brian Kha,4,0,30,26
1657328904305,MATH 20E,A01,083771,Ganguly; Soumya,7,0,32,25
1657328904305,MATH 20E,A02,083772,Ganguly; Soumya,6,0,32,26
1657328904305,MATH 20E,B01,083773,Ciotti; Benjamin,20,0,35,15
1657328904305,MATH 20E,B02,083774,Ciotti; Benjamin,17,0,35,18
1657328910337,MATH 103A,A01,083777,Greenfeld; Be'Eri,3,0,36,33
1657328910337,MATH 103A,A02,083778,Greenfeld; Be'Eri,5,0,36,31
1657328910337,MATH 103A,A03,093561,Greenfeld; Be'Eri,4,0,36,32
1657328910337,MATH 103A,B01,083779,Greenfeld; Be'Eri,6,0,36,30
1657328910337,MATH 103A,B02,083780,Greenfeld; Be'Eri,4,0,36,32
1657328910337,MATH 103A,B03,093562,Greenfeld; Be'Eri,3,0,36,33
1657328916367,MATH 105,A01,085443,Carter; Anne Toulson,15,0,35,20
1657328916367,MATH 105,A02,093477,Carter; Anne Toulson,20,0,35,15
1657328922395,MATH 109,A01,083213,Ganzberger; Geoffrey Michael,2,0,34,32
1657328922395,MATH 109,A02,083214,Ganzberger; Geoffrey Michael,4,0,34,30
1657328922395,MATH 109,A03,093478,Ganzberger; Geoffrey Michael,2,0,34,32
1657328922395,MATH 109,B01,083215,Ganzberger; Geoffrey Michael,1,0,32,31
1657328922395,MATH 109,B02,083216,Ganzberger; Geoffrey Michael,1,0,32,31
1657328922395,MATH 109,B03,093479,Ganzberger; Geoffrey Michael,8,0,32,24
1657328928423,MATH 142A,A01,083219,Chow; Bennett,7,0,32,25
1657328928423,MATH 142A,A02,083220,Chow; Bennett,10,0,32,22
1657328928423,MATH 142A,A03,093480,Chow; Bennett,7,0,32,25
1657328928423,MATH 142A,B03,093481,Chow; Bennett,8,0,32,24
1657328928423,MATH 142A,B04,093558,Chow; Bennett,13,0,32,19
1657328928423,MATH 142A,B05,093559,Chow; Bennett,6,0,32,26
1657328934457,MATH 193A,A01,083224,Rotar; Vladimir,7,0,34,27
1657328934457,MATH 193A,A02,083225,Rotar; Vladimir,7,0,34,27
1657328934457,MATH 193A,A03,083781,Rotar; Vladimir,3,0,34,31
1657328934457,MATH 193A,A04,083782,Rotar; Vladimir,8,0,34,26
1657328934457,MATH 193A,A05,093482,Rotar; Vladimir,9,0,34,25
1657328940481,MATH 197,001,091859,McAuley; Julian John,9999,0,9999,0
1657328940481,MATH 197,002,095566,Kedlaya; Kiran S.,9997,0,9999,2
1657328940481,MATH 197,003,095567,Xiao; Ming,9999,0,9999,0
1657328940481,MATH 197,004,095571,Perols; Johan Lars,9998,0,9999,1
1657328947544,COGS 9,A01,083615,Shannon; Kyle Michael,8,0,75,67
1657328953571,COGS 11,A01,083617,Boyle; Mary E. T.,22,0,48,26
1657328959600,COGS 13,A01,083071,Bastos; Amalia Pinkusfeld,11,0,71,60
1657328965626,COGS 14A,A01,092681,Semenuks; Arturs,3,1,100,97
1657328971662,COGS 14B,A01,083073,Cheng; Tzu-Han,6,0,63,57
1657328977688,COGS 17,A01,092677,Semenuks; Arturs,6,0,81,75
1657328983713,COGS 100,A01,083619,Allen; Michael Gordon,16,0,70,54
1657328989735,COGS 101A,A01,083621,Davis; Joshua Daniel,9,0,68,59
1657328995757,COGS 101B,A01,091572,Allen; Michael Gordon,11,0,65,54
1657329001784,COGS 101C,A01,083625,Delgado; Tania,17,0,35,18
1657329007823,COGS 107A,A01,083627,Boyle; Mary E. T.,13,0,60,47
1657329013845,COGS 118A,A01,083075,Gupta; Anjum,19,0,76,57
1657329019870,CSE 3,A50,083646,Miranda; Gregory Joseph,24,0,50,26
1657329025895,CSE 8A,A50,083650,Miranda; Gregory Joseph,17,1,56,39
1657329031931,CSE 11,A01,083080,Cao; Yingjun,6,15,40,34
1657329037952,CSE 12,A01,083652,Krause-Levy; Sophia Louisa,28,1,120,92
1657329043976,CSE 15L,A01,083654,Morris; Justin Loren,9,0,50,41
1657329043976,CSE 15L,A02,083655,Morris; Justin Loren,9,0,50,41
1657329050002,CSE 20,A01,083657,Tran; Khoa Dang,39,0,80,41
1657329056033,CSE 21,A01,095574,Bach; Quang Tran,22,0,48,26
1657329062074,CSE 30,A01,083084,Eldon; John,4,0,80,76
1657329062074,CSE 30,B01,095061,Bhaskar; Nishant,9,0,50,41
1657329068193,CSE 100,A01,083659,Cao; Yingjun,4,4,70,66
1657329074214,CSE 134B,A01,083661,Powell; Thomas Allan,22,0,100,78
1657329080241,CSE 140,A01,083663,Gungor; Onat,14,0,85,71
1657329086263,CSE 140L,A01,083088,Eldon; John,21,0,100,79
1657329092288,CSE 175,A01,083665,Kumar; Rakesh,3,0,25,22
1657329098311,CSE 190,A00,092507,Dubnov; Shlomo,7,0,20,13
1657329104338,ECE 45,A01,083139,Congero; Spencer William,6,0,75,69
1657329110362,ECE 65,A50,083695,Saad; Andrew S,12,0,30,18
1657329110362,ECE 65,A51,095125,Saad; Andrew S,24,0,26,2
1657329116393,ECE 109,A01,091882,Touri; Behrouz,19,0,70,51
1657329122414,ECE 180,A00,083140,Abi Samra; Nicholas Camill,1,0,30,29
1657329122414,ECE 180,B00,083141,Abi Samra; Nicholas Camill,0,0,30,30
1657329128444,MATH 10A,A01,083735,Patchell; Gregory David,2,0,30,28
1657329128444,MATH 10A,A02,083736,Patchell; Gregory David,20,0,30,10
1657329128444,MATH 10A,A03,083737,Patchell; Gregory David,16,0,30,14
1657329134468,MATH 10B,A01,083207,Lim; Seonhee,7,0,34,27
1657329134468,MATH 10B,A02,083208,Lim; Seonhee,9,0,35,26
1657329134468,MATH 10B,A03,093472,Lim; Seonhee,7,0,34,27
1657329134468,MATH 10B,B01,083739,Sinha; Shubham,12,0,30,18
1657329140498,MATH 18,A01,083743,Cinel; Cameron Alexander,6,0,30,24
1657329140498,MATH 18,A02,083744,Cinel; Cameron Alexander,17,0,30,13
1657329140498,MATH 18,A03,083745,Cinel; Cameron Alexander,9,0,30,21
1657329140498,MATH 18,B01,083748,Rideout; David Porter,4,0,37,33
1657329140498,MATH 18,B02,083749,Rideout; David Porter,5,0,36,31
1657329140498,MATH 18,B03,083750,Rideout; David Porter,3,0,37,34
1657329140498,MATH 18,B04,083751,Rideout; David Porter,6,0,36,30
1657329140498,MATH 18,B05,093473,Rideout; David Porter,6,0,36,30
1657329140498,MATH 18,B06,093474,Rideout; David Porter,6,0,36,30
1657329146525,MATH 20A,A01,083754,Zheng; Zequn,14,0,40,26
1657329152550,MATH 20B,A01,083756,Briones; Jor-el Thomas Caparas,4,0,36,32
1657329152550,MATH 20B,A02,083757,Briones; Jor-el Thomas Caparas,1,0,36,35
1657329152550,MATH 20B,A03,093475,Briones; Jor-el Thomas Caparas,2,0,36,34
1657329158574,MATH 20C,A01,083760,Briones; Jor-el Thomas Caparas,1,0,35,34
1657329158574,MATH 20C,A02,083761,Briones; Jor-el Thomas Caparas,8,0,35,27
1657329158574,MATH 20C,A03,093476,Briones; Jor-el Thomas Caparas,0,1,36,36
1657329158574,MATH 20C,B01,083762,Bach; Quang Tran,1,0,30,29
1657329164603,MATH 20D,A01,083765,Tran; Brian Kha,5,0,30,25
1657329164603,MATH 20D,A02,083766,Tran; Brian Kha,5,0,30,25
1657329164603,MATH 20D,A03,083767,Tran; Brian Kha,4,0,30,26
1657329170632,MATH 20E,A01,083771,Ganguly; Soumya,7,0,32,25
1657329170632,MATH 20E,A02,083772,Ganguly; Soumya,6,0,32,26
1657329170632,MATH 20E,B01,083773,Ciotti; Benjamin,20,0,35,15
1657329170632,MATH 20E,B02,083774,Ciotti; Benjamin,17,0,35,18
1657329176656,MATH 103A,A01,083777,Greenfeld; Be'Eri,3,0,36,33
1657329176656,MATH 103A,A02,083778,Greenfeld; Be'Eri,5,0,36,31
1657329176656,MATH 103A,A03,093561,Greenfeld; Be'Eri,4,0,36,32
1657329176656,MATH 103A,B01,083779,Greenfeld; Be'Eri,6,0,36,30
1657329176656,MATH 103A,B02,083780,Greenfeld; Be'Eri,4,0,36,32
1657329176656,MATH 103A,B03,093562,Greenfeld; Be'Eri,3,0,36,33
1657329182684,MATH 105,A01,085443,Carter; Anne Toulson,15,0,35,20
1657329182684,MATH 105,A02,093477,Carter; Anne Toulson,20,0,35,15
1657329188707,MATH 109,A01,083213,Ganzberger; Geoffrey Michael,2,0,34,32
1657329188707,MATH 109,A02,083214,Ganzberger; Geoffrey Michael,4,0,34,30
1657329188707,MATH 109,A03,093478,Ganzberger; Geoffrey Michael,2,0,34,32
1657329188707,MATH 109,B01,083215,Ganzberger; Geoffrey Michael,1,0,32,31
1657329188707,MATH 109,B02,083216,Ganzberger; Geoffrey Michael,1,0,32,31
1657329188707,MATH 109,B03,093479,Ganzberger; Geoffrey Michael,8,0,32,24
1657329194736,MATH 142A,A01,083219,Chow; Bennett,7,0,32,25
1657329194736,MATH 142A,A02,083220,Chow; Bennett,10,0,32,22
1657329194736,MATH 142A,A03,093480,Chow; Bennett,7,0,32,25
1657329194736,MATH 142A,B03,093481,Chow; Bennett,8,0,32,24
1657329194736,MATH 142A,B04,093558,Chow; Bennett,13,0,32,19
1657329194736,MATH 142A,B05,093559,Chow; Bennett,6,0,32,26
1657329200758,MATH 193A,A01,083224,Rotar; Vladimir,7,0,34,27
1657329200758,MATH 193A,A02,083225,Rotar; Vladimir,7,0,34,27
1657329200758,MATH 193A,A03,083781,Rotar; Vladimir,3,0,34,31
1657329200758,MATH 193A,A04,083782,Rotar; Vladimir,8,0,34,26
1657329200758,MATH 193A,A05,093482,Rotar; Vladimir,9,0,34,25
1657329206782,MATH 197,001,091859,McAuley; Julian John,9999,0,9999,0
1657329206782,MATH 197,002,095566,Kedlaya; Kiran S.,9997,0,9999,2
1657329206782,MATH 197,003,095567,Xiao; Ming,9999,0,9999,0
1657329206782,MATH 197,004,095571,Perols; Johan Lars,9998,0,9999,1
1657329213837,COGS 9,A01,083615,Shannon; Kyle Michael,8,0,75,67
1657329219861,COGS 11,A01,083617,Boyle; Mary E. T.,22,0,48,26
1657329225885,COGS 13,A01,083071,Bastos; Amalia Pinkusfeld,11,0,71,60
1657329231911,COGS 14A,A01,092681,Semenuks; Arturs,3,1,100,97
1657329237934,COGS 14B,A01,083073,Cheng; Tzu-Han,6,0,63,57
1657329243959,COGS 17,A01,092677,Semenuks; Arturs,6,0,81,75
1657329249983,COGS 100,A01,083619,Allen; Michael Gordon,16,0,70,54
1657329256005,COGS 101A,A01,083621,Davis; Joshua Daniel,9,0,68,59
1657329262028,COGS 101B,A01,091572,Allen; Michael Gordon,11,0,65,54
1657329268051,COGS 101C,A01,083625,Delgado; Tania,17,0,35,18
1657329274074,COGS 107A,A01,083627,Boyle; Mary E. T.,13,0,60,47
1657329280097,COGS 118A,A01,083075,Gupta; Anjum,19,0,76,57
1657329286120,CSE 3,A50,083646,Miranda; Gregory Joseph,24,0,50,26
1657329292144,CSE 8A,A50,083650,Miranda; Gregory Joseph,17,1,56,39
1657329298169,CSE 11,A01,083080,Cao; Yingjun,6,15,40,34
1657329304193,CSE 12,A01,083652,Krause-Levy; Sophia Louisa,28,1,120,92
1657329310215,CSE 15L,A01,083654,Morris; Justin Loren,9,0,50,41
1657329310215,CSE 15L,A02,083655,Morris; Justin Loren,9,0,50,41
1657329316245,CSE 20,A01,083657,Tran; Khoa Dang,39,0,80,41
1657329322281,CSE 21,A01,095574,Bach; Quang Tran,22,0,48,26
1657329328304,CSE 30,A01,083084,Eldon; John,4,0,80,76
1657329328304,CSE 30,B01,095061,Bhaskar; Nishant,9,0,50,41
1657329334330,CSE 100,A01,083659,Cao; Yingjun,4,4,70,66
1657329340358,CSE 134B,A01,083661,Powell; Thomas Allan,22,0,100,78
1657329346395,CSE 140,A01,083663,Gungor; Onat,14,0,85,71
1657329352424,CSE 140L,A01,083088,Eldon; John,21,0,100,79
1657329358447,CSE 175,A01,083665,Kumar; Rakesh,3,0,25,22
1657329364471,CSE 190,A00,092507,Dubnov; Shlomo,7,0,20,13
1657329370493,ECE 45,A01,083139,Congero; Spencer William,6,0,75,69
1657329376521,ECE 65,A50,083695,Saad; Andrew S,12,0,30,18
1657329376521,ECE 65,A51,095125,Saad; Andrew S,24,0,26,2
1657329382544,ECE 109,A01,091882,Touri; Behrouz,19,0,70,51
1657329388575,ECE 180,A00,083140,Abi Samra; Nicholas Camill,1,0,30,29
1657329388575,ECE 180,B00,083141,Abi Samra; Nicholas Camill,0,0,30,30
1657329394603,MATH 10A,A01,083735,Patchell; Gregory David,2,0,30,28
1657329394603,MATH 10A,A02,083736,Patchell; Gregory David,20,0,30,10
1657329394603,MATH 10A,A03,083737,Patchell; Gregory David,16,0,30,14
1657329400632,MATH 10B,A01,083207,Lim; Seonhee,7,0,34,27
1657329400632,MATH 10B,A02,083208,Lim; Seonhee,9,0,35,26
1657329400632,MATH 10B,A03,093472,Lim; Seonhee,7,0,34,27
1657329400632,MATH 10B,B01,083739,Sinha; Shubham,12,0,30,18
1657329406655,MATH 18,A01,083743,Cinel; Cameron Alexander,6,0,30,24
1657329406655,MATH 18,A02,083744,Cinel; Cameron Alexander,17,0,30,13
1657329406655,MATH 18,A03,083745,Cinel; Cameron Alexander,9,0,30,21
1657329406655,MATH 18,B01,083748,Rideout; David Porter,4,0,37,33
1657329406655,MATH 18,B02,083749,Rideout; David Porter,5,0,36,31
1657329406655,MATH 18,B03,083750,Rideout; David Porter,3,0,37,34
1657329406655,MATH 18,B04,083751,Rideout; David Porter,6,0,36,30
1657329406655,MATH 18,B05,093473,Rideout; David Porter,6,0,36,30
1657329406655,MATH 18,B06,093474,Rideout; David Porter,6,0,36,30
1657329412680,MATH 20A,A01,083754,Zheng; Zequn,14,0,40,26
1657329418717,MATH 20B,A01,083756,Briones; Jor-el Thomas Caparas,4,0,36,32
1657329418717,MATH 20B,A02,083757,Briones; Jor-el Thomas Caparas,1,0,36,35
1657329418717,MATH 20B,A03,093475,Briones; Jor-el Thomas Caparas,2,0,36,34
1657329424739,MATH 20C,A01,083760,Briones; Jor-el Thomas Caparas,1,0,35,34
1657329424739,MATH 20C,A02,083761,Briones; Jor-el Thomas Caparas,8,0,35,27
1657329424739,MATH 20C,A03,093476,Briones; Jor-el Thomas Caparas,0,1,36,36
1657329424739,MATH 20C,B01,083762,Bach; Quang Tran,1,0,30,29
1657329430771,MATH 20D,A01,083765,Tran; Brian Kha,5,0,30,25
1657329430771,MATH 20D,A02,083766,Tran; Brian Kha,5,0,30,25
1657329430771,MATH 20D,A03,083767,Tran; Brian Kha,4,0,30,26
1657329436797,MATH 20E,A01,083771,Ganguly; Soumya,7,0,32,25
1657329436797,MATH 20E,A02,083772,Ganguly; Soumya,6,0,32,26
1657329436797,MATH 20E,B01,083773,Ciotti; Benjamin,20,0,35,15
1657329436797,MATH 20E,B02,083774,Ciotti; Benjamin,17,0,35,18
1657329442840,MATH 103A,A01,083777,Greenfeld; Be'Eri,3,0,36,33
1657329442840,MATH 103A,A02,083778,Greenfeld; Be'Eri,5,0,36,31
1657329442840,MATH 103A,A03,093561,Greenfeld; Be'Eri,4,0,36,32
1657329442840,MATH 103A,B01,083779,Greenfeld; Be'Eri,6,0,36,30
1657329442840,MATH 103A,B02,083780,Greenfeld; Be'Eri,4,0,36,32
1657329442840,MATH 103A,B03,093562,Greenfeld; Be'Eri,3,0,36,33
1657329448866,MATH 105,A01,085443,Carter; Anne Toulson,15,0,35,20
1657329448866,MATH 105,A02,093477,Carter; Anne Toulson,20,0,35,15
1657329454889,MATH 109,A01,083213,Ganzberger; Geoffrey Michael,2,0,34,32
1657329454889,MATH 109,A02,083214,Ganzberger; Geoffrey Michael,4,0,34,30
1657329454889,MATH 109,A03,093478,Ganzberger; Geoffrey Michael,2,0,34,32
1657329454889,MATH 109,B01,083215,Ganzberger; Geoffrey Michael,1,0,32,31
1657329454889,MATH 109,B02,083216,Ganzberger; Geoffrey Michael,1,0,32,31
1657329454889,MATH 109,B03,093479,Ganzberger; Geoffrey Michael,8,0,32,24
1657329460915,MATH 142A,A01,083219,Chow; Bennett,7,0,32,25
1657329460915,MATH 142A,A02,083220,Chow; Bennett,10,0,32,22
1657329460915,MATH 142A,A03,093480,Chow; Bennett,7,0,32,25
1657329460915,MATH 142A,B03,093481,Chow; Bennett,8,0,32,24
1657329460915,MATH 142A,B04,093558,Chow; Bennett,13,0,32,19
1657329460915,MATH 142A,B05,093559,Chow; Bennett,6,0,32,26
1657329466938,MATH 193A,A01,083224,Rotar; Vladimir,7,0,34,27
1657329466938,MATH 193A,A02,083225,Rotar; Vladimir,7,0,34,27
1657329466938,MATH 193A,A03,083781,Rotar; Vladimir,3,0,34,31
1657329466938,MATH 193A,A04,083782,Rotar; Vladimir,8,0,34,26
1657329466938,MATH 193A,A05,093482,Rotar; Vladimir,9,0,34,25
1657329472962,MATH 197,001,091859,McAuley; Julian John,9999,0,9999,0
1657329472962,MATH 197,002,095566,Kedlaya; Kiran S.,9997,0,9999,2
1657329472962,MATH 197,003,095567,Xiao; Ming,9999,0,9999,0
1657329472962,MATH 197,004,095571,Perols; Johan Lars,9998,0,9999,1
1657329480036,COGS 9,A01,083615,Shannon; Kyle Michael,8,0,75,67
1657329486059,COGS 11,A01,083617,Boyle; Mary E. T.,22,0,48,26
1657329492082,COGS 13,A01,083071,Bastos; Amalia Pinkusfeld,11,0,71,60
1657329498104,COGS 14A,A01,092681,Semenuks; Arturs,3,1,100,97
1657329504128,COGS 14B,A01,083073,Cheng; Tzu-Han,6,0,63,57
1657329510163,COGS 17,A01,092677,Semenuks; Arturs,6,0,81,75
1657329516190,COGS 100,A01,083619,Allen; Michael Gordon,16,0,70,54
1657329522215,COGS 101A,A01,083621,Davis; Joshua Daniel,9,0,68,59
1657329528236,COGS 101B,A01,091572,Allen; Michael Gordon,11,0,65,54
1657329534258,COGS 101C,A01,083625,Delgado; Tania,17,0,35,18
1657329540282,COGS 107A,A01,083627,Boyle; Mary E. T.,13,0,60,47
1657329546308,COGS 118A,A01,083075,Gupta; Anjum,19,0,76,57
1657329552333,CSE 3,A50,083646,Miranda; Gregory Joseph,24,0,50,26
1657329558358,CSE 8A,A50,083650,Miranda; Gregory Joseph,17,1,56,39
1657329564383,CSE 11,A01,083080,Cao; Yingjun,6,15,40,34
1657329570406,CSE 12,A01,083652,Krause-Levy; Sophia Louisa,28,1,120,92
1657329576430,CSE 15L,A01,083654,Morris; Justin Loren,9,0,50,41
1657329576430,CSE 15L,A02,083655,Morris; Justin Loren,9,0,50,41
1657329582455,CSE 20,A01,083657,Tran; Khoa Dang,39,0,80,41
1657329588482,CSE 21,A01,095574,Bach; Quang Tran,22,0,48,26
1657329594504,CSE 30,A01,083084,Eldon; John,4,0,80,76
1657329594504,CSE 30,B01,095061,Bhaskar; Nishant,9,0,50,41
1657329600533,CSE 100,A01,083659,Cao; Yingjun,4,4,70,66
1657329606555,CSE 134B,A01,083661,Powell; Thomas Allan,22,0,100,78
1657329612580,CSE 140,A01,083663,Gungor; Onat,14,0,85,71
1657329618605,CSE 140L,A01,083088,Eldon; John,21,0,100,79
1657329624629,CSE 175,A01,083665,Kumar; Rakesh,3,0,25,22
1657329630654,CSE 190,A00,092507,Dubnov; Shlomo,7,0,20,13
1657329636677,ECE 45,A01,083139,Congero; Spencer William,6,0,75,69
1657329642707,ECE 65,A50,083695,Saad; Andrew S,12,0,30,18
1657329642707,ECE 65,A51,095125,Saad; Andrew S,24,0,26,2
1657329648730,ECE 109,A01,091882,Touri; Behrouz,19,0,70,51
1657329654758,ECE 180,A00,083140,Abi Samra; Nicholas Camill,1,0,30,29
1657329654758,ECE 180,B00,083141,Abi Samra; Nicholas Camill,0,0,30,30
1657329660780,MATH 10A,A01,083735,Patchell; Gregory David,2,0,30,28
1657329660780,MATH 10A,A02,083736,Patchell; Gregory David,20,0,30,10
1657329660780,MATH 10A,A03,083737,Patchell; Gregory David,16,0,30,14
1657329666882,MATH 10B,A01,083207,Lim; Seonhee,7,0,34,27
1657329666882,MATH 10B,A02,083208,Lim; Seonhee,9,0,35,26
1657329666882,MATH 10B,A03,093472,Lim; Seonhee,7,0,34,27
1657329666882,MATH 10B,B01,083739,Sinha; Shubham,12,0,30,18
1657329672913,MATH 18,A01,083743,Cinel; Cameron Alexander,6,0,30,24
1657329672913,MATH 18,A02,083744,Cinel; Cameron Alexander,17,0,30,13
1657329672913,MATH 18,A03,083745,Cinel; Cameron Alexander,9,0,30,21
1657329672913,MATH 18,B01,083748,Rideout; David Porter,4,0,37,33
1657329672913,MATH 18,B02,083749,Rideout; David Porter,5,0,36,31
1657329672913,MATH 18,B03,083750,Rideout; David Porter,3,0,37,34
1657329672913,MATH 18,B04,083751,Rideout; David Porter,6,0,36,30
1657329672913,MATH 18,B05,093473,Rideout; David Porter,6,0,36,30
1657329672913,MATH 18,B06,093474,Rideout; David Porter,6,0,36,30
1657329678936,MATH 20A,A01,083754,Zheng; Zequn,14,0,40,26
1657329684959,MATH 20B,A01,083756,Briones; Jor-el Thomas Caparas,4,0,36,32
1657329684959,MATH 20B,A02,083757,Briones; Jor-el Thomas Caparas,1,0,36,35
1657329684959,MATH 20B,A03,093475,Briones; Jor-el Thomas Caparas,2,0,36,34
1657329690982,MATH 20C,A01,083760,Briones; Jor-el Thomas Caparas,1,0,35,34
1657329690982,MATH 20C,A02,083761,Briones; Jor-el Thomas Caparas,8,0,35,27
1657329690982,MATH 20C,A03,093476,Briones; Jor-el Thomas Caparas,0,1,36,36
1657329690982,MATH 20C,B01,083762,Bach; Quang Tran,1,0,30,29
1657329697012,MATH 20D,A01,083765,Tran; Brian Kha,5,0,30,25
1657329697012,MATH 20D,A02,083766,Tran; Brian Kha,5,0,30,25
1657329697012,MATH 20D,A03,083767,Tran; Brian Kha,4,0,30,26
1657329703041,MATH 20E,A01,083771,Ganguly; Soumya,7,0,32,25
1657329703041,MATH 20E,A02,083772,Ganguly; Soumya,6,0,32,26
1657329703041,MATH 20E,B01,083773,Ciotti; Benjamin,20,0,35,15
1657329703041,MATH 20E,B02,083774,Ciotti; Benjamin,17,0,35,18
1657329709065,MATH 103A,A01,083777,Greenfeld; Be'Eri,3,0,36,33
1657329709065,MATH 103A,A02,083778,Greenfeld; Be'Eri,5,0,36,31
1657329709065,MATH 103A,A03,093561,Greenfeld; Be'Eri,4,0,36,32
1657329709065,MATH 103A,B01,083779,Greenfeld; Be'Eri,6,0,36,30
1657329709065,MATH 103A,B02,083780,Greenfeld; Be'Eri,4,0,36,32
1657329709065,MATH 103A,B03,093562,Greenfeld; Be'Eri,3,0,36,33
1657329715101,MATH 105,A01,085443,Carter; Anne Toulson,15,0,35,20
1657329715101,MATH 105,A02,093477,Carter; Anne Toulson,20,0,35,15
1657329721126,MATH 109,A01,083213,Ganzberger; Geoffrey Michael,2,0,34,32
1657329721126,MATH 109,A02,083214,Ganzberger; Geoffrey Michael,4,0,34,30
1657329721126,MATH 109,A03,093478,Ganzberger; Geoffrey Michael,2,0,34,32
1657329721126,MATH 109,B01,083215,Ganzberger; Geoffrey Michael,1,0,32,31
1657329721126,MATH 109,B02,083216,Ganzberger; Geoffrey Michael,1,0,32,31
1657329721126,MATH 109,B03,093479,Ganzberger; Geoffrey Michael,8,0,32,24
1657329727151,MATH 142A,A01,083219,Chow; Bennett,7,0,32,25
1657329727151,MATH 142A,A02,083220,Chow; Bennett,10,0,32,22
1657329727151,MATH 142A,A03,093480,Chow; Bennett,7,0,32,25
1657329727151,MATH 142A,B03,093481,Chow; Bennett,8,0,32,24
1657329727151,MATH 142A,B04,093558,Chow; Bennett,13,0,32,19
1657329727151,MATH 142A,B05,093559,Chow; Bennett,6,0,32,26
1657329733176,MATH 193A,A01,083224,Rotar; Vladimir,7,0,34,27
1657329733176,MATH 193A,A02,083225,Rotar; Vladimir,7,0,34,27
1657329733176,MATH 193A,A03,083781,Rotar; Vladimir,3,0,34,31
1657329733176,MATH 193A,A04,083782,Rotar; Vladimir,8,0,34,26
1657329733176,MATH 193A,A05,093482,Rotar; Vladimir,9,0,34,25
1657329739198,MATH 197,001,091859,McAuley; Julian John,9999,0,9999,0
1657329739198,MATH 197,002,095566,Kedlaya; Kiran S.,9997,0,9999,2
1657329739198,MATH 197,003,095567,Xiao; Ming,9999,0,9999,0
1657329739198,MATH 197,004,095571,Perols; Johan Lars,9998,0,9999,1
1657329746260,COGS 9,A01,083615,Shannon; Kyle Michael,8,0,75,67
1657329752287,COGS 11,A01,083617,Boyle; Mary E. T.,22,0,48,26
1657329758314,COGS 13,A01,083071,Bastos; Amalia Pinkusfeld,11,0,71,60
1657329764338,COGS 14A,A01,092681,Semenuks; Arturs,3,1,100,97
1657329770362,COGS 14B,A01,083073,Cheng; Tzu-Han,6,0,63,57
1657329776387,COGS 17,A01,092677,Semenuks; Arturs,6,0,81,75
1657329782414,COGS 100,A01,083619,Allen; Michael Gordon,16,0,70,54
1657329788443,COGS 101A,A01,083621,Davis; Joshua Daniel,9,0,68,59
1657329794469,COGS 101B,A01,091572,Allen; Michael Gordon,11,0,65,54
1657329800495,COGS 101C,A01,083625,Delgado; Tania,17,0,35,18
1657329806518,COGS 107A,A01,083627,Boyle; Mary E. T.,13,0,60,47
1657329812540,COGS 118A,A01,083075,Gupta; Anjum,19,0,76,57
1657329818567,CSE 3,A50,083646,Miranda; Gregory Joseph,24,0,50,26
1657329824608,CSE 8A,A50,083650,Miranda; Gregory Joseph,17,1,56,39
1657329830635,CSE 11,A01,083080,Cao; Yingjun,6,15,40,34
1657329836663,CSE 12,A01,083652,Krause-Levy; Sophia Louisa,28,1,120,92
1657329842685,CSE 15L,A01,083654,Morris; Justin Loren,9,0,50,41
1657329842685,CSE 15L,A02,083655,Morris; Justin Loren,9,0,50,41
1657329848712,CSE 20,A01,083657,Tran; Khoa Dang,39,0,80,41
1657329854734,CSE 21,A01,095574,Bach; Quang Tran,22,0,48,26
1657329860757,CSE 30,A01,083084,Eldon; John,4,0,80,76
1657329860757,CSE 30,B01,095061,Bhaskar; Nishant,9,0,50,41
1657329866789,CSE 100,A01,083659,Cao; Yingjun,4,4,70,66
1657329872813,CSE 134B,A01,083661,Powell; Thomas Allan,22,0,100,78
1657329878848,CSE 140,A01,083663,Gungor; Onat,14,0,85,71
1657329884870,CSE 140L,A01,083088,Eldon; John,21,0,100,79
1657329890894,CSE 175,A01,083665,Kumar; Rakesh,3,0,25,22
1657329896920,CSE 190,A00,092507,Dubnov; Shlomo,7,0,20,13
1657329902947,ECE 45,A01,083139,Congero; Spencer William,6,0,75,69
1657329908975,ECE 65,A50,083695,Saad; Andrew S,12,0,30,18
1657329908975,ECE 65,A51,095125,Saad; Andrew S,24,0,26,2
1657329915000,ECE 109,A01,091882,Touri; Behrouz,19,0,70,51
1657329921024,ECE 180,A00,083140,Abi Samra; Nicholas Camill,1,0,30,29
1657329921024,ECE 180,B00,083141,Abi Samra; Nicholas Camill,0,0,30,30
1657329927047,MATH 10A,A01,083735,Patchell; Gregory David,2,0,30,28
1657329927047,MATH 10A,A02,083736,Patchell; Gregory David,20,0,30,10
1657329927047,MATH 10A,A03,083737,Patchell; Gregory David,16,0,30,14
1657329933076,MATH 10B,A01,083207,Lim; Seonhee,7,0,34,27
1657329933076,MATH 10B,A02,083208,Lim; Seonhee,9,0,35,26
1657329933076,MATH 10B,A03,093472,Lim; Seonhee,7,0,34,27
1657329933076,MATH 10B,B01,083739,Sinha; Shubham,12,0,30,18
1657329939107,MATH 18,A01,083743,Cinel; Cameron Alexander,6,0,30,24
1657329939107,MATH 18,A02,083744,Cinel; Cameron Alexander,17,0,30,13
1657329939107,MATH 18,A03,083745,Cinel; Cameron Alexander,9,0,30,21
1657329939107,MATH 18,B01,083748,Rideout; David Porter,4,0,37,33
1657329939107,MATH 18,B02,083749,Rideout; David Porter,5,0,36,31
1657329939107,MATH 18,B03,083750,Rideout; David Porter,3,0,37,34
1657329939107,MATH 18,B04,083751,Rideout; David Porter,6,0,36,30
1657329939107,MATH 18,B05,093473,Rideout; David Porter,6,0,36,30
1657329939107,MATH 18,B06,093474,Rideout; David Porter,6,0,36,30
1657329945130,MATH 20A,A01,083754,Zheng; Zequn,14,0,40,26
1657329951152,MATH 20B,A01,083756,Briones; Jor-el Thomas Caparas,4,0,36,32
1657329951152,MATH 20B,A02,083757,Briones; Jor-el Thomas Caparas,1,0,36,35
1657329951152,MATH 20B,A03,093475,Briones; Jor-el Thomas Caparas,2,0,36,34
1657329957181,MATH 20C,A01,083760,Briones; Jor-el Thomas Caparas,1,0,35,34
1657329957181,MATH 20C,A02,083761,Briones; Jor-el Thomas Caparas,8,0,35,27
1657329957181,MATH 20C,A03,093476,Briones; Jor-el Thomas Caparas,0,1,36,36
1657329957181,MATH 20C,B01,083762,Bach; Quang Tran,1,0,30,29
1657329963210,MATH 20D,A01,083765,Tran; Brian Kha,5,0,30,25
1657329963210,MATH 20D,A02,083766,Tran; Brian Kha,5,0,30,25
1657329963210,MATH 20D,A03,083767,Tran; Brian Kha,4,0,30,26
1657329969233,MATH 20E,A01,083771,Ganguly; Soumya,7,0,32,25
1657329969233,MATH 20E,A02,083772,Ganguly; Soumya,6,0,32,26
1657329969233,MATH 20E,B01,083773,Ciotti; Benjamin,20,0,35,15
1657329969233,MATH 20E,B02,083774,Ciotti; Benjamin,17,0,35,18
1657329975269,MATH 103A,A01,083777,Greenfeld; Be'Eri,3,0,36,33
1657329975269,MATH 103A,A02,083778,Greenfeld; Be'Eri,5,0,36,31
1657329975269,MATH 103A,A03,093561,Greenfeld; Be'Eri,4,0,36,32
1657329975269,MATH 103A,B01,083779,Greenfeld; Be'Eri,6,0,36,30
1657329975269,MATH 103A,B02,083780,Greenfeld; Be'Eri,4,0,36,32
1657329975269,MATH 103A,B03,093562,Greenfeld; Be'Eri,3,0,36,33
1657329981296,MATH 105,A01,085443,Carter; Anne Toulson,15,0,35,20
1657329981296,MATH 105,A02,093477,Carter; Anne Toulson,20,0,35,15
1657329987319,MATH 109,A01,083213,Ganzberger; Geoffrey Michael,2,0,34,32
1657329987319,MATH 109,A02,083214,Ganzberger; Geoffrey Michael,4,0,34,30
1657329987319,MATH 109,A03,093478,Ganzberger; Geoffrey Michael,2,0,34,32
1657329987319,MATH 109,B01,083215,Ganzberger; Geoffrey Michael,1,0,32,31
1657329987319,MATH 109,B02,083216,Ganzberger; Geoffrey Michael,1,0,32,31
1657329987319,MATH 109,B03,093479,Ganzberger; Geoffrey Michael,8,0,32,24
1657329993348,MATH 142A,A01,083219,Chow; Bennett,7,0,32,25
1657329993348,MATH 142A,A02,083220,Chow; Bennett,10,0,32,22
1657329993348,MATH 142A,A03,093480,Chow; Bennett,7,0,32,25
1657329993348,MATH 142A,B03,093481,Chow; Bennett,8,0,32,24
1657329993348,MATH 142A,B04,093558,Chow; Bennett,13,0,32,19
1657329993348,MATH 142A,B05,093559,Chow; Bennett,6,0,32,26
1657329999373,MATH 193A,A01,083224,Rotar; Vladimir,7,0,34,27
1657329999373,MATH 193A,A02,083225,Rotar; Vladimir,7,0,34,27
1657329999373,MATH 193A,A03,083781,Rotar; Vladimir,3,0,34,31
1657329999373,MATH 193A,A04,083782,Rotar; Vladimir,8,0,34,26
1657329999373,MATH 193A,A05,093482,Rotar; Vladimir,9,0,34,25
1657330005398,MATH 197,001,091859,McAuley; Julian John,9999,0,9999,0
1657330005398,MATH 197,002,095566,Kedlaya; Kiran S.,9997,0,9999,2
1657330005398,MATH 197,003,095567,Xiao; Ming,9999,0,9999,0
1657330005398,MATH 197,004,095571,Perols; Johan Lars,9998,0,9999,1
1657330012463,COGS 9,A01,083615,Shannon; Kyle Michael,8,0,75,67
1657330018486,COGS 11,A01,083617,Boyle; Mary E. T.,22,0,48,26
1657330024509,COGS 13,A01,083071,Bastos; Amalia Pinkusfeld,11,0,71,60
1657330030535,COGS 14A,A01,092681,Semenuks; Arturs,3,1,100,97
1657330036559,COGS 14B,A01,083073,Cheng; Tzu-Han,6,0,63,57
1657330042585,COGS 17,A01,092677,Semenuks; Arturs,6,0,81,75
1657330048611,COGS 100,A01,083619,Allen; Michael Gordon,16,0,70,54
1657330054636,COGS 101A,A01,083621,Davis; Joshua Daniel,9,0,68,59
1657330060660,COGS 101B,A01,091572,Allen; Michael Gordon,11,0,65,54
1657330066695,COGS 101C,A01,083625,Delgado; Tania,17,0,35,18
1657330072721,COGS 107A,A01,083627,Boyle; Mary E. T.,13,0,60,47
1657330078743,COGS 118A,A01,083075,Gupta; Anjum,19,0,76,57
1657330084775,CSE 3,A50,083646,Miranda; Gregory Joseph,24,0,50,26
1657330090798,CSE 8A,A50,083650,Miranda; Gregory Joseph,17,1,56,39
1657330096826,CSE 11,A01,083080,Cao; Yingjun,6,15,40,34
1657330102850,CSE 12,A01,083652,Krause-Levy; Sophia Louisa,28,1,120,92
1657330108880,CSE 15L,A01,083654,Morris; Justin Loren,9,0,50,41
1657330108880,CSE 15L,A02,083655,Morris; Justin Loren,9,0,50,41
1657330114905,CSE 20,A01,083657,Tran; Khoa Dang,39,0,80,41
1657330120930,CSE 21,A01,095574,Bach; Quang Tran,22,0,48,26
1657330126953,CSE 30,A01,083084,Eldon; John,4,0,80,76
1657330126953,CSE 30,B01,095061,Bhaskar; Nishant,9,0,50,41
1657330132975,CSE 100,A01,083659,Cao; Yingjun,4,4,70,66
1657330139011,CSE 134B,A01,083661,Powell; Thomas Allan,22,0,100,78
1657330145038,CSE 140,A01,083663,Gungor; Onat,14,0,85,71
1657330151061,CSE 140L,A01,083088,Eldon; John,21,0,100,79
1657330157084,CSE 175,A01,083665,Kumar; Rakesh,3,0,25,22
1657330163107,CSE 190,A00,092507,Dubnov; Shlomo,7,0,20,13
1657330169130,ECE 45,A01,083139,Congero; Spencer William,6,0,75,69
1657330175165,ECE 65,A50,083695,Saad; Andrew S,12,0,30,18
1657330175165,ECE 65,A51,095125,Saad; Andrew S,24,0,26,2
1657330181189,ECE 109,A01,091882,Touri; Behrouz,19,0,70,51
1657330187212,ECE 180,A00,083140,Abi Samra; Nicholas Camill,1,0,30,29
1657330187212,ECE 180,B00,083141,Abi Samra; Nicholas Camill,0,0,30,30
1657330193236,MATH 10A,A01,083735,Patchell; Gregory David,2,0,30,28
1657330193236,MATH 10A,A02,083736,Patchell; Gregory David,20,0,30,10
1657330193236,MATH 10A,A03,083737,Patchell; Gregory David,16,0,30,14
1657330199261,MATH 10B,A01,083207,Lim; Seonhee,7,0,34,27
1657330199261,MATH 10B,A02,083208,Lim; Seonhee,9,0,35,26
1657330199261,MATH 10B,A03,093472,Lim; Seonhee,7,0,34,27
1657330199261,MATH 10B,B01,083739,Sinha; Shubham,12,0,30,18
1657330205295,MATH 18,A01,083743,Cinel; Cameron Alexander,6,0,30,24
1657330205295,MATH 18,A02,083744,Cinel; Cameron Alexander,17,0,30,13
1657330205295,MATH 18,A03,083745,Cinel; Cameron Alexander,9,0,30,21
1657330205295,MATH 18,B01,083748,Rideout; David Porter,4,0,37,33
1657330205295,MATH 18,B02,083749,Rideout; David Porter,5,0,36,31
1657330205295,MATH 18,B03,083750,Rideout; David Porter,3,0,37,34
1657330205295,MATH 18,B04,083751,Rideout; David Porter,6,0,36,30
1657330205295,MATH 18,B05,093473,Rideout; David Porter,6,0,36,30
1657330205295,MATH 18,B06,093474,Rideout; David Porter,6,0,36,30
1657330211322,MATH 20A,A01,083754,Zheng; Zequn,14,0,40,26
1657330217354,MATH 20B,A01,083756,Briones; Jor-el Thomas Caparas,4,0,36,32
1657330217354,MATH 20B,A02,083757,Briones; Jor-el Thomas Caparas,1,0,36,35
1657330217354,MATH 20B,A03,093475,Briones; Jor-el Thomas Caparas,2,0,36,34
1657330223378,MATH 20C,A01,083760,Briones; Jor-el Thomas Caparas,1,0,35,34
1657330223378,MATH 20C,A02,083761,Briones; Jor-el Thomas Caparas,8,0,35,27
1657330223378,MATH 20C,A03,093476,Briones; Jor-el Thomas Caparas,0,1,36,36
1657330223378,MATH 20C,B01,083762,Bach; Quang Tran,1,0,30,29
1657330229407,MATH 20D,A01,083765,Tran; Brian Kha,5,0,30,25
1657330229407,MATH 20D,A02,083766,Tran; Brian Kha,5,0,30,25
1657330229407,MATH 20D,A03,083767,Tran; Brian Kha,4,0,30,26
1657330235431,MATH 20E,A01,083771,Ganguly; Soumya,7,0,32,25
1657330235431,MATH 20E,A02,083772,Ganguly; Soumya,6,0,32,26
1657330235431,MATH 20E,B01,083773,Ciotti; Benjamin,20,0,35,15
1657330235431,MATH 20E,B02,083774,Ciotti; Benjamin,17,0,35,18
1657330241458,MATH 103A,A01,083777,Greenfeld; Be'Eri,3,0,36,33
1657330241458,MATH 103A,A02,083778,Greenfeld; Be'Eri,5,0,36,31
1657330241458,MATH 103A,A03,093561,Greenfeld; Be'Eri,4,0,36,32
1657330241458,MATH 103A,B01,083779,Greenfeld; Be'Eri,6,0,36,30
1657330241458,MATH 103A,B02,083780,Greenfeld; Be'Eri,4,0,36,32
1657330241458,MATH 103A,B03,093562,Greenfeld; Be'Eri,3,0,36,33
1657330247484,MATH 105,A01,085443,Carter; Anne Toulson,15,0,35,20
1657330247484,MATH 105,A02,093477,Carter; Anne Toulson,20,0,35,15
1657330253511,MATH 109,A01,083213,Ganzberger; Geoffrey Michael,2,0,34,32
1657330253511,MATH 109,A02,083214,Ganzberger; Geoffrey Michael,4,0,34,30
1657330253511,MATH 109,A03,093478,Ganzberger; Geoffrey Michael,2,0,34,32
1657330253511,MATH 109,B01,083215,Ganzberger; Geoffrey Michael,1,0,32,31
1657330253511,MATH 109,B02,083216,Ganzberger; Geoffrey Michael,1,0,32,31
1657330253511,MATH 109,B03,093479,Ganzberger; Geoffrey Michael,8,0,32,24
1657330259535,MATH 142A,A01,083219,Chow; Bennett,7,0,32,25
1657330259535,MATH 142A,A02,083220,Chow; Bennett,10,0,32,22
1657330259535,MATH 142A,A03,093480,Chow; Bennett,7,0,32,25
1657330259535,MATH 142A,B03,093481,Chow; Bennett,8,0,32,24
1657330259535,MATH 142A,B04,093558,Chow; Bennett,13,0,32,19
1657330259535,MATH 142A,B05,093559,Chow; Bennett,6,0,32,26
1657330265637,MATH 193A,A01,083224,Rotar; Vladimir,7,0,34,27
1657330265637,MATH 193A,A02,083225,Rotar; Vladimir,7,0,34,27
1657330265637,MATH 193A,A03,083781,Rotar; Vladimir,3,0,34,31
1657330265637,MATH 193A,A04,083782,Rotar; Vladimir,8,0,34,26
1657330265637,MATH 193A,A05,093482,Rotar; Vladimir,9,0,34,25
1657330271671,MATH 197,001,091859,McAuley; Julian John,9999,0,9999,0
1657330271671,MATH 197,002,095566,Kedlaya; Kiran S.,9997,0,9999,2
1657330271671,MATH 197,003,095567,Xiao; Ming,9999,0,9999,0
1657330271671,MATH 197,004,095571,Perols; Johan Lars,9998,0,9999,1
1657330278722,COGS 9,A01,083615,Shannon; Kyle Michael,8,0,75,67
1657330284760,COGS 11,A01,083617,Boyle; Mary E. T.,22,0,48,26
1657330290783,COGS 13,A01,083071,Bastos; Amalia Pinkusfeld,11,0,71,60
1657330296805,COGS 14A,A01,092681,Semenuks; Arturs,3,1,100,97
1657330302837,COGS 14B,A01,083073,Cheng; Tzu-Han,6,0,63,57
1657330308871,COGS 17,A01,092677,Semenuks; Arturs,6,0,81,75
1657330314897,COGS 100,A01,083619,Allen; Michael Gordon,16,0,70,54
1657330320922,COGS 101A,A01,083621,Davis; Joshua Daniel,9,0,68,59
1657330326944,COGS 101B,A01,091572,Allen; Michael Gordon,11,0,65,54
1657330332970,COGS 101C,A01,083625,Delgado; Tania,17,0,35,18
1657330338997,COGS 107A,A01,083627,Boyle; Mary E. T.,13,0,60,47
1657330345034,COGS 118A,A01,083075,Gupta; Anjum,19,0,76,57
1657330351068,CSE 3,A50,083646,Miranda; Gregory Joseph,24,0,50,26
1657330357092,CSE 8A,A50,083650,Miranda; Gregory Joseph,17,1,56,39
1657330363123,CSE 11,A01,083080,Cao; Yingjun,6,15,40,34
1657330369150,CSE 12,A01,083652,Krause-Levy; Sophia Louisa,28,1,120,92
1657330375176,CSE 15L,A01,083654,Morris; Justin Loren,9,0,50,41
1657330375176,CSE 15L,A02,083655,Morris; Justin Loren,9,0,50,41
1657330381206,CSE 20,A01,083657,Tran; Khoa Dang,39,0,80,41
1657330387233,CSE 21,A01,095574,Bach; Quang Tran,22,0,48,26
1657330393256,CSE 30,A01,083084,Eldon; John,4,0,80,76
1657330393256,CSE 30,B01,095061,Bhaskar; Nishant,9,0,50,41
1657330399279,CSE 100,A01,083659,Cao; Yingjun,4,4,70,66
1657330405302,CSE 134B,A01,083661,Powell; Thomas Allan,22,0,100,78
1657330411324,CSE 140,A01,083663,Gungor; Onat,14,0,85,71
1657330417349,CSE 140L,A01,083088,Eldon; John,21,0,100,79
1657330423378,CSE 175,A01,083665,Kumar; Rakesh,3,0,25,22
1657330429403,CSE 190,A00,092507,Dubnov; Shlomo,7,0,20,13
1657330435430,ECE 45,A01,083139,Congero; Spencer William,6,0,75,69
1657330441457,ECE 65,A50,083695,Saad; Andrew S,12,0,30,18
1657330441457,ECE 65,A51,095125,Saad; Andrew S,24,0,26,2
1657330447483,ECE 109,A01,091882,Touri; Behrouz,19,0,70,51
1657330453507,ECE 180,A00,083140,Abi Samra; Nicholas Camill,1,0,30,29
1657330453507,ECE 180,B00,083141,Abi Samra; Nicholas Camill,0,0,30,30
1657330459534,MATH 10A,A01,083735,Patchell; Gregory David,2,0,30,28
1657330459534,MATH 10A,A02,083736,Patchell; Gregory David,20,0,30,10
1657330459534,MATH 10A,A03,083737,Patchell; Gregory David,16,0,30,14
1657330465557,MATH 10B,A01,083207,Lim; Seonhee,7,0,34,27
1657330465557,MATH 10B,A02,083208,Lim; Seonhee,9,0,35,26
1657330465557,MATH 10B,A03,093472,Lim; Seonhee,7,0,34,27
1657330465557,MATH 10B,B01,083739,Sinha; Shubham,12,0,30,18
1657330471588,MATH 18,A01,083743,Cinel; Cameron Alexander,6,0,30,24
1657330471588,MATH 18,A02,083744,Cinel; Cameron Alexander,17,0,30,13
1657330471588,MATH 18,A03,083745,Cinel; Cameron Alexander,9,0,30,21
1657330471588,MATH 18,B01,083748,Rideout; David Porter,4,0,37,33
1657330471588,MATH 18,B02,083749,Rideout; David Porter,5,0,36,31
1657330471588,MATH 18,B03,083750,Rideout; David Porter,3,0,37,34
1657330471588,MATH 18,B04,083751,Rideout; David Porter,6,0,36,30
1657330471588,MATH 18,B05,093473,Rideout; David Porter,6,0,36,30
1657330471588,MATH 18,B06,093474,Rideout; David Porter,6,0,36,30
1657330477615,MATH 20A,A01,083754,Zheng; Zequn,14,0,40,26
1657330483639,MATH 20B,A01,083756,Briones; Jor-el Thomas Caparas,4,0,36,32
1657330483639,MATH 20B,A02,083757,Briones; Jor-el Thomas Caparas,1,0,36,35
1657330483639,MATH 20B,A03,093475,Briones; Jor-el Thomas Caparas,2,0,36,34
1657330489660,MATH 20C,A01,083760,Briones; Jor-el Thomas Caparas,1,0,35,34
1657330489660,MATH 20C,A02,083761,Briones; Jor-el Thomas Caparas,8,0,35,27
1657330489660,MATH 20C,A03,093476,Briones; Jor-el Thomas Caparas,0,1,36,36
1657330489660,MATH 20C,B01,083762,Bach; Quang Tran,1,0,30,29
1657330495688,MATH 20D,A01,083765,Tran; Brian Kha,5,0,30,25
1657330495688,MATH 20D,A02,083766,Tran; Brian Kha,5,0,30,25
1657330495688,MATH 20D,A03,083767,Tran; Brian Kha,4,0,30,26
1657330501720,MATH 20E,A01,083771,Ganguly; Soumya,7,0,32,25
1657330501720,MATH 20E,A02,083772,Ganguly; Soumya,6,0,32,26
1657330501720,MATH 20E,B01,083773,Ciotti; Benjamin,20,0,35,15
1657330501720,MATH 20E,B02,083774,Ciotti; Benjamin,17,0,35,18
1657330507748,MATH 103A,A01,083777,Greenfeld; Be'Eri,3,0,36,33
1657330507748,MATH 103A,A02,083778,Greenfeld; Be'Eri,5,0,36,31
1657330507748,MATH 103A,A03,093561,Greenfeld; Be'Eri,4,0,36,32
1657330507748,MATH 103A,B01,083779,Greenfeld; Be'Eri,6,0,36,30
1657330507748,MATH 103A,B02,083780,Greenfeld; Be'Eri,4,0,36,32
1657330507748,MATH 103A,B03,093562,Greenfeld; Be'Eri,3,0,36,33
1657330513774,MATH 105,A01,085443,Carter; Anne Toulson,15,0,35,20
1657330513774,MATH 105,A02,093477,Carter; Anne Toulson,20,0,35,15
1657330519802,MATH 109,A01,083213,Ganzberger; Geoffrey Michael,2,0,34,32
1657330519802,MATH 109,A02,083214,Ganzberger; Geoffrey Michael,4,0,34,30
1657330519802,MATH 109,A03,093478,Ganzberger; Geoffrey Michael,2,0,34,32
1657330519802,MATH 109,B01,083215,Ganzberger; Geoffrey Michael,1,0,32,31
1657330519802,MATH 109,B02,083216,Ganzberger; Geoffrey Michael,1,0,32,31
1657330519802,MATH 109,B03,093479,Ganzberger; Geoffrey Michael,8,0,32,24
1657330525827,MATH 142A,A01,083219,Chow; Bennett,7,0,32,25
1657330525827,MATH 142A,A02,083220,Chow; Bennett,10,0,32,22
1657330525827,MATH 142A,A03,093480,Chow; Bennett,7,0,32,25
1657330525827,MATH 142A,B03,093481,Chow; Bennett,8,0,32,24
1657330525827,MATH 142A,B04,093558,Chow; Bennett,13,0,32,19
1657330525827,MATH 142A,B05,093559,Chow; Bennett,6,0,32,26
1657330531851,MATH 193A,A01,083224,Rotar; Vladimir,7,0,34,27
1657330531851,MATH 193A,A02,083225,Rotar; Vladimir,7,0,34,27
1657330531851,MATH 193A,A03,083781,Rotar; Vladimir,3,0,34,31
1657330531851,MATH 193A,A04,083782,Rotar; Vladimir,8,0,34,26
1657330531851,MATH 193A,A05,093482,Rotar; Vladimir,9,0,34,25
1657330537899,MATH 197,001,091859,McAuley; Julian John,9999,0,9999,0
1657330537899,MATH 197,002,095566,Kedlaya; Kiran S.,9997,0,9999,2
1657330537899,MATH 197,003,095567,Xiao; Ming,9999,0,9999,0
1657330537899,MATH 197,004,095571,Perols; Johan Lars,9998,0,9999,1
1657330544954,COGS 9,A01,083615,Shannon; Kyle Michael,8,0,75,67
1657330550978,COGS 11,A01,083617,Boyle; Mary E. T.,22,0,48,26
1657330557006,COGS 13,A01,083071,Bastos; Amalia Pinkusfeld,11,0,71,60
1657330563044,COGS 14A,A01,092681,Semenuks; Arturs,3,1,100,97
1657330569068,COGS 14B,A01,083073,Cheng; Tzu-Han,6,0,63,57
1657330575093,COGS 17,A01,092677,Semenuks; Arturs,6,0,81,75
1657330581116,COGS 100,A01,083619,Allen; Michael Gordon,16,0,70,54
1657330587146,COGS 101A,A01,083621,Davis; Joshua Daniel,9,0,68,59
1657330593172,COGS 101B,A01,091572,Allen; Michael Gordon,11,0,65,54
1657330599199,COGS 101C,A01,083625,Delgado; Tania,17,0,35,18
1657330605222,COGS 107A,A01,083627,Boyle; Mary E. T.,13,0,60,47
1657330611249,COGS 118A,A01,083075,Gupta; Anjum,19,0,76,57
1657330617273,CSE 3,A50,083646,Miranda; Gregory Joseph,24,0,50,26
1657330623296,CSE 8A,A50,083650,Miranda; Gregory Joseph,17,1,56,39
1657330629320,CSE 11,A01,083080,Cao; Yingjun,6,15,40,34
1657330635342,CSE 12,A01,083652,Krause-Levy; Sophia Louisa,28,1,120,92
1657330641367,CSE 15L,A01,083654,Morris; Justin Loren,9,0,50,41
1657330641367,CSE 15L,A02,083655,Morris; Justin Loren,9,0,50,41
1657330647391,CSE 20,A01,083657,Tran; Khoa Dang,39,0,80,41
1657330653427,CSE 21,A01,095574,Bach; Quang Tran,22,0,48,26
1657330659455,CSE 30,A01,083084,Eldon; John,4,0,80,76
1657330659455,CSE 30,B01,095061,Bhaskar; Nishant,9,0,50,41
1657330665482,CSE 100,A01,083659,Cao; Yingjun,4,4,70,66
1657330671509,CSE 134B,A01,083661,Powell; Thomas Allan,22,0,100,78
1657330677531,CSE 140,A01,083663,Gungor; Onat,14,0,85,71
1657330683558,CSE 140L,A01,083088,Eldon; John,21,0,100,79
1657330689581,CSE 175,A01,083665,Kumar; Rakesh,3,0,25,22
1657330695606,CSE 190,A00,092507,Dubnov; Shlomo,7,0,20,13
1657330701644,ECE 45,A01,083139,Congero; Spencer William,6,0,75,69
1657330707674,ECE 65,A50,083695,Saad; Andrew S,12,0,30,18
1657330707674,ECE 65,A51,095125,Saad; Andrew S,24,0,26,2
1657330713698,ECE 109,A01,091882,Touri; Behrouz,19,0,70,51
1657330719724,ECE 180,A00,083140,Abi Samra; Nicholas Camill,1,0,30,29
1657330719724,ECE 180,B00,083141,Abi Samra; Nicholas Camill,0,0,30,30
1657330725747,MATH 10A,A01,083735,Patchell; Gregory David,2,0,30,28
1657330725747,MATH 10A,A02,083736,Patchell; Gregory David,20,0,30,10
1657330725747,MATH 10A,A03,083737,Patchell; Gregory David,16,0,30,14
1657330731771,MATH 10B,A01,083207,Lim; Seonhee,7,0,34,27
1657330731771,MATH 10B,A02,083208,Lim; Seonhee,9,0,35,26
1657330731771,MATH 10B,A03,093472,Lim; Seonhee,7,0,34,27
1657330731771,MATH 10B,B01,083739,Sinha; Shubham,12,0,30,18
1657330737800,MATH 18,A01,083743,Cinel; Cameron Alexander,6,0,30,24
1657330737800,MATH 18,A02,083744,Cinel; Cameron Alexander,17,0,30,13
1657330737800,MATH 18,A03,083745,Cinel; Cameron Alexander,9,0,30,21
1657330737800,MATH 18,B01,083748,Rideout; David Porter,4,0,37,33
1657330737800,MATH 18,B02,083749,Rideout; David Porter,5,0,36,31
1657330737800,MATH 18,B03,083750,Rideout; David Porter,3,0,37,34
1657330737800,MATH 18,B04,083751,Rideout; David Porter,6,0,36,30
1657330737800,MATH 18,B05,093473,Rideout; David Porter,6,0,36,30
1657330737800,MATH 18,B06,093474,Rideout; David Porter,6,0,36,30
1657330743829,MATH 20A,A01,083754,Zheng; Zequn,14,0,40,26
1657330749852,MATH 20B,A01,083756,Briones; Jor-el Thomas Caparas,4,0,36,32
1657330749852,MATH 20B,A02,083757,Briones; Jor-el Thomas Caparas,1,0,36,35
1657330749852,MATH 20B,A03,093475,Briones; Jor-el Thomas Caparas,2,0,36,34
1657330755881,MATH 20C,A01,083760,Briones; Jor-el Thomas Caparas,1,0,35,34
1657330755881,MATH 20C,A02,083761,Briones; Jor-el Thomas Caparas,8,0,35,27
1657330755881,MATH 20C,A03,093476,Briones; Jor-el Thomas Caparas,0,1,36,36
1657330755881,MATH 20C,B01,083762,Bach; Quang Tran,1,0,30,29
1657330761907,MATH 20D,A01,083765,Tran; Brian Kha,5,0,30,25
1657330761907,MATH 20D,A02,083766,Tran; Brian Kha,5,0,30,25
1657330761907,MATH 20D,A03,083767,Tran; Brian Kha,4,0,30,26
1657330767930,MATH 20E,A01,083771,Ganguly; Soumya,7,0,32,25
1657330767930,MATH 20E,A02,083772,Ganguly; Soumya,6,0,32,26
1657330767930,MATH 20E,B01,083773,Ciotti; Benjamin,20,0,35,15
1657330767930,MATH 20E,B02,083774,Ciotti; Benjamin,17,0,35,18
1657330773960,MATH 103A,A01,083777,Greenfeld; Be'Eri,3,0,36,33
1657330773960,MATH 103A,A02,083778,Greenfeld; Be'Eri,5,0,36,31
1657330773960,MATH 103A,A03,093561,Greenfeld; Be'Eri,4,0,36,32
1657330773960,MATH 103A,B01,083779,Greenfeld; Be'Eri,6,0,36,30
1657330773960,MATH 103A,B02,083780,Greenfeld; Be'Eri,4,0,36,32
1657330773960,MATH 103A,B03,093562,Greenfeld; Be'Eri,3,0,36,33
1657330779995,MATH 105,A01,085443,Carter; Anne Toulson,15,0,35,20
1657330779995,MATH 105,A02,093477,Carter; Anne Toulson,20,0,35,15
1657330786022,MATH 109,A01,083213,Ganzberger; Geoffrey Michael,2,0,34,32
1657330786022,MATH 109,A02,083214,Ganzberger; Geoffrey Michael,4,0,34,30
1657330786022,MATH 109,A03,093478,Ganzberger; Geoffrey Michael,2,0,34,32
1657330786022,MATH 109,B01,083215,Ganzberger; Geoffrey Michael,1,0,32,31
1657330786022,MATH 109,B02,083216,Ganzberger; Geoffrey Michael,1,0,32,31
1657330786022,MATH 109,B03,093479,Ganzberger; Geoffrey Michael,8,0,32,24
1657330792052,MATH 142A,A01,083219,Chow; Bennett,7,0,32,25
1657330792052,MATH 142A,A02,083220,Chow; Bennett,10,0,32,22
1657330792052,MATH 142A,A03,093480,Chow; Bennett,7,0,32,25
1657330792052,MATH 142A,B03,093481,Chow; Bennett,8,0,32,24
1657330792052,MATH 142A,B04,093558,Chow; Bennett,13,0,32,19
1657330792052,MATH 142A,B05,093559,Chow; Bennett,6,0,32,26
1657330798079,MATH 193A,A01,083224,Rotar; Vladimir,7,0,34,27
1657330798079,MATH 193A,A02,083225,Rotar; Vladimir,7,0,34,27
1657330798079,MATH 193A,A03,083781,Rotar; Vladimir,3,0,34,31
1657330798079,MATH 193A,A04,083782,Rotar; Vladimir,8,0,34,26
1657330798079,MATH 193A,A05,093482,Rotar; Vladimir,9,0,34,25
1657330804102,MATH 197,001,091859,McAuley; Julian John,9999,0,9999,0
1657330804102,MATH 197,002,095566,Kedlaya; Kiran S.,9997,0,9999,2
1657330804102,MATH 197,003,095567,Xiao; Ming,9999,0,9999,0
1657330804102,MATH 197,004,095571,Perols; Johan Lars,9998,0,9999,1
1657330811157,COGS 9,A01,083615,Shannon; Kyle Michael,8,0,75,67
1657330817180,COGS 11,A01,083617,Boyle; Mary E. T.,22,0,48,26
1657330823202,COGS 13,A01,083071,Bastos; Amalia Pinkusfeld,11,0,71,60
1657330829223,COGS 14A,A01,092681,Semenuks; Arturs,3,1,100,97
1657330835247,COGS 14B,A01,083073,Cheng; Tzu-Han,6,0,63,57
1657330841270,COGS 17,A01,092677,Semenuks; Arturs,6,0,81,75
1657330847295,COGS 100,A01,083619,Allen; Michael Gordon,16,0,70,54
1657330853325,COGS 101A,A01,083621,Davis; Joshua Daniel,9,0,68,59
1657330859433,COGS 101B,A01,091572,Allen; Michael Gordon,11,0,65,54
1657330865466,COGS 101C,A01,083625,Delgado; Tania,17,0,35,18
1657330871489,COGS 107A,A01,083627,Boyle; Mary E. T.,13,0,60,47
1657330877515,COGS 118A,A01,083075,Gupta; Anjum,19,0,76,57
1657330883538,CSE 3,A50,083646,Miranda; Gregory Joseph,24,0,50,26
1657330889561,CSE 8A,A50,083650,Miranda; Gregory Joseph,17,1,56,39
1657330895589,CSE 11,A01,083080,Cao; Yingjun,6,15,40,34
1657330901613,CSE 12,A01,083652,Krause-Levy; Sophia Louisa,28,1,120,92
1657330907639,CSE 15L,A01,083654,Morris; Justin Loren,9,0,50,41
1657330907639,CSE 15L,A02,083655,Morris; Justin Loren,9,0,50,41
1657330913663,CSE 20,A01,083657,Tran; Khoa Dang,39,0,80,41
1657330919692,CSE 21,A01,095574,Bach; Quang Tran,22,0,48,26
1657330925716,CSE 30,A01,083084,Eldon; John,4,0,80,76
1657330925716,CSE 30,B01,095061,Bhaskar; Nishant,9,0,50,41
1657330931739,CSE 100,A01,083659,Cao; Yingjun,4,4,70,66
1657330937763,CSE 134B,A01,083661,Powell; Thomas Allan,22,0,100,78
1657330943791,CSE 140,A01,083663,Gungor; Onat,14,0,85,71
1657330949815,CSE 140L,A01,083088,Eldon; John,21,0,100,79
1657330955842,CSE 175,A01,083665,Kumar; Rakesh,3,0,25,22
1657330961867,CSE 190,A00,092507,Dubnov; Shlomo,7,0,20,13
1657330967894,ECE 45,A01,083139,Congero; Spencer William,6,0,75,69
1657330973920,ECE 65,A50,083695,Saad; Andrew S,12,0,30,18
1657330973920,ECE 65,A51,095125,Saad; Andrew S,24,0,26,2
1657330979947,ECE 109,A01,091882,Touri; Behrouz,19,0,70,51
1657330985969,ECE 180,A00,083140,Abi Samra; Nicholas Camill,1,0,30,29
1657330985969,ECE 180,B00,083141,Abi Samra; Nicholas Camill,0,0,30,30
1657330991993,MATH 10A,A01,083735,Patchell; Gregory David,2,0,30,28
1657330991993,MATH 10A,A02,083736,Patchell; Gregory David,20,0,30,10
1657330991993,MATH 10A,A03,083737,Patchell; Gregory David,16,0,30,14
1657330998021,MATH 10B,A01,083207,Lim; Seonhee,7,0,34,27
1657330998021,MATH 10B,A02,083208,Lim; Seonhee,9,0,35,26
1657330998021,MATH 10B,A03,093472,Lim; Seonhee,7,0,34,27
1657330998021,MATH 10B,B01,083739,Sinha; Shubham,12,0,30,18
1657331004044,MATH 18,A01,083743,Cinel; Cameron Alexander,6,0,30,24
1657331004044,MATH 18,A02,083744,Cinel; Cameron Alexander,17,0,30,13
1657331004044,MATH 18,A03,083745,Cinel; Cameron Alexander,9,0,30,21
1657331004044,MATH 18,B01,083748,Rideout; David Porter,4,0,37,33
1657331004044,MATH 18,B02,083749,Rideout; David Porter,5,0,36,31
1657331004044,MATH 18,B03,083750,Rideout; David Porter,3,0,37,34
1657331004044,MATH 18,B04,083751,Rideout; David Porter,6,0,36,30
1657331004044,MATH 18,B05,093473,Rideout; David Porter,6,0,36,30
1657331004044,MATH 18,B06,093474,Rideout; David Porter,6,0,36,30
1657331010069,MATH 20A,A01,083754,Zheng; Zequn,14,0,40,26
1657331016095,MATH 20B,A01,083756,Briones; Jor-el Thomas Caparas,4,0,36,32
1657331016095,MATH 20B,A02,083757,Briones; Jor-el Thomas Caparas,1,0,36,35
1657331016095,MATH 20B,A03,093475,Briones; Jor-el Thomas Caparas,2,0,36,34
1657331022124,MATH 20C,A01,083760,Briones; Jor-el Thomas Caparas,1,0,35,34
1657331022124,MATH 20C,A02,083761,Briones; Jor-el Thomas Caparas,8,0,35,27
1657331022124,MATH 20C,A03,093476,Briones; Jor-el Thomas Caparas,0,1,36,36
1657331022124,MATH 20C,B01,083762,Bach; Quang Tran,1,0,30,29
1657331028151,MATH 20D,A01,083765,Tran; Brian Kha,5,0,30,25
1657331028151,MATH 20D,A02,083766,Tran; Brian Kha,5,0,30,25
1657331028151,MATH 20D,A03,083767,Tran; Brian Kha,4,0,30,26
1657331034179,MATH 20E,A01,083771,Ganguly; Soumya,7,0,32,25
1657331034179,MATH 20E,A02,083772,Ganguly; Soumya,6,0,32,26
1657331034179,MATH 20E,B01,083773,Ciotti; Benjamin,20,0,35,15
1657331034179,MATH 20E,B02,083774,Ciotti; Benjamin,17,0,35,18
1657331040214,MATH 103A,A01,083777,Greenfeld; Be'Eri,3,0,36,33
1657331040214,MATH 103A,A02,083778,Greenfeld; Be'Eri,5,0,36,31
1657331040214,MATH 103A,A03,093561,Greenfeld; Be'Eri,4,0,36,32
1657331040214,MATH 103A,B01,083779,Greenfeld; Be'Eri,6,0,36,30
1657331040214,MATH 103A,B02,083780,Greenfeld; Be'Eri,4,0,36,32
1657331040214,MATH 103A,B03,093562,Greenfeld; Be'Eri,3,0,36,33
1657331046238,MATH 105,A01,085443,Carter; Anne Toulson,15,0,35,20
1657331046238,MATH 105,A02,093477,Carter; Anne Toulson,20,0,35,15
1657331052270,MATH 109,A01,083213,Ganzberger; Geoffrey Michael,2,0,34,32
1657331052270,MATH 109,A02,083214,Ganzberger; Geoffrey Michael,4,0,34,30
1657331052270,MATH 109,A03,093478,Ganzberger; Geoffrey Michael,2,0,34,32
1657331052270,MATH 109,B01,083215,Ganzberger; Geoffrey Michael,1,0,32,31
1657331052270,MATH 109,B02,083216,Ganzberger; Geoffrey Michael,1,0,32,31
1657331052270,MATH 109,B03,093479,Ganzberger; Geoffrey Michael,8,0,32,24
1657331058295,MATH 142A,A01,083219,Chow; Bennett,7,0,32,25
1657331058295,MATH 142A,A02,083220,Chow; Bennett,10,0,32,22
1657331058295,MATH 142A,A03,093480,Chow; Bennett,7,0,32,25
1657331058295,MATH 142A,B03,093481,Chow; Bennett,8,0,32,24
1657331058295,MATH 142A,B04,093558,Chow; Bennett,13,0,32,19
1657331058295,MATH 142A,B05,093559,Chow; Bennett,6,0,32,26
1657331064333,MATH 193A,A01,083224,Rotar; Vladimir,7,0,34,27
1657331064333,MATH 193A,A02,083225,Rotar; Vladimir,7,0,34,27
1657331064333,MATH 193A,A03,083781,Rotar; Vladimir,3,0,34,31
1657331064333,MATH 193A,A04,083782,Rotar; Vladimir,8,0,34,26
1657331064333,MATH 193A,A05,093482,Rotar; Vladimir,9,0,34,25
1657331070363,MATH 197,001,091859,McAuley; Julian John,9999,0,9999,0
1657331070363,MATH 197,002,095566,Kedlaya; Kiran S.,9997,0,9999,2
1657331070363,MATH 197,003,095567,Xiao; Ming,9999,0,9999,0
1657331070363,MATH 197,004,095571,Perols; Johan Lars,9998,0,9999,1
1657331077428,COGS 9,A01,083615,Shannon; Kyle Michael,8,0,75,67
1657331083454,COGS 11,A01,083617,Boyle; Mary E. T.,22,0,48,26
1657331089478,COGS 13,A01,083071,Bastos; Amalia Pinkusfeld,11,0,71,60
1657331095501,COGS 14A,A01,092681,Semenuks; Arturs,3,1,100,97
1657331101529,COGS 14B,A01,083073,Cheng; Tzu-Han,6,0,63,57
1657331107550,COGS 17,A01,092677,Semenuks; Arturs,6,0,81,75
1657331113573,COGS 100,A01,083619,Allen; Michael Gordon,16,0,70,54
1657331119595,COGS 101A,A01,083621,Davis; Joshua Daniel,9,0,68,59
1657331125620,COGS 101B,A01,091572,Allen; Michael Gordon,11,0,65,54
1657331131643,COGS 101C,A01,083625,Delgado; Tania,17,0,35,18
1657331137665,COGS 107A,A01,083627,Boyle; Mary E. T.,13,0,60,47
1657331143687,COGS 118A,A01,083075,Gupta; Anjum,19,0,76,57
1657331149711,CSE 3,A50,083646,Miranda; Gregory Joseph,24,0,50,26
1657331155735,CSE 8A,A50,083650,Miranda; Gregory Joseph,17,1,56,39
1657331161759,CSE 11,A01,083080,Cao; Yingjun,6,15,40,34
1657331167782,CSE 12,A01,083652,Krause-Levy; Sophia Louisa,28,1,120,92
1657331173805,CSE 15L,A01,083654,Morris; Justin Loren,9,0,50,41
1657331173805,CSE 15L,A02,083655,Morris; Justin Loren,9,0,50,41
1657331179834,CSE 20,A01,083657,Tran; Khoa Dang,39,0,80,41
1657331185862,CSE 21,A01,095574,Bach; Quang Tran,22,0,48,26
1657331191889,CSE 30,A01,083084,Eldon; John,4,0,80,76
1657331191889,CSE 30,B01,095061,Bhaskar; Nishant,9,0,50,41
1657331197913,CSE 100,A01,083659,Cao; Yingjun,4,4,70,66
1657331203939,CSE 134B,A01,083661,Powell; Thomas Allan,22,0,100,78
1657331209965,CSE 140,A01,083663,Gungor; Onat,14,0,85,71
1657331215988,CSE 140L,A01,083088,Eldon; John,21,0,100,79
1657331222014,CSE 175,A01,083665,Kumar; Rakesh,3,0,25,22
1657331228035,CSE 190,A00,092507,Dubnov; Shlomo,7,0,20,13
1657331234059,ECE 45,A01,083139,Congero; Spencer William,6,0,75,69
1657331240082,ECE 65,A50,083695,Saad; Andrew S,12,0,30,18
1657331240082,ECE 65,A51,095125,Saad; Andrew S,24,0,26,2
1657331246120,ECE 109,A01,091882,Touri; Behrouz,19,0,70,51
1657331252143,ECE 180,A00,083140,Abi Samra; Nicholas Camill,1,0,30,29
1657331252143,ECE 180,B00,083141,Abi Samra; Nicholas Camill,0,0,30,30
1657331258171,MATH 10A,A01,083735,Patchell; Gregory David,2,0,30,28
1657331258171,MATH 10A,A02,083736,Patchell; Gregory David,20,0,30,10
1657331258171,MATH 10A,A03,083737,Patchell; Gregory David,16,0,30,14
1657331264194,MATH 10B,A01,083207,Lim; Seonhee,7,0,34,27
1657331264194,MATH 10B,A02,083208,Lim; Seonhee,9,0,35,26
1657331264194,MATH 10B,A03,093472,Lim; Seonhee,7,0,34,27
1657331264194,MATH 10B,B01,083739,Sinha; Shubham,12,0,30,18
1657331270218,MATH 18,A01,083743,Cinel; Cameron Alexander,6,0,30,24
1657331270218,MATH 18,A02,083744,Cinel; Cameron Alexander,17,0,30,13
1657331270218,MATH 18,A03,083745,Cinel; Cameron Alexander,9,0,30,21
1657331270218,MATH 18,B01,083748,Rideout; David Porter,4,0,37,33
1657331270218,MATH 18,B02,083749,Rideout; David Porter,5,0,36,31
1657331270218,MATH 18,B03,083750,Rideout; David Porter,3,0,37,34
1657331270218,MATH 18,B04,083751,Rideout; David Porter,6,0,36,30
1657331270218,MATH 18,B05,093473,Rideout; David Porter,6,0,36,30
1657331270218,MATH 18,B06,093474,Rideout; David Porter,6,0,36,30
1657331276246,MATH 20A,A01,083754,Zheng; Zequn,14,0,40,26
1657331282270,MATH 20B,A01,083756,Briones; Jor-el Thomas Caparas,4,0,36,32
1657331282270,MATH 20B,A02,083757,Briones; Jor-el Thomas Caparas,1,0,36,35
1657331282270,MATH 20B,A03,093475,Briones; Jor-el Thomas Caparas,2,0,36,34
1657331288294,MATH 20C,A01,083760,Briones; Jor-el Thomas Caparas,1,0,35,34
1657331288294,MATH 20C,A02,083761,Briones; Jor-el Thomas Caparas,8,0,35,27
1657331288294,MATH 20C,A03,093476,Briones; Jor-el Thomas Caparas,0,1,36,36
1657331288294,MATH 20C,B01,083762,Bach; Quang Tran,1,0,30,29
1657331294323,MATH 20D,A01,083765,Tran; Brian Kha,5,0,30,25
1657331294323,MATH 20D,A02,083766,Tran; Brian Kha,5,0,30,25
1657331294323,MATH 20D,A03,083767,Tran; Brian Kha,4,0,30,26
1657331300352,MATH 20E,A01,083771,Ganguly; Soumya,7,0,32,25
1657331300352,MATH 20E,A02,083772,Ganguly; Soumya,6,0,32,26
1657331300352,MATH 20E,B01,083773,Ciotti; Benjamin,20,0,35,15
1657331300352,MATH 20E,B02,083774,Ciotti; Benjamin,17,0,35,18
1657331306383,MATH 103A,A01,083777,Greenfeld; Be'Eri,3,0,36,33
1657331306383,MATH 103A,A02,083778,Greenfeld; Be'Eri,5,0,36,31
1657331306383,MATH 103A,A03,093561,Greenfeld; Be'Eri,4,0,36,32
1657331306383,MATH 103A,B01,083779,Greenfeld; Be'Eri,6,0,36,30
1657331306383,MATH 103A,B02,083780,Greenfeld; Be'Eri,4,0,36,32
1657331306383,MATH 103A,B03,093562,Greenfeld; Be'Eri,3,0,36,33
1657331312415,MATH 105,A01,085443,Carter; Anne Toulson,15,0,35,20
1657331312415,MATH 105,A02,093477,Carter; Anne Toulson,20,0,35,15
1657331318443,MATH 109,A01,083213,Ganzberger; Geoffrey Michael,2,0,34,32
1657331318443,MATH 109,A02,083214,Ganzberger; Geoffrey Michael,4,0,34,30
1657331318443,MATH 109,A03,093478,Ganzberger; Geoffrey Michael,2,0,34,32
1657331318443,MATH 109,B01,083215,Ganzberger; Geoffrey Michael,1,0,32,31
1657331318443,MATH 109,B02,083216,Ganzberger; Geoffrey Michael,1,0,32,31
1657331318443,MATH 109,B03,093479,Ganzberger; Geoffrey Michael,8,0,32,24
1657331324471,MATH 142A,A01,083219,Chow; Bennett,7,0,32,25
1657331324471,MATH 142A,A02,083220,Chow; Bennett,10,0,32,22
1657331324471,MATH 142A,A03,093480,Chow; Bennett,7,0,32,25
1657331324471,MATH 142A,B03,093481,Chow; Bennett,8,0,32,24
1657331324471,MATH 142A,B04,093558,Chow; Bennett,13,0,32,19
1657331324471,MATH 142A,B05,093559,Chow; Bennett,6,0,32,26
1657331330496,MATH 193A,A01,083224,Rotar; Vladimir,7,0,34,27
1657331330496,MATH 193A,A02,083225,Rotar; Vladimir,7,0,34,27
1657331330496,MATH 193A,A03,083781,Rotar; Vladimir,3,0,34,31
1657331330496,MATH 193A,A04,083782,Rotar; Vladimir,9,0,34,25
1657331330496,MATH 193A,A05,093482,Rotar; Vladimir,9,0,34,25
1657331336521,MATH 197,001,091859,McAuley; Julian John,9999,0,9999,0
1657331336521,MATH 197,002,095566,Kedlaya; Kiran S.,9997,0,9999,2
1657331336521,MATH 197,003,095567,Xiao; Ming,9999,0,9999,0
1657331336521,MATH 197,004,095571,Perols; Johan Lars,9998,0,9999,1
1657331343583,COGS 9,A01,083615,Shannon; Kyle Michael,8,0,75,67
1657331349611,COGS 11,A01,083617,Boyle; Mary E. T.,22,0,48,26
1657331355635,COGS 13,A01,083071,Bastos; Amalia Pinkusfeld,11,0,71,60
1657331361658,COGS 14A,A01,092681,Semenuks; Arturs,3,1,100,97
1657331367685,COGS 14B,A01,083073,Cheng; Tzu-Han,6,0,63,57
1657331373709,COGS 17,A01,092677,Semenuks; Arturs,6,0,81,75
1657331379736,COGS 100,A01,083619,Allen; Michael Gordon,16,0,70,54
1657331385761,COGS 101A,A01,083621,Davis; Joshua Daniel,9,0,68,59
1657331391787,COGS 101B,A01,091572,Allen; Michael Gordon,11,0,65,54
1657331397814,COGS 101C,A01,083625,Delgado; Tania,17,0,35,18
1657331403837,COGS 107A,A01,083627,Boyle; Mary E. T.,13,0,60,47
1657331409865,COGS 118A,A01,083075,Gupta; Anjum,19,0,76,57
1657331415891,CSE 3,A50,083646,Miranda; Gregory Joseph,24,0,50,26
1657331421919,CSE 8A,A50,083650,Miranda; Gregory Joseph,17,1,56,39
1657331427945,CSE 11,A01,083080,Cao; Yingjun,6,15,40,34
1657331433971,CSE 12,A01,083652,Krause-Levy; Sophia Louisa,28,1,120,92
1657331439996,CSE 15L,A01,083654,Morris; Justin Loren,9,0,50,41
1657331439996,CSE 15L,A02,083655,Morris; Justin Loren,9,0,50,41
1657331446026,CSE 20,A01,083657,Tran; Khoa Dang,39,0,80,41
1657331452050,CSE 21,A01,095574,Bach; Quang Tran,22,0,48,26
1657331458155,CSE 30,A01,083084,Eldon; John,4,0,80,76
1657331458155,CSE 30,B01,095061,Bhaskar; Nishant,9,0,50,41
1657331464177,CSE 100,A01,083659,Cao; Yingjun,4,4,70,66
1657331470199,CSE 134B,A01,083661,Powell; Thomas Allan,22,0,100,78
1657331476246,CSE 140,A01,083663,Gungor; Onat,14,0,85,71
1657331482267,CSE 140L,A01,083088,Eldon; John,21,0,100,79
1657331488290,CSE 175,A01,083665,Kumar; Rakesh,3,0,25,22
1657331494316,CSE 190,A00,092507,Dubnov; Shlomo,7,0,20,13
1657331500344,ECE 45,A01,083139,Congero; Spencer William,6,0,75,69
1657331506372,ECE 65,A50,083695,Saad; Andrew S,12,0,30,18
1657331506372,ECE 65,A51,095125,Saad; Andrew S,24,0,26,2
1657331512396,ECE 109,A01,091882,Touri; Behrouz,19,0,70,51
1657331518423,ECE 180,A00,083140,Abi Samra; Nicholas Camill,1,0,30,29
1657331518423,ECE 180,B00,083141,Abi Samra; Nicholas Camill,0,0,30,30
1657331524452,MATH 10A,A01,083735,Patchell; Gregory David,2,0,30,28
1657331524452,MATH 10A,A02,083736,Patchell; Gregory David,20,0,30,10
1657331524452,MATH 10A,A03,083737,Patchell; Gregory David,16,0,30,14
1657331530478,MATH 10B,A01,083207,Lim; Seonhee,7,0,34,27
1657331530478,MATH 10B,A02,083208,Lim; Seonhee,9,0,35,26
1657331530478,MATH 10B,A03,093472,Lim; Seonhee,7,0,34,27
1657331530478,MATH 10B,B01,083739,Sinha; Shubham,12,0,30,18
1657331536503,MATH 18,A01,083743,Cinel; Cameron Alexander,6,0,30,24
1657331536503,MATH 18,A02,083744,Cinel; Cameron Alexander,17,0,30,13
1657331536503,MATH 18,A03,083745,Cinel; Cameron Alexander,9,0,30,21
1657331536503,MATH 18,B01,083748,Rideout; David Porter,4,0,37,33
1657331536503,MATH 18,B02,083749,Rideout; David Porter,5,0,36,31
1657331536503,MATH 18,B03,083750,Rideout; David Porter,3,0,37,34
1657331536503,MATH 18,B04,083751,Rideout; David Porter,6,0,36,30
1657331536503,MATH 18,B05,093473,Rideout; David Porter,6,0,36,30
1657331536503,MATH 18,B06,093474,Rideout; David Porter,6,0,36,30
1657331542533,MATH 20A,A01,083754,Zheng; Zequn,14,0,40,26
1657331548560,MATH 20B,A01,083756,Briones; Jor-el Thomas Caparas,4,0,36,32
1657331548560,MATH 20B,A02,083757,Briones; Jor-el Thomas Caparas,1,0,36,35
1657331548560,MATH 20B,A03,093475,Briones; Jor-el Thomas Caparas,2,0,36,34
1657331554582,MATH 20C,A01,083760,Briones; Jor-el Thomas Caparas,1,0,35,34
1657331554582,MATH 20C,A02,083761,Briones; Jor-el Thomas Caparas,8,0,35,27
1657331554582,MATH 20C,A03,093476,Briones; Jor-el Thomas Caparas,0,1,36,36
1657331554582,MATH 20C,B01,083762,Bach; Quang Tran,1,0,30,29
1657331560611,MATH 20D,A01,083765,Tran; Brian Kha,5,0,30,25
1657331560611,MATH 20D,A02,083766,Tran; Brian Kha,5,0,30,25
1657331560611,MATH 20D,A03,083767,Tran; Brian Kha,4,0,30,26
1657331566633,MATH 20E,A01,083771,Ganguly; Soumya,7,0,32,25
1657331566633,MATH 20E,A02,083772,Ganguly; Soumya,6,0,32,26
1657331566633,MATH 20E,B01,083773,Ciotti; Benjamin,20,0,35,15
1657331566633,MATH 20E,B02,083774,Ciotti; Benjamin,17,0,35,18
1657331572657,MATH 103A,A01,083777,Greenfeld; Be'Eri,3,0,36,33
1657331572657,MATH 103A,A02,083778,Greenfeld; Be'Eri,5,0,36,31
1657331572657,MATH 103A,A03,093561,Greenfeld; Be'Eri,4,0,36,32
1657331572657,MATH 103A,B01,083779,Greenfeld; Be'Eri,6,0,36,30
1657331572657,MATH 103A,B02,083780,Greenfeld; Be'Eri,4,0,36,32
1657331572657,MATH 103A,B03,093562,Greenfeld; Be'Eri,3,0,36,33
1657331578681,MATH 105,A01,085443,Carter; Anne Toulson,15,0,35,20
1657331578681,MATH 105,A02,093477,Carter; Anne Toulson,20,0,35,15
1657331584704,MATH 109,A01,083213,Ganzberger; Geoffrey Michael,2,0,34,32
1657331584704,MATH 109,A02,083214,Ganzberger; Geoffrey Michael,4,0,34,30
1657331584704,MATH 109,A03,093478,Ganzberger; Geoffrey Michael,2,0,34,32
1657331584704,MATH 109,B01,083215,Ganzberger; Geoffrey Michael,1,0,32,31
1657331584704,MATH 109,B02,083216,Ganzberger; Geoffrey Michael,1,0,32,31
1657331584704,MATH 109,B03,093479,Ganzberger; Geoffrey Michael,8,0,32,24
1657331590728,MATH 142A,A01,083219,Chow; Bennett,7,0,32,25
1657331590728,MATH 142A,A02,083220,Chow; Bennett,10,0,32,22
1657331590728,MATH 142A,A03,093480,Chow; Bennett,7,0,32,25
1657331590728,MATH 142A,B03,093481,Chow; Bennett,8,0,32,24
1657331590728,MATH 142A,B04,093558,Chow; Bennett,13,0,32,19
1657331590728,MATH 142A,B05,093559,Chow; Bennett,6,0,32,26
1657331596749,MATH 193A,A01,083224,Rotar; Vladimir,7,0,34,27
1657331596749,MATH 193A,A02,083225,Rotar; Vladimir,7,0,34,27
1657331596749,MATH 193A,A03,083781,Rotar; Vladimir,3,0,34,31
1657331596749,MATH 193A,A04,083782,Rotar; Vladimir,9,0,34,25
1657331596749,MATH 193A,A05,093482,Rotar; Vladimir,9,0,34,25
1657331602771,MATH 197,001,091859,McAuley; Julian John,9999,0,9999,0
1657331602771,MATH 197,002,095566,Kedlaya; Kiran S.,9997,0,9999,2
1657331602771,MATH 197,003,095567,Xiao; Ming,9999,0,9999,0
1657331602771,MATH 197,004,095571,Perols; Johan Lars,9998,0,9999,1
1657331609851,COGS 9,A01,083615,Shannon; Kyle Michael,8,0,75,67
1657331615878,COGS 11,A01,083617,Boyle; Mary E. T.,22,0,48,26
1657331621904,COGS 13,A01,083071,Bastos; Amalia Pinkusfeld,11,0,71,60
1657331627927,COGS 14A,A01,092681,Semenuks; Arturs,3,1,100,97
1657331633949,COGS 14B,A01,083073,Cheng; Tzu-Han,6,0,63,57
1657331639974,COGS 17,A01,092677,Semenuks; Arturs,6,0,81,75
1657331645997,COGS 100,A01,083619,Allen; Michael Gordon,16,0,70,54
1657331652025,COGS 101A,A01,083621,Davis; Joshua Daniel,9,0,68,59
1657331658049,COGS 101B,A01,091572,Allen; Michael Gordon,11,0,65,54
1657331664072,COGS 101C,A01,083625,Delgado; Tania,17,0,35,18
1657331670096,COGS 107A,A01,083627,Boyle; Mary E. T.,13,0,60,47
1657331676124,COGS 118A,A01,083075,Gupta; Anjum,19,0,76,57
1657331682149,CSE 3,A50,083646,Miranda; Gregory Joseph,24,0,50,26
1657331688183,CSE 8A,A50,083650,Miranda; Gregory Joseph,17,1,56,39
1657331694210,CSE 11,A01,083080,Cao; Yingjun,6,15,40,34
1657331700234,CSE 12,A01,083652,Krause-Levy; Sophia Louisa,28,1,120,92
1657331706272,CSE 15L,A01,083654,Morris; Justin Loren,9,0,50,41
1657331706272,CSE 15L,A02,083655,Morris; Justin Loren,9,0,50,41
1657331712302,CSE 20,A01,083657,Tran; Khoa Dang,39,0,80,41
1657331718329,CSE 21,A01,095574,Bach; Quang Tran,22,0,48,26
1657331724352,CSE 30,A01,083084,Eldon; John,4,0,80,76
1657331724352,CSE 30,B01,095061,Bhaskar; Nishant,9,0,50,41
1657331730373,CSE 100,A01,083659,Cao; Yingjun,4,4,70,66
1657331736400,CSE 134B,A01,083661,Powell; Thomas Allan,22,0,100,78
1657331742430,CSE 140,A01,083663,Gungor; Onat,14,0,85,71
1657331748452,CSE 140L,A01,083088,Eldon; John,21,0,100,79
1657331754478,CSE 175,A01,083665,Kumar; Rakesh,3,0,25,22
1657331760499,CSE 190,A00,092507,Dubnov; Shlomo,7,0,20,13
1657331766526,ECE 45,A01,083139,Congero; Spencer William,6,0,75,69
1657331772552,ECE 65,A50,083695,Saad; Andrew S,12,0,30,18
1657331772552,ECE 65,A51,095125,Saad; Andrew S,24,0,26,2
1657331778574,ECE 109,A01,091882,Touri; Behrouz,19,0,70,51
1657331784601,ECE 180,A00,083140,Abi Samra; Nicholas Camill,1,0,30,29
1657331784601,ECE 180,B00,083141,Abi Samra; Nicholas Camill,0,0,30,30
1657331790623,MATH 10A,A01,083735,Patchell; Gregory David,2,0,30,28
1657331790623,MATH 10A,A02,083736,Patchell; Gregory David,20,0,30,10
1657331790623,MATH 10A,A03,083737,Patchell; Gregory David,16,0,30,14
1657331796651,MATH 10B,A01,083207,Lim; Seonhee,7,0,34,27
1657331796651,MATH 10B,A02,083208,Lim; Seonhee,9,0,35,26
1657331796651,MATH 10B,A03,093472,Lim; Seonhee,7,0,34,27
1657331796651,MATH 10B,B01,083739,Sinha; Shubham,12,0,30,18
1657331802678,MATH 18,A01,083743,Cinel; Cameron Alexander,6,0,30,24
1657331802678,MATH 18,A02,083744,Cinel; Cameron Alexander,17,0,30,13
1657331802678,MATH 18,A03,083745,Cinel; Cameron Alexander,9,0,30,21
1657331802678,MATH 18,B01,083748,Rideout; David Porter,4,0,37,33
1657331802678,MATH 18,B02,083749,Rideout; David Porter,5,0,36,31
1657331802678,MATH 18,B03,083750,Rideout; David Porter,3,0,37,34
1657331802678,MATH 18,B04,083751,Rideout; David Porter,6,0,36,30
1657331802678,MATH 18,B05,093473,Rideout; David Porter,6,0,36,30
1657331802678,MATH 18,B06,093474,Rideout; David Porter,6,0,36,30
1657331808704,MATH 20A,A01,083754,Zheng; Zequn,14,0,40,26
1657331814743,MATH 20B,A01,083756,Briones; Jor-el Thomas Caparas,4,0,36,32
1657331814743,MATH 20B,A02,083757,Briones; Jor-el Thomas Caparas,1,0,36,35
1657331814743,MATH 20B,A03,093475,Briones; Jor-el Thomas Caparas,2,0,36,34
1657331820776,MATH 20C,A01,083760,Briones; Jor-el Thomas Caparas,1,0,35,34
1657331820776,MATH 20C,A02,083761,Briones; Jor-el Thomas Caparas,8,0,35,27
1657331820776,MATH 20C,A03,093476,Briones; Jor-el Thomas Caparas,0,1,36,36
1657331820776,MATH 20C,B01,083762,Bach; Quang Tran,1,0,30,29
1657331826799,MATH 20D,A01,083765,Tran; Brian Kha,5,0,30,25
1657331826799,MATH 20D,A02,083766,Tran; Brian Kha,5,0,30,25
1657331826799,MATH 20D,A03,083767,Tran; Brian Kha,4,0,30,26
1657331832842,MATH 20E,A01,083771,Ganguly; Soumya,7,0,32,25
1657331832842,MATH 20E,A02,083772,Ganguly; Soumya,6,0,32,26
1657331832842,MATH 20E,B01,083773,Ciotti; Benjamin,20,0,35,15
1657331832842,MATH 20E,B02,083774,Ciotti; Benjamin,17,0,35,18
1657331838864,MATH 103A,A01,083777,Greenfeld; Be'Eri,3,0,36,33
1657331838864,MATH 103A,A02,083778,Greenfeld; Be'Eri,5,0,36,31
1657331838864,MATH 103A,A03,093561,Greenfeld; Be'Eri,4,0,36,32
1657331838864,MATH 103A,B01,083779,Greenfeld; Be'Eri,6,0,36,30
1657331838864,MATH 103A,B02,083780,Greenfeld; Be'Eri,4,0,36,32
1657331838864,MATH 103A,B03,093562,Greenfeld; Be'Eri,3,0,36,33
1657331844886,MATH 105,A01,085443,Carter; Anne Toulson,15,0,35,20
1657331844886,MATH 105,A02,093477,Carter; Anne Toulson,20,0,35,15
1657331850915,MATH 109,A01,083213,Ganzberger; Geoffrey Michael,2,0,34,32
1657331850915,MATH 109,A02,083214,Ganzberger; Geoffrey Michael,4,0,34,30
1657331850915,MATH 109,A03,093478,Ganzberger; Geoffrey Michael,2,0,34,32
1657331850915,MATH 109,B01,083215,Ganzberger; Geoffrey Michael,1,0,32,31
1657331850915,MATH 109,B02,083216,Ganzberger; Geoffrey Michael,1,0,32,31
1657331850915,MATH 109,B03,093479,Ganzberger; Geoffrey Michael,8,0,32,24
1657331856943,MATH 142A,A01,083219,Chow; Bennett,7,0,32,25
1657331856943,MATH 142A,A02,083220,Chow; Bennett,10,0,32,22
1657331856943,MATH 142A,A03,093480,Chow; Bennett,7,0,32,25
1657331856943,MATH 142A,B03,093481,Chow; Bennett,8,0,32,24
1657331856943,MATH 142A,B04,093558,Chow; Bennett,13,0,32,19
1657331856943,MATH 142A,B05,093559,Chow; Bennett,6,0,32,26
1657331862968,MATH 193A,A01,083224,Rotar; Vladimir,7,0,34,27
1657331862968,MATH 193A,A02,083225,Rotar; Vladimir,7,0,34,27
1657331862968,MATH 193A,A03,083781,Rotar; Vladimir,3,0,34,31
1657331862968,MATH 193A,A04,083782,Rotar; Vladimir,9,0,34,25
1657331862968,MATH 193A,A05,093482,Rotar; Vladimir,9,0,34,25
1657331868994,MATH 197,001,091859,McAuley; Julian John,9999,0,9999,0
1657331868994,MATH 197,002,095566,Kedlaya; Kiran S.,9997,0,9999,2
1657331868994,MATH 197,003,095567,Xiao; Ming,9999,0,9999,0
1657331868994,MATH 197,004,095571,Perols; Johan Lars,9998,0,9999,1
1657331876058,COGS 9,A01,083615,Shannon; Kyle Michael,8,0,75,67
1657331882088,COGS 11,A01,083617,Boyle; Mary E. T.,22,0,48,26
1657331888112,COGS 13,A01,083071,Bastos; Amalia Pinkusfeld,11,0,71,60
1657331894136,COGS 14A,A01,092681,Semenuks; Arturs,3,1,100,97
1657331900161,COGS 14B,A01,083073,Cheng; Tzu-Han,6,0,63,57
1657331906187,COGS 17,A01,092677,Semenuks; Arturs,6,0,81,75
1657331912210,COGS 100,A01,083619,Allen; Michael Gordon,16,0,70,54
1657331918234,COGS 101A,A01,083621,Davis; Joshua Daniel,9,0,68,59
1657331924267,COGS 101B,A01,091572,Allen; Michael Gordon,11,0,65,54
1657331930293,COGS 101C,A01,083625,Delgado; Tania,17,0,35,18
1657331936330,COGS 107A,A01,083627,Boyle; Mary E. T.,13,0,60,47
1657331942353,COGS 118A,A01,083075,Gupta; Anjum,19,0,76,57
1657331948377,CSE 3,A50,083646,Miranda; Gregory Joseph,24,0,50,26
1657331954404,CSE 8A,A50,083650,Miranda; Gregory Joseph,17,1,56,39
1657331960430,CSE 11,A01,083080,Cao; Yingjun,6,15,40,34
1657331966463,CSE 12,A01,083652,Krause-Levy; Sophia Louisa,28,1,120,92
1657331972490,CSE 15L,A01,083654,Morris; Justin Loren,9,0,50,41
1657331972490,CSE 15L,A02,083655,Morris; Justin Loren,9,0,50,41
1657331978516,CSE 20,A01,083657,Tran; Khoa Dang,39,0,80,41
1657331984544,CSE 21,A01,095574,Bach; Quang Tran,22,0,48,26
1657331990566,CSE 30,A01,083084,Eldon; John,4,0,80,76
1657331990566,CSE 30,B01,095061,Bhaskar; Nishant,9,0,50,41
1657331996622,CSE 100,A01,083659,Cao; Yingjun,4,4,70,66
1657332002645,CSE 134B,A01,083661,Powell; Thomas Allan,22,0,100,78
1657332008672,CSE 140,A01,083663,Gungor; Onat,14,0,85,71
1657332014694,CSE 140L,A01,083088,Eldon; John,21,0,100,79
1657332020715,CSE 175,A01,083665,Kumar; Rakesh,3,0,25,22
1657332026742,CSE 190,A00,092507,Dubnov; Shlomo,7,0,20,13
1657332032769,ECE 45,A01,083139,Congero; Spencer William,6,0,75,69
1657332038793,ECE 65,A50,083695,Saad; Andrew S,12,0,30,18
1657332038793,ECE 65,A51,095125,Saad; Andrew S,24,0,26,2
1657332044819,ECE 109,A01,091882,Touri; Behrouz,19,0,70,51
1657332050840,ECE 180,A00,083140,Abi Samra; Nicholas Camill,1,0,30,29
1657332050840,ECE 180,B00,083141,Abi Samra; Nicholas Camill,0,0,30,30
1657332056937,MATH 10A,A01,083735,Patchell; Gregory David,2,0,30,28
1657332056937,MATH 10A,A02,083736,Patchell; Gregory David,20,0,30,10
1657332056937,MATH 10A,A03,083737,Patchell; Gregory David,16,0,30,14
1657332062960,MATH 10B,A01,083207,Lim; Seonhee,7,0,34,27
1657332062960,MATH 10B,A02,083208,Lim; Seonhee,9,0,35,26
1657332062960,MATH 10B,A03,093472,Lim; Seonhee,7,0,34,27
1657332062960,MATH 10B,B01,083739,Sinha; Shubham,12,0,30,18
1657332068993,MATH 18,A01,083743,Cinel; Cameron Alexander,6,0,30,24
1657332068993,MATH 18,A02,083744,Cinel; Cameron Alexander,17,0,30,13
1657332068993,MATH 18,A03,083745,Cinel; Cameron Alexander,9,0,30,21
1657332068993,MATH 18,B01,083748,Rideout; David Porter,4,0,37,33
1657332068993,MATH 18,B02,083749,Rideout; David Porter,5,0,36,31
1657332068993,MATH 18,B03,083750,Rideout; David Porter,3,0,37,34
1657332068993,MATH 18,B04,083751,Rideout; David Porter,6,0,36,30
1657332068993,MATH 18,B05,093473,Rideout; David Porter,6,0,36,30
1657332068993,MATH 18,B06,093474,Rideout; David Porter,6,0,36,30
1657332075016,MATH 20A,A01,083754,Zheng; Zequn,14,0,40,26
1657332081042,MATH 20B,A01,083756,Briones; Jor-el Thomas Caparas,4,0,36,32
1657332081042,MATH 20B,A02,083757,Briones; Jor-el Thomas Caparas,1,0,36,35
1657332081042,MATH 20B,A03,093475,Briones; Jor-el Thomas Caparas,2,0,36,34
1657332087073,MATH 20C,A01,083760,Briones; Jor-el Thomas Caparas,1,0,35,34
1657332087073,MATH 20C,A02,083761,Briones; Jor-el Thomas Caparas,8,0,35,27
1657332087073,MATH 20C,A03,093476,Briones; Jor-el Thomas Caparas,0,1,36,36
1657332087073,MATH 20C,B01,083762,Bach; Quang Tran,1,0,30,29
1657332093097,MATH 20D,A01,083765,Tran; Brian Kha,5,0,30,25
1657332093097,MATH 20D,A02,083766,Tran; Brian Kha,5,0,30,25
1657332093097,MATH 20D,A03,083767,Tran; Brian Kha,4,0,30,26
1657332099119,MATH 20E,A01,083771,Ganguly; Soumya,7,0,32,25
1657332099119,MATH 20E,A02,083772,Ganguly; Soumya,6,0,32,26
1657332099119,MATH 20E,B01,083773,Ciotti; Benjamin,20,0,35,15
1657332099119,MATH 20E,B02,083774,Ciotti; Benjamin,17,0,35,18
1657332105148,MATH 103A,A01,083777,Greenfeld; Be'Eri,3,0,36,33
1657332105148,MATH 103A,A02,083778,Greenfeld; Be'Eri,5,0,36,31
1657332105148,MATH 103A,A03,093561,Greenfeld; Be'Eri,4,0,36,32
1657332105148,MATH 103A,B01,083779,Greenfeld; Be'Eri,6,0,36,30
1657332105148,MATH 103A,B02,083780,Greenfeld; Be'Eri,4,0,36,32
1657332105148,MATH 103A,B03,093562,Greenfeld; Be'Eri,3,0,36,33
1657332111171,MATH 105,A01,085443,Carter; Anne Toulson,15,0,35,20
1657332111171,MATH 105,A02,093477,Carter; Anne Toulson,20,0,35,15
1657332117197,MATH 109,A01,083213,Ganzberger; Geoffrey Michael,2,0,34,32
1657332117197,MATH 109,A02,083214,Ganzberger; Geoffrey Michael,4,0,34,30
1657332117197,MATH 109,A03,093478,Ganzberger; Geoffrey Michael,2,0,34,32
1657332117197,MATH 109,B01,083215,Ganzberger; Geoffrey Michael,1,0,32,31
1657332117197,MATH 109,B02,083216,Ganzberger; Geoffrey Michael,1,0,32,31
1657332117197,MATH 109,B03,093479,Ganzberger; Geoffrey Michael,8,0,32,24
1657332123230,MATH 142A,A01,083219,Chow; Bennett,7,0,32,25
1657332123230,MATH 142A,A02,083220,Chow; Bennett,10,0,32,22
1657332123230,MATH 142A,A03,093480,Chow; Bennett,7,0,32,25
1657332123230,MATH 142A,B03,093481,Chow; Bennett,8,0,32,24
1657332123230,MATH 142A,B04,093558,Chow; Bennett,13,0,32,19
1657332123230,MATH 142A,B05,093559,Chow; Bennett,6,0,32,26
1657332129259,MATH 193A,A01,083224,Rotar; Vladimir,7,0,34,27
1657332129259,MATH 193A,A02,083225,Rotar; Vladimir,7,0,34,27
1657332129259,MATH 193A,A03,083781,Rotar; Vladimir,3,0,34,31
1657332129259,MATH 193A,A04,083782,Rotar; Vladimir,9,0,34,25
1657332129259,MATH 193A,A05,093482,Rotar; Vladimir,9,0,34,25
1657332135299,MATH 197,001,091859,McAuley; Julian John,9999,0,9999,0
1657332135299,MATH 197,002,095566,Kedlaya; Kiran S.,9997,0,9999,2
1657332135299,MATH 197,003,095567,Xiao; Ming,9999,0,9999,0
1657332135299,MATH 197,004,095571,Perols; Johan Lars,9998,0,9999,1
1657332142356,COGS 9,A01,083615,Shannon; Kyle Michael,8,0,75,67
1657332148379,COGS 11,A01,083617,Boyle; Mary E. T.,22,0,48,26
1657332154402,COGS 13,A01,083071,Bastos; Amalia Pinkusfeld,11,0,71,60
1657332160434,COGS 14A,A01,092681,Semenuks; Arturs,3,1,100,97
1657332166456,COGS 14B,A01,083073,Cheng; Tzu-Han,6,0,63,57
1657332172478,COGS 17,A01,092677,Semenuks; Arturs,6,0,81,75
1657332178503,COGS 100,A01,083619,Allen; Michael Gordon,16,0,70,54
1657332184527,COGS 101A,A01,083621,Davis; Joshua Daniel,9,0,68,59
1657332190550,COGS 101B,A01,091572,Allen; Michael Gordon,11,0,65,54
1657332196573,COGS 101C,A01,083625,Delgado; Tania,17,0,35,18
1657332202602,COGS 107A,A01,083627,Boyle; Mary E. T.,13,0,60,47
1657332208628,COGS 118A,A01,083075,Gupta; Anjum,19,0,76,57
1657332214654,CSE 3,A50,083646,Miranda; Gregory Joseph,24,0,50,26
1657332220681,CSE 8A,A50,083650,Miranda; Gregory Joseph,17,1,56,39
1657332226703,CSE 11,A01,083080,Cao; Yingjun,6,15,40,34
1657332232725,CSE 12,A01,083652,Krause-Levy; Sophia Louisa,28,1,120,92
1657332238747,CSE 15L,A01,083654,Morris; Justin Loren,9,0,50,41
1657332238747,CSE 15L,A02,083655,Morris; Justin Loren,9,0,50,41
1657332244774,CSE 20,A01,083657,Tran; Khoa Dang,39,0,80,41
1657332250800,CSE 21,A01,095574,Bach; Quang Tran,22,0,48,26
1657332256823,CSE 30,A01,083084,Eldon; John,4,0,80,76
1657332256823,CSE 30,B01,095061,Bhaskar; Nishant,9,0,50,41
1657332262849,CSE 100,A01,083659,Cao; Yingjun,4,4,70,66
1657332268872,CSE 134B,A01,083661,Powell; Thomas Allan,22,0,100,78
1657332274907,CSE 140,A01,083663,Gungor; Onat,14,0,85,71
1657332280933,CSE 140L,A01,083088,Eldon; John,21,0,100,79
1657332286959,CSE 175,A01,083665,Kumar; Rakesh,3,0,25,22
1657332292981,CSE 190,A00,092507,Dubnov; Shlomo,7,0,20,13
1657332299004,ECE 45,A01,083139,Congero; Spencer William,6,0,75,69
1657332305038,ECE 65,A50,083695,Saad; Andrew S,12,0,30,18
1657332305038,ECE 65,A51,095125,Saad; Andrew S,24,0,26,2
1657332311068,ECE 109,A01,091882,Touri; Behrouz,19,0,70,51
1657332317093,ECE 180,A00,083140,Abi Samra; Nicholas Camill,1,0,30,29
1657332317093,ECE 180,B00,083141,Abi Samra; Nicholas Camill,0,0,30,30
1657332323116,MATH 10A,A01,083735,Patchell; Gregory David,2,0,30,28
1657332323116,MATH 10A,A02,083736,Patchell; Gregory David,20,0,30,10
1657332323116,MATH 10A,A03,083737,Patchell; Gregory David,16,0,30,14
1657332329146,MATH 10B,A01,083207,Lim; Seonhee,7,0,34,27
1657332329146,MATH 10B,A02,083208,Lim; Seonhee,9,0,35,26
1657332329146,MATH 10B,A03,093472,Lim; Seonhee,7,0,34,27
1657332329146,MATH 10B,B01,083739,Sinha; Shubham,12,0,30,18
1657332335172,MATH 18,A01,083743,Cinel; Cameron Alexander,6,0,30,24
1657332335172,MATH 18,A02,083744,Cinel; Cameron Alexander,17,0,30,13
1657332335172,MATH 18,A03,083745,Cinel; Cameron Alexander,9,0,30,21
1657332335172,MATH 18,B01,083748,Rideout; David Porter,4,0,37,33
1657332335172,MATH 18,B02,083749,Rideout; David Porter,5,0,36,31
1657332335172,MATH 18,B03,083750,Rideout; David Porter,3,0,37,34
1657332335172,MATH 18,B04,083751,Rideout; David Porter,6,0,36,30
1657332335172,MATH 18,B05,093473,Rideout; David Porter,6,0,36,30
1657332335172,MATH 18,B06,093474,Rideout; David Porter,6,0,36,30
1657332341195,MATH 20A,A01,083754,Zheng; Zequn,14,0,40,26
1657332347218,MATH 20B,A01,083756,Briones; Jor-el Thomas Caparas,4,0,36,32
1657332347218,MATH 20B,A02,083757,Briones; Jor-el Thomas Caparas,1,0,36,35
1657332347218,MATH 20B,A03,093475,Briones; Jor-el Thomas Caparas,2,0,36,34
1657332353242,MATH 20C,A01,083760,Briones; Jor-el Thomas Caparas,1,0,35,34
1657332353242,MATH 20C,A02,083761,Briones; Jor-el Thomas Caparas,8,0,35,27
1657332353242,MATH 20C,A03,093476,Briones; Jor-el Thomas Caparas,0,1,36,36
1657332353242,MATH 20C,B01,083762,Bach; Quang Tran,1,0,30,29
1657332359264,MATH 20D,A01,083765,Tran; Brian Kha,5,0,30,25
1657332359264,MATH 20D,A02,083766,Tran; Brian Kha,5,0,30,25
1657332359264,MATH 20D,A03,083767,Tran; Brian Kha,4,0,30,26
1657332365292,MATH 20E,A01,083771,Ganguly; Soumya,7,0,32,25
1657332365292,MATH 20E,A02,083772,Ganguly; Soumya,6,0,32,26
1657332365292,MATH 20E,B01,083773,Ciotti; Benjamin,20,0,35,15
1657332365292,MATH 20E,B02,083774,Ciotti; Benjamin,17,0,35,18
1657332371323,MATH 103A,A01,083777,Greenfeld; Be'Eri,3,0,36,33
1657332371323,MATH 103A,A02,083778,Greenfeld; Be'Eri,5,0,36,31
1657332371323,MATH 103A,A03,093561,Greenfeld; Be'Eri,4,0,36,32
1657332371323,MATH 103A,B01,083779,Greenfeld; Be'Eri,6,0,36,30
1657332371323,MATH 103A,B02,083780,Greenfeld; Be'Eri,4,0,36,32
1657332371323,MATH 103A,B03,093562,Greenfeld; Be'Eri,3,0,36,33
1657332377345,MATH 105,A01,085443,Carter; Anne Toulson,15,0,35,20
1657332377345,MATH 105,A02,093477,Carter; Anne Toulson,20,0,35,15
1657332383370,MATH 109,A01,083213,Ganzberger; Geoffrey Michael,2,0,34,32
1657332383370,MATH 109,A02,083214,Ganzberger; Geoffrey Michael,4,0,34,30
1657332383370,MATH 109,A03,093478,Ganzberger; Geoffrey Michael,2,0,34,32
1657332383370,MATH 109,B01,083215,Ganzberger; Geoffrey Michael,1,0,32,31
1657332383370,MATH 109,B02,083216,Ganzberger; Geoffrey Michael,1,0,32,31
1657332383370,MATH 109,B03,093479,Ganzberger; Geoffrey Michael,8,0,32,24
1657332389394,MATH 142A,A01,083219,Chow; Bennett,7,0,32,25
1657332389394,MATH 142A,A02,083220,Chow; Bennett,10,0,32,22
1657332389394,MATH 142A,A03,093480,Chow; Bennett,7,0,32,25
1657332389394,MATH 142A,B03,093481,Chow; Bennett,8,0,32,24
1657332389394,MATH 142A,B04,093558,Chow; Bennett,13,0,32,19
1657332389394,MATH 142A,B05,093559,Chow; Bennett,6,0,32,26
1657332395417,MATH 193A,A01,083224,Rotar; Vladimir,7,0,34,27
1657332395417,MATH 193A,A02,083225,Rotar; Vladimir,7,0,34,27
1657332395417,MATH 193A,A03,083781,Rotar; Vladimir,3,0,34,31
1657332395417,MATH 193A,A04,083782,Rotar; Vladimir,9,0,34,25
1657332395417,MATH 193A,A05,093482,Rotar; Vladimir,9,0,34,25
1657332401439,MATH 197,001,091859,McAuley; Julian John,9999,0,9999,0
1657332401439,MATH 197,002,095566,Kedlaya; Kiran S.,9997,0,9999,2
1657332401439,MATH 197,003,095567,Xiao; Ming,9999,0,9999,0
1657332401439,MATH 197,004,095571,Perols; Johan Lars,9998,0,9999,1
1657332408515,COGS 9,A01,083615,Shannon; Kyle Michael,8,0,75,67
1657332414539,COGS 11,A01,083617,Boyle; Mary E. T.,22,0,48,26
1657332420567,COGS 13,A01,083071,Bastos; Amalia Pinkusfeld,11,0,71,60
1657332426596,COGS 14A,A01,092681,Semenuks; Arturs,3,1,100,97
1657332432620,COGS 14B,A01,083073,Cheng; Tzu-Han,6,0,63,57
1657332438646,COGS 17,A01,092677,Semenuks; Arturs,6,0,81,75
1657332444671,COGS 100,A01,083619,Allen; Michael Gordon,16,0,70,54
1657332450697,COGS 101A,A01,083621,Davis; Joshua Daniel,9,0,68,59
1657332456731,COGS 101B,A01,091572,Allen; Michael Gordon,11,0,65,54
1657332462753,COGS 101C,A01,083625,Delgado; Tania,17,0,35,18
1657332468780,COGS 107A,A01,083627,Boyle; Mary E. T.,13,0,60,47
1657332474806,COGS 118A,A01,083075,Gupta; Anjum,19,0,76,57
1657332480834,CSE 3,A50,083646,Miranda; Gregory Joseph,24,0,50,26
1657332486862,CSE 8A,A50,083650,Miranda; Gregory Joseph,17,1,56,39
1657332492887,CSE 11,A01,083080,Cao; Yingjun,6,15,40,34
1657332498909,CSE 12,A01,083652,Krause-Levy; Sophia Louisa,28,1,120,92
1657332504934,CSE 15L,A01,083654,Morris; Justin Loren,9,0,50,41
1657332504934,CSE 15L,A02,083655,Morris; Justin Loren,9,0,50,41
1657332510957,CSE 20,A01,083657,Tran; Khoa Dang,39,0,80,41
1657332516983,CSE 21,A01,095574,Bach; Quang Tran,22,0,48,26
1657332523007,CSE 30,A01,083084,Eldon; John,4,0,80,76
1657332523007,CSE 30,B01,095061,Bhaskar; Nishant,9,0,50,41
1657332529033,CSE 100,A01,083659,Cao; Yingjun,4,4,70,66
1657332535056,CSE 134B,A01,083661,Powell; Thomas Allan,22,0,100,78
1657332541078,CSE 140,A01,083663,Gungor; Onat,14,0,85,71
1657332547105,CSE 140L,A01,083088,Eldon; John,21,0,100,79
1657332553131,CSE 175,A01,083665,Kumar; Rakesh,3,0,25,22
1657332559154,CSE 190,A00,092507,Dubnov; Shlomo,7,0,20,13
1657332565178,ECE 45,A01,083139,Congero; Spencer William,6,0,75,69
1657332571205,ECE 65,A50,083695,Saad; Andrew S,12,0,30,18
1657332571205,ECE 65,A51,095125,Saad; Andrew S,24,0,26,2
1657332577229,ECE 109,A01,091882,Touri; Behrouz,19,0,70,51
1657332583255,ECE 180,A00,083140,Abi Samra; Nicholas Camill,1,0,30,29
1657332583255,ECE 180,B00,083141,Abi Samra; Nicholas Camill,0,0,30,30
1657332589279,MATH 10A,A01,083735,Patchell; Gregory David,2,0,30,28
1657332589279,MATH 10A,A02,083736,Patchell; Gregory David,20,0,30,10
1657332589279,MATH 10A,A03,083737,Patchell; Gregory David,16,0,30,14
1657332595302,MATH 10B,A01,083207,Lim; Seonhee,7,0,34,27
1657332595302,MATH 10B,A02,083208,Lim; Seonhee,9,0,35,26
1657332595302,MATH 10B,A03,093472,Lim; Seonhee,7,0,34,27
1657332595302,MATH 10B,B01,083739,Sinha; Shubham,12,0,30,18
1657332601330,MATH 18,A01,083743,Cinel; Cameron Alexander,6,0,30,24
1657332601330,MATH 18,A02,083744,Cinel; Cameron Alexander,17,0,30,13
1657332601330,MATH 18,A03,083745,Cinel; Cameron Alexander,9,0,30,21
1657332601330,MATH 18,B01,083748,Rideout; David Porter,4,0,37,33
1657332601330,MATH 18,B02,083749,Rideout; David Porter,5,0,36,31
1657332601330,MATH 18,B03,083750,Rideout; David Porter,3,0,37,34
1657332601330,MATH 18,B04,083751,Rideout; David Porter,6,0,36,30
1657332601330,MATH 18,B05,093473,Rideout; David Porter,6,0,36,30
1657332601330,MATH 18,B06,093474,Rideout; David Porter,6,0,36,30
1657332607358,MATH 20A,A01,083754,Zheng; Zequn,14,0,40,26
1657332613385,MATH 20B,A01,083756,Briones; Jor-el Thomas Caparas,4,0,36,32
1657332613385,MATH 20B,A02,083757,Briones; Jor-el Thomas Caparas,1,0,36,35
1657332613385,MATH 20B,A03,093475,Briones; Jor-el Thomas Caparas,2,0,36,34
1657332619408,MATH 20C,A01,083760,Briones; Jor-el Thomas Caparas,1,0,35,34
1657332619408,MATH 20C,A02,083761,Briones; Jor-el Thomas Caparas,8,0,35,27
1657332619408,MATH 20C,A03,093476,Briones; Jor-el Thomas Caparas,0,1,36,36
1657332619408,MATH 20C,B01,083762,Bach; Quang Tran,1,0,30,29
1657332625432,MATH 20D,A01,083765,Tran; Brian Kha,5,0,30,25
1657332625432,MATH 20D,A02,083766,Tran; Brian Kha,5,0,30,25
1657332625432,MATH 20D,A03,083767,Tran; Brian Kha,4,0,30,26
1657332631455,MATH 20E,A01,083771,Ganguly; Soumya,7,0,32,25
1657332631455,MATH 20E,A02,083772,Ganguly; Soumya,6,0,32,26
1657332631455,MATH 20E,B01,083773,Ciotti; Benjamin,20,0,35,15
1657332631455,MATH 20E,B02,083774,Ciotti; Benjamin,17,0,35,18
1657332637479,MATH 103A,A01,083777,Greenfeld; Be'Eri,3,0,36,33
1657332637479,MATH 103A,A02,083778,Greenfeld; Be'Eri,5,0,36,31
1657332637479,MATH 103A,A03,093561,Greenfeld; Be'Eri,4,0,36,32
1657332637479,MATH 103A,B01,083779,Greenfeld; Be'Eri,6,0,36,30
1657332637479,MATH 103A,B02,083780,Greenfeld; Be'Eri,4,0,36,32
1657332637479,MATH 103A,B03,093562,Greenfeld; Be'Eri,3,0,36,33
1657332643502,MATH 105,A01,085443,Carter; Anne Toulson,15,0,35,20
1657332643502,MATH 105,A02,093477,Carter; Anne Toulson,20,0,35,15
1657332649524,MATH 109,A01,083213,Ganzberger; Geoffrey Michael,2,0,34,32
1657332649524,MATH 109,A02,083214,Ganzberger; Geoffrey Michael,4,0,34,30
1657332649524,MATH 109,A03,093478,Ganzberger; Geoffrey Michael,2,0,34,32
1657332649524,MATH 109,B01,083215,Ganzberger; Geoffrey Michael,1,0,32,31
1657332649524,MATH 109,B02,083216,Ganzberger; Geoffrey Michael,1,0,32,31
1657332649524,MATH 109,B03,093479,Ganzberger; Geoffrey Michael,8,0,32,24
1657332655644,MATH 142A,A01,083219,Chow; Bennett,7,0,32,25
1657332655644,MATH 142A,A02,083220,Chow; Bennett,10,0,32,22
1657332655644,MATH 142A,A03,093480,Chow; Bennett,7,0,32,25
1657332655644,MATH 142A,B03,093481,Chow; Bennett,8,0,32,24
1657332655644,MATH 142A,B04,093558,Chow; Bennett,13,0,32,19
1657332655644,MATH 142A,B05,093559,Chow; Bennett,6,0,32,26
1657332661672,MATH 193A,A01,083224,Rotar; Vladimir,7,0,34,27
1657332661672,MATH 193A,A02,083225,Rotar; Vladimir,7,0,34,27
1657332661672,MATH 193A,A03,083781,Rotar; Vladimir,3,0,34,31
1657332661672,MATH 193A,A04,083782,Rotar; Vladimir,9,0,34,25
1657332661672,MATH 193A,A05,093482,Rotar; Vladimir,9,0,34,25
1657332667694,MATH 197,001,091859,McAuley; Julian John,9999,0,9999,0
1657332667694,MATH 197,002,095566,Kedlaya; Kiran S.,9997,0,9999,2
1657332667694,MATH 197,003,095567,Xiao; Ming,9999,0,9999,0
1657332667694,MATH 197,004,095571,Perols; Johan Lars,9998,0,9999,1
1657332674761,COGS 9,A01,083615,Shannon; Kyle Michael,8,0,75,67
1657332680783,COGS 11,A01,083617,Boyle; Mary E. T.,22,0,48,26
1657332686804,COGS 13,A01,083071,Bastos; Amalia Pinkusfeld,11,0,71,60
1657332692827,COGS 14A,A01,092681,Semenuks; Arturs,3,1,100,97
1657332698851,COGS 14B,A01,083073,Cheng; Tzu-Han,6,0,63,57
1657332704874,COGS 17,A01,092677,Semenuks; Arturs,6,0,81,75
1657332710900,COGS 100,A01,083619,Allen; Michael Gordon,16,0,70,54
1657332716945,COGS 101A,A01,083621,Davis; Joshua Daniel,9,0,68,59
1657332722972,COGS 101B,A01,091572,Allen; Michael Gordon,11,0,65,54
1657332728999,COGS 101C,A01,083625,Delgado; Tania,17,0,35,18
1657332735025,COGS 107A,A01,083627,Boyle; Mary E. T.,13,0,60,47
1657332741048,COGS 118A,A01,083075,Gupta; Anjum,19,0,76,57
1657332747072,CSE 3,A50,083646,Miranda; Gregory Joseph,24,0,50,26
1657332753100,CSE 8A,A50,083650,Miranda; Gregory Joseph,17,1,56,39
1657332759123,CSE 11,A01,083080,Cao; Yingjun,6,15,40,34
1657332765148,CSE 12,A01,083652,Krause-Levy; Sophia Louisa,28,1,120,92
1657332771170,CSE 15L,A01,083654,Morris; Justin Loren,9,0,50,41
1657332771170,CSE 15L,A02,083655,Morris; Justin Loren,9,0,50,41
1657332777197,CSE 20,A01,083657,Tran; Khoa Dang,39,0,80,41
1657332783219,CSE 21,A01,095574,Bach; Quang Tran,22,0,48,26
1657332789241,CSE 30,A01,083084,Eldon; John,4,0,80,76
1657332789241,CSE 30,B01,095061,Bhaskar; Nishant,9,0,50,41
1657332795264,CSE 100,A01,083659,Cao; Yingjun,4,4,70,66
1657332801288,CSE 134B,A01,083661,Powell; Thomas Allan,22,0,100,78
1657332807322,CSE 140,A01,083663,Gungor; Onat,14,0,85,71
1657332813351,CSE 140L,A01,083088,Eldon; John,21,0,100,79
1657332819375,CSE 175,A01,083665,Kumar; Rakesh,3,0,25,22
1657332825397,CSE 190,A00,092507,Dubnov; Shlomo,7,0,20,13
1657332831424,ECE 45,A01,083139,Congero; Spencer William,6,0,75,69
1657332837447,ECE 65,A50,083695,Saad; Andrew S,12,0,30,18
1657332837447,ECE 65,A51,095125,Saad; Andrew S,24,0,26,2
1657332843471,ECE 109,A01,091882,Touri; Behrouz,19,0,70,51
1657332849494,ECE 180,A00,083140,Abi Samra; Nicholas Camill,1,0,30,29
1657332849494,ECE 180,B00,083141,Abi Samra; Nicholas Camill,0,0,30,30
1657332855518,MATH 10A,A01,083735,Patchell; Gregory David,2,0,30,28
1657332855518,MATH 10A,A02,083736,Patchell; Gregory David,20,0,30,10
1657332855518,MATH 10A,A03,083737,Patchell; Gregory David,16,0,30,14
1657332861540,MATH 10B,A01,083207,Lim; Seonhee,7,0,34,27
1657332861540,MATH 10B,A02,083208,Lim; Seonhee,9,0,35,26
1657332861540,MATH 10B,A03,093472,Lim; Seonhee,7,0,34,27
1657332861540,MATH 10B,B01,083739,Sinha; Shubham,12,0,30,18
1657332867566,MATH 18,A01,083743,Cinel; Cameron Alexander,6,0,30,24
1657332867566,MATH 18,A02,083744,Cinel; Cameron Alexander,17,0,30,13
1657332867566,MATH 18,A03,083745,Cinel; Cameron Alexander,9,0,30,21
1657332867566,MATH 18,B01,083748,Rideout; David Porter,4,0,37,33
1657332867566,MATH 18,B02,083749,Rideout; David Porter,5,0,36,31
1657332867566,MATH 18,B03,083750,Rideout; David Porter,3,0,37,34
1657332867566,MATH 18,B04,083751,Rideout; David Porter,6,0,36,30
1657332867566,MATH 18,B05,093473,Rideout; David Porter,6,0,36,30
1657332867566,MATH 18,B06,093474,Rideout; David Porter,6,0,36,30
1657332873605,MATH 20A,A01,083754,Zheng; Zequn,14,0,40,26
1657332879632,MATH 20B,A01,083756,Briones; Jor-el Thomas Caparas,4,0,36,32
1657332879632,MATH 20B,A02,083757,Briones; Jor-el Thomas Caparas,1,0,36,35
1657332879632,MATH 20B,A03,093475,Briones; Jor-el Thomas Caparas,2,0,36,34
1657332885662,MATH 20C,A01,083760,Briones; Jor-el Thomas Caparas,1,0,35,34
1657332885662,MATH 20C,A02,083761,Briones; Jor-el Thomas Caparas,8,0,35,27
1657332885662,MATH 20C,A03,093476,Briones; Jor-el Thomas Caparas,0,1,36,36
1657332885662,MATH 20C,B01,083762,Bach; Quang Tran,1,0,30,29
1657332891687,MATH 20D,A01,083765,Tran; Brian Kha,5,0,30,25
1657332891687,MATH 20D,A02,083766,Tran; Brian Kha,5,0,30,25
1657332891687,MATH 20D,A03,083767,Tran; Brian Kha,4,0,30,26
1657332897717,MATH 20E,A01,083771,Ganguly; Soumya,7,0,32,25
1657332897717,MATH 20E,A02,083772,Ganguly; Soumya,6,0,32,26
1657332897717,MATH 20E,B01,083773,Ciotti; Benjamin,20,0,35,15
1657332897717,MATH 20E,B02,083774,Ciotti; Benjamin,17,0,35,18
1657332903741,MATH 103A,A01,083777,Greenfeld; Be'Eri,3,0,36,33
1657332903741,MATH 103A,A02,083778,Greenfeld; Be'Eri,5,0,36,31
1657332903741,MATH 103A,A03,093561,Greenfeld; Be'Eri,4,0,36,32
1657332903741,MATH 103A,B01,083779,Greenfeld; Be'Eri,6,0,36,30
1657332903741,MATH 103A,B02,083780,Greenfeld; Be'Eri,4,0,36,32
1657332903741,MATH 103A,B03,093562,Greenfeld; Be'Eri,3,0,36,33
1657332909766,MATH 105,A01,085443,Carter; Anne Toulson,15,0,35,20
1657332909766,MATH 105,A02,093477,Carter; Anne Toulson,20,0,35,15
1657332915795,MATH 109,A01,083213,Ganzberger; Geoffrey Michael,2,0,34,32
1657332915795,MATH 109,A02,083214,Ganzberger; Geoffrey Michael,4,0,34,30
1657332915795,MATH 109,A03,093478,Ganzberger; Geoffrey Michael,2,0,34,32
1657332915795,MATH 109,B01,083215,Ganzberger; Geoffrey Michael,1,0,32,31
1657332915795,MATH 109,B02,083216,Ganzberger; Geoffrey Michael,1,0,32,31
1657332915795,MATH 109,B03,093479,Ganzberger; Geoffrey Michael,8,0,32,24
1657332921827,MATH 142A,A01,083219,Chow; Bennett,7,0,32,25
1657332921827,MATH 142A,A02,083220,Chow; Bennett,10,0,32,22
1657332921827,MATH 142A,A03,093480,Chow; Bennett,7,0,32,25
1657332921827,MATH 142A,B03,093481,Chow; Bennett,8,0,32,24
1657332921827,MATH 142A,B04,093558,Chow; Bennett,13,0,32,19
1657332921827,MATH 142A,B05,093559,Chow; Bennett,6,0,32,26
1657332927856,MATH 193A,A01,083224,Rotar; Vladimir,7,0,34,27
1657332927856,MATH 193A,A02,083225,Rotar; Vladimir,7,0,34,27
1657332927856,MATH 193A,A03,083781,Rotar; Vladimir,3,0,34,31
1657332927856,MATH 193A,A04,083782,Rotar; Vladimir,9,0,34,25
1657332927856,MATH 193A,A05,093482,Rotar; Vladimir,9,0,34,25
1657332933878,MATH 197,001,091859,McAuley; Julian John,9999,0,9999,0
1657332933878,MATH 197,002,095566,Kedlaya; Kiran S.,9997,0,9999,2
1657332933878,MATH 197,003,095567,Xiao; Ming,9999,0,9999,0
1657332933878,MATH 197,004,095571,Perols; Johan Lars,9998,0,9999,1
1657332940928,COGS 9,A01,083615,Shannon; Kyle Michael,8,0,75,67
1657332946952,COGS 11,A01,083617,Boyle; Mary E. T.,22,0,48,26
1657332952976,COGS 13,A01,083071,Bastos; Amalia Pinkusfeld,11,0,71,60
1657332958999,COGS 14A,A01,092681,Semenuks; Arturs,3,1,100,97
1657332965028,COGS 14B,A01,083073,Cheng; Tzu-Han,6,0,63,57
1657332971050,COGS 17,A01,092677,Semenuks; Arturs,6,0,81,75
1657332977081,COGS 100,A01,083619,Allen; Michael Gordon,16,0,70,54
1657332983104,COGS 101A,A01,083621,Davis; Joshua Daniel,9,0,68,59
1657332989126,COGS 101B,A01,091572,Allen; Michael Gordon,11,0,65,54
1657332995147,COGS 101C,A01,083625,Delgado; Tania,17,0,35,18
1657333001170,COGS 107A,A01,083627,Boyle; Mary E. T.,13,0,60,47
1657333007214,COGS 118A,A01,083075,Gupta; Anjum,19,0,76,57
1657333013252,CSE 3,A50,083646,Miranda; Gregory Joseph,24,0,50,26
1657333019278,CSE 8A,A50,083650,Miranda; Gregory Joseph,17,1,56,39
1657333025301,CSE 11,A01,083080,Cao; Yingjun,6,15,40,34
1657333031327,CSE 12,A01,083652,Krause-Levy; Sophia Louisa,28,1,120,92
1657333037353,CSE 15L,A01,083654,Morris; Justin Loren,9,0,50,41
1657333037353,CSE 15L,A02,083655,Morris; Justin Loren,9,0,50,41
1657333043393,CSE 20,A01,083657,Tran; Khoa Dang,39,0,80,41
1657333049427,CSE 21,A01,095574,Bach; Quang Tran,22,0,48,26
1657333055452,CSE 30,A01,083084,Eldon; John,4,0,80,76
1657333055452,CSE 30,B01,095061,Bhaskar; Nishant,9,0,50,41
1657333061473,CSE 100,A01,083659,Cao; Yingjun,4,4,70,66
1657333067511,CSE 134B,A01,083661,Powell; Thomas Allan,22,0,100,78
1657333073540,CSE 140,A01,083663,Gungor; Onat,14,0,85,71
1657333079571,CSE 140L,A01,083088,Eldon; John,21,0,100,79
1657333085599,CSE 175,A01,083665,Kumar; Rakesh,3,0,25,22
1657333091625,CSE 190,A00,092507,Dubnov; Shlomo,7,0,20,13
1657333097652,ECE 45,A01,083139,Congero; Spencer William,6,0,75,69
1657333103691,ECE 65,A50,083695,Saad; Andrew S,12,0,30,18
1657333103691,ECE 65,A51,095125,Saad; Andrew S,24,0,26,2
1657333109715,ECE 109,A01,091882,Touri; Behrouz,19,0,70,51
1657333115737,ECE 180,A00,083140,Abi Samra; Nicholas Camill,1,0,30,29
1657333115737,ECE 180,B00,083141,Abi Samra; Nicholas Camill,0,0,30,30
1657333121774,MATH 10A,A01,083735,Patchell; Gregory David,2,0,30,28
1657333121774,MATH 10A,A02,083736,Patchell; Gregory David,20,0,30,10
1657333121774,MATH 10A,A03,083737,Patchell; Gregory David,16,0,30,14
1657333127796,MATH 10B,A01,083207,Lim; Seonhee,7,0,34,27
1657333127796,MATH 10B,A02,083208,Lim; Seonhee,9,0,35,26
1657333127796,MATH 10B,A03,093472,Lim; Seonhee,7,0,34,27
1657333127796,MATH 10B,B01,083739,Sinha; Shubham,12,0,30,18
1657333133821,MATH 18,A01,083743,Cinel; Cameron Alexander,6,0,30,24
1657333133821,MATH 18,A02,083744,Cinel; Cameron Alexander,17,0,30,13
1657333133821,MATH 18,A03,083745,Cinel; Cameron Alexander,9,0,30,21
1657333133821,MATH 18,B01,083748,Rideout; David Porter,4,0,37,33
1657333133821,MATH 18,B02,083749,Rideout; David Porter,5,0,36,31
1657333133821,MATH 18,B03,083750,Rideout; David Porter,3,0,37,34
1657333133821,MATH 18,B04,083751,Rideout; David Porter,6,0,36,30
1657333133821,MATH 18,B05,093473,Rideout; David Porter,6,0,36,30
1657333133821,MATH 18,B06,093474,Rideout; David Porter,6,0,36,30
1657333139844,MATH 20A,A01,083754,Zheng; Zequn,14,0,40,26
1657333145865,MATH 20B,A01,083756,Briones; Jor-el Thomas Caparas,4,0,36,32
1657333145865,MATH 20B,A02,083757,Briones; Jor-el Thomas Caparas,1,0,36,35
1657333145865,MATH 20B,A03,093475,Briones; Jor-el Thomas Caparas,2,0,36,34
1657333151889,MATH 20C,A01,083760,Briones; Jor-el Thomas Caparas,1,0,35,34
1657333151889,MATH 20C,A02,083761,Briones; Jor-el Thomas Caparas,8,0,35,27
1657333151889,MATH 20C,A03,093476,Briones; Jor-el Thomas Caparas,0,1,36,36
1657333151889,MATH 20C,B01,083762,Bach; Quang Tran,1,0,30,29
1657333157916,MATH 20D,A01,083765,Tran; Brian Kha,5,0,30,25
1657333157916,MATH 20D,A02,083766,Tran; Brian Kha,5,0,30,25
1657333157916,MATH 20D,A03,083767,Tran; Brian Kha,4,0,30,26
1657333163941,MATH 20E,A01,083771,Ganguly; Soumya,7,0,32,25
1657333163941,MATH 20E,A02,083772,Ganguly; Soumya,6,0,32,26
1657333163941,MATH 20E,B01,083773,Ciotti; Benjamin,20,0,35,15
1657333163941,MATH 20E,B02,083774,Ciotti; Benjamin,17,0,35,18
1657333169967,MATH 103A,A01,083777,Greenfeld; Be'Eri,3,0,36,33
1657333169967,MATH 103A,A02,083778,Greenfeld; Be'Eri,5,0,36,31
1657333169967,MATH 103A,A03,093561,Greenfeld; Be'Eri,4,0,36,32
1657333169967,MATH 103A,B01,083779,Greenfeld; Be'Eri,6,0,36,30
1657333169967,MATH 103A,B02,083780,Greenfeld; Be'Eri,4,0,36,32
1657333169967,MATH 103A,B03,093562,Greenfeld; Be'Eri,3,0,36,33
1657333175990,MATH 105,A01,085443,Carter; Anne Toulson,15,0,35,20
1657333175990,MATH 105,A02,093477,Carter; Anne Toulson,20,0,35,15
1657333182013,MATH 109,A01,083213,Ganzberger; Geoffrey Michael,2,0,34,32
1657333182013,MATH 109,A02,083214,Ganzberger; Geoffrey Michael,4,0,34,30
1657333182013,MATH 109,A03,093478,Ganzberger; Geoffrey Michael,2,0,34,32
1657333182013,MATH 109,B01,083215,Ganzberger; Geoffrey Michael,1,0,32,31
1657333182013,MATH 109,B02,083216,Ganzberger; Geoffrey Michael,1,0,32,31
1657333182013,MATH 109,B03,093479,Ganzberger; Geoffrey Michael,8,0,32,24
1657333188038,MATH 142A,A01,083219,Chow; Bennett,7,0,32,25
1657333188038,MATH 142A,A02,083220,Chow; Bennett,10,0,32,22
1657333188038,MATH 142A,A03,093480,Chow; Bennett,7,0,32,25
1657333188038,MATH 142A,B03,093481,Chow; Bennett,8,0,32,24
1657333188038,MATH 142A,B04,093558,Chow; Bennett,13,0,32,19
1657333188038,MATH 142A,B05,093559,Chow; Bennett,6,0,32,26
1657333203741,MATH 193A,A01,083224,Rotar; Vladimir,7,0,34,27
1657333203741,MATH 193A,A02,083225,Rotar; Vladimir,7,0,34,27
1657333203741,MATH 193A,A03,083781,Rotar; Vladimir,3,0,34,31
1657333203741,MATH 193A,A04,083782,Rotar; Vladimir,9,0,34,25
1657333203741,MATH 193A,A05,093482,Rotar; Vladimir,9,0,34,25
1657333209763,MATH 197,001,091859,McAuley; Julian John,9999,0,9999,0
1657333209763,MATH 197,002,095566,Kedlaya; Kiran S.,9997,0,9999,2
1657333209763,MATH 197,003,095567,Xiao; Ming,9999,0,9999,0
1657333209763,MATH 197,004,095571,Perols; Johan Lars,9998,0,9999,1
1657333216813,COGS 9,A01,083615,Shannon; Kyle Michael,8,0,75,67
1657333222838,COGS 11,A01,083617,Boyle; Mary E. T.,22,0,48,26
1657333228865,COGS 13,A01,083071,Bastos; Amalia Pinkusfeld,11,0,71,60
1657333234897,COGS 14A,A01,092681,Semenuks; Arturs,3,1,100,97
1657333240920,COGS 14B,A01,083073,Cheng; Tzu-Han,6,0,63,57
1657333246942,COGS 17,A01,092677,Semenuks; Arturs,6,0,81,75
1657333252967,COGS 100,A01,083619,Allen; Michael Gordon,16,0,70,54
1657333259069,COGS 101A,A01,083621,Davis; Joshua Daniel,9,0,68,59
1657333265094,COGS 101B,A01,091572,Allen; Michael Gordon,11,0,65,54
1657333271118,COGS 101C,A01,083625,Delgado; Tania,17,0,35,18
1657333277142,COGS 107A,A01,083627,Boyle; Mary E. T.,13,0,60,47
1657333283166,COGS 118A,A01,083075,Gupta; Anjum,19,0,76,57
1657333289193,CSE 3,A50,083646,Miranda; Gregory Joseph,24,0,50,26
1657333295220,CSE 8A,A50,083650,Miranda; Gregory Joseph,17,1,56,39
1657333301245,CSE 11,A01,083080,Cao; Yingjun,6,15,40,34
1657333307267,CSE 12,A01,083652,Krause-Levy; Sophia Louisa,28,1,120,92
1657333313289,CSE 15L,A01,083654,Morris; Justin Loren,9,0,50,41
1657333313289,CSE 15L,A02,083655,Morris; Justin Loren,9,0,50,41
1657333319325,CSE 20,A01,083657,Tran; Khoa Dang,39,0,80,41
1657333325355,CSE 21,A01,095574,Bach; Quang Tran,22,0,48,26
1657333331379,CSE 30,A01,083084,Eldon; John,4,0,80,76
1657333331379,CSE 30,B01,095061,Bhaskar; Nishant,9,0,50,41
1657333337412,CSE 100,A01,083659,Cao; Yingjun,4,4,70,66
1657333343440,CSE 134B,A01,083661,Powell; Thomas Allan,22,0,100,78
1657333349463,CSE 140,A01,083663,Gungor; Onat,14,0,85,71
1657333355494,CSE 140L,A01,083088,Eldon; John,21,0,100,79
1657333361517,CSE 175,A01,083665,Kumar; Rakesh,3,0,25,22
1657333367545,CSE 190,A00,092507,Dubnov; Shlomo,7,0,20,13
1657333373573,ECE 45,A01,083139,Congero; Spencer William,6,0,75,69
1657333379603,ECE 65,A50,083695,Saad; Andrew S,12,0,30,18
1657333379603,ECE 65,A51,095125,Saad; Andrew S,24,0,26,2
1657333385630,ECE 109,A01,091882,Touri; Behrouz,19,0,70,51
1657333391655,ECE 180,A00,083140,Abi Samra; Nicholas Camill,1,0,30,29
1657333391655,ECE 180,B00,083141,Abi Samra; Nicholas Camill,0,0,30,30
1657333397681,MATH 10A,A01,083735,Patchell; Gregory David,2,0,30,28
1657333397681,MATH 10A,A02,083736,Patchell; Gregory David,20,0,30,10
1657333397681,MATH 10A,A03,083737,Patchell; Gregory David,16,0,30,14
1657333403706,MATH 10B,A01,083207,Lim; Seonhee,7,0,34,27
1657333403706,MATH 10B,A02,083208,Lim; Seonhee,9,0,35,26
1657333403706,MATH 10B,A03,093472,Lim; Seonhee,7,0,34,27
1657333403706,MATH 10B,B01,083739,Sinha; Shubham,12,0,30,18
1657333409740,MATH 18,A01,083743,Cinel; Cameron Alexander,6,0,30,24
1657333409740,MATH 18,A02,083744,Cinel; Cameron Alexander,17,0,30,13
1657333409740,MATH 18,A03,083745,Cinel; Cameron Alexander,9,0,30,21
1657333409740,MATH 18,B01,083748,Rideout; David Porter,5,0,37,32
1657333409740,MATH 18,B02,083749,Rideout; David Porter,5,0,36,31
1657333409740,MATH 18,B03,083750,Rideout; David Porter,3,0,37,34
1657333409740,MATH 18,B04,083751,Rideout; David Porter,6,0,36,30
1657333409740,MATH 18,B05,093473,Rideout; David Porter,6,0,36,30
1657333409740,MATH 18,B06,093474,Rideout; David Porter,6,0,36,30
1657333415765,MATH 20A,A01,083754,Zheng; Zequn,14,0,40,26
1657333421789,MATH 20B,A01,083756,Briones; Jor-el Thomas Caparas,4,0,36,32
1657333421789,MATH 20B,A02,083757,Briones; Jor-el Thomas Caparas,1,0,36,35
1657333421789,MATH 20B,A03,093475,Briones; Jor-el Thomas Caparas,2,0,36,34
1657333427813,MATH 20C,A01,083760,Briones; Jor-el Thomas Caparas,1,0,35,34
1657333427813,MATH 20C,A02,083761,Briones; Jor-el Thomas Caparas,8,0,35,27
1657333427813,MATH 20C,A03,093476,Briones; Jor-el Thomas Caparas,0,1,36,36
1657333427813,MATH 20C,B01,083762,Bach; Quang Tran,1,0,30,29
1657333433837,MATH 20D,A01,083765,Tran; Brian Kha,5,0,30,25
1657333433837,MATH 20D,A02,083766,Tran; Brian Kha,5,0,30,25
1657333433837,MATH 20D,A03,083767,Tran; Brian Kha,4,0,30,26
1657333439862,MATH 20E,A01,083771,Ganguly; Soumya,9,0,32,23
1657333439862,MATH 20E,A02,083772,Ganguly; Soumya,6,0,32,26
1657333439862,MATH 20E,B01,083773,Ciotti; Benjamin,20,0,35,15
1657333439862,MATH 20E,B02,083774,Ciotti; Benjamin,17,0,35,18
1657333445887,MATH 103A,A01,083777,Greenfeld; Be'Eri,3,0,36,33
1657333445887,MATH 103A,A02,083778,Greenfeld; Be'Eri,5,0,36,31
1657333445887,MATH 103A,A03,093561,Greenfeld; Be'Eri,4,0,36,32
1657333445887,MATH 103A,B01,083779,Greenfeld; Be'Eri,6,0,36,30
1657333445887,MATH 103A,B02,083780,Greenfeld; Be'Eri,4,0,36,32
1657333445887,MATH 103A,B03,093562,Greenfeld; Be'Eri,3,0,36,33
1657333451922,MATH 105,A01,085443,Carter; Anne Toulson,15,0,35,20
1657333451922,MATH 105,A02,093477,Carter; Anne Toulson,20,0,35,15
1657333457950,MATH 109,A01,083213,Ganzberger; Geoffrey Michael,2,0,34,32
1657333457950,MATH 109,A02,083214,Ganzberger; Geoffrey Michael,4,0,34,30
1657333457950,MATH 109,A03,093478,Ganzberger; Geoffrey Michael,2,0,34,32
1657333457950,MATH 109,B01,083215,Ganzberger; Geoffrey Michael,1,0,32,31
1657333457950,MATH 109,B02,083216,Ganzberger; Geoffrey Michael,1,0,32,31
1657333457950,MATH 109,B03,093479,Ganzberger; Geoffrey Michael,8,0,32,24
1657333463979,MATH 142A,A01,083219,Chow; Bennett,7,0,32,25
1657333463979,MATH 142A,A02,083220,Chow; Bennett,10,0,32,22
1657333463979,MATH 142A,A03,093480,Chow; Bennett,7,0,32,25
1657333463979,MATH 142A,B03,093481,Chow; Bennett,8,0,32,24
1657333463979,MATH 142A,B04,093558,Chow; Bennett,13,0,32,19
1657333463979,MATH 142A,B05,093559,Chow; Bennett,6,0,32,26
1657333470006,MATH 193A,A01,083224,Rotar; Vladimir,7,0,34,27
1657333470006,MATH 193A,A02,083225,Rotar; Vladimir,7,0,34,27
1657333470006,MATH 193A,A03,083781,Rotar; Vladimir,3,0,34,31
1657333470006,MATH 193A,A04,083782,Rotar; Vladimir,9,0,34,25
1657333470006,MATH 193A,A05,093482,Rotar; Vladimir,9,0,34,25
1657333476029,MATH 197,001,091859,McAuley; Julian John,9999,0,9999,0
1657333476029,MATH 197,002,095566,Kedlaya; Kiran S.,9997,0,9999,2
1657333476029,MATH 197,003,095567,Xiao; Ming,9999,0,9999,0
1657333476029,MATH 197,004,095571,Perols; Johan Lars,9998,0,9999,1
1657333483087,COGS 9,A01,083615,Shannon; Kyle Michael,8,0,75,67
1657333489113,COGS 11,A01,083617,Boyle; Mary E. T.,22,0,48,26
1657333495142,COGS 13,A01,083071,Bastos; Amalia Pinkusfeld,11,0,71,60
1657333501165,COGS 14A,A01,092681,Semenuks; Arturs,3,1,100,97
1657333507189,COGS 14B,A01,083073,Cheng; Tzu-Han,6,0,63,57
1657333513211,COGS 17,A01,092677,Semenuks; Arturs,6,0,81,75
1657333519234,COGS 100,A01,083619,Allen; Michael Gordon,16,0,70,54
1657333525263,COGS 101A,A01,083621,Davis; Joshua Daniel,9,0,68,59
1657333531285,COGS 101B,A01,091572,Allen; Michael Gordon,11,0,65,54
1657333537309,COGS 101C,A01,083625,Delgado; Tania,17,0,35,18
1657333543336,COGS 107A,A01,083627,Boyle; Mary E. T.,13,0,60,47
1657333549363,COGS 118A,A01,083075,Gupta; Anjum,19,0,76,57
1657333555392,CSE 3,A50,083646,Miranda; Gregory Joseph,24,0,50,26
1657333561420,CSE 8A,A50,083650,Miranda; Gregory Joseph,17,1,56,39
1657333567444,CSE 11,A01,083080,Cao; Yingjun,6,15,40,34
1657333573474,CSE 12,A01,083652,Krause-Levy; Sophia Louisa,28,1,120,92
1657333579496,CSE 15L,A01,083654,Morris; Justin Loren,9,0,50,41
1657333579496,CSE 15L,A02,083655,Morris; Justin Loren,9,0,50,41
1657333585520,CSE 20,A01,083657,Tran; Khoa Dang,39,0,80,41
1657333591547,CSE 21,A01,095574,Bach; Quang Tran,22,0,48,26
1657333597570,CSE 30,A01,083084,Eldon; John,4,0,80,76
1657333597570,CSE 30,B01,095061,Bhaskar; Nishant,9,0,50,41
1657333603594,CSE 100,A01,083659,Cao; Yingjun,4,4,70,66
1657333609620,CSE 134B,A01,083661,Powell; Thomas Allan,22,0,100,78
1657333615643,CSE 140,A01,083663,Gungor; Onat,14,0,85,71
1657333621668,CSE 140L,A01,083088,Eldon; John,21,0,100,79
1657333627695,CSE 175,A01,083665,Kumar; Rakesh,3,0,25,22
1657333633716,CSE 190,A00,092507,Dubnov; Shlomo,7,0,20,13
1657333639740,ECE 45,A01,083139,Congero; Spencer William,6,0,75,69
1657333645773,ECE 65,A50,083695,Saad; Andrew S,12,0,30,18
1657333645773,ECE 65,A51,095125,Saad; Andrew S,24,0,26,2
1657333651799,ECE 109,A01,091882,Touri; Behrouz,19,0,70,51
1657333657821,ECE 180,A00,083140,Abi Samra; Nicholas Camill,1,0,30,29
1657333657821,ECE 180,B00,083141,Abi Samra; Nicholas Camill,0,0,30,30
1657333663843,MATH 10A,A01,083735,Patchell; Gregory David,2,0,30,28
1657333663843,MATH 10A,A02,083736,Patchell; Gregory David,20,0,30,10
1657333663843,MATH 10A,A03,083737,Patchell; Gregory David,16,0,30,14
1657333669864,MATH 10B,A01,083207,Lim; Seonhee,7,0,34,27
1657333669864,MATH 10B,A02,083208,Lim; Seonhee,9,0,35,26
1657333669864,MATH 10B,A03,093472,Lim; Seonhee,7,0,34,27
1657333669864,MATH 10B,B01,083739,Sinha; Shubham,12,0,30,18
1657333675889,MATH 18,A01,083743,Cinel; Cameron Alexander,6,0,30,24
1657333675889,MATH 18,A02,083744,Cinel; Cameron Alexander,17,0,30,13
1657333675889,MATH 18,A03,083745,Cinel; Cameron Alexander,9,0,30,21
1657333675889,MATH 18,B01,083748,Rideout; David Porter,5,0,37,32
1657333675889,MATH 18,B02,083749,Rideout; David Porter,5,0,36,31
1657333675889,MATH 18,B03,083750,Rideout; David Porter,3,0,37,34
1657333675889,MATH 18,B04,083751,Rideout; David Porter,6,0,36,30
1657333675889,MATH 18,B05,093473,Rideout; David Porter,6,0,36,30
1657333675889,MATH 18,B06,093474,Rideout; David Porter,6,0,36,30
1657333681916,MATH 20A,A01,083754,Zheng; Zequn,14,0,40,26
1657333687943,MATH 20B,A01,083756,Briones; Jor-el Thomas Caparas,4,0,36,32
1657333687943,MATH 20B,A02,083757,Briones; Jor-el Thomas Caparas,1,0,36,35
1657333687943,MATH 20B,A03,093475,Briones; Jor-el Thomas Caparas,2,0,36,34
1657333693968,MATH 20C,A01,083760,Briones; Jor-el Thomas Caparas,1,0,35,34
1657333693968,MATH 20C,A02,083761,Briones; Jor-el Thomas Caparas,8,0,35,27
1657333693968,MATH 20C,A03,093476,Briones; Jor-el Thomas Caparas,0,1,36,36
1657333693968,MATH 20C,B01,083762,Bach; Quang Tran,1,0,30,29
1657333699991,MATH 20D,A01,083765,Tran; Brian Kha,5,0,30,25
1657333699991,MATH 20D,A02,083766,Tran; Brian Kha,5,0,30,25
1657333699991,MATH 20D,A03,083767,Tran; Brian Kha,4,0,30,26
1657333706021,MATH 20E,A01,083771,Ganguly; Soumya,9,0,32,23
1657333706021,MATH 20E,A02,083772,Ganguly; Soumya,6,0,32,26
1657333706021,MATH 20E,B01,083773,Ciotti; Benjamin,20,0,35,15
1657333706021,MATH 20E,B02,083774,Ciotti; Benjamin,17,0,35,18
1657333712051,MATH 103A,A01,083777,Greenfeld; Be'Eri,3,0,36,33
1657333712051,MATH 103A,A02,083778,Greenfeld; Be'Eri,5,0,36,31
1657333712051,MATH 103A,A03,093561,Greenfeld; Be'Eri,4,0,36,32
1657333712051,MATH 103A,B01,083779,Greenfeld; Be'Eri,6,0,36,30
1657333712051,MATH 103A,B02,083780,Greenfeld; Be'Eri,4,0,36,32
1657333712051,MATH 103A,B03,093562,Greenfeld; Be'Eri,3,0,36,33
1657333718073,MATH 105,A01,085443,Carter; Anne Toulson,15,0,35,20
1657333718073,MATH 105,A02,093477,Carter; Anne Toulson,20,0,35,15
1657333724095,MATH 109,A01,083213,Ganzberger; Geoffrey Michael,2,0,34,32
1657333724095,MATH 109,A02,083214,Ganzberger; Geoffrey Michael,4,0,34,30
1657333724095,MATH 109,A03,093478,Ganzberger; Geoffrey Michael,2,0,34,32
1657333724095,MATH 109,B01,083215,Ganzberger; Geoffrey Michael,1,0,32,31
1657333724095,MATH 109,B02,083216,Ganzberger; Geoffrey Michael,1,0,32,31
1657333724095,MATH 109,B03,093479,Ganzberger; Geoffrey Michael,8,0,32,24
1657333730122,MATH 142A,A01,083219,Chow; Bennett,7,0,32,25
1657333730122,MATH 142A,A02,083220,Chow; Bennett,10,0,32,22
1657333730122,MATH 142A,A03,093480,Chow; Bennett,7,0,32,25
1657333730122,MATH 142A,B03,093481,Chow; Bennett,8,0,32,24
1657333730122,MATH 142A,B04,093558,Chow; Bennett,13,0,32,19
1657333730122,MATH 142A,B05,093559,Chow; Bennett,6,0,32,26
1657333736154,MATH 193A,A01,083224,Rotar; Vladimir,7,0,34,27
1657333736154,MATH 193A,A02,083225,Rotar; Vladimir,7,0,34,27
1657333736154,MATH 193A,A03,083781,Rotar; Vladimir,3,0,34,31
1657333736154,MATH 193A,A04,083782,Rotar; Vladimir,9,0,34,25
1657333736154,MATH 193A,A05,093482,Rotar; Vladimir,10,0,34,24
1657333742182,MATH 197,001,091859,McAuley; Julian John,9999,0,9999,0
1657333742182,MATH 197,002,095566,Kedlaya; Kiran S.,9997,0,9999,2
1657333742182,MATH 197,003,095567,Xiao; Ming,9999,0,9999,0
1657333742182,MATH 197,004,095571,Perols; Johan Lars,9998,0,9999,1
1657333749232,COGS 9,A01,083615,Shannon; Kyle Michael,8,0,75,67
1657333755258,COGS 11,A01,083617,Boyle; Mary E. T.,22,0,48,26
1657333761293,COGS 13,A01,083071,Bastos; Amalia Pinkusfeld,11,0,71,60
1657333767321,COGS 14A,A01,092681,Semenuks; Arturs,3,1,100,97
1657333773345,COGS 14B,A01,083073,Cheng; Tzu-Han,6,0,63,57
1657333779373,COGS 17,A01,092677,Semenuks; Arturs,6,0,81,75
1657333785396,COGS 100,A01,083619,Allen; Michael Gordon,16,0,70,54
1657333791419,COGS 101A,A01,083621,Davis; Joshua Daniel,9,0,68,59
1657333797457,COGS 101B,A01,091572,Allen; Michael Gordon,11,0,65,54
1657333803481,COGS 101C,A01,083625,Delgado; Tania,17,0,35,18
1657333809504,COGS 107A,A01,083627,Boyle; Mary E. T.,13,0,60,47
1657333815531,COGS 118A,A01,083075,Gupta; Anjum,19,0,76,57
1657333821559,CSE 3,A50,083646,Miranda; Gregory Joseph,24,0,50,26
1657333827582,CSE 8A,A50,083650,Miranda; Gregory Joseph,17,1,56,39
1657333833609,CSE 11,A01,083080,Cao; Yingjun,6,15,40,34
1657333839634,CSE 12,A01,083652,Krause-Levy; Sophia Louisa,28,1,120,92
1657333845656,CSE 15L,A01,083654,Morris; Justin Loren,9,0,50,41
1657333845656,CSE 15L,A02,083655,Morris; Justin Loren,9,0,50,41
1657333851681,CSE 20,A01,083657,Tran; Khoa Dang,39,0,80,41
1657333857795,CSE 21,A01,095574,Bach; Quang Tran,22,0,48,26
1657333863820,CSE 30,A01,083084,Eldon; John,4,0,80,76
1657333863820,CSE 30,B01,095061,Bhaskar; Nishant,9,0,50,41
1657333869848,CSE 100,A01,083659,Cao; Yingjun,4,4,70,66
1657333875872,CSE 134B,A01,083661,Powell; Thomas Allan,22,0,100,78
1657333881911,CSE 140,A01,083663,Gungor; Onat,14,0,85,71
1657333887938,CSE 140L,A01,083088,Eldon; John,21,0,100,79
1657333893963,CSE 175,A01,083665,Kumar; Rakesh,3,0,25,22
1657333899986,CSE 190,A00,092507,Dubnov; Shlomo,7,0,20,13
1657333906014,ECE 45,A01,083139,Congero; Spencer William,6,0,75,69
1657333912039,ECE 65,A50,083695,Saad; Andrew S,12,0,30,18
1657333912039,ECE 65,A51,095125,Saad; Andrew S,24,0,26,2
1657333918067,ECE 109,A01,091882,Touri; Behrouz,19,0,70,51
1657333924089,ECE 180,A00,083140,Abi Samra; Nicholas Camill,1,0,30,29
1657333924089,ECE 180,B00,083141,Abi Samra; Nicholas Camill,0,0,30,30
1657333930113,MATH 10A,A01,083735,Patchell; Gregory David,2,0,30,28
1657333930113,MATH 10A,A02,083736,Patchell; Gregory David,20,0,30,10
1657333930113,MATH 10A,A03,083737,Patchell; Gregory David,16,0,30,14
1657333936139,MATH 10B,A01,083207,Lim; Seonhee,7,0,34,27
1657333936139,MATH 10B,A02,083208,Lim; Seonhee,9,0,35,26
1657333936139,MATH 10B,A03,093472,Lim; Seonhee,7,0,34,27
1657333936139,MATH 10B,B01,083739,Sinha; Shubham,12,0,30,18
1657333942174,MATH 18,A01,083743,Cinel; Cameron Alexander,6,0,30,24
1657333942174,MATH 18,A02,083744,Cinel; Cameron Alexander,17,0,30,13
1657333942174,MATH 18,A03,083745,Cinel; Cameron Alexander,9,0,30,21
1657333942174,MATH 18,B01,083748,Rideout; David Porter,5,0,37,32
1657333942174,MATH 18,B02,083749,Rideout; David Porter,5,0,36,31
1657333942174,MATH 18,B03,083750,Rideout; David Porter,3,0,37,34
1657333942174,MATH 18,B04,083751,Rideout; David Porter,6,0,36,30
1657333942174,MATH 18,B05,093473,Rideout; David Porter,6,0,36,30
1657333942174,MATH 18,B06,093474,Rideout; David Porter,6,0,36,30
1657333948197,MATH 20A,A01,083754,Zheng; Zequn,14,0,40,26
1657333954223,MATH 20B,A01,083756,Briones; Jor-el Thomas Caparas,4,0,36,32
1657333954223,MATH 20B,A02,083757,Briones; Jor-el Thomas Caparas,1,0,36,35
1657333954223,MATH 20B,A03,093475,Briones; Jor-el Thomas Caparas,2,0,36,34
1657333960247,MATH 20C,A01,083760,Briones; Jor-el Thomas Caparas,1,0,35,34
1657333960247,MATH 20C,A02,083761,Briones; Jor-el Thomas Caparas,8,0,35,27
1657333960247,MATH 20C,A03,093476,Briones; Jor-el Thomas Caparas,0,1,36,36
1657333960247,MATH 20C,B01,083762,Bach; Quang Tran,1,0,30,29
1657333966275,MATH 20D,A01,083765,Tran; Brian Kha,5,0,30,25
1657333966275,MATH 20D,A02,083766,Tran; Brian Kha,5,0,30,25
1657333966275,MATH 20D,A03,083767,Tran; Brian Kha,4,0,30,26
1657333972307,MATH 20E,A01,083771,Ganguly; Soumya,9,0,32,23
1657333972307,MATH 20E,A02,083772,Ganguly; Soumya,6,0,32,26
1657333972307,MATH 20E,B01,083773,Ciotti; Benjamin,20,0,35,15
1657333972307,MATH 20E,B02,083774,Ciotti; Benjamin,17,0,35,18
1657333978331,MATH 103A,A01,083777,Greenfeld; Be'Eri,3,0,36,33
1657333978331,MATH 103A,A02,083778,Greenfeld; Be'Eri,5,0,36,31
1657333978331,MATH 103A,A03,093561,Greenfeld; Be'Eri,4,0,36,32
1657333978331,MATH 103A,B01,083779,Greenfeld; Be'Eri,6,0,36,30
1657333978331,MATH 103A,B02,083780,Greenfeld; Be'Eri,4,0,36,32
1657333978331,MATH 103A,B03,093562,Greenfeld; Be'Eri,3,0,36,33
1657333984359,MATH 105,A01,085443,Carter; Anne Toulson,15,0,35,20
1657333984359,MATH 105,A02,093477,Carter; Anne Toulson,20,0,35,15
1657333990386,MATH 109,A01,083213,Ganzberger; Geoffrey Michael,2,0,34,32
1657333990386,MATH 109,A02,083214,Ganzberger; Geoffrey Michael,4,0,34,30
1657333990386,MATH 109,A03,093478,Ganzberger; Geoffrey Michael,2,0,34,32
1657333990386,MATH 109,B01,083215,Ganzberger; Geoffrey Michael,1,0,32,31
1657333990386,MATH 109,B02,083216,Ganzberger; Geoffrey Michael,1,0,32,31
1657333990386,MATH 109,B03,093479,Ganzberger; Geoffrey Michael,8,0,32,24
1657333996411,MATH 142A,A01,083219,Chow; Bennett,7,0,32,25
1657333996411,MATH 142A,A02,083220,Chow; Bennett,10,0,32,22
1657333996411,MATH 142A,A03,093480,Chow; Bennett,7,0,32,25
1657333996411,MATH 142A,B03,093481,Chow; Bennett,8,0,32,24
1657333996411,MATH 142A,B04,093558,Chow; Bennett,13,0,32,19
1657333996411,MATH 142A,B05,093559,Chow; Bennett,6,0,32,26
1657334002440,MATH 193A,A01,083224,Rotar; Vladimir,7,0,34,27
1657334002440,MATH 193A,A02,083225,Rotar; Vladimir,7,0,34,27
1657334002440,MATH 193A,A03,083781,Rotar; Vladimir,3,0,34,31
1657334002440,MATH 193A,A04,083782,Rotar; Vladimir,9,0,34,25
1657334002440,MATH 193A,A05,093482,Rotar; Vladimir,10,0,34,24
1657334008467,MATH 197,001,091859,McAuley; Julian John,9999,0,9999,0
1657334008467,MATH 197,002,095566,Kedlaya; Kiran S.,9997,0,9999,2
1657334008467,MATH 197,003,095567,Xiao; Ming,9999,0,9999,0
1657334008467,MATH 197,004,095571,Perols; Johan Lars,9998,0,9999,1
1657334015529,COGS 9,A01,083615,Shannon; Kyle Michael,8,0,75,67
1657334021553,COGS 11,A01,083617,Boyle; Mary E. T.,22,0,48,26
1657334027576,COGS 13,A01,083071,Bastos; Amalia Pinkusfeld,11,0,71,60
1657334033599,COGS 14A,A01,092681,Semenuks; Arturs,3,1,100,97
1657334039622,COGS 14B,A01,083073,Cheng; Tzu-Han,6,0,63,57
1657334045648,COGS 17,A01,092677,Semenuks; Arturs,6,0,81,75
1657334051671,COGS 100,A01,083619,Allen; Michael Gordon,16,0,70,54
1657334057707,COGS 101A,A01,083621,Davis; Joshua Daniel,9,0,68,59
1657334063731,COGS 101B,A01,091572,Allen; Michael Gordon,11,0,65,54
1657334069756,COGS 101C,A01,083625,Delgado; Tania,17,0,35,18
1657334075777,COGS 107A,A01,083627,Boyle; Mary E. T.,13,0,60,47
1657334081799,COGS 118A,A01,083075,Gupta; Anjum,19,0,76,57
1657334087822,CSE 3,A50,083646,Miranda; Gregory Joseph,24,0,50,26
1657334093860,CSE 8A,A50,083650,Miranda; Gregory Joseph,17,1,56,39
1657334099887,CSE 11,A01,083080,Cao; Yingjun,6,15,40,34
1657334105913,CSE 12,A01,083652,Krause-Levy; Sophia Louisa,28,1,120,92
1657334111937,CSE 15L,A01,083654,Morris; Justin Loren,9,0,50,41
1657334111937,CSE 15L,A02,083655,Morris; Justin Loren,9,0,50,41
1657334117961,CSE 20,A01,083657,Tran; Khoa Dang,39,0,80,41
1657334123988,CSE 21,A01,095574,Bach; Quang Tran,22,0,48,26
1657334130018,CSE 30,A01,083084,Eldon; John,4,0,80,76
1657334130018,CSE 30,B01,095061,Bhaskar; Nishant,9,0,50,41
1657334136046,CSE 100,A01,083659,Cao; Yingjun,4,4,70,66
1657334142069,CSE 134B,A01,083661,Powell; Thomas Allan,22,0,100,78
1657334148092,CSE 140,A01,083663,Gungor; Onat,14,0,85,71
1657334154116,CSE 140L,A01,083088,Eldon; John,21,0,100,79
1657334160141,CSE 175,A01,083665,Kumar; Rakesh,3,0,25,22
1657334166165,CSE 190,A00,092507,Dubnov; Shlomo,7,0,20,13
1657334172187,ECE 45,A01,083139,Congero; Spencer William,6,0,75,69
1657334178222,ECE 65,A50,083695,Saad; Andrew S,12,0,30,18
1657334178222,ECE 65,A51,095125,Saad; Andrew S,24,0,26,2
1657334184262,ECE 109,A01,091882,Touri; Behrouz,19,0,70,51
1657334190291,ECE 180,A00,083140,Abi Samra; Nicholas Camill,1,0,30,29
1657334190291,ECE 180,B00,083141,Abi Samra; Nicholas Camill,0,0,30,30
1657334196313,MATH 10A,A01,083735,Patchell; Gregory David,2,0,30,28
1657334196313,MATH 10A,A02,083736,Patchell; Gregory David,20,0,30,10
1657334196313,MATH 10A,A03,083737,Patchell; Gregory David,16,0,30,14
1657334202342,MATH 10B,A01,083207,Lim; Seonhee,7,0,34,27
1657334202342,MATH 10B,A02,083208,Lim; Seonhee,9,0,35,26
1657334202342,MATH 10B,A03,093472,Lim; Seonhee,7,0,34,27
1657334202342,MATH 10B,B01,083739,Sinha; Shubham,12,0,30,18
1657334208374,MATH 18,A01,083743,Cinel; Cameron Alexander,6,0,30,24
1657334208374,MATH 18,A02,083744,Cinel; Cameron Alexander,17,0,30,13
1657334208374,MATH 18,A03,083745,Cinel; Cameron Alexander,9,0,30,21
1657334208374,MATH 18,B01,083748,Rideout; David Porter,5,0,37,32
1657334208374,MATH 18,B02,083749,Rideout; David Porter,5,0,36,31
1657334208374,MATH 18,B03,083750,Rideout; David Porter,3,0,37,34
1657334208374,MATH 18,B04,083751,Rideout; David Porter,6,0,36,30
1657334208374,MATH 18,B05,093473,Rideout; David Porter,6,0,36,30
1657334208374,MATH 18,B06,093474,Rideout; David Porter,6,0,36,30
1657334214400,MATH 20A,A01,083754,Zheng; Zequn,14,0,40,26
1657334220428,MATH 20B,A01,083756,Briones; Jor-el Thomas Caparas,4,0,36,32
1657334220428,MATH 20B,A02,083757,Briones; Jor-el Thomas Caparas,1,0,36,35
1657334220428,MATH 20B,A03,093475,Briones; Jor-el Thomas Caparas,2,0,36,34
1657334226454,MATH 20C,A01,083760,Briones; Jor-el Thomas Caparas,1,0,35,34
1657334226454,MATH 20C,A02,083761,Briones; Jor-el Thomas Caparas,8,0,35,27
1657334226454,MATH 20C,A03,093476,Briones; Jor-el Thomas Caparas,0,1,36,36
1657334226454,MATH 20C,B01,083762,Bach; Quang Tran,1,0,30,29
1657334232481,MATH 20D,A01,083765,Tran; Brian Kha,5,0,30,25
1657334232481,MATH 20D,A02,083766,Tran; Brian Kha,5,0,30,25
1657334232481,MATH 20D,A03,083767,Tran; Brian Kha,4,0,30,26
1657334238505,MATH 20E,A01,083771,Ganguly; Soumya,9,0,32,23
1657334238505,MATH 20E,A02,083772,Ganguly; Soumya,6,0,32,26
1657334238505,MATH 20E,B01,083773,Ciotti; Benjamin,20,0,35,15
1657334238505,MATH 20E,B02,083774,Ciotti; Benjamin,17,0,35,18
1657334244531,MATH 103A,A01,083777,Greenfeld; Be'Eri,3,0,36,33
1657334244531,MATH 103A,A02,083778,Greenfeld; Be'Eri,5,0,36,31
1657334244531,MATH 103A,A03,093561,Greenfeld; Be'Eri,4,0,36,32
1657334244531,MATH 103A,B01,083779,Greenfeld; Be'Eri,6,0,36,30
1657334244531,MATH 103A,B02,083780,Greenfeld; Be'Eri,4,0,36,32
1657334244531,MATH 103A,B03,093562,Greenfeld; Be'Eri,3,0,36,33
1657334250556,MATH 105,A01,085443,Carter; Anne Toulson,15,0,35,20
1657334250556,MATH 105,A02,093477,Carter; Anne Toulson,20,0,35,15
1657334256585,MATH 109,A01,083213,Ganzberger; Geoffrey Michael,2,0,34,32
1657334256585,MATH 109,A02,083214,Ganzberger; Geoffrey Michael,4,0,34,30
1657334256585,MATH 109,A03,093478,Ganzberger; Geoffrey Michael,2,0,34,32
1657334256585,MATH 109,B01,083215,Ganzberger; Geoffrey Michael,1,0,32,31
1657334256585,MATH 109,B02,083216,Ganzberger; Geoffrey Michael,1,0,32,31
1657334256585,MATH 109,B03,093479,Ganzberger; Geoffrey Michael,8,0,32,24
1657334262606,MATH 142A,A01,083219,Chow; Bennett,7,0,32,25
1657334262606,MATH 142A,A02,083220,Chow; Bennett,10,0,32,22
1657334262606,MATH 142A,A03,093480,Chow; Bennett,7,0,32,25
1657334262606,MATH 142A,B03,093481,Chow; Bennett,8,0,32,24
1657334262606,MATH 142A,B04,093558,Chow; Bennett,13,0,32,19
1657334262606,MATH 142A,B05,093559,Chow; Bennett,6,0,32,26
1657334268631,MATH 193A,A01,083224,Rotar; Vladimir,7,0,34,27
1657334268631,MATH 193A,A02,083225,Rotar; Vladimir,7,0,34,27
1657334268631,MATH 193A,A03,083781,Rotar; Vladimir,3,0,34,31
1657334268631,MATH 193A,A04,083782,Rotar; Vladimir,9,0,34,25
1657334268631,MATH 193A,A05,093482,Rotar; Vladimir,10,0,34,24
1657334274666,MATH 197,001,091859,McAuley; Julian John,9999,0,9999,0
1657334274666,MATH 197,002,095566,Kedlaya; Kiran S.,9997,0,9999,2
1657334274666,MATH 197,003,095567,Xiao; Ming,9999,0,9999,0
1657334274666,MATH 197,004,095571,Perols; Johan Lars,9998,0,9999,1
1657334281719,COGS 9,A01,083615,Shannon; Kyle Michael,8,0,75,67
1657334287740,COGS 11,A01,083617,Boyle; Mary E. T.,22,0,48,26
1657334293764,COGS 13,A01,083071,Bastos; Amalia Pinkusfeld,11,0,71,60
1657334299786,COGS 14A,A01,092681,Semenuks; Arturs,3,1,100,97
1657334305826,COGS 14B,A01,083073,Cheng; Tzu-Han,6,0,63,57
1657334311861,COGS 17,A01,092677,Semenuks; Arturs,6,0,81,75
1657334317888,COGS 100,A01,083619,Allen; Michael Gordon,16,0,70,54
1657334323910,COGS 101A,A01,083621,Davis; Joshua Daniel,9,0,68,59
1657334329933,COGS 101B,A01,091572,Allen; Michael Gordon,11,0,65,54
1657334335956,COGS 101C,A01,083625,Delgado; Tania,17,0,35,18
1657334341982,COGS 107A,A01,083627,Boyle; Mary E. T.,13,0,60,47
1657334348004,COGS 118A,A01,083075,Gupta; Anjum,19,0,76,57
1657334354026,CSE 3,A50,083646,Miranda; Gregory Joseph,24,0,50,26
1657334360049,CSE 8A,A50,083650,Miranda; Gregory Joseph,17,1,56,39
1657334366077,CSE 11,A01,083080,Cao; Yingjun,6,15,40,34
1657334372105,CSE 12,A01,083652,Krause-Levy; Sophia Louisa,28,1,120,92
1657334378128,CSE 15L,A01,083654,Morris; Justin Loren,9,0,50,41
1657334378128,CSE 15L,A02,083655,Morris; Justin Loren,9,0,50,41
1657334384155,CSE 20,A01,083657,Tran; Khoa Dang,39,0,80,41
1657334390180,CSE 21,A01,095574,Bach; Quang Tran,22,0,48,26
1657334396207,CSE 30,A01,083084,Eldon; John,4,0,80,76
1657334396207,CSE 30,B01,095061,Bhaskar; Nishant,9,0,50,41
1657334402233,CSE 100,A01,083659,Cao; Yingjun,4,4,70,66
1657334408258,CSE 134B,A01,083661,Powell; Thomas Allan,22,0,100,78
1657334414285,CSE 140,A01,083663,Gungor; Onat,14,0,85,71
1657334420308,CSE 140L,A01,083088,Eldon; John,21,0,100,79
1657334426335,CSE 175,A01,083665,Kumar; Rakesh,3,0,25,22
1657334432363,CSE 190,A00,092507,Dubnov; Shlomo,7,0,20,13
1657334438388,ECE 45,A01,083139,Congero; Spencer William,6,0,75,69
1657334444411,ECE 65,A50,083695,Saad; Andrew S,12,0,30,18
1657334444411,ECE 65,A51,095125,Saad; Andrew S,24,0,26,2
1657334450437,ECE 109,A01,091882,Touri; Behrouz,19,0,70,51
1657334456570,ECE 180,A00,083140,Abi Samra; Nicholas Camill,1,0,30,29
1657334456570,ECE 180,B00,083141,Abi Samra; Nicholas Camill,0,0,30,30
1657334462592,MATH 10A,A01,083735,Patchell; Gregory David,2,0,30,28
1657334462592,MATH 10A,A02,083736,Patchell; Gregory David,20,0,30,10
1657334462592,MATH 10A,A03,083737,Patchell; Gregory David,16,0,30,14
1657334468615,MATH 10B,A01,083207,Lim; Seonhee,7,0,34,27
1657334468615,MATH 10B,A02,083208,Lim; Seonhee,9,0,35,26
1657334468615,MATH 10B,A03,093472,Lim; Seonhee,7,0,34,27
1657334468615,MATH 10B,B01,083739,Sinha; Shubham,12,0,30,18
1657334474645,MATH 18,A01,083743,Cinel; Cameron Alexander,6,0,30,24
1657334474645,MATH 18,A02,083744,Cinel; Cameron Alexander,17,0,30,13
1657334474645,MATH 18,A03,083745,Cinel; Cameron Alexander,9,0,30,21
1657334474645,MATH 18,B01,083748,Rideout; David Porter,5,0,37,32
1657334474645,MATH 18,B02,083749,Rideout; David Porter,5,0,36,31
1657334474645,MATH 18,B03,083750,Rideout; David Porter,3,0,37,34
1657334474645,MATH 18,B04,083751,Rideout; David Porter,6,0,36,30
1657334474645,MATH 18,B05,093473,Rideout; David Porter,6,0,36,30
1657334474645,MATH 18,B06,093474,Rideout; David Porter,6,0,36,30
1657334480668,MATH 20A,A01,083754,Zheng; Zequn,14,0,40,26
1657334486697,MATH 20B,A01,083756,Briones; Jor-el Thomas Caparas,4,0,36,32
1657334486697,MATH 20B,A02,083757,Briones; Jor-el Thomas Caparas,1,0,36,35
1657334486697,MATH 20B,A03,093475,Briones; Jor-el Thomas Caparas,2,0,36,34
1657334492721,MATH 20C,A01,083760,Briones; Jor-el Thomas Caparas,1,0,35,34
1657334492721,MATH 20C,A02,083761,Briones; Jor-el Thomas Caparas,8,0,35,27
1657334492721,MATH 20C,A03,093476,Briones; Jor-el Thomas Caparas,0,1,36,36
1657334492721,MATH 20C,B01,083762,Bach; Quang Tran,1,0,30,29
1657334498744,MATH 20D,A01,083765,Tran; Brian Kha,5,0,30,25
1657334498744,MATH 20D,A02,083766,Tran; Brian Kha,5,0,30,25
1657334498744,MATH 20D,A03,083767,Tran; Brian Kha,4,0,30,26
1657334504768,MATH 20E,A01,083771,Ganguly; Soumya,9,0,32,23
1657334504768,MATH 20E,A02,083772,Ganguly; Soumya,6,0,32,26
1657334504768,MATH 20E,B01,083773,Ciotti; Benjamin,20,0,35,15
1657334504768,MATH 20E,B02,083774,Ciotti; Benjamin,17,0,35,18
1657334510791,MATH 103A,A01,083777,Greenfeld; Be'Eri,3,0,36,33
1657334510791,MATH 103A,A02,083778,Greenfeld; Be'Eri,5,0,36,31
1657334510791,MATH 103A,A03,093561,Greenfeld; Be'Eri,4,0,36,32
1657334510791,MATH 103A,B01,083779,Greenfeld; Be'Eri,6,0,36,30
1657334510791,MATH 103A,B02,083780,Greenfeld; Be'Eri,4,0,36,32
1657334510791,MATH 103A,B03,093562,Greenfeld; Be'Eri,3,0,36,33
1657334516817,MATH 105,A01,085443,Carter; Anne Toulson,15,0,35,20
1657334516817,MATH 105,A02,093477,Carter; Anne Toulson,20,0,35,15
1657334522846,MATH 109,A01,083213,Ganzberger; Geoffrey Michael,2,0,34,32
1657334522846,MATH 109,A02,083214,Ganzberger; Geoffrey Michael,4,0,34,30
1657334522846,MATH 109,A03,093478,Ganzberger; Geoffrey Michael,2,0,34,32
1657334522846,MATH 109,B01,083215,Ganzberger; Geoffrey Michael,1,0,32,31
1657334522846,MATH 109,B02,083216,Ganzberger; Geoffrey Michael,1,0,32,31
1657334522846,MATH 109,B03,093479,Ganzberger; Geoffrey Michael,8,0,32,24
1657334528871,MATH 142A,A01,083219,Chow; Bennett,7,0,32,25
1657334528871,MATH 142A,A02,083220,Chow; Bennett,10,0,32,22
1657334528871,MATH 142A,A03,093480,Chow; Bennett,7,0,32,25
1657334528871,MATH 142A,B03,093481,Chow; Bennett,8,0,32,24
1657334528871,MATH 142A,B04,093558,Chow; Bennett,13,0,32,19
1657334528871,MATH 142A,B05,093559,Chow; Bennett,6,0,32,26
1657334534904,MATH 193A,A01,083224,Rotar; Vladimir,7,0,34,27
1657334534904,MATH 193A,A02,083225,Rotar; Vladimir,7,0,34,27
1657334534904,MATH 193A,A03,083781,Rotar; Vladimir,3,0,34,31
1657334534904,MATH 193A,A04,083782,Rotar; Vladimir,9,0,34,25
1657334534904,MATH 193A,A05,093482,Rotar; Vladimir,10,0,34,24
1657334540926,MATH 197,001,091859,McAuley; Julian John,9999,0,9999,0
1657334540926,MATH 197,002,095566,Kedlaya; Kiran S.,9997,0,9999,2
1657334540926,MATH 197,003,095567,Xiao; Ming,9999,0,9999,0
1657334540926,MATH 197,004,095571,Perols; Johan Lars,9998,0,9999,1
1657334547987,COGS 9,A01,083615,Shannon; Kyle Michael,8,0,75,67
1657334554015,COGS 11,A01,083617,Boyle; Mary E. T.,22,0,48,26
1657334560041,COGS 13,A01,083071,Bastos; Amalia Pinkusfeld,11,0,71,60
1657334566072,COGS 14A,A01,092681,Semenuks; Arturs,3,1,100,97
1657334572099,COGS 14B,A01,083073,Cheng; Tzu-Han,6,0,63,57
1657334578125,COGS 17,A01,092677,Semenuks; Arturs,6,0,81,75
1657334584148,COGS 100,A01,083619,Allen; Michael Gordon,16,0,70,54
1657334590185,COGS 101A,A01,083621,Davis; Joshua Daniel,9,0,68,59
1657334596209,COGS 101B,A01,091572,Allen; Michael Gordon,11,0,65,54
1657334602230,COGS 101C,A01,083625,Delgado; Tania,17,0,35,18
1657334608261,COGS 107A,A01,083627,Boyle; Mary E. T.,13,0,60,47
1657334614284,COGS 118A,A01,083075,Gupta; Anjum,19,0,76,57
1657334620308,CSE 3,A50,083646,Miranda; Gregory Joseph,24,0,50,26
1657334626333,CSE 8A,A50,083650,Miranda; Gregory Joseph,17,1,56,39
1657334632358,CSE 11,A01,083080,Cao; Yingjun,6,15,40,34
1657334638386,CSE 12,A01,083652,Krause-Levy; Sophia Louisa,28,1,120,92
1657334644412,CSE 15L,A01,083654,Morris; Justin Loren,9,0,50,41
1657334644412,CSE 15L,A02,083655,Morris; Justin Loren,9,0,50,41
1657334650435,CSE 20,A01,083657,Tran; Khoa Dang,39,0,80,41
1657334656457,CSE 21,A01,095574,Bach; Quang Tran,22,0,48,26
1657334662484,CSE 30,A01,083084,Eldon; John,4,0,80,76
1657334662484,CSE 30,B01,095061,Bhaskar; Nishant,9,0,50,41
1657334668511,CSE 100,A01,083659,Cao; Yingjun,4,4,70,66
1657334674535,CSE 134B,A01,083661,Powell; Thomas Allan,22,0,100,78
1657334680559,CSE 140,A01,083663,Gungor; Onat,14,0,85,71
1657334686582,CSE 140L,A01,083088,Eldon; John,21,0,100,79
1657334692606,CSE 175,A01,083665,Kumar; Rakesh,3,0,25,22
1657334698630,CSE 190,A00,092507,Dubnov; Shlomo,7,0,20,13
1657334704655,ECE 45,A01,083139,Congero; Spencer William,6,0,75,69
1657334710681,ECE 65,A50,083695,Saad; Andrew S,12,0,30,18
1657334710681,ECE 65,A51,095125,Saad; Andrew S,24,0,26,2
1657334716707,ECE 109,A01,091882,Touri; Behrouz,19,0,70,51
1657334722732,ECE 180,A00,083140,Abi Samra; Nicholas Camill,1,0,30,29
1657334722732,ECE 180,B00,083141,Abi Samra; Nicholas Camill,0,0,30,30
1657334728759,MATH 10A,A01,083735,Patchell; Gregory David,2,0,30,28
1657334728759,MATH 10A,A02,083736,Patchell; Gregory David,20,0,30,10
1657334728759,MATH 10A,A03,083737,Patchell; Gregory David,16,0,30,14
1657334734790,MATH 10B,A01,083207,Lim; Seonhee,7,0,34,27
1657334734790,MATH 10B,A02,083208,Lim; Seonhee,9,0,35,26
1657334734790,MATH 10B,A03,093472,Lim; Seonhee,7,0,34,27
1657334734790,MATH 10B,B01,083739,Sinha; Shubham,12,0,30,18
1657334740820,MATH 18,A01,083743,Cinel; Cameron Alexander,6,0,30,24
1657334740820,MATH 18,A02,083744,Cinel; Cameron Alexander,17,0,30,13
1657334740820,MATH 18,A03,083745,Cinel; Cameron Alexander,9,0,30,21
1657334740820,MATH 18,B01,083748,Rideout; David Porter,5,0,37,32
1657334740820,MATH 18,B02,083749,Rideout; David Porter,5,0,36,31
1657334740820,MATH 18,B03,083750,Rideout; David Porter,3,0,37,34
1657334740820,MATH 18,B04,083751,Rideout; David Porter,6,0,36,30
1657334740820,MATH 18,B05,093473,Rideout; David Porter,6,0,36,30
1657334740820,MATH 18,B06,093474,Rideout; David Porter,6,0,36,30
1657334746847,MATH 20A,A01,083754,Zheng; Zequn,14,0,40,26
1657334752870,MATH 20B,A01,083756,Briones; Jor-el Thomas Caparas,4,0,36,32
1657334752870,MATH 20B,A02,083757,Briones; Jor-el Thomas Caparas,1,0,36,35
1657334752870,MATH 20B,A03,093475,Briones; Jor-el Thomas Caparas,2,0,36,34
1657334758897,MATH 20C,A01,083760,Briones; Jor-el Thomas Caparas,1,0,35,34
1657334758897,MATH 20C,A02,083761,Briones; Jor-el Thomas Caparas,8,0,35,27
1657334758897,MATH 20C,A03,093476,Briones; Jor-el Thomas Caparas,0,1,36,36
1657334758897,MATH 20C,B01,083762,Bach; Quang Tran,1,0,30,29
1657334764927,MATH 20D,A01,083765,Tran; Brian Kha,5,0,30,25
1657334764927,MATH 20D,A02,083766,Tran; Brian Kha,5,0,30,25
1657334764927,MATH 20D,A03,083767,Tran; Brian Kha,4,0,30,26
1657334770951,MATH 20E,A01,083771,Ganguly; Soumya,9,0,32,23
1657334770951,MATH 20E,A02,083772,Ganguly; Soumya,6,0,32,26
1657334770951,MATH 20E,B01,083773,Ciotti; Benjamin,20,0,35,15
1657334770951,MATH 20E,B02,083774,Ciotti; Benjamin,17,0,35,18
1657334776978,MATH 103A,A01,083777,Greenfeld; Be'Eri,3,0,36,33
1657334776978,MATH 103A,A02,083778,Greenfeld; Be'Eri,5,0,36,31
1657334776978,MATH 103A,A03,093561,Greenfeld; Be'Eri,4,0,36,32
1657334776978,MATH 103A,B01,083779,Greenfeld; Be'Eri,6,0,36,30
1657334776978,MATH 103A,B02,083780,Greenfeld; Be'Eri,4,0,36,32
1657334776978,MATH 103A,B03,093562,Greenfeld; Be'Eri,3,0,36,33
1657334783005,MATH 105,A01,085443,Carter; Anne Toulson,15,0,35,20
1657334783005,MATH 105,A02,093477,Carter; Anne Toulson,20,0,35,15
1657334789029,MATH 109,A01,083213,Ganzberger; Geoffrey Michael,2,0,34,32
1657334789029,MATH 109,A02,083214,Ganzberger; Geoffrey Michael,4,0,34,30
1657334789029,MATH 109,A03,093478,Ganzberger; Geoffrey Michael,2,0,34,32
1657334789029,MATH 109,B01,083215,Ganzberger; Geoffrey Michael,1,0,32,31
1657334789029,MATH 109,B02,083216,Ganzberger; Geoffrey Michael,1,0,32,31
1657334789029,MATH 109,B03,093479,Ganzberger; Geoffrey Michael,8,0,32,24
1657334795053,MATH 142A,A01,083219,Chow; Bennett,7,0,32,25
1657334795053,MATH 142A,A02,083220,Chow; Bennett,10,0,32,22
1657334795053,MATH 142A,A03,093480,Chow; Bennett,7,0,32,25
1657334795053,MATH 142A,B03,093481,Chow; Bennett,8,0,32,24
1657334795053,MATH 142A,B04,093558,Chow; Bennett,13,0,32,19
1657334795053,MATH 142A,B05,093559,Chow; Bennett,6,0,32,26
1657334801076,MATH 193A,A01,083224,Rotar; Vladimir,7,0,34,27
1657334801076,MATH 193A,A02,083225,Rotar; Vladimir,7,0,34,27
1657334801076,MATH 193A,A03,083781,Rotar; Vladimir,3,0,34,31
1657334801076,MATH 193A,A04,083782,Rotar; Vladimir,9,0,34,25
1657334801076,MATH 193A,A05,093482,Rotar; Vladimir,10,0,34,24
1657334807099,MATH 197,001,091859,McAuley; Julian John,9999,0,9999,0
1657334807099,MATH 197,002,095566,Kedlaya; Kiran S.,9997,0,9999,2
1657334807099,MATH 197,003,095567,Xiao; Ming,9999,0,9999,0
1657334807099,MATH 197,004,095571,Perols; Johan Lars,9998,0,9999,1
1657334814171,COGS 9,A01,083615,Shannon; Kyle Michael,8,0,75,67
1657334820202,COGS 11,A01,083617,Boyle; Mary E. T.,22,0,48,26
1657334826226,COGS 13,A01,083071,Bastos; Amalia Pinkusfeld,11,0,71,60
1657334832252,COGS 14A,A01,092681,Semenuks; Arturs,3,1,100,97
1657334838274,COGS 14B,A01,083073,Cheng; Tzu-Han,6,0,63,57
1657334844297,COGS 17,A01,092677,Semenuks; Arturs,6,0,81,75
1657334850332,COGS 100,A01,083619,Allen; Michael Gordon,16,0,70,54
1657334856353,COGS 101A,A01,083621,Davis; Joshua Daniel,9,0,68,59
1657334862380,COGS 101B,A01,091572,Allen; Michael Gordon,11,0,65,54
1657334868405,COGS 101C,A01,083625,Delgado; Tania,17,0,35,18
1657334874427,COGS 107A,A01,083627,Boyle; Mary E. T.,13,0,60,47
1657334880448,COGS 118A,A01,083075,Gupta; Anjum,19,0,76,57
1657334886474,CSE 3,A50,083646,Miranda; Gregory Joseph,24,0,50,26
1657334892496,CSE 8A,A50,083650,Miranda; Gregory Joseph,17,1,56,39
1657334898519,CSE 11,A01,083080,Cao; Yingjun,6,15,40,34
1657334904545,CSE 12,A01,083652,Krause-Levy; Sophia Louisa,28,1,120,92
1657334910568,CSE 15L,A01,083654,Morris; Justin Loren,9,0,50,41
1657334910568,CSE 15L,A02,083655,Morris; Justin Loren,9,0,50,41
1657334916595,CSE 20,A01,083657,Tran; Khoa Dang,39,0,80,41
1657334922618,CSE 21,A01,095574,Bach; Quang Tran,22,0,48,26
1657334928653,CSE 30,A01,083084,Eldon; John,4,0,80,76
1657334928653,CSE 30,B01,095061,Bhaskar; Nishant,9,0,50,41
1657334934678,CSE 100,A01,083659,Cao; Yingjun,4,4,70,66
1657334940701,CSE 134B,A01,083661,Powell; Thomas Allan,22,0,100,78
1657334946728,CSE 140,A01,083663,Gungor; Onat,14,0,85,71
1657334952750,CSE 140L,A01,083088,Eldon; John,21,0,100,79
1657334958773,CSE 175,A01,083665,Kumar; Rakesh,3,0,25,22
1657334964798,CSE 190,A00,092507,Dubnov; Shlomo,7,0,20,13
1657334970821,ECE 45,A01,083139,Congero; Spencer William,6,0,75,69
1657334976850,ECE 65,A50,083695,Saad; Andrew S,12,0,30,18
1657334976850,ECE 65,A51,095125,Saad; Andrew S,24,0,26,2
1657334982872,ECE 109,A01,091882,Touri; Behrouz,19,0,70,51
1657334988898,ECE 180,A00,083140,Abi Samra; Nicholas Camill,1,0,30,29
1657334988898,ECE 180,B00,083141,Abi Samra; Nicholas Camill,0,0,30,30
1657334994922,MATH 10A,A01,083735,Patchell; Gregory David,2,0,30,28
1657334994922,MATH 10A,A02,083736,Patchell; Gregory David,20,0,30,10
1657334994922,MATH 10A,A03,083737,Patchell; Gregory David,16,0,30,14
1657335000952,MATH 10B,A01,083207,Lim; Seonhee,7,0,34,27
1657335000952,MATH 10B,A02,083208,Lim; Seonhee,9,0,35,26
1657335000952,MATH 10B,A03,093472,Lim; Seonhee,7,0,34,27
1657335000952,MATH 10B,B01,083739,Sinha; Shubham,12,0,30,18
1657335006986,MATH 18,A01,083743,Cinel; Cameron Alexander,6,0,30,24
1657335006986,MATH 18,A02,083744,Cinel; Cameron Alexander,17,0,30,13
1657335006986,MATH 18,A03,083745,Cinel; Cameron Alexander,9,0,30,21
1657335006986,MATH 18,B01,083748,Rideout; David Porter,5,0,37,32
1657335006986,MATH 18,B02,083749,Rideout; David Porter,5,0,36,31
1657335006986,MATH 18,B03,083750,Rideout; David Porter,3,0,37,34
1657335006986,MATH 18,B04,083751,Rideout; David Porter,6,0,36,30
1657335006986,MATH 18,B05,093473,Rideout; David Porter,6,0,36,30
1657335006986,MATH 18,B06,093474,Rideout; David Porter,6,0,36,30
1657335013011,MATH 20A,A01,083754,Zheng; Zequn,14,0,40,26
1657335019036,MATH 20B,A01,083756,Briones; Jor-el Thomas Caparas,4,0,36,32
1657335019036,MATH 20B,A02,083757,Briones; Jor-el Thomas Caparas,1,0,36,35
1657335019036,MATH 20B,A03,093475,Briones; Jor-el Thomas Caparas,2,0,36,34
1657335025064,MATH 20C,A01,083760,Briones; Jor-el Thomas Caparas,1,0,35,34
1657335025064,MATH 20C,A02,083761,Briones; Jor-el Thomas Caparas,8,0,35,27
1657335025064,MATH 20C,A03,093476,Briones; Jor-el Thomas Caparas,0,1,36,36
1657335025064,MATH 20C,B01,083762,Bach; Quang Tran,1,0,30,29
1657335031086,MATH 20D,A01,083765,Tran; Brian Kha,5,0,30,25
1657335031086,MATH 20D,A02,083766,Tran; Brian Kha,5,0,30,25
1657335031086,MATH 20D,A03,083767,Tran; Brian Kha,4,0,30,26
1657335037114,MATH 20E,A01,083771,Ganguly; Soumya,9,0,32,23
1657335037114,MATH 20E,A02,083772,Ganguly; Soumya,6,0,32,26
1657335037114,MATH 20E,B01,083773,Ciotti; Benjamin,20,0,35,15
1657335037114,MATH 20E,B02,083774,Ciotti; Benjamin,17,0,35,18
1657335043136,MATH 103A,A01,083777,Greenfeld; Be'Eri,3,0,36,33
1657335043136,MATH 103A,A02,083778,Greenfeld; Be'Eri,5,0,36,31
1657335043136,MATH 103A,A03,093561,Greenfeld; Be'Eri,4,0,36,32
1657335043136,MATH 103A,B01,083779,Greenfeld; Be'Eri,6,0,36,30
1657335043136,MATH 103A,B02,083780,Greenfeld; Be'Eri,4,0,36,32
1657335043136,MATH 103A,B03,093562,Greenfeld; Be'Eri,3,0,36,33
1657335049159,MATH 105,A01,085443,Carter; Anne Toulson,15,0,35,20
1657335049159,MATH 105,A02,093477,Carter; Anne Toulson,20,0,35,15
1657335055259,MATH 109,A01,083213,Ganzberger; Geoffrey Michael,2,0,34,32
1657335055259,MATH 109,A02,083214,Ganzberger; Geoffrey Michael,4,0,34,30
1657335055259,MATH 109,A03,093478,Ganzberger; Geoffrey Michael,2,0,34,32
1657335055259,MATH 109,B01,083215,Ganzberger; Geoffrey Michael,1,0,32,31
1657335055259,MATH 109,B02,083216,Ganzberger; Geoffrey Michael,1,0,32,31
1657335055259,MATH 109,B03,093479,Ganzberger; Geoffrey Michael,8,0,32,24
1657335061289,MATH 142A,A01,083219,Chow; Bennett,7,0,32,25
1657335061289,MATH 142A,A02,083220,Chow; Bennett,10,0,32,22
1657335061289,MATH 142A,A03,093480,Chow; Bennett,7,0,32,25
1657335061289,MATH 142A,B03,093481,Chow; Bennett,8,0,32,24
1657335061289,MATH 142A,B04,093558,Chow; Bennett,13,0,32,19
1657335061289,MATH 142A,B05,093559,Chow; Bennett,6,0,32,26
1657335067316,MATH 193A,A01,083224,Rotar; Vladimir,7,0,34,27
1657335067316,MATH 193A,A02,083225,Rotar; Vladimir,7,0,34,27
1657335067316,MATH 193A,A03,083781,Rotar; Vladimir,3,0,34,31
1657335067316,MATH 193A,A04,083782,Rotar; Vladimir,9,0,34,25
1657335067316,MATH 193A,A05,093482,Rotar; Vladimir,10,0,34,24
1657335073338,MATH 197,001,091859,McAuley; Julian John,9999,0,9999,0
1657335073338,MATH 197,002,095566,Kedlaya; Kiran S.,9997,0,9999,2
1657335073338,MATH 197,003,095567,Xiao; Ming,9999,0,9999,0
1657335073338,MATH 197,004,095571,Perols; Johan Lars,9998,0,9999,1
1657335080398,COGS 9,A01,083615,Shannon; Kyle Michael,8,0,75,67
1657335086421,COGS 11,A01,083617,Boyle; Mary E. T.,22,0,48,26
1657335092442,COGS 13,A01,083071,Bastos; Amalia Pinkusfeld,11,0,71,60
1657335098466,COGS 14A,A01,092681,Semenuks; Arturs,3,1,100,97
1657335104490,COGS 14B,A01,083073,Cheng; Tzu-Han,6,0,63,57
1657335110515,COGS 17,A01,092677,Semenuks; Arturs,6,0,81,75
1657335116541,COGS 100,A01,083619,Allen; Michael Gordon,16,0,70,54
1657335122571,COGS 101A,A01,083621,Davis; Joshua Daniel,9,0,68,59
1657335128596,COGS 101B,A01,091572,Allen; Michael Gordon,11,0,65,54
1657335134619,COGS 101C,A01,083625,Delgado; Tania,17,0,35,18
1657335140644,COGS 107A,A01,083627,Boyle; Mary E. T.,13,0,60,47
1657335146667,COGS 118A,A01,083075,Gupta; Anjum,19,0,76,57
1657335152690,CSE 3,A50,083646,Miranda; Gregory Joseph,24,0,50,26
1657335158716,CSE 8A,A50,083650,Miranda; Gregory Joseph,17,1,56,39
1657335164738,CSE 11,A01,083080,Cao; Yingjun,6,15,40,34
1657335170765,CSE 12,A01,083652,Krause-Levy; Sophia Louisa,28,1,120,92
1657335176792,CSE 15L,A01,083654,Morris; Justin Loren,9,0,50,41
1657335176792,CSE 15L,A02,083655,Morris; Justin Loren,9,0,50,41
1657335182813,CSE 20,A01,083657,Tran; Khoa Dang,39,0,80,41
1657335188835,CSE 21,A01,095574,Bach; Quang Tran,22,0,48,26
1657335194858,CSE 30,A01,083084,Eldon; John,4,0,80,76
1657335194858,CSE 30,B01,095061,Bhaskar; Nishant,9,0,50,41
1657335200880,CSE 100,A01,083659,Cao; Yingjun,4,4,70,66
1657335206905,CSE 134B,A01,083661,Powell; Thomas Allan,22,0,100,78
1657335212928,CSE 140,A01,083663,Gungor; Onat,14,0,85,71
1657335218952,CSE 140L,A01,083088,Eldon; John,21,0,100,79
1657335224977,CSE 175,A01,083665,Kumar; Rakesh,3,0,25,22
1657335231000,CSE 190,A00,092507,Dubnov; Shlomo,7,0,20,13
1657335237024,ECE 45,A01,083139,Congero; Spencer William,6,0,75,69
1657335243046,ECE 65,A50,083695,Saad; Andrew S,12,0,30,18
1657335243046,ECE 65,A51,095125,Saad; Andrew S,24,0,26,2
1657335249069,ECE 109,A01,091882,Touri; Behrouz,19,0,70,51
1657335255092,ECE 180,A00,083140,Abi Samra; Nicholas Camill,1,0,30,29
1657335255092,ECE 180,B00,083141,Abi Samra; Nicholas Camill,0,0,30,30
1657335261118,MATH 10A,A01,083735,Patchell; Gregory David,2,0,30,28
1657335261118,MATH 10A,A02,083736,Patchell; Gregory David,20,0,30,10
1657335261118,MATH 10A,A03,083737,Patchell; Gregory David,16,0,30,14
1657335267142,MATH 10B,A01,083207,Lim; Seonhee,7,0,34,27
1657335267142,MATH 10B,A02,083208,Lim; Seonhee,9,0,35,26
1657335267142,MATH 10B,A03,093472,Lim; Seonhee,7,0,34,27
1657335267142,MATH 10B,B01,083739,Sinha; Shubham,12,0,30,18
1657335273173,MATH 18,A01,083743,Cinel; Cameron Alexander,6,0,30,24
1657335273173,MATH 18,A02,083744,Cinel; Cameron Alexander,17,0,30,13
1657335273173,MATH 18,A03,083745,Cinel; Cameron Alexander,9,0,30,21
1657335273173,MATH 18,B01,083748,Rideout; David Porter,5,0,37,32
1657335273173,MATH 18,B02,083749,Rideout; David Porter,5,0,36,31
1657335273173,MATH 18,B03,083750,Rideout; David Porter,3,0,37,34
1657335273173,MATH 18,B04,083751,Rideout; David Porter,6,0,36,30
1657335273173,MATH 18,B05,093473,Rideout; David Porter,6,0,36,30
1657335273173,MATH 18,B06,093474,Rideout; David Porter,6,0,36,30
1657335279201,MATH 20A,A01,083754,Zheng; Zequn,14,0,40,26
1657335285225,MATH 20B,A01,083756,Briones; Jor-el Thomas Caparas,4,0,36,32
1657335285225,MATH 20B,A02,083757,Briones; Jor-el Thomas Caparas,1,0,36,35
1657335285225,MATH 20B,A03,093475,Briones; Jor-el Thomas Caparas,2,0,36,34
1657335291251,MATH 20C,A01,083760,Briones; Jor-el Thomas Caparas,1,0,35,34
1657335291251,MATH 20C,A02,083761,Briones; Jor-el Thomas Caparas,8,0,35,27
1657335291251,MATH 20C,A03,093476,Briones; Jor-el Thomas Caparas,0,1,36,36
1657335291251,MATH 20C,B01,083762,Bach; Quang Tran,1,0,30,29
1657335297273,MATH 20D,A01,083765,Tran; Brian Kha,5,0,30,25
1657335297273,MATH 20D,A02,083766,Tran; Brian Kha,5,0,30,25
1657335297273,MATH 20D,A03,083767,Tran; Brian Kha,4,0,30,26
1657335303299,MATH 20E,A01,083771,Ganguly; Soumya,9,0,32,23
1657335303299,MATH 20E,A02,083772,Ganguly; Soumya,6,0,32,26
1657335303299,MATH 20E,B01,083773,Ciotti; Benjamin,20,0,35,15
1657335303299,MATH 20E,B02,083774,Ciotti; Benjamin,17,0,35,18
1657335309321,MATH 103A,A01,083777,Greenfeld; Be'Eri,3,0,36,33
1657335309321,MATH 103A,A02,083778,Greenfeld; Be'Eri,5,0,36,31
1657335309321,MATH 103A,A03,093561,Greenfeld; Be'Eri,4,0,36,32
1657335309321,MATH 103A,B01,083779,Greenfeld; Be'Eri,6,0,36,30
1657335309321,MATH 103A,B02,083780,Greenfeld; Be'Eri,4,0,36,32
1657335309321,MATH 103A,B03,093562,Greenfeld; Be'Eri,3,0,36,33
1657335315348,MATH 105,A01,085443,Carter; Anne Toulson,15,0,35,20
1657335315348,MATH 105,A02,093477,Carter; Anne Toulson,20,0,35,15
1657335321378,MATH 109,A01,083213,Ganzberger; Geoffrey Michael,2,0,34,32
1657335321378,MATH 109,A02,083214,Ganzberger; Geoffrey Michael,4,0,34,30
1657335321378,MATH 109,A03,093478,Ganzberger; Geoffrey Michael,2,0,34,32
1657335321378,MATH 109,B01,083215,Ganzberger; Geoffrey Michael,1,0,32,31
1657335321378,MATH 109,B02,083216,Ganzberger; Geoffrey Michael,1,0,32,31
1657335321378,MATH 109,B03,093479,Ganzberger; Geoffrey Michael,8,0,32,24
1657335327403,MATH 142A,A01,083219,Chow; Bennett,7,0,32,25
1657335327403,MATH 142A,A02,083220,Chow; Bennett,10,0,32,22
1657335327403,MATH 142A,A03,093480,Chow; Bennett,7,0,32,25
1657335327403,MATH 142A,B03,093481,Chow; Bennett,8,0,32,24
1657335327403,MATH 142A,B04,093558,Chow; Bennett,13,0,32,19
1657335327403,MATH 142A,B05,093559,Chow; Bennett,6,0,32,26
1657335333436,MATH 193A,A01,083224,Rotar; Vladimir,7,0,34,27
1657335333436,MATH 193A,A02,083225,Rotar; Vladimir,7,0,34,27
1657335333436,MATH 193A,A03,083781,Rotar; Vladimir,3,0,34,31
1657335333436,MATH 193A,A04,083782,Rotar; Vladimir,9,0,34,25
1657335333436,MATH 193A,A05,093482,Rotar; Vladimir,10,0,34,24
1657335339461,MATH 197,001,091859,McAuley; Julian John,9999,0,9999,0
1657335339461,MATH 197,002,095566,Kedlaya; Kiran S.,9997,0,9999,2
1657335339461,MATH 197,003,095567,Xiao; Ming,9999,0,9999,0
1657335339461,MATH 197,004,095571,Perols; Johan Lars,9998,0,9999,1
1657335346514,COGS 9,A01,083615,Shannon; Kyle Michael,8,0,75,67
1657335352539,COGS 11,A01,083617,Boyle; Mary E. T.,22,0,48,26
1657335358568,COGS 13,A01,083071,Bastos; Amalia Pinkusfeld,11,0,71,60
1657335364590,COGS 14A,A01,092681,Semenuks; Arturs,3,1,100,97
1657335370616,COGS 14B,A01,083073,Cheng; Tzu-Han,6,0,63,57
1657335376640,COGS 17,A01,092677,Semenuks; Arturs,6,0,81,75
1657335382662,COGS 100,A01,083619,Allen; Michael Gordon,16,0,70,54
1657335388692,COGS 101A,A01,083621,Davis; Joshua Daniel,9,0,68,59
1657335394714,COGS 101B,A01,091572,Allen; Michael Gordon,11,0,65,54
1657335400740,COGS 101C,A01,083625,Delgado; Tania,17,0,35,18
1657335406763,COGS 107A,A01,083627,Boyle; Mary E. T.,13,0,60,47
1657335412788,COGS 118A,A01,083075,Gupta; Anjum,19,0,76,57
1657335418815,CSE 3,A50,083646,Miranda; Gregory Joseph,24,0,50,26
1657335424841,CSE 8A,A50,083650,Miranda; Gregory Joseph,17,1,56,39
1657335430868,CSE 11,A01,083080,Cao; Yingjun,6,15,40,34
1657335436890,CSE 12,A01,083652,Krause-Levy; Sophia Louisa,28,1,120,92
1657335442918,CSE 15L,A01,083654,Morris; Justin Loren,9,0,50,41
1657335442918,CSE 15L,A02,083655,Morris; Justin Loren,9,0,50,41
1657335448942,CSE 20,A01,083657,Tran; Khoa Dang,39,0,80,41
1657335454975,CSE 21,A01,095574,Bach; Quang Tran,22,0,48,26
1657335461002,CSE 30,A01,083084,Eldon; John,4,0,80,76
1657335461002,CSE 30,B01,095061,Bhaskar; Nishant,9,0,50,41
1657335467026,CSE 100,A01,083659,Cao; Yingjun,4,4,70,66
1657335473051,CSE 134B,A01,083661,Powell; Thomas Allan,22,0,100,78
1657335479076,CSE 140,A01,083663,Gungor; Onat,14,0,85,71
1657335485103,CSE 140L,A01,083088,Eldon; John,21,0,100,79
1657335491129,CSE 175,A01,083665,Kumar; Rakesh,3,0,25,22
1657335497154,CSE 190,A00,092507,Dubnov; Shlomo,7,0,20,13
1657335503177,ECE 45,A01,083139,Congero; Spencer William,6,0,75,69
1657335509211,ECE 65,A50,083695,Saad; Andrew S,12,0,30,18
1657335509211,ECE 65,A51,095125,Saad; Andrew S,24,0,26,2
1657335515235,ECE 109,A01,091882,Touri; Behrouz,19,0,70,51
1657335521260,ECE 180,A00,083140,Abi Samra; Nicholas Camill,1,0,30,29
1657335521260,ECE 180,B00,083141,Abi Samra; Nicholas Camill,0,0,30,30
1657335527283,MATH 10A,A01,083735,Patchell; Gregory David,2,0,30,28
1657335527283,MATH 10A,A02,083736,Patchell; Gregory David,20,0,30,10
1657335527283,MATH 10A,A03,083737,Patchell; Gregory David,16,0,30,14
1657335533312,MATH 10B,A01,083207,Lim; Seonhee,7,0,34,27
1657335533312,MATH 10B,A02,083208,Lim; Seonhee,9,0,35,26
1657335533312,MATH 10B,A03,093472,Lim; Seonhee,7,0,34,27
1657335533312,MATH 10B,B01,083739,Sinha; Shubham,12,0,30,18
1657335539343,MATH 18,A01,083743,Cinel; Cameron Alexander,6,0,30,24
1657335539343,MATH 18,A02,083744,Cinel; Cameron Alexander,17,0,30,13
1657335539343,MATH 18,A03,083745,Cinel; Cameron Alexander,9,0,30,21
1657335539343,MATH 18,B01,083748,Rideout; David Porter,5,0,37,32
1657335539343,MATH 18,B02,083749,Rideout; David Porter,5,0,36,31
1657335539343,MATH 18,B03,083750,Rideout; David Porter,3,0,37,34
1657335539343,MATH 18,B04,083751,Rideout; David Porter,6,0,36,30
1657335539343,MATH 18,B05,093473,Rideout; David Porter,6,0,36,30
1657335539343,MATH 18,B06,093474,Rideout; David Porter,6,0,36,30
1657335545364,MATH 20A,A01,083754,Zheng; Zequn,14,0,40,26
1657335551390,MATH 20B,A01,083756,Briones; Jor-el Thomas Caparas,4,0,36,32
1657335551390,MATH 20B,A02,083757,Briones; Jor-el Thomas Caparas,1,0,36,35
1657335551390,MATH 20B,A03,093475,Briones; Jor-el Thomas Caparas,2,0,36,34
1657335557419,MATH 20C,A01,083760,Briones; Jor-el Thomas Caparas,1,0,35,34
1657335557419,MATH 20C,A02,083761,Briones; Jor-el Thomas Caparas,8,0,35,27
1657335557419,MATH 20C,A03,093476,Briones; Jor-el Thomas Caparas,0,1,36,36
1657335557419,MATH 20C,B01,083762,Bach; Quang Tran,1,0,30,29
1657335563450,MATH 20D,A01,083765,Tran; Brian Kha,5,0,30,25
1657335563450,MATH 20D,A02,083766,Tran; Brian Kha,5,0,30,25
1657335563450,MATH 20D,A03,083767,Tran; Brian Kha,4,0,30,26
1657335569475,MATH 20E,A01,083771,Ganguly; Soumya,9,0,32,23
1657335569475,MATH 20E,A02,083772,Ganguly; Soumya,6,0,32,26
1657335569475,MATH 20E,B01,083773,Ciotti; Benjamin,20,0,35,15
1657335569475,MATH 20E,B02,083774,Ciotti; Benjamin,17,0,35,18
1657335575502,MATH 103A,A01,083777,Greenfeld; Be'Eri,3,0,36,33
1657335575502,MATH 103A,A02,083778,Greenfeld; Be'Eri,5,0,36,31
1657335575502,MATH 103A,A03,093561,Greenfeld; Be'Eri,4,0,36,32
1657335575502,MATH 103A,B01,083779,Greenfeld; Be'Eri,6,0,36,30
1657335575502,MATH 103A,B02,083780,Greenfeld; Be'Eri,4,0,36,32
1657335575502,MATH 103A,B03,093562,Greenfeld; Be'Eri,3,0,36,33
1657335581529,MATH 105,A01,085443,Carter; Anne Toulson,15,0,35,20
1657335581529,MATH 105,A02,093477,Carter; Anne Toulson,20,0,35,15
1657335587552,MATH 109,A01,083213,Ganzberger; Geoffrey Michael,2,0,34,32
1657335587552,MATH 109,A02,083214,Ganzberger; Geoffrey Michael,4,0,34,30
1657335587552,MATH 109,A03,093478,Ganzberger; Geoffrey Michael,2,0,34,32
1657335587552,MATH 109,B01,083215,Ganzberger; Geoffrey Michael,1,0,32,31
1657335587552,MATH 109,B02,083216,Ganzberger; Geoffrey Michael,1,0,32,31
1657335587552,MATH 109,B03,093479,Ganzberger; Geoffrey Michael,8,0,32,24
1657335593577,MATH 142A,A01,083219,Chow; Bennett,7,0,32,25
1657335593577,MATH 142A,A02,083220,Chow; Bennett,10,0,32,22
1657335593577,MATH 142A,A03,093480,Chow; Bennett,7,0,32,25
1657335593577,MATH 142A,B03,093481,Chow; Bennett,8,0,32,24
1657335593577,MATH 142A,B04,093558,Chow; Bennett,13,0,32,19
1657335593577,MATH 142A,B05,093559,Chow; Bennett,6,0,32,26
1657335599605,MATH 193A,A01,083224,Rotar; Vladimir,7,0,34,27
1657335599605,MATH 193A,A02,083225,Rotar; Vladimir,7,0,34,27
1657335599605,MATH 193A,A03,083781,Rotar; Vladimir,3,0,34,31
1657335599605,MATH 193A,A04,083782,Rotar; Vladimir,9,0,34,25
1657335599605,MATH 193A,A05,093482,Rotar; Vladimir,10,0,34,24
1657335605631,MATH 197,001,091859,McAuley; Julian John,9999,0,9999,0
1657335605631,MATH 197,002,095566,Kedlaya; Kiran S.,9997,0,9999,2
1657335605631,MATH 197,003,095567,Xiao; Ming,9999,0,9999,0
1657335605631,MATH 197,004,095571,Perols; Johan Lars,9998,0,9999,1
1657335612697,COGS 9,A01,083615,Shannon; Kyle Michael,8,0,75,67
1657335618721,COGS 11,A01,083617,Boyle; Mary E. T.,22,0,48,26
1657335624748,COGS 13,A01,083071,Bastos; Amalia Pinkusfeld,11,0,71,60
1657335630781,COGS 14A,A01,092681,Semenuks; Arturs,3,1,100,97
1657335636815,COGS 14B,A01,083073,Cheng; Tzu-Han,6,0,63,57
1657335642841,COGS 17,A01,092677,Semenuks; Arturs,6,0,81,75
1657335648957,COGS 100,A01,083619,Allen; Michael Gordon,16,0,70,54
1657335654979,COGS 101A,A01,083621,Davis; Joshua Daniel,9,0,68,59
1657335661001,COGS 101B,A01,091572,Allen; Michael Gordon,11,0,65,54
1657335667023,COGS 101C,A01,083625,Delgado; Tania,17,0,35,18
1657335673049,COGS 107A,A01,083627,Boyle; Mary E. T.,13,0,60,47
1657335679075,COGS 118A,A01,083075,Gupta; Anjum,19,0,76,57
1657335685098,CSE 3,A50,083646,Miranda; Gregory Joseph,24,0,50,26
1657335691120,CSE 8A,A50,083650,Miranda; Gregory Joseph,17,1,56,39
1657335697154,CSE 11,A01,083080,Cao; Yingjun,6,15,40,34
1657335703177,CSE 12,A01,083652,Krause-Levy; Sophia Louisa,28,1,120,92
1657335709201,CSE 15L,A01,083654,Morris; Justin Loren,9,0,50,41
1657335709201,CSE 15L,A02,083655,Morris; Justin Loren,9,0,50,41
1657335715225,CSE 20,A01,083657,Tran; Khoa Dang,39,0,80,41
1657335721254,CSE 21,A01,095574,Bach; Quang Tran,22,0,48,26
1657335727278,CSE 30,A01,083084,Eldon; John,4,0,80,76
1657335727278,CSE 30,B01,095061,Bhaskar; Nishant,9,0,50,41
1657335733301,CSE 100,A01,083659,Cao; Yingjun,4,4,70,66
1657335739329,CSE 134B,A01,083661,Powell; Thomas Allan,22,0,100,78
1657335745356,CSE 140,A01,083663,Gungor; Onat,14,0,85,71
1657335751380,CSE 140L,A01,083088,Eldon; John,21,0,100,79
1657335757411,CSE 175,A01,083665,Kumar; Rakesh,3,0,25,22
1657335763437,CSE 190,A00,092507,Dubnov; Shlomo,7,0,20,13
1657335769466,ECE 45,A01,083139,Congero; Spencer William,6,0,75,69
1657335775492,ECE 65,A50,083695,Saad; Andrew S,12,0,30,18
1657335775492,ECE 65,A51,095125,Saad; Andrew S,24,0,26,2
1657335781518,ECE 109,A01,091882,Touri; Behrouz,19,0,70,51
1657335787544,ECE 180,A00,083140,Abi Samra; Nicholas Camill,1,0,30,29
1657335787544,ECE 180,B00,083141,Abi Samra; Nicholas Camill,0,0,30,30
1657335793568,MATH 10A,A01,083735,Patchell; Gregory David,2,0,30,28
1657335793568,MATH 10A,A02,083736,Patchell; Gregory David,20,0,30,10
1657335793568,MATH 10A,A03,083737,Patchell; Gregory David,16,0,30,14
1657335799591,MATH 10B,A01,083207,Lim; Seonhee,7,0,34,27
1657335799591,MATH 10B,A02,083208,Lim; Seonhee,9,0,35,26
1657335799591,MATH 10B,A03,093472,Lim; Seonhee,7,0,34,27
1657335799591,MATH 10B,B01,083739,Sinha; Shubham,12,0,30,18
1657335805615,MATH 18,A01,083743,Cinel; Cameron Alexander,6,0,30,24
1657335805615,MATH 18,A02,083744,Cinel; Cameron Alexander,17,0,30,13
1657335805615,MATH 18,A03,083745,Cinel; Cameron Alexander,9,0,30,21
1657335805615,MATH 18,B01,083748,Rideout; David Porter,5,0,37,32
1657335805615,MATH 18,B02,083749,Rideout; David Porter,5,0,36,31
1657335805615,MATH 18,B03,083750,Rideout; David Porter,3,0,37,34
1657335805615,MATH 18,B04,083751,Rideout; David Porter,6,0,36,30
1657335805615,MATH 18,B05,093473,Rideout; David Porter,6,0,36,30
1657335805615,MATH 18,B06,093474,Rideout; David Porter,6,0,36,30
1657335811640,MATH 20A,A01,083754,Zheng; Zequn,14,0,40,26
1657335817668,MATH 20B,A01,083756,Briones; Jor-el Thomas Caparas,4,0,36,32
1657335817668,MATH 20B,A02,083757,Briones; Jor-el Thomas Caparas,1,0,36,35
1657335817668,MATH 20B,A03,093475,Briones; Jor-el Thomas Caparas,2,0,36,34
1657335823691,MATH 20C,A01,083760,Briones; Jor-el Thomas Caparas,1,0,35,34
1657335823691,MATH 20C,A02,083761,Briones; Jor-el Thomas Caparas,8,0,35,27
1657335823691,MATH 20C,A03,093476,Briones; Jor-el Thomas Caparas,0,1,36,36
1657335823691,MATH 20C,B01,083762,Bach; Quang Tran,1,0,30,29
1657335829719,MATH 20D,A01,083765,Tran; Brian Kha,5,0,30,25
1657335829719,MATH 20D,A02,083766,Tran; Brian Kha,5,0,30,25
1657335829719,MATH 20D,A03,083767,Tran; Brian Kha,4,0,30,26
1657335835742,MATH 20E,A01,083771,Ganguly; Soumya,9,0,32,23
1657335835742,MATH 20E,A02,083772,Ganguly; Soumya,6,0,32,26
1657335835742,MATH 20E,B01,083773,Ciotti; Benjamin,20,0,35,15
1657335835742,MATH 20E,B02,083774,Ciotti; Benjamin,17,0,35,18
1657335841765,MATH 103A,A01,083777,Greenfeld; Be'Eri,3,0,36,33
1657335841765,MATH 103A,A02,083778,Greenfeld; Be'Eri,5,0,36,31
1657335841765,MATH 103A,A03,093561,Greenfeld; Be'Eri,4,0,36,32
1657335841765,MATH 103A,B01,083779,Greenfeld; Be'Eri,6,0,36,30
1657335841765,MATH 103A,B02,083780,Greenfeld; Be'Eri,4,0,36,32
1657335841765,MATH 103A,B03,093562,Greenfeld; Be'Eri,3,0,36,33
1657335847788,MATH 105,A01,085443,Carter; Anne Toulson,15,0,35,20
1657335847788,MATH 105,A02,093477,Carter; Anne Toulson,20,0,35,15
1657335853810,MATH 109,A01,083213,Ganzberger; Geoffrey Michael,2,0,34,32
1657335853810,MATH 109,A02,083214,Ganzberger; Geoffrey Michael,4,0,34,30
1657335853810,MATH 109,A03,093478,Ganzberger; Geoffrey Michael,2,0,34,32
1657335853810,MATH 109,B01,083215,Ganzberger; Geoffrey Michael,1,0,32,31
1657335853810,MATH 109,B02,083216,Ganzberger; Geoffrey Michael,1,0,32,31
1657335853810,MATH 109,B03,093479,Ganzberger; Geoffrey Michael,8,0,32,24
1657335859833,MATH 142A,A01,083219,Chow; Bennett,7,0,32,25
1657335859833,MATH 142A,A02,083220,Chow; Bennett,10,0,32,22
1657335859833,MATH 142A,A03,093480,Chow; Bennett,7,0,32,25
1657335859833,MATH 142A,B03,093481,Chow; Bennett,8,0,32,24
1657335859833,MATH 142A,B04,093558,Chow; Bennett,13,0,32,19
1657335859833,MATH 142A,B05,093559,Chow; Bennett,6,0,32,26
1657335865857,MATH 193A,A01,083224,Rotar; Vladimir,7,0,34,27
1657335865857,MATH 193A,A02,083225,Rotar; Vladimir,7,0,34,27
1657335865857,MATH 193A,A03,083781,Rotar; Vladimir,3,0,34,31
1657335865857,MATH 193A,A04,083782,Rotar; Vladimir,9,0,34,25
1657335865857,MATH 193A,A05,093482,Rotar; Vladimir,10,0,34,24
1657335871883,MATH 197,001,091859,McAuley; Julian John,9999,0,9999,0
1657335871883,MATH 197,002,095566,Kedlaya; Kiran S.,9997,0,9999,2
1657335871883,MATH 197,003,095567,Xiao; Ming,9999,0,9999,0
1657335871883,MATH 197,004,095571,Perols; Johan Lars,9998,0,9999,1
1657335878933,COGS 9,A01,083615,Shannon; Kyle Michael,8,0,75,67
1657335884956,COGS 11,A01,083617,Boyle; Mary E. T.,22,0,48,26
1657335890979,COGS 13,A01,083071,Bastos; Amalia Pinkusfeld,11,0,71,60
1657335897006,COGS 14A,A01,092681,Semenuks; Arturs,3,1,100,97
1657335903035,COGS 14B,A01,083073,Cheng; Tzu-Han,6,0,63,57
1657335909058,COGS 17,A01,092677,Semenuks; Arturs,6,0,81,75
1657335915081,COGS 100,A01,083619,Allen; Michael Gordon,16,0,70,54
1657335921104,COGS 101A,A01,083621,Davis; Joshua Daniel,9,0,68,59
1657335927128,COGS 101B,A01,091572,Allen; Michael Gordon,11,0,65,54
1657335933151,COGS 101C,A01,083625,Delgado; Tania,17,0,35,18
1657335939179,COGS 107A,A01,083627,Boyle; Mary E. T.,13,0,60,47
1657335945204,COGS 118A,A01,083075,Gupta; Anjum,19,0,76,57
1657335951233,CSE 3,A50,083646,Miranda; Gregory Joseph,24,0,50,26
1657335957270,CSE 8A,A50,083650,Miranda; Gregory Joseph,17,1,56,39
1657335963297,CSE 11,A01,083080,Cao; Yingjun,6,15,40,34
1657335969322,CSE 12,A01,083652,Krause-Levy; Sophia Louisa,28,1,120,92
1657335975346,CSE 15L,A01,083654,Morris; Justin Loren,9,0,50,41
1657335975346,CSE 15L,A02,083655,Morris; Justin Loren,9,0,50,41
1657335981372,CSE 20,A01,083657,Tran; Khoa Dang,39,0,80,41
1657335987394,CSE 21,A01,095574,Bach; Quang Tran,22,0,48,26
1657335993423,CSE 30,A01,083084,Eldon; John,4,0,80,76
1657335993423,CSE 30,B01,095061,Bhaskar; Nishant,9,0,50,41
1657335999449,CSE 100,A01,083659,Cao; Yingjun,4,4,70,66
1657336005470,CSE 134B,A01,083661,Powell; Thomas Allan,22,0,100,78
1657336011497,CSE 140,A01,083663,Gungor; Onat,14,0,85,71
1657336017529,CSE 140L,A01,083088,Eldon; John,21,0,100,79
1657336023551,CSE 175,A01,083665,Kumar; Rakesh,3,0,25,22
1657336029578,CSE 190,A00,092507,Dubnov; Shlomo,7,0,20,13
1657336035601,ECE 45,A01,083139,Congero; Spencer William,6,0,75,69
1657336041624,ECE 65,A50,083695,Saad; Andrew S,12,0,30,18
1657336041624,ECE 65,A51,095125,Saad; Andrew S,24,0,26,2
1657336047660,ECE 109,A01,091882,Touri; Behrouz,19,0,70,51
1657336053688,ECE 180,A00,083140,Abi Samra; Nicholas Camill,1,0,30,29
1657336053688,ECE 180,B00,083141,Abi Samra; Nicholas Camill,0,0,30,30
1657336059714,MATH 10A,A01,083735,Patchell; Gregory David,2,0,30,28
1657336059714,MATH 10A,A02,083736,Patchell; Gregory David,20,0,30,10
1657336059714,MATH 10A,A03,083737,Patchell; Gregory David,16,0,30,14
1657336065744,MATH 10B,A01,083207,Lim; Seonhee,7,0,34,27
1657336065744,MATH 10B,A02,083208,Lim; Seonhee,9,0,35,26
1657336065744,MATH 10B,A03,093472,Lim; Seonhee,7,0,34,27
1657336065744,MATH 10B,B01,083739,Sinha; Shubham,12,0,30,18
1657336071769,MATH 18,A01,083743,Cinel; Cameron Alexander,6,0,30,24
1657336071769,MATH 18,A02,083744,Cinel; Cameron Alexander,17,0,30,13
1657336071769,MATH 18,A03,083745,Cinel; Cameron Alexander,9,0,30,21
1657336071769,MATH 18,B01,083748,Rideout; David Porter,5,0,37,32
1657336071769,MATH 18,B02,083749,Rideout; David Porter,5,0,36,31
1657336071769,MATH 18,B03,083750,Rideout; David Porter,3,0,37,34
1657336071769,MATH 18,B04,083751,Rideout; David Porter,6,0,36,30
1657336071769,MATH 18,B05,093473,Rideout; David Porter,6,0,36,30
1657336071769,MATH 18,B06,093474,Rideout; David Porter,6,0,36,30
1657336077792,MATH 20A,A01,083754,Zheng; Zequn,14,0,40,26
1657336083815,MATH 20B,A01,083756,Briones; Jor-el Thomas Caparas,4,0,36,32
1657336083815,MATH 20B,A02,083757,Briones; Jor-el Thomas Caparas,1,0,36,35
1657336083815,MATH 20B,A03,093475,Briones; Jor-el Thomas Caparas,2,0,36,34
1657336089840,MATH 20C,A01,083760,Briones; Jor-el Thomas Caparas,1,0,35,34
1657336089840,MATH 20C,A02,083761,Briones; Jor-el Thomas Caparas,8,0,35,27
1657336089840,MATH 20C,A03,093476,Briones; Jor-el Thomas Caparas,0,1,36,36
1657336089840,MATH 20C,B01,083762,Bach; Quang Tran,1,0,30,29
1657336095863,MATH 20D,A01,083765,Tran; Brian Kha,5,0,30,25
1657336095863,MATH 20D,A02,083766,Tran; Brian Kha,5,0,30,25
1657336095863,MATH 20D,A03,083767,Tran; Brian Kha,4,0,30,26
1657336101887,MATH 20E,A01,083771,Ganguly; Soumya,9,0,32,23
1657336101887,MATH 20E,A02,083772,Ganguly; Soumya,6,0,32,26
1657336101887,MATH 20E,B01,083773,Ciotti; Benjamin,20,0,35,15
1657336101887,MATH 20E,B02,083774,Ciotti; Benjamin,17,0,35,18
1657336107915,MATH 103A,A01,083777,Greenfeld; Be'Eri,3,0,36,33
1657336107915,MATH 103A,A02,083778,Greenfeld; Be'Eri,5,0,36,31
1657336107915,MATH 103A,A03,093561,Greenfeld; Be'Eri,4,0,36,32
1657336107915,MATH 103A,B01,083779,Greenfeld; Be'Eri,6,0,36,30
1657336107915,MATH 103A,B02,083780,Greenfeld; Be'Eri,4,0,36,32
1657336107915,MATH 103A,B03,093562,Greenfeld; Be'Eri,3,0,36,33
1657336113943,MATH 105,A01,085443,Carter; Anne Toulson,15,0,35,20
1657336113943,MATH 105,A02,093477,Carter; Anne Toulson,20,0,35,15
1657336119965,MATH 109,A01,083213,Ganzberger; Geoffrey Michael,2,0,34,32
1657336119965,MATH 109,A02,083214,Ganzberger; Geoffrey Michael,4,0,34,30
1657336119965,MATH 109,A03,093478,Ganzberger; Geoffrey Michael,2,0,34,32
1657336119965,MATH 109,B01,083215,Ganzberger; Geoffrey Michael,1,0,32,31
1657336119965,MATH 109,B02,083216,Ganzberger; Geoffrey Michael,1,0,32,31
1657336119965,MATH 109,B03,093479,Ganzberger; Geoffrey Michael,8,0,32,24
1657336125988,MATH 142A,A01,083219,Chow; Bennett,7,0,32,25
1657336125988,MATH 142A,A02,083220,Chow; Bennett,10,0,32,22
1657336125988,MATH 142A,A03,093480,Chow; Bennett,7,0,32,25
1657336125988,MATH 142A,B03,093481,Chow; Bennett,8,0,32,24
1657336125988,MATH 142A,B04,093558,Chow; Bennett,13,0,32,19
1657336125988,MATH 142A,B05,093559,Chow; Bennett,6,0,32,26
1657336132017,MATH 193A,A01,083224,Rotar; Vladimir,7,0,34,27
1657336132017,MATH 193A,A02,083225,Rotar; Vladimir,7,0,34,27
1657336132017,MATH 193A,A03,083781,Rotar; Vladimir,3,0,34,31
1657336132017,MATH 193A,A04,083782,Rotar; Vladimir,9,0,34,25
1657336132017,MATH 193A,A05,093482,Rotar; Vladimir,10,0,34,24
1657336138040,MATH 197,001,091859,McAuley; Julian John,9999,0,9999,0
1657336138040,MATH 197,002,095566,Kedlaya; Kiran S.,9997,0,9999,2
1657336138040,MATH 197,003,095567,Xiao; Ming,9999,0,9999,0
1657336138040,MATH 197,004,095571,Perols; Johan Lars,9998,0,9999,1
1657336145094,COGS 9,A01,083615,Shannon; Kyle Michael,8,0,75,67
1657336151117,COGS 11,A01,083617,Boyle; Mary E. T.,22,0,48,26
1657336157144,COGS 13,A01,083071,Bastos; Amalia Pinkusfeld,11,0,71,60
1657336163168,COGS 14A,A01,092681,Semenuks; Arturs,3,1,100,97
1657336169204,COGS 14B,A01,083073,Cheng; Tzu-Han,6,0,63,57
1657336175228,COGS 17,A01,092677,Semenuks; Arturs,6,0,81,75
1657336181254,COGS 100,A01,083619,Allen; Michael Gordon,16,0,70,54
1657336187293,COGS 101A,A01,083621,Davis; Joshua Daniel,9,0,68,59
1657336193320,COGS 101B,A01,091572,Allen; Michael Gordon,11,0,65,54
1657336199346,COGS 101C,A01,083625,Delgado; Tania,17,0,35,18
1657336205378,COGS 107A,A01,083627,Boyle; Mary E. T.,13,0,60,47
1657336211401,COGS 118A,A01,083075,Gupta; Anjum,19,0,76,57
1657336217430,CSE 3,A50,083646,Miranda; Gregory Joseph,24,0,50,26
1657336223459,CSE 8A,A50,083650,Miranda; Gregory Joseph,17,1,56,39
1657336229484,CSE 11,A01,083080,Cao; Yingjun,6,15,40,34
1657336235513,CSE 12,A01,083652,Krause-Levy; Sophia Louisa,28,1,120,92
1657336241537,CSE 15L,A01,083654,Morris; Justin Loren,9,0,50,41
1657336241537,CSE 15L,A02,083655,Morris; Justin Loren,9,0,50,41
1657336247639,CSE 20,A01,083657,Tran; Khoa Dang,39,0,80,41
1657336253665,CSE 21,A01,095574,Bach; Quang Tran,22,0,48,26
1657336259690,CSE 30,A01,083084,Eldon; John,4,0,80,76
1657336259690,CSE 30,B01,095061,Bhaskar; Nishant,9,0,50,41
1657336265713,CSE 100,A01,083659,Cao; Yingjun,4,4,70,66
1657336271737,CSE 134B,A01,083661,Powell; Thomas Allan,22,0,100,78
1657336277762,CSE 140,A01,083663,Gungor; Onat,14,0,85,71
1657336283789,CSE 140L,A01,083088,Eldon; John,21,0,100,79
1657336289815,CSE 175,A01,083665,Kumar; Rakesh,3,0,25,22
1657336295839,CSE 190,A00,092507,Dubnov; Shlomo,7,0,20,13
1657336301866,ECE 45,A01,083139,Congero; Spencer William,6,0,75,69
1657336307897,ECE 65,A50,083695,Saad; Andrew S,12,0,30,18
1657336307897,ECE 65,A51,095125,Saad; Andrew S,24,0,26,2
1657336313932,ECE 109,A01,091882,Touri; Behrouz,19,0,70,51
1657336319958,ECE 180,A00,083140,Abi Samra; Nicholas Camill,1,0,30,29
1657336319958,ECE 180,B00,083141,Abi Samra; Nicholas Camill,0,0,30,30
1657336325983,MATH 10A,A01,083735,Patchell; Gregory David,2,0,30,28
1657336325983,MATH 10A,A02,083736,Patchell; Gregory David,20,0,30,10
1657336325983,MATH 10A,A03,083737,Patchell; Gregory David,16,0,30,14
1657336332006,MATH 10B,A01,083207,Lim; Seonhee,7,0,34,27
1657336332006,MATH 10B,A02,083208,Lim; Seonhee,9,0,35,26
1657336332006,MATH 10B,A03,093472,Lim; Seonhee,7,0,34,27
1657336332006,MATH 10B,B01,083739,Sinha; Shubham,12,0,30,18
1657336338034,MATH 18,A01,083743,Cinel; Cameron Alexander,6,0,30,24
1657336338034,MATH 18,A02,083744,Cinel; Cameron Alexander,17,0,30,13
1657336338034,MATH 18,A03,083745,Cinel; Cameron Alexander,9,0,30,21
1657336338034,MATH 18,B01,083748,Rideout; David Porter,5,0,37,32
1657336338034,MATH 18,B02,083749,Rideout; David Porter,5,0,36,31
1657336338034,MATH 18,B03,083750,Rideout; David Porter,3,0,37,34
1657336338034,MATH 18,B04,083751,Rideout; David Porter,6,0,36,30
1657336338034,MATH 18,B05,093473,Rideout; David Porter,6,0,36,30
1657336338034,MATH 18,B06,093474,Rideout; David Porter,6,0,36,30
1657336344059,MATH 20A,A01,083754,Zheng; Zequn,14,0,40,26
1657336350086,MATH 20B,A01,083756,Briones; Jor-el Thomas Caparas,4,0,36,32
1657336350086,MATH 20B,A02,083757,Briones; Jor-el Thomas Caparas,1,0,36,35
1657336350086,MATH 20B,A03,093475,Briones; Jor-el Thomas Caparas,2,0,36,34
1657336356116,MATH 20C,A01,083760,Briones; Jor-el Thomas Caparas,1,0,35,34
1657336356116,MATH 20C,A02,083761,Briones; Jor-el Thomas Caparas,8,0,35,27
1657336356116,MATH 20C,A03,093476,Briones; Jor-el Thomas Caparas,0,1,36,36
1657336356116,MATH 20C,B01,083762,Bach; Quang Tran,1,0,30,29
1657336362139,MATH 20D,A01,083765,Tran; Brian Kha,5,0,30,25
1657336362139,MATH 20D,A02,083766,Tran; Brian Kha,5,0,30,25
1657336362139,MATH 20D,A03,083767,Tran; Brian Kha,4,0,30,26
1657336368172,MATH 20E,A01,083771,Ganguly; Soumya,9,0,32,23
1657336368172,MATH 20E,A02,083772,Ganguly; Soumya,6,0,32,26
1657336368172,MATH 20E,B01,083773,Ciotti; Benjamin,20,0,35,15
1657336368172,MATH 20E,B02,083774,Ciotti; Benjamin,17,0,35,18
1657336374195,MATH 103A,A01,083777,Greenfeld; Be'Eri,3,0,36,33
1657336374195,MATH 103A,A02,083778,Greenfeld; Be'Eri,5,0,36,31
1657336374195,MATH 103A,A03,093561,Greenfeld; Be'Eri,4,0,36,32
1657336374195,MATH 103A,B01,083779,Greenfeld; Be'Eri,6,0,36,30
1657336374195,MATH 103A,B02,083780,Greenfeld; Be'Eri,4,0,36,32
1657336374195,MATH 103A,B03,093562,Greenfeld; Be'Eri,3,0,36,33
1657336380221,MATH 105,A01,085443,Carter; Anne Toulson,15,0,35,20
1657336380221,MATH 105,A02,093477,Carter; Anne Toulson,20,0,35,15
1657336386246,MATH 109,A01,083213,Ganzberger; Geoffrey Michael,2,0,34,32
1657336386246,MATH 109,A02,083214,Ganzberger; Geoffrey Michael,4,0,34,30
1657336386246,MATH 109,A03,093478,Ganzberger; Geoffrey Michael,2,0,34,32
1657336386246,MATH 109,B01,083215,Ganzberger; Geoffrey Michael,1,0,32,31
1657336386246,MATH 109,B02,083216,Ganzberger; Geoffrey Michael,1,0,32,31
1657336386246,MATH 109,B03,093479,Ganzberger; Geoffrey Michael,8,0,32,24
1657336392274,MATH 142A,A01,083219,Chow; Bennett,7,0,32,25
1657336392274,MATH 142A,A02,083220,Chow; Bennett,10,0,32,22
1657336392274,MATH 142A,A03,093480,Chow; Bennett,7,0,32,25
1657336392274,MATH 142A,B03,093481,Chow; Bennett,8,0,32,24
1657336392274,MATH 142A,B04,093558,Chow; Bennett,13,0,32,19
1657336392274,MATH 142A,B05,093559,Chow; Bennett,6,0,32,26
1657336398304,MATH 193A,A01,083224,Rotar; Vladimir,7,0,34,27
1657336398304,MATH 193A,A02,083225,Rotar; Vladimir,7,0,34,27
1657336398304,MATH 193A,A03,083781,Rotar; Vladimir,3,0,34,31
1657336398304,MATH 193A,A04,083782,Rotar; Vladimir,9,0,34,25
1657336398304,MATH 193A,A05,093482,Rotar; Vladimir,10,0,34,24
1657336404333,MATH 197,001,091859,McAuley; Julian John,9999,0,9999,0
1657336404333,MATH 197,002,095566,Kedlaya; Kiran S.,9997,0,9999,2
1657336404333,MATH 197,003,095567,Xiao; Ming,9999,0,9999,0
1657336404333,MATH 197,004,095571,Perols; Johan Lars,9998,0,9999,1
1657336411384,COGS 9,A01,083615,Shannon; Kyle Michael,8,0,75,67
1657336417407,COGS 11,A01,083617,Boyle; Mary E. T.,22,0,48,26
1657336423433,COGS 13,A01,083071,Bastos; Amalia Pinkusfeld,11,0,71,60
1657336429456,COGS 14A,A01,092681,Semenuks; Arturs,3,1,100,97
1657336435483,COGS 14B,A01,083073,Cheng; Tzu-Han,6,0,63,57
1657336441505,COGS 17,A01,092677,Semenuks; Arturs,6,0,81,75
1657336447527,COGS 100,A01,083619,Allen; Michael Gordon,16,0,70,54
1657336453551,COGS 101A,A01,083621,Davis; Joshua Daniel,9,0,68,59
1657336459588,COGS 101B,A01,091572,Allen; Michael Gordon,11,0,65,54
1657336465612,COGS 101C,A01,083625,Delgado; Tania,17,0,35,18
1657336471636,COGS 107A,A01,083627,Boyle; Mary E. T.,13,0,60,47
1657336477662,COGS 118A,A01,083075,Gupta; Anjum,19,0,76,57
1657336483689,CSE 3,A50,083646,Miranda; Gregory Joseph,24,0,50,26
1657336489712,CSE 8A,A50,083650,Miranda; Gregory Joseph,17,1,56,39
1657336495738,CSE 11,A01,083080,Cao; Yingjun,6,15,40,34
1657336501759,CSE 12,A01,083652,Krause-Levy; Sophia Louisa,28,1,120,92
1657336507780,CSE 15L,A01,083654,Morris; Justin Loren,9,0,50,41
1657336507780,CSE 15L,A02,083655,Morris; Justin Loren,9,0,50,41
1657336513804,CSE 20,A01,083657,Tran; Khoa Dang,39,0,80,41
1657336519827,CSE 21,A01,095574,Bach; Quang Tran,22,0,48,26
1657336525854,CSE 30,A01,083084,Eldon; John,4,0,80,76
1657336525854,CSE 30,B01,095061,Bhaskar; Nishant,9,0,50,41
1657336531886,CSE 100,A01,083659,Cao; Yingjun,4,4,70,66
1657336537909,CSE 134B,A01,083661,Powell; Thomas Allan,22,0,100,78
1657336543938,CSE 140,A01,083663,Gungor; Onat,14,0,85,71
1657336549960,CSE 140L,A01,083088,Eldon; John,21,0,100,79
1657336555984,CSE 175,A01,083665,Kumar; Rakesh,3,0,25,22
1657336562009,CSE 190,A00,092507,Dubnov; Shlomo,7,0,20,13
1657336568032,ECE 45,A01,083139,Congero; Spencer William,6,0,75,69
1657336574056,ECE 65,A50,083695,Saad; Andrew S,12,0,30,18
1657336574056,ECE 65,A51,095125,Saad; Andrew S,24,0,26,2
1657336580081,ECE 109,A01,091882,Touri; Behrouz,19,0,70,51
1657336586105,ECE 180,A00,083140,Abi Samra; Nicholas Camill,1,0,30,29
1657336586105,ECE 180,B00,083141,Abi Samra; Nicholas Camill,0,0,30,30
1657336592130,MATH 10A,A01,083735,Patchell; Gregory David,2,0,30,28
1657336592130,MATH 10A,A02,083736,Patchell; Gregory David,20,0,30,10
1657336592130,MATH 10A,A03,083737,Patchell; Gregory David,16,0,30,14
1657336598155,MATH 10B,A01,083207,Lim; Seonhee,7,0,34,27
1657336598155,MATH 10B,A02,083208,Lim; Seonhee,9,0,35,26
1657336598155,MATH 10B,A03,093472,Lim; Seonhee,7,0,34,27
1657336598155,MATH 10B,B01,083739,Sinha; Shubham,12,0,30,18
1657336604180,MATH 18,A01,083743,Cinel; Cameron Alexander,6,0,30,24
1657336604180,MATH 18,A02,083744,Cinel; Cameron Alexander,17,0,30,13
1657336604180,MATH 18,A03,083745,Cinel; Cameron Alexander,9,0,30,21
1657336604180,MATH 18,B01,083748,Rideout; David Porter,5,0,37,32
1657336604180,MATH 18,B02,083749,Rideout; David Porter,5,0,36,31
1657336604180,MATH 18,B03,083750,Rideout; David Porter,3,0,37,34
1657336604180,MATH 18,B04,083751,Rideout; David Porter,6,0,36,30
1657336604180,MATH 18,B05,093473,Rideout; David Porter,6,0,36,30
1657336604180,MATH 18,B06,093474,Rideout; David Porter,6,0,36,30
1657336610207,MATH 20A,A01,083754,Zheng; Zequn,14,0,40,26
1657336616231,MATH 20B,A01,083756,Briones; Jor-el Thomas Caparas,4,0,36,32
1657336616231,MATH 20B,A02,083757,Briones; Jor-el Thomas Caparas,1,0,36,35
1657336616231,MATH 20B,A03,093475,Briones; Jor-el Thomas Caparas,2,0,36,34
1657336622255,MATH 20C,A01,083760,Briones; Jor-el Thomas Caparas,1,0,35,34
1657336622255,MATH 20C,A02,083761,Briones; Jor-el Thomas Caparas,8,0,35,27
1657336622255,MATH 20C,A03,093476,Briones; Jor-el Thomas Caparas,0,1,36,36
1657336622255,MATH 20C,B01,083762,Bach; Quang Tran,1,0,30,29
1657336628284,MATH 20D,A01,083765,Tran; Brian Kha,5,0,30,25
1657336628284,MATH 20D,A02,083766,Tran; Brian Kha,5,0,30,25
1657336628284,MATH 20D,A03,083767,Tran; Brian Kha,4,0,30,26
1657336634309,MATH 20E,A01,083771,Ganguly; Soumya,9,0,32,23
1657336634309,MATH 20E,A02,083772,Ganguly; Soumya,6,0,32,26
1657336634309,MATH 20E,B01,083773,Ciotti; Benjamin,20,0,35,15
1657336634309,MATH 20E,B02,083774,Ciotti; Benjamin,17,0,35,18
1657336640346,MATH 103A,A01,083777,Greenfeld; Be'Eri,3,0,36,33
1657336640346,MATH 103A,A02,083778,Greenfeld; Be'Eri,5,0,36,31
1657336640346,MATH 103A,A03,093561,Greenfeld; Be'Eri,4,0,36,32
1657336640346,MATH 103A,B01,083779,Greenfeld; Be'Eri,6,0,36,30
1657336640346,MATH 103A,B02,083780,Greenfeld; Be'Eri,4,0,36,32
1657336640346,MATH 103A,B03,093562,Greenfeld; Be'Eri,3,0,36,33
1657336646379,MATH 105,A01,085443,Carter; Anne Toulson,15,0,35,20
1657336646379,MATH 105,A02,093477,Carter; Anne Toulson,20,0,35,15
1657336652401,MATH 109,A01,083213,Ganzberger; Geoffrey Michael,2,0,34,32
1657336652401,MATH 109,A02,083214,Ganzberger; Geoffrey Michael,4,0,34,30
1657336652401,MATH 109,A03,093478,Ganzberger; Geoffrey Michael,2,0,34,32
1657336652401,MATH 109,B01,083215,Ganzberger; Geoffrey Michael,1,0,32,31
1657336652401,MATH 109,B02,083216,Ganzberger; Geoffrey Michael,1,0,32,31
1657336652401,MATH 109,B03,093479,Ganzberger; Geoffrey Michael,8,0,32,24
1657336658427,MATH 142A,A01,083219,Chow; Bennett,7,0,32,25
1657336658427,MATH 142A,A02,083220,Chow; Bennett,10,0,32,22
1657336658427,MATH 142A,A03,093480,Chow; Bennett,7,0,32,25
1657336658427,MATH 142A,B03,093481,Chow; Bennett,8,0,32,24
1657336658427,MATH 142A,B04,093558,Chow; Bennett,13,0,32,19
1657336658427,MATH 142A,B05,093559,Chow; Bennett,6,0,32,26
1657336664463,MATH 193A,A01,083224,Rotar; Vladimir,7,0,34,27
1657336664463,MATH 193A,A02,083225,Rotar; Vladimir,7,0,34,27
1657336664463,MATH 193A,A03,083781,Rotar; Vladimir,3,0,34,31
1657336664463,MATH 193A,A04,083782,Rotar; Vladimir,9,0,34,25
1657336664463,MATH 193A,A05,093482,Rotar; Vladimir,10,0,34,24
1657336670490,MATH 197,001,091859,McAuley; Julian John,9999,0,9999,0
1657336670490,MATH 197,002,095566,Kedlaya; Kiran S.,9997,0,9999,2
1657336670490,MATH 197,003,095567,Xiao; Ming,9999,0,9999,0
1657336670490,MATH 197,004,095571,Perols; Johan Lars,9998,0,9999,1
1657336677555,COGS 9,A01,083615,Shannon; Kyle Michael,8,0,75,67
1657336683577,COGS 11,A01,083617,Boyle; Mary E. T.,22,0,48,26
1657336689601,COGS 13,A01,083071,Bastos; Amalia Pinkusfeld,11,0,71,60
1657336695629,COGS 14A,A01,092681,Semenuks; Arturs,3,1,100,97
1657336701655,COGS 14B,A01,083073,Cheng; Tzu-Han,6,0,63,57
1657336707678,COGS 17,A01,092677,Semenuks; Arturs,6,0,81,75
1657336713705,COGS 100,A01,083619,Allen; Michael Gordon,16,0,70,54
1657336719731,COGS 101A,A01,083621,Davis; Joshua Daniel,9,0,68,59
1657336725758,COGS 101B,A01,091572,Allen; Michael Gordon,11,0,65,54
1657336731781,COGS 101C,A01,083625,Delgado; Tania,17,0,35,18
1657336737809,COGS 107A,A01,083627,Boyle; Mary E. T.,13,0,60,47
1657336743831,COGS 118A,A01,083075,Gupta; Anjum,19,0,76,57
1657336749864,CSE 3,A50,083646,Miranda; Gregory Joseph,24,0,50,26
1657336755890,CSE 8A,A50,083650,Miranda; Gregory Joseph,17,1,56,39
1657336761919,CSE 11,A01,083080,Cao; Yingjun,6,15,40,34
1657336767947,CSE 12,A01,083652,Krause-Levy; Sophia Louisa,28,1,120,92
1657336773978,CSE 15L,A01,083654,Morris; Justin Loren,9,0,50,41
1657336773978,CSE 15L,A02,083655,Morris; Justin Loren,9,0,50,41
1657336780009,CSE 20,A01,083657,Tran; Khoa Dang,39,0,80,41
1657336786046,CSE 21,A01,095574,Bach; Quang Tran,22,0,48,26
1657336792068,CSE 30,A01,083084,Eldon; John,4,0,80,76
1657336792068,CSE 30,B01,095061,Bhaskar; Nishant,9,0,50,41
1657336798095,CSE 100,A01,083659,Cao; Yingjun,4,4,70,66
1657336804121,CSE 134B,A01,083661,Powell; Thomas Allan,22,0,100,78
1657336810147,CSE 140,A01,083663,Gungor; Onat,14,0,85,71
1657336816169,CSE 140L,A01,083088,Eldon; John,21,0,100,79
1657336822196,CSE 175,A01,083665,Kumar; Rakesh,3,0,25,22
1657336828220,CSE 190,A00,092507,Dubnov; Shlomo,7,0,20,13
1657336834243,ECE 45,A01,083139,Congero; Spencer William,6,0,75,69
1657336840271,ECE 65,A50,083695,Saad; Andrew S,12,0,30,18
1657336840271,ECE 65,A51,095125,Saad; Andrew S,24,0,26,2
1657336846390,ECE 109,A01,091882,Touri; Behrouz,19,0,70,51
1657336852420,ECE 180,A00,083140,Abi Samra; Nicholas Camill,1,0,30,29
1657336852420,ECE 180,B00,083141,Abi Samra; Nicholas Camill,0,0,30,30
1657336858444,MATH 10A,A01,083735,Patchell; Gregory David,2,0,30,28
1657336858444,MATH 10A,A02,083736,Patchell; Gregory David,20,0,30,10
1657336858444,MATH 10A,A03,083737,Patchell; Gregory David,16,0,30,14
1657336864473,MATH 10B,A01,083207,Lim; Seonhee,7,0,34,27
1657336864473,MATH 10B,A02,083208,Lim; Seonhee,9,0,35,26
1657336864473,MATH 10B,A03,093472,Lim; Seonhee,7,0,34,27
1657336864473,MATH 10B,B01,083739,Sinha; Shubham,12,0,30,18
1657336870503,MATH 18,A01,083743,Cinel; Cameron Alexander,6,0,30,24
1657336870503,MATH 18,A02,083744,Cinel; Cameron Alexander,17,0,30,13
1657336870503,MATH 18,A03,083745,Cinel; Cameron Alexander,9,0,30,21
1657336870503,MATH 18,B01,083748,Rideout; David Porter,5,0,37,32
1657336870503,MATH 18,B02,083749,Rideout; David Porter,5,0,36,31
1657336870503,MATH 18,B03,083750,Rideout; David Porter,3,0,37,34
1657336870503,MATH 18,B04,083751,Rideout; David Porter,6,0,36,30
1657336870503,MATH 18,B05,093473,Rideout; David Porter,6,0,36,30
1657336870503,MATH 18,B06,093474,Rideout; David Porter,6,0,36,30
1657336876528,MATH 20A,A01,083754,Zheng; Zequn,14,0,40,26
1657336882552,MATH 20B,A01,083756,Briones; Jor-el Thomas Caparas,4,0,36,32
1657336882552,MATH 20B,A02,083757,Briones; Jor-el Thomas Caparas,1,0,36,35
1657336882552,MATH 20B,A03,093475,Briones; Jor-el Thomas Caparas,2,0,36,34
1657336888580,MATH 20C,A01,083760,Briones; Jor-el Thomas Caparas,1,0,35,34
1657336888580,MATH 20C,A02,083761,Briones; Jor-el Thomas Caparas,8,0,35,27
1657336888580,MATH 20C,A03,093476,Briones; Jor-el Thomas Caparas,0,1,36,36
1657336888580,MATH 20C,B01,083762,Bach; Quang Tran,1,0,30,29
1657336894605,MATH 20D,A01,083765,Tran; Brian Kha,5,0,30,25
1657336894605,MATH 20D,A02,083766,Tran; Brian Kha,5,0,30,25
1657336894605,MATH 20D,A03,083767,Tran; Brian Kha,4,0,30,26
1657336900633,MATH 20E,A01,083771,Ganguly; Soumya,9,0,32,23
1657336900633,MATH 20E,A02,083772,Ganguly; Soumya,6,0,32,26
1657336900633,MATH 20E,B01,083773,Ciotti; Benjamin,20,0,35,15
1657336900633,MATH 20E,B02,083774,Ciotti; Benjamin,17,0,35,18
1657336906664,MATH 103A,A01,083777,Greenfeld; Be'Eri,3,0,36,33
1657336906664,MATH 103A,A02,083778,Greenfeld; Be'Eri,5,0,36,31
1657336906664,MATH 103A,A03,093561,Greenfeld; Be'Eri,4,0,36,32
1657336906664,MATH 103A,B01,083779,Greenfeld; Be'Eri,6,0,36,30
1657336906664,MATH 103A,B02,083780,Greenfeld; Be'Eri,4,0,36,32
1657336906664,MATH 103A,B03,093562,Greenfeld; Be'Eri,3,0,36,33
1657336912687,MATH 105,A01,085443,Carter; Anne Toulson,15,0,35,20
1657336912687,MATH 105,A02,093477,Carter; Anne Toulson,20,0,35,15
1657336918714,MATH 109,A01,083213,Ganzberger; Geoffrey Michael,2,0,34,32
1657336918714,MATH 109,A02,083214,Ganzberger; Geoffrey Michael,4,0,34,30
1657336918714,MATH 109,A03,093478,Ganzberger; Geoffrey Michael,2,0,34,32
1657336918714,MATH 109,B01,083215,Ganzberger; Geoffrey Michael,1,0,32,31
1657336918714,MATH 109,B02,083216,Ganzberger; Geoffrey Michael,1,0,32,31
1657336918714,MATH 109,B03,093479,Ganzberger; Geoffrey Michael,8,0,32,24
1657336924737,MATH 142A,A01,083219,Chow; Bennett,7,0,32,25
1657336924737,MATH 142A,A02,083220,Chow; Bennett,10,0,32,22
1657336924737,MATH 142A,A03,093480,Chow; Bennett,7,0,32,25
1657336924737,MATH 142A,B03,093481,Chow; Bennett,8,0,32,24
1657336924737,MATH 142A,B04,093558,Chow; Bennett,13,0,32,19
1657336924737,MATH 142A,B05,093559,Chow; Bennett,6,0,32,26
1657336930762,MATH 193A,A01,083224,Rotar; Vladimir,7,0,34,27
1657336930762,MATH 193A,A02,083225,Rotar; Vladimir,7,0,34,27
1657336930762,MATH 193A,A03,083781,Rotar; Vladimir,3,0,34,31
1657336930762,MATH 193A,A04,083782,Rotar; Vladimir,9,0,34,25
1657336930762,MATH 193A,A05,093482,Rotar; Vladimir,10,0,34,24
1657336936786,MATH 197,001,091859,McAuley; Julian John,9999,0,9999,0
1657336936786,MATH 197,002,095566,Kedlaya; Kiran S.,9997,0,9999,2
1657336936786,MATH 197,003,095567,Xiao; Ming,9999,0,9999,0
1657336936786,MATH 197,004,095571,Perols; Johan Lars,9998,0,9999,1
1657336943854,COGS 9,A01,083615,Shannon; Kyle Michael,8,0,75,67
1657336949876,COGS 11,A01,083617,Boyle; Mary E. T.,22,0,48,26
1657336955903,COGS 13,A01,083071,Bastos; Amalia Pinkusfeld,11,0,71,60
1657336961928,COGS 14A,A01,092681,Semenuks; Arturs,3,1,100,97
1657336967955,COGS 14B,A01,083073,Cheng; Tzu-Han,6,0,63,57
1657336973983,COGS 17,A01,092677,Semenuks; Arturs,6,0,81,75
1657336980007,COGS 100,A01,083619,Allen; Michael Gordon,16,0,70,54
1657336986035,COGS 101A,A01,083621,Davis; Joshua Daniel,9,0,68,59
1657336992058,COGS 101B,A01,091572,Allen; Michael Gordon,11,0,65,54
1657336998083,COGS 101C,A01,083625,Delgado; Tania,17,0,35,18
1657337004108,COGS 107A,A01,083627,Boyle; Mary E. T.,13,0,60,47
1657337010131,COGS 118A,A01,083075,Gupta; Anjum,19,0,76,57
1657337016153,CSE 3,A50,083646,Miranda; Gregory Joseph,24,0,50,26
1657337022176,CSE 8A,A50,083650,Miranda; Gregory Joseph,17,1,56,39
1657337028202,CSE 11,A01,083080,Cao; Yingjun,6,15,40,34
1657337034234,CSE 12,A01,083652,Krause-Levy; Sophia Louisa,28,1,120,92
1657337040258,CSE 15L,A01,083654,Morris; Justin Loren,9,0,50,41
1657337040258,CSE 15L,A02,083655,Morris; Justin Loren,9,0,50,41
1657337046285,CSE 20,A01,083657,Tran; Khoa Dang,39,0,80,41
1657337052309,CSE 21,A01,095574,Bach; Quang Tran,22,0,48,26
1657337058341,CSE 30,A01,083084,Eldon; John,4,0,80,76
1657337058341,CSE 30,B01,095061,Bhaskar; Nishant,9,0,50,41
1657337064368,CSE 100,A01,083659,Cao; Yingjun,4,4,70,66
1657337070391,CSE 134B,A01,083661,Powell; Thomas Allan,22,0,100,78
1657337076413,CSE 140,A01,083663,Gungor; Onat,14,0,85,71
1657337082441,CSE 140L,A01,083088,Eldon; John,21,0,100,79
1657337088463,CSE 175,A01,083665,Kumar; Rakesh,3,0,25,22
1657337094493,CSE 190,A00,092507,Dubnov; Shlomo,7,0,20,13
1657337100518,ECE 45,A01,083139,Congero; Spencer William,6,0,75,69
1657337106541,ECE 65,A50,083695,Saad; Andrew S,12,0,30,18
1657337106541,ECE 65,A51,095125,Saad; Andrew S,24,0,26,2
1657337112572,ECE 109,A01,091882,Touri; Behrouz,19,0,70,51
1657337118600,ECE 180,A00,083140,Abi Samra; Nicholas Camill,1,0,30,29
1657337118600,ECE 180,B00,083141,Abi Samra; Nicholas Camill,0,0,30,30
1657337124622,MATH 10A,A01,083735,Patchell; Gregory David,2,0,30,28
1657337124622,MATH 10A,A02,083736,Patchell; Gregory David,20,0,30,10
1657337124622,MATH 10A,A03,083737,Patchell; Gregory David,16,0,30,14
1657337130651,MATH 10B,A01,083207,Lim; Seonhee,7,0,34,27
1657337130651,MATH 10B,A02,083208,Lim; Seonhee,9,0,35,26
1657337130651,MATH 10B,A03,093472,Lim; Seonhee,7,0,34,27
1657337130651,MATH 10B,B01,083739,Sinha; Shubham,12,0,30,18
1657337136683,MATH 18,A01,083743,Cinel; Cameron Alexander,6,0,30,24
1657337136683,MATH 18,A02,083744,Cinel; Cameron Alexander,17,0,30,13
1657337136683,MATH 18,A03,083745,Cinel; Cameron Alexander,9,0,30,21
1657337136683,MATH 18,B01,083748,Rideout; David Porter,5,0,37,32
1657337136683,MATH 18,B02,083749,Rideout; David Porter,5,0,36,31
1657337136683,MATH 18,B03,083750,Rideout; David Porter,3,0,37,34
1657337136683,MATH 18,B04,083751,Rideout; David Porter,6,0,36,30
1657337136683,MATH 18,B05,093473,Rideout; David Porter,6,0,36,30
1657337136683,MATH 18,B06,093474,Rideout; David Porter,6,0,36,30
1657337142706,MATH 20A,A01,083754,Zheng; Zequn,14,0,40,26
1657337148735,MATH 20B,A01,083756,Briones; Jor-el Thomas Caparas,4,0,36,32
1657337148735,MATH 20B,A02,083757,Briones; Jor-el Thomas Caparas,1,0,36,35
1657337148735,MATH 20B,A03,093475,Briones; Jor-el Thomas Caparas,2,0,36,34
1657337154759,MATH 20C,A01,083760,Briones; Jor-el Thomas Caparas,1,0,35,34
1657337154759,MATH 20C,A02,083761,Briones; Jor-el Thomas Caparas,8,0,35,27
1657337154759,MATH 20C,A03,093476,Briones; Jor-el Thomas Caparas,0,1,36,36
1657337154759,MATH 20C,B01,083762,Bach; Quang Tran,1,0,30,29
1657337160788,MATH 20D,A01,083765,Tran; Brian Kha,5,0,30,25
1657337160788,MATH 20D,A02,083766,Tran; Brian Kha,5,0,30,25
1657337160788,MATH 20D,A03,083767,Tran; Brian Kha,4,0,30,26
1657337166818,MATH 20E,A01,083771,Ganguly; Soumya,9,0,32,23
1657337166818,MATH 20E,A02,083772,Ganguly; Soumya,6,0,32,26
1657337166818,MATH 20E,B01,083773,Ciotti; Benjamin,20,0,35,15
1657337166818,MATH 20E,B02,083774,Ciotti; Benjamin,17,0,35,18
1657337172847,MATH 103A,A01,083777,Greenfeld; Be'Eri,3,0,36,33
1657337172847,MATH 103A,A02,083778,Greenfeld; Be'Eri,5,0,36,31
1657337172847,MATH 103A,A03,093561,Greenfeld; Be'Eri,4,0,36,32
1657337172847,MATH 103A,B01,083779,Greenfeld; Be'Eri,6,0,36,30
1657337172847,MATH 103A,B02,083780,Greenfeld; Be'Eri,4,0,36,32
1657337172847,MATH 103A,B03,093562,Greenfeld; Be'Eri,3,0,36,33
1657337178870,MATH 105,A01,085443,Carter; Anne Toulson,15,0,35,20
1657337178870,MATH 105,A02,093477,Carter; Anne Toulson,20,0,35,15
1657337184894,MATH 109,A01,083213,Ganzberger; Geoffrey Michael,2,0,34,32
1657337184894,MATH 109,A02,083214,Ganzberger; Geoffrey Michael,4,0,34,30
1657337184894,MATH 109,A03,093478,Ganzberger; Geoffrey Michael,2,0,34,32
1657337184894,MATH 109,B01,083215,Ganzberger; Geoffrey Michael,1,0,32,31
1657337184894,MATH 109,B02,083216,Ganzberger; Geoffrey Michael,1,0,32,31
1657337184894,MATH 109,B03,093479,Ganzberger; Geoffrey Michael,8,0,32,24
1657337190923,MATH 142A,A01,083219,Chow; Bennett,7,0,32,25
1657337190923,MATH 142A,A02,083220,Chow; Bennett,10,0,32,22
1657337190923,MATH 142A,A03,093480,Chow; Bennett,7,0,32,25
1657337190923,MATH 142A,B03,093481,Chow; Bennett,8,0,32,24
1657337190923,MATH 142A,B04,093558,Chow; Bennett,13,0,32,19
1657337190923,MATH 142A,B05,093559,Chow; Bennett,6,0,32,26
1657337196947,MATH 193A,A01,083224,Rotar; Vladimir,7,0,34,27
1657337196947,MATH 193A,A02,083225,Rotar; Vladimir,7,0,34,27
1657337196947,MATH 193A,A03,083781,Rotar; Vladimir,3,0,34,31
1657337196947,MATH 193A,A04,083782,Rotar; Vladimir,9,0,34,25
1657337196947,MATH 193A,A05,093482,Rotar; Vladimir,10,0,34,24
1657337202970,MATH 197,001,091859,McAuley; Julian John,9999,0,9999,0
1657337202970,MATH 197,002,095566,Kedlaya; Kiran S.,9997,0,9999,2
1657337202970,MATH 197,003,095567,Xiao; Ming,9999,0,9999,0
1657337202970,MATH 197,004,095571,Perols; Johan Lars,9998,0,9999,1
1657337210032,COGS 9,A01,083615,Shannon; Kyle Michael,8,0,75,67
1657337216055,COGS 11,A01,083617,Boyle; Mary E. T.,22,0,48,26
1657337222078,COGS 13,A01,083071,Bastos; Amalia Pinkusfeld,11,0,71,60
1657337228106,COGS 14A,A01,092681,Semenuks; Arturs,3,1,100,97
1657337234130,COGS 14B,A01,083073,Cheng; Tzu-Han,6,0,63,57
1657337240156,COGS 17,A01,092677,Semenuks; Arturs,6,0,81,75
1657337246183,COGS 100,A01,083619,Allen; Michael Gordon,16,0,70,54
1657337252213,COGS 101A,A01,083621,Davis; Joshua Daniel,9,0,68,59
1657337258236,COGS 101B,A01,091572,Allen; Michael Gordon,11,0,65,54
1657337264264,COGS 101C,A01,083625,Delgado; Tania,17,0,35,18
1657337270288,COGS 107A,A01,083627,Boyle; Mary E. T.,13,0,60,47
1657337276312,COGS 118A,A01,083075,Gupta; Anjum,19,0,76,57
1657337282343,CSE 3,A50,083646,Miranda; Gregory Joseph,24,0,50,26
1657337288368,CSE 8A,A50,083650,Miranda; Gregory Joseph,17,1,56,39
1657337294391,CSE 11,A01,083080,Cao; Yingjun,6,15,40,34
1657337300414,CSE 12,A01,083652,Krause-Levy; Sophia Louisa,28,1,120,92
1657337306437,CSE 15L,A01,083654,Morris; Justin Loren,9,0,50,41
1657337306437,CSE 15L,A02,083655,Morris; Justin Loren,9,0,50,41
1657337312460,CSE 20,A01,083657,Tran; Khoa Dang,39,0,80,41
1657337318483,CSE 21,A01,095574,Bach; Quang Tran,22,0,48,26
1657337324505,CSE 30,A01,083084,Eldon; John,4,0,80,76
1657337324505,CSE 30,B01,095061,Bhaskar; Nishant,9,0,50,41
1657337330530,CSE 100,A01,083659,Cao; Yingjun,4,4,70,66
1657337336552,CSE 134B,A01,083661,Powell; Thomas Allan,22,0,100,78
1657337342579,CSE 140,A01,083663,Gungor; Onat,14,0,85,71
1657337348603,CSE 140L,A01,083088,Eldon; John,21,0,100,79
1657337354628,CSE 175,A01,083665,Kumar; Rakesh,3,0,25,22
1657337360652,CSE 190,A00,092507,Dubnov; Shlomo,7,0,20,13
1657337366675,ECE 45,A01,083139,Congero; Spencer William,6,0,75,69
1657337372698,ECE 65,A50,083695,Saad; Andrew S,12,0,30,18
1657337372698,ECE 65,A51,095125,Saad; Andrew S,24,0,26,2
1657337378735,ECE 109,A01,091882,Touri; Behrouz,19,0,70,51
1657337384759,ECE 180,A00,083140,Abi Samra; Nicholas Camill,1,0,30,29
1657337384759,ECE 180,B00,083141,Abi Samra; Nicholas Camill,0,0,30,30
1657337390783,MATH 10A,A01,083735,Patchell; Gregory David,2,0,30,28
1657337390783,MATH 10A,A02,083736,Patchell; Gregory David,20,0,30,10
1657337390783,MATH 10A,A03,083737,Patchell; Gregory David,16,0,30,14
1657337396815,MATH 10B,A01,083207,Lim; Seonhee,7,0,34,27
1657337396815,MATH 10B,A02,083208,Lim; Seonhee,9,0,35,26
1657337396815,MATH 10B,A03,093472,Lim; Seonhee,7,0,34,27
1657337396815,MATH 10B,B01,083739,Sinha; Shubham,12,0,30,18
1657337402839,MATH 18,A01,083743,Cinel; Cameron Alexander,6,0,30,24
1657337402839,MATH 18,A02,083744,Cinel; Cameron Alexander,17,0,30,13
1657337402839,MATH 18,A03,083745,Cinel; Cameron Alexander,9,0,30,21
1657337402839,MATH 18,B01,083748,Rideout; David Porter,5,0,37,32
1657337402839,MATH 18,B02,083749,Rideout; David Porter,5,0,36,31
1657337402839,MATH 18,B03,083750,Rideout; David Porter,3,0,37,34
1657337402839,MATH 18,B04,083751,Rideout; David Porter,6,0,36,30
1657337402839,MATH 18,B05,093473,Rideout; David Porter,6,0,36,30
1657337402839,MATH 18,B06,093474,Rideout; David Porter,6,0,36,30
1657337408864,MATH 20A,A01,083754,Zheng; Zequn,14,0,40,26
1657337414890,MATH 20B,A01,083756,Briones; Jor-el Thomas Caparas,4,0,36,32
1657337414890,MATH 20B,A02,083757,Briones; Jor-el Thomas Caparas,1,0,36,35
1657337414890,MATH 20B,A03,093475,Briones; Jor-el Thomas Caparas,2,0,36,34
1657337420914,MATH 20C,A01,083760,Briones; Jor-el Thomas Caparas,1,0,35,34
1657337420914,MATH 20C,A02,083761,Briones; Jor-el Thomas Caparas,8,0,35,27
1657337420914,MATH 20C,A03,093476,Briones; Jor-el Thomas Caparas,0,1,36,36
1657337420914,MATH 20C,B01,083762,Bach; Quang Tran,1,0,30,29
1657337426937,MATH 20D,A01,083765,Tran; Brian Kha,5,0,30,25
1657337426937,MATH 20D,A02,083766,Tran; Brian Kha,5,0,30,25
1657337426937,MATH 20D,A03,083767,Tran; Brian Kha,4,0,30,26
1657337432966,MATH 20E,A01,083771,Ganguly; Soumya,9,0,32,23
1657337432966,MATH 20E,A02,083772,Ganguly; Soumya,6,0,32,26
1657337432966,MATH 20E,B01,083773,Ciotti; Benjamin,20,0,35,15
1657337432966,MATH 20E,B02,083774,Ciotti; Benjamin,17,0,35,18
1657337438990,MATH 103A,A01,083777,Greenfeld; Be'Eri,3,0,36,33
1657337438990,MATH 103A,A02,083778,Greenfeld; Be'Eri,5,0,36,31
1657337438990,MATH 103A,A03,093561,Greenfeld; Be'Eri,4,0,36,32
1657337438990,MATH 103A,B01,083779,Greenfeld; Be'Eri,6,0,36,30
1657337438990,MATH 103A,B02,083780,Greenfeld; Be'Eri,4,0,36,32
1657337438990,MATH 103A,B03,093562,Greenfeld; Be'Eri,3,0,36,33
1657337445108,MATH 105,A01,085443,Carter; Anne Toulson,15,0,35,20
1657337445108,MATH 105,A02,093477,Carter; Anne Toulson,20,0,35,15
1657337451137,MATH 109,A01,083213,Ganzberger; Geoffrey Michael,2,0,34,32
1657337451137,MATH 109,A02,083214,Ganzberger; Geoffrey Michael,4,0,34,30
1657337451137,MATH 109,A03,093478,Ganzberger; Geoffrey Michael,2,0,34,32
1657337451137,MATH 109,B01,083215,Ganzberger; Geoffrey Michael,1,0,32,31
1657337451137,MATH 109,B02,083216,Ganzberger; Geoffrey Michael,1,0,32,31
1657337451137,MATH 109,B03,093479,Ganzberger; Geoffrey Michael,8,0,32,24
1657337457161,MATH 142A,A01,083219,Chow; Bennett,7,0,32,25
1657337457161,MATH 142A,A02,083220,Chow; Bennett,10,0,32,22
1657337457161,MATH 142A,A03,093480,Chow; Bennett,7,0,32,25
1657337457161,MATH 142A,B03,093481,Chow; Bennett,8,0,32,24
1657337457161,MATH 142A,B04,093558,Chow; Bennett,13,0,32,19
1657337457161,MATH 142A,B05,093559,Chow; Bennett,6,0,32,26
1657337463189,MATH 193A,A01,083224,Rotar; Vladimir,7,0,34,27
1657337463189,MATH 193A,A02,083225,Rotar; Vladimir,7,0,34,27
1657337463189,MATH 193A,A03,083781,Rotar; Vladimir,3,0,34,31
1657337463189,MATH 193A,A04,083782,Rotar; Vladimir,9,0,34,25
1657337463189,MATH 193A,A05,093482,Rotar; Vladimir,10,0,34,24
1657337469215,MATH 197,001,091859,McAuley; Julian John,9999,0,9999,0
1657337469215,MATH 197,002,095566,Kedlaya; Kiran S.,9997,0,9999,2
1657337469215,MATH 197,003,095567,Xiao; Ming,9999,0,9999,0
1657337469215,MATH 197,004,095571,Perols; Johan Lars,9998,0,9999,1
1657337476269,COGS 9,A01,083615,Shannon; Kyle Michael,8,0,75,67
1657337482292,COGS 11,A01,083617,Boyle; Mary E. T.,22,0,48,26
1657337488319,COGS 13,A01,083071,Bastos; Amalia Pinkusfeld,11,0,71,60
1657337494343,COGS 14A,A01,092681,Semenuks; Arturs,3,1,100,97
1657337500367,COGS 14B,A01,083073,Cheng; Tzu-Han,6,0,63,57
1657337506394,COGS 17,A01,092677,Semenuks; Arturs,6,0,81,75
1657337512422,COGS 100,A01,083619,Allen; Michael Gordon,16,0,70,54
1657337518451,COGS 101A,A01,083621,Davis; Joshua Daniel,9,0,68,59
1657337524474,COGS 101B,A01,091572,Allen; Michael Gordon,11,0,65,54
1657337530495,COGS 101C,A01,083625,Delgado; Tania,17,0,35,18
1657337536519,COGS 107A,A01,083627,Boyle; Mary E. T.,13,0,60,47
1657337542541,COGS 118A,A01,083075,Gupta; Anjum,19,0,76,57
1657337548564,CSE 3,A50,083646,Miranda; Gregory Joseph,24,0,50,26
1657337554587,CSE 8A,A50,083650,Miranda; Gregory Joseph,17,1,56,39
1657337560611,CSE 11,A01,083080,Cao; Yingjun,6,15,40,34
1657337566636,CSE 12,A01,083652,Krause-Levy; Sophia Louisa,28,1,120,92
1657337572663,CSE 15L,A01,083654,Morris; Justin Loren,9,0,50,41
1657337572663,CSE 15L,A02,083655,Morris; Justin Loren,9,0,50,41
1657337578686,CSE 20,A01,083657,Tran; Khoa Dang,39,0,80,41
1657337584709,CSE 21,A01,095574,Bach; Quang Tran,22,0,48,26
1657337590733,CSE 30,A01,083084,Eldon; John,4,0,80,76
1657337590733,CSE 30,B01,095061,Bhaskar; Nishant,9,0,50,41
1657337596759,CSE 100,A01,083659,Cao; Yingjun,4,4,70,66
1657337602784,CSE 134B,A01,083661,Powell; Thomas Allan,22,0,100,78
1657337608808,CSE 140,A01,083663,Gungor; Onat,14,0,85,71
1657337614840,CSE 140L,A01,083088,Eldon; John,21,0,100,79
1657337620862,CSE 175,A01,083665,Kumar; Rakesh,3,0,25,22
1657337626889,CSE 190,A00,092507,Dubnov; Shlomo,7,0,20,13
1657337632922,ECE 45,A01,083139,Congero; Spencer William,6,0,75,69
1657337638945,ECE 65,A50,083695,Saad; Andrew S,12,0,30,18
1657337638945,ECE 65,A51,095125,Saad; Andrew S,24,0,26,2
1657337644967,ECE 109,A01,091882,Touri; Behrouz,19,0,70,51
1657337650989,ECE 180,A00,083140,Abi Samra; Nicholas Camill,1,0,30,29
1657337650989,ECE 180,B00,083141,Abi Samra; Nicholas Camill,0,0,30,30
1657337657012,MATH 10A,A01,083735,Patchell; Gregory David,2,0,30,28
1657337657012,MATH 10A,A02,083736,Patchell; Gregory David,20,0,30,10
1657337657012,MATH 10A,A03,083737,Patchell; Gregory David,16,0,30,14
1657337663041,MATH 10B,A01,083207,Lim; Seonhee,7,0,34,27
1657337663041,MATH 10B,A02,083208,Lim; Seonhee,9,0,35,26
1657337663041,MATH 10B,A03,093472,Lim; Seonhee,7,0,34,27
1657337663041,MATH 10B,B01,083739,Sinha; Shubham,12,0,30,18
1657337669065,MATH 18,A01,083743,Cinel; Cameron Alexander,7,0,30,23
1657337669065,MATH 18,A02,083744,Cinel; Cameron Alexander,17,0,30,13
1657337669065,MATH 18,A03,083745,Cinel; Cameron Alexander,9,0,30,21
1657337669065,MATH 18,B01,083748,Rideout; David Porter,5,0,37,32
1657337669065,MATH 18,B02,083749,Rideout; David Porter,5,0,36,31
1657337669065,MATH 18,B03,083750,Rideout; David Porter,3,0,37,34
1657337669065,MATH 18,B04,083751,Rideout; David Porter,6,0,36,30
1657337669065,MATH 18,B05,093473,Rideout; David Porter,6,0,36,30
1657337669065,MATH 18,B06,093474,Rideout; David Porter,6,0,36,30
1657337675089,MATH 20A,A01,083754,Zheng; Zequn,14,0,40,26
1657337681117,MATH 20B,A01,083756,Briones; Jor-el Thomas Caparas,4,0,36,32
1657337681117,MATH 20B,A02,083757,Briones; Jor-el Thomas Caparas,1,0,36,35
1657337681117,MATH 20B,A03,093475,Briones; Jor-el Thomas Caparas,2,0,36,34
1657337687142,MATH 20C,A01,083760,Briones; Jor-el Thomas Caparas,1,0,35,34
1657337687142,MATH 20C,A02,083761,Briones; Jor-el Thomas Caparas,8,0,35,27
1657337687142,MATH 20C,A03,093476,Briones; Jor-el Thomas Caparas,0,1,36,36
1657337687142,MATH 20C,B01,083762,Bach; Quang Tran,1,0,30,29
1657337693166,MATH 20D,A01,083765,Tran; Brian Kha,5,0,30,25
1657337693166,MATH 20D,A02,083766,Tran; Brian Kha,5,0,30,25
1657337693166,MATH 20D,A03,083767,Tran; Brian Kha,4,0,30,26
1657337699194,MATH 20E,A01,083771,Ganguly; Soumya,9,0,32,23
1657337699194,MATH 20E,A02,083772,Ganguly; Soumya,6,0,32,26
1657337699194,MATH 20E,B01,083773,Ciotti; Benjamin,20,0,35,15
1657337699194,MATH 20E,B02,083774,Ciotti; Benjamin,17,0,35,18
1657337705223,MATH 103A,A01,083777,Greenfeld; Be'Eri,3,0,36,33
1657337705223,MATH 103A,A02,083778,Greenfeld; Be'Eri,5,0,36,31
1657337705223,MATH 103A,A03,093561,Greenfeld; Be'Eri,4,0,36,32
1657337705223,MATH 103A,B01,083779,Greenfeld; Be'Eri,6,0,36,30
1657337705223,MATH 103A,B02,083780,Greenfeld; Be'Eri,4,0,36,32
1657337705223,MATH 103A,B03,093562,Greenfeld; Be'Eri,3,0,36,33
1657337711249,MATH 105,A01,085443,Carter; Anne Toulson,15,0,35,20
1657337711249,MATH 105,A02,093477,Carter; Anne Toulson,20,0,35,15
1657337717274,MATH 109,A01,083213,Ganzberger; Geoffrey Michael,2,0,34,32
1657337717274,MATH 109,A02,083214,Ganzberger; Geoffrey Michael,4,0,34,30
1657337717274,MATH 109,A03,093478,Ganzberger; Geoffrey Michael,2,0,34,32
1657337717274,MATH 109,B01,083215,Ganzberger; Geoffrey Michael,1,0,32,31
1657337717274,MATH 109,B02,083216,Ganzberger; Geoffrey Michael,1,0,32,31
1657337717274,MATH 109,B03,093479,Ganzberger; Geoffrey Michael,8,0,32,24
1657337723297,MATH 142A,A01,083219,Chow; Bennett,7,0,32,25
1657337723297,MATH 142A,A02,083220,Chow; Bennett,10,0,32,22
1657337723297,MATH 142A,A03,093480,Chow; Bennett,7,0,32,25
1657337723297,MATH 142A,B03,093481,Chow; Bennett,8,0,32,24
1657337723297,MATH 142A,B04,093558,Chow; Bennett,13,0,32,19
1657337723297,MATH 142A,B05,093559,Chow; Bennett,6,0,32,26
1657337729325,MATH 193A,A01,083224,Rotar; Vladimir,7,0,34,27
1657337729325,MATH 193A,A02,083225,Rotar; Vladimir,7,0,34,27
1657337729325,MATH 193A,A03,083781,Rotar; Vladimir,3,0,34,31
1657337729325,MATH 193A,A04,083782,Rotar; Vladimir,9,0,34,25
1657337729325,MATH 193A,A05,093482,Rotar; Vladimir,10,0,34,24
1657337735345,MATH 197,001,091859,McAuley; Julian John,9999,0,9999,0
1657337735345,MATH 197,002,095566,Kedlaya; Kiran S.,9997,0,9999,2
1657337735345,MATH 197,003,095567,Xiao; Ming,9999,0,9999,0
1657337735345,MATH 197,004,095571,Perols; Johan Lars,9998,0,9999,1
1657337742411,COGS 9,A01,083615,Shannon; Kyle Michael,8,0,75,67
1657337748434,COGS 11,A01,083617,Boyle; Mary E. T.,22,0,48,26
1657337754465,COGS 13,A01,083071,Bastos; Amalia Pinkusfeld,11,0,71,60
1657337760490,COGS 14A,A01,092681,Semenuks; Arturs,3,1,100,97
1657337766517,COGS 14B,A01,083073,Cheng; Tzu-Han,6,0,63,57
1657337772543,COGS 17,A01,092677,Semenuks; Arturs,6,0,81,75
1657337778567,COGS 100,A01,083619,Allen; Michael Gordon,16,0,70,54
1657337784594,COGS 101A,A01,083621,Davis; Joshua Daniel,9,0,68,59
1657337790624,COGS 101B,A01,091572,Allen; Michael Gordon,11,0,65,54
1657337796650,COGS 101C,A01,083625,Delgado; Tania,17,0,35,18
1657337802678,COGS 107A,A01,083627,Boyle; Mary E. T.,13,0,60,47
1657337808704,COGS 118A,A01,083075,Gupta; Anjum,19,0,76,57
1657337814732,CSE 3,A50,083646,Miranda; Gregory Joseph,24,0,50,26
1657337820753,CSE 8A,A50,083650,Miranda; Gregory Joseph,17,1,56,39
1657337826780,CSE 11,A01,083080,Cao; Yingjun,6,15,40,34
1657337832804,CSE 12,A01,083652,Krause-Levy; Sophia Louisa,28,1,120,92
1657337838831,CSE 15L,A01,083654,Morris; Justin Loren,9,0,50,41
1657337838831,CSE 15L,A02,083655,Morris; Justin Loren,9,0,50,41
1657337844857,CSE 20,A01,083657,Tran; Khoa Dang,39,0,80,41
1657337850882,CSE 21,A01,095574,Bach; Quang Tran,22,0,48,26
1657337856908,CSE 30,A01,083084,Eldon; John,4,0,80,76
1657337856908,CSE 30,B01,095061,Bhaskar; Nishant,9,0,50,41
1657337862934,CSE 100,A01,083659,Cao; Yingjun,4,4,70,66
1657337868960,CSE 134B,A01,083661,Powell; Thomas Allan,22,0,100,78
1657337874983,CSE 140,A01,083663,Gungor; Onat,14,0,85,71
1657337881005,CSE 140L,A01,083088,Eldon; John,21,0,100,79
1657337887028,CSE 175,A01,083665,Kumar; Rakesh,3,0,25,22
1657337893049,CSE 190,A00,092507,Dubnov; Shlomo,7,0,20,13
1657337899071,ECE 45,A01,083139,Congero; Spencer William,6,0,75,69
1657337905095,ECE 65,A50,083695,Saad; Andrew S,12,0,30,18
1657337905095,ECE 65,A51,095125,Saad; Andrew S,24,0,26,2
1657337911121,ECE 109,A01,091882,Touri; Behrouz,19,0,70,51
1657337917144,ECE 180,A00,083140,Abi Samra; Nicholas Camill,1,0,30,29
1657337917144,ECE 180,B00,083141,Abi Samra; Nicholas Camill,0,0,30,30
1657337923167,MATH 10A,A01,083735,Patchell; Gregory David,2,0,30,28
1657337923167,MATH 10A,A02,083736,Patchell; Gregory David,20,0,30,10
1657337923167,MATH 10A,A03,083737,Patchell; Gregory David,16,0,30,14
1657337929192,MATH 10B,A01,083207,Lim; Seonhee,7,0,34,27
1657337929192,MATH 10B,A02,083208,Lim; Seonhee,9,0,35,26
1657337929192,MATH 10B,A03,093472,Lim; Seonhee,7,0,34,27
1657337929192,MATH 10B,B01,083739,Sinha; Shubham,12,0,30,18
1657337935223,MATH 18,A01,083743,Cinel; Cameron Alexander,7,0,30,23
1657337935223,MATH 18,A02,083744,Cinel; Cameron Alexander,17,0,30,13
1657337935223,MATH 18,A03,083745,Cinel; Cameron Alexander,9,0,30,21
1657337935223,MATH 18,B01,083748,Rideout; David Porter,5,0,37,32
1657337935223,MATH 18,B02,083749,Rideout; David Porter,5,0,36,31
1657337935223,MATH 18,B03,083750,Rideout; David Porter,3,0,37,34
1657337935223,MATH 18,B04,083751,Rideout; David Porter,6,0,36,30
1657337935223,MATH 18,B05,093473,Rideout; David Porter,6,0,36,30
1657337935223,MATH 18,B06,093474,Rideout; David Porter,6,0,36,30
1657337941245,MATH 20A,A01,083754,Zheng; Zequn,14,0,40,26
1657337947268,MATH 20B,A01,083756,Briones; Jor-el Thomas Caparas,4,0,36,32
1657337947268,MATH 20B,A02,083757,Briones; Jor-el Thomas Caparas,1,0,36,35
1657337947268,MATH 20B,A03,093475,Briones; Jor-el Thomas Caparas,2,0,36,34
1657337953293,MATH 20C,A01,083760,Briones; Jor-el Thomas Caparas,1,0,35,34
1657337953293,MATH 20C,A02,083761,Briones; Jor-el Thomas Caparas,8,0,35,27
1657337953293,MATH 20C,A03,093476,Briones; Jor-el Thomas Caparas,0,1,36,36
1657337953293,MATH 20C,B01,083762,Bach; Quang Tran,1,0,30,29
1657337959316,MATH 20D,A01,083765,Tran; Brian Kha,5,0,30,25
1657337959316,MATH 20D,A02,083766,Tran; Brian Kha,5,0,30,25
1657337959316,MATH 20D,A03,083767,Tran; Brian Kha,4,0,30,26
1657337965339,MATH 20E,A01,083771,Ganguly; Soumya,9,0,32,23
1657337965339,MATH 20E,A02,083772,Ganguly; Soumya,6,0,32,26
1657337965339,MATH 20E,B01,083773,Ciotti; Benjamin,20,0,35,15
1657337965339,MATH 20E,B02,083774,Ciotti; Benjamin,17,0,35,18
1657337971363,MATH 103A,A01,083777,Greenfeld; Be'Eri,3,0,36,33
1657337971363,MATH 103A,A02,083778,Greenfeld; Be'Eri,5,0,36,31
1657337971363,MATH 103A,A03,093561,Greenfeld; Be'Eri,4,0,36,32
1657337971363,MATH 103A,B01,083779,Greenfeld; Be'Eri,6,0,36,30
1657337971363,MATH 103A,B02,083780,Greenfeld; Be'Eri,4,0,36,32
1657337971363,MATH 103A,B03,093562,Greenfeld; Be'Eri,3,0,36,33
1657337977386,MATH 105,A01,085443,Carter; Anne Toulson,15,0,35,20
1657337977386,MATH 105,A02,093477,Carter; Anne Toulson,20,0,35,15
1657337983410,MATH 109,A01,083213,Ganzberger; Geoffrey Michael,2,0,34,32
1657337983410,MATH 109,A02,083214,Ganzberger; Geoffrey Michael,4,0,34,30
1657337983410,MATH 109,A03,093478,Ganzberger; Geoffrey Michael,2,0,34,32
1657337983410,MATH 109,B01,083215,Ganzberger; Geoffrey Michael,1,0,32,31
1657337983410,MATH 109,B02,083216,Ganzberger; Geoffrey Michael,1,0,32,31
1657337983410,MATH 109,B03,093479,Ganzberger; Geoffrey Michael,8,0,32,24
1657337989435,MATH 142A,A01,083219,Chow; Bennett,7,0,32,25
1657337989435,MATH 142A,A02,083220,Chow; Bennett,10,0,32,22
1657337989435,MATH 142A,A03,093480,Chow; Bennett,7,0,32,25
1657337989435,MATH 142A,B03,093481,Chow; Bennett,8,0,32,24
1657337989435,MATH 142A,B04,093558,Chow; Bennett,13,0,32,19
1657337989435,MATH 142A,B05,093559,Chow; Bennett,6,0,32,26
1657337995463,MATH 193A,A01,083224,Rotar; Vladimir,7,0,34,27
1657337995463,MATH 193A,A02,083225,Rotar; Vladimir,7,0,34,27
1657337995463,MATH 193A,A03,083781,Rotar; Vladimir,3,0,34,31
1657337995463,MATH 193A,A04,083782,Rotar; Vladimir,9,0,34,25
1657337995463,MATH 193A,A05,093482,Rotar; Vladimir,10,0,34,24
1657338001488,MATH 197,001,091859,McAuley; Julian John,9999,0,9999,0
1657338001488,MATH 197,002,095566,Kedlaya; Kiran S.,9997,0,9999,2
1657338001488,MATH 197,003,095567,Xiao; Ming,9999,0,9999,0
1657338001488,MATH 197,004,095571,Perols; Johan Lars,9998,0,9999,1
1657338008537,COGS 9,A01,083615,Shannon; Kyle Michael,8,0,75,67
1657338014559,COGS 11,A01,083617,Boyle; Mary E. T.,22,0,48,26
1657338020586,COGS 13,A01,083071,Bastos; Amalia Pinkusfeld,11,0,71,60
1657338026612,COGS 14A,A01,092681,Semenuks; Arturs,3,1,100,97
1657338032636,COGS 14B,A01,083073,Cheng; Tzu-Han,6,0,63,57
1657338038735,COGS 17,A01,092677,Semenuks; Arturs,6,0,81,75
1657338044762,COGS 100,A01,083619,Allen; Michael Gordon,16,0,70,54
1657338050785,COGS 101A,A01,083621,Davis; Joshua Daniel,9,0,68,59
1657338056808,COGS 101B,A01,091572,Allen; Michael Gordon,11,0,65,54
1657338062835,COGS 101C,A01,083625,Delgado; Tania,17,0,35,18
1657338068859,COGS 107A,A01,083627,Boyle; Mary E. T.,13,0,60,47
1657338074880,COGS 118A,A01,083075,Gupta; Anjum,20,0,76,56
1657338080907,CSE 3,A50,083646,Miranda; Gregory Joseph,24,0,50,26
1657338086929,CSE 8A,A50,083650,Miranda; Gregory Joseph,17,1,56,39
1657338092951,CSE 11,A01,083080,Cao; Yingjun,6,15,40,34
1657338098977,CSE 12,A01,083652,Krause-Levy; Sophia Louisa,28,1,120,92
1657338105003,CSE 15L,A01,083654,Morris; Justin Loren,9,0,50,41
1657338105003,CSE 15L,A02,083655,Morris; Justin Loren,9,0,50,41
1657338111031,CSE 20,A01,083657,Tran; Khoa Dang,39,0,80,41
1657338117054,CSE 21,A01,095574,Bach; Quang Tran,22,0,48,26
1657338123077,CSE 30,A01,083084,Eldon; John,4,0,80,76
1657338123077,CSE 30,B01,095061,Bhaskar; Nishant,9,0,50,41
1657338129103,CSE 100,A01,083659,Cao; Yingjun,4,4,70,66
1657338135127,CSE 134B,A01,083661,Powell; Thomas Allan,22,0,100,78
1657338141153,CSE 140,A01,083663,Gungor; Onat,14,0,85,71
1657338147177,CSE 140L,A01,083088,Eldon; John,21,0,100,79
1657338153199,CSE 175,A01,083665,Kumar; Rakesh,3,0,25,22
1657338159239,CSE 190,A00,092507,Dubnov; Shlomo,7,0,20,13
1657338165263,ECE 45,A01,083139,Congero; Spencer William,6,0,75,69
1657338171287,ECE 65,A50,083695,Saad; Andrew S,12,0,30,18
1657338171287,ECE 65,A51,095125,Saad; Andrew S,24,0,26,2
1657338177318,ECE 109,A01,091882,Touri; Behrouz,19,0,70,51
1657338183340,ECE 180,A00,083140,Abi Samra; Nicholas Camill,1,0,30,29
1657338183340,ECE 180,B00,083141,Abi Samra; Nicholas Camill,0,0,30,30
1657338189362,MATH 10A,A01,083735,Patchell; Gregory David,2,0,30,28
1657338189362,MATH 10A,A02,083736,Patchell; Gregory David,20,0,30,10
1657338189362,MATH 10A,A03,083737,Patchell; Gregory David,16,0,30,14
1657338195389,MATH 10B,A01,083207,Lim; Seonhee,7,0,34,27
1657338195389,MATH 10B,A02,083208,Lim; Seonhee,9,0,35,26
1657338195389,MATH 10B,A03,093472,Lim; Seonhee,7,0,34,27
1657338195389,MATH 10B,B01,083739,Sinha; Shubham,12,0,30,18
1657338201413,MATH 18,A01,083743,Cinel; Cameron Alexander,7,0,30,23
1657338201413,MATH 18,A02,083744,Cinel; Cameron Alexander,17,0,30,13
1657338201413,MATH 18,A03,083745,Cinel; Cameron Alexander,9,0,30,21
1657338201413,MATH 18,B01,083748,Rideout; David Porter,5,0,37,32
1657338201413,MATH 18,B02,083749,Rideout; David Porter,5,0,36,31
1657338201413,MATH 18,B03,083750,Rideout; David Porter,3,0,37,34
1657338201413,MATH 18,B04,083751,Rideout; David Porter,6,0,36,30
1657338201413,MATH 18,B05,093473,Rideout; David Porter,6,0,36,30
1657338201413,MATH 18,B06,093474,Rideout; David Porter,6,0,36,30
1657338207437,MATH 20A,A01,083754,Zheng; Zequn,14,0,40,26
1657338213463,MATH 20B,A01,083756,Briones; Jor-el Thomas Caparas,4,0,36,32
1657338213463,MATH 20B,A02,083757,Briones; Jor-el Thomas Caparas,1,0,36,35
1657338213463,MATH 20B,A03,093475,Briones; Jor-el Thomas Caparas,2,0,36,34
1657338219486,MATH 20C,A01,083760,Briones; Jor-el Thomas Caparas,1,0,35,34
1657338219486,MATH 20C,A02,083761,Briones; Jor-el Thomas Caparas,8,0,35,27
1657338219486,MATH 20C,A03,093476,Briones; Jor-el Thomas Caparas,0,1,36,36
1657338219486,MATH 20C,B01,083762,Bach; Quang Tran,1,0,30,29
1657338225509,MATH 20D,A01,083765,Tran; Brian Kha,5,0,30,25
1657338225509,MATH 20D,A02,083766,Tran; Brian Kha,5,0,30,25
1657338225509,MATH 20D,A03,083767,Tran; Brian Kha,4,0,30,26
1657338231537,MATH 20E,A01,083771,Ganguly; Soumya,9,0,32,23
1657338231537,MATH 20E,A02,083772,Ganguly; Soumya,6,0,32,26
1657338231537,MATH 20E,B01,083773,Ciotti; Benjamin,20,0,35,15
1657338231537,MATH 20E,B02,083774,Ciotti; Benjamin,17,0,35,18
1657338237561,MATH 103A,A01,083777,Greenfeld; Be'Eri,3,0,36,33
1657338237561,MATH 103A,A02,083778,Greenfeld; Be'Eri,5,0,36,31
1657338237561,MATH 103A,A03,093561,Greenfeld; Be'Eri,4,0,36,32
1657338237561,MATH 103A,B01,083779,Greenfeld; Be'Eri,6,0,36,30
1657338237561,MATH 103A,B02,083780,Greenfeld; Be'Eri,4,0,36,32
1657338237561,MATH 103A,B03,093562,Greenfeld; Be'Eri,3,0,36,33
1657338243583,MATH 105,A01,085443,Carter; Anne Toulson,15,0,35,20
1657338243583,MATH 105,A02,093477,Carter; Anne Toulson,20,0,35,15
1657338249611,MATH 109,A01,083213,Ganzberger; Geoffrey Michael,2,0,34,32
1657338249611,MATH 109,A02,083214,Ganzberger; Geoffrey Michael,4,0,34,30
1657338249611,MATH 109,A03,093478,Ganzberger; Geoffrey Michael,2,0,34,32
1657338249611,MATH 109,B01,083215,Ganzberger; Geoffrey Michael,1,0,32,31
1657338249611,MATH 109,B02,083216,Ganzberger; Geoffrey Michael,1,0,32,31
1657338249611,MATH 109,B03,093479,Ganzberger; Geoffrey Michael,8,0,32,24
1657338255633,MATH 142A,A01,083219,Chow; Bennett,7,0,32,25
1657338255633,MATH 142A,A02,083220,Chow; Bennett,10,0,32,22
1657338255633,MATH 142A,A03,093480,Chow; Bennett,7,0,32,25
1657338255633,MATH 142A,B03,093481,Chow; Bennett,8,0,32,24
1657338255633,MATH 142A,B04,093558,Chow; Bennett,13,0,32,19
1657338255633,MATH 142A,B05,093559,Chow; Bennett,6,0,32,26
1657338261661,MATH 193A,A01,083224,Rotar; Vladimir,8,0,34,26
1657338261661,MATH 193A,A02,083225,Rotar; Vladimir,7,0,34,27
1657338261661,MATH 193A,A03,083781,Rotar; Vladimir,3,0,34,31
1657338261661,MATH 193A,A04,083782,Rotar; Vladimir,9,0,34,25
1657338261661,MATH 193A,A05,093482,Rotar; Vladimir,10,0,34,24
1657338267686,MATH 197,001,091859,McAuley; Julian John,9999,0,9999,0
1657338267686,MATH 197,002,095566,Kedlaya; Kiran S.,9997,0,9999,2
1657338267686,MATH 197,003,095567,Xiao; Ming,9999,0,9999,0
1657338267686,MATH 197,004,095571,Perols; Johan Lars,9998,0,9999,1
1657338274736,COGS 9,A01,083615,Shannon; Kyle Michael,8,0,75,67
1657338280758,COGS 11,A01,083617,Boyle; Mary E. T.,22,0,48,26
1657338286787,COGS 13,A01,083071,Bastos; Amalia Pinkusfeld,11,0,71,60
1657338292811,COGS 14A,A01,092681,Semenuks; Arturs,3,1,100,97
1657338298839,COGS 14B,A01,083073,Cheng; Tzu-Han,6,0,63,57
1657338304865,COGS 17,A01,092677,Semenuks; Arturs,6,0,81,75
1657338310892,COGS 100,A01,083619,Allen; Michael Gordon,16,0,70,54
1657338316915,COGS 101A,A01,083621,Davis; Joshua Daniel,9,0,68,59
1657338322939,COGS 101B,A01,091572,Allen; Michael Gordon,11,0,65,54
1657338328966,COGS 101C,A01,083625,Delgado; Tania,17,0,35,18
1657338334988,COGS 107A,A01,083627,Boyle; Mary E. T.,13,0,60,47
1657338341010,COGS 118A,A01,083075,Gupta; Anjum,20,0,76,56
1657338347036,CSE 3,A50,083646,Miranda; Gregory Joseph,24,0,50,26
1657338353061,CSE 8A,A50,083650,Miranda; Gregory Joseph,17,1,56,39
1657338359084,CSE 11,A01,083080,Cao; Yingjun,6,15,40,34
1657338365111,CSE 12,A01,083652,Krause-Levy; Sophia Louisa,28,1,120,92
1657338371139,CSE 15L,A01,083654,Morris; Justin Loren,9,0,50,41
1657338371139,CSE 15L,A02,083655,Morris; Justin Loren,9,0,50,41
1657338377163,CSE 20,A01,083657,Tran; Khoa Dang,39,0,80,41
1657338383190,CSE 21,A01,095574,Bach; Quang Tran,22,0,48,26
1657338389214,CSE 30,A01,083084,Eldon; John,4,0,80,76
1657338389214,CSE 30,B01,095061,Bhaskar; Nishant,9,0,50,41
1657338395237,CSE 100,A01,083659,Cao; Yingjun,4,4,70,66
1657338401264,CSE 134B,A01,083661,Powell; Thomas Allan,22,0,100,78
1657338407294,CSE 140,A01,083663,Gungor; Onat,14,0,85,71
1657338413322,CSE 140L,A01,083088,Eldon; John,21,0,100,79
1657338419348,CSE 175,A01,083665,Kumar; Rakesh,3,0,25,22
1657338425370,CSE 190,A00,092507,Dubnov; Shlomo,7,0,20,13
1657338431391,ECE 45,A01,083139,Congero; Spencer William,6,0,75,69
1657338437416,ECE 65,A50,083695,Saad; Andrew S,12,0,30,18
1657338437416,ECE 65,A51,095125,Saad; Andrew S,24,0,26,2
1657338443455,ECE 109,A01,091882,Touri; Behrouz,19,0,70,51
1657338449476,ECE 180,A00,083140,Abi Samra; Nicholas Camill,1,0,30,29
1657338449476,ECE 180,B00,083141,Abi Samra; Nicholas Camill,0,0,30,30
1657338455499,MATH 10A,A01,083735,Patchell; Gregory David,2,0,30,28
1657338455499,MATH 10A,A02,083736,Patchell; Gregory David,20,0,30,10
1657338455499,MATH 10A,A03,083737,Patchell; Gregory David,16,0,30,14
1657338461526,MATH 10B,A01,083207,Lim; Seonhee,7,0,34,27
1657338461526,MATH 10B,A02,083208,Lim; Seonhee,9,0,35,26
1657338461526,MATH 10B,A03,093472,Lim; Seonhee,7,0,34,27
1657338461526,MATH 10B,B01,083739,Sinha; Shubham,12,0,30,18
1657338467556,MATH 18,A01,083743,Cinel; Cameron Alexander,7,0,30,23
1657338467556,MATH 18,A02,083744,Cinel; Cameron Alexander,17,0,30,13
1657338467556,MATH 18,A03,083745,Cinel; Cameron Alexander,9,0,30,21
1657338467556,MATH 18,B01,083748,Rideout; David Porter,5,0,37,32
1657338467556,MATH 18,B02,083749,Rideout; David Porter,5,0,36,31
1657338467556,MATH 18,B03,083750,Rideout; David Porter,3,0,37,34
1657338467556,MATH 18,B04,083751,Rideout; David Porter,6,0,36,30
1657338467556,MATH 18,B05,093473,Rideout; David Porter,6,0,36,30
1657338467556,MATH 18,B06,093474,Rideout; David Porter,6,0,36,30
1657338473579,MATH 20A,A01,083754,Zheng; Zequn,14,0,40,26
1657338479606,MATH 20B,A01,083756,Briones; Jor-el Thomas Caparas,4,0,36,32
1657338479606,MATH 20B,A02,083757,Briones; Jor-el Thomas Caparas,1,0,36,35
1657338479606,MATH 20B,A03,093475,Briones; Jor-el Thomas Caparas,2,0,36,34
1657338485630,MATH 20C,A01,083760,Briones; Jor-el Thomas Caparas,1,0,35,34
1657338485630,MATH 20C,A02,083761,Briones; Jor-el Thomas Caparas,8,0,35,27
1657338485630,MATH 20C,A03,093476,Briones; Jor-el Thomas Caparas,0,1,36,36
1657338485630,MATH 20C,B01,083762,Bach; Quang Tran,1,0,30,29
1657338491654,MATH 20D,A01,083765,Tran; Brian Kha,5,0,30,25
1657338491654,MATH 20D,A02,083766,Tran; Brian Kha,5,0,30,25
1657338491654,MATH 20D,A03,083767,Tran; Brian Kha,4,0,30,26
1657338497681,MATH 20E,A01,083771,Ganguly; Soumya,9,0,32,23
1657338497681,MATH 20E,A02,083772,Ganguly; Soumya,6,0,32,26
1657338497681,MATH 20E,B01,083773,Ciotti; Benjamin,20,0,35,15
1657338497681,MATH 20E,B02,083774,Ciotti; Benjamin,17,0,35,18
1657338503708,MATH 103A,A01,083777,Greenfeld; Be'Eri,3,0,36,33
1657338503708,MATH 103A,A02,083778,Greenfeld; Be'Eri,5,0,36,31
1657338503708,MATH 103A,A03,093561,Greenfeld; Be'Eri,4,0,36,32
1657338503708,MATH 103A,B01,083779,Greenfeld; Be'Eri,6,0,36,30
1657338503708,MATH 103A,B02,083780,Greenfeld; Be'Eri,4,0,36,32
1657338503708,MATH 103A,B03,093562,Greenfeld; Be'Eri,3,0,36,33
1657338509735,MATH 105,A01,085443,Carter; Anne Toulson,15,0,35,20
1657338509735,MATH 105,A02,093477,Carter; Anne Toulson,20,0,35,15
1657338515767,MATH 109,A01,083213,Ganzberger; Geoffrey Michael,2,0,34,32
1657338515767,MATH 109,A02,083214,Ganzberger; Geoffrey Michael,4,0,34,30
1657338515767,MATH 109,A03,093478,Ganzberger; Geoffrey Michael,2,0,34,32
1657338515767,MATH 109,B01,083215,Ganzberger; Geoffrey Michael,1,0,32,31
1657338515767,MATH 109,B02,083216,Ganzberger; Geoffrey Michael,1,0,32,31
1657338515767,MATH 109,B03,093479,Ganzberger; Geoffrey Michael,8,0,32,24
1657338521795,MATH 142A,A01,083219,Chow; Bennett,7,0,32,25
1657338521795,MATH 142A,A02,083220,Chow; Bennett,10,0,32,22
1657338521795,MATH 142A,A03,093480,Chow; Bennett,7,0,32,25
1657338521795,MATH 142A,B03,093481,Chow; Bennett,8,0,32,24
1657338521795,MATH 142A,B04,093558,Chow; Bennett,13,0,32,19
1657338521795,MATH 142A,B05,093559,Chow; Bennett,6,0,32,26
1657338527818,MATH 193A,A01,083224,Rotar; Vladimir,8,0,34,26
1657338527818,MATH 193A,A02,083225,Rotar; Vladimir,8,0,34,26
1657338527818,MATH 193A,A03,083781,Rotar; Vladimir,3,0,34,31
1657338527818,MATH 193A,A04,083782,Rotar; Vladimir,9,0,34,25
1657338527818,MATH 193A,A05,093482,Rotar; Vladimir,10,0,34,24
1657338533840,MATH 197,001,091859,McAuley; Julian John,9999,0,9999,0
1657338533840,MATH 197,002,095566,Kedlaya; Kiran S.,9997,0,9999,2
1657338533840,MATH 197,003,095567,Xiao; Ming,9999,0,9999,0
1657338533840,MATH 197,004,095571,Perols; Johan Lars,9998,0,9999,1
1657338540897,COGS 9,A01,083615,Shannon; Kyle Michael,8,0,75,67
1657338546925,COGS 11,A01,083617,Boyle; Mary E. T.,22,0,48,26
1657338552950,COGS 13,A01,083071,Bastos; Amalia Pinkusfeld,11,0,71,60
1657338558983,COGS 14A,A01,092681,Semenuks; Arturs,3,1,100,97
1657338565007,COGS 14B,A01,083073,Cheng; Tzu-Han,6,0,63,57
1657338571031,COGS 17,A01,092677,Semenuks; Arturs,6,0,81,75
1657338577061,COGS 100,A01,083619,Allen; Michael Gordon,16,0,70,54
1657338583084,COGS 101A,A01,083621,Davis; Joshua Daniel,9,0,68,59
1657338589107,COGS 101B,A01,091572,Allen; Michael Gordon,11,0,65,54
1657338595134,COGS 101C,A01,083625,Delgado; Tania,17,0,35,18
1657338601165,COGS 107A,A01,083627,Boyle; Mary E. T.,13,0,60,47
1657338607188,COGS 118A,A01,083075,Gupta; Anjum,20,0,76,56
1657338613210,CSE 3,A50,083646,Miranda; Gregory Joseph,24,0,50,26
1657338619235,CSE 8A,A50,083650,Miranda; Gregory Joseph,17,1,56,39
1657338625257,CSE 11,A01,083080,Cao; Yingjun,6,15,40,34
1657338631283,CSE 12,A01,083652,Krause-Levy; Sophia Louisa,28,1,120,92
1657338637396,CSE 15L,A01,083654,Morris; Justin Loren,9,0,50,41
1657338637396,CSE 15L,A02,083655,Morris; Justin Loren,9,0,50,41
1657338643431,CSE 20,A01,083657,Tran; Khoa Dang,39,0,80,41
1657338649456,CSE 21,A01,095574,Bach; Quang Tran,22,0,48,26
1657338655477,CSE 30,A01,083084,Eldon; John,4,0,80,76
1657338655477,CSE 30,B01,095061,Bhaskar; Nishant,9,0,50,41
1657338661501,CSE 100,A01,083659,Cao; Yingjun,4,4,70,66
1657338667528,CSE 134B,A01,083661,Powell; Thomas Allan,22,0,100,78
1657338673555,CSE 140,A01,083663,Gungor; Onat,14,0,85,71
1657338679579,CSE 140L,A01,083088,Eldon; John,21,0,100,79
1657338685608,CSE 175,A01,083665,Kumar; Rakesh,3,0,25,22
1657338691634,CSE 190,A00,092507,Dubnov; Shlomo,7,0,20,13
1657338697669,ECE 45,A01,083139,Congero; Spencer William,6,0,75,69
1657338703690,ECE 65,A50,083695,Saad; Andrew S,12,0,30,18
1657338703690,ECE 65,A51,095125,Saad; Andrew S,24,0,26,2
1657338709722,ECE 109,A01,091882,Touri; Behrouz,19,0,70,51
1657338715752,ECE 180,A00,083140,Abi Samra; Nicholas Camill,1,0,30,29
1657338715752,ECE 180,B00,083141,Abi Samra; Nicholas Camill,0,0,30,30
1657338721786,MATH 10A,A01,083735,Patchell; Gregory David,2,0,30,28
1657338721786,MATH 10A,A02,083736,Patchell; Gregory David,20,0,30,10
1657338721786,MATH 10A,A03,083737,Patchell; Gregory David,16,0,30,14
1657338727813,MATH 10B,A01,083207,Lim; Seonhee,7,0,34,27
1657338727813,MATH 10B,A02,083208,Lim; Seonhee,9,0,35,26
1657338727813,MATH 10B,A03,093472,Lim; Seonhee,7,0,34,27
1657338727813,MATH 10B,B01,083739,Sinha; Shubham,12,0,30,18
1657338733837,MATH 18,A01,083743,Cinel; Cameron Alexander,7,0,30,23
1657338733837,MATH 18,A02,083744,Cinel; Cameron Alexander,17,0,30,13
1657338733837,MATH 18,A03,083745,Cinel; Cameron Alexander,9,0,30,21
1657338733837,MATH 18,B01,083748,Rideout; David Porter,5,0,37,32
1657338733837,MATH 18,B02,083749,Rideout; David Porter,5,0,36,31
1657338733837,MATH 18,B03,083750,Rideout; David Porter,3,0,37,34
1657338733837,MATH 18,B04,083751,Rideout; David Porter,6,0,36,30
1657338733837,MATH 18,B05,093473,Rideout; David Porter,6,0,36,30
1657338733837,MATH 18,B06,093474,Rideout; David Porter,6,0,36,30
1657338739863,MATH 20A,A01,083754,Zheng; Zequn,14,0,40,26
1657338745887,MATH 20B,A01,083756,Briones; Jor-el Thomas Caparas,4,0,36,32
1657338745887,MATH 20B,A02,083757,Briones; Jor-el Thomas Caparas,1,0,36,35
1657338745887,MATH 20B,A03,093475,Briones; Jor-el Thomas Caparas,2,0,36,34
1657338751924,MATH 20C,A01,083760,Briones; Jor-el Thomas Caparas,1,0,35,34
1657338751924,MATH 20C,A02,083761,Briones; Jor-el Thomas Caparas,8,0,35,27
1657338751924,MATH 20C,A03,093476,Briones; Jor-el Thomas Caparas,0,1,36,36
1657338751924,MATH 20C,B01,083762,Bach; Quang Tran,1,0,30,29
1657338757946,MATH 20D,A01,083765,Tran; Brian Kha,5,0,30,25
1657338757946,MATH 20D,A02,083766,Tran; Brian Kha,5,0,30,25
1657338757946,MATH 20D,A03,083767,Tran; Brian Kha,4,0,30,26
1657338763982,MATH 20E,A01,083771,Ganguly; Soumya,9,0,32,23
1657338763982,MATH 20E,A02,083772,Ganguly; Soumya,6,0,32,26
1657338763982,MATH 20E,B01,083773,Ciotti; Benjamin,20,0,35,15
1657338763982,MATH 20E,B02,083774,Ciotti; Benjamin,17,0,35,18
1657338770006,MATH 103A,A01,083777,Greenfeld; Be'Eri,3,0,36,33
1657338770006,MATH 103A,A02,083778,Greenfeld; Be'Eri,5,0,36,31
1657338770006,MATH 103A,A03,093561,Greenfeld; Be'Eri,4,0,36,32
1657338770006,MATH 103A,B01,083779,Greenfeld; Be'Eri,6,0,36,30
1657338770006,MATH 103A,B02,083780,Greenfeld; Be'Eri,4,0,36,32
1657338770006,MATH 103A,B03,093562,Greenfeld; Be'Eri,3,0,36,33
1657338776030,MATH 105,A01,085443,Carter; Anne Toulson,15,0,35,20
1657338776030,MATH 105,A02,093477,Carter; Anne Toulson,20,0,35,15
1657338782053,MATH 109,A01,083213,Ganzberger; Geoffrey Michael,2,0,34,32
1657338782053,MATH 109,A02,083214,Ganzberger; Geoffrey Michael,4,0,34,30
1657338782053,MATH 109,A03,093478,Ganzberger; Geoffrey Michael,2,0,34,32
1657338782053,MATH 109,B01,083215,Ganzberger; Geoffrey Michael,1,0,32,31
1657338782053,MATH 109,B02,083216,Ganzberger; Geoffrey Michael,1,0,32,31
1657338782053,MATH 109,B03,093479,Ganzberger; Geoffrey Michael,8,0,32,24
1657338788090,MATH 142A,A01,083219,Chow; Bennett,7,0,32,25
1657338788090,MATH 142A,A02,083220,Chow; Bennett,10,0,32,22
1657338788090,MATH 142A,A03,093480,Chow; Bennett,7,0,32,25
1657338788090,MATH 142A,B03,093481,Chow; Bennett,8,0,32,24
1657338788090,MATH 142A,B04,093558,Chow; Bennett,13,0,32,19
1657338788090,MATH 142A,B05,093559,Chow; Bennett,6,0,32,26
1657338794112,MATH 193A,A01,083224,Rotar; Vladimir,8,0,34,26
1657338794112,MATH 193A,A02,083225,Rotar; Vladimir,8,0,34,26
1657338794112,MATH 193A,A03,083781,Rotar; Vladimir,3,0,34,31
1657338794112,MATH 193A,A04,083782,Rotar; Vladimir,9,0,34,25
1657338794112,MATH 193A,A05,093482,Rotar; Vladimir,10,0,34,24
1657338800138,MATH 197,001,091859,McAuley; Julian John,9999,0,9999,0
1657338800138,MATH 197,002,095566,Kedlaya; Kiran S.,9997,0,9999,2
1657338800138,MATH 197,003,095567,Xiao; Ming,9999,0,9999,0
1657338800138,MATH 197,004,095571,Perols; Johan Lars,9998,0,9999,1
1657338807184,COGS 9,A01,083615,Shannon; Kyle Michael,8,0,75,67
1657338813207,COGS 11,A01,083617,Boyle; Mary E. T.,22,0,48,26
1657338819247,COGS 13,A01,083071,Bastos; Amalia Pinkusfeld,11,0,71,60
1657338825272,COGS 14A,A01,092681,Semenuks; Arturs,3,1,100,97
1657338831295,COGS 14B,A01,083073,Cheng; Tzu-Han,6,0,63,57
1657338837321,COGS 17,A01,092677,Semenuks; Arturs,6,0,81,75
1657338843348,COGS 100,A01,083619,Allen; Michael Gordon,16,0,70,54
1657338849371,COGS 101A,A01,083621,Davis; Joshua Daniel,9,0,68,59
1657338855398,COGS 101B,A01,091572,Allen; Michael Gordon,11,0,65,54
1657338861420,COGS 101C,A01,083625,Delgado; Tania,17,0,35,18
1657338867451,COGS 107A,A01,083627,Boyle; Mary E. T.,13,0,60,47
1657338873484,COGS 118A,A01,083075,Gupta; Anjum,20,0,76,56
1657338879507,CSE 3,A50,083646,Miranda; Gregory Joseph,24,0,50,26
1657338885534,CSE 8A,A50,083650,Miranda; Gregory Joseph,17,1,56,39
1657338891569,CSE 11,A01,083080,Cao; Yingjun,6,15,40,34
1657338897591,CSE 12,A01,083652,Krause-Levy; Sophia Louisa,28,1,120,92
1657338903625,CSE 15L,A01,083654,Morris; Justin Loren,9,0,50,41
1657338903625,CSE 15L,A02,083655,Morris; Justin Loren,9,0,50,41
1657338909652,CSE 20,A01,083657,Tran; Khoa Dang,39,0,80,41
1657338915679,CSE 21,A01,095574,Bach; Quang Tran,22,0,48,26
1657338921707,CSE 30,A01,083084,Eldon; John,4,0,80,76
1657338921707,CSE 30,B01,095061,Bhaskar; Nishant,9,0,50,41
1657338927730,CSE 100,A01,083659,Cao; Yingjun,4,4,70,66
1657338933755,CSE 134B,A01,083661,Powell; Thomas Allan,22,0,100,78
1657338939778,CSE 140,A01,083663,Gungor; Onat,14,0,85,71
1657338945805,CSE 140L,A01,083088,Eldon; John,21,0,100,79
1657338951826,CSE 175,A01,083665,Kumar; Rakesh,3,0,25,22
1657338957849,CSE 190,A00,092507,Dubnov; Shlomo,7,0,20,13
1657338963876,ECE 45,A01,083139,Congero; Spencer William,6,0,75,69
1657338969900,ECE 65,A50,083695,Saad; Andrew S,12,0,30,18
1657338969900,ECE 65,A51,095125,Saad; Andrew S,24,0,26,2
1657338975927,ECE 109,A01,091882,Touri; Behrouz,19,0,70,51
1657338981953,ECE 180,A00,083140,Abi Samra; Nicholas Camill,1,0,30,29
1657338981953,ECE 180,B00,083141,Abi Samra; Nicholas Camill,0,0,30,30
1657338987977,MATH 10A,A01,083735,Patchell; Gregory David,2,0,30,28
1657338987977,MATH 10A,A02,083736,Patchell; Gregory David,20,0,30,10
1657338987977,MATH 10A,A03,083737,Patchell; Gregory David,16,0,30,14
1657338994000,MATH 10B,A01,083207,Lim; Seonhee,7,0,34,27
1657338994000,MATH 10B,A02,083208,Lim; Seonhee,9,0,35,26
1657338994000,MATH 10B,A03,093472,Lim; Seonhee,7,0,34,27
1657338994000,MATH 10B,B01,083739,Sinha; Shubham,12,0,30,18
1657339000040,MATH 18,A01,083743,Cinel; Cameron Alexander,7,0,30,23
1657339000040,MATH 18,A02,083744,Cinel; Cameron Alexander,17,0,30,13
1657339000040,MATH 18,A03,083745,Cinel; Cameron Alexander,9,0,30,21
1657339000040,MATH 18,B01,083748,Rideout; David Porter,5,0,37,32
1657339000040,MATH 18,B02,083749,Rideout; David Porter,5,0,36,31
1657339000040,MATH 18,B03,083750,Rideout; David Porter,3,0,37,34
1657339000040,MATH 18,B04,083751,Rideout; David Porter,6,0,36,30
1657339000040,MATH 18,B05,093473,Rideout; David Porter,6,0,36,30
1657339000040,MATH 18,B06,093474,Rideout; David Porter,6,0,36,30
1657339006061,MATH 20A,A01,083754,Zheng; Zequn,14,0,40,26
1657339012092,MATH 20B,A01,083756,Briones; Jor-el Thomas Caparas,4,0,36,32
1657339012092,MATH 20B,A02,083757,Briones; Jor-el Thomas Caparas,1,0,36,35
1657339012092,MATH 20B,A03,093475,Briones; Jor-el Thomas Caparas,2,0,36,34
1657339018116,MATH 20C,A01,083760,Briones; Jor-el Thomas Caparas,1,0,35,34
1657339018116,MATH 20C,A02,083761,Briones; Jor-el Thomas Caparas,8,0,35,27
1657339018116,MATH 20C,A03,093476,Briones; Jor-el Thomas Caparas,0,1,36,36
1657339018116,MATH 20C,B01,083762,Bach; Quang Tran,1,0,30,29
1657339024143,MATH 20D,A01,083765,Tran; Brian Kha,5,0,30,25
1657339024143,MATH 20D,A02,083766,Tran; Brian Kha,5,0,30,25
1657339024143,MATH 20D,A03,083767,Tran; Brian Kha,4,0,30,26
1657339030167,MATH 20E,A01,083771,Ganguly; Soumya,9,0,32,23
1657339030167,MATH 20E,A02,083772,Ganguly; Soumya,6,0,32,26
1657339030167,MATH 20E,B01,083773,Ciotti; Benjamin,20,0,35,15
1657339030167,MATH 20E,B02,083774,Ciotti; Benjamin,17,0,35,18
1657339036191,MATH 103A,A01,083777,Greenfeld; Be'Eri,3,0,36,33
1657339036191,MATH 103A,A02,083778,Greenfeld; Be'Eri,5,0,36,31
1657339036191,MATH 103A,A03,093561,Greenfeld; Be'Eri,4,0,36,32
1657339036191,MATH 103A,B01,083779,Greenfeld; Be'Eri,6,0,36,30
1657339036191,MATH 103A,B02,083780,Greenfeld; Be'Eri,4,0,36,32
1657339036191,MATH 103A,B03,093562,Greenfeld; Be'Eri,3,0,36,33
1657339042219,MATH 105,A01,085443,Carter; Anne Toulson,15,0,35,20
1657339042219,MATH 105,A02,093477,Carter; Anne Toulson,20,0,35,15
1657339048244,MATH 109,A01,083213,Ganzberger; Geoffrey Michael,2,0,34,32
1657339048244,MATH 109,A02,083214,Ganzberger; Geoffrey Michael,4,0,34,30
1657339048244,MATH 109,A03,093478,Ganzberger; Geoffrey Michael,2,0,34,32
1657339048244,MATH 109,B01,083215,Ganzberger; Geoffrey Michael,1,0,32,31
1657339048244,MATH 109,B02,083216,Ganzberger; Geoffrey Michael,1,0,32,31
1657339048244,MATH 109,B03,093479,Ganzberger; Geoffrey Michael,8,0,32,24
1657339054282,MATH 142A,A01,083219,Chow; Bennett,7,0,32,25
1657339054282,MATH 142A,A02,083220,Chow; Bennett,10,0,32,22
1657339054282,MATH 142A,A03,093480,Chow; Bennett,7,0,32,25
1657339054282,MATH 142A,B03,093481,Chow; Bennett,8,0,32,24
1657339054282,MATH 142A,B04,093558,Chow; Bennett,13,0,32,19
1657339054282,MATH 142A,B05,093559,Chow; Bennett,6,0,32,26
1657339060304,MATH 193A,A01,083224,Rotar; Vladimir,8,0,34,26
1657339060304,MATH 193A,A02,083225,Rotar; Vladimir,8,0,34,26
1657339060304,MATH 193A,A03,083781,Rotar; Vladimir,3,0,34,31
1657339060304,MATH 193A,A04,083782,Rotar; Vladimir,9,0,34,25
1657339060304,MATH 193A,A05,093482,Rotar; Vladimir,10,0,34,24
1657339066327,MATH 197,001,091859,McAuley; Julian John,9999,0,9999,0
1657339066327,MATH 197,002,095566,Kedlaya; Kiran S.,9997,0,9999,2
1657339066327,MATH 197,003,095567,Xiao; Ming,9999,0,9999,0
1657339066327,MATH 197,004,095571,Perols; Johan Lars,9998,0,9999,1
1657339073393,COGS 9,A01,083615,Shannon; Kyle Michael,8,0,75,67
1657339079414,COGS 11,A01,083617,Boyle; Mary E. T.,22,0,48,26
1657339085441,COGS 13,A01,083071,Bastos; Amalia Pinkusfeld,11,0,71,60
1657339091464,COGS 14A,A01,092681,Semenuks; Arturs,3,1,100,97
1657339097487,COGS 14B,A01,083073,Cheng; Tzu-Han,6,0,63,57
1657339103509,COGS 17,A01,092677,Semenuks; Arturs,6,0,81,75
1657339109531,COGS 100,A01,083619,Allen; Michael Gordon,16,0,70,54
1657339115553,COGS 101A,A01,083621,Davis; Joshua Daniel,9,0,68,59
1657339121578,COGS 101B,A01,091572,Allen; Michael Gordon,11,0,65,54
1657339127604,COGS 101C,A01,083625,Delgado; Tania,17,0,35,18
1657339133628,COGS 107A,A01,083627,Boyle; Mary E. T.,13,0,60,47
1657339139654,COGS 118A,A01,083075,Gupta; Anjum,20,0,76,56
1657339145681,CSE 3,A50,083646,Miranda; Gregory Joseph,24,0,50,26
1657339151705,CSE 8A,A50,083650,Miranda; Gregory Joseph,17,1,56,39
1657339157728,CSE 11,A01,083080,Cao; Yingjun,6,15,40,34
1657339163757,CSE 12,A01,083652,Krause-Levy; Sophia Louisa,28,1,120,92
1657339169779,CSE 15L,A01,083654,Morris; Justin Loren,9,0,50,41
1657339169779,CSE 15L,A02,083655,Morris; Justin Loren,9,0,50,41
1657339175803,CSE 20,A01,083657,Tran; Khoa Dang,39,0,80,41
1657339181826,CSE 21,A01,095574,Bach; Quang Tran,22,0,48,26
1657339187852,CSE 30,A01,083084,Eldon; John,4,0,80,76
1657339187852,CSE 30,B01,095061,Bhaskar; Nishant,9,0,50,41
1657339193880,CSE 100,A01,083659,Cao; Yingjun,4,4,70,66
1657339199906,CSE 134B,A01,083661,Powell; Thomas Allan,22,0,100,78
1657339205933,CSE 140,A01,083663,Gungor; Onat,14,0,85,71
1657339211959,CSE 140L,A01,083088,Eldon; John,21,0,100,79
1657339217984,CSE 175,A01,083665,Kumar; Rakesh,3,0,25,22
1657339224010,CSE 190,A00,092507,Dubnov; Shlomo,7,0,20,13
1657339230037,ECE 45,A01,083139,Congero; Spencer William,6,0,75,69
1657339236189,ECE 65,A50,083695,Saad; Andrew S,12,0,30,18
1657339236189,ECE 65,A51,095125,Saad; Andrew S,24,0,26,2
1657339242220,ECE 109,A01,091882,Touri; Behrouz,19,0,70,51
1657339248247,ECE 180,A00,083140,Abi Samra; Nicholas Camill,1,0,30,29
1657339248247,ECE 180,B00,083141,Abi Samra; Nicholas Camill,0,0,30,30
1657339254273,MATH 10A,A01,083735,Patchell; Gregory David,2,0,30,28
1657339254273,MATH 10A,A02,083736,Patchell; Gregory David,20,0,30,10
1657339254273,MATH 10A,A03,083737,Patchell; Gregory David,16,0,30,14
1657339260297,MATH 10B,A01,083207,Lim; Seonhee,7,0,34,27
1657339260297,MATH 10B,A02,083208,Lim; Seonhee,9,0,35,26
1657339260297,MATH 10B,A03,093472,Lim; Seonhee,7,0,34,27
1657339260297,MATH 10B,B01,083739,Sinha; Shubham,12,0,30,18
1657339266327,MATH 18,A01,083743,Cinel; Cameron Alexander,7,0,30,23
1657339266327,MATH 18,A02,083744,Cinel; Cameron Alexander,17,0,30,13
1657339266327,MATH 18,A03,083745,Cinel; Cameron Alexander,9,0,30,21
1657339266327,MATH 18,B01,083748,Rideout; David Porter,5,0,37,32
1657339266327,MATH 18,B02,083749,Rideout; David Porter,5,0,36,31
1657339266327,MATH 18,B03,083750,Rideout; David Porter,3,0,37,34
1657339266327,MATH 18,B04,083751,Rideout; David Porter,6,0,36,30
1657339266327,MATH 18,B05,093473,Rideout; David Porter,6,0,36,30
1657339266327,MATH 18,B06,093474,Rideout; David Porter,6,0,36,30
1657339272350,MATH 20A,A01,083754,Zheng; Zequn,14,0,40,26
1657339278371,MATH 20B,A01,083756,Briones; Jor-el Thomas Caparas,4,0,36,32
1657339278371,MATH 20B,A02,083757,Briones; Jor-el Thomas Caparas,1,0,36,35
1657339278371,MATH 20B,A03,093475,Briones; Jor-el Thomas Caparas,2,0,36,34
1657339284395,MATH 20C,A01,083760,Briones; Jor-el Thomas Caparas,1,0,35,34
1657339284395,MATH 20C,A02,083761,Briones; Jor-el Thomas Caparas,8,0,35,27
1657339284395,MATH 20C,A03,093476,Briones; Jor-el Thomas Caparas,0,1,36,36
1657339284395,MATH 20C,B01,083762,Bach; Quang Tran,1,0,30,29
1657339290419,MATH 20D,A01,083765,Tran; Brian Kha,5,0,30,25
1657339290419,MATH 20D,A02,083766,Tran; Brian Kha,5,0,30,25
1657339290419,MATH 20D,A03,083767,Tran; Brian Kha,4,0,30,26
1657339296447,MATH 20E,A01,083771,Ganguly; Soumya,9,0,32,23
1657339296447,MATH 20E,A02,083772,Ganguly; Soumya,6,0,32,26
1657339296447,MATH 20E,B01,083773,Ciotti; Benjamin,20,0,35,15
1657339296447,MATH 20E,B02,083774,Ciotti; Benjamin,17,0,35,18
1657339302471,MATH 103A,A01,083777,Greenfeld; Be'Eri,3,0,36,33
1657339302471,MATH 103A,A02,083778,Greenfeld; Be'Eri,5,0,36,31
1657339302471,MATH 103A,A03,093561,Greenfeld; Be'Eri,4,0,36,32
1657339302471,MATH 103A,B01,083779,Greenfeld; Be'Eri,6,0,36,30
1657339302471,MATH 103A,B02,083780,Greenfeld; Be'Eri,4,0,36,32
1657339302471,MATH 103A,B03,093562,Greenfeld; Be'Eri,3,0,36,33
1657339308497,MATH 105,A01,085443,Carter; Anne Toulson,15,0,35,20
1657339308497,MATH 105,A02,093477,Carter; Anne Toulson,20,0,35,15
1657339314521,MATH 109,A01,083213,Ganzberger; Geoffrey Michael,2,0,34,32
1657339314521,MATH 109,A02,083214,Ganzberger; Geoffrey Michael,4,0,34,30
1657339314521,MATH 109,A03,093478,Ganzberger; Geoffrey Michael,2,0,34,32
1657339314521,MATH 109,B01,083215,Ganzberger; Geoffrey Michael,1,0,32,31
1657339314521,MATH 109,B02,083216,Ganzberger; Geoffrey Michael,1,0,32,31
1657339314521,MATH 109,B03,093479,Ganzberger; Geoffrey Michael,8,0,32,24
1657339320550,MATH 142A,A01,083219,Chow; Bennett,7,0,32,25
1657339320550,MATH 142A,A02,083220,Chow; Bennett,10,0,32,22
1657339320550,MATH 142A,A03,093480,Chow; Bennett,7,0,32,25
1657339320550,MATH 142A,B03,093481,Chow; Bennett,8,0,32,24
1657339320550,MATH 142A,B04,093558,Chow; Bennett,13,0,32,19
1657339320550,MATH 142A,B05,093559,Chow; Bennett,6,0,32,26
1657339326580,MATH 193A,A01,083224,Rotar; Vladimir,8,0,34,26
1657339326580,MATH 193A,A02,083225,Rotar; Vladimir,8,0,34,26
1657339326580,MATH 193A,A03,083781,Rotar; Vladimir,3,0,34,31
1657339326580,MATH 193A,A04,083782,Rotar; Vladimir,9,0,34,25
1657339326580,MATH 193A,A05,093482,Rotar; Vladimir,10,0,34,24
1657339332604,MATH 197,001,091859,McAuley; Julian John,9999,0,9999,0
1657339332604,MATH 197,002,095566,Kedlaya; Kiran S.,9997,0,9999,2
1657339332604,MATH 197,003,095567,Xiao; Ming,9999,0,9999,0
1657339332604,MATH 197,004,095571,Perols; Johan Lars,9998,0,9999,1
1657339339667,COGS 9,A01,083615,Shannon; Kyle Michael,8,0,75,67
1657339345689,COGS 11,A01,083617,Boyle; Mary E. T.,22,0,48,26
1657339351711,COGS 13,A01,083071,Bastos; Amalia Pinkusfeld,11,0,71,60
1657339357736,COGS 14A,A01,092681,Semenuks; Arturs,3,1,100,97
1657339363763,COGS 14B,A01,083073,Cheng; Tzu-Han,6,0,63,57
1657339369788,COGS 17,A01,092677,Semenuks; Arturs,6,0,81,75
1657339375812,COGS 100,A01,083619,Allen; Michael Gordon,16,0,70,54
1657339381843,COGS 101A,A01,083621,Davis; Joshua Daniel,9,0,68,59
1657339387870,COGS 101B,A01,091572,Allen; Michael Gordon,11,0,65,54
1657339393897,COGS 101C,A01,083625,Delgado; Tania,17,0,35,18
1657339399919,COGS 107A,A01,083627,Boyle; Mary E. T.,13,0,60,47
1657339405940,COGS 118A,A01,083075,Gupta; Anjum,20,0,76,56
1657339411968,CSE 3,A50,083646,Miranda; Gregory Joseph,24,0,50,26
1657339417991,CSE 8A,A50,083650,Miranda; Gregory Joseph,17,1,56,39
1657339424018,CSE 11,A01,083080,Cao; Yingjun,6,15,40,34
1657339430042,CSE 12,A01,083652,Krause-Levy; Sophia Louisa,28,1,120,92
1657339436064,CSE 15L,A01,083654,Morris; Justin Loren,9,0,50,41
1657339436064,CSE 15L,A02,083655,Morris; Justin Loren,9,0,50,41
1657339442085,CSE 20,A01,083657,Tran; Khoa Dang,39,0,80,41
1657339448111,CSE 21,A01,095574,Bach; Quang Tran,22,0,48,26
1657339454137,CSE 30,A01,083084,Eldon; John,4,0,80,76
1657339454137,CSE 30,B01,095061,Bhaskar; Nishant,9,0,50,41
1657339460162,CSE 100,A01,083659,Cao; Yingjun,4,4,70,66
1657339466190,CSE 134B,A01,083661,Powell; Thomas Allan,22,0,100,78
1657339472212,CSE 140,A01,083663,Gungor; Onat,14,0,85,71
1657339478235,CSE 140L,A01,083088,Eldon; John,21,0,100,79
1657339484262,CSE 175,A01,083665,Kumar; Rakesh,3,0,25,22
1657339490285,CSE 190,A00,092507,Dubnov; Shlomo,7,0,20,13
1657339496308,ECE 45,A01,083139,Congero; Spencer William,6,0,75,69
1657339502338,ECE 65,A50,083695,Saad; Andrew S,12,0,30,18
1657339502338,ECE 65,A51,095125,Saad; Andrew S,24,0,26,2
1657339508360,ECE 109,A01,091882,Touri; Behrouz,19,0,70,51
1657339514386,ECE 180,A00,083140,Abi Samra; Nicholas Camill,1,0,30,29
1657339514386,ECE 180,B00,083141,Abi Samra; Nicholas Camill,0,0,30,30
1657339520415,MATH 10A,A01,083735,Patchell; Gregory David,2,0,30,28
1657339520415,MATH 10A,A02,083736,Patchell; Gregory David,20,0,30,10
1657339520415,MATH 10A,A03,083737,Patchell; Gregory David,16,0,30,14
1657339526445,MATH 10B,A01,083207,Lim; Seonhee,7,0,34,27
1657339526445,MATH 10B,A02,083208,Lim; Seonhee,9,0,35,26
1657339526445,MATH 10B,A03,093472,Lim; Seonhee,7,0,34,27
1657339526445,MATH 10B,B01,083739,Sinha; Shubham,12,0,30,18
1657339532476,MATH 18,A01,083743,Cinel; Cameron Alexander,7,0,30,23
1657339532476,MATH 18,A02,083744,Cinel; Cameron Alexander,17,0,30,13
1657339532476,MATH 18,A03,083745,Cinel; Cameron Alexander,9,0,30,21
1657339532476,MATH 18,B01,083748,Rideout; David Porter,5,0,37,32
1657339532476,MATH 18,B02,083749,Rideout; David Porter,5,0,36,31
1657339532476,MATH 18,B03,083750,Rideout; David Porter,3,0,37,34
1657339532476,MATH 18,B04,083751,Rideout; David Porter,6,0,36,30
1657339532476,MATH 18,B05,093473,Rideout; David Porter,6,0,36,30
1657339532476,MATH 18,B06,093474,Rideout; David Porter,6,0,36,30
1657339538511,MATH 20A,A01,083754,Zheng; Zequn,14,0,40,26
1657339544536,MATH 20B,A01,083756,Briones; Jor-el Thomas Caparas,4,0,36,32
1657339544536,MATH 20B,A02,083757,Briones; Jor-el Thomas Caparas,1,0,36,35
1657339544536,MATH 20B,A03,093475,Briones; Jor-el Thomas Caparas,2,0,36,34
1657339550559,MATH 20C,A01,083760,Briones; Jor-el Thomas Caparas,1,0,35,34
1657339550559,MATH 20C,A02,083761,Briones; Jor-el Thomas Caparas,8,0,35,27
1657339550559,MATH 20C,A03,093476,Briones; Jor-el Thomas Caparas,0,1,36,36
1657339550559,MATH 20C,B01,083762,Bach; Quang Tran,1,0,30,29
1657339556584,MATH 20D,A01,083765,Tran; Brian Kha,5,0,30,25
1657339556584,MATH 20D,A02,083766,Tran; Brian Kha,5,0,30,25
1657339556584,MATH 20D,A03,083767,Tran; Brian Kha,4,0,30,26
1657339562618,MATH 20E,A01,083771,Ganguly; Soumya,9,0,32,23
1657339562618,MATH 20E,A02,083772,Ganguly; Soumya,6,0,32,26
1657339562618,MATH 20E,B01,083773,Ciotti; Benjamin,20,0,35,15
1657339562618,MATH 20E,B02,083774,Ciotti; Benjamin,17,0,35,18
1657339568658,MATH 103A,A01,083777,Greenfeld; Be'Eri,3,0,36,33
1657339568658,MATH 103A,A02,083778,Greenfeld; Be'Eri,5,0,36,31
1657339568658,MATH 103A,A03,093561,Greenfeld; Be'Eri,4,0,36,32
1657339568658,MATH 103A,B01,083779,Greenfeld; Be'Eri,6,0,36,30
1657339568658,MATH 103A,B02,083780,Greenfeld; Be'Eri,4,0,36,32
1657339568658,MATH 103A,B03,093562,Greenfeld; Be'Eri,3,0,36,33
1657339574682,MATH 105,A01,085443,Carter; Anne Toulson,15,0,35,20
1657339574682,MATH 105,A02,093477,Carter; Anne Toulson,20,0,35,15
1657339580705,MATH 109,A01,083213,Ganzberger; Geoffrey Michael,2,0,34,32
1657339580705,MATH 109,A02,083214,Ganzberger; Geoffrey Michael,4,0,34,30
1657339580705,MATH 109,A03,093478,Ganzberger; Geoffrey Michael,2,0,34,32
1657339580705,MATH 109,B01,083215,Ganzberger; Geoffrey Michael,1,0,32,31
1657339580705,MATH 109,B02,083216,Ganzberger; Geoffrey Michael,1,0,32,31
1657339580705,MATH 109,B03,093479,Ganzberger; Geoffrey Michael,8,0,32,24
1657339586730,MATH 142A,A01,083219,Chow; Bennett,7,0,32,25
1657339586730,MATH 142A,A02,083220,Chow; Bennett,10,0,32,22
1657339586730,MATH 142A,A03,093480,Chow; Bennett,7,0,32,25
1657339586730,MATH 142A,B03,093481,Chow; Bennett,8,0,32,24
1657339586730,MATH 142A,B04,093558,Chow; Bennett,13,0,32,19
1657339586730,MATH 142A,B05,093559,Chow; Bennett,6,0,32,26
1657339592754,MATH 193A,A01,083224,Rotar; Vladimir,8,0,34,26
1657339592754,MATH 193A,A02,083225,Rotar; Vladimir,8,0,34,26
1657339592754,MATH 193A,A03,083781,Rotar; Vladimir,3,0,34,31
1657339592754,MATH 193A,A04,083782,Rotar; Vladimir,9,0,34,25
1657339592754,MATH 193A,A05,093482,Rotar; Vladimir,10,0,34,24
1657339598778,MATH 197,001,091859,McAuley; Julian John,9999,0,9999,0
1657339598778,MATH 197,002,095566,Kedlaya; Kiran S.,9997,0,9999,2
1657339598778,MATH 197,003,095567,Xiao; Ming,9999,0,9999,0
1657339598778,MATH 197,004,095571,Perols; Johan Lars,9998,0,9999,1
1657339605841,COGS 9,A01,083615,Shannon; Kyle Michael,8,0,75,67
1657339611892,COGS 11,A01,083617,Boyle; Mary E. T.,22,0,48,26
1657339617920,COGS 13,A01,083071,Bastos; Amalia Pinkusfeld,11,0,71,60
1657339623944,COGS 14A,A01,092681,Semenuks; Arturs,3,1,100,97
1657339629968,COGS 14B,A01,083073,Cheng; Tzu-Han,6,0,63,57
1657339635989,COGS 17,A01,092677,Semenuks; Arturs,6,0,81,75
1657339642014,COGS 100,A01,083619,Allen; Michael Gordon,16,0,70,54
1657339648038,COGS 101A,A01,083621,Davis; Joshua Daniel,9,0,68,59
1657339654066,COGS 101B,A01,091572,Allen; Michael Gordon,11,0,65,54
1657339660088,COGS 101C,A01,083625,Delgado; Tania,17,0,35,18
1657339666112,COGS 107A,A01,083627,Boyle; Mary E. T.,13,0,60,47
1657339672136,COGS 118A,A01,083075,Gupta; Anjum,20,0,76,56
1657339678160,CSE 3,A50,083646,Miranda; Gregory Joseph,24,0,50,26
1657339684188,CSE 8A,A50,083650,Miranda; Gregory Joseph,17,1,56,39
1657339690219,CSE 11,A01,083080,Cao; Yingjun,6,15,40,34
1657339696243,CSE 12,A01,083652,Krause-Levy; Sophia Louisa,28,1,120,92
1657339702267,CSE 15L,A01,083654,Morris; Justin Loren,9,0,50,41
1657339702267,CSE 15L,A02,083655,Morris; Justin Loren,9,0,50,41
1657339708298,CSE 20,A01,083657,Tran; Khoa Dang,39,0,80,41
1657339714321,CSE 21,A01,095574,Bach; Quang Tran,22,0,48,26
1657339720350,CSE 30,A01,083084,Eldon; John,4,0,80,76
1657339720350,CSE 30,B01,095061,Bhaskar; Nishant,9,0,50,41
1657339726375,CSE 100,A01,083659,Cao; Yingjun,4,4,70,66
1657339732401,CSE 134B,A01,083661,Powell; Thomas Allan,22,0,100,78
1657339738425,CSE 140,A01,083663,Gungor; Onat,14,0,85,71
1657339744455,CSE 140L,A01,083088,Eldon; John,21,0,100,79
1657339750476,CSE 175,A01,083665,Kumar; Rakesh,3,0,25,22
1657339756504,CSE 190,A00,092507,Dubnov; Shlomo,7,0,20,13
1657339762526,ECE 45,A01,083139,Congero; Spencer William,6,0,75,69
1657339768554,ECE 65,A50,083695,Saad; Andrew S,12,0,30,18
1657339768554,ECE 65,A51,095125,Saad; Andrew S,24,0,26,2
1657339774579,ECE 109,A01,091882,Touri; Behrouz,19,0,70,51
1657339780606,ECE 180,A00,083140,Abi Samra; Nicholas Camill,1,0,30,29
1657339780606,ECE 180,B00,083141,Abi Samra; Nicholas Camill,0,0,30,30
1657339786634,MATH 10A,A01,083735,Patchell; Gregory David,2,0,30,28
1657339786634,MATH 10A,A02,083736,Patchell; Gregory David,20,0,30,10
1657339786634,MATH 10A,A03,083737,Patchell; Gregory David,16,0,30,14
1657339792658,MATH 10B,A01,083207,Lim; Seonhee,7,0,34,27
1657339792658,MATH 10B,A02,083208,Lim; Seonhee,9,0,35,26
1657339792658,MATH 10B,A03,093472,Lim; Seonhee,7,0,34,27
1657339792658,MATH 10B,B01,083739,Sinha; Shubham,12,0,30,18
1657339798688,MATH 18,A01,083743,Cinel; Cameron Alexander,7,0,30,23
1657339798688,MATH 18,A02,083744,Cinel; Cameron Alexander,17,0,30,13
1657339798688,MATH 18,A03,083745,Cinel; Cameron Alexander,9,0,30,21
1657339798688,MATH 18,B01,083748,Rideout; David Porter,5,0,37,32
1657339798688,MATH 18,B02,083749,Rideout; David Porter,5,0,36,31
1657339798688,MATH 18,B03,083750,Rideout; David Porter,3,0,37,34
1657339798688,MATH 18,B04,083751,Rideout; David Porter,6,0,36,30
1657339798688,MATH 18,B05,093473,Rideout; David Porter,6,0,36,30
1657339798688,MATH 18,B06,093474,Rideout; David Porter,6,0,36,30
1657339804712,MATH 20A,A01,083754,Zheng; Zequn,14,0,40,26
1657339810738,MATH 20B,A01,083756,Briones; Jor-el Thomas Caparas,4,0,36,32
1657339810738,MATH 20B,A02,083757,Briones; Jor-el Thomas Caparas,1,0,36,35
1657339810738,MATH 20B,A03,093475,Briones; Jor-el Thomas Caparas,2,0,36,34
1657339816765,MATH 20C,A01,083760,Briones; Jor-el Thomas Caparas,1,0,35,34
1657339816765,MATH 20C,A02,083761,Briones; Jor-el Thomas Caparas,8,0,35,27
1657339816765,MATH 20C,A03,093476,Briones; Jor-el Thomas Caparas,0,1,36,36
1657339816765,MATH 20C,B01,083762,Bach; Quang Tran,1,0,30,29
1657339822792,MATH 20D,A01,083765,Tran; Brian Kha,5,0,30,25
1657339822792,MATH 20D,A02,083766,Tran; Brian Kha,5,0,30,25
1657339822792,MATH 20D,A03,083767,Tran; Brian Kha,4,0,30,26
1657339828820,MATH 20E,A01,083771,Ganguly; Soumya,9,0,32,23
1657339828820,MATH 20E,A02,083772,Ganguly; Soumya,6,0,32,26
1657339828820,MATH 20E,B01,083773,Ciotti; Benjamin,20,0,35,15
1657339828820,MATH 20E,B02,083774,Ciotti; Benjamin,17,0,35,18
1657339834941,MATH 103A,A01,083777,Greenfeld; Be'Eri,3,0,36,33
1657339834941,MATH 103A,A02,083778,Greenfeld; Be'Eri,5,0,36,31
1657339834941,MATH 103A,A03,093561,Greenfeld; Be'Eri,4,0,36,32
1657339834941,MATH 103A,B01,083779,Greenfeld; Be'Eri,6,0,36,30
1657339834941,MATH 103A,B02,083780,Greenfeld; Be'Eri,4,0,36,32
1657339834941,MATH 103A,B03,093562,Greenfeld; Be'Eri,3,0,36,33
1657339840969,MATH 105,A01,085443,Carter; Anne Toulson,15,0,35,20
1657339840969,MATH 105,A02,093477,Carter; Anne Toulson,20,0,35,15
1657339846993,MATH 109,A01,083213,Ganzberger; Geoffrey Michael,2,0,34,32
1657339846993,MATH 109,A02,083214,Ganzberger; Geoffrey Michael,4,0,34,30
1657339846993,MATH 109,A03,093478,Ganzberger; Geoffrey Michael,2,0,34,32
1657339846993,MATH 109,B01,083215,Ganzberger; Geoffrey Michael,1,0,32,31
1657339846993,MATH 109,B02,083216,Ganzberger; Geoffrey Michael,1,0,32,31
1657339846993,MATH 109,B03,093479,Ganzberger; Geoffrey Michael,8,0,32,24
1657339853016,MATH 142A,A01,083219,Chow; Bennett,7,0,32,25
1657339853016,MATH 142A,A02,083220,Chow; Bennett,10,0,32,22
1657339853016,MATH 142A,A03,093480,Chow; Bennett,7,0,32,25
1657339853016,MATH 142A,B03,093481,Chow; Bennett,8,0,32,24
1657339853016,MATH 142A,B04,093558,Chow; Bennett,13,0,32,19
1657339853016,MATH 142A,B05,093559,Chow; Bennett,6,0,32,26
1657339859041,MATH 193A,A01,083224,Rotar; Vladimir,8,0,34,26
1657339859041,MATH 193A,A02,083225,Rotar; Vladimir,8,0,34,26
1657339859041,MATH 193A,A03,083781,Rotar; Vladimir,3,0,34,31
1657339859041,MATH 193A,A04,083782,Rotar; Vladimir,9,0,34,25
1657339859041,MATH 193A,A05,093482,Rotar; Vladimir,10,0,34,24
1657339865069,MATH 197,001,091859,McAuley; Julian John,9999,0,9999,0
1657339865069,MATH 197,002,095566,Kedlaya; Kiran S.,9997,0,9999,2
1657339865069,MATH 197,003,095567,Xiao; Ming,9999,0,9999,0
1657339865069,MATH 197,004,095571,Perols; Johan Lars,9998,0,9999,1
1657339872118,COGS 9,A01,083615,Shannon; Kyle Michael,8,0,75,67
1657339878142,COGS 11,A01,083617,Boyle; Mary E. T.,22,0,48,26
1657339884165,COGS 13,A01,083071,Bastos; Amalia Pinkusfeld,11,0,71,60
1657339890191,COGS 14A,A01,092681,Semenuks; Arturs,3,1,100,97
1657339896213,COGS 14B,A01,083073,Cheng; Tzu-Han,6,0,63,57
1657339902237,COGS 17,A01,092677,Semenuks; Arturs,6,0,81,75
1657339908261,COGS 100,A01,083619,Allen; Michael Gordon,16,0,70,54
1657339914286,COGS 101A,A01,083621,Davis; Joshua Daniel,9,0,68,59
1657339920309,COGS 101B,A01,091572,Allen; Michael Gordon,11,0,65,54
1657339926332,COGS 101C,A01,083625,Delgado; Tania,17,0,35,18
1657339932357,COGS 107A,A01,083627,Boyle; Mary E. T.,13,0,60,47
1657339938383,COGS 118A,A01,083075,Gupta; Anjum,20,0,76,56
1657339944417,CSE 3,A50,083646,Miranda; Gregory Joseph,24,0,50,26
1657339950443,CSE 8A,A50,083650,Miranda; Gregory Joseph,17,1,56,39
1657339956470,CSE 11,A01,083080,Cao; Yingjun,6,15,40,34
1657339962496,CSE 12,A01,083652,Krause-Levy; Sophia Louisa,28,1,120,92
1657339968522,CSE 15L,A01,083654,Morris; Justin Loren,9,0,50,41
1657339968522,CSE 15L,A02,083655,Morris; Justin Loren,9,0,50,41
1657339974545,CSE 20,A01,083657,Tran; Khoa Dang,39,0,80,41
1657339980572,CSE 21,A01,095574,Bach; Quang Tran,22,0,48,26
1657339986595,CSE 30,A01,083084,Eldon; John,4,0,80,76
1657339986595,CSE 30,B01,095061,Bhaskar; Nishant,9,0,50,41
1657339992620,CSE 100,A01,083659,Cao; Yingjun,4,4,70,66
1657339998643,CSE 134B,A01,083661,Powell; Thomas Allan,22,0,100,78
1657340004669,CSE 140,A01,083663,Gungor; Onat,14,0,85,71
1657340010692,CSE 140L,A01,083088,Eldon; John,21,0,100,79
1657340016719,CSE 175,A01,083665,Kumar; Rakesh,3,0,25,22
1657340022741,CSE 190,A00,092507,Dubnov; Shlomo,7,0,20,13
1657340028765,ECE 45,A01,083139,Congero; Spencer William,6,0,75,69
1657340034789,ECE 65,A50,083695,Saad; Andrew S,12,0,30,18
1657340034789,ECE 65,A51,095125,Saad; Andrew S,24,0,26,2
1657340040815,ECE 109,A01,091882,Touri; Behrouz,19,0,70,51
1657340046839,ECE 180,A00,083140,Abi Samra; Nicholas Camill,1,0,30,29
1657340046839,ECE 180,B00,083141,Abi Samra; Nicholas Camill,0,0,30,30
1657340052863,MATH 10A,A01,083735,Patchell; Gregory David,2,0,30,28
1657340052863,MATH 10A,A02,083736,Patchell; Gregory David,20,0,30,10
1657340052863,MATH 10A,A03,083737,Patchell; Gregory David,16,0,30,14
1657340058888,MATH 10B,A01,083207,Lim; Seonhee,7,0,34,27
1657340058888,MATH 10B,A02,083208,Lim; Seonhee,9,0,35,26
1657340058888,MATH 10B,A03,093472,Lim; Seonhee,7,0,34,27
1657340058888,MATH 10B,B01,083739,Sinha; Shubham,12,0,30,18
1657340064914,MATH 18,A01,083743,Cinel; Cameron Alexander,7,0,30,23
1657340064914,MATH 18,A02,083744,Cinel; Cameron Alexander,17,0,30,13
1657340064914,MATH 18,A03,083745,Cinel; Cameron Alexander,9,0,30,21
1657340064914,MATH 18,B01,083748,Rideout; David Porter,5,0,37,32
1657340064914,MATH 18,B02,083749,Rideout; David Porter,5,0,36,31
1657340064914,MATH 18,B03,083750,Rideout; David Porter,3,0,37,34
1657340064914,MATH 18,B04,083751,Rideout; David Porter,6,0,36,30
1657340064914,MATH 18,B05,093473,Rideout; David Porter,6,0,36,30
1657340064914,MATH 18,B06,093474,Rideout; David Porter,6,0,36,30
1657340070937,MATH 20A,A01,083754,Zheng; Zequn,14,0,40,26
1657340076968,MATH 20B,A01,083756,Briones; Jor-el Thomas Caparas,4,0,36,32
1657340076968,MATH 20B,A02,083757,Briones; Jor-el Thomas Caparas,1,0,36,35
1657340076968,MATH 20B,A03,093475,Briones; Jor-el Thomas Caparas,2,0,36,34
1657340083005,MATH 20C,A01,083760,Briones; Jor-el Thomas Caparas,1,0,35,34
1657340083005,MATH 20C,A02,083761,Briones; Jor-el Thomas Caparas,8,0,35,27
1657340083005,MATH 20C,A03,093476,Briones; Jor-el Thomas Caparas,0,1,36,36
1657340083005,MATH 20C,B01,083762,Bach; Quang Tran,1,0,30,29
1657340089032,MATH 20D,A01,083765,Tran; Brian Kha,5,0,30,25
1657340089032,MATH 20D,A02,083766,Tran; Brian Kha,5,0,30,25
1657340089032,MATH 20D,A03,083767,Tran; Brian Kha,4,0,30,26
1657340095055,MATH 20E,A01,083771,Ganguly; Soumya,9,0,32,23
1657340095055,MATH 20E,A02,083772,Ganguly; Soumya,6,0,32,26
1657340095055,MATH 20E,B01,083773,Ciotti; Benjamin,20,0,35,15
1657340095055,MATH 20E,B02,083774,Ciotti; Benjamin,17,0,35,18
1657340101085,MATH 103A,A01,083777,Greenfeld; Be'Eri,3,0,36,33
1657340101085,MATH 103A,A02,083778,Greenfeld; Be'Eri,5,0,36,31
1657340101085,MATH 103A,A03,093561,Greenfeld; Be'Eri,4,0,36,32
1657340101085,MATH 103A,B01,083779,Greenfeld; Be'Eri,6,0,36,30
1657340101085,MATH 103A,B02,083780,Greenfeld; Be'Eri,4,0,36,32
1657340101085,MATH 103A,B03,093562,Greenfeld; Be'Eri,3,0,36,33
1657340107108,MATH 105,A01,085443,Carter; Anne Toulson,15,0,35,20
1657340107108,MATH 105,A02,093477,Carter; Anne Toulson,20,0,35,15
1657340113132,MATH 109,A01,083213,Ganzberger; Geoffrey Michael,2,0,34,32
1657340113132,MATH 109,A02,083214,Ganzberger; Geoffrey Michael,4,0,34,30
1657340113132,MATH 109,A03,093478,Ganzberger; Geoffrey Michael,2,0,34,32
1657340113132,MATH 109,B01,083215,Ganzberger; Geoffrey Michael,1,0,32,31
1657340113132,MATH 109,B02,083216,Ganzberger; Geoffrey Michael,1,0,32,31
1657340113132,MATH 109,B03,093479,Ganzberger; Geoffrey Michael,8,0,32,24
1657340119161,MATH 142A,A01,083219,Chow; Bennett,7,0,32,25
1657340119161,MATH 142A,A02,083220,Chow; Bennett,10,0,32,22
1657340119161,MATH 142A,A03,093480,Chow; Bennett,7,0,32,25
1657340119161,MATH 142A,B03,093481,Chow; Bennett,8,0,32,24
1657340119161,MATH 142A,B04,093558,Chow; Bennett,13,0,32,19
1657340119161,MATH 142A,B05,093559,Chow; Bennett,6,0,32,26
1657340125194,MATH 193A,A01,083224,Rotar; Vladimir,8,0,34,26
1657340125194,MATH 193A,A02,083225,Rotar; Vladimir,8,0,34,26
1657340125194,MATH 193A,A03,083781,Rotar; Vladimir,3,0,34,31
1657340125194,MATH 193A,A04,083782,Rotar; Vladimir,9,0,34,25
1657340125194,MATH 193A,A05,093482,Rotar; Vladimir,10,0,34,24
1657340131231,MATH 197,001,091859,McAuley; Julian John,9999,0,9999,0
1657340131231,MATH 197,002,095566,Kedlaya; Kiran S.,9997,0,9999,2
1657340131231,MATH 197,003,095567,Xiao; Ming,9999,0,9999,0
1657340131231,MATH 197,004,095571,Perols; Johan Lars,9998,0,9999,1
1657340138282,COGS 9,A01,083615,Shannon; Kyle Michael,8,0,75,67
1657340144305,COGS 11,A01,083617,Boyle; Mary E. T.,22,0,48,26
1657340150353,COGS 13,A01,083071,Bastos; Amalia Pinkusfeld,11,0,71,60
1657340156376,COGS 14A,A01,092681,Semenuks; Arturs,3,1,100,97
1657340162403,COGS 14B,A01,083073,Cheng; Tzu-Han,6,0,63,57
1657340168428,COGS 17,A01,092677,Semenuks; Arturs,6,0,81,75
1657340174455,COGS 100,A01,083619,Allen; Michael Gordon,16,0,70,54
1657340180479,COGS 101A,A01,083621,Davis; Joshua Daniel,9,0,68,59
1657340186507,COGS 101B,A01,091572,Allen; Michael Gordon,11,0,65,54
1657340192528,COGS 101C,A01,083625,Delgado; Tania,17,0,35,18
1657340198558,COGS 107A,A01,083627,Boyle; Mary E. T.,13,0,60,47
1657340204585,COGS 118A,A01,083075,Gupta; Anjum,20,0,76,56
1657340210611,CSE 3,A50,083646,Miranda; Gregory Joseph,24,0,50,26
1657340216636,CSE 8A,A50,083650,Miranda; Gregory Joseph,17,1,56,39
1657340222660,CSE 11,A01,083080,Cao; Yingjun,6,15,40,34
1657340228689,CSE 12,A01,083652,Krause-Levy; Sophia Louisa,28,1,120,92
1657340234714,CSE 15L,A01,083654,Morris; Justin Loren,9,0,50,41
1657340234714,CSE 15L,A02,083655,Morris; Justin Loren,9,0,50,41
1657340240741,CSE 20,A01,083657,Tran; Khoa Dang,39,0,80,41
1657340246769,CSE 21,A01,095574,Bach; Quang Tran,22,0,48,26
1657340252801,CSE 30,A01,083084,Eldon; John,4,0,80,76
1657340252801,CSE 30,B01,095061,Bhaskar; Nishant,9,0,50,41
1657340258828,CSE 100,A01,083659,Cao; Yingjun,4,4,70,66
1657340264856,CSE 134B,A01,083661,Powell; Thomas Allan,22,0,100,78
1657340270883,CSE 140,A01,083663,Gungor; Onat,14,0,85,71
1657340276910,CSE 140L,A01,083088,Eldon; John,21,0,100,79
1657340282933,CSE 175,A01,083665,Kumar; Rakesh,3,0,25,22
1657340288955,CSE 190,A00,092507,Dubnov; Shlomo,7,0,20,13
1657340294982,ECE 45,A01,083139,Congero; Spencer William,6,0,75,69
1657340301006,ECE 65,A50,083695,Saad; Andrew S,12,0,30,18
1657340301006,ECE 65,A51,095125,Saad; Andrew S,24,0,26,2
1657340307031,ECE 109,A01,091882,Touri; Behrouz,19,0,70,51
1657340313058,ECE 180,A00,083140,Abi Samra; Nicholas Camill,1,0,30,29
1657340313058,ECE 180,B00,083141,Abi Samra; Nicholas Camill,0,0,30,30
1657340319093,MATH 10A,A01,083735,Patchell; Gregory David,2,0,30,28
1657340319093,MATH 10A,A02,083736,Patchell; Gregory David,20,0,30,10
1657340319093,MATH 10A,A03,083737,Patchell; Gregory David,16,0,30,14
1657340325117,MATH 10B,A01,083207,Lim; Seonhee,7,0,34,27
1657340325117,MATH 10B,A02,083208,Lim; Seonhee,9,0,35,26
1657340325117,MATH 10B,A03,093472,Lim; Seonhee,7,0,34,27
1657340325117,MATH 10B,B01,083739,Sinha; Shubham,12,0,30,18
1657340331142,MATH 18,A01,083743,Cinel; Cameron Alexander,7,0,30,23
1657340331142,MATH 18,A02,083744,Cinel; Cameron Alexander,17,0,30,13
1657340331142,MATH 18,A03,083745,Cinel; Cameron Alexander,9,0,30,21
1657340331142,MATH 18,B01,083748,Rideout; David Porter,5,0,37,32
1657340331142,MATH 18,B02,083749,Rideout; David Porter,5,0,36,31
1657340331142,MATH 18,B03,083750,Rideout; David Porter,3,0,37,34
1657340331142,MATH 18,B04,083751,Rideout; David Porter,6,0,36,30
1657340331142,MATH 18,B05,093473,Rideout; David Porter,6,0,36,30
1657340331142,MATH 18,B06,093474,Rideout; David Porter,6,0,36,30
1657340337164,MATH 20A,A01,083754,Zheng; Zequn,14,0,40,26
1657340343192,MATH 20B,A01,083756,Briones; Jor-el Thomas Caparas,4,0,36,32
1657340343192,MATH 20B,A02,083757,Briones; Jor-el Thomas Caparas,1,0,36,35
1657340343192,MATH 20B,A03,093475,Briones; Jor-el Thomas Caparas,2,0,36,34
1657340349216,MATH 20C,A01,083760,Briones; Jor-el Thomas Caparas,1,0,35,34
1657340349216,MATH 20C,A02,083761,Briones; Jor-el Thomas Caparas,8,0,35,27
1657340349216,MATH 20C,A03,093476,Briones; Jor-el Thomas Caparas,0,1,36,36
1657340349216,MATH 20C,B01,083762,Bach; Quang Tran,1,0,30,29
1657340355243,MATH 20D,A01,083765,Tran; Brian Kha,5,0,30,25
1657340355243,MATH 20D,A02,083766,Tran; Brian Kha,5,0,30,25
1657340355243,MATH 20D,A03,083767,Tran; Brian Kha,4,0,30,26
1657340361272,MATH 20E,A01,083771,Ganguly; Soumya,9,0,32,23
1657340361272,MATH 20E,A02,083772,Ganguly; Soumya,6,0,32,26
1657340361272,MATH 20E,B01,083773,Ciotti; Benjamin,20,0,35,15
1657340361272,MATH 20E,B02,083774,Ciotti; Benjamin,17,0,35,18
1657340367294,MATH 103A,A01,083777,Greenfeld; Be'Eri,3,0,36,33
1657340367294,MATH 103A,A02,083778,Greenfeld; Be'Eri,5,0,36,31
1657340367294,MATH 103A,A03,093561,Greenfeld; Be'Eri,4,0,36,32
1657340367294,MATH 103A,B01,083779,Greenfeld; Be'Eri,6,0,36,30
1657340367294,MATH 103A,B02,083780,Greenfeld; Be'Eri,4,0,36,32
1657340367294,MATH 103A,B03,093562,Greenfeld; Be'Eri,3,0,36,33
1657340373322,MATH 105,A01,085443,Carter; Anne Toulson,15,0,35,20
1657340373322,MATH 105,A02,093477,Carter; Anne Toulson,20,0,35,15
1657340379347,MATH 109,A01,083213,Ganzberger; Geoffrey Michael,2,0,34,32
1657340379347,MATH 109,A02,083214,Ganzberger; Geoffrey Michael,4,0,34,30
1657340379347,MATH 109,A03,093478,Ganzberger; Geoffrey Michael,2,0,34,32
1657340379347,MATH 109,B01,083215,Ganzberger; Geoffrey Michael,1,0,32,31
1657340379347,MATH 109,B02,083216,Ganzberger; Geoffrey Michael,1,0,32,31
1657340379347,MATH 109,B03,093479,Ganzberger; Geoffrey Michael,8,0,32,24
1657340385376,MATH 142A,A01,083219,Chow; Bennett,7,0,32,25
1657340385376,MATH 142A,A02,083220,Chow; Bennett,10,0,32,22
1657340385376,MATH 142A,A03,093480,Chow; Bennett,7,0,32,25
1657340385376,MATH 142A,B03,093481,Chow; Bennett,8,0,32,24
1657340385376,MATH 142A,B04,093558,Chow; Bennett,13,0,32,19
1657340385376,MATH 142A,B05,093559,Chow; Bennett,6,0,32,26
1657340391405,MATH 193A,A01,083224,Rotar; Vladimir,8,0,34,26
1657340391405,MATH 193A,A02,083225,Rotar; Vladimir,8,0,34,26
1657340391405,MATH 193A,A03,083781,Rotar; Vladimir,3,0,34,31
1657340391405,MATH 193A,A04,083782,Rotar; Vladimir,9,0,34,25
1657340391405,MATH 193A,A05,093482,Rotar; Vladimir,10,0,34,24
1657340397427,MATH 197,001,091859,McAuley; Julian John,9999,0,9999,0
1657340397427,MATH 197,002,095566,Kedlaya; Kiran S.,9997,0,9999,2
1657340397427,MATH 197,003,095567,Xiao; Ming,9999,0,9999,0
1657340397427,MATH 197,004,095571,Perols; Johan Lars,9998,0,9999,1
1657340404490,COGS 9,A01,083615,Shannon; Kyle Michael,8,0,75,67
1657340410516,COGS 11,A01,083617,Boyle; Mary E. T.,22,0,48,26
1657340416551,COGS 13,A01,083071,Bastos; Amalia Pinkusfeld,11,0,71,60
1657340422579,COGS 14A,A01,092681,Semenuks; Arturs,3,1,100,97
1657340428694,COGS 14B,A01,083073,Cheng; Tzu-Han,6,0,63,57
1657340434719,COGS 17,A01,092677,Semenuks; Arturs,6,0,81,75
1657340440743,COGS 100,A01,083619,Allen; Michael Gordon,16,0,70,54
1657340446765,COGS 101A,A01,083621,Davis; Joshua Daniel,9,0,68,59
1657340452788,COGS 101B,A01,091572,Allen; Michael Gordon,11,0,65,54
1657340458810,COGS 101C,A01,083625,Delgado; Tania,17,0,35,18
1657340464835,COGS 107A,A01,083627,Boyle; Mary E. T.,13,0,60,47
1657340470861,COGS 118A,A01,083075,Gupta; Anjum,20,0,76,56
1657340476884,CSE 3,A50,083646,Miranda; Gregory Joseph,24,0,50,26
1657340482914,CSE 8A,A50,083650,Miranda; Gregory Joseph,17,1,56,39
1657340488941,CSE 11,A01,083080,Cao; Yingjun,6,15,40,34
1657340494968,CSE 12,A01,083652,Krause-Levy; Sophia Louisa,28,1,120,92
1657340500998,CSE 15L,A01,083654,Morris; Justin Loren,9,0,50,41
1657340500998,CSE 15L,A02,083655,Morris; Justin Loren,9,0,50,41
1657340507032,CSE 20,A01,083657,Tran; Khoa Dang,39,0,80,41
1657340513066,CSE 21,A01,095574,Bach; Quang Tran,22,0,48,26
1657340519090,CSE 30,A01,083084,Eldon; John,4,0,80,76
1657340519090,CSE 30,B01,095061,Bhaskar; Nishant,9,0,50,41
1657340525114,CSE 100,A01,083659,Cao; Yingjun,4,4,70,66
1657340531154,CSE 134B,A01,083661,Powell; Thomas Allan,22,0,100,78
1657340537179,CSE 140,A01,083663,Gungor; Onat,14,0,85,71
1657340543206,CSE 140L,A01,083088,Eldon; John,21,0,100,79
1657340549229,CSE 175,A01,083665,Kumar; Rakesh,3,0,25,22
1657340555254,CSE 190,A00,092507,Dubnov; Shlomo,7,0,20,13
1657340561280,ECE 45,A01,083139,Congero; Spencer William,6,0,75,69
1657340567307,ECE 65,A50,083695,Saad; Andrew S,12,0,30,18
1657340567307,ECE 65,A51,095125,Saad; Andrew S,24,0,26,2
1657340573335,ECE 109,A01,091882,Touri; Behrouz,19,0,70,51
1657340579361,ECE 180,A00,083140,Abi Samra; Nicholas Camill,1,0,30,29
1657340579361,ECE 180,B00,083141,Abi Samra; Nicholas Camill,0,0,30,30
1657340585386,MATH 10A,A01,083735,Patchell; Gregory David,2,0,30,28
1657340585386,MATH 10A,A02,083736,Patchell; Gregory David,20,0,30,10
1657340585386,MATH 10A,A03,083737,Patchell; Gregory David,16,0,30,14
1657340591414,MATH 10B,A01,083207,Lim; Seonhee,7,0,34,27
1657340591414,MATH 10B,A02,083208,Lim; Seonhee,9,0,35,26
1657340591414,MATH 10B,A03,093472,Lim; Seonhee,7,0,34,27
1657340591414,MATH 10B,B01,083739,Sinha; Shubham,12,0,30,18
1657340597443,MATH 18,A01,083743,Cinel; Cameron Alexander,7,0,30,23
1657340597443,MATH 18,A02,083744,Cinel; Cameron Alexander,17,0,30,13
1657340597443,MATH 18,A03,083745,Cinel; Cameron Alexander,9,0,30,21
1657340597443,MATH 18,B01,083748,Rideout; David Porter,5,0,37,32
1657340597443,MATH 18,B02,083749,Rideout; David Porter,5,0,36,31
1657340597443,MATH 18,B03,083750,Rideout; David Porter,3,0,37,34
1657340597443,MATH 18,B04,083751,Rideout; David Porter,6,0,36,30
1657340597443,MATH 18,B05,093473,Rideout; David Porter,6,0,36,30
1657340597443,MATH 18,B06,093474,Rideout; David Porter,6,0,36,30
1657340603469,MATH 20A,A01,083754,Zheng; Zequn,14,0,40,26
1657340609490,MATH 20B,A01,083756,Briones; Jor-el Thomas Caparas,4,0,36,32
1657340609490,MATH 20B,A02,083757,Briones; Jor-el Thomas Caparas,1,0,36,35
1657340609490,MATH 20B,A03,093475,Briones; Jor-el Thomas Caparas,2,0,36,34
1657340615518,MATH 20C,A01,083760,Briones; Jor-el Thomas Caparas,1,0,35,34
1657340615518,MATH 20C,A02,083761,Briones; Jor-el Thomas Caparas,8,0,35,27
1657340615518,MATH 20C,A03,093476,Briones; Jor-el Thomas Caparas,0,1,36,36
1657340615518,MATH 20C,B01,083762,Bach; Quang Tran,1,0,30,29
1657340621540,MATH 20D,A01,083765,Tran; Brian Kha,5,0,30,25
1657340621540,MATH 20D,A02,083766,Tran; Brian Kha,5,0,30,25
1657340621540,MATH 20D,A03,083767,Tran; Brian Kha,4,0,30,26
1657340627579,MATH 20E,A01,083771,Ganguly; Soumya,9,0,32,23
1657340627579,MATH 20E,A02,083772,Ganguly; Soumya,6,0,32,26
1657340627579,MATH 20E,B01,083773,Ciotti; Benjamin,20,0,35,15
1657340627579,MATH 20E,B02,083774,Ciotti; Benjamin,17,0,35,18
1657340633604,MATH 103A,A01,083777,Greenfeld; Be'Eri,3,0,36,33
1657340633604,MATH 103A,A02,083778,Greenfeld; Be'Eri,5,0,36,31
1657340633604,MATH 103A,A03,093561,Greenfeld; Be'Eri,4,0,36,32
1657340633604,MATH 103A,B01,083779,Greenfeld; Be'Eri,6,0,36,30
1657340633604,MATH 103A,B02,083780,Greenfeld; Be'Eri,4,0,36,32
1657340633604,MATH 103A,B03,093562,Greenfeld; Be'Eri,3,0,36,33
1657340639629,MATH 105,A01,085443,Carter; Anne Toulson,15,0,35,20
1657340639629,MATH 105,A02,093477,Carter; Anne Toulson,20,0,35,15
1657340645652,MATH 109,A01,083213,Ganzberger; Geoffrey Michael,2,0,34,32
1657340645652,MATH 109,A02,083214,Ganzberger; Geoffrey Michael,4,0,34,30
1657340645652,MATH 109,A03,093478,Ganzberger; Geoffrey Michael,2,0,34,32
1657340645652,MATH 109,B01,083215,Ganzberger; Geoffrey Michael,1,0,32,31
1657340645652,MATH 109,B02,083216,Ganzberger; Geoffrey Michael,1,0,32,31
1657340645652,MATH 109,B03,093479,Ganzberger; Geoffrey Michael,8,0,32,24
1657340651676,MATH 142A,A01,083219,Chow; Bennett,7,0,32,25
1657340651676,MATH 142A,A02,083220,Chow; Bennett,10,0,32,22
1657340651676,MATH 142A,A03,093480,Chow; Bennett,7,0,32,25
1657340651676,MATH 142A,B03,093481,Chow; Bennett,8,0,32,24
1657340651676,MATH 142A,B04,093558,Chow; Bennett,13,0,32,19
1657340651676,MATH 142A,B05,093559,Chow; Bennett,6,0,32,26
1657340657698,MATH 193A,A01,083224,Rotar; Vladimir,8,0,34,26
1657340657698,MATH 193A,A02,083225,Rotar; Vladimir,8,0,34,26
1657340657698,MATH 193A,A03,083781,Rotar; Vladimir,3,0,34,31
1657340657698,MATH 193A,A04,083782,Rotar; Vladimir,9,0,34,25
1657340657698,MATH 193A,A05,093482,Rotar; Vladimir,10,0,34,24
1657340663722,MATH 197,001,091859,McAuley; Julian John,9999,0,9999,0
1657340663722,MATH 197,002,095566,Kedlaya; Kiran S.,9997,0,9999,2
1657340663722,MATH 197,003,095567,Xiao; Ming,9999,0,9999,0
1657340663722,MATH 197,004,095571,Perols; Johan Lars,9998,0,9999,1
1657340670771,COGS 9,A01,083615,Shannon; Kyle Michael,8,0,75,67
1657340676797,COGS 11,A01,083617,Boyle; Mary E. T.,22,0,48,26
1657340682820,COGS 13,A01,083071,Bastos; Amalia Pinkusfeld,11,0,71,60
1657340688843,COGS 14A,A01,092681,Semenuks; Arturs,3,1,100,97
1657340694865,COGS 14B,A01,083073,Cheng; Tzu-Han,6,0,63,57
1657340700890,COGS 17,A01,092677,Semenuks; Arturs,6,0,81,75
1657340706924,COGS 100,A01,083619,Allen; Michael Gordon,16,0,70,54
1657340712946,COGS 101A,A01,083621,Davis; Joshua Daniel,9,0,68,59
1657340718973,COGS 101B,A01,091572,Allen; Michael Gordon,11,0,65,54
1657340724999,COGS 101C,A01,083625,Delgado; Tania,17,0,35,18
1657340731022,COGS 107A,A01,083627,Boyle; Mary E. T.,13,0,60,47
1657340737047,COGS 118A,A01,083075,Gupta; Anjum,20,0,76,56
1657340743073,CSE 3,A50,083646,Miranda; Gregory Joseph,24,0,50,26
1657340749103,CSE 8A,A50,083650,Miranda; Gregory Joseph,17,1,56,39
1657340755126,CSE 11,A01,083080,Cao; Yingjun,6,15,40,34
1657340761152,CSE 12,A01,083652,Krause-Levy; Sophia Louisa,28,1,120,92
1657340767175,CSE 15L,A01,083654,Morris; Justin Loren,9,0,50,41
1657340767175,CSE 15L,A02,083655,Morris; Justin Loren,9,0,50,41
1657340773202,CSE 20,A01,083657,Tran; Khoa Dang,39,0,80,41
1657340779226,CSE 21,A01,095574,Bach; Quang Tran,22,0,48,26
1657340785250,CSE 30,A01,083084,Eldon; John,4,0,80,76
1657340785250,CSE 30,B01,095061,Bhaskar; Nishant,9,0,50,41
1657340791273,CSE 100,A01,083659,Cao; Yingjun,4,4,70,66
1657340797295,CSE 134B,A01,083661,Powell; Thomas Allan,22,0,100,78
1657340803319,CSE 140,A01,083663,Gungor; Onat,14,0,85,71
1657340809343,CSE 140L,A01,083088,Eldon; John,21,0,100,79
1657340815365,CSE 175,A01,083665,Kumar; Rakesh,3,0,25,22
1657340821391,CSE 190,A00,092507,Dubnov; Shlomo,7,0,20,13
1657340827420,ECE 45,A01,083139,Congero; Spencer William,6,0,75,69
1657340833446,ECE 65,A50,083695,Saad; Andrew S,12,0,30,18
1657340833446,ECE 65,A51,095125,Saad; Andrew S,24,0,26,2
1657340839472,ECE 109,A01,091882,Touri; Behrouz,19,0,70,51
1657340845498,ECE 180,A00,083140,Abi Samra; Nicholas Camill,1,0,30,29
1657340845498,ECE 180,B00,083141,Abi Samra; Nicholas Camill,0,0,30,30
1657340851524,MATH 10A,A01,083735,Patchell; Gregory David,2,0,30,28
1657340851524,MATH 10A,A02,083736,Patchell; Gregory David,20,0,30,10
1657340851524,MATH 10A,A03,083737,Patchell; Gregory David,16,0,30,14
1657340857557,MATH 10B,A01,083207,Lim; Seonhee,7,0,34,27
1657340857557,MATH 10B,A02,083208,Lim; Seonhee,9,0,35,26
1657340857557,MATH 10B,A03,093472,Lim; Seonhee,7,0,34,27
1657340857557,MATH 10B,B01,083739,Sinha; Shubham,12,0,30,18
1657340863581,MATH 18,A01,083743,Cinel; Cameron Alexander,7,0,30,23
1657340863581,MATH 18,A02,083744,Cinel; Cameron Alexander,17,0,30,13
1657340863581,MATH 18,A03,083745,Cinel; Cameron Alexander,9,0,30,21
1657340863581,MATH 18,B01,083748,Rideout; David Porter,5,0,37,32
1657340863581,MATH 18,B02,083749,Rideout; David Porter,5,0,36,31
1657340863581,MATH 18,B03,083750,Rideout; David Porter,3,0,37,34
1657340863581,MATH 18,B04,083751,Rideout; David Porter,6,0,36,30
1657340863581,MATH 18,B05,093473,Rideout; David Porter,6,0,36,30
1657340863581,MATH 18,B06,093474,Rideout; David Porter,6,0,36,30
1657340869607,MATH 20A,A01,083754,Zheng; Zequn,14,0,40,26
1657340875633,MATH 20B,A01,083756,Briones; Jor-el Thomas Caparas,4,0,36,32
1657340875633,MATH 20B,A02,083757,Briones; Jor-el Thomas Caparas,1,0,36,35
1657340875633,MATH 20B,A03,093475,Briones; Jor-el Thomas Caparas,2,0,36,34
1657340881656,MATH 20C,A01,083760,Briones; Jor-el Thomas Caparas,1,0,35,34
1657340881656,MATH 20C,A02,083761,Briones; Jor-el Thomas Caparas,8,0,35,27
1657340881656,MATH 20C,A03,093476,Briones; Jor-el Thomas Caparas,0,1,36,36
1657340881656,MATH 20C,B01,083762,Bach; Quang Tran,1,0,30,29
1657340887678,MATH 20D,A01,083765,Tran; Brian Kha,5,0,30,25
1657340887678,MATH 20D,A02,083766,Tran; Brian Kha,5,0,30,25
1657340887678,MATH 20D,A03,083767,Tran; Brian Kha,4,0,30,26
1657340893702,MATH 20E,A01,083771,Ganguly; Soumya,9,0,32,23
1657340893702,MATH 20E,A02,083772,Ganguly; Soumya,6,0,32,26
1657340893702,MATH 20E,B01,083773,Ciotti; Benjamin,20,0,35,15
1657340893702,MATH 20E,B02,083774,Ciotti; Benjamin,17,0,35,18
1657340899725,MATH 103A,A01,083777,Greenfeld; Be'Eri,3,0,36,33
1657340899725,MATH 103A,A02,083778,Greenfeld; Be'Eri,5,0,36,31
1657340899725,MATH 103A,A03,093561,Greenfeld; Be'Eri,4,0,36,32
1657340899725,MATH 103A,B01,083779,Greenfeld; Be'Eri,6,0,36,30
1657340899725,MATH 103A,B02,083780,Greenfeld; Be'Eri,4,0,36,32
1657340899725,MATH 103A,B03,093562,Greenfeld; Be'Eri,3,0,36,33
1657340905764,MATH 105,A01,085443,Carter; Anne Toulson,15,0,35,20
1657340905764,MATH 105,A02,093477,Carter; Anne Toulson,20,0,35,15
1657340911790,MATH 109,A01,083213,Ganzberger; Geoffrey Michael,2,0,34,32
1657340911790,MATH 109,A02,083214,Ganzberger; Geoffrey Michael,4,0,34,30
1657340911790,MATH 109,A03,093478,Ganzberger; Geoffrey Michael,2,0,34,32
1657340911790,MATH 109,B01,083215,Ganzberger; Geoffrey Michael,1,0,32,31
1657340911790,MATH 109,B02,083216,Ganzberger; Geoffrey Michael,1,0,32,31
1657340911790,MATH 109,B03,093479,Ganzberger; Geoffrey Michael,8,0,32,24
1657340917814,MATH 142A,A01,083219,Chow; Bennett,7,0,32,25
1657340917814,MATH 142A,A02,083220,Chow; Bennett,10,0,32,22
1657340917814,MATH 142A,A03,093480,Chow; Bennett,8,0,32,24
1657340917814,MATH 142A,B03,093481,Chow; Bennett,8,0,32,24
1657340917814,MATH 142A,B04,093558,Chow; Bennett,13,0,32,19
1657340917814,MATH 142A,B05,093559,Chow; Bennett,6,0,32,26
1657340923838,MATH 193A,A01,083224,Rotar; Vladimir,8,0,34,26
1657340923838,MATH 193A,A02,083225,Rotar; Vladimir,8,0,34,26
1657340923838,MATH 193A,A03,083781,Rotar; Vladimir,3,0,34,31
1657340923838,MATH 193A,A04,083782,Rotar; Vladimir,9,0,34,25
1657340923838,MATH 193A,A05,093482,Rotar; Vladimir,10,0,34,24
1657340929860,MATH 197,001,091859,McAuley; Julian John,9999,0,9999,0
1657340929860,MATH 197,002,095566,Kedlaya; Kiran S.,9997,0,9999,2
1657340929860,MATH 197,003,095567,Xiao; Ming,9999,0,9999,0
1657340929860,MATH 197,004,095571,Perols; Johan Lars,9998,0,9999,1
1657340936919,COGS 9,A01,083615,Shannon; Kyle Michael,8,0,75,67
1657340942946,COGS 11,A01,083617,Boyle; Mary E. T.,22,0,48,26
1657340948973,COGS 13,A01,083071,Bastos; Amalia Pinkusfeld,11,0,71,60
1657340954999,COGS 14A,A01,092681,Semenuks; Arturs,3,1,100,97
1657340961024,COGS 14B,A01,083073,Cheng; Tzu-Han,6,0,63,57
1657340967053,COGS 17,A01,092677,Semenuks; Arturs,6,0,81,75
1657340973076,COGS 100,A01,083619,Allen; Michael Gordon,16,0,70,54
1657340979100,COGS 101A,A01,083621,Davis; Joshua Daniel,9,0,68,59
1657340985126,COGS 101B,A01,091572,Allen; Michael Gordon,11,0,65,54
1657340991150,COGS 101C,A01,083625,Delgado; Tania,17,0,35,18
1657340997172,COGS 107A,A01,083627,Boyle; Mary E. T.,13,0,60,47
1657341003197,COGS 118A,A01,083075,Gupta; Anjum,20,0,76,56
1657341009221,CSE 3,A50,083646,Miranda; Gregory Joseph,24,0,50,26
1657341015245,CSE 8A,A50,083650,Miranda; Gregory Joseph,17,1,56,39
1657341021268,CSE 11,A01,083080,Cao; Yingjun,6,15,40,34
1657341027380,CSE 12,A01,083652,Krause-Levy; Sophia Louisa,28,1,120,92
1657341033404,CSE 15L,A01,083654,Morris; Justin Loren,9,0,50,41
1657341033404,CSE 15L,A02,083655,Morris; Justin Loren,9,0,50,41
1657341039435,CSE 20,A01,083657,Tran; Khoa Dang,39,0,80,41
1657341045459,CSE 21,A01,095574,Bach; Quang Tran,22,0,48,26
1657341051486,CSE 30,A01,083084,Eldon; John,4,0,80,76
1657341051486,CSE 30,B01,095061,Bhaskar; Nishant,9,0,50,41
1657341057509,CSE 100,A01,083659,Cao; Yingjun,4,4,70,66
1657341063534,CSE 134B,A01,083661,Powell; Thomas Allan,22,0,100,78
1657341069561,CSE 140,A01,083663,Gungor; Onat,14,0,85,71
1657341075585,CSE 140L,A01,083088,Eldon; John,21,0,100,79
1657341081610,CSE 175,A01,083665,Kumar; Rakesh,3,0,25,22
1657341087638,CSE 190,A00,092507,Dubnov; Shlomo,7,0,20,13
1657341093664,ECE 45,A01,083139,Congero; Spencer William,6,0,75,69
1657341099692,ECE 65,A50,083695,Saad; Andrew S,12,0,30,18
1657341099692,ECE 65,A51,095125,Saad; Andrew S,24,0,26,2
1657341105715,ECE 109,A01,091882,Touri; Behrouz,19,0,70,51
1657341111742,ECE 180,A00,083140,Abi Samra; Nicholas Camill,1,0,30,29
1657341111742,ECE 180,B00,083141,Abi Samra; Nicholas Camill,0,0,30,30
1657341117766,MATH 10A,A01,083735,Patchell; Gregory David,2,0,30,28
1657341117766,MATH 10A,A02,083736,Patchell; Gregory David,20,0,30,10
1657341117766,MATH 10A,A03,083737,Patchell; Gregory David,16,0,30,14
1657341123791,MATH 10B,A01,083207,Lim; Seonhee,7,0,34,27
1657341123791,MATH 10B,A02,083208,Lim; Seonhee,9,0,35,26
1657341123791,MATH 10B,A03,093472,Lim; Seonhee,7,0,34,27
1657341123791,MATH 10B,B01,083739,Sinha; Shubham,12,0,30,18
1657341129816,MATH 18,A01,083743,Cinel; Cameron Alexander,7,0,30,23
1657341129816,MATH 18,A02,083744,Cinel; Cameron Alexander,17,0,30,13
1657341129816,MATH 18,A03,083745,Cinel; Cameron Alexander,9,0,30,21
1657341129816,MATH 18,B01,083748,Rideout; David Porter,5,0,37,32
1657341129816,MATH 18,B02,083749,Rideout; David Porter,5,0,36,31
1657341129816,MATH 18,B03,083750,Rideout; David Porter,3,0,37,34
1657341129816,MATH 18,B04,083751,Rideout; David Porter,6,0,36,30
1657341129816,MATH 18,B05,093473,Rideout; David Porter,6,0,36,30
1657341129816,MATH 18,B06,093474,Rideout; David Porter,6,0,36,30
1657341135845,MATH 20A,A01,083754,Zheng; Zequn,14,0,40,26
1657341141870,MATH 20B,A01,083756,Briones; Jor-el Thomas Caparas,4,0,36,32
1657341141870,MATH 20B,A02,083757,Briones; Jor-el Thomas Caparas,1,0,36,35
1657341141870,MATH 20B,A03,093475,Briones; Jor-el Thomas Caparas,2,0,36,34
1657341147909,MATH 20C,A01,083760,Briones; Jor-el Thomas Caparas,1,0,35,34
1657341147909,MATH 20C,A02,083761,Briones; Jor-el Thomas Caparas,8,0,35,27
1657341147909,MATH 20C,A03,093476,Briones; Jor-el Thomas Caparas,0,1,36,36
1657341147909,MATH 20C,B01,083762,Bach; Quang Tran,1,0,30,29
1657341153932,MATH 20D,A01,083765,Tran; Brian Kha,5,0,30,25
1657341153932,MATH 20D,A02,083766,Tran; Brian Kha,5,0,30,25
1657341153932,MATH 20D,A03,083767,Tran; Brian Kha,4,0,30,26
1657341159967,MATH 20E,A01,083771,Ganguly; Soumya,9,0,32,23
1657341159967,MATH 20E,A02,083772,Ganguly; Soumya,6,0,32,26
1657341159967,MATH 20E,B01,083773,Ciotti; Benjamin,20,0,35,15
1657341159967,MATH 20E,B02,083774,Ciotti; Benjamin,17,0,35,18
1657341165998,MATH 103A,A01,083777,Greenfeld; Be'Eri,3,0,36,33
1657341165998,MATH 103A,A02,083778,Greenfeld; Be'Eri,5,0,36,31
1657341165998,MATH 103A,A03,093561,Greenfeld; Be'Eri,4,0,36,32
1657341165998,MATH 103A,B01,083779,Greenfeld; Be'Eri,6,0,36,30
1657341165998,MATH 103A,B02,083780,Greenfeld; Be'Eri,4,0,36,32
1657341165998,MATH 103A,B03,093562,Greenfeld; Be'Eri,3,0,36,33
1657341172020,MATH 105,A01,085443,Carter; Anne Toulson,15,0,35,20
1657341172020,MATH 105,A02,093477,Carter; Anne Toulson,20,0,35,15
1657341178044,MATH 109,A01,083213,Ganzberger; Geoffrey Michael,2,0,34,32
1657341178044,MATH 109,A02,083214,Ganzberger; Geoffrey Michael,4,0,34,30
1657341178044,MATH 109,A03,093478,Ganzberger; Geoffrey Michael,2,0,34,32
1657341178044,MATH 109,B01,083215,Ganzberger; Geoffrey Michael,1,0,32,31
1657341178044,MATH 109,B02,083216,Ganzberger; Geoffrey Michael,1,0,32,31
1657341178044,MATH 109,B03,093479,Ganzberger; Geoffrey Michael,8,0,32,24
1657341184068,MATH 142A,A01,083219,Chow; Bennett,7,0,32,25
1657341184068,MATH 142A,A02,083220,Chow; Bennett,10,0,32,22
1657341184068,MATH 142A,A03,093480,Chow; Bennett,8,0,32,24
1657341184068,MATH 142A,B03,093481,Chow; Bennett,8,0,32,24
1657341184068,MATH 142A,B04,093558,Chow; Bennett,13,0,32,19
1657341184068,MATH 142A,B05,093559,Chow; Bennett,6,0,32,26
1657341190097,MATH 193A,A01,083224,Rotar; Vladimir,8,0,34,26
1657341190097,MATH 193A,A02,083225,Rotar; Vladimir,8,0,34,26
1657341190097,MATH 193A,A03,083781,Rotar; Vladimir,3,0,34,31
1657341190097,MATH 193A,A04,083782,Rotar; Vladimir,9,0,34,25
1657341190097,MATH 193A,A05,093482,Rotar; Vladimir,10,0,34,24
1657341196122,MATH 197,001,091859,McAuley; Julian John,9999,0,9999,0
1657341196122,MATH 197,002,095566,Kedlaya; Kiran S.,9997,0,9999,2
1657341196122,MATH 197,003,095567,Xiao; Ming,9999,0,9999,0
1657341196122,MATH 197,004,095571,Perols; Johan Lars,9998,0,9999,1
1657341203169,COGS 9,A01,083615,Shannon; Kyle Michael,8,0,75,67
1657341209196,COGS 11,A01,083617,Boyle; Mary E. T.,22,0,48,26
1657341215224,COGS 13,A01,083071,Bastos; Amalia Pinkusfeld,11,0,71,60
1657341221247,COGS 14A,A01,092681,Semenuks; Arturs,3,1,100,97
1657341227280,COGS 14B,A01,083073,Cheng; Tzu-Han,6,0,63,57
1657341233309,COGS 17,A01,092677,Semenuks; Arturs,6,0,81,75
1657341239331,COGS 100,A01,083619,Allen; Michael Gordon,16,0,70,54
1657341245355,COGS 101A,A01,083621,Davis; Joshua Daniel,9,0,68,59
1657341251383,COGS 101B,A01,091572,Allen; Michael Gordon,11,0,65,54
1657341257406,COGS 101C,A01,083625,Delgado; Tania,17,0,35,18
1657341263428,COGS 107A,A01,083627,Boyle; Mary E. T.,13,0,60,47
1657341269467,COGS 118A,A01,083075,Gupta; Anjum,20,0,76,56
1657341275495,CSE 3,A50,083646,Miranda; Gregory Joseph,24,0,50,26
1657341281521,CSE 8A,A50,083650,Miranda; Gregory Joseph,17,1,56,39
1657341287543,CSE 11,A01,083080,Cao; Yingjun,6,15,40,34
1657341293566,CSE 12,A01,083652,Krause-Levy; Sophia Louisa,28,1,120,92
1657341299589,CSE 15L,A01,083654,Morris; Justin Loren,9,0,50,41
1657341299589,CSE 15L,A02,083655,Morris; Justin Loren,9,0,50,41
1657341305613,CSE 20,A01,083657,Tran; Khoa Dang,39,0,80,41
1657341311636,CSE 21,A01,095574,Bach; Quang Tran,22,0,48,26
1657341317659,CSE 30,A01,083084,Eldon; John,4,0,80,76
1657341317659,CSE 30,B01,095061,Bhaskar; Nishant,9,0,50,41
1657341323684,CSE 100,A01,083659,Cao; Yingjun,4,4,70,66
1657341329711,CSE 134B,A01,083661,Powell; Thomas Allan,22,0,100,78
1657341335737,CSE 140,A01,083663,Gungor; Onat,14,0,85,71
1657341341760,CSE 140L,A01,083088,Eldon; John,21,0,100,79
1657341347784,CSE 175,A01,083665,Kumar; Rakesh,3,0,25,22
1657341353808,CSE 190,A00,092507,Dubnov; Shlomo,7,0,20,13
1657341359830,ECE 45,A01,083139,Congero; Spencer William,6,0,75,69
1657341365856,ECE 65,A50,083695,Saad; Andrew S,12,0,30,18
1657341365856,ECE 65,A51,095125,Saad; Andrew S,24,0,26,2
1657341371879,ECE 109,A01,091882,Touri; Behrouz,19,0,70,51
1657341377902,ECE 180,A00,083140,Abi Samra; Nicholas Camill,1,0,30,29
1657341377902,ECE 180,B00,083141,Abi Samra; Nicholas Camill,0,0,30,30
1657341383926,MATH 10A,A01,083735,Patchell; Gregory David,2,0,30,28
1657341383926,MATH 10A,A02,083736,Patchell; Gregory David,20,0,30,10
1657341383926,MATH 10A,A03,083737,Patchell; Gregory David,16,0,30,14
1657341389952,MATH 10B,A01,083207,Lim; Seonhee,7,0,34,27
1657341389952,MATH 10B,A02,083208,Lim; Seonhee,9,0,35,26
1657341389952,MATH 10B,A03,093472,Lim; Seonhee,7,0,34,27
1657341389952,MATH 10B,B01,083739,Sinha; Shubham,12,0,30,18
1657341395977,MATH 18,A01,083743,Cinel; Cameron Alexander,7,0,30,23
1657341395977,MATH 18,A02,083744,Cinel; Cameron Alexander,17,0,30,13
1657341395977,MATH 18,A03,083745,Cinel; Cameron Alexander,9,0,30,21
1657341395977,MATH 18,B01,083748,Rideout; David Porter,5,0,37,32
1657341395977,MATH 18,B02,083749,Rideout; David Porter,5,0,36,31
1657341395977,MATH 18,B03,083750,Rideout; David Porter,3,0,37,34
1657341395977,MATH 18,B04,083751,Rideout; David Porter,6,0,36,30
1657341395977,MATH 18,B05,093473,Rideout; David Porter,6,0,36,30
1657341395977,MATH 18,B06,093474,Rideout; David Porter,6,0,36,30
1657341402000,MATH 20A,A01,083754,Zheng; Zequn,14,0,40,26
1657341408024,MATH 20B,A01,083756,Briones; Jor-el Thomas Caparas,4,0,36,32
1657341408024,MATH 20B,A02,083757,Briones; Jor-el Thomas Caparas,1,0,36,35
1657341408024,MATH 20B,A03,093475,Briones; Jor-el Thomas Caparas,2,0,36,34
1657341414059,MATH 20C,A01,083760,Briones; Jor-el Thomas Caparas,1,0,35,34
1657341414059,MATH 20C,A02,083761,Briones; Jor-el Thomas Caparas,8,0,35,27
1657341414059,MATH 20C,A03,093476,Briones; Jor-el Thomas Caparas,0,1,36,36
1657341414059,MATH 20C,B01,083762,Bach; Quang Tran,1,0,30,29
1657341420088,MATH 20D,A01,083765,Tran; Brian Kha,5,0,30,25
1657341420088,MATH 20D,A02,083766,Tran; Brian Kha,5,0,30,25
1657341420088,MATH 20D,A03,083767,Tran; Brian Kha,4,0,30,26
1657341426112,MATH 20E,A01,083771,Ganguly; Soumya,9,0,32,23
1657341426112,MATH 20E,A02,083772,Ganguly; Soumya,6,0,32,26
1657341426112,MATH 20E,B01,083773,Ciotti; Benjamin,20,0,35,15
1657341426112,MATH 20E,B02,083774,Ciotti; Benjamin,17,0,35,18
1657341432146,MATH 103A,A01,083777,Greenfeld; Be'Eri,3,0,36,33
1657341432146,MATH 103A,A02,083778,Greenfeld; Be'Eri,5,0,36,31
1657341432146,MATH 103A,A03,093561,Greenfeld; Be'Eri,4,0,36,32
1657341432146,MATH 103A,B01,083779,Greenfeld; Be'Eri,6,0,36,30
1657341432146,MATH 103A,B02,083780,Greenfeld; Be'Eri,4,0,36,32
1657341432146,MATH 103A,B03,093562,Greenfeld; Be'Eri,3,0,36,33
1657341438171,MATH 105,A01,085443,Carter; Anne Toulson,15,0,35,20
1657341438171,MATH 105,A02,093477,Carter; Anne Toulson,20,0,35,15
1657341444197,MATH 109,A01,083213,Ganzberger; Geoffrey Michael,2,0,34,32
1657341444197,MATH 109,A02,083214,Ganzberger; Geoffrey Michael,4,0,34,30
1657341444197,MATH 109,A03,093478,Ganzberger; Geoffrey Michael,2,0,34,32
1657341444197,MATH 109,B01,083215,Ganzberger; Geoffrey Michael,1,0,32,31
1657341444197,MATH 109,B02,083216,Ganzberger; Geoffrey Michael,1,0,32,31
1657341444197,MATH 109,B03,093479,Ganzberger; Geoffrey Michael,8,0,32,24
1657341450220,MATH 142A,A01,083219,Chow; Bennett,7,0,32,25
1657341450220,MATH 142A,A02,083220,Chow; Bennett,10,0,32,22
1657341450220,MATH 142A,A03,093480,Chow; Bennett,8,0,32,24
1657341450220,MATH 142A,B03,093481,Chow; Bennett,8,0,32,24
1657341450220,MATH 142A,B04,093558,Chow; Bennett,13,0,32,19
1657341450220,MATH 142A,B05,093559,Chow; Bennett,6,0,32,26
1657341456252,MATH 193A,A01,083224,Rotar; Vladimir,8,0,34,26
1657341456252,MATH 193A,A02,083225,Rotar; Vladimir,8,0,34,26
1657341456252,MATH 193A,A03,083781,Rotar; Vladimir,3,0,34,31
1657341456252,MATH 193A,A04,083782,Rotar; Vladimir,9,0,34,25
1657341456252,MATH 193A,A05,093482,Rotar; Vladimir,10,0,34,24
1657341462274,MATH 197,001,091859,McAuley; Julian John,9999,0,9999,0
1657341462274,MATH 197,002,095566,Kedlaya; Kiran S.,9997,0,9999,2
1657341462274,MATH 197,003,095567,Xiao; Ming,9999,0,9999,0
1657341462274,MATH 197,004,095571,Perols; Johan Lars,9998,0,9999,1
1657341469333,COGS 9,A01,083615,Shannon; Kyle Michael,8,0,75,67
1657341475359,COGS 11,A01,083617,Boyle; Mary E. T.,22,0,48,26
1657341481386,COGS 13,A01,083071,Bastos; Amalia Pinkusfeld,11,0,71,60
1657341487412,COGS 14A,A01,092681,Semenuks; Arturs,3,1,100,97
1657341493437,COGS 14B,A01,083073,Cheng; Tzu-Han,6,0,63,57
1657341499460,COGS 17,A01,092677,Semenuks; Arturs,6,0,81,75
1657341505483,COGS 100,A01,083619,Allen; Michael Gordon,16,0,70,54
1657341511513,COGS 101A,A01,083621,Davis; Joshua Daniel,9,0,68,59
1657341517538,COGS 101B,A01,091572,Allen; Michael Gordon,11,0,65,54
1657341523560,COGS 101C,A01,083625,Delgado; Tania,17,0,35,18
1657341529586,COGS 107A,A01,083627,Boyle; Mary E. T.,13,0,60,47
1657341535611,COGS 118A,A01,083075,Gupta; Anjum,20,0,76,56
1657341541633,CSE 3,A50,083646,Miranda; Gregory Joseph,24,0,50,26
1657341547657,CSE 8A,A50,083650,Miranda; Gregory Joseph,17,1,56,39
1657341553685,CSE 11,A01,083080,Cao; Yingjun,6,15,40,34
1657341559711,CSE 12,A01,083652,Krause-Levy; Sophia Louisa,28,1,120,92
1657341565745,CSE 15L,A01,083654,Morris; Justin Loren,9,0,50,41
1657341565745,CSE 15L,A02,083655,Morris; Justin Loren,9,0,50,41
1657341571767,CSE 20,A01,083657,Tran; Khoa Dang,39,0,80,41
1657341577793,CSE 21,A01,095574,Bach; Quang Tran,22,0,48,26
1657341583815,CSE 30,A01,083084,Eldon; John,4,0,80,76
1657341583815,CSE 30,B01,095061,Bhaskar; Nishant,9,0,50,41
1657341589841,CSE 100,A01,083659,Cao; Yingjun,4,4,70,66
1657341595868,CSE 134B,A01,083661,Powell; Thomas Allan,22,0,100,78
1657341601892,CSE 140,A01,083663,Gungor; Onat,14,0,85,71
1657341607920,CSE 140L,A01,083088,Eldon; John,21,0,100,79
1657341613944,CSE 175,A01,083665,Kumar; Rakesh,3,0,25,22
1657341619966,CSE 190,A00,092507,Dubnov; Shlomo,7,0,20,13
1657341626068,ECE 45,A01,083139,Congero; Spencer William,6,0,75,69
1657341632095,ECE 65,A50,083695,Saad; Andrew S,12,0,30,18
1657341632095,ECE 65,A51,095125,Saad; Andrew S,24,0,26,2
1657341638118,ECE 109,A01,091882,Touri; Behrouz,19,0,70,51
1657341644141,ECE 180,A00,083140,Abi Samra; Nicholas Camill,1,0,30,29
1657341644141,ECE 180,B00,083141,Abi Samra; Nicholas Camill,0,0,30,30
1657341650163,MATH 10A,A01,083735,Patchell; Gregory David,2,0,30,28
1657341650163,MATH 10A,A02,083736,Patchell; Gregory David,20,0,30,10
1657341650163,MATH 10A,A03,083737,Patchell; Gregory David,16,0,30,14
1657341656189,MATH 10B,A01,083207,Lim; Seonhee,7,0,34,27
1657341656189,MATH 10B,A02,083208,Lim; Seonhee,9,0,35,26
1657341656189,MATH 10B,A03,093472,Lim; Seonhee,7,0,34,27
1657341656189,MATH 10B,B01,083739,Sinha; Shubham,12,0,30,18
1657341662213,MATH 18,A01,083743,Cinel; Cameron Alexander,7,0,30,23
1657341662213,MATH 18,A02,083744,Cinel; Cameron Alexander,17,0,30,13
1657341662213,MATH 18,A03,083745,Cinel; Cameron Alexander,9,0,30,21
1657341662213,MATH 18,B01,083748,Rideout; David Porter,5,0,37,32
1657341662213,MATH 18,B02,083749,Rideout; David Porter,5,0,36,31
1657341662213,MATH 18,B03,083750,Rideout; David Porter,3,0,37,34
1657341662213,MATH 18,B04,083751,Rideout; David Porter,6,0,36,30
1657341662213,MATH 18,B05,093473,Rideout; David Porter,6,0,36,30
1657341662213,MATH 18,B06,093474,Rideout; David Porter,6,0,36,30
1657341668244,MATH 20A,A01,083754,Zheng; Zequn,14,0,40,26
1657341674272,MATH 20B,A01,083756,Briones; Jor-el Thomas Caparas,4,0,36,32
1657341674272,MATH 20B,A02,083757,Briones; Jor-el Thomas Caparas,1,0,36,35
1657341674272,MATH 20B,A03,093475,Briones; Jor-el Thomas Caparas,2,0,36,34
1657341680296,MATH 20C,A01,083760,Briones; Jor-el Thomas Caparas,1,0,35,34
1657341680296,MATH 20C,A02,083761,Briones; Jor-el Thomas Caparas,8,0,35,27
1657341680296,MATH 20C,A03,093476,Briones; Jor-el Thomas Caparas,0,1,36,36
1657341680296,MATH 20C,B01,083762,Bach; Quang Tran,1,0,30,29
1657341686323,MATH 20D,A01,083765,Tran; Brian Kha,5,0,30,25
1657341686323,MATH 20D,A02,083766,Tran; Brian Kha,5,0,30,25
1657341686323,MATH 20D,A03,083767,Tran; Brian Kha,4,0,30,26
1657341692346,MATH 20E,A01,083771,Ganguly; Soumya,9,0,32,23
1657341692346,MATH 20E,A02,083772,Ganguly; Soumya,6,0,32,26
1657341692346,MATH 20E,B01,083773,Ciotti; Benjamin,20,0,35,15
1657341692346,MATH 20E,B02,083774,Ciotti; Benjamin,17,0,35,18
1657341698372,MATH 103A,A01,083777,Greenfeld; Be'Eri,3,0,36,33
1657341698372,MATH 103A,A02,083778,Greenfeld; Be'Eri,5,0,36,31
1657341698372,MATH 103A,A03,093561,Greenfeld; Be'Eri,4,0,36,32
1657341698372,MATH 103A,B01,083779,Greenfeld; Be'Eri,6,0,36,30
1657341698372,MATH 103A,B02,083780,Greenfeld; Be'Eri,4,0,36,32
1657341698372,MATH 103A,B03,093562,Greenfeld; Be'Eri,3,0,36,33
1657341704400,MATH 105,A01,085443,Carter; Anne Toulson,15,0,35,20
1657341704400,MATH 105,A02,093477,Carter; Anne Toulson,20,0,35,15
1657341710428,MATH 109,A01,083213,Ganzberger; Geoffrey Michael,2,0,34,32
1657341710428,MATH 109,A02,083214,Ganzberger; Geoffrey Michael,4,0,34,30
1657341710428,MATH 109,A03,093478,Ganzberger; Geoffrey Michael,2,0,34,32
1657341710428,MATH 109,B01,083215,Ganzberger; Geoffrey Michael,1,0,32,31
1657341710428,MATH 109,B02,083216,Ganzberger; Geoffrey Michael,1,0,32,31
1657341710428,MATH 109,B03,093479,Ganzberger; Geoffrey Michael,8,0,32,24
1657341716457,MATH 142A,A01,083219,Chow; Bennett,7,0,32,25
1657341716457,MATH 142A,A02,083220,Chow; Bennett,10,0,32,22
1657341716457,MATH 142A,A03,093480,Chow; Bennett,8,0,32,24
1657341716457,MATH 142A,B03,093481,Chow; Bennett,8,0,32,24
1657341716457,MATH 142A,B04,093558,Chow; Bennett,13,0,32,19
1657341716457,MATH 142A,B05,093559,Chow; Bennett,6,0,32,26
1657341722481,MATH 193A,A01,083224,Rotar; Vladimir,8,0,34,26
1657341722481,MATH 193A,A02,083225,Rotar; Vladimir,8,0,34,26
1657341722481,MATH 193A,A03,083781,Rotar; Vladimir,3,0,34,31
1657341722481,MATH 193A,A04,083782,Rotar; Vladimir,9,0,34,25
1657341722481,MATH 193A,A05,093482,Rotar; Vladimir,10,0,34,24
1657341728503,MATH 197,001,091859,McAuley; Julian John,9999,0,9999,0
1657341728503,MATH 197,002,095566,Kedlaya; Kiran S.,9997,0,9999,2
1657341728503,MATH 197,003,095567,Xiao; Ming,9999,0,9999,0
1657341728503,MATH 197,004,095571,Perols; Johan Lars,9998,0,9999,1
1657341735557,COGS 9,A01,083615,Shannon; Kyle Michael,8,0,75,67
1657341741585,COGS 11,A01,083617,Boyle; Mary E. T.,22,0,48,26
1657341747609,COGS 13,A01,083071,Bastos; Amalia Pinkusfeld,11,0,71,60
1657341753632,COGS 14A,A01,092681,Semenuks; Arturs,3,1,100,97
1657341759657,COGS 14B,A01,083073,Cheng; Tzu-Han,6,0,63,57
1657341765683,COGS 17,A01,092677,Semenuks; Arturs,6,0,81,75
1657341771709,COGS 100,A01,083619,Allen; Michael Gordon,16,0,70,54
1657341777737,COGS 101A,A01,083621,Davis; Joshua Daniel,9,0,68,59
1657341783764,COGS 101B,A01,091572,Allen; Michael Gordon,11,0,65,54
1657341789789,COGS 101C,A01,083625,Delgado; Tania,17,0,35,18
1657341795814,COGS 107A,A01,083627,Boyle; Mary E. T.,13,0,60,47
1657341801835,COGS 118A,A01,083075,Gupta; Anjum,20,0,76,56
1657341807859,CSE 3,A50,083646,Miranda; Gregory Joseph,24,0,50,26
1657341813884,CSE 8A,A50,083650,Miranda; Gregory Joseph,17,1,56,39
1657341819910,CSE 11,A01,083080,Cao; Yingjun,6,15,40,34
1657341825936,CSE 12,A01,083652,Krause-Levy; Sophia Louisa,28,1,120,92
1657341831962,CSE 15L,A01,083654,Morris; Justin Loren,9,0,50,41
1657341831962,CSE 15L,A02,083655,Morris; Justin Loren,9,0,50,41
1657341837987,CSE 20,A01,083657,Tran; Khoa Dang,39,0,80,41
1657341844014,CSE 21,A01,095574,Bach; Quang Tran,22,0,48,26
1657341850037,CSE 30,A01,083084,Eldon; John,4,0,80,76
1657341850037,CSE 30,B01,095061,Bhaskar; Nishant,9,0,50,41
1657341856062,CSE 100,A01,083659,Cao; Yingjun,4,4,70,66
1657341862091,CSE 134B,A01,083661,Powell; Thomas Allan,22,0,100,78
1657341868116,CSE 140,A01,083663,Gungor; Onat,14,0,85,71
1657341874144,CSE 140L,A01,083088,Eldon; John,21,0,100,79
1657341880167,CSE 175,A01,083665,Kumar; Rakesh,3,0,25,22
1657341886194,CSE 190,A00,092507,Dubnov; Shlomo,7,0,20,13
1657341892218,ECE 45,A01,083139,Congero; Spencer William,6,0,75,69
1657341898240,ECE 65,A50,083695,Saad; Andrew S,12,0,30,18
1657341898240,ECE 65,A51,095125,Saad; Andrew S,24,0,26,2
1657341904264,ECE 109,A01,091882,Touri; Behrouz,19,0,70,51
1657341910305,ECE 180,A00,083140,Abi Samra; Nicholas Camill,1,0,30,29
1657341910305,ECE 180,B00,083141,Abi Samra; Nicholas Camill,0,0,30,30
1657341916329,MATH 10A,A01,083735,Patchell; Gregory David,2,0,30,28
1657341916329,MATH 10A,A02,083736,Patchell; Gregory David,20,0,30,10
1657341916329,MATH 10A,A03,083737,Patchell; Gregory David,16,0,30,14
1657341922353,MATH 10B,A01,083207,Lim; Seonhee,7,0,34,27
1657341922353,MATH 10B,A02,083208,Lim; Seonhee,9,0,35,26
1657341922353,MATH 10B,A03,093472,Lim; Seonhee,7,0,34,27
1657341922353,MATH 10B,B01,083739,Sinha; Shubham,12,0,30,18
1657341928379,MATH 18,A01,083743,Cinel; Cameron Alexander,7,0,30,23
1657341928379,MATH 18,A02,083744,Cinel; Cameron Alexander,17,0,30,13
1657341928379,MATH 18,A03,083745,Cinel; Cameron Alexander,9,0,30,21
1657341928379,MATH 18,B01,083748,Rideout; David Porter,5,0,37,32
1657341928379,MATH 18,B02,083749,Rideout; David Porter,5,0,36,31
1657341928379,MATH 18,B03,083750,Rideout; David Porter,3,0,37,34
1657341928379,MATH 18,B04,083751,Rideout; David Porter,6,0,36,30
1657341928379,MATH 18,B05,093473,Rideout; David Porter,6,0,36,30
1657341928379,MATH 18,B06,093474,Rideout; David Porter,6,0,36,30
1657341934406,MATH 20A,A01,083754,Zheng; Zequn,14,0,40,26
1657341940430,MATH 20B,A01,083756,Briones; Jor-el Thomas Caparas,4,0,36,32
1657341940430,MATH 20B,A02,083757,Briones; Jor-el Thomas Caparas,1,0,36,35
1657341940430,MATH 20B,A03,093475,Briones; Jor-el Thomas Caparas,2,0,36,34
1657341946453,MATH 20C,A01,083760,Briones; Jor-el Thomas Caparas,1,0,35,34
1657341946453,MATH 20C,A02,083761,Briones; Jor-el Thomas Caparas,8,0,35,27
1657341946453,MATH 20C,A03,093476,Briones; Jor-el Thomas Caparas,0,1,36,36
1657341946453,MATH 20C,B01,083762,Bach; Quang Tran,1,0,30,29
1657341952479,MATH 20D,A01,083765,Tran; Brian Kha,5,0,30,25
1657341952479,MATH 20D,A02,083766,Tran; Brian Kha,5,0,30,25
1657341952479,MATH 20D,A03,083767,Tran; Brian Kha,4,0,30,26
1657341958507,MATH 20E,A01,083771,Ganguly; Soumya,9,0,32,23
1657341958507,MATH 20E,A02,083772,Ganguly; Soumya,6,0,32,26
1657341958507,MATH 20E,B01,083773,Ciotti; Benjamin,20,0,35,15
1657341958507,MATH 20E,B02,083774,Ciotti; Benjamin,17,0,35,18
1657341964529,MATH 103A,A01,083777,Greenfeld; Be'Eri,3,0,36,33
1657341964529,MATH 103A,A02,083778,Greenfeld; Be'Eri,5,0,36,31
1657341964529,MATH 103A,A03,093561,Greenfeld; Be'Eri,4,0,36,32
1657341964529,MATH 103A,B01,083779,Greenfeld; Be'Eri,6,0,36,30
1657341964529,MATH 103A,B02,083780,Greenfeld; Be'Eri,4,0,36,32
1657341964529,MATH 103A,B03,093562,Greenfeld; Be'Eri,3,0,36,33
1657341970552,MATH 105,A01,085443,Carter; Anne Toulson,15,0,35,20
1657341970552,MATH 105,A02,093477,Carter; Anne Toulson,20,0,35,15
1657341976581,MATH 109,A01,083213,Ganzberger; Geoffrey Michael,2,0,34,32
1657341976581,MATH 109,A02,083214,Ganzberger; Geoffrey Michael,4,0,34,30
1657341976581,MATH 109,A03,093478,Ganzberger; Geoffrey Michael,2,0,34,32
1657341976581,MATH 109,B01,083215,Ganzberger; Geoffrey Michael,1,0,32,31
1657341976581,MATH 109,B02,083216,Ganzberger; Geoffrey Michael,1,0,32,31
1657341976581,MATH 109,B03,093479,Ganzberger; Geoffrey Michael,8,0,32,24
1657341982607,MATH 142A,A01,083219,Chow; Bennett,7,0,32,25
1657341982607,MATH 142A,A02,083220,Chow; Bennett,10,0,32,22
1657341982607,MATH 142A,A03,093480,Chow; Bennett,8,0,32,24
1657341982607,MATH 142A,B03,093481,Chow; Bennett,8,0,32,24
1657341982607,MATH 142A,B04,093558,Chow; Bennett,13,0,32,19
1657341982607,MATH 142A,B05,093559,Chow; Bennett,6,0,32,26
1657341988637,MATH 193A,A01,083224,Rotar; Vladimir,8,0,34,26
1657341988637,MATH 193A,A02,083225,Rotar; Vladimir,8,0,34,26
1657341988637,MATH 193A,A03,083781,Rotar; Vladimir,3,0,34,31
1657341988637,MATH 193A,A04,083782,Rotar; Vladimir,9,0,34,25
1657341988637,MATH 193A,A05,093482,Rotar; Vladimir,10,0,34,24
1657341994663,MATH 197,001,091859,McAuley; Julian John,9999,0,9999,0
1657341994663,MATH 197,002,095566,Kedlaya; Kiran S.,9997,0,9999,2
1657341994663,MATH 197,003,095567,Xiao; Ming,9999,0,9999,0
1657341994663,MATH 197,004,095571,Perols; Johan Lars,9998,0,9999,1
1657342001713,COGS 9,A01,083615,Shannon; Kyle Michael,8,0,75,67
1657342007739,COGS 11,A01,083617,Boyle; Mary E. T.,22,0,48,26
1657342013766,COGS 13,A01,083071,Bastos; Amalia Pinkusfeld,11,0,71,60
1657342019792,COGS 14A,A01,092681,Semenuks; Arturs,3,1,100,97
1657342025819,COGS 14B,A01,083073,Cheng; Tzu-Han,6,0,63,57
1657342031847,COGS 17,A01,092677,Semenuks; Arturs,6,0,81,75
1657342037874,COGS 100,A01,083619,Allen; Michael Gordon,16,0,70,54
1657342043901,COGS 101A,A01,083621,Davis; Joshua Daniel,9,0,68,59
1657342049924,COGS 101B,A01,091572,Allen; Michael Gordon,11,0,65,54
1657342055951,COGS 101C,A01,083625,Delgado; Tania,17,0,35,18
1657342061973,COGS 107A,A01,083627,Boyle; Mary E. T.,13,0,60,47
1657342067997,COGS 118A,A01,083075,Gupta; Anjum,20,0,76,56
1657342074024,CSE 3,A50,083646,Miranda; Gregory Joseph,24,0,50,26
1657342080060,CSE 8A,A50,083650,Miranda; Gregory Joseph,17,1,56,39
1657342086083,CSE 11,A01,083080,Cao; Yingjun,6,15,40,34
1657342092115,CSE 12,A01,083652,Krause-Levy; Sophia Louisa,28,1,120,92
1657342098140,CSE 15L,A01,083654,Morris; Justin Loren,9,0,50,41
1657342098140,CSE 15L,A02,083655,Morris; Justin Loren,9,0,50,41
1657342104165,CSE 20,A01,083657,Tran; Khoa Dang,39,0,80,41
1657342110193,CSE 21,A01,095574,Bach; Quang Tran,22,0,48,26
1657342116222,CSE 30,A01,083084,Eldon; John,4,0,80,76
1657342116222,CSE 30,B01,095061,Bhaskar; Nishant,9,0,50,41
1657342122246,CSE 100,A01,083659,Cao; Yingjun,4,4,70,66
1657342128273,CSE 134B,A01,083661,Powell; Thomas Allan,22,0,100,78
1657342134298,CSE 140,A01,083663,Gungor; Onat,14,0,85,71
1657342140326,CSE 140L,A01,083088,Eldon; John,21,0,100,79
1657342146349,CSE 175,A01,083665,Kumar; Rakesh,3,0,25,22
1657342152390,CSE 190,A00,092507,Dubnov; Shlomo,7,0,20,13
1657342158416,ECE 45,A01,083139,Congero; Spencer William,6,0,75,69
1657342164441,ECE 65,A50,083695,Saad; Andrew S,12,0,30,18
1657342164441,ECE 65,A51,095125,Saad; Andrew S,24,0,26,2
1657342170463,ECE 109,A01,091882,Touri; Behrouz,19,0,70,51
1657342176489,ECE 180,A00,083140,Abi Samra; Nicholas Camill,1,0,30,29
1657342176489,ECE 180,B00,083141,Abi Samra; Nicholas Camill,0,0,30,30
1657342182527,MATH 10A,A01,083735,Patchell; Gregory David,2,0,30,28
1657342182527,MATH 10A,A02,083736,Patchell; Gregory David,20,0,30,10
1657342182527,MATH 10A,A03,083737,Patchell; Gregory David,16,0,30,14
1657342188559,MATH 10B,A01,083207,Lim; Seonhee,7,0,34,27
1657342188559,MATH 10B,A02,083208,Lim; Seonhee,9,0,35,26
1657342188559,MATH 10B,A03,093472,Lim; Seonhee,7,0,34,27
1657342188559,MATH 10B,B01,083739,Sinha; Shubham,12,0,30,18
1657342194584,MATH 18,A01,083743,Cinel; Cameron Alexander,7,0,30,23
1657342194584,MATH 18,A02,083744,Cinel; Cameron Alexander,17,0,30,13
1657342194584,MATH 18,A03,083745,Cinel; Cameron Alexander,9,0,30,21
1657342194584,MATH 18,B01,083748,Rideout; David Porter,5,0,37,32
1657342194584,MATH 18,B02,083749,Rideout; David Porter,5,0,36,31
1657342194584,MATH 18,B03,083750,Rideout; David Porter,3,0,37,34
1657342194584,MATH 18,B04,083751,Rideout; David Porter,6,0,36,30
1657342194584,MATH 18,B05,093473,Rideout; David Porter,6,0,36,30
1657342194584,MATH 18,B06,093474,Rideout; David Porter,6,0,36,30
1657342200610,MATH 20A,A01,083754,Zheng; Zequn,14,0,40,26
1657342206644,MATH 20B,A01,083756,Briones; Jor-el Thomas Caparas,4,0,36,32
1657342206644,MATH 20B,A02,083757,Briones; Jor-el Thomas Caparas,1,0,36,35
1657342206644,MATH 20B,A03,093475,Briones; Jor-el Thomas Caparas,2,0,36,34
1657342212673,MATH 20C,A01,083760,Briones; Jor-el Thomas Caparas,1,0,35,34
1657342212673,MATH 20C,A02,083761,Briones; Jor-el Thomas Caparas,8,0,35,27
1657342212673,MATH 20C,A03,093476,Briones; Jor-el Thomas Caparas,0,1,36,36
1657342212673,MATH 20C,B01,083762,Bach; Quang Tran,1,0,30,29
1657342218708,MATH 20D,A01,083765,Tran; Brian Kha,5,0,30,25
1657342218708,MATH 20D,A02,083766,Tran; Brian Kha,5,0,30,25
1657342218708,MATH 20D,A03,083767,Tran; Brian Kha,4,0,30,26
1657342224803,MATH 20E,A01,083771,Ganguly; Soumya,9,0,32,23
1657342224803,MATH 20E,A02,083772,Ganguly; Soumya,6,0,32,26
1657342224803,MATH 20E,B01,083773,Ciotti; Benjamin,20,0,35,15
1657342224803,MATH 20E,B02,083774,Ciotti; Benjamin,17,0,35,18
1657342230826,MATH 103A,A01,083777,Greenfeld; Be'Eri,3,0,36,33
1657342230826,MATH 103A,A02,083778,Greenfeld; Be'Eri,5,0,36,31
1657342230826,MATH 103A,A03,093561,Greenfeld; Be'Eri,4,0,36,32
1657342230826,MATH 103A,B01,083779,Greenfeld; Be'Eri,6,0,36,30
1657342230826,MATH 103A,B02,083780,Greenfeld; Be'Eri,4,0,36,32
1657342230826,MATH 103A,B03,093562,Greenfeld; Be'Eri,3,0,36,33
1657342236851,MATH 105,A01,085443,Carter; Anne Toulson,15,0,35,20
1657342236851,MATH 105,A02,093477,Carter; Anne Toulson,20,0,35,15
1657342242875,MATH 109,A01,083213,Ganzberger; Geoffrey Michael,2,0,34,32
1657342242875,MATH 109,A02,083214,Ganzberger; Geoffrey Michael,4,0,34,30
1657342242875,MATH 109,A03,093478,Ganzberger; Geoffrey Michael,2,0,34,32
1657342242875,MATH 109,B01,083215,Ganzberger; Geoffrey Michael,1,0,32,31
1657342242875,MATH 109,B02,083216,Ganzberger; Geoffrey Michael,1,0,32,31
1657342242875,MATH 109,B03,093479,Ganzberger; Geoffrey Michael,8,0,32,24
1657342248898,MATH 142A,A01,083219,Chow; Bennett,7,0,32,25
1657342248898,MATH 142A,A02,083220,Chow; Bennett,10,0,32,22
1657342248898,MATH 142A,A03,093480,Chow; Bennett,8,0,32,24
1657342248898,MATH 142A,B03,093481,Chow; Bennett,8,0,32,24
1657342248898,MATH 142A,B04,093558,Chow; Bennett,13,0,32,19
1657342248898,MATH 142A,B05,093559,Chow; Bennett,6,0,32,26
1657342254930,MATH 193A,A01,083224,Rotar; Vladimir,8,0,34,26
1657342254930,MATH 193A,A02,083225,Rotar; Vladimir,8,0,34,26
1657342254930,MATH 193A,A03,083781,Rotar; Vladimir,3,0,34,31
1657342254930,MATH 193A,A04,083782,Rotar; Vladimir,9,0,34,25
1657342254930,MATH 193A,A05,093482,Rotar; Vladimir,10,0,34,24
1657342260955,MATH 197,001,091859,McAuley; Julian John,9999,0,9999,0
1657342260955,MATH 197,002,095566,Kedlaya; Kiran S.,9997,0,9999,2
1657342260955,MATH 197,003,095567,Xiao; Ming,9999,0,9999,0
1657342260955,MATH 197,004,095571,Perols; Johan Lars,9998,0,9999,1
1657342268008,COGS 9,A01,083615,Shannon; Kyle Michael,8,0,75,67
1657342274032,COGS 11,A01,083617,Boyle; Mary E. T.,22,0,48,26
1657342280067,COGS 13,A01,083071,Bastos; Amalia Pinkusfeld,11,0,71,60
1657342286090,COGS 14A,A01,092681,Semenuks; Arturs,3,1,100,97
1657342292114,COGS 14B,A01,083073,Cheng; Tzu-Han,6,0,63,57
1657342298137,COGS 17,A01,092677,Semenuks; Arturs,6,0,81,75
1657342304164,COGS 100,A01,083619,Allen; Michael Gordon,16,0,70,54
1657342310191,COGS 101A,A01,083621,Davis; Joshua Daniel,9,0,68,59
1657342316214,COGS 101B,A01,091572,Allen; Michael Gordon,11,0,65,54
1657342322238,COGS 101C,A01,083625,Delgado; Tania,17,0,35,18
1657342328267,COGS 107A,A01,083627,Boyle; Mary E. T.,13,0,60,47
1657342334295,COGS 118A,A01,083075,Gupta; Anjum,20,0,76,56
1657342340324,CSE 3,A50,083646,Miranda; Gregory Joseph,24,0,50,26
1657342346348,CSE 8A,A50,083650,Miranda; Gregory Joseph,17,1,56,39
1657342352376,CSE 11,A01,083080,Cao; Yingjun,6,15,40,34
1657342358398,CSE 12,A01,083652,Krause-Levy; Sophia Louisa,28,1,120,92
1657342364424,CSE 15L,A01,083654,Morris; Justin Loren,9,0,50,41
1657342364424,CSE 15L,A02,083655,Morris; Justin Loren,9,0,50,41
1657342370451,CSE 20,A01,083657,Tran; Khoa Dang,39,0,80,41
1657342376473,CSE 21,A01,095574,Bach; Quang Tran,22,0,48,26
1657342382500,CSE 30,A01,083084,Eldon; John,4,0,80,76
1657342382500,CSE 30,B01,095061,Bhaskar; Nishant,9,0,50,41
1657342388523,CSE 100,A01,083659,Cao; Yingjun,4,4,70,66
1657342394556,CSE 134B,A01,083661,Powell; Thomas Allan,22,0,100,78
1657342400583,CSE 140,A01,083663,Gungor; Onat,14,0,85,71
1657342406610,CSE 140L,A01,083088,Eldon; John,21,0,100,79
1657342412635,CSE 175,A01,083665,Kumar; Rakesh,3,0,25,22
1657342418661,CSE 190,A00,092507,Dubnov; Shlomo,7,0,20,13
1657342424688,ECE 45,A01,083139,Congero; Spencer William,6,0,75,69
1657342430711,ECE 65,A50,083695,Saad; Andrew S,12,0,30,18
1657342430711,ECE 65,A51,095125,Saad; Andrew S,24,0,26,2
1657342436737,ECE 109,A01,091882,Touri; Behrouz,19,0,70,51
1657342442760,ECE 180,A00,083140,Abi Samra; Nicholas Camill,1,0,30,29
1657342442760,ECE 180,B00,083141,Abi Samra; Nicholas Camill,0,0,30,30
1657342448788,MATH 10A,A01,083735,Patchell; Gregory David,2,0,30,28
1657342448788,MATH 10A,A02,083736,Patchell; Gregory David,20,0,30,10
1657342448788,MATH 10A,A03,083737,Patchell; Gregory David,16,0,30,14
1657342454811,MATH 10B,A01,083207,Lim; Seonhee,7,0,34,27
1657342454811,MATH 10B,A02,083208,Lim; Seonhee,9,0,35,26
1657342454811,MATH 10B,A03,093472,Lim; Seonhee,7,0,34,27
1657342454811,MATH 10B,B01,083739,Sinha; Shubham,12,0,30,18
1657342460836,MATH 18,A01,083743,Cinel; Cameron Alexander,7,0,30,23
1657342460836,MATH 18,A02,083744,Cinel; Cameron Alexander,17,0,30,13
1657342460836,MATH 18,A03,083745,Cinel; Cameron Alexander,9,0,30,21
1657342460836,MATH 18,B01,083748,Rideout; David Porter,5,0,37,32
1657342460836,MATH 18,B02,083749,Rideout; David Porter,5,0,36,31
1657342460836,MATH 18,B03,083750,Rideout; David Porter,3,0,37,34
1657342460836,MATH 18,B04,083751,Rideout; David Porter,6,0,36,30
1657342460836,MATH 18,B05,093473,Rideout; David Porter,6,0,36,30
1657342460836,MATH 18,B06,093474,Rideout; David Porter,6,0,36,30
1657342466859,MATH 20A,A01,083754,Zheng; Zequn,14,0,40,26
1657342472886,MATH 20B,A01,083756,Briones; Jor-el Thomas Caparas,4,0,36,32
1657342472886,MATH 20B,A02,083757,Briones; Jor-el Thomas Caparas,1,0,36,35
1657342472886,MATH 20B,A03,093475,Briones; Jor-el Thomas Caparas,2,0,36,34
1657342478915,MATH 20C,A01,083760,Briones; Jor-el Thomas Caparas,1,0,35,34
1657342478915,MATH 20C,A02,083761,Briones; Jor-el Thomas Caparas,8,0,35,27
1657342478915,MATH 20C,A03,093476,Briones; Jor-el Thomas Caparas,0,1,36,36
1657342478915,MATH 20C,B01,083762,Bach; Quang Tran,1,0,30,29
1657342484938,MATH 20D,A01,083765,Tran; Brian Kha,5,0,30,25
1657342484938,MATH 20D,A02,083766,Tran; Brian Kha,5,0,30,25
1657342484938,MATH 20D,A03,083767,Tran; Brian Kha,4,0,30,26
1657342490963,MATH 20E,A01,083771,Ganguly; Soumya,9,0,32,23
1657342490963,MATH 20E,A02,083772,Ganguly; Soumya,6,0,32,26
1657342490963,MATH 20E,B01,083773,Ciotti; Benjamin,20,0,35,15
1657342490963,MATH 20E,B02,083774,Ciotti; Benjamin,17,0,35,18
1657342496995,MATH 103A,A01,083777,Greenfeld; Be'Eri,3,0,36,33
1657342496995,MATH 103A,A02,083778,Greenfeld; Be'Eri,5,0,36,31
1657342496995,MATH 103A,A03,093561,Greenfeld; Be'Eri,4,0,36,32
1657342496995,MATH 103A,B01,083779,Greenfeld; Be'Eri,6,0,36,30
1657342496995,MATH 103A,B02,083780,Greenfeld; Be'Eri,4,0,36,32
1657342496995,MATH 103A,B03,093562,Greenfeld; Be'Eri,3,0,36,33
1657342503022,MATH 105,A01,085443,Carter; Anne Toulson,15,0,35,20
1657342503022,MATH 105,A02,093477,Carter; Anne Toulson,20,0,35,15
1657342509045,MATH 109,A01,083213,Ganzberger; Geoffrey Michael,2,0,34,32
1657342509045,MATH 109,A02,083214,Ganzberger; Geoffrey Michael,4,0,34,30
1657342509045,MATH 109,A03,093478,Ganzberger; Geoffrey Michael,2,0,34,32
1657342509045,MATH 109,B01,083215,Ganzberger; Geoffrey Michael,1,0,32,31
1657342509045,MATH 109,B02,083216,Ganzberger; Geoffrey Michael,1,0,32,31
1657342509045,MATH 109,B03,093479,Ganzberger; Geoffrey Michael,8,0,32,24
1657342515069,MATH 142A,A01,083219,Chow; Bennett,7,0,32,25
1657342515069,MATH 142A,A02,083220,Chow; Bennett,10,0,32,22
1657342515069,MATH 142A,A03,093480,Chow; Bennett,8,0,32,24
1657342515069,MATH 142A,B03,093481,Chow; Bennett,8,0,32,24
1657342515069,MATH 142A,B04,093558,Chow; Bennett,13,0,32,19
1657342515069,MATH 142A,B05,093559,Chow; Bennett,6,0,32,26
1657342521092,MATH 193A,A01,083224,Rotar; Vladimir,8,0,34,26
1657342521092,MATH 193A,A02,083225,Rotar; Vladimir,9,0,34,25
1657342521092,MATH 193A,A03,083781,Rotar; Vladimir,3,0,34,31
1657342521092,MATH 193A,A04,083782,Rotar; Vladimir,9,0,34,25
1657342521092,MATH 193A,A05,093482,Rotar; Vladimir,10,0,34,24
1657342527115,MATH 197,001,091859,McAuley; Julian John,9999,0,9999,0
1657342527115,MATH 197,002,095566,Kedlaya; Kiran S.,9997,0,9999,2
1657342527115,MATH 197,003,095567,Xiao; Ming,9999,0,9999,0
1657342527115,MATH 197,004,095571,Perols; Johan Lars,9998,0,9999,1
1657342534169,COGS 9,A01,083615,Shannon; Kyle Michael,8,0,75,67
1657342540198,COGS 11,A01,083617,Boyle; Mary E. T.,22,0,48,26
1657342546221,COGS 13,A01,083071,Bastos; Amalia Pinkusfeld,11,0,71,60
1657342552248,COGS 14A,A01,092681,Semenuks; Arturs,3,1,100,97
1657342558275,COGS 14B,A01,083073,Cheng; Tzu-Han,6,0,63,57
1657342564299,COGS 17,A01,092677,Semenuks; Arturs,6,0,81,75
1657342570326,COGS 100,A01,083619,Allen; Michael Gordon,16,0,70,54
1657342576353,COGS 101A,A01,083621,Davis; Joshua Daniel,9,0,68,59
1657342582377,COGS 101B,A01,091572,Allen; Michael Gordon,11,0,65,54
1657342588403,COGS 101C,A01,083625,Delgado; Tania,17,0,35,18
1657342594437,COGS 107A,A01,083627,Boyle; Mary E. T.,13,0,60,47
1657342600460,COGS 118A,A01,083075,Gupta; Anjum,20,0,76,56
1657342606488,CSE 3,A50,083646,Miranda; Gregory Joseph,24,0,50,26
1657342612511,CSE 8A,A50,083650,Miranda; Gregory Joseph,17,1,56,39
1657342618533,CSE 11,A01,083080,Cao; Yingjun,6,15,40,34
1657342624555,CSE 12,A01,083652,Krause-Levy; Sophia Louisa,28,1,120,92
1657342630577,CSE 15L,A01,083654,Morris; Justin Loren,9,0,50,41
1657342630577,CSE 15L,A02,083655,Morris; Justin Loren,9,0,50,41
1657342636604,CSE 20,A01,083657,Tran; Khoa Dang,39,0,80,41
1657342642627,CSE 21,A01,095574,Bach; Quang Tran,22,0,48,26
1657342648656,CSE 30,A01,083084,Eldon; John,4,0,80,76
1657342648656,CSE 30,B01,095061,Bhaskar; Nishant,9,0,50,41
1657342654694,CSE 100,A01,083659,Cao; Yingjun,4,4,70,66
1657342660722,CSE 134B,A01,083661,Powell; Thomas Allan,22,0,100,78
1657342666747,CSE 140,A01,083663,Gungor; Onat,14,0,85,71
1657342672769,CSE 140L,A01,083088,Eldon; John,21,0,100,79
1657342678791,CSE 175,A01,083665,Kumar; Rakesh,3,0,25,22
1657342684813,CSE 190,A00,092507,Dubnov; Shlomo,7,0,20,13
1657342690836,ECE 45,A01,083139,Congero; Spencer William,6,0,75,69
1657342696859,ECE 65,A50,083695,Saad; Andrew S,12,0,30,18
1657342696859,ECE 65,A51,095125,Saad; Andrew S,24,0,26,2
1657342702882,ECE 109,A01,091882,Touri; Behrouz,19,0,70,51
1657342708919,ECE 180,A00,083140,Abi Samra; Nicholas Camill,1,0,30,29
1657342708919,ECE 180,B00,083141,Abi Samra; Nicholas Camill,0,0,30,30
1657342714950,MATH 10A,A01,083735,Patchell; Gregory David,2,0,30,28
1657342714950,MATH 10A,A02,083736,Patchell; Gregory David,20,0,30,10
1657342714950,MATH 10A,A03,083737,Patchell; Gregory David,16,0,30,14
1657342720975,MATH 10B,A01,083207,Lim; Seonhee,7,0,34,27
1657342720975,MATH 10B,A02,083208,Lim; Seonhee,9,0,35,26
1657342720975,MATH 10B,A03,093472,Lim; Seonhee,7,0,34,27
1657342720975,MATH 10B,B01,083739,Sinha; Shubham,12,0,30,18
1657342726998,MATH 18,A01,083743,Cinel; Cameron Alexander,7,0,30,23
1657342726998,MATH 18,A02,083744,Cinel; Cameron Alexander,17,0,30,13
1657342726998,MATH 18,A03,083745,Cinel; Cameron Alexander,9,0,30,21
1657342726998,MATH 18,B01,083748,Rideout; David Porter,5,0,37,32
1657342726998,MATH 18,B02,083749,Rideout; David Porter,5,0,36,31
1657342726998,MATH 18,B03,083750,Rideout; David Porter,3,0,37,34
1657342726998,MATH 18,B04,083751,Rideout; David Porter,6,0,36,30
1657342726998,MATH 18,B05,093473,Rideout; David Porter,6,0,36,30
1657342726998,MATH 18,B06,093474,Rideout; David Porter,6,0,36,30
1657342733022,MATH 20A,A01,083754,Zheng; Zequn,14,0,40,26
1657342739046,MATH 20B,A01,083756,Briones; Jor-el Thomas Caparas,4,0,36,32
1657342739046,MATH 20B,A02,083757,Briones; Jor-el Thomas Caparas,1,0,36,35
1657342739046,MATH 20B,A03,093475,Briones; Jor-el Thomas Caparas,2,0,36,34
1657342745075,MATH 20C,A01,083760,Briones; Jor-el Thomas Caparas,1,0,35,34
1657342745075,MATH 20C,A02,083761,Briones; Jor-el Thomas Caparas,8,0,35,27
1657342745075,MATH 20C,A03,093476,Briones; Jor-el Thomas Caparas,0,1,36,36
1657342745075,MATH 20C,B01,083762,Bach; Quang Tran,1,0,30,29
1657342751110,MATH 20D,A01,083765,Tran; Brian Kha,5,0,30,25
1657342751110,MATH 20D,A02,083766,Tran; Brian Kha,5,0,30,25
1657342751110,MATH 20D,A03,083767,Tran; Brian Kha,4,0,30,26
1657342757134,MATH 20E,A01,083771,Ganguly; Soumya,9,0,32,23
1657342757134,MATH 20E,A02,083772,Ganguly; Soumya,6,0,32,26
1657342757134,MATH 20E,B01,083773,Ciotti; Benjamin,20,0,35,15
1657342757134,MATH 20E,B02,083774,Ciotti; Benjamin,17,0,35,18
1657342763159,MATH 103A,A01,083777,Greenfeld; Be'Eri,3,0,36,33
1657342763159,MATH 103A,A02,083778,Greenfeld; Be'Eri,5,0,36,31
1657342763159,MATH 103A,A03,093561,Greenfeld; Be'Eri,4,0,36,32
1657342763159,MATH 103A,B01,083779,Greenfeld; Be'Eri,6,0,36,30
1657342763159,MATH 103A,B02,083780,Greenfeld; Be'Eri,4,0,36,32
1657342763159,MATH 103A,B03,093562,Greenfeld; Be'Eri,3,0,36,33
1657342769183,MATH 105,A01,085443,Carter; Anne Toulson,15,0,35,20
1657342769183,MATH 105,A02,093477,Carter; Anne Toulson,20,0,35,15
1657342775212,MATH 109,A01,083213,Ganzberger; Geoffrey Michael,2,0,34,32
1657342775212,MATH 109,A02,083214,Ganzberger; Geoffrey Michael,4,0,34,30
1657342775212,MATH 109,A03,093478,Ganzberger; Geoffrey Michael,2,0,34,32
1657342775212,MATH 109,B01,083215,Ganzberger; Geoffrey Michael,1,0,32,31
1657342775212,MATH 109,B02,083216,Ganzberger; Geoffrey Michael,1,0,32,31
1657342775212,MATH 109,B03,093479,Ganzberger; Geoffrey Michael,8,0,32,24
1657342781236,MATH 142A,A01,083219,Chow; Bennett,7,0,32,25
1657342781236,MATH 142A,A02,083220,Chow; Bennett,10,0,32,22
1657342781236,MATH 142A,A03,093480,Chow; Bennett,8,0,32,24
1657342781236,MATH 142A,B03,093481,Chow; Bennett,8,0,32,24
1657342781236,MATH 142A,B04,093558,Chow; Bennett,13,0,32,19
1657342781236,MATH 142A,B05,093559,Chow; Bennett,6,0,32,26
1657342787260,MATH 193A,A01,083224,Rotar; Vladimir,8,0,34,26
1657342787260,MATH 193A,A02,083225,Rotar; Vladimir,9,0,34,25
1657342787260,MATH 193A,A03,083781,Rotar; Vladimir,3,0,34,31
1657342787260,MATH 193A,A04,083782,Rotar; Vladimir,9,0,34,25
1657342787260,MATH 193A,A05,093482,Rotar; Vladimir,10,0,34,24
1657342793286,MATH 197,001,091859,McAuley; Julian John,9999,0,9999,0
1657342793286,MATH 197,002,095566,Kedlaya; Kiran S.,9997,0,9999,2
1657342793286,MATH 197,003,095567,Xiao; Ming,9999,0,9999,0
1657342793286,MATH 197,004,095571,Perols; Johan Lars,9998,0,9999,1
1657342800335,COGS 9,A01,083615,Shannon; Kyle Michael,8,0,75,67
1657342806359,COGS 11,A01,083617,Boyle; Mary E. T.,22,0,48,26
1657342812386,COGS 13,A01,083071,Bastos; Amalia Pinkusfeld,11,0,71,60
1657342818485,COGS 14A,A01,092681,Semenuks; Arturs,3,1,100,97
1657342824517,COGS 14B,A01,083073,Cheng; Tzu-Han,6,0,63,57
1657342830543,COGS 17,A01,092677,Semenuks; Arturs,6,0,81,75
1657342836568,COGS 100,A01,083619,Allen; Michael Gordon,16,0,70,54
1657342842594,COGS 101A,A01,083621,Davis; Joshua Daniel,9,0,68,59
1657342848619,COGS 101B,A01,091572,Allen; Michael Gordon,11,0,65,54
1657342854645,COGS 101C,A01,083625,Delgado; Tania,17,0,35,18
1657342860668,COGS 107A,A01,083627,Boyle; Mary E. T.,13,0,60,47
1657342866694,COGS 118A,A01,083075,Gupta; Anjum,20,0,76,56
1657342872719,CSE 3,A50,083646,Miranda; Gregory Joseph,24,0,50,26
1657342878743,CSE 8A,A50,083650,Miranda; Gregory Joseph,17,1,56,39
1657342884775,CSE 11,A01,083080,Cao; Yingjun,6,15,40,34
1657342890799,CSE 12,A01,083652,Krause-Levy; Sophia Louisa,28,1,120,92
1657342896826,CSE 15L,A01,083654,Morris; Justin Loren,9,0,50,41
1657342896826,CSE 15L,A02,083655,Morris; Justin Loren,9,0,50,41
1657342902856,CSE 20,A01,083657,Tran; Khoa Dang,39,0,80,41
1657342908883,CSE 21,A01,095574,Bach; Quang Tran,22,0,48,26
1657342914913,CSE 30,A01,083084,Eldon; John,4,0,80,76
1657342914913,CSE 30,B01,095061,Bhaskar; Nishant,9,0,50,41
1657342920949,CSE 100,A01,083659,Cao; Yingjun,5,4,70,65
1657342926971,CSE 134B,A01,083661,Powell; Thomas Allan,22,0,100,78
1657342932995,CSE 140,A01,083663,Gungor; Onat,14,0,85,71
1657342939023,CSE 140L,A01,083088,Eldon; John,21,0,100,79
1657342945046,CSE 175,A01,083665,Kumar; Rakesh,3,0,25,22
1657342951068,CSE 190,A00,092507,Dubnov; Shlomo,7,0,20,13
1657342957099,ECE 45,A01,083139,Congero; Spencer William,6,0,75,69
1657342963126,ECE 65,A50,083695,Saad; Andrew S,12,0,30,18
1657342963126,ECE 65,A51,095125,Saad; Andrew S,24,0,26,2
1657342969148,ECE 109,A01,091882,Touri; Behrouz,19,0,70,51
1657342975172,ECE 180,A00,083140,Abi Samra; Nicholas Camill,1,0,30,29
1657342975172,ECE 180,B00,083141,Abi Samra; Nicholas Camill,0,0,30,30
1657342981199,MATH 10A,A01,083735,Patchell; Gregory David,2,0,30,28
1657342981199,MATH 10A,A02,083736,Patchell; Gregory David,20,0,30,10
1657342981199,MATH 10A,A03,083737,Patchell; Gregory David,16,0,30,14
1657342987222,MATH 10B,A01,083207,Lim; Seonhee,7,0,34,27
1657342987222,MATH 10B,A02,083208,Lim; Seonhee,9,0,35,26
1657342987222,MATH 10B,A03,093472,Lim; Seonhee,7,0,34,27
1657342987222,MATH 10B,B01,083739,Sinha; Shubham,12,0,30,18
1657342993252,MATH 18,A01,083743,Cinel; Cameron Alexander,7,0,30,23
1657342993252,MATH 18,A02,083744,Cinel; Cameron Alexander,17,0,30,13
1657342993252,MATH 18,A03,083745,Cinel; Cameron Alexander,9,0,30,21
1657342993252,MATH 18,B01,083748,Rideout; David Porter,5,0,37,32
1657342993252,MATH 18,B02,083749,Rideout; David Porter,5,0,36,31
1657342993252,MATH 18,B03,083750,Rideout; David Porter,3,0,37,34
1657342993252,MATH 18,B04,083751,Rideout; David Porter,6,0,36,30
1657342993252,MATH 18,B05,093473,Rideout; David Porter,6,0,36,30
1657342993252,MATH 18,B06,093474,Rideout; David Porter,6,0,36,30
1657342999276,MATH 20A,A01,083754,Zheng; Zequn,14,0,40,26
1657343005302,MATH 20B,A01,083756,Briones; Jor-el Thomas Caparas,4,0,36,32
1657343005302,MATH 20B,A02,083757,Briones; Jor-el Thomas Caparas,1,0,36,35
1657343005302,MATH 20B,A03,093475,Briones; Jor-el Thomas Caparas,2,0,36,34
1657343011331,MATH 20C,A01,083760,Briones; Jor-el Thomas Caparas,1,0,35,34
1657343011331,MATH 20C,A02,083761,Briones; Jor-el Thomas Caparas,8,0,35,27
1657343011331,MATH 20C,A03,093476,Briones; Jor-el Thomas Caparas,0,1,36,36
1657343011331,MATH 20C,B01,083762,Bach; Quang Tran,1,0,30,29
1657343017355,MATH 20D,A01,083765,Tran; Brian Kha,5,0,30,25
1657343017355,MATH 20D,A02,083766,Tran; Brian Kha,5,0,30,25
1657343017355,MATH 20D,A03,083767,Tran; Brian Kha,4,0,30,26
1657343023384,MATH 20E,A01,083771,Ganguly; Soumya,9,0,32,23
1657343023384,MATH 20E,A02,083772,Ganguly; Soumya,6,0,32,26
1657343023384,MATH 20E,B01,083773,Ciotti; Benjamin,20,0,35,15
1657343023384,MATH 20E,B02,083774,Ciotti; Benjamin,17,0,35,18
1657343029409,MATH 103A,A01,083777,Greenfeld; Be'Eri,3,0,36,33
1657343029409,MATH 103A,A02,083778,Greenfeld; Be'Eri,5,0,36,31
1657343029409,MATH 103A,A03,093561,Greenfeld; Be'Eri,4,0,36,32
1657343029409,MATH 103A,B01,083779,Greenfeld; Be'Eri,6,0,36,30
1657343029409,MATH 103A,B02,083780,Greenfeld; Be'Eri,4,0,36,32
1657343029409,MATH 103A,B03,093562,Greenfeld; Be'Eri,3,0,36,33
1657343035432,MATH 105,A01,085443,Carter; Anne Toulson,15,0,35,20
1657343035432,MATH 105,A02,093477,Carter; Anne Toulson,20,0,35,15
1657343041457,MATH 109,A01,083213,Ganzberger; Geoffrey Michael,2,0,34,32
1657343041457,MATH 109,A02,083214,Ganzberger; Geoffrey Michael,4,0,34,30
1657343041457,MATH 109,A03,093478,Ganzberger; Geoffrey Michael,2,0,34,32
1657343041457,MATH 109,B01,083215,Ganzberger; Geoffrey Michael,1,0,32,31
1657343041457,MATH 109,B02,083216,Ganzberger; Geoffrey Michael,1,0,32,31
1657343041457,MATH 109,B03,093479,Ganzberger; Geoffrey Michael,8,0,32,24
1657343047486,MATH 142A,A01,083219,Chow; Bennett,7,0,32,25
1657343047486,MATH 142A,A02,083220,Chow; Bennett,10,0,32,22
1657343047486,MATH 142A,A03,093480,Chow; Bennett,8,0,32,24
1657343047486,MATH 142A,B03,093481,Chow; Bennett,8,0,32,24
1657343047486,MATH 142A,B04,093558,Chow; Bennett,13,0,32,19
1657343047486,MATH 142A,B05,093559,Chow; Bennett,6,0,32,26
1657343053512,MATH 193A,A01,083224,Rotar; Vladimir,8,0,34,26
1657343053512,MATH 193A,A02,083225,Rotar; Vladimir,9,0,34,25
1657343053512,MATH 193A,A03,083781,Rotar; Vladimir,3,0,34,31
1657343053512,MATH 193A,A04,083782,Rotar; Vladimir,9,0,34,25
1657343053512,MATH 193A,A05,093482,Rotar; Vladimir,10,0,34,24
1657343059539,MATH 197,001,091859,McAuley; Julian John,9999,0,9999,0
1657343059539,MATH 197,002,095566,Kedlaya; Kiran S.,9997,0,9999,2
1657343059539,MATH 197,003,095567,Xiao; Ming,9999,0,9999,0
1657343059539,MATH 197,004,095571,Perols; Johan Lars,9998,0,9999,1
1657343066593,COGS 9,A01,083615,Shannon; Kyle Michael,8,0,75,67
1657343072617,COGS 11,A01,083617,Boyle; Mary E. T.,22,0,48,26
1657343078646,COGS 13,A01,083071,Bastos; Amalia Pinkusfeld,11,0,71,60
1657343084671,COGS 14A,A01,092681,Semenuks; Arturs,3,1,100,97
1657343090697,COGS 14B,A01,083073,Cheng; Tzu-Han,6,0,63,57
1657343096721,COGS 17,A01,092677,Semenuks; Arturs,6,0,81,75
1657343102744,COGS 100,A01,083619,Allen; Michael Gordon,16,0,70,54
1657343108771,COGS 101A,A01,083621,Davis; Joshua Daniel,9,0,68,59
1657343114799,COGS 101B,A01,091572,Allen; Michael Gordon,11,0,65,54
1657343120821,COGS 101C,A01,083625,Delgado; Tania,17,0,35,18
1657343126845,COGS 107A,A01,083627,Boyle; Mary E. T.,13,0,60,47
1657343132871,COGS 118A,A01,083075,Gupta; Anjum,20,0,76,56
1657343138894,CSE 3,A50,083646,Miranda; Gregory Joseph,24,0,50,26
1657343144926,CSE 8A,A50,083650,Miranda; Gregory Joseph,17,1,56,39
1657343150953,CSE 11,A01,083080,Cao; Yingjun,6,15,40,34
1657343156976,CSE 12,A01,083652,Krause-Levy; Sophia Louisa,28,1,120,92
1657343162998,CSE 15L,A01,083654,Morris; Justin Loren,9,0,50,41
1657343162998,CSE 15L,A02,083655,Morris; Justin Loren,9,0,50,41
1657343169032,CSE 20,A01,083657,Tran; Khoa Dang,39,0,80,41
1657343175056,CSE 21,A01,095574,Bach; Quang Tran,22,0,48,26
1657343181080,CSE 30,A01,083084,Eldon; John,4,0,80,76
1657343181080,CSE 30,B01,095061,Bhaskar; Nishant,9,0,50,41
1657343187104,CSE 100,A01,083659,Cao; Yingjun,5,4,70,65
1657343193129,CSE 134B,A01,083661,Powell; Thomas Allan,22,0,100,78
1657343199155,CSE 140,A01,083663,Gungor; Onat,14,0,85,71
1657343205182,CSE 140L,A01,083088,Eldon; John,21,0,100,79
1657343211238,CSE 175,A01,083665,Kumar; Rakesh,3,0,25,22
1657343217262,CSE 190,A00,092507,Dubnov; Shlomo,7,0,20,13
1657343223286,ECE 45,A01,083139,Congero; Spencer William,6,0,75,69
1657343229315,ECE 65,A50,083695,Saad; Andrew S,12,0,30,18
1657343229315,ECE 65,A51,095125,Saad; Andrew S,24,0,26,2
1657343235346,ECE 109,A01,091882,Touri; Behrouz,19,0,70,51
1657343241369,ECE 180,A00,083140,Abi Samra; Nicholas Camill,1,0,30,29
1657343241369,ECE 180,B00,083141,Abi Samra; Nicholas Camill,0,0,30,30
1657343247394,MATH 10A,A01,083735,Patchell; Gregory David,2,0,30,28
1657343247394,MATH 10A,A02,083736,Patchell; Gregory David,20,0,30,10
1657343247394,MATH 10A,A03,083737,Patchell; Gregory David,16,0,30,14
1657343253417,MATH 10B,A01,083207,Lim; Seonhee,7,0,34,27
1657343253417,MATH 10B,A02,083208,Lim; Seonhee,9,0,35,26
1657343253417,MATH 10B,A03,093472,Lim; Seonhee,7,0,34,27
1657343253417,MATH 10B,B01,083739,Sinha; Shubham,12,0,30,18
1657343259442,MATH 18,A01,083743,Cinel; Cameron Alexander,7,0,30,23
1657343259442,MATH 18,A02,083744,Cinel; Cameron Alexander,17,0,30,13
1657343259442,MATH 18,A03,083745,Cinel; Cameron Alexander,9,0,30,21
1657343259442,MATH 18,B01,083748,Rideout; David Porter,5,0,37,32
1657343259442,MATH 18,B02,083749,Rideout; David Porter,5,0,36,31
1657343259442,MATH 18,B03,083750,Rideout; David Porter,3,0,37,34
1657343259442,MATH 18,B04,083751,Rideout; David Porter,6,0,36,30
1657343259442,MATH 18,B05,093473,Rideout; David Porter,6,0,36,30
1657343259442,MATH 18,B06,093474,Rideout; David Porter,6,0,36,30
1657343265481,MATH 20A,A01,083754,Zheng; Zequn,14,0,40,26
1657343271505,MATH 20B,A01,083756,Briones; Jor-el Thomas Caparas,4,0,36,32
1657343271505,MATH 20B,A02,083757,Briones; Jor-el Thomas Caparas,1,0,36,35
1657343271505,MATH 20B,A03,093475,Briones; Jor-el Thomas Caparas,2,0,36,34
1657343277528,MATH 20C,A01,083760,Briones; Jor-el Thomas Caparas,1,0,35,34
1657343277528,MATH 20C,A02,083761,Briones; Jor-el Thomas Caparas,8,0,35,27
1657343277528,MATH 20C,A03,093476,Briones; Jor-el Thomas Caparas,0,1,36,36
1657343277528,MATH 20C,B01,083762,Bach; Quang Tran,1,0,30,29
1657343283557,MATH 20D,A01,083765,Tran; Brian Kha,5,0,30,25
1657343283557,MATH 20D,A02,083766,Tran; Brian Kha,5,0,30,25
1657343283557,MATH 20D,A03,083767,Tran; Brian Kha,4,0,30,26
1657343289581,MATH 20E,A01,083771,Ganguly; Soumya,9,0,32,23
1657343289581,MATH 20E,A02,083772,Ganguly; Soumya,6,0,32,26
1657343289581,MATH 20E,B01,083773,Ciotti; Benjamin,20,0,35,15
1657343289581,MATH 20E,B02,083774,Ciotti; Benjamin,17,0,35,18
1657343295605,MATH 103A,A01,083777,Greenfeld; Be'Eri,3,0,36,33
1657343295605,MATH 103A,A02,083778,Greenfeld; Be'Eri,5,0,36,31
1657343295605,MATH 103A,A03,093561,Greenfeld; Be'Eri,4,0,36,32
1657343295605,MATH 103A,B01,083779,Greenfeld; Be'Eri,6,0,36,30
1657343295605,MATH 103A,B02,083780,Greenfeld; Be'Eri,4,0,36,32
1657343295605,MATH 103A,B03,093562,Greenfeld; Be'Eri,3,0,36,33
1657343301628,MATH 105,A01,085443,Carter; Anne Toulson,15,0,35,20
1657343301628,MATH 105,A02,093477,Carter; Anne Toulson,20,0,35,15
1657343307659,MATH 109,A01,083213,Ganzberger; Geoffrey Michael,2,0,34,32
1657343307659,MATH 109,A02,083214,Ganzberger; Geoffrey Michael,4,0,34,30
1657343307659,MATH 109,A03,093478,Ganzberger; Geoffrey Michael,2,0,34,32
1657343307659,MATH 109,B01,083215,Ganzberger; Geoffrey Michael,1,0,32,31
1657343307659,MATH 109,B02,083216,Ganzberger; Geoffrey Michael,1,0,32,31
1657343307659,MATH 109,B03,093479,Ganzberger; Geoffrey Michael,8,0,32,24
1657343313690,MATH 142A,A01,083219,Chow; Bennett,7,0,32,25
1657343313690,MATH 142A,A02,083220,Chow; Bennett,10,0,32,22
1657343313690,MATH 142A,A03,093480,Chow; Bennett,8,0,32,24
1657343313690,MATH 142A,B03,093481,Chow; Bennett,8,0,32,24
1657343313690,MATH 142A,B04,093558,Chow; Bennett,13,0,32,19
1657343313690,MATH 142A,B05,093559,Chow; Bennett,6,0,32,26
1657343319714,MATH 193A,A01,083224,Rotar; Vladimir,8,0,34,26
1657343319714,MATH 193A,A02,083225,Rotar; Vladimir,9,0,34,25
1657343319714,MATH 193A,A03,083781,Rotar; Vladimir,3,0,34,31
1657343319714,MATH 193A,A04,083782,Rotar; Vladimir,9,0,34,25
1657343319714,MATH 193A,A05,093482,Rotar; Vladimir,10,0,34,24
1657343325739,MATH 197,001,091859,McAuley; Julian John,9999,0,9999,0
1657343325739,MATH 197,002,095566,Kedlaya; Kiran S.,9997,0,9999,2
1657343325739,MATH 197,003,095567,Xiao; Ming,9999,0,9999,0
1657343325739,MATH 197,004,095571,Perols; Johan Lars,9998,0,9999,1
1657343332798,COGS 9,A01,083615,Shannon; Kyle Michael,8,0,75,67
1657343338820,COGS 11,A01,083617,Boyle; Mary E. T.,22,0,48,26
1657343344845,COGS 13,A01,083071,Bastos; Amalia Pinkusfeld,11,0,71,60
1657343350867,COGS 14A,A01,092681,Semenuks; Arturs,3,1,100,97
1657343356893,COGS 14B,A01,083073,Cheng; Tzu-Han,6,0,63,57
1657343362916,COGS 17,A01,092677,Semenuks; Arturs,6,0,81,75
1657343368946,COGS 100,A01,083619,Allen; Michael Gordon,16,0,70,54
1657343374969,COGS 101A,A01,083621,Davis; Joshua Daniel,9,0,68,59
1657343380995,COGS 101B,A01,091572,Allen; Michael Gordon,11,0,65,54
1657343387020,COGS 101C,A01,083625,Delgado; Tania,17,0,35,18
1657343393042,COGS 107A,A01,083627,Boyle; Mary E. T.,13,0,60,47
1657343399065,COGS 118A,A01,083075,Gupta; Anjum,20,0,76,56
1657343405093,CSE 3,A50,083646,Miranda; Gregory Joseph,24,0,50,26
1657343411116,CSE 8A,A50,083650,Miranda; Gregory Joseph,17,1,56,39
1657343417217,CSE 11,A01,083080,Cao; Yingjun,6,15,40,34
1657343423245,CSE 12,A01,083652,Krause-Levy; Sophia Louisa,28,1,120,92
1657343429268,CSE 15L,A01,083654,Morris; Justin Loren,9,0,50,41
1657343429268,CSE 15L,A02,083655,Morris; Justin Loren,9,0,50,41
1657343435291,CSE 20,A01,083657,Tran; Khoa Dang,39,0,80,41
1657343441314,CSE 21,A01,095574,Bach; Quang Tran,22,0,48,26
1657343447341,CSE 30,A01,083084,Eldon; John,4,0,80,76
1657343447341,CSE 30,B01,095061,Bhaskar; Nishant,9,0,50,41
1657343453364,CSE 100,A01,083659,Cao; Yingjun,5,4,70,65
1657343459387,CSE 134B,A01,083661,Powell; Thomas Allan,22,0,100,78
1657343465412,CSE 140,A01,083663,Gungor; Onat,14,0,85,71
1657343471433,CSE 140L,A01,083088,Eldon; John,21,0,100,79
1657343477456,CSE 175,A01,083665,Kumar; Rakesh,3,0,25,22
1657343483479,CSE 190,A00,092507,Dubnov; Shlomo,7,0,20,13
1657343489502,ECE 45,A01,083139,Congero; Spencer William,6,0,75,69
1657343495524,ECE 65,A50,083695,Saad; Andrew S,12,0,30,18
1657343495524,ECE 65,A51,095125,Saad; Andrew S,24,0,26,2
1657343501551,ECE 109,A01,091882,Touri; Behrouz,19,0,70,51
1657343507578,ECE 180,A00,083140,Abi Samra; Nicholas Camill,1,0,30,29
1657343507578,ECE 180,B00,083141,Abi Samra; Nicholas Camill,0,0,30,30
1657343513605,MATH 10A,A01,083735,Patchell; Gregory David,2,0,30,28
1657343513605,MATH 10A,A02,083736,Patchell; Gregory David,20,0,30,10
1657343513605,MATH 10A,A03,083737,Patchell; Gregory David,16,0,30,14
1657343519629,MATH 10B,A01,083207,Lim; Seonhee,8,0,34,26
1657343519629,MATH 10B,A02,083208,Lim; Seonhee,9,0,35,26
1657343519629,MATH 10B,A03,093472,Lim; Seonhee,7,0,34,27
1657343519629,MATH 10B,B01,083739,Sinha; Shubham,12,0,30,18
1657343525652,MATH 18,A01,083743,Cinel; Cameron Alexander,7,0,30,23
1657343525652,MATH 18,A02,083744,Cinel; Cameron Alexander,17,0,30,13
1657343525652,MATH 18,A03,083745,Cinel; Cameron Alexander,9,0,30,21
1657343525652,MATH 18,B01,083748,Rideout; David Porter,5,0,37,32
1657343525652,MATH 18,B02,083749,Rideout; David Porter,5,0,36,31
1657343525652,MATH 18,B03,083750,Rideout; David Porter,3,0,37,34
1657343525652,MATH 18,B04,083751,Rideout; David Porter,6,0,36,30
1657343525652,MATH 18,B05,093473,Rideout; David Porter,6,0,36,30
1657343525652,MATH 18,B06,093474,Rideout; David Porter,6,0,36,30
1657343531679,MATH 20A,A01,083754,Zheng; Zequn,14,0,40,26
1657343537706,MATH 20B,A01,083756,Briones; Jor-el Thomas Caparas,4,0,36,32
1657343537706,MATH 20B,A02,083757,Briones; Jor-el Thomas Caparas,1,0,36,35
1657343537706,MATH 20B,A03,093475,Briones; Jor-el Thomas Caparas,2,0,36,34
1657343543747,MATH 20C,A01,083760,Briones; Jor-el Thomas Caparas,1,0,35,34
1657343543747,MATH 20C,A02,083761,Briones; Jor-el Thomas Caparas,8,0,35,27
1657343543747,MATH 20C,A03,093476,Briones; Jor-el Thomas Caparas,0,1,36,36
1657343543747,MATH 20C,B01,083762,Bach; Quang Tran,1,0,30,29
1657343549771,MATH 20D,A01,083765,Tran; Brian Kha,5,0,30,25
1657343549771,MATH 20D,A02,083766,Tran; Brian Kha,5,0,30,25
1657343549771,MATH 20D,A03,083767,Tran; Brian Kha,4,0,30,26
1657343555813,MATH 20E,A01,083771,Ganguly; Soumya,9,0,32,23
1657343555813,MATH 20E,A02,083772,Ganguly; Soumya,6,0,32,26
1657343555813,MATH 20E,B01,083773,Ciotti; Benjamin,20,0,35,15
1657343555813,MATH 20E,B02,083774,Ciotti; Benjamin,17,0,35,18
1657343561839,MATH 103A,A01,083777,Greenfeld; Be'Eri,3,0,36,33
1657343561839,MATH 103A,A02,083778,Greenfeld; Be'Eri,5,0,36,31
1657343561839,MATH 103A,A03,093561,Greenfeld; Be'Eri,4,0,36,32
1657343561839,MATH 103A,B01,083779,Greenfeld; Be'Eri,6,0,36,30
1657343561839,MATH 103A,B02,083780,Greenfeld; Be'Eri,4,0,36,32
1657343561839,MATH 103A,B03,093562,Greenfeld; Be'Eri,3,0,36,33
1657343567862,MATH 105,A01,085443,Carter; Anne Toulson,15,0,35,20
1657343567862,MATH 105,A02,093477,Carter; Anne Toulson,20,0,35,15
1657343573886,MATH 109,A01,083213,Ganzberger; Geoffrey Michael,2,0,34,32
1657343573886,MATH 109,A02,083214,Ganzberger; Geoffrey Michael,4,0,34,30
1657343573886,MATH 109,A03,093478,Ganzberger; Geoffrey Michael,2,0,34,32
1657343573886,MATH 109,B01,083215,Ganzberger; Geoffrey Michael,1,0,32,31
1657343573886,MATH 109,B02,083216,Ganzberger; Geoffrey Michael,1,0,32,31
1657343573886,MATH 109,B03,093479,Ganzberger; Geoffrey Michael,8,0,32,24
1657343579910,MATH 142A,A01,083219,Chow; Bennett,7,0,32,25
1657343579910,MATH 142A,A02,083220,Chow; Bennett,10,0,32,22
1657343579910,MATH 142A,A03,093480,Chow; Bennett,8,0,32,24
1657343579910,MATH 142A,B03,093481,Chow; Bennett,8,0,32,24
1657343579910,MATH 142A,B04,093558,Chow; Bennett,13,0,32,19
1657343579910,MATH 142A,B05,093559,Chow; Bennett,6,0,32,26
1657343585933,MATH 193A,A01,083224,Rotar; Vladimir,8,0,34,26
1657343585933,MATH 193A,A02,083225,Rotar; Vladimir,9,0,34,25
1657343585933,MATH 193A,A03,083781,Rotar; Vladimir,3,0,34,31
1657343585933,MATH 193A,A04,083782,Rotar; Vladimir,9,0,34,25
1657343585933,MATH 193A,A05,093482,Rotar; Vladimir,10,0,34,24
1657343591958,MATH 197,001,091859,McAuley; Julian John,9999,0,9999,0
1657343591958,MATH 197,002,095566,Kedlaya; Kiran S.,9997,0,9999,2
1657343591958,MATH 197,003,095567,Xiao; Ming,9999,0,9999,0
1657343591958,MATH 197,004,095571,Perols; Johan Lars,9998,0,9999,1
1657343599016,COGS 9,A01,083615,Shannon; Kyle Michael,8,0,75,67
1657343605040,COGS 11,A01,083617,Boyle; Mary E. T.,22,0,48,26
1657343611070,COGS 13,A01,083071,Bastos; Amalia Pinkusfeld,11,0,71,60
1657343617096,COGS 14A,A01,092681,Semenuks; Arturs,3,1,100,97
1657343623117,COGS 14B,A01,083073,Cheng; Tzu-Han,6,0,63,57
1657343629140,COGS 17,A01,092677,Semenuks; Arturs,6,0,81,75
1657343635164,COGS 100,A01,083619,Allen; Michael Gordon,16,0,70,54
1657343641186,COGS 101A,A01,083621,Davis; Joshua Daniel,9,0,68,59
1657343647209,COGS 101B,A01,091572,Allen; Michael Gordon,11,0,65,54
1657343653236,COGS 101C,A01,083625,Delgado; Tania,17,0,35,18
1657343659263,COGS 107A,A01,083627,Boyle; Mary E. T.,13,0,60,47
1657343665285,COGS 118A,A01,083075,Gupta; Anjum,20,0,76,56
1657343671312,CSE 3,A50,083646,Miranda; Gregory Joseph,24,0,50,26
1657343677340,CSE 8A,A50,083650,Miranda; Gregory Joseph,17,1,56,39
1657343683363,CSE 11,A01,083080,Cao; Yingjun,6,15,40,34
1657343689385,CSE 12,A01,083652,Krause-Levy; Sophia Louisa,28,1,120,92
1657343695411,CSE 15L,A01,083654,Morris; Justin Loren,9,0,50,41
1657343695411,CSE 15L,A02,083655,Morris; Justin Loren,9,0,50,41
1657343701434,CSE 20,A01,083657,Tran; Khoa Dang,39,0,80,41
1657343707461,CSE 21,A01,095574,Bach; Quang Tran,22,0,48,26
1657343713484,CSE 30,A01,083084,Eldon; John,4,0,80,76
1657343713484,CSE 30,B01,095061,Bhaskar; Nishant,9,0,50,41
1657343719506,CSE 100,A01,083659,Cao; Yingjun,5,4,70,65
1657343725529,CSE 134B,A01,083661,Powell; Thomas Allan,22,0,100,78
1657343731550,CSE 140,A01,083663,Gungor; Onat,14,0,85,71
1657343737577,CSE 140L,A01,083088,Eldon; John,21,0,100,79
1657343743603,CSE 175,A01,083665,Kumar; Rakesh,3,0,25,22
1657343749627,CSE 190,A00,092507,Dubnov; Shlomo,7,0,20,13
1657343755649,ECE 45,A01,083139,Congero; Spencer William,6,0,75,69
1657343761675,ECE 65,A50,083695,Saad; Andrew S,12,0,30,18
1657343761675,ECE 65,A51,095125,Saad; Andrew S,24,0,26,2
1657343767699,ECE 109,A01,091882,Touri; Behrouz,19,0,70,51
1657343773721,ECE 180,A00,083140,Abi Samra; Nicholas Camill,1,0,30,29
1657343773721,ECE 180,B00,083141,Abi Samra; Nicholas Camill,0,0,30,30
1657343779747,MATH 10A,A01,083735,Patchell; Gregory David,2,0,30,28
1657343779747,MATH 10A,A02,083736,Patchell; Gregory David,20,0,30,10
1657343779747,MATH 10A,A03,083737,Patchell; Gregory David,16,0,30,14
1657343785779,MATH 10B,A01,083207,Lim; Seonhee,8,0,34,26
1657343785779,MATH 10B,A02,083208,Lim; Seonhee,9,0,35,26
1657343785779,MATH 10B,A03,093472,Lim; Seonhee,7,0,34,27
1657343785779,MATH 10B,B01,083739,Sinha; Shubham,12,0,30,18
1657343791811,MATH 18,A01,083743,Cinel; Cameron Alexander,7,0,30,23
1657343791811,MATH 18,A02,083744,Cinel; Cameron Alexander,17,0,30,13
1657343791811,MATH 18,A03,083745,Cinel; Cameron Alexander,9,0,30,21
1657343791811,MATH 18,B01,083748,Rideout; David Porter,5,0,37,32
1657343791811,MATH 18,B02,083749,Rideout; David Porter,5,0,36,31
1657343791811,MATH 18,B03,083750,Rideout; David Porter,3,0,37,34
1657343791811,MATH 18,B04,083751,Rideout; David Porter,6,0,36,30
1657343791811,MATH 18,B05,093473,Rideout; David Porter,6,0,36,30
1657343791811,MATH 18,B06,093474,Rideout; David Porter,6,0,36,30
1657343797838,MATH 20A,A01,083754,Zheng; Zequn,14,0,40,26
1657343803865,MATH 20B,A01,083756,Briones; Jor-el Thomas Caparas,4,0,36,32
1657343803865,MATH 20B,A02,083757,Briones; Jor-el Thomas Caparas,1,0,36,35
1657343803865,MATH 20B,A03,093475,Briones; Jor-el Thomas Caparas,2,0,36,34
1657343809897,MATH 20C,A01,083760,Briones; Jor-el Thomas Caparas,1,0,35,34
1657343809897,MATH 20C,A02,083761,Briones; Jor-el Thomas Caparas,8,0,35,27
1657343809897,MATH 20C,A03,093476,Briones; Jor-el Thomas Caparas,0,1,36,36
1657343809897,MATH 20C,B01,083762,Bach; Quang Tran,1,0,30,29
1657343815921,MATH 20D,A01,083765,Tran; Brian Kha,5,0,30,25
1657343815921,MATH 20D,A02,083766,Tran; Brian Kha,5,0,30,25
1657343815921,MATH 20D,A03,083767,Tran; Brian Kha,4,0,30,26
1657343821952,MATH 20E,A01,083771,Ganguly; Soumya,9,0,32,23
1657343821952,MATH 20E,A02,083772,Ganguly; Soumya,6,0,32,26
1657343821952,MATH 20E,B01,083773,Ciotti; Benjamin,20,0,35,15
1657343821952,MATH 20E,B02,083774,Ciotti; Benjamin,17,0,35,18
1657343827975,MATH 103A,A01,083777,Greenfeld; Be'Eri,3,0,36,33
1657343827975,MATH 103A,A02,083778,Greenfeld; Be'Eri,5,0,36,31
1657343827975,MATH 103A,A03,093561,Greenfeld; Be'Eri,4,0,36,32
1657343827975,MATH 103A,B01,083779,Greenfeld; Be'Eri,6,0,36,30
1657343827975,MATH 103A,B02,083780,Greenfeld; Be'Eri,4,0,36,32
1657343827975,MATH 103A,B03,093562,Greenfeld; Be'Eri,3,0,36,33
1657343834009,MATH 105,A01,085443,Carter; Anne Toulson,15,0,35,20
1657343834009,MATH 105,A02,093477,Carter; Anne Toulson,20,0,35,15
1657343840037,MATH 109,A01,083213,Ganzberger; Geoffrey Michael,2,0,34,32
1657343840037,MATH 109,A02,083214,Ganzberger; Geoffrey Michael,4,0,34,30
1657343840037,MATH 109,A03,093478,Ganzberger; Geoffrey Michael,2,0,34,32
1657343840037,MATH 109,B01,083215,Ganzberger; Geoffrey Michael,1,0,32,31
1657343840037,MATH 109,B02,083216,Ganzberger; Geoffrey Michael,1,0,32,31
1657343840037,MATH 109,B03,093479,Ganzberger; Geoffrey Michael,8,0,32,24
1657343846062,MATH 142A,A01,083219,Chow; Bennett,7,0,32,25
1657343846062,MATH 142A,A02,083220,Chow; Bennett,10,0,32,22
1657343846062,MATH 142A,A03,093480,Chow; Bennett,8,0,32,24
1657343846062,MATH 142A,B03,093481,Chow; Bennett,8,0,32,24
1657343846062,MATH 142A,B04,093558,Chow; Bennett,13,0,32,19
1657343846062,MATH 142A,B05,093559,Chow; Bennett,6,0,32,26
1657343852086,MATH 193A,A01,083224,Rotar; Vladimir,8,0,34,26
1657343852086,MATH 193A,A02,083225,Rotar; Vladimir,9,0,34,25
1657343852086,MATH 193A,A03,083781,Rotar; Vladimir,3,0,34,31
1657343852086,MATH 193A,A04,083782,Rotar; Vladimir,9,0,34,25
1657343852086,MATH 193A,A05,093482,Rotar; Vladimir,10,0,34,24
1657343858110,MATH 197,001,091859,McAuley; Julian John,9999,0,9999,0
1657343858110,MATH 197,002,095566,Kedlaya; Kiran S.,9997,0,9999,2
1657343858110,MATH 197,003,095567,Xiao; Ming,9999,0,9999,0
1657343858110,MATH 197,004,095571,Perols; Johan Lars,9998,0,9999,1
1657343865182,COGS 9,A01,083615,Shannon; Kyle Michael,8,0,75,67
1657343871204,COGS 11,A01,083617,Boyle; Mary E. T.,22,0,48,26
1657343877226,COGS 13,A01,083071,Bastos; Amalia Pinkusfeld,11,0,71,60
1657343883253,COGS 14A,A01,092681,Semenuks; Arturs,3,1,100,97
1657343889275,COGS 14B,A01,083073,Cheng; Tzu-Han,6,0,63,57
1657343895302,COGS 17,A01,092677,Semenuks; Arturs,6,0,81,75
1657343901332,COGS 100,A01,083619,Allen; Michael Gordon,16,0,70,54
1657343907356,COGS 101A,A01,083621,Davis; Joshua Daniel,9,0,68,59
1657343913382,COGS 101B,A01,091572,Allen; Michael Gordon,11,0,65,54
1657343919406,COGS 101C,A01,083625,Delgado; Tania,17,0,35,18
1657343925433,COGS 107A,A01,083627,Boyle; Mary E. T.,13,0,60,47
1657343931455,COGS 118A,A01,083075,Gupta; Anjum,20,0,76,56
1657343937482,CSE 3,A50,083646,Miranda; Gregory Joseph,24,0,50,26
1657343943507,CSE 8A,A50,083650,Miranda; Gregory Joseph,17,1,56,39
1657343949529,CSE 11,A01,083080,Cao; Yingjun,6,15,40,34
1657343955555,CSE 12,A01,083652,Krause-Levy; Sophia Louisa,28,1,120,92
1657343961577,CSE 15L,A01,083654,Morris; Justin Loren,9,0,50,41
1657343961577,CSE 15L,A02,083655,Morris; Justin Loren,9,0,50,41
1657343967602,CSE 20,A01,083657,Tran; Khoa Dang,39,0,80,41
1657343973629,CSE 21,A01,095574,Bach; Quang Tran,22,0,48,26
1657343979654,CSE 30,A01,083084,Eldon; John,4,0,80,76
1657343979654,CSE 30,B01,095061,Bhaskar; Nishant,9,0,50,41
1657343985679,CSE 100,A01,083659,Cao; Yingjun,5,4,70,65
1657343991703,CSE 134B,A01,083661,Powell; Thomas Allan,22,0,100,78
1657343997730,CSE 140,A01,083663,Gungor; Onat,14,0,85,71
1657344003756,CSE 140L,A01,083088,Eldon; John,21,0,100,79
1657344009782,CSE 175,A01,083665,Kumar; Rakesh,3,0,25,22
1657344015908,CSE 190,A00,092507,Dubnov; Shlomo,7,0,20,13
1657344021934,ECE 45,A01,083139,Congero; Spencer William,6,0,75,69
1657344027961,ECE 65,A50,083695,Saad; Andrew S,12,0,30,18
1657344027961,ECE 65,A51,095125,Saad; Andrew S,24,0,26,2
1657344033988,ECE 109,A01,091882,Touri; Behrouz,19,0,70,51
1657344040011,ECE 180,A00,083140,Abi Samra; Nicholas Camill,1,0,30,29
1657344040011,ECE 180,B00,083141,Abi Samra; Nicholas Camill,0,0,30,30
1657344046034,MATH 10A,A01,083735,Patchell; Gregory David,2,0,30,28
1657344046034,MATH 10A,A02,083736,Patchell; Gregory David,20,0,30,10
1657344046034,MATH 10A,A03,083737,Patchell; Gregory David,16,0,30,14
1657344052058,MATH 10B,A01,083207,Lim; Seonhee,8,0,34,26
1657344052058,MATH 10B,A02,083208,Lim; Seonhee,9,0,35,26
1657344052058,MATH 10B,A03,093472,Lim; Seonhee,7,0,34,27
1657344052058,MATH 10B,B01,083739,Sinha; Shubham,12,0,30,18
1657344058088,MATH 18,A01,083743,Cinel; Cameron Alexander,7,0,30,23
1657344058088,MATH 18,A02,083744,Cinel; Cameron Alexander,17,0,30,13
1657344058088,MATH 18,A03,083745,Cinel; Cameron Alexander,9,0,30,21
1657344058088,MATH 18,B01,083748,Rideout; David Porter,5,0,37,32
1657344058088,MATH 18,B02,083749,Rideout; David Porter,5,0,36,31
1657344058088,MATH 18,B03,083750,Rideout; David Porter,3,0,37,34
1657344058088,MATH 18,B04,083751,Rideout; David Porter,6,0,36,30
1657344058088,MATH 18,B05,093473,Rideout; David Porter,6,0,36,30
1657344058088,MATH 18,B06,093474,Rideout; David Porter,6,0,36,30
1657344064114,MATH 20A,A01,083754,Zheng; Zequn,14,0,40,26
1657344070140,MATH 20B,A01,083756,Briones; Jor-el Thomas Caparas,4,0,36,32
1657344070140,MATH 20B,A02,083757,Briones; Jor-el Thomas Caparas,1,0,36,35
1657344070140,MATH 20B,A03,093475,Briones; Jor-el Thomas Caparas,2,0,36,34
1657344076169,MATH 20C,A01,083760,Briones; Jor-el Thomas Caparas,1,0,35,34
1657344076169,MATH 20C,A02,083761,Briones; Jor-el Thomas Caparas,8,0,35,27
1657344076169,MATH 20C,A03,093476,Briones; Jor-el Thomas Caparas,0,1,36,36
1657344076169,MATH 20C,B01,083762,Bach; Quang Tran,1,0,30,29
1657344082192,MATH 20D,A01,083765,Tran; Brian Kha,5,0,30,25
1657344082192,MATH 20D,A02,083766,Tran; Brian Kha,5,0,30,25
1657344082192,MATH 20D,A03,083767,Tran; Brian Kha,4,0,30,26
1657344088219,MATH 20E,A01,083771,Ganguly; Soumya,9,0,32,23
1657344088219,MATH 20E,A02,083772,Ganguly; Soumya,6,0,32,26
1657344088219,MATH 20E,B01,083773,Ciotti; Benjamin,20,0,35,15
1657344088219,MATH 20E,B02,083774,Ciotti; Benjamin,17,0,35,18
1657344094243,MATH 103A,A01,083777,Greenfeld; Be'Eri,3,0,36,33
1657344094243,MATH 103A,A02,083778,Greenfeld; Be'Eri,5,0,36,31
1657344094243,MATH 103A,A03,093561,Greenfeld; Be'Eri,4,0,36,32
1657344094243,MATH 103A,B01,083779,Greenfeld; Be'Eri,6,0,36,30
1657344094243,MATH 103A,B02,083780,Greenfeld; Be'Eri,4,0,36,32
1657344094243,MATH 103A,B03,093562,Greenfeld; Be'Eri,3,0,36,33
1657344100269,MATH 105,A01,085443,Carter; Anne Toulson,15,0,35,20
1657344100269,MATH 105,A02,093477,Carter; Anne Toulson,20,0,35,15
1657344106298,MATH 109,A01,083213,Ganzberger; Geoffrey Michael,2,0,34,32
1657344106298,MATH 109,A02,083214,Ganzberger; Geoffrey Michael,4,0,34,30
1657344106298,MATH 109,A03,093478,Ganzberger; Geoffrey Michael,2,0,34,32
1657344106298,MATH 109,B01,083215,Ganzberger; Geoffrey Michael,1,0,32,31
1657344106298,MATH 109,B02,083216,Ganzberger; Geoffrey Michael,1,0,32,31
1657344106298,MATH 109,B03,093479,Ganzberger; Geoffrey Michael,8,0,32,24
1657344112324,MATH 142A,A01,083219,Chow; Bennett,7,0,32,25
1657344112324,MATH 142A,A02,083220,Chow; Bennett,10,0,32,22
1657344112324,MATH 142A,A03,093480,Chow; Bennett,8,0,32,24
1657344112324,MATH 142A,B03,093481,Chow; Bennett,8,0,32,24
1657344112324,MATH 142A,B04,093558,Chow; Bennett,13,0,32,19
1657344112324,MATH 142A,B05,093559,Chow; Bennett,6,0,32,26
1657344118353,MATH 193A,A01,083224,Rotar; Vladimir,8,0,34,26
1657344118353,MATH 193A,A02,083225,Rotar; Vladimir,9,0,34,25
1657344118353,MATH 193A,A03,083781,Rotar; Vladimir,4,0,34,30
1657344118353,MATH 193A,A04,083782,Rotar; Vladimir,9,0,34,25
1657344118353,MATH 193A,A05,093482,Rotar; Vladimir,10,0,34,24
1657344124374,MATH 197,001,091859,McAuley; Julian John,9999,0,9999,0
1657344124374,MATH 197,002,095566,Kedlaya; Kiran S.,9997,0,9999,2
1657344124374,MATH 197,003,095567,Xiao; Ming,9999,0,9999,0
1657344124374,MATH 197,004,095571,Perols; Johan Lars,9998,0,9999,1
1657344131437,COGS 9,A01,083615,Shannon; Kyle Michael,8,0,75,67
1657344137461,COGS 11,A01,083617,Boyle; Mary E. T.,22,0,48,26
1657344143485,COGS 13,A01,083071,Bastos; Amalia Pinkusfeld,11,0,71,60
1657344149509,COGS 14A,A01,092681,Semenuks; Arturs,3,1,100,97
1657344155535,COGS 14B,A01,083073,Cheng; Tzu-Han,6,0,63,57
1657344161561,COGS 17,A01,092677,Semenuks; Arturs,6,0,81,75
1657344167591,COGS 100,A01,083619,Allen; Michael Gordon,16,0,70,54
1657344173615,COGS 101A,A01,083621,Davis; Joshua Daniel,9,0,68,59
1657344179637,COGS 101B,A01,091572,Allen; Michael Gordon,11,0,65,54
1657344185664,COGS 101C,A01,083625,Delgado; Tania,17,0,35,18
1657344191686,COGS 107A,A01,083627,Boyle; Mary E. T.,13,0,60,47
1657344197708,COGS 118A,A01,083075,Gupta; Anjum,20,0,76,56
1657344203733,CSE 3,A50,083646,Miranda; Gregory Joseph,24,0,50,26
1657344209763,CSE 8A,A50,083650,Miranda; Gregory Joseph,17,1,56,39
1657344215794,CSE 11,A01,083080,Cao; Yingjun,6,15,40,34
1657344221820,CSE 12,A01,083652,Krause-Levy; Sophia Louisa,28,1,120,92
1657344227846,CSE 15L,A01,083654,Morris; Justin Loren,9,0,50,41
1657344227846,CSE 15L,A02,083655,Morris; Justin Loren,9,0,50,41
1657344233869,CSE 20,A01,083657,Tran; Khoa Dang,39,0,80,41
1657344239892,CSE 21,A01,095574,Bach; Quang Tran,22,0,48,26
1657344245934,CSE 30,A01,083084,Eldon; John,4,0,80,76
1657344245934,CSE 30,B01,095061,Bhaskar; Nishant,9,0,50,41
1657344251973,CSE 100,A01,083659,Cao; Yingjun,5,4,70,65
1657344257995,CSE 134B,A01,083661,Powell; Thomas Allan,22,0,100,78
1657344264017,CSE 140,A01,083663,Gungor; Onat,14,0,85,71
1657344270044,CSE 140L,A01,083088,Eldon; John,21,0,100,79
1657344276071,CSE 175,A01,083665,Kumar; Rakesh,3,0,25,22
1657344282098,CSE 190,A00,092507,Dubnov; Shlomo,7,0,20,13
1657344288120,ECE 45,A01,083139,Congero; Spencer William,6,0,75,69
1657344294147,ECE 65,A50,083695,Saad; Andrew S,12,0,30,18
1657344294147,ECE 65,A51,095125,Saad; Andrew S,24,0,26,2
1657344300181,ECE 109,A01,091882,Touri; Behrouz,19,0,70,51
1657344306207,ECE 180,A00,083140,Abi Samra; Nicholas Camill,1,0,30,29
1657344306207,ECE 180,B00,083141,Abi Samra; Nicholas Camill,0,0,30,30
1657344312231,MATH 10A,A01,083735,Patchell; Gregory David,2,0,30,28
1657344312231,MATH 10A,A02,083736,Patchell; Gregory David,20,0,30,10
1657344312231,MATH 10A,A03,083737,Patchell; Gregory David,16,0,30,14
1657344318255,MATH 10B,A01,083207,Lim; Seonhee,8,0,34,26
1657344318255,MATH 10B,A02,083208,Lim; Seonhee,9,0,35,26
1657344318255,MATH 10B,A03,093472,Lim; Seonhee,7,0,34,27
1657344318255,MATH 10B,B01,083739,Sinha; Shubham,12,0,30,18
1657344324286,MATH 18,A01,083743,Cinel; Cameron Alexander,7,0,30,23
1657344324286,MATH 18,A02,083744,Cinel; Cameron Alexander,17,0,30,13
1657344324286,MATH 18,A03,083745,Cinel; Cameron Alexander,9,0,30,21
1657344324286,MATH 18,B01,083748,Rideout; David Porter,5,0,37,32
1657344324286,MATH 18,B02,083749,Rideout; David Porter,5,0,36,31
1657344324286,MATH 18,B03,083750,Rideout; David Porter,3,0,37,34
1657344324286,MATH 18,B04,083751,Rideout; David Porter,6,0,36,30
1657344324286,MATH 18,B05,093473,Rideout; David Porter,6,0,36,30
1657344324286,MATH 18,B06,093474,Rideout; David Porter,6,0,36,30
1657344330308,MATH 20A,A01,083754,Zheng; Zequn,14,0,40,26
1657344336336,MATH 20B,A01,083756,Briones; Jor-el Thomas Caparas,4,0,36,32
1657344336336,MATH 20B,A02,083757,Briones; Jor-el Thomas Caparas,1,0,36,35
1657344336336,MATH 20B,A03,093475,Briones; Jor-el Thomas Caparas,2,0,36,34
1657344342370,MATH 20C,A01,083760,Briones; Jor-el Thomas Caparas,1,0,35,34
1657344342370,MATH 20C,A02,083761,Briones; Jor-el Thomas Caparas,8,0,35,27
1657344342370,MATH 20C,A03,093476,Briones; Jor-el Thomas Caparas,0,1,36,36
1657344342370,MATH 20C,B01,083762,Bach; Quang Tran,1,0,30,29
1657344348395,MATH 20D,A01,083765,Tran; Brian Kha,5,0,30,25
1657344348395,MATH 20D,A02,083766,Tran; Brian Kha,5,0,30,25
1657344348395,MATH 20D,A03,083767,Tran; Brian Kha,4,0,30,26
1657344354420,MATH 20E,A01,083771,Ganguly; Soumya,9,0,32,23
1657344354420,MATH 20E,A02,083772,Ganguly; Soumya,6,0,32,26
1657344354420,MATH 20E,B01,083773,Ciotti; Benjamin,20,0,35,15
1657344354420,MATH 20E,B02,083774,Ciotti; Benjamin,17,0,35,18
1657344360445,MATH 103A,A01,083777,Greenfeld; Be'Eri,3,0,36,33
1657344360445,MATH 103A,A02,083778,Greenfeld; Be'Eri,5,0,36,31
1657344360445,MATH 103A,A03,093561,Greenfeld; Be'Eri,4,0,36,32
1657344360445,MATH 103A,B01,083779,Greenfeld; Be'Eri,6,0,36,30
1657344360445,MATH 103A,B02,083780,Greenfeld; Be'Eri,4,0,36,32
1657344360445,MATH 103A,B03,093562,Greenfeld; Be'Eri,3,0,36,33
1657344366473,MATH 105,A01,085443,Carter; Anne Toulson,15,0,35,20
1657344366473,MATH 105,A02,093477,Carter; Anne Toulson,20,0,35,15
1657344372497,MATH 109,A01,083213,Ganzberger; Geoffrey Michael,2,0,34,32
1657344372497,MATH 109,A02,083214,Ganzberger; Geoffrey Michael,4,0,34,30
1657344372497,MATH 109,A03,093478,Ganzberger; Geoffrey Michael,2,0,34,32
1657344372497,MATH 109,B01,083215,Ganzberger; Geoffrey Michael,1,0,32,31
1657344372497,MATH 109,B02,083216,Ganzberger; Geoffrey Michael,1,0,32,31
1657344372497,MATH 109,B03,093479,Ganzberger; Geoffrey Michael,8,0,32,24
1657344378521,MATH 142A,A01,083219,Chow; Bennett,7,0,32,25
1657344378521,MATH 142A,A02,083220,Chow; Bennett,10,0,32,22
1657344378521,MATH 142A,A03,093480,Chow; Bennett,8,0,32,24
1657344378521,MATH 142A,B03,093481,Chow; Bennett,8,0,32,24
1657344378521,MATH 142A,B04,093558,Chow; Bennett,13,0,32,19
1657344378521,MATH 142A,B05,093559,Chow; Bennett,6,0,32,26
1657344384546,MATH 193A,A01,083224,Rotar; Vladimir,8,0,34,26
1657344384546,MATH 193A,A02,083225,Rotar; Vladimir,9,0,34,25
1657344384546,MATH 193A,A03,083781,Rotar; Vladimir,4,0,34,30
1657344384546,MATH 193A,A04,083782,Rotar; Vladimir,9,0,34,25
1657344384546,MATH 193A,A05,093482,Rotar; Vladimir,10,0,34,24
1657344390575,MATH 197,001,091859,McAuley; Julian John,9999,0,9999,0
1657344390575,MATH 197,002,095566,Kedlaya; Kiran S.,9997,0,9999,2
1657344390575,MATH 197,003,095567,Xiao; Ming,9999,0,9999,0
1657344390575,MATH 197,004,095571,Perols; Johan Lars,9998,0,9999,1
1657344397637,COGS 9,A01,083615,Shannon; Kyle Michael,8,0,75,67
1657344403663,COGS 11,A01,083617,Boyle; Mary E. T.,22,0,48,26
1657344409688,COGS 13,A01,083071,Bastos; Amalia Pinkusfeld,11,0,71,60
1657344415716,COGS 14A,A01,092681,Semenuks; Arturs,3,1,100,97
1657344421754,COGS 14B,A01,083073,Cheng; Tzu-Han,6,0,63,57
1657344427775,COGS 17,A01,092677,Semenuks; Arturs,6,0,81,75
1657344433802,COGS 100,A01,083619,Allen; Michael Gordon,16,0,70,54
1657344439825,COGS 101A,A01,083621,Davis; Joshua Daniel,9,0,68,59
1657344445846,COGS 101B,A01,091572,Allen; Michael Gordon,11,0,65,54
1657344451870,COGS 101C,A01,083625,Delgado; Tania,17,0,35,18
1657344457906,COGS 107A,A01,083627,Boyle; Mary E. T.,13,0,60,47
1657344463930,COGS 118A,A01,083075,Gupta; Anjum,20,0,76,56
1657344469955,CSE 3,A50,083646,Miranda; Gregory Joseph,24,0,50,26
1657344475977,CSE 8A,A50,083650,Miranda; Gregory Joseph,17,1,56,39
1657344482002,CSE 11,A01,083080,Cao; Yingjun,6,15,40,34
1657344488029,CSE 12,A01,083652,Krause-Levy; Sophia Louisa,28,1,120,92
1657344494055,CSE 15L,A01,083654,Morris; Justin Loren,9,0,50,41
1657344494055,CSE 15L,A02,083655,Morris; Justin Loren,9,0,50,41
1657344500080,CSE 20,A01,083657,Tran; Khoa Dang,39,0,80,41
1657344506105,CSE 21,A01,095574,Bach; Quang Tran,22,0,48,26
1657344512128,CSE 30,A01,083084,Eldon; John,4,0,80,76
1657344512128,CSE 30,B01,095061,Bhaskar; Nishant,9,0,50,41
1657344518153,CSE 100,A01,083659,Cao; Yingjun,5,4,70,65
1657344524176,CSE 134B,A01,083661,Powell; Thomas Allan,22,0,100,78
1657344530207,CSE 140,A01,083663,Gungor; Onat,14,0,85,71
1657344536237,CSE 140L,A01,083088,Eldon; John,21,0,100,79
1657344542261,CSE 175,A01,083665,Kumar; Rakesh,3,0,25,22
1657344548285,CSE 190,A00,092507,Dubnov; Shlomo,7,0,20,13
1657344554308,ECE 45,A01,083139,Congero; Spencer William,6,0,75,69
1657344560334,ECE 65,A50,083695,Saad; Andrew S,12,0,30,18
1657344560334,ECE 65,A51,095125,Saad; Andrew S,24,0,26,2
1657344566356,ECE 109,A01,091882,Touri; Behrouz,19,0,70,51
1657344572383,ECE 180,A00,083140,Abi Samra; Nicholas Camill,1,0,30,29
1657344572383,ECE 180,B00,083141,Abi Samra; Nicholas Camill,0,0,30,30
1657344578407,MATH 10A,A01,083735,Patchell; Gregory David,2,0,30,28
1657344578407,MATH 10A,A02,083736,Patchell; Gregory David,20,0,30,10
1657344578407,MATH 10A,A03,083737,Patchell; Gregory David,16,0,30,14
1657344584432,MATH 10B,A01,083207,Lim; Seonhee,8,0,34,26
1657344584432,MATH 10B,A02,083208,Lim; Seonhee,9,0,35,26
1657344584432,MATH 10B,A03,093472,Lim; Seonhee,7,0,34,27
1657344584432,MATH 10B,B01,083739,Sinha; Shubham,12,0,30,18
1657344590465,MATH 18,A01,083743,Cinel; Cameron Alexander,7,0,30,23
1657344590465,MATH 18,A02,083744,Cinel; Cameron Alexander,17,0,30,13
1657344590465,MATH 18,A03,083745,Cinel; Cameron Alexander,9,0,30,21
1657344590465,MATH 18,B01,083748,Rideout; David Porter,5,0,37,32
1657344590465,MATH 18,B02,083749,Rideout; David Porter,5,0,36,31
1657344590465,MATH 18,B03,083750,Rideout; David Porter,3,0,37,34
1657344590465,MATH 18,B04,083751,Rideout; David Porter,6,0,36,30
1657344590465,MATH 18,B05,093473,Rideout; David Porter,6,0,36,30
1657344590465,MATH 18,B06,093474,Rideout; David Porter,6,0,36,30
1657344596489,MATH 20A,A01,083754,Zheng; Zequn,14,0,40,26
1657344602517,MATH 20B,A01,083756,Briones; Jor-el Thomas Caparas,4,0,36,32
1657344602517,MATH 20B,A02,083757,Briones; Jor-el Thomas Caparas,1,0,36,35
1657344602517,MATH 20B,A03,093475,Briones; Jor-el Thomas Caparas,2,0,36,34
1657344608545,MATH 20C,A01,083760,Briones; Jor-el Thomas Caparas,1,0,35,34
1657344608545,MATH 20C,A02,083761,Briones; Jor-el Thomas Caparas,8,0,35,27
1657344608545,MATH 20C,A03,093476,Briones; Jor-el Thomas Caparas,0,1,36,36
1657344608545,MATH 20C,B01,083762,Bach; Quang Tran,1,0,30,29
1657344614640,MATH 20D,A01,083765,Tran; Brian Kha,5,0,30,25
1657344614640,MATH 20D,A02,083766,Tran; Brian Kha,5,0,30,25
1657344614640,MATH 20D,A03,083767,Tran; Brian Kha,4,0,30,26
1657344620666,MATH 20E,A01,083771,Ganguly; Soumya,9,0,32,23
1657344620666,MATH 20E,A02,083772,Ganguly; Soumya,6,0,32,26
1657344620666,MATH 20E,B01,083773,Ciotti; Benjamin,20,0,35,15
1657344620666,MATH 20E,B02,083774,Ciotti; Benjamin,17,0,35,18
1657344626689,MATH 103A,A01,083777,Greenfeld; Be'Eri,3,0,36,33
1657344626689,MATH 103A,A02,083778,Greenfeld; Be'Eri,5,0,36,31
1657344626689,MATH 103A,A03,093561,Greenfeld; Be'Eri,4,0,36,32
1657344626689,MATH 103A,B01,083779,Greenfeld; Be'Eri,6,0,36,30
1657344626689,MATH 103A,B02,083780,Greenfeld; Be'Eri,4,0,36,32
1657344626689,MATH 103A,B03,093562,Greenfeld; Be'Eri,3,0,36,33
1657344632712,MATH 105,A01,085443,Carter; Anne Toulson,15,0,35,20
1657344632712,MATH 105,A02,093477,Carter; Anne Toulson,20,0,35,15
1657344638741,MATH 109,A01,083213,Ganzberger; Geoffrey Michael,2,0,34,32
1657344638741,MATH 109,A02,083214,Ganzberger; Geoffrey Michael,4,0,34,30
1657344638741,MATH 109,A03,093478,Ganzberger; Geoffrey Michael,2,0,34,32
1657344638741,MATH 109,B01,083215,Ganzberger; Geoffrey Michael,1,0,32,31
1657344638741,MATH 109,B02,083216,Ganzberger; Geoffrey Michael,1,0,32,31
1657344638741,MATH 109,B03,093479,Ganzberger; Geoffrey Michael,8,0,32,24
1657344644769,MATH 142A,A01,083219,Chow; Bennett,7,0,32,25
1657344644769,MATH 142A,A02,083220,Chow; Bennett,10,0,32,22
1657344644769,MATH 142A,A03,093480,Chow; Bennett,8,0,32,24
1657344644769,MATH 142A,B03,093481,Chow; Bennett,8,0,32,24
1657344644769,MATH 142A,B04,093558,Chow; Bennett,13,0,32,19
1657344644769,MATH 142A,B05,093559,Chow; Bennett,6,0,32,26
1657344650799,MATH 193A,A01,083224,Rotar; Vladimir,8,0,34,26
1657344650799,MATH 193A,A02,083225,Rotar; Vladimir,9,0,34,25
1657344650799,MATH 193A,A03,083781,Rotar; Vladimir,4,0,34,30
1657344650799,MATH 193A,A04,083782,Rotar; Vladimir,9,0,34,25
1657344650799,MATH 193A,A05,093482,Rotar; Vladimir,10,0,34,24
1657344656825,MATH 197,001,091859,McAuley; Julian John,9999,0,9999,0
1657344656825,MATH 197,002,095566,Kedlaya; Kiran S.,9997,0,9999,2
1657344656825,MATH 197,003,095567,Xiao; Ming,9999,0,9999,0
1657344656825,MATH 197,004,095571,Perols; Johan Lars,9998,0,9999,1
1657344663880,COGS 9,A01,083615,Shannon; Kyle Michael,8,0,75,67
1657344669903,COGS 11,A01,083617,Boyle; Mary E. T.,22,0,48,26
1657344675926,COGS 13,A01,083071,Bastos; Amalia Pinkusfeld,11,0,71,60
1657344681952,COGS 14A,A01,092681,Semenuks; Arturs,3,1,100,97
1657344687976,COGS 14B,A01,083073,Cheng; Tzu-Han,6,0,63,57
1657344693998,COGS 17,A01,092677,Semenuks; Arturs,6,0,81,75
1657344700022,COGS 100,A01,083619,Allen; Michael Gordon,16,0,70,54
1657344706045,COGS 101A,A01,083621,Davis; Joshua Daniel,9,0,68,59
1657344712072,COGS 101B,A01,091572,Allen; Michael Gordon,11,0,65,54
1657344718099,COGS 101C,A01,083625,Delgado; Tania,17,0,35,18
1657344724127,COGS 107A,A01,083627,Boyle; Mary E. T.,13,0,60,47
1657344730153,COGS 118A,A01,083075,Gupta; Anjum,20,0,76,56
1657344736190,CSE 3,A50,083646,Miranda; Gregory Joseph,24,0,50,26
1657344742215,CSE 8A,A50,083650,Miranda; Gregory Joseph,17,1,56,39
1657344748237,CSE 11,A01,083080,Cao; Yingjun,6,15,40,34
1657344754265,CSE 12,A01,083652,Krause-Levy; Sophia Louisa,28,1,120,92
1657344760288,CSE 15L,A01,083654,Morris; Justin Loren,9,0,50,41
1657344760288,CSE 15L,A02,083655,Morris; Justin Loren,9,0,50,41
1657344766313,CSE 20,A01,083657,Tran; Khoa Dang,39,0,80,41
1657344772343,CSE 21,A01,095574,Bach; Quang Tran,22,0,48,26
1657344778371,CSE 30,A01,083084,Eldon; John,4,0,80,76
1657344778371,CSE 30,B01,095061,Bhaskar; Nishant,9,0,50,41
1657344784397,CSE 100,A01,083659,Cao; Yingjun,5,4,70,65
1657344790426,CSE 134B,A01,083661,Powell; Thomas Allan,22,0,100,78
1657344796453,CSE 140,A01,083663,Gungor; Onat,14,0,85,71
1657344802479,CSE 140L,A01,083088,Eldon; John,21,0,100,79
1657344808503,CSE 175,A01,083665,Kumar; Rakesh,3,0,25,22
1657344814529,CSE 190,A00,092507,Dubnov; Shlomo,7,0,20,13
1657344820552,ECE 45,A01,083139,Congero; Spencer William,6,0,75,69
1657344826579,ECE 65,A50,083695,Saad; Andrew S,12,0,30,18
1657344826579,ECE 65,A51,095125,Saad; Andrew S,24,0,26,2
1657344832601,ECE 109,A01,091882,Touri; Behrouz,19,0,70,51
1657344838624,ECE 180,A00,083140,Abi Samra; Nicholas Camill,1,0,30,29
1657344838624,ECE 180,B00,083141,Abi Samra; Nicholas Camill,0,0,30,30
1657344844647,MATH 10A,A01,083735,Patchell; Gregory David,2,0,30,28
1657344844647,MATH 10A,A02,083736,Patchell; Gregory David,20,0,30,10
1657344844647,MATH 10A,A03,083737,Patchell; Gregory David,16,0,30,14
1657344850670,MATH 10B,A01,083207,Lim; Seonhee,8,0,34,26
1657344850670,MATH 10B,A02,083208,Lim; Seonhee,9,0,35,26
1657344850670,MATH 10B,A03,093472,Lim; Seonhee,7,0,34,27
1657344850670,MATH 10B,B01,083739,Sinha; Shubham,12,0,30,18
1657344856702,MATH 18,A01,083743,Cinel; Cameron Alexander,7,0,30,23
1657344856702,MATH 18,A02,083744,Cinel; Cameron Alexander,17,0,30,13
1657344856702,MATH 18,A03,083745,Cinel; Cameron Alexander,9,0,30,21
1657344856702,MATH 18,B01,083748,Rideout; David Porter,5,0,37,32
1657344856702,MATH 18,B02,083749,Rideout; David Porter,5,0,36,31
1657344856702,MATH 18,B03,083750,Rideout; David Porter,3,0,37,34
1657344856702,MATH 18,B04,083751,Rideout; David Porter,6,0,36,30
1657344856702,MATH 18,B05,093473,Rideout; David Porter,6,0,36,30
1657344856702,MATH 18,B06,093474,Rideout; David Porter,6,0,36,30
1657344862728,MATH 20A,A01,083754,Zheng; Zequn,14,0,40,26
1657344868750,MATH 20B,A01,083756,Briones; Jor-el Thomas Caparas,4,0,36,32
1657344868750,MATH 20B,A02,083757,Briones; Jor-el Thomas Caparas,1,0,36,35
1657344868750,MATH 20B,A03,093475,Briones; Jor-el Thomas Caparas,2,0,36,34
1657344874773,MATH 20C,A01,083760,Briones; Jor-el Thomas Caparas,1,0,35,34
1657344874773,MATH 20C,A02,083761,Briones; Jor-el Thomas Caparas,8,0,35,27
1657344874773,MATH 20C,A03,093476,Briones; Jor-el Thomas Caparas,0,1,36,36
1657344874773,MATH 20C,B01,083762,Bach; Quang Tran,1,0,30,29
1657344880805,MATH 20D,A01,083765,Tran; Brian Kha,5,0,30,25
1657344880805,MATH 20D,A02,083766,Tran; Brian Kha,5,0,30,25
1657344880805,MATH 20D,A03,083767,Tran; Brian Kha,4,0,30,26
1657344886828,MATH 20E,A01,083771,Ganguly; Soumya,9,0,32,23
1657344886828,MATH 20E,A02,083772,Ganguly; Soumya,6,0,32,26
1657344886828,MATH 20E,B01,083773,Ciotti; Benjamin,20,0,35,15
1657344886828,MATH 20E,B02,083774,Ciotti; Benjamin,17,0,35,18
1657344892853,MATH 103A,A01,083777,Greenfeld; Be'Eri,3,0,36,33
1657344892853,MATH 103A,A02,083778,Greenfeld; Be'Eri,5,0,36,31
1657344892853,MATH 103A,A03,093561,Greenfeld; Be'Eri,4,0,36,32
1657344892853,MATH 103A,B01,083779,Greenfeld; Be'Eri,6,0,36,30
1657344892853,MATH 103A,B02,083780,Greenfeld; Be'Eri,4,0,36,32
1657344892853,MATH 103A,B03,093562,Greenfeld; Be'Eri,3,0,36,33
1657344898876,MATH 105,A01,085443,Carter; Anne Toulson,15,0,35,20
1657344898876,MATH 105,A02,093477,Carter; Anne Toulson,20,0,35,15
1657344904902,MATH 109,A01,083213,Ganzberger; Geoffrey Michael,2,0,34,32
1657344904902,MATH 109,A02,083214,Ganzberger; Geoffrey Michael,4,0,34,30
1657344904902,MATH 109,A03,093478,Ganzberger; Geoffrey Michael,2,0,34,32
1657344904902,MATH 109,B01,083215,Ganzberger; Geoffrey Michael,1,0,32,31
1657344904902,MATH 109,B02,083216,Ganzberger; Geoffrey Michael,1,0,32,31
1657344904902,MATH 109,B03,093479,Ganzberger; Geoffrey Michael,8,0,32,24
1657344910926,MATH 142A,A01,083219,Chow; Bennett,7,0,32,25
1657344910926,MATH 142A,A02,083220,Chow; Bennett,10,0,32,22
1657344910926,MATH 142A,A03,093480,Chow; Bennett,8,0,32,24
1657344910926,MATH 142A,B03,093481,Chow; Bennett,8,0,32,24
1657344910926,MATH 142A,B04,093558,Chow; Bennett,13,0,32,19
1657344910926,MATH 142A,B05,093559,Chow; Bennett,6,0,32,26
1657344916956,MATH 193A,A01,083224,Rotar; Vladimir,8,0,34,26
1657344916956,MATH 193A,A02,083225,Rotar; Vladimir,9,0,34,25
1657344916956,MATH 193A,A03,083781,Rotar; Vladimir,4,0,34,30
1657344916956,MATH 193A,A04,083782,Rotar; Vladimir,9,0,34,25
1657344916956,MATH 193A,A05,093482,Rotar; Vladimir,10,0,34,24
1657344922979,MATH 197,001,091859,McAuley; Julian John,9999,0,9999,0
1657344922979,MATH 197,002,095566,Kedlaya; Kiran S.,9997,0,9999,2
1657344922979,MATH 197,003,095567,Xiao; Ming,9999,0,9999,0
1657344922979,MATH 197,004,095571,Perols; Johan Lars,9998,0,9999,1
1657344930047,COGS 9,A01,083615,Shannon; Kyle Michael,8,0,75,67
1657344936074,COGS 11,A01,083617,Boyle; Mary E. T.,22,0,48,26
1657344942101,COGS 13,A01,083071,Bastos; Amalia Pinkusfeld,11,0,71,60
1657344948122,COGS 14A,A01,092681,Semenuks; Arturs,3,1,100,97
1657344954145,COGS 14B,A01,083073,Cheng; Tzu-Han,6,0,63,57
1657344960174,COGS 17,A01,092677,Semenuks; Arturs,6,0,81,75
1657344966197,COGS 100,A01,083619,Allen; Michael Gordon,16,0,70,54
1657344972221,COGS 101A,A01,083621,Davis; Joshua Daniel,9,0,68,59
1657344978243,COGS 101B,A01,091572,Allen; Michael Gordon,11,0,65,54
1657344984269,COGS 101C,A01,083625,Delgado; Tania,17,0,35,18
1657344990293,COGS 107A,A01,083627,Boyle; Mary E. T.,13,0,60,47
1657344996316,COGS 118A,A01,083075,Gupta; Anjum,20,0,76,56
1657345002341,CSE 3,A50,083646,Miranda; Gregory Joseph,24,0,50,26
1657345008365,CSE 8A,A50,083650,Miranda; Gregory Joseph,17,1,56,39
1657345014387,CSE 11,A01,083080,Cao; Yingjun,6,15,40,34
1657345020410,CSE 12,A01,083652,Krause-Levy; Sophia Louisa,28,1,120,92
1657345036851,CSE 15L,A01,083654,Morris; Justin Loren,9,0,50,41
1657345036851,CSE 15L,A02,083655,Morris; Justin Loren,9,0,50,41
1657345042879,CSE 20,A01,083657,Tran; Khoa Dang,39,0,80,41
1657345048906,CSE 21,A01,095574,Bach; Quang Tran,22,0,48,26
1657345054933,CSE 30,A01,083084,Eldon; John,4,0,80,76
1657345054933,CSE 30,B01,095061,Bhaskar; Nishant,9,0,50,41
1657345060959,CSE 100,A01,083659,Cao; Yingjun,5,4,70,65
1657345066983,CSE 134B,A01,083661,Powell; Thomas Allan,22,0,100,78
1657345073008,CSE 140,A01,083663,Gungor; Onat,14,0,85,71
1657345079035,CSE 140L,A01,083088,Eldon; John,21,0,100,79
1657345085063,CSE 175,A01,083665,Kumar; Rakesh,3,0,25,22
1657345091088,CSE 190,A00,092507,Dubnov; Shlomo,7,0,20,13
1657345097112,ECE 45,A01,083139,Congero; Spencer William,6,0,75,69
1657345103134,ECE 65,A50,083695,Saad; Andrew S,12,0,30,18
1657345103134,ECE 65,A51,095125,Saad; Andrew S,24,0,26,2
1657345109157,ECE 109,A01,091882,Touri; Behrouz,19,0,70,51
1657345115183,ECE 180,A00,083140,Abi Samra; Nicholas Camill,1,0,30,29
1657345115183,ECE 180,B00,083141,Abi Samra; Nicholas Camill,0,0,30,30
1657345121207,MATH 10A,A01,083735,Patchell; Gregory David,2,0,30,28
1657345121207,MATH 10A,A02,083736,Patchell; Gregory David,20,0,30,10
1657345121207,MATH 10A,A03,083737,Patchell; Gregory David,16,0,30,14
1657345127236,MATH 10B,A01,083207,Lim; Seonhee,8,0,34,26
1657345127236,MATH 10B,A02,083208,Lim; Seonhee,9,0,35,26
1657345127236,MATH 10B,A03,093472,Lim; Seonhee,7,0,34,27
1657345127236,MATH 10B,B01,083739,Sinha; Shubham,12,0,30,18
1657345133267,MATH 18,A01,083743,Cinel; Cameron Alexander,7,0,30,23
1657345133267,MATH 18,A02,083744,Cinel; Cameron Alexander,17,0,30,13
1657345133267,MATH 18,A03,083745,Cinel; Cameron Alexander,9,0,30,21
1657345133267,MATH 18,B01,083748,Rideout; David Porter,5,0,37,32
1657345133267,MATH 18,B02,083749,Rideout; David Porter,5,0,36,31
1657345133267,MATH 18,B03,083750,Rideout; David Porter,3,0,37,34
1657345133267,MATH 18,B04,083751,Rideout; David Porter,6,0,36,30
1657345133267,MATH 18,B05,093473,Rideout; David Porter,6,0,36,30
1657345133267,MATH 18,B06,093474,Rideout; David Porter,6,0,36,30
1657345139292,MATH 20A,A01,083754,Zheng; Zequn,14,0,40,26
1657345145323,MATH 20B,A01,083756,Briones; Jor-el Thomas Caparas,4,0,36,32
1657345145323,MATH 20B,A02,083757,Briones; Jor-el Thomas Caparas,1,0,36,35
1657345145323,MATH 20B,A03,093475,Briones; Jor-el Thomas Caparas,2,0,36,34
1657345151347,MATH 20C,A01,083760,Briones; Jor-el Thomas Caparas,1,0,35,34
1657345151347,MATH 20C,A02,083761,Briones; Jor-el Thomas Caparas,8,0,35,27
1657345151347,MATH 20C,A03,093476,Briones; Jor-el Thomas Caparas,0,1,36,36
1657345151347,MATH 20C,B01,083762,Bach; Quang Tran,1,0,30,29
1657345157369,MATH 20D,A01,083765,Tran; Brian Kha,5,0,30,25
1657345157369,MATH 20D,A02,083766,Tran; Brian Kha,5,0,30,25
1657345157369,MATH 20D,A03,083767,Tran; Brian Kha,4,0,30,26
1657345163395,MATH 20E,A01,083771,Ganguly; Soumya,9,0,32,23
1657345163395,MATH 20E,A02,083772,Ganguly; Soumya,6,0,32,26
1657345163395,MATH 20E,B01,083773,Ciotti; Benjamin,20,0,35,15
1657345163395,MATH 20E,B02,083774,Ciotti; Benjamin,17,0,35,18
1657345169435,MATH 103A,A01,083777,Greenfeld; Be'Eri,3,0,36,33
1657345169435,MATH 103A,A02,083778,Greenfeld; Be'Eri,5,0,36,31
1657345169435,MATH 103A,A03,093561,Greenfeld; Be'Eri,4,0,36,32
1657345169435,MATH 103A,B01,083779,Greenfeld; Be'Eri,6,0,36,30
1657345169435,MATH 103A,B02,083780,Greenfeld; Be'Eri,4,0,36,32
1657345169435,MATH 103A,B03,093562,Greenfeld; Be'Eri,3,0,36,33
1657345175459,MATH 105,A01,085443,Carter; Anne Toulson,15,0,35,20
1657345175459,MATH 105,A02,093477,Carter; Anne Toulson,20,0,35,15
1657345181484,MATH 109,A01,083213,Ganzberger; Geoffrey Michael,2,0,34,32
1657345181484,MATH 109,A02,083214,Ganzberger; Geoffrey Michael,4,0,34,30
1657345181484,MATH 109,A03,093478,Ganzberger; Geoffrey Michael,2,0,34,32
1657345181484,MATH 109,B01,083215,Ganzberger; Geoffrey Michael,1,0,32,31
1657345181484,MATH 109,B02,083216,Ganzberger; Geoffrey Michael,2,0,32,30
1657345181484,MATH 109,B03,093479,Ganzberger; Geoffrey Michael,8,0,32,24
1657345187507,MATH 142A,A01,083219,Chow; Bennett,7,0,32,25
1657345187507,MATH 142A,A02,083220,Chow; Bennett,10,0,32,22
1657345187507,MATH 142A,A03,093480,Chow; Bennett,8,0,32,24
1657345187507,MATH 142A,B03,093481,Chow; Bennett,8,0,32,24
1657345187507,MATH 142A,B04,093558,Chow; Bennett,13,0,32,19
1657345187507,MATH 142A,B05,093559,Chow; Bennett,6,0,32,26
1657345193529,MATH 193A,A01,083224,Rotar; Vladimir,8,0,34,26
1657345193529,MATH 193A,A02,083225,Rotar; Vladimir,9,0,34,25
1657345193529,MATH 193A,A03,083781,Rotar; Vladimir,4,0,34,30
1657345193529,MATH 193A,A04,083782,Rotar; Vladimir,9,0,34,25
1657345193529,MATH 193A,A05,093482,Rotar; Vladimir,10,0,34,24
1657345199568,MATH 197,001,091859,McAuley; Julian John,9999,0,9999,0
1657345199568,MATH 197,002,095566,Kedlaya; Kiran S.,9997,0,9999,2
1657345199568,MATH 197,003,095567,Xiao; Ming,9999,0,9999,0
1657345199568,MATH 197,004,095571,Perols; Johan Lars,9998,0,9999,1
1657345206633,COGS 9,A01,083615,Shannon; Kyle Michael,8,0,75,67
1657345212660,COGS 11,A01,083617,Boyle; Mary E. T.,22,0,48,26
1657345218779,COGS 13,A01,083071,Bastos; Amalia Pinkusfeld,11,0,71,60
1657345224810,COGS 14A,A01,092681,Semenuks; Arturs,3,1,100,97
1657345230835,COGS 14B,A01,083073,Cheng; Tzu-Han,6,0,63,57
1657345236860,COGS 17,A01,092677,Semenuks; Arturs,6,0,81,75
1657345242881,COGS 100,A01,083619,Allen; Michael Gordon,16,0,70,54
1657345248903,COGS 101A,A01,083621,Davis; Joshua Daniel,9,0,68,59
1657345254925,COGS 101B,A01,091572,Allen; Michael Gordon,11,0,65,54
1657345260948,COGS 101C,A01,083625,Delgado; Tania,17,0,35,18
1657345266975,COGS 107A,A01,083627,Boyle; Mary E. T.,13,0,60,47
1657345273000,COGS 118A,A01,083075,Gupta; Anjum,20,0,76,56
1657345279023,CSE 3,A50,083646,Miranda; Gregory Joseph,24,0,50,26
1657345285052,CSE 8A,A50,083650,Miranda; Gregory Joseph,17,1,56,39
1657345291080,CSE 11,A01,083080,Cao; Yingjun,6,15,40,34
1657345297103,CSE 12,A01,083652,Krause-Levy; Sophia Louisa,28,1,120,92
1657345303125,CSE 15L,A01,083654,Morris; Justin Loren,9,0,50,41
1657345303125,CSE 15L,A02,083655,Morris; Justin Loren,9,0,50,41
1657345309149,CSE 20,A01,083657,Tran; Khoa Dang,39,0,80,41
1657345315175,CSE 21,A01,095574,Bach; Quang Tran,22,0,48,26
1657345321202,CSE 30,A01,083084,Eldon; John,4,0,80,76
1657345321202,CSE 30,B01,095061,Bhaskar; Nishant,9,0,50,41
1657345327224,CSE 100,A01,083659,Cao; Yingjun,5,4,70,65
1657345333251,CSE 134B,A01,083661,Powell; Thomas Allan,22,0,100,78
1657345339275,CSE 140,A01,083663,Gungor; Onat,14,0,85,71
1657345345302,CSE 140L,A01,083088,Eldon; John,21,0,100,79
1657345351326,CSE 175,A01,083665,Kumar; Rakesh,3,0,25,22
1657345357355,CSE 190,A00,092507,Dubnov; Shlomo,7,0,20,13
1657345363382,ECE 45,A01,083139,Congero; Spencer William,6,0,75,69
1657345369407,ECE 65,A50,083695,Saad; Andrew S,12,0,30,18
1657345369407,ECE 65,A51,095125,Saad; Andrew S,24,0,26,2
1657345375431,ECE 109,A01,091882,Touri; Behrouz,19,0,70,51
1657345381453,ECE 180,A00,083140,Abi Samra; Nicholas Camill,1,0,30,29
1657345381453,ECE 180,B00,083141,Abi Samra; Nicholas Camill,0,0,30,30
1657345387476,MATH 10A,A01,083735,Patchell; Gregory David,2,0,30,28
1657345387476,MATH 10A,A02,083736,Patchell; Gregory David,20,0,30,10
1657345387476,MATH 10A,A03,083737,Patchell; Gregory David,16,0,30,14
1657345393506,MATH 10B,A01,083207,Lim; Seonhee,8,0,34,26
1657345393506,MATH 10B,A02,083208,Lim; Seonhee,9,0,35,26
1657345393506,MATH 10B,A03,093472,Lim; Seonhee,7,0,34,27
1657345393506,MATH 10B,B01,083739,Sinha; Shubham,12,0,30,18
1657345399530,MATH 18,A01,083743,Cinel; Cameron Alexander,7,0,30,23
1657345399530,MATH 18,A02,083744,Cinel; Cameron Alexander,17,0,30,13
1657345399530,MATH 18,A03,083745,Cinel; Cameron Alexander,9,0,30,21
1657345399530,MATH 18,B01,083748,Rideout; David Porter,5,0,37,32
1657345399530,MATH 18,B02,083749,Rideout; David Porter,5,0,36,31
1657345399530,MATH 18,B03,083750,Rideout; David Porter,3,0,37,34
1657345399530,MATH 18,B04,083751,Rideout; David Porter,6,0,36,30
1657345399530,MATH 18,B05,093473,Rideout; David Porter,6,0,36,30
1657345399530,MATH 18,B06,093474,Rideout; David Porter,6,0,36,30
1657345405558,MATH 20A,A01,083754,Zheng; Zequn,14,0,40,26
1657345411585,MATH 20B,A01,083756,Briones; Jor-el Thomas Caparas,4,0,36,32
1657345411585,MATH 20B,A02,083757,Briones; Jor-el Thomas Caparas,1,0,36,35
1657345411585,MATH 20B,A03,093475,Briones; Jor-el Thomas Caparas,2,0,36,34
1657345417608,MATH 20C,A01,083760,Briones; Jor-el Thomas Caparas,1,0,35,34
1657345417608,MATH 20C,A02,083761,Briones; Jor-el Thomas Caparas,8,0,35,27
1657345417608,MATH 20C,A03,093476,Briones; Jor-el Thomas Caparas,0,1,36,36
1657345417608,MATH 20C,B01,083762,Bach; Quang Tran,1,0,30,29
1657345423635,MATH 20D,A01,083765,Tran; Brian Kha,5,0,30,25
1657345423635,MATH 20D,A02,083766,Tran; Brian Kha,5,0,30,25
1657345423635,MATH 20D,A03,083767,Tran; Brian Kha,4,0,30,26
1657345429658,MATH 20E,A01,083771,Ganguly; Soumya,9,0,32,23
1657345429658,MATH 20E,A02,083772,Ganguly; Soumya,6,0,32,26
1657345429658,MATH 20E,B01,083773,Ciotti; Benjamin,20,0,35,15
1657345429658,MATH 20E,B02,083774,Ciotti; Benjamin,17,0,35,18
1657345435680,MATH 103A,A01,083777,Greenfeld; Be'Eri,3,0,36,33
1657345435680,MATH 103A,A02,083778,Greenfeld; Be'Eri,5,0,36,31
1657345435680,MATH 103A,A03,093561,Greenfeld; Be'Eri,5,0,36,31
1657345435680,MATH 103A,B01,083779,Greenfeld; Be'Eri,6,0,36,30
1657345435680,MATH 103A,B02,083780,Greenfeld; Be'Eri,4,0,36,32
1657345435680,MATH 103A,B03,093562,Greenfeld; Be'Eri,3,0,36,33
1657345441711,MATH 105,A01,085443,Carter; Anne Toulson,15,0,35,20
1657345441711,MATH 105,A02,093477,Carter; Anne Toulson,20,0,35,15
1657345447740,MATH 109,A01,083213,Ganzberger; Geoffrey Michael,2,0,34,32
1657345447740,MATH 109,A02,083214,Ganzberger; Geoffrey Michael,4,0,34,30
1657345447740,MATH 109,A03,093478,Ganzberger; Geoffrey Michael,2,0,34,32
1657345447740,MATH 109,B01,083215,Ganzberger; Geoffrey Michael,1,0,32,31
1657345447740,MATH 109,B02,083216,Ganzberger; Geoffrey Michael,2,0,32,30
1657345447740,MATH 109,B03,093479,Ganzberger; Geoffrey Michael,8,0,32,24
1657345453763,MATH 142A,A01,083219,Chow; Bennett,7,0,32,25
1657345453763,MATH 142A,A02,083220,Chow; Bennett,10,0,32,22
1657345453763,MATH 142A,A03,093480,Chow; Bennett,8,0,32,24
1657345453763,MATH 142A,B03,093481,Chow; Bennett,8,0,32,24
1657345453763,MATH 142A,B04,093558,Chow; Bennett,13,0,32,19
1657345453763,MATH 142A,B05,093559,Chow; Bennett,6,0,32,26
1657345459786,MATH 193A,A01,083224,Rotar; Vladimir,8,0,34,26
1657345459786,MATH 193A,A02,083225,Rotar; Vladimir,9,0,34,25
1657345459786,MATH 193A,A03,083781,Rotar; Vladimir,4,0,34,30
1657345459786,MATH 193A,A04,083782,Rotar; Vladimir,9,0,34,25
1657345459786,MATH 193A,A05,093482,Rotar; Vladimir,10,0,34,24
1657345465813,MATH 197,001,091859,McAuley; Julian John,9999,0,9999,0
1657345465813,MATH 197,002,095566,Kedlaya; Kiran S.,9997,0,9999,2
1657345465813,MATH 197,003,095567,Xiao; Ming,9999,0,9999,0
1657345465813,MATH 197,004,095571,Perols; Johan Lars,9998,0,9999,1
1657345472874,COGS 9,A01,083615,Shannon; Kyle Michael,8,0,75,67
1657345478901,COGS 11,A01,083617,Boyle; Mary E. T.,22,0,48,26
1657345484924,COGS 13,A01,083071,Bastos; Amalia Pinkusfeld,11,0,71,60
1657345490946,COGS 14A,A01,092681,Semenuks; Arturs,3,1,100,97
1657345496968,COGS 14B,A01,083073,Cheng; Tzu-Han,6,0,63,57
1657345502992,COGS 17,A01,092677,Semenuks; Arturs,6,0,81,75
1657345509022,COGS 100,A01,083619,Allen; Michael Gordon,16,0,70,54
1657345515057,COGS 101A,A01,083621,Davis; Joshua Daniel,9,0,68,59
1657345521081,COGS 101B,A01,091572,Allen; Michael Gordon,11,0,65,54
1657345527107,COGS 101C,A01,083625,Delgado; Tania,17,0,35,18
1657345533132,COGS 107A,A01,083627,Boyle; Mary E. T.,13,0,60,47
1657345539159,COGS 118A,A01,083075,Gupta; Anjum,20,0,76,56
1657345545186,CSE 3,A50,083646,Miranda; Gregory Joseph,24,0,50,26
1657345551210,CSE 8A,A50,083650,Miranda; Gregory Joseph,17,1,56,39
1657345557231,CSE 11,A01,083080,Cao; Yingjun,6,15,40,34
1657345563256,CSE 12,A01,083652,Krause-Levy; Sophia Louisa,28,1,120,92
1657345569283,CSE 15L,A01,083654,Morris; Justin Loren,9,0,50,41
1657345569283,CSE 15L,A02,083655,Morris; Justin Loren,9,0,50,41
1657345575314,CSE 20,A01,083657,Tran; Khoa Dang,39,0,80,41
1657345581340,CSE 21,A01,095574,Bach; Quang Tran,22,0,48,26
1657345587363,CSE 30,A01,083084,Eldon; John,4,0,80,76
1657345587363,CSE 30,B01,095061,Bhaskar; Nishant,9,0,50,41
1657345593387,CSE 100,A01,083659,Cao; Yingjun,5,4,70,65
1657345599413,CSE 134B,A01,083661,Powell; Thomas Allan,22,0,100,78
1657345605435,CSE 140,A01,083663,Gungor; Onat,14,0,85,71
1657345611464,CSE 140L,A01,083088,Eldon; John,21,0,100,79
1657345617486,CSE 175,A01,083665,Kumar; Rakesh,3,0,25,22
1657345623512,CSE 190,A00,092507,Dubnov; Shlomo,7,0,20,13
1657345629534,ECE 45,A01,083139,Congero; Spencer William,6,0,75,69
1657345635558,ECE 65,A50,083695,Saad; Andrew S,12,0,30,18
1657345635558,ECE 65,A51,095125,Saad; Andrew S,24,0,26,2
1657345641585,ECE 109,A01,091882,Touri; Behrouz,19,0,70,51
1657345647614,ECE 180,A00,083140,Abi Samra; Nicholas Camill,1,0,30,29
1657345647614,ECE 180,B00,083141,Abi Samra; Nicholas Camill,0,0,30,30
1657345653641,MATH 10A,A01,083735,Patchell; Gregory David,2,0,30,28
1657345653641,MATH 10A,A02,083736,Patchell; Gregory David,20,0,30,10
1657345653641,MATH 10A,A03,083737,Patchell; Gregory David,16,0,30,14
1657345659665,MATH 10B,A01,083207,Lim; Seonhee,8,0,34,26
1657345659665,MATH 10B,A02,083208,Lim; Seonhee,9,0,35,26
1657345659665,MATH 10B,A03,093472,Lim; Seonhee,7,0,34,27
1657345659665,MATH 10B,B01,083739,Sinha; Shubham,12,0,30,18
1657345665688,MATH 18,A01,083743,Cinel; Cameron Alexander,7,0,30,23
1657345665688,MATH 18,A02,083744,Cinel; Cameron Alexander,17,0,30,13
1657345665688,MATH 18,A03,083745,Cinel; Cameron Alexander,9,0,30,21
1657345665688,MATH 18,B01,083748,Rideout; David Porter,5,0,37,32
1657345665688,MATH 18,B02,083749,Rideout; David Porter,5,0,36,31
1657345665688,MATH 18,B03,083750,Rideout; David Porter,3,0,37,34
1657345665688,MATH 18,B04,083751,Rideout; David Porter,6,0,36,30
1657345665688,MATH 18,B05,093473,Rideout; David Porter,6,0,36,30
1657345665688,MATH 18,B06,093474,Rideout; David Porter,6,0,36,30
1657345679091,MATH 20A,A01,083754,Zheng; Zequn,14,0,40,26
1657345685121,MATH 20B,A01,083756,Briones; Jor-el Thomas Caparas,4,0,36,32
1657345685121,MATH 20B,A02,083757,Briones; Jor-el Thomas Caparas,1,0,36,35
1657345685121,MATH 20B,A03,093475,Briones; Jor-el Thomas Caparas,2,0,36,34
1657345691145,MATH 20C,A01,083760,Briones; Jor-el Thomas Caparas,1,0,35,34
1657345691145,MATH 20C,A02,083761,Briones; Jor-el Thomas Caparas,8,0,35,27
1657345691145,MATH 20C,A03,093476,Briones; Jor-el Thomas Caparas,0,1,36,36
1657345691145,MATH 20C,B01,083762,Bach; Quang Tran,1,0,30,29
1657345697180,MATH 20D,A01,083765,Tran; Brian Kha,5,0,30,25
1657345697180,MATH 20D,A02,083766,Tran; Brian Kha,5,0,30,25
1657345697180,MATH 20D,A03,083767,Tran; Brian Kha,4,0,30,26
1657345703206,MATH 20E,A01,083771,Ganguly; Soumya,9,0,32,23
1657345703206,MATH 20E,A02,083772,Ganguly; Soumya,6,0,32,26
1657345703206,MATH 20E,B01,083773,Ciotti; Benjamin,20,0,35,15
1657345703206,MATH 20E,B02,083774,Ciotti; Benjamin,17,0,35,18
1657345709232,MATH 103A,A01,083777,Greenfeld; Be'Eri,3,0,36,33
1657345709232,MATH 103A,A02,083778,Greenfeld; Be'Eri,5,0,36,31
1657345709232,MATH 103A,A03,093561,Greenfeld; Be'Eri,5,0,36,31
1657345709232,MATH 103A,B01,083779,Greenfeld; Be'Eri,6,0,36,30
1657345709232,MATH 103A,B02,083780,Greenfeld; Be'Eri,4,0,36,32
1657345709232,MATH 103A,B03,093562,Greenfeld; Be'Eri,3,0,36,33
1657345715254,MATH 105,A01,085443,Carter; Anne Toulson,15,0,35,20
1657345715254,MATH 105,A02,093477,Carter; Anne Toulson,20,0,35,15
1657345721276,MATH 109,A01,083213,Ganzberger; Geoffrey Michael,2,0,34,32
1657345721276,MATH 109,A02,083214,Ganzberger; Geoffrey Michael,4,0,34,30
1657345721276,MATH 109,A03,093478,Ganzberger; Geoffrey Michael,2,0,34,32
1657345721276,MATH 109,B01,083215,Ganzberger; Geoffrey Michael,1,0,32,31
1657345721276,MATH 109,B02,083216,Ganzberger; Geoffrey Michael,2,0,32,30
1657345721276,MATH 109,B03,093479,Ganzberger; Geoffrey Michael,8,0,32,24
1657345727306,MATH 142A,A01,083219,Chow; Bennett,7,0,32,25
1657345727306,MATH 142A,A02,083220,Chow; Bennett,10,0,32,22
1657345727306,MATH 142A,A03,093480,Chow; Bennett,8,0,32,24
1657345727306,MATH 142A,B03,093481,Chow; Bennett,8,0,32,24
1657345727306,MATH 142A,B04,093558,Chow; Bennett,13,0,32,19
1657345727306,MATH 142A,B05,093559,Chow; Bennett,6,0,32,26
1657345733333,MATH 193A,A01,083224,Rotar; Vladimir,8,0,34,26
1657345733333,MATH 193A,A02,083225,Rotar; Vladimir,9,0,34,25
1657345733333,MATH 193A,A03,083781,Rotar; Vladimir,4,0,34,30
1657345733333,MATH 193A,A04,083782,Rotar; Vladimir,9,0,34,25
1657345733333,MATH 193A,A05,093482,Rotar; Vladimir,10,0,34,24
1657345739356,MATH 197,001,091859,McAuley; Julian John,9999,0,9999,0
1657345739356,MATH 197,002,095566,Kedlaya; Kiran S.,9997,0,9999,2
1657345739356,MATH 197,003,095567,Xiao; Ming,9999,0,9999,0
1657345739356,MATH 197,004,095571,Perols; Johan Lars,9998,0,9999,1
1657345746422,COGS 9,A01,083615,Shannon; Kyle Michael,8,0,75,67
1657345752449,COGS 11,A01,083617,Boyle; Mary E. T.,22,0,48,26
1657345758471,COGS 13,A01,083071,Bastos; Amalia Pinkusfeld,11,0,71,60
1657345764494,COGS 14A,A01,092681,Semenuks; Arturs,3,1,100,97
1657345770522,COGS 14B,A01,083073,Cheng; Tzu-Han,6,0,63,57
1657345776543,COGS 17,A01,092677,Semenuks; Arturs,6,0,81,75
1657345782566,COGS 100,A01,083619,Allen; Michael Gordon,16,0,70,54
1657345788592,COGS 101A,A01,083621,Davis; Joshua Daniel,9,0,68,59
1657345794616,COGS 101B,A01,091572,Allen; Michael Gordon,11,0,65,54
1657345800639,COGS 101C,A01,083625,Delgado; Tania,17,0,35,18
1657345806664,COGS 107A,A01,083627,Boyle; Mary E. T.,13,0,60,47
1657345812688,COGS 118A,A01,083075,Gupta; Anjum,20,0,76,56
1657345818736,CSE 3,A50,083646,Miranda; Gregory Joseph,24,0,50,26
1657345824851,CSE 8A,A50,083650,Miranda; Gregory Joseph,17,1,56,39
1657345830877,CSE 11,A01,083080,Cao; Yingjun,6,15,40,34
1657345836902,CSE 12,A01,083652,Krause-Levy; Sophia Louisa,28,1,120,92
1657345842928,CSE 15L,A01,083654,Morris; Justin Loren,9,0,50,41
1657345842928,CSE 15L,A02,083655,Morris; Justin Loren,9,0,50,41
1657345848950,CSE 20,A01,083657,Tran; Khoa Dang,39,0,80,41
1657345854974,CSE 21,A01,095574,Bach; Quang Tran,22,0,48,26
1657345861001,CSE 30,A01,083084,Eldon; John,4,0,80,76
1657345861001,CSE 30,B01,095061,Bhaskar; Nishant,9,0,50,41
1657345867027,CSE 100,A01,083659,Cao; Yingjun,5,4,70,65
1657345873053,CSE 134B,A01,083661,Powell; Thomas Allan,22,0,100,78
1657345879077,CSE 140,A01,083663,Gungor; Onat,14,0,85,71
1657345885110,CSE 140L,A01,083088,Eldon; John,21,0,100,79
1657345891139,CSE 175,A01,083665,Kumar; Rakesh,3,0,25,22
1657345897162,CSE 190,A00,092507,Dubnov; Shlomo,7,0,20,13
1657345903186,ECE 45,A01,083139,Congero; Spencer William,6,0,75,69
1657345909208,ECE 65,A50,083695,Saad; Andrew S,12,0,30,18
1657345909208,ECE 65,A51,095125,Saad; Andrew S,24,0,26,2
1657345915230,ECE 109,A01,091882,Touri; Behrouz,19,0,70,51
1657345921252,ECE 180,A00,083140,Abi Samra; Nicholas Camill,1,0,30,29
1657345921252,ECE 180,B00,083141,Abi Samra; Nicholas Camill,0,0,30,30
1657345927278,MATH 10A,A01,083735,Patchell; Gregory David,2,0,30,28
1657345927278,MATH 10A,A02,083736,Patchell; Gregory David,20,0,30,10
1657345927278,MATH 10A,A03,083737,Patchell; Gregory David,16,0,30,14
1657345933304,MATH 10B,A01,083207,Lim; Seonhee,8,0,34,26
1657345933304,MATH 10B,A02,083208,Lim; Seonhee,9,0,35,26
1657345933304,MATH 10B,A03,093472,Lim; Seonhee,7,0,34,27
1657345933304,MATH 10B,B01,083739,Sinha; Shubham,12,0,30,18
1657345939329,MATH 18,A01,083743,Cinel; Cameron Alexander,7,0,30,23
1657345939329,MATH 18,A02,083744,Cinel; Cameron Alexander,17,0,30,13
1657345939329,MATH 18,A03,083745,Cinel; Cameron Alexander,9,0,30,21
1657345939329,MATH 18,B01,083748,Rideout; David Porter,5,0,37,32
1657345939329,MATH 18,B02,083749,Rideout; David Porter,5,0,36,31
1657345939329,MATH 18,B03,083750,Rideout; David Porter,3,0,37,34
1657345939329,MATH 18,B04,083751,Rideout; David Porter,6,0,36,30
1657345939329,MATH 18,B05,093473,Rideout; David Porter,6,0,36,30
1657345939329,MATH 18,B06,093474,Rideout; David Porter,6,0,36,30
1657345945353,MATH 20A,A01,083754,Zheng; Zequn,14,0,40,26
1657345951380,MATH 20B,A01,083756,Briones; Jor-el Thomas Caparas,4,0,36,32
1657345951380,MATH 20B,A02,083757,Briones; Jor-el Thomas Caparas,1,0,36,35
1657345951380,MATH 20B,A03,093475,Briones; Jor-el Thomas Caparas,2,0,36,34
1657345957404,MATH 20C,A01,083760,Briones; Jor-el Thomas Caparas,1,0,35,34
1657345957404,MATH 20C,A02,083761,Briones; Jor-el Thomas Caparas,8,0,35,27
1657345957404,MATH 20C,A03,093476,Briones; Jor-el Thomas Caparas,0,1,36,36
1657345957404,MATH 20C,B01,083762,Bach; Quang Tran,1,0,30,29
1657345963427,MATH 20D,A01,083765,Tran; Brian Kha,5,0,30,25
1657345963427,MATH 20D,A02,083766,Tran; Brian Kha,5,0,30,25
1657345963427,MATH 20D,A03,083767,Tran; Brian Kha,4,0,30,26
1657345969450,MATH 20E,A01,083771,Ganguly; Soumya,9,0,32,23
1657345969450,MATH 20E,A02,083772,Ganguly; Soumya,6,0,32,26
1657345969450,MATH 20E,B01,083773,Ciotti; Benjamin,20,0,35,15
1657345969450,MATH 20E,B02,083774,Ciotti; Benjamin,17,0,35,18
1657345975480,MATH 103A,A01,083777,Greenfeld; Be'Eri,3,0,36,33
1657345975480,MATH 103A,A02,083778,Greenfeld; Be'Eri,5,0,36,31
1657345975480,MATH 103A,A03,093561,Greenfeld; Be'Eri,5,0,36,31
1657345975480,MATH 103A,B01,083779,Greenfeld; Be'Eri,6,0,36,30
1657345975480,MATH 103A,B02,083780,Greenfeld; Be'Eri,4,0,36,32
1657345975480,MATH 103A,B03,093562,Greenfeld; Be'Eri,3,0,36,33
1657345981505,MATH 105,A01,085443,Carter; Anne Toulson,15,0,35,20
1657345981505,MATH 105,A02,093477,Carter; Anne Toulson,20,0,35,15
1657345987533,MATH 109,A01,083213,Ganzberger; Geoffrey Michael,2,0,34,32
1657345987533,MATH 109,A02,083214,Ganzberger; Geoffrey Michael,4,0,34,30
1657345987533,MATH 109,A03,093478,Ganzberger; Geoffrey Michael,2,0,34,32
1657345987533,MATH 109,B01,083215,Ganzberger; Geoffrey Michael,1,0,32,31
1657345987533,MATH 109,B02,083216,Ganzberger; Geoffrey Michael,2,0,32,30
1657345987533,MATH 109,B03,093479,Ganzberger; Geoffrey Michael,8,0,32,24
1657345993562,MATH 142A,A01,083219,Chow; Bennett,7,0,32,25
1657345993562,MATH 142A,A02,083220,Chow; Bennett,10,0,32,22
1657345993562,MATH 142A,A03,093480,Chow; Bennett,8,0,32,24
1657345993562,MATH 142A,B03,093481,Chow; Bennett,8,0,32,24
1657345993562,MATH 142A,B04,093558,Chow; Bennett,13,0,32,19
1657345993562,MATH 142A,B05,093559,Chow; Bennett,6,0,32,26
1657345999596,MATH 193A,A01,083224,Rotar; Vladimir,8,0,34,26
1657345999596,MATH 193A,A02,083225,Rotar; Vladimir,9,0,34,25
1657345999596,MATH 193A,A03,083781,Rotar; Vladimir,4,0,34,30
1657345999596,MATH 193A,A04,083782,Rotar; Vladimir,9,0,34,25
1657345999596,MATH 193A,A05,093482,Rotar; Vladimir,10,0,34,24
1657346005621,MATH 197,001,091859,McAuley; Julian John,9999,0,9999,0
1657346005621,MATH 197,002,095566,Kedlaya; Kiran S.,9997,0,9999,2
1657346005621,MATH 197,003,095567,Xiao; Ming,9999,0,9999,0
1657346005621,MATH 197,004,095571,Perols; Johan Lars,9998,0,9999,1
1657346012684,COGS 9,A01,083615,Shannon; Kyle Michael,8,0,75,67
1657346018710,COGS 11,A01,083617,Boyle; Mary E. T.,22,0,48,26
1657346024733,COGS 13,A01,083071,Bastos; Amalia Pinkusfeld,11,0,71,60
1657346030759,COGS 14A,A01,092681,Semenuks; Arturs,4,1,100,96
1657346036790,COGS 14B,A01,083073,Cheng; Tzu-Han,6,0,63,57
1657346042813,COGS 17,A01,092677,Semenuks; Arturs,6,0,81,75
1657346048836,COGS 100,A01,083619,Allen; Michael Gordon,16,0,70,54
1657346054858,COGS 101A,A01,083621,Davis; Joshua Daniel,9,0,68,59
1657346060880,COGS 101B,A01,091572,Allen; Michael Gordon,11,0,65,54
1657346066914,COGS 101C,A01,083625,Delgado; Tania,17,0,35,18
1657346072941,COGS 107A,A01,083627,Boyle; Mary E. T.,13,0,60,47
1657346078964,COGS 118A,A01,083075,Gupta; Anjum,20,0,76,56
1657346084988,CSE 3,A50,083646,Miranda; Gregory Joseph,24,0,50,26
1657346091012,CSE 8A,A50,083650,Miranda; Gregory Joseph,17,1,56,39
1657346097040,CSE 11,A01,083080,Cao; Yingjun,6,15,40,34
1657346103064,CSE 12,A01,083652,Krause-Levy; Sophia Louisa,28,1,120,92
1657346109086,CSE 15L,A01,083654,Morris; Justin Loren,9,0,50,41
1657346109086,CSE 15L,A02,083655,Morris; Justin Loren,9,0,50,41
1657346115111,CSE 20,A01,083657,Tran; Khoa Dang,39,0,80,41
1657346121139,CSE 21,A01,095574,Bach; Quang Tran,22,0,48,26
1657346127166,CSE 30,A01,083084,Eldon; John,4,0,80,76
1657346127166,CSE 30,B01,095061,Bhaskar; Nishant,9,0,50,41
1657346133193,CSE 100,A01,083659,Cao; Yingjun,5,4,70,65
1657346139216,CSE 134B,A01,083661,Powell; Thomas Allan,22,0,100,78
1657346145242,CSE 140,A01,083663,Gungor; Onat,14,0,85,71
1657346151268,CSE 140L,A01,083088,Eldon; John,21,0,100,79
1657346157295,CSE 175,A01,083665,Kumar; Rakesh,3,0,25,22
1657346163321,CSE 190,A00,092507,Dubnov; Shlomo,7,0,20,13
1657346169349,ECE 45,A01,083139,Congero; Spencer William,6,0,75,69
1657346175377,ECE 65,A50,083695,Saad; Andrew S,12,0,30,18
1657346175377,ECE 65,A51,095125,Saad; Andrew S,24,0,26,2
1657346181398,ECE 109,A01,091882,Touri; Behrouz,19,0,70,51
1657346187421,ECE 180,A00,083140,Abi Samra; Nicholas Camill,1,0,30,29
1657346187421,ECE 180,B00,083141,Abi Samra; Nicholas Camill,0,0,30,30
1657346193447,MATH 10A,A01,083735,Patchell; Gregory David,2,0,30,28
1657346193447,MATH 10A,A02,083736,Patchell; Gregory David,20,0,30,10
1657346193447,MATH 10A,A03,083737,Patchell; Gregory David,16,0,30,14
1657346199476,MATH 10B,A01,083207,Lim; Seonhee,8,0,34,26
1657346199476,MATH 10B,A02,083208,Lim; Seonhee,9,0,35,26
1657346199476,MATH 10B,A03,093472,Lim; Seonhee,7,0,34,27
1657346199476,MATH 10B,B01,083739,Sinha; Shubham,12,0,30,18
1657346205506,MATH 18,A01,083743,Cinel; Cameron Alexander,7,0,30,23
1657346205506,MATH 18,A02,083744,Cinel; Cameron Alexander,17,0,30,13
1657346205506,MATH 18,A03,083745,Cinel; Cameron Alexander,9,0,30,21
1657346205506,MATH 18,B01,083748,Rideout; David Porter,5,0,37,32
1657346205506,MATH 18,B02,083749,Rideout; David Porter,5,0,36,31
1657346205506,MATH 18,B03,083750,Rideout; David Porter,3,0,37,34
1657346205506,MATH 18,B04,083751,Rideout; David Porter,6,0,36,30
1657346205506,MATH 18,B05,093473,Rideout; David Porter,6,0,36,30
1657346205506,MATH 18,B06,093474,Rideout; David Porter,6,0,36,30
1657346211529,MATH 20A,A01,083754,Zheng; Zequn,14,0,40,26
1657346217556,MATH 20B,A01,083756,Briones; Jor-el Thomas Caparas,4,0,36,32
1657346217556,MATH 20B,A02,083757,Briones; Jor-el Thomas Caparas,1,0,36,35
1657346217556,MATH 20B,A03,093475,Briones; Jor-el Thomas Caparas,2,0,36,34
1657346223577,MATH 20C,A01,083760,Briones; Jor-el Thomas Caparas,1,0,35,34
1657346223577,MATH 20C,A02,083761,Briones; Jor-el Thomas Caparas,8,0,35,27
1657346223577,MATH 20C,A03,093476,Briones; Jor-el Thomas Caparas,0,1,36,36
1657346223577,MATH 20C,B01,083762,Bach; Quang Tran,1,0,30,29
1657346229608,MATH 20D,A01,083765,Tran; Brian Kha,5,0,30,25
1657346229608,MATH 20D,A02,083766,Tran; Brian Kha,5,0,30,25
1657346229608,MATH 20D,A03,083767,Tran; Brian Kha,4,0,30,26
1657346235636,MATH 20E,A01,083771,Ganguly; Soumya,9,0,32,23
1657346235636,MATH 20E,A02,083772,Ganguly; Soumya,6,0,32,26
1657346235636,MATH 20E,B01,083773,Ciotti; Benjamin,20,0,35,15
1657346235636,MATH 20E,B02,083774,Ciotti; Benjamin,17,0,35,18
1657346241661,MATH 103A,A01,083777,Greenfeld; Be'Eri,3,0,36,33
1657346241661,MATH 103A,A02,083778,Greenfeld; Be'Eri,5,0,36,31
1657346241661,MATH 103A,A03,093561,Greenfeld; Be'Eri,5,0,36,31
1657346241661,MATH 103A,B01,083779,Greenfeld; Be'Eri,6,0,36,30
1657346241661,MATH 103A,B02,083780,Greenfeld; Be'Eri,4,0,36,32
1657346241661,MATH 103A,B03,093562,Greenfeld; Be'Eri,3,0,36,33
1657346247691,MATH 105,A01,085443,Carter; Anne Toulson,15,0,35,20
1657346247691,MATH 105,A02,093477,Carter; Anne Toulson,20,0,35,15
1657346253715,MATH 109,A01,083213,Ganzberger; Geoffrey Michael,2,0,34,32
1657346253715,MATH 109,A02,083214,Ganzberger; Geoffrey Michael,4,0,34,30
1657346253715,MATH 109,A03,093478,Ganzberger; Geoffrey Michael,2,0,34,32
1657346253715,MATH 109,B01,083215,Ganzberger; Geoffrey Michael,1,0,32,31
1657346253715,MATH 109,B02,083216,Ganzberger; Geoffrey Michael,2,0,32,30
1657346253715,MATH 109,B03,093479,Ganzberger; Geoffrey Michael,8,0,32,24
1657346259738,MATH 142A,A01,083219,Chow; Bennett,7,0,32,25
1657346259738,MATH 142A,A02,083220,Chow; Bennett,10,0,32,22
1657346259738,MATH 142A,A03,093480,Chow; Bennett,8,0,32,24
1657346259738,MATH 142A,B03,093481,Chow; Bennett,8,0,32,24
1657346259738,MATH 142A,B04,093558,Chow; Bennett,13,0,32,19
1657346259738,MATH 142A,B05,093559,Chow; Bennett,6,0,32,26
1657346265762,MATH 193A,A01,083224,Rotar; Vladimir,8,0,34,26
1657346265762,MATH 193A,A02,083225,Rotar; Vladimir,9,0,34,25
1657346265762,MATH 193A,A03,083781,Rotar; Vladimir,4,0,34,30
1657346265762,MATH 193A,A04,083782,Rotar; Vladimir,9,0,34,25
1657346265762,MATH 193A,A05,093482,Rotar; Vladimir,10,0,34,24
1657346271797,MATH 197,001,091859,McAuley; Julian John,9999,0,9999,0
1657346271797,MATH 197,002,095566,Kedlaya; Kiran S.,9997,0,9999,2
1657346271797,MATH 197,003,095567,Xiao; Ming,9999,0,9999,0
1657346271797,MATH 197,004,095571,Perols; Johan Lars,9998,0,9999,1
1657346278852,COGS 9,A01,083615,Shannon; Kyle Michael,8,0,75,67
1657346284873,COGS 11,A01,083617,Boyle; Mary E. T.,22,0,48,26
1657346290894,COGS 13,A01,083071,Bastos; Amalia Pinkusfeld,11,0,71,60
1657346296917,COGS 14A,A01,092681,Semenuks; Arturs,4,1,100,96
1657346302938,COGS 14B,A01,083073,Cheng; Tzu-Han,6,0,63,57
1657346308971,COGS 17,A01,092677,Semenuks; Arturs,6,0,81,75
1657346314995,COGS 100,A01,083619,Allen; Michael Gordon,16,0,70,54
1657346321019,COGS 101A,A01,083621,Davis; Joshua Daniel,9,0,68,59
1657346327042,COGS 101B,A01,091572,Allen; Michael Gordon,11,0,65,54
1657346333068,COGS 101C,A01,083625,Delgado; Tania,17,0,35,18
1657346339095,COGS 107A,A01,083627,Boyle; Mary E. T.,13,0,60,47
1657346345123,COGS 118A,A01,083075,Gupta; Anjum,20,0,76,56
1657346351151,CSE 3,A50,083646,Miranda; Gregory Joseph,24,0,50,26
1657346357174,CSE 8A,A50,083650,Miranda; Gregory Joseph,17,1,56,39
1657346363197,CSE 11,A01,083080,Cao; Yingjun,6,15,40,34
1657346369223,CSE 12,A01,083652,Krause-Levy; Sophia Louisa,28,1,120,92
1657346375246,CSE 15L,A01,083654,Morris; Justin Loren,9,0,50,41
1657346375246,CSE 15L,A02,083655,Morris; Justin Loren,9,0,50,41
1657346381269,CSE 20,A01,083657,Tran; Khoa Dang,39,0,80,41
1657346387306,CSE 21,A01,095574,Bach; Quang Tran,22,0,48,26
1657346393335,CSE 30,A01,083084,Eldon; John,4,0,80,76
1657346393335,CSE 30,B01,095061,Bhaskar; Nishant,9,0,50,41
1657346399359,CSE 100,A01,083659,Cao; Yingjun,5,4,70,65
1657346405381,CSE 134B,A01,083661,Powell; Thomas Allan,22,0,100,78
1657346411403,CSE 140,A01,083663,Gungor; Onat,14,0,85,71
1657346417431,CSE 140L,A01,083088,Eldon; John,21,0,100,79
1657346423526,CSE 175,A01,083665,Kumar; Rakesh,3,0,25,22
1657346429548,CSE 190,A00,092507,Dubnov; Shlomo,7,0,20,13
1657346435580,ECE 45,A01,083139,Congero; Spencer William,6,0,75,69
1657346441603,ECE 65,A50,083695,Saad; Andrew S,12,0,30,18
1657346441603,ECE 65,A51,095125,Saad; Andrew S,24,0,26,2
1657346447624,ECE 109,A01,091882,Touri; Behrouz,19,0,70,51
1657346453651,ECE 180,A00,083140,Abi Samra; Nicholas Camill,1,0,30,29
1657346453651,ECE 180,B00,083141,Abi Samra; Nicholas Camill,0,0,30,30
1657346459674,MATH 10A,A01,083735,Patchell; Gregory David,2,0,30,28
1657346459674,MATH 10A,A02,083736,Patchell; Gregory David,20,0,30,10
1657346459674,MATH 10A,A03,083737,Patchell; Gregory David,16,0,30,14
1657346465715,MATH 10B,A01,083207,Lim; Seonhee,8,0,34,26
1657346465715,MATH 10B,A02,083208,Lim; Seonhee,9,0,35,26
1657346465715,MATH 10B,A03,093472,Lim; Seonhee,7,0,34,27
1657346465715,MATH 10B,B01,083739,Sinha; Shubham,12,0,30,18
1657346471753,MATH 18,A01,083743,Cinel; Cameron Alexander,7,0,30,23
1657346471753,MATH 18,A02,083744,Cinel; Cameron Alexander,17,0,30,13
1657346471753,MATH 18,A03,083745,Cinel; Cameron Alexander,9,0,30,21
1657346471753,MATH 18,B01,083748,Rideout; David Porter,5,0,37,32
1657346471753,MATH 18,B02,083749,Rideout; David Porter,5,0,36,31
1657346471753,MATH 18,B03,083750,Rideout; David Porter,3,0,37,34
1657346471753,MATH 18,B04,083751,Rideout; David Porter,6,0,36,30
1657346471753,MATH 18,B05,093473,Rideout; David Porter,6,0,36,30
1657346471753,MATH 18,B06,093474,Rideout; David Porter,6,0,36,30
1657346477783,MATH 20A,A01,083754,Zheng; Zequn,14,0,40,26
1657346483808,MATH 20B,A01,083756,Briones; Jor-el Thomas Caparas,4,0,36,32
1657346483808,MATH 20B,A02,083757,Briones; Jor-el Thomas Caparas,1,0,36,35
1657346483808,MATH 20B,A03,093475,Briones; Jor-el Thomas Caparas,2,0,36,34
1657346489837,MATH 20C,A01,083760,Briones; Jor-el Thomas Caparas,1,0,35,34
1657346489837,MATH 20C,A02,083761,Briones; Jor-el Thomas Caparas,8,0,35,27
1657346489837,MATH 20C,A03,093476,Briones; Jor-el Thomas Caparas,0,1,36,36
1657346489837,MATH 20C,B01,083762,Bach; Quang Tran,1,0,30,29
1657346495868,MATH 20D,A01,083765,Tran; Brian Kha,5,0,30,25
1657346495868,MATH 20D,A02,083766,Tran; Brian Kha,5,0,30,25
1657346495868,MATH 20D,A03,083767,Tran; Brian Kha,4,0,30,26
1657346501893,MATH 20E,A01,083771,Ganguly; Soumya,9,0,32,23
1657346501893,MATH 20E,A02,083772,Ganguly; Soumya,6,0,32,26
1657346501893,MATH 20E,B01,083773,Ciotti; Benjamin,20,0,35,15
1657346501893,MATH 20E,B02,083774,Ciotti; Benjamin,17,0,35,18
1657346507924,MATH 103A,A01,083777,Greenfeld; Be'Eri,3,0,36,33
1657346507924,MATH 103A,A02,083778,Greenfeld; Be'Eri,5,0,36,31
1657346507924,MATH 103A,A03,093561,Greenfeld; Be'Eri,5,0,36,31
1657346507924,MATH 103A,B01,083779,Greenfeld; Be'Eri,6,0,36,30
1657346507924,MATH 103A,B02,083780,Greenfeld; Be'Eri,4,0,36,32
1657346507924,MATH 103A,B03,093562,Greenfeld; Be'Eri,3,0,36,33
1657346513951,MATH 105,A01,085443,Carter; Anne Toulson,15,0,35,20
1657346513951,MATH 105,A02,093477,Carter; Anne Toulson,20,0,35,15
1657346519975,MATH 109,A01,083213,Ganzberger; Geoffrey Michael,2,0,34,32
1657346519975,MATH 109,A02,083214,Ganzberger; Geoffrey Michael,4,0,34,30
1657346519975,MATH 109,A03,093478,Ganzberger; Geoffrey Michael,2,0,34,32
1657346519975,MATH 109,B01,083215,Ganzberger; Geoffrey Michael,1,0,32,31
1657346519975,MATH 109,B02,083216,Ganzberger; Geoffrey Michael,2,0,32,30
1657346519975,MATH 109,B03,093479,Ganzberger; Geoffrey Michael,8,0,32,24
1657346526005,MATH 142A,A01,083219,Chow; Bennett,7,0,32,25
1657346526005,MATH 142A,A02,083220,Chow; Bennett,10,0,32,22
1657346526005,MATH 142A,A03,093480,Chow; Bennett,8,0,32,24
1657346526005,MATH 142A,B03,093481,Chow; Bennett,8,0,32,24
1657346526005,MATH 142A,B04,093558,Chow; Bennett,13,0,32,19
1657346526005,MATH 142A,B05,093559,Chow; Bennett,6,0,32,26
1657346532034,MATH 193A,A01,083224,Rotar; Vladimir,8,0,34,26
1657346532034,MATH 193A,A02,083225,Rotar; Vladimir,9,0,34,25
1657346532034,MATH 193A,A03,083781,Rotar; Vladimir,4,0,34,30
1657346532034,MATH 193A,A04,083782,Rotar; Vladimir,9,0,34,25
1657346532034,MATH 193A,A05,093482,Rotar; Vladimir,10,0,34,24
1657346538065,MATH 197,001,091859,McAuley; Julian John,9999,0,9999,0
1657346538065,MATH 197,002,095566,Kedlaya; Kiran S.,9997,0,9999,2
1657346538065,MATH 197,003,095567,Xiao; Ming,9999,0,9999,0
1657346538065,MATH 197,004,095571,Perols; Johan Lars,9998,0,9999,1
1657346545131,COGS 9,A01,083615,Shannon; Kyle Michael,8,0,75,67
1657346551155,COGS 11,A01,083617,Boyle; Mary E. T.,22,0,48,26
1657346557193,COGS 13,A01,083071,Bastos; Amalia Pinkusfeld,11,0,71,60
1657346563216,COGS 14A,A01,092681,Semenuks; Arturs,4,1,100,96
1657346569239,COGS 14B,A01,083073,Cheng; Tzu-Han,6,0,63,57
1657346575269,COGS 17,A01,092677,Semenuks; Arturs,6,0,81,75
1657346581301,COGS 100,A01,083619,Allen; Michael Gordon,16,0,70,54
1657346587323,COGS 101A,A01,083621,Davis; Joshua Daniel,9,0,68,59
1657346593359,COGS 101B,A01,091572,Allen; Michael Gordon,11,0,65,54
1657346599386,COGS 101C,A01,083625,Delgado; Tania,17,0,35,18
1657346605410,COGS 107A,A01,083627,Boyle; Mary E. T.,13,0,60,47
1657346611433,COGS 118A,A01,083075,Gupta; Anjum,20,0,76,56
1657346617456,CSE 3,A50,083646,Miranda; Gregory Joseph,24,0,50,26
1657346623482,CSE 8A,A50,083650,Miranda; Gregory Joseph,17,1,56,39
1657346629506,CSE 11,A01,083080,Cao; Yingjun,6,15,40,34
1657346635540,CSE 12,A01,083652,Krause-Levy; Sophia Louisa,28,1,120,92
1657346641562,CSE 15L,A01,083654,Morris; Justin Loren,9,0,50,41
1657346641562,CSE 15L,A02,083655,Morris; Justin Loren,9,0,50,41
1657346647586,CSE 20,A01,083657,Tran; Khoa Dang,39,0,80,41
1657346653610,CSE 21,A01,095574,Bach; Quang Tran,22,0,48,26
1657346659633,CSE 30,A01,083084,Eldon; John,4,0,80,76
1657346659633,CSE 30,B01,095061,Bhaskar; Nishant,9,0,50,41
1657346665659,CSE 100,A01,083659,Cao; Yingjun,5,4,70,65
1657346671692,CSE 134B,A01,083661,Powell; Thomas Allan,22,0,100,78
1657346677719,CSE 140,A01,083663,Gungor; Onat,14,0,85,71
1657346683742,CSE 140L,A01,083088,Eldon; John,21,0,100,79
1657346689769,CSE 175,A01,083665,Kumar; Rakesh,3,0,25,22
1657346695801,CSE 190,A00,092507,Dubnov; Shlomo,7,0,20,13
1657346701832,ECE 45,A01,083139,Congero; Spencer William,6,0,75,69
1657346707860,ECE 65,A50,083695,Saad; Andrew S,12,0,30,18
1657346707860,ECE 65,A51,095125,Saad; Andrew S,24,0,26,2
1657346713886,ECE 109,A01,091882,Touri; Behrouz,19,0,70,51
1657346719916,ECE 180,A00,083140,Abi Samra; Nicholas Camill,1,0,30,29
1657346719916,ECE 180,B00,083141,Abi Samra; Nicholas Camill,0,0,30,30
1657346725949,MATH 10A,A01,083735,Patchell; Gregory David,2,0,30,28
1657346725949,MATH 10A,A02,083736,Patchell; Gregory David,20,0,30,10
1657346725949,MATH 10A,A03,083737,Patchell; Gregory David,16,0,30,14
1657346731982,MATH 10B,A01,083207,Lim; Seonhee,8,0,34,26
1657346731982,MATH 10B,A02,083208,Lim; Seonhee,9,0,35,26
1657346731982,MATH 10B,A03,093472,Lim; Seonhee,7,0,34,27
1657346731982,MATH 10B,B01,083739,Sinha; Shubham,12,0,30,18
1657346738016,MATH 18,A01,083743,Cinel; Cameron Alexander,7,0,30,23
1657346738016,MATH 18,A02,083744,Cinel; Cameron Alexander,17,0,30,13
1657346738016,MATH 18,A03,083745,Cinel; Cameron Alexander,9,0,30,21
1657346738016,MATH 18,B01,083748,Rideout; David Porter,5,0,37,32
1657346738016,MATH 18,B02,083749,Rideout; David Porter,5,0,36,31
1657346738016,MATH 18,B03,083750,Rideout; David Porter,3,0,37,34
1657346738016,MATH 18,B04,083751,Rideout; David Porter,6,0,36,30
1657346738016,MATH 18,B05,093473,Rideout; David Porter,6,0,36,30
1657346738016,MATH 18,B06,093474,Rideout; David Porter,6,0,36,30
1657346744040,MATH 20A,A01,083754,Zheng; Zequn,14,0,40,26
1657346750063,MATH 20B,A01,083756,Briones; Jor-el Thomas Caparas,4,0,36,32
1657346750063,MATH 20B,A02,083757,Briones; Jor-el Thomas Caparas,1,0,36,35
1657346750063,MATH 20B,A03,093475,Briones; Jor-el Thomas Caparas,2,0,36,34
1657346756090,MATH 20C,A01,083760,Briones; Jor-el Thomas Caparas,1,0,35,34
1657346756090,MATH 20C,A02,083761,Briones; Jor-el Thomas Caparas,8,0,35,27
1657346756090,MATH 20C,A03,093476,Briones; Jor-el Thomas Caparas,0,1,36,36
1657346756090,MATH 20C,B01,083762,Bach; Quang Tran,1,0,30,29
1657346762114,MATH 20D,A01,083765,Tran; Brian Kha,5,0,30,25
1657346762114,MATH 20D,A02,083766,Tran; Brian Kha,5,0,30,25
1657346762114,MATH 20D,A03,083767,Tran; Brian Kha,4,0,30,26
1657346768143,MATH 20E,A01,083771,Ganguly; Soumya,9,0,32,23
1657346768143,MATH 20E,A02,083772,Ganguly; Soumya,6,0,32,26
1657346768143,MATH 20E,B01,083773,Ciotti; Benjamin,20,0,35,15
1657346768143,MATH 20E,B02,083774,Ciotti; Benjamin,17,0,35,18
1657346774172,MATH 103A,A01,083777,Greenfeld; Be'Eri,3,0,36,33
1657346774172,MATH 103A,A02,083778,Greenfeld; Be'Eri,5,0,36,31
1657346774172,MATH 103A,A03,093561,Greenfeld; Be'Eri,5,0,36,31
1657346774172,MATH 103A,B01,083779,Greenfeld; Be'Eri,6,0,36,30
1657346774172,MATH 103A,B02,083780,Greenfeld; Be'Eri,4,0,36,32
1657346774172,MATH 103A,B03,093562,Greenfeld; Be'Eri,3,0,36,33
1657346780200,MATH 105,A01,085443,Carter; Anne Toulson,15,0,35,20
1657346780200,MATH 105,A02,093477,Carter; Anne Toulson,20,0,35,15
1657346786229,MATH 109,A01,083213,Ganzberger; Geoffrey Michael,2,0,34,32
1657346786229,MATH 109,A02,083214,Ganzberger; Geoffrey Michael,4,0,34,30
1657346786229,MATH 109,A03,093478,Ganzberger; Geoffrey Michael,2,0,34,32
1657346786229,MATH 109,B01,083215,Ganzberger; Geoffrey Michael,1,0,32,31
1657346786229,MATH 109,B02,083216,Ganzberger; Geoffrey Michael,2,0,32,30
1657346786229,MATH 109,B03,093479,Ganzberger; Geoffrey Michael,8,0,32,24
1657346792259,MATH 142A,A01,083219,Chow; Bennett,7,0,32,25
1657346792259,MATH 142A,A02,083220,Chow; Bennett,10,0,32,22
1657346792259,MATH 142A,A03,093480,Chow; Bennett,8,0,32,24
1657346792259,MATH 142A,B03,093481,Chow; Bennett,8,0,32,24
1657346792259,MATH 142A,B04,093558,Chow; Bennett,13,0,32,19
1657346792259,MATH 142A,B05,093559,Chow; Bennett,6,0,32,26
1657346798282,MATH 193A,A01,083224,Rotar; Vladimir,8,0,34,26
1657346798282,MATH 193A,A02,083225,Rotar; Vladimir,9,0,34,25
1657346798282,MATH 193A,A03,083781,Rotar; Vladimir,5,0,34,29
1657346798282,MATH 193A,A04,083782,Rotar; Vladimir,9,0,34,25
1657346798282,MATH 193A,A05,093482,Rotar; Vladimir,10,0,34,24
1657346804308,MATH 197,001,091859,McAuley; Julian John,9999,0,9999,0
1657346804308,MATH 197,002,095566,Kedlaya; Kiran S.,9997,0,9999,2
1657346804308,MATH 197,003,095567,Xiao; Ming,9999,0,9999,0
1657346804308,MATH 197,004,095571,Perols; Johan Lars,9998,0,9999,1
1657346811374,COGS 9,A01,083615,Shannon; Kyle Michael,8,0,75,67
1657346817403,COGS 11,A01,083617,Boyle; Mary E. T.,22,0,48,26
1657346823425,COGS 13,A01,083071,Bastos; Amalia Pinkusfeld,11,0,71,60
1657346829453,COGS 14A,A01,092681,Semenuks; Arturs,4,1,100,96
1657346835480,COGS 14B,A01,083073,Cheng; Tzu-Han,6,0,63,57
1657346841502,COGS 17,A01,092677,Semenuks; Arturs,6,0,81,75
1657346847523,COGS 100,A01,083619,Allen; Michael Gordon,16,0,70,54
1657346853546,COGS 101A,A01,083621,Davis; Joshua Daniel,9,0,68,59
1657346859569,COGS 101B,A01,091572,Allen; Michael Gordon,11,0,65,54
1657346865596,COGS 101C,A01,083625,Delgado; Tania,17,0,35,18
1657346871620,COGS 107A,A01,083627,Boyle; Mary E. T.,13,0,60,47
1657346877644,COGS 118A,A01,083075,Gupta; Anjum,20,0,76,56
1657346883669,CSE 3,A50,083646,Miranda; Gregory Joseph,24,0,50,26
1657346889697,CSE 8A,A50,083650,Miranda; Gregory Joseph,17,1,56,39
1657346895724,CSE 11,A01,083080,Cao; Yingjun,6,15,40,34
1657346901750,CSE 12,A01,083652,Krause-Levy; Sophia Louisa,28,1,120,92
1657346907785,CSE 15L,A01,083654,Morris; Justin Loren,9,0,50,41
1657346907785,CSE 15L,A02,083655,Morris; Justin Loren,9,0,50,41
1657346913810,CSE 20,A01,083657,Tran; Khoa Dang,39,0,80,41
1657346919834,CSE 21,A01,095574,Bach; Quang Tran,22,0,48,26
1657346925858,CSE 30,A01,083084,Eldon; John,4,0,80,76
1657346925858,CSE 30,B01,095061,Bhaskar; Nishant,9,0,50,41
1657346931880,CSE 100,A01,083659,Cao; Yingjun,5,4,70,65
1657346937903,CSE 134B,A01,083661,Powell; Thomas Allan,22,0,100,78
1657346943926,CSE 140,A01,083663,Gungor; Onat,14,0,85,71
1657346949950,CSE 140L,A01,083088,Eldon; John,21,0,100,79
1657346955974,CSE 175,A01,083665,Kumar; Rakesh,3,0,25,22
1657346961999,CSE 190,A00,092507,Dubnov; Shlomo,7,0,20,13
1657346968028,ECE 45,A01,083139,Congero; Spencer William,6,0,75,69
1657346974055,ECE 65,A50,083695,Saad; Andrew S,12,0,30,18
1657346974055,ECE 65,A51,095125,Saad; Andrew S,24,0,26,2
1657346980081,ECE 109,A01,091882,Touri; Behrouz,19,0,70,51
1657346986109,ECE 180,A00,083140,Abi Samra; Nicholas Camill,1,0,30,29
1657346986109,ECE 180,B00,083141,Abi Samra; Nicholas Camill,0,0,30,30
1657346992133,MATH 10A,A01,083735,Patchell; Gregory David,2,0,30,28
1657346992133,MATH 10A,A02,083736,Patchell; Gregory David,20,0,30,10
1657346992133,MATH 10A,A03,083737,Patchell; Gregory David,16,0,30,14
1657346998162,MATH 10B,A01,083207,Lim; Seonhee,8,0,34,26
1657346998162,MATH 10B,A02,083208,Lim; Seonhee,9,0,35,26
1657346998162,MATH 10B,A03,093472,Lim; Seonhee,7,0,34,27
1657346998162,MATH 10B,B01,083739,Sinha; Shubham,12,0,30,18
1657347004185,MATH 18,A01,083743,Cinel; Cameron Alexander,7,0,30,23
1657347004185,MATH 18,A02,083744,Cinel; Cameron Alexander,17,0,30,13
1657347004185,MATH 18,A03,083745,Cinel; Cameron Alexander,9,0,30,21
1657347004185,MATH 18,B01,083748,Rideout; David Porter,5,0,37,32
1657347004185,MATH 18,B02,083749,Rideout; David Porter,5,0,36,31
1657347004185,MATH 18,B03,083750,Rideout; David Porter,3,0,37,34
1657347004185,MATH 18,B04,083751,Rideout; David Porter,6,0,36,30
1657347004185,MATH 18,B05,093473,Rideout; David Porter,6,0,36,30
1657347004185,MATH 18,B06,093474,Rideout; David Porter,6,0,36,30
1657347010208,MATH 20A,A01,083754,Zheng; Zequn,14,0,40,26
1657347016232,MATH 20B,A01,083756,Briones; Jor-el Thomas Caparas,4,0,36,32
1657347016232,MATH 20B,A02,083757,Briones; Jor-el Thomas Caparas,1,0,36,35
1657347016232,MATH 20B,A03,093475,Briones; Jor-el Thomas Caparas,2,0,36,34
1657347022349,MATH 20C,A01,083760,Briones; Jor-el Thomas Caparas,1,0,35,34
1657347022349,MATH 20C,A02,083761,Briones; Jor-el Thomas Caparas,8,0,35,27
1657347022349,MATH 20C,A03,093476,Briones; Jor-el Thomas Caparas,0,1,36,36
1657347022349,MATH 20C,B01,083762,Bach; Quang Tran,1,0,30,29
1657347028383,MATH 20D,A01,083765,Tran; Brian Kha,5,0,30,25
1657347028383,MATH 20D,A02,083766,Tran; Brian Kha,5,0,30,25
1657347028383,MATH 20D,A03,083767,Tran; Brian Kha,4,0,30,26
1657347034413,MATH 20E,A01,083771,Ganguly; Soumya,9,0,32,23
1657347034413,MATH 20E,A02,083772,Ganguly; Soumya,6,0,32,26
1657347034413,MATH 20E,B01,083773,Ciotti; Benjamin,20,0,35,15
1657347034413,MATH 20E,B02,083774,Ciotti; Benjamin,17,0,35,18
1657347040436,MATH 103A,A01,083777,Greenfeld; Be'Eri,3,0,36,33
1657347040436,MATH 103A,A02,083778,Greenfeld; Be'Eri,5,0,36,31
1657347040436,MATH 103A,A03,093561,Greenfeld; Be'Eri,5,0,36,31
1657347040436,MATH 103A,B01,083779,Greenfeld; Be'Eri,6,0,36,30
1657347040436,MATH 103A,B02,083780,Greenfeld; Be'Eri,4,0,36,32
1657347040436,MATH 103A,B03,093562,Greenfeld; Be'Eri,3,0,36,33
1657347046464,MATH 105,A01,085443,Carter; Anne Toulson,15,0,35,20
1657347046464,MATH 105,A02,093477,Carter; Anne Toulson,20,0,35,15
1657347052488,MATH 109,A01,083213,Ganzberger; Geoffrey Michael,2,0,34,32
1657347052488,MATH 109,A02,083214,Ganzberger; Geoffrey Michael,4,0,34,30
1657347052488,MATH 109,A03,093478,Ganzberger; Geoffrey Michael,2,0,34,32
1657347052488,MATH 109,B01,083215,Ganzberger; Geoffrey Michael,1,0,32,31
1657347052488,MATH 109,B02,083216,Ganzberger; Geoffrey Michael,2,0,32,30
1657347052488,MATH 109,B03,093479,Ganzberger; Geoffrey Michael,8,0,32,24
1657347058518,MATH 142A,A01,083219,Chow; Bennett,7,0,32,25
1657347058518,MATH 142A,A02,083220,Chow; Bennett,10,0,32,22
1657347058518,MATH 142A,A03,093480,Chow; Bennett,8,0,32,24
1657347058518,MATH 142A,B03,093481,Chow; Bennett,8,0,32,24
1657347058518,MATH 142A,B04,093558,Chow; Bennett,13,0,32,19
1657347058518,MATH 142A,B05,093559,Chow; Bennett,6,0,32,26
1657347064541,MATH 193A,A01,083224,Rotar; Vladimir,8,0,34,26
1657347064541,MATH 193A,A02,083225,Rotar; Vladimir,9,0,34,25
1657347064541,MATH 193A,A03,083781,Rotar; Vladimir,5,0,34,29
1657347064541,MATH 193A,A04,083782,Rotar; Vladimir,9,0,34,25
1657347064541,MATH 193A,A05,093482,Rotar; Vladimir,10,0,34,24
1657347070570,MATH 197,001,091859,McAuley; Julian John,9999,0,9999,0
1657347070570,MATH 197,002,095566,Kedlaya; Kiran S.,9997,0,9999,2
1657347070570,MATH 197,003,095567,Xiao; Ming,9999,0,9999,0
1657347070570,MATH 197,004,095571,Perols; Johan Lars,9998,0,9999,1
1657347077632,COGS 9,A01,083615,Shannon; Kyle Michael,8,0,75,67
1657347083660,COGS 11,A01,083617,Boyle; Mary E. T.,22,0,48,26
1657347089686,COGS 13,A01,083071,Bastos; Amalia Pinkusfeld,11,0,71,60
1657347095709,COGS 14A,A01,092681,Semenuks; Arturs,4,1,100,96
1657347101732,COGS 14B,A01,083073,Cheng; Tzu-Han,6,0,63,57
1657347107756,COGS 17,A01,092677,Semenuks; Arturs,6,0,81,75
1657347113779,COGS 100,A01,083619,Allen; Michael Gordon,16,0,70,54
1657347119805,COGS 101A,A01,083621,Davis; Joshua Daniel,9,0,68,59
1657347125833,COGS 101B,A01,091572,Allen; Michael Gordon,11,0,65,54
1657347131858,COGS 101C,A01,083625,Delgado; Tania,17,0,35,18
1657347137883,COGS 107A,A01,083627,Boyle; Mary E. T.,13,0,60,47
1657347143906,COGS 118A,A01,083075,Gupta; Anjum,20,0,76,56
1657347149935,CSE 3,A50,083646,Miranda; Gregory Joseph,24,0,50,26
1657347155964,CSE 8A,A50,083650,Miranda; Gregory Joseph,17,1,56,39
1657347161985,CSE 11,A01,083080,Cao; Yingjun,6,15,40,34
1657347168013,CSE 12,A01,083652,Krause-Levy; Sophia Louisa,28,1,120,92
1657347174037,CSE 15L,A01,083654,Morris; Justin Loren,9,0,50,41
1657347174037,CSE 15L,A02,083655,Morris; Justin Loren,9,0,50,41
1657347180060,CSE 20,A01,083657,Tran; Khoa Dang,39,0,80,41
1657347186085,CSE 21,A01,095574,Bach; Quang Tran,22,0,48,26
1657347192112,CSE 30,A01,083084,Eldon; John,4,0,80,76
1657347192112,CSE 30,B01,095061,Bhaskar; Nishant,9,0,50,41
1657347198140,CSE 100,A01,083659,Cao; Yingjun,5,4,70,65
1657347204163,CSE 134B,A01,083661,Powell; Thomas Allan,22,0,100,78
1657347210189,CSE 140,A01,083663,Gungor; Onat,14,0,85,71
1657347216217,CSE 140L,A01,083088,Eldon; John,21,0,100,79
1657347222242,CSE 175,A01,083665,Kumar; Rakesh,3,0,25,22
1657347228265,CSE 190,A00,092507,Dubnov; Shlomo,7,0,20,13
1657347234289,ECE 45,A01,083139,Congero; Spencer William,6,0,75,69
1657347240313,ECE 65,A50,083695,Saad; Andrew S,12,0,30,18
1657347240313,ECE 65,A51,095125,Saad; Andrew S,24,0,26,2
1657347246340,ECE 109,A01,091882,Touri; Behrouz,19,0,70,51
1657347252368,ECE 180,A00,083140,Abi Samra; Nicholas Camill,1,0,30,29
1657347252368,ECE 180,B00,083141,Abi Samra; Nicholas Camill,0,0,30,30
1657347258391,MATH 10A,A01,083735,Patchell; Gregory David,2,0,30,28
1657347258391,MATH 10A,A02,083736,Patchell; Gregory David,20,0,30,10
1657347258391,MATH 10A,A03,083737,Patchell; Gregory David,16,0,30,14
1657347264415,MATH 10B,A01,083207,Lim; Seonhee,8,0,34,26
1657347264415,MATH 10B,A02,083208,Lim; Seonhee,9,0,35,26
1657347264415,MATH 10B,A03,093472,Lim; Seonhee,7,0,34,27
1657347264415,MATH 10B,B01,083739,Sinha; Shubham,12,0,30,18
1657347270442,MATH 18,A01,083743,Cinel; Cameron Alexander,7,0,30,23
1657347270442,MATH 18,A02,083744,Cinel; Cameron Alexander,17,0,30,13
1657347270442,MATH 18,A03,083745,Cinel; Cameron Alexander,9,0,30,21
1657347270442,MATH 18,B01,083748,Rideout; David Porter,5,0,37,32
1657347270442,MATH 18,B02,083749,Rideout; David Porter,5,0,36,31
1657347270442,MATH 18,B03,083750,Rideout; David Porter,3,0,37,34
1657347270442,MATH 18,B04,083751,Rideout; David Porter,6,0,36,30
1657347270442,MATH 18,B05,093473,Rideout; David Porter,6,0,36,30
1657347270442,MATH 18,B06,093474,Rideout; David Porter,6,0,36,30
1657347276466,MATH 20A,A01,083754,Zheng; Zequn,14,0,40,26
1657347282494,MATH 20B,A01,083756,Briones; Jor-el Thomas Caparas,4,0,36,32
1657347282494,MATH 20B,A02,083757,Briones; Jor-el Thomas Caparas,1,0,36,35
1657347282494,MATH 20B,A03,093475,Briones; Jor-el Thomas Caparas,2,0,36,34
1657347288533,MATH 20C,A01,083760,Briones; Jor-el Thomas Caparas,1,0,35,34
1657347288533,MATH 20C,A02,083761,Briones; Jor-el Thomas Caparas,8,0,35,27
1657347288533,MATH 20C,A03,093476,Briones; Jor-el Thomas Caparas,0,1,36,36
1657347288533,MATH 20C,B01,083762,Bach; Quang Tran,1,0,30,29
1657347294557,MATH 20D,A01,083765,Tran; Brian Kha,5,0,30,25
1657347294557,MATH 20D,A02,083766,Tran; Brian Kha,5,0,30,25
1657347294557,MATH 20D,A03,083767,Tran; Brian Kha,4,0,30,26
1657347300582,MATH 20E,A01,083771,Ganguly; Soumya,9,0,32,23
1657347300582,MATH 20E,A02,083772,Ganguly; Soumya,6,0,32,26
1657347300582,MATH 20E,B01,083773,Ciotti; Benjamin,20,0,35,15
1657347300582,MATH 20E,B02,083774,Ciotti; Benjamin,17,0,35,18
1657347306617,MATH 103A,A01,083777,Greenfeld; Be'Eri,3,0,36,33
1657347306617,MATH 103A,A02,083778,Greenfeld; Be'Eri,5,0,36,31
1657347306617,MATH 103A,A03,093561,Greenfeld; Be'Eri,5,0,36,31
1657347306617,MATH 103A,B01,083779,Greenfeld; Be'Eri,6,0,36,30
1657347306617,MATH 103A,B02,083780,Greenfeld; Be'Eri,4,0,36,32
1657347306617,MATH 103A,B03,093562,Greenfeld; Be'Eri,3,0,36,33
1657347312640,MATH 105,A01,085443,Carter; Anne Toulson,15,0,35,20
1657347312640,MATH 105,A02,093477,Carter; Anne Toulson,20,0,35,15
1657347318667,MATH 109,A01,083213,Ganzberger; Geoffrey Michael,2,0,34,32
1657347318667,MATH 109,A02,083214,Ganzberger; Geoffrey Michael,4,0,34,30
1657347318667,MATH 109,A03,093478,Ganzberger; Geoffrey Michael,2,0,34,32
1657347318667,MATH 109,B01,083215,Ganzberger; Geoffrey Michael,1,0,32,31
1657347318667,MATH 109,B02,083216,Ganzberger; Geoffrey Michael,2,0,32,30
1657347318667,MATH 109,B03,093479,Ganzberger; Geoffrey Michael,8,0,32,24
1657347324689,MATH 142A,A01,083219,Chow; Bennett,7,0,32,25
1657347324689,MATH 142A,A02,083220,Chow; Bennett,10,0,32,22
1657347324689,MATH 142A,A03,093480,Chow; Bennett,8,0,32,24
1657347324689,MATH 142A,B03,093481,Chow; Bennett,8,0,32,24
1657347324689,MATH 142A,B04,093558,Chow; Bennett,13,0,32,19
1657347324689,MATH 142A,B05,093559,Chow; Bennett,6,0,32,26
1657347330713,MATH 193A,A01,083224,Rotar; Vladimir,8,0,34,26
1657347330713,MATH 193A,A02,083225,Rotar; Vladimir,9,0,34,25
1657347330713,MATH 193A,A03,083781,Rotar; Vladimir,5,0,34,29
1657347330713,MATH 193A,A04,083782,Rotar; Vladimir,10,0,34,24
1657347330713,MATH 193A,A05,093482,Rotar; Vladimir,10,0,34,24
1657347336738,MATH 197,001,091859,McAuley; Julian John,9999,0,9999,0
1657347336738,MATH 197,002,095566,Kedlaya; Kiran S.,9997,0,9999,2
1657347336738,MATH 197,003,095567,Xiao; Ming,9999,0,9999,0
1657347336738,MATH 197,004,095571,Perols; Johan Lars,9998,0,9999,1
1657347343802,COGS 9,A01,083615,Shannon; Kyle Michael,8,0,75,67
1657347349826,COGS 11,A01,083617,Boyle; Mary E. T.,22,0,48,26
1657347355849,COGS 13,A01,083071,Bastos; Amalia Pinkusfeld,11,0,71,60
1657347361879,COGS 14A,A01,092681,Semenuks; Arturs,4,1,100,96
1657347367901,COGS 14B,A01,083073,Cheng; Tzu-Han,6,0,63,57
1657347373925,COGS 17,A01,092677,Semenuks; Arturs,6,0,81,75
1657347379948,COGS 100,A01,083619,Allen; Michael Gordon,16,0,70,54
1657347385971,COGS 101A,A01,083621,Davis; Joshua Daniel,9,0,68,59
1657347391998,COGS 101B,A01,091572,Allen; Michael Gordon,11,0,65,54
1657347398022,COGS 101C,A01,083625,Delgado; Tania,17,0,35,18
1657347404046,COGS 107A,A01,083627,Boyle; Mary E. T.,13,0,60,47
1657347410070,COGS 118A,A01,083075,Gupta; Anjum,20,0,76,56
1657347416099,CSE 3,A50,083646,Miranda; Gregory Joseph,24,0,50,26
1657347422136,CSE 8A,A50,083650,Miranda; Gregory Joseph,17,1,56,39
1657347428163,CSE 11,A01,083080,Cao; Yingjun,6,15,40,34
1657347434191,CSE 12,A01,083652,Krause-Levy; Sophia Louisa,28,1,120,92
1657347440214,CSE 15L,A01,083654,Morris; Justin Loren,9,0,50,41
1657347440214,CSE 15L,A02,083655,Morris; Justin Loren,9,0,50,41
1657347446241,CSE 20,A01,083657,Tran; Khoa Dang,39,0,80,41
1657347452264,CSE 21,A01,095574,Bach; Quang Tran,22,0,48,26
1657347458291,CSE 30,A01,083084,Eldon; John,4,0,80,76
1657347458291,CSE 30,B01,095061,Bhaskar; Nishant,9,0,50,41
1657347464315,CSE 100,A01,083659,Cao; Yingjun,5,4,70,65
1657347470342,CSE 134B,A01,083661,Powell; Thomas Allan,22,0,100,78
1657347476370,CSE 140,A01,083663,Gungor; Onat,14,0,85,71
1657347482392,CSE 140L,A01,083088,Eldon; John,21,0,100,79
1657347488414,CSE 175,A01,083665,Kumar; Rakesh,3,0,25,22
1657347494442,CSE 190,A00,092507,Dubnov; Shlomo,7,0,20,13
1657347500467,ECE 45,A01,083139,Congero; Spencer William,6,0,75,69
1657347506491,ECE 65,A50,083695,Saad; Andrew S,12,0,30,18
1657347506491,ECE 65,A51,095125,Saad; Andrew S,24,0,26,2
1657347512516,ECE 109,A01,091882,Touri; Behrouz,19,0,70,51
1657347518539,ECE 180,A00,083140,Abi Samra; Nicholas Camill,1,0,30,29
1657347518539,ECE 180,B00,083141,Abi Samra; Nicholas Camill,0,0,30,30
1657347524561,MATH 10A,A01,083735,Patchell; Gregory David,2,0,30,28
1657347524561,MATH 10A,A02,083736,Patchell; Gregory David,20,0,30,10
1657347524561,MATH 10A,A03,083737,Patchell; Gregory David,16,0,30,14
1657347530584,MATH 10B,A01,083207,Lim; Seonhee,8,0,34,26
1657347530584,MATH 10B,A02,083208,Lim; Seonhee,9,0,35,26
1657347530584,MATH 10B,A03,093472,Lim; Seonhee,7,0,34,27
1657347530584,MATH 10B,B01,083739,Sinha; Shubham,12,0,30,18
1657347536616,MATH 18,A01,083743,Cinel; Cameron Alexander,7,0,30,23
1657347536616,MATH 18,A02,083744,Cinel; Cameron Alexander,17,0,30,13
1657347536616,MATH 18,A03,083745,Cinel; Cameron Alexander,9,0,30,21
1657347536616,MATH 18,B01,083748,Rideout; David Porter,5,0,37,32
1657347536616,MATH 18,B02,083749,Rideout; David Porter,5,0,36,31
1657347536616,MATH 18,B03,083750,Rideout; David Porter,3,0,37,34
1657347536616,MATH 18,B04,083751,Rideout; David Porter,6,0,36,30
1657347536616,MATH 18,B05,093473,Rideout; David Porter,6,0,36,30
1657347536616,MATH 18,B06,093474,Rideout; David Porter,6,0,36,30
1657347542650,MATH 20A,A01,083754,Zheng; Zequn,14,0,40,26
1657347548678,MATH 20B,A01,083756,Briones; Jor-el Thomas Caparas,4,0,36,32
1657347548678,MATH 20B,A02,083757,Briones; Jor-el Thomas Caparas,1,0,36,35
1657347548678,MATH 20B,A03,093475,Briones; Jor-el Thomas Caparas,2,0,36,34
1657347554707,MATH 20C,A01,083760,Briones; Jor-el Thomas Caparas,1,0,35,34
1657347554707,MATH 20C,A02,083761,Briones; Jor-el Thomas Caparas,8,0,35,27
1657347554707,MATH 20C,A03,093476,Briones; Jor-el Thomas Caparas,0,1,36,36
1657347554707,MATH 20C,B01,083762,Bach; Quang Tran,1,0,30,29
1657347560735,MATH 20D,A01,083765,Tran; Brian Kha,5,0,30,25
1657347560735,MATH 20D,A02,083766,Tran; Brian Kha,5,0,30,25
1657347560735,MATH 20D,A03,083767,Tran; Brian Kha,4,0,30,26
1657347566760,MATH 20E,A01,083771,Ganguly; Soumya,9,0,32,23
1657347566760,MATH 20E,A02,083772,Ganguly; Soumya,6,0,32,26
1657347566760,MATH 20E,B01,083773,Ciotti; Benjamin,20,0,35,15
1657347566760,MATH 20E,B02,083774,Ciotti; Benjamin,17,0,35,18
1657347572789,MATH 103A,A01,083777,Greenfeld; Be'Eri,3,0,36,33
1657347572789,MATH 103A,A02,083778,Greenfeld; Be'Eri,5,0,36,31
1657347572789,MATH 103A,A03,093561,Greenfeld; Be'Eri,5,0,36,31
1657347572789,MATH 103A,B01,083779,Greenfeld; Be'Eri,6,0,36,30
1657347572789,MATH 103A,B02,083780,Greenfeld; Be'Eri,4,0,36,32
1657347572789,MATH 103A,B03,093562,Greenfeld; Be'Eri,3,0,36,33
1657347578820,MATH 105,A01,085443,Carter; Anne Toulson,15,0,35,20
1657347578820,MATH 105,A02,093477,Carter; Anne Toulson,20,0,35,15
1657347584850,MATH 109,A01,083213,Ganzberger; Geoffrey Michael,2,0,34,32
1657347584850,MATH 109,A02,083214,Ganzberger; Geoffrey Michael,4,0,34,30
1657347584850,MATH 109,A03,093478,Ganzberger; Geoffrey Michael,2,0,34,32
1657347584850,MATH 109,B01,083215,Ganzberger; Geoffrey Michael,1,0,32,31
1657347584850,MATH 109,B02,083216,Ganzberger; Geoffrey Michael,2,0,32,30
1657347584850,MATH 109,B03,093479,Ganzberger; Geoffrey Michael,8,0,32,24
1657347590881,MATH 142A,A01,083219,Chow; Bennett,7,0,32,25
1657347590881,MATH 142A,A02,083220,Chow; Bennett,10,0,32,22
1657347590881,MATH 142A,A03,093480,Chow; Bennett,8,0,32,24
1657347590881,MATH 142A,B03,093481,Chow; Bennett,8,0,32,24
1657347590881,MATH 142A,B04,093558,Chow; Bennett,13,0,32,19
1657347590881,MATH 142A,B05,093559,Chow; Bennett,6,0,32,26
1657347596905,MATH 193A,A01,083224,Rotar; Vladimir,8,0,34,26
1657347596905,MATH 193A,A02,083225,Rotar; Vladimir,9,0,34,25
1657347596905,MATH 193A,A03,083781,Rotar; Vladimir,5,0,34,29
1657347596905,MATH 193A,A04,083782,Rotar; Vladimir,10,0,34,24
1657347596905,MATH 193A,A05,093482,Rotar; Vladimir,10,0,34,24
1657347602932,MATH 197,001,091859,McAuley; Julian John,9999,0,9999,0
1657347602932,MATH 197,002,095566,Kedlaya; Kiran S.,9997,0,9999,2
1657347602932,MATH 197,003,095567,Xiao; Ming,9999,0,9999,0
1657347602932,MATH 197,004,095571,Perols; Johan Lars,9998,0,9999,1
1657347610001,COGS 9,A01,083615,Shannon; Kyle Michael,8,0,75,67
1657347616101,COGS 11,A01,083617,Boyle; Mary E. T.,22,0,48,26
1657347622137,COGS 13,A01,083071,Bastos; Amalia Pinkusfeld,11,0,71,60
1657347628163,COGS 14A,A01,092681,Semenuks; Arturs,4,1,100,96
1657347634193,COGS 14B,A01,083073,Cheng; Tzu-Han,6,0,63,57
1657347640215,COGS 17,A01,092677,Semenuks; Arturs,6,0,81,75
1657347646243,COGS 100,A01,083619,Allen; Michael Gordon,16,0,70,54
1657347652267,COGS 101A,A01,083621,Davis; Joshua Daniel,9,0,68,59
1657347658293,COGS 101B,A01,091572,Allen; Michael Gordon,11,0,65,54
1657347664319,COGS 101C,A01,083625,Delgado; Tania,17,0,35,18
1657347670345,COGS 107A,A01,083627,Boyle; Mary E. T.,13,0,60,47
1657347676371,COGS 118A,A01,083075,Gupta; Anjum,20,0,76,56
1657347682400,CSE 3,A50,083646,Miranda; Gregory Joseph,24,0,50,26
1657347688423,CSE 8A,A50,083650,Miranda; Gregory Joseph,17,1,56,39
1657347694451,CSE 11,A01,083080,Cao; Yingjun,6,15,40,34
1657347700479,CSE 12,A01,083652,Krause-Levy; Sophia Louisa,28,1,120,92
1657347706501,CSE 15L,A01,083654,Morris; Justin Loren,9,0,50,41
1657347706501,CSE 15L,A02,083655,Morris; Justin Loren,9,0,50,41
1657347712524,CSE 20,A01,083657,Tran; Khoa Dang,39,0,80,41
1657347718546,CSE 21,A01,095574,Bach; Quang Tran,22,0,48,26
1657347724571,CSE 30,A01,083084,Eldon; John,4,0,80,76
1657347724571,CSE 30,B01,095061,Bhaskar; Nishant,9,0,50,41
1657347730592,CSE 100,A01,083659,Cao; Yingjun,5,4,70,65
1657347736613,CSE 134B,A01,083661,Powell; Thomas Allan,22,0,100,78
1657347742646,CSE 140,A01,083663,Gungor; Onat,14,0,85,71
1657347748668,CSE 140L,A01,083088,Eldon; John,21,0,100,79
1657347754694,CSE 175,A01,083665,Kumar; Rakesh,3,0,25,22
1657347760719,CSE 190,A00,092507,Dubnov; Shlomo,7,0,20,13
1657347766744,ECE 45,A01,083139,Congero; Spencer William,6,0,75,69
1657347772768,ECE 65,A50,083695,Saad; Andrew S,12,0,30,18
1657347772768,ECE 65,A51,095125,Saad; Andrew S,24,0,26,2
1657347778792,ECE 109,A01,091882,Touri; Behrouz,19,0,70,51
1657347784815,ECE 180,A00,083140,Abi Samra; Nicholas Camill,1,0,30,29
1657347784815,ECE 180,B00,083141,Abi Samra; Nicholas Camill,0,0,30,30
1657347790842,MATH 10A,A01,083735,Patchell; Gregory David,2,0,30,28
1657347790842,MATH 10A,A02,083736,Patchell; Gregory David,20,0,30,10
1657347790842,MATH 10A,A03,083737,Patchell; Gregory David,16,0,30,14
1657347796877,MATH 10B,A01,083207,Lim; Seonhee,8,0,34,26
1657347796877,MATH 10B,A02,083208,Lim; Seonhee,9,0,35,26
1657347796877,MATH 10B,A03,093472,Lim; Seonhee,7,0,34,27
1657347796877,MATH 10B,B01,083739,Sinha; Shubham,12,0,30,18
1657347802902,MATH 18,A01,083743,Cinel; Cameron Alexander,7,0,30,23
1657347802902,MATH 18,A02,083744,Cinel; Cameron Alexander,17,0,30,13
1657347802902,MATH 18,A03,083745,Cinel; Cameron Alexander,9,0,30,21
1657347802902,MATH 18,B01,083748,Rideout; David Porter,5,0,37,32
1657347802902,MATH 18,B02,083749,Rideout; David Porter,5,0,36,31
1657347802902,MATH 18,B03,083750,Rideout; David Porter,3,0,37,34
1657347802902,MATH 18,B04,083751,Rideout; David Porter,6,0,36,30
1657347802902,MATH 18,B05,093473,Rideout; David Porter,6,0,36,30
1657347802902,MATH 18,B06,093474,Rideout; David Porter,6,0,36,30
1657347808927,MATH 20A,A01,083754,Zheng; Zequn,14,0,40,26
1657347814954,MATH 20B,A01,083756,Briones; Jor-el Thomas Caparas,4,0,36,32
1657347814954,MATH 20B,A02,083757,Briones; Jor-el Thomas Caparas,1,0,36,35
1657347814954,MATH 20B,A03,093475,Briones; Jor-el Thomas Caparas,2,0,36,34
1657347820978,MATH 20C,A01,083760,Briones; Jor-el Thomas Caparas,1,0,35,34
1657347820978,MATH 20C,A02,083761,Briones; Jor-el Thomas Caparas,8,0,35,27
1657347820978,MATH 20C,A03,093476,Briones; Jor-el Thomas Caparas,0,1,36,36
1657347820978,MATH 20C,B01,083762,Bach; Quang Tran,1,0,30,29
1657347827007,MATH 20D,A01,083765,Tran; Brian Kha,5,0,30,25
1657347827007,MATH 20D,A02,083766,Tran; Brian Kha,5,0,30,25
1657347827007,MATH 20D,A03,083767,Tran; Brian Kha,4,0,30,26
1657347833031,MATH 20E,A01,083771,Ganguly; Soumya,9,0,32,23
1657347833031,MATH 20E,A02,083772,Ganguly; Soumya,6,0,32,26
1657347833031,MATH 20E,B01,083773,Ciotti; Benjamin,20,0,35,15
1657347833031,MATH 20E,B02,083774,Ciotti; Benjamin,17,0,35,18
1657347839061,MATH 103A,A01,083777,Greenfeld; Be'Eri,3,0,36,33
1657347839061,MATH 103A,A02,083778,Greenfeld; Be'Eri,5,0,36,31
1657347839061,MATH 103A,A03,093561,Greenfeld; Be'Eri,5,0,36,31
1657347839061,MATH 103A,B01,083779,Greenfeld; Be'Eri,6,0,36,30
1657347839061,MATH 103A,B02,083780,Greenfeld; Be'Eri,4,0,36,32
1657347839061,MATH 103A,B03,093562,Greenfeld; Be'Eri,3,0,36,33
1657347845085,MATH 105,A01,085443,Carter; Anne Toulson,15,0,35,20
1657347845085,MATH 105,A02,093477,Carter; Anne Toulson,20,0,35,15
1657347851108,MATH 109,A01,083213,Ganzberger; Geoffrey Michael,2,0,34,32
1657347851108,MATH 109,A02,083214,Ganzberger; Geoffrey Michael,4,0,34,30
1657347851108,MATH 109,A03,093478,Ganzberger; Geoffrey Michael,2,0,34,32
1657347851108,MATH 109,B01,083215,Ganzberger; Geoffrey Michael,1,0,32,31
1657347851108,MATH 109,B02,083216,Ganzberger; Geoffrey Michael,2,0,32,30
1657347851108,MATH 109,B03,093479,Ganzberger; Geoffrey Michael,8,0,32,24
1657347857132,MATH 142A,A01,083219,Chow; Bennett,7,0,32,25
1657347857132,MATH 142A,A02,083220,Chow; Bennett,10,0,32,22
1657347857132,MATH 142A,A03,093480,Chow; Bennett,8,0,32,24
1657347857132,MATH 142A,B03,093481,Chow; Bennett,8,0,32,24
1657347857132,MATH 142A,B04,093558,Chow; Bennett,13,0,32,19
1657347857132,MATH 142A,B05,093559,Chow; Bennett,6,0,32,26
1657347863155,MATH 193A,A01,083224,Rotar; Vladimir,8,0,34,26
1657347863155,MATH 193A,A02,083225,Rotar; Vladimir,9,0,34,25
1657347863155,MATH 193A,A03,083781,Rotar; Vladimir,5,0,34,29
1657347863155,MATH 193A,A04,083782,Rotar; Vladimir,10,0,34,24
1657347863155,MATH 193A,A05,093482,Rotar; Vladimir,10,0,34,24
1657347869182,MATH 197,001,091859,McAuley; Julian John,9999,0,9999,0
1657347869182,MATH 197,002,095566,Kedlaya; Kiran S.,9997,0,9999,2
1657347869182,MATH 197,003,095567,Xiao; Ming,9999,0,9999,0
1657347869182,MATH 197,004,095571,Perols; Johan Lars,9998,0,9999,1
1657347876241,COGS 9,A01,083615,Shannon; Kyle Michael,8,0,75,67
1657347882267,COGS 11,A01,083617,Boyle; Mary E. T.,22,0,48,26
1657347888295,COGS 13,A01,083071,Bastos; Amalia Pinkusfeld,11,0,71,60
1657347894327,COGS 14A,A01,092681,Semenuks; Arturs,4,1,100,96
1657347900356,COGS 14B,A01,083073,Cheng; Tzu-Han,6,0,63,57
1657347906386,COGS 17,A01,092677,Semenuks; Arturs,6,0,81,75
1657347912410,COGS 100,A01,083619,Allen; Michael Gordon,16,0,70,54
1657347918432,COGS 101A,A01,083621,Davis; Joshua Daniel,9,0,68,59
1657347924456,COGS 101B,A01,091572,Allen; Michael Gordon,11,0,65,54
1657347930482,COGS 101C,A01,083625,Delgado; Tania,17,0,35,18
1657347936506,COGS 107A,A01,083627,Boyle; Mary E. T.,13,0,60,47
1657347942529,COGS 118A,A01,083075,Gupta; Anjum,20,0,76,56
1657347948557,CSE 3,A50,083646,Miranda; Gregory Joseph,24,0,50,26
1657347954583,CSE 8A,A50,083650,Miranda; Gregory Joseph,17,1,56,39
1657347960607,CSE 11,A01,083080,Cao; Yingjun,6,15,40,34
1657347966629,CSE 12,A01,083652,Krause-Levy; Sophia Louisa,28,1,120,92
1657347972652,CSE 15L,A01,083654,Morris; Justin Loren,9,0,50,41
1657347972652,CSE 15L,A02,083655,Morris; Justin Loren,9,0,50,41
1657347978681,CSE 20,A01,083657,Tran; Khoa Dang,39,0,80,41
1657347984714,CSE 21,A01,095574,Bach; Quang Tran,22,0,48,26
1657347990741,CSE 30,A01,083084,Eldon; John,4,0,80,76
1657347990741,CSE 30,B01,095061,Bhaskar; Nishant,9,0,50,41
1657347996767,CSE 100,A01,083659,Cao; Yingjun,5,4,70,65
1657348002793,CSE 134B,A01,083661,Powell; Thomas Allan,22,0,100,78
1657348008818,CSE 140,A01,083663,Gungor; Onat,14,0,85,71
1657348014842,CSE 140L,A01,083088,Eldon; John,21,0,100,79
1657348020864,CSE 175,A01,083665,Kumar; Rakesh,3,0,25,22
1657348026893,CSE 190,A00,092507,Dubnov; Shlomo,7,0,20,13
1657348032925,ECE 45,A01,083139,Congero; Spencer William,6,0,75,69
1657348038949,ECE 65,A50,083695,Saad; Andrew S,12,0,30,18
1657348038949,ECE 65,A51,095125,Saad; Andrew S,24,0,26,2
1657348044985,ECE 109,A01,091882,Touri; Behrouz,19,0,70,51
1657348051010,ECE 180,A00,083140,Abi Samra; Nicholas Camill,1,0,30,29
1657348051010,ECE 180,B00,083141,Abi Samra; Nicholas Camill,0,0,30,30
1657348057038,MATH 10A,A01,083735,Patchell; Gregory David,2,0,30,28
1657348057038,MATH 10A,A02,083736,Patchell; Gregory David,20,0,30,10
1657348057038,MATH 10A,A03,083737,Patchell; Gregory David,16,0,30,14
1657348063062,MATH 10B,A01,083207,Lim; Seonhee,8,0,34,26
1657348063062,MATH 10B,A02,083208,Lim; Seonhee,9,0,35,26
1657348063062,MATH 10B,A03,093472,Lim; Seonhee,7,0,34,27
1657348063062,MATH 10B,B01,083739,Sinha; Shubham,12,0,30,18
1657348069098,MATH 18,A01,083743,Cinel; Cameron Alexander,7,0,30,23
1657348069098,MATH 18,A02,083744,Cinel; Cameron Alexander,17,0,30,13
1657348069098,MATH 18,A03,083745,Cinel; Cameron Alexander,9,0,30,21
1657348069098,MATH 18,B01,083748,Rideout; David Porter,5,0,37,32
1657348069098,MATH 18,B02,083749,Rideout; David Porter,5,0,36,31
1657348069098,MATH 18,B03,083750,Rideout; David Porter,3,0,37,34
1657348069098,MATH 18,B04,083751,Rideout; David Porter,6,0,36,30
1657348069098,MATH 18,B05,093473,Rideout; David Porter,6,0,36,30
1657348069098,MATH 18,B06,093474,Rideout; David Porter,6,0,36,30
1657348075123,MATH 20A,A01,083754,Zheng; Zequn,14,0,40,26
1657348081148,MATH 20B,A01,083756,Briones; Jor-el Thomas Caparas,4,0,36,32
1657348081148,MATH 20B,A02,083757,Briones; Jor-el Thomas Caparas,1,0,36,35
1657348081148,MATH 20B,A03,093475,Briones; Jor-el Thomas Caparas,2,0,36,34
1657348087172,MATH 20C,A01,083760,Briones; Jor-el Thomas Caparas,1,0,35,34
1657348087172,MATH 20C,A02,083761,Briones; Jor-el Thomas Caparas,8,0,35,27
1657348087172,MATH 20C,A03,093476,Briones; Jor-el Thomas Caparas,0,1,36,36
1657348087172,MATH 20C,B01,083762,Bach; Quang Tran,1,0,30,29
1657348093201,MATH 20D,A01,083765,Tran; Brian Kha,5,0,30,25
1657348093201,MATH 20D,A02,083766,Tran; Brian Kha,5,0,30,25
1657348093201,MATH 20D,A03,083767,Tran; Brian Kha,4,0,30,26
1657348099228,MATH 20E,A01,083771,Ganguly; Soumya,9,0,32,23
1657348099228,MATH 20E,A02,083772,Ganguly; Soumya,6,0,32,26
1657348099228,MATH 20E,B01,083773,Ciotti; Benjamin,20,0,35,15
1657348099228,MATH 20E,B02,083774,Ciotti; Benjamin,17,0,35,18
1657348105251,MATH 103A,A01,083777,Greenfeld; Be'Eri,3,0,36,33
1657348105251,MATH 103A,A02,083778,Greenfeld; Be'Eri,5,0,36,31
1657348105251,MATH 103A,A03,093561,Greenfeld; Be'Eri,5,0,36,31
1657348105251,MATH 103A,B01,083779,Greenfeld; Be'Eri,6,0,36,30
1657348105251,MATH 103A,B02,083780,Greenfeld; Be'Eri,4,0,36,32
1657348105251,MATH 103A,B03,093562,Greenfeld; Be'Eri,3,0,36,33
1657348111281,MATH 105,A01,085443,Carter; Anne Toulson,15,0,35,20
1657348111281,MATH 105,A02,093477,Carter; Anne Toulson,20,0,35,15
1657348117304,MATH 109,A01,083213,Ganzberger; Geoffrey Michael,2,0,34,32
1657348117304,MATH 109,A02,083214,Ganzberger; Geoffrey Michael,4,0,34,30
1657348117304,MATH 109,A03,093478,Ganzberger; Geoffrey Michael,2,0,34,32
1657348117304,MATH 109,B01,083215,Ganzberger; Geoffrey Michael,1,0,32,31
1657348117304,MATH 109,B02,083216,Ganzberger; Geoffrey Michael,2,0,32,30
1657348117304,MATH 109,B03,093479,Ganzberger; Geoffrey Michael,8,0,32,24
1657348123328,MATH 142A,A01,083219,Chow; Bennett,7,0,32,25
1657348123328,MATH 142A,A02,083220,Chow; Bennett,10,0,32,22
1657348123328,MATH 142A,A03,093480,Chow; Bennett,8,0,32,24
1657348123328,MATH 142A,B03,093481,Chow; Bennett,8,0,32,24
1657348123328,MATH 142A,B04,093558,Chow; Bennett,13,0,32,19
1657348123328,MATH 142A,B05,093559,Chow; Bennett,6,0,32,26
1657348129356,MATH 193A,A01,083224,Rotar; Vladimir,8,0,34,26
1657348129356,MATH 193A,A02,083225,Rotar; Vladimir,9,0,34,25
1657348129356,MATH 193A,A03,083781,Rotar; Vladimir,5,0,34,29
1657348129356,MATH 193A,A04,083782,Rotar; Vladimir,10,0,34,24
1657348129356,MATH 193A,A05,093482,Rotar; Vladimir,10,0,34,24
1657348135380,MATH 197,001,091859,McAuley; Julian John,9999,0,9999,0
1657348135380,MATH 197,002,095566,Kedlaya; Kiran S.,9997,0,9999,2
1657348135380,MATH 197,003,095567,Xiao; Ming,9999,0,9999,0
1657348135380,MATH 197,004,095571,Perols; Johan Lars,9998,0,9999,1
1657348142440,COGS 9,A01,083615,Shannon; Kyle Michael,8,0,75,67
1657348148461,COGS 11,A01,083617,Boyle; Mary E. T.,22,0,48,26
1657348154487,COGS 13,A01,083071,Bastos; Amalia Pinkusfeld,11,0,71,60
1657348160510,COGS 14A,A01,092681,Semenuks; Arturs,4,1,100,96
1657348166557,COGS 14B,A01,083073,Cheng; Tzu-Han,6,0,63,57
1657348172579,COGS 17,A01,092677,Semenuks; Arturs,6,0,81,75
1657348178605,COGS 100,A01,083619,Allen; Michael Gordon,16,0,70,54
1657348184628,COGS 101A,A01,083621,Davis; Joshua Daniel,9,0,68,59
1657348190727,COGS 101B,A01,091572,Allen; Michael Gordon,11,0,65,54
1657348196750,COGS 101C,A01,083625,Delgado; Tania,17,0,35,18
1657348202773,COGS 107A,A01,083627,Boyle; Mary E. T.,13,0,60,47
1657348208799,COGS 118A,A01,083075,Gupta; Anjum,20,0,76,56
1657348214913,CSE 3,A50,083646,Miranda; Gregory Joseph,24,0,50,26
1657348220937,CSE 8A,A50,083650,Miranda; Gregory Joseph,17,1,56,39
1657348226962,CSE 11,A01,083080,Cao; Yingjun,6,15,40,34
1657348232989,CSE 12,A01,083652,Krause-Levy; Sophia Louisa,28,1,120,92
1657348239016,CSE 15L,A01,083654,Morris; Justin Loren,9,0,50,41
1657348239016,CSE 15L,A02,083655,Morris; Justin Loren,9,0,50,41
1657348245038,CSE 20,A01,083657,Tran; Khoa Dang,39,0,80,41
1657348251063,CSE 21,A01,095574,Bach; Quang Tran,22,0,48,26
1657348257100,CSE 30,A01,083084,Eldon; John,4,0,80,76
1657348257100,CSE 30,B01,095061,Bhaskar; Nishant,9,0,50,41
1657348263123,CSE 100,A01,083659,Cao; Yingjun,5,4,70,65
1657348269152,CSE 134B,A01,083661,Powell; Thomas Allan,22,0,100,78
1657348275178,CSE 140,A01,083663,Gungor; Onat,14,0,85,71
1657348281200,CSE 140L,A01,083088,Eldon; John,21,0,100,79
1657348287221,CSE 175,A01,083665,Kumar; Rakesh,3,0,25,22
1657348293253,CSE 190,A00,092507,Dubnov; Shlomo,7,0,20,13
1657348299276,ECE 45,A01,083139,Congero; Spencer William,6,0,75,69
1657348305307,ECE 65,A50,083695,Saad; Andrew S,12,0,30,18
1657348305307,ECE 65,A51,095125,Saad; Andrew S,24,0,26,2
1657348311334,ECE 109,A01,091882,Touri; Behrouz,19,0,70,51
1657348317357,ECE 180,A00,083140,Abi Samra; Nicholas Camill,1,0,30,29
1657348317357,ECE 180,B00,083141,Abi Samra; Nicholas Camill,0,0,30,30
1657348323380,MATH 10A,A01,083735,Patchell; Gregory David,2,0,30,28
1657348323380,MATH 10A,A02,083736,Patchell; Gregory David,20,0,30,10
1657348323380,MATH 10A,A03,083737,Patchell; Gregory David,16,0,30,14
1657348329409,MATH 10B,A01,083207,Lim; Seonhee,8,0,34,26
1657348329409,MATH 10B,A02,083208,Lim; Seonhee,9,0,35,26
1657348329409,MATH 10B,A03,093472,Lim; Seonhee,7,0,34,27
1657348329409,MATH 10B,B01,083739,Sinha; Shubham,12,0,30,18
1657348335435,MATH 18,A01,083743,Cinel; Cameron Alexander,7,0,30,23
1657348335435,MATH 18,A02,083744,Cinel; Cameron Alexander,17,0,30,13
1657348335435,MATH 18,A03,083745,Cinel; Cameron Alexander,9,0,30,21
1657348335435,MATH 18,B01,083748,Rideout; David Porter,5,0,37,32
1657348335435,MATH 18,B02,083749,Rideout; David Porter,5,0,36,31
1657348335435,MATH 18,B03,083750,Rideout; David Porter,3,0,37,34
1657348335435,MATH 18,B04,083751,Rideout; David Porter,6,0,36,30
1657348335435,MATH 18,B05,093473,Rideout; David Porter,6,0,36,30
1657348335435,MATH 18,B06,093474,Rideout; David Porter,6,0,36,30
1657348341457,MATH 20A,A01,083754,Zheng; Zequn,14,0,40,26
1657348347479,MATH 20B,A01,083756,Briones; Jor-el Thomas Caparas,4,0,36,32
1657348347479,MATH 20B,A02,083757,Briones; Jor-el Thomas Caparas,1,0,36,35
1657348347479,MATH 20B,A03,093475,Briones; Jor-el Thomas Caparas,2,0,36,34
1657348353504,MATH 20C,A01,083760,Briones; Jor-el Thomas Caparas,1,0,35,34
1657348353504,MATH 20C,A02,083761,Briones; Jor-el Thomas Caparas,8,0,35,27
1657348353504,MATH 20C,A03,093476,Briones; Jor-el Thomas Caparas,0,1,36,36
1657348353504,MATH 20C,B01,083762,Bach; Quang Tran,1,0,30,29
1657348359529,MATH 20D,A01,083765,Tran; Brian Kha,5,0,30,25
1657348359529,MATH 20D,A02,083766,Tran; Brian Kha,5,0,30,25
1657348359529,MATH 20D,A03,083767,Tran; Brian Kha,4,0,30,26
1657348365576,MATH 20E,A01,083771,Ganguly; Soumya,9,0,32,23
1657348365576,MATH 20E,A02,083772,Ganguly; Soumya,6,0,32,26
1657348365576,MATH 20E,B01,083773,Ciotti; Benjamin,20,0,35,15
1657348365576,MATH 20E,B02,083774,Ciotti; Benjamin,17,0,35,18
1657348371599,MATH 103A,A01,083777,Greenfeld; Be'Eri,3,0,36,33
1657348371599,MATH 103A,A02,083778,Greenfeld; Be'Eri,5,0,36,31
1657348371599,MATH 103A,A03,093561,Greenfeld; Be'Eri,5,0,36,31
1657348371599,MATH 103A,B01,083779,Greenfeld; Be'Eri,6,0,36,30
1657348371599,MATH 103A,B02,083780,Greenfeld; Be'Eri,4,0,36,32
1657348371599,MATH 103A,B03,093562,Greenfeld; Be'Eri,3,0,36,33
1657348377623,MATH 105,A01,085443,Carter; Anne Toulson,15,0,35,20
1657348377623,MATH 105,A02,093477,Carter; Anne Toulson,20,0,35,15
1657348383646,MATH 109,A01,083213,Ganzberger; Geoffrey Michael,2,0,34,32
1657348383646,MATH 109,A02,083214,Ganzberger; Geoffrey Michael,4,0,34,30
1657348383646,MATH 109,A03,093478,Ganzberger; Geoffrey Michael,2,0,34,32
1657348383646,MATH 109,B01,083215,Ganzberger; Geoffrey Michael,1,0,32,31
1657348383646,MATH 109,B02,083216,Ganzberger; Geoffrey Michael,2,0,32,30
1657348383646,MATH 109,B03,093479,Ganzberger; Geoffrey Michael,8,0,32,24
1657348389671,MATH 142A,A01,083219,Chow; Bennett,7,0,32,25
1657348389671,MATH 142A,A02,083220,Chow; Bennett,10,0,32,22
1657348389671,MATH 142A,A03,093480,Chow; Bennett,8,0,32,24
1657348389671,MATH 142A,B03,093481,Chow; Bennett,8,0,32,24
1657348389671,MATH 142A,B04,093558,Chow; Bennett,13,0,32,19
1657348389671,MATH 142A,B05,093559,Chow; Bennett,6,0,32,26
1657348395698,MATH 193A,A01,083224,Rotar; Vladimir,8,0,34,26
1657348395698,MATH 193A,A02,083225,Rotar; Vladimir,9,0,34,25
1657348395698,MATH 193A,A03,083781,Rotar; Vladimir,5,0,34,29
1657348395698,MATH 193A,A04,083782,Rotar; Vladimir,10,0,34,24
1657348395698,MATH 193A,A05,093482,Rotar; Vladimir,10,0,34,24
1657348401719,MATH 197,001,091859,McAuley; Julian John,9999,0,9999,0
1657348401719,MATH 197,002,095566,Kedlaya; Kiran S.,9997,0,9999,2
1657348401719,MATH 197,003,095567,Xiao; Ming,9999,0,9999,0
1657348401719,MATH 197,004,095571,Perols; Johan Lars,9998,0,9999,1
1657348408779,COGS 9,A01,083615,Shannon; Kyle Michael,8,0,75,67
1657348414801,COGS 11,A01,083617,Boyle; Mary E. T.,22,0,48,26
1657348420825,COGS 13,A01,083071,Bastos; Amalia Pinkusfeld,11,0,71,60
1657348426849,COGS 14A,A01,092681,Semenuks; Arturs,4,1,100,96
1657348432874,COGS 14B,A01,083073,Cheng; Tzu-Han,6,0,63,57
1657348438900,COGS 17,A01,092677,Semenuks; Arturs,6,0,81,75
1657348445009,COGS 100,A01,083619,Allen; Michael Gordon,16,0,70,54
1657348451033,COGS 101A,A01,083621,Davis; Joshua Daniel,9,0,68,59
1657348457063,COGS 101B,A01,091572,Allen; Michael Gordon,11,0,65,54
1657348463086,COGS 101C,A01,083625,Delgado; Tania,17,0,35,18
1657348469108,COGS 107A,A01,083627,Boyle; Mary E. T.,13,0,60,47
1657348475140,COGS 118A,A01,083075,Gupta; Anjum,20,0,76,56
1657348481167,CSE 3,A50,083646,Miranda; Gregory Joseph,24,0,50,26
1657348487194,CSE 8A,A50,083650,Miranda; Gregory Joseph,17,1,56,39
1657348493219,CSE 11,A01,083080,Cao; Yingjun,6,15,40,34
1657348499242,CSE 12,A01,083652,Krause-Levy; Sophia Louisa,28,1,120,92
1657348505265,CSE 15L,A01,083654,Morris; Justin Loren,9,0,50,41
1657348505265,CSE 15L,A02,083655,Morris; Justin Loren,9,0,50,41
1657348511291,CSE 20,A01,083657,Tran; Khoa Dang,39,0,80,41
1657348517318,CSE 21,A01,095574,Bach; Quang Tran,22,0,48,26
1657348523346,CSE 30,A01,083084,Eldon; John,4,0,80,76
1657348523346,CSE 30,B01,095061,Bhaskar; Nishant,9,0,50,41
1657348529369,CSE 100,A01,083659,Cao; Yingjun,5,4,70,65
1657348535393,CSE 134B,A01,083661,Powell; Thomas Allan,22,0,100,78
1657348541414,CSE 140,A01,083663,Gungor; Onat,14,0,85,71
1657348547440,CSE 140L,A01,083088,Eldon; John,21,0,100,79
1657348553466,CSE 175,A01,083665,Kumar; Rakesh,3,0,25,22
1657348559489,CSE 190,A00,092507,Dubnov; Shlomo,7,0,20,13
1657348565516,ECE 45,A01,083139,Congero; Spencer William,6,0,75,69
1657348571537,ECE 65,A50,083695,Saad; Andrew S,12,0,30,18
1657348571537,ECE 65,A51,095125,Saad; Andrew S,24,0,26,2
1657348577560,ECE 109,A01,091882,Touri; Behrouz,19,0,70,51
1657348583589,ECE 180,A00,083140,Abi Samra; Nicholas Camill,1,0,30,29
1657348583589,ECE 180,B00,083141,Abi Samra; Nicholas Camill,0,0,30,30
1657348589613,MATH 10A,A01,083735,Patchell; Gregory David,2,0,30,28
1657348589613,MATH 10A,A02,083736,Patchell; Gregory David,20,0,30,10
1657348589613,MATH 10A,A03,083737,Patchell; Gregory David,16,0,30,14
1657348595637,MATH 10B,A01,083207,Lim; Seonhee,8,0,34,26
1657348595637,MATH 10B,A02,083208,Lim; Seonhee,9,0,35,26
1657348595637,MATH 10B,A03,093472,Lim; Seonhee,7,0,34,27
1657348595637,MATH 10B,B01,083739,Sinha; Shubham,12,0,30,18
1657348601668,MATH 18,A01,083743,Cinel; Cameron Alexander,7,0,30,23
1657348601668,MATH 18,A02,083744,Cinel; Cameron Alexander,17,0,30,13
1657348601668,MATH 18,A03,083745,Cinel; Cameron Alexander,9,0,30,21
1657348601668,MATH 18,B01,083748,Rideout; David Porter,5,0,37,32
1657348601668,MATH 18,B02,083749,Rideout; David Porter,5,0,36,31
1657348601668,MATH 18,B03,083750,Rideout; David Porter,3,0,37,34
1657348601668,MATH 18,B04,083751,Rideout; David Porter,6,0,36,30
1657348601668,MATH 18,B05,093473,Rideout; David Porter,6,0,36,30
1657348601668,MATH 18,B06,093474,Rideout; David Porter,6,0,36,30
1657348607695,MATH 20A,A01,083754,Zheng; Zequn,14,0,40,26
1657348613722,MATH 20B,A01,083756,Briones; Jor-el Thomas Caparas,4,0,36,32
1657348613722,MATH 20B,A02,083757,Briones; Jor-el Thomas Caparas,1,0,36,35
1657348613722,MATH 20B,A03,093475,Briones; Jor-el Thomas Caparas,2,0,36,34
1657348619752,MATH 20C,A01,083760,Briones; Jor-el Thomas Caparas,1,0,35,34
1657348619752,MATH 20C,A02,083761,Briones; Jor-el Thomas Caparas,8,0,35,27
1657348619752,MATH 20C,A03,093476,Briones; Jor-el Thomas Caparas,0,1,36,36
1657348619752,MATH 20C,B01,083762,Bach; Quang Tran,1,0,30,29
1657348625782,MATH 20D,A01,083765,Tran; Brian Kha,5,0,30,25
1657348625782,MATH 20D,A02,083766,Tran; Brian Kha,5,0,30,25
1657348625782,MATH 20D,A03,083767,Tran; Brian Kha,4,0,30,26
1657348631809,MATH 20E,A01,083771,Ganguly; Soumya,9,0,32,23
1657348631809,MATH 20E,A02,083772,Ganguly; Soumya,6,0,32,26
1657348631809,MATH 20E,B01,083773,Ciotti; Benjamin,20,0,35,15
1657348631809,MATH 20E,B02,083774,Ciotti; Benjamin,17,0,35,18
1657348637832,MATH 103A,A01,083777,Greenfeld; Be'Eri,3,0,36,33
1657348637832,MATH 103A,A02,083778,Greenfeld; Be'Eri,5,0,36,31
1657348637832,MATH 103A,A03,093561,Greenfeld; Be'Eri,5,0,36,31
1657348637832,MATH 103A,B01,083779,Greenfeld; Be'Eri,6,0,36,30
1657348637832,MATH 103A,B02,083780,Greenfeld; Be'Eri,4,0,36,32
1657348637832,MATH 103A,B03,093562,Greenfeld; Be'Eri,3,0,36,33
1657348643858,MATH 105,A01,085443,Carter; Anne Toulson,15,0,35,20
1657348643858,MATH 105,A02,093477,Carter; Anne Toulson,20,0,35,15
1657348649887,MATH 109,A01,083213,Ganzberger; Geoffrey Michael,2,0,34,32
1657348649887,MATH 109,A02,083214,Ganzberger; Geoffrey Michael,4,0,34,30
1657348649887,MATH 109,A03,093478,Ganzberger; Geoffrey Michael,2,0,34,32
1657348649887,MATH 109,B01,083215,Ganzberger; Geoffrey Michael,1,0,32,31
1657348649887,MATH 109,B02,083216,Ganzberger; Geoffrey Michael,2,0,32,30
1657348649887,MATH 109,B03,093479,Ganzberger; Geoffrey Michael,8,0,32,24
1657348655912,MATH 142A,A01,083219,Chow; Bennett,7,0,32,25
1657348655912,MATH 142A,A02,083220,Chow; Bennett,10,0,32,22
1657348655912,MATH 142A,A03,093480,Chow; Bennett,8,0,32,24
1657348655912,MATH 142A,B03,093481,Chow; Bennett,8,0,32,24
1657348655912,MATH 142A,B04,093558,Chow; Bennett,13,0,32,19
1657348655912,MATH 142A,B05,093559,Chow; Bennett,6,0,32,26
1657348661935,MATH 193A,A01,083224,Rotar; Vladimir,8,0,34,26
1657348661935,MATH 193A,A02,083225,Rotar; Vladimir,9,0,34,25
1657348661935,MATH 193A,A03,083781,Rotar; Vladimir,5,0,34,29
1657348661935,MATH 193A,A04,083782,Rotar; Vladimir,10,0,34,24
1657348661935,MATH 193A,A05,093482,Rotar; Vladimir,10,0,34,24
1657348667957,MATH 197,001,091859,McAuley; Julian John,9999,0,9999,0
1657348667957,MATH 197,002,095566,Kedlaya; Kiran S.,9997,0,9999,2
1657348667957,MATH 197,003,095567,Xiao; Ming,9999,0,9999,0
1657348667957,MATH 197,004,095571,Perols; Johan Lars,9998,0,9999,1
1657348675021,COGS 9,A01,083615,Shannon; Kyle Michael,8,0,75,67
1657348681048,COGS 11,A01,083617,Boyle; Mary E. T.,22,0,48,26
1657348687073,COGS 13,A01,083071,Bastos; Amalia Pinkusfeld,11,0,71,60
1657348693101,COGS 14A,A01,092681,Semenuks; Arturs,4,1,100,96
1657348699123,COGS 14B,A01,083073,Cheng; Tzu-Han,6,0,63,57
1657348705147,COGS 17,A01,092677,Semenuks; Arturs,6,0,81,75
1657348711174,COGS 100,A01,083619,Allen; Michael Gordon,16,0,70,54
1657348717201,COGS 101A,A01,083621,Davis; Joshua Daniel,9,0,68,59
1657348723224,COGS 101B,A01,091572,Allen; Michael Gordon,11,0,65,54
1657348729252,COGS 101C,A01,083625,Delgado; Tania,17,0,35,18
1657348735278,COGS 107A,A01,083627,Boyle; Mary E. T.,13,0,60,47
1657348741302,COGS 118A,A01,083075,Gupta; Anjum,20,0,76,56
1657348747329,CSE 3,A50,083646,Miranda; Gregory Joseph,24,0,50,26
1657348753360,CSE 8A,A50,083650,Miranda; Gregory Joseph,17,1,56,39
1657348759382,CSE 11,A01,083080,Cao; Yingjun,6,15,40,34
1657348765410,CSE 12,A01,083652,Krause-Levy; Sophia Louisa,28,1,120,92
1657348771436,CSE 15L,A01,083654,Morris; Justin Loren,9,0,50,41
1657348771436,CSE 15L,A02,083655,Morris; Justin Loren,9,0,50,41
1657348777461,CSE 20,A01,083657,Tran; Khoa Dang,39,0,80,41
1657348783489,CSE 21,A01,095574,Bach; Quang Tran,22,0,48,26
1657348789516,CSE 30,A01,083084,Eldon; John,4,0,80,76
1657348789516,CSE 30,B01,095061,Bhaskar; Nishant,9,0,50,41
1657348795542,CSE 100,A01,083659,Cao; Yingjun,5,4,70,65
1657348801568,CSE 134B,A01,083661,Powell; Thomas Allan,22,0,100,78
1657348807593,CSE 140,A01,083663,Gungor; Onat,14,0,85,71
1657348813689,CSE 140L,A01,083088,Eldon; John,21,0,100,79
1657348819710,CSE 175,A01,083665,Kumar; Rakesh,3,0,25,22
1657348825738,CSE 190,A00,092507,Dubnov; Shlomo,7,0,20,13
1657348831761,ECE 45,A01,083139,Congero; Spencer William,6,0,75,69
1657348837787,ECE 65,A50,083695,Saad; Andrew S,12,0,30,18
1657348837787,ECE 65,A51,095125,Saad; Andrew S,24,0,26,2
1657348843810,ECE 109,A01,091882,Touri; Behrouz,19,0,70,51
1657348849834,ECE 180,A00,083140,Abi Samra; Nicholas Camill,1,0,30,29
1657348849834,ECE 180,B00,083141,Abi Samra; Nicholas Camill,0,0,30,30
1657348855857,MATH 10A,A01,083735,Patchell; Gregory David,2,0,30,28
1657348855857,MATH 10A,A02,083736,Patchell; Gregory David,20,0,30,10
1657348855857,MATH 10A,A03,083737,Patchell; Gregory David,16,0,30,14
1657348861884,MATH 10B,A01,083207,Lim; Seonhee,8,0,34,26
1657348861884,MATH 10B,A02,083208,Lim; Seonhee,9,0,35,26
1657348861884,MATH 10B,A03,093472,Lim; Seonhee,7,0,34,27
1657348861884,MATH 10B,B01,083739,Sinha; Shubham,12,0,30,18
1657348867910,MATH 18,A01,083743,Cinel; Cameron Alexander,7,0,30,23
1657348867910,MATH 18,A02,083744,Cinel; Cameron Alexander,17,0,30,13
1657348867910,MATH 18,A03,083745,Cinel; Cameron Alexander,9,0,30,21
1657348867910,MATH 18,B01,083748,Rideout; David Porter,5,0,37,32
1657348867910,MATH 18,B02,083749,Rideout; David Porter,5,0,36,31
1657348867910,MATH 18,B03,083750,Rideout; David Porter,3,0,37,34
1657348867910,MATH 18,B04,083751,Rideout; David Porter,6,0,36,30
1657348867910,MATH 18,B05,093473,Rideout; David Porter,6,0,36,30
1657348867910,MATH 18,B06,093474,Rideout; David Porter,6,0,36,30
1657348873933,MATH 20A,A01,083754,Zheng; Zequn,14,0,40,26
1657348879961,MATH 20B,A01,083756,Briones; Jor-el Thomas Caparas,4,0,36,32
1657348879961,MATH 20B,A02,083757,Briones; Jor-el Thomas Caparas,1,0,36,35
1657348879961,MATH 20B,A03,093475,Briones; Jor-el Thomas Caparas,2,0,36,34
1657348885990,MATH 20C,A01,083760,Briones; Jor-el Thomas Caparas,1,0,35,34
1657348885990,MATH 20C,A02,083761,Briones; Jor-el Thomas Caparas,8,0,35,27
1657348885990,MATH 20C,A03,093476,Briones; Jor-el Thomas Caparas,0,1,36,36
1657348885990,MATH 20C,B01,083762,Bach; Quang Tran,1,0,30,29
1657348892014,MATH 20D,A01,083765,Tran; Brian Kha,5,0,30,25
1657348892014,MATH 20D,A02,083766,Tran; Brian Kha,5,0,30,25
1657348892014,MATH 20D,A03,083767,Tran; Brian Kha,4,0,30,26
1657348898043,MATH 20E,A01,083771,Ganguly; Soumya,9,0,32,23
1657348898043,MATH 20E,A02,083772,Ganguly; Soumya,6,0,32,26
1657348898043,MATH 20E,B01,083773,Ciotti; Benjamin,20,0,35,15
1657348898043,MATH 20E,B02,083774,Ciotti; Benjamin,17,0,35,18
1657348904069,MATH 103A,A01,083777,Greenfeld; Be'Eri,3,0,36,33
1657348904069,MATH 103A,A02,083778,Greenfeld; Be'Eri,5,0,36,31
1657348904069,MATH 103A,A03,093561,Greenfeld; Be'Eri,5,0,36,31
1657348904069,MATH 103A,B01,083779,Greenfeld; Be'Eri,6,0,36,30
1657348904069,MATH 103A,B02,083780,Greenfeld; Be'Eri,4,0,36,32
1657348904069,MATH 103A,B03,093562,Greenfeld; Be'Eri,3,0,36,33
1657348910093,MATH 105,A01,085443,Carter; Anne Toulson,15,0,35,20
1657348910093,MATH 105,A02,093477,Carter; Anne Toulson,20,0,35,15
1657348916122,MATH 109,A01,083213,Ganzberger; Geoffrey Michael,2,0,34,32
1657348916122,MATH 109,A02,083214,Ganzberger; Geoffrey Michael,4,0,34,30
1657348916122,MATH 109,A03,093478,Ganzberger; Geoffrey Michael,2,0,34,32
1657348916122,MATH 109,B01,083215,Ganzberger; Geoffrey Michael,1,0,32,31
1657348916122,MATH 109,B02,083216,Ganzberger; Geoffrey Michael,2,0,32,30
1657348916122,MATH 109,B03,093479,Ganzberger; Geoffrey Michael,8,0,32,24
1657348922151,MATH 142A,A01,083219,Chow; Bennett,7,0,32,25
1657348922151,MATH 142A,A02,083220,Chow; Bennett,10,0,32,22
1657348922151,MATH 142A,A03,093480,Chow; Bennett,8,0,32,24
1657348922151,MATH 142A,B03,093481,Chow; Bennett,8,0,32,24
1657348922151,MATH 142A,B04,093558,Chow; Bennett,13,0,32,19
1657348922151,MATH 142A,B05,093559,Chow; Bennett,6,0,32,26
1657348928180,MATH 193A,A01,083224,Rotar; Vladimir,8,0,34,26
1657348928180,MATH 193A,A02,083225,Rotar; Vladimir,9,0,34,25
1657348928180,MATH 193A,A03,083781,Rotar; Vladimir,5,0,34,29
1657348928180,MATH 193A,A04,083782,Rotar; Vladimir,10,0,34,24
1657348928180,MATH 193A,A05,093482,Rotar; Vladimir,10,0,34,24
1657348934204,MATH 197,001,091859,McAuley; Julian John,9999,0,9999,0
1657348934204,MATH 197,002,095566,Kedlaya; Kiran S.,9997,0,9999,2
1657348934204,MATH 197,003,095567,Xiao; Ming,9999,0,9999,0
1657348934204,MATH 197,004,095571,Perols; Johan Lars,9998,0,9999,1
1657348941259,COGS 9,A01,083615,Shannon; Kyle Michael,8,0,75,67
1657348947284,COGS 11,A01,083617,Boyle; Mary E. T.,22,0,48,26
1657348953311,COGS 13,A01,083071,Bastos; Amalia Pinkusfeld,11,0,71,60
1657348959336,COGS 14A,A01,092681,Semenuks; Arturs,4,1,100,96
1657348965358,COGS 14B,A01,083073,Cheng; Tzu-Han,6,0,63,57
1657348971384,COGS 17,A01,092677,Semenuks; Arturs,6,0,81,75
1657348977409,COGS 100,A01,083619,Allen; Michael Gordon,16,0,70,54
1657348983432,COGS 101A,A01,083621,Davis; Joshua Daniel,9,0,68,59
1657348989456,COGS 101B,A01,091572,Allen; Michael Gordon,11,0,65,54
1657348995492,COGS 101C,A01,083625,Delgado; Tania,17,0,35,18
1657349001518,COGS 107A,A01,083627,Boyle; Mary E. T.,13,0,60,47
1657349007540,COGS 118A,A01,083075,Gupta; Anjum,20,0,76,56
1657349013566,CSE 3,A50,083646,Miranda; Gregory Joseph,24,0,50,26
1657349019594,CSE 8A,A50,083650,Miranda; Gregory Joseph,17,1,56,39
1657349025616,CSE 11,A01,083080,Cao; Yingjun,6,15,40,34
1657349031642,CSE 12,A01,083652,Krause-Levy; Sophia Louisa,28,1,120,92
1657349037664,CSE 15L,A01,083654,Morris; Justin Loren,9,0,50,41
1657349037664,CSE 15L,A02,083655,Morris; Justin Loren,9,0,50,41
1657349043688,CSE 20,A01,083657,Tran; Khoa Dang,39,0,80,41
1657349049710,CSE 21,A01,095574,Bach; Quang Tran,22,0,48,26
1657349055733,CSE 30,A01,083084,Eldon; John,4,0,80,76
1657349055733,CSE 30,B01,095061,Bhaskar; Nishant,9,0,50,41
1657349061756,CSE 100,A01,083659,Cao; Yingjun,5,4,70,65
1657349067778,CSE 134B,A01,083661,Powell; Thomas Allan,22,0,100,78
1657349073800,CSE 140,A01,083663,Gungor; Onat,14,0,85,71
1657349079822,CSE 140L,A01,083088,Eldon; John,21,0,100,79
1657349085849,CSE 175,A01,083665,Kumar; Rakesh,3,0,25,22
1657349091873,CSE 190,A00,092507,Dubnov; Shlomo,7,0,20,13
1657349097896,ECE 45,A01,083139,Congero; Spencer William,6,0,75,69
1657349103926,ECE 65,A50,083695,Saad; Andrew S,12,0,30,18
1657349103926,ECE 65,A51,095125,Saad; Andrew S,24,0,26,2
1657349109948,ECE 109,A01,091882,Touri; Behrouz,19,0,70,51
1657349115974,ECE 180,A00,083140,Abi Samra; Nicholas Camill,1,0,30,29
1657349115974,ECE 180,B00,083141,Abi Samra; Nicholas Camill,0,0,30,30
1657349122002,MATH 10A,A01,083735,Patchell; Gregory David,2,0,30,28
1657349122002,MATH 10A,A02,083736,Patchell; Gregory David,20,0,30,10
1657349122002,MATH 10A,A03,083737,Patchell; Gregory David,16,0,30,14
1657349128026,MATH 10B,A01,083207,Lim; Seonhee,8,0,34,26
1657349128026,MATH 10B,A02,083208,Lim; Seonhee,9,0,35,26
1657349128026,MATH 10B,A03,093472,Lim; Seonhee,7,0,34,27
1657349128026,MATH 10B,B01,083739,Sinha; Shubham,12,0,30,18
1657349134056,MATH 18,A01,083743,Cinel; Cameron Alexander,7,0,30,23
1657349134056,MATH 18,A02,083744,Cinel; Cameron Alexander,17,0,30,13
1657349134056,MATH 18,A03,083745,Cinel; Cameron Alexander,9,0,30,21
1657349134056,MATH 18,B01,083748,Rideout; David Porter,5,0,37,32
1657349134056,MATH 18,B02,083749,Rideout; David Porter,5,0,36,31
1657349134056,MATH 18,B03,083750,Rideout; David Porter,3,0,37,34
1657349134056,MATH 18,B04,083751,Rideout; David Porter,6,0,36,30
1657349134056,MATH 18,B05,093473,Rideout; David Porter,6,0,36,30
1657349134056,MATH 18,B06,093474,Rideout; David Porter,6,0,36,30
1657349140081,MATH 20A,A01,083754,Zheng; Zequn,14,0,40,26
1657349146111,MATH 20B,A01,083756,Briones; Jor-el Thomas Caparas,4,0,36,32
1657349146111,MATH 20B,A02,083757,Briones; Jor-el Thomas Caparas,1,0,36,35
1657349146111,MATH 20B,A03,093475,Briones; Jor-el Thomas Caparas,2,0,36,34
1657349152139,MATH 20C,A01,083760,Briones; Jor-el Thomas Caparas,1,0,35,34
1657349152139,MATH 20C,A02,083761,Briones; Jor-el Thomas Caparas,8,0,35,27
1657349152139,MATH 20C,A03,093476,Briones; Jor-el Thomas Caparas,0,1,36,36
1657349152139,MATH 20C,B01,083762,Bach; Quang Tran,1,0,30,29
1657349158163,MATH 20D,A01,083765,Tran; Brian Kha,5,0,30,25
1657349158163,MATH 20D,A02,083766,Tran; Brian Kha,5,0,30,25
1657349158163,MATH 20D,A03,083767,Tran; Brian Kha,5,0,30,25
1657349164191,MATH 20E,A01,083771,Ganguly; Soumya,9,0,32,23
1657349164191,MATH 20E,A02,083772,Ganguly; Soumya,6,0,32,26
1657349164191,MATH 20E,B01,083773,Ciotti; Benjamin,20,0,35,15
1657349164191,MATH 20E,B02,083774,Ciotti; Benjamin,17,0,35,18
1657349170217,MATH 103A,A01,083777,Greenfeld; Be'Eri,3,0,36,33
1657349170217,MATH 103A,A02,083778,Greenfeld; Be'Eri,5,0,36,31
1657349170217,MATH 103A,A03,093561,Greenfeld; Be'Eri,5,0,36,31
1657349170217,MATH 103A,B01,083779,Greenfeld; Be'Eri,6,0,36,30
1657349170217,MATH 103A,B02,083780,Greenfeld; Be'Eri,4,0,36,32
1657349170217,MATH 103A,B03,093562,Greenfeld; Be'Eri,3,0,36,33
1657349176244,MATH 105,A01,085443,Carter; Anne Toulson,15,0,35,20
1657349176244,MATH 105,A02,093477,Carter; Anne Toulson,20,0,35,15
1657349182268,MATH 109,A01,083213,Ganzberger; Geoffrey Michael,2,0,34,32
1657349182268,MATH 109,A02,083214,Ganzberger; Geoffrey Michael,4,0,34,30
1657349182268,MATH 109,A03,093478,Ganzberger; Geoffrey Michael,2,0,34,32
1657349182268,MATH 109,B01,083215,Ganzberger; Geoffrey Michael,1,0,32,31
1657349182268,MATH 109,B02,083216,Ganzberger; Geoffrey Michael,2,0,32,30
1657349182268,MATH 109,B03,093479,Ganzberger; Geoffrey Michael,8,0,32,24
1657349188292,MATH 142A,A01,083219,Chow; Bennett,7,0,32,25
1657349188292,MATH 142A,A02,083220,Chow; Bennett,10,0,32,22
1657349188292,MATH 142A,A03,093480,Chow; Bennett,8,0,32,24
1657349188292,MATH 142A,B03,093481,Chow; Bennett,8,0,32,24
1657349188292,MATH 142A,B04,093558,Chow; Bennett,13,0,32,19
1657349188292,MATH 142A,B05,093559,Chow; Bennett,6,0,32,26
1657349194315,MATH 193A,A01,083224,Rotar; Vladimir,8,0,34,26
1657349194315,MATH 193A,A02,083225,Rotar; Vladimir,9,0,34,25
1657349194315,MATH 193A,A03,083781,Rotar; Vladimir,5,0,34,29
1657349194315,MATH 193A,A04,083782,Rotar; Vladimir,10,0,34,24
1657349194315,MATH 193A,A05,093482,Rotar; Vladimir,10,0,34,24
1657349200338,MATH 197,001,091859,McAuley; Julian John,9999,0,9999,0
1657349200338,MATH 197,002,095566,Kedlaya; Kiran S.,9997,0,9999,2
1657349200338,MATH 197,003,095567,Xiao; Ming,9999,0,9999,0
1657349200338,MATH 197,004,095571,Perols; Johan Lars,9998,0,9999,1
1657349207406,COGS 9,A01,083615,Shannon; Kyle Michael,8,0,75,67
1657349213430,COGS 11,A01,083617,Boyle; Mary E. T.,22,0,48,26
1657349219457,COGS 13,A01,083071,Bastos; Amalia Pinkusfeld,11,0,71,60
1657349225482,COGS 14A,A01,092681,Semenuks; Arturs,4,1,100,96
1657349231505,COGS 14B,A01,083073,Cheng; Tzu-Han,6,0,63,57
1657349237530,COGS 17,A01,092677,Semenuks; Arturs,6,0,81,75
1657349243553,COGS 100,A01,083619,Allen; Michael Gordon,16,0,70,54
1657349249575,COGS 101A,A01,083621,Davis; Joshua Daniel,9,0,68,59
1657349255611,COGS 101B,A01,091572,Allen; Michael Gordon,11,0,65,54
1657349261639,COGS 101C,A01,083625,Delgado; Tania,17,0,35,18
1657349267666,COGS 107A,A01,083627,Boyle; Mary E. T.,13,0,60,47
1657349273690,COGS 118A,A01,083075,Gupta; Anjum,20,0,76,56
1657349279718,CSE 3,A50,083646,Miranda; Gregory Joseph,24,0,50,26
1657349285742,CSE 8A,A50,083650,Miranda; Gregory Joseph,17,1,56,39
1657349291764,CSE 11,A01,083080,Cao; Yingjun,6,15,40,34
1657349297786,CSE 12,A01,083652,Krause-Levy; Sophia Louisa,28,1,120,92
1657349303811,CSE 15L,A01,083654,Morris; Justin Loren,9,0,50,41
1657349303811,CSE 15L,A02,083655,Morris; Justin Loren,9,0,50,41
1657349309833,CSE 20,A01,083657,Tran; Khoa Dang,39,0,80,41
1657349315857,CSE 21,A01,095574,Bach; Quang Tran,22,0,48,26
1657349321880,CSE 30,A01,083084,Eldon; John,4,0,80,76
1657349321880,CSE 30,B01,095061,Bhaskar; Nishant,9,0,50,41
1657349327903,CSE 100,A01,083659,Cao; Yingjun,5,4,70,65
1657349333930,CSE 134B,A01,083661,Powell; Thomas Allan,22,0,100,78
1657349339952,CSE 140,A01,083663,Gungor; Onat,14,0,85,71
1657349345986,CSE 140L,A01,083088,Eldon; John,21,0,100,79
1657349352012,CSE 175,A01,083665,Kumar; Rakesh,3,0,25,22
1657349358038,CSE 190,A00,092507,Dubnov; Shlomo,7,0,20,13
1657349364060,ECE 45,A01,083139,Congero; Spencer William,6,0,75,69
1657349370087,ECE 65,A50,083695,Saad; Andrew S,12,0,30,18
1657349370087,ECE 65,A51,095125,Saad; Andrew S,24,0,26,2
1657349376115,ECE 109,A01,091882,Touri; Behrouz,19,0,70,51
1657349382138,ECE 180,A00,083140,Abi Samra; Nicholas Camill,1,0,30,29
1657349382138,ECE 180,B00,083141,Abi Samra; Nicholas Camill,0,0,30,30
1657349388168,MATH 10A,A01,083735,Patchell; Gregory David,2,0,30,28
1657349388168,MATH 10A,A02,083736,Patchell; Gregory David,20,0,30,10
1657349388168,MATH 10A,A03,083737,Patchell; Gregory David,16,0,30,14
1657349394191,MATH 10B,A01,083207,Lim; Seonhee,8,0,34,26
1657349394191,MATH 10B,A02,083208,Lim; Seonhee,9,0,35,26
1657349394191,MATH 10B,A03,093472,Lim; Seonhee,7,0,34,27
1657349394191,MATH 10B,B01,083739,Sinha; Shubham,12,0,30,18
1657349400222,MATH 18,A01,083743,Cinel; Cameron Alexander,7,0,30,23
1657349400222,MATH 18,A02,083744,Cinel; Cameron Alexander,17,0,30,13
1657349400222,MATH 18,A03,083745,Cinel; Cameron Alexander,9,0,30,21
1657349400222,MATH 18,B01,083748,Rideout; David Porter,5,0,37,32
1657349400222,MATH 18,B02,083749,Rideout; David Porter,5,0,36,31
1657349400222,MATH 18,B03,083750,Rideout; David Porter,3,0,37,34
1657349400222,MATH 18,B04,083751,Rideout; David Porter,6,0,36,30
1657349400222,MATH 18,B05,093473,Rideout; David Porter,6,0,36,30
1657349400222,MATH 18,B06,093474,Rideout; David Porter,6,0,36,30
1657349406251,MATH 20A,A01,083754,Zheng; Zequn,14,0,40,26
1657349412351,MATH 20B,A01,083756,Briones; Jor-el Thomas Caparas,4,0,36,32
1657349412351,MATH 20B,A02,083757,Briones; Jor-el Thomas Caparas,1,0,36,35
1657349412351,MATH 20B,A03,093475,Briones; Jor-el Thomas Caparas,2,0,36,34
1657349418374,MATH 20C,A01,083760,Briones; Jor-el Thomas Caparas,1,0,35,34
1657349418374,MATH 20C,A02,083761,Briones; Jor-el Thomas Caparas,8,0,35,27
1657349418374,MATH 20C,A03,093476,Briones; Jor-el Thomas Caparas,0,1,36,36
1657349418374,MATH 20C,B01,083762,Bach; Quang Tran,1,0,30,29
1657349424397,MATH 20D,A01,083765,Tran; Brian Kha,5,0,30,25
1657349424397,MATH 20D,A02,083766,Tran; Brian Kha,5,0,30,25
1657349424397,MATH 20D,A03,083767,Tran; Brian Kha,5,0,30,25
1657349430420,MATH 20E,A01,083771,Ganguly; Soumya,9,0,32,23
1657349430420,MATH 20E,A02,083772,Ganguly; Soumya,6,0,32,26
1657349430420,MATH 20E,B01,083773,Ciotti; Benjamin,20,0,35,15
1657349430420,MATH 20E,B02,083774,Ciotti; Benjamin,17,0,35,18
1657349436444,MATH 103A,A01,083777,Greenfeld; Be'Eri,3,0,36,33
1657349436444,MATH 103A,A02,083778,Greenfeld; Be'Eri,5,0,36,31
1657349436444,MATH 103A,A03,093561,Greenfeld; Be'Eri,5,0,36,31
1657349436444,MATH 103A,B01,083779,Greenfeld; Be'Eri,6,0,36,30
1657349436444,MATH 103A,B02,083780,Greenfeld; Be'Eri,4,0,36,32
1657349436444,MATH 103A,B03,093562,Greenfeld; Be'Eri,3,0,36,33
1657349442471,MATH 105,A01,085443,Carter; Anne Toulson,15,0,35,20
1657349442471,MATH 105,A02,093477,Carter; Anne Toulson,20,0,35,15
1657349448497,MATH 109,A01,083213,Ganzberger; Geoffrey Michael,2,0,34,32
1657349448497,MATH 109,A02,083214,Ganzberger; Geoffrey Michael,4,0,34,30
1657349448497,MATH 109,A03,093478,Ganzberger; Geoffrey Michael,2,0,34,32
1657349448497,MATH 109,B01,083215,Ganzberger; Geoffrey Michael,1,0,32,31
1657349448497,MATH 109,B02,083216,Ganzberger; Geoffrey Michael,2,0,32,30
1657349448497,MATH 109,B03,093479,Ganzberger; Geoffrey Michael,8,0,32,24
1657349454525,MATH 142A,A01,083219,Chow; Bennett,7,0,32,25
1657349454525,MATH 142A,A02,083220,Chow; Bennett,10,0,32,22
1657349454525,MATH 142A,A03,093480,Chow; Bennett,8,0,32,24
1657349454525,MATH 142A,B03,093481,Chow; Bennett,8,0,32,24
1657349454525,MATH 142A,B04,093558,Chow; Bennett,13,0,32,19
1657349454525,MATH 142A,B05,093559,Chow; Bennett,6,0,32,26
1657349460547,MATH 193A,A01,083224,Rotar; Vladimir,8,0,34,26
1657349460547,MATH 193A,A02,083225,Rotar; Vladimir,9,0,34,25
1657349460547,MATH 193A,A03,083781,Rotar; Vladimir,5,0,34,29
1657349460547,MATH 193A,A04,083782,Rotar; Vladimir,10,0,34,24
1657349460547,MATH 193A,A05,093482,Rotar; Vladimir,10,0,34,24
1657349466570,MATH 197,001,091859,McAuley; Julian John,9999,0,9999,0
1657349466570,MATH 197,002,095566,Kedlaya; Kiran S.,9997,0,9999,2
1657349466570,MATH 197,003,095567,Xiao; Ming,9999,0,9999,0
1657349466570,MATH 197,004,095571,Perols; Johan Lars,9998,0,9999,1
1657349473631,COGS 9,A01,083615,Shannon; Kyle Michael,8,0,75,67
1657349479653,COGS 11,A01,083617,Boyle; Mary E. T.,22,0,48,26
1657349485676,COGS 13,A01,083071,Bastos; Amalia Pinkusfeld,11,0,71,60
1657349491700,COGS 14A,A01,092681,Semenuks; Arturs,4,1,100,96
1657349497722,COGS 14B,A01,083073,Cheng; Tzu-Han,6,0,63,57
1657349503744,COGS 17,A01,092677,Semenuks; Arturs,6,0,81,75
1657349509765,COGS 100,A01,083619,Allen; Michael Gordon,16,0,70,54
1657349515794,COGS 101A,A01,083621,Davis; Joshua Daniel,9,0,68,59
1657349521815,COGS 101B,A01,091572,Allen; Michael Gordon,11,0,65,54
1657349527837,COGS 101C,A01,083625,Delgado; Tania,17,0,35,18
1657349533864,COGS 107A,A01,083627,Boyle; Mary E. T.,13,0,60,47
1657349539891,COGS 118A,A01,083075,Gupta; Anjum,20,0,76,56
1657349545917,CSE 3,A50,083646,Miranda; Gregory Joseph,24,0,50,26
1657349551941,CSE 8A,A50,083650,Miranda; Gregory Joseph,17,1,56,39
1657349557963,CSE 11,A01,083080,Cao; Yingjun,6,15,40,34
1657349563991,CSE 12,A01,083652,Krause-Levy; Sophia Louisa,28,1,120,92
1657349570019,CSE 15L,A01,083654,Morris; Justin Loren,9,0,50,41
1657349570019,CSE 15L,A02,083655,Morris; Justin Loren,9,0,50,41
1657349576043,CSE 20,A01,083657,Tran; Khoa Dang,39,0,80,41
1657349582067,CSE 21,A01,095574,Bach; Quang Tran,22,0,48,26
1657349588093,CSE 30,A01,083084,Eldon; John,4,0,80,76
1657349588093,CSE 30,B01,095061,Bhaskar; Nishant,9,0,50,41
1657349594120,CSE 100,A01,083659,Cao; Yingjun,5,4,70,65
1657349600143,CSE 134B,A01,083661,Powell; Thomas Allan,22,0,100,78
1657349606168,CSE 140,A01,083663,Gungor; Onat,14,0,85,71
1657349612195,CSE 140L,A01,083088,Eldon; John,21,0,100,79
1657349618221,CSE 175,A01,083665,Kumar; Rakesh,3,0,25,22
1657349624247,CSE 190,A00,092507,Dubnov; Shlomo,7,0,20,13
1657349630276,ECE 45,A01,083139,Congero; Spencer William,6,0,75,69
1657349636299,ECE 65,A50,083695,Saad; Andrew S,12,0,30,18
1657349636299,ECE 65,A51,095125,Saad; Andrew S,24,0,26,2
1657349642326,ECE 109,A01,091882,Touri; Behrouz,19,0,70,51
1657349648348,ECE 180,A00,083140,Abi Samra; Nicholas Camill,1,0,30,29
1657349648348,ECE 180,B00,083141,Abi Samra; Nicholas Camill,0,0,30,30
1657349654376,MATH 10A,A01,083735,Patchell; Gregory David,2,0,30,28
1657349654376,MATH 10A,A02,083736,Patchell; Gregory David,20,0,30,10
1657349654376,MATH 10A,A03,083737,Patchell; Gregory David,16,0,30,14
1657349660404,MATH 10B,A01,083207,Lim; Seonhee,8,0,34,26
1657349660404,MATH 10B,A02,083208,Lim; Seonhee,9,0,35,26
1657349660404,MATH 10B,A03,093472,Lim; Seonhee,7,0,34,27
1657349660404,MATH 10B,B01,083739,Sinha; Shubham,12,0,30,18
1657349666441,MATH 18,A01,083743,Cinel; Cameron Alexander,7,0,30,23
1657349666441,MATH 18,A02,083744,Cinel; Cameron Alexander,17,0,30,13
1657349666441,MATH 18,A03,083745,Cinel; Cameron Alexander,9,0,30,21
1657349666441,MATH 18,B01,083748,Rideout; David Porter,5,0,37,32
1657349666441,MATH 18,B02,083749,Rideout; David Porter,5,0,36,31
1657349666441,MATH 18,B03,083750,Rideout; David Porter,3,0,37,34
1657349666441,MATH 18,B04,083751,Rideout; David Porter,6,0,36,30
1657349666441,MATH 18,B05,093473,Rideout; David Porter,6,0,36,30
1657349666441,MATH 18,B06,093474,Rideout; David Porter,6,0,36,30
1657349672465,MATH 20A,A01,083754,Zheng; Zequn,14,0,40,26
1657349678488,MATH 20B,A01,083756,Briones; Jor-el Thomas Caparas,4,0,36,32
1657349678488,MATH 20B,A02,083757,Briones; Jor-el Thomas Caparas,1,0,36,35
1657349678488,MATH 20B,A03,093475,Briones; Jor-el Thomas Caparas,2,0,36,34
1657349684512,MATH 20C,A01,083760,Briones; Jor-el Thomas Caparas,1,0,35,34
1657349684512,MATH 20C,A02,083761,Briones; Jor-el Thomas Caparas,8,0,35,27
1657349684512,MATH 20C,A03,093476,Briones; Jor-el Thomas Caparas,0,1,36,36
1657349684512,MATH 20C,B01,083762,Bach; Quang Tran,1,0,30,29
1657349690535,MATH 20D,A01,083765,Tran; Brian Kha,5,0,30,25
1657349690535,MATH 20D,A02,083766,Tran; Brian Kha,5,0,30,25
1657349690535,MATH 20D,A03,083767,Tran; Brian Kha,5,0,30,25
1657349696557,MATH 20E,A01,083771,Ganguly; Soumya,9,0,32,23
1657349696557,MATH 20E,A02,083772,Ganguly; Soumya,6,0,32,26
1657349696557,MATH 20E,B01,083773,Ciotti; Benjamin,20,0,35,15
1657349696557,MATH 20E,B02,083774,Ciotti; Benjamin,17,0,35,18
1657349702583,MATH 103A,A01,083777,Greenfeld; Be'Eri,3,0,36,33
1657349702583,MATH 103A,A02,083778,Greenfeld; Be'Eri,5,0,36,31
1657349702583,MATH 103A,A03,093561,Greenfeld; Be'Eri,5,0,36,31
1657349702583,MATH 103A,B01,083779,Greenfeld; Be'Eri,6,0,36,30
1657349702583,MATH 103A,B02,083780,Greenfeld; Be'Eri,4,0,36,32
1657349702583,MATH 103A,B03,093562,Greenfeld; Be'Eri,3,0,36,33
1657349708607,MATH 105,A01,085443,Carter; Anne Toulson,15,0,35,20
1657349708607,MATH 105,A02,093477,Carter; Anne Toulson,20,0,35,15
1657349714630,MATH 109,A01,083213,Ganzberger; Geoffrey Michael,2,0,34,32
1657349714630,MATH 109,A02,083214,Ganzberger; Geoffrey Michael,4,0,34,30
1657349714630,MATH 109,A03,093478,Ganzberger; Geoffrey Michael,2,0,34,32
1657349714630,MATH 109,B01,083215,Ganzberger; Geoffrey Michael,1,0,32,31
1657349714630,MATH 109,B02,083216,Ganzberger; Geoffrey Michael,2,0,32,30
1657349714630,MATH 109,B03,093479,Ganzberger; Geoffrey Michael,8,0,32,24
1657349720662,MATH 142A,A01,083219,Chow; Bennett,7,0,32,25
1657349720662,MATH 142A,A02,083220,Chow; Bennett,10,0,32,22
1657349720662,MATH 142A,A03,093480,Chow; Bennett,8,0,32,24
1657349720662,MATH 142A,B03,093481,Chow; Bennett,8,0,32,24
1657349720662,MATH 142A,B04,093558,Chow; Bennett,13,0,32,19
1657349720662,MATH 142A,B05,093559,Chow; Bennett,6,0,32,26
1657349726685,MATH 193A,A01,083224,Rotar; Vladimir,8,0,34,26
1657349726685,MATH 193A,A02,083225,Rotar; Vladimir,9,0,34,25
1657349726685,MATH 193A,A03,083781,Rotar; Vladimir,5,0,34,29
1657349726685,MATH 193A,A04,083782,Rotar; Vladimir,10,0,34,24
1657349726685,MATH 193A,A05,093482,Rotar; Vladimir,10,0,34,24
1657349732707,MATH 197,001,091859,McAuley; Julian John,9999,0,9999,0
1657349732707,MATH 197,002,095566,Kedlaya; Kiran S.,9997,0,9999,2
1657349732707,MATH 197,003,095567,Xiao; Ming,9999,0,9999,0
1657349732707,MATH 197,004,095571,Perols; Johan Lars,9998,0,9999,1
1657349739758,COGS 9,A01,083615,Shannon; Kyle Michael,8,0,75,67
1657349745784,COGS 11,A01,083617,Boyle; Mary E. T.,22,0,48,26
1657349751809,COGS 13,A01,083071,Bastos; Amalia Pinkusfeld,11,0,71,60
1657349757832,COGS 14A,A01,092681,Semenuks; Arturs,4,1,100,96
1657349763859,COGS 14B,A01,083073,Cheng; Tzu-Han,6,0,63,57
1657349769881,COGS 17,A01,092677,Semenuks; Arturs,6,0,81,75
1657349775909,COGS 100,A01,083619,Allen; Michael Gordon,17,0,70,53
1657349781937,COGS 101A,A01,083621,Davis; Joshua Daniel,9,0,68,59
1657349787961,COGS 101B,A01,091572,Allen; Michael Gordon,11,0,65,54
1657349793986,COGS 101C,A01,083625,Delgado; Tania,17,0,35,18
1657349800009,COGS 107A,A01,083627,Boyle; Mary E. T.,13,0,60,47
1657349806036,COGS 118A,A01,083075,Gupta; Anjum,20,0,76,56
1657349812076,CSE 3,A50,083646,Miranda; Gregory Joseph,24,0,50,26
1657349818101,CSE 8A,A50,083650,Miranda; Gregory Joseph,17,1,56,39
1657349824125,CSE 11,A01,083080,Cao; Yingjun,6,15,40,34
1657349830149,CSE 12,A01,083652,Krause-Levy; Sophia Louisa,28,1,120,92
1657349836170,CSE 15L,A01,083654,Morris; Justin Loren,9,0,50,41
1657349836170,CSE 15L,A02,083655,Morris; Justin Loren,9,0,50,41
1657349842199,CSE 20,A01,083657,Tran; Khoa Dang,39,0,80,41
1657349848226,CSE 21,A01,095574,Bach; Quang Tran,22,0,48,26
1657349854250,CSE 30,A01,083084,Eldon; John,4,0,80,76
1657349854250,CSE 30,B01,095061,Bhaskar; Nishant,9,0,50,41
1657349860277,CSE 100,A01,083659,Cao; Yingjun,5,4,70,65
1657349866303,CSE 134B,A01,083661,Powell; Thomas Allan,22,0,100,78
1657349872326,CSE 140,A01,083663,Gungor; Onat,14,0,85,71
1657349878349,CSE 140L,A01,083088,Eldon; John,21,0,100,79
1657349884372,CSE 175,A01,083665,Kumar; Rakesh,3,0,25,22
1657349890396,CSE 190,A00,092507,Dubnov; Shlomo,7,0,20,13
1657349896420,ECE 45,A01,083139,Congero; Spencer William,6,0,75,69
1657349902444,ECE 65,A50,083695,Saad; Andrew S,12,0,30,18
1657349902444,ECE 65,A51,095125,Saad; Andrew S,24,0,26,2
1657349908473,ECE 109,A01,091882,Touri; Behrouz,19,0,70,51
1657349914501,ECE 180,A00,083140,Abi Samra; Nicholas Camill,1,0,30,29
1657349914501,ECE 180,B00,083141,Abi Samra; Nicholas Camill,0,0,30,30
1657349920524,MATH 10A,A01,083735,Patchell; Gregory David,2,0,30,28
1657349920524,MATH 10A,A02,083736,Patchell; Gregory David,20,0,30,10
1657349920524,MATH 10A,A03,083737,Patchell; Gregory David,16,0,30,14
1657349926547,MATH 10B,A01,083207,Lim; Seonhee,8,0,34,26
1657349926547,MATH 10B,A02,083208,Lim; Seonhee,9,0,35,26
1657349926547,MATH 10B,A03,093472,Lim; Seonhee,7,0,34,27
1657349926547,MATH 10B,B01,083739,Sinha; Shubham,12,0,30,18
1657349932573,MATH 18,A01,083743,Cinel; Cameron Alexander,7,0,30,23
1657349932573,MATH 18,A02,083744,Cinel; Cameron Alexander,17,0,30,13
1657349932573,MATH 18,A03,083745,Cinel; Cameron Alexander,9,0,30,21
1657349932573,MATH 18,B01,083748,Rideout; David Porter,5,0,37,32
1657349932573,MATH 18,B02,083749,Rideout; David Porter,5,0,36,31
1657349932573,MATH 18,B03,083750,Rideout; David Porter,3,0,37,34
1657349932573,MATH 18,B04,083751,Rideout; David Porter,6,0,36,30
1657349932573,MATH 18,B05,093473,Rideout; David Porter,6,0,36,30
1657349932573,MATH 18,B06,093474,Rideout; David Porter,6,0,36,30
1657349938598,MATH 20A,A01,083754,Zheng; Zequn,14,0,40,26
1657349944621,MATH 20B,A01,083756,Briones; Jor-el Thomas Caparas,4,0,36,32
1657349944621,MATH 20B,A02,083757,Briones; Jor-el Thomas Caparas,1,0,36,35
1657349944621,MATH 20B,A03,093475,Briones; Jor-el Thomas Caparas,2,0,36,34
1657349950644,MATH 20C,A01,083760,Briones; Jor-el Thomas Caparas,1,0,35,34
1657349950644,MATH 20C,A02,083761,Briones; Jor-el Thomas Caparas,8,0,35,27
1657349950644,MATH 20C,A03,093476,Briones; Jor-el Thomas Caparas,0,1,36,36
1657349950644,MATH 20C,B01,083762,Bach; Quang Tran,1,0,30,29
1657349956672,MATH 20D,A01,083765,Tran; Brian Kha,5,0,30,25
1657349956672,MATH 20D,A02,083766,Tran; Brian Kha,5,0,30,25
1657349956672,MATH 20D,A03,083767,Tran; Brian Kha,5,0,30,25
1657349962703,MATH 20E,A01,083771,Ganguly; Soumya,9,0,32,23
1657349962703,MATH 20E,A02,083772,Ganguly; Soumya,6,0,32,26
1657349962703,MATH 20E,B01,083773,Ciotti; Benjamin,20,0,35,15
1657349962703,MATH 20E,B02,083774,Ciotti; Benjamin,17,0,35,18
1657349968727,MATH 103A,A01,083777,Greenfeld; Be'Eri,3,0,36,33
1657349968727,MATH 103A,A02,083778,Greenfeld; Be'Eri,5,0,36,31
1657349968727,MATH 103A,A03,093561,Greenfeld; Be'Eri,5,0,36,31
1657349968727,MATH 103A,B01,083779,Greenfeld; Be'Eri,6,0,36,30
1657349968727,MATH 103A,B02,083780,Greenfeld; Be'Eri,4,0,36,32
1657349968727,MATH 103A,B03,093562,Greenfeld; Be'Eri,3,0,36,33
1657349974748,MATH 105,A01,085443,Carter; Anne Toulson,15,0,35,20
1657349974748,MATH 105,A02,093477,Carter; Anne Toulson,20,0,35,15
1657349980771,MATH 109,A01,083213,Ganzberger; Geoffrey Michael,2,0,34,32
1657349980771,MATH 109,A02,083214,Ganzberger; Geoffrey Michael,4,0,34,30
1657349980771,MATH 109,A03,093478,Ganzberger; Geoffrey Michael,2,0,34,32
1657349980771,MATH 109,B01,083215,Ganzberger; Geoffrey Michael,1,0,32,31
1657349980771,MATH 109,B02,083216,Ganzberger; Geoffrey Michael,2,0,32,30
1657349980771,MATH 109,B03,093479,Ganzberger; Geoffrey Michael,8,0,32,24
1657349986794,MATH 142A,A01,083219,Chow; Bennett,7,0,32,25
1657349986794,MATH 142A,A02,083220,Chow; Bennett,10,0,32,22
1657349986794,MATH 142A,A03,093480,Chow; Bennett,8,0,32,24
1657349986794,MATH 142A,B03,093481,Chow; Bennett,8,0,32,24
1657349986794,MATH 142A,B04,093558,Chow; Bennett,13,0,32,19
1657349986794,MATH 142A,B05,093559,Chow; Bennett,6,0,32,26
1657349992818,MATH 193A,A01,083224,Rotar; Vladimir,8,0,34,26
1657349992818,MATH 193A,A02,083225,Rotar; Vladimir,9,0,34,25
1657349992818,MATH 193A,A03,083781,Rotar; Vladimir,5,0,34,29
1657349992818,MATH 193A,A04,083782,Rotar; Vladimir,10,0,34,24
1657349992818,MATH 193A,A05,093482,Rotar; Vladimir,10,0,34,24
1657349998842,MATH 197,001,091859,McAuley; Julian John,9999,0,9999,0
1657349998842,MATH 197,002,095566,Kedlaya; Kiran S.,9997,0,9999,2
1657349998842,MATH 197,003,095567,Xiao; Ming,9999,0,9999,0
1657349998842,MATH 197,004,095571,Perols; Johan Lars,9998,0,9999,1
1657350005983,COGS 9,A01,083615,Shannon; Kyle Michael,8,0,75,67
1657350012005,COGS 11,A01,083617,Boyle; Mary E. T.,22,0,48,26
1657350018028,COGS 13,A01,083071,Bastos; Amalia Pinkusfeld,11,0,71,60
1657350024055,COGS 14A,A01,092681,Semenuks; Arturs,4,1,100,96
1657350030082,COGS 14B,A01,083073,Cheng; Tzu-Han,6,0,63,57
1657350036107,COGS 17,A01,092677,Semenuks; Arturs,6,0,81,75
1657350042131,COGS 100,A01,083619,Allen; Michael Gordon,17,0,70,53
1657350048158,COGS 101A,A01,083621,Davis; Joshua Daniel,9,0,68,59
1657350054179,COGS 101B,A01,091572,Allen; Michael Gordon,11,0,65,54
1657350060208,COGS 101C,A01,083625,Delgado; Tania,17,0,35,18
1657350066237,COGS 107A,A01,083627,Boyle; Mary E. T.,13,0,60,47
1657350072260,COGS 118A,A01,083075,Gupta; Anjum,20,0,76,56
1657350078284,CSE 3,A50,083646,Miranda; Gregory Joseph,24,0,50,26
1657350084315,CSE 8A,A50,083650,Miranda; Gregory Joseph,17,1,56,39
1657350090349,CSE 11,A01,083080,Cao; Yingjun,6,15,40,34
1657350096375,CSE 12,A01,083652,Krause-Levy; Sophia Louisa,28,1,120,92
1657350102400,CSE 15L,A01,083654,Morris; Justin Loren,9,0,50,41
1657350102400,CSE 15L,A02,083655,Morris; Justin Loren,9,0,50,41
1657350108423,CSE 20,A01,083657,Tran; Khoa Dang,39,0,80,41
1657350114447,CSE 21,A01,095574,Bach; Quang Tran,22,0,48,26
1657350120477,CSE 30,A01,083084,Eldon; John,4,0,80,76
1657350120477,CSE 30,B01,095061,Bhaskar; Nishant,9,0,50,41
1657350126501,CSE 100,A01,083659,Cao; Yingjun,5,4,70,65
1657350132527,CSE 134B,A01,083661,Powell; Thomas Allan,22,0,100,78
1657350138551,CSE 140,A01,083663,Gungor; Onat,14,0,85,71
1657350144587,CSE 140L,A01,083088,Eldon; John,21,0,100,79
1657350150612,CSE 175,A01,083665,Kumar; Rakesh,3,0,25,22
1657350156637,CSE 190,A00,092507,Dubnov; Shlomo,7,0,20,13
1657350162660,ECE 45,A01,083139,Congero; Spencer William,6,0,75,69
1657350168695,ECE 65,A50,083695,Saad; Andrew S,12,0,30,18
1657350168695,ECE 65,A51,095125,Saad; Andrew S,24,0,26,2
1657350174718,ECE 109,A01,091882,Touri; Behrouz,19,0,70,51
1657350180741,ECE 180,A00,083140,Abi Samra; Nicholas Camill,1,0,30,29
1657350180741,ECE 180,B00,083141,Abi Samra; Nicholas Camill,0,0,30,30
1657350186765,MATH 10A,A01,083735,Patchell; Gregory David,2,0,30,28
1657350186765,MATH 10A,A02,083736,Patchell; Gregory David,20,0,30,10
1657350186765,MATH 10A,A03,083737,Patchell; Gregory David,16,0,30,14
1657350192793,MATH 10B,A01,083207,Lim; Seonhee,8,0,34,26
1657350192793,MATH 10B,A02,083208,Lim; Seonhee,9,0,35,26
1657350192793,MATH 10B,A03,093472,Lim; Seonhee,7,0,34,27
1657350192793,MATH 10B,B01,083739,Sinha; Shubham,12,0,30,18
1657350198828,MATH 18,A01,083743,Cinel; Cameron Alexander,7,0,30,23
1657350198828,MATH 18,A02,083744,Cinel; Cameron Alexander,17,0,30,13
1657350198828,MATH 18,A03,083745,Cinel; Cameron Alexander,9,0,30,21
1657350198828,MATH 18,B01,083748,Rideout; David Porter,5,0,37,32
1657350198828,MATH 18,B02,083749,Rideout; David Porter,5,0,36,31
1657350198828,MATH 18,B03,083750,Rideout; David Porter,3,0,37,34
1657350198828,MATH 18,B04,083751,Rideout; David Porter,6,0,36,30
1657350198828,MATH 18,B05,093473,Rideout; David Porter,6,0,36,30
1657350198828,MATH 18,B06,093474,Rideout; David Porter,6,0,36,30
1657350204852,MATH 20A,A01,083754,Zheng; Zequn,14,0,40,26
1657350210886,MATH 20B,A01,083756,Briones; Jor-el Thomas Caparas,4,0,36,32
1657350210886,MATH 20B,A02,083757,Briones; Jor-el Thomas Caparas,1,0,36,35
1657350210886,MATH 20B,A03,093475,Briones; Jor-el Thomas Caparas,2,0,36,34
1657350216917,MATH 20C,A01,083760,Briones; Jor-el Thomas Caparas,1,0,35,34
1657350216917,MATH 20C,A02,083761,Briones; Jor-el Thomas Caparas,8,0,35,27
1657350216917,MATH 20C,A03,093476,Briones; Jor-el Thomas Caparas,0,1,36,36
1657350216917,MATH 20C,B01,083762,Bach; Quang Tran,1,0,30,29
1657350222948,MATH 20D,A01,083765,Tran; Brian Kha,5,0,30,25
1657350222948,MATH 20D,A02,083766,Tran; Brian Kha,5,0,30,25
1657350222948,MATH 20D,A03,083767,Tran; Brian Kha,5,0,30,25
1657350228977,MATH 20E,A01,083771,Ganguly; Soumya,9,0,32,23
1657350228977,MATH 20E,A02,083772,Ganguly; Soumya,6,0,32,26
1657350228977,MATH 20E,B01,083773,Ciotti; Benjamin,20,0,35,15
1657350228977,MATH 20E,B02,083774,Ciotti; Benjamin,17,0,35,18
1657350235007,MATH 103A,A01,083777,Greenfeld; Be'Eri,3,0,36,33
1657350235007,MATH 103A,A02,083778,Greenfeld; Be'Eri,5,0,36,31
1657350235007,MATH 103A,A03,093561,Greenfeld; Be'Eri,5,0,36,31
1657350235007,MATH 103A,B01,083779,Greenfeld; Be'Eri,7,0,36,29
1657350235007,MATH 103A,B02,083780,Greenfeld; Be'Eri,4,0,36,32
1657350235007,MATH 103A,B03,093562,Greenfeld; Be'Eri,3,0,36,33
1657350241031,MATH 105,A01,085443,Carter; Anne Toulson,15,0,35,20
1657350241031,MATH 105,A02,093477,Carter; Anne Toulson,20,0,35,15
1657350247053,MATH 109,A01,083213,Ganzberger; Geoffrey Michael,2,0,34,32
1657350247053,MATH 109,A02,083214,Ganzberger; Geoffrey Michael,4,0,34,30
1657350247053,MATH 109,A03,093478,Ganzberger; Geoffrey Michael,2,0,34,32
1657350247053,MATH 109,B01,083215,Ganzberger; Geoffrey Michael,1,0,32,31
1657350247053,MATH 109,B02,083216,Ganzberger; Geoffrey Michael,2,0,32,30
1657350247053,MATH 109,B03,093479,Ganzberger; Geoffrey Michael,8,0,32,24
1657350253083,MATH 142A,A01,083219,Chow; Bennett,7,0,32,25
1657350253083,MATH 142A,A02,083220,Chow; Bennett,10,0,32,22
1657350253083,MATH 142A,A03,093480,Chow; Bennett,8,0,32,24
1657350253083,MATH 142A,B03,093481,Chow; Bennett,8,0,32,24
1657350253083,MATH 142A,B04,093558,Chow; Bennett,13,0,32,19
1657350253083,MATH 142A,B05,093559,Chow; Bennett,6,0,32,26
1657350259107,MATH 193A,A01,083224,Rotar; Vladimir,8,0,34,26
1657350259107,MATH 193A,A02,083225,Rotar; Vladimir,9,0,34,25
1657350259107,MATH 193A,A03,083781,Rotar; Vladimir,5,0,34,29
1657350259107,MATH 193A,A04,083782,Rotar; Vladimir,10,0,34,24
1657350259107,MATH 193A,A05,093482,Rotar; Vladimir,10,0,34,24
1657350265133,MATH 197,001,091859,McAuley; Julian John,9999,0,9999,0
1657350265133,MATH 197,002,095566,Kedlaya; Kiran S.,9997,0,9999,2
1657350265133,MATH 197,003,095567,Xiao; Ming,9999,0,9999,0
1657350265133,MATH 197,004,095571,Perols; Johan Lars,9998,0,9999,1
1657350272200,COGS 9,A01,083615,Shannon; Kyle Michael,8,0,75,67
1657350278226,COGS 11,A01,083617,Boyle; Mary E. T.,22,0,48,26
1657350284252,COGS 13,A01,083071,Bastos; Amalia Pinkusfeld,11,0,71,60
1657350290284,COGS 14A,A01,092681,Semenuks; Arturs,4,1,100,96
1657350296311,COGS 14B,A01,083073,Cheng; Tzu-Han,6,0,63,57
1657350302339,COGS 17,A01,092677,Semenuks; Arturs,6,0,81,75
1657350308361,COGS 100,A01,083619,Allen; Michael Gordon,17,0,70,53
1657350314386,COGS 101A,A01,083621,Davis; Joshua Daniel,9,0,68,59
1657350320419,COGS 101B,A01,091572,Allen; Michael Gordon,11,0,65,54
1657350326443,COGS 101C,A01,083625,Delgado; Tania,17,0,35,18
1657350332469,COGS 107A,A01,083627,Boyle; Mary E. T.,13,0,60,47
1657350338492,COGS 118A,A01,083075,Gupta; Anjum,20,0,76,56
1657350344520,CSE 3,A50,083646,Miranda; Gregory Joseph,24,0,50,26
1657350350543,CSE 8A,A50,083650,Miranda; Gregory Joseph,17,1,56,39
1657350356565,CSE 11,A01,083080,Cao; Yingjun,6,15,40,34
1657350362589,CSE 12,A01,083652,Krause-Levy; Sophia Louisa,28,1,120,92
1657350368613,CSE 15L,A01,083654,Morris; Justin Loren,9,0,50,41
1657350368613,CSE 15L,A02,083655,Morris; Justin Loren,9,0,50,41
1657350374635,CSE 20,A01,083657,Tran; Khoa Dang,39,0,80,41
1657350380659,CSE 21,A01,095574,Bach; Quang Tran,22,0,48,26
1657350386692,CSE 30,A01,083084,Eldon; John,4,0,80,76
1657350386692,CSE 30,B01,095061,Bhaskar; Nishant,9,0,50,41
1657350392718,CSE 100,A01,083659,Cao; Yingjun,5,4,70,65
1657350398739,CSE 134B,A01,083661,Powell; Thomas Allan,22,0,100,78
1657350404766,CSE 140,A01,083663,Gungor; Onat,14,0,85,71
1657350410796,CSE 140L,A01,083088,Eldon; John,21,0,100,79
1657350416821,CSE 175,A01,083665,Kumar; Rakesh,3,0,25,22
1657350422848,CSE 190,A00,092507,Dubnov; Shlomo,7,0,20,13
1657350428876,ECE 45,A01,083139,Congero; Spencer William,6,0,75,69
1657350434901,ECE 65,A50,083695,Saad; Andrew S,12,0,30,18
1657350434901,ECE 65,A51,095125,Saad; Andrew S,24,0,26,2
1657350440925,ECE 109,A01,091882,Touri; Behrouz,19,0,70,51
1657350446956,ECE 180,A00,083140,Abi Samra; Nicholas Camill,1,0,30,29
1657350446956,ECE 180,B00,083141,Abi Samra; Nicholas Camill,0,0,30,30
1657350452993,MATH 10A,A01,083735,Patchell; Gregory David,2,0,30,28
1657350452993,MATH 10A,A02,083736,Patchell; Gregory David,20,0,30,10
1657350452993,MATH 10A,A03,083737,Patchell; Gregory David,16,0,30,14
1657350459018,MATH 10B,A01,083207,Lim; Seonhee,8,0,34,26
1657350459018,MATH 10B,A02,083208,Lim; Seonhee,9,0,35,26
1657350459018,MATH 10B,A03,093472,Lim; Seonhee,7,0,34,27
1657350459018,MATH 10B,B01,083739,Sinha; Shubham,12,0,30,18
1657350465044,MATH 18,A01,083743,Cinel; Cameron Alexander,7,0,30,23
1657350465044,MATH 18,A02,083744,Cinel; Cameron Alexander,17,0,30,13
1657350465044,MATH 18,A03,083745,Cinel; Cameron Alexander,9,0,30,21
1657350465044,MATH 18,B01,083748,Rideout; David Porter,5,0,37,32
1657350465044,MATH 18,B02,083749,Rideout; David Porter,5,0,36,31
1657350465044,MATH 18,B03,083750,Rideout; David Porter,3,0,37,34
1657350465044,MATH 18,B04,083751,Rideout; David Porter,6,0,36,30
1657350465044,MATH 18,B05,093473,Rideout; David Porter,6,0,36,30
1657350465044,MATH 18,B06,093474,Rideout; David Porter,6,0,36,30
1657350471067,MATH 20A,A01,083754,Zheng; Zequn,14,0,40,26
1657350477091,MATH 20B,A01,083756,Briones; Jor-el Thomas Caparas,4,0,36,32
1657350477091,MATH 20B,A02,083757,Briones; Jor-el Thomas Caparas,1,0,36,35
1657350477091,MATH 20B,A03,093475,Briones; Jor-el Thomas Caparas,2,0,36,34
1657350483116,MATH 20C,A01,083760,Briones; Jor-el Thomas Caparas,1,0,35,34
1657350483116,MATH 20C,A02,083761,Briones; Jor-el Thomas Caparas,8,0,35,27
1657350483116,MATH 20C,A03,093476,Briones; Jor-el Thomas Caparas,0,1,36,36
1657350483116,MATH 20C,B01,083762,Bach; Quang Tran,1,0,30,29
1657350489155,MATH 20D,A01,083765,Tran; Brian Kha,5,0,30,25
1657350489155,MATH 20D,A02,083766,Tran; Brian Kha,5,0,30,25
1657350489155,MATH 20D,A03,083767,Tran; Brian Kha,5,0,30,25
1657350495187,MATH 20E,A01,083771,Ganguly; Soumya,9,0,32,23
1657350495187,MATH 20E,A02,083772,Ganguly; Soumya,6,0,32,26
1657350495187,MATH 20E,B01,083773,Ciotti; Benjamin,20,0,35,15
1657350495187,MATH 20E,B02,083774,Ciotti; Benjamin,17,0,35,18
1657350501211,MATH 103A,A01,083777,Greenfeld; Be'Eri,3,0,36,33
1657350501211,MATH 103A,A02,083778,Greenfeld; Be'Eri,5,0,36,31
1657350501211,MATH 103A,A03,093561,Greenfeld; Be'Eri,5,0,36,31
1657350501211,MATH 103A,B01,083779,Greenfeld; Be'Eri,7,0,36,29
1657350501211,MATH 103A,B02,083780,Greenfeld; Be'Eri,4,0,36,32
1657350501211,MATH 103A,B03,093562,Greenfeld; Be'Eri,3,0,36,33
1657350507242,MATH 105,A01,085443,Carter; Anne Toulson,15,0,35,20
1657350507242,MATH 105,A02,093477,Carter; Anne Toulson,20,0,35,15
1657350513272,MATH 109,A01,083213,Ganzberger; Geoffrey Michael,2,0,34,32
1657350513272,MATH 109,A02,083214,Ganzberger; Geoffrey Michael,4,0,34,30
1657350513272,MATH 109,A03,093478,Ganzberger; Geoffrey Michael,2,0,34,32
1657350513272,MATH 109,B01,083215,Ganzberger; Geoffrey Michael,1,0,32,31
1657350513272,MATH 109,B02,083216,Ganzberger; Geoffrey Michael,2,0,32,30
1657350513272,MATH 109,B03,093479,Ganzberger; Geoffrey Michael,8,0,32,24
1657350519301,MATH 142A,A01,083219,Chow; Bennett,7,0,32,25
1657350519301,MATH 142A,A02,083220,Chow; Bennett,10,0,32,22
1657350519301,MATH 142A,A03,093480,Chow; Bennett,8,0,32,24
1657350519301,MATH 142A,B03,093481,Chow; Bennett,8,0,32,24
1657350519301,MATH 142A,B04,093558,Chow; Bennett,13,0,32,19
1657350519301,MATH 142A,B05,093559,Chow; Bennett,6,0,32,26
1657350525330,MATH 193A,A01,083224,Rotar; Vladimir,8,0,34,26
1657350525330,MATH 193A,A02,083225,Rotar; Vladimir,9,0,34,25
1657350525330,MATH 193A,A03,083781,Rotar; Vladimir,5,0,34,29
1657350525330,MATH 193A,A04,083782,Rotar; Vladimir,10,0,34,24
1657350525330,MATH 193A,A05,093482,Rotar; Vladimir,10,0,34,24
1657350531354,MATH 197,001,091859,McAuley; Julian John,9999,0,9999,0
1657350531354,MATH 197,002,095566,Kedlaya; Kiran S.,9997,0,9999,2
1657350531354,MATH 197,003,095567,Xiao; Ming,9999,0,9999,0
1657350531354,MATH 197,004,095571,Perols; Johan Lars,9998,0,9999,1
1657350538440,COGS 9,A01,083615,Shannon; Kyle Michael,8,0,75,67
1657350544467,COGS 11,A01,083617,Boyle; Mary E. T.,22,0,48,26
1657350550492,COGS 13,A01,083071,Bastos; Amalia Pinkusfeld,11,0,71,60
1657350556520,COGS 14A,A01,092681,Semenuks; Arturs,4,1,100,96
1657350562548,COGS 14B,A01,083073,Cheng; Tzu-Han,6,0,63,57
1657350568571,COGS 17,A01,092677,Semenuks; Arturs,6,0,81,75
1657350574595,COGS 100,A01,083619,Allen; Michael Gordon,17,0,70,53
1657350580618,COGS 101A,A01,083621,Davis; Joshua Daniel,9,0,68,59
1657350586640,COGS 101B,A01,091572,Allen; Michael Gordon,11,0,65,54
1657350592666,COGS 101C,A01,083625,Delgado; Tania,17,0,35,18
1657350598690,COGS 107A,A01,083627,Boyle; Mary E. T.,13,0,60,47
1657350604817,COGS 118A,A01,083075,Gupta; Anjum,20,0,76,56
1657350610850,CSE 3,A50,083646,Miranda; Gregory Joseph,24,0,50,26
1657350616873,CSE 8A,A50,083650,Miranda; Gregory Joseph,17,1,56,39
1657350622899,CSE 11,A01,083080,Cao; Yingjun,6,15,40,34
1657350628923,CSE 12,A01,083652,Krause-Levy; Sophia Louisa,28,1,120,92
1657350634951,CSE 15L,A01,083654,Morris; Justin Loren,9,0,50,41
1657350634951,CSE 15L,A02,083655,Morris; Justin Loren,9,0,50,41
1657350640976,CSE 20,A01,083657,Tran; Khoa Dang,39,0,80,41
1657350647009,CSE 21,A01,095574,Bach; Quang Tran,22,0,48,26
1657350653031,CSE 30,A01,083084,Eldon; John,4,0,80,76
1657350653031,CSE 30,B01,095061,Bhaskar; Nishant,9,0,50,41
1657350659055,CSE 100,A01,083659,Cao; Yingjun,5,4,70,65
1657350665106,CSE 134B,A01,083661,Powell; Thomas Allan,22,0,100,78
1657350671143,CSE 140,A01,083663,Gungor; Onat,14,0,85,71
1657350677172,CSE 140L,A01,083088,Eldon; John,21,0,100,79
1657350683197,CSE 175,A01,083665,Kumar; Rakesh,3,0,25,22
1657350689221,CSE 190,A00,092507,Dubnov; Shlomo,7,0,20,13
1657350695256,ECE 45,A01,083139,Congero; Spencer William,6,0,75,69
1657350701288,ECE 65,A50,083695,Saad; Andrew S,12,0,30,18
1657350701288,ECE 65,A51,095125,Saad; Andrew S,24,0,26,2
1657350707311,ECE 109,A01,091882,Touri; Behrouz,19,0,70,51
1657350713339,ECE 180,A00,083140,Abi Samra; Nicholas Camill,1,0,30,29
1657350713339,ECE 180,B00,083141,Abi Samra; Nicholas Camill,0,0,30,30
1657350719376,MATH 10A,A01,083735,Patchell; Gregory David,2,0,30,28
1657350719376,MATH 10A,A02,083736,Patchell; Gregory David,20,0,30,10
1657350719376,MATH 10A,A03,083737,Patchell; Gregory David,16,0,30,14
1657350725400,MATH 10B,A01,083207,Lim; Seonhee,8,0,34,26
1657350725400,MATH 10B,A02,083208,Lim; Seonhee,9,0,35,26
1657350725400,MATH 10B,A03,093472,Lim; Seonhee,7,0,34,27
1657350725400,MATH 10B,B01,083739,Sinha; Shubham,12,0,30,18
1657350731426,MATH 18,A01,083743,Cinel; Cameron Alexander,7,0,30,23
1657350731426,MATH 18,A02,083744,Cinel; Cameron Alexander,17,0,30,13
1657350731426,MATH 18,A03,083745,Cinel; Cameron Alexander,9,0,30,21
1657350731426,MATH 18,B01,083748,Rideout; David Porter,5,0,37,32
1657350731426,MATH 18,B02,083749,Rideout; David Porter,5,0,36,31
1657350731426,MATH 18,B03,083750,Rideout; David Porter,3,0,37,34
1657350731426,MATH 18,B04,083751,Rideout; David Porter,6,0,36,30
1657350731426,MATH 18,B05,093473,Rideout; David Porter,6,0,36,30
1657350731426,MATH 18,B06,093474,Rideout; David Porter,6,0,36,30
1657350737452,MATH 20A,A01,083754,Zheng; Zequn,14,0,40,26
1657350743501,MATH 20B,A01,083756,Briones; Jor-el Thomas Caparas,4,0,36,32
1657350743501,MATH 20B,A02,083757,Briones; Jor-el Thomas Caparas,1,0,36,35
1657350743501,MATH 20B,A03,093475,Briones; Jor-el Thomas Caparas,2,0,36,34
1657350749542,MATH 20C,A01,083760,Briones; Jor-el Thomas Caparas,1,0,35,34
1657350749542,MATH 20C,A02,083761,Briones; Jor-el Thomas Caparas,8,0,35,27
1657350749542,MATH 20C,A03,093476,Briones; Jor-el Thomas Caparas,0,1,36,36
1657350749542,MATH 20C,B01,083762,Bach; Quang Tran,1,0,30,29
1657350755587,MATH 20D,A01,083765,Tran; Brian Kha,5,0,30,25
1657350755587,MATH 20D,A02,083766,Tran; Brian Kha,5,0,30,25
1657350755587,MATH 20D,A03,083767,Tran; Brian Kha,5,0,30,25
1657350761620,MATH 20E,A01,083771,Ganguly; Soumya,9,0,32,23
1657350761620,MATH 20E,A02,083772,Ganguly; Soumya,6,0,32,26
1657350761620,MATH 20E,B01,083773,Ciotti; Benjamin,20,0,35,15
1657350761620,MATH 20E,B02,083774,Ciotti; Benjamin,17,0,35,18
1657350767645,MATH 103A,A01,083777,Greenfeld; Be'Eri,3,0,36,33
1657350767645,MATH 103A,A02,083778,Greenfeld; Be'Eri,5,0,36,31
1657350767645,MATH 103A,A03,093561,Greenfeld; Be'Eri,5,0,36,31
1657350767645,MATH 103A,B01,083779,Greenfeld; Be'Eri,7,0,36,29
1657350767645,MATH 103A,B02,083780,Greenfeld; Be'Eri,4,0,36,32
1657350767645,MATH 103A,B03,093562,Greenfeld; Be'Eri,3,0,36,33
1657350773669,MATH 105,A01,085443,Carter; Anne Toulson,15,0,35,20
1657350773669,MATH 105,A02,093477,Carter; Anne Toulson,20,0,35,15
1657350779702,MATH 109,A01,083213,Ganzberger; Geoffrey Michael,2,0,34,32
1657350779702,MATH 109,A02,083214,Ganzberger; Geoffrey Michael,4,0,34,30
1657350779702,MATH 109,A03,093478,Ganzberger; Geoffrey Michael,2,0,34,32
1657350779702,MATH 109,B01,083215,Ganzberger; Geoffrey Michael,1,0,32,31
1657350779702,MATH 109,B02,083216,Ganzberger; Geoffrey Michael,2,0,32,30
1657350779702,MATH 109,B03,093479,Ganzberger; Geoffrey Michael,8,0,32,24
1657350785728,MATH 142A,A01,083219,Chow; Bennett,7,0,32,25
1657350785728,MATH 142A,A02,083220,Chow; Bennett,10,0,32,22
1657350785728,MATH 142A,A03,093480,Chow; Bennett,8,0,32,24
1657350785728,MATH 142A,B03,093481,Chow; Bennett,8,0,32,24
1657350785728,MATH 142A,B04,093558,Chow; Bennett,13,0,32,19
1657350785728,MATH 142A,B05,093559,Chow; Bennett,6,0,32,26
1657350791758,MATH 193A,A01,083224,Rotar; Vladimir,8,0,34,26
1657350791758,MATH 193A,A02,083225,Rotar; Vladimir,9,0,34,25
1657350791758,MATH 193A,A03,083781,Rotar; Vladimir,5,0,34,29
1657350791758,MATH 193A,A04,083782,Rotar; Vladimir,10,0,34,24
1657350791758,MATH 193A,A05,093482,Rotar; Vladimir,10,0,34,24
1657350797793,MATH 197,001,091859,McAuley; Julian John,9999,0,9999,0
1657350797793,MATH 197,002,095566,Kedlaya; Kiran S.,9997,0,9999,2
1657350797793,MATH 197,003,095567,Xiao; Ming,9999,0,9999,0
1657350797793,MATH 197,004,095571,Perols; Johan Lars,9998,0,9999,1
1657350804856,COGS 9,A01,083615,Shannon; Kyle Michael,8,0,75,67
1657350810880,COGS 11,A01,083617,Boyle; Mary E. T.,22,0,48,26
1657350816910,COGS 13,A01,083071,Bastos; Amalia Pinkusfeld,11,0,71,60
1657350822933,COGS 14A,A01,092681,Semenuks; Arturs,4,1,100,96
1657350828957,COGS 14B,A01,083073,Cheng; Tzu-Han,6,0,63,57
1657350834980,COGS 17,A01,092677,Semenuks; Arturs,6,0,81,75
1657350841009,COGS 100,A01,083619,Allen; Michael Gordon,17,0,70,53
1657350847033,COGS 101A,A01,083621,Davis; Joshua Daniel,9,0,68,59
1657350853063,COGS 101B,A01,091572,Allen; Michael Gordon,11,0,65,54
1657350859088,COGS 101C,A01,083625,Delgado; Tania,17,0,35,18
1657350865113,COGS 107A,A01,083627,Boyle; Mary E. T.,13,0,60,47
1657350871136,COGS 118A,A01,083075,Gupta; Anjum,20,0,76,56
1657350877185,CSE 3,A50,083646,Miranda; Gregory Joseph,24,0,50,26
1657350883215,CSE 8A,A50,083650,Miranda; Gregory Joseph,17,1,56,39
1657350889244,CSE 11,A01,083080,Cao; Yingjun,6,15,40,34
1657350895275,CSE 12,A01,083652,Krause-Levy; Sophia Louisa,28,1,120,92
1657350901299,CSE 15L,A01,083654,Morris; Justin Loren,9,0,50,41
1657350901299,CSE 15L,A02,083655,Morris; Justin Loren,9,0,50,41
1657350907327,CSE 20,A01,083657,Tran; Khoa Dang,39,0,80,41
1657350913350,CSE 21,A01,095574,Bach; Quang Tran,22,0,48,26
1657350919375,CSE 30,A01,083084,Eldon; John,4,0,80,76
1657350919375,CSE 30,B01,095061,Bhaskar; Nishant,9,0,50,41
1657350925399,CSE 100,A01,083659,Cao; Yingjun,5,4,70,65
1657350931427,CSE 134B,A01,083661,Powell; Thomas Allan,22,0,100,78
1657350937456,CSE 140,A01,083663,Gungor; Onat,14,0,85,71
1657350943480,CSE 140L,A01,083088,Eldon; John,21,0,100,79
1657350949503,CSE 175,A01,083665,Kumar; Rakesh,3,0,25,22
1657350955531,CSE 190,A00,092507,Dubnov; Shlomo,7,0,20,13
1657350961570,ECE 45,A01,083139,Congero; Spencer William,6,0,75,69
1657350967600,ECE 65,A50,083695,Saad; Andrew S,12,0,30,18
1657350967600,ECE 65,A51,095125,Saad; Andrew S,24,0,26,2
1657350973627,ECE 109,A01,091882,Touri; Behrouz,19,0,70,51
1657350979650,ECE 180,A00,083140,Abi Samra; Nicholas Camill,1,0,30,29
1657350979650,ECE 180,B00,083141,Abi Samra; Nicholas Camill,0,0,30,30
1657350985681,MATH 10A,A01,083735,Patchell; Gregory David,2,0,30,28
1657350985681,MATH 10A,A02,083736,Patchell; Gregory David,20,0,30,10
1657350985681,MATH 10A,A03,083737,Patchell; Gregory David,16,0,30,14
1657350991706,MATH 10B,A01,083207,Lim; Seonhee,8,0,34,26
1657350991706,MATH 10B,A02,083208,Lim; Seonhee,9,0,35,26
1657350991706,MATH 10B,A03,093472,Lim; Seonhee,7,0,34,27
1657350991706,MATH 10B,B01,083739,Sinha; Shubham,12,0,30,18
1657350997730,MATH 18,A01,083743,Cinel; Cameron Alexander,7,0,30,23
1657350997730,MATH 18,A02,083744,Cinel; Cameron Alexander,17,0,30,13
1657350997730,MATH 18,A03,083745,Cinel; Cameron Alexander,9,0,30,21
1657350997730,MATH 18,B01,083748,Rideout; David Porter,5,0,37,32
1657350997730,MATH 18,B02,083749,Rideout; David Porter,5,0,36,31
1657350997730,MATH 18,B03,083750,Rideout; David Porter,3,0,37,34
1657350997730,MATH 18,B04,083751,Rideout; David Porter,6,0,36,30
1657350997730,MATH 18,B05,093473,Rideout; David Porter,6,0,36,30
1657350997730,MATH 18,B06,093474,Rideout; David Porter,6,0,36,30
1657351003764,MATH 20A,A01,083754,Zheng; Zequn,14,0,40,26
1657351009786,MATH 20B,A01,083756,Briones; Jor-el Thomas Caparas,4,0,36,32
1657351009786,MATH 20B,A02,083757,Briones; Jor-el Thomas Caparas,1,0,36,35
1657351009786,MATH 20B,A03,093475,Briones; Jor-el Thomas Caparas,2,0,36,34
1657351015817,MATH 20C,A01,083760,Briones; Jor-el Thomas Caparas,1,0,35,34
1657351015817,MATH 20C,A02,083761,Briones; Jor-el Thomas Caparas,8,0,35,27
1657351015817,MATH 20C,A03,093476,Briones; Jor-el Thomas Caparas,0,1,36,36
1657351015817,MATH 20C,B01,083762,Bach; Quang Tran,1,0,30,29
1657351021840,MATH 20D,A01,083765,Tran; Brian Kha,5,0,30,25
1657351021840,MATH 20D,A02,083766,Tran; Brian Kha,5,0,30,25
1657351021840,MATH 20D,A03,083767,Tran; Brian Kha,5,0,30,25
1657351027870,MATH 20E,A01,083771,Ganguly; Soumya,9,0,32,23
1657351027870,MATH 20E,A02,083772,Ganguly; Soumya,6,0,32,26
1657351027870,MATH 20E,B01,083773,Ciotti; Benjamin,20,0,35,15
1657351027870,MATH 20E,B02,083774,Ciotti; Benjamin,17,0,35,18
1657351033895,MATH 103A,A01,083777,Greenfeld; Be'Eri,3,0,36,33
1657351033895,MATH 103A,A02,083778,Greenfeld; Be'Eri,5,0,36,31
1657351033895,MATH 103A,A03,093561,Greenfeld; Be'Eri,5,0,36,31
1657351033895,MATH 103A,B01,083779,Greenfeld; Be'Eri,7,0,36,29
1657351033895,MATH 103A,B02,083780,Greenfeld; Be'Eri,4,0,36,32
1657351033895,MATH 103A,B03,093562,Greenfeld; Be'Eri,3,0,36,33
1657351039925,MATH 105,A01,085443,Carter; Anne Toulson,15,0,35,20
1657351039925,MATH 105,A02,093477,Carter; Anne Toulson,20,0,35,15
1657351045969,MATH 109,A01,083213,Ganzberger; Geoffrey Michael,2,0,34,32
1657351045969,MATH 109,A02,083214,Ganzberger; Geoffrey Michael,4,0,34,30
1657351045969,MATH 109,A03,093478,Ganzberger; Geoffrey Michael,2,0,34,32
1657351045969,MATH 109,B01,083215,Ganzberger; Geoffrey Michael,1,0,32,31
1657351045969,MATH 109,B02,083216,Ganzberger; Geoffrey Michael,2,0,32,30
1657351045969,MATH 109,B03,093479,Ganzberger; Geoffrey Michael,8,0,32,24
1657351052003,MATH 142A,A01,083219,Chow; Bennett,7,0,32,25
1657351052003,MATH 142A,A02,083220,Chow; Bennett,10,0,32,22
1657351052003,MATH 142A,A03,093480,Chow; Bennett,8,0,32,24
1657351052003,MATH 142A,B03,093481,Chow; Bennett,8,0,32,24
1657351052003,MATH 142A,B04,093558,Chow; Bennett,13,0,32,19
1657351052003,MATH 142A,B05,093559,Chow; Bennett,6,0,32,26
1657351058029,MATH 193A,A01,083224,Rotar; Vladimir,8,0,34,26
1657351058029,MATH 193A,A02,083225,Rotar; Vladimir,9,0,34,25
1657351058029,MATH 193A,A03,083781,Rotar; Vladimir,5,0,34,29
1657351058029,MATH 193A,A04,083782,Rotar; Vladimir,10,0,34,24
1657351058029,MATH 193A,A05,093482,Rotar; Vladimir,10,0,34,24
1657351064059,MATH 197,001,091859,McAuley; Julian John,9999,0,9999,0
1657351064059,MATH 197,002,095566,Kedlaya; Kiran S.,9997,0,9999,2
1657351064059,MATH 197,003,095567,Xiao; Ming,9999,0,9999,0
1657351064059,MATH 197,004,095571,Perols; Johan Lars,9998,0,9999,1
1657351071157,COGS 9,A01,083615,Shannon; Kyle Michael,8,0,75,67
1657351077186,COGS 11,A01,083617,Boyle; Mary E. T.,22,0,48,26
1657351083211,COGS 13,A01,083071,Bastos; Amalia Pinkusfeld,11,0,71,60
1657351089237,COGS 14A,A01,092681,Semenuks; Arturs,4,1,100,96
1657351095270,COGS 14B,A01,083073,Cheng; Tzu-Han,6,0,63,57
1657351101294,COGS 17,A01,092677,Semenuks; Arturs,6,0,81,75
1657351107351,COGS 100,A01,083619,Allen; Michael Gordon,17,0,70,53
1657351113376,COGS 101A,A01,083621,Davis; Joshua Daniel,9,0,68,59
1657351119404,COGS 101B,A01,091572,Allen; Michael Gordon,11,0,65,54
1657351125434,COGS 101C,A01,083625,Delgado; Tania,17,0,35,18
1657351131457,COGS 107A,A01,083627,Boyle; Mary E. T.,13,0,60,47
1657351137488,COGS 118A,A01,083075,Gupta; Anjum,20,0,76,56
1657351143513,CSE 3,A50,083646,Miranda; Gregory Joseph,24,0,50,26
1657351149537,CSE 8A,A50,083650,Miranda; Gregory Joseph,17,1,56,39
1657351155563,CSE 11,A01,083080,Cao; Yingjun,6,15,40,34
1657351161587,CSE 12,A01,083652,Krause-Levy; Sophia Louisa,28,1,120,92
1657351167616,CSE 15L,A01,083654,Morris; Justin Loren,9,0,50,41
1657351167616,CSE 15L,A02,083655,Morris; Justin Loren,9,0,50,41
1657351173642,CSE 20,A01,083657,Tran; Khoa Dang,39,0,80,41
1657351179675,CSE 21,A01,095574,Bach; Quang Tran,22,0,48,26
1657351185702,CSE 30,A01,083084,Eldon; John,4,0,80,76
1657351185702,CSE 30,B01,095061,Bhaskar; Nishant,9,0,50,41
1657351191726,CSE 100,A01,083659,Cao; Yingjun,5,4,70,65
1657351197754,CSE 134B,A01,083661,Powell; Thomas Allan,22,0,100,78
1657351203869,CSE 140,A01,083663,Gungor; Onat,14,0,85,71
1657351209896,CSE 140L,A01,083088,Eldon; John,21,0,100,79
1657351215923,CSE 175,A01,083665,Kumar; Rakesh,3,0,25,22
1657351221946,CSE 190,A00,092507,Dubnov; Shlomo,7,0,20,13
1657351227972,ECE 45,A01,083139,Congero; Spencer William,6,0,75,69
1657351233994,ECE 65,A50,083695,Saad; Andrew S,12,0,30,18
1657351233994,ECE 65,A51,095125,Saad; Andrew S,24,0,26,2
1657351240025,ECE 109,A01,091882,Touri; Behrouz,19,0,70,51
1657351246050,ECE 180,A00,083140,Abi Samra; Nicholas Camill,1,0,30,29
1657351246050,ECE 180,B00,083141,Abi Samra; Nicholas Camill,0,0,30,30
1657351252082,MATH 10A,A01,083735,Patchell; Gregory David,2,0,30,28
1657351252082,MATH 10A,A02,083736,Patchell; Gregory David,20,0,30,10
1657351252082,MATH 10A,A03,083737,Patchell; Gregory David,16,0,30,14
1657351258107,MATH 10B,A01,083207,Lim; Seonhee,8,0,34,26
1657351258107,MATH 10B,A02,083208,Lim; Seonhee,9,0,35,26
1657351258107,MATH 10B,A03,093472,Lim; Seonhee,7,0,34,27
1657351258107,MATH 10B,B01,083739,Sinha; Shubham,12,0,30,18
1657351264134,MATH 18,A01,083743,Cinel; Cameron Alexander,7,0,30,23
1657351264134,MATH 18,A02,083744,Cinel; Cameron Alexander,17,0,30,13
1657351264134,MATH 18,A03,083745,Cinel; Cameron Alexander,9,0,30,21
1657351264134,MATH 18,B01,083748,Rideout; David Porter,5,0,37,32
1657351264134,MATH 18,B02,083749,Rideout; David Porter,5,0,36,31
1657351264134,MATH 18,B03,083750,Rideout; David Porter,3,0,37,34
1657351264134,MATH 18,B04,083751,Rideout; David Porter,6,0,36,30
1657351264134,MATH 18,B05,093473,Rideout; David Porter,6,0,36,30
1657351264134,MATH 18,B06,093474,Rideout; David Porter,6,0,36,30
1657351270156,MATH 20A,A01,083754,Zheng; Zequn,14,0,40,26
1657351276182,MATH 20B,A01,083756,Briones; Jor-el Thomas Caparas,4,0,36,32
1657351276182,MATH 20B,A02,083757,Briones; Jor-el Thomas Caparas,1,0,36,35
1657351276182,MATH 20B,A03,093475,Briones; Jor-el Thomas Caparas,2,0,36,34
1657351282207,MATH 20C,A01,083760,Briones; Jor-el Thomas Caparas,1,0,35,34
1657351282207,MATH 20C,A02,083761,Briones; Jor-el Thomas Caparas,8,0,35,27
1657351282207,MATH 20C,A03,093476,Briones; Jor-el Thomas Caparas,0,1,36,36
1657351282207,MATH 20C,B01,083762,Bach; Quang Tran,1,0,30,29
1657351288245,MATH 20D,A01,083765,Tran; Brian Kha,5,0,30,25
1657351288245,MATH 20D,A02,083766,Tran; Brian Kha,5,0,30,25
1657351288245,MATH 20D,A03,083767,Tran; Brian Kha,5,0,30,25
1657351294279,MATH 20E,A01,083771,Ganguly; Soumya,9,0,32,23
1657351294279,MATH 20E,A02,083772,Ganguly; Soumya,6,0,32,26
1657351294279,MATH 20E,B01,083773,Ciotti; Benjamin,20,0,35,15
1657351294279,MATH 20E,B02,083774,Ciotti; Benjamin,17,0,35,18
1657351300306,MATH 103A,A01,083777,Greenfeld; Be'Eri,3,0,36,33
1657351300306,MATH 103A,A02,083778,Greenfeld; Be'Eri,5,0,36,31
1657351300306,MATH 103A,A03,093561,Greenfeld; Be'Eri,5,0,36,31
1657351300306,MATH 103A,B01,083779,Greenfeld; Be'Eri,7,0,36,29
1657351300306,MATH 103A,B02,083780,Greenfeld; Be'Eri,4,0,36,32
1657351300306,MATH 103A,B03,093562,Greenfeld; Be'Eri,3,0,36,33
1657351306331,MATH 105,A01,085443,Carter; Anne Toulson,15,0,35,20
1657351306331,MATH 105,A02,093477,Carter; Anne Toulson,20,0,35,15
1657351312355,MATH 109,A01,083213,Ganzberger; Geoffrey Michael,2,0,34,32
1657351312355,MATH 109,A02,083214,Ganzberger; Geoffrey Michael,4,0,34,30
1657351312355,MATH 109,A03,093478,Ganzberger; Geoffrey Michael,2,0,34,32
1657351312355,MATH 109,B01,083215,Ganzberger; Geoffrey Michael,1,0,32,31
1657351312355,MATH 109,B02,083216,Ganzberger; Geoffrey Michael,2,0,32,30
1657351312355,MATH 109,B03,093479,Ganzberger; Geoffrey Michael,8,0,32,24
1657351318382,MATH 142A,A01,083219,Chow; Bennett,7,0,32,25
1657351318382,MATH 142A,A02,083220,Chow; Bennett,10,0,32,22
1657351318382,MATH 142A,A03,093480,Chow; Bennett,8,0,32,24
1657351318382,MATH 142A,B03,093481,Chow; Bennett,8,0,32,24
1657351318382,MATH 142A,B04,093558,Chow; Bennett,13,0,32,19
1657351318382,MATH 142A,B05,093559,Chow; Bennett,6,0,32,26
1657351324408,MATH 193A,A01,083224,Rotar; Vladimir,8,0,34,26
1657351324408,MATH 193A,A02,083225,Rotar; Vladimir,9,0,34,25
1657351324408,MATH 193A,A03,083781,Rotar; Vladimir,5,0,34,29
1657351324408,MATH 193A,A04,083782,Rotar; Vladimir,10,0,34,24
1657351324408,MATH 193A,A05,093482,Rotar; Vladimir,10,0,34,24
1657351330434,MATH 197,001,091859,McAuley; Julian John,9999,0,9999,0
1657351330434,MATH 197,002,095566,Kedlaya; Kiran S.,9997,0,9999,2
1657351330434,MATH 197,003,095567,Xiao; Ming,9999,0,9999,0
1657351330434,MATH 197,004,095571,Perols; Johan Lars,9998,0,9999,1
1657351337505,COGS 9,A01,083615,Shannon; Kyle Michael,8,0,75,67
1657351343531,COGS 11,A01,083617,Boyle; Mary E. T.,22,0,48,26
1657351349556,COGS 13,A01,083071,Bastos; Amalia Pinkusfeld,11,0,71,60
1657351355588,COGS 14A,A01,092681,Semenuks; Arturs,4,1,100,96
1657351361613,COGS 14B,A01,083073,Cheng; Tzu-Han,6,0,63,57
1657351367637,COGS 17,A01,092677,Semenuks; Arturs,6,0,81,75
1657351373662,COGS 100,A01,083619,Allen; Michael Gordon,17,0,70,53
1657351379687,COGS 101A,A01,083621,Davis; Joshua Daniel,9,0,68,59
1657351385716,COGS 101B,A01,091572,Allen; Michael Gordon,11,0,65,54
1657351391743,COGS 101C,A01,083625,Delgado; Tania,17,0,35,18
1657351397766,COGS 107A,A01,083627,Boyle; Mary E. T.,13,0,60,47
1657351403792,COGS 118A,A01,083075,Gupta; Anjum,20,0,76,56
1657351409820,CSE 3,A50,083646,Miranda; Gregory Joseph,24,0,50,26
1657351415845,CSE 8A,A50,083650,Miranda; Gregory Joseph,17,1,56,39
1657351421870,CSE 11,A01,083080,Cao; Yingjun,6,15,40,34
1657351427897,CSE 12,A01,083652,Krause-Levy; Sophia Louisa,28,1,120,92
1657351433919,CSE 15L,A01,083654,Morris; Justin Loren,9,0,50,41
1657351433919,CSE 15L,A02,083655,Morris; Justin Loren,9,0,50,41
1657351439943,CSE 20,A01,083657,Tran; Khoa Dang,39,0,80,41
1657351445972,CSE 21,A01,095574,Bach; Quang Tran,22,0,48,26
1657351451998,CSE 30,A01,083084,Eldon; John,4,0,80,76
1657351451998,CSE 30,B01,095061,Bhaskar; Nishant,9,0,50,41
1657351458023,CSE 100,A01,083659,Cao; Yingjun,5,4,70,65
1657351464045,CSE 134B,A01,083661,Powell; Thomas Allan,22,0,100,78
1657351470069,CSE 140,A01,083663,Gungor; Onat,14,0,85,71
1657351476094,CSE 140L,A01,083088,Eldon; John,21,0,100,79
1657351482121,CSE 175,A01,083665,Kumar; Rakesh,3,0,25,22
1657351488144,CSE 190,A00,092507,Dubnov; Shlomo,7,0,20,13
1657351494169,ECE 45,A01,083139,Congero; Spencer William,6,0,75,69
1657351500203,ECE 65,A50,083695,Saad; Andrew S,12,0,30,18
1657351500203,ECE 65,A51,095125,Saad; Andrew S,24,0,26,2
1657351506226,ECE 109,A01,091882,Touri; Behrouz,19,0,70,51
1657351512254,ECE 180,A00,083140,Abi Samra; Nicholas Camill,1,0,30,29
1657351512254,ECE 180,B00,083141,Abi Samra; Nicholas Camill,0,0,30,30
1657351518282,MATH 10A,A01,083735,Patchell; Gregory David,2,0,30,28
1657351518282,MATH 10A,A02,083736,Patchell; Gregory David,20,0,30,10
1657351518282,MATH 10A,A03,083737,Patchell; Gregory David,16,0,30,14
1657351524312,MATH 10B,A01,083207,Lim; Seonhee,8,0,34,26
1657351524312,MATH 10B,A02,083208,Lim; Seonhee,9,0,35,26
1657351524312,MATH 10B,A03,093472,Lim; Seonhee,7,0,34,27
1657351524312,MATH 10B,B01,083739,Sinha; Shubham,12,0,30,18
1657351530345,MATH 18,A01,083743,Cinel; Cameron Alexander,7,0,30,23
1657351530345,MATH 18,A02,083744,Cinel; Cameron Alexander,17,0,30,13
1657351530345,MATH 18,A03,083745,Cinel; Cameron Alexander,9,0,30,21
1657351530345,MATH 18,B01,083748,Rideout; David Porter,5,0,37,32
1657351530345,MATH 18,B02,083749,Rideout; David Porter,5,0,36,31
1657351530345,MATH 18,B03,083750,Rideout; David Porter,3,0,37,34
1657351530345,MATH 18,B04,083751,Rideout; David Porter,6,0,36,30
1657351530345,MATH 18,B05,093473,Rideout; David Porter,6,0,36,30
1657351530345,MATH 18,B06,093474,Rideout; David Porter,6,0,36,30
1657351536369,MATH 20A,A01,083754,Zheng; Zequn,14,0,40,26
1657351542393,MATH 20B,A01,083756,Briones; Jor-el Thomas Caparas,4,0,36,32
1657351542393,MATH 20B,A02,083757,Briones; Jor-el Thomas Caparas,1,0,36,35
1657351542393,MATH 20B,A03,093475,Briones; Jor-el Thomas Caparas,2,0,36,34
1657351548423,MATH 20C,A01,083760,Briones; Jor-el Thomas Caparas,1,0,35,34
1657351548423,MATH 20C,A02,083761,Briones; Jor-el Thomas Caparas,8,0,35,27
1657351548423,MATH 20C,A03,093476,Briones; Jor-el Thomas Caparas,0,1,36,36
1657351548423,MATH 20C,B01,083762,Bach; Quang Tran,1,0,30,29
1657351554451,MATH 20D,A01,083765,Tran; Brian Kha,5,0,30,25
1657351554451,MATH 20D,A02,083766,Tran; Brian Kha,5,0,30,25
1657351554451,MATH 20D,A03,083767,Tran; Brian Kha,5,0,30,25
1657351560477,MATH 20E,A01,083771,Ganguly; Soumya,9,0,32,23
1657351560477,MATH 20E,A02,083772,Ganguly; Soumya,6,0,32,26
1657351560477,MATH 20E,B01,083773,Ciotti; Benjamin,20,0,35,15
1657351560477,MATH 20E,B02,083774,Ciotti; Benjamin,17,0,35,18
1657351566506,MATH 103A,A01,083777,Greenfeld; Be'Eri,3,0,36,33
1657351566506,MATH 103A,A02,083778,Greenfeld; Be'Eri,5,0,36,31
1657351566506,MATH 103A,A03,093561,Greenfeld; Be'Eri,5,0,36,31
1657351566506,MATH 103A,B01,083779,Greenfeld; Be'Eri,7,0,36,29
1657351566506,MATH 103A,B02,083780,Greenfeld; Be'Eri,4,0,36,32
1657351566506,MATH 103A,B03,093562,Greenfeld; Be'Eri,3,0,36,33
1657351572530,MATH 105,A01,085443,Carter; Anne Toulson,15,0,35,20
1657351572530,MATH 105,A02,093477,Carter; Anne Toulson,20,0,35,15
1657351578560,MATH 109,A01,083213,Ganzberger; Geoffrey Michael,2,0,34,32
1657351578560,MATH 109,A02,083214,Ganzberger; Geoffrey Michael,4,0,34,30
1657351578560,MATH 109,A03,093478,Ganzberger; Geoffrey Michael,2,0,34,32
1657351578560,MATH 109,B01,083215,Ganzberger; Geoffrey Michael,1,0,32,31
1657351578560,MATH 109,B02,083216,Ganzberger; Geoffrey Michael,2,0,32,30
1657351578560,MATH 109,B03,093479,Ganzberger; Geoffrey Michael,8,0,32,24
1657351584584,MATH 142A,A01,083219,Chow; Bennett,7,0,32,25
1657351584584,MATH 142A,A02,083220,Chow; Bennett,10,0,32,22
1657351584584,MATH 142A,A03,093480,Chow; Bennett,8,0,32,24
1657351584584,MATH 142A,B03,093481,Chow; Bennett,8,0,32,24
1657351584584,MATH 142A,B04,093558,Chow; Bennett,13,0,32,19
1657351584584,MATH 142A,B05,093559,Chow; Bennett,6,0,32,26
1657351590616,MATH 193A,A01,083224,Rotar; Vladimir,8,0,34,26
1657351590616,MATH 193A,A02,083225,Rotar; Vladimir,9,0,34,25
1657351590616,MATH 193A,A03,083781,Rotar; Vladimir,5,0,34,29
1657351590616,MATH 193A,A04,083782,Rotar; Vladimir,10,0,34,24
1657351590616,MATH 193A,A05,093482,Rotar; Vladimir,10,0,34,24
1657351596640,MATH 197,001,091859,McAuley; Julian John,9999,0,9999,0
1657351596640,MATH 197,002,095566,Kedlaya; Kiran S.,9997,0,9999,2
1657351596640,MATH 197,003,095567,Xiao; Ming,9999,0,9999,0
1657351596640,MATH 197,004,095571,Perols; Johan Lars,9998,0,9999,1
1657351603729,COGS 9,A01,083615,Shannon; Kyle Michael,8,0,75,67
1657351609755,COGS 11,A01,083617,Boyle; Mary E. T.,22,0,48,26
1657351615782,COGS 13,A01,083071,Bastos; Amalia Pinkusfeld,11,0,71,60
1657351621806,COGS 14A,A01,092681,Semenuks; Arturs,4,1,100,96
1657351627828,COGS 14B,A01,083073,Cheng; Tzu-Han,6,0,63,57
1657351633855,COGS 17,A01,092677,Semenuks; Arturs,6,0,81,75
1657351639885,COGS 100,A01,083619,Allen; Michael Gordon,17,0,70,53
1657351645910,COGS 101A,A01,083621,Davis; Joshua Daniel,9,0,68,59
1657351651939,COGS 101B,A01,091572,Allen; Michael Gordon,11,0,65,54
1657351657963,COGS 101C,A01,083625,Delgado; Tania,17,0,35,18
1657351663985,COGS 107A,A01,083627,Boyle; Mary E. T.,13,0,60,47
1657351670009,COGS 118A,A01,083075,Gupta; Anjum,20,0,76,56
1657351676038,CSE 3,A50,083646,Miranda; Gregory Joseph,24,0,50,26
1657351682061,CSE 8A,A50,083650,Miranda; Gregory Joseph,17,1,56,39
1657351688084,CSE 11,A01,083080,Cao; Yingjun,6,15,40,34
1657351694109,CSE 12,A01,083652,Krause-Levy; Sophia Louisa,28,1,120,92
1657351700134,CSE 15L,A01,083654,Morris; Justin Loren,9,0,50,41
1657351700134,CSE 15L,A02,083655,Morris; Justin Loren,9,0,50,41
1657351706155,CSE 20,A01,083657,Tran; Khoa Dang,39,0,80,41
1657351712179,CSE 21,A01,095574,Bach; Quang Tran,22,0,48,26
1657351718206,CSE 30,A01,083084,Eldon; John,4,0,80,76
1657351718206,CSE 30,B01,095061,Bhaskar; Nishant,9,0,50,41
1657351724234,CSE 100,A01,083659,Cao; Yingjun,5,4,70,65
1657351730258,CSE 134B,A01,083661,Powell; Thomas Allan,22,0,100,78
1657351736287,CSE 140,A01,083663,Gungor; Onat,14,0,85,71
1657351742316,CSE 140L,A01,083088,Eldon; John,21,0,100,79
1657351748337,CSE 175,A01,083665,Kumar; Rakesh,3,0,25,22
1657351754359,CSE 190,A00,092507,Dubnov; Shlomo,7,0,20,13
1657351760381,ECE 45,A01,083139,Congero; Spencer William,6,0,75,69
1657351766406,ECE 65,A50,083695,Saad; Andrew S,12,0,30,18
1657351766406,ECE 65,A51,095125,Saad; Andrew S,24,0,26,2
1657351772430,ECE 109,A01,091882,Touri; Behrouz,19,0,70,51
1657351778453,ECE 180,A00,083140,Abi Samra; Nicholas Camill,1,0,30,29
1657351778453,ECE 180,B00,083141,Abi Samra; Nicholas Camill,0,0,30,30
1657351784478,MATH 10A,A01,083735,Patchell; Gregory David,2,0,30,28
1657351784478,MATH 10A,A02,083736,Patchell; Gregory David,20,0,30,10
1657351784478,MATH 10A,A03,083737,Patchell; Gregory David,16,0,30,14
1657351790508,MATH 10B,A01,083207,Lim; Seonhee,8,0,34,26
1657351790508,MATH 10B,A02,083208,Lim; Seonhee,9,0,35,26
1657351790508,MATH 10B,A03,093472,Lim; Seonhee,7,0,34,27
1657351790508,MATH 10B,B01,083739,Sinha; Shubham,12,0,30,18
1657351796532,MATH 18,A01,083743,Cinel; Cameron Alexander,7,0,30,23
1657351796532,MATH 18,A02,083744,Cinel; Cameron Alexander,17,0,30,13
1657351796532,MATH 18,A03,083745,Cinel; Cameron Alexander,9,0,30,21
1657351796532,MATH 18,B01,083748,Rideout; David Porter,5,0,37,32
1657351796532,MATH 18,B02,083749,Rideout; David Porter,5,0,36,31
1657351796532,MATH 18,B03,083750,Rideout; David Porter,3,0,37,34
1657351796532,MATH 18,B04,083751,Rideout; David Porter,6,0,36,30
1657351796532,MATH 18,B05,093473,Rideout; David Porter,6,0,36,30
1657351796532,MATH 18,B06,093474,Rideout; David Porter,6,0,36,30
1657351802647,MATH 20A,A01,083754,Zheng; Zequn,14,0,40,26
1657351808670,MATH 20B,A01,083756,Briones; Jor-el Thomas Caparas,4,0,36,32
1657351808670,MATH 20B,A02,083757,Briones; Jor-el Thomas Caparas,1,0,36,35
1657351808670,MATH 20B,A03,093475,Briones; Jor-el Thomas Caparas,2,0,36,34
1657351814694,MATH 20C,A01,083760,Briones; Jor-el Thomas Caparas,1,0,35,34
1657351814694,MATH 20C,A02,083761,Briones; Jor-el Thomas Caparas,8,0,35,27
1657351814694,MATH 20C,A03,093476,Briones; Jor-el Thomas Caparas,0,1,36,36
1657351814694,MATH 20C,B01,083762,Bach; Quang Tran,1,0,30,29
1657351820724,MATH 20D,A01,083765,Tran; Brian Kha,5,0,30,25
1657351820724,MATH 20D,A02,083766,Tran; Brian Kha,5,0,30,25
1657351820724,MATH 20D,A03,083767,Tran; Brian Kha,5,0,30,25
1657351826752,MATH 20E,A01,083771,Ganguly; Soumya,9,0,32,23
1657351826752,MATH 20E,A02,083772,Ganguly; Soumya,6,0,32,26
1657351826752,MATH 20E,B01,083773,Ciotti; Benjamin,20,0,35,15
1657351826752,MATH 20E,B02,083774,Ciotti; Benjamin,17,0,35,18
1657351832776,MATH 103A,A01,083777,Greenfeld; Be'Eri,3,0,36,33
1657351832776,MATH 103A,A02,083778,Greenfeld; Be'Eri,5,0,36,31
1657351832776,MATH 103A,A03,093561,Greenfeld; Be'Eri,5,0,36,31
1657351832776,MATH 103A,B01,083779,Greenfeld; Be'Eri,7,0,36,29
1657351832776,MATH 103A,B02,083780,Greenfeld; Be'Eri,4,0,36,32
1657351832776,MATH 103A,B03,093562,Greenfeld; Be'Eri,3,0,36,33
1657351838818,MATH 105,A01,085443,Carter; Anne Toulson,15,0,35,20
1657351838818,MATH 105,A02,093477,Carter; Anne Toulson,20,0,35,15
1657351844845,MATH 109,A01,083213,Ganzberger; Geoffrey Michael,2,0,34,32
1657351844845,MATH 109,A02,083214,Ganzberger; Geoffrey Michael,4,0,34,30
1657351844845,MATH 109,A03,093478,Ganzberger; Geoffrey Michael,2,0,34,32
1657351844845,MATH 109,B01,083215,Ganzberger; Geoffrey Michael,1,0,32,31
1657351844845,MATH 109,B02,083216,Ganzberger; Geoffrey Michael,2,0,32,30
1657351844845,MATH 109,B03,093479,Ganzberger; Geoffrey Michael,8,0,32,24
1657351850889,MATH 142A,A01,083219,Chow; Bennett,7,0,32,25
1657351850889,MATH 142A,A02,083220,Chow; Bennett,10,0,32,22
1657351850889,MATH 142A,A03,093480,Chow; Bennett,8,0,32,24
1657351850889,MATH 142A,B03,093481,Chow; Bennett,8,0,32,24
1657351850889,MATH 142A,B04,093558,Chow; Bennett,13,0,32,19
1657351850889,MATH 142A,B05,093559,Chow; Bennett,6,0,32,26
1657351856912,MATH 193A,A01,083224,Rotar; Vladimir,8,0,34,26
1657351856912,MATH 193A,A02,083225,Rotar; Vladimir,9,0,34,25
1657351856912,MATH 193A,A03,083781,Rotar; Vladimir,5,0,34,29
1657351856912,MATH 193A,A04,083782,Rotar; Vladimir,10,0,34,24
1657351856912,MATH 193A,A05,093482,Rotar; Vladimir,10,0,34,24
1657351862941,MATH 197,001,091859,McAuley; Julian John,9999,0,9999,0
1657351862941,MATH 197,002,095566,Kedlaya; Kiran S.,9997,0,9999,2
1657351862941,MATH 197,003,095567,Xiao; Ming,9999,0,9999,0
1657351862941,MATH 197,004,095571,Perols; Johan Lars,9998,0,9999,1
1657351870015,COGS 9,A01,083615,Shannon; Kyle Michael,8,0,75,67
1657351876040,COGS 11,A01,083617,Boyle; Mary E. T.,22,0,48,26
1657351882065,COGS 13,A01,083071,Bastos; Amalia Pinkusfeld,11,0,71,60
1657351888089,COGS 14A,A01,092681,Semenuks; Arturs,4,1,100,96
1657351894115,COGS 14B,A01,083073,Cheng; Tzu-Han,6,0,63,57
1657351900138,COGS 17,A01,092677,Semenuks; Arturs,6,0,81,75
1657351906165,COGS 100,A01,083619,Allen; Michael Gordon,17,0,70,53
1657351912202,COGS 101A,A01,083621,Davis; Joshua Daniel,9,0,68,59
1657351918226,COGS 101B,A01,091572,Allen; Michael Gordon,11,0,65,54
1657351924249,COGS 101C,A01,083625,Delgado; Tania,17,0,35,18
1657351930274,COGS 107A,A01,083627,Boyle; Mary E. T.,13,0,60,47
1657351936299,COGS 118A,A01,083075,Gupta; Anjum,20,0,76,56
1657351942326,CSE 3,A50,083646,Miranda; Gregory Joseph,24,0,50,26
1657351948353,CSE 8A,A50,083650,Miranda; Gregory Joseph,17,1,56,39
1657351954385,CSE 11,A01,083080,Cao; Yingjun,6,15,40,34
1657351960409,CSE 12,A01,083652,Krause-Levy; Sophia Louisa,28,1,120,92
1657351966436,CSE 15L,A01,083654,Morris; Justin Loren,9,0,50,41
1657351966436,CSE 15L,A02,083655,Morris; Justin Loren,9,0,50,41
1657351972461,CSE 20,A01,083657,Tran; Khoa Dang,39,0,80,41
1657351978487,CSE 21,A01,095574,Bach; Quang Tran,22,0,48,26
1657351984513,CSE 30,A01,083084,Eldon; John,4,0,80,76
1657351984513,CSE 30,B01,095061,Bhaskar; Nishant,9,0,50,41
1657351990538,CSE 100,A01,083659,Cao; Yingjun,5,4,70,65
1657351996568,CSE 134B,A01,083661,Powell; Thomas Allan,22,0,100,78
1657352002593,CSE 140,A01,083663,Gungor; Onat,14,0,85,71
1657352008622,CSE 140L,A01,083088,Eldon; John,21,0,100,79
1657352014652,CSE 175,A01,083665,Kumar; Rakesh,3,0,25,22
1657352020676,CSE 190,A00,092507,Dubnov; Shlomo,7,0,20,13
1657352026700,ECE 45,A01,083139,Congero; Spencer William,6,0,75,69
1657352032726,ECE 65,A50,083695,Saad; Andrew S,12,0,30,18
1657352032726,ECE 65,A51,095125,Saad; Andrew S,24,0,26,2
1657352038754,ECE 109,A01,091882,Touri; Behrouz,19,0,70,51
1657352044777,ECE 180,A00,083140,Abi Samra; Nicholas Camill,1,0,30,29
1657352044777,ECE 180,B00,083141,Abi Samra; Nicholas Camill,0,0,30,30
1657352050814,MATH 10A,A01,083735,Patchell; Gregory David,2,0,30,28
1657352050814,MATH 10A,A02,083736,Patchell; Gregory David,20,0,30,10
1657352050814,MATH 10A,A03,083737,Patchell; Gregory David,16,0,30,14
1657352056841,MATH 10B,A01,083207,Lim; Seonhee,8,0,34,26
1657352056841,MATH 10B,A02,083208,Lim; Seonhee,9,0,35,26
1657352056841,MATH 10B,A03,093472,Lim; Seonhee,7,0,34,27
1657352056841,MATH 10B,B01,083739,Sinha; Shubham,12,0,30,18
1657352062871,MATH 18,A01,083743,Cinel; Cameron Alexander,7,0,30,23
1657352062871,MATH 18,A02,083744,Cinel; Cameron Alexander,17,0,30,13
1657352062871,MATH 18,A03,083745,Cinel; Cameron Alexander,9,0,30,21
1657352062871,MATH 18,B01,083748,Rideout; David Porter,5,0,37,32
1657352062871,MATH 18,B02,083749,Rideout; David Porter,5,0,36,31
1657352062871,MATH 18,B03,083750,Rideout; David Porter,3,0,37,34
1657352062871,MATH 18,B04,083751,Rideout; David Porter,6,0,36,30
1657352062871,MATH 18,B05,093473,Rideout; David Porter,6,0,36,30
1657352062871,MATH 18,B06,093474,Rideout; David Porter,6,0,36,30
1657352068895,MATH 20A,A01,083754,Zheng; Zequn,14,0,40,26
1657352074928,MATH 20B,A01,083756,Briones; Jor-el Thomas Caparas,4,0,36,32
1657352074928,MATH 20B,A02,083757,Briones; Jor-el Thomas Caparas,1,0,36,35
1657352074928,MATH 20B,A03,093475,Briones; Jor-el Thomas Caparas,2,0,36,34
1657352080962,MATH 20C,A01,083760,Briones; Jor-el Thomas Caparas,1,0,35,34
1657352080962,MATH 20C,A02,083761,Briones; Jor-el Thomas Caparas,8,0,35,27
1657352080962,MATH 20C,A03,093476,Briones; Jor-el Thomas Caparas,0,1,36,36
1657352080962,MATH 20C,B01,083762,Bach; Quang Tran,1,0,30,29
1657352086992,MATH 20D,A01,083765,Tran; Brian Kha,5,0,30,25
1657352086992,MATH 20D,A02,083766,Tran; Brian Kha,5,0,30,25
1657352086992,MATH 20D,A03,083767,Tran; Brian Kha,5,0,30,25
1657352093019,MATH 20E,A01,083771,Ganguly; Soumya,9,0,32,23
1657352093019,MATH 20E,A02,083772,Ganguly; Soumya,6,0,32,26
1657352093019,MATH 20E,B01,083773,Ciotti; Benjamin,20,0,35,15
1657352093019,MATH 20E,B02,083774,Ciotti; Benjamin,17,0,35,18
1657352099052,MATH 103A,A01,083777,Greenfeld; Be'Eri,3,0,36,33
1657352099052,MATH 103A,A02,083778,Greenfeld; Be'Eri,5,0,36,31
1657352099052,MATH 103A,A03,093561,Greenfeld; Be'Eri,5,0,36,31
1657352099052,MATH 103A,B01,083779,Greenfeld; Be'Eri,7,0,36,29
1657352099052,MATH 103A,B02,083780,Greenfeld; Be'Eri,4,0,36,32
1657352099052,MATH 103A,B03,093562,Greenfeld; Be'Eri,3,0,36,33
1657352105076,MATH 105,A01,085443,Carter; Anne Toulson,15,0,35,20
1657352105076,MATH 105,A02,093477,Carter; Anne Toulson,20,0,35,15
1657352111102,MATH 109,A01,083213,Ganzberger; Geoffrey Michael,2,0,34,32
1657352111102,MATH 109,A02,083214,Ganzberger; Geoffrey Michael,4,0,34,30
1657352111102,MATH 109,A03,093478,Ganzberger; Geoffrey Michael,2,0,34,32
1657352111102,MATH 109,B01,083215,Ganzberger; Geoffrey Michael,1,0,32,31
1657352111102,MATH 109,B02,083216,Ganzberger; Geoffrey Michael,2,0,32,30
1657352111102,MATH 109,B03,093479,Ganzberger; Geoffrey Michael,8,0,32,24
1657352117129,MATH 142A,A01,083219,Chow; Bennett,7,0,32,25
1657352117129,MATH 142A,A02,083220,Chow; Bennett,10,0,32,22
1657352117129,MATH 142A,A03,093480,Chow; Bennett,8,0,32,24
1657352117129,MATH 142A,B03,093481,Chow; Bennett,8,0,32,24
1657352117129,MATH 142A,B04,093558,Chow; Bennett,13,0,32,19
1657352117129,MATH 142A,B05,093559,Chow; Bennett,6,0,32,26
1657352123159,MATH 193A,A01,083224,Rotar; Vladimir,8,0,34,26
1657352123159,MATH 193A,A02,083225,Rotar; Vladimir,9,0,34,25
1657352123159,MATH 193A,A03,083781,Rotar; Vladimir,5,0,34,29
1657352123159,MATH 193A,A04,083782,Rotar; Vladimir,10,0,34,24
1657352123159,MATH 193A,A05,093482,Rotar; Vladimir,10,0,34,24
1657352129182,MATH 197,001,091859,McAuley; Julian John,9999,0,9999,0
1657352129182,MATH 197,002,095566,Kedlaya; Kiran S.,9997,0,9999,2
1657352129182,MATH 197,003,095567,Xiao; Ming,9999,0,9999,0
1657352129182,MATH 197,004,095571,Perols; Johan Lars,9998,0,9999,1
1657352136267,COGS 9,A01,083615,Shannon; Kyle Michael,8,0,75,67
1657352142297,COGS 11,A01,083617,Boyle; Mary E. T.,22,0,48,26
1657352148326,COGS 13,A01,083071,Bastos; Amalia Pinkusfeld,11,0,71,60
1657352154351,COGS 14A,A01,092681,Semenuks; Arturs,4,1,100,96
1657352160383,COGS 14B,A01,083073,Cheng; Tzu-Han,6,0,63,57
1657352166407,COGS 17,A01,092677,Semenuks; Arturs,6,0,81,75
1657352172437,COGS 100,A01,083619,Allen; Michael Gordon,17,0,70,53
1657352178462,COGS 101A,A01,083621,Davis; Joshua Daniel,9,0,68,59
1657352184485,COGS 101B,A01,091572,Allen; Michael Gordon,11,0,65,54
1657352190509,COGS 101C,A01,083625,Delgado; Tania,17,0,35,18
1657352196532,COGS 107A,A01,083627,Boyle; Mary E. T.,13,0,60,47
1657352202556,COGS 118A,A01,083075,Gupta; Anjum,20,0,76,56
1657352208595,CSE 3,A50,083646,Miranda; Gregory Joseph,24,0,50,26
1657352214619,CSE 8A,A50,083650,Miranda; Gregory Joseph,17,1,56,39
1657352220648,CSE 11,A01,083080,Cao; Yingjun,6,15,40,34
1657352226681,CSE 12,A01,083652,Krause-Levy; Sophia Louisa,28,1,120,92
1657352232713,CSE 15L,A01,083654,Morris; Justin Loren,9,0,50,41
1657352232713,CSE 15L,A02,083655,Morris; Justin Loren,9,0,50,41
1657352238738,CSE 20,A01,083657,Tran; Khoa Dang,39,0,80,41
1657352244777,CSE 21,A01,095574,Bach; Quang Tran,22,0,48,26
1657352250803,CSE 30,A01,083084,Eldon; John,4,0,80,76
1657352250803,CSE 30,B01,095061,Bhaskar; Nishant,9,0,50,41
1657352256827,CSE 100,A01,083659,Cao; Yingjun,5,4,70,65
1657352262853,CSE 134B,A01,083661,Powell; Thomas Allan,22,0,100,78
1657352268881,CSE 140,A01,083663,Gungor; Onat,14,0,85,71
1657352274908,CSE 140L,A01,083088,Eldon; John,21,0,100,79
1657352280938,CSE 175,A01,083665,Kumar; Rakesh,3,0,25,22
1657352286961,CSE 190,A00,092507,Dubnov; Shlomo,7,0,20,13
1657352292994,ECE 45,A01,083139,Congero; Spencer William,6,0,75,69
1657352299027,ECE 65,A50,083695,Saad; Andrew S,12,0,30,18
1657352299027,ECE 65,A51,095125,Saad; Andrew S,24,0,26,2
1657352305051,ECE 109,A01,091882,Touri; Behrouz,19,0,70,51
1657352311075,ECE 180,A00,083140,Abi Samra; Nicholas Camill,1,0,30,29
1657352311075,ECE 180,B00,083141,Abi Samra; Nicholas Camill,0,0,30,30
1657352317113,MATH 10A,A01,083735,Patchell; Gregory David,2,0,30,28
1657352317113,MATH 10A,A02,083736,Patchell; Gregory David,20,0,30,10
1657352317113,MATH 10A,A03,083737,Patchell; Gregory David,16,0,30,14
1657352323155,MATH 10B,A01,083207,Lim; Seonhee,8,0,34,26
1657352323155,MATH 10B,A02,083208,Lim; Seonhee,9,0,35,26
1657352323155,MATH 10B,A03,093472,Lim; Seonhee,7,0,34,27
1657352323155,MATH 10B,B01,083739,Sinha; Shubham,12,0,30,18
1657352329184,MATH 18,A01,083743,Cinel; Cameron Alexander,7,0,30,23
1657352329184,MATH 18,A02,083744,Cinel; Cameron Alexander,17,0,30,13
1657352329184,MATH 18,A03,083745,Cinel; Cameron Alexander,9,0,30,21
1657352329184,MATH 18,B01,083748,Rideout; David Porter,5,0,37,32
1657352329184,MATH 18,B02,083749,Rideout; David Porter,5,0,36,31
1657352329184,MATH 18,B03,083750,Rideout; David Porter,3,0,37,34
1657352329184,MATH 18,B04,083751,Rideout; David Porter,6,0,36,30
1657352329184,MATH 18,B05,093473,Rideout; David Porter,6,0,36,30
1657352329184,MATH 18,B06,093474,Rideout; David Porter,6,0,36,30
1657352335208,MATH 20A,A01,083754,Zheng; Zequn,14,0,40,26
1657352341234,MATH 20B,A01,083756,Briones; Jor-el Thomas Caparas,4,0,36,32
1657352341234,MATH 20B,A02,083757,Briones; Jor-el Thomas Caparas,1,0,36,35
1657352341234,MATH 20B,A03,093475,Briones; Jor-el Thomas Caparas,2,0,36,34
1657352347261,MATH 20C,A01,083760,Briones; Jor-el Thomas Caparas,1,0,35,34
1657352347261,MATH 20C,A02,083761,Briones; Jor-el Thomas Caparas,8,0,35,27
1657352347261,MATH 20C,A03,093476,Briones; Jor-el Thomas Caparas,0,1,36,36
1657352347261,MATH 20C,B01,083762,Bach; Quang Tran,1,0,30,29
1657352353285,MATH 20D,A01,083765,Tran; Brian Kha,5,0,30,25
1657352353285,MATH 20D,A02,083766,Tran; Brian Kha,5,0,30,25
1657352353285,MATH 20D,A03,083767,Tran; Brian Kha,5,0,30,25
1657352359316,MATH 20E,A01,083771,Ganguly; Soumya,9,0,32,23
1657352359316,MATH 20E,A02,083772,Ganguly; Soumya,6,0,32,26
1657352359316,MATH 20E,B01,083773,Ciotti; Benjamin,20,0,35,15
1657352359316,MATH 20E,B02,083774,Ciotti; Benjamin,17,0,35,18
1657352365344,MATH 103A,A01,083777,Greenfeld; Be'Eri,3,0,36,33
1657352365344,MATH 103A,A02,083778,Greenfeld; Be'Eri,5,0,36,31
1657352365344,MATH 103A,A03,093561,Greenfeld; Be'Eri,5,0,36,31
1657352365344,MATH 103A,B01,083779,Greenfeld; Be'Eri,7,0,36,29
1657352365344,MATH 103A,B02,083780,Greenfeld; Be'Eri,4,0,36,32
1657352365344,MATH 103A,B03,093562,Greenfeld; Be'Eri,3,0,36,33
1657352371373,MATH 105,A01,085443,Carter; Anne Toulson,15,0,35,20
1657352371373,MATH 105,A02,093477,Carter; Anne Toulson,20,0,35,15
1657352377405,MATH 109,A01,083213,Ganzberger; Geoffrey Michael,2,0,34,32
1657352377405,MATH 109,A02,083214,Ganzberger; Geoffrey Michael,4,0,34,30
1657352377405,MATH 109,A03,093478,Ganzberger; Geoffrey Michael,2,0,34,32
1657352377405,MATH 109,B01,083215,Ganzberger; Geoffrey Michael,1,0,32,31
1657352377405,MATH 109,B02,083216,Ganzberger; Geoffrey Michael,2,0,32,30
1657352377405,MATH 109,B03,093479,Ganzberger; Geoffrey Michael,8,0,32,24
1657352383432,MATH 142A,A01,083219,Chow; Bennett,7,0,32,25
1657352383432,MATH 142A,A02,083220,Chow; Bennett,10,0,32,22
1657352383432,MATH 142A,A03,093480,Chow; Bennett,8,0,32,24
1657352383432,MATH 142A,B03,093481,Chow; Bennett,8,0,32,24
1657352383432,MATH 142A,B04,093558,Chow; Bennett,13,0,32,19
1657352383432,MATH 142A,B05,093559,Chow; Bennett,6,0,32,26
1657352389456,MATH 193A,A01,083224,Rotar; Vladimir,8,0,34,26
1657352389456,MATH 193A,A02,083225,Rotar; Vladimir,9,0,34,25
1657352389456,MATH 193A,A03,083781,Rotar; Vladimir,5,0,34,29
1657352389456,MATH 193A,A04,083782,Rotar; Vladimir,10,0,34,24
1657352389456,MATH 193A,A05,093482,Rotar; Vladimir,10,0,34,24
1657352395486,MATH 197,001,091859,McAuley; Julian John,9999,0,9999,0
1657352395486,MATH 197,002,095566,Kedlaya; Kiran S.,9997,0,9999,2
1657352395486,MATH 197,003,095567,Xiao; Ming,9999,0,9999,0
1657352395486,MATH 197,004,095571,Perols; Johan Lars,9998,0,9999,1
1657352402633,COGS 9,A01,083615,Shannon; Kyle Michael,8,0,75,67
1657352408663,COGS 11,A01,083617,Boyle; Mary E. T.,22,0,48,26
1657352414694,COGS 13,A01,083071,Bastos; Amalia Pinkusfeld,11,0,71,60
1657352420719,COGS 14A,A01,092681,Semenuks; Arturs,4,1,100,96
1657352426744,COGS 14B,A01,083073,Cheng; Tzu-Han,6,0,63,57
1657352432771,COGS 17,A01,092677,Semenuks; Arturs,6,0,81,75
1657352438795,COGS 100,A01,083619,Allen; Michael Gordon,17,0,70,53
1657352444825,COGS 101A,A01,083621,Davis; Joshua Daniel,9,0,68,59
1657352450856,COGS 101B,A01,091572,Allen; Michael Gordon,11,0,65,54
1657352456882,COGS 101C,A01,083625,Delgado; Tania,17,0,35,18
1657352462907,COGS 107A,A01,083627,Boyle; Mary E. T.,13,0,60,47
1657352468942,COGS 118A,A01,083075,Gupta; Anjum,20,0,76,56
1657352474967,CSE 3,A50,083646,Miranda; Gregory Joseph,24,0,50,26
1657352480999,CSE 8A,A50,083650,Miranda; Gregory Joseph,17,1,56,39
1657352487025,CSE 11,A01,083080,Cao; Yingjun,6,15,40,34
1657352493052,CSE 12,A01,083652,Krause-Levy; Sophia Louisa,28,1,120,92
1657352499078,CSE 15L,A01,083654,Morris; Justin Loren,9,0,50,41
1657352499078,CSE 15L,A02,083655,Morris; Justin Loren,9,0,50,41
1657352505110,CSE 20,A01,083657,Tran; Khoa Dang,39,0,80,41
1657352511138,CSE 21,A01,095574,Bach; Quang Tran,22,0,48,26
1657352517167,CSE 30,A01,083084,Eldon; John,4,0,80,76
1657352517167,CSE 30,B01,095061,Bhaskar; Nishant,9,0,50,41
1657352523190,CSE 100,A01,083659,Cao; Yingjun,5,4,70,65
1657352529216,CSE 134B,A01,083661,Powell; Thomas Allan,22,0,100,78
1657352535241,CSE 140,A01,083663,Gungor; Onat,14,0,85,71
1657352541266,CSE 140L,A01,083088,Eldon; John,21,0,100,79
1657352547291,CSE 175,A01,083665,Kumar; Rakesh,3,0,25,22
1657352553320,CSE 190,A00,092507,Dubnov; Shlomo,7,0,20,13
1657352559345,ECE 45,A01,083139,Congero; Spencer William,6,0,75,69
1657352565370,ECE 65,A50,083695,Saad; Andrew S,12,0,30,18
1657352565370,ECE 65,A51,095125,Saad; Andrew S,24,0,26,2
1657352571399,ECE 109,A01,091882,Touri; Behrouz,19,0,70,51
1657352577423,ECE 180,A00,083140,Abi Samra; Nicholas Camill,1,0,30,29
1657352577423,ECE 180,B00,083141,Abi Samra; Nicholas Camill,0,0,30,30
1657352583449,MATH 10A,A01,083735,Patchell; Gregory David,2,0,30,28
1657352583449,MATH 10A,A02,083736,Patchell; Gregory David,20,0,30,10
1657352583449,MATH 10A,A03,083737,Patchell; Gregory David,16,0,30,14
1657352589477,MATH 10B,A01,083207,Lim; Seonhee,8,0,34,26
1657352589477,MATH 10B,A02,083208,Lim; Seonhee,9,0,35,26
1657352589477,MATH 10B,A03,093472,Lim; Seonhee,7,0,34,27
1657352589477,MATH 10B,B01,083739,Sinha; Shubham,12,0,30,18
1657352595506,MATH 18,A01,083743,Cinel; Cameron Alexander,7,0,30,23
1657352595506,MATH 18,A02,083744,Cinel; Cameron Alexander,17,0,30,13
1657352595506,MATH 18,A03,083745,Cinel; Cameron Alexander,9,0,30,21
1657352595506,MATH 18,B01,083748,Rideout; David Porter,5,0,37,32
1657352595506,MATH 18,B02,083749,Rideout; David Porter,5,0,36,31
1657352595506,MATH 18,B03,083750,Rideout; David Porter,3,0,37,34
1657352595506,MATH 18,B04,083751,Rideout; David Porter,6,0,36,30
1657352595506,MATH 18,B05,093473,Rideout; David Porter,6,0,36,30
1657352595506,MATH 18,B06,093474,Rideout; David Porter,6,0,36,30
1657352601530,MATH 20A,A01,083754,Zheng; Zequn,14,0,40,26
1657352607566,MATH 20B,A01,083756,Briones; Jor-el Thomas Caparas,4,0,36,32
1657352607566,MATH 20B,A02,083757,Briones; Jor-el Thomas Caparas,1,0,36,35
1657352607566,MATH 20B,A03,093475,Briones; Jor-el Thomas Caparas,2,0,36,34
1657352613601,MATH 20C,A01,083760,Briones; Jor-el Thomas Caparas,1,0,35,34
1657352613601,MATH 20C,A02,083761,Briones; Jor-el Thomas Caparas,8,0,35,27
1657352613601,MATH 20C,A03,093476,Briones; Jor-el Thomas Caparas,0,1,36,36
1657352613601,MATH 20C,B01,083762,Bach; Quang Tran,1,0,30,29
1657352619627,MATH 20D,A01,083765,Tran; Brian Kha,5,0,30,25
1657352619627,MATH 20D,A02,083766,Tran; Brian Kha,5,0,30,25
1657352619627,MATH 20D,A03,083767,Tran; Brian Kha,5,0,30,25
1657352625651,MATH 20E,A01,083771,Ganguly; Soumya,9,0,32,23
1657352625651,MATH 20E,A02,083772,Ganguly; Soumya,6,0,32,26
1657352625651,MATH 20E,B01,083773,Ciotti; Benjamin,20,0,35,15
1657352625651,MATH 20E,B02,083774,Ciotti; Benjamin,17,0,35,18
1657352631679,MATH 103A,A01,083777,Greenfeld; Be'Eri,3,0,36,33
1657352631679,MATH 103A,A02,083778,Greenfeld; Be'Eri,5,0,36,31
1657352631679,MATH 103A,A03,093561,Greenfeld; Be'Eri,5,0,36,31
1657352631679,MATH 103A,B01,083779,Greenfeld; Be'Eri,7,0,36,29
1657352631679,MATH 103A,B02,083780,Greenfeld; Be'Eri,4,0,36,32
1657352631679,MATH 103A,B03,093562,Greenfeld; Be'Eri,3,0,36,33
1657352637714,MATH 105,A01,085443,Carter; Anne Toulson,15,0,35,20
1657352637714,MATH 105,A02,093477,Carter; Anne Toulson,20,0,35,15
1657352643745,MATH 109,A01,083213,Ganzberger; Geoffrey Michael,2,0,34,32
1657352643745,MATH 109,A02,083214,Ganzberger; Geoffrey Michael,4,0,34,30
1657352643745,MATH 109,A03,093478,Ganzberger; Geoffrey Michael,2,0,34,32
1657352643745,MATH 109,B01,083215,Ganzberger; Geoffrey Michael,1,0,32,31
1657352643745,MATH 109,B02,083216,Ganzberger; Geoffrey Michael,2,0,32,30
1657352643745,MATH 109,B03,093479,Ganzberger; Geoffrey Michael,8,0,32,24
1657352649771,MATH 142A,A01,083219,Chow; Bennett,7,0,32,25
1657352649771,MATH 142A,A02,083220,Chow; Bennett,10,0,32,22
1657352649771,MATH 142A,A03,093480,Chow; Bennett,8,0,32,24
1657352649771,MATH 142A,B03,093481,Chow; Bennett,8,0,32,24
1657352649771,MATH 142A,B04,093558,Chow; Bennett,13,0,32,19
1657352649771,MATH 142A,B05,093559,Chow; Bennett,6,0,32,26
1657352655803,MATH 193A,A01,083224,Rotar; Vladimir,8,0,34,26
1657352655803,MATH 193A,A02,083225,Rotar; Vladimir,9,0,34,25
1657352655803,MATH 193A,A03,083781,Rotar; Vladimir,5,0,34,29
1657352655803,MATH 193A,A04,083782,Rotar; Vladimir,10,0,34,24
1657352655803,MATH 193A,A05,093482,Rotar; Vladimir,10,0,34,24
1657352661833,MATH 197,001,091859,McAuley; Julian John,9999,0,9999,0
1657352661833,MATH 197,002,095566,Kedlaya; Kiran S.,9997,0,9999,2
1657352661833,MATH 197,003,095567,Xiao; Ming,9999,0,9999,0
1657352661833,MATH 197,004,095571,Perols; Johan Lars,9998,0,9999,1
1657352668931,COGS 9,A01,083615,Shannon; Kyle Michael,8,0,75,67
1657352674960,COGS 11,A01,083617,Boyle; Mary E. T.,22,0,48,26
1657352680991,COGS 13,A01,083071,Bastos; Amalia Pinkusfeld,11,0,71,60
1657352687021,COGS 14A,A01,092681,Semenuks; Arturs,4,1,100,96
1657352693049,COGS 14B,A01,083073,Cheng; Tzu-Han,6,0,63,57
1657352699076,COGS 17,A01,092677,Semenuks; Arturs,6,0,81,75
1657352705107,COGS 100,A01,083619,Allen; Michael Gordon,17,0,70,53
1657352711134,COGS 101A,A01,083621,Davis; Joshua Daniel,9,0,68,59
1657352717157,COGS 101B,A01,091572,Allen; Michael Gordon,11,0,65,54
1657352723184,COGS 101C,A01,083625,Delgado; Tania,17,0,35,18
1657352729209,COGS 107A,A01,083627,Boyle; Mary E. T.,13,0,60,47
1657352735239,COGS 118A,A01,083075,Gupta; Anjum,20,0,76,56
1657352741266,CSE 3,A50,083646,Miranda; Gregory Joseph,24,0,50,26
1657352747296,CSE 8A,A50,083650,Miranda; Gregory Joseph,17,1,56,39
1657352753322,CSE 11,A01,083080,Cao; Yingjun,6,15,40,34
1657352759347,CSE 12,A01,083652,Krause-Levy; Sophia Louisa,28,1,120,92
1657352765372,CSE 15L,A01,083654,Morris; Justin Loren,9,0,50,41
1657352765372,CSE 15L,A02,083655,Morris; Justin Loren,9,0,50,41
1657352771397,CSE 20,A01,083657,Tran; Khoa Dang,39,0,80,41
1657352777426,CSE 21,A01,095574,Bach; Quang Tran,22,0,48,26
1657352783460,CSE 30,A01,083084,Eldon; John,4,0,80,76
1657352783460,CSE 30,B01,095061,Bhaskar; Nishant,9,0,50,41
1657352789488,CSE 100,A01,083659,Cao; Yingjun,5,4,70,65
1657352795518,CSE 134B,A01,083661,Powell; Thomas Allan,22,0,100,78
1657352801546,CSE 140,A01,083663,Gungor; Onat,14,0,85,71
1657352807574,CSE 140L,A01,083088,Eldon; John,21,0,100,79
1657352813613,CSE 175,A01,083665,Kumar; Rakesh,3,0,25,22
1657352819636,CSE 190,A00,092507,Dubnov; Shlomo,7,0,20,13
1657352825662,ECE 45,A01,083139,Congero; Spencer William,6,0,75,69
1657352831692,ECE 65,A50,083695,Saad; Andrew S,12,0,30,18
1657352831692,ECE 65,A51,095125,Saad; Andrew S,24,0,26,2
1657352837734,ECE 109,A01,091882,Touri; Behrouz,19,0,70,51
1657352843763,ECE 180,A00,083140,Abi Samra; Nicholas Camill,1,0,30,29
1657352843763,ECE 180,B00,083141,Abi Samra; Nicholas Camill,0,0,30,30
1657352849796,MATH 10A,A01,083735,Patchell; Gregory David,2,0,30,28
1657352849796,MATH 10A,A02,083736,Patchell; Gregory David,20,0,30,10
1657352849796,MATH 10A,A03,083737,Patchell; Gregory David,16,0,30,14
1657352855843,MATH 10B,A01,083207,Lim; Seonhee,8,0,34,26
1657352855843,MATH 10B,A02,083208,Lim; Seonhee,9,0,35,26
1657352855843,MATH 10B,A03,093472,Lim; Seonhee,7,0,34,27
1657352855843,MATH 10B,B01,083739,Sinha; Shubham,12,0,30,18
1657352861873,MATH 18,A01,083743,Cinel; Cameron Alexander,7,0,30,23
1657352861873,MATH 18,A02,083744,Cinel; Cameron Alexander,17,0,30,13
1657352861873,MATH 18,A03,083745,Cinel; Cameron Alexander,9,0,30,21
1657352861873,MATH 18,B01,083748,Rideout; David Porter,5,0,37,32
1657352861873,MATH 18,B02,083749,Rideout; David Porter,5,0,36,31
1657352861873,MATH 18,B03,083750,Rideout; David Porter,3,0,37,34
1657352861873,MATH 18,B04,083751,Rideout; David Porter,6,0,36,30
1657352861873,MATH 18,B05,093473,Rideout; David Porter,6,0,36,30
1657352861873,MATH 18,B06,093474,Rideout; David Porter,6,0,36,30
1657352867903,MATH 20A,A01,083754,Zheng; Zequn,14,0,40,26
1657352873935,MATH 20B,A01,083756,Briones; Jor-el Thomas Caparas,4,0,36,32
1657352873935,MATH 20B,A02,083757,Briones; Jor-el Thomas Caparas,1,0,36,35
1657352873935,MATH 20B,A03,093475,Briones; Jor-el Thomas Caparas,2,0,36,34
1657352879962,MATH 20C,A01,083760,Briones; Jor-el Thomas Caparas,1,0,35,34
1657352879962,MATH 20C,A02,083761,Briones; Jor-el Thomas Caparas,8,0,35,27
1657352879962,MATH 20C,A03,093476,Briones; Jor-el Thomas Caparas,0,1,36,36
1657352879962,MATH 20C,B01,083762,Bach; Quang Tran,1,0,30,29
1657352885994,MATH 20D,A01,083765,Tran; Brian Kha,5,0,30,25
1657352885994,MATH 20D,A02,083766,Tran; Brian Kha,5,0,30,25
1657352885994,MATH 20D,A03,083767,Tran; Brian Kha,5,0,30,25
1657352892027,MATH 20E,A01,083771,Ganguly; Soumya,9,0,32,23
1657352892027,MATH 20E,A02,083772,Ganguly; Soumya,6,0,32,26
1657352892027,MATH 20E,B01,083773,Ciotti; Benjamin,20,0,35,15
1657352892027,MATH 20E,B02,083774,Ciotti; Benjamin,17,0,35,18
1657352898057,MATH 103A,A01,083777,Greenfeld; Be'Eri,3,0,36,33
1657352898057,MATH 103A,A02,083778,Greenfeld; Be'Eri,5,0,36,31
1657352898057,MATH 103A,A03,093561,Greenfeld; Be'Eri,5,0,36,31
1657352898057,MATH 103A,B01,083779,Greenfeld; Be'Eri,7,0,36,29
1657352898057,MATH 103A,B02,083780,Greenfeld; Be'Eri,4,0,36,32
1657352898057,MATH 103A,B03,093562,Greenfeld; Be'Eri,3,0,36,33
1657352904091,MATH 105,A01,085443,Carter; Anne Toulson,15,0,35,20
1657352904091,MATH 105,A02,093477,Carter; Anne Toulson,20,0,35,15
1657352910126,MATH 109,A01,083213,Ganzberger; Geoffrey Michael,2,0,34,32
1657352910126,MATH 109,A02,083214,Ganzberger; Geoffrey Michael,4,0,34,30
1657352910126,MATH 109,A03,093478,Ganzberger; Geoffrey Michael,2,0,34,32
1657352910126,MATH 109,B01,083215,Ganzberger; Geoffrey Michael,1,0,32,31
1657352910126,MATH 109,B02,083216,Ganzberger; Geoffrey Michael,2,0,32,30
1657352910126,MATH 109,B03,093479,Ganzberger; Geoffrey Michael,8,0,32,24
1657352916154,MATH 142A,A01,083219,Chow; Bennett,7,0,32,25
1657352916154,MATH 142A,A02,083220,Chow; Bennett,10,0,32,22
1657352916154,MATH 142A,A03,093480,Chow; Bennett,8,0,32,24
1657352916154,MATH 142A,B03,093481,Chow; Bennett,8,0,32,24
1657352916154,MATH 142A,B04,093558,Chow; Bennett,13,0,32,19
1657352916154,MATH 142A,B05,093559,Chow; Bennett,6,0,32,26
1657352922189,MATH 193A,A01,083224,Rotar; Vladimir,8,0,34,26
1657352922189,MATH 193A,A02,083225,Rotar; Vladimir,9,0,34,25
1657352922189,MATH 193A,A03,083781,Rotar; Vladimir,5,0,34,29
1657352922189,MATH 193A,A04,083782,Rotar; Vladimir,10,0,34,24
1657352922189,MATH 193A,A05,093482,Rotar; Vladimir,10,0,34,24
1657352928226,MATH 197,001,091859,McAuley; Julian John,9999,0,9999,0
1657352928226,MATH 197,002,095566,Kedlaya; Kiran S.,9997,0,9999,2
1657352928226,MATH 197,003,095567,Xiao; Ming,9999,0,9999,0
1657352928226,MATH 197,004,095571,Perols; Johan Lars,9998,0,9999,1
1657352935303,COGS 9,A01,083615,Shannon; Kyle Michael,8,0,75,67
1657352941328,COGS 11,A01,083617,Boyle; Mary E. T.,22,0,48,26
1657352947363,COGS 13,A01,083071,Bastos; Amalia Pinkusfeld,11,0,71,60
1657352953390,COGS 14A,A01,092681,Semenuks; Arturs,4,1,100,96
1657352959419,COGS 14B,A01,083073,Cheng; Tzu-Han,6,0,63,57
1657352965449,COGS 17,A01,092677,Semenuks; Arturs,6,0,81,75
1657352971476,COGS 100,A01,083619,Allen; Michael Gordon,17,0,70,53
1657352977506,COGS 101A,A01,083621,Davis; Joshua Daniel,9,0,68,59
1657352983530,COGS 101B,A01,091572,Allen; Michael Gordon,11,0,65,54
1657352989556,COGS 101C,A01,083625,Delgado; Tania,17,0,35,18
1657352995654,COGS 107A,A01,083627,Boyle; Mary E. T.,13,0,60,47
1657353001686,COGS 118A,A01,083075,Gupta; Anjum,20,0,76,56
1657353007713,CSE 3,A50,083646,Miranda; Gregory Joseph,24,0,50,26
1657353013737,CSE 8A,A50,083650,Miranda; Gregory Joseph,17,1,56,39
1657353019775,CSE 11,A01,083080,Cao; Yingjun,6,15,40,34
1657353025818,CSE 12,A01,083652,Krause-Levy; Sophia Louisa,28,1,120,92
1657353031853,CSE 15L,A01,083654,Morris; Justin Loren,9,0,50,41
1657353031853,CSE 15L,A02,083655,Morris; Justin Loren,9,0,50,41
1657353037879,CSE 20,A01,083657,Tran; Khoa Dang,39,0,80,41
1657353043903,CSE 21,A01,095574,Bach; Quang Tran,22,0,48,26
1657353049930,CSE 30,A01,083084,Eldon; John,4,0,80,76
1657353049930,CSE 30,B01,095061,Bhaskar; Nishant,9,0,50,41
1657353055962,CSE 100,A01,083659,Cao; Yingjun,5,4,70,65
1657353061994,CSE 134B,A01,083661,Powell; Thomas Allan,22,0,100,78
1657353068019,CSE 140,A01,083663,Gungor; Onat,14,0,85,71
1657353074047,CSE 140L,A01,083088,Eldon; John,21,0,100,79
1657353080074,CSE 175,A01,083665,Kumar; Rakesh,3,0,25,22
1657353086103,CSE 190,A00,092507,Dubnov; Shlomo,7,0,20,13
1657353092135,ECE 45,A01,083139,Congero; Spencer William,6,0,75,69
1657353098169,ECE 65,A50,083695,Saad; Andrew S,12,0,30,18
1657353098169,ECE 65,A51,095125,Saad; Andrew S,24,0,26,2
1657353104194,ECE 109,A01,091882,Touri; Behrouz,19,0,70,51
1657353110223,ECE 180,A00,083140,Abi Samra; Nicholas Camill,1,0,30,29
1657353110223,ECE 180,B00,083141,Abi Samra; Nicholas Camill,0,0,30,30
1657353116250,MATH 10A,A01,083735,Patchell; Gregory David,2,0,30,28
1657353116250,MATH 10A,A02,083736,Patchell; Gregory David,20,0,30,10
1657353116250,MATH 10A,A03,083737,Patchell; Gregory David,16,0,30,14
1657353122285,MATH 10B,A01,083207,Lim; Seonhee,8,0,34,26
1657353122285,MATH 10B,A02,083208,Lim; Seonhee,9,0,35,26
1657353122285,MATH 10B,A03,093472,Lim; Seonhee,7,0,34,27
1657353122285,MATH 10B,B01,083739,Sinha; Shubham,12,0,30,18
1657353128312,MATH 18,A01,083743,Cinel; Cameron Alexander,7,0,30,23
1657353128312,MATH 18,A02,083744,Cinel; Cameron Alexander,17,0,30,13
1657353128312,MATH 18,A03,083745,Cinel; Cameron Alexander,9,0,30,21
1657353128312,MATH 18,B01,083748,Rideout; David Porter,5,0,37,32
1657353128312,MATH 18,B02,083749,Rideout; David Porter,5,0,36,31
1657353128312,MATH 18,B03,083750,Rideout; David Porter,3,0,37,34
1657353128312,MATH 18,B04,083751,Rideout; David Porter,6,0,36,30
1657353128312,MATH 18,B05,093473,Rideout; David Porter,6,0,36,30
1657353128312,MATH 18,B06,093474,Rideout; David Porter,6,0,36,30
1657353134342,MATH 20A,A01,083754,Zheng; Zequn,14,0,40,26
1657353140367,MATH 20B,A01,083756,Briones; Jor-el Thomas Caparas,4,0,36,32
1657353140367,MATH 20B,A02,083757,Briones; Jor-el Thomas Caparas,1,0,36,35
1657353140367,MATH 20B,A03,093475,Briones; Jor-el Thomas Caparas,2,0,36,34
1657353146393,MATH 20C,A01,083760,Briones; Jor-el Thomas Caparas,1,0,35,34
1657353146393,MATH 20C,A02,083761,Briones; Jor-el Thomas Caparas,8,0,35,27
1657353146393,MATH 20C,A03,093476,Briones; Jor-el Thomas Caparas,0,1,36,36
1657353146393,MATH 20C,B01,083762,Bach; Quang Tran,1,0,30,29
1657353152426,MATH 20D,A01,083765,Tran; Brian Kha,5,0,30,25
1657353152426,MATH 20D,A02,083766,Tran; Brian Kha,5,0,30,25
1657353152426,MATH 20D,A03,083767,Tran; Brian Kha,5,0,30,25
1657353158462,MATH 20E,A01,083771,Ganguly; Soumya,9,0,32,23
1657353158462,MATH 20E,A02,083772,Ganguly; Soumya,6,0,32,26
1657353158462,MATH 20E,B01,083773,Ciotti; Benjamin,20,0,35,15
1657353158462,MATH 20E,B02,083774,Ciotti; Benjamin,17,0,35,18
1657353164498,MATH 103A,A01,083777,Greenfeld; Be'Eri,3,0,36,33
1657353164498,MATH 103A,A02,083778,Greenfeld; Be'Eri,5,0,36,31
1657353164498,MATH 103A,A03,093561,Greenfeld; Be'Eri,5,0,36,31
1657353164498,MATH 103A,B01,083779,Greenfeld; Be'Eri,7,0,36,29
1657353164498,MATH 103A,B02,083780,Greenfeld; Be'Eri,4,0,36,32
1657353164498,MATH 103A,B03,093562,Greenfeld; Be'Eri,3,0,36,33
1657353170524,MATH 105,A01,085443,Carter; Anne Toulson,15,0,35,20
1657353170524,MATH 105,A02,093477,Carter; Anne Toulson,20,0,35,15
1657353176548,MATH 109,A01,083213,Ganzberger; Geoffrey Michael,2,0,34,32
1657353176548,MATH 109,A02,083214,Ganzberger; Geoffrey Michael,4,0,34,30
1657353176548,MATH 109,A03,093478,Ganzberger; Geoffrey Michael,2,0,34,32
1657353176548,MATH 109,B01,083215,Ganzberger; Geoffrey Michael,1,0,32,31
1657353176548,MATH 109,B02,083216,Ganzberger; Geoffrey Michael,2,0,32,30
1657353176548,MATH 109,B03,093479,Ganzberger; Geoffrey Michael,8,0,32,24
1657353182573,MATH 142A,A01,083219,Chow; Bennett,7,0,32,25
1657353182573,MATH 142A,A02,083220,Chow; Bennett,10,0,32,22
1657353182573,MATH 142A,A03,093480,Chow; Bennett,8,0,32,24
1657353182573,MATH 142A,B03,093481,Chow; Bennett,8,0,32,24
1657353182573,MATH 142A,B04,093558,Chow; Bennett,13,0,32,19
1657353182573,MATH 142A,B05,093559,Chow; Bennett,6,0,32,26
1657353188600,MATH 193A,A01,083224,Rotar; Vladimir,8,0,34,26
1657353188600,MATH 193A,A02,083225,Rotar; Vladimir,9,0,34,25
1657353188600,MATH 193A,A03,083781,Rotar; Vladimir,5,0,34,29
1657353188600,MATH 193A,A04,083782,Rotar; Vladimir,10,0,34,24
1657353188600,MATH 193A,A05,093482,Rotar; Vladimir,10,0,34,24
1657353194623,MATH 197,001,091859,McAuley; Julian John,9999,0,9999,0
1657353194623,MATH 197,002,095566,Kedlaya; Kiran S.,9997,0,9999,2
1657353194623,MATH 197,003,095567,Xiao; Ming,9999,0,9999,0
1657353194623,MATH 197,004,095571,Perols; Johan Lars,9998,0,9999,1
1657353201696,COGS 9,A01,083615,Shannon; Kyle Michael,8,0,75,67
1657353207720,COGS 11,A01,083617,Boyle; Mary E. T.,22,0,48,26
1657353213752,COGS 13,A01,083071,Bastos; Amalia Pinkusfeld,11,0,71,60
1657353219776,COGS 14A,A01,092681,Semenuks; Arturs,4,1,100,96
1657353225800,COGS 14B,A01,083073,Cheng; Tzu-Han,6,0,63,57
1657353231826,COGS 17,A01,092677,Semenuks; Arturs,6,0,81,75
1657353237856,COGS 100,A01,083619,Allen; Michael Gordon,17,0,70,53
1657353243880,COGS 101A,A01,083621,Davis; Joshua Daniel,9,0,68,59
1657353249905,COGS 101B,A01,091572,Allen; Michael Gordon,11,0,65,54
1657353255930,COGS 101C,A01,083625,Delgado; Tania,17,0,35,18
1657353261954,COGS 107A,A01,083627,Boyle; Mary E. T.,13,0,60,47
1657353267978,COGS 118A,A01,083075,Gupta; Anjum,20,0,76,56
1657353274009,CSE 3,A50,083646,Miranda; Gregory Joseph,24,0,50,26
1657353280032,CSE 8A,A50,083650,Miranda; Gregory Joseph,17,1,56,39
1657353286056,CSE 11,A01,083080,Cao; Yingjun,6,15,40,34
1657353292082,CSE 12,A01,083652,Krause-Levy; Sophia Louisa,28,1,120,92
1657353298111,CSE 15L,A01,083654,Morris; Justin Loren,9,0,50,41
1657353298111,CSE 15L,A02,083655,Morris; Justin Loren,9,0,50,41
1657353304135,CSE 20,A01,083657,Tran; Khoa Dang,39,0,80,41
1657353310163,CSE 21,A01,095574,Bach; Quang Tran,22,0,48,26
1657353316192,CSE 30,A01,083084,Eldon; John,4,0,80,76
1657353316192,CSE 30,B01,095061,Bhaskar; Nishant,9,0,50,41
1657353322217,CSE 100,A01,083659,Cao; Yingjun,5,4,70,65
1657353328241,CSE 134B,A01,083661,Powell; Thomas Allan,22,0,100,78
1657353334271,CSE 140,A01,083663,Gungor; Onat,14,0,85,71
1657353340294,CSE 140L,A01,083088,Eldon; John,21,0,100,79
1657353346320,CSE 175,A01,083665,Kumar; Rakesh,3,0,25,22
1657353352348,CSE 190,A00,092507,Dubnov; Shlomo,7,0,20,13
1657353358378,ECE 45,A01,083139,Congero; Spencer William,6,0,75,69
1657353364402,ECE 65,A50,083695,Saad; Andrew S,12,0,30,18
1657353364402,ECE 65,A51,095125,Saad; Andrew S,24,0,26,2
1657353370425,ECE 109,A01,091882,Touri; Behrouz,19,0,70,51
1657353376455,ECE 180,A00,083140,Abi Samra; Nicholas Camill,1,0,30,29
1657353376455,ECE 180,B00,083141,Abi Samra; Nicholas Camill,0,0,30,30
1657353382482,MATH 10A,A01,083735,Patchell; Gregory David,2,0,30,28
1657353382482,MATH 10A,A02,083736,Patchell; Gregory David,20,0,30,10
1657353382482,MATH 10A,A03,083737,Patchell; Gregory David,16,0,30,14
1657353388512,MATH 10B,A01,083207,Lim; Seonhee,8,0,34,26
1657353388512,MATH 10B,A02,083208,Lim; Seonhee,9,0,35,26
1657353388512,MATH 10B,A03,093472,Lim; Seonhee,7,0,34,27
1657353388512,MATH 10B,B01,083739,Sinha; Shubham,12,0,30,18
1657353394548,MATH 18,A01,083743,Cinel; Cameron Alexander,7,0,30,23
1657353394548,MATH 18,A02,083744,Cinel; Cameron Alexander,17,0,30,13
1657353394548,MATH 18,A03,083745,Cinel; Cameron Alexander,9,0,30,21
1657353394548,MATH 18,B01,083748,Rideout; David Porter,5,0,37,32
1657353394548,MATH 18,B02,083749,Rideout; David Porter,5,0,36,31
1657353394548,MATH 18,B03,083750,Rideout; David Porter,3,0,37,34
1657353394548,MATH 18,B04,083751,Rideout; David Porter,6,0,36,30
1657353394548,MATH 18,B05,093473,Rideout; David Porter,6,0,36,30
1657353394548,MATH 18,B06,093474,Rideout; David Porter,6,0,36,30
1657353400574,MATH 20A,A01,083754,Zheng; Zequn,14,0,40,26
1657353406598,MATH 20B,A01,083756,Briones; Jor-el Thomas Caparas,4,0,36,32
1657353406598,MATH 20B,A02,083757,Briones; Jor-el Thomas Caparas,1,0,36,35
1657353406598,MATH 20B,A03,093475,Briones; Jor-el Thomas Caparas,2,0,36,34
1657353412624,MATH 20C,A01,083760,Briones; Jor-el Thomas Caparas,1,0,35,34
1657353412624,MATH 20C,A02,083761,Briones; Jor-el Thomas Caparas,8,0,35,27
1657353412624,MATH 20C,A03,093476,Briones; Jor-el Thomas Caparas,0,1,36,36
1657353412624,MATH 20C,B01,083762,Bach; Quang Tran,1,0,30,29
1657353418648,MATH 20D,A01,083765,Tran; Brian Kha,5,0,30,25
1657353418648,MATH 20D,A02,083766,Tran; Brian Kha,5,0,30,25
1657353418648,MATH 20D,A03,083767,Tran; Brian Kha,5,0,30,25
1657353424674,MATH 20E,A01,083771,Ganguly; Soumya,9,0,32,23
1657353424674,MATH 20E,A02,083772,Ganguly; Soumya,6,0,32,26
1657353424674,MATH 20E,B01,083773,Ciotti; Benjamin,20,0,35,15
1657353424674,MATH 20E,B02,083774,Ciotti; Benjamin,17,0,35,18
1657353430698,MATH 103A,A01,083777,Greenfeld; Be'Eri,3,0,36,33
1657353430698,MATH 103A,A02,083778,Greenfeld; Be'Eri,5,0,36,31
1657353430698,MATH 103A,A03,093561,Greenfeld; Be'Eri,5,0,36,31
1657353430698,MATH 103A,B01,083779,Greenfeld; Be'Eri,7,0,36,29
1657353430698,MATH 103A,B02,083780,Greenfeld; Be'Eri,4,0,36,32
1657353430698,MATH 103A,B03,093562,Greenfeld; Be'Eri,3,0,36,33
1657353436722,MATH 105,A01,085443,Carter; Anne Toulson,15,0,35,20
1657353436722,MATH 105,A02,093477,Carter; Anne Toulson,20,0,35,15
1657353442753,MATH 109,A01,083213,Ganzberger; Geoffrey Michael,2,0,34,32
1657353442753,MATH 109,A02,083214,Ganzberger; Geoffrey Michael,4,0,34,30
1657353442753,MATH 109,A03,093478,Ganzberger; Geoffrey Michael,2,0,34,32
1657353442753,MATH 109,B01,083215,Ganzberger; Geoffrey Michael,1,0,32,31
1657353442753,MATH 109,B02,083216,Ganzberger; Geoffrey Michael,2,0,32,30
1657353442753,MATH 109,B03,093479,Ganzberger; Geoffrey Michael,8,0,32,24
1657353448779,MATH 142A,A01,083219,Chow; Bennett,7,0,32,25
1657353448779,MATH 142A,A02,083220,Chow; Bennett,10,0,32,22
1657353448779,MATH 142A,A03,093480,Chow; Bennett,8,0,32,24
1657353448779,MATH 142A,B03,093481,Chow; Bennett,8,0,32,24
1657353448779,MATH 142A,B04,093558,Chow; Bennett,13,0,32,19
1657353448779,MATH 142A,B05,093559,Chow; Bennett,6,0,32,26
1657353454805,MATH 193A,A01,083224,Rotar; Vladimir,8,0,34,26
1657353454805,MATH 193A,A02,083225,Rotar; Vladimir,9,0,34,25
1657353454805,MATH 193A,A03,083781,Rotar; Vladimir,5,0,34,29
1657353454805,MATH 193A,A04,083782,Rotar; Vladimir,10,0,34,24
1657353454805,MATH 193A,A05,093482,Rotar; Vladimir,10,0,34,24
1657353460834,MATH 197,001,091859,McAuley; Julian John,9999,0,9999,0
1657353460834,MATH 197,002,095566,Kedlaya; Kiran S.,9997,0,9999,2
1657353460834,MATH 197,003,095567,Xiao; Ming,9999,0,9999,0
1657353460834,MATH 197,004,095571,Perols; Johan Lars,9998,0,9999,1
1657353467904,COGS 9,A01,083615,Shannon; Kyle Michael,8,0,75,67
1657353473934,COGS 11,A01,083617,Boyle; Mary E. T.,22,0,48,26
1657353479960,COGS 13,A01,083071,Bastos; Amalia Pinkusfeld,11,0,71,60
1657353485984,COGS 14A,A01,092681,Semenuks; Arturs,4,1,100,96
1657353492009,COGS 14B,A01,083073,Cheng; Tzu-Han,6,0,63,57
1657353498040,COGS 17,A01,092677,Semenuks; Arturs,6,0,81,75
1657353504075,COGS 100,A01,083619,Allen; Michael Gordon,17,0,70,53
1657353510098,COGS 101A,A01,083621,Davis; Joshua Daniel,9,0,68,59
1657353516123,COGS 101B,A01,091572,Allen; Michael Gordon,11,0,65,54
1657353522159,COGS 101C,A01,083625,Delgado; Tania,17,0,35,18
1657353528184,COGS 107A,A01,083627,Boyle; Mary E. T.,13,0,60,47
1657353534209,COGS 118A,A01,083075,Gupta; Anjum,20,0,76,56
1657353540235,CSE 3,A50,083646,Miranda; Gregory Joseph,24,0,50,26
1657353546265,CSE 8A,A50,083650,Miranda; Gregory Joseph,17,1,56,39
1657353552289,CSE 11,A01,083080,Cao; Yingjun,6,15,40,34
1657353558313,CSE 12,A01,083652,Krause-Levy; Sophia Louisa,28,1,120,92
1657353564340,CSE 15L,A01,083654,Morris; Justin Loren,9,0,50,41
1657353564340,CSE 15L,A02,083655,Morris; Justin Loren,9,0,50,41
1657353570364,CSE 20,A01,083657,Tran; Khoa Dang,39,0,80,41
1657353576389,CSE 21,A01,095574,Bach; Quang Tran,22,0,48,26
1657353582417,CSE 30,A01,083084,Eldon; John,4,0,80,76
1657353582417,CSE 30,B01,095061,Bhaskar; Nishant,9,0,50,41
1657353588447,CSE 100,A01,083659,Cao; Yingjun,5,4,70,65
1657353594547,CSE 134B,A01,083661,Powell; Thomas Allan,22,0,100,78
1657353600573,CSE 140,A01,083663,Gungor; Onat,14,0,85,71
1657353606602,CSE 140L,A01,083088,Eldon; John,21,0,100,79
1657353612627,CSE 175,A01,083665,Kumar; Rakesh,3,0,25,22
1657353618654,CSE 190,A00,092507,Dubnov; Shlomo,7,0,20,13
1657353624683,ECE 45,A01,083139,Congero; Spencer William,6,0,75,69
1657353630717,ECE 65,A50,083695,Saad; Andrew S,12,0,30,18
1657353630717,ECE 65,A51,095125,Saad; Andrew S,24,0,26,2
1657353636742,ECE 109,A01,091882,Touri; Behrouz,19,0,70,51
1657353642781,ECE 180,A00,083140,Abi Samra; Nicholas Camill,1,0,30,29
1657353642781,ECE 180,B00,083141,Abi Samra; Nicholas Camill,0,0,30,30
1657353648806,MATH 10A,A01,083735,Patchell; Gregory David,2,0,30,28
1657353648806,MATH 10A,A02,083736,Patchell; Gregory David,20,0,30,10
1657353648806,MATH 10A,A03,083737,Patchell; Gregory David,16,0,30,14
1657353654834,MATH 10B,A01,083207,Lim; Seonhee,8,0,34,26
1657353654834,MATH 10B,A02,083208,Lim; Seonhee,9,0,35,26
1657353654834,MATH 10B,A03,093472,Lim; Seonhee,7,0,34,27
1657353654834,MATH 10B,B01,083739,Sinha; Shubham,12,0,30,18
1657353660873,MATH 18,A01,083743,Cinel; Cameron Alexander,7,0,30,23
1657353660873,MATH 18,A02,083744,Cinel; Cameron Alexander,17,0,30,13
1657353660873,MATH 18,A03,083745,Cinel; Cameron Alexander,9,0,30,21
1657353660873,MATH 18,B01,083748,Rideout; David Porter,5,0,37,32
1657353660873,MATH 18,B02,083749,Rideout; David Porter,5,0,36,31
1657353660873,MATH 18,B03,083750,Rideout; David Porter,3,0,37,34
1657353660873,MATH 18,B04,083751,Rideout; David Porter,6,0,36,30
1657353660873,MATH 18,B05,093473,Rideout; David Porter,6,0,36,30
1657353660873,MATH 18,B06,093474,Rideout; David Porter,6,0,36,30
1657353666901,MATH 20A,A01,083754,Zheng; Zequn,14,0,40,26
1657353672931,MATH 20B,A01,083756,Briones; Jor-el Thomas Caparas,4,0,36,32
1657353672931,MATH 20B,A02,083757,Briones; Jor-el Thomas Caparas,1,0,36,35
1657353672931,MATH 20B,A03,093475,Briones; Jor-el Thomas Caparas,2,0,36,34
1657353678957,MATH 20C,A01,083760,Briones; Jor-el Thomas Caparas,1,0,35,34
1657353678957,MATH 20C,A02,083761,Briones; Jor-el Thomas Caparas,8,0,35,27
1657353678957,MATH 20C,A03,093476,Briones; Jor-el Thomas Caparas,0,1,36,36
1657353678957,MATH 20C,B01,083762,Bach; Quang Tran,1,0,30,29
1657353684986,MATH 20D,A01,083765,Tran; Brian Kha,5,0,30,25
1657353684986,MATH 20D,A02,083766,Tran; Brian Kha,5,0,30,25
1657353684986,MATH 20D,A03,083767,Tran; Brian Kha,5,0,30,25
1657353691020,MATH 20E,A01,083771,Ganguly; Soumya,9,0,32,23
1657353691020,MATH 20E,A02,083772,Ganguly; Soumya,6,0,32,26
1657353691020,MATH 20E,B01,083773,Ciotti; Benjamin,20,0,35,15
1657353691020,MATH 20E,B02,083774,Ciotti; Benjamin,17,0,35,18
1657353697056,MATH 103A,A01,083777,Greenfeld; Be'Eri,3,0,36,33
1657353697056,MATH 103A,A02,083778,Greenfeld; Be'Eri,5,0,36,31
1657353697056,MATH 103A,A03,093561,Greenfeld; Be'Eri,5,0,36,31
1657353697056,MATH 103A,B01,083779,Greenfeld; Be'Eri,7,0,36,29
1657353697056,MATH 103A,B02,083780,Greenfeld; Be'Eri,4,0,36,32
1657353697056,MATH 103A,B03,093562,Greenfeld; Be'Eri,3,0,36,33
1657353703086,MATH 105,A01,085443,Carter; Anne Toulson,15,0,35,20
1657353703086,MATH 105,A02,093477,Carter; Anne Toulson,20,0,35,15
1657353709110,MATH 109,A01,083213,Ganzberger; Geoffrey Michael,2,0,34,32
1657353709110,MATH 109,A02,083214,Ganzberger; Geoffrey Michael,4,0,34,30
1657353709110,MATH 109,A03,093478,Ganzberger; Geoffrey Michael,2,0,34,32
1657353709110,MATH 109,B01,083215,Ganzberger; Geoffrey Michael,1,0,32,31
1657353709110,MATH 109,B02,083216,Ganzberger; Geoffrey Michael,2,0,32,30
1657353709110,MATH 109,B03,093479,Ganzberger; Geoffrey Michael,8,0,32,24
1657353715135,MATH 142A,A01,083219,Chow; Bennett,7,0,32,25
1657353715135,MATH 142A,A02,083220,Chow; Bennett,10,0,32,22
1657353715135,MATH 142A,A03,093480,Chow; Bennett,8,0,32,24
1657353715135,MATH 142A,B03,093481,Chow; Bennett,8,0,32,24
1657353715135,MATH 142A,B04,093558,Chow; Bennett,13,0,32,19
1657353715135,MATH 142A,B05,093559,Chow; Bennett,6,0,32,26
1657353721166,MATH 193A,A01,083224,Rotar; Vladimir,8,0,34,26
1657353721166,MATH 193A,A02,083225,Rotar; Vladimir,9,0,34,25
1657353721166,MATH 193A,A03,083781,Rotar; Vladimir,5,0,34,29
1657353721166,MATH 193A,A04,083782,Rotar; Vladimir,10,0,34,24
1657353721166,MATH 193A,A05,093482,Rotar; Vladimir,10,0,34,24
1657353727193,MATH 197,001,091859,McAuley; Julian John,9999,0,9999,0
1657353727193,MATH 197,002,095566,Kedlaya; Kiran S.,9997,0,9999,2
1657353727193,MATH 197,003,095567,Xiao; Ming,9999,0,9999,0
1657353727193,MATH 197,004,095571,Perols; Johan Lars,9998,0,9999,1
1657353734258,COGS 9,A01,083615,Shannon; Kyle Michael,8,0,75,67
1657353740283,COGS 11,A01,083617,Boyle; Mary E. T.,22,0,48,26
1657353746307,COGS 13,A01,083071,Bastos; Amalia Pinkusfeld,11,0,71,60
1657353752337,COGS 14A,A01,092681,Semenuks; Arturs,4,1,100,96
1657353758360,COGS 14B,A01,083073,Cheng; Tzu-Han,6,0,63,57
1657353764386,COGS 17,A01,092677,Semenuks; Arturs,6,0,81,75
1657353770410,COGS 100,A01,083619,Allen; Michael Gordon,17,0,70,53
1657353776433,COGS 101A,A01,083621,Davis; Joshua Daniel,9,0,68,59
1657353782459,COGS 101B,A01,091572,Allen; Michael Gordon,11,0,65,54
1657353788484,COGS 101C,A01,083625,Delgado; Tania,17,0,35,18
1657353794507,COGS 107A,A01,083627,Boyle; Mary E. T.,13,0,60,47
1657353800538,COGS 118A,A01,083075,Gupta; Anjum,20,0,76,56
1657353806569,CSE 3,A50,083646,Miranda; Gregory Joseph,24,0,50,26
1657353812595,CSE 8A,A50,083650,Miranda; Gregory Joseph,17,1,56,39
1657353818623,CSE 11,A01,083080,Cao; Yingjun,6,15,40,34
1657353824645,CSE 12,A01,083652,Krause-Levy; Sophia Louisa,28,1,120,92
1657353830724,CSE 15L,A01,083654,Morris; Justin Loren,9,0,50,41
1657353830724,CSE 15L,A02,083655,Morris; Justin Loren,9,0,50,41
1657353836747,CSE 20,A01,083657,Tran; Khoa Dang,39,0,80,41
1657353842770,CSE 21,A01,095574,Bach; Quang Tran,22,0,48,26
1657353848799,CSE 30,A01,083084,Eldon; John,4,0,80,76
1657353848799,CSE 30,B01,095061,Bhaskar; Nishant,9,0,50,41
1657353854821,CSE 100,A01,083659,Cao; Yingjun,5,4,70,65
1657353860850,CSE 134B,A01,083661,Powell; Thomas Allan,22,0,100,78
1657353866878,CSE 140,A01,083663,Gungor; Onat,14,0,85,71
1657353872904,CSE 140L,A01,083088,Eldon; John,21,0,100,79
1657353878927,CSE 175,A01,083665,Kumar; Rakesh,3,0,25,22
1657353884961,CSE 190,A00,092507,Dubnov; Shlomo,7,0,20,13
1657353890991,ECE 45,A01,083139,Congero; Spencer William,6,0,75,69
1657353897027,ECE 65,A50,083695,Saad; Andrew S,12,0,30,18
1657353897027,ECE 65,A51,095125,Saad; Andrew S,24,0,26,2
1657353903066,ECE 109,A01,091882,Touri; Behrouz,19,0,70,51
1657353909089,ECE 180,A00,083140,Abi Samra; Nicholas Camill,1,0,30,29
1657353909089,ECE 180,B00,083141,Abi Samra; Nicholas Camill,0,0,30,30
1657353915114,MATH 10A,A01,083735,Patchell; Gregory David,2,0,30,28
1657353915114,MATH 10A,A02,083736,Patchell; Gregory David,20,0,30,10
1657353915114,MATH 10A,A03,083737,Patchell; Gregory David,16,0,30,14
1657353921140,MATH 10B,A01,083207,Lim; Seonhee,8,0,34,26
1657353921140,MATH 10B,A02,083208,Lim; Seonhee,9,0,35,26
1657353921140,MATH 10B,A03,093472,Lim; Seonhee,7,0,34,27
1657353921140,MATH 10B,B01,083739,Sinha; Shubham,12,0,30,18
1657353927172,MATH 18,A01,083743,Cinel; Cameron Alexander,7,0,30,23
1657353927172,MATH 18,A02,083744,Cinel; Cameron Alexander,17,0,30,13
1657353927172,MATH 18,A03,083745,Cinel; Cameron Alexander,9,0,30,21
1657353927172,MATH 18,B01,083748,Rideout; David Porter,5,0,37,32
1657353927172,MATH 18,B02,083749,Rideout; David Porter,5,0,36,31
1657353927172,MATH 18,B03,083750,Rideout; David Porter,3,0,37,34
1657353927172,MATH 18,B04,083751,Rideout; David Porter,6,0,36,30
1657353927172,MATH 18,B05,093473,Rideout; David Porter,6,0,36,30
1657353927172,MATH 18,B06,093474,Rideout; David Porter,6,0,36,30
1657353933195,MATH 20A,A01,083754,Zheng; Zequn,14,0,40,26
1657353939245,MATH 20B,A01,083756,Briones; Jor-el Thomas Caparas,4,0,36,32
1657353939245,MATH 20B,A02,083757,Briones; Jor-el Thomas Caparas,1,0,36,35
1657353939245,MATH 20B,A03,093475,Briones; Jor-el Thomas Caparas,2,0,36,34
1657353945272,MATH 20C,A01,083760,Briones; Jor-el Thomas Caparas,1,0,35,34
1657353945272,MATH 20C,A02,083761,Briones; Jor-el Thomas Caparas,8,0,35,27
1657353945272,MATH 20C,A03,093476,Briones; Jor-el Thomas Caparas,0,1,36,36
1657353945272,MATH 20C,B01,083762,Bach; Quang Tran,1,0,30,29
1657353951299,MATH 20D,A01,083765,Tran; Brian Kha,5,0,30,25
1657353951299,MATH 20D,A02,083766,Tran; Brian Kha,5,0,30,25
1657353951299,MATH 20D,A03,083767,Tran; Brian Kha,5,0,30,25
1657353957327,MATH 20E,A01,083771,Ganguly; Soumya,9,0,32,23
1657353957327,MATH 20E,A02,083772,Ganguly; Soumya,6,0,32,26
1657353957327,MATH 20E,B01,083773,Ciotti; Benjamin,20,0,35,15
1657353957327,MATH 20E,B02,083774,Ciotti; Benjamin,17,0,35,18
1657353963357,MATH 103A,A01,083777,Greenfeld; Be'Eri,3,0,36,33
1657353963357,MATH 103A,A02,083778,Greenfeld; Be'Eri,5,0,36,31
1657353963357,MATH 103A,A03,093561,Greenfeld; Be'Eri,5,0,36,31
1657353963357,MATH 103A,B01,083779,Greenfeld; Be'Eri,7,0,36,29
1657353963357,MATH 103A,B02,083780,Greenfeld; Be'Eri,4,0,36,32
1657353963357,MATH 103A,B03,093562,Greenfeld; Be'Eri,3,0,36,33
1657353969386,MATH 105,A01,085443,Carter; Anne Toulson,15,0,35,20
1657353969386,MATH 105,A02,093477,Carter; Anne Toulson,20,0,35,15
1657353975414,MATH 109,A01,083213,Ganzberger; Geoffrey Michael,2,0,34,32
1657353975414,MATH 109,A02,083214,Ganzberger; Geoffrey Michael,4,0,34,30
1657353975414,MATH 109,A03,093478,Ganzberger; Geoffrey Michael,2,0,34,32
1657353975414,MATH 109,B01,083215,Ganzberger; Geoffrey Michael,1,0,32,31
1657353975414,MATH 109,B02,083216,Ganzberger; Geoffrey Michael,2,0,32,30
1657353975414,MATH 109,B03,093479,Ganzberger; Geoffrey Michael,8,0,32,24
1657353981445,MATH 142A,A01,083219,Chow; Bennett,7,0,32,25
1657353981445,MATH 142A,A02,083220,Chow; Bennett,10,0,32,22
1657353981445,MATH 142A,A03,093480,Chow; Bennett,8,0,32,24
1657353981445,MATH 142A,B03,093481,Chow; Bennett,8,0,32,24
1657353981445,MATH 142A,B04,093558,Chow; Bennett,13,0,32,19
1657353981445,MATH 142A,B05,093559,Chow; Bennett,6,0,32,26
1657353987469,MATH 193A,A01,083224,Rotar; Vladimir,8,0,34,26
1657353987469,MATH 193A,A02,083225,Rotar; Vladimir,9,0,34,25
1657353987469,MATH 193A,A03,083781,Rotar; Vladimir,5,0,34,29
1657353987469,MATH 193A,A04,083782,Rotar; Vladimir,10,0,34,24
1657353987469,MATH 193A,A05,093482,Rotar; Vladimir,10,0,34,24
1657353993494,MATH 197,001,091859,McAuley; Julian John,9999,0,9999,0
1657353993494,MATH 197,002,095566,Kedlaya; Kiran S.,9997,0,9999,2
1657353993494,MATH 197,003,095567,Xiao; Ming,9999,0,9999,0
1657353993494,MATH 197,004,095571,Perols; Johan Lars,9998,0,9999,1
1657354000545,COGS 9,A01,083615,Shannon; Kyle Michael,8,0,75,67
1657354006571,COGS 11,A01,083617,Boyle; Mary E. T.,22,0,48,26
1657354012609,COGS 13,A01,083071,Bastos; Amalia Pinkusfeld,11,0,71,60
1657354018633,COGS 14A,A01,092681,Semenuks; Arturs,4,1,100,96
1657354024657,COGS 14B,A01,083073,Cheng; Tzu-Han,6,0,63,57
1657354030681,COGS 17,A01,092677,Semenuks; Arturs,6,0,81,75
1657354036704,COGS 100,A01,083619,Allen; Michael Gordon,17,0,70,53
1657354042729,COGS 101A,A01,083621,Davis; Joshua Daniel,9,0,68,59
1657354048757,COGS 101B,A01,091572,Allen; Michael Gordon,11,0,65,54
1657354054789,COGS 101C,A01,083625,Delgado; Tania,17,0,35,18
1657354060813,COGS 107A,A01,083627,Boyle; Mary E. T.,13,0,60,47
1657354066838,COGS 118A,A01,083075,Gupta; Anjum,20,0,76,56
1657354072865,CSE 3,A50,083646,Miranda; Gregory Joseph,24,0,50,26
1657354078893,CSE 8A,A50,083650,Miranda; Gregory Joseph,17,1,56,39
1657354084918,CSE 11,A01,083080,Cao; Yingjun,6,15,40,34
1657354090950,CSE 12,A01,083652,Krause-Levy; Sophia Louisa,28,1,120,92
1657354096974,CSE 15L,A01,083654,Morris; Justin Loren,9,0,50,41
1657354096974,CSE 15L,A02,083655,Morris; Justin Loren,9,0,50,41
1657354103003,CSE 20,A01,083657,Tran; Khoa Dang,39,0,80,41
1657354109028,CSE 21,A01,095574,Bach; Quang Tran,22,0,48,26
1657354115054,CSE 30,A01,083084,Eldon; John,4,0,80,76
1657354115054,CSE 30,B01,095061,Bhaskar; Nishant,9,0,50,41
1657354121087,CSE 100,A01,083659,Cao; Yingjun,5,4,70,65
1657354127120,CSE 134B,A01,083661,Powell; Thomas Allan,22,0,100,78
1657354133150,CSE 140,A01,083663,Gungor; Onat,14,0,85,71
1657354139175,CSE 140L,A01,083088,Eldon; John,21,0,100,79
1657354145199,CSE 175,A01,083665,Kumar; Rakesh,3,0,25,22
1657354151229,CSE 190,A00,092507,Dubnov; Shlomo,7,0,20,13
1657354157259,ECE 45,A01,083139,Congero; Spencer William,6,0,75,69
1657354163284,ECE 65,A50,083695,Saad; Andrew S,12,0,30,18
1657354163284,ECE 65,A51,095125,Saad; Andrew S,24,0,26,2
1657354169309,ECE 109,A01,091882,Touri; Behrouz,19,0,70,51
1657354175333,ECE 180,A00,083140,Abi Samra; Nicholas Camill,1,0,30,29
1657354175333,ECE 180,B00,083141,Abi Samra; Nicholas Camill,0,0,30,30
1657354181365,MATH 10A,A01,083735,Patchell; Gregory David,2,0,30,28
1657354181365,MATH 10A,A02,083736,Patchell; Gregory David,20,0,30,10
1657354181365,MATH 10A,A03,083737,Patchell; Gregory David,16,0,30,14
1657354187395,MATH 10B,A01,083207,Lim; Seonhee,8,0,34,26
1657354187395,MATH 10B,A02,083208,Lim; Seonhee,9,0,35,26
1657354187395,MATH 10B,A03,093472,Lim; Seonhee,7,0,34,27
1657354187395,MATH 10B,B01,083739,Sinha; Shubham,12,0,30,18
1657354193513,MATH 18,A01,083743,Cinel; Cameron Alexander,7,0,30,23
1657354193513,MATH 18,A02,083744,Cinel; Cameron Alexander,17,0,30,13
1657354193513,MATH 18,A03,083745,Cinel; Cameron Alexander,9,0,30,21
1657354193513,MATH 18,B01,083748,Rideout; David Porter,5,0,37,32
1657354193513,MATH 18,B02,083749,Rideout; David Porter,5,0,36,31
1657354193513,MATH 18,B03,083750,Rideout; David Porter,3,0,37,34
1657354193513,MATH 18,B04,083751,Rideout; David Porter,6,0,36,30
1657354193513,MATH 18,B05,093473,Rideout; David Porter,6,0,36,30
1657354193513,MATH 18,B06,093474,Rideout; David Porter,6,0,36,30
1657354199538,MATH 20A,A01,083754,Zheng; Zequn,14,0,40,26
1657354205564,MATH 20B,A01,083756,Briones; Jor-el Thomas Caparas,4,0,36,32
1657354205564,MATH 20B,A02,083757,Briones; Jor-el Thomas Caparas,1,0,36,35
1657354205564,MATH 20B,A03,093475,Briones; Jor-el Thomas Caparas,2,0,36,34
1657354211596,MATH 20C,A01,083760,Briones; Jor-el Thomas Caparas,1,0,35,34
1657354211596,MATH 20C,A02,083761,Briones; Jor-el Thomas Caparas,8,0,35,27
1657354211596,MATH 20C,A03,093476,Briones; Jor-el Thomas Caparas,0,1,36,36
1657354211596,MATH 20C,B01,083762,Bach; Quang Tran,1,0,30,29
1657354217620,MATH 20D,A01,083765,Tran; Brian Kha,5,0,30,25
1657354217620,MATH 20D,A02,083766,Tran; Brian Kha,5,0,30,25
1657354217620,MATH 20D,A03,083767,Tran; Brian Kha,5,0,30,25
1657354223656,MATH 20E,A01,083771,Ganguly; Soumya,9,0,32,23
1657354223656,MATH 20E,A02,083772,Ganguly; Soumya,6,0,32,26
1657354223656,MATH 20E,B01,083773,Ciotti; Benjamin,20,0,35,15
1657354223656,MATH 20E,B02,083774,Ciotti; Benjamin,17,0,35,18
1657354229692,MATH 103A,A01,083777,Greenfeld; Be'Eri,3,0,36,33
1657354229692,MATH 103A,A02,083778,Greenfeld; Be'Eri,5,0,36,31
1657354229692,MATH 103A,A03,093561,Greenfeld; Be'Eri,5,0,36,31
1657354229692,MATH 103A,B01,083779,Greenfeld; Be'Eri,7,0,36,29
1657354229692,MATH 103A,B02,083780,Greenfeld; Be'Eri,4,0,36,32
1657354229692,MATH 103A,B03,093562,Greenfeld; Be'Eri,3,0,36,33
1657354235723,MATH 105,A01,085443,Carter; Anne Toulson,15,0,35,20
1657354235723,MATH 105,A02,093477,Carter; Anne Toulson,20,0,35,15
1657354241760,MATH 109,A01,083213,Ganzberger; Geoffrey Michael,2,0,34,32
1657354241760,MATH 109,A02,083214,Ganzberger; Geoffrey Michael,4,0,34,30
1657354241760,MATH 109,A03,093478,Ganzberger; Geoffrey Michael,2,0,34,32
1657354241760,MATH 109,B01,083215,Ganzberger; Geoffrey Michael,1,0,32,31
1657354241760,MATH 109,B02,083216,Ganzberger; Geoffrey Michael,2,0,32,30
1657354241760,MATH 109,B03,093479,Ganzberger; Geoffrey Michael,8,0,32,24
1657354247785,MATH 142A,A01,083219,Chow; Bennett,7,0,32,25
1657354247785,MATH 142A,A02,083220,Chow; Bennett,10,0,32,22
1657354247785,MATH 142A,A03,093480,Chow; Bennett,8,0,32,24
1657354247785,MATH 142A,B03,093481,Chow; Bennett,8,0,32,24
1657354247785,MATH 142A,B04,093558,Chow; Bennett,13,0,32,19
1657354247785,MATH 142A,B05,093559,Chow; Bennett,6,0,32,26
1657354253828,MATH 193A,A01,083224,Rotar; Vladimir,8,0,34,26
1657354253828,MATH 193A,A02,083225,Rotar; Vladimir,9,0,34,25
1657354253828,MATH 193A,A03,083781,Rotar; Vladimir,5,0,34,29
1657354253828,MATH 193A,A04,083782,Rotar; Vladimir,10,0,34,24
1657354253828,MATH 193A,A05,093482,Rotar; Vladimir,10,0,34,24
1657354259855,MATH 197,001,091859,McAuley; Julian John,9999,0,9999,0
1657354259855,MATH 197,002,095566,Kedlaya; Kiran S.,9997,0,9999,2
1657354259855,MATH 197,003,095567,Xiao; Ming,9999,0,9999,0
1657354259855,MATH 197,004,095571,Perols; Johan Lars,9998,0,9999,1
1657354266937,COGS 9,A01,083615,Shannon; Kyle Michael,8,0,75,67
1657354272963,COGS 11,A01,083617,Boyle; Mary E. T.,22,0,48,26
1657354278994,COGS 13,A01,083071,Bastos; Amalia Pinkusfeld,11,0,71,60
1657354285019,COGS 14A,A01,092681,Semenuks; Arturs,4,1,100,96
1657354291047,COGS 14B,A01,083073,Cheng; Tzu-Han,6,0,63,57
1657354297080,COGS 17,A01,092677,Semenuks; Arturs,6,0,81,75
1657354303110,COGS 100,A01,083619,Allen; Michael Gordon,17,0,70,53
1657354309140,COGS 101A,A01,083621,Davis; Joshua Daniel,9,0,68,59
1657354315164,COGS 101B,A01,091572,Allen; Michael Gordon,11,0,65,54
1657354321195,COGS 101C,A01,083625,Delgado; Tania,17,0,35,18
1657354327226,COGS 107A,A01,083627,Boyle; Mary E. T.,13,0,60,47
1657354333264,COGS 118A,A01,083075,Gupta; Anjum,20,0,76,56
1657354339301,CSE 3,A50,083646,Miranda; Gregory Joseph,24,0,50,26
1657354345327,CSE 8A,A50,083650,Miranda; Gregory Joseph,17,1,56,39
1657354351353,CSE 11,A01,083080,Cao; Yingjun,6,15,40,34
1657354357386,CSE 12,A01,083652,Krause-Levy; Sophia Louisa,28,1,120,92
1657354363415,CSE 15L,A01,083654,Morris; Justin Loren,9,0,50,41
1657354363415,CSE 15L,A02,083655,Morris; Justin Loren,9,0,50,41
1657354369446,CSE 20,A01,083657,Tran; Khoa Dang,39,0,80,41
1657354375472,CSE 21,A01,095574,Bach; Quang Tran,22,0,48,26
1657354381499,CSE 30,A01,083084,Eldon; John,4,0,80,76
1657354381499,CSE 30,B01,095061,Bhaskar; Nishant,9,0,50,41
1657354387530,CSE 100,A01,083659,Cao; Yingjun,5,4,70,65
1657354393555,CSE 134B,A01,083661,Powell; Thomas Allan,22,0,100,78
1657354399590,CSE 140,A01,083663,Gungor; Onat,14,0,85,71
1657354405619,CSE 140L,A01,083088,Eldon; John,21,0,100,79
1657354411644,CSE 175,A01,083665,Kumar; Rakesh,3,0,25,22
1657354417672,CSE 190,A00,092507,Dubnov; Shlomo,7,0,20,13
1657354423697,ECE 45,A01,083139,Congero; Spencer William,6,0,75,69
1657354429731,ECE 65,A50,083695,Saad; Andrew S,12,0,30,18
1657354429731,ECE 65,A51,095125,Saad; Andrew S,24,0,26,2
1657354435756,ECE 109,A01,091882,Touri; Behrouz,19,0,70,51
1657354441783,ECE 180,A00,083140,Abi Samra; Nicholas Camill,1,0,30,29
1657354441783,ECE 180,B00,083141,Abi Samra; Nicholas Camill,0,0,30,30
1657354447817,MATH 10A,A01,083735,Patchell; Gregory David,2,0,30,28
1657354447817,MATH 10A,A02,083736,Patchell; Gregory David,20,0,30,10
1657354447817,MATH 10A,A03,083737,Patchell; Gregory David,16,0,30,14
1657354453844,MATH 10B,A01,083207,Lim; Seonhee,8,0,34,26
1657354453844,MATH 10B,A02,083208,Lim; Seonhee,9,0,35,26
1657354453844,MATH 10B,A03,093472,Lim; Seonhee,7,0,34,27
1657354453844,MATH 10B,B01,083739,Sinha; Shubham,12,0,30,18
1657354459873,MATH 18,A01,083743,Cinel; Cameron Alexander,7,0,30,23
1657354459873,MATH 18,A02,083744,Cinel; Cameron Alexander,17,0,30,13
1657354459873,MATH 18,A03,083745,Cinel; Cameron Alexander,9,0,30,21
1657354459873,MATH 18,B01,083748,Rideout; David Porter,5,0,37,32
1657354459873,MATH 18,B02,083749,Rideout; David Porter,5,0,36,31
1657354459873,MATH 18,B03,083750,Rideout; David Porter,3,0,37,34
1657354459873,MATH 18,B04,083751,Rideout; David Porter,6,0,36,30
1657354459873,MATH 18,B05,093473,Rideout; David Porter,6,0,36,30
1657354459873,MATH 18,B06,093474,Rideout; David Porter,6,0,36,30
1657354465901,MATH 20A,A01,083754,Zheng; Zequn,14,0,40,26
1657354471925,MATH 20B,A01,083756,Briones; Jor-el Thomas Caparas,4,0,36,32
1657354471925,MATH 20B,A02,083757,Briones; Jor-el Thomas Caparas,1,0,36,35
1657354471925,MATH 20B,A03,093475,Briones; Jor-el Thomas Caparas,2,0,36,34
1657354477955,MATH 20C,A01,083760,Briones; Jor-el Thomas Caparas,1,0,35,34
1657354477955,MATH 20C,A02,083761,Briones; Jor-el Thomas Caparas,8,0,35,27
1657354477955,MATH 20C,A03,093476,Briones; Jor-el Thomas Caparas,0,1,36,36
1657354477955,MATH 20C,B01,083762,Bach; Quang Tran,1,0,30,29
1657354483987,MATH 20D,A01,083765,Tran; Brian Kha,5,0,30,25
1657354483987,MATH 20D,A02,083766,Tran; Brian Kha,5,0,30,25
1657354483987,MATH 20D,A03,083767,Tran; Brian Kha,5,0,30,25
1657354490014,MATH 20E,A01,083771,Ganguly; Soumya,9,0,32,23
1657354490014,MATH 20E,A02,083772,Ganguly; Soumya,6,0,32,26
1657354490014,MATH 20E,B01,083773,Ciotti; Benjamin,20,0,35,15
1657354490014,MATH 20E,B02,083774,Ciotti; Benjamin,17,0,35,18
1657354496039,MATH 103A,A01,083777,Greenfeld; Be'Eri,3,0,36,33
1657354496039,MATH 103A,A02,083778,Greenfeld; Be'Eri,5,0,36,31
1657354496039,MATH 103A,A03,093561,Greenfeld; Be'Eri,5,0,36,31
1657354496039,MATH 103A,B01,083779,Greenfeld; Be'Eri,7,0,36,29
1657354496039,MATH 103A,B02,083780,Greenfeld; Be'Eri,4,0,36,32
1657354496039,MATH 103A,B03,093562,Greenfeld; Be'Eri,3,0,36,33
1657354502073,MATH 105,A01,085443,Carter; Anne Toulson,15,0,35,20
1657354502073,MATH 105,A02,093477,Carter; Anne Toulson,20,0,35,15
1657354508098,MATH 109,A01,083213,Ganzberger; Geoffrey Michael,2,0,34,32
1657354508098,MATH 109,A02,083214,Ganzberger; Geoffrey Michael,4,0,34,30
1657354508098,MATH 109,A03,093478,Ganzberger; Geoffrey Michael,2,0,34,32
1657354508098,MATH 109,B01,083215,Ganzberger; Geoffrey Michael,1,0,32,31
1657354508098,MATH 109,B02,083216,Ganzberger; Geoffrey Michael,2,0,32,30
1657354508098,MATH 109,B03,093479,Ganzberger; Geoffrey Michael,8,0,32,24
1657354514130,MATH 142A,A01,083219,Chow; Bennett,7,0,32,25
1657354514130,MATH 142A,A02,083220,Chow; Bennett,10,0,32,22
1657354514130,MATH 142A,A03,093480,Chow; Bennett,8,0,32,24
1657354514130,MATH 142A,B03,093481,Chow; Bennett,8,0,32,24
1657354514130,MATH 142A,B04,093558,Chow; Bennett,13,0,32,19
1657354514130,MATH 142A,B05,093559,Chow; Bennett,6,0,32,26
1657354520163,MATH 193A,A01,083224,Rotar; Vladimir,8,0,34,26
1657354520163,MATH 193A,A02,083225,Rotar; Vladimir,9,0,34,25
1657354520163,MATH 193A,A03,083781,Rotar; Vladimir,5,0,34,29
1657354520163,MATH 193A,A04,083782,Rotar; Vladimir,10,0,34,24
1657354520163,MATH 193A,A05,093482,Rotar; Vladimir,10,0,34,24
1657354526199,MATH 197,001,091859,McAuley; Julian John,9999,0,9999,0
1657354526199,MATH 197,002,095566,Kedlaya; Kiran S.,9997,0,9999,2
1657354526199,MATH 197,003,095567,Xiao; Ming,9999,0,9999,0
1657354526199,MATH 197,004,095571,Perols; Johan Lars,9998,0,9999,1
1657354533268,COGS 9,A01,083615,Shannon; Kyle Michael,8,0,75,67
1657354539299,COGS 11,A01,083617,Boyle; Mary E. T.,22,0,48,26
1657354545328,COGS 13,A01,083071,Bastos; Amalia Pinkusfeld,11,0,71,60
1657354551359,COGS 14A,A01,092681,Semenuks; Arturs,4,1,100,96
1657354557382,COGS 14B,A01,083073,Cheng; Tzu-Han,6,0,63,57
1657354563414,COGS 17,A01,092677,Semenuks; Arturs,6,0,81,75
1657354569442,COGS 100,A01,083619,Allen; Michael Gordon,17,0,70,53
1657354575470,COGS 101A,A01,083621,Davis; Joshua Daniel,9,0,68,59
1657354581494,COGS 101B,A01,091572,Allen; Michael Gordon,11,0,65,54
1657354587522,COGS 101C,A01,083625,Delgado; Tania,17,0,35,18
1657354593549,COGS 107A,A01,083627,Boyle; Mary E. T.,13,0,60,47
1657354599575,COGS 118A,A01,083075,Gupta; Anjum,20,0,76,56
1657354605607,CSE 3,A50,083646,Miranda; Gregory Joseph,24,0,50,26
1657354611630,CSE 8A,A50,083650,Miranda; Gregory Joseph,17,1,56,39
1657354617655,CSE 11,A01,083080,Cao; Yingjun,6,15,40,34
1657354623678,CSE 12,A01,083652,Krause-Levy; Sophia Louisa,28,1,120,92
1657354629700,CSE 15L,A01,083654,Morris; Justin Loren,9,0,50,41
1657354629700,CSE 15L,A02,083655,Morris; Justin Loren,9,0,50,41
1657354635724,CSE 20,A01,083657,Tran; Khoa Dang,39,0,80,41
1657354641747,CSE 21,A01,095574,Bach; Quang Tran,22,0,48,26
1657354647775,CSE 30,A01,083084,Eldon; John,4,0,80,76
1657354647775,CSE 30,B01,095061,Bhaskar; Nishant,9,0,50,41
1657354653800,CSE 100,A01,083659,Cao; Yingjun,5,4,70,65
1657354659823,CSE 134B,A01,083661,Powell; Thomas Allan,22,0,100,78
1657354665847,CSE 140,A01,083663,Gungor; Onat,14,0,85,71
1657354671876,CSE 140L,A01,083088,Eldon; John,21,0,100,79
1657354677906,CSE 175,A01,083665,Kumar; Rakesh,3,0,25,22
1657354683944,CSE 190,A00,092507,Dubnov; Shlomo,7,0,20,13
1657354689967,ECE 45,A01,083139,Congero; Spencer William,6,0,75,69
1657354695992,ECE 65,A50,083695,Saad; Andrew S,12,0,30,18
1657354695992,ECE 65,A51,095125,Saad; Andrew S,24,0,26,2
1657354702020,ECE 109,A01,091882,Touri; Behrouz,19,0,70,51
1657354708048,ECE 180,A00,083140,Abi Samra; Nicholas Camill,1,0,30,29
1657354708048,ECE 180,B00,083141,Abi Samra; Nicholas Camill,0,0,30,30
1657354714071,MATH 10A,A01,083735,Patchell; Gregory David,2,0,30,28
1657354714071,MATH 10A,A02,083736,Patchell; Gregory David,20,0,30,10
1657354714071,MATH 10A,A03,083737,Patchell; Gregory David,16,0,30,14
1657354720102,MATH 10B,A01,083207,Lim; Seonhee,8,0,34,26
1657354720102,MATH 10B,A02,083208,Lim; Seonhee,9,0,35,26
1657354720102,MATH 10B,A03,093472,Lim; Seonhee,7,0,34,27
1657354720102,MATH 10B,B01,083739,Sinha; Shubham,12,0,30,18
1657354726128,MATH 18,A01,083743,Cinel; Cameron Alexander,7,0,30,23
1657354726128,MATH 18,A02,083744,Cinel; Cameron Alexander,17,0,30,13
1657354726128,MATH 18,A03,083745,Cinel; Cameron Alexander,9,0,30,21
1657354726128,MATH 18,B01,083748,Rideout; David Porter,5,0,37,32
1657354726128,MATH 18,B02,083749,Rideout; David Porter,5,0,36,31
1657354726128,MATH 18,B03,083750,Rideout; David Porter,3,0,37,34
1657354726128,MATH 18,B04,083751,Rideout; David Porter,6,0,36,30
1657354726128,MATH 18,B05,093473,Rideout; David Porter,6,0,36,30
1657354726128,MATH 18,B06,093474,Rideout; David Porter,6,0,36,30
1657354732156,MATH 20A,A01,083754,Zheng; Zequn,14,0,40,26
1657354738180,MATH 20B,A01,083756,Briones; Jor-el Thomas Caparas,4,0,36,32
1657354738180,MATH 20B,A02,083757,Briones; Jor-el Thomas Caparas,1,0,36,35
1657354738180,MATH 20B,A03,093475,Briones; Jor-el Thomas Caparas,2,0,36,34
1657354744209,MATH 20C,A01,083760,Briones; Jor-el Thomas Caparas,1,0,35,34
1657354744209,MATH 20C,A02,083761,Briones; Jor-el Thomas Caparas,8,0,35,27
1657354744209,MATH 20C,A03,093476,Briones; Jor-el Thomas Caparas,0,1,36,36
1657354744209,MATH 20C,B01,083762,Bach; Quang Tran,1,0,30,29
1657354750245,MATH 20D,A01,083765,Tran; Brian Kha,5,0,30,25
1657354750245,MATH 20D,A02,083766,Tran; Brian Kha,5,0,30,25
1657354750245,MATH 20D,A03,083767,Tran; Brian Kha,5,0,30,25
1657354756268,MATH 20E,A01,083771,Ganguly; Soumya,9,0,32,23
1657354756268,MATH 20E,A02,083772,Ganguly; Soumya,6,0,32,26
1657354756268,MATH 20E,B01,083773,Ciotti; Benjamin,20,0,35,15
1657354756268,MATH 20E,B02,083774,Ciotti; Benjamin,17,0,35,18
1657354762292,MATH 103A,A01,083777,Greenfeld; Be'Eri,3,0,36,33
1657354762292,MATH 103A,A02,083778,Greenfeld; Be'Eri,5,0,36,31
1657354762292,MATH 103A,A03,093561,Greenfeld; Be'Eri,5,0,36,31
1657354762292,MATH 103A,B01,083779,Greenfeld; Be'Eri,7,0,36,29
1657354762292,MATH 103A,B02,083780,Greenfeld; Be'Eri,4,0,36,32
1657354762292,MATH 103A,B03,093562,Greenfeld; Be'Eri,3,0,36,33
1657354768316,MATH 105,A01,085443,Carter; Anne Toulson,15,0,35,20
1657354768316,MATH 105,A02,093477,Carter; Anne Toulson,20,0,35,15
1657354774341,MATH 109,A01,083213,Ganzberger; Geoffrey Michael,2,0,34,32
1657354774341,MATH 109,A02,083214,Ganzberger; Geoffrey Michael,4,0,34,30
1657354774341,MATH 109,A03,093478,Ganzberger; Geoffrey Michael,2,0,34,32
1657354774341,MATH 109,B01,083215,Ganzberger; Geoffrey Michael,1,0,32,31
1657354774341,MATH 109,B02,083216,Ganzberger; Geoffrey Michael,2,0,32,30
1657354774341,MATH 109,B03,093479,Ganzberger; Geoffrey Michael,8,0,32,24
1657354780365,MATH 142A,A01,083219,Chow; Bennett,7,0,32,25
1657354780365,MATH 142A,A02,083220,Chow; Bennett,10,0,32,22
1657354780365,MATH 142A,A03,093480,Chow; Bennett,8,0,32,24
1657354780365,MATH 142A,B03,093481,Chow; Bennett,8,0,32,24
1657354780365,MATH 142A,B04,093558,Chow; Bennett,13,0,32,19
1657354780365,MATH 142A,B05,093559,Chow; Bennett,6,0,32,26
1657354786390,MATH 193A,A01,083224,Rotar; Vladimir,8,0,34,26
1657354786390,MATH 193A,A02,083225,Rotar; Vladimir,9,0,34,25
1657354786390,MATH 193A,A03,083781,Rotar; Vladimir,5,0,34,29
1657354786390,MATH 193A,A04,083782,Rotar; Vladimir,10,0,34,24
1657354786390,MATH 193A,A05,093482,Rotar; Vladimir,10,0,34,24
1657354792505,MATH 197,001,091859,McAuley; Julian John,9999,0,9999,0
1657354792505,MATH 197,002,095566,Kedlaya; Kiran S.,9997,0,9999,2
1657354792505,MATH 197,003,095567,Xiao; Ming,9999,0,9999,0
1657354792505,MATH 197,004,095571,Perols; Johan Lars,9998,0,9999,1
1657354799576,COGS 9,A01,083615,Shannon; Kyle Michael,8,0,75,67
1657354805599,COGS 11,A01,083617,Boyle; Mary E. T.,22,0,48,26
1657354811625,COGS 13,A01,083071,Bastos; Amalia Pinkusfeld,11,0,71,60
1657354817647,COGS 14A,A01,092681,Semenuks; Arturs,4,1,100,96
1657354823669,COGS 14B,A01,083073,Cheng; Tzu-Han,6,0,63,57
1657354829695,COGS 17,A01,092677,Semenuks; Arturs,6,0,81,75
1657354835719,COGS 100,A01,083619,Allen; Michael Gordon,17,0,70,53
1657354841750,COGS 101A,A01,083621,Davis; Joshua Daniel,9,0,68,59
1657354847777,COGS 101B,A01,091572,Allen; Michael Gordon,11,0,65,54
1657354853799,COGS 101C,A01,083625,Delgado; Tania,17,0,35,18
1657354859823,COGS 107A,A01,083627,Boyle; Mary E. T.,13,0,60,47
1657354865845,COGS 118A,A01,083075,Gupta; Anjum,20,0,76,56
1657354871870,CSE 3,A50,083646,Miranda; Gregory Joseph,24,0,50,26
1657354877899,CSE 8A,A50,083650,Miranda; Gregory Joseph,17,1,56,39
1657354883922,CSE 11,A01,083080,Cao; Yingjun,6,15,40,34
1657354889957,CSE 12,A01,083652,Krause-Levy; Sophia Louisa,28,1,120,92
1657354895983,CSE 15L,A01,083654,Morris; Justin Loren,9,0,50,41
1657354895983,CSE 15L,A02,083655,Morris; Justin Loren,9,0,50,41
1657354902008,CSE 20,A01,083657,Tran; Khoa Dang,39,0,80,41
1657354908032,CSE 21,A01,095574,Bach; Quang Tran,22,0,48,26
1657354914061,CSE 30,A01,083084,Eldon; John,4,0,80,76
1657354914061,CSE 30,B01,095061,Bhaskar; Nishant,9,0,50,41
1657354920086,CSE 100,A01,083659,Cao; Yingjun,5,4,70,65
1657354926109,CSE 134B,A01,083661,Powell; Thomas Allan,22,0,100,78
1657354932136,CSE 140,A01,083663,Gungor; Onat,14,0,85,71
1657354938161,CSE 140L,A01,083088,Eldon; John,21,0,100,79
1657354944187,CSE 175,A01,083665,Kumar; Rakesh,3,0,25,22
1657354950211,CSE 190,A00,092507,Dubnov; Shlomo,7,0,20,13
1657354956246,ECE 45,A01,083139,Congero; Spencer William,6,0,75,69
1657354962274,ECE 65,A50,083695,Saad; Andrew S,12,0,30,18
1657354962274,ECE 65,A51,095125,Saad; Andrew S,24,0,26,2
1657354968302,ECE 109,A01,091882,Touri; Behrouz,19,0,70,51
1657354974334,ECE 180,A00,083140,Abi Samra; Nicholas Camill,1,0,30,29
1657354974334,ECE 180,B00,083141,Abi Samra; Nicholas Camill,0,0,30,30
1657354980365,MATH 10A,A01,083735,Patchell; Gregory David,2,0,30,28
1657354980365,MATH 10A,A02,083736,Patchell; Gregory David,20,0,30,10
1657354980365,MATH 10A,A03,083737,Patchell; Gregory David,16,0,30,14
1657354986397,MATH 10B,A01,083207,Lim; Seonhee,8,0,34,26
1657354986397,MATH 10B,A02,083208,Lim; Seonhee,9,0,35,26
1657354986397,MATH 10B,A03,093472,Lim; Seonhee,7,0,34,27
1657354986397,MATH 10B,B01,083739,Sinha; Shubham,12,0,30,18
1657354992445,MATH 18,A01,083743,Cinel; Cameron Alexander,7,0,30,23
1657354992445,MATH 18,A02,083744,Cinel; Cameron Alexander,17,0,30,13
1657354992445,MATH 18,A03,083745,Cinel; Cameron Alexander,9,0,30,21
1657354992445,MATH 18,B01,083748,Rideout; David Porter,5,0,37,32
1657354992445,MATH 18,B02,083749,Rideout; David Porter,5,0,36,31
1657354992445,MATH 18,B03,083750,Rideout; David Porter,3,0,37,34
1657354992445,MATH 18,B04,083751,Rideout; David Porter,6,0,36,30
1657354992445,MATH 18,B05,093473,Rideout; David Porter,6,0,36,30
1657354992445,MATH 18,B06,093474,Rideout; David Porter,6,0,36,30
1657354998476,MATH 20A,A01,083754,Zheng; Zequn,14,0,40,26
1657355004509,MATH 20B,A01,083756,Briones; Jor-el Thomas Caparas,4,0,36,32
1657355004509,MATH 20B,A02,083757,Briones; Jor-el Thomas Caparas,1,0,36,35
1657355004509,MATH 20B,A03,093475,Briones; Jor-el Thomas Caparas,2,0,36,34
1657355010533,MATH 20C,A01,083760,Briones; Jor-el Thomas Caparas,1,0,35,34
1657355010533,MATH 20C,A02,083761,Briones; Jor-el Thomas Caparas,8,0,35,27
1657355010533,MATH 20C,A03,093476,Briones; Jor-el Thomas Caparas,0,1,36,36
1657355010533,MATH 20C,B01,083762,Bach; Quang Tran,1,0,30,29
1657355016564,MATH 20D,A01,083765,Tran; Brian Kha,5,0,30,25
1657355016564,MATH 20D,A02,083766,Tran; Brian Kha,5,0,30,25
1657355016564,MATH 20D,A03,083767,Tran; Brian Kha,5,0,30,25
1657355022598,MATH 20E,A01,083771,Ganguly; Soumya,9,0,32,23
1657355022598,MATH 20E,A02,083772,Ganguly; Soumya,6,0,32,26
1657355022598,MATH 20E,B01,083773,Ciotti; Benjamin,20,0,35,15
1657355022598,MATH 20E,B02,083774,Ciotti; Benjamin,17,0,35,18
1657355028627,MATH 103A,A01,083777,Greenfeld; Be'Eri,3,0,36,33
1657355028627,MATH 103A,A02,083778,Greenfeld; Be'Eri,5,0,36,31
1657355028627,MATH 103A,A03,093561,Greenfeld; Be'Eri,5,0,36,31
1657355028627,MATH 103A,B01,083779,Greenfeld; Be'Eri,7,0,36,29
1657355028627,MATH 103A,B02,083780,Greenfeld; Be'Eri,4,0,36,32
1657355028627,MATH 103A,B03,093562,Greenfeld; Be'Eri,3,0,36,33
1657355034653,MATH 105,A01,085443,Carter; Anne Toulson,15,0,35,20
1657355034653,MATH 105,A02,093477,Carter; Anne Toulson,20,0,35,15
1657355040678,MATH 109,A01,083213,Ganzberger; Geoffrey Michael,2,0,34,32
1657355040678,MATH 109,A02,083214,Ganzberger; Geoffrey Michael,4,0,34,30
1657355040678,MATH 109,A03,093478,Ganzberger; Geoffrey Michael,2,0,34,32
1657355040678,MATH 109,B01,083215,Ganzberger; Geoffrey Michael,1,0,32,31
1657355040678,MATH 109,B02,083216,Ganzberger; Geoffrey Michael,2,0,32,30
1657355040678,MATH 109,B03,093479,Ganzberger; Geoffrey Michael,8,0,32,24
1657355046704,MATH 142A,A01,083219,Chow; Bennett,7,0,32,25
1657355046704,MATH 142A,A02,083220,Chow; Bennett,10,0,32,22
1657355046704,MATH 142A,A03,093480,Chow; Bennett,8,0,32,24
1657355046704,MATH 142A,B03,093481,Chow; Bennett,8,0,32,24
1657355046704,MATH 142A,B04,093558,Chow; Bennett,13,0,32,19
1657355046704,MATH 142A,B05,093559,Chow; Bennett,6,0,32,26
1657355052741,MATH 193A,A01,083224,Rotar; Vladimir,8,0,34,26
1657355052741,MATH 193A,A02,083225,Rotar; Vladimir,9,0,34,25
1657355052741,MATH 193A,A03,083781,Rotar; Vladimir,5,0,34,29
1657355052741,MATH 193A,A04,083782,Rotar; Vladimir,10,0,34,24
1657355052741,MATH 193A,A05,093482,Rotar; Vladimir,10,0,34,24
1657355058766,MATH 197,001,091859,McAuley; Julian John,9999,0,9999,0
1657355058766,MATH 197,002,095566,Kedlaya; Kiran S.,9997,0,9999,2
1657355058766,MATH 197,003,095567,Xiao; Ming,9999,0,9999,0
1657355058766,MATH 197,004,095571,Perols; Johan Lars,9998,0,9999,1
1657355065854,COGS 9,A01,083615,Shannon; Kyle Michael,8,0,75,67
1657355071880,COGS 11,A01,083617,Boyle; Mary E. T.,22,0,48,26
1657355077905,COGS 13,A01,083071,Bastos; Amalia Pinkusfeld,11,0,71,60
1657355083931,COGS 14A,A01,092681,Semenuks; Arturs,4,1,100,96
1657355089956,COGS 14B,A01,083073,Cheng; Tzu-Han,6,0,63,57
1657355095979,COGS 17,A01,092677,Semenuks; Arturs,6,0,81,75
1657355102005,COGS 100,A01,083619,Allen; Michael Gordon,17,0,70,53
1657355108030,COGS 101A,A01,083621,Davis; Joshua Daniel,9,0,68,59
1657355114055,COGS 101B,A01,091572,Allen; Michael Gordon,11,0,65,54
1657355120098,COGS 101C,A01,083625,Delgado; Tania,17,0,35,18
1657355126123,COGS 107A,A01,083627,Boyle; Mary E. T.,13,0,60,47
1657355132148,COGS 118A,A01,083075,Gupta; Anjum,20,0,76,56
1657355138184,CSE 3,A50,083646,Miranda; Gregory Joseph,24,0,50,26
1657355144213,CSE 8A,A50,083650,Miranda; Gregory Joseph,17,1,56,39
1657355150238,CSE 11,A01,083080,Cao; Yingjun,6,15,40,34
1657355156268,CSE 12,A01,083652,Krause-Levy; Sophia Louisa,28,1,120,92
1657355162297,CSE 15L,A01,083654,Morris; Justin Loren,9,0,50,41
1657355162297,CSE 15L,A02,083655,Morris; Justin Loren,9,0,50,41
1657355168327,CSE 20,A01,083657,Tran; Khoa Dang,39,0,80,41
1657355174352,CSE 21,A01,095574,Bach; Quang Tran,22,0,48,26
1657355180386,CSE 30,A01,083084,Eldon; John,4,0,80,76
1657355180386,CSE 30,B01,095061,Bhaskar; Nishant,9,0,50,41
1657355186412,CSE 100,A01,083659,Cao; Yingjun,5,4,70,65
1657355192444,CSE 134B,A01,083661,Powell; Thomas Allan,22,0,100,78
1657355198467,CSE 140,A01,083663,Gungor; Onat,14,0,85,71
1657355204492,CSE 140L,A01,083088,Eldon; John,21,0,100,79
1657355210521,CSE 175,A01,083665,Kumar; Rakesh,3,0,25,22
1657355216545,CSE 190,A00,092507,Dubnov; Shlomo,7,0,20,13
1657355222579,ECE 45,A01,083139,Congero; Spencer William,6,0,75,69
1657355228605,ECE 65,A50,083695,Saad; Andrew S,12,0,30,18
1657355228605,ECE 65,A51,095125,Saad; Andrew S,24,0,26,2
1657355234636,ECE 109,A01,091882,Touri; Behrouz,19,0,70,51
1657355240662,ECE 180,A00,083140,Abi Samra; Nicholas Camill,1,0,30,29
1657355240662,ECE 180,B00,083141,Abi Samra; Nicholas Camill,0,0,30,30
1657355246690,MATH 10A,A01,083735,Patchell; Gregory David,2,0,30,28
1657355246690,MATH 10A,A02,083736,Patchell; Gregory David,20,0,30,10
1657355246690,MATH 10A,A03,083737,Patchell; Gregory David,16,0,30,14
1657355252733,MATH 10B,A01,083207,Lim; Seonhee,8,0,34,26
1657355252733,MATH 10B,A02,083208,Lim; Seonhee,9,0,35,26
1657355252733,MATH 10B,A03,093472,Lim; Seonhee,7,0,34,27
1657355252733,MATH 10B,B01,083739,Sinha; Shubham,12,0,30,18
1657355258772,MATH 18,A01,083743,Cinel; Cameron Alexander,7,0,30,23
1657355258772,MATH 18,A02,083744,Cinel; Cameron Alexander,17,0,30,13
1657355258772,MATH 18,A03,083745,Cinel; Cameron Alexander,9,0,30,21
1657355258772,MATH 18,B01,083748,Rideout; David Porter,5,0,37,32
1657355258772,MATH 18,B02,083749,Rideout; David Porter,5,0,36,31
1657355258772,MATH 18,B03,083750,Rideout; David Porter,3,0,37,34
1657355258772,MATH 18,B04,083751,Rideout; David Porter,6,0,36,30
1657355258772,MATH 18,B05,093473,Rideout; David Porter,6,0,36,30
1657355258772,MATH 18,B06,093474,Rideout; David Porter,6,0,36,30
1657355264811,MATH 20A,A01,083754,Zheng; Zequn,14,0,40,26
1657355270852,MATH 20B,A01,083756,Briones; Jor-el Thomas Caparas,4,0,36,32
1657355270852,MATH 20B,A02,083757,Briones; Jor-el Thomas Caparas,1,0,36,35
1657355270852,MATH 20B,A03,093475,Briones; Jor-el Thomas Caparas,2,0,36,34
1657355276879,MATH 20C,A01,083760,Briones; Jor-el Thomas Caparas,1,0,35,34
1657355276879,MATH 20C,A02,083761,Briones; Jor-el Thomas Caparas,8,0,35,27
1657355276879,MATH 20C,A03,093476,Briones; Jor-el Thomas Caparas,0,1,36,36
1657355276879,MATH 20C,B01,083762,Bach; Quang Tran,1,0,30,29
1657355282917,MATH 20D,A01,083765,Tran; Brian Kha,5,0,30,25
1657355282917,MATH 20D,A02,083766,Tran; Brian Kha,5,0,30,25
1657355282917,MATH 20D,A03,083767,Tran; Brian Kha,5,0,30,25
1657355288951,MATH 20E,A01,083771,Ganguly; Soumya,9,0,32,23
1657355288951,MATH 20E,A02,083772,Ganguly; Soumya,6,0,32,26
1657355288951,MATH 20E,B01,083773,Ciotti; Benjamin,20,0,35,15
1657355288951,MATH 20E,B02,083774,Ciotti; Benjamin,17,0,35,18
1657355294986,MATH 103A,A01,083777,Greenfeld; Be'Eri,3,0,36,33
1657355294986,MATH 103A,A02,083778,Greenfeld; Be'Eri,5,0,36,31
1657355294986,MATH 103A,A03,093561,Greenfeld; Be'Eri,5,0,36,31
1657355294986,MATH 103A,B01,083779,Greenfeld; Be'Eri,7,0,36,29
1657355294986,MATH 103A,B02,083780,Greenfeld; Be'Eri,4,0,36,32
1657355294986,MATH 103A,B03,093562,Greenfeld; Be'Eri,3,0,36,33
1657355301013,MATH 105,A01,085443,Carter; Anne Toulson,15,0,35,20
1657355301013,MATH 105,A02,093477,Carter; Anne Toulson,20,0,35,15
1657355307039,MATH 109,A01,083213,Ganzberger; Geoffrey Michael,2,0,34,32
1657355307039,MATH 109,A02,083214,Ganzberger; Geoffrey Michael,4,0,34,30
1657355307039,MATH 109,A03,093478,Ganzberger; Geoffrey Michael,2,0,34,32
1657355307039,MATH 109,B01,083215,Ganzberger; Geoffrey Michael,1,0,32,31
1657355307039,MATH 109,B02,083216,Ganzberger; Geoffrey Michael,2,0,32,30
1657355307039,MATH 109,B03,093479,Ganzberger; Geoffrey Michael,8,0,32,24
1657355313072,MATH 142A,A01,083219,Chow; Bennett,7,0,32,25
1657355313072,MATH 142A,A02,083220,Chow; Bennett,10,0,32,22
1657355313072,MATH 142A,A03,093480,Chow; Bennett,8,0,32,24
1657355313072,MATH 142A,B03,093481,Chow; Bennett,8,0,32,24
1657355313072,MATH 142A,B04,093558,Chow; Bennett,13,0,32,19
1657355313072,MATH 142A,B05,093559,Chow; Bennett,6,0,32,26
1657355319106,MATH 193A,A01,083224,Rotar; Vladimir,8,0,34,26
1657355319106,MATH 193A,A02,083225,Rotar; Vladimir,9,0,34,25
1657355319106,MATH 193A,A03,083781,Rotar; Vladimir,5,0,34,29
1657355319106,MATH 193A,A04,083782,Rotar; Vladimir,10,0,34,24
1657355319106,MATH 193A,A05,093482,Rotar; Vladimir,10,0,34,24
1657355325136,MATH 197,001,091859,McAuley; Julian John,9999,0,9999,0
1657355325136,MATH 197,002,095566,Kedlaya; Kiran S.,9997,0,9999,2
1657355325136,MATH 197,003,095567,Xiao; Ming,9999,0,9999,0
1657355325136,MATH 197,004,095571,Perols; Johan Lars,9998,0,9999,1
1657355332205,COGS 9,A01,083615,Shannon; Kyle Michael,8,0,75,67
1657355338235,COGS 11,A01,083617,Boyle; Mary E. T.,22,0,48,26
1657355344265,COGS 13,A01,083071,Bastos; Amalia Pinkusfeld,11,0,71,60
1657355350293,COGS 14A,A01,092681,Semenuks; Arturs,4,1,100,96
1657355356319,COGS 14B,A01,083073,Cheng; Tzu-Han,6,0,63,57
1657355362347,COGS 17,A01,092677,Semenuks; Arturs,6,0,81,75
1657355368380,COGS 100,A01,083619,Allen; Michael Gordon,17,0,70,53
1657355374410,COGS 101A,A01,083621,Davis; Joshua Daniel,9,0,68,59
1657355380435,COGS 101B,A01,091572,Allen; Michael Gordon,11,0,65,54
1657355386533,COGS 101C,A01,083625,Delgado; Tania,17,0,35,18
1657355392563,COGS 107A,A01,083627,Boyle; Mary E. T.,13,0,60,47
1657355398596,COGS 118A,A01,083075,Gupta; Anjum,20,0,76,56
1657355404622,CSE 3,A50,083646,Miranda; Gregory Joseph,24,0,50,26
1657355410651,CSE 8A,A50,083650,Miranda; Gregory Joseph,17,1,56,39
1657355416680,CSE 11,A01,083080,Cao; Yingjun,6,15,40,34
1657355422705,CSE 12,A01,083652,Krause-Levy; Sophia Louisa,28,1,120,92
1657355428728,CSE 15L,A01,083654,Morris; Justin Loren,9,0,50,41
1657355428728,CSE 15L,A02,083655,Morris; Justin Loren,9,0,50,41
1657355434755,CSE 20,A01,083657,Tran; Khoa Dang,39,0,80,41
1657355440781,CSE 21,A01,095574,Bach; Quang Tran,22,0,48,26
1657355446807,CSE 30,A01,083084,Eldon; John,4,0,80,76
1657355446807,CSE 30,B01,095061,Bhaskar; Nishant,9,0,50,41
1657355452831,CSE 100,A01,083659,Cao; Yingjun,5,4,70,65
1657355458855,CSE 134B,A01,083661,Powell; Thomas Allan,22,0,100,78
1657355464884,CSE 140,A01,083663,Gungor; Onat,14,0,85,71
1657355470913,CSE 140L,A01,083088,Eldon; John,21,0,100,79
1657355476949,CSE 175,A01,083665,Kumar; Rakesh,3,0,25,22
1657355482981,CSE 190,A00,092507,Dubnov; Shlomo,7,0,20,13
1657355489008,ECE 45,A01,083139,Congero; Spencer William,6,0,75,69
1657355495035,ECE 65,A50,083695,Saad; Andrew S,12,0,30,18
1657355495035,ECE 65,A51,095125,Saad; Andrew S,24,0,26,2
1657355501065,ECE 109,A01,091882,Touri; Behrouz,19,0,70,51
1657355507091,ECE 180,A00,083140,Abi Samra; Nicholas Camill,1,0,30,29
1657355507091,ECE 180,B00,083141,Abi Samra; Nicholas Camill,0,0,30,30
1657355513118,MATH 10A,A01,083735,Patchell; Gregory David,2,0,30,28
1657355513118,MATH 10A,A02,083736,Patchell; Gregory David,20,0,30,10
1657355513118,MATH 10A,A03,083737,Patchell; Gregory David,16,0,30,14
1657355519148,MATH 10B,A01,083207,Lim; Seonhee,8,0,34,26
1657355519148,MATH 10B,A02,083208,Lim; Seonhee,9,0,35,26
1657355519148,MATH 10B,A03,093472,Lim; Seonhee,7,0,34,27
1657355519148,MATH 10B,B01,083739,Sinha; Shubham,12,0,30,18
1657355525182,MATH 18,A01,083743,Cinel; Cameron Alexander,7,0,30,23
1657355525182,MATH 18,A02,083744,Cinel; Cameron Alexander,17,0,30,13
1657355525182,MATH 18,A03,083745,Cinel; Cameron Alexander,9,0,30,21
1657355525182,MATH 18,B01,083748,Rideout; David Porter,5,0,37,32
1657355525182,MATH 18,B02,083749,Rideout; David Porter,5,0,36,31
1657355525182,MATH 18,B03,083750,Rideout; David Porter,3,0,37,34
1657355525182,MATH 18,B04,083751,Rideout; David Porter,6,0,36,30
1657355525182,MATH 18,B05,093473,Rideout; David Porter,6,0,36,30
1657355525182,MATH 18,B06,093474,Rideout; David Porter,6,0,36,30
1657355531213,MATH 20A,A01,083754,Zheng; Zequn,14,0,40,26
1657355537238,MATH 20B,A01,083756,Briones; Jor-el Thomas Caparas,4,0,36,32
1657355537238,MATH 20B,A02,083757,Briones; Jor-el Thomas Caparas,1,0,36,35
1657355537238,MATH 20B,A03,093475,Briones; Jor-el Thomas Caparas,2,0,36,34
1657355543267,MATH 20C,A01,083760,Briones; Jor-el Thomas Caparas,1,0,35,34
1657355543267,MATH 20C,A02,083761,Briones; Jor-el Thomas Caparas,8,0,35,27
1657355543267,MATH 20C,A03,093476,Briones; Jor-el Thomas Caparas,0,1,36,36
1657355543267,MATH 20C,B01,083762,Bach; Quang Tran,1,0,30,29
1657355549291,MATH 20D,A01,083765,Tran; Brian Kha,5,0,30,25
1657355549291,MATH 20D,A02,083766,Tran; Brian Kha,5,0,30,25
1657355549291,MATH 20D,A03,083767,Tran; Brian Kha,5,0,30,25
1657355555330,MATH 20E,A01,083771,Ganguly; Soumya,9,0,32,23
1657355555330,MATH 20E,A02,083772,Ganguly; Soumya,6,0,32,26
1657355555330,MATH 20E,B01,083773,Ciotti; Benjamin,20,0,35,15
1657355555330,MATH 20E,B02,083774,Ciotti; Benjamin,17,0,35,18
1657355561369,MATH 103A,A01,083777,Greenfeld; Be'Eri,3,0,36,33
1657355561369,MATH 103A,A02,083778,Greenfeld; Be'Eri,5,0,36,31
1657355561369,MATH 103A,A03,093561,Greenfeld; Be'Eri,5,0,36,31
1657355561369,MATH 103A,B01,083779,Greenfeld; Be'Eri,7,0,36,29
1657355561369,MATH 103A,B02,083780,Greenfeld; Be'Eri,4,0,36,32
1657355561369,MATH 103A,B03,093562,Greenfeld; Be'Eri,3,0,36,33
1657355567395,MATH 105,A01,085443,Carter; Anne Toulson,15,0,35,20
1657355567395,MATH 105,A02,093477,Carter; Anne Toulson,20,0,35,15
1657355573427,MATH 109,A01,083213,Ganzberger; Geoffrey Michael,2,0,34,32
1657355573427,MATH 109,A02,083214,Ganzberger; Geoffrey Michael,4,0,34,30
1657355573427,MATH 109,A03,093478,Ganzberger; Geoffrey Michael,2,0,34,32
1657355573427,MATH 109,B01,083215,Ganzberger; Geoffrey Michael,1,0,32,31
1657355573427,MATH 109,B02,083216,Ganzberger; Geoffrey Michael,2,0,32,30
1657355573427,MATH 109,B03,093479,Ganzberger; Geoffrey Michael,8,0,32,24
1657355579452,MATH 142A,A01,083219,Chow; Bennett,7,0,32,25
1657355579452,MATH 142A,A02,083220,Chow; Bennett,10,0,32,22
1657355579452,MATH 142A,A03,093480,Chow; Bennett,8,0,32,24
1657355579452,MATH 142A,B03,093481,Chow; Bennett,8,0,32,24
1657355579452,MATH 142A,B04,093558,Chow; Bennett,13,0,32,19
1657355579452,MATH 142A,B05,093559,Chow; Bennett,6,0,32,26
1657355585487,MATH 193A,A01,083224,Rotar; Vladimir,8,0,34,26
1657355585487,MATH 193A,A02,083225,Rotar; Vladimir,9,0,34,25
1657355585487,MATH 193A,A03,083781,Rotar; Vladimir,5,0,34,29
1657355585487,MATH 193A,A04,083782,Rotar; Vladimir,10,0,34,24
1657355585487,MATH 193A,A05,093482,Rotar; Vladimir,10,0,34,24
1657355591512,MATH 197,001,091859,McAuley; Julian John,9999,0,9999,0
1657355591512,MATH 197,002,095566,Kedlaya; Kiran S.,9997,0,9999,2
1657355591512,MATH 197,003,095567,Xiao; Ming,9999,0,9999,0
1657355591512,MATH 197,004,095571,Perols; Johan Lars,9998,0,9999,1
1657355598588,COGS 9,A01,083615,Shannon; Kyle Michael,8,0,75,67
1657355604612,COGS 11,A01,083617,Boyle; Mary E. T.,22,0,48,26
1657355610652,COGS 13,A01,083071,Bastos; Amalia Pinkusfeld,11,0,71,60
1657355616676,COGS 14A,A01,092681,Semenuks; Arturs,4,1,100,96
1657355622705,COGS 14B,A01,083073,Cheng; Tzu-Han,6,0,63,57
1657355628730,COGS 17,A01,092677,Semenuks; Arturs,6,0,81,75
1657355634758,COGS 100,A01,083619,Allen; Michael Gordon,17,0,70,53
1657355640783,COGS 101A,A01,083621,Davis; Joshua Daniel,9,0,68,59
1657355646811,COGS 101B,A01,091572,Allen; Michael Gordon,11,0,65,54
1657355652839,COGS 101C,A01,083625,Delgado; Tania,17,0,35,18
1657355658869,COGS 107A,A01,083627,Boyle; Mary E. T.,13,0,60,47
1657355664895,COGS 118A,A01,083075,Gupta; Anjum,20,0,76,56
1657355670931,CSE 3,A50,083646,Miranda; Gregory Joseph,24,0,50,26
1657355676963,CSE 8A,A50,083650,Miranda; Gregory Joseph,17,1,56,39
1657355682991,CSE 11,A01,083080,Cao; Yingjun,6,15,40,34
1657355689024,CSE 12,A01,083652,Krause-Levy; Sophia Louisa,28,1,120,92
1657355695049,CSE 15L,A01,083654,Morris; Justin Loren,9,0,50,41
1657355695049,CSE 15L,A02,083655,Morris; Justin Loren,9,0,50,41
1657355701074,CSE 20,A01,083657,Tran; Khoa Dang,39,0,80,41
1657355707131,CSE 21,A01,095574,Bach; Quang Tran,22,0,48,26
1657355713157,CSE 30,A01,083084,Eldon; John,4,0,80,76
1657355713157,CSE 30,B01,095061,Bhaskar; Nishant,9,0,50,41
1657355719189,CSE 100,A01,083659,Cao; Yingjun,5,4,70,65
1657355725212,CSE 134B,A01,083661,Powell; Thomas Allan,22,0,100,78
1657355731243,CSE 140,A01,083663,Gungor; Onat,14,0,85,71
1657355737267,CSE 140L,A01,083088,Eldon; John,21,0,100,79
1657355743293,CSE 175,A01,083665,Kumar; Rakesh,3,0,25,22
1657355749318,CSE 190,A00,092507,Dubnov; Shlomo,7,0,20,13
1657355755344,ECE 45,A01,083139,Congero; Spencer William,6,0,75,69
1657355761371,ECE 65,A50,083695,Saad; Andrew S,12,0,30,18
1657355761371,ECE 65,A51,095125,Saad; Andrew S,24,0,26,2
1657355767396,ECE 109,A01,091882,Touri; Behrouz,19,0,70,51
1657355773422,ECE 180,A00,083140,Abi Samra; Nicholas Camill,1,0,30,29
1657355773422,ECE 180,B00,083141,Abi Samra; Nicholas Camill,0,0,30,30
1657355779448,MATH 10A,A01,083735,Patchell; Gregory David,2,0,30,28
1657355779448,MATH 10A,A02,083736,Patchell; Gregory David,20,0,30,10
1657355779448,MATH 10A,A03,083737,Patchell; Gregory David,16,0,30,14
1657355785489,MATH 10B,A01,083207,Lim; Seonhee,8,0,34,26
1657355785489,MATH 10B,A02,083208,Lim; Seonhee,9,0,35,26
1657355785489,MATH 10B,A03,093472,Lim; Seonhee,7,0,34,27
1657355785489,MATH 10B,B01,083739,Sinha; Shubham,12,0,30,18
1657355791517,MATH 18,A01,083743,Cinel; Cameron Alexander,7,0,30,23
1657355791517,MATH 18,A02,083744,Cinel; Cameron Alexander,17,0,30,13
1657355791517,MATH 18,A03,083745,Cinel; Cameron Alexander,9,0,30,21
1657355791517,MATH 18,B01,083748,Rideout; David Porter,5,0,37,32
1657355791517,MATH 18,B02,083749,Rideout; David Porter,5,0,36,31
1657355791517,MATH 18,B03,083750,Rideout; David Porter,3,0,37,34
1657355791517,MATH 18,B04,083751,Rideout; David Porter,6,0,36,30
1657355791517,MATH 18,B05,093473,Rideout; David Porter,6,0,36,30
1657355791517,MATH 18,B06,093474,Rideout; David Porter,6,0,36,30
1657355797545,MATH 20A,A01,083754,Zheng; Zequn,14,0,40,26
1657355803572,MATH 20B,A01,083756,Briones; Jor-el Thomas Caparas,4,0,36,32
1657355803572,MATH 20B,A02,083757,Briones; Jor-el Thomas Caparas,1,0,36,35
1657355803572,MATH 20B,A03,093475,Briones; Jor-el Thomas Caparas,2,0,36,34
1657355809608,MATH 20C,A01,083760,Briones; Jor-el Thomas Caparas,1,0,35,34
1657355809608,MATH 20C,A02,083761,Briones; Jor-el Thomas Caparas,8,0,35,27
1657355809608,MATH 20C,A03,093476,Briones; Jor-el Thomas Caparas,0,1,36,36
1657355809608,MATH 20C,B01,083762,Bach; Quang Tran,1,0,30,29
1657355815640,MATH 20D,A01,083765,Tran; Brian Kha,5,0,30,25
1657355815640,MATH 20D,A02,083766,Tran; Brian Kha,5,0,30,25
1657355815640,MATH 20D,A03,083767,Tran; Brian Kha,5,0,30,25
1657355821669,MATH 20E,A01,083771,Ganguly; Soumya,9,0,32,23
1657355821669,MATH 20E,A02,083772,Ganguly; Soumya,6,0,32,26
1657355821669,MATH 20E,B01,083773,Ciotti; Benjamin,20,0,35,15
1657355821669,MATH 20E,B02,083774,Ciotti; Benjamin,17,0,35,18
1657355827695,MATH 103A,A01,083777,Greenfeld; Be'Eri,3,0,36,33
1657355827695,MATH 103A,A02,083778,Greenfeld; Be'Eri,5,0,36,31
1657355827695,MATH 103A,A03,093561,Greenfeld; Be'Eri,5,0,36,31
1657355827695,MATH 103A,B01,083779,Greenfeld; Be'Eri,7,0,36,29
1657355827695,MATH 103A,B02,083780,Greenfeld; Be'Eri,4,0,36,32
1657355827695,MATH 103A,B03,093562,Greenfeld; Be'Eri,3,0,36,33
1657355833728,MATH 105,A01,085443,Carter; Anne Toulson,15,0,35,20
1657355833728,MATH 105,A02,093477,Carter; Anne Toulson,20,0,35,15
1657355839753,MATH 109,A01,083213,Ganzberger; Geoffrey Michael,2,0,34,32
1657355839753,MATH 109,A02,083214,Ganzberger; Geoffrey Michael,4,0,34,30
1657355839753,MATH 109,A03,093478,Ganzberger; Geoffrey Michael,2,0,34,32
1657355839753,MATH 109,B01,083215,Ganzberger; Geoffrey Michael,1,0,32,31
1657355839753,MATH 109,B02,083216,Ganzberger; Geoffrey Michael,2,0,32,30
1657355839753,MATH 109,B03,093479,Ganzberger; Geoffrey Michael,8,0,32,24
1657355845781,MATH 142A,A01,083219,Chow; Bennett,7,0,32,25
1657355845781,MATH 142A,A02,083220,Chow; Bennett,10,0,32,22
1657355845781,MATH 142A,A03,093480,Chow; Bennett,8,0,32,24
1657355845781,MATH 142A,B03,093481,Chow; Bennett,8,0,32,24
1657355845781,MATH 142A,B04,093558,Chow; Bennett,13,0,32,19
1657355845781,MATH 142A,B05,093559,Chow; Bennett,6,0,32,26
1657355851806,MATH 193A,A01,083224,Rotar; Vladimir,8,0,34,26
1657355851806,MATH 193A,A02,083225,Rotar; Vladimir,9,0,34,25
1657355851806,MATH 193A,A03,083781,Rotar; Vladimir,5,0,34,29
1657355851806,MATH 193A,A04,083782,Rotar; Vladimir,10,0,34,24
1657355851806,MATH 193A,A05,093482,Rotar; Vladimir,10,0,34,24
1657355857841,MATH 197,001,091859,McAuley; Julian John,9999,0,9999,0
1657355857841,MATH 197,002,095566,Kedlaya; Kiran S.,9997,0,9999,2
1657355857841,MATH 197,003,095567,Xiao; Ming,9999,0,9999,0
1657355857841,MATH 197,004,095571,Perols; Johan Lars,9998,0,9999,1
1657355864918,COGS 9,A01,083615,Shannon; Kyle Michael,8,0,75,67
1657355870943,COGS 11,A01,083617,Boyle; Mary E. T.,22,0,48,26
1657355876967,COGS 13,A01,083071,Bastos; Amalia Pinkusfeld,11,0,71,60
1657355883004,COGS 14A,A01,092681,Semenuks; Arturs,4,1,100,96
1657355889032,COGS 14B,A01,083073,Cheng; Tzu-Han,6,0,63,57
1657355895058,COGS 17,A01,092677,Semenuks; Arturs,6,0,81,75
1657355901084,COGS 100,A01,083619,Allen; Michael Gordon,17,0,70,53
1657355907114,COGS 101A,A01,083621,Davis; Joshua Daniel,9,0,68,59
1657355913138,COGS 101B,A01,091572,Allen; Michael Gordon,11,0,65,54
1657355919169,COGS 101C,A01,083625,Delgado; Tania,17,0,35,18
1657355925193,COGS 107A,A01,083627,Boyle; Mary E. T.,13,0,60,47
1657355931218,COGS 118A,A01,083075,Gupta; Anjum,20,0,76,56
1657355937246,CSE 3,A50,083646,Miranda; Gregory Joseph,24,0,50,26
1657355943275,CSE 8A,A50,083650,Miranda; Gregory Joseph,17,1,56,39
1657355949300,CSE 11,A01,083080,Cao; Yingjun,6,15,40,34
1657355955325,CSE 12,A01,083652,Krause-Levy; Sophia Louisa,28,1,120,92
1657355961350,CSE 15L,A01,083654,Morris; Justin Loren,9,0,50,41
1657355961350,CSE 15L,A02,083655,Morris; Justin Loren,9,0,50,41
1657355967375,CSE 20,A01,083657,Tran; Khoa Dang,39,0,80,41
1657355973402,CSE 21,A01,095574,Bach; Quang Tran,22,0,48,26
1657355979436,CSE 30,A01,083084,Eldon; John,4,0,80,76
1657355979436,CSE 30,B01,095061,Bhaskar; Nishant,9,0,50,41
1657355985548,CSE 100,A01,083659,Cao; Yingjun,5,4,70,65
1657355991572,CSE 134B,A01,083661,Powell; Thomas Allan,22,0,100,78
1657355997601,CSE 140,A01,083663,Gungor; Onat,14,0,85,71
1657356003625,CSE 140L,A01,083088,Eldon; John,21,0,100,79
1657356009654,CSE 175,A01,083665,Kumar; Rakesh,3,0,25,22
1657356015692,CSE 190,A00,092507,Dubnov; Shlomo,7,0,20,13
1657356021716,ECE 45,A01,083139,Congero; Spencer William,6,0,75,69
1657356027747,ECE 65,A50,083695,Saad; Andrew S,12,0,30,18
1657356027747,ECE 65,A51,095125,Saad; Andrew S,24,0,26,2
1657356033771,ECE 109,A01,091882,Touri; Behrouz,19,0,70,51
1657356039795,ECE 180,A00,083140,Abi Samra; Nicholas Camill,1,0,30,29
1657356039795,ECE 180,B00,083141,Abi Samra; Nicholas Camill,0,0,30,30
1657356045823,MATH 10A,A01,083735,Patchell; Gregory David,2,0,30,28
1657356045823,MATH 10A,A02,083736,Patchell; Gregory David,20,0,30,10
1657356045823,MATH 10A,A03,083737,Patchell; Gregory David,16,0,30,14
1657356051860,MATH 10B,A01,083207,Lim; Seonhee,8,0,34,26
1657356051860,MATH 10B,A02,083208,Lim; Seonhee,9,0,35,26
1657356051860,MATH 10B,A03,093472,Lim; Seonhee,7,0,34,27
1657356051860,MATH 10B,B01,083739,Sinha; Shubham,12,0,30,18
1657356057905,MATH 18,A01,083743,Cinel; Cameron Alexander,7,0,30,23
1657356057905,MATH 18,A02,083744,Cinel; Cameron Alexander,17,0,30,13
1657356057905,MATH 18,A03,083745,Cinel; Cameron Alexander,9,0,30,21
1657356057905,MATH 18,B01,083748,Rideout; David Porter,5,0,37,32
1657356057905,MATH 18,B02,083749,Rideout; David Porter,5,0,36,31
1657356057905,MATH 18,B03,083750,Rideout; David Porter,3,0,37,34
1657356057905,MATH 18,B04,083751,Rideout; David Porter,6,0,36,30
1657356057905,MATH 18,B05,093473,Rideout; David Porter,6,0,36,30
1657356057905,MATH 18,B06,093474,Rideout; David Porter,6,0,36,30
1657356063932,MATH 20A,A01,083754,Zheng; Zequn,14,0,40,26
1657356069958,MATH 20B,A01,083756,Briones; Jor-el Thomas Caparas,4,0,36,32
1657356069958,MATH 20B,A02,083757,Briones; Jor-el Thomas Caparas,1,0,36,35
1657356069958,MATH 20B,A03,093475,Briones; Jor-el Thomas Caparas,2,0,36,34
1657356075984,MATH 20C,A01,083760,Briones; Jor-el Thomas Caparas,1,0,35,34
1657356075984,MATH 20C,A02,083761,Briones; Jor-el Thomas Caparas,8,0,35,27
1657356075984,MATH 20C,A03,093476,Briones; Jor-el Thomas Caparas,0,1,36,36
1657356075984,MATH 20C,B01,083762,Bach; Quang Tran,1,0,30,29
1657356082009,MATH 20D,A01,083765,Tran; Brian Kha,5,0,30,25
1657356082009,MATH 20D,A02,083766,Tran; Brian Kha,5,0,30,25
1657356082009,MATH 20D,A03,083767,Tran; Brian Kha,5,0,30,25
1657356088041,MATH 20E,A01,083771,Ganguly; Soumya,9,0,32,23
1657356088041,MATH 20E,A02,083772,Ganguly; Soumya,6,0,32,26
1657356088041,MATH 20E,B01,083773,Ciotti; Benjamin,20,0,35,15
1657356088041,MATH 20E,B02,083774,Ciotti; Benjamin,17,0,35,18
1657356094078,MATH 103A,A01,083777,Greenfeld; Be'Eri,3,0,36,33
1657356094078,MATH 103A,A02,083778,Greenfeld; Be'Eri,5,0,36,31
1657356094078,MATH 103A,A03,093561,Greenfeld; Be'Eri,5,0,36,31
1657356094078,MATH 103A,B01,083779,Greenfeld; Be'Eri,7,0,36,29
1657356094078,MATH 103A,B02,083780,Greenfeld; Be'Eri,4,0,36,32
1657356094078,MATH 103A,B03,093562,Greenfeld; Be'Eri,3,0,36,33
1657356100104,MATH 105,A01,085443,Carter; Anne Toulson,15,0,35,20
1657356100104,MATH 105,A02,093477,Carter; Anne Toulson,20,0,35,15
1657356106133,MATH 109,A01,083213,Ganzberger; Geoffrey Michael,2,0,34,32
1657356106133,MATH 109,A02,083214,Ganzberger; Geoffrey Michael,4,0,34,30
1657356106133,MATH 109,A03,093478,Ganzberger; Geoffrey Michael,2,0,34,32
1657356106133,MATH 109,B01,083215,Ganzberger; Geoffrey Michael,1,0,32,31
1657356106133,MATH 109,B02,083216,Ganzberger; Geoffrey Michael,2,0,32,30
1657356106133,MATH 109,B03,093479,Ganzberger; Geoffrey Michael,8,0,32,24
1657356112166,MATH 142A,A01,083219,Chow; Bennett,7,0,32,25
1657356112166,MATH 142A,A02,083220,Chow; Bennett,10,0,32,22
1657356112166,MATH 142A,A03,093480,Chow; Bennett,8,0,32,24
1657356112166,MATH 142A,B03,093481,Chow; Bennett,8,0,32,24
1657356112166,MATH 142A,B04,093558,Chow; Bennett,13,0,32,19
1657356112166,MATH 142A,B05,093559,Chow; Bennett,6,0,32,26
1657356118192,MATH 193A,A01,083224,Rotar; Vladimir,8,0,34,26
1657356118192,MATH 193A,A02,083225,Rotar; Vladimir,9,0,34,25
1657356118192,MATH 193A,A03,083781,Rotar; Vladimir,5,0,34,29
1657356118192,MATH 193A,A04,083782,Rotar; Vladimir,10,0,34,24
1657356118192,MATH 193A,A05,093482,Rotar; Vladimir,10,0,34,24
1657356124220,MATH 197,001,091859,McAuley; Julian John,9999,0,9999,0
1657356124220,MATH 197,002,095566,Kedlaya; Kiran S.,9997,0,9999,2
1657356124220,MATH 197,003,095567,Xiao; Ming,9999,0,9999,0
1657356124220,MATH 197,004,095571,Perols; Johan Lars,9998,0,9999,1
1657356131298,COGS 9,A01,083615,Shannon; Kyle Michael,8,0,75,67
1657356137322,COGS 11,A01,083617,Boyle; Mary E. T.,22,0,48,26
1657356143349,COGS 13,A01,083071,Bastos; Amalia Pinkusfeld,11,0,71,60
1657356149374,COGS 14A,A01,092681,Semenuks; Arturs,4,1,100,96
1657356155400,COGS 14B,A01,083073,Cheng; Tzu-Han,6,0,63,57
1657356161423,COGS 17,A01,092677,Semenuks; Arturs,6,0,81,75
1657356167448,COGS 100,A01,083619,Allen; Michael Gordon,17,0,70,53
1657356173475,COGS 101A,A01,083621,Davis; Joshua Daniel,9,0,68,59
1657356179500,COGS 101B,A01,091572,Allen; Michael Gordon,11,0,65,54
1657356185526,COGS 101C,A01,083625,Delgado; Tania,17,0,35,18
1657356191550,COGS 107A,A01,083627,Boyle; Mary E. T.,13,0,60,47
1657356197580,COGS 118A,A01,083075,Gupta; Anjum,20,0,76,56
1657356203616,CSE 3,A50,083646,Miranda; Gregory Joseph,24,0,50,26
1657356209646,CSE 8A,A50,083650,Miranda; Gregory Joseph,17,1,56,39
1657356215678,CSE 11,A01,083080,Cao; Yingjun,6,15,40,34
1657356221711,CSE 12,A01,083652,Krause-Levy; Sophia Louisa,28,1,120,92
1657356227737,CSE 15L,A01,083654,Morris; Justin Loren,9,0,50,41
1657356227737,CSE 15L,A02,083655,Morris; Justin Loren,9,0,50,41
1657356233763,CSE 20,A01,083657,Tran; Khoa Dang,39,0,80,41
1657356239788,CSE 21,A01,095574,Bach; Quang Tran,22,0,48,26
1657356245814,CSE 30,A01,083084,Eldon; John,4,0,80,76
1657356245814,CSE 30,B01,095061,Bhaskar; Nishant,9,0,50,41
1657356251838,CSE 100,A01,083659,Cao; Yingjun,5,4,70,65
1657356257866,CSE 134B,A01,083661,Powell; Thomas Allan,22,0,100,78
1657356263890,CSE 140,A01,083663,Gungor; Onat,14,0,85,71
1657356269920,CSE 140L,A01,083088,Eldon; John,21,0,100,79
1657356275950,CSE 175,A01,083665,Kumar; Rakesh,3,0,25,22
1657356281973,CSE 190,A00,092507,Dubnov; Shlomo,7,0,20,13
1657356288001,ECE 45,A01,083139,Congero; Spencer William,6,0,75,69
1657356294046,ECE 65,A50,083695,Saad; Andrew S,12,0,30,18
1657356294046,ECE 65,A51,095125,Saad; Andrew S,24,0,26,2
1657356300076,ECE 109,A01,091882,Touri; Behrouz,19,0,70,51
1657356306100,ECE 180,A00,083140,Abi Samra; Nicholas Camill,1,0,30,29
1657356306100,ECE 180,B00,083141,Abi Samra; Nicholas Camill,0,0,30,30
1657356312126,MATH 10A,A01,083735,Patchell; Gregory David,2,0,30,28
1657356312126,MATH 10A,A02,083736,Patchell; Gregory David,20,0,30,10
1657356312126,MATH 10A,A03,083737,Patchell; Gregory David,16,0,30,14
1657356318166,MATH 10B,A01,083207,Lim; Seonhee,8,0,34,26
1657356318166,MATH 10B,A02,083208,Lim; Seonhee,9,0,35,26
1657356318166,MATH 10B,A03,093472,Lim; Seonhee,7,0,34,27
1657356318166,MATH 10B,B01,083739,Sinha; Shubham,12,0,30,18
1657356324193,MATH 18,A01,083743,Cinel; Cameron Alexander,7,0,30,23
1657356324193,MATH 18,A02,083744,Cinel; Cameron Alexander,17,0,30,13
1657356324193,MATH 18,A03,083745,Cinel; Cameron Alexander,9,0,30,21
1657356324193,MATH 18,B01,083748,Rideout; David Porter,5,0,37,32
1657356324193,MATH 18,B02,083749,Rideout; David Porter,5,0,36,31
1657356324193,MATH 18,B03,083750,Rideout; David Porter,3,0,37,34
1657356324193,MATH 18,B04,083751,Rideout; David Porter,6,0,36,30
1657356324193,MATH 18,B05,093473,Rideout; David Porter,6,0,36,30
1657356324193,MATH 18,B06,093474,Rideout; David Porter,6,0,36,30
1657356330227,MATH 20A,A01,083754,Zheng; Zequn,14,0,40,26
1657356336262,MATH 20B,A01,083756,Briones; Jor-el Thomas Caparas,4,0,36,32
1657356336262,MATH 20B,A02,083757,Briones; Jor-el Thomas Caparas,1,0,36,35
1657356336262,MATH 20B,A03,093475,Briones; Jor-el Thomas Caparas,2,0,36,34
1657356342289,MATH 20C,A01,083760,Briones; Jor-el Thomas Caparas,1,0,35,34
1657356342289,MATH 20C,A02,083761,Briones; Jor-el Thomas Caparas,8,0,35,27
1657356342289,MATH 20C,A03,093476,Briones; Jor-el Thomas Caparas,0,1,36,36
1657356342289,MATH 20C,B01,083762,Bach; Quang Tran,1,0,30,29
1657356348315,MATH 20D,A01,083765,Tran; Brian Kha,5,0,30,25
1657356348315,MATH 20D,A02,083766,Tran; Brian Kha,5,0,30,25
1657356348315,MATH 20D,A03,083767,Tran; Brian Kha,5,0,30,25
1657356354349,MATH 20E,A01,083771,Ganguly; Soumya,9,0,32,23
1657356354349,MATH 20E,A02,083772,Ganguly; Soumya,6,0,32,26
1657356354349,MATH 20E,B01,083773,Ciotti; Benjamin,20,0,35,15
1657356354349,MATH 20E,B02,083774,Ciotti; Benjamin,17,0,35,18
1657356360386,MATH 103A,A01,083777,Greenfeld; Be'Eri,3,0,36,33
1657356360386,MATH 103A,A02,083778,Greenfeld; Be'Eri,5,0,36,31
1657356360386,MATH 103A,A03,093561,Greenfeld; Be'Eri,5,0,36,31
1657356360386,MATH 103A,B01,083779,Greenfeld; Be'Eri,7,0,36,29
1657356360386,MATH 103A,B02,083780,Greenfeld; Be'Eri,4,0,36,32
1657356360386,MATH 103A,B03,093562,Greenfeld; Be'Eri,3,0,36,33
1657356366433,MATH 105,A01,085443,Carter; Anne Toulson,15,0,35,20
1657356366433,MATH 105,A02,093477,Carter; Anne Toulson,20,0,35,15
1657356372459,MATH 109,A01,083213,Ganzberger; Geoffrey Michael,2,0,34,32
1657356372459,MATH 109,A02,083214,Ganzberger; Geoffrey Michael,4,0,34,30
1657356372459,MATH 109,A03,093478,Ganzberger; Geoffrey Michael,2,0,34,32
1657356372459,MATH 109,B01,083215,Ganzberger; Geoffrey Michael,1,0,32,31
1657356372459,MATH 109,B02,083216,Ganzberger; Geoffrey Michael,2,0,32,30
1657356372459,MATH 109,B03,093479,Ganzberger; Geoffrey Michael,8,0,32,24
1657356378485,MATH 142A,A01,083219,Chow; Bennett,7,0,32,25
1657356378485,MATH 142A,A02,083220,Chow; Bennett,10,0,32,22
1657356378485,MATH 142A,A03,093480,Chow; Bennett,8,0,32,24
1657356378485,MATH 142A,B03,093481,Chow; Bennett,8,0,32,24
1657356378485,MATH 142A,B04,093558,Chow; Bennett,13,0,32,19
1657356378485,MATH 142A,B05,093559,Chow; Bennett,6,0,32,26
1657356384509,MATH 193A,A01,083224,Rotar; Vladimir,8,0,34,26
1657356384509,MATH 193A,A02,083225,Rotar; Vladimir,9,0,34,25
1657356384509,MATH 193A,A03,083781,Rotar; Vladimir,5,0,34,29
1657356384509,MATH 193A,A04,083782,Rotar; Vladimir,10,0,34,24
1657356384509,MATH 193A,A05,093482,Rotar; Vladimir,10,0,34,24
1657356390538,MATH 197,001,091859,McAuley; Julian John,9999,0,9999,0
1657356390538,MATH 197,002,095566,Kedlaya; Kiran S.,9997,0,9999,2
1657356390538,MATH 197,003,095567,Xiao; Ming,9999,0,9999,0
1657356390538,MATH 197,004,095571,Perols; Johan Lars,9998,0,9999,1
1657356397610,COGS 9,A01,083615,Shannon; Kyle Michael,8,0,75,67
1657356403638,COGS 11,A01,083617,Boyle; Mary E. T.,22,0,48,26
1657356409663,COGS 13,A01,083071,Bastos; Amalia Pinkusfeld,11,0,71,60
1657356415688,COGS 14A,A01,092681,Semenuks; Arturs,4,1,100,96
1657356421725,COGS 14B,A01,083073,Cheng; Tzu-Han,6,0,63,57
1657356427752,COGS 17,A01,092677,Semenuks; Arturs,6,0,81,75
1657356433781,COGS 100,A01,083619,Allen; Michael Gordon,17,0,70,53
1657356439810,COGS 101A,A01,083621,Davis; Joshua Daniel,9,0,68,59
1657356445838,COGS 101B,A01,091572,Allen; Michael Gordon,11,0,65,54
1657356451869,COGS 101C,A01,083625,Delgado; Tania,17,0,35,18
1657356457907,COGS 107A,A01,083627,Boyle; Mary E. T.,13,0,60,47
1657356463932,COGS 118A,A01,083075,Gupta; Anjum,20,0,76,56
1657356469958,CSE 3,A50,083646,Miranda; Gregory Joseph,24,0,50,26
1657356476002,CSE 8A,A50,083650,Miranda; Gregory Joseph,17,1,56,39
1657356482031,CSE 11,A01,083080,Cao; Yingjun,6,15,40,34
1657356488058,CSE 12,A01,083652,Krause-Levy; Sophia Louisa,28,1,120,92
1657356494083,CSE 15L,A01,083654,Morris; Justin Loren,9,0,50,41
1657356494083,CSE 15L,A02,083655,Morris; Justin Loren,9,0,50,41
1657356500112,CSE 20,A01,083657,Tran; Khoa Dang,39,0,80,41
1657356506138,CSE 21,A01,095574,Bach; Quang Tran,22,0,48,26
1657356512170,CSE 30,A01,083084,Eldon; John,4,0,80,76
1657356512170,CSE 30,B01,095061,Bhaskar; Nishant,9,0,50,41
1657356518196,CSE 100,A01,083659,Cao; Yingjun,5,4,70,65
1657356524239,CSE 134B,A01,083661,Powell; Thomas Allan,22,0,100,78
1657356530265,CSE 140,A01,083663,Gungor; Onat,14,0,85,71
1657356536288,CSE 140L,A01,083088,Eldon; John,21,0,100,79
1657356542315,CSE 175,A01,083665,Kumar; Rakesh,3,0,25,22
1657356548341,CSE 190,A00,092507,Dubnov; Shlomo,7,0,20,13
1657356554368,ECE 45,A01,083139,Congero; Spencer William,6,0,75,69
1657356560396,ECE 65,A50,083695,Saad; Andrew S,12,0,30,18
1657356560396,ECE 65,A51,095125,Saad; Andrew S,24,0,26,2
1657356566423,ECE 109,A01,091882,Touri; Behrouz,19,0,70,51
1657356572448,ECE 180,A00,083140,Abi Samra; Nicholas Camill,1,0,30,29
1657356572448,ECE 180,B00,083141,Abi Samra; Nicholas Camill,0,0,30,30
1657356578486,MATH 10A,A01,083735,Patchell; Gregory David,2,0,30,28
1657356578486,MATH 10A,A02,083736,Patchell; Gregory David,20,0,30,10
1657356578486,MATH 10A,A03,083737,Patchell; Gregory David,16,0,30,14
1657356584598,MATH 10B,A01,083207,Lim; Seonhee,8,0,34,26
1657356584598,MATH 10B,A02,083208,Lim; Seonhee,9,0,35,26
1657356584598,MATH 10B,A03,093472,Lim; Seonhee,7,0,34,27
1657356584598,MATH 10B,B01,083739,Sinha; Shubham,12,0,30,18
1657356590633,MATH 18,A01,083743,Cinel; Cameron Alexander,7,0,30,23
1657356590633,MATH 18,A02,083744,Cinel; Cameron Alexander,17,0,30,13
1657356590633,MATH 18,A03,083745,Cinel; Cameron Alexander,9,0,30,21
1657356590633,MATH 18,B01,083748,Rideout; David Porter,5,0,37,32
1657356590633,MATH 18,B02,083749,Rideout; David Porter,5,0,36,31
1657356590633,MATH 18,B03,083750,Rideout; David Porter,3,0,37,34
1657356590633,MATH 18,B04,083751,Rideout; David Porter,6,0,36,30
1657356590633,MATH 18,B05,093473,Rideout; David Porter,6,0,36,30
1657356590633,MATH 18,B06,093474,Rideout; David Porter,6,0,36,30
1657356596663,MATH 20A,A01,083754,Zheng; Zequn,14,0,40,26
1657356602690,MATH 20B,A01,083756,Briones; Jor-el Thomas Caparas,4,0,36,32
1657356602690,MATH 20B,A02,083757,Briones; Jor-el Thomas Caparas,1,0,36,35
1657356602690,MATH 20B,A03,093475,Briones; Jor-el Thomas Caparas,2,0,36,34
1657356608721,MATH 20C,A01,083760,Briones; Jor-el Thomas Caparas,1,0,35,34
1657356608721,MATH 20C,A02,083761,Briones; Jor-el Thomas Caparas,8,0,35,27
1657356608721,MATH 20C,A03,093476,Briones; Jor-el Thomas Caparas,0,1,36,36
1657356608721,MATH 20C,B01,083762,Bach; Quang Tran,1,0,30,29
1657356614750,MATH 20D,A01,083765,Tran; Brian Kha,5,0,30,25
1657356614750,MATH 20D,A02,083766,Tran; Brian Kha,5,0,30,25
1657356614750,MATH 20D,A03,083767,Tran; Brian Kha,5,0,30,25
1657356620777,MATH 20E,A01,083771,Ganguly; Soumya,9,0,32,23
1657356620777,MATH 20E,A02,083772,Ganguly; Soumya,6,0,32,26
1657356620777,MATH 20E,B01,083773,Ciotti; Benjamin,20,0,35,15
1657356620777,MATH 20E,B02,083774,Ciotti; Benjamin,17,0,35,18
1657356626814,MATH 103A,A01,083777,Greenfeld; Be'Eri,3,0,36,33
1657356626814,MATH 103A,A02,083778,Greenfeld; Be'Eri,5,0,36,31
1657356626814,MATH 103A,A03,093561,Greenfeld; Be'Eri,5,0,36,31
1657356626814,MATH 103A,B01,083779,Greenfeld; Be'Eri,7,0,36,29
1657356626814,MATH 103A,B02,083780,Greenfeld; Be'Eri,4,0,36,32
1657356626814,MATH 103A,B03,093562,Greenfeld; Be'Eri,3,0,36,33
1657356632843,MATH 105,A01,085443,Carter; Anne Toulson,15,0,35,20
1657356632843,MATH 105,A02,093477,Carter; Anne Toulson,20,0,35,15
1657356638870,MATH 109,A01,083213,Ganzberger; Geoffrey Michael,2,0,34,32
1657356638870,MATH 109,A02,083214,Ganzberger; Geoffrey Michael,4,0,34,30
1657356638870,MATH 109,A03,093478,Ganzberger; Geoffrey Michael,2,0,34,32
1657356638870,MATH 109,B01,083215,Ganzberger; Geoffrey Michael,1,0,32,31
1657356638870,MATH 109,B02,083216,Ganzberger; Geoffrey Michael,2,0,32,30
1657356638870,MATH 109,B03,093479,Ganzberger; Geoffrey Michael,8,0,32,24
1657356644907,MATH 142A,A01,083219,Chow; Bennett,7,0,32,25
1657356644907,MATH 142A,A02,083220,Chow; Bennett,10,0,32,22
1657356644907,MATH 142A,A03,093480,Chow; Bennett,8,0,32,24
1657356644907,MATH 142A,B03,093481,Chow; Bennett,8,0,32,24
1657356644907,MATH 142A,B04,093558,Chow; Bennett,13,0,32,19
1657356644907,MATH 142A,B05,093559,Chow; Bennett,6,0,32,26
1657356650934,MATH 193A,A01,083224,Rotar; Vladimir,8,0,34,26
1657356650934,MATH 193A,A02,083225,Rotar; Vladimir,9,0,34,25
1657356650934,MATH 193A,A03,083781,Rotar; Vladimir,5,0,34,29
1657356650934,MATH 193A,A04,083782,Rotar; Vladimir,10,0,34,24
1657356650934,MATH 193A,A05,093482,Rotar; Vladimir,10,0,34,24
1657356656982,MATH 197,001,091859,McAuley; Julian John,9999,0,9999,0
1657356656982,MATH 197,002,095566,Kedlaya; Kiran S.,9997,0,9999,2
1657356656982,MATH 197,003,095567,Xiao; Ming,9999,0,9999,0
1657356656982,MATH 197,004,095571,Perols; Johan Lars,9998,0,9999,1
1657356664054,COGS 9,A01,083615,Shannon; Kyle Michael,8,0,75,67
1657356670080,COGS 11,A01,083617,Boyle; Mary E. T.,22,0,48,26
1657356676105,COGS 13,A01,083071,Bastos; Amalia Pinkusfeld,11,0,71,60
1657356682130,COGS 14A,A01,092681,Semenuks; Arturs,4,1,100,96
1657356688157,COGS 14B,A01,083073,Cheng; Tzu-Han,6,0,63,57
1657356694181,COGS 17,A01,092677,Semenuks; Arturs,6,0,81,75
1657356700207,COGS 100,A01,083619,Allen; Michael Gordon,17,0,70,53
1657356706232,COGS 101A,A01,083621,Davis; Joshua Daniel,9,0,68,59
1657356712274,COGS 101B,A01,091572,Allen; Michael Gordon,11,0,65,54
1657356718304,COGS 101C,A01,083625,Delgado; Tania,17,0,35,18
1657356724332,COGS 107A,A01,083627,Boyle; Mary E. T.,13,0,60,47
1657356730357,COGS 118A,A01,083075,Gupta; Anjum,20,0,76,56
1657356736382,CSE 3,A50,083646,Miranda; Gregory Joseph,24,0,50,26
1657356742408,CSE 8A,A50,083650,Miranda; Gregory Joseph,17,1,56,39
1657356748437,CSE 11,A01,083080,Cao; Yingjun,6,15,40,34
1657356754466,CSE 12,A01,083652,Krause-Levy; Sophia Louisa,28,1,120,92
1657356760493,CSE 15L,A01,083654,Morris; Justin Loren,9,0,50,41
1657356760493,CSE 15L,A02,083655,Morris; Justin Loren,9,0,50,41
1657356766518,CSE 20,A01,083657,Tran; Khoa Dang,39,0,80,41
1657356772547,CSE 21,A01,095574,Bach; Quang Tran,22,0,48,26
1657356778574,CSE 30,A01,083084,Eldon; John,4,0,80,76
1657356778574,CSE 30,B01,095061,Bhaskar; Nishant,9,0,50,41
1657356784600,CSE 100,A01,083659,Cao; Yingjun,5,4,70,65
1657356790623,CSE 134B,A01,083661,Powell; Thomas Allan,22,0,100,78
1657356796648,CSE 140,A01,083663,Gungor; Onat,14,0,85,71
1657356802673,CSE 140L,A01,083088,Eldon; John,21,0,100,79
1657356808701,CSE 175,A01,083665,Kumar; Rakesh,3,0,25,22
1657356814727,CSE 190,A00,092507,Dubnov; Shlomo,7,0,20,13
1657356820768,ECE 45,A01,083139,Congero; Spencer William,6,0,75,69
1657356826801,ECE 65,A50,083695,Saad; Andrew S,12,0,30,18
1657356826801,ECE 65,A51,095125,Saad; Andrew S,24,0,26,2
1657356832827,ECE 109,A01,091882,Touri; Behrouz,19,0,70,51
1657356838855,ECE 180,A00,083140,Abi Samra; Nicholas Camill,1,0,30,29
1657356838855,ECE 180,B00,083141,Abi Samra; Nicholas Camill,0,0,30,30
1657356844881,MATH 10A,A01,083735,Patchell; Gregory David,2,0,30,28
1657356844881,MATH 10A,A02,083736,Patchell; Gregory David,20,0,30,10
1657356844881,MATH 10A,A03,083737,Patchell; Gregory David,16,0,30,14
1657356850919,MATH 10B,A01,083207,Lim; Seonhee,8,0,34,26
1657356850919,MATH 10B,A02,083208,Lim; Seonhee,9,0,35,26
1657356850919,MATH 10B,A03,093472,Lim; Seonhee,7,0,34,27
1657356850919,MATH 10B,B01,083739,Sinha; Shubham,12,0,30,18
1657356856949,MATH 18,A01,083743,Cinel; Cameron Alexander,7,0,30,23
1657356856949,MATH 18,A02,083744,Cinel; Cameron Alexander,17,0,30,13
1657356856949,MATH 18,A03,083745,Cinel; Cameron Alexander,9,0,30,21
1657356856949,MATH 18,B01,083748,Rideout; David Porter,5,0,37,32
1657356856949,MATH 18,B02,083749,Rideout; David Porter,5,0,36,31
1657356856949,MATH 18,B03,083750,Rideout; David Porter,3,0,37,34
1657356856949,MATH 18,B04,083751,Rideout; David Porter,6,0,36,30
1657356856949,MATH 18,B05,093473,Rideout; David Porter,6,0,36,30
1657356856949,MATH 18,B06,093474,Rideout; David Porter,6,0,36,30
1657356862975,MATH 20A,A01,083754,Zheng; Zequn,14,0,40,26
1657356869001,MATH 20B,A01,083756,Briones; Jor-el Thomas Caparas,4,0,36,32
1657356869001,MATH 20B,A02,083757,Briones; Jor-el Thomas Caparas,1,0,36,35
1657356869001,MATH 20B,A03,093475,Briones; Jor-el Thomas Caparas,2,0,36,34
1657356875037,MATH 20C,A01,083760,Briones; Jor-el Thomas Caparas,1,0,35,34
1657356875037,MATH 20C,A02,083761,Briones; Jor-el Thomas Caparas,8,0,35,27
1657356875037,MATH 20C,A03,093476,Briones; Jor-el Thomas Caparas,0,1,36,36
1657356875037,MATH 20C,B01,083762,Bach; Quang Tran,1,0,30,29
1657356881065,MATH 20D,A01,083765,Tran; Brian Kha,5,0,30,25
1657356881065,MATH 20D,A02,083766,Tran; Brian Kha,5,0,30,25
1657356881065,MATH 20D,A03,083767,Tran; Brian Kha,5,0,30,25
1657356887091,MATH 20E,A01,083771,Ganguly; Soumya,9,0,32,23
1657356887091,MATH 20E,A02,083772,Ganguly; Soumya,6,0,32,26
1657356887091,MATH 20E,B01,083773,Ciotti; Benjamin,20,0,35,15
1657356887091,MATH 20E,B02,083774,Ciotti; Benjamin,17,0,35,18
1657356893125,MATH 103A,A01,083777,Greenfeld; Be'Eri,3,0,36,33
1657356893125,MATH 103A,A02,083778,Greenfeld; Be'Eri,5,0,36,31
1657356893125,MATH 103A,A03,093561,Greenfeld; Be'Eri,5,0,36,31
1657356893125,MATH 103A,B01,083779,Greenfeld; Be'Eri,7,0,36,29
1657356893125,MATH 103A,B02,083780,Greenfeld; Be'Eri,4,0,36,32
1657356893125,MATH 103A,B03,093562,Greenfeld; Be'Eri,3,0,36,33
1657356899155,MATH 105,A01,085443,Carter; Anne Toulson,15,0,35,20
1657356899155,MATH 105,A02,093477,Carter; Anne Toulson,20,0,35,15
1657356905180,MATH 109,A01,083213,Ganzberger; Geoffrey Michael,2,0,34,32
1657356905180,MATH 109,A02,083214,Ganzberger; Geoffrey Michael,4,0,34,30
1657356905180,MATH 109,A03,093478,Ganzberger; Geoffrey Michael,2,0,34,32
1657356905180,MATH 109,B01,083215,Ganzberger; Geoffrey Michael,1,0,32,31
1657356905180,MATH 109,B02,083216,Ganzberger; Geoffrey Michael,2,0,32,30
1657356905180,MATH 109,B03,093479,Ganzberger; Geoffrey Michael,8,0,32,24
1657356911204,MATH 142A,A01,083219,Chow; Bennett,7,0,32,25
1657356911204,MATH 142A,A02,083220,Chow; Bennett,10,0,32,22
1657356911204,MATH 142A,A03,093480,Chow; Bennett,8,0,32,24
1657356911204,MATH 142A,B03,093481,Chow; Bennett,8,0,32,24
1657356911204,MATH 142A,B04,093558,Chow; Bennett,13,0,32,19
1657356911204,MATH 142A,B05,093559,Chow; Bennett,6,0,32,26
1657356917230,MATH 193A,A01,083224,Rotar; Vladimir,8,0,34,26
1657356917230,MATH 193A,A02,083225,Rotar; Vladimir,9,0,34,25
1657356917230,MATH 193A,A03,083781,Rotar; Vladimir,5,0,34,29
1657356917230,MATH 193A,A04,083782,Rotar; Vladimir,10,0,34,24
1657356917230,MATH 193A,A05,093482,Rotar; Vladimir,10,0,34,24
1657356923260,MATH 197,001,091859,McAuley; Julian John,9999,0,9999,0
1657356923260,MATH 197,002,095566,Kedlaya; Kiran S.,9997,0,9999,2
1657356923260,MATH 197,003,095567,Xiao; Ming,9999,0,9999,0
1657356923260,MATH 197,004,095571,Perols; Johan Lars,9998,0,9999,1
1657356930331,COGS 9,A01,083615,Shannon; Kyle Michael,8,0,75,67
1657356936355,COGS 11,A01,083617,Boyle; Mary E. T.,22,0,48,26
1657356942383,COGS 13,A01,083071,Bastos; Amalia Pinkusfeld,11,0,71,60
1657356948408,COGS 14A,A01,092681,Semenuks; Arturs,4,1,100,96
1657356954435,COGS 14B,A01,083073,Cheng; Tzu-Han,6,0,63,57
1657356960461,COGS 17,A01,092677,Semenuks; Arturs,6,0,81,75
1657356966486,COGS 100,A01,083619,Allen; Michael Gordon,17,0,70,53
1657356972510,COGS 101A,A01,083621,Davis; Joshua Daniel,9,0,68,59
1657356978536,COGS 101B,A01,091572,Allen; Michael Gordon,11,0,65,54
1657356984567,COGS 101C,A01,083625,Delgado; Tania,17,0,35,18
1657356990590,COGS 107A,A01,083627,Boyle; Mary E. T.,13,0,60,47
1657356996614,COGS 118A,A01,083075,Gupta; Anjum,20,0,76,56
1657357002647,CSE 3,A50,083646,Miranda; Gregory Joseph,24,0,50,26
1657357008677,CSE 8A,A50,083650,Miranda; Gregory Joseph,17,1,56,39
1657357014703,CSE 11,A01,083080,Cao; Yingjun,6,15,40,34
1657357020726,CSE 12,A01,083652,Krause-Levy; Sophia Louisa,28,1,120,92
1657357026750,CSE 15L,A01,083654,Morris; Justin Loren,9,0,50,41
1657357026750,CSE 15L,A02,083655,Morris; Justin Loren,9,0,50,41
1657357032775,CSE 20,A01,083657,Tran; Khoa Dang,39,0,80,41
1657357038802,CSE 21,A01,095574,Bach; Quang Tran,22,0,48,26
1657357044828,CSE 30,A01,083084,Eldon; John,4,0,80,76
1657357044828,CSE 30,B01,095061,Bhaskar; Nishant,9,0,50,41
1657357050853,CSE 100,A01,083659,Cao; Yingjun,5,4,70,65
1657357056877,CSE 134B,A01,083661,Powell; Thomas Allan,22,0,100,78
1657357062902,CSE 140,A01,083663,Gungor; Onat,14,0,85,71
1657357068928,CSE 140L,A01,083088,Eldon; John,21,0,100,79
1657357074956,CSE 175,A01,083665,Kumar; Rakesh,3,0,25,22
1657357080980,CSE 190,A00,092507,Dubnov; Shlomo,7,0,20,13
1657357087005,ECE 45,A01,083139,Congero; Spencer William,6,0,75,69
1657357093032,ECE 65,A50,083695,Saad; Andrew S,12,0,30,18
1657357093032,ECE 65,A51,095125,Saad; Andrew S,24,0,26,2
1657357099070,ECE 109,A01,091882,Touri; Behrouz,19,0,70,51
1657357105097,ECE 180,A00,083140,Abi Samra; Nicholas Camill,1,0,30,29
1657357105097,ECE 180,B00,083141,Abi Samra; Nicholas Camill,0,0,30,30
1657357111133,MATH 10A,A01,083735,Patchell; Gregory David,2,0,30,28
1657357111133,MATH 10A,A02,083736,Patchell; Gregory David,20,0,30,10
1657357111133,MATH 10A,A03,083737,Patchell; Gregory David,16,0,30,14
1657357117160,MATH 10B,A01,083207,Lim; Seonhee,8,0,34,26
1657357117160,MATH 10B,A02,083208,Lim; Seonhee,9,0,35,26
1657357117160,MATH 10B,A03,093472,Lim; Seonhee,7,0,34,27
1657357117160,MATH 10B,B01,083739,Sinha; Shubham,12,0,30,18
1657357123195,MATH 18,A01,083743,Cinel; Cameron Alexander,7,0,30,23
1657357123195,MATH 18,A02,083744,Cinel; Cameron Alexander,17,0,30,13
1657357123195,MATH 18,A03,083745,Cinel; Cameron Alexander,9,0,30,21
1657357123195,MATH 18,B01,083748,Rideout; David Porter,5,0,37,32
1657357123195,MATH 18,B02,083749,Rideout; David Porter,5,0,36,31
1657357123195,MATH 18,B03,083750,Rideout; David Porter,3,0,37,34
1657357123195,MATH 18,B04,083751,Rideout; David Porter,6,0,36,30
1657357123195,MATH 18,B05,093473,Rideout; David Porter,6,0,36,30
1657357123195,MATH 18,B06,093474,Rideout; David Porter,6,0,36,30
1657357129220,MATH 20A,A01,083754,Zheng; Zequn,14,0,40,26
1657357135249,MATH 20B,A01,083756,Briones; Jor-el Thomas Caparas,4,0,36,32
1657357135249,MATH 20B,A02,083757,Briones; Jor-el Thomas Caparas,1,0,36,35
1657357135249,MATH 20B,A03,093475,Briones; Jor-el Thomas Caparas,2,0,36,34
1657357141272,MATH 20C,A01,083760,Briones; Jor-el Thomas Caparas,1,0,35,34
1657357141272,MATH 20C,A02,083761,Briones; Jor-el Thomas Caparas,8,0,35,27
1657357141272,MATH 20C,A03,093476,Briones; Jor-el Thomas Caparas,0,1,36,36
1657357141272,MATH 20C,B01,083762,Bach; Quang Tran,1,0,30,29
1657357147296,MATH 20D,A01,083765,Tran; Brian Kha,5,0,30,25
1657357147296,MATH 20D,A02,083766,Tran; Brian Kha,5,0,30,25
1657357147296,MATH 20D,A03,083767,Tran; Brian Kha,5,0,30,25
1657357153324,MATH 20E,A01,083771,Ganguly; Soumya,9,0,32,23
1657357153324,MATH 20E,A02,083772,Ganguly; Soumya,6,0,32,26
1657357153324,MATH 20E,B01,083773,Ciotti; Benjamin,20,0,35,15
1657357153324,MATH 20E,B02,083774,Ciotti; Benjamin,17,0,35,18
1657357159348,MATH 103A,A01,083777,Greenfeld; Be'Eri,3,0,36,33
1657357159348,MATH 103A,A02,083778,Greenfeld; Be'Eri,5,0,36,31
1657357159348,MATH 103A,A03,093561,Greenfeld; Be'Eri,5,0,36,31
1657357159348,MATH 103A,B01,083779,Greenfeld; Be'Eri,7,0,36,29
1657357159348,MATH 103A,B02,083780,Greenfeld; Be'Eri,4,0,36,32
1657357159348,MATH 103A,B03,093562,Greenfeld; Be'Eri,3,0,36,33
1657357165374,MATH 105,A01,085443,Carter; Anne Toulson,15,0,35,20
1657357165374,MATH 105,A02,093477,Carter; Anne Toulson,20,0,35,15
1657357171418,MATH 109,A01,083213,Ganzberger; Geoffrey Michael,2,0,34,32
1657357171418,MATH 109,A02,083214,Ganzberger; Geoffrey Michael,4,0,34,30
1657357171418,MATH 109,A03,093478,Ganzberger; Geoffrey Michael,2,0,34,32
1657357171418,MATH 109,B01,083215,Ganzberger; Geoffrey Michael,1,0,32,31
1657357171418,MATH 109,B02,083216,Ganzberger; Geoffrey Michael,2,0,32,30
1657357171418,MATH 109,B03,093479,Ganzberger; Geoffrey Michael,8,0,32,24
1657357177444,MATH 142A,A01,083219,Chow; Bennett,7,0,32,25
1657357177444,MATH 142A,A02,083220,Chow; Bennett,10,0,32,22
1657357177444,MATH 142A,A03,093480,Chow; Bennett,8,0,32,24
1657357177444,MATH 142A,B03,093481,Chow; Bennett,8,0,32,24
1657357177444,MATH 142A,B04,093558,Chow; Bennett,13,0,32,19
1657357177444,MATH 142A,B05,093559,Chow; Bennett,6,0,32,26
1657357183545,MATH 193A,A01,083224,Rotar; Vladimir,8,0,34,26
1657357183545,MATH 193A,A02,083225,Rotar; Vladimir,9,0,34,25
1657357183545,MATH 193A,A03,083781,Rotar; Vladimir,5,0,34,29
1657357183545,MATH 193A,A04,083782,Rotar; Vladimir,10,0,34,24
1657357183545,MATH 193A,A05,093482,Rotar; Vladimir,10,0,34,24
1657357189571,MATH 197,001,091859,McAuley; Julian John,9999,0,9999,0
1657357189571,MATH 197,002,095566,Kedlaya; Kiran S.,9997,0,9999,2
1657357189571,MATH 197,003,095567,Xiao; Ming,9999,0,9999,0
1657357189571,MATH 197,004,095571,Perols; Johan Lars,9998,0,9999,1
1657357196651,COGS 9,A01,083615,Shannon; Kyle Michael,8,0,75,67
1657357202675,COGS 11,A01,083617,Boyle; Mary E. T.,22,0,48,26
1657357208699,COGS 13,A01,083071,Bastos; Amalia Pinkusfeld,11,0,71,60
1657357214727,COGS 14A,A01,092681,Semenuks; Arturs,4,1,100,96
1657357220754,COGS 14B,A01,083073,Cheng; Tzu-Han,6,0,63,57
1657357226781,COGS 17,A01,092677,Semenuks; Arturs,6,0,81,75
1657357232805,COGS 100,A01,083619,Allen; Michael Gordon,17,0,70,53
1657357238827,COGS 101A,A01,083621,Davis; Joshua Daniel,9,0,68,59
1657357244849,COGS 101B,A01,091572,Allen; Michael Gordon,11,0,65,54
1657357250874,COGS 101C,A01,083625,Delgado; Tania,17,0,35,18
1657357256901,COGS 107A,A01,083627,Boyle; Mary E. T.,13,0,60,47
1657357262945,COGS 118A,A01,083075,Gupta; Anjum,20,0,76,56
1657357268976,CSE 3,A50,083646,Miranda; Gregory Joseph,24,0,50,26
1657357275002,CSE 8A,A50,083650,Miranda; Gregory Joseph,17,1,56,39
1657357281024,CSE 11,A01,083080,Cao; Yingjun,6,15,40,34
1657357287050,CSE 12,A01,083652,Krause-Levy; Sophia Louisa,28,1,120,92
1657357293074,CSE 15L,A01,083654,Morris; Justin Loren,9,0,50,41
1657357293074,CSE 15L,A02,083655,Morris; Justin Loren,9,0,50,41
1657357299098,CSE 20,A01,083657,Tran; Khoa Dang,39,0,80,41
1657357305129,CSE 21,A01,095574,Bach; Quang Tran,22,0,48,26
1657357311158,CSE 30,A01,083084,Eldon; John,4,0,80,76
1657357311158,CSE 30,B01,095061,Bhaskar; Nishant,9,0,50,41
1657357317184,CSE 100,A01,083659,Cao; Yingjun,5,4,70,65
1657357323214,CSE 134B,A01,083661,Powell; Thomas Allan,22,0,100,78
1657357329238,CSE 140,A01,083663,Gungor; Onat,14,0,85,71
1657357335269,CSE 140L,A01,083088,Eldon; John,21,0,100,79
1657357341294,CSE 175,A01,083665,Kumar; Rakesh,3,0,25,22
1657357347323,CSE 190,A00,092507,Dubnov; Shlomo,7,0,20,13
1657357353353,ECE 45,A01,083139,Congero; Spencer William,6,0,75,69
1657357359384,ECE 65,A50,083695,Saad; Andrew S,12,0,30,18
1657357359384,ECE 65,A51,095125,Saad; Andrew S,24,0,26,2
1657357365410,ECE 109,A01,091882,Touri; Behrouz,19,0,70,51
1657357371434,ECE 180,A00,083140,Abi Samra; Nicholas Camill,1,0,30,29
1657357371434,ECE 180,B00,083141,Abi Samra; Nicholas Camill,0,0,30,30
1657357377468,MATH 10A,A01,083735,Patchell; Gregory David,2,0,30,28
1657357377468,MATH 10A,A02,083736,Patchell; Gregory David,20,0,30,10
1657357377468,MATH 10A,A03,083737,Patchell; Gregory David,16,0,30,14
1657357383504,MATH 10B,A01,083207,Lim; Seonhee,8,0,34,26
1657357383504,MATH 10B,A02,083208,Lim; Seonhee,9,0,35,26
1657357383504,MATH 10B,A03,093472,Lim; Seonhee,7,0,34,27
1657357383504,MATH 10B,B01,083739,Sinha; Shubham,12,0,30,18
1657357389559,MATH 18,A01,083743,Cinel; Cameron Alexander,7,0,30,23
1657357389559,MATH 18,A02,083744,Cinel; Cameron Alexander,17,0,30,13
1657357389559,MATH 18,A03,083745,Cinel; Cameron Alexander,9,0,30,21
1657357389559,MATH 18,B01,083748,Rideout; David Porter,5,0,37,32
1657357389559,MATH 18,B02,083749,Rideout; David Porter,5,0,36,31
1657357389559,MATH 18,B03,083750,Rideout; David Porter,3,0,37,34
1657357389559,MATH 18,B04,083751,Rideout; David Porter,6,0,36,30
1657357389559,MATH 18,B05,093473,Rideout; David Porter,6,0,36,30
1657357389559,MATH 18,B06,093474,Rideout; David Porter,6,0,36,30
1657357395583,MATH 20A,A01,083754,Zheng; Zequn,14,0,40,26
1657357401608,MATH 20B,A01,083756,Briones; Jor-el Thomas Caparas,4,0,36,32
1657357401608,MATH 20B,A02,083757,Briones; Jor-el Thomas Caparas,1,0,36,35
1657357401608,MATH 20B,A03,093475,Briones; Jor-el Thomas Caparas,2,0,36,34
1657357407636,MATH 20C,A01,083760,Briones; Jor-el Thomas Caparas,1,0,35,34
1657357407636,MATH 20C,A02,083761,Briones; Jor-el Thomas Caparas,8,0,35,27
1657357407636,MATH 20C,A03,093476,Briones; Jor-el Thomas Caparas,0,1,36,36
1657357407636,MATH 20C,B01,083762,Bach; Quang Tran,1,0,30,29
1657357413664,MATH 20D,A01,083765,Tran; Brian Kha,5,0,30,25
1657357413664,MATH 20D,A02,083766,Tran; Brian Kha,5,0,30,25
1657357413664,MATH 20D,A03,083767,Tran; Brian Kha,5,0,30,25
1657357419697,MATH 20E,A01,083771,Ganguly; Soumya,9,0,32,23
1657357419697,MATH 20E,A02,083772,Ganguly; Soumya,6,0,32,26
1657357419697,MATH 20E,B01,083773,Ciotti; Benjamin,20,0,35,15
1657357419697,MATH 20E,B02,083774,Ciotti; Benjamin,17,0,35,18
1657357425725,MATH 103A,A01,083777,Greenfeld; Be'Eri,3,0,36,33
1657357425725,MATH 103A,A02,083778,Greenfeld; Be'Eri,5,0,36,31
1657357425725,MATH 103A,A03,093561,Greenfeld; Be'Eri,5,0,36,31
1657357425725,MATH 103A,B01,083779,Greenfeld; Be'Eri,7,0,36,29
1657357425725,MATH 103A,B02,083780,Greenfeld; Be'Eri,4,0,36,32
1657357425725,MATH 103A,B03,093562,Greenfeld; Be'Eri,3,0,36,33
1657357431752,MATH 105,A01,085443,Carter; Anne Toulson,15,0,35,20
1657357431752,MATH 105,A02,093477,Carter; Anne Toulson,20,0,35,15
1657357437776,MATH 109,A01,083213,Ganzberger; Geoffrey Michael,2,0,34,32
1657357437776,MATH 109,A02,083214,Ganzberger; Geoffrey Michael,4,0,34,30
1657357437776,MATH 109,A03,093478,Ganzberger; Geoffrey Michael,2,0,34,32
1657357437776,MATH 109,B01,083215,Ganzberger; Geoffrey Michael,1,0,32,31
1657357437776,MATH 109,B02,083216,Ganzberger; Geoffrey Michael,2,0,32,30
1657357437776,MATH 109,B03,093479,Ganzberger; Geoffrey Michael,8,0,32,24
1657357443800,MATH 142A,A01,083219,Chow; Bennett,7,0,32,25
1657357443800,MATH 142A,A02,083220,Chow; Bennett,10,0,32,22
1657357443800,MATH 142A,A03,093480,Chow; Bennett,8,0,32,24
1657357443800,MATH 142A,B03,093481,Chow; Bennett,8,0,32,24
1657357443800,MATH 142A,B04,093558,Chow; Bennett,13,0,32,19
1657357443800,MATH 142A,B05,093559,Chow; Bennett,6,0,32,26
1657357449825,MATH 193A,A01,083224,Rotar; Vladimir,8,0,34,26
1657357449825,MATH 193A,A02,083225,Rotar; Vladimir,9,0,34,25
1657357449825,MATH 193A,A03,083781,Rotar; Vladimir,5,0,34,29
1657357449825,MATH 193A,A04,083782,Rotar; Vladimir,10,0,34,24
1657357449825,MATH 193A,A05,093482,Rotar; Vladimir,10,0,34,24
1657357455852,MATH 197,001,091859,McAuley; Julian John,9999,0,9999,0
1657357455852,MATH 197,002,095566,Kedlaya; Kiran S.,9997,0,9999,2
1657357455852,MATH 197,003,095567,Xiao; Ming,9999,0,9999,0
1657357455852,MATH 197,004,095571,Perols; Johan Lars,9998,0,9999,1
1657357462912,COGS 9,A01,083615,Shannon; Kyle Michael,8,0,75,67
1657357468941,COGS 11,A01,083617,Boyle; Mary E. T.,22,0,48,26
1657357474966,COGS 13,A01,083071,Bastos; Amalia Pinkusfeld,11,0,71,60
1657357480996,COGS 14A,A01,092681,Semenuks; Arturs,4,1,100,96
1657357487021,COGS 14B,A01,083073,Cheng; Tzu-Han,6,0,63,57
1657357493052,COGS 17,A01,092677,Semenuks; Arturs,6,0,81,75
1657357499083,COGS 100,A01,083619,Allen; Michael Gordon,17,0,70,53
1657357505112,COGS 101A,A01,083621,Davis; Joshua Daniel,9,0,68,59
1657357511137,COGS 101B,A01,091572,Allen; Michael Gordon,11,0,65,54
1657357517168,COGS 101C,A01,083625,Delgado; Tania,17,0,35,18
1657357523191,COGS 107A,A01,083627,Boyle; Mary E. T.,13,0,60,47
1657357529218,COGS 118A,A01,083075,Gupta; Anjum,20,0,76,56
1657357535246,CSE 3,A50,083646,Miranda; Gregory Joseph,24,0,50,26
1657357541271,CSE 8A,A50,083650,Miranda; Gregory Joseph,17,1,56,39
1657357547298,CSE 11,A01,083080,Cao; Yingjun,6,15,40,34
1657357553323,CSE 12,A01,083652,Krause-Levy; Sophia Louisa,28,1,120,92
1657357559347,CSE 15L,A01,083654,Morris; Justin Loren,9,0,50,41
1657357559347,CSE 15L,A02,083655,Morris; Justin Loren,9,0,50,41
1657357565379,CSE 20,A01,083657,Tran; Khoa Dang,39,0,80,41
1657357571402,CSE 21,A01,095574,Bach; Quang Tran,22,0,48,26
1657357577429,CSE 30,A01,083084,Eldon; John,4,0,80,76
1657357577429,CSE 30,B01,095061,Bhaskar; Nishant,9,0,50,41
1657357583468,CSE 100,A01,083659,Cao; Yingjun,5,4,70,65
1657357589502,CSE 134B,A01,083661,Powell; Thomas Allan,22,0,100,78
1657357595533,CSE 140,A01,083663,Gungor; Onat,14,0,85,71
1657357601555,CSE 140L,A01,083088,Eldon; John,21,0,100,79
1657357607580,CSE 175,A01,083665,Kumar; Rakesh,3,0,25,22
1657357613606,CSE 190,A00,092507,Dubnov; Shlomo,7,0,20,13
1657357619632,ECE 45,A01,083139,Congero; Spencer William,6,0,75,69
1657357625656,ECE 65,A50,083695,Saad; Andrew S,12,0,30,18
1657357625656,ECE 65,A51,095125,Saad; Andrew S,24,0,26,2
1657357631682,ECE 109,A01,091882,Touri; Behrouz,19,0,70,51
1657357637718,ECE 180,A00,083140,Abi Samra; Nicholas Camill,1,0,30,29
1657357637718,ECE 180,B00,083141,Abi Samra; Nicholas Camill,0,0,30,30
1657357643744,MATH 10A,A01,083735,Patchell; Gregory David,2,0,30,28
1657357643744,MATH 10A,A02,083736,Patchell; Gregory David,20,0,30,10
1657357643744,MATH 10A,A03,083737,Patchell; Gregory David,16,0,30,14
1657357649768,MATH 10B,A01,083207,Lim; Seonhee,8,0,34,26
1657357649768,MATH 10B,A02,083208,Lim; Seonhee,9,0,35,26
1657357649768,MATH 10B,A03,093472,Lim; Seonhee,7,0,34,27
1657357649768,MATH 10B,B01,083739,Sinha; Shubham,12,0,30,18
1657357655807,MATH 18,A01,083743,Cinel; Cameron Alexander,7,0,30,23
1657357655807,MATH 18,A02,083744,Cinel; Cameron Alexander,17,0,30,13
1657357655807,MATH 18,A03,083745,Cinel; Cameron Alexander,9,0,30,21
1657357655807,MATH 18,B01,083748,Rideout; David Porter,5,0,37,32
1657357655807,MATH 18,B02,083749,Rideout; David Porter,5,0,36,31
1657357655807,MATH 18,B03,083750,Rideout; David Porter,3,0,37,34
1657357655807,MATH 18,B04,083751,Rideout; David Porter,6,0,36,30
1657357655807,MATH 18,B05,093473,Rideout; David Porter,6,0,36,30
1657357655807,MATH 18,B06,093474,Rideout; David Porter,6,0,36,30
1657357661836,MATH 20A,A01,083754,Zheng; Zequn,14,0,40,26
1657357667858,MATH 20B,A01,083756,Briones; Jor-el Thomas Caparas,4,0,36,32
1657357667858,MATH 20B,A02,083757,Briones; Jor-el Thomas Caparas,1,0,36,35
1657357667858,MATH 20B,A03,093475,Briones; Jor-el Thomas Caparas,2,0,36,34
1657357673892,MATH 20C,A01,083760,Briones; Jor-el Thomas Caparas,1,0,35,34
1657357673892,MATH 20C,A02,083761,Briones; Jor-el Thomas Caparas,8,0,35,27
1657357673892,MATH 20C,A03,093476,Briones; Jor-el Thomas Caparas,0,1,36,36
1657357673892,MATH 20C,B01,083762,Bach; Quang Tran,1,0,30,29
1657357679916,MATH 20D,A01,083765,Tran; Brian Kha,5,0,30,25
1657357679916,MATH 20D,A02,083766,Tran; Brian Kha,5,0,30,25
1657357679916,MATH 20D,A03,083767,Tran; Brian Kha,5,0,30,25
1657357685947,MATH 20E,A01,083771,Ganguly; Soumya,9,0,32,23
1657357685947,MATH 20E,A02,083772,Ganguly; Soumya,6,0,32,26
1657357685947,MATH 20E,B01,083773,Ciotti; Benjamin,20,0,35,15
1657357685947,MATH 20E,B02,083774,Ciotti; Benjamin,17,0,35,18
1657357691973,MATH 103A,A01,083777,Greenfeld; Be'Eri,3,0,36,33
1657357691973,MATH 103A,A02,083778,Greenfeld; Be'Eri,5,0,36,31
1657357691973,MATH 103A,A03,093561,Greenfeld; Be'Eri,5,0,36,31
1657357691973,MATH 103A,B01,083779,Greenfeld; Be'Eri,7,0,36,29
1657357691973,MATH 103A,B02,083780,Greenfeld; Be'Eri,4,0,36,32
1657357691973,MATH 103A,B03,093562,Greenfeld; Be'Eri,3,0,36,33
1657357697996,MATH 105,A01,085443,Carter; Anne Toulson,15,0,35,20
1657357697996,MATH 105,A02,093477,Carter; Anne Toulson,20,0,35,15
1657357704022,MATH 109,A01,083213,Ganzberger; Geoffrey Michael,2,0,34,32
1657357704022,MATH 109,A02,083214,Ganzberger; Geoffrey Michael,4,0,34,30
1657357704022,MATH 109,A03,093478,Ganzberger; Geoffrey Michael,2,0,34,32
1657357704022,MATH 109,B01,083215,Ganzberger; Geoffrey Michael,1,0,32,31
1657357704022,MATH 109,B02,083216,Ganzberger; Geoffrey Michael,2,0,32,30
1657357704022,MATH 109,B03,093479,Ganzberger; Geoffrey Michael,8,0,32,24
1657357710053,MATH 142A,A01,083219,Chow; Bennett,7,0,32,25
1657357710053,MATH 142A,A02,083220,Chow; Bennett,10,0,32,22
1657357710053,MATH 142A,A03,093480,Chow; Bennett,8,0,32,24
1657357710053,MATH 142A,B03,093481,Chow; Bennett,8,0,32,24
1657357710053,MATH 142A,B04,093558,Chow; Bennett,13,0,32,19
1657357710053,MATH 142A,B05,093559,Chow; Bennett,6,0,32,26
1657357716080,MATH 193A,A01,083224,Rotar; Vladimir,8,0,34,26
1657357716080,MATH 193A,A02,083225,Rotar; Vladimir,9,0,34,25
1657357716080,MATH 193A,A03,083781,Rotar; Vladimir,5,0,34,29
1657357716080,MATH 193A,A04,083782,Rotar; Vladimir,10,0,34,24
1657357716080,MATH 193A,A05,093482,Rotar; Vladimir,10,0,34,24
1657357722104,MATH 197,001,091859,McAuley; Julian John,9999,0,9999,0
1657357722104,MATH 197,002,095566,Kedlaya; Kiran S.,9997,0,9999,2
1657357722104,MATH 197,003,095567,Xiao; Ming,9999,0,9999,0
1657357722104,MATH 197,004,095571,Perols; Johan Lars,9998,0,9999,1
1657357729182,COGS 9,A01,083615,Shannon; Kyle Michael,8,0,75,67
1657357735211,COGS 11,A01,083617,Boyle; Mary E. T.,22,0,48,26
1657357741234,COGS 13,A01,083071,Bastos; Amalia Pinkusfeld,11,0,71,60
1657357747266,COGS 14A,A01,092681,Semenuks; Arturs,4,1,100,96
1657357753289,COGS 14B,A01,083073,Cheng; Tzu-Han,6,0,63,57
1657357759313,COGS 17,A01,092677,Semenuks; Arturs,6,0,81,75
1657357765340,COGS 100,A01,083619,Allen; Michael Gordon,17,0,70,53
1657357771369,COGS 101A,A01,083621,Davis; Joshua Daniel,9,0,68,59
1657357777467,COGS 101B,A01,091572,Allen; Michael Gordon,11,0,65,54
1657357783492,COGS 101C,A01,083625,Delgado; Tania,17,0,35,18
1657357789516,COGS 107A,A01,083627,Boyle; Mary E. T.,13,0,60,47
1657357795540,COGS 118A,A01,083075,Gupta; Anjum,20,0,76,56
1657357801566,CSE 3,A50,083646,Miranda; Gregory Joseph,24,0,50,26
1657357807588,CSE 8A,A50,083650,Miranda; Gregory Joseph,17,1,56,39
1657357813615,CSE 11,A01,083080,Cao; Yingjun,6,15,40,34
1657357819641,CSE 12,A01,083652,Krause-Levy; Sophia Louisa,28,1,120,92
1657357825666,CSE 15L,A01,083654,Morris; Justin Loren,9,0,50,41
1657357825666,CSE 15L,A02,083655,Morris; Justin Loren,9,0,50,41
1657357831693,CSE 20,A01,083657,Tran; Khoa Dang,39,0,80,41
1657357837722,CSE 21,A01,095574,Bach; Quang Tran,22,0,48,26
1657357843744,CSE 30,A01,083084,Eldon; John,4,0,80,76
1657357843744,CSE 30,B01,095061,Bhaskar; Nishant,9,0,50,41
1657357849766,CSE 100,A01,083659,Cao; Yingjun,5,4,70,65
1657357855794,CSE 134B,A01,083661,Powell; Thomas Allan,22,0,100,78
1657357861820,CSE 140,A01,083663,Gungor; Onat,14,0,85,71
1657357867850,CSE 140L,A01,083088,Eldon; John,21,0,100,79
1657357873875,CSE 175,A01,083665,Kumar; Rakesh,3,0,25,22
1657357879900,CSE 190,A00,092507,Dubnov; Shlomo,7,0,20,13
1657357885928,ECE 45,A01,083139,Congero; Spencer William,6,0,75,69
1657357891954,ECE 65,A50,083695,Saad; Andrew S,12,0,30,18
1657357891954,ECE 65,A51,095125,Saad; Andrew S,24,0,26,2
1657357897977,ECE 109,A01,091882,Touri; Behrouz,19,0,70,51
1657357904005,ECE 180,A00,083140,Abi Samra; Nicholas Camill,1,0,30,29
1657357904005,ECE 180,B00,083141,Abi Samra; Nicholas Camill,0,0,30,30
1657357910031,MATH 10A,A01,083735,Patchell; Gregory David,2,0,30,28
1657357910031,MATH 10A,A02,083736,Patchell; Gregory David,20,0,30,10
1657357910031,MATH 10A,A03,083737,Patchell; Gregory David,16,0,30,14
1657357916055,MATH 10B,A01,083207,Lim; Seonhee,8,0,34,26
1657357916055,MATH 10B,A02,083208,Lim; Seonhee,9,0,35,26
1657357916055,MATH 10B,A03,093472,Lim; Seonhee,7,0,34,27
1657357916055,MATH 10B,B01,083739,Sinha; Shubham,12,0,30,18
1657357922086,MATH 18,A01,083743,Cinel; Cameron Alexander,7,0,30,23
1657357922086,MATH 18,A02,083744,Cinel; Cameron Alexander,17,0,30,13
1657357922086,MATH 18,A03,083745,Cinel; Cameron Alexander,9,0,30,21
1657357922086,MATH 18,B01,083748,Rideout; David Porter,5,0,37,32
1657357922086,MATH 18,B02,083749,Rideout; David Porter,5,0,36,31
1657357922086,MATH 18,B03,083750,Rideout; David Porter,3,0,37,34
1657357922086,MATH 18,B04,083751,Rideout; David Porter,6,0,36,30
1657357922086,MATH 18,B05,093473,Rideout; David Porter,6,0,36,30
1657357922086,MATH 18,B06,093474,Rideout; David Porter,6,0,36,30
1657357928110,MATH 20A,A01,083754,Zheng; Zequn,14,0,40,26
1657357934134,MATH 20B,A01,083756,Briones; Jor-el Thomas Caparas,4,0,36,32
1657357934134,MATH 20B,A02,083757,Briones; Jor-el Thomas Caparas,1,0,36,35
1657357934134,MATH 20B,A03,093475,Briones; Jor-el Thomas Caparas,2,0,36,34
1657357940161,MATH 20C,A01,083760,Briones; Jor-el Thomas Caparas,1,0,35,34
1657357940161,MATH 20C,A02,083761,Briones; Jor-el Thomas Caparas,8,0,35,27
1657357940161,MATH 20C,A03,093476,Briones; Jor-el Thomas Caparas,0,1,36,36
1657357940161,MATH 20C,B01,083762,Bach; Quang Tran,1,0,30,29
1657357946190,MATH 20D,A01,083765,Tran; Brian Kha,5,0,30,25
1657357946190,MATH 20D,A02,083766,Tran; Brian Kha,5,0,30,25
1657357946190,MATH 20D,A03,083767,Tran; Brian Kha,5,0,30,25
1657357952217,MATH 20E,A01,083771,Ganguly; Soumya,9,0,32,23
1657357952217,MATH 20E,A02,083772,Ganguly; Soumya,6,0,32,26
1657357952217,MATH 20E,B01,083773,Ciotti; Benjamin,20,0,35,15
1657357952217,MATH 20E,B02,083774,Ciotti; Benjamin,17,0,35,18
1657357958246,MATH 103A,A01,083777,Greenfeld; Be'Eri,3,0,36,33
1657357958246,MATH 103A,A02,083778,Greenfeld; Be'Eri,5,0,36,31
1657357958246,MATH 103A,A03,093561,Greenfeld; Be'Eri,5,0,36,31
1657357958246,MATH 103A,B01,083779,Greenfeld; Be'Eri,7,0,36,29
1657357958246,MATH 103A,B02,083780,Greenfeld; Be'Eri,4,0,36,32
1657357958246,MATH 103A,B03,093562,Greenfeld; Be'Eri,3,0,36,33
1657357964271,MATH 105,A01,085443,Carter; Anne Toulson,15,0,35,20
1657357964271,MATH 105,A02,093477,Carter; Anne Toulson,20,0,35,15
1657357970294,MATH 109,A01,083213,Ganzberger; Geoffrey Michael,2,0,34,32
1657357970294,MATH 109,A02,083214,Ganzberger; Geoffrey Michael,4,0,34,30
1657357970294,MATH 109,A03,093478,Ganzberger; Geoffrey Michael,2,0,34,32
1657357970294,MATH 109,B01,083215,Ganzberger; Geoffrey Michael,1,0,32,31
1657357970294,MATH 109,B02,083216,Ganzberger; Geoffrey Michael,2,0,32,30
1657357970294,MATH 109,B03,093479,Ganzberger; Geoffrey Michael,8,0,32,24
1657357976320,MATH 142A,A01,083219,Chow; Bennett,7,0,32,25
1657357976320,MATH 142A,A02,083220,Chow; Bennett,10,0,32,22
1657357976320,MATH 142A,A03,093480,Chow; Bennett,8,0,32,24
1657357976320,MATH 142A,B03,093481,Chow; Bennett,8,0,32,24
1657357976320,MATH 142A,B04,093558,Chow; Bennett,13,0,32,19
1657357976320,MATH 142A,B05,093559,Chow; Bennett,6,0,32,26
1657357982345,MATH 193A,A01,083224,Rotar; Vladimir,8,0,34,26
1657357982345,MATH 193A,A02,083225,Rotar; Vladimir,9,0,34,25
1657357982345,MATH 193A,A03,083781,Rotar; Vladimir,5,0,34,29
1657357982345,MATH 193A,A04,083782,Rotar; Vladimir,10,0,34,24
1657357982345,MATH 193A,A05,093482,Rotar; Vladimir,10,0,34,24
1657357988367,MATH 197,001,091859,McAuley; Julian John,9999,0,9999,0
1657357988367,MATH 197,002,095566,Kedlaya; Kiran S.,9997,0,9999,2
1657357988367,MATH 197,003,095567,Xiao; Ming,9999,0,9999,0
1657357988367,MATH 197,004,095571,Perols; Johan Lars,9998,0,9999,1
1657357995423,COGS 9,A01,083615,Shannon; Kyle Michael,8,0,75,67
1657358001449,COGS 11,A01,083617,Boyle; Mary E. T.,22,0,48,26
1657358007473,COGS 13,A01,083071,Bastos; Amalia Pinkusfeld,11,0,71,60
1657358013497,COGS 14A,A01,092681,Semenuks; Arturs,4,1,100,96
1657358019518,COGS 14B,A01,083073,Cheng; Tzu-Han,6,0,63,57
1657358025541,COGS 17,A01,092677,Semenuks; Arturs,6,0,81,75
1657358031567,COGS 100,A01,083619,Allen; Michael Gordon,17,0,70,53
1657358037593,COGS 101A,A01,083621,Davis; Joshua Daniel,9,0,68,59
1657358043623,COGS 101B,A01,091572,Allen; Michael Gordon,11,0,65,54
1657358049647,COGS 101C,A01,083625,Delgado; Tania,17,0,35,18
1657358055669,COGS 107A,A01,083627,Boyle; Mary E. T.,13,0,60,47
1657358061692,COGS 118A,A01,083075,Gupta; Anjum,20,0,76,56
1657358067719,CSE 3,A50,083646,Miranda; Gregory Joseph,24,0,50,26
1657358073742,CSE 8A,A50,083650,Miranda; Gregory Joseph,17,1,56,39
1657358079769,CSE 11,A01,083080,Cao; Yingjun,6,15,40,34
1657358085797,CSE 12,A01,083652,Krause-Levy; Sophia Louisa,28,1,120,92
1657358091825,CSE 15L,A01,083654,Morris; Justin Loren,9,0,50,41
1657358091825,CSE 15L,A02,083655,Morris; Justin Loren,9,0,50,41
1657358097849,CSE 20,A01,083657,Tran; Khoa Dang,39,0,80,41
1657358103875,CSE 21,A01,095574,Bach; Quang Tran,22,0,48,26
1657358109898,CSE 30,A01,083084,Eldon; John,4,0,80,76
1657358109898,CSE 30,B01,095061,Bhaskar; Nishant,9,0,50,41
1657358115921,CSE 100,A01,083659,Cao; Yingjun,5,4,70,65
1657358121948,CSE 134B,A01,083661,Powell; Thomas Allan,22,0,100,78
1657358127975,CSE 140,A01,083663,Gungor; Onat,14,0,85,71
1657358134005,CSE 140L,A01,083088,Eldon; John,21,0,100,79
1657358140028,CSE 175,A01,083665,Kumar; Rakesh,3,0,25,22
1657358146051,CSE 190,A00,092507,Dubnov; Shlomo,7,0,20,13
1657358152078,ECE 45,A01,083139,Congero; Spencer William,6,0,75,69
1657358158102,ECE 65,A50,083695,Saad; Andrew S,12,0,30,18
1657358158102,ECE 65,A51,095125,Saad; Andrew S,24,0,26,2
1657358164126,ECE 109,A01,091882,Touri; Behrouz,19,0,70,51
1657358170153,ECE 180,A00,083140,Abi Samra; Nicholas Camill,1,0,30,29
1657358170153,ECE 180,B00,083141,Abi Samra; Nicholas Camill,0,0,30,30
1657358176175,MATH 10A,A01,083735,Patchell; Gregory David,2,0,30,28
1657358176175,MATH 10A,A02,083736,Patchell; Gregory David,20,0,30,10
1657358176175,MATH 10A,A03,083737,Patchell; Gregory David,16,0,30,14
1657358182203,MATH 10B,A01,083207,Lim; Seonhee,8,0,34,26
1657358182203,MATH 10B,A02,083208,Lim; Seonhee,9,0,35,26
1657358182203,MATH 10B,A03,093472,Lim; Seonhee,7,0,34,27
1657358182203,MATH 10B,B01,083739,Sinha; Shubham,12,0,30,18
1657358188231,MATH 18,A01,083743,Cinel; Cameron Alexander,7,0,30,23
1657358188231,MATH 18,A02,083744,Cinel; Cameron Alexander,17,0,30,13
1657358188231,MATH 18,A03,083745,Cinel; Cameron Alexander,9,0,30,21
1657358188231,MATH 18,B01,083748,Rideout; David Porter,5,0,37,32
1657358188231,MATH 18,B02,083749,Rideout; David Porter,5,0,36,31
1657358188231,MATH 18,B03,083750,Rideout; David Porter,3,0,37,34
1657358188231,MATH 18,B04,083751,Rideout; David Porter,6,0,36,30
1657358188231,MATH 18,B05,093473,Rideout; David Porter,6,0,36,30
1657358188231,MATH 18,B06,093474,Rideout; David Porter,6,0,36,30
1657358194258,MATH 20A,A01,083754,Zheng; Zequn,14,0,40,26
1657358200281,MATH 20B,A01,083756,Briones; Jor-el Thomas Caparas,4,0,36,32
1657358200281,MATH 20B,A02,083757,Briones; Jor-el Thomas Caparas,1,0,36,35
1657358200281,MATH 20B,A03,093475,Briones; Jor-el Thomas Caparas,2,0,36,34
1657358206304,MATH 20C,A01,083760,Briones; Jor-el Thomas Caparas,1,0,35,34
1657358206304,MATH 20C,A02,083761,Briones; Jor-el Thomas Caparas,8,0,35,27
1657358206304,MATH 20C,A03,093476,Briones; Jor-el Thomas Caparas,0,1,36,36
1657358206304,MATH 20C,B01,083762,Bach; Quang Tran,1,0,30,29
1657358212326,MATH 20D,A01,083765,Tran; Brian Kha,5,0,30,25
1657358212326,MATH 20D,A02,083766,Tran; Brian Kha,5,0,30,25
1657358212326,MATH 20D,A03,083767,Tran; Brian Kha,5,0,30,25
1657358218349,MATH 20E,A01,083771,Ganguly; Soumya,9,0,32,23
1657358218349,MATH 20E,A02,083772,Ganguly; Soumya,6,0,32,26
1657358218349,MATH 20E,B01,083773,Ciotti; Benjamin,20,0,35,15
1657358218349,MATH 20E,B02,083774,Ciotti; Benjamin,17,0,35,18
1657358224379,MATH 103A,A01,083777,Greenfeld; Be'Eri,3,0,36,33
1657358224379,MATH 103A,A02,083778,Greenfeld; Be'Eri,5,0,36,31
1657358224379,MATH 103A,A03,093561,Greenfeld; Be'Eri,5,0,36,31
1657358224379,MATH 103A,B01,083779,Greenfeld; Be'Eri,7,0,36,29
1657358224379,MATH 103A,B02,083780,Greenfeld; Be'Eri,4,0,36,32
1657358224379,MATH 103A,B03,093562,Greenfeld; Be'Eri,3,0,36,33
1657358230400,MATH 105,A01,085443,Carter; Anne Toulson,15,0,35,20
1657358230400,MATH 105,A02,093477,Carter; Anne Toulson,20,0,35,15
1657358236428,MATH 109,A01,083213,Ganzberger; Geoffrey Michael,2,0,34,32
1657358236428,MATH 109,A02,083214,Ganzberger; Geoffrey Michael,4,0,34,30
1657358236428,MATH 109,A03,093478,Ganzberger; Geoffrey Michael,2,0,34,32
1657358236428,MATH 109,B01,083215,Ganzberger; Geoffrey Michael,1,0,32,31
1657358236428,MATH 109,B02,083216,Ganzberger; Geoffrey Michael,2,0,32,30
1657358236428,MATH 109,B03,093479,Ganzberger; Geoffrey Michael,8,0,32,24
1657358242456,MATH 142A,A01,083219,Chow; Bennett,7,0,32,25
1657358242456,MATH 142A,A02,083220,Chow; Bennett,10,0,32,22
1657358242456,MATH 142A,A03,093480,Chow; Bennett,8,0,32,24
1657358242456,MATH 142A,B03,093481,Chow; Bennett,8,0,32,24
1657358242456,MATH 142A,B04,093558,Chow; Bennett,13,0,32,19
1657358242456,MATH 142A,B05,093559,Chow; Bennett,6,0,32,26
1657358248485,MATH 193A,A01,083224,Rotar; Vladimir,8,0,34,26
1657358248485,MATH 193A,A02,083225,Rotar; Vladimir,9,0,34,25
1657358248485,MATH 193A,A03,083781,Rotar; Vladimir,5,0,34,29
1657358248485,MATH 193A,A04,083782,Rotar; Vladimir,10,0,34,24
1657358248485,MATH 193A,A05,093482,Rotar; Vladimir,10,0,34,24
1657358254522,MATH 197,001,091859,McAuley; Julian John,9999,0,9999,0
1657358254522,MATH 197,002,095566,Kedlaya; Kiran S.,9997,0,9999,2
1657358254522,MATH 197,003,095567,Xiao; Ming,9999,0,9999,0
1657358254522,MATH 197,004,095571,Perols; Johan Lars,9998,0,9999,1
1657358261571,COGS 9,A01,083615,Shannon; Kyle Michael,8,0,75,67
1657358267594,COGS 11,A01,083617,Boyle; Mary E. T.,22,0,48,26
1657358273618,COGS 13,A01,083071,Bastos; Amalia Pinkusfeld,11,0,71,60
1657358279644,COGS 14A,A01,092681,Semenuks; Arturs,4,1,100,96
1657358285667,COGS 14B,A01,083073,Cheng; Tzu-Han,6,0,63,57
1657358291694,COGS 17,A01,092677,Semenuks; Arturs,6,0,81,75
1657358297723,COGS 100,A01,083619,Allen; Michael Gordon,17,0,70,53
1657358303745,COGS 101A,A01,083621,Davis; Joshua Daniel,9,0,68,59
1657358309772,COGS 101B,A01,091572,Allen; Michael Gordon,11,0,65,54
1657358315796,COGS 101C,A01,083625,Delgado; Tania,17,0,35,18
1657358321824,COGS 107A,A01,083627,Boyle; Mary E. T.,13,0,60,47
1657358327849,COGS 118A,A01,083075,Gupta; Anjum,20,0,76,56
1657358333884,CSE 3,A50,083646,Miranda; Gregory Joseph,24,0,50,26
1657358339910,CSE 8A,A50,083650,Miranda; Gregory Joseph,17,1,56,39
1657358345933,CSE 11,A01,083080,Cao; Yingjun,6,15,40,34
1657358351956,CSE 12,A01,083652,Krause-Levy; Sophia Louisa,28,1,120,92
1657358357978,CSE 15L,A01,083654,Morris; Justin Loren,9,0,50,41
1657358357978,CSE 15L,A02,083655,Morris; Justin Loren,9,0,50,41
1657358364003,CSE 20,A01,083657,Tran; Khoa Dang,39,0,80,41
1657358370035,CSE 21,A01,095574,Bach; Quang Tran,22,0,48,26
1657358376131,CSE 30,A01,083084,Eldon; John,4,0,80,76
1657358376131,CSE 30,B01,095061,Bhaskar; Nishant,9,0,50,41
1657358382159,CSE 100,A01,083659,Cao; Yingjun,5,4,70,65
1657358388208,CSE 134B,A01,083661,Powell; Thomas Allan,22,0,100,78
1657358394232,CSE 140,A01,083663,Gungor; Onat,14,0,85,71
1657358400266,CSE 140L,A01,083088,Eldon; John,21,0,100,79
1657358406288,CSE 175,A01,083665,Kumar; Rakesh,3,0,25,22
1657358412313,CSE 190,A00,092507,Dubnov; Shlomo,7,0,20,13
1657358418339,ECE 45,A01,083139,Congero; Spencer William,6,0,75,69
1657358424366,ECE 65,A50,083695,Saad; Andrew S,12,0,30,18
1657358424366,ECE 65,A51,095125,Saad; Andrew S,24,0,26,2
1657358430387,ECE 109,A01,091882,Touri; Behrouz,19,0,70,51
1657358436410,ECE 180,A00,083140,Abi Samra; Nicholas Camill,1,0,30,29
1657358436410,ECE 180,B00,083141,Abi Samra; Nicholas Camill,0,0,30,30
1657358442433,MATH 10A,A01,083735,Patchell; Gregory David,2,0,30,28
1657358442433,MATH 10A,A02,083736,Patchell; Gregory David,20,0,30,10
1657358442433,MATH 10A,A03,083737,Patchell; Gregory David,16,0,30,14
1657358448457,MATH 10B,A01,083207,Lim; Seonhee,8,0,34,26
1657358448457,MATH 10B,A02,083208,Lim; Seonhee,9,0,35,26
1657358448457,MATH 10B,A03,093472,Lim; Seonhee,7,0,34,27
1657358448457,MATH 10B,B01,083739,Sinha; Shubham,12,0,30,18
1657358454480,MATH 18,A01,083743,Cinel; Cameron Alexander,7,0,30,23
1657358454480,MATH 18,A02,083744,Cinel; Cameron Alexander,17,0,30,13
1657358454480,MATH 18,A03,083745,Cinel; Cameron Alexander,9,0,30,21
1657358454480,MATH 18,B01,083748,Rideout; David Porter,5,0,37,32
1657358454480,MATH 18,B02,083749,Rideout; David Porter,5,0,36,31
1657358454480,MATH 18,B03,083750,Rideout; David Porter,3,0,37,34
1657358454480,MATH 18,B04,083751,Rideout; David Porter,6,0,36,30
1657358454480,MATH 18,B05,093473,Rideout; David Porter,6,0,36,30
1657358454480,MATH 18,B06,093474,Rideout; David Porter,6,0,36,30
1657358460503,MATH 20A,A01,083754,Zheng; Zequn,14,0,40,26
1657358466531,MATH 20B,A01,083756,Briones; Jor-el Thomas Caparas,4,0,36,32
1657358466531,MATH 20B,A02,083757,Briones; Jor-el Thomas Caparas,1,0,36,35
1657358466531,MATH 20B,A03,093475,Briones; Jor-el Thomas Caparas,2,0,36,34
1657358472554,MATH 20C,A01,083760,Briones; Jor-el Thomas Caparas,1,0,35,34
1657358472554,MATH 20C,A02,083761,Briones; Jor-el Thomas Caparas,8,0,35,27
1657358472554,MATH 20C,A03,093476,Briones; Jor-el Thomas Caparas,0,1,36,36
1657358472554,MATH 20C,B01,083762,Bach; Quang Tran,1,0,30,29
1657358478578,MATH 20D,A01,083765,Tran; Brian Kha,5,0,30,25
1657358478578,MATH 20D,A02,083766,Tran; Brian Kha,5,0,30,25
1657358478578,MATH 20D,A03,083767,Tran; Brian Kha,5,0,30,25
1657358484602,MATH 20E,A01,083771,Ganguly; Soumya,9,0,32,23
1657358484602,MATH 20E,A02,083772,Ganguly; Soumya,6,0,32,26
1657358484602,MATH 20E,B01,083773,Ciotti; Benjamin,20,0,35,15
1657358484602,MATH 20E,B02,083774,Ciotti; Benjamin,17,0,35,18
1657358490625,MATH 103A,A01,083777,Greenfeld; Be'Eri,3,0,36,33
1657358490625,MATH 103A,A02,083778,Greenfeld; Be'Eri,5,0,36,31
1657358490625,MATH 103A,A03,093561,Greenfeld; Be'Eri,5,0,36,31
1657358490625,MATH 103A,B01,083779,Greenfeld; Be'Eri,7,0,36,29
1657358490625,MATH 103A,B02,083780,Greenfeld; Be'Eri,4,0,36,32
1657358490625,MATH 103A,B03,093562,Greenfeld; Be'Eri,3,0,36,33
1657358496650,MATH 105,A01,085443,Carter; Anne Toulson,15,0,35,20
1657358496650,MATH 105,A02,093477,Carter; Anne Toulson,20,0,35,15
1657358502679,MATH 109,A01,083213,Ganzberger; Geoffrey Michael,2,0,34,32
1657358502679,MATH 109,A02,083214,Ganzberger; Geoffrey Michael,4,0,34,30
1657358502679,MATH 109,A03,093478,Ganzberger; Geoffrey Michael,2,0,34,32
1657358502679,MATH 109,B01,083215,Ganzberger; Geoffrey Michael,1,0,32,31
1657358502679,MATH 109,B02,083216,Ganzberger; Geoffrey Michael,2,0,32,30
1657358502679,MATH 109,B03,093479,Ganzberger; Geoffrey Michael,8,0,32,24
1657358508708,MATH 142A,A01,083219,Chow; Bennett,7,0,32,25
1657358508708,MATH 142A,A02,083220,Chow; Bennett,10,0,32,22
1657358508708,MATH 142A,A03,093480,Chow; Bennett,8,0,32,24
1657358508708,MATH 142A,B03,093481,Chow; Bennett,8,0,32,24
1657358508708,MATH 142A,B04,093558,Chow; Bennett,13,0,32,19
1657358508708,MATH 142A,B05,093559,Chow; Bennett,6,0,32,26
1657358514735,MATH 193A,A01,083224,Rotar; Vladimir,8,0,34,26
1657358514735,MATH 193A,A02,083225,Rotar; Vladimir,9,0,34,25
1657358514735,MATH 193A,A03,083781,Rotar; Vladimir,5,0,34,29
1657358514735,MATH 193A,A04,083782,Rotar; Vladimir,10,0,34,24
1657358514735,MATH 193A,A05,093482,Rotar; Vladimir,10,0,34,24
1657358520757,MATH 197,001,091859,McAuley; Julian John,9999,0,9999,0
1657358520757,MATH 197,002,095566,Kedlaya; Kiran S.,9997,0,9999,2
1657358520757,MATH 197,003,095567,Xiao; Ming,9999,0,9999,0
1657358520757,MATH 197,004,095571,Perols; Johan Lars,9998,0,9999,1
1657358527818,COGS 9,A01,083615,Shannon; Kyle Michael,8,0,75,67
1657358533841,COGS 11,A01,083617,Boyle; Mary E. T.,22,0,48,26
1657358539864,COGS 13,A01,083071,Bastos; Amalia Pinkusfeld,11,0,71,60
1657358545889,COGS 14A,A01,092681,Semenuks; Arturs,4,1,100,96
1657358551921,COGS 14B,A01,083073,Cheng; Tzu-Han,6,0,63,57
1657358557943,COGS 17,A01,092677,Semenuks; Arturs,6,0,81,75
1657358563968,COGS 100,A01,083619,Allen; Michael Gordon,17,0,70,53
1657358569990,COGS 101A,A01,083621,Davis; Joshua Daniel,9,0,68,59
1657358576017,COGS 101B,A01,091572,Allen; Michael Gordon,11,0,65,54
1657358582043,COGS 101C,A01,083625,Delgado; Tania,17,0,35,18
1657358588065,COGS 107A,A01,083627,Boyle; Mary E. T.,13,0,60,47
1657358594089,COGS 118A,A01,083075,Gupta; Anjum,20,0,76,56
1657358600116,CSE 3,A50,083646,Miranda; Gregory Joseph,24,0,50,26
1657358606143,CSE 8A,A50,083650,Miranda; Gregory Joseph,17,1,56,39
1657358612198,CSE 11,A01,083080,Cao; Yingjun,6,15,40,34
1657358618222,CSE 12,A01,083652,Krause-Levy; Sophia Louisa,28,1,120,92
1657358624244,CSE 15L,A01,083654,Morris; Justin Loren,9,0,50,41
1657358624244,CSE 15L,A02,083655,Morris; Justin Loren,9,0,50,41
1657358630272,CSE 20,A01,083657,Tran; Khoa Dang,39,0,80,41
1657358636300,CSE 21,A01,095574,Bach; Quang Tran,22,0,48,26
1657358642327,CSE 30,A01,083084,Eldon; John,4,0,80,76
1657358642327,CSE 30,B01,095061,Bhaskar; Nishant,9,0,50,41
1657358648351,CSE 100,A01,083659,Cao; Yingjun,5,4,70,65
1657358654374,CSE 134B,A01,083661,Powell; Thomas Allan,22,0,100,78
1657358660398,CSE 140,A01,083663,Gungor; Onat,14,0,85,71
1657358666425,CSE 140L,A01,083088,Eldon; John,21,0,100,79
1657358672450,CSE 175,A01,083665,Kumar; Rakesh,3,0,25,22
1657358678472,CSE 190,A00,092507,Dubnov; Shlomo,7,0,20,13
1657358684500,ECE 45,A01,083139,Congero; Spencer William,6,0,75,69
1657358690527,ECE 65,A50,083695,Saad; Andrew S,12,0,30,18
1657358690527,ECE 65,A51,095125,Saad; Andrew S,24,0,26,2
1657358696556,ECE 109,A01,091882,Touri; Behrouz,19,0,70,51
1657358702582,ECE 180,A00,083140,Abi Samra; Nicholas Camill,1,0,30,29
1657358702582,ECE 180,B00,083141,Abi Samra; Nicholas Camill,0,0,30,30
1657358708610,MATH 10A,A01,083735,Patchell; Gregory David,2,0,30,28
1657358708610,MATH 10A,A02,083736,Patchell; Gregory David,20,0,30,10
1657358708610,MATH 10A,A03,083737,Patchell; Gregory David,16,0,30,14
1657358714642,MATH 10B,A01,083207,Lim; Seonhee,8,0,34,26
1657358714642,MATH 10B,A02,083208,Lim; Seonhee,9,0,35,26
1657358714642,MATH 10B,A03,093472,Lim; Seonhee,7,0,34,27
1657358714642,MATH 10B,B01,083739,Sinha; Shubham,12,0,30,18
1657358720672,MATH 18,A01,083743,Cinel; Cameron Alexander,7,0,30,23
1657358720672,MATH 18,A02,083744,Cinel; Cameron Alexander,17,0,30,13
1657358720672,MATH 18,A03,083745,Cinel; Cameron Alexander,9,0,30,21
1657358720672,MATH 18,B01,083748,Rideout; David Porter,5,0,37,32
1657358720672,MATH 18,B02,083749,Rideout; David Porter,5,0,36,31
1657358720672,MATH 18,B03,083750,Rideout; David Porter,3,0,37,34
1657358720672,MATH 18,B04,083751,Rideout; David Porter,6,0,36,30
1657358720672,MATH 18,B05,093473,Rideout; David Porter,6,0,36,30
1657358720672,MATH 18,B06,093474,Rideout; David Porter,6,0,36,30
1657358726695,MATH 20A,A01,083754,Zheng; Zequn,14,0,40,26
1657358732724,MATH 20B,A01,083756,Briones; Jor-el Thomas Caparas,4,0,36,32
1657358732724,MATH 20B,A02,083757,Briones; Jor-el Thomas Caparas,1,0,36,35
1657358732724,MATH 20B,A03,093475,Briones; Jor-el Thomas Caparas,2,0,36,34
1657358738749,MATH 20C,A01,083760,Briones; Jor-el Thomas Caparas,1,0,35,34
1657358738749,MATH 20C,A02,083761,Briones; Jor-el Thomas Caparas,8,0,35,27
1657358738749,MATH 20C,A03,093476,Briones; Jor-el Thomas Caparas,0,1,36,36
1657358738749,MATH 20C,B01,083762,Bach; Quang Tran,1,0,30,29
1657358744775,MATH 20D,A01,083765,Tran; Brian Kha,5,0,30,25
1657358744775,MATH 20D,A02,083766,Tran; Brian Kha,5,0,30,25
1657358744775,MATH 20D,A03,083767,Tran; Brian Kha,5,0,30,25
1657358750798,MATH 20E,A01,083771,Ganguly; Soumya,9,0,32,23
1657358750798,MATH 20E,A02,083772,Ganguly; Soumya,6,0,32,26
1657358750798,MATH 20E,B01,083773,Ciotti; Benjamin,20,0,35,15
1657358750798,MATH 20E,B02,083774,Ciotti; Benjamin,17,0,35,18
1657358756827,MATH 103A,A01,083777,Greenfeld; Be'Eri,3,0,36,33
1657358756827,MATH 103A,A02,083778,Greenfeld; Be'Eri,5,0,36,31
1657358756827,MATH 103A,A03,093561,Greenfeld; Be'Eri,5,0,36,31
1657358756827,MATH 103A,B01,083779,Greenfeld; Be'Eri,7,0,36,29
1657358756827,MATH 103A,B02,083780,Greenfeld; Be'Eri,4,0,36,32
1657358756827,MATH 103A,B03,093562,Greenfeld; Be'Eri,3,0,36,33
1657358762854,MATH 105,A01,085443,Carter; Anne Toulson,15,0,35,20
1657358762854,MATH 105,A02,093477,Carter; Anne Toulson,20,0,35,15
1657358768876,MATH 109,A01,083213,Ganzberger; Geoffrey Michael,2,0,34,32
1657358768876,MATH 109,A02,083214,Ganzberger; Geoffrey Michael,4,0,34,30
1657358768876,MATH 109,A03,093478,Ganzberger; Geoffrey Michael,2,0,34,32
1657358768876,MATH 109,B01,083215,Ganzberger; Geoffrey Michael,1,0,32,31
1657358768876,MATH 109,B02,083216,Ganzberger; Geoffrey Michael,2,0,32,30
1657358768876,MATH 109,B03,093479,Ganzberger; Geoffrey Michael,8,0,32,24
1657358774910,MATH 142A,A01,083219,Chow; Bennett,7,0,32,25
1657358774910,MATH 142A,A02,083220,Chow; Bennett,10,0,32,22
1657358774910,MATH 142A,A03,093480,Chow; Bennett,8,0,32,24
1657358774910,MATH 142A,B03,093481,Chow; Bennett,8,0,32,24
1657358774910,MATH 142A,B04,093558,Chow; Bennett,13,0,32,19
1657358774910,MATH 142A,B05,093559,Chow; Bennett,6,0,32,26
1657358780940,MATH 193A,A01,083224,Rotar; Vladimir,8,0,34,26
1657358780940,MATH 193A,A02,083225,Rotar; Vladimir,9,0,34,25
1657358780940,MATH 193A,A03,083781,Rotar; Vladimir,5,0,34,29
1657358780940,MATH 193A,A04,083782,Rotar; Vladimir,10,0,34,24
1657358780940,MATH 193A,A05,093482,Rotar; Vladimir,10,0,34,24
1657358786964,MATH 197,001,091859,McAuley; Julian John,9999,0,9999,0
1657358786964,MATH 197,002,095566,Kedlaya; Kiran S.,9997,0,9999,2
1657358786964,MATH 197,003,095567,Xiao; Ming,9999,0,9999,0
1657358786964,MATH 197,004,095571,Perols; Johan Lars,9998,0,9999,1
1657358794017,COGS 9,A01,083615,Shannon; Kyle Michael,8,0,75,67
1657358800045,COGS 11,A01,083617,Boyle; Mary E. T.,22,0,48,26
1657358806067,COGS 13,A01,083071,Bastos; Amalia Pinkusfeld,11,0,71,60
1657358812090,COGS 14A,A01,092681,Semenuks; Arturs,4,1,100,96
1657358818117,COGS 14B,A01,083073,Cheng; Tzu-Han,6,0,63,57
1657358824144,COGS 17,A01,092677,Semenuks; Arturs,6,0,81,75
1657358830166,COGS 100,A01,083619,Allen; Michael Gordon,17,0,70,53
1657358836190,COGS 101A,A01,083621,Davis; Joshua Daniel,9,0,68,59
1657358842217,COGS 101B,A01,091572,Allen; Michael Gordon,11,0,65,54
1657358848240,COGS 101C,A01,083625,Delgado; Tania,17,0,35,18
1657358854263,COGS 107A,A01,083627,Boyle; Mary E. T.,13,0,60,47
1657358860286,COGS 118A,A01,083075,Gupta; Anjum,20,0,76,56
1657358866314,CSE 3,A50,083646,Miranda; Gregory Joseph,24,0,50,26
1657358872341,CSE 8A,A50,083650,Miranda; Gregory Joseph,17,1,56,39
1657358878367,CSE 11,A01,083080,Cao; Yingjun,6,15,40,34
1657358884394,CSE 12,A01,083652,Krause-Levy; Sophia Louisa,28,1,120,92
1657358890417,CSE 15L,A01,083654,Morris; Justin Loren,9,0,50,41
1657358890417,CSE 15L,A02,083655,Morris; Justin Loren,9,0,50,41
1657358896442,CSE 20,A01,083657,Tran; Khoa Dang,39,0,80,41
1657358902467,CSE 21,A01,095574,Bach; Quang Tran,22,0,48,26
1657358908493,CSE 30,A01,083084,Eldon; John,4,0,80,76
1657358908493,CSE 30,B01,095061,Bhaskar; Nishant,9,0,50,41
1657358914518,CSE 100,A01,083659,Cao; Yingjun,5,4,70,65
1657358920541,CSE 134B,A01,083661,Powell; Thomas Allan,22,0,100,78
1657358926567,CSE 140,A01,083663,Gungor; Onat,14,0,85,71
1657358932589,CSE 140L,A01,083088,Eldon; John,21,0,100,79
1657358938610,CSE 175,A01,083665,Kumar; Rakesh,3,0,25,22
1657358944634,CSE 190,A00,092507,Dubnov; Shlomo,7,0,20,13
1657358950662,ECE 45,A01,083139,Congero; Spencer William,6,0,75,69
1657358956684,ECE 65,A50,083695,Saad; Andrew S,12,0,30,18
1657358956684,ECE 65,A51,095125,Saad; Andrew S,24,0,26,2
1657358962707,ECE 109,A01,091882,Touri; Behrouz,19,0,70,51
1657358968729,ECE 180,A00,083140,Abi Samra; Nicholas Camill,1,0,30,29
1657358968729,ECE 180,B00,083141,Abi Samra; Nicholas Camill,0,0,30,30
1657358974826,MATH 10A,A01,083735,Patchell; Gregory David,2,0,30,28
1657358974826,MATH 10A,A02,083736,Patchell; Gregory David,20,0,30,10
1657358974826,MATH 10A,A03,083737,Patchell; Gregory David,16,0,30,14
1657358980854,MATH 10B,A01,083207,Lim; Seonhee,8,0,34,26
1657358980854,MATH 10B,A02,083208,Lim; Seonhee,9,0,35,26
1657358980854,MATH 10B,A03,093472,Lim; Seonhee,7,0,34,27
1657358980854,MATH 10B,B01,083739,Sinha; Shubham,12,0,30,18
1657358986886,MATH 18,A01,083743,Cinel; Cameron Alexander,7,0,30,23
1657358986886,MATH 18,A02,083744,Cinel; Cameron Alexander,17,0,30,13
1657358986886,MATH 18,A03,083745,Cinel; Cameron Alexander,9,0,30,21
1657358986886,MATH 18,B01,083748,Rideout; David Porter,5,0,37,32
1657358986886,MATH 18,B02,083749,Rideout; David Porter,5,0,36,31
1657358986886,MATH 18,B03,083750,Rideout; David Porter,3,0,37,34
1657358986886,MATH 18,B04,083751,Rideout; David Porter,6,0,36,30
1657358986886,MATH 18,B05,093473,Rideout; David Porter,6,0,36,30
1657358986886,MATH 18,B06,093474,Rideout; David Porter,6,0,36,30
1657358992911,MATH 20A,A01,083754,Zheng; Zequn,14,0,40,26
1657358998934,MATH 20B,A01,083756,Briones; Jor-el Thomas Caparas,4,0,36,32
1657358998934,MATH 20B,A02,083757,Briones; Jor-el Thomas Caparas,1,0,36,35
1657358998934,MATH 20B,A03,093475,Briones; Jor-el Thomas Caparas,2,0,36,34
1657359004957,MATH 20C,A01,083760,Briones; Jor-el Thomas Caparas,1,0,35,34
1657359004957,MATH 20C,A02,083761,Briones; Jor-el Thomas Caparas,8,0,35,27
1657359004957,MATH 20C,A03,093476,Briones; Jor-el Thomas Caparas,0,1,36,36
1657359004957,MATH 20C,B01,083762,Bach; Quang Tran,1,0,30,29
1657359010979,MATH 20D,A01,083765,Tran; Brian Kha,5,0,30,25
1657359010979,MATH 20D,A02,083766,Tran; Brian Kha,5,0,30,25
1657359010979,MATH 20D,A03,083767,Tran; Brian Kha,5,0,30,25
1657359017008,MATH 20E,A01,083771,Ganguly; Soumya,9,0,32,23
1657359017008,MATH 20E,A02,083772,Ganguly; Soumya,6,0,32,26
1657359017008,MATH 20E,B01,083773,Ciotti; Benjamin,20,0,35,15
1657359017008,MATH 20E,B02,083774,Ciotti; Benjamin,17,0,35,18
1657359023034,MATH 103A,A01,083777,Greenfeld; Be'Eri,3,0,36,33
1657359023034,MATH 103A,A02,083778,Greenfeld; Be'Eri,5,0,36,31
1657359023034,MATH 103A,A03,093561,Greenfeld; Be'Eri,5,0,36,31
1657359023034,MATH 103A,B01,083779,Greenfeld; Be'Eri,7,0,36,29
1657359023034,MATH 103A,B02,083780,Greenfeld; Be'Eri,4,0,36,32
1657359023034,MATH 103A,B03,093562,Greenfeld; Be'Eri,3,0,36,33
1657359029063,MATH 105,A01,085443,Carter; Anne Toulson,15,0,35,20
1657359029063,MATH 105,A02,093477,Carter; Anne Toulson,20,0,35,15
1657359035264,MATH 109,A01,083213,Ganzberger; Geoffrey Michael,2,0,34,32
1657359035264,MATH 109,A02,083214,Ganzberger; Geoffrey Michael,4,0,34,30
1657359035264,MATH 109,A03,093478,Ganzberger; Geoffrey Michael,2,0,34,32
1657359035264,MATH 109,B01,083215,Ganzberger; Geoffrey Michael,1,0,32,31
1657359035264,MATH 109,B02,083216,Ganzberger; Geoffrey Michael,2,0,32,30
1657359035264,MATH 109,B03,093479,Ganzberger; Geoffrey Michael,8,0,32,24
1657359041295,MATH 142A,A01,083219,Chow; Bennett,7,0,32,25
1657359041295,MATH 142A,A02,083220,Chow; Bennett,10,0,32,22
1657359041295,MATH 142A,A03,093480,Chow; Bennett,8,0,32,24
1657359041295,MATH 142A,B03,093481,Chow; Bennett,8,0,32,24
1657359041295,MATH 142A,B04,093558,Chow; Bennett,13,0,32,19
1657359041295,MATH 142A,B05,093559,Chow; Bennett,6,0,32,26
1657359047317,MATH 193A,A01,083224,Rotar; Vladimir,8,0,34,26
1657359047317,MATH 193A,A02,083225,Rotar; Vladimir,9,0,34,25
1657359047317,MATH 193A,A03,083781,Rotar; Vladimir,5,0,34,29
1657359047317,MATH 193A,A04,083782,Rotar; Vladimir,10,0,34,24
1657359047317,MATH 193A,A05,093482,Rotar; Vladimir,10,0,34,24
1657359053340,MATH 197,001,091859,McAuley; Julian John,9999,0,9999,0
1657359053340,MATH 197,002,095566,Kedlaya; Kiran S.,9997,0,9999,2
1657359053340,MATH 197,003,095567,Xiao; Ming,9999,0,9999,0
1657359053340,MATH 197,004,095571,Perols; Johan Lars,9998,0,9999,1
1657359060405,COGS 9,A01,083615,Shannon; Kyle Michael,8,0,75,67
1657359066432,COGS 11,A01,083617,Boyle; Mary E. T.,22,0,48,26
1657359072458,COGS 13,A01,083071,Bastos; Amalia Pinkusfeld,11,0,71,60
1657359078484,COGS 14A,A01,092681,Semenuks; Arturs,4,1,100,96
1657359084511,COGS 14B,A01,083073,Cheng; Tzu-Han,6,0,63,57
1657359090537,COGS 17,A01,092677,Semenuks; Arturs,6,0,81,75
1657359096559,COGS 100,A01,083619,Allen; Michael Gordon,17,0,70,53
1657359102587,COGS 101A,A01,083621,Davis; Joshua Daniel,9,0,68,59
1657359108610,COGS 101B,A01,091572,Allen; Michael Gordon,11,0,65,54
1657359114634,COGS 101C,A01,083625,Delgado; Tania,17,0,35,18
1657359120661,COGS 107A,A01,083627,Boyle; Mary E. T.,13,0,60,47
1657359126692,COGS 118A,A01,083075,Gupta; Anjum,20,0,76,56
1657359132722,CSE 3,A50,083646,Miranda; Gregory Joseph,24,0,50,26
1657359138746,CSE 8A,A50,083650,Miranda; Gregory Joseph,17,1,56,39
1657359144774,CSE 11,A01,083080,Cao; Yingjun,6,15,40,34
1657359150801,CSE 12,A01,083652,Krause-Levy; Sophia Louisa,28,1,120,92
1657359156829,CSE 15L,A01,083654,Morris; Justin Loren,9,0,50,41
1657359156829,CSE 15L,A02,083655,Morris; Justin Loren,9,0,50,41
1657359162851,CSE 20,A01,083657,Tran; Khoa Dang,39,0,80,41
1657359168876,CSE 21,A01,095574,Bach; Quang Tran,22,0,48,26
1657359174904,CSE 30,A01,083084,Eldon; John,4,0,80,76
1657359174904,CSE 30,B01,095061,Bhaskar; Nishant,9,0,50,41
1657359180927,CSE 100,A01,083659,Cao; Yingjun,5,4,70,65
1657359186951,CSE 134B,A01,083661,Powell; Thomas Allan,22,0,100,78
1657359192979,CSE 140,A01,083663,Gungor; Onat,14,0,85,71
1657359199012,CSE 140L,A01,083088,Eldon; John,21,0,100,79
1657359205039,CSE 175,A01,083665,Kumar; Rakesh,3,0,25,22
1657359211064,CSE 190,A00,092507,Dubnov; Shlomo,7,0,20,13
1657359217088,ECE 45,A01,083139,Congero; Spencer William,6,0,75,69
1657359223117,ECE 65,A50,083695,Saad; Andrew S,12,0,30,18
1657359223117,ECE 65,A51,095125,Saad; Andrew S,24,0,26,2
1657359229139,ECE 109,A01,091882,Touri; Behrouz,19,0,70,51
1657359235163,ECE 180,A00,083140,Abi Samra; Nicholas Camill,1,0,30,29
1657359235163,ECE 180,B00,083141,Abi Samra; Nicholas Camill,0,0,30,30
1657359241188,MATH 10A,A01,083735,Patchell; Gregory David,2,0,30,28
1657359241188,MATH 10A,A02,083736,Patchell; Gregory David,20,0,30,10
1657359241188,MATH 10A,A03,083737,Patchell; Gregory David,16,0,30,14
1657359247217,MATH 10B,A01,083207,Lim; Seonhee,8,0,34,26
1657359247217,MATH 10B,A02,083208,Lim; Seonhee,9,0,35,26
1657359247217,MATH 10B,A03,093472,Lim; Seonhee,7,0,34,27
1657359247217,MATH 10B,B01,083739,Sinha; Shubham,12,0,30,18
1657359253241,MATH 18,A01,083743,Cinel; Cameron Alexander,7,0,30,23
1657359253241,MATH 18,A02,083744,Cinel; Cameron Alexander,17,0,30,13
1657359253241,MATH 18,A03,083745,Cinel; Cameron Alexander,9,0,30,21
1657359253241,MATH 18,B01,083748,Rideout; David Porter,5,0,37,32
1657359253241,MATH 18,B02,083749,Rideout; David Porter,5,0,36,31
1657359253241,MATH 18,B03,083750,Rideout; David Porter,3,0,37,34
1657359253241,MATH 18,B04,083751,Rideout; David Porter,6,0,36,30
1657359253241,MATH 18,B05,093473,Rideout; David Porter,6,0,36,30
1657359253241,MATH 18,B06,093474,Rideout; David Porter,6,0,36,30
1657359259268,MATH 20A,A01,083754,Zheng; Zequn,14,0,40,26
1657359265291,MATH 20B,A01,083756,Briones; Jor-el Thomas Caparas,4,0,36,32
1657359265291,MATH 20B,A02,083757,Briones; Jor-el Thomas Caparas,1,0,36,35
1657359265291,MATH 20B,A03,093475,Briones; Jor-el Thomas Caparas,2,0,36,34
1657359271316,MATH 20C,A01,083760,Briones; Jor-el Thomas Caparas,1,0,35,34
1657359271316,MATH 20C,A02,083761,Briones; Jor-el Thomas Caparas,8,0,35,27
1657359271316,MATH 20C,A03,093476,Briones; Jor-el Thomas Caparas,0,1,36,36
1657359271316,MATH 20C,B01,083762,Bach; Quang Tran,1,0,30,29
1657359277340,MATH 20D,A01,083765,Tran; Brian Kha,5,0,30,25
1657359277340,MATH 20D,A02,083766,Tran; Brian Kha,5,0,30,25
1657359277340,MATH 20D,A03,083767,Tran; Brian Kha,5,0,30,25
1657359283363,MATH 20E,A01,083771,Ganguly; Soumya,9,0,32,23
1657359283363,MATH 20E,A02,083772,Ganguly; Soumya,6,0,32,26
1657359283363,MATH 20E,B01,083773,Ciotti; Benjamin,20,0,35,15
1657359283363,MATH 20E,B02,083774,Ciotti; Benjamin,17,0,35,18
1657359289388,MATH 103A,A01,083777,Greenfeld; Be'Eri,3,0,36,33
1657359289388,MATH 103A,A02,083778,Greenfeld; Be'Eri,5,0,36,31
1657359289388,MATH 103A,A03,093561,Greenfeld; Be'Eri,5,0,36,31
1657359289388,MATH 103A,B01,083779,Greenfeld; Be'Eri,7,0,36,29
1657359289388,MATH 103A,B02,083780,Greenfeld; Be'Eri,4,0,36,32
1657359289388,MATH 103A,B03,093562,Greenfeld; Be'Eri,3,0,36,33
1657359295411,MATH 105,A01,085443,Carter; Anne Toulson,15,0,35,20
1657359295411,MATH 105,A02,093477,Carter; Anne Toulson,20,0,35,15
1657359301435,MATH 109,A01,083213,Ganzberger; Geoffrey Michael,2,0,34,32
1657359301435,MATH 109,A02,083214,Ganzberger; Geoffrey Michael,4,0,34,30
1657359301435,MATH 109,A03,093478,Ganzberger; Geoffrey Michael,2,0,34,32
1657359301435,MATH 109,B01,083215,Ganzberger; Geoffrey Michael,1,0,32,31
1657359301435,MATH 109,B02,083216,Ganzberger; Geoffrey Michael,2,0,32,30
1657359301435,MATH 109,B03,093479,Ganzberger; Geoffrey Michael,8,0,32,24
1657359307459,MATH 142A,A01,083219,Chow; Bennett,7,0,32,25
1657359307459,MATH 142A,A02,083220,Chow; Bennett,10,0,32,22
1657359307459,MATH 142A,A03,093480,Chow; Bennett,8,0,32,24
1657359307459,MATH 142A,B03,093481,Chow; Bennett,8,0,32,24
1657359307459,MATH 142A,B04,093558,Chow; Bennett,13,0,32,19
1657359307459,MATH 142A,B05,093559,Chow; Bennett,6,0,32,26
1657359313483,MATH 193A,A01,083224,Rotar; Vladimir,8,0,34,26
1657359313483,MATH 193A,A02,083225,Rotar; Vladimir,9,0,34,25
1657359313483,MATH 193A,A03,083781,Rotar; Vladimir,5,0,34,29
1657359313483,MATH 193A,A04,083782,Rotar; Vladimir,10,0,34,24
1657359313483,MATH 193A,A05,093482,Rotar; Vladimir,10,0,34,24
1657359319507,MATH 197,001,091859,McAuley; Julian John,9999,0,9999,0
1657359319507,MATH 197,002,095566,Kedlaya; Kiran S.,9997,0,9999,2
1657359319507,MATH 197,003,095567,Xiao; Ming,9999,0,9999,0
1657359319507,MATH 197,004,095571,Perols; Johan Lars,9998,0,9999,1
1657359326560,COGS 9,A01,083615,Shannon; Kyle Michael,8,0,75,67
1657359332595,COGS 11,A01,083617,Boyle; Mary E. T.,22,0,48,26
1657359338617,COGS 13,A01,083071,Bastos; Amalia Pinkusfeld,11,0,71,60
1657359344644,COGS 14A,A01,092681,Semenuks; Arturs,4,1,100,96
1657359350666,COGS 14B,A01,083073,Cheng; Tzu-Han,6,0,63,57
1657359356691,COGS 17,A01,092677,Semenuks; Arturs,6,0,81,75
1657359362717,COGS 100,A01,083619,Allen; Michael Gordon,17,0,70,53
1657359368740,COGS 101A,A01,083621,Davis; Joshua Daniel,9,0,68,59
1657359374762,COGS 101B,A01,091572,Allen; Michael Gordon,11,0,65,54
1657359380786,COGS 101C,A01,083625,Delgado; Tania,17,0,35,18
1657359386812,COGS 107A,A01,083627,Boyle; Mary E. T.,13,0,60,47
1657359392836,COGS 118A,A01,083075,Gupta; Anjum,20,0,76,56
1657359398862,CSE 3,A50,083646,Miranda; Gregory Joseph,24,0,50,26
1657359404884,CSE 8A,A50,083650,Miranda; Gregory Joseph,17,1,56,39
1657359410910,CSE 11,A01,083080,Cao; Yingjun,6,15,40,34
1657359416933,CSE 12,A01,083652,Krause-Levy; Sophia Louisa,28,1,120,92
1657359422957,CSE 15L,A01,083654,Morris; Justin Loren,9,0,50,41
1657359422957,CSE 15L,A02,083655,Morris; Justin Loren,9,0,50,41
1657359428981,CSE 20,A01,083657,Tran; Khoa Dang,39,0,80,41
1657359435005,CSE 21,A01,095574,Bach; Quang Tran,22,0,48,26
1657359441033,CSE 30,A01,083084,Eldon; John,4,0,80,76
1657359441033,CSE 30,B01,095061,Bhaskar; Nishant,9,0,50,41
1657359447060,CSE 100,A01,083659,Cao; Yingjun,5,4,70,65
1657359453085,CSE 134B,A01,083661,Powell; Thomas Allan,22,0,100,78
1657359459111,CSE 140,A01,083663,Gungor; Onat,14,0,85,71
1657359465135,CSE 140L,A01,083088,Eldon; John,21,0,100,79
1657359471158,CSE 175,A01,083665,Kumar; Rakesh,3,0,25,22
1657359477181,CSE 190,A00,092507,Dubnov; Shlomo,7,0,20,13
1657359483204,ECE 45,A01,083139,Congero; Spencer William,6,0,75,69
1657359489232,ECE 65,A50,083695,Saad; Andrew S,12,0,30,18
1657359489232,ECE 65,A51,095125,Saad; Andrew S,24,0,26,2
1657359495254,ECE 109,A01,091882,Touri; Behrouz,19,0,70,51
1657359501281,ECE 180,A00,083140,Abi Samra; Nicholas Camill,1,0,30,29
1657359501281,ECE 180,B00,083141,Abi Samra; Nicholas Camill,0,0,30,30
1657359507305,MATH 10A,A01,083735,Patchell; Gregory David,2,0,30,28
1657359507305,MATH 10A,A02,083736,Patchell; Gregory David,20,0,30,10
1657359507305,MATH 10A,A03,083737,Patchell; Gregory David,16,0,30,14
1657359513327,MATH 10B,A01,083207,Lim; Seonhee,8,0,34,26
1657359513327,MATH 10B,A02,083208,Lim; Seonhee,9,0,35,26
1657359513327,MATH 10B,A03,093472,Lim; Seonhee,7,0,34,27
1657359513327,MATH 10B,B01,083739,Sinha; Shubham,12,0,30,18
1657359519358,MATH 18,A01,083743,Cinel; Cameron Alexander,7,0,30,23
1657359519358,MATH 18,A02,083744,Cinel; Cameron Alexander,17,0,30,13
1657359519358,MATH 18,A03,083745,Cinel; Cameron Alexander,9,0,30,21
1657359519358,MATH 18,B01,083748,Rideout; David Porter,5,0,37,32
1657359519358,MATH 18,B02,083749,Rideout; David Porter,5,0,36,31
1657359519358,MATH 18,B03,083750,Rideout; David Porter,3,0,37,34
1657359519358,MATH 18,B04,083751,Rideout; David Porter,6,0,36,30
1657359519358,MATH 18,B05,093473,Rideout; David Porter,6,0,36,30
1657359519358,MATH 18,B06,093474,Rideout; David Porter,6,0,36,30
1657359525384,MATH 20A,A01,083754,Zheng; Zequn,14,0,40,26
1657359531407,MATH 20B,A01,083756,Briones; Jor-el Thomas Caparas,4,0,36,32
1657359531407,MATH 20B,A02,083757,Briones; Jor-el Thomas Caparas,1,0,36,35
1657359531407,MATH 20B,A03,093475,Briones; Jor-el Thomas Caparas,2,0,36,34
1657359537431,MATH 20C,A01,083760,Briones; Jor-el Thomas Caparas,1,0,35,34
1657359537431,MATH 20C,A02,083761,Briones; Jor-el Thomas Caparas,8,0,35,27
1657359537431,MATH 20C,A03,093476,Briones; Jor-el Thomas Caparas,0,1,36,36
1657359537431,MATH 20C,B01,083762,Bach; Quang Tran,1,0,30,29
1657359543455,MATH 20D,A01,083765,Tran; Brian Kha,5,0,30,25
1657359543455,MATH 20D,A02,083766,Tran; Brian Kha,5,0,30,25
1657359543455,MATH 20D,A03,083767,Tran; Brian Kha,5,0,30,25
1657359549479,MATH 20E,A01,083771,Ganguly; Soumya,9,0,32,23
1657359549479,MATH 20E,A02,083772,Ganguly; Soumya,6,0,32,26
1657359549479,MATH 20E,B01,083773,Ciotti; Benjamin,20,0,35,15
1657359549479,MATH 20E,B02,083774,Ciotti; Benjamin,17,0,35,18
1657359555508,MATH 103A,A01,083777,Greenfeld; Be'Eri,3,0,36,33
1657359555508,MATH 103A,A02,083778,Greenfeld; Be'Eri,5,0,36,31
1657359555508,MATH 103A,A03,093561,Greenfeld; Be'Eri,5,0,36,31
1657359555508,MATH 103A,B01,083779,Greenfeld; Be'Eri,7,0,36,29
1657359555508,MATH 103A,B02,083780,Greenfeld; Be'Eri,4,0,36,32
1657359555508,MATH 103A,B03,093562,Greenfeld; Be'Eri,3,0,36,33
1657359561530,MATH 105,A01,085443,Carter; Anne Toulson,15,0,35,20
1657359561530,MATH 105,A02,093477,Carter; Anne Toulson,20,0,35,15
1657359567564,MATH 109,A01,083213,Ganzberger; Geoffrey Michael,2,0,34,32
1657359567564,MATH 109,A02,083214,Ganzberger; Geoffrey Michael,4,0,34,30
1657359567564,MATH 109,A03,093478,Ganzberger; Geoffrey Michael,2,0,34,32
1657359567564,MATH 109,B01,083215,Ganzberger; Geoffrey Michael,1,0,32,31
1657359567564,MATH 109,B02,083216,Ganzberger; Geoffrey Michael,2,0,32,30
1657359567564,MATH 109,B03,093479,Ganzberger; Geoffrey Michael,8,0,32,24
1657359573662,MATH 142A,A01,083219,Chow; Bennett,7,0,32,25
1657359573662,MATH 142A,A02,083220,Chow; Bennett,10,0,32,22
1657359573662,MATH 142A,A03,093480,Chow; Bennett,8,0,32,24
1657359573662,MATH 142A,B03,093481,Chow; Bennett,8,0,32,24
1657359573662,MATH 142A,B04,093558,Chow; Bennett,13,0,32,19
1657359573662,MATH 142A,B05,093559,Chow; Bennett,6,0,32,26
1657359579687,MATH 193A,A01,083224,Rotar; Vladimir,8,0,34,26
1657359579687,MATH 193A,A02,083225,Rotar; Vladimir,9,0,34,25
1657359579687,MATH 193A,A03,083781,Rotar; Vladimir,5,0,34,29
1657359579687,MATH 193A,A04,083782,Rotar; Vladimir,10,0,34,24
1657359579687,MATH 193A,A05,093482,Rotar; Vladimir,10,0,34,24
1657359585711,MATH 197,001,091859,McAuley; Julian John,9999,0,9999,0
1657359585711,MATH 197,002,095566,Kedlaya; Kiran S.,9997,0,9999,2
1657359585711,MATH 197,003,095567,Xiao; Ming,9999,0,9999,0
1657359585711,MATH 197,004,095571,Perols; Johan Lars,9998,0,9999,1
1657359592768,COGS 9,A01,083615,Shannon; Kyle Michael,8,0,75,67
1657359598794,COGS 11,A01,083617,Boyle; Mary E. T.,22,0,48,26
1657359604819,COGS 13,A01,083071,Bastos; Amalia Pinkusfeld,11,0,71,60
1657359610841,COGS 14A,A01,092681,Semenuks; Arturs,4,1,100,96
1657359616867,COGS 14B,A01,083073,Cheng; Tzu-Han,6,0,63,57
1657359622892,COGS 17,A01,092677,Semenuks; Arturs,6,0,81,75
1657359628914,COGS 100,A01,083619,Allen; Michael Gordon,17,0,70,53
1657359634937,COGS 101A,A01,083621,Davis; Joshua Daniel,9,0,68,59
1657359640964,COGS 101B,A01,091572,Allen; Michael Gordon,11,0,65,54
1657359646988,COGS 101C,A01,083625,Delgado; Tania,17,0,35,18
1657359653013,COGS 107A,A01,083627,Boyle; Mary E. T.,13,0,60,47
1657359659035,COGS 118A,A01,083075,Gupta; Anjum,20,0,76,56
1657359665058,CSE 3,A50,083646,Miranda; Gregory Joseph,24,0,50,26
1657359671084,CSE 8A,A50,083650,Miranda; Gregory Joseph,17,1,56,39
1657359677107,CSE 11,A01,083080,Cao; Yingjun,6,15,40,34
1657359683135,CSE 12,A01,083652,Krause-Levy; Sophia Louisa,28,1,120,92
1657359689158,CSE 15L,A01,083654,Morris; Justin Loren,9,0,50,41
1657359689158,CSE 15L,A02,083655,Morris; Justin Loren,9,0,50,41
1657359695181,CSE 20,A01,083657,Tran; Khoa Dang,39,0,80,41
1657359701209,CSE 21,A01,095574,Bach; Quang Tran,22,0,48,26
1657359707237,CSE 30,A01,083084,Eldon; John,4,0,80,76
1657359707237,CSE 30,B01,095061,Bhaskar; Nishant,9,0,50,41
1657359713260,CSE 100,A01,083659,Cao; Yingjun,5,4,70,65
1657359719284,CSE 134B,A01,083661,Powell; Thomas Allan,22,0,100,78
1657359725307,CSE 140,A01,083663,Gungor; Onat,14,0,85,71
1657359731335,CSE 140L,A01,083088,Eldon; John,21,0,100,79
1657359737359,CSE 175,A01,083665,Kumar; Rakesh,3,0,25,22
1657359743384,CSE 190,A00,092507,Dubnov; Shlomo,7,0,20,13
1657359749411,ECE 45,A01,083139,Congero; Spencer William,6,0,75,69
1657359755439,ECE 65,A50,083695,Saad; Andrew S,12,0,30,18
1657359755439,ECE 65,A51,095125,Saad; Andrew S,24,0,26,2
1657359761462,ECE 109,A01,091882,Touri; Behrouz,19,0,70,51
1657359767485,ECE 180,A00,083140,Abi Samra; Nicholas Camill,1,0,30,29
1657359767485,ECE 180,B00,083141,Abi Samra; Nicholas Camill,0,0,30,30
1657359773508,MATH 10A,A01,083735,Patchell; Gregory David,2,0,30,28
1657359773508,MATH 10A,A02,083736,Patchell; Gregory David,20,0,30,10
1657359773508,MATH 10A,A03,083737,Patchell; Gregory David,16,0,30,14
1657359779529,MATH 10B,A01,083207,Lim; Seonhee,8,0,34,26
1657359779529,MATH 10B,A02,083208,Lim; Seonhee,9,0,35,26
1657359779529,MATH 10B,A03,093472,Lim; Seonhee,7,0,34,27
1657359779529,MATH 10B,B01,083739,Sinha; Shubham,12,0,30,18
1657359785559,MATH 18,A01,083743,Cinel; Cameron Alexander,7,0,30,23
1657359785559,MATH 18,A02,083744,Cinel; Cameron Alexander,17,0,30,13
1657359785559,MATH 18,A03,083745,Cinel; Cameron Alexander,9,0,30,21
1657359785559,MATH 18,B01,083748,Rideout; David Porter,5,0,37,32
1657359785559,MATH 18,B02,083749,Rideout; David Porter,5,0,36,31
1657359785559,MATH 18,B03,083750,Rideout; David Porter,3,0,37,34
1657359785559,MATH 18,B04,083751,Rideout; David Porter,6,0,36,30
1657359785559,MATH 18,B05,093473,Rideout; David Porter,6,0,36,30
1657359785559,MATH 18,B06,093474,Rideout; David Porter,6,0,36,30
1657359791581,MATH 20A,A01,083754,Zheng; Zequn,14,0,40,26
1657359797606,MATH 20B,A01,083756,Briones; Jor-el Thomas Caparas,4,0,36,32
1657359797606,MATH 20B,A02,083757,Briones; Jor-el Thomas Caparas,1,0,36,35
1657359797606,MATH 20B,A03,093475,Briones; Jor-el Thomas Caparas,2,0,36,34
1657359803631,MATH 20C,A01,083760,Briones; Jor-el Thomas Caparas,1,0,35,34
1657359803631,MATH 20C,A02,083761,Briones; Jor-el Thomas Caparas,8,0,35,27
1657359803631,MATH 20C,A03,093476,Briones; Jor-el Thomas Caparas,0,1,36,36
1657359803631,MATH 20C,B01,083762,Bach; Quang Tran,1,0,30,29
1657359809654,MATH 20D,A01,083765,Tran; Brian Kha,5,0,30,25
1657359809654,MATH 20D,A02,083766,Tran; Brian Kha,5,0,30,25
1657359809654,MATH 20D,A03,083767,Tran; Brian Kha,5,0,30,25
1657359815678,MATH 20E,A01,083771,Ganguly; Soumya,9,0,32,23
1657359815678,MATH 20E,A02,083772,Ganguly; Soumya,6,0,32,26
1657359815678,MATH 20E,B01,083773,Ciotti; Benjamin,20,0,35,15
1657359815678,MATH 20E,B02,083774,Ciotti; Benjamin,17,0,35,18
1657359821703,MATH 103A,A01,083777,Greenfeld; Be'Eri,3,0,36,33
1657359821703,MATH 103A,A02,083778,Greenfeld; Be'Eri,5,0,36,31
1657359821703,MATH 103A,A03,093561,Greenfeld; Be'Eri,5,0,36,31
1657359821703,MATH 103A,B01,083779,Greenfeld; Be'Eri,7,0,36,29
1657359821703,MATH 103A,B02,083780,Greenfeld; Be'Eri,4,0,36,32
1657359821703,MATH 103A,B03,093562,Greenfeld; Be'Eri,3,0,36,33
1657359827731,MATH 105,A01,085443,Carter; Anne Toulson,15,0,35,20
1657359827731,MATH 105,A02,093477,Carter; Anne Toulson,20,0,35,15
1657359833754,MATH 109,A01,083213,Ganzberger; Geoffrey Michael,2,0,34,32
1657359833754,MATH 109,A02,083214,Ganzberger; Geoffrey Michael,4,0,34,30
1657359833754,MATH 109,A03,093478,Ganzberger; Geoffrey Michael,2,0,34,32
1657359833754,MATH 109,B01,083215,Ganzberger; Geoffrey Michael,1,0,32,31
1657359833754,MATH 109,B02,083216,Ganzberger; Geoffrey Michael,2,0,32,30
1657359833754,MATH 109,B03,093479,Ganzberger; Geoffrey Michael,8,0,32,24
1657359839789,MATH 142A,A01,083219,Chow; Bennett,7,0,32,25
1657359839789,MATH 142A,A02,083220,Chow; Bennett,10,0,32,22
1657359839789,MATH 142A,A03,093480,Chow; Bennett,8,0,32,24
1657359839789,MATH 142A,B03,093481,Chow; Bennett,8,0,32,24
1657359839789,MATH 142A,B04,093558,Chow; Bennett,13,0,32,19
1657359839789,MATH 142A,B05,093559,Chow; Bennett,6,0,32,26
1657359845812,MATH 193A,A01,083224,Rotar; Vladimir,8,0,34,26
1657359845812,MATH 193A,A02,083225,Rotar; Vladimir,9,0,34,25
1657359845812,MATH 193A,A03,083781,Rotar; Vladimir,5,0,34,29
1657359845812,MATH 193A,A04,083782,Rotar; Vladimir,10,0,34,24
1657359845812,MATH 193A,A05,093482,Rotar; Vladimir,10,0,34,24
1657359851839,MATH 197,001,091859,McAuley; Julian John,9999,0,9999,0
1657359851839,MATH 197,002,095566,Kedlaya; Kiran S.,9997,0,9999,2
1657359851839,MATH 197,003,095567,Xiao; Ming,9999,0,9999,0
1657359851839,MATH 197,004,095571,Perols; Johan Lars,9998,0,9999,1
1657359858906,COGS 9,A01,083615,Shannon; Kyle Michael,8,0,75,67
1657359864928,COGS 11,A01,083617,Boyle; Mary E. T.,22,0,48,26
1657359870950,COGS 13,A01,083071,Bastos; Amalia Pinkusfeld,11,0,71,60
1657359876981,COGS 14A,A01,092681,Semenuks; Arturs,4,1,100,96
1657359883005,COGS 14B,A01,083073,Cheng; Tzu-Han,6,0,63,57
1657359889029,COGS 17,A01,092677,Semenuks; Arturs,6,0,81,75
1657359895053,COGS 100,A01,083619,Allen; Michael Gordon,17,0,70,53
1657359901078,COGS 101A,A01,083621,Davis; Joshua Daniel,9,0,68,59
1657359907100,COGS 101B,A01,091572,Allen; Michael Gordon,11,0,65,54
1657359913123,COGS 101C,A01,083625,Delgado; Tania,17,0,35,18
1657359919147,COGS 107A,A01,083627,Boyle; Mary E. T.,13,0,60,47
1657359925168,COGS 118A,A01,083075,Gupta; Anjum,20,0,76,56
1657359931196,CSE 3,A50,083646,Miranda; Gregory Joseph,24,0,50,26
1657359937219,CSE 8A,A50,083650,Miranda; Gregory Joseph,17,1,56,39
1657359943246,CSE 11,A01,083080,Cao; Yingjun,6,15,40,34
1657359949268,CSE 12,A01,083652,Krause-Levy; Sophia Louisa,28,1,120,92
1657359955297,CSE 15L,A01,083654,Morris; Justin Loren,9,0,50,41
1657359955297,CSE 15L,A02,083655,Morris; Justin Loren,9,0,50,41
1657359961322,CSE 20,A01,083657,Tran; Khoa Dang,39,0,80,41
1657359967348,CSE 21,A01,095574,Bach; Quang Tran,22,0,48,26
1657359973376,CSE 30,A01,083084,Eldon; John,4,0,80,76
1657359973376,CSE 30,B01,095061,Bhaskar; Nishant,9,0,50,41
1657359979400,CSE 100,A01,083659,Cao; Yingjun,5,4,70,65
1657359985427,CSE 134B,A01,083661,Powell; Thomas Allan,22,0,100,78
1657359991450,CSE 140,A01,083663,Gungor; Onat,14,0,85,71
1657359997478,CSE 140L,A01,083088,Eldon; John,21,0,100,79
1657360003502,CSE 175,A01,083665,Kumar; Rakesh,3,0,25,22
1657360009524,CSE 190,A00,092507,Dubnov; Shlomo,7,0,20,13
1657360015550,ECE 45,A01,083139,Congero; Spencer William,6,0,75,69
1657360021574,ECE 65,A50,083695,Saad; Andrew S,12,0,30,18
1657360021574,ECE 65,A51,095125,Saad; Andrew S,24,0,26,2
1657360027595,ECE 109,A01,091882,Touri; Behrouz,19,0,70,51
1657360033619,ECE 180,A00,083140,Abi Samra; Nicholas Camill,1,0,30,29
1657360033619,ECE 180,B00,083141,Abi Samra; Nicholas Camill,0,0,30,30
1657360039644,MATH 10A,A01,083735,Patchell; Gregory David,2,0,30,28
1657360039644,MATH 10A,A02,083736,Patchell; Gregory David,20,0,30,10
1657360039644,MATH 10A,A03,083737,Patchell; Gregory David,16,0,30,14
1657360045672,MATH 10B,A01,083207,Lim; Seonhee,8,0,34,26
1657360045672,MATH 10B,A02,083208,Lim; Seonhee,9,0,35,26
1657360045672,MATH 10B,A03,093472,Lim; Seonhee,7,0,34,27
1657360045672,MATH 10B,B01,083739,Sinha; Shubham,12,0,30,18
1657360051701,MATH 18,A01,083743,Cinel; Cameron Alexander,7,0,30,23
1657360051701,MATH 18,A02,083744,Cinel; Cameron Alexander,17,0,30,13
1657360051701,MATH 18,A03,083745,Cinel; Cameron Alexander,9,0,30,21
1657360051701,MATH 18,B01,083748,Rideout; David Porter,5,0,37,32
1657360051701,MATH 18,B02,083749,Rideout; David Porter,5,0,36,31
1657360051701,MATH 18,B03,083750,Rideout; David Porter,3,0,37,34
1657360051701,MATH 18,B04,083751,Rideout; David Porter,6,0,36,30
1657360051701,MATH 18,B05,093473,Rideout; David Porter,6,0,36,30
1657360051701,MATH 18,B06,093474,Rideout; David Porter,6,0,36,30
1657360057724,MATH 20A,A01,083754,Zheng; Zequn,14,0,40,26
1657360063752,MATH 20B,A01,083756,Briones; Jor-el Thomas Caparas,4,0,36,32
1657360063752,MATH 20B,A02,083757,Briones; Jor-el Thomas Caparas,1,0,36,35
1657360063752,MATH 20B,A03,093475,Briones; Jor-el Thomas Caparas,2,0,36,34
1657360069776,MATH 20C,A01,083760,Briones; Jor-el Thomas Caparas,1,0,35,34
1657360069776,MATH 20C,A02,083761,Briones; Jor-el Thomas Caparas,8,0,35,27
1657360069776,MATH 20C,A03,093476,Briones; Jor-el Thomas Caparas,0,1,36,36
1657360069776,MATH 20C,B01,083762,Bach; Quang Tran,1,0,30,29
1657360075805,MATH 20D,A01,083765,Tran; Brian Kha,5,0,30,25
1657360075805,MATH 20D,A02,083766,Tran; Brian Kha,5,0,30,25
1657360075805,MATH 20D,A03,083767,Tran; Brian Kha,5,0,30,25
1657360081834,MATH 20E,A01,083771,Ganguly; Soumya,9,0,32,23
1657360081834,MATH 20E,A02,083772,Ganguly; Soumya,6,0,32,26
1657360081834,MATH 20E,B01,083773,Ciotti; Benjamin,20,0,35,15
1657360081834,MATH 20E,B02,083774,Ciotti; Benjamin,17,0,35,18
1657360087856,MATH 103A,A01,083777,Greenfeld; Be'Eri,3,0,36,33
1657360087856,MATH 103A,A02,083778,Greenfeld; Be'Eri,5,0,36,31
1657360087856,MATH 103A,A03,093561,Greenfeld; Be'Eri,5,0,36,31
1657360087856,MATH 103A,B01,083779,Greenfeld; Be'Eri,7,0,36,29
1657360087856,MATH 103A,B02,083780,Greenfeld; Be'Eri,4,0,36,32
1657360087856,MATH 103A,B03,093562,Greenfeld; Be'Eri,3,0,36,33
1657360093883,MATH 105,A01,085443,Carter; Anne Toulson,15,0,35,20
1657360093883,MATH 105,A02,093477,Carter; Anne Toulson,20,0,35,15
1657360099912,MATH 109,A01,083213,Ganzberger; Geoffrey Michael,2,0,34,32
1657360099912,MATH 109,A02,083214,Ganzberger; Geoffrey Michael,4,0,34,30
1657360099912,MATH 109,A03,093478,Ganzberger; Geoffrey Michael,2,0,34,32
1657360099912,MATH 109,B01,083215,Ganzberger; Geoffrey Michael,1,0,32,31
1657360099912,MATH 109,B02,083216,Ganzberger; Geoffrey Michael,2,0,32,30
1657360099912,MATH 109,B03,093479,Ganzberger; Geoffrey Michael,8,0,32,24
1657360105941,MATH 142A,A01,083219,Chow; Bennett,7,0,32,25
1657360105941,MATH 142A,A02,083220,Chow; Bennett,10,0,32,22
1657360105941,MATH 142A,A03,093480,Chow; Bennett,8,0,32,24
1657360105941,MATH 142A,B03,093481,Chow; Bennett,8,0,32,24
1657360105941,MATH 142A,B04,093558,Chow; Bennett,13,0,32,19
1657360105941,MATH 142A,B05,093559,Chow; Bennett,6,0,32,26
1657360111965,MATH 193A,A01,083224,Rotar; Vladimir,8,0,34,26
1657360111965,MATH 193A,A02,083225,Rotar; Vladimir,9,0,34,25
1657360111965,MATH 193A,A03,083781,Rotar; Vladimir,5,0,34,29
1657360111965,MATH 193A,A04,083782,Rotar; Vladimir,10,0,34,24
1657360111965,MATH 193A,A05,093482,Rotar; Vladimir,10,0,34,24
1657360117990,MATH 197,001,091859,McAuley; Julian John,9999,0,9999,0
1657360117990,MATH 197,002,095566,Kedlaya; Kiran S.,9997,0,9999,2
1657360117990,MATH 197,003,095567,Xiao; Ming,9999,0,9999,0
1657360117990,MATH 197,004,095571,Perols; Johan Lars,9998,0,9999,1
1657360125046,COGS 9,A01,083615,Shannon; Kyle Michael,8,0,75,67
1657360131073,COGS 11,A01,083617,Boyle; Mary E. T.,22,0,48,26
1657360137095,COGS 13,A01,083071,Bastos; Amalia Pinkusfeld,11,0,71,60
1657360143122,COGS 14A,A01,092681,Semenuks; Arturs,4,1,100,96
1657360149144,COGS 14B,A01,083073,Cheng; Tzu-Han,6,0,63,57
1657360155168,COGS 17,A01,092677,Semenuks; Arturs,6,0,81,75
1657360161195,COGS 100,A01,083619,Allen; Michael Gordon,17,0,70,53
1657360167315,COGS 101A,A01,083621,Davis; Joshua Daniel,9,0,68,59
1657360173342,COGS 101B,A01,091572,Allen; Michael Gordon,11,0,65,54
1657360179368,COGS 101C,A01,083625,Delgado; Tania,17,0,35,18
1657360185392,COGS 107A,A01,083627,Boyle; Mary E. T.,13,0,60,47
1657360191415,COGS 118A,A01,083075,Gupta; Anjum,20,0,76,56
1657360197442,CSE 3,A50,083646,Miranda; Gregory Joseph,24,0,50,26
1657360203466,CSE 8A,A50,083650,Miranda; Gregory Joseph,17,1,56,39
1657360209493,CSE 11,A01,083080,Cao; Yingjun,6,15,40,34
1657360215520,CSE 12,A01,083652,Krause-Levy; Sophia Louisa,28,1,120,92
1657360221544,CSE 15L,A01,083654,Morris; Justin Loren,9,0,50,41
1657360221544,CSE 15L,A02,083655,Morris; Justin Loren,9,0,50,41
1657360227567,CSE 20,A01,083657,Tran; Khoa Dang,39,0,80,41
1657360233594,CSE 21,A01,095574,Bach; Quang Tran,22,0,48,26
1657360239618,CSE 30,A01,083084,Eldon; John,4,0,80,76
1657360239618,CSE 30,B01,095061,Bhaskar; Nishant,9,0,50,41
1657360245642,CSE 100,A01,083659,Cao; Yingjun,5,4,70,65
1657360251668,CSE 134B,A01,083661,Powell; Thomas Allan,22,0,100,78
1657360257694,CSE 140,A01,083663,Gungor; Onat,14,0,85,71
1657360263719,CSE 140L,A01,083088,Eldon; John,21,0,100,79
1657360269742,CSE 175,A01,083665,Kumar; Rakesh,3,0,25,22
1657360275769,CSE 190,A00,092507,Dubnov; Shlomo,7,0,20,13
1657360281792,ECE 45,A01,083139,Congero; Spencer William,6,0,75,69
1657360287816,ECE 65,A50,083695,Saad; Andrew S,12,0,30,18
1657360287816,ECE 65,A51,095125,Saad; Andrew S,24,0,26,2
1657360293839,ECE 109,A01,091882,Touri; Behrouz,19,0,70,51
1657360299864,ECE 180,A00,083140,Abi Samra; Nicholas Camill,1,0,30,29
1657360299864,ECE 180,B00,083141,Abi Samra; Nicholas Camill,0,0,30,30
1657360305891,MATH 10A,A01,083735,Patchell; Gregory David,2,0,30,28
1657360305891,MATH 10A,A02,083736,Patchell; Gregory David,20,0,30,10
1657360305891,MATH 10A,A03,083737,Patchell; Gregory David,16,0,30,14
1657360311920,MATH 10B,A01,083207,Lim; Seonhee,8,0,34,26
1657360311920,MATH 10B,A02,083208,Lim; Seonhee,9,0,35,26
1657360311920,MATH 10B,A03,093472,Lim; Seonhee,7,0,34,27
1657360311920,MATH 10B,B01,083739,Sinha; Shubham,12,0,30,18
1657360317944,MATH 18,A01,083743,Cinel; Cameron Alexander,7,0,30,23
1657360317944,MATH 18,A02,083744,Cinel; Cameron Alexander,17,0,30,13
1657360317944,MATH 18,A03,083745,Cinel; Cameron Alexander,9,0,30,21
1657360317944,MATH 18,B01,083748,Rideout; David Porter,5,0,37,32
1657360317944,MATH 18,B02,083749,Rideout; David Porter,5,0,36,31
1657360317944,MATH 18,B03,083750,Rideout; David Porter,3,0,37,34
1657360317944,MATH 18,B04,083751,Rideout; David Porter,6,0,36,30
1657360317944,MATH 18,B05,093473,Rideout; David Porter,6,0,36,30
1657360317944,MATH 18,B06,093474,Rideout; David Porter,6,0,36,30
1657360323969,MATH 20A,A01,083754,Zheng; Zequn,14,0,40,26
1657360329998,MATH 20B,A01,083756,Briones; Jor-el Thomas Caparas,4,0,36,32
1657360329998,MATH 20B,A02,083757,Briones; Jor-el Thomas Caparas,1,0,36,35
1657360329998,MATH 20B,A03,093475,Briones; Jor-el Thomas Caparas,2,0,36,34
1657360336024,MATH 20C,A01,083760,Briones; Jor-el Thomas Caparas,1,0,35,34
1657360336024,MATH 20C,A02,083761,Briones; Jor-el Thomas Caparas,8,0,35,27
1657360336024,MATH 20C,A03,093476,Briones; Jor-el Thomas Caparas,0,1,36,36
1657360336024,MATH 20C,B01,083762,Bach; Quang Tran,1,0,30,29
1657360342053,MATH 20D,A01,083765,Tran; Brian Kha,5,0,30,25
1657360342053,MATH 20D,A02,083766,Tran; Brian Kha,5,0,30,25
1657360342053,MATH 20D,A03,083767,Tran; Brian Kha,5,0,30,25
1657360348083,MATH 20E,A01,083771,Ganguly; Soumya,9,0,32,23
1657360348083,MATH 20E,A02,083772,Ganguly; Soumya,6,0,32,26
1657360348083,MATH 20E,B01,083773,Ciotti; Benjamin,20,0,35,15
1657360348083,MATH 20E,B02,083774,Ciotti; Benjamin,17,0,35,18
1657360354106,MATH 103A,A01,083777,Greenfeld; Be'Eri,3,0,36,33
1657360354106,MATH 103A,A02,083778,Greenfeld; Be'Eri,5,0,36,31
1657360354106,MATH 103A,A03,093561,Greenfeld; Be'Eri,5,0,36,31
1657360354106,MATH 103A,B01,083779,Greenfeld; Be'Eri,7,0,36,29
1657360354106,MATH 103A,B02,083780,Greenfeld; Be'Eri,4,0,36,32
1657360354106,MATH 103A,B03,093562,Greenfeld; Be'Eri,3,0,36,33
1657360360135,MATH 105,A01,085443,Carter; Anne Toulson,15,0,35,20
1657360360135,MATH 105,A02,093477,Carter; Anne Toulson,20,0,35,15
1657360366159,MATH 109,A01,083213,Ganzberger; Geoffrey Michael,2,0,34,32
1657360366159,MATH 109,A02,083214,Ganzberger; Geoffrey Michael,4,0,34,30
1657360366159,MATH 109,A03,093478,Ganzberger; Geoffrey Michael,2,0,34,32
1657360366159,MATH 109,B01,083215,Ganzberger; Geoffrey Michael,1,0,32,31
1657360366159,MATH 109,B02,083216,Ganzberger; Geoffrey Michael,2,0,32,30
1657360366159,MATH 109,B03,093479,Ganzberger; Geoffrey Michael,8,0,32,24
1657360372189,MATH 142A,A01,083219,Chow; Bennett,7,0,32,25
1657360372189,MATH 142A,A02,083220,Chow; Bennett,10,0,32,22
1657360372189,MATH 142A,A03,093480,Chow; Bennett,8,0,32,24
1657360372189,MATH 142A,B03,093481,Chow; Bennett,8,0,32,24
1657360372189,MATH 142A,B04,093558,Chow; Bennett,13,0,32,19
1657360372189,MATH 142A,B05,093559,Chow; Bennett,6,0,32,26
1657360378218,MATH 193A,A01,083224,Rotar; Vladimir,8,0,34,26
1657360378218,MATH 193A,A02,083225,Rotar; Vladimir,9,0,34,25
1657360378218,MATH 193A,A03,083781,Rotar; Vladimir,5,0,34,29
1657360378218,MATH 193A,A04,083782,Rotar; Vladimir,10,0,34,24
1657360378218,MATH 193A,A05,093482,Rotar; Vladimir,10,0,34,24
1657360384247,MATH 197,001,091859,McAuley; Julian John,9999,0,9999,0
1657360384247,MATH 197,002,095566,Kedlaya; Kiran S.,9997,0,9999,2
1657360384247,MATH 197,003,095567,Xiao; Ming,9999,0,9999,0
1657360384247,MATH 197,004,095571,Perols; Johan Lars,9998,0,9999,1
1657360391304,COGS 9,A01,083615,Shannon; Kyle Michael,8,0,75,67
1657360397330,COGS 11,A01,083617,Boyle; Mary E. T.,22,0,48,26
1657360403355,COGS 13,A01,083071,Bastos; Amalia Pinkusfeld,11,0,71,60
1657360409382,COGS 14A,A01,092681,Semenuks; Arturs,4,1,100,96
1657360415411,COGS 14B,A01,083073,Cheng; Tzu-Han,6,0,63,57
1657360421436,COGS 17,A01,092677,Semenuks; Arturs,6,0,81,75
1657360427460,COGS 100,A01,083619,Allen; Michael Gordon,17,0,70,53
1657360433482,COGS 101A,A01,083621,Davis; Joshua Daniel,9,0,68,59
1657360439505,COGS 101B,A01,091572,Allen; Michael Gordon,11,0,65,54
1657360445528,COGS 101C,A01,083625,Delgado; Tania,17,0,35,18
1657360451550,COGS 107A,A01,083627,Boyle; Mary E. T.,13,0,60,47
1657360457576,COGS 118A,A01,083075,Gupta; Anjum,20,0,76,56
1657360463605,CSE 3,A50,083646,Miranda; Gregory Joseph,24,0,50,26
1657360469627,CSE 8A,A50,083650,Miranda; Gregory Joseph,17,1,56,39
1657360475650,CSE 11,A01,083080,Cao; Yingjun,6,15,40,34
1657360481673,CSE 12,A01,083652,Krause-Levy; Sophia Louisa,28,1,120,92
1657360487699,CSE 15L,A01,083654,Morris; Justin Loren,9,0,50,41
1657360487699,CSE 15L,A02,083655,Morris; Justin Loren,9,0,50,41
1657360493722,CSE 20,A01,083657,Tran; Khoa Dang,39,0,80,41
1657360499745,CSE 21,A01,095574,Bach; Quang Tran,22,0,48,26
1657360505768,CSE 30,A01,083084,Eldon; John,4,0,80,76
1657360505768,CSE 30,B01,095061,Bhaskar; Nishant,9,0,50,41
1657360511792,CSE 100,A01,083659,Cao; Yingjun,5,4,70,65
1657360517818,CSE 134B,A01,083661,Powell; Thomas Allan,22,0,100,78
1657360523841,CSE 140,A01,083663,Gungor; Onat,14,0,85,71
1657360529866,CSE 140L,A01,083088,Eldon; John,21,0,100,79
1657360535890,CSE 175,A01,083665,Kumar; Rakesh,3,0,25,22
1657360541915,CSE 190,A00,092507,Dubnov; Shlomo,7,0,20,13
1657360547938,ECE 45,A01,083139,Congero; Spencer William,6,0,75,69
1657360553963,ECE 65,A50,083695,Saad; Andrew S,12,0,30,18
1657360553963,ECE 65,A51,095125,Saad; Andrew S,24,0,26,2
1657360559987,ECE 109,A01,091882,Touri; Behrouz,19,0,70,51
1657360566009,ECE 180,A00,083140,Abi Samra; Nicholas Camill,1,0,30,29
1657360566009,ECE 180,B00,083141,Abi Samra; Nicholas Camill,0,0,30,30
1657360572043,MATH 10A,A01,083735,Patchell; Gregory David,2,0,30,28
1657360572043,MATH 10A,A02,083736,Patchell; Gregory David,20,0,30,10
1657360572043,MATH 10A,A03,083737,Patchell; Gregory David,16,0,30,14
1657360578069,MATH 10B,A01,083207,Lim; Seonhee,8,0,34,26
1657360578069,MATH 10B,A02,083208,Lim; Seonhee,9,0,35,26
1657360578069,MATH 10B,A03,093472,Lim; Seonhee,7,0,34,27
1657360578069,MATH 10B,B01,083739,Sinha; Shubham,12,0,30,18
1657360584099,MATH 18,A01,083743,Cinel; Cameron Alexander,7,0,30,23
1657360584099,MATH 18,A02,083744,Cinel; Cameron Alexander,17,0,30,13
1657360584099,MATH 18,A03,083745,Cinel; Cameron Alexander,9,0,30,21
1657360584099,MATH 18,B01,083748,Rideout; David Porter,5,0,37,32
1657360584099,MATH 18,B02,083749,Rideout; David Porter,5,0,36,31
1657360584099,MATH 18,B03,083750,Rideout; David Porter,3,0,37,34
1657360584099,MATH 18,B04,083751,Rideout; David Porter,6,0,36,30
1657360584099,MATH 18,B05,093473,Rideout; David Porter,6,0,36,30
1657360584099,MATH 18,B06,093474,Rideout; David Porter,6,0,36,30
1657360590124,MATH 20A,A01,083754,Zheng; Zequn,14,0,40,26
1657360596149,MATH 20B,A01,083756,Briones; Jor-el Thomas Caparas,4,0,36,32
1657360596149,MATH 20B,A02,083757,Briones; Jor-el Thomas Caparas,1,0,36,35
1657360596149,MATH 20B,A03,093475,Briones; Jor-el Thomas Caparas,2,0,36,34
1657360602177,MATH 20C,A01,083760,Briones; Jor-el Thomas Caparas,1,0,35,34
1657360602177,MATH 20C,A02,083761,Briones; Jor-el Thomas Caparas,8,0,35,27
1657360602177,MATH 20C,A03,093476,Briones; Jor-el Thomas Caparas,0,1,36,36
1657360602177,MATH 20C,B01,083762,Bach; Quang Tran,1,0,30,29
1657360608206,MATH 20D,A01,083765,Tran; Brian Kha,5,0,30,25
1657360608206,MATH 20D,A02,083766,Tran; Brian Kha,5,0,30,25
1657360608206,MATH 20D,A03,083767,Tran; Brian Kha,5,0,30,25
1657360614234,MATH 20E,A01,083771,Ganguly; Soumya,9,0,32,23
1657360614234,MATH 20E,A02,083772,Ganguly; Soumya,6,0,32,26
1657360614234,MATH 20E,B01,083773,Ciotti; Benjamin,20,0,35,15
1657360614234,MATH 20E,B02,083774,Ciotti; Benjamin,17,0,35,18
1657360620263,MATH 103A,A01,083777,Greenfeld; Be'Eri,3,0,36,33
1657360620263,MATH 103A,A02,083778,Greenfeld; Be'Eri,5,0,36,31
1657360620263,MATH 103A,A03,093561,Greenfeld; Be'Eri,5,0,36,31
1657360620263,MATH 103A,B01,083779,Greenfeld; Be'Eri,7,0,36,29
1657360620263,MATH 103A,B02,083780,Greenfeld; Be'Eri,4,0,36,32
1657360620263,MATH 103A,B03,093562,Greenfeld; Be'Eri,3,0,36,33
1657360626290,MATH 105,A01,085443,Carter; Anne Toulson,15,0,35,20
1657360626290,MATH 105,A02,093477,Carter; Anne Toulson,20,0,35,15
1657360632314,MATH 109,A01,083213,Ganzberger; Geoffrey Michael,2,0,34,32
1657360632314,MATH 109,A02,083214,Ganzberger; Geoffrey Michael,4,0,34,30
1657360632314,MATH 109,A03,093478,Ganzberger; Geoffrey Michael,2,0,34,32
1657360632314,MATH 109,B01,083215,Ganzberger; Geoffrey Michael,1,0,32,31
1657360632314,MATH 109,B02,083216,Ganzberger; Geoffrey Michael,2,0,32,30
1657360632314,MATH 109,B03,093479,Ganzberger; Geoffrey Michael,8,0,32,24
1657360638338,MATH 142A,A01,083219,Chow; Bennett,7,0,32,25
1657360638338,MATH 142A,A02,083220,Chow; Bennett,10,0,32,22
1657360638338,MATH 142A,A03,093480,Chow; Bennett,8,0,32,24
1657360638338,MATH 142A,B03,093481,Chow; Bennett,8,0,32,24
1657360638338,MATH 142A,B04,093558,Chow; Bennett,13,0,32,19
1657360638338,MATH 142A,B05,093559,Chow; Bennett,6,0,32,26
1657360644363,MATH 193A,A01,083224,Rotar; Vladimir,8,0,34,26
1657360644363,MATH 193A,A02,083225,Rotar; Vladimir,9,0,34,25
1657360644363,MATH 193A,A03,083781,Rotar; Vladimir,5,0,34,29
1657360644363,MATH 193A,A04,083782,Rotar; Vladimir,10,0,34,24
1657360644363,MATH 193A,A05,093482,Rotar; Vladimir,10,0,34,24
1657360650386,MATH 197,001,091859,McAuley; Julian John,9999,0,9999,0
1657360650386,MATH 197,002,095566,Kedlaya; Kiran S.,9997,0,9999,2
1657360650386,MATH 197,003,095567,Xiao; Ming,9999,0,9999,0
1657360650386,MATH 197,004,095571,Perols; Johan Lars,9998,0,9999,1
1657360657452,COGS 9,A01,083615,Shannon; Kyle Michael,8,0,75,67
1657360663502,COGS 11,A01,083617,Boyle; Mary E. T.,22,0,48,26
1657360669529,COGS 13,A01,083071,Bastos; Amalia Pinkusfeld,11,0,71,60
1657360675552,COGS 14A,A01,092681,Semenuks; Arturs,4,1,100,96
1657360681576,COGS 14B,A01,083073,Cheng; Tzu-Han,6,0,63,57
1657360687598,COGS 17,A01,092677,Semenuks; Arturs,6,0,81,75
1657360693620,COGS 100,A01,083619,Allen; Michael Gordon,17,0,70,53
1657360699642,COGS 101A,A01,083621,Davis; Joshua Daniel,9,0,68,59
1657360705665,COGS 101B,A01,091572,Allen; Michael Gordon,11,0,65,54
1657360711692,COGS 101C,A01,083625,Delgado; Tania,17,0,35,18
1657360717714,COGS 107A,A01,083627,Boyle; Mary E. T.,13,0,60,47
1657360723742,COGS 118A,A01,083075,Gupta; Anjum,20,0,76,56
1657360729770,CSE 3,A50,083646,Miranda; Gregory Joseph,24,0,50,26
1657360735797,CSE 8A,A50,083650,Miranda; Gregory Joseph,17,1,56,39
1657360741824,CSE 11,A01,083080,Cao; Yingjun,6,15,40,34
1657360747846,CSE 12,A01,083652,Krause-Levy; Sophia Louisa,28,1,120,92
1657360753873,CSE 15L,A01,083654,Morris; Justin Loren,9,0,50,41
1657360753873,CSE 15L,A02,083655,Morris; Justin Loren,9,0,50,41
1657360759895,CSE 20,A01,083657,Tran; Khoa Dang,39,0,80,41
1657360765999,CSE 21,A01,095574,Bach; Quang Tran,22,0,48,26
1657360772024,CSE 30,A01,083084,Eldon; John,4,0,80,76
1657360772024,CSE 30,B01,095061,Bhaskar; Nishant,9,0,50,41
1657360778057,CSE 100,A01,083659,Cao; Yingjun,5,4,70,65
1657360784080,CSE 134B,A01,083661,Powell; Thomas Allan,22,0,100,78
1657360790103,CSE 140,A01,083663,Gungor; Onat,14,0,85,71
1657360796126,CSE 140L,A01,083088,Eldon; John,21,0,100,79
1657360802149,CSE 175,A01,083665,Kumar; Rakesh,3,0,25,22
1657360808172,CSE 190,A00,092507,Dubnov; Shlomo,7,0,20,13
1657360814195,ECE 45,A01,083139,Congero; Spencer William,6,0,75,69
1657360820220,ECE 65,A50,083695,Saad; Andrew S,12,0,30,18
1657360820220,ECE 65,A51,095125,Saad; Andrew S,24,0,26,2
1657360826242,ECE 109,A01,091882,Touri; Behrouz,19,0,70,51
1657360832266,ECE 180,A00,083140,Abi Samra; Nicholas Camill,1,0,30,29
1657360832266,ECE 180,B00,083141,Abi Samra; Nicholas Camill,0,0,30,30
1657360838290,MATH 10A,A01,083735,Patchell; Gregory David,2,0,30,28
1657360838290,MATH 10A,A02,083736,Patchell; Gregory David,20,0,30,10
1657360838290,MATH 10A,A03,083737,Patchell; Gregory David,16,0,30,14
1657360844314,MATH 10B,A01,083207,Lim; Seonhee,8,0,34,26
1657360844314,MATH 10B,A02,083208,Lim; Seonhee,9,0,35,26
1657360844314,MATH 10B,A03,093472,Lim; Seonhee,7,0,34,27
1657360844314,MATH 10B,B01,083739,Sinha; Shubham,12,0,30,18
1657360850339,MATH 18,A01,083743,Cinel; Cameron Alexander,7,0,30,23
1657360850339,MATH 18,A02,083744,Cinel; Cameron Alexander,17,0,30,13
1657360850339,MATH 18,A03,083745,Cinel; Cameron Alexander,9,0,30,21
1657360850339,MATH 18,B01,083748,Rideout; David Porter,5,0,37,32
1657360850339,MATH 18,B02,083749,Rideout; David Porter,5,0,36,31
1657360850339,MATH 18,B03,083750,Rideout; David Porter,3,0,37,34
1657360850339,MATH 18,B04,083751,Rideout; David Porter,6,0,36,30
1657360850339,MATH 18,B05,093473,Rideout; David Porter,6,0,36,30
1657360850339,MATH 18,B06,093474,Rideout; David Porter,6,0,36,30
1657360856362,MATH 20A,A01,083754,Zheng; Zequn,14,0,40,26
1657360862385,MATH 20B,A01,083756,Briones; Jor-el Thomas Caparas,4,0,36,32
1657360862385,MATH 20B,A02,083757,Briones; Jor-el Thomas Caparas,1,0,36,35
1657360862385,MATH 20B,A03,093475,Briones; Jor-el Thomas Caparas,2,0,36,34
1657360868414,MATH 20C,A01,083760,Briones; Jor-el Thomas Caparas,1,0,35,34
1657360868414,MATH 20C,A02,083761,Briones; Jor-el Thomas Caparas,8,0,35,27
1657360868414,MATH 20C,A03,093476,Briones; Jor-el Thomas Caparas,0,1,36,36
1657360868414,MATH 20C,B01,083762,Bach; Quang Tran,1,0,30,29
1657360874438,MATH 20D,A01,083765,Tran; Brian Kha,5,0,30,25
1657360874438,MATH 20D,A02,083766,Tran; Brian Kha,5,0,30,25
1657360874438,MATH 20D,A03,083767,Tran; Brian Kha,5,0,30,25
1657360880481,MATH 20E,A01,083771,Ganguly; Soumya,9,0,32,23
1657360880481,MATH 20E,A02,083772,Ganguly; Soumya,6,0,32,26
1657360880481,MATH 20E,B01,083773,Ciotti; Benjamin,20,0,35,15
1657360880481,MATH 20E,B02,083774,Ciotti; Benjamin,17,0,35,18
1657360886504,MATH 103A,A01,083777,Greenfeld; Be'Eri,3,0,36,33
1657360886504,MATH 103A,A02,083778,Greenfeld; Be'Eri,5,0,36,31
1657360886504,MATH 103A,A03,093561,Greenfeld; Be'Eri,5,0,36,31
1657360886504,MATH 103A,B01,083779,Greenfeld; Be'Eri,7,0,36,29
1657360886504,MATH 103A,B02,083780,Greenfeld; Be'Eri,4,0,36,32
1657360886504,MATH 103A,B03,093562,Greenfeld; Be'Eri,3,0,36,33
1657360892546,MATH 105,A01,085443,Carter; Anne Toulson,15,0,35,20
1657360892546,MATH 105,A02,093477,Carter; Anne Toulson,20,0,35,15
1657360898568,MATH 109,A01,083213,Ganzberger; Geoffrey Michael,2,0,34,32
1657360898568,MATH 109,A02,083214,Ganzberger; Geoffrey Michael,4,0,34,30
1657360898568,MATH 109,A03,093478,Ganzberger; Geoffrey Michael,2,0,34,32
1657360898568,MATH 109,B01,083215,Ganzberger; Geoffrey Michael,1,0,32,31
1657360898568,MATH 109,B02,083216,Ganzberger; Geoffrey Michael,2,0,32,30
1657360898568,MATH 109,B03,093479,Ganzberger; Geoffrey Michael,8,0,32,24
1657360904593,MATH 142A,A01,083219,Chow; Bennett,7,0,32,25
1657360904593,MATH 142A,A02,083220,Chow; Bennett,10,0,32,22
1657360904593,MATH 142A,A03,093480,Chow; Bennett,8,0,32,24
1657360904593,MATH 142A,B03,093481,Chow; Bennett,8,0,32,24
1657360904593,MATH 142A,B04,093558,Chow; Bennett,13,0,32,19
1657360904593,MATH 142A,B05,093559,Chow; Bennett,6,0,32,26
1657360910616,MATH 193A,A01,083224,Rotar; Vladimir,8,0,34,26
1657360910616,MATH 193A,A02,083225,Rotar; Vladimir,9,0,34,25
1657360910616,MATH 193A,A03,083781,Rotar; Vladimir,5,0,34,29
1657360910616,MATH 193A,A04,083782,Rotar; Vladimir,10,0,34,24
1657360910616,MATH 193A,A05,093482,Rotar; Vladimir,10,0,34,24
1657360916638,MATH 197,001,091859,McAuley; Julian John,9999,0,9999,0
1657360916638,MATH 197,002,095566,Kedlaya; Kiran S.,9997,0,9999,2
1657360916638,MATH 197,003,095567,Xiao; Ming,9999,0,9999,0
1657360916638,MATH 197,004,095571,Perols; Johan Lars,9998,0,9999,1
1657360923702,COGS 9,A01,083615,Shannon; Kyle Michael,8,0,75,67
1657360929724,COGS 11,A01,083617,Boyle; Mary E. T.,22,0,48,26
1657360935751,COGS 13,A01,083071,Bastos; Amalia Pinkusfeld,11,0,71,60
1657360941775,COGS 14A,A01,092681,Semenuks; Arturs,4,1,100,96
1657360947810,COGS 14B,A01,083073,Cheng; Tzu-Han,6,0,63,57
1657360953836,COGS 17,A01,092677,Semenuks; Arturs,6,0,81,75
1657360959860,COGS 100,A01,083619,Allen; Michael Gordon,17,0,70,53
1657360965888,COGS 101A,A01,083621,Davis; Joshua Daniel,9,0,68,59
1657360971912,COGS 101B,A01,091572,Allen; Michael Gordon,11,0,65,54
1657360977941,COGS 101C,A01,083625,Delgado; Tania,17,0,35,18
1657360983965,COGS 107A,A01,083627,Boyle; Mary E. T.,13,0,60,47
1657360989986,COGS 118A,A01,083075,Gupta; Anjum,20,0,76,56
1657360996009,CSE 3,A50,083646,Miranda; Gregory Joseph,24,0,50,26
1657361002032,CSE 8A,A50,083650,Miranda; Gregory Joseph,17,1,56,39
1657361008054,CSE 11,A01,083080,Cao; Yingjun,6,15,40,34
1657361014079,CSE 12,A01,083652,Krause-Levy; Sophia Louisa,28,1,120,92
1657361020114,CSE 15L,A01,083654,Morris; Justin Loren,9,0,50,41
1657361020114,CSE 15L,A02,083655,Morris; Justin Loren,9,0,50,41
1657361026137,CSE 20,A01,083657,Tran; Khoa Dang,39,0,80,41
1657361032160,CSE 21,A01,095574,Bach; Quang Tran,22,0,48,26
1657361038186,CSE 30,A01,083084,Eldon; John,4,0,80,76
1657361038186,CSE 30,B01,095061,Bhaskar; Nishant,9,0,50,41
1657361044213,CSE 100,A01,083659,Cao; Yingjun,5,4,70,65
1657361050236,CSE 134B,A01,083661,Powell; Thomas Allan,22,0,100,78
1657361056260,CSE 140,A01,083663,Gungor; Onat,14,0,85,71
1657361062284,CSE 140L,A01,083088,Eldon; John,21,0,100,79
1657361068308,CSE 175,A01,083665,Kumar; Rakesh,3,0,25,22
1657361074330,CSE 190,A00,092507,Dubnov; Shlomo,7,0,20,13
1657361080352,ECE 45,A01,083139,Congero; Spencer William,6,0,75,69
1657361086379,ECE 65,A50,083695,Saad; Andrew S,12,0,30,18
1657361086379,ECE 65,A51,095125,Saad; Andrew S,24,0,26,2
1657361092402,ECE 109,A01,091882,Touri; Behrouz,19,0,70,51
1657361098425,ECE 180,A00,083140,Abi Samra; Nicholas Camill,1,0,30,29
1657361098425,ECE 180,B00,083141,Abi Samra; Nicholas Camill,0,0,30,30
1657361104446,MATH 10A,A01,083735,Patchell; Gregory David,2,0,30,28
1657361104446,MATH 10A,A02,083736,Patchell; Gregory David,20,0,30,10
1657361104446,MATH 10A,A03,083737,Patchell; Gregory David,16,0,30,14
1657361110470,MATH 10B,A01,083207,Lim; Seonhee,8,0,34,26
1657361110470,MATH 10B,A02,083208,Lim; Seonhee,9,0,35,26
1657361110470,MATH 10B,A03,093472,Lim; Seonhee,7,0,34,27
1657361110470,MATH 10B,B01,083739,Sinha; Shubham,12,0,30,18
1657361116493,MATH 18,A01,083743,Cinel; Cameron Alexander,7,0,30,23
1657361116493,MATH 18,A02,083744,Cinel; Cameron Alexander,17,0,30,13
1657361116493,MATH 18,A03,083745,Cinel; Cameron Alexander,9,0,30,21
1657361116493,MATH 18,B01,083748,Rideout; David Porter,5,0,37,32
1657361116493,MATH 18,B02,083749,Rideout; David Porter,5,0,36,31
1657361116493,MATH 18,B03,083750,Rideout; David Porter,3,0,37,34
1657361116493,MATH 18,B04,083751,Rideout; David Porter,6,0,36,30
1657361116493,MATH 18,B05,093473,Rideout; David Porter,6,0,36,30
1657361116493,MATH 18,B06,093474,Rideout; David Porter,6,0,36,30
1657361122514,MATH 20A,A01,083754,Zheng; Zequn,14,0,40,26
1657361128541,MATH 20B,A01,083756,Briones; Jor-el Thomas Caparas,4,0,36,32
1657361128541,MATH 20B,A02,083757,Briones; Jor-el Thomas Caparas,1,0,36,35
1657361128541,MATH 20B,A03,093475,Briones; Jor-el Thomas Caparas,2,0,36,34
1657361134566,MATH 20C,A01,083760,Briones; Jor-el Thomas Caparas,1,0,35,34
1657361134566,MATH 20C,A02,083761,Briones; Jor-el Thomas Caparas,8,0,35,27
1657361134566,MATH 20C,A03,093476,Briones; Jor-el Thomas Caparas,0,1,36,36
1657361134566,MATH 20C,B01,083762,Bach; Quang Tran,1,0,30,29
1657361140590,MATH 20D,A01,083765,Tran; Brian Kha,5,0,30,25
1657361140590,MATH 20D,A02,083766,Tran; Brian Kha,5,0,30,25
1657361140590,MATH 20D,A03,083767,Tran; Brian Kha,5,0,30,25
1657361146616,MATH 20E,A01,083771,Ganguly; Soumya,9,0,32,23
1657361146616,MATH 20E,A02,083772,Ganguly; Soumya,6,0,32,26
1657361146616,MATH 20E,B01,083773,Ciotti; Benjamin,20,0,35,15
1657361146616,MATH 20E,B02,083774,Ciotti; Benjamin,17,0,35,18
1657361152640,MATH 103A,A01,083777,Greenfeld; Be'Eri,3,0,36,33
1657361152640,MATH 103A,A02,083778,Greenfeld; Be'Eri,5,0,36,31
1657361152640,MATH 103A,A03,093561,Greenfeld; Be'Eri,5,0,36,31
1657361152640,MATH 103A,B01,083779,Greenfeld; Be'Eri,7,0,36,29
1657361152640,MATH 103A,B02,083780,Greenfeld; Be'Eri,4,0,36,32
1657361152640,MATH 103A,B03,093562,Greenfeld; Be'Eri,3,0,36,33
1657361158664,MATH 105,A01,085443,Carter; Anne Toulson,15,0,35,20
1657361158664,MATH 105,A02,093477,Carter; Anne Toulson,20,0,35,15
1657361164687,MATH 109,A01,083213,Ganzberger; Geoffrey Michael,2,0,34,32
1657361164687,MATH 109,A02,083214,Ganzberger; Geoffrey Michael,4,0,34,30
1657361164687,MATH 109,A03,093478,Ganzberger; Geoffrey Michael,2,0,34,32
1657361164687,MATH 109,B01,083215,Ganzberger; Geoffrey Michael,1,0,32,31
1657361164687,MATH 109,B02,083216,Ganzberger; Geoffrey Michael,2,0,32,30
1657361164687,MATH 109,B03,093479,Ganzberger; Geoffrey Michael,8,0,32,24
1657361170711,MATH 142A,A01,083219,Chow; Bennett,7,0,32,25
1657361170711,MATH 142A,A02,083220,Chow; Bennett,10,0,32,22
1657361170711,MATH 142A,A03,093480,Chow; Bennett,8,0,32,24
1657361170711,MATH 142A,B03,093481,Chow; Bennett,8,0,32,24
1657361170711,MATH 142A,B04,093558,Chow; Bennett,13,0,32,19
1657361170711,MATH 142A,B05,093559,Chow; Bennett,6,0,32,26
1657361176739,MATH 193A,A01,083224,Rotar; Vladimir,8,0,34,26
1657361176739,MATH 193A,A02,083225,Rotar; Vladimir,9,0,34,25
1657361176739,MATH 193A,A03,083781,Rotar; Vladimir,5,0,34,29
1657361176739,MATH 193A,A04,083782,Rotar; Vladimir,10,0,34,24
1657361176739,MATH 193A,A05,093482,Rotar; Vladimir,10,0,34,24
1657361182761,MATH 197,001,091859,McAuley; Julian John,9999,0,9999,0
1657361182761,MATH 197,002,095566,Kedlaya; Kiran S.,9997,0,9999,2
1657361182761,MATH 197,003,095567,Xiao; Ming,9999,0,9999,0
1657361182761,MATH 197,004,095571,Perols; Johan Lars,9998,0,9999,1
1657361189830,COGS 9,A01,083615,Shannon; Kyle Michael,8,0,75,67
1657361195861,COGS 11,A01,083617,Boyle; Mary E. T.,22,0,48,26
1657361201883,COGS 13,A01,083071,Bastos; Amalia Pinkusfeld,11,0,71,60
1657361207912,COGS 14A,A01,092681,Semenuks; Arturs,4,1,100,96
1657361213938,COGS 14B,A01,083073,Cheng; Tzu-Han,6,0,63,57
1657361219961,COGS 17,A01,092677,Semenuks; Arturs,6,0,81,75
1657361225984,COGS 100,A01,083619,Allen; Michael Gordon,17,0,70,53
1657361232012,COGS 101A,A01,083621,Davis; Joshua Daniel,9,0,68,59
1657361238039,COGS 101B,A01,091572,Allen; Michael Gordon,11,0,65,54
1657361244062,COGS 101C,A01,083625,Delgado; Tania,17,0,35,18
1657361250085,COGS 107A,A01,083627,Boyle; Mary E. T.,13,0,60,47
1657361256109,COGS 118A,A01,083075,Gupta; Anjum,20,0,76,56
1657361262136,CSE 3,A50,083646,Miranda; Gregory Joseph,24,0,50,26
1657361268159,CSE 8A,A50,083650,Miranda; Gregory Joseph,17,1,56,39
1657361274186,CSE 11,A01,083080,Cao; Yingjun,6,15,40,34
1657361280216,CSE 12,A01,083652,Krause-Levy; Sophia Louisa,28,1,120,92
1657361286245,CSE 15L,A01,083654,Morris; Justin Loren,9,0,50,41
1657361286245,CSE 15L,A02,083655,Morris; Justin Loren,9,0,50,41
1657361292271,CSE 20,A01,083657,Tran; Khoa Dang,39,0,80,41
1657361298294,CSE 21,A01,095574,Bach; Quang Tran,22,0,48,26
1657361304324,CSE 30,A01,083084,Eldon; John,4,0,80,76
1657361304324,CSE 30,B01,095061,Bhaskar; Nishant,9,0,50,41
1657361310353,CSE 100,A01,083659,Cao; Yingjun,5,4,70,65
1657361316379,CSE 134B,A01,083661,Powell; Thomas Allan,22,0,100,78
1657361322404,CSE 140,A01,083663,Gungor; Onat,14,0,85,71
1657361328426,CSE 140L,A01,083088,Eldon; John,21,0,100,79
1657361334448,CSE 175,A01,083665,Kumar; Rakesh,3,0,25,22
1657361340473,CSE 190,A00,092507,Dubnov; Shlomo,7,0,20,13
1657361346499,ECE 45,A01,083139,Congero; Spencer William,6,0,75,69
1657361352521,ECE 65,A50,083695,Saad; Andrew S,12,0,30,18
1657361352521,ECE 65,A51,095125,Saad; Andrew S,24,0,26,2
1657361358547,ECE 109,A01,091882,Touri; Behrouz,19,0,70,51
1657361364666,ECE 180,A00,083140,Abi Samra; Nicholas Camill,1,0,30,29
1657361364666,ECE 180,B00,083141,Abi Samra; Nicholas Camill,0,0,30,30
1657361370692,MATH 10A,A01,083735,Patchell; Gregory David,2,0,30,28
1657361370692,MATH 10A,A02,083736,Patchell; Gregory David,20,0,30,10
1657361370692,MATH 10A,A03,083737,Patchell; Gregory David,16,0,30,14
1657361376715,MATH 10B,A01,083207,Lim; Seonhee,8,0,34,26
1657361376715,MATH 10B,A02,083208,Lim; Seonhee,9,0,35,26
1657361376715,MATH 10B,A03,093472,Lim; Seonhee,7,0,34,27
1657361376715,MATH 10B,B01,083739,Sinha; Shubham,12,0,30,18
1657361382747,MATH 18,A01,083743,Cinel; Cameron Alexander,7,0,30,23
1657361382747,MATH 18,A02,083744,Cinel; Cameron Alexander,17,0,30,13
1657361382747,MATH 18,A03,083745,Cinel; Cameron Alexander,9,0,30,21
1657361382747,MATH 18,B01,083748,Rideout; David Porter,5,0,37,32
1657361382747,MATH 18,B02,083749,Rideout; David Porter,5,0,36,31
1657361382747,MATH 18,B03,083750,Rideout; David Porter,3,0,37,34
1657361382747,MATH 18,B04,083751,Rideout; David Porter,6,0,36,30
1657361382747,MATH 18,B05,093473,Rideout; David Porter,6,0,36,30
1657361382747,MATH 18,B06,093474,Rideout; David Porter,6,0,36,30
1657361388772,MATH 20A,A01,083754,Zheng; Zequn,14,0,40,26
1657361394795,MATH 20B,A01,083756,Briones; Jor-el Thomas Caparas,4,0,36,32
1657361394795,MATH 20B,A02,083757,Briones; Jor-el Thomas Caparas,1,0,36,35
1657361394795,MATH 20B,A03,093475,Briones; Jor-el Thomas Caparas,2,0,36,34
1657361400823,MATH 20C,A01,083760,Briones; Jor-el Thomas Caparas,1,0,35,34
1657361400823,MATH 20C,A02,083761,Briones; Jor-el Thomas Caparas,8,0,35,27
1657361400823,MATH 20C,A03,093476,Briones; Jor-el Thomas Caparas,0,1,36,36
1657361400823,MATH 20C,B01,083762,Bach; Quang Tran,1,0,30,29
1657361406851,MATH 20D,A01,083765,Tran; Brian Kha,5,0,30,25
1657361406851,MATH 20D,A02,083766,Tran; Brian Kha,5,0,30,25
1657361406851,MATH 20D,A03,083767,Tran; Brian Kha,5,0,30,25
1657361412875,MATH 20E,A01,083771,Ganguly; Soumya,9,0,32,23
1657361412875,MATH 20E,A02,083772,Ganguly; Soumya,6,0,32,26
1657361412875,MATH 20E,B01,083773,Ciotti; Benjamin,20,0,35,15
1657361412875,MATH 20E,B02,083774,Ciotti; Benjamin,17,0,35,18
1657361418898,MATH 103A,A01,083777,Greenfeld; Be'Eri,3,0,36,33
1657361418898,MATH 103A,A02,083778,Greenfeld; Be'Eri,5,0,36,31
1657361418898,MATH 103A,A03,093561,Greenfeld; Be'Eri,5,0,36,31
1657361418898,MATH 103A,B01,083779,Greenfeld; Be'Eri,7,0,36,29
1657361418898,MATH 103A,B02,083780,Greenfeld; Be'Eri,4,0,36,32
1657361418898,MATH 103A,B03,093562,Greenfeld; Be'Eri,3,0,36,33
1657361424922,MATH 105,A01,085443,Carter; Anne Toulson,15,0,35,20
1657361424922,MATH 105,A02,093477,Carter; Anne Toulson,20,0,35,15
1657361430950,MATH 109,A01,083213,Ganzberger; Geoffrey Michael,2,0,34,32
1657361430950,MATH 109,A02,083214,Ganzberger; Geoffrey Michael,4,0,34,30
1657361430950,MATH 109,A03,093478,Ganzberger; Geoffrey Michael,2,0,34,32
1657361430950,MATH 109,B01,083215,Ganzberger; Geoffrey Michael,1,0,32,31
1657361430950,MATH 109,B02,083216,Ganzberger; Geoffrey Michael,2,0,32,30
1657361430950,MATH 109,B03,093479,Ganzberger; Geoffrey Michael,8,0,32,24
1657361436978,MATH 142A,A01,083219,Chow; Bennett,7,0,32,25
1657361436978,MATH 142A,A02,083220,Chow; Bennett,10,0,32,22
1657361436978,MATH 142A,A03,093480,Chow; Bennett,8,0,32,24
1657361436978,MATH 142A,B03,093481,Chow; Bennett,8,0,32,24
1657361436978,MATH 142A,B04,093558,Chow; Bennett,13,0,32,19
1657361436978,MATH 142A,B05,093559,Chow; Bennett,6,0,32,26
1657361443009,MATH 193A,A01,083224,Rotar; Vladimir,8,0,34,26
1657361443009,MATH 193A,A02,083225,Rotar; Vladimir,9,0,34,25
1657361443009,MATH 193A,A03,083781,Rotar; Vladimir,5,0,34,29
1657361443009,MATH 193A,A04,083782,Rotar; Vladimir,10,0,34,24
1657361443009,MATH 193A,A05,093482,Rotar; Vladimir,10,0,34,24
1657361449032,MATH 197,001,091859,McAuley; Julian John,9999,0,9999,0
1657361449032,MATH 197,002,095566,Kedlaya; Kiran S.,9997,0,9999,2
1657361449032,MATH 197,003,095567,Xiao; Ming,9999,0,9999,0
1657361449032,MATH 197,004,095571,Perols; Johan Lars,9998,0,9999,1
1657361456105,COGS 9,A01,083615,Shannon; Kyle Michael,8,0,75,67
1657361462132,COGS 11,A01,083617,Boyle; Mary E. T.,22,0,48,26
1657361468153,COGS 13,A01,083071,Bastos; Amalia Pinkusfeld,11,0,71,60
1657361474180,COGS 14A,A01,092681,Semenuks; Arturs,4,1,100,96
1657361480203,COGS 14B,A01,083073,Cheng; Tzu-Han,6,0,63,57
1657361486229,COGS 17,A01,092677,Semenuks; Arturs,6,0,81,75
1657361492255,COGS 100,A01,083619,Allen; Michael Gordon,17,0,70,53
1657361498281,COGS 101A,A01,083621,Davis; Joshua Daniel,9,0,68,59
1657361504308,COGS 101B,A01,091572,Allen; Michael Gordon,11,0,65,54
1657361510331,COGS 101C,A01,083625,Delgado; Tania,17,0,35,18
1657361516365,COGS 107A,A01,083627,Boyle; Mary E. T.,13,0,60,47
1657361522387,COGS 118A,A01,083075,Gupta; Anjum,20,0,76,56
1657361528410,CSE 3,A50,083646,Miranda; Gregory Joseph,24,0,50,26
1657361534437,CSE 8A,A50,083650,Miranda; Gregory Joseph,17,1,56,39
1657361540461,CSE 11,A01,083080,Cao; Yingjun,6,15,40,34
1657361546485,CSE 12,A01,083652,Krause-Levy; Sophia Louisa,28,1,120,92
1657361552508,CSE 15L,A01,083654,Morris; Justin Loren,9,0,50,41
1657361552508,CSE 15L,A02,083655,Morris; Justin Loren,9,0,50,41
1657361558533,CSE 20,A01,083657,Tran; Khoa Dang,39,0,80,41
1657361564559,CSE 21,A01,095574,Bach; Quang Tran,22,0,48,26
1657361570584,CSE 30,A01,083084,Eldon; John,4,0,80,76
1657361570584,CSE 30,B01,095061,Bhaskar; Nishant,9,0,50,41
1657361576610,CSE 100,A01,083659,Cao; Yingjun,5,4,70,65
1657361582633,CSE 134B,A01,083661,Powell; Thomas Allan,22,0,100,78
1657361588656,CSE 140,A01,083663,Gungor; Onat,14,0,85,71
1657361594681,CSE 140L,A01,083088,Eldon; John,21,0,100,79
1657361600708,CSE 175,A01,083665,Kumar; Rakesh,3,0,25,22
1657361606734,CSE 190,A00,092507,Dubnov; Shlomo,7,0,20,13
1657361612762,ECE 45,A01,083139,Congero; Spencer William,6,0,75,69
1657361618791,ECE 65,A50,083695,Saad; Andrew S,12,0,30,18
1657361618791,ECE 65,A51,095125,Saad; Andrew S,24,0,26,2
1657361624818,ECE 109,A01,091882,Touri; Behrouz,19,0,70,51
1657361630852,ECE 180,A00,083140,Abi Samra; Nicholas Camill,1,0,30,29
1657361630852,ECE 180,B00,083141,Abi Samra; Nicholas Camill,0,0,30,30
1657361636874,MATH 10A,A01,083735,Patchell; Gregory David,2,0,30,28
1657361636874,MATH 10A,A02,083736,Patchell; Gregory David,20,0,30,10
1657361636874,MATH 10A,A03,083737,Patchell; Gregory David,16,0,30,14
1657361642900,MATH 10B,A01,083207,Lim; Seonhee,8,0,34,26
1657361642900,MATH 10B,A02,083208,Lim; Seonhee,9,0,35,26
1657361642900,MATH 10B,A03,093472,Lim; Seonhee,7,0,34,27
1657361642900,MATH 10B,B01,083739,Sinha; Shubham,12,0,30,18
1657361648937,MATH 18,A01,083743,Cinel; Cameron Alexander,7,0,30,23
1657361648937,MATH 18,A02,083744,Cinel; Cameron Alexander,17,0,30,13
1657361648937,MATH 18,A03,083745,Cinel; Cameron Alexander,9,0,30,21
1657361648937,MATH 18,B01,083748,Rideout; David Porter,5,0,37,32
1657361648937,MATH 18,B02,083749,Rideout; David Porter,5,0,36,31
1657361648937,MATH 18,B03,083750,Rideout; David Porter,3,0,37,34
1657361648937,MATH 18,B04,083751,Rideout; David Porter,6,0,36,30
1657361648937,MATH 18,B05,093473,Rideout; David Porter,6,0,36,30
1657361648937,MATH 18,B06,093474,Rideout; David Porter,6,0,36,30
1657361654960,MATH 20A,A01,083754,Zheng; Zequn,14,0,40,26
1657361660984,MATH 20B,A01,083756,Briones; Jor-el Thomas Caparas,4,0,36,32
1657361660984,MATH 20B,A02,083757,Briones; Jor-el Thomas Caparas,1,0,36,35
1657361660984,MATH 20B,A03,093475,Briones; Jor-el Thomas Caparas,2,0,36,34
1657361667008,MATH 20C,A01,083760,Briones; Jor-el Thomas Caparas,1,0,35,34
1657361667008,MATH 20C,A02,083761,Briones; Jor-el Thomas Caparas,8,0,35,27
1657361667008,MATH 20C,A03,093476,Briones; Jor-el Thomas Caparas,0,1,36,36
1657361667008,MATH 20C,B01,083762,Bach; Quang Tran,1,0,30,29
1657361673038,MATH 20D,A01,083765,Tran; Brian Kha,5,0,30,25
1657361673038,MATH 20D,A02,083766,Tran; Brian Kha,5,0,30,25
1657361673038,MATH 20D,A03,083767,Tran; Brian Kha,5,0,30,25
1657361679071,MATH 20E,A01,083771,Ganguly; Soumya,9,0,32,23
1657361679071,MATH 20E,A02,083772,Ganguly; Soumya,6,0,32,26
1657361679071,MATH 20E,B01,083773,Ciotti; Benjamin,20,0,35,15
1657361679071,MATH 20E,B02,083774,Ciotti; Benjamin,17,0,35,18
1657361685094,MATH 103A,A01,083777,Greenfeld; Be'Eri,3,0,36,33
1657361685094,MATH 103A,A02,083778,Greenfeld; Be'Eri,5,0,36,31
1657361685094,MATH 103A,A03,093561,Greenfeld; Be'Eri,5,0,36,31
1657361685094,MATH 103A,B01,083779,Greenfeld; Be'Eri,7,0,36,29
1657361685094,MATH 103A,B02,083780,Greenfeld; Be'Eri,4,0,36,32
1657361685094,MATH 103A,B03,093562,Greenfeld; Be'Eri,3,0,36,33
1657361691117,MATH 105,A01,085443,Carter; Anne Toulson,15,0,35,20
1657361691117,MATH 105,A02,093477,Carter; Anne Toulson,20,0,35,15
1657361697140,MATH 109,A01,083213,Ganzberger; Geoffrey Michael,2,0,34,32
1657361697140,MATH 109,A02,083214,Ganzberger; Geoffrey Michael,4,0,34,30
1657361697140,MATH 109,A03,093478,Ganzberger; Geoffrey Michael,2,0,34,32
1657361697140,MATH 109,B01,083215,Ganzberger; Geoffrey Michael,1,0,32,31
1657361697140,MATH 109,B02,083216,Ganzberger; Geoffrey Michael,2,0,32,30
1657361697140,MATH 109,B03,093479,Ganzberger; Geoffrey Michael,8,0,32,24
1657361703171,MATH 142A,A01,083219,Chow; Bennett,7,0,32,25
1657361703171,MATH 142A,A02,083220,Chow; Bennett,10,0,32,22
1657361703171,MATH 142A,A03,093480,Chow; Bennett,8,0,32,24
1657361703171,MATH 142A,B03,093481,Chow; Bennett,8,0,32,24
1657361703171,MATH 142A,B04,093558,Chow; Bennett,13,0,32,19
1657361703171,MATH 142A,B05,093559,Chow; Bennett,6,0,32,26
1657361709195,MATH 193A,A01,083224,Rotar; Vladimir,8,0,34,26
1657361709195,MATH 193A,A02,083225,Rotar; Vladimir,9,0,34,25
1657361709195,MATH 193A,A03,083781,Rotar; Vladimir,5,0,34,29
1657361709195,MATH 193A,A04,083782,Rotar; Vladimir,10,0,34,24
1657361709195,MATH 193A,A05,093482,Rotar; Vladimir,10,0,34,24
1657361715217,MATH 197,001,091859,McAuley; Julian John,9999,0,9999,0
1657361715217,MATH 197,002,095566,Kedlaya; Kiran S.,9997,0,9999,2
1657361715217,MATH 197,003,095567,Xiao; Ming,9999,0,9999,0
1657361715217,MATH 197,004,095571,Perols; Johan Lars,9998,0,9999,1
1657361722270,COGS 9,A01,083615,Shannon; Kyle Michael,8,0,75,67
1657361728293,COGS 11,A01,083617,Boyle; Mary E. T.,22,0,48,26
1657361734319,COGS 13,A01,083071,Bastos; Amalia Pinkusfeld,11,0,71,60
1657361740343,COGS 14A,A01,092681,Semenuks; Arturs,4,1,100,96
1657361746367,COGS 14B,A01,083073,Cheng; Tzu-Han,6,0,63,57
1657361752390,COGS 17,A01,092677,Semenuks; Arturs,6,0,81,75
1657361758413,COGS 100,A01,083619,Allen; Michael Gordon,17,0,70,53
1657361764436,COGS 101A,A01,083621,Davis; Joshua Daniel,9,0,68,59
1657361770458,COGS 101B,A01,091572,Allen; Michael Gordon,11,0,65,54
1657361776482,COGS 101C,A01,083625,Delgado; Tania,17,0,35,18
1657361782507,COGS 107A,A01,083627,Boyle; Mary E. T.,13,0,60,47
1657361788532,COGS 118A,A01,083075,Gupta; Anjum,20,0,76,56
1657361794559,CSE 3,A50,083646,Miranda; Gregory Joseph,24,0,50,26
1657361800585,CSE 8A,A50,083650,Miranda; Gregory Joseph,17,1,56,39
1657361806611,CSE 11,A01,083080,Cao; Yingjun,6,15,40,34
1657361812634,CSE 12,A01,083652,Krause-Levy; Sophia Louisa,28,1,120,92
1657361818658,CSE 15L,A01,083654,Morris; Justin Loren,9,0,50,41
1657361818658,CSE 15L,A02,083655,Morris; Justin Loren,9,0,50,41
1657361824686,CSE 20,A01,083657,Tran; Khoa Dang,39,0,80,41
1657361830710,CSE 21,A01,095574,Bach; Quang Tran,22,0,48,26
1657361836735,CSE 30,A01,083084,Eldon; John,4,0,80,76
1657361836735,CSE 30,B01,095061,Bhaskar; Nishant,9,0,50,41
1657361842757,CSE 100,A01,083659,Cao; Yingjun,5,4,70,65
1657361848779,CSE 134B,A01,083661,Powell; Thomas Allan,22,0,100,78
1657361854802,CSE 140,A01,083663,Gungor; Onat,14,0,85,71
1657361860826,CSE 140L,A01,083088,Eldon; John,21,0,100,79
1657361866851,CSE 175,A01,083665,Kumar; Rakesh,3,0,25,22
1657361872874,CSE 190,A00,092507,Dubnov; Shlomo,7,0,20,13
1657361878897,ECE 45,A01,083139,Congero; Spencer William,6,0,75,69
1657361884921,ECE 65,A50,083695,Saad; Andrew S,12,0,30,18
1657361884921,ECE 65,A51,095125,Saad; Andrew S,24,0,26,2
1657361890948,ECE 109,A01,091882,Touri; Behrouz,19,0,70,51
1657361896972,ECE 180,A00,083140,Abi Samra; Nicholas Camill,1,0,30,29
1657361896972,ECE 180,B00,083141,Abi Samra; Nicholas Camill,0,0,30,30
1657361902993,MATH 10A,A01,083735,Patchell; Gregory David,2,0,30,28
1657361902993,MATH 10A,A02,083736,Patchell; Gregory David,20,0,30,10
1657361902993,MATH 10A,A03,083737,Patchell; Gregory David,16,0,30,14
1657361909018,MATH 10B,A01,083207,Lim; Seonhee,8,0,34,26
1657361909018,MATH 10B,A02,083208,Lim; Seonhee,9,0,35,26
1657361909018,MATH 10B,A03,093472,Lim; Seonhee,7,0,34,27
1657361909018,MATH 10B,B01,083739,Sinha; Shubham,12,0,30,18
1657361915048,MATH 18,A01,083743,Cinel; Cameron Alexander,7,0,30,23
1657361915048,MATH 18,A02,083744,Cinel; Cameron Alexander,17,0,30,13
1657361915048,MATH 18,A03,083745,Cinel; Cameron Alexander,9,0,30,21
1657361915048,MATH 18,B01,083748,Rideout; David Porter,5,0,37,32
1657361915048,MATH 18,B02,083749,Rideout; David Porter,5,0,36,31
1657361915048,MATH 18,B03,083750,Rideout; David Porter,3,0,37,34
1657361915048,MATH 18,B04,083751,Rideout; David Porter,6,0,36,30
1657361915048,MATH 18,B05,093473,Rideout; David Porter,6,0,36,30
1657361915048,MATH 18,B06,093474,Rideout; David Porter,6,0,36,30
1657361921071,MATH 20A,A01,083754,Zheng; Zequn,14,0,40,26
1657361927104,MATH 20B,A01,083756,Briones; Jor-el Thomas Caparas,4,0,36,32
1657361927104,MATH 20B,A02,083757,Briones; Jor-el Thomas Caparas,1,0,36,35
1657361927104,MATH 20B,A03,093475,Briones; Jor-el Thomas Caparas,2,0,36,34
1657361933129,MATH 20C,A01,083760,Briones; Jor-el Thomas Caparas,1,0,35,34
1657361933129,MATH 20C,A02,083761,Briones; Jor-el Thomas Caparas,8,0,35,27
1657361933129,MATH 20C,A03,093476,Briones; Jor-el Thomas Caparas,0,1,36,36
1657361933129,MATH 20C,B01,083762,Bach; Quang Tran,1,0,30,29
1657361939152,MATH 20D,A01,083765,Tran; Brian Kha,5,0,30,25
1657361939152,MATH 20D,A02,083766,Tran; Brian Kha,5,0,30,25
1657361939152,MATH 20D,A03,083767,Tran; Brian Kha,5,0,30,25
1657361945177,MATH 20E,A01,083771,Ganguly; Soumya,9,0,32,23
1657361945177,MATH 20E,A02,083772,Ganguly; Soumya,6,0,32,26
1657361945177,MATH 20E,B01,083773,Ciotti; Benjamin,20,0,35,15
1657361945177,MATH 20E,B02,083774,Ciotti; Benjamin,17,0,35,18
1657361951201,MATH 103A,A01,083777,Greenfeld; Be'Eri,3,0,36,33
1657361951201,MATH 103A,A02,083778,Greenfeld; Be'Eri,5,0,36,31
1657361951201,MATH 103A,A03,093561,Greenfeld; Be'Eri,5,0,36,31
1657361951201,MATH 103A,B01,083779,Greenfeld; Be'Eri,7,0,36,29
1657361951201,MATH 103A,B02,083780,Greenfeld; Be'Eri,4,0,36,32
1657361951201,MATH 103A,B03,093562,Greenfeld; Be'Eri,3,0,36,33
1657361957223,MATH 105,A01,085443,Carter; Anne Toulson,15,0,35,20
1657361957223,MATH 105,A02,093477,Carter; Anne Toulson,20,0,35,15
1657361963345,MATH 109,A01,083213,Ganzberger; Geoffrey Michael,2,0,34,32
1657361963345,MATH 109,A02,083214,Ganzberger; Geoffrey Michael,4,0,34,30
1657361963345,MATH 109,A03,093478,Ganzberger; Geoffrey Michael,2,0,34,32
1657361963345,MATH 109,B01,083215,Ganzberger; Geoffrey Michael,1,0,32,31
1657361963345,MATH 109,B02,083216,Ganzberger; Geoffrey Michael,2,0,32,30
1657361963345,MATH 109,B03,093479,Ganzberger; Geoffrey Michael,8,0,32,24
1657361969368,MATH 142A,A01,083219,Chow; Bennett,7,0,32,25
1657361969368,MATH 142A,A02,083220,Chow; Bennett,10,0,32,22
1657361969368,MATH 142A,A03,093480,Chow; Bennett,8,0,32,24
1657361969368,MATH 142A,B03,093481,Chow; Bennett,8,0,32,24
1657361969368,MATH 142A,B04,093558,Chow; Bennett,13,0,32,19
1657361969368,MATH 142A,B05,093559,Chow; Bennett,6,0,32,26
1657361975393,MATH 193A,A01,083224,Rotar; Vladimir,8,0,34,26
1657361975393,MATH 193A,A02,083225,Rotar; Vladimir,9,0,34,25
1657361975393,MATH 193A,A03,083781,Rotar; Vladimir,5,0,34,29
1657361975393,MATH 193A,A04,083782,Rotar; Vladimir,10,0,34,24
1657361975393,MATH 193A,A05,093482,Rotar; Vladimir,10,0,34,24
1657361981419,MATH 197,001,091859,McAuley; Julian John,9999,0,9999,0
1657361981419,MATH 197,002,095566,Kedlaya; Kiran S.,9997,0,9999,2
1657361981419,MATH 197,003,095567,Xiao; Ming,9999,0,9999,0
1657361981419,MATH 197,004,095571,Perols; Johan Lars,9998,0,9999,1
1657361988475,COGS 9,A01,083615,Shannon; Kyle Michael,8,0,75,67
1657361994498,COGS 11,A01,083617,Boyle; Mary E. T.,22,0,48,26
1657362000524,COGS 13,A01,083071,Bastos; Amalia Pinkusfeld,11,0,71,60
1657362006552,COGS 14A,A01,092681,Semenuks; Arturs,4,1,100,96
1657362012573,COGS 14B,A01,083073,Cheng; Tzu-Han,6,0,63,57
1657362018601,COGS 17,A01,092677,Semenuks; Arturs,6,0,81,75
1657362024633,COGS 100,A01,083619,Allen; Michael Gordon,17,0,70,53
1657362030654,COGS 101A,A01,083621,Davis; Joshua Daniel,9,0,68,59
1657362036679,COGS 101B,A01,091572,Allen; Michael Gordon,11,0,65,54
1657362042700,COGS 101C,A01,083625,Delgado; Tania,17,0,35,18
1657362048723,COGS 107A,A01,083627,Boyle; Mary E. T.,13,0,60,47
1657362054751,COGS 118A,A01,083075,Gupta; Anjum,20,0,76,56
1657362060778,CSE 3,A50,083646,Miranda; Gregory Joseph,24,0,50,26
1657362066804,CSE 8A,A50,083650,Miranda; Gregory Joseph,17,1,56,39
1657362072832,CSE 11,A01,083080,Cao; Yingjun,6,15,40,34
1657362078855,CSE 12,A01,083652,Krause-Levy; Sophia Louisa,28,1,120,92
1657362084877,CSE 15L,A01,083654,Morris; Justin Loren,9,0,50,41
1657362084877,CSE 15L,A02,083655,Morris; Justin Loren,9,0,50,41
1657362090901,CSE 20,A01,083657,Tran; Khoa Dang,39,0,80,41
1657362096928,CSE 21,A01,095574,Bach; Quang Tran,22,0,48,26
1657362102952,CSE 30,A01,083084,Eldon; John,4,0,80,76
1657362102952,CSE 30,B01,095061,Bhaskar; Nishant,9,0,50,41
1657362108977,CSE 100,A01,083659,Cao; Yingjun,5,4,70,65
1657362115000,CSE 134B,A01,083661,Powell; Thomas Allan,22,0,100,78
1657362121022,CSE 140,A01,083663,Gungor; Onat,14,0,85,71
1657362127046,CSE 140L,A01,083088,Eldon; John,21,0,100,79
1657362133068,CSE 175,A01,083665,Kumar; Rakesh,3,0,25,22
1657362139091,CSE 190,A00,092507,Dubnov; Shlomo,7,0,20,13
1657362145118,ECE 45,A01,083139,Congero; Spencer William,6,0,75,69
1657362151146,ECE 65,A50,083695,Saad; Andrew S,12,0,30,18
1657362151146,ECE 65,A51,095125,Saad; Andrew S,24,0,26,2
1657362157172,ECE 109,A01,091882,Touri; Behrouz,19,0,70,51
1657362163195,ECE 180,A00,083140,Abi Samra; Nicholas Camill,1,0,30,29
1657362163195,ECE 180,B00,083141,Abi Samra; Nicholas Camill,0,0,30,30
1657362169219,MATH 10A,A01,083735,Patchell; Gregory David,2,0,30,28
1657362169219,MATH 10A,A02,083736,Patchell; Gregory David,20,0,30,10
1657362169219,MATH 10A,A03,083737,Patchell; Gregory David,16,0,30,14
1657362175243,MATH 10B,A01,083207,Lim; Seonhee,8,0,34,26
1657362175243,MATH 10B,A02,083208,Lim; Seonhee,9,0,35,26
1657362175243,MATH 10B,A03,093472,Lim; Seonhee,7,0,34,27
1657362175243,MATH 10B,B01,083739,Sinha; Shubham,12,0,30,18
1657362181273,MATH 18,A01,083743,Cinel; Cameron Alexander,7,0,30,23
1657362181273,MATH 18,A02,083744,Cinel; Cameron Alexander,17,0,30,13
1657362181273,MATH 18,A03,083745,Cinel; Cameron Alexander,9,0,30,21
1657362181273,MATH 18,B01,083748,Rideout; David Porter,5,0,37,32
1657362181273,MATH 18,B02,083749,Rideout; David Porter,5,0,36,31
1657362181273,MATH 18,B03,083750,Rideout; David Porter,3,0,37,34
1657362181273,MATH 18,B04,083751,Rideout; David Porter,6,0,36,30
1657362181273,MATH 18,B05,093473,Rideout; David Porter,6,0,36,30
1657362181273,MATH 18,B06,093474,Rideout; David Porter,6,0,36,30
1657362187300,MATH 20A,A01,083754,Zheng; Zequn,14,0,40,26
1657362193323,MATH 20B,A01,083756,Briones; Jor-el Thomas Caparas,4,0,36,32
1657362193323,MATH 20B,A02,083757,Briones; Jor-el Thomas Caparas,1,0,36,35
1657362193323,MATH 20B,A03,093475,Briones; Jor-el Thomas Caparas,2,0,36,34
1657362199352,MATH 20C,A01,083760,Briones; Jor-el Thomas Caparas,1,0,35,34
1657362199352,MATH 20C,A02,083761,Briones; Jor-el Thomas Caparas,8,0,35,27
1657362199352,MATH 20C,A03,093476,Briones; Jor-el Thomas Caparas,0,1,36,36
1657362199352,MATH 20C,B01,083762,Bach; Quang Tran,1,0,30,29
1657362205390,MATH 20D,A01,083765,Tran; Brian Kha,5,0,30,25
1657362205390,MATH 20D,A02,083766,Tran; Brian Kha,5,0,30,25
1657362205390,MATH 20D,A03,083767,Tran; Brian Kha,5,0,30,25
1657362211413,MATH 20E,A01,083771,Ganguly; Soumya,9,0,32,23
1657362211413,MATH 20E,A02,083772,Ganguly; Soumya,6,0,32,26
1657362211413,MATH 20E,B01,083773,Ciotti; Benjamin,20,0,35,15
1657362211413,MATH 20E,B02,083774,Ciotti; Benjamin,17,0,35,18
1657362217442,MATH 103A,A01,083777,Greenfeld; Be'Eri,3,0,36,33
1657362217442,MATH 103A,A02,083778,Greenfeld; Be'Eri,5,0,36,31
1657362217442,MATH 103A,A03,093561,Greenfeld; Be'Eri,5,0,36,31
1657362217442,MATH 103A,B01,083779,Greenfeld; Be'Eri,7,0,36,29
1657362217442,MATH 103A,B02,083780,Greenfeld; Be'Eri,4,0,36,32
1657362217442,MATH 103A,B03,093562,Greenfeld; Be'Eri,3,0,36,33
1657362223469,MATH 105,A01,085443,Carter; Anne Toulson,15,0,35,20
1657362223469,MATH 105,A02,093477,Carter; Anne Toulson,20,0,35,15
1657362229492,MATH 109,A01,083213,Ganzberger; Geoffrey Michael,2,0,34,32
1657362229492,MATH 109,A02,083214,Ganzberger; Geoffrey Michael,4,0,34,30
1657362229492,MATH 109,A03,093478,Ganzberger; Geoffrey Michael,2,0,34,32
1657362229492,MATH 109,B01,083215,Ganzberger; Geoffrey Michael,1,0,32,31
1657362229492,MATH 109,B02,083216,Ganzberger; Geoffrey Michael,2,0,32,30
1657362229492,MATH 109,B03,093479,Ganzberger; Geoffrey Michael,8,0,32,24
1657362235517,MATH 142A,A01,083219,Chow; Bennett,7,0,32,25
1657362235517,MATH 142A,A02,083220,Chow; Bennett,10,0,32,22
1657362235517,MATH 142A,A03,093480,Chow; Bennett,8,0,32,24
1657362235517,MATH 142A,B03,093481,Chow; Bennett,8,0,32,24
1657362235517,MATH 142A,B04,093558,Chow; Bennett,13,0,32,19
1657362235517,MATH 142A,B05,093559,Chow; Bennett,6,0,32,26
1657362241541,MATH 193A,A01,083224,Rotar; Vladimir,8,0,34,26
1657362241541,MATH 193A,A02,083225,Rotar; Vladimir,9,0,34,25
1657362241541,MATH 193A,A03,083781,Rotar; Vladimir,5,0,34,29
1657362241541,MATH 193A,A04,083782,Rotar; Vladimir,10,0,34,24
1657362241541,MATH 193A,A05,093482,Rotar; Vladimir,10,0,34,24
1657362247566,MATH 197,001,091859,McAuley; Julian John,9999,0,9999,0
1657362247566,MATH 197,002,095566,Kedlaya; Kiran S.,9997,0,9999,2
1657362247566,MATH 197,003,095567,Xiao; Ming,9999,0,9999,0
1657362247566,MATH 197,004,095571,Perols; Johan Lars,9998,0,9999,1
1657362254627,COGS 9,A01,083615,Shannon; Kyle Michael,8,0,75,67
1657362260649,COGS 11,A01,083617,Boyle; Mary E. T.,22,0,48,26
1657362266676,COGS 13,A01,083071,Bastos; Amalia Pinkusfeld,11,0,71,60
1657362272698,COGS 14A,A01,092681,Semenuks; Arturs,4,1,100,96
1657362278727,COGS 14B,A01,083073,Cheng; Tzu-Han,6,0,63,57
1657362284750,COGS 17,A01,092677,Semenuks; Arturs,6,0,81,75
1657362290773,COGS 100,A01,083619,Allen; Michael Gordon,17,0,70,53
1657362296797,COGS 101A,A01,083621,Davis; Joshua Daniel,9,0,68,59
1657362302824,COGS 101B,A01,091572,Allen; Michael Gordon,11,0,65,54
1657362308847,COGS 101C,A01,083625,Delgado; Tania,17,0,35,18
1657362314874,COGS 107A,A01,083627,Boyle; Mary E. T.,13,0,60,47
1657362320899,COGS 118A,A01,083075,Gupta; Anjum,20,0,76,56
1657362326925,CSE 3,A50,083646,Miranda; Gregory Joseph,24,0,50,26
1657362332954,CSE 8A,A50,083650,Miranda; Gregory Joseph,17,1,56,39
1657362338989,CSE 11,A01,083080,Cao; Yingjun,6,15,40,34
1657362345013,CSE 12,A01,083652,Krause-Levy; Sophia Louisa,28,1,120,92
1657362351037,CSE 15L,A01,083654,Morris; Justin Loren,9,0,50,41
1657362351037,CSE 15L,A02,083655,Morris; Justin Loren,9,0,50,41
1657362357064,CSE 20,A01,083657,Tran; Khoa Dang,39,0,80,41
1657362363091,CSE 21,A01,095574,Bach; Quang Tran,22,0,48,26
1657362369114,CSE 30,A01,083084,Eldon; John,4,0,80,76
1657362369114,CSE 30,B01,095061,Bhaskar; Nishant,9,0,50,41
1657362375163,CSE 100,A01,083659,Cao; Yingjun,5,4,70,65
1657362381187,CSE 134B,A01,083661,Powell; Thomas Allan,22,0,100,78
1657362387210,CSE 140,A01,083663,Gungor; Onat,14,0,85,71
1657362393238,CSE 140L,A01,083088,Eldon; John,21,0,100,79
1657362399260,CSE 175,A01,083665,Kumar; Rakesh,3,0,25,22
1657362405282,CSE 190,A00,092507,Dubnov; Shlomo,7,0,20,13
1657362411308,ECE 45,A01,083139,Congero; Spencer William,6,0,75,69
1657362417336,ECE 65,A50,083695,Saad; Andrew S,12,0,30,18
1657362417336,ECE 65,A51,095125,Saad; Andrew S,24,0,26,2
1657362423359,ECE 109,A01,091882,Touri; Behrouz,19,0,70,51
1657362429381,ECE 180,A00,083140,Abi Samra; Nicholas Camill,1,0,30,29
1657362429381,ECE 180,B00,083141,Abi Samra; Nicholas Camill,0,0,30,30
1657362435404,MATH 10A,A01,083735,Patchell; Gregory David,2,0,30,28
1657362435404,MATH 10A,A02,083736,Patchell; Gregory David,20,0,30,10
1657362435404,MATH 10A,A03,083737,Patchell; Gregory David,16,0,30,14
1657362441427,MATH 10B,A01,083207,Lim; Seonhee,8,0,34,26
1657362441427,MATH 10B,A02,083208,Lim; Seonhee,9,0,35,26
1657362441427,MATH 10B,A03,093472,Lim; Seonhee,7,0,34,27
1657362441427,MATH 10B,B01,083739,Sinha; Shubham,12,0,30,18
1657362447453,MATH 18,A01,083743,Cinel; Cameron Alexander,7,0,30,23
1657362447453,MATH 18,A02,083744,Cinel; Cameron Alexander,17,0,30,13
1657362447453,MATH 18,A03,083745,Cinel; Cameron Alexander,9,0,30,21
1657362447453,MATH 18,B01,083748,Rideout; David Porter,5,0,37,32
1657362447453,MATH 18,B02,083749,Rideout; David Porter,5,0,36,31
1657362447453,MATH 18,B03,083750,Rideout; David Porter,3,0,37,34
1657362447453,MATH 18,B04,083751,Rideout; David Porter,6,0,36,30
1657362447453,MATH 18,B05,093473,Rideout; David Porter,6,0,36,30
1657362447453,MATH 18,B06,093474,Rideout; David Porter,6,0,36,30
1657362453488,MATH 20A,A01,083754,Zheng; Zequn,14,0,40,26
1657362459515,MATH 20B,A01,083756,Briones; Jor-el Thomas Caparas,4,0,36,32
1657362459515,MATH 20B,A02,083757,Briones; Jor-el Thomas Caparas,1,0,36,35
1657362459515,MATH 20B,A03,093475,Briones; Jor-el Thomas Caparas,2,0,36,34
1657362465543,MATH 20C,A01,083760,Briones; Jor-el Thomas Caparas,1,0,35,34
1657362465543,MATH 20C,A02,083761,Briones; Jor-el Thomas Caparas,8,0,35,27
1657362465543,MATH 20C,A03,093476,Briones; Jor-el Thomas Caparas,0,1,36,36
1657362465543,MATH 20C,B01,083762,Bach; Quang Tran,1,0,30,29
1657362471572,MATH 20D,A01,083765,Tran; Brian Kha,5,0,30,25
1657362471572,MATH 20D,A02,083766,Tran; Brian Kha,5,0,30,25
1657362471572,MATH 20D,A03,083767,Tran; Brian Kha,5,0,30,25
1657362477599,MATH 20E,A01,083771,Ganguly; Soumya,9,0,32,23
1657362477599,MATH 20E,A02,083772,Ganguly; Soumya,6,0,32,26
1657362477599,MATH 20E,B01,083773,Ciotti; Benjamin,20,0,35,15
1657362477599,MATH 20E,B02,083774,Ciotti; Benjamin,17,0,35,18
1657362483625,MATH 103A,A01,083777,Greenfeld; Be'Eri,3,0,36,33
1657362483625,MATH 103A,A02,083778,Greenfeld; Be'Eri,5,0,36,31
1657362483625,MATH 103A,A03,093561,Greenfeld; Be'Eri,5,0,36,31
1657362483625,MATH 103A,B01,083779,Greenfeld; Be'Eri,7,0,36,29
1657362483625,MATH 103A,B02,083780,Greenfeld; Be'Eri,4,0,36,32
1657362483625,MATH 103A,B03,093562,Greenfeld; Be'Eri,3,0,36,33
1657362489647,MATH 105,A01,085443,Carter; Anne Toulson,15,0,35,20
1657362489647,MATH 105,A02,093477,Carter; Anne Toulson,20,0,35,15
1657362495671,MATH 109,A01,083213,Ganzberger; Geoffrey Michael,2,0,34,32
1657362495671,MATH 109,A02,083214,Ganzberger; Geoffrey Michael,4,0,34,30
1657362495671,MATH 109,A03,093478,Ganzberger; Geoffrey Michael,2,0,34,32
1657362495671,MATH 109,B01,083215,Ganzberger; Geoffrey Michael,1,0,32,31
1657362495671,MATH 109,B02,083216,Ganzberger; Geoffrey Michael,2,0,32,30
1657362495671,MATH 109,B03,093479,Ganzberger; Geoffrey Michael,8,0,32,24
1657362501695,MATH 142A,A01,083219,Chow; Bennett,7,0,32,25
1657362501695,MATH 142A,A02,083220,Chow; Bennett,10,0,32,22
1657362501695,MATH 142A,A03,093480,Chow; Bennett,8,0,32,24
1657362501695,MATH 142A,B03,093481,Chow; Bennett,8,0,32,24
1657362501695,MATH 142A,B04,093558,Chow; Bennett,13,0,32,19
1657362501695,MATH 142A,B05,093559,Chow; Bennett,6,0,32,26
1657362507719,MATH 193A,A01,083224,Rotar; Vladimir,8,0,34,26
1657362507719,MATH 193A,A02,083225,Rotar; Vladimir,9,0,34,25
1657362507719,MATH 193A,A03,083781,Rotar; Vladimir,5,0,34,29
1657362507719,MATH 193A,A04,083782,Rotar; Vladimir,10,0,34,24
1657362507719,MATH 193A,A05,093482,Rotar; Vladimir,10,0,34,24
1657362513745,MATH 197,001,091859,McAuley; Julian John,9999,0,9999,0
1657362513745,MATH 197,002,095566,Kedlaya; Kiran S.,9997,0,9999,2
1657362513745,MATH 197,003,095567,Xiao; Ming,9999,0,9999,0
1657362513745,MATH 197,004,095571,Perols; Johan Lars,9998,0,9999,1
1657362520806,COGS 9,A01,083615,Shannon; Kyle Michael,8,0,75,67
1657362526841,COGS 11,A01,083617,Boyle; Mary E. T.,22,0,48,26
1657362532890,COGS 13,A01,083071,Bastos; Amalia Pinkusfeld,11,0,71,60
1657362538913,COGS 14A,A01,092681,Semenuks; Arturs,4,1,100,96
1657362544934,COGS 14B,A01,083073,Cheng; Tzu-Han,6,0,63,57
1657362550960,COGS 17,A01,092677,Semenuks; Arturs,6,0,81,75
1657362557057,COGS 100,A01,083619,Allen; Michael Gordon,17,0,70,53
1657362563088,COGS 101A,A01,083621,Davis; Joshua Daniel,9,0,68,59
1657362569114,COGS 101B,A01,091572,Allen; Michael Gordon,11,0,65,54
1657362575138,COGS 101C,A01,083625,Delgado; Tania,17,0,35,18
1657362581167,COGS 107A,A01,083627,Boyle; Mary E. T.,13,0,60,47
1657362587189,COGS 118A,A01,083075,Gupta; Anjum,20,0,76,56
1657362593217,CSE 3,A50,083646,Miranda; Gregory Joseph,24,0,50,26
1657362599244,CSE 8A,A50,083650,Miranda; Gregory Joseph,17,1,56,39
1657362605273,CSE 11,A01,083080,Cao; Yingjun,6,15,40,34
1657362611305,CSE 12,A01,083652,Krause-Levy; Sophia Louisa,28,1,120,92
1657362617328,CSE 15L,A01,083654,Morris; Justin Loren,9,0,50,41
1657362617328,CSE 15L,A02,083655,Morris; Justin Loren,9,0,50,41
1657362623351,CSE 20,A01,083657,Tran; Khoa Dang,39,0,80,41
1657362629376,CSE 21,A01,095574,Bach; Quang Tran,22,0,48,26
1657362635404,CSE 30,A01,083084,Eldon; John,4,0,80,76
1657362635404,CSE 30,B01,095061,Bhaskar; Nishant,9,0,50,41
1657362641430,CSE 100,A01,083659,Cao; Yingjun,5,4,70,65
1657362647452,CSE 134B,A01,083661,Powell; Thomas Allan,22,0,100,78
1657362653479,CSE 140,A01,083663,Gungor; Onat,14,0,85,71
1657362659505,CSE 140L,A01,083088,Eldon; John,21,0,100,79
1657362665528,CSE 175,A01,083665,Kumar; Rakesh,3,0,25,22
1657362671553,CSE 190,A00,092507,Dubnov; Shlomo,7,0,20,13
1657362677578,ECE 45,A01,083139,Congero; Spencer William,6,0,75,69
1657362683605,ECE 65,A50,083695,Saad; Andrew S,12,0,30,18
1657362683605,ECE 65,A51,095125,Saad; Andrew S,24,0,26,2
1657362689628,ECE 109,A01,091882,Touri; Behrouz,19,0,70,51
1657362695655,ECE 180,A00,083140,Abi Samra; Nicholas Camill,1,0,30,29
1657362695655,ECE 180,B00,083141,Abi Samra; Nicholas Camill,0,0,30,30
1657362701681,MATH 10A,A01,083735,Patchell; Gregory David,2,0,30,28
1657362701681,MATH 10A,A02,083736,Patchell; Gregory David,20,0,30,10
1657362701681,MATH 10A,A03,083737,Patchell; Gregory David,16,0,30,14
1657362707710,MATH 10B,A01,083207,Lim; Seonhee,8,0,34,26
1657362707710,MATH 10B,A02,083208,Lim; Seonhee,9,0,35,26
1657362707710,MATH 10B,A03,093472,Lim; Seonhee,7,0,34,27
1657362707710,MATH 10B,B01,083739,Sinha; Shubham,12,0,30,18
1657362713741,MATH 18,A01,083743,Cinel; Cameron Alexander,7,0,30,23
1657362713741,MATH 18,A02,083744,Cinel; Cameron Alexander,17,0,30,13
1657362713741,MATH 18,A03,083745,Cinel; Cameron Alexander,9,0,30,21
1657362713741,MATH 18,B01,083748,Rideout; David Porter,5,0,37,32
1657362713741,MATH 18,B02,083749,Rideout; David Porter,5,0,36,31
1657362713741,MATH 18,B03,083750,Rideout; David Porter,3,0,37,34
1657362713741,MATH 18,B04,083751,Rideout; David Porter,6,0,36,30
1657362713741,MATH 18,B05,093473,Rideout; David Porter,6,0,36,30
1657362713741,MATH 18,B06,093474,Rideout; David Porter,6,0,36,30
1657362719774,MATH 20A,A01,083754,Zheng; Zequn,14,0,40,26
1657362725799,MATH 20B,A01,083756,Briones; Jor-el Thomas Caparas,4,0,36,32
1657362725799,MATH 20B,A02,083757,Briones; Jor-el Thomas Caparas,1,0,36,35
1657362725799,MATH 20B,A03,093475,Briones; Jor-el Thomas Caparas,2,0,36,34
1657362731830,MATH 20C,A01,083760,Briones; Jor-el Thomas Caparas,1,0,35,34
1657362731830,MATH 20C,A02,083761,Briones; Jor-el Thomas Caparas,8,0,35,27
1657362731830,MATH 20C,A03,093476,Briones; Jor-el Thomas Caparas,0,1,36,36
1657362731830,MATH 20C,B01,083762,Bach; Quang Tran,1,0,30,29
1657362737853,MATH 20D,A01,083765,Tran; Brian Kha,5,0,30,25
1657362737853,MATH 20D,A02,083766,Tran; Brian Kha,5,0,30,25
1657362737853,MATH 20D,A03,083767,Tran; Brian Kha,5,0,30,25
1657362743877,MATH 20E,A01,083771,Ganguly; Soumya,9,0,32,23
1657362743877,MATH 20E,A02,083772,Ganguly; Soumya,6,0,32,26
1657362743877,MATH 20E,B01,083773,Ciotti; Benjamin,20,0,35,15
1657362743877,MATH 20E,B02,083774,Ciotti; Benjamin,17,0,35,18
1657362749907,MATH 103A,A01,083777,Greenfeld; Be'Eri,3,0,36,33
1657362749907,MATH 103A,A02,083778,Greenfeld; Be'Eri,5,0,36,31
1657362749907,MATH 103A,A03,093561,Greenfeld; Be'Eri,5,0,36,31
1657362749907,MATH 103A,B01,083779,Greenfeld; Be'Eri,7,0,36,29
1657362749907,MATH 103A,B02,083780,Greenfeld; Be'Eri,4,0,36,32
1657362749907,MATH 103A,B03,093562,Greenfeld; Be'Eri,3,0,36,33
1657362755945,MATH 105,A01,085443,Carter; Anne Toulson,15,0,35,20
1657362755945,MATH 105,A02,093477,Carter; Anne Toulson,20,0,35,15
1657362761970,MATH 109,A01,083213,Ganzberger; Geoffrey Michael,2,0,34,32
1657362761970,MATH 109,A02,083214,Ganzberger; Geoffrey Michael,4,0,34,30
1657362761970,MATH 109,A03,093478,Ganzberger; Geoffrey Michael,2,0,34,32
1657362761970,MATH 109,B01,083215,Ganzberger; Geoffrey Michael,1,0,32,31
1657362761970,MATH 109,B02,083216,Ganzberger; Geoffrey Michael,2,0,32,30
1657362761970,MATH 109,B03,093479,Ganzberger; Geoffrey Michael,8,0,32,24
1657362767994,MATH 142A,A01,083219,Chow; Bennett,7,0,32,25
1657362767994,MATH 142A,A02,083220,Chow; Bennett,10,0,32,22
1657362767994,MATH 142A,A03,093480,Chow; Bennett,8,0,32,24
1657362767994,MATH 142A,B03,093481,Chow; Bennett,8,0,32,24
1657362767994,MATH 142A,B04,093558,Chow; Bennett,13,0,32,19
1657362767994,MATH 142A,B05,093559,Chow; Bennett,6,0,32,26
1657362774021,MATH 193A,A01,083224,Rotar; Vladimir,8,0,34,26
1657362774021,MATH 193A,A02,083225,Rotar; Vladimir,9,0,34,25
1657362774021,MATH 193A,A03,083781,Rotar; Vladimir,5,0,34,29
1657362774021,MATH 193A,A04,083782,Rotar; Vladimir,10,0,34,24
1657362774021,MATH 193A,A05,093482,Rotar; Vladimir,10,0,34,24
1657362780047,MATH 197,001,091859,McAuley; Julian John,9999,0,9999,0
1657362780047,MATH 197,002,095566,Kedlaya; Kiran S.,9997,0,9999,2
1657362780047,MATH 197,003,095567,Xiao; Ming,9999,0,9999,0
1657362780047,MATH 197,004,095571,Perols; Johan Lars,9998,0,9999,1
1657362787109,COGS 9,A01,083615,Shannon; Kyle Michael,8,0,75,67
1657362793134,COGS 11,A01,083617,Boyle; Mary E. T.,22,0,48,26
1657362809580,COGS 13,A01,083071,Bastos; Amalia Pinkusfeld,11,0,71,60
1657362815608,COGS 14A,A01,092681,Semenuks; Arturs,4,1,100,96
1657362821636,COGS 14B,A01,083073,Cheng; Tzu-Han,6,0,63,57
1657362827660,COGS 17,A01,092677,Semenuks; Arturs,6,0,81,75
1657362833683,COGS 100,A01,083619,Allen; Michael Gordon,17,0,70,53
1657362839707,COGS 101A,A01,083621,Davis; Joshua Daniel,9,0,68,59
1657362845730,COGS 101B,A01,091572,Allen; Michael Gordon,11,0,65,54
1657362851753,COGS 101C,A01,083625,Delgado; Tania,17,0,35,18
1657362857776,COGS 107A,A01,083627,Boyle; Mary E. T.,13,0,60,47
1657362863804,COGS 118A,A01,083075,Gupta; Anjum,20,0,76,56
1657362869826,CSE 3,A50,083646,Miranda; Gregory Joseph,24,0,50,26
1657362875854,CSE 8A,A50,083650,Miranda; Gregory Joseph,17,1,56,39
1657362881879,CSE 11,A01,083080,Cao; Yingjun,6,15,40,34
1657362887905,CSE 12,A01,083652,Krause-Levy; Sophia Louisa,28,1,120,92
1657362893928,CSE 15L,A01,083654,Morris; Justin Loren,9,0,50,41
1657362893928,CSE 15L,A02,083655,Morris; Justin Loren,9,0,50,41
1657362899952,CSE 20,A01,083657,Tran; Khoa Dang,39,0,80,41
1657362905974,CSE 21,A01,095574,Bach; Quang Tran,22,0,48,26
1657362911996,CSE 30,A01,083084,Eldon; John,4,0,80,76
1657362911996,CSE 30,B01,095061,Bhaskar; Nishant,9,0,50,41
1657362918018,CSE 100,A01,083659,Cao; Yingjun,5,4,70,65
1657362924045,CSE 134B,A01,083661,Powell; Thomas Allan,22,0,100,78
1657362930071,CSE 140,A01,083663,Gungor; Onat,14,0,85,71
1657362936098,CSE 140L,A01,083088,Eldon; John,21,0,100,79
1657362942120,CSE 175,A01,083665,Kumar; Rakesh,3,0,25,22
1657362948147,CSE 190,A00,092507,Dubnov; Shlomo,7,0,20,13
1657362954170,ECE 45,A01,083139,Congero; Spencer William,6,0,75,69
1657362960202,ECE 65,A50,083695,Saad; Andrew S,12,0,30,18
1657362960202,ECE 65,A51,095125,Saad; Andrew S,24,0,26,2
1657362966224,ECE 109,A01,091882,Touri; Behrouz,19,0,70,51
1657362972247,ECE 180,A00,083140,Abi Samra; Nicholas Camill,1,0,30,29
1657362972247,ECE 180,B00,083141,Abi Samra; Nicholas Camill,0,0,30,30
1657362978271,MATH 10A,A01,083735,Patchell; Gregory David,2,0,30,28
1657362978271,MATH 10A,A02,083736,Patchell; Gregory David,20,0,30,10
1657362978271,MATH 10A,A03,083737,Patchell; Gregory David,16,0,30,14
1657362984323,MATH 10B,A01,083207,Lim; Seonhee,8,0,34,26
1657362984323,MATH 10B,A02,083208,Lim; Seonhee,9,0,35,26
1657362984323,MATH 10B,A03,093472,Lim; Seonhee,7,0,34,27
1657362984323,MATH 10B,B01,083739,Sinha; Shubham,12,0,30,18
1657362990352,MATH 18,A01,083743,Cinel; Cameron Alexander,7,0,30,23
1657362990352,MATH 18,A02,083744,Cinel; Cameron Alexander,17,0,30,13
1657362990352,MATH 18,A03,083745,Cinel; Cameron Alexander,9,0,30,21
1657362990352,MATH 18,B01,083748,Rideout; David Porter,5,0,37,32
1657362990352,MATH 18,B02,083749,Rideout; David Porter,5,0,36,31
1657362990352,MATH 18,B03,083750,Rideout; David Porter,3,0,37,34
1657362990352,MATH 18,B04,083751,Rideout; David Porter,6,0,36,30
1657362990352,MATH 18,B05,093473,Rideout; David Porter,6,0,36,30
1657362990352,MATH 18,B06,093474,Rideout; David Porter,6,0,36,30
1657362996374,MATH 20A,A01,083754,Zheng; Zequn,14,0,40,26
1657363002400,MATH 20B,A01,083756,Briones; Jor-el Thomas Caparas,4,0,36,32
1657363002400,MATH 20B,A02,083757,Briones; Jor-el Thomas Caparas,1,0,36,35
1657363002400,MATH 20B,A03,093475,Briones; Jor-el Thomas Caparas,2,0,36,34
1657363008440,MATH 20C,A01,083760,Briones; Jor-el Thomas Caparas,1,0,35,34
1657363008440,MATH 20C,A02,083761,Briones; Jor-el Thomas Caparas,8,0,35,27
1657363008440,MATH 20C,A03,093476,Briones; Jor-el Thomas Caparas,0,1,36,36
1657363008440,MATH 20C,B01,083762,Bach; Quang Tran,1,0,30,29
1657363014467,MATH 20D,A01,083765,Tran; Brian Kha,5,0,30,25
1657363014467,MATH 20D,A02,083766,Tran; Brian Kha,5,0,30,25
1657363014467,MATH 20D,A03,083767,Tran; Brian Kha,5,0,30,25
1657363020499,MATH 20E,A01,083771,Ganguly; Soumya,9,0,32,23
1657363020499,MATH 20E,A02,083772,Ganguly; Soumya,6,0,32,26
1657363020499,MATH 20E,B01,083773,Ciotti; Benjamin,20,0,35,15
1657363020499,MATH 20E,B02,083774,Ciotti; Benjamin,17,0,35,18
1657363026525,MATH 103A,A01,083777,Greenfeld; Be'Eri,3,0,36,33
1657363026525,MATH 103A,A02,083778,Greenfeld; Be'Eri,5,0,36,31
1657363026525,MATH 103A,A03,093561,Greenfeld; Be'Eri,5,0,36,31
1657363026525,MATH 103A,B01,083779,Greenfeld; Be'Eri,7,0,36,29
1657363026525,MATH 103A,B02,083780,Greenfeld; Be'Eri,4,0,36,32
1657363026525,MATH 103A,B03,093562,Greenfeld; Be'Eri,3,0,36,33
1657363032553,MATH 105,A01,085443,Carter; Anne Toulson,15,0,35,20
1657363032553,MATH 105,A02,093477,Carter; Anne Toulson,20,0,35,15
1657363038578,MATH 109,A01,083213,Ganzberger; Geoffrey Michael,2,0,34,32
1657363038578,MATH 109,A02,083214,Ganzberger; Geoffrey Michael,4,0,34,30
1657363038578,MATH 109,A03,093478,Ganzberger; Geoffrey Michael,2,0,34,32
1657363038578,MATH 109,B01,083215,Ganzberger; Geoffrey Michael,1,0,32,31
1657363038578,MATH 109,B02,083216,Ganzberger; Geoffrey Michael,2,0,32,30
1657363038578,MATH 109,B03,093479,Ganzberger; Geoffrey Michael,8,0,32,24
1657363044612,MATH 142A,A01,083219,Chow; Bennett,7,0,32,25
1657363044612,MATH 142A,A02,083220,Chow; Bennett,10,0,32,22
1657363044612,MATH 142A,A03,093480,Chow; Bennett,8,0,32,24
1657363044612,MATH 142A,B03,093481,Chow; Bennett,8,0,32,24
1657363044612,MATH 142A,B04,093558,Chow; Bennett,13,0,32,19
1657363044612,MATH 142A,B05,093559,Chow; Bennett,6,0,32,26
1657363050638,MATH 193A,A01,083224,Rotar; Vladimir,8,0,34,26
1657363050638,MATH 193A,A02,083225,Rotar; Vladimir,9,0,34,25
1657363050638,MATH 193A,A03,083781,Rotar; Vladimir,5,0,34,29
1657363050638,MATH 193A,A04,083782,Rotar; Vladimir,10,0,34,24
1657363050638,MATH 193A,A05,093482,Rotar; Vladimir,10,0,34,24
1657363056668,MATH 197,001,091859,McAuley; Julian John,9999,0,9999,0
1657363056668,MATH 197,002,095566,Kedlaya; Kiran S.,9997,0,9999,2
1657363056668,MATH 197,003,095567,Xiao; Ming,9999,0,9999,0
1657363056668,MATH 197,004,095571,Perols; Johan Lars,9998,0,9999,1
1657363063742,COGS 9,A01,083615,Shannon; Kyle Michael,8,0,75,67
1657363069772,COGS 11,A01,083617,Boyle; Mary E. T.,22,0,48,26
1657363075799,COGS 13,A01,083071,Bastos; Amalia Pinkusfeld,11,0,71,60
1657363081823,COGS 14A,A01,092681,Semenuks; Arturs,4,1,100,96
1657363087859,COGS 14B,A01,083073,Cheng; Tzu-Han,6,0,63,57
1657363093882,COGS 17,A01,092677,Semenuks; Arturs,6,0,81,75
1657363099906,COGS 100,A01,083619,Allen; Michael Gordon,17,0,70,53
1657363105933,COGS 101A,A01,083621,Davis; Joshua Daniel,9,0,68,59
1657363111961,COGS 101B,A01,091572,Allen; Michael Gordon,11,0,65,54
1657363117997,COGS 101C,A01,083625,Delgado; Tania,17,0,35,18
1657363124022,COGS 107A,A01,083627,Boyle; Mary E. T.,13,0,60,47
1657363130052,COGS 118A,A01,083075,Gupta; Anjum,20,0,76,56
1657363136091,CSE 3,A50,083646,Miranda; Gregory Joseph,24,0,50,26
1657363142124,CSE 8A,A50,083650,Miranda; Gregory Joseph,17,1,56,39
1657363148154,CSE 11,A01,083080,Cao; Yingjun,6,15,40,34
1657363154180,CSE 12,A01,083652,Krause-Levy; Sophia Louisa,28,1,120,92
1657363160208,CSE 15L,A01,083654,Morris; Justin Loren,9,0,50,41
1657363160208,CSE 15L,A02,083655,Morris; Justin Loren,9,0,50,41
1657363166301,CSE 20,A01,083657,Tran; Khoa Dang,39,0,80,41
1657363172329,CSE 21,A01,095574,Bach; Quang Tran,22,0,48,26
1657363178352,CSE 30,A01,083084,Eldon; John,4,0,80,76
1657363178352,CSE 30,B01,095061,Bhaskar; Nishant,9,0,50,41
1657363184379,CSE 100,A01,083659,Cao; Yingjun,5,4,70,65
1657363190403,CSE 134B,A01,083661,Powell; Thomas Allan,22,0,100,78
1657363196430,CSE 140,A01,083663,Gungor; Onat,14,0,85,71
1657363202458,CSE 140L,A01,083088,Eldon; John,21,0,100,79
1657363208488,CSE 175,A01,083665,Kumar; Rakesh,3,0,25,22
1657363214515,CSE 190,A00,092507,Dubnov; Shlomo,7,0,20,13
1657363220546,ECE 45,A01,083139,Congero; Spencer William,6,0,75,69
1657363226577,ECE 65,A50,083695,Saad; Andrew S,12,0,30,18
1657363226577,ECE 65,A51,095125,Saad; Andrew S,24,0,26,2
1657363232603,ECE 109,A01,091882,Touri; Behrouz,19,0,70,51
1657363238630,ECE 180,A00,083140,Abi Samra; Nicholas Camill,1,0,30,29
1657363238630,ECE 180,B00,083141,Abi Samra; Nicholas Camill,0,0,30,30
1657363244661,MATH 10A,A01,083735,Patchell; Gregory David,2,0,30,28
1657363244661,MATH 10A,A02,083736,Patchell; Gregory David,20,0,30,10
1657363244661,MATH 10A,A03,083737,Patchell; Gregory David,16,0,30,14
1657363250686,MATH 10B,A01,083207,Lim; Seonhee,8,0,34,26
1657363250686,MATH 10B,A02,083208,Lim; Seonhee,9,0,35,26
1657363250686,MATH 10B,A03,093472,Lim; Seonhee,7,0,34,27
1657363250686,MATH 10B,B01,083739,Sinha; Shubham,12,0,30,18
1657363256715,MATH 18,A01,083743,Cinel; Cameron Alexander,7,0,30,23
1657363256715,MATH 18,A02,083744,Cinel; Cameron Alexander,17,0,30,13
1657363256715,MATH 18,A03,083745,Cinel; Cameron Alexander,9,0,30,21
1657363256715,MATH 18,B01,083748,Rideout; David Porter,5,0,37,32
1657363256715,MATH 18,B02,083749,Rideout; David Porter,5,0,36,31
1657363256715,MATH 18,B03,083750,Rideout; David Porter,3,0,37,34
1657363256715,MATH 18,B04,083751,Rideout; David Porter,6,0,36,30
1657363256715,MATH 18,B05,093473,Rideout; David Porter,6,0,36,30
1657363256715,MATH 18,B06,093474,Rideout; David Porter,6,0,36,30
1657363262740,MATH 20A,A01,083754,Zheng; Zequn,14,0,40,26
1657363268763,MATH 20B,A01,083756,Briones; Jor-el Thomas Caparas,4,0,36,32
1657363268763,MATH 20B,A02,083757,Briones; Jor-el Thomas Caparas,1,0,36,35
1657363268763,MATH 20B,A03,093475,Briones; Jor-el Thomas Caparas,2,0,36,34
1657363274801,MATH 20C,A01,083760,Briones; Jor-el Thomas Caparas,1,0,35,34
1657363274801,MATH 20C,A02,083761,Briones; Jor-el Thomas Caparas,8,0,35,27
1657363274801,MATH 20C,A03,093476,Briones; Jor-el Thomas Caparas,0,1,36,36
1657363274801,MATH 20C,B01,083762,Bach; Quang Tran,1,0,30,29
1657363280825,MATH 20D,A01,083765,Tran; Brian Kha,5,0,30,25
1657363280825,MATH 20D,A02,083766,Tran; Brian Kha,5,0,30,25
1657363280825,MATH 20D,A03,083767,Tran; Brian Kha,5,0,30,25
1657363286858,MATH 20E,A01,083771,Ganguly; Soumya,9,0,32,23
1657363286858,MATH 20E,A02,083772,Ganguly; Soumya,6,0,32,26
1657363286858,MATH 20E,B01,083773,Ciotti; Benjamin,20,0,35,15
1657363286858,MATH 20E,B02,083774,Ciotti; Benjamin,17,0,35,18
1657363292892,MATH 103A,A01,083777,Greenfeld; Be'Eri,3,0,36,33
1657363292892,MATH 103A,A02,083778,Greenfeld; Be'Eri,5,0,36,31
1657363292892,MATH 103A,A03,093561,Greenfeld; Be'Eri,5,0,36,31
1657363292892,MATH 103A,B01,083779,Greenfeld; Be'Eri,7,0,36,29
1657363292892,MATH 103A,B02,083780,Greenfeld; Be'Eri,4,0,36,32
1657363292892,MATH 103A,B03,093562,Greenfeld; Be'Eri,3,0,36,33
1657363298921,MATH 105,A01,085443,Carter; Anne Toulson,15,0,35,20
1657363298921,MATH 105,A02,093477,Carter; Anne Toulson,20,0,35,15
1657363304950,MATH 109,A01,083213,Ganzberger; Geoffrey Michael,2,0,34,32
1657363304950,MATH 109,A02,083214,Ganzberger; Geoffrey Michael,4,0,34,30
1657363304950,MATH 109,A03,093478,Ganzberger; Geoffrey Michael,2,0,34,32
1657363304950,MATH 109,B01,083215,Ganzberger; Geoffrey Michael,1,0,32,31
1657363304950,MATH 109,B02,083216,Ganzberger; Geoffrey Michael,2,0,32,30
1657363304950,MATH 109,B03,093479,Ganzberger; Geoffrey Michael,8,0,32,24
1657363310982,MATH 142A,A01,083219,Chow; Bennett,7,0,32,25
1657363310982,MATH 142A,A02,083220,Chow; Bennett,10,0,32,22
1657363310982,MATH 142A,A03,093480,Chow; Bennett,8,0,32,24
1657363310982,MATH 142A,B03,093481,Chow; Bennett,8,0,32,24
1657363310982,MATH 142A,B04,093558,Chow; Bennett,13,0,32,19
1657363310982,MATH 142A,B05,093559,Chow; Bennett,6,0,32,26
1657363317012,MATH 193A,A01,083224,Rotar; Vladimir,8,0,34,26
1657363317012,MATH 193A,A02,083225,Rotar; Vladimir,9,0,34,25
1657363317012,MATH 193A,A03,083781,Rotar; Vladimir,5,0,34,29
1657363317012,MATH 193A,A04,083782,Rotar; Vladimir,10,0,34,24
1657363317012,MATH 193A,A05,093482,Rotar; Vladimir,10,0,34,24
1657363323038,MATH 197,001,091859,McAuley; Julian John,9999,0,9999,0
1657363323038,MATH 197,002,095566,Kedlaya; Kiran S.,9997,0,9999,2
1657363323038,MATH 197,003,095567,Xiao; Ming,9999,0,9999,0
1657363323038,MATH 197,004,095571,Perols; Johan Lars,9998,0,9999,1
1657363330126,COGS 9,A01,083615,Shannon; Kyle Michael,8,0,75,67
1657363336158,COGS 11,A01,083617,Boyle; Mary E. T.,22,0,48,26
1657363342190,COGS 13,A01,083071,Bastos; Amalia Pinkusfeld,11,0,71,60
1657363348220,COGS 14A,A01,092681,Semenuks; Arturs,4,1,100,96
1657363354252,COGS 14B,A01,083073,Cheng; Tzu-Han,6,0,63,57
1657363360274,COGS 17,A01,092677,Semenuks; Arturs,6,0,81,75
1657363366299,COGS 100,A01,083619,Allen; Michael Gordon,17,0,70,53
1657363372325,COGS 101A,A01,083621,Davis; Joshua Daniel,9,0,68,59
1657363378353,COGS 101B,A01,091572,Allen; Michael Gordon,11,0,65,54
1657363384384,COGS 101C,A01,083625,Delgado; Tania,17,0,35,18
1657363390407,COGS 107A,A01,083627,Boyle; Mary E. T.,13,0,60,47
1657363396431,COGS 118A,A01,083075,Gupta; Anjum,20,0,76,56
1657363402457,CSE 3,A50,083646,Miranda; Gregory Joseph,24,0,50,26
1657363408493,CSE 8A,A50,083650,Miranda; Gregory Joseph,17,1,56,39
1657363414516,CSE 11,A01,083080,Cao; Yingjun,6,15,40,34
1657363420540,CSE 12,A01,083652,Krause-Levy; Sophia Louisa,28,1,120,92
1657363426564,CSE 15L,A01,083654,Morris; Justin Loren,9,0,50,41
1657363426564,CSE 15L,A02,083655,Morris; Justin Loren,9,0,50,41
1657363432588,CSE 20,A01,083657,Tran; Khoa Dang,39,0,80,41
1657363438626,CSE 21,A01,095574,Bach; Quang Tran,22,0,48,26
1657363444658,CSE 30,A01,083084,Eldon; John,4,0,80,76
1657363444658,CSE 30,B01,095061,Bhaskar; Nishant,9,0,50,41
1657363450687,CSE 100,A01,083659,Cao; Yingjun,5,4,70,65
1657363456711,CSE 134B,A01,083661,Powell; Thomas Allan,22,0,100,78
1657363462739,CSE 140,A01,083663,Gungor; Onat,14,0,85,71
1657363468760,CSE 140L,A01,083088,Eldon; John,21,0,100,79
1657363474784,CSE 175,A01,083665,Kumar; Rakesh,3,0,25,22
1657363480813,CSE 190,A00,092507,Dubnov; Shlomo,7,0,20,13
1657363486837,ECE 45,A01,083139,Congero; Spencer William,6,0,75,69
1657363492874,ECE 65,A50,083695,Saad; Andrew S,12,0,30,18
1657363492874,ECE 65,A51,095125,Saad; Andrew S,24,0,26,2
1657363498908,ECE 109,A01,091882,Touri; Behrouz,19,0,70,51
1657363504932,ECE 180,A00,083140,Abi Samra; Nicholas Camill,1,0,30,29
1657363504932,ECE 180,B00,083141,Abi Samra; Nicholas Camill,0,0,30,30
1657363510957,MATH 10A,A01,083735,Patchell; Gregory David,2,0,30,28
1657363510957,MATH 10A,A02,083736,Patchell; Gregory David,20,0,30,10
1657363510957,MATH 10A,A03,083737,Patchell; Gregory David,16,0,30,14
1657363516994,MATH 10B,A01,083207,Lim; Seonhee,8,0,34,26
1657363516994,MATH 10B,A02,083208,Lim; Seonhee,9,0,35,26
1657363516994,MATH 10B,A03,093472,Lim; Seonhee,7,0,34,27
1657363516994,MATH 10B,B01,083739,Sinha; Shubham,12,0,30,18
1657363523022,MATH 18,A01,083743,Cinel; Cameron Alexander,7,0,30,23
1657363523022,MATH 18,A02,083744,Cinel; Cameron Alexander,17,0,30,13
1657363523022,MATH 18,A03,083745,Cinel; Cameron Alexander,9,0,30,21
1657363523022,MATH 18,B01,083748,Rideout; David Porter,5,0,37,32
1657363523022,MATH 18,B02,083749,Rideout; David Porter,5,0,36,31
1657363523022,MATH 18,B03,083750,Rideout; David Porter,3,0,37,34
1657363523022,MATH 18,B04,083751,Rideout; David Porter,6,0,36,30
1657363523022,MATH 18,B05,093473,Rideout; David Porter,6,0,36,30
1657363523022,MATH 18,B06,093474,Rideout; David Porter,6,0,36,30
1657363529055,MATH 20A,A01,083754,Zheng; Zequn,14,0,40,26
1657363535088,MATH 20B,A01,083756,Briones; Jor-el Thomas Caparas,4,0,36,32
1657363535088,MATH 20B,A02,083757,Briones; Jor-el Thomas Caparas,1,0,36,35
1657363535088,MATH 20B,A03,093475,Briones; Jor-el Thomas Caparas,2,0,36,34
1657363541126,MATH 20C,A01,083760,Briones; Jor-el Thomas Caparas,1,0,35,34
1657363541126,MATH 20C,A02,083761,Briones; Jor-el Thomas Caparas,8,0,35,27
1657363541126,MATH 20C,A03,093476,Briones; Jor-el Thomas Caparas,0,1,36,36
1657363541126,MATH 20C,B01,083762,Bach; Quang Tran,1,0,30,29
1657363547152,MATH 20D,A01,083765,Tran; Brian Kha,5,0,30,25
1657363547152,MATH 20D,A02,083766,Tran; Brian Kha,5,0,30,25
1657363547152,MATH 20D,A03,083767,Tran; Brian Kha,5,0,30,25
1657363553185,MATH 20E,A01,083771,Ganguly; Soumya,9,0,32,23
1657363553185,MATH 20E,A02,083772,Ganguly; Soumya,6,0,32,26
1657363553185,MATH 20E,B01,083773,Ciotti; Benjamin,20,0,35,15
1657363553185,MATH 20E,B02,083774,Ciotti; Benjamin,17,0,35,18
1657363559211,MATH 103A,A01,083777,Greenfeld; Be'Eri,3,0,36,33
1657363559211,MATH 103A,A02,083778,Greenfeld; Be'Eri,5,0,36,31
1657363559211,MATH 103A,A03,093561,Greenfeld; Be'Eri,5,0,36,31
1657363559211,MATH 103A,B01,083779,Greenfeld; Be'Eri,7,0,36,29
1657363559211,MATH 103A,B02,083780,Greenfeld; Be'Eri,4,0,36,32
1657363559211,MATH 103A,B03,093562,Greenfeld; Be'Eri,3,0,36,33
1657363565247,MATH 105,A01,085443,Carter; Anne Toulson,15,0,35,20
1657363565247,MATH 105,A02,093477,Carter; Anne Toulson,20,0,35,15
1657363571272,MATH 109,A01,083213,Ganzberger; Geoffrey Michael,2,0,34,32
1657363571272,MATH 109,A02,083214,Ganzberger; Geoffrey Michael,4,0,34,30
1657363571272,MATH 109,A03,093478,Ganzberger; Geoffrey Michael,2,0,34,32
1657363571272,MATH 109,B01,083215,Ganzberger; Geoffrey Michael,1,0,32,31
1657363571272,MATH 109,B02,083216,Ganzberger; Geoffrey Michael,2,0,32,30
1657363571272,MATH 109,B03,093479,Ganzberger; Geoffrey Michael,8,0,32,24
1657363577299,MATH 142A,A01,083219,Chow; Bennett,7,0,32,25
1657363577299,MATH 142A,A02,083220,Chow; Bennett,10,0,32,22
1657363577299,MATH 142A,A03,093480,Chow; Bennett,8,0,32,24
1657363577299,MATH 142A,B03,093481,Chow; Bennett,8,0,32,24
1657363577299,MATH 142A,B04,093558,Chow; Bennett,13,0,32,19
1657363577299,MATH 142A,B05,093559,Chow; Bennett,6,0,32,26
1657363583324,MATH 193A,A01,083224,Rotar; Vladimir,8,0,34,26
1657363583324,MATH 193A,A02,083225,Rotar; Vladimir,9,0,34,25
1657363583324,MATH 193A,A03,083781,Rotar; Vladimir,5,0,34,29
1657363583324,MATH 193A,A04,083782,Rotar; Vladimir,10,0,34,24
1657363583324,MATH 193A,A05,093482,Rotar; Vladimir,10,0,34,24
1657363589353,MATH 197,001,091859,McAuley; Julian John,9999,0,9999,0
1657363589353,MATH 197,002,095566,Kedlaya; Kiran S.,9997,0,9999,2
1657363589353,MATH 197,003,095567,Xiao; Ming,9999,0,9999,0
1657363589353,MATH 197,004,095571,Perols; Johan Lars,9998,0,9999,1
1657363596422,COGS 9,A01,083615,Shannon; Kyle Michael,8,0,75,67
1657363602461,COGS 11,A01,083617,Boyle; Mary E. T.,22,0,48,26
1657363608485,COGS 13,A01,083071,Bastos; Amalia Pinkusfeld,11,0,71,60
1657363614513,COGS 14A,A01,092681,Semenuks; Arturs,4,1,100,96
1657363620538,COGS 14B,A01,083073,Cheng; Tzu-Han,6,0,63,57
1657363626560,COGS 17,A01,092677,Semenuks; Arturs,6,0,81,75
1657363632587,COGS 100,A01,083619,Allen; Michael Gordon,17,0,70,53
1657363638623,COGS 101A,A01,083621,Davis; Joshua Daniel,9,0,68,59
1657363644647,COGS 101B,A01,091572,Allen; Michael Gordon,11,0,65,54
1657363650671,COGS 101C,A01,083625,Delgado; Tania,17,0,35,18
1657363656698,COGS 107A,A01,083627,Boyle; Mary E. T.,13,0,60,47
1657363662719,COGS 118A,A01,083075,Gupta; Anjum,20,0,76,56
1657363668744,CSE 3,A50,083646,Miranda; Gregory Joseph,24,0,50,26
1657363674768,CSE 8A,A50,083650,Miranda; Gregory Joseph,17,1,56,39
1657363680800,CSE 11,A01,083080,Cao; Yingjun,6,15,40,34
1657363686824,CSE 12,A01,083652,Krause-Levy; Sophia Louisa,28,1,120,92
1657363692852,CSE 15L,A01,083654,Morris; Justin Loren,9,0,50,41
1657363692852,CSE 15L,A02,083655,Morris; Justin Loren,9,0,50,41
1657363698881,CSE 20,A01,083657,Tran; Khoa Dang,39,0,80,41
1657363704906,CSE 21,A01,095574,Bach; Quang Tran,22,0,48,26
1657363710930,CSE 30,A01,083084,Eldon; John,4,0,80,76
1657363710930,CSE 30,B01,095061,Bhaskar; Nishant,9,0,50,41
1657363716954,CSE 100,A01,083659,Cao; Yingjun,5,4,70,65
1657363722978,CSE 134B,A01,083661,Powell; Thomas Allan,22,0,100,78
1657363729001,CSE 140,A01,083663,Gungor; Onat,14,0,85,71
1657363735025,CSE 140L,A01,083088,Eldon; John,21,0,100,79
1657363741056,CSE 175,A01,083665,Kumar; Rakesh,3,0,25,22
1657363747084,CSE 190,A00,092507,Dubnov; Shlomo,7,0,20,13
1657363753114,ECE 45,A01,083139,Congero; Spencer William,6,0,75,69
1657363759149,ECE 65,A50,083695,Saad; Andrew S,12,0,30,18
1657363759149,ECE 65,A51,095125,Saad; Andrew S,24,0,26,2
1657363765263,ECE 109,A01,091882,Touri; Behrouz,19,0,70,51
1657363771287,ECE 180,A00,083140,Abi Samra; Nicholas Camill,1,0,30,29
1657363771287,ECE 180,B00,083141,Abi Samra; Nicholas Camill,0,0,30,30
1657363777311,MATH 10A,A01,083735,Patchell; Gregory David,2,0,30,28
1657363777311,MATH 10A,A02,083736,Patchell; Gregory David,20,0,30,10
1657363777311,MATH 10A,A03,083737,Patchell; Gregory David,16,0,30,14
1657363783337,MATH 10B,A01,083207,Lim; Seonhee,8,0,34,26
1657363783337,MATH 10B,A02,083208,Lim; Seonhee,9,0,35,26
1657363783337,MATH 10B,A03,093472,Lim; Seonhee,7,0,34,27
1657363783337,MATH 10B,B01,083739,Sinha; Shubham,12,0,30,18
1657363789361,MATH 18,A01,083743,Cinel; Cameron Alexander,7,0,30,23
1657363789361,MATH 18,A02,083744,Cinel; Cameron Alexander,17,0,30,13
1657363789361,MATH 18,A03,083745,Cinel; Cameron Alexander,9,0,30,21
1657363789361,MATH 18,B01,083748,Rideout; David Porter,5,0,37,32
1657363789361,MATH 18,B02,083749,Rideout; David Porter,5,0,36,31
1657363789361,MATH 18,B03,083750,Rideout; David Porter,3,0,37,34
1657363789361,MATH 18,B04,083751,Rideout; David Porter,6,0,36,30
1657363789361,MATH 18,B05,093473,Rideout; David Porter,6,0,36,30
1657363789361,MATH 18,B06,093474,Rideout; David Porter,6,0,36,30
1657363795386,MATH 20A,A01,083754,Zheng; Zequn,14,0,40,26
1657363801414,MATH 20B,A01,083756,Briones; Jor-el Thomas Caparas,4,0,36,32
1657363801414,MATH 20B,A02,083757,Briones; Jor-el Thomas Caparas,1,0,36,35
1657363801414,MATH 20B,A03,093475,Briones; Jor-el Thomas Caparas,2,0,36,34
1657363807439,MATH 20C,A01,083760,Briones; Jor-el Thomas Caparas,1,0,35,34
1657363807439,MATH 20C,A02,083761,Briones; Jor-el Thomas Caparas,8,0,35,27
1657363807439,MATH 20C,A03,093476,Briones; Jor-el Thomas Caparas,0,1,36,36
1657363807439,MATH 20C,B01,083762,Bach; Quang Tran,1,0,30,29
1657363813464,MATH 20D,A01,083765,Tran; Brian Kha,5,0,30,25
1657363813464,MATH 20D,A02,083766,Tran; Brian Kha,5,0,30,25
1657363813464,MATH 20D,A03,083767,Tran; Brian Kha,5,0,30,25
1657363819490,MATH 20E,A01,083771,Ganguly; Soumya,9,0,32,23
1657363819490,MATH 20E,A02,083772,Ganguly; Soumya,6,0,32,26
1657363819490,MATH 20E,B01,083773,Ciotti; Benjamin,20,0,35,15
1657363819490,MATH 20E,B02,083774,Ciotti; Benjamin,17,0,35,18
1657363825525,MATH 103A,A01,083777,Greenfeld; Be'Eri,3,0,36,33
1657363825525,MATH 103A,A02,083778,Greenfeld; Be'Eri,5,0,36,31
1657363825525,MATH 103A,A03,093561,Greenfeld; Be'Eri,5,0,36,31
1657363825525,MATH 103A,B01,083779,Greenfeld; Be'Eri,7,0,36,29
1657363825525,MATH 103A,B02,083780,Greenfeld; Be'Eri,4,0,36,32
1657363825525,MATH 103A,B03,093562,Greenfeld; Be'Eri,3,0,36,33
1657363831549,MATH 105,A01,085443,Carter; Anne Toulson,15,0,35,20
1657363831549,MATH 105,A02,093477,Carter; Anne Toulson,20,0,35,15
1657363837574,MATH 109,A01,083213,Ganzberger; Geoffrey Michael,2,0,34,32
1657363837574,MATH 109,A02,083214,Ganzberger; Geoffrey Michael,4,0,34,30
1657363837574,MATH 109,A03,093478,Ganzberger; Geoffrey Michael,2,0,34,32
1657363837574,MATH 109,B01,083215,Ganzberger; Geoffrey Michael,1,0,32,31
1657363837574,MATH 109,B02,083216,Ganzberger; Geoffrey Michael,2,0,32,30
1657363837574,MATH 109,B03,093479,Ganzberger; Geoffrey Michael,8,0,32,24
1657363843608,MATH 142A,A01,083219,Chow; Bennett,7,0,32,25
1657363843608,MATH 142A,A02,083220,Chow; Bennett,10,0,32,22
1657363843608,MATH 142A,A03,093480,Chow; Bennett,8,0,32,24
1657363843608,MATH 142A,B03,093481,Chow; Bennett,8,0,32,24
1657363843608,MATH 142A,B04,093558,Chow; Bennett,13,0,32,19
1657363843608,MATH 142A,B05,093559,Chow; Bennett,6,0,32,26
1657363849632,MATH 193A,A01,083224,Rotar; Vladimir,8,0,34,26
1657363849632,MATH 193A,A02,083225,Rotar; Vladimir,9,0,34,25
1657363849632,MATH 193A,A03,083781,Rotar; Vladimir,5,0,34,29
1657363849632,MATH 193A,A04,083782,Rotar; Vladimir,10,0,34,24
1657363849632,MATH 193A,A05,093482,Rotar; Vladimir,10,0,34,24
1657363855660,MATH 197,001,091859,McAuley; Julian John,9999,0,9999,0
1657363855660,MATH 197,002,095566,Kedlaya; Kiran S.,9997,0,9999,2
1657363855660,MATH 197,003,095567,Xiao; Ming,9999,0,9999,0
1657363855660,MATH 197,004,095571,Perols; Johan Lars,9998,0,9999,1
1657363862724,COGS 9,A01,083615,Shannon; Kyle Michael,8,0,75,67
1657363868747,COGS 11,A01,083617,Boyle; Mary E. T.,22,0,48,26
1657363874772,COGS 13,A01,083071,Bastos; Amalia Pinkusfeld,11,0,71,60
1657363880798,COGS 14A,A01,092681,Semenuks; Arturs,4,1,100,96
1657363886820,COGS 14B,A01,083073,Cheng; Tzu-Han,6,0,63,57
1657363892845,COGS 17,A01,092677,Semenuks; Arturs,6,0,81,75
1657363898869,COGS 100,A01,083619,Allen; Michael Gordon,17,0,70,53
1657363904893,COGS 101A,A01,083621,Davis; Joshua Daniel,9,0,68,59
1657363910923,COGS 101B,A01,091572,Allen; Michael Gordon,11,0,65,54
1657363916948,COGS 101C,A01,083625,Delgado; Tania,17,0,35,18
1657363922975,COGS 107A,A01,083627,Boyle; Mary E. T.,13,0,60,47
1657363928999,COGS 118A,A01,083075,Gupta; Anjum,20,0,76,56
1657363935031,CSE 3,A50,083646,Miranda; Gregory Joseph,24,0,50,26
1657363941060,CSE 8A,A50,083650,Miranda; Gregory Joseph,17,1,56,39
1657363947086,CSE 11,A01,083080,Cao; Yingjun,6,15,40,34
1657363953110,CSE 12,A01,083652,Krause-Levy; Sophia Louisa,28,1,120,92
1657363959141,CSE 15L,A01,083654,Morris; Justin Loren,9,0,50,41
1657363959141,CSE 15L,A02,083655,Morris; Justin Loren,9,0,50,41
1657363965164,CSE 20,A01,083657,Tran; Khoa Dang,39,0,80,41
1657363971189,CSE 21,A01,095574,Bach; Quang Tran,22,0,48,26
1657363977217,CSE 30,A01,083084,Eldon; John,4,0,80,76
1657363977217,CSE 30,B01,095061,Bhaskar; Nishant,9,0,50,41
1657363983240,CSE 100,A01,083659,Cao; Yingjun,5,4,70,65
1657363989264,CSE 134B,A01,083661,Powell; Thomas Allan,22,0,100,78
1657363995291,CSE 140,A01,083663,Gungor; Onat,14,0,85,71
1657364001314,CSE 140L,A01,083088,Eldon; John,21,0,100,79
1657364007339,CSE 175,A01,083665,Kumar; Rakesh,3,0,25,22
1657364013369,CSE 190,A00,092507,Dubnov; Shlomo,7,0,20,13
1657364019396,ECE 45,A01,083139,Congero; Spencer William,6,0,75,69
1657364025427,ECE 65,A50,083695,Saad; Andrew S,12,0,30,18
1657364025427,ECE 65,A51,095125,Saad; Andrew S,24,0,26,2
1657364031449,ECE 109,A01,091882,Touri; Behrouz,19,0,70,51
1657364037478,ECE 180,A00,083140,Abi Samra; Nicholas Camill,1,0,30,29
1657364037478,ECE 180,B00,083141,Abi Samra; Nicholas Camill,0,0,30,30
1657364043513,MATH 10A,A01,083735,Patchell; Gregory David,2,0,30,28
1657364043513,MATH 10A,A02,083736,Patchell; Gregory David,20,0,30,10
1657364043513,MATH 10A,A03,083737,Patchell; Gregory David,16,0,30,14
1657364049545,MATH 10B,A01,083207,Lim; Seonhee,8,0,34,26
1657364049545,MATH 10B,A02,083208,Lim; Seonhee,9,0,35,26
1657364049545,MATH 10B,A03,093472,Lim; Seonhee,7,0,34,27
1657364049545,MATH 10B,B01,083739,Sinha; Shubham,12,0,30,18
1657364055586,MATH 18,A01,083743,Cinel; Cameron Alexander,7,0,30,23
1657364055586,MATH 18,A02,083744,Cinel; Cameron Alexander,17,0,30,13
1657364055586,MATH 18,A03,083745,Cinel; Cameron Alexander,9,0,30,21
1657364055586,MATH 18,B01,083748,Rideout; David Porter,5,0,37,32
1657364055586,MATH 18,B02,083749,Rideout; David Porter,5,0,36,31
1657364055586,MATH 18,B03,083750,Rideout; David Porter,3,0,37,34
1657364055586,MATH 18,B04,083751,Rideout; David Porter,6,0,36,30
1657364055586,MATH 18,B05,093473,Rideout; David Porter,6,0,36,30
1657364055586,MATH 18,B06,093474,Rideout; David Porter,6,0,36,30
1657364061609,MATH 20A,A01,083754,Zheng; Zequn,14,0,40,26
1657364067635,MATH 20B,A01,083756,Briones; Jor-el Thomas Caparas,4,0,36,32
1657364067635,MATH 20B,A02,083757,Briones; Jor-el Thomas Caparas,1,0,36,35
1657364067635,MATH 20B,A03,093475,Briones; Jor-el Thomas Caparas,2,0,36,34
1657364073668,MATH 20C,A01,083760,Briones; Jor-el Thomas Caparas,1,0,35,34
1657364073668,MATH 20C,A02,083761,Briones; Jor-el Thomas Caparas,8,0,35,27
1657364073668,MATH 20C,A03,093476,Briones; Jor-el Thomas Caparas,0,1,36,36
1657364073668,MATH 20C,B01,083762,Bach; Quang Tran,1,0,30,29
1657364079692,MATH 20D,A01,083765,Tran; Brian Kha,5,0,30,25
1657364079692,MATH 20D,A02,083766,Tran; Brian Kha,5,0,30,25
1657364079692,MATH 20D,A03,083767,Tran; Brian Kha,5,0,30,25
1657364085726,MATH 20E,A01,083771,Ganguly; Soumya,9,0,32,23
1657364085726,MATH 20E,A02,083772,Ganguly; Soumya,6,0,32,26
1657364085726,MATH 20E,B01,083773,Ciotti; Benjamin,20,0,35,15
1657364085726,MATH 20E,B02,083774,Ciotti; Benjamin,17,0,35,18
1657364091771,MATH 103A,A01,083777,Greenfeld; Be'Eri,3,0,36,33
1657364091771,MATH 103A,A02,083778,Greenfeld; Be'Eri,5,0,36,31
1657364091771,MATH 103A,A03,093561,Greenfeld; Be'Eri,5,0,36,31
1657364091771,MATH 103A,B01,083779,Greenfeld; Be'Eri,7,0,36,29
1657364091771,MATH 103A,B02,083780,Greenfeld; Be'Eri,4,0,36,32
1657364091771,MATH 103A,B03,093562,Greenfeld; Be'Eri,3,0,36,33
1657364097797,MATH 105,A01,085443,Carter; Anne Toulson,15,0,35,20
1657364097797,MATH 105,A02,093477,Carter; Anne Toulson,20,0,35,15
1657364103821,MATH 109,A01,083213,Ganzberger; Geoffrey Michael,2,0,34,32
1657364103821,MATH 109,A02,083214,Ganzberger; Geoffrey Michael,4,0,34,30
1657364103821,MATH 109,A03,093478,Ganzberger; Geoffrey Michael,2,0,34,32
1657364103821,MATH 109,B01,083215,Ganzberger; Geoffrey Michael,1,0,32,31
1657364103821,MATH 109,B02,083216,Ganzberger; Geoffrey Michael,2,0,32,30
1657364103821,MATH 109,B03,093479,Ganzberger; Geoffrey Michael,8,0,32,24
1657364109860,MATH 142A,A01,083219,Chow; Bennett,7,0,32,25
1657364109860,MATH 142A,A02,083220,Chow; Bennett,10,0,32,22
1657364109860,MATH 142A,A03,093480,Chow; Bennett,8,0,32,24
1657364109860,MATH 142A,B03,093481,Chow; Bennett,8,0,32,24
1657364109860,MATH 142A,B04,093558,Chow; Bennett,13,0,32,19
1657364109860,MATH 142A,B05,093559,Chow; Bennett,6,0,32,26
1657364115884,MATH 193A,A01,083224,Rotar; Vladimir,8,0,34,26
1657364115884,MATH 193A,A02,083225,Rotar; Vladimir,9,0,34,25
1657364115884,MATH 193A,A03,083781,Rotar; Vladimir,5,0,34,29
1657364115884,MATH 193A,A04,083782,Rotar; Vladimir,10,0,34,24
1657364115884,MATH 193A,A05,093482,Rotar; Vladimir,10,0,34,24
1657364121910,MATH 197,001,091859,McAuley; Julian John,9999,0,9999,0
1657364121910,MATH 197,002,095566,Kedlaya; Kiran S.,9997,0,9999,2
1657364121910,MATH 197,003,095567,Xiao; Ming,9999,0,9999,0
1657364121910,MATH 197,004,095571,Perols; Johan Lars,9998,0,9999,1
1657364128981,COGS 9,A01,083615,Shannon; Kyle Michael,8,0,75,67
1657364135009,COGS 11,A01,083617,Boyle; Mary E. T.,22,0,48,26
1657364141040,COGS 13,A01,083071,Bastos; Amalia Pinkusfeld,11,0,71,60
1657364147062,COGS 14A,A01,092681,Semenuks; Arturs,4,1,100,96
1657364153091,COGS 14B,A01,083073,Cheng; Tzu-Han,6,0,63,57
1657364159131,COGS 17,A01,092677,Semenuks; Arturs,6,0,81,75
1657364165155,COGS 100,A01,083619,Allen; Michael Gordon,17,0,70,53
1657364171188,COGS 101A,A01,083621,Davis; Joshua Daniel,9,0,68,59
1657364177210,COGS 101B,A01,091572,Allen; Michael Gordon,11,0,65,54
1657364183236,COGS 101C,A01,083625,Delgado; Tania,17,0,35,18
1657364189258,COGS 107A,A01,083627,Boyle; Mary E. T.,13,0,60,47
1657364195282,COGS 118A,A01,083075,Gupta; Anjum,20,0,76,56
1657364201307,CSE 3,A50,083646,Miranda; Gregory Joseph,24,0,50,26
1657364207331,CSE 8A,A50,083650,Miranda; Gregory Joseph,17,1,56,39
1657364213356,CSE 11,A01,083080,Cao; Yingjun,6,15,40,34
1657364219381,CSE 12,A01,083652,Krause-Levy; Sophia Louisa,28,1,120,92
1657364225413,CSE 15L,A01,083654,Morris; Justin Loren,9,0,50,41
1657364225413,CSE 15L,A02,083655,Morris; Justin Loren,9,0,50,41
1657364231437,CSE 20,A01,083657,Tran; Khoa Dang,39,0,80,41
1657364237462,CSE 21,A01,095574,Bach; Quang Tran,22,0,48,26
1657364243496,CSE 30,A01,083084,Eldon; John,4,0,80,76
1657364243496,CSE 30,B01,095061,Bhaskar; Nishant,9,0,50,41
1657364249524,CSE 100,A01,083659,Cao; Yingjun,5,4,70,65
1657364255547,CSE 134B,A01,083661,Powell; Thomas Allan,22,0,100,78
1657364261571,CSE 140,A01,083663,Gungor; Onat,14,0,85,71
1657364267599,CSE 140L,A01,083088,Eldon; John,21,0,100,79
1657364273622,CSE 175,A01,083665,Kumar; Rakesh,3,0,25,22
1657364279648,CSE 190,A00,092507,Dubnov; Shlomo,7,0,20,13
1657364285672,ECE 45,A01,083139,Congero; Spencer William,6,0,75,69
1657364291698,ECE 65,A50,083695,Saad; Andrew S,12,0,30,18
1657364291698,ECE 65,A51,095125,Saad; Andrew S,24,0,26,2
1657364297729,ECE 109,A01,091882,Touri; Behrouz,19,0,70,51
1657364303752,ECE 180,A00,083140,Abi Samra; Nicholas Camill,1,0,30,29
1657364303752,ECE 180,B00,083141,Abi Samra; Nicholas Camill,0,0,30,30
1657364309786,MATH 10A,A01,083735,Patchell; Gregory David,2,0,30,28
1657364309786,MATH 10A,A02,083736,Patchell; Gregory David,20,0,30,10
1657364309786,MATH 10A,A03,083737,Patchell; Gregory David,16,0,30,14
1657364315820,MATH 10B,A01,083207,Lim; Seonhee,8,0,34,26
1657364315820,MATH 10B,A02,083208,Lim; Seonhee,9,0,35,26
1657364315820,MATH 10B,A03,093472,Lim; Seonhee,7,0,34,27
1657364315820,MATH 10B,B01,083739,Sinha; Shubham,12,0,30,18
1657364321863,MATH 18,A01,083743,Cinel; Cameron Alexander,7,0,30,23
1657364321863,MATH 18,A02,083744,Cinel; Cameron Alexander,17,0,30,13
1657364321863,MATH 18,A03,083745,Cinel; Cameron Alexander,9,0,30,21
1657364321863,MATH 18,B01,083748,Rideout; David Porter,5,0,37,32
1657364321863,MATH 18,B02,083749,Rideout; David Porter,5,0,36,31
1657364321863,MATH 18,B03,083750,Rideout; David Porter,3,0,37,34
1657364321863,MATH 18,B04,083751,Rideout; David Porter,6,0,36,30
1657364321863,MATH 18,B05,093473,Rideout; David Porter,6,0,36,30
1657364321863,MATH 18,B06,093474,Rideout; David Porter,6,0,36,30
1657364327890,MATH 20A,A01,083754,Zheng; Zequn,14,0,40,26
1657364333919,MATH 20B,A01,083756,Briones; Jor-el Thomas Caparas,4,0,36,32
1657364333919,MATH 20B,A02,083757,Briones; Jor-el Thomas Caparas,1,0,36,35
1657364333919,MATH 20B,A03,093475,Briones; Jor-el Thomas Caparas,2,0,36,34
1657364339950,MATH 20C,A01,083760,Briones; Jor-el Thomas Caparas,1,0,35,34
1657364339950,MATH 20C,A02,083761,Briones; Jor-el Thomas Caparas,8,0,35,27
1657364339950,MATH 20C,A03,093476,Briones; Jor-el Thomas Caparas,0,1,36,36
1657364339950,MATH 20C,B01,083762,Bach; Quang Tran,1,0,30,29
1657364345975,MATH 20D,A01,083765,Tran; Brian Kha,5,0,30,25
1657364345975,MATH 20D,A02,083766,Tran; Brian Kha,5,0,30,25
1657364345975,MATH 20D,A03,083767,Tran; Brian Kha,5,0,30,25
1657364352000,MATH 20E,A01,083771,Ganguly; Soumya,9,0,32,23
1657364352000,MATH 20E,A02,083772,Ganguly; Soumya,6,0,32,26
1657364352000,MATH 20E,B01,083773,Ciotti; Benjamin,20,0,35,15
1657364352000,MATH 20E,B02,083774,Ciotti; Benjamin,17,0,35,18
1657364358047,MATH 103A,A01,083777,Greenfeld; Be'Eri,3,0,36,33
1657364358047,MATH 103A,A02,083778,Greenfeld; Be'Eri,5,0,36,31
1657364358047,MATH 103A,A03,093561,Greenfeld; Be'Eri,5,0,36,31
1657364358047,MATH 103A,B01,083779,Greenfeld; Be'Eri,7,0,36,29
1657364358047,MATH 103A,B02,083780,Greenfeld; Be'Eri,4,0,36,32
1657364358047,MATH 103A,B03,093562,Greenfeld; Be'Eri,3,0,36,33
1657364364144,MATH 105,A01,085443,Carter; Anne Toulson,15,0,35,20
1657364364144,MATH 105,A02,093477,Carter; Anne Toulson,20,0,35,15
1657364370170,MATH 109,A01,083213,Ganzberger; Geoffrey Michael,2,0,34,32
1657364370170,MATH 109,A02,083214,Ganzberger; Geoffrey Michael,4,0,34,30
1657364370170,MATH 109,A03,093478,Ganzberger; Geoffrey Michael,2,0,34,32
1657364370170,MATH 109,B01,083215,Ganzberger; Geoffrey Michael,1,0,32,31
1657364370170,MATH 109,B02,083216,Ganzberger; Geoffrey Michael,2,0,32,30
1657364370170,MATH 109,B03,093479,Ganzberger; Geoffrey Michael,8,0,32,24
1657364376195,MATH 142A,A01,083219,Chow; Bennett,7,0,32,25
1657364376195,MATH 142A,A02,083220,Chow; Bennett,10,0,32,22
1657364376195,MATH 142A,A03,093480,Chow; Bennett,8,0,32,24
1657364376195,MATH 142A,B03,093481,Chow; Bennett,8,0,32,24
1657364376195,MATH 142A,B04,093558,Chow; Bennett,13,0,32,19
1657364376195,MATH 142A,B05,093559,Chow; Bennett,6,0,32,26
1657364382226,MATH 193A,A01,083224,Rotar; Vladimir,8,0,34,26
1657364382226,MATH 193A,A02,083225,Rotar; Vladimir,9,0,34,25
1657364382226,MATH 193A,A03,083781,Rotar; Vladimir,5,0,34,29
1657364382226,MATH 193A,A04,083782,Rotar; Vladimir,10,0,34,24
1657364382226,MATH 193A,A05,093482,Rotar; Vladimir,10,0,34,24
1657364388251,MATH 197,001,091859,McAuley; Julian John,9999,0,9999,0
1657364388251,MATH 197,002,095566,Kedlaya; Kiran S.,9997,0,9999,2
1657364388251,MATH 197,003,095567,Xiao; Ming,9999,0,9999,0
1657364388251,MATH 197,004,095571,Perols; Johan Lars,9998,0,9999,1
1657364395343,COGS 9,A01,083615,Shannon; Kyle Michael,8,0,75,67
1657364401368,COGS 11,A01,083617,Boyle; Mary E. T.,22,0,48,26
1657364407400,COGS 13,A01,083071,Bastos; Amalia Pinkusfeld,11,0,71,60
1657364413431,COGS 14A,A01,092681,Semenuks; Arturs,4,1,100,96
1657364419459,COGS 14B,A01,083073,Cheng; Tzu-Han,6,0,63,57
1657364425481,COGS 17,A01,092677,Semenuks; Arturs,6,0,81,75
1657364431511,COGS 100,A01,083619,Allen; Michael Gordon,17,0,70,53
1657364437541,COGS 101A,A01,083621,Davis; Joshua Daniel,9,0,68,59
1657364443567,COGS 101B,A01,091572,Allen; Michael Gordon,11,0,65,54
1657364449593,COGS 101C,A01,083625,Delgado; Tania,17,0,35,18
1657364455616,COGS 107A,A01,083627,Boyle; Mary E. T.,13,0,60,47
1657364461639,COGS 118A,A01,083075,Gupta; Anjum,20,0,76,56
1657364467664,CSE 3,A50,083646,Miranda; Gregory Joseph,24,0,50,26
1657364473687,CSE 8A,A50,083650,Miranda; Gregory Joseph,17,1,56,39
1657364479711,CSE 11,A01,083080,Cao; Yingjun,6,15,40,34
1657364485746,CSE 12,A01,083652,Krause-Levy; Sophia Louisa,28,1,120,92
1657364491769,CSE 15L,A01,083654,Morris; Justin Loren,9,0,50,41
1657364491769,CSE 15L,A02,083655,Morris; Justin Loren,9,0,50,41
1657364497792,CSE 20,A01,083657,Tran; Khoa Dang,39,0,80,41
1657364503821,CSE 21,A01,095574,Bach; Quang Tran,22,0,48,26
1657364509856,CSE 30,A01,083084,Eldon; John,4,0,80,76
1657364509856,CSE 30,B01,095061,Bhaskar; Nishant,9,0,50,41
1657364515880,CSE 100,A01,083659,Cao; Yingjun,5,4,70,65
1657364521903,CSE 134B,A01,083661,Powell; Thomas Allan,22,0,100,78
1657364527925,CSE 140,A01,083663,Gungor; Onat,14,0,85,71
1657364533958,CSE 140L,A01,083088,Eldon; John,21,0,100,79
1657364539988,CSE 175,A01,083665,Kumar; Rakesh,3,0,25,22
1657364546016,CSE 190,A00,092507,Dubnov; Shlomo,7,0,20,13
1657364552043,ECE 45,A01,083139,Congero; Spencer William,6,0,75,69
1657364558068,ECE 65,A50,083695,Saad; Andrew S,12,0,30,18
1657364558068,ECE 65,A51,095125,Saad; Andrew S,24,0,26,2
1657364564094,ECE 109,A01,091882,Touri; Behrouz,19,0,70,51
1657364570118,ECE 180,A00,083140,Abi Samra; Nicholas Camill,1,0,30,29
1657364570118,ECE 180,B00,083141,Abi Samra; Nicholas Camill,0,0,30,30
1657364576145,MATH 10A,A01,083735,Patchell; Gregory David,2,0,30,28
1657364576145,MATH 10A,A02,083736,Patchell; Gregory David,20,0,30,10
1657364576145,MATH 10A,A03,083737,Patchell; Gregory David,16,0,30,14
1657364582205,MATH 10B,A01,083207,Lim; Seonhee,8,0,34,26
1657364582205,MATH 10B,A02,083208,Lim; Seonhee,9,0,35,26
1657364582205,MATH 10B,A03,093472,Lim; Seonhee,7,0,34,27
1657364582205,MATH 10B,B01,083739,Sinha; Shubham,12,0,30,18
1657364588242,MATH 18,A01,083743,Cinel; Cameron Alexander,7,0,30,23
1657364588242,MATH 18,A02,083744,Cinel; Cameron Alexander,17,0,30,13
1657364588242,MATH 18,A03,083745,Cinel; Cameron Alexander,9,0,30,21
1657364588242,MATH 18,B01,083748,Rideout; David Porter,5,0,37,32
1657364588242,MATH 18,B02,083749,Rideout; David Porter,5,0,36,31
1657364588242,MATH 18,B03,083750,Rideout; David Porter,3,0,37,34
1657364588242,MATH 18,B04,083751,Rideout; David Porter,6,0,36,30
1657364588242,MATH 18,B05,093473,Rideout; David Porter,6,0,36,30
1657364588242,MATH 18,B06,093474,Rideout; David Porter,6,0,36,30
1657364594420,MATH 20A,A01,083754,Zheng; Zequn,14,0,40,26
1657364600453,MATH 20B,A01,083756,Briones; Jor-el Thomas Caparas,4,0,36,32
1657364600453,MATH 20B,A02,083757,Briones; Jor-el Thomas Caparas,1,0,36,35
1657364600453,MATH 20B,A03,093475,Briones; Jor-el Thomas Caparas,2,0,36,34
1657364606490,MATH 20C,A01,083760,Briones; Jor-el Thomas Caparas,1,0,35,34
1657364606490,MATH 20C,A02,083761,Briones; Jor-el Thomas Caparas,8,0,35,27
1657364606490,MATH 20C,A03,093476,Briones; Jor-el Thomas Caparas,0,1,36,36
1657364606490,MATH 20C,B01,083762,Bach; Quang Tran,1,0,30,29
1657364612522,MATH 20D,A01,083765,Tran; Brian Kha,5,0,30,25
1657364612522,MATH 20D,A02,083766,Tran; Brian Kha,5,0,30,25
1657364612522,MATH 20D,A03,083767,Tran; Brian Kha,5,0,30,25
1657364618550,MATH 20E,A01,083771,Ganguly; Soumya,9,0,32,23
1657364618550,MATH 20E,A02,083772,Ganguly; Soumya,6,0,32,26
1657364618550,MATH 20E,B01,083773,Ciotti; Benjamin,20,0,35,15
1657364618550,MATH 20E,B02,083774,Ciotti; Benjamin,17,0,35,18
1657364624578,MATH 103A,A01,083777,Greenfeld; Be'Eri,3,0,36,33
1657364624578,MATH 103A,A02,083778,Greenfeld; Be'Eri,5,0,36,31
1657364624578,MATH 103A,A03,093561,Greenfeld; Be'Eri,5,0,36,31
1657364624578,MATH 103A,B01,083779,Greenfeld; Be'Eri,7,0,36,29
1657364624578,MATH 103A,B02,083780,Greenfeld; Be'Eri,4,0,36,32
1657364624578,MATH 103A,B03,093562,Greenfeld; Be'Eri,3,0,36,33
1657364630606,MATH 105,A01,085443,Carter; Anne Toulson,15,0,35,20
1657364630606,MATH 105,A02,093477,Carter; Anne Toulson,20,0,35,15
1657364636632,MATH 109,A01,083213,Ganzberger; Geoffrey Michael,2,0,34,32
1657364636632,MATH 109,A02,083214,Ganzberger; Geoffrey Michael,4,0,34,30
1657364636632,MATH 109,A03,093478,Ganzberger; Geoffrey Michael,2,0,34,32
1657364636632,MATH 109,B01,083215,Ganzberger; Geoffrey Michael,1,0,32,31
1657364636632,MATH 109,B02,083216,Ganzberger; Geoffrey Michael,2,0,32,30
1657364636632,MATH 109,B03,093479,Ganzberger; Geoffrey Michael,8,0,32,24
1657364642668,MATH 142A,A01,083219,Chow; Bennett,7,0,32,25
1657364642668,MATH 142A,A02,083220,Chow; Bennett,10,0,32,22
1657364642668,MATH 142A,A03,093480,Chow; Bennett,8,0,32,24
1657364642668,MATH 142A,B03,093481,Chow; Bennett,8,0,32,24
1657364642668,MATH 142A,B04,093558,Chow; Bennett,13,0,32,19
1657364642668,MATH 142A,B05,093559,Chow; Bennett,6,0,32,26
1657364648698,MATH 193A,A01,083224,Rotar; Vladimir,8,0,34,26
1657364648698,MATH 193A,A02,083225,Rotar; Vladimir,9,0,34,25
1657364648698,MATH 193A,A03,083781,Rotar; Vladimir,5,0,34,29
1657364648698,MATH 193A,A04,083782,Rotar; Vladimir,10,0,34,24
1657364648698,MATH 193A,A05,093482,Rotar; Vladimir,10,0,34,24
1657364654728,MATH 197,001,091859,McAuley; Julian John,9999,0,9999,0
1657364654728,MATH 197,002,095566,Kedlaya; Kiran S.,9997,0,9999,2
1657364654728,MATH 197,003,095567,Xiao; Ming,9999,0,9999,0
1657364654728,MATH 197,004,095571,Perols; Johan Lars,9998,0,9999,1
