time,subj_course_id,sec_code,sec_id,prof,available,waitlist,total,enrolled_ct
1656761041273,COGS 9,A01,083615,Shannon; Kyle Michael,6,0,75,69
1656761047304,COGS 11,A01,083617,Boyle; Mary E. T.,18,0,48,30
1656761058508,COGS 13,A01,083071,Bastos; Amalia Pinkusfeld,8,0,71,63
1656761064541,COGS 14A,A01,092681,Semenuks; Arturs,0,1,100,100
1656761078428,COGS 14B,A01,083073,Cheng; Tzu-Han,5,0,63,58
1656761084458,COGS 17,A01,092677,Semenuks; Arturs,4,0,81,77
1656761098662,COGS 100,A01,083619,Allen; Michael Gordon,15,0,70,55
1656761104691,COGS 101A,A01,083621,Davis; Joshua Daniel,9,0,68,59
1656761118545,COGS 101B,A01,091572,Allen; Michael Gordon,8,0,65,57
1656761124577,COGS 101C,A01,083625,Delgado; Tania,17,0,35,18
1656761131132,COGS 107A,A01,083627,Boyle; Mary E. T.,13,0,60,47
1656761137165,COGS 118A,A01,083075,Gupta; Anjum,15,0,76,61
1656761143196,CSE 3,A50,083646,Miranda; Gregory Joseph,22,0,50,28
1656761149233,CSE 8A,A50,083650,Miranda; Gregory Joseph,17,1,56,39
1656761155277,CSE 11,A01,083080,Cao; Yingjun,4,15,40,36
1656761161312,CSE 12,A01,083652,Krause-Levy; Sophia Louisa,20,1,120,100
1656761167348,CSE 15L,A01,083654,Morris; Justin Loren,8,0,50,42
1656761167348,CSE 15L,A02,083655,Morris; Justin Loren,8,0,50,42
1656761173378,CSE 20,A01,083657,Tran; Khoa Dang,37,0,80,43
1656761179417,CSE 21,A01,095574,Bach; Quang Tran,21,0,48,27
1656761185452,CSE 30,A01,083084,Eldon; John,4,0,80,76
1656761185452,CSE 30,B01,095061,Bhaskar; Nishant,5,0,50,45
1656761191498,CSE 100,A01,083659,Cao; Yingjun,1,4,70,69
1656761197528,CSE 134B,A01,083661,Powell; Thomas Allan,18,0,100,82
1656761203564,CSE 140,A01,083663,Gungor; Onat,14,0,85,71
1656761209596,CSE 140L,A01,083088,Eldon; John,16,0,100,84
1656761215632,CSE 175,A01,083665,Kumar; Rakesh,3,0,25,22
1656761221671,CSE 190,A00,092507,Dubnov; Shlomo,7,0,20,13
1656761227707,ECE 45,A01,083139,Congero; Spencer William,5,0,75,70
1656761233739,ECE 65,A50,083695,Saad; Andrew S,12,0,30,18
1656761233739,ECE 65,A51,095125,Saad; Andrew S,25,0,26,1
1656761239769,ECE 109,A01,091882,Touri; Behrouz,15,0,70,55
1656761245799,ECE 180,A00,083140,Abi Samra; Nicholas Camill,0,0,30,30
1656761245799,ECE 180,B00,083141,Abi Samra; Nicholas Camill,0,0,30,30
1656761251843,MATH 10A,A01,083735,Patchell; Gregory David,1,0,30,29
1656761251843,MATH 10A,A02,083736,Patchell; Gregory David,20,0,30,10
1656761251843,MATH 10A,A03,083737,Patchell; Gregory David,15,0,30,15
1656761257879,MATH 10B,A01,083207,Lim; Seonhee,7,0,34,27
1656761257879,MATH 10B,A02,083208,Lim; Seonhee,9,0,35,26
1656761257879,MATH 10B,A03,093472,Lim; Seonhee,4,0,34,30
1656761257879,MATH 10B,B01,083739,Sinha; Shubham,9,0,30,21
1656761263918,MATH 18,A01,083743,Cinel; Cameron Alexander,6,0,30,24
1656761263918,MATH 18,A02,083744,Cinel; Cameron Alexander,15,0,30,15
1656761263918,MATH 18,A03,083745,Cinel; Cameron Alexander,8,0,30,22
1656761263918,MATH 18,B01,083748,Rideout; David Porter,3,0,37,34
1656761263918,MATH 18,B02,083749,Rideout; David Porter,3,0,36,33
1656761263918,MATH 18,B03,083750,Rideout; David Porter,1,0,37,36
1656761263918,MATH 18,B04,083751,Rideout; David Porter,5,0,36,31
1656761263918,MATH 18,B05,093473,Rideout; David Porter,4,0,36,32
1656761263918,MATH 18,B06,093474,Rideout; David Porter,5,0,36,31
1656761269946,MATH 20A,A01,083754,Zheng; Zequn,12,0,40,28
1656761275986,MATH 20B,A01,083756,Briones; Jor-el Thomas Caparas,1,0,36,35
1656761275986,MATH 20B,A02,083757,Briones; Jor-el Thomas Caparas,1,0,36,35
1656761275986,MATH 20B,A03,093475,Briones; Jor-el Thomas Caparas,0,0,36,36
1656761282028,MATH 20C,A01,083760,Briones; Jor-el Thomas Caparas,1,0,35,34
1656761282028,MATH 20C,A02,083761,Briones; Jor-el Thomas Caparas,8,0,35,27
1656761282028,MATH 20C,A03,093476,Briones; Jor-el Thomas Caparas,0,1,36,36
1656761282028,MATH 20C,B01,083762,Bach; Quang Tran,0,0,30,30
1656761288061,MATH 20D,A01,083765,Tran; Brian Kha,4,0,30,26
1656761288061,MATH 20D,A02,083766,Tran; Brian Kha,4,0,30,26
1656761288061,MATH 20D,A03,083767,Tran; Brian Kha,2,0,30,28
1656761294100,MATH 20E,A01,083771,Ganguly; Soumya,5,0,32,27
1656761294100,MATH 20E,A02,083772,Ganguly; Soumya,5,0,32,27
1656761294100,MATH 20E,B01,083773,Ciotti; Benjamin,18,0,35,17
1656761294100,MATH 20E,B02,083774,Ciotti; Benjamin,17,0,35,18
1656761300134,MATH 103A,A01,083777,Greenfeld; Be'Eri,2,0,36,34
1656761300134,MATH 103A,A02,083778,Greenfeld; Be'Eri,5,0,36,31
1656761300134,MATH 103A,A03,093561,Greenfeld; Be'Eri,4,0,36,32
1656761300134,MATH 103A,B01,083779,Greenfeld; Be'Eri,6,0,36,30
1656761300134,MATH 103A,B02,083780,Greenfeld; Be'Eri,2,0,36,34
1656761300134,MATH 103A,B03,093562,Greenfeld; Be'Eri,2,0,36,34
1656761306167,MATH 105,A01,085443,Carter; Anne Toulson,13,0,35,22
1656761306167,MATH 105,A02,093477,Carter; Anne Toulson,20,0,35,15
1656761312202,MATH 109,A01,083213,Ganzberger; Geoffrey Michael,2,0,34,32
1656761312202,MATH 109,A02,083214,Ganzberger; Geoffrey Michael,2,0,34,32
1656761312202,MATH 109,A03,093478,Ganzberger; Geoffrey Michael,1,0,34,33
1656761312202,MATH 109,B01,083215,Ganzberger; Geoffrey Michael,1,0,32,31
1656761312202,MATH 109,B02,083216,Ganzberger; Geoffrey Michael,1,0,32,31
1656761312202,MATH 109,B03,093479,Ganzberger; Geoffrey Michael,6,0,32,26
1656761318241,MATH 142A,A01,083219,Chow; Bennett,6,0,32,26
1656761318241,MATH 142A,A02,083220,Chow; Bennett,9,0,32,23
1656761318241,MATH 142A,A03,093480,Chow; Bennett,7,0,32,25
1656761318241,MATH 142A,B03,093481,Chow; Bennett,7,0,32,25
1656761318241,MATH 142A,B04,093558,Chow; Bennett,10,0,32,22
1656761318241,MATH 142A,B05,093559,Chow; Bennett,6,0,32,26
1656761324279,MATH 193A,A01,083224,Rotar; Vladimir,6,0,34,28
1656761324279,MATH 193A,A02,083225,Rotar; Vladimir,3,0,34,31
1656761324279,MATH 193A,A03,083781,Rotar; Vladimir,1,0,34,33
1656761324279,MATH 193A,A04,083782,Rotar; Vladimir,6,0,34,28
1656761324279,MATH 193A,A05,093482,Rotar; Vladimir,6,0,34,28
1656761330316,MATH 197,001,091859,McAuley; Julian John,9999,0,9999,0
1656761330316,MATH 197,002,095566,Kedlaya; Kiran S.,9997,0,9999,2
1656761330316,MATH 197,003,095567,Xiao; Ming,9999,0,9999,0
1656761330316,MATH 197,004,095571,Perols; Johan Lars,9998,0,9999,1
1656761337406,COGS 9,A01,083615,Shannon; Kyle Michael,6,0,75,69
1656761343437,COGS 11,A01,083617,Boyle; Mary E. T.,18,0,48,30
1656761356862,COGS 13,A01,083071,Bastos; Amalia Pinkusfeld,8,0,71,63
1656761362893,COGS 14A,A01,092681,Semenuks; Arturs,0,1,100,100
1656761372028,COGS 14B,A01,083073,Cheng; Tzu-Han,5,0,63,58
1656761378056,COGS 17,A01,092677,Semenuks; Arturs,4,0,81,77
1656761384090,COGS 100,A01,083619,Allen; Michael Gordon,15,0,70,55
1656761390124,COGS 101A,A01,083621,Davis; Joshua Daniel,9,0,68,59
1656761396153,COGS 101B,A01,091572,Allen; Michael Gordon,8,0,65,57
1656761402185,COGS 101C,A01,083625,Delgado; Tania,17,0,35,18
1656761408217,COGS 107A,A01,083627,Boyle; Mary E. T.,13,0,60,47
1656761414254,COGS 118A,A01,083075,Gupta; Anjum,15,0,76,61
1656761420296,CSE 3,A50,083646,Miranda; Gregory Joseph,22,0,50,28
1656761426323,CSE 8A,A50,083650,Miranda; Gregory Joseph,17,1,56,39
1656761432349,CSE 11,A01,083080,Cao; Yingjun,4,15,40,36
1656761438378,CSE 12,A01,083652,Krause-Levy; Sophia Louisa,20,1,120,100
1656761444407,CSE 15L,A01,083654,Morris; Justin Loren,8,0,50,42
1656761444407,CSE 15L,A02,083655,Morris; Justin Loren,8,0,50,42
1656761450442,CSE 20,A01,083657,Tran; Khoa Dang,37,0,80,43
1656761456468,CSE 21,A01,095574,Bach; Quang Tran,21,0,48,27
1656761462499,CSE 30,A01,083084,Eldon; John,4,0,80,76
1656761462499,CSE 30,B01,095061,Bhaskar; Nishant,5,0,50,45
1656761468532,CSE 100,A01,083659,Cao; Yingjun,1,4,70,69
1656761474563,CSE 134B,A01,083661,Powell; Thomas Allan,18,0,100,82
1656761480604,CSE 140,A01,083663,Gungor; Onat,14,0,85,71
1656761486637,CSE 140L,A01,083088,Eldon; John,16,0,100,84
1656761492674,CSE 175,A01,083665,Kumar; Rakesh,3,0,25,22
1656761498706,CSE 190,A00,092507,Dubnov; Shlomo,7,0,20,13
1656761504751,ECE 45,A01,083139,Congero; Spencer William,5,0,75,70
1656761510789,ECE 65,A50,083695,Saad; Andrew S,12,0,30,18
1656761510789,ECE 65,A51,095125,Saad; Andrew S,25,0,26,1
1656761516824,ECE 109,A01,091882,Touri; Behrouz,15,0,70,55
1656761522852,ECE 180,A00,083140,Abi Samra; Nicholas Camill,0,0,30,30
1656761522852,ECE 180,B00,083141,Abi Samra; Nicholas Camill,0,0,30,30
1656761528886,MATH 10A,A01,083735,Patchell; Gregory David,1,0,30,29
1656761528886,MATH 10A,A02,083736,Patchell; Gregory David,20,0,30,10
1656761528886,MATH 10A,A03,083737,Patchell; Gregory David,15,0,30,15
1656761534926,MATH 10B,A01,083207,Lim; Seonhee,7,0,34,27
1656761534926,MATH 10B,A02,083208,Lim; Seonhee,9,0,35,26
1656761534926,MATH 10B,A03,093472,Lim; Seonhee,4,0,34,30
1656761534926,MATH 10B,B01,083739,Sinha; Shubham,9,0,30,21
1656761540959,MATH 18,A01,083743,Cinel; Cameron Alexander,6,0,30,24
1656761540959,MATH 18,A02,083744,Cinel; Cameron Alexander,15,0,30,15
1656761540959,MATH 18,A03,083745,Cinel; Cameron Alexander,8,0,30,22
1656761540959,MATH 18,B01,083748,Rideout; David Porter,3,0,37,34
1656761540959,MATH 18,B02,083749,Rideout; David Porter,3,0,36,33
1656761540959,MATH 18,B03,083750,Rideout; David Porter,1,0,37,36
1656761540959,MATH 18,B04,083751,Rideout; David Porter,5,0,36,31
1656761540959,MATH 18,B05,093473,Rideout; David Porter,4,0,36,32
1656761540959,MATH 18,B06,093474,Rideout; David Porter,5,0,36,31
1656761546992,MATH 20A,A01,083754,Zheng; Zequn,12,0,40,28
1656761553029,MATH 20B,A01,083756,Briones; Jor-el Thomas Caparas,1,0,36,35
1656761553029,MATH 20B,A02,083757,Briones; Jor-el Thomas Caparas,1,0,36,35
1656761553029,MATH 20B,A03,093475,Briones; Jor-el Thomas Caparas,0,0,36,36
1656761559061,MATH 20C,A01,083760,Briones; Jor-el Thomas Caparas,1,0,35,34
1656761559061,MATH 20C,A02,083761,Briones; Jor-el Thomas Caparas,8,0,35,27
1656761559061,MATH 20C,A03,093476,Briones; Jor-el Thomas Caparas,0,1,36,36
1656761559061,MATH 20C,B01,083762,Bach; Quang Tran,0,0,30,30
1656761565088,MATH 20D,A01,083765,Tran; Brian Kha,4,0,30,26
1656761565088,MATH 20D,A02,083766,Tran; Brian Kha,4,0,30,26
1656761565088,MATH 20D,A03,083767,Tran; Brian Kha,2,0,30,28
1656761571131,MATH 20E,A01,083771,Ganguly; Soumya,5,0,32,27
1656761571131,MATH 20E,A02,083772,Ganguly; Soumya,5,0,32,27
1656761571131,MATH 20E,B01,083773,Ciotti; Benjamin,18,0,35,17
1656761571131,MATH 20E,B02,083774,Ciotti; Benjamin,17,0,35,18
1656761577164,MATH 103A,A01,083777,Greenfeld; Be'Eri,2,0,36,34
1656761577164,MATH 103A,A02,083778,Greenfeld; Be'Eri,5,0,36,31
1656761577164,MATH 103A,A03,093561,Greenfeld; Be'Eri,4,0,36,32
1656761577164,MATH 103A,B01,083779,Greenfeld; Be'Eri,6,0,36,30
1656761577164,MATH 103A,B02,083780,Greenfeld; Be'Eri,2,0,36,34
1656761577164,MATH 103A,B03,093562,Greenfeld; Be'Eri,2,0,36,34
1656761583202,MATH 105,A01,085443,Carter; Anne Toulson,13,0,35,22
1656761583202,MATH 105,A02,093477,Carter; Anne Toulson,20,0,35,15
1656761589232,MATH 109,A01,083213,Ganzberger; Geoffrey Michael,2,0,34,32
1656761589232,MATH 109,A02,083214,Ganzberger; Geoffrey Michael,2,0,34,32
1656761589232,MATH 109,A03,093478,Ganzberger; Geoffrey Michael,1,0,34,33
1656761589232,MATH 109,B01,083215,Ganzberger; Geoffrey Michael,1,0,32,31
1656761589232,MATH 109,B02,083216,Ganzberger; Geoffrey Michael,1,0,32,31
1656761589232,MATH 109,B03,093479,Ganzberger; Geoffrey Michael,6,0,32,26
1656761595260,MATH 142A,A01,083219,Chow; Bennett,6,0,32,26
1656761595260,MATH 142A,A02,083220,Chow; Bennett,9,0,32,23
1656761595260,MATH 142A,A03,093480,Chow; Bennett,7,0,32,25
1656761595260,MATH 142A,B03,093481,Chow; Bennett,7,0,32,25
1656761595260,MATH 142A,B04,093558,Chow; Bennett,10,0,32,22
1656761595260,MATH 142A,B05,093559,Chow; Bennett,6,0,32,26
1656761601289,MATH 193A,A01,083224,Rotar; Vladimir,6,0,34,28
1656761601289,MATH 193A,A02,083225,Rotar; Vladimir,3,0,34,31
1656761601289,MATH 193A,A03,083781,Rotar; Vladimir,1,0,34,33
1656761601289,MATH 193A,A04,083782,Rotar; Vladimir,6,0,34,28
1656761601289,MATH 193A,A05,093482,Rotar; Vladimir,6,0,34,28
1656761607333,MATH 197,001,091859,McAuley; Julian John,9999,0,9999,0
1656761607333,MATH 197,002,095566,Kedlaya; Kiran S.,9997,0,9999,2
1656761607333,MATH 197,003,095567,Xiao; Ming,9999,0,9999,0
1656761607333,MATH 197,004,095571,Perols; Johan Lars,9998,0,9999,1
1656761614408,COGS 9,A01,083615,Shannon; Kyle Michael,6,0,75,69
1656761620442,COGS 11,A01,083617,Boyle; Mary E. T.,18,0,48,30
1656761626471,COGS 13,A01,083071,Bastos; Amalia Pinkusfeld,8,0,71,63
1656761632501,COGS 14A,A01,092681,Semenuks; Arturs,0,1,100,100
1656761638532,COGS 14B,A01,083073,Cheng; Tzu-Han,5,0,63,58
1656761644568,COGS 17,A01,092677,Semenuks; Arturs,4,0,81,77
1656761650601,COGS 100,A01,083619,Allen; Michael Gordon,15,0,70,55
1656761656718,COGS 101A,A01,083621,Davis; Joshua Daniel,9,0,68,59
1656761662748,COGS 101B,A01,091572,Allen; Michael Gordon,8,0,65,57
1656761668773,COGS 101C,A01,083625,Delgado; Tania,17,0,35,18
1656761674800,COGS 107A,A01,083627,Boyle; Mary E. T.,13,0,60,47
1656761680826,COGS 118A,A01,083075,Gupta; Anjum,15,0,76,61
1656761686866,CSE 3,A50,083646,Miranda; Gregory Joseph,22,0,50,28
1656761692905,CSE 8A,A50,083650,Miranda; Gregory Joseph,17,1,56,39
1656761698931,CSE 11,A01,083080,Cao; Yingjun,4,15,40,36
1656761704960,CSE 12,A01,083652,Krause-Levy; Sophia Louisa,20,1,120,100
1656761710992,CSE 15L,A01,083654,Morris; Justin Loren,8,0,50,42
1656761710992,CSE 15L,A02,083655,Morris; Justin Loren,8,0,50,42
1656761717026,CSE 20,A01,083657,Tran; Khoa Dang,37,0,80,43
1656761723054,CSE 21,A01,095574,Bach; Quang Tran,21,0,48,27
1656761729090,CSE 30,A01,083084,Eldon; John,4,0,80,76
1656761729090,CSE 30,B01,095061,Bhaskar; Nishant,5,0,50,45
1656761735119,CSE 100,A01,083659,Cao; Yingjun,1,4,70,69
1656761741152,CSE 134B,A01,083661,Powell; Thomas Allan,18,0,100,82
1656761747184,CSE 140,A01,083663,Gungor; Onat,14,0,85,71
1656761753210,CSE 140L,A01,083088,Eldon; John,16,0,100,84
1656761759239,CSE 175,A01,083665,Kumar; Rakesh,3,0,25,22
1656761765268,CSE 190,A00,092507,Dubnov; Shlomo,7,0,20,13
1656761771305,ECE 45,A01,083139,Congero; Spencer William,5,0,75,70
1656761777337,ECE 65,A50,083695,Saad; Andrew S,12,0,30,18
1656761777337,ECE 65,A51,095125,Saad; Andrew S,25,0,26,1
1656761783373,ECE 109,A01,091882,Touri; Behrouz,15,0,70,55
1656761789403,ECE 180,A00,083140,Abi Samra; Nicholas Camill,0,0,30,30
1656761789403,ECE 180,B00,083141,Abi Samra; Nicholas Camill,0,0,30,30
1656761795434,MATH 10A,A01,083735,Patchell; Gregory David,1,0,30,29
1656761795434,MATH 10A,A02,083736,Patchell; Gregory David,20,0,30,10
1656761795434,MATH 10A,A03,083737,Patchell; Gregory David,15,0,30,15
1656761801466,MATH 10B,A01,083207,Lim; Seonhee,7,0,34,27
1656761801466,MATH 10B,A02,083208,Lim; Seonhee,9,0,35,26
1656761801466,MATH 10B,A03,093472,Lim; Seonhee,4,0,34,30
1656761801466,MATH 10B,B01,083739,Sinha; Shubham,9,0,30,21
1656761807509,MATH 18,A01,083743,Cinel; Cameron Alexander,6,0,30,24
1656761807509,MATH 18,A02,083744,Cinel; Cameron Alexander,15,0,30,15
1656761807509,MATH 18,A03,083745,Cinel; Cameron Alexander,8,0,30,22
1656761807509,MATH 18,B01,083748,Rideout; David Porter,3,0,37,34
1656761807509,MATH 18,B02,083749,Rideout; David Porter,3,0,36,33
1656761807509,MATH 18,B03,083750,Rideout; David Porter,1,0,37,36
1656761807509,MATH 18,B04,083751,Rideout; David Porter,5,0,36,31
1656761807509,MATH 18,B05,093473,Rideout; David Porter,4,0,36,32
1656761807509,MATH 18,B06,093474,Rideout; David Porter,5,0,36,31
1656761813539,MATH 20A,A01,083754,Zheng; Zequn,12,0,40,28
1656761819568,MATH 20B,A01,083756,Briones; Jor-el Thomas Caparas,1,0,36,35
1656761819568,MATH 20B,A02,083757,Briones; Jor-el Thomas Caparas,1,0,36,35
1656761819568,MATH 20B,A03,093475,Briones; Jor-el Thomas Caparas,0,0,36,36
1656761825595,MATH 20C,A01,083760,Briones; Jor-el Thomas Caparas,1,0,35,34
1656761825595,MATH 20C,A02,083761,Briones; Jor-el Thomas Caparas,8,0,35,27
1656761825595,MATH 20C,A03,093476,Briones; Jor-el Thomas Caparas,0,1,36,36
1656761825595,MATH 20C,B01,083762,Bach; Quang Tran,0,0,30,30
1656761831632,MATH 20D,A01,083765,Tran; Brian Kha,4,0,30,26
1656761831632,MATH 20D,A02,083766,Tran; Brian Kha,4,0,30,26
1656761831632,MATH 20D,A03,083767,Tran; Brian Kha,2,0,30,28
1656761837663,MATH 20E,A01,083771,Ganguly; Soumya,5,0,32,27
1656761837663,MATH 20E,A02,083772,Ganguly; Soumya,5,0,32,27
1656761837663,MATH 20E,B01,083773,Ciotti; Benjamin,18,0,35,17
1656761837663,MATH 20E,B02,083774,Ciotti; Benjamin,17,0,35,18
1656761843703,MATH 103A,A01,083777,Greenfeld; Be'Eri,2,0,36,34
1656761843703,MATH 103A,A02,083778,Greenfeld; Be'Eri,5,0,36,31
1656761843703,MATH 103A,A03,093561,Greenfeld; Be'Eri,4,0,36,32
1656761843703,MATH 103A,B01,083779,Greenfeld; Be'Eri,6,0,36,30
1656761843703,MATH 103A,B02,083780,Greenfeld; Be'Eri,2,0,36,34
1656761843703,MATH 103A,B03,093562,Greenfeld; Be'Eri,2,0,36,34
1656761849733,MATH 105,A01,085443,Carter; Anne Toulson,13,0,35,22
1656761849733,MATH 105,A02,093477,Carter; Anne Toulson,20,0,35,15
1656761855768,MATH 109,A01,083213,Ganzberger; Geoffrey Michael,2,0,34,32
1656761855768,MATH 109,A02,083214,Ganzberger; Geoffrey Michael,2,0,34,32
1656761855768,MATH 109,A03,093478,Ganzberger; Geoffrey Michael,1,0,34,33
1656761855768,MATH 109,B01,083215,Ganzberger; Geoffrey Michael,1,0,32,31
1656761855768,MATH 109,B02,083216,Ganzberger; Geoffrey Michael,1,0,32,31
1656761855768,MATH 109,B03,093479,Ganzberger; Geoffrey Michael,6,0,32,26
1656761861813,MATH 142A,A01,083219,Chow; Bennett,6,0,32,26
1656761861813,MATH 142A,A02,083220,Chow; Bennett,9,0,32,23
1656761861813,MATH 142A,A03,093480,Chow; Bennett,7,0,32,25
1656761861813,MATH 142A,B03,093481,Chow; Bennett,7,0,32,25
1656761861813,MATH 142A,B04,093558,Chow; Bennett,10,0,32,22
1656761861813,MATH 142A,B05,093559,Chow; Bennett,6,0,32,26
1656761867848,MATH 193A,A01,083224,Rotar; Vladimir,6,0,34,28
1656761867848,MATH 193A,A02,083225,Rotar; Vladimir,3,0,34,31
1656761867848,MATH 193A,A03,083781,Rotar; Vladimir,1,0,34,33
1656761867848,MATH 193A,A04,083782,Rotar; Vladimir,6,0,34,28
1656761867848,MATH 193A,A05,093482,Rotar; Vladimir,6,0,34,28
1656761873878,MATH 197,001,091859,McAuley; Julian John,9999,0,9999,0
1656761873878,MATH 197,002,095566,Kedlaya; Kiran S.,9997,0,9999,2
1656761873878,MATH 197,003,095567,Xiao; Ming,9999,0,9999,0
1656761873878,MATH 197,004,095571,Perols; Johan Lars,9998,0,9999,1
1656761880961,COGS 9,A01,083615,Shannon; Kyle Michael,6,0,75,69
1656761886997,COGS 11,A01,083617,Boyle; Mary E. T.,18,0,48,30
1656761893026,COGS 13,A01,083071,Bastos; Amalia Pinkusfeld,8,0,71,63
1656761899064,COGS 14A,A01,092681,Semenuks; Arturs,0,1,100,100
1656761905100,COGS 14B,A01,083073,Cheng; Tzu-Han,5,0,63,58
1656761911127,COGS 17,A01,092677,Semenuks; Arturs,4,0,81,77
1656761917156,COGS 100,A01,083619,Allen; Michael Gordon,15,0,70,55
1656761923189,COGS 101A,A01,083621,Davis; Joshua Daniel,9,0,68,59
1656761929223,COGS 101B,A01,091572,Allen; Michael Gordon,8,0,65,57
1656761935259,COGS 101C,A01,083625,Delgado; Tania,17,0,35,18
1656761941287,COGS 107A,A01,083627,Boyle; Mary E. T.,13,0,60,47
1656761947321,COGS 118A,A01,083075,Gupta; Anjum,15,0,76,61
1656761953352,CSE 3,A50,083646,Miranda; Gregory Joseph,22,0,50,28
1656761959381,CSE 8A,A50,083650,Miranda; Gregory Joseph,17,1,56,39
1656761965416,CSE 11,A01,083080,Cao; Yingjun,4,15,40,36
1656761971461,CSE 12,A01,083652,Krause-Levy; Sophia Louisa,20,1,120,100
1656761977488,CSE 15L,A01,083654,Morris; Justin Loren,8,0,50,42
1656761977488,CSE 15L,A02,083655,Morris; Justin Loren,8,0,50,42
1656761983517,CSE 20,A01,083657,Tran; Khoa Dang,37,0,80,43
1656761989550,CSE 21,A01,095574,Bach; Quang Tran,21,0,48,27
1656761995583,CSE 30,A01,083084,Eldon; John,4,0,80,76
1656761995583,CSE 30,B01,095061,Bhaskar; Nishant,5,0,50,45
1656762001613,CSE 100,A01,083659,Cao; Yingjun,1,4,70,69
1656762007641,CSE 134B,A01,083661,Powell; Thomas Allan,18,0,100,82
1656762013669,CSE 140,A01,083663,Gungor; Onat,14,0,85,71
1656762019695,CSE 140L,A01,083088,Eldon; John,16,0,100,84
1656762025720,CSE 175,A01,083665,Kumar; Rakesh,3,0,25,22
1656762031756,CSE 190,A00,092507,Dubnov; Shlomo,7,0,20,13
1656762037783,ECE 45,A01,083139,Congero; Spencer William,5,0,75,70
1656762043811,ECE 65,A50,083695,Saad; Andrew S,12,0,30,18
1656762043811,ECE 65,A51,095125,Saad; Andrew S,25,0,26,1
1656762049842,ECE 109,A01,091882,Touri; Behrouz,15,0,70,55
1656762055871,ECE 180,A00,083140,Abi Samra; Nicholas Camill,0,0,30,30
1656762055871,ECE 180,B00,083141,Abi Samra; Nicholas Camill,0,0,30,30
1656762061901,MATH 10A,A01,083735,Patchell; Gregory David,1,0,30,29
1656762061901,MATH 10A,A02,083736,Patchell; Gregory David,20,0,30,10
1656762061901,MATH 10A,A03,083737,Patchell; Gregory David,15,0,30,15
1656762067938,MATH 10B,A01,083207,Lim; Seonhee,7,0,34,27
1656762067938,MATH 10B,A02,083208,Lim; Seonhee,9,0,35,26
1656762067938,MATH 10B,A03,093472,Lim; Seonhee,4,0,34,30
1656762067938,MATH 10B,B01,083739,Sinha; Shubham,9,0,30,21
1656762073970,MATH 18,A01,083743,Cinel; Cameron Alexander,6,0,30,24
1656762073970,MATH 18,A02,083744,Cinel; Cameron Alexander,15,0,30,15
1656762073970,MATH 18,A03,083745,Cinel; Cameron Alexander,8,0,30,22
1656762073970,MATH 18,B01,083748,Rideout; David Porter,3,0,37,34
1656762073970,MATH 18,B02,083749,Rideout; David Porter,3,0,36,33
1656762073970,MATH 18,B03,083750,Rideout; David Porter,1,0,37,36
1656762073970,MATH 18,B04,083751,Rideout; David Porter,5,0,36,31
1656762073970,MATH 18,B05,093473,Rideout; David Porter,4,0,36,32
1656762073970,MATH 18,B06,093474,Rideout; David Porter,5,0,36,31
1656762079995,MATH 20A,A01,083754,Zheng; Zequn,12,0,40,28
1656762086033,MATH 20B,A01,083756,Briones; Jor-el Thomas Caparas,1,0,36,35
1656762086033,MATH 20B,A02,083757,Briones; Jor-el Thomas Caparas,1,0,36,35
1656762086033,MATH 20B,A03,093475,Briones; Jor-el Thomas Caparas,0,0,36,36
1656762092068,MATH 20C,A01,083760,Briones; Jor-el Thomas Caparas,1,0,35,34
1656762092068,MATH 20C,A02,083761,Briones; Jor-el Thomas Caparas,8,0,35,27
1656762092068,MATH 20C,A03,093476,Briones; Jor-el Thomas Caparas,0,1,36,36
1656762092068,MATH 20C,B01,083762,Bach; Quang Tran,0,0,30,30
1656762098103,MATH 20D,A01,083765,Tran; Brian Kha,4,0,30,26
1656762098103,MATH 20D,A02,083766,Tran; Brian Kha,4,0,30,26
1656762098103,MATH 20D,A03,083767,Tran; Brian Kha,2,0,30,28
1656762104141,MATH 20E,A01,083771,Ganguly; Soumya,5,0,32,27
1656762104141,MATH 20E,A02,083772,Ganguly; Soumya,5,0,32,27
1656762104141,MATH 20E,B01,083773,Ciotti; Benjamin,18,0,35,17
1656762104141,MATH 20E,B02,083774,Ciotti; Benjamin,17,0,35,18
1656762110179,MATH 103A,A01,083777,Greenfeld; Be'Eri,2,0,36,34
1656762110179,MATH 103A,A02,083778,Greenfeld; Be'Eri,5,0,36,31
1656762110179,MATH 103A,A03,093561,Greenfeld; Be'Eri,4,0,36,32
1656762110179,MATH 103A,B01,083779,Greenfeld; Be'Eri,6,0,36,30
1656762110179,MATH 103A,B02,083780,Greenfeld; Be'Eri,2,0,36,34
1656762110179,MATH 103A,B03,093562,Greenfeld; Be'Eri,2,0,36,34
1656762116211,MATH 105,A01,085443,Carter; Anne Toulson,13,0,35,22
1656762116211,MATH 105,A02,093477,Carter; Anne Toulson,20,0,35,15
1656762122245,MATH 109,A01,083213,Ganzberger; Geoffrey Michael,2,0,34,32
1656762122245,MATH 109,A02,083214,Ganzberger; Geoffrey Michael,2,0,34,32
1656762122245,MATH 109,A03,093478,Ganzberger; Geoffrey Michael,1,0,34,33
1656762122245,MATH 109,B01,083215,Ganzberger; Geoffrey Michael,1,0,32,31
1656762122245,MATH 109,B02,083216,Ganzberger; Geoffrey Michael,1,0,32,31
1656762122245,MATH 109,B03,093479,Ganzberger; Geoffrey Michael,6,0,32,26
1656762128285,MATH 142A,A01,083219,Chow; Bennett,6,0,32,26
1656762128285,MATH 142A,A02,083220,Chow; Bennett,9,0,32,23
1656762128285,MATH 142A,A03,093480,Chow; Bennett,7,0,32,25
1656762128285,MATH 142A,B03,093481,Chow; Bennett,7,0,32,25
1656762128285,MATH 142A,B04,093558,Chow; Bennett,10,0,32,22
1656762128285,MATH 142A,B05,093559,Chow; Bennett,6,0,32,26
1656762134312,MATH 193A,A01,083224,Rotar; Vladimir,6,0,34,28
1656762134312,MATH 193A,A02,083225,Rotar; Vladimir,3,0,34,31
1656762134312,MATH 193A,A03,083781,Rotar; Vladimir,1,0,34,33
1656762134312,MATH 193A,A04,083782,Rotar; Vladimir,6,0,34,28
1656762134312,MATH 193A,A05,093482,Rotar; Vladimir,6,0,34,28
1656762140342,MATH 197,001,091859,McAuley; Julian John,9999,0,9999,0
1656762140342,MATH 197,002,095566,Kedlaya; Kiran S.,9997,0,9999,2
1656762140342,MATH 197,003,095567,Xiao; Ming,9999,0,9999,0
1656762140342,MATH 197,004,095571,Perols; Johan Lars,9998,0,9999,1
1656762147414,COGS 9,A01,083615,Shannon; Kyle Michael,6,0,75,69
1656762153447,COGS 11,A01,083617,Boyle; Mary E. T.,18,0,48,30
1656762159480,COGS 13,A01,083071,Bastos; Amalia Pinkusfeld,8,0,71,63
1656762165512,COGS 14A,A01,092681,Semenuks; Arturs,0,1,100,100
1656762171548,COGS 14B,A01,083073,Cheng; Tzu-Han,5,0,63,58
1656762177576,COGS 17,A01,092677,Semenuks; Arturs,4,0,81,77
1656762183605,COGS 100,A01,083619,Allen; Michael Gordon,15,0,70,55
1656762189633,COGS 101A,A01,083621,Davis; Joshua Daniel,9,0,68,59
1656762195685,COGS 101B,A01,091572,Allen; Michael Gordon,8,0,65,57
1656762201713,COGS 101C,A01,083625,Delgado; Tania,17,0,35,18
1656762207746,COGS 107A,A01,083627,Boyle; Mary E. T.,13,0,60,47
1656762213775,COGS 118A,A01,083075,Gupta; Anjum,15,0,76,61
1656762219807,CSE 3,A50,083646,Miranda; Gregory Joseph,22,0,50,28
1656762225836,CSE 8A,A50,083650,Miranda; Gregory Joseph,17,1,56,39
1656762231863,CSE 11,A01,083080,Cao; Yingjun,4,15,40,36
1656762237896,CSE 12,A01,083652,Krause-Levy; Sophia Louisa,20,1,120,100
1656762243930,CSE 15L,A01,083654,Morris; Justin Loren,8,0,50,42
1656762243930,CSE 15L,A02,083655,Morris; Justin Loren,8,0,50,42
1656762249962,CSE 20,A01,083657,Tran; Khoa Dang,37,0,80,43
1656762256069,CSE 21,A01,095574,Bach; Quang Tran,21,0,48,27
1656762262104,CSE 30,A01,083084,Eldon; John,4,0,80,76
1656762262104,CSE 30,B01,095061,Bhaskar; Nishant,5,0,50,45
1656762268132,CSE 100,A01,083659,Cao; Yingjun,1,4,70,69
1656762274161,CSE 134B,A01,083661,Powell; Thomas Allan,18,0,100,82
1656762280195,CSE 140,A01,083663,Gungor; Onat,14,0,85,71
1656762286225,CSE 140L,A01,083088,Eldon; John,16,0,100,84
1656762292257,CSE 175,A01,083665,Kumar; Rakesh,3,0,25,22
1656762298300,CSE 190,A00,092507,Dubnov; Shlomo,7,0,20,13
1656762304327,ECE 45,A01,083139,Congero; Spencer William,5,0,75,70
1656762310354,ECE 65,A50,083695,Saad; Andrew S,12,0,30,18
1656762310354,ECE 65,A51,095125,Saad; Andrew S,25,0,26,1
1656762316385,ECE 109,A01,091882,Touri; Behrouz,15,0,70,55
1656762322424,ECE 180,A00,083140,Abi Samra; Nicholas Camill,0,0,30,30
1656762322424,ECE 180,B00,083141,Abi Samra; Nicholas Camill,0,0,30,30
1656762328453,MATH 10A,A01,083735,Patchell; Gregory David,1,0,30,29
1656762328453,MATH 10A,A02,083736,Patchell; Gregory David,20,0,30,10
1656762328453,MATH 10A,A03,083737,Patchell; Gregory David,15,0,30,15
1656762334485,MATH 10B,A01,083207,Lim; Seonhee,7,0,34,27
1656762334485,MATH 10B,A02,083208,Lim; Seonhee,9,0,35,26
1656762334485,MATH 10B,A03,093472,Lim; Seonhee,4,0,34,30
1656762334485,MATH 10B,B01,083739,Sinha; Shubham,9,0,30,21
1656762340516,MATH 18,A01,083743,Cinel; Cameron Alexander,6,0,30,24
1656762340516,MATH 18,A02,083744,Cinel; Cameron Alexander,15,0,30,15
1656762340516,MATH 18,A03,083745,Cinel; Cameron Alexander,8,0,30,22
1656762340516,MATH 18,B01,083748,Rideout; David Porter,3,0,37,34
1656762340516,MATH 18,B02,083749,Rideout; David Porter,3,0,36,33
1656762340516,MATH 18,B03,083750,Rideout; David Porter,1,0,37,36
1656762340516,MATH 18,B04,083751,Rideout; David Porter,5,0,36,31
1656762340516,MATH 18,B05,093473,Rideout; David Porter,4,0,36,32
1656762340516,MATH 18,B06,093474,Rideout; David Porter,5,0,36,31
1656762346549,MATH 20A,A01,083754,Zheng; Zequn,12,0,40,28
1656762352583,MATH 20B,A01,083756,Briones; Jor-el Thomas Caparas,1,0,36,35
1656762352583,MATH 20B,A02,083757,Briones; Jor-el Thomas Caparas,1,0,36,35
1656762352583,MATH 20B,A03,093475,Briones; Jor-el Thomas Caparas,0,0,36,36
1656762358613,MATH 20C,A01,083760,Briones; Jor-el Thomas Caparas,1,0,35,34
1656762358613,MATH 20C,A02,083761,Briones; Jor-el Thomas Caparas,8,0,35,27
1656762358613,MATH 20C,A03,093476,Briones; Jor-el Thomas Caparas,0,1,36,36
1656762358613,MATH 20C,B01,083762,Bach; Quang Tran,0,0,30,30
1656762364645,MATH 20D,A01,083765,Tran; Brian Kha,4,0,30,26
1656762364645,MATH 20D,A02,083766,Tran; Brian Kha,4,0,30,26
1656762364645,MATH 20D,A03,083767,Tran; Brian Kha,2,0,30,28
1656762370674,MATH 20E,A01,083771,Ganguly; Soumya,5,0,32,27
1656762370674,MATH 20E,A02,083772,Ganguly; Soumya,5,0,32,27
1656762370674,MATH 20E,B01,083773,Ciotti; Benjamin,18,0,35,17
1656762370674,MATH 20E,B02,083774,Ciotti; Benjamin,17,0,35,18
1656762376713,MATH 103A,A01,083777,Greenfeld; Be'Eri,2,0,36,34
1656762376713,MATH 103A,A02,083778,Greenfeld; Be'Eri,5,0,36,31
1656762376713,MATH 103A,A03,093561,Greenfeld; Be'Eri,4,0,36,32
1656762376713,MATH 103A,B01,083779,Greenfeld; Be'Eri,6,0,36,30
1656762376713,MATH 103A,B02,083780,Greenfeld; Be'Eri,2,0,36,34
1656762376713,MATH 103A,B03,093562,Greenfeld; Be'Eri,2,0,36,34
1656762382743,MATH 105,A01,085443,Carter; Anne Toulson,13,0,35,22
1656762382743,MATH 105,A02,093477,Carter; Anne Toulson,20,0,35,15
1656762388769,MATH 109,A01,083213,Ganzberger; Geoffrey Michael,2,0,34,32
1656762388769,MATH 109,A02,083214,Ganzberger; Geoffrey Michael,2,0,34,32
1656762388769,MATH 109,A03,093478,Ganzberger; Geoffrey Michael,1,0,34,33
1656762388769,MATH 109,B01,083215,Ganzberger; Geoffrey Michael,1,0,32,31
1656762388769,MATH 109,B02,083216,Ganzberger; Geoffrey Michael,1,0,32,31
1656762388769,MATH 109,B03,093479,Ganzberger; Geoffrey Michael,6,0,32,26
1656762394799,MATH 142A,A01,083219,Chow; Bennett,6,0,32,26
1656762394799,MATH 142A,A02,083220,Chow; Bennett,9,0,32,23
1656762394799,MATH 142A,A03,093480,Chow; Bennett,7,0,32,25
1656762394799,MATH 142A,B03,093481,Chow; Bennett,7,0,32,25
1656762394799,MATH 142A,B04,093558,Chow; Bennett,10,0,32,22
1656762394799,MATH 142A,B05,093559,Chow; Bennett,6,0,32,26
1656762400830,MATH 193A,A01,083224,Rotar; Vladimir,6,0,34,28
1656762400830,MATH 193A,A02,083225,Rotar; Vladimir,3,0,34,31
1656762400830,MATH 193A,A03,083781,Rotar; Vladimir,1,0,34,33
1656762400830,MATH 193A,A04,083782,Rotar; Vladimir,6,0,34,28
1656762400830,MATH 193A,A05,093482,Rotar; Vladimir,6,0,34,28
1656762406862,MATH 197,001,091859,McAuley; Julian John,9999,0,9999,0
1656762406862,MATH 197,002,095566,Kedlaya; Kiran S.,9997,0,9999,2
1656762406862,MATH 197,003,095567,Xiao; Ming,9999,0,9999,0
1656762406862,MATH 197,004,095571,Perols; Johan Lars,9998,0,9999,1
1656762413937,COGS 9,A01,083615,Shannon; Kyle Michael,6,0,75,69
1656762419972,COGS 11,A01,083617,Boyle; Mary E. T.,18,0,48,30
1656762426000,COGS 13,A01,083071,Bastos; Amalia Pinkusfeld,8,0,71,63
1656762432033,COGS 14A,A01,092681,Semenuks; Arturs,0,1,100,100
1656762438064,COGS 14B,A01,083073,Cheng; Tzu-Han,5,0,63,58
1656762444090,COGS 17,A01,092677,Semenuks; Arturs,4,0,81,77
1656762450116,COGS 100,A01,083619,Allen; Michael Gordon,15,0,70,55
1656762456144,COGS 101A,A01,083621,Davis; Joshua Daniel,9,0,68,59
1656762462188,COGS 101B,A01,091572,Allen; Michael Gordon,8,0,65,57
1656762468222,COGS 101C,A01,083625,Delgado; Tania,17,0,35,18
1656762474249,COGS 107A,A01,083627,Boyle; Mary E. T.,13,0,60,47
1656762480281,COGS 118A,A01,083075,Gupta; Anjum,15,0,76,61
1656762486317,CSE 3,A50,083646,Miranda; Gregory Joseph,22,0,50,28
1656762492352,CSE 8A,A50,083650,Miranda; Gregory Joseph,17,1,56,39
1656762498384,CSE 11,A01,083080,Cao; Yingjun,4,15,40,36
1656762504414,CSE 12,A01,083652,Krause-Levy; Sophia Louisa,20,1,120,100
1656762510440,CSE 15L,A01,083654,Morris; Justin Loren,8,0,50,42
1656762510440,CSE 15L,A02,083655,Morris; Justin Loren,8,0,50,42
1656762516472,CSE 20,A01,083657,Tran; Khoa Dang,37,0,80,43
1656762522500,CSE 21,A01,095574,Bach; Quang Tran,21,0,48,27
1656762528530,CSE 30,A01,083084,Eldon; John,4,0,80,76
1656762528530,CSE 30,B01,095061,Bhaskar; Nishant,5,0,50,45
1656762534556,CSE 100,A01,083659,Cao; Yingjun,1,4,70,69
1656762540592,CSE 134B,A01,083661,Powell; Thomas Allan,18,0,100,82
1656762546626,CSE 140,A01,083663,Gungor; Onat,14,0,85,71
1656762552658,CSE 140L,A01,083088,Eldon; John,16,0,100,84
1656762558683,CSE 175,A01,083665,Kumar; Rakesh,3,0,25,22
1656762564710,CSE 190,A00,092507,Dubnov; Shlomo,7,0,20,13
1656762570741,ECE 45,A01,083139,Congero; Spencer William,5,0,75,70
1656762576775,ECE 65,A50,083695,Saad; Andrew S,12,0,30,18
1656762576775,ECE 65,A51,095125,Saad; Andrew S,25,0,26,1
1656762582808,ECE 109,A01,091882,Touri; Behrouz,15,0,70,55
1656762588836,ECE 180,A00,083140,Abi Samra; Nicholas Camill,0,0,30,30
1656762588836,ECE 180,B00,083141,Abi Samra; Nicholas Camill,0,0,30,30
1656762594873,MATH 10A,A01,083735,Patchell; Gregory David,1,0,30,29
1656762594873,MATH 10A,A02,083736,Patchell; Gregory David,20,0,30,10
1656762594873,MATH 10A,A03,083737,Patchell; Gregory David,15,0,30,15
1656762600911,MATH 10B,A01,083207,Lim; Seonhee,7,0,34,27
1656762600911,MATH 10B,A02,083208,Lim; Seonhee,9,0,35,26
1656762600911,MATH 10B,A03,093472,Lim; Seonhee,4,0,34,30
1656762600911,MATH 10B,B01,083739,Sinha; Shubham,9,0,30,21
1656762606954,MATH 18,A01,083743,Cinel; Cameron Alexander,6,0,30,24
1656762606954,MATH 18,A02,083744,Cinel; Cameron Alexander,15,0,30,15
1656762606954,MATH 18,A03,083745,Cinel; Cameron Alexander,8,0,30,22
1656762606954,MATH 18,B01,083748,Rideout; David Porter,3,0,37,34
1656762606954,MATH 18,B02,083749,Rideout; David Porter,3,0,36,33
1656762606954,MATH 18,B03,083750,Rideout; David Porter,1,0,37,36
1656762606954,MATH 18,B04,083751,Rideout; David Porter,5,0,36,31
1656762606954,MATH 18,B05,093473,Rideout; David Porter,4,0,36,32
1656762606954,MATH 18,B06,093474,Rideout; David Porter,5,0,36,31
1656762612980,MATH 20A,A01,083754,Zheng; Zequn,12,0,40,28
1656762619006,MATH 20B,A01,083756,Briones; Jor-el Thomas Caparas,1,0,36,35
1656762619006,MATH 20B,A02,083757,Briones; Jor-el Thomas Caparas,1,0,36,35
1656762619006,MATH 20B,A03,093475,Briones; Jor-el Thomas Caparas,0,0,36,36
1656762625038,MATH 20C,A01,083760,Briones; Jor-el Thomas Caparas,1,0,35,34
1656762625038,MATH 20C,A02,083761,Briones; Jor-el Thomas Caparas,8,0,35,27
1656762625038,MATH 20C,A03,093476,Briones; Jor-el Thomas Caparas,0,1,36,36
1656762625038,MATH 20C,B01,083762,Bach; Quang Tran,0,0,30,30
1656762631076,MATH 20D,A01,083765,Tran; Brian Kha,4,0,30,26
1656762631076,MATH 20D,A02,083766,Tran; Brian Kha,4,0,30,26
1656762631076,MATH 20D,A03,083767,Tran; Brian Kha,2,0,30,28
1656762637112,MATH 20E,A01,083771,Ganguly; Soumya,5,0,32,27
1656762637112,MATH 20E,A02,083772,Ganguly; Soumya,5,0,32,27
1656762637112,MATH 20E,B01,083773,Ciotti; Benjamin,18,0,35,17
1656762637112,MATH 20E,B02,083774,Ciotti; Benjamin,17,0,35,18
1656762643140,MATH 103A,A01,083777,Greenfeld; Be'Eri,2,0,36,34
1656762643140,MATH 103A,A02,083778,Greenfeld; Be'Eri,5,0,36,31
1656762643140,MATH 103A,A03,093561,Greenfeld; Be'Eri,4,0,36,32
1656762643140,MATH 103A,B01,083779,Greenfeld; Be'Eri,6,0,36,30
1656762643140,MATH 103A,B02,083780,Greenfeld; Be'Eri,2,0,36,34
1656762643140,MATH 103A,B03,093562,Greenfeld; Be'Eri,2,0,36,34
1656762649168,MATH 105,A01,085443,Carter; Anne Toulson,13,0,35,22
1656762649168,MATH 105,A02,093477,Carter; Anne Toulson,20,0,35,15
1656762655201,MATH 109,A01,083213,Ganzberger; Geoffrey Michael,2,0,34,32
1656762655201,MATH 109,A02,083214,Ganzberger; Geoffrey Michael,2,0,34,32
1656762655201,MATH 109,A03,093478,Ganzberger; Geoffrey Michael,1,0,34,33
1656762655201,MATH 109,B01,083215,Ganzberger; Geoffrey Michael,1,0,32,31
1656762655201,MATH 109,B02,083216,Ganzberger; Geoffrey Michael,1,0,32,31
1656762655201,MATH 109,B03,093479,Ganzberger; Geoffrey Michael,6,0,32,26
1656762661231,MATH 142A,A01,083219,Chow; Bennett,6,0,32,26
1656762661231,MATH 142A,A02,083220,Chow; Bennett,9,0,32,23
1656762661231,MATH 142A,A03,093480,Chow; Bennett,7,0,32,25
1656762661231,MATH 142A,B03,093481,Chow; Bennett,7,0,32,25
1656762661231,MATH 142A,B04,093558,Chow; Bennett,10,0,32,22
1656762661231,MATH 142A,B05,093559,Chow; Bennett,6,0,32,26
1656762667254,MATH 193A,A01,083224,Rotar; Vladimir,6,0,34,28
1656762667254,MATH 193A,A02,083225,Rotar; Vladimir,3,0,34,31
1656762667254,MATH 193A,A03,083781,Rotar; Vladimir,1,0,34,33
1656762667254,MATH 193A,A04,083782,Rotar; Vladimir,6,0,34,28
1656762667254,MATH 193A,A05,093482,Rotar; Vladimir,6,0,34,28
1656762673283,MATH 197,001,091859,McAuley; Julian John,9999,0,9999,0
1656762673283,MATH 197,002,095566,Kedlaya; Kiran S.,9997,0,9999,2
1656762673283,MATH 197,003,095567,Xiao; Ming,9999,0,9999,0
1656762673283,MATH 197,004,095571,Perols; Johan Lars,9998,0,9999,1
1656762680361,COGS 9,A01,083615,Shannon; Kyle Michael,6,0,75,69
1656762686388,COGS 11,A01,083617,Boyle; Mary E. T.,18,0,48,30
1656762692417,COGS 13,A01,083071,Bastos; Amalia Pinkusfeld,8,0,71,63
1656762698445,COGS 14A,A01,092681,Semenuks; Arturs,0,1,100,100
1656762704472,COGS 14B,A01,083073,Cheng; Tzu-Han,5,0,63,58
1656762710500,COGS 17,A01,092677,Semenuks; Arturs,4,0,81,77
1656762716530,COGS 100,A01,083619,Allen; Michael Gordon,15,0,70,55
1656762722556,COGS 101A,A01,083621,Davis; Joshua Daniel,9,0,68,59
1656762728583,COGS 101B,A01,091572,Allen; Michael Gordon,8,0,65,57
1656762734615,COGS 101C,A01,083625,Delgado; Tania,17,0,35,18
1656762740639,COGS 107A,A01,083627,Boyle; Mary E. T.,13,0,60,47
1656762746668,COGS 118A,A01,083075,Gupta; Anjum,15,0,76,61
1656762752701,CSE 3,A50,083646,Miranda; Gregory Joseph,22,0,50,28
1656762758728,CSE 8A,A50,083650,Miranda; Gregory Joseph,17,1,56,39
1656762764760,CSE 11,A01,083080,Cao; Yingjun,4,15,40,36
1656762770787,CSE 12,A01,083652,Krause-Levy; Sophia Louisa,20,1,120,100
1656762776813,CSE 15L,A01,083654,Morris; Justin Loren,8,0,50,42
1656762776813,CSE 15L,A02,083655,Morris; Justin Loren,8,0,50,42
1656762782840,CSE 20,A01,083657,Tran; Khoa Dang,37,0,80,43
1656762788870,CSE 21,A01,095574,Bach; Quang Tran,21,0,48,27
1656762794899,CSE 30,A01,083084,Eldon; John,4,0,80,76
1656762794899,CSE 30,B01,095061,Bhaskar; Nishant,5,0,50,45
1656762800931,CSE 100,A01,083659,Cao; Yingjun,1,4,70,69
1656762806959,CSE 134B,A01,083661,Powell; Thomas Allan,18,0,100,82
1656762812995,CSE 140,A01,083663,Gungor; Onat,14,0,85,71
1656762819025,CSE 140L,A01,083088,Eldon; John,16,0,100,84
1656762825051,CSE 175,A01,083665,Kumar; Rakesh,3,0,25,22
1656762831079,CSE 190,A00,092507,Dubnov; Shlomo,7,0,20,13
1656762837109,ECE 45,A01,083139,Congero; Spencer William,5,0,75,70
1656762843140,ECE 65,A50,083695,Saad; Andrew S,12,0,30,18
1656762843140,ECE 65,A51,095125,Saad; Andrew S,25,0,26,1
1656762849173,ECE 109,A01,091882,Touri; Behrouz,15,0,70,55
1656762855276,ECE 180,A00,083140,Abi Samra; Nicholas Camill,0,0,30,30
1656762855276,ECE 180,B00,083141,Abi Samra; Nicholas Camill,0,0,30,30
1656762861306,MATH 10A,A01,083735,Patchell; Gregory David,1,0,30,29
1656762861306,MATH 10A,A02,083736,Patchell; Gregory David,20,0,30,10
1656762861306,MATH 10A,A03,083737,Patchell; Gregory David,15,0,30,15
1656762867333,MATH 10B,A01,083207,Lim; Seonhee,7,0,34,27
1656762867333,MATH 10B,A02,083208,Lim; Seonhee,9,0,35,26
1656762867333,MATH 10B,A03,093472,Lim; Seonhee,4,0,34,30
1656762867333,MATH 10B,B01,083739,Sinha; Shubham,9,0,30,21
1656762873360,MATH 18,A01,083743,Cinel; Cameron Alexander,6,0,30,24
1656762873360,MATH 18,A02,083744,Cinel; Cameron Alexander,15,0,30,15
1656762873360,MATH 18,A03,083745,Cinel; Cameron Alexander,8,0,30,22
1656762873360,MATH 18,B01,083748,Rideout; David Porter,3,0,37,34
1656762873360,MATH 18,B02,083749,Rideout; David Porter,3,0,36,33
1656762873360,MATH 18,B03,083750,Rideout; David Porter,1,0,37,36
1656762873360,MATH 18,B04,083751,Rideout; David Porter,5,0,36,31
1656762873360,MATH 18,B05,093473,Rideout; David Porter,4,0,36,32
1656762873360,MATH 18,B06,093474,Rideout; David Porter,5,0,36,31
1656762879385,MATH 20A,A01,083754,Zheng; Zequn,12,0,40,28
1656762885411,MATH 20B,A01,083756,Briones; Jor-el Thomas Caparas,1,0,36,35
1656762885411,MATH 20B,A02,083757,Briones; Jor-el Thomas Caparas,1,0,36,35
1656762885411,MATH 20B,A03,093475,Briones; Jor-el Thomas Caparas,0,0,36,36
1656762891437,MATH 20C,A01,083760,Briones; Jor-el Thomas Caparas,1,0,35,34
1656762891437,MATH 20C,A02,083761,Briones; Jor-el Thomas Caparas,8,0,35,27
1656762891437,MATH 20C,A03,093476,Briones; Jor-el Thomas Caparas,0,1,36,36
1656762891437,MATH 20C,B01,083762,Bach; Quang Tran,0,0,30,30
1656762897463,MATH 20D,A01,083765,Tran; Brian Kha,4,0,30,26
1656762897463,MATH 20D,A02,083766,Tran; Brian Kha,4,0,30,26
1656762897463,MATH 20D,A03,083767,Tran; Brian Kha,2,0,30,28
1656762903496,MATH 20E,A01,083771,Ganguly; Soumya,5,0,32,27
1656762903496,MATH 20E,A02,083772,Ganguly; Soumya,5,0,32,27
1656762903496,MATH 20E,B01,083773,Ciotti; Benjamin,18,0,35,17
1656762903496,MATH 20E,B02,083774,Ciotti; Benjamin,17,0,35,18
1656762909522,MATH 103A,A01,083777,Greenfeld; Be'Eri,2,0,36,34
1656762909522,MATH 103A,A02,083778,Greenfeld; Be'Eri,5,0,36,31
1656762909522,MATH 103A,A03,093561,Greenfeld; Be'Eri,4,0,36,32
1656762909522,MATH 103A,B01,083779,Greenfeld; Be'Eri,6,0,36,30
1656762909522,MATH 103A,B02,083780,Greenfeld; Be'Eri,2,0,36,34
1656762909522,MATH 103A,B03,093562,Greenfeld; Be'Eri,2,0,36,34
1656762915554,MATH 105,A01,085443,Carter; Anne Toulson,13,0,35,22
1656762915554,MATH 105,A02,093477,Carter; Anne Toulson,20,0,35,15
1656762921582,MATH 109,A01,083213,Ganzberger; Geoffrey Michael,2,0,34,32
1656762921582,MATH 109,A02,083214,Ganzberger; Geoffrey Michael,2,0,34,32
1656762921582,MATH 109,A03,093478,Ganzberger; Geoffrey Michael,1,0,34,33
1656762921582,MATH 109,B01,083215,Ganzberger; Geoffrey Michael,1,0,32,31
1656762921582,MATH 109,B02,083216,Ganzberger; Geoffrey Michael,1,0,32,31
1656762921582,MATH 109,B03,093479,Ganzberger; Geoffrey Michael,6,0,32,26
1656762927609,MATH 142A,A01,083219,Chow; Bennett,6,0,32,26
1656762927609,MATH 142A,A02,083220,Chow; Bennett,9,0,32,23
1656762927609,MATH 142A,A03,093480,Chow; Bennett,7,0,32,25
1656762927609,MATH 142A,B03,093481,Chow; Bennett,7,0,32,25
1656762927609,MATH 142A,B04,093558,Chow; Bennett,10,0,32,22
1656762927609,MATH 142A,B05,093559,Chow; Bennett,6,0,32,26
1656762933639,MATH 193A,A01,083224,Rotar; Vladimir,6,0,34,28
1656762933639,MATH 193A,A02,083225,Rotar; Vladimir,3,0,34,31
1656762933639,MATH 193A,A03,083781,Rotar; Vladimir,1,0,34,33
1656762933639,MATH 193A,A04,083782,Rotar; Vladimir,6,0,34,28
1656762933639,MATH 193A,A05,093482,Rotar; Vladimir,6,0,34,28
1656762939664,MATH 197,001,091859,McAuley; Julian John,9999,0,9999,0
1656762939664,MATH 197,002,095566,Kedlaya; Kiran S.,9997,0,9999,2
1656762939664,MATH 197,003,095567,Xiao; Ming,9999,0,9999,0
1656762939664,MATH 197,004,095571,Perols; Johan Lars,9998,0,9999,1
1656762946727,COGS 9,A01,083615,Shannon; Kyle Michael,6,0,75,69
1656762952750,COGS 11,A01,083617,Boyle; Mary E. T.,18,0,48,30
1656762958778,COGS 13,A01,083071,Bastos; Amalia Pinkusfeld,8,0,71,63
1656762964808,COGS 14A,A01,092681,Semenuks; Arturs,0,1,100,100
1656762970834,COGS 14B,A01,083073,Cheng; Tzu-Han,5,0,63,58
1656762976863,COGS 17,A01,092677,Semenuks; Arturs,4,0,81,77
1656762982889,COGS 100,A01,083619,Allen; Michael Gordon,15,0,70,55
1656762988916,COGS 101A,A01,083621,Davis; Joshua Daniel,9,0,68,59
1656762994946,COGS 101B,A01,091572,Allen; Michael Gordon,8,0,65,57
1656763000970,COGS 101C,A01,083625,Delgado; Tania,17,0,35,18
1656763007022,COGS 107A,A01,083627,Boyle; Mary E. T.,13,0,60,47
1656763013046,COGS 118A,A01,083075,Gupta; Anjum,15,0,76,61
1656763019078,CSE 3,A50,083646,Miranda; Gregory Joseph,22,0,50,28
1656763025106,CSE 8A,A50,083650,Miranda; Gregory Joseph,17,1,56,39
1656763031134,CSE 11,A01,083080,Cao; Yingjun,4,15,40,36
1656763037161,CSE 12,A01,083652,Krause-Levy; Sophia Louisa,20,1,120,100
1656763043192,CSE 15L,A01,083654,Morris; Justin Loren,8,0,50,42
1656763043192,CSE 15L,A02,083655,Morris; Justin Loren,8,0,50,42
1656763049220,CSE 20,A01,083657,Tran; Khoa Dang,37,0,80,43
1656763055246,CSE 21,A01,095574,Bach; Quang Tran,21,0,48,27
1656763061273,CSE 30,A01,083084,Eldon; John,4,0,80,76
1656763061273,CSE 30,B01,095061,Bhaskar; Nishant,5,0,50,45
1656763067301,CSE 100,A01,083659,Cao; Yingjun,1,4,70,69
1656763073332,CSE 134B,A01,083661,Powell; Thomas Allan,18,0,100,82
1656763079359,CSE 140,A01,083663,Gungor; Onat,14,0,85,71
1656763085385,CSE 140L,A01,083088,Eldon; John,16,0,100,84
1656763091409,CSE 175,A01,083665,Kumar; Rakesh,3,0,25,22
1656763097432,CSE 190,A00,092507,Dubnov; Shlomo,7,0,20,13
1656763103461,ECE 45,A01,083139,Congero; Spencer William,5,0,75,70
1656763109487,ECE 65,A50,083695,Saad; Andrew S,12,0,30,18
1656763109487,ECE 65,A51,095125,Saad; Andrew S,25,0,26,1
1656763115512,ECE 109,A01,091882,Touri; Behrouz,15,0,70,55
1656763121541,ECE 180,A00,083140,Abi Samra; Nicholas Camill,0,0,30,30
1656763121541,ECE 180,B00,083141,Abi Samra; Nicholas Camill,0,0,30,30
1656763127566,MATH 10A,A01,083735,Patchell; Gregory David,1,0,30,29
1656763127566,MATH 10A,A02,083736,Patchell; Gregory David,20,0,30,10
1656763127566,MATH 10A,A03,083737,Patchell; Gregory David,15,0,30,15
1656763133593,MATH 10B,A01,083207,Lim; Seonhee,7,0,34,27
1656763133593,MATH 10B,A02,083208,Lim; Seonhee,9,0,35,26
1656763133593,MATH 10B,A03,093472,Lim; Seonhee,4,0,34,30
1656763133593,MATH 10B,B01,083739,Sinha; Shubham,9,0,30,21
1656763139623,MATH 18,A01,083743,Cinel; Cameron Alexander,6,0,30,24
1656763139623,MATH 18,A02,083744,Cinel; Cameron Alexander,15,0,30,15
1656763139623,MATH 18,A03,083745,Cinel; Cameron Alexander,8,0,30,22
1656763139623,MATH 18,B01,083748,Rideout; David Porter,3,0,37,34
1656763139623,MATH 18,B02,083749,Rideout; David Porter,3,0,36,33
1656763139623,MATH 18,B03,083750,Rideout; David Porter,1,0,37,36
1656763139623,MATH 18,B04,083751,Rideout; David Porter,5,0,36,31
1656763139623,MATH 18,B05,093473,Rideout; David Porter,4,0,36,32
1656763139623,MATH 18,B06,093474,Rideout; David Porter,5,0,36,31
1656763145648,MATH 20A,A01,083754,Zheng; Zequn,12,0,40,28
1656763151673,MATH 20B,A01,083756,Briones; Jor-el Thomas Caparas,1,0,36,35
1656763151673,MATH 20B,A02,083757,Briones; Jor-el Thomas Caparas,1,0,36,35
1656763151673,MATH 20B,A03,093475,Briones; Jor-el Thomas Caparas,0,0,36,36
1656763157715,MATH 20C,A01,083760,Briones; Jor-el Thomas Caparas,1,0,35,34
1656763157715,MATH 20C,A02,083761,Briones; Jor-el Thomas Caparas,8,0,35,27
1656763157715,MATH 20C,A03,093476,Briones; Jor-el Thomas Caparas,0,1,36,36
1656763157715,MATH 20C,B01,083762,Bach; Quang Tran,0,0,30,30
1656763163755,MATH 20D,A01,083765,Tran; Brian Kha,4,0,30,26
1656763163755,MATH 20D,A02,083766,Tran; Brian Kha,4,0,30,26
1656763163755,MATH 20D,A03,083767,Tran; Brian Kha,2,0,30,28
1656763169788,MATH 20E,A01,083771,Ganguly; Soumya,5,0,32,27
1656763169788,MATH 20E,A02,083772,Ganguly; Soumya,5,0,32,27
1656763169788,MATH 20E,B01,083773,Ciotti; Benjamin,18,0,35,17
1656763169788,MATH 20E,B02,083774,Ciotti; Benjamin,17,0,35,18
1656763175818,MATH 103A,A01,083777,Greenfeld; Be'Eri,2,0,36,34
1656763175818,MATH 103A,A02,083778,Greenfeld; Be'Eri,5,0,36,31
1656763175818,MATH 103A,A03,093561,Greenfeld; Be'Eri,4,0,36,32
1656763175818,MATH 103A,B01,083779,Greenfeld; Be'Eri,6,0,36,30
1656763175818,MATH 103A,B02,083780,Greenfeld; Be'Eri,2,0,36,34
1656763175818,MATH 103A,B03,093562,Greenfeld; Be'Eri,2,0,36,34
1656763181844,MATH 105,A01,085443,Carter; Anne Toulson,13,0,35,22
1656763181844,MATH 105,A02,093477,Carter; Anne Toulson,20,0,35,15
1656763187870,MATH 109,A01,083213,Ganzberger; Geoffrey Michael,2,0,34,32
1656763187870,MATH 109,A02,083214,Ganzberger; Geoffrey Michael,2,0,34,32
1656763187870,MATH 109,A03,093478,Ganzberger; Geoffrey Michael,1,0,34,33
1656763187870,MATH 109,B01,083215,Ganzberger; Geoffrey Michael,1,0,32,31
1656763187870,MATH 109,B02,083216,Ganzberger; Geoffrey Michael,1,0,32,31
1656763187870,MATH 109,B03,093479,Ganzberger; Geoffrey Michael,6,0,32,26
1656763193904,MATH 142A,A01,083219,Chow; Bennett,6,0,32,26
1656763193904,MATH 142A,A02,083220,Chow; Bennett,9,0,32,23
1656763193904,MATH 142A,A03,093480,Chow; Bennett,7,0,32,25
1656763193904,MATH 142A,B03,093481,Chow; Bennett,7,0,32,25
1656763193904,MATH 142A,B04,093558,Chow; Bennett,10,0,32,22
1656763193904,MATH 142A,B05,093559,Chow; Bennett,6,0,32,26
1656763199930,MATH 193A,A01,083224,Rotar; Vladimir,6,0,34,28
1656763199930,MATH 193A,A02,083225,Rotar; Vladimir,3,0,34,31
1656763199930,MATH 193A,A03,083781,Rotar; Vladimir,1,0,34,33
1656763199930,MATH 193A,A04,083782,Rotar; Vladimir,6,0,34,28
1656763199930,MATH 193A,A05,093482,Rotar; Vladimir,6,0,34,28
1656763205953,MATH 197,001,091859,McAuley; Julian John,9999,0,9999,0
1656763205953,MATH 197,002,095566,Kedlaya; Kiran S.,9997,0,9999,2
1656763205953,MATH 197,003,095567,Xiao; Ming,9999,0,9999,0
1656763205953,MATH 197,004,095571,Perols; Johan Lars,9998,0,9999,1
1656763213026,COGS 9,A01,083615,Shannon; Kyle Michael,6,0,75,69
1656763219055,COGS 11,A01,083617,Boyle; Mary E. T.,18,0,48,30
1656763225082,COGS 13,A01,083071,Bastos; Amalia Pinkusfeld,8,0,71,63
1656763231107,COGS 14A,A01,092681,Semenuks; Arturs,0,1,100,100
1656763237134,COGS 14B,A01,083073,Cheng; Tzu-Han,5,0,63,58
1656763243158,COGS 17,A01,092677,Semenuks; Arturs,4,0,81,77
1656763249182,COGS 100,A01,083619,Allen; Michael Gordon,15,0,70,55
1656763255206,COGS 101A,A01,083621,Davis; Joshua Daniel,9,0,68,59
1656763261236,COGS 101B,A01,091572,Allen; Michael Gordon,8,0,65,57
1656763267260,COGS 101C,A01,083625,Delgado; Tania,17,0,35,18
1656763273289,COGS 107A,A01,083627,Boyle; Mary E. T.,13,0,60,47
1656763279322,COGS 118A,A01,083075,Gupta; Anjum,15,0,76,61
1656763285352,CSE 3,A50,083646,Miranda; Gregory Joseph,22,0,50,28
1656763291385,CSE 8A,A50,083650,Miranda; Gregory Joseph,17,1,56,39
1656763297414,CSE 11,A01,083080,Cao; Yingjun,4,15,40,36
1656763303444,CSE 12,A01,083652,Krause-Levy; Sophia Louisa,20,1,120,100
1656763309473,CSE 15L,A01,083654,Morris; Justin Loren,8,0,50,42
1656763309473,CSE 15L,A02,083655,Morris; Justin Loren,8,0,50,42
1656763315498,CSE 20,A01,083657,Tran; Khoa Dang,37,0,80,43
1656763321524,CSE 21,A01,095574,Bach; Quang Tran,21,0,48,27
1656763327554,CSE 30,A01,083084,Eldon; John,4,0,80,76
1656763327554,CSE 30,B01,095061,Bhaskar; Nishant,5,0,50,45
1656763333582,CSE 100,A01,083659,Cao; Yingjun,1,4,70,69
1656763339606,CSE 134B,A01,083661,Powell; Thomas Allan,18,0,100,82
1656763345629,CSE 140,A01,083663,Gungor; Onat,14,0,85,71
1656763351658,CSE 140L,A01,083088,Eldon; John,16,0,100,84
1656763357686,CSE 175,A01,083665,Kumar; Rakesh,3,0,25,22
1656763363709,CSE 190,A00,092507,Dubnov; Shlomo,7,0,20,13
1656763369735,ECE 45,A01,083139,Congero; Spencer William,5,0,75,70
1656763375772,ECE 65,A50,083695,Saad; Andrew S,12,0,30,18
1656763375772,ECE 65,A51,095125,Saad; Andrew S,25,0,26,1
1656763381805,ECE 109,A01,091882,Touri; Behrouz,15,0,70,55
1656763387829,ECE 180,A00,083140,Abi Samra; Nicholas Camill,0,0,30,30
1656763387829,ECE 180,B00,083141,Abi Samra; Nicholas Camill,0,0,30,30
1656763393858,MATH 10A,A01,083735,Patchell; Gregory David,1,0,30,29
1656763393858,MATH 10A,A02,083736,Patchell; Gregory David,20,0,30,10
1656763393858,MATH 10A,A03,083737,Patchell; Gregory David,15,0,30,15
1656763399890,MATH 10B,A01,083207,Lim; Seonhee,7,0,34,27
1656763399890,MATH 10B,A02,083208,Lim; Seonhee,9,0,35,26
1656763399890,MATH 10B,A03,093472,Lim; Seonhee,4,0,34,30
1656763399890,MATH 10B,B01,083739,Sinha; Shubham,9,0,30,21
1656763405916,MATH 18,A01,083743,Cinel; Cameron Alexander,6,0,30,24
1656763405916,MATH 18,A02,083744,Cinel; Cameron Alexander,15,0,30,15
1656763405916,MATH 18,A03,083745,Cinel; Cameron Alexander,8,0,30,22
1656763405916,MATH 18,B01,083748,Rideout; David Porter,3,0,37,34
1656763405916,MATH 18,B02,083749,Rideout; David Porter,3,0,36,33
1656763405916,MATH 18,B03,083750,Rideout; David Porter,1,0,37,36
1656763405916,MATH 18,B04,083751,Rideout; David Porter,5,0,36,31
1656763405916,MATH 18,B05,093473,Rideout; David Porter,4,0,36,32
1656763405916,MATH 18,B06,093474,Rideout; David Porter,5,0,36,31
1656763411943,MATH 20A,A01,083754,Zheng; Zequn,12,0,40,28
1656763417966,MATH 20B,A01,083756,Briones; Jor-el Thomas Caparas,1,0,36,35
1656763417966,MATH 20B,A02,083757,Briones; Jor-el Thomas Caparas,1,0,36,35
1656763417966,MATH 20B,A03,093475,Briones; Jor-el Thomas Caparas,0,0,36,36
1656763423992,MATH 20C,A01,083760,Briones; Jor-el Thomas Caparas,1,0,35,34
1656763423992,MATH 20C,A02,083761,Briones; Jor-el Thomas Caparas,8,0,35,27
1656763423992,MATH 20C,A03,093476,Briones; Jor-el Thomas Caparas,0,1,36,36
1656763423992,MATH 20C,B01,083762,Bach; Quang Tran,0,0,30,30
1656763430017,MATH 20D,A01,083765,Tran; Brian Kha,4,0,30,26
1656763430017,MATH 20D,A02,083766,Tran; Brian Kha,4,0,30,26
1656763430017,MATH 20D,A03,083767,Tran; Brian Kha,2,0,30,28
1656763436047,MATH 20E,A01,083771,Ganguly; Soumya,5,0,32,27
1656763436047,MATH 20E,A02,083772,Ganguly; Soumya,5,0,32,27
1656763436047,MATH 20E,B01,083773,Ciotti; Benjamin,18,0,35,17
1656763436047,MATH 20E,B02,083774,Ciotti; Benjamin,17,0,35,18
1656763442071,MATH 103A,A01,083777,Greenfeld; Be'Eri,2,0,36,34
1656763442071,MATH 103A,A02,083778,Greenfeld; Be'Eri,5,0,36,31
1656763442071,MATH 103A,A03,093561,Greenfeld; Be'Eri,4,0,36,32
1656763442071,MATH 103A,B01,083779,Greenfeld; Be'Eri,6,0,36,30
1656763442071,MATH 103A,B02,083780,Greenfeld; Be'Eri,2,0,36,34
1656763442071,MATH 103A,B03,093562,Greenfeld; Be'Eri,2,0,36,34
1656763448100,MATH 105,A01,085443,Carter; Anne Toulson,13,0,35,22
1656763448100,MATH 105,A02,093477,Carter; Anne Toulson,20,0,35,15
1656763454218,MATH 109,A01,083213,Ganzberger; Geoffrey Michael,2,0,34,32
1656763454218,MATH 109,A02,083214,Ganzberger; Geoffrey Michael,2,0,34,32
1656763454218,MATH 109,A03,093478,Ganzberger; Geoffrey Michael,1,0,34,33
1656763454218,MATH 109,B01,083215,Ganzberger; Geoffrey Michael,1,0,32,31
1656763454218,MATH 109,B02,083216,Ganzberger; Geoffrey Michael,1,0,32,31
1656763454218,MATH 109,B03,093479,Ganzberger; Geoffrey Michael,6,0,32,26
1656763460259,MATH 142A,A01,083219,Chow; Bennett,6,0,32,26
1656763460259,MATH 142A,A02,083220,Chow; Bennett,9,0,32,23
1656763460259,MATH 142A,A03,093480,Chow; Bennett,7,0,32,25
1656763460259,MATH 142A,B03,093481,Chow; Bennett,7,0,32,25
1656763460259,MATH 142A,B04,093558,Chow; Bennett,10,0,32,22
1656763460259,MATH 142A,B05,093559,Chow; Bennett,6,0,32,26
1656763466291,MATH 193A,A01,083224,Rotar; Vladimir,6,0,34,28
1656763466291,MATH 193A,A02,083225,Rotar; Vladimir,3,0,34,31
1656763466291,MATH 193A,A03,083781,Rotar; Vladimir,1,0,34,33
1656763466291,MATH 193A,A04,083782,Rotar; Vladimir,6,0,34,28
1656763466291,MATH 193A,A05,093482,Rotar; Vladimir,6,0,34,28
1656763472323,MATH 197,001,091859,McAuley; Julian John,9999,0,9999,0
1656763472323,MATH 197,002,095566,Kedlaya; Kiran S.,9997,0,9999,2
1656763472323,MATH 197,003,095567,Xiao; Ming,9999,0,9999,0
1656763472323,MATH 197,004,095571,Perols; Johan Lars,9998,0,9999,1
1656763479386,COGS 9,A01,083615,Shannon; Kyle Michael,6,0,75,69
1656763485412,COGS 11,A01,083617,Boyle; Mary E. T.,18,0,48,30
1656763491440,COGS 13,A01,083071,Bastos; Amalia Pinkusfeld,8,0,71,63
1656763497466,COGS 14A,A01,092681,Semenuks; Arturs,0,1,100,100
1656763503492,COGS 14B,A01,083073,Cheng; Tzu-Han,5,0,63,58
1656763509522,COGS 17,A01,092677,Semenuks; Arturs,4,0,81,77
1656763515550,COGS 100,A01,083619,Allen; Michael Gordon,15,0,70,55
1656763521579,COGS 101A,A01,083621,Davis; Joshua Daniel,9,0,68,59
1656763527605,COGS 101B,A01,091572,Allen; Michael Gordon,8,0,65,57
1656763533634,COGS 101C,A01,083625,Delgado; Tania,17,0,35,18
1656763539661,COGS 107A,A01,083627,Boyle; Mary E. T.,13,0,60,47
1656763545687,COGS 118A,A01,083075,Gupta; Anjum,15,0,76,61
1656763551716,CSE 3,A50,083646,Miranda; Gregory Joseph,22,0,50,28
1656763557746,CSE 8A,A50,083650,Miranda; Gregory Joseph,17,1,56,39
1656763563784,CSE 11,A01,083080,Cao; Yingjun,4,15,40,36
1656763569808,CSE 12,A01,083652,Krause-Levy; Sophia Louisa,20,1,120,100
1656763575831,CSE 15L,A01,083654,Morris; Justin Loren,8,0,50,42
1656763575831,CSE 15L,A02,083655,Morris; Justin Loren,8,0,50,42
1656763581857,CSE 20,A01,083657,Tran; Khoa Dang,37,0,80,43
1656763587890,CSE 21,A01,095574,Bach; Quang Tran,21,0,48,27
1656763593916,CSE 30,A01,083084,Eldon; John,4,0,80,76
1656763593916,CSE 30,B01,095061,Bhaskar; Nishant,5,0,50,45
1656763599941,CSE 100,A01,083659,Cao; Yingjun,1,4,70,69
1656763605968,CSE 134B,A01,083661,Powell; Thomas Allan,18,0,100,82
1656763611998,CSE 140,A01,083663,Gungor; Onat,14,0,85,71
1656763618026,CSE 140L,A01,083088,Eldon; John,16,0,100,84
1656763624050,CSE 175,A01,083665,Kumar; Rakesh,3,0,25,22
1656763630075,CSE 190,A00,092507,Dubnov; Shlomo,7,0,20,13
1656763636101,ECE 45,A01,083139,Congero; Spencer William,5,0,75,70
1656763642131,ECE 65,A50,083695,Saad; Andrew S,12,0,30,18
1656763642131,ECE 65,A51,095125,Saad; Andrew S,25,0,26,1
1656763648156,ECE 109,A01,091882,Touri; Behrouz,15,0,70,55
1656763654189,ECE 180,A00,083140,Abi Samra; Nicholas Camill,0,0,30,30
1656763654189,ECE 180,B00,083141,Abi Samra; Nicholas Camill,0,0,30,30
1656763660215,MATH 10A,A01,083735,Patchell; Gregory David,1,0,30,29
1656763660215,MATH 10A,A02,083736,Patchell; Gregory David,20,0,30,10
1656763660215,MATH 10A,A03,083737,Patchell; Gregory David,15,0,30,15
1656763666241,MATH 10B,A01,083207,Lim; Seonhee,7,0,34,27
1656763666241,MATH 10B,A02,083208,Lim; Seonhee,9,0,35,26
1656763666241,MATH 10B,A03,093472,Lim; Seonhee,4,0,34,30
1656763666241,MATH 10B,B01,083739,Sinha; Shubham,9,0,30,21
1656763672275,MATH 18,A01,083743,Cinel; Cameron Alexander,6,0,30,24
1656763672275,MATH 18,A02,083744,Cinel; Cameron Alexander,15,0,30,15
1656763672275,MATH 18,A03,083745,Cinel; Cameron Alexander,8,0,30,22
1656763672275,MATH 18,B01,083748,Rideout; David Porter,3,0,37,34
1656763672275,MATH 18,B02,083749,Rideout; David Porter,3,0,36,33
1656763672275,MATH 18,B03,083750,Rideout; David Porter,1,0,37,36
1656763672275,MATH 18,B04,083751,Rideout; David Porter,5,0,36,31
1656763672275,MATH 18,B05,093473,Rideout; David Porter,4,0,36,32
1656763672275,MATH 18,B06,093474,Rideout; David Porter,5,0,36,31
1656763678315,MATH 20A,A01,083754,Zheng; Zequn,12,0,40,28
1656763684344,MATH 20B,A01,083756,Briones; Jor-el Thomas Caparas,1,0,36,35
1656763684344,MATH 20B,A02,083757,Briones; Jor-el Thomas Caparas,1,0,36,35
1656763684344,MATH 20B,A03,093475,Briones; Jor-el Thomas Caparas,0,0,36,36
1656763690369,MATH 20C,A01,083760,Briones; Jor-el Thomas Caparas,1,0,35,34
1656763690369,MATH 20C,A02,083761,Briones; Jor-el Thomas Caparas,8,0,35,27
1656763690369,MATH 20C,A03,093476,Briones; Jor-el Thomas Caparas,0,1,36,36
1656763690369,MATH 20C,B01,083762,Bach; Quang Tran,0,0,30,30
1656763696393,MATH 20D,A01,083765,Tran; Brian Kha,4,0,30,26
1656763696393,MATH 20D,A02,083766,Tran; Brian Kha,4,0,30,26
1656763696393,MATH 20D,A03,083767,Tran; Brian Kha,2,0,30,28
1656763702415,MATH 20E,A01,083771,Ganguly; Soumya,5,0,32,27
1656763702415,MATH 20E,A02,083772,Ganguly; Soumya,5,0,32,27
1656763702415,MATH 20E,B01,083773,Ciotti; Benjamin,18,0,35,17
1656763702415,MATH 20E,B02,083774,Ciotti; Benjamin,17,0,35,18
1656763708440,MATH 103A,A01,083777,Greenfeld; Be'Eri,2,0,36,34
1656763708440,MATH 103A,A02,083778,Greenfeld; Be'Eri,5,0,36,31
1656763708440,MATH 103A,A03,093561,Greenfeld; Be'Eri,4,0,36,32
1656763708440,MATH 103A,B01,083779,Greenfeld; Be'Eri,6,0,36,30
1656763708440,MATH 103A,B02,083780,Greenfeld; Be'Eri,2,0,36,34
1656763708440,MATH 103A,B03,093562,Greenfeld; Be'Eri,2,0,36,34
1656763714467,MATH 105,A01,085443,Carter; Anne Toulson,13,0,35,22
1656763714467,MATH 105,A02,093477,Carter; Anne Toulson,20,0,35,15
1656763720494,MATH 109,A01,083213,Ganzberger; Geoffrey Michael,2,0,34,32
1656763720494,MATH 109,A02,083214,Ganzberger; Geoffrey Michael,2,0,34,32
1656763720494,MATH 109,A03,093478,Ganzberger; Geoffrey Michael,1,0,34,33
1656763720494,MATH 109,B01,083215,Ganzberger; Geoffrey Michael,1,0,32,31
1656763720494,MATH 109,B02,083216,Ganzberger; Geoffrey Michael,1,0,32,31
1656763720494,MATH 109,B03,093479,Ganzberger; Geoffrey Michael,6,0,32,26
1656763726520,MATH 142A,A01,083219,Chow; Bennett,6,0,32,26
1656763726520,MATH 142A,A02,083220,Chow; Bennett,9,0,32,23
1656763726520,MATH 142A,A03,093480,Chow; Bennett,7,0,32,25
1656763726520,MATH 142A,B03,093481,Chow; Bennett,7,0,32,25
1656763726520,MATH 142A,B04,093558,Chow; Bennett,10,0,32,22
1656763726520,MATH 142A,B05,093559,Chow; Bennett,6,0,32,26
1656763732546,MATH 193A,A01,083224,Rotar; Vladimir,6,0,34,28
1656763732546,MATH 193A,A02,083225,Rotar; Vladimir,3,0,34,31
1656763732546,MATH 193A,A03,083781,Rotar; Vladimir,1,0,34,33
1656763732546,MATH 193A,A04,083782,Rotar; Vladimir,6,0,34,28
1656763732546,MATH 193A,A05,093482,Rotar; Vladimir,6,0,34,28
1656763738571,MATH 197,001,091859,McAuley; Julian John,9999,0,9999,0
1656763738571,MATH 197,002,095566,Kedlaya; Kiran S.,9997,0,9999,2
1656763738571,MATH 197,003,095567,Xiao; Ming,9999,0,9999,0
1656763738571,MATH 197,004,095571,Perols; Johan Lars,9998,0,9999,1
1656763745651,COGS 9,A01,083615,Shannon; Kyle Michael,6,0,75,69
1656763751679,COGS 11,A01,083617,Boyle; Mary E. T.,18,0,48,30
1656763757709,COGS 13,A01,083071,Bastos; Amalia Pinkusfeld,8,0,71,63
1656763763739,COGS 14A,A01,092681,Semenuks; Arturs,0,1,100,100
1656763769769,COGS 14B,A01,083073,Cheng; Tzu-Han,5,0,63,58
1656763775795,COGS 17,A01,092677,Semenuks; Arturs,4,0,81,77
1656763781821,COGS 100,A01,083619,Allen; Michael Gordon,15,0,70,55
1656763787849,COGS 101A,A01,083621,Davis; Joshua Daniel,9,0,68,59
1656763793876,COGS 101B,A01,091572,Allen; Michael Gordon,8,0,65,57
1656763799916,COGS 101C,A01,083625,Delgado; Tania,17,0,35,18
1656763805944,COGS 107A,A01,083627,Boyle; Mary E. T.,13,0,60,47
1656763811973,COGS 118A,A01,083075,Gupta; Anjum,15,0,76,61
1656763818003,CSE 3,A50,083646,Miranda; Gregory Joseph,22,0,50,28
1656763824030,CSE 8A,A50,083650,Miranda; Gregory Joseph,17,1,56,39
1656763830056,CSE 11,A01,083080,Cao; Yingjun,4,15,40,36
1656763836084,CSE 12,A01,083652,Krause-Levy; Sophia Louisa,20,1,120,100
1656763842114,CSE 15L,A01,083654,Morris; Justin Loren,8,0,50,42
1656763842114,CSE 15L,A02,083655,Morris; Justin Loren,8,0,50,42
1656763848148,CSE 20,A01,083657,Tran; Khoa Dang,37,0,80,43
1656763854171,CSE 21,A01,095574,Bach; Quang Tran,21,0,48,27
1656763860202,CSE 30,A01,083084,Eldon; John,4,0,80,76
1656763860202,CSE 30,B01,095061,Bhaskar; Nishant,5,0,50,45
1656763866231,CSE 100,A01,083659,Cao; Yingjun,1,4,70,69
1656763872260,CSE 134B,A01,083661,Powell; Thomas Allan,18,0,100,82
1656763878300,CSE 140,A01,083663,Gungor; Onat,14,0,85,71
1656763884329,CSE 140L,A01,083088,Eldon; John,16,0,100,84
1656763890359,CSE 175,A01,083665,Kumar; Rakesh,3,0,25,22
1656763896385,CSE 190,A00,092507,Dubnov; Shlomo,7,0,20,13
1656763902415,ECE 45,A01,083139,Congero; Spencer William,5,0,75,70
1656763908439,ECE 65,A50,083695,Saad; Andrew S,12,0,30,18
1656763908439,ECE 65,A51,095125,Saad; Andrew S,25,0,26,1
1656763914469,ECE 109,A01,091882,Touri; Behrouz,15,0,70,55
1656763920496,ECE 180,A00,083140,Abi Samra; Nicholas Camill,0,0,30,30
1656763920496,ECE 180,B00,083141,Abi Samra; Nicholas Camill,0,0,30,30
1656763926538,MATH 10A,A01,083735,Patchell; Gregory David,1,0,30,29
1656763926538,MATH 10A,A02,083736,Patchell; Gregory David,20,0,30,10
1656763926538,MATH 10A,A03,083737,Patchell; Gregory David,15,0,30,15
1656763932570,MATH 10B,A01,083207,Lim; Seonhee,7,0,34,27
1656763932570,MATH 10B,A02,083208,Lim; Seonhee,9,0,35,26
1656763932570,MATH 10B,A03,093472,Lim; Seonhee,4,0,34,30
1656763932570,MATH 10B,B01,083739,Sinha; Shubham,9,0,30,21
1656763938604,MATH 18,A01,083743,Cinel; Cameron Alexander,6,0,30,24
1656763938604,MATH 18,A02,083744,Cinel; Cameron Alexander,15,0,30,15
1656763938604,MATH 18,A03,083745,Cinel; Cameron Alexander,8,0,30,22
1656763938604,MATH 18,B01,083748,Rideout; David Porter,3,0,37,34
1656763938604,MATH 18,B02,083749,Rideout; David Porter,3,0,36,33
1656763938604,MATH 18,B03,083750,Rideout; David Porter,1,0,37,36
1656763938604,MATH 18,B04,083751,Rideout; David Porter,5,0,36,31
1656763938604,MATH 18,B05,093473,Rideout; David Porter,4,0,36,32
1656763938604,MATH 18,B06,093474,Rideout; David Porter,5,0,36,31
1656763944639,MATH 20A,A01,083754,Zheng; Zequn,12,0,40,28
1656763950677,MATH 20B,A01,083756,Briones; Jor-el Thomas Caparas,1,0,36,35
1656763950677,MATH 20B,A02,083757,Briones; Jor-el Thomas Caparas,1,0,36,35
1656763950677,MATH 20B,A03,093475,Briones; Jor-el Thomas Caparas,0,0,36,36
1656763956702,MATH 20C,A01,083760,Briones; Jor-el Thomas Caparas,1,0,35,34
1656763956702,MATH 20C,A02,083761,Briones; Jor-el Thomas Caparas,8,0,35,27
1656763956702,MATH 20C,A03,093476,Briones; Jor-el Thomas Caparas,0,1,36,36
1656763956702,MATH 20C,B01,083762,Bach; Quang Tran,0,0,30,30
1656763962728,MATH 20D,A01,083765,Tran; Brian Kha,4,0,30,26
1656763962728,MATH 20D,A02,083766,Tran; Brian Kha,4,0,30,26
1656763962728,MATH 20D,A03,083767,Tran; Brian Kha,2,0,30,28
1656763968757,MATH 20E,A01,083771,Ganguly; Soumya,5,0,32,27
1656763968757,MATH 20E,A02,083772,Ganguly; Soumya,5,0,32,27
1656763968757,MATH 20E,B01,083773,Ciotti; Benjamin,18,0,35,17
1656763968757,MATH 20E,B02,083774,Ciotti; Benjamin,17,0,35,18
1656763974783,MATH 103A,A01,083777,Greenfeld; Be'Eri,2,0,36,34
1656763974783,MATH 103A,A02,083778,Greenfeld; Be'Eri,5,0,36,31
1656763974783,MATH 103A,A03,093561,Greenfeld; Be'Eri,4,0,36,32
1656763974783,MATH 103A,B01,083779,Greenfeld; Be'Eri,6,0,36,30
1656763974783,MATH 103A,B02,083780,Greenfeld; Be'Eri,2,0,36,34
1656763974783,MATH 103A,B03,093562,Greenfeld; Be'Eri,2,0,36,34
1656763980815,MATH 105,A01,085443,Carter; Anne Toulson,13,0,35,22
1656763980815,MATH 105,A02,093477,Carter; Anne Toulson,20,0,35,15
1656763986844,MATH 109,A01,083213,Ganzberger; Geoffrey Michael,2,0,34,32
1656763986844,MATH 109,A02,083214,Ganzberger; Geoffrey Michael,2,0,34,32
1656763986844,MATH 109,A03,093478,Ganzberger; Geoffrey Michael,1,0,34,33
1656763986844,MATH 109,B01,083215,Ganzberger; Geoffrey Michael,1,0,32,31
1656763986844,MATH 109,B02,083216,Ganzberger; Geoffrey Michael,1,0,32,31
1656763986844,MATH 109,B03,093479,Ganzberger; Geoffrey Michael,6,0,32,26
1656763992879,MATH 142A,A01,083219,Chow; Bennett,6,0,32,26
1656763992879,MATH 142A,A02,083220,Chow; Bennett,9,0,32,23
1656763992879,MATH 142A,A03,093480,Chow; Bennett,7,0,32,25
1656763992879,MATH 142A,B03,093481,Chow; Bennett,7,0,32,25
1656763992879,MATH 142A,B04,093558,Chow; Bennett,10,0,32,22
1656763992879,MATH 142A,B05,093559,Chow; Bennett,6,0,32,26
1656763998915,MATH 193A,A01,083224,Rotar; Vladimir,6,0,34,28
1656763998915,MATH 193A,A02,083225,Rotar; Vladimir,3,0,34,31
1656763998915,MATH 193A,A03,083781,Rotar; Vladimir,1,0,34,33
1656763998915,MATH 193A,A04,083782,Rotar; Vladimir,6,0,34,28
1656763998915,MATH 193A,A05,093482,Rotar; Vladimir,6,0,34,28
1656764004944,MATH 197,001,091859,McAuley; Julian John,9999,0,9999,0
1656764004944,MATH 197,002,095566,Kedlaya; Kiran S.,9997,0,9999,2
1656764004944,MATH 197,003,095567,Xiao; Ming,9999,0,9999,0
1656764004944,MATH 197,004,095571,Perols; Johan Lars,9998,0,9999,1
1656764012041,COGS 9,A01,083615,Shannon; Kyle Michael,6,0,75,69
1656764018067,COGS 11,A01,083617,Boyle; Mary E. T.,18,0,48,30
1656764024093,COGS 13,A01,083071,Bastos; Amalia Pinkusfeld,8,0,71,63
1656764030117,COGS 14A,A01,092681,Semenuks; Arturs,0,1,100,100
1656764036151,COGS 14B,A01,083073,Cheng; Tzu-Han,5,0,63,58
1656764042180,COGS 17,A01,092677,Semenuks; Arturs,4,0,81,77
1656764048291,COGS 100,A01,083619,Allen; Michael Gordon,15,0,70,55
1656764054320,COGS 101A,A01,083621,Davis; Joshua Daniel,9,0,68,59
1656764060353,COGS 101B,A01,091572,Allen; Michael Gordon,8,0,65,57
1656764066383,COGS 101C,A01,083625,Delgado; Tania,17,0,35,18
1656764072411,COGS 107A,A01,083627,Boyle; Mary E. T.,13,0,60,47
1656764078438,COGS 118A,A01,083075,Gupta; Anjum,15,0,76,61
1656764084471,CSE 3,A50,083646,Miranda; Gregory Joseph,22,0,50,28
1656764090504,CSE 8A,A50,083650,Miranda; Gregory Joseph,17,1,56,39
1656764096529,CSE 11,A01,083080,Cao; Yingjun,4,15,40,36
1656764102571,CSE 12,A01,083652,Krause-Levy; Sophia Louisa,20,1,120,100
1656764108599,CSE 15L,A01,083654,Morris; Justin Loren,8,0,50,42
1656764108599,CSE 15L,A02,083655,Morris; Justin Loren,8,0,50,42
1656764114628,CSE 20,A01,083657,Tran; Khoa Dang,37,0,80,43
1656764120657,CSE 21,A01,095574,Bach; Quang Tran,21,0,48,27
1656764126687,CSE 30,A01,083084,Eldon; John,4,0,80,76
1656764126687,CSE 30,B01,095061,Bhaskar; Nishant,5,0,50,45
1656764132718,CSE 100,A01,083659,Cao; Yingjun,1,4,70,69
1656764138746,CSE 134B,A01,083661,Powell; Thomas Allan,18,0,100,82
1656764144775,CSE 140,A01,083663,Gungor; Onat,14,0,85,71
1656764150800,CSE 140L,A01,083088,Eldon; John,16,0,100,84
1656764156827,CSE 175,A01,083665,Kumar; Rakesh,3,0,25,22
1656764162861,CSE 190,A00,092507,Dubnov; Shlomo,7,0,20,13
1656764168887,ECE 45,A01,083139,Congero; Spencer William,5,0,75,70
1656764174921,ECE 65,A50,083695,Saad; Andrew S,12,0,30,18
1656764174921,ECE 65,A51,095125,Saad; Andrew S,25,0,26,1
1656764180951,ECE 109,A01,091882,Touri; Behrouz,15,0,70,55
1656764186980,ECE 180,A00,083140,Abi Samra; Nicholas Camill,0,0,30,30
1656764186980,ECE 180,B00,083141,Abi Samra; Nicholas Camill,0,0,30,30
1656764193010,MATH 10A,A01,083735,Patchell; Gregory David,1,0,30,29
1656764193010,MATH 10A,A02,083736,Patchell; Gregory David,20,0,30,10
1656764193010,MATH 10A,A03,083737,Patchell; Gregory David,15,0,30,15
1656764199038,MATH 10B,A01,083207,Lim; Seonhee,7,0,34,27
1656764199038,MATH 10B,A02,083208,Lim; Seonhee,9,0,35,26
1656764199038,MATH 10B,A03,093472,Lim; Seonhee,4,0,34,30
1656764199038,MATH 10B,B01,083739,Sinha; Shubham,9,0,30,21
1656764205087,MATH 18,A01,083743,Cinel; Cameron Alexander,6,0,30,24
1656764205087,MATH 18,A02,083744,Cinel; Cameron Alexander,15,0,30,15
1656764205087,MATH 18,A03,083745,Cinel; Cameron Alexander,8,0,30,22
1656764205087,MATH 18,B01,083748,Rideout; David Porter,3,0,37,34
1656764205087,MATH 18,B02,083749,Rideout; David Porter,3,0,36,33
1656764205087,MATH 18,B03,083750,Rideout; David Porter,1,0,37,36
1656764205087,MATH 18,B04,083751,Rideout; David Porter,5,0,36,31
1656764205087,MATH 18,B05,093473,Rideout; David Porter,4,0,36,32
1656764205087,MATH 18,B06,093474,Rideout; David Porter,5,0,36,31
1656764211114,MATH 20A,A01,083754,Zheng; Zequn,12,0,40,28
1656764217149,MATH 20B,A01,083756,Briones; Jor-el Thomas Caparas,1,0,36,35
1656764217149,MATH 20B,A02,083757,Briones; Jor-el Thomas Caparas,1,0,36,35
1656764217149,MATH 20B,A03,093475,Briones; Jor-el Thomas Caparas,0,0,36,36
1656764223194,MATH 20C,A01,083760,Briones; Jor-el Thomas Caparas,1,0,35,34
1656764223194,MATH 20C,A02,083761,Briones; Jor-el Thomas Caparas,8,0,35,27
1656764223194,MATH 20C,A03,093476,Briones; Jor-el Thomas Caparas,0,1,36,36
1656764223194,MATH 20C,B01,083762,Bach; Quang Tran,0,0,30,30
1656764229220,MATH 20D,A01,083765,Tran; Brian Kha,4,0,30,26
1656764229220,MATH 20D,A02,083766,Tran; Brian Kha,4,0,30,26
1656764229220,MATH 20D,A03,083767,Tran; Brian Kha,2,0,30,28
1656764235264,MATH 20E,A01,083771,Ganguly; Soumya,5,0,32,27
1656764235264,MATH 20E,A02,083772,Ganguly; Soumya,5,0,32,27
1656764235264,MATH 20E,B01,083773,Ciotti; Benjamin,18,0,35,17
1656764235264,MATH 20E,B02,083774,Ciotti; Benjamin,17,0,35,18
1656764241313,MATH 103A,A01,083777,Greenfeld; Be'Eri,2,0,36,34
1656764241313,MATH 103A,A02,083778,Greenfeld; Be'Eri,5,0,36,31
1656764241313,MATH 103A,A03,093561,Greenfeld; Be'Eri,4,0,36,32
1656764241313,MATH 103A,B01,083779,Greenfeld; Be'Eri,6,0,36,30
1656764241313,MATH 103A,B02,083780,Greenfeld; Be'Eri,2,0,36,34
1656764241313,MATH 103A,B03,093562,Greenfeld; Be'Eri,2,0,36,34
1656764247351,MATH 105,A01,085443,Carter; Anne Toulson,13,0,35,22
1656764247351,MATH 105,A02,093477,Carter; Anne Toulson,20,0,35,15
1656764253378,MATH 109,A01,083213,Ganzberger; Geoffrey Michael,2,0,34,32
1656764253378,MATH 109,A02,083214,Ganzberger; Geoffrey Michael,2,0,34,32
1656764253378,MATH 109,A03,093478,Ganzberger; Geoffrey Michael,1,0,34,33
1656764253378,MATH 109,B01,083215,Ganzberger; Geoffrey Michael,1,0,32,31
1656764253378,MATH 109,B02,083216,Ganzberger; Geoffrey Michael,1,0,32,31
1656764253378,MATH 109,B03,093479,Ganzberger; Geoffrey Michael,6,0,32,26
1656764259420,MATH 142A,A01,083219,Chow; Bennett,6,0,32,26
1656764259420,MATH 142A,A02,083220,Chow; Bennett,9,0,32,23
1656764259420,MATH 142A,A03,093480,Chow; Bennett,7,0,32,25
1656764259420,MATH 142A,B03,093481,Chow; Bennett,7,0,32,25
1656764259420,MATH 142A,B04,093558,Chow; Bennett,10,0,32,22
1656764259420,MATH 142A,B05,093559,Chow; Bennett,6,0,32,26
1656764265449,MATH 193A,A01,083224,Rotar; Vladimir,6,0,34,28
1656764265449,MATH 193A,A02,083225,Rotar; Vladimir,3,0,34,31
1656764265449,MATH 193A,A03,083781,Rotar; Vladimir,1,0,34,33
1656764265449,MATH 193A,A04,083782,Rotar; Vladimir,6,0,34,28
1656764265449,MATH 193A,A05,093482,Rotar; Vladimir,6,0,34,28
1656764271476,MATH 197,001,091859,McAuley; Julian John,9999,0,9999,0
1656764271476,MATH 197,002,095566,Kedlaya; Kiran S.,9997,0,9999,2
1656764271476,MATH 197,003,095567,Xiao; Ming,9999,0,9999,0
1656764271476,MATH 197,004,095571,Perols; Johan Lars,9998,0,9999,1
1656764278583,COGS 9,A01,083615,Shannon; Kyle Michael,6,0,75,69
1656764284609,COGS 11,A01,083617,Boyle; Mary E. T.,18,0,48,30
1656764290642,COGS 13,A01,083071,Bastos; Amalia Pinkusfeld,8,0,71,63
1656764296671,COGS 14A,A01,092681,Semenuks; Arturs,0,1,100,100
1656764302701,COGS 14B,A01,083073,Cheng; Tzu-Han,5,0,63,58
1656764308731,COGS 17,A01,092677,Semenuks; Arturs,4,0,81,77
1656764314758,COGS 100,A01,083619,Allen; Michael Gordon,15,0,70,55
1656764320787,COGS 101A,A01,083621,Davis; Joshua Daniel,9,0,68,59
1656764326812,COGS 101B,A01,091572,Allen; Michael Gordon,8,0,65,57
1656764332841,COGS 101C,A01,083625,Delgado; Tania,17,0,35,18
1656764338868,COGS 107A,A01,083627,Boyle; Mary E. T.,13,0,60,47
1656764344909,COGS 118A,A01,083075,Gupta; Anjum,15,0,76,61
1656764350950,CSE 3,A50,083646,Miranda; Gregory Joseph,22,0,50,28
1656764356977,CSE 8A,A50,083650,Miranda; Gregory Joseph,17,1,56,39
1656764363017,CSE 11,A01,083080,Cao; Yingjun,4,15,40,36
1656764369060,CSE 12,A01,083652,Krause-Levy; Sophia Louisa,20,1,120,100
1656764375085,CSE 15L,A01,083654,Morris; Justin Loren,8,0,50,42
1656764375085,CSE 15L,A02,083655,Morris; Justin Loren,8,0,50,42
1656764381118,CSE 20,A01,083657,Tran; Khoa Dang,37,0,80,43
1656764387757,CSE 21,A01,095574,Bach; Quang Tran,21,0,48,27
1656764393810,CSE 30,A01,083084,Eldon; John,4,0,80,76
1656764393810,CSE 30,B01,095061,Bhaskar; Nishant,5,0,50,45
1656764399844,CSE 100,A01,083659,Cao; Yingjun,1,4,70,69
1656764405877,CSE 134B,A01,083661,Powell; Thomas Allan,18,0,100,82
1656764411903,CSE 140,A01,083663,Gungor; Onat,14,0,85,71
1656764417935,CSE 140L,A01,083088,Eldon; John,16,0,100,84
1656764423969,CSE 175,A01,083665,Kumar; Rakesh,3,0,25,22
1656764430003,CSE 190,A00,092507,Dubnov; Shlomo,7,0,20,13
1656764436031,ECE 45,A01,083139,Congero; Spencer William,5,0,75,70
1656764442061,ECE 65,A50,083695,Saad; Andrew S,12,0,30,18
1656764442061,ECE 65,A51,095125,Saad; Andrew S,25,0,26,1
1656764448087,ECE 109,A01,091882,Touri; Behrouz,15,0,70,55
1656764454114,ECE 180,A00,083140,Abi Samra; Nicholas Camill,0,0,30,30
1656764454114,ECE 180,B00,083141,Abi Samra; Nicholas Camill,0,0,30,30
1656764460142,MATH 10A,A01,083735,Patchell; Gregory David,1,0,30,29
1656764460142,MATH 10A,A02,083736,Patchell; Gregory David,20,0,30,10
1656764460142,MATH 10A,A03,083737,Patchell; Gregory David,15,0,30,15
1656764466171,MATH 10B,A01,083207,Lim; Seonhee,7,0,34,27
1656764466171,MATH 10B,A02,083208,Lim; Seonhee,9,0,35,26
1656764466171,MATH 10B,A03,093472,Lim; Seonhee,4,0,34,30
1656764466171,MATH 10B,B01,083739,Sinha; Shubham,9,0,30,21
1656764472216,MATH 18,A01,083743,Cinel; Cameron Alexander,6,0,30,24
1656764472216,MATH 18,A02,083744,Cinel; Cameron Alexander,15,0,30,15
1656764472216,MATH 18,A03,083745,Cinel; Cameron Alexander,8,0,30,22
1656764472216,MATH 18,B01,083748,Rideout; David Porter,3,0,37,34
1656764472216,MATH 18,B02,083749,Rideout; David Porter,3,0,36,33
1656764472216,MATH 18,B03,083750,Rideout; David Porter,1,0,37,36
1656764472216,MATH 18,B04,083751,Rideout; David Porter,5,0,36,31
1656764472216,MATH 18,B05,093473,Rideout; David Porter,4,0,36,32
1656764472216,MATH 18,B06,093474,Rideout; David Porter,5,0,36,31
1656764478241,MATH 20A,A01,083754,Zheng; Zequn,12,0,40,28
1656764484275,MATH 20B,A01,083756,Briones; Jor-el Thomas Caparas,1,0,36,35
1656764484275,MATH 20B,A02,083757,Briones; Jor-el Thomas Caparas,1,0,36,35
1656764484275,MATH 20B,A03,093475,Briones; Jor-el Thomas Caparas,0,0,36,36
1656764490304,MATH 20C,A01,083760,Briones; Jor-el Thomas Caparas,1,0,35,34
1656764490304,MATH 20C,A02,083761,Briones; Jor-el Thomas Caparas,8,0,35,27
1656764490304,MATH 20C,A03,093476,Briones; Jor-el Thomas Caparas,0,1,36,36
1656764490304,MATH 20C,B01,083762,Bach; Quang Tran,0,0,30,30
1656764496338,MATH 20D,A01,083765,Tran; Brian Kha,4,0,30,26
1656764496338,MATH 20D,A02,083766,Tran; Brian Kha,4,0,30,26
1656764496338,MATH 20D,A03,083767,Tran; Brian Kha,2,0,30,28
1656764502366,MATH 20E,A01,083771,Ganguly; Soumya,5,0,32,27
1656764502366,MATH 20E,A02,083772,Ganguly; Soumya,5,0,32,27
1656764502366,MATH 20E,B01,083773,Ciotti; Benjamin,18,0,35,17
1656764502366,MATH 20E,B02,083774,Ciotti; Benjamin,17,0,35,18
1656764508395,MATH 103A,A01,083777,Greenfeld; Be'Eri,2,0,36,34
1656764508395,MATH 103A,A02,083778,Greenfeld; Be'Eri,5,0,36,31
1656764508395,MATH 103A,A03,093561,Greenfeld; Be'Eri,4,0,36,32
1656764508395,MATH 103A,B01,083779,Greenfeld; Be'Eri,6,0,36,30
1656764508395,MATH 103A,B02,083780,Greenfeld; Be'Eri,2,0,36,34
1656764508395,MATH 103A,B03,093562,Greenfeld; Be'Eri,2,0,36,34
1656764514419,MATH 105,A01,085443,Carter; Anne Toulson,13,0,35,22
1656764514419,MATH 105,A02,093477,Carter; Anne Toulson,20,0,35,15
1656764520446,MATH 109,A01,083213,Ganzberger; Geoffrey Michael,2,0,34,32
1656764520446,MATH 109,A02,083214,Ganzberger; Geoffrey Michael,2,0,34,32
1656764520446,MATH 109,A03,093478,Ganzberger; Geoffrey Michael,1,0,34,33
1656764520446,MATH 109,B01,083215,Ganzberger; Geoffrey Michael,1,0,32,31
1656764520446,MATH 109,B02,083216,Ganzberger; Geoffrey Michael,1,0,32,31
1656764520446,MATH 109,B03,093479,Ganzberger; Geoffrey Michael,6,0,32,26
1656764526474,MATH 142A,A01,083219,Chow; Bennett,6,0,32,26
1656764526474,MATH 142A,A02,083220,Chow; Bennett,9,0,32,23
1656764526474,MATH 142A,A03,093480,Chow; Bennett,7,0,32,25
1656764526474,MATH 142A,B03,093481,Chow; Bennett,7,0,32,25
1656764526474,MATH 142A,B04,093558,Chow; Bennett,10,0,32,22
1656764526474,MATH 142A,B05,093559,Chow; Bennett,6,0,32,26
1656764532511,MATH 193A,A01,083224,Rotar; Vladimir,6,0,34,28
1656764532511,MATH 193A,A02,083225,Rotar; Vladimir,3,0,34,31
1656764532511,MATH 193A,A03,083781,Rotar; Vladimir,1,0,34,33
1656764532511,MATH 193A,A04,083782,Rotar; Vladimir,6,0,34,28
1656764532511,MATH 193A,A05,093482,Rotar; Vladimir,6,0,34,28
1656764538547,MATH 197,001,091859,McAuley; Julian John,9999,0,9999,0
1656764538547,MATH 197,002,095566,Kedlaya; Kiran S.,9997,0,9999,2
1656764538547,MATH 197,003,095567,Xiao; Ming,9999,0,9999,0
1656764538547,MATH 197,004,095571,Perols; Johan Lars,9998,0,9999,1
1656764545621,COGS 9,A01,083615,Shannon; Kyle Michael,6,0,75,69
1656764551650,COGS 11,A01,083617,Boyle; Mary E. T.,18,0,48,30
1656764557679,COGS 13,A01,083071,Bastos; Amalia Pinkusfeld,8,0,71,63
1656764563703,COGS 14A,A01,092681,Semenuks; Arturs,0,1,100,100
1656764569730,COGS 14B,A01,083073,Cheng; Tzu-Han,5,0,63,58
1656764575761,COGS 17,A01,092677,Semenuks; Arturs,4,0,81,77
1656764581789,COGS 100,A01,083619,Allen; Michael Gordon,15,0,70,55
1656764587814,COGS 101A,A01,083621,Davis; Joshua Daniel,9,0,68,59
1656764593842,COGS 101B,A01,091572,Allen; Michael Gordon,8,0,65,57
1656764599879,COGS 101C,A01,083625,Delgado; Tania,17,0,35,18
1656764605904,COGS 107A,A01,083627,Boyle; Mary E. T.,13,0,60,47
1656764611931,COGS 118A,A01,083075,Gupta; Anjum,15,0,76,61
1656764617971,CSE 3,A50,083646,Miranda; Gregory Joseph,22,0,50,28
1656764623998,CSE 8A,A50,083650,Miranda; Gregory Joseph,17,1,56,39
1656764630024,CSE 11,A01,083080,Cao; Yingjun,4,15,40,36
1656764636049,CSE 12,A01,083652,Krause-Levy; Sophia Louisa,20,1,120,100
1656764642073,CSE 15L,A01,083654,Morris; Justin Loren,8,0,50,42
1656764642073,CSE 15L,A02,083655,Morris; Justin Loren,8,0,50,42
1656764648177,CSE 20,A01,083657,Tran; Khoa Dang,37,0,80,43
1656764654205,CSE 21,A01,095574,Bach; Quang Tran,21,0,48,27
1656764660232,CSE 30,A01,083084,Eldon; John,4,0,80,76
1656764660232,CSE 30,B01,095061,Bhaskar; Nishant,5,0,50,45
1656764666260,CSE 100,A01,083659,Cao; Yingjun,1,4,70,69
1656764672290,CSE 134B,A01,083661,Powell; Thomas Allan,18,0,100,82
1656764678318,CSE 140,A01,083663,Gungor; Onat,14,0,85,71
1656764684348,CSE 140L,A01,083088,Eldon; John,16,0,100,84
1656764690378,CSE 175,A01,083665,Kumar; Rakesh,3,0,25,22
1656764696408,CSE 190,A00,092507,Dubnov; Shlomo,7,0,20,13
1656764702439,ECE 45,A01,083139,Congero; Spencer William,5,0,75,70
1656764708467,ECE 65,A50,083695,Saad; Andrew S,12,0,30,18
1656764708467,ECE 65,A51,095125,Saad; Andrew S,25,0,26,1
1656764714497,ECE 109,A01,091882,Touri; Behrouz,15,0,70,55
1656764720524,ECE 180,A00,083140,Abi Samra; Nicholas Camill,0,0,30,30
1656764720524,ECE 180,B00,083141,Abi Samra; Nicholas Camill,0,0,30,30
1656764726551,MATH 10A,A01,083735,Patchell; Gregory David,1,0,30,29
1656764726551,MATH 10A,A02,083736,Patchell; Gregory David,20,0,30,10
1656764726551,MATH 10A,A03,083737,Patchell; Gregory David,15,0,30,15
1656764732581,MATH 10B,A01,083207,Lim; Seonhee,7,0,34,27
1656764732581,MATH 10B,A02,083208,Lim; Seonhee,9,0,35,26
1656764732581,MATH 10B,A03,093472,Lim; Seonhee,4,0,34,30
1656764732581,MATH 10B,B01,083739,Sinha; Shubham,9,0,30,21
1656764738617,MATH 18,A01,083743,Cinel; Cameron Alexander,6,0,30,24
1656764738617,MATH 18,A02,083744,Cinel; Cameron Alexander,15,0,30,15
1656764738617,MATH 18,A03,083745,Cinel; Cameron Alexander,8,0,30,22
1656764738617,MATH 18,B01,083748,Rideout; David Porter,3,0,37,34
1656764738617,MATH 18,B02,083749,Rideout; David Porter,3,0,36,33
1656764738617,MATH 18,B03,083750,Rideout; David Porter,1,0,37,36
1656764738617,MATH 18,B04,083751,Rideout; David Porter,5,0,36,31
1656764738617,MATH 18,B05,093473,Rideout; David Porter,4,0,36,32
1656764738617,MATH 18,B06,093474,Rideout; David Porter,5,0,36,31
1656764744645,MATH 20A,A01,083754,Zheng; Zequn,12,0,40,28
1656764750672,MATH 20B,A01,083756,Briones; Jor-el Thomas Caparas,1,0,36,35
1656764750672,MATH 20B,A02,083757,Briones; Jor-el Thomas Caparas,1,0,36,35
1656764750672,MATH 20B,A03,093475,Briones; Jor-el Thomas Caparas,0,0,36,36
1656764756698,MATH 20C,A01,083760,Briones; Jor-el Thomas Caparas,1,0,35,34
1656764756698,MATH 20C,A02,083761,Briones; Jor-el Thomas Caparas,8,0,35,27
1656764756698,MATH 20C,A03,093476,Briones; Jor-el Thomas Caparas,0,1,36,36
1656764756698,MATH 20C,B01,083762,Bach; Quang Tran,0,0,30,30
1656764762730,MATH 20D,A01,083765,Tran; Brian Kha,4,0,30,26
1656764762730,MATH 20D,A02,083766,Tran; Brian Kha,4,0,30,26
1656764762730,MATH 20D,A03,083767,Tran; Brian Kha,2,0,30,28
1656764768758,MATH 20E,A01,083771,Ganguly; Soumya,5,0,32,27
1656764768758,MATH 20E,A02,083772,Ganguly; Soumya,5,0,32,27
1656764768758,MATH 20E,B01,083773,Ciotti; Benjamin,18,0,35,17
1656764768758,MATH 20E,B02,083774,Ciotti; Benjamin,17,0,35,18
1656764774791,MATH 103A,A01,083777,Greenfeld; Be'Eri,2,0,36,34
1656764774791,MATH 103A,A02,083778,Greenfeld; Be'Eri,5,0,36,31
1656764774791,MATH 103A,A03,093561,Greenfeld; Be'Eri,4,0,36,32
1656764774791,MATH 103A,B01,083779,Greenfeld; Be'Eri,6,0,36,30
1656764774791,MATH 103A,B02,083780,Greenfeld; Be'Eri,2,0,36,34
1656764774791,MATH 103A,B03,093562,Greenfeld; Be'Eri,2,0,36,34
1656764780823,MATH 105,A01,085443,Carter; Anne Toulson,13,0,35,22
1656764780823,MATH 105,A02,093477,Carter; Anne Toulson,20,0,35,15
1656764786854,MATH 109,A01,083213,Ganzberger; Geoffrey Michael,2,0,34,32
1656764786854,MATH 109,A02,083214,Ganzberger; Geoffrey Michael,2,0,34,32
1656764786854,MATH 109,A03,093478,Ganzberger; Geoffrey Michael,1,0,34,33
1656764786854,MATH 109,B01,083215,Ganzberger; Geoffrey Michael,1,0,32,31
1656764786854,MATH 109,B02,083216,Ganzberger; Geoffrey Michael,1,0,32,31
1656764786854,MATH 109,B03,093479,Ganzberger; Geoffrey Michael,6,0,32,26
1656764792882,MATH 142A,A01,083219,Chow; Bennett,6,0,32,26
1656764792882,MATH 142A,A02,083220,Chow; Bennett,9,0,32,23
1656764792882,MATH 142A,A03,093480,Chow; Bennett,7,0,32,25
1656764792882,MATH 142A,B03,093481,Chow; Bennett,7,0,32,25
1656764792882,MATH 142A,B04,093558,Chow; Bennett,10,0,32,22
1656764792882,MATH 142A,B05,093559,Chow; Bennett,6,0,32,26
1656764798908,MATH 193A,A01,083224,Rotar; Vladimir,6,0,34,28
1656764798908,MATH 193A,A02,083225,Rotar; Vladimir,3,0,34,31
1656764798908,MATH 193A,A03,083781,Rotar; Vladimir,1,0,34,33
1656764798908,MATH 193A,A04,083782,Rotar; Vladimir,6,0,34,28
1656764798908,MATH 193A,A05,093482,Rotar; Vladimir,6,0,34,28
1656764804935,MATH 197,001,091859,McAuley; Julian John,9999,0,9999,0
1656764804935,MATH 197,002,095566,Kedlaya; Kiran S.,9997,0,9999,2
1656764804935,MATH 197,003,095567,Xiao; Ming,9999,0,9999,0
1656764804935,MATH 197,004,095571,Perols; Johan Lars,9998,0,9999,1
1656764812000,COGS 9,A01,083615,Shannon; Kyle Michael,6,0,75,69
1656764818025,COGS 11,A01,083617,Boyle; Mary E. T.,18,0,48,30
1656764824050,COGS 13,A01,083071,Bastos; Amalia Pinkusfeld,8,0,71,63
1656764830076,COGS 14A,A01,092681,Semenuks; Arturs,0,1,100,100
1656764836101,COGS 14B,A01,083073,Cheng; Tzu-Han,5,0,63,58
1656764842126,COGS 17,A01,092677,Semenuks; Arturs,4,0,81,77
1656764848165,COGS 100,A01,083619,Allen; Michael Gordon,15,0,70,55
1656764854190,COGS 101A,A01,083621,Davis; Joshua Daniel,9,0,68,59
1656764860217,COGS 101B,A01,091572,Allen; Michael Gordon,8,0,65,57
1656764866246,COGS 101C,A01,083625,Delgado; Tania,17,0,35,18
1656764872273,COGS 107A,A01,083627,Boyle; Mary E. T.,13,0,60,47
1656764878300,COGS 118A,A01,083075,Gupta; Anjum,15,0,76,61
1656764884327,CSE 3,A50,083646,Miranda; Gregory Joseph,22,0,50,28
1656764890353,CSE 8A,A50,083650,Miranda; Gregory Joseph,17,1,56,39
1656764896382,CSE 11,A01,083080,Cao; Yingjun,4,15,40,36
1656764902415,CSE 12,A01,083652,Krause-Levy; Sophia Louisa,20,1,120,100
1656764908441,CSE 15L,A01,083654,Morris; Justin Loren,8,0,50,42
1656764908441,CSE 15L,A02,083655,Morris; Justin Loren,8,0,50,42
1656764914469,CSE 20,A01,083657,Tran; Khoa Dang,37,0,80,43
1656764920493,CSE 21,A01,095574,Bach; Quang Tran,21,0,48,27
1656764926526,CSE 30,A01,083084,Eldon; John,4,0,80,76
1656764926526,CSE 30,B01,095061,Bhaskar; Nishant,5,0,50,45
1656764932557,CSE 100,A01,083659,Cao; Yingjun,1,4,70,69
1656764938592,CSE 134B,A01,083661,Powell; Thomas Allan,18,0,100,82
1656764944621,CSE 140,A01,083663,Gungor; Onat,14,0,85,71
1656764950651,CSE 140L,A01,083088,Eldon; John,16,0,100,84
1656764956676,CSE 175,A01,083665,Kumar; Rakesh,3,0,25,22
1656764962700,CSE 190,A00,092507,Dubnov; Shlomo,7,0,20,13
1656764968728,ECE 45,A01,083139,Congero; Spencer William,5,0,75,70
1656764974760,ECE 65,A50,083695,Saad; Andrew S,12,0,30,18
1656764974760,ECE 65,A51,095125,Saad; Andrew S,25,0,26,1
1656764980788,ECE 109,A01,091882,Touri; Behrouz,15,0,70,55
1656764986811,ECE 180,A00,083140,Abi Samra; Nicholas Camill,0,0,30,30
1656764986811,ECE 180,B00,083141,Abi Samra; Nicholas Camill,0,0,30,30
1656764992838,MATH 10A,A01,083735,Patchell; Gregory David,1,0,30,29
1656764992838,MATH 10A,A02,083736,Patchell; Gregory David,20,0,30,10
1656764992838,MATH 10A,A03,083737,Patchell; Gregory David,15,0,30,15
1656764998874,MATH 10B,A01,083207,Lim; Seonhee,7,0,34,27
1656764998874,MATH 10B,A02,083208,Lim; Seonhee,9,0,35,26
1656764998874,MATH 10B,A03,093472,Lim; Seonhee,4,0,34,30
1656764998874,MATH 10B,B01,083739,Sinha; Shubham,9,0,30,21
1656765004904,MATH 18,A01,083743,Cinel; Cameron Alexander,6,0,30,24
1656765004904,MATH 18,A02,083744,Cinel; Cameron Alexander,15,0,30,15
1656765004904,MATH 18,A03,083745,Cinel; Cameron Alexander,8,0,30,22
1656765004904,MATH 18,B01,083748,Rideout; David Porter,3,0,37,34
1656765004904,MATH 18,B02,083749,Rideout; David Porter,3,0,36,33
1656765004904,MATH 18,B03,083750,Rideout; David Porter,1,0,37,36
1656765004904,MATH 18,B04,083751,Rideout; David Porter,5,0,36,31
1656765004904,MATH 18,B05,093473,Rideout; David Porter,4,0,36,32
1656765004904,MATH 18,B06,093474,Rideout; David Porter,5,0,36,31
1656765010927,MATH 20A,A01,083754,Zheng; Zequn,12,0,40,28
1656765016958,MATH 20B,A01,083756,Briones; Jor-el Thomas Caparas,1,0,36,35
1656765016958,MATH 20B,A02,083757,Briones; Jor-el Thomas Caparas,1,0,36,35
1656765016958,MATH 20B,A03,093475,Briones; Jor-el Thomas Caparas,0,0,36,36
1656765022992,MATH 20C,A01,083760,Briones; Jor-el Thomas Caparas,1,0,35,34
1656765022992,MATH 20C,A02,083761,Briones; Jor-el Thomas Caparas,8,0,35,27
1656765022992,MATH 20C,A03,093476,Briones; Jor-el Thomas Caparas,0,1,36,36
1656765022992,MATH 20C,B01,083762,Bach; Quang Tran,0,0,30,30
1656765029027,MATH 20D,A01,083765,Tran; Brian Kha,4,0,30,26
1656765029027,MATH 20D,A02,083766,Tran; Brian Kha,4,0,30,26
1656765029027,MATH 20D,A03,083767,Tran; Brian Kha,2,0,30,28
1656765035062,MATH 20E,A01,083771,Ganguly; Soumya,5,0,32,27
1656765035062,MATH 20E,A02,083772,Ganguly; Soumya,5,0,32,27
1656765035062,MATH 20E,B01,083773,Ciotti; Benjamin,18,0,35,17
1656765035062,MATH 20E,B02,083774,Ciotti; Benjamin,17,0,35,18
1656765041097,MATH 103A,A01,083777,Greenfeld; Be'Eri,2,0,36,34
1656765041097,MATH 103A,A02,083778,Greenfeld; Be'Eri,5,0,36,31
1656765041097,MATH 103A,A03,093561,Greenfeld; Be'Eri,4,0,36,32
1656765041097,MATH 103A,B01,083779,Greenfeld; Be'Eri,6,0,36,30
1656765041097,MATH 103A,B02,083780,Greenfeld; Be'Eri,2,0,36,34
1656765041097,MATH 103A,B03,093562,Greenfeld; Be'Eri,2,0,36,34
1656765047131,MATH 105,A01,085443,Carter; Anne Toulson,13,0,35,22
1656765047131,MATH 105,A02,093477,Carter; Anne Toulson,20,0,35,15
1656765053168,MATH 109,A01,083213,Ganzberger; Geoffrey Michael,2,0,34,32
1656765053168,MATH 109,A02,083214,Ganzberger; Geoffrey Michael,2,0,34,32
1656765053168,MATH 109,A03,093478,Ganzberger; Geoffrey Michael,1,0,34,33
1656765053168,MATH 109,B01,083215,Ganzberger; Geoffrey Michael,1,0,32,31
1656765053168,MATH 109,B02,083216,Ganzberger; Geoffrey Michael,1,0,32,31
1656765053168,MATH 109,B03,093479,Ganzberger; Geoffrey Michael,6,0,32,26
1656765059197,MATH 142A,A01,083219,Chow; Bennett,6,0,32,26
1656765059197,MATH 142A,A02,083220,Chow; Bennett,9,0,32,23
1656765059197,MATH 142A,A03,093480,Chow; Bennett,7,0,32,25
1656765059197,MATH 142A,B03,093481,Chow; Bennett,7,0,32,25
1656765059197,MATH 142A,B04,093558,Chow; Bennett,10,0,32,22
1656765059197,MATH 142A,B05,093559,Chow; Bennett,6,0,32,26
1656765065230,MATH 193A,A01,083224,Rotar; Vladimir,6,0,34,28
1656765065230,MATH 193A,A02,083225,Rotar; Vladimir,3,0,34,31
1656765065230,MATH 193A,A03,083781,Rotar; Vladimir,1,0,34,33
1656765065230,MATH 193A,A04,083782,Rotar; Vladimir,6,0,34,28
1656765065230,MATH 193A,A05,093482,Rotar; Vladimir,6,0,34,28
1656765071256,MATH 197,001,091859,McAuley; Julian John,9999,0,9999,0
1656765071256,MATH 197,002,095566,Kedlaya; Kiran S.,9997,0,9999,2
1656765071256,MATH 197,003,095567,Xiao; Ming,9999,0,9999,0
1656765071256,MATH 197,004,095571,Perols; Johan Lars,9998,0,9999,1
1656765078330,COGS 9,A01,083615,Shannon; Kyle Michael,6,0,75,69
1656765084362,COGS 11,A01,083617,Boyle; Mary E. T.,18,0,48,30
1656765090390,COGS 13,A01,083071,Bastos; Amalia Pinkusfeld,8,0,71,63
1656765096420,COGS 14A,A01,092681,Semenuks; Arturs,0,1,100,100
1656765102445,COGS 14B,A01,083073,Cheng; Tzu-Han,5,0,63,58
1656765108474,COGS 17,A01,092677,Semenuks; Arturs,4,0,81,77
1656765114512,COGS 100,A01,083619,Allen; Michael Gordon,15,0,70,55
1656765120556,COGS 101A,A01,083621,Davis; Joshua Daniel,9,0,68,59
1656765126582,COGS 101B,A01,091572,Allen; Michael Gordon,8,0,65,57
1656765132607,COGS 101C,A01,083625,Delgado; Tania,17,0,35,18
1656765138641,COGS 107A,A01,083627,Boyle; Mary E. T.,13,0,60,47
1656765144667,COGS 118A,A01,083075,Gupta; Anjum,15,0,76,61
1656765150692,CSE 3,A50,083646,Miranda; Gregory Joseph,22,0,50,28
1656765156717,CSE 8A,A50,083650,Miranda; Gregory Joseph,17,1,56,39
1656765162743,CSE 11,A01,083080,Cao; Yingjun,4,15,40,36
1656765168768,CSE 12,A01,083652,Krause-Levy; Sophia Louisa,20,1,120,100
1656765174801,CSE 15L,A01,083654,Morris; Justin Loren,8,0,50,42
1656765174801,CSE 15L,A02,083655,Morris; Justin Loren,8,0,50,42
1656765180829,CSE 20,A01,083657,Tran; Khoa Dang,37,0,80,43
1656765186859,CSE 21,A01,095574,Bach; Quang Tran,21,0,48,27
1656765192892,CSE 30,A01,083084,Eldon; John,4,0,80,76
1656765192892,CSE 30,B01,095061,Bhaskar; Nishant,5,0,50,45
1656765198925,CSE 100,A01,083659,Cao; Yingjun,1,4,70,69
1656765204953,CSE 134B,A01,083661,Powell; Thomas Allan,18,0,100,82
1656765210979,CSE 140,A01,083663,Gungor; Onat,14,0,85,71
1656765217005,CSE 140L,A01,083088,Eldon; John,16,0,100,84
1656765223036,CSE 175,A01,083665,Kumar; Rakesh,3,0,25,22
1656765229065,CSE 190,A00,092507,Dubnov; Shlomo,7,0,20,13
1656765235095,ECE 45,A01,083139,Congero; Spencer William,5,0,75,70
1656765241121,ECE 65,A50,083695,Saad; Andrew S,12,0,30,18
1656765241121,ECE 65,A51,095125,Saad; Andrew S,25,0,26,1
1656765247221,ECE 109,A01,091882,Touri; Behrouz,15,0,70,55
1656765253247,ECE 180,A00,083140,Abi Samra; Nicholas Camill,0,0,30,30
1656765253247,ECE 180,B00,083141,Abi Samra; Nicholas Camill,0,0,30,30
1656765259276,MATH 10A,A01,083735,Patchell; Gregory David,1,0,30,29
1656765259276,MATH 10A,A02,083736,Patchell; Gregory David,20,0,30,10
1656765259276,MATH 10A,A03,083737,Patchell; Gregory David,15,0,30,15
1656765265313,MATH 10B,A01,083207,Lim; Seonhee,7,0,34,27
1656765265313,MATH 10B,A02,083208,Lim; Seonhee,9,0,35,26
1656765265313,MATH 10B,A03,093472,Lim; Seonhee,4,0,34,30
1656765265313,MATH 10B,B01,083739,Sinha; Shubham,9,0,30,21
1656765271354,MATH 18,A01,083743,Cinel; Cameron Alexander,6,0,30,24
1656765271354,MATH 18,A02,083744,Cinel; Cameron Alexander,15,0,30,15
1656765271354,MATH 18,A03,083745,Cinel; Cameron Alexander,8,0,30,22
1656765271354,MATH 18,B01,083748,Rideout; David Porter,3,0,37,34
1656765271354,MATH 18,B02,083749,Rideout; David Porter,3,0,36,33
1656765271354,MATH 18,B03,083750,Rideout; David Porter,1,0,37,36
1656765271354,MATH 18,B04,083751,Rideout; David Porter,5,0,36,31
1656765271354,MATH 18,B05,093473,Rideout; David Porter,4,0,36,32
1656765271354,MATH 18,B06,093474,Rideout; David Porter,5,0,36,31
1656765277385,MATH 20A,A01,083754,Zheng; Zequn,12,0,40,28
1656765283418,MATH 20B,A01,083756,Briones; Jor-el Thomas Caparas,1,0,36,35
1656765283418,MATH 20B,A02,083757,Briones; Jor-el Thomas Caparas,1,0,36,35
1656765283418,MATH 20B,A03,093475,Briones; Jor-el Thomas Caparas,0,0,36,36
1656765289449,MATH 20C,A01,083760,Briones; Jor-el Thomas Caparas,1,0,35,34
1656765289449,MATH 20C,A02,083761,Briones; Jor-el Thomas Caparas,8,0,35,27
1656765289449,MATH 20C,A03,093476,Briones; Jor-el Thomas Caparas,0,1,36,36
1656765289449,MATH 20C,B01,083762,Bach; Quang Tran,0,0,30,30
1656765295475,MATH 20D,A01,083765,Tran; Brian Kha,4,0,30,26
1656765295475,MATH 20D,A02,083766,Tran; Brian Kha,4,0,30,26
1656765295475,MATH 20D,A03,083767,Tran; Brian Kha,2,0,30,28
1656765301500,MATH 20E,A01,083771,Ganguly; Soumya,5,0,32,27
1656765301500,MATH 20E,A02,083772,Ganguly; Soumya,5,0,32,27
1656765301500,MATH 20E,B01,083773,Ciotti; Benjamin,18,0,35,17
1656765301500,MATH 20E,B02,083774,Ciotti; Benjamin,17,0,35,18
1656765307534,MATH 103A,A01,083777,Greenfeld; Be'Eri,2,0,36,34
1656765307534,MATH 103A,A02,083778,Greenfeld; Be'Eri,5,0,36,31
1656765307534,MATH 103A,A03,093561,Greenfeld; Be'Eri,4,0,36,32
1656765307534,MATH 103A,B01,083779,Greenfeld; Be'Eri,6,0,36,30
1656765307534,MATH 103A,B02,083780,Greenfeld; Be'Eri,2,0,36,34
1656765307534,MATH 103A,B03,093562,Greenfeld; Be'Eri,2,0,36,34
1656765313576,MATH 105,A01,085443,Carter; Anne Toulson,13,0,35,22
1656765313576,MATH 105,A02,093477,Carter; Anne Toulson,20,0,35,15
1656765319605,MATH 109,A01,083213,Ganzberger; Geoffrey Michael,2,0,34,32
1656765319605,MATH 109,A02,083214,Ganzberger; Geoffrey Michael,2,0,34,32
1656765319605,MATH 109,A03,093478,Ganzberger; Geoffrey Michael,1,0,34,33
1656765319605,MATH 109,B01,083215,Ganzberger; Geoffrey Michael,1,0,32,31
1656765319605,MATH 109,B02,083216,Ganzberger; Geoffrey Michael,1,0,32,31
1656765319605,MATH 109,B03,093479,Ganzberger; Geoffrey Michael,6,0,32,26
1656765325638,MATH 142A,A01,083219,Chow; Bennett,6,0,32,26
1656765325638,MATH 142A,A02,083220,Chow; Bennett,9,0,32,23
1656765325638,MATH 142A,A03,093480,Chow; Bennett,7,0,32,25
1656765325638,MATH 142A,B03,093481,Chow; Bennett,7,0,32,25
1656765325638,MATH 142A,B04,093558,Chow; Bennett,10,0,32,22
1656765325638,MATH 142A,B05,093559,Chow; Bennett,6,0,32,26
1656765331666,MATH 193A,A01,083224,Rotar; Vladimir,6,0,34,28
1656765331666,MATH 193A,A02,083225,Rotar; Vladimir,3,0,34,31
1656765331666,MATH 193A,A03,083781,Rotar; Vladimir,1,0,34,33
1656765331666,MATH 193A,A04,083782,Rotar; Vladimir,6,0,34,28
1656765331666,MATH 193A,A05,093482,Rotar; Vladimir,6,0,34,28
1656765337690,MATH 197,001,091859,McAuley; Julian John,9999,0,9999,0
1656765337690,MATH 197,002,095566,Kedlaya; Kiran S.,9997,0,9999,2
1656765337690,MATH 197,003,095567,Xiao; Ming,9999,0,9999,0
1656765337690,MATH 197,004,095571,Perols; Johan Lars,9998,0,9999,1
1656765344759,COGS 9,A01,083615,Shannon; Kyle Michael,6,0,75,69
1656765350783,COGS 11,A01,083617,Boyle; Mary E. T.,18,0,48,30
1656765356817,COGS 13,A01,083071,Bastos; Amalia Pinkusfeld,8,0,71,63
1656765362859,COGS 14A,A01,092681,Semenuks; Arturs,0,1,100,100
1656765368893,COGS 14B,A01,083073,Cheng; Tzu-Han,5,0,63,58
1656765374925,COGS 17,A01,092677,Semenuks; Arturs,4,0,81,77
1656765380966,COGS 100,A01,083619,Allen; Michael Gordon,15,0,70,55
1656765386992,COGS 101A,A01,083621,Davis; Joshua Daniel,9,0,68,59
1656765393019,COGS 101B,A01,091572,Allen; Michael Gordon,8,0,65,57
1656765399043,COGS 101C,A01,083625,Delgado; Tania,17,0,35,18
1656765405068,COGS 107A,A01,083627,Boyle; Mary E. T.,13,0,60,47
1656765411098,COGS 118A,A01,083075,Gupta; Anjum,15,0,76,61
1656765417125,CSE 3,A50,083646,Miranda; Gregory Joseph,22,0,50,28
1656765423157,CSE 8A,A50,083650,Miranda; Gregory Joseph,17,1,56,39
1656765429183,CSE 11,A01,083080,Cao; Yingjun,4,15,40,36
1656765435209,CSE 12,A01,083652,Krause-Levy; Sophia Louisa,20,1,120,100
1656765441235,CSE 15L,A01,083654,Morris; Justin Loren,8,0,50,42
1656765441235,CSE 15L,A02,083655,Morris; Justin Loren,8,0,50,42
1656765447264,CSE 20,A01,083657,Tran; Khoa Dang,37,0,80,43
1656765453290,CSE 21,A01,095574,Bach; Quang Tran,21,0,48,27
1656765459331,CSE 30,A01,083084,Eldon; John,4,0,80,76
1656765459331,CSE 30,B01,095061,Bhaskar; Nishant,5,0,50,45
1656765465356,CSE 100,A01,083659,Cao; Yingjun,1,4,70,69
1656765471387,CSE 134B,A01,083661,Powell; Thomas Allan,18,0,100,82
1656765477416,CSE 140,A01,083663,Gungor; Onat,14,0,85,71
1656765483443,CSE 140L,A01,083088,Eldon; John,16,0,100,84
1656765489470,CSE 175,A01,083665,Kumar; Rakesh,3,0,25,22
1656765495495,CSE 190,A00,092507,Dubnov; Shlomo,7,0,20,13
1656765501520,ECE 45,A01,083139,Congero; Spencer William,5,0,75,70
1656765507555,ECE 65,A50,083695,Saad; Andrew S,12,0,30,18
1656765507555,ECE 65,A51,095125,Saad; Andrew S,25,0,26,1
1656765513586,ECE 109,A01,091882,Touri; Behrouz,15,0,70,55
1656765519620,ECE 180,A00,083140,Abi Samra; Nicholas Camill,0,0,30,30
1656765519620,ECE 180,B00,083141,Abi Samra; Nicholas Camill,0,0,30,30
1656765525646,MATH 10A,A01,083735,Patchell; Gregory David,1,0,30,29
1656765525646,MATH 10A,A02,083736,Patchell; Gregory David,20,0,30,10
1656765525646,MATH 10A,A03,083737,Patchell; Gregory David,15,0,30,15
1656765531687,MATH 10B,A01,083207,Lim; Seonhee,7,0,34,27
1656765531687,MATH 10B,A02,083208,Lim; Seonhee,9,0,35,26
1656765531687,MATH 10B,A03,093472,Lim; Seonhee,4,0,34,30
1656765531687,MATH 10B,B01,083739,Sinha; Shubham,9,0,30,21
1656765537715,MATH 18,A01,083743,Cinel; Cameron Alexander,6,0,30,24
1656765537715,MATH 18,A02,083744,Cinel; Cameron Alexander,15,0,30,15
1656765537715,MATH 18,A03,083745,Cinel; Cameron Alexander,8,0,30,22
1656765537715,MATH 18,B01,083748,Rideout; David Porter,3,0,37,34
1656765537715,MATH 18,B02,083749,Rideout; David Porter,3,0,36,33
1656765537715,MATH 18,B03,083750,Rideout; David Porter,1,0,37,36
1656765537715,MATH 18,B04,083751,Rideout; David Porter,5,0,36,31
1656765537715,MATH 18,B05,093473,Rideout; David Porter,4,0,36,32
1656765537715,MATH 18,B06,093474,Rideout; David Porter,5,0,36,31
1656765543741,MATH 20A,A01,083754,Zheng; Zequn,12,0,40,28
1656765549777,MATH 20B,A01,083756,Briones; Jor-el Thomas Caparas,1,0,36,35
1656765549777,MATH 20B,A02,083757,Briones; Jor-el Thomas Caparas,1,0,36,35
1656765549777,MATH 20B,A03,093475,Briones; Jor-el Thomas Caparas,0,0,36,36
1656765555803,MATH 20C,A01,083760,Briones; Jor-el Thomas Caparas,1,0,35,34
1656765555803,MATH 20C,A02,083761,Briones; Jor-el Thomas Caparas,8,0,35,27
1656765555803,MATH 20C,A03,093476,Briones; Jor-el Thomas Caparas,0,1,36,36
1656765555803,MATH 20C,B01,083762,Bach; Quang Tran,0,0,30,30
1656765561839,MATH 20D,A01,083765,Tran; Brian Kha,4,0,30,26
1656765561839,MATH 20D,A02,083766,Tran; Brian Kha,4,0,30,26
1656765561839,MATH 20D,A03,083767,Tran; Brian Kha,2,0,30,28
1656765567876,MATH 20E,A01,083771,Ganguly; Soumya,5,0,32,27
1656765567876,MATH 20E,A02,083772,Ganguly; Soumya,5,0,32,27
1656765567876,MATH 20E,B01,083773,Ciotti; Benjamin,18,0,35,17
1656765567876,MATH 20E,B02,083774,Ciotti; Benjamin,17,0,35,18
1656765573912,MATH 103A,A01,083777,Greenfeld; Be'Eri,2,0,36,34
1656765573912,MATH 103A,A02,083778,Greenfeld; Be'Eri,5,0,36,31
1656765573912,MATH 103A,A03,093561,Greenfeld; Be'Eri,4,0,36,32
1656765573912,MATH 103A,B01,083779,Greenfeld; Be'Eri,6,0,36,30
1656765573912,MATH 103A,B02,083780,Greenfeld; Be'Eri,2,0,36,34
1656765573912,MATH 103A,B03,093562,Greenfeld; Be'Eri,2,0,36,34
1656765579945,MATH 105,A01,085443,Carter; Anne Toulson,13,0,35,22
1656765579945,MATH 105,A02,093477,Carter; Anne Toulson,20,0,35,15
1656765585973,MATH 109,A01,083213,Ganzberger; Geoffrey Michael,2,0,34,32
1656765585973,MATH 109,A02,083214,Ganzberger; Geoffrey Michael,2,0,34,32
1656765585973,MATH 109,A03,093478,Ganzberger; Geoffrey Michael,1,0,34,33
1656765585973,MATH 109,B01,083215,Ganzberger; Geoffrey Michael,1,0,32,31
1656765585973,MATH 109,B02,083216,Ganzberger; Geoffrey Michael,1,0,32,31
1656765585973,MATH 109,B03,093479,Ganzberger; Geoffrey Michael,6,0,32,26
1656765592001,MATH 142A,A01,083219,Chow; Bennett,6,0,32,26
1656765592001,MATH 142A,A02,083220,Chow; Bennett,9,0,32,23
1656765592001,MATH 142A,A03,093480,Chow; Bennett,7,0,32,25
1656765592001,MATH 142A,B03,093481,Chow; Bennett,7,0,32,25
1656765592001,MATH 142A,B04,093558,Chow; Bennett,10,0,32,22
1656765592001,MATH 142A,B05,093559,Chow; Bennett,6,0,32,26
1656765598034,MATH 193A,A01,083224,Rotar; Vladimir,6,0,34,28
1656765598034,MATH 193A,A02,083225,Rotar; Vladimir,3,0,34,31
1656765598034,MATH 193A,A03,083781,Rotar; Vladimir,1,0,34,33
1656765598034,MATH 193A,A04,083782,Rotar; Vladimir,6,0,34,28
1656765598034,MATH 193A,A05,093482,Rotar; Vladimir,6,0,34,28
1656765604065,MATH 197,001,091859,McAuley; Julian John,9999,0,9999,0
1656765604065,MATH 197,002,095566,Kedlaya; Kiran S.,9997,0,9999,2
1656765604065,MATH 197,003,095567,Xiao; Ming,9999,0,9999,0
1656765604065,MATH 197,004,095571,Perols; Johan Lars,9998,0,9999,1
1656765611132,COGS 9,A01,083615,Shannon; Kyle Michael,6,0,75,69
1656765617159,COGS 11,A01,083617,Boyle; Mary E. T.,18,0,48,30
1656765623193,COGS 13,A01,083071,Bastos; Amalia Pinkusfeld,8,0,71,63
1656765629228,COGS 14A,A01,092681,Semenuks; Arturs,0,1,100,100
1656765635256,COGS 14B,A01,083073,Cheng; Tzu-Han,5,0,63,58
1656765641286,COGS 17,A01,092677,Semenuks; Arturs,4,0,81,77
1656765647316,COGS 100,A01,083619,Allen; Michael Gordon,15,0,70,55
1656765653341,COGS 101A,A01,083621,Davis; Joshua Daniel,9,0,68,59
1656765659371,COGS 101B,A01,091572,Allen; Michael Gordon,8,0,65,57
1656765665402,COGS 101C,A01,083625,Delgado; Tania,17,0,35,18
1656765671427,COGS 107A,A01,083627,Boyle; Mary E. T.,13,0,60,47
1656765677456,COGS 118A,A01,083075,Gupta; Anjum,15,0,76,61
1656765683483,CSE 3,A50,083646,Miranda; Gregory Joseph,22,0,50,28
1656765689513,CSE 8A,A50,083650,Miranda; Gregory Joseph,17,1,56,39
1656765695539,CSE 11,A01,083080,Cao; Yingjun,4,15,40,36
1656765701565,CSE 12,A01,083652,Krause-Levy; Sophia Louisa,20,1,120,100
1656765707600,CSE 15L,A01,083654,Morris; Justin Loren,8,0,50,42
1656765707600,CSE 15L,A02,083655,Morris; Justin Loren,8,0,50,42
1656765713626,CSE 20,A01,083657,Tran; Khoa Dang,37,0,80,43
1656765719657,CSE 21,A01,095574,Bach; Quang Tran,21,0,48,27
1656765725695,CSE 30,A01,083084,Eldon; John,4,0,80,76
1656765725695,CSE 30,B01,095061,Bhaskar; Nishant,5,0,50,45
1656765731724,CSE 100,A01,083659,Cao; Yingjun,1,4,70,69
1656765737764,CSE 134B,A01,083661,Powell; Thomas Allan,18,0,100,82
1656765743788,CSE 140,A01,083663,Gungor; Onat,14,0,85,71
1656765749812,CSE 140L,A01,083088,Eldon; John,16,0,100,84
1656765755836,CSE 175,A01,083665,Kumar; Rakesh,3,0,25,22
1656765761863,CSE 190,A00,092507,Dubnov; Shlomo,7,0,20,13
1656765767892,ECE 45,A01,083139,Congero; Spencer William,5,0,75,70
1656765773920,ECE 65,A50,083695,Saad; Andrew S,12,0,30,18
1656765773920,ECE 65,A51,095125,Saad; Andrew S,25,0,26,1
1656765779951,ECE 109,A01,091882,Touri; Behrouz,15,0,70,55
1656765785979,ECE 180,A00,083140,Abi Samra; Nicholas Camill,0,0,30,30
1656765785979,ECE 180,B00,083141,Abi Samra; Nicholas Camill,0,0,30,30
1656765792009,MATH 10A,A01,083735,Patchell; Gregory David,1,0,30,29
1656765792009,MATH 10A,A02,083736,Patchell; Gregory David,20,0,30,10
1656765792009,MATH 10A,A03,083737,Patchell; Gregory David,15,0,30,15
1656765798045,MATH 10B,A01,083207,Lim; Seonhee,7,0,34,27
1656765798045,MATH 10B,A02,083208,Lim; Seonhee,9,0,35,26
1656765798045,MATH 10B,A03,093472,Lim; Seonhee,4,0,34,30
1656765798045,MATH 10B,B01,083739,Sinha; Shubham,9,0,30,21
1656765804072,MATH 18,A01,083743,Cinel; Cameron Alexander,6,0,30,24
1656765804072,MATH 18,A02,083744,Cinel; Cameron Alexander,15,0,30,15
1656765804072,MATH 18,A03,083745,Cinel; Cameron Alexander,8,0,30,22
1656765804072,MATH 18,B01,083748,Rideout; David Porter,3,0,37,34
1656765804072,MATH 18,B02,083749,Rideout; David Porter,3,0,36,33
1656765804072,MATH 18,B03,083750,Rideout; David Porter,1,0,37,36
1656765804072,MATH 18,B04,083751,Rideout; David Porter,5,0,36,31
1656765804072,MATH 18,B05,093473,Rideout; David Porter,4,0,36,32
1656765804072,MATH 18,B06,093474,Rideout; David Porter,5,0,36,31
1656765810102,MATH 20A,A01,083754,Zheng; Zequn,12,0,40,28
1656765816134,MATH 20B,A01,083756,Briones; Jor-el Thomas Caparas,1,0,36,35
1656765816134,MATH 20B,A02,083757,Briones; Jor-el Thomas Caparas,1,0,36,35
1656765816134,MATH 20B,A03,093475,Briones; Jor-el Thomas Caparas,0,0,36,36
1656765822164,MATH 20C,A01,083760,Briones; Jor-el Thomas Caparas,1,0,35,34
1656765822164,MATH 20C,A02,083761,Briones; Jor-el Thomas Caparas,8,0,35,27
1656765822164,MATH 20C,A03,093476,Briones; Jor-el Thomas Caparas,0,1,36,36
1656765822164,MATH 20C,B01,083762,Bach; Quang Tran,0,0,30,30
1656765828198,MATH 20D,A01,083765,Tran; Brian Kha,4,0,30,26
1656765828198,MATH 20D,A02,083766,Tran; Brian Kha,4,0,30,26
1656765828198,MATH 20D,A03,083767,Tran; Brian Kha,2,0,30,28
1656765834231,MATH 20E,A01,083771,Ganguly; Soumya,5,0,32,27
1656765834231,MATH 20E,A02,083772,Ganguly; Soumya,5,0,32,27
1656765834231,MATH 20E,B01,083773,Ciotti; Benjamin,18,0,35,17
1656765834231,MATH 20E,B02,083774,Ciotti; Benjamin,17,0,35,18
1656765840269,MATH 103A,A01,083777,Greenfeld; Be'Eri,2,0,36,34
1656765840269,MATH 103A,A02,083778,Greenfeld; Be'Eri,5,0,36,31
1656765840269,MATH 103A,A03,093561,Greenfeld; Be'Eri,4,0,36,32
1656765840269,MATH 103A,B01,083779,Greenfeld; Be'Eri,6,0,36,30
1656765840269,MATH 103A,B02,083780,Greenfeld; Be'Eri,2,0,36,34
1656765840269,MATH 103A,B03,093562,Greenfeld; Be'Eri,2,0,36,34
1656765846375,MATH 105,A01,085443,Carter; Anne Toulson,13,0,35,22
1656765846375,MATH 105,A02,093477,Carter; Anne Toulson,20,0,35,15
1656765852401,MATH 109,A01,083213,Ganzberger; Geoffrey Michael,2,0,34,32
1656765852401,MATH 109,A02,083214,Ganzberger; Geoffrey Michael,2,0,34,32
1656765852401,MATH 109,A03,093478,Ganzberger; Geoffrey Michael,1,0,34,33
1656765852401,MATH 109,B01,083215,Ganzberger; Geoffrey Michael,1,0,32,31
1656765852401,MATH 109,B02,083216,Ganzberger; Geoffrey Michael,1,0,32,31
1656765852401,MATH 109,B03,093479,Ganzberger; Geoffrey Michael,6,0,32,26
1656765858428,MATH 142A,A01,083219,Chow; Bennett,6,0,32,26
1656765858428,MATH 142A,A02,083220,Chow; Bennett,9,0,32,23
1656765858428,MATH 142A,A03,093480,Chow; Bennett,7,0,32,25
1656765858428,MATH 142A,B03,093481,Chow; Bennett,7,0,32,25
1656765858428,MATH 142A,B04,093558,Chow; Bennett,10,0,32,22
1656765858428,MATH 142A,B05,093559,Chow; Bennett,6,0,32,26
1656765864466,MATH 193A,A01,083224,Rotar; Vladimir,6,0,34,28
1656765864466,MATH 193A,A02,083225,Rotar; Vladimir,3,0,34,31
1656765864466,MATH 193A,A03,083781,Rotar; Vladimir,1,0,34,33
1656765864466,MATH 193A,A04,083782,Rotar; Vladimir,6,0,34,28
1656765864466,MATH 193A,A05,093482,Rotar; Vladimir,6,0,34,28
1656765870496,MATH 197,001,091859,McAuley; Julian John,9999,0,9999,0
1656765870496,MATH 197,002,095566,Kedlaya; Kiran S.,9997,0,9999,2
1656765870496,MATH 197,003,095567,Xiao; Ming,9999,0,9999,0
1656765870496,MATH 197,004,095571,Perols; Johan Lars,9998,0,9999,1
1656765877561,COGS 9,A01,083615,Shannon; Kyle Michael,6,0,75,69
1656765883587,COGS 11,A01,083617,Boyle; Mary E. T.,18,0,48,30
1656765889619,COGS 13,A01,083071,Bastos; Amalia Pinkusfeld,8,0,71,63
1656765895649,COGS 14A,A01,092681,Semenuks; Arturs,0,1,100,100
1656765901675,COGS 14B,A01,083073,Cheng; Tzu-Han,5,0,63,58
1656765907702,COGS 17,A01,092677,Semenuks; Arturs,4,0,81,77
1656765913743,COGS 100,A01,083619,Allen; Michael Gordon,15,0,70,55
1656765919771,COGS 101A,A01,083621,Davis; Joshua Daniel,9,0,68,59
1656765925795,COGS 101B,A01,091572,Allen; Michael Gordon,8,0,65,57
1656765931821,COGS 101C,A01,083625,Delgado; Tania,17,0,35,18
1656765937848,COGS 107A,A01,083627,Boyle; Mary E. T.,13,0,60,47
1656765943874,COGS 118A,A01,083075,Gupta; Anjum,15,0,76,61
1656765949907,CSE 3,A50,083646,Miranda; Gregory Joseph,22,0,50,28
1656765955940,CSE 8A,A50,083650,Miranda; Gregory Joseph,17,1,56,39
1656765961967,CSE 11,A01,083080,Cao; Yingjun,4,15,40,36
1656765967999,CSE 12,A01,083652,Krause-Levy; Sophia Louisa,20,1,120,100
1656765974025,CSE 15L,A01,083654,Morris; Justin Loren,8,0,50,42
1656765974025,CSE 15L,A02,083655,Morris; Justin Loren,8,0,50,42
1656765980050,CSE 20,A01,083657,Tran; Khoa Dang,37,0,80,43
1656765986082,CSE 21,A01,095574,Bach; Quang Tran,21,0,48,27
1656765992115,CSE 30,A01,083084,Eldon; John,4,0,80,76
1656765992115,CSE 30,B01,095061,Bhaskar; Nishant,5,0,50,45
1656765998145,CSE 100,A01,083659,Cao; Yingjun,1,4,70,69
1656766004171,CSE 134B,A01,083661,Powell; Thomas Allan,18,0,100,82
1656766010196,CSE 140,A01,083663,Gungor; Onat,14,0,85,71
1656766016226,CSE 140L,A01,083088,Eldon; John,16,0,100,84
1656766022253,CSE 175,A01,083665,Kumar; Rakesh,3,0,25,22
1656766028279,CSE 190,A00,092507,Dubnov; Shlomo,7,0,20,13
1656766034311,ECE 45,A01,083139,Congero; Spencer William,5,0,75,70
1656766040349,ECE 65,A50,083695,Saad; Andrew S,12,0,30,18
1656766040349,ECE 65,A51,095125,Saad; Andrew S,25,0,26,1
1656766046375,ECE 109,A01,091882,Touri; Behrouz,15,0,70,55
1656766052405,ECE 180,A00,083140,Abi Samra; Nicholas Camill,0,0,30,30
1656766052405,ECE 180,B00,083141,Abi Samra; Nicholas Camill,0,0,30,30
1656766058434,MATH 10A,A01,083735,Patchell; Gregory David,1,0,30,29
1656766058434,MATH 10A,A02,083736,Patchell; Gregory David,20,0,30,10
1656766058434,MATH 10A,A03,083737,Patchell; Gregory David,15,0,30,15
1656766064465,MATH 10B,A01,083207,Lim; Seonhee,7,0,34,27
1656766064465,MATH 10B,A02,083208,Lim; Seonhee,9,0,35,26
1656766064465,MATH 10B,A03,093472,Lim; Seonhee,4,0,34,30
1656766064465,MATH 10B,B01,083739,Sinha; Shubham,9,0,30,21
1656766070506,MATH 18,A01,083743,Cinel; Cameron Alexander,6,0,30,24
1656766070506,MATH 18,A02,083744,Cinel; Cameron Alexander,15,0,30,15
1656766070506,MATH 18,A03,083745,Cinel; Cameron Alexander,8,0,30,22
1656766070506,MATH 18,B01,083748,Rideout; David Porter,3,0,37,34
1656766070506,MATH 18,B02,083749,Rideout; David Porter,3,0,36,33
1656766070506,MATH 18,B03,083750,Rideout; David Porter,1,0,37,36
1656766070506,MATH 18,B04,083751,Rideout; David Porter,5,0,36,31
1656766070506,MATH 18,B05,093473,Rideout; David Porter,4,0,36,32
1656766070506,MATH 18,B06,093474,Rideout; David Porter,5,0,36,31
1656766076537,MATH 20A,A01,083754,Zheng; Zequn,12,0,40,28
1656766082564,MATH 20B,A01,083756,Briones; Jor-el Thomas Caparas,1,0,36,35
1656766082564,MATH 20B,A02,083757,Briones; Jor-el Thomas Caparas,1,0,36,35
1656766082564,MATH 20B,A03,093475,Briones; Jor-el Thomas Caparas,0,0,36,36
1656766088594,MATH 20C,A01,083760,Briones; Jor-el Thomas Caparas,1,0,35,34
1656766088594,MATH 20C,A02,083761,Briones; Jor-el Thomas Caparas,8,0,35,27
1656766088594,MATH 20C,A03,093476,Briones; Jor-el Thomas Caparas,0,1,36,36
1656766088594,MATH 20C,B01,083762,Bach; Quang Tran,0,0,30,30
1656766094624,MATH 20D,A01,083765,Tran; Brian Kha,4,0,30,26
1656766094624,MATH 20D,A02,083766,Tran; Brian Kha,4,0,30,26
1656766094624,MATH 20D,A03,083767,Tran; Brian Kha,2,0,30,28
1656766100651,MATH 20E,A01,083771,Ganguly; Soumya,5,0,32,27
1656766100651,MATH 20E,A02,083772,Ganguly; Soumya,5,0,32,27
1656766100651,MATH 20E,B01,083773,Ciotti; Benjamin,18,0,35,17
1656766100651,MATH 20E,B02,083774,Ciotti; Benjamin,17,0,35,18
1656766106688,MATH 103A,A01,083777,Greenfeld; Be'Eri,2,0,36,34
1656766106688,MATH 103A,A02,083778,Greenfeld; Be'Eri,5,0,36,31
1656766106688,MATH 103A,A03,093561,Greenfeld; Be'Eri,4,0,36,32
1656766106688,MATH 103A,B01,083779,Greenfeld; Be'Eri,6,0,36,30
1656766106688,MATH 103A,B02,083780,Greenfeld; Be'Eri,2,0,36,34
1656766106688,MATH 103A,B03,093562,Greenfeld; Be'Eri,2,0,36,34
1656766112715,MATH 105,A01,085443,Carter; Anne Toulson,13,0,35,22
1656766112715,MATH 105,A02,093477,Carter; Anne Toulson,20,0,35,15
1656766118743,MATH 109,A01,083213,Ganzberger; Geoffrey Michael,2,0,34,32
1656766118743,MATH 109,A02,083214,Ganzberger; Geoffrey Michael,2,0,34,32
1656766118743,MATH 109,A03,093478,Ganzberger; Geoffrey Michael,1,0,34,33
1656766118743,MATH 109,B01,083215,Ganzberger; Geoffrey Michael,1,0,32,31
1656766118743,MATH 109,B02,083216,Ganzberger; Geoffrey Michael,1,0,32,31
1656766118743,MATH 109,B03,093479,Ganzberger; Geoffrey Michael,6,0,32,26
1656766124777,MATH 142A,A01,083219,Chow; Bennett,6,0,32,26
1656766124777,MATH 142A,A02,083220,Chow; Bennett,9,0,32,23
1656766124777,MATH 142A,A03,093480,Chow; Bennett,7,0,32,25
1656766124777,MATH 142A,B03,093481,Chow; Bennett,7,0,32,25
1656766124777,MATH 142A,B04,093558,Chow; Bennett,10,0,32,22
1656766124777,MATH 142A,B05,093559,Chow; Bennett,6,0,32,26
1656766130804,MATH 193A,A01,083224,Rotar; Vladimir,6,0,34,28
1656766130804,MATH 193A,A02,083225,Rotar; Vladimir,3,0,34,31
1656766130804,MATH 193A,A03,083781,Rotar; Vladimir,1,0,34,33
1656766130804,MATH 193A,A04,083782,Rotar; Vladimir,6,0,34,28
1656766130804,MATH 193A,A05,093482,Rotar; Vladimir,6,0,34,28
1656766136829,MATH 197,001,091859,McAuley; Julian John,9999,0,9999,0
1656766136829,MATH 197,002,095566,Kedlaya; Kiran S.,9997,0,9999,2
1656766136829,MATH 197,003,095567,Xiao; Ming,9999,0,9999,0
1656766136829,MATH 197,004,095571,Perols; Johan Lars,9998,0,9999,1
1656766143924,COGS 9,A01,083615,Shannon; Kyle Michael,6,0,75,69
1656766149950,COGS 11,A01,083617,Boyle; Mary E. T.,18,0,48,30
1656766155976,COGS 13,A01,083071,Bastos; Amalia Pinkusfeld,8,0,71,63
1656766162004,COGS 14A,A01,092681,Semenuks; Arturs,0,1,100,100
1656766168042,COGS 14B,A01,083073,Cheng; Tzu-Han,5,0,63,58
1656766174066,COGS 17,A01,092677,Semenuks; Arturs,4,0,81,77
1656766180091,COGS 100,A01,083619,Allen; Michael Gordon,15,0,70,55
1656766186116,COGS 101A,A01,083621,Davis; Joshua Daniel,9,0,68,59
1656766192147,COGS 101B,A01,091572,Allen; Michael Gordon,8,0,65,57
1656766198173,COGS 101C,A01,083625,Delgado; Tania,17,0,35,18
1656766204196,COGS 107A,A01,083627,Boyle; Mary E. T.,13,0,60,47
1656766210221,COGS 118A,A01,083075,Gupta; Anjum,15,0,76,61
1656766216250,CSE 3,A50,083646,Miranda; Gregory Joseph,22,0,50,28
1656766222278,CSE 8A,A50,083650,Miranda; Gregory Joseph,17,1,56,39
1656766228303,CSE 11,A01,083080,Cao; Yingjun,4,15,40,36
1656766234329,CSE 12,A01,083652,Krause-Levy; Sophia Louisa,20,1,120,100
1656766240358,CSE 15L,A01,083654,Morris; Justin Loren,8,0,50,42
1656766240358,CSE 15L,A02,083655,Morris; Justin Loren,8,0,50,42
1656766246389,CSE 20,A01,083657,Tran; Khoa Dang,37,0,80,43
1656766252419,CSE 21,A01,095574,Bach; Quang Tran,21,0,48,27
1656766258445,CSE 30,A01,083084,Eldon; John,4,0,80,76
1656766258445,CSE 30,B01,095061,Bhaskar; Nishant,5,0,50,45
1656766264474,CSE 100,A01,083659,Cao; Yingjun,1,4,70,69
1656766270501,CSE 134B,A01,083661,Powell; Thomas Allan,18,0,100,82
1656766276525,CSE 140,A01,083663,Gungor; Onat,14,0,85,71
1656766282557,CSE 140L,A01,083088,Eldon; John,16,0,100,84
1656766288580,CSE 175,A01,083665,Kumar; Rakesh,3,0,25,22
1656766294606,CSE 190,A00,092507,Dubnov; Shlomo,7,0,20,13
1656766300639,ECE 45,A01,083139,Congero; Spencer William,5,0,75,70
1656766306668,ECE 65,A50,083695,Saad; Andrew S,12,0,30,18
1656766306668,ECE 65,A51,095125,Saad; Andrew S,25,0,26,1
1656766312699,ECE 109,A01,091882,Touri; Behrouz,15,0,70,55
1656766318728,ECE 180,A00,083140,Abi Samra; Nicholas Camill,0,0,30,30
1656766318728,ECE 180,B00,083141,Abi Samra; Nicholas Camill,0,0,30,30
1656766324760,MATH 10A,A01,083735,Patchell; Gregory David,1,0,30,29
1656766324760,MATH 10A,A02,083736,Patchell; Gregory David,20,0,30,10
1656766324760,MATH 10A,A03,083737,Patchell; Gregory David,15,0,30,15
1656766330799,MATH 10B,A01,083207,Lim; Seonhee,7,0,34,27
1656766330799,MATH 10B,A02,083208,Lim; Seonhee,9,0,35,26
1656766330799,MATH 10B,A03,093472,Lim; Seonhee,4,0,34,30
1656766330799,MATH 10B,B01,083739,Sinha; Shubham,9,0,30,21
1656766336836,MATH 18,A01,083743,Cinel; Cameron Alexander,6,0,30,24
1656766336836,MATH 18,A02,083744,Cinel; Cameron Alexander,15,0,30,15
1656766336836,MATH 18,A03,083745,Cinel; Cameron Alexander,8,0,30,22
1656766336836,MATH 18,B01,083748,Rideout; David Porter,3,0,37,34
1656766336836,MATH 18,B02,083749,Rideout; David Porter,3,0,36,33
1656766336836,MATH 18,B03,083750,Rideout; David Porter,1,0,37,36
1656766336836,MATH 18,B04,083751,Rideout; David Porter,5,0,36,31
1656766336836,MATH 18,B05,093473,Rideout; David Porter,4,0,36,32
1656766336836,MATH 18,B06,093474,Rideout; David Porter,5,0,36,31
1656766342861,MATH 20A,A01,083754,Zheng; Zequn,12,0,40,28
1656766348886,MATH 20B,A01,083756,Briones; Jor-el Thomas Caparas,1,0,36,35
1656766348886,MATH 20B,A02,083757,Briones; Jor-el Thomas Caparas,1,0,36,35
1656766348886,MATH 20B,A03,093475,Briones; Jor-el Thomas Caparas,0,0,36,36
1656766354913,MATH 20C,A01,083760,Briones; Jor-el Thomas Caparas,1,0,35,34
1656766354913,MATH 20C,A02,083761,Briones; Jor-el Thomas Caparas,8,0,35,27
1656766354913,MATH 20C,A03,093476,Briones; Jor-el Thomas Caparas,0,1,36,36
1656766354913,MATH 20C,B01,083762,Bach; Quang Tran,0,0,30,30
1656766360939,MATH 20D,A01,083765,Tran; Brian Kha,4,0,30,26
1656766360939,MATH 20D,A02,083766,Tran; Brian Kha,4,0,30,26
1656766360939,MATH 20D,A03,083767,Tran; Brian Kha,2,0,30,28
1656766366967,MATH 20E,A01,083771,Ganguly; Soumya,5,0,32,27
1656766366967,MATH 20E,A02,083772,Ganguly; Soumya,5,0,32,27
1656766366967,MATH 20E,B01,083773,Ciotti; Benjamin,18,0,35,17
1656766366967,MATH 20E,B02,083774,Ciotti; Benjamin,17,0,35,18
1656766372995,MATH 103A,A01,083777,Greenfeld; Be'Eri,2,0,36,34
1656766372995,MATH 103A,A02,083778,Greenfeld; Be'Eri,5,0,36,31
1656766372995,MATH 103A,A03,093561,Greenfeld; Be'Eri,4,0,36,32
1656766372995,MATH 103A,B01,083779,Greenfeld; Be'Eri,6,0,36,30
1656766372995,MATH 103A,B02,083780,Greenfeld; Be'Eri,2,0,36,34
1656766372995,MATH 103A,B03,093562,Greenfeld; Be'Eri,2,0,36,34
1656766379022,MATH 105,A01,085443,Carter; Anne Toulson,13,0,35,22
1656766379022,MATH 105,A02,093477,Carter; Anne Toulson,20,0,35,15
1656766385051,MATH 109,A01,083213,Ganzberger; Geoffrey Michael,2,0,34,32
1656766385051,MATH 109,A02,083214,Ganzberger; Geoffrey Michael,2,0,34,32
1656766385051,MATH 109,A03,093478,Ganzberger; Geoffrey Michael,1,0,34,33
1656766385051,MATH 109,B01,083215,Ganzberger; Geoffrey Michael,1,0,32,31
1656766385051,MATH 109,B02,083216,Ganzberger; Geoffrey Michael,1,0,32,31
1656766385051,MATH 109,B03,093479,Ganzberger; Geoffrey Michael,6,0,32,26
1656766391078,MATH 142A,A01,083219,Chow; Bennett,6,0,32,26
1656766391078,MATH 142A,A02,083220,Chow; Bennett,9,0,32,23
1656766391078,MATH 142A,A03,093480,Chow; Bennett,7,0,32,25
1656766391078,MATH 142A,B03,093481,Chow; Bennett,7,0,32,25
1656766391078,MATH 142A,B04,093558,Chow; Bennett,10,0,32,22
1656766391078,MATH 142A,B05,093559,Chow; Bennett,6,0,32,26
1656766397110,MATH 193A,A01,083224,Rotar; Vladimir,6,0,34,28
1656766397110,MATH 193A,A02,083225,Rotar; Vladimir,3,0,34,31
1656766397110,MATH 193A,A03,083781,Rotar; Vladimir,1,0,34,33
1656766397110,MATH 193A,A04,083782,Rotar; Vladimir,6,0,34,28
1656766397110,MATH 193A,A05,093482,Rotar; Vladimir,6,0,34,28
1656766403138,MATH 197,001,091859,McAuley; Julian John,9999,0,9999,0
1656766403138,MATH 197,002,095566,Kedlaya; Kiran S.,9997,0,9999,2
1656766403138,MATH 197,003,095567,Xiao; Ming,9999,0,9999,0
1656766403138,MATH 197,004,095571,Perols; Johan Lars,9998,0,9999,1
1656766410217,COGS 9,A01,083615,Shannon; Kyle Michael,6,0,75,69
1656766416242,COGS 11,A01,083617,Boyle; Mary E. T.,18,0,48,30
1656766422265,COGS 13,A01,083071,Bastos; Amalia Pinkusfeld,8,0,71,63
1656766428294,COGS 14A,A01,092681,Semenuks; Arturs,0,1,100,100
1656766434320,COGS 14B,A01,083073,Cheng; Tzu-Han,5,0,63,58
1656766440429,COGS 17,A01,092677,Semenuks; Arturs,4,0,81,77
1656766446457,COGS 100,A01,083619,Allen; Michael Gordon,15,0,70,55
1656766452482,COGS 101A,A01,083621,Davis; Joshua Daniel,9,0,68,59
1656766458507,COGS 101B,A01,091572,Allen; Michael Gordon,8,0,65,57
1656766464534,COGS 101C,A01,083625,Delgado; Tania,17,0,35,18
1656766470560,COGS 107A,A01,083627,Boyle; Mary E. T.,13,0,60,47
1656766476584,COGS 118A,A01,083075,Gupta; Anjum,15,0,76,61
1656766482618,CSE 3,A50,083646,Miranda; Gregory Joseph,22,0,50,28
1656766488641,CSE 8A,A50,083650,Miranda; Gregory Joseph,17,1,56,39
1656766494666,CSE 11,A01,083080,Cao; Yingjun,4,15,40,36
1656766500691,CSE 12,A01,083652,Krause-Levy; Sophia Louisa,20,1,120,100
1656766506720,CSE 15L,A01,083654,Morris; Justin Loren,8,0,50,42
1656766506720,CSE 15L,A02,083655,Morris; Justin Loren,8,0,50,42
1656766512749,CSE 20,A01,083657,Tran; Khoa Dang,37,0,80,43
1656766518776,CSE 21,A01,095574,Bach; Quang Tran,21,0,48,27
1656766524810,CSE 30,A01,083084,Eldon; John,4,0,80,76
1656766524810,CSE 30,B01,095061,Bhaskar; Nishant,5,0,50,45
1656766530833,CSE 100,A01,083659,Cao; Yingjun,1,4,70,69
1656766536858,CSE 134B,A01,083661,Powell; Thomas Allan,18,0,100,82
1656766542888,CSE 140,A01,083663,Gungor; Onat,14,0,85,71
1656766548913,CSE 140L,A01,083088,Eldon; John,16,0,100,84
1656766554938,CSE 175,A01,083665,Kumar; Rakesh,3,0,25,22
1656766560962,CSE 190,A00,092507,Dubnov; Shlomo,7,0,20,13
1656766566995,ECE 45,A01,083139,Congero; Spencer William,5,0,75,70
1656766573021,ECE 65,A50,083695,Saad; Andrew S,12,0,30,18
1656766573021,ECE 65,A51,095125,Saad; Andrew S,25,0,26,1
1656766579053,ECE 109,A01,091882,Touri; Behrouz,15,0,70,55
1656766585077,ECE 180,A00,083140,Abi Samra; Nicholas Camill,0,0,30,30
1656766585077,ECE 180,B00,083141,Abi Samra; Nicholas Camill,0,0,30,30
1656766591103,MATH 10A,A01,083735,Patchell; Gregory David,1,0,30,29
1656766591103,MATH 10A,A02,083736,Patchell; Gregory David,20,0,30,10
1656766591103,MATH 10A,A03,083737,Patchell; Gregory David,15,0,30,15
1656766597133,MATH 10B,A01,083207,Lim; Seonhee,7,0,34,27
1656766597133,MATH 10B,A02,083208,Lim; Seonhee,9,0,35,26
1656766597133,MATH 10B,A03,093472,Lim; Seonhee,4,0,34,30
1656766597133,MATH 10B,B01,083739,Sinha; Shubham,9,0,30,21
1656766603173,MATH 18,A01,083743,Cinel; Cameron Alexander,6,0,30,24
1656766603173,MATH 18,A02,083744,Cinel; Cameron Alexander,15,0,30,15
1656766603173,MATH 18,A03,083745,Cinel; Cameron Alexander,8,0,30,22
1656766603173,MATH 18,B01,083748,Rideout; David Porter,3,0,37,34
1656766603173,MATH 18,B02,083749,Rideout; David Porter,3,0,36,33
1656766603173,MATH 18,B03,083750,Rideout; David Porter,1,0,37,36
1656766603173,MATH 18,B04,083751,Rideout; David Porter,5,0,36,31
1656766603173,MATH 18,B05,093473,Rideout; David Porter,4,0,36,32
1656766603173,MATH 18,B06,093474,Rideout; David Porter,5,0,36,31
1656766609199,MATH 20A,A01,083754,Zheng; Zequn,12,0,40,28
1656766615230,MATH 20B,A01,083756,Briones; Jor-el Thomas Caparas,1,0,36,35
1656766615230,MATH 20B,A02,083757,Briones; Jor-el Thomas Caparas,1,0,36,35
1656766615230,MATH 20B,A03,093475,Briones; Jor-el Thomas Caparas,0,0,36,36
1656766621261,MATH 20C,A01,083760,Briones; Jor-el Thomas Caparas,1,0,35,34
1656766621261,MATH 20C,A02,083761,Briones; Jor-el Thomas Caparas,8,0,35,27
1656766621261,MATH 20C,A03,093476,Briones; Jor-el Thomas Caparas,0,1,36,36
1656766621261,MATH 20C,B01,083762,Bach; Quang Tran,0,0,30,30
1656766627294,MATH 20D,A01,083765,Tran; Brian Kha,4,0,30,26
1656766627294,MATH 20D,A02,083766,Tran; Brian Kha,4,0,30,26
1656766627294,MATH 20D,A03,083767,Tran; Brian Kha,2,0,30,28
1656766633321,MATH 20E,A01,083771,Ganguly; Soumya,5,0,32,27
1656766633321,MATH 20E,A02,083772,Ganguly; Soumya,5,0,32,27
1656766633321,MATH 20E,B01,083773,Ciotti; Benjamin,18,0,35,17
1656766633321,MATH 20E,B02,083774,Ciotti; Benjamin,17,0,35,18
1656766639360,MATH 103A,A01,083777,Greenfeld; Be'Eri,2,0,36,34
1656766639360,MATH 103A,A02,083778,Greenfeld; Be'Eri,5,0,36,31
1656766639360,MATH 103A,A03,093561,Greenfeld; Be'Eri,4,0,36,32
1656766639360,MATH 103A,B01,083779,Greenfeld; Be'Eri,6,0,36,30
1656766639360,MATH 103A,B02,083780,Greenfeld; Be'Eri,2,0,36,34
1656766639360,MATH 103A,B03,093562,Greenfeld; Be'Eri,2,0,36,34
1656766645387,MATH 105,A01,085443,Carter; Anne Toulson,13,0,35,22
1656766645387,MATH 105,A02,093477,Carter; Anne Toulson,20,0,35,15
1656766651425,MATH 109,A01,083213,Ganzberger; Geoffrey Michael,2,0,34,32
1656766651425,MATH 109,A02,083214,Ganzberger; Geoffrey Michael,2,0,34,32
1656766651425,MATH 109,A03,093478,Ganzberger; Geoffrey Michael,1,0,34,33
1656766651425,MATH 109,B01,083215,Ganzberger; Geoffrey Michael,1,0,32,31
1656766651425,MATH 109,B02,083216,Ganzberger; Geoffrey Michael,1,0,32,31
1656766651425,MATH 109,B03,093479,Ganzberger; Geoffrey Michael,6,0,32,26
1656766657451,MATH 142A,A01,083219,Chow; Bennett,6,0,32,26
1656766657451,MATH 142A,A02,083220,Chow; Bennett,9,0,32,23
1656766657451,MATH 142A,A03,093480,Chow; Bennett,7,0,32,25
1656766657451,MATH 142A,B03,093481,Chow; Bennett,7,0,32,25
1656766657451,MATH 142A,B04,093558,Chow; Bennett,10,0,32,22
1656766657451,MATH 142A,B05,093559,Chow; Bennett,6,0,32,26
1656766663482,MATH 193A,A01,083224,Rotar; Vladimir,6,0,34,28
1656766663482,MATH 193A,A02,083225,Rotar; Vladimir,3,0,34,31
1656766663482,MATH 193A,A03,083781,Rotar; Vladimir,1,0,34,33
1656766663482,MATH 193A,A04,083782,Rotar; Vladimir,6,0,34,28
1656766663482,MATH 193A,A05,093482,Rotar; Vladimir,6,0,34,28
1656766669509,MATH 197,001,091859,McAuley; Julian John,9999,0,9999,0
1656766669509,MATH 197,002,095566,Kedlaya; Kiran S.,9997,0,9999,2
1656766669509,MATH 197,003,095567,Xiao; Ming,9999,0,9999,0
1656766669509,MATH 197,004,095571,Perols; Johan Lars,9998,0,9999,1
1656766676573,COGS 9,A01,083615,Shannon; Kyle Michael,6,0,75,69
1656766682599,COGS 11,A01,083617,Boyle; Mary E. T.,18,0,48,30
1656766688629,COGS 13,A01,083071,Bastos; Amalia Pinkusfeld,8,0,71,63
1656766694655,COGS 14A,A01,092681,Semenuks; Arturs,0,1,100,100
1656766700681,COGS 14B,A01,083073,Cheng; Tzu-Han,5,0,63,58
1656766706706,COGS 17,A01,092677,Semenuks; Arturs,4,0,81,77
1656766712734,COGS 100,A01,083619,Allen; Michael Gordon,15,0,70,55
1656766718760,COGS 101A,A01,083621,Davis; Joshua Daniel,9,0,68,59
1656766724784,COGS 101B,A01,091572,Allen; Michael Gordon,8,0,65,57
1656766730808,COGS 101C,A01,083625,Delgado; Tania,17,0,35,18
1656766736833,COGS 107A,A01,083627,Boyle; Mary E. T.,13,0,60,47
1656766742857,COGS 118A,A01,083075,Gupta; Anjum,15,0,76,61
1656766748885,CSE 3,A50,083646,Miranda; Gregory Joseph,22,0,50,28
1656766754910,CSE 8A,A50,083650,Miranda; Gregory Joseph,17,1,56,39
1656766760937,CSE 11,A01,083080,Cao; Yingjun,4,15,40,36
1656766766969,CSE 12,A01,083652,Krause-Levy; Sophia Louisa,20,1,120,100
1656766772997,CSE 15L,A01,083654,Morris; Justin Loren,8,0,50,42
1656766772997,CSE 15L,A02,083655,Morris; Justin Loren,8,0,50,42
1656766779035,CSE 20,A01,083657,Tran; Khoa Dang,37,0,80,43
1656766785060,CSE 21,A01,095574,Bach; Quang Tran,21,0,48,27
1656766791093,CSE 30,A01,083084,Eldon; John,4,0,80,76
1656766791093,CSE 30,B01,095061,Bhaskar; Nishant,5,0,50,45
1656766797118,CSE 100,A01,083659,Cao; Yingjun,1,4,70,69
1656766803149,CSE 134B,A01,083661,Powell; Thomas Allan,18,0,100,82
1656766809178,CSE 140,A01,083663,Gungor; Onat,14,0,85,71
1656766815207,CSE 140L,A01,083088,Eldon; John,16,0,100,84
1656766821235,CSE 175,A01,083665,Kumar; Rakesh,3,0,25,22
1656766827261,CSE 190,A00,092507,Dubnov; Shlomo,7,0,20,13
1656766833287,ECE 45,A01,083139,Congero; Spencer William,5,0,75,70
1656766839320,ECE 65,A50,083695,Saad; Andrew S,12,0,30,18
1656766839320,ECE 65,A51,095125,Saad; Andrew S,25,0,26,1
1656766845348,ECE 109,A01,091882,Touri; Behrouz,15,0,70,55
1656766851373,ECE 180,A00,083140,Abi Samra; Nicholas Camill,0,0,30,30
1656766851373,ECE 180,B00,083141,Abi Samra; Nicholas Camill,0,0,30,30
1656766857398,MATH 10A,A01,083735,Patchell; Gregory David,1,0,30,29
1656766857398,MATH 10A,A02,083736,Patchell; Gregory David,20,0,30,10
1656766857398,MATH 10A,A03,083737,Patchell; Gregory David,15,0,30,15
1656766863435,MATH 10B,A01,083207,Lim; Seonhee,7,0,34,27
1656766863435,MATH 10B,A02,083208,Lim; Seonhee,9,0,35,26
1656766863435,MATH 10B,A03,093472,Lim; Seonhee,4,0,34,30
1656766863435,MATH 10B,B01,083739,Sinha; Shubham,9,0,30,21
1656766869463,MATH 18,A01,083743,Cinel; Cameron Alexander,6,0,30,24
1656766869463,MATH 18,A02,083744,Cinel; Cameron Alexander,15,0,30,15
1656766869463,MATH 18,A03,083745,Cinel; Cameron Alexander,8,0,30,22
1656766869463,MATH 18,B01,083748,Rideout; David Porter,3,0,37,34
1656766869463,MATH 18,B02,083749,Rideout; David Porter,3,0,36,33
1656766869463,MATH 18,B03,083750,Rideout; David Porter,1,0,37,36
1656766869463,MATH 18,B04,083751,Rideout; David Porter,5,0,36,31
1656766869463,MATH 18,B05,093473,Rideout; David Porter,4,0,36,32
1656766869463,MATH 18,B06,093474,Rideout; David Porter,5,0,36,31
1656766875493,MATH 20A,A01,083754,Zheng; Zequn,12,0,40,28
1656766881520,MATH 20B,A01,083756,Briones; Jor-el Thomas Caparas,1,0,36,35
1656766881520,MATH 20B,A02,083757,Briones; Jor-el Thomas Caparas,1,0,36,35
1656766881520,MATH 20B,A03,093475,Briones; Jor-el Thomas Caparas,0,0,36,36
1656766887553,MATH 20C,A01,083760,Briones; Jor-el Thomas Caparas,1,0,35,34
1656766887553,MATH 20C,A02,083761,Briones; Jor-el Thomas Caparas,8,0,35,27
1656766887553,MATH 20C,A03,093476,Briones; Jor-el Thomas Caparas,0,1,36,36
1656766887553,MATH 20C,B01,083762,Bach; Quang Tran,0,0,30,30
1656766893584,MATH 20D,A01,083765,Tran; Brian Kha,4,0,30,26
1656766893584,MATH 20D,A02,083766,Tran; Brian Kha,4,0,30,26
1656766893584,MATH 20D,A03,083767,Tran; Brian Kha,2,0,30,28
1656766899617,MATH 20E,A01,083771,Ganguly; Soumya,5,0,32,27
1656766899617,MATH 20E,A02,083772,Ganguly; Soumya,5,0,32,27
1656766899617,MATH 20E,B01,083773,Ciotti; Benjamin,18,0,35,17
1656766899617,MATH 20E,B02,083774,Ciotti; Benjamin,17,0,35,18
1656766905645,MATH 103A,A01,083777,Greenfeld; Be'Eri,2,0,36,34
1656766905645,MATH 103A,A02,083778,Greenfeld; Be'Eri,5,0,36,31
1656766905645,MATH 103A,A03,093561,Greenfeld; Be'Eri,4,0,36,32
1656766905645,MATH 103A,B01,083779,Greenfeld; Be'Eri,6,0,36,30
1656766905645,MATH 103A,B02,083780,Greenfeld; Be'Eri,2,0,36,34
1656766905645,MATH 103A,B03,093562,Greenfeld; Be'Eri,2,0,36,34
1656766911675,MATH 105,A01,085443,Carter; Anne Toulson,13,0,35,22
1656766911675,MATH 105,A02,093477,Carter; Anne Toulson,20,0,35,15
1656766917700,MATH 109,A01,083213,Ganzberger; Geoffrey Michael,2,0,34,32
1656766917700,MATH 109,A02,083214,Ganzberger; Geoffrey Michael,2,0,34,32
1656766917700,MATH 109,A03,093478,Ganzberger; Geoffrey Michael,1,0,34,33
1656766917700,MATH 109,B01,083215,Ganzberger; Geoffrey Michael,1,0,32,31
1656766917700,MATH 109,B02,083216,Ganzberger; Geoffrey Michael,1,0,32,31
1656766917700,MATH 109,B03,093479,Ganzberger; Geoffrey Michael,6,0,32,26
1656766923736,MATH 142A,A01,083219,Chow; Bennett,6,0,32,26
1656766923736,MATH 142A,A02,083220,Chow; Bennett,9,0,32,23
1656766923736,MATH 142A,A03,093480,Chow; Bennett,7,0,32,25
1656766923736,MATH 142A,B03,093481,Chow; Bennett,7,0,32,25
1656766923736,MATH 142A,B04,093558,Chow; Bennett,10,0,32,22
1656766923736,MATH 142A,B05,093559,Chow; Bennett,6,0,32,26
1656766929768,MATH 193A,A01,083224,Rotar; Vladimir,6,0,34,28
1656766929768,MATH 193A,A02,083225,Rotar; Vladimir,3,0,34,31
1656766929768,MATH 193A,A03,083781,Rotar; Vladimir,1,0,34,33
1656766929768,MATH 193A,A04,083782,Rotar; Vladimir,6,0,34,28
1656766929768,MATH 193A,A05,093482,Rotar; Vladimir,6,0,34,28
1656766935798,MATH 197,001,091859,McAuley; Julian John,9999,0,9999,0
1656766935798,MATH 197,002,095566,Kedlaya; Kiran S.,9997,0,9999,2
1656766935798,MATH 197,003,095567,Xiao; Ming,9999,0,9999,0
1656766935798,MATH 197,004,095571,Perols; Johan Lars,9998,0,9999,1
1656766942870,COGS 9,A01,083615,Shannon; Kyle Michael,6,0,75,69
1656766948897,COGS 11,A01,083617,Boyle; Mary E. T.,18,0,48,30
1656766954921,COGS 13,A01,083071,Bastos; Amalia Pinkusfeld,8,0,71,63
1656766960954,COGS 14A,A01,092681,Semenuks; Arturs,0,1,100,100
1656766966980,COGS 14B,A01,083073,Cheng; Tzu-Han,5,0,63,58
1656766973012,COGS 17,A01,092677,Semenuks; Arturs,4,0,81,77
1656766979037,COGS 100,A01,083619,Allen; Michael Gordon,15,0,70,55
1656766985062,COGS 101A,A01,083621,Davis; Joshua Daniel,9,0,68,59
1656766991087,COGS 101B,A01,091572,Allen; Michael Gordon,8,0,65,57
1656766997117,COGS 101C,A01,083625,Delgado; Tania,17,0,35,18
1656767003143,COGS 107A,A01,083627,Boyle; Mary E. T.,13,0,60,47
1656767009167,COGS 118A,A01,083075,Gupta; Anjum,15,0,76,61
1656767015194,CSE 3,A50,083646,Miranda; Gregory Joseph,22,0,50,28
1656767021219,CSE 8A,A50,083650,Miranda; Gregory Joseph,17,1,56,39
1656767027244,CSE 11,A01,083080,Cao; Yingjun,4,15,40,36
1656767033271,CSE 12,A01,083652,Krause-Levy; Sophia Louisa,20,1,120,100
1656767039369,CSE 15L,A01,083654,Morris; Justin Loren,8,0,50,42
1656767039369,CSE 15L,A02,083655,Morris; Justin Loren,8,0,50,42
1656767045401,CSE 20,A01,083657,Tran; Khoa Dang,37,0,80,43
1656767051428,CSE 21,A01,095574,Bach; Quang Tran,21,0,48,27
1656767057463,CSE 30,A01,083084,Eldon; John,4,0,80,76
1656767057463,CSE 30,B01,095061,Bhaskar; Nishant,5,0,50,45
1656767063486,CSE 100,A01,083659,Cao; Yingjun,1,4,70,69
1656767069516,CSE 134B,A01,083661,Powell; Thomas Allan,18,0,100,82
1656767075542,CSE 140,A01,083663,Gungor; Onat,14,0,85,71
1656767081571,CSE 140L,A01,083088,Eldon; John,16,0,100,84
1656767087602,CSE 175,A01,083665,Kumar; Rakesh,3,0,25,22
1656767093631,CSE 190,A00,092507,Dubnov; Shlomo,7,0,20,13
1656767099664,ECE 45,A01,083139,Congero; Spencer William,5,0,75,70
1656767105691,ECE 65,A50,083695,Saad; Andrew S,12,0,30,18
1656767105691,ECE 65,A51,095125,Saad; Andrew S,25,0,26,1
1656767111722,ECE 109,A01,091882,Touri; Behrouz,15,0,70,55
1656767117755,ECE 180,A00,083140,Abi Samra; Nicholas Camill,0,0,30,30
1656767117755,ECE 180,B00,083141,Abi Samra; Nicholas Camill,0,0,30,30
1656767123789,MATH 10A,A01,083735,Patchell; Gregory David,1,0,30,29
1656767123789,MATH 10A,A02,083736,Patchell; Gregory David,20,0,30,10
1656767123789,MATH 10A,A03,083737,Patchell; Gregory David,15,0,30,15
1656767129820,MATH 10B,A01,083207,Lim; Seonhee,7,0,34,27
1656767129820,MATH 10B,A02,083208,Lim; Seonhee,9,0,35,26
1656767129820,MATH 10B,A03,093472,Lim; Seonhee,4,0,34,30
1656767129820,MATH 10B,B01,083739,Sinha; Shubham,9,0,30,21
1656767135859,MATH 18,A01,083743,Cinel; Cameron Alexander,6,0,30,24
1656767135859,MATH 18,A02,083744,Cinel; Cameron Alexander,15,0,30,15
1656767135859,MATH 18,A03,083745,Cinel; Cameron Alexander,8,0,30,22
1656767135859,MATH 18,B01,083748,Rideout; David Porter,3,0,37,34
1656767135859,MATH 18,B02,083749,Rideout; David Porter,3,0,36,33
1656767135859,MATH 18,B03,083750,Rideout; David Porter,1,0,37,36
1656767135859,MATH 18,B04,083751,Rideout; David Porter,5,0,36,31
1656767135859,MATH 18,B05,093473,Rideout; David Porter,4,0,36,32
1656767135859,MATH 18,B06,093474,Rideout; David Porter,5,0,36,31
1656767141888,MATH 20A,A01,083754,Zheng; Zequn,12,0,40,28
1656767147914,MATH 20B,A01,083756,Briones; Jor-el Thomas Caparas,1,0,36,35
1656767147914,MATH 20B,A02,083757,Briones; Jor-el Thomas Caparas,1,0,36,35
1656767147914,MATH 20B,A03,093475,Briones; Jor-el Thomas Caparas,0,0,36,36
1656767153949,MATH 20C,A01,083760,Briones; Jor-el Thomas Caparas,1,0,35,34
1656767153949,MATH 20C,A02,083761,Briones; Jor-el Thomas Caparas,8,0,35,27
1656767153949,MATH 20C,A03,093476,Briones; Jor-el Thomas Caparas,0,1,36,36
1656767153949,MATH 20C,B01,083762,Bach; Quang Tran,0,0,30,30
1656767159975,MATH 20D,A01,083765,Tran; Brian Kha,4,0,30,26
1656767159975,MATH 20D,A02,083766,Tran; Brian Kha,4,0,30,26
1656767159975,MATH 20D,A03,083767,Tran; Brian Kha,2,0,30,28
1656767166001,MATH 20E,A01,083771,Ganguly; Soumya,5,0,32,27
1656767166001,MATH 20E,A02,083772,Ganguly; Soumya,5,0,32,27
1656767166001,MATH 20E,B01,083773,Ciotti; Benjamin,18,0,35,17
1656767166001,MATH 20E,B02,083774,Ciotti; Benjamin,17,0,35,18
1656767172036,MATH 103A,A01,083777,Greenfeld; Be'Eri,2,0,36,34
1656767172036,MATH 103A,A02,083778,Greenfeld; Be'Eri,5,0,36,31
1656767172036,MATH 103A,A03,093561,Greenfeld; Be'Eri,4,0,36,32
1656767172036,MATH 103A,B01,083779,Greenfeld; Be'Eri,6,0,36,30
1656767172036,MATH 103A,B02,083780,Greenfeld; Be'Eri,2,0,36,34
1656767172036,MATH 103A,B03,093562,Greenfeld; Be'Eri,2,0,36,34
1656767178067,MATH 105,A01,085443,Carter; Anne Toulson,13,0,35,22
1656767178067,MATH 105,A02,093477,Carter; Anne Toulson,20,0,35,15
1656767184094,MATH 109,A01,083213,Ganzberger; Geoffrey Michael,2,0,34,32
1656767184094,MATH 109,A02,083214,Ganzberger; Geoffrey Michael,2,0,34,32
1656767184094,MATH 109,A03,093478,Ganzberger; Geoffrey Michael,1,0,34,33
1656767184094,MATH 109,B01,083215,Ganzberger; Geoffrey Michael,1,0,32,31
1656767184094,MATH 109,B02,083216,Ganzberger; Geoffrey Michael,1,0,32,31
1656767184094,MATH 109,B03,093479,Ganzberger; Geoffrey Michael,6,0,32,26
1656767190122,MATH 142A,A01,083219,Chow; Bennett,6,0,32,26
1656767190122,MATH 142A,A02,083220,Chow; Bennett,9,0,32,23
1656767190122,MATH 142A,A03,093480,Chow; Bennett,7,0,32,25
1656767190122,MATH 142A,B03,093481,Chow; Bennett,7,0,32,25
1656767190122,MATH 142A,B04,093558,Chow; Bennett,10,0,32,22
1656767190122,MATH 142A,B05,093559,Chow; Bennett,6,0,32,26
1656767196153,MATH 193A,A01,083224,Rotar; Vladimir,6,0,34,28
1656767196153,MATH 193A,A02,083225,Rotar; Vladimir,3,0,34,31
1656767196153,MATH 193A,A03,083781,Rotar; Vladimir,1,0,34,33
1656767196153,MATH 193A,A04,083782,Rotar; Vladimir,6,0,34,28
1656767196153,MATH 193A,A05,093482,Rotar; Vladimir,6,0,34,28
1656767202183,MATH 197,001,091859,McAuley; Julian John,9999,0,9999,0
1656767202183,MATH 197,002,095566,Kedlaya; Kiran S.,9997,0,9999,2
1656767202183,MATH 197,003,095567,Xiao; Ming,9999,0,9999,0
1656767202183,MATH 197,004,095571,Perols; Johan Lars,9998,0,9999,1
1656767209251,COGS 9,A01,083615,Shannon; Kyle Michael,6,0,75,69
1656767215275,COGS 11,A01,083617,Boyle; Mary E. T.,18,0,48,30
1656767221300,COGS 13,A01,083071,Bastos; Amalia Pinkusfeld,8,0,71,63
1656767227329,COGS 14A,A01,092681,Semenuks; Arturs,0,1,100,100
1656767233359,COGS 14B,A01,083073,Cheng; Tzu-Han,5,0,63,58
1656767239383,COGS 17,A01,092677,Semenuks; Arturs,4,0,81,77
1656767245415,COGS 100,A01,083619,Allen; Michael Gordon,15,0,70,55
1656767251445,COGS 101A,A01,083621,Davis; Joshua Daniel,9,0,68,59
1656767257481,COGS 101B,A01,091572,Allen; Michael Gordon,8,0,65,57
1656767263508,COGS 101C,A01,083625,Delgado; Tania,17,0,35,18
1656767269532,COGS 107A,A01,083627,Boyle; Mary E. T.,13,0,60,47
1656767275558,COGS 118A,A01,083075,Gupta; Anjum,15,0,76,61
1656767281587,CSE 3,A50,083646,Miranda; Gregory Joseph,22,0,50,28
1656767287612,CSE 8A,A50,083650,Miranda; Gregory Joseph,17,1,56,39
1656767293637,CSE 11,A01,083080,Cao; Yingjun,4,15,40,36
1656767299668,CSE 12,A01,083652,Krause-Levy; Sophia Louisa,20,1,120,100
1656767305702,CSE 15L,A01,083654,Morris; Justin Loren,8,0,50,42
1656767305702,CSE 15L,A02,083655,Morris; Justin Loren,8,0,50,42
1656767311732,CSE 20,A01,083657,Tran; Khoa Dang,37,0,80,43
1656767317757,CSE 21,A01,095574,Bach; Quang Tran,21,0,48,27
1656767323784,CSE 30,A01,083084,Eldon; John,4,0,80,76
1656767323784,CSE 30,B01,095061,Bhaskar; Nishant,5,0,50,45
1656767329808,CSE 100,A01,083659,Cao; Yingjun,1,4,70,69
1656767335832,CSE 134B,A01,083661,Powell; Thomas Allan,18,0,100,82
1656767341858,CSE 140,A01,083663,Gungor; Onat,14,0,85,71
1656767347884,CSE 140L,A01,083088,Eldon; John,16,0,100,84
1656767353910,CSE 175,A01,083665,Kumar; Rakesh,3,0,25,22
1656767359933,CSE 190,A00,092507,Dubnov; Shlomo,7,0,20,13
1656767365960,ECE 45,A01,083139,Congero; Spencer William,5,0,75,70
1656767371993,ECE 65,A50,083695,Saad; Andrew S,12,0,30,18
1656767371993,ECE 65,A51,095125,Saad; Andrew S,25,0,26,1
1656767378020,ECE 109,A01,091882,Touri; Behrouz,15,0,70,55
1656767384051,ECE 180,A00,083140,Abi Samra; Nicholas Camill,0,0,30,30
1656767384051,ECE 180,B00,083141,Abi Samra; Nicholas Camill,0,0,30,30
1656767390084,MATH 10A,A01,083735,Patchell; Gregory David,1,0,30,29
1656767390084,MATH 10A,A02,083736,Patchell; Gregory David,20,0,30,10
1656767390084,MATH 10A,A03,083737,Patchell; Gregory David,15,0,30,15
1656767396111,MATH 10B,A01,083207,Lim; Seonhee,7,0,34,27
1656767396111,MATH 10B,A02,083208,Lim; Seonhee,9,0,35,26
1656767396111,MATH 10B,A03,093472,Lim; Seonhee,4,0,34,30
1656767396111,MATH 10B,B01,083739,Sinha; Shubham,9,0,30,21
1656767402149,MATH 18,A01,083743,Cinel; Cameron Alexander,6,0,30,24
1656767402149,MATH 18,A02,083744,Cinel; Cameron Alexander,15,0,30,15
1656767402149,MATH 18,A03,083745,Cinel; Cameron Alexander,8,0,30,22
1656767402149,MATH 18,B01,083748,Rideout; David Porter,3,0,37,34
1656767402149,MATH 18,B02,083749,Rideout; David Porter,3,0,36,33
1656767402149,MATH 18,B03,083750,Rideout; David Porter,1,0,37,36
1656767402149,MATH 18,B04,083751,Rideout; David Porter,5,0,36,31
1656767402149,MATH 18,B05,093473,Rideout; David Porter,4,0,36,32
1656767402149,MATH 18,B06,093474,Rideout; David Porter,5,0,36,31
1656767408178,MATH 20A,A01,083754,Zheng; Zequn,12,0,40,28
1656767414213,MATH 20B,A01,083756,Briones; Jor-el Thomas Caparas,1,0,36,35
1656767414213,MATH 20B,A02,083757,Briones; Jor-el Thomas Caparas,1,0,36,35
1656767414213,MATH 20B,A03,093475,Briones; Jor-el Thomas Caparas,0,0,36,36
1656767420247,MATH 20C,A01,083760,Briones; Jor-el Thomas Caparas,1,0,35,34
1656767420247,MATH 20C,A02,083761,Briones; Jor-el Thomas Caparas,8,0,35,27
1656767420247,MATH 20C,A03,093476,Briones; Jor-el Thomas Caparas,0,1,36,36
1656767420247,MATH 20C,B01,083762,Bach; Quang Tran,0,0,30,30
1656767426281,MATH 20D,A01,083765,Tran; Brian Kha,4,0,30,26
1656767426281,MATH 20D,A02,083766,Tran; Brian Kha,4,0,30,26
1656767426281,MATH 20D,A03,083767,Tran; Brian Kha,2,0,30,28
1656767432308,MATH 20E,A01,083771,Ganguly; Soumya,5,0,32,27
1656767432308,MATH 20E,A02,083772,Ganguly; Soumya,5,0,32,27
1656767432308,MATH 20E,B01,083773,Ciotti; Benjamin,18,0,35,17
1656767432308,MATH 20E,B02,083774,Ciotti; Benjamin,17,0,35,18
1656767438343,MATH 103A,A01,083777,Greenfeld; Be'Eri,2,0,36,34
1656767438343,MATH 103A,A02,083778,Greenfeld; Be'Eri,5,0,36,31
1656767438343,MATH 103A,A03,093561,Greenfeld; Be'Eri,4,0,36,32
1656767438343,MATH 103A,B01,083779,Greenfeld; Be'Eri,6,0,36,30
1656767438343,MATH 103A,B02,083780,Greenfeld; Be'Eri,2,0,36,34
1656767438343,MATH 103A,B03,093562,Greenfeld; Be'Eri,2,0,36,34
1656767444370,MATH 105,A01,085443,Carter; Anne Toulson,13,0,35,22
1656767444370,MATH 105,A02,093477,Carter; Anne Toulson,20,0,35,15
1656767450395,MATH 109,A01,083213,Ganzberger; Geoffrey Michael,2,0,34,32
1656767450395,MATH 109,A02,083214,Ganzberger; Geoffrey Michael,2,0,34,32
1656767450395,MATH 109,A03,093478,Ganzberger; Geoffrey Michael,1,0,34,33
1656767450395,MATH 109,B01,083215,Ganzberger; Geoffrey Michael,1,0,32,31
1656767450395,MATH 109,B02,083216,Ganzberger; Geoffrey Michael,1,0,32,31
1656767450395,MATH 109,B03,093479,Ganzberger; Geoffrey Michael,6,0,32,26
1656767456422,MATH 142A,A01,083219,Chow; Bennett,6,0,32,26
1656767456422,MATH 142A,A02,083220,Chow; Bennett,9,0,32,23
1656767456422,MATH 142A,A03,093480,Chow; Bennett,7,0,32,25
1656767456422,MATH 142A,B03,093481,Chow; Bennett,7,0,32,25
1656767456422,MATH 142A,B04,093558,Chow; Bennett,10,0,32,22
1656767456422,MATH 142A,B05,093559,Chow; Bennett,6,0,32,26
1656767462450,MATH 193A,A01,083224,Rotar; Vladimir,6,0,34,28
1656767462450,MATH 193A,A02,083225,Rotar; Vladimir,3,0,34,31
1656767462450,MATH 193A,A03,083781,Rotar; Vladimir,1,0,34,33
1656767462450,MATH 193A,A04,083782,Rotar; Vladimir,6,0,34,28
1656767462450,MATH 193A,A05,093482,Rotar; Vladimir,6,0,34,28
1656767468483,MATH 197,001,091859,McAuley; Julian John,9999,0,9999,0
1656767468483,MATH 197,002,095566,Kedlaya; Kiran S.,9997,0,9999,2
1656767468483,MATH 197,003,095567,Xiao; Ming,9999,0,9999,0
1656767468483,MATH 197,004,095571,Perols; Johan Lars,9998,0,9999,1
1656767475564,COGS 9,A01,083615,Shannon; Kyle Michael,6,0,75,69
1656767481604,COGS 11,A01,083617,Boyle; Mary E. T.,18,0,48,30
1656767487632,COGS 13,A01,083071,Bastos; Amalia Pinkusfeld,8,0,71,63
1656767493657,COGS 14A,A01,092681,Semenuks; Arturs,0,1,100,100
1656767499687,COGS 14B,A01,083073,Cheng; Tzu-Han,5,0,63,58
1656767505716,COGS 17,A01,092677,Semenuks; Arturs,4,0,81,77
1656767511744,COGS 100,A01,083619,Allen; Michael Gordon,15,0,70,55
1656767517775,COGS 101A,A01,083621,Davis; Joshua Daniel,9,0,68,59
1656767523800,COGS 101B,A01,091572,Allen; Michael Gordon,8,0,65,57
1656767529828,COGS 101C,A01,083625,Delgado; Tania,17,0,35,18
1656767535860,COGS 107A,A01,083627,Boyle; Mary E. T.,13,0,60,47
1656767541885,COGS 118A,A01,083075,Gupta; Anjum,15,0,76,61
1656767547920,CSE 3,A50,083646,Miranda; Gregory Joseph,22,0,50,28
1656767553944,CSE 8A,A50,083650,Miranda; Gregory Joseph,17,1,56,39
1656767559971,CSE 11,A01,083080,Cao; Yingjun,4,15,40,36
1656767566015,CSE 12,A01,083652,Krause-Levy; Sophia Louisa,20,1,120,100
1656767572043,CSE 15L,A01,083654,Morris; Justin Loren,8,0,50,42
1656767572043,CSE 15L,A02,083655,Morris; Justin Loren,8,0,50,42
1656767578067,CSE 20,A01,083657,Tran; Khoa Dang,37,0,80,43
1656767584102,CSE 21,A01,095574,Bach; Quang Tran,21,0,48,27
1656767590134,CSE 30,A01,083084,Eldon; John,4,0,80,76
1656767590134,CSE 30,B01,095061,Bhaskar; Nishant,5,0,50,45
1656767596161,CSE 100,A01,083659,Cao; Yingjun,1,4,70,69
1656767602185,CSE 134B,A01,083661,Powell; Thomas Allan,18,0,100,82
1656767608209,CSE 140,A01,083663,Gungor; Onat,14,0,85,71
1656767614234,CSE 140L,A01,083088,Eldon; John,16,0,100,84
1656767620264,CSE 175,A01,083665,Kumar; Rakesh,3,0,25,22
1656767626289,CSE 190,A00,092507,Dubnov; Shlomo,7,0,20,13
1656767632321,ECE 45,A01,083139,Congero; Spencer William,5,0,75,70
1656767638437,ECE 65,A50,083695,Saad; Andrew S,12,0,30,18
1656767638437,ECE 65,A51,095125,Saad; Andrew S,25,0,26,1
1656767644469,ECE 109,A01,091882,Touri; Behrouz,15,0,70,55
1656767650494,ECE 180,A00,083140,Abi Samra; Nicholas Camill,0,0,30,30
1656767650494,ECE 180,B00,083141,Abi Samra; Nicholas Camill,0,0,30,30
1656767656526,MATH 10A,A01,083735,Patchell; Gregory David,1,0,30,29
1656767656526,MATH 10A,A02,083736,Patchell; Gregory David,20,0,30,10
1656767656526,MATH 10A,A03,083737,Patchell; Gregory David,15,0,30,15
1656767662556,MATH 10B,A01,083207,Lim; Seonhee,7,0,34,27
1656767662556,MATH 10B,A02,083208,Lim; Seonhee,9,0,35,26
1656767662556,MATH 10B,A03,093472,Lim; Seonhee,4,0,34,30
1656767662556,MATH 10B,B01,083739,Sinha; Shubham,9,0,30,21
1656767668595,MATH 18,A01,083743,Cinel; Cameron Alexander,6,0,30,24
1656767668595,MATH 18,A02,083744,Cinel; Cameron Alexander,15,0,30,15
1656767668595,MATH 18,A03,083745,Cinel; Cameron Alexander,8,0,30,22
1656767668595,MATH 18,B01,083748,Rideout; David Porter,3,0,37,34
1656767668595,MATH 18,B02,083749,Rideout; David Porter,3,0,36,33
1656767668595,MATH 18,B03,083750,Rideout; David Porter,1,0,37,36
1656767668595,MATH 18,B04,083751,Rideout; David Porter,5,0,36,31
1656767668595,MATH 18,B05,093473,Rideout; David Porter,4,0,36,32
1656767668595,MATH 18,B06,093474,Rideout; David Porter,5,0,36,31
1656767674624,MATH 20A,A01,083754,Zheng; Zequn,12,0,40,28
1656767680649,MATH 20B,A01,083756,Briones; Jor-el Thomas Caparas,1,0,36,35
1656767680649,MATH 20B,A02,083757,Briones; Jor-el Thomas Caparas,1,0,36,35
1656767680649,MATH 20B,A03,093475,Briones; Jor-el Thomas Caparas,0,0,36,36
1656767686675,MATH 20C,A01,083760,Briones; Jor-el Thomas Caparas,1,0,35,34
1656767686675,MATH 20C,A02,083761,Briones; Jor-el Thomas Caparas,8,0,35,27
1656767686675,MATH 20C,A03,093476,Briones; Jor-el Thomas Caparas,0,1,36,36
1656767686675,MATH 20C,B01,083762,Bach; Quang Tran,0,0,30,30
1656767692712,MATH 20D,A01,083765,Tran; Brian Kha,4,0,30,26
1656767692712,MATH 20D,A02,083766,Tran; Brian Kha,4,0,30,26
1656767692712,MATH 20D,A03,083767,Tran; Brian Kha,2,0,30,28
1656767698738,MATH 20E,A01,083771,Ganguly; Soumya,5,0,32,27
1656767698738,MATH 20E,A02,083772,Ganguly; Soumya,5,0,32,27
1656767698738,MATH 20E,B01,083773,Ciotti; Benjamin,18,0,35,17
1656767698738,MATH 20E,B02,083774,Ciotti; Benjamin,17,0,35,18
1656767704773,MATH 103A,A01,083777,Greenfeld; Be'Eri,2,0,36,34
1656767704773,MATH 103A,A02,083778,Greenfeld; Be'Eri,5,0,36,31
1656767704773,MATH 103A,A03,093561,Greenfeld; Be'Eri,4,0,36,32
1656767704773,MATH 103A,B01,083779,Greenfeld; Be'Eri,6,0,36,30
1656767704773,MATH 103A,B02,083780,Greenfeld; Be'Eri,2,0,36,34
1656767704773,MATH 103A,B03,093562,Greenfeld; Be'Eri,2,0,36,34
1656767710803,MATH 105,A01,085443,Carter; Anne Toulson,13,0,35,22
1656767710803,MATH 105,A02,093477,Carter; Anne Toulson,20,0,35,15
1656767716835,MATH 109,A01,083213,Ganzberger; Geoffrey Michael,2,0,34,32
1656767716835,MATH 109,A02,083214,Ganzberger; Geoffrey Michael,2,0,34,32
1656767716835,MATH 109,A03,093478,Ganzberger; Geoffrey Michael,1,0,34,33
1656767716835,MATH 109,B01,083215,Ganzberger; Geoffrey Michael,1,0,32,31
1656767716835,MATH 109,B02,083216,Ganzberger; Geoffrey Michael,1,0,32,31
1656767716835,MATH 109,B03,093479,Ganzberger; Geoffrey Michael,6,0,32,26
1656767722870,MATH 142A,A01,083219,Chow; Bennett,6,0,32,26
1656767722870,MATH 142A,A02,083220,Chow; Bennett,9,0,32,23
1656767722870,MATH 142A,A03,093480,Chow; Bennett,7,0,32,25
1656767722870,MATH 142A,B03,093481,Chow; Bennett,7,0,32,25
1656767722870,MATH 142A,B04,093558,Chow; Bennett,10,0,32,22
1656767722870,MATH 142A,B05,093559,Chow; Bennett,6,0,32,26
1656767728899,MATH 193A,A01,083224,Rotar; Vladimir,6,0,34,28
1656767728899,MATH 193A,A02,083225,Rotar; Vladimir,3,0,34,31
1656767728899,MATH 193A,A03,083781,Rotar; Vladimir,1,0,34,33
1656767728899,MATH 193A,A04,083782,Rotar; Vladimir,6,0,34,28
1656767728899,MATH 193A,A05,093482,Rotar; Vladimir,6,0,34,28
1656767734929,MATH 197,001,091859,McAuley; Julian John,9999,0,9999,0
1656767734929,MATH 197,002,095566,Kedlaya; Kiran S.,9997,0,9999,2
1656767734929,MATH 197,003,095567,Xiao; Ming,9999,0,9999,0
1656767734929,MATH 197,004,095571,Perols; Johan Lars,9998,0,9999,1
1656767741993,COGS 9,A01,083615,Shannon; Kyle Michael,6,0,75,69
1656767748020,COGS 11,A01,083617,Boyle; Mary E. T.,18,0,48,30
1656767754043,COGS 13,A01,083071,Bastos; Amalia Pinkusfeld,8,0,71,63
1656767760077,COGS 14A,A01,092681,Semenuks; Arturs,0,1,100,100
1656767766102,COGS 14B,A01,083073,Cheng; Tzu-Han,5,0,63,58
1656767772133,COGS 17,A01,092677,Semenuks; Arturs,4,0,81,77
1656767778159,COGS 100,A01,083619,Allen; Michael Gordon,15,0,70,55
1656767784183,COGS 101A,A01,083621,Davis; Joshua Daniel,9,0,68,59
1656767790208,COGS 101B,A01,091572,Allen; Michael Gordon,8,0,65,57
1656767796239,COGS 101C,A01,083625,Delgado; Tania,17,0,35,18
1656767802265,COGS 107A,A01,083627,Boyle; Mary E. T.,13,0,60,47
1656767808289,COGS 118A,A01,083075,Gupta; Anjum,15,0,76,61
1656767814318,CSE 3,A50,083646,Miranda; Gregory Joseph,22,0,50,28
1656767820346,CSE 8A,A50,083650,Miranda; Gregory Joseph,17,1,56,39
1656767826371,CSE 11,A01,083080,Cao; Yingjun,4,15,40,36
1656767832397,CSE 12,A01,083652,Krause-Levy; Sophia Louisa,20,1,120,100
1656767838422,CSE 15L,A01,083654,Morris; Justin Loren,8,0,50,42
1656767838422,CSE 15L,A02,083655,Morris; Justin Loren,8,0,50,42
1656767844452,CSE 20,A01,083657,Tran; Khoa Dang,37,0,80,43
1656767850482,CSE 21,A01,095574,Bach; Quang Tran,21,0,48,27
1656767856508,CSE 30,A01,083084,Eldon; John,4,0,80,76
1656767856508,CSE 30,B01,095061,Bhaskar; Nishant,5,0,50,45
1656767862539,CSE 100,A01,083659,Cao; Yingjun,1,4,70,69
1656767868564,CSE 134B,A01,083661,Powell; Thomas Allan,18,0,100,82
1656767874593,CSE 140,A01,083663,Gungor; Onat,14,0,85,71
1656767880624,CSE 140L,A01,083088,Eldon; John,16,0,100,84
1656767886651,CSE 175,A01,083665,Kumar; Rakesh,3,0,25,22
1656767892678,CSE 190,A00,092507,Dubnov; Shlomo,7,0,20,13
1656767898710,ECE 45,A01,083139,Congero; Spencer William,5,0,75,70
1656767904736,ECE 65,A50,083695,Saad; Andrew S,12,0,30,18
1656767904736,ECE 65,A51,095125,Saad; Andrew S,25,0,26,1
1656767910766,ECE 109,A01,091882,Touri; Behrouz,15,0,70,55
1656767916796,ECE 180,A00,083140,Abi Samra; Nicholas Camill,0,0,30,30
1656767916796,ECE 180,B00,083141,Abi Samra; Nicholas Camill,0,0,30,30
1656767922824,MATH 10A,A01,083735,Patchell; Gregory David,1,0,30,29
1656767922824,MATH 10A,A02,083736,Patchell; Gregory David,20,0,30,10
1656767922824,MATH 10A,A03,083737,Patchell; Gregory David,15,0,30,15
1656767928861,MATH 10B,A01,083207,Lim; Seonhee,7,0,34,27
1656767928861,MATH 10B,A02,083208,Lim; Seonhee,9,0,35,26
1656767928861,MATH 10B,A03,093472,Lim; Seonhee,4,0,34,30
1656767928861,MATH 10B,B01,083739,Sinha; Shubham,9,0,30,21
1656767934891,MATH 18,A01,083743,Cinel; Cameron Alexander,6,0,30,24
1656767934891,MATH 18,A02,083744,Cinel; Cameron Alexander,15,0,30,15
1656767934891,MATH 18,A03,083745,Cinel; Cameron Alexander,8,0,30,22
1656767934891,MATH 18,B01,083748,Rideout; David Porter,3,0,37,34
1656767934891,MATH 18,B02,083749,Rideout; David Porter,3,0,36,33
1656767934891,MATH 18,B03,083750,Rideout; David Porter,1,0,37,36
1656767934891,MATH 18,B04,083751,Rideout; David Porter,5,0,36,31
1656767934891,MATH 18,B05,093473,Rideout; David Porter,4,0,36,32
1656767934891,MATH 18,B06,093474,Rideout; David Porter,5,0,36,31
1656767940913,MATH 20A,A01,083754,Zheng; Zequn,12,0,40,28
1656767946941,MATH 20B,A01,083756,Briones; Jor-el Thomas Caparas,1,0,36,35
1656767946941,MATH 20B,A02,083757,Briones; Jor-el Thomas Caparas,1,0,36,35
1656767946941,MATH 20B,A03,093475,Briones; Jor-el Thomas Caparas,0,0,36,36
1656767952974,MATH 20C,A01,083760,Briones; Jor-el Thomas Caparas,1,0,35,34
1656767952974,MATH 20C,A02,083761,Briones; Jor-el Thomas Caparas,8,0,35,27
1656767952974,MATH 20C,A03,093476,Briones; Jor-el Thomas Caparas,0,1,36,36
1656767952974,MATH 20C,B01,083762,Bach; Quang Tran,0,0,30,30
1656767959020,MATH 20D,A01,083765,Tran; Brian Kha,4,0,30,26
1656767959020,MATH 20D,A02,083766,Tran; Brian Kha,4,0,30,26
1656767959020,MATH 20D,A03,083767,Tran; Brian Kha,2,0,30,28
1656767965056,MATH 20E,A01,083771,Ganguly; Soumya,5,0,32,27
1656767965056,MATH 20E,A02,083772,Ganguly; Soumya,5,0,32,27
1656767965056,MATH 20E,B01,083773,Ciotti; Benjamin,18,0,35,17
1656767965056,MATH 20E,B02,083774,Ciotti; Benjamin,17,0,35,18
1656767971086,MATH 103A,A01,083777,Greenfeld; Be'Eri,2,0,36,34
1656767971086,MATH 103A,A02,083778,Greenfeld; Be'Eri,5,0,36,31
1656767971086,MATH 103A,A03,093561,Greenfeld; Be'Eri,4,0,36,32
1656767971086,MATH 103A,B01,083779,Greenfeld; Be'Eri,6,0,36,30
1656767971086,MATH 103A,B02,083780,Greenfeld; Be'Eri,2,0,36,34
1656767971086,MATH 103A,B03,093562,Greenfeld; Be'Eri,2,0,36,34
1656767977118,MATH 105,A01,085443,Carter; Anne Toulson,13,0,35,22
1656767977118,MATH 105,A02,093477,Carter; Anne Toulson,20,0,35,15
1656767983150,MATH 109,A01,083213,Ganzberger; Geoffrey Michael,2,0,34,32
1656767983150,MATH 109,A02,083214,Ganzberger; Geoffrey Michael,2,0,34,32
1656767983150,MATH 109,A03,093478,Ganzberger; Geoffrey Michael,1,0,34,33
1656767983150,MATH 109,B01,083215,Ganzberger; Geoffrey Michael,1,0,32,31
1656767983150,MATH 109,B02,083216,Ganzberger; Geoffrey Michael,1,0,32,31
1656767983150,MATH 109,B03,093479,Ganzberger; Geoffrey Michael,6,0,32,26
1656767989187,MATH 142A,A01,083219,Chow; Bennett,6,0,32,26
1656767989187,MATH 142A,A02,083220,Chow; Bennett,9,0,32,23
1656767989187,MATH 142A,A03,093480,Chow; Bennett,7,0,32,25
1656767989187,MATH 142A,B03,093481,Chow; Bennett,7,0,32,25
1656767989187,MATH 142A,B04,093558,Chow; Bennett,10,0,32,22
1656767989187,MATH 142A,B05,093559,Chow; Bennett,6,0,32,26
1656767995220,MATH 193A,A01,083224,Rotar; Vladimir,6,0,34,28
1656767995220,MATH 193A,A02,083225,Rotar; Vladimir,3,0,34,31
1656767995220,MATH 193A,A03,083781,Rotar; Vladimir,1,0,34,33
1656767995220,MATH 193A,A04,083782,Rotar; Vladimir,6,0,34,28
1656767995220,MATH 193A,A05,093482,Rotar; Vladimir,6,0,34,28
1656768001258,MATH 197,001,091859,McAuley; Julian John,9999,0,9999,0
1656768001258,MATH 197,002,095566,Kedlaya; Kiran S.,9997,0,9999,2
1656768001258,MATH 197,003,095567,Xiao; Ming,9999,0,9999,0
1656768001258,MATH 197,004,095571,Perols; Johan Lars,9998,0,9999,1
1656768008326,COGS 9,A01,083615,Shannon; Kyle Michael,6,0,75,69
1656768014356,COGS 11,A01,083617,Boyle; Mary E. T.,18,0,48,30
1656768020381,COGS 13,A01,083071,Bastos; Amalia Pinkusfeld,8,0,71,63
1656768026406,COGS 14A,A01,092681,Semenuks; Arturs,0,1,100,100
1656768032436,COGS 14B,A01,083073,Cheng; Tzu-Han,5,0,63,58
1656768038462,COGS 17,A01,092677,Semenuks; Arturs,4,0,81,77
1656768044486,COGS 100,A01,083619,Allen; Michael Gordon,15,0,70,55
1656768050511,COGS 101A,A01,083621,Davis; Joshua Daniel,9,0,68,59
1656768056536,COGS 101B,A01,091572,Allen; Michael Gordon,8,0,65,57
1656768062567,COGS 101C,A01,083625,Delgado; Tania,17,0,35,18
1656768068591,COGS 107A,A01,083627,Boyle; Mary E. T.,13,0,60,47
1656768074621,COGS 118A,A01,083075,Gupta; Anjum,15,0,76,61
1656768080659,CSE 3,A50,083646,Miranda; Gregory Joseph,22,0,50,28
1656768086687,CSE 8A,A50,083650,Miranda; Gregory Joseph,17,1,56,39
1656768092717,CSE 11,A01,083080,Cao; Yingjun,4,15,40,36
1656768098744,CSE 12,A01,083652,Krause-Levy; Sophia Louisa,20,1,120,100
1656768104774,CSE 15L,A01,083654,Morris; Justin Loren,8,0,50,42
1656768104774,CSE 15L,A02,083655,Morris; Justin Loren,8,0,50,42
1656768110804,CSE 20,A01,083657,Tran; Khoa Dang,37,0,80,43
1656768116834,CSE 21,A01,095574,Bach; Quang Tran,21,0,48,27
1656768122861,CSE 30,A01,083084,Eldon; John,4,0,80,76
1656768122861,CSE 30,B01,095061,Bhaskar; Nishant,5,0,50,45
1656768128894,CSE 100,A01,083659,Cao; Yingjun,1,4,70,69
1656768134923,CSE 134B,A01,083661,Powell; Thomas Allan,18,0,100,82
1656768140955,CSE 140,A01,083663,Gungor; Onat,14,0,85,71
1656768146982,CSE 140L,A01,083088,Eldon; John,16,0,100,84
1656768153008,CSE 175,A01,083665,Kumar; Rakesh,3,0,25,22
1656768159042,CSE 190,A00,092507,Dubnov; Shlomo,7,0,20,13
1656768165072,ECE 45,A01,083139,Congero; Spencer William,5,0,75,70
1656768171100,ECE 65,A50,083695,Saad; Andrew S,12,0,30,18
1656768171100,ECE 65,A51,095125,Saad; Andrew S,25,0,26,1
1656768177128,ECE 109,A01,091882,Touri; Behrouz,15,0,70,55
1656768183157,ECE 180,A00,083140,Abi Samra; Nicholas Camill,0,0,30,30
1656768183157,ECE 180,B00,083141,Abi Samra; Nicholas Camill,0,0,30,30
1656768189191,MATH 10A,A01,083735,Patchell; Gregory David,1,0,30,29
1656768189191,MATH 10A,A02,083736,Patchell; Gregory David,20,0,30,10
1656768189191,MATH 10A,A03,083737,Patchell; Gregory David,15,0,30,15
1656768195226,MATH 10B,A01,083207,Lim; Seonhee,7,0,34,27
1656768195226,MATH 10B,A02,083208,Lim; Seonhee,9,0,35,26
1656768195226,MATH 10B,A03,093472,Lim; Seonhee,4,0,34,30
1656768195226,MATH 10B,B01,083739,Sinha; Shubham,9,0,30,21
1656768201263,MATH 18,A01,083743,Cinel; Cameron Alexander,6,0,30,24
1656768201263,MATH 18,A02,083744,Cinel; Cameron Alexander,15,0,30,15
1656768201263,MATH 18,A03,083745,Cinel; Cameron Alexander,8,0,30,22
1656768201263,MATH 18,B01,083748,Rideout; David Porter,3,0,37,34
1656768201263,MATH 18,B02,083749,Rideout; David Porter,3,0,36,33
1656768201263,MATH 18,B03,083750,Rideout; David Porter,1,0,37,36
1656768201263,MATH 18,B04,083751,Rideout; David Porter,5,0,36,31
1656768201263,MATH 18,B05,093473,Rideout; David Porter,4,0,36,32
1656768201263,MATH 18,B06,093474,Rideout; David Porter,5,0,36,31
1656768207292,MATH 20A,A01,083754,Zheng; Zequn,12,0,40,28
1656768213318,MATH 20B,A01,083756,Briones; Jor-el Thomas Caparas,1,0,36,35
1656768213318,MATH 20B,A02,083757,Briones; Jor-el Thomas Caparas,1,0,36,35
1656768213318,MATH 20B,A03,093475,Briones; Jor-el Thomas Caparas,0,0,36,36
1656768219343,MATH 20C,A01,083760,Briones; Jor-el Thomas Caparas,1,0,35,34
1656768219343,MATH 20C,A02,083761,Briones; Jor-el Thomas Caparas,8,0,35,27
1656768219343,MATH 20C,A03,093476,Briones; Jor-el Thomas Caparas,0,1,36,36
1656768219343,MATH 20C,B01,083762,Bach; Quang Tran,0,0,30,30
1656768225371,MATH 20D,A01,083765,Tran; Brian Kha,4,0,30,26
1656768225371,MATH 20D,A02,083766,Tran; Brian Kha,4,0,30,26
1656768225371,MATH 20D,A03,083767,Tran; Brian Kha,2,0,30,28
1656768231397,MATH 20E,A01,083771,Ganguly; Soumya,5,0,32,27
1656768231397,MATH 20E,A02,083772,Ganguly; Soumya,5,0,32,27
1656768231397,MATH 20E,B01,083773,Ciotti; Benjamin,18,0,35,17
1656768231397,MATH 20E,B02,083774,Ciotti; Benjamin,17,0,35,18
1656768237497,MATH 103A,A01,083777,Greenfeld; Be'Eri,2,0,36,34
1656768237497,MATH 103A,A02,083778,Greenfeld; Be'Eri,5,0,36,31
1656768237497,MATH 103A,A03,093561,Greenfeld; Be'Eri,4,0,36,32
1656768237497,MATH 103A,B01,083779,Greenfeld; Be'Eri,6,0,36,30
1656768237497,MATH 103A,B02,083780,Greenfeld; Be'Eri,2,0,36,34
1656768237497,MATH 103A,B03,093562,Greenfeld; Be'Eri,2,0,36,34
1656768243521,MATH 105,A01,085443,Carter; Anne Toulson,13,0,35,22
1656768243521,MATH 105,A02,093477,Carter; Anne Toulson,20,0,35,15
1656768249549,MATH 109,A01,083213,Ganzberger; Geoffrey Michael,2,0,34,32
1656768249549,MATH 109,A02,083214,Ganzberger; Geoffrey Michael,2,0,34,32
1656768249549,MATH 109,A03,093478,Ganzberger; Geoffrey Michael,1,0,34,33
1656768249549,MATH 109,B01,083215,Ganzberger; Geoffrey Michael,1,0,32,31
1656768249549,MATH 109,B02,083216,Ganzberger; Geoffrey Michael,1,0,32,31
1656768249549,MATH 109,B03,093479,Ganzberger; Geoffrey Michael,6,0,32,26
1656768255576,MATH 142A,A01,083219,Chow; Bennett,6,0,32,26
1656768255576,MATH 142A,A02,083220,Chow; Bennett,9,0,32,23
1656768255576,MATH 142A,A03,093480,Chow; Bennett,7,0,32,25
1656768255576,MATH 142A,B03,093481,Chow; Bennett,7,0,32,25
1656768255576,MATH 142A,B04,093558,Chow; Bennett,10,0,32,22
1656768255576,MATH 142A,B05,093559,Chow; Bennett,6,0,32,26
1656768261602,MATH 193A,A01,083224,Rotar; Vladimir,6,0,34,28
1656768261602,MATH 193A,A02,083225,Rotar; Vladimir,3,0,34,31
1656768261602,MATH 193A,A03,083781,Rotar; Vladimir,1,0,34,33
1656768261602,MATH 193A,A04,083782,Rotar; Vladimir,6,0,34,28
1656768261602,MATH 193A,A05,093482,Rotar; Vladimir,6,0,34,28
1656768267633,MATH 197,001,091859,McAuley; Julian John,9999,0,9999,0
1656768267633,MATH 197,002,095566,Kedlaya; Kiran S.,9997,0,9999,2
1656768267633,MATH 197,003,095567,Xiao; Ming,9999,0,9999,0
1656768267633,MATH 197,004,095571,Perols; Johan Lars,9998,0,9999,1
1656768274696,COGS 9,A01,083615,Shannon; Kyle Michael,6,0,75,69
1656768280732,COGS 11,A01,083617,Boyle; Mary E. T.,18,0,48,30
1656768286765,COGS 13,A01,083071,Bastos; Amalia Pinkusfeld,8,0,71,63
1656768292802,COGS 14A,A01,092681,Semenuks; Arturs,0,1,100,100
1656768298832,COGS 14B,A01,083073,Cheng; Tzu-Han,5,0,63,58
1656768304862,COGS 17,A01,092677,Semenuks; Arturs,4,0,81,77
1656768310889,COGS 100,A01,083619,Allen; Michael Gordon,15,0,70,55
1656768316919,COGS 101A,A01,083621,Davis; Joshua Daniel,9,0,68,59
1656768322948,COGS 101B,A01,091572,Allen; Michael Gordon,8,0,65,57
1656768328974,COGS 101C,A01,083625,Delgado; Tania,17,0,35,18
1656768335007,COGS 107A,A01,083627,Boyle; Mary E. T.,13,0,60,47
1656768341038,COGS 118A,A01,083075,Gupta; Anjum,15,0,76,61
1656768347078,CSE 3,A50,083646,Miranda; Gregory Joseph,22,0,50,28
1656768353102,CSE 8A,A50,083650,Miranda; Gregory Joseph,17,1,56,39
1656768359130,CSE 11,A01,083080,Cao; Yingjun,4,15,40,36
1656768365155,CSE 12,A01,083652,Krause-Levy; Sophia Louisa,20,1,120,100
1656768371185,CSE 15L,A01,083654,Morris; Justin Loren,8,0,50,42
1656768371185,CSE 15L,A02,083655,Morris; Justin Loren,8,0,50,42
1656768377210,CSE 20,A01,083657,Tran; Khoa Dang,37,0,80,43
1656768383240,CSE 21,A01,095574,Bach; Quang Tran,21,0,48,27
1656768389265,CSE 30,A01,083084,Eldon; John,4,0,80,76
1656768389265,CSE 30,B01,095061,Bhaskar; Nishant,5,0,50,45
1656768395290,CSE 100,A01,083659,Cao; Yingjun,1,4,70,69
1656768401322,CSE 134B,A01,083661,Powell; Thomas Allan,18,0,100,82
1656768407352,CSE 140,A01,083663,Gungor; Onat,14,0,85,71
1656768413377,CSE 140L,A01,083088,Eldon; John,16,0,100,84
1656768419404,CSE 175,A01,083665,Kumar; Rakesh,3,0,25,22
1656768425432,CSE 190,A00,092507,Dubnov; Shlomo,7,0,20,13
1656768431466,ECE 45,A01,083139,Congero; Spencer William,5,0,75,70
1656768437497,ECE 65,A50,083695,Saad; Andrew S,12,0,30,18
1656768437497,ECE 65,A51,095125,Saad; Andrew S,25,0,26,1
1656768443523,ECE 109,A01,091882,Touri; Behrouz,15,0,70,55
1656768449551,ECE 180,A00,083140,Abi Samra; Nicholas Camill,0,0,30,30
1656768449551,ECE 180,B00,083141,Abi Samra; Nicholas Camill,0,0,30,30
1656768455579,MATH 10A,A01,083735,Patchell; Gregory David,1,0,30,29
1656768455579,MATH 10A,A02,083736,Patchell; Gregory David,20,0,30,10
1656768455579,MATH 10A,A03,083737,Patchell; Gregory David,15,0,30,15
1656768461606,MATH 10B,A01,083207,Lim; Seonhee,7,0,34,27
1656768461606,MATH 10B,A02,083208,Lim; Seonhee,9,0,35,26
1656768461606,MATH 10B,A03,093472,Lim; Seonhee,4,0,34,30
1656768461606,MATH 10B,B01,083739,Sinha; Shubham,9,0,30,21
1656768467640,MATH 18,A01,083743,Cinel; Cameron Alexander,6,0,30,24
1656768467640,MATH 18,A02,083744,Cinel; Cameron Alexander,15,0,30,15
1656768467640,MATH 18,A03,083745,Cinel; Cameron Alexander,8,0,30,22
1656768467640,MATH 18,B01,083748,Rideout; David Porter,3,0,37,34
1656768467640,MATH 18,B02,083749,Rideout; David Porter,3,0,36,33
1656768467640,MATH 18,B03,083750,Rideout; David Porter,1,0,37,36
1656768467640,MATH 18,B04,083751,Rideout; David Porter,5,0,36,31
1656768467640,MATH 18,B05,093473,Rideout; David Porter,4,0,36,32
1656768467640,MATH 18,B06,093474,Rideout; David Porter,5,0,36,31
1656768473682,MATH 20A,A01,083754,Zheng; Zequn,12,0,40,28
1656768479708,MATH 20B,A01,083756,Briones; Jor-el Thomas Caparas,1,0,36,35
1656768479708,MATH 20B,A02,083757,Briones; Jor-el Thomas Caparas,1,0,36,35
1656768479708,MATH 20B,A03,093475,Briones; Jor-el Thomas Caparas,0,0,36,36
1656768485734,MATH 20C,A01,083760,Briones; Jor-el Thomas Caparas,1,0,35,34
1656768485734,MATH 20C,A02,083761,Briones; Jor-el Thomas Caparas,8,0,35,27
1656768485734,MATH 20C,A03,093476,Briones; Jor-el Thomas Caparas,0,1,36,36
1656768485734,MATH 20C,B01,083762,Bach; Quang Tran,0,0,30,30
1656768491758,MATH 20D,A01,083765,Tran; Brian Kha,4,0,30,26
1656768491758,MATH 20D,A02,083766,Tran; Brian Kha,4,0,30,26
1656768491758,MATH 20D,A03,083767,Tran; Brian Kha,2,0,30,28
1656768497786,MATH 20E,A01,083771,Ganguly; Soumya,5,0,32,27
1656768497786,MATH 20E,A02,083772,Ganguly; Soumya,5,0,32,27
1656768497786,MATH 20E,B01,083773,Ciotti; Benjamin,18,0,35,17
1656768497786,MATH 20E,B02,083774,Ciotti; Benjamin,17,0,35,18
1656768503818,MATH 103A,A01,083777,Greenfeld; Be'Eri,2,0,36,34
1656768503818,MATH 103A,A02,083778,Greenfeld; Be'Eri,5,0,36,31
1656768503818,MATH 103A,A03,093561,Greenfeld; Be'Eri,4,0,36,32
1656768503818,MATH 103A,B01,083779,Greenfeld; Be'Eri,6,0,36,30
1656768503818,MATH 103A,B02,083780,Greenfeld; Be'Eri,2,0,36,34
1656768503818,MATH 103A,B03,093562,Greenfeld; Be'Eri,2,0,36,34
1656768509844,MATH 105,A01,085443,Carter; Anne Toulson,13,0,35,22
1656768509844,MATH 105,A02,093477,Carter; Anne Toulson,20,0,35,15
1656768515873,MATH 109,A01,083213,Ganzberger; Geoffrey Michael,2,0,34,32
1656768515873,MATH 109,A02,083214,Ganzberger; Geoffrey Michael,2,0,34,32
1656768515873,MATH 109,A03,093478,Ganzberger; Geoffrey Michael,1,0,34,33
1656768515873,MATH 109,B01,083215,Ganzberger; Geoffrey Michael,1,0,32,31
1656768515873,MATH 109,B02,083216,Ganzberger; Geoffrey Michael,1,0,32,31
1656768515873,MATH 109,B03,093479,Ganzberger; Geoffrey Michael,6,0,32,26
1656768521907,MATH 142A,A01,083219,Chow; Bennett,6,0,32,26
1656768521907,MATH 142A,A02,083220,Chow; Bennett,9,0,32,23
1656768521907,MATH 142A,A03,093480,Chow; Bennett,7,0,32,25
1656768521907,MATH 142A,B03,093481,Chow; Bennett,7,0,32,25
1656768521907,MATH 142A,B04,093558,Chow; Bennett,10,0,32,22
1656768521907,MATH 142A,B05,093559,Chow; Bennett,6,0,32,26
1656768527933,MATH 193A,A01,083224,Rotar; Vladimir,6,0,34,28
1656768527933,MATH 193A,A02,083225,Rotar; Vladimir,3,0,34,31
1656768527933,MATH 193A,A03,083781,Rotar; Vladimir,1,0,34,33
1656768527933,MATH 193A,A04,083782,Rotar; Vladimir,6,0,34,28
1656768527933,MATH 193A,A05,093482,Rotar; Vladimir,6,0,34,28
1656768533961,MATH 197,001,091859,McAuley; Julian John,9999,0,9999,0
1656768533961,MATH 197,002,095566,Kedlaya; Kiran S.,9997,0,9999,2
1656768533961,MATH 197,003,095567,Xiao; Ming,9999,0,9999,0
1656768533961,MATH 197,004,095571,Perols; Johan Lars,9998,0,9999,1
1656768541025,COGS 9,A01,083615,Shannon; Kyle Michael,6,0,75,69
1656768547056,COGS 11,A01,083617,Boyle; Mary E. T.,18,0,48,30
1656768553083,COGS 13,A01,083071,Bastos; Amalia Pinkusfeld,8,0,71,63
1656768559109,COGS 14A,A01,092681,Semenuks; Arturs,0,1,100,100
1656768565137,COGS 14B,A01,083073,Cheng; Tzu-Han,5,0,63,58
1656768571165,COGS 17,A01,092677,Semenuks; Arturs,4,0,81,77
1656768577192,COGS 100,A01,083619,Allen; Michael Gordon,15,0,70,55
1656768583223,COGS 101A,A01,083621,Davis; Joshua Daniel,9,0,68,59
1656768589247,COGS 101B,A01,091572,Allen; Michael Gordon,8,0,65,57
1656768595272,COGS 101C,A01,083625,Delgado; Tania,17,0,35,18
1656768601302,COGS 107A,A01,083627,Boyle; Mary E. T.,13,0,60,47
1656768607330,COGS 118A,A01,083075,Gupta; Anjum,15,0,76,61
1656768613361,CSE 3,A50,083646,Miranda; Gregory Joseph,22,0,50,28
1656768619387,CSE 8A,A50,083650,Miranda; Gregory Joseph,17,1,56,39
1656768625416,CSE 11,A01,083080,Cao; Yingjun,4,15,40,36
1656768631442,CSE 12,A01,083652,Krause-Levy; Sophia Louisa,20,1,120,100
1656768637468,CSE 15L,A01,083654,Morris; Justin Loren,8,0,50,42
1656768637468,CSE 15L,A02,083655,Morris; Justin Loren,8,0,50,42
1656768643499,CSE 20,A01,083657,Tran; Khoa Dang,37,0,80,43
1656768649525,CSE 21,A01,095574,Bach; Quang Tran,21,0,48,27
1656768655553,CSE 30,A01,083084,Eldon; John,4,0,80,76
1656768655553,CSE 30,B01,095061,Bhaskar; Nishant,5,0,50,45
1656768661577,CSE 100,A01,083659,Cao; Yingjun,1,4,70,69
1656768667605,CSE 134B,A01,083661,Powell; Thomas Allan,18,0,100,82
1656768673636,CSE 140,A01,083663,Gungor; Onat,14,0,85,71
1656768679663,CSE 140L,A01,083088,Eldon; John,16,0,100,84
1656768685690,CSE 175,A01,083665,Kumar; Rakesh,3,0,25,22
1656768691714,CSE 190,A00,092507,Dubnov; Shlomo,7,0,20,13
1656768697750,ECE 45,A01,083139,Congero; Spencer William,5,0,75,70
1656768703782,ECE 65,A50,083695,Saad; Andrew S,12,0,30,18
1656768703782,ECE 65,A51,095125,Saad; Andrew S,25,0,26,1
1656768709806,ECE 109,A01,091882,Touri; Behrouz,15,0,70,55
1656768715835,ECE 180,A00,083140,Abi Samra; Nicholas Camill,0,0,30,30
1656768715835,ECE 180,B00,083141,Abi Samra; Nicholas Camill,0,0,30,30
1656768721860,MATH 10A,A01,083735,Patchell; Gregory David,1,0,30,29
1656768721860,MATH 10A,A02,083736,Patchell; Gregory David,20,0,30,10
1656768721860,MATH 10A,A03,083737,Patchell; Gregory David,15,0,30,15
1656768727894,MATH 10B,A01,083207,Lim; Seonhee,7,0,34,27
1656768727894,MATH 10B,A02,083208,Lim; Seonhee,9,0,35,26
1656768727894,MATH 10B,A03,093472,Lim; Seonhee,4,0,34,30
1656768727894,MATH 10B,B01,083739,Sinha; Shubham,9,0,30,21
1656768733930,MATH 18,A01,083743,Cinel; Cameron Alexander,6,0,30,24
1656768733930,MATH 18,A02,083744,Cinel; Cameron Alexander,15,0,30,15
1656768733930,MATH 18,A03,083745,Cinel; Cameron Alexander,8,0,30,22
1656768733930,MATH 18,B01,083748,Rideout; David Porter,3,0,37,34
1656768733930,MATH 18,B02,083749,Rideout; David Porter,3,0,36,33
1656768733930,MATH 18,B03,083750,Rideout; David Porter,1,0,37,36
1656768733930,MATH 18,B04,083751,Rideout; David Porter,5,0,36,31
1656768733930,MATH 18,B05,093473,Rideout; David Porter,4,0,36,32
1656768733930,MATH 18,B06,093474,Rideout; David Porter,5,0,36,31
1656768739954,MATH 20A,A01,083754,Zheng; Zequn,12,0,40,28
1656768745990,MATH 20B,A01,083756,Briones; Jor-el Thomas Caparas,1,0,36,35
1656768745990,MATH 20B,A02,083757,Briones; Jor-el Thomas Caparas,1,0,36,35
1656768745990,MATH 20B,A03,093475,Briones; Jor-el Thomas Caparas,0,0,36,36
1656768752037,MATH 20C,A01,083760,Briones; Jor-el Thomas Caparas,1,0,35,34
1656768752037,MATH 20C,A02,083761,Briones; Jor-el Thomas Caparas,8,0,35,27
1656768752037,MATH 20C,A03,093476,Briones; Jor-el Thomas Caparas,0,1,36,36
1656768752037,MATH 20C,B01,083762,Bach; Quang Tran,0,0,30,30
1656768758064,MATH 20D,A01,083765,Tran; Brian Kha,4,0,30,26
1656768758064,MATH 20D,A02,083766,Tran; Brian Kha,4,0,30,26
1656768758064,MATH 20D,A03,083767,Tran; Brian Kha,2,0,30,28
1656768764097,MATH 20E,A01,083771,Ganguly; Soumya,5,0,32,27
1656768764097,MATH 20E,A02,083772,Ganguly; Soumya,5,0,32,27
1656768764097,MATH 20E,B01,083773,Ciotti; Benjamin,18,0,35,17
1656768764097,MATH 20E,B02,083774,Ciotti; Benjamin,17,0,35,18
1656768770132,MATH 103A,A01,083777,Greenfeld; Be'Eri,2,0,36,34
1656768770132,MATH 103A,A02,083778,Greenfeld; Be'Eri,5,0,36,31
1656768770132,MATH 103A,A03,093561,Greenfeld; Be'Eri,4,0,36,32
1656768770132,MATH 103A,B01,083779,Greenfeld; Be'Eri,6,0,36,30
1656768770132,MATH 103A,B02,083780,Greenfeld; Be'Eri,2,0,36,34
1656768770132,MATH 103A,B03,093562,Greenfeld; Be'Eri,2,0,36,34
1656768776156,MATH 105,A01,085443,Carter; Anne Toulson,13,0,35,22
1656768776156,MATH 105,A02,093477,Carter; Anne Toulson,20,0,35,15
1656768782182,MATH 109,A01,083213,Ganzberger; Geoffrey Michael,2,0,34,32
1656768782182,MATH 109,A02,083214,Ganzberger; Geoffrey Michael,2,0,34,32
1656768782182,MATH 109,A03,093478,Ganzberger; Geoffrey Michael,1,0,34,33
1656768782182,MATH 109,B01,083215,Ganzberger; Geoffrey Michael,1,0,32,31
1656768782182,MATH 109,B02,083216,Ganzberger; Geoffrey Michael,1,0,32,31
1656768782182,MATH 109,B03,093479,Ganzberger; Geoffrey Michael,6,0,32,26
1656768788209,MATH 142A,A01,083219,Chow; Bennett,6,0,32,26
1656768788209,MATH 142A,A02,083220,Chow; Bennett,9,0,32,23
1656768788209,MATH 142A,A03,093480,Chow; Bennett,7,0,32,25
1656768788209,MATH 142A,B03,093481,Chow; Bennett,7,0,32,25
1656768788209,MATH 142A,B04,093558,Chow; Bennett,10,0,32,22
1656768788209,MATH 142A,B05,093559,Chow; Bennett,6,0,32,26
1656768794239,MATH 193A,A01,083224,Rotar; Vladimir,6,0,34,28
1656768794239,MATH 193A,A02,083225,Rotar; Vladimir,3,0,34,31
1656768794239,MATH 193A,A03,083781,Rotar; Vladimir,1,0,34,33
1656768794239,MATH 193A,A04,083782,Rotar; Vladimir,6,0,34,28
1656768794239,MATH 193A,A05,093482,Rotar; Vladimir,6,0,34,28
1656768800266,MATH 197,001,091859,McAuley; Julian John,9999,0,9999,0
1656768800266,MATH 197,002,095566,Kedlaya; Kiran S.,9997,0,9999,2
1656768800266,MATH 197,003,095567,Xiao; Ming,9999,0,9999,0
1656768800266,MATH 197,004,095571,Perols; Johan Lars,9998,0,9999,1
1656768807342,COGS 9,A01,083615,Shannon; Kyle Michael,6,0,75,69
1656768813373,COGS 11,A01,083617,Boyle; Mary E. T.,18,0,48,30
1656768819404,COGS 13,A01,083071,Bastos; Amalia Pinkusfeld,8,0,71,63
1656768825428,COGS 14A,A01,092681,Semenuks; Arturs,0,1,100,100
1656768831528,COGS 14B,A01,083073,Cheng; Tzu-Han,5,0,63,58
1656768837558,COGS 17,A01,092677,Semenuks; Arturs,4,0,81,77
1656768843584,COGS 100,A01,083619,Allen; Michael Gordon,15,0,70,55
1656768849608,COGS 101A,A01,083621,Davis; Joshua Daniel,9,0,68,59
1656768855631,COGS 101B,A01,091572,Allen; Michael Gordon,8,0,65,57
1656768861655,COGS 101C,A01,083625,Delgado; Tania,17,0,35,18
1656768867683,COGS 107A,A01,083627,Boyle; Mary E. T.,13,0,60,47
1656768873712,COGS 118A,A01,083075,Gupta; Anjum,15,0,76,61
1656768879738,CSE 3,A50,083646,Miranda; Gregory Joseph,22,0,50,28
1656768885768,CSE 8A,A50,083650,Miranda; Gregory Joseph,17,1,56,39
1656768891793,CSE 11,A01,083080,Cao; Yingjun,4,15,40,36
1656768897824,CSE 12,A01,083652,Krause-Levy; Sophia Louisa,20,1,120,100
1656768903854,CSE 15L,A01,083654,Morris; Justin Loren,8,0,50,42
1656768903854,CSE 15L,A02,083655,Morris; Justin Loren,8,0,50,42
1656768909877,CSE 20,A01,083657,Tran; Khoa Dang,37,0,80,43
1656768915901,CSE 21,A01,095574,Bach; Quang Tran,21,0,48,27
1656768921929,CSE 30,A01,083084,Eldon; John,4,0,80,76
1656768921929,CSE 30,B01,095061,Bhaskar; Nishant,5,0,50,45
1656768927952,CSE 100,A01,083659,Cao; Yingjun,1,4,70,69
1656768933979,CSE 134B,A01,083661,Powell; Thomas Allan,18,0,100,82
1656768940006,CSE 140,A01,083663,Gungor; Onat,14,0,85,71
1656768946038,CSE 140L,A01,083088,Eldon; John,16,0,100,84
1656768952066,CSE 175,A01,083665,Kumar; Rakesh,3,0,25,22
1656768958094,CSE 190,A00,092507,Dubnov; Shlomo,7,0,20,13
1656768964125,ECE 45,A01,083139,Congero; Spencer William,5,0,75,70
1656768970158,ECE 65,A50,083695,Saad; Andrew S,12,0,30,18
1656768970158,ECE 65,A51,095125,Saad; Andrew S,25,0,26,1
1656768976191,ECE 109,A01,091882,Touri; Behrouz,15,0,70,55
1656768982217,ECE 180,A00,083140,Abi Samra; Nicholas Camill,0,0,30,30
1656768982217,ECE 180,B00,083141,Abi Samra; Nicholas Camill,0,0,30,30
1656768988253,MATH 10A,A01,083735,Patchell; Gregory David,1,0,30,29
1656768988253,MATH 10A,A02,083736,Patchell; Gregory David,20,0,30,10
1656768988253,MATH 10A,A03,083737,Patchell; Gregory David,15,0,30,15
1656768994280,MATH 10B,A01,083207,Lim; Seonhee,7,0,34,27
1656768994280,MATH 10B,A02,083208,Lim; Seonhee,9,0,35,26
1656768994280,MATH 10B,A03,093472,Lim; Seonhee,4,0,34,30
1656768994280,MATH 10B,B01,083739,Sinha; Shubham,9,0,30,21
1656769000309,MATH 18,A01,083743,Cinel; Cameron Alexander,6,0,30,24
1656769000309,MATH 18,A02,083744,Cinel; Cameron Alexander,15,0,30,15
1656769000309,MATH 18,A03,083745,Cinel; Cameron Alexander,8,0,30,22
1656769000309,MATH 18,B01,083748,Rideout; David Porter,3,0,37,34
1656769000309,MATH 18,B02,083749,Rideout; David Porter,3,0,36,33
1656769000309,MATH 18,B03,083750,Rideout; David Porter,1,0,37,36
1656769000309,MATH 18,B04,083751,Rideout; David Porter,5,0,36,31
1656769000309,MATH 18,B05,093473,Rideout; David Porter,4,0,36,32
1656769000309,MATH 18,B06,093474,Rideout; David Porter,5,0,36,31
1656769006339,MATH 20A,A01,083754,Zheng; Zequn,12,0,40,28
1656769012370,MATH 20B,A01,083756,Briones; Jor-el Thomas Caparas,1,0,36,35
1656769012370,MATH 20B,A02,083757,Briones; Jor-el Thomas Caparas,1,0,36,35
1656769012370,MATH 20B,A03,093475,Briones; Jor-el Thomas Caparas,0,0,36,36
1656769018401,MATH 20C,A01,083760,Briones; Jor-el Thomas Caparas,1,0,35,34
1656769018401,MATH 20C,A02,083761,Briones; Jor-el Thomas Caparas,8,0,35,27
1656769018401,MATH 20C,A03,093476,Briones; Jor-el Thomas Caparas,0,1,36,36
1656769018401,MATH 20C,B01,083762,Bach; Quang Tran,0,0,30,30
1656769024427,MATH 20D,A01,083765,Tran; Brian Kha,4,0,30,26
1656769024427,MATH 20D,A02,083766,Tran; Brian Kha,4,0,30,26
1656769024427,MATH 20D,A03,083767,Tran; Brian Kha,2,0,30,28
1656769030454,MATH 20E,A01,083771,Ganguly; Soumya,5,0,32,27
1656769030454,MATH 20E,A02,083772,Ganguly; Soumya,5,0,32,27
1656769030454,MATH 20E,B01,083773,Ciotti; Benjamin,18,0,35,17
1656769030454,MATH 20E,B02,083774,Ciotti; Benjamin,17,0,35,18
1656769036483,MATH 103A,A01,083777,Greenfeld; Be'Eri,2,0,36,34
1656769036483,MATH 103A,A02,083778,Greenfeld; Be'Eri,5,0,36,31
1656769036483,MATH 103A,A03,093561,Greenfeld; Be'Eri,4,0,36,32
1656769036483,MATH 103A,B01,083779,Greenfeld; Be'Eri,6,0,36,30
1656769036483,MATH 103A,B02,083780,Greenfeld; Be'Eri,2,0,36,34
1656769036483,MATH 103A,B03,093562,Greenfeld; Be'Eri,2,0,36,34
1656769042509,MATH 105,A01,085443,Carter; Anne Toulson,13,0,35,22
1656769042509,MATH 105,A02,093477,Carter; Anne Toulson,20,0,35,15
1656769048540,MATH 109,A01,083213,Ganzberger; Geoffrey Michael,2,0,34,32
1656769048540,MATH 109,A02,083214,Ganzberger; Geoffrey Michael,2,0,34,32
1656769048540,MATH 109,A03,093478,Ganzberger; Geoffrey Michael,1,0,34,33
1656769048540,MATH 109,B01,083215,Ganzberger; Geoffrey Michael,1,0,32,31
1656769048540,MATH 109,B02,083216,Ganzberger; Geoffrey Michael,1,0,32,31
1656769048540,MATH 109,B03,093479,Ganzberger; Geoffrey Michael,6,0,32,26
1656769054568,MATH 142A,A01,083219,Chow; Bennett,6,0,32,26
1656769054568,MATH 142A,A02,083220,Chow; Bennett,9,0,32,23
1656769054568,MATH 142A,A03,093480,Chow; Bennett,7,0,32,25
1656769054568,MATH 142A,B03,093481,Chow; Bennett,7,0,32,25
1656769054568,MATH 142A,B04,093558,Chow; Bennett,10,0,32,22
1656769054568,MATH 142A,B05,093559,Chow; Bennett,6,0,32,26
1656769060592,MATH 193A,A01,083224,Rotar; Vladimir,6,0,34,28
1656769060592,MATH 193A,A02,083225,Rotar; Vladimir,3,0,34,31
1656769060592,MATH 193A,A03,083781,Rotar; Vladimir,1,0,34,33
1656769060592,MATH 193A,A04,083782,Rotar; Vladimir,6,0,34,28
1656769060592,MATH 193A,A05,093482,Rotar; Vladimir,6,0,34,28
1656769066619,MATH 197,001,091859,McAuley; Julian John,9999,0,9999,0
1656769066619,MATH 197,002,095566,Kedlaya; Kiran S.,9997,0,9999,2
1656769066619,MATH 197,003,095567,Xiao; Ming,9999,0,9999,0
1656769066619,MATH 197,004,095571,Perols; Johan Lars,9998,0,9999,1
1656769073698,COGS 9,A01,083615,Shannon; Kyle Michael,6,0,75,69
1656769079722,COGS 11,A01,083617,Boyle; Mary E. T.,18,0,48,30
1656769085752,COGS 13,A01,083071,Bastos; Amalia Pinkusfeld,8,0,71,63
1656769091781,COGS 14A,A01,092681,Semenuks; Arturs,0,1,100,100
1656769097804,COGS 14B,A01,083073,Cheng; Tzu-Han,5,0,63,58
1656769103828,COGS 17,A01,092677,Semenuks; Arturs,4,0,81,77
1656769109857,COGS 100,A01,083619,Allen; Michael Gordon,15,0,70,55
1656769115889,COGS 101A,A01,083621,Davis; Joshua Daniel,9,0,68,59
1656769121919,COGS 101B,A01,091572,Allen; Michael Gordon,8,0,65,57
1656769127953,COGS 101C,A01,083625,Delgado; Tania,17,0,35,18
1656769133976,COGS 107A,A01,083627,Boyle; Mary E. T.,13,0,60,47
1656769140000,COGS 118A,A01,083075,Gupta; Anjum,15,0,76,61
1656769146027,CSE 3,A50,083646,Miranda; Gregory Joseph,22,0,50,28
1656769152056,CSE 8A,A50,083650,Miranda; Gregory Joseph,17,1,56,39
1656769158081,CSE 11,A01,083080,Cao; Yingjun,4,15,40,36
1656769164111,CSE 12,A01,083652,Krause-Levy; Sophia Louisa,20,1,120,100
1656769170138,CSE 15L,A01,083654,Morris; Justin Loren,8,0,50,42
1656769170138,CSE 15L,A02,083655,Morris; Justin Loren,8,0,50,42
1656769176169,CSE 20,A01,083657,Tran; Khoa Dang,37,0,80,43
1656769182200,CSE 21,A01,095574,Bach; Quang Tran,21,0,48,27
1656769188233,CSE 30,A01,083084,Eldon; John,4,0,80,76
1656769188233,CSE 30,B01,095061,Bhaskar; Nishant,5,0,50,45
1656769194258,CSE 100,A01,083659,Cao; Yingjun,1,4,70,69
1656769200283,CSE 134B,A01,083661,Powell; Thomas Allan,18,0,100,82
1656769206307,CSE 140,A01,083663,Gungor; Onat,14,0,85,71
1656769212335,CSE 140L,A01,083088,Eldon; John,16,0,100,84
1656769218364,CSE 175,A01,083665,Kumar; Rakesh,3,0,25,22
1656769224394,CSE 190,A00,092507,Dubnov; Shlomo,7,0,20,13
1656769230425,ECE 45,A01,083139,Congero; Spencer William,5,0,75,70
1656769236456,ECE 65,A50,083695,Saad; Andrew S,12,0,30,18
1656769236456,ECE 65,A51,095125,Saad; Andrew S,25,0,26,1
1656769242485,ECE 109,A01,091882,Touri; Behrouz,15,0,70,55
1656769248518,ECE 180,A00,083140,Abi Samra; Nicholas Camill,0,0,30,30
1656769248518,ECE 180,B00,083141,Abi Samra; Nicholas Camill,0,0,30,30
1656769254544,MATH 10A,A01,083735,Patchell; Gregory David,1,0,30,29
1656769254544,MATH 10A,A02,083736,Patchell; Gregory David,20,0,30,10
1656769254544,MATH 10A,A03,083737,Patchell; Gregory David,15,0,30,15
1656769260575,MATH 10B,A01,083207,Lim; Seonhee,7,0,34,27
1656769260575,MATH 10B,A02,083208,Lim; Seonhee,9,0,35,26
1656769260575,MATH 10B,A03,093472,Lim; Seonhee,4,0,34,30
1656769260575,MATH 10B,B01,083739,Sinha; Shubham,9,0,30,21
1656769266604,MATH 18,A01,083743,Cinel; Cameron Alexander,6,0,30,24
1656769266604,MATH 18,A02,083744,Cinel; Cameron Alexander,15,0,30,15
1656769266604,MATH 18,A03,083745,Cinel; Cameron Alexander,8,0,30,22
1656769266604,MATH 18,B01,083748,Rideout; David Porter,3,0,37,34
1656769266604,MATH 18,B02,083749,Rideout; David Porter,3,0,36,33
1656769266604,MATH 18,B03,083750,Rideout; David Porter,1,0,37,36
1656769266604,MATH 18,B04,083751,Rideout; David Porter,5,0,36,31
1656769266604,MATH 18,B05,093473,Rideout; David Porter,4,0,36,32
1656769266604,MATH 18,B06,093474,Rideout; David Porter,5,0,36,31
1656769272629,MATH 20A,A01,083754,Zheng; Zequn,12,0,40,28
1656769278665,MATH 20B,A01,083756,Briones; Jor-el Thomas Caparas,1,0,36,35
1656769278665,MATH 20B,A02,083757,Briones; Jor-el Thomas Caparas,1,0,36,35
1656769278665,MATH 20B,A03,093475,Briones; Jor-el Thomas Caparas,0,0,36,36
1656769284699,MATH 20C,A01,083760,Briones; Jor-el Thomas Caparas,1,0,35,34
1656769284699,MATH 20C,A02,083761,Briones; Jor-el Thomas Caparas,8,0,35,27
1656769284699,MATH 20C,A03,093476,Briones; Jor-el Thomas Caparas,0,1,36,36
1656769284699,MATH 20C,B01,083762,Bach; Quang Tran,0,0,30,30
1656769290724,MATH 20D,A01,083765,Tran; Brian Kha,4,0,30,26
1656769290724,MATH 20D,A02,083766,Tran; Brian Kha,4,0,30,26
1656769290724,MATH 20D,A03,083767,Tran; Brian Kha,2,0,30,28
1656769296753,MATH 20E,A01,083771,Ganguly; Soumya,5,0,32,27
1656769296753,MATH 20E,A02,083772,Ganguly; Soumya,5,0,32,27
1656769296753,MATH 20E,B01,083773,Ciotti; Benjamin,18,0,35,17
1656769296753,MATH 20E,B02,083774,Ciotti; Benjamin,17,0,35,18
1656769302791,MATH 103A,A01,083777,Greenfeld; Be'Eri,2,0,36,34
1656769302791,MATH 103A,A02,083778,Greenfeld; Be'Eri,5,0,36,31
1656769302791,MATH 103A,A03,093561,Greenfeld; Be'Eri,4,0,36,32
1656769302791,MATH 103A,B01,083779,Greenfeld; Be'Eri,6,0,36,30
1656769302791,MATH 103A,B02,083780,Greenfeld; Be'Eri,2,0,36,34
1656769302791,MATH 103A,B03,093562,Greenfeld; Be'Eri,2,0,36,34
1656769308817,MATH 105,A01,085443,Carter; Anne Toulson,13,0,35,22
1656769308817,MATH 105,A02,093477,Carter; Anne Toulson,20,0,35,15
1656769314842,MATH 109,A01,083213,Ganzberger; Geoffrey Michael,2,0,34,32
1656769314842,MATH 109,A02,083214,Ganzberger; Geoffrey Michael,2,0,34,32
1656769314842,MATH 109,A03,093478,Ganzberger; Geoffrey Michael,1,0,34,33
1656769314842,MATH 109,B01,083215,Ganzberger; Geoffrey Michael,1,0,32,31
1656769314842,MATH 109,B02,083216,Ganzberger; Geoffrey Michael,1,0,32,31
1656769314842,MATH 109,B03,093479,Ganzberger; Geoffrey Michael,6,0,32,26
1656769320869,MATH 142A,A01,083219,Chow; Bennett,6,0,32,26
1656769320869,MATH 142A,A02,083220,Chow; Bennett,9,0,32,23
1656769320869,MATH 142A,A03,093480,Chow; Bennett,7,0,32,25
1656769320869,MATH 142A,B03,093481,Chow; Bennett,7,0,32,25
1656769320869,MATH 142A,B04,093558,Chow; Bennett,10,0,32,22
1656769320869,MATH 142A,B05,093559,Chow; Bennett,6,0,32,26
1656769326894,MATH 193A,A01,083224,Rotar; Vladimir,6,0,34,28
1656769326894,MATH 193A,A02,083225,Rotar; Vladimir,3,0,34,31
1656769326894,MATH 193A,A03,083781,Rotar; Vladimir,1,0,34,33
1656769326894,MATH 193A,A04,083782,Rotar; Vladimir,6,0,34,28
1656769326894,MATH 193A,A05,093482,Rotar; Vladimir,6,0,34,28
1656769332925,MATH 197,001,091859,McAuley; Julian John,9999,0,9999,0
1656769332925,MATH 197,002,095566,Kedlaya; Kiran S.,9997,0,9999,2
1656769332925,MATH 197,003,095567,Xiao; Ming,9999,0,9999,0
1656769332925,MATH 197,004,095571,Perols; Johan Lars,9998,0,9999,1
1656769339991,COGS 9,A01,083615,Shannon; Kyle Michael,6,0,75,69
1656769346020,COGS 11,A01,083617,Boyle; Mary E. T.,18,0,48,30
1656769352046,COGS 13,A01,083071,Bastos; Amalia Pinkusfeld,8,0,71,63
1656769358072,COGS 14A,A01,092681,Semenuks; Arturs,0,1,100,100
1656769364097,COGS 14B,A01,083073,Cheng; Tzu-Han,5,0,63,58
1656769370123,COGS 17,A01,092677,Semenuks; Arturs,4,0,81,77
1656769376147,COGS 100,A01,083619,Allen; Michael Gordon,15,0,70,55
1656769382175,COGS 101A,A01,083621,Davis; Joshua Daniel,9,0,68,59
1656769388202,COGS 101B,A01,091572,Allen; Michael Gordon,8,0,65,57
1656769394232,COGS 101C,A01,083625,Delgado; Tania,17,0,35,18
1656769400260,COGS 107A,A01,083627,Boyle; Mary E. T.,13,0,60,47
1656769406285,COGS 118A,A01,083075,Gupta; Anjum,15,0,76,61
1656769412322,CSE 3,A50,083646,Miranda; Gregory Joseph,22,0,50,28
1656769418351,CSE 8A,A50,083650,Miranda; Gregory Joseph,17,1,56,39
1656769424383,CSE 11,A01,083080,Cao; Yingjun,4,15,40,36
1656769430484,CSE 12,A01,083652,Krause-Levy; Sophia Louisa,20,1,120,100
1656769436513,CSE 15L,A01,083654,Morris; Justin Loren,8,0,50,42
1656769436513,CSE 15L,A02,083655,Morris; Justin Loren,8,0,50,42
1656769442539,CSE 20,A01,083657,Tran; Khoa Dang,37,0,80,43
1656769448571,CSE 21,A01,095574,Bach; Quang Tran,21,0,48,27
1656769454606,CSE 30,A01,083084,Eldon; John,4,0,80,76
1656769454606,CSE 30,B01,095061,Bhaskar; Nishant,5,0,50,45
1656769460632,CSE 100,A01,083659,Cao; Yingjun,1,4,70,69
1656769466656,CSE 134B,A01,083661,Powell; Thomas Allan,18,0,100,82
1656769472681,CSE 140,A01,083663,Gungor; Onat,14,0,85,71
1656769478711,CSE 140L,A01,083088,Eldon; John,16,0,100,84
1656769484736,CSE 175,A01,083665,Kumar; Rakesh,3,0,25,22
1656769490763,CSE 190,A00,092507,Dubnov; Shlomo,7,0,20,13
1656769496787,ECE 45,A01,083139,Congero; Spencer William,5,0,75,70
1656769502814,ECE 65,A50,083695,Saad; Andrew S,12,0,30,18
1656769502814,ECE 65,A51,095125,Saad; Andrew S,25,0,26,1
1656769508844,ECE 109,A01,091882,Touri; Behrouz,15,0,70,55
1656769514869,ECE 180,A00,083140,Abi Samra; Nicholas Camill,0,0,30,30
1656769514869,ECE 180,B00,083141,Abi Samra; Nicholas Camill,0,0,30,30
1656769520898,MATH 10A,A01,083735,Patchell; Gregory David,1,0,30,29
1656769520898,MATH 10A,A02,083736,Patchell; Gregory David,20,0,30,10
1656769520898,MATH 10A,A03,083737,Patchell; Gregory David,15,0,30,15
1656769526932,MATH 10B,A01,083207,Lim; Seonhee,7,0,34,27
1656769526932,MATH 10B,A02,083208,Lim; Seonhee,9,0,35,26
1656769526932,MATH 10B,A03,093472,Lim; Seonhee,4,0,34,30
1656769526932,MATH 10B,B01,083739,Sinha; Shubham,9,0,30,21
1656769532970,MATH 18,A01,083743,Cinel; Cameron Alexander,6,0,30,24
1656769532970,MATH 18,A02,083744,Cinel; Cameron Alexander,15,0,30,15
1656769532970,MATH 18,A03,083745,Cinel; Cameron Alexander,8,0,30,22
1656769532970,MATH 18,B01,083748,Rideout; David Porter,3,0,37,34
1656769532970,MATH 18,B02,083749,Rideout; David Porter,3,0,36,33
1656769532970,MATH 18,B03,083750,Rideout; David Porter,1,0,37,36
1656769532970,MATH 18,B04,083751,Rideout; David Porter,5,0,36,31
1656769532970,MATH 18,B05,093473,Rideout; David Porter,4,0,36,32
1656769532970,MATH 18,B06,093474,Rideout; David Porter,5,0,36,31
1656769539000,MATH 20A,A01,083754,Zheng; Zequn,12,0,40,28
1656769545032,MATH 20B,A01,083756,Briones; Jor-el Thomas Caparas,1,0,36,35
1656769545032,MATH 20B,A02,083757,Briones; Jor-el Thomas Caparas,1,0,36,35
1656769545032,MATH 20B,A03,093475,Briones; Jor-el Thomas Caparas,0,0,36,36
1656769551065,MATH 20C,A01,083760,Briones; Jor-el Thomas Caparas,1,0,35,34
1656769551065,MATH 20C,A02,083761,Briones; Jor-el Thomas Caparas,8,0,35,27
1656769551065,MATH 20C,A03,093476,Briones; Jor-el Thomas Caparas,0,1,36,36
1656769551065,MATH 20C,B01,083762,Bach; Quang Tran,0,0,30,30
1656769557095,MATH 20D,A01,083765,Tran; Brian Kha,4,0,30,26
1656769557095,MATH 20D,A02,083766,Tran; Brian Kha,4,0,30,26
1656769557095,MATH 20D,A03,083767,Tran; Brian Kha,2,0,30,28
1656769563130,MATH 20E,A01,083771,Ganguly; Soumya,5,0,32,27
1656769563130,MATH 20E,A02,083772,Ganguly; Soumya,5,0,32,27
1656769563130,MATH 20E,B01,083773,Ciotti; Benjamin,18,0,35,17
1656769563130,MATH 20E,B02,083774,Ciotti; Benjamin,17,0,35,18
1656769569168,MATH 103A,A01,083777,Greenfeld; Be'Eri,2,0,36,34
1656769569168,MATH 103A,A02,083778,Greenfeld; Be'Eri,5,0,36,31
1656769569168,MATH 103A,A03,093561,Greenfeld; Be'Eri,4,0,36,32
1656769569168,MATH 103A,B01,083779,Greenfeld; Be'Eri,6,0,36,30
1656769569168,MATH 103A,B02,083780,Greenfeld; Be'Eri,2,0,36,34
1656769569168,MATH 103A,B03,093562,Greenfeld; Be'Eri,2,0,36,34
1656769575199,MATH 105,A01,085443,Carter; Anne Toulson,13,0,35,22
1656769575199,MATH 105,A02,093477,Carter; Anne Toulson,20,0,35,15
1656769581224,MATH 109,A01,083213,Ganzberger; Geoffrey Michael,2,0,34,32
1656769581224,MATH 109,A02,083214,Ganzberger; Geoffrey Michael,2,0,34,32
1656769581224,MATH 109,A03,093478,Ganzberger; Geoffrey Michael,1,0,34,33
1656769581224,MATH 109,B01,083215,Ganzberger; Geoffrey Michael,1,0,32,31
1656769581224,MATH 109,B02,083216,Ganzberger; Geoffrey Michael,1,0,32,31
1656769581224,MATH 109,B03,093479,Ganzberger; Geoffrey Michael,6,0,32,26
1656769587252,MATH 142A,A01,083219,Chow; Bennett,6,0,32,26
1656769587252,MATH 142A,A02,083220,Chow; Bennett,9,0,32,23
1656769587252,MATH 142A,A03,093480,Chow; Bennett,7,0,32,25
1656769587252,MATH 142A,B03,093481,Chow; Bennett,7,0,32,25
1656769587252,MATH 142A,B04,093558,Chow; Bennett,10,0,32,22
1656769587252,MATH 142A,B05,093559,Chow; Bennett,6,0,32,26
1656769593283,MATH 193A,A01,083224,Rotar; Vladimir,6,0,34,28
1656769593283,MATH 193A,A02,083225,Rotar; Vladimir,3,0,34,31
1656769593283,MATH 193A,A03,083781,Rotar; Vladimir,1,0,34,33
1656769593283,MATH 193A,A04,083782,Rotar; Vladimir,6,0,34,28
1656769593283,MATH 193A,A05,093482,Rotar; Vladimir,6,0,34,28
1656769599309,MATH 197,001,091859,McAuley; Julian John,9999,0,9999,0
1656769599309,MATH 197,002,095566,Kedlaya; Kiran S.,9997,0,9999,2
1656769599309,MATH 197,003,095567,Xiao; Ming,9999,0,9999,0
1656769599309,MATH 197,004,095571,Perols; Johan Lars,9998,0,9999,1
1656769606380,COGS 9,A01,083615,Shannon; Kyle Michael,6,0,75,69
1656769612413,COGS 11,A01,083617,Boyle; Mary E. T.,18,0,48,30
1656769618439,COGS 13,A01,083071,Bastos; Amalia Pinkusfeld,8,0,71,63
1656769624468,COGS 14A,A01,092681,Semenuks; Arturs,0,1,100,100
1656769630495,COGS 14B,A01,083073,Cheng; Tzu-Han,5,0,63,58
1656769636529,COGS 17,A01,092677,Semenuks; Arturs,4,0,81,77
1656769642556,COGS 100,A01,083619,Allen; Michael Gordon,15,0,70,55
1656769648579,COGS 101A,A01,083621,Davis; Joshua Daniel,9,0,68,59
1656769654609,COGS 101B,A01,091572,Allen; Michael Gordon,8,0,65,57
1656769660637,COGS 101C,A01,083625,Delgado; Tania,17,0,35,18
1656769666664,COGS 107A,A01,083627,Boyle; Mary E. T.,13,0,60,47
1656769672698,COGS 118A,A01,083075,Gupta; Anjum,15,0,76,61
1656769678726,CSE 3,A50,083646,Miranda; Gregory Joseph,22,0,50,28
1656769684755,CSE 8A,A50,083650,Miranda; Gregory Joseph,17,1,56,39
1656769690782,CSE 11,A01,083080,Cao; Yingjun,4,15,40,36
1656769696806,CSE 12,A01,083652,Krause-Levy; Sophia Louisa,20,1,120,100
1656769702836,CSE 15L,A01,083654,Morris; Justin Loren,8,0,50,42
1656769702836,CSE 15L,A02,083655,Morris; Justin Loren,8,0,50,42
1656769708864,CSE 20,A01,083657,Tran; Khoa Dang,37,0,80,43
1656769714893,CSE 21,A01,095574,Bach; Quang Tran,21,0,48,27
1656769720926,CSE 30,A01,083084,Eldon; John,4,0,80,76
1656769720926,CSE 30,B01,095061,Bhaskar; Nishant,5,0,50,45
1656769726958,CSE 100,A01,083659,Cao; Yingjun,1,4,70,69
1656769732988,CSE 134B,A01,083661,Powell; Thomas Allan,18,0,100,82
1656769739017,CSE 140,A01,083663,Gungor; Onat,14,0,85,71
1656769745045,CSE 140L,A01,083088,Eldon; John,16,0,100,84
1656769751073,CSE 175,A01,083665,Kumar; Rakesh,3,0,25,22
1656769757107,CSE 190,A00,092507,Dubnov; Shlomo,7,0,20,13
1656769763140,ECE 45,A01,083139,Congero; Spencer William,5,0,75,70
1656769769174,ECE 65,A50,083695,Saad; Andrew S,12,0,30,18
1656769769174,ECE 65,A51,095125,Saad; Andrew S,25,0,26,1
1656769775200,ECE 109,A01,091882,Touri; Behrouz,15,0,70,55
1656769781231,ECE 180,A00,083140,Abi Samra; Nicholas Camill,0,0,30,30
1656769781231,ECE 180,B00,083141,Abi Samra; Nicholas Camill,0,0,30,30
1656769787266,MATH 10A,A01,083735,Patchell; Gregory David,1,0,30,29
1656769787266,MATH 10A,A02,083736,Patchell; Gregory David,20,0,30,10
1656769787266,MATH 10A,A03,083737,Patchell; Gregory David,15,0,30,15
1656769793298,MATH 10B,A01,083207,Lim; Seonhee,7,0,34,27
1656769793298,MATH 10B,A02,083208,Lim; Seonhee,9,0,35,26
1656769793298,MATH 10B,A03,093472,Lim; Seonhee,4,0,34,30
1656769793298,MATH 10B,B01,083739,Sinha; Shubham,9,0,30,21
1656769799327,MATH 18,A01,083743,Cinel; Cameron Alexander,6,0,30,24
1656769799327,MATH 18,A02,083744,Cinel; Cameron Alexander,15,0,30,15
1656769799327,MATH 18,A03,083745,Cinel; Cameron Alexander,8,0,30,22
1656769799327,MATH 18,B01,083748,Rideout; David Porter,3,0,37,34
1656769799327,MATH 18,B02,083749,Rideout; David Porter,3,0,36,33
1656769799327,MATH 18,B03,083750,Rideout; David Porter,1,0,37,36
1656769799327,MATH 18,B04,083751,Rideout; David Porter,5,0,36,31
1656769799327,MATH 18,B05,093473,Rideout; David Porter,4,0,36,32
1656769799327,MATH 18,B06,093474,Rideout; David Porter,5,0,36,31
1656769805356,MATH 20A,A01,083754,Zheng; Zequn,12,0,40,28
1656769811383,MATH 20B,A01,083756,Briones; Jor-el Thomas Caparas,1,0,36,35
1656769811383,MATH 20B,A02,083757,Briones; Jor-el Thomas Caparas,1,0,36,35
1656769811383,MATH 20B,A03,093475,Briones; Jor-el Thomas Caparas,0,0,36,36
1656769817408,MATH 20C,A01,083760,Briones; Jor-el Thomas Caparas,1,0,35,34
1656769817408,MATH 20C,A02,083761,Briones; Jor-el Thomas Caparas,8,0,35,27
1656769817408,MATH 20C,A03,093476,Briones; Jor-el Thomas Caparas,0,1,36,36
1656769817408,MATH 20C,B01,083762,Bach; Quang Tran,0,0,30,30
1656769823433,MATH 20D,A01,083765,Tran; Brian Kha,4,0,30,26
1656769823433,MATH 20D,A02,083766,Tran; Brian Kha,4,0,30,26
1656769823433,MATH 20D,A03,083767,Tran; Brian Kha,2,0,30,28
1656769829460,MATH 20E,A01,083771,Ganguly; Soumya,5,0,32,27
1656769829460,MATH 20E,A02,083772,Ganguly; Soumya,5,0,32,27
1656769829460,MATH 20E,B01,083773,Ciotti; Benjamin,18,0,35,17
1656769829460,MATH 20E,B02,083774,Ciotti; Benjamin,17,0,35,18
1656769835498,MATH 103A,A01,083777,Greenfeld; Be'Eri,2,0,36,34
1656769835498,MATH 103A,A02,083778,Greenfeld; Be'Eri,5,0,36,31
1656769835498,MATH 103A,A03,093561,Greenfeld; Be'Eri,4,0,36,32
1656769835498,MATH 103A,B01,083779,Greenfeld; Be'Eri,6,0,36,30
1656769835498,MATH 103A,B02,083780,Greenfeld; Be'Eri,2,0,36,34
1656769835498,MATH 103A,B03,093562,Greenfeld; Be'Eri,2,0,36,34
1656769841529,MATH 105,A01,085443,Carter; Anne Toulson,13,0,35,22
1656769841529,MATH 105,A02,093477,Carter; Anne Toulson,20,0,35,15
1656769847562,MATH 109,A01,083213,Ganzberger; Geoffrey Michael,2,0,34,32
1656769847562,MATH 109,A02,083214,Ganzberger; Geoffrey Michael,2,0,34,32
1656769847562,MATH 109,A03,093478,Ganzberger; Geoffrey Michael,1,0,34,33
1656769847562,MATH 109,B01,083215,Ganzberger; Geoffrey Michael,1,0,32,31
1656769847562,MATH 109,B02,083216,Ganzberger; Geoffrey Michael,1,0,32,31
1656769847562,MATH 109,B03,093479,Ganzberger; Geoffrey Michael,6,0,32,26
1656769853596,MATH 142A,A01,083219,Chow; Bennett,6,0,32,26
1656769853596,MATH 142A,A02,083220,Chow; Bennett,9,0,32,23
1656769853596,MATH 142A,A03,093480,Chow; Bennett,7,0,32,25
1656769853596,MATH 142A,B03,093481,Chow; Bennett,7,0,32,25
1656769853596,MATH 142A,B04,093558,Chow; Bennett,10,0,32,22
1656769853596,MATH 142A,B05,093559,Chow; Bennett,6,0,32,26
1656769859627,MATH 193A,A01,083224,Rotar; Vladimir,6,0,34,28
1656769859627,MATH 193A,A02,083225,Rotar; Vladimir,3,0,34,31
1656769859627,MATH 193A,A03,083781,Rotar; Vladimir,1,0,34,33
1656769859627,MATH 193A,A04,083782,Rotar; Vladimir,6,0,34,28
1656769859627,MATH 193A,A05,093482,Rotar; Vladimir,6,0,34,28
1656769865652,MATH 197,001,091859,McAuley; Julian John,9999,0,9999,0
1656769865652,MATH 197,002,095566,Kedlaya; Kiran S.,9997,0,9999,2
1656769865652,MATH 197,003,095567,Xiao; Ming,9999,0,9999,0
1656769865652,MATH 197,004,095571,Perols; Johan Lars,9998,0,9999,1
1656769872740,COGS 9,A01,083615,Shannon; Kyle Michael,6,0,75,69
1656769878765,COGS 11,A01,083617,Boyle; Mary E. T.,18,0,48,30
1656769884791,COGS 13,A01,083071,Bastos; Amalia Pinkusfeld,8,0,71,63
1656769890823,COGS 14A,A01,092681,Semenuks; Arturs,0,1,100,100
1656769896854,COGS 14B,A01,083073,Cheng; Tzu-Han,5,0,63,58
1656769902881,COGS 17,A01,092677,Semenuks; Arturs,4,0,81,77
1656769908911,COGS 100,A01,083619,Allen; Michael Gordon,15,0,70,55
1656769914939,COGS 101A,A01,083621,Davis; Joshua Daniel,9,0,68,59
1656769920971,COGS 101B,A01,091572,Allen; Michael Gordon,8,0,65,57
1656769926997,COGS 101C,A01,083625,Delgado; Tania,17,0,35,18
1656769933023,COGS 107A,A01,083627,Boyle; Mary E. T.,13,0,60,47
1656769939056,COGS 118A,A01,083075,Gupta; Anjum,15,0,76,61
1656769945105,CSE 3,A50,083646,Miranda; Gregory Joseph,22,0,50,28
1656769951133,CSE 8A,A50,083650,Miranda; Gregory Joseph,17,1,56,39
1656769957156,CSE 11,A01,083080,Cao; Yingjun,4,15,40,36
1656769963180,CSE 12,A01,083652,Krause-Levy; Sophia Louisa,20,1,120,100
1656769969206,CSE 15L,A01,083654,Morris; Justin Loren,8,0,50,42
1656769969206,CSE 15L,A02,083655,Morris; Justin Loren,8,0,50,42
1656769975241,CSE 20,A01,083657,Tran; Khoa Dang,37,0,80,43
1656769981270,CSE 21,A01,095574,Bach; Quang Tran,21,0,48,27
1656769987317,CSE 30,A01,083084,Eldon; John,4,0,80,76
1656769987317,CSE 30,B01,095061,Bhaskar; Nishant,5,0,50,45
1656769993348,CSE 100,A01,083659,Cao; Yingjun,1,4,70,69
1656769999374,CSE 134B,A01,083661,Powell; Thomas Allan,18,0,100,82
1656770005402,CSE 140,A01,083663,Gungor; Onat,14,0,85,71
1656770011433,CSE 140L,A01,083088,Eldon; John,16,0,100,84
1656770017463,CSE 175,A01,083665,Kumar; Rakesh,3,0,25,22
1656770023494,CSE 190,A00,092507,Dubnov; Shlomo,7,0,20,13
1656770029599,ECE 45,A01,083139,Congero; Spencer William,5,0,75,70
1656770035626,ECE 65,A50,083695,Saad; Andrew S,12,0,30,18
1656770035626,ECE 65,A51,095125,Saad; Andrew S,25,0,26,1
1656770041657,ECE 109,A01,091882,Touri; Behrouz,15,0,70,55
1656770047682,ECE 180,A00,083140,Abi Samra; Nicholas Camill,0,0,30,30
1656770047682,ECE 180,B00,083141,Abi Samra; Nicholas Camill,0,0,30,30
1656770053709,MATH 10A,A01,083735,Patchell; Gregory David,1,0,30,29
1656770053709,MATH 10A,A02,083736,Patchell; Gregory David,20,0,30,10
1656770053709,MATH 10A,A03,083737,Patchell; Gregory David,15,0,30,15
1656770059738,MATH 10B,A01,083207,Lim; Seonhee,7,0,34,27
1656770059738,MATH 10B,A02,083208,Lim; Seonhee,9,0,35,26
1656770059738,MATH 10B,A03,093472,Lim; Seonhee,4,0,34,30
1656770059738,MATH 10B,B01,083739,Sinha; Shubham,9,0,30,21
1656770065769,MATH 18,A01,083743,Cinel; Cameron Alexander,6,0,30,24
1656770065769,MATH 18,A02,083744,Cinel; Cameron Alexander,15,0,30,15
1656770065769,MATH 18,A03,083745,Cinel; Cameron Alexander,8,0,30,22
1656770065769,MATH 18,B01,083748,Rideout; David Porter,3,0,37,34
1656770065769,MATH 18,B02,083749,Rideout; David Porter,3,0,36,33
1656770065769,MATH 18,B03,083750,Rideout; David Porter,1,0,37,36
1656770065769,MATH 18,B04,083751,Rideout; David Porter,5,0,36,31
1656770065769,MATH 18,B05,093473,Rideout; David Porter,4,0,36,32
1656770065769,MATH 18,B06,093474,Rideout; David Porter,5,0,36,31
1656770071794,MATH 20A,A01,083754,Zheng; Zequn,12,0,40,28
1656770077820,MATH 20B,A01,083756,Briones; Jor-el Thomas Caparas,1,0,36,35
1656770077820,MATH 20B,A02,083757,Briones; Jor-el Thomas Caparas,1,0,36,35
1656770077820,MATH 20B,A03,093475,Briones; Jor-el Thomas Caparas,0,0,36,36
1656770083848,MATH 20C,A01,083760,Briones; Jor-el Thomas Caparas,1,0,35,34
1656770083848,MATH 20C,A02,083761,Briones; Jor-el Thomas Caparas,8,0,35,27
1656770083848,MATH 20C,A03,093476,Briones; Jor-el Thomas Caparas,0,1,36,36
1656770083848,MATH 20C,B01,083762,Bach; Quang Tran,0,0,30,30
1656770089874,MATH 20D,A01,083765,Tran; Brian Kha,4,0,30,26
1656770089874,MATH 20D,A02,083766,Tran; Brian Kha,4,0,30,26
1656770089874,MATH 20D,A03,083767,Tran; Brian Kha,2,0,30,28
1656770095907,MATH 20E,A01,083771,Ganguly; Soumya,5,0,32,27
1656770095907,MATH 20E,A02,083772,Ganguly; Soumya,5,0,32,27
1656770095907,MATH 20E,B01,083773,Ciotti; Benjamin,18,0,35,17
1656770095907,MATH 20E,B02,083774,Ciotti; Benjamin,17,0,35,18
1656770101937,MATH 103A,A01,083777,Greenfeld; Be'Eri,2,0,36,34
1656770101937,MATH 103A,A02,083778,Greenfeld; Be'Eri,5,0,36,31
1656770101937,MATH 103A,A03,093561,Greenfeld; Be'Eri,4,0,36,32
1656770101937,MATH 103A,B01,083779,Greenfeld; Be'Eri,6,0,36,30
1656770101937,MATH 103A,B02,083780,Greenfeld; Be'Eri,2,0,36,34
1656770101937,MATH 103A,B03,093562,Greenfeld; Be'Eri,2,0,36,34
1656770107961,MATH 105,A01,085443,Carter; Anne Toulson,13,0,35,22
1656770107961,MATH 105,A02,093477,Carter; Anne Toulson,20,0,35,15
1656770113988,MATH 109,A01,083213,Ganzberger; Geoffrey Michael,2,0,34,32
1656770113988,MATH 109,A02,083214,Ganzberger; Geoffrey Michael,2,0,34,32
1656770113988,MATH 109,A03,093478,Ganzberger; Geoffrey Michael,1,0,34,33
1656770113988,MATH 109,B01,083215,Ganzberger; Geoffrey Michael,1,0,32,31
1656770113988,MATH 109,B02,083216,Ganzberger; Geoffrey Michael,1,0,32,31
1656770113988,MATH 109,B03,093479,Ganzberger; Geoffrey Michael,6,0,32,26
1656770120056,MATH 142A,A01,083219,Chow; Bennett,6,0,32,26
1656770120056,MATH 142A,A02,083220,Chow; Bennett,9,0,32,23
1656770120056,MATH 142A,A03,093480,Chow; Bennett,7,0,32,25
1656770120056,MATH 142A,B03,093481,Chow; Bennett,7,0,32,25
1656770120056,MATH 142A,B04,093558,Chow; Bennett,10,0,32,22
1656770120056,MATH 142A,B05,093559,Chow; Bennett,6,0,32,26
1656770126081,MATH 193A,A01,083224,Rotar; Vladimir,6,0,34,28
1656770126081,MATH 193A,A02,083225,Rotar; Vladimir,3,0,34,31
1656770126081,MATH 193A,A03,083781,Rotar; Vladimir,1,0,34,33
1656770126081,MATH 193A,A04,083782,Rotar; Vladimir,6,0,34,28
1656770126081,MATH 193A,A05,093482,Rotar; Vladimir,6,0,34,28
1656770132106,MATH 197,001,091859,McAuley; Julian John,9999,0,9999,0
1656770132106,MATH 197,002,095566,Kedlaya; Kiran S.,9997,0,9999,2
1656770132106,MATH 197,003,095567,Xiao; Ming,9999,0,9999,0
1656770132106,MATH 197,004,095571,Perols; Johan Lars,9998,0,9999,1
1656770139168,COGS 9,A01,083615,Shannon; Kyle Michael,6,0,75,69
1656770145200,COGS 11,A01,083617,Boyle; Mary E. T.,18,0,48,30
1656770151227,COGS 13,A01,083071,Bastos; Amalia Pinkusfeld,8,0,71,63
1656770157256,COGS 14A,A01,092681,Semenuks; Arturs,0,1,100,100
1656770163282,COGS 14B,A01,083073,Cheng; Tzu-Han,5,0,63,58
1656770169306,COGS 17,A01,092677,Semenuks; Arturs,4,0,81,77
1656770175331,COGS 100,A01,083619,Allen; Michael Gordon,15,0,70,55
1656770181354,COGS 101A,A01,083621,Davis; Joshua Daniel,9,0,68,59
1656770187378,COGS 101B,A01,091572,Allen; Michael Gordon,8,0,65,57
1656770193408,COGS 101C,A01,083625,Delgado; Tania,17,0,35,18
1656770199434,COGS 107A,A01,083627,Boyle; Mary E. T.,13,0,60,47
1656770205465,COGS 118A,A01,083075,Gupta; Anjum,15,0,76,61
1656770211491,CSE 3,A50,083646,Miranda; Gregory Joseph,22,0,50,28
1656770217523,CSE 8A,A50,083650,Miranda; Gregory Joseph,17,1,56,39
1656770223548,CSE 11,A01,083080,Cao; Yingjun,4,15,40,36
1656770229577,CSE 12,A01,083652,Krause-Levy; Sophia Louisa,20,1,120,100
1656770235603,CSE 15L,A01,083654,Morris; Justin Loren,8,0,50,42
1656770235603,CSE 15L,A02,083655,Morris; Justin Loren,8,0,50,42
1656770241630,CSE 20,A01,083657,Tran; Khoa Dang,37,0,80,43
1656770247668,CSE 21,A01,095574,Bach; Quang Tran,21,0,48,27
1656770253701,CSE 30,A01,083084,Eldon; John,4,0,80,76
1656770253701,CSE 30,B01,095061,Bhaskar; Nishant,5,0,50,45
1656770259730,CSE 100,A01,083659,Cao; Yingjun,1,4,70,69
1656770265760,CSE 134B,A01,083661,Powell; Thomas Allan,18,0,100,82
1656770271789,CSE 140,A01,083663,Gungor; Onat,14,0,85,71
1656770277817,CSE 140L,A01,083088,Eldon; John,16,0,100,84
1656770283844,CSE 175,A01,083665,Kumar; Rakesh,3,0,25,22
1656770289869,CSE 190,A00,092507,Dubnov; Shlomo,7,0,20,13
1656770295901,ECE 45,A01,083139,Congero; Spencer William,5,0,75,70
1656770301933,ECE 65,A50,083695,Saad; Andrew S,12,0,30,18
1656770301933,ECE 65,A51,095125,Saad; Andrew S,25,0,26,1
1656770307958,ECE 109,A01,091882,Touri; Behrouz,15,0,70,55
1656770313981,ECE 180,A00,083140,Abi Samra; Nicholas Camill,0,0,30,30
1656770313981,ECE 180,B00,083141,Abi Samra; Nicholas Camill,0,0,30,30
1656770320006,MATH 10A,A01,083735,Patchell; Gregory David,1,0,30,29
1656770320006,MATH 10A,A02,083736,Patchell; Gregory David,20,0,30,10
1656770320006,MATH 10A,A03,083737,Patchell; Gregory David,15,0,30,15
1656770326034,MATH 10B,A01,083207,Lim; Seonhee,7,0,34,27
1656770326034,MATH 10B,A02,083208,Lim; Seonhee,9,0,35,26
1656770326034,MATH 10B,A03,093472,Lim; Seonhee,4,0,34,30
1656770326034,MATH 10B,B01,083739,Sinha; Shubham,9,0,30,21
1656770332060,MATH 18,A01,083743,Cinel; Cameron Alexander,6,0,30,24
1656770332060,MATH 18,A02,083744,Cinel; Cameron Alexander,15,0,30,15
1656770332060,MATH 18,A03,083745,Cinel; Cameron Alexander,8,0,30,22
1656770332060,MATH 18,B01,083748,Rideout; David Porter,3,0,37,34
1656770332060,MATH 18,B02,083749,Rideout; David Porter,3,0,36,33
1656770332060,MATH 18,B03,083750,Rideout; David Porter,1,0,37,36
1656770332060,MATH 18,B04,083751,Rideout; David Porter,5,0,36,31
1656770332060,MATH 18,B05,093473,Rideout; David Porter,4,0,36,32
1656770332060,MATH 18,B06,093474,Rideout; David Porter,5,0,36,31
1656770338088,MATH 20A,A01,083754,Zheng; Zequn,12,0,40,28
1656770344113,MATH 20B,A01,083756,Briones; Jor-el Thomas Caparas,1,0,36,35
1656770344113,MATH 20B,A02,083757,Briones; Jor-el Thomas Caparas,1,0,36,35
1656770344113,MATH 20B,A03,093475,Briones; Jor-el Thomas Caparas,0,0,36,36
1656770350143,MATH 20C,A01,083760,Briones; Jor-el Thomas Caparas,1,0,35,34
1656770350143,MATH 20C,A02,083761,Briones; Jor-el Thomas Caparas,8,0,35,27
1656770350143,MATH 20C,A03,093476,Briones; Jor-el Thomas Caparas,0,1,36,36
1656770350143,MATH 20C,B01,083762,Bach; Quang Tran,0,0,30,30
1656770356168,MATH 20D,A01,083765,Tran; Brian Kha,4,0,30,26
1656770356168,MATH 20D,A02,083766,Tran; Brian Kha,4,0,30,26
1656770356168,MATH 20D,A03,083767,Tran; Brian Kha,2,0,30,28
1656770362197,MATH 20E,A01,083771,Ganguly; Soumya,5,0,32,27
1656770362197,MATH 20E,A02,083772,Ganguly; Soumya,5,0,32,27
1656770362197,MATH 20E,B01,083773,Ciotti; Benjamin,18,0,35,17
1656770362197,MATH 20E,B02,083774,Ciotti; Benjamin,17,0,35,18
1656770368232,MATH 103A,A01,083777,Greenfeld; Be'Eri,2,0,36,34
1656770368232,MATH 103A,A02,083778,Greenfeld; Be'Eri,5,0,36,31
1656770368232,MATH 103A,A03,093561,Greenfeld; Be'Eri,4,0,36,32
1656770368232,MATH 103A,B01,083779,Greenfeld; Be'Eri,6,0,36,30
1656770368232,MATH 103A,B02,083780,Greenfeld; Be'Eri,2,0,36,34
1656770368232,MATH 103A,B03,093562,Greenfeld; Be'Eri,2,0,36,34
1656770374256,MATH 105,A01,085443,Carter; Anne Toulson,13,0,35,22
1656770374256,MATH 105,A02,093477,Carter; Anne Toulson,20,0,35,15
1656770380288,MATH 109,A01,083213,Ganzberger; Geoffrey Michael,2,0,34,32
1656770380288,MATH 109,A02,083214,Ganzberger; Geoffrey Michael,2,0,34,32
1656770380288,MATH 109,A03,093478,Ganzberger; Geoffrey Michael,1,0,34,33
1656770380288,MATH 109,B01,083215,Ganzberger; Geoffrey Michael,1,0,32,31
1656770380288,MATH 109,B02,083216,Ganzberger; Geoffrey Michael,1,0,32,31
1656770380288,MATH 109,B03,093479,Ganzberger; Geoffrey Michael,6,0,32,26
1656770386325,MATH 142A,A01,083219,Chow; Bennett,6,0,32,26
1656770386325,MATH 142A,A02,083220,Chow; Bennett,9,0,32,23
1656770386325,MATH 142A,A03,093480,Chow; Bennett,7,0,32,25
1656770386325,MATH 142A,B03,093481,Chow; Bennett,7,0,32,25
1656770386325,MATH 142A,B04,093558,Chow; Bennett,10,0,32,22
1656770386325,MATH 142A,B05,093559,Chow; Bennett,6,0,32,26
1656770392357,MATH 193A,A01,083224,Rotar; Vladimir,6,0,34,28
1656770392357,MATH 193A,A02,083225,Rotar; Vladimir,3,0,34,31
1656770392357,MATH 193A,A03,083781,Rotar; Vladimir,1,0,34,33
1656770392357,MATH 193A,A04,083782,Rotar; Vladimir,6,0,34,28
1656770392357,MATH 193A,A05,093482,Rotar; Vladimir,6,0,34,28
1656770398383,MATH 197,001,091859,McAuley; Julian John,9999,0,9999,0
1656770398383,MATH 197,002,095566,Kedlaya; Kiran S.,9997,0,9999,2
1656770398383,MATH 197,003,095567,Xiao; Ming,9999,0,9999,0
1656770398383,MATH 197,004,095571,Perols; Johan Lars,9998,0,9999,1
1656770405462,COGS 9,A01,083615,Shannon; Kyle Michael,6,0,75,69
1656770411491,COGS 11,A01,083617,Boyle; Mary E. T.,18,0,48,30
1656770417521,COGS 13,A01,083071,Bastos; Amalia Pinkusfeld,8,0,71,63
1656770423548,COGS 14A,A01,092681,Semenuks; Arturs,0,1,100,100
1656770429579,COGS 14B,A01,083073,Cheng; Tzu-Han,5,0,63,58
1656770435605,COGS 17,A01,092677,Semenuks; Arturs,4,0,81,77
1656770441629,COGS 100,A01,083619,Allen; Michael Gordon,15,0,70,55
1656770447654,COGS 101A,A01,083621,Davis; Joshua Daniel,9,0,68,59
1656770453683,COGS 101B,A01,091572,Allen; Michael Gordon,8,0,65,57
1656770459714,COGS 101C,A01,083625,Delgado; Tania,17,0,35,18
1656770465741,COGS 107A,A01,083627,Boyle; Mary E. T.,13,0,60,47
1656770471767,COGS 118A,A01,083075,Gupta; Anjum,15,0,76,61
1656770477793,CSE 3,A50,083646,Miranda; Gregory Joseph,22,0,50,28
1656770483819,CSE 8A,A50,083650,Miranda; Gregory Joseph,17,1,56,39
1656770489848,CSE 11,A01,083080,Cao; Yingjun,4,15,40,36
1656770495880,CSE 12,A01,083652,Krause-Levy; Sophia Louisa,20,1,120,100
1656770501906,CSE 15L,A01,083654,Morris; Justin Loren,8,0,50,42
1656770501906,CSE 15L,A02,083655,Morris; Justin Loren,8,0,50,42
1656770507931,CSE 20,A01,083657,Tran; Khoa Dang,37,0,80,43
1656770513956,CSE 21,A01,095574,Bach; Quang Tran,21,0,48,27
1656770519991,CSE 30,A01,083084,Eldon; John,4,0,80,76
1656770519991,CSE 30,B01,095061,Bhaskar; Nishant,5,0,50,45
1656770526019,CSE 100,A01,083659,Cao; Yingjun,1,4,70,69
1656770532054,CSE 134B,A01,083661,Powell; Thomas Allan,18,0,100,82
1656770538087,CSE 140,A01,083663,Gungor; Onat,14,0,85,71
1656770544111,CSE 140L,A01,083088,Eldon; John,16,0,100,84
1656770550136,CSE 175,A01,083665,Kumar; Rakesh,3,0,25,22
1656770556160,CSE 190,A00,092507,Dubnov; Shlomo,7,0,20,13
1656770562187,ECE 45,A01,083139,Congero; Spencer William,5,0,75,70
1656770568223,ECE 65,A50,083695,Saad; Andrew S,12,0,30,18
1656770568223,ECE 65,A51,095125,Saad; Andrew S,25,0,26,1
1656770574254,ECE 109,A01,091882,Touri; Behrouz,15,0,70,55
1656770580284,ECE 180,A00,083140,Abi Samra; Nicholas Camill,0,0,30,30
1656770580284,ECE 180,B00,083141,Abi Samra; Nicholas Camill,0,0,30,30
1656770586324,MATH 10A,A01,083735,Patchell; Gregory David,1,0,30,29
1656770586324,MATH 10A,A02,083736,Patchell; Gregory David,20,0,30,10
1656770586324,MATH 10A,A03,083737,Patchell; Gregory David,15,0,30,15
1656770592360,MATH 10B,A01,083207,Lim; Seonhee,7,0,34,27
1656770592360,MATH 10B,A02,083208,Lim; Seonhee,9,0,35,26
1656770592360,MATH 10B,A03,093472,Lim; Seonhee,4,0,34,30
1656770592360,MATH 10B,B01,083739,Sinha; Shubham,9,0,30,21
1656770598389,MATH 18,A01,083743,Cinel; Cameron Alexander,6,0,30,24
1656770598389,MATH 18,A02,083744,Cinel; Cameron Alexander,15,0,30,15
1656770598389,MATH 18,A03,083745,Cinel; Cameron Alexander,8,0,30,22
1656770598389,MATH 18,B01,083748,Rideout; David Porter,3,0,37,34
1656770598389,MATH 18,B02,083749,Rideout; David Porter,3,0,36,33
1656770598389,MATH 18,B03,083750,Rideout; David Porter,1,0,37,36
1656770598389,MATH 18,B04,083751,Rideout; David Porter,5,0,36,31
1656770598389,MATH 18,B05,093473,Rideout; David Porter,4,0,36,32
1656770598389,MATH 18,B06,093474,Rideout; David Porter,5,0,36,31
1656770604413,MATH 20A,A01,083754,Zheng; Zequn,12,0,40,28
1656770610448,MATH 20B,A01,083756,Briones; Jor-el Thomas Caparas,1,0,36,35
1656770610448,MATH 20B,A02,083757,Briones; Jor-el Thomas Caparas,1,0,36,35
1656770610448,MATH 20B,A03,093475,Briones; Jor-el Thomas Caparas,0,0,36,36
1656770616481,MATH 20C,A01,083760,Briones; Jor-el Thomas Caparas,1,0,35,34
1656770616481,MATH 20C,A02,083761,Briones; Jor-el Thomas Caparas,8,0,35,27
1656770616481,MATH 20C,A03,093476,Briones; Jor-el Thomas Caparas,0,1,36,36
1656770616481,MATH 20C,B01,083762,Bach; Quang Tran,0,0,30,30
1656770622512,MATH 20D,A01,083765,Tran; Brian Kha,4,0,30,26
1656770622512,MATH 20D,A02,083766,Tran; Brian Kha,4,0,30,26
1656770622512,MATH 20D,A03,083767,Tran; Brian Kha,2,0,30,28
1656770628632,MATH 20E,A01,083771,Ganguly; Soumya,5,0,32,27
1656770628632,MATH 20E,A02,083772,Ganguly; Soumya,5,0,32,27
1656770628632,MATH 20E,B01,083773,Ciotti; Benjamin,18,0,35,17
1656770628632,MATH 20E,B02,083774,Ciotti; Benjamin,17,0,35,18
1656770634668,MATH 103A,A01,083777,Greenfeld; Be'Eri,2,0,36,34
1656770634668,MATH 103A,A02,083778,Greenfeld; Be'Eri,5,0,36,31
1656770634668,MATH 103A,A03,093561,Greenfeld; Be'Eri,4,0,36,32
1656770634668,MATH 103A,B01,083779,Greenfeld; Be'Eri,6,0,36,30
1656770634668,MATH 103A,B02,083780,Greenfeld; Be'Eri,2,0,36,34
1656770634668,MATH 103A,B03,093562,Greenfeld; Be'Eri,2,0,36,34
1656770640699,MATH 105,A01,085443,Carter; Anne Toulson,13,0,35,22
1656770640699,MATH 105,A02,093477,Carter; Anne Toulson,20,0,35,15
1656770646723,MATH 109,A01,083213,Ganzberger; Geoffrey Michael,2,0,34,32
1656770646723,MATH 109,A02,083214,Ganzberger; Geoffrey Michael,2,0,34,32
1656770646723,MATH 109,A03,093478,Ganzberger; Geoffrey Michael,1,0,34,33
1656770646723,MATH 109,B01,083215,Ganzberger; Geoffrey Michael,1,0,32,31
1656770646723,MATH 109,B02,083216,Ganzberger; Geoffrey Michael,1,0,32,31
1656770646723,MATH 109,B03,093479,Ganzberger; Geoffrey Michael,6,0,32,26
1656770652757,MATH 142A,A01,083219,Chow; Bennett,6,0,32,26
1656770652757,MATH 142A,A02,083220,Chow; Bennett,9,0,32,23
1656770652757,MATH 142A,A03,093480,Chow; Bennett,7,0,32,25
1656770652757,MATH 142A,B03,093481,Chow; Bennett,7,0,32,25
1656770652757,MATH 142A,B04,093558,Chow; Bennett,10,0,32,22
1656770652757,MATH 142A,B05,093559,Chow; Bennett,6,0,32,26
1656770658782,MATH 193A,A01,083224,Rotar; Vladimir,6,0,34,28
1656770658782,MATH 193A,A02,083225,Rotar; Vladimir,3,0,34,31
1656770658782,MATH 193A,A03,083781,Rotar; Vladimir,1,0,34,33
1656770658782,MATH 193A,A04,083782,Rotar; Vladimir,6,0,34,28
1656770658782,MATH 193A,A05,093482,Rotar; Vladimir,6,0,34,28
1656770664815,MATH 197,001,091859,McAuley; Julian John,9999,0,9999,0
1656770664815,MATH 197,002,095566,Kedlaya; Kiran S.,9997,0,9999,2
1656770664815,MATH 197,003,095567,Xiao; Ming,9999,0,9999,0
1656770664815,MATH 197,004,095571,Perols; Johan Lars,9998,0,9999,1
1656770671878,COGS 9,A01,083615,Shannon; Kyle Michael,6,0,75,69
1656770677909,COGS 11,A01,083617,Boyle; Mary E. T.,18,0,48,30
1656770683942,COGS 13,A01,083071,Bastos; Amalia Pinkusfeld,8,0,71,63
1656770689968,COGS 14A,A01,092681,Semenuks; Arturs,0,1,100,100
1656770695993,COGS 14B,A01,083073,Cheng; Tzu-Han,5,0,63,58
1656770702024,COGS 17,A01,092677,Semenuks; Arturs,4,0,81,77
1656770708056,COGS 100,A01,083619,Allen; Michael Gordon,15,0,70,55
1656770714083,COGS 101A,A01,083621,Davis; Joshua Daniel,9,0,68,59
1656770720110,COGS 101B,A01,091572,Allen; Michael Gordon,8,0,65,57
1656770726140,COGS 101C,A01,083625,Delgado; Tania,17,0,35,18
1656770732166,COGS 107A,A01,083627,Boyle; Mary E. T.,13,0,60,47
1656770738191,COGS 118A,A01,083075,Gupta; Anjum,15,0,76,61
1656770744215,CSE 3,A50,083646,Miranda; Gregory Joseph,22,0,50,28
1656770750240,CSE 8A,A50,083650,Miranda; Gregory Joseph,17,1,56,39
1656770756265,CSE 11,A01,083080,Cao; Yingjun,4,15,40,36
1656770762290,CSE 12,A01,083652,Krause-Levy; Sophia Louisa,20,1,120,100
1656770768316,CSE 15L,A01,083654,Morris; Justin Loren,8,0,50,42
1656770768316,CSE 15L,A02,083655,Morris; Justin Loren,8,0,50,42
1656770774342,CSE 20,A01,083657,Tran; Khoa Dang,37,0,80,43
1656770780367,CSE 21,A01,095574,Bach; Quang Tran,21,0,48,27
1656770786393,CSE 30,A01,083084,Eldon; John,4,0,80,76
1656770786393,CSE 30,B01,095061,Bhaskar; Nishant,5,0,50,45
1656770792420,CSE 100,A01,083659,Cao; Yingjun,1,4,70,69
1656770798446,CSE 134B,A01,083661,Powell; Thomas Allan,18,0,100,82
1656770804477,CSE 140,A01,083663,Gungor; Onat,14,0,85,71
1656770810503,CSE 140L,A01,083088,Eldon; John,16,0,100,84
1656770816528,CSE 175,A01,083665,Kumar; Rakesh,3,0,25,22
1656770822555,CSE 190,A00,092507,Dubnov; Shlomo,7,0,20,13
1656770828581,ECE 45,A01,083139,Congero; Spencer William,5,0,75,70
1656770834608,ECE 65,A50,083695,Saad; Andrew S,12,0,30,18
1656770834608,ECE 65,A51,095125,Saad; Andrew S,25,0,26,1
1656770840677,ECE 109,A01,091882,Touri; Behrouz,15,0,70,55
1656770846701,ECE 180,A00,083140,Abi Samra; Nicholas Camill,0,0,30,30
1656770846701,ECE 180,B00,083141,Abi Samra; Nicholas Camill,0,0,30,30
1656770852735,MATH 10A,A01,083735,Patchell; Gregory David,1,0,30,29
1656770852735,MATH 10A,A02,083736,Patchell; Gregory David,20,0,30,10
1656770852735,MATH 10A,A03,083737,Patchell; Gregory David,15,0,30,15
1656770858765,MATH 10B,A01,083207,Lim; Seonhee,7,0,34,27
1656770858765,MATH 10B,A02,083208,Lim; Seonhee,9,0,35,26
1656770858765,MATH 10B,A03,093472,Lim; Seonhee,4,0,34,30
1656770858765,MATH 10B,B01,083739,Sinha; Shubham,9,0,30,21
1656770864792,MATH 18,A01,083743,Cinel; Cameron Alexander,6,0,30,24
1656770864792,MATH 18,A02,083744,Cinel; Cameron Alexander,15,0,30,15
1656770864792,MATH 18,A03,083745,Cinel; Cameron Alexander,8,0,30,22
1656770864792,MATH 18,B01,083748,Rideout; David Porter,3,0,37,34
1656770864792,MATH 18,B02,083749,Rideout; David Porter,3,0,36,33
1656770864792,MATH 18,B03,083750,Rideout; David Porter,1,0,37,36
1656770864792,MATH 18,B04,083751,Rideout; David Porter,5,0,36,31
1656770864792,MATH 18,B05,093473,Rideout; David Porter,4,0,36,32
1656770864792,MATH 18,B06,093474,Rideout; David Porter,5,0,36,31
1656770870818,MATH 20A,A01,083754,Zheng; Zequn,12,0,40,28
1656770876844,MATH 20B,A01,083756,Briones; Jor-el Thomas Caparas,1,0,36,35
1656770876844,MATH 20B,A02,083757,Briones; Jor-el Thomas Caparas,1,0,36,35
1656770876844,MATH 20B,A03,093475,Briones; Jor-el Thomas Caparas,0,0,36,36
1656770882870,MATH 20C,A01,083760,Briones; Jor-el Thomas Caparas,1,0,35,34
1656770882870,MATH 20C,A02,083761,Briones; Jor-el Thomas Caparas,8,0,35,27
1656770882870,MATH 20C,A03,093476,Briones; Jor-el Thomas Caparas,0,1,36,36
1656770882870,MATH 20C,B01,083762,Bach; Quang Tran,0,0,30,30
1656770888902,MATH 20D,A01,083765,Tran; Brian Kha,4,0,30,26
1656770888902,MATH 20D,A02,083766,Tran; Brian Kha,4,0,30,26
1656770888902,MATH 20D,A03,083767,Tran; Brian Kha,2,0,30,28
1656770894928,MATH 20E,A01,083771,Ganguly; Soumya,5,0,32,27
1656770894928,MATH 20E,A02,083772,Ganguly; Soumya,5,0,32,27
1656770894928,MATH 20E,B01,083773,Ciotti; Benjamin,18,0,35,17
1656770894928,MATH 20E,B02,083774,Ciotti; Benjamin,17,0,35,18
1656770900957,MATH 103A,A01,083777,Greenfeld; Be'Eri,2,0,36,34
1656770900957,MATH 103A,A02,083778,Greenfeld; Be'Eri,5,0,36,31
1656770900957,MATH 103A,A03,093561,Greenfeld; Be'Eri,4,0,36,32
1656770900957,MATH 103A,B01,083779,Greenfeld; Be'Eri,6,0,36,30
1656770900957,MATH 103A,B02,083780,Greenfeld; Be'Eri,2,0,36,34
1656770900957,MATH 103A,B03,093562,Greenfeld; Be'Eri,2,0,36,34
1656770906993,MATH 105,A01,085443,Carter; Anne Toulson,13,0,35,22
1656770906993,MATH 105,A02,093477,Carter; Anne Toulson,20,0,35,15
1656770913024,MATH 109,A01,083213,Ganzberger; Geoffrey Michael,2,0,34,32
1656770913024,MATH 109,A02,083214,Ganzberger; Geoffrey Michael,2,0,34,32
1656770913024,MATH 109,A03,093478,Ganzberger; Geoffrey Michael,1,0,34,33
1656770913024,MATH 109,B01,083215,Ganzberger; Geoffrey Michael,1,0,32,31
1656770913024,MATH 109,B02,083216,Ganzberger; Geoffrey Michael,1,0,32,31
1656770913024,MATH 109,B03,093479,Ganzberger; Geoffrey Michael,6,0,32,26
1656770919048,MATH 142A,A01,083219,Chow; Bennett,6,0,32,26
1656770919048,MATH 142A,A02,083220,Chow; Bennett,9,0,32,23
1656770919048,MATH 142A,A03,093480,Chow; Bennett,7,0,32,25
1656770919048,MATH 142A,B03,093481,Chow; Bennett,7,0,32,25
1656770919048,MATH 142A,B04,093558,Chow; Bennett,10,0,32,22
1656770919048,MATH 142A,B05,093559,Chow; Bennett,6,0,32,26
1656770925079,MATH 193A,A01,083224,Rotar; Vladimir,6,0,34,28
1656770925079,MATH 193A,A02,083225,Rotar; Vladimir,3,0,34,31
1656770925079,MATH 193A,A03,083781,Rotar; Vladimir,1,0,34,33
1656770925079,MATH 193A,A04,083782,Rotar; Vladimir,6,0,34,28
1656770925079,MATH 193A,A05,093482,Rotar; Vladimir,6,0,34,28
1656770931102,MATH 197,001,091859,McAuley; Julian John,9999,0,9999,0
1656770931102,MATH 197,002,095566,Kedlaya; Kiran S.,9997,0,9999,2
1656770931102,MATH 197,003,095567,Xiao; Ming,9999,0,9999,0
1656770931102,MATH 197,004,095571,Perols; Johan Lars,9998,0,9999,1
1656770938187,COGS 9,A01,083615,Shannon; Kyle Michael,6,0,75,69
1656770944218,COGS 11,A01,083617,Boyle; Mary E. T.,18,0,48,30
1656770950243,COGS 13,A01,083071,Bastos; Amalia Pinkusfeld,8,0,71,63
1656770956268,COGS 14A,A01,092681,Semenuks; Arturs,0,1,100,100
1656770962292,COGS 14B,A01,083073,Cheng; Tzu-Han,5,0,63,58
1656770968316,COGS 17,A01,092677,Semenuks; Arturs,4,0,81,77
1656770974340,COGS 100,A01,083619,Allen; Michael Gordon,15,0,70,55
1656770980365,COGS 101A,A01,083621,Davis; Joshua Daniel,9,0,68,59
1656770986390,COGS 101B,A01,091572,Allen; Michael Gordon,8,0,65,57
1656770992423,COGS 101C,A01,083625,Delgado; Tania,17,0,35,18
1656770998451,COGS 107A,A01,083627,Boyle; Mary E. T.,13,0,60,47
1656771004478,COGS 118A,A01,083075,Gupta; Anjum,15,0,76,61
1656771010504,CSE 3,A50,083646,Miranda; Gregory Joseph,22,0,50,28
1656771016538,CSE 8A,A50,083650,Miranda; Gregory Joseph,17,1,56,39
1656771022563,CSE 11,A01,083080,Cao; Yingjun,4,15,40,36
1656771028597,CSE 12,A01,083652,Krause-Levy; Sophia Louisa,20,1,120,100
1656771034620,CSE 15L,A01,083654,Morris; Justin Loren,8,0,50,42
1656771034620,CSE 15L,A02,083655,Morris; Justin Loren,8,0,50,42
1656771040648,CSE 20,A01,083657,Tran; Khoa Dang,37,0,80,43
1656771046672,CSE 21,A01,095574,Bach; Quang Tran,21,0,48,27
1656771052702,CSE 30,A01,083084,Eldon; John,4,0,80,76
1656771052702,CSE 30,B01,095061,Bhaskar; Nishant,5,0,50,45
1656771058732,CSE 100,A01,083659,Cao; Yingjun,1,4,70,69
1656771064756,CSE 134B,A01,083661,Powell; Thomas Allan,18,0,100,82
1656771070783,CSE 140,A01,083663,Gungor; Onat,14,0,85,71
1656771076806,CSE 140L,A01,083088,Eldon; John,16,0,100,84
1656771082833,CSE 175,A01,083665,Kumar; Rakesh,3,0,25,22
1656771088863,CSE 190,A00,092507,Dubnov; Shlomo,7,0,20,13
1656771094893,ECE 45,A01,083139,Congero; Spencer William,5,0,75,70
1656771100925,ECE 65,A50,083695,Saad; Andrew S,12,0,30,18
1656771100925,ECE 65,A51,095125,Saad; Andrew S,25,0,26,1
1656771106953,ECE 109,A01,091882,Touri; Behrouz,15,0,70,55
1656771112989,ECE 180,A00,083140,Abi Samra; Nicholas Camill,0,0,30,30
1656771112989,ECE 180,B00,083141,Abi Samra; Nicholas Camill,0,0,30,30
1656771119018,MATH 10A,A01,083735,Patchell; Gregory David,1,0,30,29
1656771119018,MATH 10A,A02,083736,Patchell; Gregory David,20,0,30,10
1656771119018,MATH 10A,A03,083737,Patchell; Gregory David,15,0,30,15
1656771125051,MATH 10B,A01,083207,Lim; Seonhee,7,0,34,27
1656771125051,MATH 10B,A02,083208,Lim; Seonhee,9,0,35,26
1656771125051,MATH 10B,A03,093472,Lim; Seonhee,4,0,34,30
1656771125051,MATH 10B,B01,083739,Sinha; Shubham,9,0,30,21
1656771131107,MATH 18,A01,083743,Cinel; Cameron Alexander,6,0,30,24
1656771131107,MATH 18,A02,083744,Cinel; Cameron Alexander,15,0,30,15
1656771131107,MATH 18,A03,083745,Cinel; Cameron Alexander,8,0,30,22
1656771131107,MATH 18,B01,083748,Rideout; David Porter,3,0,37,34
1656771131107,MATH 18,B02,083749,Rideout; David Porter,3,0,36,33
1656771131107,MATH 18,B03,083750,Rideout; David Porter,1,0,37,36
1656771131107,MATH 18,B04,083751,Rideout; David Porter,5,0,36,31
1656771131107,MATH 18,B05,093473,Rideout; David Porter,4,0,36,32
1656771131107,MATH 18,B06,093474,Rideout; David Porter,5,0,36,31
1656771137136,MATH 20A,A01,083754,Zheng; Zequn,12,0,40,28
1656771143162,MATH 20B,A01,083756,Briones; Jor-el Thomas Caparas,1,0,36,35
1656771143162,MATH 20B,A02,083757,Briones; Jor-el Thomas Caparas,1,0,36,35
1656771143162,MATH 20B,A03,093475,Briones; Jor-el Thomas Caparas,0,0,36,36
1656771149188,MATH 20C,A01,083760,Briones; Jor-el Thomas Caparas,1,0,35,34
1656771149188,MATH 20C,A02,083761,Briones; Jor-el Thomas Caparas,8,0,35,27
1656771149188,MATH 20C,A03,093476,Briones; Jor-el Thomas Caparas,0,1,36,36
1656771149188,MATH 20C,B01,083762,Bach; Quang Tran,0,0,30,30
1656771155222,MATH 20D,A01,083765,Tran; Brian Kha,4,0,30,26
1656771155222,MATH 20D,A02,083766,Tran; Brian Kha,4,0,30,26
1656771155222,MATH 20D,A03,083767,Tran; Brian Kha,2,0,30,28
1656771161250,MATH 20E,A01,083771,Ganguly; Soumya,5,0,32,27
1656771161250,MATH 20E,A02,083772,Ganguly; Soumya,5,0,32,27
1656771161250,MATH 20E,B01,083773,Ciotti; Benjamin,18,0,35,17
1656771161250,MATH 20E,B02,083774,Ciotti; Benjamin,17,0,35,18
1656771167279,MATH 103A,A01,083777,Greenfeld; Be'Eri,2,0,36,34
1656771167279,MATH 103A,A02,083778,Greenfeld; Be'Eri,5,0,36,31
1656771167279,MATH 103A,A03,093561,Greenfeld; Be'Eri,4,0,36,32
1656771167279,MATH 103A,B01,083779,Greenfeld; Be'Eri,6,0,36,30
1656771167279,MATH 103A,B02,083780,Greenfeld; Be'Eri,2,0,36,34
1656771167279,MATH 103A,B03,093562,Greenfeld; Be'Eri,2,0,36,34
1656771173305,MATH 105,A01,085443,Carter; Anne Toulson,13,0,35,22
1656771173305,MATH 105,A02,093477,Carter; Anne Toulson,20,0,35,15
1656771179330,MATH 109,A01,083213,Ganzberger; Geoffrey Michael,2,0,34,32
1656771179330,MATH 109,A02,083214,Ganzberger; Geoffrey Michael,2,0,34,32
1656771179330,MATH 109,A03,093478,Ganzberger; Geoffrey Michael,1,0,34,33
1656771179330,MATH 109,B01,083215,Ganzberger; Geoffrey Michael,1,0,32,31
1656771179330,MATH 109,B02,083216,Ganzberger; Geoffrey Michael,1,0,32,31
1656771179330,MATH 109,B03,093479,Ganzberger; Geoffrey Michael,6,0,32,26
1656771185358,MATH 142A,A01,083219,Chow; Bennett,6,0,32,26
1656771185358,MATH 142A,A02,083220,Chow; Bennett,9,0,32,23
1656771185358,MATH 142A,A03,093480,Chow; Bennett,7,0,32,25
1656771185358,MATH 142A,B03,093481,Chow; Bennett,7,0,32,25
1656771185358,MATH 142A,B04,093558,Chow; Bennett,10,0,32,22
1656771185358,MATH 142A,B05,093559,Chow; Bennett,6,0,32,26
1656771191388,MATH 193A,A01,083224,Rotar; Vladimir,6,0,34,28
1656771191388,MATH 193A,A02,083225,Rotar; Vladimir,3,0,34,31
1656771191388,MATH 193A,A03,083781,Rotar; Vladimir,1,0,34,33
1656771191388,MATH 193A,A04,083782,Rotar; Vladimir,6,0,34,28
1656771191388,MATH 193A,A05,093482,Rotar; Vladimir,6,0,34,28
1656771197419,MATH 197,001,091859,McAuley; Julian John,9999,0,9999,0
1656771197419,MATH 197,002,095566,Kedlaya; Kiran S.,9997,0,9999,2
1656771197419,MATH 197,003,095567,Xiao; Ming,9999,0,9999,0
1656771197419,MATH 197,004,095571,Perols; Johan Lars,9998,0,9999,1
1656771204486,COGS 9,A01,083615,Shannon; Kyle Michael,6,0,75,69
1656771210512,COGS 11,A01,083617,Boyle; Mary E. T.,18,0,48,30
1656771216538,COGS 13,A01,083071,Bastos; Amalia Pinkusfeld,8,0,71,63
1656771222665,COGS 14A,A01,092681,Semenuks; Arturs,0,1,100,100
1656771228691,COGS 14B,A01,083073,Cheng; Tzu-Han,5,0,63,58
1656771234716,COGS 17,A01,092677,Semenuks; Arturs,4,0,81,77
1656771240741,COGS 100,A01,083619,Allen; Michael Gordon,15,0,70,55
1656771246776,COGS 101A,A01,083621,Davis; Joshua Daniel,9,0,68,59
1656771252801,COGS 101B,A01,091572,Allen; Michael Gordon,8,0,65,57
1656771258828,COGS 101C,A01,083625,Delgado; Tania,17,0,35,18
1656771264852,COGS 107A,A01,083627,Boyle; Mary E. T.,13,0,60,47
1656771270880,COGS 118A,A01,083075,Gupta; Anjum,15,0,76,61
1656771276915,CSE 3,A50,083646,Miranda; Gregory Joseph,22,0,50,28
1656771282947,CSE 8A,A50,083650,Miranda; Gregory Joseph,17,1,56,39
1656771288973,CSE 11,A01,083080,Cao; Yingjun,4,15,40,36
1656771295003,CSE 12,A01,083652,Krause-Levy; Sophia Louisa,20,1,120,100
1656771301041,CSE 15L,A01,083654,Morris; Justin Loren,8,0,50,42
1656771301041,CSE 15L,A02,083655,Morris; Justin Loren,8,0,50,42
1656771307064,CSE 20,A01,083657,Tran; Khoa Dang,37,0,80,43
1656771313098,CSE 21,A01,095574,Bach; Quang Tran,21,0,48,27
1656771319138,CSE 30,A01,083084,Eldon; John,4,0,80,76
1656771319138,CSE 30,B01,095061,Bhaskar; Nishant,5,0,50,45
1656771325171,CSE 100,A01,083659,Cao; Yingjun,1,4,70,69
1656771331197,CSE 134B,A01,083661,Powell; Thomas Allan,18,0,100,82
1656771337233,CSE 140,A01,083663,Gungor; Onat,14,0,85,71
1656771343262,CSE 140L,A01,083088,Eldon; John,16,0,100,84
1656771349292,CSE 175,A01,083665,Kumar; Rakesh,3,0,25,22
1656771355317,CSE 190,A00,092507,Dubnov; Shlomo,7,0,20,13
1656771361344,ECE 45,A01,083139,Congero; Spencer William,5,0,75,70
1656771367379,ECE 65,A50,083695,Saad; Andrew S,12,0,30,18
1656771367379,ECE 65,A51,095125,Saad; Andrew S,25,0,26,1
1656771373409,ECE 109,A01,091882,Touri; Behrouz,15,0,70,55
1656771379440,ECE 180,A00,083140,Abi Samra; Nicholas Camill,0,0,30,30
1656771379440,ECE 180,B00,083141,Abi Samra; Nicholas Camill,0,0,30,30
1656771385466,MATH 10A,A01,083735,Patchell; Gregory David,1,0,30,29
1656771385466,MATH 10A,A02,083736,Patchell; Gregory David,20,0,30,10
1656771385466,MATH 10A,A03,083737,Patchell; Gregory David,15,0,30,15
1656771391494,MATH 10B,A01,083207,Lim; Seonhee,7,0,34,27
1656771391494,MATH 10B,A02,083208,Lim; Seonhee,9,0,35,26
1656771391494,MATH 10B,A03,093472,Lim; Seonhee,4,0,34,30
1656771391494,MATH 10B,B01,083739,Sinha; Shubham,9,0,30,21
1656771397521,MATH 18,A01,083743,Cinel; Cameron Alexander,6,0,30,24
1656771397521,MATH 18,A02,083744,Cinel; Cameron Alexander,15,0,30,15
1656771397521,MATH 18,A03,083745,Cinel; Cameron Alexander,8,0,30,22
1656771397521,MATH 18,B01,083748,Rideout; David Porter,3,0,37,34
1656771397521,MATH 18,B02,083749,Rideout; David Porter,3,0,36,33
1656771397521,MATH 18,B03,083750,Rideout; David Porter,1,0,37,36
1656771397521,MATH 18,B04,083751,Rideout; David Porter,5,0,36,31
1656771397521,MATH 18,B05,093473,Rideout; David Porter,4,0,36,32
1656771397521,MATH 18,B06,093474,Rideout; David Porter,5,0,36,31
1656771403549,MATH 20A,A01,083754,Zheng; Zequn,12,0,40,28
1656771409580,MATH 20B,A01,083756,Briones; Jor-el Thomas Caparas,1,0,36,35
1656771409580,MATH 20B,A02,083757,Briones; Jor-el Thomas Caparas,1,0,36,35
1656771409580,MATH 20B,A03,093475,Briones; Jor-el Thomas Caparas,0,0,36,36
1656771415605,MATH 20C,A01,083760,Briones; Jor-el Thomas Caparas,1,0,35,34
1656771415605,MATH 20C,A02,083761,Briones; Jor-el Thomas Caparas,8,0,35,27
1656771415605,MATH 20C,A03,093476,Briones; Jor-el Thomas Caparas,0,1,36,36
1656771415605,MATH 20C,B01,083762,Bach; Quang Tran,0,0,30,30
1656771421636,MATH 20D,A01,083765,Tran; Brian Kha,4,0,30,26
1656771421636,MATH 20D,A02,083766,Tran; Brian Kha,4,0,30,26
1656771421636,MATH 20D,A03,083767,Tran; Brian Kha,2,0,30,28
1656771427665,MATH 20E,A01,083771,Ganguly; Soumya,5,0,32,27
1656771427665,MATH 20E,A02,083772,Ganguly; Soumya,5,0,32,27
1656771427665,MATH 20E,B01,083773,Ciotti; Benjamin,18,0,35,17
1656771427665,MATH 20E,B02,083774,Ciotti; Benjamin,17,0,35,18
1656771433691,MATH 103A,A01,083777,Greenfeld; Be'Eri,2,0,36,34
1656771433691,MATH 103A,A02,083778,Greenfeld; Be'Eri,5,0,36,31
1656771433691,MATH 103A,A03,093561,Greenfeld; Be'Eri,4,0,36,32
1656771433691,MATH 103A,B01,083779,Greenfeld; Be'Eri,6,0,36,30
1656771433691,MATH 103A,B02,083780,Greenfeld; Be'Eri,2,0,36,34
1656771433691,MATH 103A,B03,093562,Greenfeld; Be'Eri,2,0,36,34
1656771439721,MATH 105,A01,085443,Carter; Anne Toulson,13,0,35,22
1656771439721,MATH 105,A02,093477,Carter; Anne Toulson,20,0,35,15
1656771445745,MATH 109,A01,083213,Ganzberger; Geoffrey Michael,2,0,34,32
1656771445745,MATH 109,A02,083214,Ganzberger; Geoffrey Michael,2,0,34,32
1656771445745,MATH 109,A03,093478,Ganzberger; Geoffrey Michael,1,0,34,33
1656771445745,MATH 109,B01,083215,Ganzberger; Geoffrey Michael,1,0,32,31
1656771445745,MATH 109,B02,083216,Ganzberger; Geoffrey Michael,1,0,32,31
1656771445745,MATH 109,B03,093479,Ganzberger; Geoffrey Michael,6,0,32,26
1656771451775,MATH 142A,A01,083219,Chow; Bennett,6,0,32,26
1656771451775,MATH 142A,A02,083220,Chow; Bennett,9,0,32,23
1656771451775,MATH 142A,A03,093480,Chow; Bennett,7,0,32,25
1656771451775,MATH 142A,B03,093481,Chow; Bennett,7,0,32,25
1656771451775,MATH 142A,B04,093558,Chow; Bennett,10,0,32,22
1656771451775,MATH 142A,B05,093559,Chow; Bennett,6,0,32,26
1656771457798,MATH 193A,A01,083224,Rotar; Vladimir,6,0,34,28
1656771457798,MATH 193A,A02,083225,Rotar; Vladimir,3,0,34,31
1656771457798,MATH 193A,A03,083781,Rotar; Vladimir,1,0,34,33
1656771457798,MATH 193A,A04,083782,Rotar; Vladimir,6,0,34,28
1656771457798,MATH 193A,A05,093482,Rotar; Vladimir,6,0,34,28
1656771463821,MATH 197,001,091859,McAuley; Julian John,9999,0,9999,0
1656771463821,MATH 197,002,095566,Kedlaya; Kiran S.,9997,0,9999,2
1656771463821,MATH 197,003,095567,Xiao; Ming,9999,0,9999,0
1656771463821,MATH 197,004,095571,Perols; Johan Lars,9998,0,9999,1
1656771470896,COGS 9,A01,083615,Shannon; Kyle Michael,6,0,75,69
1656771476922,COGS 11,A01,083617,Boyle; Mary E. T.,18,0,48,30
1656771482950,COGS 13,A01,083071,Bastos; Amalia Pinkusfeld,8,0,71,63
1656771488976,COGS 14A,A01,092681,Semenuks; Arturs,0,1,100,100
1656771495005,COGS 14B,A01,083073,Cheng; Tzu-Han,5,0,63,58
1656771501035,COGS 17,A01,092677,Semenuks; Arturs,4,0,81,77
1656771507063,COGS 100,A01,083619,Allen; Michael Gordon,15,0,70,55
1656771513087,COGS 101A,A01,083621,Davis; Joshua Daniel,9,0,68,59
1656771519118,COGS 101B,A01,091572,Allen; Michael Gordon,8,0,65,57
1656771525150,COGS 101C,A01,083625,Delgado; Tania,17,0,35,18
1656771531175,COGS 107A,A01,083627,Boyle; Mary E. T.,13,0,60,47
1656771537198,COGS 118A,A01,083075,Gupta; Anjum,15,0,76,61
1656771543235,CSE 3,A50,083646,Miranda; Gregory Joseph,22,0,50,28
1656771549264,CSE 8A,A50,083650,Miranda; Gregory Joseph,17,1,56,39
1656771555289,CSE 11,A01,083080,Cao; Yingjun,4,15,40,36
1656771561312,CSE 12,A01,083652,Krause-Levy; Sophia Louisa,20,1,120,100
1656771567337,CSE 15L,A01,083654,Morris; Justin Loren,8,0,50,42
1656771567337,CSE 15L,A02,083655,Morris; Justin Loren,8,0,50,42
1656771573364,CSE 20,A01,083657,Tran; Khoa Dang,37,0,80,43
1656771579394,CSE 21,A01,095574,Bach; Quang Tran,21,0,48,27
1656771585432,CSE 30,A01,083084,Eldon; John,4,0,80,76
1656771585432,CSE 30,B01,095061,Bhaskar; Nishant,5,0,50,45
1656771591464,CSE 100,A01,083659,Cao; Yingjun,1,4,70,69
1656771597492,CSE 134B,A01,083661,Powell; Thomas Allan,18,0,100,82
1656771603523,CSE 140,A01,083663,Gungor; Onat,14,0,85,71
1656771609551,CSE 140L,A01,083088,Eldon; John,16,0,100,84
1656771615576,CSE 175,A01,083665,Kumar; Rakesh,3,0,25,22
1656771621601,CSE 190,A00,092507,Dubnov; Shlomo,7,0,20,13
1656771627635,ECE 45,A01,083139,Congero; Spencer William,5,0,75,70
1656771633667,ECE 65,A50,083695,Saad; Andrew S,12,0,30,18
1656771633667,ECE 65,A51,095125,Saad; Andrew S,25,0,26,1
1656771639695,ECE 109,A01,091882,Touri; Behrouz,15,0,70,55
1656771645722,ECE 180,A00,083140,Abi Samra; Nicholas Camill,0,0,30,30
1656771645722,ECE 180,B00,083141,Abi Samra; Nicholas Camill,0,0,30,30
1656771651748,MATH 10A,A01,083735,Patchell; Gregory David,1,0,30,29
1656771651748,MATH 10A,A02,083736,Patchell; Gregory David,20,0,30,10
1656771651748,MATH 10A,A03,083737,Patchell; Gregory David,15,0,30,15
1656771657786,MATH 10B,A01,083207,Lim; Seonhee,7,0,34,27
1656771657786,MATH 10B,A02,083208,Lim; Seonhee,9,0,35,26
1656771657786,MATH 10B,A03,093472,Lim; Seonhee,4,0,34,30
1656771657786,MATH 10B,B01,083739,Sinha; Shubham,9,0,30,21
1656771663813,MATH 18,A01,083743,Cinel; Cameron Alexander,6,0,30,24
1656771663813,MATH 18,A02,083744,Cinel; Cameron Alexander,15,0,30,15
1656771663813,MATH 18,A03,083745,Cinel; Cameron Alexander,8,0,30,22
1656771663813,MATH 18,B01,083748,Rideout; David Porter,3,0,37,34
1656771663813,MATH 18,B02,083749,Rideout; David Porter,3,0,36,33
1656771663813,MATH 18,B03,083750,Rideout; David Porter,1,0,37,36
1656771663813,MATH 18,B04,083751,Rideout; David Porter,5,0,36,31
1656771663813,MATH 18,B05,093473,Rideout; David Porter,4,0,36,32
1656771663813,MATH 18,B06,093474,Rideout; David Porter,5,0,36,31
1656771669841,MATH 20A,A01,083754,Zheng; Zequn,12,0,40,28
1656771675870,MATH 20B,A01,083756,Briones; Jor-el Thomas Caparas,1,0,36,35
1656771675870,MATH 20B,A02,083757,Briones; Jor-el Thomas Caparas,1,0,36,35
1656771675870,MATH 20B,A03,093475,Briones; Jor-el Thomas Caparas,0,0,36,36
1656771681913,MATH 20C,A01,083760,Briones; Jor-el Thomas Caparas,1,0,35,34
1656771681913,MATH 20C,A02,083761,Briones; Jor-el Thomas Caparas,8,0,35,27
1656771681913,MATH 20C,A03,093476,Briones; Jor-el Thomas Caparas,0,1,36,36
1656771681913,MATH 20C,B01,083762,Bach; Quang Tran,0,0,30,30
1656771687940,MATH 20D,A01,083765,Tran; Brian Kha,4,0,30,26
1656771687940,MATH 20D,A02,083766,Tran; Brian Kha,4,0,30,26
1656771687940,MATH 20D,A03,083767,Tran; Brian Kha,2,0,30,28
1656771693970,MATH 20E,A01,083771,Ganguly; Soumya,5,0,32,27
1656771693970,MATH 20E,A02,083772,Ganguly; Soumya,5,0,32,27
1656771693970,MATH 20E,B01,083773,Ciotti; Benjamin,18,0,35,17
1656771693970,MATH 20E,B02,083774,Ciotti; Benjamin,17,0,35,18
1656771700008,MATH 103A,A01,083777,Greenfeld; Be'Eri,2,0,36,34
1656771700008,MATH 103A,A02,083778,Greenfeld; Be'Eri,5,0,36,31
1656771700008,MATH 103A,A03,093561,Greenfeld; Be'Eri,4,0,36,32
1656771700008,MATH 103A,B01,083779,Greenfeld; Be'Eri,6,0,36,30
1656771700008,MATH 103A,B02,083780,Greenfeld; Be'Eri,2,0,36,34
1656771700008,MATH 103A,B03,093562,Greenfeld; Be'Eri,2,0,36,34
1656771706041,MATH 105,A01,085443,Carter; Anne Toulson,13,0,35,22
1656771706041,MATH 105,A02,093477,Carter; Anne Toulson,20,0,35,15
1656771712066,MATH 109,A01,083213,Ganzberger; Geoffrey Michael,2,0,34,32
1656771712066,MATH 109,A02,083214,Ganzberger; Geoffrey Michael,2,0,34,32
1656771712066,MATH 109,A03,093478,Ganzberger; Geoffrey Michael,1,0,34,33
1656771712066,MATH 109,B01,083215,Ganzberger; Geoffrey Michael,1,0,32,31
1656771712066,MATH 109,B02,083216,Ganzberger; Geoffrey Michael,1,0,32,31
1656771712066,MATH 109,B03,093479,Ganzberger; Geoffrey Michael,6,0,32,26
1656771718095,MATH 142A,A01,083219,Chow; Bennett,6,0,32,26
1656771718095,MATH 142A,A02,083220,Chow; Bennett,9,0,32,23
1656771718095,MATH 142A,A03,093480,Chow; Bennett,7,0,32,25
1656771718095,MATH 142A,B03,093481,Chow; Bennett,7,0,32,25
1656771718095,MATH 142A,B04,093558,Chow; Bennett,10,0,32,22
1656771718095,MATH 142A,B05,093559,Chow; Bennett,6,0,32,26
1656771724120,MATH 193A,A01,083224,Rotar; Vladimir,6,0,34,28
1656771724120,MATH 193A,A02,083225,Rotar; Vladimir,3,0,34,31
1656771724120,MATH 193A,A03,083781,Rotar; Vladimir,1,0,34,33
1656771724120,MATH 193A,A04,083782,Rotar; Vladimir,6,0,34,28
1656771724120,MATH 193A,A05,093482,Rotar; Vladimir,6,0,34,28
1656771730157,MATH 197,001,091859,McAuley; Julian John,9999,0,9999,0
1656771730157,MATH 197,002,095566,Kedlaya; Kiran S.,9997,0,9999,2
1656771730157,MATH 197,003,095567,Xiao; Ming,9999,0,9999,0
1656771730157,MATH 197,004,095571,Perols; Johan Lars,9998,0,9999,1
1656771737217,COGS 9,A01,083615,Shannon; Kyle Michael,6,0,75,69
1656771743242,COGS 11,A01,083617,Boyle; Mary E. T.,18,0,48,30
1656771749267,COGS 13,A01,083071,Bastos; Amalia Pinkusfeld,8,0,71,63
1656771755298,COGS 14A,A01,092681,Semenuks; Arturs,0,1,100,100
1656771761325,COGS 14B,A01,083073,Cheng; Tzu-Han,5,0,63,58
1656771767354,COGS 17,A01,092677,Semenuks; Arturs,4,0,81,77
1656771773383,COGS 100,A01,083619,Allen; Michael Gordon,15,0,70,55
1656771779411,COGS 101A,A01,083621,Davis; Joshua Daniel,9,0,68,59
1656771785437,COGS 101B,A01,091572,Allen; Michael Gordon,8,0,65,57
1656771791461,COGS 101C,A01,083625,Delgado; Tania,17,0,35,18
1656771797488,COGS 107A,A01,083627,Boyle; Mary E. T.,13,0,60,47
1656771803512,COGS 118A,A01,083075,Gupta; Anjum,15,0,76,61
1656771809545,CSE 3,A50,083646,Miranda; Gregory Joseph,22,0,50,28
1656771815568,CSE 8A,A50,083650,Miranda; Gregory Joseph,17,1,56,39
1656771821664,CSE 11,A01,083080,Cao; Yingjun,4,15,40,36
1656771827689,CSE 12,A01,083652,Krause-Levy; Sophia Louisa,20,1,120,100
1656771833718,CSE 15L,A01,083654,Morris; Justin Loren,8,0,50,42
1656771833718,CSE 15L,A02,083655,Morris; Justin Loren,8,0,50,42
1656771839746,CSE 20,A01,083657,Tran; Khoa Dang,37,0,80,43
1656771845772,CSE 21,A01,095574,Bach; Quang Tran,21,0,48,27
1656771851799,CSE 30,A01,083084,Eldon; John,4,0,80,76
1656771851799,CSE 30,B01,095061,Bhaskar; Nishant,5,0,50,45
1656771857824,CSE 100,A01,083659,Cao; Yingjun,1,4,70,69
1656771863849,CSE 134B,A01,083661,Powell; Thomas Allan,18,0,100,82
1656771869879,CSE 140,A01,083663,Gungor; Onat,14,0,85,71
1656771875904,CSE 140L,A01,083088,Eldon; John,16,0,100,84
1656771881941,CSE 175,A01,083665,Kumar; Rakesh,3,0,25,22
1656771887976,CSE 190,A00,092507,Dubnov; Shlomo,7,0,20,13
1656771894002,ECE 45,A01,083139,Congero; Spencer William,5,0,75,70
1656771900034,ECE 65,A50,083695,Saad; Andrew S,12,0,30,18
1656771900034,ECE 65,A51,095125,Saad; Andrew S,25,0,26,1
1656771906064,ECE 109,A01,091882,Touri; Behrouz,15,0,70,55
1656771912092,ECE 180,A00,083140,Abi Samra; Nicholas Camill,0,0,30,30
1656771912092,ECE 180,B00,083141,Abi Samra; Nicholas Camill,0,0,30,30
1656771918119,MATH 10A,A01,083735,Patchell; Gregory David,1,0,30,29
1656771918119,MATH 10A,A02,083736,Patchell; Gregory David,20,0,30,10
1656771918119,MATH 10A,A03,083737,Patchell; Gregory David,15,0,30,15
1656771924156,MATH 10B,A01,083207,Lim; Seonhee,7,0,34,27
1656771924156,MATH 10B,A02,083208,Lim; Seonhee,9,0,35,26
1656771924156,MATH 10B,A03,093472,Lim; Seonhee,4,0,34,30
1656771924156,MATH 10B,B01,083739,Sinha; Shubham,9,0,30,21
1656771930185,MATH 18,A01,083743,Cinel; Cameron Alexander,6,0,30,24
1656771930185,MATH 18,A02,083744,Cinel; Cameron Alexander,15,0,30,15
1656771930185,MATH 18,A03,083745,Cinel; Cameron Alexander,8,0,30,22
1656771930185,MATH 18,B01,083748,Rideout; David Porter,3,0,37,34
1656771930185,MATH 18,B02,083749,Rideout; David Porter,3,0,36,33
1656771930185,MATH 18,B03,083750,Rideout; David Porter,1,0,37,36
1656771930185,MATH 18,B04,083751,Rideout; David Porter,5,0,36,31
1656771930185,MATH 18,B05,093473,Rideout; David Porter,4,0,36,32
1656771930185,MATH 18,B06,093474,Rideout; David Porter,5,0,36,31
1656771936214,MATH 20A,A01,083754,Zheng; Zequn,12,0,40,28
1656771942245,MATH 20B,A01,083756,Briones; Jor-el Thomas Caparas,1,0,36,35
1656771942245,MATH 20B,A02,083757,Briones; Jor-el Thomas Caparas,1,0,36,35
1656771942245,MATH 20B,A03,093475,Briones; Jor-el Thomas Caparas,0,0,36,36
1656771948278,MATH 20C,A01,083760,Briones; Jor-el Thomas Caparas,1,0,35,34
1656771948278,MATH 20C,A02,083761,Briones; Jor-el Thomas Caparas,8,0,35,27
1656771948278,MATH 20C,A03,093476,Briones; Jor-el Thomas Caparas,0,1,36,36
1656771948278,MATH 20C,B01,083762,Bach; Quang Tran,0,0,30,30
1656771954305,MATH 20D,A01,083765,Tran; Brian Kha,4,0,30,26
1656771954305,MATH 20D,A02,083766,Tran; Brian Kha,4,0,30,26
1656771954305,MATH 20D,A03,083767,Tran; Brian Kha,2,0,30,28
1656771960332,MATH 20E,A01,083771,Ganguly; Soumya,5,0,32,27
1656771960332,MATH 20E,A02,083772,Ganguly; Soumya,5,0,32,27
1656771960332,MATH 20E,B01,083773,Ciotti; Benjamin,18,0,35,17
1656771960332,MATH 20E,B02,083774,Ciotti; Benjamin,17,0,35,18
1656771966358,MATH 103A,A01,083777,Greenfeld; Be'Eri,2,0,36,34
1656771966358,MATH 103A,A02,083778,Greenfeld; Be'Eri,5,0,36,31
1656771966358,MATH 103A,A03,093561,Greenfeld; Be'Eri,4,0,36,32
1656771966358,MATH 103A,B01,083779,Greenfeld; Be'Eri,6,0,36,30
1656771966358,MATH 103A,B02,083780,Greenfeld; Be'Eri,2,0,36,34
1656771966358,MATH 103A,B03,093562,Greenfeld; Be'Eri,2,0,36,34
1656771972391,MATH 105,A01,085443,Carter; Anne Toulson,13,0,35,22
1656771972391,MATH 105,A02,093477,Carter; Anne Toulson,20,0,35,15
1656771978426,MATH 109,A01,083213,Ganzberger; Geoffrey Michael,2,0,34,32
1656771978426,MATH 109,A02,083214,Ganzberger; Geoffrey Michael,2,0,34,32
1656771978426,MATH 109,A03,093478,Ganzberger; Geoffrey Michael,1,0,34,33
1656771978426,MATH 109,B01,083215,Ganzberger; Geoffrey Michael,1,0,32,31
1656771978426,MATH 109,B02,083216,Ganzberger; Geoffrey Michael,1,0,32,31
1656771978426,MATH 109,B03,093479,Ganzberger; Geoffrey Michael,6,0,32,26
1656771984453,MATH 142A,A01,083219,Chow; Bennett,6,0,32,26
1656771984453,MATH 142A,A02,083220,Chow; Bennett,9,0,32,23
1656771984453,MATH 142A,A03,093480,Chow; Bennett,7,0,32,25
1656771984453,MATH 142A,B03,093481,Chow; Bennett,7,0,32,25
1656771984453,MATH 142A,B04,093558,Chow; Bennett,10,0,32,22
1656771984453,MATH 142A,B05,093559,Chow; Bennett,6,0,32,26
1656771990479,MATH 193A,A01,083224,Rotar; Vladimir,6,0,34,28
1656771990479,MATH 193A,A02,083225,Rotar; Vladimir,3,0,34,31
1656771990479,MATH 193A,A03,083781,Rotar; Vladimir,1,0,34,33
1656771990479,MATH 193A,A04,083782,Rotar; Vladimir,6,0,34,28
1656771990479,MATH 193A,A05,093482,Rotar; Vladimir,6,0,34,28
1656771996504,MATH 197,001,091859,McAuley; Julian John,9999,0,9999,0
1656771996504,MATH 197,002,095566,Kedlaya; Kiran S.,9997,0,9999,2
1656771996504,MATH 197,003,095567,Xiao; Ming,9999,0,9999,0
1656771996504,MATH 197,004,095571,Perols; Johan Lars,9998,0,9999,1
1656772003576,COGS 9,A01,083615,Shannon; Kyle Michael,6,0,75,69
1656772009600,COGS 11,A01,083617,Boyle; Mary E. T.,18,0,48,30
1656772015646,COGS 13,A01,083071,Bastos; Amalia Pinkusfeld,8,0,71,63
1656772021670,COGS 14A,A01,092681,Semenuks; Arturs,0,1,100,100
1656772027694,COGS 14B,A01,083073,Cheng; Tzu-Han,5,0,63,58
1656772033716,COGS 17,A01,092677,Semenuks; Arturs,4,0,81,77
1656772039744,COGS 100,A01,083619,Allen; Michael Gordon,15,0,70,55
1656772045774,COGS 101A,A01,083621,Davis; Joshua Daniel,9,0,68,59
1656772051800,COGS 101B,A01,091572,Allen; Michael Gordon,8,0,65,57
1656772057824,COGS 101C,A01,083625,Delgado; Tania,17,0,35,18
1656772063854,COGS 107A,A01,083627,Boyle; Mary E. T.,13,0,60,47
1656772069881,COGS 118A,A01,083075,Gupta; Anjum,15,0,76,61
1656772075905,CSE 3,A50,083646,Miranda; Gregory Joseph,22,0,50,28
1656772081930,CSE 8A,A50,083650,Miranda; Gregory Joseph,17,1,56,39
1656772087954,CSE 11,A01,083080,Cao; Yingjun,4,15,40,36
1656772093995,CSE 12,A01,083652,Krause-Levy; Sophia Louisa,20,1,120,100
1656772100023,CSE 15L,A01,083654,Morris; Justin Loren,8,0,50,42
1656772100023,CSE 15L,A02,083655,Morris; Justin Loren,8,0,50,42
1656772106046,CSE 20,A01,083657,Tran; Khoa Dang,37,0,80,43
1656772112073,CSE 21,A01,095574,Bach; Quang Tran,21,0,48,27
1656772118106,CSE 30,A01,083084,Eldon; John,4,0,80,76
1656772118106,CSE 30,B01,095061,Bhaskar; Nishant,5,0,50,45
1656772124131,CSE 100,A01,083659,Cao; Yingjun,1,4,70,69
1656772130157,CSE 134B,A01,083661,Powell; Thomas Allan,18,0,100,82
1656772136184,CSE 140,A01,083663,Gungor; Onat,14,0,85,71
1656772142213,CSE 140L,A01,083088,Eldon; John,16,0,100,84
1656772148243,CSE 175,A01,083665,Kumar; Rakesh,3,0,25,22
1656772154269,CSE 190,A00,092507,Dubnov; Shlomo,7,0,20,13
1656772160301,ECE 45,A01,083139,Congero; Spencer William,5,0,75,70
1656772166329,ECE 65,A50,083695,Saad; Andrew S,12,0,30,18
1656772166329,ECE 65,A51,095125,Saad; Andrew S,25,0,26,1
1656772172353,ECE 109,A01,091882,Touri; Behrouz,15,0,70,55
1656772178379,ECE 180,A00,083140,Abi Samra; Nicholas Camill,0,0,30,30
1656772178379,ECE 180,B00,083141,Abi Samra; Nicholas Camill,0,0,30,30
1656772184421,MATH 10A,A01,083735,Patchell; Gregory David,1,0,30,29
1656772184421,MATH 10A,A02,083736,Patchell; Gregory David,20,0,30,10
1656772184421,MATH 10A,A03,083737,Patchell; Gregory David,15,0,30,15
1656772190448,MATH 10B,A01,083207,Lim; Seonhee,7,0,34,27
1656772190448,MATH 10B,A02,083208,Lim; Seonhee,9,0,35,26
1656772190448,MATH 10B,A03,093472,Lim; Seonhee,4,0,34,30
1656772190448,MATH 10B,B01,083739,Sinha; Shubham,9,0,30,21
1656772196477,MATH 18,A01,083743,Cinel; Cameron Alexander,6,0,30,24
1656772196477,MATH 18,A02,083744,Cinel; Cameron Alexander,15,0,30,15
1656772196477,MATH 18,A03,083745,Cinel; Cameron Alexander,8,0,30,22
1656772196477,MATH 18,B01,083748,Rideout; David Porter,3,0,37,34
1656772196477,MATH 18,B02,083749,Rideout; David Porter,3,0,36,33
1656772196477,MATH 18,B03,083750,Rideout; David Porter,1,0,37,36
1656772196477,MATH 18,B04,083751,Rideout; David Porter,5,0,36,31
1656772196477,MATH 18,B05,093473,Rideout; David Porter,4,0,36,32
1656772196477,MATH 18,B06,093474,Rideout; David Porter,5,0,36,31
1656772202504,MATH 20A,A01,083754,Zheng; Zequn,12,0,40,28
1656772208534,MATH 20B,A01,083756,Briones; Jor-el Thomas Caparas,1,0,36,35
1656772208534,MATH 20B,A02,083757,Briones; Jor-el Thomas Caparas,1,0,36,35
1656772208534,MATH 20B,A03,093475,Briones; Jor-el Thomas Caparas,0,0,36,36
1656772214567,MATH 20C,A01,083760,Briones; Jor-el Thomas Caparas,1,0,35,34
1656772214567,MATH 20C,A02,083761,Briones; Jor-el Thomas Caparas,8,0,35,27
1656772214567,MATH 20C,A03,093476,Briones; Jor-el Thomas Caparas,0,1,36,36
1656772214567,MATH 20C,B01,083762,Bach; Quang Tran,0,0,30,30
1656772220597,MATH 20D,A01,083765,Tran; Brian Kha,4,0,30,26
1656772220597,MATH 20D,A02,083766,Tran; Brian Kha,4,0,30,26
1656772220597,MATH 20D,A03,083767,Tran; Brian Kha,2,0,30,28
1656772226625,MATH 20E,A01,083771,Ganguly; Soumya,5,0,32,27
1656772226625,MATH 20E,A02,083772,Ganguly; Soumya,5,0,32,27
1656772226625,MATH 20E,B01,083773,Ciotti; Benjamin,18,0,35,17
1656772226625,MATH 20E,B02,083774,Ciotti; Benjamin,17,0,35,18
1656772232654,MATH 103A,A01,083777,Greenfeld; Be'Eri,2,0,36,34
1656772232654,MATH 103A,A02,083778,Greenfeld; Be'Eri,5,0,36,31
1656772232654,MATH 103A,A03,093561,Greenfeld; Be'Eri,4,0,36,32
1656772232654,MATH 103A,B01,083779,Greenfeld; Be'Eri,6,0,36,30
1656772232654,MATH 103A,B02,083780,Greenfeld; Be'Eri,2,0,36,34
1656772232654,MATH 103A,B03,093562,Greenfeld; Be'Eri,2,0,36,34
1656772238681,MATH 105,A01,085443,Carter; Anne Toulson,13,0,35,22
1656772238681,MATH 105,A02,093477,Carter; Anne Toulson,20,0,35,15
1656772244708,MATH 109,A01,083213,Ganzberger; Geoffrey Michael,2,0,34,32
1656772244708,MATH 109,A02,083214,Ganzberger; Geoffrey Michael,2,0,34,32
1656772244708,MATH 109,A03,093478,Ganzberger; Geoffrey Michael,1,0,34,33
1656772244708,MATH 109,B01,083215,Ganzberger; Geoffrey Michael,1,0,32,31
1656772244708,MATH 109,B02,083216,Ganzberger; Geoffrey Michael,1,0,32,31
1656772244708,MATH 109,B03,093479,Ganzberger; Geoffrey Michael,6,0,32,26
1656772250733,MATH 142A,A01,083219,Chow; Bennett,6,0,32,26
1656772250733,MATH 142A,A02,083220,Chow; Bennett,9,0,32,23
1656772250733,MATH 142A,A03,093480,Chow; Bennett,7,0,32,25
1656772250733,MATH 142A,B03,093481,Chow; Bennett,7,0,32,25
1656772250733,MATH 142A,B04,093558,Chow; Bennett,10,0,32,22
1656772250733,MATH 142A,B05,093559,Chow; Bennett,6,0,32,26
1656772256765,MATH 193A,A01,083224,Rotar; Vladimir,6,0,34,28
1656772256765,MATH 193A,A02,083225,Rotar; Vladimir,3,0,34,31
1656772256765,MATH 193A,A03,083781,Rotar; Vladimir,1,0,34,33
1656772256765,MATH 193A,A04,083782,Rotar; Vladimir,6,0,34,28
1656772256765,MATH 193A,A05,093482,Rotar; Vladimir,6,0,34,28
1656772262790,MATH 197,001,091859,McAuley; Julian John,9999,0,9999,0
1656772262790,MATH 197,002,095566,Kedlaya; Kiran S.,9997,0,9999,2
1656772262790,MATH 197,003,095567,Xiao; Ming,9999,0,9999,0
1656772262790,MATH 197,004,095571,Perols; Johan Lars,9998,0,9999,1
1656772269852,COGS 9,A01,083615,Shannon; Kyle Michael,6,0,75,69
1656772275885,COGS 11,A01,083617,Boyle; Mary E. T.,18,0,48,30
1656772281911,COGS 13,A01,083071,Bastos; Amalia Pinkusfeld,8,0,71,63
1656772287938,COGS 14A,A01,092681,Semenuks; Arturs,0,1,100,100
1656772293963,COGS 14B,A01,083073,Cheng; Tzu-Han,5,0,63,58
1656772299992,COGS 17,A01,092677,Semenuks; Arturs,4,0,81,77
1656772306018,COGS 100,A01,083619,Allen; Michael Gordon,15,0,70,55
1656772312042,COGS 101A,A01,083621,Davis; Joshua Daniel,9,0,68,59
1656772318065,COGS 101B,A01,091572,Allen; Michael Gordon,8,0,65,57
1656772324090,COGS 101C,A01,083625,Delgado; Tania,17,0,35,18
1656772330119,COGS 107A,A01,083627,Boyle; Mary E. T.,13,0,60,47
1656772336142,COGS 118A,A01,083075,Gupta; Anjum,15,0,76,61
1656772342175,CSE 3,A50,083646,Miranda; Gregory Joseph,22,0,50,28
1656772348204,CSE 8A,A50,083650,Miranda; Gregory Joseph,17,1,56,39
1656772354232,CSE 11,A01,083080,Cao; Yingjun,4,15,40,36
1656772360257,CSE 12,A01,083652,Krause-Levy; Sophia Louisa,20,1,120,100
1656772366287,CSE 15L,A01,083654,Morris; Justin Loren,8,0,50,42
1656772366287,CSE 15L,A02,083655,Morris; Justin Loren,8,0,50,42
1656772372313,CSE 20,A01,083657,Tran; Khoa Dang,37,0,80,43
1656772378339,CSE 21,A01,095574,Bach; Quang Tran,21,0,48,27
1656772384368,CSE 30,A01,083084,Eldon; John,4,0,80,76
1656772384368,CSE 30,B01,095061,Bhaskar; Nishant,5,0,50,45
1656772390397,CSE 100,A01,083659,Cao; Yingjun,1,4,70,69
1656772396423,CSE 134B,A01,083661,Powell; Thomas Allan,18,0,100,82
1656772402447,CSE 140,A01,083663,Gungor; Onat,14,0,85,71
1656772408469,CSE 140L,A01,083088,Eldon; John,16,0,100,84
1656772414499,CSE 175,A01,083665,Kumar; Rakesh,3,0,25,22
1656772420599,CSE 190,A00,092507,Dubnov; Shlomo,7,0,20,13
1656772426622,ECE 45,A01,083139,Congero; Spencer William,5,0,75,70
1656772432654,ECE 65,A50,083695,Saad; Andrew S,12,0,30,18
1656772432654,ECE 65,A51,095125,Saad; Andrew S,25,0,26,1
1656772438683,ECE 109,A01,091882,Touri; Behrouz,15,0,70,55
1656772444706,ECE 180,A00,083140,Abi Samra; Nicholas Camill,0,0,30,30
1656772444706,ECE 180,B00,083141,Abi Samra; Nicholas Camill,0,0,30,30
1656772450737,MATH 10A,A01,083735,Patchell; Gregory David,1,0,30,29
1656772450737,MATH 10A,A02,083736,Patchell; Gregory David,20,0,30,10
1656772450737,MATH 10A,A03,083737,Patchell; Gregory David,15,0,30,15
1656772456781,MATH 10B,A01,083207,Lim; Seonhee,7,0,34,27
1656772456781,MATH 10B,A02,083208,Lim; Seonhee,9,0,35,26
1656772456781,MATH 10B,A03,093472,Lim; Seonhee,4,0,34,30
1656772456781,MATH 10B,B01,083739,Sinha; Shubham,9,0,30,21
1656772462809,MATH 18,A01,083743,Cinel; Cameron Alexander,6,0,30,24
1656772462809,MATH 18,A02,083744,Cinel; Cameron Alexander,15,0,30,15
1656772462809,MATH 18,A03,083745,Cinel; Cameron Alexander,8,0,30,22
1656772462809,MATH 18,B01,083748,Rideout; David Porter,3,0,37,34
1656772462809,MATH 18,B02,083749,Rideout; David Porter,3,0,36,33
1656772462809,MATH 18,B03,083750,Rideout; David Porter,1,0,37,36
1656772462809,MATH 18,B04,083751,Rideout; David Porter,5,0,36,31
1656772462809,MATH 18,B05,093473,Rideout; David Porter,4,0,36,32
1656772462809,MATH 18,B06,093474,Rideout; David Porter,5,0,36,31
1656772468848,MATH 20A,A01,083754,Zheng; Zequn,12,0,40,28
1656772474875,MATH 20B,A01,083756,Briones; Jor-el Thomas Caparas,1,0,36,35
1656772474875,MATH 20B,A02,083757,Briones; Jor-el Thomas Caparas,1,0,36,35
1656772474875,MATH 20B,A03,093475,Briones; Jor-el Thomas Caparas,0,0,36,36
1656772480901,MATH 20C,A01,083760,Briones; Jor-el Thomas Caparas,1,0,35,34
1656772480901,MATH 20C,A02,083761,Briones; Jor-el Thomas Caparas,8,0,35,27
1656772480901,MATH 20C,A03,093476,Briones; Jor-el Thomas Caparas,0,1,36,36
1656772480901,MATH 20C,B01,083762,Bach; Quang Tran,0,0,30,30
1656772486926,MATH 20D,A01,083765,Tran; Brian Kha,4,0,30,26
1656772486926,MATH 20D,A02,083766,Tran; Brian Kha,4,0,30,26
1656772486926,MATH 20D,A03,083767,Tran; Brian Kha,2,0,30,28
1656772492953,MATH 20E,A01,083771,Ganguly; Soumya,5,0,32,27
1656772492953,MATH 20E,A02,083772,Ganguly; Soumya,5,0,32,27
1656772492953,MATH 20E,B01,083773,Ciotti; Benjamin,18,0,35,17
1656772492953,MATH 20E,B02,083774,Ciotti; Benjamin,17,0,35,18
1656772498981,MATH 103A,A01,083777,Greenfeld; Be'Eri,2,0,36,34
1656772498981,MATH 103A,A02,083778,Greenfeld; Be'Eri,5,0,36,31
1656772498981,MATH 103A,A03,093561,Greenfeld; Be'Eri,4,0,36,32
1656772498981,MATH 103A,B01,083779,Greenfeld; Be'Eri,6,0,36,30
1656772498981,MATH 103A,B02,083780,Greenfeld; Be'Eri,2,0,36,34
1656772498981,MATH 103A,B03,093562,Greenfeld; Be'Eri,2,0,36,34
1656772505005,MATH 105,A01,085443,Carter; Anne Toulson,13,0,35,22
1656772505005,MATH 105,A02,093477,Carter; Anne Toulson,20,0,35,15
1656772511031,MATH 109,A01,083213,Ganzberger; Geoffrey Michael,2,0,34,32
1656772511031,MATH 109,A02,083214,Ganzberger; Geoffrey Michael,2,0,34,32
1656772511031,MATH 109,A03,093478,Ganzberger; Geoffrey Michael,1,0,34,33
1656772511031,MATH 109,B01,083215,Ganzberger; Geoffrey Michael,1,0,32,31
1656772511031,MATH 109,B02,083216,Ganzberger; Geoffrey Michael,1,0,32,31
1656772511031,MATH 109,B03,093479,Ganzberger; Geoffrey Michael,6,0,32,26
1656772517056,MATH 142A,A01,083219,Chow; Bennett,6,0,32,26
1656772517056,MATH 142A,A02,083220,Chow; Bennett,9,0,32,23
1656772517056,MATH 142A,A03,093480,Chow; Bennett,7,0,32,25
1656772517056,MATH 142A,B03,093481,Chow; Bennett,7,0,32,25
1656772517056,MATH 142A,B04,093558,Chow; Bennett,10,0,32,22
1656772517056,MATH 142A,B05,093559,Chow; Bennett,6,0,32,26
1656772523081,MATH 193A,A01,083224,Rotar; Vladimir,6,0,34,28
1656772523081,MATH 193A,A02,083225,Rotar; Vladimir,3,0,34,31
1656772523081,MATH 193A,A03,083781,Rotar; Vladimir,1,0,34,33
1656772523081,MATH 193A,A04,083782,Rotar; Vladimir,6,0,34,28
1656772523081,MATH 193A,A05,093482,Rotar; Vladimir,6,0,34,28
1656772529108,MATH 197,001,091859,McAuley; Julian John,9999,0,9999,0
1656772529108,MATH 197,002,095566,Kedlaya; Kiran S.,9997,0,9999,2
1656772529108,MATH 197,003,095567,Xiao; Ming,9999,0,9999,0
1656772529108,MATH 197,004,095571,Perols; Johan Lars,9998,0,9999,1
1656772536176,COGS 9,A01,083615,Shannon; Kyle Michael,6,0,75,69
1656772542207,COGS 11,A01,083617,Boyle; Mary E. T.,18,0,48,30
1656772548238,COGS 13,A01,083071,Bastos; Amalia Pinkusfeld,8,0,71,63
1656772554263,COGS 14A,A01,092681,Semenuks; Arturs,0,1,100,100
1656772560299,COGS 14B,A01,083073,Cheng; Tzu-Han,5,0,63,58
1656772566325,COGS 17,A01,092677,Semenuks; Arturs,4,0,81,77
1656772572352,COGS 100,A01,083619,Allen; Michael Gordon,15,0,70,55
1656772578382,COGS 101A,A01,083621,Davis; Joshua Daniel,9,0,68,59
1656772584408,COGS 101B,A01,091572,Allen; Michael Gordon,8,0,65,57
1656772590433,COGS 101C,A01,083625,Delgado; Tania,17,0,35,18
1656772596467,COGS 107A,A01,083627,Boyle; Mary E. T.,13,0,60,47
1656772602493,COGS 118A,A01,083075,Gupta; Anjum,15,0,76,61
1656772608542,CSE 3,A50,083646,Miranda; Gregory Joseph,22,0,50,28
1656772614567,CSE 8A,A50,083650,Miranda; Gregory Joseph,17,1,56,39
1656772620590,CSE 11,A01,083080,Cao; Yingjun,4,15,40,36
1656772626626,CSE 12,A01,083652,Krause-Levy; Sophia Louisa,20,1,120,100
1656772632660,CSE 15L,A01,083654,Morris; Justin Loren,8,0,50,42
1656772632660,CSE 15L,A02,083655,Morris; Justin Loren,8,0,50,42
1656772638691,CSE 20,A01,083657,Tran; Khoa Dang,37,0,80,43
1656772644717,CSE 21,A01,095574,Bach; Quang Tran,21,0,48,27
1656772650745,CSE 30,A01,083084,Eldon; John,4,0,80,76
1656772650745,CSE 30,B01,095061,Bhaskar; Nishant,5,0,50,45
1656772656780,CSE 100,A01,083659,Cao; Yingjun,1,4,70,69
1656772662812,CSE 134B,A01,083661,Powell; Thomas Allan,18,0,100,82
1656772668841,CSE 140,A01,083663,Gungor; Onat,14,0,85,71
1656772674870,CSE 140L,A01,083088,Eldon; John,16,0,100,84
1656772680895,CSE 175,A01,083665,Kumar; Rakesh,3,0,25,22
1656772686920,CSE 190,A00,092507,Dubnov; Shlomo,7,0,20,13
1656772692948,ECE 45,A01,083139,Congero; Spencer William,5,0,75,70
1656772698976,ECE 65,A50,083695,Saad; Andrew S,12,0,30,18
1656772698976,ECE 65,A51,095125,Saad; Andrew S,25,0,26,1
1656772705001,ECE 109,A01,091882,Touri; Behrouz,15,0,70,55
1656772711025,ECE 180,A00,083140,Abi Samra; Nicholas Camill,0,0,30,30
1656772711025,ECE 180,B00,083141,Abi Samra; Nicholas Camill,0,0,30,30
1656772717052,MATH 10A,A01,083735,Patchell; Gregory David,1,0,30,29
1656772717052,MATH 10A,A02,083736,Patchell; Gregory David,20,0,30,10
1656772717052,MATH 10A,A03,083737,Patchell; Gregory David,15,0,30,15
1656772723085,MATH 10B,A01,083207,Lim; Seonhee,7,0,34,27
1656772723085,MATH 10B,A02,083208,Lim; Seonhee,9,0,35,26
1656772723085,MATH 10B,A03,093472,Lim; Seonhee,4,0,34,30
1656772723085,MATH 10B,B01,083739,Sinha; Shubham,9,0,30,21
1656772729131,MATH 18,A01,083743,Cinel; Cameron Alexander,6,0,30,24
1656772729131,MATH 18,A02,083744,Cinel; Cameron Alexander,15,0,30,15
1656772729131,MATH 18,A03,083745,Cinel; Cameron Alexander,8,0,30,22
1656772729131,MATH 18,B01,083748,Rideout; David Porter,3,0,37,34
1656772729131,MATH 18,B02,083749,Rideout; David Porter,3,0,36,33
1656772729131,MATH 18,B03,083750,Rideout; David Porter,1,0,37,36
1656772729131,MATH 18,B04,083751,Rideout; David Porter,5,0,36,31
1656772729131,MATH 18,B05,093473,Rideout; David Porter,4,0,36,32
1656772729131,MATH 18,B06,093474,Rideout; David Porter,5,0,36,31
1656772735166,MATH 20A,A01,083754,Zheng; Zequn,12,0,40,28
1656772741193,MATH 20B,A01,083756,Briones; Jor-el Thomas Caparas,1,0,36,35
1656772741193,MATH 20B,A02,083757,Briones; Jor-el Thomas Caparas,1,0,36,35
1656772741193,MATH 20B,A03,093475,Briones; Jor-el Thomas Caparas,0,0,36,36
1656772747224,MATH 20C,A01,083760,Briones; Jor-el Thomas Caparas,1,0,35,34
1656772747224,MATH 20C,A02,083761,Briones; Jor-el Thomas Caparas,8,0,35,27
1656772747224,MATH 20C,A03,093476,Briones; Jor-el Thomas Caparas,0,1,36,36
1656772747224,MATH 20C,B01,083762,Bach; Quang Tran,0,0,30,30
1656772753259,MATH 20D,A01,083765,Tran; Brian Kha,4,0,30,26
1656772753259,MATH 20D,A02,083766,Tran; Brian Kha,4,0,30,26
1656772753259,MATH 20D,A03,083767,Tran; Brian Kha,2,0,30,28
1656772759299,MATH 20E,A01,083771,Ganguly; Soumya,5,0,32,27
1656772759299,MATH 20E,A02,083772,Ganguly; Soumya,5,0,32,27
1656772759299,MATH 20E,B01,083773,Ciotti; Benjamin,18,0,35,17
1656772759299,MATH 20E,B02,083774,Ciotti; Benjamin,17,0,35,18
1656772765340,MATH 103A,A01,083777,Greenfeld; Be'Eri,2,0,36,34
1656772765340,MATH 103A,A02,083778,Greenfeld; Be'Eri,5,0,36,31
1656772765340,MATH 103A,A03,093561,Greenfeld; Be'Eri,4,0,36,32
1656772765340,MATH 103A,B01,083779,Greenfeld; Be'Eri,6,0,36,30
1656772765340,MATH 103A,B02,083780,Greenfeld; Be'Eri,2,0,36,34
1656772765340,MATH 103A,B03,093562,Greenfeld; Be'Eri,2,0,36,34
1656772771367,MATH 105,A01,085443,Carter; Anne Toulson,13,0,35,22
1656772771367,MATH 105,A02,093477,Carter; Anne Toulson,20,0,35,15
1656772777396,MATH 109,A01,083213,Ganzberger; Geoffrey Michael,2,0,34,32
1656772777396,MATH 109,A02,083214,Ganzberger; Geoffrey Michael,2,0,34,32
1656772777396,MATH 109,A03,093478,Ganzberger; Geoffrey Michael,1,0,34,33
1656772777396,MATH 109,B01,083215,Ganzberger; Geoffrey Michael,1,0,32,31
1656772777396,MATH 109,B02,083216,Ganzberger; Geoffrey Michael,1,0,32,31
1656772777396,MATH 109,B03,093479,Ganzberger; Geoffrey Michael,6,0,32,26
1656772783423,MATH 142A,A01,083219,Chow; Bennett,6,0,32,26
1656772783423,MATH 142A,A02,083220,Chow; Bennett,9,0,32,23
1656772783423,MATH 142A,A03,093480,Chow; Bennett,7,0,32,25
1656772783423,MATH 142A,B03,093481,Chow; Bennett,7,0,32,25
1656772783423,MATH 142A,B04,093558,Chow; Bennett,10,0,32,22
1656772783423,MATH 142A,B05,093559,Chow; Bennett,6,0,32,26
1656772789449,MATH 193A,A01,083224,Rotar; Vladimir,6,0,34,28
1656772789449,MATH 193A,A02,083225,Rotar; Vladimir,3,0,34,31
1656772789449,MATH 193A,A03,083781,Rotar; Vladimir,1,0,34,33
1656772789449,MATH 193A,A04,083782,Rotar; Vladimir,6,0,34,28
1656772789449,MATH 193A,A05,093482,Rotar; Vladimir,6,0,34,28
1656772795487,MATH 197,001,091859,McAuley; Julian John,9999,0,9999,0
1656772795487,MATH 197,002,095566,Kedlaya; Kiran S.,9997,0,9999,2
1656772795487,MATH 197,003,095567,Xiao; Ming,9999,0,9999,0
1656772795487,MATH 197,004,095571,Perols; Johan Lars,9998,0,9999,1
1656772802576,COGS 9,A01,083615,Shannon; Kyle Michael,6,0,75,69
1656772808606,COGS 11,A01,083617,Boyle; Mary E. T.,18,0,48,30
1656772814641,COGS 13,A01,083071,Bastos; Amalia Pinkusfeld,8,0,71,63
1656772820668,COGS 14A,A01,092681,Semenuks; Arturs,0,1,100,100
1656772826692,COGS 14B,A01,083073,Cheng; Tzu-Han,5,0,63,58
1656772832716,COGS 17,A01,092677,Semenuks; Arturs,4,0,81,77
1656772838739,COGS 100,A01,083619,Allen; Michael Gordon,15,0,70,55
1656772844771,COGS 101A,A01,083621,Davis; Joshua Daniel,9,0,68,59
1656772850795,COGS 101B,A01,091572,Allen; Michael Gordon,8,0,65,57
1656772856828,COGS 101C,A01,083625,Delgado; Tania,17,0,35,18
1656772862852,COGS 107A,A01,083627,Boyle; Mary E. T.,13,0,60,47
1656772868881,COGS 118A,A01,083075,Gupta; Anjum,15,0,76,61
1656772874916,CSE 3,A50,083646,Miranda; Gregory Joseph,22,0,50,28
1656772880941,CSE 8A,A50,083650,Miranda; Gregory Joseph,17,1,56,39
1656772886966,CSE 11,A01,083080,Cao; Yingjun,4,15,40,36
1656772892993,CSE 12,A01,083652,Krause-Levy; Sophia Louisa,20,1,120,100
1656772899025,CSE 15L,A01,083654,Morris; Justin Loren,8,0,50,42
1656772899025,CSE 15L,A02,083655,Morris; Justin Loren,8,0,50,42
1656772905049,CSE 20,A01,083657,Tran; Khoa Dang,37,0,80,43
1656772911073,CSE 21,A01,095574,Bach; Quang Tran,21,0,48,27
1656772917099,CSE 30,A01,083084,Eldon; John,4,0,80,76
1656772917099,CSE 30,B01,095061,Bhaskar; Nishant,5,0,50,45
1656772923132,CSE 100,A01,083659,Cao; Yingjun,1,4,70,69
1656772929157,CSE 134B,A01,083661,Powell; Thomas Allan,18,0,100,82
1656772935182,CSE 140,A01,083663,Gungor; Onat,14,0,85,71
1656772941211,CSE 140L,A01,083088,Eldon; John,16,0,100,84
1656772947237,CSE 175,A01,083665,Kumar; Rakesh,3,0,25,22
1656772953265,CSE 190,A00,092507,Dubnov; Shlomo,7,0,20,13
1656772959296,ECE 45,A01,083139,Congero; Spencer William,5,0,75,70
1656772965325,ECE 65,A50,083695,Saad; Andrew S,12,0,30,18
1656772965325,ECE 65,A51,095125,Saad; Andrew S,25,0,26,1
1656772971355,ECE 109,A01,091882,Touri; Behrouz,15,0,70,55
1656772977381,ECE 180,A00,083140,Abi Samra; Nicholas Camill,0,0,30,30
1656772977381,ECE 180,B00,083141,Abi Samra; Nicholas Camill,0,0,30,30
1656772983420,MATH 10A,A01,083735,Patchell; Gregory David,1,0,30,29
1656772983420,MATH 10A,A02,083736,Patchell; Gregory David,20,0,30,10
1656772983420,MATH 10A,A03,083737,Patchell; Gregory David,15,0,30,15
1656772989446,MATH 10B,A01,083207,Lim; Seonhee,7,0,34,27
1656772989446,MATH 10B,A02,083208,Lim; Seonhee,9,0,35,26
1656772989446,MATH 10B,A03,093472,Lim; Seonhee,4,0,34,30
1656772989446,MATH 10B,B01,083739,Sinha; Shubham,9,0,30,21
1656772995489,MATH 18,A01,083743,Cinel; Cameron Alexander,6,0,30,24
1656772995489,MATH 18,A02,083744,Cinel; Cameron Alexander,15,0,30,15
1656772995489,MATH 18,A03,083745,Cinel; Cameron Alexander,8,0,30,22
1656772995489,MATH 18,B01,083748,Rideout; David Porter,3,0,37,34
1656772995489,MATH 18,B02,083749,Rideout; David Porter,3,0,36,33
1656772995489,MATH 18,B03,083750,Rideout; David Porter,1,0,37,36
1656772995489,MATH 18,B04,083751,Rideout; David Porter,5,0,36,31
1656772995489,MATH 18,B05,093473,Rideout; David Porter,4,0,36,32
1656772995489,MATH 18,B06,093474,Rideout; David Porter,5,0,36,31
1656773001513,MATH 20A,A01,083754,Zheng; Zequn,12,0,40,28
1656773007545,MATH 20B,A01,083756,Briones; Jor-el Thomas Caparas,1,0,36,35
1656773007545,MATH 20B,A02,083757,Briones; Jor-el Thomas Caparas,1,0,36,35
1656773007545,MATH 20B,A03,093475,Briones; Jor-el Thomas Caparas,0,0,36,36
1656773013571,MATH 20C,A01,083760,Briones; Jor-el Thomas Caparas,1,0,35,34
1656773013571,MATH 20C,A02,083761,Briones; Jor-el Thomas Caparas,8,0,35,27
1656773013571,MATH 20C,A03,093476,Briones; Jor-el Thomas Caparas,0,1,36,36
1656773013571,MATH 20C,B01,083762,Bach; Quang Tran,0,0,30,30
1656773019671,MATH 20D,A01,083765,Tran; Brian Kha,4,0,30,26
1656773019671,MATH 20D,A02,083766,Tran; Brian Kha,4,0,30,26
1656773019671,MATH 20D,A03,083767,Tran; Brian Kha,2,0,30,28
1656773025708,MATH 20E,A01,083771,Ganguly; Soumya,5,0,32,27
1656773025708,MATH 20E,A02,083772,Ganguly; Soumya,5,0,32,27
1656773025708,MATH 20E,B01,083773,Ciotti; Benjamin,18,0,35,17
1656773025708,MATH 20E,B02,083774,Ciotti; Benjamin,17,0,35,18
1656773031742,MATH 103A,A01,083777,Greenfeld; Be'Eri,2,0,36,34
1656773031742,MATH 103A,A02,083778,Greenfeld; Be'Eri,5,0,36,31
1656773031742,MATH 103A,A03,093561,Greenfeld; Be'Eri,4,0,36,32
1656773031742,MATH 103A,B01,083779,Greenfeld; Be'Eri,6,0,36,30
1656773031742,MATH 103A,B02,083780,Greenfeld; Be'Eri,2,0,36,34
1656773031742,MATH 103A,B03,093562,Greenfeld; Be'Eri,2,0,36,34
1656773037765,MATH 105,A01,085443,Carter; Anne Toulson,13,0,35,22
1656773037765,MATH 105,A02,093477,Carter; Anne Toulson,20,0,35,15
1656773043790,MATH 109,A01,083213,Ganzberger; Geoffrey Michael,2,0,34,32
1656773043790,MATH 109,A02,083214,Ganzberger; Geoffrey Michael,2,0,34,32
1656773043790,MATH 109,A03,093478,Ganzberger; Geoffrey Michael,1,0,34,33
1656773043790,MATH 109,B01,083215,Ganzberger; Geoffrey Michael,1,0,32,31
1656773043790,MATH 109,B02,083216,Ganzberger; Geoffrey Michael,1,0,32,31
1656773043790,MATH 109,B03,093479,Ganzberger; Geoffrey Michael,6,0,32,26
1656773049824,MATH 142A,A01,083219,Chow; Bennett,6,0,32,26
1656773049824,MATH 142A,A02,083220,Chow; Bennett,9,0,32,23
1656773049824,MATH 142A,A03,093480,Chow; Bennett,7,0,32,25
1656773049824,MATH 142A,B03,093481,Chow; Bennett,7,0,32,25
1656773049824,MATH 142A,B04,093558,Chow; Bennett,10,0,32,22
1656773049824,MATH 142A,B05,093559,Chow; Bennett,6,0,32,26
1656773055849,MATH 193A,A01,083224,Rotar; Vladimir,6,0,34,28
1656773055849,MATH 193A,A02,083225,Rotar; Vladimir,3,0,34,31
1656773055849,MATH 193A,A03,083781,Rotar; Vladimir,1,0,34,33
1656773055849,MATH 193A,A04,083782,Rotar; Vladimir,6,0,34,28
1656773055849,MATH 193A,A05,093482,Rotar; Vladimir,6,0,34,28
1656773061876,MATH 197,001,091859,McAuley; Julian John,9999,0,9999,0
1656773061876,MATH 197,002,095566,Kedlaya; Kiran S.,9997,0,9999,2
1656773061876,MATH 197,003,095567,Xiao; Ming,9999,0,9999,0
1656773061876,MATH 197,004,095571,Perols; Johan Lars,9998,0,9999,1
1656773068938,COGS 9,A01,083615,Shannon; Kyle Michael,6,0,75,69
1656773074963,COGS 11,A01,083617,Boyle; Mary E. T.,18,0,48,30
1656773080993,COGS 13,A01,083071,Bastos; Amalia Pinkusfeld,8,0,71,63
1656773087025,COGS 14A,A01,092681,Semenuks; Arturs,0,1,100,100
1656773093054,COGS 14B,A01,083073,Cheng; Tzu-Han,5,0,63,58
1656773099079,COGS 17,A01,092677,Semenuks; Arturs,4,0,81,77
1656773105104,COGS 100,A01,083619,Allen; Michael Gordon,15,0,70,55
1656773111127,COGS 101A,A01,083621,Davis; Joshua Daniel,9,0,68,59
1656773117158,COGS 101B,A01,091572,Allen; Michael Gordon,8,0,65,57
1656773123188,COGS 101C,A01,083625,Delgado; Tania,17,0,35,18
1656773129217,COGS 107A,A01,083627,Boyle; Mary E. T.,13,0,60,47
1656773135247,COGS 118A,A01,083075,Gupta; Anjum,15,0,76,61
1656773141283,CSE 3,A50,083646,Miranda; Gregory Joseph,22,0,50,28
1656773147314,CSE 8A,A50,083650,Miranda; Gregory Joseph,17,1,56,39
1656773153343,CSE 11,A01,083080,Cao; Yingjun,4,15,40,36
1656773159374,CSE 12,A01,083652,Krause-Levy; Sophia Louisa,20,1,120,100
1656773165398,CSE 15L,A01,083654,Morris; Justin Loren,8,0,50,42
1656773165398,CSE 15L,A02,083655,Morris; Justin Loren,8,0,50,42
1656773171427,CSE 20,A01,083657,Tran; Khoa Dang,37,0,80,43
1656773177452,CSE 21,A01,095574,Bach; Quang Tran,21,0,48,27
1656773183486,CSE 30,A01,083084,Eldon; John,4,0,80,76
1656773183486,CSE 30,B01,095061,Bhaskar; Nishant,5,0,50,45
1656773189516,CSE 100,A01,083659,Cao; Yingjun,1,4,70,69
1656773195540,CSE 134B,A01,083661,Powell; Thomas Allan,18,0,100,82
1656773201568,CSE 140,A01,083663,Gungor; Onat,14,0,85,71
1656773207595,CSE 140L,A01,083088,Eldon; John,16,0,100,84
1656773213626,CSE 175,A01,083665,Kumar; Rakesh,3,0,25,22
1656773219659,CSE 190,A00,092507,Dubnov; Shlomo,7,0,20,13
1656773225687,ECE 45,A01,083139,Congero; Spencer William,5,0,75,70
1656773231720,ECE 65,A50,083695,Saad; Andrew S,12,0,30,18
1656773231720,ECE 65,A51,095125,Saad; Andrew S,25,0,26,1
1656773237746,ECE 109,A01,091882,Touri; Behrouz,15,0,70,55
1656773243781,ECE 180,A00,083140,Abi Samra; Nicholas Camill,0,0,30,30
1656773243781,ECE 180,B00,083141,Abi Samra; Nicholas Camill,0,0,30,30
1656773249807,MATH 10A,A01,083735,Patchell; Gregory David,1,0,30,29
1656773249807,MATH 10A,A02,083736,Patchell; Gregory David,20,0,30,10
1656773249807,MATH 10A,A03,083737,Patchell; Gregory David,15,0,30,15
1656773255835,MATH 10B,A01,083207,Lim; Seonhee,7,0,34,27
1656773255835,MATH 10B,A02,083208,Lim; Seonhee,9,0,35,26
1656773255835,MATH 10B,A03,093472,Lim; Seonhee,4,0,34,30
1656773255835,MATH 10B,B01,083739,Sinha; Shubham,9,0,30,21
1656773261872,MATH 18,A01,083743,Cinel; Cameron Alexander,6,0,30,24
1656773261872,MATH 18,A02,083744,Cinel; Cameron Alexander,15,0,30,15
1656773261872,MATH 18,A03,083745,Cinel; Cameron Alexander,8,0,30,22
1656773261872,MATH 18,B01,083748,Rideout; David Porter,3,0,37,34
1656773261872,MATH 18,B02,083749,Rideout; David Porter,3,0,36,33
1656773261872,MATH 18,B03,083750,Rideout; David Porter,1,0,37,36
1656773261872,MATH 18,B04,083751,Rideout; David Porter,5,0,36,31
1656773261872,MATH 18,B05,093473,Rideout; David Porter,4,0,36,32
1656773261872,MATH 18,B06,093474,Rideout; David Porter,5,0,36,31
1656773267900,MATH 20A,A01,083754,Zheng; Zequn,12,0,40,28
1656773273931,MATH 20B,A01,083756,Briones; Jor-el Thomas Caparas,1,0,36,35
1656773273931,MATH 20B,A02,083757,Briones; Jor-el Thomas Caparas,1,0,36,35
1656773273931,MATH 20B,A03,093475,Briones; Jor-el Thomas Caparas,0,0,36,36
1656773279961,MATH 20C,A01,083760,Briones; Jor-el Thomas Caparas,1,0,35,34
1656773279961,MATH 20C,A02,083761,Briones; Jor-el Thomas Caparas,8,0,35,27
1656773279961,MATH 20C,A03,093476,Briones; Jor-el Thomas Caparas,0,1,36,36
1656773279961,MATH 20C,B01,083762,Bach; Quang Tran,0,0,30,30
1656773285993,MATH 20D,A01,083765,Tran; Brian Kha,4,0,30,26
1656773285993,MATH 20D,A02,083766,Tran; Brian Kha,4,0,30,26
1656773285993,MATH 20D,A03,083767,Tran; Brian Kha,2,0,30,28
1656773292030,MATH 20E,A01,083771,Ganguly; Soumya,5,0,32,27
1656773292030,MATH 20E,A02,083772,Ganguly; Soumya,5,0,32,27
1656773292030,MATH 20E,B01,083773,Ciotti; Benjamin,18,0,35,17
1656773292030,MATH 20E,B02,083774,Ciotti; Benjamin,17,0,35,18
1656773298055,MATH 103A,A01,083777,Greenfeld; Be'Eri,2,0,36,34
1656773298055,MATH 103A,A02,083778,Greenfeld; Be'Eri,5,0,36,31
1656773298055,MATH 103A,A03,093561,Greenfeld; Be'Eri,4,0,36,32
1656773298055,MATH 103A,B01,083779,Greenfeld; Be'Eri,6,0,36,30
1656773298055,MATH 103A,B02,083780,Greenfeld; Be'Eri,2,0,36,34
1656773298055,MATH 103A,B03,093562,Greenfeld; Be'Eri,2,0,36,34
1656773304087,MATH 105,A01,085443,Carter; Anne Toulson,13,0,35,22
1656773304087,MATH 105,A02,093477,Carter; Anne Toulson,20,0,35,15
1656773310113,MATH 109,A01,083213,Ganzberger; Geoffrey Michael,2,0,34,32
1656773310113,MATH 109,A02,083214,Ganzberger; Geoffrey Michael,2,0,34,32
1656773310113,MATH 109,A03,093478,Ganzberger; Geoffrey Michael,1,0,34,33
1656773310113,MATH 109,B01,083215,Ganzberger; Geoffrey Michael,1,0,32,31
1656773310113,MATH 109,B02,083216,Ganzberger; Geoffrey Michael,1,0,32,31
1656773310113,MATH 109,B03,093479,Ganzberger; Geoffrey Michael,6,0,32,26
1656773316144,MATH 142A,A01,083219,Chow; Bennett,6,0,32,26
1656773316144,MATH 142A,A02,083220,Chow; Bennett,9,0,32,23
1656773316144,MATH 142A,A03,093480,Chow; Bennett,7,0,32,25
1656773316144,MATH 142A,B03,093481,Chow; Bennett,7,0,32,25
1656773316144,MATH 142A,B04,093558,Chow; Bennett,10,0,32,22
1656773316144,MATH 142A,B05,093559,Chow; Bennett,6,0,32,26
1656773322178,MATH 193A,A01,083224,Rotar; Vladimir,6,0,34,28
1656773322178,MATH 193A,A02,083225,Rotar; Vladimir,3,0,34,31
1656773322178,MATH 193A,A03,083781,Rotar; Vladimir,1,0,34,33
1656773322178,MATH 193A,A04,083782,Rotar; Vladimir,6,0,34,28
1656773322178,MATH 193A,A05,093482,Rotar; Vladimir,6,0,34,28
1656773328204,MATH 197,001,091859,McAuley; Julian John,9999,0,9999,0
1656773328204,MATH 197,002,095566,Kedlaya; Kiran S.,9997,0,9999,2
1656773328204,MATH 197,003,095567,Xiao; Ming,9999,0,9999,0
1656773328204,MATH 197,004,095571,Perols; Johan Lars,9998,0,9999,1
1656773335283,COGS 9,A01,083615,Shannon; Kyle Michael,6,0,75,69
1656773341309,COGS 11,A01,083617,Boyle; Mary E. T.,18,0,48,30
1656773347335,COGS 13,A01,083071,Bastos; Amalia Pinkusfeld,8,0,71,63
1656773353359,COGS 14A,A01,092681,Semenuks; Arturs,0,1,100,100
1656773359385,COGS 14B,A01,083073,Cheng; Tzu-Han,5,0,63,58
1656773365409,COGS 17,A01,092677,Semenuks; Arturs,4,0,81,77
1656773371435,COGS 100,A01,083619,Allen; Michael Gordon,15,0,70,55
1656773377459,COGS 101A,A01,083621,Davis; Joshua Daniel,9,0,68,59
1656773383487,COGS 101B,A01,091572,Allen; Michael Gordon,8,0,65,57
1656773389512,COGS 101C,A01,083625,Delgado; Tania,17,0,35,18
1656773395537,COGS 107A,A01,083627,Boyle; Mary E. T.,13,0,60,47
1656773401563,COGS 118A,A01,083075,Gupta; Anjum,15,0,76,61
1656773407590,CSE 3,A50,083646,Miranda; Gregory Joseph,22,0,50,28
1656773413619,CSE 8A,A50,083650,Miranda; Gregory Joseph,17,1,56,39
1656773419647,CSE 11,A01,083080,Cao; Yingjun,4,15,40,36
1656773425679,CSE 12,A01,083652,Krause-Levy; Sophia Louisa,20,1,120,100
1656773431711,CSE 15L,A01,083654,Morris; Justin Loren,8,0,50,42
1656773431711,CSE 15L,A02,083655,Morris; Justin Loren,8,0,50,42
1656773437735,CSE 20,A01,083657,Tran; Khoa Dang,37,0,80,43
1656773443762,CSE 21,A01,095574,Bach; Quang Tran,21,0,48,27
1656773449788,CSE 30,A01,083084,Eldon; John,4,0,80,76
1656773449788,CSE 30,B01,095061,Bhaskar; Nishant,5,0,50,45
1656773455811,CSE 100,A01,083659,Cao; Yingjun,1,4,70,69
1656773461834,CSE 134B,A01,083661,Powell; Thomas Allan,18,0,100,82
1656773467858,CSE 140,A01,083663,Gungor; Onat,14,0,85,71
1656773473885,CSE 140L,A01,083088,Eldon; John,16,0,100,84
1656773479913,CSE 175,A01,083665,Kumar; Rakesh,3,0,25,22
1656773485943,CSE 190,A00,092507,Dubnov; Shlomo,7,0,20,13
1656773491970,ECE 45,A01,083139,Congero; Spencer William,5,0,75,70
1656773498003,ECE 65,A50,083695,Saad; Andrew S,12,0,30,18
1656773498003,ECE 65,A51,095125,Saad; Andrew S,25,0,26,1
1656773504035,ECE 109,A01,091882,Touri; Behrouz,15,0,70,55
1656773510062,ECE 180,A00,083140,Abi Samra; Nicholas Camill,0,0,30,30
1656773510062,ECE 180,B00,083141,Abi Samra; Nicholas Camill,0,0,30,30
1656773516090,MATH 10A,A01,083735,Patchell; Gregory David,1,0,30,29
1656773516090,MATH 10A,A02,083736,Patchell; Gregory David,20,0,30,10
1656773516090,MATH 10A,A03,083737,Patchell; Gregory David,15,0,30,15
1656773522119,MATH 10B,A01,083207,Lim; Seonhee,7,0,34,27
1656773522119,MATH 10B,A02,083208,Lim; Seonhee,9,0,35,26
1656773522119,MATH 10B,A03,093472,Lim; Seonhee,4,0,34,30
1656773522119,MATH 10B,B01,083739,Sinha; Shubham,9,0,30,21
1656773528156,MATH 18,A01,083743,Cinel; Cameron Alexander,6,0,30,24
1656773528156,MATH 18,A02,083744,Cinel; Cameron Alexander,15,0,30,15
1656773528156,MATH 18,A03,083745,Cinel; Cameron Alexander,8,0,30,22
1656773528156,MATH 18,B01,083748,Rideout; David Porter,3,0,37,34
1656773528156,MATH 18,B02,083749,Rideout; David Porter,3,0,36,33
1656773528156,MATH 18,B03,083750,Rideout; David Porter,1,0,37,36
1656773528156,MATH 18,B04,083751,Rideout; David Porter,5,0,36,31
1656773528156,MATH 18,B05,093473,Rideout; David Porter,4,0,36,32
1656773528156,MATH 18,B06,093474,Rideout; David Porter,5,0,36,31
1656773534181,MATH 20A,A01,083754,Zheng; Zequn,12,0,40,28
1656773540207,MATH 20B,A01,083756,Briones; Jor-el Thomas Caparas,1,0,36,35
1656773540207,MATH 20B,A02,083757,Briones; Jor-el Thomas Caparas,1,0,36,35
1656773540207,MATH 20B,A03,093475,Briones; Jor-el Thomas Caparas,0,0,36,36
1656773546244,MATH 20C,A01,083760,Briones; Jor-el Thomas Caparas,1,0,35,34
1656773546244,MATH 20C,A02,083761,Briones; Jor-el Thomas Caparas,8,0,35,27
1656773546244,MATH 20C,A03,093476,Briones; Jor-el Thomas Caparas,0,1,36,36
1656773546244,MATH 20C,B01,083762,Bach; Quang Tran,0,0,30,30
1656773552276,MATH 20D,A01,083765,Tran; Brian Kha,4,0,30,26
1656773552276,MATH 20D,A02,083766,Tran; Brian Kha,4,0,30,26
1656773552276,MATH 20D,A03,083767,Tran; Brian Kha,2,0,30,28
1656773558303,MATH 20E,A01,083771,Ganguly; Soumya,5,0,32,27
1656773558303,MATH 20E,A02,083772,Ganguly; Soumya,5,0,32,27
1656773558303,MATH 20E,B01,083773,Ciotti; Benjamin,18,0,35,17
1656773558303,MATH 20E,B02,083774,Ciotti; Benjamin,17,0,35,18
1656773564329,MATH 103A,A01,083777,Greenfeld; Be'Eri,2,0,36,34
1656773564329,MATH 103A,A02,083778,Greenfeld; Be'Eri,5,0,36,31
1656773564329,MATH 103A,A03,093561,Greenfeld; Be'Eri,4,0,36,32
1656773564329,MATH 103A,B01,083779,Greenfeld; Be'Eri,6,0,36,30
1656773564329,MATH 103A,B02,083780,Greenfeld; Be'Eri,2,0,36,34
1656773564329,MATH 103A,B03,093562,Greenfeld; Be'Eri,2,0,36,34
1656773570354,MATH 105,A01,085443,Carter; Anne Toulson,13,0,35,22
1656773570354,MATH 105,A02,093477,Carter; Anne Toulson,20,0,35,15
1656773576398,MATH 109,A01,083213,Ganzberger; Geoffrey Michael,2,0,34,32
1656773576398,MATH 109,A02,083214,Ganzberger; Geoffrey Michael,2,0,34,32
1656773576398,MATH 109,A03,093478,Ganzberger; Geoffrey Michael,1,0,34,33
1656773576398,MATH 109,B01,083215,Ganzberger; Geoffrey Michael,1,0,32,31
1656773576398,MATH 109,B02,083216,Ganzberger; Geoffrey Michael,1,0,32,31
1656773576398,MATH 109,B03,093479,Ganzberger; Geoffrey Michael,6,0,32,26
1656773582425,MATH 142A,A01,083219,Chow; Bennett,6,0,32,26
1656773582425,MATH 142A,A02,083220,Chow; Bennett,9,0,32,23
1656773582425,MATH 142A,A03,093480,Chow; Bennett,7,0,32,25
1656773582425,MATH 142A,B03,093481,Chow; Bennett,7,0,32,25
1656773582425,MATH 142A,B04,093558,Chow; Bennett,10,0,32,22
1656773582425,MATH 142A,B05,093559,Chow; Bennett,6,0,32,26
1656773588449,MATH 193A,A01,083224,Rotar; Vladimir,6,0,34,28
1656773588449,MATH 193A,A02,083225,Rotar; Vladimir,3,0,34,31
1656773588449,MATH 193A,A03,083781,Rotar; Vladimir,1,0,34,33
1656773588449,MATH 193A,A04,083782,Rotar; Vladimir,6,0,34,28
1656773588449,MATH 193A,A05,093482,Rotar; Vladimir,6,0,34,28
1656773594474,MATH 197,001,091859,McAuley; Julian John,9999,0,9999,0
1656773594474,MATH 197,002,095566,Kedlaya; Kiran S.,9997,0,9999,2
1656773594474,MATH 197,003,095567,Xiao; Ming,9999,0,9999,0
1656773594474,MATH 197,004,095571,Perols; Johan Lars,9998,0,9999,1
1656773601533,COGS 9,A01,083615,Shannon; Kyle Michael,6,0,75,69
1656773607556,COGS 11,A01,083617,Boyle; Mary E. T.,18,0,48,30
1656773613679,COGS 13,A01,083071,Bastos; Amalia Pinkusfeld,8,0,71,63
1656773619705,COGS 14A,A01,092681,Semenuks; Arturs,0,1,100,100
1656773625733,COGS 14B,A01,083073,Cheng; Tzu-Han,5,0,63,58
1656773631762,COGS 17,A01,092677,Semenuks; Arturs,4,0,81,77
1656773637791,COGS 100,A01,083619,Allen; Michael Gordon,15,0,70,55
1656773643816,COGS 101A,A01,083621,Davis; Joshua Daniel,9,0,68,59
1656773649838,COGS 101B,A01,091572,Allen; Michael Gordon,8,0,65,57
1656773655864,COGS 101C,A01,083625,Delgado; Tania,17,0,35,18
1656773661887,COGS 107A,A01,083627,Boyle; Mary E. T.,13,0,60,47
1656773667914,COGS 118A,A01,083075,Gupta; Anjum,15,0,76,61
1656773673940,CSE 3,A50,083646,Miranda; Gregory Joseph,22,0,50,28
1656773679970,CSE 8A,A50,083650,Miranda; Gregory Joseph,17,1,56,39
1656773685998,CSE 11,A01,083080,Cao; Yingjun,4,15,40,36
1656773692023,CSE 12,A01,083652,Krause-Levy; Sophia Louisa,20,1,120,100
1656773698047,CSE 15L,A01,083654,Morris; Justin Loren,8,0,50,42
1656773698047,CSE 15L,A02,083655,Morris; Justin Loren,8,0,50,42
1656773704073,CSE 20,A01,083657,Tran; Khoa Dang,37,0,80,43
1656773710096,CSE 21,A01,095574,Bach; Quang Tran,21,0,48,27
1656773716124,CSE 30,A01,083084,Eldon; John,4,0,80,76
1656773716124,CSE 30,B01,095061,Bhaskar; Nishant,5,0,50,45
1656773722153,CSE 100,A01,083659,Cao; Yingjun,1,4,70,69
1656773728180,CSE 134B,A01,083661,Powell; Thomas Allan,18,0,100,82
1656773734205,CSE 140,A01,083663,Gungor; Onat,14,0,85,71
1656773740229,CSE 140L,A01,083088,Eldon; John,16,0,100,84
1656773746259,CSE 175,A01,083665,Kumar; Rakesh,3,0,25,22
1656773752285,CSE 190,A00,092507,Dubnov; Shlomo,7,0,20,13
1656773758325,ECE 45,A01,083139,Congero; Spencer William,5,0,75,70
1656773764352,ECE 65,A50,083695,Saad; Andrew S,12,0,30,18
1656773764352,ECE 65,A51,095125,Saad; Andrew S,25,0,26,1
1656773770378,ECE 109,A01,091882,Touri; Behrouz,15,0,70,55
1656773776403,ECE 180,A00,083140,Abi Samra; Nicholas Camill,0,0,30,30
1656773776403,ECE 180,B00,083141,Abi Samra; Nicholas Camill,0,0,30,30
1656773782431,MATH 10A,A01,083735,Patchell; Gregory David,1,0,30,29
1656773782431,MATH 10A,A02,083736,Patchell; Gregory David,20,0,30,10
1656773782431,MATH 10A,A03,083737,Patchell; Gregory David,15,0,30,15
1656773788459,MATH 10B,A01,083207,Lim; Seonhee,7,0,34,27
1656773788459,MATH 10B,A02,083208,Lim; Seonhee,9,0,35,26
1656773788459,MATH 10B,A03,093472,Lim; Seonhee,4,0,34,30
1656773788459,MATH 10B,B01,083739,Sinha; Shubham,9,0,30,21
1656773794487,MATH 18,A01,083743,Cinel; Cameron Alexander,6,0,30,24
1656773794487,MATH 18,A02,083744,Cinel; Cameron Alexander,15,0,30,15
1656773794487,MATH 18,A03,083745,Cinel; Cameron Alexander,8,0,30,22
1656773794487,MATH 18,B01,083748,Rideout; David Porter,3,0,37,34
1656773794487,MATH 18,B02,083749,Rideout; David Porter,3,0,36,33
1656773794487,MATH 18,B03,083750,Rideout; David Porter,1,0,37,36
1656773794487,MATH 18,B04,083751,Rideout; David Porter,5,0,36,31
1656773794487,MATH 18,B05,093473,Rideout; David Porter,4,0,36,32
1656773794487,MATH 18,B06,093474,Rideout; David Porter,5,0,36,31
1656773800513,MATH 20A,A01,083754,Zheng; Zequn,12,0,40,28
1656773806541,MATH 20B,A01,083756,Briones; Jor-el Thomas Caparas,1,0,36,35
1656773806541,MATH 20B,A02,083757,Briones; Jor-el Thomas Caparas,1,0,36,35
1656773806541,MATH 20B,A03,093475,Briones; Jor-el Thomas Caparas,0,0,36,36
1656773812567,MATH 20C,A01,083760,Briones; Jor-el Thomas Caparas,1,0,35,34
1656773812567,MATH 20C,A02,083761,Briones; Jor-el Thomas Caparas,8,0,35,27
1656773812567,MATH 20C,A03,093476,Briones; Jor-el Thomas Caparas,0,1,36,36
1656773812567,MATH 20C,B01,083762,Bach; Quang Tran,0,0,30,30
1656773818598,MATH 20D,A01,083765,Tran; Brian Kha,4,0,30,26
1656773818598,MATH 20D,A02,083766,Tran; Brian Kha,4,0,30,26
1656773818598,MATH 20D,A03,083767,Tran; Brian Kha,2,0,30,28
1656773824623,MATH 20E,A01,083771,Ganguly; Soumya,5,0,32,27
1656773824623,MATH 20E,A02,083772,Ganguly; Soumya,5,0,32,27
1656773824623,MATH 20E,B01,083773,Ciotti; Benjamin,18,0,35,17
1656773824623,MATH 20E,B02,083774,Ciotti; Benjamin,17,0,35,18
1656773830649,MATH 103A,A01,083777,Greenfeld; Be'Eri,2,0,36,34
1656773830649,MATH 103A,A02,083778,Greenfeld; Be'Eri,5,0,36,31
1656773830649,MATH 103A,A03,093561,Greenfeld; Be'Eri,4,0,36,32
1656773830649,MATH 103A,B01,083779,Greenfeld; Be'Eri,6,0,36,30
1656773830649,MATH 103A,B02,083780,Greenfeld; Be'Eri,2,0,36,34
1656773830649,MATH 103A,B03,093562,Greenfeld; Be'Eri,2,0,36,34
1656773836678,MATH 105,A01,085443,Carter; Anne Toulson,13,0,35,22
1656773836678,MATH 105,A02,093477,Carter; Anne Toulson,20,0,35,15
1656773842705,MATH 109,A01,083213,Ganzberger; Geoffrey Michael,2,0,34,32
1656773842705,MATH 109,A02,083214,Ganzberger; Geoffrey Michael,2,0,34,32
1656773842705,MATH 109,A03,093478,Ganzberger; Geoffrey Michael,1,0,34,33
1656773842705,MATH 109,B01,083215,Ganzberger; Geoffrey Michael,1,0,32,31
1656773842705,MATH 109,B02,083216,Ganzberger; Geoffrey Michael,1,0,32,31
1656773842705,MATH 109,B03,093479,Ganzberger; Geoffrey Michael,6,0,32,26
1656773848745,MATH 142A,A01,083219,Chow; Bennett,6,0,32,26
1656773848745,MATH 142A,A02,083220,Chow; Bennett,9,0,32,23
1656773848745,MATH 142A,A03,093480,Chow; Bennett,7,0,32,25
1656773848745,MATH 142A,B03,093481,Chow; Bennett,7,0,32,25
1656773848745,MATH 142A,B04,093558,Chow; Bennett,10,0,32,22
1656773848745,MATH 142A,B05,093559,Chow; Bennett,6,0,32,26
1656773854775,MATH 193A,A01,083224,Rotar; Vladimir,6,0,34,28
1656773854775,MATH 193A,A02,083225,Rotar; Vladimir,3,0,34,31
1656773854775,MATH 193A,A03,083781,Rotar; Vladimir,1,0,34,33
1656773854775,MATH 193A,A04,083782,Rotar; Vladimir,6,0,34,28
1656773854775,MATH 193A,A05,093482,Rotar; Vladimir,6,0,34,28
1656773860799,MATH 197,001,091859,McAuley; Julian John,9999,0,9999,0
1656773860799,MATH 197,002,095566,Kedlaya; Kiran S.,9997,0,9999,2
1656773860799,MATH 197,003,095567,Xiao; Ming,9999,0,9999,0
1656773860799,MATH 197,004,095571,Perols; Johan Lars,9998,0,9999,1
1656773867879,COGS 9,A01,083615,Shannon; Kyle Michael,6,0,75,69
1656773873909,COGS 11,A01,083617,Boyle; Mary E. T.,18,0,48,30
1656773879936,COGS 13,A01,083071,Bastos; Amalia Pinkusfeld,8,0,71,63
1656773885964,COGS 14A,A01,092681,Semenuks; Arturs,0,1,100,100
1656773891992,COGS 14B,A01,083073,Cheng; Tzu-Han,5,0,63,58
1656773898019,COGS 17,A01,092677,Semenuks; Arturs,4,0,81,77
1656773904043,COGS 100,A01,083619,Allen; Michael Gordon,15,0,70,55
1656773910070,COGS 101A,A01,083621,Davis; Joshua Daniel,9,0,68,59
1656773916094,COGS 101B,A01,091572,Allen; Michael Gordon,8,0,65,57
1656773922121,COGS 101C,A01,083625,Delgado; Tania,17,0,35,18
1656773928149,COGS 107A,A01,083627,Boyle; Mary E. T.,13,0,60,47
1656773934172,COGS 118A,A01,083075,Gupta; Anjum,15,0,76,61
1656773940199,CSE 3,A50,083646,Miranda; Gregory Joseph,22,0,50,28
1656773946228,CSE 8A,A50,083650,Miranda; Gregory Joseph,17,1,56,39
1656773952265,CSE 11,A01,083080,Cao; Yingjun,4,15,40,36
1656773958289,CSE 12,A01,083652,Krause-Levy; Sophia Louisa,20,1,120,100
1656773964312,CSE 15L,A01,083654,Morris; Justin Loren,8,0,50,42
1656773964312,CSE 15L,A02,083655,Morris; Justin Loren,8,0,50,42
1656773970336,CSE 20,A01,083657,Tran; Khoa Dang,37,0,80,43
1656773976366,CSE 21,A01,095574,Bach; Quang Tran,21,0,48,27
1656773982400,CSE 30,A01,083084,Eldon; John,4,0,80,76
1656773982400,CSE 30,B01,095061,Bhaskar; Nishant,5,0,50,45
1656773988425,CSE 100,A01,083659,Cao; Yingjun,1,4,70,69
1656773994450,CSE 134B,A01,083661,Powell; Thomas Allan,18,0,100,82
1656774000485,CSE 140,A01,083663,Gungor; Onat,14,0,85,71
1656774006513,CSE 140L,A01,083088,Eldon; John,16,0,100,84
1656774012540,CSE 175,A01,083665,Kumar; Rakesh,3,0,25,22
1656774018566,CSE 190,A00,092507,Dubnov; Shlomo,7,0,20,13
1656774024594,ECE 45,A01,083139,Congero; Spencer William,5,0,75,70
1656774030620,ECE 65,A50,083695,Saad; Andrew S,12,0,30,18
1656774030620,ECE 65,A51,095125,Saad; Andrew S,25,0,26,1
1656774036647,ECE 109,A01,091882,Touri; Behrouz,15,0,70,55
1656774042673,ECE 180,A00,083140,Abi Samra; Nicholas Camill,0,0,30,30
1656774042673,ECE 180,B00,083141,Abi Samra; Nicholas Camill,0,0,30,30
1656774048699,MATH 10A,A01,083735,Patchell; Gregory David,1,0,30,29
1656774048699,MATH 10A,A02,083736,Patchell; Gregory David,20,0,30,10
1656774048699,MATH 10A,A03,083737,Patchell; Gregory David,15,0,30,15
1656774054727,MATH 10B,A01,083207,Lim; Seonhee,7,0,34,27
1656774054727,MATH 10B,A02,083208,Lim; Seonhee,9,0,35,26
1656774054727,MATH 10B,A03,093472,Lim; Seonhee,4,0,34,30
1656774054727,MATH 10B,B01,083739,Sinha; Shubham,9,0,30,21
1656774060759,MATH 18,A01,083743,Cinel; Cameron Alexander,6,0,30,24
1656774060759,MATH 18,A02,083744,Cinel; Cameron Alexander,15,0,30,15
1656774060759,MATH 18,A03,083745,Cinel; Cameron Alexander,8,0,30,22
1656774060759,MATH 18,B01,083748,Rideout; David Porter,3,0,37,34
1656774060759,MATH 18,B02,083749,Rideout; David Porter,3,0,36,33
1656774060759,MATH 18,B03,083750,Rideout; David Porter,1,0,37,36
1656774060759,MATH 18,B04,083751,Rideout; David Porter,5,0,36,31
1656774060759,MATH 18,B05,093473,Rideout; David Porter,4,0,36,32
1656774060759,MATH 18,B06,093474,Rideout; David Porter,5,0,36,31
1656774066788,MATH 20A,A01,083754,Zheng; Zequn,12,0,40,28
1656774072815,MATH 20B,A01,083756,Briones; Jor-el Thomas Caparas,1,0,36,35
1656774072815,MATH 20B,A02,083757,Briones; Jor-el Thomas Caparas,1,0,36,35
1656774072815,MATH 20B,A03,093475,Briones; Jor-el Thomas Caparas,0,0,36,36
1656774078850,MATH 20C,A01,083760,Briones; Jor-el Thomas Caparas,1,0,35,34
1656774078850,MATH 20C,A02,083761,Briones; Jor-el Thomas Caparas,8,0,35,27
1656774078850,MATH 20C,A03,093476,Briones; Jor-el Thomas Caparas,0,1,36,36
1656774078850,MATH 20C,B01,083762,Bach; Quang Tran,0,0,30,30
1656774084881,MATH 20D,A01,083765,Tran; Brian Kha,4,0,30,26
1656774084881,MATH 20D,A02,083766,Tran; Brian Kha,4,0,30,26
1656774084881,MATH 20D,A03,083767,Tran; Brian Kha,2,0,30,28
1656774090909,MATH 20E,A01,083771,Ganguly; Soumya,5,0,32,27
1656774090909,MATH 20E,A02,083772,Ganguly; Soumya,5,0,32,27
1656774090909,MATH 20E,B01,083773,Ciotti; Benjamin,18,0,35,17
1656774090909,MATH 20E,B02,083774,Ciotti; Benjamin,17,0,35,18
1656774096946,MATH 103A,A01,083777,Greenfeld; Be'Eri,2,0,36,34
1656774096946,MATH 103A,A02,083778,Greenfeld; Be'Eri,5,0,36,31
1656774096946,MATH 103A,A03,093561,Greenfeld; Be'Eri,4,0,36,32
1656774096946,MATH 103A,B01,083779,Greenfeld; Be'Eri,6,0,36,30
1656774096946,MATH 103A,B02,083780,Greenfeld; Be'Eri,2,0,36,34
1656774096946,MATH 103A,B03,093562,Greenfeld; Be'Eri,2,0,36,34
1656774102970,MATH 105,A01,085443,Carter; Anne Toulson,13,0,35,22
1656774102970,MATH 105,A02,093477,Carter; Anne Toulson,20,0,35,15
1656774109004,MATH 109,A01,083213,Ganzberger; Geoffrey Michael,2,0,34,32
1656774109004,MATH 109,A02,083214,Ganzberger; Geoffrey Michael,2,0,34,32
1656774109004,MATH 109,A03,093478,Ganzberger; Geoffrey Michael,1,0,34,33
1656774109004,MATH 109,B01,083215,Ganzberger; Geoffrey Michael,1,0,32,31
1656774109004,MATH 109,B02,083216,Ganzberger; Geoffrey Michael,1,0,32,31
1656774109004,MATH 109,B03,093479,Ganzberger; Geoffrey Michael,6,0,32,26
1656774115037,MATH 142A,A01,083219,Chow; Bennett,6,0,32,26
1656774115037,MATH 142A,A02,083220,Chow; Bennett,9,0,32,23
1656774115037,MATH 142A,A03,093480,Chow; Bennett,7,0,32,25
1656774115037,MATH 142A,B03,093481,Chow; Bennett,7,0,32,25
1656774115037,MATH 142A,B04,093558,Chow; Bennett,10,0,32,22
1656774115037,MATH 142A,B05,093559,Chow; Bennett,6,0,32,26
1656774121064,MATH 193A,A01,083224,Rotar; Vladimir,6,0,34,28
1656774121064,MATH 193A,A02,083225,Rotar; Vladimir,3,0,34,31
1656774121064,MATH 193A,A03,083781,Rotar; Vladimir,1,0,34,33
1656774121064,MATH 193A,A04,083782,Rotar; Vladimir,6,0,34,28
1656774121064,MATH 193A,A05,093482,Rotar; Vladimir,6,0,34,28
1656774127095,MATH 197,001,091859,McAuley; Julian John,9999,0,9999,0
1656774127095,MATH 197,002,095566,Kedlaya; Kiran S.,9997,0,9999,2
1656774127095,MATH 197,003,095567,Xiao; Ming,9999,0,9999,0
1656774127095,MATH 197,004,095571,Perols; Johan Lars,9998,0,9999,1
1656774134156,COGS 9,A01,083615,Shannon; Kyle Michael,6,0,75,69
1656774140184,COGS 11,A01,083617,Boyle; Mary E. T.,18,0,48,30
1656774146213,COGS 13,A01,083071,Bastos; Amalia Pinkusfeld,8,0,71,63
1656774152236,COGS 14A,A01,092681,Semenuks; Arturs,0,1,100,100
1656774158261,COGS 14B,A01,083073,Cheng; Tzu-Han,5,0,63,58
1656774164288,COGS 17,A01,092677,Semenuks; Arturs,4,0,81,77
1656774170314,COGS 100,A01,083619,Allen; Michael Gordon,15,0,70,55
1656774176344,COGS 101A,A01,083621,Davis; Joshua Daniel,9,0,68,59
1656774182379,COGS 101B,A01,091572,Allen; Michael Gordon,8,0,65,57
1656774188419,COGS 101C,A01,083625,Delgado; Tania,17,0,35,18
1656774194448,COGS 107A,A01,083627,Boyle; Mary E. T.,13,0,60,47
1656774200472,COGS 118A,A01,083075,Gupta; Anjum,15,0,76,61
1656774206506,CSE 3,A50,083646,Miranda; Gregory Joseph,22,0,50,28
1656774212608,CSE 8A,A50,083650,Miranda; Gregory Joseph,17,1,56,39
1656774218637,CSE 11,A01,083080,Cao; Yingjun,4,15,40,36
1656774224668,CSE 12,A01,083652,Krause-Levy; Sophia Louisa,20,1,120,100
1656774230692,CSE 15L,A01,083654,Morris; Justin Loren,8,0,50,42
1656774230692,CSE 15L,A02,083655,Morris; Justin Loren,8,0,50,42
1656774236717,CSE 20,A01,083657,Tran; Khoa Dang,37,0,80,43
1656774242743,CSE 21,A01,095574,Bach; Quang Tran,21,0,48,27
1656774248777,CSE 30,A01,083084,Eldon; John,4,0,80,76
1656774248777,CSE 30,B01,095061,Bhaskar; Nishant,5,0,50,45
1656774254801,CSE 100,A01,083659,Cao; Yingjun,1,4,70,69
1656774260833,CSE 134B,A01,083661,Powell; Thomas Allan,18,0,100,82
1656774266858,CSE 140,A01,083663,Gungor; Onat,14,0,85,71
1656774272884,CSE 140L,A01,083088,Eldon; John,16,0,100,84
1656774278924,CSE 175,A01,083665,Kumar; Rakesh,3,0,25,22
1656774284949,CSE 190,A00,092507,Dubnov; Shlomo,7,0,20,13
1656774290983,ECE 45,A01,083139,Congero; Spencer William,5,0,75,70
1656774297007,ECE 65,A50,083695,Saad; Andrew S,12,0,30,18
1656774297007,ECE 65,A51,095125,Saad; Andrew S,25,0,26,1
1656774303035,ECE 109,A01,091882,Touri; Behrouz,15,0,70,55
1656774309064,ECE 180,A00,083140,Abi Samra; Nicholas Camill,0,0,30,30
1656774309064,ECE 180,B00,083141,Abi Samra; Nicholas Camill,0,0,30,30
1656774315099,MATH 10A,A01,083735,Patchell; Gregory David,1,0,30,29
1656774315099,MATH 10A,A02,083736,Patchell; Gregory David,20,0,30,10
1656774315099,MATH 10A,A03,083737,Patchell; Gregory David,15,0,30,15
1656774321137,MATH 10B,A01,083207,Lim; Seonhee,7,0,34,27
1656774321137,MATH 10B,A02,083208,Lim; Seonhee,9,0,35,26
1656774321137,MATH 10B,A03,093472,Lim; Seonhee,4,0,34,30
1656774321137,MATH 10B,B01,083739,Sinha; Shubham,9,0,30,21
1656774327166,MATH 18,A01,083743,Cinel; Cameron Alexander,6,0,30,24
1656774327166,MATH 18,A02,083744,Cinel; Cameron Alexander,15,0,30,15
1656774327166,MATH 18,A03,083745,Cinel; Cameron Alexander,8,0,30,22
1656774327166,MATH 18,B01,083748,Rideout; David Porter,3,0,37,34
1656774327166,MATH 18,B02,083749,Rideout; David Porter,3,0,36,33
1656774327166,MATH 18,B03,083750,Rideout; David Porter,1,0,37,36
1656774327166,MATH 18,B04,083751,Rideout; David Porter,5,0,36,31
1656774327166,MATH 18,B05,093473,Rideout; David Porter,4,0,36,32
1656774327166,MATH 18,B06,093474,Rideout; David Porter,5,0,36,31
1656774333196,MATH 20A,A01,083754,Zheng; Zequn,12,0,40,28
1656774339223,MATH 20B,A01,083756,Briones; Jor-el Thomas Caparas,1,0,36,35
1656774339223,MATH 20B,A02,083757,Briones; Jor-el Thomas Caparas,1,0,36,35
1656774339223,MATH 20B,A03,093475,Briones; Jor-el Thomas Caparas,0,0,36,36
1656774345248,MATH 20C,A01,083760,Briones; Jor-el Thomas Caparas,1,0,35,34
1656774345248,MATH 20C,A02,083761,Briones; Jor-el Thomas Caparas,8,0,35,27
1656774345248,MATH 20C,A03,093476,Briones; Jor-el Thomas Caparas,0,1,36,36
1656774345248,MATH 20C,B01,083762,Bach; Quang Tran,0,0,30,30
1656774351275,MATH 20D,A01,083765,Tran; Brian Kha,4,0,30,26
1656774351275,MATH 20D,A02,083766,Tran; Brian Kha,4,0,30,26
1656774351275,MATH 20D,A03,083767,Tran; Brian Kha,2,0,30,28
1656774357310,MATH 20E,A01,083771,Ganguly; Soumya,5,0,32,27
1656774357310,MATH 20E,A02,083772,Ganguly; Soumya,5,0,32,27
1656774357310,MATH 20E,B01,083773,Ciotti; Benjamin,18,0,35,17
1656774357310,MATH 20E,B02,083774,Ciotti; Benjamin,17,0,35,18
1656774363349,MATH 103A,A01,083777,Greenfeld; Be'Eri,2,0,36,34
1656774363349,MATH 103A,A02,083778,Greenfeld; Be'Eri,5,0,36,31
1656774363349,MATH 103A,A03,093561,Greenfeld; Be'Eri,4,0,36,32
1656774363349,MATH 103A,B01,083779,Greenfeld; Be'Eri,6,0,36,30
1656774363349,MATH 103A,B02,083780,Greenfeld; Be'Eri,2,0,36,34
1656774363349,MATH 103A,B03,093562,Greenfeld; Be'Eri,2,0,36,34
1656774369378,MATH 105,A01,085443,Carter; Anne Toulson,13,0,35,22
1656774369378,MATH 105,A02,093477,Carter; Anne Toulson,20,0,35,15
1656774375404,MATH 109,A01,083213,Ganzberger; Geoffrey Michael,2,0,34,32
1656774375404,MATH 109,A02,083214,Ganzberger; Geoffrey Michael,2,0,34,32
1656774375404,MATH 109,A03,093478,Ganzberger; Geoffrey Michael,1,0,34,33
1656774375404,MATH 109,B01,083215,Ganzberger; Geoffrey Michael,1,0,32,31
1656774375404,MATH 109,B02,083216,Ganzberger; Geoffrey Michael,1,0,32,31
1656774375404,MATH 109,B03,093479,Ganzberger; Geoffrey Michael,6,0,32,26
1656774381436,MATH 142A,A01,083219,Chow; Bennett,6,0,32,26
1656774381436,MATH 142A,A02,083220,Chow; Bennett,9,0,32,23
1656774381436,MATH 142A,A03,093480,Chow; Bennett,7,0,32,25
1656774381436,MATH 142A,B03,093481,Chow; Bennett,7,0,32,25
1656774381436,MATH 142A,B04,093558,Chow; Bennett,10,0,32,22
1656774381436,MATH 142A,B05,093559,Chow; Bennett,6,0,32,26
1656774387462,MATH 193A,A01,083224,Rotar; Vladimir,6,0,34,28
1656774387462,MATH 193A,A02,083225,Rotar; Vladimir,3,0,34,31
1656774387462,MATH 193A,A03,083781,Rotar; Vladimir,1,0,34,33
1656774387462,MATH 193A,A04,083782,Rotar; Vladimir,6,0,34,28
1656774387462,MATH 193A,A05,093482,Rotar; Vladimir,6,0,34,28
1656774393486,MATH 197,001,091859,McAuley; Julian John,9999,0,9999,0
1656774393486,MATH 197,002,095566,Kedlaya; Kiran S.,9997,0,9999,2
1656774393486,MATH 197,003,095567,Xiao; Ming,9999,0,9999,0
1656774393486,MATH 197,004,095571,Perols; Johan Lars,9998,0,9999,1
1656774400548,COGS 9,A01,083615,Shannon; Kyle Michael,6,0,75,69
1656774406579,COGS 11,A01,083617,Boyle; Mary E. T.,18,0,48,30
1656774412605,COGS 13,A01,083071,Bastos; Amalia Pinkusfeld,8,0,71,63
1656774418630,COGS 14A,A01,092681,Semenuks; Arturs,0,1,100,100
1656774424657,COGS 14B,A01,083073,Cheng; Tzu-Han,5,0,63,58
1656774430682,COGS 17,A01,092677,Semenuks; Arturs,4,0,81,77
1656774436714,COGS 100,A01,083619,Allen; Michael Gordon,15,0,70,55
1656774442737,COGS 101A,A01,083621,Davis; Joshua Daniel,9,0,68,59
1656774448761,COGS 101B,A01,091572,Allen; Michael Gordon,8,0,65,57
1656774454787,COGS 101C,A01,083625,Delgado; Tania,17,0,35,18
1656774460812,COGS 107A,A01,083627,Boyle; Mary E. T.,13,0,60,47
1656774466840,COGS 118A,A01,083075,Gupta; Anjum,15,0,76,61
1656774472875,CSE 3,A50,083646,Miranda; Gregory Joseph,22,0,50,28
1656774478900,CSE 8A,A50,083650,Miranda; Gregory Joseph,17,1,56,39
1656774484929,CSE 11,A01,083080,Cao; Yingjun,4,15,40,36
1656774490956,CSE 12,A01,083652,Krause-Levy; Sophia Louisa,20,1,120,100
1656774496980,CSE 15L,A01,083654,Morris; Justin Loren,8,0,50,42
1656774496980,CSE 15L,A02,083655,Morris; Justin Loren,8,0,50,42
1656774503011,CSE 20,A01,083657,Tran; Khoa Dang,37,0,80,43
1656774509041,CSE 21,A01,095574,Bach; Quang Tran,21,0,48,27
1656774515083,CSE 30,A01,083084,Eldon; John,4,0,80,76
1656774515083,CSE 30,B01,095061,Bhaskar; Nishant,5,0,50,45
1656774521114,CSE 100,A01,083659,Cao; Yingjun,1,4,70,69
1656774527149,CSE 134B,A01,083661,Powell; Thomas Allan,18,0,100,82
1656774533179,CSE 140,A01,083663,Gungor; Onat,14,0,85,71
1656774539208,CSE 140L,A01,083088,Eldon; John,16,0,100,84
1656774545240,CSE 175,A01,083665,Kumar; Rakesh,3,0,25,22
1656774551269,CSE 190,A00,092507,Dubnov; Shlomo,7,0,20,13
1656774557300,ECE 45,A01,083139,Congero; Spencer William,5,0,75,70
1656774563326,ECE 65,A50,083695,Saad; Andrew S,12,0,30,18
1656774563326,ECE 65,A51,095125,Saad; Andrew S,25,0,26,1
1656774569360,ECE 109,A01,091882,Touri; Behrouz,15,0,70,55
1656774575391,ECE 180,A00,083140,Abi Samra; Nicholas Camill,0,0,30,30
1656774575391,ECE 180,B00,083141,Abi Samra; Nicholas Camill,0,0,30,30
1656774581417,MATH 10A,A01,083735,Patchell; Gregory David,1,0,30,29
1656774581417,MATH 10A,A02,083736,Patchell; Gregory David,20,0,30,10
1656774581417,MATH 10A,A03,083737,Patchell; Gregory David,15,0,30,15
1656774587452,MATH 10B,A01,083207,Lim; Seonhee,7,0,34,27
1656774587452,MATH 10B,A02,083208,Lim; Seonhee,9,0,35,26
1656774587452,MATH 10B,A03,093472,Lim; Seonhee,4,0,34,30
1656774587452,MATH 10B,B01,083739,Sinha; Shubham,9,0,30,21
1656774593482,MATH 18,A01,083743,Cinel; Cameron Alexander,6,0,30,24
1656774593482,MATH 18,A02,083744,Cinel; Cameron Alexander,15,0,30,15
1656774593482,MATH 18,A03,083745,Cinel; Cameron Alexander,8,0,30,22
1656774593482,MATH 18,B01,083748,Rideout; David Porter,3,0,37,34
1656774593482,MATH 18,B02,083749,Rideout; David Porter,3,0,36,33
1656774593482,MATH 18,B03,083750,Rideout; David Porter,1,0,37,36
1656774593482,MATH 18,B04,083751,Rideout; David Porter,5,0,36,31
1656774593482,MATH 18,B05,093473,Rideout; David Porter,4,0,36,32
1656774593482,MATH 18,B06,093474,Rideout; David Porter,5,0,36,31
1656774599512,MATH 20A,A01,083754,Zheng; Zequn,12,0,40,28
1656774605536,MATH 20B,A01,083756,Briones; Jor-el Thomas Caparas,1,0,36,35
1656774605536,MATH 20B,A02,083757,Briones; Jor-el Thomas Caparas,1,0,36,35
1656774605536,MATH 20B,A03,093475,Briones; Jor-el Thomas Caparas,0,0,36,36
1656774611568,MATH 20C,A01,083760,Briones; Jor-el Thomas Caparas,1,0,35,34
1656774611568,MATH 20C,A02,083761,Briones; Jor-el Thomas Caparas,8,0,35,27
1656774611568,MATH 20C,A03,093476,Briones; Jor-el Thomas Caparas,0,1,36,36
1656774611568,MATH 20C,B01,083762,Bach; Quang Tran,0,0,30,30
1656774617595,MATH 20D,A01,083765,Tran; Brian Kha,4,0,30,26
1656774617595,MATH 20D,A02,083766,Tran; Brian Kha,4,0,30,26
1656774617595,MATH 20D,A03,083767,Tran; Brian Kha,2,0,30,28
1656774623628,MATH 20E,A01,083771,Ganguly; Soumya,5,0,32,27
1656774623628,MATH 20E,A02,083772,Ganguly; Soumya,5,0,32,27
1656774623628,MATH 20E,B01,083773,Ciotti; Benjamin,18,0,35,17
1656774623628,MATH 20E,B02,083774,Ciotti; Benjamin,17,0,35,18
1656774629663,MATH 103A,A01,083777,Greenfeld; Be'Eri,2,0,36,34
1656774629663,MATH 103A,A02,083778,Greenfeld; Be'Eri,5,0,36,31
1656774629663,MATH 103A,A03,093561,Greenfeld; Be'Eri,4,0,36,32
1656774629663,MATH 103A,B01,083779,Greenfeld; Be'Eri,6,0,36,30
1656774629663,MATH 103A,B02,083780,Greenfeld; Be'Eri,2,0,36,34
1656774629663,MATH 103A,B03,093562,Greenfeld; Be'Eri,2,0,36,34
1656774635688,MATH 105,A01,085443,Carter; Anne Toulson,13,0,35,22
1656774635688,MATH 105,A02,093477,Carter; Anne Toulson,20,0,35,15
1656774641727,MATH 109,A01,083213,Ganzberger; Geoffrey Michael,2,0,34,32
1656774641727,MATH 109,A02,083214,Ganzberger; Geoffrey Michael,2,0,34,32
1656774641727,MATH 109,A03,093478,Ganzberger; Geoffrey Michael,1,0,34,33
1656774641727,MATH 109,B01,083215,Ganzberger; Geoffrey Michael,1,0,32,31
1656774641727,MATH 109,B02,083216,Ganzberger; Geoffrey Michael,1,0,32,31
1656774641727,MATH 109,B03,093479,Ganzberger; Geoffrey Michael,6,0,32,26
1656774647761,MATH 142A,A01,083219,Chow; Bennett,6,0,32,26
1656774647761,MATH 142A,A02,083220,Chow; Bennett,9,0,32,23
1656774647761,MATH 142A,A03,093480,Chow; Bennett,7,0,32,25
1656774647761,MATH 142A,B03,093481,Chow; Bennett,7,0,32,25
1656774647761,MATH 142A,B04,093558,Chow; Bennett,10,0,32,22
1656774647761,MATH 142A,B05,093559,Chow; Bennett,6,0,32,26
1656774653803,MATH 193A,A01,083224,Rotar; Vladimir,6,0,34,28
1656774653803,MATH 193A,A02,083225,Rotar; Vladimir,3,0,34,31
1656774653803,MATH 193A,A03,083781,Rotar; Vladimir,1,0,34,33
1656774653803,MATH 193A,A04,083782,Rotar; Vladimir,6,0,34,28
1656774653803,MATH 193A,A05,093482,Rotar; Vladimir,6,0,34,28
1656774659829,MATH 197,001,091859,McAuley; Julian John,9999,0,9999,0
1656774659829,MATH 197,002,095566,Kedlaya; Kiran S.,9997,0,9999,2
1656774659829,MATH 197,003,095567,Xiao; Ming,9999,0,9999,0
1656774659829,MATH 197,004,095571,Perols; Johan Lars,9998,0,9999,1
1656774666914,COGS 9,A01,083615,Shannon; Kyle Michael,6,0,75,69
1656774672939,COGS 11,A01,083617,Boyle; Mary E. T.,18,0,48,30
1656774678965,COGS 13,A01,083071,Bastos; Amalia Pinkusfeld,8,0,71,63
1656774684996,COGS 14A,A01,092681,Semenuks; Arturs,0,1,100,100
1656774691028,COGS 14B,A01,083073,Cheng; Tzu-Han,5,0,63,58
1656774697053,COGS 17,A01,092677,Semenuks; Arturs,4,0,81,77
1656774703081,COGS 100,A01,083619,Allen; Michael Gordon,15,0,70,55
1656774709107,COGS 101A,A01,083621,Davis; Joshua Daniel,9,0,68,59
1656774715132,COGS 101B,A01,091572,Allen; Michael Gordon,8,0,65,57
1656774721162,COGS 101C,A01,083625,Delgado; Tania,17,0,35,18
1656774727190,COGS 107A,A01,083627,Boyle; Mary E. T.,13,0,60,47
1656774733216,COGS 118A,A01,083075,Gupta; Anjum,15,0,76,61
1656774739245,CSE 3,A50,083646,Miranda; Gregory Joseph,22,0,50,28
1656774745274,CSE 8A,A50,083650,Miranda; Gregory Joseph,17,1,56,39
1656774751310,CSE 11,A01,083080,Cao; Yingjun,4,15,40,36
1656774757339,CSE 12,A01,083652,Krause-Levy; Sophia Louisa,20,1,120,100
1656774763364,CSE 15L,A01,083654,Morris; Justin Loren,8,0,50,42
1656774763364,CSE 15L,A02,083655,Morris; Justin Loren,8,0,50,42
1656774769390,CSE 20,A01,083657,Tran; Khoa Dang,37,0,80,43
1656774775416,CSE 21,A01,095574,Bach; Quang Tran,21,0,48,27
1656774781443,CSE 30,A01,083084,Eldon; John,4,0,80,76
1656774781443,CSE 30,B01,095061,Bhaskar; Nishant,5,0,50,45
1656774787472,CSE 100,A01,083659,Cao; Yingjun,1,4,70,69
1656774793497,CSE 134B,A01,083661,Powell; Thomas Allan,18,0,100,82
1656774799528,CSE 140,A01,083663,Gungor; Onat,14,0,85,71
1656774805553,CSE 140L,A01,083088,Eldon; John,16,0,100,84
1656774811649,CSE 175,A01,083665,Kumar; Rakesh,3,0,25,22
1656774817675,CSE 190,A00,092507,Dubnov; Shlomo,7,0,20,13
1656774823701,ECE 45,A01,083139,Congero; Spencer William,5,0,75,70
1656774829727,ECE 65,A50,083695,Saad; Andrew S,12,0,30,18
1656774829727,ECE 65,A51,095125,Saad; Andrew S,25,0,26,1
1656774835758,ECE 109,A01,091882,Touri; Behrouz,15,0,70,55
1656774841782,ECE 180,A00,083140,Abi Samra; Nicholas Camill,0,0,30,30
1656774841782,ECE 180,B00,083141,Abi Samra; Nicholas Camill,0,0,30,30
1656774847808,MATH 10A,A01,083735,Patchell; Gregory David,1,0,30,29
1656774847808,MATH 10A,A02,083736,Patchell; Gregory David,20,0,30,10
1656774847808,MATH 10A,A03,083737,Patchell; Gregory David,15,0,30,15
1656774853845,MATH 10B,A01,083207,Lim; Seonhee,7,0,34,27
1656774853845,MATH 10B,A02,083208,Lim; Seonhee,9,0,35,26
1656774853845,MATH 10B,A03,093472,Lim; Seonhee,4,0,34,30
1656774853845,MATH 10B,B01,083739,Sinha; Shubham,9,0,30,21
1656774859886,MATH 18,A01,083743,Cinel; Cameron Alexander,6,0,30,24
1656774859886,MATH 18,A02,083744,Cinel; Cameron Alexander,15,0,30,15
1656774859886,MATH 18,A03,083745,Cinel; Cameron Alexander,8,0,30,22
1656774859886,MATH 18,B01,083748,Rideout; David Porter,3,0,37,34
1656774859886,MATH 18,B02,083749,Rideout; David Porter,3,0,36,33
1656774859886,MATH 18,B03,083750,Rideout; David Porter,1,0,37,36
1656774859886,MATH 18,B04,083751,Rideout; David Porter,5,0,36,31
1656774859886,MATH 18,B05,093473,Rideout; David Porter,4,0,36,32
1656774859886,MATH 18,B06,093474,Rideout; David Porter,5,0,36,31
1656774865912,MATH 20A,A01,083754,Zheng; Zequn,12,0,40,28
1656774871938,MATH 20B,A01,083756,Briones; Jor-el Thomas Caparas,1,0,36,35
1656774871938,MATH 20B,A02,083757,Briones; Jor-el Thomas Caparas,1,0,36,35
1656774871938,MATH 20B,A03,093475,Briones; Jor-el Thomas Caparas,0,0,36,36
1656774877969,MATH 20C,A01,083760,Briones; Jor-el Thomas Caparas,1,0,35,34
1656774877969,MATH 20C,A02,083761,Briones; Jor-el Thomas Caparas,8,0,35,27
1656774877969,MATH 20C,A03,093476,Briones; Jor-el Thomas Caparas,0,1,36,36
1656774877969,MATH 20C,B01,083762,Bach; Quang Tran,0,0,30,30
1656774883995,MATH 20D,A01,083765,Tran; Brian Kha,4,0,30,26
1656774883995,MATH 20D,A02,083766,Tran; Brian Kha,4,0,30,26
1656774883995,MATH 20D,A03,083767,Tran; Brian Kha,2,0,30,28
1656774890021,MATH 20E,A01,083771,Ganguly; Soumya,5,0,32,27
1656774890021,MATH 20E,A02,083772,Ganguly; Soumya,5,0,32,27
1656774890021,MATH 20E,B01,083773,Ciotti; Benjamin,18,0,35,17
1656774890021,MATH 20E,B02,083774,Ciotti; Benjamin,17,0,35,18
1656774896048,MATH 103A,A01,083777,Greenfeld; Be'Eri,2,0,36,34
1656774896048,MATH 103A,A02,083778,Greenfeld; Be'Eri,5,0,36,31
1656774896048,MATH 103A,A03,093561,Greenfeld; Be'Eri,4,0,36,32
1656774896048,MATH 103A,B01,083779,Greenfeld; Be'Eri,6,0,36,30
1656774896048,MATH 103A,B02,083780,Greenfeld; Be'Eri,2,0,36,34
1656774896048,MATH 103A,B03,093562,Greenfeld; Be'Eri,2,0,36,34
1656774902079,MATH 105,A01,085443,Carter; Anne Toulson,13,0,35,22
1656774902079,MATH 105,A02,093477,Carter; Anne Toulson,20,0,35,15
1656774908105,MATH 109,A01,083213,Ganzberger; Geoffrey Michael,2,0,34,32
1656774908105,MATH 109,A02,083214,Ganzberger; Geoffrey Michael,2,0,34,32
1656774908105,MATH 109,A03,093478,Ganzberger; Geoffrey Michael,1,0,34,33
1656774908105,MATH 109,B01,083215,Ganzberger; Geoffrey Michael,1,0,32,31
1656774908105,MATH 109,B02,083216,Ganzberger; Geoffrey Michael,1,0,32,31
1656774908105,MATH 109,B03,093479,Ganzberger; Geoffrey Michael,6,0,32,26
1656774914140,MATH 142A,A01,083219,Chow; Bennett,6,0,32,26
1656774914140,MATH 142A,A02,083220,Chow; Bennett,9,0,32,23
1656774914140,MATH 142A,A03,093480,Chow; Bennett,7,0,32,25
1656774914140,MATH 142A,B03,093481,Chow; Bennett,7,0,32,25
1656774914140,MATH 142A,B04,093558,Chow; Bennett,10,0,32,22
1656774914140,MATH 142A,B05,093559,Chow; Bennett,6,0,32,26
1656774920167,MATH 193A,A01,083224,Rotar; Vladimir,6,0,34,28
1656774920167,MATH 193A,A02,083225,Rotar; Vladimir,3,0,34,31
1656774920167,MATH 193A,A03,083781,Rotar; Vladimir,1,0,34,33
1656774920167,MATH 193A,A04,083782,Rotar; Vladimir,6,0,34,28
1656774920167,MATH 193A,A05,093482,Rotar; Vladimir,6,0,34,28
1656774926192,MATH 197,001,091859,McAuley; Julian John,9999,0,9999,0
1656774926192,MATH 197,002,095566,Kedlaya; Kiran S.,9997,0,9999,2
1656774926192,MATH 197,003,095567,Xiao; Ming,9999,0,9999,0
1656774926192,MATH 197,004,095571,Perols; Johan Lars,9998,0,9999,1
1656774933262,COGS 9,A01,083615,Shannon; Kyle Michael,6,0,75,69
1656774939290,COGS 11,A01,083617,Boyle; Mary E. T.,18,0,48,30
1656774945316,COGS 13,A01,083071,Bastos; Amalia Pinkusfeld,8,0,71,63
1656774951340,COGS 14A,A01,092681,Semenuks; Arturs,0,1,100,100
1656774957379,COGS 14B,A01,083073,Cheng; Tzu-Han,5,0,63,58
1656774963408,COGS 17,A01,092677,Semenuks; Arturs,4,0,81,77
1656774969442,COGS 100,A01,083619,Allen; Michael Gordon,15,0,70,55
1656774975470,COGS 101A,A01,083621,Davis; Joshua Daniel,9,0,68,59
1656774981504,COGS 101B,A01,091572,Allen; Michael Gordon,8,0,65,57
1656774987537,COGS 101C,A01,083625,Delgado; Tania,17,0,35,18
1656774993564,COGS 107A,A01,083627,Boyle; Mary E. T.,13,0,60,47
1656774999590,COGS 118A,A01,083075,Gupta; Anjum,15,0,76,61
1656775005619,CSE 3,A50,083646,Miranda; Gregory Joseph,22,0,50,28
1656775011646,CSE 8A,A50,083650,Miranda; Gregory Joseph,17,1,56,39
1656775017674,CSE 11,A01,083080,Cao; Yingjun,4,15,40,36
1656775023708,CSE 12,A01,083652,Krause-Levy; Sophia Louisa,20,1,120,100
1656775029743,CSE 15L,A01,083654,Morris; Justin Loren,8,0,50,42
1656775029743,CSE 15L,A02,083655,Morris; Justin Loren,8,0,50,42
1656775035774,CSE 20,A01,083657,Tran; Khoa Dang,37,0,80,43
1656775041800,CSE 21,A01,095574,Bach; Quang Tran,21,0,48,27
1656775047828,CSE 30,A01,083084,Eldon; John,4,0,80,76
1656775047828,CSE 30,B01,095061,Bhaskar; Nishant,5,0,50,45
1656775053856,CSE 100,A01,083659,Cao; Yingjun,1,4,70,69
1656775059887,CSE 134B,A01,083661,Powell; Thomas Allan,18,0,100,82
1656775065915,CSE 140,A01,083663,Gungor; Onat,14,0,85,71
1656775071944,CSE 140L,A01,083088,Eldon; John,16,0,100,84
1656775077976,CSE 175,A01,083665,Kumar; Rakesh,3,0,25,22
1656775084003,CSE 190,A00,092507,Dubnov; Shlomo,7,0,20,13
1656775090047,ECE 45,A01,083139,Congero; Spencer William,5,0,75,70
1656775096074,ECE 65,A50,083695,Saad; Andrew S,12,0,30,18
1656775096074,ECE 65,A51,095125,Saad; Andrew S,25,0,26,1
1656775102102,ECE 109,A01,091882,Touri; Behrouz,15,0,70,55
1656775108139,ECE 180,A00,083140,Abi Samra; Nicholas Camill,0,0,30,30
1656775108139,ECE 180,B00,083141,Abi Samra; Nicholas Camill,0,0,30,30
1656775114185,MATH 10A,A01,083735,Patchell; Gregory David,1,0,30,29
1656775114185,MATH 10A,A02,083736,Patchell; Gregory David,20,0,30,10
1656775114185,MATH 10A,A03,083737,Patchell; Gregory David,15,0,30,15
1656775120214,MATH 10B,A01,083207,Lim; Seonhee,7,0,34,27
1656775120214,MATH 10B,A02,083208,Lim; Seonhee,9,0,35,26
1656775120214,MATH 10B,A03,093472,Lim; Seonhee,4,0,34,30
1656775120214,MATH 10B,B01,083739,Sinha; Shubham,9,0,30,21
1656775126254,MATH 18,A01,083743,Cinel; Cameron Alexander,6,0,30,24
1656775126254,MATH 18,A02,083744,Cinel; Cameron Alexander,15,0,30,15
1656775126254,MATH 18,A03,083745,Cinel; Cameron Alexander,8,0,30,22
1656775126254,MATH 18,B01,083748,Rideout; David Porter,3,0,37,34
1656775126254,MATH 18,B02,083749,Rideout; David Porter,3,0,36,33
1656775126254,MATH 18,B03,083750,Rideout; David Porter,1,0,37,36
1656775126254,MATH 18,B04,083751,Rideout; David Porter,5,0,36,31
1656775126254,MATH 18,B05,093473,Rideout; David Porter,4,0,36,32
1656775126254,MATH 18,B06,093474,Rideout; David Porter,5,0,36,31
1656775132278,MATH 20A,A01,083754,Zheng; Zequn,12,0,40,28
1656775138306,MATH 20B,A01,083756,Briones; Jor-el Thomas Caparas,1,0,36,35
1656775138306,MATH 20B,A02,083757,Briones; Jor-el Thomas Caparas,1,0,36,35
1656775138306,MATH 20B,A03,093475,Briones; Jor-el Thomas Caparas,0,0,36,36
1656775144335,MATH 20C,A01,083760,Briones; Jor-el Thomas Caparas,1,0,35,34
1656775144335,MATH 20C,A02,083761,Briones; Jor-el Thomas Caparas,8,0,35,27
1656775144335,MATH 20C,A03,093476,Briones; Jor-el Thomas Caparas,0,1,36,36
1656775144335,MATH 20C,B01,083762,Bach; Quang Tran,0,0,30,30
1656775150369,MATH 20D,A01,083765,Tran; Brian Kha,4,0,30,26
1656775150369,MATH 20D,A02,083766,Tran; Brian Kha,4,0,30,26
1656775150369,MATH 20D,A03,083767,Tran; Brian Kha,2,0,30,28
1656775156401,MATH 20E,A01,083771,Ganguly; Soumya,5,0,32,27
1656775156401,MATH 20E,A02,083772,Ganguly; Soumya,5,0,32,27
1656775156401,MATH 20E,B01,083773,Ciotti; Benjamin,18,0,35,17
1656775156401,MATH 20E,B02,083774,Ciotti; Benjamin,17,0,35,18
1656775162444,MATH 103A,A01,083777,Greenfeld; Be'Eri,2,0,36,34
1656775162444,MATH 103A,A02,083778,Greenfeld; Be'Eri,5,0,36,31
1656775162444,MATH 103A,A03,093561,Greenfeld; Be'Eri,4,0,36,32
1656775162444,MATH 103A,B01,083779,Greenfeld; Be'Eri,6,0,36,30
1656775162444,MATH 103A,B02,083780,Greenfeld; Be'Eri,2,0,36,34
1656775162444,MATH 103A,B03,093562,Greenfeld; Be'Eri,2,0,36,34
1656775168471,MATH 105,A01,085443,Carter; Anne Toulson,13,0,35,22
1656775168471,MATH 105,A02,093477,Carter; Anne Toulson,20,0,35,15
1656775174504,MATH 109,A01,083213,Ganzberger; Geoffrey Michael,2,0,34,32
1656775174504,MATH 109,A02,083214,Ganzberger; Geoffrey Michael,2,0,34,32
1656775174504,MATH 109,A03,093478,Ganzberger; Geoffrey Michael,1,0,34,33
1656775174504,MATH 109,B01,083215,Ganzberger; Geoffrey Michael,1,0,32,31
1656775174504,MATH 109,B02,083216,Ganzberger; Geoffrey Michael,1,0,32,31
1656775174504,MATH 109,B03,093479,Ganzberger; Geoffrey Michael,6,0,32,26
1656775180537,MATH 142A,A01,083219,Chow; Bennett,6,0,32,26
1656775180537,MATH 142A,A02,083220,Chow; Bennett,9,0,32,23
1656775180537,MATH 142A,A03,093480,Chow; Bennett,7,0,32,25
1656775180537,MATH 142A,B03,093481,Chow; Bennett,7,0,32,25
1656775180537,MATH 142A,B04,093558,Chow; Bennett,10,0,32,22
1656775180537,MATH 142A,B05,093559,Chow; Bennett,6,0,32,26
1656775186571,MATH 193A,A01,083224,Rotar; Vladimir,6,0,34,28
1656775186571,MATH 193A,A02,083225,Rotar; Vladimir,3,0,34,31
1656775186571,MATH 193A,A03,083781,Rotar; Vladimir,1,0,34,33
1656775186571,MATH 193A,A04,083782,Rotar; Vladimir,6,0,34,28
1656775186571,MATH 193A,A05,093482,Rotar; Vladimir,6,0,34,28
1656775192607,MATH 197,001,091859,McAuley; Julian John,9999,0,9999,0
1656775192607,MATH 197,002,095566,Kedlaya; Kiran S.,9997,0,9999,2
1656775192607,MATH 197,003,095567,Xiao; Ming,9999,0,9999,0
1656775192607,MATH 197,004,095571,Perols; Johan Lars,9998,0,9999,1
1656775199699,COGS 9,A01,083615,Shannon; Kyle Michael,6,0,75,69
1656775205723,COGS 11,A01,083617,Boyle; Mary E. T.,18,0,48,30
1656775211752,COGS 13,A01,083071,Bastos; Amalia Pinkusfeld,8,0,71,63
1656775217777,COGS 14A,A01,092681,Semenuks; Arturs,0,1,100,100
1656775223803,COGS 14B,A01,083073,Cheng; Tzu-Han,5,0,63,58
1656775229836,COGS 17,A01,092677,Semenuks; Arturs,4,0,81,77
1656775235865,COGS 100,A01,083619,Allen; Michael Gordon,15,0,70,55
1656775241890,COGS 101A,A01,083621,Davis; Joshua Daniel,9,0,68,59
1656775247916,COGS 101B,A01,091572,Allen; Michael Gordon,8,0,65,57
1656775253942,COGS 101C,A01,083625,Delgado; Tania,17,0,35,18
1656775259968,COGS 107A,A01,083627,Boyle; Mary E. T.,13,0,60,47
1656775265999,COGS 118A,A01,083075,Gupta; Anjum,15,0,76,61
1656775272034,CSE 3,A50,083646,Miranda; Gregory Joseph,22,0,50,28
1656775278058,CSE 8A,A50,083650,Miranda; Gregory Joseph,17,1,56,39
1656775284088,CSE 11,A01,083080,Cao; Yingjun,4,15,40,36
1656775290114,CSE 12,A01,083652,Krause-Levy; Sophia Louisa,20,1,120,100
1656775296143,CSE 15L,A01,083654,Morris; Justin Loren,8,0,50,42
1656775296143,CSE 15L,A02,083655,Morris; Justin Loren,8,0,50,42
1656775302168,CSE 20,A01,083657,Tran; Khoa Dang,37,0,80,43
1656775308203,CSE 21,A01,095574,Bach; Quang Tran,21,0,48,27
1656775314229,CSE 30,A01,083084,Eldon; John,4,0,80,76
1656775314229,CSE 30,B01,095061,Bhaskar; Nishant,5,0,50,45
1656775320253,CSE 100,A01,083659,Cao; Yingjun,1,4,70,69
1656775326284,CSE 134B,A01,083661,Powell; Thomas Allan,18,0,100,82
1656775332309,CSE 140,A01,083663,Gungor; Onat,14,0,85,71
1656775338336,CSE 140L,A01,083088,Eldon; John,16,0,100,84
1656775344362,CSE 175,A01,083665,Kumar; Rakesh,3,0,25,22
1656775350391,CSE 190,A00,092507,Dubnov; Shlomo,7,0,20,13
1656775356422,ECE 45,A01,083139,Congero; Spencer William,5,0,75,70
1656775362448,ECE 65,A50,083695,Saad; Andrew S,12,0,30,18
1656775362448,ECE 65,A51,095125,Saad; Andrew S,25,0,26,1
1656775368480,ECE 109,A01,091882,Touri; Behrouz,15,0,70,55
1656775374507,ECE 180,A00,083140,Abi Samra; Nicholas Camill,0,0,30,30
1656775374507,ECE 180,B00,083141,Abi Samra; Nicholas Camill,0,0,30,30
1656775380542,MATH 10A,A01,083735,Patchell; Gregory David,1,0,30,29
1656775380542,MATH 10A,A02,083736,Patchell; Gregory David,20,0,30,10
1656775380542,MATH 10A,A03,083737,Patchell; Gregory David,15,0,30,15
1656775386572,MATH 10B,A01,083207,Lim; Seonhee,7,0,34,27
1656775386572,MATH 10B,A02,083208,Lim; Seonhee,9,0,35,26
1656775386572,MATH 10B,A03,093472,Lim; Seonhee,4,0,34,30
1656775386572,MATH 10B,B01,083739,Sinha; Shubham,9,0,30,21
1656775392602,MATH 18,A01,083743,Cinel; Cameron Alexander,6,0,30,24
1656775392602,MATH 18,A02,083744,Cinel; Cameron Alexander,15,0,30,15
1656775392602,MATH 18,A03,083745,Cinel; Cameron Alexander,8,0,30,22
1656775392602,MATH 18,B01,083748,Rideout; David Porter,3,0,37,34
1656775392602,MATH 18,B02,083749,Rideout; David Porter,3,0,36,33
1656775392602,MATH 18,B03,083750,Rideout; David Porter,1,0,37,36
1656775392602,MATH 18,B04,083751,Rideout; David Porter,5,0,36,31
1656775392602,MATH 18,B05,093473,Rideout; David Porter,4,0,36,32
1656775392602,MATH 18,B06,093474,Rideout; David Porter,5,0,36,31
1656775398635,MATH 20A,A01,083754,Zheng; Zequn,12,0,40,28
1656775404676,MATH 20B,A01,083756,Briones; Jor-el Thomas Caparas,1,0,36,35
1656775404676,MATH 20B,A02,083757,Briones; Jor-el Thomas Caparas,1,0,36,35
1656775404676,MATH 20B,A03,093475,Briones; Jor-el Thomas Caparas,0,0,36,36
1656775410799,MATH 20C,A01,083760,Briones; Jor-el Thomas Caparas,1,0,35,34
1656775410799,MATH 20C,A02,083761,Briones; Jor-el Thomas Caparas,8,0,35,27
1656775410799,MATH 20C,A03,093476,Briones; Jor-el Thomas Caparas,0,1,36,36
1656775410799,MATH 20C,B01,083762,Bach; Quang Tran,0,0,30,30
1656775416824,MATH 20D,A01,083765,Tran; Brian Kha,4,0,30,26
1656775416824,MATH 20D,A02,083766,Tran; Brian Kha,4,0,30,26
1656775416824,MATH 20D,A03,083767,Tran; Brian Kha,2,0,30,28
1656775422858,MATH 20E,A01,083771,Ganguly; Soumya,5,0,32,27
1656775422858,MATH 20E,A02,083772,Ganguly; Soumya,5,0,32,27
1656775422858,MATH 20E,B01,083773,Ciotti; Benjamin,18,0,35,17
1656775422858,MATH 20E,B02,083774,Ciotti; Benjamin,17,0,35,18
1656775428886,MATH 103A,A01,083777,Greenfeld; Be'Eri,2,0,36,34
1656775428886,MATH 103A,A02,083778,Greenfeld; Be'Eri,5,0,36,31
1656775428886,MATH 103A,A03,093561,Greenfeld; Be'Eri,4,0,36,32
1656775428886,MATH 103A,B01,083779,Greenfeld; Be'Eri,6,0,36,30
1656775428886,MATH 103A,B02,083780,Greenfeld; Be'Eri,2,0,36,34
1656775428886,MATH 103A,B03,093562,Greenfeld; Be'Eri,2,0,36,34
1656775434911,MATH 105,A01,085443,Carter; Anne Toulson,13,0,35,22
1656775434911,MATH 105,A02,093477,Carter; Anne Toulson,20,0,35,15
1656775440938,MATH 109,A01,083213,Ganzberger; Geoffrey Michael,2,0,34,32
1656775440938,MATH 109,A02,083214,Ganzberger; Geoffrey Michael,2,0,34,32
1656775440938,MATH 109,A03,093478,Ganzberger; Geoffrey Michael,1,0,34,33
1656775440938,MATH 109,B01,083215,Ganzberger; Geoffrey Michael,1,0,32,31
1656775440938,MATH 109,B02,083216,Ganzberger; Geoffrey Michael,1,0,32,31
1656775440938,MATH 109,B03,093479,Ganzberger; Geoffrey Michael,6,0,32,26
1656775446964,MATH 142A,A01,083219,Chow; Bennett,6,0,32,26
1656775446964,MATH 142A,A02,083220,Chow; Bennett,9,0,32,23
1656775446964,MATH 142A,A03,093480,Chow; Bennett,7,0,32,25
1656775446964,MATH 142A,B03,093481,Chow; Bennett,7,0,32,25
1656775446964,MATH 142A,B04,093558,Chow; Bennett,10,0,32,22
1656775446964,MATH 142A,B05,093559,Chow; Bennett,6,0,32,26
1656775452990,MATH 193A,A01,083224,Rotar; Vladimir,6,0,34,28
1656775452990,MATH 193A,A02,083225,Rotar; Vladimir,3,0,34,31
1656775452990,MATH 193A,A03,083781,Rotar; Vladimir,1,0,34,33
1656775452990,MATH 193A,A04,083782,Rotar; Vladimir,6,0,34,28
1656775452990,MATH 193A,A05,093482,Rotar; Vladimir,6,0,34,28
1656775459016,MATH 197,001,091859,McAuley; Julian John,9999,0,9999,0
1656775459016,MATH 197,002,095566,Kedlaya; Kiran S.,9997,0,9999,2
1656775459016,MATH 197,003,095567,Xiao; Ming,9999,0,9999,0
1656775459016,MATH 197,004,095571,Perols; Johan Lars,9998,0,9999,1
1656775466085,COGS 9,A01,083615,Shannon; Kyle Michael,6,0,75,69
1656775472114,COGS 11,A01,083617,Boyle; Mary E. T.,18,0,48,30
1656775478140,COGS 13,A01,083071,Bastos; Amalia Pinkusfeld,8,0,71,63
1656775484166,COGS 14A,A01,092681,Semenuks; Arturs,0,1,100,100
1656775490192,COGS 14B,A01,083073,Cheng; Tzu-Han,5,0,63,58
1656775496223,COGS 17,A01,092677,Semenuks; Arturs,4,0,81,77
1656775502248,COGS 100,A01,083619,Allen; Michael Gordon,15,0,70,55
1656775508279,COGS 101A,A01,083621,Davis; Joshua Daniel,9,0,68,59
1656775514306,COGS 101B,A01,091572,Allen; Michael Gordon,8,0,65,57
1656775520335,COGS 101C,A01,083625,Delgado; Tania,17,0,35,18
1656775526364,COGS 107A,A01,083627,Boyle; Mary E. T.,13,0,60,47
1656775532390,COGS 118A,A01,083075,Gupta; Anjum,15,0,76,61
1656775538417,CSE 3,A50,083646,Miranda; Gregory Joseph,22,0,50,28
1656775544446,CSE 8A,A50,083650,Miranda; Gregory Joseph,17,1,56,39
1656775550474,CSE 11,A01,083080,Cao; Yingjun,4,15,40,36
1656775556505,CSE 12,A01,083652,Krause-Levy; Sophia Louisa,20,1,120,100
1656775562531,CSE 15L,A01,083654,Morris; Justin Loren,8,0,50,42
1656775562531,CSE 15L,A02,083655,Morris; Justin Loren,8,0,50,42
1656775568558,CSE 20,A01,083657,Tran; Khoa Dang,37,0,80,43
1656775574581,CSE 21,A01,095574,Bach; Quang Tran,21,0,48,27
1656775580616,CSE 30,A01,083084,Eldon; John,4,0,80,76
1656775580616,CSE 30,B01,095061,Bhaskar; Nishant,5,0,50,45
1656775586641,CSE 100,A01,083659,Cao; Yingjun,1,4,70,69
1656775592671,CSE 134B,A01,083661,Powell; Thomas Allan,18,0,100,82
1656775598701,CSE 140,A01,083663,Gungor; Onat,14,0,85,71
1656775604725,CSE 140L,A01,083088,Eldon; John,16,0,100,84
1656775610752,CSE 175,A01,083665,Kumar; Rakesh,3,0,25,22
1656775616782,CSE 190,A00,092507,Dubnov; Shlomo,7,0,20,13
1656775622815,ECE 45,A01,083139,Congero; Spencer William,5,0,75,70
1656775628849,ECE 65,A50,083695,Saad; Andrew S,12,0,30,18
1656775628849,ECE 65,A51,095125,Saad; Andrew S,25,0,26,1
1656775634878,ECE 109,A01,091882,Touri; Behrouz,15,0,70,55
1656775640908,ECE 180,A00,083140,Abi Samra; Nicholas Camill,0,0,30,30
1656775640908,ECE 180,B00,083141,Abi Samra; Nicholas Camill,0,0,30,30
1656775646935,MATH 10A,A01,083735,Patchell; Gregory David,1,0,30,29
1656775646935,MATH 10A,A02,083736,Patchell; Gregory David,20,0,30,10
1656775646935,MATH 10A,A03,083737,Patchell; Gregory David,15,0,30,15
1656775652964,MATH 10B,A01,083207,Lim; Seonhee,7,0,34,27
1656775652964,MATH 10B,A02,083208,Lim; Seonhee,9,0,35,26
1656775652964,MATH 10B,A03,093472,Lim; Seonhee,4,0,34,30
1656775652964,MATH 10B,B01,083739,Sinha; Shubham,9,0,30,21
1656775658993,MATH 18,A01,083743,Cinel; Cameron Alexander,6,0,30,24
1656775658993,MATH 18,A02,083744,Cinel; Cameron Alexander,15,0,30,15
1656775658993,MATH 18,A03,083745,Cinel; Cameron Alexander,8,0,30,22
1656775658993,MATH 18,B01,083748,Rideout; David Porter,3,0,37,34
1656775658993,MATH 18,B02,083749,Rideout; David Porter,3,0,36,33
1656775658993,MATH 18,B03,083750,Rideout; David Porter,1,0,37,36
1656775658993,MATH 18,B04,083751,Rideout; David Porter,5,0,36,31
1656775658993,MATH 18,B05,093473,Rideout; David Porter,4,0,36,32
1656775658993,MATH 18,B06,093474,Rideout; David Porter,5,0,36,31
1656775665018,MATH 20A,A01,083754,Zheng; Zequn,12,0,40,28
1656775671044,MATH 20B,A01,083756,Briones; Jor-el Thomas Caparas,1,0,36,35
1656775671044,MATH 20B,A02,083757,Briones; Jor-el Thomas Caparas,1,0,36,35
1656775671044,MATH 20B,A03,093475,Briones; Jor-el Thomas Caparas,0,0,36,36
1656775677069,MATH 20C,A01,083760,Briones; Jor-el Thomas Caparas,1,0,35,34
1656775677069,MATH 20C,A02,083761,Briones; Jor-el Thomas Caparas,8,0,35,27
1656775677069,MATH 20C,A03,093476,Briones; Jor-el Thomas Caparas,0,1,36,36
1656775677069,MATH 20C,B01,083762,Bach; Quang Tran,0,0,30,30
1656775683099,MATH 20D,A01,083765,Tran; Brian Kha,4,0,30,26
1656775683099,MATH 20D,A02,083766,Tran; Brian Kha,4,0,30,26
1656775683099,MATH 20D,A03,083767,Tran; Brian Kha,2,0,30,28
1656775689125,MATH 20E,A01,083771,Ganguly; Soumya,5,0,32,27
1656775689125,MATH 20E,A02,083772,Ganguly; Soumya,5,0,32,27
1656775689125,MATH 20E,B01,083773,Ciotti; Benjamin,18,0,35,17
1656775689125,MATH 20E,B02,083774,Ciotti; Benjamin,17,0,35,18
1656775695159,MATH 103A,A01,083777,Greenfeld; Be'Eri,2,0,36,34
1656775695159,MATH 103A,A02,083778,Greenfeld; Be'Eri,5,0,36,31
1656775695159,MATH 103A,A03,093561,Greenfeld; Be'Eri,4,0,36,32
1656775695159,MATH 103A,B01,083779,Greenfeld; Be'Eri,6,0,36,30
1656775695159,MATH 103A,B02,083780,Greenfeld; Be'Eri,2,0,36,34
1656775695159,MATH 103A,B03,093562,Greenfeld; Be'Eri,2,0,36,34
1656775701189,MATH 105,A01,085443,Carter; Anne Toulson,13,0,35,22
1656775701189,MATH 105,A02,093477,Carter; Anne Toulson,20,0,35,15
1656775707221,MATH 109,A01,083213,Ganzberger; Geoffrey Michael,2,0,34,32
1656775707221,MATH 109,A02,083214,Ganzberger; Geoffrey Michael,2,0,34,32
1656775707221,MATH 109,A03,093478,Ganzberger; Geoffrey Michael,1,0,34,33
1656775707221,MATH 109,B01,083215,Ganzberger; Geoffrey Michael,1,0,32,31
1656775707221,MATH 109,B02,083216,Ganzberger; Geoffrey Michael,1,0,32,31
1656775707221,MATH 109,B03,093479,Ganzberger; Geoffrey Michael,6,0,32,26
1656775713249,MATH 142A,A01,083219,Chow; Bennett,6,0,32,26
1656775713249,MATH 142A,A02,083220,Chow; Bennett,9,0,32,23
1656775713249,MATH 142A,A03,093480,Chow; Bennett,7,0,32,25
1656775713249,MATH 142A,B03,093481,Chow; Bennett,7,0,32,25
1656775713249,MATH 142A,B04,093558,Chow; Bennett,10,0,32,22
1656775713249,MATH 142A,B05,093559,Chow; Bennett,6,0,32,26
1656775719278,MATH 193A,A01,083224,Rotar; Vladimir,6,0,34,28
1656775719278,MATH 193A,A02,083225,Rotar; Vladimir,3,0,34,31
1656775719278,MATH 193A,A03,083781,Rotar; Vladimir,1,0,34,33
1656775719278,MATH 193A,A04,083782,Rotar; Vladimir,6,0,34,28
1656775719278,MATH 193A,A05,093482,Rotar; Vladimir,6,0,34,28
1656775725309,MATH 197,001,091859,McAuley; Julian John,9999,0,9999,0
1656775725309,MATH 197,002,095566,Kedlaya; Kiran S.,9997,0,9999,2
1656775725309,MATH 197,003,095567,Xiao; Ming,9999,0,9999,0
1656775725309,MATH 197,004,095571,Perols; Johan Lars,9998,0,9999,1
1656775732376,COGS 9,A01,083615,Shannon; Kyle Michael,6,0,75,69
1656775738407,COGS 11,A01,083617,Boyle; Mary E. T.,18,0,48,30
1656775744437,COGS 13,A01,083071,Bastos; Amalia Pinkusfeld,8,0,71,63
1656775750467,COGS 14A,A01,092681,Semenuks; Arturs,0,1,100,100
1656775756494,COGS 14B,A01,083073,Cheng; Tzu-Han,5,0,63,58
1656775762518,COGS 17,A01,092677,Semenuks; Arturs,4,0,81,77
1656775768545,COGS 100,A01,083619,Allen; Michael Gordon,15,0,70,55
1656775774580,COGS 101A,A01,083621,Davis; Joshua Daniel,9,0,68,59
1656775780605,COGS 101B,A01,091572,Allen; Michael Gordon,8,0,65,57
1656775786629,COGS 101C,A01,083625,Delgado; Tania,17,0,35,18
1656775792663,COGS 107A,A01,083627,Boyle; Mary E. T.,13,0,60,47
1656775798691,COGS 118A,A01,083075,Gupta; Anjum,15,0,76,61
1656775804720,CSE 3,A50,083646,Miranda; Gregory Joseph,22,0,50,28
1656775810743,CSE 8A,A50,083650,Miranda; Gregory Joseph,17,1,56,39
1656775816771,CSE 11,A01,083080,Cao; Yingjun,4,15,40,36
1656775822795,CSE 12,A01,083652,Krause-Levy; Sophia Louisa,20,1,120,100
1656775828819,CSE 15L,A01,083654,Morris; Justin Loren,8,0,50,42
1656775828819,CSE 15L,A02,083655,Morris; Justin Loren,8,0,50,42
1656775834845,CSE 20,A01,083657,Tran; Khoa Dang,37,0,80,43
1656775840871,CSE 21,A01,095574,Bach; Quang Tran,21,0,48,27
1656775846903,CSE 30,A01,083084,Eldon; John,4,0,80,76
1656775846903,CSE 30,B01,095061,Bhaskar; Nishant,5,0,50,45
1656775852929,CSE 100,A01,083659,Cao; Yingjun,1,4,70,69
1656775858957,CSE 134B,A01,083661,Powell; Thomas Allan,18,0,100,82
1656775864982,CSE 140,A01,083663,Gungor; Onat,14,0,85,71
1656775871011,CSE 140L,A01,083088,Eldon; John,16,0,100,84
1656775877034,CSE 175,A01,083665,Kumar; Rakesh,3,0,25,22
1656775883060,CSE 190,A00,092507,Dubnov; Shlomo,7,0,20,13
1656775889085,ECE 45,A01,083139,Congero; Spencer William,5,0,75,70
1656775895110,ECE 65,A50,083695,Saad; Andrew S,12,0,30,18
1656775895110,ECE 65,A51,095125,Saad; Andrew S,25,0,26,1
1656775901137,ECE 109,A01,091882,Touri; Behrouz,15,0,70,55
1656775907162,ECE 180,A00,083140,Abi Samra; Nicholas Camill,0,0,30,30
1656775907162,ECE 180,B00,083141,Abi Samra; Nicholas Camill,0,0,30,30
1656775913194,MATH 10A,A01,083735,Patchell; Gregory David,1,0,30,29
1656775913194,MATH 10A,A02,083736,Patchell; Gregory David,20,0,30,10
1656775913194,MATH 10A,A03,083737,Patchell; Gregory David,15,0,30,15
1656775919230,MATH 10B,A01,083207,Lim; Seonhee,7,0,34,27
1656775919230,MATH 10B,A02,083208,Lim; Seonhee,9,0,35,26
1656775919230,MATH 10B,A03,093472,Lim; Seonhee,4,0,34,30
1656775919230,MATH 10B,B01,083739,Sinha; Shubham,9,0,30,21
1656775925260,MATH 18,A01,083743,Cinel; Cameron Alexander,6,0,30,24
1656775925260,MATH 18,A02,083744,Cinel; Cameron Alexander,15,0,30,15
1656775925260,MATH 18,A03,083745,Cinel; Cameron Alexander,8,0,30,22
1656775925260,MATH 18,B01,083748,Rideout; David Porter,3,0,37,34
1656775925260,MATH 18,B02,083749,Rideout; David Porter,3,0,36,33
1656775925260,MATH 18,B03,083750,Rideout; David Porter,1,0,37,36
1656775925260,MATH 18,B04,083751,Rideout; David Porter,5,0,36,31
1656775925260,MATH 18,B05,093473,Rideout; David Porter,4,0,36,32
1656775925260,MATH 18,B06,093474,Rideout; David Porter,5,0,36,31
1656775931284,MATH 20A,A01,083754,Zheng; Zequn,12,0,40,28
1656775937313,MATH 20B,A01,083756,Briones; Jor-el Thomas Caparas,1,0,36,35
1656775937313,MATH 20B,A02,083757,Briones; Jor-el Thomas Caparas,1,0,36,35
1656775937313,MATH 20B,A03,093475,Briones; Jor-el Thomas Caparas,0,0,36,36
1656775943346,MATH 20C,A01,083760,Briones; Jor-el Thomas Caparas,1,0,35,34
1656775943346,MATH 20C,A02,083761,Briones; Jor-el Thomas Caparas,8,0,35,27
1656775943346,MATH 20C,A03,093476,Briones; Jor-el Thomas Caparas,0,1,36,36
1656775943346,MATH 20C,B01,083762,Bach; Quang Tran,0,0,30,30
1656775949372,MATH 20D,A01,083765,Tran; Brian Kha,4,0,30,26
1656775949372,MATH 20D,A02,083766,Tran; Brian Kha,4,0,30,26
1656775949372,MATH 20D,A03,083767,Tran; Brian Kha,2,0,30,28
1656775955401,MATH 20E,A01,083771,Ganguly; Soumya,5,0,32,27
1656775955401,MATH 20E,A02,083772,Ganguly; Soumya,5,0,32,27
1656775955401,MATH 20E,B01,083773,Ciotti; Benjamin,18,0,35,17
1656775955401,MATH 20E,B02,083774,Ciotti; Benjamin,17,0,35,18
1656775961429,MATH 103A,A01,083777,Greenfeld; Be'Eri,2,0,36,34
1656775961429,MATH 103A,A02,083778,Greenfeld; Be'Eri,5,0,36,31
1656775961429,MATH 103A,A03,093561,Greenfeld; Be'Eri,4,0,36,32
1656775961429,MATH 103A,B01,083779,Greenfeld; Be'Eri,6,0,36,30
1656775961429,MATH 103A,B02,083780,Greenfeld; Be'Eri,2,0,36,34
1656775961429,MATH 103A,B03,093562,Greenfeld; Be'Eri,2,0,36,34
1656775967460,MATH 105,A01,085443,Carter; Anne Toulson,13,0,35,22
1656775967460,MATH 105,A02,093477,Carter; Anne Toulson,20,0,35,15
1656775973488,MATH 109,A01,083213,Ganzberger; Geoffrey Michael,2,0,34,32
1656775973488,MATH 109,A02,083214,Ganzberger; Geoffrey Michael,2,0,34,32
1656775973488,MATH 109,A03,093478,Ganzberger; Geoffrey Michael,1,0,34,33
1656775973488,MATH 109,B01,083215,Ganzberger; Geoffrey Michael,1,0,32,31
1656775973488,MATH 109,B02,083216,Ganzberger; Geoffrey Michael,1,0,32,31
1656775973488,MATH 109,B03,093479,Ganzberger; Geoffrey Michael,6,0,32,26
1656775979549,MATH 142A,A01,083219,Chow; Bennett,6,0,32,26
1656775979549,MATH 142A,A02,083220,Chow; Bennett,9,0,32,23
1656775979549,MATH 142A,A03,093480,Chow; Bennett,7,0,32,25
1656775979549,MATH 142A,B03,093481,Chow; Bennett,7,0,32,25
1656775979549,MATH 142A,B04,093558,Chow; Bennett,10,0,32,22
1656775979549,MATH 142A,B05,093559,Chow; Bennett,6,0,32,26
1656775985580,MATH 193A,A01,083224,Rotar; Vladimir,6,0,34,28
1656775985580,MATH 193A,A02,083225,Rotar; Vladimir,3,0,34,31
1656775985580,MATH 193A,A03,083781,Rotar; Vladimir,1,0,34,33
1656775985580,MATH 193A,A04,083782,Rotar; Vladimir,6,0,34,28
1656775985580,MATH 193A,A05,093482,Rotar; Vladimir,6,0,34,28
1656775991609,MATH 197,001,091859,McAuley; Julian John,9999,0,9999,0
1656775991609,MATH 197,002,095566,Kedlaya; Kiran S.,9997,0,9999,2
1656775991609,MATH 197,003,095567,Xiao; Ming,9999,0,9999,0
1656775991609,MATH 197,004,095571,Perols; Johan Lars,9998,0,9999,1
1656775998688,COGS 9,A01,083615,Shannon; Kyle Michael,6,0,75,69
1656776004792,COGS 11,A01,083617,Boyle; Mary E. T.,18,0,48,30
1656776010817,COGS 13,A01,083071,Bastos; Amalia Pinkusfeld,8,0,71,63
1656776016843,COGS 14A,A01,092681,Semenuks; Arturs,0,1,100,100
1656776022869,COGS 14B,A01,083073,Cheng; Tzu-Han,5,0,63,58
1656776028896,COGS 17,A01,092677,Semenuks; Arturs,4,0,81,77
1656776034927,COGS 100,A01,083619,Allen; Michael Gordon,15,0,70,55
1656776040957,COGS 101A,A01,083621,Davis; Joshua Daniel,9,0,68,59
1656776046986,COGS 101B,A01,091572,Allen; Michael Gordon,8,0,65,57
1656776053012,COGS 101C,A01,083625,Delgado; Tania,17,0,35,18
1656776059037,COGS 107A,A01,083627,Boyle; Mary E. T.,13,0,60,47
1656776065062,COGS 118A,A01,083075,Gupta; Anjum,15,0,76,61
1656776071095,CSE 3,A50,083646,Miranda; Gregory Joseph,22,0,50,28
1656776077119,CSE 8A,A50,083650,Miranda; Gregory Joseph,17,1,56,39
1656776083145,CSE 11,A01,083080,Cao; Yingjun,4,15,40,36
1656776089174,CSE 12,A01,083652,Krause-Levy; Sophia Louisa,20,1,120,100
1656776095200,CSE 15L,A01,083654,Morris; Justin Loren,8,0,50,42
1656776095200,CSE 15L,A02,083655,Morris; Justin Loren,8,0,50,42
1656776101227,CSE 20,A01,083657,Tran; Khoa Dang,37,0,80,43
1656776107257,CSE 21,A01,095574,Bach; Quang Tran,21,0,48,27
1656776113284,CSE 30,A01,083084,Eldon; John,4,0,80,76
1656776113284,CSE 30,B01,095061,Bhaskar; Nishant,5,0,50,45
1656776119313,CSE 100,A01,083659,Cao; Yingjun,1,4,70,69
1656776125338,CSE 134B,A01,083661,Powell; Thomas Allan,18,0,100,82
1656776131364,CSE 140,A01,083663,Gungor; Onat,14,0,85,71
1656776137390,CSE 140L,A01,083088,Eldon; John,16,0,100,84
1656776143415,CSE 175,A01,083665,Kumar; Rakesh,3,0,25,22
1656776149441,CSE 190,A00,092507,Dubnov; Shlomo,7,0,20,13
1656776155468,ECE 45,A01,083139,Congero; Spencer William,5,0,75,70
1656776161498,ECE 65,A50,083695,Saad; Andrew S,12,0,30,18
1656776161498,ECE 65,A51,095125,Saad; Andrew S,25,0,26,1
1656776167522,ECE 109,A01,091882,Touri; Behrouz,15,0,70,55
1656776173548,ECE 180,A00,083140,Abi Samra; Nicholas Camill,0,0,30,30
1656776173548,ECE 180,B00,083141,Abi Samra; Nicholas Camill,0,0,30,30
1656776179580,MATH 10A,A01,083735,Patchell; Gregory David,1,0,30,29
1656776179580,MATH 10A,A02,083736,Patchell; Gregory David,20,0,30,10
1656776179580,MATH 10A,A03,083737,Patchell; Gregory David,15,0,30,15
1656776185616,MATH 10B,A01,083207,Lim; Seonhee,7,0,34,27
1656776185616,MATH 10B,A02,083208,Lim; Seonhee,9,0,35,26
1656776185616,MATH 10B,A03,093472,Lim; Seonhee,4,0,34,30
1656776185616,MATH 10B,B01,083739,Sinha; Shubham,9,0,30,21
1656776191652,MATH 18,A01,083743,Cinel; Cameron Alexander,6,0,30,24
1656776191652,MATH 18,A02,083744,Cinel; Cameron Alexander,15,0,30,15
1656776191652,MATH 18,A03,083745,Cinel; Cameron Alexander,8,0,30,22
1656776191652,MATH 18,B01,083748,Rideout; David Porter,3,0,37,34
1656776191652,MATH 18,B02,083749,Rideout; David Porter,3,0,36,33
1656776191652,MATH 18,B03,083750,Rideout; David Porter,1,0,37,36
1656776191652,MATH 18,B04,083751,Rideout; David Porter,5,0,36,31
1656776191652,MATH 18,B05,093473,Rideout; David Porter,4,0,36,32
1656776191652,MATH 18,B06,093474,Rideout; David Porter,5,0,36,31
1656776197675,MATH 20A,A01,083754,Zheng; Zequn,12,0,40,28
1656776203702,MATH 20B,A01,083756,Briones; Jor-el Thomas Caparas,1,0,36,35
1656776203702,MATH 20B,A02,083757,Briones; Jor-el Thomas Caparas,1,0,36,35
1656776203702,MATH 20B,A03,093475,Briones; Jor-el Thomas Caparas,0,0,36,36
1656776209727,MATH 20C,A01,083760,Briones; Jor-el Thomas Caparas,1,0,35,34
1656776209727,MATH 20C,A02,083761,Briones; Jor-el Thomas Caparas,8,0,35,27
1656776209727,MATH 20C,A03,093476,Briones; Jor-el Thomas Caparas,0,1,36,36
1656776209727,MATH 20C,B01,083762,Bach; Quang Tran,0,0,30,30
1656776215751,MATH 20D,A01,083765,Tran; Brian Kha,4,0,30,26
1656776215751,MATH 20D,A02,083766,Tran; Brian Kha,4,0,30,26
1656776215751,MATH 20D,A03,083767,Tran; Brian Kha,2,0,30,28
1656776221778,MATH 20E,A01,083771,Ganguly; Soumya,5,0,32,27
1656776221778,MATH 20E,A02,083772,Ganguly; Soumya,5,0,32,27
1656776221778,MATH 20E,B01,083773,Ciotti; Benjamin,18,0,35,17
1656776221778,MATH 20E,B02,083774,Ciotti; Benjamin,17,0,35,18
1656776227812,MATH 103A,A01,083777,Greenfeld; Be'Eri,2,0,36,34
1656776227812,MATH 103A,A02,083778,Greenfeld; Be'Eri,5,0,36,31
1656776227812,MATH 103A,A03,093561,Greenfeld; Be'Eri,4,0,36,32
1656776227812,MATH 103A,B01,083779,Greenfeld; Be'Eri,6,0,36,30
1656776227812,MATH 103A,B02,083780,Greenfeld; Be'Eri,2,0,36,34
1656776227812,MATH 103A,B03,093562,Greenfeld; Be'Eri,2,0,36,34
1656776233843,MATH 105,A01,085443,Carter; Anne Toulson,13,0,35,22
1656776233843,MATH 105,A02,093477,Carter; Anne Toulson,20,0,35,15
1656776239874,MATH 109,A01,083213,Ganzberger; Geoffrey Michael,2,0,34,32
1656776239874,MATH 109,A02,083214,Ganzberger; Geoffrey Michael,2,0,34,32
1656776239874,MATH 109,A03,093478,Ganzberger; Geoffrey Michael,1,0,34,33
1656776239874,MATH 109,B01,083215,Ganzberger; Geoffrey Michael,1,0,32,31
1656776239874,MATH 109,B02,083216,Ganzberger; Geoffrey Michael,1,0,32,31
1656776239874,MATH 109,B03,093479,Ganzberger; Geoffrey Michael,6,0,32,26
1656776245902,MATH 142A,A01,083219,Chow; Bennett,6,0,32,26
1656776245902,MATH 142A,A02,083220,Chow; Bennett,9,0,32,23
1656776245902,MATH 142A,A03,093480,Chow; Bennett,7,0,32,25
1656776245902,MATH 142A,B03,093481,Chow; Bennett,7,0,32,25
1656776245902,MATH 142A,B04,093558,Chow; Bennett,10,0,32,22
1656776245902,MATH 142A,B05,093559,Chow; Bennett,6,0,32,26
1656776251933,MATH 193A,A01,083224,Rotar; Vladimir,6,0,34,28
1656776251933,MATH 193A,A02,083225,Rotar; Vladimir,3,0,34,31
1656776251933,MATH 193A,A03,083781,Rotar; Vladimir,1,0,34,33
1656776251933,MATH 193A,A04,083782,Rotar; Vladimir,6,0,34,28
1656776251933,MATH 193A,A05,093482,Rotar; Vladimir,6,0,34,28
1656776257962,MATH 197,001,091859,McAuley; Julian John,9999,0,9999,0
1656776257962,MATH 197,002,095566,Kedlaya; Kiran S.,9997,0,9999,2
1656776257962,MATH 197,003,095567,Xiao; Ming,9999,0,9999,0
1656776257962,MATH 197,004,095571,Perols; Johan Lars,9998,0,9999,1
1656776265039,COGS 9,A01,083615,Shannon; Kyle Michael,6,0,75,69
1656776271063,COGS 11,A01,083617,Boyle; Mary E. T.,18,0,48,30
1656776277087,COGS 13,A01,083071,Bastos; Amalia Pinkusfeld,8,0,71,63
1656776283127,COGS 14A,A01,092681,Semenuks; Arturs,0,1,100,100
1656776289151,COGS 14B,A01,083073,Cheng; Tzu-Han,5,0,63,58
1656776295177,COGS 17,A01,092677,Semenuks; Arturs,4,0,81,77
1656776301200,COGS 100,A01,083619,Allen; Michael Gordon,15,0,70,55
1656776307226,COGS 101A,A01,083621,Davis; Joshua Daniel,9,0,68,59
1656776313251,COGS 101B,A01,091572,Allen; Michael Gordon,8,0,65,57
1656776319280,COGS 101C,A01,083625,Delgado; Tania,17,0,35,18
1656776325314,COGS 107A,A01,083627,Boyle; Mary E. T.,13,0,60,47
1656776331338,COGS 118A,A01,083075,Gupta; Anjum,15,0,76,61
1656776337370,CSE 3,A50,083646,Miranda; Gregory Joseph,22,0,50,28
1656776343393,CSE 8A,A50,083650,Miranda; Gregory Joseph,17,1,56,39
1656776349421,CSE 11,A01,083080,Cao; Yingjun,4,15,40,36
1656776355450,CSE 12,A01,083652,Krause-Levy; Sophia Louisa,20,1,120,100
1656776361473,CSE 15L,A01,083654,Morris; Justin Loren,8,0,50,42
1656776361473,CSE 15L,A02,083655,Morris; Justin Loren,8,0,50,42
1656776367498,CSE 20,A01,083657,Tran; Khoa Dang,37,0,80,43
1656776373523,CSE 21,A01,095574,Bach; Quang Tran,21,0,48,27
1656776379556,CSE 30,A01,083084,Eldon; John,4,0,80,76
1656776379556,CSE 30,B01,095061,Bhaskar; Nishant,5,0,50,45
1656776385580,CSE 100,A01,083659,Cao; Yingjun,1,4,70,69
1656776391610,CSE 134B,A01,083661,Powell; Thomas Allan,18,0,100,82
1656776397634,CSE 140,A01,083663,Gungor; Onat,14,0,85,71
1656776403659,CSE 140L,A01,083088,Eldon; John,16,0,100,84
1656776409689,CSE 175,A01,083665,Kumar; Rakesh,3,0,25,22
1656776415726,CSE 190,A00,092507,Dubnov; Shlomo,7,0,20,13
1656776421759,ECE 45,A01,083139,Congero; Spencer William,5,0,75,70
1656776427790,ECE 65,A50,083695,Saad; Andrew S,12,0,30,18
1656776427790,ECE 65,A51,095125,Saad; Andrew S,25,0,26,1
1656776433816,ECE 109,A01,091882,Touri; Behrouz,15,0,70,55
1656776439845,ECE 180,A00,083140,Abi Samra; Nicholas Camill,0,0,30,30
1656776439845,ECE 180,B00,083141,Abi Samra; Nicholas Camill,0,0,30,30
1656776445886,MATH 10A,A01,083735,Patchell; Gregory David,1,0,30,29
1656776445886,MATH 10A,A02,083736,Patchell; Gregory David,20,0,30,10
1656776445886,MATH 10A,A03,083737,Patchell; Gregory David,15,0,30,15
1656776451920,MATH 10B,A01,083207,Lim; Seonhee,7,0,34,27
1656776451920,MATH 10B,A02,083208,Lim; Seonhee,9,0,35,26
1656776451920,MATH 10B,A03,093472,Lim; Seonhee,4,0,34,30
1656776451920,MATH 10B,B01,083739,Sinha; Shubham,9,0,30,21
1656776457948,MATH 18,A01,083743,Cinel; Cameron Alexander,6,0,30,24
1656776457948,MATH 18,A02,083744,Cinel; Cameron Alexander,15,0,30,15
1656776457948,MATH 18,A03,083745,Cinel; Cameron Alexander,8,0,30,22
1656776457948,MATH 18,B01,083748,Rideout; David Porter,3,0,37,34
1656776457948,MATH 18,B02,083749,Rideout; David Porter,3,0,36,33
1656776457948,MATH 18,B03,083750,Rideout; David Porter,1,0,37,36
1656776457948,MATH 18,B04,083751,Rideout; David Porter,5,0,36,31
1656776457948,MATH 18,B05,093473,Rideout; David Porter,4,0,36,32
1656776457948,MATH 18,B06,093474,Rideout; David Porter,5,0,36,31
1656776463978,MATH 20A,A01,083754,Zheng; Zequn,12,0,40,28
1656776470015,MATH 20B,A01,083756,Briones; Jor-el Thomas Caparas,1,0,36,35
1656776470015,MATH 20B,A02,083757,Briones; Jor-el Thomas Caparas,1,0,36,35
1656776470015,MATH 20B,A03,093475,Briones; Jor-el Thomas Caparas,0,0,36,36
1656776476040,MATH 20C,A01,083760,Briones; Jor-el Thomas Caparas,1,0,35,34
1656776476040,MATH 20C,A02,083761,Briones; Jor-el Thomas Caparas,8,0,35,27
1656776476040,MATH 20C,A03,093476,Briones; Jor-el Thomas Caparas,0,1,36,36
1656776476040,MATH 20C,B01,083762,Bach; Quang Tran,0,0,30,30
1656776482072,MATH 20D,A01,083765,Tran; Brian Kha,4,0,30,26
1656776482072,MATH 20D,A02,083766,Tran; Brian Kha,4,0,30,26
1656776482072,MATH 20D,A03,083767,Tran; Brian Kha,2,0,30,28
1656776488100,MATH 20E,A01,083771,Ganguly; Soumya,5,0,32,27
1656776488100,MATH 20E,A02,083772,Ganguly; Soumya,5,0,32,27
1656776488100,MATH 20E,B01,083773,Ciotti; Benjamin,18,0,35,17
1656776488100,MATH 20E,B02,083774,Ciotti; Benjamin,17,0,35,18
1656776494128,MATH 103A,A01,083777,Greenfeld; Be'Eri,2,0,36,34
1656776494128,MATH 103A,A02,083778,Greenfeld; Be'Eri,5,0,36,31
1656776494128,MATH 103A,A03,093561,Greenfeld; Be'Eri,4,0,36,32
1656776494128,MATH 103A,B01,083779,Greenfeld; Be'Eri,6,0,36,30
1656776494128,MATH 103A,B02,083780,Greenfeld; Be'Eri,2,0,36,34
1656776494128,MATH 103A,B03,093562,Greenfeld; Be'Eri,2,0,36,34
1656776500153,MATH 105,A01,085443,Carter; Anne Toulson,13,0,35,22
1656776500153,MATH 105,A02,093477,Carter; Anne Toulson,20,0,35,15
1656776506180,MATH 109,A01,083213,Ganzberger; Geoffrey Michael,2,0,34,32
1656776506180,MATH 109,A02,083214,Ganzberger; Geoffrey Michael,2,0,34,32
1656776506180,MATH 109,A03,093478,Ganzberger; Geoffrey Michael,1,0,34,33
1656776506180,MATH 109,B01,083215,Ganzberger; Geoffrey Michael,1,0,32,31
1656776506180,MATH 109,B02,083216,Ganzberger; Geoffrey Michael,1,0,32,31
1656776506180,MATH 109,B03,093479,Ganzberger; Geoffrey Michael,6,0,32,26
1656776512214,MATH 142A,A01,083219,Chow; Bennett,6,0,32,26
1656776512214,MATH 142A,A02,083220,Chow; Bennett,9,0,32,23
1656776512214,MATH 142A,A03,093480,Chow; Bennett,7,0,32,25
1656776512214,MATH 142A,B03,093481,Chow; Bennett,7,0,32,25
1656776512214,MATH 142A,B04,093558,Chow; Bennett,10,0,32,22
1656776512214,MATH 142A,B05,093559,Chow; Bennett,6,0,32,26
1656776518241,MATH 193A,A01,083224,Rotar; Vladimir,6,0,34,28
1656776518241,MATH 193A,A02,083225,Rotar; Vladimir,3,0,34,31
1656776518241,MATH 193A,A03,083781,Rotar; Vladimir,1,0,34,33
1656776518241,MATH 193A,A04,083782,Rotar; Vladimir,6,0,34,28
1656776518241,MATH 193A,A05,093482,Rotar; Vladimir,6,0,34,28
1656776524267,MATH 197,001,091859,McAuley; Julian John,9999,0,9999,0
1656776524267,MATH 197,002,095566,Kedlaya; Kiran S.,9997,0,9999,2
1656776524267,MATH 197,003,095567,Xiao; Ming,9999,0,9999,0
1656776524267,MATH 197,004,095571,Perols; Johan Lars,9998,0,9999,1
1656776531339,COGS 9,A01,083615,Shannon; Kyle Michael,6,0,75,69
1656776537365,COGS 11,A01,083617,Boyle; Mary E. T.,18,0,48,30
1656776543392,COGS 13,A01,083071,Bastos; Amalia Pinkusfeld,8,0,71,63
1656776549422,COGS 14A,A01,092681,Semenuks; Arturs,0,1,100,100
1656776555445,COGS 14B,A01,083073,Cheng; Tzu-Han,5,0,63,58
1656776561470,COGS 17,A01,092677,Semenuks; Arturs,4,0,81,77
1656776567497,COGS 100,A01,083619,Allen; Michael Gordon,15,0,70,55
1656776573523,COGS 101A,A01,083621,Davis; Joshua Daniel,9,0,68,59
1656776579556,COGS 101B,A01,091572,Allen; Michael Gordon,8,0,65,57
1656776585587,COGS 101C,A01,083625,Delgado; Tania,17,0,35,18
1656776591610,COGS 107A,A01,083627,Boyle; Mary E. T.,13,0,60,47
1656776597635,COGS 118A,A01,083075,Gupta; Anjum,15,0,76,61
1656776603734,CSE 3,A50,083646,Miranda; Gregory Joseph,22,0,50,28
1656776609757,CSE 8A,A50,083650,Miranda; Gregory Joseph,17,1,56,39
1656776615787,CSE 11,A01,083080,Cao; Yingjun,4,15,40,36
1656776621821,CSE 12,A01,083652,Krause-Levy; Sophia Louisa,20,1,120,100
1656776627846,CSE 15L,A01,083654,Morris; Justin Loren,8,0,50,42
1656776627846,CSE 15L,A02,083655,Morris; Justin Loren,8,0,50,42
1656776633874,CSE 20,A01,083657,Tran; Khoa Dang,37,0,80,43
1656776639900,CSE 21,A01,095574,Bach; Quang Tran,21,0,48,27
1656776645925,CSE 30,A01,083084,Eldon; John,4,0,80,76
1656776645925,CSE 30,B01,095061,Bhaskar; Nishant,5,0,50,45
1656776651949,CSE 100,A01,083659,Cao; Yingjun,1,4,70,69
1656776657976,CSE 134B,A01,083661,Powell; Thomas Allan,18,0,100,82
1656776664004,CSE 140,A01,083663,Gungor; Onat,14,0,85,71
1656776670028,CSE 140L,A01,083088,Eldon; John,16,0,100,84
1656776676052,CSE 175,A01,083665,Kumar; Rakesh,3,0,25,22
1656776682076,CSE 190,A00,092507,Dubnov; Shlomo,7,0,20,13
1656776688106,ECE 45,A01,083139,Congero; Spencer William,5,0,75,70
1656776694132,ECE 65,A50,083695,Saad; Andrew S,12,0,30,18
1656776694132,ECE 65,A51,095125,Saad; Andrew S,25,0,26,1
1656776700158,ECE 109,A01,091882,Touri; Behrouz,15,0,70,55
1656776706182,ECE 180,A00,083140,Abi Samra; Nicholas Camill,0,0,30,30
1656776706182,ECE 180,B00,083141,Abi Samra; Nicholas Camill,0,0,30,30
1656776712214,MATH 10A,A01,083735,Patchell; Gregory David,1,0,30,29
1656776712214,MATH 10A,A02,083736,Patchell; Gregory David,20,0,30,10
1656776712214,MATH 10A,A03,083737,Patchell; Gregory David,15,0,30,15
1656776718257,MATH 10B,A01,083207,Lim; Seonhee,7,0,34,27
1656776718257,MATH 10B,A02,083208,Lim; Seonhee,9,0,35,26
1656776718257,MATH 10B,A03,093472,Lim; Seonhee,4,0,34,30
1656776718257,MATH 10B,B01,083739,Sinha; Shubham,9,0,30,21
1656776724287,MATH 18,A01,083743,Cinel; Cameron Alexander,6,0,30,24
1656776724287,MATH 18,A02,083744,Cinel; Cameron Alexander,15,0,30,15
1656776724287,MATH 18,A03,083745,Cinel; Cameron Alexander,8,0,30,22
1656776724287,MATH 18,B01,083748,Rideout; David Porter,3,0,37,34
1656776724287,MATH 18,B02,083749,Rideout; David Porter,3,0,36,33
1656776724287,MATH 18,B03,083750,Rideout; David Porter,1,0,37,36
1656776724287,MATH 18,B04,083751,Rideout; David Porter,5,0,36,31
1656776724287,MATH 18,B05,093473,Rideout; David Porter,4,0,36,32
1656776724287,MATH 18,B06,093474,Rideout; David Porter,5,0,36,31
1656776730313,MATH 20A,A01,083754,Zheng; Zequn,12,0,40,28
1656776736338,MATH 20B,A01,083756,Briones; Jor-el Thomas Caparas,1,0,36,35
1656776736338,MATH 20B,A02,083757,Briones; Jor-el Thomas Caparas,1,0,36,35
1656776736338,MATH 20B,A03,093475,Briones; Jor-el Thomas Caparas,0,0,36,36
1656776742366,MATH 20C,A01,083760,Briones; Jor-el Thomas Caparas,1,0,35,34
1656776742366,MATH 20C,A02,083761,Briones; Jor-el Thomas Caparas,8,0,35,27
1656776742366,MATH 20C,A03,093476,Briones; Jor-el Thomas Caparas,0,1,36,36
1656776742366,MATH 20C,B01,083762,Bach; Quang Tran,0,0,30,30
1656776748396,MATH 20D,A01,083765,Tran; Brian Kha,4,0,30,26
1656776748396,MATH 20D,A02,083766,Tran; Brian Kha,4,0,30,26
1656776748396,MATH 20D,A03,083767,Tran; Brian Kha,2,0,30,28
1656776754427,MATH 20E,A01,083771,Ganguly; Soumya,5,0,32,27
1656776754427,MATH 20E,A02,083772,Ganguly; Soumya,5,0,32,27
1656776754427,MATH 20E,B01,083773,Ciotti; Benjamin,18,0,35,17
1656776754427,MATH 20E,B02,083774,Ciotti; Benjamin,17,0,35,18
1656776760464,MATH 103A,A01,083777,Greenfeld; Be'Eri,2,0,36,34
1656776760464,MATH 103A,A02,083778,Greenfeld; Be'Eri,5,0,36,31
1656776760464,MATH 103A,A03,093561,Greenfeld; Be'Eri,4,0,36,32
1656776760464,MATH 103A,B01,083779,Greenfeld; Be'Eri,6,0,36,30
1656776760464,MATH 103A,B02,083780,Greenfeld; Be'Eri,2,0,36,34
1656776760464,MATH 103A,B03,093562,Greenfeld; Be'Eri,2,0,36,34
1656776766489,MATH 105,A01,085443,Carter; Anne Toulson,13,0,35,22
1656776766489,MATH 105,A02,093477,Carter; Anne Toulson,20,0,35,15
1656776772520,MATH 109,A01,083213,Ganzberger; Geoffrey Michael,2,0,34,32
1656776772520,MATH 109,A02,083214,Ganzberger; Geoffrey Michael,2,0,34,32
1656776772520,MATH 109,A03,093478,Ganzberger; Geoffrey Michael,1,0,34,33
1656776772520,MATH 109,B01,083215,Ganzberger; Geoffrey Michael,1,0,32,31
1656776772520,MATH 109,B02,083216,Ganzberger; Geoffrey Michael,1,0,32,31
1656776772520,MATH 109,B03,093479,Ganzberger; Geoffrey Michael,6,0,32,26
1656776778547,MATH 142A,A01,083219,Chow; Bennett,6,0,32,26
1656776778547,MATH 142A,A02,083220,Chow; Bennett,9,0,32,23
1656776778547,MATH 142A,A03,093480,Chow; Bennett,7,0,32,25
1656776778547,MATH 142A,B03,093481,Chow; Bennett,7,0,32,25
1656776778547,MATH 142A,B04,093558,Chow; Bennett,10,0,32,22
1656776778547,MATH 142A,B05,093559,Chow; Bennett,6,0,32,26
1656776784581,MATH 193A,A01,083224,Rotar; Vladimir,6,0,34,28
1656776784581,MATH 193A,A02,083225,Rotar; Vladimir,3,0,34,31
1656776784581,MATH 193A,A03,083781,Rotar; Vladimir,1,0,34,33
1656776784581,MATH 193A,A04,083782,Rotar; Vladimir,6,0,34,28
1656776784581,MATH 193A,A05,093482,Rotar; Vladimir,6,0,34,28
1656776790607,MATH 197,001,091859,McAuley; Julian John,9999,0,9999,0
1656776790607,MATH 197,002,095566,Kedlaya; Kiran S.,9997,0,9999,2
1656776790607,MATH 197,003,095567,Xiao; Ming,9999,0,9999,0
1656776790607,MATH 197,004,095571,Perols; Johan Lars,9998,0,9999,1
1656776797673,COGS 9,A01,083615,Shannon; Kyle Michael,6,0,75,69
1656776803700,COGS 11,A01,083617,Boyle; Mary E. T.,18,0,48,30
1656776809723,COGS 13,A01,083071,Bastos; Amalia Pinkusfeld,8,0,71,63
1656776815747,COGS 14A,A01,092681,Semenuks; Arturs,0,1,100,100
1656776821773,COGS 14B,A01,083073,Cheng; Tzu-Han,5,0,63,58
1656776827804,COGS 17,A01,092677,Semenuks; Arturs,4,0,81,77
1656776833833,COGS 100,A01,083619,Allen; Michael Gordon,15,0,70,55
1656776839858,COGS 101A,A01,083621,Davis; Joshua Daniel,9,0,68,59
1656776845882,COGS 101B,A01,091572,Allen; Michael Gordon,8,0,65,57
1656776851906,COGS 101C,A01,083625,Delgado; Tania,17,0,35,18
1656776857936,COGS 107A,A01,083627,Boyle; Mary E. T.,13,0,60,47
1656776863963,COGS 118A,A01,083075,Gupta; Anjum,15,0,76,61
1656776869990,CSE 3,A50,083646,Miranda; Gregory Joseph,22,0,50,28
1656776876016,CSE 8A,A50,083650,Miranda; Gregory Joseph,17,1,56,39
1656776882040,CSE 11,A01,083080,Cao; Yingjun,4,15,40,36
1656776888064,CSE 12,A01,083652,Krause-Levy; Sophia Louisa,20,1,120,100
1656776894088,CSE 15L,A01,083654,Morris; Justin Loren,8,0,50,42
1656776894088,CSE 15L,A02,083655,Morris; Justin Loren,8,0,50,42
1656776900116,CSE 20,A01,083657,Tran; Khoa Dang,37,0,80,43
1656776906143,CSE 21,A01,095574,Bach; Quang Tran,21,0,48,27
1656776912174,CSE 30,A01,083084,Eldon; John,4,0,80,76
1656776912174,CSE 30,B01,095061,Bhaskar; Nishant,5,0,50,45
1656776918205,CSE 100,A01,083659,Cao; Yingjun,1,4,70,69
1656776924227,CSE 134B,A01,083661,Powell; Thomas Allan,18,0,100,82
1656776930254,CSE 140,A01,083663,Gungor; Onat,14,0,85,71
1656776936282,CSE 140L,A01,083088,Eldon; John,16,0,100,84
1656776942315,CSE 175,A01,083665,Kumar; Rakesh,3,0,25,22
1656776948341,CSE 190,A00,092507,Dubnov; Shlomo,7,0,20,13
1656776954368,ECE 45,A01,083139,Congero; Spencer William,5,0,75,70
1656776960414,ECE 65,A50,083695,Saad; Andrew S,12,0,30,18
1656776960414,ECE 65,A51,095125,Saad; Andrew S,25,0,26,1
1656776966437,ECE 109,A01,091882,Touri; Behrouz,15,0,70,55
1656776972469,ECE 180,A00,083140,Abi Samra; Nicholas Camill,0,0,30,30
1656776972469,ECE 180,B00,083141,Abi Samra; Nicholas Camill,0,0,30,30
1656776978497,MATH 10A,A01,083735,Patchell; Gregory David,1,0,30,29
1656776978497,MATH 10A,A02,083736,Patchell; Gregory David,20,0,30,10
1656776978497,MATH 10A,A03,083737,Patchell; Gregory David,15,0,30,15
1656776984527,MATH 10B,A01,083207,Lim; Seonhee,7,0,34,27
1656776984527,MATH 10B,A02,083208,Lim; Seonhee,9,0,35,26
1656776984527,MATH 10B,A03,093472,Lim; Seonhee,4,0,34,30
1656776984527,MATH 10B,B01,083739,Sinha; Shubham,9,0,30,21
1656776990564,MATH 18,A01,083743,Cinel; Cameron Alexander,6,0,30,24
1656776990564,MATH 18,A02,083744,Cinel; Cameron Alexander,15,0,30,15
1656776990564,MATH 18,A03,083745,Cinel; Cameron Alexander,8,0,30,22
1656776990564,MATH 18,B01,083748,Rideout; David Porter,3,0,37,34
1656776990564,MATH 18,B02,083749,Rideout; David Porter,3,0,36,33
1656776990564,MATH 18,B03,083750,Rideout; David Porter,1,0,37,36
1656776990564,MATH 18,B04,083751,Rideout; David Porter,5,0,36,31
1656776990564,MATH 18,B05,093473,Rideout; David Porter,4,0,36,32
1656776990564,MATH 18,B06,093474,Rideout; David Porter,5,0,36,31
1656776996590,MATH 20A,A01,083754,Zheng; Zequn,12,0,40,28
1656777002616,MATH 20B,A01,083756,Briones; Jor-el Thomas Caparas,1,0,36,35
1656777002616,MATH 20B,A02,083757,Briones; Jor-el Thomas Caparas,1,0,36,35
1656777002616,MATH 20B,A03,093475,Briones; Jor-el Thomas Caparas,0,0,36,36
1656777008641,MATH 20C,A01,083760,Briones; Jor-el Thomas Caparas,1,0,35,34
1656777008641,MATH 20C,A02,083761,Briones; Jor-el Thomas Caparas,8,0,35,27
1656777008641,MATH 20C,A03,093476,Briones; Jor-el Thomas Caparas,0,1,36,36
1656777008641,MATH 20C,B01,083762,Bach; Quang Tran,0,0,30,30
1656777014670,MATH 20D,A01,083765,Tran; Brian Kha,4,0,30,26
1656777014670,MATH 20D,A02,083766,Tran; Brian Kha,4,0,30,26
1656777014670,MATH 20D,A03,083767,Tran; Brian Kha,2,0,30,28
1656777020697,MATH 20E,A01,083771,Ganguly; Soumya,5,0,32,27
1656777020697,MATH 20E,A02,083772,Ganguly; Soumya,5,0,32,27
1656777020697,MATH 20E,B01,083773,Ciotti; Benjamin,18,0,35,17
1656777020697,MATH 20E,B02,083774,Ciotti; Benjamin,17,0,35,18
1656777026731,MATH 103A,A01,083777,Greenfeld; Be'Eri,2,0,36,34
1656777026731,MATH 103A,A02,083778,Greenfeld; Be'Eri,5,0,36,31
1656777026731,MATH 103A,A03,093561,Greenfeld; Be'Eri,4,0,36,32
1656777026731,MATH 103A,B01,083779,Greenfeld; Be'Eri,6,0,36,30
1656777026731,MATH 103A,B02,083780,Greenfeld; Be'Eri,2,0,36,34
1656777026731,MATH 103A,B03,093562,Greenfeld; Be'Eri,2,0,36,34
1656777032758,MATH 105,A01,085443,Carter; Anne Toulson,13,0,35,22
1656777032758,MATH 105,A02,093477,Carter; Anne Toulson,20,0,35,15
1656777038786,MATH 109,A01,083213,Ganzberger; Geoffrey Michael,2,0,34,32
1656777038786,MATH 109,A02,083214,Ganzberger; Geoffrey Michael,2,0,34,32
1656777038786,MATH 109,A03,093478,Ganzberger; Geoffrey Michael,1,0,34,33
1656777038786,MATH 109,B01,083215,Ganzberger; Geoffrey Michael,1,0,32,31
1656777038786,MATH 109,B02,083216,Ganzberger; Geoffrey Michael,1,0,32,31
1656777038786,MATH 109,B03,093479,Ganzberger; Geoffrey Michael,6,0,32,26
1656777044817,MATH 142A,A01,083219,Chow; Bennett,6,0,32,26
1656777044817,MATH 142A,A02,083220,Chow; Bennett,9,0,32,23
1656777044817,MATH 142A,A03,093480,Chow; Bennett,7,0,32,25
1656777044817,MATH 142A,B03,093481,Chow; Bennett,7,0,32,25
1656777044817,MATH 142A,B04,093558,Chow; Bennett,10,0,32,22
1656777044817,MATH 142A,B05,093559,Chow; Bennett,6,0,32,26
1656777050849,MATH 193A,A01,083224,Rotar; Vladimir,6,0,34,28
1656777050849,MATH 193A,A02,083225,Rotar; Vladimir,3,0,34,31
1656777050849,MATH 193A,A03,083781,Rotar; Vladimir,1,0,34,33
1656777050849,MATH 193A,A04,083782,Rotar; Vladimir,6,0,34,28
1656777050849,MATH 193A,A05,093482,Rotar; Vladimir,6,0,34,28
1656777056880,MATH 197,001,091859,McAuley; Julian John,9999,0,9999,0
1656777056880,MATH 197,002,095566,Kedlaya; Kiran S.,9997,0,9999,2
1656777056880,MATH 197,003,095567,Xiao; Ming,9999,0,9999,0
1656777056880,MATH 197,004,095571,Perols; Johan Lars,9998,0,9999,1
1656777063957,COGS 9,A01,083615,Shannon; Kyle Michael,6,0,75,69
1656777069981,COGS 11,A01,083617,Boyle; Mary E. T.,18,0,48,30
1656777076006,COGS 13,A01,083071,Bastos; Amalia Pinkusfeld,8,0,71,63
1656777082032,COGS 14A,A01,092681,Semenuks; Arturs,0,1,100,100
1656777088057,COGS 14B,A01,083073,Cheng; Tzu-Han,5,0,63,58
1656777094083,COGS 17,A01,092677,Semenuks; Arturs,4,0,81,77
1656777100110,COGS 100,A01,083619,Allen; Michael Gordon,15,0,70,55
1656777106135,COGS 101A,A01,083621,Davis; Joshua Daniel,9,0,68,59
1656777112162,COGS 101B,A01,091572,Allen; Michael Gordon,8,0,65,57
1656777118189,COGS 101C,A01,083625,Delgado; Tania,17,0,35,18
1656777124214,COGS 107A,A01,083627,Boyle; Mary E. T.,13,0,60,47
1656777130240,COGS 118A,A01,083075,Gupta; Anjum,15,0,76,61
1656777136272,CSE 3,A50,083646,Miranda; Gregory Joseph,22,0,50,28
1656777142302,CSE 8A,A50,083650,Miranda; Gregory Joseph,17,1,56,39
1656777148331,CSE 11,A01,083080,Cao; Yingjun,4,15,40,36
1656777154361,CSE 12,A01,083652,Krause-Levy; Sophia Louisa,20,1,120,100
1656777160386,CSE 15L,A01,083654,Morris; Justin Loren,8,0,50,42
1656777160386,CSE 15L,A02,083655,Morris; Justin Loren,8,0,50,42
1656777166411,CSE 20,A01,083657,Tran; Khoa Dang,37,0,80,43
1656777172436,CSE 21,A01,095574,Bach; Quang Tran,21,0,48,27
1656777178461,CSE 30,A01,083084,Eldon; John,4,0,80,76
1656777178461,CSE 30,B01,095061,Bhaskar; Nishant,5,0,50,45
1656777184487,CSE 100,A01,083659,Cao; Yingjun,1,4,70,69
1656777190517,CSE 134B,A01,083661,Powell; Thomas Allan,18,0,100,82
1656777196544,CSE 140,A01,083663,Gungor; Onat,14,0,85,71
1656777202643,CSE 140L,A01,083088,Eldon; John,16,0,100,84
1656777208675,CSE 175,A01,083665,Kumar; Rakesh,3,0,25,22
1656777214700,CSE 190,A00,092507,Dubnov; Shlomo,7,0,20,13
1656777220725,ECE 45,A01,083139,Congero; Spencer William,5,0,75,70
1656777226753,ECE 65,A50,083695,Saad; Andrew S,12,0,30,18
1656777226753,ECE 65,A51,095125,Saad; Andrew S,25,0,26,1
1656777232778,ECE 109,A01,091882,Touri; Behrouz,15,0,70,55
1656777238803,ECE 180,A00,083140,Abi Samra; Nicholas Camill,0,0,30,30
1656777238803,ECE 180,B00,083141,Abi Samra; Nicholas Camill,0,0,30,30
1656777244835,MATH 10A,A01,083735,Patchell; Gregory David,1,0,30,29
1656777244835,MATH 10A,A02,083736,Patchell; Gregory David,20,0,30,10
1656777244835,MATH 10A,A03,083737,Patchell; Gregory David,15,0,30,15
1656777250861,MATH 10B,A01,083207,Lim; Seonhee,7,0,34,27
1656777250861,MATH 10B,A02,083208,Lim; Seonhee,9,0,35,26
1656777250861,MATH 10B,A03,093472,Lim; Seonhee,4,0,34,30
1656777250861,MATH 10B,B01,083739,Sinha; Shubham,9,0,30,21
1656777256890,MATH 18,A01,083743,Cinel; Cameron Alexander,6,0,30,24
1656777256890,MATH 18,A02,083744,Cinel; Cameron Alexander,15,0,30,15
1656777256890,MATH 18,A03,083745,Cinel; Cameron Alexander,8,0,30,22
1656777256890,MATH 18,B01,083748,Rideout; David Porter,3,0,37,34
1656777256890,MATH 18,B02,083749,Rideout; David Porter,3,0,36,33
1656777256890,MATH 18,B03,083750,Rideout; David Porter,1,0,37,36
1656777256890,MATH 18,B04,083751,Rideout; David Porter,5,0,36,31
1656777256890,MATH 18,B05,093473,Rideout; David Porter,4,0,36,32
1656777256890,MATH 18,B06,093474,Rideout; David Porter,5,0,36,31
1656777262924,MATH 20A,A01,083754,Zheng; Zequn,12,0,40,28
1656777268957,MATH 20B,A01,083756,Briones; Jor-el Thomas Caparas,1,0,36,35
1656777268957,MATH 20B,A02,083757,Briones; Jor-el Thomas Caparas,1,0,36,35
1656777268957,MATH 20B,A03,093475,Briones; Jor-el Thomas Caparas,0,0,36,36
1656777274984,MATH 20C,A01,083760,Briones; Jor-el Thomas Caparas,1,0,35,34
1656777274984,MATH 20C,A02,083761,Briones; Jor-el Thomas Caparas,8,0,35,27
1656777274984,MATH 20C,A03,093476,Briones; Jor-el Thomas Caparas,0,1,36,36
1656777274984,MATH 20C,B01,083762,Bach; Quang Tran,0,0,30,30
1656777281008,MATH 20D,A01,083765,Tran; Brian Kha,4,0,30,26
1656777281008,MATH 20D,A02,083766,Tran; Brian Kha,4,0,30,26
1656777281008,MATH 20D,A03,083767,Tran; Brian Kha,2,0,30,28
1656777287035,MATH 20E,A01,083771,Ganguly; Soumya,5,0,32,27
1656777287035,MATH 20E,A02,083772,Ganguly; Soumya,5,0,32,27
1656777287035,MATH 20E,B01,083773,Ciotti; Benjamin,18,0,35,17
1656777287035,MATH 20E,B02,083774,Ciotti; Benjamin,17,0,35,18
1656777293065,MATH 103A,A01,083777,Greenfeld; Be'Eri,2,0,36,34
1656777293065,MATH 103A,A02,083778,Greenfeld; Be'Eri,5,0,36,31
1656777293065,MATH 103A,A03,093561,Greenfeld; Be'Eri,4,0,36,32
1656777293065,MATH 103A,B01,083779,Greenfeld; Be'Eri,6,0,36,30
1656777293065,MATH 103A,B02,083780,Greenfeld; Be'Eri,2,0,36,34
1656777293065,MATH 103A,B03,093562,Greenfeld; Be'Eri,2,0,36,34
1656777299092,MATH 105,A01,085443,Carter; Anne Toulson,13,0,35,22
1656777299092,MATH 105,A02,093477,Carter; Anne Toulson,20,0,35,15
1656777305118,MATH 109,A01,083213,Ganzberger; Geoffrey Michael,2,0,34,32
1656777305118,MATH 109,A02,083214,Ganzberger; Geoffrey Michael,2,0,34,32
1656777305118,MATH 109,A03,093478,Ganzberger; Geoffrey Michael,1,0,34,33
1656777305118,MATH 109,B01,083215,Ganzberger; Geoffrey Michael,1,0,32,31
1656777305118,MATH 109,B02,083216,Ganzberger; Geoffrey Michael,1,0,32,31
1656777305118,MATH 109,B03,093479,Ganzberger; Geoffrey Michael,6,0,32,26
1656777311144,MATH 142A,A01,083219,Chow; Bennett,6,0,32,26
1656777311144,MATH 142A,A02,083220,Chow; Bennett,9,0,32,23
1656777311144,MATH 142A,A03,093480,Chow; Bennett,7,0,32,25
1656777311144,MATH 142A,B03,093481,Chow; Bennett,7,0,32,25
1656777311144,MATH 142A,B04,093558,Chow; Bennett,10,0,32,22
1656777311144,MATH 142A,B05,093559,Chow; Bennett,6,0,32,26
1656777317168,MATH 193A,A01,083224,Rotar; Vladimir,6,0,34,28
1656777317168,MATH 193A,A02,083225,Rotar; Vladimir,3,0,34,31
1656777317168,MATH 193A,A03,083781,Rotar; Vladimir,1,0,34,33
1656777317168,MATH 193A,A04,083782,Rotar; Vladimir,6,0,34,28
1656777317168,MATH 193A,A05,093482,Rotar; Vladimir,6,0,34,28
1656777323197,MATH 197,001,091859,McAuley; Julian John,9999,0,9999,0
1656777323197,MATH 197,002,095566,Kedlaya; Kiran S.,9997,0,9999,2
1656777323197,MATH 197,003,095567,Xiao; Ming,9999,0,9999,0
1656777323197,MATH 197,004,095571,Perols; Johan Lars,9998,0,9999,1
1656777330274,COGS 9,A01,083615,Shannon; Kyle Michael,6,0,75,69
1656777336300,COGS 11,A01,083617,Boyle; Mary E. T.,18,0,48,30
1656777342325,COGS 13,A01,083071,Bastos; Amalia Pinkusfeld,8,0,71,63
1656777348354,COGS 14A,A01,092681,Semenuks; Arturs,0,1,100,100
1656777354384,COGS 14B,A01,083073,Cheng; Tzu-Han,5,0,63,58
1656777360413,COGS 17,A01,092677,Semenuks; Arturs,4,0,81,77
1656777366443,COGS 100,A01,083619,Allen; Michael Gordon,15,0,70,55
1656777372484,COGS 101A,A01,083621,Davis; Joshua Daniel,9,0,68,59
1656777378510,COGS 101B,A01,091572,Allen; Michael Gordon,8,0,65,57
1656777384535,COGS 101C,A01,083625,Delgado; Tania,17,0,35,18
1656777390563,COGS 107A,A01,083627,Boyle; Mary E. T.,13,0,60,47
1656777396591,COGS 118A,A01,083075,Gupta; Anjum,15,0,76,61
1656777402623,CSE 3,A50,083646,Miranda; Gregory Joseph,22,0,50,28
1656777408649,CSE 8A,A50,083650,Miranda; Gregory Joseph,17,1,56,39
1656777414673,CSE 11,A01,083080,Cao; Yingjun,4,15,40,36
1656777420698,CSE 12,A01,083652,Krause-Levy; Sophia Louisa,20,1,120,100
1656777426722,CSE 15L,A01,083654,Morris; Justin Loren,8,0,50,42
1656777426722,CSE 15L,A02,083655,Morris; Justin Loren,8,0,50,42
1656777432745,CSE 20,A01,083657,Tran; Khoa Dang,37,0,80,43
1656777438774,CSE 21,A01,095574,Bach; Quang Tran,21,0,48,27
1656777444800,CSE 30,A01,083084,Eldon; John,4,0,80,76
1656777444800,CSE 30,B01,095061,Bhaskar; Nishant,5,0,50,45
1656777450823,CSE 100,A01,083659,Cao; Yingjun,1,4,70,69
1656777456849,CSE 134B,A01,083661,Powell; Thomas Allan,18,0,100,82
1656777462876,CSE 140,A01,083663,Gungor; Onat,14,0,85,71
1656777468905,CSE 140L,A01,083088,Eldon; John,16,0,100,84
1656777474930,CSE 175,A01,083665,Kumar; Rakesh,3,0,25,22
1656777480969,CSE 190,A00,092507,Dubnov; Shlomo,7,0,20,13
1656777486994,ECE 45,A01,083139,Congero; Spencer William,5,0,75,70
1656777493019,ECE 65,A50,083695,Saad; Andrew S,12,0,30,18
1656777493019,ECE 65,A51,095125,Saad; Andrew S,25,0,26,1
1656777499046,ECE 109,A01,091882,Touri; Behrouz,15,0,70,55
1656777505069,ECE 180,A00,083140,Abi Samra; Nicholas Camill,0,0,30,30
1656777505069,ECE 180,B00,083141,Abi Samra; Nicholas Camill,0,0,30,30
1656777511095,MATH 10A,A01,083735,Patchell; Gregory David,1,0,30,29
1656777511095,MATH 10A,A02,083736,Patchell; Gregory David,20,0,30,10
1656777511095,MATH 10A,A03,083737,Patchell; Gregory David,15,0,30,15
1656777517124,MATH 10B,A01,083207,Lim; Seonhee,7,0,34,27
1656777517124,MATH 10B,A02,083208,Lim; Seonhee,9,0,35,26
1656777517124,MATH 10B,A03,093472,Lim; Seonhee,4,0,34,30
1656777517124,MATH 10B,B01,083739,Sinha; Shubham,9,0,30,21
1656777523161,MATH 18,A01,083743,Cinel; Cameron Alexander,6,0,30,24
1656777523161,MATH 18,A02,083744,Cinel; Cameron Alexander,15,0,30,15
1656777523161,MATH 18,A03,083745,Cinel; Cameron Alexander,8,0,30,22
1656777523161,MATH 18,B01,083748,Rideout; David Porter,3,0,37,34
1656777523161,MATH 18,B02,083749,Rideout; David Porter,3,0,36,33
1656777523161,MATH 18,B03,083750,Rideout; David Porter,1,0,37,36
1656777523161,MATH 18,B04,083751,Rideout; David Porter,5,0,36,31
1656777523161,MATH 18,B05,093473,Rideout; David Porter,4,0,36,32
1656777523161,MATH 18,B06,093474,Rideout; David Porter,5,0,36,31
1656777529187,MATH 20A,A01,083754,Zheng; Zequn,12,0,40,28
1656777535214,MATH 20B,A01,083756,Briones; Jor-el Thomas Caparas,1,0,36,35
1656777535214,MATH 20B,A02,083757,Briones; Jor-el Thomas Caparas,1,0,36,35
1656777535214,MATH 20B,A03,093475,Briones; Jor-el Thomas Caparas,0,0,36,36
1656777541240,MATH 20C,A01,083760,Briones; Jor-el Thomas Caparas,1,0,35,34
1656777541240,MATH 20C,A02,083761,Briones; Jor-el Thomas Caparas,8,0,35,27
1656777541240,MATH 20C,A03,093476,Briones; Jor-el Thomas Caparas,0,1,36,36
1656777541240,MATH 20C,B01,083762,Bach; Quang Tran,0,0,30,30
1656777547269,MATH 20D,A01,083765,Tran; Brian Kha,4,0,30,26
1656777547269,MATH 20D,A02,083766,Tran; Brian Kha,4,0,30,26
1656777547269,MATH 20D,A03,083767,Tran; Brian Kha,2,0,30,28
1656777553301,MATH 20E,A01,083771,Ganguly; Soumya,5,0,32,27
1656777553301,MATH 20E,A02,083772,Ganguly; Soumya,5,0,32,27
1656777553301,MATH 20E,B01,083773,Ciotti; Benjamin,18,0,35,17
1656777553301,MATH 20E,B02,083774,Ciotti; Benjamin,17,0,35,18
1656777559328,MATH 103A,A01,083777,Greenfeld; Be'Eri,2,0,36,34
1656777559328,MATH 103A,A02,083778,Greenfeld; Be'Eri,5,0,36,31
1656777559328,MATH 103A,A03,093561,Greenfeld; Be'Eri,4,0,36,32
1656777559328,MATH 103A,B01,083779,Greenfeld; Be'Eri,6,0,36,30
1656777559328,MATH 103A,B02,083780,Greenfeld; Be'Eri,2,0,36,34
1656777559328,MATH 103A,B03,093562,Greenfeld; Be'Eri,2,0,36,34
1656777565358,MATH 105,A01,085443,Carter; Anne Toulson,13,0,35,22
1656777565358,MATH 105,A02,093477,Carter; Anne Toulson,20,0,35,15
1656777571383,MATH 109,A01,083213,Ganzberger; Geoffrey Michael,2,0,34,32
1656777571383,MATH 109,A02,083214,Ganzberger; Geoffrey Michael,2,0,34,32
1656777571383,MATH 109,A03,093478,Ganzberger; Geoffrey Michael,1,0,34,33
1656777571383,MATH 109,B01,083215,Ganzberger; Geoffrey Michael,1,0,32,31
1656777571383,MATH 109,B02,083216,Ganzberger; Geoffrey Michael,1,0,32,31
1656777571383,MATH 109,B03,093479,Ganzberger; Geoffrey Michael,6,0,32,26
1656777577408,MATH 142A,A01,083219,Chow; Bennett,6,0,32,26
1656777577408,MATH 142A,A02,083220,Chow; Bennett,9,0,32,23
1656777577408,MATH 142A,A03,093480,Chow; Bennett,7,0,32,25
1656777577408,MATH 142A,B03,093481,Chow; Bennett,7,0,32,25
1656777577408,MATH 142A,B04,093558,Chow; Bennett,10,0,32,22
1656777577408,MATH 142A,B05,093559,Chow; Bennett,6,0,32,26
1656777583440,MATH 193A,A01,083224,Rotar; Vladimir,6,0,34,28
1656777583440,MATH 193A,A02,083225,Rotar; Vladimir,3,0,34,31
1656777583440,MATH 193A,A03,083781,Rotar; Vladimir,1,0,34,33
1656777583440,MATH 193A,A04,083782,Rotar; Vladimir,6,0,34,28
1656777583440,MATH 193A,A05,093482,Rotar; Vladimir,6,0,34,28
1656777589470,MATH 197,001,091859,McAuley; Julian John,9999,0,9999,0
1656777589470,MATH 197,002,095566,Kedlaya; Kiran S.,9997,0,9999,2
1656777589470,MATH 197,003,095567,Xiao; Ming,9999,0,9999,0
1656777589470,MATH 197,004,095571,Perols; Johan Lars,9998,0,9999,1
1656777596527,COGS 9,A01,083615,Shannon; Kyle Michael,6,0,75,69
1656777602553,COGS 11,A01,083617,Boyle; Mary E. T.,18,0,48,30
1656777608582,COGS 13,A01,083071,Bastos; Amalia Pinkusfeld,8,0,71,63
1656777614607,COGS 14A,A01,092681,Semenuks; Arturs,0,1,100,100
1656777620631,COGS 14B,A01,083073,Cheng; Tzu-Han,5,0,63,58
1656777626659,COGS 17,A01,092677,Semenuks; Arturs,4,0,81,77
1656777632685,COGS 100,A01,083619,Allen; Michael Gordon,15,0,70,55
1656777638714,COGS 101A,A01,083621,Davis; Joshua Daniel,9,0,68,59
1656777644744,COGS 101B,A01,091572,Allen; Michael Gordon,8,0,65,57
1656777650773,COGS 101C,A01,083625,Delgado; Tania,17,0,35,18
1656777656799,COGS 107A,A01,083627,Boyle; Mary E. T.,13,0,60,47
1656777662831,COGS 118A,A01,083075,Gupta; Anjum,15,0,76,61
1656777668865,CSE 3,A50,083646,Miranda; Gregory Joseph,22,0,50,28
1656777674895,CSE 8A,A50,083650,Miranda; Gregory Joseph,17,1,56,39
1656777680922,CSE 11,A01,083080,Cao; Yingjun,4,15,40,36
1656777686946,CSE 12,A01,083652,Krause-Levy; Sophia Louisa,20,1,120,100
1656777692970,CSE 15L,A01,083654,Morris; Justin Loren,8,0,50,42
1656777692970,CSE 15L,A02,083655,Morris; Justin Loren,8,0,50,42
1656777698998,CSE 20,A01,083657,Tran; Khoa Dang,37,0,80,43
1656777705024,CSE 21,A01,095574,Bach; Quang Tran,21,0,48,27
1656777711050,CSE 30,A01,083084,Eldon; John,4,0,80,76
1656777711050,CSE 30,B01,095061,Bhaskar; Nishant,5,0,50,45
1656777717079,CSE 100,A01,083659,Cao; Yingjun,1,4,70,69
1656777723109,CSE 134B,A01,083661,Powell; Thomas Allan,18,0,100,82
1656777729140,CSE 140,A01,083663,Gungor; Onat,14,0,85,71
1656777735185,CSE 140L,A01,083088,Eldon; John,16,0,100,84
1656777741211,CSE 175,A01,083665,Kumar; Rakesh,3,0,25,22
1656777747236,CSE 190,A00,092507,Dubnov; Shlomo,7,0,20,13
1656777753262,ECE 45,A01,083139,Congero; Spencer William,5,0,75,70
1656777759287,ECE 65,A50,083695,Saad; Andrew S,12,0,30,18
1656777759287,ECE 65,A51,095125,Saad; Andrew S,25,0,26,1
1656777765311,ECE 109,A01,091882,Touri; Behrouz,15,0,70,55
1656777771335,ECE 180,A00,083140,Abi Samra; Nicholas Camill,0,0,30,30
1656777771335,ECE 180,B00,083141,Abi Samra; Nicholas Camill,0,0,30,30
1656777777362,MATH 10A,A01,083735,Patchell; Gregory David,1,0,30,29
1656777777362,MATH 10A,A02,083736,Patchell; Gregory David,20,0,30,10
1656777777362,MATH 10A,A03,083737,Patchell; Gregory David,15,0,30,15
1656777783391,MATH 10B,A01,083207,Lim; Seonhee,7,0,34,27
1656777783391,MATH 10B,A02,083208,Lim; Seonhee,9,0,35,26
1656777783391,MATH 10B,A03,093472,Lim; Seonhee,4,0,34,30
1656777783391,MATH 10B,B01,083739,Sinha; Shubham,9,0,30,21
1656777789420,MATH 18,A01,083743,Cinel; Cameron Alexander,6,0,30,24
1656777789420,MATH 18,A02,083744,Cinel; Cameron Alexander,15,0,30,15
1656777789420,MATH 18,A03,083745,Cinel; Cameron Alexander,8,0,30,22
1656777789420,MATH 18,B01,083748,Rideout; David Porter,3,0,37,34
1656777789420,MATH 18,B02,083749,Rideout; David Porter,3,0,36,33
1656777789420,MATH 18,B03,083750,Rideout; David Porter,1,0,37,36
1656777789420,MATH 18,B04,083751,Rideout; David Porter,5,0,36,31
1656777789420,MATH 18,B05,093473,Rideout; David Porter,4,0,36,32
1656777789420,MATH 18,B06,093474,Rideout; David Porter,5,0,36,31
1656777795444,MATH 20A,A01,083754,Zheng; Zequn,12,0,40,28
1656777801566,MATH 20B,A01,083756,Briones; Jor-el Thomas Caparas,1,0,36,35
1656777801566,MATH 20B,A02,083757,Briones; Jor-el Thomas Caparas,1,0,36,35
1656777801566,MATH 20B,A03,093475,Briones; Jor-el Thomas Caparas,0,0,36,36
1656777807608,MATH 20C,A01,083760,Briones; Jor-el Thomas Caparas,1,0,35,34
1656777807608,MATH 20C,A02,083761,Briones; Jor-el Thomas Caparas,8,0,35,27
1656777807608,MATH 20C,A03,093476,Briones; Jor-el Thomas Caparas,0,1,36,36
1656777807608,MATH 20C,B01,083762,Bach; Quang Tran,0,0,30,30
1656777813640,MATH 20D,A01,083765,Tran; Brian Kha,4,0,30,26
1656777813640,MATH 20D,A02,083766,Tran; Brian Kha,4,0,30,26
1656777813640,MATH 20D,A03,083767,Tran; Brian Kha,2,0,30,28
1656777819666,MATH 20E,A01,083771,Ganguly; Soumya,5,0,32,27
1656777819666,MATH 20E,A02,083772,Ganguly; Soumya,5,0,32,27
1656777819666,MATH 20E,B01,083773,Ciotti; Benjamin,18,0,35,17
1656777819666,MATH 20E,B02,083774,Ciotti; Benjamin,17,0,35,18
1656777825702,MATH 103A,A01,083777,Greenfeld; Be'Eri,2,0,36,34
1656777825702,MATH 103A,A02,083778,Greenfeld; Be'Eri,5,0,36,31
1656777825702,MATH 103A,A03,093561,Greenfeld; Be'Eri,4,0,36,32
1656777825702,MATH 103A,B01,083779,Greenfeld; Be'Eri,6,0,36,30
1656777825702,MATH 103A,B02,083780,Greenfeld; Be'Eri,2,0,36,34
1656777825702,MATH 103A,B03,093562,Greenfeld; Be'Eri,2,0,36,34
1656777831726,MATH 105,A01,085443,Carter; Anne Toulson,13,0,35,22
1656777831726,MATH 105,A02,093477,Carter; Anne Toulson,20,0,35,15
1656777837760,MATH 109,A01,083213,Ganzberger; Geoffrey Michael,2,0,34,32
1656777837760,MATH 109,A02,083214,Ganzberger; Geoffrey Michael,2,0,34,32
1656777837760,MATH 109,A03,093478,Ganzberger; Geoffrey Michael,1,0,34,33
1656777837760,MATH 109,B01,083215,Ganzberger; Geoffrey Michael,1,0,32,31
1656777837760,MATH 109,B02,083216,Ganzberger; Geoffrey Michael,1,0,32,31
1656777837760,MATH 109,B03,093479,Ganzberger; Geoffrey Michael,6,0,32,26
1656777843793,MATH 142A,A01,083219,Chow; Bennett,6,0,32,26
1656777843793,MATH 142A,A02,083220,Chow; Bennett,9,0,32,23
1656777843793,MATH 142A,A03,093480,Chow; Bennett,7,0,32,25
1656777843793,MATH 142A,B03,093481,Chow; Bennett,7,0,32,25
1656777843793,MATH 142A,B04,093558,Chow; Bennett,10,0,32,22
1656777843793,MATH 142A,B05,093559,Chow; Bennett,6,0,32,26
1656777849827,MATH 193A,A01,083224,Rotar; Vladimir,6,0,34,28
1656777849827,MATH 193A,A02,083225,Rotar; Vladimir,3,0,34,31
1656777849827,MATH 193A,A03,083781,Rotar; Vladimir,1,0,34,33
1656777849827,MATH 193A,A04,083782,Rotar; Vladimir,6,0,34,28
1656777849827,MATH 193A,A05,093482,Rotar; Vladimir,6,0,34,28
1656777855856,MATH 197,001,091859,McAuley; Julian John,9999,0,9999,0
1656777855856,MATH 197,002,095566,Kedlaya; Kiran S.,9997,0,9999,2
1656777855856,MATH 197,003,095567,Xiao; Ming,9999,0,9999,0
1656777855856,MATH 197,004,095571,Perols; Johan Lars,9998,0,9999,1
1656777862919,COGS 9,A01,083615,Shannon; Kyle Michael,6,0,75,69
1656777868945,COGS 11,A01,083617,Boyle; Mary E. T.,18,0,48,30
1656777874976,COGS 13,A01,083071,Bastos; Amalia Pinkusfeld,8,0,71,63
1656777881005,COGS 14A,A01,092681,Semenuks; Arturs,0,1,100,100
1656777887029,COGS 14B,A01,083073,Cheng; Tzu-Han,5,0,63,58
1656777893058,COGS 17,A01,092677,Semenuks; Arturs,4,0,81,77
1656777899082,COGS 100,A01,083619,Allen; Michael Gordon,15,0,70,55
1656777905106,COGS 101A,A01,083621,Davis; Joshua Daniel,9,0,68,59
1656777911133,COGS 101B,A01,091572,Allen; Michael Gordon,8,0,65,57
1656777917158,COGS 101C,A01,083625,Delgado; Tania,17,0,35,18
1656777923183,COGS 107A,A01,083627,Boyle; Mary E. T.,13,0,60,47
1656777929210,COGS 118A,A01,083075,Gupta; Anjum,15,0,76,61
1656777935236,CSE 3,A50,083646,Miranda; Gregory Joseph,22,0,50,28
1656777941264,CSE 8A,A50,083650,Miranda; Gregory Joseph,17,1,56,39
1656777947290,CSE 11,A01,083080,Cao; Yingjun,4,15,40,36
1656777953320,CSE 12,A01,083652,Krause-Levy; Sophia Louisa,20,1,120,100
1656777959344,CSE 15L,A01,083654,Morris; Justin Loren,8,0,50,42
1656777959344,CSE 15L,A02,083655,Morris; Justin Loren,8,0,50,42
1656777965369,CSE 20,A01,083657,Tran; Khoa Dang,37,0,80,43
1656777971394,CSE 21,A01,095574,Bach; Quang Tran,21,0,48,27
1656777977422,CSE 30,A01,083084,Eldon; John,4,0,80,76
1656777977422,CSE 30,B01,095061,Bhaskar; Nishant,5,0,50,45
1656777983453,CSE 100,A01,083659,Cao; Yingjun,1,4,70,69
1656777989475,CSE 134B,A01,083661,Powell; Thomas Allan,18,0,100,82
1656777995499,CSE 140,A01,083663,Gungor; Onat,14,0,85,71
1656778001522,CSE 140L,A01,083088,Eldon; John,16,0,100,84
1656778007546,CSE 175,A01,083665,Kumar; Rakesh,3,0,25,22
1656778013569,CSE 190,A00,092507,Dubnov; Shlomo,7,0,20,13
1656778019633,ECE 45,A01,083139,Congero; Spencer William,5,0,75,70
1656778025660,ECE 65,A50,083695,Saad; Andrew S,12,0,30,18
1656778025660,ECE 65,A51,095125,Saad; Andrew S,25,0,26,1
1656778031694,ECE 109,A01,091882,Touri; Behrouz,15,0,70,55
1656778037764,ECE 180,A00,083140,Abi Samra; Nicholas Camill,0,0,30,30
1656778037764,ECE 180,B00,083141,Abi Samra; Nicholas Camill,0,0,30,30
1656778043788,MATH 10A,A01,083735,Patchell; Gregory David,1,0,30,29
1656778043788,MATH 10A,A02,083736,Patchell; Gregory David,20,0,30,10
1656778043788,MATH 10A,A03,083737,Patchell; Gregory David,15,0,30,15
1656778049821,MATH 10B,A01,083207,Lim; Seonhee,7,0,34,27
1656778049821,MATH 10B,A02,083208,Lim; Seonhee,9,0,35,26
1656778049821,MATH 10B,A03,093472,Lim; Seonhee,4,0,34,30
1656778049821,MATH 10B,B01,083739,Sinha; Shubham,9,0,30,21
1656778055866,MATH 18,A01,083743,Cinel; Cameron Alexander,6,0,30,24
1656778055866,MATH 18,A02,083744,Cinel; Cameron Alexander,15,0,30,15
1656778055866,MATH 18,A03,083745,Cinel; Cameron Alexander,8,0,30,22
1656778055866,MATH 18,B01,083748,Rideout; David Porter,3,0,37,34
1656778055866,MATH 18,B02,083749,Rideout; David Porter,3,0,36,33
1656778055866,MATH 18,B03,083750,Rideout; David Porter,1,0,37,36
1656778055866,MATH 18,B04,083751,Rideout; David Porter,5,0,36,31
1656778055866,MATH 18,B05,093473,Rideout; David Porter,4,0,36,32
1656778055866,MATH 18,B06,093474,Rideout; David Porter,5,0,36,31
1656778061893,MATH 20A,A01,083754,Zheng; Zequn,12,0,40,28
1656778067917,MATH 20B,A01,083756,Briones; Jor-el Thomas Caparas,1,0,36,35
1656778067917,MATH 20B,A02,083757,Briones; Jor-el Thomas Caparas,1,0,36,35
1656778067917,MATH 20B,A03,093475,Briones; Jor-el Thomas Caparas,0,0,36,36
1656778073940,MATH 20C,A01,083760,Briones; Jor-el Thomas Caparas,1,0,35,34
1656778073940,MATH 20C,A02,083761,Briones; Jor-el Thomas Caparas,8,0,35,27
1656778073940,MATH 20C,A03,093476,Briones; Jor-el Thomas Caparas,0,1,36,36
1656778073940,MATH 20C,B01,083762,Bach; Quang Tran,0,0,30,30
1656778079967,MATH 20D,A01,083765,Tran; Brian Kha,4,0,30,26
1656778079967,MATH 20D,A02,083766,Tran; Brian Kha,4,0,30,26
1656778079967,MATH 20D,A03,083767,Tran; Brian Kha,2,0,30,28
1656778085989,MATH 20E,A01,083771,Ganguly; Soumya,5,0,32,27
1656778085989,MATH 20E,A02,083772,Ganguly; Soumya,5,0,32,27
1656778085989,MATH 20E,B01,083773,Ciotti; Benjamin,18,0,35,17
1656778085989,MATH 20E,B02,083774,Ciotti; Benjamin,17,0,35,18
1656778092020,MATH 103A,A01,083777,Greenfeld; Be'Eri,2,0,36,34
1656778092020,MATH 103A,A02,083778,Greenfeld; Be'Eri,5,0,36,31
1656778092020,MATH 103A,A03,093561,Greenfeld; Be'Eri,4,0,36,32
1656778092020,MATH 103A,B01,083779,Greenfeld; Be'Eri,6,0,36,30
1656778092020,MATH 103A,B02,083780,Greenfeld; Be'Eri,2,0,36,34
1656778092020,MATH 103A,B03,093562,Greenfeld; Be'Eri,2,0,36,34
1656778098043,MATH 105,A01,085443,Carter; Anne Toulson,13,0,35,22
1656778098043,MATH 105,A02,093477,Carter; Anne Toulson,20,0,35,15
1656778104074,MATH 109,A01,083213,Ganzberger; Geoffrey Michael,2,0,34,32
1656778104074,MATH 109,A02,083214,Ganzberger; Geoffrey Michael,2,0,34,32
1656778104074,MATH 109,A03,093478,Ganzberger; Geoffrey Michael,1,0,34,33
1656778104074,MATH 109,B01,083215,Ganzberger; Geoffrey Michael,1,0,32,31
1656778104074,MATH 109,B02,083216,Ganzberger; Geoffrey Michael,1,0,32,31
1656778104074,MATH 109,B03,093479,Ganzberger; Geoffrey Michael,6,0,32,26
1656778110101,MATH 142A,A01,083219,Chow; Bennett,6,0,32,26
1656778110101,MATH 142A,A02,083220,Chow; Bennett,9,0,32,23
1656778110101,MATH 142A,A03,093480,Chow; Bennett,7,0,32,25
1656778110101,MATH 142A,B03,093481,Chow; Bennett,7,0,32,25
1656778110101,MATH 142A,B04,093558,Chow; Bennett,10,0,32,22
1656778110101,MATH 142A,B05,093559,Chow; Bennett,6,0,32,26
1656778116130,MATH 193A,A01,083224,Rotar; Vladimir,6,0,34,28
1656778116130,MATH 193A,A02,083225,Rotar; Vladimir,3,0,34,31
1656778116130,MATH 193A,A03,083781,Rotar; Vladimir,1,0,34,33
1656778116130,MATH 193A,A04,083782,Rotar; Vladimir,6,0,34,28
1656778116130,MATH 193A,A05,093482,Rotar; Vladimir,6,0,34,28
1656778122152,MATH 197,001,091859,McAuley; Julian John,9999,0,9999,0
1656778122152,MATH 197,002,095566,Kedlaya; Kiran S.,9997,0,9999,2
1656778122152,MATH 197,003,095567,Xiao; Ming,9999,0,9999,0
1656778122152,MATH 197,004,095571,Perols; Johan Lars,9998,0,9999,1
1656778129223,COGS 9,A01,083615,Shannon; Kyle Michael,6,0,75,69
1656778135246,COGS 11,A01,083617,Boyle; Mary E. T.,18,0,48,30
1656778141274,COGS 13,A01,083071,Bastos; Amalia Pinkusfeld,8,0,71,63
1656778147301,COGS 14A,A01,092681,Semenuks; Arturs,0,1,100,100
1656778153326,COGS 14B,A01,083073,Cheng; Tzu-Han,5,0,63,58
1656778159356,COGS 17,A01,092677,Semenuks; Arturs,4,0,81,77
1656778165379,COGS 100,A01,083619,Allen; Michael Gordon,15,0,70,55
1656778171407,COGS 101A,A01,083621,Davis; Joshua Daniel,9,0,68,59
1656778177427,COGS 101B,A01,091572,Allen; Michael Gordon,8,0,65,57
1656778183452,COGS 101C,A01,083625,Delgado; Tania,17,0,35,18
1656778189476,COGS 107A,A01,083627,Boyle; Mary E. T.,13,0,60,47
1656778195500,COGS 118A,A01,083075,Gupta; Anjum,15,0,76,61
1656778201523,CSE 3,A50,083646,Miranda; Gregory Joseph,22,0,50,28
1656778207548,CSE 8A,A50,083650,Miranda; Gregory Joseph,17,1,56,39
1656778213572,CSE 11,A01,083080,Cao; Yingjun,4,15,40,36
1656778219595,CSE 12,A01,083652,Krause-Levy; Sophia Louisa,20,1,120,100
1656778225621,CSE 15L,A01,083654,Morris; Justin Loren,8,0,50,42
1656778225621,CSE 15L,A02,083655,Morris; Justin Loren,8,0,50,42
1656778231646,CSE 20,A01,083657,Tran; Khoa Dang,37,0,80,43
1656778237669,CSE 21,A01,095574,Bach; Quang Tran,21,0,48,27
1656778243714,CSE 30,A01,083084,Eldon; John,4,0,80,76
1656778243714,CSE 30,B01,095061,Bhaskar; Nishant,5,0,50,45
1656778249736,CSE 100,A01,083659,Cao; Yingjun,1,4,70,69
1656778255759,CSE 134B,A01,083661,Powell; Thomas Allan,18,0,100,82
1656778261783,CSE 140,A01,083663,Gungor; Onat,14,0,85,71
1656778267808,CSE 140L,A01,083088,Eldon; John,16,0,100,84
1656778273831,CSE 175,A01,083665,Kumar; Rakesh,3,0,25,22
1656778279854,CSE 190,A00,092507,Dubnov; Shlomo,7,0,20,13
1656778285877,ECE 45,A01,083139,Congero; Spencer William,5,0,75,70
1656778291901,ECE 65,A50,083695,Saad; Andrew S,12,0,30,18
1656778291901,ECE 65,A51,095125,Saad; Andrew S,25,0,26,1
1656778297922,ECE 109,A01,091882,Touri; Behrouz,15,0,70,55
1656778303945,ECE 180,A00,083140,Abi Samra; Nicholas Camill,0,0,30,30
1656778303945,ECE 180,B00,083141,Abi Samra; Nicholas Camill,0,0,30,30
1656778309969,MATH 10A,A01,083735,Patchell; Gregory David,1,0,30,29
1656778309969,MATH 10A,A02,083736,Patchell; Gregory David,20,0,30,10
1656778309969,MATH 10A,A03,083737,Patchell; Gregory David,15,0,30,15
1656778315992,MATH 10B,A01,083207,Lim; Seonhee,7,0,34,27
1656778315992,MATH 10B,A02,083208,Lim; Seonhee,9,0,35,26
1656778315992,MATH 10B,A03,093472,Lim; Seonhee,4,0,34,30
1656778315992,MATH 10B,B01,083739,Sinha; Shubham,9,0,30,21
1656778322016,MATH 18,A01,083743,Cinel; Cameron Alexander,6,0,30,24
1656778322016,MATH 18,A02,083744,Cinel; Cameron Alexander,15,0,30,15
1656778322016,MATH 18,A03,083745,Cinel; Cameron Alexander,8,0,30,22
1656778322016,MATH 18,B01,083748,Rideout; David Porter,3,0,37,34
1656778322016,MATH 18,B02,083749,Rideout; David Porter,3,0,36,33
1656778322016,MATH 18,B03,083750,Rideout; David Porter,1,0,37,36
1656778322016,MATH 18,B04,083751,Rideout; David Porter,5,0,36,31
1656778322016,MATH 18,B05,093473,Rideout; David Porter,4,0,36,32
1656778322016,MATH 18,B06,093474,Rideout; David Porter,5,0,36,31
1656778328039,MATH 20A,A01,083754,Zheng; Zequn,12,0,40,28
1656778334063,MATH 20B,A01,083756,Briones; Jor-el Thomas Caparas,1,0,36,35
1656778334063,MATH 20B,A02,083757,Briones; Jor-el Thomas Caparas,1,0,36,35
1656778334063,MATH 20B,A03,093475,Briones; Jor-el Thomas Caparas,0,0,36,36
1656778340089,MATH 20C,A01,083760,Briones; Jor-el Thomas Caparas,1,0,35,34
1656778340089,MATH 20C,A02,083761,Briones; Jor-el Thomas Caparas,8,0,35,27
1656778340089,MATH 20C,A03,093476,Briones; Jor-el Thomas Caparas,0,1,36,36
1656778340089,MATH 20C,B01,083762,Bach; Quang Tran,0,0,30,30
1656778346117,MATH 20D,A01,083765,Tran; Brian Kha,4,0,30,26
1656778346117,MATH 20D,A02,083766,Tran; Brian Kha,4,0,30,26
1656778346117,MATH 20D,A03,083767,Tran; Brian Kha,2,0,30,28
1656778352145,MATH 20E,A01,083771,Ganguly; Soumya,5,0,32,27
1656778352145,MATH 20E,A02,083772,Ganguly; Soumya,5,0,32,27
1656778352145,MATH 20E,B01,083773,Ciotti; Benjamin,18,0,35,17
1656778352145,MATH 20E,B02,083774,Ciotti; Benjamin,17,0,35,18
1656778358174,MATH 103A,A01,083777,Greenfeld; Be'Eri,2,0,36,34
1656778358174,MATH 103A,A02,083778,Greenfeld; Be'Eri,5,0,36,31
1656778358174,MATH 103A,A03,093561,Greenfeld; Be'Eri,4,0,36,32
1656778358174,MATH 103A,B01,083779,Greenfeld; Be'Eri,6,0,36,30
1656778358174,MATH 103A,B02,083780,Greenfeld; Be'Eri,2,0,36,34
1656778358174,MATH 103A,B03,093562,Greenfeld; Be'Eri,2,0,36,34
1656778364197,MATH 105,A01,085443,Carter; Anne Toulson,13,0,35,22
1656778364197,MATH 105,A02,093477,Carter; Anne Toulson,20,0,35,15
1656778370221,MATH 109,A01,083213,Ganzberger; Geoffrey Michael,2,0,34,32
1656778370221,MATH 109,A02,083214,Ganzberger; Geoffrey Michael,2,0,34,32
1656778370221,MATH 109,A03,093478,Ganzberger; Geoffrey Michael,1,0,34,33
1656778370221,MATH 109,B01,083215,Ganzberger; Geoffrey Michael,1,0,32,31
1656778370221,MATH 109,B02,083216,Ganzberger; Geoffrey Michael,1,0,32,31
1656778370221,MATH 109,B03,093479,Ganzberger; Geoffrey Michael,6,0,32,26
1656778376250,MATH 142A,A01,083219,Chow; Bennett,6,0,32,26
1656778376250,MATH 142A,A02,083220,Chow; Bennett,9,0,32,23
1656778376250,MATH 142A,A03,093480,Chow; Bennett,7,0,32,25
1656778376250,MATH 142A,B03,093481,Chow; Bennett,7,0,32,25
1656778376250,MATH 142A,B04,093558,Chow; Bennett,10,0,32,22
1656778376250,MATH 142A,B05,093559,Chow; Bennett,6,0,32,26
1656778382278,MATH 193A,A01,083224,Rotar; Vladimir,6,0,34,28
1656778382278,MATH 193A,A02,083225,Rotar; Vladimir,3,0,34,31
1656778382278,MATH 193A,A03,083781,Rotar; Vladimir,1,0,34,33
1656778382278,MATH 193A,A04,083782,Rotar; Vladimir,6,0,34,28
1656778382278,MATH 193A,A05,093482,Rotar; Vladimir,6,0,34,28
1656778388305,MATH 197,001,091859,McAuley; Julian John,9999,0,9999,0
1656778388305,MATH 197,002,095566,Kedlaya; Kiran S.,9997,0,9999,2
1656778388305,MATH 197,003,095567,Xiao; Ming,9999,0,9999,0
1656778388305,MATH 197,004,095571,Perols; Johan Lars,9998,0,9999,1
1656778395434,COGS 9,A01,083615,Shannon; Kyle Michael,6,0,75,69
1656778401460,COGS 11,A01,083617,Boyle; Mary E. T.,18,0,48,30
1656778407499,COGS 13,A01,083071,Bastos; Amalia Pinkusfeld,8,0,71,63
1656778413523,COGS 14A,A01,092681,Semenuks; Arturs,0,1,100,100
1656778419551,COGS 14B,A01,083073,Cheng; Tzu-Han,5,0,63,58
1656778425573,COGS 17,A01,092677,Semenuks; Arturs,4,0,81,77
1656778431615,COGS 100,A01,083619,Allen; Michael Gordon,15,0,70,55
1656778437642,COGS 101A,A01,083621,Davis; Joshua Daniel,9,0,68,59
1656778443667,COGS 101B,A01,091572,Allen; Michael Gordon,8,0,65,57
1656778449690,COGS 101C,A01,083625,Delgado; Tania,17,0,35,18
1656778455752,COGS 107A,A01,083627,Boyle; Mary E. T.,13,0,60,47
1656778461776,COGS 118A,A01,083075,Gupta; Anjum,15,0,76,61
1656778467798,CSE 3,A50,083646,Miranda; Gregory Joseph,22,0,50,28
1656778473832,CSE 8A,A50,083650,Miranda; Gregory Joseph,17,1,56,39
1656778479854,CSE 11,A01,083080,Cao; Yingjun,4,15,40,36
1656778485877,CSE 12,A01,083652,Krause-Levy; Sophia Louisa,20,1,120,100
1656778491902,CSE 15L,A01,083654,Morris; Justin Loren,8,0,50,42
1656778491902,CSE 15L,A02,083655,Morris; Justin Loren,8,0,50,42
1656778497932,CSE 20,A01,083657,Tran; Khoa Dang,37,0,80,43
1656778503959,CSE 21,A01,095574,Bach; Quang Tran,21,0,48,27
1656778509981,CSE 30,A01,083084,Eldon; John,4,0,80,76
1656778509981,CSE 30,B01,095061,Bhaskar; Nishant,5,0,50,45
1656778516010,CSE 100,A01,083659,Cao; Yingjun,1,4,70,69
1656778522036,CSE 134B,A01,083661,Powell; Thomas Allan,18,0,100,82
1656778528074,CSE 140,A01,083663,Gungor; Onat,14,0,85,71
1656778534099,CSE 140L,A01,083088,Eldon; John,16,0,100,84
1656778540123,CSE 175,A01,083665,Kumar; Rakesh,3,0,25,22
1656778546148,CSE 190,A00,092507,Dubnov; Shlomo,7,0,20,13
1656778552171,ECE 45,A01,083139,Congero; Spencer William,5,0,75,70
1656778558198,ECE 65,A50,083695,Saad; Andrew S,12,0,30,18
1656778558198,ECE 65,A51,095125,Saad; Andrew S,25,0,26,1
1656778564222,ECE 109,A01,091882,Touri; Behrouz,15,0,70,55
1656778570243,ECE 180,A00,083140,Abi Samra; Nicholas Camill,0,0,30,30
1656778570243,ECE 180,B00,083141,Abi Samra; Nicholas Camill,0,0,30,30
1656778576271,MATH 10A,A01,083735,Patchell; Gregory David,1,0,30,29
1656778576271,MATH 10A,A02,083736,Patchell; Gregory David,20,0,30,10
1656778576271,MATH 10A,A03,083737,Patchell; Gregory David,15,0,30,15
1656778582299,MATH 10B,A01,083207,Lim; Seonhee,7,0,34,27
1656778582299,MATH 10B,A02,083208,Lim; Seonhee,9,0,35,26
1656778582299,MATH 10B,A03,093472,Lim; Seonhee,4,0,34,30
1656778582299,MATH 10B,B01,083739,Sinha; Shubham,9,0,30,21
1656778588335,MATH 18,A01,083743,Cinel; Cameron Alexander,6,0,30,24
1656778588335,MATH 18,A02,083744,Cinel; Cameron Alexander,15,0,30,15
1656778588335,MATH 18,A03,083745,Cinel; Cameron Alexander,8,0,30,22
1656778588335,MATH 18,B01,083748,Rideout; David Porter,3,0,37,34
1656778588335,MATH 18,B02,083749,Rideout; David Porter,3,0,36,33
1656778588335,MATH 18,B03,083750,Rideout; David Porter,1,0,37,36
1656778588335,MATH 18,B04,083751,Rideout; David Porter,5,0,36,31
1656778588335,MATH 18,B05,093473,Rideout; David Porter,4,0,36,32
1656778588335,MATH 18,B06,093474,Rideout; David Porter,5,0,36,31
1656778594362,MATH 20A,A01,083754,Zheng; Zequn,12,0,40,28
1656778600390,MATH 20B,A01,083756,Briones; Jor-el Thomas Caparas,1,0,36,35
1656778600390,MATH 20B,A02,083757,Briones; Jor-el Thomas Caparas,1,0,36,35
1656778600390,MATH 20B,A03,093475,Briones; Jor-el Thomas Caparas,0,0,36,36
1656778606414,MATH 20C,A01,083760,Briones; Jor-el Thomas Caparas,1,0,35,34
1656778606414,MATH 20C,A02,083761,Briones; Jor-el Thomas Caparas,8,0,35,27
1656778606414,MATH 20C,A03,093476,Briones; Jor-el Thomas Caparas,0,1,36,36
1656778606414,MATH 20C,B01,083762,Bach; Quang Tran,0,0,30,30
1656778612440,MATH 20D,A01,083765,Tran; Brian Kha,4,0,30,26
1656778612440,MATH 20D,A02,083766,Tran; Brian Kha,4,0,30,26
1656778612440,MATH 20D,A03,083767,Tran; Brian Kha,2,0,30,28
1656778618469,MATH 20E,A01,083771,Ganguly; Soumya,5,0,32,27
1656778618469,MATH 20E,A02,083772,Ganguly; Soumya,5,0,32,27
1656778618469,MATH 20E,B01,083773,Ciotti; Benjamin,18,0,35,17
1656778618469,MATH 20E,B02,083774,Ciotti; Benjamin,17,0,35,18
1656778624491,MATH 103A,A01,083777,Greenfeld; Be'Eri,2,0,36,34
1656778624491,MATH 103A,A02,083778,Greenfeld; Be'Eri,5,0,36,31
1656778624491,MATH 103A,A03,093561,Greenfeld; Be'Eri,4,0,36,32
1656778624491,MATH 103A,B01,083779,Greenfeld; Be'Eri,6,0,36,30
1656778624491,MATH 103A,B02,083780,Greenfeld; Be'Eri,2,0,36,34
1656778624491,MATH 103A,B03,093562,Greenfeld; Be'Eri,2,0,36,34
1656778630520,MATH 105,A01,085443,Carter; Anne Toulson,13,0,35,22
1656778630520,MATH 105,A02,093477,Carter; Anne Toulson,20,0,35,15
1656778636544,MATH 109,A01,083213,Ganzberger; Geoffrey Michael,2,0,34,32
1656778636544,MATH 109,A02,083214,Ganzberger; Geoffrey Michael,2,0,34,32
1656778636544,MATH 109,A03,093478,Ganzberger; Geoffrey Michael,1,0,34,33
1656778636544,MATH 109,B01,083215,Ganzberger; Geoffrey Michael,1,0,32,31
1656778636544,MATH 109,B02,083216,Ganzberger; Geoffrey Michael,1,0,32,31
1656778636544,MATH 109,B03,093479,Ganzberger; Geoffrey Michael,6,0,32,26
1656778642574,MATH 142A,A01,083219,Chow; Bennett,6,0,32,26
1656778642574,MATH 142A,A02,083220,Chow; Bennett,9,0,32,23
1656778642574,MATH 142A,A03,093480,Chow; Bennett,7,0,32,25
1656778642574,MATH 142A,B03,093481,Chow; Bennett,7,0,32,25
1656778642574,MATH 142A,B04,093558,Chow; Bennett,10,0,32,22
1656778642574,MATH 142A,B05,093559,Chow; Bennett,6,0,32,26
1656778648597,MATH 193A,A01,083224,Rotar; Vladimir,6,0,34,28
1656778648597,MATH 193A,A02,083225,Rotar; Vladimir,3,0,34,31
1656778648597,MATH 193A,A03,083781,Rotar; Vladimir,1,0,34,33
1656778648597,MATH 193A,A04,083782,Rotar; Vladimir,6,0,34,28
1656778648597,MATH 193A,A05,093482,Rotar; Vladimir,6,0,34,28
1656778654620,MATH 197,001,091859,McAuley; Julian John,9999,0,9999,0
1656778654620,MATH 197,002,095566,Kedlaya; Kiran S.,9997,0,9999,2
1656778654620,MATH 197,003,095567,Xiao; Ming,9999,0,9999,0
1656778654620,MATH 197,004,095571,Perols; Johan Lars,9998,0,9999,1
1656778661672,COGS 9,A01,083615,Shannon; Kyle Michael,6,0,75,69
1656778667696,COGS 11,A01,083617,Boyle; Mary E. T.,18,0,48,30
1656778673722,COGS 13,A01,083071,Bastos; Amalia Pinkusfeld,8,0,71,63
1656778679744,COGS 14A,A01,092681,Semenuks; Arturs,0,1,100,100
1656778685766,COGS 14B,A01,083073,Cheng; Tzu-Han,5,0,63,58
1656778691791,COGS 17,A01,092677,Semenuks; Arturs,4,0,81,77
1656778697815,COGS 100,A01,083619,Allen; Michael Gordon,15,0,70,55
1656778703839,COGS 101A,A01,083621,Davis; Joshua Daniel,9,0,68,59
1656778709866,COGS 101B,A01,091572,Allen; Michael Gordon,8,0,65,57
1656778715891,COGS 101C,A01,083625,Delgado; Tania,17,0,35,18
1656778721920,COGS 107A,A01,083627,Boyle; Mary E. T.,13,0,60,47
1656778727942,COGS 118A,A01,083075,Gupta; Anjum,15,0,76,61
1656778733966,CSE 3,A50,083646,Miranda; Gregory Joseph,22,0,50,28
1656778740006,CSE 8A,A50,083650,Miranda; Gregory Joseph,17,1,56,39
1656778746029,CSE 11,A01,083080,Cao; Yingjun,4,15,40,36
1656778752051,CSE 12,A01,083652,Krause-Levy; Sophia Louisa,20,1,120,100
1656778758074,CSE 15L,A01,083654,Morris; Justin Loren,8,0,50,42
1656778758074,CSE 15L,A02,083655,Morris; Justin Loren,8,0,50,42
1656778764097,CSE 20,A01,083657,Tran; Khoa Dang,37,0,80,43
1656778770126,CSE 21,A01,095574,Bach; Quang Tran,21,0,48,27
1656778776149,CSE 30,A01,083084,Eldon; John,4,0,80,76
1656778776149,CSE 30,B01,095061,Bhaskar; Nishant,5,0,50,45
1656778782175,CSE 100,A01,083659,Cao; Yingjun,1,4,70,69
1656778788201,CSE 134B,A01,083661,Powell; Thomas Allan,18,0,100,82
1656778794224,CSE 140,A01,083663,Gungor; Onat,14,0,85,71
1656778800248,CSE 140L,A01,083088,Eldon; John,16,0,100,84
1656778806277,CSE 175,A01,083665,Kumar; Rakesh,3,0,25,22
1656778812299,CSE 190,A00,092507,Dubnov; Shlomo,7,0,20,13
1656778818324,ECE 45,A01,083139,Congero; Spencer William,5,0,75,70
1656778824347,ECE 65,A50,083695,Saad; Andrew S,12,0,30,18
1656778824347,ECE 65,A51,095125,Saad; Andrew S,25,0,26,1
1656778830372,ECE 109,A01,091882,Touri; Behrouz,15,0,70,55
1656778836398,ECE 180,A00,083140,Abi Samra; Nicholas Camill,0,0,30,30
1656778836398,ECE 180,B00,083141,Abi Samra; Nicholas Camill,0,0,30,30
1656778842424,MATH 10A,A01,083735,Patchell; Gregory David,1,0,30,29
1656778842424,MATH 10A,A02,083736,Patchell; Gregory David,20,0,30,10
1656778842424,MATH 10A,A03,083737,Patchell; Gregory David,15,0,30,15
1656778848454,MATH 10B,A01,083207,Lim; Seonhee,7,0,34,27
1656778848454,MATH 10B,A02,083208,Lim; Seonhee,9,0,35,26
1656778848454,MATH 10B,A03,093472,Lim; Seonhee,4,0,34,30
1656778848454,MATH 10B,B01,083739,Sinha; Shubham,9,0,30,21
1656778854487,MATH 18,A01,083743,Cinel; Cameron Alexander,6,0,30,24
1656778854487,MATH 18,A02,083744,Cinel; Cameron Alexander,15,0,30,15
1656778854487,MATH 18,A03,083745,Cinel; Cameron Alexander,8,0,30,22
1656778854487,MATH 18,B01,083748,Rideout; David Porter,3,0,37,34
1656778854487,MATH 18,B02,083749,Rideout; David Porter,3,0,36,33
1656778854487,MATH 18,B03,083750,Rideout; David Porter,1,0,37,36
1656778854487,MATH 18,B04,083751,Rideout; David Porter,5,0,36,31
1656778854487,MATH 18,B05,093473,Rideout; David Porter,4,0,36,32
1656778854487,MATH 18,B06,093474,Rideout; David Porter,5,0,36,31
1656778860511,MATH 20A,A01,083754,Zheng; Zequn,12,0,40,28
1656778866535,MATH 20B,A01,083756,Briones; Jor-el Thomas Caparas,1,0,36,35
1656778866535,MATH 20B,A02,083757,Briones; Jor-el Thomas Caparas,1,0,36,35
1656778866535,MATH 20B,A03,093475,Briones; Jor-el Thomas Caparas,0,0,36,36
1656778872561,MATH 20C,A01,083760,Briones; Jor-el Thomas Caparas,1,0,35,34
1656778872561,MATH 20C,A02,083761,Briones; Jor-el Thomas Caparas,8,0,35,27
1656778872561,MATH 20C,A03,093476,Briones; Jor-el Thomas Caparas,0,1,36,36
1656778872561,MATH 20C,B01,083762,Bach; Quang Tran,0,0,30,30
1656778878589,MATH 20D,A01,083765,Tran; Brian Kha,4,0,30,26
1656778878589,MATH 20D,A02,083766,Tran; Brian Kha,4,0,30,26
1656778878589,MATH 20D,A03,083767,Tran; Brian Kha,2,0,30,28
1656778884615,MATH 20E,A01,083771,Ganguly; Soumya,5,0,32,27
1656778884615,MATH 20E,A02,083772,Ganguly; Soumya,5,0,32,27
1656778884615,MATH 20E,B01,083773,Ciotti; Benjamin,18,0,35,17
1656778884615,MATH 20E,B02,083774,Ciotti; Benjamin,17,0,35,18
1656778890641,MATH 103A,A01,083777,Greenfeld; Be'Eri,2,0,36,34
1656778890641,MATH 103A,A02,083778,Greenfeld; Be'Eri,5,0,36,31
1656778890641,MATH 103A,A03,093561,Greenfeld; Be'Eri,4,0,36,32
1656778890641,MATH 103A,B01,083779,Greenfeld; Be'Eri,6,0,36,30
1656778890641,MATH 103A,B02,083780,Greenfeld; Be'Eri,2,0,36,34
1656778890641,MATH 103A,B03,093562,Greenfeld; Be'Eri,2,0,36,34
1656778896666,MATH 105,A01,085443,Carter; Anne Toulson,13,0,35,22
1656778896666,MATH 105,A02,093477,Carter; Anne Toulson,20,0,35,15
1656778902707,MATH 109,A01,083213,Ganzberger; Geoffrey Michael,2,0,34,32
1656778902707,MATH 109,A02,083214,Ganzberger; Geoffrey Michael,2,0,34,32
1656778902707,MATH 109,A03,093478,Ganzberger; Geoffrey Michael,1,0,34,33
1656778902707,MATH 109,B01,083215,Ganzberger; Geoffrey Michael,1,0,32,31
1656778902707,MATH 109,B02,083216,Ganzberger; Geoffrey Michael,1,0,32,31
1656778902707,MATH 109,B03,093479,Ganzberger; Geoffrey Michael,6,0,32,26
1656778908731,MATH 142A,A01,083219,Chow; Bennett,6,0,32,26
1656778908731,MATH 142A,A02,083220,Chow; Bennett,9,0,32,23
1656778908731,MATH 142A,A03,093480,Chow; Bennett,7,0,32,25
1656778908731,MATH 142A,B03,093481,Chow; Bennett,7,0,32,25
1656778908731,MATH 142A,B04,093558,Chow; Bennett,10,0,32,22
1656778908731,MATH 142A,B05,093559,Chow; Bennett,6,0,32,26
1656778914779,MATH 193A,A01,083224,Rotar; Vladimir,6,0,34,28
1656778914779,MATH 193A,A02,083225,Rotar; Vladimir,3,0,34,31
1656778914779,MATH 193A,A03,083781,Rotar; Vladimir,1,0,34,33
1656778914779,MATH 193A,A04,083782,Rotar; Vladimir,6,0,34,28
1656778914779,MATH 193A,A05,093482,Rotar; Vladimir,6,0,34,28
1656778920804,MATH 197,001,091859,McAuley; Julian John,9999,0,9999,0
1656778920804,MATH 197,002,095566,Kedlaya; Kiran S.,9997,0,9999,2
1656778920804,MATH 197,003,095567,Xiao; Ming,9999,0,9999,0
1656778920804,MATH 197,004,095571,Perols; Johan Lars,9998,0,9999,1
1656778927874,COGS 9,A01,083615,Shannon; Kyle Michael,6,0,75,69
1656778933899,COGS 11,A01,083617,Boyle; Mary E. T.,18,0,48,30
1656778939925,COGS 13,A01,083071,Bastos; Amalia Pinkusfeld,8,0,71,63
1656778945952,COGS 14A,A01,092681,Semenuks; Arturs,0,1,100,100
1656778951981,COGS 14B,A01,083073,Cheng; Tzu-Han,5,0,63,58
1656778958005,COGS 17,A01,092677,Semenuks; Arturs,4,0,81,77
1656778964029,COGS 100,A01,083619,Allen; Michael Gordon,15,0,70,55
1656778970054,COGS 101A,A01,083621,Davis; Joshua Daniel,9,0,68,59
1656778976081,COGS 101B,A01,091572,Allen; Michael Gordon,8,0,65,57
1656778982105,COGS 101C,A01,083625,Delgado; Tania,17,0,35,18
1656778988132,COGS 107A,A01,083627,Boyle; Mary E. T.,13,0,60,47
1656778994248,COGS 118A,A01,083075,Gupta; Anjum,15,0,76,61
1656779000275,CSE 3,A50,083646,Miranda; Gregory Joseph,22,0,50,28
1656779006298,CSE 8A,A50,083650,Miranda; Gregory Joseph,17,1,56,39
1656779012321,CSE 11,A01,083080,Cao; Yingjun,4,15,40,36
1656779018343,CSE 12,A01,083652,Krause-Levy; Sophia Louisa,20,1,120,100
1656779024369,CSE 15L,A01,083654,Morris; Justin Loren,8,0,50,42
1656779024369,CSE 15L,A02,083655,Morris; Justin Loren,8,0,50,42
1656779030393,CSE 20,A01,083657,Tran; Khoa Dang,37,0,80,43
1656779036420,CSE 21,A01,095574,Bach; Quang Tran,21,0,48,27
1656779042446,CSE 30,A01,083084,Eldon; John,4,0,80,76
1656779042446,CSE 30,B01,095061,Bhaskar; Nishant,5,0,50,45
1656779048471,CSE 100,A01,083659,Cao; Yingjun,1,4,70,69
1656779054497,CSE 134B,A01,083661,Powell; Thomas Allan,18,0,100,82
1656779060520,CSE 140,A01,083663,Gungor; Onat,14,0,85,71
1656779066548,CSE 140L,A01,083088,Eldon; John,16,0,100,84
1656779072579,CSE 175,A01,083665,Kumar; Rakesh,3,0,25,22
1656779078606,CSE 190,A00,092507,Dubnov; Shlomo,7,0,20,13
1656779084633,ECE 45,A01,083139,Congero; Spencer William,5,0,75,70
1656779090656,ECE 65,A50,083695,Saad; Andrew S,12,0,30,18
1656779090656,ECE 65,A51,095125,Saad; Andrew S,25,0,26,1
1656779096682,ECE 109,A01,091882,Touri; Behrouz,15,0,70,55
1656779102705,ECE 180,A00,083140,Abi Samra; Nicholas Camill,0,0,30,30
1656779102705,ECE 180,B00,083141,Abi Samra; Nicholas Camill,0,0,30,30
1656779108730,MATH 10A,A01,083735,Patchell; Gregory David,1,0,30,29
1656779108730,MATH 10A,A02,083736,Patchell; Gregory David,20,0,30,10
1656779108730,MATH 10A,A03,083737,Patchell; Gregory David,15,0,30,15
1656779114759,MATH 10B,A01,083207,Lim; Seonhee,7,0,34,27
1656779114759,MATH 10B,A02,083208,Lim; Seonhee,9,0,35,26
1656779114759,MATH 10B,A03,093472,Lim; Seonhee,4,0,34,30
1656779114759,MATH 10B,B01,083739,Sinha; Shubham,9,0,30,21
1656779120792,MATH 18,A01,083743,Cinel; Cameron Alexander,6,0,30,24
1656779120792,MATH 18,A02,083744,Cinel; Cameron Alexander,15,0,30,15
1656779120792,MATH 18,A03,083745,Cinel; Cameron Alexander,8,0,30,22
1656779120792,MATH 18,B01,083748,Rideout; David Porter,3,0,37,34
1656779120792,MATH 18,B02,083749,Rideout; David Porter,3,0,36,33
1656779120792,MATH 18,B03,083750,Rideout; David Porter,1,0,37,36
1656779120792,MATH 18,B04,083751,Rideout; David Porter,5,0,36,31
1656779120792,MATH 18,B05,093473,Rideout; David Porter,4,0,36,32
1656779120792,MATH 18,B06,093474,Rideout; David Porter,5,0,36,31
1656779126817,MATH 20A,A01,083754,Zheng; Zequn,12,0,40,28
1656779132841,MATH 20B,A01,083756,Briones; Jor-el Thomas Caparas,1,0,36,35
1656779132841,MATH 20B,A02,083757,Briones; Jor-el Thomas Caparas,1,0,36,35
1656779132841,MATH 20B,A03,093475,Briones; Jor-el Thomas Caparas,0,0,36,36
1656779138870,MATH 20C,A01,083760,Briones; Jor-el Thomas Caparas,1,0,35,34
1656779138870,MATH 20C,A02,083761,Briones; Jor-el Thomas Caparas,8,0,35,27
1656779138870,MATH 20C,A03,093476,Briones; Jor-el Thomas Caparas,0,1,36,36
1656779138870,MATH 20C,B01,083762,Bach; Quang Tran,0,0,30,30
1656779144896,MATH 20D,A01,083765,Tran; Brian Kha,4,0,30,26
1656779144896,MATH 20D,A02,083766,Tran; Brian Kha,4,0,30,26
1656779144896,MATH 20D,A03,083767,Tran; Brian Kha,2,0,30,28
1656779150934,MATH 20E,A01,083771,Ganguly; Soumya,5,0,32,27
1656779150934,MATH 20E,A02,083772,Ganguly; Soumya,5,0,32,27
1656779150934,MATH 20E,B01,083773,Ciotti; Benjamin,18,0,35,17
1656779150934,MATH 20E,B02,083774,Ciotti; Benjamin,17,0,35,18
1656779156965,MATH 103A,A01,083777,Greenfeld; Be'Eri,2,0,36,34
1656779156965,MATH 103A,A02,083778,Greenfeld; Be'Eri,5,0,36,31
1656779156965,MATH 103A,A03,093561,Greenfeld; Be'Eri,4,0,36,32
1656779156965,MATH 103A,B01,083779,Greenfeld; Be'Eri,6,0,36,30
1656779156965,MATH 103A,B02,083780,Greenfeld; Be'Eri,2,0,36,34
1656779156965,MATH 103A,B03,093562,Greenfeld; Be'Eri,2,0,36,34
1656779162989,MATH 105,A01,085443,Carter; Anne Toulson,13,0,35,22
1656779162989,MATH 105,A02,093477,Carter; Anne Toulson,20,0,35,15
1656779169019,MATH 109,A01,083213,Ganzberger; Geoffrey Michael,2,0,34,32
1656779169019,MATH 109,A02,083214,Ganzberger; Geoffrey Michael,2,0,34,32
1656779169019,MATH 109,A03,093478,Ganzberger; Geoffrey Michael,1,0,34,33
1656779169019,MATH 109,B01,083215,Ganzberger; Geoffrey Michael,1,0,32,31
1656779169019,MATH 109,B02,083216,Ganzberger; Geoffrey Michael,1,0,32,31
1656779169019,MATH 109,B03,093479,Ganzberger; Geoffrey Michael,6,0,32,26
1656779175044,MATH 142A,A01,083219,Chow; Bennett,6,0,32,26
1656779175044,MATH 142A,A02,083220,Chow; Bennett,9,0,32,23
1656779175044,MATH 142A,A03,093480,Chow; Bennett,7,0,32,25
1656779175044,MATH 142A,B03,093481,Chow; Bennett,7,0,32,25
1656779175044,MATH 142A,B04,093558,Chow; Bennett,10,0,32,22
1656779175044,MATH 142A,B05,093559,Chow; Bennett,6,0,32,26
1656779181067,MATH 193A,A01,083224,Rotar; Vladimir,6,0,34,28
1656779181067,MATH 193A,A02,083225,Rotar; Vladimir,3,0,34,31
1656779181067,MATH 193A,A03,083781,Rotar; Vladimir,1,0,34,33
1656779181067,MATH 193A,A04,083782,Rotar; Vladimir,6,0,34,28
1656779181067,MATH 193A,A05,093482,Rotar; Vladimir,6,0,34,28
1656779187092,MATH 197,001,091859,McAuley; Julian John,9999,0,9999,0
1656779187092,MATH 197,002,095566,Kedlaya; Kiran S.,9997,0,9999,2
1656779187092,MATH 197,003,095567,Xiao; Ming,9999,0,9999,0
1656779187092,MATH 197,004,095571,Perols; Johan Lars,9998,0,9999,1
1656779194160,COGS 9,A01,083615,Shannon; Kyle Michael,6,0,75,69
1656779200188,COGS 11,A01,083617,Boyle; Mary E. T.,18,0,48,30
1656779206216,COGS 13,A01,083071,Bastos; Amalia Pinkusfeld,8,0,71,63
1656779212242,COGS 14A,A01,092681,Semenuks; Arturs,0,1,100,100
1656779218270,COGS 14B,A01,083073,Cheng; Tzu-Han,5,0,63,58
1656779224301,COGS 17,A01,092677,Semenuks; Arturs,4,0,81,77
1656779230325,COGS 100,A01,083619,Allen; Michael Gordon,15,0,70,55
1656779236350,COGS 101A,A01,083621,Davis; Joshua Daniel,9,0,68,59
1656779242378,COGS 101B,A01,091572,Allen; Michael Gordon,8,0,65,57
1656779248403,COGS 101C,A01,083625,Delgado; Tania,17,0,35,18
1656779254433,COGS 107A,A01,083627,Boyle; Mary E. T.,13,0,60,47
1656779260458,COGS 118A,A01,083075,Gupta; Anjum,15,0,76,61
1656779266492,CSE 3,A50,083646,Miranda; Gregory Joseph,22,0,50,28
1656779272525,CSE 8A,A50,083650,Miranda; Gregory Joseph,17,1,56,39
1656779278553,CSE 11,A01,083080,Cao; Yingjun,4,15,40,36
1656779284577,CSE 12,A01,083652,Krause-Levy; Sophia Louisa,20,1,120,100
1656779290600,CSE 15L,A01,083654,Morris; Justin Loren,8,0,50,42
1656779290600,CSE 15L,A02,083655,Morris; Justin Loren,8,0,50,42
1656779296628,CSE 20,A01,083657,Tran; Khoa Dang,37,0,80,43
1656779302670,CSE 21,A01,095574,Bach; Quang Tran,21,0,48,27
1656779308698,CSE 30,A01,083084,Eldon; John,4,0,80,76
1656779308698,CSE 30,B01,095061,Bhaskar; Nishant,5,0,50,45
1656779314725,CSE 100,A01,083659,Cao; Yingjun,1,4,70,69
1656779320750,CSE 134B,A01,083661,Powell; Thomas Allan,18,0,100,82
1656779326787,CSE 140,A01,083663,Gungor; Onat,14,0,85,71
1656779332816,CSE 140L,A01,083088,Eldon; John,16,0,100,84
1656779338840,CSE 175,A01,083665,Kumar; Rakesh,3,0,25,22
1656779344865,CSE 190,A00,092507,Dubnov; Shlomo,7,0,20,13
1656779351848,ECE 45,A01,083139,Congero; Spencer William,5,0,75,70
1656779357876,ECE 65,A50,083695,Saad; Andrew S,12,0,30,18
1656779357876,ECE 65,A51,095125,Saad; Andrew S,25,0,26,1
1656779363910,ECE 109,A01,091882,Touri; Behrouz,15,0,70,55
1656779369946,ECE 180,A00,083140,Abi Samra; Nicholas Camill,0,0,30,30
1656779369946,ECE 180,B00,083141,Abi Samra; Nicholas Camill,0,0,30,30
1656779375971,MATH 10A,A01,083735,Patchell; Gregory David,1,0,30,29
1656779375971,MATH 10A,A02,083736,Patchell; Gregory David,20,0,30,10
1656779375971,MATH 10A,A03,083737,Patchell; Gregory David,15,0,30,15
1656779382028,MATH 10B,A01,083207,Lim; Seonhee,7,0,34,27
1656779382028,MATH 10B,A02,083208,Lim; Seonhee,9,0,35,26
1656779382028,MATH 10B,A03,093472,Lim; Seonhee,4,0,34,30
1656779382028,MATH 10B,B01,083739,Sinha; Shubham,9,0,30,21
1656779388054,MATH 18,A01,083743,Cinel; Cameron Alexander,6,0,30,24
1656779388054,MATH 18,A02,083744,Cinel; Cameron Alexander,15,0,30,15
1656779388054,MATH 18,A03,083745,Cinel; Cameron Alexander,8,0,30,22
1656779388054,MATH 18,B01,083748,Rideout; David Porter,3,0,37,34
1656779388054,MATH 18,B02,083749,Rideout; David Porter,3,0,36,33
1656779388054,MATH 18,B03,083750,Rideout; David Porter,1,0,37,36
1656779388054,MATH 18,B04,083751,Rideout; David Porter,5,0,36,31
1656779388054,MATH 18,B05,093473,Rideout; David Porter,4,0,36,32
1656779388054,MATH 18,B06,093474,Rideout; David Porter,5,0,36,31
1656779394079,MATH 20A,A01,083754,Zheng; Zequn,12,0,40,28
1656779400115,MATH 20B,A01,083756,Briones; Jor-el Thomas Caparas,1,0,36,35
1656779400115,MATH 20B,A02,083757,Briones; Jor-el Thomas Caparas,1,0,36,35
1656779400115,MATH 20B,A03,093475,Briones; Jor-el Thomas Caparas,0,0,36,36
1656779406153,MATH 20C,A01,083760,Briones; Jor-el Thomas Caparas,1,0,35,34
1656779406153,MATH 20C,A02,083761,Briones; Jor-el Thomas Caparas,8,0,35,27
1656779406153,MATH 20C,A03,093476,Briones; Jor-el Thomas Caparas,0,1,36,36
1656779406153,MATH 20C,B01,083762,Bach; Quang Tran,0,0,30,30
1656779412181,MATH 20D,A01,083765,Tran; Brian Kha,4,0,30,26
1656779412181,MATH 20D,A02,083766,Tran; Brian Kha,4,0,30,26
1656779412181,MATH 20D,A03,083767,Tran; Brian Kha,2,0,30,28
1656779418209,MATH 20E,A01,083771,Ganguly; Soumya,5,0,32,27
1656779418209,MATH 20E,A02,083772,Ganguly; Soumya,5,0,32,27
1656779418209,MATH 20E,B01,083773,Ciotti; Benjamin,18,0,35,17
1656779418209,MATH 20E,B02,083774,Ciotti; Benjamin,17,0,35,18
1656779424237,MATH 103A,A01,083777,Greenfeld; Be'Eri,2,0,36,34
1656779424237,MATH 103A,A02,083778,Greenfeld; Be'Eri,5,0,36,31
1656779424237,MATH 103A,A03,093561,Greenfeld; Be'Eri,4,0,36,32
1656779424237,MATH 103A,B01,083779,Greenfeld; Be'Eri,6,0,36,30
1656779424237,MATH 103A,B02,083780,Greenfeld; Be'Eri,2,0,36,34
1656779424237,MATH 103A,B03,093562,Greenfeld; Be'Eri,2,0,36,34
1656779430267,MATH 105,A01,085443,Carter; Anne Toulson,13,0,35,22
1656779430267,MATH 105,A02,093477,Carter; Anne Toulson,20,0,35,15
1656779436299,MATH 109,A01,083213,Ganzberger; Geoffrey Michael,2,0,34,32
1656779436299,MATH 109,A02,083214,Ganzberger; Geoffrey Michael,2,0,34,32
1656779436299,MATH 109,A03,093478,Ganzberger; Geoffrey Michael,1,0,34,33
1656779436299,MATH 109,B01,083215,Ganzberger; Geoffrey Michael,1,0,32,31
1656779436299,MATH 109,B02,083216,Ganzberger; Geoffrey Michael,1,0,32,31
1656779436299,MATH 109,B03,093479,Ganzberger; Geoffrey Michael,6,0,32,26
1656779442331,MATH 142A,A01,083219,Chow; Bennett,6,0,32,26
1656779442331,MATH 142A,A02,083220,Chow; Bennett,9,0,32,23
1656779442331,MATH 142A,A03,093480,Chow; Bennett,7,0,32,25
1656779442331,MATH 142A,B03,093481,Chow; Bennett,7,0,32,25
1656779442331,MATH 142A,B04,093558,Chow; Bennett,10,0,32,22
1656779442331,MATH 142A,B05,093559,Chow; Bennett,6,0,32,26
1656779448356,MATH 193A,A01,083224,Rotar; Vladimir,6,0,34,28
1656779448356,MATH 193A,A02,083225,Rotar; Vladimir,3,0,34,31
1656779448356,MATH 193A,A03,083781,Rotar; Vladimir,1,0,34,33
1656779448356,MATH 193A,A04,083782,Rotar; Vladimir,6,0,34,28
1656779448356,MATH 193A,A05,093482,Rotar; Vladimir,6,0,34,28
1656779454390,MATH 197,001,091859,McAuley; Julian John,9999,0,9999,0
1656779454390,MATH 197,002,095566,Kedlaya; Kiran S.,9997,0,9999,2
1656779454390,MATH 197,003,095567,Xiao; Ming,9999,0,9999,0
1656779454390,MATH 197,004,095571,Perols; Johan Lars,9998,0,9999,1
1656779461452,COGS 9,A01,083615,Shannon; Kyle Michael,6,0,75,69
1656779467477,COGS 11,A01,083617,Boyle; Mary E. T.,18,0,48,30
1656779473500,COGS 13,A01,083071,Bastos; Amalia Pinkusfeld,8,0,71,63
1656779479534,COGS 14A,A01,092681,Semenuks; Arturs,0,1,100,100
1656779485559,COGS 14B,A01,083073,Cheng; Tzu-Han,5,0,63,58
1656779491586,COGS 17,A01,092677,Semenuks; Arturs,4,0,81,77
1656779497616,COGS 100,A01,083619,Allen; Michael Gordon,15,0,70,55
1656779503639,COGS 101A,A01,083621,Davis; Joshua Daniel,9,0,68,59
1656779509667,COGS 101B,A01,091572,Allen; Michael Gordon,8,0,65,57
1656779515704,COGS 101C,A01,083625,Delgado; Tania,17,0,35,18
1656779521734,COGS 107A,A01,083627,Boyle; Mary E. T.,13,0,60,47
1656779527763,COGS 118A,A01,083075,Gupta; Anjum,15,0,76,61
1656779533787,CSE 3,A50,083646,Miranda; Gregory Joseph,22,0,50,28
1656779539819,CSE 8A,A50,083650,Miranda; Gregory Joseph,17,1,56,39
1656779545845,CSE 11,A01,083080,Cao; Yingjun,4,15,40,36
1656779551876,CSE 12,A01,083652,Krause-Levy; Sophia Louisa,20,1,120,100
1656779557899,CSE 15L,A01,083654,Morris; Justin Loren,8,0,50,42
1656779557899,CSE 15L,A02,083655,Morris; Justin Loren,8,0,50,42
1656779563928,CSE 20,A01,083657,Tran; Khoa Dang,37,0,80,43
1656779569951,CSE 21,A01,095574,Bach; Quang Tran,21,0,48,27
1656779575977,CSE 30,A01,083084,Eldon; John,4,0,80,76
1656779575977,CSE 30,B01,095061,Bhaskar; Nishant,5,0,50,45
1656779582005,CSE 100,A01,083659,Cao; Yingjun,1,4,70,69
1656779588030,CSE 134B,A01,083661,Powell; Thomas Allan,18,0,100,82
1656779594128,CSE 140,A01,083663,Gungor; Onat,14,0,85,71
1656779600152,CSE 140L,A01,083088,Eldon; John,16,0,100,84
1656779606184,CSE 175,A01,083665,Kumar; Rakesh,3,0,25,22
1656779612208,CSE 190,A00,092507,Dubnov; Shlomo,7,0,20,13
1656779618233,ECE 45,A01,083139,Congero; Spencer William,5,0,75,70
1656779624260,ECE 65,A50,083695,Saad; Andrew S,12,0,30,18
1656779624260,ECE 65,A51,095125,Saad; Andrew S,25,0,26,1
1656779630294,ECE 109,A01,091882,Touri; Behrouz,15,0,70,55
1656779636320,ECE 180,A00,083140,Abi Samra; Nicholas Camill,0,0,30,30
1656779636320,ECE 180,B00,083141,Abi Samra; Nicholas Camill,0,0,30,30
1656779642345,MATH 10A,A01,083735,Patchell; Gregory David,1,0,30,29
1656779642345,MATH 10A,A02,083736,Patchell; Gregory David,20,0,30,10
1656779642345,MATH 10A,A03,083737,Patchell; Gregory David,15,0,30,15
1656779648372,MATH 10B,A01,083207,Lim; Seonhee,7,0,34,27
1656779648372,MATH 10B,A02,083208,Lim; Seonhee,9,0,35,26
1656779648372,MATH 10B,A03,093472,Lim; Seonhee,4,0,34,30
1656779648372,MATH 10B,B01,083739,Sinha; Shubham,9,0,30,21
1656779654403,MATH 18,A01,083743,Cinel; Cameron Alexander,6,0,30,24
1656779654403,MATH 18,A02,083744,Cinel; Cameron Alexander,15,0,30,15
1656779654403,MATH 18,A03,083745,Cinel; Cameron Alexander,8,0,30,22
1656779654403,MATH 18,B01,083748,Rideout; David Porter,3,0,37,34
1656779654403,MATH 18,B02,083749,Rideout; David Porter,3,0,36,33
1656779654403,MATH 18,B03,083750,Rideout; David Porter,1,0,37,36
1656779654403,MATH 18,B04,083751,Rideout; David Porter,5,0,36,31
1656779654403,MATH 18,B05,093473,Rideout; David Porter,4,0,36,32
1656779654403,MATH 18,B06,093474,Rideout; David Porter,5,0,36,31
1656779660427,MATH 20A,A01,083754,Zheng; Zequn,12,0,40,28
1656779666452,MATH 20B,A01,083756,Briones; Jor-el Thomas Caparas,1,0,36,35
1656779666452,MATH 20B,A02,083757,Briones; Jor-el Thomas Caparas,1,0,36,35
1656779666452,MATH 20B,A03,093475,Briones; Jor-el Thomas Caparas,0,0,36,36
1656779672477,MATH 20C,A01,083760,Briones; Jor-el Thomas Caparas,1,0,35,34
1656779672477,MATH 20C,A02,083761,Briones; Jor-el Thomas Caparas,8,0,35,27
1656779672477,MATH 20C,A03,093476,Briones; Jor-el Thomas Caparas,0,1,36,36
1656779672477,MATH 20C,B01,083762,Bach; Quang Tran,0,0,30,30
1656779678503,MATH 20D,A01,083765,Tran; Brian Kha,4,0,30,26
1656779678503,MATH 20D,A02,083766,Tran; Brian Kha,4,0,30,26
1656779678503,MATH 20D,A03,083767,Tran; Brian Kha,2,0,30,28
1656779684535,MATH 20E,A01,083771,Ganguly; Soumya,5,0,32,27
1656779684535,MATH 20E,A02,083772,Ganguly; Soumya,5,0,32,27
1656779684535,MATH 20E,B01,083773,Ciotti; Benjamin,18,0,35,17
1656779684535,MATH 20E,B02,083774,Ciotti; Benjamin,17,0,35,18
1656779690561,MATH 103A,A01,083777,Greenfeld; Be'Eri,2,0,36,34
1656779690561,MATH 103A,A02,083778,Greenfeld; Be'Eri,5,0,36,31
1656779690561,MATH 103A,A03,093561,Greenfeld; Be'Eri,4,0,36,32
1656779690561,MATH 103A,B01,083779,Greenfeld; Be'Eri,6,0,36,30
1656779690561,MATH 103A,B02,083780,Greenfeld; Be'Eri,2,0,36,34
1656779690561,MATH 103A,B03,093562,Greenfeld; Be'Eri,2,0,36,34
1656779696588,MATH 105,A01,085443,Carter; Anne Toulson,13,0,35,22
1656779696588,MATH 105,A02,093477,Carter; Anne Toulson,20,0,35,15
1656779702623,MATH 109,A01,083213,Ganzberger; Geoffrey Michael,2,0,34,32
1656779702623,MATH 109,A02,083214,Ganzberger; Geoffrey Michael,2,0,34,32
1656779702623,MATH 109,A03,093478,Ganzberger; Geoffrey Michael,1,0,34,33
1656779702623,MATH 109,B01,083215,Ganzberger; Geoffrey Michael,1,0,32,31
1656779702623,MATH 109,B02,083216,Ganzberger; Geoffrey Michael,1,0,32,31
1656779702623,MATH 109,B03,093479,Ganzberger; Geoffrey Michael,6,0,32,26
1656779708650,MATH 142A,A01,083219,Chow; Bennett,6,0,32,26
1656779708650,MATH 142A,A02,083220,Chow; Bennett,9,0,32,23
1656779708650,MATH 142A,A03,093480,Chow; Bennett,7,0,32,25
1656779708650,MATH 142A,B03,093481,Chow; Bennett,7,0,32,25
1656779708650,MATH 142A,B04,093558,Chow; Bennett,10,0,32,22
1656779708650,MATH 142A,B05,093559,Chow; Bennett,6,0,32,26
1656779714675,MATH 193A,A01,083224,Rotar; Vladimir,6,0,34,28
1656779714675,MATH 193A,A02,083225,Rotar; Vladimir,3,0,34,31
1656779714675,MATH 193A,A03,083781,Rotar; Vladimir,1,0,34,33
1656779714675,MATH 193A,A04,083782,Rotar; Vladimir,6,0,34,28
1656779714675,MATH 193A,A05,093482,Rotar; Vladimir,6,0,34,28
1656779720700,MATH 197,001,091859,McAuley; Julian John,9999,0,9999,0
1656779720700,MATH 197,002,095566,Kedlaya; Kiran S.,9997,0,9999,2
1656779720700,MATH 197,003,095567,Xiao; Ming,9999,0,9999,0
1656779720700,MATH 197,004,095571,Perols; Johan Lars,9998,0,9999,1
1656779727765,COGS 9,A01,083615,Shannon; Kyle Michael,6,0,75,69
1656779733792,COGS 11,A01,083617,Boyle; Mary E. T.,18,0,48,30
1656779739816,COGS 13,A01,083071,Bastos; Amalia Pinkusfeld,8,0,71,63
1656779745847,COGS 14A,A01,092681,Semenuks; Arturs,0,1,100,100
1656779751871,COGS 14B,A01,083073,Cheng; Tzu-Han,5,0,63,58
1656779757898,COGS 17,A01,092677,Semenuks; Arturs,4,0,81,77
1656779763927,COGS 100,A01,083619,Allen; Michael Gordon,15,0,70,55
1656779769952,COGS 101A,A01,083621,Davis; Joshua Daniel,9,0,68,59
1656779775976,COGS 101B,A01,091572,Allen; Michael Gordon,8,0,65,57
1656779782004,COGS 101C,A01,083625,Delgado; Tania,17,0,35,18
1656779788028,COGS 107A,A01,083627,Boyle; Mary E. T.,13,0,60,47
1656779794053,COGS 118A,A01,083075,Gupta; Anjum,15,0,76,61
1656779800079,CSE 3,A50,083646,Miranda; Gregory Joseph,22,0,50,28
1656779806107,CSE 8A,A50,083650,Miranda; Gregory Joseph,17,1,56,39
1656779812136,CSE 11,A01,083080,Cao; Yingjun,4,15,40,36
1656779818161,CSE 12,A01,083652,Krause-Levy; Sophia Louisa,20,1,120,100
1656779824185,CSE 15L,A01,083654,Morris; Justin Loren,8,0,50,42
1656779824185,CSE 15L,A02,083655,Morris; Justin Loren,8,0,50,42
1656779830221,CSE 20,A01,083657,Tran; Khoa Dang,37,0,80,43
1656779836245,CSE 21,A01,095574,Bach; Quang Tran,21,0,48,27
1656779842270,CSE 30,A01,083084,Eldon; John,4,0,80,76
1656779842270,CSE 30,B01,095061,Bhaskar; Nishant,5,0,50,45
1656779848293,CSE 100,A01,083659,Cao; Yingjun,1,4,70,69
1656779854322,CSE 134B,A01,083661,Powell; Thomas Allan,18,0,100,82
1656779869692,CSE 140,A01,083663,Gungor; Onat,14,0,85,71
1656779875715,CSE 140L,A01,083088,Eldon; John,16,0,100,84
1656779881744,CSE 175,A01,083665,Kumar; Rakesh,3,0,25,22
1656779887766,CSE 190,A00,092507,Dubnov; Shlomo,7,0,20,13
1656779893793,ECE 45,A01,083139,Congero; Spencer William,5,0,75,70
1656779899816,ECE 65,A50,083695,Saad; Andrew S,12,0,30,18
1656779899816,ECE 65,A51,095125,Saad; Andrew S,25,0,26,1
1656779905849,ECE 109,A01,091882,Touri; Behrouz,15,0,70,55
1656779911871,ECE 180,A00,083140,Abi Samra; Nicholas Camill,0,0,30,30
1656779911871,ECE 180,B00,083141,Abi Samra; Nicholas Camill,0,0,30,30
1656779917904,MATH 10A,A01,083735,Patchell; Gregory David,1,0,30,29
1656779917904,MATH 10A,A02,083736,Patchell; Gregory David,20,0,30,10
1656779917904,MATH 10A,A03,083737,Patchell; Gregory David,15,0,30,15
1656779923931,MATH 10B,A01,083207,Lim; Seonhee,7,0,34,27
1656779923931,MATH 10B,A02,083208,Lim; Seonhee,9,0,35,26
1656779923931,MATH 10B,A03,093472,Lim; Seonhee,4,0,34,30
1656779923931,MATH 10B,B01,083739,Sinha; Shubham,9,0,30,21
1656779929959,MATH 18,A01,083743,Cinel; Cameron Alexander,6,0,30,24
1656779929959,MATH 18,A02,083744,Cinel; Cameron Alexander,15,0,30,15
1656779929959,MATH 18,A03,083745,Cinel; Cameron Alexander,8,0,30,22
1656779929959,MATH 18,B01,083748,Rideout; David Porter,3,0,37,34
1656779929959,MATH 18,B02,083749,Rideout; David Porter,3,0,36,33
1656779929959,MATH 18,B03,083750,Rideout; David Porter,1,0,37,36
1656779929959,MATH 18,B04,083751,Rideout; David Porter,5,0,36,31
1656779929959,MATH 18,B05,093473,Rideout; David Porter,4,0,36,32
1656779929959,MATH 18,B06,093474,Rideout; David Porter,5,0,36,31
1656779935991,MATH 20A,A01,083754,Zheng; Zequn,12,0,40,28
1656779942018,MATH 20B,A01,083756,Briones; Jor-el Thomas Caparas,1,0,36,35
1656779942018,MATH 20B,A02,083757,Briones; Jor-el Thomas Caparas,1,0,36,35
1656779942018,MATH 20B,A03,093475,Briones; Jor-el Thomas Caparas,0,0,36,36
1656779948051,MATH 20C,A01,083760,Briones; Jor-el Thomas Caparas,1,0,35,34
1656779948051,MATH 20C,A02,083761,Briones; Jor-el Thomas Caparas,8,0,35,27
1656779948051,MATH 20C,A03,093476,Briones; Jor-el Thomas Caparas,0,1,36,36
1656779948051,MATH 20C,B01,083762,Bach; Quang Tran,0,0,30,30
1656779954078,MATH 20D,A01,083765,Tran; Brian Kha,4,0,30,26
1656779954078,MATH 20D,A02,083766,Tran; Brian Kha,4,0,30,26
1656779954078,MATH 20D,A03,083767,Tran; Brian Kha,2,0,30,28
1656779960106,MATH 20E,A01,083771,Ganguly; Soumya,5,0,32,27
1656779960106,MATH 20E,A02,083772,Ganguly; Soumya,5,0,32,27
1656779960106,MATH 20E,B01,083773,Ciotti; Benjamin,18,0,35,17
1656779960106,MATH 20E,B02,083774,Ciotti; Benjamin,17,0,35,18
1656779966134,MATH 103A,A01,083777,Greenfeld; Be'Eri,2,0,36,34
1656779966134,MATH 103A,A02,083778,Greenfeld; Be'Eri,5,0,36,31
1656779966134,MATH 103A,A03,093561,Greenfeld; Be'Eri,4,0,36,32
1656779966134,MATH 103A,B01,083779,Greenfeld; Be'Eri,6,0,36,30
1656779966134,MATH 103A,B02,083780,Greenfeld; Be'Eri,2,0,36,34
1656779966134,MATH 103A,B03,093562,Greenfeld; Be'Eri,2,0,36,34
1656779972160,MATH 105,A01,085443,Carter; Anne Toulson,13,0,35,22
1656779972160,MATH 105,A02,093477,Carter; Anne Toulson,20,0,35,15
1656779978192,MATH 109,A01,083213,Ganzberger; Geoffrey Michael,2,0,34,32
1656779978192,MATH 109,A02,083214,Ganzberger; Geoffrey Michael,2,0,34,32
1656779978192,MATH 109,A03,093478,Ganzberger; Geoffrey Michael,1,0,34,33
1656779978192,MATH 109,B01,083215,Ganzberger; Geoffrey Michael,1,0,32,31
1656779978192,MATH 109,B02,083216,Ganzberger; Geoffrey Michael,1,0,32,31
1656779978192,MATH 109,B03,093479,Ganzberger; Geoffrey Michael,6,0,32,26
1656779984219,MATH 142A,A01,083219,Chow; Bennett,6,0,32,26
1656779984219,MATH 142A,A02,083220,Chow; Bennett,9,0,32,23
1656779984219,MATH 142A,A03,093480,Chow; Bennett,7,0,32,25
1656779984219,MATH 142A,B03,093481,Chow; Bennett,7,0,32,25
1656779984219,MATH 142A,B04,093558,Chow; Bennett,10,0,32,22
1656779984219,MATH 142A,B05,093559,Chow; Bennett,6,0,32,26
1656779990244,MATH 193A,A01,083224,Rotar; Vladimir,6,0,34,28
1656779990244,MATH 193A,A02,083225,Rotar; Vladimir,3,0,34,31
1656779990244,MATH 193A,A03,083781,Rotar; Vladimir,1,0,34,33
1656779990244,MATH 193A,A04,083782,Rotar; Vladimir,6,0,34,28
1656779990244,MATH 193A,A05,093482,Rotar; Vladimir,6,0,34,28
1656779996283,MATH 197,001,091859,McAuley; Julian John,9999,0,9999,0
1656779996283,MATH 197,002,095566,Kedlaya; Kiran S.,9997,0,9999,2
1656779996283,MATH 197,003,095567,Xiao; Ming,9999,0,9999,0
1656779996283,MATH 197,004,095571,Perols; Johan Lars,9998,0,9999,1
1656780003372,COGS 9,A01,083615,Shannon; Kyle Michael,6,0,75,69
1656780009398,COGS 11,A01,083617,Boyle; Mary E. T.,18,0,48,30
1656780015435,COGS 13,A01,083071,Bastos; Amalia Pinkusfeld,8,0,71,63
1656780021461,COGS 14A,A01,092681,Semenuks; Arturs,0,1,100,100
1656780027487,COGS 14B,A01,083073,Cheng; Tzu-Han,5,0,63,58
1656780033516,COGS 17,A01,092677,Semenuks; Arturs,4,0,81,77
1656780039541,COGS 100,A01,083619,Allen; Michael Gordon,15,0,70,55
1656780045567,COGS 101A,A01,083621,Davis; Joshua Daniel,9,0,68,59
1656780051590,COGS 101B,A01,091572,Allen; Michael Gordon,8,0,65,57
1656780057617,COGS 101C,A01,083625,Delgado; Tania,17,0,35,18
1656780063645,COGS 107A,A01,083627,Boyle; Mary E. T.,13,0,60,47
1656780069670,COGS 118A,A01,083075,Gupta; Anjum,15,0,76,61
1656780075696,CSE 3,A50,083646,Miranda; Gregory Joseph,22,0,50,28
1656780081723,CSE 8A,A50,083650,Miranda; Gregory Joseph,17,1,56,39
1656780087748,CSE 11,A01,083080,Cao; Yingjun,4,15,40,36
1656780093774,CSE 12,A01,083652,Krause-Levy; Sophia Louisa,20,1,120,100
1656780099813,CSE 15L,A01,083654,Morris; Justin Loren,8,0,50,42
1656780099813,CSE 15L,A02,083655,Morris; Justin Loren,8,0,50,42
1656780105839,CSE 20,A01,083657,Tran; Khoa Dang,37,0,80,43
1656780111891,CSE 21,A01,095574,Bach; Quang Tran,21,0,48,27
1656780117923,CSE 30,A01,083084,Eldon; John,4,0,80,76
1656780117923,CSE 30,B01,095061,Bhaskar; Nishant,5,0,50,45
1656780123952,CSE 100,A01,083659,Cao; Yingjun,1,4,70,69
1656780129980,CSE 134B,A01,083661,Powell; Thomas Allan,18,0,100,82
1656780136007,CSE 140,A01,083663,Gungor; Onat,14,0,85,71
1656780142030,CSE 140L,A01,083088,Eldon; John,16,0,100,84
1656780148060,CSE 175,A01,083665,Kumar; Rakesh,3,0,25,22
1656780154090,CSE 190,A00,092507,Dubnov; Shlomo,7,0,20,13
1656780160117,ECE 45,A01,083139,Congero; Spencer William,5,0,75,70
1656780166142,ECE 65,A50,083695,Saad; Andrew S,12,0,30,18
1656780166142,ECE 65,A51,095125,Saad; Andrew S,25,0,26,1
1656780172169,ECE 109,A01,091882,Touri; Behrouz,15,0,70,55
1656780178197,ECE 180,A00,083140,Abi Samra; Nicholas Camill,0,0,30,30
1656780178197,ECE 180,B00,083141,Abi Samra; Nicholas Camill,0,0,30,30
1656780184234,MATH 10A,A01,083735,Patchell; Gregory David,1,0,30,29
1656780184234,MATH 10A,A02,083736,Patchell; Gregory David,20,0,30,10
1656780184234,MATH 10A,A03,083737,Patchell; Gregory David,15,0,30,15
1656780190264,MATH 10B,A01,083207,Lim; Seonhee,7,0,34,27
1656780190264,MATH 10B,A02,083208,Lim; Seonhee,9,0,35,26
1656780190264,MATH 10B,A03,093472,Lim; Seonhee,4,0,34,30
1656780190264,MATH 10B,B01,083739,Sinha; Shubham,9,0,30,21
1656780196297,MATH 18,A01,083743,Cinel; Cameron Alexander,6,0,30,24
1656780196297,MATH 18,A02,083744,Cinel; Cameron Alexander,15,0,30,15
1656780196297,MATH 18,A03,083745,Cinel; Cameron Alexander,8,0,30,22
1656780196297,MATH 18,B01,083748,Rideout; David Porter,3,0,37,34
1656780196297,MATH 18,B02,083749,Rideout; David Porter,3,0,36,33
1656780196297,MATH 18,B03,083750,Rideout; David Porter,1,0,37,36
1656780196297,MATH 18,B04,083751,Rideout; David Porter,5,0,36,31
1656780196297,MATH 18,B05,093473,Rideout; David Porter,4,0,36,32
1656780196297,MATH 18,B06,093474,Rideout; David Porter,5,0,36,31
1656780202394,MATH 20A,A01,083754,Zheng; Zequn,12,0,40,28
1656780208419,MATH 20B,A01,083756,Briones; Jor-el Thomas Caparas,1,0,36,35
1656780208419,MATH 20B,A02,083757,Briones; Jor-el Thomas Caparas,1,0,36,35
1656780208419,MATH 20B,A03,093475,Briones; Jor-el Thomas Caparas,0,0,36,36
1656780214460,MATH 20C,A01,083760,Briones; Jor-el Thomas Caparas,1,0,35,34
1656780214460,MATH 20C,A02,083761,Briones; Jor-el Thomas Caparas,8,0,35,27
1656780214460,MATH 20C,A03,093476,Briones; Jor-el Thomas Caparas,0,1,36,36
1656780214460,MATH 20C,B01,083762,Bach; Quang Tran,0,0,30,30
1656780220484,MATH 20D,A01,083765,Tran; Brian Kha,4,0,30,26
1656780220484,MATH 20D,A02,083766,Tran; Brian Kha,4,0,30,26
1656780220484,MATH 20D,A03,083767,Tran; Brian Kha,2,0,30,28
1656780226511,MATH 20E,A01,083771,Ganguly; Soumya,5,0,32,27
1656780226511,MATH 20E,A02,083772,Ganguly; Soumya,5,0,32,27
1656780226511,MATH 20E,B01,083773,Ciotti; Benjamin,18,0,35,17
1656780226511,MATH 20E,B02,083774,Ciotti; Benjamin,17,0,35,18
1656780232539,MATH 103A,A01,083777,Greenfeld; Be'Eri,2,0,36,34
1656780232539,MATH 103A,A02,083778,Greenfeld; Be'Eri,5,0,36,31
1656780232539,MATH 103A,A03,093561,Greenfeld; Be'Eri,4,0,36,32
1656780232539,MATH 103A,B01,083779,Greenfeld; Be'Eri,6,0,36,30
1656780232539,MATH 103A,B02,083780,Greenfeld; Be'Eri,2,0,36,34
1656780232539,MATH 103A,B03,093562,Greenfeld; Be'Eri,2,0,36,34
1656780238570,MATH 105,A01,085443,Carter; Anne Toulson,13,0,35,22
1656780238570,MATH 105,A02,093477,Carter; Anne Toulson,20,0,35,15
1656780244599,MATH 109,A01,083213,Ganzberger; Geoffrey Michael,2,0,34,32
1656780244599,MATH 109,A02,083214,Ganzberger; Geoffrey Michael,2,0,34,32
1656780244599,MATH 109,A03,093478,Ganzberger; Geoffrey Michael,1,0,34,33
1656780244599,MATH 109,B01,083215,Ganzberger; Geoffrey Michael,1,0,32,31
1656780244599,MATH 109,B02,083216,Ganzberger; Geoffrey Michael,1,0,32,31
1656780244599,MATH 109,B03,093479,Ganzberger; Geoffrey Michael,6,0,32,26
1656780250629,MATH 142A,A01,083219,Chow; Bennett,6,0,32,26
1656780250629,MATH 142A,A02,083220,Chow; Bennett,9,0,32,23
1656780250629,MATH 142A,A03,093480,Chow; Bennett,7,0,32,25
1656780250629,MATH 142A,B03,093481,Chow; Bennett,7,0,32,25
1656780250629,MATH 142A,B04,093558,Chow; Bennett,10,0,32,22
1656780250629,MATH 142A,B05,093559,Chow; Bennett,6,0,32,26
1656780256652,MATH 193A,A01,083224,Rotar; Vladimir,6,0,34,28
1656780256652,MATH 193A,A02,083225,Rotar; Vladimir,3,0,34,31
1656780256652,MATH 193A,A03,083781,Rotar; Vladimir,1,0,34,33
1656780256652,MATH 193A,A04,083782,Rotar; Vladimir,6,0,34,28
1656780256652,MATH 193A,A05,093482,Rotar; Vladimir,6,0,34,28
1656780262679,MATH 197,001,091859,McAuley; Julian John,9999,0,9999,0
1656780262679,MATH 197,002,095566,Kedlaya; Kiran S.,9997,0,9999,2
1656780262679,MATH 197,003,095567,Xiao; Ming,9999,0,9999,0
1656780262679,MATH 197,004,095571,Perols; Johan Lars,9998,0,9999,1
1656780269772,COGS 9,A01,083615,Shannon; Kyle Michael,6,0,75,69
1656780275804,COGS 11,A01,083617,Boyle; Mary E. T.,18,0,48,30
1656780281839,COGS 13,A01,083071,Bastos; Amalia Pinkusfeld,8,0,71,63
1656780287866,COGS 14A,A01,092681,Semenuks; Arturs,0,1,100,100
1656780293895,COGS 14B,A01,083073,Cheng; Tzu-Han,5,0,63,58
1656780299920,COGS 17,A01,092677,Semenuks; Arturs,4,0,81,77
1656780305952,COGS 100,A01,083619,Allen; Michael Gordon,15,0,70,55
1656780311980,COGS 101A,A01,083621,Davis; Joshua Daniel,9,0,68,59
1656780318009,COGS 101B,A01,091572,Allen; Michael Gordon,8,0,65,57
1656780324042,COGS 101C,A01,083625,Delgado; Tania,17,0,35,18
1656780330068,COGS 107A,A01,083627,Boyle; Mary E. T.,13,0,60,47
1656780336094,COGS 118A,A01,083075,Gupta; Anjum,15,0,76,61
1656780342121,CSE 3,A50,083646,Miranda; Gregory Joseph,22,0,50,28
1656780348150,CSE 8A,A50,083650,Miranda; Gregory Joseph,17,1,56,39
1656780354173,CSE 11,A01,083080,Cao; Yingjun,4,15,40,36
1656780360204,CSE 12,A01,083652,Krause-Levy; Sophia Louisa,20,1,120,100
1656780366228,CSE 15L,A01,083654,Morris; Justin Loren,8,0,50,42
1656780366228,CSE 15L,A02,083655,Morris; Justin Loren,8,0,50,42
1656780372253,CSE 20,A01,083657,Tran; Khoa Dang,37,0,80,43
1656780378282,CSE 21,A01,095574,Bach; Quang Tran,21,0,48,27
1656780384323,CSE 30,A01,083084,Eldon; John,4,0,80,76
1656780384323,CSE 30,B01,095061,Bhaskar; Nishant,5,0,50,45
1656780390347,CSE 100,A01,083659,Cao; Yingjun,1,4,70,69
1656780396377,CSE 134B,A01,083661,Powell; Thomas Allan,18,0,100,82
1656780402403,CSE 140,A01,083663,Gungor; Onat,14,0,85,71
1656780408430,CSE 140L,A01,083088,Eldon; John,16,0,100,84
1656780414471,CSE 175,A01,083665,Kumar; Rakesh,3,0,25,22
1656780420495,CSE 190,A00,092507,Dubnov; Shlomo,7,0,20,13
1656780426520,ECE 45,A01,083139,Congero; Spencer William,5,0,75,70
1656780432552,ECE 65,A50,083695,Saad; Andrew S,12,0,30,18
1656780432552,ECE 65,A51,095125,Saad; Andrew S,25,0,26,1
1656780438576,ECE 109,A01,091882,Touri; Behrouz,15,0,70,55
1656780444602,ECE 180,A00,083140,Abi Samra; Nicholas Camill,0,0,30,30
1656780444602,ECE 180,B00,083141,Abi Samra; Nicholas Camill,0,0,30,30
1656780450634,MATH 10A,A01,083735,Patchell; Gregory David,1,0,30,29
1656780450634,MATH 10A,A02,083736,Patchell; Gregory David,20,0,30,10
1656780450634,MATH 10A,A03,083737,Patchell; Gregory David,15,0,30,15
1656780456659,MATH 10B,A01,083207,Lim; Seonhee,7,0,34,27
1656780456659,MATH 10B,A02,083208,Lim; Seonhee,9,0,35,26
1656780456659,MATH 10B,A03,093472,Lim; Seonhee,4,0,34,30
1656780456659,MATH 10B,B01,083739,Sinha; Shubham,9,0,30,21
1656780462686,MATH 18,A01,083743,Cinel; Cameron Alexander,6,0,30,24
1656780462686,MATH 18,A02,083744,Cinel; Cameron Alexander,15,0,30,15
1656780462686,MATH 18,A03,083745,Cinel; Cameron Alexander,8,0,30,22
1656780462686,MATH 18,B01,083748,Rideout; David Porter,3,0,37,34
1656780462686,MATH 18,B02,083749,Rideout; David Porter,3,0,36,33
1656780462686,MATH 18,B03,083750,Rideout; David Porter,1,0,37,36
1656780462686,MATH 18,B04,083751,Rideout; David Porter,5,0,36,31
1656780462686,MATH 18,B05,093473,Rideout; David Porter,4,0,36,32
1656780462686,MATH 18,B06,093474,Rideout; David Porter,5,0,36,31
1656780468721,MATH 20A,A01,083754,Zheng; Zequn,12,0,40,28
1656780474749,MATH 20B,A01,083756,Briones; Jor-el Thomas Caparas,1,0,36,35
1656780474749,MATH 20B,A02,083757,Briones; Jor-el Thomas Caparas,1,0,36,35
1656780474749,MATH 20B,A03,093475,Briones; Jor-el Thomas Caparas,0,0,36,36
1656780480774,MATH 20C,A01,083760,Briones; Jor-el Thomas Caparas,1,0,35,34
1656780480774,MATH 20C,A02,083761,Briones; Jor-el Thomas Caparas,8,0,35,27
1656780480774,MATH 20C,A03,093476,Briones; Jor-el Thomas Caparas,0,1,36,36
1656780480774,MATH 20C,B01,083762,Bach; Quang Tran,0,0,30,30
1656780486799,MATH 20D,A01,083765,Tran; Brian Kha,4,0,30,26
1656780486799,MATH 20D,A02,083766,Tran; Brian Kha,4,0,30,26
1656780486799,MATH 20D,A03,083767,Tran; Brian Kha,2,0,30,28
1656780492830,MATH 20E,A01,083771,Ganguly; Soumya,5,0,32,27
1656780492830,MATH 20E,A02,083772,Ganguly; Soumya,5,0,32,27
1656780492830,MATH 20E,B01,083773,Ciotti; Benjamin,18,0,35,17
1656780492830,MATH 20E,B02,083774,Ciotti; Benjamin,17,0,35,18
1656780498863,MATH 103A,A01,083777,Greenfeld; Be'Eri,2,0,36,34
1656780498863,MATH 103A,A02,083778,Greenfeld; Be'Eri,5,0,36,31
1656780498863,MATH 103A,A03,093561,Greenfeld; Be'Eri,4,0,36,32
1656780498863,MATH 103A,B01,083779,Greenfeld; Be'Eri,6,0,36,30
1656780498863,MATH 103A,B02,083780,Greenfeld; Be'Eri,2,0,36,34
1656780498863,MATH 103A,B03,093562,Greenfeld; Be'Eri,2,0,36,34
1656780504888,MATH 105,A01,085443,Carter; Anne Toulson,13,0,35,22
1656780504888,MATH 105,A02,093477,Carter; Anne Toulson,20,0,35,15
1656780510917,MATH 109,A01,083213,Ganzberger; Geoffrey Michael,2,0,34,32
1656780510917,MATH 109,A02,083214,Ganzberger; Geoffrey Michael,2,0,34,32
1656780510917,MATH 109,A03,093478,Ganzberger; Geoffrey Michael,1,0,34,33
1656780510917,MATH 109,B01,083215,Ganzberger; Geoffrey Michael,1,0,32,31
1656780510917,MATH 109,B02,083216,Ganzberger; Geoffrey Michael,1,0,32,31
1656780510917,MATH 109,B03,093479,Ganzberger; Geoffrey Michael,6,0,32,26
1656780516950,MATH 142A,A01,083219,Chow; Bennett,6,0,32,26
1656780516950,MATH 142A,A02,083220,Chow; Bennett,9,0,32,23
1656780516950,MATH 142A,A03,093480,Chow; Bennett,7,0,32,25
1656780516950,MATH 142A,B03,093481,Chow; Bennett,7,0,32,25
1656780516950,MATH 142A,B04,093558,Chow; Bennett,10,0,32,22
1656780516950,MATH 142A,B05,093559,Chow; Bennett,6,0,32,26
1656780522977,MATH 193A,A01,083224,Rotar; Vladimir,6,0,34,28
1656780522977,MATH 193A,A02,083225,Rotar; Vladimir,3,0,34,31
1656780522977,MATH 193A,A03,083781,Rotar; Vladimir,1,0,34,33
1656780522977,MATH 193A,A04,083782,Rotar; Vladimir,6,0,34,28
1656780522977,MATH 193A,A05,093482,Rotar; Vladimir,6,0,34,28
1656780529010,MATH 197,001,091859,McAuley; Julian John,9999,0,9999,0
1656780529010,MATH 197,002,095566,Kedlaya; Kiran S.,9997,0,9999,2
1656780529010,MATH 197,003,095567,Xiao; Ming,9999,0,9999,0
1656780529010,MATH 197,004,095571,Perols; Johan Lars,9998,0,9999,1
1656780536074,COGS 9,A01,083615,Shannon; Kyle Michael,6,0,75,69
1656780542098,COGS 11,A01,083617,Boyle; Mary E. T.,18,0,48,30
1656780548122,COGS 13,A01,083071,Bastos; Amalia Pinkusfeld,8,0,71,63
1656780554152,COGS 14A,A01,092681,Semenuks; Arturs,0,1,100,100
1656780560176,COGS 14B,A01,083073,Cheng; Tzu-Han,5,0,63,58
1656780566200,COGS 17,A01,092677,Semenuks; Arturs,4,0,81,77
1656780572228,COGS 100,A01,083619,Allen; Michael Gordon,15,0,70,55
1656780578256,COGS 101A,A01,083621,Davis; Joshua Daniel,9,0,68,59
1656780584281,COGS 101B,A01,091572,Allen; Michael Gordon,8,0,65,57
1656780590310,COGS 101C,A01,083625,Delgado; Tania,17,0,35,18
1656780596336,COGS 107A,A01,083627,Boyle; Mary E. T.,13,0,60,47
1656780602370,COGS 118A,A01,083075,Gupta; Anjum,15,0,76,61
1656780608409,CSE 3,A50,083646,Miranda; Gregory Joseph,22,0,50,28
1656780614432,CSE 8A,A50,083650,Miranda; Gregory Joseph,17,1,56,39
1656780620458,CSE 11,A01,083080,Cao; Yingjun,4,15,40,36
1656780626482,CSE 12,A01,083652,Krause-Levy; Sophia Louisa,20,1,120,100
1656780632511,CSE 15L,A01,083654,Morris; Justin Loren,8,0,50,42
1656780632511,CSE 15L,A02,083655,Morris; Justin Loren,8,0,50,42
1656780638539,CSE 20,A01,083657,Tran; Khoa Dang,37,0,80,43
1656780644564,CSE 21,A01,095574,Bach; Quang Tran,21,0,48,27
1656780650593,CSE 30,A01,083084,Eldon; John,4,0,80,76
1656780650593,CSE 30,B01,095061,Bhaskar; Nishant,5,0,50,45
1656780656618,CSE 100,A01,083659,Cao; Yingjun,1,4,70,69
1656780662642,CSE 134B,A01,083661,Powell; Thomas Allan,18,0,100,82
1656780668664,CSE 140,A01,083663,Gungor; Onat,14,0,85,71
1656780674689,CSE 140L,A01,083088,Eldon; John,16,0,100,84
1656780680714,CSE 175,A01,083665,Kumar; Rakesh,3,0,25,22
1656780686743,CSE 190,A00,092507,Dubnov; Shlomo,7,0,20,13
1656780692771,ECE 45,A01,083139,Congero; Spencer William,5,0,75,70
1656780698804,ECE 65,A50,083695,Saad; Andrew S,12,0,30,18
1656780698804,ECE 65,A51,095125,Saad; Andrew S,25,0,26,1
1656780704828,ECE 109,A01,091882,Touri; Behrouz,15,0,70,55
1656780710859,ECE 180,A00,083140,Abi Samra; Nicholas Camill,0,0,30,30
1656780710859,ECE 180,B00,083141,Abi Samra; Nicholas Camill,0,0,30,30
1656780716890,MATH 10A,A01,083735,Patchell; Gregory David,1,0,30,29
1656780716890,MATH 10A,A02,083736,Patchell; Gregory David,20,0,30,10
1656780716890,MATH 10A,A03,083737,Patchell; Gregory David,15,0,30,15
1656780722921,MATH 10B,A01,083207,Lim; Seonhee,7,0,34,27
1656780722921,MATH 10B,A02,083208,Lim; Seonhee,9,0,35,26
1656780722921,MATH 10B,A03,093472,Lim; Seonhee,4,0,34,30
1656780722921,MATH 10B,B01,083739,Sinha; Shubham,9,0,30,21
1656780728956,MATH 18,A01,083743,Cinel; Cameron Alexander,6,0,30,24
1656780728956,MATH 18,A02,083744,Cinel; Cameron Alexander,15,0,30,15
1656780728956,MATH 18,A03,083745,Cinel; Cameron Alexander,8,0,30,22
1656780728956,MATH 18,B01,083748,Rideout; David Porter,3,0,37,34
1656780728956,MATH 18,B02,083749,Rideout; David Porter,3,0,36,33
1656780728956,MATH 18,B03,083750,Rideout; David Porter,1,0,37,36
1656780728956,MATH 18,B04,083751,Rideout; David Porter,5,0,36,31
1656780728956,MATH 18,B05,093473,Rideout; David Porter,4,0,36,32
1656780728956,MATH 18,B06,093474,Rideout; David Porter,5,0,36,31
1656780734983,MATH 20A,A01,083754,Zheng; Zequn,12,0,40,28
1656780741021,MATH 20B,A01,083756,Briones; Jor-el Thomas Caparas,1,0,36,35
1656780741021,MATH 20B,A02,083757,Briones; Jor-el Thomas Caparas,1,0,36,35
1656780741021,MATH 20B,A03,093475,Briones; Jor-el Thomas Caparas,0,0,36,36
1656780747046,MATH 20C,A01,083760,Briones; Jor-el Thomas Caparas,1,0,35,34
1656780747046,MATH 20C,A02,083761,Briones; Jor-el Thomas Caparas,8,0,35,27
1656780747046,MATH 20C,A03,093476,Briones; Jor-el Thomas Caparas,0,1,36,36
1656780747046,MATH 20C,B01,083762,Bach; Quang Tran,0,0,30,30
1656780753070,MATH 20D,A01,083765,Tran; Brian Kha,4,0,30,26
1656780753070,MATH 20D,A02,083766,Tran; Brian Kha,4,0,30,26
1656780753070,MATH 20D,A03,083767,Tran; Brian Kha,2,0,30,28
1656780759103,MATH 20E,A01,083771,Ganguly; Soumya,5,0,32,27
1656780759103,MATH 20E,A02,083772,Ganguly; Soumya,5,0,32,27
1656780759103,MATH 20E,B01,083773,Ciotti; Benjamin,18,0,35,17
1656780759103,MATH 20E,B02,083774,Ciotti; Benjamin,17,0,35,18
1656780765136,MATH 103A,A01,083777,Greenfeld; Be'Eri,2,0,36,34
1656780765136,MATH 103A,A02,083778,Greenfeld; Be'Eri,5,0,36,31
1656780765136,MATH 103A,A03,093561,Greenfeld; Be'Eri,4,0,36,32
1656780765136,MATH 103A,B01,083779,Greenfeld; Be'Eri,6,0,36,30
1656780765136,MATH 103A,B02,083780,Greenfeld; Be'Eri,2,0,36,34
1656780765136,MATH 103A,B03,093562,Greenfeld; Be'Eri,2,0,36,34
1656780771167,MATH 105,A01,085443,Carter; Anne Toulson,13,0,35,22
1656780771167,MATH 105,A02,093477,Carter; Anne Toulson,20,0,35,15
1656780777196,MATH 109,A01,083213,Ganzberger; Geoffrey Michael,2,0,34,32
1656780777196,MATH 109,A02,083214,Ganzberger; Geoffrey Michael,2,0,34,32
1656780777196,MATH 109,A03,093478,Ganzberger; Geoffrey Michael,1,0,34,33
1656780777196,MATH 109,B01,083215,Ganzberger; Geoffrey Michael,1,0,32,31
1656780777196,MATH 109,B02,083216,Ganzberger; Geoffrey Michael,1,0,32,31
1656780777196,MATH 109,B03,093479,Ganzberger; Geoffrey Michael,6,0,32,26
1656780783227,MATH 142A,A01,083219,Chow; Bennett,6,0,32,26
1656780783227,MATH 142A,A02,083220,Chow; Bennett,9,0,32,23
1656780783227,MATH 142A,A03,093480,Chow; Bennett,7,0,32,25
1656780783227,MATH 142A,B03,093481,Chow; Bennett,7,0,32,25
1656780783227,MATH 142A,B04,093558,Chow; Bennett,10,0,32,22
1656780783227,MATH 142A,B05,093559,Chow; Bennett,6,0,32,26
1656780789252,MATH 193A,A01,083224,Rotar; Vladimir,6,0,34,28
1656780789252,MATH 193A,A02,083225,Rotar; Vladimir,3,0,34,31
1656780789252,MATH 193A,A03,083781,Rotar; Vladimir,1,0,34,33
1656780789252,MATH 193A,A04,083782,Rotar; Vladimir,6,0,34,28
1656780789252,MATH 193A,A05,093482,Rotar; Vladimir,6,0,34,28
1656780795276,MATH 197,001,091859,McAuley; Julian John,9999,0,9999,0
1656780795276,MATH 197,002,095566,Kedlaya; Kiran S.,9997,0,9999,2
1656780795276,MATH 197,003,095567,Xiao; Ming,9999,0,9999,0
1656780795276,MATH 197,004,095571,Perols; Johan Lars,9998,0,9999,1
1656780802420,COGS 9,A01,083615,Shannon; Kyle Michael,6,0,75,69
1656780808444,COGS 11,A01,083617,Boyle; Mary E. T.,18,0,48,30
1656780814474,COGS 13,A01,083071,Bastos; Amalia Pinkusfeld,8,0,71,63
1656780820499,COGS 14A,A01,092681,Semenuks; Arturs,0,1,100,100
1656780826524,COGS 14B,A01,083073,Cheng; Tzu-Han,5,0,63,58
1656780832553,COGS 17,A01,092677,Semenuks; Arturs,4,0,81,77
1656780838578,COGS 100,A01,083619,Allen; Michael Gordon,15,0,70,55
1656780844602,COGS 101A,A01,083621,Davis; Joshua Daniel,9,0,68,59
1656780850626,COGS 101B,A01,091572,Allen; Michael Gordon,8,0,65,57
1656780856659,COGS 101C,A01,083625,Delgado; Tania,17,0,35,18
1656780862680,COGS 107A,A01,083627,Boyle; Mary E. T.,13,0,60,47
1656780868705,COGS 118A,A01,083075,Gupta; Anjum,15,0,76,61
1656780874730,CSE 3,A50,083646,Miranda; Gregory Joseph,22,0,50,28
1656780880753,CSE 8A,A50,083650,Miranda; Gregory Joseph,17,1,56,39
1656780886776,CSE 11,A01,083080,Cao; Yingjun,4,15,40,36
1656780892801,CSE 12,A01,083652,Krause-Levy; Sophia Louisa,20,1,120,100
1656780898826,CSE 15L,A01,083654,Morris; Justin Loren,8,0,50,42
1656780898826,CSE 15L,A02,083655,Morris; Justin Loren,8,0,50,42
1656780904850,CSE 20,A01,083657,Tran; Khoa Dang,37,0,80,43
1656780910876,CSE 21,A01,095574,Bach; Quang Tran,21,0,48,27
1656780916900,CSE 30,A01,083084,Eldon; John,4,0,80,76
1656780916900,CSE 30,B01,095061,Bhaskar; Nishant,5,0,50,45
1656780922928,CSE 100,A01,083659,Cao; Yingjun,1,4,70,69
1656780928956,CSE 134B,A01,083661,Powell; Thomas Allan,18,0,100,82
1656780934980,CSE 140,A01,083663,Gungor; Onat,14,0,85,71
1656780941009,CSE 140L,A01,083088,Eldon; John,16,0,100,84
1656780947036,CSE 175,A01,083665,Kumar; Rakesh,3,0,25,22
1656780953060,CSE 190,A00,092507,Dubnov; Shlomo,7,0,20,13
1656780959087,ECE 45,A01,083139,Congero; Spencer William,5,0,75,70
1656780965112,ECE 65,A50,083695,Saad; Andrew S,12,0,30,18
1656780965112,ECE 65,A51,095125,Saad; Andrew S,25,0,26,1
1656780971139,ECE 109,A01,091882,Touri; Behrouz,15,0,70,55
1656780977164,ECE 180,A00,083140,Abi Samra; Nicholas Camill,0,0,30,30
1656780977164,ECE 180,B00,083141,Abi Samra; Nicholas Camill,0,0,30,30
1656780983189,MATH 10A,A01,083735,Patchell; Gregory David,1,0,30,29
1656780983189,MATH 10A,A02,083736,Patchell; Gregory David,20,0,30,10
1656780983189,MATH 10A,A03,083737,Patchell; Gregory David,15,0,30,15
1656780989214,MATH 10B,A01,083207,Lim; Seonhee,7,0,34,27
1656780989214,MATH 10B,A02,083208,Lim; Seonhee,9,0,35,26
1656780989214,MATH 10B,A03,093472,Lim; Seonhee,4,0,34,30
1656780989214,MATH 10B,B01,083739,Sinha; Shubham,9,0,30,21
1656780995247,MATH 18,A01,083743,Cinel; Cameron Alexander,6,0,30,24
1656780995247,MATH 18,A02,083744,Cinel; Cameron Alexander,15,0,30,15
1656780995247,MATH 18,A03,083745,Cinel; Cameron Alexander,8,0,30,22
1656780995247,MATH 18,B01,083748,Rideout; David Porter,3,0,37,34
1656780995247,MATH 18,B02,083749,Rideout; David Porter,3,0,36,33
1656780995247,MATH 18,B03,083750,Rideout; David Porter,1,0,37,36
1656780995247,MATH 18,B04,083751,Rideout; David Porter,5,0,36,31
1656780995247,MATH 18,B05,093473,Rideout; David Porter,4,0,36,32
1656780995247,MATH 18,B06,093474,Rideout; David Porter,5,0,36,31
1656781001272,MATH 20A,A01,083754,Zheng; Zequn,12,0,40,28
1656781007304,MATH 20B,A01,083756,Briones; Jor-el Thomas Caparas,1,0,36,35
1656781007304,MATH 20B,A02,083757,Briones; Jor-el Thomas Caparas,1,0,36,35
1656781007304,MATH 20B,A03,093475,Briones; Jor-el Thomas Caparas,0,0,36,36
1656781013329,MATH 20C,A01,083760,Briones; Jor-el Thomas Caparas,1,0,35,34
1656781013329,MATH 20C,A02,083761,Briones; Jor-el Thomas Caparas,8,0,35,27
1656781013329,MATH 20C,A03,093476,Briones; Jor-el Thomas Caparas,0,1,36,36
1656781013329,MATH 20C,B01,083762,Bach; Quang Tran,0,0,30,30
1656781019366,MATH 20D,A01,083765,Tran; Brian Kha,4,0,30,26
1656781019366,MATH 20D,A02,083766,Tran; Brian Kha,4,0,30,26
1656781019366,MATH 20D,A03,083767,Tran; Brian Kha,2,0,30,28
1656781025407,MATH 20E,A01,083771,Ganguly; Soumya,5,0,32,27
1656781025407,MATH 20E,A02,083772,Ganguly; Soumya,5,0,32,27
1656781025407,MATH 20E,B01,083773,Ciotti; Benjamin,18,0,35,17
1656781025407,MATH 20E,B02,083774,Ciotti; Benjamin,17,0,35,18
1656781031432,MATH 103A,A01,083777,Greenfeld; Be'Eri,2,0,36,34
1656781031432,MATH 103A,A02,083778,Greenfeld; Be'Eri,5,0,36,31
1656781031432,MATH 103A,A03,093561,Greenfeld; Be'Eri,4,0,36,32
1656781031432,MATH 103A,B01,083779,Greenfeld; Be'Eri,6,0,36,30
1656781031432,MATH 103A,B02,083780,Greenfeld; Be'Eri,2,0,36,34
1656781031432,MATH 103A,B03,093562,Greenfeld; Be'Eri,2,0,36,34
1656781037461,MATH 105,A01,085443,Carter; Anne Toulson,13,0,35,22
1656781037461,MATH 105,A02,093477,Carter; Anne Toulson,20,0,35,15
1656781043508,MATH 109,A01,083213,Ganzberger; Geoffrey Michael,2,0,34,32
1656781043508,MATH 109,A02,083214,Ganzberger; Geoffrey Michael,2,0,34,32
1656781043508,MATH 109,A03,093478,Ganzberger; Geoffrey Michael,1,0,34,33
1656781043508,MATH 109,B01,083215,Ganzberger; Geoffrey Michael,1,0,32,31
1656781043508,MATH 109,B02,083216,Ganzberger; Geoffrey Michael,1,0,32,31
1656781043508,MATH 109,B03,093479,Ganzberger; Geoffrey Michael,6,0,32,26
1656781049539,MATH 142A,A01,083219,Chow; Bennett,6,0,32,26
1656781049539,MATH 142A,A02,083220,Chow; Bennett,9,0,32,23
1656781049539,MATH 142A,A03,093480,Chow; Bennett,7,0,32,25
1656781049539,MATH 142A,B03,093481,Chow; Bennett,7,0,32,25
1656781049539,MATH 142A,B04,093558,Chow; Bennett,10,0,32,22
1656781049539,MATH 142A,B05,093559,Chow; Bennett,6,0,32,26
1656781055568,MATH 193A,A01,083224,Rotar; Vladimir,6,0,34,28
1656781055568,MATH 193A,A02,083225,Rotar; Vladimir,3,0,34,31
1656781055568,MATH 193A,A03,083781,Rotar; Vladimir,1,0,34,33
1656781055568,MATH 193A,A04,083782,Rotar; Vladimir,6,0,34,28
1656781055568,MATH 193A,A05,093482,Rotar; Vladimir,6,0,34,28
1656781061592,MATH 197,001,091859,McAuley; Julian John,9999,0,9999,0
1656781061592,MATH 197,002,095566,Kedlaya; Kiran S.,9997,0,9999,2
1656781061592,MATH 197,003,095567,Xiao; Ming,9999,0,9999,0
1656781061592,MATH 197,004,095571,Perols; Johan Lars,9998,0,9999,1
1656781068676,COGS 9,A01,083615,Shannon; Kyle Michael,6,0,75,69
1656781074704,COGS 11,A01,083617,Boyle; Mary E. T.,18,0,48,30
1656781080728,COGS 13,A01,083071,Bastos; Amalia Pinkusfeld,8,0,71,63
1656781086767,COGS 14A,A01,092681,Semenuks; Arturs,0,1,100,100
1656781092806,COGS 14B,A01,083073,Cheng; Tzu-Han,5,0,63,58
1656781098828,COGS 17,A01,092677,Semenuks; Arturs,4,0,81,77
1656781104856,COGS 100,A01,083619,Allen; Michael Gordon,15,0,70,55
1656781110882,COGS 101A,A01,083621,Davis; Joshua Daniel,9,0,68,59
1656781116906,COGS 101B,A01,091572,Allen; Michael Gordon,8,0,65,57
1656781122936,COGS 101C,A01,083625,Delgado; Tania,17,0,35,18
1656781128966,COGS 107A,A01,083627,Boyle; Mary E. T.,13,0,60,47
1656781134992,COGS 118A,A01,083075,Gupta; Anjum,15,0,76,61
1656781141025,CSE 3,A50,083646,Miranda; Gregory Joseph,22,0,50,28
1656781147053,CSE 8A,A50,083650,Miranda; Gregory Joseph,17,1,56,39
1656781153079,CSE 11,A01,083080,Cao; Yingjun,4,15,40,36
1656781159103,CSE 12,A01,083652,Krause-Levy; Sophia Louisa,20,1,120,100
1656781165132,CSE 15L,A01,083654,Morris; Justin Loren,8,0,50,42
1656781165132,CSE 15L,A02,083655,Morris; Justin Loren,8,0,50,42
1656781171159,CSE 20,A01,083657,Tran; Khoa Dang,37,0,80,43
1656781177186,CSE 21,A01,095574,Bach; Quang Tran,21,0,48,27
1656781183215,CSE 30,A01,083084,Eldon; John,4,0,80,76
1656781183215,CSE 30,B01,095061,Bhaskar; Nishant,5,0,50,45
1656781189240,CSE 100,A01,083659,Cao; Yingjun,1,4,70,69
1656781195265,CSE 134B,A01,083661,Powell; Thomas Allan,18,0,100,82
1656781201289,CSE 140,A01,083663,Gungor; Onat,14,0,85,71
1656781207320,CSE 140L,A01,083088,Eldon; John,16,0,100,84
1656781213351,CSE 175,A01,083665,Kumar; Rakesh,3,0,25,22
1656781219375,CSE 190,A00,092507,Dubnov; Shlomo,7,0,20,13
1656781225401,ECE 45,A01,083139,Congero; Spencer William,5,0,75,70
1656781231427,ECE 65,A50,083695,Saad; Andrew S,12,0,30,18
1656781231427,ECE 65,A51,095125,Saad; Andrew S,25,0,26,1
1656781237452,ECE 109,A01,091882,Touri; Behrouz,15,0,70,55
1656781243481,ECE 180,A00,083140,Abi Samra; Nicholas Camill,0,0,30,30
1656781243481,ECE 180,B00,083141,Abi Samra; Nicholas Camill,0,0,30,30
1656781249516,MATH 10A,A01,083735,Patchell; Gregory David,1,0,30,29
1656781249516,MATH 10A,A02,083736,Patchell; Gregory David,20,0,30,10
1656781249516,MATH 10A,A03,083737,Patchell; Gregory David,15,0,30,15
1656781255541,MATH 10B,A01,083207,Lim; Seonhee,7,0,34,27
1656781255541,MATH 10B,A02,083208,Lim; Seonhee,9,0,35,26
1656781255541,MATH 10B,A03,093472,Lim; Seonhee,4,0,34,30
1656781255541,MATH 10B,B01,083739,Sinha; Shubham,9,0,30,21
1656781261566,MATH 18,A01,083743,Cinel; Cameron Alexander,6,0,30,24
1656781261566,MATH 18,A02,083744,Cinel; Cameron Alexander,15,0,30,15
1656781261566,MATH 18,A03,083745,Cinel; Cameron Alexander,8,0,30,22
1656781261566,MATH 18,B01,083748,Rideout; David Porter,3,0,37,34
1656781261566,MATH 18,B02,083749,Rideout; David Porter,3,0,36,33
1656781261566,MATH 18,B03,083750,Rideout; David Porter,1,0,37,36
1656781261566,MATH 18,B04,083751,Rideout; David Porter,5,0,36,31
1656781261566,MATH 18,B05,093473,Rideout; David Porter,4,0,36,32
1656781261566,MATH 18,B06,093474,Rideout; David Porter,5,0,36,31
1656781267590,MATH 20A,A01,083754,Zheng; Zequn,12,0,40,28
1656781273618,MATH 20B,A01,083756,Briones; Jor-el Thomas Caparas,1,0,36,35
1656781273618,MATH 20B,A02,083757,Briones; Jor-el Thomas Caparas,1,0,36,35
1656781273618,MATH 20B,A03,093475,Briones; Jor-el Thomas Caparas,0,0,36,36
1656781279643,MATH 20C,A01,083760,Briones; Jor-el Thomas Caparas,1,0,35,34
1656781279643,MATH 20C,A02,083761,Briones; Jor-el Thomas Caparas,8,0,35,27
1656781279643,MATH 20C,A03,093476,Briones; Jor-el Thomas Caparas,0,1,36,36
1656781279643,MATH 20C,B01,083762,Bach; Quang Tran,0,0,30,30
1656781285667,MATH 20D,A01,083765,Tran; Brian Kha,4,0,30,26
1656781285667,MATH 20D,A02,083766,Tran; Brian Kha,4,0,30,26
1656781285667,MATH 20D,A03,083767,Tran; Brian Kha,2,0,30,28
1656781291697,MATH 20E,A01,083771,Ganguly; Soumya,5,0,32,27
1656781291697,MATH 20E,A02,083772,Ganguly; Soumya,5,0,32,27
1656781291697,MATH 20E,B01,083773,Ciotti; Benjamin,18,0,35,17
1656781291697,MATH 20E,B02,083774,Ciotti; Benjamin,17,0,35,18
1656781297728,MATH 103A,A01,083777,Greenfeld; Be'Eri,2,0,36,34
1656781297728,MATH 103A,A02,083778,Greenfeld; Be'Eri,5,0,36,31
1656781297728,MATH 103A,A03,093561,Greenfeld; Be'Eri,4,0,36,32
1656781297728,MATH 103A,B01,083779,Greenfeld; Be'Eri,6,0,36,30
1656781297728,MATH 103A,B02,083780,Greenfeld; Be'Eri,2,0,36,34
1656781297728,MATH 103A,B03,093562,Greenfeld; Be'Eri,2,0,36,34
1656781303757,MATH 105,A01,085443,Carter; Anne Toulson,13,0,35,22
1656781303757,MATH 105,A02,093477,Carter; Anne Toulson,20,0,35,15
1656781309797,MATH 109,A01,083213,Ganzberger; Geoffrey Michael,2,0,34,32
1656781309797,MATH 109,A02,083214,Ganzberger; Geoffrey Michael,2,0,34,32
1656781309797,MATH 109,A03,093478,Ganzberger; Geoffrey Michael,1,0,34,33
1656781309797,MATH 109,B01,083215,Ganzberger; Geoffrey Michael,1,0,32,31
1656781309797,MATH 109,B02,083216,Ganzberger; Geoffrey Michael,1,0,32,31
1656781309797,MATH 109,B03,093479,Ganzberger; Geoffrey Michael,6,0,32,26
1656781315825,MATH 142A,A01,083219,Chow; Bennett,6,0,32,26
1656781315825,MATH 142A,A02,083220,Chow; Bennett,9,0,32,23
1656781315825,MATH 142A,A03,093480,Chow; Bennett,7,0,32,25
1656781315825,MATH 142A,B03,093481,Chow; Bennett,7,0,32,25
1656781315825,MATH 142A,B04,093558,Chow; Bennett,10,0,32,22
1656781315825,MATH 142A,B05,093559,Chow; Bennett,6,0,32,26
1656781321857,MATH 193A,A01,083224,Rotar; Vladimir,6,0,34,28
1656781321857,MATH 193A,A02,083225,Rotar; Vladimir,3,0,34,31
1656781321857,MATH 193A,A03,083781,Rotar; Vladimir,1,0,34,33
1656781321857,MATH 193A,A04,083782,Rotar; Vladimir,6,0,34,28
1656781321857,MATH 193A,A05,093482,Rotar; Vladimir,6,0,34,28
1656781327881,MATH 197,001,091859,McAuley; Julian John,9999,0,9999,0
1656781327881,MATH 197,002,095566,Kedlaya; Kiran S.,9997,0,9999,2
1656781327881,MATH 197,003,095567,Xiao; Ming,9999,0,9999,0
1656781327881,MATH 197,004,095571,Perols; Johan Lars,9998,0,9999,1
1656781334943,COGS 9,A01,083615,Shannon; Kyle Michael,6,0,75,69
1656781340966,COGS 11,A01,083617,Boyle; Mary E. T.,18,0,48,30
1656781346991,COGS 13,A01,083071,Bastos; Amalia Pinkusfeld,8,0,71,63
1656781353017,COGS 14A,A01,092681,Semenuks; Arturs,0,1,100,100
1656781359040,COGS 14B,A01,083073,Cheng; Tzu-Han,5,0,63,58
1656781365062,COGS 17,A01,092677,Semenuks; Arturs,4,0,81,77
1656781371085,COGS 100,A01,083619,Allen; Michael Gordon,15,0,70,55
1656781377127,COGS 101A,A01,083621,Davis; Joshua Daniel,9,0,68,59
1656781383156,COGS 101B,A01,091572,Allen; Michael Gordon,8,0,65,57
1656781389183,COGS 101C,A01,083625,Delgado; Tania,17,0,35,18
1656781395277,COGS 107A,A01,083627,Boyle; Mary E. T.,13,0,60,47
1656781401315,COGS 118A,A01,083075,Gupta; Anjum,15,0,76,61
1656781407345,CSE 3,A50,083646,Miranda; Gregory Joseph,22,0,50,28
1656781413369,CSE 8A,A50,083650,Miranda; Gregory Joseph,17,1,56,39
1656781419396,CSE 11,A01,083080,Cao; Yingjun,4,15,40,36
1656781425425,CSE 12,A01,083652,Krause-Levy; Sophia Louisa,20,1,120,100
1656781431448,CSE 15L,A01,083654,Morris; Justin Loren,8,0,50,42
1656781431448,CSE 15L,A02,083655,Morris; Justin Loren,8,0,50,42
1656781437474,CSE 20,A01,083657,Tran; Khoa Dang,37,0,80,43
1656781443496,CSE 21,A01,095574,Bach; Quang Tran,21,0,48,27
1656781449525,CSE 30,A01,083084,Eldon; John,4,0,80,76
1656781449525,CSE 30,B01,095061,Bhaskar; Nishant,5,0,50,45
1656781455548,CSE 100,A01,083659,Cao; Yingjun,1,4,70,69
1656781461576,CSE 134B,A01,083661,Powell; Thomas Allan,18,0,100,82
1656781467603,CSE 140,A01,083663,Gungor; Onat,14,0,85,71
1656781473639,CSE 140L,A01,083088,Eldon; John,16,0,100,84
1656781479663,CSE 175,A01,083665,Kumar; Rakesh,3,0,25,22
1656781485692,CSE 190,A00,092507,Dubnov; Shlomo,7,0,20,13
1656781491717,ECE 45,A01,083139,Congero; Spencer William,5,0,75,70
1656781497750,ECE 65,A50,083695,Saad; Andrew S,12,0,30,18
1656781497750,ECE 65,A51,095125,Saad; Andrew S,25,0,26,1
1656781503780,ECE 109,A01,091882,Touri; Behrouz,15,0,70,55
1656781509804,ECE 180,A00,083140,Abi Samra; Nicholas Camill,0,0,30,30
1656781509804,ECE 180,B00,083141,Abi Samra; Nicholas Camill,0,0,30,30
1656781515829,MATH 10A,A01,083735,Patchell; Gregory David,1,0,30,29
1656781515829,MATH 10A,A02,083736,Patchell; Gregory David,20,0,30,10
1656781515829,MATH 10A,A03,083737,Patchell; Gregory David,15,0,30,15
1656781521856,MATH 10B,A01,083207,Lim; Seonhee,7,0,34,27
1656781521856,MATH 10B,A02,083208,Lim; Seonhee,9,0,35,26
1656781521856,MATH 10B,A03,093472,Lim; Seonhee,4,0,34,30
1656781521856,MATH 10B,B01,083739,Sinha; Shubham,9,0,30,21
1656781527905,MATH 18,A01,083743,Cinel; Cameron Alexander,6,0,30,24
1656781527905,MATH 18,A02,083744,Cinel; Cameron Alexander,15,0,30,15
1656781527905,MATH 18,A03,083745,Cinel; Cameron Alexander,8,0,30,22
1656781527905,MATH 18,B01,083748,Rideout; David Porter,3,0,37,34
1656781527905,MATH 18,B02,083749,Rideout; David Porter,3,0,36,33
1656781527905,MATH 18,B03,083750,Rideout; David Porter,1,0,37,36
1656781527905,MATH 18,B04,083751,Rideout; David Porter,5,0,36,31
1656781527905,MATH 18,B05,093473,Rideout; David Porter,4,0,36,32
1656781527905,MATH 18,B06,093474,Rideout; David Porter,5,0,36,31
1656781533930,MATH 20A,A01,083754,Zheng; Zequn,12,0,40,28
1656781539954,MATH 20B,A01,083756,Briones; Jor-el Thomas Caparas,1,0,36,35
1656781539954,MATH 20B,A02,083757,Briones; Jor-el Thomas Caparas,1,0,36,35
1656781539954,MATH 20B,A03,093475,Briones; Jor-el Thomas Caparas,0,0,36,36
1656781545978,MATH 20C,A01,083760,Briones; Jor-el Thomas Caparas,1,0,35,34
1656781545978,MATH 20C,A02,083761,Briones; Jor-el Thomas Caparas,8,0,35,27
1656781545978,MATH 20C,A03,093476,Briones; Jor-el Thomas Caparas,0,1,36,36
1656781545978,MATH 20C,B01,083762,Bach; Quang Tran,0,0,30,30
1656781552011,MATH 20D,A01,083765,Tran; Brian Kha,4,0,30,26
1656781552011,MATH 20D,A02,083766,Tran; Brian Kha,4,0,30,26
1656781552011,MATH 20D,A03,083767,Tran; Brian Kha,2,0,30,28
1656781558039,MATH 20E,A01,083771,Ganguly; Soumya,5,0,32,27
1656781558039,MATH 20E,A02,083772,Ganguly; Soumya,5,0,32,27
1656781558039,MATH 20E,B01,083773,Ciotti; Benjamin,18,0,35,17
1656781558039,MATH 20E,B02,083774,Ciotti; Benjamin,17,0,35,18
1656781564064,MATH 103A,A01,083777,Greenfeld; Be'Eri,2,0,36,34
1656781564064,MATH 103A,A02,083778,Greenfeld; Be'Eri,5,0,36,31
1656781564064,MATH 103A,A03,093561,Greenfeld; Be'Eri,4,0,36,32
1656781564064,MATH 103A,B01,083779,Greenfeld; Be'Eri,6,0,36,30
1656781564064,MATH 103A,B02,083780,Greenfeld; Be'Eri,2,0,36,34
1656781564064,MATH 103A,B03,093562,Greenfeld; Be'Eri,2,0,36,34
1656781570090,MATH 105,A01,085443,Carter; Anne Toulson,13,0,35,22
1656781570090,MATH 105,A02,093477,Carter; Anne Toulson,20,0,35,15
1656781576115,MATH 109,A01,083213,Ganzberger; Geoffrey Michael,2,0,34,32
1656781576115,MATH 109,A02,083214,Ganzberger; Geoffrey Michael,2,0,34,32
1656781576115,MATH 109,A03,093478,Ganzberger; Geoffrey Michael,1,0,34,33
1656781576115,MATH 109,B01,083215,Ganzberger; Geoffrey Michael,1,0,32,31
1656781576115,MATH 109,B02,083216,Ganzberger; Geoffrey Michael,1,0,32,31
1656781576115,MATH 109,B03,093479,Ganzberger; Geoffrey Michael,6,0,32,26
1656781582140,MATH 142A,A01,083219,Chow; Bennett,6,0,32,26
1656781582140,MATH 142A,A02,083220,Chow; Bennett,9,0,32,23
1656781582140,MATH 142A,A03,093480,Chow; Bennett,7,0,32,25
1656781582140,MATH 142A,B03,093481,Chow; Bennett,7,0,32,25
1656781582140,MATH 142A,B04,093558,Chow; Bennett,10,0,32,22
1656781582140,MATH 142A,B05,093559,Chow; Bennett,6,0,32,26
1656781588171,MATH 193A,A01,083224,Rotar; Vladimir,6,0,34,28
1656781588171,MATH 193A,A02,083225,Rotar; Vladimir,3,0,34,31
1656781588171,MATH 193A,A03,083781,Rotar; Vladimir,1,0,34,33
1656781588171,MATH 193A,A04,083782,Rotar; Vladimir,6,0,34,28
1656781588171,MATH 193A,A05,093482,Rotar; Vladimir,6,0,34,28
1656781594198,MATH 197,001,091859,McAuley; Julian John,9999,0,9999,0
1656781594198,MATH 197,002,095566,Kedlaya; Kiran S.,9997,0,9999,2
1656781594198,MATH 197,003,095567,Xiao; Ming,9999,0,9999,0
1656781594198,MATH 197,004,095571,Perols; Johan Lars,9998,0,9999,1
1656781601275,COGS 9,A01,083615,Shannon; Kyle Michael,6,0,75,69
1656781607304,COGS 11,A01,083617,Boyle; Mary E. T.,18,0,48,30
1656781613335,COGS 13,A01,083071,Bastos; Amalia Pinkusfeld,8,0,71,63
1656781619364,COGS 14A,A01,092681,Semenuks; Arturs,0,1,100,100
1656781625388,COGS 14B,A01,083073,Cheng; Tzu-Han,5,0,63,58
1656781631415,COGS 17,A01,092677,Semenuks; Arturs,4,0,81,77
1656781637438,COGS 100,A01,083619,Allen; Michael Gordon,15,0,70,55
1656781643468,COGS 101A,A01,083621,Davis; Joshua Daniel,9,0,68,59
1656781649493,COGS 101B,A01,091572,Allen; Michael Gordon,8,0,65,57
1656781655525,COGS 101C,A01,083625,Delgado; Tania,17,0,35,18
1656781661549,COGS 107A,A01,083627,Boyle; Mary E. T.,13,0,60,47
1656781667579,COGS 118A,A01,083075,Gupta; Anjum,15,0,76,61
1656781673607,CSE 3,A50,083646,Miranda; Gregory Joseph,22,0,50,28
1656781679644,CSE 8A,A50,083650,Miranda; Gregory Joseph,17,1,56,39
1656781685671,CSE 11,A01,083080,Cao; Yingjun,4,15,40,36
1656781691698,CSE 12,A01,083652,Krause-Levy; Sophia Louisa,20,1,120,100
1656781697722,CSE 15L,A01,083654,Morris; Justin Loren,8,0,50,42
1656781697722,CSE 15L,A02,083655,Morris; Justin Loren,8,0,50,42
1656781703746,CSE 20,A01,083657,Tran; Khoa Dang,37,0,80,43
1656781709773,CSE 21,A01,095574,Bach; Quang Tran,21,0,48,27
1656781715802,CSE 30,A01,083084,Eldon; John,4,0,80,76
1656781715802,CSE 30,B01,095061,Bhaskar; Nishant,5,0,50,45
1656781721835,CSE 100,A01,083659,Cao; Yingjun,1,4,70,69
1656781727861,CSE 134B,A01,083661,Powell; Thomas Allan,18,0,100,82
1656781733894,CSE 140,A01,083663,Gungor; Onat,14,0,85,71
1656781739921,CSE 140L,A01,083088,Eldon; John,16,0,100,84
1656781745947,CSE 175,A01,083665,Kumar; Rakesh,3,0,25,22
1656781751969,CSE 190,A00,092507,Dubnov; Shlomo,7,0,20,13
1656781757995,ECE 45,A01,083139,Congero; Spencer William,5,0,75,70
1656781764022,ECE 65,A50,083695,Saad; Andrew S,12,0,30,18
1656781764022,ECE 65,A51,095125,Saad; Andrew S,25,0,26,1
1656781770048,ECE 109,A01,091882,Touri; Behrouz,15,0,70,55
1656781776079,ECE 180,A00,083140,Abi Samra; Nicholas Camill,0,0,30,30
1656781776079,ECE 180,B00,083141,Abi Samra; Nicholas Camill,0,0,30,30
1656781782109,MATH 10A,A01,083735,Patchell; Gregory David,1,0,30,29
1656781782109,MATH 10A,A02,083736,Patchell; Gregory David,20,0,30,10
1656781782109,MATH 10A,A03,083737,Patchell; Gregory David,15,0,30,15
1656781788134,MATH 10B,A01,083207,Lim; Seonhee,7,0,34,27
1656781788134,MATH 10B,A02,083208,Lim; Seonhee,9,0,35,26
1656781788134,MATH 10B,A03,093472,Lim; Seonhee,4,0,34,30
1656781788134,MATH 10B,B01,083739,Sinha; Shubham,9,0,30,21
1656781794167,MATH 18,A01,083743,Cinel; Cameron Alexander,6,0,30,24
1656781794167,MATH 18,A02,083744,Cinel; Cameron Alexander,15,0,30,15
1656781794167,MATH 18,A03,083745,Cinel; Cameron Alexander,8,0,30,22
1656781794167,MATH 18,B01,083748,Rideout; David Porter,3,0,37,34
1656781794167,MATH 18,B02,083749,Rideout; David Porter,3,0,36,33
1656781794167,MATH 18,B03,083750,Rideout; David Porter,1,0,37,36
1656781794167,MATH 18,B04,083751,Rideout; David Porter,5,0,36,31
1656781794167,MATH 18,B05,093473,Rideout; David Porter,4,0,36,32
1656781794167,MATH 18,B06,093474,Rideout; David Porter,5,0,36,31
1656781800192,MATH 20A,A01,083754,Zheng; Zequn,12,0,40,28
1656781806234,MATH 20B,A01,083756,Briones; Jor-el Thomas Caparas,1,0,36,35
1656781806234,MATH 20B,A02,083757,Briones; Jor-el Thomas Caparas,1,0,36,35
1656781806234,MATH 20B,A03,093475,Briones; Jor-el Thomas Caparas,0,0,36,36
1656781812261,MATH 20C,A01,083760,Briones; Jor-el Thomas Caparas,1,0,35,34
1656781812261,MATH 20C,A02,083761,Briones; Jor-el Thomas Caparas,8,0,35,27
1656781812261,MATH 20C,A03,093476,Briones; Jor-el Thomas Caparas,0,1,36,36
1656781812261,MATH 20C,B01,083762,Bach; Quang Tran,0,0,30,30
1656781818292,MATH 20D,A01,083765,Tran; Brian Kha,4,0,30,26
1656781818292,MATH 20D,A02,083766,Tran; Brian Kha,4,0,30,26
1656781818292,MATH 20D,A03,083767,Tran; Brian Kha,2,0,30,28
1656781824322,MATH 20E,A01,083771,Ganguly; Soumya,5,0,32,27
1656781824322,MATH 20E,A02,083772,Ganguly; Soumya,5,0,32,27
1656781824322,MATH 20E,B01,083773,Ciotti; Benjamin,18,0,35,17
1656781824322,MATH 20E,B02,083774,Ciotti; Benjamin,17,0,35,18
1656781830347,MATH 103A,A01,083777,Greenfeld; Be'Eri,2,0,36,34
1656781830347,MATH 103A,A02,083778,Greenfeld; Be'Eri,5,0,36,31
1656781830347,MATH 103A,A03,093561,Greenfeld; Be'Eri,4,0,36,32
1656781830347,MATH 103A,B01,083779,Greenfeld; Be'Eri,6,0,36,30
1656781830347,MATH 103A,B02,083780,Greenfeld; Be'Eri,2,0,36,34
1656781830347,MATH 103A,B03,093562,Greenfeld; Be'Eri,2,0,36,34
1656781836377,MATH 105,A01,085443,Carter; Anne Toulson,13,0,35,22
1656781836377,MATH 105,A02,093477,Carter; Anne Toulson,20,0,35,15
1656781842402,MATH 109,A01,083213,Ganzberger; Geoffrey Michael,2,0,34,32
1656781842402,MATH 109,A02,083214,Ganzberger; Geoffrey Michael,2,0,34,32
1656781842402,MATH 109,A03,093478,Ganzberger; Geoffrey Michael,1,0,34,33
1656781842402,MATH 109,B01,083215,Ganzberger; Geoffrey Michael,1,0,32,31
1656781842402,MATH 109,B02,083216,Ganzberger; Geoffrey Michael,1,0,32,31
1656781842402,MATH 109,B03,093479,Ganzberger; Geoffrey Michael,6,0,32,26
1656781848427,MATH 142A,A01,083219,Chow; Bennett,6,0,32,26
1656781848427,MATH 142A,A02,083220,Chow; Bennett,9,0,32,23
1656781848427,MATH 142A,A03,093480,Chow; Bennett,7,0,32,25
1656781848427,MATH 142A,B03,093481,Chow; Bennett,7,0,32,25
1656781848427,MATH 142A,B04,093558,Chow; Bennett,10,0,32,22
1656781848427,MATH 142A,B05,093559,Chow; Bennett,6,0,32,26
1656781854451,MATH 193A,A01,083224,Rotar; Vladimir,6,0,34,28
1656781854451,MATH 193A,A02,083225,Rotar; Vladimir,3,0,34,31
1656781854451,MATH 193A,A03,083781,Rotar; Vladimir,1,0,34,33
1656781854451,MATH 193A,A04,083782,Rotar; Vladimir,6,0,34,28
1656781854451,MATH 193A,A05,093482,Rotar; Vladimir,6,0,34,28
1656781860477,MATH 197,001,091859,McAuley; Julian John,9999,0,9999,0
1656781860477,MATH 197,002,095566,Kedlaya; Kiran S.,9997,0,9999,2
1656781860477,MATH 197,003,095567,Xiao; Ming,9999,0,9999,0
1656781860477,MATH 197,004,095571,Perols; Johan Lars,9998,0,9999,1
1656781867532,COGS 9,A01,083615,Shannon; Kyle Michael,6,0,75,69
1656781873556,COGS 11,A01,083617,Boyle; Mary E. T.,18,0,48,30
1656781879585,COGS 13,A01,083071,Bastos; Amalia Pinkusfeld,8,0,71,63
1656781885607,COGS 14A,A01,092681,Semenuks; Arturs,0,1,100,100
1656781891631,COGS 14B,A01,083073,Cheng; Tzu-Han,5,0,63,58
1656781897653,COGS 17,A01,092677,Semenuks; Arturs,4,0,81,77
1656781903677,COGS 100,A01,083619,Allen; Michael Gordon,15,0,70,55
1656781909701,COGS 101A,A01,083621,Davis; Joshua Daniel,9,0,68,59
1656781915723,COGS 101B,A01,091572,Allen; Michael Gordon,8,0,65,57
1656781921749,COGS 101C,A01,083625,Delgado; Tania,17,0,35,18
1656781927775,COGS 107A,A01,083627,Boyle; Mary E. T.,13,0,60,47
1656781933808,COGS 118A,A01,083075,Gupta; Anjum,15,0,76,61
1656781939834,CSE 3,A50,083646,Miranda; Gregory Joseph,22,0,50,28
1656781945859,CSE 8A,A50,083650,Miranda; Gregory Joseph,17,1,56,39
1656781951886,CSE 11,A01,083080,Cao; Yingjun,4,15,40,36
1656781957909,CSE 12,A01,083652,Krause-Levy; Sophia Louisa,20,1,120,100
1656781963935,CSE 15L,A01,083654,Morris; Justin Loren,8,0,50,42
1656781963935,CSE 15L,A02,083655,Morris; Justin Loren,8,0,50,42
1656781969960,CSE 20,A01,083657,Tran; Khoa Dang,37,0,80,43
1656781975983,CSE 21,A01,095574,Bach; Quang Tran,21,0,48,27
1656781982009,CSE 30,A01,083084,Eldon; John,4,0,80,76
1656781982009,CSE 30,B01,095061,Bhaskar; Nishant,5,0,50,45
1656781988032,CSE 100,A01,083659,Cao; Yingjun,1,4,70,69
1656781994136,CSE 134B,A01,083661,Powell; Thomas Allan,18,0,100,82
1656782000163,CSE 140,A01,083663,Gungor; Onat,14,0,85,71
1656782006186,CSE 140L,A01,083088,Eldon; John,16,0,100,84
1656782012210,CSE 175,A01,083665,Kumar; Rakesh,3,0,25,22
1656782018234,CSE 190,A00,092507,Dubnov; Shlomo,7,0,20,13
1656782024257,ECE 45,A01,083139,Congero; Spencer William,5,0,75,70
1656782030287,ECE 65,A50,083695,Saad; Andrew S,12,0,30,18
1656782030287,ECE 65,A51,095125,Saad; Andrew S,25,0,26,1
1656782036309,ECE 109,A01,091882,Touri; Behrouz,15,0,70,55
1656782042335,ECE 180,A00,083140,Abi Samra; Nicholas Camill,0,0,30,30
1656782042335,ECE 180,B00,083141,Abi Samra; Nicholas Camill,0,0,30,30
1656782048363,MATH 10A,A01,083735,Patchell; Gregory David,1,0,30,29
1656782048363,MATH 10A,A02,083736,Patchell; Gregory David,20,0,30,10
1656782048363,MATH 10A,A03,083737,Patchell; Gregory David,15,0,30,15
1656782054388,MATH 10B,A01,083207,Lim; Seonhee,7,0,34,27
1656782054388,MATH 10B,A02,083208,Lim; Seonhee,9,0,35,26
1656782054388,MATH 10B,A03,093472,Lim; Seonhee,4,0,34,30
1656782054388,MATH 10B,B01,083739,Sinha; Shubham,9,0,30,21
1656782060414,MATH 18,A01,083743,Cinel; Cameron Alexander,6,0,30,24
1656782060414,MATH 18,A02,083744,Cinel; Cameron Alexander,15,0,30,15
1656782060414,MATH 18,A03,083745,Cinel; Cameron Alexander,8,0,30,22
1656782060414,MATH 18,B01,083748,Rideout; David Porter,3,0,37,34
1656782060414,MATH 18,B02,083749,Rideout; David Porter,3,0,36,33
1656782060414,MATH 18,B03,083750,Rideout; David Porter,1,0,37,36
1656782060414,MATH 18,B04,083751,Rideout; David Porter,5,0,36,31
1656782060414,MATH 18,B05,093473,Rideout; David Porter,4,0,36,32
1656782060414,MATH 18,B06,093474,Rideout; David Porter,5,0,36,31
1656782066439,MATH 20A,A01,083754,Zheng; Zequn,12,0,40,28
1656782072462,MATH 20B,A01,083756,Briones; Jor-el Thomas Caparas,1,0,36,35
1656782072462,MATH 20B,A02,083757,Briones; Jor-el Thomas Caparas,1,0,36,35
1656782072462,MATH 20B,A03,093475,Briones; Jor-el Thomas Caparas,0,0,36,36
1656782078488,MATH 20C,A01,083760,Briones; Jor-el Thomas Caparas,1,0,35,34
1656782078488,MATH 20C,A02,083761,Briones; Jor-el Thomas Caparas,8,0,35,27
1656782078488,MATH 20C,A03,093476,Briones; Jor-el Thomas Caparas,0,1,36,36
1656782078488,MATH 20C,B01,083762,Bach; Quang Tran,0,0,30,30
1656782084510,MATH 20D,A01,083765,Tran; Brian Kha,4,0,30,26
1656782084510,MATH 20D,A02,083766,Tran; Brian Kha,4,0,30,26
1656782084510,MATH 20D,A03,083767,Tran; Brian Kha,2,0,30,28
1656782090538,MATH 20E,A01,083771,Ganguly; Soumya,5,0,32,27
1656782090538,MATH 20E,A02,083772,Ganguly; Soumya,5,0,32,27
1656782090538,MATH 20E,B01,083773,Ciotti; Benjamin,18,0,35,17
1656782090538,MATH 20E,B02,083774,Ciotti; Benjamin,17,0,35,18
1656782096564,MATH 103A,A01,083777,Greenfeld; Be'Eri,2,0,36,34
1656782096564,MATH 103A,A02,083778,Greenfeld; Be'Eri,5,0,36,31
1656782096564,MATH 103A,A03,093561,Greenfeld; Be'Eri,4,0,36,32
1656782096564,MATH 103A,B01,083779,Greenfeld; Be'Eri,6,0,36,30
1656782096564,MATH 103A,B02,083780,Greenfeld; Be'Eri,2,0,36,34
1656782096564,MATH 103A,B03,093562,Greenfeld; Be'Eri,2,0,36,34
1656782102588,MATH 105,A01,085443,Carter; Anne Toulson,13,0,35,22
1656782102588,MATH 105,A02,093477,Carter; Anne Toulson,20,0,35,15
1656782108617,MATH 109,A01,083213,Ganzberger; Geoffrey Michael,2,0,34,32
1656782108617,MATH 109,A02,083214,Ganzberger; Geoffrey Michael,2,0,34,32
1656782108617,MATH 109,A03,093478,Ganzberger; Geoffrey Michael,1,0,34,33
1656782108617,MATH 109,B01,083215,Ganzberger; Geoffrey Michael,1,0,32,31
1656782108617,MATH 109,B02,083216,Ganzberger; Geoffrey Michael,1,0,32,31
1656782108617,MATH 109,B03,093479,Ganzberger; Geoffrey Michael,6,0,32,26
1656782114653,MATH 142A,A01,083219,Chow; Bennett,6,0,32,26
1656782114653,MATH 142A,A02,083220,Chow; Bennett,9,0,32,23
1656782114653,MATH 142A,A03,093480,Chow; Bennett,7,0,32,25
1656782114653,MATH 142A,B03,093481,Chow; Bennett,7,0,32,25
1656782114653,MATH 142A,B04,093558,Chow; Bennett,10,0,32,22
1656782114653,MATH 142A,B05,093559,Chow; Bennett,6,0,32,26
1656782120678,MATH 193A,A01,083224,Rotar; Vladimir,6,0,34,28
1656782120678,MATH 193A,A02,083225,Rotar; Vladimir,3,0,34,31
1656782120678,MATH 193A,A03,083781,Rotar; Vladimir,1,0,34,33
1656782120678,MATH 193A,A04,083782,Rotar; Vladimir,6,0,34,28
1656782120678,MATH 193A,A05,093482,Rotar; Vladimir,6,0,34,28
1656782126707,MATH 197,001,091859,McAuley; Julian John,9999,0,9999,0
1656782126707,MATH 197,002,095566,Kedlaya; Kiran S.,9997,0,9999,2
1656782126707,MATH 197,003,095567,Xiao; Ming,9999,0,9999,0
1656782126707,MATH 197,004,095571,Perols; Johan Lars,9998,0,9999,1
1656782133790,COGS 9,A01,083615,Shannon; Kyle Michael,6,0,75,69
1656782139819,COGS 11,A01,083617,Boyle; Mary E. T.,18,0,48,30
1656782145844,COGS 13,A01,083071,Bastos; Amalia Pinkusfeld,8,0,71,63
1656782151882,COGS 14A,A01,092681,Semenuks; Arturs,0,1,100,100
1656782157912,COGS 14B,A01,083073,Cheng; Tzu-Han,5,0,63,58
1656782163944,COGS 17,A01,092677,Semenuks; Arturs,4,0,81,77
1656782169970,COGS 100,A01,083619,Allen; Michael Gordon,15,0,70,55
1656782176001,COGS 101A,A01,083621,Davis; Joshua Daniel,9,0,68,59
1656782182026,COGS 101B,A01,091572,Allen; Michael Gordon,8,0,65,57
1656782188052,COGS 101C,A01,083625,Delgado; Tania,17,0,35,18
1656782194077,COGS 107A,A01,083627,Boyle; Mary E. T.,13,0,60,47
1656782200103,COGS 118A,A01,083075,Gupta; Anjum,15,0,76,61
1656782206128,CSE 3,A50,083646,Miranda; Gregory Joseph,22,0,50,28
1656782212155,CSE 8A,A50,083650,Miranda; Gregory Joseph,17,1,56,39
1656782218180,CSE 11,A01,083080,Cao; Yingjun,4,15,40,36
1656782224205,CSE 12,A01,083652,Krause-Levy; Sophia Louisa,20,1,120,100
1656782230230,CSE 15L,A01,083654,Morris; Justin Loren,8,0,50,42
1656782230230,CSE 15L,A02,083655,Morris; Justin Loren,8,0,50,42
1656782236255,CSE 20,A01,083657,Tran; Khoa Dang,37,0,80,43
1656782242287,CSE 21,A01,095574,Bach; Quang Tran,21,0,48,27
1656782248312,CSE 30,A01,083084,Eldon; John,4,0,80,76
1656782248312,CSE 30,B01,095061,Bhaskar; Nishant,5,0,50,45
1656782254336,CSE 100,A01,083659,Cao; Yingjun,1,4,70,69
1656782260361,CSE 134B,A01,083661,Powell; Thomas Allan,18,0,100,82
1656782266414,CSE 140,A01,083663,Gungor; Onat,14,0,85,71
1656782272451,CSE 140L,A01,083088,Eldon; John,16,0,100,84
1656782278474,CSE 175,A01,083665,Kumar; Rakesh,3,0,25,22
1656782284497,CSE 190,A00,092507,Dubnov; Shlomo,7,0,20,13
1656782290522,ECE 45,A01,083139,Congero; Spencer William,5,0,75,70
1656782296564,ECE 65,A50,083695,Saad; Andrew S,12,0,30,18
1656782296564,ECE 65,A51,095125,Saad; Andrew S,25,0,26,1
1656782302587,ECE 109,A01,091882,Touri; Behrouz,15,0,70,55
1656782308610,ECE 180,A00,083140,Abi Samra; Nicholas Camill,0,0,30,30
1656782308610,ECE 180,B00,083141,Abi Samra; Nicholas Camill,0,0,30,30
1656782314637,MATH 10A,A01,083735,Patchell; Gregory David,1,0,30,29
1656782314637,MATH 10A,A02,083736,Patchell; Gregory David,20,0,30,10
1656782314637,MATH 10A,A03,083737,Patchell; Gregory David,15,0,30,15
1656782320669,MATH 10B,A01,083207,Lim; Seonhee,7,0,34,27
1656782320669,MATH 10B,A02,083208,Lim; Seonhee,9,0,35,26
1656782320669,MATH 10B,A03,093472,Lim; Seonhee,4,0,34,30
1656782320669,MATH 10B,B01,083739,Sinha; Shubham,9,0,30,21
1656782326705,MATH 18,A01,083743,Cinel; Cameron Alexander,6,0,30,24
1656782326705,MATH 18,A02,083744,Cinel; Cameron Alexander,15,0,30,15
1656782326705,MATH 18,A03,083745,Cinel; Cameron Alexander,8,0,30,22
1656782326705,MATH 18,B01,083748,Rideout; David Porter,3,0,37,34
1656782326705,MATH 18,B02,083749,Rideout; David Porter,3,0,36,33
1656782326705,MATH 18,B03,083750,Rideout; David Porter,1,0,37,36
1656782326705,MATH 18,B04,083751,Rideout; David Porter,5,0,36,31
1656782326705,MATH 18,B05,093473,Rideout; David Porter,4,0,36,32
1656782326705,MATH 18,B06,093474,Rideout; David Porter,5,0,36,31
1656782332729,MATH 20A,A01,083754,Zheng; Zequn,12,0,40,28
1656782338754,MATH 20B,A01,083756,Briones; Jor-el Thomas Caparas,1,0,36,35
1656782338754,MATH 20B,A02,083757,Briones; Jor-el Thomas Caparas,1,0,36,35
1656782338754,MATH 20B,A03,093475,Briones; Jor-el Thomas Caparas,0,0,36,36
1656782344784,MATH 20C,A01,083760,Briones; Jor-el Thomas Caparas,1,0,35,34
1656782344784,MATH 20C,A02,083761,Briones; Jor-el Thomas Caparas,8,0,35,27
1656782344784,MATH 20C,A03,093476,Briones; Jor-el Thomas Caparas,0,1,36,36
1656782344784,MATH 20C,B01,083762,Bach; Quang Tran,0,0,30,30
1656782350812,MATH 20D,A01,083765,Tran; Brian Kha,4,0,30,26
1656782350812,MATH 20D,A02,083766,Tran; Brian Kha,4,0,30,26
1656782350812,MATH 20D,A03,083767,Tran; Brian Kha,2,0,30,28
1656782356837,MATH 20E,A01,083771,Ganguly; Soumya,5,0,32,27
1656782356837,MATH 20E,A02,083772,Ganguly; Soumya,5,0,32,27
1656782356837,MATH 20E,B01,083773,Ciotti; Benjamin,18,0,35,17
1656782356837,MATH 20E,B02,083774,Ciotti; Benjamin,17,0,35,18
1656782362861,MATH 103A,A01,083777,Greenfeld; Be'Eri,2,0,36,34
1656782362861,MATH 103A,A02,083778,Greenfeld; Be'Eri,5,0,36,31
1656782362861,MATH 103A,A03,093561,Greenfeld; Be'Eri,4,0,36,32
1656782362861,MATH 103A,B01,083779,Greenfeld; Be'Eri,6,0,36,30
1656782362861,MATH 103A,B02,083780,Greenfeld; Be'Eri,2,0,36,34
1656782362861,MATH 103A,B03,093562,Greenfeld; Be'Eri,2,0,36,34
1656782368890,MATH 105,A01,085443,Carter; Anne Toulson,13,0,35,22
1656782368890,MATH 105,A02,093477,Carter; Anne Toulson,20,0,35,15
1656782374914,MATH 109,A01,083213,Ganzberger; Geoffrey Michael,2,0,34,32
1656782374914,MATH 109,A02,083214,Ganzberger; Geoffrey Michael,2,0,34,32
1656782374914,MATH 109,A03,093478,Ganzberger; Geoffrey Michael,1,0,34,33
1656782374914,MATH 109,B01,083215,Ganzberger; Geoffrey Michael,1,0,32,31
1656782374914,MATH 109,B02,083216,Ganzberger; Geoffrey Michael,1,0,32,31
1656782374914,MATH 109,B03,093479,Ganzberger; Geoffrey Michael,6,0,32,26
1656782380943,MATH 142A,A01,083219,Chow; Bennett,6,0,32,26
1656782380943,MATH 142A,A02,083220,Chow; Bennett,9,0,32,23
1656782380943,MATH 142A,A03,093480,Chow; Bennett,7,0,32,25
1656782380943,MATH 142A,B03,093481,Chow; Bennett,7,0,32,25
1656782380943,MATH 142A,B04,093558,Chow; Bennett,10,0,32,22
1656782380943,MATH 142A,B05,093559,Chow; Bennett,6,0,32,26
1656782386973,MATH 193A,A01,083224,Rotar; Vladimir,6,0,34,28
1656782386973,MATH 193A,A02,083225,Rotar; Vladimir,3,0,34,31
1656782386973,MATH 193A,A03,083781,Rotar; Vladimir,1,0,34,33
1656782386973,MATH 193A,A04,083782,Rotar; Vladimir,6,0,34,28
1656782386973,MATH 193A,A05,093482,Rotar; Vladimir,6,0,34,28
1656782392998,MATH 197,001,091859,McAuley; Julian John,9999,0,9999,0
1656782392998,MATH 197,002,095566,Kedlaya; Kiran S.,9997,0,9999,2
1656782392998,MATH 197,003,095567,Xiao; Ming,9999,0,9999,0
1656782392998,MATH 197,004,095571,Perols; Johan Lars,9998,0,9999,1
1656782400070,COGS 9,A01,083615,Shannon; Kyle Michael,6,0,75,69
1656782406098,COGS 11,A01,083617,Boyle; Mary E. T.,18,0,48,30
1656782412123,COGS 13,A01,083071,Bastos; Amalia Pinkusfeld,8,0,71,63
1656782418146,COGS 14A,A01,092681,Semenuks; Arturs,0,1,100,100
1656782424170,COGS 14B,A01,083073,Cheng; Tzu-Han,5,0,63,58
1656782430198,COGS 17,A01,092677,Semenuks; Arturs,4,0,81,77
1656782436222,COGS 100,A01,083619,Allen; Michael Gordon,15,0,70,55
1656782442250,COGS 101A,A01,083621,Davis; Joshua Daniel,9,0,68,59
1656782448274,COGS 101B,A01,091572,Allen; Michael Gordon,8,0,65,57
1656782454298,COGS 101C,A01,083625,Delgado; Tania,17,0,35,18
1656782460325,COGS 107A,A01,083627,Boyle; Mary E. T.,13,0,60,47
1656782466350,COGS 118A,A01,083075,Gupta; Anjum,15,0,76,61
1656782472378,CSE 3,A50,083646,Miranda; Gregory Joseph,22,0,50,28
1656782478406,CSE 8A,A50,083650,Miranda; Gregory Joseph,17,1,56,39
1656782484445,CSE 11,A01,083080,Cao; Yingjun,4,15,40,36
1656782490470,CSE 12,A01,083652,Krause-Levy; Sophia Louisa,20,1,120,100
1656782496503,CSE 15L,A01,083654,Morris; Justin Loren,8,0,50,42
1656782496503,CSE 15L,A02,083655,Morris; Justin Loren,8,0,50,42
1656782502527,CSE 20,A01,083657,Tran; Khoa Dang,37,0,80,43
1656782508556,CSE 21,A01,095574,Bach; Quang Tran,21,0,48,27
1656782514581,CSE 30,A01,083084,Eldon; John,4,0,80,76
1656782514581,CSE 30,B01,095061,Bhaskar; Nishant,5,0,50,45
1656782520605,CSE 100,A01,083659,Cao; Yingjun,1,4,70,69
1656782526639,CSE 134B,A01,083661,Powell; Thomas Allan,18,0,100,82
1656782532665,CSE 140,A01,083663,Gungor; Onat,14,0,85,71
1656782538693,CSE 140L,A01,083088,Eldon; John,16,0,100,84
1656782544720,CSE 175,A01,083665,Kumar; Rakesh,3,0,25,22
1656782550745,CSE 190,A00,092507,Dubnov; Shlomo,7,0,20,13
1656782556772,ECE 45,A01,083139,Congero; Spencer William,5,0,75,70
1656782562803,ECE 65,A50,083695,Saad; Andrew S,12,0,30,18
1656782562803,ECE 65,A51,095125,Saad; Andrew S,25,0,26,1
1656782568827,ECE 109,A01,091882,Touri; Behrouz,15,0,70,55
1656782574850,ECE 180,A00,083140,Abi Samra; Nicholas Camill,0,0,30,30
1656782574850,ECE 180,B00,083141,Abi Samra; Nicholas Camill,0,0,30,30
1656782580883,MATH 10A,A01,083735,Patchell; Gregory David,1,0,30,29
1656782580883,MATH 10A,A02,083736,Patchell; Gregory David,20,0,30,10
1656782580883,MATH 10A,A03,083737,Patchell; Gregory David,15,0,30,15
1656782586913,MATH 10B,A01,083207,Lim; Seonhee,7,0,34,27
1656782586913,MATH 10B,A02,083208,Lim; Seonhee,9,0,35,26
1656782586913,MATH 10B,A03,093472,Lim; Seonhee,4,0,34,30
1656782586913,MATH 10B,B01,083739,Sinha; Shubham,9,0,30,21
1656782593041,MATH 18,A01,083743,Cinel; Cameron Alexander,6,0,30,24
1656782593041,MATH 18,A02,083744,Cinel; Cameron Alexander,15,0,30,15
1656782593041,MATH 18,A03,083745,Cinel; Cameron Alexander,8,0,30,22
1656782593041,MATH 18,B01,083748,Rideout; David Porter,3,0,37,34
1656782593041,MATH 18,B02,083749,Rideout; David Porter,3,0,36,33
1656782593041,MATH 18,B03,083750,Rideout; David Porter,1,0,37,36
1656782593041,MATH 18,B04,083751,Rideout; David Porter,5,0,36,31
1656782593041,MATH 18,B05,093473,Rideout; David Porter,4,0,36,32
1656782593041,MATH 18,B06,093474,Rideout; David Porter,5,0,36,31
1656782599067,MATH 20A,A01,083754,Zheng; Zequn,12,0,40,28
1656782605089,MATH 20B,A01,083756,Briones; Jor-el Thomas Caparas,1,0,36,35
1656782605089,MATH 20B,A02,083757,Briones; Jor-el Thomas Caparas,1,0,36,35
1656782605089,MATH 20B,A03,093475,Briones; Jor-el Thomas Caparas,0,0,36,36
1656782611115,MATH 20C,A01,083760,Briones; Jor-el Thomas Caparas,1,0,35,34
1656782611115,MATH 20C,A02,083761,Briones; Jor-el Thomas Caparas,8,0,35,27
1656782611115,MATH 20C,A03,093476,Briones; Jor-el Thomas Caparas,0,1,36,36
1656782611115,MATH 20C,B01,083762,Bach; Quang Tran,0,0,30,30
1656782617145,MATH 20D,A01,083765,Tran; Brian Kha,4,0,30,26
1656782617145,MATH 20D,A02,083766,Tran; Brian Kha,4,0,30,26
1656782617145,MATH 20D,A03,083767,Tran; Brian Kha,2,0,30,28
1656782623176,MATH 20E,A01,083771,Ganguly; Soumya,5,0,32,27
1656782623176,MATH 20E,A02,083772,Ganguly; Soumya,5,0,32,27
1656782623176,MATH 20E,B01,083773,Ciotti; Benjamin,18,0,35,17
1656782623176,MATH 20E,B02,083774,Ciotti; Benjamin,17,0,35,18
1656782629201,MATH 103A,A01,083777,Greenfeld; Be'Eri,2,0,36,34
1656782629201,MATH 103A,A02,083778,Greenfeld; Be'Eri,5,0,36,31
1656782629201,MATH 103A,A03,093561,Greenfeld; Be'Eri,4,0,36,32
1656782629201,MATH 103A,B01,083779,Greenfeld; Be'Eri,6,0,36,30
1656782629201,MATH 103A,B02,083780,Greenfeld; Be'Eri,2,0,36,34
1656782629201,MATH 103A,B03,093562,Greenfeld; Be'Eri,2,0,36,34
1656782635226,MATH 105,A01,085443,Carter; Anne Toulson,13,0,35,22
1656782635226,MATH 105,A02,093477,Carter; Anne Toulson,20,0,35,15
1656782641251,MATH 109,A01,083213,Ganzberger; Geoffrey Michael,2,0,34,32
1656782641251,MATH 109,A02,083214,Ganzberger; Geoffrey Michael,2,0,34,32
1656782641251,MATH 109,A03,093478,Ganzberger; Geoffrey Michael,1,0,34,33
1656782641251,MATH 109,B01,083215,Ganzberger; Geoffrey Michael,1,0,32,31
1656782641251,MATH 109,B02,083216,Ganzberger; Geoffrey Michael,1,0,32,31
1656782641251,MATH 109,B03,093479,Ganzberger; Geoffrey Michael,6,0,32,26
1656782647276,MATH 142A,A01,083219,Chow; Bennett,6,0,32,26
1656782647276,MATH 142A,A02,083220,Chow; Bennett,9,0,32,23
1656782647276,MATH 142A,A03,093480,Chow; Bennett,7,0,32,25
1656782647276,MATH 142A,B03,093481,Chow; Bennett,7,0,32,25
1656782647276,MATH 142A,B04,093558,Chow; Bennett,10,0,32,22
1656782647276,MATH 142A,B05,093559,Chow; Bennett,6,0,32,26
1656782653309,MATH 193A,A01,083224,Rotar; Vladimir,6,0,34,28
1656782653309,MATH 193A,A02,083225,Rotar; Vladimir,3,0,34,31
1656782653309,MATH 193A,A03,083781,Rotar; Vladimir,1,0,34,33
1656782653309,MATH 193A,A04,083782,Rotar; Vladimir,6,0,34,28
1656782653309,MATH 193A,A05,093482,Rotar; Vladimir,6,0,34,28
1656782659332,MATH 197,001,091859,McAuley; Julian John,9999,0,9999,0
1656782659332,MATH 197,002,095566,Kedlaya; Kiran S.,9997,0,9999,2
1656782659332,MATH 197,003,095567,Xiao; Ming,9999,0,9999,0
1656782659332,MATH 197,004,095571,Perols; Johan Lars,9998,0,9999,1
1656782666389,COGS 9,A01,083615,Shannon; Kyle Michael,6,0,75,69
1656782672412,COGS 11,A01,083617,Boyle; Mary E. T.,18,0,48,30
1656782678441,COGS 13,A01,083071,Bastos; Amalia Pinkusfeld,8,0,71,63
1656782684464,COGS 14A,A01,092681,Semenuks; Arturs,0,1,100,100
1656782690494,COGS 14B,A01,083073,Cheng; Tzu-Han,5,0,63,58
1656782696522,COGS 17,A01,092677,Semenuks; Arturs,4,0,81,77
1656782702547,COGS 100,A01,083619,Allen; Michael Gordon,15,0,70,55
1656782708570,COGS 101A,A01,083621,Davis; Joshua Daniel,9,0,68,59
1656782714594,COGS 101B,A01,091572,Allen; Michael Gordon,8,0,65,57
1656782720618,COGS 101C,A01,083625,Delgado; Tania,17,0,35,18
1656782726640,COGS 107A,A01,083627,Boyle; Mary E. T.,13,0,60,47
1656782732669,COGS 118A,A01,083075,Gupta; Anjum,15,0,76,61
1656782738696,CSE 3,A50,083646,Miranda; Gregory Joseph,22,0,50,28
1656782744724,CSE 8A,A50,083650,Miranda; Gregory Joseph,17,1,56,39
1656782750752,CSE 11,A01,083080,Cao; Yingjun,4,15,40,36
1656782756781,CSE 12,A01,083652,Krause-Levy; Sophia Louisa,20,1,120,100
1656782762810,CSE 15L,A01,083654,Morris; Justin Loren,8,0,50,42
1656782762810,CSE 15L,A02,083655,Morris; Justin Loren,8,0,50,42
1656782768834,CSE 20,A01,083657,Tran; Khoa Dang,37,0,80,43
1656782774859,CSE 21,A01,095574,Bach; Quang Tran,21,0,48,27
1656782780886,CSE 30,A01,083084,Eldon; John,4,0,80,76
1656782780886,CSE 30,B01,095061,Bhaskar; Nishant,5,0,50,45
1656782786908,CSE 100,A01,083659,Cao; Yingjun,1,4,70,69
1656782792936,CSE 134B,A01,083661,Powell; Thomas Allan,18,0,100,82
1656782798973,CSE 140,A01,083663,Gungor; Onat,14,0,85,71
1656782805007,CSE 140L,A01,083088,Eldon; John,16,0,100,84
1656782811033,CSE 175,A01,083665,Kumar; Rakesh,3,0,25,22
1656782817061,CSE 190,A00,092507,Dubnov; Shlomo,7,0,20,13
1656782823089,ECE 45,A01,083139,Congero; Spencer William,5,0,75,70
1656782829119,ECE 65,A50,083695,Saad; Andrew S,12,0,30,18
1656782829119,ECE 65,A51,095125,Saad; Andrew S,25,0,26,1
1656782835145,ECE 109,A01,091882,Touri; Behrouz,15,0,70,55
1656782841168,ECE 180,A00,083140,Abi Samra; Nicholas Camill,0,0,30,30
1656782841168,ECE 180,B00,083141,Abi Samra; Nicholas Camill,0,0,30,30
1656782847191,MATH 10A,A01,083735,Patchell; Gregory David,1,0,30,29
1656782847191,MATH 10A,A02,083736,Patchell; Gregory David,20,0,30,10
1656782847191,MATH 10A,A03,083737,Patchell; Gregory David,15,0,30,15
1656782853216,MATH 10B,A01,083207,Lim; Seonhee,7,0,34,27
1656782853216,MATH 10B,A02,083208,Lim; Seonhee,9,0,35,26
1656782853216,MATH 10B,A03,093472,Lim; Seonhee,4,0,34,30
1656782853216,MATH 10B,B01,083739,Sinha; Shubham,9,0,30,21
1656782859240,MATH 18,A01,083743,Cinel; Cameron Alexander,6,0,30,24
1656782859240,MATH 18,A02,083744,Cinel; Cameron Alexander,15,0,30,15
1656782859240,MATH 18,A03,083745,Cinel; Cameron Alexander,8,0,30,22
1656782859240,MATH 18,B01,083748,Rideout; David Porter,3,0,37,34
1656782859240,MATH 18,B02,083749,Rideout; David Porter,3,0,36,33
1656782859240,MATH 18,B03,083750,Rideout; David Porter,1,0,37,36
1656782859240,MATH 18,B04,083751,Rideout; David Porter,5,0,36,31
1656782859240,MATH 18,B05,093473,Rideout; David Porter,4,0,36,32
1656782859240,MATH 18,B06,093474,Rideout; David Porter,5,0,36,31
1656782865268,MATH 20A,A01,083754,Zheng; Zequn,12,0,40,28
1656782871295,MATH 20B,A01,083756,Briones; Jor-el Thomas Caparas,1,0,36,35
1656782871295,MATH 20B,A02,083757,Briones; Jor-el Thomas Caparas,1,0,36,35
1656782871295,MATH 20B,A03,093475,Briones; Jor-el Thomas Caparas,0,0,36,36
1656782877325,MATH 20C,A01,083760,Briones; Jor-el Thomas Caparas,1,0,35,34
1656782877325,MATH 20C,A02,083761,Briones; Jor-el Thomas Caparas,8,0,35,27
1656782877325,MATH 20C,A03,093476,Briones; Jor-el Thomas Caparas,0,1,36,36
1656782877325,MATH 20C,B01,083762,Bach; Quang Tran,0,0,30,30
1656782883349,MATH 20D,A01,083765,Tran; Brian Kha,4,0,30,26
1656782883349,MATH 20D,A02,083766,Tran; Brian Kha,4,0,30,26
1656782883349,MATH 20D,A03,083767,Tran; Brian Kha,2,0,30,28
1656782889374,MATH 20E,A01,083771,Ganguly; Soumya,5,0,32,27
1656782889374,MATH 20E,A02,083772,Ganguly; Soumya,5,0,32,27
1656782889374,MATH 20E,B01,083773,Ciotti; Benjamin,18,0,35,17
1656782889374,MATH 20E,B02,083774,Ciotti; Benjamin,17,0,35,18
1656782895399,MATH 103A,A01,083777,Greenfeld; Be'Eri,2,0,36,34
1656782895399,MATH 103A,A02,083778,Greenfeld; Be'Eri,5,0,36,31
1656782895399,MATH 103A,A03,093561,Greenfeld; Be'Eri,4,0,36,32
1656782895399,MATH 103A,B01,083779,Greenfeld; Be'Eri,6,0,36,30
1656782895399,MATH 103A,B02,083780,Greenfeld; Be'Eri,2,0,36,34
1656782895399,MATH 103A,B03,093562,Greenfeld; Be'Eri,2,0,36,34
1656782901423,MATH 105,A01,085443,Carter; Anne Toulson,13,0,35,22
1656782901423,MATH 105,A02,093477,Carter; Anne Toulson,20,0,35,15
1656782907446,MATH 109,A01,083213,Ganzberger; Geoffrey Michael,2,0,34,32
1656782907446,MATH 109,A02,083214,Ganzberger; Geoffrey Michael,2,0,34,32
1656782907446,MATH 109,A03,093478,Ganzberger; Geoffrey Michael,1,0,34,33
1656782907446,MATH 109,B01,083215,Ganzberger; Geoffrey Michael,1,0,32,31
1656782907446,MATH 109,B02,083216,Ganzberger; Geoffrey Michael,1,0,32,31
1656782907446,MATH 109,B03,093479,Ganzberger; Geoffrey Michael,6,0,32,26
1656782913469,MATH 142A,A01,083219,Chow; Bennett,6,0,32,26
1656782913469,MATH 142A,A02,083220,Chow; Bennett,9,0,32,23
1656782913469,MATH 142A,A03,093480,Chow; Bennett,7,0,32,25
1656782913469,MATH 142A,B03,093481,Chow; Bennett,7,0,32,25
1656782913469,MATH 142A,B04,093558,Chow; Bennett,10,0,32,22
1656782913469,MATH 142A,B05,093559,Chow; Bennett,6,0,32,26
1656782919494,MATH 193A,A01,083224,Rotar; Vladimir,6,0,34,28
1656782919494,MATH 193A,A02,083225,Rotar; Vladimir,3,0,34,31
1656782919494,MATH 193A,A03,083781,Rotar; Vladimir,1,0,34,33
1656782919494,MATH 193A,A04,083782,Rotar; Vladimir,6,0,34,28
1656782919494,MATH 193A,A05,093482,Rotar; Vladimir,6,0,34,28
1656782925521,MATH 197,001,091859,McAuley; Julian John,9999,0,9999,0
1656782925521,MATH 197,002,095566,Kedlaya; Kiran S.,9997,0,9999,2
1656782925521,MATH 197,003,095567,Xiao; Ming,9999,0,9999,0
1656782925521,MATH 197,004,095571,Perols; Johan Lars,9998,0,9999,1
1656782932590,COGS 9,A01,083615,Shannon; Kyle Michael,6,0,75,69
1656782938615,COGS 11,A01,083617,Boyle; Mary E. T.,18,0,48,30
1656782944644,COGS 13,A01,083071,Bastos; Amalia Pinkusfeld,8,0,71,63
1656782950667,COGS 14A,A01,092681,Semenuks; Arturs,0,1,100,100
1656782956691,COGS 14B,A01,083073,Cheng; Tzu-Han,5,0,63,58
1656782962717,COGS 17,A01,092677,Semenuks; Arturs,4,0,81,77
1656782968742,COGS 100,A01,083619,Allen; Michael Gordon,15,0,70,55
1656782974770,COGS 101A,A01,083621,Davis; Joshua Daniel,9,0,68,59
1656782980798,COGS 101B,A01,091572,Allen; Michael Gordon,8,0,65,57
1656782986821,COGS 101C,A01,083625,Delgado; Tania,17,0,35,18
1656782992848,COGS 107A,A01,083627,Boyle; Mary E. T.,13,0,60,47
1656782998874,COGS 118A,A01,083075,Gupta; Anjum,15,0,76,61
1656783004897,CSE 3,A50,083646,Miranda; Gregory Joseph,22,0,50,28
1656783010922,CSE 8A,A50,083650,Miranda; Gregory Joseph,17,1,56,39
1656783016947,CSE 11,A01,083080,Cao; Yingjun,4,15,40,36
1656783022975,CSE 12,A01,083652,Krause-Levy; Sophia Louisa,20,1,120,100
1656783029003,CSE 15L,A01,083654,Morris; Justin Loren,8,0,50,42
1656783029003,CSE 15L,A02,083655,Morris; Justin Loren,8,0,50,42
1656783035027,CSE 20,A01,083657,Tran; Khoa Dang,37,0,80,43
1656783041055,CSE 21,A01,095574,Bach; Quang Tran,21,0,48,27
1656783047089,CSE 30,A01,083084,Eldon; John,4,0,80,76
1656783047089,CSE 30,B01,095061,Bhaskar; Nishant,5,0,50,45
1656783053118,CSE 100,A01,083659,Cao; Yingjun,1,4,70,69
1656783059145,CSE 134B,A01,083661,Powell; Thomas Allan,18,0,100,82
1656783065169,CSE 140,A01,083663,Gungor; Onat,14,0,85,71
1656783071194,CSE 140L,A01,083088,Eldon; John,16,0,100,84
1656783077225,CSE 175,A01,083665,Kumar; Rakesh,3,0,25,22
1656783083252,CSE 190,A00,092507,Dubnov; Shlomo,7,0,20,13
1656783089280,ECE 45,A01,083139,Congero; Spencer William,5,0,75,70
1656783095305,ECE 65,A50,083695,Saad; Andrew S,12,0,30,18
1656783095305,ECE 65,A51,095125,Saad; Andrew S,25,0,26,1
1656783101329,ECE 109,A01,091882,Touri; Behrouz,15,0,70,55
1656783107352,ECE 180,A00,083140,Abi Samra; Nicholas Camill,0,0,30,30
1656783107352,ECE 180,B00,083141,Abi Samra; Nicholas Camill,0,0,30,30
1656783113380,MATH 10A,A01,083735,Patchell; Gregory David,1,0,30,29
1656783113380,MATH 10A,A02,083736,Patchell; Gregory David,20,0,30,10
1656783113380,MATH 10A,A03,083737,Patchell; Gregory David,15,0,30,15
1656783119405,MATH 10B,A01,083207,Lim; Seonhee,7,0,34,27
1656783119405,MATH 10B,A02,083208,Lim; Seonhee,9,0,35,26
1656783119405,MATH 10B,A03,093472,Lim; Seonhee,4,0,34,30
1656783119405,MATH 10B,B01,083739,Sinha; Shubham,9,0,30,21
1656783125429,MATH 18,A01,083743,Cinel; Cameron Alexander,6,0,30,24
1656783125429,MATH 18,A02,083744,Cinel; Cameron Alexander,15,0,30,15
1656783125429,MATH 18,A03,083745,Cinel; Cameron Alexander,8,0,30,22
1656783125429,MATH 18,B01,083748,Rideout; David Porter,3,0,37,34
1656783125429,MATH 18,B02,083749,Rideout; David Porter,3,0,36,33
1656783125429,MATH 18,B03,083750,Rideout; David Porter,1,0,37,36
1656783125429,MATH 18,B04,083751,Rideout; David Porter,5,0,36,31
1656783125429,MATH 18,B05,093473,Rideout; David Porter,4,0,36,32
1656783125429,MATH 18,B06,093474,Rideout; David Porter,5,0,36,31
1656783131455,MATH 20A,A01,083754,Zheng; Zequn,12,0,40,28
1656783137478,MATH 20B,A01,083756,Briones; Jor-el Thomas Caparas,1,0,36,35
1656783137478,MATH 20B,A02,083757,Briones; Jor-el Thomas Caparas,1,0,36,35
1656783137478,MATH 20B,A03,093475,Briones; Jor-el Thomas Caparas,0,0,36,36
1656783143507,MATH 20C,A01,083760,Briones; Jor-el Thomas Caparas,1,0,35,34
1656783143507,MATH 20C,A02,083761,Briones; Jor-el Thomas Caparas,8,0,35,27
1656783143507,MATH 20C,A03,093476,Briones; Jor-el Thomas Caparas,0,1,36,36
1656783143507,MATH 20C,B01,083762,Bach; Quang Tran,0,0,30,30
1656783149533,MATH 20D,A01,083765,Tran; Brian Kha,4,0,30,26
1656783149533,MATH 20D,A02,083766,Tran; Brian Kha,4,0,30,26
1656783149533,MATH 20D,A03,083767,Tran; Brian Kha,2,0,30,28
1656783155557,MATH 20E,A01,083771,Ganguly; Soumya,5,0,32,27
1656783155557,MATH 20E,A02,083772,Ganguly; Soumya,5,0,32,27
1656783155557,MATH 20E,B01,083773,Ciotti; Benjamin,18,0,35,17
1656783155557,MATH 20E,B02,083774,Ciotti; Benjamin,17,0,35,18
1656783161588,MATH 103A,A01,083777,Greenfeld; Be'Eri,2,0,36,34
1656783161588,MATH 103A,A02,083778,Greenfeld; Be'Eri,5,0,36,31
1656783161588,MATH 103A,A03,093561,Greenfeld; Be'Eri,4,0,36,32
1656783161588,MATH 103A,B01,083779,Greenfeld; Be'Eri,6,0,36,30
1656783161588,MATH 103A,B02,083780,Greenfeld; Be'Eri,2,0,36,34
1656783161588,MATH 103A,B03,093562,Greenfeld; Be'Eri,2,0,36,34
1656783167616,MATH 105,A01,085443,Carter; Anne Toulson,13,0,35,22
1656783167616,MATH 105,A02,093477,Carter; Anne Toulson,20,0,35,15
1656783173642,MATH 109,A01,083213,Ganzberger; Geoffrey Michael,2,0,34,32
1656783173642,MATH 109,A02,083214,Ganzberger; Geoffrey Michael,2,0,34,32
1656783173642,MATH 109,A03,093478,Ganzberger; Geoffrey Michael,1,0,34,33
1656783173642,MATH 109,B01,083215,Ganzberger; Geoffrey Michael,1,0,32,31
1656783173642,MATH 109,B02,083216,Ganzberger; Geoffrey Michael,1,0,32,31
1656783173642,MATH 109,B03,093479,Ganzberger; Geoffrey Michael,6,0,32,26
1656783179664,MATH 142A,A01,083219,Chow; Bennett,6,0,32,26
1656783179664,MATH 142A,A02,083220,Chow; Bennett,9,0,32,23
1656783179664,MATH 142A,A03,093480,Chow; Bennett,7,0,32,25
1656783179664,MATH 142A,B03,093481,Chow; Bennett,7,0,32,25
1656783179664,MATH 142A,B04,093558,Chow; Bennett,10,0,32,22
1656783179664,MATH 142A,B05,093559,Chow; Bennett,6,0,32,26
1656783185689,MATH 193A,A01,083224,Rotar; Vladimir,6,0,34,28
1656783185689,MATH 193A,A02,083225,Rotar; Vladimir,3,0,34,31
1656783185689,MATH 193A,A03,083781,Rotar; Vladimir,1,0,34,33
1656783185689,MATH 193A,A04,083782,Rotar; Vladimir,6,0,34,28
1656783185689,MATH 193A,A05,093482,Rotar; Vladimir,6,0,34,28
1656783191799,MATH 197,001,091859,McAuley; Julian John,9999,0,9999,0
1656783191799,MATH 197,002,095566,Kedlaya; Kiran S.,9997,0,9999,2
1656783191799,MATH 197,003,095567,Xiao; Ming,9999,0,9999,0
1656783191799,MATH 197,004,095571,Perols; Johan Lars,9998,0,9999,1
1656783198884,COGS 9,A01,083615,Shannon; Kyle Michael,6,0,75,69
1656783204914,COGS 11,A01,083617,Boyle; Mary E. T.,18,0,48,30
1656783210938,COGS 13,A01,083071,Bastos; Amalia Pinkusfeld,8,0,71,63
1656783216961,COGS 14A,A01,092681,Semenuks; Arturs,0,1,100,100
1656783222985,COGS 14B,A01,083073,Cheng; Tzu-Han,5,0,63,58
1656783229010,COGS 17,A01,092677,Semenuks; Arturs,4,0,81,77
1656783235038,COGS 100,A01,083619,Allen; Michael Gordon,15,0,70,55
1656783241064,COGS 101A,A01,083621,Davis; Joshua Daniel,9,0,68,59
1656783247099,COGS 101B,A01,091572,Allen; Michael Gordon,8,0,65,57
1656783253130,COGS 101C,A01,083625,Delgado; Tania,17,0,35,18
1656783259153,COGS 107A,A01,083627,Boyle; Mary E. T.,13,0,60,47
1656783265175,COGS 118A,A01,083075,Gupta; Anjum,15,0,76,61
1656783271200,CSE 3,A50,083646,Miranda; Gregory Joseph,22,0,50,28
1656783277224,CSE 8A,A50,083650,Miranda; Gregory Joseph,17,1,56,39
1656783283250,CSE 11,A01,083080,Cao; Yingjun,4,15,40,36
1656783289273,CSE 12,A01,083652,Krause-Levy; Sophia Louisa,20,1,120,100
1656783295297,CSE 15L,A01,083654,Morris; Justin Loren,8,0,50,42
1656783295297,CSE 15L,A02,083655,Morris; Justin Loren,8,0,50,42
1656783301322,CSE 20,A01,083657,Tran; Khoa Dang,37,0,80,43
1656783307349,CSE 21,A01,095574,Bach; Quang Tran,21,0,48,27
1656783313377,CSE 30,A01,083084,Eldon; John,4,0,80,76
1656783313377,CSE 30,B01,095061,Bhaskar; Nishant,5,0,50,45
1656783319400,CSE 100,A01,083659,Cao; Yingjun,1,4,70,69
1656783325427,CSE 134B,A01,083661,Powell; Thomas Allan,18,0,100,82
1656783331451,CSE 140,A01,083663,Gungor; Onat,14,0,85,71
1656783337478,CSE 140L,A01,083088,Eldon; John,16,0,100,84
1656783343515,CSE 175,A01,083665,Kumar; Rakesh,3,0,25,22
1656783349539,CSE 190,A00,092507,Dubnov; Shlomo,7,0,20,13
1656783355568,ECE 45,A01,083139,Congero; Spencer William,5,0,75,70
1656783361590,ECE 65,A50,083695,Saad; Andrew S,12,0,30,18
1656783361590,ECE 65,A51,095125,Saad; Andrew S,25,0,26,1
1656783367614,ECE 109,A01,091882,Touri; Behrouz,15,0,70,55
1656783373642,ECE 180,A00,083140,Abi Samra; Nicholas Camill,0,0,30,30
1656783373642,ECE 180,B00,083141,Abi Samra; Nicholas Camill,0,0,30,30
1656783379665,MATH 10A,A01,083735,Patchell; Gregory David,1,0,30,29
1656783379665,MATH 10A,A02,083736,Patchell; Gregory David,20,0,30,10
1656783379665,MATH 10A,A03,083737,Patchell; Gregory David,15,0,30,15
1656783385697,MATH 10B,A01,083207,Lim; Seonhee,7,0,34,27
1656783385697,MATH 10B,A02,083208,Lim; Seonhee,9,0,35,26
1656783385697,MATH 10B,A03,093472,Lim; Seonhee,4,0,34,30
1656783385697,MATH 10B,B01,083739,Sinha; Shubham,9,0,30,21
1656783391721,MATH 18,A01,083743,Cinel; Cameron Alexander,6,0,30,24
1656783391721,MATH 18,A02,083744,Cinel; Cameron Alexander,15,0,30,15
1656783391721,MATH 18,A03,083745,Cinel; Cameron Alexander,8,0,30,22
1656783391721,MATH 18,B01,083748,Rideout; David Porter,3,0,37,34
1656783391721,MATH 18,B02,083749,Rideout; David Porter,3,0,36,33
1656783391721,MATH 18,B03,083750,Rideout; David Porter,1,0,37,36
1656783391721,MATH 18,B04,083751,Rideout; David Porter,5,0,36,31
1656783391721,MATH 18,B05,093473,Rideout; David Porter,4,0,36,32
1656783391721,MATH 18,B06,093474,Rideout; David Porter,5,0,36,31
1656783397743,MATH 20A,A01,083754,Zheng; Zequn,12,0,40,28
1656783403765,MATH 20B,A01,083756,Briones; Jor-el Thomas Caparas,1,0,36,35
1656783403765,MATH 20B,A02,083757,Briones; Jor-el Thomas Caparas,1,0,36,35
1656783403765,MATH 20B,A03,093475,Briones; Jor-el Thomas Caparas,0,0,36,36
1656783409793,MATH 20C,A01,083760,Briones; Jor-el Thomas Caparas,1,0,35,34
1656783409793,MATH 20C,A02,083761,Briones; Jor-el Thomas Caparas,8,0,35,27
1656783409793,MATH 20C,A03,093476,Briones; Jor-el Thomas Caparas,0,1,36,36
1656783409793,MATH 20C,B01,083762,Bach; Quang Tran,0,0,30,30
1656783415821,MATH 20D,A01,083765,Tran; Brian Kha,4,0,30,26
1656783415821,MATH 20D,A02,083766,Tran; Brian Kha,4,0,30,26
1656783415821,MATH 20D,A03,083767,Tran; Brian Kha,2,0,30,28
1656783421851,MATH 20E,A01,083771,Ganguly; Soumya,5,0,32,27
1656783421851,MATH 20E,A02,083772,Ganguly; Soumya,5,0,32,27
1656783421851,MATH 20E,B01,083773,Ciotti; Benjamin,18,0,35,17
1656783421851,MATH 20E,B02,083774,Ciotti; Benjamin,17,0,35,18
1656783427880,MATH 103A,A01,083777,Greenfeld; Be'Eri,2,0,36,34
1656783427880,MATH 103A,A02,083778,Greenfeld; Be'Eri,5,0,36,31
1656783427880,MATH 103A,A03,093561,Greenfeld; Be'Eri,4,0,36,32
1656783427880,MATH 103A,B01,083779,Greenfeld; Be'Eri,6,0,36,30
1656783427880,MATH 103A,B02,083780,Greenfeld; Be'Eri,2,0,36,34
1656783427880,MATH 103A,B03,093562,Greenfeld; Be'Eri,2,0,36,34
1656783433915,MATH 105,A01,085443,Carter; Anne Toulson,13,0,35,22
1656783433915,MATH 105,A02,093477,Carter; Anne Toulson,20,0,35,15
1656783439945,MATH 109,A01,083213,Ganzberger; Geoffrey Michael,2,0,34,32
1656783439945,MATH 109,A02,083214,Ganzberger; Geoffrey Michael,2,0,34,32
1656783439945,MATH 109,A03,093478,Ganzberger; Geoffrey Michael,1,0,34,33
1656783439945,MATH 109,B01,083215,Ganzberger; Geoffrey Michael,1,0,32,31
1656783439945,MATH 109,B02,083216,Ganzberger; Geoffrey Michael,1,0,32,31
1656783439945,MATH 109,B03,093479,Ganzberger; Geoffrey Michael,6,0,32,26
1656783445974,MATH 142A,A01,083219,Chow; Bennett,6,0,32,26
1656783445974,MATH 142A,A02,083220,Chow; Bennett,9,0,32,23
1656783445974,MATH 142A,A03,093480,Chow; Bennett,7,0,32,25
1656783445974,MATH 142A,B03,093481,Chow; Bennett,7,0,32,25
1656783445974,MATH 142A,B04,093558,Chow; Bennett,10,0,32,22
1656783445974,MATH 142A,B05,093559,Chow; Bennett,6,0,32,26
1656783451999,MATH 193A,A01,083224,Rotar; Vladimir,6,0,34,28
1656783451999,MATH 193A,A02,083225,Rotar; Vladimir,3,0,34,31
1656783451999,MATH 193A,A03,083781,Rotar; Vladimir,1,0,34,33
1656783451999,MATH 193A,A04,083782,Rotar; Vladimir,6,0,34,28
1656783451999,MATH 193A,A05,093482,Rotar; Vladimir,6,0,34,28
1656783458025,MATH 197,001,091859,McAuley; Julian John,9999,0,9999,0
1656783458025,MATH 197,002,095566,Kedlaya; Kiran S.,9997,0,9999,2
1656783458025,MATH 197,003,095567,Xiao; Ming,9999,0,9999,0
1656783458025,MATH 197,004,095571,Perols; Johan Lars,9998,0,9999,1
1656783465084,COGS 9,A01,083615,Shannon; Kyle Michael,6,0,75,69
1656783471105,COGS 11,A01,083617,Boyle; Mary E. T.,18,0,48,30
1656783477133,COGS 13,A01,083071,Bastos; Amalia Pinkusfeld,8,0,71,63
1656783483160,COGS 14A,A01,092681,Semenuks; Arturs,0,1,100,100
1656783489183,COGS 14B,A01,083073,Cheng; Tzu-Han,5,0,63,58
1656783495210,COGS 17,A01,092677,Semenuks; Arturs,4,0,81,77
1656783501232,COGS 100,A01,083619,Allen; Michael Gordon,15,0,70,55
1656783507255,COGS 101A,A01,083621,Davis; Joshua Daniel,9,0,68,59
1656783513278,COGS 101B,A01,091572,Allen; Michael Gordon,8,0,65,57
1656783519304,COGS 101C,A01,083625,Delgado; Tania,17,0,35,18
1656783525335,COGS 107A,A01,083627,Boyle; Mary E. T.,13,0,60,47
1656783531360,COGS 118A,A01,083075,Gupta; Anjum,15,0,76,61
1656783537385,CSE 3,A50,083646,Miranda; Gregory Joseph,22,0,50,28
1656783543409,CSE 8A,A50,083650,Miranda; Gregory Joseph,17,1,56,39
1656783549435,CSE 11,A01,083080,Cao; Yingjun,4,15,40,36
1656783555463,CSE 12,A01,083652,Krause-Levy; Sophia Louisa,20,1,120,100
1656783561490,CSE 15L,A01,083654,Morris; Justin Loren,8,0,50,42
1656783561490,CSE 15L,A02,083655,Morris; Justin Loren,8,0,50,42
1656783567517,CSE 20,A01,083657,Tran; Khoa Dang,37,0,80,43
1656783573545,CSE 21,A01,095574,Bach; Quang Tran,21,0,48,27
1656783579569,CSE 30,A01,083084,Eldon; John,4,0,80,76
1656783579569,CSE 30,B01,095061,Bhaskar; Nishant,5,0,50,45
1656783585596,CSE 100,A01,083659,Cao; Yingjun,1,4,70,69
1656783591621,CSE 134B,A01,083661,Powell; Thomas Allan,18,0,100,82
1656783597644,CSE 140,A01,083663,Gungor; Onat,14,0,85,71
1656783603672,CSE 140L,A01,083088,Eldon; John,16,0,100,84
1656783609697,CSE 175,A01,083665,Kumar; Rakesh,3,0,25,22
1656783615720,CSE 190,A00,092507,Dubnov; Shlomo,7,0,20,13
1656783621749,ECE 45,A01,083139,Congero; Spencer William,5,0,75,70
1656783627779,ECE 65,A50,083695,Saad; Andrew S,12,0,30,18
1656783627779,ECE 65,A51,095125,Saad; Andrew S,25,0,26,1
1656783633804,ECE 109,A01,091882,Touri; Behrouz,15,0,70,55
1656783639827,ECE 180,A00,083140,Abi Samra; Nicholas Camill,0,0,30,30
1656783639827,ECE 180,B00,083141,Abi Samra; Nicholas Camill,0,0,30,30
1656783645853,MATH 10A,A01,083735,Patchell; Gregory David,1,0,30,29
1656783645853,MATH 10A,A02,083736,Patchell; Gregory David,20,0,30,10
1656783645853,MATH 10A,A03,083737,Patchell; Gregory David,15,0,30,15
1656783651877,MATH 10B,A01,083207,Lim; Seonhee,7,0,34,27
1656783651877,MATH 10B,A02,083208,Lim; Seonhee,9,0,35,26
1656783651877,MATH 10B,A03,093472,Lim; Seonhee,4,0,34,30
1656783651877,MATH 10B,B01,083739,Sinha; Shubham,9,0,30,21
1656783657903,MATH 18,A01,083743,Cinel; Cameron Alexander,6,0,30,24
1656783657903,MATH 18,A02,083744,Cinel; Cameron Alexander,15,0,30,15
1656783657903,MATH 18,A03,083745,Cinel; Cameron Alexander,8,0,30,22
1656783657903,MATH 18,B01,083748,Rideout; David Porter,3,0,37,34
1656783657903,MATH 18,B02,083749,Rideout; David Porter,3,0,36,33
1656783657903,MATH 18,B03,083750,Rideout; David Porter,1,0,37,36
1656783657903,MATH 18,B04,083751,Rideout; David Porter,5,0,36,31
1656783657903,MATH 18,B05,093473,Rideout; David Porter,4,0,36,32
1656783657903,MATH 18,B06,093474,Rideout; David Porter,5,0,36,31
1656783663931,MATH 20A,A01,083754,Zheng; Zequn,12,0,40,28
1656783669955,MATH 20B,A01,083756,Briones; Jor-el Thomas Caparas,1,0,36,35
1656783669955,MATH 20B,A02,083757,Briones; Jor-el Thomas Caparas,1,0,36,35
1656783669955,MATH 20B,A03,093475,Briones; Jor-el Thomas Caparas,0,0,36,36
1656783675984,MATH 20C,A01,083760,Briones; Jor-el Thomas Caparas,1,0,35,34
1656783675984,MATH 20C,A02,083761,Briones; Jor-el Thomas Caparas,8,0,35,27
1656783675984,MATH 20C,A03,093476,Briones; Jor-el Thomas Caparas,0,1,36,36
1656783675984,MATH 20C,B01,083762,Bach; Quang Tran,0,0,30,30
1656783682009,MATH 20D,A01,083765,Tran; Brian Kha,4,0,30,26
1656783682009,MATH 20D,A02,083766,Tran; Brian Kha,4,0,30,26
1656783682009,MATH 20D,A03,083767,Tran; Brian Kha,2,0,30,28
1656783688033,MATH 20E,A01,083771,Ganguly; Soumya,5,0,32,27
1656783688033,MATH 20E,A02,083772,Ganguly; Soumya,5,0,32,27
1656783688033,MATH 20E,B01,083773,Ciotti; Benjamin,18,0,35,17
1656783688033,MATH 20E,B02,083774,Ciotti; Benjamin,17,0,35,18
1656783694062,MATH 103A,A01,083777,Greenfeld; Be'Eri,2,0,36,34
1656783694062,MATH 103A,A02,083778,Greenfeld; Be'Eri,5,0,36,31
1656783694062,MATH 103A,A03,093561,Greenfeld; Be'Eri,4,0,36,32
1656783694062,MATH 103A,B01,083779,Greenfeld; Be'Eri,6,0,36,30
1656783694062,MATH 103A,B02,083780,Greenfeld; Be'Eri,2,0,36,34
1656783694062,MATH 103A,B03,093562,Greenfeld; Be'Eri,2,0,36,34
1656783700086,MATH 105,A01,085443,Carter; Anne Toulson,13,0,35,22
1656783700086,MATH 105,A02,093477,Carter; Anne Toulson,20,0,35,15
1656783706114,MATH 109,A01,083213,Ganzberger; Geoffrey Michael,2,0,34,32
1656783706114,MATH 109,A02,083214,Ganzberger; Geoffrey Michael,2,0,34,32
1656783706114,MATH 109,A03,093478,Ganzberger; Geoffrey Michael,1,0,34,33
1656783706114,MATH 109,B01,083215,Ganzberger; Geoffrey Michael,1,0,32,31
1656783706114,MATH 109,B02,083216,Ganzberger; Geoffrey Michael,1,0,32,31
1656783706114,MATH 109,B03,093479,Ganzberger; Geoffrey Michael,6,0,32,26
1656783712138,MATH 142A,A01,083219,Chow; Bennett,6,0,32,26
1656783712138,MATH 142A,A02,083220,Chow; Bennett,9,0,32,23
1656783712138,MATH 142A,A03,093480,Chow; Bennett,7,0,32,25
1656783712138,MATH 142A,B03,093481,Chow; Bennett,7,0,32,25
1656783712138,MATH 142A,B04,093558,Chow; Bennett,10,0,32,22
1656783712138,MATH 142A,B05,093559,Chow; Bennett,6,0,32,26
1656783718168,MATH 193A,A01,083224,Rotar; Vladimir,6,0,34,28
1656783718168,MATH 193A,A02,083225,Rotar; Vladimir,3,0,34,31
1656783718168,MATH 193A,A03,083781,Rotar; Vladimir,1,0,34,33
1656783718168,MATH 193A,A04,083782,Rotar; Vladimir,6,0,34,28
1656783718168,MATH 193A,A05,093482,Rotar; Vladimir,6,0,34,28
1656783724191,MATH 197,001,091859,McAuley; Julian John,9999,0,9999,0
1656783724191,MATH 197,002,095566,Kedlaya; Kiran S.,9997,0,9999,2
1656783724191,MATH 197,003,095567,Xiao; Ming,9999,0,9999,0
1656783724191,MATH 197,004,095571,Perols; Johan Lars,9998,0,9999,1
1656783731244,COGS 9,A01,083615,Shannon; Kyle Michael,6,0,75,69
1656783737267,COGS 11,A01,083617,Boyle; Mary E. T.,18,0,48,30
1656783743291,COGS 13,A01,083071,Bastos; Amalia Pinkusfeld,8,0,71,63
1656783749315,COGS 14A,A01,092681,Semenuks; Arturs,0,1,100,100
1656783755343,COGS 14B,A01,083073,Cheng; Tzu-Han,5,0,63,58
1656783761368,COGS 17,A01,092677,Semenuks; Arturs,4,0,81,77
1656783767395,COGS 100,A01,083619,Allen; Michael Gordon,15,0,70,55
1656783773418,COGS 101A,A01,083621,Davis; Joshua Daniel,9,0,68,59
1656783779446,COGS 101B,A01,091572,Allen; Michael Gordon,8,0,65,57
1656783785561,COGS 101C,A01,083625,Delgado; Tania,17,0,35,18
1656783791587,COGS 107A,A01,083627,Boyle; Mary E. T.,13,0,60,47
1656783797610,COGS 118A,A01,083075,Gupta; Anjum,15,0,76,61
1656783803633,CSE 3,A50,083646,Miranda; Gregory Joseph,22,0,50,28
1656783809658,CSE 8A,A50,083650,Miranda; Gregory Joseph,17,1,56,39
1656783815681,CSE 11,A01,083080,Cao; Yingjun,4,15,40,36
1656783821705,CSE 12,A01,083652,Krause-Levy; Sophia Louisa,20,1,120,100
1656783827743,CSE 15L,A01,083654,Morris; Justin Loren,8,0,50,42
1656783827743,CSE 15L,A02,083655,Morris; Justin Loren,8,0,50,42
1656783833771,CSE 20,A01,083657,Tran; Khoa Dang,37,0,80,43
1656783839799,CSE 21,A01,095574,Bach; Quang Tran,21,0,48,27
1656783845827,CSE 30,A01,083084,Eldon; John,4,0,80,76
1656783845827,CSE 30,B01,095061,Bhaskar; Nishant,5,0,50,45
1656783851852,CSE 100,A01,083659,Cao; Yingjun,1,4,70,69
1656783857881,CSE 134B,A01,083661,Powell; Thomas Allan,18,0,100,82
1656783863906,CSE 140,A01,083663,Gungor; Onat,14,0,85,71
1656783869935,CSE 140L,A01,083088,Eldon; John,16,0,100,84
1656783875960,CSE 175,A01,083665,Kumar; Rakesh,3,0,25,22
1656783881988,CSE 190,A00,092507,Dubnov; Shlomo,7,0,20,13
1656783888010,ECE 45,A01,083139,Congero; Spencer William,5,0,75,70
1656783894035,ECE 65,A50,083695,Saad; Andrew S,12,0,30,18
1656783894035,ECE 65,A51,095125,Saad; Andrew S,25,0,26,1
1656783900058,ECE 109,A01,091882,Touri; Behrouz,15,0,70,55
1656783906082,ECE 180,A00,083140,Abi Samra; Nicholas Camill,0,0,30,30
1656783906082,ECE 180,B00,083141,Abi Samra; Nicholas Camill,0,0,30,30
1656783912109,MATH 10A,A01,083735,Patchell; Gregory David,1,0,30,29
1656783912109,MATH 10A,A02,083736,Patchell; Gregory David,20,0,30,10
1656783912109,MATH 10A,A03,083737,Patchell; Gregory David,15,0,30,15
1656783918133,MATH 10B,A01,083207,Lim; Seonhee,7,0,34,27
1656783918133,MATH 10B,A02,083208,Lim; Seonhee,9,0,35,26
1656783918133,MATH 10B,A03,093472,Lim; Seonhee,4,0,34,30
1656783918133,MATH 10B,B01,083739,Sinha; Shubham,9,0,30,21
1656783924160,MATH 18,A01,083743,Cinel; Cameron Alexander,6,0,30,24
1656783924160,MATH 18,A02,083744,Cinel; Cameron Alexander,15,0,30,15
1656783924160,MATH 18,A03,083745,Cinel; Cameron Alexander,8,0,30,22
1656783924160,MATH 18,B01,083748,Rideout; David Porter,3,0,37,34
1656783924160,MATH 18,B02,083749,Rideout; David Porter,3,0,36,33
1656783924160,MATH 18,B03,083750,Rideout; David Porter,1,0,37,36
1656783924160,MATH 18,B04,083751,Rideout; David Porter,5,0,36,31
1656783924160,MATH 18,B05,093473,Rideout; David Porter,4,0,36,32
1656783924160,MATH 18,B06,093474,Rideout; David Porter,5,0,36,31
1656783930183,MATH 20A,A01,083754,Zheng; Zequn,12,0,40,28
1656783936208,MATH 20B,A01,083756,Briones; Jor-el Thomas Caparas,1,0,36,35
1656783936208,MATH 20B,A02,083757,Briones; Jor-el Thomas Caparas,1,0,36,35
1656783936208,MATH 20B,A03,093475,Briones; Jor-el Thomas Caparas,0,0,36,36
1656783942237,MATH 20C,A01,083760,Briones; Jor-el Thomas Caparas,1,0,35,34
1656783942237,MATH 20C,A02,083761,Briones; Jor-el Thomas Caparas,8,0,35,27
1656783942237,MATH 20C,A03,093476,Briones; Jor-el Thomas Caparas,0,1,36,36
1656783942237,MATH 20C,B01,083762,Bach; Quang Tran,0,0,30,30
1656783948262,MATH 20D,A01,083765,Tran; Brian Kha,4,0,30,26
1656783948262,MATH 20D,A02,083766,Tran; Brian Kha,4,0,30,26
1656783948262,MATH 20D,A03,083767,Tran; Brian Kha,2,0,30,28
1656783954286,MATH 20E,A01,083771,Ganguly; Soumya,5,0,32,27
1656783954286,MATH 20E,A02,083772,Ganguly; Soumya,5,0,32,27
1656783954286,MATH 20E,B01,083773,Ciotti; Benjamin,18,0,35,17
1656783954286,MATH 20E,B02,083774,Ciotti; Benjamin,17,0,35,18
1656783960312,MATH 103A,A01,083777,Greenfeld; Be'Eri,2,0,36,34
1656783960312,MATH 103A,A02,083778,Greenfeld; Be'Eri,5,0,36,31
1656783960312,MATH 103A,A03,093561,Greenfeld; Be'Eri,4,0,36,32
1656783960312,MATH 103A,B01,083779,Greenfeld; Be'Eri,6,0,36,30
1656783960312,MATH 103A,B02,083780,Greenfeld; Be'Eri,2,0,36,34
1656783960312,MATH 103A,B03,093562,Greenfeld; Be'Eri,2,0,36,34
1656783966340,MATH 105,A01,085443,Carter; Anne Toulson,13,0,35,22
1656783966340,MATH 105,A02,093477,Carter; Anne Toulson,20,0,35,15
1656783972362,MATH 109,A01,083213,Ganzberger; Geoffrey Michael,2,0,34,32
1656783972362,MATH 109,A02,083214,Ganzberger; Geoffrey Michael,2,0,34,32
1656783972362,MATH 109,A03,093478,Ganzberger; Geoffrey Michael,1,0,34,33
1656783972362,MATH 109,B01,083215,Ganzberger; Geoffrey Michael,1,0,32,31
1656783972362,MATH 109,B02,083216,Ganzberger; Geoffrey Michael,1,0,32,31
1656783972362,MATH 109,B03,093479,Ganzberger; Geoffrey Michael,6,0,32,26
1656783978388,MATH 142A,A01,083219,Chow; Bennett,6,0,32,26
1656783978388,MATH 142A,A02,083220,Chow; Bennett,9,0,32,23
1656783978388,MATH 142A,A03,093480,Chow; Bennett,7,0,32,25
1656783978388,MATH 142A,B03,093481,Chow; Bennett,7,0,32,25
1656783978388,MATH 142A,B04,093558,Chow; Bennett,10,0,32,22
1656783978388,MATH 142A,B05,093559,Chow; Bennett,6,0,32,26
1656783984417,MATH 193A,A01,083224,Rotar; Vladimir,6,0,34,28
1656783984417,MATH 193A,A02,083225,Rotar; Vladimir,3,0,34,31
1656783984417,MATH 193A,A03,083781,Rotar; Vladimir,1,0,34,33
1656783984417,MATH 193A,A04,083782,Rotar; Vladimir,6,0,34,28
1656783984417,MATH 193A,A05,093482,Rotar; Vladimir,6,0,34,28
1656783990441,MATH 197,001,091859,McAuley; Julian John,9999,0,9999,0
1656783990441,MATH 197,002,095566,Kedlaya; Kiran S.,9997,0,9999,2
1656783990441,MATH 197,003,095567,Xiao; Ming,9999,0,9999,0
1656783990441,MATH 197,004,095571,Perols; Johan Lars,9998,0,9999,1
1656783997498,COGS 9,A01,083615,Shannon; Kyle Michael,6,0,75,69
1656784003519,COGS 11,A01,083617,Boyle; Mary E. T.,18,0,48,30
1656784009543,COGS 13,A01,083071,Bastos; Amalia Pinkusfeld,8,0,71,63
1656784015568,COGS 14A,A01,092681,Semenuks; Arturs,0,1,100,100
1656784021594,COGS 14B,A01,083073,Cheng; Tzu-Han,5,0,63,58
1656784027619,COGS 17,A01,092677,Semenuks; Arturs,4,0,81,77
1656784033648,COGS 100,A01,083619,Allen; Michael Gordon,15,0,70,55
1656784039674,COGS 101A,A01,083621,Davis; Joshua Daniel,9,0,68,59
1656784045697,COGS 101B,A01,091572,Allen; Michael Gordon,8,0,65,57
1656784051720,COGS 101C,A01,083625,Delgado; Tania,17,0,35,18
1656784057742,COGS 107A,A01,083627,Boyle; Mary E. T.,13,0,60,47
1656784063766,COGS 118A,A01,083075,Gupta; Anjum,15,0,76,61
1656784069789,CSE 3,A50,083646,Miranda; Gregory Joseph,22,0,50,28
1656784075814,CSE 8A,A50,083650,Miranda; Gregory Joseph,17,1,56,39
1656784081839,CSE 11,A01,083080,Cao; Yingjun,4,15,40,36
1656784087862,CSE 12,A01,083652,Krause-Levy; Sophia Louisa,20,1,120,100
1656784093884,CSE 15L,A01,083654,Morris; Justin Loren,8,0,50,42
1656784093884,CSE 15L,A02,083655,Morris; Justin Loren,8,0,50,42
1656784099909,CSE 20,A01,083657,Tran; Khoa Dang,37,0,80,43
1656784105931,CSE 21,A01,095574,Bach; Quang Tran,21,0,48,27
1656784111962,CSE 30,A01,083084,Eldon; John,4,0,80,76
1656784111962,CSE 30,B01,095061,Bhaskar; Nishant,5,0,50,45
1656784117988,CSE 100,A01,083659,Cao; Yingjun,1,4,70,69
1656784124016,CSE 134B,A01,083661,Powell; Thomas Allan,18,0,100,82
1656784130042,CSE 140,A01,083663,Gungor; Onat,14,0,85,71
1656784136067,CSE 140L,A01,083088,Eldon; John,16,0,100,84
1656784142090,CSE 175,A01,083665,Kumar; Rakesh,3,0,25,22
1656784148114,CSE 190,A00,092507,Dubnov; Shlomo,7,0,20,13
1656784154143,ECE 45,A01,083139,Congero; Spencer William,5,0,75,70
1656784160173,ECE 65,A50,083695,Saad; Andrew S,12,0,30,18
1656784160173,ECE 65,A51,095125,Saad; Andrew S,25,0,26,1
1656784166196,ECE 109,A01,091882,Touri; Behrouz,15,0,70,55
1656784172220,ECE 180,A00,083140,Abi Samra; Nicholas Camill,0,0,30,30
1656784172220,ECE 180,B00,083141,Abi Samra; Nicholas Camill,0,0,30,30
1656784178248,MATH 10A,A01,083735,Patchell; Gregory David,1,0,30,29
1656784178248,MATH 10A,A02,083736,Patchell; Gregory David,20,0,30,10
1656784178248,MATH 10A,A03,083737,Patchell; Gregory David,15,0,30,15
1656784184272,MATH 10B,A01,083207,Lim; Seonhee,7,0,34,27
1656784184272,MATH 10B,A02,083208,Lim; Seonhee,9,0,35,26
1656784184272,MATH 10B,A03,093472,Lim; Seonhee,4,0,34,30
1656784184272,MATH 10B,B01,083739,Sinha; Shubham,9,0,30,21
1656784190309,MATH 18,A01,083743,Cinel; Cameron Alexander,6,0,30,24
1656784190309,MATH 18,A02,083744,Cinel; Cameron Alexander,15,0,30,15
1656784190309,MATH 18,A03,083745,Cinel; Cameron Alexander,8,0,30,22
1656784190309,MATH 18,B01,083748,Rideout; David Porter,3,0,37,34
1656784190309,MATH 18,B02,083749,Rideout; David Porter,3,0,36,33
1656784190309,MATH 18,B03,083750,Rideout; David Porter,1,0,37,36
1656784190309,MATH 18,B04,083751,Rideout; David Porter,5,0,36,31
1656784190309,MATH 18,B05,093473,Rideout; David Porter,4,0,36,32
1656784190309,MATH 18,B06,093474,Rideout; David Porter,5,0,36,31
1656784196335,MATH 20A,A01,083754,Zheng; Zequn,12,0,40,28
1656784202360,MATH 20B,A01,083756,Briones; Jor-el Thomas Caparas,1,0,36,35
1656784202360,MATH 20B,A02,083757,Briones; Jor-el Thomas Caparas,1,0,36,35
1656784202360,MATH 20B,A03,093475,Briones; Jor-el Thomas Caparas,0,0,36,36
1656784208391,MATH 20C,A01,083760,Briones; Jor-el Thomas Caparas,1,0,35,34
1656784208391,MATH 20C,A02,083761,Briones; Jor-el Thomas Caparas,8,0,35,27
1656784208391,MATH 20C,A03,093476,Briones; Jor-el Thomas Caparas,0,1,36,36
1656784208391,MATH 20C,B01,083762,Bach; Quang Tran,0,0,30,30
1656784214420,MATH 20D,A01,083765,Tran; Brian Kha,4,0,30,26
1656784214420,MATH 20D,A02,083766,Tran; Brian Kha,4,0,30,26
1656784214420,MATH 20D,A03,083767,Tran; Brian Kha,2,0,30,28
1656784220449,MATH 20E,A01,083771,Ganguly; Soumya,5,0,32,27
1656784220449,MATH 20E,A02,083772,Ganguly; Soumya,5,0,32,27
1656784220449,MATH 20E,B01,083773,Ciotti; Benjamin,18,0,35,17
1656784220449,MATH 20E,B02,083774,Ciotti; Benjamin,17,0,35,18
1656784226472,MATH 103A,A01,083777,Greenfeld; Be'Eri,2,0,36,34
1656784226472,MATH 103A,A02,083778,Greenfeld; Be'Eri,5,0,36,31
1656784226472,MATH 103A,A03,093561,Greenfeld; Be'Eri,4,0,36,32
1656784226472,MATH 103A,B01,083779,Greenfeld; Be'Eri,6,0,36,30
1656784226472,MATH 103A,B02,083780,Greenfeld; Be'Eri,2,0,36,34
1656784226472,MATH 103A,B03,093562,Greenfeld; Be'Eri,2,0,36,34
1656784232497,MATH 105,A01,085443,Carter; Anne Toulson,13,0,35,22
1656784232497,MATH 105,A02,093477,Carter; Anne Toulson,20,0,35,15
1656784238522,MATH 109,A01,083213,Ganzberger; Geoffrey Michael,2,0,34,32
1656784238522,MATH 109,A02,083214,Ganzberger; Geoffrey Michael,2,0,34,32
1656784238522,MATH 109,A03,093478,Ganzberger; Geoffrey Michael,1,0,34,33
1656784238522,MATH 109,B01,083215,Ganzberger; Geoffrey Michael,1,0,32,31
1656784238522,MATH 109,B02,083216,Ganzberger; Geoffrey Michael,1,0,32,31
1656784238522,MATH 109,B03,093479,Ganzberger; Geoffrey Michael,6,0,32,26
1656784244546,MATH 142A,A01,083219,Chow; Bennett,6,0,32,26
1656784244546,MATH 142A,A02,083220,Chow; Bennett,9,0,32,23
1656784244546,MATH 142A,A03,093480,Chow; Bennett,7,0,32,25
1656784244546,MATH 142A,B03,093481,Chow; Bennett,7,0,32,25
1656784244546,MATH 142A,B04,093558,Chow; Bennett,10,0,32,22
1656784244546,MATH 142A,B05,093559,Chow; Bennett,6,0,32,26
1656784250570,MATH 193A,A01,083224,Rotar; Vladimir,6,0,34,28
1656784250570,MATH 193A,A02,083225,Rotar; Vladimir,3,0,34,31
1656784250570,MATH 193A,A03,083781,Rotar; Vladimir,1,0,34,33
1656784250570,MATH 193A,A04,083782,Rotar; Vladimir,6,0,34,28
1656784250570,MATH 193A,A05,093482,Rotar; Vladimir,6,0,34,28
1656784256597,MATH 197,001,091859,McAuley; Julian John,9999,0,9999,0
1656784256597,MATH 197,002,095566,Kedlaya; Kiran S.,9997,0,9999,2
1656784256597,MATH 197,003,095567,Xiao; Ming,9999,0,9999,0
1656784256597,MATH 197,004,095571,Perols; Johan Lars,9998,0,9999,1
1656784263662,COGS 9,A01,083615,Shannon; Kyle Michael,6,0,75,69
1656784269688,COGS 11,A01,083617,Boyle; Mary E. T.,18,0,48,30
1656784275713,COGS 13,A01,083071,Bastos; Amalia Pinkusfeld,8,0,71,63
1656784281738,COGS 14A,A01,092681,Semenuks; Arturs,0,1,100,100
1656784287760,COGS 14B,A01,083073,Cheng; Tzu-Han,5,0,63,58
1656784293786,COGS 17,A01,092677,Semenuks; Arturs,4,0,81,77
1656784299810,COGS 100,A01,083619,Allen; Michael Gordon,15,0,70,55
1656784305841,COGS 101A,A01,083621,Davis; Joshua Daniel,9,0,68,59
1656784311865,COGS 101B,A01,091572,Allen; Michael Gordon,8,0,65,57
1656784317889,COGS 101C,A01,083625,Delgado; Tania,17,0,35,18
1656784323924,COGS 107A,A01,083627,Boyle; Mary E. T.,13,0,60,47
1656784329952,COGS 118A,A01,083075,Gupta; Anjum,15,0,76,61
1656784335980,CSE 3,A50,083646,Miranda; Gregory Joseph,22,0,50,28
1656784342009,CSE 8A,A50,083650,Miranda; Gregory Joseph,17,1,56,39
1656784348032,CSE 11,A01,083080,Cao; Yingjun,4,15,40,36
1656784354060,CSE 12,A01,083652,Krause-Levy; Sophia Louisa,20,1,120,100
1656784360085,CSE 15L,A01,083654,Morris; Justin Loren,8,0,50,42
1656784360085,CSE 15L,A02,083655,Morris; Justin Loren,8,0,50,42
1656784366120,CSE 20,A01,083657,Tran; Khoa Dang,37,0,80,43
1656784372149,CSE 21,A01,095574,Bach; Quang Tran,21,0,48,27
1656784378181,CSE 30,A01,083084,Eldon; John,4,0,80,76
1656784378181,CSE 30,B01,095061,Bhaskar; Nishant,5,0,50,45
1656784384275,CSE 100,A01,083659,Cao; Yingjun,1,4,70,69
1656784390303,CSE 134B,A01,083661,Powell; Thomas Allan,18,0,100,82
1656784396343,CSE 140,A01,083663,Gungor; Onat,14,0,85,71
1656784402370,CSE 140L,A01,083088,Eldon; John,16,0,100,84
1656784408393,CSE 175,A01,083665,Kumar; Rakesh,3,0,25,22
1656784414416,CSE 190,A00,092507,Dubnov; Shlomo,7,0,20,13
1656784420439,ECE 45,A01,083139,Congero; Spencer William,5,0,75,70
1656784426463,ECE 65,A50,083695,Saad; Andrew S,12,0,30,18
1656784426463,ECE 65,A51,095125,Saad; Andrew S,25,0,26,1
1656784432492,ECE 109,A01,091882,Touri; Behrouz,15,0,70,55
1656784438518,ECE 180,A00,083140,Abi Samra; Nicholas Camill,0,0,30,30
1656784438518,ECE 180,B00,083141,Abi Samra; Nicholas Camill,0,0,30,30
1656784444543,MATH 10A,A01,083735,Patchell; Gregory David,1,0,30,29
1656784444543,MATH 10A,A02,083736,Patchell; Gregory David,20,0,30,10
1656784444543,MATH 10A,A03,083737,Patchell; Gregory David,15,0,30,15
1656784450578,MATH 10B,A01,083207,Lim; Seonhee,7,0,34,27
1656784450578,MATH 10B,A02,083208,Lim; Seonhee,9,0,35,26
1656784450578,MATH 10B,A03,093472,Lim; Seonhee,4,0,34,30
1656784450578,MATH 10B,B01,083739,Sinha; Shubham,9,0,30,21
1656784456609,MATH 18,A01,083743,Cinel; Cameron Alexander,6,0,30,24
1656784456609,MATH 18,A02,083744,Cinel; Cameron Alexander,15,0,30,15
1656784456609,MATH 18,A03,083745,Cinel; Cameron Alexander,8,0,30,22
1656784456609,MATH 18,B01,083748,Rideout; David Porter,3,0,37,34
1656784456609,MATH 18,B02,083749,Rideout; David Porter,3,0,36,33
1656784456609,MATH 18,B03,083750,Rideout; David Porter,1,0,37,36
1656784456609,MATH 18,B04,083751,Rideout; David Porter,5,0,36,31
1656784456609,MATH 18,B05,093473,Rideout; David Porter,4,0,36,32
1656784456609,MATH 18,B06,093474,Rideout; David Porter,5,0,36,31
1656784462633,MATH 20A,A01,083754,Zheng; Zequn,12,0,40,28
1656784468698,MATH 20B,A01,083756,Briones; Jor-el Thomas Caparas,1,0,36,35
1656784468698,MATH 20B,A02,083757,Briones; Jor-el Thomas Caparas,1,0,36,35
1656784468698,MATH 20B,A03,093475,Briones; Jor-el Thomas Caparas,0,0,36,36
1656784474722,MATH 20C,A01,083760,Briones; Jor-el Thomas Caparas,1,0,35,34
1656784474722,MATH 20C,A02,083761,Briones; Jor-el Thomas Caparas,8,0,35,27
1656784474722,MATH 20C,A03,093476,Briones; Jor-el Thomas Caparas,0,1,36,36
1656784474722,MATH 20C,B01,083762,Bach; Quang Tran,0,0,30,30
1656784480751,MATH 20D,A01,083765,Tran; Brian Kha,4,0,30,26
1656784480751,MATH 20D,A02,083766,Tran; Brian Kha,4,0,30,26
1656784480751,MATH 20D,A03,083767,Tran; Brian Kha,2,0,30,28
1656784486774,MATH 20E,A01,083771,Ganguly; Soumya,5,0,32,27
1656784486774,MATH 20E,A02,083772,Ganguly; Soumya,5,0,32,27
1656784486774,MATH 20E,B01,083773,Ciotti; Benjamin,18,0,35,17
1656784486774,MATH 20E,B02,083774,Ciotti; Benjamin,17,0,35,18
1656784492814,MATH 103A,A01,083777,Greenfeld; Be'Eri,2,0,36,34
1656784492814,MATH 103A,A02,083778,Greenfeld; Be'Eri,5,0,36,31
1656784492814,MATH 103A,A03,093561,Greenfeld; Be'Eri,4,0,36,32
1656784492814,MATH 103A,B01,083779,Greenfeld; Be'Eri,6,0,36,30
1656784492814,MATH 103A,B02,083780,Greenfeld; Be'Eri,2,0,36,34
1656784492814,MATH 103A,B03,093562,Greenfeld; Be'Eri,2,0,36,34
1656784498842,MATH 105,A01,085443,Carter; Anne Toulson,13,0,35,22
1656784498842,MATH 105,A02,093477,Carter; Anne Toulson,20,0,35,15
1656784504864,MATH 109,A01,083213,Ganzberger; Geoffrey Michael,2,0,34,32
1656784504864,MATH 109,A02,083214,Ganzberger; Geoffrey Michael,2,0,34,32
1656784504864,MATH 109,A03,093478,Ganzberger; Geoffrey Michael,1,0,34,33
1656784504864,MATH 109,B01,083215,Ganzberger; Geoffrey Michael,1,0,32,31
1656784504864,MATH 109,B02,083216,Ganzberger; Geoffrey Michael,1,0,32,31
1656784504864,MATH 109,B03,093479,Ganzberger; Geoffrey Michael,6,0,32,26
1656784510893,MATH 142A,A01,083219,Chow; Bennett,6,0,32,26
1656784510893,MATH 142A,A02,083220,Chow; Bennett,9,0,32,23
1656784510893,MATH 142A,A03,093480,Chow; Bennett,7,0,32,25
1656784510893,MATH 142A,B03,093481,Chow; Bennett,7,0,32,25
1656784510893,MATH 142A,B04,093558,Chow; Bennett,10,0,32,22
1656784510893,MATH 142A,B05,093559,Chow; Bennett,6,0,32,26
1656784516932,MATH 193A,A01,083224,Rotar; Vladimir,6,0,34,28
1656784516932,MATH 193A,A02,083225,Rotar; Vladimir,3,0,34,31
1656784516932,MATH 193A,A03,083781,Rotar; Vladimir,1,0,34,33
1656784516932,MATH 193A,A04,083782,Rotar; Vladimir,6,0,34,28
1656784516932,MATH 193A,A05,093482,Rotar; Vladimir,6,0,34,28
1656784522961,MATH 197,001,091859,McAuley; Julian John,9999,0,9999,0
1656784522961,MATH 197,002,095566,Kedlaya; Kiran S.,9997,0,9999,2
1656784522961,MATH 197,003,095567,Xiao; Ming,9999,0,9999,0
1656784522961,MATH 197,004,095571,Perols; Johan Lars,9998,0,9999,1
1656784530031,COGS 9,A01,083615,Shannon; Kyle Michael,6,0,75,69
1656784536058,COGS 11,A01,083617,Boyle; Mary E. T.,18,0,48,30
1656784542082,COGS 13,A01,083071,Bastos; Amalia Pinkusfeld,8,0,71,63
1656784548125,COGS 14A,A01,092681,Semenuks; Arturs,0,1,100,100
1656784554152,COGS 14B,A01,083073,Cheng; Tzu-Han,5,0,63,58
1656784560179,COGS 17,A01,092677,Semenuks; Arturs,4,0,81,77
1656784566204,COGS 100,A01,083619,Allen; Michael Gordon,15,0,70,55
1656784572228,COGS 101A,A01,083621,Davis; Joshua Daniel,9,0,68,59
1656784578255,COGS 101B,A01,091572,Allen; Michael Gordon,8,0,65,57
1656784584284,COGS 101C,A01,083625,Delgado; Tania,17,0,35,18
1656784590307,COGS 107A,A01,083627,Boyle; Mary E. T.,13,0,60,47
1656784596331,COGS 118A,A01,083075,Gupta; Anjum,15,0,76,61
1656784602359,CSE 3,A50,083646,Miranda; Gregory Joseph,22,0,50,28
1656784608386,CSE 8A,A50,083650,Miranda; Gregory Joseph,17,1,56,39
1656784614413,CSE 11,A01,083080,Cao; Yingjun,4,15,40,36
1656784620440,CSE 12,A01,083652,Krause-Levy; Sophia Louisa,20,1,120,100
1656784626465,CSE 15L,A01,083654,Morris; Justin Loren,8,0,50,42
1656784626465,CSE 15L,A02,083655,Morris; Justin Loren,8,0,50,42
1656784632488,CSE 20,A01,083657,Tran; Khoa Dang,37,0,80,43
1656784638513,CSE 21,A01,095574,Bach; Quang Tran,21,0,48,27
1656784644535,CSE 30,A01,083084,Eldon; John,4,0,80,76
1656784644535,CSE 30,B01,095061,Bhaskar; Nishant,5,0,50,45
1656784650562,CSE 100,A01,083659,Cao; Yingjun,1,4,70,69
1656784656585,CSE 134B,A01,083661,Powell; Thomas Allan,18,0,100,82
1656784662611,CSE 140,A01,083663,Gungor; Onat,14,0,85,71
1656784668635,CSE 140L,A01,083088,Eldon; John,16,0,100,84
1656784674659,CSE 175,A01,083665,Kumar; Rakesh,3,0,25,22
1656784680683,CSE 190,A00,092507,Dubnov; Shlomo,7,0,20,13
1656784686706,ECE 45,A01,083139,Congero; Spencer William,5,0,75,70
1656784692730,ECE 65,A50,083695,Saad; Andrew S,12,0,30,18
1656784692730,ECE 65,A51,095125,Saad; Andrew S,25,0,26,1
1656784698757,ECE 109,A01,091882,Touri; Behrouz,15,0,70,55
1656784704785,ECE 180,A00,083140,Abi Samra; Nicholas Camill,0,0,30,30
1656784704785,ECE 180,B00,083141,Abi Samra; Nicholas Camill,0,0,30,30
1656784710809,MATH 10A,A01,083735,Patchell; Gregory David,1,0,30,29
1656784710809,MATH 10A,A02,083736,Patchell; Gregory David,20,0,30,10
1656784710809,MATH 10A,A03,083737,Patchell; Gregory David,15,0,30,15
1656784716837,MATH 10B,A01,083207,Lim; Seonhee,7,0,34,27
1656784716837,MATH 10B,A02,083208,Lim; Seonhee,9,0,35,26
1656784716837,MATH 10B,A03,093472,Lim; Seonhee,4,0,34,30
1656784716837,MATH 10B,B01,083739,Sinha; Shubham,9,0,30,21
1656784722861,MATH 18,A01,083743,Cinel; Cameron Alexander,6,0,30,24
1656784722861,MATH 18,A02,083744,Cinel; Cameron Alexander,15,0,30,15
1656784722861,MATH 18,A03,083745,Cinel; Cameron Alexander,8,0,30,22
1656784722861,MATH 18,B01,083748,Rideout; David Porter,3,0,37,34
1656784722861,MATH 18,B02,083749,Rideout; David Porter,3,0,36,33
1656784722861,MATH 18,B03,083750,Rideout; David Porter,1,0,37,36
1656784722861,MATH 18,B04,083751,Rideout; David Porter,5,0,36,31
1656784722861,MATH 18,B05,093473,Rideout; David Porter,4,0,36,32
1656784722861,MATH 18,B06,093474,Rideout; David Porter,5,0,36,31
1656784728885,MATH 20A,A01,083754,Zheng; Zequn,12,0,40,28
1656784734919,MATH 20B,A01,083756,Briones; Jor-el Thomas Caparas,1,0,36,35
1656784734919,MATH 20B,A02,083757,Briones; Jor-el Thomas Caparas,1,0,36,35
1656784734919,MATH 20B,A03,093475,Briones; Jor-el Thomas Caparas,0,0,36,36
1656784740948,MATH 20C,A01,083760,Briones; Jor-el Thomas Caparas,1,0,35,34
1656784740948,MATH 20C,A02,083761,Briones; Jor-el Thomas Caparas,8,0,35,27
1656784740948,MATH 20C,A03,093476,Briones; Jor-el Thomas Caparas,0,1,36,36
1656784740948,MATH 20C,B01,083762,Bach; Quang Tran,0,0,30,30
1656784746971,MATH 20D,A01,083765,Tran; Brian Kha,4,0,30,26
1656784746971,MATH 20D,A02,083766,Tran; Brian Kha,4,0,30,26
1656784746971,MATH 20D,A03,083767,Tran; Brian Kha,2,0,30,28
1656784752996,MATH 20E,A01,083771,Ganguly; Soumya,5,0,32,27
1656784752996,MATH 20E,A02,083772,Ganguly; Soumya,5,0,32,27
1656784752996,MATH 20E,B01,083773,Ciotti; Benjamin,18,0,35,17
1656784752996,MATH 20E,B02,083774,Ciotti; Benjamin,17,0,35,18
1656784759020,MATH 103A,A01,083777,Greenfeld; Be'Eri,2,0,36,34
1656784759020,MATH 103A,A02,083778,Greenfeld; Be'Eri,5,0,36,31
1656784759020,MATH 103A,A03,093561,Greenfeld; Be'Eri,4,0,36,32
1656784759020,MATH 103A,B01,083779,Greenfeld; Be'Eri,6,0,36,30
1656784759020,MATH 103A,B02,083780,Greenfeld; Be'Eri,2,0,36,34
1656784759020,MATH 103A,B03,093562,Greenfeld; Be'Eri,2,0,36,34
1656784765043,MATH 105,A01,085443,Carter; Anne Toulson,13,0,35,22
1656784765043,MATH 105,A02,093477,Carter; Anne Toulson,20,0,35,15
1656784771065,MATH 109,A01,083213,Ganzberger; Geoffrey Michael,2,0,34,32
1656784771065,MATH 109,A02,083214,Ganzberger; Geoffrey Michael,2,0,34,32
1656784771065,MATH 109,A03,093478,Ganzberger; Geoffrey Michael,1,0,34,33
1656784771065,MATH 109,B01,083215,Ganzberger; Geoffrey Michael,1,0,32,31
1656784771065,MATH 109,B02,083216,Ganzberger; Geoffrey Michael,1,0,32,31
1656784771065,MATH 109,B03,093479,Ganzberger; Geoffrey Michael,6,0,32,26
1656784777088,MATH 142A,A01,083219,Chow; Bennett,6,0,32,26
1656784777088,MATH 142A,A02,083220,Chow; Bennett,9,0,32,23
1656784777088,MATH 142A,A03,093480,Chow; Bennett,7,0,32,25
1656784777088,MATH 142A,B03,093481,Chow; Bennett,7,0,32,25
1656784777088,MATH 142A,B04,093558,Chow; Bennett,10,0,32,22
1656784777088,MATH 142A,B05,093559,Chow; Bennett,6,0,32,26
1656784783119,MATH 193A,A01,083224,Rotar; Vladimir,6,0,34,28
1656784783119,MATH 193A,A02,083225,Rotar; Vladimir,3,0,34,31
1656784783119,MATH 193A,A03,083781,Rotar; Vladimir,1,0,34,33
1656784783119,MATH 193A,A04,083782,Rotar; Vladimir,6,0,34,28
1656784783119,MATH 193A,A05,093482,Rotar; Vladimir,6,0,34,28
1656784789145,MATH 197,001,091859,McAuley; Julian John,9999,0,9999,0
1656784789145,MATH 197,002,095566,Kedlaya; Kiran S.,9997,0,9999,2
1656784789145,MATH 197,003,095567,Xiao; Ming,9999,0,9999,0
1656784789145,MATH 197,004,095571,Perols; Johan Lars,9998,0,9999,1
1656784796209,COGS 9,A01,083615,Shannon; Kyle Michael,6,0,75,69
1656784802238,COGS 11,A01,083617,Boyle; Mary E. T.,18,0,48,30
1656784808261,COGS 13,A01,083071,Bastos; Amalia Pinkusfeld,8,0,71,63
1656784814283,COGS 14A,A01,092681,Semenuks; Arturs,0,1,100,100
1656784820320,COGS 14B,A01,083073,Cheng; Tzu-Han,5,0,63,58
1656784826348,COGS 17,A01,092677,Semenuks; Arturs,4,0,81,77
1656784832376,COGS 100,A01,083619,Allen; Michael Gordon,15,0,70,55
1656784838400,COGS 101A,A01,083621,Davis; Joshua Daniel,9,0,68,59
1656784844423,COGS 101B,A01,091572,Allen; Michael Gordon,8,0,65,57
1656784850458,COGS 101C,A01,083625,Delgado; Tania,17,0,35,18
1656784856480,COGS 107A,A01,083627,Boyle; Mary E. T.,13,0,60,47
1656784862505,COGS 118A,A01,083075,Gupta; Anjum,15,0,76,61
1656784868535,CSE 3,A50,083646,Miranda; Gregory Joseph,22,0,50,28
1656784874572,CSE 8A,A50,083650,Miranda; Gregory Joseph,17,1,56,39
1656784880601,CSE 11,A01,083080,Cao; Yingjun,4,15,40,36
1656784886631,CSE 12,A01,083652,Krause-Levy; Sophia Louisa,20,1,120,100
1656784892655,CSE 15L,A01,083654,Morris; Justin Loren,8,0,50,42
1656784892655,CSE 15L,A02,083655,Morris; Justin Loren,8,0,50,42
1656784898684,CSE 20,A01,083657,Tran; Khoa Dang,37,0,80,43
1656784904708,CSE 21,A01,095574,Bach; Quang Tran,21,0,48,27
1656784910735,CSE 30,A01,083084,Eldon; John,4,0,80,76
1656784910735,CSE 30,B01,095061,Bhaskar; Nishant,5,0,50,45
1656784916759,CSE 100,A01,083659,Cao; Yingjun,1,4,70,69
1656784922786,CSE 134B,A01,083661,Powell; Thomas Allan,18,0,100,82
1656784928810,CSE 140,A01,083663,Gungor; Onat,14,0,85,71
1656784934832,CSE 140L,A01,083088,Eldon; John,16,0,100,84
1656784940856,CSE 175,A01,083665,Kumar; Rakesh,3,0,25,22
1656784946879,CSE 190,A00,092507,Dubnov; Shlomo,7,0,20,13
1656784952903,ECE 45,A01,083139,Congero; Spencer William,5,0,75,70
1656784958927,ECE 65,A50,083695,Saad; Andrew S,12,0,30,18
1656784958927,ECE 65,A51,095125,Saad; Andrew S,25,0,26,1
1656784964951,ECE 109,A01,091882,Touri; Behrouz,15,0,70,55
1656784970977,ECE 180,A00,083140,Abi Samra; Nicholas Camill,0,0,30,30
1656784970977,ECE 180,B00,083141,Abi Samra; Nicholas Camill,0,0,30,30
1656784977008,MATH 10A,A01,083735,Patchell; Gregory David,1,0,30,29
1656784977008,MATH 10A,A02,083736,Patchell; Gregory David,20,0,30,10
1656784977008,MATH 10A,A03,083737,Patchell; Gregory David,15,0,30,15
1656784983147,MATH 10B,A01,083207,Lim; Seonhee,7,0,34,27
1656784983147,MATH 10B,A02,083208,Lim; Seonhee,9,0,35,26
1656784983147,MATH 10B,A03,093472,Lim; Seonhee,4,0,34,30
1656784983147,MATH 10B,B01,083739,Sinha; Shubham,9,0,30,21
1656784989171,MATH 18,A01,083743,Cinel; Cameron Alexander,6,0,30,24
1656784989171,MATH 18,A02,083744,Cinel; Cameron Alexander,15,0,30,15
1656784989171,MATH 18,A03,083745,Cinel; Cameron Alexander,8,0,30,22
1656784989171,MATH 18,B01,083748,Rideout; David Porter,3,0,37,34
1656784989171,MATH 18,B02,083749,Rideout; David Porter,3,0,36,33
1656784989171,MATH 18,B03,083750,Rideout; David Porter,1,0,37,36
1656784989171,MATH 18,B04,083751,Rideout; David Porter,5,0,36,31
1656784989171,MATH 18,B05,093473,Rideout; David Porter,4,0,36,32
1656784989171,MATH 18,B06,093474,Rideout; David Porter,5,0,36,31
1656784995195,MATH 20A,A01,083754,Zheng; Zequn,12,0,40,28
1656785001218,MATH 20B,A01,083756,Briones; Jor-el Thomas Caparas,1,0,36,35
1656785001218,MATH 20B,A02,083757,Briones; Jor-el Thomas Caparas,1,0,36,35
1656785001218,MATH 20B,A03,093475,Briones; Jor-el Thomas Caparas,0,0,36,36
1656785007248,MATH 20C,A01,083760,Briones; Jor-el Thomas Caparas,1,0,35,34
1656785007248,MATH 20C,A02,083761,Briones; Jor-el Thomas Caparas,8,0,35,27
1656785007248,MATH 20C,A03,093476,Briones; Jor-el Thomas Caparas,0,1,36,36
1656785007248,MATH 20C,B01,083762,Bach; Quang Tran,0,0,30,30
1656785013274,MATH 20D,A01,083765,Tran; Brian Kha,4,0,30,26
1656785013274,MATH 20D,A02,083766,Tran; Brian Kha,4,0,30,26
1656785013274,MATH 20D,A03,083767,Tran; Brian Kha,2,0,30,28
1656785019300,MATH 20E,A01,083771,Ganguly; Soumya,5,0,32,27
1656785019300,MATH 20E,A02,083772,Ganguly; Soumya,5,0,32,27
1656785019300,MATH 20E,B01,083773,Ciotti; Benjamin,18,0,35,17
1656785019300,MATH 20E,B02,083774,Ciotti; Benjamin,17,0,35,18
1656785025330,MATH 103A,A01,083777,Greenfeld; Be'Eri,2,0,36,34
1656785025330,MATH 103A,A02,083778,Greenfeld; Be'Eri,5,0,36,31
1656785025330,MATH 103A,A03,093561,Greenfeld; Be'Eri,4,0,36,32
1656785025330,MATH 103A,B01,083779,Greenfeld; Be'Eri,6,0,36,30
1656785025330,MATH 103A,B02,083780,Greenfeld; Be'Eri,2,0,36,34
1656785025330,MATH 103A,B03,093562,Greenfeld; Be'Eri,2,0,36,34
1656785031360,MATH 105,A01,085443,Carter; Anne Toulson,13,0,35,22
1656785031360,MATH 105,A02,093477,Carter; Anne Toulson,20,0,35,15
1656785037385,MATH 109,A01,083213,Ganzberger; Geoffrey Michael,2,0,34,32
1656785037385,MATH 109,A02,083214,Ganzberger; Geoffrey Michael,2,0,34,32
1656785037385,MATH 109,A03,093478,Ganzberger; Geoffrey Michael,1,0,34,33
1656785037385,MATH 109,B01,083215,Ganzberger; Geoffrey Michael,1,0,32,31
1656785037385,MATH 109,B02,083216,Ganzberger; Geoffrey Michael,1,0,32,31
1656785037385,MATH 109,B03,093479,Ganzberger; Geoffrey Michael,6,0,32,26
1656785043413,MATH 142A,A01,083219,Chow; Bennett,6,0,32,26
1656785043413,MATH 142A,A02,083220,Chow; Bennett,9,0,32,23
1656785043413,MATH 142A,A03,093480,Chow; Bennett,7,0,32,25
1656785043413,MATH 142A,B03,093481,Chow; Bennett,7,0,32,25
1656785043413,MATH 142A,B04,093558,Chow; Bennett,10,0,32,22
1656785043413,MATH 142A,B05,093559,Chow; Bennett,6,0,32,26
1656785049450,MATH 193A,A01,083224,Rotar; Vladimir,6,0,34,28
1656785049450,MATH 193A,A02,083225,Rotar; Vladimir,3,0,34,31
1656785049450,MATH 193A,A03,083781,Rotar; Vladimir,1,0,34,33
1656785049450,MATH 193A,A04,083782,Rotar; Vladimir,6,0,34,28
1656785049450,MATH 193A,A05,093482,Rotar; Vladimir,6,0,34,28
1656785055479,MATH 197,001,091859,McAuley; Julian John,9999,0,9999,0
1656785055479,MATH 197,002,095566,Kedlaya; Kiran S.,9997,0,9999,2
1656785055479,MATH 197,003,095567,Xiao; Ming,9999,0,9999,0
1656785055479,MATH 197,004,095571,Perols; Johan Lars,9998,0,9999,1
1656785062533,COGS 9,A01,083615,Shannon; Kyle Michael,6,0,75,69
1656785068561,COGS 11,A01,083617,Boyle; Mary E. T.,18,0,48,30
1656785074589,COGS 13,A01,083071,Bastos; Amalia Pinkusfeld,8,0,71,63
1656785080611,COGS 14A,A01,092681,Semenuks; Arturs,0,1,100,100
1656785086637,COGS 14B,A01,083073,Cheng; Tzu-Han,5,0,63,58
1656785092658,COGS 17,A01,092677,Semenuks; Arturs,4,0,81,77
1656785098685,COGS 100,A01,083619,Allen; Michael Gordon,15,0,70,55
1656785104714,COGS 101A,A01,083621,Davis; Joshua Daniel,9,0,68,59
1656785110740,COGS 101B,A01,091572,Allen; Michael Gordon,8,0,65,57
1656785116762,COGS 101C,A01,083625,Delgado; Tania,17,0,35,18
1656785122786,COGS 107A,A01,083627,Boyle; Mary E. T.,13,0,60,47
1656785128809,COGS 118A,A01,083075,Gupta; Anjum,15,0,76,61
1656785134833,CSE 3,A50,083646,Miranda; Gregory Joseph,22,0,50,28
1656785140863,CSE 8A,A50,083650,Miranda; Gregory Joseph,17,1,56,39
1656785146889,CSE 11,A01,083080,Cao; Yingjun,4,15,40,36
1656785152914,CSE 12,A01,083652,Krause-Levy; Sophia Louisa,20,1,120,100
1656785158940,CSE 15L,A01,083654,Morris; Justin Loren,8,0,50,42
1656785158940,CSE 15L,A02,083655,Morris; Justin Loren,8,0,50,42
1656785164967,CSE 20,A01,083657,Tran; Khoa Dang,37,0,80,43
1656785170992,CSE 21,A01,095574,Bach; Quang Tran,21,0,48,27
1656785177021,CSE 30,A01,083084,Eldon; John,4,0,80,76
1656785177021,CSE 30,B01,095061,Bhaskar; Nishant,5,0,50,45
1656785183047,CSE 100,A01,083659,Cao; Yingjun,1,4,70,69
1656785189074,CSE 134B,A01,083661,Powell; Thomas Allan,18,0,100,82
1656785195098,CSE 140,A01,083663,Gungor; Onat,14,0,85,71
1656785201123,CSE 140L,A01,083088,Eldon; John,16,0,100,84
1656785207151,CSE 175,A01,083665,Kumar; Rakesh,3,0,25,22
1656785213177,CSE 190,A00,092507,Dubnov; Shlomo,7,0,20,13
1656785219209,ECE 45,A01,083139,Congero; Spencer William,5,0,75,70
1656785225234,ECE 65,A50,083695,Saad; Andrew S,12,0,30,18
1656785225234,ECE 65,A51,095125,Saad; Andrew S,25,0,26,1
1656785231258,ECE 109,A01,091882,Touri; Behrouz,15,0,70,55
1656785237288,ECE 180,A00,083140,Abi Samra; Nicholas Camill,0,0,30,30
1656785237288,ECE 180,B00,083141,Abi Samra; Nicholas Camill,0,0,30,30
1656785243318,MATH 10A,A01,083735,Patchell; Gregory David,1,0,30,29
1656785243318,MATH 10A,A02,083736,Patchell; Gregory David,20,0,30,10
1656785243318,MATH 10A,A03,083737,Patchell; Gregory David,15,0,30,15
1656785249351,MATH 10B,A01,083207,Lim; Seonhee,7,0,34,27
1656785249351,MATH 10B,A02,083208,Lim; Seonhee,9,0,35,26
1656785249351,MATH 10B,A03,093472,Lim; Seonhee,4,0,34,30
1656785249351,MATH 10B,B01,083739,Sinha; Shubham,9,0,30,21
1656785255388,MATH 18,A01,083743,Cinel; Cameron Alexander,6,0,30,24
1656785255388,MATH 18,A02,083744,Cinel; Cameron Alexander,15,0,30,15
1656785255388,MATH 18,A03,083745,Cinel; Cameron Alexander,8,0,30,22
1656785255388,MATH 18,B01,083748,Rideout; David Porter,3,0,37,34
1656785255388,MATH 18,B02,083749,Rideout; David Porter,3,0,36,33
1656785255388,MATH 18,B03,083750,Rideout; David Porter,1,0,37,36
1656785255388,MATH 18,B04,083751,Rideout; David Porter,5,0,36,31
1656785255388,MATH 18,B05,093473,Rideout; David Porter,4,0,36,32
1656785255388,MATH 18,B06,093474,Rideout; David Porter,5,0,36,31
1656785261411,MATH 20A,A01,083754,Zheng; Zequn,12,0,40,28
1656785267436,MATH 20B,A01,083756,Briones; Jor-el Thomas Caparas,1,0,36,35
1656785267436,MATH 20B,A02,083757,Briones; Jor-el Thomas Caparas,1,0,36,35
1656785267436,MATH 20B,A03,093475,Briones; Jor-el Thomas Caparas,0,0,36,36
1656785273460,MATH 20C,A01,083760,Briones; Jor-el Thomas Caparas,1,0,35,34
1656785273460,MATH 20C,A02,083761,Briones; Jor-el Thomas Caparas,8,0,35,27
1656785273460,MATH 20C,A03,093476,Briones; Jor-el Thomas Caparas,0,1,36,36
1656785273460,MATH 20C,B01,083762,Bach; Quang Tran,0,0,30,30
1656785279492,MATH 20D,A01,083765,Tran; Brian Kha,4,0,30,26
1656785279492,MATH 20D,A02,083766,Tran; Brian Kha,4,0,30,26
1656785279492,MATH 20D,A03,083767,Tran; Brian Kha,2,0,30,28
1656785285519,MATH 20E,A01,083771,Ganguly; Soumya,5,0,32,27
1656785285519,MATH 20E,A02,083772,Ganguly; Soumya,5,0,32,27
1656785285519,MATH 20E,B01,083773,Ciotti; Benjamin,18,0,35,17
1656785285519,MATH 20E,B02,083774,Ciotti; Benjamin,17,0,35,18
1656785291550,MATH 103A,A01,083777,Greenfeld; Be'Eri,2,0,36,34
1656785291550,MATH 103A,A02,083778,Greenfeld; Be'Eri,5,0,36,31
1656785291550,MATH 103A,A03,093561,Greenfeld; Be'Eri,4,0,36,32
1656785291550,MATH 103A,B01,083779,Greenfeld; Be'Eri,6,0,36,30
1656785291550,MATH 103A,B02,083780,Greenfeld; Be'Eri,2,0,36,34
1656785291550,MATH 103A,B03,093562,Greenfeld; Be'Eri,2,0,36,34
1656785297579,MATH 105,A01,085443,Carter; Anne Toulson,13,0,35,22
1656785297579,MATH 105,A02,093477,Carter; Anne Toulson,20,0,35,15
1656785303606,MATH 109,A01,083213,Ganzberger; Geoffrey Michael,2,0,34,32
1656785303606,MATH 109,A02,083214,Ganzberger; Geoffrey Michael,2,0,34,32
1656785303606,MATH 109,A03,093478,Ganzberger; Geoffrey Michael,1,0,34,33
1656785303606,MATH 109,B01,083215,Ganzberger; Geoffrey Michael,1,0,32,31
1656785303606,MATH 109,B02,083216,Ganzberger; Geoffrey Michael,1,0,32,31
1656785303606,MATH 109,B03,093479,Ganzberger; Geoffrey Michael,6,0,32,26
1656785309632,MATH 142A,A01,083219,Chow; Bennett,6,0,32,26
1656785309632,MATH 142A,A02,083220,Chow; Bennett,9,0,32,23
1656785309632,MATH 142A,A03,093480,Chow; Bennett,7,0,32,25
1656785309632,MATH 142A,B03,093481,Chow; Bennett,7,0,32,25
1656785309632,MATH 142A,B04,093558,Chow; Bennett,10,0,32,22
1656785309632,MATH 142A,B05,093559,Chow; Bennett,6,0,32,26
1656785315666,MATH 193A,A01,083224,Rotar; Vladimir,6,0,34,28
1656785315666,MATH 193A,A02,083225,Rotar; Vladimir,3,0,34,31
1656785315666,MATH 193A,A03,083781,Rotar; Vladimir,1,0,34,33
1656785315666,MATH 193A,A04,083782,Rotar; Vladimir,6,0,34,28
1656785315666,MATH 193A,A05,093482,Rotar; Vladimir,6,0,34,28
1656785321691,MATH 197,001,091859,McAuley; Julian John,9999,0,9999,0
1656785321691,MATH 197,002,095566,Kedlaya; Kiran S.,9997,0,9999,2
1656785321691,MATH 197,003,095567,Xiao; Ming,9999,0,9999,0
1656785321691,MATH 197,004,095571,Perols; Johan Lars,9998,0,9999,1
1656785328769,COGS 9,A01,083615,Shannon; Kyle Michael,6,0,75,69
1656785334794,COGS 11,A01,083617,Boyle; Mary E. T.,18,0,48,30
1656785340819,COGS 13,A01,083071,Bastos; Amalia Pinkusfeld,8,0,71,63
1656785346850,COGS 14A,A01,092681,Semenuks; Arturs,0,1,100,100
1656785352874,COGS 14B,A01,083073,Cheng; Tzu-Han,5,0,63,58
1656785358903,COGS 17,A01,092677,Semenuks; Arturs,4,0,81,77
1656785364931,COGS 100,A01,083619,Allen; Michael Gordon,15,0,70,55
1656785370956,COGS 101A,A01,083621,Davis; Joshua Daniel,9,0,68,59
1656785376981,COGS 101B,A01,091572,Allen; Michael Gordon,8,0,65,57
1656785383011,COGS 101C,A01,083625,Delgado; Tania,17,0,35,18
1656785389036,COGS 107A,A01,083627,Boyle; Mary E. T.,13,0,60,47
1656785395068,COGS 118A,A01,083075,Gupta; Anjum,15,0,76,61
1656785401100,CSE 3,A50,083646,Miranda; Gregory Joseph,22,0,50,28
1656785407124,CSE 8A,A50,083650,Miranda; Gregory Joseph,17,1,56,39
1656785413153,CSE 11,A01,083080,Cao; Yingjun,4,15,40,36
1656785419184,CSE 12,A01,083652,Krause-Levy; Sophia Louisa,20,1,120,100
1656785425212,CSE 15L,A01,083654,Morris; Justin Loren,8,0,50,42
1656785425212,CSE 15L,A02,083655,Morris; Justin Loren,8,0,50,42
1656785431239,CSE 20,A01,083657,Tran; Khoa Dang,37,0,80,43
1656785437266,CSE 21,A01,095574,Bach; Quang Tran,21,0,48,27
1656785443293,CSE 30,A01,083084,Eldon; John,4,0,80,76
1656785443293,CSE 30,B01,095061,Bhaskar; Nishant,5,0,50,45
1656785449320,CSE 100,A01,083659,Cao; Yingjun,1,4,70,69
1656785455345,CSE 134B,A01,083661,Powell; Thomas Allan,18,0,100,82
1656785461386,CSE 140,A01,083663,Gungor; Onat,14,0,85,71
1656785467418,CSE 140L,A01,083088,Eldon; John,16,0,100,84
1656785473443,CSE 175,A01,083665,Kumar; Rakesh,3,0,25,22
1656785479475,CSE 190,A00,092507,Dubnov; Shlomo,7,0,20,13
1656785485505,ECE 45,A01,083139,Congero; Spencer William,5,0,75,70
1656785491532,ECE 65,A50,083695,Saad; Andrew S,12,0,30,18
1656785491532,ECE 65,A51,095125,Saad; Andrew S,25,0,26,1
1656785497557,ECE 109,A01,091882,Touri; Behrouz,15,0,70,55
1656785503584,ECE 180,A00,083140,Abi Samra; Nicholas Camill,0,0,30,30
1656785503584,ECE 180,B00,083141,Abi Samra; Nicholas Camill,0,0,30,30
1656785509616,MATH 10A,A01,083735,Patchell; Gregory David,1,0,30,29
1656785509616,MATH 10A,A02,083736,Patchell; Gregory David,20,0,30,10
1656785509616,MATH 10A,A03,083737,Patchell; Gregory David,15,0,30,15
1656785515645,MATH 10B,A01,083207,Lim; Seonhee,7,0,34,27
1656785515645,MATH 10B,A02,083208,Lim; Seonhee,9,0,35,26
1656785515645,MATH 10B,A03,093472,Lim; Seonhee,4,0,34,30
1656785515645,MATH 10B,B01,083739,Sinha; Shubham,9,0,30,21
1656785521671,MATH 18,A01,083743,Cinel; Cameron Alexander,6,0,30,24
1656785521671,MATH 18,A02,083744,Cinel; Cameron Alexander,15,0,30,15
1656785521671,MATH 18,A03,083745,Cinel; Cameron Alexander,8,0,30,22
1656785521671,MATH 18,B01,083748,Rideout; David Porter,3,0,37,34
1656785521671,MATH 18,B02,083749,Rideout; David Porter,3,0,36,33
1656785521671,MATH 18,B03,083750,Rideout; David Porter,1,0,37,36
1656785521671,MATH 18,B04,083751,Rideout; David Porter,5,0,36,31
1656785521671,MATH 18,B05,093473,Rideout; David Porter,4,0,36,32
1656785521671,MATH 18,B06,093474,Rideout; David Porter,5,0,36,31
1656785527692,MATH 20A,A01,083754,Zheng; Zequn,12,0,40,28
1656785533716,MATH 20B,A01,083756,Briones; Jor-el Thomas Caparas,1,0,36,35
1656785533716,MATH 20B,A02,083757,Briones; Jor-el Thomas Caparas,1,0,36,35
1656785533716,MATH 20B,A03,093475,Briones; Jor-el Thomas Caparas,0,0,36,36
1656785539745,MATH 20C,A01,083760,Briones; Jor-el Thomas Caparas,1,0,35,34
1656785539745,MATH 20C,A02,083761,Briones; Jor-el Thomas Caparas,8,0,35,27
1656785539745,MATH 20C,A03,093476,Briones; Jor-el Thomas Caparas,0,1,36,36
1656785539745,MATH 20C,B01,083762,Bach; Quang Tran,0,0,30,30
1656785545774,MATH 20D,A01,083765,Tran; Brian Kha,4,0,30,26
1656785545774,MATH 20D,A02,083766,Tran; Brian Kha,4,0,30,26
1656785545774,MATH 20D,A03,083767,Tran; Brian Kha,2,0,30,28
1656785551801,MATH 20E,A01,083771,Ganguly; Soumya,5,0,32,27
1656785551801,MATH 20E,A02,083772,Ganguly; Soumya,5,0,32,27
1656785551801,MATH 20E,B01,083773,Ciotti; Benjamin,18,0,35,17
1656785551801,MATH 20E,B02,083774,Ciotti; Benjamin,17,0,35,18
1656785557830,MATH 103A,A01,083777,Greenfeld; Be'Eri,2,0,36,34
1656785557830,MATH 103A,A02,083778,Greenfeld; Be'Eri,5,0,36,31
1656785557830,MATH 103A,A03,093561,Greenfeld; Be'Eri,4,0,36,32
1656785557830,MATH 103A,B01,083779,Greenfeld; Be'Eri,6,0,36,30
1656785557830,MATH 103A,B02,083780,Greenfeld; Be'Eri,2,0,36,34
1656785557830,MATH 103A,B03,093562,Greenfeld; Be'Eri,2,0,36,34
1656785563860,MATH 105,A01,085443,Carter; Anne Toulson,13,0,35,22
1656785563860,MATH 105,A02,093477,Carter; Anne Toulson,20,0,35,15
1656785569889,MATH 109,A01,083213,Ganzberger; Geoffrey Michael,2,0,34,32
1656785569889,MATH 109,A02,083214,Ganzberger; Geoffrey Michael,2,0,34,32
1656785569889,MATH 109,A03,093478,Ganzberger; Geoffrey Michael,1,0,34,33
1656785569889,MATH 109,B01,083215,Ganzberger; Geoffrey Michael,1,0,32,31
1656785569889,MATH 109,B02,083216,Ganzberger; Geoffrey Michael,1,0,32,31
1656785569889,MATH 109,B03,093479,Ganzberger; Geoffrey Michael,6,0,32,26
1656785575917,MATH 142A,A01,083219,Chow; Bennett,6,0,32,26
1656785575917,MATH 142A,A02,083220,Chow; Bennett,9,0,32,23
1656785575917,MATH 142A,A03,093480,Chow; Bennett,7,0,32,25
1656785575917,MATH 142A,B03,093481,Chow; Bennett,7,0,32,25
1656785575917,MATH 142A,B04,093558,Chow; Bennett,10,0,32,22
1656785575917,MATH 142A,B05,093559,Chow; Bennett,6,0,32,26
1656785582037,MATH 193A,A01,083224,Rotar; Vladimir,6,0,34,28
1656785582037,MATH 193A,A02,083225,Rotar; Vladimir,3,0,34,31
1656785582037,MATH 193A,A03,083781,Rotar; Vladimir,1,0,34,33
1656785582037,MATH 193A,A04,083782,Rotar; Vladimir,6,0,34,28
1656785582037,MATH 193A,A05,093482,Rotar; Vladimir,6,0,34,28
1656785588062,MATH 197,001,091859,McAuley; Julian John,9999,0,9999,0
1656785588062,MATH 197,002,095566,Kedlaya; Kiran S.,9997,0,9999,2
1656785588062,MATH 197,003,095567,Xiao; Ming,9999,0,9999,0
1656785588062,MATH 197,004,095571,Perols; Johan Lars,9998,0,9999,1
1656785595129,COGS 9,A01,083615,Shannon; Kyle Michael,6,0,75,69
1656785601152,COGS 11,A01,083617,Boyle; Mary E. T.,18,0,48,30
1656785607178,COGS 13,A01,083071,Bastos; Amalia Pinkusfeld,8,0,71,63
1656785613208,COGS 14A,A01,092681,Semenuks; Arturs,0,1,100,100
1656785619248,COGS 14B,A01,083073,Cheng; Tzu-Han,5,0,63,58
1656785625273,COGS 17,A01,092677,Semenuks; Arturs,4,0,81,77
1656785631296,COGS 100,A01,083619,Allen; Michael Gordon,15,0,70,55
1656785637325,COGS 101A,A01,083621,Davis; Joshua Daniel,9,0,68,59
1656785643349,COGS 101B,A01,091572,Allen; Michael Gordon,8,0,65,57
1656785649373,COGS 101C,A01,083625,Delgado; Tania,17,0,35,18
1656785655396,COGS 107A,A01,083627,Boyle; Mary E. T.,13,0,60,47
1656785661421,COGS 118A,A01,083075,Gupta; Anjum,15,0,76,61
1656785667456,CSE 3,A50,083646,Miranda; Gregory Joseph,22,0,50,28
1656785673481,CSE 8A,A50,083650,Miranda; Gregory Joseph,17,1,56,39
1656785679505,CSE 11,A01,083080,Cao; Yingjun,4,15,40,36
1656785685533,CSE 12,A01,083652,Krause-Levy; Sophia Louisa,20,1,120,100
1656785691558,CSE 15L,A01,083654,Morris; Justin Loren,8,0,50,42
1656785691558,CSE 15L,A02,083655,Morris; Justin Loren,8,0,50,42
1656785697585,CSE 20,A01,083657,Tran; Khoa Dang,37,0,80,43
1656785703613,CSE 21,A01,095574,Bach; Quang Tran,21,0,48,27
1656785709639,CSE 30,A01,083084,Eldon; John,4,0,80,76
1656785709639,CSE 30,B01,095061,Bhaskar; Nishant,5,0,50,45
1656785715667,CSE 100,A01,083659,Cao; Yingjun,1,4,70,69
1656785721694,CSE 134B,A01,083661,Powell; Thomas Allan,18,0,100,82
1656785727718,CSE 140,A01,083663,Gungor; Onat,14,0,85,71
1656785733745,CSE 140L,A01,083088,Eldon; John,16,0,100,84
1656785739775,CSE 175,A01,083665,Kumar; Rakesh,3,0,25,22
1656785745797,CSE 190,A00,092507,Dubnov; Shlomo,7,0,20,13
1656785751831,ECE 45,A01,083139,Congero; Spencer William,5,0,75,70
1656785757855,ECE 65,A50,083695,Saad; Andrew S,12,0,30,18
1656785757855,ECE 65,A51,095125,Saad; Andrew S,25,0,26,1
1656785763879,ECE 109,A01,091882,Touri; Behrouz,15,0,70,55
1656785769906,ECE 180,A00,083140,Abi Samra; Nicholas Camill,0,0,30,30
1656785769906,ECE 180,B00,083141,Abi Samra; Nicholas Camill,0,0,30,30
1656785775933,MATH 10A,A01,083735,Patchell; Gregory David,1,0,30,29
1656785775933,MATH 10A,A02,083736,Patchell; Gregory David,20,0,30,10
1656785775933,MATH 10A,A03,083737,Patchell; Gregory David,15,0,30,15
1656785781972,MATH 10B,A01,083207,Lim; Seonhee,7,0,34,27
1656785781972,MATH 10B,A02,083208,Lim; Seonhee,9,0,35,26
1656785781972,MATH 10B,A03,093472,Lim; Seonhee,4,0,34,30
1656785781972,MATH 10B,B01,083739,Sinha; Shubham,9,0,30,21
1656785787998,MATH 18,A01,083743,Cinel; Cameron Alexander,6,0,30,24
1656785787998,MATH 18,A02,083744,Cinel; Cameron Alexander,15,0,30,15
1656785787998,MATH 18,A03,083745,Cinel; Cameron Alexander,8,0,30,22
1656785787998,MATH 18,B01,083748,Rideout; David Porter,3,0,37,34
1656785787998,MATH 18,B02,083749,Rideout; David Porter,3,0,36,33
1656785787998,MATH 18,B03,083750,Rideout; David Porter,1,0,37,36
1656785787998,MATH 18,B04,083751,Rideout; David Porter,5,0,36,31
1656785787998,MATH 18,B05,093473,Rideout; David Porter,4,0,36,32
1656785787998,MATH 18,B06,093474,Rideout; David Porter,5,0,36,31
1656785794022,MATH 20A,A01,083754,Zheng; Zequn,12,0,40,28
1656785800046,MATH 20B,A01,083756,Briones; Jor-el Thomas Caparas,1,0,36,35
1656785800046,MATH 20B,A02,083757,Briones; Jor-el Thomas Caparas,1,0,36,35
1656785800046,MATH 20B,A03,093475,Briones; Jor-el Thomas Caparas,0,0,36,36
1656785806077,MATH 20C,A01,083760,Briones; Jor-el Thomas Caparas,1,0,35,34
1656785806077,MATH 20C,A02,083761,Briones; Jor-el Thomas Caparas,8,0,35,27
1656785806077,MATH 20C,A03,093476,Briones; Jor-el Thomas Caparas,0,1,36,36
1656785806077,MATH 20C,B01,083762,Bach; Quang Tran,0,0,30,30
1656785812099,MATH 20D,A01,083765,Tran; Brian Kha,4,0,30,26
1656785812099,MATH 20D,A02,083766,Tran; Brian Kha,4,0,30,26
1656785812099,MATH 20D,A03,083767,Tran; Brian Kha,2,0,30,28
1656785818122,MATH 20E,A01,083771,Ganguly; Soumya,5,0,32,27
1656785818122,MATH 20E,A02,083772,Ganguly; Soumya,5,0,32,27
1656785818122,MATH 20E,B01,083773,Ciotti; Benjamin,18,0,35,17
1656785818122,MATH 20E,B02,083774,Ciotti; Benjamin,17,0,35,18
1656785824145,MATH 103A,A01,083777,Greenfeld; Be'Eri,2,0,36,34
1656785824145,MATH 103A,A02,083778,Greenfeld; Be'Eri,5,0,36,31
1656785824145,MATH 103A,A03,093561,Greenfeld; Be'Eri,4,0,36,32
1656785824145,MATH 103A,B01,083779,Greenfeld; Be'Eri,6,0,36,30
1656785824145,MATH 103A,B02,083780,Greenfeld; Be'Eri,2,0,36,34
1656785824145,MATH 103A,B03,093562,Greenfeld; Be'Eri,2,0,36,34
1656785830168,MATH 105,A01,085443,Carter; Anne Toulson,13,0,35,22
1656785830168,MATH 105,A02,093477,Carter; Anne Toulson,20,0,35,15
1656785836200,MATH 109,A01,083213,Ganzberger; Geoffrey Michael,2,0,34,32
1656785836200,MATH 109,A02,083214,Ganzberger; Geoffrey Michael,2,0,34,32
1656785836200,MATH 109,A03,093478,Ganzberger; Geoffrey Michael,1,0,34,33
1656785836200,MATH 109,B01,083215,Ganzberger; Geoffrey Michael,1,0,32,31
1656785836200,MATH 109,B02,083216,Ganzberger; Geoffrey Michael,1,0,32,31
1656785836200,MATH 109,B03,093479,Ganzberger; Geoffrey Michael,6,0,32,26
1656785842230,MATH 142A,A01,083219,Chow; Bennett,6,0,32,26
1656785842230,MATH 142A,A02,083220,Chow; Bennett,9,0,32,23
1656785842230,MATH 142A,A03,093480,Chow; Bennett,7,0,32,25
1656785842230,MATH 142A,B03,093481,Chow; Bennett,7,0,32,25
1656785842230,MATH 142A,B04,093558,Chow; Bennett,10,0,32,22
1656785842230,MATH 142A,B05,093559,Chow; Bennett,6,0,32,26
1656785848254,MATH 193A,A01,083224,Rotar; Vladimir,6,0,34,28
1656785848254,MATH 193A,A02,083225,Rotar; Vladimir,3,0,34,31
1656785848254,MATH 193A,A03,083781,Rotar; Vladimir,1,0,34,33
1656785848254,MATH 193A,A04,083782,Rotar; Vladimir,6,0,34,28
1656785848254,MATH 193A,A05,093482,Rotar; Vladimir,6,0,34,28
1656785854282,MATH 197,001,091859,McAuley; Julian John,9999,0,9999,0
1656785854282,MATH 197,002,095566,Kedlaya; Kiran S.,9997,0,9999,2
1656785854282,MATH 197,003,095567,Xiao; Ming,9999,0,9999,0
1656785854282,MATH 197,004,095571,Perols; Johan Lars,9998,0,9999,1
1656785861370,COGS 9,A01,083615,Shannon; Kyle Michael,6,0,75,69
1656785867394,COGS 11,A01,083617,Boyle; Mary E. T.,18,0,48,30
1656785873418,COGS 13,A01,083071,Bastos; Amalia Pinkusfeld,8,0,71,63
1656785879453,COGS 14A,A01,092681,Semenuks; Arturs,0,1,100,100
1656785885476,COGS 14B,A01,083073,Cheng; Tzu-Han,5,0,63,58
1656785891503,COGS 17,A01,092677,Semenuks; Arturs,4,0,81,77
1656785897532,COGS 100,A01,083619,Allen; Michael Gordon,15,0,70,55
1656785903557,COGS 101A,A01,083621,Davis; Joshua Daniel,9,0,68,59
1656785909586,COGS 101B,A01,091572,Allen; Michael Gordon,8,0,65,57
1656785915616,COGS 101C,A01,083625,Delgado; Tania,17,0,35,18
1656785921643,COGS 107A,A01,083627,Boyle; Mary E. T.,13,0,60,47
1656785927666,COGS 118A,A01,083075,Gupta; Anjum,15,0,76,61
1656785933690,CSE 3,A50,083646,Miranda; Gregory Joseph,22,0,50,28
1656785939713,CSE 8A,A50,083650,Miranda; Gregory Joseph,17,1,56,39
1656785945741,CSE 11,A01,083080,Cao; Yingjun,4,15,40,36
1656785951769,CSE 12,A01,083652,Krause-Levy; Sophia Louisa,20,1,120,100
1656785957793,CSE 15L,A01,083654,Morris; Justin Loren,8,0,50,42
1656785957793,CSE 15L,A02,083655,Morris; Justin Loren,8,0,50,42
1656785963818,CSE 20,A01,083657,Tran; Khoa Dang,37,0,80,43
1656785969846,CSE 21,A01,095574,Bach; Quang Tran,21,0,48,27
1656785975870,CSE 30,A01,083084,Eldon; John,4,0,80,76
1656785975870,CSE 30,B01,095061,Bhaskar; Nishant,5,0,50,45
1656785981894,CSE 100,A01,083659,Cao; Yingjun,1,4,70,69
1656785987918,CSE 134B,A01,083661,Powell; Thomas Allan,18,0,100,82
1656785993941,CSE 140,A01,083663,Gungor; Onat,14,0,85,71
1656785999964,CSE 140L,A01,083088,Eldon; John,16,0,100,84
1656786005988,CSE 175,A01,083665,Kumar; Rakesh,3,0,25,22
1656786012012,CSE 190,A00,092507,Dubnov; Shlomo,7,0,20,13
1656786018037,ECE 45,A01,083139,Congero; Spencer William,5,0,75,70
1656786024065,ECE 65,A50,083695,Saad; Andrew S,12,0,30,18
1656786024065,ECE 65,A51,095125,Saad; Andrew S,25,0,26,1
1656786030092,ECE 109,A01,091882,Touri; Behrouz,15,0,70,55
1656786036118,ECE 180,A00,083140,Abi Samra; Nicholas Camill,0,0,30,30
1656786036118,ECE 180,B00,083141,Abi Samra; Nicholas Camill,0,0,30,30
1656786042142,MATH 10A,A01,083735,Patchell; Gregory David,1,0,30,29
1656786042142,MATH 10A,A02,083736,Patchell; Gregory David,20,0,30,10
1656786042142,MATH 10A,A03,083737,Patchell; Gregory David,15,0,30,15
1656786048179,MATH 10B,A01,083207,Lim; Seonhee,7,0,34,27
1656786048179,MATH 10B,A02,083208,Lim; Seonhee,9,0,35,26
1656786048179,MATH 10B,A03,093472,Lim; Seonhee,4,0,34,30
1656786048179,MATH 10B,B01,083739,Sinha; Shubham,9,0,30,21
1656786054215,MATH 18,A01,083743,Cinel; Cameron Alexander,6,0,30,24
1656786054215,MATH 18,A02,083744,Cinel; Cameron Alexander,15,0,30,15
1656786054215,MATH 18,A03,083745,Cinel; Cameron Alexander,8,0,30,22
1656786054215,MATH 18,B01,083748,Rideout; David Porter,3,0,37,34
1656786054215,MATH 18,B02,083749,Rideout; David Porter,3,0,36,33
1656786054215,MATH 18,B03,083750,Rideout; David Porter,1,0,37,36
1656786054215,MATH 18,B04,083751,Rideout; David Porter,5,0,36,31
1656786054215,MATH 18,B05,093473,Rideout; David Porter,4,0,36,32
1656786054215,MATH 18,B06,093474,Rideout; David Porter,5,0,36,31
1656786060244,MATH 20A,A01,083754,Zheng; Zequn,12,0,40,28
1656786066274,MATH 20B,A01,083756,Briones; Jor-el Thomas Caparas,1,0,36,35
1656786066274,MATH 20B,A02,083757,Briones; Jor-el Thomas Caparas,1,0,36,35
1656786066274,MATH 20B,A03,093475,Briones; Jor-el Thomas Caparas,0,0,36,36
1656786072298,MATH 20C,A01,083760,Briones; Jor-el Thomas Caparas,1,0,35,34
1656786072298,MATH 20C,A02,083761,Briones; Jor-el Thomas Caparas,8,0,35,27
1656786072298,MATH 20C,A03,093476,Briones; Jor-el Thomas Caparas,0,1,36,36
1656786072298,MATH 20C,B01,083762,Bach; Quang Tran,0,0,30,30
1656786078328,MATH 20D,A01,083765,Tran; Brian Kha,4,0,30,26
1656786078328,MATH 20D,A02,083766,Tran; Brian Kha,4,0,30,26
1656786078328,MATH 20D,A03,083767,Tran; Brian Kha,2,0,30,28
1656786084361,MATH 20E,A01,083771,Ganguly; Soumya,5,0,32,27
1656786084361,MATH 20E,A02,083772,Ganguly; Soumya,5,0,32,27
1656786084361,MATH 20E,B01,083773,Ciotti; Benjamin,18,0,35,17
1656786084361,MATH 20E,B02,083774,Ciotti; Benjamin,17,0,35,18
1656786090389,MATH 103A,A01,083777,Greenfeld; Be'Eri,2,0,36,34
1656786090389,MATH 103A,A02,083778,Greenfeld; Be'Eri,5,0,36,31
1656786090389,MATH 103A,A03,093561,Greenfeld; Be'Eri,4,0,36,32
1656786090389,MATH 103A,B01,083779,Greenfeld; Be'Eri,6,0,36,30
1656786090389,MATH 103A,B02,083780,Greenfeld; Be'Eri,2,0,36,34
1656786090389,MATH 103A,B03,093562,Greenfeld; Be'Eri,2,0,36,34
1656786096412,MATH 105,A01,085443,Carter; Anne Toulson,13,0,35,22
1656786096412,MATH 105,A02,093477,Carter; Anne Toulson,20,0,35,15
1656786102442,MATH 109,A01,083213,Ganzberger; Geoffrey Michael,2,0,34,32
1656786102442,MATH 109,A02,083214,Ganzberger; Geoffrey Michael,2,0,34,32
1656786102442,MATH 109,A03,093478,Ganzberger; Geoffrey Michael,1,0,34,33
1656786102442,MATH 109,B01,083215,Ganzberger; Geoffrey Michael,1,0,32,31
1656786102442,MATH 109,B02,083216,Ganzberger; Geoffrey Michael,1,0,32,31
1656786102442,MATH 109,B03,093479,Ganzberger; Geoffrey Michael,6,0,32,26
1656786108473,MATH 142A,A01,083219,Chow; Bennett,6,0,32,26
1656786108473,MATH 142A,A02,083220,Chow; Bennett,9,0,32,23
1656786108473,MATH 142A,A03,093480,Chow; Bennett,7,0,32,25
1656786108473,MATH 142A,B03,093481,Chow; Bennett,7,0,32,25
1656786108473,MATH 142A,B04,093558,Chow; Bennett,10,0,32,22
1656786108473,MATH 142A,B05,093559,Chow; Bennett,6,0,32,26
1656786114497,MATH 193A,A01,083224,Rotar; Vladimir,6,0,34,28
1656786114497,MATH 193A,A02,083225,Rotar; Vladimir,3,0,34,31
1656786114497,MATH 193A,A03,083781,Rotar; Vladimir,1,0,34,33
1656786114497,MATH 193A,A04,083782,Rotar; Vladimir,6,0,34,28
1656786114497,MATH 193A,A05,093482,Rotar; Vladimir,6,0,34,28
1656786120525,MATH 197,001,091859,McAuley; Julian John,9999,0,9999,0
1656786120525,MATH 197,002,095566,Kedlaya; Kiran S.,9997,0,9999,2
1656786120525,MATH 197,003,095567,Xiao; Ming,9999,0,9999,0
1656786120525,MATH 197,004,095571,Perols; Johan Lars,9998,0,9999,1
1656786127597,COGS 9,A01,083615,Shannon; Kyle Michael,6,0,75,69
1656786133632,COGS 11,A01,083617,Boyle; Mary E. T.,18,0,48,30
1656786139658,COGS 13,A01,083071,Bastos; Amalia Pinkusfeld,8,0,71,63
1656786145681,COGS 14A,A01,092681,Semenuks; Arturs,0,1,100,100
1656786151707,COGS 14B,A01,083073,Cheng; Tzu-Han,5,0,63,58
1656786157729,COGS 17,A01,092677,Semenuks; Arturs,4,0,81,77
1656786163753,COGS 100,A01,083619,Allen; Michael Gordon,15,0,70,55
1656786169778,COGS 101A,A01,083621,Davis; Joshua Daniel,9,0,68,59
1656786175891,COGS 101B,A01,091572,Allen; Michael Gordon,8,0,65,57
1656786181924,COGS 101C,A01,083625,Delgado; Tania,17,0,35,18
1656786187948,COGS 107A,A01,083627,Boyle; Mary E. T.,13,0,60,47
1656786193976,COGS 118A,A01,083075,Gupta; Anjum,15,0,76,61
1656786200011,CSE 3,A50,083646,Miranda; Gregory Joseph,22,0,50,28
1656786206038,CSE 8A,A50,083650,Miranda; Gregory Joseph,17,1,56,39
1656786212061,CSE 11,A01,083080,Cao; Yingjun,4,15,40,36
1656786218085,CSE 12,A01,083652,Krause-Levy; Sophia Louisa,20,1,120,100
1656786224113,CSE 15L,A01,083654,Morris; Justin Loren,8,0,50,42
1656786224113,CSE 15L,A02,083655,Morris; Justin Loren,8,0,50,42
1656786230138,CSE 20,A01,083657,Tran; Khoa Dang,37,0,80,43
1656786236163,CSE 21,A01,095574,Bach; Quang Tran,21,0,48,27
1656786242193,CSE 30,A01,083084,Eldon; John,4,0,80,76
1656786242193,CSE 30,B01,095061,Bhaskar; Nishant,5,0,50,45
1656786248216,CSE 100,A01,083659,Cao; Yingjun,1,4,70,69
1656786254242,CSE 134B,A01,083661,Powell; Thomas Allan,18,0,100,82
1656786260273,CSE 140,A01,083663,Gungor; Onat,14,0,85,71
1656786266301,CSE 140L,A01,083088,Eldon; John,16,0,100,84
1656786272330,CSE 175,A01,083665,Kumar; Rakesh,3,0,25,22
1656786278356,CSE 190,A00,092507,Dubnov; Shlomo,7,0,20,13
1656786284386,ECE 45,A01,083139,Congero; Spencer William,5,0,75,70
1656786290411,ECE 65,A50,083695,Saad; Andrew S,12,0,30,18
1656786290411,ECE 65,A51,095125,Saad; Andrew S,25,0,26,1
1656786296986,ECE 109,A01,091882,Touri; Behrouz,15,0,70,55
1656786303015,ECE 180,A00,083140,Abi Samra; Nicholas Camill,0,0,30,30
1656786303015,ECE 180,B00,083141,Abi Samra; Nicholas Camill,0,0,30,30
1656786309048,MATH 10A,A01,083735,Patchell; Gregory David,1,0,30,29
1656786309048,MATH 10A,A02,083736,Patchell; Gregory David,20,0,30,10
1656786309048,MATH 10A,A03,083737,Patchell; Gregory David,15,0,30,15
1656786315084,MATH 10B,A01,083207,Lim; Seonhee,7,0,34,27
1656786315084,MATH 10B,A02,083208,Lim; Seonhee,9,0,35,26
1656786315084,MATH 10B,A03,093472,Lim; Seonhee,4,0,34,30
1656786315084,MATH 10B,B01,083739,Sinha; Shubham,9,0,30,21
1656786321113,MATH 18,A01,083743,Cinel; Cameron Alexander,6,0,30,24
1656786321113,MATH 18,A02,083744,Cinel; Cameron Alexander,15,0,30,15
1656786321113,MATH 18,A03,083745,Cinel; Cameron Alexander,8,0,30,22
1656786321113,MATH 18,B01,083748,Rideout; David Porter,3,0,37,34
1656786321113,MATH 18,B02,083749,Rideout; David Porter,3,0,36,33
1656786321113,MATH 18,B03,083750,Rideout; David Porter,1,0,37,36
1656786321113,MATH 18,B04,083751,Rideout; David Porter,5,0,36,31
1656786321113,MATH 18,B05,093473,Rideout; David Porter,4,0,36,32
1656786321113,MATH 18,B06,093474,Rideout; David Porter,5,0,36,31
1656786327138,MATH 20A,A01,083754,Zheng; Zequn,12,0,40,28
1656786333165,MATH 20B,A01,083756,Briones; Jor-el Thomas Caparas,1,0,36,35
1656786333165,MATH 20B,A02,083757,Briones; Jor-el Thomas Caparas,1,0,36,35
1656786333165,MATH 20B,A03,093475,Briones; Jor-el Thomas Caparas,0,0,36,36
1656786339208,MATH 20C,A01,083760,Briones; Jor-el Thomas Caparas,1,0,35,34
1656786339208,MATH 20C,A02,083761,Briones; Jor-el Thomas Caparas,8,0,35,27
1656786339208,MATH 20C,A03,093476,Briones; Jor-el Thomas Caparas,0,1,36,36
1656786339208,MATH 20C,B01,083762,Bach; Quang Tran,0,0,30,30
1656786345235,MATH 20D,A01,083765,Tran; Brian Kha,4,0,30,26
1656786345235,MATH 20D,A02,083766,Tran; Brian Kha,4,0,30,26
1656786345235,MATH 20D,A03,083767,Tran; Brian Kha,2,0,30,28
1656786351264,MATH 20E,A01,083771,Ganguly; Soumya,5,0,32,27
1656786351264,MATH 20E,A02,083772,Ganguly; Soumya,5,0,32,27
1656786351264,MATH 20E,B01,083773,Ciotti; Benjamin,18,0,35,17
1656786351264,MATH 20E,B02,083774,Ciotti; Benjamin,17,0,35,18
1656786357300,MATH 103A,A01,083777,Greenfeld; Be'Eri,2,0,36,34
1656786357300,MATH 103A,A02,083778,Greenfeld; Be'Eri,5,0,36,31
1656786357300,MATH 103A,A03,093561,Greenfeld; Be'Eri,4,0,36,32
1656786357300,MATH 103A,B01,083779,Greenfeld; Be'Eri,6,0,36,30
1656786357300,MATH 103A,B02,083780,Greenfeld; Be'Eri,2,0,36,34
1656786357300,MATH 103A,B03,093562,Greenfeld; Be'Eri,2,0,36,34
1656786363328,MATH 105,A01,085443,Carter; Anne Toulson,13,0,35,22
1656786363328,MATH 105,A02,093477,Carter; Anne Toulson,20,0,35,15
1656786369364,MATH 109,A01,083213,Ganzberger; Geoffrey Michael,2,0,34,32
1656786369364,MATH 109,A02,083214,Ganzberger; Geoffrey Michael,2,0,34,32
1656786369364,MATH 109,A03,093478,Ganzberger; Geoffrey Michael,1,0,34,33
1656786369364,MATH 109,B01,083215,Ganzberger; Geoffrey Michael,1,0,32,31
1656786369364,MATH 109,B02,083216,Ganzberger; Geoffrey Michael,1,0,32,31
1656786369364,MATH 109,B03,093479,Ganzberger; Geoffrey Michael,6,0,32,26
1656786375389,MATH 142A,A01,083219,Chow; Bennett,6,0,32,26
1656786375389,MATH 142A,A02,083220,Chow; Bennett,9,0,32,23
1656786375389,MATH 142A,A03,093480,Chow; Bennett,7,0,32,25
1656786375389,MATH 142A,B03,093481,Chow; Bennett,7,0,32,25
1656786375389,MATH 142A,B04,093558,Chow; Bennett,10,0,32,22
1656786375389,MATH 142A,B05,093559,Chow; Bennett,6,0,32,26
1656786381412,MATH 193A,A01,083224,Rotar; Vladimir,6,0,34,28
1656786381412,MATH 193A,A02,083225,Rotar; Vladimir,3,0,34,31
1656786381412,MATH 193A,A03,083781,Rotar; Vladimir,1,0,34,33
1656786381412,MATH 193A,A04,083782,Rotar; Vladimir,6,0,34,28
1656786381412,MATH 193A,A05,093482,Rotar; Vladimir,6,0,34,28
1656786387436,MATH 197,001,091859,McAuley; Julian John,9999,0,9999,0
1656786387436,MATH 197,002,095566,Kedlaya; Kiran S.,9997,0,9999,2
1656786387436,MATH 197,003,095567,Xiao; Ming,9999,0,9999,0
1656786387436,MATH 197,004,095571,Perols; Johan Lars,9998,0,9999,1
1656786394525,COGS 9,A01,083615,Shannon; Kyle Michael,6,0,75,69
1656786400551,COGS 11,A01,083617,Boyle; Mary E. T.,18,0,48,30
1656786406576,COGS 13,A01,083071,Bastos; Amalia Pinkusfeld,8,0,71,63
1656786412601,COGS 14A,A01,092681,Semenuks; Arturs,0,1,100,100
1656786418655,COGS 14B,A01,083073,Cheng; Tzu-Han,5,0,63,58
1656786424681,COGS 17,A01,092677,Semenuks; Arturs,4,0,81,77
1656786430708,COGS 100,A01,083619,Allen; Michael Gordon,15,0,70,55
1656786436741,COGS 101A,A01,083621,Davis; Joshua Daniel,9,0,68,59
1656786442767,COGS 101B,A01,091572,Allen; Michael Gordon,8,0,65,57
1656786448792,COGS 101C,A01,083625,Delgado; Tania,17,0,35,18
1656786454816,COGS 107A,A01,083627,Boyle; Mary E. T.,13,0,60,47
1656786460850,COGS 118A,A01,083075,Gupta; Anjum,15,0,76,61
1656786466881,CSE 3,A50,083646,Miranda; Gregory Joseph,22,0,50,28
1656786472917,CSE 8A,A50,083650,Miranda; Gregory Joseph,17,1,56,39
1656786478942,CSE 11,A01,083080,Cao; Yingjun,4,15,40,36
1656786484972,CSE 12,A01,083652,Krause-Levy; Sophia Louisa,20,1,120,100
1656786490997,CSE 15L,A01,083654,Morris; Justin Loren,8,0,50,42
1656786490997,CSE 15L,A02,083655,Morris; Justin Loren,8,0,50,42
1656786497023,CSE 20,A01,083657,Tran; Khoa Dang,37,0,80,43
1656786503064,CSE 21,A01,095574,Bach; Quang Tran,21,0,48,27
1656786509094,CSE 30,A01,083084,Eldon; John,4,0,80,76
1656786509094,CSE 30,B01,095061,Bhaskar; Nishant,5,0,50,45
1656786515124,CSE 100,A01,083659,Cao; Yingjun,1,4,70,69
1656786521148,CSE 134B,A01,083661,Powell; Thomas Allan,18,0,100,82
1656786527184,CSE 140,A01,083663,Gungor; Onat,14,0,85,71
1656786533208,CSE 140L,A01,083088,Eldon; John,16,0,100,84
1656786539234,CSE 175,A01,083665,Kumar; Rakesh,3,0,25,22
1656786545260,CSE 190,A00,092507,Dubnov; Shlomo,7,0,20,13
1656786551314,ECE 45,A01,083139,Congero; Spencer William,5,0,75,70
1656786557340,ECE 65,A50,083695,Saad; Andrew S,12,0,30,18
1656786557340,ECE 65,A51,095125,Saad; Andrew S,25,0,26,1
1656786563371,ECE 109,A01,091882,Touri; Behrouz,15,0,70,55
1656786569411,ECE 180,A00,083140,Abi Samra; Nicholas Camill,0,0,30,30
1656786569411,ECE 180,B00,083141,Abi Samra; Nicholas Camill,0,0,30,30
1656786575444,MATH 10A,A01,083735,Patchell; Gregory David,1,0,30,29
1656786575444,MATH 10A,A02,083736,Patchell; Gregory David,20,0,30,10
1656786575444,MATH 10A,A03,083737,Patchell; Gregory David,15,0,30,15
1656786581493,MATH 10B,A01,083207,Lim; Seonhee,7,0,34,27
1656786581493,MATH 10B,A02,083208,Lim; Seonhee,9,0,35,26
1656786581493,MATH 10B,A03,093472,Lim; Seonhee,4,0,34,30
1656786581493,MATH 10B,B01,083739,Sinha; Shubham,9,0,30,21
1656786587522,MATH 18,A01,083743,Cinel; Cameron Alexander,6,0,30,24
1656786587522,MATH 18,A02,083744,Cinel; Cameron Alexander,15,0,30,15
1656786587522,MATH 18,A03,083745,Cinel; Cameron Alexander,8,0,30,22
1656786587522,MATH 18,B01,083748,Rideout; David Porter,3,0,37,34
1656786587522,MATH 18,B02,083749,Rideout; David Porter,3,0,36,33
1656786587522,MATH 18,B03,083750,Rideout; David Porter,1,0,37,36
1656786587522,MATH 18,B04,083751,Rideout; David Porter,5,0,36,31
1656786587522,MATH 18,B05,093473,Rideout; David Porter,4,0,36,32
1656786587522,MATH 18,B06,093474,Rideout; David Porter,5,0,36,31
1656786598000,MATH 20A,A01,083754,Zheng; Zequn,12,0,40,28
1656786611456,MATH 20B,A01,083756,Briones; Jor-el Thomas Caparas,1,0,36,35
1656786611456,MATH 20B,A02,083757,Briones; Jor-el Thomas Caparas,1,0,36,35
1656786611456,MATH 20B,A03,093475,Briones; Jor-el Thomas Caparas,0,0,36,36
1656786617491,MATH 20C,A01,083760,Briones; Jor-el Thomas Caparas,1,0,35,34
1656786617491,MATH 20C,A02,083761,Briones; Jor-el Thomas Caparas,8,0,35,27
1656786617491,MATH 20C,A03,093476,Briones; Jor-el Thomas Caparas,0,1,36,36
1656786617491,MATH 20C,B01,083762,Bach; Quang Tran,0,0,30,30
1656786623519,MATH 20D,A01,083765,Tran; Brian Kha,4,0,30,26
1656786623519,MATH 20D,A02,083766,Tran; Brian Kha,4,0,30,26
1656786623519,MATH 20D,A03,083767,Tran; Brian Kha,2,0,30,28
1656786629550,MATH 20E,A01,083771,Ganguly; Soumya,5,0,32,27
1656786629550,MATH 20E,A02,083772,Ganguly; Soumya,5,0,32,27
1656786629550,MATH 20E,B01,083773,Ciotti; Benjamin,18,0,35,17
1656786629550,MATH 20E,B02,083774,Ciotti; Benjamin,17,0,35,18
1656786635588,MATH 103A,A01,083777,Greenfeld; Be'Eri,2,0,36,34
1656786635588,MATH 103A,A02,083778,Greenfeld; Be'Eri,5,0,36,31
1656786635588,MATH 103A,A03,093561,Greenfeld; Be'Eri,4,0,36,32
1656786635588,MATH 103A,B01,083779,Greenfeld; Be'Eri,6,0,36,30
1656786635588,MATH 103A,B02,083780,Greenfeld; Be'Eri,2,0,36,34
1656786635588,MATH 103A,B03,093562,Greenfeld; Be'Eri,2,0,36,34
1656786641616,MATH 105,A01,085443,Carter; Anne Toulson,13,0,35,22
1656786641616,MATH 105,A02,093477,Carter; Anne Toulson,20,0,35,15
1656786647649,MATH 109,A01,083213,Ganzberger; Geoffrey Michael,2,0,34,32
1656786647649,MATH 109,A02,083214,Ganzberger; Geoffrey Michael,2,0,34,32
1656786647649,MATH 109,A03,093478,Ganzberger; Geoffrey Michael,1,0,34,33
1656786647649,MATH 109,B01,083215,Ganzberger; Geoffrey Michael,1,0,32,31
1656786647649,MATH 109,B02,083216,Ganzberger; Geoffrey Michael,1,0,32,31
1656786647649,MATH 109,B03,093479,Ganzberger; Geoffrey Michael,6,0,32,26
1656786653674,MATH 142A,A01,083219,Chow; Bennett,6,0,32,26
1656786653674,MATH 142A,A02,083220,Chow; Bennett,9,0,32,23
1656786653674,MATH 142A,A03,093480,Chow; Bennett,7,0,32,25
1656786653674,MATH 142A,B03,093481,Chow; Bennett,7,0,32,25
1656786653674,MATH 142A,B04,093558,Chow; Bennett,10,0,32,22
1656786653674,MATH 142A,B05,093559,Chow; Bennett,6,0,32,26
1656786659722,MATH 193A,A01,083224,Rotar; Vladimir,6,0,34,28
1656786659722,MATH 193A,A02,083225,Rotar; Vladimir,3,0,34,31
1656786659722,MATH 193A,A03,083781,Rotar; Vladimir,1,0,34,33
1656786659722,MATH 193A,A04,083782,Rotar; Vladimir,6,0,34,28
1656786659722,MATH 193A,A05,093482,Rotar; Vladimir,6,0,34,28
1656786665747,MATH 197,001,091859,McAuley; Julian John,9999,0,9999,0
1656786665747,MATH 197,002,095566,Kedlaya; Kiran S.,9997,0,9999,2
1656786665747,MATH 197,003,095567,Xiao; Ming,9999,0,9999,0
1656786665747,MATH 197,004,095571,Perols; Johan Lars,9998,0,9999,1
1656786672824,COGS 9,A01,083615,Shannon; Kyle Michael,6,0,75,69
1656786678856,COGS 11,A01,083617,Boyle; Mary E. T.,18,0,48,30
1656786684881,COGS 13,A01,083071,Bastos; Amalia Pinkusfeld,8,0,71,63
1656786690913,COGS 14A,A01,092681,Semenuks; Arturs,0,1,100,100
1656786696940,COGS 14B,A01,083073,Cheng; Tzu-Han,5,0,63,58
1656786705627,COGS 17,A01,092677,Semenuks; Arturs,4,0,81,77
1656786711665,COGS 100,A01,083619,Allen; Michael Gordon,15,0,70,55
1656786717694,COGS 101A,A01,083621,Davis; Joshua Daniel,9,0,68,59
1656786723724,COGS 101B,A01,091572,Allen; Michael Gordon,8,0,65,57
1656786729753,COGS 101C,A01,083625,Delgado; Tania,17,0,35,18
1656786735779,COGS 107A,A01,083627,Boyle; Mary E. T.,13,0,60,47
1656786741803,COGS 118A,A01,083075,Gupta; Anjum,15,0,76,61
1656786747841,CSE 3,A50,083646,Miranda; Gregory Joseph,22,0,50,28
1656786753864,CSE 8A,A50,083650,Miranda; Gregory Joseph,17,1,56,39
1656786759893,CSE 11,A01,083080,Cao; Yingjun,4,15,40,36
1656786765924,CSE 12,A01,083652,Krause-Levy; Sophia Louisa,20,1,120,100
1656786771946,CSE 15L,A01,083654,Morris; Justin Loren,8,0,50,42
1656786771946,CSE 15L,A02,083655,Morris; Justin Loren,8,0,50,42
1656786777975,CSE 20,A01,083657,Tran; Khoa Dang,37,0,80,43
1656786784003,CSE 21,A01,095574,Bach; Quang Tran,21,0,48,27
1656786790118,CSE 30,A01,083084,Eldon; John,4,0,80,76
1656786790118,CSE 30,B01,095061,Bhaskar; Nishant,5,0,50,45
1656786796169,CSE 100,A01,083659,Cao; Yingjun,1,4,70,69
1656786802197,CSE 134B,A01,083661,Powell; Thomas Allan,18,0,100,82
1656786808223,CSE 140,A01,083663,Gungor; Onat,14,0,85,71
1656786814265,CSE 140L,A01,083088,Eldon; John,16,0,100,84
1656786820289,CSE 175,A01,083665,Kumar; Rakesh,3,0,25,22
1656786826313,CSE 190,A00,092507,Dubnov; Shlomo,7,0,20,13
1656786832340,ECE 45,A01,083139,Congero; Spencer William,5,0,75,70
1656786838374,ECE 65,A50,083695,Saad; Andrew S,12,0,30,18
1656786838374,ECE 65,A51,095125,Saad; Andrew S,25,0,26,1
1656786844406,ECE 109,A01,091882,Touri; Behrouz,15,0,70,55
1656786850428,ECE 180,A00,083140,Abi Samra; Nicholas Camill,0,0,30,30
1656786850428,ECE 180,B00,083141,Abi Samra; Nicholas Camill,0,0,30,30
1656786856459,MATH 10A,A01,083735,Patchell; Gregory David,1,0,30,29
1656786856459,MATH 10A,A02,083736,Patchell; Gregory David,20,0,30,10
1656786856459,MATH 10A,A03,083737,Patchell; Gregory David,15,0,30,15
1656786862488,MATH 10B,A01,083207,Lim; Seonhee,7,0,34,27
1656786862488,MATH 10B,A02,083208,Lim; Seonhee,9,0,35,26
1656786862488,MATH 10B,A03,093472,Lim; Seonhee,4,0,34,30
1656786862488,MATH 10B,B01,083739,Sinha; Shubham,9,0,30,21
1656786868516,MATH 18,A01,083743,Cinel; Cameron Alexander,6,0,30,24
1656786868516,MATH 18,A02,083744,Cinel; Cameron Alexander,15,0,30,15
1656786868516,MATH 18,A03,083745,Cinel; Cameron Alexander,8,0,30,22
1656786868516,MATH 18,B01,083748,Rideout; David Porter,3,0,37,34
1656786868516,MATH 18,B02,083749,Rideout; David Porter,3,0,36,33
1656786868516,MATH 18,B03,083750,Rideout; David Porter,1,0,37,36
1656786868516,MATH 18,B04,083751,Rideout; David Porter,5,0,36,31
1656786868516,MATH 18,B05,093473,Rideout; David Porter,4,0,36,32
1656786868516,MATH 18,B06,093474,Rideout; David Porter,5,0,36,31
1656786874541,MATH 20A,A01,083754,Zheng; Zequn,12,0,40,28
1656786880569,MATH 20B,A01,083756,Briones; Jor-el Thomas Caparas,1,0,36,35
1656786880569,MATH 20B,A02,083757,Briones; Jor-el Thomas Caparas,1,0,36,35
1656786880569,MATH 20B,A03,093475,Briones; Jor-el Thomas Caparas,0,0,36,36
1656786886600,MATH 20C,A01,083760,Briones; Jor-el Thomas Caparas,1,0,35,34
1656786886600,MATH 20C,A02,083761,Briones; Jor-el Thomas Caparas,8,0,35,27
1656786886600,MATH 20C,A03,093476,Briones; Jor-el Thomas Caparas,0,1,36,36
1656786886600,MATH 20C,B01,083762,Bach; Quang Tran,0,0,30,30
1656786892625,MATH 20D,A01,083765,Tran; Brian Kha,4,0,30,26
1656786892625,MATH 20D,A02,083766,Tran; Brian Kha,4,0,30,26
1656786892625,MATH 20D,A03,083767,Tran; Brian Kha,2,0,30,28
1656786898656,MATH 20E,A01,083771,Ganguly; Soumya,5,0,32,27
1656786898656,MATH 20E,A02,083772,Ganguly; Soumya,5,0,32,27
1656786898656,MATH 20E,B01,083773,Ciotti; Benjamin,18,0,35,17
1656786898656,MATH 20E,B02,083774,Ciotti; Benjamin,17,0,35,18
1656786904690,MATH 103A,A01,083777,Greenfeld; Be'Eri,2,0,36,34
1656786904690,MATH 103A,A02,083778,Greenfeld; Be'Eri,5,0,36,31
1656786904690,MATH 103A,A03,093561,Greenfeld; Be'Eri,4,0,36,32
1656786904690,MATH 103A,B01,083779,Greenfeld; Be'Eri,6,0,36,30
1656786904690,MATH 103A,B02,083780,Greenfeld; Be'Eri,2,0,36,34
1656786904690,MATH 103A,B03,093562,Greenfeld; Be'Eri,2,0,36,34
1656786910713,MATH 105,A01,085443,Carter; Anne Toulson,13,0,35,22
1656786910713,MATH 105,A02,093477,Carter; Anne Toulson,20,0,35,15
1656786916756,MATH 109,A01,083213,Ganzberger; Geoffrey Michael,2,0,34,32
1656786916756,MATH 109,A02,083214,Ganzberger; Geoffrey Michael,2,0,34,32
1656786916756,MATH 109,A03,093478,Ganzberger; Geoffrey Michael,1,0,34,33
1656786916756,MATH 109,B01,083215,Ganzberger; Geoffrey Michael,1,0,32,31
1656786916756,MATH 109,B02,083216,Ganzberger; Geoffrey Michael,1,0,32,31
1656786916756,MATH 109,B03,093479,Ganzberger; Geoffrey Michael,6,0,32,26
1656786922780,MATH 142A,A01,083219,Chow; Bennett,6,0,32,26
1656786922780,MATH 142A,A02,083220,Chow; Bennett,9,0,32,23
1656786922780,MATH 142A,A03,093480,Chow; Bennett,7,0,32,25
1656786922780,MATH 142A,B03,093481,Chow; Bennett,7,0,32,25
1656786922780,MATH 142A,B04,093558,Chow; Bennett,10,0,32,22
1656786922780,MATH 142A,B05,093559,Chow; Bennett,6,0,32,26
1656786928805,MATH 193A,A01,083224,Rotar; Vladimir,6,0,34,28
1656786928805,MATH 193A,A02,083225,Rotar; Vladimir,3,0,34,31
1656786928805,MATH 193A,A03,083781,Rotar; Vladimir,1,0,34,33
1656786928805,MATH 193A,A04,083782,Rotar; Vladimir,6,0,34,28
1656786928805,MATH 193A,A05,093482,Rotar; Vladimir,6,0,34,28
1656786934833,MATH 197,001,091859,McAuley; Julian John,9999,0,9999,0
1656786934833,MATH 197,002,095566,Kedlaya; Kiran S.,9997,0,9999,2
1656786934833,MATH 197,003,095567,Xiao; Ming,9999,0,9999,0
1656786934833,MATH 197,004,095571,Perols; Johan Lars,9998,0,9999,1
1656786941902,COGS 9,A01,083615,Shannon; Kyle Michael,6,0,75,69
1656786947932,COGS 11,A01,083617,Boyle; Mary E. T.,18,0,48,30
1656786953959,COGS 13,A01,083071,Bastos; Amalia Pinkusfeld,8,0,71,63
1656786959984,COGS 14A,A01,092681,Semenuks; Arturs,0,1,100,100
1656786966008,COGS 14B,A01,083073,Cheng; Tzu-Han,5,0,63,58
1656786972032,COGS 17,A01,092677,Semenuks; Arturs,4,0,81,77
1656786978065,COGS 100,A01,083619,Allen; Michael Gordon,15,0,70,55
1656786984090,COGS 101A,A01,083621,Davis; Joshua Daniel,9,0,68,59
1656786990116,COGS 101B,A01,091572,Allen; Michael Gordon,8,0,65,57
1656786996142,COGS 101C,A01,083625,Delgado; Tania,17,0,35,18
1656787002170,COGS 107A,A01,083627,Boyle; Mary E. T.,13,0,60,47
1656787008198,COGS 118A,A01,083075,Gupta; Anjum,15,0,76,61
1656787014223,CSE 3,A50,083646,Miranda; Gregory Joseph,22,0,50,28
1656787020261,CSE 8A,A50,083650,Miranda; Gregory Joseph,17,1,56,39
1656787026285,CSE 11,A01,083080,Cao; Yingjun,4,15,40,36
1656787032313,CSE 12,A01,083652,Krause-Levy; Sophia Louisa,20,1,120,100
1656787038341,CSE 15L,A01,083654,Morris; Justin Loren,8,0,50,42
1656787038341,CSE 15L,A02,083655,Morris; Justin Loren,8,0,50,42
1656787044367,CSE 20,A01,083657,Tran; Khoa Dang,37,0,80,43
1656787050393,CSE 21,A01,095574,Bach; Quang Tran,21,0,48,27
1656787056428,CSE 30,A01,083084,Eldon; John,4,0,80,76
1656787056428,CSE 30,B01,095061,Bhaskar; Nishant,5,0,50,45
1656787062453,CSE 100,A01,083659,Cao; Yingjun,1,4,70,69
1656787068476,CSE 134B,A01,083661,Powell; Thomas Allan,18,0,100,82
1656787074499,CSE 140,A01,083663,Gungor; Onat,14,0,85,71
1656787080528,CSE 140L,A01,083088,Eldon; John,16,0,100,84
1656787086552,CSE 175,A01,083665,Kumar; Rakesh,3,0,25,22
1656787092588,CSE 190,A00,092507,Dubnov; Shlomo,7,0,20,13
1656787098625,ECE 45,A01,083139,Congero; Spencer William,5,0,75,70
1656787104652,ECE 65,A50,083695,Saad; Andrew S,12,0,30,18
1656787104652,ECE 65,A51,095125,Saad; Andrew S,25,0,26,1
1656787110679,ECE 109,A01,091882,Touri; Behrouz,15,0,70,55
1656787116710,ECE 180,A00,083140,Abi Samra; Nicholas Camill,0,0,30,30
1656787116710,ECE 180,B00,083141,Abi Samra; Nicholas Camill,0,0,30,30
1656787122746,MATH 10A,A01,083735,Patchell; Gregory David,1,0,30,29
1656787122746,MATH 10A,A02,083736,Patchell; Gregory David,20,0,30,10
1656787122746,MATH 10A,A03,083737,Patchell; Gregory David,15,0,30,15
1656787128773,MATH 10B,A01,083207,Lim; Seonhee,7,0,34,27
1656787128773,MATH 10B,A02,083208,Lim; Seonhee,9,0,35,26
1656787128773,MATH 10B,A03,093472,Lim; Seonhee,4,0,34,30
1656787128773,MATH 10B,B01,083739,Sinha; Shubham,9,0,30,21
1656787134816,MATH 18,A01,083743,Cinel; Cameron Alexander,6,0,30,24
1656787134816,MATH 18,A02,083744,Cinel; Cameron Alexander,15,0,30,15
1656787134816,MATH 18,A03,083745,Cinel; Cameron Alexander,8,0,30,22
1656787134816,MATH 18,B01,083748,Rideout; David Porter,3,0,37,34
1656787134816,MATH 18,B02,083749,Rideout; David Porter,3,0,36,33
1656787134816,MATH 18,B03,083750,Rideout; David Porter,1,0,37,36
1656787134816,MATH 18,B04,083751,Rideout; David Porter,5,0,36,31
1656787134816,MATH 18,B05,093473,Rideout; David Porter,4,0,36,32
1656787134816,MATH 18,B06,093474,Rideout; David Porter,5,0,36,31
1656787140841,MATH 20A,A01,083754,Zheng; Zequn,12,0,40,28
1656787146873,MATH 20B,A01,083756,Briones; Jor-el Thomas Caparas,1,0,36,35
1656787146873,MATH 20B,A02,083757,Briones; Jor-el Thomas Caparas,1,0,36,35
1656787146873,MATH 20B,A03,093475,Briones; Jor-el Thomas Caparas,0,0,36,36
1656787152899,MATH 20C,A01,083760,Briones; Jor-el Thomas Caparas,1,0,35,34
1656787152899,MATH 20C,A02,083761,Briones; Jor-el Thomas Caparas,8,0,35,27
1656787152899,MATH 20C,A03,093476,Briones; Jor-el Thomas Caparas,0,1,36,36
1656787152899,MATH 20C,B01,083762,Bach; Quang Tran,0,0,30,30
1656787158927,MATH 20D,A01,083765,Tran; Brian Kha,4,0,30,26
1656787158927,MATH 20D,A02,083766,Tran; Brian Kha,4,0,30,26
1656787158927,MATH 20D,A03,083767,Tran; Brian Kha,2,0,30,28
1656787164975,MATH 20E,A01,083771,Ganguly; Soumya,5,0,32,27
1656787164975,MATH 20E,A02,083772,Ganguly; Soumya,5,0,32,27
1656787164975,MATH 20E,B01,083773,Ciotti; Benjamin,18,0,35,17
1656787164975,MATH 20E,B02,083774,Ciotti; Benjamin,17,0,35,18
1656787171009,MATH 103A,A01,083777,Greenfeld; Be'Eri,2,0,36,34
1656787171009,MATH 103A,A02,083778,Greenfeld; Be'Eri,5,0,36,31
1656787171009,MATH 103A,A03,093561,Greenfeld; Be'Eri,4,0,36,32
1656787171009,MATH 103A,B01,083779,Greenfeld; Be'Eri,6,0,36,30
1656787171009,MATH 103A,B02,083780,Greenfeld; Be'Eri,2,0,36,34
1656787171009,MATH 103A,B03,093562,Greenfeld; Be'Eri,2,0,36,34
1656787177038,MATH 105,A01,085443,Carter; Anne Toulson,13,0,35,22
1656787177038,MATH 105,A02,093477,Carter; Anne Toulson,20,0,35,15
1656787183066,MATH 109,A01,083213,Ganzberger; Geoffrey Michael,2,0,34,32
1656787183066,MATH 109,A02,083214,Ganzberger; Geoffrey Michael,2,0,34,32
1656787183066,MATH 109,A03,093478,Ganzberger; Geoffrey Michael,1,0,34,33
1656787183066,MATH 109,B01,083215,Ganzberger; Geoffrey Michael,1,0,32,31
1656787183066,MATH 109,B02,083216,Ganzberger; Geoffrey Michael,1,0,32,31
1656787183066,MATH 109,B03,093479,Ganzberger; Geoffrey Michael,6,0,32,26
1656787189100,MATH 142A,A01,083219,Chow; Bennett,6,0,32,26
1656787189100,MATH 142A,A02,083220,Chow; Bennett,9,0,32,23
1656787189100,MATH 142A,A03,093480,Chow; Bennett,7,0,32,25
1656787189100,MATH 142A,B03,093481,Chow; Bennett,7,0,32,25
1656787189100,MATH 142A,B04,093558,Chow; Bennett,10,0,32,22
1656787189100,MATH 142A,B05,093559,Chow; Bennett,6,0,32,26
1656787195126,MATH 193A,A01,083224,Rotar; Vladimir,6,0,34,28
1656787195126,MATH 193A,A02,083225,Rotar; Vladimir,3,0,34,31
1656787195126,MATH 193A,A03,083781,Rotar; Vladimir,1,0,34,33
1656787195126,MATH 193A,A04,083782,Rotar; Vladimir,6,0,34,28
1656787195126,MATH 193A,A05,093482,Rotar; Vladimir,6,0,34,28
1656787201151,MATH 197,001,091859,McAuley; Julian John,9999,0,9999,0
1656787201151,MATH 197,002,095566,Kedlaya; Kiran S.,9997,0,9999,2
1656787201151,MATH 197,003,095567,Xiao; Ming,9999,0,9999,0
1656787201151,MATH 197,004,095571,Perols; Johan Lars,9998,0,9999,1
1656787208212,COGS 9,A01,083615,Shannon; Kyle Michael,6,0,75,69
1656787214243,COGS 11,A01,083617,Boyle; Mary E. T.,18,0,48,30
1656787220267,COGS 13,A01,083071,Bastos; Amalia Pinkusfeld,8,0,71,63
1656787226306,COGS 14A,A01,092681,Semenuks; Arturs,0,1,100,100
1656787232347,COGS 14B,A01,083073,Cheng; Tzu-Han,5,0,63,58
1656787238371,COGS 17,A01,092677,Semenuks; Arturs,4,0,81,77
1656787244398,COGS 100,A01,083619,Allen; Michael Gordon,15,0,70,55
1656787250421,COGS 101A,A01,083621,Davis; Joshua Daniel,9,0,68,59
1656787256445,COGS 101B,A01,091572,Allen; Michael Gordon,8,0,65,57
1656787262468,COGS 101C,A01,083625,Delgado; Tania,17,0,35,18
1656787268507,COGS 107A,A01,083627,Boyle; Mary E. T.,13,0,60,47
1656787274531,COGS 118A,A01,083075,Gupta; Anjum,15,0,76,61
1656787280557,CSE 3,A50,083646,Miranda; Gregory Joseph,22,0,50,28
1656787286582,CSE 8A,A50,083650,Miranda; Gregory Joseph,17,1,56,39
1656787292607,CSE 11,A01,083080,Cao; Yingjun,4,15,40,36
1656787298636,CSE 12,A01,083652,Krause-Levy; Sophia Louisa,20,1,120,100
1656787304666,CSE 15L,A01,083654,Morris; Justin Loren,8,0,50,42
1656787304666,CSE 15L,A02,083655,Morris; Justin Loren,8,0,50,42
1656787310692,CSE 20,A01,083657,Tran; Khoa Dang,37,0,80,43
1656787316722,CSE 21,A01,095574,Bach; Quang Tran,21,0,48,27
1656787322754,CSE 30,A01,083084,Eldon; John,4,0,80,76
1656787322754,CSE 30,B01,095061,Bhaskar; Nishant,5,0,50,45
1656787328778,CSE 100,A01,083659,Cao; Yingjun,1,4,70,69
1656787334804,CSE 134B,A01,083661,Powell; Thomas Allan,18,0,100,82
1656787340830,CSE 140,A01,083663,Gungor; Onat,14,0,85,71
1656787346858,CSE 140L,A01,083088,Eldon; John,16,0,100,84
1656787352896,CSE 175,A01,083665,Kumar; Rakesh,3,0,25,22
1656787358919,CSE 190,A00,092507,Dubnov; Shlomo,7,0,20,13
1656787364948,ECE 45,A01,083139,Congero; Spencer William,5,0,75,70
1656787370974,ECE 65,A50,083695,Saad; Andrew S,12,0,30,18
1656787370974,ECE 65,A51,095125,Saad; Andrew S,25,0,26,1
1656787377004,ECE 109,A01,091882,Touri; Behrouz,15,0,70,55
1656787383042,ECE 180,A00,083140,Abi Samra; Nicholas Camill,0,0,30,30
1656787383042,ECE 180,B00,083141,Abi Samra; Nicholas Camill,0,0,30,30
1656787389149,MATH 10A,A01,083735,Patchell; Gregory David,1,0,30,29
1656787389149,MATH 10A,A02,083736,Patchell; Gregory David,20,0,30,10
1656787389149,MATH 10A,A03,083737,Patchell; Gregory David,15,0,30,15
1656787395195,MATH 10B,A01,083207,Lim; Seonhee,7,0,34,27
1656787395195,MATH 10B,A02,083208,Lim; Seonhee,9,0,35,26
1656787395195,MATH 10B,A03,093472,Lim; Seonhee,4,0,34,30
1656787395195,MATH 10B,B01,083739,Sinha; Shubham,9,0,30,21
1656787401224,MATH 18,A01,083743,Cinel; Cameron Alexander,6,0,30,24
1656787401224,MATH 18,A02,083744,Cinel; Cameron Alexander,15,0,30,15
1656787401224,MATH 18,A03,083745,Cinel; Cameron Alexander,8,0,30,22
1656787401224,MATH 18,B01,083748,Rideout; David Porter,3,0,37,34
1656787401224,MATH 18,B02,083749,Rideout; David Porter,3,0,36,33
1656787401224,MATH 18,B03,083750,Rideout; David Porter,1,0,37,36
1656787401224,MATH 18,B04,083751,Rideout; David Porter,5,0,36,31
1656787401224,MATH 18,B05,093473,Rideout; David Porter,4,0,36,32
1656787401224,MATH 18,B06,093474,Rideout; David Porter,5,0,36,31
1656787407248,MATH 20A,A01,083754,Zheng; Zequn,12,0,40,28
1656787413274,MATH 20B,A01,083756,Briones; Jor-el Thomas Caparas,1,0,36,35
1656787413274,MATH 20B,A02,083757,Briones; Jor-el Thomas Caparas,1,0,36,35
1656787413274,MATH 20B,A03,093475,Briones; Jor-el Thomas Caparas,0,0,36,36
1656787419305,MATH 20C,A01,083760,Briones; Jor-el Thomas Caparas,1,0,35,34
1656787419305,MATH 20C,A02,083761,Briones; Jor-el Thomas Caparas,8,0,35,27
1656787419305,MATH 20C,A03,093476,Briones; Jor-el Thomas Caparas,0,1,36,36
1656787419305,MATH 20C,B01,083762,Bach; Quang Tran,0,0,30,30
1656787425334,MATH 20D,A01,083765,Tran; Brian Kha,4,0,30,26
1656787425334,MATH 20D,A02,083766,Tran; Brian Kha,4,0,30,26
1656787425334,MATH 20D,A03,083767,Tran; Brian Kha,2,0,30,28
1656787431367,MATH 20E,A01,083771,Ganguly; Soumya,5,0,32,27
1656787431367,MATH 20E,A02,083772,Ganguly; Soumya,5,0,32,27
1656787431367,MATH 20E,B01,083773,Ciotti; Benjamin,18,0,35,17
1656787431367,MATH 20E,B02,083774,Ciotti; Benjamin,17,0,35,18
1656787437394,MATH 103A,A01,083777,Greenfeld; Be'Eri,2,0,36,34
1656787437394,MATH 103A,A02,083778,Greenfeld; Be'Eri,5,0,36,31
1656787437394,MATH 103A,A03,093561,Greenfeld; Be'Eri,4,0,36,32
1656787437394,MATH 103A,B01,083779,Greenfeld; Be'Eri,6,0,36,30
1656787437394,MATH 103A,B02,083780,Greenfeld; Be'Eri,2,0,36,34
1656787437394,MATH 103A,B03,093562,Greenfeld; Be'Eri,2,0,36,34
1656787443421,MATH 105,A01,085443,Carter; Anne Toulson,13,0,35,22
1656787443421,MATH 105,A02,093477,Carter; Anne Toulson,20,0,35,15
1656787449451,MATH 109,A01,083213,Ganzberger; Geoffrey Michael,2,0,34,32
1656787449451,MATH 109,A02,083214,Ganzberger; Geoffrey Michael,2,0,34,32
1656787449451,MATH 109,A03,093478,Ganzberger; Geoffrey Michael,1,0,34,33
1656787449451,MATH 109,B01,083215,Ganzberger; Geoffrey Michael,1,0,32,31
1656787449451,MATH 109,B02,083216,Ganzberger; Geoffrey Michael,1,0,32,31
1656787449451,MATH 109,B03,093479,Ganzberger; Geoffrey Michael,6,0,32,26
1656787455486,MATH 142A,A01,083219,Chow; Bennett,6,0,32,26
1656787455486,MATH 142A,A02,083220,Chow; Bennett,9,0,32,23
1656787455486,MATH 142A,A03,093480,Chow; Bennett,7,0,32,25
1656787455486,MATH 142A,B03,093481,Chow; Bennett,7,0,32,25
1656787455486,MATH 142A,B04,093558,Chow; Bennett,10,0,32,22
1656787455486,MATH 142A,B05,093559,Chow; Bennett,6,0,32,26
1656787461510,MATH 193A,A01,083224,Rotar; Vladimir,6,0,34,28
1656787461510,MATH 193A,A02,083225,Rotar; Vladimir,3,0,34,31
1656787461510,MATH 193A,A03,083781,Rotar; Vladimir,1,0,34,33
1656787461510,MATH 193A,A04,083782,Rotar; Vladimir,6,0,34,28
1656787461510,MATH 193A,A05,093482,Rotar; Vladimir,6,0,34,28
1656787467538,MATH 197,001,091859,McAuley; Julian John,9999,0,9999,0
1656787467538,MATH 197,002,095566,Kedlaya; Kiran S.,9997,0,9999,2
1656787467538,MATH 197,003,095567,Xiao; Ming,9999,0,9999,0
1656787467538,MATH 197,004,095571,Perols; Johan Lars,9998,0,9999,1
1656787474606,COGS 9,A01,083615,Shannon; Kyle Michael,6,0,75,69
1656787480634,COGS 11,A01,083617,Boyle; Mary E. T.,18,0,48,30
1656787486665,COGS 13,A01,083071,Bastos; Amalia Pinkusfeld,8,0,71,63
1656787492687,COGS 14A,A01,092681,Semenuks; Arturs,0,1,100,100
1656787498713,COGS 14B,A01,083073,Cheng; Tzu-Han,5,0,63,58
1656787504736,COGS 17,A01,092677,Semenuks; Arturs,4,0,81,77
1656787510761,COGS 100,A01,083619,Allen; Michael Gordon,15,0,70,55
1656787516785,COGS 101A,A01,083621,Davis; Joshua Daniel,9,0,68,59
1656787522809,COGS 101B,A01,091572,Allen; Michael Gordon,8,0,65,57
1656787528833,COGS 101C,A01,083625,Delgado; Tania,17,0,35,18
1656787534858,COGS 107A,A01,083627,Boyle; Mary E. T.,13,0,60,47
1656787540886,COGS 118A,A01,083075,Gupta; Anjum,15,0,76,61
1656787546919,CSE 3,A50,083646,Miranda; Gregory Joseph,22,0,50,28
1656787552941,CSE 8A,A50,083650,Miranda; Gregory Joseph,17,1,56,39
1656787558966,CSE 11,A01,083080,Cao; Yingjun,4,15,40,36
1656787564992,CSE 12,A01,083652,Krause-Levy; Sophia Louisa,20,1,120,100
1656787571018,CSE 15L,A01,083654,Morris; Justin Loren,8,0,50,42
1656787571018,CSE 15L,A02,083655,Morris; Justin Loren,8,0,50,42
1656787577043,CSE 20,A01,083657,Tran; Khoa Dang,37,0,80,43
1656787583067,CSE 21,A01,095574,Bach; Quang Tran,21,0,48,27
1656787589097,CSE 30,A01,083084,Eldon; John,4,0,80,76
1656787589097,CSE 30,B01,095061,Bhaskar; Nishant,5,0,50,45
1656787595122,CSE 100,A01,083659,Cao; Yingjun,1,4,70,69
1656787601149,CSE 134B,A01,083661,Powell; Thomas Allan,18,0,100,82
1656787607172,CSE 140,A01,083663,Gungor; Onat,14,0,85,71
1656787613196,CSE 140L,A01,083088,Eldon; John,16,0,100,84
1656787619220,CSE 175,A01,083665,Kumar; Rakesh,3,0,25,22
1656787625251,CSE 190,A00,092507,Dubnov; Shlomo,7,0,20,13
1656787631274,ECE 45,A01,083139,Congero; Spencer William,5,0,75,70
1656787637301,ECE 65,A50,083695,Saad; Andrew S,12,0,30,18
1656787637301,ECE 65,A51,095125,Saad; Andrew S,25,0,26,1
1656787643323,ECE 109,A01,091882,Touri; Behrouz,15,0,70,55
1656787649348,ECE 180,A00,083140,Abi Samra; Nicholas Camill,0,0,30,30
1656787649348,ECE 180,B00,083141,Abi Samra; Nicholas Camill,0,0,30,30
1656787655376,MATH 10A,A01,083735,Patchell; Gregory David,1,0,30,29
1656787655376,MATH 10A,A02,083736,Patchell; Gregory David,20,0,30,10
1656787655376,MATH 10A,A03,083737,Patchell; Gregory David,15,0,30,15
1656787661408,MATH 10B,A01,083207,Lim; Seonhee,7,0,34,27
1656787661408,MATH 10B,A02,083208,Lim; Seonhee,9,0,35,26
1656787661408,MATH 10B,A03,093472,Lim; Seonhee,4,0,34,30
1656787661408,MATH 10B,B01,083739,Sinha; Shubham,9,0,30,21
1656787667436,MATH 18,A01,083743,Cinel; Cameron Alexander,6,0,30,24
1656787667436,MATH 18,A02,083744,Cinel; Cameron Alexander,15,0,30,15
1656787667436,MATH 18,A03,083745,Cinel; Cameron Alexander,8,0,30,22
1656787667436,MATH 18,B01,083748,Rideout; David Porter,3,0,37,34
1656787667436,MATH 18,B02,083749,Rideout; David Porter,3,0,36,33
1656787667436,MATH 18,B03,083750,Rideout; David Porter,1,0,37,36
1656787667436,MATH 18,B04,083751,Rideout; David Porter,5,0,36,31
1656787667436,MATH 18,B05,093473,Rideout; David Porter,4,0,36,32
1656787667436,MATH 18,B06,093474,Rideout; David Porter,5,0,36,31
1656787673467,MATH 20A,A01,083754,Zheng; Zequn,12,0,40,28
1656787679493,MATH 20B,A01,083756,Briones; Jor-el Thomas Caparas,1,0,36,35
1656787679493,MATH 20B,A02,083757,Briones; Jor-el Thomas Caparas,1,0,36,35
1656787679493,MATH 20B,A03,093475,Briones; Jor-el Thomas Caparas,0,0,36,36
1656787685518,MATH 20C,A01,083760,Briones; Jor-el Thomas Caparas,1,0,35,34
1656787685518,MATH 20C,A02,083761,Briones; Jor-el Thomas Caparas,8,0,35,27
1656787685518,MATH 20C,A03,093476,Briones; Jor-el Thomas Caparas,0,1,36,36
1656787685518,MATH 20C,B01,083762,Bach; Quang Tran,0,0,30,30
1656787691545,MATH 20D,A01,083765,Tran; Brian Kha,4,0,30,26
1656787691545,MATH 20D,A02,083766,Tran; Brian Kha,4,0,30,26
1656787691545,MATH 20D,A03,083767,Tran; Brian Kha,2,0,30,28
1656787697571,MATH 20E,A01,083771,Ganguly; Soumya,5,0,32,27
1656787697571,MATH 20E,A02,083772,Ganguly; Soumya,5,0,32,27
1656787697571,MATH 20E,B01,083773,Ciotti; Benjamin,18,0,35,17
1656787697571,MATH 20E,B02,083774,Ciotti; Benjamin,17,0,35,18
1656787703605,MATH 103A,A01,083777,Greenfeld; Be'Eri,2,0,36,34
1656787703605,MATH 103A,A02,083778,Greenfeld; Be'Eri,5,0,36,31
1656787703605,MATH 103A,A03,093561,Greenfeld; Be'Eri,4,0,36,32
1656787703605,MATH 103A,B01,083779,Greenfeld; Be'Eri,6,0,36,30
1656787703605,MATH 103A,B02,083780,Greenfeld; Be'Eri,2,0,36,34
1656787703605,MATH 103A,B03,093562,Greenfeld; Be'Eri,2,0,36,34
1656787709635,MATH 105,A01,085443,Carter; Anne Toulson,13,0,35,22
1656787709635,MATH 105,A02,093477,Carter; Anne Toulson,20,0,35,15
1656787715662,MATH 109,A01,083213,Ganzberger; Geoffrey Michael,2,0,34,32
1656787715662,MATH 109,A02,083214,Ganzberger; Geoffrey Michael,2,0,34,32
1656787715662,MATH 109,A03,093478,Ganzberger; Geoffrey Michael,1,0,34,33
1656787715662,MATH 109,B01,083215,Ganzberger; Geoffrey Michael,1,0,32,31
1656787715662,MATH 109,B02,083216,Ganzberger; Geoffrey Michael,1,0,32,31
1656787715662,MATH 109,B03,093479,Ganzberger; Geoffrey Michael,6,0,32,26
1656787721694,MATH 142A,A01,083219,Chow; Bennett,6,0,32,26
1656787721694,MATH 142A,A02,083220,Chow; Bennett,9,0,32,23
1656787721694,MATH 142A,A03,093480,Chow; Bennett,7,0,32,25
1656787721694,MATH 142A,B03,093481,Chow; Bennett,7,0,32,25
1656787721694,MATH 142A,B04,093558,Chow; Bennett,10,0,32,22
1656787721694,MATH 142A,B05,093559,Chow; Bennett,6,0,32,26
1656787727723,MATH 193A,A01,083224,Rotar; Vladimir,6,0,34,28
1656787727723,MATH 193A,A02,083225,Rotar; Vladimir,3,0,34,31
1656787727723,MATH 193A,A03,083781,Rotar; Vladimir,1,0,34,33
1656787727723,MATH 193A,A04,083782,Rotar; Vladimir,6,0,34,28
1656787727723,MATH 193A,A05,093482,Rotar; Vladimir,6,0,34,28
1656787733749,MATH 197,001,091859,McAuley; Julian John,9999,0,9999,0
1656787733749,MATH 197,002,095566,Kedlaya; Kiran S.,9997,0,9999,2
1656787733749,MATH 197,003,095567,Xiao; Ming,9999,0,9999,0
1656787733749,MATH 197,004,095571,Perols; Johan Lars,9998,0,9999,1
1656787740823,COGS 9,A01,083615,Shannon; Kyle Michael,6,0,75,69
1656787746849,COGS 11,A01,083617,Boyle; Mary E. T.,18,0,48,30
1656787752877,COGS 13,A01,083071,Bastos; Amalia Pinkusfeld,8,0,71,63
1656787758909,COGS 14A,A01,092681,Semenuks; Arturs,0,1,100,100
1656787764937,COGS 14B,A01,083073,Cheng; Tzu-Han,5,0,63,58
1656787770962,COGS 17,A01,092677,Semenuks; Arturs,4,0,81,77
1656787776991,COGS 100,A01,083619,Allen; Michael Gordon,15,0,70,55
1656787783018,COGS 101A,A01,083621,Davis; Joshua Daniel,9,0,68,59
1656787789045,COGS 101B,A01,091572,Allen; Michael Gordon,8,0,65,57
1656787795078,COGS 101C,A01,083625,Delgado; Tania,17,0,35,18
1656787801107,COGS 107A,A01,083627,Boyle; Mary E. T.,13,0,60,47
1656787807132,COGS 118A,A01,083075,Gupta; Anjum,15,0,76,61
1656787813160,CSE 3,A50,083646,Miranda; Gregory Joseph,22,0,50,28
1656787819194,CSE 8A,A50,083650,Miranda; Gregory Joseph,17,1,56,39
1656787825218,CSE 11,A01,083080,Cao; Yingjun,4,15,40,36
1656787831247,CSE 12,A01,083652,Krause-Levy; Sophia Louisa,20,1,120,100
1656787837271,CSE 15L,A01,083654,Morris; Justin Loren,8,0,50,42
1656787837271,CSE 15L,A02,083655,Morris; Justin Loren,8,0,50,42
1656787843300,CSE 20,A01,083657,Tran; Khoa Dang,37,0,80,43
1656787849324,CSE 21,A01,095574,Bach; Quang Tran,21,0,48,27
1656787855350,CSE 30,A01,083084,Eldon; John,4,0,80,76
1656787855350,CSE 30,B01,095061,Bhaskar; Nishant,5,0,50,45
1656787861379,CSE 100,A01,083659,Cao; Yingjun,1,4,70,69
1656787867404,CSE 134B,A01,083661,Powell; Thomas Allan,18,0,100,82
1656787873428,CSE 140,A01,083663,Gungor; Onat,14,0,85,71
1656787879455,CSE 140L,A01,083088,Eldon; John,16,0,100,84
1656787885479,CSE 175,A01,083665,Kumar; Rakesh,3,0,25,22
1656787891504,CSE 190,A00,092507,Dubnov; Shlomo,7,0,20,13
1656787897528,ECE 45,A01,083139,Congero; Spencer William,5,0,75,70
1656787903555,ECE 65,A50,083695,Saad; Andrew S,12,0,30,18
1656787903555,ECE 65,A51,095125,Saad; Andrew S,25,0,26,1
1656787909578,ECE 109,A01,091882,Touri; Behrouz,15,0,70,55
1656787915617,ECE 180,A00,083140,Abi Samra; Nicholas Camill,0,0,30,30
1656787915617,ECE 180,B00,083141,Abi Samra; Nicholas Camill,0,0,30,30
1656787921644,MATH 10A,A01,083735,Patchell; Gregory David,1,0,30,29
1656787921644,MATH 10A,A02,083736,Patchell; Gregory David,20,0,30,10
1656787921644,MATH 10A,A03,083737,Patchell; Gregory David,15,0,30,15
1656787927671,MATH 10B,A01,083207,Lim; Seonhee,7,0,34,27
1656787927671,MATH 10B,A02,083208,Lim; Seonhee,9,0,35,26
1656787927671,MATH 10B,A03,093472,Lim; Seonhee,4,0,34,30
1656787927671,MATH 10B,B01,083739,Sinha; Shubham,9,0,30,21
1656787933696,MATH 18,A01,083743,Cinel; Cameron Alexander,6,0,30,24
1656787933696,MATH 18,A02,083744,Cinel; Cameron Alexander,15,0,30,15
1656787933696,MATH 18,A03,083745,Cinel; Cameron Alexander,8,0,30,22
1656787933696,MATH 18,B01,083748,Rideout; David Porter,3,0,37,34
1656787933696,MATH 18,B02,083749,Rideout; David Porter,3,0,36,33
1656787933696,MATH 18,B03,083750,Rideout; David Porter,1,0,37,36
1656787933696,MATH 18,B04,083751,Rideout; David Porter,5,0,36,31
1656787933696,MATH 18,B05,093473,Rideout; David Porter,4,0,36,32
1656787933696,MATH 18,B06,093474,Rideout; David Porter,5,0,36,31
1656787939719,MATH 20A,A01,083754,Zheng; Zequn,12,0,40,28
1656787945751,MATH 20B,A01,083756,Briones; Jor-el Thomas Caparas,1,0,36,35
1656787945751,MATH 20B,A02,083757,Briones; Jor-el Thomas Caparas,1,0,36,35
1656787945751,MATH 20B,A03,093475,Briones; Jor-el Thomas Caparas,0,0,36,36
1656787951777,MATH 20C,A01,083760,Briones; Jor-el Thomas Caparas,1,0,35,34
1656787951777,MATH 20C,A02,083761,Briones; Jor-el Thomas Caparas,8,0,35,27
1656787951777,MATH 20C,A03,093476,Briones; Jor-el Thomas Caparas,0,1,36,36
1656787951777,MATH 20C,B01,083762,Bach; Quang Tran,0,0,30,30
1656787957807,MATH 20D,A01,083765,Tran; Brian Kha,4,0,30,26
1656787957807,MATH 20D,A02,083766,Tran; Brian Kha,4,0,30,26
1656787957807,MATH 20D,A03,083767,Tran; Brian Kha,2,0,30,28
1656787963843,MATH 20E,A01,083771,Ganguly; Soumya,5,0,32,27
1656787963843,MATH 20E,A02,083772,Ganguly; Soumya,5,0,32,27
1656787963843,MATH 20E,B01,083773,Ciotti; Benjamin,18,0,35,17
1656787963843,MATH 20E,B02,083774,Ciotti; Benjamin,17,0,35,18
1656787969868,MATH 103A,A01,083777,Greenfeld; Be'Eri,2,0,36,34
1656787969868,MATH 103A,A02,083778,Greenfeld; Be'Eri,5,0,36,31
1656787969868,MATH 103A,A03,093561,Greenfeld; Be'Eri,4,0,36,32
1656787969868,MATH 103A,B01,083779,Greenfeld; Be'Eri,6,0,36,30
1656787969868,MATH 103A,B02,083780,Greenfeld; Be'Eri,2,0,36,34
1656787969868,MATH 103A,B03,093562,Greenfeld; Be'Eri,2,0,36,34
1656787975897,MATH 105,A01,085443,Carter; Anne Toulson,13,0,35,22
1656787975897,MATH 105,A02,093477,Carter; Anne Toulson,20,0,35,15
1656787981927,MATH 109,A01,083213,Ganzberger; Geoffrey Michael,2,0,34,32
1656787981927,MATH 109,A02,083214,Ganzberger; Geoffrey Michael,2,0,34,32
1656787981927,MATH 109,A03,093478,Ganzberger; Geoffrey Michael,1,0,34,33
1656787981927,MATH 109,B01,083215,Ganzberger; Geoffrey Michael,1,0,32,31
1656787981927,MATH 109,B02,083216,Ganzberger; Geoffrey Michael,1,0,32,31
1656787981927,MATH 109,B03,093479,Ganzberger; Geoffrey Michael,6,0,32,26
1656787988025,MATH 142A,A01,083219,Chow; Bennett,6,0,32,26
1656787988025,MATH 142A,A02,083220,Chow; Bennett,9,0,32,23
1656787988025,MATH 142A,A03,093480,Chow; Bennett,7,0,32,25
1656787988025,MATH 142A,B03,093481,Chow; Bennett,7,0,32,25
1656787988025,MATH 142A,B04,093558,Chow; Bennett,10,0,32,22
1656787988025,MATH 142A,B05,093559,Chow; Bennett,6,0,32,26
1656787994049,MATH 193A,A01,083224,Rotar; Vladimir,6,0,34,28
1656787994049,MATH 193A,A02,083225,Rotar; Vladimir,3,0,34,31
1656787994049,MATH 193A,A03,083781,Rotar; Vladimir,1,0,34,33
1656787994049,MATH 193A,A04,083782,Rotar; Vladimir,6,0,34,28
1656787994049,MATH 193A,A05,093482,Rotar; Vladimir,6,0,34,28
1656788000097,MATH 197,001,091859,McAuley; Julian John,9999,0,9999,0
1656788000097,MATH 197,002,095566,Kedlaya; Kiran S.,9997,0,9999,2
1656788000097,MATH 197,003,095567,Xiao; Ming,9999,0,9999,0
1656788000097,MATH 197,004,095571,Perols; Johan Lars,9998,0,9999,1
1656788007174,COGS 9,A01,083615,Shannon; Kyle Michael,6,0,75,69
1656788013199,COGS 11,A01,083617,Boyle; Mary E. T.,18,0,48,30
1656788019222,COGS 13,A01,083071,Bastos; Amalia Pinkusfeld,8,0,71,63
1656788025250,COGS 14A,A01,092681,Semenuks; Arturs,0,1,100,100
1656788031280,COGS 14B,A01,083073,Cheng; Tzu-Han,5,0,63,58
1656788037301,COGS 17,A01,092677,Semenuks; Arturs,4,0,81,77
1656788043327,COGS 100,A01,083619,Allen; Michael Gordon,15,0,70,55
1656788049352,COGS 101A,A01,083621,Davis; Joshua Daniel,9,0,68,59
1656788055380,COGS 101B,A01,091572,Allen; Michael Gordon,8,0,65,57
1656788061405,COGS 101C,A01,083625,Delgado; Tania,17,0,35,18
1656788067432,COGS 107A,A01,083627,Boyle; Mary E. T.,13,0,60,47
1656788073458,COGS 118A,A01,083075,Gupta; Anjum,15,0,76,61
1656788079491,CSE 3,A50,083646,Miranda; Gregory Joseph,22,0,50,28
1656788085516,CSE 8A,A50,083650,Miranda; Gregory Joseph,17,1,56,39
1656788091537,CSE 11,A01,083080,Cao; Yingjun,4,15,40,36
1656788097563,CSE 12,A01,083652,Krause-Levy; Sophia Louisa,20,1,120,100
1656788103588,CSE 15L,A01,083654,Morris; Justin Loren,8,0,50,42
1656788103588,CSE 15L,A02,083655,Morris; Justin Loren,8,0,50,42
1656788109612,CSE 20,A01,083657,Tran; Khoa Dang,37,0,80,43
1656788115638,CSE 21,A01,095574,Bach; Quang Tran,21,0,48,27
1656788121668,CSE 30,A01,083084,Eldon; John,4,0,80,76
1656788121668,CSE 30,B01,095061,Bhaskar; Nishant,5,0,50,45
1656788127693,CSE 100,A01,083659,Cao; Yingjun,1,4,70,69
1656788133716,CSE 134B,A01,083661,Powell; Thomas Allan,18,0,100,82
1656788139748,CSE 140,A01,083663,Gungor; Onat,14,0,85,71
1656788145770,CSE 140L,A01,083088,Eldon; John,16,0,100,84
1656788151794,CSE 175,A01,083665,Kumar; Rakesh,3,0,25,22
1656788157817,CSE 190,A00,092507,Dubnov; Shlomo,7,0,20,13
1656788163849,ECE 45,A01,083139,Congero; Spencer William,5,0,75,70
1656788169874,ECE 65,A50,083695,Saad; Andrew S,12,0,30,18
1656788169874,ECE 65,A51,095125,Saad; Andrew S,25,0,26,1
1656788175902,ECE 109,A01,091882,Touri; Behrouz,15,0,70,55
1656788181936,ECE 180,A00,083140,Abi Samra; Nicholas Camill,0,0,30,30
1656788181936,ECE 180,B00,083141,Abi Samra; Nicholas Camill,0,0,30,30
1656788187967,MATH 10A,A01,083735,Patchell; Gregory David,1,0,30,29
1656788187967,MATH 10A,A02,083736,Patchell; Gregory David,20,0,30,10
1656788187967,MATH 10A,A03,083737,Patchell; Gregory David,15,0,30,15
1656788194003,MATH 10B,A01,083207,Lim; Seonhee,7,0,34,27
1656788194003,MATH 10B,A02,083208,Lim; Seonhee,9,0,35,26
1656788194003,MATH 10B,A03,093472,Lim; Seonhee,4,0,34,30
1656788194003,MATH 10B,B01,083739,Sinha; Shubham,9,0,30,21
1656788200041,MATH 18,A01,083743,Cinel; Cameron Alexander,6,0,30,24
1656788200041,MATH 18,A02,083744,Cinel; Cameron Alexander,15,0,30,15
1656788200041,MATH 18,A03,083745,Cinel; Cameron Alexander,8,0,30,22
1656788200041,MATH 18,B01,083748,Rideout; David Porter,3,0,37,34
1656788200041,MATH 18,B02,083749,Rideout; David Porter,3,0,36,33
1656788200041,MATH 18,B03,083750,Rideout; David Porter,1,0,37,36
1656788200041,MATH 18,B04,083751,Rideout; David Porter,5,0,36,31
1656788200041,MATH 18,B05,093473,Rideout; David Porter,4,0,36,32
1656788200041,MATH 18,B06,093474,Rideout; David Porter,5,0,36,31
1656788206066,MATH 20A,A01,083754,Zheng; Zequn,12,0,40,28
1656788212097,MATH 20B,A01,083756,Briones; Jor-el Thomas Caparas,1,0,36,35
1656788212097,MATH 20B,A02,083757,Briones; Jor-el Thomas Caparas,1,0,36,35
1656788212097,MATH 20B,A03,093475,Briones; Jor-el Thomas Caparas,0,0,36,36
1656788218124,MATH 20C,A01,083760,Briones; Jor-el Thomas Caparas,1,0,35,34
1656788218124,MATH 20C,A02,083761,Briones; Jor-el Thomas Caparas,8,0,35,27
1656788218124,MATH 20C,A03,093476,Briones; Jor-el Thomas Caparas,0,1,36,36
1656788218124,MATH 20C,B01,083762,Bach; Quang Tran,0,0,30,30
1656788224152,MATH 20D,A01,083765,Tran; Brian Kha,4,0,30,26
1656788224152,MATH 20D,A02,083766,Tran; Brian Kha,4,0,30,26
1656788224152,MATH 20D,A03,083767,Tran; Brian Kha,2,0,30,28
1656788230184,MATH 20E,A01,083771,Ganguly; Soumya,5,0,32,27
1656788230184,MATH 20E,A02,083772,Ganguly; Soumya,5,0,32,27
1656788230184,MATH 20E,B01,083773,Ciotti; Benjamin,18,0,35,17
1656788230184,MATH 20E,B02,083774,Ciotti; Benjamin,17,0,35,18
1656788236210,MATH 103A,A01,083777,Greenfeld; Be'Eri,2,0,36,34
1656788236210,MATH 103A,A02,083778,Greenfeld; Be'Eri,5,0,36,31
1656788236210,MATH 103A,A03,093561,Greenfeld; Be'Eri,4,0,36,32
1656788236210,MATH 103A,B01,083779,Greenfeld; Be'Eri,6,0,36,30
1656788236210,MATH 103A,B02,083780,Greenfeld; Be'Eri,2,0,36,34
1656788236210,MATH 103A,B03,093562,Greenfeld; Be'Eri,2,0,36,34
1656788242237,MATH 105,A01,085443,Carter; Anne Toulson,13,0,35,22
1656788242237,MATH 105,A02,093477,Carter; Anne Toulson,20,0,35,15
1656788248262,MATH 109,A01,083213,Ganzberger; Geoffrey Michael,2,0,34,32
1656788248262,MATH 109,A02,083214,Ganzberger; Geoffrey Michael,2,0,34,32
1656788248262,MATH 109,A03,093478,Ganzberger; Geoffrey Michael,1,0,34,33
1656788248262,MATH 109,B01,083215,Ganzberger; Geoffrey Michael,1,0,32,31
1656788248262,MATH 109,B02,083216,Ganzberger; Geoffrey Michael,1,0,32,31
1656788248262,MATH 109,B03,093479,Ganzberger; Geoffrey Michael,6,0,32,26
1656788254287,MATH 142A,A01,083219,Chow; Bennett,6,0,32,26
1656788254287,MATH 142A,A02,083220,Chow; Bennett,9,0,32,23
1656788254287,MATH 142A,A03,093480,Chow; Bennett,7,0,32,25
1656788254287,MATH 142A,B03,093481,Chow; Bennett,7,0,32,25
1656788254287,MATH 142A,B04,093558,Chow; Bennett,10,0,32,22
1656788254287,MATH 142A,B05,093559,Chow; Bennett,6,0,32,26
1656788260316,MATH 193A,A01,083224,Rotar; Vladimir,6,0,34,28
1656788260316,MATH 193A,A02,083225,Rotar; Vladimir,3,0,34,31
1656788260316,MATH 193A,A03,083781,Rotar; Vladimir,1,0,34,33
1656788260316,MATH 193A,A04,083782,Rotar; Vladimir,6,0,34,28
1656788260316,MATH 193A,A05,093482,Rotar; Vladimir,6,0,34,28
1656788266346,MATH 197,001,091859,McAuley; Julian John,9999,0,9999,0
1656788266346,MATH 197,002,095566,Kedlaya; Kiran S.,9997,0,9999,2
1656788266346,MATH 197,003,095567,Xiao; Ming,9999,0,9999,0
1656788266346,MATH 197,004,095571,Perols; Johan Lars,9998,0,9999,1
1656788273411,COGS 9,A01,083615,Shannon; Kyle Michael,6,0,75,69
1656788279436,COGS 11,A01,083617,Boyle; Mary E. T.,18,0,48,30
1656788285465,COGS 13,A01,083071,Bastos; Amalia Pinkusfeld,8,0,71,63
1656788291489,COGS 14A,A01,092681,Semenuks; Arturs,0,1,100,100
1656788297513,COGS 14B,A01,083073,Cheng; Tzu-Han,5,0,63,58
1656788303538,COGS 17,A01,092677,Semenuks; Arturs,4,0,81,77
1656788309569,COGS 100,A01,083619,Allen; Michael Gordon,15,0,70,55
1656788315593,COGS 101A,A01,083621,Davis; Joshua Daniel,9,0,68,59
1656788321620,COGS 101B,A01,091572,Allen; Michael Gordon,8,0,65,57
1656788327653,COGS 101C,A01,083625,Delgado; Tania,17,0,35,18
1656788333681,COGS 107A,A01,083627,Boyle; Mary E. T.,13,0,60,47
1656788339710,COGS 118A,A01,083075,Gupta; Anjum,15,0,76,61
1656788345737,CSE 3,A50,083646,Miranda; Gregory Joseph,22,0,50,28
1656788351768,CSE 8A,A50,083650,Miranda; Gregory Joseph,17,1,56,39
1656788357793,CSE 11,A01,083080,Cao; Yingjun,4,15,40,36
1656788363818,CSE 12,A01,083652,Krause-Levy; Sophia Louisa,20,1,120,100
1656788369842,CSE 15L,A01,083654,Morris; Justin Loren,8,0,50,42
1656788369842,CSE 15L,A02,083655,Morris; Justin Loren,8,0,50,42
1656788375867,CSE 20,A01,083657,Tran; Khoa Dang,37,0,80,43
1656788381891,CSE 21,A01,095574,Bach; Quang Tran,21,0,48,27
1656788387918,CSE 30,A01,083084,Eldon; John,4,0,80,76
1656788387918,CSE 30,B01,095061,Bhaskar; Nishant,5,0,50,45
1656788393942,CSE 100,A01,083659,Cao; Yingjun,1,4,70,69
1656788399971,CSE 134B,A01,083661,Powell; Thomas Allan,18,0,100,82
1656788405995,CSE 140,A01,083663,Gungor; Onat,14,0,85,71
1656788412024,CSE 140L,A01,083088,Eldon; John,16,0,100,84
1656788418048,CSE 175,A01,083665,Kumar; Rakesh,3,0,25,22
1656788424077,CSE 190,A00,092507,Dubnov; Shlomo,7,0,20,13
1656788430106,ECE 45,A01,083139,Congero; Spencer William,5,0,75,70
1656788436132,ECE 65,A50,083695,Saad; Andrew S,12,0,30,18
1656788436132,ECE 65,A51,095125,Saad; Andrew S,25,0,26,1
1656788442164,ECE 109,A01,091882,Touri; Behrouz,15,0,70,55
1656788448189,ECE 180,A00,083140,Abi Samra; Nicholas Camill,0,0,30,30
1656788448189,ECE 180,B00,083141,Abi Samra; Nicholas Camill,0,0,30,30
1656788454218,MATH 10A,A01,083735,Patchell; Gregory David,1,0,30,29
1656788454218,MATH 10A,A02,083736,Patchell; Gregory David,20,0,30,10
1656788454218,MATH 10A,A03,083737,Patchell; Gregory David,15,0,30,15
1656788460250,MATH 10B,A01,083207,Lim; Seonhee,7,0,34,27
1656788460250,MATH 10B,A02,083208,Lim; Seonhee,9,0,35,26
1656788460250,MATH 10B,A03,093472,Lim; Seonhee,4,0,34,30
1656788460250,MATH 10B,B01,083739,Sinha; Shubham,9,0,30,21
1656788466277,MATH 18,A01,083743,Cinel; Cameron Alexander,6,0,30,24
1656788466277,MATH 18,A02,083744,Cinel; Cameron Alexander,15,0,30,15
1656788466277,MATH 18,A03,083745,Cinel; Cameron Alexander,8,0,30,22
1656788466277,MATH 18,B01,083748,Rideout; David Porter,3,0,37,34
1656788466277,MATH 18,B02,083749,Rideout; David Porter,3,0,36,33
1656788466277,MATH 18,B03,083750,Rideout; David Porter,1,0,37,36
1656788466277,MATH 18,B04,083751,Rideout; David Porter,5,0,36,31
1656788466277,MATH 18,B05,093473,Rideout; David Porter,4,0,36,32
1656788466277,MATH 18,B06,093474,Rideout; David Porter,5,0,36,31
1656788472304,MATH 20A,A01,083754,Zheng; Zequn,12,0,40,28
1656788478328,MATH 20B,A01,083756,Briones; Jor-el Thomas Caparas,1,0,36,35
1656788478328,MATH 20B,A02,083757,Briones; Jor-el Thomas Caparas,1,0,36,35
1656788478328,MATH 20B,A03,093475,Briones; Jor-el Thomas Caparas,0,0,36,36
1656788484354,MATH 20C,A01,083760,Briones; Jor-el Thomas Caparas,1,0,35,34
1656788484354,MATH 20C,A02,083761,Briones; Jor-el Thomas Caparas,8,0,35,27
1656788484354,MATH 20C,A03,093476,Briones; Jor-el Thomas Caparas,0,1,36,36
1656788484354,MATH 20C,B01,083762,Bach; Quang Tran,0,0,30,30
1656788490379,MATH 20D,A01,083765,Tran; Brian Kha,4,0,30,26
1656788490379,MATH 20D,A02,083766,Tran; Brian Kha,4,0,30,26
1656788490379,MATH 20D,A03,083767,Tran; Brian Kha,2,0,30,28
1656788496410,MATH 20E,A01,083771,Ganguly; Soumya,5,0,32,27
1656788496410,MATH 20E,A02,083772,Ganguly; Soumya,5,0,32,27
1656788496410,MATH 20E,B01,083773,Ciotti; Benjamin,18,0,35,17
1656788496410,MATH 20E,B02,083774,Ciotti; Benjamin,17,0,35,18
1656788502434,MATH 103A,A01,083777,Greenfeld; Be'Eri,2,0,36,34
1656788502434,MATH 103A,A02,083778,Greenfeld; Be'Eri,5,0,36,31
1656788502434,MATH 103A,A03,093561,Greenfeld; Be'Eri,4,0,36,32
1656788502434,MATH 103A,B01,083779,Greenfeld; Be'Eri,6,0,36,30
1656788502434,MATH 103A,B02,083780,Greenfeld; Be'Eri,2,0,36,34
1656788502434,MATH 103A,B03,093562,Greenfeld; Be'Eri,2,0,36,34
1656788508460,MATH 105,A01,085443,Carter; Anne Toulson,13,0,35,22
1656788508460,MATH 105,A02,093477,Carter; Anne Toulson,20,0,35,15
1656788514486,MATH 109,A01,083213,Ganzberger; Geoffrey Michael,2,0,34,32
1656788514486,MATH 109,A02,083214,Ganzberger; Geoffrey Michael,2,0,34,32
1656788514486,MATH 109,A03,093478,Ganzberger; Geoffrey Michael,1,0,34,33
1656788514486,MATH 109,B01,083215,Ganzberger; Geoffrey Michael,1,0,32,31
1656788514486,MATH 109,B02,083216,Ganzberger; Geoffrey Michael,1,0,32,31
1656788514486,MATH 109,B03,093479,Ganzberger; Geoffrey Michael,6,0,32,26
1656788520520,MATH 142A,A01,083219,Chow; Bennett,6,0,32,26
1656788520520,MATH 142A,A02,083220,Chow; Bennett,9,0,32,23
1656788520520,MATH 142A,A03,093480,Chow; Bennett,7,0,32,25
1656788520520,MATH 142A,B03,093481,Chow; Bennett,7,0,32,25
1656788520520,MATH 142A,B04,093558,Chow; Bennett,10,0,32,22
1656788520520,MATH 142A,B05,093559,Chow; Bennett,6,0,32,26
1656788526546,MATH 193A,A01,083224,Rotar; Vladimir,6,0,34,28
1656788526546,MATH 193A,A02,083225,Rotar; Vladimir,3,0,34,31
1656788526546,MATH 193A,A03,083781,Rotar; Vladimir,1,0,34,33
1656788526546,MATH 193A,A04,083782,Rotar; Vladimir,6,0,34,28
1656788526546,MATH 193A,A05,093482,Rotar; Vladimir,6,0,34,28
1656788532572,MATH 197,001,091859,McAuley; Julian John,9999,0,9999,0
1656788532572,MATH 197,002,095566,Kedlaya; Kiran S.,9997,0,9999,2
1656788532572,MATH 197,003,095567,Xiao; Ming,9999,0,9999,0
1656788532572,MATH 197,004,095571,Perols; Johan Lars,9998,0,9999,1
1656788539636,COGS 9,A01,083615,Shannon; Kyle Michael,6,0,75,69
1656788545661,COGS 11,A01,083617,Boyle; Mary E. T.,18,0,48,30
1656788551686,COGS 13,A01,083071,Bastos; Amalia Pinkusfeld,8,0,71,63
1656788557710,COGS 14A,A01,092681,Semenuks; Arturs,0,1,100,100
1656788563735,COGS 14B,A01,083073,Cheng; Tzu-Han,5,0,63,58
1656788569765,COGS 17,A01,092677,Semenuks; Arturs,4,0,81,77
1656788575794,COGS 100,A01,083619,Allen; Michael Gordon,15,0,70,55
1656788581915,COGS 101A,A01,083621,Davis; Joshua Daniel,9,0,68,59
1656788587940,COGS 101B,A01,091572,Allen; Michael Gordon,8,0,65,57
1656788593967,COGS 101C,A01,083625,Delgado; Tania,17,0,35,18
1656788599990,COGS 107A,A01,083627,Boyle; Mary E. T.,13,0,60,47
1656788606020,COGS 118A,A01,083075,Gupta; Anjum,15,0,76,61
1656788612050,CSE 3,A50,083646,Miranda; Gregory Joseph,22,0,50,28
1656788618078,CSE 8A,A50,083650,Miranda; Gregory Joseph,17,1,56,39
1656788624102,CSE 11,A01,083080,Cao; Yingjun,4,15,40,36
1656788630130,CSE 12,A01,083652,Krause-Levy; Sophia Louisa,20,1,120,100
1656788636160,CSE 15L,A01,083654,Morris; Justin Loren,8,0,50,42
1656788636160,CSE 15L,A02,083655,Morris; Justin Loren,8,0,50,42
1656788642187,CSE 20,A01,083657,Tran; Khoa Dang,37,0,80,43
1656788648212,CSE 21,A01,095574,Bach; Quang Tran,21,0,48,27
1656788654238,CSE 30,A01,083084,Eldon; John,4,0,80,76
1656788654238,CSE 30,B01,095061,Bhaskar; Nishant,5,0,50,45
1656788660272,CSE 100,A01,083659,Cao; Yingjun,1,4,70,69
1656788666297,CSE 134B,A01,083661,Powell; Thomas Allan,18,0,100,82
1656788672327,CSE 140,A01,083663,Gungor; Onat,14,0,85,71
1656788678351,CSE 140L,A01,083088,Eldon; John,16,0,100,84
1656788684376,CSE 175,A01,083665,Kumar; Rakesh,3,0,25,22
1656788690400,CSE 190,A00,092507,Dubnov; Shlomo,7,0,20,13
1656788696430,ECE 45,A01,083139,Congero; Spencer William,5,0,75,70
1656788702454,ECE 65,A50,083695,Saad; Andrew S,12,0,30,18
1656788702454,ECE 65,A51,095125,Saad; Andrew S,25,0,26,1
1656788708478,ECE 109,A01,091882,Touri; Behrouz,15,0,70,55
1656788714503,ECE 180,A00,083140,Abi Samra; Nicholas Camill,0,0,30,30
1656788714503,ECE 180,B00,083141,Abi Samra; Nicholas Camill,0,0,30,30
1656788720532,MATH 10A,A01,083735,Patchell; Gregory David,1,0,30,29
1656788720532,MATH 10A,A02,083736,Patchell; Gregory David,20,0,30,10
1656788720532,MATH 10A,A03,083737,Patchell; Gregory David,15,0,30,15
1656788726566,MATH 10B,A01,083207,Lim; Seonhee,7,0,34,27
1656788726566,MATH 10B,A02,083208,Lim; Seonhee,9,0,35,26
1656788726566,MATH 10B,A03,093472,Lim; Seonhee,4,0,34,30
1656788726566,MATH 10B,B01,083739,Sinha; Shubham,9,0,30,21
1656788732596,MATH 18,A01,083743,Cinel; Cameron Alexander,6,0,30,24
1656788732596,MATH 18,A02,083744,Cinel; Cameron Alexander,15,0,30,15
1656788732596,MATH 18,A03,083745,Cinel; Cameron Alexander,8,0,30,22
1656788732596,MATH 18,B01,083748,Rideout; David Porter,3,0,37,34
1656788732596,MATH 18,B02,083749,Rideout; David Porter,3,0,36,33
1656788732596,MATH 18,B03,083750,Rideout; David Porter,1,0,37,36
1656788732596,MATH 18,B04,083751,Rideout; David Porter,5,0,36,31
1656788732596,MATH 18,B05,093473,Rideout; David Porter,4,0,36,32
1656788732596,MATH 18,B06,093474,Rideout; David Porter,5,0,36,31
1656788738625,MATH 20A,A01,083754,Zheng; Zequn,12,0,40,28
1656788744657,MATH 20B,A01,083756,Briones; Jor-el Thomas Caparas,1,0,36,35
1656788744657,MATH 20B,A02,083757,Briones; Jor-el Thomas Caparas,1,0,36,35
1656788744657,MATH 20B,A03,093475,Briones; Jor-el Thomas Caparas,0,0,36,36
1656788750688,MATH 20C,A01,083760,Briones; Jor-el Thomas Caparas,1,0,35,34
1656788750688,MATH 20C,A02,083761,Briones; Jor-el Thomas Caparas,8,0,35,27
1656788750688,MATH 20C,A03,093476,Briones; Jor-el Thomas Caparas,0,1,36,36
1656788750688,MATH 20C,B01,083762,Bach; Quang Tran,0,0,30,30
1656788756712,MATH 20D,A01,083765,Tran; Brian Kha,4,0,30,26
1656788756712,MATH 20D,A02,083766,Tran; Brian Kha,4,0,30,26
1656788756712,MATH 20D,A03,083767,Tran; Brian Kha,2,0,30,28
1656788762736,MATH 20E,A01,083771,Ganguly; Soumya,5,0,32,27
1656788762736,MATH 20E,A02,083772,Ganguly; Soumya,5,0,32,27
1656788762736,MATH 20E,B01,083773,Ciotti; Benjamin,18,0,35,17
1656788762736,MATH 20E,B02,083774,Ciotti; Benjamin,17,0,35,18
1656788768771,MATH 103A,A01,083777,Greenfeld; Be'Eri,2,0,36,34
1656788768771,MATH 103A,A02,083778,Greenfeld; Be'Eri,5,0,36,31
1656788768771,MATH 103A,A03,093561,Greenfeld; Be'Eri,4,0,36,32
1656788768771,MATH 103A,B01,083779,Greenfeld; Be'Eri,6,0,36,30
1656788768771,MATH 103A,B02,083780,Greenfeld; Be'Eri,2,0,36,34
1656788768771,MATH 103A,B03,093562,Greenfeld; Be'Eri,2,0,36,34
1656788774798,MATH 105,A01,085443,Carter; Anne Toulson,13,0,35,22
1656788774798,MATH 105,A02,093477,Carter; Anne Toulson,20,0,35,15
1656788780823,MATH 109,A01,083213,Ganzberger; Geoffrey Michael,2,0,34,32
1656788780823,MATH 109,A02,083214,Ganzberger; Geoffrey Michael,2,0,34,32
1656788780823,MATH 109,A03,093478,Ganzberger; Geoffrey Michael,1,0,34,33
1656788780823,MATH 109,B01,083215,Ganzberger; Geoffrey Michael,1,0,32,31
1656788780823,MATH 109,B02,083216,Ganzberger; Geoffrey Michael,1,0,32,31
1656788780823,MATH 109,B03,093479,Ganzberger; Geoffrey Michael,6,0,32,26
1656788786854,MATH 142A,A01,083219,Chow; Bennett,6,0,32,26
1656788786854,MATH 142A,A02,083220,Chow; Bennett,9,0,32,23
1656788786854,MATH 142A,A03,093480,Chow; Bennett,7,0,32,25
1656788786854,MATH 142A,B03,093481,Chow; Bennett,7,0,32,25
1656788786854,MATH 142A,B04,093558,Chow; Bennett,10,0,32,22
1656788786854,MATH 142A,B05,093559,Chow; Bennett,6,0,32,26
1656788792879,MATH 193A,A01,083224,Rotar; Vladimir,6,0,34,28
1656788792879,MATH 193A,A02,083225,Rotar; Vladimir,3,0,34,31
1656788792879,MATH 193A,A03,083781,Rotar; Vladimir,1,0,34,33
1656788792879,MATH 193A,A04,083782,Rotar; Vladimir,6,0,34,28
1656788792879,MATH 193A,A05,093482,Rotar; Vladimir,6,0,34,28
1656788798904,MATH 197,001,091859,McAuley; Julian John,9999,0,9999,0
1656788798904,MATH 197,002,095566,Kedlaya; Kiran S.,9997,0,9999,2
1656788798904,MATH 197,003,095567,Xiao; Ming,9999,0,9999,0
1656788798904,MATH 197,004,095571,Perols; Johan Lars,9998,0,9999,1
1656788805975,COGS 9,A01,083615,Shannon; Kyle Michael,6,0,75,69
1656788811999,COGS 11,A01,083617,Boyle; Mary E. T.,18,0,48,30
1656788818025,COGS 13,A01,083071,Bastos; Amalia Pinkusfeld,8,0,71,63
1656788824054,COGS 14A,A01,092681,Semenuks; Arturs,0,1,100,100
1656788830079,COGS 14B,A01,083073,Cheng; Tzu-Han,5,0,63,58
1656788836104,COGS 17,A01,092677,Semenuks; Arturs,4,0,81,77
1656788842130,COGS 100,A01,083619,Allen; Michael Gordon,15,0,70,55
1656788848155,COGS 101A,A01,083621,Davis; Joshua Daniel,9,0,68,59
1656788854180,COGS 101B,A01,091572,Allen; Michael Gordon,8,0,65,57
1656788860202,COGS 101C,A01,083625,Delgado; Tania,17,0,35,18
1656788866229,COGS 107A,A01,083627,Boyle; Mary E. T.,13,0,60,47
1656788872257,COGS 118A,A01,083075,Gupta; Anjum,15,0,76,61
1656788878283,CSE 3,A50,083646,Miranda; Gregory Joseph,22,0,50,28
1656788884309,CSE 8A,A50,083650,Miranda; Gregory Joseph,17,1,56,39
1656788890337,CSE 11,A01,083080,Cao; Yingjun,4,15,40,36
1656788896367,CSE 12,A01,083652,Krause-Levy; Sophia Louisa,20,1,120,100
1656788902405,CSE 15L,A01,083654,Morris; Justin Loren,8,0,50,42
1656788902405,CSE 15L,A02,083655,Morris; Justin Loren,8,0,50,42
1656788908434,CSE 20,A01,083657,Tran; Khoa Dang,37,0,80,43
1656788914459,CSE 21,A01,095574,Bach; Quang Tran,21,0,48,27
1656788920487,CSE 30,A01,083084,Eldon; John,4,0,80,76
1656788920487,CSE 30,B01,095061,Bhaskar; Nishant,5,0,50,45
1656788926513,CSE 100,A01,083659,Cao; Yingjun,1,4,70,69
1656788932543,CSE 134B,A01,083661,Powell; Thomas Allan,18,0,100,82
1656788938573,CSE 140,A01,083663,Gungor; Onat,14,0,85,71
1656788944602,CSE 140L,A01,083088,Eldon; John,16,0,100,84
1656788950625,CSE 175,A01,083665,Kumar; Rakesh,3,0,25,22
1656788956648,CSE 190,A00,092507,Dubnov; Shlomo,7,0,20,13
1656788962671,ECE 45,A01,083139,Congero; Spencer William,5,0,75,70
1656788968700,ECE 65,A50,083695,Saad; Andrew S,12,0,30,18
1656788968700,ECE 65,A51,095125,Saad; Andrew S,25,0,26,1
1656788974729,ECE 109,A01,091882,Touri; Behrouz,15,0,70,55
1656788980763,ECE 180,A00,083140,Abi Samra; Nicholas Camill,0,0,30,30
1656788980763,ECE 180,B00,083141,Abi Samra; Nicholas Camill,0,0,30,30
1656788986792,MATH 10A,A01,083735,Patchell; Gregory David,1,0,30,29
1656788986792,MATH 10A,A02,083736,Patchell; Gregory David,20,0,30,10
1656788986792,MATH 10A,A03,083737,Patchell; Gregory David,15,0,30,15
1656788992819,MATH 10B,A01,083207,Lim; Seonhee,7,0,34,27
1656788992819,MATH 10B,A02,083208,Lim; Seonhee,9,0,35,26
1656788992819,MATH 10B,A03,093472,Lim; Seonhee,4,0,34,30
1656788992819,MATH 10B,B01,083739,Sinha; Shubham,9,0,30,21
1656788998858,MATH 18,A01,083743,Cinel; Cameron Alexander,6,0,30,24
1656788998858,MATH 18,A02,083744,Cinel; Cameron Alexander,15,0,30,15
1656788998858,MATH 18,A03,083745,Cinel; Cameron Alexander,8,0,30,22
1656788998858,MATH 18,B01,083748,Rideout; David Porter,3,0,37,34
1656788998858,MATH 18,B02,083749,Rideout; David Porter,3,0,36,33
1656788998858,MATH 18,B03,083750,Rideout; David Porter,1,0,37,36
1656788998858,MATH 18,B04,083751,Rideout; David Porter,5,0,36,31
1656788998858,MATH 18,B05,093473,Rideout; David Porter,4,0,36,32
1656788998858,MATH 18,B06,093474,Rideout; David Porter,5,0,36,31
1656789004880,MATH 20A,A01,083754,Zheng; Zequn,12,0,40,28
1656789010911,MATH 20B,A01,083756,Briones; Jor-el Thomas Caparas,1,0,36,35
1656789010911,MATH 20B,A02,083757,Briones; Jor-el Thomas Caparas,1,0,36,35
1656789010911,MATH 20B,A03,093475,Briones; Jor-el Thomas Caparas,0,0,36,36
1656789016942,MATH 20C,A01,083760,Briones; Jor-el Thomas Caparas,1,0,35,34
1656789016942,MATH 20C,A02,083761,Briones; Jor-el Thomas Caparas,8,0,35,27
1656789016942,MATH 20C,A03,093476,Briones; Jor-el Thomas Caparas,0,1,36,36
1656789016942,MATH 20C,B01,083762,Bach; Quang Tran,0,0,30,30
1656789022966,MATH 20D,A01,083765,Tran; Brian Kha,4,0,30,26
1656789022966,MATH 20D,A02,083766,Tran; Brian Kha,4,0,30,26
1656789022966,MATH 20D,A03,083767,Tran; Brian Kha,2,0,30,28
1656789029001,MATH 20E,A01,083771,Ganguly; Soumya,5,0,32,27
1656789029001,MATH 20E,A02,083772,Ganguly; Soumya,5,0,32,27
1656789029001,MATH 20E,B01,083773,Ciotti; Benjamin,18,0,35,17
1656789029001,MATH 20E,B02,083774,Ciotti; Benjamin,17,0,35,18
1656789035027,MATH 103A,A01,083777,Greenfeld; Be'Eri,2,0,36,34
1656789035027,MATH 103A,A02,083778,Greenfeld; Be'Eri,5,0,36,31
1656789035027,MATH 103A,A03,093561,Greenfeld; Be'Eri,4,0,36,32
1656789035027,MATH 103A,B01,083779,Greenfeld; Be'Eri,6,0,36,30
1656789035027,MATH 103A,B02,083780,Greenfeld; Be'Eri,2,0,36,34
1656789035027,MATH 103A,B03,093562,Greenfeld; Be'Eri,2,0,36,34
1656789041062,MATH 105,A01,085443,Carter; Anne Toulson,13,0,35,22
1656789041062,MATH 105,A02,093477,Carter; Anne Toulson,20,0,35,15
1656789047088,MATH 109,A01,083213,Ganzberger; Geoffrey Michael,2,0,34,32
1656789047088,MATH 109,A02,083214,Ganzberger; Geoffrey Michael,2,0,34,32
1656789047088,MATH 109,A03,093478,Ganzberger; Geoffrey Michael,1,0,34,33
1656789047088,MATH 109,B01,083215,Ganzberger; Geoffrey Michael,1,0,32,31
1656789047088,MATH 109,B02,083216,Ganzberger; Geoffrey Michael,1,0,32,31
1656789047088,MATH 109,B03,093479,Ganzberger; Geoffrey Michael,6,0,32,26
1656789053121,MATH 142A,A01,083219,Chow; Bennett,6,0,32,26
1656789053121,MATH 142A,A02,083220,Chow; Bennett,9,0,32,23
1656789053121,MATH 142A,A03,093480,Chow; Bennett,7,0,32,25
1656789053121,MATH 142A,B03,093481,Chow; Bennett,7,0,32,25
1656789053121,MATH 142A,B04,093558,Chow; Bennett,10,0,32,22
1656789053121,MATH 142A,B05,093559,Chow; Bennett,6,0,32,26
1656789059146,MATH 193A,A01,083224,Rotar; Vladimir,6,0,34,28
1656789059146,MATH 193A,A02,083225,Rotar; Vladimir,3,0,34,31
1656789059146,MATH 193A,A03,083781,Rotar; Vladimir,1,0,34,33
1656789059146,MATH 193A,A04,083782,Rotar; Vladimir,6,0,34,28
1656789059146,MATH 193A,A05,093482,Rotar; Vladimir,6,0,34,28
1656789065174,MATH 197,001,091859,McAuley; Julian John,9999,0,9999,0
1656789065174,MATH 197,002,095566,Kedlaya; Kiran S.,9997,0,9999,2
1656789065174,MATH 197,003,095567,Xiao; Ming,9999,0,9999,0
1656789065174,MATH 197,004,095571,Perols; Johan Lars,9998,0,9999,1
1656789072280,COGS 9,A01,083615,Shannon; Kyle Michael,6,0,75,69
1656789078303,COGS 11,A01,083617,Boyle; Mary E. T.,18,0,48,30
1656789084329,COGS 13,A01,083071,Bastos; Amalia Pinkusfeld,8,0,71,63
1656789090354,COGS 14A,A01,092681,Semenuks; Arturs,0,1,100,100
1656789096379,COGS 14B,A01,083073,Cheng; Tzu-Han,5,0,63,58
1656789102404,COGS 17,A01,092677,Semenuks; Arturs,4,0,81,77
1656789108435,COGS 100,A01,083619,Allen; Michael Gordon,15,0,70,55
1656789114465,COGS 101A,A01,083621,Davis; Joshua Daniel,9,0,68,59
1656789120488,COGS 101B,A01,091572,Allen; Michael Gordon,8,0,65,57
1656789126513,COGS 101C,A01,083625,Delgado; Tania,17,0,35,18
1656789132537,COGS 107A,A01,083627,Boyle; Mary E. T.,13,0,60,47
1656789138563,COGS 118A,A01,083075,Gupta; Anjum,15,0,76,61
1656789144589,CSE 3,A50,083646,Miranda; Gregory Joseph,22,0,50,28
1656789150612,CSE 8A,A50,083650,Miranda; Gregory Joseph,17,1,56,39
1656789156642,CSE 11,A01,083080,Cao; Yingjun,4,15,40,36
1656789162668,CSE 12,A01,083652,Krause-Levy; Sophia Louisa,20,1,120,100
1656789168701,CSE 15L,A01,083654,Morris; Justin Loren,8,0,50,42
1656789168701,CSE 15L,A02,083655,Morris; Justin Loren,8,0,50,42
1656789174726,CSE 20,A01,083657,Tran; Khoa Dang,37,0,80,43
1656789180821,CSE 21,A01,095574,Bach; Quang Tran,21,0,48,27
1656789186853,CSE 30,A01,083084,Eldon; John,4,0,80,76
1656789186853,CSE 30,B01,095061,Bhaskar; Nishant,5,0,50,45
1656789192889,CSE 100,A01,083659,Cao; Yingjun,1,4,70,69
1656789198913,CSE 134B,A01,083661,Powell; Thomas Allan,18,0,100,82
1656789204940,CSE 140,A01,083663,Gungor; Onat,14,0,85,71
1656789210972,CSE 140L,A01,083088,Eldon; John,16,0,100,84
1656789216996,CSE 175,A01,083665,Kumar; Rakesh,3,0,25,22
1656789223027,CSE 190,A00,092507,Dubnov; Shlomo,7,0,20,13
1656789229052,ECE 45,A01,083139,Congero; Spencer William,5,0,75,70
1656789235082,ECE 65,A50,083695,Saad; Andrew S,12,0,30,18
1656789235082,ECE 65,A51,095125,Saad; Andrew S,25,0,26,1
1656789241115,ECE 109,A01,091882,Touri; Behrouz,15,0,70,55
1656789247148,ECE 180,A00,083140,Abi Samra; Nicholas Camill,0,0,30,30
1656789247148,ECE 180,B00,083141,Abi Samra; Nicholas Camill,0,0,30,30
1656789253181,MATH 10A,A01,083735,Patchell; Gregory David,1,0,30,29
1656789253181,MATH 10A,A02,083736,Patchell; Gregory David,20,0,30,10
1656789253181,MATH 10A,A03,083737,Patchell; Gregory David,15,0,30,15
1656789259223,MATH 10B,A01,083207,Lim; Seonhee,7,0,34,27
1656789259223,MATH 10B,A02,083208,Lim; Seonhee,9,0,35,26
1656789259223,MATH 10B,A03,093472,Lim; Seonhee,4,0,34,30
1656789259223,MATH 10B,B01,083739,Sinha; Shubham,9,0,30,21
1656789265265,MATH 18,A01,083743,Cinel; Cameron Alexander,6,0,30,24
1656789265265,MATH 18,A02,083744,Cinel; Cameron Alexander,15,0,30,15
1656789265265,MATH 18,A03,083745,Cinel; Cameron Alexander,8,0,30,22
1656789265265,MATH 18,B01,083748,Rideout; David Porter,3,0,37,34
1656789265265,MATH 18,B02,083749,Rideout; David Porter,3,0,36,33
1656789265265,MATH 18,B03,083750,Rideout; David Porter,1,0,37,36
1656789265265,MATH 18,B04,083751,Rideout; David Porter,5,0,36,31
1656789265265,MATH 18,B05,093473,Rideout; David Porter,4,0,36,32
1656789265265,MATH 18,B06,093474,Rideout; David Porter,5,0,36,31
1656789271291,MATH 20A,A01,083754,Zheng; Zequn,12,0,40,28
1656789277320,MATH 20B,A01,083756,Briones; Jor-el Thomas Caparas,1,0,36,35
1656789277320,MATH 20B,A02,083757,Briones; Jor-el Thomas Caparas,1,0,36,35
1656789277320,MATH 20B,A03,093475,Briones; Jor-el Thomas Caparas,0,0,36,36
1656789283345,MATH 20C,A01,083760,Briones; Jor-el Thomas Caparas,1,0,35,34
1656789283345,MATH 20C,A02,083761,Briones; Jor-el Thomas Caparas,8,0,35,27
1656789283345,MATH 20C,A03,093476,Briones; Jor-el Thomas Caparas,0,1,36,36
1656789283345,MATH 20C,B01,083762,Bach; Quang Tran,0,0,30,30
1656789289372,MATH 20D,A01,083765,Tran; Brian Kha,4,0,30,26
1656789289372,MATH 20D,A02,083766,Tran; Brian Kha,4,0,30,26
1656789289372,MATH 20D,A03,083767,Tran; Brian Kha,2,0,30,28
1656789295399,MATH 20E,A01,083771,Ganguly; Soumya,5,0,32,27
1656789295399,MATH 20E,A02,083772,Ganguly; Soumya,5,0,32,27
1656789295399,MATH 20E,B01,083773,Ciotti; Benjamin,18,0,35,17
1656789295399,MATH 20E,B02,083774,Ciotti; Benjamin,17,0,35,18
1656789301435,MATH 103A,A01,083777,Greenfeld; Be'Eri,2,0,36,34
1656789301435,MATH 103A,A02,083778,Greenfeld; Be'Eri,5,0,36,31
1656789301435,MATH 103A,A03,093561,Greenfeld; Be'Eri,4,0,36,32
1656789301435,MATH 103A,B01,083779,Greenfeld; Be'Eri,6,0,36,30
1656789301435,MATH 103A,B02,083780,Greenfeld; Be'Eri,2,0,36,34
1656789301435,MATH 103A,B03,093562,Greenfeld; Be'Eri,2,0,36,34
1656789307465,MATH 105,A01,085443,Carter; Anne Toulson,13,0,35,22
1656789307465,MATH 105,A02,093477,Carter; Anne Toulson,20,0,35,15
1656789313492,MATH 109,A01,083213,Ganzberger; Geoffrey Michael,2,0,34,32
1656789313492,MATH 109,A02,083214,Ganzberger; Geoffrey Michael,2,0,34,32
1656789313492,MATH 109,A03,093478,Ganzberger; Geoffrey Michael,1,0,34,33
1656789313492,MATH 109,B01,083215,Ganzberger; Geoffrey Michael,1,0,32,31
1656789313492,MATH 109,B02,083216,Ganzberger; Geoffrey Michael,1,0,32,31
1656789313492,MATH 109,B03,093479,Ganzberger; Geoffrey Michael,6,0,32,26
1656789319517,MATH 142A,A01,083219,Chow; Bennett,6,0,32,26
1656789319517,MATH 142A,A02,083220,Chow; Bennett,9,0,32,23
1656789319517,MATH 142A,A03,093480,Chow; Bennett,7,0,32,25
1656789319517,MATH 142A,B03,093481,Chow; Bennett,7,0,32,25
1656789319517,MATH 142A,B04,093558,Chow; Bennett,10,0,32,22
1656789319517,MATH 142A,B05,093559,Chow; Bennett,6,0,32,26
1656789325550,MATH 193A,A01,083224,Rotar; Vladimir,6,0,34,28
1656789325550,MATH 193A,A02,083225,Rotar; Vladimir,3,0,34,31
1656789325550,MATH 193A,A03,083781,Rotar; Vladimir,1,0,34,33
1656789325550,MATH 193A,A04,083782,Rotar; Vladimir,6,0,34,28
1656789325550,MATH 193A,A05,093482,Rotar; Vladimir,6,0,34,28
1656789331576,MATH 197,001,091859,McAuley; Julian John,9999,0,9999,0
1656789331576,MATH 197,002,095566,Kedlaya; Kiran S.,9997,0,9999,2
1656789331576,MATH 197,003,095567,Xiao; Ming,9999,0,9999,0
1656789331576,MATH 197,004,095571,Perols; Johan Lars,9998,0,9999,1
1656789338667,COGS 9,A01,083615,Shannon; Kyle Michael,6,0,75,69
1656789344692,COGS 11,A01,083617,Boyle; Mary E. T.,18,0,48,30
1656789350715,COGS 13,A01,083071,Bastos; Amalia Pinkusfeld,8,0,71,63
1656789356742,COGS 14A,A01,092681,Semenuks; Arturs,0,1,100,100
1656789362778,COGS 14B,A01,083073,Cheng; Tzu-Han,5,0,63,58
1656789368803,COGS 17,A01,092677,Semenuks; Arturs,4,0,81,77
1656789374835,COGS 100,A01,083619,Allen; Michael Gordon,15,0,70,55
1656789380864,COGS 101A,A01,083621,Davis; Joshua Daniel,9,0,68,59
1656789386890,COGS 101B,A01,091572,Allen; Michael Gordon,8,0,65,57
1656789392919,COGS 101C,A01,083625,Delgado; Tania,17,0,35,18
1656789398945,COGS 107A,A01,083627,Boyle; Mary E. T.,13,0,60,47
1656789404968,COGS 118A,A01,083075,Gupta; Anjum,15,0,76,61
1656789410999,CSE 3,A50,083646,Miranda; Gregory Joseph,22,0,50,28
1656789417034,CSE 8A,A50,083650,Miranda; Gregory Joseph,17,1,56,39
1656789423062,CSE 11,A01,083080,Cao; Yingjun,4,15,40,36
1656789429092,CSE 12,A01,083652,Krause-Levy; Sophia Louisa,20,1,120,100
1656789435121,CSE 15L,A01,083654,Morris; Justin Loren,8,0,50,42
1656789435121,CSE 15L,A02,083655,Morris; Justin Loren,8,0,50,42
1656789441150,CSE 20,A01,083657,Tran; Khoa Dang,37,0,80,43
1656789447176,CSE 21,A01,095574,Bach; Quang Tran,21,0,48,27
1656789453203,CSE 30,A01,083084,Eldon; John,4,0,80,76
1656789453203,CSE 30,B01,095061,Bhaskar; Nishant,5,0,50,45
1656789459227,CSE 100,A01,083659,Cao; Yingjun,1,4,70,69
1656789465251,CSE 134B,A01,083661,Powell; Thomas Allan,18,0,100,82
1656789471281,CSE 140,A01,083663,Gungor; Onat,14,0,85,71
1656789477305,CSE 140L,A01,083088,Eldon; John,16,0,100,84
1656789483330,CSE 175,A01,083665,Kumar; Rakesh,3,0,25,22
1656789489354,CSE 190,A00,092507,Dubnov; Shlomo,7,0,20,13
1656789495380,ECE 45,A01,083139,Congero; Spencer William,5,0,75,70
1656789501412,ECE 65,A50,083695,Saad; Andrew S,12,0,30,18
1656789501412,ECE 65,A51,095125,Saad; Andrew S,25,0,26,1
1656789507441,ECE 109,A01,091882,Touri; Behrouz,15,0,70,55
1656789513467,ECE 180,A00,083140,Abi Samra; Nicholas Camill,0,0,30,30
1656789513467,ECE 180,B00,083141,Abi Samra; Nicholas Camill,0,0,30,30
1656789519509,MATH 10A,A01,083735,Patchell; Gregory David,1,0,30,29
1656789519509,MATH 10A,A02,083736,Patchell; Gregory David,20,0,30,10
1656789519509,MATH 10A,A03,083737,Patchell; Gregory David,15,0,30,15
1656789525544,MATH 10B,A01,083207,Lim; Seonhee,7,0,34,27
1656789525544,MATH 10B,A02,083208,Lim; Seonhee,9,0,35,26
1656789525544,MATH 10B,A03,093472,Lim; Seonhee,4,0,34,30
1656789525544,MATH 10B,B01,083739,Sinha; Shubham,9,0,30,21
1656789531581,MATH 18,A01,083743,Cinel; Cameron Alexander,6,0,30,24
1656789531581,MATH 18,A02,083744,Cinel; Cameron Alexander,15,0,30,15
1656789531581,MATH 18,A03,083745,Cinel; Cameron Alexander,8,0,30,22
1656789531581,MATH 18,B01,083748,Rideout; David Porter,3,0,37,34
1656789531581,MATH 18,B02,083749,Rideout; David Porter,3,0,36,33
1656789531581,MATH 18,B03,083750,Rideout; David Porter,1,0,37,36
1656789531581,MATH 18,B04,083751,Rideout; David Porter,5,0,36,31
1656789531581,MATH 18,B05,093473,Rideout; David Porter,4,0,36,32
1656789531581,MATH 18,B06,093474,Rideout; David Porter,5,0,36,31
1656789537611,MATH 20A,A01,083754,Zheng; Zequn,12,0,40,28
1656789543637,MATH 20B,A01,083756,Briones; Jor-el Thomas Caparas,1,0,36,35
1656789543637,MATH 20B,A02,083757,Briones; Jor-el Thomas Caparas,1,0,36,35
1656789543637,MATH 20B,A03,093475,Briones; Jor-el Thomas Caparas,0,0,36,36
1656789549665,MATH 20C,A01,083760,Briones; Jor-el Thomas Caparas,1,0,35,34
1656789549665,MATH 20C,A02,083761,Briones; Jor-el Thomas Caparas,8,0,35,27
1656789549665,MATH 20C,A03,093476,Briones; Jor-el Thomas Caparas,0,1,36,36
1656789549665,MATH 20C,B01,083762,Bach; Quang Tran,0,0,30,30
1656789555696,MATH 20D,A01,083765,Tran; Brian Kha,4,0,30,26
1656789555696,MATH 20D,A02,083766,Tran; Brian Kha,4,0,30,26
1656789555696,MATH 20D,A03,083767,Tran; Brian Kha,2,0,30,28
1656789561722,MATH 20E,A01,083771,Ganguly; Soumya,5,0,32,27
1656789561722,MATH 20E,A02,083772,Ganguly; Soumya,5,0,32,27
1656789561722,MATH 20E,B01,083773,Ciotti; Benjamin,18,0,35,17
1656789561722,MATH 20E,B02,083774,Ciotti; Benjamin,17,0,35,18
1656789567756,MATH 103A,A01,083777,Greenfeld; Be'Eri,2,0,36,34
1656789567756,MATH 103A,A02,083778,Greenfeld; Be'Eri,5,0,36,31
1656789567756,MATH 103A,A03,093561,Greenfeld; Be'Eri,4,0,36,32
1656789567756,MATH 103A,B01,083779,Greenfeld; Be'Eri,6,0,36,30
1656789567756,MATH 103A,B02,083780,Greenfeld; Be'Eri,2,0,36,34
1656789567756,MATH 103A,B03,093562,Greenfeld; Be'Eri,2,0,36,34
1656789573780,MATH 105,A01,085443,Carter; Anne Toulson,13,0,35,22
1656789573780,MATH 105,A02,093477,Carter; Anne Toulson,20,0,35,15
1656789579806,MATH 109,A01,083213,Ganzberger; Geoffrey Michael,2,0,34,32
1656789579806,MATH 109,A02,083214,Ganzberger; Geoffrey Michael,2,0,34,32
1656789579806,MATH 109,A03,093478,Ganzberger; Geoffrey Michael,1,0,34,33
1656789579806,MATH 109,B01,083215,Ganzberger; Geoffrey Michael,1,0,32,31
1656789579806,MATH 109,B02,083216,Ganzberger; Geoffrey Michael,1,0,32,31
1656789579806,MATH 109,B03,093479,Ganzberger; Geoffrey Michael,6,0,32,26
1656789585832,MATH 142A,A01,083219,Chow; Bennett,6,0,32,26
1656789585832,MATH 142A,A02,083220,Chow; Bennett,9,0,32,23
1656789585832,MATH 142A,A03,093480,Chow; Bennett,7,0,32,25
1656789585832,MATH 142A,B03,093481,Chow; Bennett,7,0,32,25
1656789585832,MATH 142A,B04,093558,Chow; Bennett,10,0,32,22
1656789585832,MATH 142A,B05,093559,Chow; Bennett,6,0,32,26
1656789591858,MATH 193A,A01,083224,Rotar; Vladimir,6,0,34,28
1656789591858,MATH 193A,A02,083225,Rotar; Vladimir,3,0,34,31
1656789591858,MATH 193A,A03,083781,Rotar; Vladimir,1,0,34,33
1656789591858,MATH 193A,A04,083782,Rotar; Vladimir,6,0,34,28
1656789591858,MATH 193A,A05,093482,Rotar; Vladimir,6,0,34,28
1656789597883,MATH 197,001,091859,McAuley; Julian John,9999,0,9999,0
1656789597883,MATH 197,002,095566,Kedlaya; Kiran S.,9997,0,9999,2
1656789597883,MATH 197,003,095567,Xiao; Ming,9999,0,9999,0
1656789597883,MATH 197,004,095571,Perols; Johan Lars,9998,0,9999,1
1656789604949,COGS 9,A01,083615,Shannon; Kyle Michael,6,0,75,69
1656789610974,COGS 11,A01,083617,Boyle; Mary E. T.,18,0,48,30
1656789616999,COGS 13,A01,083071,Bastos; Amalia Pinkusfeld,8,0,71,63
1656789623025,COGS 14A,A01,092681,Semenuks; Arturs,0,1,100,100
1656789629053,COGS 14B,A01,083073,Cheng; Tzu-Han,5,0,63,58
1656789635076,COGS 17,A01,092677,Semenuks; Arturs,4,0,81,77
1656789641101,COGS 100,A01,083619,Allen; Michael Gordon,15,0,70,55
1656789647129,COGS 101A,A01,083621,Davis; Joshua Daniel,9,0,68,59
1656789653154,COGS 101B,A01,091572,Allen; Michael Gordon,8,0,65,57
1656789659190,COGS 101C,A01,083625,Delgado; Tania,17,0,35,18
1656789665212,COGS 107A,A01,083627,Boyle; Mary E. T.,13,0,60,47
1656789671238,COGS 118A,A01,083075,Gupta; Anjum,15,0,76,61
1656789677272,CSE 3,A50,083646,Miranda; Gregory Joseph,22,0,50,28
1656789683295,CSE 8A,A50,083650,Miranda; Gregory Joseph,17,1,56,39
1656789689317,CSE 11,A01,083080,Cao; Yingjun,4,15,40,36
1656789695342,CSE 12,A01,083652,Krause-Levy; Sophia Louisa,20,1,120,100
1656789701368,CSE 15L,A01,083654,Morris; Justin Loren,8,0,50,42
1656789701368,CSE 15L,A02,083655,Morris; Justin Loren,8,0,50,42
1656789707395,CSE 20,A01,083657,Tran; Khoa Dang,37,0,80,43
1656789713420,CSE 21,A01,095574,Bach; Quang Tran,21,0,48,27
1656789719450,CSE 30,A01,083084,Eldon; John,4,0,80,76
1656789719450,CSE 30,B01,095061,Bhaskar; Nishant,5,0,50,45
1656789725474,CSE 100,A01,083659,Cao; Yingjun,1,4,70,69
1656789731502,CSE 134B,A01,083661,Powell; Thomas Allan,18,0,100,82
1656789737529,CSE 140,A01,083663,Gungor; Onat,14,0,85,71
1656789743553,CSE 140L,A01,083088,Eldon; John,16,0,100,84
1656789749577,CSE 175,A01,083665,Kumar; Rakesh,3,0,25,22
1656789755602,CSE 190,A00,092507,Dubnov; Shlomo,7,0,20,13
1656789761632,ECE 45,A01,083139,Congero; Spencer William,5,0,75,70
1656789767661,ECE 65,A50,083695,Saad; Andrew S,12,0,30,18
1656789767661,ECE 65,A51,095125,Saad; Andrew S,25,0,26,1
1656789773685,ECE 109,A01,091882,Touri; Behrouz,15,0,70,55
1656789779782,ECE 180,A00,083140,Abi Samra; Nicholas Camill,0,0,30,30
1656789779782,ECE 180,B00,083141,Abi Samra; Nicholas Camill,0,0,30,30
1656789785809,MATH 10A,A01,083735,Patchell; Gregory David,1,0,30,29
1656789785809,MATH 10A,A02,083736,Patchell; Gregory David,20,0,30,10
1656789785809,MATH 10A,A03,083737,Patchell; Gregory David,15,0,30,15
1656789791839,MATH 10B,A01,083207,Lim; Seonhee,7,0,34,27
1656789791839,MATH 10B,A02,083208,Lim; Seonhee,9,0,35,26
1656789791839,MATH 10B,A03,093472,Lim; Seonhee,4,0,34,30
1656789791839,MATH 10B,B01,083739,Sinha; Shubham,9,0,30,21
1656789797867,MATH 18,A01,083743,Cinel; Cameron Alexander,6,0,30,24
1656789797867,MATH 18,A02,083744,Cinel; Cameron Alexander,15,0,30,15
1656789797867,MATH 18,A03,083745,Cinel; Cameron Alexander,8,0,30,22
1656789797867,MATH 18,B01,083748,Rideout; David Porter,3,0,37,34
1656789797867,MATH 18,B02,083749,Rideout; David Porter,3,0,36,33
1656789797867,MATH 18,B03,083750,Rideout; David Porter,1,0,37,36
1656789797867,MATH 18,B04,083751,Rideout; David Porter,5,0,36,31
1656789797867,MATH 18,B05,093473,Rideout; David Porter,4,0,36,32
1656789797867,MATH 18,B06,093474,Rideout; David Porter,5,0,36,31
1656789803895,MATH 20A,A01,083754,Zheng; Zequn,12,0,40,28
1656789809926,MATH 20B,A01,083756,Briones; Jor-el Thomas Caparas,1,0,36,35
1656789809926,MATH 20B,A02,083757,Briones; Jor-el Thomas Caparas,1,0,36,35
1656789809926,MATH 20B,A03,093475,Briones; Jor-el Thomas Caparas,0,0,36,36
1656789815951,MATH 20C,A01,083760,Briones; Jor-el Thomas Caparas,1,0,35,34
1656789815951,MATH 20C,A02,083761,Briones; Jor-el Thomas Caparas,8,0,35,27
1656789815951,MATH 20C,A03,093476,Briones; Jor-el Thomas Caparas,0,1,36,36
1656789815951,MATH 20C,B01,083762,Bach; Quang Tran,0,0,30,30
1656789821980,MATH 20D,A01,083765,Tran; Brian Kha,4,0,30,26
1656789821980,MATH 20D,A02,083766,Tran; Brian Kha,4,0,30,26
1656789821980,MATH 20D,A03,083767,Tran; Brian Kha,2,0,30,28
1656789828012,MATH 20E,A01,083771,Ganguly; Soumya,5,0,32,27
1656789828012,MATH 20E,A02,083772,Ganguly; Soumya,5,0,32,27
1656789828012,MATH 20E,B01,083773,Ciotti; Benjamin,18,0,35,17
1656789828012,MATH 20E,B02,083774,Ciotti; Benjamin,17,0,35,18
1656789834038,MATH 103A,A01,083777,Greenfeld; Be'Eri,2,0,36,34
1656789834038,MATH 103A,A02,083778,Greenfeld; Be'Eri,5,0,36,31
1656789834038,MATH 103A,A03,093561,Greenfeld; Be'Eri,4,0,36,32
1656789834038,MATH 103A,B01,083779,Greenfeld; Be'Eri,6,0,36,30
1656789834038,MATH 103A,B02,083780,Greenfeld; Be'Eri,2,0,36,34
1656789834038,MATH 103A,B03,093562,Greenfeld; Be'Eri,2,0,36,34
1656789840064,MATH 105,A01,085443,Carter; Anne Toulson,13,0,35,22
1656789840064,MATH 105,A02,093477,Carter; Anne Toulson,20,0,35,15
1656789846094,MATH 109,A01,083213,Ganzberger; Geoffrey Michael,2,0,34,32
1656789846094,MATH 109,A02,083214,Ganzberger; Geoffrey Michael,2,0,34,32
1656789846094,MATH 109,A03,093478,Ganzberger; Geoffrey Michael,1,0,34,33
1656789846094,MATH 109,B01,083215,Ganzberger; Geoffrey Michael,1,0,32,31
1656789846094,MATH 109,B02,083216,Ganzberger; Geoffrey Michael,1,0,32,31
1656789846094,MATH 109,B03,093479,Ganzberger; Geoffrey Michael,6,0,32,26
1656789852126,MATH 142A,A01,083219,Chow; Bennett,6,0,32,26
1656789852126,MATH 142A,A02,083220,Chow; Bennett,9,0,32,23
1656789852126,MATH 142A,A03,093480,Chow; Bennett,7,0,32,25
1656789852126,MATH 142A,B03,093481,Chow; Bennett,7,0,32,25
1656789852126,MATH 142A,B04,093558,Chow; Bennett,10,0,32,22
1656789852126,MATH 142A,B05,093559,Chow; Bennett,6,0,32,26
1656789858152,MATH 193A,A01,083224,Rotar; Vladimir,6,0,34,28
1656789858152,MATH 193A,A02,083225,Rotar; Vladimir,3,0,34,31
1656789858152,MATH 193A,A03,083781,Rotar; Vladimir,1,0,34,33
1656789858152,MATH 193A,A04,083782,Rotar; Vladimir,6,0,34,28
1656789858152,MATH 193A,A05,093482,Rotar; Vladimir,6,0,34,28
1656789864175,MATH 197,001,091859,McAuley; Julian John,9999,0,9999,0
1656789864175,MATH 197,002,095566,Kedlaya; Kiran S.,9997,0,9999,2
1656789864175,MATH 197,003,095567,Xiao; Ming,9999,0,9999,0
1656789864175,MATH 197,004,095571,Perols; Johan Lars,9998,0,9999,1
1656789871248,COGS 9,A01,083615,Shannon; Kyle Michael,6,0,75,69
1656789877276,COGS 11,A01,083617,Boyle; Mary E. T.,18,0,48,30
1656789883302,COGS 13,A01,083071,Bastos; Amalia Pinkusfeld,8,0,71,63
1656789889334,COGS 14A,A01,092681,Semenuks; Arturs,0,1,100,100
1656789895359,COGS 14B,A01,083073,Cheng; Tzu-Han,5,0,63,58
1656789901388,COGS 17,A01,092677,Semenuks; Arturs,4,0,81,77
1656789907421,COGS 100,A01,083619,Allen; Michael Gordon,15,0,70,55
1656789913451,COGS 101A,A01,083621,Davis; Joshua Daniel,9,0,68,59
1656789919477,COGS 101B,A01,091572,Allen; Michael Gordon,8,0,65,57
1656789925507,COGS 101C,A01,083625,Delgado; Tania,17,0,35,18
1656789931531,COGS 107A,A01,083627,Boyle; Mary E. T.,13,0,60,47
1656789937555,COGS 118A,A01,083075,Gupta; Anjum,15,0,76,61
1656789943581,CSE 3,A50,083646,Miranda; Gregory Joseph,22,0,50,28
1656789949607,CSE 8A,A50,083650,Miranda; Gregory Joseph,17,1,56,39
1656789955634,CSE 11,A01,083080,Cao; Yingjun,4,15,40,36
1656789961669,CSE 12,A01,083652,Krause-Levy; Sophia Louisa,20,1,120,100
1656789967714,CSE 15L,A01,083654,Morris; Justin Loren,8,0,50,42
1656789967714,CSE 15L,A02,083655,Morris; Justin Loren,8,0,50,42
1656789973746,CSE 20,A01,083657,Tran; Khoa Dang,37,0,80,43
1656789979773,CSE 21,A01,095574,Bach; Quang Tran,21,0,48,27
1656789985817,CSE 30,A01,083084,Eldon; John,4,0,80,76
1656789985817,CSE 30,B01,095061,Bhaskar; Nishant,5,0,50,45
1656789991842,CSE 100,A01,083659,Cao; Yingjun,1,4,70,69
1656789997865,CSE 134B,A01,083661,Powell; Thomas Allan,18,0,100,82
1656790003889,CSE 140,A01,083663,Gungor; Onat,14,0,85,71
1656790009913,CSE 140L,A01,083088,Eldon; John,16,0,100,84
1656790015939,CSE 175,A01,083665,Kumar; Rakesh,3,0,25,22
1656790021964,CSE 190,A00,092507,Dubnov; Shlomo,7,0,20,13
1656790027997,ECE 45,A01,083139,Congero; Spencer William,5,0,75,70
1656790034024,ECE 65,A50,083695,Saad; Andrew S,12,0,30,18
1656790034024,ECE 65,A51,095125,Saad; Andrew S,25,0,26,1
1656790040047,ECE 109,A01,091882,Touri; Behrouz,15,0,70,55
1656790046075,ECE 180,A00,083140,Abi Samra; Nicholas Camill,0,0,30,30
1656790046075,ECE 180,B00,083141,Abi Samra; Nicholas Camill,0,0,30,30
1656790052102,MATH 10A,A01,083735,Patchell; Gregory David,1,0,30,29
1656790052102,MATH 10A,A02,083736,Patchell; Gregory David,20,0,30,10
1656790052102,MATH 10A,A03,083737,Patchell; Gregory David,15,0,30,15
1656790058136,MATH 10B,A01,083207,Lim; Seonhee,7,0,34,27
1656790058136,MATH 10B,A02,083208,Lim; Seonhee,9,0,35,26
1656790058136,MATH 10B,A03,093472,Lim; Seonhee,4,0,34,30
1656790058136,MATH 10B,B01,083739,Sinha; Shubham,9,0,30,21
1656790064165,MATH 18,A01,083743,Cinel; Cameron Alexander,6,0,30,24
1656790064165,MATH 18,A02,083744,Cinel; Cameron Alexander,15,0,30,15
1656790064165,MATH 18,A03,083745,Cinel; Cameron Alexander,8,0,30,22
1656790064165,MATH 18,B01,083748,Rideout; David Porter,3,0,37,34
1656790064165,MATH 18,B02,083749,Rideout; David Porter,3,0,36,33
1656790064165,MATH 18,B03,083750,Rideout; David Porter,1,0,37,36
1656790064165,MATH 18,B04,083751,Rideout; David Porter,5,0,36,31
1656790064165,MATH 18,B05,093473,Rideout; David Porter,4,0,36,32
1656790064165,MATH 18,B06,093474,Rideout; David Porter,5,0,36,31
1656790070189,MATH 20A,A01,083754,Zheng; Zequn,12,0,40,28
1656790076214,MATH 20B,A01,083756,Briones; Jor-el Thomas Caparas,1,0,36,35
1656790076214,MATH 20B,A02,083757,Briones; Jor-el Thomas Caparas,1,0,36,35
1656790076214,MATH 20B,A03,093475,Briones; Jor-el Thomas Caparas,0,0,36,36
1656790082245,MATH 20C,A01,083760,Briones; Jor-el Thomas Caparas,1,0,35,34
1656790082245,MATH 20C,A02,083761,Briones; Jor-el Thomas Caparas,8,0,35,27
1656790082245,MATH 20C,A03,093476,Briones; Jor-el Thomas Caparas,0,1,36,36
1656790082245,MATH 20C,B01,083762,Bach; Quang Tran,0,0,30,30
1656790088279,MATH 20D,A01,083765,Tran; Brian Kha,4,0,30,26
1656790088279,MATH 20D,A02,083766,Tran; Brian Kha,4,0,30,26
1656790088279,MATH 20D,A03,083767,Tran; Brian Kha,2,0,30,28
1656790094308,MATH 20E,A01,083771,Ganguly; Soumya,5,0,32,27
1656790094308,MATH 20E,A02,083772,Ganguly; Soumya,5,0,32,27
1656790094308,MATH 20E,B01,083773,Ciotti; Benjamin,18,0,35,17
1656790094308,MATH 20E,B02,083774,Ciotti; Benjamin,17,0,35,18
1656790100335,MATH 103A,A01,083777,Greenfeld; Be'Eri,2,0,36,34
1656790100335,MATH 103A,A02,083778,Greenfeld; Be'Eri,5,0,36,31
1656790100335,MATH 103A,A03,093561,Greenfeld; Be'Eri,4,0,36,32
1656790100335,MATH 103A,B01,083779,Greenfeld; Be'Eri,6,0,36,30
1656790100335,MATH 103A,B02,083780,Greenfeld; Be'Eri,2,0,36,34
1656790100335,MATH 103A,B03,093562,Greenfeld; Be'Eri,2,0,36,34
1656790106365,MATH 105,A01,085443,Carter; Anne Toulson,13,0,35,22
1656790106365,MATH 105,A02,093477,Carter; Anne Toulson,20,0,35,15
1656790112398,MATH 109,A01,083213,Ganzberger; Geoffrey Michael,2,0,34,32
1656790112398,MATH 109,A02,083214,Ganzberger; Geoffrey Michael,2,0,34,32
1656790112398,MATH 109,A03,093478,Ganzberger; Geoffrey Michael,1,0,34,33
1656790112398,MATH 109,B01,083215,Ganzberger; Geoffrey Michael,1,0,32,31
1656790112398,MATH 109,B02,083216,Ganzberger; Geoffrey Michael,1,0,32,31
1656790112398,MATH 109,B03,093479,Ganzberger; Geoffrey Michael,6,0,32,26
1656790118423,MATH 142A,A01,083219,Chow; Bennett,6,0,32,26
1656790118423,MATH 142A,A02,083220,Chow; Bennett,9,0,32,23
1656790118423,MATH 142A,A03,093480,Chow; Bennett,7,0,32,25
1656790118423,MATH 142A,B03,093481,Chow; Bennett,7,0,32,25
1656790118423,MATH 142A,B04,093558,Chow; Bennett,10,0,32,22
1656790118423,MATH 142A,B05,093559,Chow; Bennett,6,0,32,26
1656790124452,MATH 193A,A01,083224,Rotar; Vladimir,6,0,34,28
1656790124452,MATH 193A,A02,083225,Rotar; Vladimir,3,0,34,31
1656790124452,MATH 193A,A03,083781,Rotar; Vladimir,1,0,34,33
1656790124452,MATH 193A,A04,083782,Rotar; Vladimir,6,0,34,28
1656790124452,MATH 193A,A05,093482,Rotar; Vladimir,6,0,34,28
1656790130480,MATH 197,001,091859,McAuley; Julian John,9999,0,9999,0
1656790130480,MATH 197,002,095566,Kedlaya; Kiran S.,9997,0,9999,2
1656790130480,MATH 197,003,095567,Xiao; Ming,9999,0,9999,0
1656790130480,MATH 197,004,095571,Perols; Johan Lars,9998,0,9999,1
1656790137544,COGS 9,A01,083615,Shannon; Kyle Michael,6,0,75,69
1656790143570,COGS 11,A01,083617,Boyle; Mary E. T.,18,0,48,30
1656790149601,COGS 13,A01,083071,Bastos; Amalia Pinkusfeld,8,0,71,63
1656790155627,COGS 14A,A01,092681,Semenuks; Arturs,0,1,100,100
1656790161657,COGS 14B,A01,083073,Cheng; Tzu-Han,5,0,63,58
1656790167686,COGS 17,A01,092677,Semenuks; Arturs,4,0,81,77
1656790173714,COGS 100,A01,083619,Allen; Michael Gordon,15,0,70,55
1656790179742,COGS 101A,A01,083621,Davis; Joshua Daniel,9,0,68,59
1656790185770,COGS 101B,A01,091572,Allen; Michael Gordon,8,0,65,57
1656790191851,COGS 101C,A01,083625,Delgado; Tania,17,0,35,18
1656790197880,COGS 107A,A01,083627,Boyle; Mary E. T.,13,0,60,47
1656790203907,COGS 118A,A01,083075,Gupta; Anjum,15,0,76,61
1656790209934,CSE 3,A50,083646,Miranda; Gregory Joseph,22,0,50,28
1656790215967,CSE 8A,A50,083650,Miranda; Gregory Joseph,17,1,56,39
1656790221995,CSE 11,A01,083080,Cao; Yingjun,4,15,40,36
1656790228028,CSE 12,A01,083652,Krause-Levy; Sophia Louisa,20,1,120,100
1656790234052,CSE 15L,A01,083654,Morris; Justin Loren,8,0,50,42
1656790234052,CSE 15L,A02,083655,Morris; Justin Loren,8,0,50,42
1656790240077,CSE 20,A01,083657,Tran; Khoa Dang,37,0,80,43
1656790246106,CSE 21,A01,095574,Bach; Quang Tran,21,0,48,27
1656790252169,CSE 30,A01,083084,Eldon; John,4,0,80,76
1656790252169,CSE 30,B01,095061,Bhaskar; Nishant,5,0,50,45
1656790258198,CSE 100,A01,083659,Cao; Yingjun,1,4,70,69
1656790264226,CSE 134B,A01,083661,Powell; Thomas Allan,18,0,100,82
1656790270249,CSE 140,A01,083663,Gungor; Onat,14,0,85,71
1656790276276,CSE 140L,A01,083088,Eldon; John,16,0,100,84
1656790282299,CSE 175,A01,083665,Kumar; Rakesh,3,0,25,22
1656790288320,CSE 190,A00,092507,Dubnov; Shlomo,7,0,20,13
1656790294345,ECE 45,A01,083139,Congero; Spencer William,5,0,75,70
1656790300377,ECE 65,A50,083695,Saad; Andrew S,12,0,30,18
1656790300377,ECE 65,A51,095125,Saad; Andrew S,25,0,26,1
1656790306404,ECE 109,A01,091882,Touri; Behrouz,15,0,70,55
1656790312435,ECE 180,A00,083140,Abi Samra; Nicholas Camill,0,0,30,30
1656790312435,ECE 180,B00,083141,Abi Samra; Nicholas Camill,0,0,30,30
1656790318475,MATH 10A,A01,083735,Patchell; Gregory David,1,0,30,29
1656790318475,MATH 10A,A02,083736,Patchell; Gregory David,20,0,30,10
1656790318475,MATH 10A,A03,083737,Patchell; Gregory David,15,0,30,15
1656790324500,MATH 10B,A01,083207,Lim; Seonhee,7,0,34,27
1656790324500,MATH 10B,A02,083208,Lim; Seonhee,9,0,35,26
1656790324500,MATH 10B,A03,093472,Lim; Seonhee,4,0,34,30
1656790324500,MATH 10B,B01,083739,Sinha; Shubham,9,0,30,21
1656790330526,MATH 18,A01,083743,Cinel; Cameron Alexander,6,0,30,24
1656790330526,MATH 18,A02,083744,Cinel; Cameron Alexander,15,0,30,15
1656790330526,MATH 18,A03,083745,Cinel; Cameron Alexander,8,0,30,22
1656790330526,MATH 18,B01,083748,Rideout; David Porter,3,0,37,34
1656790330526,MATH 18,B02,083749,Rideout; David Porter,3,0,36,33
1656790330526,MATH 18,B03,083750,Rideout; David Porter,1,0,37,36
1656790330526,MATH 18,B04,083751,Rideout; David Porter,5,0,36,31
1656790330526,MATH 18,B05,093473,Rideout; David Porter,4,0,36,32
1656790330526,MATH 18,B06,093474,Rideout; David Porter,5,0,36,31
1656790336549,MATH 20A,A01,083754,Zheng; Zequn,12,0,40,28
1656790342577,MATH 20B,A01,083756,Briones; Jor-el Thomas Caparas,1,0,36,35
1656790342577,MATH 20B,A02,083757,Briones; Jor-el Thomas Caparas,1,0,36,35
1656790342577,MATH 20B,A03,093475,Briones; Jor-el Thomas Caparas,0,0,36,36
1656790348606,MATH 20C,A01,083760,Briones; Jor-el Thomas Caparas,1,0,35,34
1656790348606,MATH 20C,A02,083761,Briones; Jor-el Thomas Caparas,8,0,35,27
1656790348606,MATH 20C,A03,093476,Briones; Jor-el Thomas Caparas,0,1,36,36
1656790348606,MATH 20C,B01,083762,Bach; Quang Tran,0,0,30,30
1656790354634,MATH 20D,A01,083765,Tran; Brian Kha,4,0,30,26
1656790354634,MATH 20D,A02,083766,Tran; Brian Kha,4,0,30,26
1656790354634,MATH 20D,A03,083767,Tran; Brian Kha,2,0,30,28
1656790360659,MATH 20E,A01,083771,Ganguly; Soumya,5,0,32,27
1656790360659,MATH 20E,A02,083772,Ganguly; Soumya,5,0,32,27
1656790360659,MATH 20E,B01,083773,Ciotti; Benjamin,18,0,35,17
1656790360659,MATH 20E,B02,083774,Ciotti; Benjamin,17,0,35,18
1656790366683,MATH 103A,A01,083777,Greenfeld; Be'Eri,2,0,36,34
1656790366683,MATH 103A,A02,083778,Greenfeld; Be'Eri,5,0,36,31
1656790366683,MATH 103A,A03,093561,Greenfeld; Be'Eri,4,0,36,32
1656790366683,MATH 103A,B01,083779,Greenfeld; Be'Eri,6,0,36,30
1656790366683,MATH 103A,B02,083780,Greenfeld; Be'Eri,2,0,36,34
1656790366683,MATH 103A,B03,093562,Greenfeld; Be'Eri,2,0,36,34
1656790372714,MATH 105,A01,085443,Carter; Anne Toulson,13,0,35,22
1656790372714,MATH 105,A02,093477,Carter; Anne Toulson,20,0,35,15
1656790378858,MATH 109,A01,083213,Ganzberger; Geoffrey Michael,2,0,34,32
1656790378858,MATH 109,A02,083214,Ganzberger; Geoffrey Michael,2,0,34,32
1656790378858,MATH 109,A03,093478,Ganzberger; Geoffrey Michael,1,0,34,33
1656790378858,MATH 109,B01,083215,Ganzberger; Geoffrey Michael,1,0,32,31
1656790378858,MATH 109,B02,083216,Ganzberger; Geoffrey Michael,1,0,32,31
1656790378858,MATH 109,B03,093479,Ganzberger; Geoffrey Michael,6,0,32,26
1656790384898,MATH 142A,A01,083219,Chow; Bennett,6,0,32,26
1656790384898,MATH 142A,A02,083220,Chow; Bennett,9,0,32,23
1656790384898,MATH 142A,A03,093480,Chow; Bennett,7,0,32,25
1656790384898,MATH 142A,B03,093481,Chow; Bennett,7,0,32,25
1656790384898,MATH 142A,B04,093558,Chow; Bennett,10,0,32,22
1656790384898,MATH 142A,B05,093559,Chow; Bennett,6,0,32,26
1656790390930,MATH 193A,A01,083224,Rotar; Vladimir,6,0,34,28
1656790390930,MATH 193A,A02,083225,Rotar; Vladimir,3,0,34,31
1656790390930,MATH 193A,A03,083781,Rotar; Vladimir,1,0,34,33
1656790390930,MATH 193A,A04,083782,Rotar; Vladimir,6,0,34,28
1656790390930,MATH 193A,A05,093482,Rotar; Vladimir,6,0,34,28
1656790396961,MATH 197,001,091859,McAuley; Julian John,9999,0,9999,0
1656790396961,MATH 197,002,095566,Kedlaya; Kiran S.,9997,0,9999,2
1656790396961,MATH 197,003,095567,Xiao; Ming,9999,0,9999,0
1656790396961,MATH 197,004,095571,Perols; Johan Lars,9998,0,9999,1
1656790404026,COGS 9,A01,083615,Shannon; Kyle Michael,6,0,75,69
1656790410051,COGS 11,A01,083617,Boyle; Mary E. T.,18,0,48,30
1656790416080,COGS 13,A01,083071,Bastos; Amalia Pinkusfeld,8,0,71,63
1656790422110,COGS 14A,A01,092681,Semenuks; Arturs,0,1,100,100
1656790428134,COGS 14B,A01,083073,Cheng; Tzu-Han,5,0,63,58
1656790434156,COGS 17,A01,092677,Semenuks; Arturs,4,0,81,77
1656790440193,COGS 100,A01,083619,Allen; Michael Gordon,15,0,70,55
1656790446221,COGS 101A,A01,083621,Davis; Joshua Daniel,9,0,68,59
1656790452243,COGS 101B,A01,091572,Allen; Michael Gordon,8,0,65,57
1656790458271,COGS 101C,A01,083625,Delgado; Tania,17,0,35,18
1656790464305,COGS 107A,A01,083627,Boyle; Mary E. T.,13,0,60,47
1656790470329,COGS 118A,A01,083075,Gupta; Anjum,15,0,76,61
1656790476361,CSE 3,A50,083646,Miranda; Gregory Joseph,22,0,50,28
1656790482386,CSE 8A,A50,083650,Miranda; Gregory Joseph,17,1,56,39
1656790488414,CSE 11,A01,083080,Cao; Yingjun,4,15,40,36
1656790494438,CSE 12,A01,083652,Krause-Levy; Sophia Louisa,20,1,120,100
1656790500467,CSE 15L,A01,083654,Morris; Justin Loren,8,0,50,42
1656790500467,CSE 15L,A02,083655,Morris; Justin Loren,8,0,50,42
1656790506497,CSE 20,A01,083657,Tran; Khoa Dang,37,0,80,43
1656790512525,CSE 21,A01,095574,Bach; Quang Tran,21,0,48,27
1656790518555,CSE 30,A01,083084,Eldon; John,4,0,80,76
1656790518555,CSE 30,B01,095061,Bhaskar; Nishant,5,0,50,45
1656790524585,CSE 100,A01,083659,Cao; Yingjun,1,4,70,69
1656790530608,CSE 134B,A01,083661,Powell; Thomas Allan,18,0,100,82
1656790536632,CSE 140,A01,083663,Gungor; Onat,14,0,85,71
1656790542660,CSE 140L,A01,083088,Eldon; John,16,0,100,84
1656790548689,CSE 175,A01,083665,Kumar; Rakesh,3,0,25,22
1656790554713,CSE 190,A00,092507,Dubnov; Shlomo,7,0,20,13
1656790560738,ECE 45,A01,083139,Congero; Spencer William,5,0,75,70
1656790566771,ECE 65,A50,083695,Saad; Andrew S,12,0,30,18
1656790566771,ECE 65,A51,095125,Saad; Andrew S,25,0,26,1
1656790572796,ECE 109,A01,091882,Touri; Behrouz,15,0,70,55
1656790578820,ECE 180,A00,083140,Abi Samra; Nicholas Camill,0,0,30,30
1656790578820,ECE 180,B00,083141,Abi Samra; Nicholas Camill,0,0,30,30
1656790584846,MATH 10A,A01,083735,Patchell; Gregory David,1,0,30,29
1656790584846,MATH 10A,A02,083736,Patchell; Gregory David,20,0,30,10
1656790584846,MATH 10A,A03,083737,Patchell; Gregory David,15,0,30,15
1656790590874,MATH 10B,A01,083207,Lim; Seonhee,7,0,34,27
1656790590874,MATH 10B,A02,083208,Lim; Seonhee,9,0,35,26
1656790590874,MATH 10B,A03,093472,Lim; Seonhee,4,0,34,30
1656790590874,MATH 10B,B01,083739,Sinha; Shubham,9,0,30,21
1656790596903,MATH 18,A01,083743,Cinel; Cameron Alexander,6,0,30,24
1656790596903,MATH 18,A02,083744,Cinel; Cameron Alexander,15,0,30,15
1656790596903,MATH 18,A03,083745,Cinel; Cameron Alexander,8,0,30,22
1656790596903,MATH 18,B01,083748,Rideout; David Porter,3,0,37,34
1656790596903,MATH 18,B02,083749,Rideout; David Porter,3,0,36,33
1656790596903,MATH 18,B03,083750,Rideout; David Porter,1,0,37,36
1656790596903,MATH 18,B04,083751,Rideout; David Porter,5,0,36,31
1656790596903,MATH 18,B05,093473,Rideout; David Porter,4,0,36,32
1656790596903,MATH 18,B06,093474,Rideout; David Porter,5,0,36,31
1656790602926,MATH 20A,A01,083754,Zheng; Zequn,12,0,40,28
1656790608956,MATH 20B,A01,083756,Briones; Jor-el Thomas Caparas,1,0,36,35
1656790608956,MATH 20B,A02,083757,Briones; Jor-el Thomas Caparas,1,0,36,35
1656790608956,MATH 20B,A03,093475,Briones; Jor-el Thomas Caparas,0,0,36,36
1656790614981,MATH 20C,A01,083760,Briones; Jor-el Thomas Caparas,1,0,35,34
1656790614981,MATH 20C,A02,083761,Briones; Jor-el Thomas Caparas,8,0,35,27
1656790614981,MATH 20C,A03,093476,Briones; Jor-el Thomas Caparas,0,1,36,36
1656790614981,MATH 20C,B01,083762,Bach; Quang Tran,0,0,30,30
1656790621012,MATH 20D,A01,083765,Tran; Brian Kha,4,0,30,26
1656790621012,MATH 20D,A02,083766,Tran; Brian Kha,4,0,30,26
1656790621012,MATH 20D,A03,083767,Tran; Brian Kha,2,0,30,28
1656790627047,MATH 20E,A01,083771,Ganguly; Soumya,5,0,32,27
1656790627047,MATH 20E,A02,083772,Ganguly; Soumya,5,0,32,27
1656790627047,MATH 20E,B01,083773,Ciotti; Benjamin,18,0,35,17
1656790627047,MATH 20E,B02,083774,Ciotti; Benjamin,17,0,35,18
1656790633084,MATH 103A,A01,083777,Greenfeld; Be'Eri,2,0,36,34
1656790633084,MATH 103A,A02,083778,Greenfeld; Be'Eri,5,0,36,31
1656790633084,MATH 103A,A03,093561,Greenfeld; Be'Eri,4,0,36,32
1656790633084,MATH 103A,B01,083779,Greenfeld; Be'Eri,6,0,36,30
1656790633084,MATH 103A,B02,083780,Greenfeld; Be'Eri,2,0,36,34
1656790633084,MATH 103A,B03,093562,Greenfeld; Be'Eri,2,0,36,34
1656790639112,MATH 105,A01,085443,Carter; Anne Toulson,13,0,35,22
1656790639112,MATH 105,A02,093477,Carter; Anne Toulson,20,0,35,15
1656790645144,MATH 109,A01,083213,Ganzberger; Geoffrey Michael,2,0,34,32
1656790645144,MATH 109,A02,083214,Ganzberger; Geoffrey Michael,2,0,34,32
1656790645144,MATH 109,A03,093478,Ganzberger; Geoffrey Michael,1,0,34,33
1656790645144,MATH 109,B01,083215,Ganzberger; Geoffrey Michael,1,0,32,31
1656790645144,MATH 109,B02,083216,Ganzberger; Geoffrey Michael,1,0,32,31
1656790645144,MATH 109,B03,093479,Ganzberger; Geoffrey Michael,6,0,32,26
1656790651176,MATH 142A,A01,083219,Chow; Bennett,6,0,32,26
1656790651176,MATH 142A,A02,083220,Chow; Bennett,9,0,32,23
1656790651176,MATH 142A,A03,093480,Chow; Bennett,7,0,32,25
1656790651176,MATH 142A,B03,093481,Chow; Bennett,7,0,32,25
1656790651176,MATH 142A,B04,093558,Chow; Bennett,10,0,32,22
1656790651176,MATH 142A,B05,093559,Chow; Bennett,6,0,32,26
1656790657208,MATH 193A,A01,083224,Rotar; Vladimir,6,0,34,28
1656790657208,MATH 193A,A02,083225,Rotar; Vladimir,3,0,34,31
1656790657208,MATH 193A,A03,083781,Rotar; Vladimir,1,0,34,33
1656790657208,MATH 193A,A04,083782,Rotar; Vladimir,6,0,34,28
1656790657208,MATH 193A,A05,093482,Rotar; Vladimir,6,0,34,28
1656790663239,MATH 197,001,091859,McAuley; Julian John,9999,0,9999,0
1656790663239,MATH 197,002,095566,Kedlaya; Kiran S.,9997,0,9999,2
1656790663239,MATH 197,003,095567,Xiao; Ming,9999,0,9999,0
1656790663239,MATH 197,004,095571,Perols; Johan Lars,9998,0,9999,1
1656790670297,COGS 9,A01,083615,Shannon; Kyle Michael,6,0,75,69
1656790676321,COGS 11,A01,083617,Boyle; Mary E. T.,18,0,48,30
1656790682346,COGS 13,A01,083071,Bastos; Amalia Pinkusfeld,8,0,71,63
1656790688376,COGS 14A,A01,092681,Semenuks; Arturs,0,1,100,100
1656790694399,COGS 14B,A01,083073,Cheng; Tzu-Han,5,0,63,58
1656790700422,COGS 17,A01,092677,Semenuks; Arturs,4,0,81,77
1656790706453,COGS 100,A01,083619,Allen; Michael Gordon,15,0,70,55
1656790712476,COGS 101A,A01,083621,Davis; Joshua Daniel,9,0,68,59
1656790718501,COGS 101B,A01,091572,Allen; Michael Gordon,8,0,65,57
1656790724528,COGS 101C,A01,083625,Delgado; Tania,17,0,35,18
1656790730551,COGS 107A,A01,083627,Boyle; Mary E. T.,13,0,60,47
1656790736588,COGS 118A,A01,083075,Gupta; Anjum,15,0,76,61
1656790742620,CSE 3,A50,083646,Miranda; Gregory Joseph,22,0,50,28
1656790748644,CSE 8A,A50,083650,Miranda; Gregory Joseph,17,1,56,39
1656790754669,CSE 11,A01,083080,Cao; Yingjun,4,15,40,36
1656790760700,CSE 12,A01,083652,Krause-Levy; Sophia Louisa,20,1,120,100
1656790766723,CSE 15L,A01,083654,Morris; Justin Loren,8,0,50,42
1656790766723,CSE 15L,A02,083655,Morris; Justin Loren,8,0,50,42
1656790772752,CSE 20,A01,083657,Tran; Khoa Dang,37,0,80,43
1656790778780,CSE 21,A01,095574,Bach; Quang Tran,21,0,48,27
1656790784805,CSE 30,A01,083084,Eldon; John,4,0,80,76
1656790784805,CSE 30,B01,095061,Bhaskar; Nishant,5,0,50,45
1656790790833,CSE 100,A01,083659,Cao; Yingjun,1,4,70,69
1656790796856,CSE 134B,A01,083661,Powell; Thomas Allan,18,0,100,82
1656790802884,CSE 140,A01,083663,Gungor; Onat,14,0,85,71
1656790808910,CSE 140L,A01,083088,Eldon; John,16,0,100,84
1656790814940,CSE 175,A01,083665,Kumar; Rakesh,3,0,25,22
1656790820982,CSE 190,A00,092507,Dubnov; Shlomo,7,0,20,13
1656790827004,ECE 45,A01,083139,Congero; Spencer William,5,0,75,70
1656790833033,ECE 65,A50,083695,Saad; Andrew S,12,0,30,18
1656790833033,ECE 65,A51,095125,Saad; Andrew S,25,0,26,1
1656790839058,ECE 109,A01,091882,Touri; Behrouz,15,0,70,55
1656790845085,ECE 180,A00,083140,Abi Samra; Nicholas Camill,0,0,30,30
1656790845085,ECE 180,B00,083141,Abi Samra; Nicholas Camill,0,0,30,30
1656790851116,MATH 10A,A01,083735,Patchell; Gregory David,1,0,30,29
1656790851116,MATH 10A,A02,083736,Patchell; Gregory David,20,0,30,10
1656790851116,MATH 10A,A03,083737,Patchell; Gregory David,15,0,30,15
1656790857147,MATH 10B,A01,083207,Lim; Seonhee,7,0,34,27
1656790857147,MATH 10B,A02,083208,Lim; Seonhee,9,0,35,26
1656790857147,MATH 10B,A03,093472,Lim; Seonhee,4,0,34,30
1656790857147,MATH 10B,B01,083739,Sinha; Shubham,9,0,30,21
1656790863188,MATH 18,A01,083743,Cinel; Cameron Alexander,6,0,30,24
1656790863188,MATH 18,A02,083744,Cinel; Cameron Alexander,15,0,30,15
1656790863188,MATH 18,A03,083745,Cinel; Cameron Alexander,8,0,30,22
1656790863188,MATH 18,B01,083748,Rideout; David Porter,3,0,37,34
1656790863188,MATH 18,B02,083749,Rideout; David Porter,3,0,36,33
1656790863188,MATH 18,B03,083750,Rideout; David Porter,1,0,37,36
1656790863188,MATH 18,B04,083751,Rideout; David Porter,5,0,36,31
1656790863188,MATH 18,B05,093473,Rideout; David Porter,4,0,36,32
1656790863188,MATH 18,B06,093474,Rideout; David Porter,5,0,36,31
1656790869212,MATH 20A,A01,083754,Zheng; Zequn,12,0,40,28
1656790875236,MATH 20B,A01,083756,Briones; Jor-el Thomas Caparas,1,0,36,35
1656790875236,MATH 20B,A02,083757,Briones; Jor-el Thomas Caparas,1,0,36,35
1656790875236,MATH 20B,A03,093475,Briones; Jor-el Thomas Caparas,0,0,36,36
1656790881266,MATH 20C,A01,083760,Briones; Jor-el Thomas Caparas,1,0,35,34
1656790881266,MATH 20C,A02,083761,Briones; Jor-el Thomas Caparas,8,0,35,27
1656790881266,MATH 20C,A03,093476,Briones; Jor-el Thomas Caparas,0,1,36,36
1656790881266,MATH 20C,B01,083762,Bach; Quang Tran,0,0,30,30
1656790887292,MATH 20D,A01,083765,Tran; Brian Kha,4,0,30,26
1656790887292,MATH 20D,A02,083766,Tran; Brian Kha,4,0,30,26
1656790887292,MATH 20D,A03,083767,Tran; Brian Kha,2,0,30,28
1656790893324,MATH 20E,A01,083771,Ganguly; Soumya,5,0,32,27
1656790893324,MATH 20E,A02,083772,Ganguly; Soumya,5,0,32,27
1656790893324,MATH 20E,B01,083773,Ciotti; Benjamin,18,0,35,17
1656790893324,MATH 20E,B02,083774,Ciotti; Benjamin,17,0,35,18
1656790899351,MATH 103A,A01,083777,Greenfeld; Be'Eri,2,0,36,34
1656790899351,MATH 103A,A02,083778,Greenfeld; Be'Eri,5,0,36,31
1656790899351,MATH 103A,A03,093561,Greenfeld; Be'Eri,4,0,36,32
1656790899351,MATH 103A,B01,083779,Greenfeld; Be'Eri,6,0,36,30
1656790899351,MATH 103A,B02,083780,Greenfeld; Be'Eri,2,0,36,34
1656790899351,MATH 103A,B03,093562,Greenfeld; Be'Eri,2,0,36,34
1656790905375,MATH 105,A01,085443,Carter; Anne Toulson,13,0,35,22
1656790905375,MATH 105,A02,093477,Carter; Anne Toulson,20,0,35,15
1656790911400,MATH 109,A01,083213,Ganzberger; Geoffrey Michael,2,0,34,32
1656790911400,MATH 109,A02,083214,Ganzberger; Geoffrey Michael,2,0,34,32
1656790911400,MATH 109,A03,093478,Ganzberger; Geoffrey Michael,1,0,34,33
1656790911400,MATH 109,B01,083215,Ganzberger; Geoffrey Michael,1,0,32,31
1656790911400,MATH 109,B02,083216,Ganzberger; Geoffrey Michael,1,0,32,31
1656790911400,MATH 109,B03,093479,Ganzberger; Geoffrey Michael,6,0,32,26
1656790917426,MATH 142A,A01,083219,Chow; Bennett,6,0,32,26
1656790917426,MATH 142A,A02,083220,Chow; Bennett,9,0,32,23
1656790917426,MATH 142A,A03,093480,Chow; Bennett,7,0,32,25
1656790917426,MATH 142A,B03,093481,Chow; Bennett,7,0,32,25
1656790917426,MATH 142A,B04,093558,Chow; Bennett,10,0,32,22
1656790917426,MATH 142A,B05,093559,Chow; Bennett,6,0,32,26
1656790923452,MATH 193A,A01,083224,Rotar; Vladimir,6,0,34,28
1656790923452,MATH 193A,A02,083225,Rotar; Vladimir,3,0,34,31
1656790923452,MATH 193A,A03,083781,Rotar; Vladimir,1,0,34,33
1656790923452,MATH 193A,A04,083782,Rotar; Vladimir,6,0,34,28
1656790923452,MATH 193A,A05,093482,Rotar; Vladimir,6,0,34,28
1656790929476,MATH 197,001,091859,McAuley; Julian John,9999,0,9999,0
1656790929476,MATH 197,002,095566,Kedlaya; Kiran S.,9997,0,9999,2
1656790929476,MATH 197,003,095567,Xiao; Ming,9999,0,9999,0
1656790929476,MATH 197,004,095571,Perols; Johan Lars,9998,0,9999,1
1656790936551,COGS 9,A01,083615,Shannon; Kyle Michael,6,0,75,69
1656790942576,COGS 11,A01,083617,Boyle; Mary E. T.,18,0,48,30
1656790948601,COGS 13,A01,083071,Bastos; Amalia Pinkusfeld,8,0,71,63
1656790954627,COGS 14A,A01,092681,Semenuks; Arturs,0,1,100,100
1656790960651,COGS 14B,A01,083073,Cheng; Tzu-Han,5,0,63,58
1656790966686,COGS 17,A01,092677,Semenuks; Arturs,4,0,81,77
1656790972800,COGS 100,A01,083619,Allen; Michael Gordon,15,0,70,55
1656790978825,COGS 101A,A01,083621,Davis; Joshua Daniel,9,0,68,59
1656790984848,COGS 101B,A01,091572,Allen; Michael Gordon,8,0,65,57
1656790990872,COGS 101C,A01,083625,Delgado; Tania,17,0,35,18
1656790996896,COGS 107A,A01,083627,Boyle; Mary E. T.,13,0,60,47
1656791002919,COGS 118A,A01,083075,Gupta; Anjum,15,0,76,61
1656791008950,CSE 3,A50,083646,Miranda; Gregory Joseph,22,0,50,28
1656791014977,CSE 8A,A50,083650,Miranda; Gregory Joseph,17,1,56,39
1656791021009,CSE 11,A01,083080,Cao; Yingjun,4,15,40,36
1656791027033,CSE 12,A01,083652,Krause-Levy; Sophia Louisa,20,1,120,100
1656791033060,CSE 15L,A01,083654,Morris; Justin Loren,8,0,50,42
1656791033060,CSE 15L,A02,083655,Morris; Justin Loren,8,0,50,42
1656791039089,CSE 20,A01,083657,Tran; Khoa Dang,37,0,80,43
1656791045113,CSE 21,A01,095574,Bach; Quang Tran,21,0,48,27
1656791051141,CSE 30,A01,083084,Eldon; John,4,0,80,76
1656791051141,CSE 30,B01,095061,Bhaskar; Nishant,5,0,50,45
1656791057171,CSE 100,A01,083659,Cao; Yingjun,1,4,70,69
1656791063195,CSE 134B,A01,083661,Powell; Thomas Allan,18,0,100,82
1656791069219,CSE 140,A01,083663,Gungor; Onat,14,0,85,71
1656791075244,CSE 140L,A01,083088,Eldon; John,16,0,100,84
1656791081271,CSE 175,A01,083665,Kumar; Rakesh,3,0,25,22
1656791087295,CSE 190,A00,092507,Dubnov; Shlomo,7,0,20,13
1656791093330,ECE 45,A01,083139,Congero; Spencer William,5,0,75,70
1656791099356,ECE 65,A50,083695,Saad; Andrew S,12,0,30,18
1656791099356,ECE 65,A51,095125,Saad; Andrew S,25,0,26,1
1656791105381,ECE 109,A01,091882,Touri; Behrouz,15,0,70,55
1656791111406,ECE 180,A00,083140,Abi Samra; Nicholas Camill,0,0,30,30
1656791111406,ECE 180,B00,083141,Abi Samra; Nicholas Camill,0,0,30,30
1656791117439,MATH 10A,A01,083735,Patchell; Gregory David,1,0,30,29
1656791117439,MATH 10A,A02,083736,Patchell; Gregory David,20,0,30,10
1656791117439,MATH 10A,A03,083737,Patchell; Gregory David,15,0,30,15
1656791123482,MATH 10B,A01,083207,Lim; Seonhee,7,0,34,27
1656791123482,MATH 10B,A02,083208,Lim; Seonhee,9,0,35,26
1656791123482,MATH 10B,A03,093472,Lim; Seonhee,4,0,34,30
1656791123482,MATH 10B,B01,083739,Sinha; Shubham,9,0,30,21
1656791129535,MATH 18,A01,083743,Cinel; Cameron Alexander,6,0,30,24
1656791129535,MATH 18,A02,083744,Cinel; Cameron Alexander,15,0,30,15
1656791129535,MATH 18,A03,083745,Cinel; Cameron Alexander,8,0,30,22
1656791129535,MATH 18,B01,083748,Rideout; David Porter,3,0,37,34
1656791129535,MATH 18,B02,083749,Rideout; David Porter,3,0,36,33
1656791129535,MATH 18,B03,083750,Rideout; David Porter,1,0,37,36
1656791129535,MATH 18,B04,083751,Rideout; David Porter,5,0,36,31
1656791129535,MATH 18,B05,093473,Rideout; David Porter,4,0,36,32
1656791129535,MATH 18,B06,093474,Rideout; David Porter,5,0,36,31
1656791135558,MATH 20A,A01,083754,Zheng; Zequn,12,0,40,28
1656791141590,MATH 20B,A01,083756,Briones; Jor-el Thomas Caparas,1,0,36,35
1656791141590,MATH 20B,A02,083757,Briones; Jor-el Thomas Caparas,1,0,36,35
1656791141590,MATH 20B,A03,093475,Briones; Jor-el Thomas Caparas,0,0,36,36
1656791147624,MATH 20C,A01,083760,Briones; Jor-el Thomas Caparas,1,0,35,34
1656791147624,MATH 20C,A02,083761,Briones; Jor-el Thomas Caparas,8,0,35,27
1656791147624,MATH 20C,A03,093476,Briones; Jor-el Thomas Caparas,0,1,36,36
1656791147624,MATH 20C,B01,083762,Bach; Quang Tran,0,0,30,30
1656791153655,MATH 20D,A01,083765,Tran; Brian Kha,4,0,30,26
1656791153655,MATH 20D,A02,083766,Tran; Brian Kha,4,0,30,26
1656791153655,MATH 20D,A03,083767,Tran; Brian Kha,2,0,30,28
1656791159686,MATH 20E,A01,083771,Ganguly; Soumya,5,0,32,27
1656791159686,MATH 20E,A02,083772,Ganguly; Soumya,5,0,32,27
1656791159686,MATH 20E,B01,083773,Ciotti; Benjamin,18,0,35,17
1656791159686,MATH 20E,B02,083774,Ciotti; Benjamin,17,0,35,18
1656791165714,MATH 103A,A01,083777,Greenfeld; Be'Eri,2,0,36,34
1656791165714,MATH 103A,A02,083778,Greenfeld; Be'Eri,5,0,36,31
1656791165714,MATH 103A,A03,093561,Greenfeld; Be'Eri,4,0,36,32
1656791165714,MATH 103A,B01,083779,Greenfeld; Be'Eri,6,0,36,30
1656791165714,MATH 103A,B02,083780,Greenfeld; Be'Eri,2,0,36,34
1656791165714,MATH 103A,B03,093562,Greenfeld; Be'Eri,2,0,36,34
1656791171739,MATH 105,A01,085443,Carter; Anne Toulson,13,0,35,22
1656791171739,MATH 105,A02,093477,Carter; Anne Toulson,20,0,35,15
1656791177767,MATH 109,A01,083213,Ganzberger; Geoffrey Michael,2,0,34,32
1656791177767,MATH 109,A02,083214,Ganzberger; Geoffrey Michael,2,0,34,32
1656791177767,MATH 109,A03,093478,Ganzberger; Geoffrey Michael,1,0,34,33
1656791177767,MATH 109,B01,083215,Ganzberger; Geoffrey Michael,1,0,32,31
1656791177767,MATH 109,B02,083216,Ganzberger; Geoffrey Michael,1,0,32,31
1656791177767,MATH 109,B03,093479,Ganzberger; Geoffrey Michael,6,0,32,26
1656791183793,MATH 142A,A01,083219,Chow; Bennett,6,0,32,26
1656791183793,MATH 142A,A02,083220,Chow; Bennett,9,0,32,23
1656791183793,MATH 142A,A03,093480,Chow; Bennett,7,0,32,25
1656791183793,MATH 142A,B03,093481,Chow; Bennett,7,0,32,25
1656791183793,MATH 142A,B04,093558,Chow; Bennett,10,0,32,22
1656791183793,MATH 142A,B05,093559,Chow; Bennett,6,0,32,26
1656791189819,MATH 193A,A01,083224,Rotar; Vladimir,6,0,34,28
1656791189819,MATH 193A,A02,083225,Rotar; Vladimir,3,0,34,31
1656791189819,MATH 193A,A03,083781,Rotar; Vladimir,1,0,34,33
1656791189819,MATH 193A,A04,083782,Rotar; Vladimir,6,0,34,28
1656791189819,MATH 193A,A05,093482,Rotar; Vladimir,6,0,34,28
1656791195843,MATH 197,001,091859,McAuley; Julian John,9999,0,9999,0
1656791195843,MATH 197,002,095566,Kedlaya; Kiran S.,9997,0,9999,2
1656791195843,MATH 197,003,095567,Xiao; Ming,9999,0,9999,0
1656791195843,MATH 197,004,095571,Perols; Johan Lars,9998,0,9999,1
1656791202914,COGS 9,A01,083615,Shannon; Kyle Michael,6,0,75,69
1656791208939,COGS 11,A01,083617,Boyle; Mary E. T.,18,0,48,30
1656791214962,COGS 13,A01,083071,Bastos; Amalia Pinkusfeld,8,0,71,63
1656791220990,COGS 14A,A01,092681,Semenuks; Arturs,0,1,100,100
1656791227021,COGS 14B,A01,083073,Cheng; Tzu-Han,5,0,63,58
1656791233057,COGS 17,A01,092677,Semenuks; Arturs,4,0,81,77
1656791239083,COGS 100,A01,083619,Allen; Michael Gordon,15,0,70,55
1656791245107,COGS 101A,A01,083621,Davis; Joshua Daniel,9,0,68,59
1656791251140,COGS 101B,A01,091572,Allen; Michael Gordon,8,0,65,57
1656791257175,COGS 101C,A01,083625,Delgado; Tania,17,0,35,18
1656791263203,COGS 107A,A01,083627,Boyle; Mary E. T.,13,0,60,47
1656791269227,COGS 118A,A01,083075,Gupta; Anjum,15,0,76,61
1656791275258,CSE 3,A50,083646,Miranda; Gregory Joseph,22,0,50,28
1656791281286,CSE 8A,A50,083650,Miranda; Gregory Joseph,17,1,56,39
1656791287309,CSE 11,A01,083080,Cao; Yingjun,4,15,40,36
1656791293335,CSE 12,A01,083652,Krause-Levy; Sophia Louisa,20,1,120,100
1656791299364,CSE 15L,A01,083654,Morris; Justin Loren,8,0,50,42
1656791299364,CSE 15L,A02,083655,Morris; Justin Loren,8,0,50,42
1656791305390,CSE 20,A01,083657,Tran; Khoa Dang,37,0,80,43
1656791311415,CSE 21,A01,095574,Bach; Quang Tran,21,0,48,27
1656791317452,CSE 30,A01,083084,Eldon; John,4,0,80,76
1656791317452,CSE 30,B01,095061,Bhaskar; Nishant,5,0,50,45
1656791323481,CSE 100,A01,083659,Cao; Yingjun,1,4,70,69
1656791329506,CSE 134B,A01,083661,Powell; Thomas Allan,18,0,100,82
1656791335530,CSE 140,A01,083663,Gungor; Onat,14,0,85,71
1656791341554,CSE 140L,A01,083088,Eldon; John,16,0,100,84
1656791347584,CSE 175,A01,083665,Kumar; Rakesh,3,0,25,22
1656791353611,CSE 190,A00,092507,Dubnov; Shlomo,7,0,20,13
1656791359640,ECE 45,A01,083139,Congero; Spencer William,5,0,75,70
1656791365678,ECE 65,A50,083695,Saad; Andrew S,12,0,30,18
1656791365678,ECE 65,A51,095125,Saad; Andrew S,25,0,26,1
1656791371707,ECE 109,A01,091882,Touri; Behrouz,15,0,70,55
1656791377732,ECE 180,A00,083140,Abi Samra; Nicholas Camill,0,0,30,30
1656791377732,ECE 180,B00,083141,Abi Samra; Nicholas Camill,0,0,30,30
1656791383756,MATH 10A,A01,083735,Patchell; Gregory David,1,0,30,29
1656791383756,MATH 10A,A02,083736,Patchell; Gregory David,20,0,30,10
1656791383756,MATH 10A,A03,083737,Patchell; Gregory David,15,0,30,15
1656791389784,MATH 10B,A01,083207,Lim; Seonhee,7,0,34,27
1656791389784,MATH 10B,A02,083208,Lim; Seonhee,9,0,35,26
1656791389784,MATH 10B,A03,093472,Lim; Seonhee,4,0,34,30
1656791389784,MATH 10B,B01,083739,Sinha; Shubham,9,0,30,21
1656791395821,MATH 18,A01,083743,Cinel; Cameron Alexander,6,0,30,24
1656791395821,MATH 18,A02,083744,Cinel; Cameron Alexander,15,0,30,15
1656791395821,MATH 18,A03,083745,Cinel; Cameron Alexander,8,0,30,22
1656791395821,MATH 18,B01,083748,Rideout; David Porter,3,0,37,34
1656791395821,MATH 18,B02,083749,Rideout; David Porter,3,0,36,33
1656791395821,MATH 18,B03,083750,Rideout; David Porter,1,0,37,36
1656791395821,MATH 18,B04,083751,Rideout; David Porter,5,0,36,31
1656791395821,MATH 18,B05,093473,Rideout; David Porter,4,0,36,32
1656791395821,MATH 18,B06,093474,Rideout; David Porter,5,0,36,31
1656791401849,MATH 20A,A01,083754,Zheng; Zequn,12,0,40,28
1656791407874,MATH 20B,A01,083756,Briones; Jor-el Thomas Caparas,1,0,36,35
1656791407874,MATH 20B,A02,083757,Briones; Jor-el Thomas Caparas,1,0,36,35
1656791407874,MATH 20B,A03,093475,Briones; Jor-el Thomas Caparas,0,0,36,36
1656791413904,MATH 20C,A01,083760,Briones; Jor-el Thomas Caparas,1,0,35,34
1656791413904,MATH 20C,A02,083761,Briones; Jor-el Thomas Caparas,8,0,35,27
1656791413904,MATH 20C,A03,093476,Briones; Jor-el Thomas Caparas,0,1,36,36
1656791413904,MATH 20C,B01,083762,Bach; Quang Tran,0,0,30,30
1656791419934,MATH 20D,A01,083765,Tran; Brian Kha,4,0,30,26
1656791419934,MATH 20D,A02,083766,Tran; Brian Kha,4,0,30,26
1656791419934,MATH 20D,A03,083767,Tran; Brian Kha,2,0,30,28
1656791425971,MATH 20E,A01,083771,Ganguly; Soumya,5,0,32,27
1656791425971,MATH 20E,A02,083772,Ganguly; Soumya,5,0,32,27
1656791425971,MATH 20E,B01,083773,Ciotti; Benjamin,18,0,35,17
1656791425971,MATH 20E,B02,083774,Ciotti; Benjamin,17,0,35,18
1656791432000,MATH 103A,A01,083777,Greenfeld; Be'Eri,2,0,36,34
1656791432000,MATH 103A,A02,083778,Greenfeld; Be'Eri,5,0,36,31
1656791432000,MATH 103A,A03,093561,Greenfeld; Be'Eri,4,0,36,32
1656791432000,MATH 103A,B01,083779,Greenfeld; Be'Eri,6,0,36,30
1656791432000,MATH 103A,B02,083780,Greenfeld; Be'Eri,2,0,36,34
1656791432000,MATH 103A,B03,093562,Greenfeld; Be'Eri,2,0,36,34
1656791438030,MATH 105,A01,085443,Carter; Anne Toulson,13,0,35,22
1656791438030,MATH 105,A02,093477,Carter; Anne Toulson,20,0,35,15
1656791444060,MATH 109,A01,083213,Ganzberger; Geoffrey Michael,2,0,34,32
1656791444060,MATH 109,A02,083214,Ganzberger; Geoffrey Michael,2,0,34,32
1656791444060,MATH 109,A03,093478,Ganzberger; Geoffrey Michael,1,0,34,33
1656791444060,MATH 109,B01,083215,Ganzberger; Geoffrey Michael,1,0,32,31
1656791444060,MATH 109,B02,083216,Ganzberger; Geoffrey Michael,1,0,32,31
1656791444060,MATH 109,B03,093479,Ganzberger; Geoffrey Michael,6,0,32,26
1656791450091,MATH 142A,A01,083219,Chow; Bennett,6,0,32,26
1656791450091,MATH 142A,A02,083220,Chow; Bennett,9,0,32,23
1656791450091,MATH 142A,A03,093480,Chow; Bennett,7,0,32,25
1656791450091,MATH 142A,B03,093481,Chow; Bennett,7,0,32,25
1656791450091,MATH 142A,B04,093558,Chow; Bennett,10,0,32,22
1656791450091,MATH 142A,B05,093559,Chow; Bennett,6,0,32,26
1656791456119,MATH 193A,A01,083224,Rotar; Vladimir,6,0,34,28
1656791456119,MATH 193A,A02,083225,Rotar; Vladimir,3,0,34,31
1656791456119,MATH 193A,A03,083781,Rotar; Vladimir,1,0,34,33
1656791456119,MATH 193A,A04,083782,Rotar; Vladimir,6,0,34,28
1656791456119,MATH 193A,A05,093482,Rotar; Vladimir,6,0,34,28
1656791462154,MATH 197,001,091859,McAuley; Julian John,9999,0,9999,0
1656791462154,MATH 197,002,095566,Kedlaya; Kiran S.,9997,0,9999,2
1656791462154,MATH 197,003,095567,Xiao; Ming,9999,0,9999,0
1656791462154,MATH 197,004,095571,Perols; Johan Lars,9998,0,9999,1
1656791469229,COGS 9,A01,083615,Shannon; Kyle Michael,6,0,75,69
1656791475259,COGS 11,A01,083617,Boyle; Mary E. T.,18,0,48,30
1656791481284,COGS 13,A01,083071,Bastos; Amalia Pinkusfeld,8,0,71,63
1656791487309,COGS 14A,A01,092681,Semenuks; Arturs,0,1,100,100
1656791493338,COGS 14B,A01,083073,Cheng; Tzu-Han,5,0,63,58
1656791499362,COGS 17,A01,092677,Semenuks; Arturs,4,0,81,77
1656791505390,COGS 100,A01,083619,Allen; Michael Gordon,15,0,70,55
1656791511416,COGS 101A,A01,083621,Davis; Joshua Daniel,9,0,68,59
1656791517445,COGS 101B,A01,091572,Allen; Michael Gordon,8,0,65,57
1656791523474,COGS 101C,A01,083625,Delgado; Tania,17,0,35,18
1656791529524,COGS 107A,A01,083627,Boyle; Mary E. T.,13,0,60,47
1656791535550,COGS 118A,A01,083075,Gupta; Anjum,15,0,76,61
1656791541587,CSE 3,A50,083646,Miranda; Gregory Joseph,22,0,50,28
1656791547611,CSE 8A,A50,083650,Miranda; Gregory Joseph,17,1,56,39
1656791553635,CSE 11,A01,083080,Cao; Yingjun,4,15,40,36
1656791559660,CSE 12,A01,083652,Krause-Levy; Sophia Louisa,20,1,120,100
1656791565694,CSE 15L,A01,083654,Morris; Justin Loren,8,0,50,42
1656791565694,CSE 15L,A02,083655,Morris; Justin Loren,8,0,50,42
1656791571826,CSE 20,A01,083657,Tran; Khoa Dang,37,0,80,43
1656791577853,CSE 21,A01,095574,Bach; Quang Tran,21,0,48,27
1656791583878,CSE 30,A01,083084,Eldon; John,4,0,80,76
1656791583878,CSE 30,B01,095061,Bhaskar; Nishant,5,0,50,45
1656791589907,CSE 100,A01,083659,Cao; Yingjun,1,4,70,69
1656791595944,CSE 134B,A01,083661,Powell; Thomas Allan,18,0,100,82
1656791601971,CSE 140,A01,083663,Gungor; Onat,14,0,85,71
1656791607994,CSE 140L,A01,083088,Eldon; John,16,0,100,84
1656791614020,CSE 175,A01,083665,Kumar; Rakesh,3,0,25,22
1656791620049,CSE 190,A00,092507,Dubnov; Shlomo,7,0,20,13
1656791626079,ECE 45,A01,083139,Congero; Spencer William,5,0,75,70
1656791632106,ECE 65,A50,083695,Saad; Andrew S,12,0,30,18
1656791632106,ECE 65,A51,095125,Saad; Andrew S,25,0,26,1
1656791638131,ECE 109,A01,091882,Touri; Behrouz,15,0,70,55
1656791644158,ECE 180,A00,083140,Abi Samra; Nicholas Camill,0,0,30,30
1656791644158,ECE 180,B00,083141,Abi Samra; Nicholas Camill,0,0,30,30
1656791650184,MATH 10A,A01,083735,Patchell; Gregory David,1,0,30,29
1656791650184,MATH 10A,A02,083736,Patchell; Gregory David,20,0,30,10
1656791650184,MATH 10A,A03,083737,Patchell; Gregory David,15,0,30,15
1656791656211,MATH 10B,A01,083207,Lim; Seonhee,7,0,34,27
1656791656211,MATH 10B,A02,083208,Lim; Seonhee,9,0,35,26
1656791656211,MATH 10B,A03,093472,Lim; Seonhee,4,0,34,30
1656791656211,MATH 10B,B01,083739,Sinha; Shubham,9,0,30,21
1656791662248,MATH 18,A01,083743,Cinel; Cameron Alexander,6,0,30,24
1656791662248,MATH 18,A02,083744,Cinel; Cameron Alexander,15,0,30,15
1656791662248,MATH 18,A03,083745,Cinel; Cameron Alexander,8,0,30,22
1656791662248,MATH 18,B01,083748,Rideout; David Porter,3,0,37,34
1656791662248,MATH 18,B02,083749,Rideout; David Porter,3,0,36,33
1656791662248,MATH 18,B03,083750,Rideout; David Porter,1,0,37,36
1656791662248,MATH 18,B04,083751,Rideout; David Porter,5,0,36,31
1656791662248,MATH 18,B05,093473,Rideout; David Porter,4,0,36,32
1656791662248,MATH 18,B06,093474,Rideout; David Porter,5,0,36,31
1656791668282,MATH 20A,A01,083754,Zheng; Zequn,12,0,40,28
1656791674314,MATH 20B,A01,083756,Briones; Jor-el Thomas Caparas,1,0,36,35
1656791674314,MATH 20B,A02,083757,Briones; Jor-el Thomas Caparas,1,0,36,35
1656791674314,MATH 20B,A03,093475,Briones; Jor-el Thomas Caparas,0,0,36,36
1656791680346,MATH 20C,A01,083760,Briones; Jor-el Thomas Caparas,1,0,35,34
1656791680346,MATH 20C,A02,083761,Briones; Jor-el Thomas Caparas,8,0,35,27
1656791680346,MATH 20C,A03,093476,Briones; Jor-el Thomas Caparas,0,1,36,36
1656791680346,MATH 20C,B01,083762,Bach; Quang Tran,0,0,30,30
1656791686375,MATH 20D,A01,083765,Tran; Brian Kha,4,0,30,26
1656791686375,MATH 20D,A02,083766,Tran; Brian Kha,4,0,30,26
1656791686375,MATH 20D,A03,083767,Tran; Brian Kha,2,0,30,28
1656791692408,MATH 20E,A01,083771,Ganguly; Soumya,5,0,32,27
1656791692408,MATH 20E,A02,083772,Ganguly; Soumya,5,0,32,27
1656791692408,MATH 20E,B01,083773,Ciotti; Benjamin,18,0,35,17
1656791692408,MATH 20E,B02,083774,Ciotti; Benjamin,17,0,35,18
1656791698437,MATH 103A,A01,083777,Greenfeld; Be'Eri,2,0,36,34
1656791698437,MATH 103A,A02,083778,Greenfeld; Be'Eri,5,0,36,31
1656791698437,MATH 103A,A03,093561,Greenfeld; Be'Eri,4,0,36,32
1656791698437,MATH 103A,B01,083779,Greenfeld; Be'Eri,6,0,36,30
1656791698437,MATH 103A,B02,083780,Greenfeld; Be'Eri,2,0,36,34
1656791698437,MATH 103A,B03,093562,Greenfeld; Be'Eri,2,0,36,34
1656791704468,MATH 105,A01,085443,Carter; Anne Toulson,13,0,35,22
1656791704468,MATH 105,A02,093477,Carter; Anne Toulson,20,0,35,15
1656791710492,MATH 109,A01,083213,Ganzberger; Geoffrey Michael,2,0,34,32
1656791710492,MATH 109,A02,083214,Ganzberger; Geoffrey Michael,2,0,34,32
1656791710492,MATH 109,A03,093478,Ganzberger; Geoffrey Michael,1,0,34,33
1656791710492,MATH 109,B01,083215,Ganzberger; Geoffrey Michael,1,0,32,31
1656791710492,MATH 109,B02,083216,Ganzberger; Geoffrey Michael,1,0,32,31
1656791710492,MATH 109,B03,093479,Ganzberger; Geoffrey Michael,6,0,32,26
1656791716529,MATH 142A,A01,083219,Chow; Bennett,6,0,32,26
1656791716529,MATH 142A,A02,083220,Chow; Bennett,9,0,32,23
1656791716529,MATH 142A,A03,093480,Chow; Bennett,7,0,32,25
1656791716529,MATH 142A,B03,093481,Chow; Bennett,7,0,32,25
1656791716529,MATH 142A,B04,093558,Chow; Bennett,10,0,32,22
1656791716529,MATH 142A,B05,093559,Chow; Bennett,6,0,32,26
1656791722557,MATH 193A,A01,083224,Rotar; Vladimir,6,0,34,28
1656791722557,MATH 193A,A02,083225,Rotar; Vladimir,3,0,34,31
1656791722557,MATH 193A,A03,083781,Rotar; Vladimir,1,0,34,33
1656791722557,MATH 193A,A04,083782,Rotar; Vladimir,6,0,34,28
1656791722557,MATH 193A,A05,093482,Rotar; Vladimir,6,0,34,28
1656791728588,MATH 197,001,091859,McAuley; Julian John,9999,0,9999,0
1656791728588,MATH 197,002,095566,Kedlaya; Kiran S.,9997,0,9999,2
1656791728588,MATH 197,003,095567,Xiao; Ming,9999,0,9999,0
1656791728588,MATH 197,004,095571,Perols; Johan Lars,9998,0,9999,1
1656791735668,COGS 9,A01,083615,Shannon; Kyle Michael,6,0,75,69
1656791741696,COGS 11,A01,083617,Boyle; Mary E. T.,18,0,48,30
1656791747724,COGS 13,A01,083071,Bastos; Amalia Pinkusfeld,8,0,71,63
1656791753749,COGS 14A,A01,092681,Semenuks; Arturs,0,1,100,100
1656791759778,COGS 14B,A01,083073,Cheng; Tzu-Han,5,0,63,58
1656791765809,COGS 17,A01,092677,Semenuks; Arturs,4,0,81,77
1656791771835,COGS 100,A01,083619,Allen; Michael Gordon,15,0,70,55
1656791777885,COGS 101A,A01,083621,Davis; Joshua Daniel,9,0,68,59
1656791783910,COGS 101B,A01,091572,Allen; Michael Gordon,8,0,65,57
1656791789936,COGS 101C,A01,083625,Delgado; Tania,17,0,35,18
1656791795962,COGS 107A,A01,083627,Boyle; Mary E. T.,13,0,60,47
1656791801995,COGS 118A,A01,083075,Gupta; Anjum,15,0,76,61
1656791808027,CSE 3,A50,083646,Miranda; Gregory Joseph,22,0,50,28
1656791814053,CSE 8A,A50,083650,Miranda; Gregory Joseph,17,1,56,39
1656791820079,CSE 11,A01,083080,Cao; Yingjun,4,15,40,36
1656791826103,CSE 12,A01,083652,Krause-Levy; Sophia Louisa,20,1,120,100
1656791832128,CSE 15L,A01,083654,Morris; Justin Loren,8,0,50,42
1656791832128,CSE 15L,A02,083655,Morris; Justin Loren,8,0,50,42
1656791838152,CSE 20,A01,083657,Tran; Khoa Dang,37,0,80,43
1656791844181,CSE 21,A01,095574,Bach; Quang Tran,21,0,48,27
1656791850214,CSE 30,A01,083084,Eldon; John,4,0,80,76
1656791850214,CSE 30,B01,095061,Bhaskar; Nishant,5,0,50,45
1656791856245,CSE 100,A01,083659,Cao; Yingjun,1,4,70,69
1656791862269,CSE 134B,A01,083661,Powell; Thomas Allan,18,0,100,82
1656791868304,CSE 140,A01,083663,Gungor; Onat,14,0,85,71
1656791874327,CSE 140L,A01,083088,Eldon; John,16,0,100,84
1656791880355,CSE 175,A01,083665,Kumar; Rakesh,3,0,25,22
1656791886383,CSE 190,A00,092507,Dubnov; Shlomo,7,0,20,13
1656791892407,ECE 45,A01,083139,Congero; Spencer William,5,0,75,70
1656791898438,ECE 65,A50,083695,Saad; Andrew S,12,0,30,18
1656791898438,ECE 65,A51,095125,Saad; Andrew S,25,0,26,1
1656791904465,ECE 109,A01,091882,Touri; Behrouz,15,0,70,55
1656791910491,ECE 180,A00,083140,Abi Samra; Nicholas Camill,0,0,30,30
1656791910491,ECE 180,B00,083141,Abi Samra; Nicholas Camill,0,0,30,30
1656791916522,MATH 10A,A01,083735,Patchell; Gregory David,1,0,30,29
1656791916522,MATH 10A,A02,083736,Patchell; Gregory David,20,0,30,10
1656791916522,MATH 10A,A03,083737,Patchell; Gregory David,15,0,30,15
1656791922550,MATH 10B,A01,083207,Lim; Seonhee,7,0,34,27
1656791922550,MATH 10B,A02,083208,Lim; Seonhee,9,0,35,26
1656791922550,MATH 10B,A03,093472,Lim; Seonhee,4,0,34,30
1656791922550,MATH 10B,B01,083739,Sinha; Shubham,9,0,30,21
1656791928578,MATH 18,A01,083743,Cinel; Cameron Alexander,6,0,30,24
1656791928578,MATH 18,A02,083744,Cinel; Cameron Alexander,15,0,30,15
1656791928578,MATH 18,A03,083745,Cinel; Cameron Alexander,8,0,30,22
1656791928578,MATH 18,B01,083748,Rideout; David Porter,3,0,37,34
1656791928578,MATH 18,B02,083749,Rideout; David Porter,3,0,36,33
1656791928578,MATH 18,B03,083750,Rideout; David Porter,1,0,37,36
1656791928578,MATH 18,B04,083751,Rideout; David Porter,5,0,36,31
1656791928578,MATH 18,B05,093473,Rideout; David Porter,4,0,36,32
1656791928578,MATH 18,B06,093474,Rideout; David Porter,5,0,36,31
1656791934603,MATH 20A,A01,083754,Zheng; Zequn,12,0,40,28
1656791940637,MATH 20B,A01,083756,Briones; Jor-el Thomas Caparas,1,0,36,35
1656791940637,MATH 20B,A02,083757,Briones; Jor-el Thomas Caparas,1,0,36,35
1656791940637,MATH 20B,A03,093475,Briones; Jor-el Thomas Caparas,0,0,36,36
1656791946666,MATH 20C,A01,083760,Briones; Jor-el Thomas Caparas,1,0,35,34
1656791946666,MATH 20C,A02,083761,Briones; Jor-el Thomas Caparas,8,0,35,27
1656791946666,MATH 20C,A03,093476,Briones; Jor-el Thomas Caparas,0,1,36,36
1656791946666,MATH 20C,B01,083762,Bach; Quang Tran,0,0,30,30
1656791952697,MATH 20D,A01,083765,Tran; Brian Kha,4,0,30,26
1656791952697,MATH 20D,A02,083766,Tran; Brian Kha,4,0,30,26
1656791952697,MATH 20D,A03,083767,Tran; Brian Kha,2,0,30,28
1656791958728,MATH 20E,A01,083771,Ganguly; Soumya,5,0,32,27
1656791958728,MATH 20E,A02,083772,Ganguly; Soumya,5,0,32,27
1656791958728,MATH 20E,B01,083773,Ciotti; Benjamin,18,0,35,17
1656791958728,MATH 20E,B02,083774,Ciotti; Benjamin,17,0,35,18
1656791964763,MATH 103A,A01,083777,Greenfeld; Be'Eri,2,0,36,34
1656791964763,MATH 103A,A02,083778,Greenfeld; Be'Eri,5,0,36,31
1656791964763,MATH 103A,A03,093561,Greenfeld; Be'Eri,4,0,36,32
1656791964763,MATH 103A,B01,083779,Greenfeld; Be'Eri,6,0,36,30
1656791964763,MATH 103A,B02,083780,Greenfeld; Be'Eri,2,0,36,34
1656791964763,MATH 103A,B03,093562,Greenfeld; Be'Eri,2,0,36,34
1656791970790,MATH 105,A01,085443,Carter; Anne Toulson,13,0,35,22
1656791970790,MATH 105,A02,093477,Carter; Anne Toulson,20,0,35,15
1656791976813,MATH 109,A01,083213,Ganzberger; Geoffrey Michael,2,0,34,32
1656791976813,MATH 109,A02,083214,Ganzberger; Geoffrey Michael,2,0,34,32
1656791976813,MATH 109,A03,093478,Ganzberger; Geoffrey Michael,1,0,34,33
1656791976813,MATH 109,B01,083215,Ganzberger; Geoffrey Michael,1,0,32,31
1656791976813,MATH 109,B02,083216,Ganzberger; Geoffrey Michael,1,0,32,31
1656791976813,MATH 109,B03,093479,Ganzberger; Geoffrey Michael,6,0,32,26
1656791982841,MATH 142A,A01,083219,Chow; Bennett,6,0,32,26
1656791982841,MATH 142A,A02,083220,Chow; Bennett,9,0,32,23
1656791982841,MATH 142A,A03,093480,Chow; Bennett,7,0,32,25
1656791982841,MATH 142A,B03,093481,Chow; Bennett,7,0,32,25
1656791982841,MATH 142A,B04,093558,Chow; Bennett,10,0,32,22
1656791982841,MATH 142A,B05,093559,Chow; Bennett,6,0,32,26
1656791988876,MATH 193A,A01,083224,Rotar; Vladimir,6,0,34,28
1656791988876,MATH 193A,A02,083225,Rotar; Vladimir,3,0,34,31
1656791988876,MATH 193A,A03,083781,Rotar; Vladimir,1,0,34,33
1656791988876,MATH 193A,A04,083782,Rotar; Vladimir,6,0,34,28
1656791988876,MATH 193A,A05,093482,Rotar; Vladimir,6,0,34,28
1656791994901,MATH 197,001,091859,McAuley; Julian John,9999,0,9999,0
1656791994901,MATH 197,002,095566,Kedlaya; Kiran S.,9997,0,9999,2
1656791994901,MATH 197,003,095567,Xiao; Ming,9999,0,9999,0
1656791994901,MATH 197,004,095571,Perols; Johan Lars,9998,0,9999,1
1656792001970,COGS 9,A01,083615,Shannon; Kyle Michael,6,0,75,69
1656792007996,COGS 11,A01,083617,Boyle; Mary E. T.,18,0,48,30
1656792014025,COGS 13,A01,083071,Bastos; Amalia Pinkusfeld,8,0,71,63
1656792020052,COGS 14A,A01,092681,Semenuks; Arturs,0,1,100,100
1656792026079,COGS 14B,A01,083073,Cheng; Tzu-Han,5,0,63,58
1656792032107,COGS 17,A01,092677,Semenuks; Arturs,4,0,81,77
1656792038148,COGS 100,A01,083619,Allen; Michael Gordon,15,0,70,55
1656792044176,COGS 101A,A01,083621,Davis; Joshua Daniel,9,0,68,59
1656792050211,COGS 101B,A01,091572,Allen; Michael Gordon,8,0,65,57
1656792056238,COGS 101C,A01,083625,Delgado; Tania,17,0,35,18
1656792062261,COGS 107A,A01,083627,Boyle; Mary E. T.,13,0,60,47
1656792068289,COGS 118A,A01,083075,Gupta; Anjum,15,0,76,61
1656792074314,CSE 3,A50,083646,Miranda; Gregory Joseph,22,0,50,28
1656792080344,CSE 8A,A50,083650,Miranda; Gregory Joseph,17,1,56,39
1656792086373,CSE 11,A01,083080,Cao; Yingjun,4,15,40,36
1656792092395,CSE 12,A01,083652,Krause-Levy; Sophia Louisa,20,1,120,100
1656792098419,CSE 15L,A01,083654,Morris; Justin Loren,8,0,50,42
1656792098419,CSE 15L,A02,083655,Morris; Justin Loren,8,0,50,42
1656792104446,CSE 20,A01,083657,Tran; Khoa Dang,37,0,80,43
1656792110471,CSE 21,A01,095574,Bach; Quang Tran,21,0,48,27
1656792116500,CSE 30,A01,083084,Eldon; John,4,0,80,76
1656792116500,CSE 30,B01,095061,Bhaskar; Nishant,5,0,50,45
1656792122535,CSE 100,A01,083659,Cao; Yingjun,1,4,70,69
1656792128557,CSE 134B,A01,083661,Powell; Thomas Allan,18,0,100,82
1656792134582,CSE 140,A01,083663,Gungor; Onat,14,0,85,71
1656792140607,CSE 140L,A01,083088,Eldon; John,16,0,100,84
1656792146636,CSE 175,A01,083665,Kumar; Rakesh,3,0,25,22
1656792152664,CSE 190,A00,092507,Dubnov; Shlomo,7,0,20,13
1656792158697,ECE 45,A01,083139,Congero; Spencer William,5,0,75,70
1656792164733,ECE 65,A50,083695,Saad; Andrew S,12,0,30,18
1656792164733,ECE 65,A51,095125,Saad; Andrew S,25,0,26,1
1656792170869,ECE 109,A01,091882,Touri; Behrouz,15,0,70,55
1656792176896,ECE 180,A00,083140,Abi Samra; Nicholas Camill,0,0,30,30
1656792176896,ECE 180,B00,083141,Abi Samra; Nicholas Camill,0,0,30,30
1656792182930,MATH 10A,A01,083735,Patchell; Gregory David,1,0,30,29
1656792182930,MATH 10A,A02,083736,Patchell; Gregory David,20,0,30,10
1656792182930,MATH 10A,A03,083737,Patchell; Gregory David,15,0,30,15
1656792188965,MATH 10B,A01,083207,Lim; Seonhee,7,0,34,27
1656792188965,MATH 10B,A02,083208,Lim; Seonhee,9,0,35,26
1656792188965,MATH 10B,A03,093472,Lim; Seonhee,4,0,34,30
1656792188965,MATH 10B,B01,083739,Sinha; Shubham,9,0,30,21
1656792194992,MATH 18,A01,083743,Cinel; Cameron Alexander,6,0,30,24
1656792194992,MATH 18,A02,083744,Cinel; Cameron Alexander,15,0,30,15
1656792194992,MATH 18,A03,083745,Cinel; Cameron Alexander,8,0,30,22
1656792194992,MATH 18,B01,083748,Rideout; David Porter,3,0,37,34
1656792194992,MATH 18,B02,083749,Rideout; David Porter,3,0,36,33
1656792194992,MATH 18,B03,083750,Rideout; David Porter,1,0,37,36
1656792194992,MATH 18,B04,083751,Rideout; David Porter,5,0,36,31
1656792194992,MATH 18,B05,093473,Rideout; David Porter,4,0,36,32
1656792194992,MATH 18,B06,093474,Rideout; David Porter,5,0,36,31
1656792201017,MATH 20A,A01,083754,Zheng; Zequn,12,0,40,28
1656792207046,MATH 20B,A01,083756,Briones; Jor-el Thomas Caparas,1,0,36,35
1656792207046,MATH 20B,A02,083757,Briones; Jor-el Thomas Caparas,1,0,36,35
1656792207046,MATH 20B,A03,093475,Briones; Jor-el Thomas Caparas,0,0,36,36
1656792213076,MATH 20C,A01,083760,Briones; Jor-el Thomas Caparas,1,0,35,34
1656792213076,MATH 20C,A02,083761,Briones; Jor-el Thomas Caparas,8,0,35,27
1656792213076,MATH 20C,A03,093476,Briones; Jor-el Thomas Caparas,0,1,36,36
1656792213076,MATH 20C,B01,083762,Bach; Quang Tran,0,0,30,30
1656792219100,MATH 20D,A01,083765,Tran; Brian Kha,4,0,30,26
1656792219100,MATH 20D,A02,083766,Tran; Brian Kha,4,0,30,26
1656792219100,MATH 20D,A03,083767,Tran; Brian Kha,2,0,30,28
1656792225132,MATH 20E,A01,083771,Ganguly; Soumya,5,0,32,27
1656792225132,MATH 20E,A02,083772,Ganguly; Soumya,5,0,32,27
1656792225132,MATH 20E,B01,083773,Ciotti; Benjamin,18,0,35,17
1656792225132,MATH 20E,B02,083774,Ciotti; Benjamin,17,0,35,18
1656792231158,MATH 103A,A01,083777,Greenfeld; Be'Eri,2,0,36,34
1656792231158,MATH 103A,A02,083778,Greenfeld; Be'Eri,5,0,36,31
1656792231158,MATH 103A,A03,093561,Greenfeld; Be'Eri,4,0,36,32
1656792231158,MATH 103A,B01,083779,Greenfeld; Be'Eri,6,0,36,30
1656792231158,MATH 103A,B02,083780,Greenfeld; Be'Eri,2,0,36,34
1656792231158,MATH 103A,B03,093562,Greenfeld; Be'Eri,2,0,36,34
1656792237185,MATH 105,A01,085443,Carter; Anne Toulson,13,0,35,22
1656792237185,MATH 105,A02,093477,Carter; Anne Toulson,20,0,35,15
1656792243208,MATH 109,A01,083213,Ganzberger; Geoffrey Michael,2,0,34,32
1656792243208,MATH 109,A02,083214,Ganzberger; Geoffrey Michael,2,0,34,32
1656792243208,MATH 109,A03,093478,Ganzberger; Geoffrey Michael,1,0,34,33
1656792243208,MATH 109,B01,083215,Ganzberger; Geoffrey Michael,1,0,32,31
1656792243208,MATH 109,B02,083216,Ganzberger; Geoffrey Michael,1,0,32,31
1656792243208,MATH 109,B03,093479,Ganzberger; Geoffrey Michael,6,0,32,26
1656792249231,MATH 142A,A01,083219,Chow; Bennett,6,0,32,26
1656792249231,MATH 142A,A02,083220,Chow; Bennett,9,0,32,23
1656792249231,MATH 142A,A03,093480,Chow; Bennett,7,0,32,25
1656792249231,MATH 142A,B03,093481,Chow; Bennett,7,0,32,25
1656792249231,MATH 142A,B04,093558,Chow; Bennett,10,0,32,22
1656792249231,MATH 142A,B05,093559,Chow; Bennett,6,0,32,26
1656792255255,MATH 193A,A01,083224,Rotar; Vladimir,6,0,34,28
1656792255255,MATH 193A,A02,083225,Rotar; Vladimir,3,0,34,31
1656792255255,MATH 193A,A03,083781,Rotar; Vladimir,1,0,34,33
1656792255255,MATH 193A,A04,083782,Rotar; Vladimir,6,0,34,28
1656792255255,MATH 193A,A05,093482,Rotar; Vladimir,6,0,34,28
1656792261289,MATH 197,001,091859,McAuley; Julian John,9999,0,9999,0
1656792261289,MATH 197,002,095566,Kedlaya; Kiran S.,9997,0,9999,2
1656792261289,MATH 197,003,095567,Xiao; Ming,9999,0,9999,0
1656792261289,MATH 197,004,095571,Perols; Johan Lars,9998,0,9999,1
1656792268355,COGS 9,A01,083615,Shannon; Kyle Michael,6,0,75,69
1656792274378,COGS 11,A01,083617,Boyle; Mary E. T.,18,0,48,30
1656792280403,COGS 13,A01,083071,Bastos; Amalia Pinkusfeld,8,0,71,63
1656792286429,COGS 14A,A01,092681,Semenuks; Arturs,0,1,100,100
1656792292454,COGS 14B,A01,083073,Cheng; Tzu-Han,5,0,63,58
1656792298477,COGS 17,A01,092677,Semenuks; Arturs,4,0,81,77
1656792304503,COGS 100,A01,083619,Allen; Michael Gordon,15,0,70,55
1656792310528,COGS 101A,A01,083621,Davis; Joshua Daniel,9,0,68,59
1656792316551,COGS 101B,A01,091572,Allen; Michael Gordon,8,0,65,57
1656792322579,COGS 101C,A01,083625,Delgado; Tania,17,0,35,18
1656792328605,COGS 107A,A01,083627,Boyle; Mary E. T.,13,0,60,47
1656792334630,COGS 118A,A01,083075,Gupta; Anjum,15,0,76,61
1656792340659,CSE 3,A50,083646,Miranda; Gregory Joseph,22,0,50,28
1656792346682,CSE 8A,A50,083650,Miranda; Gregory Joseph,17,1,56,39
1656792352705,CSE 11,A01,083080,Cao; Yingjun,4,15,40,36
1656792358729,CSE 12,A01,083652,Krause-Levy; Sophia Louisa,20,1,120,100
1656792364752,CSE 15L,A01,083654,Morris; Justin Loren,8,0,50,42
1656792364752,CSE 15L,A02,083655,Morris; Justin Loren,8,0,50,42
1656792370779,CSE 20,A01,083657,Tran; Khoa Dang,37,0,80,43
1656792376806,CSE 21,A01,095574,Bach; Quang Tran,21,0,48,27
1656792382836,CSE 30,A01,083084,Eldon; John,4,0,80,76
1656792382836,CSE 30,B01,095061,Bhaskar; Nishant,5,0,50,45
1656792388862,CSE 100,A01,083659,Cao; Yingjun,1,4,70,69
1656792394886,CSE 134B,A01,083661,Powell; Thomas Allan,18,0,100,82
1656792400911,CSE 140,A01,083663,Gungor; Onat,14,0,85,71
1656792406935,CSE 140L,A01,083088,Eldon; John,16,0,100,84
1656792412960,CSE 175,A01,083665,Kumar; Rakesh,3,0,25,22
1656792418985,CSE 190,A00,092507,Dubnov; Shlomo,7,0,20,13
1656792425011,ECE 45,A01,083139,Congero; Spencer William,5,0,75,70
1656792431037,ECE 65,A50,083695,Saad; Andrew S,12,0,30,18
1656792431037,ECE 65,A51,095125,Saad; Andrew S,25,0,26,1
1656792437061,ECE 109,A01,091882,Touri; Behrouz,15,0,70,55
1656792443085,ECE 180,A00,083140,Abi Samra; Nicholas Camill,0,0,30,30
1656792443085,ECE 180,B00,083141,Abi Samra; Nicholas Camill,0,0,30,30
1656792449112,MATH 10A,A01,083735,Patchell; Gregory David,1,0,30,29
1656792449112,MATH 10A,A02,083736,Patchell; Gregory David,20,0,30,10
1656792449112,MATH 10A,A03,083737,Patchell; Gregory David,15,0,30,15
1656792455140,MATH 10B,A01,083207,Lim; Seonhee,7,0,34,27
1656792455140,MATH 10B,A02,083208,Lim; Seonhee,9,0,35,26
1656792455140,MATH 10B,A03,093472,Lim; Seonhee,4,0,34,30
1656792455140,MATH 10B,B01,083739,Sinha; Shubham,9,0,30,21
1656792461171,MATH 18,A01,083743,Cinel; Cameron Alexander,6,0,30,24
1656792461171,MATH 18,A02,083744,Cinel; Cameron Alexander,15,0,30,15
1656792461171,MATH 18,A03,083745,Cinel; Cameron Alexander,8,0,30,22
1656792461171,MATH 18,B01,083748,Rideout; David Porter,3,0,37,34
1656792461171,MATH 18,B02,083749,Rideout; David Porter,3,0,36,33
1656792461171,MATH 18,B03,083750,Rideout; David Porter,1,0,37,36
1656792461171,MATH 18,B04,083751,Rideout; David Porter,5,0,36,31
1656792461171,MATH 18,B05,093473,Rideout; David Porter,4,0,36,32
1656792461171,MATH 18,B06,093474,Rideout; David Porter,5,0,36,31
1656792467199,MATH 20A,A01,083754,Zheng; Zequn,12,0,40,28
1656792473226,MATH 20B,A01,083756,Briones; Jor-el Thomas Caparas,1,0,36,35
1656792473226,MATH 20B,A02,083757,Briones; Jor-el Thomas Caparas,1,0,36,35
1656792473226,MATH 20B,A03,093475,Briones; Jor-el Thomas Caparas,0,0,36,36
1656792479260,MATH 20C,A01,083760,Briones; Jor-el Thomas Caparas,1,0,35,34
1656792479260,MATH 20C,A02,083761,Briones; Jor-el Thomas Caparas,8,0,35,27
1656792479260,MATH 20C,A03,093476,Briones; Jor-el Thomas Caparas,0,1,36,36
1656792479260,MATH 20C,B01,083762,Bach; Quang Tran,0,0,30,30
1656792485288,MATH 20D,A01,083765,Tran; Brian Kha,4,0,30,26
1656792485288,MATH 20D,A02,083766,Tran; Brian Kha,4,0,30,26
1656792485288,MATH 20D,A03,083767,Tran; Brian Kha,2,0,30,28
1656792491321,MATH 20E,A01,083771,Ganguly; Soumya,5,0,32,27
1656792491321,MATH 20E,A02,083772,Ganguly; Soumya,5,0,32,27
1656792491321,MATH 20E,B01,083773,Ciotti; Benjamin,18,0,35,17
1656792491321,MATH 20E,B02,083774,Ciotti; Benjamin,17,0,35,18
1656792497352,MATH 103A,A01,083777,Greenfeld; Be'Eri,2,0,36,34
1656792497352,MATH 103A,A02,083778,Greenfeld; Be'Eri,5,0,36,31
1656792497352,MATH 103A,A03,093561,Greenfeld; Be'Eri,4,0,36,32
1656792497352,MATH 103A,B01,083779,Greenfeld; Be'Eri,6,0,36,30
1656792497352,MATH 103A,B02,083780,Greenfeld; Be'Eri,2,0,36,34
1656792497352,MATH 103A,B03,093562,Greenfeld; Be'Eri,2,0,36,34
1656792503377,MATH 105,A01,085443,Carter; Anne Toulson,13,0,35,22
1656792503377,MATH 105,A02,093477,Carter; Anne Toulson,20,0,35,15
1656792509409,MATH 109,A01,083213,Ganzberger; Geoffrey Michael,2,0,34,32
1656792509409,MATH 109,A02,083214,Ganzberger; Geoffrey Michael,2,0,34,32
1656792509409,MATH 109,A03,093478,Ganzberger; Geoffrey Michael,1,0,34,33
1656792509409,MATH 109,B01,083215,Ganzberger; Geoffrey Michael,1,0,32,31
1656792509409,MATH 109,B02,083216,Ganzberger; Geoffrey Michael,1,0,32,31
1656792509409,MATH 109,B03,093479,Ganzberger; Geoffrey Michael,6,0,32,26
1656792515437,MATH 142A,A01,083219,Chow; Bennett,6,0,32,26
1656792515437,MATH 142A,A02,083220,Chow; Bennett,9,0,32,23
1656792515437,MATH 142A,A03,093480,Chow; Bennett,7,0,32,25
1656792515437,MATH 142A,B03,093481,Chow; Bennett,7,0,32,25
1656792515437,MATH 142A,B04,093558,Chow; Bennett,10,0,32,22
1656792515437,MATH 142A,B05,093559,Chow; Bennett,6,0,32,26
1656792521461,MATH 193A,A01,083224,Rotar; Vladimir,6,0,34,28
1656792521461,MATH 193A,A02,083225,Rotar; Vladimir,3,0,34,31
1656792521461,MATH 193A,A03,083781,Rotar; Vladimir,1,0,34,33
1656792521461,MATH 193A,A04,083782,Rotar; Vladimir,6,0,34,28
1656792521461,MATH 193A,A05,093482,Rotar; Vladimir,6,0,34,28
1656792527487,MATH 197,001,091859,McAuley; Julian John,9999,0,9999,0
1656792527487,MATH 197,002,095566,Kedlaya; Kiran S.,9997,0,9999,2
1656792527487,MATH 197,003,095567,Xiao; Ming,9999,0,9999,0
1656792527487,MATH 197,004,095571,Perols; Johan Lars,9998,0,9999,1
1656792534547,COGS 9,A01,083615,Shannon; Kyle Michael,6,0,75,69
1656792540575,COGS 11,A01,083617,Boyle; Mary E. T.,18,0,48,30
1656792546606,COGS 13,A01,083071,Bastos; Amalia Pinkusfeld,8,0,71,63
1656792552636,COGS 14A,A01,092681,Semenuks; Arturs,0,1,100,100
1656792558663,COGS 14B,A01,083073,Cheng; Tzu-Han,5,0,63,58
1656792564687,COGS 17,A01,092677,Semenuks; Arturs,4,0,81,77
1656792570717,COGS 100,A01,083619,Allen; Michael Gordon,15,0,70,55
1656792576747,COGS 101A,A01,083621,Davis; Joshua Daniel,9,0,68,59
1656792582775,COGS 101B,A01,091572,Allen; Michael Gordon,8,0,65,57
1656792588802,COGS 101C,A01,083625,Delgado; Tania,17,0,35,18
1656792594826,COGS 107A,A01,083627,Boyle; Mary E. T.,13,0,60,47
1656792600866,COGS 118A,A01,083075,Gupta; Anjum,15,0,76,61
1656792606900,CSE 3,A50,083646,Miranda; Gregory Joseph,22,0,50,28
1656792612925,CSE 8A,A50,083650,Miranda; Gregory Joseph,17,1,56,39
1656792618956,CSE 11,A01,083080,Cao; Yingjun,4,15,40,36
1656792624986,CSE 12,A01,083652,Krause-Levy; Sophia Louisa,20,1,120,100
1656792631014,CSE 15L,A01,083654,Morris; Justin Loren,8,0,50,42
1656792631014,CSE 15L,A02,083655,Morris; Justin Loren,8,0,50,42
1656792637040,CSE 20,A01,083657,Tran; Khoa Dang,37,0,80,43
1656792643066,CSE 21,A01,095574,Bach; Quang Tran,21,0,48,27
1656792649091,CSE 30,A01,083084,Eldon; John,4,0,80,76
1656792649091,CSE 30,B01,095061,Bhaskar; Nishant,5,0,50,45
1656792655116,CSE 100,A01,083659,Cao; Yingjun,1,4,70,69
1656792661141,CSE 134B,A01,083661,Powell; Thomas Allan,18,0,100,82
1656792667165,CSE 140,A01,083663,Gungor; Onat,14,0,85,71
1656792673193,CSE 140L,A01,083088,Eldon; John,16,0,100,84
1656792679224,CSE 175,A01,083665,Kumar; Rakesh,3,0,25,22
1656792685249,CSE 190,A00,092507,Dubnov; Shlomo,7,0,20,13
1656792691279,ECE 45,A01,083139,Congero; Spencer William,5,0,75,70
1656792697303,ECE 65,A50,083695,Saad; Andrew S,12,0,30,18
1656792697303,ECE 65,A51,095125,Saad; Andrew S,25,0,26,1
1656792703332,ECE 109,A01,091882,Touri; Behrouz,15,0,70,55
1656792709356,ECE 180,A00,083140,Abi Samra; Nicholas Camill,0,0,30,30
1656792709356,ECE 180,B00,083141,Abi Samra; Nicholas Camill,0,0,30,30
1656792715388,MATH 10A,A01,083735,Patchell; Gregory David,1,0,30,29
1656792715388,MATH 10A,A02,083736,Patchell; Gregory David,20,0,30,10
1656792715388,MATH 10A,A03,083737,Patchell; Gregory David,15,0,30,15
1656792721421,MATH 10B,A01,083207,Lim; Seonhee,7,0,34,27
1656792721421,MATH 10B,A02,083208,Lim; Seonhee,9,0,35,26
1656792721421,MATH 10B,A03,093472,Lim; Seonhee,4,0,34,30
1656792721421,MATH 10B,B01,083739,Sinha; Shubham,9,0,30,21
1656792727458,MATH 18,A01,083743,Cinel; Cameron Alexander,6,0,30,24
1656792727458,MATH 18,A02,083744,Cinel; Cameron Alexander,15,0,30,15
1656792727458,MATH 18,A03,083745,Cinel; Cameron Alexander,8,0,30,22
1656792727458,MATH 18,B01,083748,Rideout; David Porter,3,0,37,34
1656792727458,MATH 18,B02,083749,Rideout; David Porter,3,0,36,33
1656792727458,MATH 18,B03,083750,Rideout; David Porter,1,0,37,36
1656792727458,MATH 18,B04,083751,Rideout; David Porter,5,0,36,31
1656792727458,MATH 18,B05,093473,Rideout; David Porter,4,0,36,32
1656792727458,MATH 18,B06,093474,Rideout; David Porter,5,0,36,31
1656792733490,MATH 20A,A01,083754,Zheng; Zequn,12,0,40,28
1656792739523,MATH 20B,A01,083756,Briones; Jor-el Thomas Caparas,1,0,36,35
1656792739523,MATH 20B,A02,083757,Briones; Jor-el Thomas Caparas,1,0,36,35
1656792739523,MATH 20B,A03,093475,Briones; Jor-el Thomas Caparas,0,0,36,36
1656792745552,MATH 20C,A01,083760,Briones; Jor-el Thomas Caparas,1,0,35,34
1656792745552,MATH 20C,A02,083761,Briones; Jor-el Thomas Caparas,8,0,35,27
1656792745552,MATH 20C,A03,093476,Briones; Jor-el Thomas Caparas,0,1,36,36
1656792745552,MATH 20C,B01,083762,Bach; Quang Tran,0,0,30,30
1656792751584,MATH 20D,A01,083765,Tran; Brian Kha,4,0,30,26
1656792751584,MATH 20D,A02,083766,Tran; Brian Kha,4,0,30,26
1656792751584,MATH 20D,A03,083767,Tran; Brian Kha,2,0,30,28
1656792757614,MATH 20E,A01,083771,Ganguly; Soumya,5,0,32,27
1656792757614,MATH 20E,A02,083772,Ganguly; Soumya,5,0,32,27
1656792757614,MATH 20E,B01,083773,Ciotti; Benjamin,18,0,35,17
1656792757614,MATH 20E,B02,083774,Ciotti; Benjamin,17,0,35,18
1656792763638,MATH 103A,A01,083777,Greenfeld; Be'Eri,2,0,36,34
1656792763638,MATH 103A,A02,083778,Greenfeld; Be'Eri,5,0,36,31
1656792763638,MATH 103A,A03,093561,Greenfeld; Be'Eri,4,0,36,32
1656792763638,MATH 103A,B01,083779,Greenfeld; Be'Eri,6,0,36,30
1656792763638,MATH 103A,B02,083780,Greenfeld; Be'Eri,2,0,36,34
1656792763638,MATH 103A,B03,093562,Greenfeld; Be'Eri,2,0,36,34
1656792769764,MATH 105,A01,085443,Carter; Anne Toulson,13,0,35,22
1656792769764,MATH 105,A02,093477,Carter; Anne Toulson,20,0,35,15
1656792775787,MATH 109,A01,083213,Ganzberger; Geoffrey Michael,2,0,34,32
1656792775787,MATH 109,A02,083214,Ganzberger; Geoffrey Michael,2,0,34,32
1656792775787,MATH 109,A03,093478,Ganzberger; Geoffrey Michael,1,0,34,33
1656792775787,MATH 109,B01,083215,Ganzberger; Geoffrey Michael,1,0,32,31
1656792775787,MATH 109,B02,083216,Ganzberger; Geoffrey Michael,1,0,32,31
1656792775787,MATH 109,B03,093479,Ganzberger; Geoffrey Michael,6,0,32,26
1656792781811,MATH 142A,A01,083219,Chow; Bennett,6,0,32,26
1656792781811,MATH 142A,A02,083220,Chow; Bennett,9,0,32,23
1656792781811,MATH 142A,A03,093480,Chow; Bennett,7,0,32,25
1656792781811,MATH 142A,B03,093481,Chow; Bennett,7,0,32,25
1656792781811,MATH 142A,B04,093558,Chow; Bennett,10,0,32,22
1656792781811,MATH 142A,B05,093559,Chow; Bennett,6,0,32,26
1656792787836,MATH 193A,A01,083224,Rotar; Vladimir,6,0,34,28
1656792787836,MATH 193A,A02,083225,Rotar; Vladimir,3,0,34,31
1656792787836,MATH 193A,A03,083781,Rotar; Vladimir,1,0,34,33
1656792787836,MATH 193A,A04,083782,Rotar; Vladimir,6,0,34,28
1656792787836,MATH 193A,A05,093482,Rotar; Vladimir,6,0,34,28
1656792793861,MATH 197,001,091859,McAuley; Julian John,9999,0,9999,0
1656792793861,MATH 197,002,095566,Kedlaya; Kiran S.,9997,0,9999,2
1656792793861,MATH 197,003,095567,Xiao; Ming,9999,0,9999,0
1656792793861,MATH 197,004,095571,Perols; Johan Lars,9998,0,9999,1
1656792800934,COGS 9,A01,083615,Shannon; Kyle Michael,6,0,75,69
1656792806963,COGS 11,A01,083617,Boyle; Mary E. T.,18,0,48,30
1656792812989,COGS 13,A01,083071,Bastos; Amalia Pinkusfeld,8,0,71,63
1656792819016,COGS 14A,A01,092681,Semenuks; Arturs,0,1,100,100
1656792825048,COGS 14B,A01,083073,Cheng; Tzu-Han,5,0,63,58
1656792831071,COGS 17,A01,092677,Semenuks; Arturs,4,0,81,77
1656792837095,COGS 100,A01,083619,Allen; Michael Gordon,15,0,70,55
1656792843124,COGS 101A,A01,083621,Davis; Joshua Daniel,9,0,68,59
1656792849148,COGS 101B,A01,091572,Allen; Michael Gordon,8,0,65,57
1656792855176,COGS 101C,A01,083625,Delgado; Tania,17,0,35,18
1656792861200,COGS 107A,A01,083627,Boyle; Mary E. T.,13,0,60,47
1656792867230,COGS 118A,A01,083075,Gupta; Anjum,15,0,76,61
1656792873262,CSE 3,A50,083646,Miranda; Gregory Joseph,22,0,50,28
1656792879286,CSE 8A,A50,083650,Miranda; Gregory Joseph,17,1,56,39
1656792885327,CSE 11,A01,083080,Cao; Yingjun,4,15,40,36
1656792891356,CSE 12,A01,083652,Krause-Levy; Sophia Louisa,20,1,120,100
1656792897380,CSE 15L,A01,083654,Morris; Justin Loren,8,0,50,42
1656792897380,CSE 15L,A02,083655,Morris; Justin Loren,8,0,50,42
1656792903405,CSE 20,A01,083657,Tran; Khoa Dang,37,0,80,43
1656792909434,CSE 21,A01,095574,Bach; Quang Tran,21,0,48,27
1656792915464,CSE 30,A01,083084,Eldon; John,4,0,80,76
1656792915464,CSE 30,B01,095061,Bhaskar; Nishant,5,0,50,45
1656792921488,CSE 100,A01,083659,Cao; Yingjun,1,4,70,69
1656792927514,CSE 134B,A01,083661,Powell; Thomas Allan,18,0,100,82
1656792933541,CSE 140,A01,083663,Gungor; Onat,14,0,85,71
1656792939570,CSE 140L,A01,083088,Eldon; John,16,0,100,84
1656792945595,CSE 175,A01,083665,Kumar; Rakesh,3,0,25,22
1656792951618,CSE 190,A00,092507,Dubnov; Shlomo,7,0,20,13
1656792957644,ECE 45,A01,083139,Congero; Spencer William,5,0,75,70
1656792963675,ECE 65,A50,083695,Saad; Andrew S,12,0,30,18
1656792963675,ECE 65,A51,095125,Saad; Andrew S,25,0,26,1
1656792969703,ECE 109,A01,091882,Touri; Behrouz,15,0,70,55
1656792975733,ECE 180,A00,083140,Abi Samra; Nicholas Camill,0,0,30,30
1656792975733,ECE 180,B00,083141,Abi Samra; Nicholas Camill,0,0,30,30
1656792981760,MATH 10A,A01,083735,Patchell; Gregory David,1,0,30,29
1656792981760,MATH 10A,A02,083736,Patchell; Gregory David,20,0,30,10
1656792981760,MATH 10A,A03,083737,Patchell; Gregory David,15,0,30,15
1656792987788,MATH 10B,A01,083207,Lim; Seonhee,7,0,34,27
1656792987788,MATH 10B,A02,083208,Lim; Seonhee,9,0,35,26
1656792987788,MATH 10B,A03,093472,Lim; Seonhee,4,0,34,30
1656792987788,MATH 10B,B01,083739,Sinha; Shubham,9,0,30,21
1656792993818,MATH 18,A01,083743,Cinel; Cameron Alexander,6,0,30,24
1656792993818,MATH 18,A02,083744,Cinel; Cameron Alexander,15,0,30,15
1656792993818,MATH 18,A03,083745,Cinel; Cameron Alexander,8,0,30,22
1656792993818,MATH 18,B01,083748,Rideout; David Porter,3,0,37,34
1656792993818,MATH 18,B02,083749,Rideout; David Porter,3,0,36,33
1656792993818,MATH 18,B03,083750,Rideout; David Porter,1,0,37,36
1656792993818,MATH 18,B04,083751,Rideout; David Porter,5,0,36,31
1656792993818,MATH 18,B05,093473,Rideout; David Porter,4,0,36,32
1656792993818,MATH 18,B06,093474,Rideout; David Porter,5,0,36,31
1656792999847,MATH 20A,A01,083754,Zheng; Zequn,12,0,40,28
1656793005872,MATH 20B,A01,083756,Briones; Jor-el Thomas Caparas,1,0,36,35
1656793005872,MATH 20B,A02,083757,Briones; Jor-el Thomas Caparas,1,0,36,35
1656793005872,MATH 20B,A03,093475,Briones; Jor-el Thomas Caparas,0,0,36,36
1656793011896,MATH 20C,A01,083760,Briones; Jor-el Thomas Caparas,1,0,35,34
1656793011896,MATH 20C,A02,083761,Briones; Jor-el Thomas Caparas,8,0,35,27
1656793011896,MATH 20C,A03,093476,Briones; Jor-el Thomas Caparas,0,1,36,36
1656793011896,MATH 20C,B01,083762,Bach; Quang Tran,0,0,30,30
1656793017924,MATH 20D,A01,083765,Tran; Brian Kha,4,0,30,26
1656793017924,MATH 20D,A02,083766,Tran; Brian Kha,4,0,30,26
1656793017924,MATH 20D,A03,083767,Tran; Brian Kha,2,0,30,28
1656793023955,MATH 20E,A01,083771,Ganguly; Soumya,5,0,32,27
1656793023955,MATH 20E,A02,083772,Ganguly; Soumya,5,0,32,27
1656793023955,MATH 20E,B01,083773,Ciotti; Benjamin,18,0,35,17
1656793023955,MATH 20E,B02,083774,Ciotti; Benjamin,17,0,35,18
1656793029981,MATH 103A,A01,083777,Greenfeld; Be'Eri,2,0,36,34
1656793029981,MATH 103A,A02,083778,Greenfeld; Be'Eri,5,0,36,31
1656793029981,MATH 103A,A03,093561,Greenfeld; Be'Eri,4,0,36,32
1656793029981,MATH 103A,B01,083779,Greenfeld; Be'Eri,6,0,36,30
1656793029981,MATH 103A,B02,083780,Greenfeld; Be'Eri,2,0,36,34
1656793029981,MATH 103A,B03,093562,Greenfeld; Be'Eri,2,0,36,34
1656793036013,MATH 105,A01,085443,Carter; Anne Toulson,13,0,35,22
1656793036013,MATH 105,A02,093477,Carter; Anne Toulson,20,0,35,15
1656793042038,MATH 109,A01,083213,Ganzberger; Geoffrey Michael,2,0,34,32
1656793042038,MATH 109,A02,083214,Ganzberger; Geoffrey Michael,2,0,34,32
1656793042038,MATH 109,A03,093478,Ganzberger; Geoffrey Michael,1,0,34,33
1656793042038,MATH 109,B01,083215,Ganzberger; Geoffrey Michael,1,0,32,31
1656793042038,MATH 109,B02,083216,Ganzberger; Geoffrey Michael,1,0,32,31
1656793042038,MATH 109,B03,093479,Ganzberger; Geoffrey Michael,6,0,32,26
1656793048065,MATH 142A,A01,083219,Chow; Bennett,6,0,32,26
1656793048065,MATH 142A,A02,083220,Chow; Bennett,9,0,32,23
1656793048065,MATH 142A,A03,093480,Chow; Bennett,7,0,32,25
1656793048065,MATH 142A,B03,093481,Chow; Bennett,7,0,32,25
1656793048065,MATH 142A,B04,093558,Chow; Bennett,10,0,32,22
1656793048065,MATH 142A,B05,093559,Chow; Bennett,6,0,32,26
1656793054090,MATH 193A,A01,083224,Rotar; Vladimir,6,0,34,28
1656793054090,MATH 193A,A02,083225,Rotar; Vladimir,3,0,34,31
1656793054090,MATH 193A,A03,083781,Rotar; Vladimir,1,0,34,33
1656793054090,MATH 193A,A04,083782,Rotar; Vladimir,6,0,34,28
1656793054090,MATH 193A,A05,093482,Rotar; Vladimir,6,0,34,28
1656793060116,MATH 197,001,091859,McAuley; Julian John,9999,0,9999,0
1656793060116,MATH 197,002,095566,Kedlaya; Kiran S.,9997,0,9999,2
1656793060116,MATH 197,003,095567,Xiao; Ming,9999,0,9999,0
1656793060116,MATH 197,004,095571,Perols; Johan Lars,9998,0,9999,1
1656793067184,COGS 9,A01,083615,Shannon; Kyle Michael,6,0,75,69
1656793073212,COGS 11,A01,083617,Boyle; Mary E. T.,18,0,48,30
1656793079237,COGS 13,A01,083071,Bastos; Amalia Pinkusfeld,8,0,71,63
1656793085268,COGS 14A,A01,092681,Semenuks; Arturs,0,1,100,100
1656793091291,COGS 14B,A01,083073,Cheng; Tzu-Han,5,0,63,58
1656793097320,COGS 17,A01,092677,Semenuks; Arturs,4,0,81,77
1656793103350,COGS 100,A01,083619,Allen; Michael Gordon,15,0,70,55
1656793109378,COGS 101A,A01,083621,Davis; Joshua Daniel,9,0,68,59
1656793115403,COGS 101B,A01,091572,Allen; Michael Gordon,8,0,65,57
1656793121427,COGS 101C,A01,083625,Delgado; Tania,17,0,35,18
1656793127452,COGS 107A,A01,083627,Boyle; Mary E. T.,13,0,60,47
1656793133475,COGS 118A,A01,083075,Gupta; Anjum,15,0,76,61
1656793139509,CSE 3,A50,083646,Miranda; Gregory Joseph,22,0,50,28
1656793145533,CSE 8A,A50,083650,Miranda; Gregory Joseph,17,1,56,39
1656793151561,CSE 11,A01,083080,Cao; Yingjun,4,15,40,36
1656793157596,CSE 12,A01,083652,Krause-Levy; Sophia Louisa,20,1,120,100
1656793163625,CSE 15L,A01,083654,Morris; Justin Loren,8,0,50,42
1656793163625,CSE 15L,A02,083655,Morris; Justin Loren,8,0,50,42
1656793169669,CSE 20,A01,083657,Tran; Khoa Dang,37,0,80,43
1656793175695,CSE 21,A01,095574,Bach; Quang Tran,21,0,48,27
1656793181721,CSE 30,A01,083084,Eldon; John,4,0,80,76
1656793181721,CSE 30,B01,095061,Bhaskar; Nishant,5,0,50,45
1656793187746,CSE 100,A01,083659,Cao; Yingjun,1,4,70,69
1656793193772,CSE 134B,A01,083661,Powell; Thomas Allan,18,0,100,82
1656793199800,CSE 140,A01,083663,Gungor; Onat,14,0,85,71
1656793205823,CSE 140L,A01,083088,Eldon; John,16,0,100,84
1656793211854,CSE 175,A01,083665,Kumar; Rakesh,3,0,25,22
1656793217878,CSE 190,A00,092507,Dubnov; Shlomo,7,0,20,13
1656793223902,ECE 45,A01,083139,Congero; Spencer William,5,0,75,70
1656793229928,ECE 65,A50,083695,Saad; Andrew S,12,0,30,18
1656793229928,ECE 65,A51,095125,Saad; Andrew S,25,0,26,1
1656793235952,ECE 109,A01,091882,Touri; Behrouz,15,0,70,55
1656793241983,ECE 180,A00,083140,Abi Samra; Nicholas Camill,0,0,30,30
1656793241983,ECE 180,B00,083141,Abi Samra; Nicholas Camill,0,0,30,30
1656793248010,MATH 10A,A01,083735,Patchell; Gregory David,1,0,30,29
1656793248010,MATH 10A,A02,083736,Patchell; Gregory David,20,0,30,10
1656793248010,MATH 10A,A03,083737,Patchell; Gregory David,15,0,30,15
1656793254034,MATH 10B,A01,083207,Lim; Seonhee,7,0,34,27
1656793254034,MATH 10B,A02,083208,Lim; Seonhee,9,0,35,26
1656793254034,MATH 10B,A03,093472,Lim; Seonhee,4,0,34,30
1656793254034,MATH 10B,B01,083739,Sinha; Shubham,9,0,30,21
1656793260059,MATH 18,A01,083743,Cinel; Cameron Alexander,6,0,30,24
1656793260059,MATH 18,A02,083744,Cinel; Cameron Alexander,15,0,30,15
1656793260059,MATH 18,A03,083745,Cinel; Cameron Alexander,8,0,30,22
1656793260059,MATH 18,B01,083748,Rideout; David Porter,3,0,37,34
1656793260059,MATH 18,B02,083749,Rideout; David Porter,3,0,36,33
1656793260059,MATH 18,B03,083750,Rideout; David Porter,1,0,37,36
1656793260059,MATH 18,B04,083751,Rideout; David Porter,5,0,36,31
1656793260059,MATH 18,B05,093473,Rideout; David Porter,4,0,36,32
1656793260059,MATH 18,B06,093474,Rideout; David Porter,5,0,36,31
1656793266083,MATH 20A,A01,083754,Zheng; Zequn,12,0,40,28
1656793272109,MATH 20B,A01,083756,Briones; Jor-el Thomas Caparas,1,0,36,35
1656793272109,MATH 20B,A02,083757,Briones; Jor-el Thomas Caparas,1,0,36,35
1656793272109,MATH 20B,A03,093475,Briones; Jor-el Thomas Caparas,0,0,36,36
1656793278134,MATH 20C,A01,083760,Briones; Jor-el Thomas Caparas,1,0,35,34
1656793278134,MATH 20C,A02,083761,Briones; Jor-el Thomas Caparas,8,0,35,27
1656793278134,MATH 20C,A03,093476,Briones; Jor-el Thomas Caparas,0,1,36,36
1656793278134,MATH 20C,B01,083762,Bach; Quang Tran,0,0,30,30
1656793284159,MATH 20D,A01,083765,Tran; Brian Kha,4,0,30,26
1656793284159,MATH 20D,A02,083766,Tran; Brian Kha,4,0,30,26
1656793284159,MATH 20D,A03,083767,Tran; Brian Kha,2,0,30,28
1656793290183,MATH 20E,A01,083771,Ganguly; Soumya,5,0,32,27
1656793290183,MATH 20E,A02,083772,Ganguly; Soumya,5,0,32,27
1656793290183,MATH 20E,B01,083773,Ciotti; Benjamin,18,0,35,17
1656793290183,MATH 20E,B02,083774,Ciotti; Benjamin,17,0,35,18
1656793296207,MATH 103A,A01,083777,Greenfeld; Be'Eri,2,0,36,34
1656793296207,MATH 103A,A02,083778,Greenfeld; Be'Eri,5,0,36,31
1656793296207,MATH 103A,A03,093561,Greenfeld; Be'Eri,4,0,36,32
1656793296207,MATH 103A,B01,083779,Greenfeld; Be'Eri,6,0,36,30
1656793296207,MATH 103A,B02,083780,Greenfeld; Be'Eri,2,0,36,34
1656793296207,MATH 103A,B03,093562,Greenfeld; Be'Eri,2,0,36,34
1656793302236,MATH 105,A01,085443,Carter; Anne Toulson,13,0,35,22
1656793302236,MATH 105,A02,093477,Carter; Anne Toulson,20,0,35,15
1656793308261,MATH 109,A01,083213,Ganzberger; Geoffrey Michael,2,0,34,32
1656793308261,MATH 109,A02,083214,Ganzberger; Geoffrey Michael,2,0,34,32
1656793308261,MATH 109,A03,093478,Ganzberger; Geoffrey Michael,1,0,34,33
1656793308261,MATH 109,B01,083215,Ganzberger; Geoffrey Michael,1,0,32,31
1656793308261,MATH 109,B02,083216,Ganzberger; Geoffrey Michael,1,0,32,31
1656793308261,MATH 109,B03,093479,Ganzberger; Geoffrey Michael,6,0,32,26
1656793314287,MATH 142A,A01,083219,Chow; Bennett,6,0,32,26
1656793314287,MATH 142A,A02,083220,Chow; Bennett,9,0,32,23
1656793314287,MATH 142A,A03,093480,Chow; Bennett,7,0,32,25
1656793314287,MATH 142A,B03,093481,Chow; Bennett,7,0,32,25
1656793314287,MATH 142A,B04,093558,Chow; Bennett,10,0,32,22
1656793314287,MATH 142A,B05,093559,Chow; Bennett,6,0,32,26
1656793320315,MATH 193A,A01,083224,Rotar; Vladimir,6,0,34,28
1656793320315,MATH 193A,A02,083225,Rotar; Vladimir,3,0,34,31
1656793320315,MATH 193A,A03,083781,Rotar; Vladimir,1,0,34,33
1656793320315,MATH 193A,A04,083782,Rotar; Vladimir,6,0,34,28
1656793320315,MATH 193A,A05,093482,Rotar; Vladimir,6,0,34,28
1656793326342,MATH 197,001,091859,McAuley; Julian John,9999,0,9999,0
1656793326342,MATH 197,002,095566,Kedlaya; Kiran S.,9997,0,9999,2
1656793326342,MATH 197,003,095567,Xiao; Ming,9999,0,9999,0
1656793326342,MATH 197,004,095571,Perols; Johan Lars,9998,0,9999,1
1656793333413,COGS 9,A01,083615,Shannon; Kyle Michael,6,0,75,69
1656793339443,COGS 11,A01,083617,Boyle; Mary E. T.,18,0,48,30
1656793345481,COGS 13,A01,083071,Bastos; Amalia Pinkusfeld,8,0,71,63
1656793351510,COGS 14A,A01,092681,Semenuks; Arturs,0,1,100,100
1656793357533,COGS 14B,A01,083073,Cheng; Tzu-Han,5,0,63,58
1656793363634,COGS 17,A01,092677,Semenuks; Arturs,4,0,81,77
1656793369662,COGS 100,A01,083619,Allen; Michael Gordon,15,0,70,55
1656793375692,COGS 101A,A01,083621,Davis; Joshua Daniel,9,0,68,59
1656793381715,COGS 101B,A01,091572,Allen; Michael Gordon,8,0,65,57
1656793387743,COGS 101C,A01,083625,Delgado; Tania,17,0,35,18
1656793393765,COGS 107A,A01,083627,Boyle; Mary E. T.,13,0,60,47
1656793399789,COGS 118A,A01,083075,Gupta; Anjum,15,0,76,61
1656793405813,CSE 3,A50,083646,Miranda; Gregory Joseph,22,0,50,28
1656793411836,CSE 8A,A50,083650,Miranda; Gregory Joseph,17,1,56,39
1656793417860,CSE 11,A01,083080,Cao; Yingjun,4,15,40,36
1656793423885,CSE 12,A01,083652,Krause-Levy; Sophia Louisa,20,1,120,100
1656793429910,CSE 15L,A01,083654,Morris; Justin Loren,8,0,50,42
1656793429910,CSE 15L,A02,083655,Morris; Justin Loren,8,0,50,42
1656793435934,CSE 20,A01,083657,Tran; Khoa Dang,37,0,80,43
1656793441963,CSE 21,A01,095574,Bach; Quang Tran,21,0,48,27
1656793447989,CSE 30,A01,083084,Eldon; John,4,0,80,76
1656793447989,CSE 30,B01,095061,Bhaskar; Nishant,5,0,50,45
1656793454015,CSE 100,A01,083659,Cao; Yingjun,1,4,70,69
1656793460039,CSE 134B,A01,083661,Powell; Thomas Allan,18,0,100,82
1656793466067,CSE 140,A01,083663,Gungor; Onat,14,0,85,71
1656793472095,CSE 140L,A01,083088,Eldon; John,16,0,100,84
1656793478122,CSE 175,A01,083665,Kumar; Rakesh,3,0,25,22
1656793484146,CSE 190,A00,092507,Dubnov; Shlomo,7,0,20,13
1656793490170,ECE 45,A01,083139,Congero; Spencer William,5,0,75,70
1656793496203,ECE 65,A50,083695,Saad; Andrew S,12,0,30,18
1656793496203,ECE 65,A51,095125,Saad; Andrew S,25,0,26,1
1656793502231,ECE 109,A01,091882,Touri; Behrouz,15,0,70,55
1656793508255,ECE 180,A00,083140,Abi Samra; Nicholas Camill,0,0,30,30
1656793508255,ECE 180,B00,083141,Abi Samra; Nicholas Camill,0,0,30,30
1656793514283,MATH 10A,A01,083735,Patchell; Gregory David,1,0,30,29
1656793514283,MATH 10A,A02,083736,Patchell; Gregory David,20,0,30,10
1656793514283,MATH 10A,A03,083737,Patchell; Gregory David,15,0,30,15
1656793520308,MATH 10B,A01,083207,Lim; Seonhee,7,0,34,27
1656793520308,MATH 10B,A02,083208,Lim; Seonhee,9,0,35,26
1656793520308,MATH 10B,A03,093472,Lim; Seonhee,4,0,34,30
1656793520308,MATH 10B,B01,083739,Sinha; Shubham,9,0,30,21
1656793526335,MATH 18,A01,083743,Cinel; Cameron Alexander,6,0,30,24
1656793526335,MATH 18,A02,083744,Cinel; Cameron Alexander,15,0,30,15
1656793526335,MATH 18,A03,083745,Cinel; Cameron Alexander,8,0,30,22
1656793526335,MATH 18,B01,083748,Rideout; David Porter,3,0,37,34
1656793526335,MATH 18,B02,083749,Rideout; David Porter,3,0,36,33
1656793526335,MATH 18,B03,083750,Rideout; David Porter,1,0,37,36
1656793526335,MATH 18,B04,083751,Rideout; David Porter,5,0,36,31
1656793526335,MATH 18,B05,093473,Rideout; David Porter,4,0,36,32
1656793526335,MATH 18,B06,093474,Rideout; David Porter,5,0,36,31
1656793532366,MATH 20A,A01,083754,Zheng; Zequn,12,0,40,28
1656793538390,MATH 20B,A01,083756,Briones; Jor-el Thomas Caparas,1,0,36,35
1656793538390,MATH 20B,A02,083757,Briones; Jor-el Thomas Caparas,1,0,36,35
1656793538390,MATH 20B,A03,093475,Briones; Jor-el Thomas Caparas,0,0,36,36
1656793544417,MATH 20C,A01,083760,Briones; Jor-el Thomas Caparas,1,0,35,34
1656793544417,MATH 20C,A02,083761,Briones; Jor-el Thomas Caparas,8,0,35,27
1656793544417,MATH 20C,A03,093476,Briones; Jor-el Thomas Caparas,0,1,36,36
1656793544417,MATH 20C,B01,083762,Bach; Quang Tran,0,0,30,30
1656793550442,MATH 20D,A01,083765,Tran; Brian Kha,4,0,30,26
1656793550442,MATH 20D,A02,083766,Tran; Brian Kha,4,0,30,26
1656793550442,MATH 20D,A03,083767,Tran; Brian Kha,2,0,30,28
1656793556466,MATH 20E,A01,083771,Ganguly; Soumya,5,0,32,27
1656793556466,MATH 20E,A02,083772,Ganguly; Soumya,5,0,32,27
1656793556466,MATH 20E,B01,083773,Ciotti; Benjamin,18,0,35,17
1656793556466,MATH 20E,B02,083774,Ciotti; Benjamin,17,0,35,18
1656793562503,MATH 103A,A01,083777,Greenfeld; Be'Eri,2,0,36,34
1656793562503,MATH 103A,A02,083778,Greenfeld; Be'Eri,5,0,36,31
1656793562503,MATH 103A,A03,093561,Greenfeld; Be'Eri,4,0,36,32
1656793562503,MATH 103A,B01,083779,Greenfeld; Be'Eri,6,0,36,30
1656793562503,MATH 103A,B02,083780,Greenfeld; Be'Eri,2,0,36,34
1656793562503,MATH 103A,B03,093562,Greenfeld; Be'Eri,2,0,36,34
1656793568526,MATH 105,A01,085443,Carter; Anne Toulson,13,0,35,22
1656793568526,MATH 105,A02,093477,Carter; Anne Toulson,20,0,35,15
1656793574559,MATH 109,A01,083213,Ganzberger; Geoffrey Michael,2,0,34,32
1656793574559,MATH 109,A02,083214,Ganzberger; Geoffrey Michael,2,0,34,32
1656793574559,MATH 109,A03,093478,Ganzberger; Geoffrey Michael,1,0,34,33
1656793574559,MATH 109,B01,083215,Ganzberger; Geoffrey Michael,1,0,32,31
1656793574559,MATH 109,B02,083216,Ganzberger; Geoffrey Michael,1,0,32,31
1656793574559,MATH 109,B03,093479,Ganzberger; Geoffrey Michael,6,0,32,26
1656793580585,MATH 142A,A01,083219,Chow; Bennett,6,0,32,26
1656793580585,MATH 142A,A02,083220,Chow; Bennett,9,0,32,23
1656793580585,MATH 142A,A03,093480,Chow; Bennett,7,0,32,25
1656793580585,MATH 142A,B03,093481,Chow; Bennett,7,0,32,25
1656793580585,MATH 142A,B04,093558,Chow; Bennett,10,0,32,22
1656793580585,MATH 142A,B05,093559,Chow; Bennett,6,0,32,26
1656793586615,MATH 193A,A01,083224,Rotar; Vladimir,6,0,34,28
1656793586615,MATH 193A,A02,083225,Rotar; Vladimir,3,0,34,31
1656793586615,MATH 193A,A03,083781,Rotar; Vladimir,1,0,34,33
1656793586615,MATH 193A,A04,083782,Rotar; Vladimir,6,0,34,28
1656793586615,MATH 193A,A05,093482,Rotar; Vladimir,6,0,34,28
1656793592638,MATH 197,001,091859,McAuley; Julian John,9999,0,9999,0
1656793592638,MATH 197,002,095566,Kedlaya; Kiran S.,9997,0,9999,2
1656793592638,MATH 197,003,095567,Xiao; Ming,9999,0,9999,0
1656793592638,MATH 197,004,095571,Perols; Johan Lars,9998,0,9999,1
1656793599714,COGS 9,A01,083615,Shannon; Kyle Michael,6,0,75,69
1656793605738,COGS 11,A01,083617,Boyle; Mary E. T.,18,0,48,30
1656793611770,COGS 13,A01,083071,Bastos; Amalia Pinkusfeld,8,0,71,63
1656793617793,COGS 14A,A01,092681,Semenuks; Arturs,0,1,100,100
1656793623816,COGS 14B,A01,083073,Cheng; Tzu-Han,5,0,63,58
1656793629840,COGS 17,A01,092677,Semenuks; Arturs,4,0,81,77
1656793635868,COGS 100,A01,083619,Allen; Michael Gordon,15,0,70,55
1656793641892,COGS 101A,A01,083621,Davis; Joshua Daniel,9,0,68,59
1656793647915,COGS 101B,A01,091572,Allen; Michael Gordon,8,0,65,57
1656793653943,COGS 101C,A01,083625,Delgado; Tania,17,0,35,18
1656793659965,COGS 107A,A01,083627,Boyle; Mary E. T.,13,0,60,47
1656793665993,COGS 118A,A01,083075,Gupta; Anjum,15,0,76,61
1656793672020,CSE 3,A50,083646,Miranda; Gregory Joseph,22,0,50,28
1656793678046,CSE 8A,A50,083650,Miranda; Gregory Joseph,17,1,56,39
1656793684069,CSE 11,A01,083080,Cao; Yingjun,4,15,40,36
1656793690093,CSE 12,A01,083652,Krause-Levy; Sophia Louisa,20,1,120,100
1656793696120,CSE 15L,A01,083654,Morris; Justin Loren,8,0,50,42
1656793696120,CSE 15L,A02,083655,Morris; Justin Loren,8,0,50,42
1656793702148,CSE 20,A01,083657,Tran; Khoa Dang,37,0,80,43
1656793708173,CSE 21,A01,095574,Bach; Quang Tran,21,0,48,27
1656793714201,CSE 30,A01,083084,Eldon; John,4,0,80,76
1656793714201,CSE 30,B01,095061,Bhaskar; Nishant,5,0,50,45
1656793720225,CSE 100,A01,083659,Cao; Yingjun,1,4,70,69
1656793726250,CSE 134B,A01,083661,Powell; Thomas Allan,18,0,100,82
1656793732276,CSE 140,A01,083663,Gungor; Onat,14,0,85,71
1656793738300,CSE 140L,A01,083088,Eldon; John,16,0,100,84
1656793744324,CSE 175,A01,083665,Kumar; Rakesh,3,0,25,22
1656793750360,CSE 190,A00,092507,Dubnov; Shlomo,7,0,20,13
1656793756382,ECE 45,A01,083139,Congero; Spencer William,5,0,75,70
1656793762408,ECE 65,A50,083695,Saad; Andrew S,12,0,30,18
1656793762408,ECE 65,A51,095125,Saad; Andrew S,25,0,26,1
1656793768434,ECE 109,A01,091882,Touri; Behrouz,15,0,70,55
1656793774463,ECE 180,A00,083140,Abi Samra; Nicholas Camill,0,0,30,30
1656793774463,ECE 180,B00,083141,Abi Samra; Nicholas Camill,0,0,30,30
1656793780491,MATH 10A,A01,083735,Patchell; Gregory David,1,0,30,29
1656793780491,MATH 10A,A02,083736,Patchell; Gregory David,20,0,30,10
1656793780491,MATH 10A,A03,083737,Patchell; Gregory David,15,0,30,15
1656793786521,MATH 10B,A01,083207,Lim; Seonhee,7,0,34,27
1656793786521,MATH 10B,A02,083208,Lim; Seonhee,9,0,35,26
1656793786521,MATH 10B,A03,093472,Lim; Seonhee,4,0,34,30
1656793786521,MATH 10B,B01,083739,Sinha; Shubham,9,0,30,21
1656793792554,MATH 18,A01,083743,Cinel; Cameron Alexander,6,0,30,24
1656793792554,MATH 18,A02,083744,Cinel; Cameron Alexander,15,0,30,15
1656793792554,MATH 18,A03,083745,Cinel; Cameron Alexander,8,0,30,22
1656793792554,MATH 18,B01,083748,Rideout; David Porter,3,0,37,34
1656793792554,MATH 18,B02,083749,Rideout; David Porter,3,0,36,33
1656793792554,MATH 18,B03,083750,Rideout; David Porter,1,0,37,36
1656793792554,MATH 18,B04,083751,Rideout; David Porter,5,0,36,31
1656793792554,MATH 18,B05,093473,Rideout; David Porter,4,0,36,32
1656793792554,MATH 18,B06,093474,Rideout; David Porter,5,0,36,31
1656793798594,MATH 20A,A01,083754,Zheng; Zequn,12,0,40,28
1656793804619,MATH 20B,A01,083756,Briones; Jor-el Thomas Caparas,1,0,36,35
1656793804619,MATH 20B,A02,083757,Briones; Jor-el Thomas Caparas,1,0,36,35
1656793804619,MATH 20B,A03,093475,Briones; Jor-el Thomas Caparas,0,0,36,36
1656793810648,MATH 20C,A01,083760,Briones; Jor-el Thomas Caparas,1,0,35,34
1656793810648,MATH 20C,A02,083761,Briones; Jor-el Thomas Caparas,8,0,35,27
1656793810648,MATH 20C,A03,093476,Briones; Jor-el Thomas Caparas,0,1,36,36
1656793810648,MATH 20C,B01,083762,Bach; Quang Tran,0,0,30,30
1656793816671,MATH 20D,A01,083765,Tran; Brian Kha,4,0,30,26
1656793816671,MATH 20D,A02,083766,Tran; Brian Kha,4,0,30,26
1656793816671,MATH 20D,A03,083767,Tran; Brian Kha,2,0,30,28
1656793822699,MATH 20E,A01,083771,Ganguly; Soumya,5,0,32,27
1656793822699,MATH 20E,A02,083772,Ganguly; Soumya,5,0,32,27
1656793822699,MATH 20E,B01,083773,Ciotti; Benjamin,18,0,35,17
1656793822699,MATH 20E,B02,083774,Ciotti; Benjamin,17,0,35,18
1656793828740,MATH 103A,A01,083777,Greenfeld; Be'Eri,2,0,36,34
1656793828740,MATH 103A,A02,083778,Greenfeld; Be'Eri,5,0,36,31
1656793828740,MATH 103A,A03,093561,Greenfeld; Be'Eri,4,0,36,32
1656793828740,MATH 103A,B01,083779,Greenfeld; Be'Eri,6,0,36,30
1656793828740,MATH 103A,B02,083780,Greenfeld; Be'Eri,2,0,36,34
1656793828740,MATH 103A,B03,093562,Greenfeld; Be'Eri,2,0,36,34
1656793834767,MATH 105,A01,085443,Carter; Anne Toulson,13,0,35,22
1656793834767,MATH 105,A02,093477,Carter; Anne Toulson,20,0,35,15
1656793840794,MATH 109,A01,083213,Ganzberger; Geoffrey Michael,2,0,34,32
1656793840794,MATH 109,A02,083214,Ganzberger; Geoffrey Michael,2,0,34,32
1656793840794,MATH 109,A03,093478,Ganzberger; Geoffrey Michael,1,0,34,33
1656793840794,MATH 109,B01,083215,Ganzberger; Geoffrey Michael,1,0,32,31
1656793840794,MATH 109,B02,083216,Ganzberger; Geoffrey Michael,1,0,32,31
1656793840794,MATH 109,B03,093479,Ganzberger; Geoffrey Michael,6,0,32,26
1656793846822,MATH 142A,A01,083219,Chow; Bennett,6,0,32,26
1656793846822,MATH 142A,A02,083220,Chow; Bennett,9,0,32,23
1656793846822,MATH 142A,A03,093480,Chow; Bennett,7,0,32,25
1656793846822,MATH 142A,B03,093481,Chow; Bennett,7,0,32,25
1656793846822,MATH 142A,B04,093558,Chow; Bennett,10,0,32,22
1656793846822,MATH 142A,B05,093559,Chow; Bennett,6,0,32,26
1656793852849,MATH 193A,A01,083224,Rotar; Vladimir,6,0,34,28
1656793852849,MATH 193A,A02,083225,Rotar; Vladimir,3,0,34,31
1656793852849,MATH 193A,A03,083781,Rotar; Vladimir,1,0,34,33
1656793852849,MATH 193A,A04,083782,Rotar; Vladimir,6,0,34,28
1656793852849,MATH 193A,A05,093482,Rotar; Vladimir,6,0,34,28
1656793858872,MATH 197,001,091859,McAuley; Julian John,9999,0,9999,0
1656793858872,MATH 197,002,095566,Kedlaya; Kiran S.,9997,0,9999,2
1656793858872,MATH 197,003,095567,Xiao; Ming,9999,0,9999,0
1656793858872,MATH 197,004,095571,Perols; Johan Lars,9998,0,9999,1
1656793865934,COGS 9,A01,083615,Shannon; Kyle Michael,6,0,75,69
1656793871959,COGS 11,A01,083617,Boyle; Mary E. T.,18,0,48,30
1656793877982,COGS 13,A01,083071,Bastos; Amalia Pinkusfeld,8,0,71,63
1656793884005,COGS 14A,A01,092681,Semenuks; Arturs,0,1,100,100
1656793890032,COGS 14B,A01,083073,Cheng; Tzu-Han,5,0,63,58
1656793896053,COGS 17,A01,092677,Semenuks; Arturs,4,0,81,77
1656793902079,COGS 100,A01,083619,Allen; Michael Gordon,15,0,70,55
1656793908103,COGS 101A,A01,083621,Davis; Joshua Daniel,9,0,68,59
1656793914130,COGS 101B,A01,091572,Allen; Michael Gordon,8,0,65,57
1656793920152,COGS 101C,A01,083625,Delgado; Tania,17,0,35,18
1656793926179,COGS 107A,A01,083627,Boyle; Mary E. T.,13,0,60,47
1656793932207,COGS 118A,A01,083075,Gupta; Anjum,15,0,76,61
1656793938234,CSE 3,A50,083646,Miranda; Gregory Joseph,22,0,50,28
1656793944261,CSE 8A,A50,083650,Miranda; Gregory Joseph,17,1,56,39
1656793950283,CSE 11,A01,083080,Cao; Yingjun,4,15,40,36
1656793956308,CSE 12,A01,083652,Krause-Levy; Sophia Louisa,20,1,120,100
1656793962424,CSE 15L,A01,083654,Morris; Justin Loren,8,0,50,42
1656793962424,CSE 15L,A02,083655,Morris; Justin Loren,8,0,50,42
1656793968452,CSE 20,A01,083657,Tran; Khoa Dang,37,0,80,43
1656793974476,CSE 21,A01,095574,Bach; Quang Tran,21,0,48,27
1656793980506,CSE 30,A01,083084,Eldon; John,4,0,80,76
1656793980506,CSE 30,B01,095061,Bhaskar; Nishant,5,0,50,45
1656793986529,CSE 100,A01,083659,Cao; Yingjun,1,4,70,69
1656793992553,CSE 134B,A01,083661,Powell; Thomas Allan,18,0,100,82
1656793998581,CSE 140,A01,083663,Gungor; Onat,14,0,85,71
1656794004604,CSE 140L,A01,083088,Eldon; John,16,0,100,84
1656794010627,CSE 175,A01,083665,Kumar; Rakesh,3,0,25,22
1656794016650,CSE 190,A00,092507,Dubnov; Shlomo,7,0,20,13
1656794022674,ECE 45,A01,083139,Congero; Spencer William,5,0,75,70
1656794028696,ECE 65,A50,083695,Saad; Andrew S,12,0,30,18
1656794028696,ECE 65,A51,095125,Saad; Andrew S,25,0,26,1
1656794034723,ECE 109,A01,091882,Touri; Behrouz,15,0,70,55
1656794040751,ECE 180,A00,083140,Abi Samra; Nicholas Camill,0,0,30,30
1656794040751,ECE 180,B00,083141,Abi Samra; Nicholas Camill,0,0,30,30
1656794046787,MATH 10A,A01,083735,Patchell; Gregory David,1,0,30,29
1656794046787,MATH 10A,A02,083736,Patchell; Gregory David,20,0,30,10
1656794046787,MATH 10A,A03,083737,Patchell; Gregory David,15,0,30,15
1656794052811,MATH 10B,A01,083207,Lim; Seonhee,7,0,34,27
1656794052811,MATH 10B,A02,083208,Lim; Seonhee,9,0,35,26
1656794052811,MATH 10B,A03,093472,Lim; Seonhee,4,0,34,30
1656794052811,MATH 10B,B01,083739,Sinha; Shubham,9,0,30,21
1656794058843,MATH 18,A01,083743,Cinel; Cameron Alexander,6,0,30,24
1656794058843,MATH 18,A02,083744,Cinel; Cameron Alexander,15,0,30,15
1656794058843,MATH 18,A03,083745,Cinel; Cameron Alexander,8,0,30,22
1656794058843,MATH 18,B01,083748,Rideout; David Porter,3,0,37,34
1656794058843,MATH 18,B02,083749,Rideout; David Porter,3,0,36,33
1656794058843,MATH 18,B03,083750,Rideout; David Porter,1,0,37,36
1656794058843,MATH 18,B04,083751,Rideout; David Porter,5,0,36,31
1656794058843,MATH 18,B05,093473,Rideout; David Porter,4,0,36,32
1656794058843,MATH 18,B06,093474,Rideout; David Porter,5,0,36,31
1656794064866,MATH 20A,A01,083754,Zheng; Zequn,12,0,40,28
1656794070894,MATH 20B,A01,083756,Briones; Jor-el Thomas Caparas,1,0,36,35
1656794070894,MATH 20B,A02,083757,Briones; Jor-el Thomas Caparas,1,0,36,35
1656794070894,MATH 20B,A03,093475,Briones; Jor-el Thomas Caparas,0,0,36,36
1656794076918,MATH 20C,A01,083760,Briones; Jor-el Thomas Caparas,1,0,35,34
1656794076918,MATH 20C,A02,083761,Briones; Jor-el Thomas Caparas,8,0,35,27
1656794076918,MATH 20C,A03,093476,Briones; Jor-el Thomas Caparas,0,1,36,36
1656794076918,MATH 20C,B01,083762,Bach; Quang Tran,0,0,30,30
1656794082943,MATH 20D,A01,083765,Tran; Brian Kha,4,0,30,26
1656794082943,MATH 20D,A02,083766,Tran; Brian Kha,4,0,30,26
1656794082943,MATH 20D,A03,083767,Tran; Brian Kha,2,0,30,28
1656794088975,MATH 20E,A01,083771,Ganguly; Soumya,5,0,32,27
1656794088975,MATH 20E,A02,083772,Ganguly; Soumya,5,0,32,27
1656794088975,MATH 20E,B01,083773,Ciotti; Benjamin,18,0,35,17
1656794088975,MATH 20E,B02,083774,Ciotti; Benjamin,17,0,35,18
1656794095007,MATH 103A,A01,083777,Greenfeld; Be'Eri,2,0,36,34
1656794095007,MATH 103A,A02,083778,Greenfeld; Be'Eri,5,0,36,31
1656794095007,MATH 103A,A03,093561,Greenfeld; Be'Eri,4,0,36,32
1656794095007,MATH 103A,B01,083779,Greenfeld; Be'Eri,6,0,36,30
1656794095007,MATH 103A,B02,083780,Greenfeld; Be'Eri,2,0,36,34
1656794095007,MATH 103A,B03,093562,Greenfeld; Be'Eri,2,0,36,34
1656794101035,MATH 105,A01,085443,Carter; Anne Toulson,13,0,35,22
1656794101035,MATH 105,A02,093477,Carter; Anne Toulson,20,0,35,15
1656794107059,MATH 109,A01,083213,Ganzberger; Geoffrey Michael,2,0,34,32
1656794107059,MATH 109,A02,083214,Ganzberger; Geoffrey Michael,2,0,34,32
1656794107059,MATH 109,A03,093478,Ganzberger; Geoffrey Michael,1,0,34,33
1656794107059,MATH 109,B01,083215,Ganzberger; Geoffrey Michael,1,0,32,31
1656794107059,MATH 109,B02,083216,Ganzberger; Geoffrey Michael,1,0,32,31
1656794107059,MATH 109,B03,093479,Ganzberger; Geoffrey Michael,6,0,32,26
1656794113086,MATH 142A,A01,083219,Chow; Bennett,6,0,32,26
1656794113086,MATH 142A,A02,083220,Chow; Bennett,9,0,32,23
1656794113086,MATH 142A,A03,093480,Chow; Bennett,7,0,32,25
1656794113086,MATH 142A,B03,093481,Chow; Bennett,7,0,32,25
1656794113086,MATH 142A,B04,093558,Chow; Bennett,10,0,32,22
1656794113086,MATH 142A,B05,093559,Chow; Bennett,6,0,32,26
1656794119112,MATH 193A,A01,083224,Rotar; Vladimir,6,0,34,28
1656794119112,MATH 193A,A02,083225,Rotar; Vladimir,3,0,34,31
1656794119112,MATH 193A,A03,083781,Rotar; Vladimir,1,0,34,33
1656794119112,MATH 193A,A04,083782,Rotar; Vladimir,6,0,34,28
1656794119112,MATH 193A,A05,093482,Rotar; Vladimir,6,0,34,28
1656794125140,MATH 197,001,091859,McAuley; Julian John,9999,0,9999,0
1656794125140,MATH 197,002,095566,Kedlaya; Kiran S.,9997,0,9999,2
1656794125140,MATH 197,003,095567,Xiao; Ming,9999,0,9999,0
1656794125140,MATH 197,004,095571,Perols; Johan Lars,9998,0,9999,1
1656794132206,COGS 9,A01,083615,Shannon; Kyle Michael,6,0,75,69
1656794138227,COGS 11,A01,083617,Boyle; Mary E. T.,18,0,48,30
1656794144251,COGS 13,A01,083071,Bastos; Amalia Pinkusfeld,8,0,71,63
1656794150277,COGS 14A,A01,092681,Semenuks; Arturs,0,1,100,100
1656794156301,COGS 14B,A01,083073,Cheng; Tzu-Han,5,0,63,58
1656794162328,COGS 17,A01,092677,Semenuks; Arturs,4,0,81,77
1656794168355,COGS 100,A01,083619,Allen; Michael Gordon,15,0,70,55
1656794174383,COGS 101A,A01,083621,Davis; Joshua Daniel,9,0,68,59
1656794180407,COGS 101B,A01,091572,Allen; Michael Gordon,8,0,65,57
1656794186437,COGS 101C,A01,083625,Delgado; Tania,17,0,35,18
1656794192460,COGS 107A,A01,083627,Boyle; Mary E. T.,13,0,60,47
1656794198484,COGS 118A,A01,083075,Gupta; Anjum,15,0,76,61
1656794204510,CSE 3,A50,083646,Miranda; Gregory Joseph,22,0,50,28
1656794210549,CSE 8A,A50,083650,Miranda; Gregory Joseph,17,1,56,39
1656794216571,CSE 11,A01,083080,Cao; Yingjun,4,15,40,36
1656794222599,CSE 12,A01,083652,Krause-Levy; Sophia Louisa,20,1,120,100
1656794228622,CSE 15L,A01,083654,Morris; Justin Loren,8,0,50,42
1656794228622,CSE 15L,A02,083655,Morris; Justin Loren,8,0,50,42
1656794234647,CSE 20,A01,083657,Tran; Khoa Dang,37,0,80,43
1656794240672,CSE 21,A01,095574,Bach; Quang Tran,21,0,48,27
1656794246701,CSE 30,A01,083084,Eldon; John,4,0,80,76
1656794246701,CSE 30,B01,095061,Bhaskar; Nishant,5,0,50,45
1656794252727,CSE 100,A01,083659,Cao; Yingjun,1,4,70,69
1656794258751,CSE 134B,A01,083661,Powell; Thomas Allan,18,0,100,82
1656794264790,CSE 140,A01,083663,Gungor; Onat,14,0,85,71
1656794270816,CSE 140L,A01,083088,Eldon; John,16,0,100,84
1656794276843,CSE 175,A01,083665,Kumar; Rakesh,3,0,25,22
1656794282869,CSE 190,A00,092507,Dubnov; Shlomo,7,0,20,13
1656794288893,ECE 45,A01,083139,Congero; Spencer William,5,0,75,70
1656794294918,ECE 65,A50,083695,Saad; Andrew S,12,0,30,18
1656794294918,ECE 65,A51,095125,Saad; Andrew S,25,0,26,1
1656794300943,ECE 109,A01,091882,Touri; Behrouz,15,0,70,55
1656794306966,ECE 180,A00,083140,Abi Samra; Nicholas Camill,0,0,30,30
1656794306966,ECE 180,B00,083141,Abi Samra; Nicholas Camill,0,0,30,30
1656794312997,MATH 10A,A01,083735,Patchell; Gregory David,1,0,30,29
1656794312997,MATH 10A,A02,083736,Patchell; Gregory David,20,0,30,10
1656794312997,MATH 10A,A03,083737,Patchell; Gregory David,15,0,30,15
1656794319025,MATH 10B,A01,083207,Lim; Seonhee,7,0,34,27
1656794319025,MATH 10B,A02,083208,Lim; Seonhee,9,0,35,26
1656794319025,MATH 10B,A03,093472,Lim; Seonhee,4,0,34,30
1656794319025,MATH 10B,B01,083739,Sinha; Shubham,9,0,30,21
1656794325050,MATH 18,A01,083743,Cinel; Cameron Alexander,6,0,30,24
1656794325050,MATH 18,A02,083744,Cinel; Cameron Alexander,15,0,30,15
1656794325050,MATH 18,A03,083745,Cinel; Cameron Alexander,8,0,30,22
1656794325050,MATH 18,B01,083748,Rideout; David Porter,3,0,37,34
1656794325050,MATH 18,B02,083749,Rideout; David Porter,3,0,36,33
1656794325050,MATH 18,B03,083750,Rideout; David Porter,1,0,37,36
1656794325050,MATH 18,B04,083751,Rideout; David Porter,5,0,36,31
1656794325050,MATH 18,B05,093473,Rideout; David Porter,4,0,36,32
1656794325050,MATH 18,B06,093474,Rideout; David Porter,5,0,36,31
1656794331076,MATH 20A,A01,083754,Zheng; Zequn,12,0,40,28
1656794337105,MATH 20B,A01,083756,Briones; Jor-el Thomas Caparas,1,0,36,35
1656794337105,MATH 20B,A02,083757,Briones; Jor-el Thomas Caparas,1,0,36,35
1656794337105,MATH 20B,A03,093475,Briones; Jor-el Thomas Caparas,0,0,36,36
1656794343129,MATH 20C,A01,083760,Briones; Jor-el Thomas Caparas,1,0,35,34
1656794343129,MATH 20C,A02,083761,Briones; Jor-el Thomas Caparas,8,0,35,27
1656794343129,MATH 20C,A03,093476,Briones; Jor-el Thomas Caparas,0,1,36,36
1656794343129,MATH 20C,B01,083762,Bach; Quang Tran,0,0,30,30
1656794349157,MATH 20D,A01,083765,Tran; Brian Kha,4,0,30,26
1656794349157,MATH 20D,A02,083766,Tran; Brian Kha,4,0,30,26
1656794349157,MATH 20D,A03,083767,Tran; Brian Kha,2,0,30,28
1656794355186,MATH 20E,A01,083771,Ganguly; Soumya,5,0,32,27
1656794355186,MATH 20E,A02,083772,Ganguly; Soumya,5,0,32,27
1656794355186,MATH 20E,B01,083773,Ciotti; Benjamin,18,0,35,17
1656794355186,MATH 20E,B02,083774,Ciotti; Benjamin,17,0,35,18
1656794361216,MATH 103A,A01,083777,Greenfeld; Be'Eri,2,0,36,34
1656794361216,MATH 103A,A02,083778,Greenfeld; Be'Eri,5,0,36,31
1656794361216,MATH 103A,A03,093561,Greenfeld; Be'Eri,4,0,36,32
1656794361216,MATH 103A,B01,083779,Greenfeld; Be'Eri,6,0,36,30
1656794361216,MATH 103A,B02,083780,Greenfeld; Be'Eri,2,0,36,34
1656794361216,MATH 103A,B03,093562,Greenfeld; Be'Eri,2,0,36,34
1656794367244,MATH 105,A01,085443,Carter; Anne Toulson,13,0,35,22
1656794367244,MATH 105,A02,093477,Carter; Anne Toulson,20,0,35,15
1656794373273,MATH 109,A01,083213,Ganzberger; Geoffrey Michael,2,0,34,32
1656794373273,MATH 109,A02,083214,Ganzberger; Geoffrey Michael,2,0,34,32
1656794373273,MATH 109,A03,093478,Ganzberger; Geoffrey Michael,1,0,34,33
1656794373273,MATH 109,B01,083215,Ganzberger; Geoffrey Michael,1,0,32,31
1656794373273,MATH 109,B02,083216,Ganzberger; Geoffrey Michael,1,0,32,31
1656794373273,MATH 109,B03,093479,Ganzberger; Geoffrey Michael,6,0,32,26
1656794379296,MATH 142A,A01,083219,Chow; Bennett,6,0,32,26
1656794379296,MATH 142A,A02,083220,Chow; Bennett,9,0,32,23
1656794379296,MATH 142A,A03,093480,Chow; Bennett,7,0,32,25
1656794379296,MATH 142A,B03,093481,Chow; Bennett,7,0,32,25
1656794379296,MATH 142A,B04,093558,Chow; Bennett,10,0,32,22
1656794379296,MATH 142A,B05,093559,Chow; Bennett,6,0,32,26
1656794385325,MATH 193A,A01,083224,Rotar; Vladimir,6,0,34,28
1656794385325,MATH 193A,A02,083225,Rotar; Vladimir,3,0,34,31
1656794385325,MATH 193A,A03,083781,Rotar; Vladimir,1,0,34,33
1656794385325,MATH 193A,A04,083782,Rotar; Vladimir,6,0,34,28
1656794385325,MATH 193A,A05,093482,Rotar; Vladimir,6,0,34,28
1656794391355,MATH 197,001,091859,McAuley; Julian John,9999,0,9999,0
1656794391355,MATH 197,002,095566,Kedlaya; Kiran S.,9997,0,9999,2
1656794391355,MATH 197,003,095567,Xiao; Ming,9999,0,9999,0
1656794391355,MATH 197,004,095571,Perols; Johan Lars,9998,0,9999,1
1656794398440,COGS 9,A01,083615,Shannon; Kyle Michael,6,0,75,69
1656794404465,COGS 11,A01,083617,Boyle; Mary E. T.,18,0,48,30
1656794410488,COGS 13,A01,083071,Bastos; Amalia Pinkusfeld,8,0,71,63
1656794416515,COGS 14A,A01,092681,Semenuks; Arturs,0,1,100,100
1656794422543,COGS 14B,A01,083073,Cheng; Tzu-Han,5,0,63,58
1656794428565,COGS 17,A01,092677,Semenuks; Arturs,4,0,81,77
1656794434592,COGS 100,A01,083619,Allen; Michael Gordon,15,0,70,55
1656794440616,COGS 101A,A01,083621,Davis; Joshua Daniel,9,0,68,59
1656794446641,COGS 101B,A01,091572,Allen; Michael Gordon,8,0,65,57
1656794452668,COGS 101C,A01,083625,Delgado; Tania,17,0,35,18
1656794458691,COGS 107A,A01,083627,Boyle; Mary E. T.,13,0,60,47
1656794464721,COGS 118A,A01,083075,Gupta; Anjum,15,0,76,61
1656794470752,CSE 3,A50,083646,Miranda; Gregory Joseph,22,0,50,28
1656794476774,CSE 8A,A50,083650,Miranda; Gregory Joseph,17,1,56,39
1656794482800,CSE 11,A01,083080,Cao; Yingjun,4,15,40,36
1656794488833,CSE 12,A01,083652,Krause-Levy; Sophia Louisa,20,1,120,100
1656794494857,CSE 15L,A01,083654,Morris; Justin Loren,8,0,50,42
1656794494857,CSE 15L,A02,083655,Morris; Justin Loren,8,0,50,42
1656794500883,CSE 20,A01,083657,Tran; Khoa Dang,37,0,80,43
1656794506906,CSE 21,A01,095574,Bach; Quang Tran,21,0,48,27
1656794512932,CSE 30,A01,083084,Eldon; John,4,0,80,76
1656794512932,CSE 30,B01,095061,Bhaskar; Nishant,5,0,50,45
1656794518955,CSE 100,A01,083659,Cao; Yingjun,1,4,70,69
1656794524990,CSE 134B,A01,083661,Powell; Thomas Allan,18,0,100,82
1656794531016,CSE 140,A01,083663,Gungor; Onat,14,0,85,71
1656794537041,CSE 140L,A01,083088,Eldon; John,16,0,100,84
1656794543064,CSE 175,A01,083665,Kumar; Rakesh,3,0,25,22
1656794549090,CSE 190,A00,092507,Dubnov; Shlomo,7,0,20,13
1656794555117,ECE 45,A01,083139,Congero; Spencer William,5,0,75,70
1656794561215,ECE 65,A50,083695,Saad; Andrew S,12,0,30,18
1656794561215,ECE 65,A51,095125,Saad; Andrew S,25,0,26,1
1656794567238,ECE 109,A01,091882,Touri; Behrouz,15,0,70,55
1656794573262,ECE 180,A00,083140,Abi Samra; Nicholas Camill,0,0,30,30
1656794573262,ECE 180,B00,083141,Abi Samra; Nicholas Camill,0,0,30,30
1656794579301,MATH 10A,A01,083735,Patchell; Gregory David,1,0,30,29
1656794579301,MATH 10A,A02,083736,Patchell; Gregory David,20,0,30,10
1656794579301,MATH 10A,A03,083737,Patchell; Gregory David,15,0,30,15
1656794585328,MATH 10B,A01,083207,Lim; Seonhee,7,0,34,27
1656794585328,MATH 10B,A02,083208,Lim; Seonhee,9,0,35,26
1656794585328,MATH 10B,A03,093472,Lim; Seonhee,4,0,34,30
1656794585328,MATH 10B,B01,083739,Sinha; Shubham,9,0,30,21
1656794591353,MATH 18,A01,083743,Cinel; Cameron Alexander,6,0,30,24
1656794591353,MATH 18,A02,083744,Cinel; Cameron Alexander,15,0,30,15
1656794591353,MATH 18,A03,083745,Cinel; Cameron Alexander,8,0,30,22
1656794591353,MATH 18,B01,083748,Rideout; David Porter,3,0,37,34
1656794591353,MATH 18,B02,083749,Rideout; David Porter,3,0,36,33
1656794591353,MATH 18,B03,083750,Rideout; David Porter,1,0,37,36
1656794591353,MATH 18,B04,083751,Rideout; David Porter,5,0,36,31
1656794591353,MATH 18,B05,093473,Rideout; David Porter,4,0,36,32
1656794591353,MATH 18,B06,093474,Rideout; David Porter,5,0,36,31
1656794597377,MATH 20A,A01,083754,Zheng; Zequn,12,0,40,28
1656794603407,MATH 20B,A01,083756,Briones; Jor-el Thomas Caparas,1,0,36,35
1656794603407,MATH 20B,A02,083757,Briones; Jor-el Thomas Caparas,1,0,36,35
1656794603407,MATH 20B,A03,093475,Briones; Jor-el Thomas Caparas,0,0,36,36
1656794609442,MATH 20C,A01,083760,Briones; Jor-el Thomas Caparas,1,0,35,34
1656794609442,MATH 20C,A02,083761,Briones; Jor-el Thomas Caparas,8,0,35,27
1656794609442,MATH 20C,A03,093476,Briones; Jor-el Thomas Caparas,0,1,36,36
1656794609442,MATH 20C,B01,083762,Bach; Quang Tran,0,0,30,30
1656794615476,MATH 20D,A01,083765,Tran; Brian Kha,4,0,30,26
1656794615476,MATH 20D,A02,083766,Tran; Brian Kha,4,0,30,26
1656794615476,MATH 20D,A03,083767,Tran; Brian Kha,2,0,30,28
1656794621501,MATH 20E,A01,083771,Ganguly; Soumya,5,0,32,27
1656794621501,MATH 20E,A02,083772,Ganguly; Soumya,5,0,32,27
1656794621501,MATH 20E,B01,083773,Ciotti; Benjamin,18,0,35,17
1656794621501,MATH 20E,B02,083774,Ciotti; Benjamin,17,0,35,18
1656794627526,MATH 103A,A01,083777,Greenfeld; Be'Eri,2,0,36,34
1656794627526,MATH 103A,A02,083778,Greenfeld; Be'Eri,5,0,36,31
1656794627526,MATH 103A,A03,093561,Greenfeld; Be'Eri,4,0,36,32
1656794627526,MATH 103A,B01,083779,Greenfeld; Be'Eri,6,0,36,30
1656794627526,MATH 103A,B02,083780,Greenfeld; Be'Eri,2,0,36,34
1656794627526,MATH 103A,B03,093562,Greenfeld; Be'Eri,2,0,36,34
1656794633559,MATH 105,A01,085443,Carter; Anne Toulson,13,0,35,22
1656794633559,MATH 105,A02,093477,Carter; Anne Toulson,20,0,35,15
1656794639590,MATH 109,A01,083213,Ganzberger; Geoffrey Michael,2,0,34,32
1656794639590,MATH 109,A02,083214,Ganzberger; Geoffrey Michael,2,0,34,32
1656794639590,MATH 109,A03,093478,Ganzberger; Geoffrey Michael,1,0,34,33
1656794639590,MATH 109,B01,083215,Ganzberger; Geoffrey Michael,1,0,32,31
1656794639590,MATH 109,B02,083216,Ganzberger; Geoffrey Michael,1,0,32,31
1656794639590,MATH 109,B03,093479,Ganzberger; Geoffrey Michael,6,0,32,26
1656794645621,MATH 142A,A01,083219,Chow; Bennett,6,0,32,26
1656794645621,MATH 142A,A02,083220,Chow; Bennett,9,0,32,23
1656794645621,MATH 142A,A03,093480,Chow; Bennett,7,0,32,25
1656794645621,MATH 142A,B03,093481,Chow; Bennett,7,0,32,25
1656794645621,MATH 142A,B04,093558,Chow; Bennett,10,0,32,22
1656794645621,MATH 142A,B05,093559,Chow; Bennett,6,0,32,26
1656794651654,MATH 193A,A01,083224,Rotar; Vladimir,6,0,34,28
1656794651654,MATH 193A,A02,083225,Rotar; Vladimir,3,0,34,31
1656794651654,MATH 193A,A03,083781,Rotar; Vladimir,1,0,34,33
1656794651654,MATH 193A,A04,083782,Rotar; Vladimir,6,0,34,28
1656794651654,MATH 193A,A05,093482,Rotar; Vladimir,6,0,34,28
1656794657678,MATH 197,001,091859,McAuley; Julian John,9999,0,9999,0
1656794657678,MATH 197,002,095566,Kedlaya; Kiran S.,9997,0,9999,2
1656794657678,MATH 197,003,095567,Xiao; Ming,9999,0,9999,0
1656794657678,MATH 197,004,095571,Perols; Johan Lars,9998,0,9999,1
1656794664741,COGS 9,A01,083615,Shannon; Kyle Michael,6,0,75,69
1656794670772,COGS 11,A01,083617,Boyle; Mary E. T.,18,0,48,30
1656794676795,COGS 13,A01,083071,Bastos; Amalia Pinkusfeld,8,0,71,63
1656794682826,COGS 14A,A01,092681,Semenuks; Arturs,0,1,100,100
1656794688849,COGS 14B,A01,083073,Cheng; Tzu-Han,5,0,63,58
1656794694873,COGS 17,A01,092677,Semenuks; Arturs,4,0,81,77
1656794700899,COGS 100,A01,083619,Allen; Michael Gordon,15,0,70,55
1656794706927,COGS 101A,A01,083621,Davis; Joshua Daniel,9,0,68,59
1656794712952,COGS 101B,A01,091572,Allen; Michael Gordon,8,0,65,57
1656794718984,COGS 101C,A01,083625,Delgado; Tania,17,0,35,18
1656794725010,COGS 107A,A01,083627,Boyle; Mary E. T.,13,0,60,47
1656794731033,COGS 118A,A01,083075,Gupta; Anjum,15,0,76,61
1656794737060,CSE 3,A50,083646,Miranda; Gregory Joseph,22,0,50,28
1656794743083,CSE 8A,A50,083650,Miranda; Gregory Joseph,17,1,56,39
1656794749112,CSE 11,A01,083080,Cao; Yingjun,4,15,40,36
1656794755137,CSE 12,A01,083652,Krause-Levy; Sophia Louisa,20,1,120,100
1656794761166,CSE 15L,A01,083654,Morris; Justin Loren,8,0,50,42
1656794761166,CSE 15L,A02,083655,Morris; Justin Loren,8,0,50,42
1656794767190,CSE 20,A01,083657,Tran; Khoa Dang,37,0,80,43
1656794773219,CSE 21,A01,095574,Bach; Quang Tran,21,0,48,27
1656794779244,CSE 30,A01,083084,Eldon; John,4,0,80,76
1656794779244,CSE 30,B01,095061,Bhaskar; Nishant,5,0,50,45
1656794785268,CSE 100,A01,083659,Cao; Yingjun,1,4,70,69
1656794791291,CSE 134B,A01,083661,Powell; Thomas Allan,18,0,100,82
1656794797316,CSE 140,A01,083663,Gungor; Onat,14,0,85,71
1656794803338,CSE 140L,A01,083088,Eldon; John,16,0,100,84
1656794809363,CSE 175,A01,083665,Kumar; Rakesh,3,0,25,22
1656794815389,CSE 190,A00,092507,Dubnov; Shlomo,7,0,20,13
1656794821427,ECE 45,A01,083139,Congero; Spencer William,5,0,75,70
1656794827457,ECE 65,A50,083695,Saad; Andrew S,12,0,30,18
1656794827457,ECE 65,A51,095125,Saad; Andrew S,25,0,26,1
1656794833481,ECE 109,A01,091882,Touri; Behrouz,15,0,70,55
1656794839506,ECE 180,A00,083140,Abi Samra; Nicholas Camill,0,0,30,30
1656794839506,ECE 180,B00,083141,Abi Samra; Nicholas Camill,0,0,30,30
1656794845536,MATH 10A,A01,083735,Patchell; Gregory David,1,0,30,29
1656794845536,MATH 10A,A02,083736,Patchell; Gregory David,20,0,30,10
1656794845536,MATH 10A,A03,083737,Patchell; Gregory David,15,0,30,15
1656794851563,MATH 10B,A01,083207,Lim; Seonhee,7,0,34,27
1656794851563,MATH 10B,A02,083208,Lim; Seonhee,9,0,35,26
1656794851563,MATH 10B,A03,093472,Lim; Seonhee,4,0,34,30
1656794851563,MATH 10B,B01,083739,Sinha; Shubham,9,0,30,21
1656794857587,MATH 18,A01,083743,Cinel; Cameron Alexander,6,0,30,24
1656794857587,MATH 18,A02,083744,Cinel; Cameron Alexander,15,0,30,15
1656794857587,MATH 18,A03,083745,Cinel; Cameron Alexander,8,0,30,22
1656794857587,MATH 18,B01,083748,Rideout; David Porter,3,0,37,34
1656794857587,MATH 18,B02,083749,Rideout; David Porter,3,0,36,33
1656794857587,MATH 18,B03,083750,Rideout; David Porter,1,0,37,36
1656794857587,MATH 18,B04,083751,Rideout; David Porter,5,0,36,31
1656794857587,MATH 18,B05,093473,Rideout; David Porter,4,0,36,32
1656794857587,MATH 18,B06,093474,Rideout; David Porter,5,0,36,31
1656794863617,MATH 20A,A01,083754,Zheng; Zequn,12,0,40,28
1656794869644,MATH 20B,A01,083756,Briones; Jor-el Thomas Caparas,1,0,36,35
1656794869644,MATH 20B,A02,083757,Briones; Jor-el Thomas Caparas,1,0,36,35
1656794869644,MATH 20B,A03,093475,Briones; Jor-el Thomas Caparas,0,0,36,36
1656794875675,MATH 20C,A01,083760,Briones; Jor-el Thomas Caparas,1,0,35,34
1656794875675,MATH 20C,A02,083761,Briones; Jor-el Thomas Caparas,8,0,35,27
1656794875675,MATH 20C,A03,093476,Briones; Jor-el Thomas Caparas,0,1,36,36
1656794875675,MATH 20C,B01,083762,Bach; Quang Tran,0,0,30,30
1656794881703,MATH 20D,A01,083765,Tran; Brian Kha,4,0,30,26
1656794881703,MATH 20D,A02,083766,Tran; Brian Kha,4,0,30,26
1656794881703,MATH 20D,A03,083767,Tran; Brian Kha,2,0,30,28
1656794887727,MATH 20E,A01,083771,Ganguly; Soumya,5,0,32,27
1656794887727,MATH 20E,A02,083772,Ganguly; Soumya,5,0,32,27
1656794887727,MATH 20E,B01,083773,Ciotti; Benjamin,18,0,35,17
1656794887727,MATH 20E,B02,083774,Ciotti; Benjamin,17,0,35,18
1656794893748,MATH 103A,A01,083777,Greenfeld; Be'Eri,2,0,36,34
1656794893748,MATH 103A,A02,083778,Greenfeld; Be'Eri,5,0,36,31
1656794893748,MATH 103A,A03,093561,Greenfeld; Be'Eri,4,0,36,32
1656794893748,MATH 103A,B01,083779,Greenfeld; Be'Eri,6,0,36,30
1656794893748,MATH 103A,B02,083780,Greenfeld; Be'Eri,2,0,36,34
1656794893748,MATH 103A,B03,093562,Greenfeld; Be'Eri,2,0,36,34
1656794899773,MATH 105,A01,085443,Carter; Anne Toulson,13,0,35,22
1656794899773,MATH 105,A02,093477,Carter; Anne Toulson,20,0,35,15
1656794905797,MATH 109,A01,083213,Ganzberger; Geoffrey Michael,2,0,34,32
1656794905797,MATH 109,A02,083214,Ganzberger; Geoffrey Michael,2,0,34,32
1656794905797,MATH 109,A03,093478,Ganzberger; Geoffrey Michael,1,0,34,33
1656794905797,MATH 109,B01,083215,Ganzberger; Geoffrey Michael,1,0,32,31
1656794905797,MATH 109,B02,083216,Ganzberger; Geoffrey Michael,1,0,32,31
1656794905797,MATH 109,B03,093479,Ganzberger; Geoffrey Michael,6,0,32,26
1656794911830,MATH 142A,A01,083219,Chow; Bennett,6,0,32,26
1656794911830,MATH 142A,A02,083220,Chow; Bennett,9,0,32,23
1656794911830,MATH 142A,A03,093480,Chow; Bennett,7,0,32,25
1656794911830,MATH 142A,B03,093481,Chow; Bennett,7,0,32,25
1656794911830,MATH 142A,B04,093558,Chow; Bennett,10,0,32,22
1656794911830,MATH 142A,B05,093559,Chow; Bennett,6,0,32,26
1656794917853,MATH 193A,A01,083224,Rotar; Vladimir,6,0,34,28
1656794917853,MATH 193A,A02,083225,Rotar; Vladimir,3,0,34,31
1656794917853,MATH 193A,A03,083781,Rotar; Vladimir,1,0,34,33
1656794917853,MATH 193A,A04,083782,Rotar; Vladimir,6,0,34,28
1656794917853,MATH 193A,A05,093482,Rotar; Vladimir,6,0,34,28
1656794923880,MATH 197,001,091859,McAuley; Julian John,9999,0,9999,0
1656794923880,MATH 197,002,095566,Kedlaya; Kiran S.,9997,0,9999,2
1656794923880,MATH 197,003,095567,Xiao; Ming,9999,0,9999,0
1656794923880,MATH 197,004,095571,Perols; Johan Lars,9998,0,9999,1
1656794930939,COGS 9,A01,083615,Shannon; Kyle Michael,6,0,75,69
1656794936962,COGS 11,A01,083617,Boyle; Mary E. T.,18,0,48,30
1656794942993,COGS 13,A01,083071,Bastos; Amalia Pinkusfeld,8,0,71,63
1656794949021,COGS 14A,A01,092681,Semenuks; Arturs,0,1,100,100
1656794955045,COGS 14B,A01,083073,Cheng; Tzu-Han,5,0,63,58
1656794961067,COGS 17,A01,092677,Semenuks; Arturs,4,0,81,77
1656794967090,COGS 100,A01,083619,Allen; Michael Gordon,15,0,70,55
1656794973117,COGS 101A,A01,083621,Davis; Joshua Daniel,9,0,68,59
1656794979145,COGS 101B,A01,091572,Allen; Michael Gordon,8,0,65,57
1656794985168,COGS 101C,A01,083625,Delgado; Tania,17,0,35,18
1656794991194,COGS 107A,A01,083627,Boyle; Mary E. T.,13,0,60,47
1656794997223,COGS 118A,A01,083075,Gupta; Anjum,15,0,76,61
1656795003247,CSE 3,A50,083646,Miranda; Gregory Joseph,22,0,50,28
1656795009271,CSE 8A,A50,083650,Miranda; Gregory Joseph,17,1,56,39
1656795015295,CSE 11,A01,083080,Cao; Yingjun,4,15,40,36
1656795021323,CSE 12,A01,083652,Krause-Levy; Sophia Louisa,20,1,120,100
1656795027356,CSE 15L,A01,083654,Morris; Justin Loren,8,0,50,42
1656795027356,CSE 15L,A02,083655,Morris; Justin Loren,8,0,50,42
1656795033379,CSE 20,A01,083657,Tran; Khoa Dang,37,0,80,43
1656795039402,CSE 21,A01,095574,Bach; Quang Tran,21,0,48,27
1656795045431,CSE 30,A01,083084,Eldon; John,4,0,80,76
1656795045431,CSE 30,B01,095061,Bhaskar; Nishant,5,0,50,45
1656795051463,CSE 100,A01,083659,Cao; Yingjun,1,4,70,69
1656795057487,CSE 134B,A01,083661,Powell; Thomas Allan,18,0,100,82
1656795063516,CSE 140,A01,083663,Gungor; Onat,14,0,85,71
1656795069541,CSE 140L,A01,083088,Eldon; John,16,0,100,84
1656795075565,CSE 175,A01,083665,Kumar; Rakesh,3,0,25,22
1656795081589,CSE 190,A00,092507,Dubnov; Shlomo,7,0,20,13
1656795087614,ECE 45,A01,083139,Congero; Spencer William,5,0,75,70
1656795093640,ECE 65,A50,083695,Saad; Andrew S,12,0,30,18
1656795093640,ECE 65,A51,095125,Saad; Andrew S,25,0,26,1
1656795099672,ECE 109,A01,091882,Touri; Behrouz,15,0,70,55
1656795105697,ECE 180,A00,083140,Abi Samra; Nicholas Camill,0,0,30,30
1656795105697,ECE 180,B00,083141,Abi Samra; Nicholas Camill,0,0,30,30
1656795111729,MATH 10A,A01,083735,Patchell; Gregory David,1,0,30,29
1656795111729,MATH 10A,A02,083736,Patchell; Gregory David,20,0,30,10
1656795111729,MATH 10A,A03,083737,Patchell; Gregory David,15,0,30,15
1656795117756,MATH 10B,A01,083207,Lim; Seonhee,7,0,34,27
1656795117756,MATH 10B,A02,083208,Lim; Seonhee,9,0,35,26
1656795117756,MATH 10B,A03,093472,Lim; Seonhee,4,0,34,30
1656795117756,MATH 10B,B01,083739,Sinha; Shubham,9,0,30,21
1656795123782,MATH 18,A01,083743,Cinel; Cameron Alexander,6,0,30,24
1656795123782,MATH 18,A02,083744,Cinel; Cameron Alexander,15,0,30,15
1656795123782,MATH 18,A03,083745,Cinel; Cameron Alexander,8,0,30,22
1656795123782,MATH 18,B01,083748,Rideout; David Porter,3,0,37,34
1656795123782,MATH 18,B02,083749,Rideout; David Porter,3,0,36,33
1656795123782,MATH 18,B03,083750,Rideout; David Porter,1,0,37,36
1656795123782,MATH 18,B04,083751,Rideout; David Porter,5,0,36,31
1656795123782,MATH 18,B05,093473,Rideout; David Porter,4,0,36,32
1656795123782,MATH 18,B06,093474,Rideout; David Porter,5,0,36,31
1656795129807,MATH 20A,A01,083754,Zheng; Zequn,12,0,40,28
1656795135836,MATH 20B,A01,083756,Briones; Jor-el Thomas Caparas,1,0,36,35
1656795135836,MATH 20B,A02,083757,Briones; Jor-el Thomas Caparas,1,0,36,35
1656795135836,MATH 20B,A03,093475,Briones; Jor-el Thomas Caparas,0,0,36,36
1656795141865,MATH 20C,A01,083760,Briones; Jor-el Thomas Caparas,1,0,35,34
1656795141865,MATH 20C,A02,083761,Briones; Jor-el Thomas Caparas,8,0,35,27
1656795141865,MATH 20C,A03,093476,Briones; Jor-el Thomas Caparas,0,1,36,36
1656795141865,MATH 20C,B01,083762,Bach; Quang Tran,0,0,30,30
1656795147894,MATH 20D,A01,083765,Tran; Brian Kha,4,0,30,26
1656795147894,MATH 20D,A02,083766,Tran; Brian Kha,4,0,30,26
1656795147894,MATH 20D,A03,083767,Tran; Brian Kha,2,0,30,28
1656795153924,MATH 20E,A01,083771,Ganguly; Soumya,5,0,32,27
1656795153924,MATH 20E,A02,083772,Ganguly; Soumya,5,0,32,27
1656795153924,MATH 20E,B01,083773,Ciotti; Benjamin,18,0,35,17
1656795153924,MATH 20E,B02,083774,Ciotti; Benjamin,17,0,35,18
1656795160049,MATH 103A,A01,083777,Greenfeld; Be'Eri,2,0,36,34
1656795160049,MATH 103A,A02,083778,Greenfeld; Be'Eri,5,0,36,31
1656795160049,MATH 103A,A03,093561,Greenfeld; Be'Eri,4,0,36,32
1656795160049,MATH 103A,B01,083779,Greenfeld; Be'Eri,6,0,36,30
1656795160049,MATH 103A,B02,083780,Greenfeld; Be'Eri,2,0,36,34
1656795160049,MATH 103A,B03,093562,Greenfeld; Be'Eri,2,0,36,34
1656795166073,MATH 105,A01,085443,Carter; Anne Toulson,13,0,35,22
1656795166073,MATH 105,A02,093477,Carter; Anne Toulson,20,0,35,15
1656795172103,MATH 109,A01,083213,Ganzberger; Geoffrey Michael,2,0,34,32
1656795172103,MATH 109,A02,083214,Ganzberger; Geoffrey Michael,2,0,34,32
1656795172103,MATH 109,A03,093478,Ganzberger; Geoffrey Michael,1,0,34,33
1656795172103,MATH 109,B01,083215,Ganzberger; Geoffrey Michael,1,0,32,31
1656795172103,MATH 109,B02,083216,Ganzberger; Geoffrey Michael,1,0,32,31
1656795172103,MATH 109,B03,093479,Ganzberger; Geoffrey Michael,6,0,32,26
1656795178134,MATH 142A,A01,083219,Chow; Bennett,6,0,32,26
1656795178134,MATH 142A,A02,083220,Chow; Bennett,9,0,32,23
1656795178134,MATH 142A,A03,093480,Chow; Bennett,7,0,32,25
1656795178134,MATH 142A,B03,093481,Chow; Bennett,7,0,32,25
1656795178134,MATH 142A,B04,093558,Chow; Bennett,10,0,32,22
1656795178134,MATH 142A,B05,093559,Chow; Bennett,6,0,32,26
1656795184165,MATH 193A,A01,083224,Rotar; Vladimir,6,0,34,28
1656795184165,MATH 193A,A02,083225,Rotar; Vladimir,3,0,34,31
1656795184165,MATH 193A,A03,083781,Rotar; Vladimir,1,0,34,33
1656795184165,MATH 193A,A04,083782,Rotar; Vladimir,6,0,34,28
1656795184165,MATH 193A,A05,093482,Rotar; Vladimir,6,0,34,28
1656795190191,MATH 197,001,091859,McAuley; Julian John,9999,0,9999,0
1656795190191,MATH 197,002,095566,Kedlaya; Kiran S.,9997,0,9999,2
1656795190191,MATH 197,003,095567,Xiao; Ming,9999,0,9999,0
1656795190191,MATH 197,004,095571,Perols; Johan Lars,9998,0,9999,1
1656795197249,COGS 9,A01,083615,Shannon; Kyle Michael,6,0,75,69
1656795203274,COGS 11,A01,083617,Boyle; Mary E. T.,18,0,48,30
1656795209302,COGS 13,A01,083071,Bastos; Amalia Pinkusfeld,8,0,71,63
1656795215330,COGS 14A,A01,092681,Semenuks; Arturs,0,1,100,100
1656795221360,COGS 14B,A01,083073,Cheng; Tzu-Han,5,0,63,58
1656795227382,COGS 17,A01,092677,Semenuks; Arturs,4,0,81,77
1656795233407,COGS 100,A01,083619,Allen; Michael Gordon,15,0,70,55
1656795239431,COGS 101A,A01,083621,Davis; Joshua Daniel,9,0,68,59
1656795245456,COGS 101B,A01,091572,Allen; Michael Gordon,8,0,65,57
1656795251485,COGS 101C,A01,083625,Delgado; Tania,17,0,35,18
1656795257508,COGS 107A,A01,083627,Boyle; Mary E. T.,13,0,60,47
1656795263533,COGS 118A,A01,083075,Gupta; Anjum,15,0,76,61
1656795269564,CSE 3,A50,083646,Miranda; Gregory Joseph,22,0,50,28
1656795275592,CSE 8A,A50,083650,Miranda; Gregory Joseph,17,1,56,39
1656795281622,CSE 11,A01,083080,Cao; Yingjun,4,15,40,36
1656795287646,CSE 12,A01,083652,Krause-Levy; Sophia Louisa,20,1,120,100
1656795293674,CSE 15L,A01,083654,Morris; Justin Loren,8,0,50,42
1656795293674,CSE 15L,A02,083655,Morris; Justin Loren,8,0,50,42
1656795299700,CSE 20,A01,083657,Tran; Khoa Dang,37,0,80,43
1656795305724,CSE 21,A01,095574,Bach; Quang Tran,21,0,48,27
1656795311754,CSE 30,A01,083084,Eldon; John,4,0,80,76
1656795311754,CSE 30,B01,095061,Bhaskar; Nishant,5,0,50,45
1656795317783,CSE 100,A01,083659,Cao; Yingjun,1,4,70,69
1656795323811,CSE 134B,A01,083661,Powell; Thomas Allan,18,0,100,82
1656795329835,CSE 140,A01,083663,Gungor; Onat,14,0,85,71
1656795335862,CSE 140L,A01,083088,Eldon; John,16,0,100,84
1656795341886,CSE 175,A01,083665,Kumar; Rakesh,3,0,25,22
1656795347911,CSE 190,A00,092507,Dubnov; Shlomo,7,0,20,13
1656795353941,ECE 45,A01,083139,Congero; Spencer William,5,0,75,70
1656795359970,ECE 65,A50,083695,Saad; Andrew S,12,0,30,18
1656795359970,ECE 65,A51,095125,Saad; Andrew S,25,0,26,1
1656795365996,ECE 109,A01,091882,Touri; Behrouz,15,0,70,55
1656795372022,ECE 180,A00,083140,Abi Samra; Nicholas Camill,0,0,30,30
1656795372022,ECE 180,B00,083141,Abi Samra; Nicholas Camill,0,0,30,30
1656795378049,MATH 10A,A01,083735,Patchell; Gregory David,1,0,30,29
1656795378049,MATH 10A,A02,083736,Patchell; Gregory David,20,0,30,10
1656795378049,MATH 10A,A03,083737,Patchell; Gregory David,15,0,30,15
1656795384073,MATH 10B,A01,083207,Lim; Seonhee,7,0,34,27
1656795384073,MATH 10B,A02,083208,Lim; Seonhee,9,0,35,26
1656795384073,MATH 10B,A03,093472,Lim; Seonhee,4,0,34,30
1656795384073,MATH 10B,B01,083739,Sinha; Shubham,9,0,30,21
1656795390106,MATH 18,A01,083743,Cinel; Cameron Alexander,6,0,30,24
1656795390106,MATH 18,A02,083744,Cinel; Cameron Alexander,15,0,30,15
1656795390106,MATH 18,A03,083745,Cinel; Cameron Alexander,8,0,30,22
1656795390106,MATH 18,B01,083748,Rideout; David Porter,3,0,37,34
1656795390106,MATH 18,B02,083749,Rideout; David Porter,3,0,36,33
1656795390106,MATH 18,B03,083750,Rideout; David Porter,1,0,37,36
1656795390106,MATH 18,B04,083751,Rideout; David Porter,5,0,36,31
1656795390106,MATH 18,B05,093473,Rideout; David Porter,4,0,36,32
1656795390106,MATH 18,B06,093474,Rideout; David Porter,5,0,36,31
1656795396132,MATH 20A,A01,083754,Zheng; Zequn,12,0,40,28
1656795402160,MATH 20B,A01,083756,Briones; Jor-el Thomas Caparas,1,0,36,35
1656795402160,MATH 20B,A02,083757,Briones; Jor-el Thomas Caparas,1,0,36,35
1656795402160,MATH 20B,A03,093475,Briones; Jor-el Thomas Caparas,0,0,36,36
1656795408186,MATH 20C,A01,083760,Briones; Jor-el Thomas Caparas,1,0,35,34
1656795408186,MATH 20C,A02,083761,Briones; Jor-el Thomas Caparas,8,0,35,27
1656795408186,MATH 20C,A03,093476,Briones; Jor-el Thomas Caparas,0,1,36,36
1656795408186,MATH 20C,B01,083762,Bach; Quang Tran,0,0,30,30
1656795414215,MATH 20D,A01,083765,Tran; Brian Kha,4,0,30,26
1656795414215,MATH 20D,A02,083766,Tran; Brian Kha,4,0,30,26
1656795414215,MATH 20D,A03,083767,Tran; Brian Kha,2,0,30,28
1656795420248,MATH 20E,A01,083771,Ganguly; Soumya,5,0,32,27
1656795420248,MATH 20E,A02,083772,Ganguly; Soumya,5,0,32,27
1656795420248,MATH 20E,B01,083773,Ciotti; Benjamin,18,0,35,17
1656795420248,MATH 20E,B02,083774,Ciotti; Benjamin,17,0,35,18
1656795426284,MATH 103A,A01,083777,Greenfeld; Be'Eri,2,0,36,34
1656795426284,MATH 103A,A02,083778,Greenfeld; Be'Eri,5,0,36,31
1656795426284,MATH 103A,A03,093561,Greenfeld; Be'Eri,4,0,36,32
1656795426284,MATH 103A,B01,083779,Greenfeld; Be'Eri,6,0,36,30
1656795426284,MATH 103A,B02,083780,Greenfeld; Be'Eri,2,0,36,34
1656795426284,MATH 103A,B03,093562,Greenfeld; Be'Eri,2,0,36,34
1656795432309,MATH 105,A01,085443,Carter; Anne Toulson,13,0,35,22
1656795432309,MATH 105,A02,093477,Carter; Anne Toulson,20,0,35,15
1656795438334,MATH 109,A01,083213,Ganzberger; Geoffrey Michael,2,0,34,32
1656795438334,MATH 109,A02,083214,Ganzberger; Geoffrey Michael,2,0,34,32
1656795438334,MATH 109,A03,093478,Ganzberger; Geoffrey Michael,1,0,34,33
1656795438334,MATH 109,B01,083215,Ganzberger; Geoffrey Michael,1,0,32,31
1656795438334,MATH 109,B02,083216,Ganzberger; Geoffrey Michael,1,0,32,31
1656795438334,MATH 109,B03,093479,Ganzberger; Geoffrey Michael,6,0,32,26
1656795444365,MATH 142A,A01,083219,Chow; Bennett,6,0,32,26
1656795444365,MATH 142A,A02,083220,Chow; Bennett,9,0,32,23
1656795444365,MATH 142A,A03,093480,Chow; Bennett,7,0,32,25
1656795444365,MATH 142A,B03,093481,Chow; Bennett,7,0,32,25
1656795444365,MATH 142A,B04,093558,Chow; Bennett,10,0,32,22
1656795444365,MATH 142A,B05,093559,Chow; Bennett,6,0,32,26
1656795450389,MATH 193A,A01,083224,Rotar; Vladimir,6,0,34,28
1656795450389,MATH 193A,A02,083225,Rotar; Vladimir,3,0,34,31
1656795450389,MATH 193A,A03,083781,Rotar; Vladimir,1,0,34,33
1656795450389,MATH 193A,A04,083782,Rotar; Vladimir,6,0,34,28
1656795450389,MATH 193A,A05,093482,Rotar; Vladimir,6,0,34,28
1656795456418,MATH 197,001,091859,McAuley; Julian John,9999,0,9999,0
1656795456418,MATH 197,002,095566,Kedlaya; Kiran S.,9997,0,9999,2
1656795456418,MATH 197,003,095567,Xiao; Ming,9999,0,9999,0
1656795456418,MATH 197,004,095571,Perols; Johan Lars,9998,0,9999,1
1656795463478,COGS 9,A01,083615,Shannon; Kyle Michael,6,0,75,69
1656795469501,COGS 11,A01,083617,Boyle; Mary E. T.,18,0,48,30
1656795475524,COGS 13,A01,083071,Bastos; Amalia Pinkusfeld,8,0,71,63
1656795481553,COGS 14A,A01,092681,Semenuks; Arturs,0,1,100,100
1656795487579,COGS 14B,A01,083073,Cheng; Tzu-Han,5,0,63,58
1656795493605,COGS 17,A01,092677,Semenuks; Arturs,4,0,81,77
1656795499632,COGS 100,A01,083619,Allen; Michael Gordon,15,0,70,55
1656795505658,COGS 101A,A01,083621,Davis; Joshua Daniel,9,0,68,59
1656795511685,COGS 101B,A01,091572,Allen; Michael Gordon,8,0,65,57
1656795517707,COGS 101C,A01,083625,Delgado; Tania,17,0,35,18
1656795523732,COGS 107A,A01,083627,Boyle; Mary E. T.,13,0,60,47
1656795529756,COGS 118A,A01,083075,Gupta; Anjum,15,0,76,61
1656795535780,CSE 3,A50,083646,Miranda; Gregory Joseph,22,0,50,28
1656795541803,CSE 8A,A50,083650,Miranda; Gregory Joseph,17,1,56,39
1656795547825,CSE 11,A01,083080,Cao; Yingjun,4,15,40,36
1656795553851,CSE 12,A01,083652,Krause-Levy; Sophia Louisa,20,1,120,100
1656795559875,CSE 15L,A01,083654,Morris; Justin Loren,8,0,50,42
1656795559875,CSE 15L,A02,083655,Morris; Justin Loren,8,0,50,42
1656795565904,CSE 20,A01,083657,Tran; Khoa Dang,37,0,80,43
1656795571928,CSE 21,A01,095574,Bach; Quang Tran,21,0,48,27
1656795577956,CSE 30,A01,083084,Eldon; John,4,0,80,76
1656795577956,CSE 30,B01,095061,Bhaskar; Nishant,5,0,50,45
1656795583981,CSE 100,A01,083659,Cao; Yingjun,1,4,70,69
1656795590009,CSE 134B,A01,083661,Powell; Thomas Allan,18,0,100,82
1656795596033,CSE 140,A01,083663,Gungor; Onat,14,0,85,71
1656795602058,CSE 140L,A01,083088,Eldon; John,16,0,100,84
1656795608094,CSE 175,A01,083665,Kumar; Rakesh,3,0,25,22
1656795614118,CSE 190,A00,092507,Dubnov; Shlomo,7,0,20,13
1656795620145,ECE 45,A01,083139,Congero; Spencer William,5,0,75,70
1656795626170,ECE 65,A50,083695,Saad; Andrew S,12,0,30,18
1656795626170,ECE 65,A51,095125,Saad; Andrew S,25,0,26,1
1656795632194,ECE 109,A01,091882,Touri; Behrouz,15,0,70,55
1656795638222,ECE 180,A00,083140,Abi Samra; Nicholas Camill,0,0,30,30
1656795638222,ECE 180,B00,083141,Abi Samra; Nicholas Camill,0,0,30,30
1656795644246,MATH 10A,A01,083735,Patchell; Gregory David,1,0,30,29
1656795644246,MATH 10A,A02,083736,Patchell; Gregory David,20,0,30,10
1656795644246,MATH 10A,A03,083737,Patchell; Gregory David,15,0,30,15
1656795650270,MATH 10B,A01,083207,Lim; Seonhee,7,0,34,27
1656795650270,MATH 10B,A02,083208,Lim; Seonhee,9,0,35,26
1656795650270,MATH 10B,A03,093472,Lim; Seonhee,4,0,34,30
1656795650270,MATH 10B,B01,083739,Sinha; Shubham,9,0,30,21
1656795656304,MATH 18,A01,083743,Cinel; Cameron Alexander,6,0,30,24
1656795656304,MATH 18,A02,083744,Cinel; Cameron Alexander,15,0,30,15
1656795656304,MATH 18,A03,083745,Cinel; Cameron Alexander,8,0,30,22
1656795656304,MATH 18,B01,083748,Rideout; David Porter,3,0,37,34
1656795656304,MATH 18,B02,083749,Rideout; David Porter,3,0,36,33
1656795656304,MATH 18,B03,083750,Rideout; David Porter,1,0,37,36
1656795656304,MATH 18,B04,083751,Rideout; David Porter,5,0,36,31
1656795656304,MATH 18,B05,093473,Rideout; David Porter,4,0,36,32
1656795656304,MATH 18,B06,093474,Rideout; David Porter,5,0,36,31
1656795662334,MATH 20A,A01,083754,Zheng; Zequn,12,0,40,28
1656795668358,MATH 20B,A01,083756,Briones; Jor-el Thomas Caparas,1,0,36,35
1656795668358,MATH 20B,A02,083757,Briones; Jor-el Thomas Caparas,1,0,36,35
1656795668358,MATH 20B,A03,093475,Briones; Jor-el Thomas Caparas,0,0,36,36
1656795674389,MATH 20C,A01,083760,Briones; Jor-el Thomas Caparas,1,0,35,34
1656795674389,MATH 20C,A02,083761,Briones; Jor-el Thomas Caparas,8,0,35,27
1656795674389,MATH 20C,A03,093476,Briones; Jor-el Thomas Caparas,0,1,36,36
1656795674389,MATH 20C,B01,083762,Bach; Quang Tran,0,0,30,30
1656795680414,MATH 20D,A01,083765,Tran; Brian Kha,4,0,30,26
1656795680414,MATH 20D,A02,083766,Tran; Brian Kha,4,0,30,26
1656795680414,MATH 20D,A03,083767,Tran; Brian Kha,2,0,30,28
1656795686439,MATH 20E,A01,083771,Ganguly; Soumya,5,0,32,27
1656795686439,MATH 20E,A02,083772,Ganguly; Soumya,5,0,32,27
1656795686439,MATH 20E,B01,083773,Ciotti; Benjamin,18,0,35,17
1656795686439,MATH 20E,B02,083774,Ciotti; Benjamin,17,0,35,18
1656795692471,MATH 103A,A01,083777,Greenfeld; Be'Eri,2,0,36,34
1656795692471,MATH 103A,A02,083778,Greenfeld; Be'Eri,5,0,36,31
1656795692471,MATH 103A,A03,093561,Greenfeld; Be'Eri,4,0,36,32
1656795692471,MATH 103A,B01,083779,Greenfeld; Be'Eri,6,0,36,30
1656795692471,MATH 103A,B02,083780,Greenfeld; Be'Eri,2,0,36,34
1656795692471,MATH 103A,B03,093562,Greenfeld; Be'Eri,2,0,36,34
1656795698493,MATH 105,A01,085443,Carter; Anne Toulson,13,0,35,22
1656795698493,MATH 105,A02,093477,Carter; Anne Toulson,20,0,35,15
1656795704520,MATH 109,A01,083213,Ganzberger; Geoffrey Michael,2,0,34,32
1656795704520,MATH 109,A02,083214,Ganzberger; Geoffrey Michael,2,0,34,32
1656795704520,MATH 109,A03,093478,Ganzberger; Geoffrey Michael,1,0,34,33
1656795704520,MATH 109,B01,083215,Ganzberger; Geoffrey Michael,1,0,32,31
1656795704520,MATH 109,B02,083216,Ganzberger; Geoffrey Michael,1,0,32,31
1656795704520,MATH 109,B03,093479,Ganzberger; Geoffrey Michael,6,0,32,26
1656795710552,MATH 142A,A01,083219,Chow; Bennett,6,0,32,26
1656795710552,MATH 142A,A02,083220,Chow; Bennett,9,0,32,23
1656795710552,MATH 142A,A03,093480,Chow; Bennett,7,0,32,25
1656795710552,MATH 142A,B03,093481,Chow; Bennett,7,0,32,25
1656795710552,MATH 142A,B04,093558,Chow; Bennett,10,0,32,22
1656795710552,MATH 142A,B05,093559,Chow; Bennett,6,0,32,26
1656795716581,MATH 193A,A01,083224,Rotar; Vladimir,6,0,34,28
1656795716581,MATH 193A,A02,083225,Rotar; Vladimir,3,0,34,31
1656795716581,MATH 193A,A03,083781,Rotar; Vladimir,1,0,34,33
1656795716581,MATH 193A,A04,083782,Rotar; Vladimir,6,0,34,28
1656795716581,MATH 193A,A05,093482,Rotar; Vladimir,6,0,34,28
1656795722607,MATH 197,001,091859,McAuley; Julian John,9999,0,9999,0
1656795722607,MATH 197,002,095566,Kedlaya; Kiran S.,9997,0,9999,2
1656795722607,MATH 197,003,095567,Xiao; Ming,9999,0,9999,0
1656795722607,MATH 197,004,095571,Perols; Johan Lars,9998,0,9999,1
1656795729674,COGS 9,A01,083615,Shannon; Kyle Michael,6,0,75,69
1656795735704,COGS 11,A01,083617,Boyle; Mary E. T.,18,0,48,30
1656795741727,COGS 13,A01,083071,Bastos; Amalia Pinkusfeld,8,0,71,63
1656795747760,COGS 14A,A01,092681,Semenuks; Arturs,0,1,100,100
1656795753860,COGS 14B,A01,083073,Cheng; Tzu-Han,5,0,63,58
1656795759888,COGS 17,A01,092677,Semenuks; Arturs,4,0,81,77
1656795765913,COGS 100,A01,083619,Allen; Michael Gordon,15,0,70,55
1656795771941,COGS 101A,A01,083621,Davis; Joshua Daniel,9,0,68,59
1656795777966,COGS 101B,A01,091572,Allen; Michael Gordon,8,0,65,57
1656795783989,COGS 101C,A01,083625,Delgado; Tania,17,0,35,18
1656795790015,COGS 107A,A01,083627,Boyle; Mary E. T.,13,0,60,47
1656795796038,COGS 118A,A01,083075,Gupta; Anjum,15,0,76,61
1656795802063,CSE 3,A50,083646,Miranda; Gregory Joseph,22,0,50,28
1656795808087,CSE 8A,A50,083650,Miranda; Gregory Joseph,17,1,56,39
1656795814110,CSE 11,A01,083080,Cao; Yingjun,4,15,40,36
1656795820139,CSE 12,A01,083652,Krause-Levy; Sophia Louisa,20,1,120,100
1656795826161,CSE 15L,A01,083654,Morris; Justin Loren,8,0,50,42
1656795826161,CSE 15L,A02,083655,Morris; Justin Loren,8,0,50,42
1656795832185,CSE 20,A01,083657,Tran; Khoa Dang,37,0,80,43
1656795838209,CSE 21,A01,095574,Bach; Quang Tran,21,0,48,27
1656795844238,CSE 30,A01,083084,Eldon; John,4,0,80,76
1656795844238,CSE 30,B01,095061,Bhaskar; Nishant,5,0,50,45
1656795850266,CSE 100,A01,083659,Cao; Yingjun,1,4,70,69
1656795856291,CSE 134B,A01,083661,Powell; Thomas Allan,18,0,100,82
1656795862319,CSE 140,A01,083663,Gungor; Onat,14,0,85,71
1656795868345,CSE 140L,A01,083088,Eldon; John,16,0,100,84
1656795874372,CSE 175,A01,083665,Kumar; Rakesh,3,0,25,22
1656795880395,CSE 190,A00,092507,Dubnov; Shlomo,7,0,20,13
1656795886417,ECE 45,A01,083139,Congero; Spencer William,5,0,75,70
1656795892447,ECE 65,A50,083695,Saad; Andrew S,12,0,30,18
1656795892447,ECE 65,A51,095125,Saad; Andrew S,25,0,26,1
1656795898472,ECE 109,A01,091882,Touri; Behrouz,15,0,70,55
1656795904499,ECE 180,A00,083140,Abi Samra; Nicholas Camill,0,0,30,30
1656795904499,ECE 180,B00,083141,Abi Samra; Nicholas Camill,0,0,30,30
1656795910524,MATH 10A,A01,083735,Patchell; Gregory David,1,0,30,29
1656795910524,MATH 10A,A02,083736,Patchell; Gregory David,20,0,30,10
1656795910524,MATH 10A,A03,083737,Patchell; Gregory David,15,0,30,15
1656795916563,MATH 10B,A01,083207,Lim; Seonhee,7,0,34,27
1656795916563,MATH 10B,A02,083208,Lim; Seonhee,9,0,35,26
1656795916563,MATH 10B,A03,093472,Lim; Seonhee,4,0,34,30
1656795916563,MATH 10B,B01,083739,Sinha; Shubham,9,0,30,21
1656795922587,MATH 18,A01,083743,Cinel; Cameron Alexander,6,0,30,24
1656795922587,MATH 18,A02,083744,Cinel; Cameron Alexander,15,0,30,15
1656795922587,MATH 18,A03,083745,Cinel; Cameron Alexander,8,0,30,22
1656795922587,MATH 18,B01,083748,Rideout; David Porter,3,0,37,34
1656795922587,MATH 18,B02,083749,Rideout; David Porter,3,0,36,33
1656795922587,MATH 18,B03,083750,Rideout; David Porter,1,0,37,36
1656795922587,MATH 18,B04,083751,Rideout; David Porter,5,0,36,31
1656795922587,MATH 18,B05,093473,Rideout; David Porter,4,0,36,32
1656795922587,MATH 18,B06,093474,Rideout; David Porter,5,0,36,31
1656795928614,MATH 20A,A01,083754,Zheng; Zequn,12,0,40,28
1656795934643,MATH 20B,A01,083756,Briones; Jor-el Thomas Caparas,1,0,36,35
1656795934643,MATH 20B,A02,083757,Briones; Jor-el Thomas Caparas,1,0,36,35
1656795934643,MATH 20B,A03,093475,Briones; Jor-el Thomas Caparas,0,0,36,36
1656795940675,MATH 20C,A01,083760,Briones; Jor-el Thomas Caparas,1,0,35,34
1656795940675,MATH 20C,A02,083761,Briones; Jor-el Thomas Caparas,8,0,35,27
1656795940675,MATH 20C,A03,093476,Briones; Jor-el Thomas Caparas,0,1,36,36
1656795940675,MATH 20C,B01,083762,Bach; Quang Tran,0,0,30,30
1656795946700,MATH 20D,A01,083765,Tran; Brian Kha,4,0,30,26
1656795946700,MATH 20D,A02,083766,Tran; Brian Kha,4,0,30,26
1656795946700,MATH 20D,A03,083767,Tran; Brian Kha,2,0,30,28
1656795952724,MATH 20E,A01,083771,Ganguly; Soumya,5,0,32,27
1656795952724,MATH 20E,A02,083772,Ganguly; Soumya,5,0,32,27
1656795952724,MATH 20E,B01,083773,Ciotti; Benjamin,18,0,35,17
1656795952724,MATH 20E,B02,083774,Ciotti; Benjamin,17,0,35,18
1656795958748,MATH 103A,A01,083777,Greenfeld; Be'Eri,2,0,36,34
1656795958748,MATH 103A,A02,083778,Greenfeld; Be'Eri,5,0,36,31
1656795958748,MATH 103A,A03,093561,Greenfeld; Be'Eri,4,0,36,32
1656795958748,MATH 103A,B01,083779,Greenfeld; Be'Eri,6,0,36,30
1656795958748,MATH 103A,B02,083780,Greenfeld; Be'Eri,2,0,36,34
1656795958748,MATH 103A,B03,093562,Greenfeld; Be'Eri,2,0,36,34
1656795964776,MATH 105,A01,085443,Carter; Anne Toulson,13,0,35,22
1656795964776,MATH 105,A02,093477,Carter; Anne Toulson,20,0,35,15
1656795970799,MATH 109,A01,083213,Ganzberger; Geoffrey Michael,2,0,34,32
1656795970799,MATH 109,A02,083214,Ganzberger; Geoffrey Michael,2,0,34,32
1656795970799,MATH 109,A03,093478,Ganzberger; Geoffrey Michael,1,0,34,33
1656795970799,MATH 109,B01,083215,Ganzberger; Geoffrey Michael,1,0,32,31
1656795970799,MATH 109,B02,083216,Ganzberger; Geoffrey Michael,1,0,32,31
1656795970799,MATH 109,B03,093479,Ganzberger; Geoffrey Michael,6,0,32,26
1656795976824,MATH 142A,A01,083219,Chow; Bennett,6,0,32,26
1656795976824,MATH 142A,A02,083220,Chow; Bennett,9,0,32,23
1656795976824,MATH 142A,A03,093480,Chow; Bennett,7,0,32,25
1656795976824,MATH 142A,B03,093481,Chow; Bennett,7,0,32,25
1656795976824,MATH 142A,B04,093558,Chow; Bennett,10,0,32,22
1656795976824,MATH 142A,B05,093559,Chow; Bennett,6,0,32,26
1656795982849,MATH 193A,A01,083224,Rotar; Vladimir,6,0,34,28
1656795982849,MATH 193A,A02,083225,Rotar; Vladimir,3,0,34,31
1656795982849,MATH 193A,A03,083781,Rotar; Vladimir,1,0,34,33
1656795982849,MATH 193A,A04,083782,Rotar; Vladimir,6,0,34,28
1656795982849,MATH 193A,A05,093482,Rotar; Vladimir,6,0,34,28
1656795988873,MATH 197,001,091859,McAuley; Julian John,9999,0,9999,0
1656795988873,MATH 197,002,095566,Kedlaya; Kiran S.,9997,0,9999,2
1656795988873,MATH 197,003,095567,Xiao; Ming,9999,0,9999,0
1656795988873,MATH 197,004,095571,Perols; Johan Lars,9998,0,9999,1
1656795995940,COGS 9,A01,083615,Shannon; Kyle Michael,6,0,75,69
1656796001962,COGS 11,A01,083617,Boyle; Mary E. T.,18,0,48,30
1656796007987,COGS 13,A01,083071,Bastos; Amalia Pinkusfeld,8,0,71,63
1656796014016,COGS 14A,A01,092681,Semenuks; Arturs,0,1,100,100
1656796020043,COGS 14B,A01,083073,Cheng; Tzu-Han,5,0,63,58
1656796026070,COGS 17,A01,092677,Semenuks; Arturs,4,0,81,77
1656796032094,COGS 100,A01,083619,Allen; Michael Gordon,15,0,70,55
1656796038122,COGS 101A,A01,083621,Davis; Joshua Daniel,9,0,68,59
1656796044147,COGS 101B,A01,091572,Allen; Michael Gordon,8,0,65,57
1656796050172,COGS 101C,A01,083625,Delgado; Tania,17,0,35,18
1656796056195,COGS 107A,A01,083627,Boyle; Mary E. T.,13,0,60,47
1656796062220,COGS 118A,A01,083075,Gupta; Anjum,15,0,76,61
1656796068248,CSE 3,A50,083646,Miranda; Gregory Joseph,22,0,50,28
1656796074274,CSE 8A,A50,083650,Miranda; Gregory Joseph,17,1,56,39
1656796080308,CSE 11,A01,083080,Cao; Yingjun,4,15,40,36
1656796086335,CSE 12,A01,083652,Krause-Levy; Sophia Louisa,20,1,120,100
1656796092358,CSE 15L,A01,083654,Morris; Justin Loren,8,0,50,42
1656796092358,CSE 15L,A02,083655,Morris; Justin Loren,8,0,50,42
1656796098381,CSE 20,A01,083657,Tran; Khoa Dang,37,0,80,43
1656796104404,CSE 21,A01,095574,Bach; Quang Tran,21,0,48,27
1656796110427,CSE 30,A01,083084,Eldon; John,4,0,80,76
1656796110427,CSE 30,B01,095061,Bhaskar; Nishant,5,0,50,45
1656796116449,CSE 100,A01,083659,Cao; Yingjun,1,4,70,69
1656796122475,CSE 134B,A01,083661,Powell; Thomas Allan,18,0,100,82
1656796128503,CSE 140,A01,083663,Gungor; Onat,14,0,85,71
1656796134527,CSE 140L,A01,083088,Eldon; John,16,0,100,84
1656796140555,CSE 175,A01,083665,Kumar; Rakesh,3,0,25,22
1656796146580,CSE 190,A00,092507,Dubnov; Shlomo,7,0,20,13
1656796152604,ECE 45,A01,083139,Congero; Spencer William,5,0,75,70
1656796158630,ECE 65,A50,083695,Saad; Andrew S,12,0,30,18
1656796158630,ECE 65,A51,095125,Saad; Andrew S,25,0,26,1
1656796164659,ECE 109,A01,091882,Touri; Behrouz,15,0,70,55
1656796170686,ECE 180,A00,083140,Abi Samra; Nicholas Camill,0,0,30,30
1656796170686,ECE 180,B00,083141,Abi Samra; Nicholas Camill,0,0,30,30
1656796176711,MATH 10A,A01,083735,Patchell; Gregory David,1,0,30,29
1656796176711,MATH 10A,A02,083736,Patchell; Gregory David,20,0,30,10
1656796176711,MATH 10A,A03,083737,Patchell; Gregory David,15,0,30,15
1656796182736,MATH 10B,A01,083207,Lim; Seonhee,7,0,34,27
1656796182736,MATH 10B,A02,083208,Lim; Seonhee,9,0,35,26
1656796182736,MATH 10B,A03,093472,Lim; Seonhee,4,0,34,30
1656796182736,MATH 10B,B01,083739,Sinha; Shubham,9,0,30,21
1656796188762,MATH 18,A01,083743,Cinel; Cameron Alexander,6,0,30,24
1656796188762,MATH 18,A02,083744,Cinel; Cameron Alexander,15,0,30,15
1656796188762,MATH 18,A03,083745,Cinel; Cameron Alexander,8,0,30,22
1656796188762,MATH 18,B01,083748,Rideout; David Porter,3,0,37,34
1656796188762,MATH 18,B02,083749,Rideout; David Porter,3,0,36,33
1656796188762,MATH 18,B03,083750,Rideout; David Porter,1,0,37,36
1656796188762,MATH 18,B04,083751,Rideout; David Porter,5,0,36,31
1656796188762,MATH 18,B05,093473,Rideout; David Porter,4,0,36,32
1656796188762,MATH 18,B06,093474,Rideout; David Porter,5,0,36,31
1656796194786,MATH 20A,A01,083754,Zheng; Zequn,12,0,40,28
1656796200826,MATH 20B,A01,083756,Briones; Jor-el Thomas Caparas,1,0,36,35
1656796200826,MATH 20B,A02,083757,Briones; Jor-el Thomas Caparas,1,0,36,35
1656796200826,MATH 20B,A03,093475,Briones; Jor-el Thomas Caparas,0,0,36,36
1656796206860,MATH 20C,A01,083760,Briones; Jor-el Thomas Caparas,1,0,35,34
1656796206860,MATH 20C,A02,083761,Briones; Jor-el Thomas Caparas,8,0,35,27
1656796206860,MATH 20C,A03,093476,Briones; Jor-el Thomas Caparas,0,1,36,36
1656796206860,MATH 20C,B01,083762,Bach; Quang Tran,0,0,30,30
1656796212886,MATH 20D,A01,083765,Tran; Brian Kha,4,0,30,26
1656796212886,MATH 20D,A02,083766,Tran; Brian Kha,4,0,30,26
1656796212886,MATH 20D,A03,083767,Tran; Brian Kha,2,0,30,28
1656796218911,MATH 20E,A01,083771,Ganguly; Soumya,5,0,32,27
1656796218911,MATH 20E,A02,083772,Ganguly; Soumya,5,0,32,27
1656796218911,MATH 20E,B01,083773,Ciotti; Benjamin,18,0,35,17
1656796218911,MATH 20E,B02,083774,Ciotti; Benjamin,17,0,35,18
1656796224945,MATH 103A,A01,083777,Greenfeld; Be'Eri,2,0,36,34
1656796224945,MATH 103A,A02,083778,Greenfeld; Be'Eri,5,0,36,31
1656796224945,MATH 103A,A03,093561,Greenfeld; Be'Eri,4,0,36,32
1656796224945,MATH 103A,B01,083779,Greenfeld; Be'Eri,6,0,36,30
1656796224945,MATH 103A,B02,083780,Greenfeld; Be'Eri,2,0,36,34
1656796224945,MATH 103A,B03,093562,Greenfeld; Be'Eri,2,0,36,34
1656796230976,MATH 105,A01,085443,Carter; Anne Toulson,13,0,35,22
1656796230976,MATH 105,A02,093477,Carter; Anne Toulson,20,0,35,15
1656796237002,MATH 109,A01,083213,Ganzberger; Geoffrey Michael,2,0,34,32
1656796237002,MATH 109,A02,083214,Ganzberger; Geoffrey Michael,2,0,34,32
1656796237002,MATH 109,A03,093478,Ganzberger; Geoffrey Michael,1,0,34,33
1656796237002,MATH 109,B01,083215,Ganzberger; Geoffrey Michael,1,0,32,31
1656796237002,MATH 109,B02,083216,Ganzberger; Geoffrey Michael,1,0,32,31
1656796237002,MATH 109,B03,093479,Ganzberger; Geoffrey Michael,6,0,32,26
1656796243030,MATH 142A,A01,083219,Chow; Bennett,6,0,32,26
1656796243030,MATH 142A,A02,083220,Chow; Bennett,9,0,32,23
1656796243030,MATH 142A,A03,093480,Chow; Bennett,7,0,32,25
1656796243030,MATH 142A,B03,093481,Chow; Bennett,7,0,32,25
1656796243030,MATH 142A,B04,093558,Chow; Bennett,10,0,32,22
1656796243030,MATH 142A,B05,093559,Chow; Bennett,6,0,32,26
1656796249076,MATH 193A,A01,083224,Rotar; Vladimir,6,0,34,28
1656796249076,MATH 193A,A02,083225,Rotar; Vladimir,3,0,34,31
1656796249076,MATH 193A,A03,083781,Rotar; Vladimir,1,0,34,33
1656796249076,MATH 193A,A04,083782,Rotar; Vladimir,6,0,34,28
1656796249076,MATH 193A,A05,093482,Rotar; Vladimir,6,0,34,28
1656796255100,MATH 197,001,091859,McAuley; Julian John,9999,0,9999,0
1656796255100,MATH 197,002,095566,Kedlaya; Kiran S.,9997,0,9999,2
1656796255100,MATH 197,003,095567,Xiao; Ming,9999,0,9999,0
1656796255100,MATH 197,004,095571,Perols; Johan Lars,9998,0,9999,1
1656796262171,COGS 9,A01,083615,Shannon; Kyle Michael,6,0,75,69
1656796268200,COGS 11,A01,083617,Boyle; Mary E. T.,18,0,48,30
1656796274224,COGS 13,A01,083071,Bastos; Amalia Pinkusfeld,8,0,71,63
1656796280251,COGS 14A,A01,092681,Semenuks; Arturs,0,1,100,100
1656796286275,COGS 14B,A01,083073,Cheng; Tzu-Han,5,0,63,58
1656796292302,COGS 17,A01,092677,Semenuks; Arturs,4,0,81,77
1656796298331,COGS 100,A01,083619,Allen; Michael Gordon,15,0,70,55
1656796304360,COGS 101A,A01,083621,Davis; Joshua Daniel,9,0,68,59
1656796310385,COGS 101B,A01,091572,Allen; Michael Gordon,8,0,65,57
1656796316422,COGS 101C,A01,083625,Delgado; Tania,17,0,35,18
1656796322445,COGS 107A,A01,083627,Boyle; Mary E. T.,13,0,60,47
1656796328474,COGS 118A,A01,083075,Gupta; Anjum,15,0,76,61
1656796334507,CSE 3,A50,083646,Miranda; Gregory Joseph,22,0,50,28
1656796340536,CSE 8A,A50,083650,Miranda; Gregory Joseph,17,1,56,39
1656796346560,CSE 11,A01,083080,Cao; Yingjun,4,15,40,36
1656796352655,CSE 12,A01,083652,Krause-Levy; Sophia Louisa,20,1,120,100
1656796358684,CSE 15L,A01,083654,Morris; Justin Loren,8,0,50,42
1656796358684,CSE 15L,A02,083655,Morris; Justin Loren,8,0,50,42
1656796364709,CSE 20,A01,083657,Tran; Khoa Dang,37,0,80,43
1656796370736,CSE 21,A01,095574,Bach; Quang Tran,21,0,48,27
1656796376760,CSE 30,A01,083084,Eldon; John,4,0,80,76
1656796376760,CSE 30,B01,095061,Bhaskar; Nishant,5,0,50,45
1656796382784,CSE 100,A01,083659,Cao; Yingjun,1,4,70,69
1656796388811,CSE 134B,A01,083661,Powell; Thomas Allan,18,0,100,82
1656796394836,CSE 140,A01,083663,Gungor; Onat,14,0,85,71
1656796400860,CSE 140L,A01,083088,Eldon; John,16,0,100,84
1656796406888,CSE 175,A01,083665,Kumar; Rakesh,3,0,25,22
1656796412912,CSE 190,A00,092507,Dubnov; Shlomo,7,0,20,13
1656796418941,ECE 45,A01,083139,Congero; Spencer William,5,0,75,70
1656796424968,ECE 65,A50,083695,Saad; Andrew S,12,0,30,18
1656796424968,ECE 65,A51,095125,Saad; Andrew S,25,0,26,1
1656796431001,ECE 109,A01,091882,Touri; Behrouz,15,0,70,55
1656796437029,ECE 180,A00,083140,Abi Samra; Nicholas Camill,0,0,30,30
1656796437029,ECE 180,B00,083141,Abi Samra; Nicholas Camill,0,0,30,30
1656796443059,MATH 10A,A01,083735,Patchell; Gregory David,1,0,30,29
1656796443059,MATH 10A,A02,083736,Patchell; Gregory David,20,0,30,10
1656796443059,MATH 10A,A03,083737,Patchell; Gregory David,15,0,30,15
1656796449082,MATH 10B,A01,083207,Lim; Seonhee,7,0,34,27
1656796449082,MATH 10B,A02,083208,Lim; Seonhee,9,0,35,26
1656796449082,MATH 10B,A03,093472,Lim; Seonhee,4,0,34,30
1656796449082,MATH 10B,B01,083739,Sinha; Shubham,9,0,30,21
1656796455129,MATH 18,A01,083743,Cinel; Cameron Alexander,6,0,30,24
1656796455129,MATH 18,A02,083744,Cinel; Cameron Alexander,15,0,30,15
1656796455129,MATH 18,A03,083745,Cinel; Cameron Alexander,8,0,30,22
1656796455129,MATH 18,B01,083748,Rideout; David Porter,3,0,37,34
1656796455129,MATH 18,B02,083749,Rideout; David Porter,3,0,36,33
1656796455129,MATH 18,B03,083750,Rideout; David Porter,1,0,37,36
1656796455129,MATH 18,B04,083751,Rideout; David Porter,5,0,36,31
1656796455129,MATH 18,B05,093473,Rideout; David Porter,4,0,36,32
1656796455129,MATH 18,B06,093474,Rideout; David Porter,5,0,36,31
1656796461155,MATH 20A,A01,083754,Zheng; Zequn,12,0,40,28
1656796467180,MATH 20B,A01,083756,Briones; Jor-el Thomas Caparas,1,0,36,35
1656796467180,MATH 20B,A02,083757,Briones; Jor-el Thomas Caparas,1,0,36,35
1656796467180,MATH 20B,A03,093475,Briones; Jor-el Thomas Caparas,0,0,36,36
1656796473205,MATH 20C,A01,083760,Briones; Jor-el Thomas Caparas,1,0,35,34
1656796473205,MATH 20C,A02,083761,Briones; Jor-el Thomas Caparas,8,0,35,27
1656796473205,MATH 20C,A03,093476,Briones; Jor-el Thomas Caparas,0,1,36,36
1656796473205,MATH 20C,B01,083762,Bach; Quang Tran,0,0,30,30
1656796479233,MATH 20D,A01,083765,Tran; Brian Kha,4,0,30,26
1656796479233,MATH 20D,A02,083766,Tran; Brian Kha,4,0,30,26
1656796479233,MATH 20D,A03,083767,Tran; Brian Kha,2,0,30,28
1656796485264,MATH 20E,A01,083771,Ganguly; Soumya,5,0,32,27
1656796485264,MATH 20E,A02,083772,Ganguly; Soumya,5,0,32,27
1656796485264,MATH 20E,B01,083773,Ciotti; Benjamin,18,0,35,17
1656796485264,MATH 20E,B02,083774,Ciotti; Benjamin,17,0,35,18
1656796491291,MATH 103A,A01,083777,Greenfeld; Be'Eri,2,0,36,34
1656796491291,MATH 103A,A02,083778,Greenfeld; Be'Eri,5,0,36,31
1656796491291,MATH 103A,A03,093561,Greenfeld; Be'Eri,4,0,36,32
1656796491291,MATH 103A,B01,083779,Greenfeld; Be'Eri,6,0,36,30
1656796491291,MATH 103A,B02,083780,Greenfeld; Be'Eri,2,0,36,34
1656796491291,MATH 103A,B03,093562,Greenfeld; Be'Eri,2,0,36,34
1656796497318,MATH 105,A01,085443,Carter; Anne Toulson,13,0,35,22
1656796497318,MATH 105,A02,093477,Carter; Anne Toulson,20,0,35,15
1656796503348,MATH 109,A01,083213,Ganzberger; Geoffrey Michael,2,0,34,32
1656796503348,MATH 109,A02,083214,Ganzberger; Geoffrey Michael,2,0,34,32
1656796503348,MATH 109,A03,093478,Ganzberger; Geoffrey Michael,1,0,34,33
1656796503348,MATH 109,B01,083215,Ganzberger; Geoffrey Michael,1,0,32,31
1656796503348,MATH 109,B02,083216,Ganzberger; Geoffrey Michael,1,0,32,31
1656796503348,MATH 109,B03,093479,Ganzberger; Geoffrey Michael,6,0,32,26
1656796509372,MATH 142A,A01,083219,Chow; Bennett,6,0,32,26
1656796509372,MATH 142A,A02,083220,Chow; Bennett,9,0,32,23
1656796509372,MATH 142A,A03,093480,Chow; Bennett,7,0,32,25
1656796509372,MATH 142A,B03,093481,Chow; Bennett,7,0,32,25
1656796509372,MATH 142A,B04,093558,Chow; Bennett,10,0,32,22
1656796509372,MATH 142A,B05,093559,Chow; Bennett,6,0,32,26
1656796515400,MATH 193A,A01,083224,Rotar; Vladimir,6,0,34,28
1656796515400,MATH 193A,A02,083225,Rotar; Vladimir,3,0,34,31
1656796515400,MATH 193A,A03,083781,Rotar; Vladimir,1,0,34,33
1656796515400,MATH 193A,A04,083782,Rotar; Vladimir,6,0,34,28
1656796515400,MATH 193A,A05,093482,Rotar; Vladimir,6,0,34,28
1656796521428,MATH 197,001,091859,McAuley; Julian John,9999,0,9999,0
1656796521428,MATH 197,002,095566,Kedlaya; Kiran S.,9997,0,9999,2
1656796521428,MATH 197,003,095567,Xiao; Ming,9999,0,9999,0
1656796521428,MATH 197,004,095571,Perols; Johan Lars,9998,0,9999,1
1656796528485,COGS 9,A01,083615,Shannon; Kyle Michael,6,0,75,69
1656796534512,COGS 11,A01,083617,Boyle; Mary E. T.,18,0,48,30
1656796540542,COGS 13,A01,083071,Bastos; Amalia Pinkusfeld,8,0,71,63
1656796546569,COGS 14A,A01,092681,Semenuks; Arturs,0,1,100,100
1656796552592,COGS 14B,A01,083073,Cheng; Tzu-Han,5,0,63,58
1656796558616,COGS 17,A01,092677,Semenuks; Arturs,4,0,81,77
1656796564643,COGS 100,A01,083619,Allen; Michael Gordon,15,0,70,55
1656796570671,COGS 101A,A01,083621,Davis; Joshua Daniel,9,0,68,59
1656796576695,COGS 101B,A01,091572,Allen; Michael Gordon,8,0,65,57
1656796582720,COGS 101C,A01,083625,Delgado; Tania,17,0,35,18
1656796588748,COGS 107A,A01,083627,Boyle; Mary E. T.,13,0,60,47
1656796594770,COGS 118A,A01,083075,Gupta; Anjum,15,0,76,61
1656796600794,CSE 3,A50,083646,Miranda; Gregory Joseph,22,0,50,28
1656796606821,CSE 8A,A50,083650,Miranda; Gregory Joseph,17,1,56,39
1656796612845,CSE 11,A01,083080,Cao; Yingjun,4,15,40,36
1656796618873,CSE 12,A01,083652,Krause-Levy; Sophia Louisa,20,1,120,100
1656796624897,CSE 15L,A01,083654,Morris; Justin Loren,8,0,50,42
1656796624897,CSE 15L,A02,083655,Morris; Justin Loren,8,0,50,42
1656796630920,CSE 20,A01,083657,Tran; Khoa Dang,37,0,80,43
1656796636951,CSE 21,A01,095574,Bach; Quang Tran,21,0,48,27
1656796642978,CSE 30,A01,083084,Eldon; John,4,0,80,76
1656796642978,CSE 30,B01,095061,Bhaskar; Nishant,5,0,50,45
1656796649001,CSE 100,A01,083659,Cao; Yingjun,1,4,70,69
1656796655030,CSE 134B,A01,083661,Powell; Thomas Allan,18,0,100,82
1656796661053,CSE 140,A01,083663,Gungor; Onat,14,0,85,71
1656796667081,CSE 140L,A01,083088,Eldon; John,16,0,100,84
1656796673105,CSE 175,A01,083665,Kumar; Rakesh,3,0,25,22
1656796679129,CSE 190,A00,092507,Dubnov; Shlomo,7,0,20,13
1656796685153,ECE 45,A01,083139,Congero; Spencer William,5,0,75,70
1656796691177,ECE 65,A50,083695,Saad; Andrew S,12,0,30,18
1656796691177,ECE 65,A51,095125,Saad; Andrew S,25,0,26,1
1656796697200,ECE 109,A01,091882,Touri; Behrouz,15,0,70,55
1656796703229,ECE 180,A00,083140,Abi Samra; Nicholas Camill,0,0,30,30
1656796703229,ECE 180,B00,083141,Abi Samra; Nicholas Camill,0,0,30,30
1656796709252,MATH 10A,A01,083735,Patchell; Gregory David,1,0,30,29
1656796709252,MATH 10A,A02,083736,Patchell; Gregory David,20,0,30,10
1656796709252,MATH 10A,A03,083737,Patchell; Gregory David,15,0,30,15
1656796715285,MATH 10B,A01,083207,Lim; Seonhee,7,0,34,27
1656796715285,MATH 10B,A02,083208,Lim; Seonhee,9,0,35,26
1656796715285,MATH 10B,A03,093472,Lim; Seonhee,4,0,34,30
1656796715285,MATH 10B,B01,083739,Sinha; Shubham,9,0,30,21
1656796721317,MATH 18,A01,083743,Cinel; Cameron Alexander,6,0,30,24
1656796721317,MATH 18,A02,083744,Cinel; Cameron Alexander,15,0,30,15
1656796721317,MATH 18,A03,083745,Cinel; Cameron Alexander,8,0,30,22
1656796721317,MATH 18,B01,083748,Rideout; David Porter,3,0,37,34
1656796721317,MATH 18,B02,083749,Rideout; David Porter,3,0,36,33
1656796721317,MATH 18,B03,083750,Rideout; David Porter,1,0,37,36
1656796721317,MATH 18,B04,083751,Rideout; David Porter,5,0,36,31
1656796721317,MATH 18,B05,093473,Rideout; David Porter,4,0,36,32
1656796721317,MATH 18,B06,093474,Rideout; David Porter,5,0,36,31
1656796727347,MATH 20A,A01,083754,Zheng; Zequn,12,0,40,28
1656796733371,MATH 20B,A01,083756,Briones; Jor-el Thomas Caparas,1,0,36,35
1656796733371,MATH 20B,A02,083757,Briones; Jor-el Thomas Caparas,1,0,36,35
1656796733371,MATH 20B,A03,093475,Briones; Jor-el Thomas Caparas,0,0,36,36
1656796739395,MATH 20C,A01,083760,Briones; Jor-el Thomas Caparas,1,0,35,34
1656796739395,MATH 20C,A02,083761,Briones; Jor-el Thomas Caparas,8,0,35,27
1656796739395,MATH 20C,A03,093476,Briones; Jor-el Thomas Caparas,0,1,36,36
1656796739395,MATH 20C,B01,083762,Bach; Quang Tran,0,0,30,30
1656796745425,MATH 20D,A01,083765,Tran; Brian Kha,4,0,30,26
1656796745425,MATH 20D,A02,083766,Tran; Brian Kha,4,0,30,26
1656796745425,MATH 20D,A03,083767,Tran; Brian Kha,2,0,30,28
1656796751452,MATH 20E,A01,083771,Ganguly; Soumya,5,0,32,27
1656796751452,MATH 20E,A02,083772,Ganguly; Soumya,5,0,32,27
1656796751452,MATH 20E,B01,083773,Ciotti; Benjamin,18,0,35,17
1656796751452,MATH 20E,B02,083774,Ciotti; Benjamin,17,0,35,18
1656796757484,MATH 103A,A01,083777,Greenfeld; Be'Eri,2,0,36,34
1656796757484,MATH 103A,A02,083778,Greenfeld; Be'Eri,5,0,36,31
1656796757484,MATH 103A,A03,093561,Greenfeld; Be'Eri,4,0,36,32
1656796757484,MATH 103A,B01,083779,Greenfeld; Be'Eri,6,0,36,30
1656796757484,MATH 103A,B02,083780,Greenfeld; Be'Eri,2,0,36,34
1656796757484,MATH 103A,B03,093562,Greenfeld; Be'Eri,2,0,36,34
1656796763510,MATH 105,A01,085443,Carter; Anne Toulson,13,0,35,22
1656796763510,MATH 105,A02,093477,Carter; Anne Toulson,20,0,35,15
1656796769536,MATH 109,A01,083213,Ganzberger; Geoffrey Michael,2,0,34,32
1656796769536,MATH 109,A02,083214,Ganzberger; Geoffrey Michael,2,0,34,32
1656796769536,MATH 109,A03,093478,Ganzberger; Geoffrey Michael,1,0,34,33
1656796769536,MATH 109,B01,083215,Ganzberger; Geoffrey Michael,1,0,32,31
1656796769536,MATH 109,B02,083216,Ganzberger; Geoffrey Michael,1,0,32,31
1656796769536,MATH 109,B03,093479,Ganzberger; Geoffrey Michael,6,0,32,26
1656796775567,MATH 142A,A01,083219,Chow; Bennett,6,0,32,26
1656796775567,MATH 142A,A02,083220,Chow; Bennett,9,0,32,23
1656796775567,MATH 142A,A03,093480,Chow; Bennett,7,0,32,25
1656796775567,MATH 142A,B03,093481,Chow; Bennett,7,0,32,25
1656796775567,MATH 142A,B04,093558,Chow; Bennett,10,0,32,22
1656796775567,MATH 142A,B05,093559,Chow; Bennett,6,0,32,26
1656796781591,MATH 193A,A01,083224,Rotar; Vladimir,6,0,34,28
1656796781591,MATH 193A,A02,083225,Rotar; Vladimir,3,0,34,31
1656796781591,MATH 193A,A03,083781,Rotar; Vladimir,1,0,34,33
1656796781591,MATH 193A,A04,083782,Rotar; Vladimir,6,0,34,28
1656796781591,MATH 193A,A05,093482,Rotar; Vladimir,6,0,34,28
1656796787615,MATH 197,001,091859,McAuley; Julian John,9999,0,9999,0
1656796787615,MATH 197,002,095566,Kedlaya; Kiran S.,9997,0,9999,2
1656796787615,MATH 197,003,095567,Xiao; Ming,9999,0,9999,0
1656796787615,MATH 197,004,095571,Perols; Johan Lars,9998,0,9999,1
1656796794676,COGS 9,A01,083615,Shannon; Kyle Michael,6,0,75,69
1656796800699,COGS 11,A01,083617,Boyle; Mary E. T.,18,0,48,30
1656796806726,COGS 13,A01,083071,Bastos; Amalia Pinkusfeld,8,0,71,63
1656796812749,COGS 14A,A01,092681,Semenuks; Arturs,0,1,100,100
1656796818773,COGS 14B,A01,083073,Cheng; Tzu-Han,5,0,63,58
1656796824798,COGS 17,A01,092677,Semenuks; Arturs,4,0,81,77
1656796830832,COGS 100,A01,083619,Allen; Michael Gordon,15,0,70,55
1656796836856,COGS 101A,A01,083621,Davis; Joshua Daniel,9,0,68,59
1656796842881,COGS 101B,A01,091572,Allen; Michael Gordon,8,0,65,57
1656796848915,COGS 101C,A01,083625,Delgado; Tania,17,0,35,18
1656796854938,COGS 107A,A01,083627,Boyle; Mary E. T.,13,0,60,47
1656796860962,COGS 118A,A01,083075,Gupta; Anjum,15,0,76,61
1656796866998,CSE 3,A50,083646,Miranda; Gregory Joseph,22,0,50,28
1656796873022,CSE 8A,A50,083650,Miranda; Gregory Joseph,17,1,56,39
1656796879044,CSE 11,A01,083080,Cao; Yingjun,4,15,40,36
1656796885069,CSE 12,A01,083652,Krause-Levy; Sophia Louisa,20,1,120,100
1656796891093,CSE 15L,A01,083654,Morris; Justin Loren,8,0,50,42
1656796891093,CSE 15L,A02,083655,Morris; Justin Loren,8,0,50,42
1656796897115,CSE 20,A01,083657,Tran; Khoa Dang,37,0,80,43
1656796903140,CSE 21,A01,095574,Bach; Quang Tran,21,0,48,27
1656796909174,CSE 30,A01,083084,Eldon; John,4,0,80,76
1656796909174,CSE 30,B01,095061,Bhaskar; Nishant,5,0,50,45
1656796915198,CSE 100,A01,083659,Cao; Yingjun,1,4,70,69
1656796921222,CSE 134B,A01,083661,Powell; Thomas Allan,18,0,100,82
1656796927247,CSE 140,A01,083663,Gungor; Onat,14,0,85,71
1656796933272,CSE 140L,A01,083088,Eldon; John,16,0,100,84
1656796939313,CSE 175,A01,083665,Kumar; Rakesh,3,0,25,22
1656796945343,CSE 190,A00,092507,Dubnov; Shlomo,7,0,20,13
1656796951463,ECE 45,A01,083139,Congero; Spencer William,5,0,75,70
1656796957493,ECE 65,A50,083695,Saad; Andrew S,12,0,30,18
1656796957493,ECE 65,A51,095125,Saad; Andrew S,25,0,26,1
1656796963520,ECE 109,A01,091882,Touri; Behrouz,15,0,70,55
1656796969545,ECE 180,A00,083140,Abi Samra; Nicholas Camill,0,0,30,30
1656796969545,ECE 180,B00,083141,Abi Samra; Nicholas Camill,0,0,30,30
1656796975569,MATH 10A,A01,083735,Patchell; Gregory David,1,0,30,29
1656796975569,MATH 10A,A02,083736,Patchell; Gregory David,20,0,30,10
1656796975569,MATH 10A,A03,083737,Patchell; Gregory David,15,0,30,15
1656796981601,MATH 10B,A01,083207,Lim; Seonhee,7,0,34,27
1656796981601,MATH 10B,A02,083208,Lim; Seonhee,9,0,35,26
1656796981601,MATH 10B,A03,093472,Lim; Seonhee,4,0,34,30
1656796981601,MATH 10B,B01,083739,Sinha; Shubham,9,0,30,21
1656796987634,MATH 18,A01,083743,Cinel; Cameron Alexander,6,0,30,24
1656796987634,MATH 18,A02,083744,Cinel; Cameron Alexander,15,0,30,15
1656796987634,MATH 18,A03,083745,Cinel; Cameron Alexander,8,0,30,22
1656796987634,MATH 18,B01,083748,Rideout; David Porter,3,0,37,34
1656796987634,MATH 18,B02,083749,Rideout; David Porter,3,0,36,33
1656796987634,MATH 18,B03,083750,Rideout; David Porter,1,0,37,36
1656796987634,MATH 18,B04,083751,Rideout; David Porter,5,0,36,31
1656796987634,MATH 18,B05,093473,Rideout; David Porter,4,0,36,32
1656796987634,MATH 18,B06,093474,Rideout; David Porter,5,0,36,31
1656796993655,MATH 20A,A01,083754,Zheng; Zequn,12,0,40,28
1656796999678,MATH 20B,A01,083756,Briones; Jor-el Thomas Caparas,1,0,36,35
1656796999678,MATH 20B,A02,083757,Briones; Jor-el Thomas Caparas,1,0,36,35
1656796999678,MATH 20B,A03,093475,Briones; Jor-el Thomas Caparas,0,0,36,36
1656797005705,MATH 20C,A01,083760,Briones; Jor-el Thomas Caparas,1,0,35,34
1656797005705,MATH 20C,A02,083761,Briones; Jor-el Thomas Caparas,8,0,35,27
1656797005705,MATH 20C,A03,093476,Briones; Jor-el Thomas Caparas,0,1,36,36
1656797005705,MATH 20C,B01,083762,Bach; Quang Tran,0,0,30,30
1656797011737,MATH 20D,A01,083765,Tran; Brian Kha,4,0,30,26
1656797011737,MATH 20D,A02,083766,Tran; Brian Kha,4,0,30,26
1656797011737,MATH 20D,A03,083767,Tran; Brian Kha,2,0,30,28
1656797017760,MATH 20E,A01,083771,Ganguly; Soumya,5,0,32,27
1656797017760,MATH 20E,A02,083772,Ganguly; Soumya,5,0,32,27
1656797017760,MATH 20E,B01,083773,Ciotti; Benjamin,18,0,35,17
1656797017760,MATH 20E,B02,083774,Ciotti; Benjamin,17,0,35,18
1656797023796,MATH 103A,A01,083777,Greenfeld; Be'Eri,2,0,36,34
1656797023796,MATH 103A,A02,083778,Greenfeld; Be'Eri,5,0,36,31
1656797023796,MATH 103A,A03,093561,Greenfeld; Be'Eri,4,0,36,32
1656797023796,MATH 103A,B01,083779,Greenfeld; Be'Eri,6,0,36,30
1656797023796,MATH 103A,B02,083780,Greenfeld; Be'Eri,2,0,36,34
1656797023796,MATH 103A,B03,093562,Greenfeld; Be'Eri,2,0,36,34
1656797029836,MATH 105,A01,085443,Carter; Anne Toulson,13,0,35,22
1656797029836,MATH 105,A02,093477,Carter; Anne Toulson,20,0,35,15
1656797035864,MATH 109,A01,083213,Ganzberger; Geoffrey Michael,2,0,34,32
1656797035864,MATH 109,A02,083214,Ganzberger; Geoffrey Michael,2,0,34,32
1656797035864,MATH 109,A03,093478,Ganzberger; Geoffrey Michael,1,0,34,33
1656797035864,MATH 109,B01,083215,Ganzberger; Geoffrey Michael,1,0,32,31
1656797035864,MATH 109,B02,083216,Ganzberger; Geoffrey Michael,1,0,32,31
1656797035864,MATH 109,B03,093479,Ganzberger; Geoffrey Michael,6,0,32,26
1656797041903,MATH 142A,A01,083219,Chow; Bennett,6,0,32,26
1656797041903,MATH 142A,A02,083220,Chow; Bennett,9,0,32,23
1656797041903,MATH 142A,A03,093480,Chow; Bennett,7,0,32,25
1656797041903,MATH 142A,B03,093481,Chow; Bennett,7,0,32,25
1656797041903,MATH 142A,B04,093558,Chow; Bennett,10,0,32,22
1656797041903,MATH 142A,B05,093559,Chow; Bennett,6,0,32,26
1656797047926,MATH 193A,A01,083224,Rotar; Vladimir,6,0,34,28
1656797047926,MATH 193A,A02,083225,Rotar; Vladimir,3,0,34,31
1656797047926,MATH 193A,A03,083781,Rotar; Vladimir,1,0,34,33
1656797047926,MATH 193A,A04,083782,Rotar; Vladimir,6,0,34,28
1656797047926,MATH 193A,A05,093482,Rotar; Vladimir,6,0,34,28
1656797053948,MATH 197,001,091859,McAuley; Julian John,9999,0,9999,0
1656797053948,MATH 197,002,095566,Kedlaya; Kiran S.,9997,0,9999,2
1656797053948,MATH 197,003,095567,Xiao; Ming,9999,0,9999,0
1656797053948,MATH 197,004,095571,Perols; Johan Lars,9998,0,9999,1
1656797061013,COGS 9,A01,083615,Shannon; Kyle Michael,6,0,75,69
1656797067035,COGS 11,A01,083617,Boyle; Mary E. T.,18,0,48,30
1656797073059,COGS 13,A01,083071,Bastos; Amalia Pinkusfeld,8,0,71,63
1656797079086,COGS 14A,A01,092681,Semenuks; Arturs,0,1,100,100
1656797085117,COGS 14B,A01,083073,Cheng; Tzu-Han,5,0,63,58
1656797091144,COGS 17,A01,092677,Semenuks; Arturs,4,0,81,77
1656797097166,COGS 100,A01,083619,Allen; Michael Gordon,15,0,70,55
1656797103193,COGS 101A,A01,083621,Davis; Joshua Daniel,9,0,68,59
1656797109221,COGS 101B,A01,091572,Allen; Michael Gordon,8,0,65,57
1656797115248,COGS 101C,A01,083625,Delgado; Tania,17,0,35,18
1656797121278,COGS 107A,A01,083627,Boyle; Mary E. T.,13,0,60,47
1656797127306,COGS 118A,A01,083075,Gupta; Anjum,15,0,76,61
1656797133342,CSE 3,A50,083646,Miranda; Gregory Joseph,22,0,50,28
1656797139370,CSE 8A,A50,083650,Miranda; Gregory Joseph,17,1,56,39
1656797145399,CSE 11,A01,083080,Cao; Yingjun,4,15,40,36
1656797151432,CSE 12,A01,083652,Krause-Levy; Sophia Louisa,20,1,120,100
1656797157465,CSE 15L,A01,083654,Morris; Justin Loren,8,0,50,42
1656797157465,CSE 15L,A02,083655,Morris; Justin Loren,8,0,50,42
1656797163493,CSE 20,A01,083657,Tran; Khoa Dang,37,0,80,43
1656797169517,CSE 21,A01,095574,Bach; Quang Tran,21,0,48,27
1656797175546,CSE 30,A01,083084,Eldon; John,4,0,80,76
1656797175546,CSE 30,B01,095061,Bhaskar; Nishant,5,0,50,45
1656797181574,CSE 100,A01,083659,Cao; Yingjun,1,4,70,69
1656797187603,CSE 134B,A01,083661,Powell; Thomas Allan,18,0,100,82
1656797193645,CSE 140,A01,083663,Gungor; Onat,14,0,85,71
1656797199674,CSE 140L,A01,083088,Eldon; John,16,0,100,84
1656797205701,CSE 175,A01,083665,Kumar; Rakesh,3,0,25,22
1656797211728,CSE 190,A00,092507,Dubnov; Shlomo,7,0,20,13
1656797217753,ECE 45,A01,083139,Congero; Spencer William,5,0,75,70
1656797223778,ECE 65,A50,083695,Saad; Andrew S,12,0,30,18
1656797223778,ECE 65,A51,095125,Saad; Andrew S,25,0,26,1
1656797229801,ECE 109,A01,091882,Touri; Behrouz,15,0,70,55
1656797235828,ECE 180,A00,083140,Abi Samra; Nicholas Camill,0,0,30,30
1656797235828,ECE 180,B00,083141,Abi Samra; Nicholas Camill,0,0,30,30
1656797241857,MATH 10A,A01,083735,Patchell; Gregory David,1,0,30,29
1656797241857,MATH 10A,A02,083736,Patchell; Gregory David,20,0,30,10
1656797241857,MATH 10A,A03,083737,Patchell; Gregory David,15,0,30,15
1656797247885,MATH 10B,A01,083207,Lim; Seonhee,7,0,34,27
1656797247885,MATH 10B,A02,083208,Lim; Seonhee,9,0,35,26
1656797247885,MATH 10B,A03,093472,Lim; Seonhee,4,0,34,30
1656797247885,MATH 10B,B01,083739,Sinha; Shubham,9,0,30,21
1656797253917,MATH 18,A01,083743,Cinel; Cameron Alexander,6,0,30,24
1656797253917,MATH 18,A02,083744,Cinel; Cameron Alexander,15,0,30,15
1656797253917,MATH 18,A03,083745,Cinel; Cameron Alexander,8,0,30,22
1656797253917,MATH 18,B01,083748,Rideout; David Porter,3,0,37,34
1656797253917,MATH 18,B02,083749,Rideout; David Porter,3,0,36,33
1656797253917,MATH 18,B03,083750,Rideout; David Porter,1,0,37,36
1656797253917,MATH 18,B04,083751,Rideout; David Porter,5,0,36,31
1656797253917,MATH 18,B05,093473,Rideout; David Porter,4,0,36,32
1656797253917,MATH 18,B06,093474,Rideout; David Porter,5,0,36,31
1656797259944,MATH 20A,A01,083754,Zheng; Zequn,12,0,40,28
1656797265976,MATH 20B,A01,083756,Briones; Jor-el Thomas Caparas,1,0,36,35
1656797265976,MATH 20B,A02,083757,Briones; Jor-el Thomas Caparas,1,0,36,35
1656797265976,MATH 20B,A03,093475,Briones; Jor-el Thomas Caparas,0,0,36,36
1656797272001,MATH 20C,A01,083760,Briones; Jor-el Thomas Caparas,1,0,35,34
1656797272001,MATH 20C,A02,083761,Briones; Jor-el Thomas Caparas,8,0,35,27
1656797272001,MATH 20C,A03,093476,Briones; Jor-el Thomas Caparas,0,1,36,36
1656797272001,MATH 20C,B01,083762,Bach; Quang Tran,0,0,30,30
1656797278026,MATH 20D,A01,083765,Tran; Brian Kha,4,0,30,26
1656797278026,MATH 20D,A02,083766,Tran; Brian Kha,4,0,30,26
1656797278026,MATH 20D,A03,083767,Tran; Brian Kha,2,0,30,28
1656797284054,MATH 20E,A01,083771,Ganguly; Soumya,5,0,32,27
1656797284054,MATH 20E,A02,083772,Ganguly; Soumya,5,0,32,27
1656797284054,MATH 20E,B01,083773,Ciotti; Benjamin,18,0,35,17
1656797284054,MATH 20E,B02,083774,Ciotti; Benjamin,17,0,35,18
1656797290078,MATH 103A,A01,083777,Greenfeld; Be'Eri,2,0,36,34
1656797290078,MATH 103A,A02,083778,Greenfeld; Be'Eri,5,0,36,31
1656797290078,MATH 103A,A03,093561,Greenfeld; Be'Eri,4,0,36,32
1656797290078,MATH 103A,B01,083779,Greenfeld; Be'Eri,6,0,36,30
1656797290078,MATH 103A,B02,083780,Greenfeld; Be'Eri,2,0,36,34
1656797290078,MATH 103A,B03,093562,Greenfeld; Be'Eri,2,0,36,34
1656797296109,MATH 105,A01,085443,Carter; Anne Toulson,13,0,35,22
1656797296109,MATH 105,A02,093477,Carter; Anne Toulson,20,0,35,15
1656797302131,MATH 109,A01,083213,Ganzberger; Geoffrey Michael,2,0,34,32
1656797302131,MATH 109,A02,083214,Ganzberger; Geoffrey Michael,2,0,34,32
1656797302131,MATH 109,A03,093478,Ganzberger; Geoffrey Michael,1,0,34,33
1656797302131,MATH 109,B01,083215,Ganzberger; Geoffrey Michael,1,0,32,31
1656797302131,MATH 109,B02,083216,Ganzberger; Geoffrey Michael,1,0,32,31
1656797302131,MATH 109,B03,093479,Ganzberger; Geoffrey Michael,6,0,32,26
1656797308156,MATH 142A,A01,083219,Chow; Bennett,6,0,32,26
1656797308156,MATH 142A,A02,083220,Chow; Bennett,9,0,32,23
1656797308156,MATH 142A,A03,093480,Chow; Bennett,7,0,32,25
1656797308156,MATH 142A,B03,093481,Chow; Bennett,7,0,32,25
1656797308156,MATH 142A,B04,093558,Chow; Bennett,10,0,32,22
1656797308156,MATH 142A,B05,093559,Chow; Bennett,6,0,32,26
1656797314187,MATH 193A,A01,083224,Rotar; Vladimir,6,0,34,28
1656797314187,MATH 193A,A02,083225,Rotar; Vladimir,3,0,34,31
1656797314187,MATH 193A,A03,083781,Rotar; Vladimir,1,0,34,33
1656797314187,MATH 193A,A04,083782,Rotar; Vladimir,6,0,34,28
1656797314187,MATH 193A,A05,093482,Rotar; Vladimir,6,0,34,28
1656797320221,MATH 197,001,091859,McAuley; Julian John,9999,0,9999,0
1656797320221,MATH 197,002,095566,Kedlaya; Kiran S.,9997,0,9999,2
1656797320221,MATH 197,003,095567,Xiao; Ming,9999,0,9999,0
1656797320221,MATH 197,004,095571,Perols; Johan Lars,9998,0,9999,1
1656797327283,COGS 9,A01,083615,Shannon; Kyle Michael,6,0,75,69
1656797333314,COGS 11,A01,083617,Boyle; Mary E. T.,18,0,48,30
1656797339338,COGS 13,A01,083071,Bastos; Amalia Pinkusfeld,8,0,71,63
1656797345361,COGS 14A,A01,092681,Semenuks; Arturs,0,1,100,100
1656797351389,COGS 14B,A01,083073,Cheng; Tzu-Han,5,0,63,58
1656797357424,COGS 17,A01,092677,Semenuks; Arturs,4,0,81,77
1656797363452,COGS 100,A01,083619,Allen; Michael Gordon,15,0,70,55
1656797369488,COGS 101A,A01,083621,Davis; Joshua Daniel,9,0,68,59
1656797375516,COGS 101B,A01,091572,Allen; Michael Gordon,8,0,65,57
1656797381545,COGS 101C,A01,083625,Delgado; Tania,17,0,35,18
1656797387569,COGS 107A,A01,083627,Boyle; Mary E. T.,13,0,60,47
1656797393596,COGS 118A,A01,083075,Gupta; Anjum,15,0,76,61
1656797399622,CSE 3,A50,083646,Miranda; Gregory Joseph,22,0,50,28
1656797405661,CSE 8A,A50,083650,Miranda; Gregory Joseph,17,1,56,39
1656797411691,CSE 11,A01,083080,Cao; Yingjun,4,15,40,36
1656797417715,CSE 12,A01,083652,Krause-Levy; Sophia Louisa,20,1,120,100
1656797423740,CSE 15L,A01,083654,Morris; Justin Loren,8,0,50,42
1656797423740,CSE 15L,A02,083655,Morris; Justin Loren,8,0,50,42
1656797429768,CSE 20,A01,083657,Tran; Khoa Dang,37,0,80,43
1656797435802,CSE 21,A01,095574,Bach; Quang Tran,21,0,48,27
1656797441827,CSE 30,A01,083084,Eldon; John,4,0,80,76
1656797441827,CSE 30,B01,095061,Bhaskar; Nishant,5,0,50,45
1656797447853,CSE 100,A01,083659,Cao; Yingjun,1,4,70,69
1656797453886,CSE 134B,A01,083661,Powell; Thomas Allan,18,0,100,82
1656797459913,CSE 140,A01,083663,Gungor; Onat,14,0,85,71
1656797465936,CSE 140L,A01,083088,Eldon; John,16,0,100,84
1656797471959,CSE 175,A01,083665,Kumar; Rakesh,3,0,25,22
1656797477984,CSE 190,A00,092507,Dubnov; Shlomo,7,0,20,13
1656797484009,ECE 45,A01,083139,Congero; Spencer William,5,0,75,70
1656797490031,ECE 65,A50,083695,Saad; Andrew S,12,0,30,18
1656797490031,ECE 65,A51,095125,Saad; Andrew S,25,0,26,1
1656797496063,ECE 109,A01,091882,Touri; Behrouz,15,0,70,55
1656797502085,ECE 180,A00,083140,Abi Samra; Nicholas Camill,0,0,30,30
1656797502085,ECE 180,B00,083141,Abi Samra; Nicholas Camill,0,0,30,30
1656797508109,MATH 10A,A01,083735,Patchell; Gregory David,1,0,30,29
1656797508109,MATH 10A,A02,083736,Patchell; Gregory David,20,0,30,10
1656797508109,MATH 10A,A03,083737,Patchell; Gregory David,15,0,30,15
1656797514136,MATH 10B,A01,083207,Lim; Seonhee,7,0,34,27
1656797514136,MATH 10B,A02,083208,Lim; Seonhee,9,0,35,26
1656797514136,MATH 10B,A03,093472,Lim; Seonhee,4,0,34,30
1656797514136,MATH 10B,B01,083739,Sinha; Shubham,9,0,30,21
1656797520167,MATH 18,A01,083743,Cinel; Cameron Alexander,6,0,30,24
1656797520167,MATH 18,A02,083744,Cinel; Cameron Alexander,15,0,30,15
1656797520167,MATH 18,A03,083745,Cinel; Cameron Alexander,8,0,30,22
1656797520167,MATH 18,B01,083748,Rideout; David Porter,3,0,37,34
1656797520167,MATH 18,B02,083749,Rideout; David Porter,3,0,36,33
1656797520167,MATH 18,B03,083750,Rideout; David Porter,1,0,37,36
1656797520167,MATH 18,B04,083751,Rideout; David Porter,5,0,36,31
1656797520167,MATH 18,B05,093473,Rideout; David Porter,4,0,36,32
1656797520167,MATH 18,B06,093474,Rideout; David Porter,5,0,36,31
1656797526189,MATH 20A,A01,083754,Zheng; Zequn,12,0,40,28
1656797532216,MATH 20B,A01,083756,Briones; Jor-el Thomas Caparas,1,0,36,35
1656797532216,MATH 20B,A02,083757,Briones; Jor-el Thomas Caparas,1,0,36,35
1656797532216,MATH 20B,A03,093475,Briones; Jor-el Thomas Caparas,0,0,36,36
1656797538250,MATH 20C,A01,083760,Briones; Jor-el Thomas Caparas,1,0,35,34
1656797538250,MATH 20C,A02,083761,Briones; Jor-el Thomas Caparas,8,0,35,27
1656797538250,MATH 20C,A03,093476,Briones; Jor-el Thomas Caparas,0,1,36,36
1656797538250,MATH 20C,B01,083762,Bach; Quang Tran,0,0,30,30
1656797544274,MATH 20D,A01,083765,Tran; Brian Kha,4,0,30,26
1656797544274,MATH 20D,A02,083766,Tran; Brian Kha,4,0,30,26
1656797544274,MATH 20D,A03,083767,Tran; Brian Kha,2,0,30,28
1656797550368,MATH 20E,A01,083771,Ganguly; Soumya,5,0,32,27
1656797550368,MATH 20E,A02,083772,Ganguly; Soumya,5,0,32,27
1656797550368,MATH 20E,B01,083773,Ciotti; Benjamin,18,0,35,17
1656797550368,MATH 20E,B02,083774,Ciotti; Benjamin,17,0,35,18
1656797556398,MATH 103A,A01,083777,Greenfeld; Be'Eri,2,0,36,34
1656797556398,MATH 103A,A02,083778,Greenfeld; Be'Eri,5,0,36,31
1656797556398,MATH 103A,A03,093561,Greenfeld; Be'Eri,4,0,36,32
1656797556398,MATH 103A,B01,083779,Greenfeld; Be'Eri,6,0,36,30
1656797556398,MATH 103A,B02,083780,Greenfeld; Be'Eri,2,0,36,34
1656797556398,MATH 103A,B03,093562,Greenfeld; Be'Eri,2,0,36,34
1656797562425,MATH 105,A01,085443,Carter; Anne Toulson,13,0,35,22
1656797562425,MATH 105,A02,093477,Carter; Anne Toulson,20,0,35,15
1656797568447,MATH 109,A01,083213,Ganzberger; Geoffrey Michael,2,0,34,32
1656797568447,MATH 109,A02,083214,Ganzberger; Geoffrey Michael,2,0,34,32
1656797568447,MATH 109,A03,093478,Ganzberger; Geoffrey Michael,1,0,34,33
1656797568447,MATH 109,B01,083215,Ganzberger; Geoffrey Michael,1,0,32,31
1656797568447,MATH 109,B02,083216,Ganzberger; Geoffrey Michael,1,0,32,31
1656797568447,MATH 109,B03,093479,Ganzberger; Geoffrey Michael,6,0,32,26
1656797574472,MATH 142A,A01,083219,Chow; Bennett,6,0,32,26
1656797574472,MATH 142A,A02,083220,Chow; Bennett,9,0,32,23
1656797574472,MATH 142A,A03,093480,Chow; Bennett,7,0,32,25
1656797574472,MATH 142A,B03,093481,Chow; Bennett,7,0,32,25
1656797574472,MATH 142A,B04,093558,Chow; Bennett,10,0,32,22
1656797574472,MATH 142A,B05,093559,Chow; Bennett,6,0,32,26
1656797580499,MATH 193A,A01,083224,Rotar; Vladimir,6,0,34,28
1656797580499,MATH 193A,A02,083225,Rotar; Vladimir,3,0,34,31
1656797580499,MATH 193A,A03,083781,Rotar; Vladimir,1,0,34,33
1656797580499,MATH 193A,A04,083782,Rotar; Vladimir,6,0,34,28
1656797580499,MATH 193A,A05,093482,Rotar; Vladimir,6,0,34,28
1656797586523,MATH 197,001,091859,McAuley; Julian John,9999,0,9999,0
1656797586523,MATH 197,002,095566,Kedlaya; Kiran S.,9997,0,9999,2
1656797586523,MATH 197,003,095567,Xiao; Ming,9999,0,9999,0
1656797586523,MATH 197,004,095571,Perols; Johan Lars,9998,0,9999,1
1656797593574,COGS 9,A01,083615,Shannon; Kyle Michael,6,0,75,69
1656797599601,COGS 11,A01,083617,Boyle; Mary E. T.,18,0,48,30
1656797605625,COGS 13,A01,083071,Bastos; Amalia Pinkusfeld,8,0,71,63
1656797611647,COGS 14A,A01,092681,Semenuks; Arturs,0,1,100,100
1656797617678,COGS 14B,A01,083073,Cheng; Tzu-Han,5,0,63,58
1656797623702,COGS 17,A01,092677,Semenuks; Arturs,4,0,81,77
1656797629724,COGS 100,A01,083619,Allen; Michael Gordon,15,0,70,55
1656797635746,COGS 101A,A01,083621,Davis; Joshua Daniel,9,0,68,59
1656797641769,COGS 101B,A01,091572,Allen; Michael Gordon,8,0,65,57
1656797647795,COGS 101C,A01,083625,Delgado; Tania,17,0,35,18
1656797653817,COGS 107A,A01,083627,Boyle; Mary E. T.,13,0,60,47
1656797659843,COGS 118A,A01,083075,Gupta; Anjum,15,0,76,61
1656797665870,CSE 3,A50,083646,Miranda; Gregory Joseph,22,0,50,28
1656797671910,CSE 8A,A50,083650,Miranda; Gregory Joseph,17,1,56,39
1656797677932,CSE 11,A01,083080,Cao; Yingjun,4,15,40,36
1656797683955,CSE 12,A01,083652,Krause-Levy; Sophia Louisa,20,1,120,100
1656797689978,CSE 15L,A01,083654,Morris; Justin Loren,8,0,50,42
1656797689978,CSE 15L,A02,083655,Morris; Justin Loren,8,0,50,42
1656797696003,CSE 20,A01,083657,Tran; Khoa Dang,37,0,80,43
1656797702029,CSE 21,A01,095574,Bach; Quang Tran,21,0,48,27
1656797708053,CSE 30,A01,083084,Eldon; John,4,0,80,76
1656797708053,CSE 30,B01,095061,Bhaskar; Nishant,5,0,50,45
1656797714078,CSE 100,A01,083659,Cao; Yingjun,1,4,70,69
1656797720101,CSE 134B,A01,083661,Powell; Thomas Allan,18,0,100,82
1656797726128,CSE 140,A01,083663,Gungor; Onat,14,0,85,71
1656797732154,CSE 140L,A01,083088,Eldon; John,16,0,100,84
1656797738175,CSE 175,A01,083665,Kumar; Rakesh,3,0,25,22
1656797744198,CSE 190,A00,092507,Dubnov; Shlomo,7,0,20,13
1656797750219,ECE 45,A01,083139,Congero; Spencer William,5,0,75,70
1656797756243,ECE 65,A50,083695,Saad; Andrew S,12,0,30,18
1656797756243,ECE 65,A51,095125,Saad; Andrew S,25,0,26,1
1656797762266,ECE 109,A01,091882,Touri; Behrouz,15,0,70,55
1656797768294,ECE 180,A00,083140,Abi Samra; Nicholas Camill,0,0,30,30
1656797768294,ECE 180,B00,083141,Abi Samra; Nicholas Camill,0,0,30,30
1656797774318,MATH 10A,A01,083735,Patchell; Gregory David,1,0,30,29
1656797774318,MATH 10A,A02,083736,Patchell; Gregory David,20,0,30,10
1656797774318,MATH 10A,A03,083737,Patchell; Gregory David,15,0,30,15
1656797780368,MATH 10B,A01,083207,Lim; Seonhee,7,0,34,27
1656797780368,MATH 10B,A02,083208,Lim; Seonhee,9,0,35,26
1656797780368,MATH 10B,A03,093472,Lim; Seonhee,4,0,34,30
1656797780368,MATH 10B,B01,083739,Sinha; Shubham,9,0,30,21
1656797786392,MATH 18,A01,083743,Cinel; Cameron Alexander,6,0,30,24
1656797786392,MATH 18,A02,083744,Cinel; Cameron Alexander,15,0,30,15
1656797786392,MATH 18,A03,083745,Cinel; Cameron Alexander,8,0,30,22
1656797786392,MATH 18,B01,083748,Rideout; David Porter,3,0,37,34
1656797786392,MATH 18,B02,083749,Rideout; David Porter,3,0,36,33
1656797786392,MATH 18,B03,083750,Rideout; David Porter,1,0,37,36
1656797786392,MATH 18,B04,083751,Rideout; David Porter,5,0,36,31
1656797786392,MATH 18,B05,093473,Rideout; David Porter,4,0,36,32
1656797786392,MATH 18,B06,093474,Rideout; David Porter,5,0,36,31
1656797792425,MATH 20A,A01,083754,Zheng; Zequn,12,0,40,28
1656797798448,MATH 20B,A01,083756,Briones; Jor-el Thomas Caparas,1,0,36,35
1656797798448,MATH 20B,A02,083757,Briones; Jor-el Thomas Caparas,1,0,36,35
1656797798448,MATH 20B,A03,093475,Briones; Jor-el Thomas Caparas,0,0,36,36
1656797804474,MATH 20C,A01,083760,Briones; Jor-el Thomas Caparas,1,0,35,34
1656797804474,MATH 20C,A02,083761,Briones; Jor-el Thomas Caparas,8,0,35,27
1656797804474,MATH 20C,A03,093476,Briones; Jor-el Thomas Caparas,0,1,36,36
1656797804474,MATH 20C,B01,083762,Bach; Quang Tran,0,0,30,30
1656797810503,MATH 20D,A01,083765,Tran; Brian Kha,4,0,30,26
1656797810503,MATH 20D,A02,083766,Tran; Brian Kha,4,0,30,26
1656797810503,MATH 20D,A03,083767,Tran; Brian Kha,2,0,30,28
1656797816539,MATH 20E,A01,083771,Ganguly; Soumya,5,0,32,27
1656797816539,MATH 20E,A02,083772,Ganguly; Soumya,5,0,32,27
1656797816539,MATH 20E,B01,083773,Ciotti; Benjamin,18,0,35,17
1656797816539,MATH 20E,B02,083774,Ciotti; Benjamin,17,0,35,18
1656797822561,MATH 103A,A01,083777,Greenfeld; Be'Eri,2,0,36,34
1656797822561,MATH 103A,A02,083778,Greenfeld; Be'Eri,5,0,36,31
1656797822561,MATH 103A,A03,093561,Greenfeld; Be'Eri,4,0,36,32
1656797822561,MATH 103A,B01,083779,Greenfeld; Be'Eri,6,0,36,30
1656797822561,MATH 103A,B02,083780,Greenfeld; Be'Eri,2,0,36,34
1656797822561,MATH 103A,B03,093562,Greenfeld; Be'Eri,2,0,36,34
1656797828584,MATH 105,A01,085443,Carter; Anne Toulson,13,0,35,22
1656797828584,MATH 105,A02,093477,Carter; Anne Toulson,20,0,35,15
1656797834612,MATH 109,A01,083213,Ganzberger; Geoffrey Michael,2,0,34,32
1656797834612,MATH 109,A02,083214,Ganzberger; Geoffrey Michael,2,0,34,32
1656797834612,MATH 109,A03,093478,Ganzberger; Geoffrey Michael,1,0,34,33
1656797834612,MATH 109,B01,083215,Ganzberger; Geoffrey Michael,1,0,32,31
1656797834612,MATH 109,B02,083216,Ganzberger; Geoffrey Michael,1,0,32,31
1656797834612,MATH 109,B03,093479,Ganzberger; Geoffrey Michael,6,0,32,26
1656797840642,MATH 142A,A01,083219,Chow; Bennett,6,0,32,26
1656797840642,MATH 142A,A02,083220,Chow; Bennett,9,0,32,23
1656797840642,MATH 142A,A03,093480,Chow; Bennett,7,0,32,25
1656797840642,MATH 142A,B03,093481,Chow; Bennett,7,0,32,25
1656797840642,MATH 142A,B04,093558,Chow; Bennett,10,0,32,22
1656797840642,MATH 142A,B05,093559,Chow; Bennett,6,0,32,26
1656797846668,MATH 193A,A01,083224,Rotar; Vladimir,6,0,34,28
1656797846668,MATH 193A,A02,083225,Rotar; Vladimir,3,0,34,31
1656797846668,MATH 193A,A03,083781,Rotar; Vladimir,1,0,34,33
1656797846668,MATH 193A,A04,083782,Rotar; Vladimir,6,0,34,28
1656797846668,MATH 193A,A05,093482,Rotar; Vladimir,6,0,34,28
1656797852692,MATH 197,001,091859,McAuley; Julian John,9999,0,9999,0
1656797852692,MATH 197,002,095566,Kedlaya; Kiran S.,9997,0,9999,2
1656797852692,MATH 197,003,095567,Xiao; Ming,9999,0,9999,0
1656797852692,MATH 197,004,095571,Perols; Johan Lars,9998,0,9999,1
1656797859760,COGS 9,A01,083615,Shannon; Kyle Michael,6,0,75,69
1656797865787,COGS 11,A01,083617,Boyle; Mary E. T.,18,0,48,30
1656797871812,COGS 13,A01,083071,Bastos; Amalia Pinkusfeld,8,0,71,63
1656797877835,COGS 14A,A01,092681,Semenuks; Arturs,0,1,100,100
1656797883858,COGS 14B,A01,083073,Cheng; Tzu-Han,5,0,63,58
1656797889884,COGS 17,A01,092677,Semenuks; Arturs,4,0,81,77
1656797895908,COGS 100,A01,083619,Allen; Michael Gordon,15,0,70,55
1656797901936,COGS 101A,A01,083621,Davis; Joshua Daniel,9,0,68,59
1656797907959,COGS 101B,A01,091572,Allen; Michael Gordon,8,0,65,57
1656797913993,COGS 101C,A01,083625,Delgado; Tania,17,0,35,18
1656797920016,COGS 107A,A01,083627,Boyle; Mary E. T.,13,0,60,47
1656797926041,COGS 118A,A01,083075,Gupta; Anjum,15,0,76,61
1656797932065,CSE 3,A50,083646,Miranda; Gregory Joseph,22,0,50,28
1656797938092,CSE 8A,A50,083650,Miranda; Gregory Joseph,17,1,56,39
1656797944116,CSE 11,A01,083080,Cao; Yingjun,4,15,40,36
1656797950140,CSE 12,A01,083652,Krause-Levy; Sophia Louisa,20,1,120,100
1656797956164,CSE 15L,A01,083654,Morris; Justin Loren,8,0,50,42
1656797956164,CSE 15L,A02,083655,Morris; Justin Loren,8,0,50,42
1656797962187,CSE 20,A01,083657,Tran; Khoa Dang,37,0,80,43
1656797968209,CSE 21,A01,095574,Bach; Quang Tran,21,0,48,27
1656797974232,CSE 30,A01,083084,Eldon; John,4,0,80,76
1656797974232,CSE 30,B01,095061,Bhaskar; Nishant,5,0,50,45
1656797980260,CSE 100,A01,083659,Cao; Yingjun,1,4,70,69
1656797986283,CSE 134B,A01,083661,Powell; Thomas Allan,18,0,100,82
1656797992333,CSE 140,A01,083663,Gungor; Onat,14,0,85,71
1656797998356,CSE 140L,A01,083088,Eldon; John,16,0,100,84
1656798004379,CSE 175,A01,083665,Kumar; Rakesh,3,0,25,22
1656798010417,CSE 190,A00,092507,Dubnov; Shlomo,7,0,20,13
1656798016440,ECE 45,A01,083139,Congero; Spencer William,5,0,75,70
1656798022464,ECE 65,A50,083695,Saad; Andrew S,12,0,30,18
1656798022464,ECE 65,A51,095125,Saad; Andrew S,25,0,26,1
1656798028490,ECE 109,A01,091882,Touri; Behrouz,15,0,70,55
1656798034517,ECE 180,A00,083140,Abi Samra; Nicholas Camill,0,0,30,30
1656798034517,ECE 180,B00,083141,Abi Samra; Nicholas Camill,0,0,30,30
1656798040539,MATH 10A,A01,083735,Patchell; Gregory David,1,0,30,29
1656798040539,MATH 10A,A02,083736,Patchell; Gregory David,20,0,30,10
1656798040539,MATH 10A,A03,083737,Patchell; Gregory David,15,0,30,15
1656798046563,MATH 10B,A01,083207,Lim; Seonhee,7,0,34,27
1656798046563,MATH 10B,A02,083208,Lim; Seonhee,9,0,35,26
1656798046563,MATH 10B,A03,093472,Lim; Seonhee,4,0,34,30
1656798046563,MATH 10B,B01,083739,Sinha; Shubham,9,0,30,21
1656798052592,MATH 18,A01,083743,Cinel; Cameron Alexander,6,0,30,24
1656798052592,MATH 18,A02,083744,Cinel; Cameron Alexander,15,0,30,15
1656798052592,MATH 18,A03,083745,Cinel; Cameron Alexander,8,0,30,22
1656798052592,MATH 18,B01,083748,Rideout; David Porter,3,0,37,34
1656798052592,MATH 18,B02,083749,Rideout; David Porter,3,0,36,33
1656798052592,MATH 18,B03,083750,Rideout; David Porter,1,0,37,36
1656798052592,MATH 18,B04,083751,Rideout; David Porter,5,0,36,31
1656798052592,MATH 18,B05,093473,Rideout; David Porter,4,0,36,32
1656798052592,MATH 18,B06,093474,Rideout; David Porter,5,0,36,31
1656798058614,MATH 20A,A01,083754,Zheng; Zequn,12,0,40,28
1656798064635,MATH 20B,A01,083756,Briones; Jor-el Thomas Caparas,1,0,36,35
1656798064635,MATH 20B,A02,083757,Briones; Jor-el Thomas Caparas,1,0,36,35
1656798064635,MATH 20B,A03,093475,Briones; Jor-el Thomas Caparas,0,0,36,36
1656798070661,MATH 20C,A01,083760,Briones; Jor-el Thomas Caparas,1,0,35,34
1656798070661,MATH 20C,A02,083761,Briones; Jor-el Thomas Caparas,8,0,35,27
1656798070661,MATH 20C,A03,093476,Briones; Jor-el Thomas Caparas,0,1,36,36
1656798070661,MATH 20C,B01,083762,Bach; Quang Tran,0,0,30,30
1656798076689,MATH 20D,A01,083765,Tran; Brian Kha,4,0,30,26
1656798076689,MATH 20D,A02,083766,Tran; Brian Kha,4,0,30,26
1656798076689,MATH 20D,A03,083767,Tran; Brian Kha,2,0,30,28
1656798082713,MATH 20E,A01,083771,Ganguly; Soumya,5,0,32,27
1656798082713,MATH 20E,A02,083772,Ganguly; Soumya,5,0,32,27
1656798082713,MATH 20E,B01,083773,Ciotti; Benjamin,18,0,35,17
1656798082713,MATH 20E,B02,083774,Ciotti; Benjamin,17,0,35,18
1656798088736,MATH 103A,A01,083777,Greenfeld; Be'Eri,2,0,36,34
1656798088736,MATH 103A,A02,083778,Greenfeld; Be'Eri,5,0,36,31
1656798088736,MATH 103A,A03,093561,Greenfeld; Be'Eri,4,0,36,32
1656798088736,MATH 103A,B01,083779,Greenfeld; Be'Eri,6,0,36,30
1656798088736,MATH 103A,B02,083780,Greenfeld; Be'Eri,2,0,36,34
1656798088736,MATH 103A,B03,093562,Greenfeld; Be'Eri,2,0,36,34
1656798094760,MATH 105,A01,085443,Carter; Anne Toulson,13,0,35,22
1656798094760,MATH 105,A02,093477,Carter; Anne Toulson,20,0,35,15
1656798100782,MATH 109,A01,083213,Ganzberger; Geoffrey Michael,2,0,34,32
1656798100782,MATH 109,A02,083214,Ganzberger; Geoffrey Michael,2,0,34,32
1656798100782,MATH 109,A03,093478,Ganzberger; Geoffrey Michael,1,0,34,33
1656798100782,MATH 109,B01,083215,Ganzberger; Geoffrey Michael,1,0,32,31
1656798100782,MATH 109,B02,083216,Ganzberger; Geoffrey Michael,1,0,32,31
1656798100782,MATH 109,B03,093479,Ganzberger; Geoffrey Michael,6,0,32,26
1656798106811,MATH 142A,A01,083219,Chow; Bennett,6,0,32,26
1656798106811,MATH 142A,A02,083220,Chow; Bennett,9,0,32,23
1656798106811,MATH 142A,A03,093480,Chow; Bennett,7,0,32,25
1656798106811,MATH 142A,B03,093481,Chow; Bennett,7,0,32,25
1656798106811,MATH 142A,B04,093558,Chow; Bennett,10,0,32,22
1656798106811,MATH 142A,B05,093559,Chow; Bennett,6,0,32,26
1656798112838,MATH 193A,A01,083224,Rotar; Vladimir,6,0,34,28
1656798112838,MATH 193A,A02,083225,Rotar; Vladimir,3,0,34,31
1656798112838,MATH 193A,A03,083781,Rotar; Vladimir,1,0,34,33
1656798112838,MATH 193A,A04,083782,Rotar; Vladimir,6,0,34,28
1656798112838,MATH 193A,A05,093482,Rotar; Vladimir,6,0,34,28
1656798118868,MATH 197,001,091859,McAuley; Julian John,9999,0,9999,0
1656798118868,MATH 197,002,095566,Kedlaya; Kiran S.,9997,0,9999,2
1656798118868,MATH 197,003,095567,Xiao; Ming,9999,0,9999,0
1656798118868,MATH 197,004,095571,Perols; Johan Lars,9998,0,9999,1
1656798125932,COGS 9,A01,083615,Shannon; Kyle Michael,6,0,75,69
1656798131957,COGS 11,A01,083617,Boyle; Mary E. T.,18,0,48,30
1656798137980,COGS 13,A01,083071,Bastos; Amalia Pinkusfeld,8,0,71,63
1656798144089,COGS 14A,A01,092681,Semenuks; Arturs,0,1,100,100
1656798150113,COGS 14B,A01,083073,Cheng; Tzu-Han,5,0,63,58
1656798156135,COGS 17,A01,092677,Semenuks; Arturs,4,0,81,77
1656798162161,COGS 100,A01,083619,Allen; Michael Gordon,15,0,70,55
1656798168184,COGS 101A,A01,083621,Davis; Joshua Daniel,9,0,68,59
1656798174211,COGS 101B,A01,091572,Allen; Michael Gordon,8,0,65,57
1656798180242,COGS 101C,A01,083625,Delgado; Tania,17,0,35,18
1656798186264,COGS 107A,A01,083627,Boyle; Mary E. T.,13,0,60,47
1656798192290,COGS 118A,A01,083075,Gupta; Anjum,15,0,76,61
1656798198315,CSE 3,A50,083646,Miranda; Gregory Joseph,22,0,50,28
1656798204339,CSE 8A,A50,083650,Miranda; Gregory Joseph,17,1,56,39
1656798210375,CSE 11,A01,083080,Cao; Yingjun,4,15,40,36
1656798216403,CSE 12,A01,083652,Krause-Levy; Sophia Louisa,20,1,120,100
1656798222427,CSE 15L,A01,083654,Morris; Justin Loren,8,0,50,42
1656798222427,CSE 15L,A02,083655,Morris; Justin Loren,8,0,50,42
1656798228449,CSE 20,A01,083657,Tran; Khoa Dang,37,0,80,43
1656798234473,CSE 21,A01,095574,Bach; Quang Tran,21,0,48,27
1656798240498,CSE 30,A01,083084,Eldon; John,4,0,80,76
1656798240498,CSE 30,B01,095061,Bhaskar; Nishant,5,0,50,45
1656798246525,CSE 100,A01,083659,Cao; Yingjun,1,4,70,69
1656798252558,CSE 134B,A01,083661,Powell; Thomas Allan,18,0,100,82
1656798258585,CSE 140,A01,083663,Gungor; Onat,14,0,85,71
1656798264609,CSE 140L,A01,083088,Eldon; John,16,0,100,84
1656798270637,CSE 175,A01,083665,Kumar; Rakesh,3,0,25,22
1656798276665,CSE 190,A00,092507,Dubnov; Shlomo,7,0,20,13
1656798282689,ECE 45,A01,083139,Congero; Spencer William,5,0,75,70
1656798288711,ECE 65,A50,083695,Saad; Andrew S,12,0,30,18
1656798288711,ECE 65,A51,095125,Saad; Andrew S,25,0,26,1
1656798294736,ECE 109,A01,091882,Touri; Behrouz,15,0,70,55
1656798300760,ECE 180,A00,083140,Abi Samra; Nicholas Camill,0,0,30,30
1656798300760,ECE 180,B00,083141,Abi Samra; Nicholas Camill,0,0,30,30
1656798306795,MATH 10A,A01,083735,Patchell; Gregory David,1,0,30,29
1656798306795,MATH 10A,A02,083736,Patchell; Gregory David,20,0,30,10
1656798306795,MATH 10A,A03,083737,Patchell; Gregory David,15,0,30,15
1656798312823,MATH 10B,A01,083207,Lim; Seonhee,7,0,34,27
1656798312823,MATH 10B,A02,083208,Lim; Seonhee,9,0,35,26
1656798312823,MATH 10B,A03,093472,Lim; Seonhee,4,0,34,30
1656798312823,MATH 10B,B01,083739,Sinha; Shubham,9,0,30,21
1656798318854,MATH 18,A01,083743,Cinel; Cameron Alexander,6,0,30,24
1656798318854,MATH 18,A02,083744,Cinel; Cameron Alexander,15,0,30,15
1656798318854,MATH 18,A03,083745,Cinel; Cameron Alexander,8,0,30,22
1656798318854,MATH 18,B01,083748,Rideout; David Porter,3,0,37,34
1656798318854,MATH 18,B02,083749,Rideout; David Porter,3,0,36,33
1656798318854,MATH 18,B03,083750,Rideout; David Porter,1,0,37,36
1656798318854,MATH 18,B04,083751,Rideout; David Porter,5,0,36,31
1656798318854,MATH 18,B05,093473,Rideout; David Porter,4,0,36,32
1656798318854,MATH 18,B06,093474,Rideout; David Porter,5,0,36,31
1656798324878,MATH 20A,A01,083754,Zheng; Zequn,12,0,40,28
1656798330907,MATH 20B,A01,083756,Briones; Jor-el Thomas Caparas,1,0,36,35
1656798330907,MATH 20B,A02,083757,Briones; Jor-el Thomas Caparas,1,0,36,35
1656798330907,MATH 20B,A03,093475,Briones; Jor-el Thomas Caparas,0,0,36,36
1656798336932,MATH 20C,A01,083760,Briones; Jor-el Thomas Caparas,1,0,35,34
1656798336932,MATH 20C,A02,083761,Briones; Jor-el Thomas Caparas,8,0,35,27
1656798336932,MATH 20C,A03,093476,Briones; Jor-el Thomas Caparas,0,1,36,36
1656798336932,MATH 20C,B01,083762,Bach; Quang Tran,0,0,30,30
1656798342960,MATH 20D,A01,083765,Tran; Brian Kha,4,0,30,26
1656798342960,MATH 20D,A02,083766,Tran; Brian Kha,4,0,30,26
1656798342960,MATH 20D,A03,083767,Tran; Brian Kha,2,0,30,28
1656798348983,MATH 20E,A01,083771,Ganguly; Soumya,5,0,32,27
1656798348983,MATH 20E,A02,083772,Ganguly; Soumya,5,0,32,27
1656798348983,MATH 20E,B01,083773,Ciotti; Benjamin,18,0,35,17
1656798348983,MATH 20E,B02,083774,Ciotti; Benjamin,17,0,35,18
1656798355006,MATH 103A,A01,083777,Greenfeld; Be'Eri,2,0,36,34
1656798355006,MATH 103A,A02,083778,Greenfeld; Be'Eri,5,0,36,31
1656798355006,MATH 103A,A03,093561,Greenfeld; Be'Eri,4,0,36,32
1656798355006,MATH 103A,B01,083779,Greenfeld; Be'Eri,6,0,36,30
1656798355006,MATH 103A,B02,083780,Greenfeld; Be'Eri,2,0,36,34
1656798355006,MATH 103A,B03,093562,Greenfeld; Be'Eri,2,0,36,34
1656798361034,MATH 105,A01,085443,Carter; Anne Toulson,13,0,35,22
1656798361034,MATH 105,A02,093477,Carter; Anne Toulson,20,0,35,15
1656798367069,MATH 109,A01,083213,Ganzberger; Geoffrey Michael,2,0,34,32
1656798367069,MATH 109,A02,083214,Ganzberger; Geoffrey Michael,2,0,34,32
1656798367069,MATH 109,A03,093478,Ganzberger; Geoffrey Michael,1,0,34,33
1656798367069,MATH 109,B01,083215,Ganzberger; Geoffrey Michael,1,0,32,31
1656798367069,MATH 109,B02,083216,Ganzberger; Geoffrey Michael,1,0,32,31
1656798367069,MATH 109,B03,093479,Ganzberger; Geoffrey Michael,6,0,32,26
1656798373097,MATH 142A,A01,083219,Chow; Bennett,6,0,32,26
1656798373097,MATH 142A,A02,083220,Chow; Bennett,9,0,32,23
1656798373097,MATH 142A,A03,093480,Chow; Bennett,7,0,32,25
1656798373097,MATH 142A,B03,093481,Chow; Bennett,7,0,32,25
1656798373097,MATH 142A,B04,093558,Chow; Bennett,10,0,32,22
1656798373097,MATH 142A,B05,093559,Chow; Bennett,6,0,32,26
1656798379126,MATH 193A,A01,083224,Rotar; Vladimir,6,0,34,28
1656798379126,MATH 193A,A02,083225,Rotar; Vladimir,3,0,34,31
1656798379126,MATH 193A,A03,083781,Rotar; Vladimir,1,0,34,33
1656798379126,MATH 193A,A04,083782,Rotar; Vladimir,6,0,34,28
1656798379126,MATH 193A,A05,093482,Rotar; Vladimir,6,0,34,28
1656798385149,MATH 197,001,091859,McAuley; Julian John,9999,0,9999,0
1656798385149,MATH 197,002,095566,Kedlaya; Kiran S.,9997,0,9999,2
1656798385149,MATH 197,003,095567,Xiao; Ming,9999,0,9999,0
1656798385149,MATH 197,004,095571,Perols; Johan Lars,9998,0,9999,1
1656798392218,COGS 9,A01,083615,Shannon; Kyle Michael,6,0,75,69
1656798398244,COGS 11,A01,083617,Boyle; Mary E. T.,18,0,48,30
1656798404267,COGS 13,A01,083071,Bastos; Amalia Pinkusfeld,8,0,71,63
1656798410291,COGS 14A,A01,092681,Semenuks; Arturs,0,1,100,100
1656798416314,COGS 14B,A01,083073,Cheng; Tzu-Han,5,0,63,58
1656798422343,COGS 17,A01,092677,Semenuks; Arturs,4,0,81,77
1656798428369,COGS 100,A01,083619,Allen; Michael Gordon,15,0,70,55
1656798434392,COGS 101A,A01,083621,Davis; Joshua Daniel,9,0,68,59
1656798440420,COGS 101B,A01,091572,Allen; Michael Gordon,8,0,65,57
1656798446446,COGS 101C,A01,083625,Delgado; Tania,17,0,35,18
1656798452468,COGS 107A,A01,083627,Boyle; Mary E. T.,13,0,60,47
1656798458489,COGS 118A,A01,083075,Gupta; Anjum,15,0,76,61
1656798464513,CSE 3,A50,083646,Miranda; Gregory Joseph,22,0,50,28
1656798470537,CSE 8A,A50,083650,Miranda; Gregory Joseph,17,1,56,39
1656798476583,CSE 11,A01,083080,Cao; Yingjun,4,15,40,36
1656798482611,CSE 12,A01,083652,Krause-Levy; Sophia Louisa,20,1,120,100
1656798488638,CSE 15L,A01,083654,Morris; Justin Loren,8,0,50,42
1656798488638,CSE 15L,A02,083655,Morris; Justin Loren,8,0,50,42
1656798494666,CSE 20,A01,083657,Tran; Khoa Dang,37,0,80,43
1656798500690,CSE 21,A01,095574,Bach; Quang Tran,21,0,48,27
1656798506716,CSE 30,A01,083084,Eldon; John,4,0,80,76
1656798506716,CSE 30,B01,095061,Bhaskar; Nishant,5,0,50,45
1656798512739,CSE 100,A01,083659,Cao; Yingjun,1,4,70,69
1656798518763,CSE 134B,A01,083661,Powell; Thomas Allan,18,0,100,82
1656798524789,CSE 140,A01,083663,Gungor; Onat,14,0,85,71
1656798530816,CSE 140L,A01,083088,Eldon; John,16,0,100,84
1656798536843,CSE 175,A01,083665,Kumar; Rakesh,3,0,25,22
1656798542870,CSE 190,A00,092507,Dubnov; Shlomo,7,0,20,13
1656798548897,ECE 45,A01,083139,Congero; Spencer William,5,0,75,70
1656798554921,ECE 65,A50,083695,Saad; Andrew S,12,0,30,18
1656798554921,ECE 65,A51,095125,Saad; Andrew S,25,0,26,1
1656798560949,ECE 109,A01,091882,Touri; Behrouz,15,0,70,55
1656798566978,ECE 180,A00,083140,Abi Samra; Nicholas Camill,0,0,30,30
1656798566978,ECE 180,B00,083141,Abi Samra; Nicholas Camill,0,0,30,30
1656798573002,MATH 10A,A01,083735,Patchell; Gregory David,1,0,30,29
1656798573002,MATH 10A,A02,083736,Patchell; Gregory David,20,0,30,10
1656798573002,MATH 10A,A03,083737,Patchell; Gregory David,15,0,30,15
1656798579026,MATH 10B,A01,083207,Lim; Seonhee,7,0,34,27
1656798579026,MATH 10B,A02,083208,Lim; Seonhee,9,0,35,26
1656798579026,MATH 10B,A03,093472,Lim; Seonhee,4,0,34,30
1656798579026,MATH 10B,B01,083739,Sinha; Shubham,9,0,30,21
1656798585056,MATH 18,A01,083743,Cinel; Cameron Alexander,6,0,30,24
1656798585056,MATH 18,A02,083744,Cinel; Cameron Alexander,15,0,30,15
1656798585056,MATH 18,A03,083745,Cinel; Cameron Alexander,8,0,30,22
1656798585056,MATH 18,B01,083748,Rideout; David Porter,3,0,37,34
1656798585056,MATH 18,B02,083749,Rideout; David Porter,3,0,36,33
1656798585056,MATH 18,B03,083750,Rideout; David Porter,1,0,37,36
1656798585056,MATH 18,B04,083751,Rideout; David Porter,5,0,36,31
1656798585056,MATH 18,B05,093473,Rideout; David Porter,4,0,36,32
1656798585056,MATH 18,B06,093474,Rideout; David Porter,5,0,36,31
1656798591081,MATH 20A,A01,083754,Zheng; Zequn,12,0,40,28
1656798597111,MATH 20B,A01,083756,Briones; Jor-el Thomas Caparas,1,0,36,35
1656798597111,MATH 20B,A02,083757,Briones; Jor-el Thomas Caparas,1,0,36,35
1656798597111,MATH 20B,A03,093475,Briones; Jor-el Thomas Caparas,0,0,36,36
1656798603141,MATH 20C,A01,083760,Briones; Jor-el Thomas Caparas,1,0,35,34
1656798603141,MATH 20C,A02,083761,Briones; Jor-el Thomas Caparas,8,0,35,27
1656798603141,MATH 20C,A03,093476,Briones; Jor-el Thomas Caparas,0,1,36,36
1656798603141,MATH 20C,B01,083762,Bach; Quang Tran,0,0,30,30
1656798609163,MATH 20D,A01,083765,Tran; Brian Kha,4,0,30,26
1656798609163,MATH 20D,A02,083766,Tran; Brian Kha,4,0,30,26
1656798609163,MATH 20D,A03,083767,Tran; Brian Kha,2,0,30,28
1656798615191,MATH 20E,A01,083771,Ganguly; Soumya,5,0,32,27
1656798615191,MATH 20E,A02,083772,Ganguly; Soumya,5,0,32,27
1656798615191,MATH 20E,B01,083773,Ciotti; Benjamin,18,0,35,17
1656798615191,MATH 20E,B02,083774,Ciotti; Benjamin,17,0,35,18
1656798621215,MATH 103A,A01,083777,Greenfeld; Be'Eri,2,0,36,34
1656798621215,MATH 103A,A02,083778,Greenfeld; Be'Eri,5,0,36,31
1656798621215,MATH 103A,A03,093561,Greenfeld; Be'Eri,4,0,36,32
1656798621215,MATH 103A,B01,083779,Greenfeld; Be'Eri,6,0,36,30
1656798621215,MATH 103A,B02,083780,Greenfeld; Be'Eri,2,0,36,34
1656798621215,MATH 103A,B03,093562,Greenfeld; Be'Eri,2,0,36,34
1656798627244,MATH 105,A01,085443,Carter; Anne Toulson,13,0,35,22
1656798627244,MATH 105,A02,093477,Carter; Anne Toulson,20,0,35,15
1656798633269,MATH 109,A01,083213,Ganzberger; Geoffrey Michael,2,0,34,32
1656798633269,MATH 109,A02,083214,Ganzberger; Geoffrey Michael,2,0,34,32
1656798633269,MATH 109,A03,093478,Ganzberger; Geoffrey Michael,1,0,34,33
1656798633269,MATH 109,B01,083215,Ganzberger; Geoffrey Michael,1,0,32,31
1656798633269,MATH 109,B02,083216,Ganzberger; Geoffrey Michael,1,0,32,31
1656798633269,MATH 109,B03,093479,Ganzberger; Geoffrey Michael,6,0,32,26
1656798639293,MATH 142A,A01,083219,Chow; Bennett,6,0,32,26
1656798639293,MATH 142A,A02,083220,Chow; Bennett,9,0,32,23
1656798639293,MATH 142A,A03,093480,Chow; Bennett,7,0,32,25
1656798639293,MATH 142A,B03,093481,Chow; Bennett,7,0,32,25
1656798639293,MATH 142A,B04,093558,Chow; Bennett,10,0,32,22
1656798639293,MATH 142A,B05,093559,Chow; Bennett,6,0,32,26
1656798645322,MATH 193A,A01,083224,Rotar; Vladimir,6,0,34,28
1656798645322,MATH 193A,A02,083225,Rotar; Vladimir,3,0,34,31
1656798645322,MATH 193A,A03,083781,Rotar; Vladimir,1,0,34,33
1656798645322,MATH 193A,A04,083782,Rotar; Vladimir,6,0,34,28
1656798645322,MATH 193A,A05,093482,Rotar; Vladimir,6,0,34,28
1656798651343,MATH 197,001,091859,McAuley; Julian John,9999,0,9999,0
1656798651343,MATH 197,002,095566,Kedlaya; Kiran S.,9997,0,9999,2
1656798651343,MATH 197,003,095567,Xiao; Ming,9999,0,9999,0
1656798651343,MATH 197,004,095571,Perols; Johan Lars,9998,0,9999,1
1656798658400,COGS 9,A01,083615,Shannon; Kyle Michael,6,0,75,69
1656798664422,COGS 11,A01,083617,Boyle; Mary E. T.,18,0,48,30
1656798670446,COGS 13,A01,083071,Bastos; Amalia Pinkusfeld,8,0,71,63
1656798676475,COGS 14A,A01,092681,Semenuks; Arturs,0,1,100,100
1656798682505,COGS 14B,A01,083073,Cheng; Tzu-Han,5,0,63,58
1656798688529,COGS 17,A01,092677,Semenuks; Arturs,4,0,81,77
1656798694552,COGS 100,A01,083619,Allen; Michael Gordon,15,0,70,55
1656798700574,COGS 101A,A01,083621,Davis; Joshua Daniel,9,0,68,59
1656798706604,COGS 101B,A01,091572,Allen; Michael Gordon,8,0,65,57
1656798712631,COGS 101C,A01,083625,Delgado; Tania,17,0,35,18
1656798718655,COGS 107A,A01,083627,Boyle; Mary E. T.,13,0,60,47
1656798724677,COGS 118A,A01,083075,Gupta; Anjum,15,0,76,61
1656798730704,CSE 3,A50,083646,Miranda; Gregory Joseph,22,0,50,28
1656798736727,CSE 8A,A50,083650,Miranda; Gregory Joseph,17,1,56,39
1656798742844,CSE 11,A01,083080,Cao; Yingjun,4,15,40,36
1656798748873,CSE 12,A01,083652,Krause-Levy; Sophia Louisa,20,1,120,100
1656798754900,CSE 15L,A01,083654,Morris; Justin Loren,8,0,50,42
1656798754900,CSE 15L,A02,083655,Morris; Justin Loren,8,0,50,42
1656798760923,CSE 20,A01,083657,Tran; Khoa Dang,37,0,80,43
1656798766945,CSE 21,A01,095574,Bach; Quang Tran,21,0,48,27
1656798772970,CSE 30,A01,083084,Eldon; John,4,0,80,76
1656798772970,CSE 30,B01,095061,Bhaskar; Nishant,5,0,50,45
1656798778998,CSE 100,A01,083659,Cao; Yingjun,1,4,70,69
1656798785021,CSE 134B,A01,083661,Powell; Thomas Allan,18,0,100,82
1656798791058,CSE 140,A01,083663,Gungor; Onat,14,0,85,71
1656798797079,CSE 140L,A01,083088,Eldon; John,16,0,100,84
1656798803103,CSE 175,A01,083665,Kumar; Rakesh,3,0,25,22
1656798809127,CSE 190,A00,092507,Dubnov; Shlomo,7,0,20,13
1656798815155,ECE 45,A01,083139,Congero; Spencer William,5,0,75,70
1656798821179,ECE 65,A50,083695,Saad; Andrew S,12,0,30,18
1656798821179,ECE 65,A51,095125,Saad; Andrew S,25,0,26,1
1656798827204,ECE 109,A01,091882,Touri; Behrouz,15,0,70,55
1656798833228,ECE 180,A00,083140,Abi Samra; Nicholas Camill,0,0,30,30
1656798833228,ECE 180,B00,083141,Abi Samra; Nicholas Camill,0,0,30,30
1656798839253,MATH 10A,A01,083735,Patchell; Gregory David,1,0,30,29
1656798839253,MATH 10A,A02,083736,Patchell; Gregory David,20,0,30,10
1656798839253,MATH 10A,A03,083737,Patchell; Gregory David,15,0,30,15
1656798845278,MATH 10B,A01,083207,Lim; Seonhee,7,0,34,27
1656798845278,MATH 10B,A02,083208,Lim; Seonhee,9,0,35,26
1656798845278,MATH 10B,A03,093472,Lim; Seonhee,4,0,34,30
1656798845278,MATH 10B,B01,083739,Sinha; Shubham,9,0,30,21
1656798851308,MATH 18,A01,083743,Cinel; Cameron Alexander,6,0,30,24
1656798851308,MATH 18,A02,083744,Cinel; Cameron Alexander,15,0,30,15
1656798851308,MATH 18,A03,083745,Cinel; Cameron Alexander,8,0,30,22
1656798851308,MATH 18,B01,083748,Rideout; David Porter,3,0,37,34
1656798851308,MATH 18,B02,083749,Rideout; David Porter,3,0,36,33
1656798851308,MATH 18,B03,083750,Rideout; David Porter,1,0,37,36
1656798851308,MATH 18,B04,083751,Rideout; David Porter,5,0,36,31
1656798851308,MATH 18,B05,093473,Rideout; David Porter,4,0,36,32
1656798851308,MATH 18,B06,093474,Rideout; David Porter,5,0,36,31
1656798857334,MATH 20A,A01,083754,Zheng; Zequn,12,0,40,28
1656798863362,MATH 20B,A01,083756,Briones; Jor-el Thomas Caparas,1,0,36,35
1656798863362,MATH 20B,A02,083757,Briones; Jor-el Thomas Caparas,1,0,36,35
1656798863362,MATH 20B,A03,093475,Briones; Jor-el Thomas Caparas,0,0,36,36
1656798869387,MATH 20C,A01,083760,Briones; Jor-el Thomas Caparas,1,0,35,34
1656798869387,MATH 20C,A02,083761,Briones; Jor-el Thomas Caparas,8,0,35,27
1656798869387,MATH 20C,A03,093476,Briones; Jor-el Thomas Caparas,0,1,36,36
1656798869387,MATH 20C,B01,083762,Bach; Quang Tran,0,0,30,30
1656798875412,MATH 20D,A01,083765,Tran; Brian Kha,4,0,30,26
1656798875412,MATH 20D,A02,083766,Tran; Brian Kha,4,0,30,26
1656798875412,MATH 20D,A03,083767,Tran; Brian Kha,2,0,30,28
1656798881437,MATH 20E,A01,083771,Ganguly; Soumya,5,0,32,27
1656798881437,MATH 20E,A02,083772,Ganguly; Soumya,5,0,32,27
1656798881437,MATH 20E,B01,083773,Ciotti; Benjamin,18,0,35,17
1656798881437,MATH 20E,B02,083774,Ciotti; Benjamin,17,0,35,18
1656798887467,MATH 103A,A01,083777,Greenfeld; Be'Eri,2,0,36,34
1656798887467,MATH 103A,A02,083778,Greenfeld; Be'Eri,5,0,36,31
1656798887467,MATH 103A,A03,093561,Greenfeld; Be'Eri,4,0,36,32
1656798887467,MATH 103A,B01,083779,Greenfeld; Be'Eri,6,0,36,30
1656798887467,MATH 103A,B02,083780,Greenfeld; Be'Eri,2,0,36,34
1656798887467,MATH 103A,B03,093562,Greenfeld; Be'Eri,2,0,36,34
1656798893491,MATH 105,A01,085443,Carter; Anne Toulson,13,0,35,22
1656798893491,MATH 105,A02,093477,Carter; Anne Toulson,20,0,35,15
1656798899514,MATH 109,A01,083213,Ganzberger; Geoffrey Michael,2,0,34,32
1656798899514,MATH 109,A02,083214,Ganzberger; Geoffrey Michael,2,0,34,32
1656798899514,MATH 109,A03,093478,Ganzberger; Geoffrey Michael,1,0,34,33
1656798899514,MATH 109,B01,083215,Ganzberger; Geoffrey Michael,1,0,32,31
1656798899514,MATH 109,B02,083216,Ganzberger; Geoffrey Michael,1,0,32,31
1656798899514,MATH 109,B03,093479,Ganzberger; Geoffrey Michael,6,0,32,26
1656798905538,MATH 142A,A01,083219,Chow; Bennett,6,0,32,26
1656798905538,MATH 142A,A02,083220,Chow; Bennett,9,0,32,23
1656798905538,MATH 142A,A03,093480,Chow; Bennett,7,0,32,25
1656798905538,MATH 142A,B03,093481,Chow; Bennett,7,0,32,25
1656798905538,MATH 142A,B04,093558,Chow; Bennett,10,0,32,22
1656798905538,MATH 142A,B05,093559,Chow; Bennett,6,0,32,26
1656798911562,MATH 193A,A01,083224,Rotar; Vladimir,6,0,34,28
1656798911562,MATH 193A,A02,083225,Rotar; Vladimir,3,0,34,31
1656798911562,MATH 193A,A03,083781,Rotar; Vladimir,1,0,34,33
1656798911562,MATH 193A,A04,083782,Rotar; Vladimir,6,0,34,28
1656798911562,MATH 193A,A05,093482,Rotar; Vladimir,6,0,34,28
1656798917583,MATH 197,001,091859,McAuley; Julian John,9999,0,9999,0
1656798917583,MATH 197,002,095566,Kedlaya; Kiran S.,9997,0,9999,2
1656798917583,MATH 197,003,095567,Xiao; Ming,9999,0,9999,0
1656798917583,MATH 197,004,095571,Perols; Johan Lars,9998,0,9999,1
1656798924663,COGS 9,A01,083615,Shannon; Kyle Michael,6,0,75,69
1656798930690,COGS 11,A01,083617,Boyle; Mary E. T.,18,0,48,30
1656798936720,COGS 13,A01,083071,Bastos; Amalia Pinkusfeld,8,0,71,63
1656798942748,COGS 14A,A01,092681,Semenuks; Arturs,0,1,100,100
1656798948771,COGS 14B,A01,083073,Cheng; Tzu-Han,5,0,63,58
1656798954793,COGS 17,A01,092677,Semenuks; Arturs,4,0,81,77
1656798960820,COGS 100,A01,083619,Allen; Michael Gordon,15,0,70,55
1656798966846,COGS 101A,A01,083621,Davis; Joshua Daniel,9,0,68,59
1656798972869,COGS 101B,A01,091572,Allen; Michael Gordon,8,0,65,57
1656798978896,COGS 101C,A01,083625,Delgado; Tania,17,0,35,18
1656798984923,COGS 107A,A01,083627,Boyle; Mary E. T.,13,0,60,47
1656798990946,COGS 118A,A01,083075,Gupta; Anjum,15,0,76,61
1656798996972,CSE 3,A50,083646,Miranda; Gregory Joseph,22,0,50,28
1656799002996,CSE 8A,A50,083650,Miranda; Gregory Joseph,17,1,56,39
1656799009019,CSE 11,A01,083080,Cao; Yingjun,4,15,40,36
1656799015051,CSE 12,A01,083652,Krause-Levy; Sophia Louisa,20,1,120,100
1656799021073,CSE 15L,A01,083654,Morris; Justin Loren,8,0,50,42
1656799021073,CSE 15L,A02,083655,Morris; Justin Loren,8,0,50,42
1656799027099,CSE 20,A01,083657,Tran; Khoa Dang,37,0,80,43
1656799033134,CSE 21,A01,095574,Bach; Quang Tran,21,0,48,27
1656799039161,CSE 30,A01,083084,Eldon; John,4,0,80,76
1656799039161,CSE 30,B01,095061,Bhaskar; Nishant,5,0,50,45
1656799045187,CSE 100,A01,083659,Cao; Yingjun,1,4,70,69
1656799051210,CSE 134B,A01,083661,Powell; Thomas Allan,18,0,100,82
1656799057237,CSE 140,A01,083663,Gungor; Onat,14,0,85,71
1656799063264,CSE 140L,A01,083088,Eldon; John,16,0,100,84
1656799069288,CSE 175,A01,083665,Kumar; Rakesh,3,0,25,22
1656799075310,CSE 190,A00,092507,Dubnov; Shlomo,7,0,20,13
1656799081337,ECE 45,A01,083139,Congero; Spencer William,5,0,75,70
1656799087359,ECE 65,A50,083695,Saad; Andrew S,12,0,30,18
1656799087359,ECE 65,A51,095125,Saad; Andrew S,25,0,26,1
1656799093383,ECE 109,A01,091882,Touri; Behrouz,15,0,70,55
1656799099406,ECE 180,A00,083140,Abi Samra; Nicholas Camill,0,0,30,30
1656799099406,ECE 180,B00,083141,Abi Samra; Nicholas Camill,0,0,30,30
1656799105429,MATH 10A,A01,083735,Patchell; Gregory David,1,0,30,29
1656799105429,MATH 10A,A02,083736,Patchell; Gregory David,20,0,30,10
1656799105429,MATH 10A,A03,083737,Patchell; Gregory David,15,0,30,15
1656799111452,MATH 10B,A01,083207,Lim; Seonhee,7,0,34,27
1656799111452,MATH 10B,A02,083208,Lim; Seonhee,9,0,35,26
1656799111452,MATH 10B,A03,093472,Lim; Seonhee,4,0,34,30
1656799111452,MATH 10B,B01,083739,Sinha; Shubham,9,0,30,21
1656799117483,MATH 18,A01,083743,Cinel; Cameron Alexander,6,0,30,24
1656799117483,MATH 18,A02,083744,Cinel; Cameron Alexander,15,0,30,15
1656799117483,MATH 18,A03,083745,Cinel; Cameron Alexander,8,0,30,22
1656799117483,MATH 18,B01,083748,Rideout; David Porter,3,0,37,34
1656799117483,MATH 18,B02,083749,Rideout; David Porter,3,0,36,33
1656799117483,MATH 18,B03,083750,Rideout; David Porter,1,0,37,36
1656799117483,MATH 18,B04,083751,Rideout; David Porter,5,0,36,31
1656799117483,MATH 18,B05,093473,Rideout; David Porter,4,0,36,32
1656799117483,MATH 18,B06,093474,Rideout; David Porter,5,0,36,31
1656799123505,MATH 20A,A01,083754,Zheng; Zequn,12,0,40,28
1656799129530,MATH 20B,A01,083756,Briones; Jor-el Thomas Caparas,1,0,36,35
1656799129530,MATH 20B,A02,083757,Briones; Jor-el Thomas Caparas,1,0,36,35
1656799129530,MATH 20B,A03,093475,Briones; Jor-el Thomas Caparas,0,0,36,36
1656799135555,MATH 20C,A01,083760,Briones; Jor-el Thomas Caparas,1,0,35,34
1656799135555,MATH 20C,A02,083761,Briones; Jor-el Thomas Caparas,8,0,35,27
1656799135555,MATH 20C,A03,093476,Briones; Jor-el Thomas Caparas,0,1,36,36
1656799135555,MATH 20C,B01,083762,Bach; Quang Tran,0,0,30,30
1656799141578,MATH 20D,A01,083765,Tran; Brian Kha,4,0,30,26
1656799141578,MATH 20D,A02,083766,Tran; Brian Kha,4,0,30,26
1656799141578,MATH 20D,A03,083767,Tran; Brian Kha,2,0,30,28
1656799147600,MATH 20E,A01,083771,Ganguly; Soumya,5,0,32,27
1656799147600,MATH 20E,A02,083772,Ganguly; Soumya,5,0,32,27
1656799147600,MATH 20E,B01,083773,Ciotti; Benjamin,18,0,35,17
1656799147600,MATH 20E,B02,083774,Ciotti; Benjamin,17,0,35,18
1656799153630,MATH 103A,A01,083777,Greenfeld; Be'Eri,2,0,36,34
1656799153630,MATH 103A,A02,083778,Greenfeld; Be'Eri,5,0,36,31
1656799153630,MATH 103A,A03,093561,Greenfeld; Be'Eri,4,0,36,32
1656799153630,MATH 103A,B01,083779,Greenfeld; Be'Eri,6,0,36,30
1656799153630,MATH 103A,B02,083780,Greenfeld; Be'Eri,2,0,36,34
1656799153630,MATH 103A,B03,093562,Greenfeld; Be'Eri,2,0,36,34
1656799159655,MATH 105,A01,085443,Carter; Anne Toulson,13,0,35,22
1656799159655,MATH 105,A02,093477,Carter; Anne Toulson,20,0,35,15
1656799165679,MATH 109,A01,083213,Ganzberger; Geoffrey Michael,2,0,34,32
1656799165679,MATH 109,A02,083214,Ganzberger; Geoffrey Michael,2,0,34,32
1656799165679,MATH 109,A03,093478,Ganzberger; Geoffrey Michael,1,0,34,33
1656799165679,MATH 109,B01,083215,Ganzberger; Geoffrey Michael,1,0,32,31
1656799165679,MATH 109,B02,083216,Ganzberger; Geoffrey Michael,1,0,32,31
1656799165679,MATH 109,B03,093479,Ganzberger; Geoffrey Michael,6,0,32,26
1656799171703,MATH 142A,A01,083219,Chow; Bennett,6,0,32,26
1656799171703,MATH 142A,A02,083220,Chow; Bennett,9,0,32,23
1656799171703,MATH 142A,A03,093480,Chow; Bennett,7,0,32,25
1656799171703,MATH 142A,B03,093481,Chow; Bennett,7,0,32,25
1656799171703,MATH 142A,B04,093558,Chow; Bennett,10,0,32,22
1656799171703,MATH 142A,B05,093559,Chow; Bennett,6,0,32,26
1656799177724,MATH 193A,A01,083224,Rotar; Vladimir,6,0,34,28
1656799177724,MATH 193A,A02,083225,Rotar; Vladimir,3,0,34,31
1656799177724,MATH 193A,A03,083781,Rotar; Vladimir,1,0,34,33
1656799177724,MATH 193A,A04,083782,Rotar; Vladimir,6,0,34,28
1656799177724,MATH 193A,A05,093482,Rotar; Vladimir,6,0,34,28
1656799183746,MATH 197,001,091859,McAuley; Julian John,9999,0,9999,0
1656799183746,MATH 197,002,095566,Kedlaya; Kiran S.,9997,0,9999,2
1656799183746,MATH 197,003,095567,Xiao; Ming,9999,0,9999,0
1656799183746,MATH 197,004,095571,Perols; Johan Lars,9998,0,9999,1
1656799190804,COGS 9,A01,083615,Shannon; Kyle Michael,6,0,75,69
1656799196830,COGS 11,A01,083617,Boyle; Mary E. T.,18,0,48,30
1656799202861,COGS 13,A01,083071,Bastos; Amalia Pinkusfeld,8,0,71,63
1656799208882,COGS 14A,A01,092681,Semenuks; Arturs,0,1,100,100
1656799214905,COGS 14B,A01,083073,Cheng; Tzu-Han,5,0,63,58
1656799220929,COGS 17,A01,092677,Semenuks; Arturs,4,0,81,77
1656799226955,COGS 100,A01,083619,Allen; Michael Gordon,15,0,70,55
1656799232982,COGS 101A,A01,083621,Davis; Joshua Daniel,9,0,68,59
1656799239006,COGS 101B,A01,091572,Allen; Michael Gordon,8,0,65,57
1656799245028,COGS 101C,A01,083625,Delgado; Tania,17,0,35,18
1656799251052,COGS 107A,A01,083627,Boyle; Mary E. T.,13,0,60,47
1656799257078,COGS 118A,A01,083075,Gupta; Anjum,15,0,76,61
1656799263106,CSE 3,A50,083646,Miranda; Gregory Joseph,22,0,50,28
1656799269148,CSE 8A,A50,083650,Miranda; Gregory Joseph,17,1,56,39
1656799275170,CSE 11,A01,083080,Cao; Yingjun,4,15,40,36
1656799281198,CSE 12,A01,083652,Krause-Levy; Sophia Louisa,20,1,120,100
1656799287222,CSE 15L,A01,083654,Morris; Justin Loren,8,0,50,42
1656799287222,CSE 15L,A02,083655,Morris; Justin Loren,8,0,50,42
1656799293244,CSE 20,A01,083657,Tran; Khoa Dang,37,0,80,43
1656799299266,CSE 21,A01,095574,Bach; Quang Tran,21,0,48,27
1656799305293,CSE 30,A01,083084,Eldon; John,4,0,80,76
1656799305293,CSE 30,B01,095061,Bhaskar; Nishant,5,0,50,45
1656799311316,CSE 100,A01,083659,Cao; Yingjun,1,4,70,69
1656799317345,CSE 134B,A01,083661,Powell; Thomas Allan,18,0,100,82
1656799323367,CSE 140,A01,083663,Gungor; Onat,14,0,85,71
1656799329396,CSE 140L,A01,083088,Eldon; John,16,0,100,84
1656799335423,CSE 175,A01,083665,Kumar; Rakesh,3,0,25,22
1656799341537,CSE 190,A00,092507,Dubnov; Shlomo,7,0,20,13
1656799347558,ECE 45,A01,083139,Congero; Spencer William,5,0,75,70
1656799353588,ECE 65,A50,083695,Saad; Andrew S,12,0,30,18
1656799353588,ECE 65,A51,095125,Saad; Andrew S,25,0,26,1
1656799359611,ECE 109,A01,091882,Touri; Behrouz,15,0,70,55
1656799365645,ECE 180,A00,083140,Abi Samra; Nicholas Camill,0,0,30,30
1656799365645,ECE 180,B00,083141,Abi Samra; Nicholas Camill,0,0,30,30
1656799371670,MATH 10A,A01,083735,Patchell; Gregory David,1,0,30,29
1656799371670,MATH 10A,A02,083736,Patchell; Gregory David,20,0,30,10
1656799371670,MATH 10A,A03,083737,Patchell; Gregory David,15,0,30,15
1656799377694,MATH 10B,A01,083207,Lim; Seonhee,7,0,34,27
1656799377694,MATH 10B,A02,083208,Lim; Seonhee,9,0,35,26
1656799377694,MATH 10B,A03,093472,Lim; Seonhee,4,0,34,30
1656799377694,MATH 10B,B01,083739,Sinha; Shubham,9,0,30,21
1656799383727,MATH 18,A01,083743,Cinel; Cameron Alexander,6,0,30,24
1656799383727,MATH 18,A02,083744,Cinel; Cameron Alexander,15,0,30,15
1656799383727,MATH 18,A03,083745,Cinel; Cameron Alexander,8,0,30,22
1656799383727,MATH 18,B01,083748,Rideout; David Porter,3,0,37,34
1656799383727,MATH 18,B02,083749,Rideout; David Porter,3,0,36,33
1656799383727,MATH 18,B03,083750,Rideout; David Porter,1,0,37,36
1656799383727,MATH 18,B04,083751,Rideout; David Porter,5,0,36,31
1656799383727,MATH 18,B05,093473,Rideout; David Porter,4,0,36,32
1656799383727,MATH 18,B06,093474,Rideout; David Porter,5,0,36,31
1656799389753,MATH 20A,A01,083754,Zheng; Zequn,12,0,40,28
1656799395782,MATH 20B,A01,083756,Briones; Jor-el Thomas Caparas,1,0,36,35
1656799395782,MATH 20B,A02,083757,Briones; Jor-el Thomas Caparas,1,0,36,35
1656799395782,MATH 20B,A03,093475,Briones; Jor-el Thomas Caparas,0,0,36,36
1656799401810,MATH 20C,A01,083760,Briones; Jor-el Thomas Caparas,1,0,35,34
1656799401810,MATH 20C,A02,083761,Briones; Jor-el Thomas Caparas,8,0,35,27
1656799401810,MATH 20C,A03,093476,Briones; Jor-el Thomas Caparas,0,1,36,36
1656799401810,MATH 20C,B01,083762,Bach; Quang Tran,0,0,30,30
1656799407839,MATH 20D,A01,083765,Tran; Brian Kha,4,0,30,26
1656799407839,MATH 20D,A02,083766,Tran; Brian Kha,4,0,30,26
1656799407839,MATH 20D,A03,083767,Tran; Brian Kha,2,0,30,28
1656799413866,MATH 20E,A01,083771,Ganguly; Soumya,5,0,32,27
1656799413866,MATH 20E,A02,083772,Ganguly; Soumya,5,0,32,27
1656799413866,MATH 20E,B01,083773,Ciotti; Benjamin,18,0,35,17
1656799413866,MATH 20E,B02,083774,Ciotti; Benjamin,17,0,35,18
1656799419896,MATH 103A,A01,083777,Greenfeld; Be'Eri,2,0,36,34
1656799419896,MATH 103A,A02,083778,Greenfeld; Be'Eri,5,0,36,31
1656799419896,MATH 103A,A03,093561,Greenfeld; Be'Eri,4,0,36,32
1656799419896,MATH 103A,B01,083779,Greenfeld; Be'Eri,6,0,36,30
1656799419896,MATH 103A,B02,083780,Greenfeld; Be'Eri,2,0,36,34
1656799419896,MATH 103A,B03,093562,Greenfeld; Be'Eri,2,0,36,34
1656799425919,MATH 105,A01,085443,Carter; Anne Toulson,13,0,35,22
1656799425919,MATH 105,A02,093477,Carter; Anne Toulson,20,0,35,15
1656799431945,MATH 109,A01,083213,Ganzberger; Geoffrey Michael,2,0,34,32
1656799431945,MATH 109,A02,083214,Ganzberger; Geoffrey Michael,2,0,34,32
1656799431945,MATH 109,A03,093478,Ganzberger; Geoffrey Michael,1,0,34,33
1656799431945,MATH 109,B01,083215,Ganzberger; Geoffrey Michael,1,0,32,31
1656799431945,MATH 109,B02,083216,Ganzberger; Geoffrey Michael,1,0,32,31
1656799431945,MATH 109,B03,093479,Ganzberger; Geoffrey Michael,6,0,32,26
1656799437972,MATH 142A,A01,083219,Chow; Bennett,6,0,32,26
1656799437972,MATH 142A,A02,083220,Chow; Bennett,9,0,32,23
1656799437972,MATH 142A,A03,093480,Chow; Bennett,7,0,32,25
1656799437972,MATH 142A,B03,093481,Chow; Bennett,7,0,32,25
1656799437972,MATH 142A,B04,093558,Chow; Bennett,10,0,32,22
1656799437972,MATH 142A,B05,093559,Chow; Bennett,6,0,32,26
1656799443999,MATH 193A,A01,083224,Rotar; Vladimir,6,0,34,28
1656799443999,MATH 193A,A02,083225,Rotar; Vladimir,3,0,34,31
1656799443999,MATH 193A,A03,083781,Rotar; Vladimir,1,0,34,33
1656799443999,MATH 193A,A04,083782,Rotar; Vladimir,6,0,34,28
1656799443999,MATH 193A,A05,093482,Rotar; Vladimir,6,0,34,28
1656799450023,MATH 197,001,091859,McAuley; Julian John,9999,0,9999,0
1656799450023,MATH 197,002,095566,Kedlaya; Kiran S.,9997,0,9999,2
1656799450023,MATH 197,003,095567,Xiao; Ming,9999,0,9999,0
1656799450023,MATH 197,004,095571,Perols; Johan Lars,9998,0,9999,1
1656799457083,COGS 9,A01,083615,Shannon; Kyle Michael,6,0,75,69
1656799463107,COGS 11,A01,083617,Boyle; Mary E. T.,18,0,48,30
1656799469133,COGS 13,A01,083071,Bastos; Amalia Pinkusfeld,8,0,71,63
1656799475161,COGS 14A,A01,092681,Semenuks; Arturs,0,1,100,100
1656799481185,COGS 14B,A01,083073,Cheng; Tzu-Han,5,0,63,58
1656799487211,COGS 17,A01,092677,Semenuks; Arturs,4,0,81,77
1656799493234,COGS 100,A01,083619,Allen; Michael Gordon,15,0,70,55
1656799499257,COGS 101A,A01,083621,Davis; Joshua Daniel,9,0,68,59
1656799505280,COGS 101B,A01,091572,Allen; Michael Gordon,8,0,65,57
1656799511306,COGS 101C,A01,083625,Delgado; Tania,17,0,35,18
1656799517343,COGS 107A,A01,083627,Boyle; Mary E. T.,13,0,60,47
1656799523370,COGS 118A,A01,083075,Gupta; Anjum,15,0,76,61
1656799529399,CSE 3,A50,083646,Miranda; Gregory Joseph,22,0,50,28
1656799535427,CSE 8A,A50,083650,Miranda; Gregory Joseph,17,1,56,39
1656799541452,CSE 11,A01,083080,Cao; Yingjun,4,15,40,36
1656799547479,CSE 12,A01,083652,Krause-Levy; Sophia Louisa,20,1,120,100
1656799553503,CSE 15L,A01,083654,Morris; Justin Loren,8,0,50,42
1656799553503,CSE 15L,A02,083655,Morris; Justin Loren,8,0,50,42
1656799559526,CSE 20,A01,083657,Tran; Khoa Dang,37,0,80,43
1656799565566,CSE 21,A01,095574,Bach; Quang Tran,21,0,48,27
1656799571590,CSE 30,A01,083084,Eldon; John,4,0,80,76
1656799571590,CSE 30,B01,095061,Bhaskar; Nishant,5,0,50,45
1656799577616,CSE 100,A01,083659,Cao; Yingjun,1,4,70,69
1656799583643,CSE 134B,A01,083661,Powell; Thomas Allan,18,0,100,82
1656799589669,CSE 140,A01,083663,Gungor; Onat,14,0,85,71
1656799595693,CSE 140L,A01,083088,Eldon; John,16,0,100,84
1656799601715,CSE 175,A01,083665,Kumar; Rakesh,3,0,25,22
1656799607739,CSE 190,A00,092507,Dubnov; Shlomo,7,0,20,13
1656799613763,ECE 45,A01,083139,Congero; Spencer William,5,0,75,70
1656799619788,ECE 65,A50,083695,Saad; Andrew S,12,0,30,18
1656799619788,ECE 65,A51,095125,Saad; Andrew S,25,0,26,1
1656799625815,ECE 109,A01,091882,Touri; Behrouz,15,0,70,55
1656799631841,ECE 180,A00,083140,Abi Samra; Nicholas Camill,0,0,30,30
1656799631841,ECE 180,B00,083141,Abi Samra; Nicholas Camill,0,0,30,30
1656799637868,MATH 10A,A01,083735,Patchell; Gregory David,1,0,30,29
1656799637868,MATH 10A,A02,083736,Patchell; Gregory David,20,0,30,10
1656799637868,MATH 10A,A03,083737,Patchell; Gregory David,15,0,30,15
1656799643896,MATH 10B,A01,083207,Lim; Seonhee,7,0,34,27
1656799643896,MATH 10B,A02,083208,Lim; Seonhee,9,0,35,26
1656799643896,MATH 10B,A03,093472,Lim; Seonhee,4,0,34,30
1656799643896,MATH 10B,B01,083739,Sinha; Shubham,9,0,30,21
1656799649927,MATH 18,A01,083743,Cinel; Cameron Alexander,6,0,30,24
1656799649927,MATH 18,A02,083744,Cinel; Cameron Alexander,15,0,30,15
1656799649927,MATH 18,A03,083745,Cinel; Cameron Alexander,8,0,30,22
1656799649927,MATH 18,B01,083748,Rideout; David Porter,3,0,37,34
1656799649927,MATH 18,B02,083749,Rideout; David Porter,3,0,36,33
1656799649927,MATH 18,B03,083750,Rideout; David Porter,1,0,37,36
1656799649927,MATH 18,B04,083751,Rideout; David Porter,5,0,36,31
1656799649927,MATH 18,B05,093473,Rideout; David Porter,4,0,36,32
1656799649927,MATH 18,B06,093474,Rideout; David Porter,5,0,36,31
1656799655951,MATH 20A,A01,083754,Zheng; Zequn,12,0,40,28
1656799661973,MATH 20B,A01,083756,Briones; Jor-el Thomas Caparas,1,0,36,35
1656799661973,MATH 20B,A02,083757,Briones; Jor-el Thomas Caparas,1,0,36,35
1656799661973,MATH 20B,A03,093475,Briones; Jor-el Thomas Caparas,0,0,36,36
1656799667997,MATH 20C,A01,083760,Briones; Jor-el Thomas Caparas,1,0,35,34
1656799667997,MATH 20C,A02,083761,Briones; Jor-el Thomas Caparas,8,0,35,27
1656799667997,MATH 20C,A03,093476,Briones; Jor-el Thomas Caparas,0,1,36,36
1656799667997,MATH 20C,B01,083762,Bach; Quang Tran,0,0,30,30
1656799674022,MATH 20D,A01,083765,Tran; Brian Kha,4,0,30,26
1656799674022,MATH 20D,A02,083766,Tran; Brian Kha,4,0,30,26
1656799674022,MATH 20D,A03,083767,Tran; Brian Kha,2,0,30,28
1656799680049,MATH 20E,A01,083771,Ganguly; Soumya,5,0,32,27
1656799680049,MATH 20E,A02,083772,Ganguly; Soumya,5,0,32,27
1656799680049,MATH 20E,B01,083773,Ciotti; Benjamin,18,0,35,17
1656799680049,MATH 20E,B02,083774,Ciotti; Benjamin,17,0,35,18
1656799686073,MATH 103A,A01,083777,Greenfeld; Be'Eri,2,0,36,34
1656799686073,MATH 103A,A02,083778,Greenfeld; Be'Eri,5,0,36,31
1656799686073,MATH 103A,A03,093561,Greenfeld; Be'Eri,4,0,36,32
1656799686073,MATH 103A,B01,083779,Greenfeld; Be'Eri,6,0,36,30
1656799686073,MATH 103A,B02,083780,Greenfeld; Be'Eri,2,0,36,34
1656799686073,MATH 103A,B03,093562,Greenfeld; Be'Eri,2,0,36,34
1656799692101,MATH 105,A01,085443,Carter; Anne Toulson,13,0,35,22
1656799692101,MATH 105,A02,093477,Carter; Anne Toulson,20,0,35,15
1656799698132,MATH 109,A01,083213,Ganzberger; Geoffrey Michael,2,0,34,32
1656799698132,MATH 109,A02,083214,Ganzberger; Geoffrey Michael,2,0,34,32
1656799698132,MATH 109,A03,093478,Ganzberger; Geoffrey Michael,1,0,34,33
1656799698132,MATH 109,B01,083215,Ganzberger; Geoffrey Michael,1,0,32,31
1656799698132,MATH 109,B02,083216,Ganzberger; Geoffrey Michael,1,0,32,31
1656799698132,MATH 109,B03,093479,Ganzberger; Geoffrey Michael,6,0,32,26
1656799704155,MATH 142A,A01,083219,Chow; Bennett,6,0,32,26
1656799704155,MATH 142A,A02,083220,Chow; Bennett,9,0,32,23
1656799704155,MATH 142A,A03,093480,Chow; Bennett,7,0,32,25
1656799704155,MATH 142A,B03,093481,Chow; Bennett,7,0,32,25
1656799704155,MATH 142A,B04,093558,Chow; Bennett,10,0,32,22
1656799704155,MATH 142A,B05,093559,Chow; Bennett,6,0,32,26
1656799710178,MATH 193A,A01,083224,Rotar; Vladimir,6,0,34,28
1656799710178,MATH 193A,A02,083225,Rotar; Vladimir,3,0,34,31
1656799710178,MATH 193A,A03,083781,Rotar; Vladimir,1,0,34,33
1656799710178,MATH 193A,A04,083782,Rotar; Vladimir,6,0,34,28
1656799710178,MATH 193A,A05,093482,Rotar; Vladimir,6,0,34,28
1656799716204,MATH 197,001,091859,McAuley; Julian John,9999,0,9999,0
1656799716204,MATH 197,002,095566,Kedlaya; Kiran S.,9997,0,9999,2
1656799716204,MATH 197,003,095567,Xiao; Ming,9999,0,9999,0
1656799716204,MATH 197,004,095571,Perols; Johan Lars,9998,0,9999,1
1656799723254,COGS 9,A01,083615,Shannon; Kyle Michael,6,0,75,69
1656799729282,COGS 11,A01,083617,Boyle; Mary E. T.,18,0,48,30
1656799735306,COGS 13,A01,083071,Bastos; Amalia Pinkusfeld,8,0,71,63
1656799741328,COGS 14A,A01,092681,Semenuks; Arturs,0,1,100,100
1656799747352,COGS 14B,A01,083073,Cheng; Tzu-Han,5,0,63,58
1656799753378,COGS 17,A01,092677,Semenuks; Arturs,4,0,81,77
1656799759403,COGS 100,A01,083619,Allen; Michael Gordon,15,0,70,55
1656799765430,COGS 101A,A01,083621,Davis; Joshua Daniel,9,0,68,59
1656799771454,COGS 101B,A01,091572,Allen; Michael Gordon,8,0,65,57
1656799777480,COGS 101C,A01,083625,Delgado; Tania,17,0,35,18
1656799783508,COGS 107A,A01,083627,Boyle; Mary E. T.,13,0,60,47
1656799789610,COGS 118A,A01,083075,Gupta; Anjum,15,0,76,61
1656799795637,CSE 3,A50,083646,Miranda; Gregory Joseph,22,0,50,28
1656799801671,CSE 8A,A50,083650,Miranda; Gregory Joseph,17,1,56,39
1656799807694,CSE 11,A01,083080,Cao; Yingjun,4,15,40,36
1656799813727,CSE 12,A01,083652,Krause-Levy; Sophia Louisa,20,1,120,100
1656799819750,CSE 15L,A01,083654,Morris; Justin Loren,8,0,50,42
1656799819750,CSE 15L,A02,083655,Morris; Justin Loren,8,0,50,42
1656799825777,CSE 20,A01,083657,Tran; Khoa Dang,37,0,80,43
1656799831801,CSE 21,A01,095574,Bach; Quang Tran,21,0,48,27
1656799837827,CSE 30,A01,083084,Eldon; John,4,0,80,76
1656799837827,CSE 30,B01,095061,Bhaskar; Nishant,5,0,50,45
1656799843853,CSE 100,A01,083659,Cao; Yingjun,1,4,70,69
1656799849879,CSE 134B,A01,083661,Powell; Thomas Allan,18,0,100,82
1656799855905,CSE 140,A01,083663,Gungor; Onat,14,0,85,71
1656799861932,CSE 140L,A01,083088,Eldon; John,16,0,100,84
1656799867956,CSE 175,A01,083665,Kumar; Rakesh,3,0,25,22
1656799873977,CSE 190,A00,092507,Dubnov; Shlomo,7,0,20,13
1656799880000,ECE 45,A01,083139,Congero; Spencer William,5,0,75,70
1656799886024,ECE 65,A50,083695,Saad; Andrew S,12,0,30,18
1656799886024,ECE 65,A51,095125,Saad; Andrew S,25,0,26,1
1656799892051,ECE 109,A01,091882,Touri; Behrouz,15,0,70,55
1656799898076,ECE 180,A00,083140,Abi Samra; Nicholas Camill,0,0,30,30
1656799898076,ECE 180,B00,083141,Abi Samra; Nicholas Camill,0,0,30,30
1656799904100,MATH 10A,A01,083735,Patchell; Gregory David,1,0,30,29
1656799904100,MATH 10A,A02,083736,Patchell; Gregory David,20,0,30,10
1656799904100,MATH 10A,A03,083737,Patchell; Gregory David,15,0,30,15
1656799910124,MATH 10B,A01,083207,Lim; Seonhee,7,0,34,27
1656799910124,MATH 10B,A02,083208,Lim; Seonhee,9,0,35,26
1656799910124,MATH 10B,A03,093472,Lim; Seonhee,4,0,34,30
1656799910124,MATH 10B,B01,083739,Sinha; Shubham,9,0,30,21
1656799916149,MATH 18,A01,083743,Cinel; Cameron Alexander,6,0,30,24
1656799916149,MATH 18,A02,083744,Cinel; Cameron Alexander,15,0,30,15
1656799916149,MATH 18,A03,083745,Cinel; Cameron Alexander,8,0,30,22
1656799916149,MATH 18,B01,083748,Rideout; David Porter,3,0,37,34
1656799916149,MATH 18,B02,083749,Rideout; David Porter,3,0,36,33
1656799916149,MATH 18,B03,083750,Rideout; David Porter,1,0,37,36
1656799916149,MATH 18,B04,083751,Rideout; David Porter,5,0,36,31
1656799916149,MATH 18,B05,093473,Rideout; David Porter,4,0,36,32
1656799916149,MATH 18,B06,093474,Rideout; David Porter,5,0,36,31
1656799922171,MATH 20A,A01,083754,Zheng; Zequn,12,0,40,28
1656799928195,MATH 20B,A01,083756,Briones; Jor-el Thomas Caparas,1,0,36,35
1656799928195,MATH 20B,A02,083757,Briones; Jor-el Thomas Caparas,1,0,36,35
1656799928195,MATH 20B,A03,093475,Briones; Jor-el Thomas Caparas,0,0,36,36
1656799934218,MATH 20C,A01,083760,Briones; Jor-el Thomas Caparas,1,0,35,34
1656799934218,MATH 20C,A02,083761,Briones; Jor-el Thomas Caparas,8,0,35,27
1656799934218,MATH 20C,A03,093476,Briones; Jor-el Thomas Caparas,0,1,36,36
1656799934218,MATH 20C,B01,083762,Bach; Quang Tran,0,0,30,30
1656799940316,MATH 20D,A01,083765,Tran; Brian Kha,4,0,30,26
1656799940316,MATH 20D,A02,083766,Tran; Brian Kha,4,0,30,26
1656799940316,MATH 20D,A03,083767,Tran; Brian Kha,2,0,30,28
1656799946339,MATH 20E,A01,083771,Ganguly; Soumya,5,0,32,27
1656799946339,MATH 20E,A02,083772,Ganguly; Soumya,5,0,32,27
1656799946339,MATH 20E,B01,083773,Ciotti; Benjamin,18,0,35,17
1656799946339,MATH 20E,B02,083774,Ciotti; Benjamin,17,0,35,18
1656799952363,MATH 103A,A01,083777,Greenfeld; Be'Eri,2,0,36,34
1656799952363,MATH 103A,A02,083778,Greenfeld; Be'Eri,5,0,36,31
1656799952363,MATH 103A,A03,093561,Greenfeld; Be'Eri,4,0,36,32
1656799952363,MATH 103A,B01,083779,Greenfeld; Be'Eri,6,0,36,30
1656799952363,MATH 103A,B02,083780,Greenfeld; Be'Eri,2,0,36,34
1656799952363,MATH 103A,B03,093562,Greenfeld; Be'Eri,2,0,36,34
1656799958387,MATH 105,A01,085443,Carter; Anne Toulson,13,0,35,22
1656799958387,MATH 105,A02,093477,Carter; Anne Toulson,20,0,35,15
1656799964415,MATH 109,A01,083213,Ganzberger; Geoffrey Michael,2,0,34,32
1656799964415,MATH 109,A02,083214,Ganzberger; Geoffrey Michael,2,0,34,32
1656799964415,MATH 109,A03,093478,Ganzberger; Geoffrey Michael,1,0,34,33
1656799964415,MATH 109,B01,083215,Ganzberger; Geoffrey Michael,1,0,32,31
1656799964415,MATH 109,B02,083216,Ganzberger; Geoffrey Michael,1,0,32,31
1656799964415,MATH 109,B03,093479,Ganzberger; Geoffrey Michael,6,0,32,26
1656799970439,MATH 142A,A01,083219,Chow; Bennett,6,0,32,26
1656799970439,MATH 142A,A02,083220,Chow; Bennett,9,0,32,23
1656799970439,MATH 142A,A03,093480,Chow; Bennett,7,0,32,25
1656799970439,MATH 142A,B03,093481,Chow; Bennett,7,0,32,25
1656799970439,MATH 142A,B04,093558,Chow; Bennett,10,0,32,22
1656799970439,MATH 142A,B05,093559,Chow; Bennett,6,0,32,26
1656799976461,MATH 193A,A01,083224,Rotar; Vladimir,6,0,34,28
1656799976461,MATH 193A,A02,083225,Rotar; Vladimir,3,0,34,31
1656799976461,MATH 193A,A03,083781,Rotar; Vladimir,1,0,34,33
1656799976461,MATH 193A,A04,083782,Rotar; Vladimir,6,0,34,28
1656799976461,MATH 193A,A05,093482,Rotar; Vladimir,6,0,34,28
1656799982484,MATH 197,001,091859,McAuley; Julian John,9999,0,9999,0
1656799982484,MATH 197,002,095566,Kedlaya; Kiran S.,9997,0,9999,2
1656799982484,MATH 197,003,095567,Xiao; Ming,9999,0,9999,0
1656799982484,MATH 197,004,095571,Perols; Johan Lars,9998,0,9999,1
1656799989536,COGS 9,A01,083615,Shannon; Kyle Michael,6,0,75,69
1656799995557,COGS 11,A01,083617,Boyle; Mary E. T.,18,0,48,30
1656800001580,COGS 13,A01,083071,Bastos; Amalia Pinkusfeld,8,0,71,63
1656800007614,COGS 14A,A01,092681,Semenuks; Arturs,0,1,100,100
1656800013640,COGS 14B,A01,083073,Cheng; Tzu-Han,5,0,63,58
1656800019665,COGS 17,A01,092677,Semenuks; Arturs,4,0,81,77
1656800025693,COGS 100,A01,083619,Allen; Michael Gordon,15,0,70,55
1656800031715,COGS 101A,A01,083621,Davis; Joshua Daniel,9,0,68,59
1656800037737,COGS 101B,A01,091572,Allen; Michael Gordon,8,0,65,57
1656800043764,COGS 101C,A01,083625,Delgado; Tania,17,0,35,18
1656800049788,COGS 107A,A01,083627,Boyle; Mary E. T.,13,0,60,47
1656800055811,COGS 118A,A01,083075,Gupta; Anjum,15,0,76,61
1656800061839,CSE 3,A50,083646,Miranda; Gregory Joseph,22,0,50,28
1656800067863,CSE 8A,A50,083650,Miranda; Gregory Joseph,17,1,56,39
1656800073889,CSE 11,A01,083080,Cao; Yingjun,4,15,40,36
1656800079917,CSE 12,A01,083652,Krause-Levy; Sophia Louisa,20,1,120,100
1656800085944,CSE 15L,A01,083654,Morris; Justin Loren,8,0,50,42
1656800085944,CSE 15L,A02,083655,Morris; Justin Loren,8,0,50,42
1656800091966,CSE 20,A01,083657,Tran; Khoa Dang,37,0,80,43
1656800097990,CSE 21,A01,095574,Bach; Quang Tran,21,0,48,27
1656800104019,CSE 30,A01,083084,Eldon; John,4,0,80,76
1656800104019,CSE 30,B01,095061,Bhaskar; Nishant,5,0,50,45
1656800110042,CSE 100,A01,083659,Cao; Yingjun,1,4,70,69
1656800116067,CSE 134B,A01,083661,Powell; Thomas Allan,18,0,100,82
1656800122091,CSE 140,A01,083663,Gungor; Onat,14,0,85,71
1656800128119,CSE 140L,A01,083088,Eldon; John,16,0,100,84
1656800134152,CSE 175,A01,083665,Kumar; Rakesh,3,0,25,22
1656800140176,CSE 190,A00,092507,Dubnov; Shlomo,7,0,20,13
1656800146203,ECE 45,A01,083139,Congero; Spencer William,5,0,75,70
1656800152226,ECE 65,A50,083695,Saad; Andrew S,12,0,30,18
1656800152226,ECE 65,A51,095125,Saad; Andrew S,25,0,26,1
1656800158250,ECE 109,A01,091882,Touri; Behrouz,15,0,70,55
1656800164278,ECE 180,A00,083140,Abi Samra; Nicholas Camill,0,0,30,30
1656800164278,ECE 180,B00,083141,Abi Samra; Nicholas Camill,0,0,30,30
1656800170303,MATH 10A,A01,083735,Patchell; Gregory David,1,0,30,29
1656800170303,MATH 10A,A02,083736,Patchell; Gregory David,20,0,30,10
1656800170303,MATH 10A,A03,083737,Patchell; Gregory David,15,0,30,15
1656800176330,MATH 10B,A01,083207,Lim; Seonhee,7,0,34,27
1656800176330,MATH 10B,A02,083208,Lim; Seonhee,9,0,35,26
1656800176330,MATH 10B,A03,093472,Lim; Seonhee,4,0,34,30
1656800176330,MATH 10B,B01,083739,Sinha; Shubham,9,0,30,21
1656800182356,MATH 18,A01,083743,Cinel; Cameron Alexander,6,0,30,24
1656800182356,MATH 18,A02,083744,Cinel; Cameron Alexander,15,0,30,15
1656800182356,MATH 18,A03,083745,Cinel; Cameron Alexander,8,0,30,22
1656800182356,MATH 18,B01,083748,Rideout; David Porter,3,0,37,34
1656800182356,MATH 18,B02,083749,Rideout; David Porter,3,0,36,33
1656800182356,MATH 18,B03,083750,Rideout; David Porter,1,0,37,36
1656800182356,MATH 18,B04,083751,Rideout; David Porter,5,0,36,31
1656800182356,MATH 18,B05,093473,Rideout; David Porter,4,0,36,32
1656800182356,MATH 18,B06,093474,Rideout; David Porter,5,0,36,31
1656800188384,MATH 20A,A01,083754,Zheng; Zequn,12,0,40,28
1656800194408,MATH 20B,A01,083756,Briones; Jor-el Thomas Caparas,1,0,36,35
1656800194408,MATH 20B,A02,083757,Briones; Jor-el Thomas Caparas,1,0,36,35
1656800194408,MATH 20B,A03,093475,Briones; Jor-el Thomas Caparas,0,0,36,36
1656800200437,MATH 20C,A01,083760,Briones; Jor-el Thomas Caparas,1,0,35,34
1656800200437,MATH 20C,A02,083761,Briones; Jor-el Thomas Caparas,8,0,35,27
1656800200437,MATH 20C,A03,093476,Briones; Jor-el Thomas Caparas,0,1,36,36
1656800200437,MATH 20C,B01,083762,Bach; Quang Tran,0,0,30,30
1656800206466,MATH 20D,A01,083765,Tran; Brian Kha,4,0,30,26
1656800206466,MATH 20D,A02,083766,Tran; Brian Kha,4,0,30,26
1656800206466,MATH 20D,A03,083767,Tran; Brian Kha,2,0,30,28
1656800212490,MATH 20E,A01,083771,Ganguly; Soumya,5,0,32,27
1656800212490,MATH 20E,A02,083772,Ganguly; Soumya,5,0,32,27
1656800212490,MATH 20E,B01,083773,Ciotti; Benjamin,18,0,35,17
1656800212490,MATH 20E,B02,083774,Ciotti; Benjamin,17,0,35,18
1656800218518,MATH 103A,A01,083777,Greenfeld; Be'Eri,2,0,36,34
1656800218518,MATH 103A,A02,083778,Greenfeld; Be'Eri,5,0,36,31
1656800218518,MATH 103A,A03,093561,Greenfeld; Be'Eri,4,0,36,32
1656800218518,MATH 103A,B01,083779,Greenfeld; Be'Eri,6,0,36,30
1656800218518,MATH 103A,B02,083780,Greenfeld; Be'Eri,2,0,36,34
1656800218518,MATH 103A,B03,093562,Greenfeld; Be'Eri,2,0,36,34
1656800224546,MATH 105,A01,085443,Carter; Anne Toulson,13,0,35,22
1656800224546,MATH 105,A02,093477,Carter; Anne Toulson,20,0,35,15
1656800230575,MATH 109,A01,083213,Ganzberger; Geoffrey Michael,2,0,34,32
1656800230575,MATH 109,A02,083214,Ganzberger; Geoffrey Michael,2,0,34,32
1656800230575,MATH 109,A03,093478,Ganzberger; Geoffrey Michael,1,0,34,33
1656800230575,MATH 109,B01,083215,Ganzberger; Geoffrey Michael,1,0,32,31
1656800230575,MATH 109,B02,083216,Ganzberger; Geoffrey Michael,1,0,32,31
1656800230575,MATH 109,B03,093479,Ganzberger; Geoffrey Michael,6,0,32,26
1656800236605,MATH 142A,A01,083219,Chow; Bennett,6,0,32,26
1656800236605,MATH 142A,A02,083220,Chow; Bennett,9,0,32,23
1656800236605,MATH 142A,A03,093480,Chow; Bennett,7,0,32,25
1656800236605,MATH 142A,B03,093481,Chow; Bennett,7,0,32,25
1656800236605,MATH 142A,B04,093558,Chow; Bennett,10,0,32,22
1656800236605,MATH 142A,B05,093559,Chow; Bennett,6,0,32,26
1656800242632,MATH 193A,A01,083224,Rotar; Vladimir,6,0,34,28
1656800242632,MATH 193A,A02,083225,Rotar; Vladimir,3,0,34,31
1656800242632,MATH 193A,A03,083781,Rotar; Vladimir,1,0,34,33
1656800242632,MATH 193A,A04,083782,Rotar; Vladimir,6,0,34,28
1656800242632,MATH 193A,A05,093482,Rotar; Vladimir,6,0,34,28
1656800248656,MATH 197,001,091859,McAuley; Julian John,9999,0,9999,0
1656800248656,MATH 197,002,095566,Kedlaya; Kiran S.,9997,0,9999,2
1656800248656,MATH 197,003,095567,Xiao; Ming,9999,0,9999,0
1656800248656,MATH 197,004,095571,Perols; Johan Lars,9998,0,9999,1
1656800255712,COGS 9,A01,083615,Shannon; Kyle Michael,6,0,75,69
1656800261738,COGS 11,A01,083617,Boyle; Mary E. T.,18,0,48,30
1656800267761,COGS 13,A01,083071,Bastos; Amalia Pinkusfeld,8,0,71,63
1656800273787,COGS 14A,A01,092681,Semenuks; Arturs,0,1,100,100
1656800279817,COGS 14B,A01,083073,Cheng; Tzu-Han,5,0,63,58
1656800285838,COGS 17,A01,092677,Semenuks; Arturs,4,0,81,77
1656800291872,COGS 100,A01,083619,Allen; Michael Gordon,15,0,70,55
1656800297896,COGS 101A,A01,083621,Davis; Joshua Daniel,9,0,68,59
1656800303919,COGS 101B,A01,091572,Allen; Michael Gordon,8,0,65,57
1656800309946,COGS 101C,A01,083625,Delgado; Tania,17,0,35,18
1656800315972,COGS 107A,A01,083627,Boyle; Mary E. T.,13,0,60,47
1656800321996,COGS 118A,A01,083075,Gupta; Anjum,15,0,76,61
1656800328026,CSE 3,A50,083646,Miranda; Gregory Joseph,22,0,50,28
1656800334059,CSE 8A,A50,083650,Miranda; Gregory Joseph,17,1,56,39
1656800340086,CSE 11,A01,083080,Cao; Yingjun,4,15,40,36
1656800346112,CSE 12,A01,083652,Krause-Levy; Sophia Louisa,20,1,120,100
1656800352137,CSE 15L,A01,083654,Morris; Justin Loren,8,0,50,42
1656800352137,CSE 15L,A02,083655,Morris; Justin Loren,8,0,50,42
1656800358165,CSE 20,A01,083657,Tran; Khoa Dang,37,0,80,43
1656800364188,CSE 21,A01,095574,Bach; Quang Tran,21,0,48,27
1656800370209,CSE 30,A01,083084,Eldon; John,4,0,80,76
1656800370209,CSE 30,B01,095061,Bhaskar; Nishant,5,0,50,45
1656800376233,CSE 100,A01,083659,Cao; Yingjun,1,4,70,69
1656800382257,CSE 134B,A01,083661,Powell; Thomas Allan,18,0,100,82
1656800388284,CSE 140,A01,083663,Gungor; Onat,14,0,85,71
1656800394317,CSE 140L,A01,083088,Eldon; John,16,0,100,84
1656800400344,CSE 175,A01,083665,Kumar; Rakesh,3,0,25,22
1656800406370,CSE 190,A00,092507,Dubnov; Shlomo,7,0,20,13
1656800412395,ECE 45,A01,083139,Congero; Spencer William,5,0,75,70
1656800418419,ECE 65,A50,083695,Saad; Andrew S,12,0,30,18
1656800418419,ECE 65,A51,095125,Saad; Andrew S,25,0,26,1
1656800424444,ECE 109,A01,091882,Touri; Behrouz,15,0,70,55
1656800430470,ECE 180,A00,083140,Abi Samra; Nicholas Camill,0,0,30,30
1656800430470,ECE 180,B00,083141,Abi Samra; Nicholas Camill,0,0,30,30
1656800436501,MATH 10A,A01,083735,Patchell; Gregory David,1,0,30,29
1656800436501,MATH 10A,A02,083736,Patchell; Gregory David,20,0,30,10
1656800436501,MATH 10A,A03,083737,Patchell; Gregory David,15,0,30,15
1656800442531,MATH 10B,A01,083207,Lim; Seonhee,7,0,34,27
1656800442531,MATH 10B,A02,083208,Lim; Seonhee,9,0,35,26
1656800442531,MATH 10B,A03,093472,Lim; Seonhee,4,0,34,30
1656800442531,MATH 10B,B01,083739,Sinha; Shubham,9,0,30,21
1656800448555,MATH 18,A01,083743,Cinel; Cameron Alexander,6,0,30,24
1656800448555,MATH 18,A02,083744,Cinel; Cameron Alexander,15,0,30,15
1656800448555,MATH 18,A03,083745,Cinel; Cameron Alexander,8,0,30,22
1656800448555,MATH 18,B01,083748,Rideout; David Porter,3,0,37,34
1656800448555,MATH 18,B02,083749,Rideout; David Porter,3,0,36,33
1656800448555,MATH 18,B03,083750,Rideout; David Porter,1,0,37,36
1656800448555,MATH 18,B04,083751,Rideout; David Porter,5,0,36,31
1656800448555,MATH 18,B05,093473,Rideout; David Porter,4,0,36,32
1656800448555,MATH 18,B06,093474,Rideout; David Porter,5,0,36,31
1656800454578,MATH 20A,A01,083754,Zheng; Zequn,12,0,40,28
1656800460609,MATH 20B,A01,083756,Briones; Jor-el Thomas Caparas,1,0,36,35
1656800460609,MATH 20B,A02,083757,Briones; Jor-el Thomas Caparas,1,0,36,35
1656800460609,MATH 20B,A03,093475,Briones; Jor-el Thomas Caparas,0,0,36,36
1656800466632,MATH 20C,A01,083760,Briones; Jor-el Thomas Caparas,1,0,35,34
1656800466632,MATH 20C,A02,083761,Briones; Jor-el Thomas Caparas,8,0,35,27
1656800466632,MATH 20C,A03,093476,Briones; Jor-el Thomas Caparas,0,1,36,36
1656800466632,MATH 20C,B01,083762,Bach; Quang Tran,0,0,30,30
1656800472660,MATH 20D,A01,083765,Tran; Brian Kha,4,0,30,26
1656800472660,MATH 20D,A02,083766,Tran; Brian Kha,4,0,30,26
1656800472660,MATH 20D,A03,083767,Tran; Brian Kha,2,0,30,28
1656800478697,MATH 20E,A01,083771,Ganguly; Soumya,5,0,32,27
1656800478697,MATH 20E,A02,083772,Ganguly; Soumya,5,0,32,27
1656800478697,MATH 20E,B01,083773,Ciotti; Benjamin,18,0,35,17
1656800478697,MATH 20E,B02,083774,Ciotti; Benjamin,17,0,35,18
1656800484723,MATH 103A,A01,083777,Greenfeld; Be'Eri,2,0,36,34
1656800484723,MATH 103A,A02,083778,Greenfeld; Be'Eri,5,0,36,31
1656800484723,MATH 103A,A03,093561,Greenfeld; Be'Eri,4,0,36,32
1656800484723,MATH 103A,B01,083779,Greenfeld; Be'Eri,6,0,36,30
1656800484723,MATH 103A,B02,083780,Greenfeld; Be'Eri,2,0,36,34
1656800484723,MATH 103A,B03,093562,Greenfeld; Be'Eri,2,0,36,34
1656800490746,MATH 105,A01,085443,Carter; Anne Toulson,13,0,35,22
1656800490746,MATH 105,A02,093477,Carter; Anne Toulson,20,0,35,15
1656800496768,MATH 109,A01,083213,Ganzberger; Geoffrey Michael,2,0,34,32
1656800496768,MATH 109,A02,083214,Ganzberger; Geoffrey Michael,2,0,34,32
1656800496768,MATH 109,A03,093478,Ganzberger; Geoffrey Michael,1,0,34,33
1656800496768,MATH 109,B01,083215,Ganzberger; Geoffrey Michael,1,0,32,31
1656800496768,MATH 109,B02,083216,Ganzberger; Geoffrey Michael,1,0,32,31
1656800496768,MATH 109,B03,093479,Ganzberger; Geoffrey Michael,6,0,32,26
1656800502798,MATH 142A,A01,083219,Chow; Bennett,6,0,32,26
1656800502798,MATH 142A,A02,083220,Chow; Bennett,9,0,32,23
1656800502798,MATH 142A,A03,093480,Chow; Bennett,7,0,32,25
1656800502798,MATH 142A,B03,093481,Chow; Bennett,7,0,32,25
1656800502798,MATH 142A,B04,093558,Chow; Bennett,10,0,32,22
1656800502798,MATH 142A,B05,093559,Chow; Bennett,6,0,32,26
1656800508821,MATH 193A,A01,083224,Rotar; Vladimir,6,0,34,28
1656800508821,MATH 193A,A02,083225,Rotar; Vladimir,3,0,34,31
1656800508821,MATH 193A,A03,083781,Rotar; Vladimir,1,0,34,33
1656800508821,MATH 193A,A04,083782,Rotar; Vladimir,6,0,34,28
1656800508821,MATH 193A,A05,093482,Rotar; Vladimir,6,0,34,28
1656800514844,MATH 197,001,091859,McAuley; Julian John,9999,0,9999,0
1656800514844,MATH 197,002,095566,Kedlaya; Kiran S.,9997,0,9999,2
1656800514844,MATH 197,003,095567,Xiao; Ming,9999,0,9999,0
1656800514844,MATH 197,004,095571,Perols; Johan Lars,9998,0,9999,1
1656800521896,COGS 9,A01,083615,Shannon; Kyle Michael,6,0,75,69
1656800527927,COGS 11,A01,083617,Boyle; Mary E. T.,18,0,48,30
1656800534038,COGS 13,A01,083071,Bastos; Amalia Pinkusfeld,8,0,71,63
1656800540065,COGS 14A,A01,092681,Semenuks; Arturs,0,1,100,100
1656800546089,COGS 14B,A01,083073,Cheng; Tzu-Han,5,0,63,58
1656800552115,COGS 17,A01,092677,Semenuks; Arturs,4,0,81,77
1656800558138,COGS 100,A01,083619,Allen; Michael Gordon,15,0,70,55
1656800564168,COGS 101A,A01,083621,Davis; Joshua Daniel,9,0,68,59
1656800570194,COGS 101B,A01,091572,Allen; Michael Gordon,8,0,65,57
1656800576222,COGS 101C,A01,083625,Delgado; Tania,17,0,35,18
1656800582253,COGS 107A,A01,083627,Boyle; Mary E. T.,13,0,60,47
1656800588276,COGS 118A,A01,083075,Gupta; Anjum,15,0,76,61
1656800594300,CSE 3,A50,083646,Miranda; Gregory Joseph,22,0,50,28
1656800600327,CSE 8A,A50,083650,Miranda; Gregory Joseph,17,1,56,39
1656800606350,CSE 11,A01,083080,Cao; Yingjun,4,15,40,36
1656800612378,CSE 12,A01,083652,Krause-Levy; Sophia Louisa,20,1,120,100
1656800618403,CSE 15L,A01,083654,Morris; Justin Loren,8,0,50,42
1656800618403,CSE 15L,A02,083655,Morris; Justin Loren,8,0,50,42
1656800624429,CSE 20,A01,083657,Tran; Khoa Dang,37,0,80,43
1656800630452,CSE 21,A01,095574,Bach; Quang Tran,21,0,48,27
1656800636477,CSE 30,A01,083084,Eldon; John,4,0,80,76
1656800636477,CSE 30,B01,095061,Bhaskar; Nishant,5,0,50,45
1656800642508,CSE 100,A01,083659,Cao; Yingjun,1,4,70,69
1656800648532,CSE 134B,A01,083661,Powell; Thomas Allan,18,0,100,82
1656800654560,CSE 140,A01,083663,Gungor; Onat,14,0,85,71
1656800660584,CSE 140L,A01,083088,Eldon; John,16,0,100,84
1656800666606,CSE 175,A01,083665,Kumar; Rakesh,3,0,25,22
1656800672630,CSE 190,A00,092507,Dubnov; Shlomo,7,0,20,13
1656800678657,ECE 45,A01,083139,Congero; Spencer William,5,0,75,70
1656800684682,ECE 65,A50,083695,Saad; Andrew S,12,0,30,18
1656800684682,ECE 65,A51,095125,Saad; Andrew S,25,0,26,1
1656800690706,ECE 109,A01,091882,Touri; Behrouz,15,0,70,55
1656800696733,ECE 180,A00,083140,Abi Samra; Nicholas Camill,0,0,30,30
1656800696733,ECE 180,B00,083141,Abi Samra; Nicholas Camill,0,0,30,30
1656800702758,MATH 10A,A01,083735,Patchell; Gregory David,1,0,30,29
1656800702758,MATH 10A,A02,083736,Patchell; Gregory David,20,0,30,10
1656800702758,MATH 10A,A03,083737,Patchell; Gregory David,15,0,30,15
1656800708787,MATH 10B,A01,083207,Lim; Seonhee,7,0,34,27
1656800708787,MATH 10B,A02,083208,Lim; Seonhee,9,0,35,26
1656800708787,MATH 10B,A03,093472,Lim; Seonhee,4,0,34,30
1656800708787,MATH 10B,B01,083739,Sinha; Shubham,9,0,30,21
1656800714819,MATH 18,A01,083743,Cinel; Cameron Alexander,6,0,30,24
1656800714819,MATH 18,A02,083744,Cinel; Cameron Alexander,15,0,30,15
1656800714819,MATH 18,A03,083745,Cinel; Cameron Alexander,8,0,30,22
1656800714819,MATH 18,B01,083748,Rideout; David Porter,3,0,37,34
1656800714819,MATH 18,B02,083749,Rideout; David Porter,3,0,36,33
1656800714819,MATH 18,B03,083750,Rideout; David Porter,1,0,37,36
1656800714819,MATH 18,B04,083751,Rideout; David Porter,5,0,36,31
1656800714819,MATH 18,B05,093473,Rideout; David Porter,4,0,36,32
1656800714819,MATH 18,B06,093474,Rideout; David Porter,5,0,36,31
1656800720846,MATH 20A,A01,083754,Zheng; Zequn,12,0,40,28
1656800726869,MATH 20B,A01,083756,Briones; Jor-el Thomas Caparas,1,0,36,35
1656800726869,MATH 20B,A02,083757,Briones; Jor-el Thomas Caparas,1,0,36,35
1656800726869,MATH 20B,A03,093475,Briones; Jor-el Thomas Caparas,0,0,36,36
1656800732896,MATH 20C,A01,083760,Briones; Jor-el Thomas Caparas,1,0,35,34
1656800732896,MATH 20C,A02,083761,Briones; Jor-el Thomas Caparas,8,0,35,27
1656800732896,MATH 20C,A03,093476,Briones; Jor-el Thomas Caparas,0,1,36,36
1656800732896,MATH 20C,B01,083762,Bach; Quang Tran,0,0,30,30
1656800738920,MATH 20D,A01,083765,Tran; Brian Kha,4,0,30,26
1656800738920,MATH 20D,A02,083766,Tran; Brian Kha,4,0,30,26
1656800738920,MATH 20D,A03,083767,Tran; Brian Kha,2,0,30,28
1656800744945,MATH 20E,A01,083771,Ganguly; Soumya,5,0,32,27
1656800744945,MATH 20E,A02,083772,Ganguly; Soumya,5,0,32,27
1656800744945,MATH 20E,B01,083773,Ciotti; Benjamin,18,0,35,17
1656800744945,MATH 20E,B02,083774,Ciotti; Benjamin,17,0,35,18
1656800750967,MATH 103A,A01,083777,Greenfeld; Be'Eri,2,0,36,34
1656800750967,MATH 103A,A02,083778,Greenfeld; Be'Eri,5,0,36,31
1656800750967,MATH 103A,A03,093561,Greenfeld; Be'Eri,4,0,36,32
1656800750967,MATH 103A,B01,083779,Greenfeld; Be'Eri,6,0,36,30
1656800750967,MATH 103A,B02,083780,Greenfeld; Be'Eri,2,0,36,34
1656800750967,MATH 103A,B03,093562,Greenfeld; Be'Eri,2,0,36,34
1656800756995,MATH 105,A01,085443,Carter; Anne Toulson,13,0,35,22
1656800756995,MATH 105,A02,093477,Carter; Anne Toulson,20,0,35,15
1656800763024,MATH 109,A01,083213,Ganzberger; Geoffrey Michael,2,0,34,32
1656800763024,MATH 109,A02,083214,Ganzberger; Geoffrey Michael,2,0,34,32
1656800763024,MATH 109,A03,093478,Ganzberger; Geoffrey Michael,1,0,34,33
1656800763024,MATH 109,B01,083215,Ganzberger; Geoffrey Michael,1,0,32,31
1656800763024,MATH 109,B02,083216,Ganzberger; Geoffrey Michael,1,0,32,31
1656800763024,MATH 109,B03,093479,Ganzberger; Geoffrey Michael,6,0,32,26
1656800769053,MATH 142A,A01,083219,Chow; Bennett,6,0,32,26
1656800769053,MATH 142A,A02,083220,Chow; Bennett,9,0,32,23
1656800769053,MATH 142A,A03,093480,Chow; Bennett,7,0,32,25
1656800769053,MATH 142A,B03,093481,Chow; Bennett,7,0,32,25
1656800769053,MATH 142A,B04,093558,Chow; Bennett,10,0,32,22
1656800769053,MATH 142A,B05,093559,Chow; Bennett,6,0,32,26
1656800775088,MATH 193A,A01,083224,Rotar; Vladimir,6,0,34,28
1656800775088,MATH 193A,A02,083225,Rotar; Vladimir,3,0,34,31
1656800775088,MATH 193A,A03,083781,Rotar; Vladimir,1,0,34,33
1656800775088,MATH 193A,A04,083782,Rotar; Vladimir,6,0,34,28
1656800775088,MATH 193A,A05,093482,Rotar; Vladimir,6,0,34,28
1656800781115,MATH 197,001,091859,McAuley; Julian John,9999,0,9999,0
1656800781115,MATH 197,002,095566,Kedlaya; Kiran S.,9997,0,9999,2
1656800781115,MATH 197,003,095567,Xiao; Ming,9999,0,9999,0
1656800781115,MATH 197,004,095571,Perols; Johan Lars,9998,0,9999,1
1656800788168,COGS 9,A01,083615,Shannon; Kyle Michael,6,0,75,69
1656800794192,COGS 11,A01,083617,Boyle; Mary E. T.,18,0,48,30
1656800800215,COGS 13,A01,083071,Bastos; Amalia Pinkusfeld,8,0,71,63
1656800806249,COGS 14A,A01,092681,Semenuks; Arturs,0,1,100,100
1656800812272,COGS 14B,A01,083073,Cheng; Tzu-Han,5,0,63,58
1656800818304,COGS 17,A01,092677,Semenuks; Arturs,4,0,81,77
1656800824331,COGS 100,A01,083619,Allen; Michael Gordon,15,0,70,55
1656800830360,COGS 101A,A01,083621,Davis; Joshua Daniel,9,0,68,59
1656800836383,COGS 101B,A01,091572,Allen; Michael Gordon,8,0,65,57
1656800842408,COGS 101C,A01,083625,Delgado; Tania,17,0,35,18
1656800848430,COGS 107A,A01,083627,Boyle; Mary E. T.,13,0,60,47
1656800854454,COGS 118A,A01,083075,Gupta; Anjum,15,0,76,61
1656800860479,CSE 3,A50,083646,Miranda; Gregory Joseph,22,0,50,28
1656800866518,CSE 8A,A50,083650,Miranda; Gregory Joseph,17,1,56,39
1656800872545,CSE 11,A01,083080,Cao; Yingjun,4,15,40,36
1656800878572,CSE 12,A01,083652,Krause-Levy; Sophia Louisa,20,1,120,100
1656800884595,CSE 15L,A01,083654,Morris; Justin Loren,8,0,50,42
1656800884595,CSE 15L,A02,083655,Morris; Justin Loren,8,0,50,42
1656800890617,CSE 20,A01,083657,Tran; Khoa Dang,37,0,80,43
1656800896647,CSE 21,A01,095574,Bach; Quang Tran,21,0,48,27
1656800902674,CSE 30,A01,083084,Eldon; John,4,0,80,76
1656800902674,CSE 30,B01,095061,Bhaskar; Nishant,5,0,50,45
1656800908707,CSE 100,A01,083659,Cao; Yingjun,1,4,70,69
1656800914730,CSE 134B,A01,083661,Powell; Thomas Allan,18,0,100,82
1656800920756,CSE 140,A01,083663,Gungor; Onat,14,0,85,71
1656800926780,CSE 140L,A01,083088,Eldon; John,16,0,100,84
1656800932802,CSE 175,A01,083665,Kumar; Rakesh,3,0,25,22
1656800938829,CSE 190,A00,092507,Dubnov; Shlomo,7,0,20,13
1656800944852,ECE 45,A01,083139,Congero; Spencer William,5,0,75,70
1656800950876,ECE 65,A50,083695,Saad; Andrew S,12,0,30,18
1656800950876,ECE 65,A51,095125,Saad; Andrew S,25,0,26,1
1656800956902,ECE 109,A01,091882,Touri; Behrouz,15,0,70,55
1656800962928,ECE 180,A00,083140,Abi Samra; Nicholas Camill,0,0,30,30
1656800962928,ECE 180,B00,083141,Abi Samra; Nicholas Camill,0,0,30,30
1656800968952,MATH 10A,A01,083735,Patchell; Gregory David,1,0,30,29
1656800968952,MATH 10A,A02,083736,Patchell; Gregory David,20,0,30,10
1656800968952,MATH 10A,A03,083737,Patchell; Gregory David,15,0,30,15
1656800974980,MATH 10B,A01,083207,Lim; Seonhee,7,0,34,27
1656800974980,MATH 10B,A02,083208,Lim; Seonhee,9,0,35,26
1656800974980,MATH 10B,A03,093472,Lim; Seonhee,4,0,34,30
1656800974980,MATH 10B,B01,083739,Sinha; Shubham,9,0,30,21
1656800981007,MATH 18,A01,083743,Cinel; Cameron Alexander,6,0,30,24
1656800981007,MATH 18,A02,083744,Cinel; Cameron Alexander,15,0,30,15
1656800981007,MATH 18,A03,083745,Cinel; Cameron Alexander,8,0,30,22
1656800981007,MATH 18,B01,083748,Rideout; David Porter,3,0,37,34
1656800981007,MATH 18,B02,083749,Rideout; David Porter,3,0,36,33
1656800981007,MATH 18,B03,083750,Rideout; David Porter,1,0,37,36
1656800981007,MATH 18,B04,083751,Rideout; David Porter,5,0,36,31
1656800981007,MATH 18,B05,093473,Rideout; David Porter,4,0,36,32
1656800981007,MATH 18,B06,093474,Rideout; David Porter,5,0,36,31
1656800987031,MATH 20A,A01,083754,Zheng; Zequn,12,0,40,28
1656800993056,MATH 20B,A01,083756,Briones; Jor-el Thomas Caparas,1,0,36,35
1656800993056,MATH 20B,A02,083757,Briones; Jor-el Thomas Caparas,1,0,36,35
1656800993056,MATH 20B,A03,093475,Briones; Jor-el Thomas Caparas,0,0,36,36
1656800999108,MATH 20C,A01,083760,Briones; Jor-el Thomas Caparas,1,0,35,34
1656800999108,MATH 20C,A02,083761,Briones; Jor-el Thomas Caparas,8,0,35,27
1656800999108,MATH 20C,A03,093476,Briones; Jor-el Thomas Caparas,0,1,36,36
1656800999108,MATH 20C,B01,083762,Bach; Quang Tran,0,0,30,30
1656801005133,MATH 20D,A01,083765,Tran; Brian Kha,4,0,30,26
1656801005133,MATH 20D,A02,083766,Tran; Brian Kha,4,0,30,26
1656801005133,MATH 20D,A03,083767,Tran; Brian Kha,2,0,30,28
1656801011160,MATH 20E,A01,083771,Ganguly; Soumya,5,0,32,27
1656801011160,MATH 20E,A02,083772,Ganguly; Soumya,5,0,32,27
1656801011160,MATH 20E,B01,083773,Ciotti; Benjamin,18,0,35,17
1656801011160,MATH 20E,B02,083774,Ciotti; Benjamin,17,0,35,18
1656801017190,MATH 103A,A01,083777,Greenfeld; Be'Eri,2,0,36,34
1656801017190,MATH 103A,A02,083778,Greenfeld; Be'Eri,5,0,36,31
1656801017190,MATH 103A,A03,093561,Greenfeld; Be'Eri,4,0,36,32
1656801017190,MATH 103A,B01,083779,Greenfeld; Be'Eri,6,0,36,30
1656801017190,MATH 103A,B02,083780,Greenfeld; Be'Eri,2,0,36,34
1656801017190,MATH 103A,B03,093562,Greenfeld; Be'Eri,2,0,36,34
1656801023213,MATH 105,A01,085443,Carter; Anne Toulson,13,0,35,22
1656801023213,MATH 105,A02,093477,Carter; Anne Toulson,20,0,35,15
1656801029237,MATH 109,A01,083213,Ganzberger; Geoffrey Michael,2,0,34,32
1656801029237,MATH 109,A02,083214,Ganzberger; Geoffrey Michael,2,0,34,32
1656801029237,MATH 109,A03,093478,Ganzberger; Geoffrey Michael,1,0,34,33
1656801029237,MATH 109,B01,083215,Ganzberger; Geoffrey Michael,1,0,32,31
1656801029237,MATH 109,B02,083216,Ganzberger; Geoffrey Michael,1,0,32,31
1656801029237,MATH 109,B03,093479,Ganzberger; Geoffrey Michael,6,0,32,26
1656801035266,MATH 142A,A01,083219,Chow; Bennett,6,0,32,26
1656801035266,MATH 142A,A02,083220,Chow; Bennett,9,0,32,23
1656801035266,MATH 142A,A03,093480,Chow; Bennett,7,0,32,25
1656801035266,MATH 142A,B03,093481,Chow; Bennett,7,0,32,25
1656801035266,MATH 142A,B04,093558,Chow; Bennett,10,0,32,22
1656801035266,MATH 142A,B05,093559,Chow; Bennett,6,0,32,26
1656801041298,MATH 193A,A01,083224,Rotar; Vladimir,6,0,34,28
1656801041298,MATH 193A,A02,083225,Rotar; Vladimir,3,0,34,31
1656801041298,MATH 193A,A03,083781,Rotar; Vladimir,1,0,34,33
1656801041298,MATH 193A,A04,083782,Rotar; Vladimir,6,0,34,28
1656801041298,MATH 193A,A05,093482,Rotar; Vladimir,6,0,34,28
1656801047325,MATH 197,001,091859,McAuley; Julian John,9999,0,9999,0
1656801047325,MATH 197,002,095566,Kedlaya; Kiran S.,9997,0,9999,2
1656801047325,MATH 197,003,095567,Xiao; Ming,9999,0,9999,0
1656801047325,MATH 197,004,095571,Perols; Johan Lars,9998,0,9999,1
1656801054377,COGS 9,A01,083615,Shannon; Kyle Michael,6,0,75,69
1656801060406,COGS 11,A01,083617,Boyle; Mary E. T.,18,0,48,30
1656801066433,COGS 13,A01,083071,Bastos; Amalia Pinkusfeld,8,0,71,63
1656801072460,COGS 14A,A01,092681,Semenuks; Arturs,0,1,100,100
1656801078484,COGS 14B,A01,083073,Cheng; Tzu-Han,5,0,63,58
1656801084509,COGS 17,A01,092677,Semenuks; Arturs,4,0,81,77
1656801090550,COGS 100,A01,083619,Allen; Michael Gordon,15,0,70,55
1656801096577,COGS 101A,A01,083621,Davis; Joshua Daniel,9,0,68,59
1656801102609,COGS 101B,A01,091572,Allen; Michael Gordon,8,0,65,57
1656801108635,COGS 101C,A01,083625,Delgado; Tania,17,0,35,18
1656801114658,COGS 107A,A01,083627,Boyle; Mary E. T.,13,0,60,47
1656801120682,COGS 118A,A01,083075,Gupta; Anjum,15,0,76,61
1656801126705,CSE 3,A50,083646,Miranda; Gregory Joseph,22,0,50,28
1656801132806,CSE 8A,A50,083650,Miranda; Gregory Joseph,17,1,56,39
1656801138832,CSE 11,A01,083080,Cao; Yingjun,4,15,40,36
1656801144854,CSE 12,A01,083652,Krause-Levy; Sophia Louisa,20,1,120,100
1656801150880,CSE 15L,A01,083654,Morris; Justin Loren,8,0,50,42
1656801150880,CSE 15L,A02,083655,Morris; Justin Loren,8,0,50,42
1656801156907,CSE 20,A01,083657,Tran; Khoa Dang,37,0,80,43
1656801162931,CSE 21,A01,095574,Bach; Quang Tran,21,0,48,27
1656801168953,CSE 30,A01,083084,Eldon; John,4,0,80,76
1656801168953,CSE 30,B01,095061,Bhaskar; Nishant,5,0,50,45
1656801174979,CSE 100,A01,083659,Cao; Yingjun,1,4,70,69
1656801181006,CSE 134B,A01,083661,Powell; Thomas Allan,18,0,100,82
1656801187028,CSE 140,A01,083663,Gungor; Onat,14,0,85,71
1656801193054,CSE 140L,A01,083088,Eldon; John,16,0,100,84
1656801199077,CSE 175,A01,083665,Kumar; Rakesh,3,0,25,22
1656801205103,CSE 190,A00,092507,Dubnov; Shlomo,7,0,20,13
1656801211132,ECE 45,A01,083139,Congero; Spencer William,5,0,75,70
1656801217162,ECE 65,A50,083695,Saad; Andrew S,12,0,30,18
1656801217162,ECE 65,A51,095125,Saad; Andrew S,25,0,26,1
1656801223185,ECE 109,A01,091882,Touri; Behrouz,15,0,70,55
1656801229210,ECE 180,A00,083140,Abi Samra; Nicholas Camill,0,0,30,30
1656801229210,ECE 180,B00,083141,Abi Samra; Nicholas Camill,0,0,30,30
1656801235232,MATH 10A,A01,083735,Patchell; Gregory David,1,0,30,29
1656801235232,MATH 10A,A02,083736,Patchell; Gregory David,20,0,30,10
1656801235232,MATH 10A,A03,083737,Patchell; Gregory David,15,0,30,15
1656801241266,MATH 10B,A01,083207,Lim; Seonhee,7,0,34,27
1656801241266,MATH 10B,A02,083208,Lim; Seonhee,9,0,35,26
1656801241266,MATH 10B,A03,093472,Lim; Seonhee,4,0,34,30
1656801241266,MATH 10B,B01,083739,Sinha; Shubham,9,0,30,21
1656801247297,MATH 18,A01,083743,Cinel; Cameron Alexander,6,0,30,24
1656801247297,MATH 18,A02,083744,Cinel; Cameron Alexander,15,0,30,15
1656801247297,MATH 18,A03,083745,Cinel; Cameron Alexander,8,0,30,22
1656801247297,MATH 18,B01,083748,Rideout; David Porter,3,0,37,34
1656801247297,MATH 18,B02,083749,Rideout; David Porter,3,0,36,33
1656801247297,MATH 18,B03,083750,Rideout; David Porter,1,0,37,36
1656801247297,MATH 18,B04,083751,Rideout; David Porter,5,0,36,31
1656801247297,MATH 18,B05,093473,Rideout; David Porter,4,0,36,32
1656801247297,MATH 18,B06,093474,Rideout; David Porter,5,0,36,31
1656801253324,MATH 20A,A01,083754,Zheng; Zequn,12,0,40,28
1656801259350,MATH 20B,A01,083756,Briones; Jor-el Thomas Caparas,1,0,36,35
1656801259350,MATH 20B,A02,083757,Briones; Jor-el Thomas Caparas,1,0,36,35
1656801259350,MATH 20B,A03,093475,Briones; Jor-el Thomas Caparas,0,0,36,36
1656801265372,MATH 20C,A01,083760,Briones; Jor-el Thomas Caparas,1,0,35,34
1656801265372,MATH 20C,A02,083761,Briones; Jor-el Thomas Caparas,8,0,35,27
1656801265372,MATH 20C,A03,093476,Briones; Jor-el Thomas Caparas,0,1,36,36
1656801265372,MATH 20C,B01,083762,Bach; Quang Tran,0,0,30,30
1656801271397,MATH 20D,A01,083765,Tran; Brian Kha,4,0,30,26
1656801271397,MATH 20D,A02,083766,Tran; Brian Kha,4,0,30,26
1656801271397,MATH 20D,A03,083767,Tran; Brian Kha,2,0,30,28
1656801277442,MATH 20E,A01,083771,Ganguly; Soumya,5,0,32,27
1656801277442,MATH 20E,A02,083772,Ganguly; Soumya,5,0,32,27
1656801277442,MATH 20E,B01,083773,Ciotti; Benjamin,18,0,35,17
1656801277442,MATH 20E,B02,083774,Ciotti; Benjamin,17,0,35,18
1656801283466,MATH 103A,A01,083777,Greenfeld; Be'Eri,2,0,36,34
1656801283466,MATH 103A,A02,083778,Greenfeld; Be'Eri,5,0,36,31
1656801283466,MATH 103A,A03,093561,Greenfeld; Be'Eri,4,0,36,32
1656801283466,MATH 103A,B01,083779,Greenfeld; Be'Eri,6,0,36,30
1656801283466,MATH 103A,B02,083780,Greenfeld; Be'Eri,2,0,36,34
1656801283466,MATH 103A,B03,093562,Greenfeld; Be'Eri,2,0,36,34
1656801289498,MATH 105,A01,085443,Carter; Anne Toulson,13,0,35,22
1656801289498,MATH 105,A02,093477,Carter; Anne Toulson,20,0,35,15
1656801295529,MATH 109,A01,083213,Ganzberger; Geoffrey Michael,2,0,34,32
1656801295529,MATH 109,A02,083214,Ganzberger; Geoffrey Michael,2,0,34,32
1656801295529,MATH 109,A03,093478,Ganzberger; Geoffrey Michael,1,0,34,33
1656801295529,MATH 109,B01,083215,Ganzberger; Geoffrey Michael,1,0,32,31
1656801295529,MATH 109,B02,083216,Ganzberger; Geoffrey Michael,1,0,32,31
1656801295529,MATH 109,B03,093479,Ganzberger; Geoffrey Michael,6,0,32,26
1656801301558,MATH 142A,A01,083219,Chow; Bennett,6,0,32,26
1656801301558,MATH 142A,A02,083220,Chow; Bennett,9,0,32,23
1656801301558,MATH 142A,A03,093480,Chow; Bennett,7,0,32,25
1656801301558,MATH 142A,B03,093481,Chow; Bennett,7,0,32,25
1656801301558,MATH 142A,B04,093558,Chow; Bennett,10,0,32,22
1656801301558,MATH 142A,B05,093559,Chow; Bennett,6,0,32,26
1656801307586,MATH 193A,A01,083224,Rotar; Vladimir,6,0,34,28
1656801307586,MATH 193A,A02,083225,Rotar; Vladimir,3,0,34,31
1656801307586,MATH 193A,A03,083781,Rotar; Vladimir,1,0,34,33
1656801307586,MATH 193A,A04,083782,Rotar; Vladimir,6,0,34,28
1656801307586,MATH 193A,A05,093482,Rotar; Vladimir,6,0,34,28
1656801313619,MATH 197,001,091859,McAuley; Julian John,9999,0,9999,0
1656801313619,MATH 197,002,095566,Kedlaya; Kiran S.,9997,0,9999,2
1656801313619,MATH 197,003,095567,Xiao; Ming,9999,0,9999,0
1656801313619,MATH 197,004,095571,Perols; Johan Lars,9998,0,9999,1
1656801320675,COGS 9,A01,083615,Shannon; Kyle Michael,6,0,75,69
1656801326700,COGS 11,A01,083617,Boyle; Mary E. T.,18,0,48,30
1656801332724,COGS 13,A01,083071,Bastos; Amalia Pinkusfeld,8,0,71,63
1656801338746,COGS 14A,A01,092681,Semenuks; Arturs,0,1,100,100
1656801344773,COGS 14B,A01,083073,Cheng; Tzu-Han,5,0,63,58
1656801350801,COGS 17,A01,092677,Semenuks; Arturs,4,0,81,77
1656801356832,COGS 100,A01,083619,Allen; Michael Gordon,15,0,70,55
1656801362854,COGS 101A,A01,083621,Davis; Joshua Daniel,9,0,68,59
1656801368880,COGS 101B,A01,091572,Allen; Michael Gordon,8,0,65,57
1656801374907,COGS 101C,A01,083625,Delgado; Tania,17,0,35,18
1656801380933,COGS 107A,A01,083627,Boyle; Mary E. T.,13,0,60,47
1656801386960,COGS 118A,A01,083075,Gupta; Anjum,15,0,76,61
1656801392983,CSE 3,A50,083646,Miranda; Gregory Joseph,22,0,50,28
1656801399016,CSE 8A,A50,083650,Miranda; Gregory Joseph,17,1,56,39
1656801405039,CSE 11,A01,083080,Cao; Yingjun,4,15,40,36
1656801411062,CSE 12,A01,083652,Krause-Levy; Sophia Louisa,20,1,120,100
1656801417109,CSE 15L,A01,083654,Morris; Justin Loren,8,0,50,42
1656801417109,CSE 15L,A02,083655,Morris; Justin Loren,8,0,50,42
1656801423132,CSE 20,A01,083657,Tran; Khoa Dang,37,0,80,43
1656801429159,CSE 21,A01,095574,Bach; Quang Tran,21,0,48,27
1656801435188,CSE 30,A01,083084,Eldon; John,4,0,80,76
1656801435188,CSE 30,B01,095061,Bhaskar; Nishant,5,0,50,45
1656801441220,CSE 100,A01,083659,Cao; Yingjun,1,4,70,69
1656801447247,CSE 134B,A01,083661,Powell; Thomas Allan,18,0,100,82
1656801453274,CSE 140,A01,083663,Gungor; Onat,14,0,85,71
1656801459300,CSE 140L,A01,083088,Eldon; John,16,0,100,84
1656801465324,CSE 175,A01,083665,Kumar; Rakesh,3,0,25,22
1656801471352,CSE 190,A00,092507,Dubnov; Shlomo,7,0,20,13
1656801477374,ECE 45,A01,083139,Congero; Spencer William,5,0,75,70
1656801483397,ECE 65,A50,083695,Saad; Andrew S,12,0,30,18
1656801483397,ECE 65,A51,095125,Saad; Andrew S,25,0,26,1
1656801489419,ECE 109,A01,091882,Touri; Behrouz,15,0,70,55
1656801495447,ECE 180,A00,083140,Abi Samra; Nicholas Camill,0,0,30,30
1656801495447,ECE 180,B00,083141,Abi Samra; Nicholas Camill,0,0,30,30
1656801501469,MATH 10A,A01,083735,Patchell; Gregory David,1,0,30,29
1656801501469,MATH 10A,A02,083736,Patchell; Gregory David,20,0,30,10
1656801501469,MATH 10A,A03,083737,Patchell; Gregory David,15,0,30,15
1656801507492,MATH 10B,A01,083207,Lim; Seonhee,7,0,34,27
1656801507492,MATH 10B,A02,083208,Lim; Seonhee,9,0,35,26
1656801507492,MATH 10B,A03,093472,Lim; Seonhee,4,0,34,30
1656801507492,MATH 10B,B01,083739,Sinha; Shubham,9,0,30,21
1656801513524,MATH 18,A01,083743,Cinel; Cameron Alexander,6,0,30,24
1656801513524,MATH 18,A02,083744,Cinel; Cameron Alexander,15,0,30,15
1656801513524,MATH 18,A03,083745,Cinel; Cameron Alexander,8,0,30,22
1656801513524,MATH 18,B01,083748,Rideout; David Porter,3,0,37,34
1656801513524,MATH 18,B02,083749,Rideout; David Porter,3,0,36,33
1656801513524,MATH 18,B03,083750,Rideout; David Porter,1,0,37,36
1656801513524,MATH 18,B04,083751,Rideout; David Porter,5,0,36,31
1656801513524,MATH 18,B05,093473,Rideout; David Porter,4,0,36,32
1656801513524,MATH 18,B06,093474,Rideout; David Porter,5,0,36,31
1656801519547,MATH 20A,A01,083754,Zheng; Zequn,12,0,40,28
1656801525570,MATH 20B,A01,083756,Briones; Jor-el Thomas Caparas,1,0,36,35
1656801525570,MATH 20B,A02,083757,Briones; Jor-el Thomas Caparas,1,0,36,35
1656801525570,MATH 20B,A03,093475,Briones; Jor-el Thomas Caparas,0,0,36,36
1656801531594,MATH 20C,A01,083760,Briones; Jor-el Thomas Caparas,1,0,35,34
1656801531594,MATH 20C,A02,083761,Briones; Jor-el Thomas Caparas,8,0,35,27
1656801531594,MATH 20C,A03,093476,Briones; Jor-el Thomas Caparas,0,1,36,36
1656801531594,MATH 20C,B01,083762,Bach; Quang Tran,0,0,30,30
1656801537623,MATH 20D,A01,083765,Tran; Brian Kha,4,0,30,26
1656801537623,MATH 20D,A02,083766,Tran; Brian Kha,4,0,30,26
1656801537623,MATH 20D,A03,083767,Tran; Brian Kha,2,0,30,28
1656801543653,MATH 20E,A01,083771,Ganguly; Soumya,5,0,32,27
1656801543653,MATH 20E,A02,083772,Ganguly; Soumya,5,0,32,27
1656801543653,MATH 20E,B01,083773,Ciotti; Benjamin,18,0,35,17
1656801543653,MATH 20E,B02,083774,Ciotti; Benjamin,17,0,35,18
1656801549677,MATH 103A,A01,083777,Greenfeld; Be'Eri,2,0,36,34
1656801549677,MATH 103A,A02,083778,Greenfeld; Be'Eri,5,0,36,31
1656801549677,MATH 103A,A03,093561,Greenfeld; Be'Eri,4,0,36,32
1656801549677,MATH 103A,B01,083779,Greenfeld; Be'Eri,6,0,36,30
1656801549677,MATH 103A,B02,083780,Greenfeld; Be'Eri,2,0,36,34
1656801549677,MATH 103A,B03,093562,Greenfeld; Be'Eri,2,0,36,34
1656801555706,MATH 105,A01,085443,Carter; Anne Toulson,13,0,35,22
1656801555706,MATH 105,A02,093477,Carter; Anne Toulson,20,0,35,15
1656801561731,MATH 109,A01,083213,Ganzberger; Geoffrey Michael,2,0,34,32
1656801561731,MATH 109,A02,083214,Ganzberger; Geoffrey Michael,2,0,34,32
1656801561731,MATH 109,A03,093478,Ganzberger; Geoffrey Michael,1,0,34,33
1656801561731,MATH 109,B01,083215,Ganzberger; Geoffrey Michael,1,0,32,31
1656801561731,MATH 109,B02,083216,Ganzberger; Geoffrey Michael,1,0,32,31
1656801561731,MATH 109,B03,093479,Ganzberger; Geoffrey Michael,6,0,32,26
1656801567755,MATH 142A,A01,083219,Chow; Bennett,6,0,32,26
1656801567755,MATH 142A,A02,083220,Chow; Bennett,9,0,32,23
1656801567755,MATH 142A,A03,093480,Chow; Bennett,7,0,32,25
1656801567755,MATH 142A,B03,093481,Chow; Bennett,7,0,32,25
1656801567755,MATH 142A,B04,093558,Chow; Bennett,10,0,32,22
1656801567755,MATH 142A,B05,093559,Chow; Bennett,6,0,32,26
1656801573780,MATH 193A,A01,083224,Rotar; Vladimir,6,0,34,28
1656801573780,MATH 193A,A02,083225,Rotar; Vladimir,3,0,34,31
1656801573780,MATH 193A,A03,083781,Rotar; Vladimir,1,0,34,33
1656801573780,MATH 193A,A04,083782,Rotar; Vladimir,6,0,34,28
1656801573780,MATH 193A,A05,093482,Rotar; Vladimir,6,0,34,28
1656801579802,MATH 197,001,091859,McAuley; Julian John,9999,0,9999,0
1656801579802,MATH 197,002,095566,Kedlaya; Kiran S.,9997,0,9999,2
1656801579802,MATH 197,003,095567,Xiao; Ming,9999,0,9999,0
1656801579802,MATH 197,004,095571,Perols; Johan Lars,9998,0,9999,1
1656801586865,COGS 9,A01,083615,Shannon; Kyle Michael,6,0,75,69
1656801592892,COGS 11,A01,083617,Boyle; Mary E. T.,18,0,48,30
1656801598919,COGS 13,A01,083071,Bastos; Amalia Pinkusfeld,8,0,71,63
1656801604942,COGS 14A,A01,092681,Semenuks; Arturs,0,1,100,100
1656801610967,COGS 14B,A01,083073,Cheng; Tzu-Han,5,0,63,58
1656801616989,COGS 17,A01,092677,Semenuks; Arturs,4,0,81,77
1656801623013,COGS 100,A01,083619,Allen; Michael Gordon,15,0,70,55
1656801629035,COGS 101A,A01,083621,Davis; Joshua Daniel,9,0,68,59
1656801635057,COGS 101B,A01,091572,Allen; Michael Gordon,8,0,65,57
1656801641079,COGS 101C,A01,083625,Delgado; Tania,17,0,35,18
1656801647102,COGS 107A,A01,083627,Boyle; Mary E. T.,13,0,60,47
1656801653127,COGS 118A,A01,083075,Gupta; Anjum,15,0,76,61
1656801659155,CSE 3,A50,083646,Miranda; Gregory Joseph,22,0,50,28
1656801665178,CSE 8A,A50,083650,Miranda; Gregory Joseph,17,1,56,39
1656801671219,CSE 11,A01,083080,Cao; Yingjun,4,15,40,36
1656801677243,CSE 12,A01,083652,Krause-Levy; Sophia Louisa,20,1,120,100
1656801683269,CSE 15L,A01,083654,Morris; Justin Loren,8,0,50,42
1656801683269,CSE 15L,A02,083655,Morris; Justin Loren,8,0,50,42
1656801689291,CSE 20,A01,083657,Tran; Khoa Dang,37,0,80,43
1656801695314,CSE 21,A01,095574,Bach; Quang Tran,21,0,48,27
1656801701338,CSE 30,A01,083084,Eldon; John,4,0,80,76
1656801701338,CSE 30,B01,095061,Bhaskar; Nishant,5,0,50,45
1656801707362,CSE 100,A01,083659,Cao; Yingjun,1,4,70,69
1656801713389,CSE 134B,A01,083661,Powell; Thomas Allan,18,0,100,82
1656801719417,CSE 140,A01,083663,Gungor; Onat,14,0,85,71
1656801725443,CSE 140L,A01,083088,Eldon; John,16,0,100,84
1656801731556,CSE 175,A01,083665,Kumar; Rakesh,3,0,25,22
1656801737581,CSE 190,A00,092507,Dubnov; Shlomo,7,0,20,13
1656801743604,ECE 45,A01,083139,Congero; Spencer William,5,0,75,70
1656801749632,ECE 65,A50,083695,Saad; Andrew S,12,0,30,18
1656801749632,ECE 65,A51,095125,Saad; Andrew S,25,0,26,1
1656801755655,ECE 109,A01,091882,Touri; Behrouz,15,0,70,55
1656801761681,ECE 180,A00,083140,Abi Samra; Nicholas Camill,0,0,30,30
1656801761681,ECE 180,B00,083141,Abi Samra; Nicholas Camill,0,0,30,30
1656801767705,MATH 10A,A01,083735,Patchell; Gregory David,1,0,30,29
1656801767705,MATH 10A,A02,083736,Patchell; Gregory David,20,0,30,10
1656801767705,MATH 10A,A03,083737,Patchell; Gregory David,15,0,30,15
1656801773729,MATH 10B,A01,083207,Lim; Seonhee,7,0,34,27
1656801773729,MATH 10B,A02,083208,Lim; Seonhee,9,0,35,26
1656801773729,MATH 10B,A03,093472,Lim; Seonhee,4,0,34,30
1656801773729,MATH 10B,B01,083739,Sinha; Shubham,9,0,30,21
1656801779761,MATH 18,A01,083743,Cinel; Cameron Alexander,6,0,30,24
1656801779761,MATH 18,A02,083744,Cinel; Cameron Alexander,15,0,30,15
1656801779761,MATH 18,A03,083745,Cinel; Cameron Alexander,8,0,30,22
1656801779761,MATH 18,B01,083748,Rideout; David Porter,3,0,37,34
1656801779761,MATH 18,B02,083749,Rideout; David Porter,3,0,36,33
1656801779761,MATH 18,B03,083750,Rideout; David Porter,1,0,37,36
1656801779761,MATH 18,B04,083751,Rideout; David Porter,5,0,36,31
1656801779761,MATH 18,B05,093473,Rideout; David Porter,4,0,36,32
1656801779761,MATH 18,B06,093474,Rideout; David Porter,5,0,36,31
1656801797211,MATH 20A,A01,083754,Zheng; Zequn,12,0,40,28
1656801803234,MATH 20B,A01,083756,Briones; Jor-el Thomas Caparas,1,0,36,35
1656801803234,MATH 20B,A02,083757,Briones; Jor-el Thomas Caparas,1,0,36,35
1656801803234,MATH 20B,A03,093475,Briones; Jor-el Thomas Caparas,0,0,36,36
1656801809263,MATH 20C,A01,083760,Briones; Jor-el Thomas Caparas,1,0,35,34
1656801809263,MATH 20C,A02,083761,Briones; Jor-el Thomas Caparas,8,0,35,27
1656801809263,MATH 20C,A03,093476,Briones; Jor-el Thomas Caparas,0,1,36,36
1656801809263,MATH 20C,B01,083762,Bach; Quang Tran,0,0,30,30
1656801815288,MATH 20D,A01,083765,Tran; Brian Kha,4,0,30,26
1656801815288,MATH 20D,A02,083766,Tran; Brian Kha,4,0,30,26
1656801815288,MATH 20D,A03,083767,Tran; Brian Kha,2,0,30,28
1656801821311,MATH 20E,A01,083771,Ganguly; Soumya,5,0,32,27
1656801821311,MATH 20E,A02,083772,Ganguly; Soumya,5,0,32,27
1656801821311,MATH 20E,B01,083773,Ciotti; Benjamin,18,0,35,17
1656801821311,MATH 20E,B02,083774,Ciotti; Benjamin,17,0,35,18
1656801827339,MATH 103A,A01,083777,Greenfeld; Be'Eri,2,0,36,34
1656801827339,MATH 103A,A02,083778,Greenfeld; Be'Eri,5,0,36,31
1656801827339,MATH 103A,A03,093561,Greenfeld; Be'Eri,4,0,36,32
1656801827339,MATH 103A,B01,083779,Greenfeld; Be'Eri,6,0,36,30
1656801827339,MATH 103A,B02,083780,Greenfeld; Be'Eri,2,0,36,34
1656801827339,MATH 103A,B03,093562,Greenfeld; Be'Eri,2,0,36,34
1656801833364,MATH 105,A01,085443,Carter; Anne Toulson,13,0,35,22
1656801833364,MATH 105,A02,093477,Carter; Anne Toulson,20,0,35,15
1656801839386,MATH 109,A01,083213,Ganzberger; Geoffrey Michael,2,0,34,32
1656801839386,MATH 109,A02,083214,Ganzberger; Geoffrey Michael,2,0,34,32
1656801839386,MATH 109,A03,093478,Ganzberger; Geoffrey Michael,1,0,34,33
1656801839386,MATH 109,B01,083215,Ganzberger; Geoffrey Michael,1,0,32,31
1656801839386,MATH 109,B02,083216,Ganzberger; Geoffrey Michael,1,0,32,31
1656801839386,MATH 109,B03,093479,Ganzberger; Geoffrey Michael,6,0,32,26
1656801845411,MATH 142A,A01,083219,Chow; Bennett,6,0,32,26
1656801845411,MATH 142A,A02,083220,Chow; Bennett,9,0,32,23
1656801845411,MATH 142A,A03,093480,Chow; Bennett,7,0,32,25
1656801845411,MATH 142A,B03,093481,Chow; Bennett,7,0,32,25
1656801845411,MATH 142A,B04,093558,Chow; Bennett,10,0,32,22
1656801845411,MATH 142A,B05,093559,Chow; Bennett,6,0,32,26
1656801851434,MATH 193A,A01,083224,Rotar; Vladimir,6,0,34,28
1656801851434,MATH 193A,A02,083225,Rotar; Vladimir,3,0,34,31
1656801851434,MATH 193A,A03,083781,Rotar; Vladimir,1,0,34,33
1656801851434,MATH 193A,A04,083782,Rotar; Vladimir,6,0,34,28
1656801851434,MATH 193A,A05,093482,Rotar; Vladimir,6,0,34,28
1656801857459,MATH 197,001,091859,McAuley; Julian John,9999,0,9999,0
1656801857459,MATH 197,002,095566,Kedlaya; Kiran S.,9997,0,9999,2
1656801857459,MATH 197,003,095567,Xiao; Ming,9999,0,9999,0
1656801857459,MATH 197,004,095571,Perols; Johan Lars,9998,0,9999,1
1656801864531,COGS 9,A01,083615,Shannon; Kyle Michael,6,0,75,69
1656801870557,COGS 11,A01,083617,Boyle; Mary E. T.,18,0,48,30
1656801876586,COGS 13,A01,083071,Bastos; Amalia Pinkusfeld,8,0,71,63
1656801882610,COGS 14A,A01,092681,Semenuks; Arturs,0,1,100,100
1656801888635,COGS 14B,A01,083073,Cheng; Tzu-Han,5,0,63,58
1656801894661,COGS 17,A01,092677,Semenuks; Arturs,4,0,81,77
1656801900688,COGS 100,A01,083619,Allen; Michael Gordon,15,0,70,55
1656801906711,COGS 101A,A01,083621,Davis; Joshua Daniel,9,0,68,59
1656801912734,COGS 101B,A01,091572,Allen; Michael Gordon,8,0,65,57
1656801918762,COGS 101C,A01,083625,Delgado; Tania,17,0,35,18
1656801924789,COGS 107A,A01,083627,Boyle; Mary E. T.,13,0,60,47
1656801930812,COGS 118A,A01,083075,Gupta; Anjum,15,0,76,61
1656801936835,CSE 3,A50,083646,Miranda; Gregory Joseph,22,0,50,28
1656801942864,CSE 8A,A50,083650,Miranda; Gregory Joseph,17,1,56,39
1656801948890,CSE 11,A01,083080,Cao; Yingjun,4,15,40,36
1656801954913,CSE 12,A01,083652,Krause-Levy; Sophia Louisa,20,1,120,100
1656801960940,CSE 15L,A01,083654,Morris; Justin Loren,8,0,50,42
1656801960940,CSE 15L,A02,083655,Morris; Justin Loren,8,0,50,42
1656801966974,CSE 20,A01,083657,Tran; Khoa Dang,37,0,80,43
1656801972997,CSE 21,A01,095574,Bach; Quang Tran,21,0,48,27
1656801979025,CSE 30,A01,083084,Eldon; John,4,0,80,76
1656801979025,CSE 30,B01,095061,Bhaskar; Nishant,5,0,50,45
1656801985055,CSE 100,A01,083659,Cao; Yingjun,1,4,70,69
1656801991079,CSE 134B,A01,083661,Powell; Thomas Allan,18,0,100,82
1656801997103,CSE 140,A01,083663,Gungor; Onat,14,0,85,71
1656802003130,CSE 140L,A01,083088,Eldon; John,16,0,100,84
1656802009153,CSE 175,A01,083665,Kumar; Rakesh,3,0,25,22
1656802015178,CSE 190,A00,092507,Dubnov; Shlomo,7,0,20,13
1656802021205,ECE 45,A01,083139,Congero; Spencer William,5,0,75,70
1656802027228,ECE 65,A50,083695,Saad; Andrew S,12,0,30,18
1656802027228,ECE 65,A51,095125,Saad; Andrew S,25,0,26,1
1656802033254,ECE 109,A01,091882,Touri; Behrouz,15,0,70,55
1656802039277,ECE 180,A00,083140,Abi Samra; Nicholas Camill,0,0,30,30
1656802039277,ECE 180,B00,083141,Abi Samra; Nicholas Camill,0,0,30,30
1656802045305,MATH 10A,A01,083735,Patchell; Gregory David,1,0,30,29
1656802045305,MATH 10A,A02,083736,Patchell; Gregory David,20,0,30,10
1656802045305,MATH 10A,A03,083737,Patchell; Gregory David,15,0,30,15
1656802051332,MATH 10B,A01,083207,Lim; Seonhee,7,0,34,27
1656802051332,MATH 10B,A02,083208,Lim; Seonhee,9,0,35,26
1656802051332,MATH 10B,A03,093472,Lim; Seonhee,4,0,34,30
1656802051332,MATH 10B,B01,083739,Sinha; Shubham,9,0,30,21
1656802057358,MATH 18,A01,083743,Cinel; Cameron Alexander,6,0,30,24
1656802057358,MATH 18,A02,083744,Cinel; Cameron Alexander,15,0,30,15
1656802057358,MATH 18,A03,083745,Cinel; Cameron Alexander,8,0,30,22
1656802057358,MATH 18,B01,083748,Rideout; David Porter,3,0,37,34
1656802057358,MATH 18,B02,083749,Rideout; David Porter,3,0,36,33
1656802057358,MATH 18,B03,083750,Rideout; David Porter,1,0,37,36
1656802057358,MATH 18,B04,083751,Rideout; David Porter,5,0,36,31
1656802057358,MATH 18,B05,093473,Rideout; David Porter,4,0,36,32
1656802057358,MATH 18,B06,093474,Rideout; David Porter,5,0,36,31
1656802063384,MATH 20A,A01,083754,Zheng; Zequn,12,0,40,28
1656802069407,MATH 20B,A01,083756,Briones; Jor-el Thomas Caparas,1,0,36,35
1656802069407,MATH 20B,A02,083757,Briones; Jor-el Thomas Caparas,1,0,36,35
1656802069407,MATH 20B,A03,093475,Briones; Jor-el Thomas Caparas,0,0,36,36
1656802075429,MATH 20C,A01,083760,Briones; Jor-el Thomas Caparas,1,0,35,34
1656802075429,MATH 20C,A02,083761,Briones; Jor-el Thomas Caparas,8,0,35,27
1656802075429,MATH 20C,A03,093476,Briones; Jor-el Thomas Caparas,0,1,36,36
1656802075429,MATH 20C,B01,083762,Bach; Quang Tran,0,0,30,30
1656802081457,MATH 20D,A01,083765,Tran; Brian Kha,4,0,30,26
1656802081457,MATH 20D,A02,083766,Tran; Brian Kha,4,0,30,26
1656802081457,MATH 20D,A03,083767,Tran; Brian Kha,2,0,30,28
1656802087494,MATH 20E,A01,083771,Ganguly; Soumya,5,0,32,27
1656802087494,MATH 20E,A02,083772,Ganguly; Soumya,5,0,32,27
1656802087494,MATH 20E,B01,083773,Ciotti; Benjamin,18,0,35,17
1656802087494,MATH 20E,B02,083774,Ciotti; Benjamin,17,0,35,18
1656802093523,MATH 103A,A01,083777,Greenfeld; Be'Eri,2,0,36,34
1656802093523,MATH 103A,A02,083778,Greenfeld; Be'Eri,5,0,36,31
1656802093523,MATH 103A,A03,093561,Greenfeld; Be'Eri,4,0,36,32
1656802093523,MATH 103A,B01,083779,Greenfeld; Be'Eri,6,0,36,30
1656802093523,MATH 103A,B02,083780,Greenfeld; Be'Eri,2,0,36,34
1656802093523,MATH 103A,B03,093562,Greenfeld; Be'Eri,2,0,36,34
1656802099546,MATH 105,A01,085443,Carter; Anne Toulson,13,0,35,22
1656802099546,MATH 105,A02,093477,Carter; Anne Toulson,20,0,35,15
1656802105569,MATH 109,A01,083213,Ganzberger; Geoffrey Michael,2,0,34,32
1656802105569,MATH 109,A02,083214,Ganzberger; Geoffrey Michael,2,0,34,32
1656802105569,MATH 109,A03,093478,Ganzberger; Geoffrey Michael,1,0,34,33
1656802105569,MATH 109,B01,083215,Ganzberger; Geoffrey Michael,1,0,32,31
1656802105569,MATH 109,B02,083216,Ganzberger; Geoffrey Michael,1,0,32,31
1656802105569,MATH 109,B03,093479,Ganzberger; Geoffrey Michael,6,0,32,26
1656802111593,MATH 142A,A01,083219,Chow; Bennett,6,0,32,26
1656802111593,MATH 142A,A02,083220,Chow; Bennett,9,0,32,23
1656802111593,MATH 142A,A03,093480,Chow; Bennett,7,0,32,25
1656802111593,MATH 142A,B03,093481,Chow; Bennett,7,0,32,25
1656802111593,MATH 142A,B04,093558,Chow; Bennett,10,0,32,22
1656802111593,MATH 142A,B05,093559,Chow; Bennett,6,0,32,26
1656802117623,MATH 193A,A01,083224,Rotar; Vladimir,6,0,34,28
1656802117623,MATH 193A,A02,083225,Rotar; Vladimir,3,0,34,31
1656802117623,MATH 193A,A03,083781,Rotar; Vladimir,1,0,34,33
1656802117623,MATH 193A,A04,083782,Rotar; Vladimir,6,0,34,28
1656802117623,MATH 193A,A05,093482,Rotar; Vladimir,6,0,34,28
1656802123647,MATH 197,001,091859,McAuley; Julian John,9999,0,9999,0
1656802123647,MATH 197,002,095566,Kedlaya; Kiran S.,9997,0,9999,2
1656802123647,MATH 197,003,095567,Xiao; Ming,9999,0,9999,0
1656802123647,MATH 197,004,095571,Perols; Johan Lars,9998,0,9999,1
1656802130713,COGS 9,A01,083615,Shannon; Kyle Michael,6,0,75,69
1656802136741,COGS 11,A01,083617,Boyle; Mary E. T.,18,0,48,30
1656802142777,COGS 13,A01,083071,Bastos; Amalia Pinkusfeld,8,0,71,63
1656802148798,COGS 14A,A01,092681,Semenuks; Arturs,0,1,100,100
1656802154821,COGS 14B,A01,083073,Cheng; Tzu-Han,5,0,63,58
1656802160844,COGS 17,A01,092677,Semenuks; Arturs,4,0,81,77
1656802166872,COGS 100,A01,083619,Allen; Michael Gordon,15,0,70,55
1656802172899,COGS 101A,A01,083621,Davis; Joshua Daniel,9,0,68,59
1656802178921,COGS 101B,A01,091572,Allen; Michael Gordon,8,0,65,57
1656802184950,COGS 101C,A01,083625,Delgado; Tania,17,0,35,18
1656802190990,COGS 107A,A01,083627,Boyle; Mary E. T.,13,0,60,47
1656802197013,COGS 118A,A01,083075,Gupta; Anjum,15,0,76,61
1656802203042,CSE 3,A50,083646,Miranda; Gregory Joseph,22,0,50,28
1656802209067,CSE 8A,A50,083650,Miranda; Gregory Joseph,17,1,56,39
1656802215090,CSE 11,A01,083080,Cao; Yingjun,4,15,40,36
1656802221124,CSE 12,A01,083652,Krause-Levy; Sophia Louisa,20,1,120,100
1656802227151,CSE 15L,A01,083654,Morris; Justin Loren,8,0,50,42
1656802227151,CSE 15L,A02,083655,Morris; Justin Loren,8,0,50,42
1656802233174,CSE 20,A01,083657,Tran; Khoa Dang,37,0,80,43
1656802239200,CSE 21,A01,095574,Bach; Quang Tran,21,0,48,27
1656802245234,CSE 30,A01,083084,Eldon; John,4,0,80,76
1656802245234,CSE 30,B01,095061,Bhaskar; Nishant,5,0,50,45
1656802251257,CSE 100,A01,083659,Cao; Yingjun,1,4,70,69
1656802257281,CSE 134B,A01,083661,Powell; Thomas Allan,18,0,100,82
1656802263308,CSE 140,A01,083663,Gungor; Onat,14,0,85,71
1656802269333,CSE 140L,A01,083088,Eldon; John,16,0,100,84
1656802275355,CSE 175,A01,083665,Kumar; Rakesh,3,0,25,22
1656802281384,CSE 190,A00,092507,Dubnov; Shlomo,7,0,20,13
1656802287406,ECE 45,A01,083139,Congero; Spencer William,5,0,75,70
1656802293430,ECE 65,A50,083695,Saad; Andrew S,12,0,30,18
1656802293430,ECE 65,A51,095125,Saad; Andrew S,25,0,26,1
1656802299458,ECE 109,A01,091882,Touri; Behrouz,15,0,70,55
1656802305484,ECE 180,A00,083140,Abi Samra; Nicholas Camill,0,0,30,30
1656802305484,ECE 180,B00,083141,Abi Samra; Nicholas Camill,0,0,30,30
1656802311511,MATH 10A,A01,083735,Patchell; Gregory David,1,0,30,29
1656802311511,MATH 10A,A02,083736,Patchell; Gregory David,20,0,30,10
1656802311511,MATH 10A,A03,083737,Patchell; Gregory David,15,0,30,15
1656802317536,MATH 10B,A01,083207,Lim; Seonhee,7,0,34,27
1656802317536,MATH 10B,A02,083208,Lim; Seonhee,9,0,35,26
1656802317536,MATH 10B,A03,093472,Lim; Seonhee,4,0,34,30
1656802317536,MATH 10B,B01,083739,Sinha; Shubham,9,0,30,21
1656802323559,MATH 18,A01,083743,Cinel; Cameron Alexander,6,0,30,24
1656802323559,MATH 18,A02,083744,Cinel; Cameron Alexander,15,0,30,15
1656802323559,MATH 18,A03,083745,Cinel; Cameron Alexander,8,0,30,22
1656802323559,MATH 18,B01,083748,Rideout; David Porter,3,0,37,34
1656802323559,MATH 18,B02,083749,Rideout; David Porter,3,0,36,33
1656802323559,MATH 18,B03,083750,Rideout; David Porter,1,0,37,36
1656802323559,MATH 18,B04,083751,Rideout; David Porter,5,0,36,31
1656802323559,MATH 18,B05,093473,Rideout; David Porter,4,0,36,32
1656802323559,MATH 18,B06,093474,Rideout; David Porter,5,0,36,31
1656802329581,MATH 20A,A01,083754,Zheng; Zequn,12,0,40,28
1656802335608,MATH 20B,A01,083756,Briones; Jor-el Thomas Caparas,1,0,36,35
1656802335608,MATH 20B,A02,083757,Briones; Jor-el Thomas Caparas,1,0,36,35
1656802335608,MATH 20B,A03,093475,Briones; Jor-el Thomas Caparas,0,0,36,36
1656802341707,MATH 20C,A01,083760,Briones; Jor-el Thomas Caparas,1,0,35,34
1656802341707,MATH 20C,A02,083761,Briones; Jor-el Thomas Caparas,8,0,35,27
1656802341707,MATH 20C,A03,093476,Briones; Jor-el Thomas Caparas,0,1,36,36
1656802341707,MATH 20C,B01,083762,Bach; Quang Tran,0,0,30,30
1656802347731,MATH 20D,A01,083765,Tran; Brian Kha,4,0,30,26
1656802347731,MATH 20D,A02,083766,Tran; Brian Kha,4,0,30,26
1656802347731,MATH 20D,A03,083767,Tran; Brian Kha,2,0,30,28
1656802353760,MATH 20E,A01,083771,Ganguly; Soumya,5,0,32,27
1656802353760,MATH 20E,A02,083772,Ganguly; Soumya,5,0,32,27
1656802353760,MATH 20E,B01,083773,Ciotti; Benjamin,18,0,35,17
1656802353760,MATH 20E,B02,083774,Ciotti; Benjamin,17,0,35,18
1656802359784,MATH 103A,A01,083777,Greenfeld; Be'Eri,2,0,36,34
1656802359784,MATH 103A,A02,083778,Greenfeld; Be'Eri,5,0,36,31
1656802359784,MATH 103A,A03,093561,Greenfeld; Be'Eri,4,0,36,32
1656802359784,MATH 103A,B01,083779,Greenfeld; Be'Eri,6,0,36,30
1656802359784,MATH 103A,B02,083780,Greenfeld; Be'Eri,2,0,36,34
1656802359784,MATH 103A,B03,093562,Greenfeld; Be'Eri,2,0,36,34
1656802365807,MATH 105,A01,085443,Carter; Anne Toulson,13,0,35,22
1656802365807,MATH 105,A02,093477,Carter; Anne Toulson,20,0,35,15
1656802371830,MATH 109,A01,083213,Ganzberger; Geoffrey Michael,2,0,34,32
1656802371830,MATH 109,A02,083214,Ganzberger; Geoffrey Michael,2,0,34,32
1656802371830,MATH 109,A03,093478,Ganzberger; Geoffrey Michael,1,0,34,33
1656802371830,MATH 109,B01,083215,Ganzberger; Geoffrey Michael,1,0,32,31
1656802371830,MATH 109,B02,083216,Ganzberger; Geoffrey Michael,1,0,32,31
1656802371830,MATH 109,B03,093479,Ganzberger; Geoffrey Michael,6,0,32,26
1656802377858,MATH 142A,A01,083219,Chow; Bennett,6,0,32,26
1656802377858,MATH 142A,A02,083220,Chow; Bennett,9,0,32,23
1656802377858,MATH 142A,A03,093480,Chow; Bennett,7,0,32,25
1656802377858,MATH 142A,B03,093481,Chow; Bennett,7,0,32,25
1656802377858,MATH 142A,B04,093558,Chow; Bennett,10,0,32,22
1656802377858,MATH 142A,B05,093559,Chow; Bennett,6,0,32,26
1656802383882,MATH 193A,A01,083224,Rotar; Vladimir,6,0,34,28
1656802383882,MATH 193A,A02,083225,Rotar; Vladimir,3,0,34,31
1656802383882,MATH 193A,A03,083781,Rotar; Vladimir,1,0,34,33
1656802383882,MATH 193A,A04,083782,Rotar; Vladimir,6,0,34,28
1656802383882,MATH 193A,A05,093482,Rotar; Vladimir,6,0,34,28
1656802389904,MATH 197,001,091859,McAuley; Julian John,9999,0,9999,0
1656802389904,MATH 197,002,095566,Kedlaya; Kiran S.,9997,0,9999,2
1656802389904,MATH 197,003,095567,Xiao; Ming,9999,0,9999,0
1656802389904,MATH 197,004,095571,Perols; Johan Lars,9998,0,9999,1
1656802396976,COGS 9,A01,083615,Shannon; Kyle Michael,6,0,75,69
1656802403000,COGS 11,A01,083617,Boyle; Mary E. T.,18,0,48,30
1656802409026,COGS 13,A01,083071,Bastos; Amalia Pinkusfeld,8,0,71,63
1656802415047,COGS 14A,A01,092681,Semenuks; Arturs,0,1,100,100
1656802421070,COGS 14B,A01,083073,Cheng; Tzu-Han,5,0,63,58
1656802427101,COGS 17,A01,092677,Semenuks; Arturs,4,0,81,77
1656802433131,COGS 100,A01,083619,Allen; Michael Gordon,15,0,70,55
1656802439153,COGS 101A,A01,083621,Davis; Joshua Daniel,9,0,68,59
1656802445179,COGS 101B,A01,091572,Allen; Michael Gordon,8,0,65,57
1656802451203,COGS 101C,A01,083625,Delgado; Tania,17,0,35,18
1656802457228,COGS 107A,A01,083627,Boyle; Mary E. T.,13,0,60,47
1656802463254,COGS 118A,A01,083075,Gupta; Anjum,15,0,76,61
1656802469285,CSE 3,A50,083646,Miranda; Gregory Joseph,22,0,50,28
1656802475313,CSE 8A,A50,083650,Miranda; Gregory Joseph,17,1,56,39
1656802481338,CSE 11,A01,083080,Cao; Yingjun,4,15,40,36
1656802487373,CSE 12,A01,083652,Krause-Levy; Sophia Louisa,20,1,120,100
1656802493401,CSE 15L,A01,083654,Morris; Justin Loren,8,0,50,42
1656802493401,CSE 15L,A02,083655,Morris; Justin Loren,8,0,50,42
1656802499424,CSE 20,A01,083657,Tran; Khoa Dang,37,0,80,43
1656802505450,CSE 21,A01,095574,Bach; Quang Tran,21,0,48,27
1656802511478,CSE 30,A01,083084,Eldon; John,4,0,80,76
1656802511478,CSE 30,B01,095061,Bhaskar; Nishant,5,0,50,45
1656802517505,CSE 100,A01,083659,Cao; Yingjun,1,4,70,69
1656802523543,CSE 134B,A01,083661,Powell; Thomas Allan,18,0,100,82
1656802529570,CSE 140,A01,083663,Gungor; Onat,14,0,85,71
1656802535594,CSE 140L,A01,083088,Eldon; John,16,0,100,84
1656802541618,CSE 175,A01,083665,Kumar; Rakesh,3,0,25,22
1656802547642,CSE 190,A00,092507,Dubnov; Shlomo,7,0,20,13
1656802553666,ECE 45,A01,083139,Congero; Spencer William,5,0,75,70
1656802559690,ECE 65,A50,083695,Saad; Andrew S,12,0,30,18
1656802559690,ECE 65,A51,095125,Saad; Andrew S,25,0,26,1
1656802565716,ECE 109,A01,091882,Touri; Behrouz,15,0,70,55
1656802571740,ECE 180,A00,083140,Abi Samra; Nicholas Camill,0,0,30,30
1656802571740,ECE 180,B00,083141,Abi Samra; Nicholas Camill,0,0,30,30
1656802577765,MATH 10A,A01,083735,Patchell; Gregory David,1,0,30,29
1656802577765,MATH 10A,A02,083736,Patchell; Gregory David,20,0,30,10
1656802577765,MATH 10A,A03,083737,Patchell; Gregory David,15,0,30,15
1656802583788,MATH 10B,A01,083207,Lim; Seonhee,7,0,34,27
1656802583788,MATH 10B,A02,083208,Lim; Seonhee,9,0,35,26
1656802583788,MATH 10B,A03,093472,Lim; Seonhee,4,0,34,30
1656802583788,MATH 10B,B01,083739,Sinha; Shubham,9,0,30,21
1656802589817,MATH 18,A01,083743,Cinel; Cameron Alexander,6,0,30,24
1656802589817,MATH 18,A02,083744,Cinel; Cameron Alexander,15,0,30,15
1656802589817,MATH 18,A03,083745,Cinel; Cameron Alexander,8,0,30,22
1656802589817,MATH 18,B01,083748,Rideout; David Porter,3,0,37,34
1656802589817,MATH 18,B02,083749,Rideout; David Porter,3,0,36,33
1656802589817,MATH 18,B03,083750,Rideout; David Porter,1,0,37,36
1656802589817,MATH 18,B04,083751,Rideout; David Porter,5,0,36,31
1656802589817,MATH 18,B05,093473,Rideout; David Porter,4,0,36,32
1656802589817,MATH 18,B06,093474,Rideout; David Porter,5,0,36,31
1656802595848,MATH 20A,A01,083754,Zheng; Zequn,12,0,40,28
1656802601870,MATH 20B,A01,083756,Briones; Jor-el Thomas Caparas,1,0,36,35
1656802601870,MATH 20B,A02,083757,Briones; Jor-el Thomas Caparas,1,0,36,35
1656802601870,MATH 20B,A03,093475,Briones; Jor-el Thomas Caparas,0,0,36,36
1656802607898,MATH 20C,A01,083760,Briones; Jor-el Thomas Caparas,1,0,35,34
1656802607898,MATH 20C,A02,083761,Briones; Jor-el Thomas Caparas,8,0,35,27
1656802607898,MATH 20C,A03,093476,Briones; Jor-el Thomas Caparas,0,1,36,36
1656802607898,MATH 20C,B01,083762,Bach; Quang Tran,0,0,30,30
1656802613921,MATH 20D,A01,083765,Tran; Brian Kha,4,0,30,26
1656802613921,MATH 20D,A02,083766,Tran; Brian Kha,4,0,30,26
1656802613921,MATH 20D,A03,083767,Tran; Brian Kha,2,0,30,28
1656802619950,MATH 20E,A01,083771,Ganguly; Soumya,5,0,32,27
1656802619950,MATH 20E,A02,083772,Ganguly; Soumya,5,0,32,27
1656802619950,MATH 20E,B01,083773,Ciotti; Benjamin,18,0,35,17
1656802619950,MATH 20E,B02,083774,Ciotti; Benjamin,17,0,35,18
1656802625973,MATH 103A,A01,083777,Greenfeld; Be'Eri,2,0,36,34
1656802625973,MATH 103A,A02,083778,Greenfeld; Be'Eri,5,0,36,31
1656802625973,MATH 103A,A03,093561,Greenfeld; Be'Eri,4,0,36,32
1656802625973,MATH 103A,B01,083779,Greenfeld; Be'Eri,6,0,36,30
1656802625973,MATH 103A,B02,083780,Greenfeld; Be'Eri,2,0,36,34
1656802625973,MATH 103A,B03,093562,Greenfeld; Be'Eri,2,0,36,34
1656802631997,MATH 105,A01,085443,Carter; Anne Toulson,13,0,35,22
1656802631997,MATH 105,A02,093477,Carter; Anne Toulson,20,0,35,15
1656802638022,MATH 109,A01,083213,Ganzberger; Geoffrey Michael,2,0,34,32
1656802638022,MATH 109,A02,083214,Ganzberger; Geoffrey Michael,2,0,34,32
1656802638022,MATH 109,A03,093478,Ganzberger; Geoffrey Michael,1,0,34,33
1656802638022,MATH 109,B01,083215,Ganzberger; Geoffrey Michael,1,0,32,31
1656802638022,MATH 109,B02,083216,Ganzberger; Geoffrey Michael,1,0,32,31
1656802638022,MATH 109,B03,093479,Ganzberger; Geoffrey Michael,6,0,32,26
1656802644046,MATH 142A,A01,083219,Chow; Bennett,6,0,32,26
1656802644046,MATH 142A,A02,083220,Chow; Bennett,9,0,32,23
1656802644046,MATH 142A,A03,093480,Chow; Bennett,7,0,32,25
1656802644046,MATH 142A,B03,093481,Chow; Bennett,7,0,32,25
1656802644046,MATH 142A,B04,093558,Chow; Bennett,10,0,32,22
1656802644046,MATH 142A,B05,093559,Chow; Bennett,6,0,32,26
1656802650081,MATH 193A,A01,083224,Rotar; Vladimir,6,0,34,28
1656802650081,MATH 193A,A02,083225,Rotar; Vladimir,3,0,34,31
1656802650081,MATH 193A,A03,083781,Rotar; Vladimir,1,0,34,33
1656802650081,MATH 193A,A04,083782,Rotar; Vladimir,6,0,34,28
1656802650081,MATH 193A,A05,093482,Rotar; Vladimir,6,0,34,28
1656802656105,MATH 197,001,091859,McAuley; Julian John,9999,0,9999,0
1656802656105,MATH 197,002,095566,Kedlaya; Kiran S.,9997,0,9999,2
1656802656105,MATH 197,003,095567,Xiao; Ming,9999,0,9999,0
1656802656105,MATH 197,004,095571,Perols; Johan Lars,9998,0,9999,1
1656802663163,COGS 9,A01,083615,Shannon; Kyle Michael,6,0,75,69
1656802669190,COGS 11,A01,083617,Boyle; Mary E. T.,18,0,48,30
1656802675217,COGS 13,A01,083071,Bastos; Amalia Pinkusfeld,8,0,71,63
1656802681239,COGS 14A,A01,092681,Semenuks; Arturs,0,1,100,100
1656802687262,COGS 14B,A01,083073,Cheng; Tzu-Han,5,0,63,58
1656802693284,COGS 17,A01,092677,Semenuks; Arturs,4,0,81,77
1656802699310,COGS 100,A01,083619,Allen; Michael Gordon,15,0,70,55
1656802705344,COGS 101A,A01,083621,Davis; Joshua Daniel,9,0,68,59
1656802711370,COGS 101B,A01,091572,Allen; Michael Gordon,8,0,65,57
1656802717393,COGS 101C,A01,083625,Delgado; Tania,17,0,35,18
1656802723416,COGS 107A,A01,083627,Boyle; Mary E. T.,13,0,60,47
1656802729442,COGS 118A,A01,083075,Gupta; Anjum,15,0,76,61
1656802735469,CSE 3,A50,083646,Miranda; Gregory Joseph,22,0,50,28
1656802741495,CSE 8A,A50,083650,Miranda; Gregory Joseph,17,1,56,39
1656802747519,CSE 11,A01,083080,Cao; Yingjun,4,15,40,36
1656802753543,CSE 12,A01,083652,Krause-Levy; Sophia Louisa,20,1,120,100
1656802759566,CSE 15L,A01,083654,Morris; Justin Loren,8,0,50,42
1656802759566,CSE 15L,A02,083655,Morris; Justin Loren,8,0,50,42
1656802765588,CSE 20,A01,083657,Tran; Khoa Dang,37,0,80,43
1656802771614,CSE 21,A01,095574,Bach; Quang Tran,21,0,48,27
1656802777660,CSE 30,A01,083084,Eldon; John,4,0,80,76
1656802777660,CSE 30,B01,095061,Bhaskar; Nishant,5,0,50,45
1656802783683,CSE 100,A01,083659,Cao; Yingjun,1,4,70,69
1656802789709,CSE 134B,A01,083661,Powell; Thomas Allan,18,0,100,82
1656802795732,CSE 140,A01,083663,Gungor; Onat,14,0,85,71
1656802801754,CSE 140L,A01,083088,Eldon; John,16,0,100,84
1656802807777,CSE 175,A01,083665,Kumar; Rakesh,3,0,25,22
1656802813798,CSE 190,A00,092507,Dubnov; Shlomo,7,0,20,13
1656802819823,ECE 45,A01,083139,Congero; Spencer William,5,0,75,70
1656802825850,ECE 65,A50,083695,Saad; Andrew S,12,0,30,18
1656802825850,ECE 65,A51,095125,Saad; Andrew S,25,0,26,1
1656802831883,ECE 109,A01,091882,Touri; Behrouz,15,0,70,55
1656802837919,ECE 180,A00,083140,Abi Samra; Nicholas Camill,0,0,30,30
1656802837919,ECE 180,B00,083141,Abi Samra; Nicholas Camill,0,0,30,30
1656802843940,MATH 10A,A01,083735,Patchell; Gregory David,1,0,30,29
1656802843940,MATH 10A,A02,083736,Patchell; Gregory David,20,0,30,10
1656802843940,MATH 10A,A03,083737,Patchell; Gregory David,15,0,30,15
1656802850020,MATH 10B,A01,083207,Lim; Seonhee,7,0,34,27
1656802850020,MATH 10B,A02,083208,Lim; Seonhee,9,0,35,26
1656802850020,MATH 10B,A03,093472,Lim; Seonhee,4,0,34,30
1656802850020,MATH 10B,B01,083739,Sinha; Shubham,9,0,30,21
1656802856045,MATH 18,A01,083743,Cinel; Cameron Alexander,6,0,30,24
1656802856045,MATH 18,A02,083744,Cinel; Cameron Alexander,15,0,30,15
1656802856045,MATH 18,A03,083745,Cinel; Cameron Alexander,8,0,30,22
1656802856045,MATH 18,B01,083748,Rideout; David Porter,3,0,37,34
1656802856045,MATH 18,B02,083749,Rideout; David Porter,3,0,36,33
1656802856045,MATH 18,B03,083750,Rideout; David Porter,1,0,37,36
1656802856045,MATH 18,B04,083751,Rideout; David Porter,5,0,36,31
1656802856045,MATH 18,B05,093473,Rideout; David Porter,4,0,36,32
1656802856045,MATH 18,B06,093474,Rideout; David Porter,5,0,36,31
1656802862071,MATH 20A,A01,083754,Zheng; Zequn,12,0,40,28
1656802868094,MATH 20B,A01,083756,Briones; Jor-el Thomas Caparas,1,0,36,35
1656802868094,MATH 20B,A02,083757,Briones; Jor-el Thomas Caparas,1,0,36,35
1656802868094,MATH 20B,A03,093475,Briones; Jor-el Thomas Caparas,0,0,36,36
1656802874120,MATH 20C,A01,083760,Briones; Jor-el Thomas Caparas,1,0,35,34
1656802874120,MATH 20C,A02,083761,Briones; Jor-el Thomas Caparas,8,0,35,27
1656802874120,MATH 20C,A03,093476,Briones; Jor-el Thomas Caparas,0,1,36,36
1656802874120,MATH 20C,B01,083762,Bach; Quang Tran,0,0,30,30
1656802880142,MATH 20D,A01,083765,Tran; Brian Kha,4,0,30,26
1656802880142,MATH 20D,A02,083766,Tran; Brian Kha,4,0,30,26
1656802880142,MATH 20D,A03,083767,Tran; Brian Kha,2,0,30,28
1656802886164,MATH 20E,A01,083771,Ganguly; Soumya,5,0,32,27
1656802886164,MATH 20E,A02,083772,Ganguly; Soumya,5,0,32,27
1656802886164,MATH 20E,B01,083773,Ciotti; Benjamin,18,0,35,17
1656802886164,MATH 20E,B02,083774,Ciotti; Benjamin,17,0,35,18
1656802892193,MATH 103A,A01,083777,Greenfeld; Be'Eri,2,0,36,34
1656802892193,MATH 103A,A02,083778,Greenfeld; Be'Eri,5,0,36,31
1656802892193,MATH 103A,A03,093561,Greenfeld; Be'Eri,4,0,36,32
1656802892193,MATH 103A,B01,083779,Greenfeld; Be'Eri,6,0,36,30
1656802892193,MATH 103A,B02,083780,Greenfeld; Be'Eri,2,0,36,34
1656802892193,MATH 103A,B03,093562,Greenfeld; Be'Eri,2,0,36,34
1656802898215,MATH 105,A01,085443,Carter; Anne Toulson,13,0,35,22
1656802898215,MATH 105,A02,093477,Carter; Anne Toulson,20,0,35,15
1656802904239,MATH 109,A01,083213,Ganzberger; Geoffrey Michael,2,0,34,32
1656802904239,MATH 109,A02,083214,Ganzberger; Geoffrey Michael,2,0,34,32
1656802904239,MATH 109,A03,093478,Ganzberger; Geoffrey Michael,1,0,34,33
1656802904239,MATH 109,B01,083215,Ganzberger; Geoffrey Michael,1,0,32,31
1656802904239,MATH 109,B02,083216,Ganzberger; Geoffrey Michael,1,0,32,31
1656802904239,MATH 109,B03,093479,Ganzberger; Geoffrey Michael,6,0,32,26
1656802910268,MATH 142A,A01,083219,Chow; Bennett,6,0,32,26
1656802910268,MATH 142A,A02,083220,Chow; Bennett,9,0,32,23
1656802910268,MATH 142A,A03,093480,Chow; Bennett,7,0,32,25
1656802910268,MATH 142A,B03,093481,Chow; Bennett,7,0,32,25
1656802910268,MATH 142A,B04,093558,Chow; Bennett,10,0,32,22
1656802910268,MATH 142A,B05,093559,Chow; Bennett,6,0,32,26
1656802916292,MATH 193A,A01,083224,Rotar; Vladimir,6,0,34,28
1656802916292,MATH 193A,A02,083225,Rotar; Vladimir,3,0,34,31
1656802916292,MATH 193A,A03,083781,Rotar; Vladimir,1,0,34,33
1656802916292,MATH 193A,A04,083782,Rotar; Vladimir,6,0,34,28
1656802916292,MATH 193A,A05,093482,Rotar; Vladimir,6,0,34,28
1656802922315,MATH 197,001,091859,McAuley; Julian John,9999,0,9999,0
1656802922315,MATH 197,002,095566,Kedlaya; Kiran S.,9997,0,9999,2
1656802922315,MATH 197,003,095567,Xiao; Ming,9999,0,9999,0
1656802922315,MATH 197,004,095571,Perols; Johan Lars,9998,0,9999,1
1656802929387,COGS 9,A01,083615,Shannon; Kyle Michael,6,0,75,69
1656802935498,COGS 11,A01,083617,Boyle; Mary E. T.,18,0,48,30
1656802941520,COGS 13,A01,083071,Bastos; Amalia Pinkusfeld,8,0,71,63
1656802947541,COGS 14A,A01,092681,Semenuks; Arturs,0,1,100,100
1656802953564,COGS 14B,A01,083073,Cheng; Tzu-Han,5,0,63,58
1656802959587,COGS 17,A01,092677,Semenuks; Arturs,4,0,81,77
1656802965609,COGS 100,A01,083619,Allen; Michael Gordon,15,0,70,55
1656802971635,COGS 101A,A01,083621,Davis; Joshua Daniel,9,0,68,59
1656802977661,COGS 101B,A01,091572,Allen; Michael Gordon,8,0,65,57
1656802983683,COGS 101C,A01,083625,Delgado; Tania,17,0,35,18
1656802989710,COGS 107A,A01,083627,Boyle; Mary E. T.,13,0,60,47
1656802995736,COGS 118A,A01,083075,Gupta; Anjum,15,0,76,61
1656803001764,CSE 3,A50,083646,Miranda; Gregory Joseph,22,0,50,28
1656803007791,CSE 8A,A50,083650,Miranda; Gregory Joseph,17,1,56,39
1656803013818,CSE 11,A01,083080,Cao; Yingjun,4,15,40,36
1656803019845,CSE 12,A01,083652,Krause-Levy; Sophia Louisa,20,1,120,100
1656803025869,CSE 15L,A01,083654,Morris; Justin Loren,8,0,50,42
1656803025869,CSE 15L,A02,083655,Morris; Justin Loren,8,0,50,42
1656803031895,CSE 20,A01,083657,Tran; Khoa Dang,37,0,80,43
1656803037919,CSE 21,A01,095574,Bach; Quang Tran,21,0,48,27
1656803043944,CSE 30,A01,083084,Eldon; John,4,0,80,76
1656803043944,CSE 30,B01,095061,Bhaskar; Nishant,5,0,50,45
1656803049971,CSE 100,A01,083659,Cao; Yingjun,1,4,70,69
1656803055997,CSE 134B,A01,083661,Powell; Thomas Allan,18,0,100,82
1656803062018,CSE 140,A01,083663,Gungor; Onat,14,0,85,71
1656803068041,CSE 140L,A01,083088,Eldon; John,16,0,100,84
1656803074065,CSE 175,A01,083665,Kumar; Rakesh,3,0,25,22
1656803080091,CSE 190,A00,092507,Dubnov; Shlomo,7,0,20,13
1656803086112,ECE 45,A01,083139,Congero; Spencer William,5,0,75,70
1656803092139,ECE 65,A50,083695,Saad; Andrew S,12,0,30,18
1656803092139,ECE 65,A51,095125,Saad; Andrew S,25,0,26,1
1656803098165,ECE 109,A01,091882,Touri; Behrouz,15,0,70,55
1656803104190,ECE 180,A00,083140,Abi Samra; Nicholas Camill,0,0,30,30
1656803104190,ECE 180,B00,083141,Abi Samra; Nicholas Camill,0,0,30,30
1656803110213,MATH 10A,A01,083735,Patchell; Gregory David,1,0,30,29
1656803110213,MATH 10A,A02,083736,Patchell; Gregory David,20,0,30,10
1656803110213,MATH 10A,A03,083737,Patchell; Gregory David,15,0,30,15
1656803116236,MATH 10B,A01,083207,Lim; Seonhee,7,0,34,27
1656803116236,MATH 10B,A02,083208,Lim; Seonhee,9,0,35,26
1656803116236,MATH 10B,A03,093472,Lim; Seonhee,4,0,34,30
1656803116236,MATH 10B,B01,083739,Sinha; Shubham,9,0,30,21
1656803122261,MATH 18,A01,083743,Cinel; Cameron Alexander,6,0,30,24
1656803122261,MATH 18,A02,083744,Cinel; Cameron Alexander,15,0,30,15
1656803122261,MATH 18,A03,083745,Cinel; Cameron Alexander,8,0,30,22
1656803122261,MATH 18,B01,083748,Rideout; David Porter,3,0,37,34
1656803122261,MATH 18,B02,083749,Rideout; David Porter,3,0,36,33
1656803122261,MATH 18,B03,083750,Rideout; David Porter,1,0,37,36
1656803122261,MATH 18,B04,083751,Rideout; David Porter,5,0,36,31
1656803122261,MATH 18,B05,093473,Rideout; David Porter,4,0,36,32
1656803122261,MATH 18,B06,093474,Rideout; David Porter,5,0,36,31
1656803128288,MATH 20A,A01,083754,Zheng; Zequn,12,0,40,28
1656803134314,MATH 20B,A01,083756,Briones; Jor-el Thomas Caparas,1,0,36,35
1656803134314,MATH 20B,A02,083757,Briones; Jor-el Thomas Caparas,1,0,36,35
1656803134314,MATH 20B,A03,093475,Briones; Jor-el Thomas Caparas,0,0,36,36
1656803140336,MATH 20C,A01,083760,Briones; Jor-el Thomas Caparas,1,0,35,34
1656803140336,MATH 20C,A02,083761,Briones; Jor-el Thomas Caparas,8,0,35,27
1656803140336,MATH 20C,A03,093476,Briones; Jor-el Thomas Caparas,0,1,36,36
1656803140336,MATH 20C,B01,083762,Bach; Quang Tran,0,0,30,30
1656803146360,MATH 20D,A01,083765,Tran; Brian Kha,4,0,30,26
1656803146360,MATH 20D,A02,083766,Tran; Brian Kha,4,0,30,26
1656803146360,MATH 20D,A03,083767,Tran; Brian Kha,2,0,30,28
1656803152387,MATH 20E,A01,083771,Ganguly; Soumya,5,0,32,27
1656803152387,MATH 20E,A02,083772,Ganguly; Soumya,5,0,32,27
1656803152387,MATH 20E,B01,083773,Ciotti; Benjamin,18,0,35,17
1656803152387,MATH 20E,B02,083774,Ciotti; Benjamin,17,0,35,18
1656803158416,MATH 103A,A01,083777,Greenfeld; Be'Eri,2,0,36,34
1656803158416,MATH 103A,A02,083778,Greenfeld; Be'Eri,5,0,36,31
1656803158416,MATH 103A,A03,093561,Greenfeld; Be'Eri,4,0,36,32
1656803158416,MATH 103A,B01,083779,Greenfeld; Be'Eri,6,0,36,30
1656803158416,MATH 103A,B02,083780,Greenfeld; Be'Eri,2,0,36,34
1656803158416,MATH 103A,B03,093562,Greenfeld; Be'Eri,2,0,36,34
1656803164441,MATH 105,A01,085443,Carter; Anne Toulson,13,0,35,22
1656803164441,MATH 105,A02,093477,Carter; Anne Toulson,20,0,35,15
1656803170470,MATH 109,A01,083213,Ganzberger; Geoffrey Michael,2,0,34,32
1656803170470,MATH 109,A02,083214,Ganzberger; Geoffrey Michael,2,0,34,32
1656803170470,MATH 109,A03,093478,Ganzberger; Geoffrey Michael,1,0,34,33
1656803170470,MATH 109,B01,083215,Ganzberger; Geoffrey Michael,1,0,32,31
1656803170470,MATH 109,B02,083216,Ganzberger; Geoffrey Michael,1,0,32,31
1656803170470,MATH 109,B03,093479,Ganzberger; Geoffrey Michael,6,0,32,26
1656803176498,MATH 142A,A01,083219,Chow; Bennett,6,0,32,26
1656803176498,MATH 142A,A02,083220,Chow; Bennett,9,0,32,23
1656803176498,MATH 142A,A03,093480,Chow; Bennett,7,0,32,25
1656803176498,MATH 142A,B03,093481,Chow; Bennett,7,0,32,25
1656803176498,MATH 142A,B04,093558,Chow; Bennett,10,0,32,22
1656803176498,MATH 142A,B05,093559,Chow; Bennett,6,0,32,26
1656803182525,MATH 193A,A01,083224,Rotar; Vladimir,6,0,34,28
1656803182525,MATH 193A,A02,083225,Rotar; Vladimir,3,0,34,31
1656803182525,MATH 193A,A03,083781,Rotar; Vladimir,1,0,34,33
1656803182525,MATH 193A,A04,083782,Rotar; Vladimir,6,0,34,28
1656803182525,MATH 193A,A05,093482,Rotar; Vladimir,6,0,34,28
1656803188551,MATH 197,001,091859,McAuley; Julian John,9999,0,9999,0
1656803188551,MATH 197,002,095566,Kedlaya; Kiran S.,9997,0,9999,2
1656803188551,MATH 197,003,095567,Xiao; Ming,9999,0,9999,0
1656803188551,MATH 197,004,095571,Perols; Johan Lars,9998,0,9999,1
1656803195620,COGS 9,A01,083615,Shannon; Kyle Michael,6,0,75,69
1656803201648,COGS 11,A01,083617,Boyle; Mary E. T.,18,0,48,30
1656803207676,COGS 13,A01,083071,Bastos; Amalia Pinkusfeld,8,0,71,63
1656803213699,COGS 14A,A01,092681,Semenuks; Arturs,0,1,100,100
1656803219729,COGS 14B,A01,083073,Cheng; Tzu-Han,5,0,63,58
1656803225753,COGS 17,A01,092677,Semenuks; Arturs,4,0,81,77
1656803231783,COGS 100,A01,083619,Allen; Michael Gordon,15,0,70,55
1656803237805,COGS 101A,A01,083621,Davis; Joshua Daniel,9,0,68,59
1656803243836,COGS 101B,A01,091572,Allen; Michael Gordon,8,0,65,57
1656803249873,COGS 101C,A01,083625,Delgado; Tania,17,0,35,18
1656803255900,COGS 107A,A01,083627,Boyle; Mary E. T.,13,0,60,47
1656803261932,COGS 118A,A01,083075,Gupta; Anjum,15,0,76,61
1656803267960,CSE 3,A50,083646,Miranda; Gregory Joseph,22,0,50,28
1656803273987,CSE 8A,A50,083650,Miranda; Gregory Joseph,17,1,56,39
1656803280018,CSE 11,A01,083080,Cao; Yingjun,4,15,40,36
1656803286041,CSE 12,A01,083652,Krause-Levy; Sophia Louisa,20,1,120,100
1656803292067,CSE 15L,A01,083654,Morris; Justin Loren,8,0,50,42
1656803292067,CSE 15L,A02,083655,Morris; Justin Loren,8,0,50,42
1656803298089,CSE 20,A01,083657,Tran; Khoa Dang,37,0,80,43
1656803304112,CSE 21,A01,095574,Bach; Quang Tran,21,0,48,27
1656803310136,CSE 30,A01,083084,Eldon; John,4,0,80,76
1656803310136,CSE 30,B01,095061,Bhaskar; Nishant,5,0,50,45
1656803316159,CSE 100,A01,083659,Cao; Yingjun,1,4,70,69
1656803322204,CSE 134B,A01,083661,Powell; Thomas Allan,18,0,100,82
1656803328230,CSE 140,A01,083663,Gungor; Onat,14,0,85,71
1656803334254,CSE 140L,A01,083088,Eldon; John,16,0,100,84
1656803340279,CSE 175,A01,083665,Kumar; Rakesh,3,0,25,22
1656803346305,CSE 190,A00,092507,Dubnov; Shlomo,7,0,20,13
1656803352331,ECE 45,A01,083139,Congero; Spencer William,5,0,75,70
1656803358354,ECE 65,A50,083695,Saad; Andrew S,12,0,30,18
1656803358354,ECE 65,A51,095125,Saad; Andrew S,25,0,26,1
1656803364377,ECE 109,A01,091882,Touri; Behrouz,15,0,70,55
1656803370401,ECE 180,A00,083140,Abi Samra; Nicholas Camill,0,0,30,30
1656803370401,ECE 180,B00,083141,Abi Samra; Nicholas Camill,0,0,30,30
1656803376423,MATH 10A,A01,083735,Patchell; Gregory David,1,0,30,29
1656803376423,MATH 10A,A02,083736,Patchell; Gregory David,20,0,30,10
1656803376423,MATH 10A,A03,083737,Patchell; Gregory David,15,0,30,15
1656803382448,MATH 10B,A01,083207,Lim; Seonhee,7,0,34,27
1656803382448,MATH 10B,A02,083208,Lim; Seonhee,9,0,35,26
1656803382448,MATH 10B,A03,093472,Lim; Seonhee,4,0,34,30
1656803382448,MATH 10B,B01,083739,Sinha; Shubham,9,0,30,21
1656803388474,MATH 18,A01,083743,Cinel; Cameron Alexander,6,0,30,24
1656803388474,MATH 18,A02,083744,Cinel; Cameron Alexander,15,0,30,15
1656803388474,MATH 18,A03,083745,Cinel; Cameron Alexander,8,0,30,22
1656803388474,MATH 18,B01,083748,Rideout; David Porter,3,0,37,34
1656803388474,MATH 18,B02,083749,Rideout; David Porter,3,0,36,33
1656803388474,MATH 18,B03,083750,Rideout; David Porter,1,0,37,36
1656803388474,MATH 18,B04,083751,Rideout; David Porter,5,0,36,31
1656803388474,MATH 18,B05,093473,Rideout; David Porter,4,0,36,32
1656803388474,MATH 18,B06,093474,Rideout; David Porter,5,0,36,31
1656803394501,MATH 20A,A01,083754,Zheng; Zequn,12,0,40,28
1656803400524,MATH 20B,A01,083756,Briones; Jor-el Thomas Caparas,1,0,36,35
1656803400524,MATH 20B,A02,083757,Briones; Jor-el Thomas Caparas,1,0,36,35
1656803400524,MATH 20B,A03,093475,Briones; Jor-el Thomas Caparas,0,0,36,36
1656803406552,MATH 20C,A01,083760,Briones; Jor-el Thomas Caparas,1,0,35,34
1656803406552,MATH 20C,A02,083761,Briones; Jor-el Thomas Caparas,8,0,35,27
1656803406552,MATH 20C,A03,093476,Briones; Jor-el Thomas Caparas,0,1,36,36
1656803406552,MATH 20C,B01,083762,Bach; Quang Tran,0,0,30,30
1656803412578,MATH 20D,A01,083765,Tran; Brian Kha,4,0,30,26
1656803412578,MATH 20D,A02,083766,Tran; Brian Kha,4,0,30,26
1656803412578,MATH 20D,A03,083767,Tran; Brian Kha,2,0,30,28
1656803418612,MATH 20E,A01,083771,Ganguly; Soumya,5,0,32,27
1656803418612,MATH 20E,A02,083772,Ganguly; Soumya,5,0,32,27
1656803418612,MATH 20E,B01,083773,Ciotti; Benjamin,18,0,35,17
1656803418612,MATH 20E,B02,083774,Ciotti; Benjamin,17,0,35,18
1656803424637,MATH 103A,A01,083777,Greenfeld; Be'Eri,2,0,36,34
1656803424637,MATH 103A,A02,083778,Greenfeld; Be'Eri,5,0,36,31
1656803424637,MATH 103A,A03,093561,Greenfeld; Be'Eri,4,0,36,32
1656803424637,MATH 103A,B01,083779,Greenfeld; Be'Eri,6,0,36,30
1656803424637,MATH 103A,B02,083780,Greenfeld; Be'Eri,2,0,36,34
1656803424637,MATH 103A,B03,093562,Greenfeld; Be'Eri,2,0,36,34
1656803430661,MATH 105,A01,085443,Carter; Anne Toulson,13,0,35,22
1656803430661,MATH 105,A02,093477,Carter; Anne Toulson,20,0,35,15
1656803436685,MATH 109,A01,083213,Ganzberger; Geoffrey Michael,2,0,34,32
1656803436685,MATH 109,A02,083214,Ganzberger; Geoffrey Michael,2,0,34,32
1656803436685,MATH 109,A03,093478,Ganzberger; Geoffrey Michael,1,0,34,33
1656803436685,MATH 109,B01,083215,Ganzberger; Geoffrey Michael,1,0,32,31
1656803436685,MATH 109,B02,083216,Ganzberger; Geoffrey Michael,1,0,32,31
1656803436685,MATH 109,B03,093479,Ganzberger; Geoffrey Michael,6,0,32,26
1656803442715,MATH 142A,A01,083219,Chow; Bennett,6,0,32,26
1656803442715,MATH 142A,A02,083220,Chow; Bennett,9,0,32,23
1656803442715,MATH 142A,A03,093480,Chow; Bennett,7,0,32,25
1656803442715,MATH 142A,B03,093481,Chow; Bennett,7,0,32,25
1656803442715,MATH 142A,B04,093558,Chow; Bennett,10,0,32,22
1656803442715,MATH 142A,B05,093559,Chow; Bennett,6,0,32,26
1656803448737,MATH 193A,A01,083224,Rotar; Vladimir,6,0,34,28
1656803448737,MATH 193A,A02,083225,Rotar; Vladimir,3,0,34,31
1656803448737,MATH 193A,A03,083781,Rotar; Vladimir,1,0,34,33
1656803448737,MATH 193A,A04,083782,Rotar; Vladimir,6,0,34,28
1656803448737,MATH 193A,A05,093482,Rotar; Vladimir,6,0,34,28
1656803454763,MATH 197,001,091859,McAuley; Julian John,9999,0,9999,0
1656803454763,MATH 197,002,095566,Kedlaya; Kiran S.,9997,0,9999,2
1656803454763,MATH 197,003,095567,Xiao; Ming,9999,0,9999,0
1656803454763,MATH 197,004,095571,Perols; Johan Lars,9998,0,9999,1
1656803461819,COGS 9,A01,083615,Shannon; Kyle Michael,6,0,75,69
1656803467842,COGS 11,A01,083617,Boyle; Mary E. T.,18,0,48,30
1656803473864,COGS 13,A01,083071,Bastos; Amalia Pinkusfeld,8,0,71,63
1656803479892,COGS 14A,A01,092681,Semenuks; Arturs,0,1,100,100
1656803485919,COGS 14B,A01,083073,Cheng; Tzu-Han,5,0,63,58
1656803491942,COGS 17,A01,092677,Semenuks; Arturs,4,0,81,77
1656803497972,COGS 100,A01,083619,Allen; Michael Gordon,15,0,70,55
1656803504002,COGS 101A,A01,083621,Davis; Joshua Daniel,9,0,68,59
1656803510028,COGS 101B,A01,091572,Allen; Michael Gordon,8,0,65,57
1656803516051,COGS 101C,A01,083625,Delgado; Tania,17,0,35,18
1656803522076,COGS 107A,A01,083627,Boyle; Mary E. T.,13,0,60,47
1656803528098,COGS 118A,A01,083075,Gupta; Anjum,15,0,76,61
1656803534197,CSE 3,A50,083646,Miranda; Gregory Joseph,22,0,50,28
1656803540225,CSE 8A,A50,083650,Miranda; Gregory Joseph,17,1,56,39
1656803546248,CSE 11,A01,083080,Cao; Yingjun,4,15,40,36
1656803552271,CSE 12,A01,083652,Krause-Levy; Sophia Louisa,20,1,120,100
1656803558295,CSE 15L,A01,083654,Morris; Justin Loren,8,0,50,42
1656803558295,CSE 15L,A02,083655,Morris; Justin Loren,8,0,50,42
1656803564317,CSE 20,A01,083657,Tran; Khoa Dang,37,0,80,43
1656803570341,CSE 21,A01,095574,Bach; Quang Tran,21,0,48,27
1656803576370,CSE 30,A01,083084,Eldon; John,4,0,80,76
1656803576370,CSE 30,B01,095061,Bhaskar; Nishant,5,0,50,45
1656803582393,CSE 100,A01,083659,Cao; Yingjun,1,4,70,69
1656803588423,CSE 134B,A01,083661,Powell; Thomas Allan,18,0,100,82
1656803594449,CSE 140,A01,083663,Gungor; Onat,14,0,85,71
1656803600475,CSE 140L,A01,083088,Eldon; John,16,0,100,84
1656803606497,CSE 175,A01,083665,Kumar; Rakesh,3,0,25,22
1656803612520,CSE 190,A00,092507,Dubnov; Shlomo,7,0,20,13
1656803618546,ECE 45,A01,083139,Congero; Spencer William,5,0,75,70
1656803624573,ECE 65,A50,083695,Saad; Andrew S,12,0,30,18
1656803624573,ECE 65,A51,095125,Saad; Andrew S,25,0,26,1
1656803630598,ECE 109,A01,091882,Touri; Behrouz,15,0,70,55
1656803636625,ECE 180,A00,083140,Abi Samra; Nicholas Camill,0,0,30,30
1656803636625,ECE 180,B00,083141,Abi Samra; Nicholas Camill,0,0,30,30
1656803642649,MATH 10A,A01,083735,Patchell; Gregory David,1,0,30,29
1656803642649,MATH 10A,A02,083736,Patchell; Gregory David,20,0,30,10
1656803642649,MATH 10A,A03,083737,Patchell; Gregory David,15,0,30,15
1656803648675,MATH 10B,A01,083207,Lim; Seonhee,7,0,34,27
1656803648675,MATH 10B,A02,083208,Lim; Seonhee,9,0,35,26
1656803648675,MATH 10B,A03,093472,Lim; Seonhee,4,0,34,30
1656803648675,MATH 10B,B01,083739,Sinha; Shubham,9,0,30,21
1656803654700,MATH 18,A01,083743,Cinel; Cameron Alexander,6,0,30,24
1656803654700,MATH 18,A02,083744,Cinel; Cameron Alexander,15,0,30,15
1656803654700,MATH 18,A03,083745,Cinel; Cameron Alexander,8,0,30,22
1656803654700,MATH 18,B01,083748,Rideout; David Porter,3,0,37,34
1656803654700,MATH 18,B02,083749,Rideout; David Porter,3,0,36,33
1656803654700,MATH 18,B03,083750,Rideout; David Porter,1,0,37,36
1656803654700,MATH 18,B04,083751,Rideout; David Porter,5,0,36,31
1656803654700,MATH 18,B05,093473,Rideout; David Porter,4,0,36,32
1656803654700,MATH 18,B06,093474,Rideout; David Porter,5,0,36,31
1656803660734,MATH 20A,A01,083754,Zheng; Zequn,12,0,40,28
1656803666757,MATH 20B,A01,083756,Briones; Jor-el Thomas Caparas,1,0,36,35
1656803666757,MATH 20B,A02,083757,Briones; Jor-el Thomas Caparas,1,0,36,35
1656803666757,MATH 20B,A03,093475,Briones; Jor-el Thomas Caparas,0,0,36,36
1656803672796,MATH 20C,A01,083760,Briones; Jor-el Thomas Caparas,1,0,35,34
1656803672796,MATH 20C,A02,083761,Briones; Jor-el Thomas Caparas,8,0,35,27
1656803672796,MATH 20C,A03,093476,Briones; Jor-el Thomas Caparas,0,1,36,36
1656803672796,MATH 20C,B01,083762,Bach; Quang Tran,0,0,30,30
1656803678821,MATH 20D,A01,083765,Tran; Brian Kha,4,0,30,26
1656803678821,MATH 20D,A02,083766,Tran; Brian Kha,4,0,30,26
1656803678821,MATH 20D,A03,083767,Tran; Brian Kha,2,0,30,28
1656803684844,MATH 20E,A01,083771,Ganguly; Soumya,5,0,32,27
1656803684844,MATH 20E,A02,083772,Ganguly; Soumya,5,0,32,27
1656803684844,MATH 20E,B01,083773,Ciotti; Benjamin,18,0,35,17
1656803684844,MATH 20E,B02,083774,Ciotti; Benjamin,17,0,35,18
1656803690870,MATH 103A,A01,083777,Greenfeld; Be'Eri,2,0,36,34
1656803690870,MATH 103A,A02,083778,Greenfeld; Be'Eri,5,0,36,31
1656803690870,MATH 103A,A03,093561,Greenfeld; Be'Eri,4,0,36,32
1656803690870,MATH 103A,B01,083779,Greenfeld; Be'Eri,6,0,36,30
1656803690870,MATH 103A,B02,083780,Greenfeld; Be'Eri,2,0,36,34
1656803690870,MATH 103A,B03,093562,Greenfeld; Be'Eri,2,0,36,34
1656803696902,MATH 105,A01,085443,Carter; Anne Toulson,13,0,35,22
1656803696902,MATH 105,A02,093477,Carter; Anne Toulson,20,0,35,15
1656803702924,MATH 109,A01,083213,Ganzberger; Geoffrey Michael,2,0,34,32
1656803702924,MATH 109,A02,083214,Ganzberger; Geoffrey Michael,2,0,34,32
1656803702924,MATH 109,A03,093478,Ganzberger; Geoffrey Michael,1,0,34,33
1656803702924,MATH 109,B01,083215,Ganzberger; Geoffrey Michael,1,0,32,31
1656803702924,MATH 109,B02,083216,Ganzberger; Geoffrey Michael,1,0,32,31
1656803702924,MATH 109,B03,093479,Ganzberger; Geoffrey Michael,6,0,32,26
1656803708954,MATH 142A,A01,083219,Chow; Bennett,6,0,32,26
1656803708954,MATH 142A,A02,083220,Chow; Bennett,9,0,32,23
1656803708954,MATH 142A,A03,093480,Chow; Bennett,7,0,32,25
1656803708954,MATH 142A,B03,093481,Chow; Bennett,7,0,32,25
1656803708954,MATH 142A,B04,093558,Chow; Bennett,10,0,32,22
1656803708954,MATH 142A,B05,093559,Chow; Bennett,6,0,32,26
1656803714981,MATH 193A,A01,083224,Rotar; Vladimir,6,0,34,28
1656803714981,MATH 193A,A02,083225,Rotar; Vladimir,3,0,34,31
1656803714981,MATH 193A,A03,083781,Rotar; Vladimir,1,0,34,33
1656803714981,MATH 193A,A04,083782,Rotar; Vladimir,6,0,34,28
1656803714981,MATH 193A,A05,093482,Rotar; Vladimir,6,0,34,28
1656803721008,MATH 197,001,091859,McAuley; Julian John,9999,0,9999,0
1656803721008,MATH 197,002,095566,Kedlaya; Kiran S.,9997,0,9999,2
1656803721008,MATH 197,003,095567,Xiao; Ming,9999,0,9999,0
1656803721008,MATH 197,004,095571,Perols; Johan Lars,9998,0,9999,1
1656803728060,COGS 9,A01,083615,Shannon; Kyle Michael,6,0,75,69
1656803734086,COGS 11,A01,083617,Boyle; Mary E. T.,18,0,48,30
1656803740109,COGS 13,A01,083071,Bastos; Amalia Pinkusfeld,8,0,71,63
1656803746141,COGS 14A,A01,092681,Semenuks; Arturs,0,1,100,100
1656803752165,COGS 14B,A01,083073,Cheng; Tzu-Han,5,0,63,58
1656803758188,COGS 17,A01,092677,Semenuks; Arturs,4,0,81,77
1656803764211,COGS 100,A01,083619,Allen; Michael Gordon,15,0,70,55
1656803770233,COGS 101A,A01,083621,Davis; Joshua Daniel,9,0,68,59
1656803776260,COGS 101B,A01,091572,Allen; Michael Gordon,8,0,65,57
1656803782283,COGS 101C,A01,083625,Delgado; Tania,17,0,35,18
1656803788306,COGS 107A,A01,083627,Boyle; Mary E. T.,13,0,60,47
1656803794329,COGS 118A,A01,083075,Gupta; Anjum,15,0,76,61
1656803800358,CSE 3,A50,083646,Miranda; Gregory Joseph,22,0,50,28
1656803806381,CSE 8A,A50,083650,Miranda; Gregory Joseph,17,1,56,39
1656803812408,CSE 11,A01,083080,Cao; Yingjun,4,15,40,36
1656803818436,CSE 12,A01,083652,Krause-Levy; Sophia Louisa,20,1,120,100
1656803824461,CSE 15L,A01,083654,Morris; Justin Loren,8,0,50,42
1656803824461,CSE 15L,A02,083655,Morris; Justin Loren,8,0,50,42
1656803830484,CSE 20,A01,083657,Tran; Khoa Dang,37,0,80,43
1656803836508,CSE 21,A01,095574,Bach; Quang Tran,21,0,48,27
1656803842542,CSE 30,A01,083084,Eldon; John,4,0,80,76
1656803842542,CSE 30,B01,095061,Bhaskar; Nishant,5,0,50,45
1656803848570,CSE 100,A01,083659,Cao; Yingjun,1,4,70,69
1656803854592,CSE 134B,A01,083661,Powell; Thomas Allan,18,0,100,82
1656803860632,CSE 140,A01,083663,Gungor; Onat,14,0,85,71
1656803866656,CSE 140L,A01,083088,Eldon; John,16,0,100,84
1656803872679,CSE 175,A01,083665,Kumar; Rakesh,3,0,25,22
1656803878702,CSE 190,A00,092507,Dubnov; Shlomo,7,0,20,13
1656803884732,ECE 45,A01,083139,Congero; Spencer William,5,0,75,70
1656803890756,ECE 65,A50,083695,Saad; Andrew S,12,0,30,18
1656803890756,ECE 65,A51,095125,Saad; Andrew S,25,0,26,1
1656803896777,ECE 109,A01,091882,Touri; Behrouz,15,0,70,55
1656803902803,ECE 180,A00,083140,Abi Samra; Nicholas Camill,0,0,30,30
1656803902803,ECE 180,B00,083141,Abi Samra; Nicholas Camill,0,0,30,30
1656803908826,MATH 10A,A01,083735,Patchell; Gregory David,1,0,30,29
1656803908826,MATH 10A,A02,083736,Patchell; Gregory David,20,0,30,10
1656803908826,MATH 10A,A03,083737,Patchell; Gregory David,15,0,30,15
1656803914849,MATH 10B,A01,083207,Lim; Seonhee,7,0,34,27
1656803914849,MATH 10B,A02,083208,Lim; Seonhee,9,0,35,26
1656803914849,MATH 10B,A03,093472,Lim; Seonhee,4,0,34,30
1656803914849,MATH 10B,B01,083739,Sinha; Shubham,9,0,30,21
1656803920880,MATH 18,A01,083743,Cinel; Cameron Alexander,6,0,30,24
1656803920880,MATH 18,A02,083744,Cinel; Cameron Alexander,15,0,30,15
1656803920880,MATH 18,A03,083745,Cinel; Cameron Alexander,8,0,30,22
1656803920880,MATH 18,B01,083748,Rideout; David Porter,3,0,37,34
1656803920880,MATH 18,B02,083749,Rideout; David Porter,3,0,36,33
1656803920880,MATH 18,B03,083750,Rideout; David Porter,1,0,37,36
1656803920880,MATH 18,B04,083751,Rideout; David Porter,5,0,36,31
1656803920880,MATH 18,B05,093473,Rideout; David Porter,4,0,36,32
1656803920880,MATH 18,B06,093474,Rideout; David Porter,5,0,36,31
1656803926908,MATH 20A,A01,083754,Zheng; Zequn,12,0,40,28
1656803932936,MATH 20B,A01,083756,Briones; Jor-el Thomas Caparas,1,0,36,35
1656803932936,MATH 20B,A02,083757,Briones; Jor-el Thomas Caparas,1,0,36,35
1656803932936,MATH 20B,A03,093475,Briones; Jor-el Thomas Caparas,0,0,36,36
1656803938965,MATH 20C,A01,083760,Briones; Jor-el Thomas Caparas,1,0,35,34
1656803938965,MATH 20C,A02,083761,Briones; Jor-el Thomas Caparas,8,0,35,27
1656803938965,MATH 20C,A03,093476,Briones; Jor-el Thomas Caparas,0,1,36,36
1656803938965,MATH 20C,B01,083762,Bach; Quang Tran,0,0,30,30
1656803944989,MATH 20D,A01,083765,Tran; Brian Kha,4,0,30,26
1656803944989,MATH 20D,A02,083766,Tran; Brian Kha,4,0,30,26
1656803944989,MATH 20D,A03,083767,Tran; Brian Kha,2,0,30,28
1656803951019,MATH 20E,A01,083771,Ganguly; Soumya,5,0,32,27
1656803951019,MATH 20E,A02,083772,Ganguly; Soumya,5,0,32,27
1656803951019,MATH 20E,B01,083773,Ciotti; Benjamin,18,0,35,17
1656803951019,MATH 20E,B02,083774,Ciotti; Benjamin,17,0,35,18
1656803957043,MATH 103A,A01,083777,Greenfeld; Be'Eri,2,0,36,34
1656803957043,MATH 103A,A02,083778,Greenfeld; Be'Eri,5,0,36,31
1656803957043,MATH 103A,A03,093561,Greenfeld; Be'Eri,4,0,36,32
1656803957043,MATH 103A,B01,083779,Greenfeld; Be'Eri,6,0,36,30
1656803957043,MATH 103A,B02,083780,Greenfeld; Be'Eri,2,0,36,34
1656803957043,MATH 103A,B03,093562,Greenfeld; Be'Eri,2,0,36,34
1656803963066,MATH 105,A01,085443,Carter; Anne Toulson,13,0,35,22
1656803963066,MATH 105,A02,093477,Carter; Anne Toulson,20,0,35,15
1656803969088,MATH 109,A01,083213,Ganzberger; Geoffrey Michael,2,0,34,32
1656803969088,MATH 109,A02,083214,Ganzberger; Geoffrey Michael,2,0,34,32
1656803969088,MATH 109,A03,093478,Ganzberger; Geoffrey Michael,1,0,34,33
1656803969088,MATH 109,B01,083215,Ganzberger; Geoffrey Michael,1,0,32,31
1656803969088,MATH 109,B02,083216,Ganzberger; Geoffrey Michael,1,0,32,31
1656803969088,MATH 109,B03,093479,Ganzberger; Geoffrey Michael,6,0,32,26
1656803975112,MATH 142A,A01,083219,Chow; Bennett,6,0,32,26
1656803975112,MATH 142A,A02,083220,Chow; Bennett,9,0,32,23
1656803975112,MATH 142A,A03,093480,Chow; Bennett,7,0,32,25
1656803975112,MATH 142A,B03,093481,Chow; Bennett,7,0,32,25
1656803975112,MATH 142A,B04,093558,Chow; Bennett,10,0,32,22
1656803975112,MATH 142A,B05,093559,Chow; Bennett,6,0,32,26
1656803981137,MATH 193A,A01,083224,Rotar; Vladimir,6,0,34,28
1656803981137,MATH 193A,A02,083225,Rotar; Vladimir,3,0,34,31
1656803981137,MATH 193A,A03,083781,Rotar; Vladimir,1,0,34,33
1656803981137,MATH 193A,A04,083782,Rotar; Vladimir,6,0,34,28
1656803981137,MATH 193A,A05,093482,Rotar; Vladimir,6,0,34,28
1656803987164,MATH 197,001,091859,McAuley; Julian John,9999,0,9999,0
1656803987164,MATH 197,002,095566,Kedlaya; Kiran S.,9997,0,9999,2
1656803987164,MATH 197,003,095567,Xiao; Ming,9999,0,9999,0
1656803987164,MATH 197,004,095571,Perols; Johan Lars,9998,0,9999,1
1656803994219,COGS 9,A01,083615,Shannon; Kyle Michael,6,0,75,69
1656804000242,COGS 11,A01,083617,Boyle; Mary E. T.,18,0,48,30
1656804006264,COGS 13,A01,083071,Bastos; Amalia Pinkusfeld,8,0,71,63
1656804012288,COGS 14A,A01,092681,Semenuks; Arturs,0,1,100,100
1656804018320,COGS 14B,A01,083073,Cheng; Tzu-Han,5,0,63,58
1656804024343,COGS 17,A01,092677,Semenuks; Arturs,4,0,81,77
1656804030373,COGS 100,A01,083619,Allen; Michael Gordon,15,0,70,55
1656804036399,COGS 101A,A01,083621,Davis; Joshua Daniel,9,0,68,59
1656804042422,COGS 101B,A01,091572,Allen; Michael Gordon,8,0,65,57
1656804048462,COGS 101C,A01,083625,Delgado; Tania,17,0,35,18
1656804054486,COGS 107A,A01,083627,Boyle; Mary E. T.,13,0,60,47
1656804060514,COGS 118A,A01,083075,Gupta; Anjum,15,0,76,61
1656804066537,CSE 3,A50,083646,Miranda; Gregory Joseph,22,0,50,28
1656804072560,CSE 8A,A50,083650,Miranda; Gregory Joseph,17,1,56,39
1656804078587,CSE 11,A01,083080,Cao; Yingjun,4,15,40,36
1656804084613,CSE 12,A01,083652,Krause-Levy; Sophia Louisa,20,1,120,100
1656804090636,CSE 15L,A01,083654,Morris; Justin Loren,8,0,50,42
1656804090636,CSE 15L,A02,083655,Morris; Justin Loren,8,0,50,42
1656804096667,CSE 20,A01,083657,Tran; Khoa Dang,37,0,80,43
1656804102694,CSE 21,A01,095574,Bach; Quang Tran,21,0,48,27
1656804108718,CSE 30,A01,083084,Eldon; John,4,0,80,76
1656804108718,CSE 30,B01,095061,Bhaskar; Nishant,5,0,50,45
1656804114740,CSE 100,A01,083659,Cao; Yingjun,1,4,70,69
1656804120765,CSE 134B,A01,083661,Powell; Thomas Allan,18,0,100,82
1656804126807,CSE 140,A01,083663,Gungor; Onat,14,0,85,71
1656804132901,CSE 140L,A01,083088,Eldon; John,16,0,100,84
1656804138924,CSE 175,A01,083665,Kumar; Rakesh,3,0,25,22
1656804144950,CSE 190,A00,092507,Dubnov; Shlomo,7,0,20,13
1656804150977,ECE 45,A01,083139,Congero; Spencer William,5,0,75,70
1656804157001,ECE 65,A50,083695,Saad; Andrew S,12,0,30,18
1656804157001,ECE 65,A51,095125,Saad; Andrew S,25,0,26,1
1656804163026,ECE 109,A01,091882,Touri; Behrouz,15,0,70,55
1656804169051,ECE 180,A00,083140,Abi Samra; Nicholas Camill,0,0,30,30
1656804169051,ECE 180,B00,083141,Abi Samra; Nicholas Camill,0,0,30,30
1656804175080,MATH 10A,A01,083735,Patchell; Gregory David,1,0,30,29
1656804175080,MATH 10A,A02,083736,Patchell; Gregory David,20,0,30,10
1656804175080,MATH 10A,A03,083737,Patchell; Gregory David,15,0,30,15
1656804181109,MATH 10B,A01,083207,Lim; Seonhee,7,0,34,27
1656804181109,MATH 10B,A02,083208,Lim; Seonhee,9,0,35,26
1656804181109,MATH 10B,A03,093472,Lim; Seonhee,4,0,34,30
1656804181109,MATH 10B,B01,083739,Sinha; Shubham,9,0,30,21
1656804187132,MATH 18,A01,083743,Cinel; Cameron Alexander,6,0,30,24
1656804187132,MATH 18,A02,083744,Cinel; Cameron Alexander,15,0,30,15
1656804187132,MATH 18,A03,083745,Cinel; Cameron Alexander,8,0,30,22
1656804187132,MATH 18,B01,083748,Rideout; David Porter,3,0,37,34
1656804187132,MATH 18,B02,083749,Rideout; David Porter,3,0,36,33
1656804187132,MATH 18,B03,083750,Rideout; David Porter,1,0,37,36
1656804187132,MATH 18,B04,083751,Rideout; David Porter,5,0,36,31
1656804187132,MATH 18,B05,093473,Rideout; David Porter,4,0,36,32
1656804187132,MATH 18,B06,093474,Rideout; David Porter,5,0,36,31
1656804193159,MATH 20A,A01,083754,Zheng; Zequn,12,0,40,28
1656804199182,MATH 20B,A01,083756,Briones; Jor-el Thomas Caparas,1,0,36,35
1656804199182,MATH 20B,A02,083757,Briones; Jor-el Thomas Caparas,1,0,36,35
1656804199182,MATH 20B,A03,093475,Briones; Jor-el Thomas Caparas,0,0,36,36
1656804205206,MATH 20C,A01,083760,Briones; Jor-el Thomas Caparas,1,0,35,34
1656804205206,MATH 20C,A02,083761,Briones; Jor-el Thomas Caparas,8,0,35,27
1656804205206,MATH 20C,A03,093476,Briones; Jor-el Thomas Caparas,0,1,36,36
1656804205206,MATH 20C,B01,083762,Bach; Quang Tran,0,0,30,30
1656804211237,MATH 20D,A01,083765,Tran; Brian Kha,4,0,30,26
1656804211237,MATH 20D,A02,083766,Tran; Brian Kha,4,0,30,26
1656804211237,MATH 20D,A03,083767,Tran; Brian Kha,2,0,30,28
1656804217261,MATH 20E,A01,083771,Ganguly; Soumya,5,0,32,27
1656804217261,MATH 20E,A02,083772,Ganguly; Soumya,5,0,32,27
1656804217261,MATH 20E,B01,083773,Ciotti; Benjamin,18,0,35,17
1656804217261,MATH 20E,B02,083774,Ciotti; Benjamin,17,0,35,18
1656804223283,MATH 103A,A01,083777,Greenfeld; Be'Eri,2,0,36,34
1656804223283,MATH 103A,A02,083778,Greenfeld; Be'Eri,5,0,36,31
1656804223283,MATH 103A,A03,093561,Greenfeld; Be'Eri,4,0,36,32
1656804223283,MATH 103A,B01,083779,Greenfeld; Be'Eri,6,0,36,30
1656804223283,MATH 103A,B02,083780,Greenfeld; Be'Eri,2,0,36,34
1656804223283,MATH 103A,B03,093562,Greenfeld; Be'Eri,2,0,36,34
1656804229311,MATH 105,A01,085443,Carter; Anne Toulson,13,0,35,22
1656804229311,MATH 105,A02,093477,Carter; Anne Toulson,20,0,35,15
1656804235342,MATH 109,A01,083213,Ganzberger; Geoffrey Michael,2,0,34,32
1656804235342,MATH 109,A02,083214,Ganzberger; Geoffrey Michael,2,0,34,32
1656804235342,MATH 109,A03,093478,Ganzberger; Geoffrey Michael,1,0,34,33
1656804235342,MATH 109,B01,083215,Ganzberger; Geoffrey Michael,1,0,32,31
1656804235342,MATH 109,B02,083216,Ganzberger; Geoffrey Michael,1,0,32,31
1656804235342,MATH 109,B03,093479,Ganzberger; Geoffrey Michael,6,0,32,26
1656804241366,MATH 142A,A01,083219,Chow; Bennett,6,0,32,26
1656804241366,MATH 142A,A02,083220,Chow; Bennett,9,0,32,23
1656804241366,MATH 142A,A03,093480,Chow; Bennett,7,0,32,25
1656804241366,MATH 142A,B03,093481,Chow; Bennett,7,0,32,25
1656804241366,MATH 142A,B04,093558,Chow; Bennett,10,0,32,22
1656804241366,MATH 142A,B05,093559,Chow; Bennett,6,0,32,26
1656804247397,MATH 193A,A01,083224,Rotar; Vladimir,6,0,34,28
1656804247397,MATH 193A,A02,083225,Rotar; Vladimir,3,0,34,31
1656804247397,MATH 193A,A03,083781,Rotar; Vladimir,1,0,34,33
1656804247397,MATH 193A,A04,083782,Rotar; Vladimir,6,0,34,28
1656804247397,MATH 193A,A05,093482,Rotar; Vladimir,6,0,34,28
1656804253421,MATH 197,001,091859,McAuley; Julian John,9999,0,9999,0
1656804253421,MATH 197,002,095566,Kedlaya; Kiran S.,9997,0,9999,2
1656804253421,MATH 197,003,095567,Xiao; Ming,9999,0,9999,0
1656804253421,MATH 197,004,095571,Perols; Johan Lars,9998,0,9999,1
1656804260486,COGS 9,A01,083615,Shannon; Kyle Michael,6,0,75,69
1656804266513,COGS 11,A01,083617,Boyle; Mary E. T.,18,0,48,30
1656804272537,COGS 13,A01,083071,Bastos; Amalia Pinkusfeld,8,0,71,63
1656804278564,COGS 14A,A01,092681,Semenuks; Arturs,0,1,100,100
1656804284589,COGS 14B,A01,083073,Cheng; Tzu-Han,5,0,63,58
1656804290613,COGS 17,A01,092677,Semenuks; Arturs,4,0,81,77
1656804296637,COGS 100,A01,083619,Allen; Michael Gordon,15,0,70,55
1656804302663,COGS 101A,A01,083621,Davis; Joshua Daniel,9,0,68,59
1656804308690,COGS 101B,A01,091572,Allen; Michael Gordon,8,0,65,57
1656804314717,COGS 101C,A01,083625,Delgado; Tania,17,0,35,18
1656804320741,COGS 107A,A01,083627,Boyle; Mary E. T.,13,0,60,47
1656804326763,COGS 118A,A01,083075,Gupta; Anjum,15,0,76,61
1656804332791,CSE 3,A50,083646,Miranda; Gregory Joseph,22,0,50,28
1656804338819,CSE 8A,A50,083650,Miranda; Gregory Joseph,17,1,56,39
1656804344849,CSE 11,A01,083080,Cao; Yingjun,4,15,40,36
1656804350874,CSE 12,A01,083652,Krause-Levy; Sophia Louisa,20,1,120,100
1656804356898,CSE 15L,A01,083654,Morris; Justin Loren,8,0,50,42
1656804356898,CSE 15L,A02,083655,Morris; Justin Loren,8,0,50,42
1656804362925,CSE 20,A01,083657,Tran; Khoa Dang,37,0,80,43
1656804368948,CSE 21,A01,095574,Bach; Quang Tran,21,0,48,27
1656804374978,CSE 30,A01,083084,Eldon; John,4,0,80,76
1656804374978,CSE 30,B01,095061,Bhaskar; Nishant,5,0,50,45
1656804381010,CSE 100,A01,083659,Cao; Yingjun,1,4,70,69
1656804387036,CSE 134B,A01,083661,Powell; Thomas Allan,18,0,100,82
1656804393063,CSE 140,A01,083663,Gungor; Onat,14,0,85,71
1656804399095,CSE 140L,A01,083088,Eldon; John,16,0,100,84
1656804405121,CSE 175,A01,083665,Kumar; Rakesh,3,0,25,22
1656804411144,CSE 190,A00,092507,Dubnov; Shlomo,7,0,20,13
1656804417167,ECE 45,A01,083139,Congero; Spencer William,5,0,75,70
1656804423197,ECE 65,A50,083695,Saad; Andrew S,12,0,30,18
1656804423197,ECE 65,A51,095125,Saad; Andrew S,25,0,26,1
1656804429229,ECE 109,A01,091882,Touri; Behrouz,15,0,70,55
1656804435254,ECE 180,A00,083140,Abi Samra; Nicholas Camill,0,0,30,30
1656804435254,ECE 180,B00,083141,Abi Samra; Nicholas Camill,0,0,30,30
1656804441278,MATH 10A,A01,083735,Patchell; Gregory David,1,0,30,29
1656804441278,MATH 10A,A02,083736,Patchell; Gregory David,20,0,30,10
1656804441278,MATH 10A,A03,083737,Patchell; Gregory David,15,0,30,15
1656804447301,MATH 10B,A01,083207,Lim; Seonhee,7,0,34,27
1656804447301,MATH 10B,A02,083208,Lim; Seonhee,9,0,35,26
1656804447301,MATH 10B,A03,093472,Lim; Seonhee,4,0,34,30
1656804447301,MATH 10B,B01,083739,Sinha; Shubham,9,0,30,21
1656804453326,MATH 18,A01,083743,Cinel; Cameron Alexander,6,0,30,24
1656804453326,MATH 18,A02,083744,Cinel; Cameron Alexander,15,0,30,15
1656804453326,MATH 18,A03,083745,Cinel; Cameron Alexander,8,0,30,22
1656804453326,MATH 18,B01,083748,Rideout; David Porter,3,0,37,34
1656804453326,MATH 18,B02,083749,Rideout; David Porter,3,0,36,33
1656804453326,MATH 18,B03,083750,Rideout; David Porter,1,0,37,36
1656804453326,MATH 18,B04,083751,Rideout; David Porter,5,0,36,31
1656804453326,MATH 18,B05,093473,Rideout; David Porter,4,0,36,32
1656804453326,MATH 18,B06,093474,Rideout; David Porter,5,0,36,31
1656804459350,MATH 20A,A01,083754,Zheng; Zequn,12,0,40,28
1656804465381,MATH 20B,A01,083756,Briones; Jor-el Thomas Caparas,1,0,36,35
1656804465381,MATH 20B,A02,083757,Briones; Jor-el Thomas Caparas,1,0,36,35
1656804465381,MATH 20B,A03,093475,Briones; Jor-el Thomas Caparas,0,0,36,36
1656804471409,MATH 20C,A01,083760,Briones; Jor-el Thomas Caparas,1,0,35,34
1656804471409,MATH 20C,A02,083761,Briones; Jor-el Thomas Caparas,8,0,35,27
1656804471409,MATH 20C,A03,093476,Briones; Jor-el Thomas Caparas,0,1,36,36
1656804471409,MATH 20C,B01,083762,Bach; Quang Tran,0,0,30,30
1656804477438,MATH 20D,A01,083765,Tran; Brian Kha,4,0,30,26
1656804477438,MATH 20D,A02,083766,Tran; Brian Kha,4,0,30,26
1656804477438,MATH 20D,A03,083767,Tran; Brian Kha,2,0,30,28
1656804483462,MATH 20E,A01,083771,Ganguly; Soumya,5,0,32,27
1656804483462,MATH 20E,A02,083772,Ganguly; Soumya,5,0,32,27
1656804483462,MATH 20E,B01,083773,Ciotti; Benjamin,18,0,35,17
1656804483462,MATH 20E,B02,083774,Ciotti; Benjamin,17,0,35,18
1656804489486,MATH 103A,A01,083777,Greenfeld; Be'Eri,2,0,36,34
1656804489486,MATH 103A,A02,083778,Greenfeld; Be'Eri,5,0,36,31
1656804489486,MATH 103A,A03,093561,Greenfeld; Be'Eri,4,0,36,32
1656804489486,MATH 103A,B01,083779,Greenfeld; Be'Eri,6,0,36,30
1656804489486,MATH 103A,B02,083780,Greenfeld; Be'Eri,2,0,36,34
1656804489486,MATH 103A,B03,093562,Greenfeld; Be'Eri,2,0,36,34
1656804495510,MATH 105,A01,085443,Carter; Anne Toulson,13,0,35,22
1656804495510,MATH 105,A02,093477,Carter; Anne Toulson,20,0,35,15
1656804501538,MATH 109,A01,083213,Ganzberger; Geoffrey Michael,2,0,34,32
1656804501538,MATH 109,A02,083214,Ganzberger; Geoffrey Michael,2,0,34,32
1656804501538,MATH 109,A03,093478,Ganzberger; Geoffrey Michael,1,0,34,33
1656804501538,MATH 109,B01,083215,Ganzberger; Geoffrey Michael,1,0,32,31
1656804501538,MATH 109,B02,083216,Ganzberger; Geoffrey Michael,1,0,32,31
1656804501538,MATH 109,B03,093479,Ganzberger; Geoffrey Michael,6,0,32,26
1656804507573,MATH 142A,A01,083219,Chow; Bennett,6,0,32,26
1656804507573,MATH 142A,A02,083220,Chow; Bennett,9,0,32,23
1656804507573,MATH 142A,A03,093480,Chow; Bennett,7,0,32,25
1656804507573,MATH 142A,B03,093481,Chow; Bennett,7,0,32,25
1656804507573,MATH 142A,B04,093558,Chow; Bennett,10,0,32,22
1656804507573,MATH 142A,B05,093559,Chow; Bennett,6,0,32,26
1656804513602,MATH 193A,A01,083224,Rotar; Vladimir,6,0,34,28
1656804513602,MATH 193A,A02,083225,Rotar; Vladimir,3,0,34,31
1656804513602,MATH 193A,A03,083781,Rotar; Vladimir,1,0,34,33
1656804513602,MATH 193A,A04,083782,Rotar; Vladimir,6,0,34,28
1656804513602,MATH 193A,A05,093482,Rotar; Vladimir,6,0,34,28
1656804519632,MATH 197,001,091859,McAuley; Julian John,9999,0,9999,0
1656804519632,MATH 197,002,095566,Kedlaya; Kiran S.,9997,0,9999,2
1656804519632,MATH 197,003,095567,Xiao; Ming,9999,0,9999,0
1656804519632,MATH 197,004,095571,Perols; Johan Lars,9998,0,9999,1
1656804526687,COGS 9,A01,083615,Shannon; Kyle Michael,6,0,75,69
1656804532724,COGS 11,A01,083617,Boyle; Mary E. T.,18,0,48,30
1656804538746,COGS 13,A01,083071,Bastos; Amalia Pinkusfeld,8,0,71,63
1656804544773,COGS 14A,A01,092681,Semenuks; Arturs,0,1,100,100
1656804550795,COGS 14B,A01,083073,Cheng; Tzu-Han,5,0,63,58
1656804556818,COGS 17,A01,092677,Semenuks; Arturs,4,0,81,77
1656804562841,COGS 100,A01,083619,Allen; Michael Gordon,15,0,70,55
1656804568868,COGS 101A,A01,083621,Davis; Joshua Daniel,9,0,68,59
1656804574897,COGS 101B,A01,091572,Allen; Michael Gordon,8,0,65,57
1656804580924,COGS 101C,A01,083625,Delgado; Tania,17,0,35,18
1656804586949,COGS 107A,A01,083627,Boyle; Mary E. T.,13,0,60,47
1656804592973,COGS 118A,A01,083075,Gupta; Anjum,15,0,76,61
1656804599001,CSE 3,A50,083646,Miranda; Gregory Joseph,22,0,50,28
1656804605027,CSE 8A,A50,083650,Miranda; Gregory Joseph,17,1,56,39
1656804611050,CSE 11,A01,083080,Cao; Yingjun,4,15,40,36
1656804617072,CSE 12,A01,083652,Krause-Levy; Sophia Louisa,20,1,120,100
1656804623095,CSE 15L,A01,083654,Morris; Justin Loren,8,0,50,42
1656804623095,CSE 15L,A02,083655,Morris; Justin Loren,8,0,50,42
1656804629124,CSE 20,A01,083657,Tran; Khoa Dang,37,0,80,43
1656804635146,CSE 21,A01,095574,Bach; Quang Tran,21,0,48,27
1656804641170,CSE 30,A01,083084,Eldon; John,4,0,80,76
1656804641170,CSE 30,B01,095061,Bhaskar; Nishant,5,0,50,45
1656804647194,CSE 100,A01,083659,Cao; Yingjun,1,4,70,69
1656804653222,CSE 134B,A01,083661,Powell; Thomas Allan,18,0,100,82
1656804659245,CSE 140,A01,083663,Gungor; Onat,14,0,85,71
1656804665269,CSE 140L,A01,083088,Eldon; John,16,0,100,84
1656804671300,CSE 175,A01,083665,Kumar; Rakesh,3,0,25,22
1656804677328,CSE 190,A00,092507,Dubnov; Shlomo,7,0,20,13
1656804683352,ECE 45,A01,083139,Congero; Spencer William,5,0,75,70
1656804689377,ECE 65,A50,083695,Saad; Andrew S,12,0,30,18
1656804689377,ECE 65,A51,095125,Saad; Andrew S,25,0,26,1
1656804695404,ECE 109,A01,091882,Touri; Behrouz,15,0,70,55
1656804701428,ECE 180,A00,083140,Abi Samra; Nicholas Camill,0,0,30,30
1656804701428,ECE 180,B00,083141,Abi Samra; Nicholas Camill,0,0,30,30
1656804707451,MATH 10A,A01,083735,Patchell; Gregory David,1,0,30,29
1656804707451,MATH 10A,A02,083736,Patchell; Gregory David,20,0,30,10
1656804707451,MATH 10A,A03,083737,Patchell; Gregory David,15,0,30,15
1656804713476,MATH 10B,A01,083207,Lim; Seonhee,7,0,34,27
1656804713476,MATH 10B,A02,083208,Lim; Seonhee,9,0,35,26
1656804713476,MATH 10B,A03,093472,Lim; Seonhee,4,0,34,30
1656804713476,MATH 10B,B01,083739,Sinha; Shubham,9,0,30,21
1656804719502,MATH 18,A01,083743,Cinel; Cameron Alexander,6,0,30,24
1656804719502,MATH 18,A02,083744,Cinel; Cameron Alexander,15,0,30,15
1656804719502,MATH 18,A03,083745,Cinel; Cameron Alexander,8,0,30,22
1656804719502,MATH 18,B01,083748,Rideout; David Porter,3,0,37,34
1656804719502,MATH 18,B02,083749,Rideout; David Porter,3,0,36,33
1656804719502,MATH 18,B03,083750,Rideout; David Porter,1,0,37,36
1656804719502,MATH 18,B04,083751,Rideout; David Porter,5,0,36,31
1656804719502,MATH 18,B05,093473,Rideout; David Porter,4,0,36,32
1656804719502,MATH 18,B06,093474,Rideout; David Porter,5,0,36,31
1656804725526,MATH 20A,A01,083754,Zheng; Zequn,12,0,40,28
1656804731631,MATH 20B,A01,083756,Briones; Jor-el Thomas Caparas,1,0,36,35
1656804731631,MATH 20B,A02,083757,Briones; Jor-el Thomas Caparas,1,0,36,35
1656804731631,MATH 20B,A03,093475,Briones; Jor-el Thomas Caparas,0,0,36,36
1656804737655,MATH 20C,A01,083760,Briones; Jor-el Thomas Caparas,1,0,35,34
1656804737655,MATH 20C,A02,083761,Briones; Jor-el Thomas Caparas,8,0,35,27
1656804737655,MATH 20C,A03,093476,Briones; Jor-el Thomas Caparas,0,1,36,36
1656804737655,MATH 20C,B01,083762,Bach; Quang Tran,0,0,30,30
1656804743679,MATH 20D,A01,083765,Tran; Brian Kha,4,0,30,26
1656804743679,MATH 20D,A02,083766,Tran; Brian Kha,4,0,30,26
1656804743679,MATH 20D,A03,083767,Tran; Brian Kha,2,0,30,28
1656804749706,MATH 20E,A01,083771,Ganguly; Soumya,5,0,32,27
1656804749706,MATH 20E,A02,083772,Ganguly; Soumya,5,0,32,27
1656804749706,MATH 20E,B01,083773,Ciotti; Benjamin,18,0,35,17
1656804749706,MATH 20E,B02,083774,Ciotti; Benjamin,17,0,35,18
1656804755738,MATH 103A,A01,083777,Greenfeld; Be'Eri,2,0,36,34
1656804755738,MATH 103A,A02,083778,Greenfeld; Be'Eri,5,0,36,31
1656804755738,MATH 103A,A03,093561,Greenfeld; Be'Eri,4,0,36,32
1656804755738,MATH 103A,B01,083779,Greenfeld; Be'Eri,6,0,36,30
1656804755738,MATH 103A,B02,083780,Greenfeld; Be'Eri,2,0,36,34
1656804755738,MATH 103A,B03,093562,Greenfeld; Be'Eri,2,0,36,34
1656804761762,MATH 105,A01,085443,Carter; Anne Toulson,13,0,35,22
1656804761762,MATH 105,A02,093477,Carter; Anne Toulson,20,0,35,15
1656804767789,MATH 109,A01,083213,Ganzberger; Geoffrey Michael,2,0,34,32
1656804767789,MATH 109,A02,083214,Ganzberger; Geoffrey Michael,2,0,34,32
1656804767789,MATH 109,A03,093478,Ganzberger; Geoffrey Michael,1,0,34,33
1656804767789,MATH 109,B01,083215,Ganzberger; Geoffrey Michael,1,0,32,31
1656804767789,MATH 109,B02,083216,Ganzberger; Geoffrey Michael,1,0,32,31
1656804767789,MATH 109,B03,093479,Ganzberger; Geoffrey Michael,6,0,32,26
1656804773811,MATH 142A,A01,083219,Chow; Bennett,6,0,32,26
1656804773811,MATH 142A,A02,083220,Chow; Bennett,9,0,32,23
1656804773811,MATH 142A,A03,093480,Chow; Bennett,7,0,32,25
1656804773811,MATH 142A,B03,093481,Chow; Bennett,7,0,32,25
1656804773811,MATH 142A,B04,093558,Chow; Bennett,10,0,32,22
1656804773811,MATH 142A,B05,093559,Chow; Bennett,6,0,32,26
1656804779836,MATH 193A,A01,083224,Rotar; Vladimir,6,0,34,28
1656804779836,MATH 193A,A02,083225,Rotar; Vladimir,3,0,34,31
1656804779836,MATH 193A,A03,083781,Rotar; Vladimir,1,0,34,33
1656804779836,MATH 193A,A04,083782,Rotar; Vladimir,6,0,34,28
1656804779836,MATH 193A,A05,093482,Rotar; Vladimir,6,0,34,28
1656804785862,MATH 197,001,091859,McAuley; Julian John,9999,0,9999,0
1656804785862,MATH 197,002,095566,Kedlaya; Kiran S.,9997,0,9999,2
1656804785862,MATH 197,003,095567,Xiao; Ming,9999,0,9999,0
1656804785862,MATH 197,004,095571,Perols; Johan Lars,9998,0,9999,1
1656804792916,COGS 9,A01,083615,Shannon; Kyle Michael,6,0,75,69
1656804798942,COGS 11,A01,083617,Boyle; Mary E. T.,18,0,48,30
1656804804982,COGS 13,A01,083071,Bastos; Amalia Pinkusfeld,8,0,71,63
1656804811007,COGS 14A,A01,092681,Semenuks; Arturs,0,1,100,100
1656804817033,COGS 14B,A01,083073,Cheng; Tzu-Han,5,0,63,58
1656804823062,COGS 17,A01,092677,Semenuks; Arturs,4,0,81,77
1656804829090,COGS 100,A01,083619,Allen; Michael Gordon,15,0,70,55
1656804835114,COGS 101A,A01,083621,Davis; Joshua Daniel,9,0,68,59
1656804841140,COGS 101B,A01,091572,Allen; Michael Gordon,8,0,65,57
1656804847172,COGS 101C,A01,083625,Delgado; Tania,17,0,35,18
1656804853201,COGS 107A,A01,083627,Boyle; Mary E. T.,13,0,60,47
1656804859224,COGS 118A,A01,083075,Gupta; Anjum,15,0,76,61
1656804865248,CSE 3,A50,083646,Miranda; Gregory Joseph,22,0,50,28
1656804871270,CSE 8A,A50,083650,Miranda; Gregory Joseph,17,1,56,39
1656804877300,CSE 11,A01,083080,Cao; Yingjun,4,15,40,36
1656804883326,CSE 12,A01,083652,Krause-Levy; Sophia Louisa,20,1,120,100
1656804889349,CSE 15L,A01,083654,Morris; Justin Loren,8,0,50,42
1656804889349,CSE 15L,A02,083655,Morris; Justin Loren,8,0,50,42
1656804895376,CSE 20,A01,083657,Tran; Khoa Dang,37,0,80,43
1656804901404,CSE 21,A01,095574,Bach; Quang Tran,21,0,48,27
1656804907428,CSE 30,A01,083084,Eldon; John,4,0,80,76
1656804907428,CSE 30,B01,095061,Bhaskar; Nishant,5,0,50,45
1656804913450,CSE 100,A01,083659,Cao; Yingjun,1,4,70,69
1656804919472,CSE 134B,A01,083661,Powell; Thomas Allan,18,0,100,82
1656804925494,CSE 140,A01,083663,Gungor; Onat,14,0,85,71
1656804931518,CSE 140L,A01,083088,Eldon; John,16,0,100,84
1656804937541,CSE 175,A01,083665,Kumar; Rakesh,3,0,25,22
1656804943564,CSE 190,A00,092507,Dubnov; Shlomo,7,0,20,13
1656804949587,ECE 45,A01,083139,Congero; Spencer William,5,0,75,70
1656804955610,ECE 65,A50,083695,Saad; Andrew S,12,0,30,18
1656804955610,ECE 65,A51,095125,Saad; Andrew S,25,0,26,1
1656804961632,ECE 109,A01,091882,Touri; Behrouz,15,0,70,55
1656804967659,ECE 180,A00,083140,Abi Samra; Nicholas Camill,0,0,30,30
1656804967659,ECE 180,B00,083141,Abi Samra; Nicholas Camill,0,0,30,30
1656804973681,MATH 10A,A01,083735,Patchell; Gregory David,1,0,30,29
1656804973681,MATH 10A,A02,083736,Patchell; Gregory David,20,0,30,10
1656804973681,MATH 10A,A03,083737,Patchell; Gregory David,15,0,30,15
1656804979714,MATH 10B,A01,083207,Lim; Seonhee,7,0,34,27
1656804979714,MATH 10B,A02,083208,Lim; Seonhee,9,0,35,26
1656804979714,MATH 10B,A03,093472,Lim; Seonhee,4,0,34,30
1656804979714,MATH 10B,B01,083739,Sinha; Shubham,9,0,30,21
1656804985745,MATH 18,A01,083743,Cinel; Cameron Alexander,6,0,30,24
1656804985745,MATH 18,A02,083744,Cinel; Cameron Alexander,15,0,30,15
1656804985745,MATH 18,A03,083745,Cinel; Cameron Alexander,8,0,30,22
1656804985745,MATH 18,B01,083748,Rideout; David Porter,3,0,37,34
1656804985745,MATH 18,B02,083749,Rideout; David Porter,3,0,36,33
1656804985745,MATH 18,B03,083750,Rideout; David Porter,1,0,37,36
1656804985745,MATH 18,B04,083751,Rideout; David Porter,5,0,36,31
1656804985745,MATH 18,B05,093473,Rideout; David Porter,4,0,36,32
1656804985745,MATH 18,B06,093474,Rideout; David Porter,5,0,36,31
1656804991766,MATH 20A,A01,083754,Zheng; Zequn,12,0,40,28
1656804997788,MATH 20B,A01,083756,Briones; Jor-el Thomas Caparas,1,0,36,35
1656804997788,MATH 20B,A02,083757,Briones; Jor-el Thomas Caparas,1,0,36,35
1656804997788,MATH 20B,A03,093475,Briones; Jor-el Thomas Caparas,0,0,36,36
1656805003810,MATH 20C,A01,083760,Briones; Jor-el Thomas Caparas,1,0,35,34
1656805003810,MATH 20C,A02,083761,Briones; Jor-el Thomas Caparas,8,0,35,27
1656805003810,MATH 20C,A03,093476,Briones; Jor-el Thomas Caparas,0,1,36,36
1656805003810,MATH 20C,B01,083762,Bach; Quang Tran,0,0,30,30
1656805009835,MATH 20D,A01,083765,Tran; Brian Kha,4,0,30,26
1656805009835,MATH 20D,A02,083766,Tran; Brian Kha,4,0,30,26
1656805009835,MATH 20D,A03,083767,Tran; Brian Kha,2,0,30,28
1656805015864,MATH 20E,A01,083771,Ganguly; Soumya,5,0,32,27
1656805015864,MATH 20E,A02,083772,Ganguly; Soumya,5,0,32,27
1656805015864,MATH 20E,B01,083773,Ciotti; Benjamin,18,0,35,17
1656805015864,MATH 20E,B02,083774,Ciotti; Benjamin,17,0,35,18
1656805021891,MATH 103A,A01,083777,Greenfeld; Be'Eri,2,0,36,34
1656805021891,MATH 103A,A02,083778,Greenfeld; Be'Eri,5,0,36,31
1656805021891,MATH 103A,A03,093561,Greenfeld; Be'Eri,4,0,36,32
1656805021891,MATH 103A,B01,083779,Greenfeld; Be'Eri,6,0,36,30
1656805021891,MATH 103A,B02,083780,Greenfeld; Be'Eri,2,0,36,34
1656805021891,MATH 103A,B03,093562,Greenfeld; Be'Eri,2,0,36,34
1656805027926,MATH 105,A01,085443,Carter; Anne Toulson,13,0,35,22
1656805027926,MATH 105,A02,093477,Carter; Anne Toulson,20,0,35,15
1656805033955,MATH 109,A01,083213,Ganzberger; Geoffrey Michael,2,0,34,32
1656805033955,MATH 109,A02,083214,Ganzberger; Geoffrey Michael,2,0,34,32
1656805033955,MATH 109,A03,093478,Ganzberger; Geoffrey Michael,1,0,34,33
1656805033955,MATH 109,B01,083215,Ganzberger; Geoffrey Michael,1,0,32,31
1656805033955,MATH 109,B02,083216,Ganzberger; Geoffrey Michael,1,0,32,31
1656805033955,MATH 109,B03,093479,Ganzberger; Geoffrey Michael,6,0,32,26
1656805039984,MATH 142A,A01,083219,Chow; Bennett,6,0,32,26
1656805039984,MATH 142A,A02,083220,Chow; Bennett,9,0,32,23
1656805039984,MATH 142A,A03,093480,Chow; Bennett,7,0,32,25
1656805039984,MATH 142A,B03,093481,Chow; Bennett,7,0,32,25
1656805039984,MATH 142A,B04,093558,Chow; Bennett,10,0,32,22
1656805039984,MATH 142A,B05,093559,Chow; Bennett,6,0,32,26
1656805046013,MATH 193A,A01,083224,Rotar; Vladimir,6,0,34,28
1656805046013,MATH 193A,A02,083225,Rotar; Vladimir,3,0,34,31
1656805046013,MATH 193A,A03,083781,Rotar; Vladimir,1,0,34,33
1656805046013,MATH 193A,A04,083782,Rotar; Vladimir,6,0,34,28
1656805046013,MATH 193A,A05,093482,Rotar; Vladimir,6,0,34,28
1656805052038,MATH 197,001,091859,McAuley; Julian John,9999,0,9999,0
1656805052038,MATH 197,002,095566,Kedlaya; Kiran S.,9997,0,9999,2
1656805052038,MATH 197,003,095567,Xiao; Ming,9999,0,9999,0
1656805052038,MATH 197,004,095571,Perols; Johan Lars,9998,0,9999,1
1656805059088,COGS 9,A01,083615,Shannon; Kyle Michael,6,0,75,69
1656805065112,COGS 11,A01,083617,Boyle; Mary E. T.,18,0,48,30
1656805071134,COGS 13,A01,083071,Bastos; Amalia Pinkusfeld,8,0,71,63
1656805077160,COGS 14A,A01,092681,Semenuks; Arturs,0,1,100,100
1656805083191,COGS 14B,A01,083073,Cheng; Tzu-Han,5,0,63,58
1656805089218,COGS 17,A01,092677,Semenuks; Arturs,4,0,81,77
1656805095242,COGS 100,A01,083619,Allen; Michael Gordon,15,0,70,55
1656805101272,COGS 101A,A01,083621,Davis; Joshua Daniel,9,0,68,59
1656805107297,COGS 101B,A01,091572,Allen; Michael Gordon,8,0,65,57
1656805113324,COGS 101C,A01,083625,Delgado; Tania,17,0,35,18
1656805119347,COGS 107A,A01,083627,Boyle; Mary E. T.,13,0,60,47
1656805125371,COGS 118A,A01,083075,Gupta; Anjum,15,0,76,61
1656805131395,CSE 3,A50,083646,Miranda; Gregory Joseph,22,0,50,28
1656805137423,CSE 8A,A50,083650,Miranda; Gregory Joseph,17,1,56,39
1656805143445,CSE 11,A01,083080,Cao; Yingjun,4,15,40,36
1656805149470,CSE 12,A01,083652,Krause-Levy; Sophia Louisa,20,1,120,100
1656805155508,CSE 15L,A01,083654,Morris; Justin Loren,8,0,50,42
1656805155508,CSE 15L,A02,083655,Morris; Justin Loren,8,0,50,42
1656805161537,CSE 20,A01,083657,Tran; Khoa Dang,37,0,80,43
1656805167563,CSE 21,A01,095574,Bach; Quang Tran,21,0,48,27
1656805173594,CSE 30,A01,083084,Eldon; John,4,0,80,76
1656805173594,CSE 30,B01,095061,Bhaskar; Nishant,5,0,50,45
1656805179617,CSE 100,A01,083659,Cao; Yingjun,1,4,70,69
1656805185646,CSE 134B,A01,083661,Powell; Thomas Allan,18,0,100,82
1656805191680,CSE 140,A01,083663,Gungor; Onat,14,0,85,71
1656805197707,CSE 140L,A01,083088,Eldon; John,16,0,100,84
1656805203731,CSE 175,A01,083665,Kumar; Rakesh,3,0,25,22
1656805209756,CSE 190,A00,092507,Dubnov; Shlomo,7,0,20,13
1656805215784,ECE 45,A01,083139,Congero; Spencer William,5,0,75,70
1656805221811,ECE 65,A50,083695,Saad; Andrew S,12,0,30,18
1656805221811,ECE 65,A51,095125,Saad; Andrew S,25,0,26,1
1656805227834,ECE 109,A01,091882,Touri; Behrouz,15,0,70,55
1656805233857,ECE 180,A00,083140,Abi Samra; Nicholas Camill,0,0,30,30
1656805233857,ECE 180,B00,083141,Abi Samra; Nicholas Camill,0,0,30,30
1656805239880,MATH 10A,A01,083735,Patchell; Gregory David,1,0,30,29
1656805239880,MATH 10A,A02,083736,Patchell; Gregory David,20,0,30,10
1656805239880,MATH 10A,A03,083737,Patchell; Gregory David,15,0,30,15
1656805245905,MATH 10B,A01,083207,Lim; Seonhee,7,0,34,27
1656805245905,MATH 10B,A02,083208,Lim; Seonhee,9,0,35,26
1656805245905,MATH 10B,A03,093472,Lim; Seonhee,4,0,34,30
1656805245905,MATH 10B,B01,083739,Sinha; Shubham,9,0,30,21
1656805251929,MATH 18,A01,083743,Cinel; Cameron Alexander,6,0,30,24
1656805251929,MATH 18,A02,083744,Cinel; Cameron Alexander,15,0,30,15
1656805251929,MATH 18,A03,083745,Cinel; Cameron Alexander,8,0,30,22
1656805251929,MATH 18,B01,083748,Rideout; David Porter,3,0,37,34
1656805251929,MATH 18,B02,083749,Rideout; David Porter,3,0,36,33
1656805251929,MATH 18,B03,083750,Rideout; David Porter,1,0,37,36
1656805251929,MATH 18,B04,083751,Rideout; David Porter,5,0,36,31
1656805251929,MATH 18,B05,093473,Rideout; David Porter,4,0,36,32
1656805251929,MATH 18,B06,093474,Rideout; David Porter,5,0,36,31
1656805257956,MATH 20A,A01,083754,Zheng; Zequn,12,0,40,28
1656805263985,MATH 20B,A01,083756,Briones; Jor-el Thomas Caparas,1,0,36,35
1656805263985,MATH 20B,A02,083757,Briones; Jor-el Thomas Caparas,1,0,36,35
1656805263985,MATH 20B,A03,093475,Briones; Jor-el Thomas Caparas,0,0,36,36
1656805270009,MATH 20C,A01,083760,Briones; Jor-el Thomas Caparas,1,0,35,34
1656805270009,MATH 20C,A02,083761,Briones; Jor-el Thomas Caparas,8,0,35,27
1656805270009,MATH 20C,A03,093476,Briones; Jor-el Thomas Caparas,0,1,36,36
1656805270009,MATH 20C,B01,083762,Bach; Quang Tran,0,0,30,30
1656805276042,MATH 20D,A01,083765,Tran; Brian Kha,4,0,30,26
1656805276042,MATH 20D,A02,083766,Tran; Brian Kha,4,0,30,26
1656805276042,MATH 20D,A03,083767,Tran; Brian Kha,2,0,30,28
1656805282066,MATH 20E,A01,083771,Ganguly; Soumya,5,0,32,27
1656805282066,MATH 20E,A02,083772,Ganguly; Soumya,5,0,32,27
1656805282066,MATH 20E,B01,083773,Ciotti; Benjamin,18,0,35,17
1656805282066,MATH 20E,B02,083774,Ciotti; Benjamin,17,0,35,18
1656805288096,MATH 103A,A01,083777,Greenfeld; Be'Eri,2,0,36,34
1656805288096,MATH 103A,A02,083778,Greenfeld; Be'Eri,5,0,36,31
1656805288096,MATH 103A,A03,093561,Greenfeld; Be'Eri,4,0,36,32
1656805288096,MATH 103A,B01,083779,Greenfeld; Be'Eri,6,0,36,30
1656805288096,MATH 103A,B02,083780,Greenfeld; Be'Eri,2,0,36,34
1656805288096,MATH 103A,B03,093562,Greenfeld; Be'Eri,2,0,36,34
1656805294118,MATH 105,A01,085443,Carter; Anne Toulson,13,0,35,22
1656805294118,MATH 105,A02,093477,Carter; Anne Toulson,20,0,35,15
1656805300147,MATH 109,A01,083213,Ganzberger; Geoffrey Michael,2,0,34,32
1656805300147,MATH 109,A02,083214,Ganzberger; Geoffrey Michael,2,0,34,32
1656805300147,MATH 109,A03,093478,Ganzberger; Geoffrey Michael,1,0,34,33
1656805300147,MATH 109,B01,083215,Ganzberger; Geoffrey Michael,1,0,32,31
1656805300147,MATH 109,B02,083216,Ganzberger; Geoffrey Michael,1,0,32,31
1656805300147,MATH 109,B03,093479,Ganzberger; Geoffrey Michael,6,0,32,26
1656805306176,MATH 142A,A01,083219,Chow; Bennett,6,0,32,26
1656805306176,MATH 142A,A02,083220,Chow; Bennett,9,0,32,23
1656805306176,MATH 142A,A03,093480,Chow; Bennett,7,0,32,25
1656805306176,MATH 142A,B03,093481,Chow; Bennett,7,0,32,25
1656805306176,MATH 142A,B04,093558,Chow; Bennett,10,0,32,22
1656805306176,MATH 142A,B05,093559,Chow; Bennett,6,0,32,26
1656805312200,MATH 193A,A01,083224,Rotar; Vladimir,6,0,34,28
1656805312200,MATH 193A,A02,083225,Rotar; Vladimir,3,0,34,31
1656805312200,MATH 193A,A03,083781,Rotar; Vladimir,1,0,34,33
1656805312200,MATH 193A,A04,083782,Rotar; Vladimir,6,0,34,28
1656805312200,MATH 193A,A05,093482,Rotar; Vladimir,6,0,34,28
1656805318227,MATH 197,001,091859,McAuley; Julian John,9999,0,9999,0
1656805318227,MATH 197,002,095566,Kedlaya; Kiran S.,9997,0,9999,2
1656805318227,MATH 197,003,095567,Xiao; Ming,9999,0,9999,0
1656805318227,MATH 197,004,095571,Perols; Johan Lars,9998,0,9999,1
1656805325382,COGS 9,A01,083615,Shannon; Kyle Michael,6,0,75,69
1656805331406,COGS 11,A01,083617,Boyle; Mary E. T.,18,0,48,30
1656805337430,COGS 13,A01,083071,Bastos; Amalia Pinkusfeld,8,0,71,63
1656805343471,COGS 14A,A01,092681,Semenuks; Arturs,0,1,100,100
1656805349495,COGS 14B,A01,083073,Cheng; Tzu-Han,5,0,63,58
1656805355518,COGS 17,A01,092677,Semenuks; Arturs,4,0,81,77
1656805361540,COGS 100,A01,083619,Allen; Michael Gordon,15,0,70,55
1656805367565,COGS 101A,A01,083621,Davis; Joshua Daniel,9,0,68,59
1656805373591,COGS 101B,A01,091572,Allen; Michael Gordon,8,0,65,57
1656805379616,COGS 101C,A01,083625,Delgado; Tania,17,0,35,18
1656805385643,COGS 107A,A01,083627,Boyle; Mary E. T.,13,0,60,47
1656805391669,COGS 118A,A01,083075,Gupta; Anjum,15,0,76,61
1656805397695,CSE 3,A50,083646,Miranda; Gregory Joseph,22,0,50,28
1656805403722,CSE 8A,A50,083650,Miranda; Gregory Joseph,17,1,56,39
1656805409748,CSE 11,A01,083080,Cao; Yingjun,4,15,40,36
1656805415775,CSE 12,A01,083652,Krause-Levy; Sophia Louisa,20,1,120,100
1656805421803,CSE 15L,A01,083654,Morris; Justin Loren,8,0,50,42
1656805421803,CSE 15L,A02,083655,Morris; Justin Loren,8,0,50,42
1656805427830,CSE 20,A01,083657,Tran; Khoa Dang,37,0,80,43
1656805433858,CSE 21,A01,095574,Bach; Quang Tran,21,0,48,27
1656805439882,CSE 30,A01,083084,Eldon; John,4,0,80,76
1656805439882,CSE 30,B01,095061,Bhaskar; Nishant,5,0,50,45
1656805445905,CSE 100,A01,083659,Cao; Yingjun,1,4,70,69
1656805451927,CSE 134B,A01,083661,Powell; Thomas Allan,18,0,100,82
1656805457949,CSE 140,A01,083663,Gungor; Onat,14,0,85,71
1656805463977,CSE 140L,A01,083088,Eldon; John,16,0,100,84
1656805469999,CSE 175,A01,083665,Kumar; Rakesh,3,0,25,22
1656805476023,CSE 190,A00,092507,Dubnov; Shlomo,7,0,20,13
1656805482049,ECE 45,A01,083139,Congero; Spencer William,5,0,75,70
1656805488072,ECE 65,A50,083695,Saad; Andrew S,12,0,30,18
1656805488072,ECE 65,A51,095125,Saad; Andrew S,25,0,26,1
1656805494096,ECE 109,A01,091882,Touri; Behrouz,15,0,70,55
1656805500124,ECE 180,A00,083140,Abi Samra; Nicholas Camill,0,0,30,30
1656805500124,ECE 180,B00,083141,Abi Samra; Nicholas Camill,0,0,30,30
1656805506148,MATH 10A,A01,083735,Patchell; Gregory David,1,0,30,29
1656805506148,MATH 10A,A02,083736,Patchell; Gregory David,20,0,30,10
1656805506148,MATH 10A,A03,083737,Patchell; Gregory David,15,0,30,15
1656805512177,MATH 10B,A01,083207,Lim; Seonhee,7,0,34,27
1656805512177,MATH 10B,A02,083208,Lim; Seonhee,9,0,35,26
1656805512177,MATH 10B,A03,093472,Lim; Seonhee,4,0,34,30
1656805512177,MATH 10B,B01,083739,Sinha; Shubham,9,0,30,21
1656805518203,MATH 18,A01,083743,Cinel; Cameron Alexander,6,0,30,24
1656805518203,MATH 18,A02,083744,Cinel; Cameron Alexander,15,0,30,15
1656805518203,MATH 18,A03,083745,Cinel; Cameron Alexander,8,0,30,22
1656805518203,MATH 18,B01,083748,Rideout; David Porter,3,0,37,34
1656805518203,MATH 18,B02,083749,Rideout; David Porter,3,0,36,33
1656805518203,MATH 18,B03,083750,Rideout; David Porter,1,0,37,36
1656805518203,MATH 18,B04,083751,Rideout; David Porter,5,0,36,31
1656805518203,MATH 18,B05,093473,Rideout; David Porter,4,0,36,32
1656805518203,MATH 18,B06,093474,Rideout; David Porter,5,0,36,31
1656805524227,MATH 20A,A01,083754,Zheng; Zequn,12,0,40,28
1656805530254,MATH 20B,A01,083756,Briones; Jor-el Thomas Caparas,1,0,36,35
1656805530254,MATH 20B,A02,083757,Briones; Jor-el Thomas Caparas,1,0,36,35
1656805530254,MATH 20B,A03,093475,Briones; Jor-el Thomas Caparas,0,0,36,36
1656805536279,MATH 20C,A01,083760,Briones; Jor-el Thomas Caparas,1,0,35,34
1656805536279,MATH 20C,A02,083761,Briones; Jor-el Thomas Caparas,8,0,35,27
1656805536279,MATH 20C,A03,093476,Briones; Jor-el Thomas Caparas,0,1,36,36
1656805536279,MATH 20C,B01,083762,Bach; Quang Tran,0,0,30,30
1656805542301,MATH 20D,A01,083765,Tran; Brian Kha,4,0,30,26
1656805542301,MATH 20D,A02,083766,Tran; Brian Kha,4,0,30,26
1656805542301,MATH 20D,A03,083767,Tran; Brian Kha,2,0,30,28
1656805548326,MATH 20E,A01,083771,Ganguly; Soumya,5,0,32,27
1656805548326,MATH 20E,A02,083772,Ganguly; Soumya,5,0,32,27
1656805548326,MATH 20E,B01,083773,Ciotti; Benjamin,18,0,35,17
1656805548326,MATH 20E,B02,083774,Ciotti; Benjamin,17,0,35,18
1656805554354,MATH 103A,A01,083777,Greenfeld; Be'Eri,2,0,36,34
1656805554354,MATH 103A,A02,083778,Greenfeld; Be'Eri,5,0,36,31
1656805554354,MATH 103A,A03,093561,Greenfeld; Be'Eri,4,0,36,32
1656805554354,MATH 103A,B01,083779,Greenfeld; Be'Eri,6,0,36,30
1656805554354,MATH 103A,B02,083780,Greenfeld; Be'Eri,2,0,36,34
1656805554354,MATH 103A,B03,093562,Greenfeld; Be'Eri,2,0,36,34
1656805560383,MATH 105,A01,085443,Carter; Anne Toulson,13,0,35,22
1656805560383,MATH 105,A02,093477,Carter; Anne Toulson,20,0,35,15
1656805566407,MATH 109,A01,083213,Ganzberger; Geoffrey Michael,2,0,34,32
1656805566407,MATH 109,A02,083214,Ganzberger; Geoffrey Michael,2,0,34,32
1656805566407,MATH 109,A03,093478,Ganzberger; Geoffrey Michael,1,0,34,33
1656805566407,MATH 109,B01,083215,Ganzberger; Geoffrey Michael,1,0,32,31
1656805566407,MATH 109,B02,083216,Ganzberger; Geoffrey Michael,1,0,32,31
1656805566407,MATH 109,B03,093479,Ganzberger; Geoffrey Michael,6,0,32,26
1656805572436,MATH 142A,A01,083219,Chow; Bennett,6,0,32,26
1656805572436,MATH 142A,A02,083220,Chow; Bennett,9,0,32,23
1656805572436,MATH 142A,A03,093480,Chow; Bennett,7,0,32,25
1656805572436,MATH 142A,B03,093481,Chow; Bennett,7,0,32,25
1656805572436,MATH 142A,B04,093558,Chow; Bennett,10,0,32,22
1656805572436,MATH 142A,B05,093559,Chow; Bennett,6,0,32,26
1656805578472,MATH 193A,A01,083224,Rotar; Vladimir,6,0,34,28
1656805578472,MATH 193A,A02,083225,Rotar; Vladimir,3,0,34,31
1656805578472,MATH 193A,A03,083781,Rotar; Vladimir,1,0,34,33
1656805578472,MATH 193A,A04,083782,Rotar; Vladimir,6,0,34,28
1656805578472,MATH 193A,A05,093482,Rotar; Vladimir,6,0,34,28
1656805584498,MATH 197,001,091859,McAuley; Julian John,9999,0,9999,0
1656805584498,MATH 197,002,095566,Kedlaya; Kiran S.,9997,0,9999,2
1656805584498,MATH 197,003,095567,Xiao; Ming,9999,0,9999,0
1656805584498,MATH 197,004,095571,Perols; Johan Lars,9998,0,9999,1
1656805591566,COGS 9,A01,083615,Shannon; Kyle Michael,6,0,75,69
1656805597597,COGS 11,A01,083617,Boyle; Mary E. T.,18,0,48,30
1656805603619,COGS 13,A01,083071,Bastos; Amalia Pinkusfeld,8,0,71,63
1656805609650,COGS 14A,A01,092681,Semenuks; Arturs,0,1,100,100
1656805615678,COGS 14B,A01,083073,Cheng; Tzu-Han,5,0,63,58
1656805621700,COGS 17,A01,092677,Semenuks; Arturs,4,0,81,77
1656805627725,COGS 100,A01,083619,Allen; Michael Gordon,15,0,70,55
1656805633751,COGS 101A,A01,083621,Davis; Joshua Daniel,9,0,68,59
1656805639772,COGS 101B,A01,091572,Allen; Michael Gordon,8,0,65,57
1656805645795,COGS 101C,A01,083625,Delgado; Tania,17,0,35,18
1656805651818,COGS 107A,A01,083627,Boyle; Mary E. T.,13,0,60,47
1656805657843,COGS 118A,A01,083075,Gupta; Anjum,15,0,76,61
1656805663867,CSE 3,A50,083646,Miranda; Gregory Joseph,22,0,50,28
1656805669891,CSE 8A,A50,083650,Miranda; Gregory Joseph,17,1,56,39
1656805675914,CSE 11,A01,083080,Cao; Yingjun,4,15,40,36
1656805681940,CSE 12,A01,083652,Krause-Levy; Sophia Louisa,20,1,120,100
1656805687964,CSE 15L,A01,083654,Morris; Justin Loren,8,0,50,42
1656805687964,CSE 15L,A02,083655,Morris; Justin Loren,8,0,50,42
1656805693992,CSE 20,A01,083657,Tran; Khoa Dang,37,0,80,43
1656805700016,CSE 21,A01,095574,Bach; Quang Tran,21,0,48,27
1656805706045,CSE 30,A01,083084,Eldon; John,4,0,80,76
1656805706045,CSE 30,B01,095061,Bhaskar; Nishant,5,0,50,45
1656805712071,CSE 100,A01,083659,Cao; Yingjun,1,4,70,69
1656805718094,CSE 134B,A01,083661,Powell; Thomas Allan,18,0,100,82
1656805724116,CSE 140,A01,083663,Gungor; Onat,14,0,85,71
1656805730140,CSE 140L,A01,083088,Eldon; John,16,0,100,84
1656805736166,CSE 175,A01,083665,Kumar; Rakesh,3,0,25,22
1656805742193,CSE 190,A00,092507,Dubnov; Shlomo,7,0,20,13
1656805748223,ECE 45,A01,083139,Congero; Spencer William,5,0,75,70
1656805754250,ECE 65,A50,083695,Saad; Andrew S,12,0,30,18
1656805754250,ECE 65,A51,095125,Saad; Andrew S,25,0,26,1
1656805760272,ECE 109,A01,091882,Touri; Behrouz,15,0,70,55
1656805766294,ECE 180,A00,083140,Abi Samra; Nicholas Camill,0,0,30,30
1656805766294,ECE 180,B00,083141,Abi Samra; Nicholas Camill,0,0,30,30
1656805772321,MATH 10A,A01,083735,Patchell; Gregory David,1,0,30,29
1656805772321,MATH 10A,A02,083736,Patchell; Gregory David,20,0,30,10
1656805772321,MATH 10A,A03,083737,Patchell; Gregory David,15,0,30,15
1656805778359,MATH 10B,A01,083207,Lim; Seonhee,7,0,34,27
1656805778359,MATH 10B,A02,083208,Lim; Seonhee,9,0,35,26
1656805778359,MATH 10B,A03,093472,Lim; Seonhee,4,0,34,30
1656805778359,MATH 10B,B01,083739,Sinha; Shubham,9,0,30,21
1656805784384,MATH 18,A01,083743,Cinel; Cameron Alexander,6,0,30,24
1656805784384,MATH 18,A02,083744,Cinel; Cameron Alexander,15,0,30,15
1656805784384,MATH 18,A03,083745,Cinel; Cameron Alexander,8,0,30,22
1656805784384,MATH 18,B01,083748,Rideout; David Porter,3,0,37,34
1656805784384,MATH 18,B02,083749,Rideout; David Porter,3,0,36,33
1656805784384,MATH 18,B03,083750,Rideout; David Porter,1,0,37,36
1656805784384,MATH 18,B04,083751,Rideout; David Porter,5,0,36,31
1656805784384,MATH 18,B05,093473,Rideout; David Porter,4,0,36,32
1656805784384,MATH 18,B06,093474,Rideout; David Porter,5,0,36,31
1656805790413,MATH 20A,A01,083754,Zheng; Zequn,12,0,40,28
1656805796437,MATH 20B,A01,083756,Briones; Jor-el Thomas Caparas,1,0,36,35
1656805796437,MATH 20B,A02,083757,Briones; Jor-el Thomas Caparas,1,0,36,35
1656805796437,MATH 20B,A03,093475,Briones; Jor-el Thomas Caparas,0,0,36,36
1656805802461,MATH 20C,A01,083760,Briones; Jor-el Thomas Caparas,1,0,35,34
1656805802461,MATH 20C,A02,083761,Briones; Jor-el Thomas Caparas,8,0,35,27
1656805802461,MATH 20C,A03,093476,Briones; Jor-el Thomas Caparas,0,1,36,36
1656805802461,MATH 20C,B01,083762,Bach; Quang Tran,0,0,30,30
1656805808487,MATH 20D,A01,083765,Tran; Brian Kha,4,0,30,26
1656805808487,MATH 20D,A02,083766,Tran; Brian Kha,4,0,30,26
1656805808487,MATH 20D,A03,083767,Tran; Brian Kha,2,0,30,28
1656805814515,MATH 20E,A01,083771,Ganguly; Soumya,5,0,32,27
1656805814515,MATH 20E,A02,083772,Ganguly; Soumya,5,0,32,27
1656805814515,MATH 20E,B01,083773,Ciotti; Benjamin,18,0,35,17
1656805814515,MATH 20E,B02,083774,Ciotti; Benjamin,17,0,35,18
1656805820547,MATH 103A,A01,083777,Greenfeld; Be'Eri,2,0,36,34
1656805820547,MATH 103A,A02,083778,Greenfeld; Be'Eri,5,0,36,31
1656805820547,MATH 103A,A03,093561,Greenfeld; Be'Eri,4,0,36,32
1656805820547,MATH 103A,B01,083779,Greenfeld; Be'Eri,6,0,36,30
1656805820547,MATH 103A,B02,083780,Greenfeld; Be'Eri,2,0,36,34
1656805820547,MATH 103A,B03,093562,Greenfeld; Be'Eri,2,0,36,34
1656805826572,MATH 105,A01,085443,Carter; Anne Toulson,13,0,35,22
1656805826572,MATH 105,A02,093477,Carter; Anne Toulson,20,0,35,15
1656805832596,MATH 109,A01,083213,Ganzberger; Geoffrey Michael,2,0,34,32
1656805832596,MATH 109,A02,083214,Ganzberger; Geoffrey Michael,2,0,34,32
1656805832596,MATH 109,A03,093478,Ganzberger; Geoffrey Michael,1,0,34,33
1656805832596,MATH 109,B01,083215,Ganzberger; Geoffrey Michael,1,0,32,31
1656805832596,MATH 109,B02,083216,Ganzberger; Geoffrey Michael,1,0,32,31
1656805832596,MATH 109,B03,093479,Ganzberger; Geoffrey Michael,6,0,32,26
1656805838627,MATH 142A,A01,083219,Chow; Bennett,6,0,32,26
1656805838627,MATH 142A,A02,083220,Chow; Bennett,9,0,32,23
1656805838627,MATH 142A,A03,093480,Chow; Bennett,7,0,32,25
1656805838627,MATH 142A,B03,093481,Chow; Bennett,7,0,32,25
1656805838627,MATH 142A,B04,093558,Chow; Bennett,10,0,32,22
1656805838627,MATH 142A,B05,093559,Chow; Bennett,6,0,32,26
1656805844653,MATH 193A,A01,083224,Rotar; Vladimir,6,0,34,28
1656805844653,MATH 193A,A02,083225,Rotar; Vladimir,3,0,34,31
1656805844653,MATH 193A,A03,083781,Rotar; Vladimir,1,0,34,33
1656805844653,MATH 193A,A04,083782,Rotar; Vladimir,6,0,34,28
1656805844653,MATH 193A,A05,093482,Rotar; Vladimir,6,0,34,28
1656805850677,MATH 197,001,091859,McAuley; Julian John,9999,0,9999,0
1656805850677,MATH 197,002,095566,Kedlaya; Kiran S.,9997,0,9999,2
1656805850677,MATH 197,003,095567,Xiao; Ming,9999,0,9999,0
1656805850677,MATH 197,004,095571,Perols; Johan Lars,9998,0,9999,1
1656805857731,COGS 9,A01,083615,Shannon; Kyle Michael,6,0,75,69
1656805863756,COGS 11,A01,083617,Boyle; Mary E. T.,18,0,48,30
1656805869779,COGS 13,A01,083071,Bastos; Amalia Pinkusfeld,8,0,71,63
1656805875805,COGS 14A,A01,092681,Semenuks; Arturs,0,1,100,100
1656805881828,COGS 14B,A01,083073,Cheng; Tzu-Han,5,0,63,58
1656805887856,COGS 17,A01,092677,Semenuks; Arturs,4,0,81,77
1656805893883,COGS 100,A01,083619,Allen; Michael Gordon,15,0,70,55
1656805899906,COGS 101A,A01,083621,Davis; Joshua Daniel,9,0,68,59
1656805905929,COGS 101B,A01,091572,Allen; Michael Gordon,8,0,65,57
1656805911957,COGS 101C,A01,083625,Delgado; Tania,17,0,35,18
1656805917985,COGS 107A,A01,083627,Boyle; Mary E. T.,13,0,60,47
1656805924081,COGS 118A,A01,083075,Gupta; Anjum,15,0,76,61
1656805930105,CSE 3,A50,083646,Miranda; Gregory Joseph,22,0,50,28
1656805936134,CSE 8A,A50,083650,Miranda; Gregory Joseph,17,1,56,39
1656805942161,CSE 11,A01,083080,Cao; Yingjun,4,15,40,36
1656805948186,CSE 12,A01,083652,Krause-Levy; Sophia Louisa,20,1,120,100
1656805954209,CSE 15L,A01,083654,Morris; Justin Loren,8,0,50,42
1656805954209,CSE 15L,A02,083655,Morris; Justin Loren,8,0,50,42
1656805960231,CSE 20,A01,083657,Tran; Khoa Dang,37,0,80,43
1656805966257,CSE 21,A01,095574,Bach; Quang Tran,21,0,48,27
1656805972283,CSE 30,A01,083084,Eldon; John,4,0,80,76
1656805972283,CSE 30,B01,095061,Bhaskar; Nishant,5,0,50,45
1656805978310,CSE 100,A01,083659,Cao; Yingjun,1,4,70,69
1656805984350,CSE 134B,A01,083661,Powell; Thomas Allan,18,0,100,82
1656805990377,CSE 140,A01,083663,Gungor; Onat,14,0,85,71
1656805996402,CSE 140L,A01,083088,Eldon; John,16,0,100,84
1656806002423,CSE 175,A01,083665,Kumar; Rakesh,3,0,25,22
1656806008449,CSE 190,A00,092507,Dubnov; Shlomo,7,0,20,13
1656806014473,ECE 45,A01,083139,Congero; Spencer William,5,0,75,70
1656806020497,ECE 65,A50,083695,Saad; Andrew S,12,0,30,18
1656806020497,ECE 65,A51,095125,Saad; Andrew S,25,0,26,1
1656806026530,ECE 109,A01,091882,Touri; Behrouz,15,0,70,55
1656806032553,ECE 180,A00,083140,Abi Samra; Nicholas Camill,0,0,30,30
1656806032553,ECE 180,B00,083141,Abi Samra; Nicholas Camill,0,0,30,30
1656806038576,MATH 10A,A01,083735,Patchell; Gregory David,1,0,30,29
1656806038576,MATH 10A,A02,083736,Patchell; Gregory David,20,0,30,10
1656806038576,MATH 10A,A03,083737,Patchell; Gregory David,15,0,30,15
1656806044603,MATH 10B,A01,083207,Lim; Seonhee,7,0,34,27
1656806044603,MATH 10B,A02,083208,Lim; Seonhee,9,0,35,26
1656806044603,MATH 10B,A03,093472,Lim; Seonhee,4,0,34,30
1656806044603,MATH 10B,B01,083739,Sinha; Shubham,9,0,30,21
1656806050628,MATH 18,A01,083743,Cinel; Cameron Alexander,6,0,30,24
1656806050628,MATH 18,A02,083744,Cinel; Cameron Alexander,15,0,30,15
1656806050628,MATH 18,A03,083745,Cinel; Cameron Alexander,8,0,30,22
1656806050628,MATH 18,B01,083748,Rideout; David Porter,3,0,37,34
1656806050628,MATH 18,B02,083749,Rideout; David Porter,3,0,36,33
1656806050628,MATH 18,B03,083750,Rideout; David Porter,1,0,37,36
1656806050628,MATH 18,B04,083751,Rideout; David Porter,5,0,36,31
1656806050628,MATH 18,B05,093473,Rideout; David Porter,4,0,36,32
1656806050628,MATH 18,B06,093474,Rideout; David Porter,5,0,36,31
1656806056650,MATH 20A,A01,083754,Zheng; Zequn,12,0,40,28
1656806062676,MATH 20B,A01,083756,Briones; Jor-el Thomas Caparas,1,0,36,35
1656806062676,MATH 20B,A02,083757,Briones; Jor-el Thomas Caparas,1,0,36,35
1656806062676,MATH 20B,A03,093475,Briones; Jor-el Thomas Caparas,0,0,36,36
1656806068714,MATH 20C,A01,083760,Briones; Jor-el Thomas Caparas,1,0,35,34
1656806068714,MATH 20C,A02,083761,Briones; Jor-el Thomas Caparas,8,0,35,27
1656806068714,MATH 20C,A03,093476,Briones; Jor-el Thomas Caparas,0,1,36,36
1656806068714,MATH 20C,B01,083762,Bach; Quang Tran,0,0,30,30
1656806074736,MATH 20D,A01,083765,Tran; Brian Kha,4,0,30,26
1656806074736,MATH 20D,A02,083766,Tran; Brian Kha,4,0,30,26
1656806074736,MATH 20D,A03,083767,Tran; Brian Kha,2,0,30,28
1656806080765,MATH 20E,A01,083771,Ganguly; Soumya,5,0,32,27
1656806080765,MATH 20E,A02,083772,Ganguly; Soumya,5,0,32,27
1656806080765,MATH 20E,B01,083773,Ciotti; Benjamin,18,0,35,17
1656806080765,MATH 20E,B02,083774,Ciotti; Benjamin,17,0,35,18
1656806086790,MATH 103A,A01,083777,Greenfeld; Be'Eri,2,0,36,34
1656806086790,MATH 103A,A02,083778,Greenfeld; Be'Eri,5,0,36,31
1656806086790,MATH 103A,A03,093561,Greenfeld; Be'Eri,4,0,36,32
1656806086790,MATH 103A,B01,083779,Greenfeld; Be'Eri,6,0,36,30
1656806086790,MATH 103A,B02,083780,Greenfeld; Be'Eri,2,0,36,34
1656806086790,MATH 103A,B03,093562,Greenfeld; Be'Eri,2,0,36,34
1656806092814,MATH 105,A01,085443,Carter; Anne Toulson,13,0,35,22
1656806092814,MATH 105,A02,093477,Carter; Anne Toulson,20,0,35,15
1656806098842,MATH 109,A01,083213,Ganzberger; Geoffrey Michael,2,0,34,32
1656806098842,MATH 109,A02,083214,Ganzberger; Geoffrey Michael,2,0,34,32
1656806098842,MATH 109,A03,093478,Ganzberger; Geoffrey Michael,1,0,34,33
1656806098842,MATH 109,B01,083215,Ganzberger; Geoffrey Michael,1,0,32,31
1656806098842,MATH 109,B02,083216,Ganzberger; Geoffrey Michael,1,0,32,31
1656806098842,MATH 109,B03,093479,Ganzberger; Geoffrey Michael,6,0,32,26
1656806104867,MATH 142A,A01,083219,Chow; Bennett,6,0,32,26
1656806104867,MATH 142A,A02,083220,Chow; Bennett,9,0,32,23
1656806104867,MATH 142A,A03,093480,Chow; Bennett,7,0,32,25
1656806104867,MATH 142A,B03,093481,Chow; Bennett,7,0,32,25
1656806104867,MATH 142A,B04,093558,Chow; Bennett,10,0,32,22
1656806104867,MATH 142A,B05,093559,Chow; Bennett,6,0,32,26
1656806110915,MATH 193A,A01,083224,Rotar; Vladimir,6,0,34,28
1656806110915,MATH 193A,A02,083225,Rotar; Vladimir,3,0,34,31
1656806110915,MATH 193A,A03,083781,Rotar; Vladimir,1,0,34,33
1656806110915,MATH 193A,A04,083782,Rotar; Vladimir,6,0,34,28
1656806110915,MATH 193A,A05,093482,Rotar; Vladimir,6,0,34,28
1656806116941,MATH 197,001,091859,McAuley; Julian John,9999,0,9999,0
1656806116941,MATH 197,002,095566,Kedlaya; Kiran S.,9997,0,9999,2
1656806116941,MATH 197,003,095567,Xiao; Ming,9999,0,9999,0
1656806116941,MATH 197,004,095571,Perols; Johan Lars,9998,0,9999,1
1656806123996,COGS 9,A01,083615,Shannon; Kyle Michael,6,0,75,69
1656806130020,COGS 11,A01,083617,Boyle; Mary E. T.,18,0,48,30
1656806136046,COGS 13,A01,083071,Bastos; Amalia Pinkusfeld,8,0,71,63
1656806142069,COGS 14A,A01,092681,Semenuks; Arturs,0,1,100,100
1656806148093,COGS 14B,A01,083073,Cheng; Tzu-Han,5,0,63,58
1656806154135,COGS 17,A01,092677,Semenuks; Arturs,4,0,81,77
1656806160159,COGS 100,A01,083619,Allen; Michael Gordon,15,0,70,55
1656806166185,COGS 101A,A01,083621,Davis; Joshua Daniel,9,0,68,59
1656806172208,COGS 101B,A01,091572,Allen; Michael Gordon,8,0,65,57
1656806178230,COGS 101C,A01,083625,Delgado; Tania,17,0,35,18
1656806184253,COGS 107A,A01,083627,Boyle; Mary E. T.,13,0,60,47
1656806190276,COGS 118A,A01,083075,Gupta; Anjum,15,0,76,61
1656806196304,CSE 3,A50,083646,Miranda; Gregory Joseph,22,0,50,28
1656806202332,CSE 8A,A50,083650,Miranda; Gregory Joseph,17,1,56,39
1656806208358,CSE 11,A01,083080,Cao; Yingjun,4,15,40,36
1656806214381,CSE 12,A01,083652,Krause-Levy; Sophia Louisa,20,1,120,100
1656806220412,CSE 15L,A01,083654,Morris; Justin Loren,8,0,50,42
1656806220412,CSE 15L,A02,083655,Morris; Justin Loren,8,0,50,42
1656806226447,CSE 20,A01,083657,Tran; Khoa Dang,37,0,80,43
1656806232469,CSE 21,A01,095574,Bach; Quang Tran,21,0,48,27
1656806238492,CSE 30,A01,083084,Eldon; John,4,0,80,76
1656806238492,CSE 30,B01,095061,Bhaskar; Nishant,5,0,50,45
1656806244515,CSE 100,A01,083659,Cao; Yingjun,1,4,70,69
1656806250542,CSE 134B,A01,083661,Powell; Thomas Allan,18,0,100,82
1656806256569,CSE 140,A01,083663,Gungor; Onat,14,0,85,71
1656806262593,CSE 140L,A01,083088,Eldon; John,16,0,100,84
1656806268626,CSE 175,A01,083665,Kumar; Rakesh,3,0,25,22
1656806274652,CSE 190,A00,092507,Dubnov; Shlomo,7,0,20,13
1656806280679,ECE 45,A01,083139,Congero; Spencer William,5,0,75,70
1656806286702,ECE 65,A50,083695,Saad; Andrew S,12,0,30,18
1656806286702,ECE 65,A51,095125,Saad; Andrew S,25,0,26,1
1656806292724,ECE 109,A01,091882,Touri; Behrouz,15,0,70,55
1656806298751,ECE 180,A00,083140,Abi Samra; Nicholas Camill,0,0,30,30
1656806298751,ECE 180,B00,083141,Abi Samra; Nicholas Camill,0,0,30,30
1656806304773,MATH 10A,A01,083735,Patchell; Gregory David,1,0,30,29
1656806304773,MATH 10A,A02,083736,Patchell; Gregory David,20,0,30,10
1656806304773,MATH 10A,A03,083737,Patchell; Gregory David,15,0,30,15
1656806310797,MATH 10B,A01,083207,Lim; Seonhee,7,0,34,27
1656806310797,MATH 10B,A02,083208,Lim; Seonhee,9,0,35,26
1656806310797,MATH 10B,A03,093472,Lim; Seonhee,4,0,34,30
1656806310797,MATH 10B,B01,083739,Sinha; Shubham,9,0,30,21
1656806316828,MATH 18,A01,083743,Cinel; Cameron Alexander,6,0,30,24
1656806316828,MATH 18,A02,083744,Cinel; Cameron Alexander,15,0,30,15
1656806316828,MATH 18,A03,083745,Cinel; Cameron Alexander,8,0,30,22
1656806316828,MATH 18,B01,083748,Rideout; David Porter,3,0,37,34
1656806316828,MATH 18,B02,083749,Rideout; David Porter,3,0,36,33
1656806316828,MATH 18,B03,083750,Rideout; David Porter,1,0,37,36
1656806316828,MATH 18,B04,083751,Rideout; David Porter,5,0,36,31
1656806316828,MATH 18,B05,093473,Rideout; David Porter,4,0,36,32
1656806316828,MATH 18,B06,093474,Rideout; David Porter,5,0,36,31
1656806322855,MATH 20A,A01,083754,Zheng; Zequn,12,0,40,28
1656806328893,MATH 20B,A01,083756,Briones; Jor-el Thomas Caparas,1,0,36,35
1656806328893,MATH 20B,A02,083757,Briones; Jor-el Thomas Caparas,1,0,36,35
1656806328893,MATH 20B,A03,093475,Briones; Jor-el Thomas Caparas,0,0,36,36
1656806334918,MATH 20C,A01,083760,Briones; Jor-el Thomas Caparas,1,0,35,34
1656806334918,MATH 20C,A02,083761,Briones; Jor-el Thomas Caparas,8,0,35,27
1656806334918,MATH 20C,A03,093476,Briones; Jor-el Thomas Caparas,0,1,36,36
1656806334918,MATH 20C,B01,083762,Bach; Quang Tran,0,0,30,30
1656806340949,MATH 20D,A01,083765,Tran; Brian Kha,4,0,30,26
1656806340949,MATH 20D,A02,083766,Tran; Brian Kha,4,0,30,26
1656806340949,MATH 20D,A03,083767,Tran; Brian Kha,2,0,30,28
1656806346978,MATH 20E,A01,083771,Ganguly; Soumya,5,0,32,27
1656806346978,MATH 20E,A02,083772,Ganguly; Soumya,5,0,32,27
1656806346978,MATH 20E,B01,083773,Ciotti; Benjamin,18,0,35,17
1656806346978,MATH 20E,B02,083774,Ciotti; Benjamin,17,0,35,18
1656806353007,MATH 103A,A01,083777,Greenfeld; Be'Eri,2,0,36,34
1656806353007,MATH 103A,A02,083778,Greenfeld; Be'Eri,5,0,36,31
1656806353007,MATH 103A,A03,093561,Greenfeld; Be'Eri,4,0,36,32
1656806353007,MATH 103A,B01,083779,Greenfeld; Be'Eri,6,0,36,30
1656806353007,MATH 103A,B02,083780,Greenfeld; Be'Eri,2,0,36,34
1656806353007,MATH 103A,B03,093562,Greenfeld; Be'Eri,2,0,36,34
1656806359031,MATH 105,A01,085443,Carter; Anne Toulson,13,0,35,22
1656806359031,MATH 105,A02,093477,Carter; Anne Toulson,20,0,35,15
1656806365053,MATH 109,A01,083213,Ganzberger; Geoffrey Michael,2,0,34,32
1656806365053,MATH 109,A02,083214,Ganzberger; Geoffrey Michael,2,0,34,32
1656806365053,MATH 109,A03,093478,Ganzberger; Geoffrey Michael,1,0,34,33
1656806365053,MATH 109,B01,083215,Ganzberger; Geoffrey Michael,1,0,32,31
1656806365053,MATH 109,B02,083216,Ganzberger; Geoffrey Michael,1,0,32,31
1656806365053,MATH 109,B03,093479,Ganzberger; Geoffrey Michael,6,0,32,26
1656806371083,MATH 142A,A01,083219,Chow; Bennett,6,0,32,26
1656806371083,MATH 142A,A02,083220,Chow; Bennett,9,0,32,23
1656806371083,MATH 142A,A03,093480,Chow; Bennett,7,0,32,25
1656806371083,MATH 142A,B03,093481,Chow; Bennett,7,0,32,25
1656806371083,MATH 142A,B04,093558,Chow; Bennett,10,0,32,22
1656806371083,MATH 142A,B05,093559,Chow; Bennett,6,0,32,26
1656806377114,MATH 193A,A01,083224,Rotar; Vladimir,6,0,34,28
1656806377114,MATH 193A,A02,083225,Rotar; Vladimir,3,0,34,31
1656806377114,MATH 193A,A03,083781,Rotar; Vladimir,1,0,34,33
1656806377114,MATH 193A,A04,083782,Rotar; Vladimir,6,0,34,28
1656806377114,MATH 193A,A05,093482,Rotar; Vladimir,6,0,34,28
1656806383138,MATH 197,001,091859,McAuley; Julian John,9999,0,9999,0
1656806383138,MATH 197,002,095566,Kedlaya; Kiran S.,9997,0,9999,2
1656806383138,MATH 197,003,095567,Xiao; Ming,9999,0,9999,0
1656806383138,MATH 197,004,095571,Perols; Johan Lars,9998,0,9999,1
1656806390205,COGS 9,A01,083615,Shannon; Kyle Michael,6,0,75,69
1656806396228,COGS 11,A01,083617,Boyle; Mary E. T.,18,0,48,30
1656806402255,COGS 13,A01,083071,Bastos; Amalia Pinkusfeld,8,0,71,63
1656806408278,COGS 14A,A01,092681,Semenuks; Arturs,0,1,100,100
1656806414302,COGS 14B,A01,083073,Cheng; Tzu-Han,5,0,63,58
1656806420327,COGS 17,A01,092677,Semenuks; Arturs,4,0,81,77
1656806426349,COGS 100,A01,083619,Allen; Michael Gordon,15,0,70,55
1656806432374,COGS 101A,A01,083621,Davis; Joshua Daniel,9,0,68,59
1656806438399,COGS 101B,A01,091572,Allen; Michael Gordon,8,0,65,57
1656806444423,COGS 101C,A01,083625,Delgado; Tania,17,0,35,18
1656806450456,COGS 107A,A01,083627,Boyle; Mary E. T.,13,0,60,47
1656806456479,COGS 118A,A01,083075,Gupta; Anjum,15,0,76,61
1656806462510,CSE 3,A50,083646,Miranda; Gregory Joseph,22,0,50,28
1656806468534,CSE 8A,A50,083650,Miranda; Gregory Joseph,17,1,56,39
1656806474555,CSE 11,A01,083080,Cao; Yingjun,4,15,40,36
1656806480578,CSE 12,A01,083652,Krause-Levy; Sophia Louisa,20,1,120,100
1656806486613,CSE 15L,A01,083654,Morris; Justin Loren,8,0,50,42
1656806486613,CSE 15L,A02,083655,Morris; Justin Loren,8,0,50,42
1656806492637,CSE 20,A01,083657,Tran; Khoa Dang,37,0,80,43
1656806498660,CSE 21,A01,095574,Bach; Quang Tran,21,0,48,27
1656806504683,CSE 30,A01,083084,Eldon; John,4,0,80,76
1656806504683,CSE 30,B01,095061,Bhaskar; Nishant,5,0,50,45
1656806510708,CSE 100,A01,083659,Cao; Yingjun,1,4,70,69
1656806516735,CSE 134B,A01,083661,Powell; Thomas Allan,18,0,100,82
1656806522865,CSE 140,A01,083663,Gungor; Onat,14,0,85,71
1656806528888,CSE 140L,A01,083088,Eldon; John,16,0,100,84
1656806534910,CSE 175,A01,083665,Kumar; Rakesh,3,0,25,22
1656806540938,CSE 190,A00,092507,Dubnov; Shlomo,7,0,20,13
1656806546971,ECE 45,A01,083139,Congero; Spencer William,5,0,75,70
1656806552995,ECE 65,A50,083695,Saad; Andrew S,12,0,30,18
1656806552995,ECE 65,A51,095125,Saad; Andrew S,25,0,26,1
1656806559017,ECE 109,A01,091882,Touri; Behrouz,15,0,70,55
1656806565045,ECE 180,A00,083140,Abi Samra; Nicholas Camill,0,0,30,30
1656806565045,ECE 180,B00,083141,Abi Samra; Nicholas Camill,0,0,30,30
1656806571071,MATH 10A,A01,083735,Patchell; Gregory David,1,0,30,29
1656806571071,MATH 10A,A02,083736,Patchell; Gregory David,20,0,30,10
1656806571071,MATH 10A,A03,083737,Patchell; Gregory David,15,0,30,15
1656806577094,MATH 10B,A01,083207,Lim; Seonhee,7,0,34,27
1656806577094,MATH 10B,A02,083208,Lim; Seonhee,9,0,35,26
1656806577094,MATH 10B,A03,093472,Lim; Seonhee,4,0,34,30
1656806577094,MATH 10B,B01,083739,Sinha; Shubham,9,0,30,21
1656806583120,MATH 18,A01,083743,Cinel; Cameron Alexander,6,0,30,24
1656806583120,MATH 18,A02,083744,Cinel; Cameron Alexander,15,0,30,15
1656806583120,MATH 18,A03,083745,Cinel; Cameron Alexander,8,0,30,22
1656806583120,MATH 18,B01,083748,Rideout; David Porter,3,0,37,34
1656806583120,MATH 18,B02,083749,Rideout; David Porter,3,0,36,33
1656806583120,MATH 18,B03,083750,Rideout; David Porter,1,0,37,36
1656806583120,MATH 18,B04,083751,Rideout; David Porter,5,0,36,31
1656806583120,MATH 18,B05,093473,Rideout; David Porter,4,0,36,32
1656806583120,MATH 18,B06,093474,Rideout; David Porter,5,0,36,31
1656806589142,MATH 20A,A01,083754,Zheng; Zequn,12,0,40,28
1656806595180,MATH 20B,A01,083756,Briones; Jor-el Thomas Caparas,1,0,36,35
1656806595180,MATH 20B,A02,083757,Briones; Jor-el Thomas Caparas,1,0,36,35
1656806595180,MATH 20B,A03,093475,Briones; Jor-el Thomas Caparas,0,0,36,36
1656806601207,MATH 20C,A01,083760,Briones; Jor-el Thomas Caparas,1,0,35,34
1656806601207,MATH 20C,A02,083761,Briones; Jor-el Thomas Caparas,8,0,35,27
1656806601207,MATH 20C,A03,093476,Briones; Jor-el Thomas Caparas,0,1,36,36
1656806601207,MATH 20C,B01,083762,Bach; Quang Tran,0,0,30,30
1656806607237,MATH 20D,A01,083765,Tran; Brian Kha,4,0,30,26
1656806607237,MATH 20D,A02,083766,Tran; Brian Kha,4,0,30,26
1656806607237,MATH 20D,A03,083767,Tran; Brian Kha,2,0,30,28
1656806613266,MATH 20E,A01,083771,Ganguly; Soumya,5,0,32,27
1656806613266,MATH 20E,A02,083772,Ganguly; Soumya,5,0,32,27
1656806613266,MATH 20E,B01,083773,Ciotti; Benjamin,18,0,35,17
1656806613266,MATH 20E,B02,083774,Ciotti; Benjamin,17,0,35,18
1656806619296,MATH 103A,A01,083777,Greenfeld; Be'Eri,2,0,36,34
1656806619296,MATH 103A,A02,083778,Greenfeld; Be'Eri,5,0,36,31
1656806619296,MATH 103A,A03,093561,Greenfeld; Be'Eri,4,0,36,32
1656806619296,MATH 103A,B01,083779,Greenfeld; Be'Eri,6,0,36,30
1656806619296,MATH 103A,B02,083780,Greenfeld; Be'Eri,2,0,36,34
1656806619296,MATH 103A,B03,093562,Greenfeld; Be'Eri,2,0,36,34
1656806625328,MATH 105,A01,085443,Carter; Anne Toulson,13,0,35,22
1656806625328,MATH 105,A02,093477,Carter; Anne Toulson,20,0,35,15
1656806631358,MATH 109,A01,083213,Ganzberger; Geoffrey Michael,2,0,34,32
1656806631358,MATH 109,A02,083214,Ganzberger; Geoffrey Michael,2,0,34,32
1656806631358,MATH 109,A03,093478,Ganzberger; Geoffrey Michael,1,0,34,33
1656806631358,MATH 109,B01,083215,Ganzberger; Geoffrey Michael,1,0,32,31
1656806631358,MATH 109,B02,083216,Ganzberger; Geoffrey Michael,1,0,32,31
1656806631358,MATH 109,B03,093479,Ganzberger; Geoffrey Michael,6,0,32,26
1656806637384,MATH 142A,A01,083219,Chow; Bennett,6,0,32,26
1656806637384,MATH 142A,A02,083220,Chow; Bennett,9,0,32,23
1656806637384,MATH 142A,A03,093480,Chow; Bennett,7,0,32,25
1656806637384,MATH 142A,B03,093481,Chow; Bennett,7,0,32,25
1656806637384,MATH 142A,B04,093558,Chow; Bennett,10,0,32,22
1656806637384,MATH 142A,B05,093559,Chow; Bennett,6,0,32,26
1656806643417,MATH 193A,A01,083224,Rotar; Vladimir,6,0,34,28
1656806643417,MATH 193A,A02,083225,Rotar; Vladimir,3,0,34,31
1656806643417,MATH 193A,A03,083781,Rotar; Vladimir,1,0,34,33
1656806643417,MATH 193A,A04,083782,Rotar; Vladimir,6,0,34,28
1656806643417,MATH 193A,A05,093482,Rotar; Vladimir,6,0,34,28
1656806649444,MATH 197,001,091859,McAuley; Julian John,9999,0,9999,0
1656806649444,MATH 197,002,095566,Kedlaya; Kiran S.,9997,0,9999,2
1656806649444,MATH 197,003,095567,Xiao; Ming,9999,0,9999,0
1656806649444,MATH 197,004,095571,Perols; Johan Lars,9998,0,9999,1
1656806656497,COGS 9,A01,083615,Shannon; Kyle Michael,6,0,75,69
1656806662524,COGS 11,A01,083617,Boyle; Mary E. T.,18,0,48,30
1656806668546,COGS 13,A01,083071,Bastos; Amalia Pinkusfeld,8,0,71,63
1656806674574,COGS 14A,A01,092681,Semenuks; Arturs,0,1,100,100
1656806680602,COGS 14B,A01,083073,Cheng; Tzu-Han,5,0,63,58
1656806686624,COGS 17,A01,092677,Semenuks; Arturs,4,0,81,77
1656806692645,COGS 100,A01,083619,Allen; Michael Gordon,15,0,70,55
1656806698683,COGS 101A,A01,083621,Davis; Joshua Daniel,9,0,68,59
1656806704706,COGS 101B,A01,091572,Allen; Michael Gordon,8,0,65,57
1656806710729,COGS 101C,A01,083625,Delgado; Tania,17,0,35,18
1656806716752,COGS 107A,A01,083627,Boyle; Mary E. T.,13,0,60,47
1656806722775,COGS 118A,A01,083075,Gupta; Anjum,15,0,76,61
1656806728804,CSE 3,A50,083646,Miranda; Gregory Joseph,22,0,50,28
1656806734825,CSE 8A,A50,083650,Miranda; Gregory Joseph,17,1,56,39
1656806740852,CSE 11,A01,083080,Cao; Yingjun,4,15,40,36
1656806746879,CSE 12,A01,083652,Krause-Levy; Sophia Louisa,20,1,120,100
1656806752903,CSE 15L,A01,083654,Morris; Justin Loren,8,0,50,42
1656806752903,CSE 15L,A02,083655,Morris; Justin Loren,8,0,50,42
1656806758931,CSE 20,A01,083657,Tran; Khoa Dang,37,0,80,43
1656806764955,CSE 21,A01,095574,Bach; Quang Tran,21,0,48,27
1656806770993,CSE 30,A01,083084,Eldon; John,4,0,80,76
1656806770993,CSE 30,B01,095061,Bhaskar; Nishant,5,0,50,45
1656806777016,CSE 100,A01,083659,Cao; Yingjun,1,4,70,69
1656806783048,CSE 134B,A01,083661,Powell; Thomas Allan,18,0,100,82
1656806789078,CSE 140,A01,083663,Gungor; Onat,14,0,85,71
1656806795118,CSE 140L,A01,083088,Eldon; John,16,0,100,84
1656806801145,CSE 175,A01,083665,Kumar; Rakesh,3,0,25,22
1656806807193,CSE 190,A00,092507,Dubnov; Shlomo,7,0,20,13
1656806813222,ECE 45,A01,083139,Congero; Spencer William,5,0,75,70
1656806819246,ECE 65,A50,083695,Saad; Andrew S,12,0,30,18
1656806819246,ECE 65,A51,095125,Saad; Andrew S,25,0,26,1
1656806825275,ECE 109,A01,091882,Touri; Behrouz,15,0,70,55
1656806831317,ECE 180,A00,083140,Abi Samra; Nicholas Camill,0,0,30,30
1656806831317,ECE 180,B00,083141,Abi Samra; Nicholas Camill,0,0,30,30
1656806837346,MATH 10A,A01,083735,Patchell; Gregory David,1,0,30,29
1656806837346,MATH 10A,A02,083736,Patchell; Gregory David,20,0,30,10
1656806837346,MATH 10A,A03,083737,Patchell; Gregory David,15,0,30,15
1656806843371,MATH 10B,A01,083207,Lim; Seonhee,7,0,34,27
1656806843371,MATH 10B,A02,083208,Lim; Seonhee,9,0,35,26
1656806843371,MATH 10B,A03,093472,Lim; Seonhee,4,0,34,30
1656806843371,MATH 10B,B01,083739,Sinha; Shubham,9,0,30,21
1656806849398,MATH 18,A01,083743,Cinel; Cameron Alexander,6,0,30,24
1656806849398,MATH 18,A02,083744,Cinel; Cameron Alexander,15,0,30,15
1656806849398,MATH 18,A03,083745,Cinel; Cameron Alexander,8,0,30,22
1656806849398,MATH 18,B01,083748,Rideout; David Porter,3,0,37,34
1656806849398,MATH 18,B02,083749,Rideout; David Porter,3,0,36,33
1656806849398,MATH 18,B03,083750,Rideout; David Porter,1,0,37,36
1656806849398,MATH 18,B04,083751,Rideout; David Porter,5,0,36,31
1656806849398,MATH 18,B05,093473,Rideout; David Porter,4,0,36,32
1656806849398,MATH 18,B06,093474,Rideout; David Porter,5,0,36,31
1656806855422,MATH 20A,A01,083754,Zheng; Zequn,12,0,40,28
1656806861445,MATH 20B,A01,083756,Briones; Jor-el Thomas Caparas,1,0,36,35
1656806861445,MATH 20B,A02,083757,Briones; Jor-el Thomas Caparas,1,0,36,35
1656806861445,MATH 20B,A03,093475,Briones; Jor-el Thomas Caparas,0,0,36,36
1656806867475,MATH 20C,A01,083760,Briones; Jor-el Thomas Caparas,1,0,35,34
1656806867475,MATH 20C,A02,083761,Briones; Jor-el Thomas Caparas,8,0,35,27
1656806867475,MATH 20C,A03,093476,Briones; Jor-el Thomas Caparas,0,1,36,36
1656806867475,MATH 20C,B01,083762,Bach; Quang Tran,0,0,30,30
1656806873506,MATH 20D,A01,083765,Tran; Brian Kha,4,0,30,26
1656806873506,MATH 20D,A02,083766,Tran; Brian Kha,4,0,30,26
1656806873506,MATH 20D,A03,083767,Tran; Brian Kha,2,0,30,28
1656806879530,MATH 20E,A01,083771,Ganguly; Soumya,5,0,32,27
1656806879530,MATH 20E,A02,083772,Ganguly; Soumya,5,0,32,27
1656806879530,MATH 20E,B01,083773,Ciotti; Benjamin,18,0,35,17
1656806879530,MATH 20E,B02,083774,Ciotti; Benjamin,17,0,35,18
1656806885561,MATH 103A,A01,083777,Greenfeld; Be'Eri,2,0,36,34
1656806885561,MATH 103A,A02,083778,Greenfeld; Be'Eri,5,0,36,31
1656806885561,MATH 103A,A03,093561,Greenfeld; Be'Eri,4,0,36,32
1656806885561,MATH 103A,B01,083779,Greenfeld; Be'Eri,6,0,36,30
1656806885561,MATH 103A,B02,083780,Greenfeld; Be'Eri,2,0,36,34
1656806885561,MATH 103A,B03,093562,Greenfeld; Be'Eri,2,0,36,34
1656806891590,MATH 105,A01,085443,Carter; Anne Toulson,13,0,35,22
1656806891590,MATH 105,A02,093477,Carter; Anne Toulson,20,0,35,15
1656806897615,MATH 109,A01,083213,Ganzberger; Geoffrey Michael,2,0,34,32
1656806897615,MATH 109,A02,083214,Ganzberger; Geoffrey Michael,2,0,34,32
1656806897615,MATH 109,A03,093478,Ganzberger; Geoffrey Michael,1,0,34,33
1656806897615,MATH 109,B01,083215,Ganzberger; Geoffrey Michael,1,0,32,31
1656806897615,MATH 109,B02,083216,Ganzberger; Geoffrey Michael,1,0,32,31
1656806897615,MATH 109,B03,093479,Ganzberger; Geoffrey Michael,6,0,32,26
1656806903645,MATH 142A,A01,083219,Chow; Bennett,6,0,32,26
1656806903645,MATH 142A,A02,083220,Chow; Bennett,9,0,32,23
1656806903645,MATH 142A,A03,093480,Chow; Bennett,7,0,32,25
1656806903645,MATH 142A,B03,093481,Chow; Bennett,7,0,32,25
1656806903645,MATH 142A,B04,093558,Chow; Bennett,10,0,32,22
1656806903645,MATH 142A,B05,093559,Chow; Bennett,6,0,32,26
1656806909674,MATH 193A,A01,083224,Rotar; Vladimir,6,0,34,28
1656806909674,MATH 193A,A02,083225,Rotar; Vladimir,3,0,34,31
1656806909674,MATH 193A,A03,083781,Rotar; Vladimir,1,0,34,33
1656806909674,MATH 193A,A04,083782,Rotar; Vladimir,6,0,34,28
1656806909674,MATH 193A,A05,093482,Rotar; Vladimir,6,0,34,28
1656806915707,MATH 197,001,091859,McAuley; Julian John,9999,0,9999,0
1656806915707,MATH 197,002,095566,Kedlaya; Kiran S.,9997,0,9999,2
1656806915707,MATH 197,003,095567,Xiao; Ming,9999,0,9999,0
1656806915707,MATH 197,004,095571,Perols; Johan Lars,9998,0,9999,1
1656806922777,COGS 9,A01,083615,Shannon; Kyle Michael,6,0,75,69
1656806928803,COGS 11,A01,083617,Boyle; Mary E. T.,18,0,48,30
1656806934838,COGS 13,A01,083071,Bastos; Amalia Pinkusfeld,8,0,71,63
1656806940863,COGS 14A,A01,092681,Semenuks; Arturs,0,1,100,100
1656806946886,COGS 14B,A01,083073,Cheng; Tzu-Han,5,0,63,58
1656806952910,COGS 17,A01,092677,Semenuks; Arturs,4,0,81,77
1656806958938,COGS 100,A01,083619,Allen; Michael Gordon,15,0,70,55
1656806964965,COGS 101A,A01,083621,Davis; Joshua Daniel,9,0,68,59
1656806970994,COGS 101B,A01,091572,Allen; Michael Gordon,8,0,65,57
1656806977023,COGS 101C,A01,083625,Delgado; Tania,17,0,35,18
1656806983053,COGS 107A,A01,083627,Boyle; Mary E. T.,13,0,60,47
1656806989083,COGS 118A,A01,083075,Gupta; Anjum,15,0,76,61
1656806995116,CSE 3,A50,083646,Miranda; Gregory Joseph,22,0,50,28
1656807001139,CSE 8A,A50,083650,Miranda; Gregory Joseph,17,1,56,39
1656807007166,CSE 11,A01,083080,Cao; Yingjun,4,15,40,36
1656807013190,CSE 12,A01,083652,Krause-Levy; Sophia Louisa,20,1,120,100
1656807019218,CSE 15L,A01,083654,Morris; Justin Loren,8,0,50,42
1656807019218,CSE 15L,A02,083655,Morris; Justin Loren,8,0,50,42
1656807025241,CSE 20,A01,083657,Tran; Khoa Dang,37,0,80,43
1656807031264,CSE 21,A01,095574,Bach; Quang Tran,21,0,48,27
1656807037291,CSE 30,A01,083084,Eldon; John,4,0,80,76
1656807037291,CSE 30,B01,095061,Bhaskar; Nishant,5,0,50,45
1656807043313,CSE 100,A01,083659,Cao; Yingjun,1,4,70,69
1656807049355,CSE 134B,A01,083661,Powell; Thomas Allan,18,0,100,82
1656807055384,CSE 140,A01,083663,Gungor; Onat,14,0,85,71
1656807061407,CSE 140L,A01,083088,Eldon; John,16,0,100,84
1656807067435,CSE 175,A01,083665,Kumar; Rakesh,3,0,25,22
1656807073459,CSE 190,A00,092507,Dubnov; Shlomo,7,0,20,13
1656807079483,ECE 45,A01,083139,Congero; Spencer William,5,0,75,70
1656807085512,ECE 65,A50,083695,Saad; Andrew S,12,0,30,18
1656807085512,ECE 65,A51,095125,Saad; Andrew S,25,0,26,1
1656807091543,ECE 109,A01,091882,Touri; Behrouz,15,0,70,55
1656807097572,ECE 180,A00,083140,Abi Samra; Nicholas Camill,0,0,30,30
1656807097572,ECE 180,B00,083141,Abi Samra; Nicholas Camill,0,0,30,30
1656807103600,MATH 10A,A01,083735,Patchell; Gregory David,1,0,30,29
1656807103600,MATH 10A,A02,083736,Patchell; Gregory David,20,0,30,10
1656807103600,MATH 10A,A03,083737,Patchell; Gregory David,15,0,30,15
1656807109625,MATH 10B,A01,083207,Lim; Seonhee,7,0,34,27
1656807109625,MATH 10B,A02,083208,Lim; Seonhee,9,0,35,26
1656807109625,MATH 10B,A03,093472,Lim; Seonhee,4,0,34,30
1656807109625,MATH 10B,B01,083739,Sinha; Shubham,9,0,30,21
1656807115657,MATH 18,A01,083743,Cinel; Cameron Alexander,6,0,30,24
1656807115657,MATH 18,A02,083744,Cinel; Cameron Alexander,15,0,30,15
1656807115657,MATH 18,A03,083745,Cinel; Cameron Alexander,8,0,30,22
1656807115657,MATH 18,B01,083748,Rideout; David Porter,3,0,37,34
1656807115657,MATH 18,B02,083749,Rideout; David Porter,3,0,36,33
1656807115657,MATH 18,B03,083750,Rideout; David Porter,1,0,37,36
1656807115657,MATH 18,B04,083751,Rideout; David Porter,5,0,36,31
1656807115657,MATH 18,B05,093473,Rideout; David Porter,4,0,36,32
1656807115657,MATH 18,B06,093474,Rideout; David Porter,5,0,36,31
1656807121752,MATH 20A,A01,083754,Zheng; Zequn,12,0,40,28
1656807127775,MATH 20B,A01,083756,Briones; Jor-el Thomas Caparas,1,0,36,35
1656807127775,MATH 20B,A02,083757,Briones; Jor-el Thomas Caparas,1,0,36,35
1656807127775,MATH 20B,A03,093475,Briones; Jor-el Thomas Caparas,0,0,36,36
1656807133804,MATH 20C,A01,083760,Briones; Jor-el Thomas Caparas,1,0,35,34
1656807133804,MATH 20C,A02,083761,Briones; Jor-el Thomas Caparas,8,0,35,27
1656807133804,MATH 20C,A03,093476,Briones; Jor-el Thomas Caparas,0,1,36,36
1656807133804,MATH 20C,B01,083762,Bach; Quang Tran,0,0,30,30
1656807139832,MATH 20D,A01,083765,Tran; Brian Kha,4,0,30,26
1656807139832,MATH 20D,A02,083766,Tran; Brian Kha,4,0,30,26
1656807139832,MATH 20D,A03,083767,Tran; Brian Kha,2,0,30,28
1656807145861,MATH 20E,A01,083771,Ganguly; Soumya,5,0,32,27
1656807145861,MATH 20E,A02,083772,Ganguly; Soumya,5,0,32,27
1656807145861,MATH 20E,B01,083773,Ciotti; Benjamin,18,0,35,17
1656807145861,MATH 20E,B02,083774,Ciotti; Benjamin,17,0,35,18
1656807151889,MATH 103A,A01,083777,Greenfeld; Be'Eri,2,0,36,34
1656807151889,MATH 103A,A02,083778,Greenfeld; Be'Eri,5,0,36,31
1656807151889,MATH 103A,A03,093561,Greenfeld; Be'Eri,4,0,36,32
1656807151889,MATH 103A,B01,083779,Greenfeld; Be'Eri,6,0,36,30
1656807151889,MATH 103A,B02,083780,Greenfeld; Be'Eri,2,0,36,34
1656807151889,MATH 103A,B03,093562,Greenfeld; Be'Eri,2,0,36,34
1656807157913,MATH 105,A01,085443,Carter; Anne Toulson,13,0,35,22
1656807157913,MATH 105,A02,093477,Carter; Anne Toulson,20,0,35,15
1656807163942,MATH 109,A01,083213,Ganzberger; Geoffrey Michael,2,0,34,32
1656807163942,MATH 109,A02,083214,Ganzberger; Geoffrey Michael,2,0,34,32
1656807163942,MATH 109,A03,093478,Ganzberger; Geoffrey Michael,1,0,34,33
1656807163942,MATH 109,B01,083215,Ganzberger; Geoffrey Michael,1,0,32,31
1656807163942,MATH 109,B02,083216,Ganzberger; Geoffrey Michael,1,0,32,31
1656807163942,MATH 109,B03,093479,Ganzberger; Geoffrey Michael,6,0,32,26
1656807169973,MATH 142A,A01,083219,Chow; Bennett,6,0,32,26
1656807169973,MATH 142A,A02,083220,Chow; Bennett,9,0,32,23
1656807169973,MATH 142A,A03,093480,Chow; Bennett,7,0,32,25
1656807169973,MATH 142A,B03,093481,Chow; Bennett,7,0,32,25
1656807169973,MATH 142A,B04,093558,Chow; Bennett,10,0,32,22
1656807169973,MATH 142A,B05,093559,Chow; Bennett,6,0,32,26
1656807175997,MATH 193A,A01,083224,Rotar; Vladimir,6,0,34,28
1656807175997,MATH 193A,A02,083225,Rotar; Vladimir,3,0,34,31
1656807175997,MATH 193A,A03,083781,Rotar; Vladimir,1,0,34,33
1656807175997,MATH 193A,A04,083782,Rotar; Vladimir,6,0,34,28
1656807175997,MATH 193A,A05,093482,Rotar; Vladimir,6,0,34,28
1656807182022,MATH 197,001,091859,McAuley; Julian John,9999,0,9999,0
1656807182022,MATH 197,002,095566,Kedlaya; Kiran S.,9997,0,9999,2
1656807182022,MATH 197,003,095567,Xiao; Ming,9999,0,9999,0
1656807182022,MATH 197,004,095571,Perols; Johan Lars,9998,0,9999,1
1656807189075,COGS 9,A01,083615,Shannon; Kyle Michael,6,0,75,69
1656807195098,COGS 11,A01,083617,Boyle; Mary E. T.,18,0,48,30
1656807201122,COGS 13,A01,083071,Bastos; Amalia Pinkusfeld,8,0,71,63
1656807207149,COGS 14A,A01,092681,Semenuks; Arturs,0,1,100,100
1656807213173,COGS 14B,A01,083073,Cheng; Tzu-Han,5,0,63,58
1656807219196,COGS 17,A01,092677,Semenuks; Arturs,4,0,81,77
1656807225222,COGS 100,A01,083619,Allen; Michael Gordon,15,0,70,55
1656807231251,COGS 101A,A01,083621,Davis; Joshua Daniel,9,0,68,59
1656807237279,COGS 101B,A01,091572,Allen; Michael Gordon,8,0,65,57
1656807243305,COGS 101C,A01,083625,Delgado; Tania,17,0,35,18
1656807249328,COGS 107A,A01,083627,Boyle; Mary E. T.,13,0,60,47
1656807255350,COGS 118A,A01,083075,Gupta; Anjum,15,0,76,61
1656807261372,CSE 3,A50,083646,Miranda; Gregory Joseph,22,0,50,28
1656807267396,CSE 8A,A50,083650,Miranda; Gregory Joseph,17,1,56,39
1656807273422,CSE 11,A01,083080,Cao; Yingjun,4,15,40,36
1656807279446,CSE 12,A01,083652,Krause-Levy; Sophia Louisa,20,1,120,100
1656807285474,CSE 15L,A01,083654,Morris; Justin Loren,8,0,50,42
1656807285474,CSE 15L,A02,083655,Morris; Justin Loren,8,0,50,42
1656807291500,CSE 20,A01,083657,Tran; Khoa Dang,37,0,80,43
1656807297528,CSE 21,A01,095574,Bach; Quang Tran,21,0,48,27
1656807303550,CSE 30,A01,083084,Eldon; John,4,0,80,76
1656807303550,CSE 30,B01,095061,Bhaskar; Nishant,5,0,50,45
1656807309576,CSE 100,A01,083659,Cao; Yingjun,1,4,70,69
1656807315606,CSE 134B,A01,083661,Powell; Thomas Allan,18,0,100,82
1656807321633,CSE 140,A01,083663,Gungor; Onat,14,0,85,71
1656807327659,CSE 140L,A01,083088,Eldon; John,16,0,100,84
1656807333683,CSE 175,A01,083665,Kumar; Rakesh,3,0,25,22
1656807339706,CSE 190,A00,092507,Dubnov; Shlomo,7,0,20,13
1656807345732,ECE 45,A01,083139,Congero; Spencer William,5,0,75,70
1656807351755,ECE 65,A50,083695,Saad; Andrew S,12,0,30,18
1656807351755,ECE 65,A51,095125,Saad; Andrew S,25,0,26,1
1656807357779,ECE 109,A01,091882,Touri; Behrouz,15,0,70,55
1656807363804,ECE 180,A00,083140,Abi Samra; Nicholas Camill,0,0,30,30
1656807363804,ECE 180,B00,083141,Abi Samra; Nicholas Camill,0,0,30,30
1656807369830,MATH 10A,A01,083735,Patchell; Gregory David,1,0,30,29
1656807369830,MATH 10A,A02,083736,Patchell; Gregory David,20,0,30,10
1656807369830,MATH 10A,A03,083737,Patchell; Gregory David,15,0,30,15
1656807375871,MATH 10B,A01,083207,Lim; Seonhee,7,0,34,27
1656807375871,MATH 10B,A02,083208,Lim; Seonhee,9,0,35,26
1656807375871,MATH 10B,A03,093472,Lim; Seonhee,4,0,34,30
1656807375871,MATH 10B,B01,083739,Sinha; Shubham,9,0,30,21
1656807381896,MATH 18,A01,083743,Cinel; Cameron Alexander,6,0,30,24
1656807381896,MATH 18,A02,083744,Cinel; Cameron Alexander,15,0,30,15
1656807381896,MATH 18,A03,083745,Cinel; Cameron Alexander,8,0,30,22
1656807381896,MATH 18,B01,083748,Rideout; David Porter,3,0,37,34
1656807381896,MATH 18,B02,083749,Rideout; David Porter,3,0,36,33
1656807381896,MATH 18,B03,083750,Rideout; David Porter,1,0,37,36
1656807381896,MATH 18,B04,083751,Rideout; David Porter,5,0,36,31
1656807381896,MATH 18,B05,093473,Rideout; David Porter,4,0,36,32
1656807381896,MATH 18,B06,093474,Rideout; David Porter,5,0,36,31
1656807387920,MATH 20A,A01,083754,Zheng; Zequn,12,0,40,28
1656807393949,MATH 20B,A01,083756,Briones; Jor-el Thomas Caparas,1,0,36,35
1656807393949,MATH 20B,A02,083757,Briones; Jor-el Thomas Caparas,1,0,36,35
1656807393949,MATH 20B,A03,093475,Briones; Jor-el Thomas Caparas,0,0,36,36
1656807399982,MATH 20C,A01,083760,Briones; Jor-el Thomas Caparas,1,0,35,34
1656807399982,MATH 20C,A02,083761,Briones; Jor-el Thomas Caparas,8,0,35,27
1656807399982,MATH 20C,A03,093476,Briones; Jor-el Thomas Caparas,0,1,36,36
1656807399982,MATH 20C,B01,083762,Bach; Quang Tran,0,0,30,30
1656807406007,MATH 20D,A01,083765,Tran; Brian Kha,4,0,30,26
1656807406007,MATH 20D,A02,083766,Tran; Brian Kha,4,0,30,26
1656807406007,MATH 20D,A03,083767,Tran; Brian Kha,2,0,30,28
1656807412034,MATH 20E,A01,083771,Ganguly; Soumya,5,0,32,27
1656807412034,MATH 20E,A02,083772,Ganguly; Soumya,5,0,32,27
1656807412034,MATH 20E,B01,083773,Ciotti; Benjamin,18,0,35,17
1656807412034,MATH 20E,B02,083774,Ciotti; Benjamin,17,0,35,18
1656807418058,MATH 103A,A01,083777,Greenfeld; Be'Eri,2,0,36,34
1656807418058,MATH 103A,A02,083778,Greenfeld; Be'Eri,5,0,36,31
1656807418058,MATH 103A,A03,093561,Greenfeld; Be'Eri,4,0,36,32
1656807418058,MATH 103A,B01,083779,Greenfeld; Be'Eri,6,0,36,30
1656807418058,MATH 103A,B02,083780,Greenfeld; Be'Eri,2,0,36,34
1656807418058,MATH 103A,B03,093562,Greenfeld; Be'Eri,2,0,36,34
1656807424082,MATH 105,A01,085443,Carter; Anne Toulson,13,0,35,22
1656807424082,MATH 105,A02,093477,Carter; Anne Toulson,20,0,35,15
1656807430107,MATH 109,A01,083213,Ganzberger; Geoffrey Michael,2,0,34,32
1656807430107,MATH 109,A02,083214,Ganzberger; Geoffrey Michael,2,0,34,32
1656807430107,MATH 109,A03,093478,Ganzberger; Geoffrey Michael,1,0,34,33
1656807430107,MATH 109,B01,083215,Ganzberger; Geoffrey Michael,1,0,32,31
1656807430107,MATH 109,B02,083216,Ganzberger; Geoffrey Michael,1,0,32,31
1656807430107,MATH 109,B03,093479,Ganzberger; Geoffrey Michael,6,0,32,26
1656807436136,MATH 142A,A01,083219,Chow; Bennett,6,0,32,26
1656807436136,MATH 142A,A02,083220,Chow; Bennett,9,0,32,23
1656807436136,MATH 142A,A03,093480,Chow; Bennett,7,0,32,25
1656807436136,MATH 142A,B03,093481,Chow; Bennett,7,0,32,25
1656807436136,MATH 142A,B04,093558,Chow; Bennett,10,0,32,22
1656807436136,MATH 142A,B05,093559,Chow; Bennett,6,0,32,26
1656807442165,MATH 193A,A01,083224,Rotar; Vladimir,6,0,34,28
1656807442165,MATH 193A,A02,083225,Rotar; Vladimir,3,0,34,31
1656807442165,MATH 193A,A03,083781,Rotar; Vladimir,1,0,34,33
1656807442165,MATH 193A,A04,083782,Rotar; Vladimir,6,0,34,28
1656807442165,MATH 193A,A05,093482,Rotar; Vladimir,6,0,34,28
1656807448189,MATH 197,001,091859,McAuley; Julian John,9999,0,9999,0
1656807448189,MATH 197,002,095566,Kedlaya; Kiran S.,9997,0,9999,2
1656807448189,MATH 197,003,095567,Xiao; Ming,9999,0,9999,0
1656807448189,MATH 197,004,095571,Perols; Johan Lars,9998,0,9999,1
1656807455251,COGS 9,A01,083615,Shannon; Kyle Michael,6,0,75,69
1656807461274,COGS 11,A01,083617,Boyle; Mary E. T.,18,0,48,30
1656807467297,COGS 13,A01,083071,Bastos; Amalia Pinkusfeld,8,0,71,63
1656807473323,COGS 14A,A01,092681,Semenuks; Arturs,0,1,100,100
1656807479349,COGS 14B,A01,083073,Cheng; Tzu-Han,5,0,63,58
1656807485372,COGS 17,A01,092677,Semenuks; Arturs,4,0,81,77
1656807491408,COGS 100,A01,083619,Allen; Michael Gordon,15,0,70,55
1656807497431,COGS 101A,A01,083621,Davis; Joshua Daniel,9,0,68,59
1656807503463,COGS 101B,A01,091572,Allen; Michael Gordon,8,0,65,57
1656807509488,COGS 101C,A01,083625,Delgado; Tania,17,0,35,18
1656807515510,COGS 107A,A01,083627,Boyle; Mary E. T.,13,0,60,47
1656807521534,COGS 118A,A01,083075,Gupta; Anjum,15,0,76,61
1656807527562,CSE 3,A50,083646,Miranda; Gregory Joseph,22,0,50,28
1656807533587,CSE 8A,A50,083650,Miranda; Gregory Joseph,17,1,56,39
1656807539613,CSE 11,A01,083080,Cao; Yingjun,4,15,40,36
1656807545639,CSE 12,A01,083652,Krause-Levy; Sophia Louisa,20,1,120,100
1656807551666,CSE 15L,A01,083654,Morris; Justin Loren,8,0,50,42
1656807551666,CSE 15L,A02,083655,Morris; Justin Loren,8,0,50,42
1656807557691,CSE 20,A01,083657,Tran; Khoa Dang,37,0,80,43
1656807563714,CSE 21,A01,095574,Bach; Quang Tran,21,0,48,27
1656807569738,CSE 30,A01,083084,Eldon; John,4,0,80,76
1656807569738,CSE 30,B01,095061,Bhaskar; Nishant,5,0,50,45
1656807575765,CSE 100,A01,083659,Cao; Yingjun,1,4,70,69
1656807581797,CSE 134B,A01,083661,Powell; Thomas Allan,18,0,100,82
1656807587823,CSE 140,A01,083663,Gungor; Onat,14,0,85,71
1656807593851,CSE 140L,A01,083088,Eldon; John,16,0,100,84
1656807599890,CSE 175,A01,083665,Kumar; Rakesh,3,0,25,22
1656807605912,CSE 190,A00,092507,Dubnov; Shlomo,7,0,20,13
1656807611936,ECE 45,A01,083139,Congero; Spencer William,5,0,75,70
1656807617960,ECE 65,A50,083695,Saad; Andrew S,12,0,30,18
1656807617960,ECE 65,A51,095125,Saad; Andrew S,25,0,26,1
1656807623986,ECE 109,A01,091882,Touri; Behrouz,15,0,70,55
1656807630014,ECE 180,A00,083140,Abi Samra; Nicholas Camill,0,0,30,30
1656807630014,ECE 180,B00,083141,Abi Samra; Nicholas Camill,0,0,30,30
1656807636038,MATH 10A,A01,083735,Patchell; Gregory David,1,0,30,29
1656807636038,MATH 10A,A02,083736,Patchell; Gregory David,20,0,30,10
1656807636038,MATH 10A,A03,083737,Patchell; Gregory David,15,0,30,15
1656807642061,MATH 10B,A01,083207,Lim; Seonhee,7,0,34,27
1656807642061,MATH 10B,A02,083208,Lim; Seonhee,9,0,35,26
1656807642061,MATH 10B,A03,093472,Lim; Seonhee,4,0,34,30
1656807642061,MATH 10B,B01,083739,Sinha; Shubham,9,0,30,21
1656807648085,MATH 18,A01,083743,Cinel; Cameron Alexander,6,0,30,24
1656807648085,MATH 18,A02,083744,Cinel; Cameron Alexander,15,0,30,15
1656807648085,MATH 18,A03,083745,Cinel; Cameron Alexander,8,0,30,22
1656807648085,MATH 18,B01,083748,Rideout; David Porter,3,0,37,34
1656807648085,MATH 18,B02,083749,Rideout; David Porter,3,0,36,33
1656807648085,MATH 18,B03,083750,Rideout; David Porter,1,0,37,36
1656807648085,MATH 18,B04,083751,Rideout; David Porter,5,0,36,31
1656807648085,MATH 18,B05,093473,Rideout; David Porter,4,0,36,32
1656807648085,MATH 18,B06,093474,Rideout; David Porter,5,0,36,31
1656807654108,MATH 20A,A01,083754,Zheng; Zequn,12,0,40,28
1656807660131,MATH 20B,A01,083756,Briones; Jor-el Thomas Caparas,1,0,36,35
1656807660131,MATH 20B,A02,083757,Briones; Jor-el Thomas Caparas,1,0,36,35
1656807660131,MATH 20B,A03,093475,Briones; Jor-el Thomas Caparas,0,0,36,36
1656807666163,MATH 20C,A01,083760,Briones; Jor-el Thomas Caparas,1,0,35,34
1656807666163,MATH 20C,A02,083761,Briones; Jor-el Thomas Caparas,8,0,35,27
1656807666163,MATH 20C,A03,093476,Briones; Jor-el Thomas Caparas,0,1,36,36
1656807666163,MATH 20C,B01,083762,Bach; Quang Tran,0,0,30,30
1656807672187,MATH 20D,A01,083765,Tran; Brian Kha,4,0,30,26
1656807672187,MATH 20D,A02,083766,Tran; Brian Kha,4,0,30,26
1656807672187,MATH 20D,A03,083767,Tran; Brian Kha,2,0,30,28
1656807678209,MATH 20E,A01,083771,Ganguly; Soumya,5,0,32,27
1656807678209,MATH 20E,A02,083772,Ganguly; Soumya,5,0,32,27
1656807678209,MATH 20E,B01,083773,Ciotti; Benjamin,18,0,35,17
1656807678209,MATH 20E,B02,083774,Ciotti; Benjamin,17,0,35,18
1656807684238,MATH 103A,A01,083777,Greenfeld; Be'Eri,2,0,36,34
1656807684238,MATH 103A,A02,083778,Greenfeld; Be'Eri,5,0,36,31
1656807684238,MATH 103A,A03,093561,Greenfeld; Be'Eri,4,0,36,32
1656807684238,MATH 103A,B01,083779,Greenfeld; Be'Eri,6,0,36,30
1656807684238,MATH 103A,B02,083780,Greenfeld; Be'Eri,2,0,36,34
1656807684238,MATH 103A,B03,093562,Greenfeld; Be'Eri,2,0,36,34
1656807690262,MATH 105,A01,085443,Carter; Anne Toulson,13,0,35,22
1656807690262,MATH 105,A02,093477,Carter; Anne Toulson,20,0,35,15
1656807696291,MATH 109,A01,083213,Ganzberger; Geoffrey Michael,2,0,34,32
1656807696291,MATH 109,A02,083214,Ganzberger; Geoffrey Michael,2,0,34,32
1656807696291,MATH 109,A03,093478,Ganzberger; Geoffrey Michael,1,0,34,33
1656807696291,MATH 109,B01,083215,Ganzberger; Geoffrey Michael,1,0,32,31
1656807696291,MATH 109,B02,083216,Ganzberger; Geoffrey Michael,1,0,32,31
1656807696291,MATH 109,B03,093479,Ganzberger; Geoffrey Michael,6,0,32,26
1656807702324,MATH 142A,A01,083219,Chow; Bennett,6,0,32,26
1656807702324,MATH 142A,A02,083220,Chow; Bennett,9,0,32,23
1656807702324,MATH 142A,A03,093480,Chow; Bennett,7,0,32,25
1656807702324,MATH 142A,B03,093481,Chow; Bennett,7,0,32,25
1656807702324,MATH 142A,B04,093558,Chow; Bennett,10,0,32,22
1656807702324,MATH 142A,B05,093559,Chow; Bennett,6,0,32,26
1656807708349,MATH 193A,A01,083224,Rotar; Vladimir,6,0,34,28
1656807708349,MATH 193A,A02,083225,Rotar; Vladimir,3,0,34,31
1656807708349,MATH 193A,A03,083781,Rotar; Vladimir,1,0,34,33
1656807708349,MATH 193A,A04,083782,Rotar; Vladimir,6,0,34,28
1656807708349,MATH 193A,A05,093482,Rotar; Vladimir,6,0,34,28
1656807714372,MATH 197,001,091859,McAuley; Julian John,9999,0,9999,0
1656807714372,MATH 197,002,095566,Kedlaya; Kiran S.,9997,0,9999,2
1656807714372,MATH 197,003,095567,Xiao; Ming,9999,0,9999,0
1656807714372,MATH 197,004,095571,Perols; Johan Lars,9998,0,9999,1
1656807721500,COGS 9,A01,083615,Shannon; Kyle Michael,6,0,75,69
1656807727525,COGS 11,A01,083617,Boyle; Mary E. T.,18,0,48,30
1656807733549,COGS 13,A01,083071,Bastos; Amalia Pinkusfeld,8,0,71,63
1656807739575,COGS 14A,A01,092681,Semenuks; Arturs,0,1,100,100
1656807745602,COGS 14B,A01,083073,Cheng; Tzu-Han,5,0,63,58
1656807751627,COGS 17,A01,092677,Semenuks; Arturs,4,0,81,77
1656807757653,COGS 100,A01,083619,Allen; Michael Gordon,15,0,70,55
1656807763677,COGS 101A,A01,083621,Davis; Joshua Daniel,9,0,68,59
1656807769701,COGS 101B,A01,091572,Allen; Michael Gordon,8,0,65,57
1656807775728,COGS 101C,A01,083625,Delgado; Tania,17,0,35,18
1656807781751,COGS 107A,A01,083627,Boyle; Mary E. T.,13,0,60,47
1656807787777,COGS 118A,A01,083075,Gupta; Anjum,15,0,76,61
1656807793803,CSE 3,A50,083646,Miranda; Gregory Joseph,22,0,50,28
1656807799827,CSE 8A,A50,083650,Miranda; Gregory Joseph,17,1,56,39
1656807805854,CSE 11,A01,083080,Cao; Yingjun,4,15,40,36
1656807811892,CSE 12,A01,083652,Krause-Levy; Sophia Louisa,20,1,120,100
1656807817918,CSE 15L,A01,083654,Morris; Justin Loren,8,0,50,42
1656807817918,CSE 15L,A02,083655,Morris; Justin Loren,8,0,50,42
1656807823942,CSE 20,A01,083657,Tran; Khoa Dang,37,0,80,43
1656807829965,CSE 21,A01,095574,Bach; Quang Tran,21,0,48,27
1656807835988,CSE 30,A01,083084,Eldon; John,4,0,80,76
1656807835988,CSE 30,B01,095061,Bhaskar; Nishant,5,0,50,45
1656807842014,CSE 100,A01,083659,Cao; Yingjun,1,4,70,69
1656807848038,CSE 134B,A01,083661,Powell; Thomas Allan,18,0,100,82
1656807854059,CSE 140,A01,083663,Gungor; Onat,14,0,85,71
1656807860083,CSE 140L,A01,083088,Eldon; John,16,0,100,84
1656807866109,CSE 175,A01,083665,Kumar; Rakesh,3,0,25,22
1656807872135,CSE 190,A00,092507,Dubnov; Shlomo,7,0,20,13
1656807878159,ECE 45,A01,083139,Congero; Spencer William,5,0,75,70
1656807884187,ECE 65,A50,083695,Saad; Andrew S,12,0,30,18
1656807884187,ECE 65,A51,095125,Saad; Andrew S,25,0,26,1
1656807890214,ECE 109,A01,091882,Touri; Behrouz,15,0,70,55
1656807896243,ECE 180,A00,083140,Abi Samra; Nicholas Camill,0,0,30,30
1656807896243,ECE 180,B00,083141,Abi Samra; Nicholas Camill,0,0,30,30
1656807902274,MATH 10A,A01,083735,Patchell; Gregory David,1,0,30,29
1656807902274,MATH 10A,A02,083736,Patchell; Gregory David,20,0,30,10
1656807902274,MATH 10A,A03,083737,Patchell; Gregory David,15,0,30,15
1656807908304,MATH 10B,A01,083207,Lim; Seonhee,7,0,34,27
1656807908304,MATH 10B,A02,083208,Lim; Seonhee,9,0,35,26
1656807908304,MATH 10B,A03,093472,Lim; Seonhee,4,0,34,30
1656807908304,MATH 10B,B01,083739,Sinha; Shubham,9,0,30,21
1656807914336,MATH 18,A01,083743,Cinel; Cameron Alexander,6,0,30,24
1656807914336,MATH 18,A02,083744,Cinel; Cameron Alexander,15,0,30,15
1656807914336,MATH 18,A03,083745,Cinel; Cameron Alexander,8,0,30,22
1656807914336,MATH 18,B01,083748,Rideout; David Porter,3,0,37,34
1656807914336,MATH 18,B02,083749,Rideout; David Porter,3,0,36,33
1656807914336,MATH 18,B03,083750,Rideout; David Porter,1,0,37,36
1656807914336,MATH 18,B04,083751,Rideout; David Porter,5,0,36,31
1656807914336,MATH 18,B05,093473,Rideout; David Porter,4,0,36,32
1656807914336,MATH 18,B06,093474,Rideout; David Porter,5,0,36,31
1656807920360,MATH 20A,A01,083754,Zheng; Zequn,12,0,40,28
1656807926390,MATH 20B,A01,083756,Briones; Jor-el Thomas Caparas,1,0,36,35
1656807926390,MATH 20B,A02,083757,Briones; Jor-el Thomas Caparas,1,0,36,35
1656807926390,MATH 20B,A03,093475,Briones; Jor-el Thomas Caparas,0,0,36,36
1656807932413,MATH 20C,A01,083760,Briones; Jor-el Thomas Caparas,1,0,35,34
1656807932413,MATH 20C,A02,083761,Briones; Jor-el Thomas Caparas,8,0,35,27
1656807932413,MATH 20C,A03,093476,Briones; Jor-el Thomas Caparas,0,1,36,36
1656807932413,MATH 20C,B01,083762,Bach; Quang Tran,0,0,30,30
1656807938437,MATH 20D,A01,083765,Tran; Brian Kha,4,0,30,26
1656807938437,MATH 20D,A02,083766,Tran; Brian Kha,4,0,30,26
1656807938437,MATH 20D,A03,083767,Tran; Brian Kha,2,0,30,28
1656807944466,MATH 20E,A01,083771,Ganguly; Soumya,5,0,32,27
1656807944466,MATH 20E,A02,083772,Ganguly; Soumya,5,0,32,27
1656807944466,MATH 20E,B01,083773,Ciotti; Benjamin,18,0,35,17
1656807944466,MATH 20E,B02,083774,Ciotti; Benjamin,17,0,35,18
1656807950490,MATH 103A,A01,083777,Greenfeld; Be'Eri,2,0,36,34
1656807950490,MATH 103A,A02,083778,Greenfeld; Be'Eri,5,0,36,31
1656807950490,MATH 103A,A03,093561,Greenfeld; Be'Eri,4,0,36,32
1656807950490,MATH 103A,B01,083779,Greenfeld; Be'Eri,6,0,36,30
1656807950490,MATH 103A,B02,083780,Greenfeld; Be'Eri,2,0,36,34
1656807950490,MATH 103A,B03,093562,Greenfeld; Be'Eri,2,0,36,34
1656807956523,MATH 105,A01,085443,Carter; Anne Toulson,13,0,35,22
1656807956523,MATH 105,A02,093477,Carter; Anne Toulson,20,0,35,15
1656807962550,MATH 109,A01,083213,Ganzberger; Geoffrey Michael,2,0,34,32
1656807962550,MATH 109,A02,083214,Ganzberger; Geoffrey Michael,2,0,34,32
1656807962550,MATH 109,A03,093478,Ganzberger; Geoffrey Michael,1,0,34,33
1656807962550,MATH 109,B01,083215,Ganzberger; Geoffrey Michael,1,0,32,31
1656807962550,MATH 109,B02,083216,Ganzberger; Geoffrey Michael,1,0,32,31
1656807962550,MATH 109,B03,093479,Ganzberger; Geoffrey Michael,6,0,32,26
1656807968585,MATH 142A,A01,083219,Chow; Bennett,6,0,32,26
1656807968585,MATH 142A,A02,083220,Chow; Bennett,9,0,32,23
1656807968585,MATH 142A,A03,093480,Chow; Bennett,7,0,32,25
1656807968585,MATH 142A,B03,093481,Chow; Bennett,7,0,32,25
1656807968585,MATH 142A,B04,093558,Chow; Bennett,10,0,32,22
1656807968585,MATH 142A,B05,093559,Chow; Bennett,6,0,32,26
1656807974613,MATH 193A,A01,083224,Rotar; Vladimir,6,0,34,28
1656807974613,MATH 193A,A02,083225,Rotar; Vladimir,3,0,34,31
1656807974613,MATH 193A,A03,083781,Rotar; Vladimir,1,0,34,33
1656807974613,MATH 193A,A04,083782,Rotar; Vladimir,6,0,34,28
1656807974613,MATH 193A,A05,093482,Rotar; Vladimir,6,0,34,28
1656807980638,MATH 197,001,091859,McAuley; Julian John,9999,0,9999,0
1656807980638,MATH 197,002,095566,Kedlaya; Kiran S.,9997,0,9999,2
1656807980638,MATH 197,003,095567,Xiao; Ming,9999,0,9999,0
1656807980638,MATH 197,004,095571,Perols; Johan Lars,9998,0,9999,1
1656807987706,COGS 9,A01,083615,Shannon; Kyle Michael,6,0,75,69
1656807993733,COGS 11,A01,083617,Boyle; Mary E. T.,18,0,48,30
1656807999760,COGS 13,A01,083071,Bastos; Amalia Pinkusfeld,8,0,71,63
1656808005788,COGS 14A,A01,092681,Semenuks; Arturs,0,1,100,100
1656808011812,COGS 14B,A01,083073,Cheng; Tzu-Han,5,0,63,58
1656808017834,COGS 17,A01,092677,Semenuks; Arturs,4,0,81,77
1656808023858,COGS 100,A01,083619,Allen; Michael Gordon,15,0,70,55
1656808029880,COGS 101A,A01,083621,Davis; Joshua Daniel,9,0,68,59
1656808035903,COGS 101B,A01,091572,Allen; Michael Gordon,8,0,65,57
1656808041927,COGS 101C,A01,083625,Delgado; Tania,17,0,35,18
1656808047950,COGS 107A,A01,083627,Boyle; Mary E. T.,13,0,60,47
1656808053985,COGS 118A,A01,083075,Gupta; Anjum,15,0,76,61
1656808060012,CSE 3,A50,083646,Miranda; Gregory Joseph,22,0,50,28
1656808066039,CSE 8A,A50,083650,Miranda; Gregory Joseph,17,1,56,39
1656808072062,CSE 11,A01,083080,Cao; Yingjun,4,15,40,36
1656808078084,CSE 12,A01,083652,Krause-Levy; Sophia Louisa,20,1,120,100
1656808084106,CSE 15L,A01,083654,Morris; Justin Loren,8,0,50,42
1656808084106,CSE 15L,A02,083655,Morris; Justin Loren,8,0,50,42
1656808090129,CSE 20,A01,083657,Tran; Khoa Dang,37,0,80,43
1656808096151,CSE 21,A01,095574,Bach; Quang Tran,21,0,48,27
1656808102175,CSE 30,A01,083084,Eldon; John,4,0,80,76
1656808102175,CSE 30,B01,095061,Bhaskar; Nishant,5,0,50,45
1656808108200,CSE 100,A01,083659,Cao; Yingjun,1,4,70,69
1656808114234,CSE 134B,A01,083661,Powell; Thomas Allan,18,0,100,82
1656808120257,CSE 140,A01,083663,Gungor; Onat,14,0,85,71
1656808126284,CSE 140L,A01,083088,Eldon; John,16,0,100,84
1656808132316,CSE 175,A01,083665,Kumar; Rakesh,3,0,25,22
1656808138341,CSE 190,A00,092507,Dubnov; Shlomo,7,0,20,13
1656808144366,ECE 45,A01,083139,Congero; Spencer William,5,0,75,70
1656808150398,ECE 65,A50,083695,Saad; Andrew S,12,0,30,18
1656808150398,ECE 65,A51,095125,Saad; Andrew S,25,0,26,1
1656808156422,ECE 109,A01,091882,Touri; Behrouz,15,0,70,55
1656808162445,ECE 180,A00,083140,Abi Samra; Nicholas Camill,0,0,30,30
1656808162445,ECE 180,B00,083141,Abi Samra; Nicholas Camill,0,0,30,30
1656808168468,MATH 10A,A01,083735,Patchell; Gregory David,1,0,30,29
1656808168468,MATH 10A,A02,083736,Patchell; Gregory David,20,0,30,10
1656808168468,MATH 10A,A03,083737,Patchell; Gregory David,15,0,30,15
1656808174493,MATH 10B,A01,083207,Lim; Seonhee,7,0,34,27
1656808174493,MATH 10B,A02,083208,Lim; Seonhee,9,0,35,26
1656808174493,MATH 10B,A03,093472,Lim; Seonhee,4,0,34,30
1656808174493,MATH 10B,B01,083739,Sinha; Shubham,9,0,30,21
1656808180522,MATH 18,A01,083743,Cinel; Cameron Alexander,6,0,30,24
1656808180522,MATH 18,A02,083744,Cinel; Cameron Alexander,15,0,30,15
1656808180522,MATH 18,A03,083745,Cinel; Cameron Alexander,8,0,30,22
1656808180522,MATH 18,B01,083748,Rideout; David Porter,3,0,37,34
1656808180522,MATH 18,B02,083749,Rideout; David Porter,3,0,36,33
1656808180522,MATH 18,B03,083750,Rideout; David Porter,1,0,37,36
1656808180522,MATH 18,B04,083751,Rideout; David Porter,5,0,36,31
1656808180522,MATH 18,B05,093473,Rideout; David Porter,4,0,36,32
1656808180522,MATH 18,B06,093474,Rideout; David Porter,5,0,36,31
1656808186552,MATH 20A,A01,083754,Zheng; Zequn,12,0,40,28
1656808192575,MATH 20B,A01,083756,Briones; Jor-el Thomas Caparas,1,0,36,35
1656808192575,MATH 20B,A02,083757,Briones; Jor-el Thomas Caparas,1,0,36,35
1656808192575,MATH 20B,A03,093475,Briones; Jor-el Thomas Caparas,0,0,36,36
1656808198600,MATH 20C,A01,083760,Briones; Jor-el Thomas Caparas,1,0,35,34
1656808198600,MATH 20C,A02,083761,Briones; Jor-el Thomas Caparas,8,0,35,27
1656808198600,MATH 20C,A03,093476,Briones; Jor-el Thomas Caparas,0,1,36,36
1656808198600,MATH 20C,B01,083762,Bach; Quang Tran,0,0,30,30
1656808204630,MATH 20D,A01,083765,Tran; Brian Kha,4,0,30,26
1656808204630,MATH 20D,A02,083766,Tran; Brian Kha,4,0,30,26
1656808204630,MATH 20D,A03,083767,Tran; Brian Kha,2,0,30,28
1656808210660,MATH 20E,A01,083771,Ganguly; Soumya,5,0,32,27
1656808210660,MATH 20E,A02,083772,Ganguly; Soumya,5,0,32,27
1656808210660,MATH 20E,B01,083773,Ciotti; Benjamin,18,0,35,17
1656808210660,MATH 20E,B02,083774,Ciotti; Benjamin,17,0,35,18
1656808216684,MATH 103A,A01,083777,Greenfeld; Be'Eri,2,0,36,34
1656808216684,MATH 103A,A02,083778,Greenfeld; Be'Eri,5,0,36,31
1656808216684,MATH 103A,A03,093561,Greenfeld; Be'Eri,4,0,36,32
1656808216684,MATH 103A,B01,083779,Greenfeld; Be'Eri,6,0,36,30
1656808216684,MATH 103A,B02,083780,Greenfeld; Be'Eri,2,0,36,34
1656808216684,MATH 103A,B03,093562,Greenfeld; Be'Eri,2,0,36,34
1656808222711,MATH 105,A01,085443,Carter; Anne Toulson,13,0,35,22
1656808222711,MATH 105,A02,093477,Carter; Anne Toulson,20,0,35,15
1656808228738,MATH 109,A01,083213,Ganzberger; Geoffrey Michael,2,0,34,32
1656808228738,MATH 109,A02,083214,Ganzberger; Geoffrey Michael,2,0,34,32
1656808228738,MATH 109,A03,093478,Ganzberger; Geoffrey Michael,1,0,34,33
1656808228738,MATH 109,B01,083215,Ganzberger; Geoffrey Michael,1,0,32,31
1656808228738,MATH 109,B02,083216,Ganzberger; Geoffrey Michael,1,0,32,31
1656808228738,MATH 109,B03,093479,Ganzberger; Geoffrey Michael,6,0,32,26
1656808234766,MATH 142A,A01,083219,Chow; Bennett,6,0,32,26
1656808234766,MATH 142A,A02,083220,Chow; Bennett,9,0,32,23
1656808234766,MATH 142A,A03,093480,Chow; Bennett,7,0,32,25
1656808234766,MATH 142A,B03,093481,Chow; Bennett,7,0,32,25
1656808234766,MATH 142A,B04,093558,Chow; Bennett,10,0,32,22
1656808234766,MATH 142A,B05,093559,Chow; Bennett,6,0,32,26
1656808240791,MATH 193A,A01,083224,Rotar; Vladimir,6,0,34,28
1656808240791,MATH 193A,A02,083225,Rotar; Vladimir,3,0,34,31
1656808240791,MATH 193A,A03,083781,Rotar; Vladimir,1,0,34,33
1656808240791,MATH 193A,A04,083782,Rotar; Vladimir,6,0,34,28
1656808240791,MATH 193A,A05,093482,Rotar; Vladimir,6,0,34,28
1656808246817,MATH 197,001,091859,McAuley; Julian John,9999,0,9999,0
1656808246817,MATH 197,002,095566,Kedlaya; Kiran S.,9997,0,9999,2
1656808246817,MATH 197,003,095567,Xiao; Ming,9999,0,9999,0
1656808246817,MATH 197,004,095571,Perols; Johan Lars,9998,0,9999,1
1656808253882,COGS 9,A01,083615,Shannon; Kyle Michael,6,0,75,69
1656808259906,COGS 11,A01,083617,Boyle; Mary E. T.,18,0,48,30
1656808265928,COGS 13,A01,083071,Bastos; Amalia Pinkusfeld,8,0,71,63
1656808271952,COGS 14A,A01,092681,Semenuks; Arturs,0,1,100,100
1656808277976,COGS 14B,A01,083073,Cheng; Tzu-Han,5,0,63,58
1656808284007,COGS 17,A01,092677,Semenuks; Arturs,4,0,81,77
1656808290033,COGS 100,A01,083619,Allen; Michael Gordon,15,0,70,55
1656808296061,COGS 101A,A01,083621,Davis; Joshua Daniel,9,0,68,59
1656808302089,COGS 101B,A01,091572,Allen; Michael Gordon,8,0,65,57
1656808308113,COGS 101C,A01,083625,Delgado; Tania,17,0,35,18
1656808314213,COGS 107A,A01,083627,Boyle; Mary E. T.,13,0,60,47
1656808320241,COGS 118A,A01,083075,Gupta; Anjum,15,0,76,61
1656808326298,CSE 3,A50,083646,Miranda; Gregory Joseph,22,0,50,28
1656808332336,CSE 8A,A50,083650,Miranda; Gregory Joseph,17,1,56,39
1656808338369,CSE 11,A01,083080,Cao; Yingjun,4,15,40,36
1656808344395,CSE 12,A01,083652,Krause-Levy; Sophia Louisa,20,1,120,100
1656808350418,CSE 15L,A01,083654,Morris; Justin Loren,8,0,50,42
1656808350418,CSE 15L,A02,083655,Morris; Justin Loren,8,0,50,42
1656808356442,CSE 20,A01,083657,Tran; Khoa Dang,37,0,80,43
1656808362465,CSE 21,A01,095574,Bach; Quang Tran,21,0,48,27
1656808368489,CSE 30,A01,083084,Eldon; John,4,0,80,76
1656808368489,CSE 30,B01,095061,Bhaskar; Nishant,5,0,50,45
1656808374516,CSE 100,A01,083659,Cao; Yingjun,1,4,70,69
1656808380540,CSE 134B,A01,083661,Powell; Thomas Allan,18,0,100,82
1656808386566,CSE 140,A01,083663,Gungor; Onat,14,0,85,71
1656808392592,CSE 140L,A01,083088,Eldon; John,16,0,100,84
1656808398619,CSE 175,A01,083665,Kumar; Rakesh,3,0,25,22
1656808404644,CSE 190,A00,092507,Dubnov; Shlomo,7,0,20,13
1656808410669,ECE 45,A01,083139,Congero; Spencer William,5,0,75,70
1656808416694,ECE 65,A50,083695,Saad; Andrew S,12,0,30,18
1656808416694,ECE 65,A51,095125,Saad; Andrew S,25,0,26,1
1656808422720,ECE 109,A01,091882,Touri; Behrouz,15,0,70,55
1656808428747,ECE 180,A00,083140,Abi Samra; Nicholas Camill,0,0,30,30
1656808428747,ECE 180,B00,083141,Abi Samra; Nicholas Camill,0,0,30,30
1656808434786,MATH 10A,A01,083735,Patchell; Gregory David,1,0,30,29
1656808434786,MATH 10A,A02,083736,Patchell; Gregory David,20,0,30,10
1656808434786,MATH 10A,A03,083737,Patchell; Gregory David,15,0,30,15
1656808440815,MATH 10B,A01,083207,Lim; Seonhee,7,0,34,27
1656808440815,MATH 10B,A02,083208,Lim; Seonhee,9,0,35,26
1656808440815,MATH 10B,A03,093472,Lim; Seonhee,4,0,34,30
1656808440815,MATH 10B,B01,083739,Sinha; Shubham,9,0,30,21
1656808446840,MATH 18,A01,083743,Cinel; Cameron Alexander,6,0,30,24
1656808446840,MATH 18,A02,083744,Cinel; Cameron Alexander,15,0,30,15
1656808446840,MATH 18,A03,083745,Cinel; Cameron Alexander,8,0,30,22
1656808446840,MATH 18,B01,083748,Rideout; David Porter,3,0,37,34
1656808446840,MATH 18,B02,083749,Rideout; David Porter,3,0,36,33
1656808446840,MATH 18,B03,083750,Rideout; David Porter,1,0,37,36
1656808446840,MATH 18,B04,083751,Rideout; David Porter,5,0,36,31
1656808446840,MATH 18,B05,093473,Rideout; David Porter,4,0,36,32
1656808446840,MATH 18,B06,093474,Rideout; David Porter,5,0,36,31
1656808452866,MATH 20A,A01,083754,Zheng; Zequn,12,0,40,28
1656808458890,MATH 20B,A01,083756,Briones; Jor-el Thomas Caparas,1,0,36,35
1656808458890,MATH 20B,A02,083757,Briones; Jor-el Thomas Caparas,1,0,36,35
1656808458890,MATH 20B,A03,093475,Briones; Jor-el Thomas Caparas,0,0,36,36
1656808464914,MATH 20C,A01,083760,Briones; Jor-el Thomas Caparas,1,0,35,34
1656808464914,MATH 20C,A02,083761,Briones; Jor-el Thomas Caparas,8,0,35,27
1656808464914,MATH 20C,A03,093476,Briones; Jor-el Thomas Caparas,0,1,36,36
1656808464914,MATH 20C,B01,083762,Bach; Quang Tran,0,0,30,30
1656808470943,MATH 20D,A01,083765,Tran; Brian Kha,4,0,30,26
1656808470943,MATH 20D,A02,083766,Tran; Brian Kha,4,0,30,26
1656808470943,MATH 20D,A03,083767,Tran; Brian Kha,2,0,30,28
1656808476972,MATH 20E,A01,083771,Ganguly; Soumya,5,0,32,27
1656808476972,MATH 20E,A02,083772,Ganguly; Soumya,5,0,32,27
1656808476972,MATH 20E,B01,083773,Ciotti; Benjamin,18,0,35,17
1656808476972,MATH 20E,B02,083774,Ciotti; Benjamin,17,0,35,18
1656808483004,MATH 103A,A01,083777,Greenfeld; Be'Eri,2,0,36,34
1656808483004,MATH 103A,A02,083778,Greenfeld; Be'Eri,5,0,36,31
1656808483004,MATH 103A,A03,093561,Greenfeld; Be'Eri,4,0,36,32
1656808483004,MATH 103A,B01,083779,Greenfeld; Be'Eri,6,0,36,30
1656808483004,MATH 103A,B02,083780,Greenfeld; Be'Eri,2,0,36,34
1656808483004,MATH 103A,B03,093562,Greenfeld; Be'Eri,2,0,36,34
1656808489030,MATH 105,A01,085443,Carter; Anne Toulson,13,0,35,22
1656808489030,MATH 105,A02,093477,Carter; Anne Toulson,20,0,35,15
1656808495053,MATH 109,A01,083213,Ganzberger; Geoffrey Michael,2,0,34,32
1656808495053,MATH 109,A02,083214,Ganzberger; Geoffrey Michael,2,0,34,32
1656808495053,MATH 109,A03,093478,Ganzberger; Geoffrey Michael,1,0,34,33
1656808495053,MATH 109,B01,083215,Ganzberger; Geoffrey Michael,1,0,32,31
1656808495053,MATH 109,B02,083216,Ganzberger; Geoffrey Michael,1,0,32,31
1656808495053,MATH 109,B03,093479,Ganzberger; Geoffrey Michael,6,0,32,26
1656808501078,MATH 142A,A01,083219,Chow; Bennett,6,0,32,26
1656808501078,MATH 142A,A02,083220,Chow; Bennett,9,0,32,23
1656808501078,MATH 142A,A03,093480,Chow; Bennett,7,0,32,25
1656808501078,MATH 142A,B03,093481,Chow; Bennett,7,0,32,25
1656808501078,MATH 142A,B04,093558,Chow; Bennett,10,0,32,22
1656808501078,MATH 142A,B05,093559,Chow; Bennett,6,0,32,26
1656808507107,MATH 193A,A01,083224,Rotar; Vladimir,6,0,34,28
1656808507107,MATH 193A,A02,083225,Rotar; Vladimir,3,0,34,31
1656808507107,MATH 193A,A03,083781,Rotar; Vladimir,1,0,34,33
1656808507107,MATH 193A,A04,083782,Rotar; Vladimir,6,0,34,28
1656808507107,MATH 193A,A05,093482,Rotar; Vladimir,6,0,34,28
1656808513128,MATH 197,001,091859,McAuley; Julian John,9999,0,9999,0
1656808513128,MATH 197,002,095566,Kedlaya; Kiran S.,9997,0,9999,2
1656808513128,MATH 197,003,095567,Xiao; Ming,9999,0,9999,0
1656808513128,MATH 197,004,095571,Perols; Johan Lars,9998,0,9999,1
1656808520181,COGS 9,A01,083615,Shannon; Kyle Michael,6,0,75,69
1656808526208,COGS 11,A01,083617,Boyle; Mary E. T.,18,0,48,30
1656808532236,COGS 13,A01,083071,Bastos; Amalia Pinkusfeld,8,0,71,63
1656808538259,COGS 14A,A01,092681,Semenuks; Arturs,0,1,100,100
1656808544290,COGS 14B,A01,083073,Cheng; Tzu-Han,5,0,63,58
1656808550316,COGS 17,A01,092677,Semenuks; Arturs,4,0,81,77
1656808556339,COGS 100,A01,083619,Allen; Michael Gordon,15,0,70,55
1656808562368,COGS 101A,A01,083621,Davis; Joshua Daniel,9,0,68,59
1656808568392,COGS 101B,A01,091572,Allen; Michael Gordon,8,0,65,57
1656808574420,COGS 101C,A01,083625,Delgado; Tania,17,0,35,18
1656808580444,COGS 107A,A01,083627,Boyle; Mary E. T.,13,0,60,47
1656808586468,COGS 118A,A01,083075,Gupta; Anjum,15,0,76,61
1656808592496,CSE 3,A50,083646,Miranda; Gregory Joseph,22,0,50,28
1656808598523,CSE 8A,A50,083650,Miranda; Gregory Joseph,17,1,56,39
1656808604546,CSE 11,A01,083080,Cao; Yingjun,4,15,40,36
1656808610570,CSE 12,A01,083652,Krause-Levy; Sophia Louisa,20,1,120,100
1656808616597,CSE 15L,A01,083654,Morris; Justin Loren,8,0,50,42
1656808616597,CSE 15L,A02,083655,Morris; Justin Loren,8,0,50,42
1656808622627,CSE 20,A01,083657,Tran; Khoa Dang,37,0,80,43
1656808628650,CSE 21,A01,095574,Bach; Quang Tran,21,0,48,27
1656808634682,CSE 30,A01,083084,Eldon; John,4,0,80,76
1656808634682,CSE 30,B01,095061,Bhaskar; Nishant,5,0,50,45
1656808640709,CSE 100,A01,083659,Cao; Yingjun,1,4,70,69
1656808646734,CSE 134B,A01,083661,Powell; Thomas Allan,18,0,100,82
1656808652757,CSE 140,A01,083663,Gungor; Onat,14,0,85,71
1656808658781,CSE 140L,A01,083088,Eldon; John,16,0,100,84
1656808664811,CSE 175,A01,083665,Kumar; Rakesh,3,0,25,22
1656808670844,CSE 190,A00,092507,Dubnov; Shlomo,7,0,20,13
1656808676868,ECE 45,A01,083139,Congero; Spencer William,5,0,75,70
1656808682891,ECE 65,A50,083695,Saad; Andrew S,12,0,30,18
1656808682891,ECE 65,A51,095125,Saad; Andrew S,25,0,26,1
1656808688914,ECE 109,A01,091882,Touri; Behrouz,15,0,70,55
1656808694942,ECE 180,A00,083140,Abi Samra; Nicholas Camill,0,0,30,30
1656808694942,ECE 180,B00,083141,Abi Samra; Nicholas Camill,0,0,30,30
1656808700965,MATH 10A,A01,083735,Patchell; Gregory David,1,0,30,29
1656808700965,MATH 10A,A02,083736,Patchell; Gregory David,20,0,30,10
1656808700965,MATH 10A,A03,083737,Patchell; Gregory David,15,0,30,15
1656808706993,MATH 10B,A01,083207,Lim; Seonhee,7,0,34,27
1656808706993,MATH 10B,A02,083208,Lim; Seonhee,9,0,35,26
1656808706993,MATH 10B,A03,093472,Lim; Seonhee,4,0,34,30
1656808706993,MATH 10B,B01,083739,Sinha; Shubham,9,0,30,21
1656808713019,MATH 18,A01,083743,Cinel; Cameron Alexander,6,0,30,24
1656808713019,MATH 18,A02,083744,Cinel; Cameron Alexander,15,0,30,15
1656808713019,MATH 18,A03,083745,Cinel; Cameron Alexander,8,0,30,22
1656808713019,MATH 18,B01,083748,Rideout; David Porter,3,0,37,34
1656808713019,MATH 18,B02,083749,Rideout; David Porter,3,0,36,33
1656808713019,MATH 18,B03,083750,Rideout; David Porter,1,0,37,36
1656808713019,MATH 18,B04,083751,Rideout; David Porter,5,0,36,31
1656808713019,MATH 18,B05,093473,Rideout; David Porter,4,0,36,32
1656808713019,MATH 18,B06,093474,Rideout; David Porter,5,0,36,31
1656808719041,MATH 20A,A01,083754,Zheng; Zequn,12,0,40,28
1656808725068,MATH 20B,A01,083756,Briones; Jor-el Thomas Caparas,1,0,36,35
1656808725068,MATH 20B,A02,083757,Briones; Jor-el Thomas Caparas,1,0,36,35
1656808725068,MATH 20B,A03,093475,Briones; Jor-el Thomas Caparas,0,0,36,36
1656808731092,MATH 20C,A01,083760,Briones; Jor-el Thomas Caparas,1,0,35,34
1656808731092,MATH 20C,A02,083761,Briones; Jor-el Thomas Caparas,8,0,35,27
1656808731092,MATH 20C,A03,093476,Briones; Jor-el Thomas Caparas,0,1,36,36
1656808731092,MATH 20C,B01,083762,Bach; Quang Tran,0,0,30,30
1656808737115,MATH 20D,A01,083765,Tran; Brian Kha,4,0,30,26
1656808737115,MATH 20D,A02,083766,Tran; Brian Kha,4,0,30,26
1656808737115,MATH 20D,A03,083767,Tran; Brian Kha,2,0,30,28
1656808743140,MATH 20E,A01,083771,Ganguly; Soumya,5,0,32,27
1656808743140,MATH 20E,A02,083772,Ganguly; Soumya,5,0,32,27
1656808743140,MATH 20E,B01,083773,Ciotti; Benjamin,18,0,35,17
1656808743140,MATH 20E,B02,083774,Ciotti; Benjamin,17,0,35,18
1656808749169,MATH 103A,A01,083777,Greenfeld; Be'Eri,2,0,36,34
1656808749169,MATH 103A,A02,083778,Greenfeld; Be'Eri,5,0,36,31
1656808749169,MATH 103A,A03,093561,Greenfeld; Be'Eri,4,0,36,32
1656808749169,MATH 103A,B01,083779,Greenfeld; Be'Eri,6,0,36,30
1656808749169,MATH 103A,B02,083780,Greenfeld; Be'Eri,2,0,36,34
1656808749169,MATH 103A,B03,093562,Greenfeld; Be'Eri,2,0,36,34
1656808755192,MATH 105,A01,085443,Carter; Anne Toulson,13,0,35,22
1656808755192,MATH 105,A02,093477,Carter; Anne Toulson,20,0,35,15
1656808761222,MATH 109,A01,083213,Ganzberger; Geoffrey Michael,2,0,34,32
1656808761222,MATH 109,A02,083214,Ganzberger; Geoffrey Michael,2,0,34,32
1656808761222,MATH 109,A03,093478,Ganzberger; Geoffrey Michael,1,0,34,33
1656808761222,MATH 109,B01,083215,Ganzberger; Geoffrey Michael,1,0,32,31
1656808761222,MATH 109,B02,083216,Ganzberger; Geoffrey Michael,1,0,32,31
1656808761222,MATH 109,B03,093479,Ganzberger; Geoffrey Michael,6,0,32,26
1656808767246,MATH 142A,A01,083219,Chow; Bennett,6,0,32,26
1656808767246,MATH 142A,A02,083220,Chow; Bennett,9,0,32,23
1656808767246,MATH 142A,A03,093480,Chow; Bennett,7,0,32,25
1656808767246,MATH 142A,B03,093481,Chow; Bennett,7,0,32,25
1656808767246,MATH 142A,B04,093558,Chow; Bennett,10,0,32,22
1656808767246,MATH 142A,B05,093559,Chow; Bennett,6,0,32,26
1656808773275,MATH 193A,A01,083224,Rotar; Vladimir,6,0,34,28
1656808773275,MATH 193A,A02,083225,Rotar; Vladimir,3,0,34,31
1656808773275,MATH 193A,A03,083781,Rotar; Vladimir,1,0,34,33
1656808773275,MATH 193A,A04,083782,Rotar; Vladimir,6,0,34,28
1656808773275,MATH 193A,A05,093482,Rotar; Vladimir,6,0,34,28
1656808779300,MATH 197,001,091859,McAuley; Julian John,9999,0,9999,0
1656808779300,MATH 197,002,095566,Kedlaya; Kiran S.,9997,0,9999,2
1656808779300,MATH 197,003,095567,Xiao; Ming,9999,0,9999,0
1656808779300,MATH 197,004,095571,Perols; Johan Lars,9998,0,9999,1
1656808786360,COGS 9,A01,083615,Shannon; Kyle Michael,6,0,75,69
1656808792387,COGS 11,A01,083617,Boyle; Mary E. T.,18,0,48,30
1656808798410,COGS 13,A01,083071,Bastos; Amalia Pinkusfeld,8,0,71,63
1656808804435,COGS 14A,A01,092681,Semenuks; Arturs,0,1,100,100
1656808810458,COGS 14B,A01,083073,Cheng; Tzu-Han,5,0,63,58
1656808816484,COGS 17,A01,092677,Semenuks; Arturs,4,0,81,77
1656808822507,COGS 100,A01,083619,Allen; Michael Gordon,15,0,70,55
1656808828535,COGS 101A,A01,083621,Davis; Joshua Daniel,9,0,68,59
1656808834559,COGS 101B,A01,091572,Allen; Michael Gordon,8,0,65,57
1656808840588,COGS 101C,A01,083625,Delgado; Tania,17,0,35,18
1656808846611,COGS 107A,A01,083627,Boyle; Mary E. T.,13,0,60,47
1656808852635,COGS 118A,A01,083075,Gupta; Anjum,15,0,76,61
1656808858658,CSE 3,A50,083646,Miranda; Gregory Joseph,22,0,50,28
1656808864679,CSE 8A,A50,083650,Miranda; Gregory Joseph,17,1,56,39
1656808870702,CSE 11,A01,083080,Cao; Yingjun,4,15,40,36
1656808876727,CSE 12,A01,083652,Krause-Levy; Sophia Louisa,20,1,120,100
1656808882753,CSE 15L,A01,083654,Morris; Justin Loren,8,0,50,42
1656808882753,CSE 15L,A02,083655,Morris; Justin Loren,8,0,50,42
1656808888777,CSE 20,A01,083657,Tran; Khoa Dang,37,0,80,43
1656808894799,CSE 21,A01,095574,Bach; Quang Tran,21,0,48,27
1656808900821,CSE 30,A01,083084,Eldon; John,4,0,80,76
1656808900821,CSE 30,B01,095061,Bhaskar; Nishant,5,0,50,45
1656808906844,CSE 100,A01,083659,Cao; Yingjun,1,4,70,69
1656808912960,CSE 134B,A01,083661,Powell; Thomas Allan,18,0,100,82
1656808918988,CSE 140,A01,083663,Gungor; Onat,14,0,85,71
1656808925016,CSE 140L,A01,083088,Eldon; John,16,0,100,84
1656808931039,CSE 175,A01,083665,Kumar; Rakesh,3,0,25,22
1656808937063,CSE 190,A00,092507,Dubnov; Shlomo,7,0,20,13
1656808943091,ECE 45,A01,083139,Congero; Spencer William,5,0,75,70
1656808949125,ECE 65,A50,083695,Saad; Andrew S,12,0,30,18
1656808949125,ECE 65,A51,095125,Saad; Andrew S,25,0,26,1
1656808955150,ECE 109,A01,091882,Touri; Behrouz,15,0,70,55
1656808961173,ECE 180,A00,083140,Abi Samra; Nicholas Camill,0,0,30,30
1656808961173,ECE 180,B00,083141,Abi Samra; Nicholas Camill,0,0,30,30
1656808967197,MATH 10A,A01,083735,Patchell; Gregory David,1,0,30,29
1656808967197,MATH 10A,A02,083736,Patchell; Gregory David,20,0,30,10
1656808967197,MATH 10A,A03,083737,Patchell; Gregory David,15,0,30,15
1656808973220,MATH 10B,A01,083207,Lim; Seonhee,7,0,34,27
1656808973220,MATH 10B,A02,083208,Lim; Seonhee,9,0,35,26
1656808973220,MATH 10B,A03,093472,Lim; Seonhee,4,0,34,30
1656808973220,MATH 10B,B01,083739,Sinha; Shubham,9,0,30,21
1656808979245,MATH 18,A01,083743,Cinel; Cameron Alexander,6,0,30,24
1656808979245,MATH 18,A02,083744,Cinel; Cameron Alexander,15,0,30,15
1656808979245,MATH 18,A03,083745,Cinel; Cameron Alexander,8,0,30,22
1656808979245,MATH 18,B01,083748,Rideout; David Porter,3,0,37,34
1656808979245,MATH 18,B02,083749,Rideout; David Porter,3,0,36,33
1656808979245,MATH 18,B03,083750,Rideout; David Porter,1,0,37,36
1656808979245,MATH 18,B04,083751,Rideout; David Porter,5,0,36,31
1656808979245,MATH 18,B05,093473,Rideout; David Porter,4,0,36,32
1656808979245,MATH 18,B06,093474,Rideout; David Porter,5,0,36,31
1656808985267,MATH 20A,A01,083754,Zheng; Zequn,12,0,40,28
1656808991290,MATH 20B,A01,083756,Briones; Jor-el Thomas Caparas,1,0,36,35
1656808991290,MATH 20B,A02,083757,Briones; Jor-el Thomas Caparas,1,0,36,35
1656808991290,MATH 20B,A03,093475,Briones; Jor-el Thomas Caparas,0,0,36,36
1656808997312,MATH 20C,A01,083760,Briones; Jor-el Thomas Caparas,1,0,35,34
1656808997312,MATH 20C,A02,083761,Briones; Jor-el Thomas Caparas,8,0,35,27
1656808997312,MATH 20C,A03,093476,Briones; Jor-el Thomas Caparas,0,1,36,36
1656808997312,MATH 20C,B01,083762,Bach; Quang Tran,0,0,30,30
1656809003336,MATH 20D,A01,083765,Tran; Brian Kha,4,0,30,26
1656809003336,MATH 20D,A02,083766,Tran; Brian Kha,4,0,30,26
1656809003336,MATH 20D,A03,083767,Tran; Brian Kha,2,0,30,28
1656809009363,MATH 20E,A01,083771,Ganguly; Soumya,5,0,32,27
1656809009363,MATH 20E,A02,083772,Ganguly; Soumya,5,0,32,27
1656809009363,MATH 20E,B01,083773,Ciotti; Benjamin,18,0,35,17
1656809009363,MATH 20E,B02,083774,Ciotti; Benjamin,17,0,35,18
1656809015386,MATH 103A,A01,083777,Greenfeld; Be'Eri,2,0,36,34
1656809015386,MATH 103A,A02,083778,Greenfeld; Be'Eri,5,0,36,31
1656809015386,MATH 103A,A03,093561,Greenfeld; Be'Eri,4,0,36,32
1656809015386,MATH 103A,B01,083779,Greenfeld; Be'Eri,6,0,36,30
1656809015386,MATH 103A,B02,083780,Greenfeld; Be'Eri,2,0,36,34
1656809015386,MATH 103A,B03,093562,Greenfeld; Be'Eri,2,0,36,34
1656809021409,MATH 105,A01,085443,Carter; Anne Toulson,13,0,35,22
1656809021409,MATH 105,A02,093477,Carter; Anne Toulson,20,0,35,15
1656809027433,MATH 109,A01,083213,Ganzberger; Geoffrey Michael,2,0,34,32
1656809027433,MATH 109,A02,083214,Ganzberger; Geoffrey Michael,2,0,34,32
1656809027433,MATH 109,A03,093478,Ganzberger; Geoffrey Michael,1,0,34,33
1656809027433,MATH 109,B01,083215,Ganzberger; Geoffrey Michael,1,0,32,31
1656809027433,MATH 109,B02,083216,Ganzberger; Geoffrey Michael,1,0,32,31
1656809027433,MATH 109,B03,093479,Ganzberger; Geoffrey Michael,6,0,32,26
1656809033458,MATH 142A,A01,083219,Chow; Bennett,6,0,32,26
1656809033458,MATH 142A,A02,083220,Chow; Bennett,9,0,32,23
1656809033458,MATH 142A,A03,093480,Chow; Bennett,7,0,32,25
1656809033458,MATH 142A,B03,093481,Chow; Bennett,7,0,32,25
1656809033458,MATH 142A,B04,093558,Chow; Bennett,10,0,32,22
1656809033458,MATH 142A,B05,093559,Chow; Bennett,6,0,32,26
1656809039480,MATH 193A,A01,083224,Rotar; Vladimir,6,0,34,28
1656809039480,MATH 193A,A02,083225,Rotar; Vladimir,3,0,34,31
1656809039480,MATH 193A,A03,083781,Rotar; Vladimir,1,0,34,33
1656809039480,MATH 193A,A04,083782,Rotar; Vladimir,6,0,34,28
1656809039480,MATH 193A,A05,093482,Rotar; Vladimir,6,0,34,28
1656809045507,MATH 197,001,091859,McAuley; Julian John,9999,0,9999,0
1656809045507,MATH 197,002,095566,Kedlaya; Kiran S.,9997,0,9999,2
1656809045507,MATH 197,003,095567,Xiao; Ming,9999,0,9999,0
1656809045507,MATH 197,004,095571,Perols; Johan Lars,9998,0,9999,1
1656809052561,COGS 9,A01,083615,Shannon; Kyle Michael,6,0,75,69
1656809058584,COGS 11,A01,083617,Boyle; Mary E. T.,18,0,48,30
1656809064611,COGS 13,A01,083071,Bastos; Amalia Pinkusfeld,8,0,71,63
1656809070643,COGS 14A,A01,092681,Semenuks; Arturs,0,1,100,100
1656809076667,COGS 14B,A01,083073,Cheng; Tzu-Han,5,0,63,58
1656809082690,COGS 17,A01,092677,Semenuks; Arturs,4,0,81,77
1656809088720,COGS 100,A01,083619,Allen; Michael Gordon,15,0,70,55
1656809094747,COGS 101A,A01,083621,Davis; Joshua Daniel,9,0,68,59
1656809100771,COGS 101B,A01,091572,Allen; Michael Gordon,8,0,65,57
1656809106797,COGS 101C,A01,083625,Delgado; Tania,17,0,35,18
1656809112823,COGS 107A,A01,083627,Boyle; Mary E. T.,13,0,60,47
1656809118846,COGS 118A,A01,083075,Gupta; Anjum,15,0,76,61
1656809124873,CSE 3,A50,083646,Miranda; Gregory Joseph,22,0,50,28
1656809130903,CSE 8A,A50,083650,Miranda; Gregory Joseph,17,1,56,39
1656809136940,CSE 11,A01,083080,Cao; Yingjun,4,15,40,36
1656809142967,CSE 12,A01,083652,Krause-Levy; Sophia Louisa,20,1,120,100
1656809148993,CSE 15L,A01,083654,Morris; Justin Loren,8,0,50,42
1656809148993,CSE 15L,A02,083655,Morris; Justin Loren,8,0,50,42
1656809155030,CSE 20,A01,083657,Tran; Khoa Dang,37,0,80,43
1656809161056,CSE 21,A01,095574,Bach; Quang Tran,21,0,48,27
1656809167078,CSE 30,A01,083084,Eldon; John,4,0,80,76
1656809167078,CSE 30,B01,095061,Bhaskar; Nishant,5,0,50,45
1656809173102,CSE 100,A01,083659,Cao; Yingjun,1,4,70,69
1656809179124,CSE 134B,A01,083661,Powell; Thomas Allan,18,0,100,82
1656809185147,CSE 140,A01,083663,Gungor; Onat,14,0,85,71
1656809191173,CSE 140L,A01,083088,Eldon; John,16,0,100,84
1656809197205,CSE 175,A01,083665,Kumar; Rakesh,3,0,25,22
1656809203233,CSE 190,A00,092507,Dubnov; Shlomo,7,0,20,13
1656809209256,ECE 45,A01,083139,Congero; Spencer William,5,0,75,70
1656809215285,ECE 65,A50,083695,Saad; Andrew S,12,0,30,18
1656809215285,ECE 65,A51,095125,Saad; Andrew S,25,0,26,1
1656809221312,ECE 109,A01,091882,Touri; Behrouz,15,0,70,55
1656809227334,ECE 180,A00,083140,Abi Samra; Nicholas Camill,0,0,30,30
1656809227334,ECE 180,B00,083141,Abi Samra; Nicholas Camill,0,0,30,30
1656809233357,MATH 10A,A01,083735,Patchell; Gregory David,1,0,30,29
1656809233357,MATH 10A,A02,083736,Patchell; Gregory David,20,0,30,10
1656809233357,MATH 10A,A03,083737,Patchell; Gregory David,15,0,30,15
1656809239381,MATH 10B,A01,083207,Lim; Seonhee,7,0,34,27
1656809239381,MATH 10B,A02,083208,Lim; Seonhee,9,0,35,26
1656809239381,MATH 10B,A03,093472,Lim; Seonhee,4,0,34,30
1656809239381,MATH 10B,B01,083739,Sinha; Shubham,9,0,30,21
1656809245417,MATH 18,A01,083743,Cinel; Cameron Alexander,6,0,30,24
1656809245417,MATH 18,A02,083744,Cinel; Cameron Alexander,15,0,30,15
1656809245417,MATH 18,A03,083745,Cinel; Cameron Alexander,8,0,30,22
1656809245417,MATH 18,B01,083748,Rideout; David Porter,3,0,37,34
1656809245417,MATH 18,B02,083749,Rideout; David Porter,3,0,36,33
1656809245417,MATH 18,B03,083750,Rideout; David Porter,1,0,37,36
1656809245417,MATH 18,B04,083751,Rideout; David Porter,5,0,36,31
1656809245417,MATH 18,B05,093473,Rideout; David Porter,4,0,36,32
1656809245417,MATH 18,B06,093474,Rideout; David Porter,5,0,36,31
1656809251446,MATH 20A,A01,083754,Zheng; Zequn,12,0,40,28
1656809257472,MATH 20B,A01,083756,Briones; Jor-el Thomas Caparas,1,0,36,35
1656809257472,MATH 20B,A02,083757,Briones; Jor-el Thomas Caparas,1,0,36,35
1656809257472,MATH 20B,A03,093475,Briones; Jor-el Thomas Caparas,0,0,36,36
1656809263496,MATH 20C,A01,083760,Briones; Jor-el Thomas Caparas,1,0,35,34
1656809263496,MATH 20C,A02,083761,Briones; Jor-el Thomas Caparas,8,0,35,27
1656809263496,MATH 20C,A03,093476,Briones; Jor-el Thomas Caparas,0,1,36,36
1656809263496,MATH 20C,B01,083762,Bach; Quang Tran,0,0,30,30
1656809269524,MATH 20D,A01,083765,Tran; Brian Kha,4,0,30,26
1656809269524,MATH 20D,A02,083766,Tran; Brian Kha,4,0,30,26
1656809269524,MATH 20D,A03,083767,Tran; Brian Kha,2,0,30,28
1656809275553,MATH 20E,A01,083771,Ganguly; Soumya,5,0,32,27
1656809275553,MATH 20E,A02,083772,Ganguly; Soumya,5,0,32,27
1656809275553,MATH 20E,B01,083773,Ciotti; Benjamin,18,0,35,17
1656809275553,MATH 20E,B02,083774,Ciotti; Benjamin,17,0,35,18
1656809281584,MATH 103A,A01,083777,Greenfeld; Be'Eri,2,0,36,34
1656809281584,MATH 103A,A02,083778,Greenfeld; Be'Eri,5,0,36,31
1656809281584,MATH 103A,A03,093561,Greenfeld; Be'Eri,4,0,36,32
1656809281584,MATH 103A,B01,083779,Greenfeld; Be'Eri,6,0,36,30
1656809281584,MATH 103A,B02,083780,Greenfeld; Be'Eri,2,0,36,34
1656809281584,MATH 103A,B03,093562,Greenfeld; Be'Eri,2,0,36,34
1656809287606,MATH 105,A01,085443,Carter; Anne Toulson,13,0,35,22
1656809287606,MATH 105,A02,093477,Carter; Anne Toulson,20,0,35,15
1656809293631,MATH 109,A01,083213,Ganzberger; Geoffrey Michael,2,0,34,32
1656809293631,MATH 109,A02,083214,Ganzberger; Geoffrey Michael,2,0,34,32
1656809293631,MATH 109,A03,093478,Ganzberger; Geoffrey Michael,1,0,34,33
1656809293631,MATH 109,B01,083215,Ganzberger; Geoffrey Michael,1,0,32,31
1656809293631,MATH 109,B02,083216,Ganzberger; Geoffrey Michael,1,0,32,31
1656809293631,MATH 109,B03,093479,Ganzberger; Geoffrey Michael,6,0,32,26
1656809299655,MATH 142A,A01,083219,Chow; Bennett,6,0,32,26
1656809299655,MATH 142A,A02,083220,Chow; Bennett,9,0,32,23
1656809299655,MATH 142A,A03,093480,Chow; Bennett,7,0,32,25
1656809299655,MATH 142A,B03,093481,Chow; Bennett,7,0,32,25
1656809299655,MATH 142A,B04,093558,Chow; Bennett,10,0,32,22
1656809299655,MATH 142A,B05,093559,Chow; Bennett,6,0,32,26
1656809305683,MATH 193A,A01,083224,Rotar; Vladimir,6,0,34,28
1656809305683,MATH 193A,A02,083225,Rotar; Vladimir,3,0,34,31
1656809305683,MATH 193A,A03,083781,Rotar; Vladimir,1,0,34,33
1656809305683,MATH 193A,A04,083782,Rotar; Vladimir,6,0,34,28
1656809305683,MATH 193A,A05,093482,Rotar; Vladimir,6,0,34,28
1656809311705,MATH 197,001,091859,McAuley; Julian John,9999,0,9999,0
1656809311705,MATH 197,002,095566,Kedlaya; Kiran S.,9997,0,9999,2
1656809311705,MATH 197,003,095567,Xiao; Ming,9999,0,9999,0
1656809311705,MATH 197,004,095571,Perols; Johan Lars,9998,0,9999,1
1656809318767,COGS 9,A01,083615,Shannon; Kyle Michael,6,0,75,69
1656809324793,COGS 11,A01,083617,Boyle; Mary E. T.,18,0,48,30
1656809330816,COGS 13,A01,083071,Bastos; Amalia Pinkusfeld,8,0,71,63
1656809336843,COGS 14A,A01,092681,Semenuks; Arturs,0,1,100,100
1656809342870,COGS 14B,A01,083073,Cheng; Tzu-Han,5,0,63,58
1656809348895,COGS 17,A01,092677,Semenuks; Arturs,4,0,81,77
1656809354919,COGS 100,A01,083619,Allen; Michael Gordon,15,0,70,55
1656809360940,COGS 101A,A01,083621,Davis; Joshua Daniel,9,0,68,59
1656809366976,COGS 101B,A01,091572,Allen; Michael Gordon,8,0,65,57
1656809373013,COGS 101C,A01,083625,Delgado; Tania,17,0,35,18
1656809379043,COGS 107A,A01,083627,Boyle; Mary E. T.,13,0,60,47
1656809385074,COGS 118A,A01,083075,Gupta; Anjum,15,0,76,61
1656809391098,CSE 3,A50,083646,Miranda; Gregory Joseph,22,0,50,28
1656809397122,CSE 8A,A50,083650,Miranda; Gregory Joseph,17,1,56,39
1656809403146,CSE 11,A01,083080,Cao; Yingjun,4,15,40,36
1656809409173,CSE 12,A01,083652,Krause-Levy; Sophia Louisa,20,1,120,100
1656809415197,CSE 15L,A01,083654,Morris; Justin Loren,8,0,50,42
1656809415197,CSE 15L,A02,083655,Morris; Justin Loren,8,0,50,42
1656809421220,CSE 20,A01,083657,Tran; Khoa Dang,37,0,80,43
1656809427243,CSE 21,A01,095574,Bach; Quang Tran,21,0,48,27
1656809433266,CSE 30,A01,083084,Eldon; John,4,0,80,76
1656809433266,CSE 30,B01,095061,Bhaskar; Nishant,5,0,50,45
1656809439293,CSE 100,A01,083659,Cao; Yingjun,1,4,70,69
1656809445321,CSE 134B,A01,083661,Powell; Thomas Allan,18,0,100,82
1656809451359,CSE 140,A01,083663,Gungor; Onat,14,0,85,71
1656809457383,CSE 140L,A01,083088,Eldon; John,16,0,100,84
1656809463417,CSE 175,A01,083665,Kumar; Rakesh,3,0,25,22
1656809469441,CSE 190,A00,092507,Dubnov; Shlomo,7,0,20,13
1656809475469,ECE 45,A01,083139,Congero; Spencer William,5,0,75,70
1656809481493,ECE 65,A50,083695,Saad; Andrew S,12,0,30,18
1656809481493,ECE 65,A51,095125,Saad; Andrew S,25,0,26,1
1656809487521,ECE 109,A01,091882,Touri; Behrouz,15,0,70,55
1656809493544,ECE 180,A00,083140,Abi Samra; Nicholas Camill,0,0,30,30
1656809493544,ECE 180,B00,083141,Abi Samra; Nicholas Camill,0,0,30,30
1656809499567,MATH 10A,A01,083735,Patchell; Gregory David,1,0,30,29
1656809499567,MATH 10A,A02,083736,Patchell; Gregory David,20,0,30,10
1656809499567,MATH 10A,A03,083737,Patchell; Gregory David,15,0,30,15
1656809505590,MATH 10B,A01,083207,Lim; Seonhee,7,0,34,27
1656809505590,MATH 10B,A02,083208,Lim; Seonhee,9,0,35,26
1656809505590,MATH 10B,A03,093472,Lim; Seonhee,4,0,34,30
1656809505590,MATH 10B,B01,083739,Sinha; Shubham,9,0,30,21
1656809511709,MATH 18,A01,083743,Cinel; Cameron Alexander,6,0,30,24
1656809511709,MATH 18,A02,083744,Cinel; Cameron Alexander,15,0,30,15
1656809511709,MATH 18,A03,083745,Cinel; Cameron Alexander,8,0,30,22
1656809511709,MATH 18,B01,083748,Rideout; David Porter,3,0,37,34
1656809511709,MATH 18,B02,083749,Rideout; David Porter,3,0,36,33
1656809511709,MATH 18,B03,083750,Rideout; David Porter,1,0,37,36
1656809511709,MATH 18,B04,083751,Rideout; David Porter,5,0,36,31
1656809511709,MATH 18,B05,093473,Rideout; David Porter,4,0,36,32
1656809511709,MATH 18,B06,093474,Rideout; David Porter,5,0,36,31
1656809517735,MATH 20A,A01,083754,Zheng; Zequn,12,0,40,28
1656809523762,MATH 20B,A01,083756,Briones; Jor-el Thomas Caparas,1,0,36,35
1656809523762,MATH 20B,A02,083757,Briones; Jor-el Thomas Caparas,1,0,36,35
1656809523762,MATH 20B,A03,093475,Briones; Jor-el Thomas Caparas,0,0,36,36
1656809529791,MATH 20C,A01,083760,Briones; Jor-el Thomas Caparas,1,0,35,34
1656809529791,MATH 20C,A02,083761,Briones; Jor-el Thomas Caparas,8,0,35,27
1656809529791,MATH 20C,A03,093476,Briones; Jor-el Thomas Caparas,0,1,36,36
1656809529791,MATH 20C,B01,083762,Bach; Quang Tran,0,0,30,30
1656809535819,MATH 20D,A01,083765,Tran; Brian Kha,4,0,30,26
1656809535819,MATH 20D,A02,083766,Tran; Brian Kha,4,0,30,26
1656809535819,MATH 20D,A03,083767,Tran; Brian Kha,2,0,30,28
1656809541842,MATH 20E,A01,083771,Ganguly; Soumya,5,0,32,27
1656809541842,MATH 20E,A02,083772,Ganguly; Soumya,5,0,32,27
1656809541842,MATH 20E,B01,083773,Ciotti; Benjamin,18,0,35,17
1656809541842,MATH 20E,B02,083774,Ciotti; Benjamin,17,0,35,18
1656809547867,MATH 103A,A01,083777,Greenfeld; Be'Eri,2,0,36,34
1656809547867,MATH 103A,A02,083778,Greenfeld; Be'Eri,5,0,36,31
1656809547867,MATH 103A,A03,093561,Greenfeld; Be'Eri,4,0,36,32
1656809547867,MATH 103A,B01,083779,Greenfeld; Be'Eri,6,0,36,30
1656809547867,MATH 103A,B02,083780,Greenfeld; Be'Eri,2,0,36,34
1656809547867,MATH 103A,B03,093562,Greenfeld; Be'Eri,2,0,36,34
1656809553894,MATH 105,A01,085443,Carter; Anne Toulson,13,0,35,22
1656809553894,MATH 105,A02,093477,Carter; Anne Toulson,20,0,35,15
1656809559922,MATH 109,A01,083213,Ganzberger; Geoffrey Michael,2,0,34,32
1656809559922,MATH 109,A02,083214,Ganzberger; Geoffrey Michael,2,0,34,32
1656809559922,MATH 109,A03,093478,Ganzberger; Geoffrey Michael,1,0,34,33
1656809559922,MATH 109,B01,083215,Ganzberger; Geoffrey Michael,1,0,32,31
1656809559922,MATH 109,B02,083216,Ganzberger; Geoffrey Michael,1,0,32,31
1656809559922,MATH 109,B03,093479,Ganzberger; Geoffrey Michael,6,0,32,26
1656809565958,MATH 142A,A01,083219,Chow; Bennett,6,0,32,26
1656809565958,MATH 142A,A02,083220,Chow; Bennett,9,0,32,23
1656809565958,MATH 142A,A03,093480,Chow; Bennett,7,0,32,25
1656809565958,MATH 142A,B03,093481,Chow; Bennett,7,0,32,25
1656809565958,MATH 142A,B04,093558,Chow; Bennett,10,0,32,22
1656809565958,MATH 142A,B05,093559,Chow; Bennett,6,0,32,26
1656809571985,MATH 193A,A01,083224,Rotar; Vladimir,6,0,34,28
1656809571985,MATH 193A,A02,083225,Rotar; Vladimir,3,0,34,31
1656809571985,MATH 193A,A03,083781,Rotar; Vladimir,1,0,34,33
1656809571985,MATH 193A,A04,083782,Rotar; Vladimir,6,0,34,28
1656809571985,MATH 193A,A05,093482,Rotar; Vladimir,6,0,34,28
1656809578013,MATH 197,001,091859,McAuley; Julian John,9999,0,9999,0
1656809578013,MATH 197,002,095566,Kedlaya; Kiran S.,9997,0,9999,2
1656809578013,MATH 197,003,095567,Xiao; Ming,9999,0,9999,0
1656809578013,MATH 197,004,095571,Perols; Johan Lars,9998,0,9999,1
1656809585064,COGS 9,A01,083615,Shannon; Kyle Michael,6,0,75,69
1656809591093,COGS 11,A01,083617,Boyle; Mary E. T.,18,0,48,30
1656809597118,COGS 13,A01,083071,Bastos; Amalia Pinkusfeld,8,0,71,63
1656809603145,COGS 14A,A01,092681,Semenuks; Arturs,0,1,100,100
1656809609169,COGS 14B,A01,083073,Cheng; Tzu-Han,5,0,63,58
1656809615193,COGS 17,A01,092677,Semenuks; Arturs,4,0,81,77
1656809621221,COGS 100,A01,083619,Allen; Michael Gordon,15,0,70,55
1656809627245,COGS 101A,A01,083621,Davis; Joshua Daniel,9,0,68,59
1656809633272,COGS 101B,A01,091572,Allen; Michael Gordon,8,0,65,57
1656809639295,COGS 101C,A01,083625,Delgado; Tania,17,0,35,18
1656809645322,COGS 107A,A01,083627,Boyle; Mary E. T.,13,0,60,47
1656809651345,COGS 118A,A01,083075,Gupta; Anjum,15,0,76,61
1656809657368,CSE 3,A50,083646,Miranda; Gregory Joseph,22,0,50,28
1656809663390,CSE 8A,A50,083650,Miranda; Gregory Joseph,17,1,56,39
1656809669420,CSE 11,A01,083080,Cao; Yingjun,4,15,40,36
1656809675444,CSE 12,A01,083652,Krause-Levy; Sophia Louisa,20,1,120,100
1656809681467,CSE 15L,A01,083654,Morris; Justin Loren,8,0,50,42
1656809681467,CSE 15L,A02,083655,Morris; Justin Loren,8,0,50,42
1656809687490,CSE 20,A01,083657,Tran; Khoa Dang,37,0,80,43
1656809693519,CSE 21,A01,095574,Bach; Quang Tran,21,0,48,27
1656809699542,CSE 30,A01,083084,Eldon; John,4,0,80,76
1656809699542,CSE 30,B01,095061,Bhaskar; Nishant,5,0,50,45
1656809705564,CSE 100,A01,083659,Cao; Yingjun,1,4,70,69
1656809711592,CSE 134B,A01,083661,Powell; Thomas Allan,18,0,100,82
1656809717619,CSE 140,A01,083663,Gungor; Onat,14,0,85,71
1656809723643,CSE 140L,A01,083088,Eldon; John,16,0,100,84
1656809729667,CSE 175,A01,083665,Kumar; Rakesh,3,0,25,22
1656809735691,CSE 190,A00,092507,Dubnov; Shlomo,7,0,20,13
1656809741717,ECE 45,A01,083139,Congero; Spencer William,5,0,75,70
1656809747752,ECE 65,A50,083695,Saad; Andrew S,12,0,30,18
1656809747752,ECE 65,A51,095125,Saad; Andrew S,25,0,26,1
1656809753779,ECE 109,A01,091882,Touri; Behrouz,15,0,70,55
1656809759806,ECE 180,A00,083140,Abi Samra; Nicholas Camill,0,0,30,30
1656809759806,ECE 180,B00,083141,Abi Samra; Nicholas Camill,0,0,30,30
1656809765834,MATH 10A,A01,083735,Patchell; Gregory David,1,0,30,29
1656809765834,MATH 10A,A02,083736,Patchell; Gregory David,20,0,30,10
1656809765834,MATH 10A,A03,083737,Patchell; Gregory David,15,0,30,15
1656809771859,MATH 10B,A01,083207,Lim; Seonhee,7,0,34,27
1656809771859,MATH 10B,A02,083208,Lim; Seonhee,9,0,35,26
1656809771859,MATH 10B,A03,093472,Lim; Seonhee,4,0,34,30
1656809771859,MATH 10B,B01,083739,Sinha; Shubham,9,0,30,21
1656809777883,MATH 18,A01,083743,Cinel; Cameron Alexander,6,0,30,24
1656809777883,MATH 18,A02,083744,Cinel; Cameron Alexander,15,0,30,15
1656809777883,MATH 18,A03,083745,Cinel; Cameron Alexander,8,0,30,22
1656809777883,MATH 18,B01,083748,Rideout; David Porter,3,0,37,34
1656809777883,MATH 18,B02,083749,Rideout; David Porter,3,0,36,33
1656809777883,MATH 18,B03,083750,Rideout; David Porter,1,0,37,36
1656809777883,MATH 18,B04,083751,Rideout; David Porter,5,0,36,31
1656809777883,MATH 18,B05,093473,Rideout; David Porter,4,0,36,32
1656809777883,MATH 18,B06,093474,Rideout; David Porter,5,0,36,31
1656809783906,MATH 20A,A01,083754,Zheng; Zequn,12,0,40,28
1656809789932,MATH 20B,A01,083756,Briones; Jor-el Thomas Caparas,1,0,36,35
1656809789932,MATH 20B,A02,083757,Briones; Jor-el Thomas Caparas,1,0,36,35
1656809789932,MATH 20B,A03,093475,Briones; Jor-el Thomas Caparas,0,0,36,36
1656809795956,MATH 20C,A01,083760,Briones; Jor-el Thomas Caparas,1,0,35,34
1656809795956,MATH 20C,A02,083761,Briones; Jor-el Thomas Caparas,8,0,35,27
1656809795956,MATH 20C,A03,093476,Briones; Jor-el Thomas Caparas,0,1,36,36
1656809795956,MATH 20C,B01,083762,Bach; Quang Tran,0,0,30,30
1656809801989,MATH 20D,A01,083765,Tran; Brian Kha,4,0,30,26
1656809801989,MATH 20D,A02,083766,Tran; Brian Kha,4,0,30,26
1656809801989,MATH 20D,A03,083767,Tran; Brian Kha,2,0,30,28
1656809808020,MATH 20E,A01,083771,Ganguly; Soumya,5,0,32,27
1656809808020,MATH 20E,A02,083772,Ganguly; Soumya,5,0,32,27
1656809808020,MATH 20E,B01,083773,Ciotti; Benjamin,18,0,35,17
1656809808020,MATH 20E,B02,083774,Ciotti; Benjamin,17,0,35,18
1656809814050,MATH 103A,A01,083777,Greenfeld; Be'Eri,2,0,36,34
1656809814050,MATH 103A,A02,083778,Greenfeld; Be'Eri,5,0,36,31
1656809814050,MATH 103A,A03,093561,Greenfeld; Be'Eri,4,0,36,32
1656809814050,MATH 103A,B01,083779,Greenfeld; Be'Eri,6,0,36,30
1656809814050,MATH 103A,B02,083780,Greenfeld; Be'Eri,2,0,36,34
1656809814050,MATH 103A,B03,093562,Greenfeld; Be'Eri,2,0,36,34
1656809820076,MATH 105,A01,085443,Carter; Anne Toulson,13,0,35,22
1656809820076,MATH 105,A02,093477,Carter; Anne Toulson,20,0,35,15
1656809826098,MATH 109,A01,083213,Ganzberger; Geoffrey Michael,2,0,34,32
1656809826098,MATH 109,A02,083214,Ganzberger; Geoffrey Michael,2,0,34,32
1656809826098,MATH 109,A03,093478,Ganzberger; Geoffrey Michael,1,0,34,33
1656809826098,MATH 109,B01,083215,Ganzberger; Geoffrey Michael,1,0,32,31
1656809826098,MATH 109,B02,083216,Ganzberger; Geoffrey Michael,1,0,32,31
1656809826098,MATH 109,B03,093479,Ganzberger; Geoffrey Michael,6,0,32,26
1656809832121,MATH 142A,A01,083219,Chow; Bennett,6,0,32,26
1656809832121,MATH 142A,A02,083220,Chow; Bennett,9,0,32,23
1656809832121,MATH 142A,A03,093480,Chow; Bennett,7,0,32,25
1656809832121,MATH 142A,B03,093481,Chow; Bennett,7,0,32,25
1656809832121,MATH 142A,B04,093558,Chow; Bennett,10,0,32,22
1656809832121,MATH 142A,B05,093559,Chow; Bennett,6,0,32,26
1656809838149,MATH 193A,A01,083224,Rotar; Vladimir,6,0,34,28
1656809838149,MATH 193A,A02,083225,Rotar; Vladimir,3,0,34,31
1656809838149,MATH 193A,A03,083781,Rotar; Vladimir,1,0,34,33
1656809838149,MATH 193A,A04,083782,Rotar; Vladimir,6,0,34,28
1656809838149,MATH 193A,A05,093482,Rotar; Vladimir,6,0,34,28
1656809844172,MATH 197,001,091859,McAuley; Julian John,9999,0,9999,0
1656809844172,MATH 197,002,095566,Kedlaya; Kiran S.,9997,0,9999,2
1656809844172,MATH 197,003,095567,Xiao; Ming,9999,0,9999,0
1656809844172,MATH 197,004,095571,Perols; Johan Lars,9998,0,9999,1
1656809851221,COGS 9,A01,083615,Shannon; Kyle Michael,6,0,75,69
1656809857247,COGS 11,A01,083617,Boyle; Mary E. T.,18,0,48,30
1656809863270,COGS 13,A01,083071,Bastos; Amalia Pinkusfeld,8,0,71,63
1656809869297,COGS 14A,A01,092681,Semenuks; Arturs,0,1,100,100
1656809875321,COGS 14B,A01,083073,Cheng; Tzu-Han,5,0,63,58
1656809881348,COGS 17,A01,092677,Semenuks; Arturs,4,0,81,77
1656809887375,COGS 100,A01,083619,Allen; Michael Gordon,15,0,70,55
1656809893398,COGS 101A,A01,083621,Davis; Joshua Daniel,9,0,68,59
1656809899423,COGS 101B,A01,091572,Allen; Michael Gordon,8,0,65,57
1656809905445,COGS 101C,A01,083625,Delgado; Tania,17,0,35,18
1656809911470,COGS 107A,A01,083627,Boyle; Mary E. T.,13,0,60,47
1656809917506,COGS 118A,A01,083075,Gupta; Anjum,15,0,76,61
1656809923530,CSE 3,A50,083646,Miranda; Gregory Joseph,22,0,50,28
1656809929553,CSE 8A,A50,083650,Miranda; Gregory Joseph,17,1,56,39
1656809935579,CSE 11,A01,083080,Cao; Yingjun,4,15,40,36
1656809941602,CSE 12,A01,083652,Krause-Levy; Sophia Louisa,20,1,120,100
1656809947624,CSE 15L,A01,083654,Morris; Justin Loren,8,0,50,42
1656809947624,CSE 15L,A02,083655,Morris; Justin Loren,8,0,50,42
1656809953647,CSE 20,A01,083657,Tran; Khoa Dang,37,0,80,43
1656809959687,CSE 21,A01,095574,Bach; Quang Tran,21,0,48,27
1656809965714,CSE 30,A01,083084,Eldon; John,4,0,80,76
1656809965714,CSE 30,B01,095061,Bhaskar; Nishant,5,0,50,45
1656809971736,CSE 100,A01,083659,Cao; Yingjun,1,4,70,69
1656809977761,CSE 134B,A01,083661,Powell; Thomas Allan,18,0,100,82
1656809983783,CSE 140,A01,083663,Gungor; Onat,14,0,85,71
1656809989807,CSE 140L,A01,083088,Eldon; John,16,0,100,84
1656809995832,CSE 175,A01,083665,Kumar; Rakesh,3,0,25,22
1656810001858,CSE 190,A00,092507,Dubnov; Shlomo,7,0,20,13
1656810007881,ECE 45,A01,083139,Congero; Spencer William,5,0,75,70
1656810013910,ECE 65,A50,083695,Saad; Andrew S,12,0,30,18
1656810013910,ECE 65,A51,095125,Saad; Andrew S,25,0,26,1
1656810019932,ECE 109,A01,091882,Touri; Behrouz,15,0,70,55
1656810025958,ECE 180,A00,083140,Abi Samra; Nicholas Camill,0,0,30,30
1656810025958,ECE 180,B00,083141,Abi Samra; Nicholas Camill,0,0,30,30
1656810031981,MATH 10A,A01,083735,Patchell; Gregory David,1,0,30,29
1656810031981,MATH 10A,A02,083736,Patchell; Gregory David,20,0,30,10
1656810031981,MATH 10A,A03,083737,Patchell; Gregory David,15,0,30,15
1656810038020,MATH 10B,A01,083207,Lim; Seonhee,7,0,34,27
1656810038020,MATH 10B,A02,083208,Lim; Seonhee,9,0,35,26
1656810038020,MATH 10B,A03,093472,Lim; Seonhee,4,0,34,30
1656810038020,MATH 10B,B01,083739,Sinha; Shubham,9,0,30,21
1656810044043,MATH 18,A01,083743,Cinel; Cameron Alexander,6,0,30,24
1656810044043,MATH 18,A02,083744,Cinel; Cameron Alexander,15,0,30,15
1656810044043,MATH 18,A03,083745,Cinel; Cameron Alexander,8,0,30,22
1656810044043,MATH 18,B01,083748,Rideout; David Porter,3,0,37,34
1656810044043,MATH 18,B02,083749,Rideout; David Porter,3,0,36,33
1656810044043,MATH 18,B03,083750,Rideout; David Porter,1,0,37,36
1656810044043,MATH 18,B04,083751,Rideout; David Porter,5,0,36,31
1656810044043,MATH 18,B05,093473,Rideout; David Porter,4,0,36,32
1656810044043,MATH 18,B06,093474,Rideout; David Porter,5,0,36,31
1656810050070,MATH 20A,A01,083754,Zheng; Zequn,12,0,40,28
1656810056093,MATH 20B,A01,083756,Briones; Jor-el Thomas Caparas,1,0,36,35
1656810056093,MATH 20B,A02,083757,Briones; Jor-el Thomas Caparas,1,0,36,35
1656810056093,MATH 20B,A03,093475,Briones; Jor-el Thomas Caparas,0,0,36,36
1656810062116,MATH 20C,A01,083760,Briones; Jor-el Thomas Caparas,1,0,35,34
1656810062116,MATH 20C,A02,083761,Briones; Jor-el Thomas Caparas,8,0,35,27
1656810062116,MATH 20C,A03,093476,Briones; Jor-el Thomas Caparas,0,1,36,36
1656810062116,MATH 20C,B01,083762,Bach; Quang Tran,0,0,30,30
1656810068138,MATH 20D,A01,083765,Tran; Brian Kha,4,0,30,26
1656810068138,MATH 20D,A02,083766,Tran; Brian Kha,4,0,30,26
1656810068138,MATH 20D,A03,083767,Tran; Brian Kha,2,0,30,28
1656810074166,MATH 20E,A01,083771,Ganguly; Soumya,5,0,32,27
1656810074166,MATH 20E,A02,083772,Ganguly; Soumya,5,0,32,27
1656810074166,MATH 20E,B01,083773,Ciotti; Benjamin,18,0,35,17
1656810074166,MATH 20E,B02,083774,Ciotti; Benjamin,17,0,35,18
1656810080211,MATH 103A,A01,083777,Greenfeld; Be'Eri,2,0,36,34
1656810080211,MATH 103A,A02,083778,Greenfeld; Be'Eri,5,0,36,31
1656810080211,MATH 103A,A03,093561,Greenfeld; Be'Eri,4,0,36,32
1656810080211,MATH 103A,B01,083779,Greenfeld; Be'Eri,6,0,36,30
1656810080211,MATH 103A,B02,083780,Greenfeld; Be'Eri,2,0,36,34
1656810080211,MATH 103A,B03,093562,Greenfeld; Be'Eri,2,0,36,34
1656810086236,MATH 105,A01,085443,Carter; Anne Toulson,13,0,35,22
1656810086236,MATH 105,A02,093477,Carter; Anne Toulson,20,0,35,15
1656810092263,MATH 109,A01,083213,Ganzberger; Geoffrey Michael,2,0,34,32
1656810092263,MATH 109,A02,083214,Ganzberger; Geoffrey Michael,2,0,34,32
1656810092263,MATH 109,A03,093478,Ganzberger; Geoffrey Michael,1,0,34,33
1656810092263,MATH 109,B01,083215,Ganzberger; Geoffrey Michael,1,0,32,31
1656810092263,MATH 109,B02,083216,Ganzberger; Geoffrey Michael,1,0,32,31
1656810092263,MATH 109,B03,093479,Ganzberger; Geoffrey Michael,6,0,32,26
1656810098302,MATH 142A,A01,083219,Chow; Bennett,6,0,32,26
1656810098302,MATH 142A,A02,083220,Chow; Bennett,9,0,32,23
1656810098302,MATH 142A,A03,093480,Chow; Bennett,7,0,32,25
1656810098302,MATH 142A,B03,093481,Chow; Bennett,7,0,32,25
1656810098302,MATH 142A,B04,093558,Chow; Bennett,10,0,32,22
1656810098302,MATH 142A,B05,093559,Chow; Bennett,6,0,32,26
1656810104323,MATH 193A,A01,083224,Rotar; Vladimir,6,0,34,28
1656810104323,MATH 193A,A02,083225,Rotar; Vladimir,3,0,34,31
1656810104323,MATH 193A,A03,083781,Rotar; Vladimir,1,0,34,33
1656810104323,MATH 193A,A04,083782,Rotar; Vladimir,6,0,34,28
1656810104323,MATH 193A,A05,093482,Rotar; Vladimir,6,0,34,28
1656810110438,MATH 197,001,091859,McAuley; Julian John,9999,0,9999,0
1656810110438,MATH 197,002,095566,Kedlaya; Kiran S.,9997,0,9999,2
1656810110438,MATH 197,003,095567,Xiao; Ming,9999,0,9999,0
1656810110438,MATH 197,004,095571,Perols; Johan Lars,9998,0,9999,1
1656810117494,COGS 9,A01,083615,Shannon; Kyle Michael,6,0,75,69
1656810123527,COGS 11,A01,083617,Boyle; Mary E. T.,18,0,48,30
1656810129558,COGS 13,A01,083071,Bastos; Amalia Pinkusfeld,8,0,71,63
1656810135584,COGS 14A,A01,092681,Semenuks; Arturs,0,1,100,100
1656810141619,COGS 14B,A01,083073,Cheng; Tzu-Han,5,0,63,58
1656810147646,COGS 17,A01,092677,Semenuks; Arturs,4,0,81,77
1656810153668,COGS 100,A01,083619,Allen; Michael Gordon,15,0,70,55
1656810159690,COGS 101A,A01,083621,Davis; Joshua Daniel,9,0,68,59
1656810165713,COGS 101B,A01,091572,Allen; Michael Gordon,8,0,65,57
1656810171739,COGS 101C,A01,083625,Delgado; Tania,17,0,35,18
1656810177761,COGS 107A,A01,083627,Boyle; Mary E. T.,13,0,60,47
1656810183785,COGS 118A,A01,083075,Gupta; Anjum,15,0,76,61
1656810189807,CSE 3,A50,083646,Miranda; Gregory Joseph,22,0,50,28
1656810195835,CSE 8A,A50,083650,Miranda; Gregory Joseph,17,1,56,39
1656810201860,CSE 11,A01,083080,Cao; Yingjun,4,15,40,36
1656810207882,CSE 12,A01,083652,Krause-Levy; Sophia Louisa,20,1,120,100
1656810213908,CSE 15L,A01,083654,Morris; Justin Loren,8,0,50,42
1656810213908,CSE 15L,A02,083655,Morris; Justin Loren,8,0,50,42
1656810219930,CSE 20,A01,083657,Tran; Khoa Dang,37,0,80,43
1656810225957,CSE 21,A01,095574,Bach; Quang Tran,21,0,48,27
1656810231985,CSE 30,A01,083084,Eldon; John,4,0,80,76
1656810231985,CSE 30,B01,095061,Bhaskar; Nishant,5,0,50,45
1656810238006,CSE 100,A01,083659,Cao; Yingjun,1,4,70,69
1656810244034,CSE 134B,A01,083661,Powell; Thomas Allan,18,0,100,82
1656810250056,CSE 140,A01,083663,Gungor; Onat,14,0,85,71
1656810256080,CSE 140L,A01,083088,Eldon; John,16,0,100,84
1656810262108,CSE 175,A01,083665,Kumar; Rakesh,3,0,25,22
1656810268128,CSE 190,A00,092507,Dubnov; Shlomo,7,0,20,13
1656810274157,ECE 45,A01,083139,Congero; Spencer William,5,0,75,70
1656810280197,ECE 65,A50,083695,Saad; Andrew S,12,0,30,18
1656810280197,ECE 65,A51,095125,Saad; Andrew S,25,0,26,1
1656810286219,ECE 109,A01,091882,Touri; Behrouz,15,0,70,55
1656810292247,ECE 180,A00,083140,Abi Samra; Nicholas Camill,0,0,30,30
1656810292247,ECE 180,B00,083141,Abi Samra; Nicholas Camill,0,0,30,30
1656810298273,MATH 10A,A01,083735,Patchell; Gregory David,1,0,30,29
1656810298273,MATH 10A,A02,083736,Patchell; Gregory David,20,0,30,10
1656810298273,MATH 10A,A03,083737,Patchell; Gregory David,15,0,30,15
1656810304296,MATH 10B,A01,083207,Lim; Seonhee,7,0,34,27
1656810304296,MATH 10B,A02,083208,Lim; Seonhee,9,0,35,26
1656810304296,MATH 10B,A03,093472,Lim; Seonhee,4,0,34,30
1656810304296,MATH 10B,B01,083739,Sinha; Shubham,9,0,30,21
1656810310326,MATH 18,A01,083743,Cinel; Cameron Alexander,6,0,30,24
1656810310326,MATH 18,A02,083744,Cinel; Cameron Alexander,15,0,30,15
1656810310326,MATH 18,A03,083745,Cinel; Cameron Alexander,8,0,30,22
1656810310326,MATH 18,B01,083748,Rideout; David Porter,3,0,37,34
1656810310326,MATH 18,B02,083749,Rideout; David Porter,3,0,36,33
1656810310326,MATH 18,B03,083750,Rideout; David Porter,1,0,37,36
1656810310326,MATH 18,B04,083751,Rideout; David Porter,5,0,36,31
1656810310326,MATH 18,B05,093473,Rideout; David Porter,4,0,36,32
1656810310326,MATH 18,B06,093474,Rideout; David Porter,5,0,36,31
1656810316347,MATH 20A,A01,083754,Zheng; Zequn,12,0,40,28
1656810322370,MATH 20B,A01,083756,Briones; Jor-el Thomas Caparas,1,0,36,35
1656810322370,MATH 20B,A02,083757,Briones; Jor-el Thomas Caparas,1,0,36,35
1656810322370,MATH 20B,A03,093475,Briones; Jor-el Thomas Caparas,0,0,36,36
1656810328398,MATH 20C,A01,083760,Briones; Jor-el Thomas Caparas,1,0,35,34
1656810328398,MATH 20C,A02,083761,Briones; Jor-el Thomas Caparas,8,0,35,27
1656810328398,MATH 20C,A03,093476,Briones; Jor-el Thomas Caparas,0,1,36,36
1656810328398,MATH 20C,B01,083762,Bach; Quang Tran,0,0,30,30
1656810334427,MATH 20D,A01,083765,Tran; Brian Kha,4,0,30,26
1656810334427,MATH 20D,A02,083766,Tran; Brian Kha,4,0,30,26
1656810334427,MATH 20D,A03,083767,Tran; Brian Kha,2,0,30,28
1656810340450,MATH 20E,A01,083771,Ganguly; Soumya,5,0,32,27
1656810340450,MATH 20E,A02,083772,Ganguly; Soumya,5,0,32,27
1656810340450,MATH 20E,B01,083773,Ciotti; Benjamin,18,0,35,17
1656810340450,MATH 20E,B02,083774,Ciotti; Benjamin,17,0,35,18
1656810346478,MATH 103A,A01,083777,Greenfeld; Be'Eri,2,0,36,34
1656810346478,MATH 103A,A02,083778,Greenfeld; Be'Eri,5,0,36,31
1656810346478,MATH 103A,A03,093561,Greenfeld; Be'Eri,4,0,36,32
1656810346478,MATH 103A,B01,083779,Greenfeld; Be'Eri,6,0,36,30
1656810346478,MATH 103A,B02,083780,Greenfeld; Be'Eri,2,0,36,34
1656810346478,MATH 103A,B03,093562,Greenfeld; Be'Eri,2,0,36,34
1656810352506,MATH 105,A01,085443,Carter; Anne Toulson,13,0,35,22
1656810352506,MATH 105,A02,093477,Carter; Anne Toulson,20,0,35,15
1656810358533,MATH 109,A01,083213,Ganzberger; Geoffrey Michael,2,0,34,32
1656810358533,MATH 109,A02,083214,Ganzberger; Geoffrey Michael,2,0,34,32
1656810358533,MATH 109,A03,093478,Ganzberger; Geoffrey Michael,1,0,34,33
1656810358533,MATH 109,B01,083215,Ganzberger; Geoffrey Michael,1,0,32,31
1656810358533,MATH 109,B02,083216,Ganzberger; Geoffrey Michael,1,0,32,31
1656810358533,MATH 109,B03,093479,Ganzberger; Geoffrey Michael,6,0,32,26
1656810364554,MATH 142A,A01,083219,Chow; Bennett,6,0,32,26
1656810364554,MATH 142A,A02,083220,Chow; Bennett,9,0,32,23
1656810364554,MATH 142A,A03,093480,Chow; Bennett,7,0,32,25
1656810364554,MATH 142A,B03,093481,Chow; Bennett,7,0,32,25
1656810364554,MATH 142A,B04,093558,Chow; Bennett,10,0,32,22
1656810364554,MATH 142A,B05,093559,Chow; Bennett,6,0,32,26
1656810370578,MATH 193A,A01,083224,Rotar; Vladimir,6,0,34,28
1656810370578,MATH 193A,A02,083225,Rotar; Vladimir,3,0,34,31
1656810370578,MATH 193A,A03,083781,Rotar; Vladimir,1,0,34,33
1656810370578,MATH 193A,A04,083782,Rotar; Vladimir,6,0,34,28
1656810370578,MATH 193A,A05,093482,Rotar; Vladimir,6,0,34,28
1656810376600,MATH 197,001,091859,McAuley; Julian John,9999,0,9999,0
1656810376600,MATH 197,002,095566,Kedlaya; Kiran S.,9997,0,9999,2
1656810376600,MATH 197,003,095567,Xiao; Ming,9999,0,9999,0
1656810376600,MATH 197,004,095571,Perols; Johan Lars,9998,0,9999,1
1656810383655,COGS 9,A01,083615,Shannon; Kyle Michael,6,0,75,69
1656810389678,COGS 11,A01,083617,Boyle; Mary E. T.,18,0,48,30
1656810395702,COGS 13,A01,083071,Bastos; Amalia Pinkusfeld,8,0,71,63
1656810401725,COGS 14A,A01,092681,Semenuks; Arturs,0,1,100,100
1656810407748,COGS 14B,A01,083073,Cheng; Tzu-Han,5,0,63,58
1656810413772,COGS 17,A01,092677,Semenuks; Arturs,4,0,81,77
1656810419796,COGS 100,A01,083619,Allen; Michael Gordon,15,0,70,55
1656810425820,COGS 101A,A01,083621,Davis; Joshua Daniel,9,0,68,59
1656810431852,COGS 101B,A01,091572,Allen; Michael Gordon,8,0,65,57
1656810437877,COGS 101C,A01,083625,Delgado; Tania,17,0,35,18
1656810443901,COGS 107A,A01,083627,Boyle; Mary E. T.,13,0,60,47
1656810449925,COGS 118A,A01,083075,Gupta; Anjum,15,0,76,61
1656810455953,CSE 3,A50,083646,Miranda; Gregory Joseph,22,0,50,28
1656810461975,CSE 8A,A50,083650,Miranda; Gregory Joseph,17,1,56,39
1656810468002,CSE 11,A01,083080,Cao; Yingjun,4,15,40,36
1656810474041,CSE 12,A01,083652,Krause-Levy; Sophia Louisa,20,1,120,100
1656810480064,CSE 15L,A01,083654,Morris; Justin Loren,8,0,50,42
1656810480064,CSE 15L,A02,083655,Morris; Justin Loren,8,0,50,42
1656810486090,CSE 20,A01,083657,Tran; Khoa Dang,37,0,80,43
1656810492118,CSE 21,A01,095574,Bach; Quang Tran,21,0,48,27
1656810498150,CSE 30,A01,083084,Eldon; John,4,0,80,76
1656810498150,CSE 30,B01,095061,Bhaskar; Nishant,5,0,50,45
1656810504173,CSE 100,A01,083659,Cao; Yingjun,1,4,70,69
1656810510195,CSE 134B,A01,083661,Powell; Thomas Allan,18,0,100,82
1656810516226,CSE 140,A01,083663,Gungor; Onat,14,0,85,71
1656810522252,CSE 140L,A01,083088,Eldon; John,16,0,100,84
1656810528287,CSE 175,A01,083665,Kumar; Rakesh,3,0,25,22
1656810534315,CSE 190,A00,092507,Dubnov; Shlomo,7,0,20,13
1656810540354,ECE 45,A01,083139,Congero; Spencer William,5,0,75,70
1656810546379,ECE 65,A50,083695,Saad; Andrew S,12,0,30,18
1656810546379,ECE 65,A51,095125,Saad; Andrew S,25,0,26,1
1656810552401,ECE 109,A01,091882,Touri; Behrouz,15,0,70,55
1656810558437,ECE 180,A00,083140,Abi Samra; Nicholas Camill,0,0,30,30
1656810558437,ECE 180,B00,083141,Abi Samra; Nicholas Camill,0,0,30,30
1656810564466,MATH 10A,A01,083735,Patchell; Gregory David,1,0,30,29
1656810564466,MATH 10A,A02,083736,Patchell; Gregory David,20,0,30,10
1656810564466,MATH 10A,A03,083737,Patchell; Gregory David,15,0,30,15
1656810570491,MATH 10B,A01,083207,Lim; Seonhee,7,0,34,27
1656810570491,MATH 10B,A02,083208,Lim; Seonhee,9,0,35,26
1656810570491,MATH 10B,A03,093472,Lim; Seonhee,4,0,34,30
1656810570491,MATH 10B,B01,083739,Sinha; Shubham,9,0,30,21
1656810576515,MATH 18,A01,083743,Cinel; Cameron Alexander,6,0,30,24
1656810576515,MATH 18,A02,083744,Cinel; Cameron Alexander,15,0,30,15
1656810576515,MATH 18,A03,083745,Cinel; Cameron Alexander,8,0,30,22
1656810576515,MATH 18,B01,083748,Rideout; David Porter,3,0,37,34
1656810576515,MATH 18,B02,083749,Rideout; David Porter,3,0,36,33
1656810576515,MATH 18,B03,083750,Rideout; David Porter,1,0,37,36
1656810576515,MATH 18,B04,083751,Rideout; David Porter,5,0,36,31
1656810576515,MATH 18,B05,093473,Rideout; David Porter,4,0,36,32
1656810576515,MATH 18,B06,093474,Rideout; David Porter,5,0,36,31
1656810582542,MATH 20A,A01,083754,Zheng; Zequn,12,0,40,28
1656810588572,MATH 20B,A01,083756,Briones; Jor-el Thomas Caparas,1,0,36,35
1656810588572,MATH 20B,A02,083757,Briones; Jor-el Thomas Caparas,1,0,36,35
1656810588572,MATH 20B,A03,093475,Briones; Jor-el Thomas Caparas,0,0,36,36
1656810594601,MATH 20C,A01,083760,Briones; Jor-el Thomas Caparas,1,0,35,34
1656810594601,MATH 20C,A02,083761,Briones; Jor-el Thomas Caparas,8,0,35,27
1656810594601,MATH 20C,A03,093476,Briones; Jor-el Thomas Caparas,0,1,36,36
1656810594601,MATH 20C,B01,083762,Bach; Quang Tran,0,0,30,30
1656810600624,MATH 20D,A01,083765,Tran; Brian Kha,4,0,30,26
1656810600624,MATH 20D,A02,083766,Tran; Brian Kha,4,0,30,26
1656810600624,MATH 20D,A03,083767,Tran; Brian Kha,2,0,30,28
1656810606646,MATH 20E,A01,083771,Ganguly; Soumya,5,0,32,27
1656810606646,MATH 20E,A02,083772,Ganguly; Soumya,5,0,32,27
1656810606646,MATH 20E,B01,083773,Ciotti; Benjamin,18,0,35,17
1656810606646,MATH 20E,B02,083774,Ciotti; Benjamin,17,0,35,18
1656810612673,MATH 103A,A01,083777,Greenfeld; Be'Eri,2,0,36,34
1656810612673,MATH 103A,A02,083778,Greenfeld; Be'Eri,5,0,36,31
1656810612673,MATH 103A,A03,093561,Greenfeld; Be'Eri,4,0,36,32
1656810612673,MATH 103A,B01,083779,Greenfeld; Be'Eri,6,0,36,30
1656810612673,MATH 103A,B02,083780,Greenfeld; Be'Eri,2,0,36,34
1656810612673,MATH 103A,B03,093562,Greenfeld; Be'Eri,2,0,36,34
1656810618696,MATH 105,A01,085443,Carter; Anne Toulson,13,0,35,22
1656810618696,MATH 105,A02,093477,Carter; Anne Toulson,20,0,35,15
1656810624740,MATH 109,A01,083213,Ganzberger; Geoffrey Michael,2,0,34,32
1656810624740,MATH 109,A02,083214,Ganzberger; Geoffrey Michael,2,0,34,32
1656810624740,MATH 109,A03,093478,Ganzberger; Geoffrey Michael,1,0,34,33
1656810624740,MATH 109,B01,083215,Ganzberger; Geoffrey Michael,1,0,32,31
1656810624740,MATH 109,B02,083216,Ganzberger; Geoffrey Michael,1,0,32,31
1656810624740,MATH 109,B03,093479,Ganzberger; Geoffrey Michael,6,0,32,26
1656810630764,MATH 142A,A01,083219,Chow; Bennett,6,0,32,26
1656810630764,MATH 142A,A02,083220,Chow; Bennett,9,0,32,23
1656810630764,MATH 142A,A03,093480,Chow; Bennett,7,0,32,25
1656810630764,MATH 142A,B03,093481,Chow; Bennett,7,0,32,25
1656810630764,MATH 142A,B04,093558,Chow; Bennett,10,0,32,22
1656810630764,MATH 142A,B05,093559,Chow; Bennett,6,0,32,26
1656810636789,MATH 193A,A01,083224,Rotar; Vladimir,6,0,34,28
1656810636789,MATH 193A,A02,083225,Rotar; Vladimir,3,0,34,31
1656810636789,MATH 193A,A03,083781,Rotar; Vladimir,1,0,34,33
1656810636789,MATH 193A,A04,083782,Rotar; Vladimir,6,0,34,28
1656810636789,MATH 193A,A05,093482,Rotar; Vladimir,6,0,34,28
1656810642815,MATH 197,001,091859,McAuley; Julian John,9999,0,9999,0
1656810642815,MATH 197,002,095566,Kedlaya; Kiran S.,9997,0,9999,2
1656810642815,MATH 197,003,095567,Xiao; Ming,9999,0,9999,0
1656810642815,MATH 197,004,095571,Perols; Johan Lars,9998,0,9999,1
1656810649876,COGS 9,A01,083615,Shannon; Kyle Michael,6,0,75,69
1656810655899,COGS 11,A01,083617,Boyle; Mary E. T.,18,0,48,30
1656810661922,COGS 13,A01,083071,Bastos; Amalia Pinkusfeld,8,0,71,63
1656810667947,COGS 14A,A01,092681,Semenuks; Arturs,0,1,100,100
1656810673973,COGS 14B,A01,083073,Cheng; Tzu-Han,5,0,63,58
1656810680006,COGS 17,A01,092677,Semenuks; Arturs,4,0,81,77
1656810686033,COGS 100,A01,083619,Allen; Michael Gordon,15,0,70,55
1656810692059,COGS 101A,A01,083621,Davis; Joshua Daniel,9,0,68,59
1656810698083,COGS 101B,A01,091572,Allen; Michael Gordon,8,0,65,57
1656810704267,COGS 101C,A01,083625,Delgado; Tania,17,0,35,18
1656810710295,COGS 107A,A01,083627,Boyle; Mary E. T.,13,0,60,47
1656810716319,COGS 118A,A01,083075,Gupta; Anjum,15,0,76,61
1656810722349,CSE 3,A50,083646,Miranda; Gregory Joseph,22,0,50,28
1656810728377,CSE 8A,A50,083650,Miranda; Gregory Joseph,17,1,56,39
1656810734403,CSE 11,A01,083080,Cao; Yingjun,4,15,40,36
1656810740429,CSE 12,A01,083652,Krause-Levy; Sophia Louisa,20,1,120,100
1656810746453,CSE 15L,A01,083654,Morris; Justin Loren,8,0,50,42
1656810746453,CSE 15L,A02,083655,Morris; Justin Loren,8,0,50,42
1656810752475,CSE 20,A01,083657,Tran; Khoa Dang,37,0,80,43
1656810758518,CSE 21,A01,095574,Bach; Quang Tran,21,0,48,27
1656810764545,CSE 30,A01,083084,Eldon; John,4,0,80,76
1656810764545,CSE 30,B01,095061,Bhaskar; Nishant,5,0,50,45
1656810770573,CSE 100,A01,083659,Cao; Yingjun,1,4,70,69
1656810776597,CSE 134B,A01,083661,Powell; Thomas Allan,18,0,100,82
1656810782620,CSE 140,A01,083663,Gungor; Onat,14,0,85,71
1656810788646,CSE 140L,A01,083088,Eldon; John,16,0,100,84
1656810794670,CSE 175,A01,083665,Kumar; Rakesh,3,0,25,22
1656810800696,CSE 190,A00,092507,Dubnov; Shlomo,7,0,20,13
1656810806722,ECE 45,A01,083139,Congero; Spencer William,5,0,75,70
1656810812743,ECE 65,A50,083695,Saad; Andrew S,12,0,30,18
1656810812743,ECE 65,A51,095125,Saad; Andrew S,25,0,26,1
1656810818764,ECE 109,A01,091882,Touri; Behrouz,15,0,70,55
1656810824788,ECE 180,A00,083140,Abi Samra; Nicholas Camill,0,0,30,30
1656810824788,ECE 180,B00,083141,Abi Samra; Nicholas Camill,0,0,30,30
1656810830816,MATH 10A,A01,083735,Patchell; Gregory David,1,0,30,29
1656810830816,MATH 10A,A02,083736,Patchell; Gregory David,20,0,30,10
1656810830816,MATH 10A,A03,083737,Patchell; Gregory David,15,0,30,15
1656810836840,MATH 10B,A01,083207,Lim; Seonhee,7,0,34,27
1656810836840,MATH 10B,A02,083208,Lim; Seonhee,9,0,35,26
1656810836840,MATH 10B,A03,093472,Lim; Seonhee,4,0,34,30
1656810836840,MATH 10B,B01,083739,Sinha; Shubham,9,0,30,21
1656810842873,MATH 18,A01,083743,Cinel; Cameron Alexander,6,0,30,24
1656810842873,MATH 18,A02,083744,Cinel; Cameron Alexander,15,0,30,15
1656810842873,MATH 18,A03,083745,Cinel; Cameron Alexander,8,0,30,22
1656810842873,MATH 18,B01,083748,Rideout; David Porter,3,0,37,34
1656810842873,MATH 18,B02,083749,Rideout; David Porter,3,0,36,33
1656810842873,MATH 18,B03,083750,Rideout; David Porter,1,0,37,36
1656810842873,MATH 18,B04,083751,Rideout; David Porter,5,0,36,31
1656810842873,MATH 18,B05,093473,Rideout; David Porter,4,0,36,32
1656810842873,MATH 18,B06,093474,Rideout; David Porter,5,0,36,31
1656810848896,MATH 20A,A01,083754,Zheng; Zequn,12,0,40,28
1656810854918,MATH 20B,A01,083756,Briones; Jor-el Thomas Caparas,1,0,36,35
1656810854918,MATH 20B,A02,083757,Briones; Jor-el Thomas Caparas,1,0,36,35
1656810854918,MATH 20B,A03,093475,Briones; Jor-el Thomas Caparas,0,0,36,36
1656810860943,MATH 20C,A01,083760,Briones; Jor-el Thomas Caparas,1,0,35,34
1656810860943,MATH 20C,A02,083761,Briones; Jor-el Thomas Caparas,8,0,35,27
1656810860943,MATH 20C,A03,093476,Briones; Jor-el Thomas Caparas,0,1,36,36
1656810860943,MATH 20C,B01,083762,Bach; Quang Tran,0,0,30,30
1656810866970,MATH 20D,A01,083765,Tran; Brian Kha,4,0,30,26
1656810866970,MATH 20D,A02,083766,Tran; Brian Kha,4,0,30,26
1656810866970,MATH 20D,A03,083767,Tran; Brian Kha,2,0,30,28
1656810872992,MATH 20E,A01,083771,Ganguly; Soumya,5,0,32,27
1656810872992,MATH 20E,A02,083772,Ganguly; Soumya,5,0,32,27
1656810872992,MATH 20E,B01,083773,Ciotti; Benjamin,18,0,35,17
1656810872992,MATH 20E,B02,083774,Ciotti; Benjamin,17,0,35,18
1656810879023,MATH 103A,A01,083777,Greenfeld; Be'Eri,2,0,36,34
1656810879023,MATH 103A,A02,083778,Greenfeld; Be'Eri,5,0,36,31
1656810879023,MATH 103A,A03,093561,Greenfeld; Be'Eri,4,0,36,32
1656810879023,MATH 103A,B01,083779,Greenfeld; Be'Eri,6,0,36,30
1656810879023,MATH 103A,B02,083780,Greenfeld; Be'Eri,2,0,36,34
1656810879023,MATH 103A,B03,093562,Greenfeld; Be'Eri,2,0,36,34
1656810885045,MATH 105,A01,085443,Carter; Anne Toulson,13,0,35,22
1656810885045,MATH 105,A02,093477,Carter; Anne Toulson,20,0,35,15
1656810891069,MATH 109,A01,083213,Ganzberger; Geoffrey Michael,2,0,34,32
1656810891069,MATH 109,A02,083214,Ganzberger; Geoffrey Michael,2,0,34,32
1656810891069,MATH 109,A03,093478,Ganzberger; Geoffrey Michael,1,0,34,33
1656810891069,MATH 109,B01,083215,Ganzberger; Geoffrey Michael,1,0,32,31
1656810891069,MATH 109,B02,083216,Ganzberger; Geoffrey Michael,1,0,32,31
1656810891069,MATH 109,B03,093479,Ganzberger; Geoffrey Michael,6,0,32,26
1656810897092,MATH 142A,A01,083219,Chow; Bennett,6,0,32,26
1656810897092,MATH 142A,A02,083220,Chow; Bennett,9,0,32,23
1656810897092,MATH 142A,A03,093480,Chow; Bennett,7,0,32,25
1656810897092,MATH 142A,B03,093481,Chow; Bennett,7,0,32,25
1656810897092,MATH 142A,B04,093558,Chow; Bennett,10,0,32,22
1656810897092,MATH 142A,B05,093559,Chow; Bennett,6,0,32,26
1656810903119,MATH 193A,A01,083224,Rotar; Vladimir,6,0,34,28
1656810903119,MATH 193A,A02,083225,Rotar; Vladimir,3,0,34,31
1656810903119,MATH 193A,A03,083781,Rotar; Vladimir,1,0,34,33
1656810903119,MATH 193A,A04,083782,Rotar; Vladimir,6,0,34,28
1656810903119,MATH 193A,A05,093482,Rotar; Vladimir,6,0,34,28
1656810909141,MATH 197,001,091859,McAuley; Julian John,9999,0,9999,0
1656810909141,MATH 197,002,095566,Kedlaya; Kiran S.,9997,0,9999,2
1656810909141,MATH 197,003,095567,Xiao; Ming,9999,0,9999,0
1656810909141,MATH 197,004,095571,Perols; Johan Lars,9998,0,9999,1
1656810916207,COGS 9,A01,083615,Shannon; Kyle Michael,6,0,75,69
1656810922233,COGS 11,A01,083617,Boyle; Mary E. T.,18,0,48,30
1656810928255,COGS 13,A01,083071,Bastos; Amalia Pinkusfeld,8,0,71,63
1656810934277,COGS 14A,A01,092681,Semenuks; Arturs,0,1,100,100
1656810940301,COGS 14B,A01,083073,Cheng; Tzu-Han,5,0,63,58
1656810946327,COGS 17,A01,092677,Semenuks; Arturs,4,0,81,77
1656810952362,COGS 100,A01,083619,Allen; Michael Gordon,15,0,70,55
1656810958385,COGS 101A,A01,083621,Davis; Joshua Daniel,9,0,68,59
1656810964408,COGS 101B,A01,091572,Allen; Michael Gordon,8,0,65,57
1656810970436,COGS 101C,A01,083625,Delgado; Tania,17,0,35,18
1656810976463,COGS 107A,A01,083627,Boyle; Mary E. T.,13,0,60,47
1656810982487,COGS 118A,A01,083075,Gupta; Anjum,15,0,76,61
1656810988510,CSE 3,A50,083646,Miranda; Gregory Joseph,22,0,50,28
1656810994533,CSE 8A,A50,083650,Miranda; Gregory Joseph,17,1,56,39
1656811000556,CSE 11,A01,083080,Cao; Yingjun,4,15,40,36
1656811006580,CSE 12,A01,083652,Krause-Levy; Sophia Louisa,20,1,120,100
1656811012603,CSE 15L,A01,083654,Morris; Justin Loren,8,0,50,42
1656811012603,CSE 15L,A02,083655,Morris; Justin Loren,8,0,50,42
1656811018627,CSE 20,A01,083657,Tran; Khoa Dang,37,0,80,43
1656811024656,CSE 21,A01,095574,Bach; Quang Tran,21,0,48,27
1656811030683,CSE 30,A01,083084,Eldon; John,4,0,80,76
1656811030683,CSE 30,B01,095061,Bhaskar; Nishant,5,0,50,45
1656811036708,CSE 100,A01,083659,Cao; Yingjun,1,4,70,69
1656811042732,CSE 134B,A01,083661,Powell; Thomas Allan,18,0,100,82
1656811048754,CSE 140,A01,083663,Gungor; Onat,14,0,85,71
1656811054779,CSE 140L,A01,083088,Eldon; John,16,0,100,84
1656811060803,CSE 175,A01,083665,Kumar; Rakesh,3,0,25,22
1656811066830,CSE 190,A00,092507,Dubnov; Shlomo,7,0,20,13
1656811072853,ECE 45,A01,083139,Congero; Spencer William,5,0,75,70
1656811078880,ECE 65,A50,083695,Saad; Andrew S,12,0,30,18
1656811078880,ECE 65,A51,095125,Saad; Andrew S,25,0,26,1
1656811084902,ECE 109,A01,091882,Touri; Behrouz,15,0,70,55
1656811090927,ECE 180,A00,083140,Abi Samra; Nicholas Camill,0,0,30,30
1656811090927,ECE 180,B00,083141,Abi Samra; Nicholas Camill,0,0,30,30
1656811096954,MATH 10A,A01,083735,Patchell; Gregory David,1,0,30,29
1656811096954,MATH 10A,A02,083736,Patchell; Gregory David,20,0,30,10
1656811096954,MATH 10A,A03,083737,Patchell; Gregory David,15,0,30,15
1656811102982,MATH 10B,A01,083207,Lim; Seonhee,7,0,34,27
1656811102982,MATH 10B,A02,083208,Lim; Seonhee,9,0,35,26
1656811102982,MATH 10B,A03,093472,Lim; Seonhee,4,0,34,30
1656811102982,MATH 10B,B01,083739,Sinha; Shubham,9,0,30,21
1656811109008,MATH 18,A01,083743,Cinel; Cameron Alexander,6,0,30,24
1656811109008,MATH 18,A02,083744,Cinel; Cameron Alexander,15,0,30,15
1656811109008,MATH 18,A03,083745,Cinel; Cameron Alexander,8,0,30,22
1656811109008,MATH 18,B01,083748,Rideout; David Porter,3,0,37,34
1656811109008,MATH 18,B02,083749,Rideout; David Porter,3,0,36,33
1656811109008,MATH 18,B03,083750,Rideout; David Porter,1,0,37,36
1656811109008,MATH 18,B04,083751,Rideout; David Porter,5,0,36,31
1656811109008,MATH 18,B05,093473,Rideout; David Porter,4,0,36,32
1656811109008,MATH 18,B06,093474,Rideout; David Porter,5,0,36,31
1656811115030,MATH 20A,A01,083754,Zheng; Zequn,12,0,40,28
1656811121056,MATH 20B,A01,083756,Briones; Jor-el Thomas Caparas,1,0,36,35
1656811121056,MATH 20B,A02,083757,Briones; Jor-el Thomas Caparas,1,0,36,35
1656811121056,MATH 20B,A03,093475,Briones; Jor-el Thomas Caparas,0,0,36,36
1656811127085,MATH 20C,A01,083760,Briones; Jor-el Thomas Caparas,1,0,35,34
1656811127085,MATH 20C,A02,083761,Briones; Jor-el Thomas Caparas,8,0,35,27
1656811127085,MATH 20C,A03,093476,Briones; Jor-el Thomas Caparas,0,1,36,36
1656811127085,MATH 20C,B01,083762,Bach; Quang Tran,0,0,30,30
1656811133108,MATH 20D,A01,083765,Tran; Brian Kha,4,0,30,26
1656811133108,MATH 20D,A02,083766,Tran; Brian Kha,4,0,30,26
1656811133108,MATH 20D,A03,083767,Tran; Brian Kha,2,0,30,28
1656811139131,MATH 20E,A01,083771,Ganguly; Soumya,5,0,32,27
1656811139131,MATH 20E,A02,083772,Ganguly; Soumya,5,0,32,27
1656811139131,MATH 20E,B01,083773,Ciotti; Benjamin,18,0,35,17
1656811139131,MATH 20E,B02,083774,Ciotti; Benjamin,17,0,35,18
1656811145162,MATH 103A,A01,083777,Greenfeld; Be'Eri,2,0,36,34
1656811145162,MATH 103A,A02,083778,Greenfeld; Be'Eri,5,0,36,31
1656811145162,MATH 103A,A03,093561,Greenfeld; Be'Eri,4,0,36,32
1656811145162,MATH 103A,B01,083779,Greenfeld; Be'Eri,6,0,36,30
1656811145162,MATH 103A,B02,083780,Greenfeld; Be'Eri,2,0,36,34
1656811145162,MATH 103A,B03,093562,Greenfeld; Be'Eri,2,0,36,34
1656811151188,MATH 105,A01,085443,Carter; Anne Toulson,13,0,35,22
1656811151188,MATH 105,A02,093477,Carter; Anne Toulson,20,0,35,15
1656811157213,MATH 109,A01,083213,Ganzberger; Geoffrey Michael,2,0,34,32
1656811157213,MATH 109,A02,083214,Ganzberger; Geoffrey Michael,2,0,34,32
1656811157213,MATH 109,A03,093478,Ganzberger; Geoffrey Michael,1,0,34,33
1656811157213,MATH 109,B01,083215,Ganzberger; Geoffrey Michael,1,0,32,31
1656811157213,MATH 109,B02,083216,Ganzberger; Geoffrey Michael,1,0,32,31
1656811157213,MATH 109,B03,093479,Ganzberger; Geoffrey Michael,6,0,32,26
1656811163238,MATH 142A,A01,083219,Chow; Bennett,6,0,32,26
1656811163238,MATH 142A,A02,083220,Chow; Bennett,9,0,32,23
1656811163238,MATH 142A,A03,093480,Chow; Bennett,7,0,32,25
1656811163238,MATH 142A,B03,093481,Chow; Bennett,7,0,32,25
1656811163238,MATH 142A,B04,093558,Chow; Bennett,10,0,32,22
1656811163238,MATH 142A,B05,093559,Chow; Bennett,6,0,32,26
1656811169267,MATH 193A,A01,083224,Rotar; Vladimir,6,0,34,28
1656811169267,MATH 193A,A02,083225,Rotar; Vladimir,3,0,34,31
1656811169267,MATH 193A,A03,083781,Rotar; Vladimir,1,0,34,33
1656811169267,MATH 193A,A04,083782,Rotar; Vladimir,6,0,34,28
1656811169267,MATH 193A,A05,093482,Rotar; Vladimir,6,0,34,28
1656811175294,MATH 197,001,091859,McAuley; Julian John,9999,0,9999,0
1656811175294,MATH 197,002,095566,Kedlaya; Kiran S.,9997,0,9999,2
1656811175294,MATH 197,003,095567,Xiao; Ming,9999,0,9999,0
1656811175294,MATH 197,004,095571,Perols; Johan Lars,9998,0,9999,1
1656811182345,COGS 9,A01,083615,Shannon; Kyle Michael,6,0,75,69
1656811188367,COGS 11,A01,083617,Boyle; Mary E. T.,18,0,48,30
1656811194391,COGS 13,A01,083071,Bastos; Amalia Pinkusfeld,8,0,71,63
1656811200414,COGS 14A,A01,092681,Semenuks; Arturs,0,1,100,100
1656811206439,COGS 14B,A01,083073,Cheng; Tzu-Han,5,0,63,58
1656811212466,COGS 17,A01,092677,Semenuks; Arturs,4,0,81,77
1656811218488,COGS 100,A01,083619,Allen; Michael Gordon,15,0,70,55
1656811224512,COGS 101A,A01,083621,Davis; Joshua Daniel,9,0,68,59
1656811230537,COGS 101B,A01,091572,Allen; Michael Gordon,8,0,65,57
1656811236560,COGS 101C,A01,083625,Delgado; Tania,17,0,35,18
1656811242583,COGS 107A,A01,083627,Boyle; Mary E. T.,13,0,60,47
1656811248607,COGS 118A,A01,083075,Gupta; Anjum,15,0,76,61
1656811254635,CSE 3,A50,083646,Miranda; Gregory Joseph,22,0,50,28
1656811260658,CSE 8A,A50,083650,Miranda; Gregory Joseph,17,1,56,39
1656811266681,CSE 11,A01,083080,Cao; Yingjun,4,15,40,36
1656811272704,CSE 12,A01,083652,Krause-Levy; Sophia Louisa,20,1,120,100
1656811278728,CSE 15L,A01,083654,Morris; Justin Loren,8,0,50,42
1656811278728,CSE 15L,A02,083655,Morris; Justin Loren,8,0,50,42
1656811284751,CSE 20,A01,083657,Tran; Khoa Dang,37,0,80,43
1656811290773,CSE 21,A01,095574,Bach; Quang Tran,21,0,48,27
1656811296797,CSE 30,A01,083084,Eldon; John,4,0,80,76
1656811296797,CSE 30,B01,095061,Bhaskar; Nishant,5,0,50,45
1656811302890,CSE 100,A01,083659,Cao; Yingjun,1,4,70,69
1656811308912,CSE 134B,A01,083661,Powell; Thomas Allan,18,0,100,82
1656811314935,CSE 140,A01,083663,Gungor; Onat,14,0,85,71
1656811320956,CSE 140L,A01,083088,Eldon; John,16,0,100,84
1656811326978,CSE 175,A01,083665,Kumar; Rakesh,3,0,25,22
1656811333001,CSE 190,A00,092507,Dubnov; Shlomo,7,0,20,13
1656811339027,ECE 45,A01,083139,Congero; Spencer William,5,0,75,70
1656811345053,ECE 65,A50,083695,Saad; Andrew S,12,0,30,18
1656811345053,ECE 65,A51,095125,Saad; Andrew S,25,0,26,1
1656811351075,ECE 109,A01,091882,Touri; Behrouz,15,0,70,55
1656811357098,ECE 180,A00,083140,Abi Samra; Nicholas Camill,0,0,30,30
1656811357098,ECE 180,B00,083141,Abi Samra; Nicholas Camill,0,0,30,30
1656811363126,MATH 10A,A01,083735,Patchell; Gregory David,1,0,30,29
1656811363126,MATH 10A,A02,083736,Patchell; Gregory David,20,0,30,10
1656811363126,MATH 10A,A03,083737,Patchell; Gregory David,15,0,30,15
1656811369149,MATH 10B,A01,083207,Lim; Seonhee,7,0,34,27
1656811369149,MATH 10B,A02,083208,Lim; Seonhee,9,0,35,26
1656811369149,MATH 10B,A03,093472,Lim; Seonhee,4,0,34,30
1656811369149,MATH 10B,B01,083739,Sinha; Shubham,9,0,30,21
1656811375173,MATH 18,A01,083743,Cinel; Cameron Alexander,6,0,30,24
1656811375173,MATH 18,A02,083744,Cinel; Cameron Alexander,15,0,30,15
1656811375173,MATH 18,A03,083745,Cinel; Cameron Alexander,8,0,30,22
1656811375173,MATH 18,B01,083748,Rideout; David Porter,3,0,37,34
1656811375173,MATH 18,B02,083749,Rideout; David Porter,3,0,36,33
1656811375173,MATH 18,B03,083750,Rideout; David Porter,1,0,37,36
1656811375173,MATH 18,B04,083751,Rideout; David Porter,5,0,36,31
1656811375173,MATH 18,B05,093473,Rideout; David Porter,4,0,36,32
1656811375173,MATH 18,B06,093474,Rideout; David Porter,5,0,36,31
1656811381195,MATH 20A,A01,083754,Zheng; Zequn,12,0,40,28
1656811387217,MATH 20B,A01,083756,Briones; Jor-el Thomas Caparas,1,0,36,35
1656811387217,MATH 20B,A02,083757,Briones; Jor-el Thomas Caparas,1,0,36,35
1656811387217,MATH 20B,A03,093475,Briones; Jor-el Thomas Caparas,0,0,36,36
1656811393241,MATH 20C,A01,083760,Briones; Jor-el Thomas Caparas,1,0,35,34
1656811393241,MATH 20C,A02,083761,Briones; Jor-el Thomas Caparas,8,0,35,27
1656811393241,MATH 20C,A03,093476,Briones; Jor-el Thomas Caparas,0,1,36,36
1656811393241,MATH 20C,B01,083762,Bach; Quang Tran,0,0,30,30
1656811399264,MATH 20D,A01,083765,Tran; Brian Kha,4,0,30,26
1656811399264,MATH 20D,A02,083766,Tran; Brian Kha,4,0,30,26
1656811399264,MATH 20D,A03,083767,Tran; Brian Kha,2,0,30,28
1656811405293,MATH 20E,A01,083771,Ganguly; Soumya,5,0,32,27
1656811405293,MATH 20E,A02,083772,Ganguly; Soumya,5,0,32,27
1656811405293,MATH 20E,B01,083773,Ciotti; Benjamin,18,0,35,17
1656811405293,MATH 20E,B02,083774,Ciotti; Benjamin,17,0,35,18
1656811411317,MATH 103A,A01,083777,Greenfeld; Be'Eri,2,0,36,34
1656811411317,MATH 103A,A02,083778,Greenfeld; Be'Eri,5,0,36,31
1656811411317,MATH 103A,A03,093561,Greenfeld; Be'Eri,4,0,36,32
1656811411317,MATH 103A,B01,083779,Greenfeld; Be'Eri,6,0,36,30
1656811411317,MATH 103A,B02,083780,Greenfeld; Be'Eri,2,0,36,34
1656811411317,MATH 103A,B03,093562,Greenfeld; Be'Eri,2,0,36,34
1656811417348,MATH 105,A01,085443,Carter; Anne Toulson,13,0,35,22
1656811417348,MATH 105,A02,093477,Carter; Anne Toulson,20,0,35,15
1656811423376,MATH 109,A01,083213,Ganzberger; Geoffrey Michael,2,0,34,32
1656811423376,MATH 109,A02,083214,Ganzberger; Geoffrey Michael,2,0,34,32
1656811423376,MATH 109,A03,093478,Ganzberger; Geoffrey Michael,1,0,34,33
1656811423376,MATH 109,B01,083215,Ganzberger; Geoffrey Michael,1,0,32,31
1656811423376,MATH 109,B02,083216,Ganzberger; Geoffrey Michael,1,0,32,31
1656811423376,MATH 109,B03,093479,Ganzberger; Geoffrey Michael,6,0,32,26
1656811429407,MATH 142A,A01,083219,Chow; Bennett,6,0,32,26
1656811429407,MATH 142A,A02,083220,Chow; Bennett,9,0,32,23
1656811429407,MATH 142A,A03,093480,Chow; Bennett,7,0,32,25
1656811429407,MATH 142A,B03,093481,Chow; Bennett,7,0,32,25
1656811429407,MATH 142A,B04,093558,Chow; Bennett,10,0,32,22
1656811429407,MATH 142A,B05,093559,Chow; Bennett,6,0,32,26
1656811435435,MATH 193A,A01,083224,Rotar; Vladimir,6,0,34,28
1656811435435,MATH 193A,A02,083225,Rotar; Vladimir,3,0,34,31
1656811435435,MATH 193A,A03,083781,Rotar; Vladimir,1,0,34,33
1656811435435,MATH 193A,A04,083782,Rotar; Vladimir,6,0,34,28
1656811435435,MATH 193A,A05,093482,Rotar; Vladimir,6,0,34,28
1656811441458,MATH 197,001,091859,McAuley; Julian John,9999,0,9999,0
1656811441458,MATH 197,002,095566,Kedlaya; Kiran S.,9997,0,9999,2
1656811441458,MATH 197,003,095567,Xiao; Ming,9999,0,9999,0
1656811441458,MATH 197,004,095571,Perols; Johan Lars,9998,0,9999,1
1656811448524,COGS 9,A01,083615,Shannon; Kyle Michael,6,0,75,69
1656811454550,COGS 11,A01,083617,Boyle; Mary E. T.,18,0,48,30
1656811460575,COGS 13,A01,083071,Bastos; Amalia Pinkusfeld,8,0,71,63
1656811466610,COGS 14A,A01,092681,Semenuks; Arturs,0,1,100,100
1656811472636,COGS 14B,A01,083073,Cheng; Tzu-Han,5,0,63,58
1656811478664,COGS 17,A01,092677,Semenuks; Arturs,4,0,81,77
1656811484688,COGS 100,A01,083619,Allen; Michael Gordon,15,0,70,55
1656811490716,COGS 101A,A01,083621,Davis; Joshua Daniel,9,0,68,59
1656811496740,COGS 101B,A01,091572,Allen; Michael Gordon,8,0,65,57
1656811502762,COGS 101C,A01,083625,Delgado; Tania,17,0,35,18
1656811508796,COGS 107A,A01,083627,Boyle; Mary E. T.,13,0,60,47
1656811514819,COGS 118A,A01,083075,Gupta; Anjum,15,0,76,61
1656811520849,CSE 3,A50,083646,Miranda; Gregory Joseph,22,0,50,28
1656811526872,CSE 8A,A50,083650,Miranda; Gregory Joseph,17,1,56,39
1656811532899,CSE 11,A01,083080,Cao; Yingjun,4,15,40,36
1656811538926,CSE 12,A01,083652,Krause-Levy; Sophia Louisa,20,1,120,100
1656811544952,CSE 15L,A01,083654,Morris; Justin Loren,8,0,50,42
1656811544952,CSE 15L,A02,083655,Morris; Justin Loren,8,0,50,42
1656811550981,CSE 20,A01,083657,Tran; Khoa Dang,37,0,80,43
1656811557005,CSE 21,A01,095574,Bach; Quang Tran,21,0,48,27
1656811563031,CSE 30,A01,083084,Eldon; John,4,0,80,76
1656811563031,CSE 30,B01,095061,Bhaskar; Nishant,5,0,50,45
1656811569056,CSE 100,A01,083659,Cao; Yingjun,1,4,70,69
1656811575080,CSE 134B,A01,083661,Powell; Thomas Allan,18,0,100,82
1656811581103,CSE 140,A01,083663,Gungor; Onat,14,0,85,71
1656811587136,CSE 140L,A01,083088,Eldon; John,16,0,100,84
1656811593159,CSE 175,A01,083665,Kumar; Rakesh,3,0,25,22
1656811599193,CSE 190,A00,092507,Dubnov; Shlomo,7,0,20,13
1656811605227,ECE 45,A01,083139,Congero; Spencer William,5,0,75,70
1656811611251,ECE 65,A50,083695,Saad; Andrew S,12,0,30,18
1656811611251,ECE 65,A51,095125,Saad; Andrew S,25,0,26,1
1656811617275,ECE 109,A01,091882,Touri; Behrouz,15,0,70,55
1656811623304,ECE 180,A00,083140,Abi Samra; Nicholas Camill,0,0,30,30
1656811623304,ECE 180,B00,083141,Abi Samra; Nicholas Camill,0,0,30,30
1656811629329,MATH 10A,A01,083735,Patchell; Gregory David,1,0,30,29
1656811629329,MATH 10A,A02,083736,Patchell; Gregory David,20,0,30,10
1656811629329,MATH 10A,A03,083737,Patchell; Gregory David,15,0,30,15
1656811635359,MATH 10B,A01,083207,Lim; Seonhee,7,0,34,27
1656811635359,MATH 10B,A02,083208,Lim; Seonhee,9,0,35,26
1656811635359,MATH 10B,A03,093472,Lim; Seonhee,4,0,34,30
1656811635359,MATH 10B,B01,083739,Sinha; Shubham,9,0,30,21
1656811641393,MATH 18,A01,083743,Cinel; Cameron Alexander,6,0,30,24
1656811641393,MATH 18,A02,083744,Cinel; Cameron Alexander,15,0,30,15
1656811641393,MATH 18,A03,083745,Cinel; Cameron Alexander,8,0,30,22
1656811641393,MATH 18,B01,083748,Rideout; David Porter,3,0,37,34
1656811641393,MATH 18,B02,083749,Rideout; David Porter,3,0,36,33
1656811641393,MATH 18,B03,083750,Rideout; David Porter,1,0,37,36
1656811641393,MATH 18,B04,083751,Rideout; David Porter,5,0,36,31
1656811641393,MATH 18,B05,093473,Rideout; David Porter,4,0,36,32
1656811641393,MATH 18,B06,093474,Rideout; David Porter,5,0,36,31
1656811647422,MATH 20A,A01,083754,Zheng; Zequn,12,0,40,28
1656811653451,MATH 20B,A01,083756,Briones; Jor-el Thomas Caparas,1,0,36,35
1656811653451,MATH 20B,A02,083757,Briones; Jor-el Thomas Caparas,1,0,36,35
1656811653451,MATH 20B,A03,093475,Briones; Jor-el Thomas Caparas,0,0,36,36
1656811659476,MATH 20C,A01,083760,Briones; Jor-el Thomas Caparas,1,0,35,34
1656811659476,MATH 20C,A02,083761,Briones; Jor-el Thomas Caparas,8,0,35,27
1656811659476,MATH 20C,A03,093476,Briones; Jor-el Thomas Caparas,0,1,36,36
1656811659476,MATH 20C,B01,083762,Bach; Quang Tran,0,0,30,30
1656811665505,MATH 20D,A01,083765,Tran; Brian Kha,4,0,30,26
1656811665505,MATH 20D,A02,083766,Tran; Brian Kha,4,0,30,26
1656811665505,MATH 20D,A03,083767,Tran; Brian Kha,2,0,30,28
1656811671530,MATH 20E,A01,083771,Ganguly; Soumya,5,0,32,27
1656811671530,MATH 20E,A02,083772,Ganguly; Soumya,5,0,32,27
1656811671530,MATH 20E,B01,083773,Ciotti; Benjamin,18,0,35,17
1656811671530,MATH 20E,B02,083774,Ciotti; Benjamin,17,0,35,18
1656811677560,MATH 103A,A01,083777,Greenfeld; Be'Eri,2,0,36,34
1656811677560,MATH 103A,A02,083778,Greenfeld; Be'Eri,5,0,36,31
1656811677560,MATH 103A,A03,093561,Greenfeld; Be'Eri,4,0,36,32
1656811677560,MATH 103A,B01,083779,Greenfeld; Be'Eri,6,0,36,30
1656811677560,MATH 103A,B02,083780,Greenfeld; Be'Eri,2,0,36,34
1656811677560,MATH 103A,B03,093562,Greenfeld; Be'Eri,2,0,36,34
1656811683594,MATH 105,A01,085443,Carter; Anne Toulson,13,0,35,22
1656811683594,MATH 105,A02,093477,Carter; Anne Toulson,20,0,35,15
1656811689622,MATH 109,A01,083213,Ganzberger; Geoffrey Michael,2,0,34,32
1656811689622,MATH 109,A02,083214,Ganzberger; Geoffrey Michael,2,0,34,32
1656811689622,MATH 109,A03,093478,Ganzberger; Geoffrey Michael,1,0,34,33
1656811689622,MATH 109,B01,083215,Ganzberger; Geoffrey Michael,1,0,32,31
1656811689622,MATH 109,B02,083216,Ganzberger; Geoffrey Michael,1,0,32,31
1656811689622,MATH 109,B03,093479,Ganzberger; Geoffrey Michael,6,0,32,26
1656811695646,MATH 142A,A01,083219,Chow; Bennett,6,0,32,26
1656811695646,MATH 142A,A02,083220,Chow; Bennett,9,0,32,23
1656811695646,MATH 142A,A03,093480,Chow; Bennett,7,0,32,25
1656811695646,MATH 142A,B03,093481,Chow; Bennett,7,0,32,25
1656811695646,MATH 142A,B04,093558,Chow; Bennett,10,0,32,22
1656811695646,MATH 142A,B05,093559,Chow; Bennett,6,0,32,26
1656811701671,MATH 193A,A01,083224,Rotar; Vladimir,6,0,34,28
1656811701671,MATH 193A,A02,083225,Rotar; Vladimir,3,0,34,31
1656811701671,MATH 193A,A03,083781,Rotar; Vladimir,1,0,34,33
1656811701671,MATH 193A,A04,083782,Rotar; Vladimir,6,0,34,28
1656811701671,MATH 193A,A05,093482,Rotar; Vladimir,6,0,34,28
1656811707700,MATH 197,001,091859,McAuley; Julian John,9999,0,9999,0
1656811707700,MATH 197,002,095566,Kedlaya; Kiran S.,9997,0,9999,2
1656811707700,MATH 197,003,095567,Xiao; Ming,9999,0,9999,0
1656811707700,MATH 197,004,095571,Perols; Johan Lars,9998,0,9999,1
1656811714757,COGS 9,A01,083615,Shannon; Kyle Michael,6,0,75,69
1656811720784,COGS 11,A01,083617,Boyle; Mary E. T.,18,0,48,30
1656811726808,COGS 13,A01,083071,Bastos; Amalia Pinkusfeld,8,0,71,63
1656811732832,COGS 14A,A01,092681,Semenuks; Arturs,0,1,100,100
1656811738854,COGS 14B,A01,083073,Cheng; Tzu-Han,5,0,63,58
1656811744877,COGS 17,A01,092677,Semenuks; Arturs,4,0,81,77
1656811750898,COGS 100,A01,083619,Allen; Michael Gordon,15,0,70,55
1656811756921,COGS 101A,A01,083621,Davis; Joshua Daniel,9,0,68,59
1656811762948,COGS 101B,A01,091572,Allen; Michael Gordon,8,0,65,57
1656811768974,COGS 101C,A01,083625,Delgado; Tania,17,0,35,18
1656811774996,COGS 107A,A01,083627,Boyle; Mary E. T.,13,0,60,47
1656811781019,COGS 118A,A01,083075,Gupta; Anjum,15,0,76,61
1656811787043,CSE 3,A50,083646,Miranda; Gregory Joseph,22,0,50,28
1656811793065,CSE 8A,A50,083650,Miranda; Gregory Joseph,17,1,56,39
1656811799088,CSE 11,A01,083080,Cao; Yingjun,4,15,40,36
1656811805115,CSE 12,A01,083652,Krause-Levy; Sophia Louisa,20,1,120,100
1656811811141,CSE 15L,A01,083654,Morris; Justin Loren,8,0,50,42
1656811811141,CSE 15L,A02,083655,Morris; Justin Loren,8,0,50,42
1656811817164,CSE 20,A01,083657,Tran; Khoa Dang,37,0,80,43
1656811823187,CSE 21,A01,095574,Bach; Quang Tran,21,0,48,27
1656811829210,CSE 30,A01,083084,Eldon; John,4,0,80,76
1656811829210,CSE 30,B01,095061,Bhaskar; Nishant,5,0,50,45
1656811835235,CSE 100,A01,083659,Cao; Yingjun,1,4,70,69
1656811841258,CSE 134B,A01,083661,Powell; Thomas Allan,18,0,100,82
1656811847280,CSE 140,A01,083663,Gungor; Onat,14,0,85,71
1656811853307,CSE 140L,A01,083088,Eldon; John,16,0,100,84
1656811859331,CSE 175,A01,083665,Kumar; Rakesh,3,0,25,22
1656811865357,CSE 190,A00,092507,Dubnov; Shlomo,7,0,20,13
1656811871381,ECE 45,A01,083139,Congero; Spencer William,5,0,75,70
1656811877405,ECE 65,A50,083695,Saad; Andrew S,12,0,30,18
1656811877405,ECE 65,A51,095125,Saad; Andrew S,25,0,26,1
1656811883433,ECE 109,A01,091882,Touri; Behrouz,15,0,70,55
1656811889456,ECE 180,A00,083140,Abi Samra; Nicholas Camill,0,0,30,30
1656811889456,ECE 180,B00,083141,Abi Samra; Nicholas Camill,0,0,30,30
1656811895480,MATH 10A,A01,083735,Patchell; Gregory David,1,0,30,29
1656811895480,MATH 10A,A02,083736,Patchell; Gregory David,20,0,30,10
1656811895480,MATH 10A,A03,083737,Patchell; Gregory David,15,0,30,15
1656811901599,MATH 10B,A01,083207,Lim; Seonhee,7,0,34,27
1656811901599,MATH 10B,A02,083208,Lim; Seonhee,9,0,35,26
1656811901599,MATH 10B,A03,093472,Lim; Seonhee,4,0,34,30
1656811901599,MATH 10B,B01,083739,Sinha; Shubham,9,0,30,21
1656811907628,MATH 18,A01,083743,Cinel; Cameron Alexander,6,0,30,24
1656811907628,MATH 18,A02,083744,Cinel; Cameron Alexander,15,0,30,15
1656811907628,MATH 18,A03,083745,Cinel; Cameron Alexander,8,0,30,22
1656811907628,MATH 18,B01,083748,Rideout; David Porter,3,0,37,34
1656811907628,MATH 18,B02,083749,Rideout; David Porter,3,0,36,33
1656811907628,MATH 18,B03,083750,Rideout; David Porter,1,0,37,36
1656811907628,MATH 18,B04,083751,Rideout; David Porter,5,0,36,31
1656811907628,MATH 18,B05,093473,Rideout; David Porter,4,0,36,32
1656811907628,MATH 18,B06,093474,Rideout; David Porter,5,0,36,31
1656811913657,MATH 20A,A01,083754,Zheng; Zequn,12,0,40,28
1656811919681,MATH 20B,A01,083756,Briones; Jor-el Thomas Caparas,1,0,36,35
1656811919681,MATH 20B,A02,083757,Briones; Jor-el Thomas Caparas,1,0,36,35
1656811919681,MATH 20B,A03,093475,Briones; Jor-el Thomas Caparas,0,0,36,36
1656811925703,MATH 20C,A01,083760,Briones; Jor-el Thomas Caparas,1,0,35,34
1656811925703,MATH 20C,A02,083761,Briones; Jor-el Thomas Caparas,8,0,35,27
1656811925703,MATH 20C,A03,093476,Briones; Jor-el Thomas Caparas,0,1,36,36
1656811925703,MATH 20C,B01,083762,Bach; Quang Tran,0,0,30,30
1656811931731,MATH 20D,A01,083765,Tran; Brian Kha,4,0,30,26
1656811931731,MATH 20D,A02,083766,Tran; Brian Kha,4,0,30,26
1656811931731,MATH 20D,A03,083767,Tran; Brian Kha,2,0,30,28
1656811937759,MATH 20E,A01,083771,Ganguly; Soumya,5,0,32,27
1656811937759,MATH 20E,A02,083772,Ganguly; Soumya,5,0,32,27
1656811937759,MATH 20E,B01,083773,Ciotti; Benjamin,18,0,35,17
1656811937759,MATH 20E,B02,083774,Ciotti; Benjamin,17,0,35,18
1656811943798,MATH 103A,A01,083777,Greenfeld; Be'Eri,2,0,36,34
1656811943798,MATH 103A,A02,083778,Greenfeld; Be'Eri,5,0,36,31
1656811943798,MATH 103A,A03,093561,Greenfeld; Be'Eri,4,0,36,32
1656811943798,MATH 103A,B01,083779,Greenfeld; Be'Eri,6,0,36,30
1656811943798,MATH 103A,B02,083780,Greenfeld; Be'Eri,2,0,36,34
1656811943798,MATH 103A,B03,093562,Greenfeld; Be'Eri,2,0,36,34
1656811949819,MATH 105,A01,085443,Carter; Anne Toulson,13,0,35,22
1656811949819,MATH 105,A02,093477,Carter; Anne Toulson,20,0,35,15
1656811955842,MATH 109,A01,083213,Ganzberger; Geoffrey Michael,2,0,34,32
1656811955842,MATH 109,A02,083214,Ganzberger; Geoffrey Michael,2,0,34,32
1656811955842,MATH 109,A03,093478,Ganzberger; Geoffrey Michael,1,0,34,33
1656811955842,MATH 109,B01,083215,Ganzberger; Geoffrey Michael,1,0,32,31
1656811955842,MATH 109,B02,083216,Ganzberger; Geoffrey Michael,1,0,32,31
1656811955842,MATH 109,B03,093479,Ganzberger; Geoffrey Michael,6,0,32,26
1656811961869,MATH 142A,A01,083219,Chow; Bennett,6,0,32,26
1656811961869,MATH 142A,A02,083220,Chow; Bennett,9,0,32,23
1656811961869,MATH 142A,A03,093480,Chow; Bennett,7,0,32,25
1656811961869,MATH 142A,B03,093481,Chow; Bennett,7,0,32,25
1656811961869,MATH 142A,B04,093558,Chow; Bennett,10,0,32,22
1656811961869,MATH 142A,B05,093559,Chow; Bennett,6,0,32,26
1656811967891,MATH 193A,A01,083224,Rotar; Vladimir,6,0,34,28
1656811967891,MATH 193A,A02,083225,Rotar; Vladimir,3,0,34,31
1656811967891,MATH 193A,A03,083781,Rotar; Vladimir,1,0,34,33
1656811967891,MATH 193A,A04,083782,Rotar; Vladimir,6,0,34,28
1656811967891,MATH 193A,A05,093482,Rotar; Vladimir,6,0,34,28
1656811973912,MATH 197,001,091859,McAuley; Julian John,9999,0,9999,0
1656811973912,MATH 197,002,095566,Kedlaya; Kiran S.,9997,0,9999,2
1656811973912,MATH 197,003,095567,Xiao; Ming,9999,0,9999,0
1656811973912,MATH 197,004,095571,Perols; Johan Lars,9998,0,9999,1
1656811980972,COGS 9,A01,083615,Shannon; Kyle Michael,6,0,75,69
1656811986998,COGS 11,A01,083617,Boyle; Mary E. T.,18,0,48,30
1656811993023,COGS 13,A01,083071,Bastos; Amalia Pinkusfeld,8,0,71,63
1656811999046,COGS 14A,A01,092681,Semenuks; Arturs,0,1,100,100
1656812005067,COGS 14B,A01,083073,Cheng; Tzu-Han,5,0,63,58
1656812011101,COGS 17,A01,092677,Semenuks; Arturs,4,0,81,77
1656812017129,COGS 100,A01,083619,Allen; Michael Gordon,15,0,70,55
1656812023155,COGS 101A,A01,083621,Davis; Joshua Daniel,9,0,68,59
1656812029177,COGS 101B,A01,091572,Allen; Michael Gordon,8,0,65,57
1656812035200,COGS 101C,A01,083625,Delgado; Tania,17,0,35,18
1656812041228,COGS 107A,A01,083627,Boyle; Mary E. T.,13,0,60,47
1656812047250,COGS 118A,A01,083075,Gupta; Anjum,15,0,76,61
1656812053273,CSE 3,A50,083646,Miranda; Gregory Joseph,22,0,50,28
1656812059300,CSE 8A,A50,083650,Miranda; Gregory Joseph,17,1,56,39
1656812065324,CSE 11,A01,083080,Cao; Yingjun,4,15,40,36
1656812071347,CSE 12,A01,083652,Krause-Levy; Sophia Louisa,20,1,120,100
1656812077371,CSE 15L,A01,083654,Morris; Justin Loren,8,0,50,42
1656812077371,CSE 15L,A02,083655,Morris; Justin Loren,8,0,50,42
1656812083396,CSE 20,A01,083657,Tran; Khoa Dang,37,0,80,43
1656812089420,CSE 21,A01,095574,Bach; Quang Tran,21,0,48,27
1656812095448,CSE 30,A01,083084,Eldon; John,4,0,80,76
1656812095448,CSE 30,B01,095061,Bhaskar; Nishant,5,0,50,45
1656812101473,CSE 100,A01,083659,Cao; Yingjun,1,4,70,69
1656812107495,CSE 134B,A01,083661,Powell; Thomas Allan,18,0,100,82
1656812113519,CSE 140,A01,083663,Gungor; Onat,14,0,85,71
1656812119546,CSE 140L,A01,083088,Eldon; John,16,0,100,84
1656812125571,CSE 175,A01,083665,Kumar; Rakesh,3,0,25,22
1656812131593,CSE 190,A00,092507,Dubnov; Shlomo,7,0,20,13
1656812137619,ECE 45,A01,083139,Congero; Spencer William,5,0,75,70
1656812143643,ECE 65,A50,083695,Saad; Andrew S,12,0,30,18
1656812143643,ECE 65,A51,095125,Saad; Andrew S,25,0,26,1
1656812149668,ECE 109,A01,091882,Touri; Behrouz,15,0,70,55
1656812155689,ECE 180,A00,083140,Abi Samra; Nicholas Camill,0,0,30,30
1656812155689,ECE 180,B00,083141,Abi Samra; Nicholas Camill,0,0,30,30
1656812161716,MATH 10A,A01,083735,Patchell; Gregory David,1,0,30,29
1656812161716,MATH 10A,A02,083736,Patchell; Gregory David,20,0,30,10
1656812161716,MATH 10A,A03,083737,Patchell; Gregory David,15,0,30,15
1656812167737,MATH 10B,A01,083207,Lim; Seonhee,7,0,34,27
1656812167737,MATH 10B,A02,083208,Lim; Seonhee,9,0,35,26
1656812167737,MATH 10B,A03,093472,Lim; Seonhee,4,0,34,30
1656812167737,MATH 10B,B01,083739,Sinha; Shubham,9,0,30,21
1656812173769,MATH 18,A01,083743,Cinel; Cameron Alexander,6,0,30,24
1656812173769,MATH 18,A02,083744,Cinel; Cameron Alexander,15,0,30,15
1656812173769,MATH 18,A03,083745,Cinel; Cameron Alexander,8,0,30,22
1656812173769,MATH 18,B01,083748,Rideout; David Porter,3,0,37,34
1656812173769,MATH 18,B02,083749,Rideout; David Porter,3,0,36,33
1656812173769,MATH 18,B03,083750,Rideout; David Porter,1,0,37,36
1656812173769,MATH 18,B04,083751,Rideout; David Porter,5,0,36,31
1656812173769,MATH 18,B05,093473,Rideout; David Porter,4,0,36,32
1656812173769,MATH 18,B06,093474,Rideout; David Porter,5,0,36,31
1656812179791,MATH 20A,A01,083754,Zheng; Zequn,12,0,40,28
1656812185822,MATH 20B,A01,083756,Briones; Jor-el Thomas Caparas,1,0,36,35
1656812185822,MATH 20B,A02,083757,Briones; Jor-el Thomas Caparas,1,0,36,35
1656812185822,MATH 20B,A03,093475,Briones; Jor-el Thomas Caparas,0,0,36,36
1656812191845,MATH 20C,A01,083760,Briones; Jor-el Thomas Caparas,1,0,35,34
1656812191845,MATH 20C,A02,083761,Briones; Jor-el Thomas Caparas,8,0,35,27
1656812191845,MATH 20C,A03,093476,Briones; Jor-el Thomas Caparas,0,1,36,36
1656812191845,MATH 20C,B01,083762,Bach; Quang Tran,0,0,30,30
1656812197868,MATH 20D,A01,083765,Tran; Brian Kha,4,0,30,26
1656812197868,MATH 20D,A02,083766,Tran; Brian Kha,4,0,30,26
1656812197868,MATH 20D,A03,083767,Tran; Brian Kha,2,0,30,28
1656812203906,MATH 20E,A01,083771,Ganguly; Soumya,5,0,32,27
1656812203906,MATH 20E,A02,083772,Ganguly; Soumya,5,0,32,27
1656812203906,MATH 20E,B01,083773,Ciotti; Benjamin,18,0,35,17
1656812203906,MATH 20E,B02,083774,Ciotti; Benjamin,17,0,35,18
1656812209930,MATH 103A,A01,083777,Greenfeld; Be'Eri,2,0,36,34
1656812209930,MATH 103A,A02,083778,Greenfeld; Be'Eri,5,0,36,31
1656812209930,MATH 103A,A03,093561,Greenfeld; Be'Eri,4,0,36,32
1656812209930,MATH 103A,B01,083779,Greenfeld; Be'Eri,6,0,36,30
1656812209930,MATH 103A,B02,083780,Greenfeld; Be'Eri,2,0,36,34
1656812209930,MATH 103A,B03,093562,Greenfeld; Be'Eri,2,0,36,34
1656812215953,MATH 105,A01,085443,Carter; Anne Toulson,13,0,35,22
1656812215953,MATH 105,A02,093477,Carter; Anne Toulson,20,0,35,15
1656812221978,MATH 109,A01,083213,Ganzberger; Geoffrey Michael,2,0,34,32
1656812221978,MATH 109,A02,083214,Ganzberger; Geoffrey Michael,2,0,34,32
1656812221978,MATH 109,A03,093478,Ganzberger; Geoffrey Michael,1,0,34,33
1656812221978,MATH 109,B01,083215,Ganzberger; Geoffrey Michael,1,0,32,31
1656812221978,MATH 109,B02,083216,Ganzberger; Geoffrey Michael,1,0,32,31
1656812221978,MATH 109,B03,093479,Ganzberger; Geoffrey Michael,6,0,32,26
1656812228009,MATH 142A,A01,083219,Chow; Bennett,6,0,32,26
1656812228009,MATH 142A,A02,083220,Chow; Bennett,9,0,32,23
1656812228009,MATH 142A,A03,093480,Chow; Bennett,7,0,32,25
1656812228009,MATH 142A,B03,093481,Chow; Bennett,7,0,32,25
1656812228009,MATH 142A,B04,093558,Chow; Bennett,10,0,32,22
1656812228009,MATH 142A,B05,093559,Chow; Bennett,6,0,32,26
1656812234038,MATH 193A,A01,083224,Rotar; Vladimir,6,0,34,28
1656812234038,MATH 193A,A02,083225,Rotar; Vladimir,3,0,34,31
1656812234038,MATH 193A,A03,083781,Rotar; Vladimir,1,0,34,33
1656812234038,MATH 193A,A04,083782,Rotar; Vladimir,6,0,34,28
1656812234038,MATH 193A,A05,093482,Rotar; Vladimir,6,0,34,28
1656812240061,MATH 197,001,091859,McAuley; Julian John,9999,0,9999,0
1656812240061,MATH 197,002,095566,Kedlaya; Kiran S.,9997,0,9999,2
1656812240061,MATH 197,003,095567,Xiao; Ming,9999,0,9999,0
1656812240061,MATH 197,004,095571,Perols; Johan Lars,9998,0,9999,1
1656812247122,COGS 9,A01,083615,Shannon; Kyle Michael,6,0,75,69
1656812253148,COGS 11,A01,083617,Boyle; Mary E. T.,18,0,48,30
1656812259170,COGS 13,A01,083071,Bastos; Amalia Pinkusfeld,8,0,71,63
1656812265193,COGS 14A,A01,092681,Semenuks; Arturs,0,1,100,100
1656812271226,COGS 14B,A01,083073,Cheng; Tzu-Han,5,0,63,58
1656812277248,COGS 17,A01,092677,Semenuks; Arturs,4,0,81,77
1656812283275,COGS 100,A01,083619,Allen; Michael Gordon,15,0,70,55
1656812289297,COGS 101A,A01,083621,Davis; Joshua Daniel,9,0,68,59
1656812295327,COGS 101B,A01,091572,Allen; Michael Gordon,8,0,65,57
1656812309321,COGS 101C,A01,083625,Delgado; Tania,17,0,35,18
1656812317304,COGS 107A,A01,083627,Boyle; Mary E. T.,13,0,60,47
1656812323330,COGS 118A,A01,083075,Gupta; Anjum,15,0,76,61
1656812329354,CSE 3,A50,083646,Miranda; Gregory Joseph,22,0,50,28
1656812335379,CSE 8A,A50,083650,Miranda; Gregory Joseph,17,1,56,39
1656812341409,CSE 11,A01,083080,Cao; Yingjun,4,15,40,36
1656812347436,CSE 12,A01,083652,Krause-Levy; Sophia Louisa,20,1,120,100
1656812353458,CSE 15L,A01,083654,Morris; Justin Loren,8,0,50,42
1656812353458,CSE 15L,A02,083655,Morris; Justin Loren,8,0,50,42
1656812359484,CSE 20,A01,083657,Tran; Khoa Dang,37,0,80,43
1656812365506,CSE 21,A01,095574,Bach; Quang Tran,21,0,48,27
1656812371528,CSE 30,A01,083084,Eldon; John,4,0,80,76
1656812371528,CSE 30,B01,095061,Bhaskar; Nishant,5,0,50,45
1656812377553,CSE 100,A01,083659,Cao; Yingjun,1,4,70,69
1656812383592,CSE 134B,A01,083661,Powell; Thomas Allan,18,0,100,82
1656812389616,CSE 140,A01,083663,Gungor; Onat,14,0,85,71
1656812395647,CSE 140L,A01,083088,Eldon; John,16,0,100,84
1656812401674,CSE 175,A01,083665,Kumar; Rakesh,3,0,25,22
1656812407699,CSE 190,A00,092507,Dubnov; Shlomo,7,0,20,13
1656812413722,ECE 45,A01,083139,Congero; Spencer William,5,0,75,70
1656812419750,ECE 65,A50,083695,Saad; Andrew S,12,0,30,18
1656812419750,ECE 65,A51,095125,Saad; Andrew S,25,0,26,1
1656812425775,ECE 109,A01,091882,Touri; Behrouz,15,0,70,55
1656812431798,ECE 180,A00,083140,Abi Samra; Nicholas Camill,0,0,30,30
1656812431798,ECE 180,B00,083141,Abi Samra; Nicholas Camill,0,0,30,30
1656812437820,MATH 10A,A01,083735,Patchell; Gregory David,1,0,30,29
1656812437820,MATH 10A,A02,083736,Patchell; Gregory David,20,0,30,10
1656812437820,MATH 10A,A03,083737,Patchell; Gregory David,15,0,30,15
1656812443844,MATH 10B,A01,083207,Lim; Seonhee,7,0,34,27
1656812443844,MATH 10B,A02,083208,Lim; Seonhee,9,0,35,26
1656812443844,MATH 10B,A03,093472,Lim; Seonhee,4,0,34,30
1656812443844,MATH 10B,B01,083739,Sinha; Shubham,9,0,30,21
1656812449874,MATH 18,A01,083743,Cinel; Cameron Alexander,6,0,30,24
1656812449874,MATH 18,A02,083744,Cinel; Cameron Alexander,15,0,30,15
1656812449874,MATH 18,A03,083745,Cinel; Cameron Alexander,8,0,30,22
1656812449874,MATH 18,B01,083748,Rideout; David Porter,3,0,37,34
1656812449874,MATH 18,B02,083749,Rideout; David Porter,3,0,36,33
1656812449874,MATH 18,B03,083750,Rideout; David Porter,1,0,37,36
1656812449874,MATH 18,B04,083751,Rideout; David Porter,5,0,36,31
1656812449874,MATH 18,B05,093473,Rideout; David Porter,4,0,36,32
1656812449874,MATH 18,B06,093474,Rideout; David Porter,5,0,36,31
1656812455898,MATH 20A,A01,083754,Zheng; Zequn,12,0,40,28
1656812461925,MATH 20B,A01,083756,Briones; Jor-el Thomas Caparas,1,0,36,35
1656812461925,MATH 20B,A02,083757,Briones; Jor-el Thomas Caparas,1,0,36,35
1656812461925,MATH 20B,A03,093475,Briones; Jor-el Thomas Caparas,0,0,36,36
1656812467952,MATH 20C,A01,083760,Briones; Jor-el Thomas Caparas,1,0,35,34
1656812467952,MATH 20C,A02,083761,Briones; Jor-el Thomas Caparas,8,0,35,27
1656812467952,MATH 20C,A03,093476,Briones; Jor-el Thomas Caparas,0,1,36,36
1656812467952,MATH 20C,B01,083762,Bach; Quang Tran,0,0,30,30
1656812473977,MATH 20D,A01,083765,Tran; Brian Kha,4,0,30,26
1656812473977,MATH 20D,A02,083766,Tran; Brian Kha,4,0,30,26
1656812473977,MATH 20D,A03,083767,Tran; Brian Kha,2,0,30,28
1656812480005,MATH 20E,A01,083771,Ganguly; Soumya,5,0,32,27
1656812480005,MATH 20E,A02,083772,Ganguly; Soumya,5,0,32,27
1656812480005,MATH 20E,B01,083773,Ciotti; Benjamin,18,0,35,17
1656812480005,MATH 20E,B02,083774,Ciotti; Benjamin,17,0,35,18
1656812486029,MATH 103A,A01,083777,Greenfeld; Be'Eri,2,0,36,34
1656812486029,MATH 103A,A02,083778,Greenfeld; Be'Eri,5,0,36,31
1656812486029,MATH 103A,A03,093561,Greenfeld; Be'Eri,4,0,36,32
1656812486029,MATH 103A,B01,083779,Greenfeld; Be'Eri,6,0,36,30
1656812486029,MATH 103A,B02,083780,Greenfeld; Be'Eri,2,0,36,34
1656812486029,MATH 103A,B03,093562,Greenfeld; Be'Eri,2,0,36,34
1656812492053,MATH 105,A01,085443,Carter; Anne Toulson,13,0,35,22
1656812492053,MATH 105,A02,093477,Carter; Anne Toulson,20,0,35,15
1656812498075,MATH 109,A01,083213,Ganzberger; Geoffrey Michael,2,0,34,32
1656812498075,MATH 109,A02,083214,Ganzberger; Geoffrey Michael,2,0,34,32
1656812498075,MATH 109,A03,093478,Ganzberger; Geoffrey Michael,1,0,34,33
1656812498075,MATH 109,B01,083215,Ganzberger; Geoffrey Michael,1,0,32,31
1656812498075,MATH 109,B02,083216,Ganzberger; Geoffrey Michael,1,0,32,31
1656812498075,MATH 109,B03,093479,Ganzberger; Geoffrey Michael,6,0,32,26
1656812504098,MATH 142A,A01,083219,Chow; Bennett,6,0,32,26
1656812504098,MATH 142A,A02,083220,Chow; Bennett,9,0,32,23
1656812504098,MATH 142A,A03,093480,Chow; Bennett,7,0,32,25
1656812504098,MATH 142A,B03,093481,Chow; Bennett,7,0,32,25
1656812504098,MATH 142A,B04,093558,Chow; Bennett,10,0,32,22
1656812504098,MATH 142A,B05,093559,Chow; Bennett,6,0,32,26
1656812510194,MATH 193A,A01,083224,Rotar; Vladimir,6,0,34,28
1656812510194,MATH 193A,A02,083225,Rotar; Vladimir,3,0,34,31
1656812510194,MATH 193A,A03,083781,Rotar; Vladimir,1,0,34,33
1656812510194,MATH 193A,A04,083782,Rotar; Vladimir,6,0,34,28
1656812510194,MATH 193A,A05,093482,Rotar; Vladimir,6,0,34,28
1656812516219,MATH 197,001,091859,McAuley; Julian John,9999,0,9999,0
1656812516219,MATH 197,002,095566,Kedlaya; Kiran S.,9997,0,9999,2
1656812516219,MATH 197,003,095567,Xiao; Ming,9999,0,9999,0
1656812516219,MATH 197,004,095571,Perols; Johan Lars,9998,0,9999,1
1656812523269,COGS 9,A01,083615,Shannon; Kyle Michael,6,0,75,69
1656812529294,COGS 11,A01,083617,Boyle; Mary E. T.,18,0,48,30
1656812535321,COGS 13,A01,083071,Bastos; Amalia Pinkusfeld,8,0,71,63
1656812541344,COGS 14A,A01,092681,Semenuks; Arturs,0,1,100,100
1656812547368,COGS 14B,A01,083073,Cheng; Tzu-Han,5,0,63,58
1656812553395,COGS 17,A01,092677,Semenuks; Arturs,4,0,81,77
1656812559421,COGS 100,A01,083619,Allen; Michael Gordon,15,0,70,55
1656812565443,COGS 101A,A01,083621,Davis; Joshua Daniel,9,0,68,59
1656812571468,COGS 101B,A01,091572,Allen; Michael Gordon,8,0,65,57
1656812577494,COGS 101C,A01,083625,Delgado; Tania,17,0,35,18
1656812583528,COGS 107A,A01,083627,Boyle; Mary E. T.,13,0,60,47
1656812589553,COGS 118A,A01,083075,Gupta; Anjum,15,0,76,61
1656812595576,CSE 3,A50,083646,Miranda; Gregory Joseph,22,0,50,28
1656812601598,CSE 8A,A50,083650,Miranda; Gregory Joseph,17,1,56,39
1656812607621,CSE 11,A01,083080,Cao; Yingjun,4,15,40,36
1656812613644,CSE 12,A01,083652,Krause-Levy; Sophia Louisa,20,1,120,100
1656812619670,CSE 15L,A01,083654,Morris; Justin Loren,8,0,50,42
1656812619670,CSE 15L,A02,083655,Morris; Justin Loren,8,0,50,42
1656812625697,CSE 20,A01,083657,Tran; Khoa Dang,37,0,80,43
1656812631718,CSE 21,A01,095574,Bach; Quang Tran,21,0,48,27
1656812637746,CSE 30,A01,083084,Eldon; John,4,0,80,76
1656812637746,CSE 30,B01,095061,Bhaskar; Nishant,5,0,50,45
1656812643772,CSE 100,A01,083659,Cao; Yingjun,1,4,70,69
1656812649806,CSE 134B,A01,083661,Powell; Thomas Allan,18,0,100,82
1656812655832,CSE 140,A01,083663,Gungor; Onat,14,0,85,71
1656812661856,CSE 140L,A01,083088,Eldon; John,16,0,100,84
1656812667882,CSE 175,A01,083665,Kumar; Rakesh,3,0,25,22
1656812673910,CSE 190,A00,092507,Dubnov; Shlomo,7,0,20,13
1656812679932,ECE 45,A01,083139,Congero; Spencer William,5,0,75,70
1656812685957,ECE 65,A50,083695,Saad; Andrew S,12,0,30,18
1656812685957,ECE 65,A51,095125,Saad; Andrew S,25,0,26,1
1656812691980,ECE 109,A01,091882,Touri; Behrouz,15,0,70,55
1656812698003,ECE 180,A00,083140,Abi Samra; Nicholas Camill,0,0,30,30
1656812698003,ECE 180,B00,083141,Abi Samra; Nicholas Camill,0,0,30,30
1656812704026,MATH 10A,A01,083735,Patchell; Gregory David,1,0,30,29
1656812704026,MATH 10A,A02,083736,Patchell; Gregory David,20,0,30,10
1656812704026,MATH 10A,A03,083737,Patchell; Gregory David,15,0,30,15
1656812710050,MATH 10B,A01,083207,Lim; Seonhee,7,0,34,27
1656812710050,MATH 10B,A02,083208,Lim; Seonhee,9,0,35,26
1656812710050,MATH 10B,A03,093472,Lim; Seonhee,4,0,34,30
1656812710050,MATH 10B,B01,083739,Sinha; Shubham,9,0,30,21
1656812716081,MATH 18,A01,083743,Cinel; Cameron Alexander,6,0,30,24
1656812716081,MATH 18,A02,083744,Cinel; Cameron Alexander,15,0,30,15
1656812716081,MATH 18,A03,083745,Cinel; Cameron Alexander,8,0,30,22
1656812716081,MATH 18,B01,083748,Rideout; David Porter,3,0,37,34
1656812716081,MATH 18,B02,083749,Rideout; David Porter,3,0,36,33
1656812716081,MATH 18,B03,083750,Rideout; David Porter,1,0,37,36
1656812716081,MATH 18,B04,083751,Rideout; David Porter,5,0,36,31
1656812716081,MATH 18,B05,093473,Rideout; David Porter,4,0,36,32
1656812716081,MATH 18,B06,093474,Rideout; David Porter,5,0,36,31
1656812722104,MATH 20A,A01,083754,Zheng; Zequn,12,0,40,28
1656812728130,MATH 20B,A01,083756,Briones; Jor-el Thomas Caparas,1,0,36,35
1656812728130,MATH 20B,A02,083757,Briones; Jor-el Thomas Caparas,1,0,36,35
1656812728130,MATH 20B,A03,093475,Briones; Jor-el Thomas Caparas,0,0,36,36
1656812734170,MATH 20C,A01,083760,Briones; Jor-el Thomas Caparas,1,0,35,34
1656812734170,MATH 20C,A02,083761,Briones; Jor-el Thomas Caparas,8,0,35,27
1656812734170,MATH 20C,A03,093476,Briones; Jor-el Thomas Caparas,0,1,36,36
1656812734170,MATH 20C,B01,083762,Bach; Quang Tran,0,0,30,30
1656812740200,MATH 20D,A01,083765,Tran; Brian Kha,4,0,30,26
1656812740200,MATH 20D,A02,083766,Tran; Brian Kha,4,0,30,26
1656812740200,MATH 20D,A03,083767,Tran; Brian Kha,2,0,30,28
1656812746228,MATH 20E,A01,083771,Ganguly; Soumya,5,0,32,27
1656812746228,MATH 20E,A02,083772,Ganguly; Soumya,5,0,32,27
1656812746228,MATH 20E,B01,083773,Ciotti; Benjamin,18,0,35,17
1656812746228,MATH 20E,B02,083774,Ciotti; Benjamin,17,0,35,18
1656812752255,MATH 103A,A01,083777,Greenfeld; Be'Eri,2,0,36,34
1656812752255,MATH 103A,A02,083778,Greenfeld; Be'Eri,5,0,36,31
1656812752255,MATH 103A,A03,093561,Greenfeld; Be'Eri,4,0,36,32
1656812752255,MATH 103A,B01,083779,Greenfeld; Be'Eri,6,0,36,30
1656812752255,MATH 103A,B02,083780,Greenfeld; Be'Eri,2,0,36,34
1656812752255,MATH 103A,B03,093562,Greenfeld; Be'Eri,2,0,36,34
1656812758282,MATH 105,A01,085443,Carter; Anne Toulson,13,0,35,22
1656812758282,MATH 105,A02,093477,Carter; Anne Toulson,20,0,35,15
1656812764363,MATH 109,A01,083213,Ganzberger; Geoffrey Michael,2,0,34,32
1656812764363,MATH 109,A02,083214,Ganzberger; Geoffrey Michael,2,0,34,32
1656812764363,MATH 109,A03,093478,Ganzberger; Geoffrey Michael,1,0,34,33
1656812764363,MATH 109,B01,083215,Ganzberger; Geoffrey Michael,1,0,32,31
1656812764363,MATH 109,B02,083216,Ganzberger; Geoffrey Michael,1,0,32,31
1656812764363,MATH 109,B03,093479,Ganzberger; Geoffrey Michael,6,0,32,26
1656812770387,MATH 142A,A01,083219,Chow; Bennett,6,0,32,26
1656812770387,MATH 142A,A02,083220,Chow; Bennett,9,0,32,23
1656812770387,MATH 142A,A03,093480,Chow; Bennett,7,0,32,25
1656812770387,MATH 142A,B03,093481,Chow; Bennett,7,0,32,25
1656812770387,MATH 142A,B04,093558,Chow; Bennett,10,0,32,22
1656812770387,MATH 142A,B05,093559,Chow; Bennett,6,0,32,26
1656812776411,MATH 193A,A01,083224,Rotar; Vladimir,6,0,34,28
1656812776411,MATH 193A,A02,083225,Rotar; Vladimir,3,0,34,31
1656812776411,MATH 193A,A03,083781,Rotar; Vladimir,1,0,34,33
1656812776411,MATH 193A,A04,083782,Rotar; Vladimir,6,0,34,28
1656812776411,MATH 193A,A05,093482,Rotar; Vladimir,6,0,34,28
1656812782435,MATH 197,001,091859,McAuley; Julian John,9999,0,9999,0
1656812782435,MATH 197,002,095566,Kedlaya; Kiran S.,9997,0,9999,2
1656812782435,MATH 197,003,095567,Xiao; Ming,9999,0,9999,0
1656812782435,MATH 197,004,095571,Perols; Johan Lars,9998,0,9999,1
1656812789503,COGS 9,A01,083615,Shannon; Kyle Michael,6,0,75,69
1656812795530,COGS 11,A01,083617,Boyle; Mary E. T.,18,0,48,30
1656812801552,COGS 13,A01,083071,Bastos; Amalia Pinkusfeld,8,0,71,63
1656812807576,COGS 14A,A01,092681,Semenuks; Arturs,0,1,100,100
1656812813599,COGS 14B,A01,083073,Cheng; Tzu-Han,5,0,63,58
1656812819623,COGS 17,A01,092677,Semenuks; Arturs,4,0,81,77
1656812825647,COGS 100,A01,083619,Allen; Michael Gordon,15,0,70,55
1656812831682,COGS 101A,A01,083621,Davis; Joshua Daniel,9,0,68,59
1656812837710,COGS 101B,A01,091572,Allen; Michael Gordon,8,0,65,57
1656812843750,COGS 101C,A01,083625,Delgado; Tania,17,0,35,18
1656812849778,COGS 107A,A01,083627,Boyle; Mary E. T.,13,0,60,47
1656812855803,COGS 118A,A01,083075,Gupta; Anjum,15,0,76,61
1656812861826,CSE 3,A50,083646,Miranda; Gregory Joseph,22,0,50,28
1656812867857,CSE 8A,A50,083650,Miranda; Gregory Joseph,17,1,56,39
1656812873883,CSE 11,A01,083080,Cao; Yingjun,4,15,40,36
1656812879908,CSE 12,A01,083652,Krause-Levy; Sophia Louisa,20,1,120,100
1656812885931,CSE 15L,A01,083654,Morris; Justin Loren,8,0,50,42
1656812885931,CSE 15L,A02,083655,Morris; Justin Loren,8,0,50,42
1656812891968,CSE 20,A01,083657,Tran; Khoa Dang,37,0,80,43
1656812897993,CSE 21,A01,095574,Bach; Quang Tran,21,0,48,27
1656812904017,CSE 30,A01,083084,Eldon; John,4,0,80,76
1656812904017,CSE 30,B01,095061,Bhaskar; Nishant,6,0,50,44
1656812910040,CSE 100,A01,083659,Cao; Yingjun,1,4,70,69
1656812916064,CSE 134B,A01,083661,Powell; Thomas Allan,18,0,100,82
1656812922090,CSE 140,A01,083663,Gungor; Onat,14,0,85,71
1656812928114,CSE 140L,A01,083088,Eldon; John,16,0,100,84
1656812934138,CSE 175,A01,083665,Kumar; Rakesh,3,0,25,22
1656812940160,CSE 190,A00,092507,Dubnov; Shlomo,7,0,20,13
1656812946188,ECE 45,A01,083139,Congero; Spencer William,5,0,75,70
1656812952211,ECE 65,A50,083695,Saad; Andrew S,12,0,30,18
1656812952211,ECE 65,A51,095125,Saad; Andrew S,25,0,26,1
1656812958234,ECE 109,A01,091882,Touri; Behrouz,15,0,70,55
1656812964257,ECE 180,A00,083140,Abi Samra; Nicholas Camill,0,0,30,30
1656812964257,ECE 180,B00,083141,Abi Samra; Nicholas Camill,0,0,30,30
1656812970286,MATH 10A,A01,083735,Patchell; Gregory David,1,0,30,29
1656812970286,MATH 10A,A02,083736,Patchell; Gregory David,20,0,30,10
1656812970286,MATH 10A,A03,083737,Patchell; Gregory David,15,0,30,15
1656812976313,MATH 10B,A01,083207,Lim; Seonhee,7,0,34,27
1656812976313,MATH 10B,A02,083208,Lim; Seonhee,9,0,35,26
1656812976313,MATH 10B,A03,093472,Lim; Seonhee,4,0,34,30
1656812976313,MATH 10B,B01,083739,Sinha; Shubham,9,0,30,21
1656812982339,MATH 18,A01,083743,Cinel; Cameron Alexander,6,0,30,24
1656812982339,MATH 18,A02,083744,Cinel; Cameron Alexander,15,0,30,15
1656812982339,MATH 18,A03,083745,Cinel; Cameron Alexander,8,0,30,22
1656812982339,MATH 18,B01,083748,Rideout; David Porter,3,0,37,34
1656812982339,MATH 18,B02,083749,Rideout; David Porter,3,0,36,33
1656812982339,MATH 18,B03,083750,Rideout; David Porter,1,0,37,36
1656812982339,MATH 18,B04,083751,Rideout; David Porter,5,0,36,31
1656812982339,MATH 18,B05,093473,Rideout; David Porter,4,0,36,32
1656812982339,MATH 18,B06,093474,Rideout; David Porter,5,0,36,31
1656812988363,MATH 20A,A01,083754,Zheng; Zequn,12,0,40,28
1656812994386,MATH 20B,A01,083756,Briones; Jor-el Thomas Caparas,1,0,36,35
1656812994386,MATH 20B,A02,083757,Briones; Jor-el Thomas Caparas,1,0,36,35
1656812994386,MATH 20B,A03,093475,Briones; Jor-el Thomas Caparas,0,0,36,36
1656813000408,MATH 20C,A01,083760,Briones; Jor-el Thomas Caparas,1,0,35,34
1656813000408,MATH 20C,A02,083761,Briones; Jor-el Thomas Caparas,8,0,35,27
1656813000408,MATH 20C,A03,093476,Briones; Jor-el Thomas Caparas,0,1,36,36
1656813000408,MATH 20C,B01,083762,Bach; Quang Tran,0,0,30,30
1656813006436,MATH 20D,A01,083765,Tran; Brian Kha,4,0,30,26
1656813006436,MATH 20D,A02,083766,Tran; Brian Kha,4,0,30,26
1656813006436,MATH 20D,A03,083767,Tran; Brian Kha,2,0,30,28
1656813012460,MATH 20E,A01,083771,Ganguly; Soumya,5,0,32,27
1656813012460,MATH 20E,A02,083772,Ganguly; Soumya,5,0,32,27
1656813012460,MATH 20E,B01,083773,Ciotti; Benjamin,18,0,35,17
1656813012460,MATH 20E,B02,083774,Ciotti; Benjamin,17,0,35,18
1656813018485,MATH 103A,A01,083777,Greenfeld; Be'Eri,2,0,36,34
1656813018485,MATH 103A,A02,083778,Greenfeld; Be'Eri,5,0,36,31
1656813018485,MATH 103A,A03,093561,Greenfeld; Be'Eri,4,0,36,32
1656813018485,MATH 103A,B01,083779,Greenfeld; Be'Eri,6,0,36,30
1656813018485,MATH 103A,B02,083780,Greenfeld; Be'Eri,2,0,36,34
1656813018485,MATH 103A,B03,093562,Greenfeld; Be'Eri,2,0,36,34
1656813024510,MATH 105,A01,085443,Carter; Anne Toulson,13,0,35,22
1656813024510,MATH 105,A02,093477,Carter; Anne Toulson,20,0,35,15
1656813030535,MATH 109,A01,083213,Ganzberger; Geoffrey Michael,2,0,34,32
1656813030535,MATH 109,A02,083214,Ganzberger; Geoffrey Michael,2,0,34,32
1656813030535,MATH 109,A03,093478,Ganzberger; Geoffrey Michael,1,0,34,33
1656813030535,MATH 109,B01,083215,Ganzberger; Geoffrey Michael,1,0,32,31
1656813030535,MATH 109,B02,083216,Ganzberger; Geoffrey Michael,1,0,32,31
1656813030535,MATH 109,B03,093479,Ganzberger; Geoffrey Michael,6,0,32,26
1656813036568,MATH 142A,A01,083219,Chow; Bennett,6,0,32,26
1656813036568,MATH 142A,A02,083220,Chow; Bennett,9,0,32,23
1656813036568,MATH 142A,A03,093480,Chow; Bennett,7,0,32,25
1656813036568,MATH 142A,B03,093481,Chow; Bennett,7,0,32,25
1656813036568,MATH 142A,B04,093558,Chow; Bennett,10,0,32,22
1656813036568,MATH 142A,B05,093559,Chow; Bennett,6,0,32,26
1656813042604,MATH 193A,A01,083224,Rotar; Vladimir,6,0,34,28
1656813042604,MATH 193A,A02,083225,Rotar; Vladimir,3,0,34,31
1656813042604,MATH 193A,A03,083781,Rotar; Vladimir,1,0,34,33
1656813042604,MATH 193A,A04,083782,Rotar; Vladimir,6,0,34,28
1656813042604,MATH 193A,A05,093482,Rotar; Vladimir,6,0,34,28
1656813048626,MATH 197,001,091859,McAuley; Julian John,9999,0,9999,0
1656813048626,MATH 197,002,095566,Kedlaya; Kiran S.,9997,0,9999,2
1656813048626,MATH 197,003,095567,Xiao; Ming,9999,0,9999,0
1656813048626,MATH 197,004,095571,Perols; Johan Lars,9998,0,9999,1
1656813055706,COGS 9,A01,083615,Shannon; Kyle Michael,6,0,75,69
1656813061730,COGS 11,A01,083617,Boyle; Mary E. T.,18,0,48,30
1656813067756,COGS 13,A01,083071,Bastos; Amalia Pinkusfeld,8,0,71,63
1656813073816,COGS 14A,A01,092681,Semenuks; Arturs,0,1,100,100
1656813079843,COGS 14B,A01,083073,Cheng; Tzu-Han,5,0,63,58
1656813085869,COGS 17,A01,092677,Semenuks; Arturs,4,0,81,77
1656813091896,COGS 100,A01,083619,Allen; Michael Gordon,15,0,70,55
1656813097919,COGS 101A,A01,083621,Davis; Joshua Daniel,9,0,68,59
1656813104024,COGS 101B,A01,091572,Allen; Michael Gordon,8,0,65,57
1656813110050,COGS 101C,A01,083625,Delgado; Tania,17,0,35,18
1656813116076,COGS 107A,A01,083627,Boyle; Mary E. T.,13,0,60,47
1656813122099,COGS 118A,A01,083075,Gupta; Anjum,15,0,76,61
1656813128123,CSE 3,A50,083646,Miranda; Gregory Joseph,22,0,50,28
1656813134158,CSE 8A,A50,083650,Miranda; Gregory Joseph,17,1,56,39
1656813140185,CSE 11,A01,083080,Cao; Yingjun,4,15,40,36
1656813146213,CSE 12,A01,083652,Krause-Levy; Sophia Louisa,20,1,120,100
1656813152237,CSE 15L,A01,083654,Morris; Justin Loren,8,0,50,42
1656813152237,CSE 15L,A02,083655,Morris; Justin Loren,8,0,50,42
1656813158259,CSE 20,A01,083657,Tran; Khoa Dang,37,0,80,43
1656813164284,CSE 21,A01,095574,Bach; Quang Tran,21,0,48,27
1656813170306,CSE 30,A01,083084,Eldon; John,4,0,80,76
1656813170306,CSE 30,B01,095061,Bhaskar; Nishant,6,0,50,44
1656813176329,CSE 100,A01,083659,Cao; Yingjun,1,4,70,69
1656813182351,CSE 134B,A01,083661,Powell; Thomas Allan,18,0,100,82
1656813188376,CSE 140,A01,083663,Gungor; Onat,14,0,85,71
1656813194398,CSE 140L,A01,083088,Eldon; John,16,0,100,84
1656813200423,CSE 175,A01,083665,Kumar; Rakesh,3,0,25,22
1656813206446,CSE 190,A00,092507,Dubnov; Shlomo,7,0,20,13
1656813212472,ECE 45,A01,083139,Congero; Spencer William,5,0,75,70
1656813218500,ECE 65,A50,083695,Saad; Andrew S,12,0,30,18
1656813218500,ECE 65,A51,095125,Saad; Andrew S,25,0,26,1
1656813224523,ECE 109,A01,091882,Touri; Behrouz,15,0,70,55
1656813230550,ECE 180,A00,083140,Abi Samra; Nicholas Camill,0,0,30,30
1656813230550,ECE 180,B00,083141,Abi Samra; Nicholas Camill,0,0,30,30
1656813236579,MATH 10A,A01,083735,Patchell; Gregory David,1,0,30,29
1656813236579,MATH 10A,A02,083736,Patchell; Gregory David,20,0,30,10
1656813236579,MATH 10A,A03,083737,Patchell; Gregory David,15,0,30,15
1656813242607,MATH 10B,A01,083207,Lim; Seonhee,7,0,34,27
1656813242607,MATH 10B,A02,083208,Lim; Seonhee,9,0,35,26
1656813242607,MATH 10B,A03,093472,Lim; Seonhee,4,0,34,30
1656813242607,MATH 10B,B01,083739,Sinha; Shubham,9,0,30,21
1656813248630,MATH 18,A01,083743,Cinel; Cameron Alexander,6,0,30,24
1656813248630,MATH 18,A02,083744,Cinel; Cameron Alexander,15,0,30,15
1656813248630,MATH 18,A03,083745,Cinel; Cameron Alexander,8,0,30,22
1656813248630,MATH 18,B01,083748,Rideout; David Porter,3,0,37,34
1656813248630,MATH 18,B02,083749,Rideout; David Porter,3,0,36,33
1656813248630,MATH 18,B03,083750,Rideout; David Porter,1,0,37,36
1656813248630,MATH 18,B04,083751,Rideout; David Porter,5,0,36,31
1656813248630,MATH 18,B05,093473,Rideout; David Porter,4,0,36,32
1656813248630,MATH 18,B06,093474,Rideout; David Porter,5,0,36,31
1656813254659,MATH 20A,A01,083754,Zheng; Zequn,12,0,40,28
1656813260683,MATH 20B,A01,083756,Briones; Jor-el Thomas Caparas,1,0,36,35
1656813260683,MATH 20B,A02,083757,Briones; Jor-el Thomas Caparas,1,0,36,35
1656813260683,MATH 20B,A03,093475,Briones; Jor-el Thomas Caparas,0,0,36,36
1656813266705,MATH 20C,A01,083760,Briones; Jor-el Thomas Caparas,1,0,35,34
1656813266705,MATH 20C,A02,083761,Briones; Jor-el Thomas Caparas,8,0,35,27
1656813266705,MATH 20C,A03,093476,Briones; Jor-el Thomas Caparas,0,1,36,36
1656813266705,MATH 20C,B01,083762,Bach; Quang Tran,0,0,30,30
1656813272740,MATH 20D,A01,083765,Tran; Brian Kha,4,0,30,26
1656813272740,MATH 20D,A02,083766,Tran; Brian Kha,4,0,30,26
1656813272740,MATH 20D,A03,083767,Tran; Brian Kha,2,0,30,28
1656813278773,MATH 20E,A01,083771,Ganguly; Soumya,5,0,32,27
1656813278773,MATH 20E,A02,083772,Ganguly; Soumya,5,0,32,27
1656813278773,MATH 20E,B01,083773,Ciotti; Benjamin,18,0,35,17
1656813278773,MATH 20E,B02,083774,Ciotti; Benjamin,17,0,35,18
1656813284809,MATH 103A,A01,083777,Greenfeld; Be'Eri,2,0,36,34
1656813284809,MATH 103A,A02,083778,Greenfeld; Be'Eri,5,0,36,31
1656813284809,MATH 103A,A03,093561,Greenfeld; Be'Eri,4,0,36,32
1656813284809,MATH 103A,B01,083779,Greenfeld; Be'Eri,6,0,36,30
1656813284809,MATH 103A,B02,083780,Greenfeld; Be'Eri,2,0,36,34
1656813284809,MATH 103A,B03,093562,Greenfeld; Be'Eri,2,0,36,34
1656813290833,MATH 105,A01,085443,Carter; Anne Toulson,13,0,35,22
1656813290833,MATH 105,A02,093477,Carter; Anne Toulson,20,0,35,15
1656813296858,MATH 109,A01,083213,Ganzberger; Geoffrey Michael,2,0,34,32
1656813296858,MATH 109,A02,083214,Ganzberger; Geoffrey Michael,2,0,34,32
1656813296858,MATH 109,A03,093478,Ganzberger; Geoffrey Michael,1,0,34,33
1656813296858,MATH 109,B01,083215,Ganzberger; Geoffrey Michael,1,0,32,31
1656813296858,MATH 109,B02,083216,Ganzberger; Geoffrey Michael,1,0,32,31
1656813296858,MATH 109,B03,093479,Ganzberger; Geoffrey Michael,6,0,32,26
1656813302883,MATH 142A,A01,083219,Chow; Bennett,6,0,32,26
1656813302883,MATH 142A,A02,083220,Chow; Bennett,9,0,32,23
1656813302883,MATH 142A,A03,093480,Chow; Bennett,7,0,32,25
1656813302883,MATH 142A,B03,093481,Chow; Bennett,7,0,32,25
1656813302883,MATH 142A,B04,093558,Chow; Bennett,10,0,32,22
1656813302883,MATH 142A,B05,093559,Chow; Bennett,6,0,32,26
1656813308911,MATH 193A,A01,083224,Rotar; Vladimir,6,0,34,28
1656813308911,MATH 193A,A02,083225,Rotar; Vladimir,3,0,34,31
1656813308911,MATH 193A,A03,083781,Rotar; Vladimir,1,0,34,33
1656813308911,MATH 193A,A04,083782,Rotar; Vladimir,6,0,34,28
1656813308911,MATH 193A,A05,093482,Rotar; Vladimir,6,0,34,28
1656813314935,MATH 197,001,091859,McAuley; Julian John,9999,0,9999,0
1656813314935,MATH 197,002,095566,Kedlaya; Kiran S.,9997,0,9999,2
1656813314935,MATH 197,003,095567,Xiao; Ming,9999,0,9999,0
1656813314935,MATH 197,004,095571,Perols; Johan Lars,9998,0,9999,1
1656813321985,COGS 9,A01,083615,Shannon; Kyle Michael,6,0,75,69
1656813328008,COGS 11,A01,083617,Boyle; Mary E. T.,18,0,48,30
1656813334035,COGS 13,A01,083071,Bastos; Amalia Pinkusfeld,8,0,71,63
1656813340060,COGS 14A,A01,092681,Semenuks; Arturs,0,1,100,100
1656813346090,COGS 14B,A01,083073,Cheng; Tzu-Han,5,0,63,58
1656813352113,COGS 17,A01,092677,Semenuks; Arturs,4,0,81,77
1656813358139,COGS 100,A01,083619,Allen; Michael Gordon,15,0,70,55
1656813364162,COGS 101A,A01,083621,Davis; Joshua Daniel,9,0,68,59
1656813370184,COGS 101B,A01,091572,Allen; Michael Gordon,8,0,65,57
1656813376218,COGS 101C,A01,083625,Delgado; Tania,17,0,35,18
1656813382244,COGS 107A,A01,083627,Boyle; Mary E. T.,13,0,60,47
1656813388275,COGS 118A,A01,083075,Gupta; Anjum,15,0,76,61
1656813394302,CSE 3,A50,083646,Miranda; Gregory Joseph,22,0,50,28
1656813400326,CSE 8A,A50,083650,Miranda; Gregory Joseph,17,1,56,39
1656813406353,CSE 11,A01,083080,Cao; Yingjun,4,15,40,36
1656813412376,CSE 12,A01,083652,Krause-Levy; Sophia Louisa,20,1,120,100
1656813418400,CSE 15L,A01,083654,Morris; Justin Loren,8,0,50,42
1656813418400,CSE 15L,A02,083655,Morris; Justin Loren,8,0,50,42
1656813424423,CSE 20,A01,083657,Tran; Khoa Dang,37,0,80,43
1656813430446,CSE 21,A01,095574,Bach; Quang Tran,21,0,48,27
1656813436468,CSE 30,A01,083084,Eldon; John,4,0,80,76
1656813436468,CSE 30,B01,095061,Bhaskar; Nishant,6,0,50,44
1656813442498,CSE 100,A01,083659,Cao; Yingjun,1,4,70,69
1656813448520,CSE 134B,A01,083661,Powell; Thomas Allan,18,0,100,82
1656813454545,CSE 140,A01,083663,Gungor; Onat,14,0,85,71
1656813460569,CSE 140L,A01,083088,Eldon; John,16,0,100,84
1656813466590,CSE 175,A01,083665,Kumar; Rakesh,3,0,25,22
1656813472614,CSE 190,A00,092507,Dubnov; Shlomo,7,0,20,13
1656813478652,ECE 45,A01,083139,Congero; Spencer William,5,0,75,70
1656813484679,ECE 65,A50,083695,Saad; Andrew S,12,0,30,18
1656813484679,ECE 65,A51,095125,Saad; Andrew S,25,0,26,1
1656813490701,ECE 109,A01,091882,Touri; Behrouz,15,0,70,55
1656813496727,ECE 180,A00,083140,Abi Samra; Nicholas Camill,0,0,30,30
1656813496727,ECE 180,B00,083141,Abi Samra; Nicholas Camill,0,0,30,30
1656813502753,MATH 10A,A01,083735,Patchell; Gregory David,1,0,30,29
1656813502753,MATH 10A,A02,083736,Patchell; Gregory David,20,0,30,10
1656813502753,MATH 10A,A03,083737,Patchell; Gregory David,15,0,30,15
1656813508776,MATH 10B,A01,083207,Lim; Seonhee,7,0,34,27
1656813508776,MATH 10B,A02,083208,Lim; Seonhee,9,0,35,26
1656813508776,MATH 10B,A03,093472,Lim; Seonhee,4,0,34,30
1656813508776,MATH 10B,B01,083739,Sinha; Shubham,9,0,30,21
1656813514800,MATH 18,A01,083743,Cinel; Cameron Alexander,6,0,30,24
1656813514800,MATH 18,A02,083744,Cinel; Cameron Alexander,15,0,30,15
1656813514800,MATH 18,A03,083745,Cinel; Cameron Alexander,8,0,30,22
1656813514800,MATH 18,B01,083748,Rideout; David Porter,3,0,37,34
1656813514800,MATH 18,B02,083749,Rideout; David Porter,3,0,36,33
1656813514800,MATH 18,B03,083750,Rideout; David Porter,1,0,37,36
1656813514800,MATH 18,B04,083751,Rideout; David Porter,5,0,36,31
1656813514800,MATH 18,B05,093473,Rideout; David Porter,4,0,36,32
1656813514800,MATH 18,B06,093474,Rideout; David Porter,5,0,36,31
1656813520822,MATH 20A,A01,083754,Zheng; Zequn,12,0,40,28
1656813526849,MATH 20B,A01,083756,Briones; Jor-el Thomas Caparas,1,0,36,35
1656813526849,MATH 20B,A02,083757,Briones; Jor-el Thomas Caparas,1,0,36,35
1656813526849,MATH 20B,A03,093475,Briones; Jor-el Thomas Caparas,0,0,36,36
1656813532876,MATH 20C,A01,083760,Briones; Jor-el Thomas Caparas,1,0,35,34
1656813532876,MATH 20C,A02,083761,Briones; Jor-el Thomas Caparas,8,0,35,27
1656813532876,MATH 20C,A03,093476,Briones; Jor-el Thomas Caparas,0,1,36,36
1656813532876,MATH 20C,B01,083762,Bach; Quang Tran,0,0,30,30
1656813538898,MATH 20D,A01,083765,Tran; Brian Kha,4,0,30,26
1656813538898,MATH 20D,A02,083766,Tran; Brian Kha,4,0,30,26
1656813538898,MATH 20D,A03,083767,Tran; Brian Kha,2,0,30,28
1656813544926,MATH 20E,A01,083771,Ganguly; Soumya,5,0,32,27
1656813544926,MATH 20E,A02,083772,Ganguly; Soumya,5,0,32,27
1656813544926,MATH 20E,B01,083773,Ciotti; Benjamin,18,0,35,17
1656813544926,MATH 20E,B02,083774,Ciotti; Benjamin,17,0,35,18
1656813550953,MATH 103A,A01,083777,Greenfeld; Be'Eri,2,0,36,34
1656813550953,MATH 103A,A02,083778,Greenfeld; Be'Eri,5,0,36,31
1656813550953,MATH 103A,A03,093561,Greenfeld; Be'Eri,4,0,36,32
1656813550953,MATH 103A,B01,083779,Greenfeld; Be'Eri,6,0,36,30
1656813550953,MATH 103A,B02,083780,Greenfeld; Be'Eri,2,0,36,34
1656813550953,MATH 103A,B03,093562,Greenfeld; Be'Eri,2,0,36,34
1656813556981,MATH 105,A01,085443,Carter; Anne Toulson,13,0,35,22
1656813556981,MATH 105,A02,093477,Carter; Anne Toulson,20,0,35,15
1656813563011,MATH 109,A01,083213,Ganzberger; Geoffrey Michael,2,0,34,32
1656813563011,MATH 109,A02,083214,Ganzberger; Geoffrey Michael,2,0,34,32
1656813563011,MATH 109,A03,093478,Ganzberger; Geoffrey Michael,1,0,34,33
1656813563011,MATH 109,B01,083215,Ganzberger; Geoffrey Michael,1,0,32,31
1656813563011,MATH 109,B02,083216,Ganzberger; Geoffrey Michael,1,0,32,31
1656813563011,MATH 109,B03,093479,Ganzberger; Geoffrey Michael,6,0,32,26
1656813569042,MATH 142A,A01,083219,Chow; Bennett,6,0,32,26
1656813569042,MATH 142A,A02,083220,Chow; Bennett,9,0,32,23
1656813569042,MATH 142A,A03,093480,Chow; Bennett,7,0,32,25
1656813569042,MATH 142A,B03,093481,Chow; Bennett,7,0,32,25
1656813569042,MATH 142A,B04,093558,Chow; Bennett,10,0,32,22
1656813569042,MATH 142A,B05,093559,Chow; Bennett,6,0,32,26
1656813575064,MATH 193A,A01,083224,Rotar; Vladimir,6,0,34,28
1656813575064,MATH 193A,A02,083225,Rotar; Vladimir,3,0,34,31
1656813575064,MATH 193A,A03,083781,Rotar; Vladimir,1,0,34,33
1656813575064,MATH 193A,A04,083782,Rotar; Vladimir,6,0,34,28
1656813575064,MATH 193A,A05,093482,Rotar; Vladimir,6,0,34,28
1656813581090,MATH 197,001,091859,McAuley; Julian John,9999,0,9999,0
1656813581090,MATH 197,002,095566,Kedlaya; Kiran S.,9997,0,9999,2
1656813581090,MATH 197,003,095567,Xiao; Ming,9999,0,9999,0
1656813581090,MATH 197,004,095571,Perols; Johan Lars,9998,0,9999,1
1656813588149,COGS 9,A01,083615,Shannon; Kyle Michael,6,0,75,69
1656813594173,COGS 11,A01,083617,Boyle; Mary E. T.,18,0,48,30
1656813600196,COGS 13,A01,083071,Bastos; Amalia Pinkusfeld,8,0,71,63
1656813606223,COGS 14A,A01,092681,Semenuks; Arturs,0,1,100,100
1656813612249,COGS 14B,A01,083073,Cheng; Tzu-Han,5,0,63,58
1656813618275,COGS 17,A01,092677,Semenuks; Arturs,4,0,81,77
1656813624300,COGS 100,A01,083619,Allen; Michael Gordon,15,0,70,55
1656813630326,COGS 101A,A01,083621,Davis; Joshua Daniel,9,0,68,59
1656813636350,COGS 101B,A01,091572,Allen; Michael Gordon,8,0,65,57
1656813642378,COGS 101C,A01,083625,Delgado; Tania,17,0,35,18
1656813648403,COGS 107A,A01,083627,Boyle; Mary E. T.,13,0,60,47
1656813654426,COGS 118A,A01,083075,Gupta; Anjum,15,0,76,61
1656813660450,CSE 3,A50,083646,Miranda; Gregory Joseph,22,0,50,28
1656813666477,CSE 8A,A50,083650,Miranda; Gregory Joseph,17,1,56,39
1656813672502,CSE 11,A01,083080,Cao; Yingjun,4,15,40,36
1656813678524,CSE 12,A01,083652,Krause-Levy; Sophia Louisa,20,1,120,100
1656813684548,CSE 15L,A01,083654,Morris; Justin Loren,8,0,50,42
1656813684548,CSE 15L,A02,083655,Morris; Justin Loren,8,0,50,42
1656813690572,CSE 20,A01,083657,Tran; Khoa Dang,37,0,80,43
1656813696604,CSE 21,A01,095574,Bach; Quang Tran,21,0,48,27
1656813702724,CSE 30,A01,083084,Eldon; John,4,0,80,76
1656813702724,CSE 30,B01,095061,Bhaskar; Nishant,6,0,50,44
1656813708751,CSE 100,A01,083659,Cao; Yingjun,1,4,70,69
1656813714774,CSE 134B,A01,083661,Powell; Thomas Allan,18,0,100,82
1656813720804,CSE 140,A01,083663,Gungor; Onat,14,0,85,71
1656813726837,CSE 140L,A01,083088,Eldon; John,16,0,100,84
1656813732864,CSE 175,A01,083665,Kumar; Rakesh,3,0,25,22
1656813738899,CSE 190,A00,092507,Dubnov; Shlomo,7,0,20,13
1656813744922,ECE 45,A01,083139,Congero; Spencer William,5,0,75,70
1656813750945,ECE 65,A50,083695,Saad; Andrew S,12,0,30,18
1656813750945,ECE 65,A51,095125,Saad; Andrew S,25,0,26,1
1656813756969,ECE 109,A01,091882,Touri; Behrouz,15,0,70,55
1656813762992,ECE 180,A00,083140,Abi Samra; Nicholas Camill,0,0,30,30
1656813762992,ECE 180,B00,083141,Abi Samra; Nicholas Camill,0,0,30,30
1656813769029,MATH 10A,A01,083735,Patchell; Gregory David,1,0,30,29
1656813769029,MATH 10A,A02,083736,Patchell; Gregory David,20,0,30,10
1656813769029,MATH 10A,A03,083737,Patchell; Gregory David,15,0,30,15
1656813775053,MATH 10B,A01,083207,Lim; Seonhee,7,0,34,27
1656813775053,MATH 10B,A02,083208,Lim; Seonhee,9,0,35,26
1656813775053,MATH 10B,A03,093472,Lim; Seonhee,4,0,34,30
1656813775053,MATH 10B,B01,083739,Sinha; Shubham,9,0,30,21
1656813781087,MATH 18,A01,083743,Cinel; Cameron Alexander,6,0,30,24
1656813781087,MATH 18,A02,083744,Cinel; Cameron Alexander,15,0,30,15
1656813781087,MATH 18,A03,083745,Cinel; Cameron Alexander,8,0,30,22
1656813781087,MATH 18,B01,083748,Rideout; David Porter,3,0,37,34
1656813781087,MATH 18,B02,083749,Rideout; David Porter,3,0,36,33
1656813781087,MATH 18,B03,083750,Rideout; David Porter,1,0,37,36
1656813781087,MATH 18,B04,083751,Rideout; David Porter,5,0,36,31
1656813781087,MATH 18,B05,093473,Rideout; David Porter,4,0,36,32
1656813781087,MATH 18,B06,093474,Rideout; David Porter,5,0,36,31
1656813787109,MATH 20A,A01,083754,Zheng; Zequn,12,0,40,28
1656813793132,MATH 20B,A01,083756,Briones; Jor-el Thomas Caparas,1,0,36,35
1656813793132,MATH 20B,A02,083757,Briones; Jor-el Thomas Caparas,1,0,36,35
1656813793132,MATH 20B,A03,093475,Briones; Jor-el Thomas Caparas,0,0,36,36
1656813799155,MATH 20C,A01,083760,Briones; Jor-el Thomas Caparas,1,0,35,34
1656813799155,MATH 20C,A02,083761,Briones; Jor-el Thomas Caparas,8,0,35,27
1656813799155,MATH 20C,A03,093476,Briones; Jor-el Thomas Caparas,0,1,36,36
1656813799155,MATH 20C,B01,083762,Bach; Quang Tran,0,0,30,30
1656813805179,MATH 20D,A01,083765,Tran; Brian Kha,4,0,30,26
1656813805179,MATH 20D,A02,083766,Tran; Brian Kha,4,0,30,26
1656813805179,MATH 20D,A03,083767,Tran; Brian Kha,2,0,30,28
1656813811204,MATH 20E,A01,083771,Ganguly; Soumya,5,0,32,27
1656813811204,MATH 20E,A02,083772,Ganguly; Soumya,5,0,32,27
1656813811204,MATH 20E,B01,083773,Ciotti; Benjamin,18,0,35,17
1656813811204,MATH 20E,B02,083774,Ciotti; Benjamin,17,0,35,18
1656813817226,MATH 103A,A01,083777,Greenfeld; Be'Eri,2,0,36,34
1656813817226,MATH 103A,A02,083778,Greenfeld; Be'Eri,5,0,36,31
1656813817226,MATH 103A,A03,093561,Greenfeld; Be'Eri,4,0,36,32
1656813817226,MATH 103A,B01,083779,Greenfeld; Be'Eri,6,0,36,30
1656813817226,MATH 103A,B02,083780,Greenfeld; Be'Eri,2,0,36,34
1656813817226,MATH 103A,B03,093562,Greenfeld; Be'Eri,2,0,36,34
1656813823255,MATH 105,A01,085443,Carter; Anne Toulson,13,0,35,22
1656813823255,MATH 105,A02,093477,Carter; Anne Toulson,20,0,35,15
1656813829281,MATH 109,A01,083213,Ganzberger; Geoffrey Michael,2,0,34,32
1656813829281,MATH 109,A02,083214,Ganzberger; Geoffrey Michael,2,0,34,32
1656813829281,MATH 109,A03,093478,Ganzberger; Geoffrey Michael,1,0,34,33
1656813829281,MATH 109,B01,083215,Ganzberger; Geoffrey Michael,1,0,32,31
1656813829281,MATH 109,B02,083216,Ganzberger; Geoffrey Michael,1,0,32,31
1656813829281,MATH 109,B03,093479,Ganzberger; Geoffrey Michael,6,0,32,26
1656813835311,MATH 142A,A01,083219,Chow; Bennett,6,0,32,26
1656813835311,MATH 142A,A02,083220,Chow; Bennett,9,0,32,23
1656813835311,MATH 142A,A03,093480,Chow; Bennett,7,0,32,25
1656813835311,MATH 142A,B03,093481,Chow; Bennett,7,0,32,25
1656813835311,MATH 142A,B04,093558,Chow; Bennett,10,0,32,22
1656813835311,MATH 142A,B05,093559,Chow; Bennett,6,0,32,26
1656813841340,MATH 193A,A01,083224,Rotar; Vladimir,6,0,34,28
1656813841340,MATH 193A,A02,083225,Rotar; Vladimir,3,0,34,31
1656813841340,MATH 193A,A03,083781,Rotar; Vladimir,1,0,34,33
1656813841340,MATH 193A,A04,083782,Rotar; Vladimir,6,0,34,28
1656813841340,MATH 193A,A05,093482,Rotar; Vladimir,6,0,34,28
1656813847372,MATH 197,001,091859,McAuley; Julian John,9999,0,9999,0
1656813847372,MATH 197,002,095566,Kedlaya; Kiran S.,9997,0,9999,2
1656813847372,MATH 197,003,095567,Xiao; Ming,9999,0,9999,0
1656813847372,MATH 197,004,095571,Perols; Johan Lars,9998,0,9999,1
1656813854426,COGS 9,A01,083615,Shannon; Kyle Michael,6,0,75,69
1656813860452,COGS 11,A01,083617,Boyle; Mary E. T.,18,0,48,30
1656813866476,COGS 13,A01,083071,Bastos; Amalia Pinkusfeld,8,0,71,63
1656813872499,COGS 14A,A01,092681,Semenuks; Arturs,0,1,100,100
1656813878521,COGS 14B,A01,083073,Cheng; Tzu-Han,5,0,63,58
1656813884545,COGS 17,A01,092677,Semenuks; Arturs,4,0,81,77
1656813890571,COGS 100,A01,083619,Allen; Michael Gordon,15,0,70,55
1656813896595,COGS 101A,A01,083621,Davis; Joshua Daniel,9,0,68,59
1656813902628,COGS 101B,A01,091572,Allen; Michael Gordon,8,0,65,57
1656813908650,COGS 101C,A01,083625,Delgado; Tania,17,0,35,18
1656813914673,COGS 107A,A01,083627,Boyle; Mary E. T.,13,0,60,47
1656813920698,COGS 118A,A01,083075,Gupta; Anjum,15,0,76,61
1656813926730,CSE 3,A50,083646,Miranda; Gregory Joseph,22,0,50,28
1656813932760,CSE 8A,A50,083650,Miranda; Gregory Joseph,17,1,56,39
1656813938784,CSE 11,A01,083080,Cao; Yingjun,4,15,40,36
1656813944807,CSE 12,A01,083652,Krause-Levy; Sophia Louisa,20,1,120,100
1656813950832,CSE 15L,A01,083654,Morris; Justin Loren,8,0,50,42
1656813950832,CSE 15L,A02,083655,Morris; Justin Loren,8,0,50,42
1656813956858,CSE 20,A01,083657,Tran; Khoa Dang,37,0,80,43
1656813962884,CSE 21,A01,095574,Bach; Quang Tran,21,0,48,27
1656813968912,CSE 30,A01,083084,Eldon; John,4,0,80,76
1656813968912,CSE 30,B01,095061,Bhaskar; Nishant,6,0,50,44
1656813974939,CSE 100,A01,083659,Cao; Yingjun,1,4,70,69
1656813980966,CSE 134B,A01,083661,Powell; Thomas Allan,18,0,100,82
1656813986994,CSE 140,A01,083663,Gungor; Onat,14,0,85,71
1656813993018,CSE 140L,A01,083088,Eldon; John,16,0,100,84
1656813999041,CSE 175,A01,083665,Kumar; Rakesh,3,0,25,22
1656814005068,CSE 190,A00,092507,Dubnov; Shlomo,7,0,20,13
1656814011090,ECE 45,A01,083139,Congero; Spencer William,5,0,75,70
1656814017119,ECE 65,A50,083695,Saad; Andrew S,12,0,30,18
1656814017119,ECE 65,A51,095125,Saad; Andrew S,25,0,26,1
1656814023153,ECE 109,A01,091882,Touri; Behrouz,15,0,70,55
1656814029184,ECE 180,A00,083140,Abi Samra; Nicholas Camill,0,0,30,30
1656814029184,ECE 180,B00,083141,Abi Samra; Nicholas Camill,0,0,30,30
1656814035210,MATH 10A,A01,083735,Patchell; Gregory David,1,0,30,29
1656814035210,MATH 10A,A02,083736,Patchell; Gregory David,20,0,30,10
1656814035210,MATH 10A,A03,083737,Patchell; Gregory David,15,0,30,15
1656814041239,MATH 10B,A01,083207,Lim; Seonhee,7,0,34,27
1656814041239,MATH 10B,A02,083208,Lim; Seonhee,9,0,35,26
1656814041239,MATH 10B,A03,093472,Lim; Seonhee,4,0,34,30
1656814041239,MATH 10B,B01,083739,Sinha; Shubham,9,0,30,21
1656814047266,MATH 18,A01,083743,Cinel; Cameron Alexander,6,0,30,24
1656814047266,MATH 18,A02,083744,Cinel; Cameron Alexander,15,0,30,15
1656814047266,MATH 18,A03,083745,Cinel; Cameron Alexander,8,0,30,22
1656814047266,MATH 18,B01,083748,Rideout; David Porter,3,0,37,34
1656814047266,MATH 18,B02,083749,Rideout; David Porter,3,0,36,33
1656814047266,MATH 18,B03,083750,Rideout; David Porter,1,0,37,36
1656814047266,MATH 18,B04,083751,Rideout; David Porter,5,0,36,31
1656814047266,MATH 18,B05,093473,Rideout; David Porter,4,0,36,32
1656814047266,MATH 18,B06,093474,Rideout; David Porter,5,0,36,31
1656814053293,MATH 20A,A01,083754,Zheng; Zequn,12,0,40,28
1656814059317,MATH 20B,A01,083756,Briones; Jor-el Thomas Caparas,1,0,36,35
1656814059317,MATH 20B,A02,083757,Briones; Jor-el Thomas Caparas,1,0,36,35
1656814059317,MATH 20B,A03,093475,Briones; Jor-el Thomas Caparas,0,0,36,36
1656814065340,MATH 20C,A01,083760,Briones; Jor-el Thomas Caparas,1,0,35,34
1656814065340,MATH 20C,A02,083761,Briones; Jor-el Thomas Caparas,8,0,35,27
1656814065340,MATH 20C,A03,093476,Briones; Jor-el Thomas Caparas,0,1,36,36
1656814065340,MATH 20C,B01,083762,Bach; Quang Tran,0,0,30,30
1656814071363,MATH 20D,A01,083765,Tran; Brian Kha,4,0,30,26
1656814071363,MATH 20D,A02,083766,Tran; Brian Kha,4,0,30,26
1656814071363,MATH 20D,A03,083767,Tran; Brian Kha,2,0,30,28
1656814077388,MATH 20E,A01,083771,Ganguly; Soumya,5,0,32,27
1656814077388,MATH 20E,A02,083772,Ganguly; Soumya,5,0,32,27
1656814077388,MATH 20E,B01,083773,Ciotti; Benjamin,18,0,35,17
1656814077388,MATH 20E,B02,083774,Ciotti; Benjamin,17,0,35,18
1656814083416,MATH 103A,A01,083777,Greenfeld; Be'Eri,2,0,36,34
1656814083416,MATH 103A,A02,083778,Greenfeld; Be'Eri,5,0,36,31
1656814083416,MATH 103A,A03,093561,Greenfeld; Be'Eri,4,0,36,32
1656814083416,MATH 103A,B01,083779,Greenfeld; Be'Eri,6,0,36,30
1656814083416,MATH 103A,B02,083780,Greenfeld; Be'Eri,2,0,36,34
1656814083416,MATH 103A,B03,093562,Greenfeld; Be'Eri,2,0,36,34
1656814089442,MATH 105,A01,085443,Carter; Anne Toulson,13,0,35,22
1656814089442,MATH 105,A02,093477,Carter; Anne Toulson,20,0,35,15
1656814095469,MATH 109,A01,083213,Ganzberger; Geoffrey Michael,2,0,34,32
1656814095469,MATH 109,A02,083214,Ganzberger; Geoffrey Michael,2,0,34,32
1656814095469,MATH 109,A03,093478,Ganzberger; Geoffrey Michael,1,0,34,33
1656814095469,MATH 109,B01,083215,Ganzberger; Geoffrey Michael,1,0,32,31
1656814095469,MATH 109,B02,083216,Ganzberger; Geoffrey Michael,1,0,32,31
1656814095469,MATH 109,B03,093479,Ganzberger; Geoffrey Michael,6,0,32,26
1656814101498,MATH 142A,A01,083219,Chow; Bennett,6,0,32,26
1656814101498,MATH 142A,A02,083220,Chow; Bennett,9,0,32,23
1656814101498,MATH 142A,A03,093480,Chow; Bennett,7,0,32,25
1656814101498,MATH 142A,B03,093481,Chow; Bennett,7,0,32,25
1656814101498,MATH 142A,B04,093558,Chow; Bennett,10,0,32,22
1656814101498,MATH 142A,B05,093559,Chow; Bennett,6,0,32,26
1656814107525,MATH 193A,A01,083224,Rotar; Vladimir,6,0,34,28
1656814107525,MATH 193A,A02,083225,Rotar; Vladimir,3,0,34,31
1656814107525,MATH 193A,A03,083781,Rotar; Vladimir,1,0,34,33
1656814107525,MATH 193A,A04,083782,Rotar; Vladimir,6,0,34,28
1656814107525,MATH 193A,A05,093482,Rotar; Vladimir,6,0,34,28
1656814113562,MATH 197,001,091859,McAuley; Julian John,9999,0,9999,0
1656814113562,MATH 197,002,095566,Kedlaya; Kiran S.,9997,0,9999,2
1656814113562,MATH 197,003,095567,Xiao; Ming,9999,0,9999,0
1656814113562,MATH 197,004,095571,Perols; Johan Lars,9998,0,9999,1
1656814120613,COGS 9,A01,083615,Shannon; Kyle Michael,6,0,75,69
1656814126636,COGS 11,A01,083617,Boyle; Mary E. T.,18,0,48,30
1656814132662,COGS 13,A01,083071,Bastos; Amalia Pinkusfeld,8,0,71,63
1656814138685,COGS 14A,A01,092681,Semenuks; Arturs,0,1,100,100
1656814144708,COGS 14B,A01,083073,Cheng; Tzu-Han,5,0,63,58
1656814150731,COGS 17,A01,092677,Semenuks; Arturs,4,0,81,77
1656814156757,COGS 100,A01,083619,Allen; Michael Gordon,15,0,70,55
1656814162781,COGS 101A,A01,083621,Davis; Joshua Daniel,9,0,68,59
1656814168803,COGS 101B,A01,091572,Allen; Michael Gordon,8,0,65,57
1656814174826,COGS 101C,A01,083625,Delgado; Tania,17,0,35,18
1656814180850,COGS 107A,A01,083627,Boyle; Mary E. T.,13,0,60,47
1656814186872,COGS 118A,A01,083075,Gupta; Anjum,15,0,76,61
1656814192896,CSE 3,A50,083646,Miranda; Gregory Joseph,22,0,50,28
1656814198920,CSE 8A,A50,083650,Miranda; Gregory Joseph,17,1,56,39
1656814204942,CSE 11,A01,083080,Cao; Yingjun,4,15,40,36
1656814210965,CSE 12,A01,083652,Krause-Levy; Sophia Louisa,20,1,120,100
1656814216988,CSE 15L,A01,083654,Morris; Justin Loren,8,0,50,42
1656814216988,CSE 15L,A02,083655,Morris; Justin Loren,8,0,50,42
1656814223010,CSE 20,A01,083657,Tran; Khoa Dang,37,0,80,43
1656814229054,CSE 21,A01,095574,Bach; Quang Tran,21,0,48,27
1656814235082,CSE 30,A01,083084,Eldon; John,4,0,80,76
1656814235082,CSE 30,B01,095061,Bhaskar; Nishant,6,0,50,44
1656814241110,CSE 100,A01,083659,Cao; Yingjun,1,4,70,69
1656814247136,CSE 134B,A01,083661,Powell; Thomas Allan,18,0,100,82
1656814253160,CSE 140,A01,083663,Gungor; Onat,14,0,85,71
1656814259186,CSE 140L,A01,083088,Eldon; John,16,0,100,84
1656814265220,CSE 175,A01,083665,Kumar; Rakesh,3,0,25,22
1656814271258,CSE 190,A00,092507,Dubnov; Shlomo,7,0,20,13
1656814277280,ECE 45,A01,083139,Congero; Spencer William,5,0,75,70
1656814283306,ECE 65,A50,083695,Saad; Andrew S,12,0,30,18
1656814283306,ECE 65,A51,095125,Saad; Andrew S,25,0,26,1
1656814289330,ECE 109,A01,091882,Touri; Behrouz,15,0,70,55
1656814295357,ECE 180,A00,083140,Abi Samra; Nicholas Camill,0,0,30,30
1656814295357,ECE 180,B00,083141,Abi Samra; Nicholas Camill,0,0,30,30
1656814301472,MATH 10A,A01,083735,Patchell; Gregory David,1,0,30,29
1656814301472,MATH 10A,A02,083736,Patchell; Gregory David,20,0,30,10
1656814301472,MATH 10A,A03,083737,Patchell; Gregory David,15,0,30,15
1656814307501,MATH 10B,A01,083207,Lim; Seonhee,7,0,34,27
1656814307501,MATH 10B,A02,083208,Lim; Seonhee,9,0,35,26
1656814307501,MATH 10B,A03,093472,Lim; Seonhee,4,0,34,30
1656814307501,MATH 10B,B01,083739,Sinha; Shubham,9,0,30,21
1656814313527,MATH 18,A01,083743,Cinel; Cameron Alexander,6,0,30,24
1656814313527,MATH 18,A02,083744,Cinel; Cameron Alexander,15,0,30,15
1656814313527,MATH 18,A03,083745,Cinel; Cameron Alexander,8,0,30,22
1656814313527,MATH 18,B01,083748,Rideout; David Porter,3,0,37,34
1656814313527,MATH 18,B02,083749,Rideout; David Porter,3,0,36,33
1656814313527,MATH 18,B03,083750,Rideout; David Porter,1,0,37,36
1656814313527,MATH 18,B04,083751,Rideout; David Porter,5,0,36,31
1656814313527,MATH 18,B05,093473,Rideout; David Porter,4,0,36,32
1656814313527,MATH 18,B06,093474,Rideout; David Porter,5,0,36,31
1656814319554,MATH 20A,A01,083754,Zheng; Zequn,12,0,40,28
1656814325584,MATH 20B,A01,083756,Briones; Jor-el Thomas Caparas,1,0,36,35
1656814325584,MATH 20B,A02,083757,Briones; Jor-el Thomas Caparas,1,0,36,35
1656814325584,MATH 20B,A03,093475,Briones; Jor-el Thomas Caparas,0,0,36,36
1656814331609,MATH 20C,A01,083760,Briones; Jor-el Thomas Caparas,1,0,35,34
1656814331609,MATH 20C,A02,083761,Briones; Jor-el Thomas Caparas,8,0,35,27
1656814331609,MATH 20C,A03,093476,Briones; Jor-el Thomas Caparas,0,1,36,36
1656814331609,MATH 20C,B01,083762,Bach; Quang Tran,0,0,30,30
1656814337630,MATH 20D,A01,083765,Tran; Brian Kha,4,0,30,26
1656814337630,MATH 20D,A02,083766,Tran; Brian Kha,4,0,30,26
1656814337630,MATH 20D,A03,083767,Tran; Brian Kha,2,0,30,28
1656814343657,MATH 20E,A01,083771,Ganguly; Soumya,5,0,32,27
1656814343657,MATH 20E,A02,083772,Ganguly; Soumya,5,0,32,27
1656814343657,MATH 20E,B01,083773,Ciotti; Benjamin,18,0,35,17
1656814343657,MATH 20E,B02,083774,Ciotti; Benjamin,17,0,35,18
1656814349681,MATH 103A,A01,083777,Greenfeld; Be'Eri,2,0,36,34
1656814349681,MATH 103A,A02,083778,Greenfeld; Be'Eri,5,0,36,31
1656814349681,MATH 103A,A03,093561,Greenfeld; Be'Eri,4,0,36,32
1656814349681,MATH 103A,B01,083779,Greenfeld; Be'Eri,6,0,36,30
1656814349681,MATH 103A,B02,083780,Greenfeld; Be'Eri,2,0,36,34
1656814349681,MATH 103A,B03,093562,Greenfeld; Be'Eri,2,0,36,34
1656814355704,MATH 105,A01,085443,Carter; Anne Toulson,13,0,35,22
1656814355704,MATH 105,A02,093477,Carter; Anne Toulson,20,0,35,15
1656814361733,MATH 109,A01,083213,Ganzberger; Geoffrey Michael,2,0,34,32
1656814361733,MATH 109,A02,083214,Ganzberger; Geoffrey Michael,2,0,34,32
1656814361733,MATH 109,A03,093478,Ganzberger; Geoffrey Michael,1,0,34,33
1656814361733,MATH 109,B01,083215,Ganzberger; Geoffrey Michael,1,0,32,31
1656814361733,MATH 109,B02,083216,Ganzberger; Geoffrey Michael,1,0,32,31
1656814361733,MATH 109,B03,093479,Ganzberger; Geoffrey Michael,6,0,32,26
1656814367762,MATH 142A,A01,083219,Chow; Bennett,6,0,32,26
1656814367762,MATH 142A,A02,083220,Chow; Bennett,9,0,32,23
1656814367762,MATH 142A,A03,093480,Chow; Bennett,7,0,32,25
1656814367762,MATH 142A,B03,093481,Chow; Bennett,7,0,32,25
1656814367762,MATH 142A,B04,093558,Chow; Bennett,10,0,32,22
1656814367762,MATH 142A,B05,093559,Chow; Bennett,6,0,32,26
1656814373786,MATH 193A,A01,083224,Rotar; Vladimir,6,0,34,28
1656814373786,MATH 193A,A02,083225,Rotar; Vladimir,3,0,34,31
1656814373786,MATH 193A,A03,083781,Rotar; Vladimir,1,0,34,33
1656814373786,MATH 193A,A04,083782,Rotar; Vladimir,6,0,34,28
1656814373786,MATH 193A,A05,093482,Rotar; Vladimir,6,0,34,28
1656814379813,MATH 197,001,091859,McAuley; Julian John,9999,0,9999,0
1656814379813,MATH 197,002,095566,Kedlaya; Kiran S.,9997,0,9999,2
1656814379813,MATH 197,003,095567,Xiao; Ming,9999,0,9999,0
1656814379813,MATH 197,004,095571,Perols; Johan Lars,9998,0,9999,1
1656814386865,COGS 9,A01,083615,Shannon; Kyle Michael,6,0,75,69
1656814392891,COGS 11,A01,083617,Boyle; Mary E. T.,18,0,48,30
1656814398917,COGS 13,A01,083071,Bastos; Amalia Pinkusfeld,8,0,71,63
1656814404944,COGS 14A,A01,092681,Semenuks; Arturs,0,1,100,100
1656814410967,COGS 14B,A01,083073,Cheng; Tzu-Han,5,0,63,58
1656814416992,COGS 17,A01,092677,Semenuks; Arturs,4,0,81,77
1656814423016,COGS 100,A01,083619,Allen; Michael Gordon,15,0,70,55
1656814429044,COGS 101A,A01,083621,Davis; Joshua Daniel,9,0,68,59
1656814435069,COGS 101B,A01,091572,Allen; Michael Gordon,8,0,65,57
1656814441093,COGS 101C,A01,083625,Delgado; Tania,17,0,35,18
1656814447119,COGS 107A,A01,083627,Boyle; Mary E. T.,13,0,60,47
1656814453146,COGS 118A,A01,083075,Gupta; Anjum,15,0,76,61
1656814459171,CSE 3,A50,083646,Miranda; Gregory Joseph,22,0,50,28
1656814465198,CSE 8A,A50,083650,Miranda; Gregory Joseph,17,1,56,39
1656814471224,CSE 11,A01,083080,Cao; Yingjun,4,15,40,36
1656814477252,CSE 12,A01,083652,Krause-Levy; Sophia Louisa,20,1,120,100
1656814483284,CSE 15L,A01,083654,Morris; Justin Loren,8,0,50,42
1656814483284,CSE 15L,A02,083655,Morris; Justin Loren,8,0,50,42
1656814489312,CSE 20,A01,083657,Tran; Khoa Dang,37,0,80,43
1656814495340,CSE 21,A01,095574,Bach; Quang Tran,21,0,48,27
1656814501367,CSE 30,A01,083084,Eldon; John,4,0,80,76
1656814501367,CSE 30,B01,095061,Bhaskar; Nishant,6,0,50,44
1656814507389,CSE 100,A01,083659,Cao; Yingjun,1,4,70,69
1656814513414,CSE 134B,A01,083661,Powell; Thomas Allan,18,0,100,82
1656814519442,CSE 140,A01,083663,Gungor; Onat,14,0,85,71
1656814525469,CSE 140L,A01,083088,Eldon; John,16,0,100,84
1656814531496,CSE 175,A01,083665,Kumar; Rakesh,3,0,25,22
1656814537518,CSE 190,A00,092507,Dubnov; Shlomo,7,0,20,13
1656814543546,ECE 45,A01,083139,Congero; Spencer William,5,0,75,70
1656814549569,ECE 65,A50,083695,Saad; Andrew S,12,0,30,18
1656814549569,ECE 65,A51,095125,Saad; Andrew S,25,0,26,1
1656814555591,ECE 109,A01,091882,Touri; Behrouz,15,0,70,55
1656814561622,ECE 180,A00,083140,Abi Samra; Nicholas Camill,0,0,30,30
1656814561622,ECE 180,B00,083141,Abi Samra; Nicholas Camill,0,0,30,30
1656814567645,MATH 10A,A01,083735,Patchell; Gregory David,1,0,30,29
1656814567645,MATH 10A,A02,083736,Patchell; Gregory David,20,0,30,10
1656814567645,MATH 10A,A03,083737,Patchell; Gregory David,15,0,30,15
1656814573667,MATH 10B,A01,083207,Lim; Seonhee,7,0,34,27
1656814573667,MATH 10B,A02,083208,Lim; Seonhee,9,0,35,26
1656814573667,MATH 10B,A03,093472,Lim; Seonhee,4,0,34,30
1656814573667,MATH 10B,B01,083739,Sinha; Shubham,9,0,30,21
1656814579692,MATH 18,A01,083743,Cinel; Cameron Alexander,6,0,30,24
1656814579692,MATH 18,A02,083744,Cinel; Cameron Alexander,15,0,30,15
1656814579692,MATH 18,A03,083745,Cinel; Cameron Alexander,8,0,30,22
1656814579692,MATH 18,B01,083748,Rideout; David Porter,3,0,37,34
1656814579692,MATH 18,B02,083749,Rideout; David Porter,3,0,36,33
1656814579692,MATH 18,B03,083750,Rideout; David Porter,1,0,37,36
1656814579692,MATH 18,B04,083751,Rideout; David Porter,5,0,36,31
1656814579692,MATH 18,B05,093473,Rideout; David Porter,4,0,36,32
1656814579692,MATH 18,B06,093474,Rideout; David Porter,5,0,36,31
1656814585713,MATH 20A,A01,083754,Zheng; Zequn,12,0,40,28
1656814591745,MATH 20B,A01,083756,Briones; Jor-el Thomas Caparas,1,0,36,35
1656814591745,MATH 20B,A02,083757,Briones; Jor-el Thomas Caparas,1,0,36,35
1656814591745,MATH 20B,A03,093475,Briones; Jor-el Thomas Caparas,0,0,36,36
1656814597768,MATH 20C,A01,083760,Briones; Jor-el Thomas Caparas,1,0,35,34
1656814597768,MATH 20C,A02,083761,Briones; Jor-el Thomas Caparas,8,0,35,27
1656814597768,MATH 20C,A03,093476,Briones; Jor-el Thomas Caparas,0,1,36,36
1656814597768,MATH 20C,B01,083762,Bach; Quang Tran,0,0,30,30
1656814603791,MATH 20D,A01,083765,Tran; Brian Kha,4,0,30,26
1656814603791,MATH 20D,A02,083766,Tran; Brian Kha,4,0,30,26
1656814603791,MATH 20D,A03,083767,Tran; Brian Kha,2,0,30,28
1656814609813,MATH 20E,A01,083771,Ganguly; Soumya,5,0,32,27
1656814609813,MATH 20E,A02,083772,Ganguly; Soumya,5,0,32,27
1656814609813,MATH 20E,B01,083773,Ciotti; Benjamin,18,0,35,17
1656814609813,MATH 20E,B02,083774,Ciotti; Benjamin,17,0,35,18
1656814615841,MATH 103A,A01,083777,Greenfeld; Be'Eri,2,0,36,34
1656814615841,MATH 103A,A02,083778,Greenfeld; Be'Eri,5,0,36,31
1656814615841,MATH 103A,A03,093561,Greenfeld; Be'Eri,4,0,36,32
1656814615841,MATH 103A,B01,083779,Greenfeld; Be'Eri,6,0,36,30
1656814615841,MATH 103A,B02,083780,Greenfeld; Be'Eri,2,0,36,34
1656814615841,MATH 103A,B03,093562,Greenfeld; Be'Eri,2,0,36,34
1656814621867,MATH 105,A01,085443,Carter; Anne Toulson,13,0,35,22
1656814621867,MATH 105,A02,093477,Carter; Anne Toulson,20,0,35,15
1656814627896,MATH 109,A01,083213,Ganzberger; Geoffrey Michael,2,0,34,32
1656814627896,MATH 109,A02,083214,Ganzberger; Geoffrey Michael,2,0,34,32
1656814627896,MATH 109,A03,093478,Ganzberger; Geoffrey Michael,1,0,34,33
1656814627896,MATH 109,B01,083215,Ganzberger; Geoffrey Michael,1,0,32,31
1656814627896,MATH 109,B02,083216,Ganzberger; Geoffrey Michael,1,0,32,31
1656814627896,MATH 109,B03,093479,Ganzberger; Geoffrey Michael,6,0,32,26
1656814633921,MATH 142A,A01,083219,Chow; Bennett,6,0,32,26
1656814633921,MATH 142A,A02,083220,Chow; Bennett,9,0,32,23
1656814633921,MATH 142A,A03,093480,Chow; Bennett,7,0,32,25
1656814633921,MATH 142A,B03,093481,Chow; Bennett,7,0,32,25
1656814633921,MATH 142A,B04,093558,Chow; Bennett,10,0,32,22
1656814633921,MATH 142A,B05,093559,Chow; Bennett,6,0,32,26
1656814639951,MATH 193A,A01,083224,Rotar; Vladimir,6,0,34,28
1656814639951,MATH 193A,A02,083225,Rotar; Vladimir,3,0,34,31
1656814639951,MATH 193A,A03,083781,Rotar; Vladimir,1,0,34,33
1656814639951,MATH 193A,A04,083782,Rotar; Vladimir,6,0,34,28
1656814639951,MATH 193A,A05,093482,Rotar; Vladimir,6,0,34,28
1656814645988,MATH 197,001,091859,McAuley; Julian John,9999,0,9999,0
1656814645988,MATH 197,002,095566,Kedlaya; Kiran S.,9997,0,9999,2
1656814645988,MATH 197,003,095567,Xiao; Ming,9999,0,9999,0
1656814645988,MATH 197,004,095571,Perols; Johan Lars,9998,0,9999,1
1656814653054,COGS 9,A01,083615,Shannon; Kyle Michael,6,0,75,69
1656814659076,COGS 11,A01,083617,Boyle; Mary E. T.,18,0,48,30
1656814665101,COGS 13,A01,083071,Bastos; Amalia Pinkusfeld,8,0,71,63
1656814671136,COGS 14A,A01,092681,Semenuks; Arturs,0,1,100,100
1656814677159,COGS 14B,A01,083073,Cheng; Tzu-Han,5,0,63,58
1656814683185,COGS 17,A01,092677,Semenuks; Arturs,4,0,81,77
1656814689207,COGS 100,A01,083619,Allen; Michael Gordon,15,0,70,55
1656814695228,COGS 101A,A01,083621,Davis; Joshua Daniel,9,0,68,59
1656814701251,COGS 101B,A01,091572,Allen; Michael Gordon,8,0,65,57
1656814707274,COGS 101C,A01,083625,Delgado; Tania,17,0,35,18
1656814713300,COGS 107A,A01,083627,Boyle; Mary E. T.,13,0,60,47
1656814719322,COGS 118A,A01,083075,Gupta; Anjum,15,0,76,61
1656814725348,CSE 3,A50,083646,Miranda; Gregory Joseph,22,0,50,28
1656814731375,CSE 8A,A50,083650,Miranda; Gregory Joseph,17,1,56,39
1656814737400,CSE 11,A01,083080,Cao; Yingjun,4,15,40,36
1656814743424,CSE 12,A01,083652,Krause-Levy; Sophia Louisa,20,1,120,100
1656814749451,CSE 15L,A01,083654,Morris; Justin Loren,8,0,50,42
1656814749451,CSE 15L,A02,083655,Morris; Justin Loren,8,0,50,42
1656814755477,CSE 20,A01,083657,Tran; Khoa Dang,37,0,80,43
1656814761504,CSE 21,A01,095574,Bach; Quang Tran,21,0,48,27
1656814767531,CSE 30,A01,083084,Eldon; John,4,0,80,76
1656814767531,CSE 30,B01,095061,Bhaskar; Nishant,6,0,50,44
1656814773553,CSE 100,A01,083659,Cao; Yingjun,1,4,70,69
1656814779578,CSE 134B,A01,083661,Powell; Thomas Allan,18,0,100,82
1656814785602,CSE 140,A01,083663,Gungor; Onat,14,0,85,71
1656814791625,CSE 140L,A01,083088,Eldon; John,16,0,100,84
1656814797655,CSE 175,A01,083665,Kumar; Rakesh,3,0,25,22
1656814803681,CSE 190,A00,092507,Dubnov; Shlomo,7,0,20,13
1656814809704,ECE 45,A01,083139,Congero; Spencer William,5,0,75,70
1656814815730,ECE 65,A50,083695,Saad; Andrew S,12,0,30,18
1656814815730,ECE 65,A51,095125,Saad; Andrew S,25,0,26,1
1656814821759,ECE 109,A01,091882,Touri; Behrouz,15,0,70,55
1656814827785,ECE 180,A00,083140,Abi Samra; Nicholas Camill,0,0,30,30
1656814827785,ECE 180,B00,083141,Abi Samra; Nicholas Camill,0,0,30,30
1656814833813,MATH 10A,A01,083735,Patchell; Gregory David,1,0,30,29
1656814833813,MATH 10A,A02,083736,Patchell; Gregory David,20,0,30,10
1656814833813,MATH 10A,A03,083737,Patchell; Gregory David,15,0,30,15
1656814839837,MATH 10B,A01,083207,Lim; Seonhee,7,0,34,27
1656814839837,MATH 10B,A02,083208,Lim; Seonhee,9,0,35,26
1656814839837,MATH 10B,A03,093472,Lim; Seonhee,4,0,34,30
1656814839837,MATH 10B,B01,083739,Sinha; Shubham,9,0,30,21
1656814845862,MATH 18,A01,083743,Cinel; Cameron Alexander,6,0,30,24
1656814845862,MATH 18,A02,083744,Cinel; Cameron Alexander,15,0,30,15
1656814845862,MATH 18,A03,083745,Cinel; Cameron Alexander,8,0,30,22
1656814845862,MATH 18,B01,083748,Rideout; David Porter,3,0,37,34
1656814845862,MATH 18,B02,083749,Rideout; David Porter,3,0,36,33
1656814845862,MATH 18,B03,083750,Rideout; David Porter,1,0,37,36
1656814845862,MATH 18,B04,083751,Rideout; David Porter,5,0,36,31
1656814845862,MATH 18,B05,093473,Rideout; David Porter,4,0,36,32
1656814845862,MATH 18,B06,093474,Rideout; David Porter,5,0,36,31
1656814851886,MATH 20A,A01,083754,Zheng; Zequn,12,0,40,28
1656814857910,MATH 20B,A01,083756,Briones; Jor-el Thomas Caparas,1,0,36,35
1656814857910,MATH 20B,A02,083757,Briones; Jor-el Thomas Caparas,1,0,36,35
1656814857910,MATH 20B,A03,093475,Briones; Jor-el Thomas Caparas,0,0,36,36
1656814863937,MATH 20C,A01,083760,Briones; Jor-el Thomas Caparas,1,0,35,34
1656814863937,MATH 20C,A02,083761,Briones; Jor-el Thomas Caparas,8,0,35,27
1656814863937,MATH 20C,A03,093476,Briones; Jor-el Thomas Caparas,0,1,36,36
1656814863937,MATH 20C,B01,083762,Bach; Quang Tran,0,0,30,30
1656814869962,MATH 20D,A01,083765,Tran; Brian Kha,4,0,30,26
1656814869962,MATH 20D,A02,083766,Tran; Brian Kha,4,0,30,26
1656814869962,MATH 20D,A03,083767,Tran; Brian Kha,2,0,30,28
1656814875992,MATH 20E,A01,083771,Ganguly; Soumya,5,0,32,27
1656814875992,MATH 20E,A02,083772,Ganguly; Soumya,5,0,32,27
1656814875992,MATH 20E,B01,083773,Ciotti; Benjamin,18,0,35,17
1656814875992,MATH 20E,B02,083774,Ciotti; Benjamin,17,0,35,18
1656814882022,MATH 103A,A01,083777,Greenfeld; Be'Eri,2,0,36,34
1656814882022,MATH 103A,A02,083778,Greenfeld; Be'Eri,5,0,36,31
1656814882022,MATH 103A,A03,093561,Greenfeld; Be'Eri,4,0,36,32
1656814882022,MATH 103A,B01,083779,Greenfeld; Be'Eri,6,0,36,30
1656814882022,MATH 103A,B02,083780,Greenfeld; Be'Eri,2,0,36,34
1656814882022,MATH 103A,B03,093562,Greenfeld; Be'Eri,2,0,36,34
1656814888048,MATH 105,A01,085443,Carter; Anne Toulson,13,0,35,22
1656814888048,MATH 105,A02,093477,Carter; Anne Toulson,20,0,35,15
1656814894080,MATH 109,A01,083213,Ganzberger; Geoffrey Michael,2,0,34,32
1656814894080,MATH 109,A02,083214,Ganzberger; Geoffrey Michael,2,0,34,32
1656814894080,MATH 109,A03,093478,Ganzberger; Geoffrey Michael,1,0,34,33
1656814894080,MATH 109,B01,083215,Ganzberger; Geoffrey Michael,1,0,32,31
1656814894080,MATH 109,B02,083216,Ganzberger; Geoffrey Michael,1,0,32,31
1656814894080,MATH 109,B03,093479,Ganzberger; Geoffrey Michael,6,0,32,26
1656814900188,MATH 142A,A01,083219,Chow; Bennett,6,0,32,26
1656814900188,MATH 142A,A02,083220,Chow; Bennett,9,0,32,23
1656814900188,MATH 142A,A03,093480,Chow; Bennett,7,0,32,25
1656814900188,MATH 142A,B03,093481,Chow; Bennett,7,0,32,25
1656814900188,MATH 142A,B04,093558,Chow; Bennett,10,0,32,22
1656814900188,MATH 142A,B05,093559,Chow; Bennett,6,0,32,26
1656814906212,MATH 193A,A01,083224,Rotar; Vladimir,6,0,34,28
1656814906212,MATH 193A,A02,083225,Rotar; Vladimir,3,0,34,31
1656814906212,MATH 193A,A03,083781,Rotar; Vladimir,1,0,34,33
1656814906212,MATH 193A,A04,083782,Rotar; Vladimir,6,0,34,28
1656814906212,MATH 193A,A05,093482,Rotar; Vladimir,6,0,34,28
1656814912235,MATH 197,001,091859,McAuley; Julian John,9999,0,9999,0
1656814912235,MATH 197,002,095566,Kedlaya; Kiran S.,9997,0,9999,2
1656814912235,MATH 197,003,095567,Xiao; Ming,9999,0,9999,0
1656814912235,MATH 197,004,095571,Perols; Johan Lars,9998,0,9999,1
1656814919292,COGS 9,A01,083615,Shannon; Kyle Michael,6,0,75,69
1656814925316,COGS 11,A01,083617,Boyle; Mary E. T.,18,0,48,30
1656814931339,COGS 13,A01,083071,Bastos; Amalia Pinkusfeld,8,0,71,63
1656814937360,COGS 14A,A01,092681,Semenuks; Arturs,0,1,100,100
1656814943387,COGS 14B,A01,083073,Cheng; Tzu-Han,5,0,63,58
1656814949414,COGS 17,A01,092677,Semenuks; Arturs,4,0,81,77
1656814955438,COGS 100,A01,083619,Allen; Michael Gordon,15,0,70,55
1656814961460,COGS 101A,A01,083621,Davis; Joshua Daniel,9,0,68,59
1656814967490,COGS 101B,A01,091572,Allen; Michael Gordon,8,0,65,57
1656814973513,COGS 101C,A01,083625,Delgado; Tania,17,0,35,18
1656814979541,COGS 107A,A01,083627,Boyle; Mary E. T.,13,0,60,47
1656814985564,COGS 118A,A01,083075,Gupta; Anjum,15,0,76,61
1656814991591,CSE 3,A50,083646,Miranda; Gregory Joseph,22,0,50,28
1656814997619,CSE 8A,A50,083650,Miranda; Gregory Joseph,17,1,56,39
1656815003643,CSE 11,A01,083080,Cao; Yingjun,4,15,40,36
1656815009665,CSE 12,A01,083652,Krause-Levy; Sophia Louisa,20,1,120,100
1656815015690,CSE 15L,A01,083654,Morris; Justin Loren,8,0,50,42
1656815015690,CSE 15L,A02,083655,Morris; Justin Loren,8,0,50,42
1656815021716,CSE 20,A01,083657,Tran; Khoa Dang,37,0,80,43
1656815027739,CSE 21,A01,095574,Bach; Quang Tran,21,0,48,27
1656815033764,CSE 30,A01,083084,Eldon; John,4,0,80,76
1656815033764,CSE 30,B01,095061,Bhaskar; Nishant,6,0,50,44
1656815039788,CSE 100,A01,083659,Cao; Yingjun,1,4,70,69
1656815045813,CSE 134B,A01,083661,Powell; Thomas Allan,18,0,100,82
1656815051837,CSE 140,A01,083663,Gungor; Onat,14,0,85,71
1656815057860,CSE 140L,A01,083088,Eldon; John,16,0,100,84
1656815063889,CSE 175,A01,083665,Kumar; Rakesh,3,0,25,22
1656815069918,CSE 190,A00,092507,Dubnov; Shlomo,7,0,20,13
1656815075943,ECE 45,A01,083139,Congero; Spencer William,5,0,75,70
1656815081967,ECE 65,A50,083695,Saad; Andrew S,12,0,30,18
1656815081967,ECE 65,A51,095125,Saad; Andrew S,25,0,26,1
1656815087990,ECE 109,A01,091882,Touri; Behrouz,15,0,70,55
1656815094019,ECE 180,A00,083140,Abi Samra; Nicholas Camill,0,0,30,30
1656815094019,ECE 180,B00,083141,Abi Samra; Nicholas Camill,0,0,30,30
1656815100045,MATH 10A,A01,083735,Patchell; Gregory David,1,0,30,29
1656815100045,MATH 10A,A02,083736,Patchell; Gregory David,20,0,30,10
1656815100045,MATH 10A,A03,083737,Patchell; Gregory David,15,0,30,15
1656815106074,MATH 10B,A01,083207,Lim; Seonhee,7,0,34,27
1656815106074,MATH 10B,A02,083208,Lim; Seonhee,9,0,35,26
1656815106074,MATH 10B,A03,093472,Lim; Seonhee,4,0,34,30
1656815106074,MATH 10B,B01,083739,Sinha; Shubham,9,0,30,21
1656815112102,MATH 18,A01,083743,Cinel; Cameron Alexander,6,0,30,24
1656815112102,MATH 18,A02,083744,Cinel; Cameron Alexander,15,0,30,15
1656815112102,MATH 18,A03,083745,Cinel; Cameron Alexander,8,0,30,22
1656815112102,MATH 18,B01,083748,Rideout; David Porter,3,0,37,34
1656815112102,MATH 18,B02,083749,Rideout; David Porter,3,0,36,33
1656815112102,MATH 18,B03,083750,Rideout; David Porter,1,0,37,36
1656815112102,MATH 18,B04,083751,Rideout; David Porter,5,0,36,31
1656815112102,MATH 18,B05,093473,Rideout; David Porter,4,0,36,32
1656815112102,MATH 18,B06,093474,Rideout; David Porter,5,0,36,31
1656815118135,MATH 20A,A01,083754,Zheng; Zequn,12,0,40,28
1656815124163,MATH 20B,A01,083756,Briones; Jor-el Thomas Caparas,1,0,36,35
1656815124163,MATH 20B,A02,083757,Briones; Jor-el Thomas Caparas,1,0,36,35
1656815124163,MATH 20B,A03,093475,Briones; Jor-el Thomas Caparas,0,0,36,36
1656815130197,MATH 20C,A01,083760,Briones; Jor-el Thomas Caparas,1,0,35,34
1656815130197,MATH 20C,A02,083761,Briones; Jor-el Thomas Caparas,8,0,35,27
1656815130197,MATH 20C,A03,093476,Briones; Jor-el Thomas Caparas,0,1,36,36
1656815130197,MATH 20C,B01,083762,Bach; Quang Tran,0,0,30,30
1656815136225,MATH 20D,A01,083765,Tran; Brian Kha,4,0,30,26
1656815136225,MATH 20D,A02,083766,Tran; Brian Kha,4,0,30,26
1656815136225,MATH 20D,A03,083767,Tran; Brian Kha,2,0,30,28
1656815142247,MATH 20E,A01,083771,Ganguly; Soumya,5,0,32,27
1656815142247,MATH 20E,A02,083772,Ganguly; Soumya,5,0,32,27
1656815142247,MATH 20E,B01,083773,Ciotti; Benjamin,18,0,35,17
1656815142247,MATH 20E,B02,083774,Ciotti; Benjamin,17,0,35,18
1656815148271,MATH 103A,A01,083777,Greenfeld; Be'Eri,2,0,36,34
1656815148271,MATH 103A,A02,083778,Greenfeld; Be'Eri,5,0,36,31
1656815148271,MATH 103A,A03,093561,Greenfeld; Be'Eri,4,0,36,32
1656815148271,MATH 103A,B01,083779,Greenfeld; Be'Eri,6,0,36,30
1656815148271,MATH 103A,B02,083780,Greenfeld; Be'Eri,2,0,36,34
1656815148271,MATH 103A,B03,093562,Greenfeld; Be'Eri,2,0,36,34
1656815154301,MATH 105,A01,085443,Carter; Anne Toulson,13,0,35,22
1656815154301,MATH 105,A02,093477,Carter; Anne Toulson,20,0,35,15
1656815160331,MATH 109,A01,083213,Ganzberger; Geoffrey Michael,2,0,34,32
1656815160331,MATH 109,A02,083214,Ganzberger; Geoffrey Michael,2,0,34,32
1656815160331,MATH 109,A03,093478,Ganzberger; Geoffrey Michael,1,0,34,33
1656815160331,MATH 109,B01,083215,Ganzberger; Geoffrey Michael,1,0,32,31
1656815160331,MATH 109,B02,083216,Ganzberger; Geoffrey Michael,1,0,32,31
1656815160331,MATH 109,B03,093479,Ganzberger; Geoffrey Michael,6,0,32,26
1656815166362,MATH 142A,A01,083219,Chow; Bennett,6,0,32,26
1656815166362,MATH 142A,A02,083220,Chow; Bennett,9,0,32,23
1656815166362,MATH 142A,A03,093480,Chow; Bennett,7,0,32,25
1656815166362,MATH 142A,B03,093481,Chow; Bennett,7,0,32,25
1656815166362,MATH 142A,B04,093558,Chow; Bennett,10,0,32,22
1656815166362,MATH 142A,B05,093559,Chow; Bennett,6,0,32,26
1656815172388,MATH 193A,A01,083224,Rotar; Vladimir,6,0,34,28
1656815172388,MATH 193A,A02,083225,Rotar; Vladimir,3,0,34,31
1656815172388,MATH 193A,A03,083781,Rotar; Vladimir,1,0,34,33
1656815172388,MATH 193A,A04,083782,Rotar; Vladimir,6,0,34,28
1656815172388,MATH 193A,A05,093482,Rotar; Vladimir,6,0,34,28
1656815178427,MATH 197,001,091859,McAuley; Julian John,9999,0,9999,0
1656815178427,MATH 197,002,095566,Kedlaya; Kiran S.,9997,0,9999,2
1656815178427,MATH 197,003,095567,Xiao; Ming,9999,0,9999,0
1656815178427,MATH 197,004,095571,Perols; Johan Lars,9998,0,9999,1
1656815185480,COGS 9,A01,083615,Shannon; Kyle Michael,6,0,75,69
1656815191507,COGS 11,A01,083617,Boyle; Mary E. T.,18,0,48,30
1656815197534,COGS 13,A01,083071,Bastos; Amalia Pinkusfeld,8,0,71,63
1656815203557,COGS 14A,A01,092681,Semenuks; Arturs,0,1,100,100
1656815209583,COGS 14B,A01,083073,Cheng; Tzu-Han,5,0,63,58
1656815215610,COGS 17,A01,092677,Semenuks; Arturs,4,0,81,77
1656815221637,COGS 100,A01,083619,Allen; Michael Gordon,15,0,70,55
1656815227666,COGS 101A,A01,083621,Davis; Joshua Daniel,9,0,68,59
1656815233688,COGS 101B,A01,091572,Allen; Michael Gordon,8,0,65,57
1656815239712,COGS 101C,A01,083625,Delgado; Tania,17,0,35,18
1656815245737,COGS 107A,A01,083627,Boyle; Mary E. T.,13,0,60,47
1656815251763,COGS 118A,A01,083075,Gupta; Anjum,15,0,76,61
1656815257788,CSE 3,A50,083646,Miranda; Gregory Joseph,22,0,50,28
1656815263811,CSE 8A,A50,083650,Miranda; Gregory Joseph,17,1,56,39
1656815269834,CSE 11,A01,083080,Cao; Yingjun,4,15,40,36
1656815275860,CSE 12,A01,083652,Krause-Levy; Sophia Louisa,20,1,120,100
1656815281882,CSE 15L,A01,083654,Morris; Justin Loren,8,0,50,42
1656815281882,CSE 15L,A02,083655,Morris; Justin Loren,8,0,50,42
1656815287914,CSE 20,A01,083657,Tran; Khoa Dang,37,0,80,43
1656815293938,CSE 21,A01,095574,Bach; Quang Tran,21,0,48,27
1656815299976,CSE 30,A01,083084,Eldon; John,4,0,80,76
1656815299976,CSE 30,B01,095061,Bhaskar; Nishant,6,0,50,44
1656815306003,CSE 100,A01,083659,Cao; Yingjun,1,4,70,69
1656815312026,CSE 134B,A01,083661,Powell; Thomas Allan,18,0,100,82
1656815318052,CSE 140,A01,083663,Gungor; Onat,14,0,85,71
1656815324089,CSE 140L,A01,083088,Eldon; John,16,0,100,84
1656815330112,CSE 175,A01,083665,Kumar; Rakesh,3,0,25,22
1656815336137,CSE 190,A00,092507,Dubnov; Shlomo,7,0,20,13
1656815342165,ECE 45,A01,083139,Congero; Spencer William,5,0,75,70
1656815348187,ECE 65,A50,083695,Saad; Andrew S,12,0,30,18
1656815348187,ECE 65,A51,095125,Saad; Andrew S,25,0,26,1
1656815354211,ECE 109,A01,091882,Touri; Behrouz,15,0,70,55
1656815360232,ECE 180,A00,083140,Abi Samra; Nicholas Camill,0,0,30,30
1656815360232,ECE 180,B00,083141,Abi Samra; Nicholas Camill,0,0,30,30
1656815366268,MATH 10A,A01,083735,Patchell; Gregory David,1,0,30,29
1656815366268,MATH 10A,A02,083736,Patchell; Gregory David,20,0,30,10
1656815366268,MATH 10A,A03,083737,Patchell; Gregory David,15,0,30,15
1656815372301,MATH 10B,A01,083207,Lim; Seonhee,7,0,34,27
1656815372301,MATH 10B,A02,083208,Lim; Seonhee,9,0,35,26
1656815372301,MATH 10B,A03,093472,Lim; Seonhee,4,0,34,30
1656815372301,MATH 10B,B01,083739,Sinha; Shubham,9,0,30,21
1656815378325,MATH 18,A01,083743,Cinel; Cameron Alexander,6,0,30,24
1656815378325,MATH 18,A02,083744,Cinel; Cameron Alexander,15,0,30,15
1656815378325,MATH 18,A03,083745,Cinel; Cameron Alexander,8,0,30,22
1656815378325,MATH 18,B01,083748,Rideout; David Porter,3,0,37,34
1656815378325,MATH 18,B02,083749,Rideout; David Porter,3,0,36,33
1656815378325,MATH 18,B03,083750,Rideout; David Porter,1,0,37,36
1656815378325,MATH 18,B04,083751,Rideout; David Porter,5,0,36,31
1656815378325,MATH 18,B05,093473,Rideout; David Porter,4,0,36,32
1656815378325,MATH 18,B06,093474,Rideout; David Porter,5,0,36,31
1656815384349,MATH 20A,A01,083754,Zheng; Zequn,12,0,40,28
1656815390374,MATH 20B,A01,083756,Briones; Jor-el Thomas Caparas,1,0,36,35
1656815390374,MATH 20B,A02,083757,Briones; Jor-el Thomas Caparas,1,0,36,35
1656815390374,MATH 20B,A03,093475,Briones; Jor-el Thomas Caparas,0,0,36,36
1656815396398,MATH 20C,A01,083760,Briones; Jor-el Thomas Caparas,1,0,35,34
1656815396398,MATH 20C,A02,083761,Briones; Jor-el Thomas Caparas,8,0,35,27
1656815396398,MATH 20C,A03,093476,Briones; Jor-el Thomas Caparas,0,1,36,36
1656815396398,MATH 20C,B01,083762,Bach; Quang Tran,0,0,30,30
1656815402427,MATH 20D,A01,083765,Tran; Brian Kha,4,0,30,26
1656815402427,MATH 20D,A02,083766,Tran; Brian Kha,4,0,30,26
1656815402427,MATH 20D,A03,083767,Tran; Brian Kha,2,0,30,28
1656815408451,MATH 20E,A01,083771,Ganguly; Soumya,5,0,32,27
1656815408451,MATH 20E,A02,083772,Ganguly; Soumya,5,0,32,27
1656815408451,MATH 20E,B01,083773,Ciotti; Benjamin,18,0,35,17
1656815408451,MATH 20E,B02,083774,Ciotti; Benjamin,17,0,35,18
1656815414475,MATH 103A,A01,083777,Greenfeld; Be'Eri,2,0,36,34
1656815414475,MATH 103A,A02,083778,Greenfeld; Be'Eri,5,0,36,31
1656815414475,MATH 103A,A03,093561,Greenfeld; Be'Eri,4,0,36,32
1656815414475,MATH 103A,B01,083779,Greenfeld; Be'Eri,6,0,36,30
1656815414475,MATH 103A,B02,083780,Greenfeld; Be'Eri,2,0,36,34
1656815414475,MATH 103A,B03,093562,Greenfeld; Be'Eri,2,0,36,34
1656815420500,MATH 105,A01,085443,Carter; Anne Toulson,13,0,35,22
1656815420500,MATH 105,A02,093477,Carter; Anne Toulson,20,0,35,15
1656815426523,MATH 109,A01,083213,Ganzberger; Geoffrey Michael,2,0,34,32
1656815426523,MATH 109,A02,083214,Ganzberger; Geoffrey Michael,2,0,34,32
1656815426523,MATH 109,A03,093478,Ganzberger; Geoffrey Michael,1,0,34,33
1656815426523,MATH 109,B01,083215,Ganzberger; Geoffrey Michael,1,0,32,31
1656815426523,MATH 109,B02,083216,Ganzberger; Geoffrey Michael,1,0,32,31
1656815426523,MATH 109,B03,093479,Ganzberger; Geoffrey Michael,6,0,32,26
1656815432547,MATH 142A,A01,083219,Chow; Bennett,6,0,32,26
1656815432547,MATH 142A,A02,083220,Chow; Bennett,9,0,32,23
1656815432547,MATH 142A,A03,093480,Chow; Bennett,7,0,32,25
1656815432547,MATH 142A,B03,093481,Chow; Bennett,7,0,32,25
1656815432547,MATH 142A,B04,093558,Chow; Bennett,10,0,32,22
1656815432547,MATH 142A,B05,093559,Chow; Bennett,6,0,32,26
1656815438575,MATH 193A,A01,083224,Rotar; Vladimir,6,0,34,28
1656815438575,MATH 193A,A02,083225,Rotar; Vladimir,3,0,34,31
1656815438575,MATH 193A,A03,083781,Rotar; Vladimir,1,0,34,33
1656815438575,MATH 193A,A04,083782,Rotar; Vladimir,6,0,34,28
1656815438575,MATH 193A,A05,093482,Rotar; Vladimir,6,0,34,28
1656815444603,MATH 197,001,091859,McAuley; Julian John,9999,0,9999,0
1656815444603,MATH 197,002,095566,Kedlaya; Kiran S.,9997,0,9999,2
1656815444603,MATH 197,003,095567,Xiao; Ming,9999,0,9999,0
1656815444603,MATH 197,004,095571,Perols; Johan Lars,9998,0,9999,1
1656815451675,COGS 9,A01,083615,Shannon; Kyle Michael,6,0,75,69
1656815457697,COGS 11,A01,083617,Boyle; Mary E. T.,18,0,48,30
1656815463724,COGS 13,A01,083071,Bastos; Amalia Pinkusfeld,8,0,71,63
1656815469748,COGS 14A,A01,092681,Semenuks; Arturs,0,1,100,100
1656815475774,COGS 14B,A01,083073,Cheng; Tzu-Han,5,0,63,58
1656815481800,COGS 17,A01,092677,Semenuks; Arturs,4,0,81,77
1656815487829,COGS 100,A01,083619,Allen; Michael Gordon,15,0,70,55
1656815493946,COGS 101A,A01,083621,Davis; Joshua Daniel,9,0,68,59
1656815499972,COGS 101B,A01,091572,Allen; Michael Gordon,8,0,65,57
1656815505998,COGS 101C,A01,083625,Delgado; Tania,17,0,35,18
1656815512026,COGS 107A,A01,083627,Boyle; Mary E. T.,13,0,60,47
1656815518051,COGS 118A,A01,083075,Gupta; Anjum,15,0,76,61
1656815524078,CSE 3,A50,083646,Miranda; Gregory Joseph,22,0,50,28
1656815530106,CSE 8A,A50,083650,Miranda; Gregory Joseph,17,1,56,39
1656815536130,CSE 11,A01,083080,Cao; Yingjun,4,15,40,36
1656815542158,CSE 12,A01,083652,Krause-Levy; Sophia Louisa,20,1,120,100
1656815548182,CSE 15L,A01,083654,Morris; Justin Loren,8,0,50,42
1656815548182,CSE 15L,A02,083655,Morris; Justin Loren,8,0,50,42
1656815554207,CSE 20,A01,083657,Tran; Khoa Dang,37,0,80,43
1656815560231,CSE 21,A01,095574,Bach; Quang Tran,21,0,48,27
1656815566259,CSE 30,A01,083084,Eldon; John,4,0,80,76
1656815566259,CSE 30,B01,095061,Bhaskar; Nishant,6,0,50,44
1656815572290,CSE 100,A01,083659,Cao; Yingjun,1,4,70,69
1656815578322,CSE 134B,A01,083661,Powell; Thomas Allan,18,0,100,82
1656815584345,CSE 140,A01,083663,Gungor; Onat,14,0,85,71
1656815590373,CSE 140L,A01,083088,Eldon; John,16,0,100,84
1656815596399,CSE 175,A01,083665,Kumar; Rakesh,3,0,25,22
1656815602426,CSE 190,A00,092507,Dubnov; Shlomo,7,0,20,13
1656815608451,ECE 45,A01,083139,Congero; Spencer William,5,0,75,70
1656815614477,ECE 65,A50,083695,Saad; Andrew S,12,0,30,18
1656815614477,ECE 65,A51,095125,Saad; Andrew S,25,0,26,1
1656815620502,ECE 109,A01,091882,Touri; Behrouz,15,0,70,55
1656815626535,ECE 180,A00,083140,Abi Samra; Nicholas Camill,0,0,30,30
1656815626535,ECE 180,B00,083141,Abi Samra; Nicholas Camill,0,0,30,30
1656815632560,MATH 10A,A01,083735,Patchell; Gregory David,1,0,30,29
1656815632560,MATH 10A,A02,083736,Patchell; Gregory David,20,0,30,10
1656815632560,MATH 10A,A03,083737,Patchell; Gregory David,15,0,30,15
1656815638589,MATH 10B,A01,083207,Lim; Seonhee,7,0,34,27
1656815638589,MATH 10B,A02,083208,Lim; Seonhee,9,0,35,26
1656815638589,MATH 10B,A03,093472,Lim; Seonhee,4,0,34,30
1656815638589,MATH 10B,B01,083739,Sinha; Shubham,9,0,30,21
1656815644616,MATH 18,A01,083743,Cinel; Cameron Alexander,6,0,30,24
1656815644616,MATH 18,A02,083744,Cinel; Cameron Alexander,15,0,30,15
1656815644616,MATH 18,A03,083745,Cinel; Cameron Alexander,8,0,30,22
1656815644616,MATH 18,B01,083748,Rideout; David Porter,3,0,37,34
1656815644616,MATH 18,B02,083749,Rideout; David Porter,3,0,36,33
1656815644616,MATH 18,B03,083750,Rideout; David Porter,1,0,37,36
1656815644616,MATH 18,B04,083751,Rideout; David Porter,5,0,36,31
1656815644616,MATH 18,B05,093473,Rideout; David Porter,4,0,36,32
1656815644616,MATH 18,B06,093474,Rideout; David Porter,5,0,36,31
1656815650642,MATH 20A,A01,083754,Zheng; Zequn,12,0,40,28
1656815656671,MATH 20B,A01,083756,Briones; Jor-el Thomas Caparas,1,0,36,35
1656815656671,MATH 20B,A02,083757,Briones; Jor-el Thomas Caparas,1,0,36,35
1656815656671,MATH 20B,A03,093475,Briones; Jor-el Thomas Caparas,0,0,36,36
1656815662702,MATH 20C,A01,083760,Briones; Jor-el Thomas Caparas,1,0,35,34
1656815662702,MATH 20C,A02,083761,Briones; Jor-el Thomas Caparas,8,0,35,27
1656815662702,MATH 20C,A03,093476,Briones; Jor-el Thomas Caparas,0,1,36,36
1656815662702,MATH 20C,B01,083762,Bach; Quang Tran,0,0,30,30
1656815668728,MATH 20D,A01,083765,Tran; Brian Kha,4,0,30,26
1656815668728,MATH 20D,A02,083766,Tran; Brian Kha,4,0,30,26
1656815668728,MATH 20D,A03,083767,Tran; Brian Kha,2,0,30,28
1656815674752,MATH 20E,A01,083771,Ganguly; Soumya,5,0,32,27
1656815674752,MATH 20E,A02,083772,Ganguly; Soumya,5,0,32,27
1656815674752,MATH 20E,B01,083773,Ciotti; Benjamin,18,0,35,17
1656815674752,MATH 20E,B02,083774,Ciotti; Benjamin,17,0,35,18
1656815680784,MATH 103A,A01,083777,Greenfeld; Be'Eri,2,0,36,34
1656815680784,MATH 103A,A02,083778,Greenfeld; Be'Eri,5,0,36,31
1656815680784,MATH 103A,A03,093561,Greenfeld; Be'Eri,4,0,36,32
1656815680784,MATH 103A,B01,083779,Greenfeld; Be'Eri,6,0,36,30
1656815680784,MATH 103A,B02,083780,Greenfeld; Be'Eri,2,0,36,34
1656815680784,MATH 103A,B03,093562,Greenfeld; Be'Eri,2,0,36,34
1656815686817,MATH 105,A01,085443,Carter; Anne Toulson,13,0,35,22
1656815686817,MATH 105,A02,093477,Carter; Anne Toulson,20,0,35,15
1656815692852,MATH 109,A01,083213,Ganzberger; Geoffrey Michael,2,0,34,32
1656815692852,MATH 109,A02,083214,Ganzberger; Geoffrey Michael,2,0,34,32
1656815692852,MATH 109,A03,093478,Ganzberger; Geoffrey Michael,1,0,34,33
1656815692852,MATH 109,B01,083215,Ganzberger; Geoffrey Michael,1,0,32,31
1656815692852,MATH 109,B02,083216,Ganzberger; Geoffrey Michael,1,0,32,31
1656815692852,MATH 109,B03,093479,Ganzberger; Geoffrey Michael,6,0,32,26
1656815698878,MATH 142A,A01,083219,Chow; Bennett,6,0,32,26
1656815698878,MATH 142A,A02,083220,Chow; Bennett,9,0,32,23
1656815698878,MATH 142A,A03,093480,Chow; Bennett,7,0,32,25
1656815698878,MATH 142A,B03,093481,Chow; Bennett,7,0,32,25
1656815698878,MATH 142A,B04,093558,Chow; Bennett,10,0,32,22
1656815698878,MATH 142A,B05,093559,Chow; Bennett,6,0,32,26
1656815704903,MATH 193A,A01,083224,Rotar; Vladimir,6,0,34,28
1656815704903,MATH 193A,A02,083225,Rotar; Vladimir,3,0,34,31
1656815704903,MATH 193A,A03,083781,Rotar; Vladimir,1,0,34,33
1656815704903,MATH 193A,A04,083782,Rotar; Vladimir,6,0,34,28
1656815704903,MATH 193A,A05,093482,Rotar; Vladimir,6,0,34,28
1656815710928,MATH 197,001,091859,McAuley; Julian John,9999,0,9999,0
1656815710928,MATH 197,002,095566,Kedlaya; Kiran S.,9997,0,9999,2
1656815710928,MATH 197,003,095567,Xiao; Ming,9999,0,9999,0
1656815710928,MATH 197,004,095571,Perols; Johan Lars,9998,0,9999,1
1656815718013,COGS 9,A01,083615,Shannon; Kyle Michael,6,0,75,69
1656815724044,COGS 11,A01,083617,Boyle; Mary E. T.,18,0,48,30
1656815730074,COGS 13,A01,083071,Bastos; Amalia Pinkusfeld,8,0,71,63
1656815736098,COGS 14A,A01,092681,Semenuks; Arturs,0,1,100,100
1656815742124,COGS 14B,A01,083073,Cheng; Tzu-Han,5,0,63,58
1656815748151,COGS 17,A01,092677,Semenuks; Arturs,4,0,81,77
1656815754184,COGS 100,A01,083619,Allen; Michael Gordon,15,0,70,55
1656815760220,COGS 101A,A01,083621,Davis; Joshua Daniel,9,0,68,59
1656815766251,COGS 101B,A01,091572,Allen; Michael Gordon,8,0,65,57
1656815772275,COGS 101C,A01,083625,Delgado; Tania,17,0,35,18
1656815778311,COGS 107A,A01,083627,Boyle; Mary E. T.,13,0,60,47
1656815784336,COGS 118A,A01,083075,Gupta; Anjum,15,0,76,61
1656815790361,CSE 3,A50,083646,Miranda; Gregory Joseph,22,0,50,28
1656815796389,CSE 8A,A50,083650,Miranda; Gregory Joseph,17,1,56,39
1656815802415,CSE 11,A01,083080,Cao; Yingjun,4,15,40,36
1656815808453,CSE 12,A01,083652,Krause-Levy; Sophia Louisa,20,1,120,100
1656815814477,CSE 15L,A01,083654,Morris; Justin Loren,8,0,50,42
1656815814477,CSE 15L,A02,083655,Morris; Justin Loren,8,0,50,42
1656815820505,CSE 20,A01,083657,Tran; Khoa Dang,37,0,80,43
1656815826531,CSE 21,A01,095574,Bach; Quang Tran,21,0,48,27
1656815832569,CSE 30,A01,083084,Eldon; John,4,0,80,76
1656815832569,CSE 30,B01,095061,Bhaskar; Nishant,6,0,50,44
1656815838597,CSE 100,A01,083659,Cao; Yingjun,1,4,70,69
1656815844620,CSE 134B,A01,083661,Powell; Thomas Allan,18,0,100,82
1656815850648,CSE 140,A01,083663,Gungor; Onat,14,0,85,71
1656815856675,CSE 140L,A01,083088,Eldon; John,16,0,100,84
1656815862710,CSE 175,A01,083665,Kumar; Rakesh,3,0,25,22
1656815868744,CSE 190,A00,092507,Dubnov; Shlomo,7,0,20,13
1656815874768,ECE 45,A01,083139,Congero; Spencer William,5,0,75,70
1656815880792,ECE 65,A50,083695,Saad; Andrew S,12,0,30,18
1656815880792,ECE 65,A51,095125,Saad; Andrew S,25,0,26,1
1656815886816,ECE 109,A01,091882,Touri; Behrouz,15,0,70,55
1656815892840,ECE 180,A00,083140,Abi Samra; Nicholas Camill,0,0,30,30
1656815892840,ECE 180,B00,083141,Abi Samra; Nicholas Camill,0,0,30,30
1656815898876,MATH 10A,A01,083735,Patchell; Gregory David,1,0,30,29
1656815898876,MATH 10A,A02,083736,Patchell; Gregory David,20,0,30,10
1656815898876,MATH 10A,A03,083737,Patchell; Gregory David,15,0,30,15
1656815904902,MATH 10B,A01,083207,Lim; Seonhee,7,0,34,27
1656815904902,MATH 10B,A02,083208,Lim; Seonhee,9,0,35,26
1656815904902,MATH 10B,A03,093472,Lim; Seonhee,4,0,34,30
1656815904902,MATH 10B,B01,083739,Sinha; Shubham,9,0,30,21
1656815910927,MATH 18,A01,083743,Cinel; Cameron Alexander,6,0,30,24
1656815910927,MATH 18,A02,083744,Cinel; Cameron Alexander,15,0,30,15
1656815910927,MATH 18,A03,083745,Cinel; Cameron Alexander,8,0,30,22
1656815910927,MATH 18,B01,083748,Rideout; David Porter,3,0,37,34
1656815910927,MATH 18,B02,083749,Rideout; David Porter,3,0,36,33
1656815910927,MATH 18,B03,083750,Rideout; David Porter,1,0,37,36
1656815910927,MATH 18,B04,083751,Rideout; David Porter,5,0,36,31
1656815910927,MATH 18,B05,093473,Rideout; David Porter,4,0,36,32
1656815910927,MATH 18,B06,093474,Rideout; David Porter,5,0,36,31
1656815917024,MATH 20A,A01,083754,Zheng; Zequn,12,0,40,28
1656815923055,MATH 20B,A01,083756,Briones; Jor-el Thomas Caparas,1,0,36,35
1656815923055,MATH 20B,A02,083757,Briones; Jor-el Thomas Caparas,1,0,36,35
1656815923055,MATH 20B,A03,093475,Briones; Jor-el Thomas Caparas,0,0,36,36
1656815929084,MATH 20C,A01,083760,Briones; Jor-el Thomas Caparas,1,0,35,34
1656815929084,MATH 20C,A02,083761,Briones; Jor-el Thomas Caparas,8,0,35,27
1656815929084,MATH 20C,A03,093476,Briones; Jor-el Thomas Caparas,0,1,36,36
1656815929084,MATH 20C,B01,083762,Bach; Quang Tran,0,0,30,30
1656815935114,MATH 20D,A01,083765,Tran; Brian Kha,4,0,30,26
1656815935114,MATH 20D,A02,083766,Tran; Brian Kha,4,0,30,26
1656815935114,MATH 20D,A03,083767,Tran; Brian Kha,2,0,30,28
1656815941141,MATH 20E,A01,083771,Ganguly; Soumya,5,0,32,27
1656815941141,MATH 20E,A02,083772,Ganguly; Soumya,5,0,32,27
1656815941141,MATH 20E,B01,083773,Ciotti; Benjamin,18,0,35,17
1656815941141,MATH 20E,B02,083774,Ciotti; Benjamin,17,0,35,18
1656815947175,MATH 103A,A01,083777,Greenfeld; Be'Eri,2,0,36,34
1656815947175,MATH 103A,A02,083778,Greenfeld; Be'Eri,5,0,36,31
1656815947175,MATH 103A,A03,093561,Greenfeld; Be'Eri,4,0,36,32
1656815947175,MATH 103A,B01,083779,Greenfeld; Be'Eri,6,0,36,30
1656815947175,MATH 103A,B02,083780,Greenfeld; Be'Eri,2,0,36,34
1656815947175,MATH 103A,B03,093562,Greenfeld; Be'Eri,2,0,36,34
1656815953204,MATH 105,A01,085443,Carter; Anne Toulson,13,0,35,22
1656815953204,MATH 105,A02,093477,Carter; Anne Toulson,20,0,35,15
1656815959231,MATH 109,A01,083213,Ganzberger; Geoffrey Michael,2,0,34,32
1656815959231,MATH 109,A02,083214,Ganzberger; Geoffrey Michael,2,0,34,32
1656815959231,MATH 109,A03,093478,Ganzberger; Geoffrey Michael,1,0,34,33
1656815959231,MATH 109,B01,083215,Ganzberger; Geoffrey Michael,1,0,32,31
1656815959231,MATH 109,B02,083216,Ganzberger; Geoffrey Michael,1,0,32,31
1656815959231,MATH 109,B03,093479,Ganzberger; Geoffrey Michael,6,0,32,26
1656815965262,MATH 142A,A01,083219,Chow; Bennett,6,0,32,26
1656815965262,MATH 142A,A02,083220,Chow; Bennett,9,0,32,23
1656815965262,MATH 142A,A03,093480,Chow; Bennett,7,0,32,25
1656815965262,MATH 142A,B03,093481,Chow; Bennett,7,0,32,25
1656815965262,MATH 142A,B04,093558,Chow; Bennett,10,0,32,22
1656815965262,MATH 142A,B05,093559,Chow; Bennett,6,0,32,26
1656815971290,MATH 193A,A01,083224,Rotar; Vladimir,6,0,34,28
1656815971290,MATH 193A,A02,083225,Rotar; Vladimir,3,0,34,31
1656815971290,MATH 193A,A03,083781,Rotar; Vladimir,1,0,34,33
1656815971290,MATH 193A,A04,083782,Rotar; Vladimir,6,0,34,28
1656815971290,MATH 193A,A05,093482,Rotar; Vladimir,6,0,34,28
1656815977313,MATH 197,001,091859,McAuley; Julian John,9999,0,9999,0
1656815977313,MATH 197,002,095566,Kedlaya; Kiran S.,9997,0,9999,2
1656815977313,MATH 197,003,095567,Xiao; Ming,9999,0,9999,0
1656815977313,MATH 197,004,095571,Perols; Johan Lars,9998,0,9999,1
1656815984386,COGS 9,A01,083615,Shannon; Kyle Michael,6,0,75,69
1656815990416,COGS 11,A01,083617,Boyle; Mary E. T.,18,0,48,30
1656815996444,COGS 13,A01,083071,Bastos; Amalia Pinkusfeld,8,0,71,63
1656816002472,COGS 14A,A01,092681,Semenuks; Arturs,0,1,100,100
1656816008499,COGS 14B,A01,083073,Cheng; Tzu-Han,5,0,63,58
1656816014521,COGS 17,A01,092677,Semenuks; Arturs,4,0,81,77
1656816020550,COGS 100,A01,083619,Allen; Michael Gordon,15,0,70,55
1656816026577,COGS 101A,A01,083621,Davis; Joshua Daniel,9,0,68,59
1656816032605,COGS 101B,A01,091572,Allen; Michael Gordon,8,0,65,57
1656816038640,COGS 101C,A01,083625,Delgado; Tania,17,0,35,18
1656816044665,COGS 107A,A01,083627,Boyle; Mary E. T.,13,0,60,47
1656816050692,COGS 118A,A01,083075,Gupta; Anjum,15,0,76,61
1656816056719,CSE 3,A50,083646,Miranda; Gregory Joseph,22,0,50,28
1656816062742,CSE 8A,A50,083650,Miranda; Gregory Joseph,17,1,56,39
1656816068770,CSE 11,A01,083080,Cao; Yingjun,4,15,40,36
1656816074808,CSE 12,A01,083652,Krause-Levy; Sophia Louisa,20,1,120,100
1656816080832,CSE 15L,A01,083654,Morris; Justin Loren,8,0,50,42
1656816080832,CSE 15L,A02,083655,Morris; Justin Loren,8,0,50,42
1656816086857,CSE 20,A01,083657,Tran; Khoa Dang,37,0,80,43
1656816092971,CSE 21,A01,095574,Bach; Quang Tran,21,0,48,27
1656816098996,CSE 30,A01,083084,Eldon; John,4,0,80,76
1656816098996,CSE 30,B01,095061,Bhaskar; Nishant,6,0,50,44
1656816105020,CSE 100,A01,083659,Cao; Yingjun,1,4,70,69
1656816111048,CSE 134B,A01,083661,Powell; Thomas Allan,18,0,100,82
1656816117077,CSE 140,A01,083663,Gungor; Onat,14,0,85,71
1656816123105,CSE 140L,A01,083088,Eldon; John,16,0,100,84
1656816129131,CSE 175,A01,083665,Kumar; Rakesh,3,0,25,22
1656816135154,CSE 190,A00,092507,Dubnov; Shlomo,7,0,20,13
1656816141184,ECE 45,A01,083139,Congero; Spencer William,5,0,75,70
1656816147208,ECE 65,A50,083695,Saad; Andrew S,12,0,30,18
1656816147208,ECE 65,A51,095125,Saad; Andrew S,25,0,26,1
1656816153234,ECE 109,A01,091882,Touri; Behrouz,15,0,70,55
1656816159262,ECE 180,A00,083140,Abi Samra; Nicholas Camill,0,0,30,30
1656816159262,ECE 180,B00,083141,Abi Samra; Nicholas Camill,0,0,30,30
1656816165292,MATH 10A,A01,083735,Patchell; Gregory David,1,0,30,29
1656816165292,MATH 10A,A02,083736,Patchell; Gregory David,20,0,30,10
1656816165292,MATH 10A,A03,083737,Patchell; Gregory David,15,0,30,15
1656816171318,MATH 10B,A01,083207,Lim; Seonhee,7,0,34,27
1656816171318,MATH 10B,A02,083208,Lim; Seonhee,9,0,35,26
1656816171318,MATH 10B,A03,093472,Lim; Seonhee,4,0,34,30
1656816171318,MATH 10B,B01,083739,Sinha; Shubham,9,0,30,21
1656816177345,MATH 18,A01,083743,Cinel; Cameron Alexander,6,0,30,24
1656816177345,MATH 18,A02,083744,Cinel; Cameron Alexander,15,0,30,15
1656816177345,MATH 18,A03,083745,Cinel; Cameron Alexander,8,0,30,22
1656816177345,MATH 18,B01,083748,Rideout; David Porter,3,0,37,34
1656816177345,MATH 18,B02,083749,Rideout; David Porter,3,0,36,33
1656816177345,MATH 18,B03,083750,Rideout; David Porter,1,0,37,36
1656816177345,MATH 18,B04,083751,Rideout; David Porter,5,0,36,31
1656816177345,MATH 18,B05,093473,Rideout; David Porter,4,0,36,32
1656816177345,MATH 18,B06,093474,Rideout; David Porter,5,0,36,31
1656816183373,MATH 20A,A01,083754,Zheng; Zequn,12,0,40,28
1656816189397,MATH 20B,A01,083756,Briones; Jor-el Thomas Caparas,1,0,36,35
1656816189397,MATH 20B,A02,083757,Briones; Jor-el Thomas Caparas,1,0,36,35
1656816189397,MATH 20B,A03,093475,Briones; Jor-el Thomas Caparas,0,0,36,36
1656816195419,MATH 20C,A01,083760,Briones; Jor-el Thomas Caparas,1,0,35,34
1656816195419,MATH 20C,A02,083761,Briones; Jor-el Thomas Caparas,8,0,35,27
1656816195419,MATH 20C,A03,093476,Briones; Jor-el Thomas Caparas,0,1,36,36
1656816195419,MATH 20C,B01,083762,Bach; Quang Tran,0,0,30,30
1656816201444,MATH 20D,A01,083765,Tran; Brian Kha,4,0,30,26
1656816201444,MATH 20D,A02,083766,Tran; Brian Kha,4,0,30,26
1656816201444,MATH 20D,A03,083767,Tran; Brian Kha,2,0,30,28
1656816207473,MATH 20E,A01,083771,Ganguly; Soumya,5,0,32,27
1656816207473,MATH 20E,A02,083772,Ganguly; Soumya,5,0,32,27
1656816207473,MATH 20E,B01,083773,Ciotti; Benjamin,18,0,35,17
1656816207473,MATH 20E,B02,083774,Ciotti; Benjamin,17,0,35,18
1656816213507,MATH 103A,A01,083777,Greenfeld; Be'Eri,2,0,36,34
1656816213507,MATH 103A,A02,083778,Greenfeld; Be'Eri,5,0,36,31
1656816213507,MATH 103A,A03,093561,Greenfeld; Be'Eri,4,0,36,32
1656816213507,MATH 103A,B01,083779,Greenfeld; Be'Eri,6,0,36,30
1656816213507,MATH 103A,B02,083780,Greenfeld; Be'Eri,2,0,36,34
1656816213507,MATH 103A,B03,093562,Greenfeld; Be'Eri,2,0,36,34
1656816219533,MATH 105,A01,085443,Carter; Anne Toulson,13,0,35,22
1656816219533,MATH 105,A02,093477,Carter; Anne Toulson,20,0,35,15
1656816225557,MATH 109,A01,083213,Ganzberger; Geoffrey Michael,2,0,34,32
1656816225557,MATH 109,A02,083214,Ganzberger; Geoffrey Michael,2,0,34,32
1656816225557,MATH 109,A03,093478,Ganzberger; Geoffrey Michael,1,0,34,33
1656816225557,MATH 109,B01,083215,Ganzberger; Geoffrey Michael,1,0,32,31
1656816225557,MATH 109,B02,083216,Ganzberger; Geoffrey Michael,1,0,32,31
1656816225557,MATH 109,B03,093479,Ganzberger; Geoffrey Michael,6,0,32,26
1656816231584,MATH 142A,A01,083219,Chow; Bennett,6,0,32,26
1656816231584,MATH 142A,A02,083220,Chow; Bennett,9,0,32,23
1656816231584,MATH 142A,A03,093480,Chow; Bennett,7,0,32,25
1656816231584,MATH 142A,B03,093481,Chow; Bennett,7,0,32,25
1656816231584,MATH 142A,B04,093558,Chow; Bennett,10,0,32,22
1656816231584,MATH 142A,B05,093559,Chow; Bennett,6,0,32,26
1656816237608,MATH 193A,A01,083224,Rotar; Vladimir,6,0,34,28
1656816237608,MATH 193A,A02,083225,Rotar; Vladimir,3,0,34,31
1656816237608,MATH 193A,A03,083781,Rotar; Vladimir,1,0,34,33
1656816237608,MATH 193A,A04,083782,Rotar; Vladimir,6,0,34,28
1656816237608,MATH 193A,A05,093482,Rotar; Vladimir,6,0,34,28
1656816243637,MATH 197,001,091859,McAuley; Julian John,9999,0,9999,0
1656816243637,MATH 197,002,095566,Kedlaya; Kiran S.,9997,0,9999,2
1656816243637,MATH 197,003,095567,Xiao; Ming,9999,0,9999,0
1656816243637,MATH 197,004,095571,Perols; Johan Lars,9998,0,9999,1
1656816250696,COGS 9,A01,083615,Shannon; Kyle Michael,6,0,75,69
1656816256726,COGS 11,A01,083617,Boyle; Mary E. T.,18,0,48,30
1656816262753,COGS 13,A01,083071,Bastos; Amalia Pinkusfeld,8,0,71,63
1656816268780,COGS 14A,A01,092681,Semenuks; Arturs,0,1,100,100
1656816274806,COGS 14B,A01,083073,Cheng; Tzu-Han,5,0,63,58
1656816280839,COGS 17,A01,092677,Semenuks; Arturs,4,0,81,77
1656816286863,COGS 100,A01,083619,Allen; Michael Gordon,15,0,70,55
1656816292889,COGS 101A,A01,083621,Davis; Joshua Daniel,9,0,68,59
1656816298911,COGS 101B,A01,091572,Allen; Michael Gordon,8,0,65,57
1656816304939,COGS 101C,A01,083625,Delgado; Tania,17,0,35,18
1656816310962,COGS 107A,A01,083627,Boyle; Mary E. T.,13,0,60,47
1656816316986,COGS 118A,A01,083075,Gupta; Anjum,15,0,76,61
1656816323020,CSE 3,A50,083646,Miranda; Gregory Joseph,22,0,50,28
1656816329052,CSE 8A,A50,083650,Miranda; Gregory Joseph,17,1,56,39
1656816335079,CSE 11,A01,083080,Cao; Yingjun,4,15,40,36
1656816341107,CSE 12,A01,083652,Krause-Levy; Sophia Louisa,20,1,120,100
1656816347137,CSE 15L,A01,083654,Morris; Justin Loren,8,0,50,42
1656816347137,CSE 15L,A02,083655,Morris; Justin Loren,8,0,50,42
1656816353165,CSE 20,A01,083657,Tran; Khoa Dang,37,0,80,43
1656816359196,CSE 21,A01,095574,Bach; Quang Tran,21,0,48,27
1656816365229,CSE 30,A01,083084,Eldon; John,4,0,80,76
1656816365229,CSE 30,B01,095061,Bhaskar; Nishant,6,0,50,44
1656816371258,CSE 100,A01,083659,Cao; Yingjun,1,4,70,69
1656816377288,CSE 134B,A01,083661,Powell; Thomas Allan,18,0,100,82
1656816383312,CSE 140,A01,083663,Gungor; Onat,14,0,85,71
1656816389334,CSE 140L,A01,083088,Eldon; John,16,0,100,84
1656816395359,CSE 175,A01,083665,Kumar; Rakesh,3,0,25,22
1656816401386,CSE 190,A00,092507,Dubnov; Shlomo,7,0,20,13
1656816407411,ECE 45,A01,083139,Congero; Spencer William,5,0,75,70
1656816413444,ECE 65,A50,083695,Saad; Andrew S,12,0,30,18
1656816413444,ECE 65,A51,095125,Saad; Andrew S,25,0,26,1
1656816419473,ECE 109,A01,091882,Touri; Behrouz,15,0,70,55
1656816425498,ECE 180,A00,083140,Abi Samra; Nicholas Camill,0,0,30,30
1656816425498,ECE 180,B00,083141,Abi Samra; Nicholas Camill,0,0,30,30
1656816431528,MATH 10A,A01,083735,Patchell; Gregory David,1,0,30,29
1656816431528,MATH 10A,A02,083736,Patchell; Gregory David,20,0,30,10
1656816431528,MATH 10A,A03,083737,Patchell; Gregory David,15,0,30,15
1656816437563,MATH 10B,A01,083207,Lim; Seonhee,7,0,34,27
1656816437563,MATH 10B,A02,083208,Lim; Seonhee,9,0,35,26
1656816437563,MATH 10B,A03,093472,Lim; Seonhee,4,0,34,30
1656816437563,MATH 10B,B01,083739,Sinha; Shubham,9,0,30,21
1656816443593,MATH 18,A01,083743,Cinel; Cameron Alexander,6,0,30,24
1656816443593,MATH 18,A02,083744,Cinel; Cameron Alexander,15,0,30,15
1656816443593,MATH 18,A03,083745,Cinel; Cameron Alexander,8,0,30,22
1656816443593,MATH 18,B01,083748,Rideout; David Porter,3,0,37,34
1656816443593,MATH 18,B02,083749,Rideout; David Porter,3,0,36,33
1656816443593,MATH 18,B03,083750,Rideout; David Porter,1,0,37,36
1656816443593,MATH 18,B04,083751,Rideout; David Porter,5,0,36,31
1656816443593,MATH 18,B05,093473,Rideout; David Porter,4,0,36,32
1656816443593,MATH 18,B06,093474,Rideout; David Porter,5,0,36,31
1656816449617,MATH 20A,A01,083754,Zheng; Zequn,12,0,40,28
1656816455648,MATH 20B,A01,083756,Briones; Jor-el Thomas Caparas,1,0,36,35
1656816455648,MATH 20B,A02,083757,Briones; Jor-el Thomas Caparas,1,0,36,35
1656816455648,MATH 20B,A03,093475,Briones; Jor-el Thomas Caparas,0,0,36,36
1656816461673,MATH 20C,A01,083760,Briones; Jor-el Thomas Caparas,1,0,35,34
1656816461673,MATH 20C,A02,083761,Briones; Jor-el Thomas Caparas,8,0,35,27
1656816461673,MATH 20C,A03,093476,Briones; Jor-el Thomas Caparas,0,1,36,36
1656816461673,MATH 20C,B01,083762,Bach; Quang Tran,0,0,30,30
1656816467699,MATH 20D,A01,083765,Tran; Brian Kha,4,0,30,26
1656816467699,MATH 20D,A02,083766,Tran; Brian Kha,4,0,30,26
1656816467699,MATH 20D,A03,083767,Tran; Brian Kha,2,0,30,28
1656816473737,MATH 20E,A01,083771,Ganguly; Soumya,5,0,32,27
1656816473737,MATH 20E,A02,083772,Ganguly; Soumya,5,0,32,27
1656816473737,MATH 20E,B01,083773,Ciotti; Benjamin,18,0,35,17
1656816473737,MATH 20E,B02,083774,Ciotti; Benjamin,17,0,35,18
1656816479773,MATH 103A,A01,083777,Greenfeld; Be'Eri,2,0,36,34
1656816479773,MATH 103A,A02,083778,Greenfeld; Be'Eri,5,0,36,31
1656816479773,MATH 103A,A03,093561,Greenfeld; Be'Eri,4,0,36,32
1656816479773,MATH 103A,B01,083779,Greenfeld; Be'Eri,6,0,36,30
1656816479773,MATH 103A,B02,083780,Greenfeld; Be'Eri,2,0,36,34
1656816479773,MATH 103A,B03,093562,Greenfeld; Be'Eri,2,0,36,34
1656816485804,MATH 105,A01,085443,Carter; Anne Toulson,13,0,35,22
1656816485804,MATH 105,A02,093477,Carter; Anne Toulson,20,0,35,15
1656816491836,MATH 109,A01,083213,Ganzberger; Geoffrey Michael,2,0,34,32
1656816491836,MATH 109,A02,083214,Ganzberger; Geoffrey Michael,2,0,34,32
1656816491836,MATH 109,A03,093478,Ganzberger; Geoffrey Michael,1,0,34,33
1656816491836,MATH 109,B01,083215,Ganzberger; Geoffrey Michael,1,0,32,31
1656816491836,MATH 109,B02,083216,Ganzberger; Geoffrey Michael,1,0,32,31
1656816491836,MATH 109,B03,093479,Ganzberger; Geoffrey Michael,6,0,32,26
1656816497864,MATH 142A,A01,083219,Chow; Bennett,6,0,32,26
1656816497864,MATH 142A,A02,083220,Chow; Bennett,9,0,32,23
1656816497864,MATH 142A,A03,093480,Chow; Bennett,7,0,32,25
1656816497864,MATH 142A,B03,093481,Chow; Bennett,7,0,32,25
1656816497864,MATH 142A,B04,093558,Chow; Bennett,10,0,32,22
1656816497864,MATH 142A,B05,093559,Chow; Bennett,6,0,32,26
1656816503892,MATH 193A,A01,083224,Rotar; Vladimir,6,0,34,28
1656816503892,MATH 193A,A02,083225,Rotar; Vladimir,3,0,34,31
1656816503892,MATH 193A,A03,083781,Rotar; Vladimir,1,0,34,33
1656816503892,MATH 193A,A04,083782,Rotar; Vladimir,6,0,34,28
1656816503892,MATH 193A,A05,093482,Rotar; Vladimir,6,0,34,28
1656816509916,MATH 197,001,091859,McAuley; Julian John,9999,0,9999,0
1656816509916,MATH 197,002,095566,Kedlaya; Kiran S.,9997,0,9999,2
1656816509916,MATH 197,003,095567,Xiao; Ming,9999,0,9999,0
1656816509916,MATH 197,004,095571,Perols; Johan Lars,9998,0,9999,1
1656816516990,COGS 9,A01,083615,Shannon; Kyle Michael,6,0,75,69
1656816523027,COGS 11,A01,083617,Boyle; Mary E. T.,18,0,48,30
1656816529050,COGS 13,A01,083071,Bastos; Amalia Pinkusfeld,8,0,71,63
1656816535079,COGS 14A,A01,092681,Semenuks; Arturs,0,1,100,100
1656816541104,COGS 14B,A01,083073,Cheng; Tzu-Han,5,0,63,58
1656816547127,COGS 17,A01,092677,Semenuks; Arturs,4,0,81,77
1656816553157,COGS 100,A01,083619,Allen; Michael Gordon,15,0,70,55
1656816559178,COGS 101A,A01,083621,Davis; Joshua Daniel,9,0,68,59
1656816565208,COGS 101B,A01,091572,Allen; Michael Gordon,8,0,65,57
1656816571235,COGS 101C,A01,083625,Delgado; Tania,17,0,35,18
1656816577256,COGS 107A,A01,083627,Boyle; Mary E. T.,13,0,60,47
1656816583281,COGS 118A,A01,083075,Gupta; Anjum,15,0,76,61
1656816589307,CSE 3,A50,083646,Miranda; Gregory Joseph,22,0,50,28
1656816595331,CSE 8A,A50,083650,Miranda; Gregory Joseph,17,1,56,39
1656816601362,CSE 11,A01,083080,Cao; Yingjun,4,15,40,36
1656816607391,CSE 12,A01,083652,Krause-Levy; Sophia Louisa,20,1,120,100
1656816613416,CSE 15L,A01,083654,Morris; Justin Loren,8,0,50,42
1656816613416,CSE 15L,A02,083655,Morris; Justin Loren,8,0,50,42
1656816619440,CSE 20,A01,083657,Tran; Khoa Dang,37,0,80,43
1656816625468,CSE 21,A01,095574,Bach; Quang Tran,21,0,48,27
1656816631492,CSE 30,A01,083084,Eldon; John,4,0,80,76
1656816631492,CSE 30,B01,095061,Bhaskar; Nishant,6,0,50,44
1656816637516,CSE 100,A01,083659,Cao; Yingjun,1,4,70,69
1656816643543,CSE 134B,A01,083661,Powell; Thomas Allan,18,0,100,82
1656816649570,CSE 140,A01,083663,Gungor; Onat,14,0,85,71
1656816655592,CSE 140L,A01,083088,Eldon; John,16,0,100,84
1656816661619,CSE 175,A01,083665,Kumar; Rakesh,3,0,25,22
1656816667643,CSE 190,A00,092507,Dubnov; Shlomo,7,0,20,13
1656816673668,ECE 45,A01,083139,Congero; Spencer William,5,0,75,70
1656816679695,ECE 65,A50,083695,Saad; Andrew S,12,0,30,18
1656816679695,ECE 65,A51,095125,Saad; Andrew S,25,0,26,1
1656816685719,ECE 109,A01,091882,Touri; Behrouz,15,0,70,55
1656816691823,ECE 180,A00,083140,Abi Samra; Nicholas Camill,0,0,30,30
1656816691823,ECE 180,B00,083141,Abi Samra; Nicholas Camill,0,0,30,30
1656816697847,MATH 10A,A01,083735,Patchell; Gregory David,1,0,30,29
1656816697847,MATH 10A,A02,083736,Patchell; Gregory David,20,0,30,10
1656816697847,MATH 10A,A03,083737,Patchell; Gregory David,15,0,30,15
1656816703875,MATH 10B,A01,083207,Lim; Seonhee,7,0,34,27
1656816703875,MATH 10B,A02,083208,Lim; Seonhee,9,0,35,26
1656816703875,MATH 10B,A03,093472,Lim; Seonhee,4,0,34,30
1656816703875,MATH 10B,B01,083739,Sinha; Shubham,9,0,30,21
1656816709902,MATH 18,A01,083743,Cinel; Cameron Alexander,6,0,30,24
1656816709902,MATH 18,A02,083744,Cinel; Cameron Alexander,15,0,30,15
1656816709902,MATH 18,A03,083745,Cinel; Cameron Alexander,8,0,30,22
1656816709902,MATH 18,B01,083748,Rideout; David Porter,3,0,37,34
1656816709902,MATH 18,B02,083749,Rideout; David Porter,3,0,36,33
1656816709902,MATH 18,B03,083750,Rideout; David Porter,1,0,37,36
1656816709902,MATH 18,B04,083751,Rideout; David Porter,5,0,36,31
1656816709902,MATH 18,B05,093473,Rideout; David Porter,4,0,36,32
1656816709902,MATH 18,B06,093474,Rideout; David Porter,5,0,36,31
1656816715925,MATH 20A,A01,083754,Zheng; Zequn,12,0,40,28
1656816721952,MATH 20B,A01,083756,Briones; Jor-el Thomas Caparas,1,0,36,35
1656816721952,MATH 20B,A02,083757,Briones; Jor-el Thomas Caparas,1,0,36,35
1656816721952,MATH 20B,A03,093475,Briones; Jor-el Thomas Caparas,0,0,36,36
1656816727983,MATH 20C,A01,083760,Briones; Jor-el Thomas Caparas,1,0,35,34
1656816727983,MATH 20C,A02,083761,Briones; Jor-el Thomas Caparas,8,0,35,27
1656816727983,MATH 20C,A03,093476,Briones; Jor-el Thomas Caparas,0,1,36,36
1656816727983,MATH 20C,B01,083762,Bach; Quang Tran,0,0,30,30
1656816734009,MATH 20D,A01,083765,Tran; Brian Kha,4,0,30,26
1656816734009,MATH 20D,A02,083766,Tran; Brian Kha,4,0,30,26
1656816734009,MATH 20D,A03,083767,Tran; Brian Kha,2,0,30,28
1656816740033,MATH 20E,A01,083771,Ganguly; Soumya,5,0,32,27
1656816740033,MATH 20E,A02,083772,Ganguly; Soumya,5,0,32,27
1656816740033,MATH 20E,B01,083773,Ciotti; Benjamin,18,0,35,17
1656816740033,MATH 20E,B02,083774,Ciotti; Benjamin,17,0,35,18
1656816746067,MATH 103A,A01,083777,Greenfeld; Be'Eri,2,0,36,34
1656816746067,MATH 103A,A02,083778,Greenfeld; Be'Eri,5,0,36,31
1656816746067,MATH 103A,A03,093561,Greenfeld; Be'Eri,4,0,36,32
1656816746067,MATH 103A,B01,083779,Greenfeld; Be'Eri,6,0,36,30
1656816746067,MATH 103A,B02,083780,Greenfeld; Be'Eri,2,0,36,34
1656816746067,MATH 103A,B03,093562,Greenfeld; Be'Eri,2,0,36,34
1656816752089,MATH 105,A01,085443,Carter; Anne Toulson,13,0,35,22
1656816752089,MATH 105,A02,093477,Carter; Anne Toulson,20,0,35,15
1656816758114,MATH 109,A01,083213,Ganzberger; Geoffrey Michael,2,0,34,32
1656816758114,MATH 109,A02,083214,Ganzberger; Geoffrey Michael,2,0,34,32
1656816758114,MATH 109,A03,093478,Ganzberger; Geoffrey Michael,1,0,34,33
1656816758114,MATH 109,B01,083215,Ganzberger; Geoffrey Michael,1,0,32,31
1656816758114,MATH 109,B02,083216,Ganzberger; Geoffrey Michael,1,0,32,31
1656816758114,MATH 109,B03,093479,Ganzberger; Geoffrey Michael,6,0,32,26
1656816764139,MATH 142A,A01,083219,Chow; Bennett,6,0,32,26
1656816764139,MATH 142A,A02,083220,Chow; Bennett,9,0,32,23
1656816764139,MATH 142A,A03,093480,Chow; Bennett,7,0,32,25
1656816764139,MATH 142A,B03,093481,Chow; Bennett,7,0,32,25
1656816764139,MATH 142A,B04,093558,Chow; Bennett,10,0,32,22
1656816764139,MATH 142A,B05,093559,Chow; Bennett,6,0,32,26
1656816770167,MATH 193A,A01,083224,Rotar; Vladimir,6,0,34,28
1656816770167,MATH 193A,A02,083225,Rotar; Vladimir,3,0,34,31
1656816770167,MATH 193A,A03,083781,Rotar; Vladimir,1,0,34,33
1656816770167,MATH 193A,A04,083782,Rotar; Vladimir,6,0,34,28
1656816770167,MATH 193A,A05,093482,Rotar; Vladimir,6,0,34,28
1656816776195,MATH 197,001,091859,McAuley; Julian John,9999,0,9999,0
1656816776195,MATH 197,002,095566,Kedlaya; Kiran S.,9997,0,9999,2
1656816776195,MATH 197,003,095567,Xiao; Ming,9999,0,9999,0
1656816776195,MATH 197,004,095571,Perols; Johan Lars,9998,0,9999,1
1656816783290,COGS 9,A01,083615,Shannon; Kyle Michael,6,0,75,69
1656816789321,COGS 11,A01,083617,Boyle; Mary E. T.,18,0,48,30
1656816795349,COGS 13,A01,083071,Bastos; Amalia Pinkusfeld,8,0,71,63
1656816801381,COGS 14A,A01,092681,Semenuks; Arturs,0,1,100,100
1656816807409,COGS 14B,A01,083073,Cheng; Tzu-Han,5,0,63,58
1656816813433,COGS 17,A01,092677,Semenuks; Arturs,4,0,81,77
1656816819457,COGS 100,A01,083619,Allen; Michael Gordon,15,0,70,55
1656816825485,COGS 101A,A01,083621,Davis; Joshua Daniel,9,0,68,59
1656816831510,COGS 101B,A01,091572,Allen; Michael Gordon,8,0,65,57
1656816837533,COGS 101C,A01,083625,Delgado; Tania,17,0,35,18
1656816843556,COGS 107A,A01,083627,Boyle; Mary E. T.,13,0,60,47
1656816849586,COGS 118A,A01,083075,Gupta; Anjum,15,0,76,61
1656816855617,CSE 3,A50,083646,Miranda; Gregory Joseph,22,0,50,28
1656816861641,CSE 8A,A50,083650,Miranda; Gregory Joseph,17,1,56,39
1656816867669,CSE 11,A01,083080,Cao; Yingjun,4,15,40,36
1656816873693,CSE 12,A01,083652,Krause-Levy; Sophia Louisa,20,1,120,100
1656816879717,CSE 15L,A01,083654,Morris; Justin Loren,8,0,50,42
1656816879717,CSE 15L,A02,083655,Morris; Justin Loren,8,0,50,42
1656816885741,CSE 20,A01,083657,Tran; Khoa Dang,37,0,80,43
1656816891765,CSE 21,A01,095574,Bach; Quang Tran,21,0,48,27
1656816897790,CSE 30,A01,083084,Eldon; John,4,0,80,76
1656816897790,CSE 30,B01,095061,Bhaskar; Nishant,6,0,50,44
1656816903821,CSE 100,A01,083659,Cao; Yingjun,1,4,70,69
1656816909846,CSE 134B,A01,083661,Powell; Thomas Allan,18,0,100,82
1656816915871,CSE 140,A01,083663,Gungor; Onat,14,0,85,71
1656816921898,CSE 140L,A01,083088,Eldon; John,16,0,100,84
1656816927923,CSE 175,A01,083665,Kumar; Rakesh,3,0,25,22
1656816933964,CSE 190,A00,092507,Dubnov; Shlomo,7,0,20,13
1656816939990,ECE 45,A01,083139,Congero; Spencer William,5,0,75,70
1656816946029,ECE 65,A50,083695,Saad; Andrew S,12,0,30,18
1656816946029,ECE 65,A51,095125,Saad; Andrew S,25,0,26,1
1656816952054,ECE 109,A01,091882,Touri; Behrouz,15,0,70,55
1656816958080,ECE 180,A00,083140,Abi Samra; Nicholas Camill,0,0,30,30
1656816958080,ECE 180,B00,083141,Abi Samra; Nicholas Camill,0,0,30,30
1656816964106,MATH 10A,A01,083735,Patchell; Gregory David,1,0,30,29
1656816964106,MATH 10A,A02,083736,Patchell; Gregory David,20,0,30,10
1656816964106,MATH 10A,A03,083737,Patchell; Gregory David,15,0,30,15
1656816970128,MATH 10B,A01,083207,Lim; Seonhee,7,0,34,27
1656816970128,MATH 10B,A02,083208,Lim; Seonhee,9,0,35,26
1656816970128,MATH 10B,A03,093472,Lim; Seonhee,4,0,34,30
1656816970128,MATH 10B,B01,083739,Sinha; Shubham,9,0,30,21
1656816976155,MATH 18,A01,083743,Cinel; Cameron Alexander,6,0,30,24
1656816976155,MATH 18,A02,083744,Cinel; Cameron Alexander,15,0,30,15
1656816976155,MATH 18,A03,083745,Cinel; Cameron Alexander,8,0,30,22
1656816976155,MATH 18,B01,083748,Rideout; David Porter,3,0,37,34
1656816976155,MATH 18,B02,083749,Rideout; David Porter,3,0,36,33
1656816976155,MATH 18,B03,083750,Rideout; David Porter,1,0,37,36
1656816976155,MATH 18,B04,083751,Rideout; David Porter,5,0,36,31
1656816976155,MATH 18,B05,093473,Rideout; David Porter,4,0,36,32
1656816976155,MATH 18,B06,093474,Rideout; David Porter,5,0,36,31
1656816982178,MATH 20A,A01,083754,Zheng; Zequn,12,0,40,28
1656816988203,MATH 20B,A01,083756,Briones; Jor-el Thomas Caparas,1,0,36,35
1656816988203,MATH 20B,A02,083757,Briones; Jor-el Thomas Caparas,1,0,36,35
1656816988203,MATH 20B,A03,093475,Briones; Jor-el Thomas Caparas,0,0,36,36
1656816994236,MATH 20C,A01,083760,Briones; Jor-el Thomas Caparas,1,0,35,34
1656816994236,MATH 20C,A02,083761,Briones; Jor-el Thomas Caparas,8,0,35,27
1656816994236,MATH 20C,A03,093476,Briones; Jor-el Thomas Caparas,0,1,36,36
1656816994236,MATH 20C,B01,083762,Bach; Quang Tran,0,0,30,30
1656817000272,MATH 20D,A01,083765,Tran; Brian Kha,4,0,30,26
1656817000272,MATH 20D,A02,083766,Tran; Brian Kha,4,0,30,26
1656817000272,MATH 20D,A03,083767,Tran; Brian Kha,2,0,30,28
1656817006295,MATH 20E,A01,083771,Ganguly; Soumya,5,0,32,27
1656817006295,MATH 20E,A02,083772,Ganguly; Soumya,5,0,32,27
1656817006295,MATH 20E,B01,083773,Ciotti; Benjamin,18,0,35,17
1656817006295,MATH 20E,B02,083774,Ciotti; Benjamin,17,0,35,18
1656817012324,MATH 103A,A01,083777,Greenfeld; Be'Eri,2,0,36,34
1656817012324,MATH 103A,A02,083778,Greenfeld; Be'Eri,5,0,36,31
1656817012324,MATH 103A,A03,093561,Greenfeld; Be'Eri,4,0,36,32
1656817012324,MATH 103A,B01,083779,Greenfeld; Be'Eri,6,0,36,30
1656817012324,MATH 103A,B02,083780,Greenfeld; Be'Eri,2,0,36,34
1656817012324,MATH 103A,B03,093562,Greenfeld; Be'Eri,2,0,36,34
1656817018352,MATH 105,A01,085443,Carter; Anne Toulson,13,0,35,22
1656817018352,MATH 105,A02,093477,Carter; Anne Toulson,20,0,35,15
1656817024376,MATH 109,A01,083213,Ganzberger; Geoffrey Michael,2,0,34,32
1656817024376,MATH 109,A02,083214,Ganzberger; Geoffrey Michael,2,0,34,32
1656817024376,MATH 109,A03,093478,Ganzberger; Geoffrey Michael,1,0,34,33
1656817024376,MATH 109,B01,083215,Ganzberger; Geoffrey Michael,1,0,32,31
1656817024376,MATH 109,B02,083216,Ganzberger; Geoffrey Michael,1,0,32,31
1656817024376,MATH 109,B03,093479,Ganzberger; Geoffrey Michael,6,0,32,26
1656817030400,MATH 142A,A01,083219,Chow; Bennett,6,0,32,26
1656817030400,MATH 142A,A02,083220,Chow; Bennett,9,0,32,23
1656817030400,MATH 142A,A03,093480,Chow; Bennett,7,0,32,25
1656817030400,MATH 142A,B03,093481,Chow; Bennett,7,0,32,25
1656817030400,MATH 142A,B04,093558,Chow; Bennett,10,0,32,22
1656817030400,MATH 142A,B05,093559,Chow; Bennett,6,0,32,26
1656817036432,MATH 193A,A01,083224,Rotar; Vladimir,6,0,34,28
1656817036432,MATH 193A,A02,083225,Rotar; Vladimir,3,0,34,31
1656817036432,MATH 193A,A03,083781,Rotar; Vladimir,1,0,34,33
1656817036432,MATH 193A,A04,083782,Rotar; Vladimir,6,0,34,28
1656817036432,MATH 193A,A05,093482,Rotar; Vladimir,6,0,34,28
1656817042461,MATH 197,001,091859,McAuley; Julian John,9999,0,9999,0
1656817042461,MATH 197,002,095566,Kedlaya; Kiran S.,9997,0,9999,2
1656817042461,MATH 197,003,095567,Xiao; Ming,9999,0,9999,0
1656817042461,MATH 197,004,095571,Perols; Johan Lars,9998,0,9999,1
1656817049526,COGS 9,A01,083615,Shannon; Kyle Michael,6,0,75,69
1656817055550,COGS 11,A01,083617,Boyle; Mary E. T.,18,0,48,30
1656817061573,COGS 13,A01,083071,Bastos; Amalia Pinkusfeld,8,0,71,63
1656817067597,COGS 14A,A01,092681,Semenuks; Arturs,0,1,100,100
1656817073622,COGS 14B,A01,083073,Cheng; Tzu-Han,5,0,63,58
1656817079644,COGS 17,A01,092677,Semenuks; Arturs,4,0,81,77
1656817085675,COGS 100,A01,083619,Allen; Michael Gordon,15,0,70,55
1656817091699,COGS 101A,A01,083621,Davis; Joshua Daniel,9,0,68,59
1656817097726,COGS 101B,A01,091572,Allen; Michael Gordon,8,0,65,57
1656817103748,COGS 101C,A01,083625,Delgado; Tania,17,0,35,18
1656817109776,COGS 107A,A01,083627,Boyle; Mary E. T.,13,0,60,47
1656817115800,COGS 118A,A01,083075,Gupta; Anjum,15,0,76,61
1656817121826,CSE 3,A50,083646,Miranda; Gregory Joseph,22,0,50,28
1656817127855,CSE 8A,A50,083650,Miranda; Gregory Joseph,17,1,56,39
1656817133883,CSE 11,A01,083080,Cao; Yingjun,4,15,40,36
1656817139917,CSE 12,A01,083652,Krause-Levy; Sophia Louisa,20,1,120,100
1656817145946,CSE 15L,A01,083654,Morris; Justin Loren,8,0,50,42
1656817145946,CSE 15L,A02,083655,Morris; Justin Loren,8,0,50,42
1656817151975,CSE 20,A01,083657,Tran; Khoa Dang,37,0,80,43
1656817157998,CSE 21,A01,095574,Bach; Quang Tran,21,0,48,27
1656817164022,CSE 30,A01,083084,Eldon; John,4,0,80,76
1656817164022,CSE 30,B01,095061,Bhaskar; Nishant,6,0,50,44
1656817170056,CSE 100,A01,083659,Cao; Yingjun,1,4,70,69
1656817176081,CSE 134B,A01,083661,Powell; Thomas Allan,18,0,100,82
1656817182104,CSE 140,A01,083663,Gungor; Onat,14,0,85,71
1656817188129,CSE 140L,A01,083088,Eldon; John,16,0,100,84
1656817194152,CSE 175,A01,083665,Kumar; Rakesh,3,0,25,22
1656817200176,CSE 190,A00,092507,Dubnov; Shlomo,7,0,20,13
1656817206199,ECE 45,A01,083139,Congero; Spencer William,5,0,75,70
1656817212228,ECE 65,A50,083695,Saad; Andrew S,12,0,30,18
1656817212228,ECE 65,A51,095125,Saad; Andrew S,25,0,26,1
1656817218256,ECE 109,A01,091882,Touri; Behrouz,15,0,70,55
1656817224285,ECE 180,A00,083140,Abi Samra; Nicholas Camill,0,0,30,30
1656817224285,ECE 180,B00,083141,Abi Samra; Nicholas Camill,0,0,30,30
1656817230316,MATH 10A,A01,083735,Patchell; Gregory David,1,0,30,29
1656817230316,MATH 10A,A02,083736,Patchell; Gregory David,20,0,30,10
1656817230316,MATH 10A,A03,083737,Patchell; Gregory David,15,0,30,15
1656817236340,MATH 10B,A01,083207,Lim; Seonhee,7,0,34,27
1656817236340,MATH 10B,A02,083208,Lim; Seonhee,9,0,35,26
1656817236340,MATH 10B,A03,093472,Lim; Seonhee,4,0,34,30
1656817236340,MATH 10B,B01,083739,Sinha; Shubham,9,0,30,21
1656817242365,MATH 18,A01,083743,Cinel; Cameron Alexander,6,0,30,24
1656817242365,MATH 18,A02,083744,Cinel; Cameron Alexander,15,0,30,15
1656817242365,MATH 18,A03,083745,Cinel; Cameron Alexander,8,0,30,22
1656817242365,MATH 18,B01,083748,Rideout; David Porter,3,0,37,34
1656817242365,MATH 18,B02,083749,Rideout; David Porter,3,0,36,33
1656817242365,MATH 18,B03,083750,Rideout; David Porter,1,0,37,36
1656817242365,MATH 18,B04,083751,Rideout; David Porter,5,0,36,31
1656817242365,MATH 18,B05,093473,Rideout; David Porter,4,0,36,32
1656817242365,MATH 18,B06,093474,Rideout; David Porter,5,0,36,31
1656817248388,MATH 20A,A01,083754,Zheng; Zequn,12,0,40,28
1656817254412,MATH 20B,A01,083756,Briones; Jor-el Thomas Caparas,1,0,36,35
1656817254412,MATH 20B,A02,083757,Briones; Jor-el Thomas Caparas,1,0,36,35
1656817254412,MATH 20B,A03,093475,Briones; Jor-el Thomas Caparas,0,0,36,36
1656817260437,MATH 20C,A01,083760,Briones; Jor-el Thomas Caparas,1,0,35,34
1656817260437,MATH 20C,A02,083761,Briones; Jor-el Thomas Caparas,8,0,35,27
1656817260437,MATH 20C,A03,093476,Briones; Jor-el Thomas Caparas,0,1,36,36
1656817260437,MATH 20C,B01,083762,Bach; Quang Tran,0,0,30,30
1656817266461,MATH 20D,A01,083765,Tran; Brian Kha,4,0,30,26
1656817266461,MATH 20D,A02,083766,Tran; Brian Kha,4,0,30,26
1656817266461,MATH 20D,A03,083767,Tran; Brian Kha,2,0,30,28
1656817272486,MATH 20E,A01,083771,Ganguly; Soumya,5,0,32,27
1656817272486,MATH 20E,A02,083772,Ganguly; Soumya,5,0,32,27
1656817272486,MATH 20E,B01,083773,Ciotti; Benjamin,18,0,35,17
1656817272486,MATH 20E,B02,083774,Ciotti; Benjamin,17,0,35,18
1656817278514,MATH 103A,A01,083777,Greenfeld; Be'Eri,2,0,36,34
1656817278514,MATH 103A,A02,083778,Greenfeld; Be'Eri,5,0,36,31
1656817278514,MATH 103A,A03,093561,Greenfeld; Be'Eri,4,0,36,32
1656817278514,MATH 103A,B01,083779,Greenfeld; Be'Eri,6,0,36,30
1656817278514,MATH 103A,B02,083780,Greenfeld; Be'Eri,2,0,36,34
1656817278514,MATH 103A,B03,093562,Greenfeld; Be'Eri,2,0,36,34
1656817284538,MATH 105,A01,085443,Carter; Anne Toulson,13,0,35,22
1656817284538,MATH 105,A02,093477,Carter; Anne Toulson,20,0,35,15
1656817290643,MATH 109,A01,083213,Ganzberger; Geoffrey Michael,2,0,34,32
1656817290643,MATH 109,A02,083214,Ganzberger; Geoffrey Michael,2,0,34,32
1656817290643,MATH 109,A03,093478,Ganzberger; Geoffrey Michael,1,0,34,33
1656817290643,MATH 109,B01,083215,Ganzberger; Geoffrey Michael,1,0,32,31
1656817290643,MATH 109,B02,083216,Ganzberger; Geoffrey Michael,1,0,32,31
1656817290643,MATH 109,B03,093479,Ganzberger; Geoffrey Michael,6,0,32,26
1656817296665,MATH 142A,A01,083219,Chow; Bennett,6,0,32,26
1656817296665,MATH 142A,A02,083220,Chow; Bennett,9,0,32,23
1656817296665,MATH 142A,A03,093480,Chow; Bennett,7,0,32,25
1656817296665,MATH 142A,B03,093481,Chow; Bennett,7,0,32,25
1656817296665,MATH 142A,B04,093558,Chow; Bennett,10,0,32,22
1656817296665,MATH 142A,B05,093559,Chow; Bennett,6,0,32,26
1656817302700,MATH 193A,A01,083224,Rotar; Vladimir,6,0,34,28
1656817302700,MATH 193A,A02,083225,Rotar; Vladimir,3,0,34,31
1656817302700,MATH 193A,A03,083781,Rotar; Vladimir,1,0,34,33
1656817302700,MATH 193A,A04,083782,Rotar; Vladimir,6,0,34,28
1656817302700,MATH 193A,A05,093482,Rotar; Vladimir,6,0,34,28
1656817308727,MATH 197,001,091859,McAuley; Julian John,9999,0,9999,0
1656817308727,MATH 197,002,095566,Kedlaya; Kiran S.,9997,0,9999,2
1656817308727,MATH 197,003,095567,Xiao; Ming,9999,0,9999,0
1656817308727,MATH 197,004,095571,Perols; Johan Lars,9998,0,9999,1
1656817315791,COGS 9,A01,083615,Shannon; Kyle Michael,6,0,75,69
1656817321814,COGS 11,A01,083617,Boyle; Mary E. T.,18,0,48,30
1656817327837,COGS 13,A01,083071,Bastos; Amalia Pinkusfeld,8,0,71,63
1656817333866,COGS 14A,A01,092681,Semenuks; Arturs,0,1,100,100
1656817339893,COGS 14B,A01,083073,Cheng; Tzu-Han,5,0,63,58
1656817345920,COGS 17,A01,092677,Semenuks; Arturs,4,0,81,77
1656817351943,COGS 100,A01,083619,Allen; Michael Gordon,15,0,70,55
1656817357969,COGS 101A,A01,083621,Davis; Joshua Daniel,9,0,68,59
1656817363998,COGS 101B,A01,091572,Allen; Michael Gordon,8,0,65,57
1656817370027,COGS 101C,A01,083625,Delgado; Tania,17,0,35,18
1656817376058,COGS 107A,A01,083627,Boyle; Mary E. T.,13,0,60,47
1656817382082,COGS 118A,A01,083075,Gupta; Anjum,15,0,76,61
1656817388112,CSE 3,A50,083646,Miranda; Gregory Joseph,22,0,50,28
1656817394140,CSE 8A,A50,083650,Miranda; Gregory Joseph,17,1,56,39
1656817400164,CSE 11,A01,083080,Cao; Yingjun,4,15,40,36
1656817406189,CSE 12,A01,083652,Krause-Levy; Sophia Louisa,20,1,120,100
1656817412213,CSE 15L,A01,083654,Morris; Justin Loren,8,0,50,42
1656817412213,CSE 15L,A02,083655,Morris; Justin Loren,8,0,50,42
1656817418240,CSE 20,A01,083657,Tran; Khoa Dang,37,0,80,43
1656817424265,CSE 21,A01,095574,Bach; Quang Tran,21,0,48,27
1656817430289,CSE 30,A01,083084,Eldon; John,4,0,80,76
1656817430289,CSE 30,B01,095061,Bhaskar; Nishant,6,0,50,44
1656817436313,CSE 100,A01,083659,Cao; Yingjun,1,4,70,69
1656817442346,CSE 134B,A01,083661,Powell; Thomas Allan,18,0,100,82
1656817448372,CSE 140,A01,083663,Gungor; Onat,14,0,85,71
1656817454399,CSE 140L,A01,083088,Eldon; John,16,0,100,84
1656817460427,CSE 175,A01,083665,Kumar; Rakesh,3,0,25,22
1656817466452,CSE 190,A00,092507,Dubnov; Shlomo,7,0,20,13
1656817472477,ECE 45,A01,083139,Congero; Spencer William,5,0,75,70
1656817478505,ECE 65,A50,083695,Saad; Andrew S,12,0,30,18
1656817478505,ECE 65,A51,095125,Saad; Andrew S,25,0,26,1
1656817484532,ECE 109,A01,091882,Touri; Behrouz,15,0,70,55
1656817490556,ECE 180,A00,083140,Abi Samra; Nicholas Camill,0,0,30,30
1656817490556,ECE 180,B00,083141,Abi Samra; Nicholas Camill,0,0,30,30
1656817496581,MATH 10A,A01,083735,Patchell; Gregory David,1,0,30,29
1656817496581,MATH 10A,A02,083736,Patchell; Gregory David,20,0,30,10
1656817496581,MATH 10A,A03,083737,Patchell; Gregory David,15,0,30,15
1656817502611,MATH 10B,A01,083207,Lim; Seonhee,7,0,34,27
1656817502611,MATH 10B,A02,083208,Lim; Seonhee,9,0,35,26
1656817502611,MATH 10B,A03,093472,Lim; Seonhee,4,0,34,30
1656817502611,MATH 10B,B01,083739,Sinha; Shubham,9,0,30,21
1656817508636,MATH 18,A01,083743,Cinel; Cameron Alexander,6,0,30,24
1656817508636,MATH 18,A02,083744,Cinel; Cameron Alexander,15,0,30,15
1656817508636,MATH 18,A03,083745,Cinel; Cameron Alexander,8,0,30,22
1656817508636,MATH 18,B01,083748,Rideout; David Porter,3,0,37,34
1656817508636,MATH 18,B02,083749,Rideout; David Porter,3,0,36,33
1656817508636,MATH 18,B03,083750,Rideout; David Porter,1,0,37,36
1656817508636,MATH 18,B04,083751,Rideout; David Porter,5,0,36,31
1656817508636,MATH 18,B05,093473,Rideout; David Porter,4,0,36,32
1656817508636,MATH 18,B06,093474,Rideout; David Porter,5,0,36,31
1656817514660,MATH 20A,A01,083754,Zheng; Zequn,12,0,40,28
1656817520684,MATH 20B,A01,083756,Briones; Jor-el Thomas Caparas,1,0,36,35
1656817520684,MATH 20B,A02,083757,Briones; Jor-el Thomas Caparas,1,0,36,35
1656817520684,MATH 20B,A03,093475,Briones; Jor-el Thomas Caparas,0,0,36,36
1656817526714,MATH 20C,A01,083760,Briones; Jor-el Thomas Caparas,1,0,35,34
1656817526714,MATH 20C,A02,083761,Briones; Jor-el Thomas Caparas,8,0,35,27
1656817526714,MATH 20C,A03,093476,Briones; Jor-el Thomas Caparas,0,1,36,36
1656817526714,MATH 20C,B01,083762,Bach; Quang Tran,0,0,30,30
1656817532744,MATH 20D,A01,083765,Tran; Brian Kha,4,0,30,26
1656817532744,MATH 20D,A02,083766,Tran; Brian Kha,4,0,30,26
1656817532744,MATH 20D,A03,083767,Tran; Brian Kha,2,0,30,28
1656817538769,MATH 20E,A01,083771,Ganguly; Soumya,5,0,32,27
1656817538769,MATH 20E,A02,083772,Ganguly; Soumya,5,0,32,27
1656817538769,MATH 20E,B01,083773,Ciotti; Benjamin,18,0,35,17
1656817538769,MATH 20E,B02,083774,Ciotti; Benjamin,17,0,35,18
1656817544794,MATH 103A,A01,083777,Greenfeld; Be'Eri,2,0,36,34
1656817544794,MATH 103A,A02,083778,Greenfeld; Be'Eri,5,0,36,31
1656817544794,MATH 103A,A03,093561,Greenfeld; Be'Eri,4,0,36,32
1656817544794,MATH 103A,B01,083779,Greenfeld; Be'Eri,6,0,36,30
1656817544794,MATH 103A,B02,083780,Greenfeld; Be'Eri,2,0,36,34
1656817544794,MATH 103A,B03,093562,Greenfeld; Be'Eri,2,0,36,34
1656817550816,MATH 105,A01,085443,Carter; Anne Toulson,13,0,35,22
1656817550816,MATH 105,A02,093477,Carter; Anne Toulson,20,0,35,15
1656817556839,MATH 109,A01,083213,Ganzberger; Geoffrey Michael,2,0,34,32
1656817556839,MATH 109,A02,083214,Ganzberger; Geoffrey Michael,2,0,34,32
1656817556839,MATH 109,A03,093478,Ganzberger; Geoffrey Michael,1,0,34,33
1656817556839,MATH 109,B01,083215,Ganzberger; Geoffrey Michael,1,0,32,31
1656817556839,MATH 109,B02,083216,Ganzberger; Geoffrey Michael,1,0,32,31
1656817556839,MATH 109,B03,093479,Ganzberger; Geoffrey Michael,6,0,32,26
1656817562864,MATH 142A,A01,083219,Chow; Bennett,6,0,32,26
1656817562864,MATH 142A,A02,083220,Chow; Bennett,9,0,32,23
1656817562864,MATH 142A,A03,093480,Chow; Bennett,7,0,32,25
1656817562864,MATH 142A,B03,093481,Chow; Bennett,7,0,32,25
1656817562864,MATH 142A,B04,093558,Chow; Bennett,10,0,32,22
1656817562864,MATH 142A,B05,093559,Chow; Bennett,6,0,32,26
1656817568898,MATH 193A,A01,083224,Rotar; Vladimir,6,0,34,28
1656817568898,MATH 193A,A02,083225,Rotar; Vladimir,3,0,34,31
1656817568898,MATH 193A,A03,083781,Rotar; Vladimir,1,0,34,33
1656817568898,MATH 193A,A04,083782,Rotar; Vladimir,6,0,34,28
1656817568898,MATH 193A,A05,093482,Rotar; Vladimir,6,0,34,28
1656817574926,MATH 197,001,091859,McAuley; Julian John,9999,0,9999,0
1656817574926,MATH 197,002,095566,Kedlaya; Kiran S.,9997,0,9999,2
1656817574926,MATH 197,003,095567,Xiao; Ming,9999,0,9999,0
1656817574926,MATH 197,004,095571,Perols; Johan Lars,9998,0,9999,1
1656817581982,COGS 9,A01,083615,Shannon; Kyle Michael,6,0,75,69
1656817588004,COGS 11,A01,083617,Boyle; Mary E. T.,18,0,48,30
1656817594034,COGS 13,A01,083071,Bastos; Amalia Pinkusfeld,8,0,71,63
1656817600065,COGS 14A,A01,092681,Semenuks; Arturs,0,1,100,100
1656817606094,COGS 14B,A01,083073,Cheng; Tzu-Han,5,0,63,58
1656817612121,COGS 17,A01,092677,Semenuks; Arturs,4,0,81,77
1656817618147,COGS 100,A01,083619,Allen; Michael Gordon,15,0,70,55
1656817624176,COGS 101A,A01,083621,Davis; Joshua Daniel,9,0,68,59
1656817630206,COGS 101B,A01,091572,Allen; Michael Gordon,8,0,65,57
1656817636230,COGS 101C,A01,083625,Delgado; Tania,17,0,35,18
1656817642256,COGS 107A,A01,083627,Boyle; Mary E. T.,13,0,60,47
1656817648281,COGS 118A,A01,083075,Gupta; Anjum,15,0,76,61
1656817654311,CSE 3,A50,083646,Miranda; Gregory Joseph,22,0,50,28
1656817660333,CSE 8A,A50,083650,Miranda; Gregory Joseph,17,1,56,39
1656817666361,CSE 11,A01,083080,Cao; Yingjun,4,15,40,36
1656817672387,CSE 12,A01,083652,Krause-Levy; Sophia Louisa,20,1,120,100
1656817678413,CSE 15L,A01,083654,Morris; Justin Loren,8,0,50,42
1656817678413,CSE 15L,A02,083655,Morris; Justin Loren,8,0,50,42
1656817684442,CSE 20,A01,083657,Tran; Khoa Dang,37,0,80,43
1656817690466,CSE 21,A01,095574,Bach; Quang Tran,21,0,48,27
1656817696493,CSE 30,A01,083084,Eldon; John,4,0,80,76
1656817696493,CSE 30,B01,095061,Bhaskar; Nishant,6,0,50,44
1656817702517,CSE 100,A01,083659,Cao; Yingjun,1,4,70,69
1656817708549,CSE 134B,A01,083661,Powell; Thomas Allan,18,0,100,82
1656817714581,CSE 140,A01,083663,Gungor; Onat,14,0,85,71
1656817720608,CSE 140L,A01,083088,Eldon; John,16,0,100,84
1656817726634,CSE 175,A01,083665,Kumar; Rakesh,3,0,25,22
1656817732660,CSE 190,A00,092507,Dubnov; Shlomo,7,0,20,13
1656817738687,ECE 45,A01,083139,Congero; Spencer William,5,0,75,70
1656817744716,ECE 65,A50,083695,Saad; Andrew S,12,0,30,18
1656817744716,ECE 65,A51,095125,Saad; Andrew S,25,0,26,1
1656817750741,ECE 109,A01,091882,Touri; Behrouz,15,0,70,55
1656817756766,ECE 180,A00,083140,Abi Samra; Nicholas Camill,0,0,30,30
1656817756766,ECE 180,B00,083141,Abi Samra; Nicholas Camill,0,0,30,30
1656817762792,MATH 10A,A01,083735,Patchell; Gregory David,1,0,30,29
1656817762792,MATH 10A,A02,083736,Patchell; Gregory David,20,0,30,10
1656817762792,MATH 10A,A03,083737,Patchell; Gregory David,15,0,30,15
1656817768824,MATH 10B,A01,083207,Lim; Seonhee,7,0,34,27
1656817768824,MATH 10B,A02,083208,Lim; Seonhee,9,0,35,26
1656817768824,MATH 10B,A03,093472,Lim; Seonhee,4,0,34,30
1656817768824,MATH 10B,B01,083739,Sinha; Shubham,9,0,30,21
1656817774861,MATH 18,A01,083743,Cinel; Cameron Alexander,6,0,30,24
1656817774861,MATH 18,A02,083744,Cinel; Cameron Alexander,15,0,30,15
1656817774861,MATH 18,A03,083745,Cinel; Cameron Alexander,8,0,30,22
1656817774861,MATH 18,B01,083748,Rideout; David Porter,3,0,37,34
1656817774861,MATH 18,B02,083749,Rideout; David Porter,3,0,36,33
1656817774861,MATH 18,B03,083750,Rideout; David Porter,1,0,37,36
1656817774861,MATH 18,B04,083751,Rideout; David Porter,5,0,36,31
1656817774861,MATH 18,B05,093473,Rideout; David Porter,4,0,36,32
1656817774861,MATH 18,B06,093474,Rideout; David Porter,5,0,36,31
1656817780885,MATH 20A,A01,083754,Zheng; Zequn,12,0,40,28
1656817786912,MATH 20B,A01,083756,Briones; Jor-el Thomas Caparas,1,0,36,35
1656817786912,MATH 20B,A02,083757,Briones; Jor-el Thomas Caparas,1,0,36,35
1656817786912,MATH 20B,A03,093475,Briones; Jor-el Thomas Caparas,0,0,36,36
1656817792944,MATH 20C,A01,083760,Briones; Jor-el Thomas Caparas,1,0,35,34
1656817792944,MATH 20C,A02,083761,Briones; Jor-el Thomas Caparas,8,0,35,27
1656817792944,MATH 20C,A03,093476,Briones; Jor-el Thomas Caparas,0,1,36,36
1656817792944,MATH 20C,B01,083762,Bach; Quang Tran,0,0,30,30
1656817798976,MATH 20D,A01,083765,Tran; Brian Kha,4,0,30,26
1656817798976,MATH 20D,A02,083766,Tran; Brian Kha,4,0,30,26
1656817798976,MATH 20D,A03,083767,Tran; Brian Kha,2,0,30,28
1656817805007,MATH 20E,A01,083771,Ganguly; Soumya,5,0,32,27
1656817805007,MATH 20E,A02,083772,Ganguly; Soumya,5,0,32,27
1656817805007,MATH 20E,B01,083773,Ciotti; Benjamin,18,0,35,17
1656817805007,MATH 20E,B02,083774,Ciotti; Benjamin,17,0,35,18
1656817811041,MATH 103A,A01,083777,Greenfeld; Be'Eri,2,0,36,34
1656817811041,MATH 103A,A02,083778,Greenfeld; Be'Eri,5,0,36,31
1656817811041,MATH 103A,A03,093561,Greenfeld; Be'Eri,4,0,36,32
1656817811041,MATH 103A,B01,083779,Greenfeld; Be'Eri,6,0,36,30
1656817811041,MATH 103A,B02,083780,Greenfeld; Be'Eri,2,0,36,34
1656817811041,MATH 103A,B03,093562,Greenfeld; Be'Eri,2,0,36,34
1656817817066,MATH 105,A01,085443,Carter; Anne Toulson,13,0,35,22
1656817817066,MATH 105,A02,093477,Carter; Anne Toulson,20,0,35,15
1656817823090,MATH 109,A01,083213,Ganzberger; Geoffrey Michael,2,0,34,32
1656817823090,MATH 109,A02,083214,Ganzberger; Geoffrey Michael,2,0,34,32
1656817823090,MATH 109,A03,093478,Ganzberger; Geoffrey Michael,1,0,34,33
1656817823090,MATH 109,B01,083215,Ganzberger; Geoffrey Michael,1,0,32,31
1656817823090,MATH 109,B02,083216,Ganzberger; Geoffrey Michael,1,0,32,31
1656817823090,MATH 109,B03,093479,Ganzberger; Geoffrey Michael,6,0,32,26
1656817829124,MATH 142A,A01,083219,Chow; Bennett,6,0,32,26
1656817829124,MATH 142A,A02,083220,Chow; Bennett,9,0,32,23
1656817829124,MATH 142A,A03,093480,Chow; Bennett,7,0,32,25
1656817829124,MATH 142A,B03,093481,Chow; Bennett,7,0,32,25
1656817829124,MATH 142A,B04,093558,Chow; Bennett,10,0,32,22
1656817829124,MATH 142A,B05,093559,Chow; Bennett,6,0,32,26
1656817835161,MATH 193A,A01,083224,Rotar; Vladimir,6,0,34,28
1656817835161,MATH 193A,A02,083225,Rotar; Vladimir,3,0,34,31
1656817835161,MATH 193A,A03,083781,Rotar; Vladimir,1,0,34,33
1656817835161,MATH 193A,A04,083782,Rotar; Vladimir,6,0,34,28
1656817835161,MATH 193A,A05,093482,Rotar; Vladimir,6,0,34,28
1656817841194,MATH 197,001,091859,McAuley; Julian John,9999,0,9999,0
1656817841194,MATH 197,002,095566,Kedlaya; Kiran S.,9997,0,9999,2
1656817841194,MATH 197,003,095567,Xiao; Ming,9999,0,9999,0
1656817841194,MATH 197,004,095571,Perols; Johan Lars,9998,0,9999,1
1656817848266,COGS 9,A01,083615,Shannon; Kyle Michael,6,0,75,69
1656817854291,COGS 11,A01,083617,Boyle; Mary E. T.,18,0,48,30
1656817860316,COGS 13,A01,083071,Bastos; Amalia Pinkusfeld,8,0,71,63
1656817866340,COGS 14A,A01,092681,Semenuks; Arturs,0,1,100,100
1656817872367,COGS 14B,A01,083073,Cheng; Tzu-Han,5,0,63,58
1656817878393,COGS 17,A01,092677,Semenuks; Arturs,4,0,81,77
1656817884514,COGS 100,A01,083619,Allen; Michael Gordon,15,0,70,55
1656817890540,COGS 101A,A01,083621,Davis; Joshua Daniel,9,0,68,59
1656817896563,COGS 101B,A01,091572,Allen; Michael Gordon,8,0,65,57
1656817902588,COGS 101C,A01,083625,Delgado; Tania,17,0,35,18
1656817908613,COGS 107A,A01,083627,Boyle; Mary E. T.,13,0,60,47
1656817914638,COGS 118A,A01,083075,Gupta; Anjum,15,0,76,61
1656817920668,CSE 3,A50,083646,Miranda; Gregory Joseph,22,0,50,28
1656817926696,CSE 8A,A50,083650,Miranda; Gregory Joseph,17,1,56,39
1656817932720,CSE 11,A01,083080,Cao; Yingjun,4,15,40,36
1656817938743,CSE 12,A01,083652,Krause-Levy; Sophia Louisa,20,1,120,100
1656817944770,CSE 15L,A01,083654,Morris; Justin Loren,8,0,50,42
1656817944770,CSE 15L,A02,083655,Morris; Justin Loren,8,0,50,42
1656817950794,CSE 20,A01,083657,Tran; Khoa Dang,37,0,80,43
1656817956822,CSE 21,A01,095574,Bach; Quang Tran,21,0,48,27
1656817962853,CSE 30,A01,083084,Eldon; John,4,0,80,76
1656817962853,CSE 30,B01,095061,Bhaskar; Nishant,6,0,50,44
1656817968887,CSE 100,A01,083659,Cao; Yingjun,1,4,70,69
1656817974916,CSE 134B,A01,083661,Powell; Thomas Allan,18,0,100,82
1656817980937,CSE 140,A01,083663,Gungor; Onat,14,0,85,71
1656817986960,CSE 140L,A01,083088,Eldon; John,16,0,100,84
1656817992984,CSE 175,A01,083665,Kumar; Rakesh,3,0,25,22
1656817999008,CSE 190,A00,092507,Dubnov; Shlomo,7,0,20,13
1656818005033,ECE 45,A01,083139,Congero; Spencer William,5,0,75,70
1656818011060,ECE 65,A50,083695,Saad; Andrew S,12,0,30,18
1656818011060,ECE 65,A51,095125,Saad; Andrew S,25,0,26,1
1656818017084,ECE 109,A01,091882,Touri; Behrouz,15,0,70,55
1656818023114,ECE 180,A00,083140,Abi Samra; Nicholas Camill,0,0,30,30
1656818023114,ECE 180,B00,083141,Abi Samra; Nicholas Camill,0,0,30,30
1656818029145,MATH 10A,A01,083735,Patchell; Gregory David,1,0,30,29
1656818029145,MATH 10A,A02,083736,Patchell; Gregory David,20,0,30,10
1656818029145,MATH 10A,A03,083737,Patchell; Gregory David,15,0,30,15
1656818035179,MATH 10B,A01,083207,Lim; Seonhee,7,0,34,27
1656818035179,MATH 10B,A02,083208,Lim; Seonhee,9,0,35,26
1656818035179,MATH 10B,A03,093472,Lim; Seonhee,4,0,34,30
1656818035179,MATH 10B,B01,083739,Sinha; Shubham,9,0,30,21
1656818041216,MATH 18,A01,083743,Cinel; Cameron Alexander,6,0,30,24
1656818041216,MATH 18,A02,083744,Cinel; Cameron Alexander,15,0,30,15
1656818041216,MATH 18,A03,083745,Cinel; Cameron Alexander,8,0,30,22
1656818041216,MATH 18,B01,083748,Rideout; David Porter,3,0,37,34
1656818041216,MATH 18,B02,083749,Rideout; David Porter,3,0,36,33
1656818041216,MATH 18,B03,083750,Rideout; David Porter,1,0,37,36
1656818041216,MATH 18,B04,083751,Rideout; David Porter,5,0,36,31
1656818041216,MATH 18,B05,093473,Rideout; David Porter,4,0,36,32
1656818041216,MATH 18,B06,093474,Rideout; David Porter,5,0,36,31
1656818047239,MATH 20A,A01,083754,Zheng; Zequn,12,0,40,28
1656818053271,MATH 20B,A01,083756,Briones; Jor-el Thomas Caparas,1,0,36,35
1656818053271,MATH 20B,A02,083757,Briones; Jor-el Thomas Caparas,1,0,36,35
1656818053271,MATH 20B,A03,093475,Briones; Jor-el Thomas Caparas,0,0,36,36
1656818059304,MATH 20C,A01,083760,Briones; Jor-el Thomas Caparas,1,0,35,34
1656818059304,MATH 20C,A02,083761,Briones; Jor-el Thomas Caparas,8,0,35,27
1656818059304,MATH 20C,A03,093476,Briones; Jor-el Thomas Caparas,0,1,36,36
1656818059304,MATH 20C,B01,083762,Bach; Quang Tran,0,0,30,30
1656818065333,MATH 20D,A01,083765,Tran; Brian Kha,4,0,30,26
1656818065333,MATH 20D,A02,083766,Tran; Brian Kha,4,0,30,26
1656818065333,MATH 20D,A03,083767,Tran; Brian Kha,2,0,30,28
1656818071360,MATH 20E,A01,083771,Ganguly; Soumya,5,0,32,27
1656818071360,MATH 20E,A02,083772,Ganguly; Soumya,5,0,32,27
1656818071360,MATH 20E,B01,083773,Ciotti; Benjamin,18,0,35,17
1656818071360,MATH 20E,B02,083774,Ciotti; Benjamin,17,0,35,18
1656818077397,MATH 103A,A01,083777,Greenfeld; Be'Eri,2,0,36,34
1656818077397,MATH 103A,A02,083778,Greenfeld; Be'Eri,5,0,36,31
1656818077397,MATH 103A,A03,093561,Greenfeld; Be'Eri,4,0,36,32
1656818077397,MATH 103A,B01,083779,Greenfeld; Be'Eri,6,0,36,30
1656818077397,MATH 103A,B02,083780,Greenfeld; Be'Eri,2,0,36,34
1656818077397,MATH 103A,B03,093562,Greenfeld; Be'Eri,2,0,36,34
1656818083421,MATH 105,A01,085443,Carter; Anne Toulson,13,0,35,22
1656818083421,MATH 105,A02,093477,Carter; Anne Toulson,20,0,35,15
1656818089454,MATH 109,A01,083213,Ganzberger; Geoffrey Michael,2,0,34,32
1656818089454,MATH 109,A02,083214,Ganzberger; Geoffrey Michael,2,0,34,32
1656818089454,MATH 109,A03,093478,Ganzberger; Geoffrey Michael,1,0,34,33
1656818089454,MATH 109,B01,083215,Ganzberger; Geoffrey Michael,1,0,32,31
1656818089454,MATH 109,B02,083216,Ganzberger; Geoffrey Michael,1,0,32,31
1656818089454,MATH 109,B03,093479,Ganzberger; Geoffrey Michael,6,0,32,26
1656818095479,MATH 142A,A01,083219,Chow; Bennett,6,0,32,26
1656818095479,MATH 142A,A02,083220,Chow; Bennett,9,0,32,23
1656818095479,MATH 142A,A03,093480,Chow; Bennett,7,0,32,25
1656818095479,MATH 142A,B03,093481,Chow; Bennett,7,0,32,25
1656818095479,MATH 142A,B04,093558,Chow; Bennett,10,0,32,22
1656818095479,MATH 142A,B05,093559,Chow; Bennett,6,0,32,26
1656818101506,MATH 193A,A01,083224,Rotar; Vladimir,6,0,34,28
1656818101506,MATH 193A,A02,083225,Rotar; Vladimir,3,0,34,31
1656818101506,MATH 193A,A03,083781,Rotar; Vladimir,1,0,34,33
1656818101506,MATH 193A,A04,083782,Rotar; Vladimir,6,0,34,28
1656818101506,MATH 193A,A05,093482,Rotar; Vladimir,6,0,34,28
1656818107533,MATH 197,001,091859,McAuley; Julian John,9999,0,9999,0
1656818107533,MATH 197,002,095566,Kedlaya; Kiran S.,9997,0,9999,2
1656818107533,MATH 197,003,095567,Xiao; Ming,9999,0,9999,0
1656818107533,MATH 197,004,095571,Perols; Johan Lars,9998,0,9999,1
1656818114591,COGS 9,A01,083615,Shannon; Kyle Michael,6,0,75,69
1656818120619,COGS 11,A01,083617,Boyle; Mary E. T.,18,0,48,30
1656818126648,COGS 13,A01,083071,Bastos; Amalia Pinkusfeld,8,0,71,63
1656818132675,COGS 14A,A01,092681,Semenuks; Arturs,0,1,100,100
1656818138700,COGS 14B,A01,083073,Cheng; Tzu-Han,5,0,63,58
1656818144724,COGS 17,A01,092677,Semenuks; Arturs,4,0,81,77
1656818150754,COGS 100,A01,083619,Allen; Michael Gordon,15,0,70,55
1656818156785,COGS 101A,A01,083621,Davis; Joshua Daniel,9,0,68,59
1656818162810,COGS 101B,A01,091572,Allen; Michael Gordon,8,0,65,57
1656818168835,COGS 101C,A01,083625,Delgado; Tania,17,0,35,18
1656818174863,COGS 107A,A01,083627,Boyle; Mary E. T.,13,0,60,47
1656818180887,COGS 118A,A01,083075,Gupta; Anjum,15,0,76,61
1656818186913,CSE 3,A50,083646,Miranda; Gregory Joseph,22,0,50,28
1656818192953,CSE 8A,A50,083650,Miranda; Gregory Joseph,17,1,56,39
1656818198978,CSE 11,A01,083080,Cao; Yingjun,4,15,40,36
1656818205009,CSE 12,A01,083652,Krause-Levy; Sophia Louisa,20,1,120,100
1656818211033,CSE 15L,A01,083654,Morris; Justin Loren,8,0,50,42
1656818211033,CSE 15L,A02,083655,Morris; Justin Loren,8,0,50,42
1656818217075,CSE 20,A01,083657,Tran; Khoa Dang,37,0,80,43
1656818223104,CSE 21,A01,095574,Bach; Quang Tran,21,0,48,27
1656818229145,CSE 30,A01,083084,Eldon; John,4,0,80,76
1656818229145,CSE 30,B01,095061,Bhaskar; Nishant,6,0,50,44
1656818235169,CSE 100,A01,083659,Cao; Yingjun,1,4,70,69
1656818241194,CSE 134B,A01,083661,Powell; Thomas Allan,18,0,100,82
1656818247223,CSE 140,A01,083663,Gungor; Onat,14,0,85,71
1656818253256,CSE 140L,A01,083088,Eldon; John,16,0,100,84
1656818259280,CSE 175,A01,083665,Kumar; Rakesh,3,0,25,22
1656818265308,CSE 190,A00,092507,Dubnov; Shlomo,7,0,20,13
1656818271345,ECE 45,A01,083139,Congero; Spencer William,5,0,75,70
1656818277369,ECE 65,A50,083695,Saad; Andrew S,12,0,30,18
1656818277369,ECE 65,A51,095125,Saad; Andrew S,25,0,26,1
1656818283403,ECE 109,A01,091882,Touri; Behrouz,15,0,70,55
1656818289433,ECE 180,A00,083140,Abi Samra; Nicholas Camill,0,0,30,30
1656818289433,ECE 180,B00,083141,Abi Samra; Nicholas Camill,0,0,30,30
1656818295471,MATH 10A,A01,083735,Patchell; Gregory David,1,0,30,29
1656818295471,MATH 10A,A02,083736,Patchell; Gregory David,20,0,30,10
1656818295471,MATH 10A,A03,083737,Patchell; Gregory David,15,0,30,15
1656818301513,MATH 10B,A01,083207,Lim; Seonhee,7,0,34,27
1656818301513,MATH 10B,A02,083208,Lim; Seonhee,9,0,35,26
1656818301513,MATH 10B,A03,093472,Lim; Seonhee,4,0,34,30
1656818301513,MATH 10B,B01,083739,Sinha; Shubham,9,0,30,21
1656818307542,MATH 18,A01,083743,Cinel; Cameron Alexander,6,0,30,24
1656818307542,MATH 18,A02,083744,Cinel; Cameron Alexander,15,0,30,15
1656818307542,MATH 18,A03,083745,Cinel; Cameron Alexander,8,0,30,22
1656818307542,MATH 18,B01,083748,Rideout; David Porter,3,0,37,34
1656818307542,MATH 18,B02,083749,Rideout; David Porter,3,0,36,33
1656818307542,MATH 18,B03,083750,Rideout; David Porter,1,0,37,36
1656818307542,MATH 18,B04,083751,Rideout; David Porter,5,0,36,31
1656818307542,MATH 18,B05,093473,Rideout; David Porter,4,0,36,32
1656818307542,MATH 18,B06,093474,Rideout; David Porter,5,0,36,31
1656818313568,MATH 20A,A01,083754,Zheng; Zequn,12,0,40,28
1656818319594,MATH 20B,A01,083756,Briones; Jor-el Thomas Caparas,1,0,36,35
1656818319594,MATH 20B,A02,083757,Briones; Jor-el Thomas Caparas,1,0,36,35
1656818319594,MATH 20B,A03,093475,Briones; Jor-el Thomas Caparas,0,0,36,36
1656818325626,MATH 20C,A01,083760,Briones; Jor-el Thomas Caparas,1,0,35,34
1656818325626,MATH 20C,A02,083761,Briones; Jor-el Thomas Caparas,8,0,35,27
1656818325626,MATH 20C,A03,093476,Briones; Jor-el Thomas Caparas,0,1,36,36
1656818325626,MATH 20C,B01,083762,Bach; Quang Tran,0,0,30,30
1656818331650,MATH 20D,A01,083765,Tran; Brian Kha,4,0,30,26
1656818331650,MATH 20D,A02,083766,Tran; Brian Kha,4,0,30,26
1656818331650,MATH 20D,A03,083767,Tran; Brian Kha,2,0,30,28
1656818337675,MATH 20E,A01,083771,Ganguly; Soumya,5,0,32,27
1656818337675,MATH 20E,A02,083772,Ganguly; Soumya,5,0,32,27
1656818337675,MATH 20E,B01,083773,Ciotti; Benjamin,18,0,35,17
1656818337675,MATH 20E,B02,083774,Ciotti; Benjamin,17,0,35,18
1656818343707,MATH 103A,A01,083777,Greenfeld; Be'Eri,2,0,36,34
1656818343707,MATH 103A,A02,083778,Greenfeld; Be'Eri,5,0,36,31
1656818343707,MATH 103A,A03,093561,Greenfeld; Be'Eri,4,0,36,32
1656818343707,MATH 103A,B01,083779,Greenfeld; Be'Eri,6,0,36,30
1656818343707,MATH 103A,B02,083780,Greenfeld; Be'Eri,2,0,36,34
1656818343707,MATH 103A,B03,093562,Greenfeld; Be'Eri,2,0,36,34
1656818349734,MATH 105,A01,085443,Carter; Anne Toulson,13,0,35,22
1656818349734,MATH 105,A02,093477,Carter; Anne Toulson,20,0,35,15
1656818355765,MATH 109,A01,083213,Ganzberger; Geoffrey Michael,2,0,34,32
1656818355765,MATH 109,A02,083214,Ganzberger; Geoffrey Michael,2,0,34,32
1656818355765,MATH 109,A03,093478,Ganzberger; Geoffrey Michael,1,0,34,33
1656818355765,MATH 109,B01,083215,Ganzberger; Geoffrey Michael,1,0,32,31
1656818355765,MATH 109,B02,083216,Ganzberger; Geoffrey Michael,1,0,32,31
1656818355765,MATH 109,B03,093479,Ganzberger; Geoffrey Michael,6,0,32,26
1656818361793,MATH 142A,A01,083219,Chow; Bennett,6,0,32,26
1656818361793,MATH 142A,A02,083220,Chow; Bennett,9,0,32,23
1656818361793,MATH 142A,A03,093480,Chow; Bennett,7,0,32,25
1656818361793,MATH 142A,B03,093481,Chow; Bennett,7,0,32,25
1656818361793,MATH 142A,B04,093558,Chow; Bennett,10,0,32,22
1656818361793,MATH 142A,B05,093559,Chow; Bennett,6,0,32,26
1656818367818,MATH 193A,A01,083224,Rotar; Vladimir,6,0,34,28
1656818367818,MATH 193A,A02,083225,Rotar; Vladimir,3,0,34,31
1656818367818,MATH 193A,A03,083781,Rotar; Vladimir,1,0,34,33
1656818367818,MATH 193A,A04,083782,Rotar; Vladimir,6,0,34,28
1656818367818,MATH 193A,A05,093482,Rotar; Vladimir,6,0,34,28
1656818373849,MATH 197,001,091859,McAuley; Julian John,9999,0,9999,0
1656818373849,MATH 197,002,095566,Kedlaya; Kiran S.,9997,0,9999,2
1656818373849,MATH 197,003,095567,Xiao; Ming,9999,0,9999,0
1656818373849,MATH 197,004,095571,Perols; Johan Lars,9998,0,9999,1
1656818380922,COGS 9,A01,083615,Shannon; Kyle Michael,6,0,75,69
1656818386950,COGS 11,A01,083617,Boyle; Mary E. T.,18,0,48,30
1656818392979,COGS 13,A01,083071,Bastos; Amalia Pinkusfeld,8,0,71,63
1656818399004,COGS 14A,A01,092681,Semenuks; Arturs,0,1,100,100
1656818405029,COGS 14B,A01,083073,Cheng; Tzu-Han,5,0,63,58
1656818411051,COGS 17,A01,092677,Semenuks; Arturs,4,0,81,77
1656818417081,COGS 100,A01,083619,Allen; Michael Gordon,15,0,70,55
1656818423107,COGS 101A,A01,083621,Davis; Joshua Daniel,9,0,68,59
1656818429130,COGS 101B,A01,091572,Allen; Michael Gordon,8,0,65,57
1656818435155,COGS 101C,A01,083625,Delgado; Tania,17,0,35,18
1656818441177,COGS 107A,A01,083627,Boyle; Mary E. T.,13,0,60,47
1656818447201,COGS 118A,A01,083075,Gupta; Anjum,15,0,76,61
1656818453228,CSE 3,A50,083646,Miranda; Gregory Joseph,22,0,50,28
1656818459252,CSE 8A,A50,083650,Miranda; Gregory Joseph,17,1,56,39
1656818465275,CSE 11,A01,083080,Cao; Yingjun,4,15,40,36
1656818471304,CSE 12,A01,083652,Krause-Levy; Sophia Louisa,20,1,120,100
1656818477334,CSE 15L,A01,083654,Morris; Justin Loren,8,0,50,42
1656818477334,CSE 15L,A02,083655,Morris; Justin Loren,8,0,50,42
1656818483447,CSE 20,A01,083657,Tran; Khoa Dang,37,0,80,43
1656818489473,CSE 21,A01,095574,Bach; Quang Tran,21,0,48,27
1656818495505,CSE 30,A01,083084,Eldon; John,4,0,80,76
1656818495505,CSE 30,B01,095061,Bhaskar; Nishant,6,0,50,44
1656818501547,CSE 100,A01,083659,Cao; Yingjun,1,4,70,69
1656818507574,CSE 134B,A01,083661,Powell; Thomas Allan,18,0,100,82
1656818513603,CSE 140,A01,083663,Gungor; Onat,14,0,85,71
1656818519632,CSE 140L,A01,083088,Eldon; John,16,0,100,84
1656818525669,CSE 175,A01,083665,Kumar; Rakesh,3,0,25,22
1656818531692,CSE 190,A00,092507,Dubnov; Shlomo,7,0,20,13
1656818537718,ECE 45,A01,083139,Congero; Spencer William,5,0,75,70
1656818543743,ECE 65,A50,083695,Saad; Andrew S,12,0,30,18
1656818543743,ECE 65,A51,095125,Saad; Andrew S,25,0,26,1
1656818549769,ECE 109,A01,091882,Touri; Behrouz,15,0,70,55
1656818555799,ECE 180,A00,083140,Abi Samra; Nicholas Camill,0,0,30,30
1656818555799,ECE 180,B00,083141,Abi Samra; Nicholas Camill,0,0,30,30
1656818561824,MATH 10A,A01,083735,Patchell; Gregory David,1,0,30,29
1656818561824,MATH 10A,A02,083736,Patchell; Gregory David,20,0,30,10
1656818561824,MATH 10A,A03,083737,Patchell; Gregory David,15,0,30,15
1656818567861,MATH 10B,A01,083207,Lim; Seonhee,7,0,34,27
1656818567861,MATH 10B,A02,083208,Lim; Seonhee,9,0,35,26
1656818567861,MATH 10B,A03,093472,Lim; Seonhee,4,0,34,30
1656818567861,MATH 10B,B01,083739,Sinha; Shubham,9,0,30,21
1656818573887,MATH 18,A01,083743,Cinel; Cameron Alexander,6,0,30,24
1656818573887,MATH 18,A02,083744,Cinel; Cameron Alexander,15,0,30,15
1656818573887,MATH 18,A03,083745,Cinel; Cameron Alexander,8,0,30,22
1656818573887,MATH 18,B01,083748,Rideout; David Porter,3,0,37,34
1656818573887,MATH 18,B02,083749,Rideout; David Porter,3,0,36,33
1656818573887,MATH 18,B03,083750,Rideout; David Porter,1,0,37,36
1656818573887,MATH 18,B04,083751,Rideout; David Porter,5,0,36,31
1656818573887,MATH 18,B05,093473,Rideout; David Porter,4,0,36,32
1656818573887,MATH 18,B06,093474,Rideout; David Porter,5,0,36,31
1656818579916,MATH 20A,A01,083754,Zheng; Zequn,12,0,40,28
1656818585947,MATH 20B,A01,083756,Briones; Jor-el Thomas Caparas,1,0,36,35
1656818585947,MATH 20B,A02,083757,Briones; Jor-el Thomas Caparas,1,0,36,35
1656818585947,MATH 20B,A03,093475,Briones; Jor-el Thomas Caparas,0,0,36,36
1656818591979,MATH 20C,A01,083760,Briones; Jor-el Thomas Caparas,1,0,35,34
1656818591979,MATH 20C,A02,083761,Briones; Jor-el Thomas Caparas,8,0,35,27
1656818591979,MATH 20C,A03,093476,Briones; Jor-el Thomas Caparas,0,1,36,36
1656818591979,MATH 20C,B01,083762,Bach; Quang Tran,0,0,30,30
1656818598011,MATH 20D,A01,083765,Tran; Brian Kha,4,0,30,26
1656818598011,MATH 20D,A02,083766,Tran; Brian Kha,4,0,30,26
1656818598011,MATH 20D,A03,083767,Tran; Brian Kha,2,0,30,28
1656818604043,MATH 20E,A01,083771,Ganguly; Soumya,5,0,32,27
1656818604043,MATH 20E,A02,083772,Ganguly; Soumya,5,0,32,27
1656818604043,MATH 20E,B01,083773,Ciotti; Benjamin,18,0,35,17
1656818604043,MATH 20E,B02,083774,Ciotti; Benjamin,17,0,35,18
1656818610068,MATH 103A,A01,083777,Greenfeld; Be'Eri,2,0,36,34
1656818610068,MATH 103A,A02,083778,Greenfeld; Be'Eri,5,0,36,31
1656818610068,MATH 103A,A03,093561,Greenfeld; Be'Eri,4,0,36,32
1656818610068,MATH 103A,B01,083779,Greenfeld; Be'Eri,6,0,36,30
1656818610068,MATH 103A,B02,083780,Greenfeld; Be'Eri,2,0,36,34
1656818610068,MATH 103A,B03,093562,Greenfeld; Be'Eri,2,0,36,34
1656818616098,MATH 105,A01,085443,Carter; Anne Toulson,13,0,35,22
1656818616098,MATH 105,A02,093477,Carter; Anne Toulson,20,0,35,15
1656818622123,MATH 109,A01,083213,Ganzberger; Geoffrey Michael,2,0,34,32
1656818622123,MATH 109,A02,083214,Ganzberger; Geoffrey Michael,2,0,34,32
1656818622123,MATH 109,A03,093478,Ganzberger; Geoffrey Michael,1,0,34,33
1656818622123,MATH 109,B01,083215,Ganzberger; Geoffrey Michael,1,0,32,31
1656818622123,MATH 109,B02,083216,Ganzberger; Geoffrey Michael,1,0,32,31
1656818622123,MATH 109,B03,093479,Ganzberger; Geoffrey Michael,6,0,32,26
1656818628155,MATH 142A,A01,083219,Chow; Bennett,6,0,32,26
1656818628155,MATH 142A,A02,083220,Chow; Bennett,9,0,32,23
1656818628155,MATH 142A,A03,093480,Chow; Bennett,7,0,32,25
1656818628155,MATH 142A,B03,093481,Chow; Bennett,7,0,32,25
1656818628155,MATH 142A,B04,093558,Chow; Bennett,10,0,32,22
1656818628155,MATH 142A,B05,093559,Chow; Bennett,6,0,32,26
1656818634180,MATH 193A,A01,083224,Rotar; Vladimir,6,0,34,28
1656818634180,MATH 193A,A02,083225,Rotar; Vladimir,3,0,34,31
1656818634180,MATH 193A,A03,083781,Rotar; Vladimir,1,0,34,33
1656818634180,MATH 193A,A04,083782,Rotar; Vladimir,6,0,34,28
1656818634180,MATH 193A,A05,093482,Rotar; Vladimir,6,0,34,28
1656818640212,MATH 197,001,091859,McAuley; Julian John,9999,0,9999,0
1656818640212,MATH 197,002,095566,Kedlaya; Kiran S.,9997,0,9999,2
1656818640212,MATH 197,003,095567,Xiao; Ming,9999,0,9999,0
1656818640212,MATH 197,004,095571,Perols; Johan Lars,9998,0,9999,1
1656818647268,COGS 9,A01,083615,Shannon; Kyle Michael,6,0,75,69
1656818653298,COGS 11,A01,083617,Boyle; Mary E. T.,18,0,48,30
1656818659327,COGS 13,A01,083071,Bastos; Amalia Pinkusfeld,8,0,71,63
1656818665356,COGS 14A,A01,092681,Semenuks; Arturs,0,1,100,100
1656818671383,COGS 14B,A01,083073,Cheng; Tzu-Han,5,0,63,58
1656818677408,COGS 17,A01,092677,Semenuks; Arturs,4,0,81,77
1656818683442,COGS 100,A01,083619,Allen; Michael Gordon,15,0,70,55
1656818689467,COGS 101A,A01,083621,Davis; Joshua Daniel,9,0,68,59
1656818695495,COGS 101B,A01,091572,Allen; Michael Gordon,8,0,65,57
1656818701519,COGS 101C,A01,083625,Delgado; Tania,17,0,35,18
1656818707543,COGS 107A,A01,083627,Boyle; Mary E. T.,13,0,60,47
1656818713567,COGS 118A,A01,083075,Gupta; Anjum,15,0,76,61
1656818719596,CSE 3,A50,083646,Miranda; Gregory Joseph,22,0,50,28
1656818725619,CSE 8A,A50,083650,Miranda; Gregory Joseph,17,1,56,39
1656818731646,CSE 11,A01,083080,Cao; Yingjun,4,15,40,36
1656818737671,CSE 12,A01,083652,Krause-Levy; Sophia Louisa,20,1,120,100
1656818743694,CSE 15L,A01,083654,Morris; Justin Loren,8,0,50,42
1656818743694,CSE 15L,A02,083655,Morris; Justin Loren,8,0,50,42
1656818749721,CSE 20,A01,083657,Tran; Khoa Dang,37,0,80,43
1656818755745,CSE 21,A01,095574,Bach; Quang Tran,21,0,48,27
1656818761770,CSE 30,A01,083084,Eldon; John,4,0,80,76
1656818761770,CSE 30,B01,095061,Bhaskar; Nishant,6,0,50,44
1656818767796,CSE 100,A01,083659,Cao; Yingjun,1,4,70,69
1656818773824,CSE 134B,A01,083661,Powell; Thomas Allan,19,0,100,81
1656818779848,CSE 140,A01,083663,Gungor; Onat,14,0,85,71
1656818785878,CSE 140L,A01,083088,Eldon; John,16,0,100,84
1656818791909,CSE 175,A01,083665,Kumar; Rakesh,3,0,25,22
1656818797932,CSE 190,A00,092507,Dubnov; Shlomo,7,0,20,13
1656818803958,ECE 45,A01,083139,Congero; Spencer William,5,0,75,70
1656818809990,ECE 65,A50,083695,Saad; Andrew S,12,0,30,18
1656818809990,ECE 65,A51,095125,Saad; Andrew S,25,0,26,1
1656818816017,ECE 109,A01,091882,Touri; Behrouz,15,0,70,55
1656818822046,ECE 180,A00,083140,Abi Samra; Nicholas Camill,0,0,30,30
1656818822046,ECE 180,B00,083141,Abi Samra; Nicholas Camill,0,0,30,30
1656818828070,MATH 10A,A01,083735,Patchell; Gregory David,1,0,30,29
1656818828070,MATH 10A,A02,083736,Patchell; Gregory David,20,0,30,10
1656818828070,MATH 10A,A03,083737,Patchell; Gregory David,15,0,30,15
1656818834097,MATH 10B,A01,083207,Lim; Seonhee,7,0,34,27
1656818834097,MATH 10B,A02,083208,Lim; Seonhee,9,0,35,26
1656818834097,MATH 10B,A03,093472,Lim; Seonhee,4,0,34,30
1656818834097,MATH 10B,B01,083739,Sinha; Shubham,9,0,30,21
1656818840133,MATH 18,A01,083743,Cinel; Cameron Alexander,6,0,30,24
1656818840133,MATH 18,A02,083744,Cinel; Cameron Alexander,15,0,30,15
1656818840133,MATH 18,A03,083745,Cinel; Cameron Alexander,8,0,30,22
1656818840133,MATH 18,B01,083748,Rideout; David Porter,3,0,37,34
1656818840133,MATH 18,B02,083749,Rideout; David Porter,3,0,36,33
1656818840133,MATH 18,B03,083750,Rideout; David Porter,1,0,37,36
1656818840133,MATH 18,B04,083751,Rideout; David Porter,5,0,36,31
1656818840133,MATH 18,B05,093473,Rideout; David Porter,4,0,36,32
1656818840133,MATH 18,B06,093474,Rideout; David Porter,5,0,36,31
1656818846160,MATH 20A,A01,083754,Zheng; Zequn,12,0,40,28
1656818852193,MATH 20B,A01,083756,Briones; Jor-el Thomas Caparas,1,0,36,35
1656818852193,MATH 20B,A02,083757,Briones; Jor-el Thomas Caparas,1,0,36,35
1656818852193,MATH 20B,A03,093475,Briones; Jor-el Thomas Caparas,0,0,36,36
1656818858223,MATH 20C,A01,083760,Briones; Jor-el Thomas Caparas,1,0,35,34
1656818858223,MATH 20C,A02,083761,Briones; Jor-el Thomas Caparas,8,0,35,27
1656818858223,MATH 20C,A03,093476,Briones; Jor-el Thomas Caparas,0,1,36,36
1656818858223,MATH 20C,B01,083762,Bach; Quang Tran,0,0,30,30
1656818864253,MATH 20D,A01,083765,Tran; Brian Kha,4,0,30,26
1656818864253,MATH 20D,A02,083766,Tran; Brian Kha,4,0,30,26
1656818864253,MATH 20D,A03,083767,Tran; Brian Kha,2,0,30,28
1656818870286,MATH 20E,A01,083771,Ganguly; Soumya,5,0,32,27
1656818870286,MATH 20E,A02,083772,Ganguly; Soumya,5,0,32,27
1656818870286,MATH 20E,B01,083773,Ciotti; Benjamin,18,0,35,17
1656818870286,MATH 20E,B02,083774,Ciotti; Benjamin,17,0,35,18
1656818876319,MATH 103A,A01,083777,Greenfeld; Be'Eri,2,0,36,34
1656818876319,MATH 103A,A02,083778,Greenfeld; Be'Eri,5,0,36,31
1656818876319,MATH 103A,A03,093561,Greenfeld; Be'Eri,4,0,36,32
1656818876319,MATH 103A,B01,083779,Greenfeld; Be'Eri,6,0,36,30
1656818876319,MATH 103A,B02,083780,Greenfeld; Be'Eri,2,0,36,34
1656818876319,MATH 103A,B03,093562,Greenfeld; Be'Eri,2,0,36,34
1656818882343,MATH 105,A01,085443,Carter; Anne Toulson,13,0,35,22
1656818882343,MATH 105,A02,093477,Carter; Anne Toulson,20,0,35,15
1656818888391,MATH 109,A01,083213,Ganzberger; Geoffrey Michael,2,0,34,32
1656818888391,MATH 109,A02,083214,Ganzberger; Geoffrey Michael,2,0,34,32
1656818888391,MATH 109,A03,093478,Ganzberger; Geoffrey Michael,1,0,34,33
1656818888391,MATH 109,B01,083215,Ganzberger; Geoffrey Michael,1,0,32,31
1656818888391,MATH 109,B02,083216,Ganzberger; Geoffrey Michael,1,0,32,31
1656818888391,MATH 109,B03,093479,Ganzberger; Geoffrey Michael,6,0,32,26
1656818894415,MATH 142A,A01,083219,Chow; Bennett,6,0,32,26
1656818894415,MATH 142A,A02,083220,Chow; Bennett,9,0,32,23
1656818894415,MATH 142A,A03,093480,Chow; Bennett,7,0,32,25
1656818894415,MATH 142A,B03,093481,Chow; Bennett,7,0,32,25
1656818894415,MATH 142A,B04,093558,Chow; Bennett,10,0,32,22
1656818894415,MATH 142A,B05,093559,Chow; Bennett,6,0,32,26
1656818900443,MATH 193A,A01,083224,Rotar; Vladimir,6,0,34,28
1656818900443,MATH 193A,A02,083225,Rotar; Vladimir,3,0,34,31
1656818900443,MATH 193A,A03,083781,Rotar; Vladimir,1,0,34,33
1656818900443,MATH 193A,A04,083782,Rotar; Vladimir,6,0,34,28
1656818900443,MATH 193A,A05,093482,Rotar; Vladimir,6,0,34,28
1656818906468,MATH 197,001,091859,McAuley; Julian John,9999,0,9999,0
1656818906468,MATH 197,002,095566,Kedlaya; Kiran S.,9997,0,9999,2
1656818906468,MATH 197,003,095567,Xiao; Ming,9999,0,9999,0
1656818906468,MATH 197,004,095571,Perols; Johan Lars,9998,0,9999,1
1656818913533,COGS 9,A01,083615,Shannon; Kyle Michael,6,0,75,69
1656818919556,COGS 11,A01,083617,Boyle; Mary E. T.,18,0,48,30
1656818925579,COGS 13,A01,083071,Bastos; Amalia Pinkusfeld,8,0,71,63
1656818931605,COGS 14A,A01,092681,Semenuks; Arturs,0,1,100,100
1656818937634,COGS 14B,A01,083073,Cheng; Tzu-Han,5,0,63,58
1656818943660,COGS 17,A01,092677,Semenuks; Arturs,4,0,81,77
1656818949684,COGS 100,A01,083619,Allen; Michael Gordon,15,0,70,55
1656818955713,COGS 101A,A01,083621,Davis; Joshua Daniel,9,0,68,59
1656818961741,COGS 101B,A01,091572,Allen; Michael Gordon,8,0,65,57
1656818967772,COGS 101C,A01,083625,Delgado; Tania,17,0,35,18
1656818973796,COGS 107A,A01,083627,Boyle; Mary E. T.,13,0,60,47
1656818979830,COGS 118A,A01,083075,Gupta; Anjum,15,0,76,61
1656818985854,CSE 3,A50,083646,Miranda; Gregory Joseph,22,0,50,28
1656818991882,CSE 8A,A50,083650,Miranda; Gregory Joseph,17,1,56,39
1656818997903,CSE 11,A01,083080,Cao; Yingjun,4,15,40,36
1656819003931,CSE 12,A01,083652,Krause-Levy; Sophia Louisa,20,1,120,100
1656819009960,CSE 15L,A01,083654,Morris; Justin Loren,8,0,50,42
1656819009960,CSE 15L,A02,083655,Morris; Justin Loren,8,0,50,42
1656819015984,CSE 20,A01,083657,Tran; Khoa Dang,37,0,80,43
1656819022011,CSE 21,A01,095574,Bach; Quang Tran,21,0,48,27
1656819028033,CSE 30,A01,083084,Eldon; John,4,0,80,76
1656819028033,CSE 30,B01,095061,Bhaskar; Nishant,6,0,50,44
1656819034060,CSE 100,A01,083659,Cao; Yingjun,1,4,70,69
1656819040087,CSE 134B,A01,083661,Powell; Thomas Allan,19,0,100,81
1656819046112,CSE 140,A01,083663,Gungor; Onat,14,0,85,71
1656819052137,CSE 140L,A01,083088,Eldon; John,16,0,100,84
1656819058161,CSE 175,A01,083665,Kumar; Rakesh,3,0,25,22
1656819064185,CSE 190,A00,092507,Dubnov; Shlomo,7,0,20,13
1656819070214,ECE 45,A01,083139,Congero; Spencer William,5,0,75,70
1656819076238,ECE 65,A50,083695,Saad; Andrew S,12,0,30,18
1656819076238,ECE 65,A51,095125,Saad; Andrew S,25,0,26,1
1656819082339,ECE 109,A01,091882,Touri; Behrouz,15,0,70,55
1656819088364,ECE 180,A00,083140,Abi Samra; Nicholas Camill,0,0,30,30
1656819088364,ECE 180,B00,083141,Abi Samra; Nicholas Camill,0,0,30,30
1656819094396,MATH 10A,A01,083735,Patchell; Gregory David,1,0,30,29
1656819094396,MATH 10A,A02,083736,Patchell; Gregory David,20,0,30,10
1656819094396,MATH 10A,A03,083737,Patchell; Gregory David,15,0,30,15
1656819100426,MATH 10B,A01,083207,Lim; Seonhee,7,0,34,27
1656819100426,MATH 10B,A02,083208,Lim; Seonhee,9,0,35,26
1656819100426,MATH 10B,A03,093472,Lim; Seonhee,4,0,34,30
1656819100426,MATH 10B,B01,083739,Sinha; Shubham,9,0,30,21
1656819106452,MATH 18,A01,083743,Cinel; Cameron Alexander,6,0,30,24
1656819106452,MATH 18,A02,083744,Cinel; Cameron Alexander,15,0,30,15
1656819106452,MATH 18,A03,083745,Cinel; Cameron Alexander,8,0,30,22
1656819106452,MATH 18,B01,083748,Rideout; David Porter,3,0,37,34
1656819106452,MATH 18,B02,083749,Rideout; David Porter,3,0,36,33
1656819106452,MATH 18,B03,083750,Rideout; David Porter,1,0,37,36
1656819106452,MATH 18,B04,083751,Rideout; David Porter,5,0,36,31
1656819106452,MATH 18,B05,093473,Rideout; David Porter,4,0,36,32
1656819106452,MATH 18,B06,093474,Rideout; David Porter,5,0,36,31
1656819112479,MATH 20A,A01,083754,Zheng; Zequn,12,0,40,28
1656819118509,MATH 20B,A01,083756,Briones; Jor-el Thomas Caparas,1,0,36,35
1656819118509,MATH 20B,A02,083757,Briones; Jor-el Thomas Caparas,1,0,36,35
1656819118509,MATH 20B,A03,093475,Briones; Jor-el Thomas Caparas,0,0,36,36
1656819124538,MATH 20C,A01,083760,Briones; Jor-el Thomas Caparas,1,0,35,34
1656819124538,MATH 20C,A02,083761,Briones; Jor-el Thomas Caparas,8,0,35,27
1656819124538,MATH 20C,A03,093476,Briones; Jor-el Thomas Caparas,0,1,36,36
1656819124538,MATH 20C,B01,083762,Bach; Quang Tran,0,0,30,30
1656819130562,MATH 20D,A01,083765,Tran; Brian Kha,4,0,30,26
1656819130562,MATH 20D,A02,083766,Tran; Brian Kha,4,0,30,26
1656819130562,MATH 20D,A03,083767,Tran; Brian Kha,2,0,30,28
1656819136592,MATH 20E,A01,083771,Ganguly; Soumya,5,0,32,27
1656819136592,MATH 20E,A02,083772,Ganguly; Soumya,5,0,32,27
1656819136592,MATH 20E,B01,083773,Ciotti; Benjamin,18,0,35,17
1656819136592,MATH 20E,B02,083774,Ciotti; Benjamin,17,0,35,18
1656819142617,MATH 103A,A01,083777,Greenfeld; Be'Eri,2,0,36,34
1656819142617,MATH 103A,A02,083778,Greenfeld; Be'Eri,5,0,36,31
1656819142617,MATH 103A,A03,093561,Greenfeld; Be'Eri,4,0,36,32
1656819142617,MATH 103A,B01,083779,Greenfeld; Be'Eri,6,0,36,30
1656819142617,MATH 103A,B02,083780,Greenfeld; Be'Eri,2,0,36,34
1656819142617,MATH 103A,B03,093562,Greenfeld; Be'Eri,2,0,36,34
1656819148642,MATH 105,A01,085443,Carter; Anne Toulson,13,0,35,22
1656819148642,MATH 105,A02,093477,Carter; Anne Toulson,20,0,35,15
1656819154672,MATH 109,A01,083213,Ganzberger; Geoffrey Michael,2,0,34,32
1656819154672,MATH 109,A02,083214,Ganzberger; Geoffrey Michael,2,0,34,32
1656819154672,MATH 109,A03,093478,Ganzberger; Geoffrey Michael,1,0,34,33
1656819154672,MATH 109,B01,083215,Ganzberger; Geoffrey Michael,1,0,32,31
1656819154672,MATH 109,B02,083216,Ganzberger; Geoffrey Michael,1,0,32,31
1656819154672,MATH 109,B03,093479,Ganzberger; Geoffrey Michael,6,0,32,26
1656819160696,MATH 142A,A01,083219,Chow; Bennett,6,0,32,26
1656819160696,MATH 142A,A02,083220,Chow; Bennett,9,0,32,23
1656819160696,MATH 142A,A03,093480,Chow; Bennett,7,0,32,25
1656819160696,MATH 142A,B03,093481,Chow; Bennett,7,0,32,25
1656819160696,MATH 142A,B04,093558,Chow; Bennett,10,0,32,22
1656819160696,MATH 142A,B05,093559,Chow; Bennett,6,0,32,26
1656819166726,MATH 193A,A01,083224,Rotar; Vladimir,6,0,34,28
1656819166726,MATH 193A,A02,083225,Rotar; Vladimir,3,0,34,31
1656819166726,MATH 193A,A03,083781,Rotar; Vladimir,1,0,34,33
1656819166726,MATH 193A,A04,083782,Rotar; Vladimir,6,0,34,28
1656819166726,MATH 193A,A05,093482,Rotar; Vladimir,6,0,34,28
1656819172750,MATH 197,001,091859,McAuley; Julian John,9999,0,9999,0
1656819172750,MATH 197,002,095566,Kedlaya; Kiran S.,9997,0,9999,2
1656819172750,MATH 197,003,095567,Xiao; Ming,9999,0,9999,0
1656819172750,MATH 197,004,095571,Perols; Johan Lars,9998,0,9999,1
1656819179803,COGS 9,A01,083615,Shannon; Kyle Michael,6,0,75,69
1656819185826,COGS 11,A01,083617,Boyle; Mary E. T.,18,0,48,30
1656819191852,COGS 13,A01,083071,Bastos; Amalia Pinkusfeld,8,0,71,63
1656819197878,COGS 14A,A01,092681,Semenuks; Arturs,0,1,100,100
1656819203902,COGS 14B,A01,083073,Cheng; Tzu-Han,5,0,63,58
1656819209926,COGS 17,A01,092677,Semenuks; Arturs,4,0,81,77
1656819215954,COGS 100,A01,083619,Allen; Michael Gordon,15,0,70,55
1656819221978,COGS 101A,A01,083621,Davis; Joshua Daniel,9,0,68,59
1656819228004,COGS 101B,A01,091572,Allen; Michael Gordon,8,0,65,57
1656819234028,COGS 101C,A01,083625,Delgado; Tania,17,0,35,18
1656819240056,COGS 107A,A01,083627,Boyle; Mary E. T.,13,0,60,47
1656819246082,COGS 118A,A01,083075,Gupta; Anjum,15,0,76,61
1656819252113,CSE 3,A50,083646,Miranda; Gregory Joseph,22,0,50,28
1656819258142,CSE 8A,A50,083650,Miranda; Gregory Joseph,17,1,56,39
1656819264169,CSE 11,A01,083080,Cao; Yingjun,4,15,40,36
1656819270196,CSE 12,A01,083652,Krause-Levy; Sophia Louisa,20,1,120,100
1656819276219,CSE 15L,A01,083654,Morris; Justin Loren,8,0,50,42
1656819276219,CSE 15L,A02,083655,Morris; Justin Loren,8,0,50,42
1656819282245,CSE 20,A01,083657,Tran; Khoa Dang,37,0,80,43
1656819288269,CSE 21,A01,095574,Bach; Quang Tran,21,0,48,27
1656819294294,CSE 30,A01,083084,Eldon; John,4,0,80,76
1656819294294,CSE 30,B01,095061,Bhaskar; Nishant,6,0,50,44
1656819300319,CSE 100,A01,083659,Cao; Yingjun,1,4,70,69
1656819306346,CSE 134B,A01,083661,Powell; Thomas Allan,19,0,100,81
1656819312374,CSE 140,A01,083663,Gungor; Onat,14,0,85,71
1656819318400,CSE 140L,A01,083088,Eldon; John,16,0,100,84
1656819324423,CSE 175,A01,083665,Kumar; Rakesh,3,0,25,22
1656819330463,CSE 190,A00,092507,Dubnov; Shlomo,7,0,20,13
1656819336486,ECE 45,A01,083139,Congero; Spencer William,5,0,75,70
1656819342515,ECE 65,A50,083695,Saad; Andrew S,12,0,30,18
1656819342515,ECE 65,A51,095125,Saad; Andrew S,25,0,26,1
1656819348549,ECE 109,A01,091882,Touri; Behrouz,15,0,70,55
1656819354581,ECE 180,A00,083140,Abi Samra; Nicholas Camill,0,0,30,30
1656819354581,ECE 180,B00,083141,Abi Samra; Nicholas Camill,0,0,30,30
1656819360606,MATH 10A,A01,083735,Patchell; Gregory David,1,0,30,29
1656819360606,MATH 10A,A02,083736,Patchell; Gregory David,20,0,30,10
1656819360606,MATH 10A,A03,083737,Patchell; Gregory David,15,0,30,15
1656819366632,MATH 10B,A01,083207,Lim; Seonhee,7,0,34,27
1656819366632,MATH 10B,A02,083208,Lim; Seonhee,9,0,35,26
1656819366632,MATH 10B,A03,093472,Lim; Seonhee,4,0,34,30
1656819366632,MATH 10B,B01,083739,Sinha; Shubham,9,0,30,21
1656819372658,MATH 18,A01,083743,Cinel; Cameron Alexander,6,0,30,24
1656819372658,MATH 18,A02,083744,Cinel; Cameron Alexander,15,0,30,15
1656819372658,MATH 18,A03,083745,Cinel; Cameron Alexander,8,0,30,22
1656819372658,MATH 18,B01,083748,Rideout; David Porter,3,0,37,34
1656819372658,MATH 18,B02,083749,Rideout; David Porter,3,0,36,33
1656819372658,MATH 18,B03,083750,Rideout; David Porter,1,0,37,36
1656819372658,MATH 18,B04,083751,Rideout; David Porter,5,0,36,31
1656819372658,MATH 18,B05,093473,Rideout; David Porter,4,0,36,32
1656819372658,MATH 18,B06,093474,Rideout; David Porter,5,0,36,31
1656819378699,MATH 20A,A01,083754,Zheng; Zequn,12,0,40,28
1656819384725,MATH 20B,A01,083756,Briones; Jor-el Thomas Caparas,1,0,36,35
1656819384725,MATH 20B,A02,083757,Briones; Jor-el Thomas Caparas,1,0,36,35
1656819384725,MATH 20B,A03,093475,Briones; Jor-el Thomas Caparas,0,0,36,36
1656819390749,MATH 20C,A01,083760,Briones; Jor-el Thomas Caparas,1,0,35,34
1656819390749,MATH 20C,A02,083761,Briones; Jor-el Thomas Caparas,8,0,35,27
1656819390749,MATH 20C,A03,093476,Briones; Jor-el Thomas Caparas,0,1,36,36
1656819390749,MATH 20C,B01,083762,Bach; Quang Tran,0,0,30,30
1656819396781,MATH 20D,A01,083765,Tran; Brian Kha,4,0,30,26
1656819396781,MATH 20D,A02,083766,Tran; Brian Kha,4,0,30,26
1656819396781,MATH 20D,A03,083767,Tran; Brian Kha,2,0,30,28
1656819402812,MATH 20E,A01,083771,Ganguly; Soumya,5,0,32,27
1656819402812,MATH 20E,A02,083772,Ganguly; Soumya,5,0,32,27
1656819402812,MATH 20E,B01,083773,Ciotti; Benjamin,18,0,35,17
1656819402812,MATH 20E,B02,083774,Ciotti; Benjamin,17,0,35,18
1656819408843,MATH 103A,A01,083777,Greenfeld; Be'Eri,2,0,36,34
1656819408843,MATH 103A,A02,083778,Greenfeld; Be'Eri,5,0,36,31
1656819408843,MATH 103A,A03,093561,Greenfeld; Be'Eri,4,0,36,32
1656819408843,MATH 103A,B01,083779,Greenfeld; Be'Eri,6,0,36,30
1656819408843,MATH 103A,B02,083780,Greenfeld; Be'Eri,2,0,36,34
1656819408843,MATH 103A,B03,093562,Greenfeld; Be'Eri,2,0,36,34
1656819414871,MATH 105,A01,085443,Carter; Anne Toulson,13,0,35,22
1656819414871,MATH 105,A02,093477,Carter; Anne Toulson,20,0,35,15
1656819420902,MATH 109,A01,083213,Ganzberger; Geoffrey Michael,2,0,34,32
1656819420902,MATH 109,A02,083214,Ganzberger; Geoffrey Michael,2,0,34,32
1656819420902,MATH 109,A03,093478,Ganzberger; Geoffrey Michael,1,0,34,33
1656819420902,MATH 109,B01,083215,Ganzberger; Geoffrey Michael,1,0,32,31
1656819420902,MATH 109,B02,083216,Ganzberger; Geoffrey Michael,1,0,32,31
1656819420902,MATH 109,B03,093479,Ganzberger; Geoffrey Michael,6,0,32,26
1656819426927,MATH 142A,A01,083219,Chow; Bennett,6,0,32,26
1656819426927,MATH 142A,A02,083220,Chow; Bennett,9,0,32,23
1656819426927,MATH 142A,A03,093480,Chow; Bennett,7,0,32,25
1656819426927,MATH 142A,B03,093481,Chow; Bennett,7,0,32,25
1656819426927,MATH 142A,B04,093558,Chow; Bennett,10,0,32,22
1656819426927,MATH 142A,B05,093559,Chow; Bennett,6,0,32,26
1656819432957,MATH 193A,A01,083224,Rotar; Vladimir,6,0,34,28
1656819432957,MATH 193A,A02,083225,Rotar; Vladimir,3,0,34,31
1656819432957,MATH 193A,A03,083781,Rotar; Vladimir,1,0,34,33
1656819432957,MATH 193A,A04,083782,Rotar; Vladimir,6,0,34,28
1656819432957,MATH 193A,A05,093482,Rotar; Vladimir,6,0,34,28
1656819438985,MATH 197,001,091859,McAuley; Julian John,9999,0,9999,0
1656819438985,MATH 197,002,095566,Kedlaya; Kiran S.,9997,0,9999,2
1656819438985,MATH 197,003,095567,Xiao; Ming,9999,0,9999,0
1656819438985,MATH 197,004,095571,Perols; Johan Lars,9998,0,9999,1
1656819446042,COGS 9,A01,083615,Shannon; Kyle Michael,6,0,75,69
1656819452063,COGS 11,A01,083617,Boyle; Mary E. T.,18,0,48,30
1656819458090,COGS 13,A01,083071,Bastos; Amalia Pinkusfeld,8,0,71,63
1656819464118,COGS 14A,A01,092681,Semenuks; Arturs,0,1,100,100
1656819470144,COGS 14B,A01,083073,Cheng; Tzu-Han,5,0,63,58
1656819476168,COGS 17,A01,092677,Semenuks; Arturs,4,0,81,77
1656819482193,COGS 100,A01,083619,Allen; Michael Gordon,15,0,70,55
1656819488218,COGS 101A,A01,083621,Davis; Joshua Daniel,9,0,68,59
1656819494241,COGS 101B,A01,091572,Allen; Michael Gordon,8,0,65,57
1656819500264,COGS 101C,A01,083625,Delgado; Tania,17,0,35,18
1656819506292,COGS 107A,A01,083627,Boyle; Mary E. T.,13,0,60,47
1656819512320,COGS 118A,A01,083075,Gupta; Anjum,15,0,76,61
1656819518343,CSE 3,A50,083646,Miranda; Gregory Joseph,22,0,50,28
1656819524367,CSE 8A,A50,083650,Miranda; Gregory Joseph,17,1,56,39
1656819530389,CSE 11,A01,083080,Cao; Yingjun,4,15,40,36
1656819536417,CSE 12,A01,083652,Krause-Levy; Sophia Louisa,20,1,120,100
1656819542441,CSE 15L,A01,083654,Morris; Justin Loren,8,0,50,42
1656819542441,CSE 15L,A02,083655,Morris; Justin Loren,8,0,50,42
1656819548471,CSE 20,A01,083657,Tran; Khoa Dang,37,0,80,43
1656819554495,CSE 21,A01,095574,Bach; Quang Tran,21,0,48,27
1656819560519,CSE 30,A01,083084,Eldon; John,4,0,80,76
1656819560519,CSE 30,B01,095061,Bhaskar; Nishant,6,0,50,44
1656819566543,CSE 100,A01,083659,Cao; Yingjun,1,4,70,69
1656819572570,CSE 134B,A01,083661,Powell; Thomas Allan,19,0,100,81
1656819578593,CSE 140,A01,083663,Gungor; Onat,14,0,85,71
1656819584617,CSE 140L,A01,083088,Eldon; John,16,0,100,84
1656819590644,CSE 175,A01,083665,Kumar; Rakesh,3,0,25,22
1656819596669,CSE 190,A00,092507,Dubnov; Shlomo,7,0,20,13
1656819602694,ECE 45,A01,083139,Congero; Spencer William,5,0,75,70
1656819608718,ECE 65,A50,083695,Saad; Andrew S,12,0,30,18
1656819608718,ECE 65,A51,095125,Saad; Andrew S,25,0,26,1
1656819614741,ECE 109,A01,091882,Touri; Behrouz,15,0,70,55
1656819620764,ECE 180,A00,083140,Abi Samra; Nicholas Camill,0,0,30,30
1656819620764,ECE 180,B00,083141,Abi Samra; Nicholas Camill,0,0,30,30
1656819626788,MATH 10A,A01,083735,Patchell; Gregory David,1,0,30,29
1656819626788,MATH 10A,A02,083736,Patchell; Gregory David,20,0,30,10
1656819626788,MATH 10A,A03,083737,Patchell; Gregory David,15,0,30,15
1656819632815,MATH 10B,A01,083207,Lim; Seonhee,7,0,34,27
1656819632815,MATH 10B,A02,083208,Lim; Seonhee,9,0,35,26
1656819632815,MATH 10B,A03,093472,Lim; Seonhee,4,0,34,30
1656819632815,MATH 10B,B01,083739,Sinha; Shubham,9,0,30,21
1656819638848,MATH 18,A01,083743,Cinel; Cameron Alexander,6,0,30,24
1656819638848,MATH 18,A02,083744,Cinel; Cameron Alexander,15,0,30,15
1656819638848,MATH 18,A03,083745,Cinel; Cameron Alexander,8,0,30,22
1656819638848,MATH 18,B01,083748,Rideout; David Porter,3,0,37,34
1656819638848,MATH 18,B02,083749,Rideout; David Porter,3,0,36,33
1656819638848,MATH 18,B03,083750,Rideout; David Porter,1,0,37,36
1656819638848,MATH 18,B04,083751,Rideout; David Porter,5,0,36,31
1656819638848,MATH 18,B05,093473,Rideout; David Porter,4,0,36,32
1656819638848,MATH 18,B06,093474,Rideout; David Porter,5,0,36,31
1656819644877,MATH 20A,A01,083754,Zheng; Zequn,12,0,40,28
1656819650905,MATH 20B,A01,083756,Briones; Jor-el Thomas Caparas,1,0,36,35
1656819650905,MATH 20B,A02,083757,Briones; Jor-el Thomas Caparas,1,0,36,35
1656819650905,MATH 20B,A03,093475,Briones; Jor-el Thomas Caparas,0,0,36,36
1656819656931,MATH 20C,A01,083760,Briones; Jor-el Thomas Caparas,1,0,35,34
1656819656931,MATH 20C,A02,083761,Briones; Jor-el Thomas Caparas,8,0,35,27
1656819656931,MATH 20C,A03,093476,Briones; Jor-el Thomas Caparas,0,1,36,36
1656819656931,MATH 20C,B01,083762,Bach; Quang Tran,0,0,30,30
1656819662956,MATH 20D,A01,083765,Tran; Brian Kha,4,0,30,26
1656819662956,MATH 20D,A02,083766,Tran; Brian Kha,4,0,30,26
1656819662956,MATH 20D,A03,083767,Tran; Brian Kha,2,0,30,28
1656819668979,MATH 20E,A01,083771,Ganguly; Soumya,5,0,32,27
1656819668979,MATH 20E,A02,083772,Ganguly; Soumya,5,0,32,27
1656819668979,MATH 20E,B01,083773,Ciotti; Benjamin,18,0,35,17
1656819668979,MATH 20E,B02,083774,Ciotti; Benjamin,17,0,35,18
1656819675004,MATH 103A,A01,083777,Greenfeld; Be'Eri,2,0,36,34
1656819675004,MATH 103A,A02,083778,Greenfeld; Be'Eri,5,0,36,31
1656819675004,MATH 103A,A03,093561,Greenfeld; Be'Eri,4,0,36,32
1656819675004,MATH 103A,B01,083779,Greenfeld; Be'Eri,6,0,36,30
1656819675004,MATH 103A,B02,083780,Greenfeld; Be'Eri,2,0,36,34
1656819675004,MATH 103A,B03,093562,Greenfeld; Be'Eri,2,0,36,34
1656819681123,MATH 105,A01,085443,Carter; Anne Toulson,13,0,35,22
1656819681123,MATH 105,A02,093477,Carter; Anne Toulson,20,0,35,15
1656819687148,MATH 109,A01,083213,Ganzberger; Geoffrey Michael,2,0,34,32
1656819687148,MATH 109,A02,083214,Ganzberger; Geoffrey Michael,2,0,34,32
1656819687148,MATH 109,A03,093478,Ganzberger; Geoffrey Michael,1,0,34,33
1656819687148,MATH 109,B01,083215,Ganzberger; Geoffrey Michael,1,0,32,31
1656819687148,MATH 109,B02,083216,Ganzberger; Geoffrey Michael,1,0,32,31
1656819687148,MATH 109,B03,093479,Ganzberger; Geoffrey Michael,6,0,32,26
1656819693187,MATH 142A,A01,083219,Chow; Bennett,6,0,32,26
1656819693187,MATH 142A,A02,083220,Chow; Bennett,9,0,32,23
1656819693187,MATH 142A,A03,093480,Chow; Bennett,7,0,32,25
1656819693187,MATH 142A,B03,093481,Chow; Bennett,7,0,32,25
1656819693187,MATH 142A,B04,093558,Chow; Bennett,10,0,32,22
1656819693187,MATH 142A,B05,093559,Chow; Bennett,6,0,32,26
1656819699215,MATH 193A,A01,083224,Rotar; Vladimir,6,0,34,28
1656819699215,MATH 193A,A02,083225,Rotar; Vladimir,3,0,34,31
1656819699215,MATH 193A,A03,083781,Rotar; Vladimir,1,0,34,33
1656819699215,MATH 193A,A04,083782,Rotar; Vladimir,6,0,34,28
1656819699215,MATH 193A,A05,093482,Rotar; Vladimir,6,0,34,28
1656819705242,MATH 197,001,091859,McAuley; Julian John,9999,0,9999,0
1656819705242,MATH 197,002,095566,Kedlaya; Kiran S.,9997,0,9999,2
1656819705242,MATH 197,003,095567,Xiao; Ming,9999,0,9999,0
1656819705242,MATH 197,004,095571,Perols; Johan Lars,9998,0,9999,1
1656819712311,COGS 9,A01,083615,Shannon; Kyle Michael,6,0,75,69
1656819718337,COGS 11,A01,083617,Boyle; Mary E. T.,18,0,48,30
1656819724362,COGS 13,A01,083071,Bastos; Amalia Pinkusfeld,8,0,71,63
1656819730393,COGS 14A,A01,092681,Semenuks; Arturs,0,1,100,100
1656819736422,COGS 14B,A01,083073,Cheng; Tzu-Han,5,0,63,58
1656819742452,COGS 17,A01,092677,Semenuks; Arturs,4,0,81,77
1656819748478,COGS 100,A01,083619,Allen; Michael Gordon,15,0,70,55
1656819754517,COGS 101A,A01,083621,Davis; Joshua Daniel,9,0,68,59
1656819760541,COGS 101B,A01,091572,Allen; Michael Gordon,8,0,65,57
1656819766567,COGS 101C,A01,083625,Delgado; Tania,17,0,35,18
1656819772596,COGS 107A,A01,083627,Boyle; Mary E. T.,13,0,60,47
1656819778621,COGS 118A,A01,083075,Gupta; Anjum,15,0,76,61
1656819784647,CSE 3,A50,083646,Miranda; Gregory Joseph,22,0,50,28
1656819790676,CSE 8A,A50,083650,Miranda; Gregory Joseph,17,1,56,39
1656819796704,CSE 11,A01,083080,Cao; Yingjun,4,15,40,36
1656819802728,CSE 12,A01,083652,Krause-Levy; Sophia Louisa,20,1,120,100
1656819808760,CSE 15L,A01,083654,Morris; Justin Loren,8,0,50,42
1656819808760,CSE 15L,A02,083655,Morris; Justin Loren,8,0,50,42
1656819814789,CSE 20,A01,083657,Tran; Khoa Dang,37,0,80,43
1656819820814,CSE 21,A01,095574,Bach; Quang Tran,21,0,48,27
1656819826849,CSE 30,A01,083084,Eldon; John,4,0,80,76
1656819826849,CSE 30,B01,095061,Bhaskar; Nishant,6,0,50,44
1656819832876,CSE 100,A01,083659,Cao; Yingjun,1,4,70,69
1656819838898,CSE 134B,A01,083661,Powell; Thomas Allan,19,0,100,81
1656819844930,CSE 140,A01,083663,Gungor; Onat,14,0,85,71
1656819850954,CSE 140L,A01,083088,Eldon; John,16,0,100,84
1656819856980,CSE 175,A01,083665,Kumar; Rakesh,3,0,25,22
1656819863005,CSE 190,A00,092507,Dubnov; Shlomo,7,0,20,13
1656819869050,ECE 45,A01,083139,Congero; Spencer William,5,0,75,70
1656819875077,ECE 65,A50,083695,Saad; Andrew S,12,0,30,18
1656819875077,ECE 65,A51,095125,Saad; Andrew S,25,0,26,1
1656819881108,ECE 109,A01,091882,Touri; Behrouz,15,0,70,55
1656819887132,ECE 180,A00,083140,Abi Samra; Nicholas Camill,0,0,30,30
1656819887132,ECE 180,B00,083141,Abi Samra; Nicholas Camill,0,0,30,30
1656819893157,MATH 10A,A01,083735,Patchell; Gregory David,1,0,30,29
1656819893157,MATH 10A,A02,083736,Patchell; Gregory David,20,0,30,10
1656819893157,MATH 10A,A03,083737,Patchell; Gregory David,15,0,30,15
1656819899186,MATH 10B,A01,083207,Lim; Seonhee,7,0,34,27
1656819899186,MATH 10B,A02,083208,Lim; Seonhee,9,0,35,26
1656819899186,MATH 10B,A03,093472,Lim; Seonhee,4,0,34,30
1656819899186,MATH 10B,B01,083739,Sinha; Shubham,9,0,30,21
1656819905216,MATH 18,A01,083743,Cinel; Cameron Alexander,6,0,30,24
1656819905216,MATH 18,A02,083744,Cinel; Cameron Alexander,15,0,30,15
1656819905216,MATH 18,A03,083745,Cinel; Cameron Alexander,8,0,30,22
1656819905216,MATH 18,B01,083748,Rideout; David Porter,3,0,37,34
1656819905216,MATH 18,B02,083749,Rideout; David Porter,3,0,36,33
1656819905216,MATH 18,B03,083750,Rideout; David Porter,1,0,37,36
1656819905216,MATH 18,B04,083751,Rideout; David Porter,5,0,36,31
1656819905216,MATH 18,B05,093473,Rideout; David Porter,4,0,36,32
1656819905216,MATH 18,B06,093474,Rideout; David Porter,5,0,36,31
1656819911245,MATH 20A,A01,083754,Zheng; Zequn,12,0,40,28
1656819917293,MATH 20B,A01,083756,Briones; Jor-el Thomas Caparas,1,0,36,35
1656819917293,MATH 20B,A02,083757,Briones; Jor-el Thomas Caparas,1,0,36,35
1656819917293,MATH 20B,A03,093475,Briones; Jor-el Thomas Caparas,0,0,36,36
1656819923325,MATH 20C,A01,083760,Briones; Jor-el Thomas Caparas,1,0,35,34
1656819923325,MATH 20C,A02,083761,Briones; Jor-el Thomas Caparas,8,0,35,27
1656819923325,MATH 20C,A03,093476,Briones; Jor-el Thomas Caparas,0,1,36,36
1656819923325,MATH 20C,B01,083762,Bach; Quang Tran,0,0,30,30
1656819929356,MATH 20D,A01,083765,Tran; Brian Kha,4,0,30,26
1656819929356,MATH 20D,A02,083766,Tran; Brian Kha,4,0,30,26
1656819929356,MATH 20D,A03,083767,Tran; Brian Kha,2,0,30,28
1656819935383,MATH 20E,A01,083771,Ganguly; Soumya,5,0,32,27
1656819935383,MATH 20E,A02,083772,Ganguly; Soumya,5,0,32,27
1656819935383,MATH 20E,B01,083773,Ciotti; Benjamin,18,0,35,17
1656819935383,MATH 20E,B02,083774,Ciotti; Benjamin,17,0,35,18
1656819941409,MATH 103A,A01,083777,Greenfeld; Be'Eri,2,0,36,34
1656819941409,MATH 103A,A02,083778,Greenfeld; Be'Eri,5,0,36,31
1656819941409,MATH 103A,A03,093561,Greenfeld; Be'Eri,4,0,36,32
1656819941409,MATH 103A,B01,083779,Greenfeld; Be'Eri,6,0,36,30
1656819941409,MATH 103A,B02,083780,Greenfeld; Be'Eri,2,0,36,34
1656819941409,MATH 103A,B03,093562,Greenfeld; Be'Eri,2,0,36,34
1656819947440,MATH 105,A01,085443,Carter; Anne Toulson,13,0,35,22
1656819947440,MATH 105,A02,093477,Carter; Anne Toulson,20,0,35,15
1656819953468,MATH 109,A01,083213,Ganzberger; Geoffrey Michael,2,0,34,32
1656819953468,MATH 109,A02,083214,Ganzberger; Geoffrey Michael,2,0,34,32
1656819953468,MATH 109,A03,093478,Ganzberger; Geoffrey Michael,1,0,34,33
1656819953468,MATH 109,B01,083215,Ganzberger; Geoffrey Michael,1,0,32,31
1656819953468,MATH 109,B02,083216,Ganzberger; Geoffrey Michael,1,0,32,31
1656819953468,MATH 109,B03,093479,Ganzberger; Geoffrey Michael,6,0,32,26
1656819959495,MATH 142A,A01,083219,Chow; Bennett,6,0,32,26
1656819959495,MATH 142A,A02,083220,Chow; Bennett,9,0,32,23
1656819959495,MATH 142A,A03,093480,Chow; Bennett,7,0,32,25
1656819959495,MATH 142A,B03,093481,Chow; Bennett,7,0,32,25
1656819959495,MATH 142A,B04,093558,Chow; Bennett,10,0,32,22
1656819959495,MATH 142A,B05,093559,Chow; Bennett,6,0,32,26
1656819965520,MATH 193A,A01,083224,Rotar; Vladimir,6,0,34,28
1656819965520,MATH 193A,A02,083225,Rotar; Vladimir,3,0,34,31
1656819965520,MATH 193A,A03,083781,Rotar; Vladimir,1,0,34,33
1656819965520,MATH 193A,A04,083782,Rotar; Vladimir,6,0,34,28
1656819965520,MATH 193A,A05,093482,Rotar; Vladimir,6,0,34,28
1656819971548,MATH 197,001,091859,McAuley; Julian John,9999,0,9999,0
1656819971548,MATH 197,002,095566,Kedlaya; Kiran S.,9997,0,9999,2
1656819971548,MATH 197,003,095567,Xiao; Ming,9999,0,9999,0
1656819971548,MATH 197,004,095571,Perols; Johan Lars,9998,0,9999,1
1656819978613,COGS 9,A01,083615,Shannon; Kyle Michael,6,0,75,69
1656819984639,COGS 11,A01,083617,Boyle; Mary E. T.,18,0,48,30
1656819990664,COGS 13,A01,083071,Bastos; Amalia Pinkusfeld,8,0,71,63
1656819996691,COGS 14A,A01,092681,Semenuks; Arturs,0,1,100,100
1656820002724,COGS 14B,A01,083073,Cheng; Tzu-Han,5,0,63,58
1656820008753,COGS 17,A01,092677,Semenuks; Arturs,4,0,81,77
1656820014789,COGS 100,A01,083619,Allen; Michael Gordon,15,0,70,55
1656820020820,COGS 101A,A01,083621,Davis; Joshua Daniel,9,0,68,59
1656820026852,COGS 101B,A01,091572,Allen; Michael Gordon,8,0,65,57
1656820032877,COGS 101C,A01,083625,Delgado; Tania,17,0,35,18
1656820038901,COGS 107A,A01,083627,Boyle; Mary E. T.,13,0,60,47
1656820044927,COGS 118A,A01,083075,Gupta; Anjum,15,0,76,61
1656820050953,CSE 3,A50,083646,Miranda; Gregory Joseph,22,0,50,28
1656820056978,CSE 8A,A50,083650,Miranda; Gregory Joseph,17,1,56,39
1656820063006,CSE 11,A01,083080,Cao; Yingjun,4,15,40,36
1656820069031,CSE 12,A01,083652,Krause-Levy; Sophia Louisa,20,1,120,100
1656820075054,CSE 15L,A01,083654,Morris; Justin Loren,8,0,50,42
1656820075054,CSE 15L,A02,083655,Morris; Justin Loren,8,0,50,42
1656820081081,CSE 20,A01,083657,Tran; Khoa Dang,37,0,80,43
1656820087106,CSE 21,A01,095574,Bach; Quang Tran,21,0,48,27
1656820093131,CSE 30,A01,083084,Eldon; John,4,0,80,76
1656820093131,CSE 30,B01,095061,Bhaskar; Nishant,6,0,50,44
1656820099157,CSE 100,A01,083659,Cao; Yingjun,1,4,70,69
1656820105186,CSE 134B,A01,083661,Powell; Thomas Allan,19,0,100,81
1656820111225,CSE 140,A01,083663,Gungor; Onat,14,0,85,71
1656820117250,CSE 140L,A01,083088,Eldon; John,16,0,100,84
1656820123280,CSE 175,A01,083665,Kumar; Rakesh,3,0,25,22
1656820129303,CSE 190,A00,092507,Dubnov; Shlomo,7,0,20,13
1656820135327,ECE 45,A01,083139,Congero; Spencer William,5,0,75,70
1656820141358,ECE 65,A50,083695,Saad; Andrew S,12,0,30,18
1656820141358,ECE 65,A51,095125,Saad; Andrew S,25,0,26,1
1656820147382,ECE 109,A01,091882,Touri; Behrouz,15,0,70,55
1656820153406,ECE 180,A00,083140,Abi Samra; Nicholas Camill,0,0,30,30
1656820153406,ECE 180,B00,083141,Abi Samra; Nicholas Camill,0,0,30,30
1656820159432,MATH 10A,A01,083735,Patchell; Gregory David,1,0,30,29
1656820159432,MATH 10A,A02,083736,Patchell; Gregory David,20,0,30,10
1656820159432,MATH 10A,A03,083737,Patchell; Gregory David,15,0,30,15
1656820165466,MATH 10B,A01,083207,Lim; Seonhee,7,0,34,27
1656820165466,MATH 10B,A02,083208,Lim; Seonhee,9,0,35,26
1656820165466,MATH 10B,A03,093472,Lim; Seonhee,4,0,34,30
1656820165466,MATH 10B,B01,083739,Sinha; Shubham,9,0,30,21
1656820171504,MATH 18,A01,083743,Cinel; Cameron Alexander,6,0,30,24
1656820171504,MATH 18,A02,083744,Cinel; Cameron Alexander,15,0,30,15
1656820171504,MATH 18,A03,083745,Cinel; Cameron Alexander,8,0,30,22
1656820171504,MATH 18,B01,083748,Rideout; David Porter,3,0,37,34
1656820171504,MATH 18,B02,083749,Rideout; David Porter,3,0,36,33
1656820171504,MATH 18,B03,083750,Rideout; David Porter,1,0,37,36
1656820171504,MATH 18,B04,083751,Rideout; David Porter,5,0,36,31
1656820171504,MATH 18,B05,093473,Rideout; David Porter,4,0,36,32
1656820171504,MATH 18,B06,093474,Rideout; David Porter,5,0,36,31
1656820177529,MATH 20A,A01,083754,Zheng; Zequn,12,0,40,28
1656820183561,MATH 20B,A01,083756,Briones; Jor-el Thomas Caparas,1,0,36,35
1656820183561,MATH 20B,A02,083757,Briones; Jor-el Thomas Caparas,1,0,36,35
1656820183561,MATH 20B,A03,093475,Briones; Jor-el Thomas Caparas,0,0,36,36
1656820189586,MATH 20C,A01,083760,Briones; Jor-el Thomas Caparas,1,0,35,34
1656820189586,MATH 20C,A02,083761,Briones; Jor-el Thomas Caparas,8,0,35,27
1656820189586,MATH 20C,A03,093476,Briones; Jor-el Thomas Caparas,0,1,36,36
1656820189586,MATH 20C,B01,083762,Bach; Quang Tran,0,0,30,30
1656820195631,MATH 20D,A01,083765,Tran; Brian Kha,4,0,30,26
1656820195631,MATH 20D,A02,083766,Tran; Brian Kha,4,0,30,26
1656820195631,MATH 20D,A03,083767,Tran; Brian Kha,2,0,30,28
1656820201666,MATH 20E,A01,083771,Ganguly; Soumya,5,0,32,27
1656820201666,MATH 20E,A02,083772,Ganguly; Soumya,5,0,32,27
1656820201666,MATH 20E,B01,083773,Ciotti; Benjamin,18,0,35,17
1656820201666,MATH 20E,B02,083774,Ciotti; Benjamin,17,0,35,18
1656820207692,MATH 103A,A01,083777,Greenfeld; Be'Eri,2,0,36,34
1656820207692,MATH 103A,A02,083778,Greenfeld; Be'Eri,5,0,36,31
1656820207692,MATH 103A,A03,093561,Greenfeld; Be'Eri,4,0,36,32
1656820207692,MATH 103A,B01,083779,Greenfeld; Be'Eri,6,0,36,30
1656820207692,MATH 103A,B02,083780,Greenfeld; Be'Eri,2,0,36,34
1656820207692,MATH 103A,B03,093562,Greenfeld; Be'Eri,2,0,36,34
1656820213729,MATH 105,A01,085443,Carter; Anne Toulson,13,0,35,22
1656820213729,MATH 105,A02,093477,Carter; Anne Toulson,20,0,35,15
1656820219752,MATH 109,A01,083213,Ganzberger; Geoffrey Michael,2,0,34,32
1656820219752,MATH 109,A02,083214,Ganzberger; Geoffrey Michael,2,0,34,32
1656820219752,MATH 109,A03,093478,Ganzberger; Geoffrey Michael,1,0,34,33
1656820219752,MATH 109,B01,083215,Ganzberger; Geoffrey Michael,1,0,32,31
1656820219752,MATH 109,B02,083216,Ganzberger; Geoffrey Michael,1,0,32,31
1656820219752,MATH 109,B03,093479,Ganzberger; Geoffrey Michael,6,0,32,26
1656820225785,MATH 142A,A01,083219,Chow; Bennett,6,0,32,26
1656820225785,MATH 142A,A02,083220,Chow; Bennett,9,0,32,23
1656820225785,MATH 142A,A03,093480,Chow; Bennett,7,0,32,25
1656820225785,MATH 142A,B03,093481,Chow; Bennett,7,0,32,25
1656820225785,MATH 142A,B04,093558,Chow; Bennett,10,0,32,22
1656820225785,MATH 142A,B05,093559,Chow; Bennett,6,0,32,26
1656820231811,MATH 193A,A01,083224,Rotar; Vladimir,6,0,34,28
1656820231811,MATH 193A,A02,083225,Rotar; Vladimir,3,0,34,31
1656820231811,MATH 193A,A03,083781,Rotar; Vladimir,1,0,34,33
1656820231811,MATH 193A,A04,083782,Rotar; Vladimir,6,0,34,28
1656820231811,MATH 193A,A05,093482,Rotar; Vladimir,6,0,34,28
1656820237835,MATH 197,001,091859,McAuley; Julian John,9999,0,9999,0
1656820237835,MATH 197,002,095566,Kedlaya; Kiran S.,9997,0,9999,2
1656820237835,MATH 197,003,095567,Xiao; Ming,9999,0,9999,0
1656820237835,MATH 197,004,095571,Perols; Johan Lars,9998,0,9999,1
1656820244916,COGS 9,A01,083615,Shannon; Kyle Michael,6,0,75,69
1656820250944,COGS 11,A01,083617,Boyle; Mary E. T.,18,0,48,30
1656820256975,COGS 13,A01,083071,Bastos; Amalia Pinkusfeld,8,0,71,63
1656820262997,COGS 14A,A01,092681,Semenuks; Arturs,0,1,100,100
1656820269033,COGS 14B,A01,083073,Cheng; Tzu-Han,5,0,63,58
1656820275132,COGS 17,A01,092677,Semenuks; Arturs,4,0,81,77
1656820281157,COGS 100,A01,083619,Allen; Michael Gordon,15,0,70,55
1656820287188,COGS 101A,A01,083621,Davis; Joshua Daniel,9,0,68,59
1656820293213,COGS 101B,A01,091572,Allen; Michael Gordon,8,0,65,57
1656820299244,COGS 101C,A01,083625,Delgado; Tania,17,0,35,18
1656820305267,COGS 107A,A01,083627,Boyle; Mary E. T.,13,0,60,47
1656820311292,COGS 118A,A01,083075,Gupta; Anjum,15,0,76,61
1656820317321,CSE 3,A50,083646,Miranda; Gregory Joseph,22,0,50,28
1656820323350,CSE 8A,A50,083650,Miranda; Gregory Joseph,17,1,56,39
1656820329373,CSE 11,A01,083080,Cao; Yingjun,4,15,40,36
1656820335403,CSE 12,A01,083652,Krause-Levy; Sophia Louisa,20,1,120,100
1656820341435,CSE 15L,A01,083654,Morris; Justin Loren,8,0,50,42
1656820341435,CSE 15L,A02,083655,Morris; Justin Loren,8,0,50,42
1656820347464,CSE 20,A01,083657,Tran; Khoa Dang,37,0,80,43
1656820353488,CSE 21,A01,095574,Bach; Quang Tran,21,0,48,27
1656820359513,CSE 30,A01,083084,Eldon; John,4,0,80,76
1656820359513,CSE 30,B01,095061,Bhaskar; Nishant,6,0,50,44
1656820365538,CSE 100,A01,083659,Cao; Yingjun,1,4,70,69
1656820371563,CSE 134B,A01,083661,Powell; Thomas Allan,19,0,100,81
1656820377590,CSE 140,A01,083663,Gungor; Onat,14,0,85,71
1656820383617,CSE 140L,A01,083088,Eldon; John,16,0,100,84
1656820389648,CSE 175,A01,083665,Kumar; Rakesh,3,0,25,22
1656820395676,CSE 190,A00,092507,Dubnov; Shlomo,7,0,20,13
1656820401712,ECE 45,A01,083139,Congero; Spencer William,5,0,75,70
1656820407743,ECE 65,A50,083695,Saad; Andrew S,12,0,30,18
1656820407743,ECE 65,A51,095125,Saad; Andrew S,25,0,26,1
1656820413767,ECE 109,A01,091882,Touri; Behrouz,15,0,70,55
1656820419794,ECE 180,A00,083140,Abi Samra; Nicholas Camill,0,0,30,30
1656820419794,ECE 180,B00,083141,Abi Samra; Nicholas Camill,0,0,30,30
1656820425827,MATH 10A,A01,083735,Patchell; Gregory David,1,0,30,29
1656820425827,MATH 10A,A02,083736,Patchell; Gregory David,20,0,30,10
1656820425827,MATH 10A,A03,083737,Patchell; Gregory David,15,0,30,15
1656820431854,MATH 10B,A01,083207,Lim; Seonhee,7,0,34,27
1656820431854,MATH 10B,A02,083208,Lim; Seonhee,9,0,35,26
1656820431854,MATH 10B,A03,093472,Lim; Seonhee,4,0,34,30
1656820431854,MATH 10B,B01,083739,Sinha; Shubham,9,0,30,21
1656820437882,MATH 18,A01,083743,Cinel; Cameron Alexander,6,0,30,24
1656820437882,MATH 18,A02,083744,Cinel; Cameron Alexander,15,0,30,15
1656820437882,MATH 18,A03,083745,Cinel; Cameron Alexander,8,0,30,22
1656820437882,MATH 18,B01,083748,Rideout; David Porter,3,0,37,34
1656820437882,MATH 18,B02,083749,Rideout; David Porter,3,0,36,33
1656820437882,MATH 18,B03,083750,Rideout; David Porter,1,0,37,36
1656820437882,MATH 18,B04,083751,Rideout; David Porter,5,0,36,31
1656820437882,MATH 18,B05,093473,Rideout; David Porter,4,0,36,32
1656820437882,MATH 18,B06,093474,Rideout; David Porter,5,0,36,31
1656820443910,MATH 20A,A01,083754,Zheng; Zequn,12,0,40,28
1656820449934,MATH 20B,A01,083756,Briones; Jor-el Thomas Caparas,1,0,36,35
1656820449934,MATH 20B,A02,083757,Briones; Jor-el Thomas Caparas,1,0,36,35
1656820449934,MATH 20B,A03,093475,Briones; Jor-el Thomas Caparas,0,0,36,36
1656820455963,MATH 20C,A01,083760,Briones; Jor-el Thomas Caparas,1,0,35,34
1656820455963,MATH 20C,A02,083761,Briones; Jor-el Thomas Caparas,8,0,35,27
1656820455963,MATH 20C,A03,093476,Briones; Jor-el Thomas Caparas,0,1,36,36
1656820455963,MATH 20C,B01,083762,Bach; Quang Tran,0,0,30,30
1656820461990,MATH 20D,A01,083765,Tran; Brian Kha,4,0,30,26
1656820461990,MATH 20D,A02,083766,Tran; Brian Kha,4,0,30,26
1656820461990,MATH 20D,A03,083767,Tran; Brian Kha,2,0,30,28
1656820468026,MATH 20E,A01,083771,Ganguly; Soumya,5,0,32,27
1656820468026,MATH 20E,A02,083772,Ganguly; Soumya,5,0,32,27
1656820468026,MATH 20E,B01,083773,Ciotti; Benjamin,18,0,35,17
1656820468026,MATH 20E,B02,083774,Ciotti; Benjamin,17,0,35,18
1656820474058,MATH 103A,A01,083777,Greenfeld; Be'Eri,2,0,36,34
1656820474058,MATH 103A,A02,083778,Greenfeld; Be'Eri,5,0,36,31
1656820474058,MATH 103A,A03,093561,Greenfeld; Be'Eri,4,0,36,32
1656820474058,MATH 103A,B01,083779,Greenfeld; Be'Eri,6,0,36,30
1656820474058,MATH 103A,B02,083780,Greenfeld; Be'Eri,2,0,36,34
1656820474058,MATH 103A,B03,093562,Greenfeld; Be'Eri,2,0,36,34
1656820480089,MATH 105,A01,085443,Carter; Anne Toulson,13,0,35,22
1656820480089,MATH 105,A02,093477,Carter; Anne Toulson,20,0,35,15
1656820486120,MATH 109,A01,083213,Ganzberger; Geoffrey Michael,2,0,34,32
1656820486120,MATH 109,A02,083214,Ganzberger; Geoffrey Michael,2,0,34,32
1656820486120,MATH 109,A03,093478,Ganzberger; Geoffrey Michael,1,0,34,33
1656820486120,MATH 109,B01,083215,Ganzberger; Geoffrey Michael,1,0,32,31
1656820486120,MATH 109,B02,083216,Ganzberger; Geoffrey Michael,1,0,32,31
1656820486120,MATH 109,B03,093479,Ganzberger; Geoffrey Michael,6,0,32,26
1656820492147,MATH 142A,A01,083219,Chow; Bennett,6,0,32,26
1656820492147,MATH 142A,A02,083220,Chow; Bennett,9,0,32,23
1656820492147,MATH 142A,A03,093480,Chow; Bennett,7,0,32,25
1656820492147,MATH 142A,B03,093481,Chow; Bennett,7,0,32,25
1656820492147,MATH 142A,B04,093558,Chow; Bennett,10,0,32,22
1656820492147,MATH 142A,B05,093559,Chow; Bennett,6,0,32,26
1656820498176,MATH 193A,A01,083224,Rotar; Vladimir,6,0,34,28
1656820498176,MATH 193A,A02,083225,Rotar; Vladimir,3,0,34,31
1656820498176,MATH 193A,A03,083781,Rotar; Vladimir,1,0,34,33
1656820498176,MATH 193A,A04,083782,Rotar; Vladimir,6,0,34,28
1656820498176,MATH 193A,A05,093482,Rotar; Vladimir,6,0,34,28
1656820504200,MATH 197,001,091859,McAuley; Julian John,9999,0,9999,0
1656820504200,MATH 197,002,095566,Kedlaya; Kiran S.,9997,0,9999,2
1656820504200,MATH 197,003,095567,Xiao; Ming,9999,0,9999,0
1656820504200,MATH 197,004,095571,Perols; Johan Lars,9998,0,9999,1
1656820511274,COGS 9,A01,083615,Shannon; Kyle Michael,6,0,75,69
1656820517302,COGS 11,A01,083617,Boyle; Mary E. T.,18,0,48,30
1656820523327,COGS 13,A01,083071,Bastos; Amalia Pinkusfeld,8,0,71,63
1656820529357,COGS 14A,A01,092681,Semenuks; Arturs,0,1,100,100
1656820535381,COGS 14B,A01,083073,Cheng; Tzu-Han,5,0,63,58
1656820541405,COGS 17,A01,092677,Semenuks; Arturs,4,0,81,77
1656820547433,COGS 100,A01,083619,Allen; Michael Gordon,15,0,70,55
1656820553458,COGS 101A,A01,083621,Davis; Joshua Daniel,9,0,68,59
1656820559486,COGS 101B,A01,091572,Allen; Michael Gordon,8,0,65,57
1656820565511,COGS 101C,A01,083625,Delgado; Tania,17,0,35,18
1656820571535,COGS 107A,A01,083627,Boyle; Mary E. T.,13,0,60,47
1656820577563,COGS 118A,A01,083075,Gupta; Anjum,15,0,76,61
1656820583589,CSE 3,A50,083646,Miranda; Gregory Joseph,22,0,50,28
1656820589617,CSE 8A,A50,083650,Miranda; Gregory Joseph,17,1,56,39
1656820595640,CSE 11,A01,083080,Cao; Yingjun,4,15,40,36
1656820601670,CSE 12,A01,083652,Krause-Levy; Sophia Louisa,20,1,120,100
1656820607694,CSE 15L,A01,083654,Morris; Justin Loren,8,0,50,42
1656820607694,CSE 15L,A02,083655,Morris; Justin Loren,8,0,50,42
1656820613721,CSE 20,A01,083657,Tran; Khoa Dang,37,0,80,43
1656820619756,CSE 21,A01,095574,Bach; Quang Tran,21,0,48,27
1656820625781,CSE 30,A01,083084,Eldon; John,4,0,80,76
1656820625781,CSE 30,B01,095061,Bhaskar; Nishant,6,0,50,44
1656820631805,CSE 100,A01,083659,Cao; Yingjun,1,4,70,69
1656820637829,CSE 134B,A01,083661,Powell; Thomas Allan,19,0,100,81
1656820643859,CSE 140,A01,083663,Gungor; Onat,14,0,85,71
1656820649887,CSE 140L,A01,083088,Eldon; John,16,0,100,84
1656820655911,CSE 175,A01,083665,Kumar; Rakesh,3,0,25,22
1656820661935,CSE 190,A00,092507,Dubnov; Shlomo,7,0,20,13
1656820667960,ECE 45,A01,083139,Congero; Spencer William,5,0,75,70
1656820673984,ECE 65,A50,083695,Saad; Andrew S,12,0,30,18
1656820673984,ECE 65,A51,095125,Saad; Andrew S,25,0,26,1
1656820680010,ECE 109,A01,091882,Touri; Behrouz,15,0,70,55
1656820686038,ECE 180,A00,083140,Abi Samra; Nicholas Camill,0,0,30,30
1656820686038,ECE 180,B00,083141,Abi Samra; Nicholas Camill,0,0,30,30
1656820692070,MATH 10A,A01,083735,Patchell; Gregory David,1,0,30,29
1656820692070,MATH 10A,A02,083736,Patchell; Gregory David,20,0,30,10
1656820692070,MATH 10A,A03,083737,Patchell; Gregory David,15,0,30,15
1656820698104,MATH 10B,A01,083207,Lim; Seonhee,7,0,34,27
1656820698104,MATH 10B,A02,083208,Lim; Seonhee,9,0,35,26
1656820698104,MATH 10B,A03,093472,Lim; Seonhee,4,0,34,30
1656820698104,MATH 10B,B01,083739,Sinha; Shubham,9,0,30,21
1656820704136,MATH 18,A01,083743,Cinel; Cameron Alexander,6,0,30,24
1656820704136,MATH 18,A02,083744,Cinel; Cameron Alexander,15,0,30,15
1656820704136,MATH 18,A03,083745,Cinel; Cameron Alexander,8,0,30,22
1656820704136,MATH 18,B01,083748,Rideout; David Porter,3,0,37,34
1656820704136,MATH 18,B02,083749,Rideout; David Porter,3,0,36,33
1656820704136,MATH 18,B03,083750,Rideout; David Porter,1,0,37,36
1656820704136,MATH 18,B04,083751,Rideout; David Porter,5,0,36,31
1656820704136,MATH 18,B05,093473,Rideout; David Porter,4,0,36,32
1656820704136,MATH 18,B06,093474,Rideout; David Porter,5,0,36,31
1656820710161,MATH 20A,A01,083754,Zheng; Zequn,12,0,40,28
1656820716192,MATH 20B,A01,083756,Briones; Jor-el Thomas Caparas,1,0,36,35
1656820716192,MATH 20B,A02,083757,Briones; Jor-el Thomas Caparas,1,0,36,35
1656820716192,MATH 20B,A03,093475,Briones; Jor-el Thomas Caparas,0,0,36,36
1656820722223,MATH 20C,A01,083760,Briones; Jor-el Thomas Caparas,1,0,35,34
1656820722223,MATH 20C,A02,083761,Briones; Jor-el Thomas Caparas,8,0,35,27
1656820722223,MATH 20C,A03,093476,Briones; Jor-el Thomas Caparas,0,1,36,36
1656820722223,MATH 20C,B01,083762,Bach; Quang Tran,0,0,30,30
1656820728250,MATH 20D,A01,083765,Tran; Brian Kha,4,0,30,26
1656820728250,MATH 20D,A02,083766,Tran; Brian Kha,4,0,30,26
1656820728250,MATH 20D,A03,083767,Tran; Brian Kha,2,0,30,28
1656820734284,MATH 20E,A01,083771,Ganguly; Soumya,5,0,32,27
1656820734284,MATH 20E,A02,083772,Ganguly; Soumya,5,0,32,27
1656820734284,MATH 20E,B01,083773,Ciotti; Benjamin,18,0,35,17
1656820734284,MATH 20E,B02,083774,Ciotti; Benjamin,17,0,35,18
1656820740317,MATH 103A,A01,083777,Greenfeld; Be'Eri,2,0,36,34
1656820740317,MATH 103A,A02,083778,Greenfeld; Be'Eri,5,0,36,31
1656820740317,MATH 103A,A03,093561,Greenfeld; Be'Eri,4,0,36,32
1656820740317,MATH 103A,B01,083779,Greenfeld; Be'Eri,6,0,36,30
1656820740317,MATH 103A,B02,083780,Greenfeld; Be'Eri,2,0,36,34
1656820740317,MATH 103A,B03,093562,Greenfeld; Be'Eri,2,0,36,34
1656820746344,MATH 105,A01,085443,Carter; Anne Toulson,13,0,35,22
1656820746344,MATH 105,A02,093477,Carter; Anne Toulson,20,0,35,15
1656820752375,MATH 109,A01,083213,Ganzberger; Geoffrey Michael,2,0,34,32
1656820752375,MATH 109,A02,083214,Ganzberger; Geoffrey Michael,2,0,34,32
1656820752375,MATH 109,A03,093478,Ganzberger; Geoffrey Michael,1,0,34,33
1656820752375,MATH 109,B01,083215,Ganzberger; Geoffrey Michael,1,0,32,31
1656820752375,MATH 109,B02,083216,Ganzberger; Geoffrey Michael,1,0,32,31
1656820752375,MATH 109,B03,093479,Ganzberger; Geoffrey Michael,6,0,32,26
1656820758404,MATH 142A,A01,083219,Chow; Bennett,6,0,32,26
1656820758404,MATH 142A,A02,083220,Chow; Bennett,9,0,32,23
1656820758404,MATH 142A,A03,093480,Chow; Bennett,7,0,32,25
1656820758404,MATH 142A,B03,093481,Chow; Bennett,7,0,32,25
1656820758404,MATH 142A,B04,093558,Chow; Bennett,10,0,32,22
1656820758404,MATH 142A,B05,093559,Chow; Bennett,6,0,32,26
1656820764430,MATH 193A,A01,083224,Rotar; Vladimir,6,0,34,28
1656820764430,MATH 193A,A02,083225,Rotar; Vladimir,3,0,34,31
1656820764430,MATH 193A,A03,083781,Rotar; Vladimir,1,0,34,33
1656820764430,MATH 193A,A04,083782,Rotar; Vladimir,6,0,34,28
1656820764430,MATH 193A,A05,093482,Rotar; Vladimir,6,0,34,28
1656820770456,MATH 197,001,091859,McAuley; Julian John,9999,0,9999,0
1656820770456,MATH 197,002,095566,Kedlaya; Kiran S.,9997,0,9999,2
1656820770456,MATH 197,003,095567,Xiao; Ming,9999,0,9999,0
1656820770456,MATH 197,004,095571,Perols; Johan Lars,9998,0,9999,1
1656820777518,COGS 9,A01,083615,Shannon; Kyle Michael,6,0,75,69
1656820783548,COGS 11,A01,083617,Boyle; Mary E. T.,18,0,48,30
1656820789577,COGS 13,A01,083071,Bastos; Amalia Pinkusfeld,8,0,71,63
1656820795607,COGS 14A,A01,092681,Semenuks; Arturs,0,1,100,100
1656820801633,COGS 14B,A01,083073,Cheng; Tzu-Han,5,0,63,58
1656820807656,COGS 17,A01,092677,Semenuks; Arturs,4,0,81,77
1656820813684,COGS 100,A01,083619,Allen; Michael Gordon,15,0,70,55
1656820819714,COGS 101A,A01,083621,Davis; Joshua Daniel,9,0,68,59
1656820825741,COGS 101B,A01,091572,Allen; Michael Gordon,8,0,65,57
1656820831769,COGS 101C,A01,083625,Delgado; Tania,17,0,35,18
1656820837792,COGS 107A,A01,083627,Boyle; Mary E. T.,13,0,60,47
1656820843814,COGS 118A,A01,083075,Gupta; Anjum,15,0,76,61
1656820849844,CSE 3,A50,083646,Miranda; Gregory Joseph,22,0,50,28
1656820855868,CSE 8A,A50,083650,Miranda; Gregory Joseph,17,1,56,39
1656820861895,CSE 11,A01,083080,Cao; Yingjun,4,15,40,36
1656820867922,CSE 12,A01,083652,Krause-Levy; Sophia Louisa,20,1,120,100
1656820874017,CSE 15L,A01,083654,Morris; Justin Loren,8,0,50,42
1656820874017,CSE 15L,A02,083655,Morris; Justin Loren,8,0,50,42
1656820880041,CSE 20,A01,083657,Tran; Khoa Dang,37,0,80,43
1656820886064,CSE 21,A01,095574,Bach; Quang Tran,21,0,48,27
1656820892090,CSE 30,A01,083084,Eldon; John,4,0,80,76
1656820892090,CSE 30,B01,095061,Bhaskar; Nishant,6,0,50,44
1656820898119,CSE 100,A01,083659,Cao; Yingjun,1,4,70,69
1656820904144,CSE 134B,A01,083661,Powell; Thomas Allan,19,0,100,81
1656820910167,CSE 140,A01,083663,Gungor; Onat,14,0,85,71
1656820916192,CSE 140L,A01,083088,Eldon; John,16,0,100,84
1656820922222,CSE 175,A01,083665,Kumar; Rakesh,3,0,25,22
1656820928245,CSE 190,A00,092507,Dubnov; Shlomo,7,0,20,13
1656820934271,ECE 45,A01,083139,Congero; Spencer William,5,0,75,70
1656820940305,ECE 65,A50,083695,Saad; Andrew S,12,0,30,18
1656820940305,ECE 65,A51,095125,Saad; Andrew S,25,0,26,1
1656820946330,ECE 109,A01,091882,Touri; Behrouz,15,0,70,55
1656820952358,ECE 180,A00,083140,Abi Samra; Nicholas Camill,0,0,30,30
1656820952358,ECE 180,B00,083141,Abi Samra; Nicholas Camill,0,0,30,30
1656820958388,MATH 10A,A01,083735,Patchell; Gregory David,1,0,30,29
1656820958388,MATH 10A,A02,083736,Patchell; Gregory David,20,0,30,10
1656820958388,MATH 10A,A03,083737,Patchell; Gregory David,15,0,30,15
1656820964413,MATH 10B,A01,083207,Lim; Seonhee,7,0,34,27
1656820964413,MATH 10B,A02,083208,Lim; Seonhee,9,0,35,26
1656820964413,MATH 10B,A03,093472,Lim; Seonhee,4,0,34,30
1656820964413,MATH 10B,B01,083739,Sinha; Shubham,9,0,30,21
1656820970446,MATH 18,A01,083743,Cinel; Cameron Alexander,6,0,30,24
1656820970446,MATH 18,A02,083744,Cinel; Cameron Alexander,15,0,30,15
1656820970446,MATH 18,A03,083745,Cinel; Cameron Alexander,8,0,30,22
1656820970446,MATH 18,B01,083748,Rideout; David Porter,3,0,37,34
1656820970446,MATH 18,B02,083749,Rideout; David Porter,3,0,36,33
1656820970446,MATH 18,B03,083750,Rideout; David Porter,1,0,37,36
1656820970446,MATH 18,B04,083751,Rideout; David Porter,5,0,36,31
1656820970446,MATH 18,B05,093473,Rideout; David Porter,4,0,36,32
1656820970446,MATH 18,B06,093474,Rideout; David Porter,5,0,36,31
1656820976473,MATH 20A,A01,083754,Zheng; Zequn,12,0,40,28
1656820982504,MATH 20B,A01,083756,Briones; Jor-el Thomas Caparas,1,0,36,35
1656820982504,MATH 20B,A02,083757,Briones; Jor-el Thomas Caparas,1,0,36,35
1656820982504,MATH 20B,A03,093475,Briones; Jor-el Thomas Caparas,0,0,36,36
1656820988533,MATH 20C,A01,083760,Briones; Jor-el Thomas Caparas,1,0,35,34
1656820988533,MATH 20C,A02,083761,Briones; Jor-el Thomas Caparas,8,0,35,27
1656820988533,MATH 20C,A03,093476,Briones; Jor-el Thomas Caparas,0,1,36,36
1656820988533,MATH 20C,B01,083762,Bach; Quang Tran,0,0,30,30
1656820994557,MATH 20D,A01,083765,Tran; Brian Kha,4,0,30,26
1656820994557,MATH 20D,A02,083766,Tran; Brian Kha,4,0,30,26
1656820994557,MATH 20D,A03,083767,Tran; Brian Kha,2,0,30,28
1656821000583,MATH 20E,A01,083771,Ganguly; Soumya,5,0,32,27
1656821000583,MATH 20E,A02,083772,Ganguly; Soumya,5,0,32,27
1656821000583,MATH 20E,B01,083773,Ciotti; Benjamin,18,0,35,17
1656821000583,MATH 20E,B02,083774,Ciotti; Benjamin,17,0,35,18
1656821006614,MATH 103A,A01,083777,Greenfeld; Be'Eri,2,0,36,34
1656821006614,MATH 103A,A02,083778,Greenfeld; Be'Eri,5,0,36,31
1656821006614,MATH 103A,A03,093561,Greenfeld; Be'Eri,4,0,36,32
1656821006614,MATH 103A,B01,083779,Greenfeld; Be'Eri,6,0,36,30
1656821006614,MATH 103A,B02,083780,Greenfeld; Be'Eri,2,0,36,34
1656821006614,MATH 103A,B03,093562,Greenfeld; Be'Eri,2,0,36,34
1656821012638,MATH 105,A01,085443,Carter; Anne Toulson,13,0,35,22
1656821012638,MATH 105,A02,093477,Carter; Anne Toulson,20,0,35,15
1656821018669,MATH 109,A01,083213,Ganzberger; Geoffrey Michael,2,0,34,32
1656821018669,MATH 109,A02,083214,Ganzberger; Geoffrey Michael,2,0,34,32
1656821018669,MATH 109,A03,093478,Ganzberger; Geoffrey Michael,1,0,34,33
1656821018669,MATH 109,B01,083215,Ganzberger; Geoffrey Michael,1,0,32,31
1656821018669,MATH 109,B02,083216,Ganzberger; Geoffrey Michael,1,0,32,31
1656821018669,MATH 109,B03,093479,Ganzberger; Geoffrey Michael,6,0,32,26
1656821024702,MATH 142A,A01,083219,Chow; Bennett,6,0,32,26
1656821024702,MATH 142A,A02,083220,Chow; Bennett,9,0,32,23
1656821024702,MATH 142A,A03,093480,Chow; Bennett,7,0,32,25
1656821024702,MATH 142A,B03,093481,Chow; Bennett,7,0,32,25
1656821024702,MATH 142A,B04,093558,Chow; Bennett,10,0,32,22
1656821024702,MATH 142A,B05,093559,Chow; Bennett,6,0,32,26
1656821030733,MATH 193A,A01,083224,Rotar; Vladimir,6,0,34,28
1656821030733,MATH 193A,A02,083225,Rotar; Vladimir,3,0,34,31
1656821030733,MATH 193A,A03,083781,Rotar; Vladimir,1,0,34,33
1656821030733,MATH 193A,A04,083782,Rotar; Vladimir,6,0,34,28
1656821030733,MATH 193A,A05,093482,Rotar; Vladimir,6,0,34,28
1656821036761,MATH 197,001,091859,McAuley; Julian John,9999,0,9999,0
1656821036761,MATH 197,002,095566,Kedlaya; Kiran S.,9997,0,9999,2
1656821036761,MATH 197,003,095567,Xiao; Ming,9999,0,9999,0
1656821036761,MATH 197,004,095571,Perols; Johan Lars,9998,0,9999,1
1656821043820,COGS 9,A01,083615,Shannon; Kyle Michael,6,0,75,69
1656821049849,COGS 11,A01,083617,Boyle; Mary E. T.,18,0,48,30
1656821055871,COGS 13,A01,083071,Bastos; Amalia Pinkusfeld,8,0,71,63
1656821061895,COGS 14A,A01,092681,Semenuks; Arturs,0,1,100,100
1656821067925,COGS 14B,A01,083073,Cheng; Tzu-Han,5,0,63,58
1656821073952,COGS 17,A01,092677,Semenuks; Arturs,4,0,81,77
1656821079981,COGS 100,A01,083619,Allen; Michael Gordon,15,0,70,55
1656821086009,COGS 101A,A01,083621,Davis; Joshua Daniel,9,0,68,59
1656821092035,COGS 101B,A01,091572,Allen; Michael Gordon,8,0,65,57
1656821098058,COGS 101C,A01,083625,Delgado; Tania,17,0,35,18
1656821104086,COGS 107A,A01,083627,Boyle; Mary E. T.,13,0,60,47
1656821110111,COGS 118A,A01,083075,Gupta; Anjum,15,0,76,61
1656821116134,CSE 3,A50,083646,Miranda; Gregory Joseph,22,0,50,28
1656821122161,CSE 8A,A50,083650,Miranda; Gregory Joseph,17,1,56,39
1656821128188,CSE 11,A01,083080,Cao; Yingjun,4,15,40,36
1656821134219,CSE 12,A01,083652,Krause-Levy; Sophia Louisa,20,1,120,100
1656821140243,CSE 15L,A01,083654,Morris; Justin Loren,8,0,50,42
1656821140243,CSE 15L,A02,083655,Morris; Justin Loren,8,0,50,42
1656821146270,CSE 20,A01,083657,Tran; Khoa Dang,37,0,80,43
1656821152297,CSE 21,A01,095574,Bach; Quang Tran,21,0,48,27
1656821158319,CSE 30,A01,083084,Eldon; John,4,0,80,76
1656821158319,CSE 30,B01,095061,Bhaskar; Nishant,6,0,50,44
1656821164343,CSE 100,A01,083659,Cao; Yingjun,1,4,70,69
1656821170372,CSE 134B,A01,083661,Powell; Thomas Allan,19,0,100,81
1656821176398,CSE 140,A01,083663,Gungor; Onat,14,0,85,71
1656821182421,CSE 140L,A01,083088,Eldon; John,16,0,100,84
1656821188443,CSE 175,A01,083665,Kumar; Rakesh,3,0,25,22
1656821194468,CSE 190,A00,092507,Dubnov; Shlomo,7,0,20,13
1656821200499,ECE 45,A01,083139,Congero; Spencer William,5,0,75,70
1656821206526,ECE 65,A50,083695,Saad; Andrew S,12,0,30,18
1656821206526,ECE 65,A51,095125,Saad; Andrew S,25,0,26,1
1656821212552,ECE 109,A01,091882,Touri; Behrouz,15,0,70,55
1656821218585,ECE 180,A00,083140,Abi Samra; Nicholas Camill,0,0,30,30
1656821218585,ECE 180,B00,083141,Abi Samra; Nicholas Camill,0,0,30,30
1656821224613,MATH 10A,A01,083735,Patchell; Gregory David,1,0,30,29
1656821224613,MATH 10A,A02,083736,Patchell; Gregory David,20,0,30,10
1656821224613,MATH 10A,A03,083737,Patchell; Gregory David,15,0,30,15
1656821230637,MATH 10B,A01,083207,Lim; Seonhee,7,0,34,27
1656821230637,MATH 10B,A02,083208,Lim; Seonhee,9,0,35,26
1656821230637,MATH 10B,A03,093472,Lim; Seonhee,4,0,34,30
1656821230637,MATH 10B,B01,083739,Sinha; Shubham,9,0,30,21
1656821236672,MATH 18,A01,083743,Cinel; Cameron Alexander,6,0,30,24
1656821236672,MATH 18,A02,083744,Cinel; Cameron Alexander,15,0,30,15
1656821236672,MATH 18,A03,083745,Cinel; Cameron Alexander,8,0,30,22
1656821236672,MATH 18,B01,083748,Rideout; David Porter,3,0,37,34
1656821236672,MATH 18,B02,083749,Rideout; David Porter,3,0,36,33
1656821236672,MATH 18,B03,083750,Rideout; David Porter,1,0,37,36
1656821236672,MATH 18,B04,083751,Rideout; David Porter,5,0,36,31
1656821236672,MATH 18,B05,093473,Rideout; David Porter,4,0,36,32
1656821236672,MATH 18,B06,093474,Rideout; David Porter,5,0,36,31
1656821242697,MATH 20A,A01,083754,Zheng; Zequn,12,0,40,28
1656821248719,MATH 20B,A01,083756,Briones; Jor-el Thomas Caparas,1,0,36,35
1656821248719,MATH 20B,A02,083757,Briones; Jor-el Thomas Caparas,1,0,36,35
1656821248719,MATH 20B,A03,093475,Briones; Jor-el Thomas Caparas,0,0,36,36
1656821254751,MATH 20C,A01,083760,Briones; Jor-el Thomas Caparas,1,0,35,34
1656821254751,MATH 20C,A02,083761,Briones; Jor-el Thomas Caparas,8,0,35,27
1656821254751,MATH 20C,A03,093476,Briones; Jor-el Thomas Caparas,0,1,36,36
1656821254751,MATH 20C,B01,083762,Bach; Quang Tran,0,0,30,30
1656821260779,MATH 20D,A01,083765,Tran; Brian Kha,4,0,30,26
1656821260779,MATH 20D,A02,083766,Tran; Brian Kha,4,0,30,26
1656821260779,MATH 20D,A03,083767,Tran; Brian Kha,2,0,30,28
1656821266803,MATH 20E,A01,083771,Ganguly; Soumya,5,0,32,27
1656821266803,MATH 20E,A02,083772,Ganguly; Soumya,5,0,32,27
1656821266803,MATH 20E,B01,083773,Ciotti; Benjamin,18,0,35,17
1656821266803,MATH 20E,B02,083774,Ciotti; Benjamin,17,0,35,18
1656821272826,MATH 103A,A01,083777,Greenfeld; Be'Eri,2,0,36,34
1656821272826,MATH 103A,A02,083778,Greenfeld; Be'Eri,5,0,36,31
1656821272826,MATH 103A,A03,093561,Greenfeld; Be'Eri,4,0,36,32
1656821272826,MATH 103A,B01,083779,Greenfeld; Be'Eri,6,0,36,30
1656821272826,MATH 103A,B02,083780,Greenfeld; Be'Eri,2,0,36,34
1656821272826,MATH 103A,B03,093562,Greenfeld; Be'Eri,2,0,36,34
1656821278850,MATH 105,A01,085443,Carter; Anne Toulson,13,0,35,22
1656821278850,MATH 105,A02,093477,Carter; Anne Toulson,20,0,35,15
1656821284882,MATH 109,A01,083213,Ganzberger; Geoffrey Michael,2,0,34,32
1656821284882,MATH 109,A02,083214,Ganzberger; Geoffrey Michael,2,0,34,32
1656821284882,MATH 109,A03,093478,Ganzberger; Geoffrey Michael,1,0,34,33
1656821284882,MATH 109,B01,083215,Ganzberger; Geoffrey Michael,1,0,32,31
1656821284882,MATH 109,B02,083216,Ganzberger; Geoffrey Michael,1,0,32,31
1656821284882,MATH 109,B03,093479,Ganzberger; Geoffrey Michael,6,0,32,26
1656821290905,MATH 142A,A01,083219,Chow; Bennett,6,0,32,26
1656821290905,MATH 142A,A02,083220,Chow; Bennett,9,0,32,23
1656821290905,MATH 142A,A03,093480,Chow; Bennett,7,0,32,25
1656821290905,MATH 142A,B03,093481,Chow; Bennett,7,0,32,25
1656821290905,MATH 142A,B04,093558,Chow; Bennett,10,0,32,22
1656821290905,MATH 142A,B05,093559,Chow; Bennett,6,0,32,26
1656821296934,MATH 193A,A01,083224,Rotar; Vladimir,6,0,34,28
1656821296934,MATH 193A,A02,083225,Rotar; Vladimir,3,0,34,31
1656821296934,MATH 193A,A03,083781,Rotar; Vladimir,1,0,34,33
1656821296934,MATH 193A,A04,083782,Rotar; Vladimir,6,0,34,28
1656821296934,MATH 193A,A05,093482,Rotar; Vladimir,6,0,34,28
1656821302961,MATH 197,001,091859,McAuley; Julian John,9999,0,9999,0
1656821302961,MATH 197,002,095566,Kedlaya; Kiran S.,9997,0,9999,2
1656821302961,MATH 197,003,095567,Xiao; Ming,9999,0,9999,0
1656821302961,MATH 197,004,095571,Perols; Johan Lars,9998,0,9999,1
1656821310016,COGS 9,A01,083615,Shannon; Kyle Michael,6,0,75,69
1656821316038,COGS 11,A01,083617,Boyle; Mary E. T.,18,0,48,30
1656821322062,COGS 13,A01,083071,Bastos; Amalia Pinkusfeld,8,0,71,63
1656821328090,COGS 14A,A01,092681,Semenuks; Arturs,0,1,100,100
1656821334113,COGS 14B,A01,083073,Cheng; Tzu-Han,5,0,63,58
1656821340137,COGS 17,A01,092677,Semenuks; Arturs,4,0,81,77
1656821346164,COGS 100,A01,083619,Allen; Michael Gordon,15,0,70,55
1656821352190,COGS 101A,A01,083621,Davis; Joshua Daniel,9,0,68,59
1656821358214,COGS 101B,A01,091572,Allen; Michael Gordon,8,0,65,57
1656821364238,COGS 101C,A01,083625,Delgado; Tania,17,0,35,18
1656821370261,COGS 107A,A01,083627,Boyle; Mary E. T.,13,0,60,47
1656821376287,COGS 118A,A01,083075,Gupta; Anjum,15,0,76,61
1656821382321,CSE 3,A50,083646,Miranda; Gregory Joseph,22,0,50,28
1656821388349,CSE 8A,A50,083650,Miranda; Gregory Joseph,17,1,56,39
1656821394378,CSE 11,A01,083080,Cao; Yingjun,4,15,40,36
1656821400400,CSE 12,A01,083652,Krause-Levy; Sophia Louisa,20,1,120,100
1656821406435,CSE 15L,A01,083654,Morris; Justin Loren,8,0,50,42
1656821406435,CSE 15L,A02,083655,Morris; Justin Loren,8,0,50,42
1656821412459,CSE 20,A01,083657,Tran; Khoa Dang,37,0,80,43
1656821418483,CSE 21,A01,095574,Bach; Quang Tran,21,0,48,27
1656821424509,CSE 30,A01,083084,Eldon; John,4,0,80,76
1656821424509,CSE 30,B01,095061,Bhaskar; Nishant,6,0,50,44
1656821430534,CSE 100,A01,083659,Cao; Yingjun,1,4,70,69
1656821436558,CSE 134B,A01,083661,Powell; Thomas Allan,19,0,100,81
1656821442587,CSE 140,A01,083663,Gungor; Onat,14,0,85,71
1656821448614,CSE 140L,A01,083088,Eldon; John,16,0,100,84
1656821454638,CSE 175,A01,083665,Kumar; Rakesh,3,0,25,22
1656821460676,CSE 190,A00,092507,Dubnov; Shlomo,7,0,20,13
1656821466705,ECE 45,A01,083139,Congero; Spencer William,5,0,75,70
1656821472824,ECE 65,A50,083695,Saad; Andrew S,12,0,30,18
1656821472824,ECE 65,A51,095125,Saad; Andrew S,25,0,26,1
1656821478848,ECE 109,A01,091882,Touri; Behrouz,15,0,70,55
1656821484877,ECE 180,A00,083140,Abi Samra; Nicholas Camill,0,0,30,30
1656821484877,ECE 180,B00,083141,Abi Samra; Nicholas Camill,0,0,30,30
1656821490900,MATH 10A,A01,083735,Patchell; Gregory David,1,0,30,29
1656821490900,MATH 10A,A02,083736,Patchell; Gregory David,20,0,30,10
1656821490900,MATH 10A,A03,083737,Patchell; Gregory David,15,0,30,15
1656821496925,MATH 10B,A01,083207,Lim; Seonhee,7,0,34,27
1656821496925,MATH 10B,A02,083208,Lim; Seonhee,9,0,35,26
1656821496925,MATH 10B,A03,093472,Lim; Seonhee,4,0,34,30
1656821496925,MATH 10B,B01,083739,Sinha; Shubham,9,0,30,21
1656821502957,MATH 18,A01,083743,Cinel; Cameron Alexander,6,0,30,24
1656821502957,MATH 18,A02,083744,Cinel; Cameron Alexander,15,0,30,15
1656821502957,MATH 18,A03,083745,Cinel; Cameron Alexander,8,0,30,22
1656821502957,MATH 18,B01,083748,Rideout; David Porter,3,0,37,34
1656821502957,MATH 18,B02,083749,Rideout; David Porter,3,0,36,33
1656821502957,MATH 18,B03,083750,Rideout; David Porter,1,0,37,36
1656821502957,MATH 18,B04,083751,Rideout; David Porter,5,0,36,31
1656821502957,MATH 18,B05,093473,Rideout; David Porter,4,0,36,32
1656821502957,MATH 18,B06,093474,Rideout; David Porter,5,0,36,31
1656821508981,MATH 20A,A01,083754,Zheng; Zequn,12,0,40,28
1656821515008,MATH 20B,A01,083756,Briones; Jor-el Thomas Caparas,1,0,36,35
1656821515008,MATH 20B,A02,083757,Briones; Jor-el Thomas Caparas,1,0,36,35
1656821515008,MATH 20B,A03,093475,Briones; Jor-el Thomas Caparas,0,0,36,36
1656821521036,MATH 20C,A01,083760,Briones; Jor-el Thomas Caparas,1,0,35,34
1656821521036,MATH 20C,A02,083761,Briones; Jor-el Thomas Caparas,8,0,35,27
1656821521036,MATH 20C,A03,093476,Briones; Jor-el Thomas Caparas,0,1,36,36
1656821521036,MATH 20C,B01,083762,Bach; Quang Tran,0,0,30,30
1656821527061,MATH 20D,A01,083765,Tran; Brian Kha,4,0,30,26
1656821527061,MATH 20D,A02,083766,Tran; Brian Kha,4,0,30,26
1656821527061,MATH 20D,A03,083767,Tran; Brian Kha,2,0,30,28
1656821533084,MATH 20E,A01,083771,Ganguly; Soumya,5,0,32,27
1656821533084,MATH 20E,A02,083772,Ganguly; Soumya,5,0,32,27
1656821533084,MATH 20E,B01,083773,Ciotti; Benjamin,18,0,35,17
1656821533084,MATH 20E,B02,083774,Ciotti; Benjamin,17,0,35,18
1656821539109,MATH 103A,A01,083777,Greenfeld; Be'Eri,2,0,36,34
1656821539109,MATH 103A,A02,083778,Greenfeld; Be'Eri,5,0,36,31
1656821539109,MATH 103A,A03,093561,Greenfeld; Be'Eri,4,0,36,32
1656821539109,MATH 103A,B01,083779,Greenfeld; Be'Eri,6,0,36,30
1656821539109,MATH 103A,B02,083780,Greenfeld; Be'Eri,2,0,36,34
1656821539109,MATH 103A,B03,093562,Greenfeld; Be'Eri,2,0,36,34
1656821545135,MATH 105,A01,085443,Carter; Anne Toulson,13,0,35,22
1656821545135,MATH 105,A02,093477,Carter; Anne Toulson,20,0,35,15
1656821551167,MATH 109,A01,083213,Ganzberger; Geoffrey Michael,2,0,34,32
1656821551167,MATH 109,A02,083214,Ganzberger; Geoffrey Michael,2,0,34,32
1656821551167,MATH 109,A03,093478,Ganzberger; Geoffrey Michael,1,0,34,33
1656821551167,MATH 109,B01,083215,Ganzberger; Geoffrey Michael,1,0,32,31
1656821551167,MATH 109,B02,083216,Ganzberger; Geoffrey Michael,1,0,32,31
1656821551167,MATH 109,B03,093479,Ganzberger; Geoffrey Michael,6,0,32,26
1656821557211,MATH 142A,A01,083219,Chow; Bennett,6,0,32,26
1656821557211,MATH 142A,A02,083220,Chow; Bennett,9,0,32,23
1656821557211,MATH 142A,A03,093480,Chow; Bennett,7,0,32,25
1656821557211,MATH 142A,B03,093481,Chow; Bennett,7,0,32,25
1656821557211,MATH 142A,B04,093558,Chow; Bennett,10,0,32,22
1656821557211,MATH 142A,B05,093559,Chow; Bennett,6,0,32,26
1656821563240,MATH 193A,A01,083224,Rotar; Vladimir,6,0,34,28
1656821563240,MATH 193A,A02,083225,Rotar; Vladimir,3,0,34,31
1656821563240,MATH 193A,A03,083781,Rotar; Vladimir,1,0,34,33
1656821563240,MATH 193A,A04,083782,Rotar; Vladimir,6,0,34,28
1656821563240,MATH 193A,A05,093482,Rotar; Vladimir,6,0,34,28
1656821569263,MATH 197,001,091859,McAuley; Julian John,9999,0,9999,0
1656821569263,MATH 197,002,095566,Kedlaya; Kiran S.,9997,0,9999,2
1656821569263,MATH 197,003,095567,Xiao; Ming,9999,0,9999,0
1656821569263,MATH 197,004,095571,Perols; Johan Lars,9998,0,9999,1
1656821576321,COGS 9,A01,083615,Shannon; Kyle Michael,6,0,75,69
1656821582345,COGS 11,A01,083617,Boyle; Mary E. T.,18,0,48,30
1656821588371,COGS 13,A01,083071,Bastos; Amalia Pinkusfeld,8,0,71,63
1656821594401,COGS 14A,A01,092681,Semenuks; Arturs,0,1,100,100
1656821600428,COGS 14B,A01,083073,Cheng; Tzu-Han,5,0,63,58
1656821606458,COGS 17,A01,092677,Semenuks; Arturs,4,0,81,77
1656821612485,COGS 100,A01,083619,Allen; Michael Gordon,15,0,70,55
1656821618515,COGS 101A,A01,083621,Davis; Joshua Daniel,9,0,68,59
1656821624540,COGS 101B,A01,091572,Allen; Michael Gordon,8,0,65,57
1656821630569,COGS 101C,A01,083625,Delgado; Tania,17,0,35,18
1656821636593,COGS 107A,A01,083627,Boyle; Mary E. T.,13,0,60,47
1656821642621,COGS 118A,A01,083075,Gupta; Anjum,15,0,76,61
1656821648649,CSE 3,A50,083646,Miranda; Gregory Joseph,22,0,50,28
1656821654684,CSE 8A,A50,083650,Miranda; Gregory Joseph,17,1,56,39
1656821660713,CSE 11,A01,083080,Cao; Yingjun,4,15,40,36
1656821666737,CSE 12,A01,083652,Krause-Levy; Sophia Louisa,20,1,120,100
1656821672767,CSE 15L,A01,083654,Morris; Justin Loren,8,0,50,42
1656821672767,CSE 15L,A02,083655,Morris; Justin Loren,8,0,50,42
1656821678795,CSE 20,A01,083657,Tran; Khoa Dang,37,0,80,43
1656821684821,CSE 21,A01,095574,Bach; Quang Tran,21,0,48,27
1656821690856,CSE 30,A01,083084,Eldon; John,4,0,80,76
1656821690856,CSE 30,B01,095061,Bhaskar; Nishant,6,0,50,44
1656821696889,CSE 100,A01,083659,Cao; Yingjun,1,4,70,69
1656821702914,CSE 134B,A01,083661,Powell; Thomas Allan,19,0,100,81
1656821708938,CSE 140,A01,083663,Gungor; Onat,14,0,85,71
1656821714964,CSE 140L,A01,083088,Eldon; John,16,0,100,84
1656821720992,CSE 175,A01,083665,Kumar; Rakesh,3,0,25,22
1656821727020,CSE 190,A00,092507,Dubnov; Shlomo,7,0,20,13
1656821733047,ECE 45,A01,083139,Congero; Spencer William,5,0,75,70
1656821739085,ECE 65,A50,083695,Saad; Andrew S,12,0,30,18
1656821739085,ECE 65,A51,095125,Saad; Andrew S,25,0,26,1
1656821745110,ECE 109,A01,091882,Touri; Behrouz,15,0,70,55
1656821751143,ECE 180,A00,083140,Abi Samra; Nicholas Camill,0,0,30,30
1656821751143,ECE 180,B00,083141,Abi Samra; Nicholas Camill,0,0,30,30
1656821757179,MATH 10A,A01,083735,Patchell; Gregory David,1,0,30,29
1656821757179,MATH 10A,A02,083736,Patchell; Gregory David,20,0,30,10
1656821757179,MATH 10A,A03,083737,Patchell; Gregory David,15,0,30,15
1656821763208,MATH 10B,A01,083207,Lim; Seonhee,7,0,34,27
1656821763208,MATH 10B,A02,083208,Lim; Seonhee,9,0,35,26
1656821763208,MATH 10B,A03,093472,Lim; Seonhee,4,0,34,30
1656821763208,MATH 10B,B01,083739,Sinha; Shubham,9,0,30,21
1656821769238,MATH 18,A01,083743,Cinel; Cameron Alexander,6,0,30,24
1656821769238,MATH 18,A02,083744,Cinel; Cameron Alexander,15,0,30,15
1656821769238,MATH 18,A03,083745,Cinel; Cameron Alexander,8,0,30,22
1656821769238,MATH 18,B01,083748,Rideout; David Porter,3,0,37,34
1656821769238,MATH 18,B02,083749,Rideout; David Porter,3,0,36,33
1656821769238,MATH 18,B03,083750,Rideout; David Porter,1,0,37,36
1656821769238,MATH 18,B04,083751,Rideout; David Porter,5,0,36,31
1656821769238,MATH 18,B05,093473,Rideout; David Porter,4,0,36,32
1656821769238,MATH 18,B06,093474,Rideout; David Porter,5,0,36,31
1656821775264,MATH 20A,A01,083754,Zheng; Zequn,12,0,40,28
1656821781294,MATH 20B,A01,083756,Briones; Jor-el Thomas Caparas,1,0,36,35
1656821781294,MATH 20B,A02,083757,Briones; Jor-el Thomas Caparas,1,0,36,35
1656821781294,MATH 20B,A03,093475,Briones; Jor-el Thomas Caparas,0,0,36,36
1656821787319,MATH 20C,A01,083760,Briones; Jor-el Thomas Caparas,1,0,35,34
1656821787319,MATH 20C,A02,083761,Briones; Jor-el Thomas Caparas,8,0,35,27
1656821787319,MATH 20C,A03,093476,Briones; Jor-el Thomas Caparas,0,1,36,36
1656821787319,MATH 20C,B01,083762,Bach; Quang Tran,0,0,30,30
1656821793348,MATH 20D,A01,083765,Tran; Brian Kha,4,0,30,26
1656821793348,MATH 20D,A02,083766,Tran; Brian Kha,4,0,30,26
1656821793348,MATH 20D,A03,083767,Tran; Brian Kha,2,0,30,28
1656821799376,MATH 20E,A01,083771,Ganguly; Soumya,5,0,32,27
1656821799376,MATH 20E,A02,083772,Ganguly; Soumya,5,0,32,27
1656821799376,MATH 20E,B01,083773,Ciotti; Benjamin,18,0,35,17
1656821799376,MATH 20E,B02,083774,Ciotti; Benjamin,17,0,35,18
1656821805402,MATH 103A,A01,083777,Greenfeld; Be'Eri,2,0,36,34
1656821805402,MATH 103A,A02,083778,Greenfeld; Be'Eri,5,0,36,31
1656821805402,MATH 103A,A03,093561,Greenfeld; Be'Eri,4,0,36,32
1656821805402,MATH 103A,B01,083779,Greenfeld; Be'Eri,6,0,36,30
1656821805402,MATH 103A,B02,083780,Greenfeld; Be'Eri,2,0,36,34
1656821805402,MATH 103A,B03,093562,Greenfeld; Be'Eri,2,0,36,34
1656821811448,MATH 105,A01,085443,Carter; Anne Toulson,13,0,35,22
1656821811448,MATH 105,A02,093477,Carter; Anne Toulson,20,0,35,15
1656821817473,MATH 109,A01,083213,Ganzberger; Geoffrey Michael,2,0,34,32
1656821817473,MATH 109,A02,083214,Ganzberger; Geoffrey Michael,2,0,34,32
1656821817473,MATH 109,A03,093478,Ganzberger; Geoffrey Michael,1,0,34,33
1656821817473,MATH 109,B01,083215,Ganzberger; Geoffrey Michael,1,0,32,31
1656821817473,MATH 109,B02,083216,Ganzberger; Geoffrey Michael,1,0,32,31
1656821817473,MATH 109,B03,093479,Ganzberger; Geoffrey Michael,6,0,32,26
1656821823505,MATH 142A,A01,083219,Chow; Bennett,6,0,32,26
1656821823505,MATH 142A,A02,083220,Chow; Bennett,9,0,32,23
1656821823505,MATH 142A,A03,093480,Chow; Bennett,7,0,32,25
1656821823505,MATH 142A,B03,093481,Chow; Bennett,7,0,32,25
1656821823505,MATH 142A,B04,093558,Chow; Bennett,10,0,32,22
1656821823505,MATH 142A,B05,093559,Chow; Bennett,6,0,32,26
1656821829530,MATH 193A,A01,083224,Rotar; Vladimir,6,0,34,28
1656821829530,MATH 193A,A02,083225,Rotar; Vladimir,3,0,34,31
1656821829530,MATH 193A,A03,083781,Rotar; Vladimir,1,0,34,33
1656821829530,MATH 193A,A04,083782,Rotar; Vladimir,6,0,34,28
1656821829530,MATH 193A,A05,093482,Rotar; Vladimir,6,0,34,28
1656821835556,MATH 197,001,091859,McAuley; Julian John,9999,0,9999,0
1656821835556,MATH 197,002,095566,Kedlaya; Kiran S.,9997,0,9999,2
1656821835556,MATH 197,003,095567,Xiao; Ming,9999,0,9999,0
1656821835556,MATH 197,004,095571,Perols; Johan Lars,9998,0,9999,1
1656821842636,COGS 9,A01,083615,Shannon; Kyle Michael,6,0,75,69
1656821848664,COGS 11,A01,083617,Boyle; Mary E. T.,18,0,48,30
1656821854693,COGS 13,A01,083071,Bastos; Amalia Pinkusfeld,8,0,71,63
1656821860719,COGS 14A,A01,092681,Semenuks; Arturs,0,1,100,100
1656821866743,COGS 14B,A01,083073,Cheng; Tzu-Han,5,0,63,58
1656821872766,COGS 17,A01,092677,Semenuks; Arturs,4,0,81,77
1656821878789,COGS 100,A01,083619,Allen; Michael Gordon,15,0,70,55
1656821884813,COGS 101A,A01,083621,Davis; Joshua Daniel,9,0,68,59
1656821890836,COGS 101B,A01,091572,Allen; Michael Gordon,8,0,65,57
1656821896864,COGS 101C,A01,083625,Delgado; Tania,17,0,35,18
1656821902889,COGS 107A,A01,083627,Boyle; Mary E. T.,13,0,60,47
1656821908913,COGS 118A,A01,083075,Gupta; Anjum,15,0,76,61
1656821914944,CSE 3,A50,083646,Miranda; Gregory Joseph,22,0,50,28
1656821920967,CSE 8A,A50,083650,Miranda; Gregory Joseph,17,1,56,39
1656821926990,CSE 11,A01,083080,Cao; Yingjun,4,15,40,36
1656821933020,CSE 12,A01,083652,Krause-Levy; Sophia Louisa,20,1,120,100
1656821939044,CSE 15L,A01,083654,Morris; Justin Loren,8,0,50,42
1656821939044,CSE 15L,A02,083655,Morris; Justin Loren,8,0,50,42
1656821945079,CSE 20,A01,083657,Tran; Khoa Dang,37,0,80,43
1656821951103,CSE 21,A01,095574,Bach; Quang Tran,21,0,48,27
1656821957127,CSE 30,A01,083084,Eldon; John,4,0,80,76
1656821957127,CSE 30,B01,095061,Bhaskar; Nishant,6,0,50,44
1656821963152,CSE 100,A01,083659,Cao; Yingjun,1,4,70,69
1656821969175,CSE 134B,A01,083661,Powell; Thomas Allan,19,0,100,81
1656821975200,CSE 140,A01,083663,Gungor; Onat,14,0,85,71
1656821981224,CSE 140L,A01,083088,Eldon; John,16,0,100,84
1656821987247,CSE 175,A01,083665,Kumar; Rakesh,3,0,25,22
1656821993270,CSE 190,A00,092507,Dubnov; Shlomo,7,0,20,13
1656821999298,ECE 45,A01,083139,Congero; Spencer William,5,0,75,70
1656822005320,ECE 65,A50,083695,Saad; Andrew S,12,0,30,18
1656822005320,ECE 65,A51,095125,Saad; Andrew S,25,0,26,1
1656822011349,ECE 109,A01,091882,Touri; Behrouz,15,0,70,55
1656822017376,ECE 180,A00,083140,Abi Samra; Nicholas Camill,0,0,30,30
1656822017376,ECE 180,B00,083141,Abi Samra; Nicholas Camill,0,0,30,30
1656822023401,MATH 10A,A01,083735,Patchell; Gregory David,1,0,30,29
1656822023401,MATH 10A,A02,083736,Patchell; Gregory David,20,0,30,10
1656822023401,MATH 10A,A03,083737,Patchell; Gregory David,15,0,30,15
1656822029426,MATH 10B,A01,083207,Lim; Seonhee,7,0,34,27
1656822029426,MATH 10B,A02,083208,Lim; Seonhee,9,0,35,26
1656822029426,MATH 10B,A03,093472,Lim; Seonhee,4,0,34,30
1656822029426,MATH 10B,B01,083739,Sinha; Shubham,9,0,30,21
1656822035452,MATH 18,A01,083743,Cinel; Cameron Alexander,6,0,30,24
1656822035452,MATH 18,A02,083744,Cinel; Cameron Alexander,15,0,30,15
1656822035452,MATH 18,A03,083745,Cinel; Cameron Alexander,8,0,30,22
1656822035452,MATH 18,B01,083748,Rideout; David Porter,3,0,37,34
1656822035452,MATH 18,B02,083749,Rideout; David Porter,3,0,36,33
1656822035452,MATH 18,B03,083750,Rideout; David Porter,1,0,37,36
1656822035452,MATH 18,B04,083751,Rideout; David Porter,5,0,36,31
1656822035452,MATH 18,B05,093473,Rideout; David Porter,4,0,36,32
1656822035452,MATH 18,B06,093474,Rideout; David Porter,5,0,36,31
1656822041477,MATH 20A,A01,083754,Zheng; Zequn,12,0,40,28
1656822047504,MATH 20B,A01,083756,Briones; Jor-el Thomas Caparas,1,0,36,35
1656822047504,MATH 20B,A02,083757,Briones; Jor-el Thomas Caparas,1,0,36,35
1656822047504,MATH 20B,A03,093475,Briones; Jor-el Thomas Caparas,0,0,36,36
1656822053530,MATH 20C,A01,083760,Briones; Jor-el Thomas Caparas,1,0,35,34
1656822053530,MATH 20C,A02,083761,Briones; Jor-el Thomas Caparas,8,0,35,27
1656822053530,MATH 20C,A03,093476,Briones; Jor-el Thomas Caparas,0,1,36,36
1656822053530,MATH 20C,B01,083762,Bach; Quang Tran,0,0,30,30
1656822059555,MATH 20D,A01,083765,Tran; Brian Kha,4,0,30,26
1656822059555,MATH 20D,A02,083766,Tran; Brian Kha,4,0,30,26
1656822059555,MATH 20D,A03,083767,Tran; Brian Kha,2,0,30,28
1656822065589,MATH 20E,A01,083771,Ganguly; Soumya,5,0,32,27
1656822065589,MATH 20E,A02,083772,Ganguly; Soumya,5,0,32,27
1656822065589,MATH 20E,B01,083773,Ciotti; Benjamin,18,0,35,17
1656822065589,MATH 20E,B02,083774,Ciotti; Benjamin,17,0,35,18
1656822071713,MATH 103A,A01,083777,Greenfeld; Be'Eri,2,0,36,34
1656822071713,MATH 103A,A02,083778,Greenfeld; Be'Eri,5,0,36,31
1656822071713,MATH 103A,A03,093561,Greenfeld; Be'Eri,4,0,36,32
1656822071713,MATH 103A,B01,083779,Greenfeld; Be'Eri,6,0,36,30
1656822071713,MATH 103A,B02,083780,Greenfeld; Be'Eri,2,0,36,34
1656822071713,MATH 103A,B03,093562,Greenfeld; Be'Eri,2,0,36,34
1656822077741,MATH 105,A01,085443,Carter; Anne Toulson,13,0,35,22
1656822077741,MATH 105,A02,093477,Carter; Anne Toulson,20,0,35,15
1656822083770,MATH 109,A01,083213,Ganzberger; Geoffrey Michael,2,0,34,32
1656822083770,MATH 109,A02,083214,Ganzberger; Geoffrey Michael,2,0,34,32
1656822083770,MATH 109,A03,093478,Ganzberger; Geoffrey Michael,1,0,34,33
1656822083770,MATH 109,B01,083215,Ganzberger; Geoffrey Michael,1,0,32,31
1656822083770,MATH 109,B02,083216,Ganzberger; Geoffrey Michael,1,0,32,31
1656822083770,MATH 109,B03,093479,Ganzberger; Geoffrey Michael,6,0,32,26
1656822089793,MATH 142A,A01,083219,Chow; Bennett,6,0,32,26
1656822089793,MATH 142A,A02,083220,Chow; Bennett,9,0,32,23
1656822089793,MATH 142A,A03,093480,Chow; Bennett,7,0,32,25
1656822089793,MATH 142A,B03,093481,Chow; Bennett,7,0,32,25
1656822089793,MATH 142A,B04,093558,Chow; Bennett,10,0,32,22
1656822089793,MATH 142A,B05,093559,Chow; Bennett,6,0,32,26
1656822095816,MATH 193A,A01,083224,Rotar; Vladimir,6,0,34,28
1656822095816,MATH 193A,A02,083225,Rotar; Vladimir,3,0,34,31
1656822095816,MATH 193A,A03,083781,Rotar; Vladimir,1,0,34,33
1656822095816,MATH 193A,A04,083782,Rotar; Vladimir,6,0,34,28
1656822095816,MATH 193A,A05,093482,Rotar; Vladimir,6,0,34,28
1656822101845,MATH 197,001,091859,McAuley; Julian John,9999,0,9999,0
1656822101845,MATH 197,002,095566,Kedlaya; Kiran S.,9997,0,9999,2
1656822101845,MATH 197,003,095567,Xiao; Ming,9999,0,9999,0
1656822101845,MATH 197,004,095571,Perols; Johan Lars,9998,0,9999,1
1656822108923,COGS 9,A01,083615,Shannon; Kyle Michael,6,0,75,69
1656822114949,COGS 11,A01,083617,Boyle; Mary E. T.,18,0,48,30
1656822120977,COGS 13,A01,083071,Bastos; Amalia Pinkusfeld,8,0,71,63
1656822127005,COGS 14A,A01,092681,Semenuks; Arturs,0,1,100,100
1656822133029,COGS 14B,A01,083073,Cheng; Tzu-Han,5,0,63,58
1656822139062,COGS 17,A01,092677,Semenuks; Arturs,4,0,81,77
1656822145087,COGS 100,A01,083619,Allen; Michael Gordon,15,0,70,55
1656822151112,COGS 101A,A01,083621,Davis; Joshua Daniel,9,0,68,59
1656822157140,COGS 101B,A01,091572,Allen; Michael Gordon,8,0,65,57
1656822163163,COGS 101C,A01,083625,Delgado; Tania,17,0,35,18
1656822169192,COGS 107A,A01,083627,Boyle; Mary E. T.,13,0,60,47
1656822175219,COGS 118A,A01,083075,Gupta; Anjum,15,0,76,61
1656822181243,CSE 3,A50,083646,Miranda; Gregory Joseph,22,0,50,28
1656822187269,CSE 8A,A50,083650,Miranda; Gregory Joseph,17,1,56,39
1656822193300,CSE 11,A01,083080,Cao; Yingjun,4,15,40,36
1656822199322,CSE 12,A01,083652,Krause-Levy; Sophia Louisa,20,1,120,100
1656822205349,CSE 15L,A01,083654,Morris; Justin Loren,8,0,50,42
1656822205349,CSE 15L,A02,083655,Morris; Justin Loren,8,0,50,42
1656822211374,CSE 20,A01,083657,Tran; Khoa Dang,37,0,80,43
1656822217397,CSE 21,A01,095574,Bach; Quang Tran,21,0,48,27
1656822223432,CSE 30,A01,083084,Eldon; John,4,0,80,76
1656822223432,CSE 30,B01,095061,Bhaskar; Nishant,6,0,50,44
1656822229455,CSE 100,A01,083659,Cao; Yingjun,1,4,70,69
1656822235479,CSE 134B,A01,083661,Powell; Thomas Allan,19,0,100,81
1656822241506,CSE 140,A01,083663,Gungor; Onat,14,0,85,71
1656822247538,CSE 140L,A01,083088,Eldon; John,16,0,100,84
1656822253571,CSE 175,A01,083665,Kumar; Rakesh,3,0,25,22
1656822259594,CSE 190,A00,092507,Dubnov; Shlomo,7,0,20,13
1656822265620,ECE 45,A01,083139,Congero; Spencer William,5,0,75,70
1656822271647,ECE 65,A50,083695,Saad; Andrew S,12,0,30,18
1656822271647,ECE 65,A51,095125,Saad; Andrew S,25,0,26,1
1656822277673,ECE 109,A01,091882,Touri; Behrouz,15,0,70,55
1656822283700,ECE 180,A00,083140,Abi Samra; Nicholas Camill,0,0,30,30
1656822283700,ECE 180,B00,083141,Abi Samra; Nicholas Camill,0,0,30,30
1656822289727,MATH 10A,A01,083735,Patchell; Gregory David,1,0,30,29
1656822289727,MATH 10A,A02,083736,Patchell; Gregory David,20,0,30,10
1656822289727,MATH 10A,A03,083737,Patchell; Gregory David,15,0,30,15
1656822295750,MATH 10B,A01,083207,Lim; Seonhee,7,0,34,27
1656822295750,MATH 10B,A02,083208,Lim; Seonhee,9,0,35,26
1656822295750,MATH 10B,A03,093472,Lim; Seonhee,4,0,34,30
1656822295750,MATH 10B,B01,083739,Sinha; Shubham,9,0,30,21
1656822301774,MATH 18,A01,083743,Cinel; Cameron Alexander,6,0,30,24
1656822301774,MATH 18,A02,083744,Cinel; Cameron Alexander,15,0,30,15
1656822301774,MATH 18,A03,083745,Cinel; Cameron Alexander,8,0,30,22
1656822301774,MATH 18,B01,083748,Rideout; David Porter,3,0,37,34
1656822301774,MATH 18,B02,083749,Rideout; David Porter,3,0,36,33
1656822301774,MATH 18,B03,083750,Rideout; David Porter,1,0,37,36
1656822301774,MATH 18,B04,083751,Rideout; David Porter,5,0,36,31
1656822301774,MATH 18,B05,093473,Rideout; David Porter,4,0,36,32
1656822301774,MATH 18,B06,093474,Rideout; David Porter,5,0,36,31
1656822307796,MATH 20A,A01,083754,Zheng; Zequn,12,0,40,28
1656822313818,MATH 20B,A01,083756,Briones; Jor-el Thomas Caparas,1,0,36,35
1656822313818,MATH 20B,A02,083757,Briones; Jor-el Thomas Caparas,1,0,36,35
1656822313818,MATH 20B,A03,093475,Briones; Jor-el Thomas Caparas,0,0,36,36
1656822319849,MATH 20C,A01,083760,Briones; Jor-el Thomas Caparas,1,0,35,34
1656822319849,MATH 20C,A02,083761,Briones; Jor-el Thomas Caparas,8,0,35,27
1656822319849,MATH 20C,A03,093476,Briones; Jor-el Thomas Caparas,0,1,36,36
1656822319849,MATH 20C,B01,083762,Bach; Quang Tran,0,0,30,30
1656822325873,MATH 20D,A01,083765,Tran; Brian Kha,4,0,30,26
1656822325873,MATH 20D,A02,083766,Tran; Brian Kha,4,0,30,26
1656822325873,MATH 20D,A03,083767,Tran; Brian Kha,2,0,30,28
1656822331897,MATH 20E,A01,083771,Ganguly; Soumya,5,0,32,27
1656822331897,MATH 20E,A02,083772,Ganguly; Soumya,5,0,32,27
1656822331897,MATH 20E,B01,083773,Ciotti; Benjamin,18,0,35,17
1656822331897,MATH 20E,B02,083774,Ciotti; Benjamin,17,0,35,18
1656822337926,MATH 103A,A01,083777,Greenfeld; Be'Eri,2,0,36,34
1656822337926,MATH 103A,A02,083778,Greenfeld; Be'Eri,5,0,36,31
1656822337926,MATH 103A,A03,093561,Greenfeld; Be'Eri,4,0,36,32
1656822337926,MATH 103A,B01,083779,Greenfeld; Be'Eri,6,0,36,30
1656822337926,MATH 103A,B02,083780,Greenfeld; Be'Eri,2,0,36,34
1656822337926,MATH 103A,B03,093562,Greenfeld; Be'Eri,2,0,36,34
1656822343954,MATH 105,A01,085443,Carter; Anne Toulson,13,0,35,22
1656822343954,MATH 105,A02,093477,Carter; Anne Toulson,20,0,35,15
1656822349978,MATH 109,A01,083213,Ganzberger; Geoffrey Michael,2,0,34,32
1656822349978,MATH 109,A02,083214,Ganzberger; Geoffrey Michael,2,0,34,32
1656822349978,MATH 109,A03,093478,Ganzberger; Geoffrey Michael,1,0,34,33
1656822349978,MATH 109,B01,083215,Ganzberger; Geoffrey Michael,1,0,32,31
1656822349978,MATH 109,B02,083216,Ganzberger; Geoffrey Michael,1,0,32,31
1656822349978,MATH 109,B03,093479,Ganzberger; Geoffrey Michael,6,0,32,26
1656822356002,MATH 142A,A01,083219,Chow; Bennett,6,0,32,26
1656822356002,MATH 142A,A02,083220,Chow; Bennett,9,0,32,23
1656822356002,MATH 142A,A03,093480,Chow; Bennett,7,0,32,25
1656822356002,MATH 142A,B03,093481,Chow; Bennett,7,0,32,25
1656822356002,MATH 142A,B04,093558,Chow; Bennett,10,0,32,22
1656822356002,MATH 142A,B05,093559,Chow; Bennett,6,0,32,26
1656822362027,MATH 193A,A01,083224,Rotar; Vladimir,6,0,34,28
1656822362027,MATH 193A,A02,083225,Rotar; Vladimir,3,0,34,31
1656822362027,MATH 193A,A03,083781,Rotar; Vladimir,1,0,34,33
1656822362027,MATH 193A,A04,083782,Rotar; Vladimir,6,0,34,28
1656822362027,MATH 193A,A05,093482,Rotar; Vladimir,6,0,34,28
1656822368049,MATH 197,001,091859,McAuley; Julian John,9999,0,9999,0
1656822368049,MATH 197,002,095566,Kedlaya; Kiran S.,9997,0,9999,2
1656822368049,MATH 197,003,095567,Xiao; Ming,9999,0,9999,0
1656822368049,MATH 197,004,095571,Perols; Johan Lars,9998,0,9999,1
1656822375102,COGS 9,A01,083615,Shannon; Kyle Michael,6,0,75,69
1656822381127,COGS 11,A01,083617,Boyle; Mary E. T.,18,0,48,30
1656822387153,COGS 13,A01,083071,Bastos; Amalia Pinkusfeld,8,0,71,63
1656822393186,COGS 14A,A01,092681,Semenuks; Arturs,0,1,100,100
1656822399213,COGS 14B,A01,083073,Cheng; Tzu-Han,5,0,63,58
1656822405239,COGS 17,A01,092677,Semenuks; Arturs,4,0,81,77
1656822411264,COGS 100,A01,083619,Allen; Michael Gordon,15,0,70,55
1656822417288,COGS 101A,A01,083621,Davis; Joshua Daniel,9,0,68,59
1656822423309,COGS 101B,A01,091572,Allen; Michael Gordon,8,0,65,57
1656822429333,COGS 101C,A01,083625,Delgado; Tania,17,0,35,18
1656822435357,COGS 107A,A01,083627,Boyle; Mary E. T.,13,0,60,47
1656822441380,COGS 118A,A01,083075,Gupta; Anjum,15,0,76,61
1656822447410,CSE 3,A50,083646,Miranda; Gregory Joseph,22,0,50,28
1656822453435,CSE 8A,A50,083650,Miranda; Gregory Joseph,17,1,56,39
1656822459461,CSE 11,A01,083080,Cao; Yingjun,4,15,40,36
1656822465498,CSE 12,A01,083652,Krause-Levy; Sophia Louisa,20,1,120,100
1656822471526,CSE 15L,A01,083654,Morris; Justin Loren,8,0,50,42
1656822471526,CSE 15L,A02,083655,Morris; Justin Loren,8,0,50,42
1656822477550,CSE 20,A01,083657,Tran; Khoa Dang,37,0,80,43
1656822483572,CSE 21,A01,095574,Bach; Quang Tran,21,0,48,27
1656822489601,CSE 30,A01,083084,Eldon; John,4,0,80,76
1656822489601,CSE 30,B01,095061,Bhaskar; Nishant,6,0,50,44
1656822495624,CSE 100,A01,083659,Cao; Yingjun,1,4,70,69
1656822501652,CSE 134B,A01,083661,Powell; Thomas Allan,19,0,100,81
1656822507674,CSE 140,A01,083663,Gungor; Onat,14,0,85,71
1656822513701,CSE 140L,A01,083088,Eldon; John,16,0,100,84
1656822519730,CSE 175,A01,083665,Kumar; Rakesh,3,0,25,22
1656822525753,CSE 190,A00,092507,Dubnov; Shlomo,7,0,20,13
1656822531775,ECE 45,A01,083139,Congero; Spencer William,5,0,75,70
1656822537807,ECE 65,A50,083695,Saad; Andrew S,12,0,30,18
1656822537807,ECE 65,A51,095125,Saad; Andrew S,25,0,26,1
1656822543831,ECE 109,A01,091882,Touri; Behrouz,15,0,70,55
1656822549854,ECE 180,A00,083140,Abi Samra; Nicholas Camill,0,0,30,30
1656822549854,ECE 180,B00,083141,Abi Samra; Nicholas Camill,0,0,30,30
1656822555885,MATH 10A,A01,083735,Patchell; Gregory David,1,0,30,29
1656822555885,MATH 10A,A02,083736,Patchell; Gregory David,20,0,30,10
1656822555885,MATH 10A,A03,083737,Patchell; Gregory David,15,0,30,15
1656822561915,MATH 10B,A01,083207,Lim; Seonhee,7,0,34,27
1656822561915,MATH 10B,A02,083208,Lim; Seonhee,9,0,35,26
1656822561915,MATH 10B,A03,093472,Lim; Seonhee,4,0,34,30
1656822561915,MATH 10B,B01,083739,Sinha; Shubham,9,0,30,21
1656822567944,MATH 18,A01,083743,Cinel; Cameron Alexander,6,0,30,24
1656822567944,MATH 18,A02,083744,Cinel; Cameron Alexander,15,0,30,15
1656822567944,MATH 18,A03,083745,Cinel; Cameron Alexander,8,0,30,22
1656822567944,MATH 18,B01,083748,Rideout; David Porter,3,0,37,34
1656822567944,MATH 18,B02,083749,Rideout; David Porter,3,0,36,33
1656822567944,MATH 18,B03,083750,Rideout; David Porter,1,0,37,36
1656822567944,MATH 18,B04,083751,Rideout; David Porter,5,0,36,31
1656822567944,MATH 18,B05,093473,Rideout; David Porter,4,0,36,32
1656822567944,MATH 18,B06,093474,Rideout; David Porter,5,0,36,31
1656822573968,MATH 20A,A01,083754,Zheng; Zequn,12,0,40,28
1656822580014,MATH 20B,A01,083756,Briones; Jor-el Thomas Caparas,1,0,36,35
1656822580014,MATH 20B,A02,083757,Briones; Jor-el Thomas Caparas,1,0,36,35
1656822580014,MATH 20B,A03,093475,Briones; Jor-el Thomas Caparas,0,0,36,36
1656822586043,MATH 20C,A01,083760,Briones; Jor-el Thomas Caparas,1,0,35,34
1656822586043,MATH 20C,A02,083761,Briones; Jor-el Thomas Caparas,8,0,35,27
1656822586043,MATH 20C,A03,093476,Briones; Jor-el Thomas Caparas,0,1,36,36
1656822586043,MATH 20C,B01,083762,Bach; Quang Tran,0,0,30,30
1656822592066,MATH 20D,A01,083765,Tran; Brian Kha,4,0,30,26
1656822592066,MATH 20D,A02,083766,Tran; Brian Kha,4,0,30,26
1656822592066,MATH 20D,A03,083767,Tran; Brian Kha,2,0,30,28
1656822598091,MATH 20E,A01,083771,Ganguly; Soumya,5,0,32,27
1656822598091,MATH 20E,A02,083772,Ganguly; Soumya,5,0,32,27
1656822598091,MATH 20E,B01,083773,Ciotti; Benjamin,18,0,35,17
1656822598091,MATH 20E,B02,083774,Ciotti; Benjamin,17,0,35,18
1656822604114,MATH 103A,A01,083777,Greenfeld; Be'Eri,2,0,36,34
1656822604114,MATH 103A,A02,083778,Greenfeld; Be'Eri,5,0,36,31
1656822604114,MATH 103A,A03,093561,Greenfeld; Be'Eri,4,0,36,32
1656822604114,MATH 103A,B01,083779,Greenfeld; Be'Eri,6,0,36,30
1656822604114,MATH 103A,B02,083780,Greenfeld; Be'Eri,2,0,36,34
1656822604114,MATH 103A,B03,093562,Greenfeld; Be'Eri,2,0,36,34
1656822610141,MATH 105,A01,085443,Carter; Anne Toulson,13,0,35,22
1656822610141,MATH 105,A02,093477,Carter; Anne Toulson,20,0,35,15
1656822616164,MATH 109,A01,083213,Ganzberger; Geoffrey Michael,2,0,34,32
1656822616164,MATH 109,A02,083214,Ganzberger; Geoffrey Michael,2,0,34,32
1656822616164,MATH 109,A03,093478,Ganzberger; Geoffrey Michael,1,0,34,33
1656822616164,MATH 109,B01,083215,Ganzberger; Geoffrey Michael,1,0,32,31
1656822616164,MATH 109,B02,083216,Ganzberger; Geoffrey Michael,1,0,32,31
1656822616164,MATH 109,B03,093479,Ganzberger; Geoffrey Michael,6,0,32,26
1656822622188,MATH 142A,A01,083219,Chow; Bennett,6,0,32,26
1656822622188,MATH 142A,A02,083220,Chow; Bennett,9,0,32,23
1656822622188,MATH 142A,A03,093480,Chow; Bennett,7,0,32,25
1656822622188,MATH 142A,B03,093481,Chow; Bennett,7,0,32,25
1656822622188,MATH 142A,B04,093558,Chow; Bennett,10,0,32,22
1656822622188,MATH 142A,B05,093559,Chow; Bennett,6,0,32,26
1656822628213,MATH 193A,A01,083224,Rotar; Vladimir,6,0,34,28
1656822628213,MATH 193A,A02,083225,Rotar; Vladimir,3,0,34,31
1656822628213,MATH 193A,A03,083781,Rotar; Vladimir,1,0,34,33
1656822628213,MATH 193A,A04,083782,Rotar; Vladimir,6,0,34,28
1656822628213,MATH 193A,A05,093482,Rotar; Vladimir,6,0,34,28
1656822634241,MATH 197,001,091859,McAuley; Julian John,9999,0,9999,0
1656822634241,MATH 197,002,095566,Kedlaya; Kiran S.,9997,0,9999,2
1656822634241,MATH 197,003,095567,Xiao; Ming,9999,0,9999,0
1656822634241,MATH 197,004,095571,Perols; Johan Lars,9998,0,9999,1
1656822641310,COGS 9,A01,083615,Shannon; Kyle Michael,6,0,75,69
1656822647337,COGS 11,A01,083617,Boyle; Mary E. T.,18,0,48,30
1656822653363,COGS 13,A01,083071,Bastos; Amalia Pinkusfeld,8,0,71,63
1656822659391,COGS 14A,A01,092681,Semenuks; Arturs,0,1,100,100
1656822665514,COGS 14B,A01,083073,Cheng; Tzu-Han,5,0,63,58
1656822671538,COGS 17,A01,092677,Semenuks; Arturs,4,0,81,77
1656822677567,COGS 100,A01,083619,Allen; Michael Gordon,15,0,70,55
1656822683592,COGS 101A,A01,083621,Davis; Joshua Daniel,9,0,68,59
1656822689625,COGS 101B,A01,091572,Allen; Michael Gordon,8,0,65,57
1656822695656,COGS 101C,A01,083625,Delgado; Tania,17,0,35,18
1656822701684,COGS 107A,A01,083627,Boyle; Mary E. T.,13,0,60,47
1656822707713,COGS 118A,A01,083075,Gupta; Anjum,15,0,76,61
1656822713737,CSE 3,A50,083646,Miranda; Gregory Joseph,22,0,50,28
1656822719768,CSE 8A,A50,083650,Miranda; Gregory Joseph,17,1,56,39
1656822725795,CSE 11,A01,083080,Cao; Yingjun,4,15,40,36
1656822731829,CSE 12,A01,083652,Krause-Levy; Sophia Louisa,20,1,120,100
1656822737851,CSE 15L,A01,083654,Morris; Justin Loren,8,0,50,42
1656822737851,CSE 15L,A02,083655,Morris; Justin Loren,8,0,50,42
1656822743880,CSE 20,A01,083657,Tran; Khoa Dang,37,0,80,43
1656822749911,CSE 21,A01,095574,Bach; Quang Tran,21,0,48,27
1656822755935,CSE 30,A01,083084,Eldon; John,4,0,80,76
1656822755935,CSE 30,B01,095061,Bhaskar; Nishant,6,0,50,44
1656822761962,CSE 100,A01,083659,Cao; Yingjun,1,4,70,69
1656822767990,CSE 134B,A01,083661,Powell; Thomas Allan,19,0,100,81
1656822774027,CSE 140,A01,083663,Gungor; Onat,14,0,85,71
1656822780049,CSE 140L,A01,083088,Eldon; John,16,0,100,84
1656822786076,CSE 175,A01,083665,Kumar; Rakesh,3,0,25,22
1656822792104,CSE 190,A00,092507,Dubnov; Shlomo,7,0,20,13
1656822798127,ECE 45,A01,083139,Congero; Spencer William,5,0,75,70
1656822804151,ECE 65,A50,083695,Saad; Andrew S,12,0,30,18
1656822804151,ECE 65,A51,095125,Saad; Andrew S,25,0,26,1
1656822810175,ECE 109,A01,091882,Touri; Behrouz,15,0,70,55
1656822816202,ECE 180,A00,083140,Abi Samra; Nicholas Camill,0,0,30,30
1656822816202,ECE 180,B00,083141,Abi Samra; Nicholas Camill,0,0,30,30
1656822822226,MATH 10A,A01,083735,Patchell; Gregory David,1,0,30,29
1656822822226,MATH 10A,A02,083736,Patchell; Gregory David,20,0,30,10
1656822822226,MATH 10A,A03,083737,Patchell; Gregory David,15,0,30,15
1656822828255,MATH 10B,A01,083207,Lim; Seonhee,7,0,34,27
1656822828255,MATH 10B,A02,083208,Lim; Seonhee,9,0,35,26
1656822828255,MATH 10B,A03,093472,Lim; Seonhee,4,0,34,30
1656822828255,MATH 10B,B01,083739,Sinha; Shubham,9,0,30,21
1656822834280,MATH 18,A01,083743,Cinel; Cameron Alexander,6,0,30,24
1656822834280,MATH 18,A02,083744,Cinel; Cameron Alexander,15,0,30,15
1656822834280,MATH 18,A03,083745,Cinel; Cameron Alexander,8,0,30,22
1656822834280,MATH 18,B01,083748,Rideout; David Porter,3,0,37,34
1656822834280,MATH 18,B02,083749,Rideout; David Porter,3,0,36,33
1656822834280,MATH 18,B03,083750,Rideout; David Porter,1,0,37,36
1656822834280,MATH 18,B04,083751,Rideout; David Porter,5,0,36,31
1656822834280,MATH 18,B05,093473,Rideout; David Porter,4,0,36,32
1656822834280,MATH 18,B06,093474,Rideout; David Porter,5,0,36,31
1656822840312,MATH 20A,A01,083754,Zheng; Zequn,12,0,40,28
1656822846349,MATH 20B,A01,083756,Briones; Jor-el Thomas Caparas,1,0,36,35
1656822846349,MATH 20B,A02,083757,Briones; Jor-el Thomas Caparas,1,0,36,35
1656822846349,MATH 20B,A03,093475,Briones; Jor-el Thomas Caparas,0,0,36,36
1656822852378,MATH 20C,A01,083760,Briones; Jor-el Thomas Caparas,1,0,35,34
1656822852378,MATH 20C,A02,083761,Briones; Jor-el Thomas Caparas,8,0,35,27
1656822852378,MATH 20C,A03,093476,Briones; Jor-el Thomas Caparas,0,1,36,36
1656822852378,MATH 20C,B01,083762,Bach; Quang Tran,0,0,30,30
1656822858402,MATH 20D,A01,083765,Tran; Brian Kha,4,0,30,26
1656822858402,MATH 20D,A02,083766,Tran; Brian Kha,4,0,30,26
1656822858402,MATH 20D,A03,083767,Tran; Brian Kha,2,0,30,28
1656822864425,MATH 20E,A01,083771,Ganguly; Soumya,5,0,32,27
1656822864425,MATH 20E,A02,083772,Ganguly; Soumya,6,0,32,26
1656822864425,MATH 20E,B01,083773,Ciotti; Benjamin,18,0,35,17
1656822864425,MATH 20E,B02,083774,Ciotti; Benjamin,17,0,35,18
1656822870455,MATH 103A,A01,083777,Greenfeld; Be'Eri,2,0,36,34
1656822870455,MATH 103A,A02,083778,Greenfeld; Be'Eri,5,0,36,31
1656822870455,MATH 103A,A03,093561,Greenfeld; Be'Eri,4,0,36,32
1656822870455,MATH 103A,B01,083779,Greenfeld; Be'Eri,6,0,36,30
1656822870455,MATH 103A,B02,083780,Greenfeld; Be'Eri,2,0,36,34
1656822870455,MATH 103A,B03,093562,Greenfeld; Be'Eri,2,0,36,34
1656822876478,MATH 105,A01,085443,Carter; Anne Toulson,13,0,35,22
1656822876478,MATH 105,A02,093477,Carter; Anne Toulson,20,0,35,15
1656822882508,MATH 109,A01,083213,Ganzberger; Geoffrey Michael,2,0,34,32
1656822882508,MATH 109,A02,083214,Ganzberger; Geoffrey Michael,2,0,34,32
1656822882508,MATH 109,A03,093478,Ganzberger; Geoffrey Michael,1,0,34,33
1656822882508,MATH 109,B01,083215,Ganzberger; Geoffrey Michael,1,0,32,31
1656822882508,MATH 109,B02,083216,Ganzberger; Geoffrey Michael,1,0,32,31
1656822882508,MATH 109,B03,093479,Ganzberger; Geoffrey Michael,6,0,32,26
1656822888533,MATH 142A,A01,083219,Chow; Bennett,6,0,32,26
1656822888533,MATH 142A,A02,083220,Chow; Bennett,9,0,32,23
1656822888533,MATH 142A,A03,093480,Chow; Bennett,7,0,32,25
1656822888533,MATH 142A,B03,093481,Chow; Bennett,7,0,32,25
1656822888533,MATH 142A,B04,093558,Chow; Bennett,10,0,32,22
1656822888533,MATH 142A,B05,093559,Chow; Bennett,6,0,32,26
1656822894562,MATH 193A,A01,083224,Rotar; Vladimir,6,0,34,28
1656822894562,MATH 193A,A02,083225,Rotar; Vladimir,3,0,34,31
1656822894562,MATH 193A,A03,083781,Rotar; Vladimir,1,0,34,33
1656822894562,MATH 193A,A04,083782,Rotar; Vladimir,6,0,34,28
1656822894562,MATH 193A,A05,093482,Rotar; Vladimir,6,0,34,28
1656822900593,MATH 197,001,091859,McAuley; Julian John,9999,0,9999,0
1656822900593,MATH 197,002,095566,Kedlaya; Kiran S.,9997,0,9999,2
1656822900593,MATH 197,003,095567,Xiao; Ming,9999,0,9999,0
1656822900593,MATH 197,004,095571,Perols; Johan Lars,9998,0,9999,1
1656822907652,COGS 9,A01,083615,Shannon; Kyle Michael,6,0,75,69
1656822913679,COGS 11,A01,083617,Boyle; Mary E. T.,18,0,48,30
1656822919703,COGS 13,A01,083071,Bastos; Amalia Pinkusfeld,8,0,71,63
1656822925727,COGS 14A,A01,092681,Semenuks; Arturs,0,1,100,100
1656822931774,COGS 14B,A01,083073,Cheng; Tzu-Han,5,0,63,58
1656822937797,COGS 17,A01,092677,Semenuks; Arturs,4,0,81,77
1656822943820,COGS 100,A01,083619,Allen; Michael Gordon,15,0,70,55
1656822949846,COGS 101A,A01,083621,Davis; Joshua Daniel,9,0,68,59
1656822955873,COGS 101B,A01,091572,Allen; Michael Gordon,8,0,65,57
1656822961896,COGS 101C,A01,083625,Delgado; Tania,17,0,35,18
1656822967920,COGS 107A,A01,083627,Boyle; Mary E. T.,13,0,60,47
1656822973944,COGS 118A,A01,083075,Gupta; Anjum,15,0,76,61
1656822979974,CSE 3,A50,083646,Miranda; Gregory Joseph,22,0,50,28
1656822986016,CSE 8A,A50,083650,Miranda; Gregory Joseph,17,1,56,39
1656822992042,CSE 11,A01,083080,Cao; Yingjun,4,15,40,36
1656822998065,CSE 12,A01,083652,Krause-Levy; Sophia Louisa,20,1,120,100
1656823004092,CSE 15L,A01,083654,Morris; Justin Loren,8,0,50,42
1656823004092,CSE 15L,A02,083655,Morris; Justin Loren,8,0,50,42
1656823010114,CSE 20,A01,083657,Tran; Khoa Dang,37,0,80,43
1656823016140,CSE 21,A01,095574,Bach; Quang Tran,21,0,48,27
1656823022166,CSE 30,A01,083084,Eldon; John,4,0,80,76
1656823022166,CSE 30,B01,095061,Bhaskar; Nishant,6,0,50,44
1656823028197,CSE 100,A01,083659,Cao; Yingjun,1,4,70,69
1656823034228,CSE 134B,A01,083661,Powell; Thomas Allan,19,0,100,81
1656823040268,CSE 140,A01,083663,Gungor; Onat,14,0,85,71
1656823046296,CSE 140L,A01,083088,Eldon; John,16,0,100,84
1656823052323,CSE 175,A01,083665,Kumar; Rakesh,3,0,25,22
1656823058348,CSE 190,A00,092507,Dubnov; Shlomo,7,0,20,13
1656823064373,ECE 45,A01,083139,Congero; Spencer William,5,0,75,70
1656823070413,ECE 65,A50,083695,Saad; Andrew S,12,0,30,18
1656823070413,ECE 65,A51,095125,Saad; Andrew S,25,0,26,1
1656823076440,ECE 109,A01,091882,Touri; Behrouz,15,0,70,55
1656823082463,ECE 180,A00,083140,Abi Samra; Nicholas Camill,0,0,30,30
1656823082463,ECE 180,B00,083141,Abi Samra; Nicholas Camill,0,0,30,30
1656823088490,MATH 10A,A01,083735,Patchell; Gregory David,1,0,30,29
1656823088490,MATH 10A,A02,083736,Patchell; Gregory David,20,0,30,10
1656823088490,MATH 10A,A03,083737,Patchell; Gregory David,15,0,30,15
1656823094516,MATH 10B,A01,083207,Lim; Seonhee,7,0,34,27
1656823094516,MATH 10B,A02,083208,Lim; Seonhee,9,0,35,26
1656823094516,MATH 10B,A03,093472,Lim; Seonhee,4,0,34,30
1656823094516,MATH 10B,B01,083739,Sinha; Shubham,9,0,30,21
1656823100554,MATH 18,A01,083743,Cinel; Cameron Alexander,6,0,30,24
1656823100554,MATH 18,A02,083744,Cinel; Cameron Alexander,15,0,30,15
1656823100554,MATH 18,A03,083745,Cinel; Cameron Alexander,8,0,30,22
1656823100554,MATH 18,B01,083748,Rideout; David Porter,3,0,37,34
1656823100554,MATH 18,B02,083749,Rideout; David Porter,3,0,36,33
1656823100554,MATH 18,B03,083750,Rideout; David Porter,1,0,37,36
1656823100554,MATH 18,B04,083751,Rideout; David Porter,5,0,36,31
1656823100554,MATH 18,B05,093473,Rideout; David Porter,4,0,36,32
1656823100554,MATH 18,B06,093474,Rideout; David Porter,5,0,36,31
1656823106578,MATH 20A,A01,083754,Zheng; Zequn,12,0,40,28
1656823112601,MATH 20B,A01,083756,Briones; Jor-el Thomas Caparas,1,0,36,35
1656823112601,MATH 20B,A02,083757,Briones; Jor-el Thomas Caparas,1,0,36,35
1656823112601,MATH 20B,A03,093475,Briones; Jor-el Thomas Caparas,0,0,36,36
1656823118626,MATH 20C,A01,083760,Briones; Jor-el Thomas Caparas,1,0,35,34
1656823118626,MATH 20C,A02,083761,Briones; Jor-el Thomas Caparas,8,0,35,27
1656823118626,MATH 20C,A03,093476,Briones; Jor-el Thomas Caparas,0,1,36,36
1656823118626,MATH 20C,B01,083762,Bach; Quang Tran,0,0,30,30
1656823124652,MATH 20D,A01,083765,Tran; Brian Kha,4,0,30,26
1656823124652,MATH 20D,A02,083766,Tran; Brian Kha,4,0,30,26
1656823124652,MATH 20D,A03,083767,Tran; Brian Kha,2,0,30,28
1656823130678,MATH 20E,A01,083771,Ganguly; Soumya,5,0,32,27
1656823130678,MATH 20E,A02,083772,Ganguly; Soumya,6,0,32,26
1656823130678,MATH 20E,B01,083773,Ciotti; Benjamin,18,0,35,17
1656823130678,MATH 20E,B02,083774,Ciotti; Benjamin,17,0,35,18
1656823136708,MATH 103A,A01,083777,Greenfeld; Be'Eri,2,0,36,34
1656823136708,MATH 103A,A02,083778,Greenfeld; Be'Eri,5,0,36,31
1656823136708,MATH 103A,A03,093561,Greenfeld; Be'Eri,4,0,36,32
1656823136708,MATH 103A,B01,083779,Greenfeld; Be'Eri,6,0,36,30
1656823136708,MATH 103A,B02,083780,Greenfeld; Be'Eri,2,0,36,34
1656823136708,MATH 103A,B03,093562,Greenfeld; Be'Eri,2,0,36,34
1656823142732,MATH 105,A01,085443,Carter; Anne Toulson,13,0,35,22
1656823142732,MATH 105,A02,093477,Carter; Anne Toulson,20,0,35,15
1656823148767,MATH 109,A01,083213,Ganzberger; Geoffrey Michael,2,0,34,32
1656823148767,MATH 109,A02,083214,Ganzberger; Geoffrey Michael,2,0,34,32
1656823148767,MATH 109,A03,093478,Ganzberger; Geoffrey Michael,1,0,34,33
1656823148767,MATH 109,B01,083215,Ganzberger; Geoffrey Michael,1,0,32,31
1656823148767,MATH 109,B02,083216,Ganzberger; Geoffrey Michael,1,0,32,31
1656823148767,MATH 109,B03,093479,Ganzberger; Geoffrey Michael,6,0,32,26
1656823154797,MATH 142A,A01,083219,Chow; Bennett,6,0,32,26
1656823154797,MATH 142A,A02,083220,Chow; Bennett,9,0,32,23
1656823154797,MATH 142A,A03,093480,Chow; Bennett,7,0,32,25
1656823154797,MATH 142A,B03,093481,Chow; Bennett,7,0,32,25
1656823154797,MATH 142A,B04,093558,Chow; Bennett,10,0,32,22
1656823154797,MATH 142A,B05,093559,Chow; Bennett,6,0,32,26
1656823160827,MATH 193A,A01,083224,Rotar; Vladimir,6,0,34,28
1656823160827,MATH 193A,A02,083225,Rotar; Vladimir,3,0,34,31
1656823160827,MATH 193A,A03,083781,Rotar; Vladimir,1,0,34,33
1656823160827,MATH 193A,A04,083782,Rotar; Vladimir,6,0,34,28
1656823160827,MATH 193A,A05,093482,Rotar; Vladimir,6,0,34,28
1656823166851,MATH 197,001,091859,McAuley; Julian John,9999,0,9999,0
1656823166851,MATH 197,002,095566,Kedlaya; Kiran S.,9997,0,9999,2
1656823166851,MATH 197,003,095567,Xiao; Ming,9999,0,9999,0
1656823166851,MATH 197,004,095571,Perols; Johan Lars,9998,0,9999,1
1656823173911,COGS 9,A01,083615,Shannon; Kyle Michael,6,0,75,69
1656823179935,COGS 11,A01,083617,Boyle; Mary E. T.,18,0,48,30
1656823185960,COGS 13,A01,083071,Bastos; Amalia Pinkusfeld,8,0,71,63
1656823191982,COGS 14A,A01,092681,Semenuks; Arturs,0,1,100,100
1656823198006,COGS 14B,A01,083073,Cheng; Tzu-Han,5,0,63,58
1656823204029,COGS 17,A01,092677,Semenuks; Arturs,4,0,81,77
1656823210052,COGS 100,A01,083619,Allen; Michael Gordon,15,0,70,55
1656823216076,COGS 101A,A01,083621,Davis; Joshua Daniel,9,0,68,59
1656823222099,COGS 101B,A01,091572,Allen; Michael Gordon,8,0,65,57
1656823228123,COGS 101C,A01,083625,Delgado; Tania,17,0,35,18
1656823234157,COGS 107A,A01,083627,Boyle; Mary E. T.,13,0,60,47
1656823240181,COGS 118A,A01,083075,Gupta; Anjum,15,0,76,61
1656823246205,CSE 3,A50,083646,Miranda; Gregory Joseph,22,0,50,28
1656823252231,CSE 8A,A50,083650,Miranda; Gregory Joseph,17,1,56,39
1656823258256,CSE 11,A01,083080,Cao; Yingjun,4,15,40,36
1656823264348,CSE 12,A01,083652,Krause-Levy; Sophia Louisa,20,1,120,100
1656823270386,CSE 15L,A01,083654,Morris; Justin Loren,8,0,50,42
1656823270386,CSE 15L,A02,083655,Morris; Justin Loren,8,0,50,42
1656823276414,CSE 20,A01,083657,Tran; Khoa Dang,37,0,80,43
1656823282443,CSE 21,A01,095574,Bach; Quang Tran,21,0,48,27
1656823288471,CSE 30,A01,083084,Eldon; John,4,0,80,76
1656823288471,CSE 30,B01,095061,Bhaskar; Nishant,6,0,50,44
1656823294494,CSE 100,A01,083659,Cao; Yingjun,1,4,70,69
1656823300521,CSE 134B,A01,083661,Powell; Thomas Allan,19,0,100,81
1656823306544,CSE 140,A01,083663,Gungor; Onat,14,0,85,71
1656823312569,CSE 140L,A01,083088,Eldon; John,16,0,100,84
1656823318594,CSE 175,A01,083665,Kumar; Rakesh,3,0,25,22
1656823324618,CSE 190,A00,092507,Dubnov; Shlomo,7,0,20,13
1656823330640,ECE 45,A01,083139,Congero; Spencer William,5,0,75,70
1656823336664,ECE 65,A50,083695,Saad; Andrew S,12,0,30,18
1656823336664,ECE 65,A51,095125,Saad; Andrew S,25,0,26,1
1656823342687,ECE 109,A01,091882,Touri; Behrouz,15,0,70,55
1656823348709,ECE 180,A00,083140,Abi Samra; Nicholas Camill,0,0,30,30
1656823348709,ECE 180,B00,083141,Abi Samra; Nicholas Camill,0,0,30,30
1656823354737,MATH 10A,A01,083735,Patchell; Gregory David,1,0,30,29
1656823354737,MATH 10A,A02,083736,Patchell; Gregory David,20,0,30,10
1656823354737,MATH 10A,A03,083737,Patchell; Gregory David,15,0,30,15
1656823360766,MATH 10B,A01,083207,Lim; Seonhee,7,0,34,27
1656823360766,MATH 10B,A02,083208,Lim; Seonhee,9,0,35,26
1656823360766,MATH 10B,A03,093472,Lim; Seonhee,4,0,34,30
1656823360766,MATH 10B,B01,083739,Sinha; Shubham,9,0,30,21
1656823366798,MATH 18,A01,083743,Cinel; Cameron Alexander,6,0,30,24
1656823366798,MATH 18,A02,083744,Cinel; Cameron Alexander,15,0,30,15
1656823366798,MATH 18,A03,083745,Cinel; Cameron Alexander,8,0,30,22
1656823366798,MATH 18,B01,083748,Rideout; David Porter,3,0,37,34
1656823366798,MATH 18,B02,083749,Rideout; David Porter,3,0,36,33
1656823366798,MATH 18,B03,083750,Rideout; David Porter,2,0,37,35
1656823366798,MATH 18,B04,083751,Rideout; David Porter,5,0,36,31
1656823366798,MATH 18,B05,093473,Rideout; David Porter,4,0,36,32
1656823366798,MATH 18,B06,093474,Rideout; David Porter,5,0,36,31
1656823372821,MATH 20A,A01,083754,Zheng; Zequn,12,0,40,28
1656823378848,MATH 20B,A01,083756,Briones; Jor-el Thomas Caparas,1,0,36,35
1656823378848,MATH 20B,A02,083757,Briones; Jor-el Thomas Caparas,1,0,36,35
1656823378848,MATH 20B,A03,093475,Briones; Jor-el Thomas Caparas,0,0,36,36
1656823384886,MATH 20C,A01,083760,Briones; Jor-el Thomas Caparas,1,0,35,34
1656823384886,MATH 20C,A02,083761,Briones; Jor-el Thomas Caparas,8,0,35,27
1656823384886,MATH 20C,A03,093476,Briones; Jor-el Thomas Caparas,0,1,36,36
1656823384886,MATH 20C,B01,083762,Bach; Quang Tran,0,0,30,30
1656823390914,MATH 20D,A01,083765,Tran; Brian Kha,4,0,30,26
1656823390914,MATH 20D,A02,083766,Tran; Brian Kha,4,0,30,26
1656823390914,MATH 20D,A03,083767,Tran; Brian Kha,2,0,30,28
1656823396943,MATH 20E,A01,083771,Ganguly; Soumya,5,0,32,27
1656823396943,MATH 20E,A02,083772,Ganguly; Soumya,6,0,32,26
1656823396943,MATH 20E,B01,083773,Ciotti; Benjamin,18,0,35,17
1656823396943,MATH 20E,B02,083774,Ciotti; Benjamin,17,0,35,18
1656823402966,MATH 103A,A01,083777,Greenfeld; Be'Eri,2,0,36,34
1656823402966,MATH 103A,A02,083778,Greenfeld; Be'Eri,5,0,36,31
1656823402966,MATH 103A,A03,093561,Greenfeld; Be'Eri,4,0,36,32
1656823402966,MATH 103A,B01,083779,Greenfeld; Be'Eri,6,0,36,30
1656823402966,MATH 103A,B02,083780,Greenfeld; Be'Eri,2,0,36,34
1656823402966,MATH 103A,B03,093562,Greenfeld; Be'Eri,2,0,36,34
1656823408993,MATH 105,A01,085443,Carter; Anne Toulson,13,0,35,22
1656823408993,MATH 105,A02,093477,Carter; Anne Toulson,20,0,35,15
1656823415023,MATH 109,A01,083213,Ganzberger; Geoffrey Michael,2,0,34,32
1656823415023,MATH 109,A02,083214,Ganzberger; Geoffrey Michael,2,0,34,32
1656823415023,MATH 109,A03,093478,Ganzberger; Geoffrey Michael,1,0,34,33
1656823415023,MATH 109,B01,083215,Ganzberger; Geoffrey Michael,1,0,32,31
1656823415023,MATH 109,B02,083216,Ganzberger; Geoffrey Michael,1,0,32,31
1656823415023,MATH 109,B03,093479,Ganzberger; Geoffrey Michael,6,0,32,26
1656823421055,MATH 142A,A01,083219,Chow; Bennett,6,0,32,26
1656823421055,MATH 142A,A02,083220,Chow; Bennett,9,0,32,23
1656823421055,MATH 142A,A03,093480,Chow; Bennett,7,0,32,25
1656823421055,MATH 142A,B03,093481,Chow; Bennett,7,0,32,25
1656823421055,MATH 142A,B04,093558,Chow; Bennett,10,0,32,22
1656823421055,MATH 142A,B05,093559,Chow; Bennett,6,0,32,26
1656823427077,MATH 193A,A01,083224,Rotar; Vladimir,6,0,34,28
1656823427077,MATH 193A,A02,083225,Rotar; Vladimir,3,0,34,31
1656823427077,MATH 193A,A03,083781,Rotar; Vladimir,1,0,34,33
1656823427077,MATH 193A,A04,083782,Rotar; Vladimir,6,0,34,28
1656823427077,MATH 193A,A05,093482,Rotar; Vladimir,6,0,34,28
1656823433104,MATH 197,001,091859,McAuley; Julian John,9999,0,9999,0
1656823433104,MATH 197,002,095566,Kedlaya; Kiran S.,9997,0,9999,2
1656823433104,MATH 197,003,095567,Xiao; Ming,9999,0,9999,0
1656823433104,MATH 197,004,095571,Perols; Johan Lars,9998,0,9999,1
1656823440171,COGS 9,A01,083615,Shannon; Kyle Michael,6,0,75,69
1656823446197,COGS 11,A01,083617,Boyle; Mary E. T.,18,0,48,30
1656823452223,COGS 13,A01,083071,Bastos; Amalia Pinkusfeld,8,0,71,63
1656823458250,COGS 14A,A01,092681,Semenuks; Arturs,0,1,100,100
1656823464276,COGS 14B,A01,083073,Cheng; Tzu-Han,5,0,63,58
1656823470302,COGS 17,A01,092677,Semenuks; Arturs,4,0,81,77
1656823476324,COGS 100,A01,083619,Allen; Michael Gordon,15,0,70,55
1656823482354,COGS 101A,A01,083621,Davis; Joshua Daniel,9,0,68,59
1656823488381,COGS 101B,A01,091572,Allen; Michael Gordon,8,0,65,57
1656823494404,COGS 101C,A01,083625,Delgado; Tania,17,0,35,18
1656823500433,COGS 107A,A01,083627,Boyle; Mary E. T.,13,0,60,47
1656823506460,COGS 118A,A01,083075,Gupta; Anjum,15,0,76,61
1656823512491,CSE 3,A50,083646,Miranda; Gregory Joseph,22,0,50,28
1656823518526,CSE 8A,A50,083650,Miranda; Gregory Joseph,17,1,56,39
1656823524550,CSE 11,A01,083080,Cao; Yingjun,4,15,40,36
1656823530574,CSE 12,A01,083652,Krause-Levy; Sophia Louisa,20,1,120,100
1656823536599,CSE 15L,A01,083654,Morris; Justin Loren,8,0,50,42
1656823536599,CSE 15L,A02,083655,Morris; Justin Loren,8,0,50,42
1656823542626,CSE 20,A01,083657,Tran; Khoa Dang,37,0,80,43
1656823548653,CSE 21,A01,095574,Bach; Quang Tran,21,0,48,27
1656823554680,CSE 30,A01,083084,Eldon; John,4,0,80,76
1656823554680,CSE 30,B01,095061,Bhaskar; Nishant,6,0,50,44
1656823560703,CSE 100,A01,083659,Cao; Yingjun,1,4,70,69
1656823566728,CSE 134B,A01,083661,Powell; Thomas Allan,19,0,100,81
1656823572754,CSE 140,A01,083663,Gungor; Onat,14,0,85,71
1656823578778,CSE 140L,A01,083088,Eldon; John,16,0,100,84
1656823584802,CSE 175,A01,083665,Kumar; Rakesh,3,0,25,22
1656823590831,CSE 190,A00,092507,Dubnov; Shlomo,7,0,20,13
1656823596855,ECE 45,A01,083139,Congero; Spencer William,5,0,75,70
1656823602879,ECE 65,A50,083695,Saad; Andrew S,12,0,30,18
1656823602879,ECE 65,A51,095125,Saad; Andrew S,25,0,26,1
1656823608925,ECE 109,A01,091882,Touri; Behrouz,15,0,70,55
1656823614955,ECE 180,A00,083140,Abi Samra; Nicholas Camill,0,0,30,30
1656823614955,ECE 180,B00,083141,Abi Samra; Nicholas Camill,0,0,30,30
1656823620978,MATH 10A,A01,083735,Patchell; Gregory David,1,0,30,29
1656823620978,MATH 10A,A02,083736,Patchell; Gregory David,20,0,30,10
1656823620978,MATH 10A,A03,083737,Patchell; Gregory David,15,0,30,15
1656823627014,MATH 10B,A01,083207,Lim; Seonhee,7,0,34,27
1656823627014,MATH 10B,A02,083208,Lim; Seonhee,9,0,35,26
1656823627014,MATH 10B,A03,093472,Lim; Seonhee,4,0,34,30
1656823627014,MATH 10B,B01,083739,Sinha; Shubham,9,0,30,21
1656823633036,MATH 18,A01,083743,Cinel; Cameron Alexander,6,0,30,24
1656823633036,MATH 18,A02,083744,Cinel; Cameron Alexander,15,0,30,15
1656823633036,MATH 18,A03,083745,Cinel; Cameron Alexander,8,0,30,22
1656823633036,MATH 18,B01,083748,Rideout; David Porter,3,0,37,34
1656823633036,MATH 18,B02,083749,Rideout; David Porter,3,0,36,33
1656823633036,MATH 18,B03,083750,Rideout; David Porter,2,0,37,35
1656823633036,MATH 18,B04,083751,Rideout; David Porter,5,0,36,31
1656823633036,MATH 18,B05,093473,Rideout; David Porter,4,0,36,32
1656823633036,MATH 18,B06,093474,Rideout; David Porter,5,0,36,31
1656823639062,MATH 20A,A01,083754,Zheng; Zequn,12,0,40,28
1656823645092,MATH 20B,A01,083756,Briones; Jor-el Thomas Caparas,1,0,36,35
1656823645092,MATH 20B,A02,083757,Briones; Jor-el Thomas Caparas,1,0,36,35
1656823645092,MATH 20B,A03,093475,Briones; Jor-el Thomas Caparas,0,0,36,36
1656823651121,MATH 20C,A01,083760,Briones; Jor-el Thomas Caparas,1,0,35,34
1656823651121,MATH 20C,A02,083761,Briones; Jor-el Thomas Caparas,8,0,35,27
1656823651121,MATH 20C,A03,093476,Briones; Jor-el Thomas Caparas,0,1,36,36
1656823651121,MATH 20C,B01,083762,Bach; Quang Tran,0,0,30,30
1656823657150,MATH 20D,A01,083765,Tran; Brian Kha,4,0,30,26
1656823657150,MATH 20D,A02,083766,Tran; Brian Kha,4,0,30,26
1656823657150,MATH 20D,A03,083767,Tran; Brian Kha,2,0,30,28
1656823663173,MATH 20E,A01,083771,Ganguly; Soumya,5,0,32,27
1656823663173,MATH 20E,A02,083772,Ganguly; Soumya,6,0,32,26
1656823663173,MATH 20E,B01,083773,Ciotti; Benjamin,18,0,35,17
1656823663173,MATH 20E,B02,083774,Ciotti; Benjamin,17,0,35,18
1656823669195,MATH 103A,A01,083777,Greenfeld; Be'Eri,2,0,36,34
1656823669195,MATH 103A,A02,083778,Greenfeld; Be'Eri,5,0,36,31
1656823669195,MATH 103A,A03,093561,Greenfeld; Be'Eri,4,0,36,32
1656823669195,MATH 103A,B01,083779,Greenfeld; Be'Eri,6,0,36,30
1656823669195,MATH 103A,B02,083780,Greenfeld; Be'Eri,2,0,36,34
1656823669195,MATH 103A,B03,093562,Greenfeld; Be'Eri,2,0,36,34
1656823675218,MATH 105,A01,085443,Carter; Anne Toulson,13,0,35,22
1656823675218,MATH 105,A02,093477,Carter; Anne Toulson,20,0,35,15
1656823681241,MATH 109,A01,083213,Ganzberger; Geoffrey Michael,2,0,34,32
1656823681241,MATH 109,A02,083214,Ganzberger; Geoffrey Michael,2,0,34,32
1656823681241,MATH 109,A03,093478,Ganzberger; Geoffrey Michael,1,0,34,33
1656823681241,MATH 109,B01,083215,Ganzberger; Geoffrey Michael,1,0,32,31
1656823681241,MATH 109,B02,083216,Ganzberger; Geoffrey Michael,1,0,32,31
1656823681241,MATH 109,B03,093479,Ganzberger; Geoffrey Michael,6,0,32,26
1656823687270,MATH 142A,A01,083219,Chow; Bennett,6,0,32,26
1656823687270,MATH 142A,A02,083220,Chow; Bennett,9,0,32,23
1656823687270,MATH 142A,A03,093480,Chow; Bennett,7,0,32,25
1656823687270,MATH 142A,B03,093481,Chow; Bennett,7,0,32,25
1656823687270,MATH 142A,B04,093558,Chow; Bennett,10,0,32,22
1656823687270,MATH 142A,B05,093559,Chow; Bennett,6,0,32,26
1656823693297,MATH 193A,A01,083224,Rotar; Vladimir,6,0,34,28
1656823693297,MATH 193A,A02,083225,Rotar; Vladimir,3,0,34,31
1656823693297,MATH 193A,A03,083781,Rotar; Vladimir,1,0,34,33
1656823693297,MATH 193A,A04,083782,Rotar; Vladimir,6,0,34,28
1656823693297,MATH 193A,A05,093482,Rotar; Vladimir,6,0,34,28
1656823699321,MATH 197,001,091859,McAuley; Julian John,9999,0,9999,0
1656823699321,MATH 197,002,095566,Kedlaya; Kiran S.,9997,0,9999,2
1656823699321,MATH 197,003,095567,Xiao; Ming,9999,0,9999,0
1656823699321,MATH 197,004,095571,Perols; Johan Lars,9998,0,9999,1
1656823706379,COGS 9,A01,083615,Shannon; Kyle Michael,6,0,75,69
1656823712408,COGS 11,A01,083617,Boyle; Mary E. T.,18,0,48,30
1656823718437,COGS 13,A01,083071,Bastos; Amalia Pinkusfeld,8,0,71,63
1656823724468,COGS 14A,A01,092681,Semenuks; Arturs,0,1,100,100
1656823730500,COGS 14B,A01,083073,Cheng; Tzu-Han,5,0,63,58
1656823736534,COGS 17,A01,092677,Semenuks; Arturs,4,0,81,77
1656823742561,COGS 100,A01,083619,Allen; Michael Gordon,15,0,70,55
1656823748595,COGS 101A,A01,083621,Davis; Joshua Daniel,9,0,68,59
1656823754624,COGS 101B,A01,091572,Allen; Michael Gordon,8,0,65,57
1656823760666,COGS 101C,A01,083625,Delgado; Tania,17,0,35,18
1656823766690,COGS 107A,A01,083627,Boyle; Mary E. T.,13,0,60,47
1656823772717,COGS 118A,A01,083075,Gupta; Anjum,15,0,76,61
1656823778741,CSE 3,A50,083646,Miranda; Gregory Joseph,22,0,50,28
1656823784764,CSE 8A,A50,083650,Miranda; Gregory Joseph,17,1,56,39
1656823790791,CSE 11,A01,083080,Cao; Yingjun,4,15,40,36
1656823796813,CSE 12,A01,083652,Krause-Levy; Sophia Louisa,20,1,120,100
1656823802842,CSE 15L,A01,083654,Morris; Justin Loren,8,0,50,42
1656823802842,CSE 15L,A02,083655,Morris; Justin Loren,8,0,50,42
1656823808867,CSE 20,A01,083657,Tran; Khoa Dang,37,0,80,43
1656823814890,CSE 21,A01,095574,Bach; Quang Tran,21,0,48,27
1656823820914,CSE 30,A01,083084,Eldon; John,4,0,80,76
1656823820914,CSE 30,B01,095061,Bhaskar; Nishant,6,0,50,44
1656823826937,CSE 100,A01,083659,Cao; Yingjun,1,4,70,69
1656823832959,CSE 134B,A01,083661,Powell; Thomas Allan,19,0,100,81
1656823838986,CSE 140,A01,083663,Gungor; Onat,14,0,85,71
1656823845009,CSE 140L,A01,083088,Eldon; John,16,0,100,84
1656823851042,CSE 175,A01,083665,Kumar; Rakesh,3,0,25,22
1656823857069,CSE 190,A00,092507,Dubnov; Shlomo,7,0,20,13
1656823863194,ECE 45,A01,083139,Congero; Spencer William,5,0,75,70
1656823869218,ECE 65,A50,083695,Saad; Andrew S,12,0,30,18
1656823869218,ECE 65,A51,095125,Saad; Andrew S,25,0,26,1
1656823875243,ECE 109,A01,091882,Touri; Behrouz,16,0,70,54
1656823881270,ECE 180,A00,083140,Abi Samra; Nicholas Camill,0,0,30,30
1656823881270,ECE 180,B00,083141,Abi Samra; Nicholas Camill,0,0,30,30
1656823887312,MATH 10A,A01,083735,Patchell; Gregory David,1,0,30,29
1656823887312,MATH 10A,A02,083736,Patchell; Gregory David,20,0,30,10
1656823887312,MATH 10A,A03,083737,Patchell; Gregory David,15,0,30,15
1656823893336,MATH 10B,A01,083207,Lim; Seonhee,7,0,34,27
1656823893336,MATH 10B,A02,083208,Lim; Seonhee,9,0,35,26
1656823893336,MATH 10B,A03,093472,Lim; Seonhee,4,0,34,30
1656823893336,MATH 10B,B01,083739,Sinha; Shubham,9,0,30,21
1656823899359,MATH 18,A01,083743,Cinel; Cameron Alexander,6,0,30,24
1656823899359,MATH 18,A02,083744,Cinel; Cameron Alexander,15,0,30,15
1656823899359,MATH 18,A03,083745,Cinel; Cameron Alexander,8,0,30,22
1656823899359,MATH 18,B01,083748,Rideout; David Porter,3,0,37,34
1656823899359,MATH 18,B02,083749,Rideout; David Porter,3,0,36,33
1656823899359,MATH 18,B03,083750,Rideout; David Porter,2,0,37,35
1656823899359,MATH 18,B04,083751,Rideout; David Porter,5,0,36,31
1656823899359,MATH 18,B05,093473,Rideout; David Porter,4,0,36,32
1656823899359,MATH 18,B06,093474,Rideout; David Porter,5,0,36,31
1656823905382,MATH 20A,A01,083754,Zheng; Zequn,12,0,40,28
1656823911408,MATH 20B,A01,083756,Briones; Jor-el Thomas Caparas,1,0,36,35
1656823911408,MATH 20B,A02,083757,Briones; Jor-el Thomas Caparas,1,0,36,35
1656823911408,MATH 20B,A03,093475,Briones; Jor-el Thomas Caparas,0,0,36,36
1656823917438,MATH 20C,A01,083760,Briones; Jor-el Thomas Caparas,1,0,35,34
1656823917438,MATH 20C,A02,083761,Briones; Jor-el Thomas Caparas,8,0,35,27
1656823917438,MATH 20C,A03,093476,Briones; Jor-el Thomas Caparas,0,1,36,36
1656823917438,MATH 20C,B01,083762,Bach; Quang Tran,0,0,30,30
1656823923466,MATH 20D,A01,083765,Tran; Brian Kha,4,0,30,26
1656823923466,MATH 20D,A02,083766,Tran; Brian Kha,4,0,30,26
1656823923466,MATH 20D,A03,083767,Tran; Brian Kha,2,0,30,28
1656823929489,MATH 20E,A01,083771,Ganguly; Soumya,5,0,32,27
1656823929489,MATH 20E,A02,083772,Ganguly; Soumya,6,0,32,26
1656823929489,MATH 20E,B01,083773,Ciotti; Benjamin,18,0,35,17
1656823929489,MATH 20E,B02,083774,Ciotti; Benjamin,17,0,35,18
1656823935513,MATH 103A,A01,083777,Greenfeld; Be'Eri,2,0,36,34
1656823935513,MATH 103A,A02,083778,Greenfeld; Be'Eri,5,0,36,31
1656823935513,MATH 103A,A03,093561,Greenfeld; Be'Eri,4,0,36,32
1656823935513,MATH 103A,B01,083779,Greenfeld; Be'Eri,6,0,36,30
1656823935513,MATH 103A,B02,083780,Greenfeld; Be'Eri,2,0,36,34
1656823935513,MATH 103A,B03,093562,Greenfeld; Be'Eri,2,0,36,34
1656823941537,MATH 105,A01,085443,Carter; Anne Toulson,13,0,35,22
1656823941537,MATH 105,A02,093477,Carter; Anne Toulson,20,0,35,15
1656823947564,MATH 109,A01,083213,Ganzberger; Geoffrey Michael,2,0,34,32
1656823947564,MATH 109,A02,083214,Ganzberger; Geoffrey Michael,2,0,34,32
1656823947564,MATH 109,A03,093478,Ganzberger; Geoffrey Michael,1,0,34,33
1656823947564,MATH 109,B01,083215,Ganzberger; Geoffrey Michael,1,0,32,31
1656823947564,MATH 109,B02,083216,Ganzberger; Geoffrey Michael,1,0,32,31
1656823947564,MATH 109,B03,093479,Ganzberger; Geoffrey Michael,6,0,32,26
1656823953588,MATH 142A,A01,083219,Chow; Bennett,6,0,32,26
1656823953588,MATH 142A,A02,083220,Chow; Bennett,9,0,32,23
1656823953588,MATH 142A,A03,093480,Chow; Bennett,7,0,32,25
1656823953588,MATH 142A,B03,093481,Chow; Bennett,7,0,32,25
1656823953588,MATH 142A,B04,093558,Chow; Bennett,10,0,32,22
1656823953588,MATH 142A,B05,093559,Chow; Bennett,6,0,32,26
1656823959614,MATH 193A,A01,083224,Rotar; Vladimir,6,0,34,28
1656823959614,MATH 193A,A02,083225,Rotar; Vladimir,3,0,34,31
1656823959614,MATH 193A,A03,083781,Rotar; Vladimir,1,0,34,33
1656823959614,MATH 193A,A04,083782,Rotar; Vladimir,6,0,34,28
1656823959614,MATH 193A,A05,093482,Rotar; Vladimir,6,0,34,28
1656823965641,MATH 197,001,091859,McAuley; Julian John,9999,0,9999,0
1656823965641,MATH 197,002,095566,Kedlaya; Kiran S.,9997,0,9999,2
1656823965641,MATH 197,003,095567,Xiao; Ming,9999,0,9999,0
1656823965641,MATH 197,004,095571,Perols; Johan Lars,9998,0,9999,1
1656823972700,COGS 9,A01,083615,Shannon; Kyle Michael,6,0,75,69
1656823978724,COGS 11,A01,083617,Boyle; Mary E. T.,18,0,48,30
1656823984750,COGS 13,A01,083071,Bastos; Amalia Pinkusfeld,8,0,71,63
1656823990775,COGS 14A,A01,092681,Semenuks; Arturs,0,1,100,100
1656823996798,COGS 14B,A01,083073,Cheng; Tzu-Han,5,0,63,58
1656824002821,COGS 17,A01,092677,Semenuks; Arturs,4,0,81,77
1656824008844,COGS 100,A01,083619,Allen; Michael Gordon,15,0,70,55
1656824014868,COGS 101A,A01,083621,Davis; Joshua Daniel,9,0,68,59
1656824020891,COGS 101B,A01,091572,Allen; Michael Gordon,8,0,65,57
1656824026919,COGS 101C,A01,083625,Delgado; Tania,17,0,35,18
1656824032945,COGS 107A,A01,083627,Boyle; Mary E. T.,13,0,60,47
1656824038972,COGS 118A,A01,083075,Gupta; Anjum,15,0,76,61
1656824044997,CSE 3,A50,083646,Miranda; Gregory Joseph,22,0,50,28
1656824051021,CSE 8A,A50,083650,Miranda; Gregory Joseph,17,1,56,39
1656824057042,CSE 11,A01,083080,Cao; Yingjun,4,15,40,36
1656824063068,CSE 12,A01,083652,Krause-Levy; Sophia Louisa,20,1,120,100
1656824069090,CSE 15L,A01,083654,Morris; Justin Loren,8,0,50,42
1656824069090,CSE 15L,A02,083655,Morris; Justin Loren,8,0,50,42
1656824075119,CSE 20,A01,083657,Tran; Khoa Dang,37,0,80,43
1656824081144,CSE 21,A01,095574,Bach; Quang Tran,21,0,48,27
1656824087168,CSE 30,A01,083084,Eldon; John,4,0,80,76
1656824087168,CSE 30,B01,095061,Bhaskar; Nishant,6,0,50,44
1656824093195,CSE 100,A01,083659,Cao; Yingjun,1,4,70,69
1656824099222,CSE 134B,A01,083661,Powell; Thomas Allan,19,0,100,81
1656824105249,CSE 140,A01,083663,Gungor; Onat,14,0,85,71
1656824111273,CSE 140L,A01,083088,Eldon; John,16,0,100,84
1656824117296,CSE 175,A01,083665,Kumar; Rakesh,3,0,25,22
1656824123323,CSE 190,A00,092507,Dubnov; Shlomo,7,0,20,13
1656824129347,ECE 45,A01,083139,Congero; Spencer William,5,0,75,70
1656824135371,ECE 65,A50,083695,Saad; Andrew S,12,0,30,18
1656824135371,ECE 65,A51,095125,Saad; Andrew S,25,0,26,1
1656824141393,ECE 109,A01,091882,Touri; Behrouz,16,0,70,54
1656824147416,ECE 180,A00,083140,Abi Samra; Nicholas Camill,0,0,30,30
1656824147416,ECE 180,B00,083141,Abi Samra; Nicholas Camill,0,0,30,30
1656824153443,MATH 10A,A01,083735,Patchell; Gregory David,1,0,30,29
1656824153443,MATH 10A,A02,083736,Patchell; Gregory David,20,0,30,10
1656824153443,MATH 10A,A03,083737,Patchell; Gregory David,15,0,30,15
1656824159468,MATH 10B,A01,083207,Lim; Seonhee,7,0,34,27
1656824159468,MATH 10B,A02,083208,Lim; Seonhee,9,0,35,26
1656824159468,MATH 10B,A03,093472,Lim; Seonhee,4,0,34,30
1656824159468,MATH 10B,B01,083739,Sinha; Shubham,9,0,30,21
1656824165499,MATH 18,A01,083743,Cinel; Cameron Alexander,6,0,30,24
1656824165499,MATH 18,A02,083744,Cinel; Cameron Alexander,15,0,30,15
1656824165499,MATH 18,A03,083745,Cinel; Cameron Alexander,8,0,30,22
1656824165499,MATH 18,B01,083748,Rideout; David Porter,3,0,37,34
1656824165499,MATH 18,B02,083749,Rideout; David Porter,3,0,36,33
1656824165499,MATH 18,B03,083750,Rideout; David Porter,2,0,37,35
1656824165499,MATH 18,B04,083751,Rideout; David Porter,5,0,36,31
1656824165499,MATH 18,B05,093473,Rideout; David Porter,4,0,36,32
1656824165499,MATH 18,B06,093474,Rideout; David Porter,5,0,36,31
1656824171526,MATH 20A,A01,083754,Zheng; Zequn,12,0,40,28
1656824177549,MATH 20B,A01,083756,Briones; Jor-el Thomas Caparas,1,0,36,35
1656824177549,MATH 20B,A02,083757,Briones; Jor-el Thomas Caparas,1,0,36,35
1656824177549,MATH 20B,A03,093475,Briones; Jor-el Thomas Caparas,0,0,36,36
1656824183574,MATH 20C,A01,083760,Briones; Jor-el Thomas Caparas,1,0,35,34
1656824183574,MATH 20C,A02,083761,Briones; Jor-el Thomas Caparas,8,0,35,27
1656824183574,MATH 20C,A03,093476,Briones; Jor-el Thomas Caparas,0,1,36,36
1656824183574,MATH 20C,B01,083762,Bach; Quang Tran,0,0,30,30
1656824189598,MATH 20D,A01,083765,Tran; Brian Kha,4,0,30,26
1656824189598,MATH 20D,A02,083766,Tran; Brian Kha,4,0,30,26
1656824189598,MATH 20D,A03,083767,Tran; Brian Kha,2,0,30,28
1656824195624,MATH 20E,A01,083771,Ganguly; Soumya,5,0,32,27
1656824195624,MATH 20E,A02,083772,Ganguly; Soumya,6,0,32,26
1656824195624,MATH 20E,B01,083773,Ciotti; Benjamin,18,0,35,17
1656824195624,MATH 20E,B02,083774,Ciotti; Benjamin,17,0,35,18
1656824201654,MATH 103A,A01,083777,Greenfeld; Be'Eri,2,0,36,34
1656824201654,MATH 103A,A02,083778,Greenfeld; Be'Eri,5,0,36,31
1656824201654,MATH 103A,A03,093561,Greenfeld; Be'Eri,4,0,36,32
1656824201654,MATH 103A,B01,083779,Greenfeld; Be'Eri,6,0,36,30
1656824201654,MATH 103A,B02,083780,Greenfeld; Be'Eri,2,0,36,34
1656824201654,MATH 103A,B03,093562,Greenfeld; Be'Eri,2,0,36,34
1656824207678,MATH 105,A01,085443,Carter; Anne Toulson,13,0,35,22
1656824207678,MATH 105,A02,093477,Carter; Anne Toulson,20,0,35,15
1656824213701,MATH 109,A01,083213,Ganzberger; Geoffrey Michael,2,0,34,32
1656824213701,MATH 109,A02,083214,Ganzberger; Geoffrey Michael,2,0,34,32
1656824213701,MATH 109,A03,093478,Ganzberger; Geoffrey Michael,1,0,34,33
1656824213701,MATH 109,B01,083215,Ganzberger; Geoffrey Michael,1,0,32,31
1656824213701,MATH 109,B02,083216,Ganzberger; Geoffrey Michael,1,0,32,31
1656824213701,MATH 109,B03,093479,Ganzberger; Geoffrey Michael,6,0,32,26
1656824219730,MATH 142A,A01,083219,Chow; Bennett,6,0,32,26
1656824219730,MATH 142A,A02,083220,Chow; Bennett,9,0,32,23
1656824219730,MATH 142A,A03,093480,Chow; Bennett,7,0,32,25
1656824219730,MATH 142A,B03,093481,Chow; Bennett,7,0,32,25
1656824219730,MATH 142A,B04,093558,Chow; Bennett,10,0,32,22
1656824219730,MATH 142A,B05,093559,Chow; Bennett,6,0,32,26
1656824225755,MATH 193A,A01,083224,Rotar; Vladimir,6,0,34,28
1656824225755,MATH 193A,A02,083225,Rotar; Vladimir,3,0,34,31
1656824225755,MATH 193A,A03,083781,Rotar; Vladimir,1,0,34,33
1656824225755,MATH 193A,A04,083782,Rotar; Vladimir,6,0,34,28
1656824225755,MATH 193A,A05,093482,Rotar; Vladimir,6,0,34,28
1656824231776,MATH 197,001,091859,McAuley; Julian John,9999,0,9999,0
1656824231776,MATH 197,002,095566,Kedlaya; Kiran S.,9997,0,9999,2
1656824231776,MATH 197,003,095567,Xiao; Ming,9999,0,9999,0
1656824231776,MATH 197,004,095571,Perols; Johan Lars,9998,0,9999,1
1656824238836,COGS 9,A01,083615,Shannon; Kyle Michael,6,0,75,69
1656824244863,COGS 11,A01,083617,Boyle; Mary E. T.,18,0,48,30
1656824250887,COGS 13,A01,083071,Bastos; Amalia Pinkusfeld,8,0,71,63
1656824256916,COGS 14A,A01,092681,Semenuks; Arturs,0,1,100,100
1656824262941,COGS 14B,A01,083073,Cheng; Tzu-Han,5,0,63,58
1656824268963,COGS 17,A01,092677,Semenuks; Arturs,4,0,81,77
1656824274989,COGS 100,A01,083619,Allen; Michael Gordon,15,0,70,55
1656824281017,COGS 101A,A01,083621,Davis; Joshua Daniel,9,0,68,59
1656824287040,COGS 101B,A01,091572,Allen; Michael Gordon,8,0,65,57
1656824293063,COGS 101C,A01,083625,Delgado; Tania,17,0,35,18
1656824299085,COGS 107A,A01,083627,Boyle; Mary E. T.,13,0,60,47
1656824305111,COGS 118A,A01,083075,Gupta; Anjum,15,0,76,61
1656824311132,CSE 3,A50,083646,Miranda; Gregory Joseph,22,0,50,28
1656824317155,CSE 8A,A50,083650,Miranda; Gregory Joseph,17,1,56,39
1656824323185,CSE 11,A01,083080,Cao; Yingjun,4,15,40,36
1656824329207,CSE 12,A01,083652,Krause-Levy; Sophia Louisa,20,1,120,100
1656824335231,CSE 15L,A01,083654,Morris; Justin Loren,8,0,50,42
1656824335231,CSE 15L,A02,083655,Morris; Justin Loren,8,0,50,42
1656824341257,CSE 20,A01,083657,Tran; Khoa Dang,37,0,80,43
1656824347279,CSE 21,A01,095574,Bach; Quang Tran,21,0,48,27
1656824353307,CSE 30,A01,083084,Eldon; John,4,0,80,76
1656824353307,CSE 30,B01,095061,Bhaskar; Nishant,6,0,50,44
1656824359331,CSE 100,A01,083659,Cao; Yingjun,1,4,70,69
1656824365354,CSE 134B,A01,083661,Powell; Thomas Allan,19,0,100,81
1656824371379,CSE 140,A01,083663,Gungor; Onat,14,0,85,71
1656824377411,CSE 140L,A01,083088,Eldon; John,16,0,100,84
1656824383436,CSE 175,A01,083665,Kumar; Rakesh,3,0,25,22
1656824389464,CSE 190,A00,092507,Dubnov; Shlomo,7,0,20,13
1656824395491,ECE 45,A01,083139,Congero; Spencer William,5,0,75,70
1656824401515,ECE 65,A50,083695,Saad; Andrew S,12,0,30,18
1656824401515,ECE 65,A51,095125,Saad; Andrew S,25,0,26,1
1656824407538,ECE 109,A01,091882,Touri; Behrouz,16,0,70,54
1656824413561,ECE 180,A00,083140,Abi Samra; Nicholas Camill,0,0,30,30
1656824413561,ECE 180,B00,083141,Abi Samra; Nicholas Camill,0,0,30,30
1656824419590,MATH 10A,A01,083735,Patchell; Gregory David,1,0,30,29
1656824419590,MATH 10A,A02,083736,Patchell; Gregory David,20,0,30,10
1656824419590,MATH 10A,A03,083737,Patchell; Gregory David,15,0,30,15
1656824425618,MATH 10B,A01,083207,Lim; Seonhee,7,0,34,27
1656824425618,MATH 10B,A02,083208,Lim; Seonhee,9,0,35,26
1656824425618,MATH 10B,A03,093472,Lim; Seonhee,4,0,34,30
1656824425618,MATH 10B,B01,083739,Sinha; Shubham,9,0,30,21
1656824431640,MATH 18,A01,083743,Cinel; Cameron Alexander,6,0,30,24
1656824431640,MATH 18,A02,083744,Cinel; Cameron Alexander,15,0,30,15
1656824431640,MATH 18,A03,083745,Cinel; Cameron Alexander,8,0,30,22
1656824431640,MATH 18,B01,083748,Rideout; David Porter,3,0,37,34
1656824431640,MATH 18,B02,083749,Rideout; David Porter,3,0,36,33
1656824431640,MATH 18,B03,083750,Rideout; David Porter,2,0,37,35
1656824431640,MATH 18,B04,083751,Rideout; David Porter,5,0,36,31
1656824431640,MATH 18,B05,093473,Rideout; David Porter,4,0,36,32
1656824431640,MATH 18,B06,093474,Rideout; David Porter,5,0,36,31
1656824437662,MATH 20A,A01,083754,Zheng; Zequn,12,0,40,28
1656824443689,MATH 20B,A01,083756,Briones; Jor-el Thomas Caparas,1,0,36,35
1656824443689,MATH 20B,A02,083757,Briones; Jor-el Thomas Caparas,1,0,36,35
1656824443689,MATH 20B,A03,093475,Briones; Jor-el Thomas Caparas,0,0,36,36
1656824449719,MATH 20C,A01,083760,Briones; Jor-el Thomas Caparas,1,0,35,34
1656824449719,MATH 20C,A02,083761,Briones; Jor-el Thomas Caparas,8,0,35,27
1656824449719,MATH 20C,A03,093476,Briones; Jor-el Thomas Caparas,0,1,36,36
1656824449719,MATH 20C,B01,083762,Bach; Quang Tran,0,0,30,30
1656824455740,MATH 20D,A01,083765,Tran; Brian Kha,4,0,30,26
1656824455740,MATH 20D,A02,083766,Tran; Brian Kha,4,0,30,26
1656824455740,MATH 20D,A03,083767,Tran; Brian Kha,2,0,30,28
1656824461839,MATH 20E,A01,083771,Ganguly; Soumya,5,0,32,27
1656824461839,MATH 20E,A02,083772,Ganguly; Soumya,6,0,32,26
1656824461839,MATH 20E,B01,083773,Ciotti; Benjamin,18,0,35,17
1656824461839,MATH 20E,B02,083774,Ciotti; Benjamin,17,0,35,18
1656824467868,MATH 103A,A01,083777,Greenfeld; Be'Eri,2,0,36,34
1656824467868,MATH 103A,A02,083778,Greenfeld; Be'Eri,5,0,36,31
1656824467868,MATH 103A,A03,093561,Greenfeld; Be'Eri,4,0,36,32
1656824467868,MATH 103A,B01,083779,Greenfeld; Be'Eri,6,0,36,30
1656824467868,MATH 103A,B02,083780,Greenfeld; Be'Eri,2,0,36,34
1656824467868,MATH 103A,B03,093562,Greenfeld; Be'Eri,2,0,36,34
1656824473896,MATH 105,A01,085443,Carter; Anne Toulson,13,0,35,22
1656824473896,MATH 105,A02,093477,Carter; Anne Toulson,20,0,35,15
1656824479925,MATH 109,A01,083213,Ganzberger; Geoffrey Michael,2,0,34,32
1656824479925,MATH 109,A02,083214,Ganzberger; Geoffrey Michael,2,0,34,32
1656824479925,MATH 109,A03,093478,Ganzberger; Geoffrey Michael,1,0,34,33
1656824479925,MATH 109,B01,083215,Ganzberger; Geoffrey Michael,1,0,32,31
1656824479925,MATH 109,B02,083216,Ganzberger; Geoffrey Michael,1,0,32,31
1656824479925,MATH 109,B03,093479,Ganzberger; Geoffrey Michael,6,0,32,26
1656824485947,MATH 142A,A01,083219,Chow; Bennett,6,0,32,26
1656824485947,MATH 142A,A02,083220,Chow; Bennett,9,0,32,23
1656824485947,MATH 142A,A03,093480,Chow; Bennett,7,0,32,25
1656824485947,MATH 142A,B03,093481,Chow; Bennett,7,0,32,25
1656824485947,MATH 142A,B04,093558,Chow; Bennett,10,0,32,22
1656824485947,MATH 142A,B05,093559,Chow; Bennett,6,0,32,26
1656824491972,MATH 193A,A01,083224,Rotar; Vladimir,6,0,34,28
1656824491972,MATH 193A,A02,083225,Rotar; Vladimir,3,0,34,31
1656824491972,MATH 193A,A03,083781,Rotar; Vladimir,1,0,34,33
1656824491972,MATH 193A,A04,083782,Rotar; Vladimir,6,0,34,28
1656824491972,MATH 193A,A05,093482,Rotar; Vladimir,6,0,34,28
1656824498004,MATH 197,001,091859,McAuley; Julian John,9999,0,9999,0
1656824498004,MATH 197,002,095566,Kedlaya; Kiran S.,9997,0,9999,2
1656824498004,MATH 197,003,095567,Xiao; Ming,9999,0,9999,0
1656824498004,MATH 197,004,095571,Perols; Johan Lars,9998,0,9999,1
1656824505057,COGS 9,A01,083615,Shannon; Kyle Michael,6,0,75,69
1656824511085,COGS 11,A01,083617,Boyle; Mary E. T.,18,0,48,30
1656824517115,COGS 13,A01,083071,Bastos; Amalia Pinkusfeld,8,0,71,63
1656824523136,COGS 14A,A01,092681,Semenuks; Arturs,0,1,100,100
1656824529158,COGS 14B,A01,083073,Cheng; Tzu-Han,5,0,63,58
1656824535191,COGS 17,A01,092677,Semenuks; Arturs,4,0,81,77
1656824541213,COGS 100,A01,083619,Allen; Michael Gordon,15,0,70,55
1656824547234,COGS 101A,A01,083621,Davis; Joshua Daniel,9,0,68,59
1656824553257,COGS 101B,A01,091572,Allen; Michael Gordon,8,0,65,57
1656824559286,COGS 101C,A01,083625,Delgado; Tania,17,0,35,18
1656824565313,COGS 107A,A01,083627,Boyle; Mary E. T.,13,0,60,47
1656824571341,COGS 118A,A01,083075,Gupta; Anjum,15,0,76,61
1656824577367,CSE 3,A50,083646,Miranda; Gregory Joseph,22,0,50,28
1656824583392,CSE 8A,A50,083650,Miranda; Gregory Joseph,17,1,56,39
1656824589418,CSE 11,A01,083080,Cao; Yingjun,4,15,40,36
1656824595448,CSE 12,A01,083652,Krause-Levy; Sophia Louisa,20,1,120,100
1656824601469,CSE 15L,A01,083654,Morris; Justin Loren,8,0,50,42
1656824601469,CSE 15L,A02,083655,Morris; Justin Loren,8,0,50,42
1656824607494,CSE 20,A01,083657,Tran; Khoa Dang,37,0,80,43
1656824613518,CSE 21,A01,095574,Bach; Quang Tran,21,0,48,27
1656824619550,CSE 30,A01,083084,Eldon; John,4,0,80,76
1656824619550,CSE 30,B01,095061,Bhaskar; Nishant,6,0,50,44
1656824625577,CSE 100,A01,083659,Cao; Yingjun,1,4,70,69
1656824631600,CSE 134B,A01,083661,Powell; Thomas Allan,19,0,100,81
1656824637625,CSE 140,A01,083663,Gungor; Onat,14,0,85,71
1656824643652,CSE 140L,A01,083088,Eldon; John,16,0,100,84
1656824649673,CSE 175,A01,083665,Kumar; Rakesh,3,0,25,22
1656824655699,CSE 190,A00,092507,Dubnov; Shlomo,7,0,20,13
1656824661726,ECE 45,A01,083139,Congero; Spencer William,5,0,75,70
1656824667757,ECE 65,A50,083695,Saad; Andrew S,12,0,30,18
1656824667757,ECE 65,A51,095125,Saad; Andrew S,25,0,26,1
1656824673780,ECE 109,A01,091882,Touri; Behrouz,16,0,70,54
1656824679804,ECE 180,A00,083140,Abi Samra; Nicholas Camill,0,0,30,30
1656824679804,ECE 180,B00,083141,Abi Samra; Nicholas Camill,0,0,30,30
1656824685834,MATH 10A,A01,083735,Patchell; Gregory David,1,0,30,29
1656824685834,MATH 10A,A02,083736,Patchell; Gregory David,20,0,30,10
1656824685834,MATH 10A,A03,083737,Patchell; Gregory David,15,0,30,15
1656824691866,MATH 10B,A01,083207,Lim; Seonhee,7,0,34,27
1656824691866,MATH 10B,A02,083208,Lim; Seonhee,9,0,35,26
1656824691866,MATH 10B,A03,093472,Lim; Seonhee,4,0,34,30
1656824691866,MATH 10B,B01,083739,Sinha; Shubham,9,0,30,21
1656824697900,MATH 18,A01,083743,Cinel; Cameron Alexander,6,0,30,24
1656824697900,MATH 18,A02,083744,Cinel; Cameron Alexander,15,0,30,15
1656824697900,MATH 18,A03,083745,Cinel; Cameron Alexander,8,0,30,22
1656824697900,MATH 18,B01,083748,Rideout; David Porter,3,0,37,34
1656824697900,MATH 18,B02,083749,Rideout; David Porter,3,0,36,33
1656824697900,MATH 18,B03,083750,Rideout; David Porter,2,0,37,35
1656824697900,MATH 18,B04,083751,Rideout; David Porter,5,0,36,31
1656824697900,MATH 18,B05,093473,Rideout; David Porter,4,0,36,32
1656824697900,MATH 18,B06,093474,Rideout; David Porter,5,0,36,31
1656824703926,MATH 20A,A01,083754,Zheng; Zequn,12,0,40,28
1656824709954,MATH 20B,A01,083756,Briones; Jor-el Thomas Caparas,1,0,36,35
1656824709954,MATH 20B,A02,083757,Briones; Jor-el Thomas Caparas,1,0,36,35
1656824709954,MATH 20B,A03,093475,Briones; Jor-el Thomas Caparas,0,0,36,36
1656824715979,MATH 20C,A01,083760,Briones; Jor-el Thomas Caparas,1,0,35,34
1656824715979,MATH 20C,A02,083761,Briones; Jor-el Thomas Caparas,8,0,35,27
1656824715979,MATH 20C,A03,093476,Briones; Jor-el Thomas Caparas,0,1,36,36
1656824715979,MATH 20C,B01,083762,Bach; Quang Tran,0,0,30,30
1656824722007,MATH 20D,A01,083765,Tran; Brian Kha,4,0,30,26
1656824722007,MATH 20D,A02,083766,Tran; Brian Kha,4,0,30,26
1656824722007,MATH 20D,A03,083767,Tran; Brian Kha,2,0,30,28
1656824728035,MATH 20E,A01,083771,Ganguly; Soumya,5,0,32,27
1656824728035,MATH 20E,A02,083772,Ganguly; Soumya,6,0,32,26
1656824728035,MATH 20E,B01,083773,Ciotti; Benjamin,18,0,35,17
1656824728035,MATH 20E,B02,083774,Ciotti; Benjamin,17,0,35,18
1656824734057,MATH 103A,A01,083777,Greenfeld; Be'Eri,2,0,36,34
1656824734057,MATH 103A,A02,083778,Greenfeld; Be'Eri,5,0,36,31
1656824734057,MATH 103A,A03,093561,Greenfeld; Be'Eri,4,0,36,32
1656824734057,MATH 103A,B01,083779,Greenfeld; Be'Eri,6,0,36,30
1656824734057,MATH 103A,B02,083780,Greenfeld; Be'Eri,2,0,36,34
1656824734057,MATH 103A,B03,093562,Greenfeld; Be'Eri,2,0,36,34
1656824740080,MATH 105,A01,085443,Carter; Anne Toulson,13,0,35,22
1656824740080,MATH 105,A02,093477,Carter; Anne Toulson,20,0,35,15
1656824746117,MATH 109,A01,083213,Ganzberger; Geoffrey Michael,2,0,34,32
1656824746117,MATH 109,A02,083214,Ganzberger; Geoffrey Michael,2,0,34,32
1656824746117,MATH 109,A03,093478,Ganzberger; Geoffrey Michael,1,0,34,33
1656824746117,MATH 109,B01,083215,Ganzberger; Geoffrey Michael,1,0,32,31
1656824746117,MATH 109,B02,083216,Ganzberger; Geoffrey Michael,1,0,32,31
1656824746117,MATH 109,B03,093479,Ganzberger; Geoffrey Michael,6,0,32,26
1656824752147,MATH 142A,A01,083219,Chow; Bennett,6,0,32,26
1656824752147,MATH 142A,A02,083220,Chow; Bennett,9,0,32,23
1656824752147,MATH 142A,A03,093480,Chow; Bennett,7,0,32,25
1656824752147,MATH 142A,B03,093481,Chow; Bennett,7,0,32,25
1656824752147,MATH 142A,B04,093558,Chow; Bennett,10,0,32,22
1656824752147,MATH 142A,B05,093559,Chow; Bennett,6,0,32,26
1656824758171,MATH 193A,A01,083224,Rotar; Vladimir,6,0,34,28
1656824758171,MATH 193A,A02,083225,Rotar; Vladimir,3,0,34,31
1656824758171,MATH 193A,A03,083781,Rotar; Vladimir,1,0,34,33
1656824758171,MATH 193A,A04,083782,Rotar; Vladimir,6,0,34,28
1656824758171,MATH 193A,A05,093482,Rotar; Vladimir,6,0,34,28
1656824764193,MATH 197,001,091859,McAuley; Julian John,9999,0,9999,0
1656824764193,MATH 197,002,095566,Kedlaya; Kiran S.,9997,0,9999,2
1656824764193,MATH 197,003,095567,Xiao; Ming,9999,0,9999,0
1656824764193,MATH 197,004,095571,Perols; Johan Lars,9998,0,9999,1
1656824771251,COGS 9,A01,083615,Shannon; Kyle Michael,6,0,75,69
1656824777286,COGS 11,A01,083617,Boyle; Mary E. T.,18,0,48,30
1656824783309,COGS 13,A01,083071,Bastos; Amalia Pinkusfeld,8,0,71,63
1656824789335,COGS 14A,A01,092681,Semenuks; Arturs,0,1,100,100
1656824795361,COGS 14B,A01,083073,Cheng; Tzu-Han,5,0,63,58
1656824801386,COGS 17,A01,092677,Semenuks; Arturs,4,0,81,77
1656824807412,COGS 100,A01,083619,Allen; Michael Gordon,15,0,70,55
1656824813437,COGS 101A,A01,083621,Davis; Joshua Daniel,9,0,68,59
1656824819461,COGS 101B,A01,091572,Allen; Michael Gordon,8,0,65,57
1656824825488,COGS 101C,A01,083625,Delgado; Tania,17,0,35,18
1656824831515,COGS 107A,A01,083627,Boyle; Mary E. T.,13,0,60,47
1656824837537,COGS 118A,A01,083075,Gupta; Anjum,15,0,76,61
1656824843565,CSE 3,A50,083646,Miranda; Gregory Joseph,22,0,50,28
1656824849588,CSE 8A,A50,083650,Miranda; Gregory Joseph,17,1,56,39
1656824855617,CSE 11,A01,083080,Cao; Yingjun,4,15,40,36
1656824861645,CSE 12,A01,083652,Krause-Levy; Sophia Louisa,20,1,120,100
1656824867676,CSE 15L,A01,083654,Morris; Justin Loren,8,0,50,42
1656824867676,CSE 15L,A02,083655,Morris; Justin Loren,8,0,50,42
1656824873700,CSE 20,A01,083657,Tran; Khoa Dang,37,0,80,43
1656824879722,CSE 21,A01,095574,Bach; Quang Tran,21,0,48,27
1656824885757,CSE 30,A01,083084,Eldon; John,4,0,80,76
1656824885757,CSE 30,B01,095061,Bhaskar; Nishant,6,0,50,44
1656824891786,CSE 100,A01,083659,Cao; Yingjun,1,4,70,69
1656824897808,CSE 134B,A01,083661,Powell; Thomas Allan,19,0,100,81
1656824903834,CSE 140,A01,083663,Gungor; Onat,14,0,85,71
1656824909862,CSE 140L,A01,083088,Eldon; John,16,0,100,84
1656824915888,CSE 175,A01,083665,Kumar; Rakesh,3,0,25,22
1656824921911,CSE 190,A00,092507,Dubnov; Shlomo,7,0,20,13
1656824927939,ECE 45,A01,083139,Congero; Spencer William,5,0,75,70
1656824933967,ECE 65,A50,083695,Saad; Andrew S,12,0,30,18
1656824933967,ECE 65,A51,095125,Saad; Andrew S,25,0,26,1
1656824939991,ECE 109,A01,091882,Touri; Behrouz,16,0,70,54
1656824946014,ECE 180,A00,083140,Abi Samra; Nicholas Camill,0,0,30,30
1656824946014,ECE 180,B00,083141,Abi Samra; Nicholas Camill,0,0,30,30
1656824952037,MATH 10A,A01,083735,Patchell; Gregory David,1,0,30,29
1656824952037,MATH 10A,A02,083736,Patchell; Gregory David,20,0,30,10
1656824952037,MATH 10A,A03,083737,Patchell; Gregory David,15,0,30,15
1656824958060,MATH 10B,A01,083207,Lim; Seonhee,7,0,34,27
1656824958060,MATH 10B,A02,083208,Lim; Seonhee,9,0,35,26
1656824958060,MATH 10B,A03,093472,Lim; Seonhee,4,0,34,30
1656824958060,MATH 10B,B01,083739,Sinha; Shubham,9,0,30,21
1656824964090,MATH 18,A01,083743,Cinel; Cameron Alexander,6,0,30,24
1656824964090,MATH 18,A02,083744,Cinel; Cameron Alexander,15,0,30,15
1656824964090,MATH 18,A03,083745,Cinel; Cameron Alexander,8,0,30,22
1656824964090,MATH 18,B01,083748,Rideout; David Porter,3,0,37,34
1656824964090,MATH 18,B02,083749,Rideout; David Porter,3,0,36,33
1656824964090,MATH 18,B03,083750,Rideout; David Porter,2,0,37,35
1656824964090,MATH 18,B04,083751,Rideout; David Porter,5,0,36,31
1656824964090,MATH 18,B05,093473,Rideout; David Porter,4,0,36,32
1656824964090,MATH 18,B06,093474,Rideout; David Porter,5,0,36,31
1656824970117,MATH 20A,A01,083754,Zheng; Zequn,12,0,40,28
1656824976143,MATH 20B,A01,083756,Briones; Jor-el Thomas Caparas,1,0,36,35
1656824976143,MATH 20B,A02,083757,Briones; Jor-el Thomas Caparas,1,0,36,35
1656824976143,MATH 20B,A03,093475,Briones; Jor-el Thomas Caparas,0,0,36,36
1656824982172,MATH 20C,A01,083760,Briones; Jor-el Thomas Caparas,1,0,35,34
1656824982172,MATH 20C,A02,083761,Briones; Jor-el Thomas Caparas,8,0,35,27
1656824982172,MATH 20C,A03,093476,Briones; Jor-el Thomas Caparas,0,1,36,36
1656824982172,MATH 20C,B01,083762,Bach; Quang Tran,0,0,30,30
1656824988194,MATH 20D,A01,083765,Tran; Brian Kha,4,0,30,26
1656824988194,MATH 20D,A02,083766,Tran; Brian Kha,4,0,30,26
1656824988194,MATH 20D,A03,083767,Tran; Brian Kha,2,0,30,28
1656824994229,MATH 20E,A01,083771,Ganguly; Soumya,5,0,32,27
1656824994229,MATH 20E,A02,083772,Ganguly; Soumya,6,0,32,26
1656824994229,MATH 20E,B01,083773,Ciotti; Benjamin,18,0,35,17
1656824994229,MATH 20E,B02,083774,Ciotti; Benjamin,17,0,35,18
1656825000258,MATH 103A,A01,083777,Greenfeld; Be'Eri,2,0,36,34
1656825000258,MATH 103A,A02,083778,Greenfeld; Be'Eri,5,0,36,31
1656825000258,MATH 103A,A03,093561,Greenfeld; Be'Eri,4,0,36,32
1656825000258,MATH 103A,B01,083779,Greenfeld; Be'Eri,6,0,36,30
1656825000258,MATH 103A,B02,083780,Greenfeld; Be'Eri,2,0,36,34
1656825000258,MATH 103A,B03,093562,Greenfeld; Be'Eri,2,0,36,34
1656825006281,MATH 105,A01,085443,Carter; Anne Toulson,13,0,35,22
1656825006281,MATH 105,A02,093477,Carter; Anne Toulson,20,0,35,15
1656825012310,MATH 109,A01,083213,Ganzberger; Geoffrey Michael,2,0,34,32
1656825012310,MATH 109,A02,083214,Ganzberger; Geoffrey Michael,2,0,34,32
1656825012310,MATH 109,A03,093478,Ganzberger; Geoffrey Michael,1,0,34,33
1656825012310,MATH 109,B01,083215,Ganzberger; Geoffrey Michael,1,0,32,31
1656825012310,MATH 109,B02,083216,Ganzberger; Geoffrey Michael,1,0,32,31
1656825012310,MATH 109,B03,093479,Ganzberger; Geoffrey Michael,6,0,32,26
1656825018340,MATH 142A,A01,083219,Chow; Bennett,6,0,32,26
1656825018340,MATH 142A,A02,083220,Chow; Bennett,9,0,32,23
1656825018340,MATH 142A,A03,093480,Chow; Bennett,7,0,32,25
1656825018340,MATH 142A,B03,093481,Chow; Bennett,7,0,32,25
1656825018340,MATH 142A,B04,093558,Chow; Bennett,10,0,32,22
1656825018340,MATH 142A,B05,093559,Chow; Bennett,6,0,32,26
1656825024364,MATH 193A,A01,083224,Rotar; Vladimir,6,0,34,28
1656825024364,MATH 193A,A02,083225,Rotar; Vladimir,3,0,34,31
1656825024364,MATH 193A,A03,083781,Rotar; Vladimir,1,0,34,33
1656825024364,MATH 193A,A04,083782,Rotar; Vladimir,6,0,34,28
1656825024364,MATH 193A,A05,093482,Rotar; Vladimir,6,0,34,28
1656825030390,MATH 197,001,091859,McAuley; Julian John,9999,0,9999,0
1656825030390,MATH 197,002,095566,Kedlaya; Kiran S.,9997,0,9999,2
1656825030390,MATH 197,003,095567,Xiao; Ming,9999,0,9999,0
1656825030390,MATH 197,004,095571,Perols; Johan Lars,9998,0,9999,1
1656825037456,COGS 9,A01,083615,Shannon; Kyle Michael,6,0,75,69
1656825043485,COGS 11,A01,083617,Boyle; Mary E. T.,18,0,48,30
1656825049507,COGS 13,A01,083071,Bastos; Amalia Pinkusfeld,8,0,71,63
1656825055606,COGS 14A,A01,092681,Semenuks; Arturs,0,1,100,100
1656825061633,COGS 14B,A01,083073,Cheng; Tzu-Han,5,0,63,58
1656825067678,COGS 17,A01,092677,Semenuks; Arturs,4,0,81,77
1656825073701,COGS 100,A01,083619,Allen; Michael Gordon,15,0,70,55
1656825079723,COGS 101A,A01,083621,Davis; Joshua Daniel,9,0,68,59
1656825085747,COGS 101B,A01,091572,Allen; Michael Gordon,8,0,65,57
1656825091768,COGS 101C,A01,083625,Delgado; Tania,17,0,35,18
1656825097800,COGS 107A,A01,083627,Boyle; Mary E. T.,13,0,60,47
1656825103825,COGS 118A,A01,083075,Gupta; Anjum,15,0,76,61
1656825109852,CSE 3,A50,083646,Miranda; Gregory Joseph,22,0,50,28
1656825115880,CSE 8A,A50,083650,Miranda; Gregory Joseph,17,1,56,39
1656825121905,CSE 11,A01,083080,Cao; Yingjun,4,15,40,36
1656825127927,CSE 12,A01,083652,Krause-Levy; Sophia Louisa,20,1,120,100
1656825133950,CSE 15L,A01,083654,Morris; Justin Loren,8,0,50,42
1656825133950,CSE 15L,A02,083655,Morris; Justin Loren,8,0,50,42
1656825139973,CSE 20,A01,083657,Tran; Khoa Dang,37,0,80,43
1656825145998,CSE 21,A01,095574,Bach; Quang Tran,21,0,48,27
1656825152025,CSE 30,A01,083084,Eldon; John,4,0,80,76
1656825152025,CSE 30,B01,095061,Bhaskar; Nishant,6,0,50,44
1656825158049,CSE 100,A01,083659,Cao; Yingjun,2,4,70,68
1656825164071,CSE 134B,A01,083661,Powell; Thomas Allan,19,0,100,81
1656825170099,CSE 140,A01,083663,Gungor; Onat,14,0,85,71
1656825176126,CSE 140L,A01,083088,Eldon; John,16,0,100,84
1656825182149,CSE 175,A01,083665,Kumar; Rakesh,3,0,25,22
1656825188172,CSE 190,A00,092507,Dubnov; Shlomo,7,0,20,13
1656825194194,ECE 45,A01,083139,Congero; Spencer William,5,0,75,70
1656825200222,ECE 65,A50,083695,Saad; Andrew S,12,0,30,18
1656825200222,ECE 65,A51,095125,Saad; Andrew S,25,0,26,1
1656825206252,ECE 109,A01,091882,Touri; Behrouz,16,0,70,54
1656825212276,ECE 180,A00,083140,Abi Samra; Nicholas Camill,0,0,30,30
1656825212276,ECE 180,B00,083141,Abi Samra; Nicholas Camill,0,0,30,30
1656825218311,MATH 10A,A01,083735,Patchell; Gregory David,1,0,30,29
1656825218311,MATH 10A,A02,083736,Patchell; Gregory David,20,0,30,10
1656825218311,MATH 10A,A03,083737,Patchell; Gregory David,15,0,30,15
1656825224336,MATH 10B,A01,083207,Lim; Seonhee,7,0,34,27
1656825224336,MATH 10B,A02,083208,Lim; Seonhee,9,0,35,26
1656825224336,MATH 10B,A03,093472,Lim; Seonhee,4,0,34,30
1656825224336,MATH 10B,B01,083739,Sinha; Shubham,9,0,30,21
1656825230368,MATH 18,A01,083743,Cinel; Cameron Alexander,6,0,30,24
1656825230368,MATH 18,A02,083744,Cinel; Cameron Alexander,15,0,30,15
1656825230368,MATH 18,A03,083745,Cinel; Cameron Alexander,8,0,30,22
1656825230368,MATH 18,B01,083748,Rideout; David Porter,3,0,37,34
1656825230368,MATH 18,B02,083749,Rideout; David Porter,3,0,36,33
1656825230368,MATH 18,B03,083750,Rideout; David Porter,2,0,37,35
1656825230368,MATH 18,B04,083751,Rideout; David Porter,5,0,36,31
1656825230368,MATH 18,B05,093473,Rideout; David Porter,4,0,36,32
1656825230368,MATH 18,B06,093474,Rideout; David Porter,5,0,36,31
1656825236407,MATH 20A,A01,083754,Zheng; Zequn,12,0,40,28
1656825242435,MATH 20B,A01,083756,Briones; Jor-el Thomas Caparas,1,0,36,35
1656825242435,MATH 20B,A02,083757,Briones; Jor-el Thomas Caparas,1,0,36,35
1656825242435,MATH 20B,A03,093475,Briones; Jor-el Thomas Caparas,0,0,36,36
1656825248459,MATH 20C,A01,083760,Briones; Jor-el Thomas Caparas,1,0,35,34
1656825248459,MATH 20C,A02,083761,Briones; Jor-el Thomas Caparas,8,0,35,27
1656825248459,MATH 20C,A03,093476,Briones; Jor-el Thomas Caparas,0,1,36,36
1656825248459,MATH 20C,B01,083762,Bach; Quang Tran,0,0,30,30
1656825254486,MATH 20D,A01,083765,Tran; Brian Kha,4,0,30,26
1656825254486,MATH 20D,A02,083766,Tran; Brian Kha,4,0,30,26
1656825254486,MATH 20D,A03,083767,Tran; Brian Kha,2,0,30,28
1656825260509,MATH 20E,A01,083771,Ganguly; Soumya,5,0,32,27
1656825260509,MATH 20E,A02,083772,Ganguly; Soumya,6,0,32,26
1656825260509,MATH 20E,B01,083773,Ciotti; Benjamin,18,0,35,17
1656825260509,MATH 20E,B02,083774,Ciotti; Benjamin,17,0,35,18
1656825266533,MATH 103A,A01,083777,Greenfeld; Be'Eri,2,0,36,34
1656825266533,MATH 103A,A02,083778,Greenfeld; Be'Eri,5,0,36,31
1656825266533,MATH 103A,A03,093561,Greenfeld; Be'Eri,4,0,36,32
1656825266533,MATH 103A,B01,083779,Greenfeld; Be'Eri,6,0,36,30
1656825266533,MATH 103A,B02,083780,Greenfeld; Be'Eri,2,0,36,34
1656825266533,MATH 103A,B03,093562,Greenfeld; Be'Eri,2,0,36,34
1656825272557,MATH 105,A01,085443,Carter; Anne Toulson,13,0,35,22
1656825272557,MATH 105,A02,093477,Carter; Anne Toulson,20,0,35,15
1656825278582,MATH 109,A01,083213,Ganzberger; Geoffrey Michael,2,0,34,32
1656825278582,MATH 109,A02,083214,Ganzberger; Geoffrey Michael,2,0,34,32
1656825278582,MATH 109,A03,093478,Ganzberger; Geoffrey Michael,1,0,34,33
1656825278582,MATH 109,B01,083215,Ganzberger; Geoffrey Michael,1,0,32,31
1656825278582,MATH 109,B02,083216,Ganzberger; Geoffrey Michael,1,0,32,31
1656825278582,MATH 109,B03,093479,Ganzberger; Geoffrey Michael,6,0,32,26
1656825284605,MATH 142A,A01,083219,Chow; Bennett,6,0,32,26
1656825284605,MATH 142A,A02,083220,Chow; Bennett,9,0,32,23
1656825284605,MATH 142A,A03,093480,Chow; Bennett,7,0,32,25
1656825284605,MATH 142A,B03,093481,Chow; Bennett,7,0,32,25
1656825284605,MATH 142A,B04,093558,Chow; Bennett,10,0,32,22
1656825284605,MATH 142A,B05,093559,Chow; Bennett,6,0,32,26
1656825290630,MATH 193A,A01,083224,Rotar; Vladimir,6,0,34,28
1656825290630,MATH 193A,A02,083225,Rotar; Vladimir,3,0,34,31
1656825290630,MATH 193A,A03,083781,Rotar; Vladimir,1,0,34,33
1656825290630,MATH 193A,A04,083782,Rotar; Vladimir,6,0,34,28
1656825290630,MATH 193A,A05,093482,Rotar; Vladimir,6,0,34,28
1656825296652,MATH 197,001,091859,McAuley; Julian John,9999,0,9999,0
1656825296652,MATH 197,002,095566,Kedlaya; Kiran S.,9997,0,9999,2
1656825296652,MATH 197,003,095567,Xiao; Ming,9999,0,9999,0
1656825296652,MATH 197,004,095571,Perols; Johan Lars,9998,0,9999,1
1656825303710,COGS 9,A01,083615,Shannon; Kyle Michael,6,0,75,69
1656825309732,COGS 11,A01,083617,Boyle; Mary E. T.,18,0,48,30
1656825315759,COGS 13,A01,083071,Bastos; Amalia Pinkusfeld,8,0,71,63
1656825321791,COGS 14A,A01,092681,Semenuks; Arturs,0,1,100,100
1656825327818,COGS 14B,A01,083073,Cheng; Tzu-Han,5,0,63,58
1656825333851,COGS 17,A01,092677,Semenuks; Arturs,4,0,81,77
1656825339874,COGS 100,A01,083619,Allen; Michael Gordon,15,0,70,55
1656825345901,COGS 101A,A01,083621,Davis; Joshua Daniel,9,0,68,59
1656825351931,COGS 101B,A01,091572,Allen; Michael Gordon,8,0,65,57
1656825357955,COGS 101C,A01,083625,Delgado; Tania,17,0,35,18
1656825363982,COGS 107A,A01,083627,Boyle; Mary E. T.,13,0,60,47
1656825370009,COGS 118A,A01,083075,Gupta; Anjum,15,0,76,61
1656825376032,CSE 3,A50,083646,Miranda; Gregory Joseph,22,0,50,28
1656825382065,CSE 8A,A50,083650,Miranda; Gregory Joseph,17,1,56,39
1656825388098,CSE 11,A01,083080,Cao; Yingjun,4,15,40,36
1656825394121,CSE 12,A01,083652,Krause-Levy; Sophia Louisa,20,1,120,100
1656825400144,CSE 15L,A01,083654,Morris; Justin Loren,8,0,50,42
1656825400144,CSE 15L,A02,083655,Morris; Justin Loren,8,0,50,42
1656825406171,CSE 20,A01,083657,Tran; Khoa Dang,37,0,80,43
1656825412194,CSE 21,A01,095574,Bach; Quang Tran,21,0,48,27
1656825418219,CSE 30,A01,083084,Eldon; John,4,0,80,76
1656825418219,CSE 30,B01,095061,Bhaskar; Nishant,6,0,50,44
1656825424242,CSE 100,A01,083659,Cao; Yingjun,2,4,70,68
1656825430271,CSE 134B,A01,083661,Powell; Thomas Allan,19,0,100,81
1656825436294,CSE 140,A01,083663,Gungor; Onat,14,0,85,71
1656825442319,CSE 140L,A01,083088,Eldon; John,16,0,100,84
1656825448343,CSE 175,A01,083665,Kumar; Rakesh,3,0,25,22
1656825462396,CSE 190,A00,092507,Dubnov; Shlomo,7,0,20,13
1656825468424,ECE 45,A01,083139,Congero; Spencer William,5,0,75,70
1656825474446,ECE 65,A50,083695,Saad; Andrew S,12,0,30,18
1656825474446,ECE 65,A51,095125,Saad; Andrew S,25,0,26,1
1656825480470,ECE 109,A01,091882,Touri; Behrouz,16,0,70,54
1656825486496,ECE 180,A00,083140,Abi Samra; Nicholas Camill,0,0,30,30
1656825486496,ECE 180,B00,083141,Abi Samra; Nicholas Camill,0,0,30,30
1656825492520,MATH 10A,A01,083735,Patchell; Gregory David,1,0,30,29
1656825492520,MATH 10A,A02,083736,Patchell; Gregory David,20,0,30,10
1656825492520,MATH 10A,A03,083737,Patchell; Gregory David,15,0,30,15
1656825498550,MATH 10B,A01,083207,Lim; Seonhee,7,0,34,27
1656825498550,MATH 10B,A02,083208,Lim; Seonhee,9,0,35,26
1656825498550,MATH 10B,A03,093472,Lim; Seonhee,4,0,34,30
1656825498550,MATH 10B,B01,083739,Sinha; Shubham,9,0,30,21
1656825504576,MATH 18,A01,083743,Cinel; Cameron Alexander,6,0,30,24
1656825504576,MATH 18,A02,083744,Cinel; Cameron Alexander,15,0,30,15
1656825504576,MATH 18,A03,083745,Cinel; Cameron Alexander,8,0,30,22
1656825504576,MATH 18,B01,083748,Rideout; David Porter,3,0,37,34
1656825504576,MATH 18,B02,083749,Rideout; David Porter,3,0,36,33
1656825504576,MATH 18,B03,083750,Rideout; David Porter,2,0,37,35
1656825504576,MATH 18,B04,083751,Rideout; David Porter,5,0,36,31
1656825504576,MATH 18,B05,093473,Rideout; David Porter,4,0,36,32
1656825504576,MATH 18,B06,093474,Rideout; David Porter,5,0,36,31
1656825510598,MATH 20A,A01,083754,Zheng; Zequn,12,0,40,28
1656825516629,MATH 20B,A01,083756,Briones; Jor-el Thomas Caparas,1,0,36,35
1656825516629,MATH 20B,A02,083757,Briones; Jor-el Thomas Caparas,1,0,36,35
1656825516629,MATH 20B,A03,093475,Briones; Jor-el Thomas Caparas,0,0,36,36
1656825522660,MATH 20C,A01,083760,Briones; Jor-el Thomas Caparas,1,0,35,34
1656825522660,MATH 20C,A02,083761,Briones; Jor-el Thomas Caparas,8,0,35,27
1656825522660,MATH 20C,A03,093476,Briones; Jor-el Thomas Caparas,0,1,36,36
1656825522660,MATH 20C,B01,083762,Bach; Quang Tran,0,0,30,30
1656825528688,MATH 20D,A01,083765,Tran; Brian Kha,4,0,30,26
1656825528688,MATH 20D,A02,083766,Tran; Brian Kha,4,0,30,26
1656825528688,MATH 20D,A03,083767,Tran; Brian Kha,2,0,30,28
1656825534713,MATH 20E,A01,083771,Ganguly; Soumya,5,0,32,27
1656825534713,MATH 20E,A02,083772,Ganguly; Soumya,6,0,32,26
1656825534713,MATH 20E,B01,083773,Ciotti; Benjamin,18,0,35,17
1656825534713,MATH 20E,B02,083774,Ciotti; Benjamin,17,0,35,18
1656825540745,MATH 103A,A01,083777,Greenfeld; Be'Eri,2,0,36,34
1656825540745,MATH 103A,A02,083778,Greenfeld; Be'Eri,5,0,36,31
1656825540745,MATH 103A,A03,093561,Greenfeld; Be'Eri,4,0,36,32
1656825540745,MATH 103A,B01,083779,Greenfeld; Be'Eri,6,0,36,30
1656825540745,MATH 103A,B02,083780,Greenfeld; Be'Eri,2,0,36,34
1656825540745,MATH 103A,B03,093562,Greenfeld; Be'Eri,2,0,36,34
1656825546767,MATH 105,A01,085443,Carter; Anne Toulson,13,0,35,22
1656825546767,MATH 105,A02,093477,Carter; Anne Toulson,20,0,35,15
1656825552795,MATH 109,A01,083213,Ganzberger; Geoffrey Michael,2,0,34,32
1656825552795,MATH 109,A02,083214,Ganzberger; Geoffrey Michael,2,0,34,32
1656825552795,MATH 109,A03,093478,Ganzberger; Geoffrey Michael,1,0,34,33
1656825552795,MATH 109,B01,083215,Ganzberger; Geoffrey Michael,1,0,32,31
1656825552795,MATH 109,B02,083216,Ganzberger; Geoffrey Michael,1,0,32,31
1656825552795,MATH 109,B03,093479,Ganzberger; Geoffrey Michael,6,0,32,26
1656825558820,MATH 142A,A01,083219,Chow; Bennett,6,0,32,26
1656825558820,MATH 142A,A02,083220,Chow; Bennett,9,0,32,23
1656825558820,MATH 142A,A03,093480,Chow; Bennett,7,0,32,25
1656825558820,MATH 142A,B03,093481,Chow; Bennett,7,0,32,25
1656825558820,MATH 142A,B04,093558,Chow; Bennett,10,0,32,22
1656825558820,MATH 142A,B05,093559,Chow; Bennett,6,0,32,26
1656825564844,MATH 193A,A01,083224,Rotar; Vladimir,6,0,34,28
1656825564844,MATH 193A,A02,083225,Rotar; Vladimir,3,0,34,31
1656825564844,MATH 193A,A03,083781,Rotar; Vladimir,1,0,34,33
1656825564844,MATH 193A,A04,083782,Rotar; Vladimir,6,0,34,28
1656825564844,MATH 193A,A05,093482,Rotar; Vladimir,6,0,34,28
1656825570871,MATH 197,001,091859,McAuley; Julian John,9999,0,9999,0
1656825570871,MATH 197,002,095566,Kedlaya; Kiran S.,9997,0,9999,2
1656825570871,MATH 197,003,095567,Xiao; Ming,9999,0,9999,0
1656825570871,MATH 197,004,095571,Perols; Johan Lars,9998,0,9999,1
1656825577941,COGS 9,A01,083615,Shannon; Kyle Michael,6,0,75,69
1656825583966,COGS 11,A01,083617,Boyle; Mary E. T.,18,0,48,30
1656825589989,COGS 13,A01,083071,Bastos; Amalia Pinkusfeld,8,0,71,63
1656825596017,COGS 14A,A01,092681,Semenuks; Arturs,0,1,100,100
1656825602043,COGS 14B,A01,083073,Cheng; Tzu-Han,5,0,63,58
1656825608071,COGS 17,A01,092677,Semenuks; Arturs,4,0,81,77
1656825614095,COGS 100,A01,083619,Allen; Michael Gordon,15,0,70,55
1656825620118,COGS 101A,A01,083621,Davis; Joshua Daniel,9,0,68,59
1656825626140,COGS 101B,A01,091572,Allen; Michael Gordon,8,0,65,57
1656825632164,COGS 101C,A01,083625,Delgado; Tania,17,0,35,18
1656825638190,COGS 107A,A01,083627,Boyle; Mary E. T.,13,0,60,47
1656825644214,COGS 118A,A01,083075,Gupta; Anjum,15,0,76,61
1656825650237,CSE 3,A50,083646,Miranda; Gregory Joseph,22,0,50,28
1656825656262,CSE 8A,A50,083650,Miranda; Gregory Joseph,17,1,56,39
1656825662359,CSE 11,A01,083080,Cao; Yingjun,4,15,40,36
1656825668382,CSE 12,A01,083652,Krause-Levy; Sophia Louisa,20,1,120,100
1656825674405,CSE 15L,A01,083654,Morris; Justin Loren,8,0,50,42
1656825674405,CSE 15L,A02,083655,Morris; Justin Loren,8,0,50,42
1656825680451,CSE 20,A01,083657,Tran; Khoa Dang,37,0,80,43
1656825686475,CSE 21,A01,095574,Bach; Quang Tran,21,0,48,27
1656825692498,CSE 30,A01,083084,Eldon; John,4,0,80,76
1656825692498,CSE 30,B01,095061,Bhaskar; Nishant,6,0,50,44
1656825698525,CSE 100,A01,083659,Cao; Yingjun,2,4,70,68
1656825704554,CSE 134B,A01,083661,Powell; Thomas Allan,19,0,100,81
1656825710579,CSE 140,A01,083663,Gungor; Onat,14,0,85,71
1656825716603,CSE 140L,A01,083088,Eldon; John,16,0,100,84
1656825722625,CSE 175,A01,083665,Kumar; Rakesh,3,0,25,22
1656825728647,CSE 190,A00,092507,Dubnov; Shlomo,7,0,20,13
1656825734670,ECE 45,A01,083139,Congero; Spencer William,5,0,75,70
1656825740694,ECE 65,A50,083695,Saad; Andrew S,12,0,30,18
1656825740694,ECE 65,A51,095125,Saad; Andrew S,25,0,26,1
1656825746716,ECE 109,A01,091882,Touri; Behrouz,16,0,70,54
1656825752744,ECE 180,A00,083140,Abi Samra; Nicholas Camill,0,0,30,30
1656825752744,ECE 180,B00,083141,Abi Samra; Nicholas Camill,0,0,30,30
1656825758767,MATH 10A,A01,083735,Patchell; Gregory David,1,0,30,29
1656825758767,MATH 10A,A02,083736,Patchell; Gregory David,20,0,30,10
1656825758767,MATH 10A,A03,083737,Patchell; Gregory David,15,0,30,15
1656825764797,MATH 10B,A01,083207,Lim; Seonhee,7,0,34,27
1656825764797,MATH 10B,A02,083208,Lim; Seonhee,9,0,35,26
1656825764797,MATH 10B,A03,093472,Lim; Seonhee,4,0,34,30
1656825764797,MATH 10B,B01,083739,Sinha; Shubham,9,0,30,21
1656825770828,MATH 18,A01,083743,Cinel; Cameron Alexander,6,0,30,24
1656825770828,MATH 18,A02,083744,Cinel; Cameron Alexander,15,0,30,15
1656825770828,MATH 18,A03,083745,Cinel; Cameron Alexander,8,0,30,22
1656825770828,MATH 18,B01,083748,Rideout; David Porter,3,0,37,34
1656825770828,MATH 18,B02,083749,Rideout; David Porter,3,0,36,33
1656825770828,MATH 18,B03,083750,Rideout; David Porter,2,0,37,35
1656825770828,MATH 18,B04,083751,Rideout; David Porter,5,0,36,31
1656825770828,MATH 18,B05,093473,Rideout; David Porter,4,0,36,32
1656825770828,MATH 18,B06,093474,Rideout; David Porter,5,0,36,31
1656825776855,MATH 20A,A01,083754,Zheng; Zequn,12,0,40,28
1656825782883,MATH 20B,A01,083756,Briones; Jor-el Thomas Caparas,1,0,36,35
1656825782883,MATH 20B,A02,083757,Briones; Jor-el Thomas Caparas,1,0,36,35
1656825782883,MATH 20B,A03,093475,Briones; Jor-el Thomas Caparas,0,0,36,36
1656825788912,MATH 20C,A01,083760,Briones; Jor-el Thomas Caparas,1,0,35,34
1656825788912,MATH 20C,A02,083761,Briones; Jor-el Thomas Caparas,8,0,35,27
1656825788912,MATH 20C,A03,093476,Briones; Jor-el Thomas Caparas,0,1,36,36
1656825788912,MATH 20C,B01,083762,Bach; Quang Tran,0,0,30,30
1656825794935,MATH 20D,A01,083765,Tran; Brian Kha,4,0,30,26
1656825794935,MATH 20D,A02,083766,Tran; Brian Kha,4,0,30,26
1656825794935,MATH 20D,A03,083767,Tran; Brian Kha,2,0,30,28
1656825800957,MATH 20E,A01,083771,Ganguly; Soumya,5,0,32,27
1656825800957,MATH 20E,A02,083772,Ganguly; Soumya,6,0,32,26
1656825800957,MATH 20E,B01,083773,Ciotti; Benjamin,18,0,35,17
1656825800957,MATH 20E,B02,083774,Ciotti; Benjamin,17,0,35,18
1656825806987,MATH 103A,A01,083777,Greenfeld; Be'Eri,2,0,36,34
1656825806987,MATH 103A,A02,083778,Greenfeld; Be'Eri,5,0,36,31
1656825806987,MATH 103A,A03,093561,Greenfeld; Be'Eri,4,0,36,32
1656825806987,MATH 103A,B01,083779,Greenfeld; Be'Eri,6,0,36,30
1656825806987,MATH 103A,B02,083780,Greenfeld; Be'Eri,2,0,36,34
1656825806987,MATH 103A,B03,093562,Greenfeld; Be'Eri,2,0,36,34
1656825813015,MATH 105,A01,085443,Carter; Anne Toulson,13,0,35,22
1656825813015,MATH 105,A02,093477,Carter; Anne Toulson,20,0,35,15
1656825819041,MATH 109,A01,083213,Ganzberger; Geoffrey Michael,2,0,34,32
1656825819041,MATH 109,A02,083214,Ganzberger; Geoffrey Michael,2,0,34,32
1656825819041,MATH 109,A03,093478,Ganzberger; Geoffrey Michael,1,0,34,33
1656825819041,MATH 109,B01,083215,Ganzberger; Geoffrey Michael,1,0,32,31
1656825819041,MATH 109,B02,083216,Ganzberger; Geoffrey Michael,1,0,32,31
1656825819041,MATH 109,B03,093479,Ganzberger; Geoffrey Michael,6,0,32,26
1656825825070,MATH 142A,A01,083219,Chow; Bennett,6,0,32,26
1656825825070,MATH 142A,A02,083220,Chow; Bennett,9,0,32,23
1656825825070,MATH 142A,A03,093480,Chow; Bennett,7,0,32,25
1656825825070,MATH 142A,B03,093481,Chow; Bennett,7,0,32,25
1656825825070,MATH 142A,B04,093558,Chow; Bennett,10,0,32,22
1656825825070,MATH 142A,B05,093559,Chow; Bennett,6,0,32,26
1656825831098,MATH 193A,A01,083224,Rotar; Vladimir,6,0,34,28
1656825831098,MATH 193A,A02,083225,Rotar; Vladimir,3,0,34,31
1656825831098,MATH 193A,A03,083781,Rotar; Vladimir,1,0,34,33
1656825831098,MATH 193A,A04,083782,Rotar; Vladimir,6,0,34,28
1656825831098,MATH 193A,A05,093482,Rotar; Vladimir,6,0,34,28
1656825837128,MATH 197,001,091859,McAuley; Julian John,9999,0,9999,0
1656825837128,MATH 197,002,095566,Kedlaya; Kiran S.,9997,0,9999,2
1656825837128,MATH 197,003,095567,Xiao; Ming,9999,0,9999,0
1656825837128,MATH 197,004,095571,Perols; Johan Lars,9998,0,9999,1
1656825844181,COGS 9,A01,083615,Shannon; Kyle Michael,6,0,75,69
1656825850208,COGS 11,A01,083617,Boyle; Mary E. T.,18,0,48,30
1656825856232,COGS 13,A01,083071,Bastos; Amalia Pinkusfeld,8,0,71,63
1656825862259,COGS 14A,A01,092681,Semenuks; Arturs,0,1,100,100
1656825868282,COGS 14B,A01,083073,Cheng; Tzu-Han,5,0,63,58
1656825874307,COGS 17,A01,092677,Semenuks; Arturs,4,0,81,77
1656825880334,COGS 100,A01,083619,Allen; Michael Gordon,15,0,70,55
1656825886363,COGS 101A,A01,083621,Davis; Joshua Daniel,9,0,68,59
1656825892384,COGS 101B,A01,091572,Allen; Michael Gordon,8,0,65,57
1656825898412,COGS 101C,A01,083625,Delgado; Tania,17,0,35,18
1656825904442,COGS 107A,A01,083627,Boyle; Mary E. T.,13,0,60,47
1656825910465,COGS 118A,A01,083075,Gupta; Anjum,15,0,76,61
1656825916492,CSE 3,A50,083646,Miranda; Gregory Joseph,22,0,50,28
1656825922514,CSE 8A,A50,083650,Miranda; Gregory Joseph,17,1,56,39
1656825928540,CSE 11,A01,083080,Cao; Yingjun,4,15,40,36
1656825934567,CSE 12,A01,083652,Krause-Levy; Sophia Louisa,20,1,120,100
1656825940592,CSE 15L,A01,083654,Morris; Justin Loren,8,0,50,42
1656825940592,CSE 15L,A02,083655,Morris; Justin Loren,8,0,50,42
1656825946614,CSE 20,A01,083657,Tran; Khoa Dang,37,0,80,43
1656825952641,CSE 21,A01,095574,Bach; Quang Tran,21,0,48,27
1656825958667,CSE 30,A01,083084,Eldon; John,4,0,80,76
1656825958667,CSE 30,B01,095061,Bhaskar; Nishant,6,0,50,44
1656825964689,CSE 100,A01,083659,Cao; Yingjun,2,4,70,68
1656825970711,CSE 134B,A01,083661,Powell; Thomas Allan,19,0,100,81
1656825976738,CSE 140,A01,083663,Gungor; Onat,14,0,85,71
1656825982766,CSE 140L,A01,083088,Eldon; John,16,0,100,84
1656825988789,CSE 175,A01,083665,Kumar; Rakesh,3,0,25,22
1656825994812,CSE 190,A00,092507,Dubnov; Shlomo,7,0,20,13
1656826000833,ECE 45,A01,083139,Congero; Spencer William,5,0,75,70
1656826006860,ECE 65,A50,083695,Saad; Andrew S,12,0,30,18
1656826006860,ECE 65,A51,095125,Saad; Andrew S,25,0,26,1
1656826012884,ECE 109,A01,091882,Touri; Behrouz,16,0,70,54
1656826018916,ECE 180,A00,083140,Abi Samra; Nicholas Camill,0,0,30,30
1656826018916,ECE 180,B00,083141,Abi Samra; Nicholas Camill,0,0,30,30
1656826024963,MATH 10A,A01,083735,Patchell; Gregory David,1,0,30,29
1656826024963,MATH 10A,A02,083736,Patchell; Gregory David,20,0,30,10
1656826024963,MATH 10A,A03,083737,Patchell; Gregory David,15,0,30,15
1656826031000,MATH 10B,A01,083207,Lim; Seonhee,7,0,34,27
1656826031000,MATH 10B,A02,083208,Lim; Seonhee,9,0,35,26
1656826031000,MATH 10B,A03,093472,Lim; Seonhee,4,0,34,30
1656826031000,MATH 10B,B01,083739,Sinha; Shubham,9,0,30,21
1656826037031,MATH 18,A01,083743,Cinel; Cameron Alexander,6,0,30,24
1656826037031,MATH 18,A02,083744,Cinel; Cameron Alexander,15,0,30,15
1656826037031,MATH 18,A03,083745,Cinel; Cameron Alexander,8,0,30,22
1656826037031,MATH 18,B01,083748,Rideout; David Porter,3,0,37,34
1656826037031,MATH 18,B02,083749,Rideout; David Porter,3,0,36,33
1656826037031,MATH 18,B03,083750,Rideout; David Porter,2,0,37,35
1656826037031,MATH 18,B04,083751,Rideout; David Porter,5,0,36,31
1656826037031,MATH 18,B05,093473,Rideout; David Porter,4,0,36,32
1656826037031,MATH 18,B06,093474,Rideout; David Porter,5,0,36,31
1656826043055,MATH 20A,A01,083754,Zheng; Zequn,12,0,40,28
1656826049078,MATH 20B,A01,083756,Briones; Jor-el Thomas Caparas,1,0,36,35
1656826049078,MATH 20B,A02,083757,Briones; Jor-el Thomas Caparas,1,0,36,35
1656826049078,MATH 20B,A03,093475,Briones; Jor-el Thomas Caparas,0,0,36,36
1656826055102,MATH 20C,A01,083760,Briones; Jor-el Thomas Caparas,1,0,35,34
1656826055102,MATH 20C,A02,083761,Briones; Jor-el Thomas Caparas,8,0,35,27
1656826055102,MATH 20C,A03,093476,Briones; Jor-el Thomas Caparas,0,1,36,36
1656826055102,MATH 20C,B01,083762,Bach; Quang Tran,0,0,30,30
1656826061125,MATH 20D,A01,083765,Tran; Brian Kha,4,0,30,26
1656826061125,MATH 20D,A02,083766,Tran; Brian Kha,4,0,30,26
1656826061125,MATH 20D,A03,083767,Tran; Brian Kha,2,0,30,28
1656826067152,MATH 20E,A01,083771,Ganguly; Soumya,5,0,32,27
1656826067152,MATH 20E,A02,083772,Ganguly; Soumya,6,0,32,26
1656826067152,MATH 20E,B01,083773,Ciotti; Benjamin,18,0,35,17
1656826067152,MATH 20E,B02,083774,Ciotti; Benjamin,17,0,35,18
1656826073175,MATH 103A,A01,083777,Greenfeld; Be'Eri,2,0,36,34
1656826073175,MATH 103A,A02,083778,Greenfeld; Be'Eri,5,0,36,31
1656826073175,MATH 103A,A03,093561,Greenfeld; Be'Eri,4,0,36,32
1656826073175,MATH 103A,B01,083779,Greenfeld; Be'Eri,6,0,36,30
1656826073175,MATH 103A,B02,083780,Greenfeld; Be'Eri,2,0,36,34
1656826073175,MATH 103A,B03,093562,Greenfeld; Be'Eri,2,0,36,34
1656826079196,MATH 105,A01,085443,Carter; Anne Toulson,13,0,35,22
1656826079196,MATH 105,A02,093477,Carter; Anne Toulson,20,0,35,15
1656826085226,MATH 109,A01,083213,Ganzberger; Geoffrey Michael,2,0,34,32
1656826085226,MATH 109,A02,083214,Ganzberger; Geoffrey Michael,2,0,34,32
1656826085226,MATH 109,A03,093478,Ganzberger; Geoffrey Michael,1,0,34,33
1656826085226,MATH 109,B01,083215,Ganzberger; Geoffrey Michael,1,0,32,31
1656826085226,MATH 109,B02,083216,Ganzberger; Geoffrey Michael,1,0,32,31
1656826085226,MATH 109,B03,093479,Ganzberger; Geoffrey Michael,6,0,32,26
1656826091252,MATH 142A,A01,083219,Chow; Bennett,6,0,32,26
1656826091252,MATH 142A,A02,083220,Chow; Bennett,9,0,32,23
1656826091252,MATH 142A,A03,093480,Chow; Bennett,7,0,32,25
1656826091252,MATH 142A,B03,093481,Chow; Bennett,7,0,32,25
1656826091252,MATH 142A,B04,093558,Chow; Bennett,10,0,32,22
1656826091252,MATH 142A,B05,093559,Chow; Bennett,6,0,32,26
1656826097282,MATH 193A,A01,083224,Rotar; Vladimir,6,0,34,28
1656826097282,MATH 193A,A02,083225,Rotar; Vladimir,3,0,34,31
1656826097282,MATH 193A,A03,083781,Rotar; Vladimir,1,0,34,33
1656826097282,MATH 193A,A04,083782,Rotar; Vladimir,6,0,34,28
1656826097282,MATH 193A,A05,093482,Rotar; Vladimir,6,0,34,28
1656826103308,MATH 197,001,091859,McAuley; Julian John,9999,0,9999,0
1656826103308,MATH 197,002,095566,Kedlaya; Kiran S.,9997,0,9999,2
1656826103308,MATH 197,003,095567,Xiao; Ming,9999,0,9999,0
1656826103308,MATH 197,004,095571,Perols; Johan Lars,9998,0,9999,1
1656826110366,COGS 9,A01,083615,Shannon; Kyle Michael,6,0,75,69
1656826116388,COGS 11,A01,083617,Boyle; Mary E. T.,18,0,48,30
1656826122412,COGS 13,A01,083071,Bastos; Amalia Pinkusfeld,8,0,71,63
1656826128435,COGS 14A,A01,092681,Semenuks; Arturs,0,1,100,100
1656826134466,COGS 14B,A01,083073,Cheng; Tzu-Han,5,0,63,58
1656826140488,COGS 17,A01,092677,Semenuks; Arturs,4,0,81,77
1656826146511,COGS 100,A01,083619,Allen; Michael Gordon,15,0,70,55
1656826152535,COGS 101A,A01,083621,Davis; Joshua Daniel,9,0,68,59
1656826158558,COGS 101B,A01,091572,Allen; Michael Gordon,8,0,65,57
1656826164582,COGS 101C,A01,083625,Delgado; Tania,17,0,35,18
1656826170608,COGS 107A,A01,083627,Boyle; Mary E. T.,13,0,60,47
1656826176633,COGS 118A,A01,083075,Gupta; Anjum,15,0,76,61
1656826182660,CSE 3,A50,083646,Miranda; Gregory Joseph,22,0,50,28
1656826188682,CSE 8A,A50,083650,Miranda; Gregory Joseph,17,1,56,39
1656826194709,CSE 11,A01,083080,Cao; Yingjun,4,15,40,36
1656826200735,CSE 12,A01,083652,Krause-Levy; Sophia Louisa,20,1,120,100
1656826206766,CSE 15L,A01,083654,Morris; Justin Loren,8,0,50,42
1656826206766,CSE 15L,A02,083655,Morris; Justin Loren,8,0,50,42
1656826212803,CSE 20,A01,083657,Tran; Khoa Dang,37,0,80,43
1656826218826,CSE 21,A01,095574,Bach; Quang Tran,21,0,48,27
1656826224857,CSE 30,A01,083084,Eldon; John,4,0,80,76
1656826224857,CSE 30,B01,095061,Bhaskar; Nishant,6,0,50,44
1656826230880,CSE 100,A01,083659,Cao; Yingjun,2,4,70,68
1656826236907,CSE 134B,A01,083661,Powell; Thomas Allan,19,0,100,81
1656826242934,CSE 140,A01,083663,Gungor; Onat,14,0,85,71
1656826248961,CSE 140L,A01,083088,Eldon; John,16,0,100,84
1656826254985,CSE 175,A01,083665,Kumar; Rakesh,3,0,25,22
1656826261119,CSE 190,A00,092507,Dubnov; Shlomo,7,0,20,13
1656826267144,ECE 45,A01,083139,Congero; Spencer William,5,0,75,70
1656826273169,ECE 65,A50,083695,Saad; Andrew S,12,0,30,18
1656826273169,ECE 65,A51,095125,Saad; Andrew S,25,0,26,1
1656826279192,ECE 109,A01,091882,Touri; Behrouz,16,0,70,54
1656826285219,ECE 180,A00,083140,Abi Samra; Nicholas Camill,0,0,30,30
1656826285219,ECE 180,B00,083141,Abi Samra; Nicholas Camill,0,0,30,30
1656826291246,MATH 10A,A01,083735,Patchell; Gregory David,1,0,30,29
1656826291246,MATH 10A,A02,083736,Patchell; Gregory David,20,0,30,10
1656826291246,MATH 10A,A03,083737,Patchell; Gregory David,15,0,30,15
1656826297269,MATH 10B,A01,083207,Lim; Seonhee,7,0,34,27
1656826297269,MATH 10B,A02,083208,Lim; Seonhee,9,0,35,26
1656826297269,MATH 10B,A03,093472,Lim; Seonhee,4,0,34,30
1656826297269,MATH 10B,B01,083739,Sinha; Shubham,9,0,30,21
1656826303299,MATH 18,A01,083743,Cinel; Cameron Alexander,6,0,30,24
1656826303299,MATH 18,A02,083744,Cinel; Cameron Alexander,15,0,30,15
1656826303299,MATH 18,A03,083745,Cinel; Cameron Alexander,8,0,30,22
1656826303299,MATH 18,B01,083748,Rideout; David Porter,3,0,37,34
1656826303299,MATH 18,B02,083749,Rideout; David Porter,3,0,36,33
1656826303299,MATH 18,B03,083750,Rideout; David Porter,2,0,37,35
1656826303299,MATH 18,B04,083751,Rideout; David Porter,5,0,36,31
1656826303299,MATH 18,B05,093473,Rideout; David Porter,4,0,36,32
1656826303299,MATH 18,B06,093474,Rideout; David Porter,5,0,36,31
1656826309322,MATH 20A,A01,083754,Zheng; Zequn,12,0,40,28
1656826315349,MATH 20B,A01,083756,Briones; Jor-el Thomas Caparas,1,0,36,35
1656826315349,MATH 20B,A02,083757,Briones; Jor-el Thomas Caparas,1,0,36,35
1656826315349,MATH 20B,A03,093475,Briones; Jor-el Thomas Caparas,0,0,36,36
1656826321371,MATH 20C,A01,083760,Briones; Jor-el Thomas Caparas,1,0,35,34
1656826321371,MATH 20C,A02,083761,Briones; Jor-el Thomas Caparas,8,0,35,27
1656826321371,MATH 20C,A03,093476,Briones; Jor-el Thomas Caparas,0,1,36,36
1656826321371,MATH 20C,B01,083762,Bach; Quang Tran,0,0,30,30
1656826327400,MATH 20D,A01,083765,Tran; Brian Kha,4,0,30,26
1656826327400,MATH 20D,A02,083766,Tran; Brian Kha,4,0,30,26
1656826327400,MATH 20D,A03,083767,Tran; Brian Kha,2,0,30,28
1656826333422,MATH 20E,A01,083771,Ganguly; Soumya,5,0,32,27
1656826333422,MATH 20E,A02,083772,Ganguly; Soumya,6,0,32,26
1656826333422,MATH 20E,B01,083773,Ciotti; Benjamin,18,0,35,17
1656826333422,MATH 20E,B02,083774,Ciotti; Benjamin,17,0,35,18
1656826339450,MATH 103A,A01,083777,Greenfeld; Be'Eri,2,0,36,34
1656826339450,MATH 103A,A02,083778,Greenfeld; Be'Eri,5,0,36,31
1656826339450,MATH 103A,A03,093561,Greenfeld; Be'Eri,4,0,36,32
1656826339450,MATH 103A,B01,083779,Greenfeld; Be'Eri,6,0,36,30
1656826339450,MATH 103A,B02,083780,Greenfeld; Be'Eri,2,0,36,34
1656826339450,MATH 103A,B03,093562,Greenfeld; Be'Eri,2,0,36,34
1656826345478,MATH 105,A01,085443,Carter; Anne Toulson,13,0,35,22
1656826345478,MATH 105,A02,093477,Carter; Anne Toulson,20,0,35,15
1656826351501,MATH 109,A01,083213,Ganzberger; Geoffrey Michael,2,0,34,32
1656826351501,MATH 109,A02,083214,Ganzberger; Geoffrey Michael,2,0,34,32
1656826351501,MATH 109,A03,093478,Ganzberger; Geoffrey Michael,1,0,34,33
1656826351501,MATH 109,B01,083215,Ganzberger; Geoffrey Michael,1,0,32,31
1656826351501,MATH 109,B02,083216,Ganzberger; Geoffrey Michael,1,0,32,31
1656826351501,MATH 109,B03,093479,Ganzberger; Geoffrey Michael,6,0,32,26
1656826357541,MATH 142A,A01,083219,Chow; Bennett,6,0,32,26
1656826357541,MATH 142A,A02,083220,Chow; Bennett,9,0,32,23
1656826357541,MATH 142A,A03,093480,Chow; Bennett,7,0,32,25
1656826357541,MATH 142A,B03,093481,Chow; Bennett,7,0,32,25
1656826357541,MATH 142A,B04,093558,Chow; Bennett,10,0,32,22
1656826357541,MATH 142A,B05,093559,Chow; Bennett,6,0,32,26
1656826363585,MATH 193A,A01,083224,Rotar; Vladimir,6,0,34,28
1656826363585,MATH 193A,A02,083225,Rotar; Vladimir,3,0,34,31
1656826363585,MATH 193A,A03,083781,Rotar; Vladimir,1,0,34,33
1656826363585,MATH 193A,A04,083782,Rotar; Vladimir,6,0,34,28
1656826363585,MATH 193A,A05,093482,Rotar; Vladimir,6,0,34,28
1656826369611,MATH 197,001,091859,McAuley; Julian John,9999,0,9999,0
1656826369611,MATH 197,002,095566,Kedlaya; Kiran S.,9997,0,9999,2
1656826369611,MATH 197,003,095567,Xiao; Ming,9999,0,9999,0
1656826369611,MATH 197,004,095571,Perols; Johan Lars,9998,0,9999,1
1656826376675,COGS 9,A01,083615,Shannon; Kyle Michael,6,0,75,69
1656826382697,COGS 11,A01,083617,Boyle; Mary E. T.,18,0,48,30
1656826388748,COGS 13,A01,083071,Bastos; Amalia Pinkusfeld,8,0,71,63
1656826394775,COGS 14A,A01,092681,Semenuks; Arturs,0,1,100,100
1656826400797,COGS 14B,A01,083073,Cheng; Tzu-Han,5,0,63,58
1656826406827,COGS 17,A01,092677,Semenuks; Arturs,4,0,81,77
1656826412851,COGS 100,A01,083619,Allen; Michael Gordon,15,0,70,55
1656826418872,COGS 101A,A01,083621,Davis; Joshua Daniel,9,0,68,59
1656826424895,COGS 101B,A01,091572,Allen; Michael Gordon,8,0,65,57
1656826430923,COGS 101C,A01,083625,Delgado; Tania,17,0,35,18
1656826436955,COGS 107A,A01,083627,Boyle; Mary E. T.,13,0,60,47
1656826442977,COGS 118A,A01,083075,Gupta; Anjum,15,0,76,61
1656826449002,CSE 3,A50,083646,Miranda; Gregory Joseph,22,0,50,28
1656826455029,CSE 8A,A50,083650,Miranda; Gregory Joseph,17,1,56,39
1656826461054,CSE 11,A01,083080,Cao; Yingjun,4,15,40,36
1656826467080,CSE 12,A01,083652,Krause-Levy; Sophia Louisa,20,1,120,100
1656826473102,CSE 15L,A01,083654,Morris; Justin Loren,8,0,50,42
1656826473102,CSE 15L,A02,083655,Morris; Justin Loren,8,0,50,42
1656826479129,CSE 20,A01,083657,Tran; Khoa Dang,37,0,80,43
1656826485155,CSE 21,A01,095574,Bach; Quang Tran,21,0,48,27
1656826491177,CSE 30,A01,083084,Eldon; John,4,0,80,76
1656826491177,CSE 30,B01,095061,Bhaskar; Nishant,6,0,50,44
1656826497199,CSE 100,A01,083659,Cao; Yingjun,2,4,70,68
1656826503225,CSE 134B,A01,083661,Powell; Thomas Allan,19,0,100,81
1656826509247,CSE 140,A01,083663,Gungor; Onat,14,0,85,71
1656826515273,CSE 140L,A01,083088,Eldon; John,16,0,100,84
1656826521297,CSE 175,A01,083665,Kumar; Rakesh,3,0,25,22
1656826527322,CSE 190,A00,092507,Dubnov; Shlomo,7,0,20,13
1656826533348,ECE 45,A01,083139,Congero; Spencer William,5,0,75,70
1656826539382,ECE 65,A50,083695,Saad; Andrew S,12,0,30,18
1656826539382,ECE 65,A51,095125,Saad; Andrew S,25,0,26,1
1656826545407,ECE 109,A01,091882,Touri; Behrouz,16,0,70,54
1656826551430,ECE 180,A00,083140,Abi Samra; Nicholas Camill,0,0,30,30
1656826551430,ECE 180,B00,083141,Abi Samra; Nicholas Camill,0,0,30,30
1656826557454,MATH 10A,A01,083735,Patchell; Gregory David,1,0,30,29
1656826557454,MATH 10A,A02,083736,Patchell; Gregory David,20,0,30,10
1656826557454,MATH 10A,A03,083737,Patchell; Gregory David,15,0,30,15
1656826563482,MATH 10B,A01,083207,Lim; Seonhee,7,0,34,27
1656826563482,MATH 10B,A02,083208,Lim; Seonhee,9,0,35,26
1656826563482,MATH 10B,A03,093472,Lim; Seonhee,4,0,34,30
1656826563482,MATH 10B,B01,083739,Sinha; Shubham,9,0,30,21
1656826569506,MATH 18,A01,083743,Cinel; Cameron Alexander,6,0,30,24
1656826569506,MATH 18,A02,083744,Cinel; Cameron Alexander,15,0,30,15
1656826569506,MATH 18,A03,083745,Cinel; Cameron Alexander,8,0,30,22
1656826569506,MATH 18,B01,083748,Rideout; David Porter,3,0,37,34
1656826569506,MATH 18,B02,083749,Rideout; David Porter,3,0,36,33
1656826569506,MATH 18,B03,083750,Rideout; David Porter,2,0,37,35
1656826569506,MATH 18,B04,083751,Rideout; David Porter,5,0,36,31
1656826569506,MATH 18,B05,093473,Rideout; David Porter,4,0,36,32
1656826569506,MATH 18,B06,093474,Rideout; David Porter,5,0,36,31
1656826575529,MATH 20A,A01,083754,Zheng; Zequn,12,0,40,28
1656826581557,MATH 20B,A01,083756,Briones; Jor-el Thomas Caparas,1,0,36,35
1656826581557,MATH 20B,A02,083757,Briones; Jor-el Thomas Caparas,1,0,36,35
1656826581557,MATH 20B,A03,093475,Briones; Jor-el Thomas Caparas,0,0,36,36
1656826587585,MATH 20C,A01,083760,Briones; Jor-el Thomas Caparas,1,0,35,34
1656826587585,MATH 20C,A02,083761,Briones; Jor-el Thomas Caparas,8,0,35,27
1656826587585,MATH 20C,A03,093476,Briones; Jor-el Thomas Caparas,0,1,36,36
1656826587585,MATH 20C,B01,083762,Bach; Quang Tran,0,0,30,30
1656826593608,MATH 20D,A01,083765,Tran; Brian Kha,4,0,30,26
1656826593608,MATH 20D,A02,083766,Tran; Brian Kha,4,0,30,26
1656826593608,MATH 20D,A03,083767,Tran; Brian Kha,2,0,30,28
1656826599644,MATH 20E,A01,083771,Ganguly; Soumya,5,0,32,27
1656826599644,MATH 20E,A02,083772,Ganguly; Soumya,6,0,32,26
1656826599644,MATH 20E,B01,083773,Ciotti; Benjamin,18,0,35,17
1656826599644,MATH 20E,B02,083774,Ciotti; Benjamin,17,0,35,18
1656826605674,MATH 103A,A01,083777,Greenfeld; Be'Eri,2,0,36,34
1656826605674,MATH 103A,A02,083778,Greenfeld; Be'Eri,5,0,36,31
1656826605674,MATH 103A,A03,093561,Greenfeld; Be'Eri,4,0,36,32
1656826605674,MATH 103A,B01,083779,Greenfeld; Be'Eri,6,0,36,30
1656826605674,MATH 103A,B02,083780,Greenfeld; Be'Eri,2,0,36,34
1656826605674,MATH 103A,B03,093562,Greenfeld; Be'Eri,2,0,36,34
1656826611699,MATH 105,A01,085443,Carter; Anne Toulson,13,0,35,22
1656826611699,MATH 105,A02,093477,Carter; Anne Toulson,20,0,35,15
1656826617727,MATH 109,A01,083213,Ganzberger; Geoffrey Michael,2,0,34,32
1656826617727,MATH 109,A02,083214,Ganzberger; Geoffrey Michael,2,0,34,32
1656826617727,MATH 109,A03,093478,Ganzberger; Geoffrey Michael,1,0,34,33
1656826617727,MATH 109,B01,083215,Ganzberger; Geoffrey Michael,1,0,32,31
1656826617727,MATH 109,B02,083216,Ganzberger; Geoffrey Michael,1,0,32,31
1656826617727,MATH 109,B03,093479,Ganzberger; Geoffrey Michael,6,0,32,26
1656826623759,MATH 142A,A01,083219,Chow; Bennett,6,0,32,26
1656826623759,MATH 142A,A02,083220,Chow; Bennett,9,0,32,23
1656826623759,MATH 142A,A03,093480,Chow; Bennett,7,0,32,25
1656826623759,MATH 142A,B03,093481,Chow; Bennett,7,0,32,25
1656826623759,MATH 142A,B04,093558,Chow; Bennett,10,0,32,22
1656826623759,MATH 142A,B05,093559,Chow; Bennett,6,0,32,26
1656826629783,MATH 193A,A01,083224,Rotar; Vladimir,6,0,34,28
1656826629783,MATH 193A,A02,083225,Rotar; Vladimir,3,0,34,31
1656826629783,MATH 193A,A03,083781,Rotar; Vladimir,1,0,34,33
1656826629783,MATH 193A,A04,083782,Rotar; Vladimir,6,0,34,28
1656826629783,MATH 193A,A05,093482,Rotar; Vladimir,6,0,34,28
1656826635806,MATH 197,001,091859,McAuley; Julian John,9999,0,9999,0
1656826635806,MATH 197,002,095566,Kedlaya; Kiran S.,9997,0,9999,2
1656826635806,MATH 197,003,095567,Xiao; Ming,9999,0,9999,0
1656826635806,MATH 197,004,095571,Perols; Johan Lars,9998,0,9999,1
1656826642856,COGS 9,A01,083615,Shannon; Kyle Michael,6,0,75,69
1656826648884,COGS 11,A01,083617,Boyle; Mary E. T.,18,0,48,30
1656826654907,COGS 13,A01,083071,Bastos; Amalia Pinkusfeld,8,0,71,63
1656826660934,COGS 14A,A01,092681,Semenuks; Arturs,0,1,100,100
1656826666961,COGS 14B,A01,083073,Cheng; Tzu-Han,5,0,63,58
1656826672997,COGS 17,A01,092677,Semenuks; Arturs,4,0,81,77
1656826679028,COGS 100,A01,083619,Allen; Michael Gordon,15,0,70,55
1656826685070,COGS 101A,A01,083621,Davis; Joshua Daniel,9,0,68,59
1656826691096,COGS 101B,A01,091572,Allen; Michael Gordon,8,0,65,57
1656826697123,COGS 101C,A01,083625,Delgado; Tania,17,0,35,18
1656826703144,COGS 107A,A01,083627,Boyle; Mary E. T.,13,0,60,47
1656826709170,COGS 118A,A01,083075,Gupta; Anjum,15,0,76,61
1656826715191,CSE 3,A50,083646,Miranda; Gregory Joseph,22,0,50,28
1656826721219,CSE 8A,A50,083650,Miranda; Gregory Joseph,17,1,56,39
1656826727241,CSE 11,A01,083080,Cao; Yingjun,4,15,40,36
1656826733267,CSE 12,A01,083652,Krause-Levy; Sophia Louisa,20,1,120,100
1656826739290,CSE 15L,A01,083654,Morris; Justin Loren,8,0,50,42
1656826739290,CSE 15L,A02,083655,Morris; Justin Loren,8,0,50,42
1656826745320,CSE 20,A01,083657,Tran; Khoa Dang,37,0,80,43
1656826751344,CSE 21,A01,095574,Bach; Quang Tran,21,0,48,27
1656826757368,CSE 30,A01,083084,Eldon; John,4,0,80,76
1656826757368,CSE 30,B01,095061,Bhaskar; Nishant,6,0,50,44
1656826763391,CSE 100,A01,083659,Cao; Yingjun,2,4,70,68
1656826769414,CSE 134B,A01,083661,Powell; Thomas Allan,19,0,100,81
1656826775438,CSE 140,A01,083663,Gungor; Onat,14,0,85,71
1656826781464,CSE 140L,A01,083088,Eldon; John,16,0,100,84
1656826787500,CSE 175,A01,083665,Kumar; Rakesh,3,0,25,22
1656826793523,CSE 190,A00,092507,Dubnov; Shlomo,7,0,20,13
1656826799546,ECE 45,A01,083139,Congero; Spencer William,5,0,75,70
1656826805573,ECE 65,A50,083695,Saad; Andrew S,12,0,30,18
1656826805573,ECE 65,A51,095125,Saad; Andrew S,25,0,26,1
1656826811596,ECE 109,A01,091882,Touri; Behrouz,16,0,70,54
1656826817622,ECE 180,A00,083140,Abi Samra; Nicholas Camill,0,0,30,30
1656826817622,ECE 180,B00,083141,Abi Samra; Nicholas Camill,0,0,30,30
1656826823649,MATH 10A,A01,083735,Patchell; Gregory David,1,0,30,29
1656826823649,MATH 10A,A02,083736,Patchell; Gregory David,20,0,30,10
1656826823649,MATH 10A,A03,083737,Patchell; Gregory David,15,0,30,15
1656826829673,MATH 10B,A01,083207,Lim; Seonhee,7,0,34,27
1656826829673,MATH 10B,A02,083208,Lim; Seonhee,9,0,35,26
1656826829673,MATH 10B,A03,093472,Lim; Seonhee,4,0,34,30
1656826829673,MATH 10B,B01,083739,Sinha; Shubham,9,0,30,21
1656826835704,MATH 18,A01,083743,Cinel; Cameron Alexander,6,0,30,24
1656826835704,MATH 18,A02,083744,Cinel; Cameron Alexander,15,0,30,15
1656826835704,MATH 18,A03,083745,Cinel; Cameron Alexander,8,0,30,22
1656826835704,MATH 18,B01,083748,Rideout; David Porter,3,0,37,34
1656826835704,MATH 18,B02,083749,Rideout; David Porter,3,0,36,33
1656826835704,MATH 18,B03,083750,Rideout; David Porter,2,0,37,35
1656826835704,MATH 18,B04,083751,Rideout; David Porter,5,0,36,31
1656826835704,MATH 18,B05,093473,Rideout; David Porter,4,0,36,32
1656826835704,MATH 18,B06,093474,Rideout; David Porter,5,0,36,31
1656826841730,MATH 20A,A01,083754,Zheng; Zequn,12,0,40,28
1656826847758,MATH 20B,A01,083756,Briones; Jor-el Thomas Caparas,1,0,36,35
1656826847758,MATH 20B,A02,083757,Briones; Jor-el Thomas Caparas,1,0,36,35
1656826847758,MATH 20B,A03,093475,Briones; Jor-el Thomas Caparas,0,0,36,36
1656826853785,MATH 20C,A01,083760,Briones; Jor-el Thomas Caparas,1,0,35,34
1656826853785,MATH 20C,A02,083761,Briones; Jor-el Thomas Caparas,8,0,35,27
1656826853785,MATH 20C,A03,093476,Briones; Jor-el Thomas Caparas,0,1,36,36
1656826853785,MATH 20C,B01,083762,Bach; Quang Tran,0,0,30,30
1656826859900,MATH 20D,A01,083765,Tran; Brian Kha,4,0,30,26
1656826859900,MATH 20D,A02,083766,Tran; Brian Kha,4,0,30,26
1656826859900,MATH 20D,A03,083767,Tran; Brian Kha,2,0,30,28
1656826865926,MATH 20E,A01,083771,Ganguly; Soumya,5,0,32,27
1656826865926,MATH 20E,A02,083772,Ganguly; Soumya,6,0,32,26
1656826865926,MATH 20E,B01,083773,Ciotti; Benjamin,18,0,35,17
1656826865926,MATH 20E,B02,083774,Ciotti; Benjamin,17,0,35,18
1656826871951,MATH 103A,A01,083777,Greenfeld; Be'Eri,2,0,36,34
1656826871951,MATH 103A,A02,083778,Greenfeld; Be'Eri,5,0,36,31
1656826871951,MATH 103A,A03,093561,Greenfeld; Be'Eri,4,0,36,32
1656826871951,MATH 103A,B01,083779,Greenfeld; Be'Eri,6,0,36,30
1656826871951,MATH 103A,B02,083780,Greenfeld; Be'Eri,2,0,36,34
1656826871951,MATH 103A,B03,093562,Greenfeld; Be'Eri,2,0,36,34
1656826877973,MATH 105,A01,085443,Carter; Anne Toulson,13,0,35,22
1656826877973,MATH 105,A02,093477,Carter; Anne Toulson,20,0,35,15
1656826884003,MATH 109,A01,083213,Ganzberger; Geoffrey Michael,2,0,34,32
1656826884003,MATH 109,A02,083214,Ganzberger; Geoffrey Michael,2,0,34,32
1656826884003,MATH 109,A03,093478,Ganzberger; Geoffrey Michael,1,0,34,33
1656826884003,MATH 109,B01,083215,Ganzberger; Geoffrey Michael,1,0,32,31
1656826884003,MATH 109,B02,083216,Ganzberger; Geoffrey Michael,1,0,32,31
1656826884003,MATH 109,B03,093479,Ganzberger; Geoffrey Michael,6,0,32,26
1656826890032,MATH 142A,A01,083219,Chow; Bennett,6,0,32,26
1656826890032,MATH 142A,A02,083220,Chow; Bennett,9,0,32,23
1656826890032,MATH 142A,A03,093480,Chow; Bennett,7,0,32,25
1656826890032,MATH 142A,B03,093481,Chow; Bennett,7,0,32,25
1656826890032,MATH 142A,B04,093558,Chow; Bennett,10,0,32,22
1656826890032,MATH 142A,B05,093559,Chow; Bennett,6,0,32,26
1656826896058,MATH 193A,A01,083224,Rotar; Vladimir,6,0,34,28
1656826896058,MATH 193A,A02,083225,Rotar; Vladimir,3,0,34,31
1656826896058,MATH 193A,A03,083781,Rotar; Vladimir,1,0,34,33
1656826896058,MATH 193A,A04,083782,Rotar; Vladimir,6,0,34,28
1656826896058,MATH 193A,A05,093482,Rotar; Vladimir,6,0,34,28
1656826902079,MATH 197,001,091859,McAuley; Julian John,9999,0,9999,0
1656826902079,MATH 197,002,095566,Kedlaya; Kiran S.,9997,0,9999,2
1656826902079,MATH 197,003,095567,Xiao; Ming,9999,0,9999,0
1656826902079,MATH 197,004,095571,Perols; Johan Lars,9998,0,9999,1
1656826909131,COGS 9,A01,083615,Shannon; Kyle Michael,6,0,75,69
1656826915153,COGS 11,A01,083617,Boyle; Mary E. T.,18,0,48,30
1656826921180,COGS 13,A01,083071,Bastos; Amalia Pinkusfeld,8,0,71,63
1656826927203,COGS 14A,A01,092681,Semenuks; Arturs,0,1,100,100
1656826933226,COGS 14B,A01,083073,Cheng; Tzu-Han,5,0,63,58
1656826939250,COGS 17,A01,092677,Semenuks; Arturs,4,0,81,77
1656826945282,COGS 100,A01,083619,Allen; Michael Gordon,15,0,70,55
1656826951311,COGS 101A,A01,083621,Davis; Joshua Daniel,9,0,68,59
1656826957335,COGS 101B,A01,091572,Allen; Michael Gordon,8,0,65,57
1656826963358,COGS 101C,A01,083625,Delgado; Tania,17,0,35,18
1656826969392,COGS 107A,A01,083627,Boyle; Mary E. T.,13,0,60,47
1656826975426,COGS 118A,A01,083075,Gupta; Anjum,15,0,76,61
1656826981449,CSE 3,A50,083646,Miranda; Gregory Joseph,22,0,50,28
1656826987472,CSE 8A,A50,083650,Miranda; Gregory Joseph,17,1,56,39
1656826993494,CSE 11,A01,083080,Cao; Yingjun,4,15,40,36
1656826999521,CSE 12,A01,083652,Krause-Levy; Sophia Louisa,20,1,120,100
1656827005543,CSE 15L,A01,083654,Morris; Justin Loren,8,0,50,42
1656827005543,CSE 15L,A02,083655,Morris; Justin Loren,8,0,50,42
1656827011575,CSE 20,A01,083657,Tran; Khoa Dang,37,0,80,43
1656827017600,CSE 21,A01,095574,Bach; Quang Tran,21,0,48,27
1656827023628,CSE 30,A01,083084,Eldon; John,4,0,80,76
1656827023628,CSE 30,B01,095061,Bhaskar; Nishant,6,0,50,44
1656827029655,CSE 100,A01,083659,Cao; Yingjun,2,4,70,68
1656827035681,CSE 134B,A01,083661,Powell; Thomas Allan,19,0,100,81
1656827041713,CSE 140,A01,083663,Gungor; Onat,14,0,85,71
1656827047741,CSE 140L,A01,083088,Eldon; John,16,0,100,84
1656827053763,CSE 175,A01,083665,Kumar; Rakesh,3,0,25,22
1656827059788,CSE 190,A00,092507,Dubnov; Shlomo,7,0,20,13
1656827065815,ECE 45,A01,083139,Congero; Spencer William,5,0,75,70
1656827071846,ECE 65,A50,083695,Saad; Andrew S,12,0,30,18
1656827071846,ECE 65,A51,095125,Saad; Andrew S,25,0,26,1
1656827077870,ECE 109,A01,091882,Touri; Behrouz,16,0,70,54
1656827083910,ECE 180,A00,083140,Abi Samra; Nicholas Camill,0,0,30,30
1656827083910,ECE 180,B00,083141,Abi Samra; Nicholas Camill,0,0,30,30
1656827089937,MATH 10A,A01,083735,Patchell; Gregory David,1,0,30,29
1656827089937,MATH 10A,A02,083736,Patchell; Gregory David,20,0,30,10
1656827089937,MATH 10A,A03,083737,Patchell; Gregory David,15,0,30,15
1656827095959,MATH 10B,A01,083207,Lim; Seonhee,7,0,34,27
1656827095959,MATH 10B,A02,083208,Lim; Seonhee,9,0,35,26
1656827095959,MATH 10B,A03,093472,Lim; Seonhee,4,0,34,30
1656827095959,MATH 10B,B01,083739,Sinha; Shubham,9,0,30,21
1656827101991,MATH 18,A01,083743,Cinel; Cameron Alexander,6,0,30,24
1656827101991,MATH 18,A02,083744,Cinel; Cameron Alexander,15,0,30,15
1656827101991,MATH 18,A03,083745,Cinel; Cameron Alexander,8,0,30,22
1656827101991,MATH 18,B01,083748,Rideout; David Porter,3,0,37,34
1656827101991,MATH 18,B02,083749,Rideout; David Porter,3,0,36,33
1656827101991,MATH 18,B03,083750,Rideout; David Porter,2,0,37,35
1656827101991,MATH 18,B04,083751,Rideout; David Porter,5,0,36,31
1656827101991,MATH 18,B05,093473,Rideout; David Porter,4,0,36,32
1656827101991,MATH 18,B06,093474,Rideout; David Porter,5,0,36,31
1656827108020,MATH 20A,A01,083754,Zheng; Zequn,12,0,40,28
1656827114044,MATH 20B,A01,083756,Briones; Jor-el Thomas Caparas,1,0,36,35
1656827114044,MATH 20B,A02,083757,Briones; Jor-el Thomas Caparas,1,0,36,35
1656827114044,MATH 20B,A03,093475,Briones; Jor-el Thomas Caparas,0,0,36,36
1656827120068,MATH 20C,A01,083760,Briones; Jor-el Thomas Caparas,1,0,35,34
1656827120068,MATH 20C,A02,083761,Briones; Jor-el Thomas Caparas,8,0,35,27
1656827120068,MATH 20C,A03,093476,Briones; Jor-el Thomas Caparas,0,1,36,36
1656827120068,MATH 20C,B01,083762,Bach; Quang Tran,0,0,30,30
1656827126091,MATH 20D,A01,083765,Tran; Brian Kha,4,0,30,26
1656827126091,MATH 20D,A02,083766,Tran; Brian Kha,4,0,30,26
1656827126091,MATH 20D,A03,083767,Tran; Brian Kha,2,0,30,28
1656827132119,MATH 20E,A01,083771,Ganguly; Soumya,5,0,32,27
1656827132119,MATH 20E,A02,083772,Ganguly; Soumya,6,0,32,26
1656827132119,MATH 20E,B01,083773,Ciotti; Benjamin,18,0,35,17
1656827132119,MATH 20E,B02,083774,Ciotti; Benjamin,17,0,35,18
1656827138146,MATH 103A,A01,083777,Greenfeld; Be'Eri,2,0,36,34
1656827138146,MATH 103A,A02,083778,Greenfeld; Be'Eri,5,0,36,31
1656827138146,MATH 103A,A03,093561,Greenfeld; Be'Eri,4,0,36,32
1656827138146,MATH 103A,B01,083779,Greenfeld; Be'Eri,6,0,36,30
1656827138146,MATH 103A,B02,083780,Greenfeld; Be'Eri,2,0,36,34
1656827138146,MATH 103A,B03,093562,Greenfeld; Be'Eri,2,0,36,34
1656827144168,MATH 105,A01,085443,Carter; Anne Toulson,13,0,35,22
1656827144168,MATH 105,A02,093477,Carter; Anne Toulson,20,0,35,15
1656827150194,MATH 109,A01,083213,Ganzberger; Geoffrey Michael,2,0,34,32
1656827150194,MATH 109,A02,083214,Ganzberger; Geoffrey Michael,2,0,34,32
1656827150194,MATH 109,A03,093478,Ganzberger; Geoffrey Michael,1,0,34,33
1656827150194,MATH 109,B01,083215,Ganzberger; Geoffrey Michael,1,0,32,31
1656827150194,MATH 109,B02,083216,Ganzberger; Geoffrey Michael,1,0,32,31
1656827150194,MATH 109,B03,093479,Ganzberger; Geoffrey Michael,6,0,32,26
1656827156222,MATH 142A,A01,083219,Chow; Bennett,6,0,32,26
1656827156222,MATH 142A,A02,083220,Chow; Bennett,9,0,32,23
1656827156222,MATH 142A,A03,093480,Chow; Bennett,7,0,32,25
1656827156222,MATH 142A,B03,093481,Chow; Bennett,7,0,32,25
1656827156222,MATH 142A,B04,093558,Chow; Bennett,10,0,32,22
1656827156222,MATH 142A,B05,093559,Chow; Bennett,6,0,32,26
1656827162246,MATH 193A,A01,083224,Rotar; Vladimir,6,0,34,28
1656827162246,MATH 193A,A02,083225,Rotar; Vladimir,3,0,34,31
1656827162246,MATH 193A,A03,083781,Rotar; Vladimir,1,0,34,33
1656827162246,MATH 193A,A04,083782,Rotar; Vladimir,6,0,34,28
1656827162246,MATH 193A,A05,093482,Rotar; Vladimir,6,0,34,28
1656827168268,MATH 197,001,091859,McAuley; Julian John,9999,0,9999,0
1656827168268,MATH 197,002,095566,Kedlaya; Kiran S.,9997,0,9999,2
1656827168268,MATH 197,003,095567,Xiao; Ming,9999,0,9999,0
1656827168268,MATH 197,004,095571,Perols; Johan Lars,9998,0,9999,1
1656827175334,COGS 9,A01,083615,Shannon; Kyle Michael,6,0,75,69
1656827181362,COGS 11,A01,083617,Boyle; Mary E. T.,18,0,48,30
1656827187384,COGS 13,A01,083071,Bastos; Amalia Pinkusfeld,8,0,71,63
1656827193417,COGS 14A,A01,092681,Semenuks; Arturs,0,1,100,100
1656827199444,COGS 14B,A01,083073,Cheng; Tzu-Han,5,0,63,58
1656827205466,COGS 17,A01,092677,Semenuks; Arturs,4,0,81,77
1656827211489,COGS 100,A01,083619,Allen; Michael Gordon,15,0,70,55
1656827217511,COGS 101A,A01,083621,Davis; Joshua Daniel,9,0,68,59
1656827223538,COGS 101B,A01,091572,Allen; Michael Gordon,8,0,65,57
1656827229566,COGS 101C,A01,083625,Delgado; Tania,17,0,35,18
1656827235590,COGS 107A,A01,083627,Boyle; Mary E. T.,13,0,60,47
1656827241613,COGS 118A,A01,083075,Gupta; Anjum,15,0,76,61
1656827247642,CSE 3,A50,083646,Miranda; Gregory Joseph,22,0,50,28
1656827253666,CSE 8A,A50,083650,Miranda; Gregory Joseph,17,1,56,39
1656827259693,CSE 11,A01,083080,Cao; Yingjun,4,15,40,36
1656827265719,CSE 12,A01,083652,Krause-Levy; Sophia Louisa,20,1,120,100
1656827271745,CSE 15L,A01,083654,Morris; Justin Loren,8,0,50,42
1656827271745,CSE 15L,A02,083655,Morris; Justin Loren,8,0,50,42
1656827277768,CSE 20,A01,083657,Tran; Khoa Dang,37,0,80,43
1656827283791,CSE 21,A01,095574,Bach; Quang Tran,21,0,48,27
1656827289819,CSE 30,A01,083084,Eldon; John,4,0,80,76
1656827289819,CSE 30,B01,095061,Bhaskar; Nishant,6,0,50,44
1656827295846,CSE 100,A01,083659,Cao; Yingjun,2,4,70,68
1656827301867,CSE 134B,A01,083661,Powell; Thomas Allan,19,0,100,81
1656827307892,CSE 140,A01,083663,Gungor; Onat,14,0,85,71
1656827313927,CSE 140L,A01,083088,Eldon; John,16,0,100,84
1656827319952,CSE 175,A01,083665,Kumar; Rakesh,3,0,25,22
1656827325986,CSE 190,A00,092507,Dubnov; Shlomo,7,0,20,13
1656827332012,ECE 45,A01,083139,Congero; Spencer William,5,0,75,70
1656827338040,ECE 65,A50,083695,Saad; Andrew S,12,0,30,18
1656827338040,ECE 65,A51,095125,Saad; Andrew S,25,0,26,1
1656827344064,ECE 109,A01,091882,Touri; Behrouz,16,0,70,54
1656827350088,ECE 180,A00,083140,Abi Samra; Nicholas Camill,0,0,30,30
1656827350088,ECE 180,B00,083141,Abi Samra; Nicholas Camill,0,0,30,30
1656827356116,MATH 10A,A01,083735,Patchell; Gregory David,1,0,30,29
1656827356116,MATH 10A,A02,083736,Patchell; Gregory David,20,0,30,10
1656827356116,MATH 10A,A03,083737,Patchell; Gregory David,15,0,30,15
1656827362146,MATH 10B,A01,083207,Lim; Seonhee,7,0,34,27
1656827362146,MATH 10B,A02,083208,Lim; Seonhee,9,0,35,26
1656827362146,MATH 10B,A03,093472,Lim; Seonhee,4,0,34,30
1656827362146,MATH 10B,B01,083739,Sinha; Shubham,9,0,30,21
1656827368179,MATH 18,A01,083743,Cinel; Cameron Alexander,6,0,30,24
1656827368179,MATH 18,A02,083744,Cinel; Cameron Alexander,15,0,30,15
1656827368179,MATH 18,A03,083745,Cinel; Cameron Alexander,8,0,30,22
1656827368179,MATH 18,B01,083748,Rideout; David Porter,3,0,37,34
1656827368179,MATH 18,B02,083749,Rideout; David Porter,3,0,36,33
1656827368179,MATH 18,B03,083750,Rideout; David Porter,2,0,37,35
1656827368179,MATH 18,B04,083751,Rideout; David Porter,5,0,36,31
1656827368179,MATH 18,B05,093473,Rideout; David Porter,4,0,36,32
1656827368179,MATH 18,B06,093474,Rideout; David Porter,5,0,36,31
1656827374205,MATH 20A,A01,083754,Zheng; Zequn,12,0,40,28
1656827380229,MATH 20B,A01,083756,Briones; Jor-el Thomas Caparas,1,0,36,35
1656827380229,MATH 20B,A02,083757,Briones; Jor-el Thomas Caparas,1,0,36,35
1656827380229,MATH 20B,A03,093475,Briones; Jor-el Thomas Caparas,0,0,36,36
1656827386252,MATH 20C,A01,083760,Briones; Jor-el Thomas Caparas,1,0,35,34
1656827386252,MATH 20C,A02,083761,Briones; Jor-el Thomas Caparas,8,0,35,27
1656827386252,MATH 20C,A03,093476,Briones; Jor-el Thomas Caparas,0,1,36,36
1656827386252,MATH 20C,B01,083762,Bach; Quang Tran,0,0,30,30
1656827392282,MATH 20D,A01,083765,Tran; Brian Kha,4,0,30,26
1656827392282,MATH 20D,A02,083766,Tran; Brian Kha,4,0,30,26
1656827392282,MATH 20D,A03,083767,Tran; Brian Kha,2,0,30,28
1656827398311,MATH 20E,A01,083771,Ganguly; Soumya,5,0,32,27
1656827398311,MATH 20E,A02,083772,Ganguly; Soumya,6,0,32,26
1656827398311,MATH 20E,B01,083773,Ciotti; Benjamin,18,0,35,17
1656827398311,MATH 20E,B02,083774,Ciotti; Benjamin,17,0,35,18
1656827404334,MATH 103A,A01,083777,Greenfeld; Be'Eri,2,0,36,34
1656827404334,MATH 103A,A02,083778,Greenfeld; Be'Eri,5,0,36,31
1656827404334,MATH 103A,A03,093561,Greenfeld; Be'Eri,4,0,36,32
1656827404334,MATH 103A,B01,083779,Greenfeld; Be'Eri,6,0,36,30
1656827404334,MATH 103A,B02,083780,Greenfeld; Be'Eri,2,0,36,34
1656827404334,MATH 103A,B03,093562,Greenfeld; Be'Eri,2,0,36,34
1656827410363,MATH 105,A01,085443,Carter; Anne Toulson,13,0,35,22
1656827410363,MATH 105,A02,093477,Carter; Anne Toulson,20,0,35,15
1656827416405,MATH 109,A01,083213,Ganzberger; Geoffrey Michael,2,0,34,32
1656827416405,MATH 109,A02,083214,Ganzberger; Geoffrey Michael,2,0,34,32
1656827416405,MATH 109,A03,093478,Ganzberger; Geoffrey Michael,1,0,34,33
1656827416405,MATH 109,B01,083215,Ganzberger; Geoffrey Michael,1,0,32,31
1656827416405,MATH 109,B02,083216,Ganzberger; Geoffrey Michael,1,0,32,31
1656827416405,MATH 109,B03,093479,Ganzberger; Geoffrey Michael,6,0,32,26
1656827422433,MATH 142A,A01,083219,Chow; Bennett,6,0,32,26
1656827422433,MATH 142A,A02,083220,Chow; Bennett,9,0,32,23
1656827422433,MATH 142A,A03,093480,Chow; Bennett,7,0,32,25
1656827422433,MATH 142A,B03,093481,Chow; Bennett,7,0,32,25
1656827422433,MATH 142A,B04,093558,Chow; Bennett,10,0,32,22
1656827422433,MATH 142A,B05,093559,Chow; Bennett,6,0,32,26
1656827428464,MATH 193A,A01,083224,Rotar; Vladimir,6,0,34,28
1656827428464,MATH 193A,A02,083225,Rotar; Vladimir,3,0,34,31
1656827428464,MATH 193A,A03,083781,Rotar; Vladimir,1,0,34,33
1656827428464,MATH 193A,A04,083782,Rotar; Vladimir,6,0,34,28
1656827428464,MATH 193A,A05,093482,Rotar; Vladimir,6,0,34,28
1656827434490,MATH 197,001,091859,McAuley; Julian John,9999,0,9999,0
1656827434490,MATH 197,002,095566,Kedlaya; Kiran S.,9997,0,9999,2
1656827434490,MATH 197,003,095567,Xiao; Ming,9999,0,9999,0
1656827434490,MATH 197,004,095571,Perols; Johan Lars,9998,0,9999,1
1656827441547,COGS 9,A01,083615,Shannon; Kyle Michael,6,0,75,69
1656827447570,COGS 11,A01,083617,Boyle; Mary E. T.,18,0,48,30
1656827453666,COGS 13,A01,083071,Bastos; Amalia Pinkusfeld,8,0,71,63
1656827459693,COGS 14A,A01,092681,Semenuks; Arturs,0,1,100,100
1656827465716,COGS 14B,A01,083073,Cheng; Tzu-Han,5,0,63,58
1656827471738,COGS 17,A01,092677,Semenuks; Arturs,4,0,81,77
1656827477759,COGS 100,A01,083619,Allen; Michael Gordon,15,0,70,55
1656827483784,COGS 101A,A01,083621,Davis; Joshua Daniel,9,0,68,59
1656827489810,COGS 101B,A01,091572,Allen; Michael Gordon,8,0,65,57
1656827495834,COGS 101C,A01,083625,Delgado; Tania,17,0,35,18
1656827501857,COGS 107A,A01,083627,Boyle; Mary E. T.,13,0,60,47
1656827507884,COGS 118A,A01,083075,Gupta; Anjum,15,0,76,61
1656827513909,CSE 3,A50,083646,Miranda; Gregory Joseph,22,0,50,28
1656827519932,CSE 8A,A50,083650,Miranda; Gregory Joseph,17,1,56,39
1656827525955,CSE 11,A01,083080,Cao; Yingjun,4,15,40,36
1656827531981,CSE 12,A01,083652,Krause-Levy; Sophia Louisa,20,1,120,100
1656827538008,CSE 15L,A01,083654,Morris; Justin Loren,8,0,50,42
1656827538008,CSE 15L,A02,083655,Morris; Justin Loren,8,0,50,42
1656827544031,CSE 20,A01,083657,Tran; Khoa Dang,37,0,80,43
1656827550053,CSE 21,A01,095574,Bach; Quang Tran,21,0,48,27
1656827556080,CSE 30,A01,083084,Eldon; John,4,0,80,76
1656827556080,CSE 30,B01,095061,Bhaskar; Nishant,6,0,50,44
1656827562113,CSE 100,A01,083659,Cao; Yingjun,2,4,70,68
1656827568145,CSE 134B,A01,083661,Powell; Thomas Allan,19,0,100,81
1656827574168,CSE 140,A01,083663,Gungor; Onat,14,0,85,71
1656827580193,CSE 140L,A01,083088,Eldon; John,16,0,100,84
1656827586214,CSE 175,A01,083665,Kumar; Rakesh,3,0,25,22
1656827592239,CSE 190,A00,092507,Dubnov; Shlomo,7,0,20,13
1656827598263,ECE 45,A01,083139,Congero; Spencer William,5,0,75,70
1656827604286,ECE 65,A50,083695,Saad; Andrew S,12,0,30,18
1656827604286,ECE 65,A51,095125,Saad; Andrew S,25,0,26,1
1656827610309,ECE 109,A01,091882,Touri; Behrouz,16,0,70,54
1656827616336,ECE 180,A00,083140,Abi Samra; Nicholas Camill,0,0,30,30
1656827616336,ECE 180,B00,083141,Abi Samra; Nicholas Camill,0,0,30,30
1656827622361,MATH 10A,A01,083735,Patchell; Gregory David,1,0,30,29
1656827622361,MATH 10A,A02,083736,Patchell; Gregory David,20,0,30,10
1656827622361,MATH 10A,A03,083737,Patchell; Gregory David,15,0,30,15
1656827628384,MATH 10B,A01,083207,Lim; Seonhee,7,0,34,27
1656827628384,MATH 10B,A02,083208,Lim; Seonhee,9,0,35,26
1656827628384,MATH 10B,A03,093472,Lim; Seonhee,4,0,34,30
1656827628384,MATH 10B,B01,083739,Sinha; Shubham,9,0,30,21
1656827634416,MATH 18,A01,083743,Cinel; Cameron Alexander,6,0,30,24
1656827634416,MATH 18,A02,083744,Cinel; Cameron Alexander,15,0,30,15
1656827634416,MATH 18,A03,083745,Cinel; Cameron Alexander,8,0,30,22
1656827634416,MATH 18,B01,083748,Rideout; David Porter,3,0,37,34
1656827634416,MATH 18,B02,083749,Rideout; David Porter,3,0,36,33
1656827634416,MATH 18,B03,083750,Rideout; David Porter,2,0,37,35
1656827634416,MATH 18,B04,083751,Rideout; David Porter,5,0,36,31
1656827634416,MATH 18,B05,093473,Rideout; David Porter,4,0,36,32
1656827634416,MATH 18,B06,093474,Rideout; David Porter,5,0,36,31
1656827640440,MATH 20A,A01,083754,Zheng; Zequn,12,0,40,28
1656827646463,MATH 20B,A01,083756,Briones; Jor-el Thomas Caparas,1,0,36,35
1656827646463,MATH 20B,A02,083757,Briones; Jor-el Thomas Caparas,1,0,36,35
1656827646463,MATH 20B,A03,093475,Briones; Jor-el Thomas Caparas,0,0,36,36
1656827652496,MATH 20C,A01,083760,Briones; Jor-el Thomas Caparas,1,0,35,34
1656827652496,MATH 20C,A02,083761,Briones; Jor-el Thomas Caparas,8,0,35,27
1656827652496,MATH 20C,A03,093476,Briones; Jor-el Thomas Caparas,0,1,36,36
1656827652496,MATH 20C,B01,083762,Bach; Quang Tran,0,0,30,30
1656827658520,MATH 20D,A01,083765,Tran; Brian Kha,4,0,30,26
1656827658520,MATH 20D,A02,083766,Tran; Brian Kha,4,0,30,26
1656827658520,MATH 20D,A03,083767,Tran; Brian Kha,2,0,30,28
1656827664549,MATH 20E,A01,083771,Ganguly; Soumya,5,0,32,27
1656827664549,MATH 20E,A02,083772,Ganguly; Soumya,6,0,32,26
1656827664549,MATH 20E,B01,083773,Ciotti; Benjamin,18,0,35,17
1656827664549,MATH 20E,B02,083774,Ciotti; Benjamin,17,0,35,18
1656827670580,MATH 103A,A01,083777,Greenfeld; Be'Eri,2,0,36,34
1656827670580,MATH 103A,A02,083778,Greenfeld; Be'Eri,5,0,36,31
1656827670580,MATH 103A,A03,093561,Greenfeld; Be'Eri,4,0,36,32
1656827670580,MATH 103A,B01,083779,Greenfeld; Be'Eri,6,0,36,30
1656827670580,MATH 103A,B02,083780,Greenfeld; Be'Eri,2,0,36,34
1656827670580,MATH 103A,B03,093562,Greenfeld; Be'Eri,2,0,36,34
1656827676602,MATH 105,A01,085443,Carter; Anne Toulson,13,0,35,22
1656827676602,MATH 105,A02,093477,Carter; Anne Toulson,20,0,35,15
1656827682627,MATH 109,A01,083213,Ganzberger; Geoffrey Michael,2,0,34,32
1656827682627,MATH 109,A02,083214,Ganzberger; Geoffrey Michael,2,0,34,32
1656827682627,MATH 109,A03,093478,Ganzberger; Geoffrey Michael,1,0,34,33
1656827682627,MATH 109,B01,083215,Ganzberger; Geoffrey Michael,1,0,32,31
1656827682627,MATH 109,B02,083216,Ganzberger; Geoffrey Michael,1,0,32,31
1656827682627,MATH 109,B03,093479,Ganzberger; Geoffrey Michael,6,0,32,26
1656827688656,MATH 142A,A01,083219,Chow; Bennett,6,0,32,26
1656827688656,MATH 142A,A02,083220,Chow; Bennett,9,0,32,23
1656827688656,MATH 142A,A03,093480,Chow; Bennett,7,0,32,25
1656827688656,MATH 142A,B03,093481,Chow; Bennett,7,0,32,25
1656827688656,MATH 142A,B04,093558,Chow; Bennett,10,0,32,22
1656827688656,MATH 142A,B05,093559,Chow; Bennett,6,0,32,26
1656827694685,MATH 193A,A01,083224,Rotar; Vladimir,6,0,34,28
1656827694685,MATH 193A,A02,083225,Rotar; Vladimir,3,0,34,31
1656827694685,MATH 193A,A03,083781,Rotar; Vladimir,1,0,34,33
1656827694685,MATH 193A,A04,083782,Rotar; Vladimir,6,0,34,28
1656827694685,MATH 193A,A05,093482,Rotar; Vladimir,6,0,34,28
1656827700718,MATH 197,001,091859,McAuley; Julian John,9999,0,9999,0
1656827700718,MATH 197,002,095566,Kedlaya; Kiran S.,9997,0,9999,2
1656827700718,MATH 197,003,095567,Xiao; Ming,9999,0,9999,0
1656827700718,MATH 197,004,095571,Perols; Johan Lars,9998,0,9999,1
1656827707770,COGS 9,A01,083615,Shannon; Kyle Michael,6,0,75,69
1656827713793,COGS 11,A01,083617,Boyle; Mary E. T.,18,0,48,30
1656827719817,COGS 13,A01,083071,Bastos; Amalia Pinkusfeld,8,0,71,63
1656827725843,COGS 14A,A01,092681,Semenuks; Arturs,0,1,100,100
1656827731866,COGS 14B,A01,083073,Cheng; Tzu-Han,5,0,63,58
1656827737891,COGS 17,A01,092677,Semenuks; Arturs,4,0,81,77
1656827743913,COGS 100,A01,083619,Allen; Michael Gordon,15,0,70,55
1656827749939,COGS 101A,A01,083621,Davis; Joshua Daniel,9,0,68,59
1656827755971,COGS 101B,A01,091572,Allen; Michael Gordon,8,0,65,57
1656827761994,COGS 101C,A01,083625,Delgado; Tania,17,0,35,18
1656827768018,COGS 107A,A01,083627,Boyle; Mary E. T.,13,0,60,47
1656827774044,COGS 118A,A01,083075,Gupta; Anjum,15,0,76,61
1656827780069,CSE 3,A50,083646,Miranda; Gregory Joseph,22,0,50,28
1656827786092,CSE 8A,A50,083650,Miranda; Gregory Joseph,17,1,56,39
1656827792115,CSE 11,A01,083080,Cao; Yingjun,4,15,40,36
1656827798137,CSE 12,A01,083652,Krause-Levy; Sophia Louisa,20,1,120,100
1656827804160,CSE 15L,A01,083654,Morris; Justin Loren,8,0,50,42
1656827804160,CSE 15L,A02,083655,Morris; Justin Loren,8,0,50,42
1656827810182,CSE 20,A01,083657,Tran; Khoa Dang,37,0,80,43
1656827816205,CSE 21,A01,095574,Bach; Quang Tran,21,0,48,27
1656827822228,CSE 30,A01,083084,Eldon; John,4,0,80,76
1656827822228,CSE 30,B01,095061,Bhaskar; Nishant,6,0,50,44
1656827828250,CSE 100,A01,083659,Cao; Yingjun,2,4,70,68
1656827834274,CSE 134B,A01,083661,Powell; Thomas Allan,19,0,100,81
1656827840299,CSE 140,A01,083663,Gungor; Onat,14,0,85,71
1656827846325,CSE 140L,A01,083088,Eldon; John,16,0,100,84
1656827852348,CSE 175,A01,083665,Kumar; Rakesh,3,0,25,22
1656827858370,CSE 190,A00,092507,Dubnov; Shlomo,7,0,20,13
1656827864397,ECE 45,A01,083139,Congero; Spencer William,5,0,75,70
1656827870420,ECE 65,A50,083695,Saad; Andrew S,12,0,30,18
1656827870420,ECE 65,A51,095125,Saad; Andrew S,25,0,26,1
1656827876443,ECE 109,A01,091882,Touri; Behrouz,16,0,70,54
1656827882470,ECE 180,A00,083140,Abi Samra; Nicholas Camill,0,0,30,30
1656827882470,ECE 180,B00,083141,Abi Samra; Nicholas Camill,0,0,30,30
1656827888492,MATH 10A,A01,083735,Patchell; Gregory David,1,0,30,29
1656827888492,MATH 10A,A02,083736,Patchell; Gregory David,20,0,30,10
1656827888492,MATH 10A,A03,083737,Patchell; Gregory David,15,0,30,15
1656827894523,MATH 10B,A01,083207,Lim; Seonhee,7,0,34,27
1656827894523,MATH 10B,A02,083208,Lim; Seonhee,9,0,35,26
1656827894523,MATH 10B,A03,093472,Lim; Seonhee,4,0,34,30
1656827894523,MATH 10B,B01,083739,Sinha; Shubham,9,0,30,21
1656827900547,MATH 18,A01,083743,Cinel; Cameron Alexander,6,0,30,24
1656827900547,MATH 18,A02,083744,Cinel; Cameron Alexander,15,0,30,15
1656827900547,MATH 18,A03,083745,Cinel; Cameron Alexander,8,0,30,22
1656827900547,MATH 18,B01,083748,Rideout; David Porter,3,0,37,34
1656827900547,MATH 18,B02,083749,Rideout; David Porter,3,0,36,33
1656827900547,MATH 18,B03,083750,Rideout; David Porter,2,0,37,35
1656827900547,MATH 18,B04,083751,Rideout; David Porter,5,0,36,31
1656827900547,MATH 18,B05,093473,Rideout; David Porter,4,0,36,32
1656827900547,MATH 18,B06,093474,Rideout; David Porter,5,0,36,31
1656827906571,MATH 20A,A01,083754,Zheng; Zequn,12,0,40,28
1656827912595,MATH 20B,A01,083756,Briones; Jor-el Thomas Caparas,1,0,36,35
1656827912595,MATH 20B,A02,083757,Briones; Jor-el Thomas Caparas,1,0,36,35
1656827912595,MATH 20B,A03,093475,Briones; Jor-el Thomas Caparas,0,0,36,36
1656827918623,MATH 20C,A01,083760,Briones; Jor-el Thomas Caparas,1,0,35,34
1656827918623,MATH 20C,A02,083761,Briones; Jor-el Thomas Caparas,8,0,35,27
1656827918623,MATH 20C,A03,093476,Briones; Jor-el Thomas Caparas,0,1,36,36
1656827918623,MATH 20C,B01,083762,Bach; Quang Tran,0,0,30,30
1656827924654,MATH 20D,A01,083765,Tran; Brian Kha,4,0,30,26
1656827924654,MATH 20D,A02,083766,Tran; Brian Kha,4,0,30,26
1656827924654,MATH 20D,A03,083767,Tran; Brian Kha,2,0,30,28
1656827930677,MATH 20E,A01,083771,Ganguly; Soumya,5,0,32,27
1656827930677,MATH 20E,A02,083772,Ganguly; Soumya,6,0,32,26
1656827930677,MATH 20E,B01,083773,Ciotti; Benjamin,18,0,35,17
1656827930677,MATH 20E,B02,083774,Ciotti; Benjamin,17,0,35,18
1656827936701,MATH 103A,A01,083777,Greenfeld; Be'Eri,2,0,36,34
1656827936701,MATH 103A,A02,083778,Greenfeld; Be'Eri,5,0,36,31
1656827936701,MATH 103A,A03,093561,Greenfeld; Be'Eri,4,0,36,32
1656827936701,MATH 103A,B01,083779,Greenfeld; Be'Eri,6,0,36,30
1656827936701,MATH 103A,B02,083780,Greenfeld; Be'Eri,2,0,36,34
1656827936701,MATH 103A,B03,093562,Greenfeld; Be'Eri,2,0,36,34
1656827942728,MATH 105,A01,085443,Carter; Anne Toulson,13,0,35,22
1656827942728,MATH 105,A02,093477,Carter; Anne Toulson,20,0,35,15
1656827948750,MATH 109,A01,083213,Ganzberger; Geoffrey Michael,2,0,34,32
1656827948750,MATH 109,A02,083214,Ganzberger; Geoffrey Michael,2,0,34,32
1656827948750,MATH 109,A03,093478,Ganzberger; Geoffrey Michael,1,0,34,33
1656827948750,MATH 109,B01,083215,Ganzberger; Geoffrey Michael,1,0,32,31
1656827948750,MATH 109,B02,083216,Ganzberger; Geoffrey Michael,1,0,32,31
1656827948750,MATH 109,B03,093479,Ganzberger; Geoffrey Michael,6,0,32,26
1656827954780,MATH 142A,A01,083219,Chow; Bennett,6,0,32,26
1656827954780,MATH 142A,A02,083220,Chow; Bennett,9,0,32,23
1656827954780,MATH 142A,A03,093480,Chow; Bennett,7,0,32,25
1656827954780,MATH 142A,B03,093481,Chow; Bennett,7,0,32,25
1656827954780,MATH 142A,B04,093558,Chow; Bennett,10,0,32,22
1656827954780,MATH 142A,B05,093559,Chow; Bennett,6,0,32,26
1656827960803,MATH 193A,A01,083224,Rotar; Vladimir,6,0,34,28
1656827960803,MATH 193A,A02,083225,Rotar; Vladimir,3,0,34,31
1656827960803,MATH 193A,A03,083781,Rotar; Vladimir,1,0,34,33
1656827960803,MATH 193A,A04,083782,Rotar; Vladimir,6,0,34,28
1656827960803,MATH 193A,A05,093482,Rotar; Vladimir,6,0,34,28
1656827966830,MATH 197,001,091859,McAuley; Julian John,9999,0,9999,0
1656827966830,MATH 197,002,095566,Kedlaya; Kiran S.,9997,0,9999,2
1656827966830,MATH 197,003,095567,Xiao; Ming,9999,0,9999,0
1656827966830,MATH 197,004,095571,Perols; Johan Lars,9998,0,9999,1
1656827973899,COGS 9,A01,083615,Shannon; Kyle Michael,6,0,75,69
1656827979929,COGS 11,A01,083617,Boyle; Mary E. T.,18,0,48,30
1656827985956,COGS 13,A01,083071,Bastos; Amalia Pinkusfeld,8,0,71,63
1656827991983,COGS 14A,A01,092681,Semenuks; Arturs,0,1,100,100
1656827998007,COGS 14B,A01,083073,Cheng; Tzu-Han,5,0,63,58
1656828004037,COGS 17,A01,092677,Semenuks; Arturs,4,0,81,77
1656828010063,COGS 100,A01,083619,Allen; Michael Gordon,15,0,70,55
1656828016090,COGS 101A,A01,083621,Davis; Joshua Daniel,9,0,68,59
1656828022115,COGS 101B,A01,091572,Allen; Michael Gordon,8,0,65,57
1656828028141,COGS 101C,A01,083625,Delgado; Tania,17,0,35,18
1656828034164,COGS 107A,A01,083627,Boyle; Mary E. T.,13,0,60,47
1656828040194,COGS 118A,A01,083075,Gupta; Anjum,15,0,76,61
1656828046223,CSE 3,A50,083646,Miranda; Gregory Joseph,22,0,50,28
1656828052335,CSE 8A,A50,083650,Miranda; Gregory Joseph,17,1,56,39
1656828058357,CSE 11,A01,083080,Cao; Yingjun,4,15,40,36
1656828064390,CSE 12,A01,083652,Krause-Levy; Sophia Louisa,20,1,120,100
1656828070417,CSE 15L,A01,083654,Morris; Justin Loren,8,0,50,42
1656828070417,CSE 15L,A02,083655,Morris; Justin Loren,8,0,50,42
1656828076441,CSE 20,A01,083657,Tran; Khoa Dang,37,0,80,43
1656828082470,CSE 21,A01,095574,Bach; Quang Tran,21,0,48,27
1656828088492,CSE 30,A01,083084,Eldon; John,4,0,80,76
1656828088492,CSE 30,B01,095061,Bhaskar; Nishant,6,0,50,44
1656828094523,CSE 100,A01,083659,Cao; Yingjun,2,4,70,68
1656828100547,CSE 134B,A01,083661,Powell; Thomas Allan,19,0,100,81
1656828106569,CSE 140,A01,083663,Gungor; Onat,14,0,85,71
1656828112608,CSE 140L,A01,083088,Eldon; John,16,0,100,84
1656828118630,CSE 175,A01,083665,Kumar; Rakesh,3,0,25,22
1656828124652,CSE 190,A00,092507,Dubnov; Shlomo,7,0,20,13
1656828130683,ECE 45,A01,083139,Congero; Spencer William,5,0,75,70
1656828136710,ECE 65,A50,083695,Saad; Andrew S,12,0,30,18
1656828136710,ECE 65,A51,095125,Saad; Andrew S,25,0,26,1
1656828142744,ECE 109,A01,091882,Touri; Behrouz,16,0,70,54
1656828148770,ECE 180,A00,083140,Abi Samra; Nicholas Camill,0,0,30,30
1656828148770,ECE 180,B00,083141,Abi Samra; Nicholas Camill,0,0,30,30
1656828154801,MATH 10A,A01,083735,Patchell; Gregory David,1,0,30,29
1656828154801,MATH 10A,A02,083736,Patchell; Gregory David,20,0,30,10
1656828154801,MATH 10A,A03,083737,Patchell; Gregory David,15,0,30,15
1656828160830,MATH 10B,A01,083207,Lim; Seonhee,7,0,34,27
1656828160830,MATH 10B,A02,083208,Lim; Seonhee,9,0,35,26
1656828160830,MATH 10B,A03,093472,Lim; Seonhee,4,0,34,30
1656828160830,MATH 10B,B01,083739,Sinha; Shubham,9,0,30,21
1656828166854,MATH 18,A01,083743,Cinel; Cameron Alexander,6,0,30,24
1656828166854,MATH 18,A02,083744,Cinel; Cameron Alexander,15,0,30,15
1656828166854,MATH 18,A03,083745,Cinel; Cameron Alexander,8,0,30,22
1656828166854,MATH 18,B01,083748,Rideout; David Porter,3,0,37,34
1656828166854,MATH 18,B02,083749,Rideout; David Porter,3,0,36,33
1656828166854,MATH 18,B03,083750,Rideout; David Porter,2,0,37,35
1656828166854,MATH 18,B04,083751,Rideout; David Porter,5,0,36,31
1656828166854,MATH 18,B05,093473,Rideout; David Porter,4,0,36,32
1656828166854,MATH 18,B06,093474,Rideout; David Porter,5,0,36,31
1656828172878,MATH 20A,A01,083754,Zheng; Zequn,12,0,40,28
1656828178907,MATH 20B,A01,083756,Briones; Jor-el Thomas Caparas,1,0,36,35
1656828178907,MATH 20B,A02,083757,Briones; Jor-el Thomas Caparas,1,0,36,35
1656828178907,MATH 20B,A03,093475,Briones; Jor-el Thomas Caparas,0,0,36,36
1656828184931,MATH 20C,A01,083760,Briones; Jor-el Thomas Caparas,1,0,35,34
1656828184931,MATH 20C,A02,083761,Briones; Jor-el Thomas Caparas,8,0,35,27
1656828184931,MATH 20C,A03,093476,Briones; Jor-el Thomas Caparas,0,1,36,36
1656828184931,MATH 20C,B01,083762,Bach; Quang Tran,0,0,30,30
1656828190966,MATH 20D,A01,083765,Tran; Brian Kha,4,0,30,26
1656828190966,MATH 20D,A02,083766,Tran; Brian Kha,4,0,30,26
1656828190966,MATH 20D,A03,083767,Tran; Brian Kha,2,0,30,28
1656828196991,MATH 20E,A01,083771,Ganguly; Soumya,5,0,32,27
1656828196991,MATH 20E,A02,083772,Ganguly; Soumya,6,0,32,26
1656828196991,MATH 20E,B01,083773,Ciotti; Benjamin,18,0,35,17
1656828196991,MATH 20E,B02,083774,Ciotti; Benjamin,17,0,35,18
1656828203015,MATH 103A,A01,083777,Greenfeld; Be'Eri,2,0,36,34
1656828203015,MATH 103A,A02,083778,Greenfeld; Be'Eri,5,0,36,31
1656828203015,MATH 103A,A03,093561,Greenfeld; Be'Eri,4,0,36,32
1656828203015,MATH 103A,B01,083779,Greenfeld; Be'Eri,6,0,36,30
1656828203015,MATH 103A,B02,083780,Greenfeld; Be'Eri,2,0,36,34
1656828203015,MATH 103A,B03,093562,Greenfeld; Be'Eri,2,0,36,34
1656828209039,MATH 105,A01,085443,Carter; Anne Toulson,13,0,35,22
1656828209039,MATH 105,A02,093477,Carter; Anne Toulson,20,0,35,15
1656828215071,MATH 109,A01,083213,Ganzberger; Geoffrey Michael,2,0,34,32
1656828215071,MATH 109,A02,083214,Ganzberger; Geoffrey Michael,2,0,34,32
1656828215071,MATH 109,A03,093478,Ganzberger; Geoffrey Michael,1,0,34,33
1656828215071,MATH 109,B01,083215,Ganzberger; Geoffrey Michael,1,0,32,31
1656828215071,MATH 109,B02,083216,Ganzberger; Geoffrey Michael,1,0,32,31
1656828215071,MATH 109,B03,093479,Ganzberger; Geoffrey Michael,6,0,32,26
1656828221096,MATH 142A,A01,083219,Chow; Bennett,6,0,32,26
1656828221096,MATH 142A,A02,083220,Chow; Bennett,9,0,32,23
1656828221096,MATH 142A,A03,093480,Chow; Bennett,7,0,32,25
1656828221096,MATH 142A,B03,093481,Chow; Bennett,7,0,32,25
1656828221096,MATH 142A,B04,093558,Chow; Bennett,10,0,32,22
1656828221096,MATH 142A,B05,093559,Chow; Bennett,6,0,32,26
1656828227119,MATH 193A,A01,083224,Rotar; Vladimir,6,0,34,28
1656828227119,MATH 193A,A02,083225,Rotar; Vladimir,3,0,34,31
1656828227119,MATH 193A,A03,083781,Rotar; Vladimir,1,0,34,33
1656828227119,MATH 193A,A04,083782,Rotar; Vladimir,6,0,34,28
1656828227119,MATH 193A,A05,093482,Rotar; Vladimir,6,0,34,28
1656828233151,MATH 197,001,091859,McAuley; Julian John,9999,0,9999,0
1656828233151,MATH 197,002,095566,Kedlaya; Kiran S.,9997,0,9999,2
1656828233151,MATH 197,003,095567,Xiao; Ming,9999,0,9999,0
1656828233151,MATH 197,004,095571,Perols; Johan Lars,9998,0,9999,1
1656828240225,COGS 9,A01,083615,Shannon; Kyle Michael,6,0,75,69
1656828246247,COGS 11,A01,083617,Boyle; Mary E. T.,18,0,48,30
1656828252272,COGS 13,A01,083071,Bastos; Amalia Pinkusfeld,8,0,71,63
1656828258299,COGS 14A,A01,092681,Semenuks; Arturs,0,1,100,100
1656828264331,COGS 14B,A01,083073,Cheng; Tzu-Han,5,0,63,58
1656828270355,COGS 17,A01,092677,Semenuks; Arturs,4,0,81,77
1656828276378,COGS 100,A01,083619,Allen; Michael Gordon,15,0,70,55
1656828282401,COGS 101A,A01,083621,Davis; Joshua Daniel,9,0,68,59
1656828288423,COGS 101B,A01,091572,Allen; Michael Gordon,8,0,65,57
1656828294456,COGS 101C,A01,083625,Delgado; Tania,17,0,35,18
1656828300478,COGS 107A,A01,083627,Boyle; Mary E. T.,13,0,60,47
1656828306504,COGS 118A,A01,083075,Gupta; Anjum,15,0,76,61
1656828312537,CSE 3,A50,083646,Miranda; Gregory Joseph,22,0,50,28
1656828318569,CSE 8A,A50,083650,Miranda; Gregory Joseph,17,1,56,39
1656828324595,CSE 11,A01,083080,Cao; Yingjun,4,15,40,36
1656828330634,CSE 12,A01,083652,Krause-Levy; Sophia Louisa,20,1,120,100
1656828336661,CSE 15L,A01,083654,Morris; Justin Loren,8,0,50,42
1656828336661,CSE 15L,A02,083655,Morris; Justin Loren,8,0,50,42
1656828342684,CSE 20,A01,083657,Tran; Khoa Dang,37,0,80,43
1656828348710,CSE 21,A01,095574,Bach; Quang Tran,21,0,48,27
1656828354736,CSE 30,A01,083084,Eldon; John,4,0,80,76
1656828354736,CSE 30,B01,095061,Bhaskar; Nishant,6,0,50,44
1656828360759,CSE 100,A01,083659,Cao; Yingjun,2,4,70,68
1656828366795,CSE 134B,A01,083661,Powell; Thomas Allan,19,0,100,81
1656828372822,CSE 140,A01,083663,Gungor; Onat,14,0,85,71
1656828378848,CSE 140L,A01,083088,Eldon; John,16,0,100,84
1656828384876,CSE 175,A01,083665,Kumar; Rakesh,3,0,25,22
1656828390900,CSE 190,A00,092507,Dubnov; Shlomo,7,0,20,13
1656828396928,ECE 45,A01,083139,Congero; Spencer William,5,0,75,70
1656828402951,ECE 65,A50,083695,Saad; Andrew S,12,0,30,18
1656828402951,ECE 65,A51,095125,Saad; Andrew S,25,0,26,1
1656828408974,ECE 109,A01,091882,Touri; Behrouz,16,0,70,54
1656828415004,ECE 180,A00,083140,Abi Samra; Nicholas Camill,0,0,30,30
1656828415004,ECE 180,B00,083141,Abi Samra; Nicholas Camill,0,0,30,30
1656828421037,MATH 10A,A01,083735,Patchell; Gregory David,1,0,30,29
1656828421037,MATH 10A,A02,083736,Patchell; Gregory David,20,0,30,10
1656828421037,MATH 10A,A03,083737,Patchell; Gregory David,15,0,30,15
1656828427061,MATH 10B,A01,083207,Lim; Seonhee,7,0,34,27
1656828427061,MATH 10B,A02,083208,Lim; Seonhee,9,0,35,26
1656828427061,MATH 10B,A03,093472,Lim; Seonhee,4,0,34,30
1656828427061,MATH 10B,B01,083739,Sinha; Shubham,9,0,30,21
1656828433087,MATH 18,A01,083743,Cinel; Cameron Alexander,6,0,30,24
1656828433087,MATH 18,A02,083744,Cinel; Cameron Alexander,15,0,30,15
1656828433087,MATH 18,A03,083745,Cinel; Cameron Alexander,8,0,30,22
1656828433087,MATH 18,B01,083748,Rideout; David Porter,3,0,37,34
1656828433087,MATH 18,B02,083749,Rideout; David Porter,3,0,36,33
1656828433087,MATH 18,B03,083750,Rideout; David Porter,2,0,37,35
1656828433087,MATH 18,B04,083751,Rideout; David Porter,5,0,36,31
1656828433087,MATH 18,B05,093473,Rideout; David Porter,4,0,36,32
1656828433087,MATH 18,B06,093474,Rideout; David Porter,5,0,36,31
1656828439114,MATH 20A,A01,083754,Zheng; Zequn,12,0,40,28
1656828445138,MATH 20B,A01,083756,Briones; Jor-el Thomas Caparas,1,0,36,35
1656828445138,MATH 20B,A02,083757,Briones; Jor-el Thomas Caparas,1,0,36,35
1656828445138,MATH 20B,A03,093475,Briones; Jor-el Thomas Caparas,0,0,36,36
1656828451169,MATH 20C,A01,083760,Briones; Jor-el Thomas Caparas,1,0,35,34
1656828451169,MATH 20C,A02,083761,Briones; Jor-el Thomas Caparas,8,0,35,27
1656828451169,MATH 20C,A03,093476,Briones; Jor-el Thomas Caparas,0,1,36,36
1656828451169,MATH 20C,B01,083762,Bach; Quang Tran,0,0,30,30
1656828457193,MATH 20D,A01,083765,Tran; Brian Kha,4,0,30,26
1656828457193,MATH 20D,A02,083766,Tran; Brian Kha,4,0,30,26
1656828457193,MATH 20D,A03,083767,Tran; Brian Kha,2,0,30,28
1656828463217,MATH 20E,A01,083771,Ganguly; Soumya,5,0,32,27
1656828463217,MATH 20E,A02,083772,Ganguly; Soumya,6,0,32,26
1656828463217,MATH 20E,B01,083773,Ciotti; Benjamin,18,0,35,17
1656828463217,MATH 20E,B02,083774,Ciotti; Benjamin,17,0,35,18
1656828469251,MATH 103A,A01,083777,Greenfeld; Be'Eri,2,0,36,34
1656828469251,MATH 103A,A02,083778,Greenfeld; Be'Eri,5,0,36,31
1656828469251,MATH 103A,A03,093561,Greenfeld; Be'Eri,4,0,36,32
1656828469251,MATH 103A,B01,083779,Greenfeld; Be'Eri,6,0,36,30
1656828469251,MATH 103A,B02,083780,Greenfeld; Be'Eri,2,0,36,34
1656828469251,MATH 103A,B03,093562,Greenfeld; Be'Eri,2,0,36,34
1656828475278,MATH 105,A01,085443,Carter; Anne Toulson,13,0,35,22
1656828475278,MATH 105,A02,093477,Carter; Anne Toulson,20,0,35,15
1656828481308,MATH 109,A01,083213,Ganzberger; Geoffrey Michael,2,0,34,32
1656828481308,MATH 109,A02,083214,Ganzberger; Geoffrey Michael,2,0,34,32
1656828481308,MATH 109,A03,093478,Ganzberger; Geoffrey Michael,1,0,34,33
1656828481308,MATH 109,B01,083215,Ganzberger; Geoffrey Michael,1,0,32,31
1656828481308,MATH 109,B02,083216,Ganzberger; Geoffrey Michael,1,0,32,31
1656828481308,MATH 109,B03,093479,Ganzberger; Geoffrey Michael,6,0,32,26
1656828487338,MATH 142A,A01,083219,Chow; Bennett,6,0,32,26
1656828487338,MATH 142A,A02,083220,Chow; Bennett,9,0,32,23
1656828487338,MATH 142A,A03,093480,Chow; Bennett,7,0,32,25
1656828487338,MATH 142A,B03,093481,Chow; Bennett,7,0,32,25
1656828487338,MATH 142A,B04,093558,Chow; Bennett,10,0,32,22
1656828487338,MATH 142A,B05,093559,Chow; Bennett,6,0,32,26
1656828493361,MATH 193A,A01,083224,Rotar; Vladimir,6,0,34,28
1656828493361,MATH 193A,A02,083225,Rotar; Vladimir,3,0,34,31
1656828493361,MATH 193A,A03,083781,Rotar; Vladimir,1,0,34,33
1656828493361,MATH 193A,A04,083782,Rotar; Vladimir,6,0,34,28
1656828493361,MATH 193A,A05,093482,Rotar; Vladimir,6,0,34,28
1656828499383,MATH 197,001,091859,McAuley; Julian John,9999,0,9999,0
1656828499383,MATH 197,002,095566,Kedlaya; Kiran S.,9997,0,9999,2
1656828499383,MATH 197,003,095567,Xiao; Ming,9999,0,9999,0
1656828499383,MATH 197,004,095571,Perols; Johan Lars,9998,0,9999,1
1656828506436,COGS 9,A01,083615,Shannon; Kyle Michael,6,0,75,69
1656828512459,COGS 11,A01,083617,Boyle; Mary E. T.,18,0,48,30
1656828518482,COGS 13,A01,083071,Bastos; Amalia Pinkusfeld,8,0,71,63
1656828524513,COGS 14A,A01,092681,Semenuks; Arturs,0,1,100,100
1656828530545,COGS 14B,A01,083073,Cheng; Tzu-Han,5,0,63,58
1656828536572,COGS 17,A01,092677,Semenuks; Arturs,4,0,81,77
1656828542595,COGS 100,A01,083619,Allen; Michael Gordon,15,0,70,55
1656828548618,COGS 101A,A01,083621,Davis; Joshua Daniel,9,0,68,59
1656828554642,COGS 101B,A01,091572,Allen; Michael Gordon,8,0,65,57
1656828560673,COGS 101C,A01,083625,Delgado; Tania,17,0,35,18
1656828566700,COGS 107A,A01,083627,Boyle; Mary E. T.,13,0,60,47
1656828572724,COGS 118A,A01,083075,Gupta; Anjum,15,0,76,61
1656828578752,CSE 3,A50,083646,Miranda; Gregory Joseph,22,0,50,28
1656828584781,CSE 8A,A50,083650,Miranda; Gregory Joseph,17,1,56,39
1656828590804,CSE 11,A01,083080,Cao; Yingjun,4,15,40,36
1656828596830,CSE 12,A01,083652,Krause-Levy; Sophia Louisa,20,1,120,100
1656828602853,CSE 15L,A01,083654,Morris; Justin Loren,8,0,50,42
1656828602853,CSE 15L,A02,083655,Morris; Justin Loren,8,0,50,42
1656828608876,CSE 20,A01,083657,Tran; Khoa Dang,37,0,80,43
1656828614908,CSE 21,A01,095574,Bach; Quang Tran,21,0,48,27
1656828620932,CSE 30,A01,083084,Eldon; John,4,0,80,76
1656828620932,CSE 30,B01,095061,Bhaskar; Nishant,6,0,50,44
1656828626956,CSE 100,A01,083659,Cao; Yingjun,2,4,70,68
1656828632978,CSE 134B,A01,083661,Powell; Thomas Allan,19,0,100,81
1656828639009,CSE 140,A01,083663,Gungor; Onat,14,0,85,71
1656828645032,CSE 140L,A01,083088,Eldon; John,16,0,100,84
1656828651150,CSE 175,A01,083665,Kumar; Rakesh,3,0,25,22
1656828657178,CSE 190,A00,092507,Dubnov; Shlomo,7,0,20,13
1656828663202,ECE 45,A01,083139,Congero; Spencer William,5,0,75,70
1656828669230,ECE 65,A50,083695,Saad; Andrew S,12,0,30,18
1656828669230,ECE 65,A51,095125,Saad; Andrew S,25,0,26,1
1656828675251,ECE 109,A01,091882,Touri; Behrouz,16,0,70,54
1656828681277,ECE 180,A00,083140,Abi Samra; Nicholas Camill,0,0,30,30
1656828681277,ECE 180,B00,083141,Abi Samra; Nicholas Camill,0,0,30,30
1656828687308,MATH 10A,A01,083735,Patchell; Gregory David,1,0,30,29
1656828687308,MATH 10A,A02,083736,Patchell; Gregory David,20,0,30,10
1656828687308,MATH 10A,A03,083737,Patchell; Gregory David,15,0,30,15
1656828693348,MATH 10B,A01,083207,Lim; Seonhee,7,0,34,27
1656828693348,MATH 10B,A02,083208,Lim; Seonhee,9,0,35,26
1656828693348,MATH 10B,A03,093472,Lim; Seonhee,4,0,34,30
1656828693348,MATH 10B,B01,083739,Sinha; Shubham,9,0,30,21
1656828699374,MATH 18,A01,083743,Cinel; Cameron Alexander,6,0,30,24
1656828699374,MATH 18,A02,083744,Cinel; Cameron Alexander,15,0,30,15
1656828699374,MATH 18,A03,083745,Cinel; Cameron Alexander,8,0,30,22
1656828699374,MATH 18,B01,083748,Rideout; David Porter,3,0,37,34
1656828699374,MATH 18,B02,083749,Rideout; David Porter,3,0,36,33
1656828699374,MATH 18,B03,083750,Rideout; David Porter,2,0,37,35
1656828699374,MATH 18,B04,083751,Rideout; David Porter,5,0,36,31
1656828699374,MATH 18,B05,093473,Rideout; David Porter,4,0,36,32
1656828699374,MATH 18,B06,093474,Rideout; David Porter,5,0,36,31
1656828705402,MATH 20A,A01,083754,Zheng; Zequn,12,0,40,28
1656828711426,MATH 20B,A01,083756,Briones; Jor-el Thomas Caparas,1,0,36,35
1656828711426,MATH 20B,A02,083757,Briones; Jor-el Thomas Caparas,1,0,36,35
1656828711426,MATH 20B,A03,093475,Briones; Jor-el Thomas Caparas,0,0,36,36
1656828717449,MATH 20C,A01,083760,Briones; Jor-el Thomas Caparas,1,0,35,34
1656828717449,MATH 20C,A02,083761,Briones; Jor-el Thomas Caparas,8,0,35,27
1656828717449,MATH 20C,A03,093476,Briones; Jor-el Thomas Caparas,0,1,36,36
1656828717449,MATH 20C,B01,083762,Bach; Quang Tran,0,0,30,30
1656828723478,MATH 20D,A01,083765,Tran; Brian Kha,4,0,30,26
1656828723478,MATH 20D,A02,083766,Tran; Brian Kha,4,0,30,26
1656828723478,MATH 20D,A03,083767,Tran; Brian Kha,2,0,30,28
1656828729506,MATH 20E,A01,083771,Ganguly; Soumya,5,0,32,27
1656828729506,MATH 20E,A02,083772,Ganguly; Soumya,6,0,32,26
1656828729506,MATH 20E,B01,083773,Ciotti; Benjamin,18,0,35,17
1656828729506,MATH 20E,B02,083774,Ciotti; Benjamin,17,0,35,18
1656828735537,MATH 103A,A01,083777,Greenfeld; Be'Eri,2,0,36,34
1656828735537,MATH 103A,A02,083778,Greenfeld; Be'Eri,5,0,36,31
1656828735537,MATH 103A,A03,093561,Greenfeld; Be'Eri,4,0,36,32
1656828735537,MATH 103A,B01,083779,Greenfeld; Be'Eri,6,0,36,30
1656828735537,MATH 103A,B02,083780,Greenfeld; Be'Eri,2,0,36,34
1656828735537,MATH 103A,B03,093562,Greenfeld; Be'Eri,2,0,36,34
1656828741560,MATH 105,A01,085443,Carter; Anne Toulson,13,0,35,22
1656828741560,MATH 105,A02,093477,Carter; Anne Toulson,20,0,35,15
1656828747587,MATH 109,A01,083213,Ganzberger; Geoffrey Michael,2,0,34,32
1656828747587,MATH 109,A02,083214,Ganzberger; Geoffrey Michael,2,0,34,32
1656828747587,MATH 109,A03,093478,Ganzberger; Geoffrey Michael,1,0,34,33
1656828747587,MATH 109,B01,083215,Ganzberger; Geoffrey Michael,1,0,32,31
1656828747587,MATH 109,B02,083216,Ganzberger; Geoffrey Michael,1,0,32,31
1656828747587,MATH 109,B03,093479,Ganzberger; Geoffrey Michael,6,0,32,26
1656828753612,MATH 142A,A01,083219,Chow; Bennett,6,0,32,26
1656828753612,MATH 142A,A02,083220,Chow; Bennett,9,0,32,23
1656828753612,MATH 142A,A03,093480,Chow; Bennett,7,0,32,25
1656828753612,MATH 142A,B03,093481,Chow; Bennett,7,0,32,25
1656828753612,MATH 142A,B04,093558,Chow; Bennett,10,0,32,22
1656828753612,MATH 142A,B05,093559,Chow; Bennett,6,0,32,26
1656828759638,MATH 193A,A01,083224,Rotar; Vladimir,6,0,34,28
1656828759638,MATH 193A,A02,083225,Rotar; Vladimir,3,0,34,31
1656828759638,MATH 193A,A03,083781,Rotar; Vladimir,1,0,34,33
1656828759638,MATH 193A,A04,083782,Rotar; Vladimir,6,0,34,28
1656828759638,MATH 193A,A05,093482,Rotar; Vladimir,6,0,34,28
1656828765664,MATH 197,001,091859,McAuley; Julian John,9999,0,9999,0
1656828765664,MATH 197,002,095566,Kedlaya; Kiran S.,9997,0,9999,2
1656828765664,MATH 197,003,095567,Xiao; Ming,9999,0,9999,0
1656828765664,MATH 197,004,095571,Perols; Johan Lars,9998,0,9999,1
1656828772736,COGS 9,A01,083615,Shannon; Kyle Michael,6,0,75,69
1656828778758,COGS 11,A01,083617,Boyle; Mary E. T.,18,0,48,30
1656828784783,COGS 13,A01,083071,Bastos; Amalia Pinkusfeld,8,0,71,63
1656828790807,COGS 14A,A01,092681,Semenuks; Arturs,0,1,100,100
1656828796829,COGS 14B,A01,083073,Cheng; Tzu-Han,5,0,63,58
1656828802852,COGS 17,A01,092677,Semenuks; Arturs,4,0,81,77
1656828808874,COGS 100,A01,083619,Allen; Michael Gordon,15,0,70,55
1656828814904,COGS 101A,A01,083621,Davis; Joshua Daniel,9,0,68,59
1656828820928,COGS 101B,A01,091572,Allen; Michael Gordon,8,0,65,57
1656828826953,COGS 101C,A01,083625,Delgado; Tania,17,0,35,18
1656828832978,COGS 107A,A01,083627,Boyle; Mary E. T.,13,0,60,47
1656828839004,COGS 118A,A01,083075,Gupta; Anjum,15,0,76,61
1656828845029,CSE 3,A50,083646,Miranda; Gregory Joseph,22,0,50,28
1656828851063,CSE 8A,A50,083650,Miranda; Gregory Joseph,17,1,56,39
1656828857093,CSE 11,A01,083080,Cao; Yingjun,4,15,40,36
1656828863116,CSE 12,A01,083652,Krause-Levy; Sophia Louisa,20,1,120,100
1656828869144,CSE 15L,A01,083654,Morris; Justin Loren,8,0,50,42
1656828869144,CSE 15L,A02,083655,Morris; Justin Loren,8,0,50,42
1656828875167,CSE 20,A01,083657,Tran; Khoa Dang,37,0,80,43
1656828881194,CSE 21,A01,095574,Bach; Quang Tran,21,0,48,27
1656828887220,CSE 30,A01,083084,Eldon; John,4,0,80,76
1656828887220,CSE 30,B01,095061,Bhaskar; Nishant,6,0,50,44
1656828893242,CSE 100,A01,083659,Cao; Yingjun,2,4,70,68
1656828899266,CSE 134B,A01,083661,Powell; Thomas Allan,19,0,100,81
1656828905292,CSE 140,A01,083663,Gungor; Onat,14,0,85,71
1656828911321,CSE 140L,A01,083088,Eldon; John,16,0,100,84
1656828917344,CSE 175,A01,083665,Kumar; Rakesh,3,0,25,22
1656828923370,CSE 190,A00,092507,Dubnov; Shlomo,7,0,20,13
1656828929393,ECE 45,A01,083139,Congero; Spencer William,5,0,75,70
1656828935419,ECE 65,A50,083695,Saad; Andrew S,12,0,30,18
1656828935419,ECE 65,A51,095125,Saad; Andrew S,25,0,26,1
1656828941443,ECE 109,A01,091882,Touri; Behrouz,16,0,70,54
1656828947467,ECE 180,A00,083140,Abi Samra; Nicholas Camill,0,0,30,30
1656828947467,ECE 180,B00,083141,Abi Samra; Nicholas Camill,0,0,30,30
1656828953492,MATH 10A,A01,083735,Patchell; Gregory David,1,0,30,29
1656828953492,MATH 10A,A02,083736,Patchell; Gregory David,20,0,30,10
1656828953492,MATH 10A,A03,083737,Patchell; Gregory David,15,0,30,15
1656828959518,MATH 10B,A01,083207,Lim; Seonhee,7,0,34,27
1656828959518,MATH 10B,A02,083208,Lim; Seonhee,9,0,35,26
1656828959518,MATH 10B,A03,093472,Lim; Seonhee,4,0,34,30
1656828959518,MATH 10B,B01,083739,Sinha; Shubham,9,0,30,21
1656828965544,MATH 18,A01,083743,Cinel; Cameron Alexander,6,0,30,24
1656828965544,MATH 18,A02,083744,Cinel; Cameron Alexander,15,0,30,15
1656828965544,MATH 18,A03,083745,Cinel; Cameron Alexander,8,0,30,22
1656828965544,MATH 18,B01,083748,Rideout; David Porter,3,0,37,34
1656828965544,MATH 18,B02,083749,Rideout; David Porter,3,0,36,33
1656828965544,MATH 18,B03,083750,Rideout; David Porter,2,0,37,35
1656828965544,MATH 18,B04,083751,Rideout; David Porter,5,0,36,31
1656828965544,MATH 18,B05,093473,Rideout; David Porter,4,0,36,32
1656828965544,MATH 18,B06,093474,Rideout; David Porter,5,0,36,31
1656828971571,MATH 20A,A01,083754,Zheng; Zequn,12,0,40,28
1656828977594,MATH 20B,A01,083756,Briones; Jor-el Thomas Caparas,1,0,36,35
1656828977594,MATH 20B,A02,083757,Briones; Jor-el Thomas Caparas,1,0,36,35
1656828977594,MATH 20B,A03,093475,Briones; Jor-el Thomas Caparas,0,0,36,36
1656828983628,MATH 20C,A01,083760,Briones; Jor-el Thomas Caparas,1,0,35,34
1656828983628,MATH 20C,A02,083761,Briones; Jor-el Thomas Caparas,8,0,35,27
1656828983628,MATH 20C,A03,093476,Briones; Jor-el Thomas Caparas,0,1,36,36
1656828983628,MATH 20C,B01,083762,Bach; Quang Tran,0,0,30,30
1656828989657,MATH 20D,A01,083765,Tran; Brian Kha,4,0,30,26
1656828989657,MATH 20D,A02,083766,Tran; Brian Kha,4,0,30,26
1656828989657,MATH 20D,A03,083767,Tran; Brian Kha,2,0,30,28
1656828995680,MATH 20E,A01,083771,Ganguly; Soumya,5,0,32,27
1656828995680,MATH 20E,A02,083772,Ganguly; Soumya,6,0,32,26
1656828995680,MATH 20E,B01,083773,Ciotti; Benjamin,18,0,35,17
1656828995680,MATH 20E,B02,083774,Ciotti; Benjamin,17,0,35,18
1656829001702,MATH 103A,A01,083777,Greenfeld; Be'Eri,2,0,36,34
1656829001702,MATH 103A,A02,083778,Greenfeld; Be'Eri,5,0,36,31
1656829001702,MATH 103A,A03,093561,Greenfeld; Be'Eri,4,0,36,32
1656829001702,MATH 103A,B01,083779,Greenfeld; Be'Eri,6,0,36,30
1656829001702,MATH 103A,B02,083780,Greenfeld; Be'Eri,2,0,36,34
1656829001702,MATH 103A,B03,093562,Greenfeld; Be'Eri,2,0,36,34
1656829007726,MATH 105,A01,085443,Carter; Anne Toulson,13,0,35,22
1656829007726,MATH 105,A02,093477,Carter; Anne Toulson,20,0,35,15
1656829013750,MATH 109,A01,083213,Ganzberger; Geoffrey Michael,2,0,34,32
1656829013750,MATH 109,A02,083214,Ganzberger; Geoffrey Michael,2,0,34,32
1656829013750,MATH 109,A03,093478,Ganzberger; Geoffrey Michael,1,0,34,33
1656829013750,MATH 109,B01,083215,Ganzberger; Geoffrey Michael,1,0,32,31
1656829013750,MATH 109,B02,083216,Ganzberger; Geoffrey Michael,1,0,32,31
1656829013750,MATH 109,B03,093479,Ganzberger; Geoffrey Michael,6,0,32,26
1656829019775,MATH 142A,A01,083219,Chow; Bennett,6,0,32,26
1656829019775,MATH 142A,A02,083220,Chow; Bennett,9,0,32,23
1656829019775,MATH 142A,A03,093480,Chow; Bennett,7,0,32,25
1656829019775,MATH 142A,B03,093481,Chow; Bennett,7,0,32,25
1656829019775,MATH 142A,B04,093558,Chow; Bennett,10,0,32,22
1656829019775,MATH 142A,B05,093559,Chow; Bennett,6,0,32,26
1656829025800,MATH 193A,A01,083224,Rotar; Vladimir,6,0,34,28
1656829025800,MATH 193A,A02,083225,Rotar; Vladimir,3,0,34,31
1656829025800,MATH 193A,A03,083781,Rotar; Vladimir,1,0,34,33
1656829025800,MATH 193A,A04,083782,Rotar; Vladimir,6,0,34,28
1656829025800,MATH 193A,A05,093482,Rotar; Vladimir,6,0,34,28
1656829031832,MATH 197,001,091859,McAuley; Julian John,9999,0,9999,0
1656829031832,MATH 197,002,095566,Kedlaya; Kiran S.,9997,0,9999,2
1656829031832,MATH 197,003,095567,Xiao; Ming,9999,0,9999,0
1656829031832,MATH 197,004,095571,Perols; Johan Lars,9998,0,9999,1
1656829038903,COGS 9,A01,083615,Shannon; Kyle Michael,6,0,75,69
1656829044927,COGS 11,A01,083617,Boyle; Mary E. T.,18,0,48,30
1656829050955,COGS 13,A01,083071,Bastos; Amalia Pinkusfeld,8,0,71,63
1656829056983,COGS 14A,A01,092681,Semenuks; Arturs,0,1,100,100
1656829063012,COGS 14B,A01,083073,Cheng; Tzu-Han,5,0,63,58
1656829069036,COGS 17,A01,092677,Semenuks; Arturs,4,0,81,77
1656829075064,COGS 100,A01,083619,Allen; Michael Gordon,15,0,70,55
1656829081088,COGS 101A,A01,083621,Davis; Joshua Daniel,9,0,68,59
1656829087118,COGS 101B,A01,091572,Allen; Michael Gordon,8,0,65,57
1656829093141,COGS 101C,A01,083625,Delgado; Tania,17,0,35,18
1656829099163,COGS 107A,A01,083627,Boyle; Mary E. T.,13,0,60,47
1656829105186,COGS 118A,A01,083075,Gupta; Anjum,15,0,76,61
1656829111224,CSE 3,A50,083646,Miranda; Gregory Joseph,22,0,50,28
1656829117252,CSE 8A,A50,083650,Miranda; Gregory Joseph,17,1,56,39
1656829123276,CSE 11,A01,083080,Cao; Yingjun,4,15,40,36
1656829129298,CSE 12,A01,083652,Krause-Levy; Sophia Louisa,20,1,120,100
1656829135321,CSE 15L,A01,083654,Morris; Justin Loren,8,0,50,42
1656829135321,CSE 15L,A02,083655,Morris; Justin Loren,8,0,50,42
1656829141346,CSE 20,A01,083657,Tran; Khoa Dang,37,0,80,43
1656829147369,CSE 21,A01,095574,Bach; Quang Tran,21,0,48,27
1656829153397,CSE 30,A01,083084,Eldon; John,4,0,80,76
1656829153397,CSE 30,B01,095061,Bhaskar; Nishant,6,0,50,44
1656829159429,CSE 100,A01,083659,Cao; Yingjun,2,4,70,68
1656829165455,CSE 134B,A01,083661,Powell; Thomas Allan,19,0,100,81
1656829171477,CSE 140,A01,083663,Gungor; Onat,14,0,85,71
1656829177502,CSE 140L,A01,083088,Eldon; John,16,0,100,84
1656829183524,CSE 175,A01,083665,Kumar; Rakesh,3,0,25,22
1656829189556,CSE 190,A00,092507,Dubnov; Shlomo,7,0,20,13
1656829195591,ECE 45,A01,083139,Congero; Spencer William,5,0,75,70
1656829201624,ECE 65,A50,083695,Saad; Andrew S,12,0,30,18
1656829201624,ECE 65,A51,095125,Saad; Andrew S,25,0,26,1
1656829207645,ECE 109,A01,091882,Touri; Behrouz,16,0,70,54
1656829213671,ECE 180,A00,083140,Abi Samra; Nicholas Camill,0,0,30,30
1656829213671,ECE 180,B00,083141,Abi Samra; Nicholas Camill,0,0,30,30
1656829219696,MATH 10A,A01,083735,Patchell; Gregory David,1,0,30,29
1656829219696,MATH 10A,A02,083736,Patchell; Gregory David,20,0,30,10
1656829219696,MATH 10A,A03,083737,Patchell; Gregory David,15,0,30,15
1656829225723,MATH 10B,A01,083207,Lim; Seonhee,7,0,34,27
1656829225723,MATH 10B,A02,083208,Lim; Seonhee,9,0,35,26
1656829225723,MATH 10B,A03,093472,Lim; Seonhee,4,0,34,30
1656829225723,MATH 10B,B01,083739,Sinha; Shubham,9,0,30,21
1656829231756,MATH 18,A01,083743,Cinel; Cameron Alexander,6,0,30,24
1656829231756,MATH 18,A02,083744,Cinel; Cameron Alexander,15,0,30,15
1656829231756,MATH 18,A03,083745,Cinel; Cameron Alexander,8,0,30,22
1656829231756,MATH 18,B01,083748,Rideout; David Porter,3,0,37,34
1656829231756,MATH 18,B02,083749,Rideout; David Porter,3,0,36,33
1656829231756,MATH 18,B03,083750,Rideout; David Porter,2,0,37,35
1656829231756,MATH 18,B04,083751,Rideout; David Porter,5,0,36,31
1656829231756,MATH 18,B05,093473,Rideout; David Porter,4,0,36,32
1656829231756,MATH 18,B06,093474,Rideout; David Porter,5,0,36,31
1656829237778,MATH 20A,A01,083754,Zheng; Zequn,12,0,40,28
1656829243807,MATH 20B,A01,083756,Briones; Jor-el Thomas Caparas,1,0,36,35
1656829243807,MATH 20B,A02,083757,Briones; Jor-el Thomas Caparas,1,0,36,35
1656829243807,MATH 20B,A03,093475,Briones; Jor-el Thomas Caparas,0,0,36,36
1656829249919,MATH 20C,A01,083760,Briones; Jor-el Thomas Caparas,1,0,35,34
1656829249919,MATH 20C,A02,083761,Briones; Jor-el Thomas Caparas,8,0,35,27
1656829249919,MATH 20C,A03,093476,Briones; Jor-el Thomas Caparas,0,1,36,36
1656829249919,MATH 20C,B01,083762,Bach; Quang Tran,0,0,30,30
1656829255942,MATH 20D,A01,083765,Tran; Brian Kha,4,0,30,26
1656829255942,MATH 20D,A02,083766,Tran; Brian Kha,4,0,30,26
1656829255942,MATH 20D,A03,083767,Tran; Brian Kha,2,0,30,28
1656829261967,MATH 20E,A01,083771,Ganguly; Soumya,5,0,32,27
1656829261967,MATH 20E,A02,083772,Ganguly; Soumya,6,0,32,26
1656829261967,MATH 20E,B01,083773,Ciotti; Benjamin,18,0,35,17
1656829261967,MATH 20E,B02,083774,Ciotti; Benjamin,17,0,35,18
1656829268006,MATH 103A,A01,083777,Greenfeld; Be'Eri,2,0,36,34
1656829268006,MATH 103A,A02,083778,Greenfeld; Be'Eri,5,0,36,31
1656829268006,MATH 103A,A03,093561,Greenfeld; Be'Eri,4,0,36,32
1656829268006,MATH 103A,B01,083779,Greenfeld; Be'Eri,6,0,36,30
1656829268006,MATH 103A,B02,083780,Greenfeld; Be'Eri,2,0,36,34
1656829268006,MATH 103A,B03,093562,Greenfeld; Be'Eri,2,0,36,34
1656829274031,MATH 105,A01,085443,Carter; Anne Toulson,13,0,35,22
1656829274031,MATH 105,A02,093477,Carter; Anne Toulson,20,0,35,15
1656829280057,MATH 109,A01,083213,Ganzberger; Geoffrey Michael,2,0,34,32
1656829280057,MATH 109,A02,083214,Ganzberger; Geoffrey Michael,2,0,34,32
1656829280057,MATH 109,A03,093478,Ganzberger; Geoffrey Michael,1,0,34,33
1656829280057,MATH 109,B01,083215,Ganzberger; Geoffrey Michael,1,0,32,31
1656829280057,MATH 109,B02,083216,Ganzberger; Geoffrey Michael,1,0,32,31
1656829280057,MATH 109,B03,093479,Ganzberger; Geoffrey Michael,6,0,32,26
1656829286081,MATH 142A,A01,083219,Chow; Bennett,6,0,32,26
1656829286081,MATH 142A,A02,083220,Chow; Bennett,9,0,32,23
1656829286081,MATH 142A,A03,093480,Chow; Bennett,7,0,32,25
1656829286081,MATH 142A,B03,093481,Chow; Bennett,7,0,32,25
1656829286081,MATH 142A,B04,093558,Chow; Bennett,10,0,32,22
1656829286081,MATH 142A,B05,093559,Chow; Bennett,6,0,32,26
1656829292117,MATH 193A,A01,083224,Rotar; Vladimir,6,0,34,28
1656829292117,MATH 193A,A02,083225,Rotar; Vladimir,3,0,34,31
1656829292117,MATH 193A,A03,083781,Rotar; Vladimir,1,0,34,33
1656829292117,MATH 193A,A04,083782,Rotar; Vladimir,6,0,34,28
1656829292117,MATH 193A,A05,093482,Rotar; Vladimir,6,0,34,28
1656829298143,MATH 197,001,091859,McAuley; Julian John,9999,0,9999,0
1656829298143,MATH 197,002,095566,Kedlaya; Kiran S.,9997,0,9999,2
1656829298143,MATH 197,003,095567,Xiao; Ming,9999,0,9999,0
1656829298143,MATH 197,004,095571,Perols; Johan Lars,9998,0,9999,1
1656829305204,COGS 9,A01,083615,Shannon; Kyle Michael,6,0,75,69
1656829311228,COGS 11,A01,083617,Boyle; Mary E. T.,18,0,48,30
1656829317253,COGS 13,A01,083071,Bastos; Amalia Pinkusfeld,8,0,71,63
1656829323280,COGS 14A,A01,092681,Semenuks; Arturs,0,1,100,100
1656829329305,COGS 14B,A01,083073,Cheng; Tzu-Han,5,0,63,58
1656829335332,COGS 17,A01,092677,Semenuks; Arturs,4,0,81,77
1656829341364,COGS 100,A01,083619,Allen; Michael Gordon,15,0,70,55
1656829347388,COGS 101A,A01,083621,Davis; Joshua Daniel,9,0,68,59
1656829353412,COGS 101B,A01,091572,Allen; Michael Gordon,8,0,65,57
1656829359435,COGS 101C,A01,083625,Delgado; Tania,17,0,35,18
1656829365458,COGS 107A,A01,083627,Boyle; Mary E. T.,13,0,60,47
1656829371481,COGS 118A,A01,083075,Gupta; Anjum,15,0,76,61
1656829377508,CSE 3,A50,083646,Miranda; Gregory Joseph,22,0,50,28
1656829383531,CSE 8A,A50,083650,Miranda; Gregory Joseph,17,1,56,39
1656829389556,CSE 11,A01,083080,Cao; Yingjun,4,15,40,36
1656829395585,CSE 12,A01,083652,Krause-Levy; Sophia Louisa,20,1,120,100
1656829401609,CSE 15L,A01,083654,Morris; Justin Loren,8,0,50,42
1656829401609,CSE 15L,A02,083655,Morris; Justin Loren,8,0,50,42
1656829407640,CSE 20,A01,083657,Tran; Khoa Dang,37,0,80,43
1656829413669,CSE 21,A01,095574,Bach; Quang Tran,21,0,48,27
1656829419702,CSE 30,A01,083084,Eldon; John,4,0,80,76
1656829419702,CSE 30,B01,095061,Bhaskar; Nishant,6,0,50,44
1656829425725,CSE 100,A01,083659,Cao; Yingjun,2,4,70,68
1656829431747,CSE 134B,A01,083661,Powell; Thomas Allan,19,0,100,81
1656829437771,CSE 140,A01,083663,Gungor; Onat,14,0,85,71
1656829443798,CSE 140L,A01,083088,Eldon; John,16,0,100,84
1656829449822,CSE 175,A01,083665,Kumar; Rakesh,3,0,25,22
1656829455850,CSE 190,A00,092507,Dubnov; Shlomo,7,0,20,13
1656829461878,ECE 45,A01,083139,Congero; Spencer William,5,0,75,70
1656829467908,ECE 65,A50,083695,Saad; Andrew S,12,0,30,18
1656829467908,ECE 65,A51,095125,Saad; Andrew S,25,0,26,1
1656829473945,ECE 109,A01,091882,Touri; Behrouz,16,0,70,54
1656829479971,ECE 180,A00,083140,Abi Samra; Nicholas Camill,0,0,30,30
1656829479971,ECE 180,B00,083141,Abi Samra; Nicholas Camill,0,0,30,30
1656829485996,MATH 10A,A01,083735,Patchell; Gregory David,1,0,30,29
1656829485996,MATH 10A,A02,083736,Patchell; Gregory David,20,0,30,10
1656829485996,MATH 10A,A03,083737,Patchell; Gregory David,15,0,30,15
1656829492025,MATH 10B,A01,083207,Lim; Seonhee,7,0,34,27
1656829492025,MATH 10B,A02,083208,Lim; Seonhee,9,0,35,26
1656829492025,MATH 10B,A03,093472,Lim; Seonhee,4,0,34,30
1656829492025,MATH 10B,B01,083739,Sinha; Shubham,9,0,30,21
1656829498062,MATH 18,A01,083743,Cinel; Cameron Alexander,6,0,30,24
1656829498062,MATH 18,A02,083744,Cinel; Cameron Alexander,15,0,30,15
1656829498062,MATH 18,A03,083745,Cinel; Cameron Alexander,8,0,30,22
1656829498062,MATH 18,B01,083748,Rideout; David Porter,3,0,37,34
1656829498062,MATH 18,B02,083749,Rideout; David Porter,3,0,36,33
1656829498062,MATH 18,B03,083750,Rideout; David Porter,2,0,37,35
1656829498062,MATH 18,B04,083751,Rideout; David Porter,5,0,36,31
1656829498062,MATH 18,B05,093473,Rideout; David Porter,4,0,36,32
1656829498062,MATH 18,B06,093474,Rideout; David Porter,5,0,36,31
1656829504088,MATH 20A,A01,083754,Zheng; Zequn,12,0,40,28
1656829510113,MATH 20B,A01,083756,Briones; Jor-el Thomas Caparas,1,0,36,35
1656829510113,MATH 20B,A02,083757,Briones; Jor-el Thomas Caparas,1,0,36,35
1656829510113,MATH 20B,A03,093475,Briones; Jor-el Thomas Caparas,0,0,36,36
1656829516147,MATH 20C,A01,083760,Briones; Jor-el Thomas Caparas,1,0,35,34
1656829516147,MATH 20C,A02,083761,Briones; Jor-el Thomas Caparas,8,0,35,27
1656829516147,MATH 20C,A03,093476,Briones; Jor-el Thomas Caparas,0,1,36,36
1656829516147,MATH 20C,B01,083762,Bach; Quang Tran,0,0,30,30
1656829522174,MATH 20D,A01,083765,Tran; Brian Kha,4,0,30,26
1656829522174,MATH 20D,A02,083766,Tran; Brian Kha,4,0,30,26
1656829522174,MATH 20D,A03,083767,Tran; Brian Kha,2,0,30,28
1656829528202,MATH 20E,A01,083771,Ganguly; Soumya,5,0,32,27
1656829528202,MATH 20E,A02,083772,Ganguly; Soumya,6,0,32,26
1656829528202,MATH 20E,B01,083773,Ciotti; Benjamin,18,0,35,17
1656829528202,MATH 20E,B02,083774,Ciotti; Benjamin,17,0,35,18
1656829534233,MATH 103A,A01,083777,Greenfeld; Be'Eri,2,0,36,34
1656829534233,MATH 103A,A02,083778,Greenfeld; Be'Eri,5,0,36,31
1656829534233,MATH 103A,A03,093561,Greenfeld; Be'Eri,4,0,36,32
1656829534233,MATH 103A,B01,083779,Greenfeld; Be'Eri,6,0,36,30
1656829534233,MATH 103A,B02,083780,Greenfeld; Be'Eri,2,0,36,34
1656829534233,MATH 103A,B03,093562,Greenfeld; Be'Eri,2,0,36,34
1656829540260,MATH 105,A01,085443,Carter; Anne Toulson,13,0,35,22
1656829540260,MATH 105,A02,093477,Carter; Anne Toulson,20,0,35,15
1656829546296,MATH 109,A01,083213,Ganzberger; Geoffrey Michael,2,0,34,32
1656829546296,MATH 109,A02,083214,Ganzberger; Geoffrey Michael,2,0,34,32
1656829546296,MATH 109,A03,093478,Ganzberger; Geoffrey Michael,1,0,34,33
1656829546296,MATH 109,B01,083215,Ganzberger; Geoffrey Michael,1,0,32,31
1656829546296,MATH 109,B02,083216,Ganzberger; Geoffrey Michael,1,0,32,31
1656829546296,MATH 109,B03,093479,Ganzberger; Geoffrey Michael,6,0,32,26
1656829552320,MATH 142A,A01,083219,Chow; Bennett,6,0,32,26
1656829552320,MATH 142A,A02,083220,Chow; Bennett,9,0,32,23
1656829552320,MATH 142A,A03,093480,Chow; Bennett,7,0,32,25
1656829552320,MATH 142A,B03,093481,Chow; Bennett,7,0,32,25
1656829552320,MATH 142A,B04,093558,Chow; Bennett,10,0,32,22
1656829552320,MATH 142A,B05,093559,Chow; Bennett,6,0,32,26
1656829558344,MATH 193A,A01,083224,Rotar; Vladimir,6,0,34,28
1656829558344,MATH 193A,A02,083225,Rotar; Vladimir,3,0,34,31
1656829558344,MATH 193A,A03,083781,Rotar; Vladimir,1,0,34,33
1656829558344,MATH 193A,A04,083782,Rotar; Vladimir,6,0,34,28
1656829558344,MATH 193A,A05,093482,Rotar; Vladimir,6,0,34,28
1656829564369,MATH 197,001,091859,McAuley; Julian John,9999,0,9999,0
1656829564369,MATH 197,002,095566,Kedlaya; Kiran S.,9997,0,9999,2
1656829564369,MATH 197,003,095567,Xiao; Ming,9999,0,9999,0
1656829564369,MATH 197,004,095571,Perols; Johan Lars,9998,0,9999,1
1656829571421,COGS 9,A01,083615,Shannon; Kyle Michael,6,0,75,69
1656829577448,COGS 11,A01,083617,Boyle; Mary E. T.,18,0,48,30
1656829583473,COGS 13,A01,083071,Bastos; Amalia Pinkusfeld,8,0,71,63
1656829589497,COGS 14A,A01,092681,Semenuks; Arturs,0,1,100,100
1656829595524,COGS 14B,A01,083073,Cheng; Tzu-Han,5,0,63,58
1656829601546,COGS 17,A01,092677,Semenuks; Arturs,4,0,81,77
1656829607573,COGS 100,A01,083619,Allen; Michael Gordon,15,0,70,55
1656829613597,COGS 101A,A01,083621,Davis; Joshua Daniel,9,0,68,59
1656829619625,COGS 101B,A01,091572,Allen; Michael Gordon,8,0,65,57
1656829625649,COGS 101C,A01,083625,Delgado; Tania,17,0,35,18
1656829631672,COGS 107A,A01,083627,Boyle; Mary E. T.,13,0,60,47
1656829637696,COGS 118A,A01,083075,Gupta; Anjum,15,0,76,61
1656829643725,CSE 3,A50,083646,Miranda; Gregory Joseph,22,0,50,28
1656829649752,CSE 8A,A50,083650,Miranda; Gregory Joseph,17,1,56,39
1656829655778,CSE 11,A01,083080,Cao; Yingjun,4,15,40,36
1656829661805,CSE 12,A01,083652,Krause-Levy; Sophia Louisa,20,1,120,100
1656829667833,CSE 15L,A01,083654,Morris; Justin Loren,8,0,50,42
1656829667833,CSE 15L,A02,083655,Morris; Justin Loren,8,0,50,42
1656829673855,CSE 20,A01,083657,Tran; Khoa Dang,37,0,80,43
1656829679878,CSE 21,A01,095574,Bach; Quang Tran,21,0,48,27
1656829685902,CSE 30,A01,083084,Eldon; John,4,0,80,76
1656829685902,CSE 30,B01,095061,Bhaskar; Nishant,6,0,50,44
1656829691927,CSE 100,A01,083659,Cao; Yingjun,2,4,70,68
1656829697950,CSE 134B,A01,083661,Powell; Thomas Allan,19,0,100,81
1656829703984,CSE 140,A01,083663,Gungor; Onat,14,0,85,71
1656829710008,CSE 140L,A01,083088,Eldon; John,16,0,100,84
1656829716036,CSE 175,A01,083665,Kumar; Rakesh,3,0,25,22
1656829722066,CSE 190,A00,092507,Dubnov; Shlomo,7,0,20,13
1656829728095,ECE 45,A01,083139,Congero; Spencer William,5,0,75,70
1656829734120,ECE 65,A50,083695,Saad; Andrew S,12,0,30,18
1656829734120,ECE 65,A51,095125,Saad; Andrew S,25,0,26,1
1656829740146,ECE 109,A01,091882,Touri; Behrouz,16,0,70,54
1656829746177,ECE 180,A00,083140,Abi Samra; Nicholas Camill,0,0,30,30
1656829746177,ECE 180,B00,083141,Abi Samra; Nicholas Camill,0,0,30,30
1656829752204,MATH 10A,A01,083735,Patchell; Gregory David,1,0,30,29
1656829752204,MATH 10A,A02,083736,Patchell; Gregory David,20,0,30,10
1656829752204,MATH 10A,A03,083737,Patchell; Gregory David,15,0,30,15
1656829758228,MATH 10B,A01,083207,Lim; Seonhee,7,0,34,27
1656829758228,MATH 10B,A02,083208,Lim; Seonhee,9,0,35,26
1656829758228,MATH 10B,A03,093472,Lim; Seonhee,4,0,34,30
1656829758228,MATH 10B,B01,083739,Sinha; Shubham,9,0,30,21
1656829764259,MATH 18,A01,083743,Cinel; Cameron Alexander,6,0,30,24
1656829764259,MATH 18,A02,083744,Cinel; Cameron Alexander,15,0,30,15
1656829764259,MATH 18,A03,083745,Cinel; Cameron Alexander,8,0,30,22
1656829764259,MATH 18,B01,083748,Rideout; David Porter,3,0,37,34
1656829764259,MATH 18,B02,083749,Rideout; David Porter,3,0,36,33
1656829764259,MATH 18,B03,083750,Rideout; David Porter,2,0,37,35
1656829764259,MATH 18,B04,083751,Rideout; David Porter,5,0,36,31
1656829764259,MATH 18,B05,093473,Rideout; David Porter,4,0,36,32
1656829764259,MATH 18,B06,093474,Rideout; David Porter,5,0,36,31
1656829770282,MATH 20A,A01,083754,Zheng; Zequn,12,0,40,28
1656829776309,MATH 20B,A01,083756,Briones; Jor-el Thomas Caparas,1,0,36,35
1656829776309,MATH 20B,A02,083757,Briones; Jor-el Thomas Caparas,1,0,36,35
1656829776309,MATH 20B,A03,093475,Briones; Jor-el Thomas Caparas,0,0,36,36
1656829782334,MATH 20C,A01,083760,Briones; Jor-el Thomas Caparas,1,0,35,34
1656829782334,MATH 20C,A02,083761,Briones; Jor-el Thomas Caparas,8,0,35,27
1656829782334,MATH 20C,A03,093476,Briones; Jor-el Thomas Caparas,0,1,36,36
1656829782334,MATH 20C,B01,083762,Bach; Quang Tran,0,0,30,30
1656829788357,MATH 20D,A01,083765,Tran; Brian Kha,4,0,30,26
1656829788357,MATH 20D,A02,083766,Tran; Brian Kha,4,0,30,26
1656829788357,MATH 20D,A03,083767,Tran; Brian Kha,2,0,30,28
1656829794381,MATH 20E,A01,083771,Ganguly; Soumya,5,0,32,27
1656829794381,MATH 20E,A02,083772,Ganguly; Soumya,6,0,32,26
1656829794381,MATH 20E,B01,083773,Ciotti; Benjamin,18,0,35,17
1656829794381,MATH 20E,B02,083774,Ciotti; Benjamin,17,0,35,18
1656829800410,MATH 103A,A01,083777,Greenfeld; Be'Eri,2,0,36,34
1656829800410,MATH 103A,A02,083778,Greenfeld; Be'Eri,5,0,36,31
1656829800410,MATH 103A,A03,093561,Greenfeld; Be'Eri,4,0,36,32
1656829800410,MATH 103A,B01,083779,Greenfeld; Be'Eri,6,0,36,30
1656829800410,MATH 103A,B02,083780,Greenfeld; Be'Eri,2,0,36,34
1656829800410,MATH 103A,B03,093562,Greenfeld; Be'Eri,2,0,36,34
1656829806439,MATH 105,A01,085443,Carter; Anne Toulson,13,0,35,22
1656829806439,MATH 105,A02,093477,Carter; Anne Toulson,20,0,35,15
1656829812463,MATH 109,A01,083213,Ganzberger; Geoffrey Michael,2,0,34,32
1656829812463,MATH 109,A02,083214,Ganzberger; Geoffrey Michael,2,0,34,32
1656829812463,MATH 109,A03,093478,Ganzberger; Geoffrey Michael,1,0,34,33
1656829812463,MATH 109,B01,083215,Ganzberger; Geoffrey Michael,1,0,32,31
1656829812463,MATH 109,B02,083216,Ganzberger; Geoffrey Michael,1,0,32,31
1656829812463,MATH 109,B03,093479,Ganzberger; Geoffrey Michael,6,0,32,26
1656829818487,MATH 142A,A01,083219,Chow; Bennett,6,0,32,26
1656829818487,MATH 142A,A02,083220,Chow; Bennett,9,0,32,23
1656829818487,MATH 142A,A03,093480,Chow; Bennett,7,0,32,25
1656829818487,MATH 142A,B03,093481,Chow; Bennett,7,0,32,25
1656829818487,MATH 142A,B04,093558,Chow; Bennett,10,0,32,22
1656829818487,MATH 142A,B05,093559,Chow; Bennett,6,0,32,26
1656829824515,MATH 193A,A01,083224,Rotar; Vladimir,6,0,34,28
1656829824515,MATH 193A,A02,083225,Rotar; Vladimir,3,0,34,31
1656829824515,MATH 193A,A03,083781,Rotar; Vladimir,1,0,34,33
1656829824515,MATH 193A,A04,083782,Rotar; Vladimir,6,0,34,28
1656829824515,MATH 193A,A05,093482,Rotar; Vladimir,6,0,34,28
1656829830538,MATH 197,001,091859,McAuley; Julian John,9999,0,9999,0
1656829830538,MATH 197,002,095566,Kedlaya; Kiran S.,9997,0,9999,2
1656829830538,MATH 197,003,095567,Xiao; Ming,9999,0,9999,0
1656829830538,MATH 197,004,095571,Perols; Johan Lars,9998,0,9999,1
1656829837590,COGS 9,A01,083615,Shannon; Kyle Michael,6,0,75,69
1656829843690,COGS 11,A01,083617,Boyle; Mary E. T.,18,0,48,30
1656829849716,COGS 13,A01,083071,Bastos; Amalia Pinkusfeld,8,0,71,63
1656829855740,COGS 14A,A01,092681,Semenuks; Arturs,0,1,100,100
1656829861766,COGS 14B,A01,083073,Cheng; Tzu-Han,5,0,63,58
1656829867788,COGS 17,A01,092677,Semenuks; Arturs,4,0,81,77
1656829873815,COGS 100,A01,083619,Allen; Michael Gordon,15,0,70,55
1656829879837,COGS 101A,A01,083621,Davis; Joshua Daniel,9,0,68,59
1656829885860,COGS 101B,A01,091572,Allen; Michael Gordon,8,0,65,57
1656829891885,COGS 101C,A01,083625,Delgado; Tania,17,0,35,18
1656829897912,COGS 107A,A01,083627,Boyle; Mary E. T.,13,0,60,47
1656829903938,COGS 118A,A01,083075,Gupta; Anjum,15,0,76,61
1656829909962,CSE 3,A50,083646,Miranda; Gregory Joseph,22,0,50,28
1656829915985,CSE 8A,A50,083650,Miranda; Gregory Joseph,17,1,56,39
1656829922016,CSE 11,A01,083080,Cao; Yingjun,4,15,40,36
1656829928040,CSE 12,A01,083652,Krause-Levy; Sophia Louisa,20,1,120,100
1656829934063,CSE 15L,A01,083654,Morris; Justin Loren,8,0,50,42
1656829934063,CSE 15L,A02,083655,Morris; Justin Loren,8,0,50,42
1656829940090,CSE 20,A01,083657,Tran; Khoa Dang,37,0,80,43
1656829946112,CSE 21,A01,095574,Bach; Quang Tran,21,0,48,27
1656829952146,CSE 30,A01,083084,Eldon; John,4,0,80,76
1656829952146,CSE 30,B01,095061,Bhaskar; Nishant,6,0,50,44
1656829958170,CSE 100,A01,083659,Cao; Yingjun,2,4,70,68
1656829964196,CSE 134B,A01,083661,Powell; Thomas Allan,19,0,100,81
1656829970222,CSE 140,A01,083663,Gungor; Onat,14,0,85,71
1656829976244,CSE 140L,A01,083088,Eldon; John,16,0,100,84
1656829982271,CSE 175,A01,083665,Kumar; Rakesh,3,0,25,22
1656829988293,CSE 190,A00,092507,Dubnov; Shlomo,7,0,20,13
1656829994333,ECE 45,A01,083139,Congero; Spencer William,5,0,75,70
1656830000361,ECE 65,A50,083695,Saad; Andrew S,12,0,30,18
1656830000361,ECE 65,A51,095125,Saad; Andrew S,25,0,26,1
1656830006387,ECE 109,A01,091882,Touri; Behrouz,16,0,70,54
1656830012413,ECE 180,A00,083140,Abi Samra; Nicholas Camill,0,0,30,30
1656830012413,ECE 180,B00,083141,Abi Samra; Nicholas Camill,0,0,30,30
1656830018437,MATH 10A,A01,083735,Patchell; Gregory David,1,0,30,29
1656830018437,MATH 10A,A02,083736,Patchell; Gregory David,20,0,30,10
1656830018437,MATH 10A,A03,083737,Patchell; Gregory David,15,0,30,15
1656830024465,MATH 10B,A01,083207,Lim; Seonhee,7,0,34,27
1656830024465,MATH 10B,A02,083208,Lim; Seonhee,9,0,35,26
1656830024465,MATH 10B,A03,093472,Lim; Seonhee,4,0,34,30
1656830024465,MATH 10B,B01,083739,Sinha; Shubham,9,0,30,21
1656830030497,MATH 18,A01,083743,Cinel; Cameron Alexander,6,0,30,24
1656830030497,MATH 18,A02,083744,Cinel; Cameron Alexander,15,0,30,15
1656830030497,MATH 18,A03,083745,Cinel; Cameron Alexander,8,0,30,22
1656830030497,MATH 18,B01,083748,Rideout; David Porter,3,0,37,34
1656830030497,MATH 18,B02,083749,Rideout; David Porter,3,0,36,33
1656830030497,MATH 18,B03,083750,Rideout; David Porter,2,0,37,35
1656830030497,MATH 18,B04,083751,Rideout; David Porter,5,0,36,31
1656830030497,MATH 18,B05,093473,Rideout; David Porter,4,0,36,32
1656830030497,MATH 18,B06,093474,Rideout; David Porter,5,0,36,31
1656830036538,MATH 20A,A01,083754,Zheng; Zequn,12,0,40,28
1656830042565,MATH 20B,A01,083756,Briones; Jor-el Thomas Caparas,1,0,36,35
1656830042565,MATH 20B,A02,083757,Briones; Jor-el Thomas Caparas,1,0,36,35
1656830042565,MATH 20B,A03,093475,Briones; Jor-el Thomas Caparas,0,0,36,36
1656830048594,MATH 20C,A01,083760,Briones; Jor-el Thomas Caparas,1,0,35,34
1656830048594,MATH 20C,A02,083761,Briones; Jor-el Thomas Caparas,8,0,35,27
1656830048594,MATH 20C,A03,093476,Briones; Jor-el Thomas Caparas,0,1,36,36
1656830048594,MATH 20C,B01,083762,Bach; Quang Tran,0,0,30,30
1656830054626,MATH 20D,A01,083765,Tran; Brian Kha,4,0,30,26
1656830054626,MATH 20D,A02,083766,Tran; Brian Kha,4,0,30,26
1656830054626,MATH 20D,A03,083767,Tran; Brian Kha,2,0,30,28
1656830060650,MATH 20E,A01,083771,Ganguly; Soumya,5,0,32,27
1656830060650,MATH 20E,A02,083772,Ganguly; Soumya,6,0,32,26
1656830060650,MATH 20E,B01,083773,Ciotti; Benjamin,18,0,35,17
1656830060650,MATH 20E,B02,083774,Ciotti; Benjamin,17,0,35,18
1656830066675,MATH 103A,A01,083777,Greenfeld; Be'Eri,2,0,36,34
1656830066675,MATH 103A,A02,083778,Greenfeld; Be'Eri,5,0,36,31
1656830066675,MATH 103A,A03,093561,Greenfeld; Be'Eri,4,0,36,32
1656830066675,MATH 103A,B01,083779,Greenfeld; Be'Eri,6,0,36,30
1656830066675,MATH 103A,B02,083780,Greenfeld; Be'Eri,2,0,36,34
1656830066675,MATH 103A,B03,093562,Greenfeld; Be'Eri,2,0,36,34
1656830072702,MATH 105,A01,085443,Carter; Anne Toulson,13,0,35,22
1656830072702,MATH 105,A02,093477,Carter; Anne Toulson,20,0,35,15
1656830078725,MATH 109,A01,083213,Ganzberger; Geoffrey Michael,2,0,34,32
1656830078725,MATH 109,A02,083214,Ganzberger; Geoffrey Michael,2,0,34,32
1656830078725,MATH 109,A03,093478,Ganzberger; Geoffrey Michael,1,0,34,33
1656830078725,MATH 109,B01,083215,Ganzberger; Geoffrey Michael,1,0,32,31
1656830078725,MATH 109,B02,083216,Ganzberger; Geoffrey Michael,1,0,32,31
1656830078725,MATH 109,B03,093479,Ganzberger; Geoffrey Michael,6,0,32,26
1656830084750,MATH 142A,A01,083219,Chow; Bennett,6,0,32,26
1656830084750,MATH 142A,A02,083220,Chow; Bennett,9,0,32,23
1656830084750,MATH 142A,A03,093480,Chow; Bennett,7,0,32,25
1656830084750,MATH 142A,B03,093481,Chow; Bennett,7,0,32,25
1656830084750,MATH 142A,B04,093558,Chow; Bennett,10,0,32,22
1656830084750,MATH 142A,B05,093559,Chow; Bennett,6,0,32,26
1656830090790,MATH 193A,A01,083224,Rotar; Vladimir,6,0,34,28
1656830090790,MATH 193A,A02,083225,Rotar; Vladimir,3,0,34,31
1656830090790,MATH 193A,A03,083781,Rotar; Vladimir,1,0,34,33
1656830090790,MATH 193A,A04,083782,Rotar; Vladimir,6,0,34,28
1656830090790,MATH 193A,A05,093482,Rotar; Vladimir,6,0,34,28
1656830096814,MATH 197,001,091859,McAuley; Julian John,9999,0,9999,0
1656830096814,MATH 197,002,095566,Kedlaya; Kiran S.,9997,0,9999,2
1656830096814,MATH 197,003,095567,Xiao; Ming,9999,0,9999,0
1656830096814,MATH 197,004,095571,Perols; Johan Lars,9998,0,9999,1
1656830103887,COGS 9,A01,083615,Shannon; Kyle Michael,6,0,75,69
1656830109916,COGS 11,A01,083617,Boyle; Mary E. T.,18,0,48,30
1656830115944,COGS 13,A01,083071,Bastos; Amalia Pinkusfeld,8,0,71,63
1656830121977,COGS 14A,A01,092681,Semenuks; Arturs,0,1,100,100
1656830128003,COGS 14B,A01,083073,Cheng; Tzu-Han,5,0,63,58
1656830134039,COGS 17,A01,092677,Semenuks; Arturs,4,0,81,77
1656830140061,COGS 100,A01,083619,Allen; Michael Gordon,15,0,70,55
1656830146107,COGS 101A,A01,083621,Davis; Joshua Daniel,9,0,68,59
1656830152137,COGS 101B,A01,091572,Allen; Michael Gordon,8,0,65,57
1656830158175,COGS 101C,A01,083625,Delgado; Tania,17,0,35,18
1656830164199,COGS 107A,A01,083627,Boyle; Mary E. T.,13,0,60,47
1656830170227,COGS 118A,A01,083075,Gupta; Anjum,15,0,76,61
1656830176255,CSE 3,A50,083646,Miranda; Gregory Joseph,22,0,50,28
1656830182277,CSE 8A,A50,083650,Miranda; Gregory Joseph,17,1,56,39
1656830188314,CSE 11,A01,083080,Cao; Yingjun,4,15,40,36
1656830194350,CSE 12,A01,083652,Krause-Levy; Sophia Louisa,20,1,120,100
1656830200383,CSE 15L,A01,083654,Morris; Justin Loren,8,0,50,42
1656830200383,CSE 15L,A02,083655,Morris; Justin Loren,8,0,50,42
1656830206407,CSE 20,A01,083657,Tran; Khoa Dang,37,0,80,43
1656830212434,CSE 21,A01,095574,Bach; Quang Tran,21,0,48,27
1656830218458,CSE 30,A01,083084,Eldon; John,4,0,80,76
1656830218458,CSE 30,B01,095061,Bhaskar; Nishant,6,0,50,44
1656830224488,CSE 100,A01,083659,Cao; Yingjun,2,4,70,68
1656830230511,CSE 134B,A01,083661,Powell; Thomas Allan,19,0,100,81
1656830236548,CSE 140,A01,083663,Gungor; Onat,14,0,85,71
1656830242575,CSE 140L,A01,083088,Eldon; John,16,0,100,84
1656830248607,CSE 175,A01,083665,Kumar; Rakesh,3,0,25,22
1656830254629,CSE 190,A00,092507,Dubnov; Shlomo,7,0,20,13
1656830260652,ECE 45,A01,083139,Congero; Spencer William,5,0,75,70
1656830266675,ECE 65,A50,083695,Saad; Andrew S,12,0,30,18
1656830266675,ECE 65,A51,095125,Saad; Andrew S,25,0,26,1
1656830272696,ECE 109,A01,091882,Touri; Behrouz,16,0,70,54
1656830278731,ECE 180,A00,083140,Abi Samra; Nicholas Camill,0,0,30,30
1656830278731,ECE 180,B00,083141,Abi Samra; Nicholas Camill,0,0,30,30
1656830284754,MATH 10A,A01,083735,Patchell; Gregory David,1,0,30,29
1656830284754,MATH 10A,A02,083736,Patchell; Gregory David,20,0,30,10
1656830284754,MATH 10A,A03,083737,Patchell; Gregory David,15,0,30,15
1656830290780,MATH 10B,A01,083207,Lim; Seonhee,7,0,34,27
1656830290780,MATH 10B,A02,083208,Lim; Seonhee,9,0,35,26
1656830290780,MATH 10B,A03,093472,Lim; Seonhee,4,0,34,30
1656830290780,MATH 10B,B01,083739,Sinha; Shubham,9,0,30,21
1656830296805,MATH 18,A01,083743,Cinel; Cameron Alexander,6,0,30,24
1656830296805,MATH 18,A02,083744,Cinel; Cameron Alexander,15,0,30,15
1656830296805,MATH 18,A03,083745,Cinel; Cameron Alexander,8,0,30,22
1656830296805,MATH 18,B01,083748,Rideout; David Porter,3,0,37,34
1656830296805,MATH 18,B02,083749,Rideout; David Porter,3,0,36,33
1656830296805,MATH 18,B03,083750,Rideout; David Porter,2,0,37,35
1656830296805,MATH 18,B04,083751,Rideout; David Porter,5,0,36,31
1656830296805,MATH 18,B05,093473,Rideout; David Porter,4,0,36,32
1656830296805,MATH 18,B06,093474,Rideout; David Porter,5,0,36,31
1656830302827,MATH 20A,A01,083754,Zheng; Zequn,12,0,40,28
1656830308861,MATH 20B,A01,083756,Briones; Jor-el Thomas Caparas,1,0,36,35
1656830308861,MATH 20B,A02,083757,Briones; Jor-el Thomas Caparas,1,0,36,35
1656830308861,MATH 20B,A03,093475,Briones; Jor-el Thomas Caparas,0,0,36,36
1656830314900,MATH 20C,A01,083760,Briones; Jor-el Thomas Caparas,1,0,35,34
1656830314900,MATH 20C,A02,083761,Briones; Jor-el Thomas Caparas,8,0,35,27
1656830314900,MATH 20C,A03,093476,Briones; Jor-el Thomas Caparas,0,1,36,36
1656830314900,MATH 20C,B01,083762,Bach; Quang Tran,0,0,30,30
1656830320929,MATH 20D,A01,083765,Tran; Brian Kha,4,0,30,26
1656830320929,MATH 20D,A02,083766,Tran; Brian Kha,4,0,30,26
1656830320929,MATH 20D,A03,083767,Tran; Brian Kha,2,0,30,28
1656830326954,MATH 20E,A01,083771,Ganguly; Soumya,5,0,32,27
1656830326954,MATH 20E,A02,083772,Ganguly; Soumya,6,0,32,26
1656830326954,MATH 20E,B01,083773,Ciotti; Benjamin,18,0,35,17
1656830326954,MATH 20E,B02,083774,Ciotti; Benjamin,17,0,35,18
1656830332978,MATH 103A,A01,083777,Greenfeld; Be'Eri,2,0,36,34
1656830332978,MATH 103A,A02,083778,Greenfeld; Be'Eri,5,0,36,31
1656830332978,MATH 103A,A03,093561,Greenfeld; Be'Eri,4,0,36,32
1656830332978,MATH 103A,B01,083779,Greenfeld; Be'Eri,6,0,36,30
1656830332978,MATH 103A,B02,083780,Greenfeld; Be'Eri,2,0,36,34
1656830332978,MATH 103A,B03,093562,Greenfeld; Be'Eri,2,0,36,34
1656830339002,MATH 105,A01,085443,Carter; Anne Toulson,13,0,35,22
1656830339002,MATH 105,A02,093477,Carter; Anne Toulson,20,0,35,15
1656830345038,MATH 109,A01,083213,Ganzberger; Geoffrey Michael,2,0,34,32
1656830345038,MATH 109,A02,083214,Ganzberger; Geoffrey Michael,2,0,34,32
1656830345038,MATH 109,A03,093478,Ganzberger; Geoffrey Michael,1,0,34,33
1656830345038,MATH 109,B01,083215,Ganzberger; Geoffrey Michael,1,0,32,31
1656830345038,MATH 109,B02,083216,Ganzberger; Geoffrey Michael,1,0,32,31
1656830345038,MATH 109,B03,093479,Ganzberger; Geoffrey Michael,6,0,32,26
1656830351063,MATH 142A,A01,083219,Chow; Bennett,6,0,32,26
1656830351063,MATH 142A,A02,083220,Chow; Bennett,9,0,32,23
1656830351063,MATH 142A,A03,093480,Chow; Bennett,7,0,32,25
1656830351063,MATH 142A,B03,093481,Chow; Bennett,7,0,32,25
1656830351063,MATH 142A,B04,093558,Chow; Bennett,10,0,32,22
1656830351063,MATH 142A,B05,093559,Chow; Bennett,6,0,32,26
1656830357087,MATH 193A,A01,083224,Rotar; Vladimir,6,0,34,28
1656830357087,MATH 193A,A02,083225,Rotar; Vladimir,3,0,34,31
1656830357087,MATH 193A,A03,083781,Rotar; Vladimir,1,0,34,33
1656830357087,MATH 193A,A04,083782,Rotar; Vladimir,6,0,34,28
1656830357087,MATH 193A,A05,093482,Rotar; Vladimir,6,0,34,28
1656830363113,MATH 197,001,091859,McAuley; Julian John,9999,0,9999,0
1656830363113,MATH 197,002,095566,Kedlaya; Kiran S.,9997,0,9999,2
1656830363113,MATH 197,003,095567,Xiao; Ming,9999,0,9999,0
1656830363113,MATH 197,004,095571,Perols; Johan Lars,9998,0,9999,1
1656830370163,COGS 9,A01,083615,Shannon; Kyle Michael,6,0,75,69
1656830376196,COGS 11,A01,083617,Boyle; Mary E. T.,18,0,48,30
1656830382220,COGS 13,A01,083071,Bastos; Amalia Pinkusfeld,8,0,71,63
1656830388246,COGS 14A,A01,092681,Semenuks; Arturs,0,1,100,100
1656830394273,COGS 14B,A01,083073,Cheng; Tzu-Han,5,0,63,58
1656830400302,COGS 17,A01,092677,Semenuks; Arturs,4,0,81,77
1656830406324,COGS 100,A01,083619,Allen; Michael Gordon,15,0,70,55
1656830412352,COGS 101A,A01,083621,Davis; Joshua Daniel,9,0,68,59
1656830418381,COGS 101B,A01,091572,Allen; Michael Gordon,8,0,65,57
1656830424409,COGS 101C,A01,083625,Delgado; Tania,17,0,35,18
1656830430443,COGS 107A,A01,083627,Boyle; Mary E. T.,13,0,60,47
1656830436466,COGS 118A,A01,083075,Gupta; Anjum,15,0,76,61
1656830442583,CSE 3,A50,083646,Miranda; Gregory Joseph,22,0,50,28
1656830448610,CSE 8A,A50,083650,Miranda; Gregory Joseph,17,1,56,39
1656830454634,CSE 11,A01,083080,Cao; Yingjun,4,15,40,36
1656830460659,CSE 12,A01,083652,Krause-Levy; Sophia Louisa,20,1,120,100
1656830466685,CSE 15L,A01,083654,Morris; Justin Loren,8,0,50,42
1656830466685,CSE 15L,A02,083655,Morris; Justin Loren,8,0,50,42
1656830472716,CSE 20,A01,083657,Tran; Khoa Dang,37,0,80,43
1656830478740,CSE 21,A01,095574,Bach; Quang Tran,21,0,48,27
1656830484773,CSE 30,A01,083084,Eldon; John,4,0,80,76
1656830484773,CSE 30,B01,095061,Bhaskar; Nishant,6,0,50,44
1656830490797,CSE 100,A01,083659,Cao; Yingjun,2,4,70,68
1656830496819,CSE 134B,A01,083661,Powell; Thomas Allan,19,0,100,81
1656830502840,CSE 140,A01,083663,Gungor; Onat,14,0,85,71
1656830508866,CSE 140L,A01,083088,Eldon; John,16,0,100,84
1656830514888,CSE 175,A01,083665,Kumar; Rakesh,3,0,25,22
1656830520913,CSE 190,A00,092507,Dubnov; Shlomo,7,0,20,13
1656830526946,ECE 45,A01,083139,Congero; Spencer William,5,0,75,70
1656830532974,ECE 65,A50,083695,Saad; Andrew S,12,0,30,18
1656830532974,ECE 65,A51,095125,Saad; Andrew S,25,0,26,1
1656830539000,ECE 109,A01,091882,Touri; Behrouz,16,0,70,54
1656830545023,ECE 180,A00,083140,Abi Samra; Nicholas Camill,0,0,30,30
1656830545023,ECE 180,B00,083141,Abi Samra; Nicholas Camill,0,0,30,30
1656830551051,MATH 10A,A01,083735,Patchell; Gregory David,1,0,30,29
1656830551051,MATH 10A,A02,083736,Patchell; Gregory David,20,0,30,10
1656830551051,MATH 10A,A03,083737,Patchell; Gregory David,15,0,30,15
1656830557078,MATH 10B,A01,083207,Lim; Seonhee,7,0,34,27
1656830557078,MATH 10B,A02,083208,Lim; Seonhee,9,0,35,26
1656830557078,MATH 10B,A03,093472,Lim; Seonhee,4,0,34,30
1656830557078,MATH 10B,B01,083739,Sinha; Shubham,9,0,30,21
1656830563111,MATH 18,A01,083743,Cinel; Cameron Alexander,6,0,30,24
1656830563111,MATH 18,A02,083744,Cinel; Cameron Alexander,15,0,30,15
1656830563111,MATH 18,A03,083745,Cinel; Cameron Alexander,8,0,30,22
1656830563111,MATH 18,B01,083748,Rideout; David Porter,3,0,37,34
1656830563111,MATH 18,B02,083749,Rideout; David Porter,3,0,36,33
1656830563111,MATH 18,B03,083750,Rideout; David Porter,2,0,37,35
1656830563111,MATH 18,B04,083751,Rideout; David Porter,5,0,36,31
1656830563111,MATH 18,B05,093473,Rideout; David Porter,4,0,36,32
1656830563111,MATH 18,B06,093474,Rideout; David Porter,5,0,36,31
1656830569133,MATH 20A,A01,083754,Zheng; Zequn,12,0,40,28
1656830575161,MATH 20B,A01,083756,Briones; Jor-el Thomas Caparas,1,0,36,35
1656830575161,MATH 20B,A02,083757,Briones; Jor-el Thomas Caparas,1,0,36,35
1656830575161,MATH 20B,A03,093475,Briones; Jor-el Thomas Caparas,0,0,36,36
1656830581189,MATH 20C,A01,083760,Briones; Jor-el Thomas Caparas,1,0,35,34
1656830581189,MATH 20C,A02,083761,Briones; Jor-el Thomas Caparas,8,0,35,27
1656830581189,MATH 20C,A03,093476,Briones; Jor-el Thomas Caparas,0,1,36,36
1656830581189,MATH 20C,B01,083762,Bach; Quang Tran,0,0,30,30
1656830587211,MATH 20D,A01,083765,Tran; Brian Kha,4,0,30,26
1656830587211,MATH 20D,A02,083766,Tran; Brian Kha,4,0,30,26
1656830587211,MATH 20D,A03,083767,Tran; Brian Kha,2,0,30,28
1656830593248,MATH 20E,A01,083771,Ganguly; Soumya,5,0,32,27
1656830593248,MATH 20E,A02,083772,Ganguly; Soumya,6,0,32,26
1656830593248,MATH 20E,B01,083773,Ciotti; Benjamin,18,0,35,17
1656830593248,MATH 20E,B02,083774,Ciotti; Benjamin,17,0,35,18
1656830599277,MATH 103A,A01,083777,Greenfeld; Be'Eri,2,0,36,34
1656830599277,MATH 103A,A02,083778,Greenfeld; Be'Eri,5,0,36,31
1656830599277,MATH 103A,A03,093561,Greenfeld; Be'Eri,4,0,36,32
1656830599277,MATH 103A,B01,083779,Greenfeld; Be'Eri,6,0,36,30
1656830599277,MATH 103A,B02,083780,Greenfeld; Be'Eri,2,0,36,34
1656830599277,MATH 103A,B03,093562,Greenfeld; Be'Eri,2,0,36,34
1656830605304,MATH 105,A01,085443,Carter; Anne Toulson,13,0,35,22
1656830605304,MATH 105,A02,093477,Carter; Anne Toulson,20,0,35,15
1656830611346,MATH 109,A01,083213,Ganzberger; Geoffrey Michael,2,0,34,32
1656830611346,MATH 109,A02,083214,Ganzberger; Geoffrey Michael,2,0,34,32
1656830611346,MATH 109,A03,093478,Ganzberger; Geoffrey Michael,1,0,34,33
1656830611346,MATH 109,B01,083215,Ganzberger; Geoffrey Michael,1,0,32,31
1656830611346,MATH 109,B02,083216,Ganzberger; Geoffrey Michael,1,0,32,31
1656830611346,MATH 109,B03,093479,Ganzberger; Geoffrey Michael,6,0,32,26
1656830617370,MATH 142A,A01,083219,Chow; Bennett,6,0,32,26
1656830617370,MATH 142A,A02,083220,Chow; Bennett,9,0,32,23
1656830617370,MATH 142A,A03,093480,Chow; Bennett,7,0,32,25
1656830617370,MATH 142A,B03,093481,Chow; Bennett,7,0,32,25
1656830617370,MATH 142A,B04,093558,Chow; Bennett,10,0,32,22
1656830617370,MATH 142A,B05,093559,Chow; Bennett,6,0,32,26
1656830623398,MATH 193A,A01,083224,Rotar; Vladimir,6,0,34,28
1656830623398,MATH 193A,A02,083225,Rotar; Vladimir,3,0,34,31
1656830623398,MATH 193A,A03,083781,Rotar; Vladimir,1,0,34,33
1656830623398,MATH 193A,A04,083782,Rotar; Vladimir,6,0,34,28
1656830623398,MATH 193A,A05,093482,Rotar; Vladimir,6,0,34,28
1656830629428,MATH 197,001,091859,McAuley; Julian John,9999,0,9999,0
1656830629428,MATH 197,002,095566,Kedlaya; Kiran S.,9997,0,9999,2
1656830629428,MATH 197,003,095567,Xiao; Ming,9999,0,9999,0
1656830629428,MATH 197,004,095571,Perols; Johan Lars,9998,0,9999,1
1656830636478,COGS 9,A01,083615,Shannon; Kyle Michael,6,0,75,69
1656830642503,COGS 11,A01,083617,Boyle; Mary E. T.,18,0,48,30
1656830648530,COGS 13,A01,083071,Bastos; Amalia Pinkusfeld,8,0,71,63
1656830654561,COGS 14A,A01,092681,Semenuks; Arturs,0,1,100,100
1656830660588,COGS 14B,A01,083073,Cheng; Tzu-Han,5,0,63,58
1656830666615,COGS 17,A01,092677,Semenuks; Arturs,4,0,81,77
1656830672655,COGS 100,A01,083619,Allen; Michael Gordon,15,0,70,55
1656830678687,COGS 101A,A01,083621,Davis; Joshua Daniel,9,0,68,59
1656830684713,COGS 101B,A01,091572,Allen; Michael Gordon,8,0,65,57
1656830690740,COGS 101C,A01,083625,Delgado; Tania,17,0,35,18
1656830696768,COGS 107A,A01,083627,Boyle; Mary E. T.,13,0,60,47
1656830702797,COGS 118A,A01,083075,Gupta; Anjum,15,0,76,61
1656830708820,CSE 3,A50,083646,Miranda; Gregory Joseph,22,0,50,28
1656830714844,CSE 8A,A50,083650,Miranda; Gregory Joseph,17,1,56,39
1656830720878,CSE 11,A01,083080,Cao; Yingjun,4,15,40,36
1656830726904,CSE 12,A01,083652,Krause-Levy; Sophia Louisa,20,1,120,100
1656830732928,CSE 15L,A01,083654,Morris; Justin Loren,8,0,50,42
1656830732928,CSE 15L,A02,083655,Morris; Justin Loren,8,0,50,42
1656830738952,CSE 20,A01,083657,Tran; Khoa Dang,37,0,80,43
1656830744979,CSE 21,A01,095574,Bach; Quang Tran,21,0,48,27
1656830751002,CSE 30,A01,083084,Eldon; John,4,0,80,76
1656830751002,CSE 30,B01,095061,Bhaskar; Nishant,6,0,50,44
1656830757029,CSE 100,A01,083659,Cao; Yingjun,2,4,70,68
1656830763052,CSE 134B,A01,083661,Powell; Thomas Allan,19,0,100,81
1656830769076,CSE 140,A01,083663,Gungor; Onat,14,0,85,71
1656830775099,CSE 140L,A01,083088,Eldon; John,16,0,100,84
1656830781127,CSE 175,A01,083665,Kumar; Rakesh,3,0,25,22
1656830787151,CSE 190,A00,092507,Dubnov; Shlomo,7,0,20,13
1656830793174,ECE 45,A01,083139,Congero; Spencer William,5,0,75,70
1656830799201,ECE 65,A50,083695,Saad; Andrew S,12,0,30,18
1656830799201,ECE 65,A51,095125,Saad; Andrew S,25,0,26,1
1656830805225,ECE 109,A01,091882,Touri; Behrouz,16,0,70,54
1656830811248,ECE 180,A00,083140,Abi Samra; Nicholas Camill,0,0,30,30
1656830811248,ECE 180,B00,083141,Abi Samra; Nicholas Camill,0,0,30,30
1656830817273,MATH 10A,A01,083735,Patchell; Gregory David,1,0,30,29
1656830817273,MATH 10A,A02,083736,Patchell; Gregory David,20,0,30,10
1656830817273,MATH 10A,A03,083737,Patchell; Gregory David,15,0,30,15
1656830823302,MATH 10B,A01,083207,Lim; Seonhee,7,0,34,27
1656830823302,MATH 10B,A02,083208,Lim; Seonhee,9,0,35,26
1656830823302,MATH 10B,A03,093472,Lim; Seonhee,4,0,34,30
1656830823302,MATH 10B,B01,083739,Sinha; Shubham,9,0,30,21
1656830829328,MATH 18,A01,083743,Cinel; Cameron Alexander,6,0,30,24
1656830829328,MATH 18,A02,083744,Cinel; Cameron Alexander,15,0,30,15
1656830829328,MATH 18,A03,083745,Cinel; Cameron Alexander,8,0,30,22
1656830829328,MATH 18,B01,083748,Rideout; David Porter,3,0,37,34
1656830829328,MATH 18,B02,083749,Rideout; David Porter,3,0,36,33
1656830829328,MATH 18,B03,083750,Rideout; David Porter,2,0,37,35
1656830829328,MATH 18,B04,083751,Rideout; David Porter,5,0,36,31
1656830829328,MATH 18,B05,093473,Rideout; David Porter,4,0,36,32
1656830829328,MATH 18,B06,093474,Rideout; David Porter,5,0,36,31
1656830835351,MATH 20A,A01,083754,Zheng; Zequn,12,0,40,28
1656830841376,MATH 20B,A01,083756,Briones; Jor-el Thomas Caparas,1,0,36,35
1656830841376,MATH 20B,A02,083757,Briones; Jor-el Thomas Caparas,1,0,36,35
1656830841376,MATH 20B,A03,093475,Briones; Jor-el Thomas Caparas,0,0,36,36
1656830847405,MATH 20C,A01,083760,Briones; Jor-el Thomas Caparas,1,0,35,34
1656830847405,MATH 20C,A02,083761,Briones; Jor-el Thomas Caparas,8,0,35,27
1656830847405,MATH 20C,A03,093476,Briones; Jor-el Thomas Caparas,0,1,36,36
1656830847405,MATH 20C,B01,083762,Bach; Quang Tran,0,0,30,30
1656830853429,MATH 20D,A01,083765,Tran; Brian Kha,4,0,30,26
1656830853429,MATH 20D,A02,083766,Tran; Brian Kha,4,0,30,26
1656830853429,MATH 20D,A03,083767,Tran; Brian Kha,2,0,30,28
1656830859454,MATH 20E,A01,083771,Ganguly; Soumya,5,0,32,27
1656830859454,MATH 20E,A02,083772,Ganguly; Soumya,6,0,32,26
1656830859454,MATH 20E,B01,083773,Ciotti; Benjamin,18,0,35,17
1656830859454,MATH 20E,B02,083774,Ciotti; Benjamin,17,0,35,18
1656830865480,MATH 103A,A01,083777,Greenfeld; Be'Eri,2,0,36,34
1656830865480,MATH 103A,A02,083778,Greenfeld; Be'Eri,5,0,36,31
1656830865480,MATH 103A,A03,093561,Greenfeld; Be'Eri,4,0,36,32
1656830865480,MATH 103A,B01,083779,Greenfeld; Be'Eri,6,0,36,30
1656830865480,MATH 103A,B02,083780,Greenfeld; Be'Eri,2,0,36,34
1656830865480,MATH 103A,B03,093562,Greenfeld; Be'Eri,2,0,36,34
1656830871508,MATH 105,A01,085443,Carter; Anne Toulson,13,0,35,22
1656830871508,MATH 105,A02,093477,Carter; Anne Toulson,20,0,35,15
1656830877536,MATH 109,A01,083213,Ganzberger; Geoffrey Michael,2,0,34,32
1656830877536,MATH 109,A02,083214,Ganzberger; Geoffrey Michael,2,0,34,32
1656830877536,MATH 109,A03,093478,Ganzberger; Geoffrey Michael,1,0,34,33
1656830877536,MATH 109,B01,083215,Ganzberger; Geoffrey Michael,1,0,32,31
1656830877536,MATH 109,B02,083216,Ganzberger; Geoffrey Michael,1,0,32,31
1656830877536,MATH 109,B03,093479,Ganzberger; Geoffrey Michael,6,0,32,26
1656830883566,MATH 142A,A01,083219,Chow; Bennett,6,0,32,26
1656830883566,MATH 142A,A02,083220,Chow; Bennett,9,0,32,23
1656830883566,MATH 142A,A03,093480,Chow; Bennett,7,0,32,25
1656830883566,MATH 142A,B03,093481,Chow; Bennett,7,0,32,25
1656830883566,MATH 142A,B04,093558,Chow; Bennett,10,0,32,22
1656830883566,MATH 142A,B05,093559,Chow; Bennett,6,0,32,26
1656830889600,MATH 193A,A01,083224,Rotar; Vladimir,6,0,34,28
1656830889600,MATH 193A,A02,083225,Rotar; Vladimir,3,0,34,31
1656830889600,MATH 193A,A03,083781,Rotar; Vladimir,1,0,34,33
1656830889600,MATH 193A,A04,083782,Rotar; Vladimir,6,0,34,28
1656830889600,MATH 193A,A05,093482,Rotar; Vladimir,6,0,34,28
1656830895622,MATH 197,001,091859,McAuley; Julian John,9999,0,9999,0
1656830895622,MATH 197,002,095566,Kedlaya; Kiran S.,9997,0,9999,2
1656830895622,MATH 197,003,095567,Xiao; Ming,9999,0,9999,0
1656830895622,MATH 197,004,095571,Perols; Johan Lars,9998,0,9999,1
1656830902680,COGS 9,A01,083615,Shannon; Kyle Michael,6,0,75,69
1656830908705,COGS 11,A01,083617,Boyle; Mary E. T.,18,0,48,30
1656830914731,COGS 13,A01,083071,Bastos; Amalia Pinkusfeld,8,0,71,63
1656830920752,COGS 14A,A01,092681,Semenuks; Arturs,0,1,100,100
1656830926774,COGS 14B,A01,083073,Cheng; Tzu-Han,5,0,63,58
1656830932799,COGS 17,A01,092677,Semenuks; Arturs,4,0,81,77
1656830938822,COGS 100,A01,083619,Allen; Michael Gordon,15,0,70,55
1656830944846,COGS 101A,A01,083621,Davis; Joshua Daniel,9,0,68,59
1656830950872,COGS 101B,A01,091572,Allen; Michael Gordon,8,0,65,57
1656830956895,COGS 101C,A01,083625,Delgado; Tania,17,0,35,18
1656830962922,COGS 107A,A01,083627,Boyle; Mary E. T.,13,0,60,47
1656830968951,COGS 118A,A01,083075,Gupta; Anjum,15,0,76,61
1656830974997,CSE 3,A50,083646,Miranda; Gregory Joseph,22,0,50,28
1656830981020,CSE 8A,A50,083650,Miranda; Gregory Joseph,17,1,56,39
1656830987043,CSE 11,A01,083080,Cao; Yingjun,4,15,40,36
1656830993070,CSE 12,A01,083652,Krause-Levy; Sophia Louisa,20,1,120,100
1656830999091,CSE 15L,A01,083654,Morris; Justin Loren,8,0,50,42
1656830999091,CSE 15L,A02,083655,Morris; Justin Loren,8,0,50,42
1656831005118,CSE 20,A01,083657,Tran; Khoa Dang,37,0,80,43
1656831011147,CSE 21,A01,095574,Bach; Quang Tran,21,0,48,27
1656831017171,CSE 30,A01,083084,Eldon; John,4,0,80,76
1656831017171,CSE 30,B01,095061,Bhaskar; Nishant,6,0,50,44
1656831023193,CSE 100,A01,083659,Cao; Yingjun,2,4,70,68
1656831029222,CSE 134B,A01,083661,Powell; Thomas Allan,19,0,100,81
1656831035248,CSE 140,A01,083663,Gungor; Onat,14,0,85,71
1656831041343,CSE 140L,A01,083088,Eldon; John,16,0,100,84
1656831047366,CSE 175,A01,083665,Kumar; Rakesh,3,0,25,22
1656831053394,CSE 190,A00,092507,Dubnov; Shlomo,7,0,20,13
1656831059421,ECE 45,A01,083139,Congero; Spencer William,5,0,75,70
1656831065444,ECE 65,A50,083695,Saad; Andrew S,12,0,30,18
1656831065444,ECE 65,A51,095125,Saad; Andrew S,25,0,26,1
1656831071467,ECE 109,A01,091882,Touri; Behrouz,16,0,70,54
1656831077495,ECE 180,A00,083140,Abi Samra; Nicholas Camill,0,0,30,30
1656831077495,ECE 180,B00,083141,Abi Samra; Nicholas Camill,0,0,30,30
1656831083518,MATH 10A,A01,083735,Patchell; Gregory David,1,0,30,29
1656831083518,MATH 10A,A02,083736,Patchell; Gregory David,20,0,30,10
1656831083518,MATH 10A,A03,083737,Patchell; Gregory David,15,0,30,15
1656831089543,MATH 10B,A01,083207,Lim; Seonhee,7,0,34,27
1656831089543,MATH 10B,A02,083208,Lim; Seonhee,9,0,35,26
1656831089543,MATH 10B,A03,093472,Lim; Seonhee,4,0,34,30
1656831089543,MATH 10B,B01,083739,Sinha; Shubham,9,0,30,21
1656831095574,MATH 18,A01,083743,Cinel; Cameron Alexander,6,0,30,24
1656831095574,MATH 18,A02,083744,Cinel; Cameron Alexander,15,0,30,15
1656831095574,MATH 18,A03,083745,Cinel; Cameron Alexander,8,0,30,22
1656831095574,MATH 18,B01,083748,Rideout; David Porter,3,0,37,34
1656831095574,MATH 18,B02,083749,Rideout; David Porter,3,0,36,33
1656831095574,MATH 18,B03,083750,Rideout; David Porter,2,0,37,35
1656831095574,MATH 18,B04,083751,Rideout; David Porter,5,0,36,31
1656831095574,MATH 18,B05,093473,Rideout; David Porter,4,0,36,32
1656831095574,MATH 18,B06,093474,Rideout; David Porter,5,0,36,31
1656831101608,MATH 20A,A01,083754,Zheng; Zequn,12,0,40,28
1656831107631,MATH 20B,A01,083756,Briones; Jor-el Thomas Caparas,1,0,36,35
1656831107631,MATH 20B,A02,083757,Briones; Jor-el Thomas Caparas,1,0,36,35
1656831107631,MATH 20B,A03,093475,Briones; Jor-el Thomas Caparas,0,0,36,36
1656831113659,MATH 20C,A01,083760,Briones; Jor-el Thomas Caparas,1,0,35,34
1656831113659,MATH 20C,A02,083761,Briones; Jor-el Thomas Caparas,8,0,35,27
1656831113659,MATH 20C,A03,093476,Briones; Jor-el Thomas Caparas,0,1,36,36
1656831113659,MATH 20C,B01,083762,Bach; Quang Tran,0,0,30,30
1656831119685,MATH 20D,A01,083765,Tran; Brian Kha,4,0,30,26
1656831119685,MATH 20D,A02,083766,Tran; Brian Kha,4,0,30,26
1656831119685,MATH 20D,A03,083767,Tran; Brian Kha,2,0,30,28
1656831125719,MATH 20E,A01,083771,Ganguly; Soumya,5,0,32,27
1656831125719,MATH 20E,A02,083772,Ganguly; Soumya,6,0,32,26
1656831125719,MATH 20E,B01,083773,Ciotti; Benjamin,18,0,35,17
1656831125719,MATH 20E,B02,083774,Ciotti; Benjamin,17,0,35,18
1656831131743,MATH 103A,A01,083777,Greenfeld; Be'Eri,2,0,36,34
1656831131743,MATH 103A,A02,083778,Greenfeld; Be'Eri,5,0,36,31
1656831131743,MATH 103A,A03,093561,Greenfeld; Be'Eri,4,0,36,32
1656831131743,MATH 103A,B01,083779,Greenfeld; Be'Eri,6,0,36,30
1656831131743,MATH 103A,B02,083780,Greenfeld; Be'Eri,2,0,36,34
1656831131743,MATH 103A,B03,093562,Greenfeld; Be'Eri,2,0,36,34
1656831137766,MATH 105,A01,085443,Carter; Anne Toulson,13,0,35,22
1656831137766,MATH 105,A02,093477,Carter; Anne Toulson,20,0,35,15
1656831143802,MATH 109,A01,083213,Ganzberger; Geoffrey Michael,2,0,34,32
1656831143802,MATH 109,A02,083214,Ganzberger; Geoffrey Michael,2,0,34,32
1656831143802,MATH 109,A03,093478,Ganzberger; Geoffrey Michael,1,0,34,33
1656831143802,MATH 109,B01,083215,Ganzberger; Geoffrey Michael,1,0,32,31
1656831143802,MATH 109,B02,083216,Ganzberger; Geoffrey Michael,1,0,32,31
1656831143802,MATH 109,B03,093479,Ganzberger; Geoffrey Michael,6,0,32,26
1656831149828,MATH 142A,A01,083219,Chow; Bennett,6,0,32,26
1656831149828,MATH 142A,A02,083220,Chow; Bennett,9,0,32,23
1656831149828,MATH 142A,A03,093480,Chow; Bennett,7,0,32,25
1656831149828,MATH 142A,B03,093481,Chow; Bennett,7,0,32,25
1656831149828,MATH 142A,B04,093558,Chow; Bennett,10,0,32,22
1656831149828,MATH 142A,B05,093559,Chow; Bennett,6,0,32,26
1656831155871,MATH 193A,A01,083224,Rotar; Vladimir,6,0,34,28
1656831155871,MATH 193A,A02,083225,Rotar; Vladimir,3,0,34,31
1656831155871,MATH 193A,A03,083781,Rotar; Vladimir,1,0,34,33
1656831155871,MATH 193A,A04,083782,Rotar; Vladimir,6,0,34,28
1656831155871,MATH 193A,A05,093482,Rotar; Vladimir,6,0,34,28
1656831161901,MATH 197,001,091859,McAuley; Julian John,9999,0,9999,0
1656831161901,MATH 197,002,095566,Kedlaya; Kiran S.,9997,0,9999,2
1656831161901,MATH 197,003,095567,Xiao; Ming,9999,0,9999,0
1656831161901,MATH 197,004,095571,Perols; Johan Lars,9998,0,9999,1
1656831168960,COGS 9,A01,083615,Shannon; Kyle Michael,6,0,75,69
1656831174984,COGS 11,A01,083617,Boyle; Mary E. T.,18,0,48,30
1656831181009,COGS 13,A01,083071,Bastos; Amalia Pinkusfeld,8,0,71,63
1656831187031,COGS 14A,A01,092681,Semenuks; Arturs,0,1,100,100
1656831193057,COGS 14B,A01,083073,Cheng; Tzu-Han,5,0,63,58
1656831199079,COGS 17,A01,092677,Semenuks; Arturs,4,0,81,77
1656831205102,COGS 100,A01,083619,Allen; Michael Gordon,15,0,70,55
1656831211126,COGS 101A,A01,083621,Davis; Joshua Daniel,9,0,68,59
1656831217151,COGS 101B,A01,091572,Allen; Michael Gordon,8,0,65,57
1656831223176,COGS 101C,A01,083625,Delgado; Tania,17,0,35,18
1656831229198,COGS 107A,A01,083627,Boyle; Mary E. T.,13,0,60,47
1656831235222,COGS 118A,A01,083075,Gupta; Anjum,15,0,76,61
1656831241245,CSE 3,A50,083646,Miranda; Gregory Joseph,22,0,50,28
1656831247272,CSE 8A,A50,083650,Miranda; Gregory Joseph,17,1,56,39
1656831253295,CSE 11,A01,083080,Cao; Yingjun,4,15,40,36
1656831259319,CSE 12,A01,083652,Krause-Levy; Sophia Louisa,20,1,120,100
1656831265343,CSE 15L,A01,083654,Morris; Justin Loren,8,0,50,42
1656831265343,CSE 15L,A02,083655,Morris; Justin Loren,8,0,50,42
1656831271388,CSE 20,A01,083657,Tran; Khoa Dang,37,0,80,43
1656831277418,CSE 21,A01,095574,Bach; Quang Tran,21,0,48,27
1656831283441,CSE 30,A01,083084,Eldon; John,4,0,80,76
1656831283441,CSE 30,B01,095061,Bhaskar; Nishant,6,0,50,44
1656831289468,CSE 100,A01,083659,Cao; Yingjun,2,4,70,68
1656831295493,CSE 134B,A01,083661,Powell; Thomas Allan,19,0,100,81
1656831301520,CSE 140,A01,083663,Gungor; Onat,14,0,85,71
1656831307541,CSE 140L,A01,083088,Eldon; John,16,0,100,84
1656831313564,CSE 175,A01,083665,Kumar; Rakesh,3,0,25,22
1656831319589,CSE 190,A00,092507,Dubnov; Shlomo,7,0,20,13
1656831325615,ECE 45,A01,083139,Congero; Spencer William,5,0,75,70
1656831331643,ECE 65,A50,083695,Saad; Andrew S,12,0,30,18
1656831331643,ECE 65,A51,095125,Saad; Andrew S,25,0,26,1
1656831337665,ECE 109,A01,091882,Touri; Behrouz,16,0,70,54
1656831343688,ECE 180,A00,083140,Abi Samra; Nicholas Camill,0,0,30,30
1656831343688,ECE 180,B00,083141,Abi Samra; Nicholas Camill,0,0,30,30
1656831349712,MATH 10A,A01,083735,Patchell; Gregory David,1,0,30,29
1656831349712,MATH 10A,A02,083736,Patchell; Gregory David,20,0,30,10
1656831349712,MATH 10A,A03,083737,Patchell; Gregory David,15,0,30,15
1656831355741,MATH 10B,A01,083207,Lim; Seonhee,7,0,34,27
1656831355741,MATH 10B,A02,083208,Lim; Seonhee,9,0,35,26
1656831355741,MATH 10B,A03,093472,Lim; Seonhee,4,0,34,30
1656831355741,MATH 10B,B01,083739,Sinha; Shubham,9,0,30,21
1656831361769,MATH 18,A01,083743,Cinel; Cameron Alexander,6,0,30,24
1656831361769,MATH 18,A02,083744,Cinel; Cameron Alexander,15,0,30,15
1656831361769,MATH 18,A03,083745,Cinel; Cameron Alexander,8,0,30,22
1656831361769,MATH 18,B01,083748,Rideout; David Porter,3,0,37,34
1656831361769,MATH 18,B02,083749,Rideout; David Porter,3,0,36,33
1656831361769,MATH 18,B03,083750,Rideout; David Porter,2,0,37,35
1656831361769,MATH 18,B04,083751,Rideout; David Porter,5,0,36,31
1656831361769,MATH 18,B05,093473,Rideout; David Porter,4,0,36,32
1656831361769,MATH 18,B06,093474,Rideout; David Porter,5,0,36,31
1656831367790,MATH 20A,A01,083754,Zheng; Zequn,12,0,40,28
1656831373813,MATH 20B,A01,083756,Briones; Jor-el Thomas Caparas,1,0,36,35
1656831373813,MATH 20B,A02,083757,Briones; Jor-el Thomas Caparas,1,0,36,35
1656831373813,MATH 20B,A03,093475,Briones; Jor-el Thomas Caparas,0,0,36,36
1656831379841,MATH 20C,A01,083760,Briones; Jor-el Thomas Caparas,1,0,35,34
1656831379841,MATH 20C,A02,083761,Briones; Jor-el Thomas Caparas,8,0,35,27
1656831379841,MATH 20C,A03,093476,Briones; Jor-el Thomas Caparas,0,1,36,36
1656831379841,MATH 20C,B01,083762,Bach; Quang Tran,0,0,30,30
1656831385865,MATH 20D,A01,083765,Tran; Brian Kha,4,0,30,26
1656831385865,MATH 20D,A02,083766,Tran; Brian Kha,4,0,30,26
1656831385865,MATH 20D,A03,083767,Tran; Brian Kha,2,0,30,28
1656831391894,MATH 20E,A01,083771,Ganguly; Soumya,5,0,32,27
1656831391894,MATH 20E,A02,083772,Ganguly; Soumya,6,0,32,26
1656831391894,MATH 20E,B01,083773,Ciotti; Benjamin,18,0,35,17
1656831391894,MATH 20E,B02,083774,Ciotti; Benjamin,17,0,35,18
1656831397926,MATH 103A,A01,083777,Greenfeld; Be'Eri,2,0,36,34
1656831397926,MATH 103A,A02,083778,Greenfeld; Be'Eri,5,0,36,31
1656831397926,MATH 103A,A03,093561,Greenfeld; Be'Eri,4,0,36,32
1656831397926,MATH 103A,B01,083779,Greenfeld; Be'Eri,6,0,36,30
1656831397926,MATH 103A,B02,083780,Greenfeld; Be'Eri,2,0,36,34
1656831397926,MATH 103A,B03,093562,Greenfeld; Be'Eri,2,0,36,34
1656831403953,MATH 105,A01,085443,Carter; Anne Toulson,13,0,35,22
1656831403953,MATH 105,A02,093477,Carter; Anne Toulson,20,0,35,15
1656831409977,MATH 109,A01,083213,Ganzberger; Geoffrey Michael,2,0,34,32
1656831409977,MATH 109,A02,083214,Ganzberger; Geoffrey Michael,2,0,34,32
1656831409977,MATH 109,A03,093478,Ganzberger; Geoffrey Michael,1,0,34,33
1656831409977,MATH 109,B01,083215,Ganzberger; Geoffrey Michael,1,0,32,31
1656831409977,MATH 109,B02,083216,Ganzberger; Geoffrey Michael,1,0,32,31
1656831409977,MATH 109,B03,093479,Ganzberger; Geoffrey Michael,6,0,32,26
1656831416001,MATH 142A,A01,083219,Chow; Bennett,6,0,32,26
1656831416001,MATH 142A,A02,083220,Chow; Bennett,9,0,32,23
1656831416001,MATH 142A,A03,093480,Chow; Bennett,7,0,32,25
1656831416001,MATH 142A,B03,093481,Chow; Bennett,7,0,32,25
1656831416001,MATH 142A,B04,093558,Chow; Bennett,10,0,32,22
1656831416001,MATH 142A,B05,093559,Chow; Bennett,6,0,32,26
1656831422024,MATH 193A,A01,083224,Rotar; Vladimir,6,0,34,28
1656831422024,MATH 193A,A02,083225,Rotar; Vladimir,3,0,34,31
1656831422024,MATH 193A,A03,083781,Rotar; Vladimir,1,0,34,33
1656831422024,MATH 193A,A04,083782,Rotar; Vladimir,6,0,34,28
1656831422024,MATH 193A,A05,093482,Rotar; Vladimir,6,0,34,28
1656831428051,MATH 197,001,091859,McAuley; Julian John,9999,0,9999,0
1656831428051,MATH 197,002,095566,Kedlaya; Kiran S.,9997,0,9999,2
1656831428051,MATH 197,003,095567,Xiao; Ming,9999,0,9999,0
1656831428051,MATH 197,004,095571,Perols; Johan Lars,9998,0,9999,1
1656831435116,COGS 9,A01,083615,Shannon; Kyle Michael,6,0,75,69
1656831441143,COGS 11,A01,083617,Boyle; Mary E. T.,18,0,48,30
1656831447169,COGS 13,A01,083071,Bastos; Amalia Pinkusfeld,8,0,71,63
1656831453194,COGS 14A,A01,092681,Semenuks; Arturs,0,1,100,100
1656831459221,COGS 14B,A01,083073,Cheng; Tzu-Han,5,0,63,58
1656831465248,COGS 17,A01,092677,Semenuks; Arturs,4,0,81,77
1656831471270,COGS 100,A01,083619,Allen; Michael Gordon,15,0,70,55
1656831477298,COGS 101A,A01,083621,Davis; Joshua Daniel,9,0,68,59
1656831483328,COGS 101B,A01,091572,Allen; Michael Gordon,8,0,65,57
1656831489350,COGS 101C,A01,083625,Delgado; Tania,17,0,35,18
1656831495372,COGS 107A,A01,083627,Boyle; Mary E. T.,13,0,60,47
1656831501398,COGS 118A,A01,083075,Gupta; Anjum,15,0,76,61
1656831507427,CSE 3,A50,083646,Miranda; Gregory Joseph,22,0,50,28
1656831513452,CSE 8A,A50,083650,Miranda; Gregory Joseph,17,1,56,39
1656831519478,CSE 11,A01,083080,Cao; Yingjun,4,15,40,36
1656831525505,CSE 12,A01,083652,Krause-Levy; Sophia Louisa,20,1,120,100
1656831531533,CSE 15L,A01,083654,Morris; Justin Loren,8,0,50,42
1656831531533,CSE 15L,A02,083655,Morris; Justin Loren,8,0,50,42
1656831537568,CSE 20,A01,083657,Tran; Khoa Dang,37,0,80,43
1656831543589,CSE 21,A01,095574,Bach; Quang Tran,21,0,48,27
1656831549618,CSE 30,A01,083084,Eldon; John,4,0,80,76
1656831549618,CSE 30,B01,095061,Bhaskar; Nishant,6,0,50,44
1656831555644,CSE 100,A01,083659,Cao; Yingjun,2,4,70,68
1656831561667,CSE 134B,A01,083661,Powell; Thomas Allan,19,0,100,81
1656831567701,CSE 140,A01,083663,Gungor; Onat,14,0,85,71
1656831573730,CSE 140L,A01,083088,Eldon; John,16,0,100,84
1656831579757,CSE 175,A01,083665,Kumar; Rakesh,3,0,25,22
1656831585780,CSE 190,A00,092507,Dubnov; Shlomo,7,0,20,13
1656831591803,ECE 45,A01,083139,Congero; Spencer William,5,0,75,70
1656831597830,ECE 65,A50,083695,Saad; Andrew S,12,0,30,18
1656831597830,ECE 65,A51,095125,Saad; Andrew S,25,0,26,1
1656831603856,ECE 109,A01,091882,Touri; Behrouz,16,0,70,54
1656831609883,ECE 180,A00,083140,Abi Samra; Nicholas Camill,0,0,30,30
1656831609883,ECE 180,B00,083141,Abi Samra; Nicholas Camill,0,0,30,30
1656831615922,MATH 10A,A01,083735,Patchell; Gregory David,1,0,30,29
1656831615922,MATH 10A,A02,083736,Patchell; Gregory David,20,0,30,10
1656831615922,MATH 10A,A03,083737,Patchell; Gregory David,15,0,30,15
1656831621951,MATH 10B,A01,083207,Lim; Seonhee,7,0,34,27
1656831621951,MATH 10B,A02,083208,Lim; Seonhee,9,0,35,26
1656831621951,MATH 10B,A03,093472,Lim; Seonhee,4,0,34,30
1656831621951,MATH 10B,B01,083739,Sinha; Shubham,9,0,30,21
1656831627985,MATH 18,A01,083743,Cinel; Cameron Alexander,6,0,30,24
1656831627985,MATH 18,A02,083744,Cinel; Cameron Alexander,15,0,30,15
1656831627985,MATH 18,A03,083745,Cinel; Cameron Alexander,8,0,30,22
1656831627985,MATH 18,B01,083748,Rideout; David Porter,3,0,37,34
1656831627985,MATH 18,B02,083749,Rideout; David Porter,3,0,36,33
1656831627985,MATH 18,B03,083750,Rideout; David Porter,2,0,37,35
1656831627985,MATH 18,B04,083751,Rideout; David Porter,5,0,36,31
1656831627985,MATH 18,B05,093473,Rideout; David Porter,4,0,36,32
1656831627985,MATH 18,B06,093474,Rideout; David Porter,5,0,36,31
1656831634014,MATH 20A,A01,083754,Zheng; Zequn,12,0,40,28
1656831640127,MATH 20B,A01,083756,Briones; Jor-el Thomas Caparas,1,0,36,35
1656831640127,MATH 20B,A02,083757,Briones; Jor-el Thomas Caparas,1,0,36,35
1656831640127,MATH 20B,A03,093475,Briones; Jor-el Thomas Caparas,0,0,36,36
1656831646150,MATH 20C,A01,083760,Briones; Jor-el Thomas Caparas,1,0,35,34
1656831646150,MATH 20C,A02,083761,Briones; Jor-el Thomas Caparas,8,0,35,27
1656831646150,MATH 20C,A03,093476,Briones; Jor-el Thomas Caparas,0,1,36,36
1656831646150,MATH 20C,B01,083762,Bach; Quang Tran,0,0,30,30
1656831652178,MATH 20D,A01,083765,Tran; Brian Kha,4,0,30,26
1656831652178,MATH 20D,A02,083766,Tran; Brian Kha,4,0,30,26
1656831652178,MATH 20D,A03,083767,Tran; Brian Kha,2,0,30,28
1656831658201,MATH 20E,A01,083771,Ganguly; Soumya,5,0,32,27
1656831658201,MATH 20E,A02,083772,Ganguly; Soumya,6,0,32,26
1656831658201,MATH 20E,B01,083773,Ciotti; Benjamin,18,0,35,17
1656831658201,MATH 20E,B02,083774,Ciotti; Benjamin,17,0,35,18
1656831664232,MATH 103A,A01,083777,Greenfeld; Be'Eri,2,0,36,34
1656831664232,MATH 103A,A02,083778,Greenfeld; Be'Eri,5,0,36,31
1656831664232,MATH 103A,A03,093561,Greenfeld; Be'Eri,4,0,36,32
1656831664232,MATH 103A,B01,083779,Greenfeld; Be'Eri,6,0,36,30
1656831664232,MATH 103A,B02,083780,Greenfeld; Be'Eri,2,0,36,34
1656831664232,MATH 103A,B03,093562,Greenfeld; Be'Eri,2,0,36,34
1656831670255,MATH 105,A01,085443,Carter; Anne Toulson,13,0,35,22
1656831670255,MATH 105,A02,093477,Carter; Anne Toulson,20,0,35,15
1656831676281,MATH 109,A01,083213,Ganzberger; Geoffrey Michael,2,0,34,32
1656831676281,MATH 109,A02,083214,Ganzberger; Geoffrey Michael,2,0,34,32
1656831676281,MATH 109,A03,093478,Ganzberger; Geoffrey Michael,1,0,34,33
1656831676281,MATH 109,B01,083215,Ganzberger; Geoffrey Michael,1,0,32,31
1656831676281,MATH 109,B02,083216,Ganzberger; Geoffrey Michael,1,0,32,31
1656831676281,MATH 109,B03,093479,Ganzberger; Geoffrey Michael,6,0,32,26
1656831682305,MATH 142A,A01,083219,Chow; Bennett,6,0,32,26
1656831682305,MATH 142A,A02,083220,Chow; Bennett,9,0,32,23
1656831682305,MATH 142A,A03,093480,Chow; Bennett,7,0,32,25
1656831682305,MATH 142A,B03,093481,Chow; Bennett,7,0,32,25
1656831682305,MATH 142A,B04,093558,Chow; Bennett,10,0,32,22
1656831682305,MATH 142A,B05,093559,Chow; Bennett,6,0,32,26
1656831688333,MATH 193A,A01,083224,Rotar; Vladimir,6,0,34,28
1656831688333,MATH 193A,A02,083225,Rotar; Vladimir,3,0,34,31
1656831688333,MATH 193A,A03,083781,Rotar; Vladimir,1,0,34,33
1656831688333,MATH 193A,A04,083782,Rotar; Vladimir,6,0,34,28
1656831688333,MATH 193A,A05,093482,Rotar; Vladimir,6,0,34,28
1656831694357,MATH 197,001,091859,McAuley; Julian John,9999,0,9999,0
1656831694357,MATH 197,002,095566,Kedlaya; Kiran S.,9997,0,9999,2
1656831694357,MATH 197,003,095567,Xiao; Ming,9999,0,9999,0
1656831694357,MATH 197,004,095571,Perols; Johan Lars,9998,0,9999,1
1656831701418,COGS 9,A01,083615,Shannon; Kyle Michael,6,0,75,69
1656831707442,COGS 11,A01,083617,Boyle; Mary E. T.,18,0,48,30
1656831713470,COGS 13,A01,083071,Bastos; Amalia Pinkusfeld,8,0,71,63
1656831719499,COGS 14A,A01,092681,Semenuks; Arturs,0,1,100,100
1656831725527,COGS 14B,A01,083073,Cheng; Tzu-Han,5,0,63,58
1656831731556,COGS 17,A01,092677,Semenuks; Arturs,4,0,81,77
1656831737579,COGS 100,A01,083619,Allen; Michael Gordon,15,0,70,55
1656831743606,COGS 101A,A01,083621,Davis; Joshua Daniel,9,0,68,59
1656831749628,COGS 101B,A01,091572,Allen; Michael Gordon,8,0,65,57
1656831755657,COGS 101C,A01,083625,Delgado; Tania,17,0,35,18
1656831761686,COGS 107A,A01,083627,Boyle; Mary E. T.,13,0,60,47
1656831767709,COGS 118A,A01,083075,Gupta; Anjum,15,0,76,61
1656831773732,CSE 3,A50,083646,Miranda; Gregory Joseph,22,0,50,28
1656831779762,CSE 8A,A50,083650,Miranda; Gregory Joseph,17,1,56,39
1656831785786,CSE 11,A01,083080,Cao; Yingjun,4,15,40,36
1656831791810,CSE 12,A01,083652,Krause-Levy; Sophia Louisa,20,1,120,100
1656831797836,CSE 15L,A01,083654,Morris; Justin Loren,8,0,50,42
1656831797836,CSE 15L,A02,083655,Morris; Justin Loren,8,0,50,42
1656831803868,CSE 20,A01,083657,Tran; Khoa Dang,37,0,80,43
1656831809900,CSE 21,A01,095574,Bach; Quang Tran,21,0,48,27
1656831815931,CSE 30,A01,083084,Eldon; John,4,0,80,76
1656831815931,CSE 30,B01,095061,Bhaskar; Nishant,6,0,50,44
1656831821953,CSE 100,A01,083659,Cao; Yingjun,2,4,70,68
1656831827977,CSE 134B,A01,083661,Powell; Thomas Allan,19,0,100,81
1656831834001,CSE 140,A01,083663,Gungor; Onat,14,0,85,71
1656831840026,CSE 140L,A01,083088,Eldon; John,16,0,100,84
1656831846056,CSE 175,A01,083665,Kumar; Rakesh,3,0,25,22
1656831852085,CSE 190,A00,092507,Dubnov; Shlomo,7,0,20,13
1656831858115,ECE 45,A01,083139,Congero; Spencer William,5,0,75,70
1656831864138,ECE 65,A50,083695,Saad; Andrew S,12,0,30,18
1656831864138,ECE 65,A51,095125,Saad; Andrew S,25,0,26,1
1656831870166,ECE 109,A01,091882,Touri; Behrouz,16,0,70,54
1656831876201,ECE 180,A00,083140,Abi Samra; Nicholas Camill,0,0,30,30
1656831876201,ECE 180,B00,083141,Abi Samra; Nicholas Camill,0,0,30,30
1656831882232,MATH 10A,A01,083735,Patchell; Gregory David,1,0,30,29
1656831882232,MATH 10A,A02,083736,Patchell; Gregory David,20,0,30,10
1656831882232,MATH 10A,A03,083737,Patchell; Gregory David,15,0,30,15
1656831888258,MATH 10B,A01,083207,Lim; Seonhee,7,0,34,27
1656831888258,MATH 10B,A02,083208,Lim; Seonhee,9,0,35,26
1656831888258,MATH 10B,A03,093472,Lim; Seonhee,4,0,34,30
1656831888258,MATH 10B,B01,083739,Sinha; Shubham,9,0,30,21
1656831894283,MATH 18,A01,083743,Cinel; Cameron Alexander,6,0,30,24
1656831894283,MATH 18,A02,083744,Cinel; Cameron Alexander,15,0,30,15
1656831894283,MATH 18,A03,083745,Cinel; Cameron Alexander,8,0,30,22
1656831894283,MATH 18,B01,083748,Rideout; David Porter,3,0,37,34
1656831894283,MATH 18,B02,083749,Rideout; David Porter,3,0,36,33
1656831894283,MATH 18,B03,083750,Rideout; David Porter,2,0,37,35
1656831894283,MATH 18,B04,083751,Rideout; David Porter,5,0,36,31
1656831894283,MATH 18,B05,093473,Rideout; David Porter,4,0,36,32
1656831894283,MATH 18,B06,093474,Rideout; David Porter,5,0,36,31
1656831900310,MATH 20A,A01,083754,Zheng; Zequn,12,0,40,28
1656831906339,MATH 20B,A01,083756,Briones; Jor-el Thomas Caparas,1,0,36,35
1656831906339,MATH 20B,A02,083757,Briones; Jor-el Thomas Caparas,1,0,36,35
1656831906339,MATH 20B,A03,093475,Briones; Jor-el Thomas Caparas,0,0,36,36
1656831912368,MATH 20C,A01,083760,Briones; Jor-el Thomas Caparas,1,0,35,34
1656831912368,MATH 20C,A02,083761,Briones; Jor-el Thomas Caparas,8,0,35,27
1656831912368,MATH 20C,A03,093476,Briones; Jor-el Thomas Caparas,0,1,36,36
1656831912368,MATH 20C,B01,083762,Bach; Quang Tran,0,0,30,30
1656831918393,MATH 20D,A01,083765,Tran; Brian Kha,4,0,30,26
1656831918393,MATH 20D,A02,083766,Tran; Brian Kha,4,0,30,26
1656831918393,MATH 20D,A03,083767,Tran; Brian Kha,2,0,30,28
1656831924423,MATH 20E,A01,083771,Ganguly; Soumya,5,0,32,27
1656831924423,MATH 20E,A02,083772,Ganguly; Soumya,6,0,32,26
1656831924423,MATH 20E,B01,083773,Ciotti; Benjamin,18,0,35,17
1656831924423,MATH 20E,B02,083774,Ciotti; Benjamin,17,0,35,18
1656831930468,MATH 103A,A01,083777,Greenfeld; Be'Eri,2,0,36,34
1656831930468,MATH 103A,A02,083778,Greenfeld; Be'Eri,5,0,36,31
1656831930468,MATH 103A,A03,093561,Greenfeld; Be'Eri,4,0,36,32
1656831930468,MATH 103A,B01,083779,Greenfeld; Be'Eri,6,0,36,30
1656831930468,MATH 103A,B02,083780,Greenfeld; Be'Eri,2,0,36,34
1656831930468,MATH 103A,B03,093562,Greenfeld; Be'Eri,2,0,36,34
1656831936497,MATH 105,A01,085443,Carter; Anne Toulson,13,0,35,22
1656831936497,MATH 105,A02,093477,Carter; Anne Toulson,20,0,35,15
1656831942521,MATH 109,A01,083213,Ganzberger; Geoffrey Michael,2,0,34,32
1656831942521,MATH 109,A02,083214,Ganzberger; Geoffrey Michael,2,0,34,32
1656831942521,MATH 109,A03,093478,Ganzberger; Geoffrey Michael,1,0,34,33
1656831942521,MATH 109,B01,083215,Ganzberger; Geoffrey Michael,1,0,32,31
1656831942521,MATH 109,B02,083216,Ganzberger; Geoffrey Michael,1,0,32,31
1656831942521,MATH 109,B03,093479,Ganzberger; Geoffrey Michael,6,0,32,26
1656831948547,MATH 142A,A01,083219,Chow; Bennett,6,0,32,26
1656831948547,MATH 142A,A02,083220,Chow; Bennett,9,0,32,23
1656831948547,MATH 142A,A03,093480,Chow; Bennett,7,0,32,25
1656831948547,MATH 142A,B03,093481,Chow; Bennett,7,0,32,25
1656831948547,MATH 142A,B04,093558,Chow; Bennett,10,0,32,22
1656831948547,MATH 142A,B05,093559,Chow; Bennett,6,0,32,26
1656831954570,MATH 193A,A01,083224,Rotar; Vladimir,6,0,34,28
1656831954570,MATH 193A,A02,083225,Rotar; Vladimir,3,0,34,31
1656831954570,MATH 193A,A03,083781,Rotar; Vladimir,1,0,34,33
1656831954570,MATH 193A,A04,083782,Rotar; Vladimir,6,0,34,28
1656831954570,MATH 193A,A05,093482,Rotar; Vladimir,6,0,34,28
1656831960598,MATH 197,001,091859,McAuley; Julian John,9999,0,9999,0
1656831960598,MATH 197,002,095566,Kedlaya; Kiran S.,9997,0,9999,2
1656831960598,MATH 197,003,095567,Xiao; Ming,9999,0,9999,0
1656831960598,MATH 197,004,095571,Perols; Johan Lars,9998,0,9999,1
1656831967670,COGS 9,A01,083615,Shannon; Kyle Michael,6,0,75,69
1656831973700,COGS 11,A01,083617,Boyle; Mary E. T.,18,0,48,30
1656831979723,COGS 13,A01,083071,Bastos; Amalia Pinkusfeld,8,0,71,63
1656831985747,COGS 14A,A01,092681,Semenuks; Arturs,0,1,100,100
1656831991775,COGS 14B,A01,083073,Cheng; Tzu-Han,5,0,63,58
1656831997801,COGS 17,A01,092677,Semenuks; Arturs,4,0,81,77
1656832003824,COGS 100,A01,083619,Allen; Michael Gordon,15,0,70,55
1656832009850,COGS 101A,A01,083621,Davis; Joshua Daniel,9,0,68,59
1656832015879,COGS 101B,A01,091572,Allen; Michael Gordon,8,0,65,57
1656832021906,COGS 101C,A01,083625,Delgado; Tania,17,0,35,18
1656832027932,COGS 107A,A01,083627,Boyle; Mary E. T.,13,0,60,47
1656832033954,COGS 118A,A01,083075,Gupta; Anjum,15,0,76,61
1656832039977,CSE 3,A50,083646,Miranda; Gregory Joseph,22,0,50,28
1656832046002,CSE 8A,A50,083650,Miranda; Gregory Joseph,17,1,56,39
1656832052026,CSE 11,A01,083080,Cao; Yingjun,4,15,40,36
1656832058049,CSE 12,A01,083652,Krause-Levy; Sophia Louisa,20,1,120,100
1656832064074,CSE 15L,A01,083654,Morris; Justin Loren,8,0,50,42
1656832064074,CSE 15L,A02,083655,Morris; Justin Loren,8,0,50,42
1656832070096,CSE 20,A01,083657,Tran; Khoa Dang,37,0,80,43
1656832076119,CSE 21,A01,095574,Bach; Quang Tran,21,0,48,27
1656832082164,CSE 30,A01,083084,Eldon; John,4,0,80,76
1656832082164,CSE 30,B01,095061,Bhaskar; Nishant,6,0,50,44
1656832088185,CSE 100,A01,083659,Cao; Yingjun,2,4,70,68
1656832094208,CSE 134B,A01,083661,Powell; Thomas Allan,19,0,100,81
1656832100236,CSE 140,A01,083663,Gungor; Onat,14,0,85,71
1656832106262,CSE 140L,A01,083088,Eldon; John,16,0,100,84
1656832112284,CSE 175,A01,083665,Kumar; Rakesh,3,0,25,22
1656832118308,CSE 190,A00,092507,Dubnov; Shlomo,7,0,20,13
1656832124333,ECE 45,A01,083139,Congero; Spencer William,5,0,75,70
1656832130358,ECE 65,A50,083695,Saad; Andrew S,12,0,30,18
1656832130358,ECE 65,A51,095125,Saad; Andrew S,25,0,26,1
1656832136382,ECE 109,A01,091882,Touri; Behrouz,16,0,70,54
1656832142406,ECE 180,A00,083140,Abi Samra; Nicholas Camill,0,0,30,30
1656832142406,ECE 180,B00,083141,Abi Samra; Nicholas Camill,0,0,30,30
1656832148435,MATH 10A,A01,083735,Patchell; Gregory David,1,0,30,29
1656832148435,MATH 10A,A02,083736,Patchell; Gregory David,20,0,30,10
1656832148435,MATH 10A,A03,083737,Patchell; Gregory David,15,0,30,15
1656832154465,MATH 10B,A01,083207,Lim; Seonhee,7,0,34,27
1656832154465,MATH 10B,A02,083208,Lim; Seonhee,9,0,35,26
1656832154465,MATH 10B,A03,093472,Lim; Seonhee,4,0,34,30
1656832154465,MATH 10B,B01,083739,Sinha; Shubham,9,0,30,21
1656832160489,MATH 18,A01,083743,Cinel; Cameron Alexander,6,0,30,24
1656832160489,MATH 18,A02,083744,Cinel; Cameron Alexander,15,0,30,15
1656832160489,MATH 18,A03,083745,Cinel; Cameron Alexander,8,0,30,22
1656832160489,MATH 18,B01,083748,Rideout; David Porter,3,0,37,34
1656832160489,MATH 18,B02,083749,Rideout; David Porter,3,0,36,33
1656832160489,MATH 18,B03,083750,Rideout; David Porter,2,0,37,35
1656832160489,MATH 18,B04,083751,Rideout; David Porter,5,0,36,31
1656832160489,MATH 18,B05,093473,Rideout; David Porter,4,0,36,32
1656832160489,MATH 18,B06,093474,Rideout; David Porter,5,0,36,31
1656832166519,MATH 20A,A01,083754,Zheng; Zequn,12,0,40,28
1656832172549,MATH 20B,A01,083756,Briones; Jor-el Thomas Caparas,1,0,36,35
1656832172549,MATH 20B,A02,083757,Briones; Jor-el Thomas Caparas,1,0,36,35
1656832172549,MATH 20B,A03,093475,Briones; Jor-el Thomas Caparas,0,0,36,36
1656832178572,MATH 20C,A01,083760,Briones; Jor-el Thomas Caparas,1,0,35,34
1656832178572,MATH 20C,A02,083761,Briones; Jor-el Thomas Caparas,8,0,35,27
1656832178572,MATH 20C,A03,093476,Briones; Jor-el Thomas Caparas,0,1,36,36
1656832178572,MATH 20C,B01,083762,Bach; Quang Tran,0,0,30,30
1656832184596,MATH 20D,A01,083765,Tran; Brian Kha,4,0,30,26
1656832184596,MATH 20D,A02,083766,Tran; Brian Kha,4,0,30,26
1656832184596,MATH 20D,A03,083767,Tran; Brian Kha,2,0,30,28
1656832190625,MATH 20E,A01,083771,Ganguly; Soumya,5,0,32,27
1656832190625,MATH 20E,A02,083772,Ganguly; Soumya,6,0,32,26
1656832190625,MATH 20E,B01,083773,Ciotti; Benjamin,18,0,35,17
1656832190625,MATH 20E,B02,083774,Ciotti; Benjamin,17,0,35,18
1656832196653,MATH 103A,A01,083777,Greenfeld; Be'Eri,2,0,36,34
1656832196653,MATH 103A,A02,083778,Greenfeld; Be'Eri,5,0,36,31
1656832196653,MATH 103A,A03,093561,Greenfeld; Be'Eri,4,0,36,32
1656832196653,MATH 103A,B01,083779,Greenfeld; Be'Eri,6,0,36,30
1656832196653,MATH 103A,B02,083780,Greenfeld; Be'Eri,2,0,36,34
1656832196653,MATH 103A,B03,093562,Greenfeld; Be'Eri,2,0,36,34
1656832202678,MATH 105,A01,085443,Carter; Anne Toulson,13,0,35,22
1656832202678,MATH 105,A02,093477,Carter; Anne Toulson,20,0,35,15
1656832208707,MATH 109,A01,083213,Ganzberger; Geoffrey Michael,2,0,34,32
1656832208707,MATH 109,A02,083214,Ganzberger; Geoffrey Michael,2,0,34,32
1656832208707,MATH 109,A03,093478,Ganzberger; Geoffrey Michael,1,0,34,33
1656832208707,MATH 109,B01,083215,Ganzberger; Geoffrey Michael,1,0,32,31
1656832208707,MATH 109,B02,083216,Ganzberger; Geoffrey Michael,1,0,32,31
1656832208707,MATH 109,B03,093479,Ganzberger; Geoffrey Michael,6,0,32,26
1656832214729,MATH 142A,A01,083219,Chow; Bennett,6,0,32,26
1656832214729,MATH 142A,A02,083220,Chow; Bennett,9,0,32,23
1656832214729,MATH 142A,A03,093480,Chow; Bennett,7,0,32,25
1656832214729,MATH 142A,B03,093481,Chow; Bennett,7,0,32,25
1656832214729,MATH 142A,B04,093558,Chow; Bennett,10,0,32,22
1656832214729,MATH 142A,B05,093559,Chow; Bennett,6,0,32,26
1656832220758,MATH 193A,A01,083224,Rotar; Vladimir,6,0,34,28
1656832220758,MATH 193A,A02,083225,Rotar; Vladimir,3,0,34,31
1656832220758,MATH 193A,A03,083781,Rotar; Vladimir,1,0,34,33
1656832220758,MATH 193A,A04,083782,Rotar; Vladimir,6,0,34,28
1656832220758,MATH 193A,A05,093482,Rotar; Vladimir,6,0,34,28
1656832226786,MATH 197,001,091859,McAuley; Julian John,9999,0,9999,0
1656832226786,MATH 197,002,095566,Kedlaya; Kiran S.,9997,0,9999,2
1656832226786,MATH 197,003,095567,Xiao; Ming,9999,0,9999,0
1656832226786,MATH 197,004,095571,Perols; Johan Lars,9998,0,9999,1
1656832233928,COGS 9,A01,083615,Shannon; Kyle Michael,6,0,75,69
1656832239957,COGS 11,A01,083617,Boyle; Mary E. T.,18,0,48,30
1656832245991,COGS 13,A01,083071,Bastos; Amalia Pinkusfeld,8,0,71,63
1656832252019,COGS 14A,A01,092681,Semenuks; Arturs,0,1,100,100
1656832258045,COGS 14B,A01,083073,Cheng; Tzu-Han,5,0,63,58
1656832264069,COGS 17,A01,092677,Semenuks; Arturs,4,0,81,77
1656832270094,COGS 100,A01,083619,Allen; Michael Gordon,15,0,70,55
1656832276122,COGS 101A,A01,083621,Davis; Joshua Daniel,9,0,68,59
1656832282150,COGS 101B,A01,091572,Allen; Michael Gordon,8,0,65,57
1656832288181,COGS 101C,A01,083625,Delgado; Tania,17,0,35,18
1656832294210,COGS 107A,A01,083627,Boyle; Mary E. T.,13,0,60,47
1656832300241,COGS 118A,A01,083075,Gupta; Anjum,15,0,76,61
1656832306265,CSE 3,A50,083646,Miranda; Gregory Joseph,22,0,50,28
1656832312287,CSE 8A,A50,083650,Miranda; Gregory Joseph,17,1,56,39
1656832318323,CSE 11,A01,083080,Cao; Yingjun,4,15,40,36
1656832324347,CSE 12,A01,083652,Krause-Levy; Sophia Louisa,20,1,120,100
1656832330383,CSE 15L,A01,083654,Morris; Justin Loren,8,0,50,42
1656832330383,CSE 15L,A02,083655,Morris; Justin Loren,8,0,50,42
1656832336410,CSE 20,A01,083657,Tran; Khoa Dang,37,0,80,43
1656832342439,CSE 21,A01,095574,Bach; Quang Tran,21,0,48,27
1656832348479,CSE 30,A01,083084,Eldon; John,4,0,80,76
1656832348479,CSE 30,B01,095061,Bhaskar; Nishant,6,0,50,44
1656832354507,CSE 100,A01,083659,Cao; Yingjun,2,4,70,68
1656832360556,CSE 134B,A01,083661,Powell; Thomas Allan,19,0,100,81
1656832366584,CSE 140,A01,083663,Gungor; Onat,14,0,85,71
1656832372606,CSE 140L,A01,083088,Eldon; John,16,0,100,84
1656832378629,CSE 175,A01,083665,Kumar; Rakesh,3,0,25,22
1656832384654,CSE 190,A00,092507,Dubnov; Shlomo,7,0,20,13
1656832390676,ECE 45,A01,083139,Congero; Spencer William,5,0,75,70
1656832396709,ECE 65,A50,083695,Saad; Andrew S,12,0,30,18
1656832396709,ECE 65,A51,095125,Saad; Andrew S,25,0,26,1
1656832402731,ECE 109,A01,091882,Touri; Behrouz,16,0,70,54
1656832408766,ECE 180,A00,083140,Abi Samra; Nicholas Camill,0,0,30,30
1656832408766,ECE 180,B00,083141,Abi Samra; Nicholas Camill,0,0,30,30
1656832414803,MATH 10A,A01,083735,Patchell; Gregory David,1,0,30,29
1656832414803,MATH 10A,A02,083736,Patchell; Gregory David,20,0,30,10
1656832414803,MATH 10A,A03,083737,Patchell; Gregory David,15,0,30,15
1656832420828,MATH 10B,A01,083207,Lim; Seonhee,7,0,34,27
1656832420828,MATH 10B,A02,083208,Lim; Seonhee,9,0,35,26
1656832420828,MATH 10B,A03,093472,Lim; Seonhee,4,0,34,30
1656832420828,MATH 10B,B01,083739,Sinha; Shubham,9,0,30,21
1656832426870,MATH 18,A01,083743,Cinel; Cameron Alexander,6,0,30,24
1656832426870,MATH 18,A02,083744,Cinel; Cameron Alexander,15,0,30,15
1656832426870,MATH 18,A03,083745,Cinel; Cameron Alexander,8,0,30,22
1656832426870,MATH 18,B01,083748,Rideout; David Porter,3,0,37,34
1656832426870,MATH 18,B02,083749,Rideout; David Porter,3,0,36,33
1656832426870,MATH 18,B03,083750,Rideout; David Porter,2,0,37,35
1656832426870,MATH 18,B04,083751,Rideout; David Porter,5,0,36,31
1656832426870,MATH 18,B05,093473,Rideout; David Porter,4,0,36,32
1656832426870,MATH 18,B06,093474,Rideout; David Porter,5,0,36,31
1656832432895,MATH 20A,A01,083754,Zheng; Zequn,12,0,40,28
1656832438917,MATH 20B,A01,083756,Briones; Jor-el Thomas Caparas,1,0,36,35
1656832438917,MATH 20B,A02,083757,Briones; Jor-el Thomas Caparas,1,0,36,35
1656832438917,MATH 20B,A03,093475,Briones; Jor-el Thomas Caparas,0,0,36,36
1656832444951,MATH 20C,A01,083760,Briones; Jor-el Thomas Caparas,1,0,35,34
1656832444951,MATH 20C,A02,083761,Briones; Jor-el Thomas Caparas,8,0,35,27
1656832444951,MATH 20C,A03,093476,Briones; Jor-el Thomas Caparas,0,1,36,36
1656832444951,MATH 20C,B01,083762,Bach; Quang Tran,0,0,30,30
1656832450977,MATH 20D,A01,083765,Tran; Brian Kha,4,0,30,26
1656832450977,MATH 20D,A02,083766,Tran; Brian Kha,4,0,30,26
1656832450977,MATH 20D,A03,083767,Tran; Brian Kha,2,0,30,28
1656832457002,MATH 20E,A01,083771,Ganguly; Soumya,5,0,32,27
1656832457002,MATH 20E,A02,083772,Ganguly; Soumya,6,0,32,26
1656832457002,MATH 20E,B01,083773,Ciotti; Benjamin,18,0,35,17
1656832457002,MATH 20E,B02,083774,Ciotti; Benjamin,17,0,35,18
1656832463028,MATH 103A,A01,083777,Greenfeld; Be'Eri,2,0,36,34
1656832463028,MATH 103A,A02,083778,Greenfeld; Be'Eri,5,0,36,31
1656832463028,MATH 103A,A03,093561,Greenfeld; Be'Eri,4,0,36,32
1656832463028,MATH 103A,B01,083779,Greenfeld; Be'Eri,6,0,36,30
1656832463028,MATH 103A,B02,083780,Greenfeld; Be'Eri,2,0,36,34
1656832463028,MATH 103A,B03,093562,Greenfeld; Be'Eri,2,0,36,34
1656832469063,MATH 105,A01,085443,Carter; Anne Toulson,13,0,35,22
1656832469063,MATH 105,A02,093477,Carter; Anne Toulson,20,0,35,15
1656832475088,MATH 109,A01,083213,Ganzberger; Geoffrey Michael,2,0,34,32
1656832475088,MATH 109,A02,083214,Ganzberger; Geoffrey Michael,2,0,34,32
1656832475088,MATH 109,A03,093478,Ganzberger; Geoffrey Michael,1,0,34,33
1656832475088,MATH 109,B01,083215,Ganzberger; Geoffrey Michael,1,0,32,31
1656832475088,MATH 109,B02,083216,Ganzberger; Geoffrey Michael,1,0,32,31
1656832475088,MATH 109,B03,093479,Ganzberger; Geoffrey Michael,6,0,32,26
1656832481121,MATH 142A,A01,083219,Chow; Bennett,6,0,32,26
1656832481121,MATH 142A,A02,083220,Chow; Bennett,9,0,32,23
1656832481121,MATH 142A,A03,093480,Chow; Bennett,7,0,32,25
1656832481121,MATH 142A,B03,093481,Chow; Bennett,7,0,32,25
1656832481121,MATH 142A,B04,093558,Chow; Bennett,10,0,32,22
1656832481121,MATH 142A,B05,093559,Chow; Bennett,6,0,32,26
1656832487153,MATH 193A,A01,083224,Rotar; Vladimir,6,0,34,28
1656832487153,MATH 193A,A02,083225,Rotar; Vladimir,3,0,34,31
1656832487153,MATH 193A,A03,083781,Rotar; Vladimir,1,0,34,33
1656832487153,MATH 193A,A04,083782,Rotar; Vladimir,6,0,34,28
1656832487153,MATH 193A,A05,093482,Rotar; Vladimir,6,0,34,28
1656832493176,MATH 197,001,091859,McAuley; Julian John,9999,0,9999,0
1656832493176,MATH 197,002,095566,Kedlaya; Kiran S.,9997,0,9999,2
1656832493176,MATH 197,003,095567,Xiao; Ming,9999,0,9999,0
1656832493176,MATH 197,004,095571,Perols; Johan Lars,9998,0,9999,1
1656832500246,COGS 9,A01,083615,Shannon; Kyle Michael,6,0,75,69
1656832506274,COGS 11,A01,083617,Boyle; Mary E. T.,18,0,48,30
1656832512298,COGS 13,A01,083071,Bastos; Amalia Pinkusfeld,8,0,71,63
1656832518323,COGS 14A,A01,092681,Semenuks; Arturs,0,1,100,100
1656832524346,COGS 14B,A01,083073,Cheng; Tzu-Han,5,0,63,58
1656832530382,COGS 17,A01,092677,Semenuks; Arturs,4,0,81,77
1656832536406,COGS 100,A01,083619,Allen; Michael Gordon,15,0,70,55
1656832542434,COGS 101A,A01,083621,Davis; Joshua Daniel,9,0,68,59
1656832548458,COGS 101B,A01,091572,Allen; Michael Gordon,8,0,65,57
1656832554493,COGS 101C,A01,083625,Delgado; Tania,17,0,35,18
1656832560517,COGS 107A,A01,083627,Boyle; Mary E. T.,13,0,60,47
1656832566548,COGS 118A,A01,083075,Gupta; Anjum,15,0,76,61
1656832572577,CSE 3,A50,083646,Miranda; Gregory Joseph,22,0,50,28
1656832578602,CSE 8A,A50,083650,Miranda; Gregory Joseph,17,1,56,39
1656832584627,CSE 11,A01,083080,Cao; Yingjun,4,15,40,36
1656832590659,CSE 12,A01,083652,Krause-Levy; Sophia Louisa,20,1,120,100
1656832596685,CSE 15L,A01,083654,Morris; Justin Loren,8,0,50,42
1656832596685,CSE 15L,A02,083655,Morris; Justin Loren,8,0,50,42
1656832602726,CSE 20,A01,083657,Tran; Khoa Dang,37,0,80,43
1656832608767,CSE 21,A01,095574,Bach; Quang Tran,21,0,48,27
1656832614812,CSE 30,A01,083084,Eldon; John,4,0,80,76
1656832614812,CSE 30,B01,095061,Bhaskar; Nishant,6,0,50,44
1656832620844,CSE 100,A01,083659,Cao; Yingjun,2,4,70,68
1656832626874,CSE 134B,A01,083661,Powell; Thomas Allan,19,0,100,81
1656832632899,CSE 140,A01,083663,Gungor; Onat,14,0,85,71
1656832638923,CSE 140L,A01,083088,Eldon; John,16,0,100,84
1656832644987,CSE 175,A01,083665,Kumar; Rakesh,3,0,25,22
1656832651016,CSE 190,A00,092507,Dubnov; Shlomo,7,0,20,13
1656832657046,ECE 45,A01,083139,Congero; Spencer William,5,0,75,70
1656832663072,ECE 65,A50,083695,Saad; Andrew S,12,0,30,18
1656832663072,ECE 65,A51,095125,Saad; Andrew S,25,0,26,1
1656832669101,ECE 109,A01,091882,Touri; Behrouz,16,0,70,54
1656832675131,ECE 180,A00,083140,Abi Samra; Nicholas Camill,0,0,30,30
1656832675131,ECE 180,B00,083141,Abi Samra; Nicholas Camill,0,0,30,30
1656832681159,MATH 10A,A01,083735,Patchell; Gregory David,1,0,30,29
1656832681159,MATH 10A,A02,083736,Patchell; Gregory David,20,0,30,10
1656832681159,MATH 10A,A03,083737,Patchell; Gregory David,15,0,30,15
1656832687189,MATH 10B,A01,083207,Lim; Seonhee,7,0,34,27
1656832687189,MATH 10B,A02,083208,Lim; Seonhee,9,0,35,26
1656832687189,MATH 10B,A03,093472,Lim; Seonhee,4,0,34,30
1656832687189,MATH 10B,B01,083739,Sinha; Shubham,9,0,30,21
1656832693215,MATH 18,A01,083743,Cinel; Cameron Alexander,6,0,30,24
1656832693215,MATH 18,A02,083744,Cinel; Cameron Alexander,15,0,30,15
1656832693215,MATH 18,A03,083745,Cinel; Cameron Alexander,8,0,30,22
1656832693215,MATH 18,B01,083748,Rideout; David Porter,3,0,37,34
1656832693215,MATH 18,B02,083749,Rideout; David Porter,3,0,36,33
1656832693215,MATH 18,B03,083750,Rideout; David Porter,2,0,37,35
1656832693215,MATH 18,B04,083751,Rideout; David Porter,5,0,36,31
1656832693215,MATH 18,B05,093473,Rideout; David Porter,4,0,36,32
1656832693215,MATH 18,B06,093474,Rideout; David Porter,5,0,36,31
1656832699243,MATH 20A,A01,083754,Zheng; Zequn,12,0,40,28
1656832705268,MATH 20B,A01,083756,Briones; Jor-el Thomas Caparas,1,0,36,35
1656832705268,MATH 20B,A02,083757,Briones; Jor-el Thomas Caparas,1,0,36,35
1656832705268,MATH 20B,A03,093475,Briones; Jor-el Thomas Caparas,0,0,36,36
1656832711291,MATH 20C,A01,083760,Briones; Jor-el Thomas Caparas,1,0,35,34
1656832711291,MATH 20C,A02,083761,Briones; Jor-el Thomas Caparas,8,0,35,27
1656832711291,MATH 20C,A03,093476,Briones; Jor-el Thomas Caparas,0,1,36,36
1656832711291,MATH 20C,B01,083762,Bach; Quang Tran,0,0,30,30
1656832717316,MATH 20D,A01,083765,Tran; Brian Kha,4,0,30,26
1656832717316,MATH 20D,A02,083766,Tran; Brian Kha,4,0,30,26
1656832717316,MATH 20D,A03,083767,Tran; Brian Kha,2,0,30,28
1656832723343,MATH 20E,A01,083771,Ganguly; Soumya,5,0,32,27
1656832723343,MATH 20E,A02,083772,Ganguly; Soumya,6,0,32,26
1656832723343,MATH 20E,B01,083773,Ciotti; Benjamin,18,0,35,17
1656832723343,MATH 20E,B02,083774,Ciotti; Benjamin,17,0,35,18
1656832729367,MATH 103A,A01,083777,Greenfeld; Be'Eri,2,0,36,34
1656832729367,MATH 103A,A02,083778,Greenfeld; Be'Eri,5,0,36,31
1656832729367,MATH 103A,A03,093561,Greenfeld; Be'Eri,4,0,36,32
1656832729367,MATH 103A,B01,083779,Greenfeld; Be'Eri,6,0,36,30
1656832729367,MATH 103A,B02,083780,Greenfeld; Be'Eri,2,0,36,34
1656832729367,MATH 103A,B03,093562,Greenfeld; Be'Eri,2,0,36,34
1656832735391,MATH 105,A01,085443,Carter; Anne Toulson,13,0,35,22
1656832735391,MATH 105,A02,093477,Carter; Anne Toulson,20,0,35,15
1656832741414,MATH 109,A01,083213,Ganzberger; Geoffrey Michael,2,0,34,32
1656832741414,MATH 109,A02,083214,Ganzberger; Geoffrey Michael,2,0,34,32
1656832741414,MATH 109,A03,093478,Ganzberger; Geoffrey Michael,1,0,34,33
1656832741414,MATH 109,B01,083215,Ganzberger; Geoffrey Michael,1,0,32,31
1656832741414,MATH 109,B02,083216,Ganzberger; Geoffrey Michael,1,0,32,31
1656832741414,MATH 109,B03,093479,Ganzberger; Geoffrey Michael,6,0,32,26
1656832747443,MATH 142A,A01,083219,Chow; Bennett,6,0,32,26
1656832747443,MATH 142A,A02,083220,Chow; Bennett,9,0,32,23
1656832747443,MATH 142A,A03,093480,Chow; Bennett,7,0,32,25
1656832747443,MATH 142A,B03,093481,Chow; Bennett,7,0,32,25
1656832747443,MATH 142A,B04,093558,Chow; Bennett,10,0,32,22
1656832747443,MATH 142A,B05,093559,Chow; Bennett,6,0,32,26
1656832753472,MATH 193A,A01,083224,Rotar; Vladimir,6,0,34,28
1656832753472,MATH 193A,A02,083225,Rotar; Vladimir,3,0,34,31
1656832753472,MATH 193A,A03,083781,Rotar; Vladimir,1,0,34,33
1656832753472,MATH 193A,A04,083782,Rotar; Vladimir,6,0,34,28
1656832753472,MATH 193A,A05,093482,Rotar; Vladimir,6,0,34,28
1656832759496,MATH 197,001,091859,McAuley; Julian John,9999,0,9999,0
1656832759496,MATH 197,002,095566,Kedlaya; Kiran S.,9997,0,9999,2
1656832759496,MATH 197,003,095567,Xiao; Ming,9999,0,9999,0
1656832759496,MATH 197,004,095571,Perols; Johan Lars,9998,0,9999,1
1656832766561,COGS 9,A01,083615,Shannon; Kyle Michael,6,0,75,69
1656832772584,COGS 11,A01,083617,Boyle; Mary E. T.,18,0,48,30
1656832778610,COGS 13,A01,083071,Bastos; Amalia Pinkusfeld,8,0,71,63
1656832784638,COGS 14A,A01,092681,Semenuks; Arturs,0,1,100,100
1656832790665,COGS 14B,A01,083073,Cheng; Tzu-Han,5,0,63,58
1656832796689,COGS 17,A01,092677,Semenuks; Arturs,4,0,81,77
1656832802713,COGS 100,A01,083619,Allen; Michael Gordon,15,0,70,55
1656832808735,COGS 101A,A01,083621,Davis; Joshua Daniel,9,0,68,59
1656832814762,COGS 101B,A01,091572,Allen; Michael Gordon,8,0,65,57
1656832820790,COGS 101C,A01,083625,Delgado; Tania,17,0,35,18
1656832826812,COGS 107A,A01,083627,Boyle; Mary E. T.,13,0,60,47
1656832832905,COGS 118A,A01,083075,Gupta; Anjum,15,0,76,61
1656832838927,CSE 3,A50,083646,Miranda; Gregory Joseph,22,0,50,28
1656832844951,CSE 8A,A50,083650,Miranda; Gregory Joseph,17,1,56,39
1656832850974,CSE 11,A01,083080,Cao; Yingjun,4,15,40,36
1656832857000,CSE 12,A01,083652,Krause-Levy; Sophia Louisa,20,1,120,100
1656832863023,CSE 15L,A01,083654,Morris; Justin Loren,8,0,50,42
1656832863023,CSE 15L,A02,083655,Morris; Justin Loren,8,0,50,42
1656832869047,CSE 20,A01,083657,Tran; Khoa Dang,37,0,80,43
1656832875070,CSE 21,A01,095574,Bach; Quang Tran,21,0,48,27
1656832881094,CSE 30,A01,083084,Eldon; John,4,0,80,76
1656832881094,CSE 30,B01,095061,Bhaskar; Nishant,6,0,50,44
1656832887129,CSE 100,A01,083659,Cao; Yingjun,2,4,70,68
1656832893153,CSE 134B,A01,083661,Powell; Thomas Allan,19,0,100,81
1656832899180,CSE 140,A01,083663,Gungor; Onat,14,0,85,71
1656832905206,CSE 140L,A01,083088,Eldon; John,16,0,100,84
1656832911234,CSE 175,A01,083665,Kumar; Rakesh,3,0,25,22
1656832917259,CSE 190,A00,092507,Dubnov; Shlomo,7,0,20,13
1656832923283,ECE 45,A01,083139,Congero; Spencer William,5,0,75,70
1656832929307,ECE 65,A50,083695,Saad; Andrew S,12,0,30,18
1656832929307,ECE 65,A51,095125,Saad; Andrew S,25,0,26,1
1656832935334,ECE 109,A01,091882,Touri; Behrouz,16,0,70,54
1656832941357,ECE 180,A00,083140,Abi Samra; Nicholas Camill,0,0,30,30
1656832941357,ECE 180,B00,083141,Abi Samra; Nicholas Camill,0,0,30,30
1656832947390,MATH 10A,A01,083735,Patchell; Gregory David,1,0,30,29
1656832947390,MATH 10A,A02,083736,Patchell; Gregory David,20,0,30,10
1656832947390,MATH 10A,A03,083737,Patchell; Gregory David,15,0,30,15
1656832953415,MATH 10B,A01,083207,Lim; Seonhee,7,0,34,27
1656832953415,MATH 10B,A02,083208,Lim; Seonhee,9,0,35,26
1656832953415,MATH 10B,A03,093472,Lim; Seonhee,4,0,34,30
1656832953415,MATH 10B,B01,083739,Sinha; Shubham,9,0,30,21
1656832959440,MATH 18,A01,083743,Cinel; Cameron Alexander,6,0,30,24
1656832959440,MATH 18,A02,083744,Cinel; Cameron Alexander,15,0,30,15
1656832959440,MATH 18,A03,083745,Cinel; Cameron Alexander,8,0,30,22
1656832959440,MATH 18,B01,083748,Rideout; David Porter,3,0,37,34
1656832959440,MATH 18,B02,083749,Rideout; David Porter,3,0,36,33
1656832959440,MATH 18,B03,083750,Rideout; David Porter,2,0,37,35
1656832959440,MATH 18,B04,083751,Rideout; David Porter,5,0,36,31
1656832959440,MATH 18,B05,093473,Rideout; David Porter,4,0,36,32
1656832959440,MATH 18,B06,093474,Rideout; David Porter,5,0,36,31
1656832965469,MATH 20A,A01,083754,Zheng; Zequn,12,0,40,28
1656832971492,MATH 20B,A01,083756,Briones; Jor-el Thomas Caparas,1,0,36,35
1656832971492,MATH 20B,A02,083757,Briones; Jor-el Thomas Caparas,1,0,36,35
1656832971492,MATH 20B,A03,093475,Briones; Jor-el Thomas Caparas,0,0,36,36
1656832977517,MATH 20C,A01,083760,Briones; Jor-el Thomas Caparas,1,0,35,34
1656832977517,MATH 20C,A02,083761,Briones; Jor-el Thomas Caparas,8,0,35,27
1656832977517,MATH 20C,A03,093476,Briones; Jor-el Thomas Caparas,0,1,36,36
1656832977517,MATH 20C,B01,083762,Bach; Quang Tran,0,0,30,30
1656832983545,MATH 20D,A01,083765,Tran; Brian Kha,4,0,30,26
1656832983545,MATH 20D,A02,083766,Tran; Brian Kha,4,0,30,26
1656832983545,MATH 20D,A03,083767,Tran; Brian Kha,2,0,30,28
1656832989570,MATH 20E,A01,083771,Ganguly; Soumya,5,0,32,27
1656832989570,MATH 20E,A02,083772,Ganguly; Soumya,6,0,32,26
1656832989570,MATH 20E,B01,083773,Ciotti; Benjamin,18,0,35,17
1656832989570,MATH 20E,B02,083774,Ciotti; Benjamin,17,0,35,18
1656832995594,MATH 103A,A01,083777,Greenfeld; Be'Eri,2,0,36,34
1656832995594,MATH 103A,A02,083778,Greenfeld; Be'Eri,5,0,36,31
1656832995594,MATH 103A,A03,093561,Greenfeld; Be'Eri,4,0,36,32
1656832995594,MATH 103A,B01,083779,Greenfeld; Be'Eri,6,0,36,30
1656832995594,MATH 103A,B02,083780,Greenfeld; Be'Eri,2,0,36,34
1656832995594,MATH 103A,B03,093562,Greenfeld; Be'Eri,2,0,36,34
1656833001618,MATH 105,A01,085443,Carter; Anne Toulson,13,0,35,22
1656833001618,MATH 105,A02,093477,Carter; Anne Toulson,20,0,35,15
1656833007641,MATH 109,A01,083213,Ganzberger; Geoffrey Michael,2,0,34,32
1656833007641,MATH 109,A02,083214,Ganzberger; Geoffrey Michael,2,0,34,32
1656833007641,MATH 109,A03,093478,Ganzberger; Geoffrey Michael,1,0,34,33
1656833007641,MATH 109,B01,083215,Ganzberger; Geoffrey Michael,1,0,32,31
1656833007641,MATH 109,B02,083216,Ganzberger; Geoffrey Michael,1,0,32,31
1656833007641,MATH 109,B03,093479,Ganzberger; Geoffrey Michael,6,0,32,26
1656833013666,MATH 142A,A01,083219,Chow; Bennett,6,0,32,26
1656833013666,MATH 142A,A02,083220,Chow; Bennett,9,0,32,23
1656833013666,MATH 142A,A03,093480,Chow; Bennett,7,0,32,25
1656833013666,MATH 142A,B03,093481,Chow; Bennett,7,0,32,25
1656833013666,MATH 142A,B04,093558,Chow; Bennett,10,0,32,22
1656833013666,MATH 142A,B05,093559,Chow; Bennett,6,0,32,26
1656833019697,MATH 193A,A01,083224,Rotar; Vladimir,6,0,34,28
1656833019697,MATH 193A,A02,083225,Rotar; Vladimir,3,0,34,31
1656833019697,MATH 193A,A03,083781,Rotar; Vladimir,1,0,34,33
1656833019697,MATH 193A,A04,083782,Rotar; Vladimir,6,0,34,28
1656833019697,MATH 193A,A05,093482,Rotar; Vladimir,6,0,34,28
1656833025724,MATH 197,001,091859,McAuley; Julian John,9999,0,9999,0
1656833025724,MATH 197,002,095566,Kedlaya; Kiran S.,9997,0,9999,2
1656833025724,MATH 197,003,095567,Xiao; Ming,9999,0,9999,0
1656833025724,MATH 197,004,095571,Perols; Johan Lars,9998,0,9999,1
1656833032793,COGS 9,A01,083615,Shannon; Kyle Michael,6,0,75,69
1656833038817,COGS 11,A01,083617,Boyle; Mary E. T.,18,0,48,30
1656833044852,COGS 13,A01,083071,Bastos; Amalia Pinkusfeld,8,0,71,63
1656833050876,COGS 14A,A01,092681,Semenuks; Arturs,0,1,100,100
1656833056899,COGS 14B,A01,083073,Cheng; Tzu-Han,5,0,63,58
1656833062928,COGS 17,A01,092677,Semenuks; Arturs,4,0,81,77
1656833068950,COGS 100,A01,083619,Allen; Michael Gordon,15,0,70,55
1656833074977,COGS 101A,A01,083621,Davis; Joshua Daniel,9,0,68,59
1656833081010,COGS 101B,A01,091572,Allen; Michael Gordon,8,0,65,57
1656833087039,COGS 101C,A01,083625,Delgado; Tania,17,0,35,18
1656833093067,COGS 107A,A01,083627,Boyle; Mary E. T.,13,0,60,47
1656833099093,COGS 118A,A01,083075,Gupta; Anjum,15,0,76,61
1656833105119,CSE 3,A50,083646,Miranda; Gregory Joseph,22,0,50,28
1656833111142,CSE 8A,A50,083650,Miranda; Gregory Joseph,17,1,56,39
1656833117168,CSE 11,A01,083080,Cao; Yingjun,4,15,40,36
1656833123195,CSE 12,A01,083652,Krause-Levy; Sophia Louisa,20,1,120,100
1656833129221,CSE 15L,A01,083654,Morris; Justin Loren,8,0,50,42
1656833129221,CSE 15L,A02,083655,Morris; Justin Loren,8,0,50,42
1656833135247,CSE 20,A01,083657,Tran; Khoa Dang,37,0,80,43
1656833141279,CSE 21,A01,095574,Bach; Quang Tran,21,0,48,27
1656833147309,CSE 30,A01,083084,Eldon; John,4,0,80,76
1656833147309,CSE 30,B01,095061,Bhaskar; Nishant,6,0,50,44
1656833153335,CSE 100,A01,083659,Cao; Yingjun,2,4,70,68
1656833159364,CSE 134B,A01,083661,Powell; Thomas Allan,19,0,100,81
1656833165388,CSE 140,A01,083663,Gungor; Onat,14,0,85,71
1656833171414,CSE 140L,A01,083088,Eldon; John,16,0,100,84
1656833177439,CSE 175,A01,083665,Kumar; Rakesh,3,0,25,22
1656833183466,CSE 190,A00,092507,Dubnov; Shlomo,7,0,20,13
1656833189497,ECE 45,A01,083139,Congero; Spencer William,5,0,75,70
1656833195525,ECE 65,A50,083695,Saad; Andrew S,12,0,30,18
1656833195525,ECE 65,A51,095125,Saad; Andrew S,25,0,26,1
1656833201551,ECE 109,A01,091882,Touri; Behrouz,16,0,70,54
1656833207576,ECE 180,A00,083140,Abi Samra; Nicholas Camill,0,0,30,30
1656833207576,ECE 180,B00,083141,Abi Samra; Nicholas Camill,0,0,30,30
1656833213609,MATH 10A,A01,083735,Patchell; Gregory David,1,0,30,29
1656833213609,MATH 10A,A02,083736,Patchell; Gregory David,20,0,30,10
1656833213609,MATH 10A,A03,083737,Patchell; Gregory David,15,0,30,15
1656833219633,MATH 10B,A01,083207,Lim; Seonhee,7,0,34,27
1656833219633,MATH 10B,A02,083208,Lim; Seonhee,9,0,35,26
1656833219633,MATH 10B,A03,093472,Lim; Seonhee,4,0,34,30
1656833219633,MATH 10B,B01,083739,Sinha; Shubham,9,0,30,21
1656833225667,MATH 18,A01,083743,Cinel; Cameron Alexander,6,0,30,24
1656833225667,MATH 18,A02,083744,Cinel; Cameron Alexander,15,0,30,15
1656833225667,MATH 18,A03,083745,Cinel; Cameron Alexander,8,0,30,22
1656833225667,MATH 18,B01,083748,Rideout; David Porter,3,0,37,34
1656833225667,MATH 18,B02,083749,Rideout; David Porter,3,0,36,33
1656833225667,MATH 18,B03,083750,Rideout; David Porter,2,0,37,35
1656833225667,MATH 18,B04,083751,Rideout; David Porter,5,0,36,31
1656833225667,MATH 18,B05,093473,Rideout; David Porter,4,0,36,32
1656833225667,MATH 18,B06,093474,Rideout; David Porter,5,0,36,31
1656833231690,MATH 20A,A01,083754,Zheng; Zequn,12,0,40,28
1656833237713,MATH 20B,A01,083756,Briones; Jor-el Thomas Caparas,1,0,36,35
1656833237713,MATH 20B,A02,083757,Briones; Jor-el Thomas Caparas,1,0,36,35
1656833237713,MATH 20B,A03,093475,Briones; Jor-el Thomas Caparas,0,0,36,36
1656833243744,MATH 20C,A01,083760,Briones; Jor-el Thomas Caparas,1,0,35,34
1656833243744,MATH 20C,A02,083761,Briones; Jor-el Thomas Caparas,8,0,35,27
1656833243744,MATH 20C,A03,093476,Briones; Jor-el Thomas Caparas,0,1,36,36
1656833243744,MATH 20C,B01,083762,Bach; Quang Tran,0,0,30,30
1656833249775,MATH 20D,A01,083765,Tran; Brian Kha,4,0,30,26
1656833249775,MATH 20D,A02,083766,Tran; Brian Kha,4,0,30,26
1656833249775,MATH 20D,A03,083767,Tran; Brian Kha,2,0,30,28
1656833255799,MATH 20E,A01,083771,Ganguly; Soumya,5,0,32,27
1656833255799,MATH 20E,A02,083772,Ganguly; Soumya,6,0,32,26
1656833255799,MATH 20E,B01,083773,Ciotti; Benjamin,18,0,35,17
1656833255799,MATH 20E,B02,083774,Ciotti; Benjamin,17,0,35,18
1656833261830,MATH 103A,A01,083777,Greenfeld; Be'Eri,2,0,36,34
1656833261830,MATH 103A,A02,083778,Greenfeld; Be'Eri,5,0,36,31
1656833261830,MATH 103A,A03,093561,Greenfeld; Be'Eri,4,0,36,32
1656833261830,MATH 103A,B01,083779,Greenfeld; Be'Eri,6,0,36,30
1656833261830,MATH 103A,B02,083780,Greenfeld; Be'Eri,2,0,36,34
1656833261830,MATH 103A,B03,093562,Greenfeld; Be'Eri,2,0,36,34
1656833267854,MATH 105,A01,085443,Carter; Anne Toulson,13,0,35,22
1656833267854,MATH 105,A02,093477,Carter; Anne Toulson,20,0,35,15
1656833273883,MATH 109,A01,083213,Ganzberger; Geoffrey Michael,2,0,34,32
1656833273883,MATH 109,A02,083214,Ganzberger; Geoffrey Michael,2,0,34,32
1656833273883,MATH 109,A03,093478,Ganzberger; Geoffrey Michael,1,0,34,33
1656833273883,MATH 109,B01,083215,Ganzberger; Geoffrey Michael,1,0,32,31
1656833273883,MATH 109,B02,083216,Ganzberger; Geoffrey Michael,1,0,32,31
1656833273883,MATH 109,B03,093479,Ganzberger; Geoffrey Michael,6,0,32,26
1656833279909,MATH 142A,A01,083219,Chow; Bennett,6,0,32,26
1656833279909,MATH 142A,A02,083220,Chow; Bennett,9,0,32,23
1656833279909,MATH 142A,A03,093480,Chow; Bennett,7,0,32,25
1656833279909,MATH 142A,B03,093481,Chow; Bennett,7,0,32,25
1656833279909,MATH 142A,B04,093558,Chow; Bennett,10,0,32,22
1656833279909,MATH 142A,B05,093559,Chow; Bennett,6,0,32,26
1656833285941,MATH 193A,A01,083224,Rotar; Vladimir,6,0,34,28
1656833285941,MATH 193A,A02,083225,Rotar; Vladimir,3,0,34,31
1656833285941,MATH 193A,A03,083781,Rotar; Vladimir,1,0,34,33
1656833285941,MATH 193A,A04,083782,Rotar; Vladimir,6,0,34,28
1656833285941,MATH 193A,A05,093482,Rotar; Vladimir,6,0,34,28
1656833291968,MATH 197,001,091859,McAuley; Julian John,9999,0,9999,0
1656833291968,MATH 197,002,095566,Kedlaya; Kiran S.,9997,0,9999,2
1656833291968,MATH 197,003,095567,Xiao; Ming,9999,0,9999,0
1656833291968,MATH 197,004,095571,Perols; Johan Lars,9998,0,9999,1
1656833299023,COGS 9,A01,083615,Shannon; Kyle Michael,6,0,75,69
1656833305058,COGS 11,A01,083617,Boyle; Mary E. T.,18,0,48,30
1656833311089,COGS 13,A01,083071,Bastos; Amalia Pinkusfeld,8,0,71,63
1656833317113,COGS 14A,A01,092681,Semenuks; Arturs,0,1,100,100
1656833323135,COGS 14B,A01,083073,Cheng; Tzu-Han,5,0,63,58
1656833329162,COGS 17,A01,092677,Semenuks; Arturs,4,0,81,77
1656833335185,COGS 100,A01,083619,Allen; Michael Gordon,15,0,70,55
1656833341211,COGS 101A,A01,083621,Davis; Joshua Daniel,9,0,68,59
1656833347248,COGS 101B,A01,091572,Allen; Michael Gordon,8,0,65,57
1656833353271,COGS 101C,A01,083625,Delgado; Tania,17,0,35,18
1656833359300,COGS 107A,A01,083627,Boyle; Mary E. T.,13,0,60,47
1656833365325,COGS 118A,A01,083075,Gupta; Anjum,15,0,76,61
1656833371355,CSE 3,A50,083646,Miranda; Gregory Joseph,22,0,50,28
1656833377384,CSE 8A,A50,083650,Miranda; Gregory Joseph,17,1,56,39
1656833383409,CSE 11,A01,083080,Cao; Yingjun,4,15,40,36
1656833389438,CSE 12,A01,083652,Krause-Levy; Sophia Louisa,20,1,120,100
1656833395465,CSE 15L,A01,083654,Morris; Justin Loren,8,0,50,42
1656833395465,CSE 15L,A02,083655,Morris; Justin Loren,8,0,50,42
1656833401489,CSE 20,A01,083657,Tran; Khoa Dang,37,0,80,43
1656833407516,CSE 21,A01,095574,Bach; Quang Tran,21,0,48,27
1656833413544,CSE 30,A01,083084,Eldon; John,4,0,80,76
1656833413544,CSE 30,B01,095061,Bhaskar; Nishant,6,0,50,44
1656833419569,CSE 100,A01,083659,Cao; Yingjun,2,4,70,68
1656833425590,CSE 134B,A01,083661,Powell; Thomas Allan,19,0,100,81
1656833431710,CSE 140,A01,083663,Gungor; Onat,14,0,85,71
1656833437731,CSE 140L,A01,083088,Eldon; John,16,0,100,84
1656833443758,CSE 175,A01,083665,Kumar; Rakesh,3,0,25,22
1656833449784,CSE 190,A00,092507,Dubnov; Shlomo,7,0,20,13
1656833455822,ECE 45,A01,083139,Congero; Spencer William,5,0,75,70
1656833461845,ECE 65,A50,083695,Saad; Andrew S,12,0,30,18
1656833461845,ECE 65,A51,095125,Saad; Andrew S,25,0,26,1
1656833467869,ECE 109,A01,091882,Touri; Behrouz,16,0,70,54
1656833473892,ECE 180,A00,083140,Abi Samra; Nicholas Camill,0,0,30,30
1656833473892,ECE 180,B00,083141,Abi Samra; Nicholas Camill,0,0,30,30
1656833479924,MATH 10A,A01,083735,Patchell; Gregory David,1,0,30,29
1656833479924,MATH 10A,A02,083736,Patchell; Gregory David,20,0,30,10
1656833479924,MATH 10A,A03,083737,Patchell; Gregory David,15,0,30,15
1656833485959,MATH 10B,A01,083207,Lim; Seonhee,7,0,34,27
1656833485959,MATH 10B,A02,083208,Lim; Seonhee,9,0,35,26
1656833485959,MATH 10B,A03,093472,Lim; Seonhee,4,0,34,30
1656833485959,MATH 10B,B01,083739,Sinha; Shubham,9,0,30,21
1656833491999,MATH 18,A01,083743,Cinel; Cameron Alexander,6,0,30,24
1656833491999,MATH 18,A02,083744,Cinel; Cameron Alexander,15,0,30,15
1656833491999,MATH 18,A03,083745,Cinel; Cameron Alexander,8,0,30,22
1656833491999,MATH 18,B01,083748,Rideout; David Porter,3,0,37,34
1656833491999,MATH 18,B02,083749,Rideout; David Porter,3,0,36,33
1656833491999,MATH 18,B03,083750,Rideout; David Porter,2,0,37,35
1656833491999,MATH 18,B04,083751,Rideout; David Porter,5,0,36,31
1656833491999,MATH 18,B05,093473,Rideout; David Porter,4,0,36,32
1656833491999,MATH 18,B06,093474,Rideout; David Porter,5,0,36,31
1656833498030,MATH 20A,A01,083754,Zheng; Zequn,12,0,40,28
1656833504054,MATH 20B,A01,083756,Briones; Jor-el Thomas Caparas,1,0,36,35
1656833504054,MATH 20B,A02,083757,Briones; Jor-el Thomas Caparas,1,0,36,35
1656833504054,MATH 20B,A03,093475,Briones; Jor-el Thomas Caparas,0,0,36,36
1656833510089,MATH 20C,A01,083760,Briones; Jor-el Thomas Caparas,1,0,35,34
1656833510089,MATH 20C,A02,083761,Briones; Jor-el Thomas Caparas,8,0,35,27
1656833510089,MATH 20C,A03,093476,Briones; Jor-el Thomas Caparas,0,1,36,36
1656833510089,MATH 20C,B01,083762,Bach; Quang Tran,0,0,30,30
1656833516117,MATH 20D,A01,083765,Tran; Brian Kha,4,0,30,26
1656833516117,MATH 20D,A02,083766,Tran; Brian Kha,4,0,30,26
1656833516117,MATH 20D,A03,083767,Tran; Brian Kha,2,0,30,28
1656833522152,MATH 20E,A01,083771,Ganguly; Soumya,5,0,32,27
1656833522152,MATH 20E,A02,083772,Ganguly; Soumya,6,0,32,26
1656833522152,MATH 20E,B01,083773,Ciotti; Benjamin,18,0,35,17
1656833522152,MATH 20E,B02,083774,Ciotti; Benjamin,17,0,35,18
1656833528179,MATH 103A,A01,083777,Greenfeld; Be'Eri,2,0,36,34
1656833528179,MATH 103A,A02,083778,Greenfeld; Be'Eri,5,0,36,31
1656833528179,MATH 103A,A03,093561,Greenfeld; Be'Eri,4,0,36,32
1656833528179,MATH 103A,B01,083779,Greenfeld; Be'Eri,6,0,36,30
1656833528179,MATH 103A,B02,083780,Greenfeld; Be'Eri,2,0,36,34
1656833528179,MATH 103A,B03,093562,Greenfeld; Be'Eri,2,0,36,34
1656833534215,MATH 105,A01,085443,Carter; Anne Toulson,13,0,35,22
1656833534215,MATH 105,A02,093477,Carter; Anne Toulson,20,0,35,15
1656833540240,MATH 109,A01,083213,Ganzberger; Geoffrey Michael,2,0,34,32
1656833540240,MATH 109,A02,083214,Ganzberger; Geoffrey Michael,2,0,34,32
1656833540240,MATH 109,A03,093478,Ganzberger; Geoffrey Michael,1,0,34,33
1656833540240,MATH 109,B01,083215,Ganzberger; Geoffrey Michael,1,0,32,31
1656833540240,MATH 109,B02,083216,Ganzberger; Geoffrey Michael,1,0,32,31
1656833540240,MATH 109,B03,093479,Ganzberger; Geoffrey Michael,6,0,32,26
1656833546266,MATH 142A,A01,083219,Chow; Bennett,6,0,32,26
1656833546266,MATH 142A,A02,083220,Chow; Bennett,9,0,32,23
1656833546266,MATH 142A,A03,093480,Chow; Bennett,7,0,32,25
1656833546266,MATH 142A,B03,093481,Chow; Bennett,7,0,32,25
1656833546266,MATH 142A,B04,093558,Chow; Bennett,10,0,32,22
1656833546266,MATH 142A,B05,093559,Chow; Bennett,6,0,32,26
1656833552298,MATH 193A,A01,083224,Rotar; Vladimir,6,0,34,28
1656833552298,MATH 193A,A02,083225,Rotar; Vladimir,3,0,34,31
1656833552298,MATH 193A,A03,083781,Rotar; Vladimir,1,0,34,33
1656833552298,MATH 193A,A04,083782,Rotar; Vladimir,6,0,34,28
1656833552298,MATH 193A,A05,093482,Rotar; Vladimir,6,0,34,28
1656833558321,MATH 197,001,091859,McAuley; Julian John,9999,0,9999,0
1656833558321,MATH 197,002,095566,Kedlaya; Kiran S.,9997,0,9999,2
1656833558321,MATH 197,003,095567,Xiao; Ming,9999,0,9999,0
1656833558321,MATH 197,004,095571,Perols; Johan Lars,9998,0,9999,1
1656833565393,COGS 9,A01,083615,Shannon; Kyle Michael,6,0,75,69
1656833571419,COGS 11,A01,083617,Boyle; Mary E. T.,18,0,48,30
1656833577445,COGS 13,A01,083071,Bastos; Amalia Pinkusfeld,8,0,71,63
1656833583468,COGS 14A,A01,092681,Semenuks; Arturs,0,1,100,100
1656833589491,COGS 14B,A01,083073,Cheng; Tzu-Han,5,0,63,58
1656833595523,COGS 17,A01,092677,Semenuks; Arturs,4,0,81,77
1656833601553,COGS 100,A01,083619,Allen; Michael Gordon,15,0,70,55
1656833607578,COGS 101A,A01,083621,Davis; Joshua Daniel,9,0,68,59
1656833613606,COGS 101B,A01,091572,Allen; Michael Gordon,8,0,65,57
1656833619636,COGS 101C,A01,083625,Delgado; Tania,17,0,35,18
1656833625663,COGS 107A,A01,083627,Boyle; Mary E. T.,13,0,60,47
1656833631685,COGS 118A,A01,083075,Gupta; Anjum,15,0,76,61
1656833637710,CSE 3,A50,083646,Miranda; Gregory Joseph,22,0,50,28
1656833643734,CSE 8A,A50,083650,Miranda; Gregory Joseph,17,1,56,39
1656833649757,CSE 11,A01,083080,Cao; Yingjun,4,15,40,36
1656833655780,CSE 12,A01,083652,Krause-Levy; Sophia Louisa,20,1,120,100
1656833661811,CSE 15L,A01,083654,Morris; Justin Loren,8,0,50,42
1656833661811,CSE 15L,A02,083655,Morris; Justin Loren,8,0,50,42
1656833667835,CSE 20,A01,083657,Tran; Khoa Dang,37,0,80,43
1656833673859,CSE 21,A01,095574,Bach; Quang Tran,21,0,48,27
1656833679885,CSE 30,A01,083084,Eldon; John,4,0,80,76
1656833679885,CSE 30,B01,095061,Bhaskar; Nishant,6,0,50,44
1656833685914,CSE 100,A01,083659,Cao; Yingjun,2,4,70,68
1656833691941,CSE 134B,A01,083661,Powell; Thomas Allan,19,0,100,81
1656833697966,CSE 140,A01,083663,Gungor; Onat,14,0,85,71
1656833703994,CSE 140L,A01,083088,Eldon; John,16,0,100,84
1656833710021,CSE 175,A01,083665,Kumar; Rakesh,3,0,25,22
1656833716045,CSE 190,A00,092507,Dubnov; Shlomo,7,0,20,13
1656833722069,ECE 45,A01,083139,Congero; Spencer William,5,0,75,70
1656833728111,ECE 65,A50,083695,Saad; Andrew S,12,0,30,18
1656833728111,ECE 65,A51,095125,Saad; Andrew S,25,0,26,1
1656833734143,ECE 109,A01,091882,Touri; Behrouz,16,0,70,54
1656833740171,ECE 180,A00,083140,Abi Samra; Nicholas Camill,0,0,30,30
1656833740171,ECE 180,B00,083141,Abi Samra; Nicholas Camill,0,0,30,30
1656833746205,MATH 10A,A01,083735,Patchell; Gregory David,1,0,30,29
1656833746205,MATH 10A,A02,083736,Patchell; Gregory David,20,0,30,10
1656833746205,MATH 10A,A03,083737,Patchell; Gregory David,15,0,30,15
1656833752243,MATH 10B,A01,083207,Lim; Seonhee,7,0,34,27
1656833752243,MATH 10B,A02,083208,Lim; Seonhee,9,0,35,26
1656833752243,MATH 10B,A03,093472,Lim; Seonhee,4,0,34,30
1656833752243,MATH 10B,B01,083739,Sinha; Shubham,9,0,30,21
1656833758270,MATH 18,A01,083743,Cinel; Cameron Alexander,6,0,30,24
1656833758270,MATH 18,A02,083744,Cinel; Cameron Alexander,15,0,30,15
1656833758270,MATH 18,A03,083745,Cinel; Cameron Alexander,8,0,30,22
1656833758270,MATH 18,B01,083748,Rideout; David Porter,3,0,37,34
1656833758270,MATH 18,B02,083749,Rideout; David Porter,3,0,36,33
1656833758270,MATH 18,B03,083750,Rideout; David Porter,2,0,37,35
1656833758270,MATH 18,B04,083751,Rideout; David Porter,5,0,36,31
1656833758270,MATH 18,B05,093473,Rideout; David Porter,4,0,36,32
1656833758270,MATH 18,B06,093474,Rideout; David Porter,5,0,36,31
1656833764303,MATH 20A,A01,083754,Zheng; Zequn,12,0,40,28
1656833770327,MATH 20B,A01,083756,Briones; Jor-el Thomas Caparas,1,0,36,35
1656833770327,MATH 20B,A02,083757,Briones; Jor-el Thomas Caparas,1,0,36,35
1656833770327,MATH 20B,A03,093475,Briones; Jor-el Thomas Caparas,0,0,36,36
1656833776360,MATH 20C,A01,083760,Briones; Jor-el Thomas Caparas,1,0,35,34
1656833776360,MATH 20C,A02,083761,Briones; Jor-el Thomas Caparas,8,0,35,27
1656833776360,MATH 20C,A03,093476,Briones; Jor-el Thomas Caparas,0,1,36,36
1656833776360,MATH 20C,B01,083762,Bach; Quang Tran,0,0,30,30
1656833782391,MATH 20D,A01,083765,Tran; Brian Kha,4,0,30,26
1656833782391,MATH 20D,A02,083766,Tran; Brian Kha,4,0,30,26
1656833782391,MATH 20D,A03,083767,Tran; Brian Kha,2,0,30,28
1656833788417,MATH 20E,A01,083771,Ganguly; Soumya,5,0,32,27
1656833788417,MATH 20E,A02,083772,Ganguly; Soumya,6,0,32,26
1656833788417,MATH 20E,B01,083773,Ciotti; Benjamin,18,0,35,17
1656833788417,MATH 20E,B02,083774,Ciotti; Benjamin,17,0,35,18
1656833794444,MATH 103A,A01,083777,Greenfeld; Be'Eri,2,0,36,34
1656833794444,MATH 103A,A02,083778,Greenfeld; Be'Eri,5,0,36,31
1656833794444,MATH 103A,A03,093561,Greenfeld; Be'Eri,4,0,36,32
1656833794444,MATH 103A,B01,083779,Greenfeld; Be'Eri,6,0,36,30
1656833794444,MATH 103A,B02,083780,Greenfeld; Be'Eri,2,0,36,34
1656833794444,MATH 103A,B03,093562,Greenfeld; Be'Eri,2,0,36,34
1656833800476,MATH 105,A01,085443,Carter; Anne Toulson,13,0,35,22
1656833800476,MATH 105,A02,093477,Carter; Anne Toulson,20,0,35,15
1656833806519,MATH 109,A01,083213,Ganzberger; Geoffrey Michael,2,0,34,32
1656833806519,MATH 109,A02,083214,Ganzberger; Geoffrey Michael,2,0,34,32
1656833806519,MATH 109,A03,093478,Ganzberger; Geoffrey Michael,1,0,34,33
1656833806519,MATH 109,B01,083215,Ganzberger; Geoffrey Michael,1,0,32,31
1656833806519,MATH 109,B02,083216,Ganzberger; Geoffrey Michael,1,0,32,31
1656833806519,MATH 109,B03,093479,Ganzberger; Geoffrey Michael,6,0,32,26
1656833812553,MATH 142A,A01,083219,Chow; Bennett,6,0,32,26
1656833812553,MATH 142A,A02,083220,Chow; Bennett,9,0,32,23
1656833812553,MATH 142A,A03,093480,Chow; Bennett,7,0,32,25
1656833812553,MATH 142A,B03,093481,Chow; Bennett,7,0,32,25
1656833812553,MATH 142A,B04,093558,Chow; Bennett,10,0,32,22
1656833812553,MATH 142A,B05,093559,Chow; Bennett,6,0,32,26
1656833818585,MATH 193A,A01,083224,Rotar; Vladimir,6,0,34,28
1656833818585,MATH 193A,A02,083225,Rotar; Vladimir,3,0,34,31
1656833818585,MATH 193A,A03,083781,Rotar; Vladimir,1,0,34,33
1656833818585,MATH 193A,A04,083782,Rotar; Vladimir,6,0,34,28
1656833818585,MATH 193A,A05,093482,Rotar; Vladimir,6,0,34,28
1656833824614,MATH 197,001,091859,McAuley; Julian John,9999,0,9999,0
1656833824614,MATH 197,002,095566,Kedlaya; Kiran S.,9997,0,9999,2
1656833824614,MATH 197,003,095567,Xiao; Ming,9999,0,9999,0
1656833824614,MATH 197,004,095571,Perols; Johan Lars,9998,0,9999,1
1656833831676,COGS 9,A01,083615,Shannon; Kyle Michael,6,0,75,69
1656833837700,COGS 11,A01,083617,Boyle; Mary E. T.,18,0,48,30
1656833843730,COGS 13,A01,083071,Bastos; Amalia Pinkusfeld,8,0,71,63
1656833849755,COGS 14A,A01,092681,Semenuks; Arturs,0,1,100,100
1656833855783,COGS 14B,A01,083073,Cheng; Tzu-Han,5,0,63,58
1656833861807,COGS 17,A01,092677,Semenuks; Arturs,4,0,81,77
1656833867833,COGS 100,A01,083619,Allen; Michael Gordon,15,0,70,55
1656833873856,COGS 101A,A01,083621,Davis; Joshua Daniel,9,0,68,59
1656833879884,COGS 101B,A01,091572,Allen; Michael Gordon,8,0,65,57
1656833885914,COGS 101C,A01,083625,Delgado; Tania,17,0,35,18
1656833891936,COGS 107A,A01,083627,Boyle; Mary E. T.,13,0,60,47
1656833897959,COGS 118A,A01,083075,Gupta; Anjum,15,0,76,61
1656833903986,CSE 3,A50,083646,Miranda; Gregory Joseph,22,0,50,28
1656833910009,CSE 8A,A50,083650,Miranda; Gregory Joseph,17,1,56,39
1656833916038,CSE 11,A01,083080,Cao; Yingjun,4,15,40,36
1656833922062,CSE 12,A01,083652,Krause-Levy; Sophia Louisa,20,1,120,100
1656833928089,CSE 15L,A01,083654,Morris; Justin Loren,8,0,50,42
1656833928089,CSE 15L,A02,083655,Morris; Justin Loren,8,0,50,42
1656833934116,CSE 20,A01,083657,Tran; Khoa Dang,37,0,80,43
1656833940153,CSE 21,A01,095574,Bach; Quang Tran,21,0,48,27
1656833946182,CSE 30,A01,083084,Eldon; John,4,0,80,76
1656833946182,CSE 30,B01,095061,Bhaskar; Nishant,6,0,50,44
1656833952210,CSE 100,A01,083659,Cao; Yingjun,2,4,70,68
1656833958233,CSE 134B,A01,083661,Powell; Thomas Allan,19,0,100,81
1656833964263,CSE 140,A01,083663,Gungor; Onat,14,0,85,71
1656833970295,CSE 140L,A01,083088,Eldon; John,16,0,100,84
1656833976319,CSE 175,A01,083665,Kumar; Rakesh,3,0,25,22
1656833982344,CSE 190,A00,092507,Dubnov; Shlomo,7,0,20,13
1656833988381,ECE 45,A01,083139,Congero; Spencer William,5,0,75,70
1656833994406,ECE 65,A50,083695,Saad; Andrew S,12,0,30,18
1656833994406,ECE 65,A51,095125,Saad; Andrew S,25,0,26,1
1656834000431,ECE 109,A01,091882,Touri; Behrouz,16,0,70,54
1656834006461,ECE 180,A00,083140,Abi Samra; Nicholas Camill,0,0,30,30
1656834006461,ECE 180,B00,083141,Abi Samra; Nicholas Camill,0,0,30,30
1656834012496,MATH 10A,A01,083735,Patchell; Gregory David,1,0,30,29
1656834012496,MATH 10A,A02,083736,Patchell; Gregory David,20,0,30,10
1656834012496,MATH 10A,A03,083737,Patchell; Gregory David,15,0,30,15
1656834018537,MATH 10B,A01,083207,Lim; Seonhee,7,0,34,27
1656834018537,MATH 10B,A02,083208,Lim; Seonhee,9,0,35,26
1656834018537,MATH 10B,A03,093472,Lim; Seonhee,4,0,34,30
1656834018537,MATH 10B,B01,083739,Sinha; Shubham,9,0,30,21
1656834024568,MATH 18,A01,083743,Cinel; Cameron Alexander,6,0,30,24
1656834024568,MATH 18,A02,083744,Cinel; Cameron Alexander,15,0,30,15
1656834024568,MATH 18,A03,083745,Cinel; Cameron Alexander,8,0,30,22
1656834024568,MATH 18,B01,083748,Rideout; David Porter,3,0,37,34
1656834024568,MATH 18,B02,083749,Rideout; David Porter,3,0,36,33
1656834024568,MATH 18,B03,083750,Rideout; David Porter,2,0,37,35
1656834024568,MATH 18,B04,083751,Rideout; David Porter,5,0,36,31
1656834024568,MATH 18,B05,093473,Rideout; David Porter,4,0,36,32
1656834024568,MATH 18,B06,093474,Rideout; David Porter,5,0,36,31
1656834030664,MATH 20A,A01,083754,Zheng; Zequn,12,0,40,28
1656834036696,MATH 20B,A01,083756,Briones; Jor-el Thomas Caparas,1,0,36,35
1656834036696,MATH 20B,A02,083757,Briones; Jor-el Thomas Caparas,1,0,36,35
1656834036696,MATH 20B,A03,093475,Briones; Jor-el Thomas Caparas,0,0,36,36
1656834042729,MATH 20C,A01,083760,Briones; Jor-el Thomas Caparas,1,0,35,34
1656834042729,MATH 20C,A02,083761,Briones; Jor-el Thomas Caparas,8,0,35,27
1656834042729,MATH 20C,A03,093476,Briones; Jor-el Thomas Caparas,0,1,36,36
1656834042729,MATH 20C,B01,083762,Bach; Quang Tran,0,0,30,30
1656834048760,MATH 20D,A01,083765,Tran; Brian Kha,4,0,30,26
1656834048760,MATH 20D,A02,083766,Tran; Brian Kha,4,0,30,26
1656834048760,MATH 20D,A03,083767,Tran; Brian Kha,2,0,30,28
1656834054794,MATH 20E,A01,083771,Ganguly; Soumya,5,0,32,27
1656834054794,MATH 20E,A02,083772,Ganguly; Soumya,6,0,32,26
1656834054794,MATH 20E,B01,083773,Ciotti; Benjamin,18,0,35,17
1656834054794,MATH 20E,B02,083774,Ciotti; Benjamin,17,0,35,18
1656834060822,MATH 103A,A01,083777,Greenfeld; Be'Eri,2,0,36,34
1656834060822,MATH 103A,A02,083778,Greenfeld; Be'Eri,5,0,36,31
1656834060822,MATH 103A,A03,093561,Greenfeld; Be'Eri,4,0,36,32
1656834060822,MATH 103A,B01,083779,Greenfeld; Be'Eri,6,0,36,30
1656834060822,MATH 103A,B02,083780,Greenfeld; Be'Eri,2,0,36,34
1656834060822,MATH 103A,B03,093562,Greenfeld; Be'Eri,2,0,36,34
1656834066847,MATH 105,A01,085443,Carter; Anne Toulson,13,0,35,22
1656834066847,MATH 105,A02,093477,Carter; Anne Toulson,20,0,35,15
1656834072872,MATH 109,A01,083213,Ganzberger; Geoffrey Michael,2,0,34,32
1656834072872,MATH 109,A02,083214,Ganzberger; Geoffrey Michael,2,0,34,32
1656834072872,MATH 109,A03,093478,Ganzberger; Geoffrey Michael,1,0,34,33
1656834072872,MATH 109,B01,083215,Ganzberger; Geoffrey Michael,1,0,32,31
1656834072872,MATH 109,B02,083216,Ganzberger; Geoffrey Michael,1,0,32,31
1656834072872,MATH 109,B03,093479,Ganzberger; Geoffrey Michael,6,0,32,26
1656834078906,MATH 142A,A01,083219,Chow; Bennett,6,0,32,26
1656834078906,MATH 142A,A02,083220,Chow; Bennett,9,0,32,23
1656834078906,MATH 142A,A03,093480,Chow; Bennett,7,0,32,25
1656834078906,MATH 142A,B03,093481,Chow; Bennett,7,0,32,25
1656834078906,MATH 142A,B04,093558,Chow; Bennett,10,0,32,22
1656834078906,MATH 142A,B05,093559,Chow; Bennett,6,0,32,26
1656834084930,MATH 193A,A01,083224,Rotar; Vladimir,6,0,34,28
1656834084930,MATH 193A,A02,083225,Rotar; Vladimir,3,0,34,31
1656834084930,MATH 193A,A03,083781,Rotar; Vladimir,1,0,34,33
1656834084930,MATH 193A,A04,083782,Rotar; Vladimir,6,0,34,28
1656834084930,MATH 193A,A05,093482,Rotar; Vladimir,6,0,34,28
1656834090957,MATH 197,001,091859,McAuley; Julian John,9999,0,9999,0
1656834090957,MATH 197,002,095566,Kedlaya; Kiran S.,9997,0,9999,2
1656834090957,MATH 197,003,095567,Xiao; Ming,9999,0,9999,0
1656834090957,MATH 197,004,095571,Perols; Johan Lars,9998,0,9999,1
1656834098035,COGS 9,A01,083615,Shannon; Kyle Michael,6,0,75,69
1656834104062,COGS 11,A01,083617,Boyle; Mary E. T.,18,0,48,30
1656834110089,COGS 13,A01,083071,Bastos; Amalia Pinkusfeld,8,0,71,63
1656834116116,COGS 14A,A01,092681,Semenuks; Arturs,0,1,100,100
1656834122146,COGS 14B,A01,083073,Cheng; Tzu-Han,5,0,63,58
1656834128169,COGS 17,A01,092677,Semenuks; Arturs,4,0,81,77
1656834134195,COGS 100,A01,083619,Allen; Michael Gordon,15,0,70,55
1656834140223,COGS 101A,A01,083621,Davis; Joshua Daniel,9,0,68,59
1656834146255,COGS 101B,A01,091572,Allen; Michael Gordon,8,0,65,57
1656834152280,COGS 101C,A01,083625,Delgado; Tania,17,0,35,18
1656834158304,COGS 107A,A01,083627,Boyle; Mary E. T.,13,0,60,47
1656834164328,COGS 118A,A01,083075,Gupta; Anjum,15,0,76,61
1656834170354,CSE 3,A50,083646,Miranda; Gregory Joseph,22,0,50,28
1656834176383,CSE 8A,A50,083650,Miranda; Gregory Joseph,17,1,56,39
1656834182407,CSE 11,A01,083080,Cao; Yingjun,4,15,40,36
1656834188439,CSE 12,A01,083652,Krause-Levy; Sophia Louisa,20,1,120,100
1656834194471,CSE 15L,A01,083654,Morris; Justin Loren,8,0,50,42
1656834194471,CSE 15L,A02,083655,Morris; Justin Loren,8,0,50,42
1656834200496,CSE 20,A01,083657,Tran; Khoa Dang,37,0,80,43
1656834206528,CSE 21,A01,095574,Bach; Quang Tran,21,0,48,27
1656834212557,CSE 30,A01,083084,Eldon; John,4,0,80,76
1656834212557,CSE 30,B01,095061,Bhaskar; Nishant,6,0,50,44
1656834218582,CSE 100,A01,083659,Cao; Yingjun,2,4,70,68
1656834224605,CSE 134B,A01,083661,Powell; Thomas Allan,19,0,100,81
1656834230632,CSE 140,A01,083663,Gungor; Onat,14,0,85,71
1656834236656,CSE 140L,A01,083088,Eldon; John,16,0,100,84
1656834242686,CSE 175,A01,083665,Kumar; Rakesh,3,0,25,22
1656834248711,CSE 190,A00,092507,Dubnov; Shlomo,7,0,20,13
1656834254743,ECE 45,A01,083139,Congero; Spencer William,5,0,75,70
1656834260778,ECE 65,A50,083695,Saad; Andrew S,12,0,30,18
1656834260778,ECE 65,A51,095125,Saad; Andrew S,25,0,26,1
1656834266803,ECE 109,A01,091882,Touri; Behrouz,16,0,70,54
1656834272830,ECE 180,A00,083140,Abi Samra; Nicholas Camill,0,0,30,30
1656834272830,ECE 180,B00,083141,Abi Samra; Nicholas Camill,0,0,30,30
1656834278859,MATH 10A,A01,083735,Patchell; Gregory David,1,0,30,29
1656834278859,MATH 10A,A02,083736,Patchell; Gregory David,20,0,30,10
1656834278859,MATH 10A,A03,083737,Patchell; Gregory David,15,0,30,15
1656834284895,MATH 10B,A01,083207,Lim; Seonhee,7,0,34,27
1656834284895,MATH 10B,A02,083208,Lim; Seonhee,9,0,35,26
1656834284895,MATH 10B,A03,093472,Lim; Seonhee,4,0,34,30
1656834284895,MATH 10B,B01,083739,Sinha; Shubham,9,0,30,21
1656834290935,MATH 18,A01,083743,Cinel; Cameron Alexander,6,0,30,24
1656834290935,MATH 18,A02,083744,Cinel; Cameron Alexander,15,0,30,15
1656834290935,MATH 18,A03,083745,Cinel; Cameron Alexander,8,0,30,22
1656834290935,MATH 18,B01,083748,Rideout; David Porter,3,0,37,34
1656834290935,MATH 18,B02,083749,Rideout; David Porter,3,0,36,33
1656834290935,MATH 18,B03,083750,Rideout; David Porter,2,0,37,35
1656834290935,MATH 18,B04,083751,Rideout; David Porter,5,0,36,31
1656834290935,MATH 18,B05,093473,Rideout; David Porter,4,0,36,32
1656834290935,MATH 18,B06,093474,Rideout; David Porter,5,0,36,31
1656834296959,MATH 20A,A01,083754,Zheng; Zequn,12,0,40,28
1656834302995,MATH 20B,A01,083756,Briones; Jor-el Thomas Caparas,1,0,36,35
1656834302995,MATH 20B,A02,083757,Briones; Jor-el Thomas Caparas,1,0,36,35
1656834302995,MATH 20B,A03,093475,Briones; Jor-el Thomas Caparas,0,0,36,36
1656834309021,MATH 20C,A01,083760,Briones; Jor-el Thomas Caparas,1,0,35,34
1656834309021,MATH 20C,A02,083761,Briones; Jor-el Thomas Caparas,8,0,35,27
1656834309021,MATH 20C,A03,093476,Briones; Jor-el Thomas Caparas,0,1,36,36
1656834309021,MATH 20C,B01,083762,Bach; Quang Tran,0,0,30,30
1656834315046,MATH 20D,A01,083765,Tran; Brian Kha,4,0,30,26
1656834315046,MATH 20D,A02,083766,Tran; Brian Kha,4,0,30,26
1656834315046,MATH 20D,A03,083767,Tran; Brian Kha,2,0,30,28
1656834321079,MATH 20E,A01,083771,Ganguly; Soumya,5,0,32,27
1656834321079,MATH 20E,A02,083772,Ganguly; Soumya,6,0,32,26
1656834321079,MATH 20E,B01,083773,Ciotti; Benjamin,18,0,35,17
1656834321079,MATH 20E,B02,083774,Ciotti; Benjamin,17,0,35,18
1656834327119,MATH 103A,A01,083777,Greenfeld; Be'Eri,2,0,36,34
1656834327119,MATH 103A,A02,083778,Greenfeld; Be'Eri,5,0,36,31
1656834327119,MATH 103A,A03,093561,Greenfeld; Be'Eri,4,0,36,32
1656834327119,MATH 103A,B01,083779,Greenfeld; Be'Eri,6,0,36,30
1656834327119,MATH 103A,B02,083780,Greenfeld; Be'Eri,2,0,36,34
1656834327119,MATH 103A,B03,093562,Greenfeld; Be'Eri,2,0,36,34
1656834333152,MATH 105,A01,085443,Carter; Anne Toulson,13,0,35,22
1656834333152,MATH 105,A02,093477,Carter; Anne Toulson,20,0,35,15
1656834339182,MATH 109,A01,083213,Ganzberger; Geoffrey Michael,2,0,34,32
1656834339182,MATH 109,A02,083214,Ganzberger; Geoffrey Michael,2,0,34,32
1656834339182,MATH 109,A03,093478,Ganzberger; Geoffrey Michael,1,0,34,33
1656834339182,MATH 109,B01,083215,Ganzberger; Geoffrey Michael,1,0,32,31
1656834339182,MATH 109,B02,083216,Ganzberger; Geoffrey Michael,1,0,32,31
1656834339182,MATH 109,B03,093479,Ganzberger; Geoffrey Michael,6,0,32,26
1656834345208,MATH 142A,A01,083219,Chow; Bennett,6,0,32,26
1656834345208,MATH 142A,A02,083220,Chow; Bennett,9,0,32,23
1656834345208,MATH 142A,A03,093480,Chow; Bennett,7,0,32,25
1656834345208,MATH 142A,B03,093481,Chow; Bennett,7,0,32,25
1656834345208,MATH 142A,B04,093558,Chow; Bennett,10,0,32,22
1656834345208,MATH 142A,B05,093559,Chow; Bennett,6,0,32,26
1656834351240,MATH 193A,A01,083224,Rotar; Vladimir,6,0,34,28
1656834351240,MATH 193A,A02,083225,Rotar; Vladimir,3,0,34,31
1656834351240,MATH 193A,A03,083781,Rotar; Vladimir,1,0,34,33
1656834351240,MATH 193A,A04,083782,Rotar; Vladimir,6,0,34,28
1656834351240,MATH 193A,A05,093482,Rotar; Vladimir,6,0,34,28
1656834357272,MATH 197,001,091859,McAuley; Julian John,9999,0,9999,0
1656834357272,MATH 197,002,095566,Kedlaya; Kiran S.,9997,0,9999,2
1656834357272,MATH 197,003,095567,Xiao; Ming,9999,0,9999,0
1656834357272,MATH 197,004,095571,Perols; Johan Lars,9998,0,9999,1
1656834364352,COGS 9,A01,083615,Shannon; Kyle Michael,6,0,75,69
1656834370378,COGS 11,A01,083617,Boyle; Mary E. T.,18,0,48,30
1656834376408,COGS 13,A01,083071,Bastos; Amalia Pinkusfeld,8,0,71,63
1656834382434,COGS 14A,A01,092681,Semenuks; Arturs,0,1,100,100
1656834388466,COGS 14B,A01,083073,Cheng; Tzu-Han,5,0,63,58
1656834394495,COGS 17,A01,092677,Semenuks; Arturs,4,0,81,77
1656834400518,COGS 100,A01,083619,Allen; Michael Gordon,15,0,70,55
1656834406548,COGS 101A,A01,083621,Davis; Joshua Daniel,9,0,68,59
1656834412573,COGS 101B,A01,091572,Allen; Michael Gordon,8,0,65,57
1656834418604,COGS 101C,A01,083625,Delgado; Tania,17,0,35,18
1656834424632,COGS 107A,A01,083627,Boyle; Mary E. T.,13,0,60,47
1656834430665,COGS 118A,A01,083075,Gupta; Anjum,15,0,76,61
1656834436700,CSE 3,A50,083646,Miranda; Gregory Joseph,22,0,50,28
1656834442729,CSE 8A,A50,083650,Miranda; Gregory Joseph,17,1,56,39
1656834448759,CSE 11,A01,083080,Cao; Yingjun,4,15,40,36
1656834454794,CSE 12,A01,083652,Krause-Levy; Sophia Louisa,20,1,120,100
1656834460823,CSE 15L,A01,083654,Morris; Justin Loren,8,0,50,42
1656834460823,CSE 15L,A02,083655,Morris; Justin Loren,8,0,50,42
1656834466848,CSE 20,A01,083657,Tran; Khoa Dang,37,0,80,43
1656834472875,CSE 21,A01,095574,Bach; Quang Tran,21,0,48,27
1656834478907,CSE 30,A01,083084,Eldon; John,4,0,80,76
1656834478907,CSE 30,B01,095061,Bhaskar; Nishant,6,0,50,44
1656834484931,CSE 100,A01,083659,Cao; Yingjun,2,4,70,68
1656834490962,CSE 134B,A01,083661,Powell; Thomas Allan,19,0,100,81
1656834496986,CSE 140,A01,083663,Gungor; Onat,14,0,85,71
1656834503012,CSE 140L,A01,083088,Eldon; John,16,0,100,84
1656834509041,CSE 175,A01,083665,Kumar; Rakesh,3,0,25,22
1656834515070,CSE 190,A00,092507,Dubnov; Shlomo,7,0,20,13
1656834521105,ECE 45,A01,083139,Congero; Spencer William,5,0,75,70
1656834527135,ECE 65,A50,083695,Saad; Andrew S,12,0,30,18
1656834527135,ECE 65,A51,095125,Saad; Andrew S,25,0,26,1
1656834533165,ECE 109,A01,091882,Touri; Behrouz,16,0,70,54
1656834539199,ECE 180,A00,083140,Abi Samra; Nicholas Camill,0,0,30,30
1656834539199,ECE 180,B00,083141,Abi Samra; Nicholas Camill,0,0,30,30
1656834545235,MATH 10A,A01,083735,Patchell; Gregory David,1,0,30,29
1656834545235,MATH 10A,A02,083736,Patchell; Gregory David,20,0,30,10
1656834545235,MATH 10A,A03,083737,Patchell; Gregory David,15,0,30,15
1656834551265,MATH 10B,A01,083207,Lim; Seonhee,7,0,34,27
1656834551265,MATH 10B,A02,083208,Lim; Seonhee,9,0,35,26
1656834551265,MATH 10B,A03,093472,Lim; Seonhee,4,0,34,30
1656834551265,MATH 10B,B01,083739,Sinha; Shubham,9,0,30,21
1656834557292,MATH 18,A01,083743,Cinel; Cameron Alexander,6,0,30,24
1656834557292,MATH 18,A02,083744,Cinel; Cameron Alexander,15,0,30,15
1656834557292,MATH 18,A03,083745,Cinel; Cameron Alexander,8,0,30,22
1656834557292,MATH 18,B01,083748,Rideout; David Porter,3,0,37,34
1656834557292,MATH 18,B02,083749,Rideout; David Porter,3,0,36,33
1656834557292,MATH 18,B03,083750,Rideout; David Porter,2,0,37,35
1656834557292,MATH 18,B04,083751,Rideout; David Porter,5,0,36,31
1656834557292,MATH 18,B05,093473,Rideout; David Porter,4,0,36,32
1656834557292,MATH 18,B06,093474,Rideout; David Porter,5,0,36,31
1656834563317,MATH 20A,A01,083754,Zheng; Zequn,12,0,40,28
1656834569343,MATH 20B,A01,083756,Briones; Jor-el Thomas Caparas,1,0,36,35
1656834569343,MATH 20B,A02,083757,Briones; Jor-el Thomas Caparas,1,0,36,35
1656834569343,MATH 20B,A03,093475,Briones; Jor-el Thomas Caparas,0,0,36,36
1656834575368,MATH 20C,A01,083760,Briones; Jor-el Thomas Caparas,1,0,35,34
1656834575368,MATH 20C,A02,083761,Briones; Jor-el Thomas Caparas,8,0,35,27
1656834575368,MATH 20C,A03,093476,Briones; Jor-el Thomas Caparas,0,1,36,36
1656834575368,MATH 20C,B01,083762,Bach; Quang Tran,0,0,30,30
1656834581398,MATH 20D,A01,083765,Tran; Brian Kha,4,0,30,26
1656834581398,MATH 20D,A02,083766,Tran; Brian Kha,4,0,30,26
1656834581398,MATH 20D,A03,083767,Tran; Brian Kha,2,0,30,28
1656834587424,MATH 20E,A01,083771,Ganguly; Soumya,5,0,32,27
1656834587424,MATH 20E,A02,083772,Ganguly; Soumya,6,0,32,26
1656834587424,MATH 20E,B01,083773,Ciotti; Benjamin,18,0,35,17
1656834587424,MATH 20E,B02,083774,Ciotti; Benjamin,17,0,35,18
1656834593454,MATH 103A,A01,083777,Greenfeld; Be'Eri,2,0,36,34
1656834593454,MATH 103A,A02,083778,Greenfeld; Be'Eri,5,0,36,31
1656834593454,MATH 103A,A03,093561,Greenfeld; Be'Eri,4,0,36,32
1656834593454,MATH 103A,B01,083779,Greenfeld; Be'Eri,6,0,36,30
1656834593454,MATH 103A,B02,083780,Greenfeld; Be'Eri,2,0,36,34
1656834593454,MATH 103A,B03,093562,Greenfeld; Be'Eri,2,0,36,34
1656834599484,MATH 105,A01,085443,Carter; Anne Toulson,13,0,35,22
1656834599484,MATH 105,A02,093477,Carter; Anne Toulson,20,0,35,15
1656834605512,MATH 109,A01,083213,Ganzberger; Geoffrey Michael,2,0,34,32
1656834605512,MATH 109,A02,083214,Ganzberger; Geoffrey Michael,2,0,34,32
1656834605512,MATH 109,A03,093478,Ganzberger; Geoffrey Michael,1,0,34,33
1656834605512,MATH 109,B01,083215,Ganzberger; Geoffrey Michael,1,0,32,31
1656834605512,MATH 109,B02,083216,Ganzberger; Geoffrey Michael,1,0,32,31
1656834605512,MATH 109,B03,093479,Ganzberger; Geoffrey Michael,6,0,32,26
1656834611550,MATH 142A,A01,083219,Chow; Bennett,6,0,32,26
1656834611550,MATH 142A,A02,083220,Chow; Bennett,9,0,32,23
1656834611550,MATH 142A,A03,093480,Chow; Bennett,7,0,32,25
1656834611550,MATH 142A,B03,093481,Chow; Bennett,7,0,32,25
1656834611550,MATH 142A,B04,093558,Chow; Bennett,10,0,32,22
1656834611550,MATH 142A,B05,093559,Chow; Bennett,6,0,32,26
1656834617583,MATH 193A,A01,083224,Rotar; Vladimir,6,0,34,28
1656834617583,MATH 193A,A02,083225,Rotar; Vladimir,3,0,34,31
1656834617583,MATH 193A,A03,083781,Rotar; Vladimir,1,0,34,33
1656834617583,MATH 193A,A04,083782,Rotar; Vladimir,6,0,34,28
1656834617583,MATH 193A,A05,093482,Rotar; Vladimir,6,0,34,28
1656834623609,MATH 197,001,091859,McAuley; Julian John,9999,0,9999,0
1656834623609,MATH 197,002,095566,Kedlaya; Kiran S.,9997,0,9999,2
1656834623609,MATH 197,003,095567,Xiao; Ming,9999,0,9999,0
1656834623609,MATH 197,004,095571,Perols; Johan Lars,9998,0,9999,1
1656834630753,COGS 9,A01,083615,Shannon; Kyle Michael,6,0,75,69
1656834636781,COGS 11,A01,083617,Boyle; Mary E. T.,18,0,48,30
1656834642814,COGS 13,A01,083071,Bastos; Amalia Pinkusfeld,8,0,71,63
1656834648836,COGS 14A,A01,092681,Semenuks; Arturs,0,1,100,100
1656834654863,COGS 14B,A01,083073,Cheng; Tzu-Han,5,0,63,58
1656834660892,COGS 17,A01,092677,Semenuks; Arturs,4,0,81,77
1656834666919,COGS 100,A01,083619,Allen; Michael Gordon,15,0,70,55
1656834672944,COGS 101A,A01,083621,Davis; Joshua Daniel,9,0,68,59
1656834678969,COGS 101B,A01,091572,Allen; Michael Gordon,8,0,65,57
1656834685001,COGS 101C,A01,083625,Delgado; Tania,17,0,35,18
1656834691024,COGS 107A,A01,083627,Boyle; Mary E. T.,13,0,60,47
1656834697049,COGS 118A,A01,083075,Gupta; Anjum,15,0,76,61
1656834703081,CSE 3,A50,083646,Miranda; Gregory Joseph,22,0,50,28
1656834709106,CSE 8A,A50,083650,Miranda; Gregory Joseph,17,1,56,39
1656834715135,CSE 11,A01,083080,Cao; Yingjun,4,15,40,36
1656834721159,CSE 12,A01,083652,Krause-Levy; Sophia Louisa,20,1,120,100
1656834727183,CSE 15L,A01,083654,Morris; Justin Loren,8,0,50,42
1656834727183,CSE 15L,A02,083655,Morris; Justin Loren,8,0,50,42
1656834733207,CSE 20,A01,083657,Tran; Khoa Dang,37,0,80,43
1656834739233,CSE 21,A01,095574,Bach; Quang Tran,21,0,48,27
1656834745258,CSE 30,A01,083084,Eldon; John,4,0,80,76
1656834745258,CSE 30,B01,095061,Bhaskar; Nishant,6,0,50,44
1656834751282,CSE 100,A01,083659,Cao; Yingjun,2,4,70,68
1656834757307,CSE 134B,A01,083661,Powell; Thomas Allan,19,0,100,81
1656834763336,CSE 140,A01,083663,Gungor; Onat,14,0,85,71
1656834769360,CSE 140L,A01,083088,Eldon; John,16,0,100,84
1656834775388,CSE 175,A01,083665,Kumar; Rakesh,3,0,25,22
1656834781415,CSE 190,A00,092507,Dubnov; Shlomo,7,0,20,13
1656834787451,ECE 45,A01,083139,Congero; Spencer William,5,0,75,70
1656834793484,ECE 65,A50,083695,Saad; Andrew S,12,0,30,18
1656834793484,ECE 65,A51,095125,Saad; Andrew S,25,0,26,1
1656834799507,ECE 109,A01,091882,Touri; Behrouz,16,0,70,54
1656834805536,ECE 180,A00,083140,Abi Samra; Nicholas Camill,0,0,30,30
1656834805536,ECE 180,B00,083141,Abi Samra; Nicholas Camill,0,0,30,30
1656834811562,MATH 10A,A01,083735,Patchell; Gregory David,1,0,30,29
1656834811562,MATH 10A,A02,083736,Patchell; Gregory David,20,0,30,10
1656834811562,MATH 10A,A03,083737,Patchell; Gregory David,15,0,30,15
1656834817589,MATH 10B,A01,083207,Lim; Seonhee,7,0,34,27
1656834817589,MATH 10B,A02,083208,Lim; Seonhee,9,0,35,26
1656834817589,MATH 10B,A03,093472,Lim; Seonhee,4,0,34,30
1656834817589,MATH 10B,B01,083739,Sinha; Shubham,9,0,30,21
1656834823617,MATH 18,A01,083743,Cinel; Cameron Alexander,6,0,30,24
1656834823617,MATH 18,A02,083744,Cinel; Cameron Alexander,15,0,30,15
1656834823617,MATH 18,A03,083745,Cinel; Cameron Alexander,8,0,30,22
1656834823617,MATH 18,B01,083748,Rideout; David Porter,3,0,37,34
1656834823617,MATH 18,B02,083749,Rideout; David Porter,3,0,36,33
1656834823617,MATH 18,B03,083750,Rideout; David Porter,2,0,37,35
1656834823617,MATH 18,B04,083751,Rideout; David Porter,5,0,36,31
1656834823617,MATH 18,B05,093473,Rideout; David Porter,4,0,36,32
1656834823617,MATH 18,B06,093474,Rideout; David Porter,5,0,36,31
1656834829640,MATH 20A,A01,083754,Zheng; Zequn,12,0,40,28
1656834835664,MATH 20B,A01,083756,Briones; Jor-el Thomas Caparas,1,0,36,35
1656834835664,MATH 20B,A02,083757,Briones; Jor-el Thomas Caparas,1,0,36,35
1656834835664,MATH 20B,A03,093475,Briones; Jor-el Thomas Caparas,0,0,36,36
1656834841701,MATH 20C,A01,083760,Briones; Jor-el Thomas Caparas,1,0,35,34
1656834841701,MATH 20C,A02,083761,Briones; Jor-el Thomas Caparas,8,0,35,27
1656834841701,MATH 20C,A03,093476,Briones; Jor-el Thomas Caparas,0,1,36,36
1656834841701,MATH 20C,B01,083762,Bach; Quang Tran,0,0,30,30
1656834847725,MATH 20D,A01,083765,Tran; Brian Kha,4,0,30,26
1656834847725,MATH 20D,A02,083766,Tran; Brian Kha,4,0,30,26
1656834847725,MATH 20D,A03,083767,Tran; Brian Kha,2,0,30,28
1656834853757,MATH 20E,A01,083771,Ganguly; Soumya,5,0,32,27
1656834853757,MATH 20E,A02,083772,Ganguly; Soumya,6,0,32,26
1656834853757,MATH 20E,B01,083773,Ciotti; Benjamin,18,0,35,17
1656834853757,MATH 20E,B02,083774,Ciotti; Benjamin,17,0,35,18
1656834859791,MATH 103A,A01,083777,Greenfeld; Be'Eri,2,0,36,34
1656834859791,MATH 103A,A02,083778,Greenfeld; Be'Eri,5,0,36,31
1656834859791,MATH 103A,A03,093561,Greenfeld; Be'Eri,4,0,36,32
1656834859791,MATH 103A,B01,083779,Greenfeld; Be'Eri,6,0,36,30
1656834859791,MATH 103A,B02,083780,Greenfeld; Be'Eri,2,0,36,34
1656834859791,MATH 103A,B03,093562,Greenfeld; Be'Eri,2,0,36,34
1656834865816,MATH 105,A01,085443,Carter; Anne Toulson,13,0,35,22
1656834865816,MATH 105,A02,093477,Carter; Anne Toulson,20,0,35,15
1656834871842,MATH 109,A01,083213,Ganzberger; Geoffrey Michael,2,0,34,32
1656834871842,MATH 109,A02,083214,Ganzberger; Geoffrey Michael,2,0,34,32
1656834871842,MATH 109,A03,093478,Ganzberger; Geoffrey Michael,1,0,34,33
1656834871842,MATH 109,B01,083215,Ganzberger; Geoffrey Michael,1,0,32,31
1656834871842,MATH 109,B02,083216,Ganzberger; Geoffrey Michael,1,0,32,31
1656834871842,MATH 109,B03,093479,Ganzberger; Geoffrey Michael,6,0,32,26
1656834877877,MATH 142A,A01,083219,Chow; Bennett,6,0,32,26
1656834877877,MATH 142A,A02,083220,Chow; Bennett,9,0,32,23
1656834877877,MATH 142A,A03,093480,Chow; Bennett,7,0,32,25
1656834877877,MATH 142A,B03,093481,Chow; Bennett,7,0,32,25
1656834877877,MATH 142A,B04,093558,Chow; Bennett,10,0,32,22
1656834877877,MATH 142A,B05,093559,Chow; Bennett,6,0,32,26
1656834883906,MATH 193A,A01,083224,Rotar; Vladimir,6,0,34,28
1656834883906,MATH 193A,A02,083225,Rotar; Vladimir,3,0,34,31
1656834883906,MATH 193A,A03,083781,Rotar; Vladimir,1,0,34,33
1656834883906,MATH 193A,A04,083782,Rotar; Vladimir,6,0,34,28
1656834883906,MATH 193A,A05,093482,Rotar; Vladimir,6,0,34,28
1656834889931,MATH 197,001,091859,McAuley; Julian John,9999,0,9999,0
1656834889931,MATH 197,002,095566,Kedlaya; Kiran S.,9997,0,9999,2
1656834889931,MATH 197,003,095567,Xiao; Ming,9999,0,9999,0
1656834889931,MATH 197,004,095571,Perols; Johan Lars,9998,0,9999,1
1656834896996,COGS 9,A01,083615,Shannon; Kyle Michael,6,0,75,69
1656834903019,COGS 11,A01,083617,Boyle; Mary E. T.,18,0,48,30
1656834909047,COGS 13,A01,083071,Bastos; Amalia Pinkusfeld,8,0,71,63
1656834915075,COGS 14A,A01,092681,Semenuks; Arturs,0,1,100,100
1656834921097,COGS 14B,A01,083073,Cheng; Tzu-Han,5,0,63,58
1656834927120,COGS 17,A01,092677,Semenuks; Arturs,4,0,81,77
1656834933144,COGS 100,A01,083619,Allen; Michael Gordon,15,0,70,55
1656834939169,COGS 101A,A01,083621,Davis; Joshua Daniel,9,0,68,59
1656834945193,COGS 101B,A01,091572,Allen; Michael Gordon,8,0,65,57
1656834951217,COGS 101C,A01,083625,Delgado; Tania,17,0,35,18
1656834957244,COGS 107A,A01,083627,Boyle; Mary E. T.,13,0,60,47
1656834963267,COGS 118A,A01,083075,Gupta; Anjum,15,0,76,61
1656834969299,CSE 3,A50,083646,Miranda; Gregory Joseph,22,0,50,28
1656834975326,CSE 8A,A50,083650,Miranda; Gregory Joseph,17,1,56,39
1656834981350,CSE 11,A01,083080,Cao; Yingjun,4,15,40,36
1656834987377,CSE 12,A01,083652,Krause-Levy; Sophia Louisa,20,1,120,100
1656834993425,CSE 15L,A01,083654,Morris; Justin Loren,8,0,50,42
1656834993425,CSE 15L,A02,083655,Morris; Justin Loren,8,0,50,42
1656834999450,CSE 20,A01,083657,Tran; Khoa Dang,37,0,80,43
1656835005478,CSE 21,A01,095574,Bach; Quang Tran,21,0,48,27
1656835011506,CSE 30,A01,083084,Eldon; John,4,0,80,76
1656835011506,CSE 30,B01,095061,Bhaskar; Nishant,6,0,50,44
1656835017533,CSE 100,A01,083659,Cao; Yingjun,2,4,70,68
1656835023559,CSE 134B,A01,083661,Powell; Thomas Allan,19,0,100,81
1656835029586,CSE 140,A01,083663,Gungor; Onat,14,0,85,71
1656835035611,CSE 140L,A01,083088,Eldon; John,16,0,100,84
1656835041638,CSE 175,A01,083665,Kumar; Rakesh,3,0,25,22
1656835047663,CSE 190,A00,092507,Dubnov; Shlomo,7,0,20,13
1656835053686,ECE 45,A01,083139,Congero; Spencer William,5,0,75,70
1656835059710,ECE 65,A50,083695,Saad; Andrew S,12,0,30,18
1656835059710,ECE 65,A51,095125,Saad; Andrew S,25,0,26,1
1656835065733,ECE 109,A01,091882,Touri; Behrouz,16,0,70,54
1656835071761,ECE 180,A00,083140,Abi Samra; Nicholas Camill,0,0,30,30
1656835071761,ECE 180,B00,083141,Abi Samra; Nicholas Camill,0,0,30,30
1656835077785,MATH 10A,A01,083735,Patchell; Gregory David,1,0,30,29
1656835077785,MATH 10A,A02,083736,Patchell; Gregory David,20,0,30,10
1656835077785,MATH 10A,A03,083737,Patchell; Gregory David,15,0,30,15
1656835083815,MATH 10B,A01,083207,Lim; Seonhee,7,0,34,27
1656835083815,MATH 10B,A02,083208,Lim; Seonhee,9,0,35,26
1656835083815,MATH 10B,A03,093472,Lim; Seonhee,4,0,34,30
1656835083815,MATH 10B,B01,083739,Sinha; Shubham,9,0,30,21
1656835089840,MATH 18,A01,083743,Cinel; Cameron Alexander,6,0,30,24
1656835089840,MATH 18,A02,083744,Cinel; Cameron Alexander,15,0,30,15
1656835089840,MATH 18,A03,083745,Cinel; Cameron Alexander,8,0,30,22
1656835089840,MATH 18,B01,083748,Rideout; David Porter,3,0,37,34
1656835089840,MATH 18,B02,083749,Rideout; David Porter,3,0,36,33
1656835089840,MATH 18,B03,083750,Rideout; David Porter,2,0,37,35
1656835089840,MATH 18,B04,083751,Rideout; David Porter,5,0,36,31
1656835089840,MATH 18,B05,093473,Rideout; David Porter,4,0,36,32
1656835089840,MATH 18,B06,093474,Rideout; David Porter,5,0,36,31
1656835095864,MATH 20A,A01,083754,Zheng; Zequn,12,0,40,28
1656835101899,MATH 20B,A01,083756,Briones; Jor-el Thomas Caparas,1,0,36,35
1656835101899,MATH 20B,A02,083757,Briones; Jor-el Thomas Caparas,1,0,36,35
1656835101899,MATH 20B,A03,093475,Briones; Jor-el Thomas Caparas,0,0,36,36
1656835107924,MATH 20C,A01,083760,Briones; Jor-el Thomas Caparas,1,0,35,34
1656835107924,MATH 20C,A02,083761,Briones; Jor-el Thomas Caparas,8,0,35,27
1656835107924,MATH 20C,A03,093476,Briones; Jor-el Thomas Caparas,0,1,36,36
1656835107924,MATH 20C,B01,083762,Bach; Quang Tran,0,0,30,30
1656835113953,MATH 20D,A01,083765,Tran; Brian Kha,4,0,30,26
1656835113953,MATH 20D,A02,083766,Tran; Brian Kha,4,0,30,26
1656835113953,MATH 20D,A03,083767,Tran; Brian Kha,2,0,30,28
1656835119978,MATH 20E,A01,083771,Ganguly; Soumya,5,0,32,27
1656835119978,MATH 20E,A02,083772,Ganguly; Soumya,6,0,32,26
1656835119978,MATH 20E,B01,083773,Ciotti; Benjamin,18,0,35,17
1656835119978,MATH 20E,B02,083774,Ciotti; Benjamin,17,0,35,18
1656835126002,MATH 103A,A01,083777,Greenfeld; Be'Eri,2,0,36,34
1656835126002,MATH 103A,A02,083778,Greenfeld; Be'Eri,5,0,36,31
1656835126002,MATH 103A,A03,093561,Greenfeld; Be'Eri,4,0,36,32
1656835126002,MATH 103A,B01,083779,Greenfeld; Be'Eri,6,0,36,30
1656835126002,MATH 103A,B02,083780,Greenfeld; Be'Eri,2,0,36,34
1656835126002,MATH 103A,B03,093562,Greenfeld; Be'Eri,2,0,36,34
1656835132033,MATH 105,A01,085443,Carter; Anne Toulson,13,0,35,22
1656835132033,MATH 105,A02,093477,Carter; Anne Toulson,20,0,35,15
1656835138065,MATH 109,A01,083213,Ganzberger; Geoffrey Michael,2,0,34,32
1656835138065,MATH 109,A02,083214,Ganzberger; Geoffrey Michael,2,0,34,32
1656835138065,MATH 109,A03,093478,Ganzberger; Geoffrey Michael,1,0,34,33
1656835138065,MATH 109,B01,083215,Ganzberger; Geoffrey Michael,1,0,32,31
1656835138065,MATH 109,B02,083216,Ganzberger; Geoffrey Michael,1,0,32,31
1656835138065,MATH 109,B03,093479,Ganzberger; Geoffrey Michael,6,0,32,26
1656835144091,MATH 142A,A01,083219,Chow; Bennett,6,0,32,26
1656835144091,MATH 142A,A02,083220,Chow; Bennett,9,0,32,23
1656835144091,MATH 142A,A03,093480,Chow; Bennett,7,0,32,25
1656835144091,MATH 142A,B03,093481,Chow; Bennett,7,0,32,25
1656835144091,MATH 142A,B04,093558,Chow; Bennett,10,0,32,22
1656835144091,MATH 142A,B05,093559,Chow; Bennett,6,0,32,26
1656835150121,MATH 193A,A01,083224,Rotar; Vladimir,6,0,34,28
1656835150121,MATH 193A,A02,083225,Rotar; Vladimir,3,0,34,31
1656835150121,MATH 193A,A03,083781,Rotar; Vladimir,1,0,34,33
1656835150121,MATH 193A,A04,083782,Rotar; Vladimir,6,0,34,28
1656835150121,MATH 193A,A05,093482,Rotar; Vladimir,6,0,34,28
1656835156147,MATH 197,001,091859,McAuley; Julian John,9999,0,9999,0
1656835156147,MATH 197,002,095566,Kedlaya; Kiran S.,9997,0,9999,2
1656835156147,MATH 197,003,095567,Xiao; Ming,9999,0,9999,0
1656835156147,MATH 197,004,095571,Perols; Johan Lars,9998,0,9999,1
1656835163215,COGS 9,A01,083615,Shannon; Kyle Michael,6,0,75,69
1656835169238,COGS 11,A01,083617,Boyle; Mary E. T.,18,0,48,30
1656835175264,COGS 13,A01,083071,Bastos; Amalia Pinkusfeld,8,0,71,63
1656835181285,COGS 14A,A01,092681,Semenuks; Arturs,0,1,100,100
1656835187308,COGS 14B,A01,083073,Cheng; Tzu-Han,5,0,63,58
1656835193332,COGS 17,A01,092677,Semenuks; Arturs,4,0,81,77
1656835199367,COGS 100,A01,083619,Allen; Michael Gordon,15,0,70,55
1656835205392,COGS 101A,A01,083621,Davis; Joshua Daniel,9,0,68,59
1656835211418,COGS 101B,A01,091572,Allen; Michael Gordon,8,0,65,57
1656835217442,COGS 101C,A01,083625,Delgado; Tania,17,0,35,18
1656835223565,COGS 107A,A01,083627,Boyle; Mary E. T.,13,0,60,47
1656835229591,COGS 118A,A01,083075,Gupta; Anjum,15,0,76,61
1656835235629,CSE 3,A50,083646,Miranda; Gregory Joseph,22,0,50,28
1656835241652,CSE 8A,A50,083650,Miranda; Gregory Joseph,17,1,56,39
1656835247687,CSE 11,A01,083080,Cao; Yingjun,4,15,40,36
1656835253726,CSE 12,A01,083652,Krause-Levy; Sophia Louisa,20,1,120,100
1656835259754,CSE 15L,A01,083654,Morris; Justin Loren,8,0,50,42
1656835259754,CSE 15L,A02,083655,Morris; Justin Loren,8,0,50,42
1656835265776,CSE 20,A01,083657,Tran; Khoa Dang,37,0,80,43
1656835271803,CSE 21,A01,095574,Bach; Quang Tran,21,0,48,27
1656835277829,CSE 30,A01,083084,Eldon; John,4,0,80,76
1656835277829,CSE 30,B01,095061,Bhaskar; Nishant,6,0,50,44
1656835283853,CSE 100,A01,083659,Cao; Yingjun,2,4,70,68
1656835289878,CSE 134B,A01,083661,Powell; Thomas Allan,19,0,100,81
1656835295902,CSE 140,A01,083663,Gungor; Onat,14,0,85,71
1656835301929,CSE 140L,A01,083088,Eldon; John,16,0,100,84
1656835307956,CSE 175,A01,083665,Kumar; Rakesh,3,0,25,22
1656835313979,CSE 190,A00,092507,Dubnov; Shlomo,7,0,20,13
1656835320012,ECE 45,A01,083139,Congero; Spencer William,5,0,75,70
1656835326040,ECE 65,A50,083695,Saad; Andrew S,12,0,30,18
1656835326040,ECE 65,A51,095125,Saad; Andrew S,25,0,26,1
1656835332065,ECE 109,A01,091882,Touri; Behrouz,16,0,70,54
1656835338091,ECE 180,A00,083140,Abi Samra; Nicholas Camill,0,0,30,30
1656835338091,ECE 180,B00,083141,Abi Samra; Nicholas Camill,0,0,30,30
1656835344116,MATH 10A,A01,083735,Patchell; Gregory David,1,0,30,29
1656835344116,MATH 10A,A02,083736,Patchell; Gregory David,20,0,30,10
1656835344116,MATH 10A,A03,083737,Patchell; Gregory David,15,0,30,15
1656835350145,MATH 10B,A01,083207,Lim; Seonhee,7,0,34,27
1656835350145,MATH 10B,A02,083208,Lim; Seonhee,9,0,35,26
1656835350145,MATH 10B,A03,093472,Lim; Seonhee,4,0,34,30
1656835350145,MATH 10B,B01,083739,Sinha; Shubham,9,0,30,21
1656835356177,MATH 18,A01,083743,Cinel; Cameron Alexander,6,0,30,24
1656835356177,MATH 18,A02,083744,Cinel; Cameron Alexander,15,0,30,15
1656835356177,MATH 18,A03,083745,Cinel; Cameron Alexander,8,0,30,22
1656835356177,MATH 18,B01,083748,Rideout; David Porter,3,0,37,34
1656835356177,MATH 18,B02,083749,Rideout; David Porter,3,0,36,33
1656835356177,MATH 18,B03,083750,Rideout; David Porter,2,0,37,35
1656835356177,MATH 18,B04,083751,Rideout; David Porter,5,0,36,31
1656835356177,MATH 18,B05,093473,Rideout; David Porter,4,0,36,32
1656835356177,MATH 18,B06,093474,Rideout; David Porter,5,0,36,31
1656835362200,MATH 20A,A01,083754,Zheng; Zequn,12,0,40,28
1656835368237,MATH 20B,A01,083756,Briones; Jor-el Thomas Caparas,1,0,36,35
1656835368237,MATH 20B,A02,083757,Briones; Jor-el Thomas Caparas,1,0,36,35
1656835368237,MATH 20B,A03,093475,Briones; Jor-el Thomas Caparas,0,0,36,36
1656835374265,MATH 20C,A01,083760,Briones; Jor-el Thomas Caparas,1,0,35,34
1656835374265,MATH 20C,A02,083761,Briones; Jor-el Thomas Caparas,8,0,35,27
1656835374265,MATH 20C,A03,093476,Briones; Jor-el Thomas Caparas,0,1,36,36
1656835374265,MATH 20C,B01,083762,Bach; Quang Tran,0,0,30,30
1656835380290,MATH 20D,A01,083765,Tran; Brian Kha,4,0,30,26
1656835380290,MATH 20D,A02,083766,Tran; Brian Kha,4,0,30,26
1656835380290,MATH 20D,A03,083767,Tran; Brian Kha,2,0,30,28
1656835386314,MATH 20E,A01,083771,Ganguly; Soumya,5,0,32,27
1656835386314,MATH 20E,A02,083772,Ganguly; Soumya,6,0,32,26
1656835386314,MATH 20E,B01,083773,Ciotti; Benjamin,18,0,35,17
1656835386314,MATH 20E,B02,083774,Ciotti; Benjamin,17,0,35,18
1656835392346,MATH 103A,A01,083777,Greenfeld; Be'Eri,2,0,36,34
1656835392346,MATH 103A,A02,083778,Greenfeld; Be'Eri,5,0,36,31
1656835392346,MATH 103A,A03,093561,Greenfeld; Be'Eri,4,0,36,32
1656835392346,MATH 103A,B01,083779,Greenfeld; Be'Eri,6,0,36,30
1656835392346,MATH 103A,B02,083780,Greenfeld; Be'Eri,2,0,36,34
1656835392346,MATH 103A,B03,093562,Greenfeld; Be'Eri,2,0,36,34
1656835398376,MATH 105,A01,085443,Carter; Anne Toulson,13,0,35,22
1656835398376,MATH 105,A02,093477,Carter; Anne Toulson,20,0,35,15
1656835404405,MATH 109,A01,083213,Ganzberger; Geoffrey Michael,2,0,34,32
1656835404405,MATH 109,A02,083214,Ganzberger; Geoffrey Michael,2,0,34,32
1656835404405,MATH 109,A03,093478,Ganzberger; Geoffrey Michael,1,0,34,33
1656835404405,MATH 109,B01,083215,Ganzberger; Geoffrey Michael,1,0,32,31
1656835404405,MATH 109,B02,083216,Ganzberger; Geoffrey Michael,1,0,32,31
1656835404405,MATH 109,B03,093479,Ganzberger; Geoffrey Michael,6,0,32,26
1656835410435,MATH 142A,A01,083219,Chow; Bennett,6,0,32,26
1656835410435,MATH 142A,A02,083220,Chow; Bennett,9,0,32,23
1656835410435,MATH 142A,A03,093480,Chow; Bennett,7,0,32,25
1656835410435,MATH 142A,B03,093481,Chow; Bennett,7,0,32,25
1656835410435,MATH 142A,B04,093558,Chow; Bennett,10,0,32,22
1656835410435,MATH 142A,B05,093559,Chow; Bennett,6,0,32,26
1656835416465,MATH 193A,A01,083224,Rotar; Vladimir,6,0,34,28
1656835416465,MATH 193A,A02,083225,Rotar; Vladimir,3,0,34,31
1656835416465,MATH 193A,A03,083781,Rotar; Vladimir,1,0,34,33
1656835416465,MATH 193A,A04,083782,Rotar; Vladimir,6,0,34,28
1656835416465,MATH 193A,A05,093482,Rotar; Vladimir,6,0,34,28
1656835422495,MATH 197,001,091859,McAuley; Julian John,9999,0,9999,0
1656835422495,MATH 197,002,095566,Kedlaya; Kiran S.,9997,0,9999,2
1656835422495,MATH 197,003,095567,Xiao; Ming,9999,0,9999,0
1656835422495,MATH 197,004,095571,Perols; Johan Lars,9998,0,9999,1
1656835429554,COGS 9,A01,083615,Shannon; Kyle Michael,6,0,75,69
1656835435582,COGS 11,A01,083617,Boyle; Mary E. T.,18,0,48,30
1656835441607,COGS 13,A01,083071,Bastos; Amalia Pinkusfeld,8,0,71,63
1656835447631,COGS 14A,A01,092681,Semenuks; Arturs,0,1,100,100
1656835453654,COGS 14B,A01,083073,Cheng; Tzu-Han,5,0,63,58
1656835459680,COGS 17,A01,092677,Semenuks; Arturs,4,0,81,77
1656835465703,COGS 100,A01,083619,Allen; Michael Gordon,15,0,70,55
1656835471725,COGS 101A,A01,083621,Davis; Joshua Daniel,9,0,68,59
1656835477746,COGS 101B,A01,091572,Allen; Michael Gordon,8,0,65,57
1656835483775,COGS 101C,A01,083625,Delgado; Tania,17,0,35,18
1656835489798,COGS 107A,A01,083627,Boyle; Mary E. T.,13,0,60,47
1656835495825,COGS 118A,A01,083075,Gupta; Anjum,15,0,76,61
1656835501866,CSE 3,A50,083646,Miranda; Gregory Joseph,22,0,50,28
1656835507889,CSE 8A,A50,083650,Miranda; Gregory Joseph,17,1,56,39
1656835513912,CSE 11,A01,083080,Cao; Yingjun,4,15,40,36
1656835519936,CSE 12,A01,083652,Krause-Levy; Sophia Louisa,20,1,120,100
1656835525961,CSE 15L,A01,083654,Morris; Justin Loren,8,0,50,42
1656835525961,CSE 15L,A02,083655,Morris; Justin Loren,8,0,50,42
1656835531985,CSE 20,A01,083657,Tran; Khoa Dang,37,0,80,43
1656835538010,CSE 21,A01,095574,Bach; Quang Tran,21,0,48,27
1656835544040,CSE 30,A01,083084,Eldon; John,4,0,80,76
1656835544040,CSE 30,B01,095061,Bhaskar; Nishant,6,0,50,44
1656835550065,CSE 100,A01,083659,Cao; Yingjun,2,4,70,68
1656835556092,CSE 134B,A01,083661,Powell; Thomas Allan,19,0,100,81
1656835562120,CSE 140,A01,083663,Gungor; Onat,14,0,85,71
1656835568143,CSE 140L,A01,083088,Eldon; John,16,0,100,84
1656835574170,CSE 175,A01,083665,Kumar; Rakesh,3,0,25,22
1656835580194,CSE 190,A00,092507,Dubnov; Shlomo,7,0,20,13
1656835586223,ECE 45,A01,083139,Congero; Spencer William,5,0,75,70
1656835592247,ECE 65,A50,083695,Saad; Andrew S,12,0,30,18
1656835592247,ECE 65,A51,095125,Saad; Andrew S,25,0,26,1
1656835598274,ECE 109,A01,091882,Touri; Behrouz,16,0,70,54
1656835604299,ECE 180,A00,083140,Abi Samra; Nicholas Camill,0,0,30,30
1656835604299,ECE 180,B00,083141,Abi Samra; Nicholas Camill,0,0,30,30
1656835610331,MATH 10A,A01,083735,Patchell; Gregory David,1,0,30,29
1656835610331,MATH 10A,A02,083736,Patchell; Gregory David,20,0,30,10
1656835610331,MATH 10A,A03,083737,Patchell; Gregory David,15,0,30,15
1656835616362,MATH 10B,A01,083207,Lim; Seonhee,7,0,34,27
1656835616362,MATH 10B,A02,083208,Lim; Seonhee,9,0,35,26
1656835616362,MATH 10B,A03,093472,Lim; Seonhee,4,0,34,30
1656835616362,MATH 10B,B01,083739,Sinha; Shubham,9,0,30,21
1656835622387,MATH 18,A01,083743,Cinel; Cameron Alexander,6,0,30,24
1656835622387,MATH 18,A02,083744,Cinel; Cameron Alexander,15,0,30,15
1656835622387,MATH 18,A03,083745,Cinel; Cameron Alexander,8,0,30,22
1656835622387,MATH 18,B01,083748,Rideout; David Porter,3,0,37,34
1656835622387,MATH 18,B02,083749,Rideout; David Porter,3,0,36,33
1656835622387,MATH 18,B03,083750,Rideout; David Porter,2,0,37,35
1656835622387,MATH 18,B04,083751,Rideout; David Porter,5,0,36,31
1656835622387,MATH 18,B05,093473,Rideout; David Porter,4,0,36,32
1656835622387,MATH 18,B06,093474,Rideout; David Porter,5,0,36,31
1656835628411,MATH 20A,A01,083754,Zheng; Zequn,12,0,40,28
1656835634443,MATH 20B,A01,083756,Briones; Jor-el Thomas Caparas,1,0,36,35
1656835634443,MATH 20B,A02,083757,Briones; Jor-el Thomas Caparas,1,0,36,35
1656835634443,MATH 20B,A03,093475,Briones; Jor-el Thomas Caparas,0,0,36,36
1656835640471,MATH 20C,A01,083760,Briones; Jor-el Thomas Caparas,1,0,35,34
1656835640471,MATH 20C,A02,083761,Briones; Jor-el Thomas Caparas,8,0,35,27
1656835640471,MATH 20C,A03,093476,Briones; Jor-el Thomas Caparas,0,1,36,36
1656835640471,MATH 20C,B01,083762,Bach; Quang Tran,0,0,30,30
1656835646496,MATH 20D,A01,083765,Tran; Brian Kha,4,0,30,26
1656835646496,MATH 20D,A02,083766,Tran; Brian Kha,4,0,30,26
1656835646496,MATH 20D,A03,083767,Tran; Brian Kha,2,0,30,28
1656835652525,MATH 20E,A01,083771,Ganguly; Soumya,5,0,32,27
1656835652525,MATH 20E,A02,083772,Ganguly; Soumya,6,0,32,26
1656835652525,MATH 20E,B01,083773,Ciotti; Benjamin,18,0,35,17
1656835652525,MATH 20E,B02,083774,Ciotti; Benjamin,17,0,35,18
1656835658549,MATH 103A,A01,083777,Greenfeld; Be'Eri,2,0,36,34
1656835658549,MATH 103A,A02,083778,Greenfeld; Be'Eri,5,0,36,31
1656835658549,MATH 103A,A03,093561,Greenfeld; Be'Eri,4,0,36,32
1656835658549,MATH 103A,B01,083779,Greenfeld; Be'Eri,6,0,36,30
1656835658549,MATH 103A,B02,083780,Greenfeld; Be'Eri,2,0,36,34
1656835658549,MATH 103A,B03,093562,Greenfeld; Be'Eri,2,0,36,34
1656835664577,MATH 105,A01,085443,Carter; Anne Toulson,13,0,35,22
1656835664577,MATH 105,A02,093477,Carter; Anne Toulson,20,0,35,15
1656835670604,MATH 109,A01,083213,Ganzberger; Geoffrey Michael,2,0,34,32
1656835670604,MATH 109,A02,083214,Ganzberger; Geoffrey Michael,2,0,34,32
1656835670604,MATH 109,A03,093478,Ganzberger; Geoffrey Michael,1,0,34,33
1656835670604,MATH 109,B01,083215,Ganzberger; Geoffrey Michael,1,0,32,31
1656835670604,MATH 109,B02,083216,Ganzberger; Geoffrey Michael,1,0,32,31
1656835670604,MATH 109,B03,093479,Ganzberger; Geoffrey Michael,6,0,32,26
1656835676635,MATH 142A,A01,083219,Chow; Bennett,6,0,32,26
1656835676635,MATH 142A,A02,083220,Chow; Bennett,9,0,32,23
1656835676635,MATH 142A,A03,093480,Chow; Bennett,7,0,32,25
1656835676635,MATH 142A,B03,093481,Chow; Bennett,7,0,32,25
1656835676635,MATH 142A,B04,093558,Chow; Bennett,10,0,32,22
1656835676635,MATH 142A,B05,093559,Chow; Bennett,6,0,32,26
1656835682658,MATH 193A,A01,083224,Rotar; Vladimir,6,0,34,28
1656835682658,MATH 193A,A02,083225,Rotar; Vladimir,3,0,34,31
1656835682658,MATH 193A,A03,083781,Rotar; Vladimir,1,0,34,33
1656835682658,MATH 193A,A04,083782,Rotar; Vladimir,6,0,34,28
1656835682658,MATH 193A,A05,093482,Rotar; Vladimir,6,0,34,28
1656835688683,MATH 197,001,091859,McAuley; Julian John,9999,0,9999,0
1656835688683,MATH 197,002,095566,Kedlaya; Kiran S.,9997,0,9999,2
1656835688683,MATH 197,003,095567,Xiao; Ming,9999,0,9999,0
1656835688683,MATH 197,004,095571,Perols; Johan Lars,9998,0,9999,1
1656835695737,COGS 9,A01,083615,Shannon; Kyle Michael,6,0,75,69
1656835701774,COGS 11,A01,083617,Boyle; Mary E. T.,18,0,48,30
1656835707803,COGS 13,A01,083071,Bastos; Amalia Pinkusfeld,8,0,71,63
1656835713860,COGS 14A,A01,092681,Semenuks; Arturs,0,1,100,100
1656835719884,COGS 14B,A01,083073,Cheng; Tzu-Han,5,0,63,58
1656835725907,COGS 17,A01,092677,Semenuks; Arturs,4,0,81,77
1656835731929,COGS 100,A01,083619,Allen; Michael Gordon,15,0,70,55
1656835737954,COGS 101A,A01,083621,Davis; Joshua Daniel,9,0,68,59
1656835743979,COGS 101B,A01,091572,Allen; Michael Gordon,8,0,65,57
1656835750004,COGS 101C,A01,083625,Delgado; Tania,17,0,35,18
1656835756031,COGS 107A,A01,083627,Boyle; Mary E. T.,13,0,60,47
1656835762055,COGS 118A,A01,083075,Gupta; Anjum,15,0,76,61
1656835768083,CSE 3,A50,083646,Miranda; Gregory Joseph,22,0,50,28
1656835774109,CSE 8A,A50,083650,Miranda; Gregory Joseph,17,1,56,39
1656835780135,CSE 11,A01,083080,Cao; Yingjun,4,15,40,36
1656835786163,CSE 12,A01,083652,Krause-Levy; Sophia Louisa,20,1,120,100
1656835792187,CSE 15L,A01,083654,Morris; Justin Loren,8,0,50,42
1656835792187,CSE 15L,A02,083655,Morris; Justin Loren,8,0,50,42
1656835798210,CSE 20,A01,083657,Tran; Khoa Dang,37,0,80,43
1656835804237,CSE 21,A01,095574,Bach; Quang Tran,21,0,48,27
1656835810264,CSE 30,A01,083084,Eldon; John,4,0,80,76
1656835810264,CSE 30,B01,095061,Bhaskar; Nishant,6,0,50,44
1656835816292,CSE 100,A01,083659,Cao; Yingjun,2,4,70,68
1656835822388,CSE 134B,A01,083661,Powell; Thomas Allan,19,0,100,81
1656835828415,CSE 140,A01,083663,Gungor; Onat,14,0,85,71
1656835834443,CSE 140L,A01,083088,Eldon; John,16,0,100,84
1656835840467,CSE 175,A01,083665,Kumar; Rakesh,3,0,25,22
1656835846490,CSE 190,A00,092507,Dubnov; Shlomo,7,0,20,13
1656835852514,ECE 45,A01,083139,Congero; Spencer William,5,0,75,70
1656835858539,ECE 65,A50,083695,Saad; Andrew S,12,0,30,18
1656835858539,ECE 65,A51,095125,Saad; Andrew S,25,0,26,1
1656835864564,ECE 109,A01,091882,Touri; Behrouz,16,0,70,54
1656835870588,ECE 180,A00,083140,Abi Samra; Nicholas Camill,0,0,30,30
1656835870588,ECE 180,B00,083141,Abi Samra; Nicholas Camill,0,0,30,30
1656835876616,MATH 10A,A01,083735,Patchell; Gregory David,1,0,30,29
1656835876616,MATH 10A,A02,083736,Patchell; Gregory David,20,0,30,10
1656835876616,MATH 10A,A03,083737,Patchell; Gregory David,15,0,30,15
1656835882640,MATH 10B,A01,083207,Lim; Seonhee,7,0,34,27
1656835882640,MATH 10B,A02,083208,Lim; Seonhee,9,0,35,26
1656835882640,MATH 10B,A03,093472,Lim; Seonhee,4,0,34,30
1656835882640,MATH 10B,B01,083739,Sinha; Shubham,9,0,30,21
1656835888670,MATH 18,A01,083743,Cinel; Cameron Alexander,6,0,30,24
1656835888670,MATH 18,A02,083744,Cinel; Cameron Alexander,15,0,30,15
1656835888670,MATH 18,A03,083745,Cinel; Cameron Alexander,8,0,30,22
1656835888670,MATH 18,B01,083748,Rideout; David Porter,3,0,37,34
1656835888670,MATH 18,B02,083749,Rideout; David Porter,3,0,36,33
1656835888670,MATH 18,B03,083750,Rideout; David Porter,2,0,37,35
1656835888670,MATH 18,B04,083751,Rideout; David Porter,5,0,36,31
1656835888670,MATH 18,B05,093473,Rideout; David Porter,4,0,36,32
1656835888670,MATH 18,B06,093474,Rideout; David Porter,5,0,36,31
1656835894705,MATH 20A,A01,083754,Zheng; Zequn,12,0,40,28
1656835900730,MATH 20B,A01,083756,Briones; Jor-el Thomas Caparas,1,0,36,35
1656835900730,MATH 20B,A02,083757,Briones; Jor-el Thomas Caparas,1,0,36,35
1656835900730,MATH 20B,A03,093475,Briones; Jor-el Thomas Caparas,0,0,36,36
1656835906753,MATH 20C,A01,083760,Briones; Jor-el Thomas Caparas,1,0,35,34
1656835906753,MATH 20C,A02,083761,Briones; Jor-el Thomas Caparas,8,0,35,27
1656835906753,MATH 20C,A03,093476,Briones; Jor-el Thomas Caparas,0,1,36,36
1656835906753,MATH 20C,B01,083762,Bach; Quang Tran,0,0,30,30
1656835912776,MATH 20D,A01,083765,Tran; Brian Kha,4,0,30,26
1656835912776,MATH 20D,A02,083766,Tran; Brian Kha,4,0,30,26
1656835912776,MATH 20D,A03,083767,Tran; Brian Kha,2,0,30,28
1656835918806,MATH 20E,A01,083771,Ganguly; Soumya,5,0,32,27
1656835918806,MATH 20E,A02,083772,Ganguly; Soumya,6,0,32,26
1656835918806,MATH 20E,B01,083773,Ciotti; Benjamin,18,0,35,17
1656835918806,MATH 20E,B02,083774,Ciotti; Benjamin,17,0,35,18
1656835924833,MATH 103A,A01,083777,Greenfeld; Be'Eri,2,0,36,34
1656835924833,MATH 103A,A02,083778,Greenfeld; Be'Eri,5,0,36,31
1656835924833,MATH 103A,A03,093561,Greenfeld; Be'Eri,4,0,36,32
1656835924833,MATH 103A,B01,083779,Greenfeld; Be'Eri,6,0,36,30
1656835924833,MATH 103A,B02,083780,Greenfeld; Be'Eri,2,0,36,34
1656835924833,MATH 103A,B03,093562,Greenfeld; Be'Eri,2,0,36,34
1656835930858,MATH 105,A01,085443,Carter; Anne Toulson,13,0,35,22
1656835930858,MATH 105,A02,093477,Carter; Anne Toulson,20,0,35,15
1656835936894,MATH 109,A01,083213,Ganzberger; Geoffrey Michael,2,0,34,32
1656835936894,MATH 109,A02,083214,Ganzberger; Geoffrey Michael,2,0,34,32
1656835936894,MATH 109,A03,093478,Ganzberger; Geoffrey Michael,1,0,34,33
1656835936894,MATH 109,B01,083215,Ganzberger; Geoffrey Michael,1,0,32,31
1656835936894,MATH 109,B02,083216,Ganzberger; Geoffrey Michael,1,0,32,31
1656835936894,MATH 109,B03,093479,Ganzberger; Geoffrey Michael,6,0,32,26
1656835942919,MATH 142A,A01,083219,Chow; Bennett,6,0,32,26
1656835942919,MATH 142A,A02,083220,Chow; Bennett,9,0,32,23
1656835942919,MATH 142A,A03,093480,Chow; Bennett,7,0,32,25
1656835942919,MATH 142A,B03,093481,Chow; Bennett,7,0,32,25
1656835942919,MATH 142A,B04,093558,Chow; Bennett,10,0,32,22
1656835942919,MATH 142A,B05,093559,Chow; Bennett,6,0,32,26
1656835948942,MATH 193A,A01,083224,Rotar; Vladimir,6,0,34,28
1656835948942,MATH 193A,A02,083225,Rotar; Vladimir,3,0,34,31
1656835948942,MATH 193A,A03,083781,Rotar; Vladimir,1,0,34,33
1656835948942,MATH 193A,A04,083782,Rotar; Vladimir,6,0,34,28
1656835948942,MATH 193A,A05,093482,Rotar; Vladimir,6,0,34,28
1656835954976,MATH 197,001,091859,McAuley; Julian John,9999,0,9999,0
1656835954976,MATH 197,002,095566,Kedlaya; Kiran S.,9997,0,9999,2
1656835954976,MATH 197,003,095567,Xiao; Ming,9999,0,9999,0
1656835954976,MATH 197,004,095571,Perols; Johan Lars,9998,0,9999,1
1656835962026,COGS 9,A01,083615,Shannon; Kyle Michael,6,0,75,69
1656835968051,COGS 11,A01,083617,Boyle; Mary E. T.,18,0,48,30
1656835974073,COGS 13,A01,083071,Bastos; Amalia Pinkusfeld,8,0,71,63
1656835980101,COGS 14A,A01,092681,Semenuks; Arturs,0,1,100,100
1656835986140,COGS 14B,A01,083073,Cheng; Tzu-Han,5,0,63,58
1656835992163,COGS 17,A01,092677,Semenuks; Arturs,4,0,81,77
1656835998186,COGS 100,A01,083619,Allen; Michael Gordon,15,0,70,55
1656836004209,COGS 101A,A01,083621,Davis; Joshua Daniel,9,0,68,59
1656836010236,COGS 101B,A01,091572,Allen; Michael Gordon,8,0,65,57
1656836016264,COGS 101C,A01,083625,Delgado; Tania,17,0,35,18
1656836022287,COGS 107A,A01,083627,Boyle; Mary E. T.,13,0,60,47
1656836028312,COGS 118A,A01,083075,Gupta; Anjum,15,0,76,61
1656836034336,CSE 3,A50,083646,Miranda; Gregory Joseph,22,0,50,28
1656836040360,CSE 8A,A50,083650,Miranda; Gregory Joseph,17,1,56,39
1656836046388,CSE 11,A01,083080,Cao; Yingjun,4,15,40,36
1656836052412,CSE 12,A01,083652,Krause-Levy; Sophia Louisa,20,1,120,100
1656836058436,CSE 15L,A01,083654,Morris; Justin Loren,8,0,50,42
1656836058436,CSE 15L,A02,083655,Morris; Justin Loren,8,0,50,42
1656836064463,CSE 20,A01,083657,Tran; Khoa Dang,37,0,80,43
1656836070487,CSE 21,A01,095574,Bach; Quang Tran,21,0,48,27
1656836076511,CSE 30,A01,083084,Eldon; John,4,0,80,76
1656836076511,CSE 30,B01,095061,Bhaskar; Nishant,6,0,50,44
1656836082533,CSE 100,A01,083659,Cao; Yingjun,2,4,70,68
1656836088561,CSE 134B,A01,083661,Powell; Thomas Allan,19,0,100,81
1656836094585,CSE 140,A01,083663,Gungor; Onat,14,0,85,71
1656836100609,CSE 140L,A01,083088,Eldon; John,16,0,100,84
1656836106633,CSE 175,A01,083665,Kumar; Rakesh,3,0,25,22
1656836112658,CSE 190,A00,092507,Dubnov; Shlomo,7,0,20,13
1656836118687,ECE 45,A01,083139,Congero; Spencer William,5,0,75,70
1656836124716,ECE 65,A50,083695,Saad; Andrew S,12,0,30,18
1656836124716,ECE 65,A51,095125,Saad; Andrew S,25,0,26,1
1656836130742,ECE 109,A01,091882,Touri; Behrouz,16,0,70,54
1656836136777,ECE 180,A00,083140,Abi Samra; Nicholas Camill,0,0,30,30
1656836136777,ECE 180,B00,083141,Abi Samra; Nicholas Camill,0,0,30,30
1656836142812,MATH 10A,A01,083735,Patchell; Gregory David,1,0,30,29
1656836142812,MATH 10A,A02,083736,Patchell; Gregory David,20,0,30,10
1656836142812,MATH 10A,A03,083737,Patchell; Gregory David,15,0,30,15
1656836148836,MATH 10B,A01,083207,Lim; Seonhee,7,0,34,27
1656836148836,MATH 10B,A02,083208,Lim; Seonhee,9,0,35,26
1656836148836,MATH 10B,A03,093472,Lim; Seonhee,4,0,34,30
1656836148836,MATH 10B,B01,083739,Sinha; Shubham,9,0,30,21
1656836154862,MATH 18,A01,083743,Cinel; Cameron Alexander,6,0,30,24
1656836154862,MATH 18,A02,083744,Cinel; Cameron Alexander,15,0,30,15
1656836154862,MATH 18,A03,083745,Cinel; Cameron Alexander,8,0,30,22
1656836154862,MATH 18,B01,083748,Rideout; David Porter,3,0,37,34
1656836154862,MATH 18,B02,083749,Rideout; David Porter,3,0,36,33
1656836154862,MATH 18,B03,083750,Rideout; David Porter,2,0,37,35
1656836154862,MATH 18,B04,083751,Rideout; David Porter,5,0,36,31
1656836154862,MATH 18,B05,093473,Rideout; David Porter,4,0,36,32
1656836154862,MATH 18,B06,093474,Rideout; David Porter,5,0,36,31
1656836160889,MATH 20A,A01,083754,Zheng; Zequn,12,0,40,28
1656836166913,MATH 20B,A01,083756,Briones; Jor-el Thomas Caparas,1,0,36,35
1656836166913,MATH 20B,A02,083757,Briones; Jor-el Thomas Caparas,1,0,36,35
1656836166913,MATH 20B,A03,093475,Briones; Jor-el Thomas Caparas,0,0,36,36
1656836172937,MATH 20C,A01,083760,Briones; Jor-el Thomas Caparas,1,0,35,34
1656836172937,MATH 20C,A02,083761,Briones; Jor-el Thomas Caparas,8,0,35,27
1656836172937,MATH 20C,A03,093476,Briones; Jor-el Thomas Caparas,0,1,36,36
1656836172937,MATH 20C,B01,083762,Bach; Quang Tran,0,0,30,30
1656836178961,MATH 20D,A01,083765,Tran; Brian Kha,4,0,30,26
1656836178961,MATH 20D,A02,083766,Tran; Brian Kha,4,0,30,26
1656836178961,MATH 20D,A03,083767,Tran; Brian Kha,2,0,30,28
1656836184989,MATH 20E,A01,083771,Ganguly; Soumya,5,0,32,27
1656836184989,MATH 20E,A02,083772,Ganguly; Soumya,6,0,32,26
1656836184989,MATH 20E,B01,083773,Ciotti; Benjamin,18,0,35,17
1656836184989,MATH 20E,B02,083774,Ciotti; Benjamin,17,0,35,18
1656836191019,MATH 103A,A01,083777,Greenfeld; Be'Eri,2,0,36,34
1656836191019,MATH 103A,A02,083778,Greenfeld; Be'Eri,5,0,36,31
1656836191019,MATH 103A,A03,093561,Greenfeld; Be'Eri,4,0,36,32
1656836191019,MATH 103A,B01,083779,Greenfeld; Be'Eri,6,0,36,30
1656836191019,MATH 103A,B02,083780,Greenfeld; Be'Eri,2,0,36,34
1656836191019,MATH 103A,B03,093562,Greenfeld; Be'Eri,2,0,36,34
1656836197045,MATH 105,A01,085443,Carter; Anne Toulson,13,0,35,22
1656836197045,MATH 105,A02,093477,Carter; Anne Toulson,20,0,35,15
1656836203068,MATH 109,A01,083213,Ganzberger; Geoffrey Michael,2,0,34,32
1656836203068,MATH 109,A02,083214,Ganzberger; Geoffrey Michael,2,0,34,32
1656836203068,MATH 109,A03,093478,Ganzberger; Geoffrey Michael,1,0,34,33
1656836203068,MATH 109,B01,083215,Ganzberger; Geoffrey Michael,1,0,32,31
1656836203068,MATH 109,B02,083216,Ganzberger; Geoffrey Michael,1,0,32,31
1656836203068,MATH 109,B03,093479,Ganzberger; Geoffrey Michael,6,0,32,26
1656836209091,MATH 142A,A01,083219,Chow; Bennett,6,0,32,26
1656836209091,MATH 142A,A02,083220,Chow; Bennett,9,0,32,23
1656836209091,MATH 142A,A03,093480,Chow; Bennett,7,0,32,25
1656836209091,MATH 142A,B03,093481,Chow; Bennett,7,0,32,25
1656836209091,MATH 142A,B04,093558,Chow; Bennett,10,0,32,22
1656836209091,MATH 142A,B05,093559,Chow; Bennett,6,0,32,26
1656836215115,MATH 193A,A01,083224,Rotar; Vladimir,6,0,34,28
1656836215115,MATH 193A,A02,083225,Rotar; Vladimir,3,0,34,31
1656836215115,MATH 193A,A03,083781,Rotar; Vladimir,1,0,34,33
1656836215115,MATH 193A,A04,083782,Rotar; Vladimir,6,0,34,28
1656836215115,MATH 193A,A05,093482,Rotar; Vladimir,6,0,34,28
1656836221141,MATH 197,001,091859,McAuley; Julian John,9999,0,9999,0
1656836221141,MATH 197,002,095566,Kedlaya; Kiran S.,9997,0,9999,2
1656836221141,MATH 197,003,095567,Xiao; Ming,9999,0,9999,0
1656836221141,MATH 197,004,095571,Perols; Johan Lars,9998,0,9999,1
1656836228203,COGS 9,A01,083615,Shannon; Kyle Michael,6,0,75,69
1656836234230,COGS 11,A01,083617,Boyle; Mary E. T.,18,0,48,30
1656836240253,COGS 13,A01,083071,Bastos; Amalia Pinkusfeld,8,0,71,63
1656836246281,COGS 14A,A01,092681,Semenuks; Arturs,0,1,100,100
1656836252309,COGS 14B,A01,083073,Cheng; Tzu-Han,5,0,63,58
1656836258333,COGS 17,A01,092677,Semenuks; Arturs,4,0,81,77
1656836264356,COGS 100,A01,083619,Allen; Michael Gordon,15,0,70,55
1656836270381,COGS 101A,A01,083621,Davis; Joshua Daniel,9,0,68,59
1656836276408,COGS 101B,A01,091572,Allen; Michael Gordon,8,0,65,57
1656836282432,COGS 101C,A01,083625,Delgado; Tania,17,0,35,18
1656836288455,COGS 107A,A01,083627,Boyle; Mary E. T.,13,0,60,47
1656836294479,COGS 118A,A01,083075,Gupta; Anjum,15,0,76,61
1656836300503,CSE 3,A50,083646,Miranda; Gregory Joseph,22,0,50,28
1656836306529,CSE 8A,A50,083650,Miranda; Gregory Joseph,17,1,56,39
1656836312553,CSE 11,A01,083080,Cao; Yingjun,4,15,40,36
1656836318582,CSE 12,A01,083652,Krause-Levy; Sophia Louisa,20,1,120,100
1656836324608,CSE 15L,A01,083654,Morris; Justin Loren,8,0,50,42
1656836324608,CSE 15L,A02,083655,Morris; Justin Loren,8,0,50,42
1656836330633,CSE 20,A01,083657,Tran; Khoa Dang,37,0,80,43
1656836336659,CSE 21,A01,095574,Bach; Quang Tran,21,0,48,27
1656836342684,CSE 30,A01,083084,Eldon; John,4,0,80,76
1656836342684,CSE 30,B01,095061,Bhaskar; Nishant,6,0,50,44
1656836348708,CSE 100,A01,083659,Cao; Yingjun,2,4,70,68
1656836354740,CSE 134B,A01,083661,Powell; Thomas Allan,19,0,100,81
1656836360769,CSE 140,A01,083663,Gungor; Onat,14,0,85,71
1656836366797,CSE 140L,A01,083088,Eldon; John,16,0,100,84
1656836372823,CSE 175,A01,083665,Kumar; Rakesh,3,0,25,22
1656836378850,CSE 190,A00,092507,Dubnov; Shlomo,7,0,20,13
1656836384874,ECE 45,A01,083139,Congero; Spencer William,5,0,75,70
1656836390897,ECE 65,A50,083695,Saad; Andrew S,12,0,30,18
1656836390897,ECE 65,A51,095125,Saad; Andrew S,25,0,26,1
1656836396921,ECE 109,A01,091882,Touri; Behrouz,16,0,70,54
1656836402948,ECE 180,A00,083140,Abi Samra; Nicholas Camill,0,0,30,30
1656836402948,ECE 180,B00,083141,Abi Samra; Nicholas Camill,0,0,30,30
1656836408971,MATH 10A,A01,083735,Patchell; Gregory David,1,0,30,29
1656836408971,MATH 10A,A02,083736,Patchell; Gregory David,20,0,30,10
1656836408971,MATH 10A,A03,083737,Patchell; Gregory David,15,0,30,15
1656836414996,MATH 10B,A01,083207,Lim; Seonhee,7,0,34,27
1656836414996,MATH 10B,A02,083208,Lim; Seonhee,9,0,35,26
1656836414996,MATH 10B,A03,093472,Lim; Seonhee,4,0,34,30
1656836414996,MATH 10B,B01,083739,Sinha; Shubham,9,0,30,21
1656836421097,MATH 18,A01,083743,Cinel; Cameron Alexander,6,0,30,24
1656836421097,MATH 18,A02,083744,Cinel; Cameron Alexander,15,0,30,15
1656836421097,MATH 18,A03,083745,Cinel; Cameron Alexander,8,0,30,22
1656836421097,MATH 18,B01,083748,Rideout; David Porter,3,0,37,34
1656836421097,MATH 18,B02,083749,Rideout; David Porter,3,0,36,33
1656836421097,MATH 18,B03,083750,Rideout; David Porter,2,0,37,35
1656836421097,MATH 18,B04,083751,Rideout; David Porter,5,0,36,31
1656836421097,MATH 18,B05,093473,Rideout; David Porter,4,0,36,32
1656836421097,MATH 18,B06,093474,Rideout; David Porter,5,0,36,31
1656836427120,MATH 20A,A01,083754,Zheng; Zequn,12,0,40,28
1656836433143,MATH 20B,A01,083756,Briones; Jor-el Thomas Caparas,1,0,36,35
1656836433143,MATH 20B,A02,083757,Briones; Jor-el Thomas Caparas,1,0,36,35
1656836433143,MATH 20B,A03,093475,Briones; Jor-el Thomas Caparas,0,0,36,36
1656836439172,MATH 20C,A01,083760,Briones; Jor-el Thomas Caparas,1,0,35,34
1656836439172,MATH 20C,A02,083761,Briones; Jor-el Thomas Caparas,8,0,35,27
1656836439172,MATH 20C,A03,093476,Briones; Jor-el Thomas Caparas,0,1,36,36
1656836439172,MATH 20C,B01,083762,Bach; Quang Tran,0,0,30,30
1656836445199,MATH 20D,A01,083765,Tran; Brian Kha,4,0,30,26
1656836445199,MATH 20D,A02,083766,Tran; Brian Kha,4,0,30,26
1656836445199,MATH 20D,A03,083767,Tran; Brian Kha,2,0,30,28
1656836451222,MATH 20E,A01,083771,Ganguly; Soumya,5,0,32,27
1656836451222,MATH 20E,A02,083772,Ganguly; Soumya,6,0,32,26
1656836451222,MATH 20E,B01,083773,Ciotti; Benjamin,18,0,35,17
1656836451222,MATH 20E,B02,083774,Ciotti; Benjamin,17,0,35,18
1656836457247,MATH 103A,A01,083777,Greenfeld; Be'Eri,2,0,36,34
1656836457247,MATH 103A,A02,083778,Greenfeld; Be'Eri,5,0,36,31
1656836457247,MATH 103A,A03,093561,Greenfeld; Be'Eri,4,0,36,32
1656836457247,MATH 103A,B01,083779,Greenfeld; Be'Eri,6,0,36,30
1656836457247,MATH 103A,B02,083780,Greenfeld; Be'Eri,2,0,36,34
1656836457247,MATH 103A,B03,093562,Greenfeld; Be'Eri,2,0,36,34
1656836463270,MATH 105,A01,085443,Carter; Anne Toulson,13,0,35,22
1656836463270,MATH 105,A02,093477,Carter; Anne Toulson,20,0,35,15
1656836469296,MATH 109,A01,083213,Ganzberger; Geoffrey Michael,2,0,34,32
1656836469296,MATH 109,A02,083214,Ganzberger; Geoffrey Michael,2,0,34,32
1656836469296,MATH 109,A03,093478,Ganzberger; Geoffrey Michael,1,0,34,33
1656836469296,MATH 109,B01,083215,Ganzberger; Geoffrey Michael,1,0,32,31
1656836469296,MATH 109,B02,083216,Ganzberger; Geoffrey Michael,1,0,32,31
1656836469296,MATH 109,B03,093479,Ganzberger; Geoffrey Michael,6,0,32,26
1656836475322,MATH 142A,A01,083219,Chow; Bennett,6,0,32,26
1656836475322,MATH 142A,A02,083220,Chow; Bennett,9,0,32,23
1656836475322,MATH 142A,A03,093480,Chow; Bennett,7,0,32,25
1656836475322,MATH 142A,B03,093481,Chow; Bennett,7,0,32,25
1656836475322,MATH 142A,B04,093558,Chow; Bennett,10,0,32,22
1656836475322,MATH 142A,B05,093559,Chow; Bennett,6,0,32,26
1656836481345,MATH 193A,A01,083224,Rotar; Vladimir,6,0,34,28
1656836481345,MATH 193A,A02,083225,Rotar; Vladimir,3,0,34,31
1656836481345,MATH 193A,A03,083781,Rotar; Vladimir,1,0,34,33
1656836481345,MATH 193A,A04,083782,Rotar; Vladimir,6,0,34,28
1656836481345,MATH 193A,A05,093482,Rotar; Vladimir,6,0,34,28
1656836487380,MATH 197,001,091859,McAuley; Julian John,9999,0,9999,0
1656836487380,MATH 197,002,095566,Kedlaya; Kiran S.,9997,0,9999,2
1656836487380,MATH 197,003,095567,Xiao; Ming,9999,0,9999,0
1656836487380,MATH 197,004,095571,Perols; Johan Lars,9998,0,9999,1
1656836494435,COGS 9,A01,083615,Shannon; Kyle Michael,6,0,75,69
1656836500462,COGS 11,A01,083617,Boyle; Mary E. T.,18,0,48,30
1656836506486,COGS 13,A01,083071,Bastos; Amalia Pinkusfeld,8,0,71,63
1656836512510,COGS 14A,A01,092681,Semenuks; Arturs,0,1,100,100
1656836518535,COGS 14B,A01,083073,Cheng; Tzu-Han,5,0,63,58
1656836524559,COGS 17,A01,092677,Semenuks; Arturs,4,0,81,77
1656836530587,COGS 100,A01,083619,Allen; Michael Gordon,15,0,70,55
1656836536614,COGS 101A,A01,083621,Davis; Joshua Daniel,9,0,68,59
1656836542638,COGS 101B,A01,091572,Allen; Michael Gordon,8,0,65,57
1656836548663,COGS 101C,A01,083625,Delgado; Tania,17,0,35,18
1656836554690,COGS 107A,A01,083627,Boyle; Mary E. T.,13,0,60,47
1656836560714,COGS 118A,A01,083075,Gupta; Anjum,15,0,76,61
1656836566740,CSE 3,A50,083646,Miranda; Gregory Joseph,22,0,50,28
1656836572762,CSE 8A,A50,083650,Miranda; Gregory Joseph,17,1,56,39
1656836578793,CSE 11,A01,083080,Cao; Yingjun,4,15,40,36
1656836584820,CSE 12,A01,083652,Krause-Levy; Sophia Louisa,20,1,120,100
1656836590859,CSE 15L,A01,083654,Morris; Justin Loren,8,0,50,42
1656836590859,CSE 15L,A02,083655,Morris; Justin Loren,8,0,50,42
1656836596883,CSE 20,A01,083657,Tran; Khoa Dang,37,0,80,43
1656836602910,CSE 21,A01,095574,Bach; Quang Tran,21,0,48,27
1656836608939,CSE 30,A01,083084,Eldon; John,4,0,80,76
1656836608939,CSE 30,B01,095061,Bhaskar; Nishant,6,0,50,44
1656836614964,CSE 100,A01,083659,Cao; Yingjun,2,4,70,68
1656836620988,CSE 134B,A01,083661,Powell; Thomas Allan,19,0,100,81
1656836627013,CSE 140,A01,083663,Gungor; Onat,14,0,85,71
1656836633043,CSE 140L,A01,083088,Eldon; John,16,0,100,84
1656836639079,CSE 175,A01,083665,Kumar; Rakesh,3,0,25,22
1656836645107,CSE 190,A00,092507,Dubnov; Shlomo,7,0,20,13
1656836651131,ECE 45,A01,083139,Congero; Spencer William,5,0,75,70
1656836657158,ECE 65,A50,083695,Saad; Andrew S,12,0,30,18
1656836657158,ECE 65,A51,095125,Saad; Andrew S,25,0,26,1
1656836663184,ECE 109,A01,091882,Touri; Behrouz,16,0,70,54
1656836669209,ECE 180,A00,083140,Abi Samra; Nicholas Camill,0,0,30,30
1656836669209,ECE 180,B00,083141,Abi Samra; Nicholas Camill,0,0,30,30
1656836675237,MATH 10A,A01,083735,Patchell; Gregory David,1,0,30,29
1656836675237,MATH 10A,A02,083736,Patchell; Gregory David,20,0,30,10
1656836675237,MATH 10A,A03,083737,Patchell; Gregory David,15,0,30,15
1656836681278,MATH 10B,A01,083207,Lim; Seonhee,7,0,34,27
1656836681278,MATH 10B,A02,083208,Lim; Seonhee,9,0,35,26
1656836681278,MATH 10B,A03,093472,Lim; Seonhee,4,0,34,30
1656836681278,MATH 10B,B01,083739,Sinha; Shubham,9,0,30,21
1656836687312,MATH 18,A01,083743,Cinel; Cameron Alexander,6,0,30,24
1656836687312,MATH 18,A02,083744,Cinel; Cameron Alexander,15,0,30,15
1656836687312,MATH 18,A03,083745,Cinel; Cameron Alexander,8,0,30,22
1656836687312,MATH 18,B01,083748,Rideout; David Porter,3,0,37,34
1656836687312,MATH 18,B02,083749,Rideout; David Porter,3,0,36,33
1656836687312,MATH 18,B03,083750,Rideout; David Porter,2,0,37,35
1656836687312,MATH 18,B04,083751,Rideout; David Porter,5,0,36,31
1656836687312,MATH 18,B05,093473,Rideout; David Porter,4,0,36,32
1656836687312,MATH 18,B06,093474,Rideout; David Porter,5,0,36,31
1656836693337,MATH 20A,A01,083754,Zheng; Zequn,12,0,40,28
1656836699361,MATH 20B,A01,083756,Briones; Jor-el Thomas Caparas,1,0,36,35
1656836699361,MATH 20B,A02,083757,Briones; Jor-el Thomas Caparas,1,0,36,35
1656836699361,MATH 20B,A03,093475,Briones; Jor-el Thomas Caparas,0,0,36,36
1656836705385,MATH 20C,A01,083760,Briones; Jor-el Thomas Caparas,1,0,35,34
1656836705385,MATH 20C,A02,083761,Briones; Jor-el Thomas Caparas,8,0,35,27
1656836705385,MATH 20C,A03,093476,Briones; Jor-el Thomas Caparas,0,1,36,36
1656836705385,MATH 20C,B01,083762,Bach; Quang Tran,0,0,30,30
1656836711409,MATH 20D,A01,083765,Tran; Brian Kha,4,0,30,26
1656836711409,MATH 20D,A02,083766,Tran; Brian Kha,4,0,30,26
1656836711409,MATH 20D,A03,083767,Tran; Brian Kha,2,0,30,28
1656836717435,MATH 20E,A01,083771,Ganguly; Soumya,5,0,32,27
1656836717435,MATH 20E,A02,083772,Ganguly; Soumya,6,0,32,26
1656836717435,MATH 20E,B01,083773,Ciotti; Benjamin,18,0,35,17
1656836717435,MATH 20E,B02,083774,Ciotti; Benjamin,17,0,35,18
1656836723458,MATH 103A,A01,083777,Greenfeld; Be'Eri,2,0,36,34
1656836723458,MATH 103A,A02,083778,Greenfeld; Be'Eri,5,0,36,31
1656836723458,MATH 103A,A03,093561,Greenfeld; Be'Eri,4,0,36,32
1656836723458,MATH 103A,B01,083779,Greenfeld; Be'Eri,6,0,36,30
1656836723458,MATH 103A,B02,083780,Greenfeld; Be'Eri,2,0,36,34
1656836723458,MATH 103A,B03,093562,Greenfeld; Be'Eri,2,0,36,34
1656836729485,MATH 105,A01,085443,Carter; Anne Toulson,13,0,35,22
1656836729485,MATH 105,A02,093477,Carter; Anne Toulson,20,0,35,15
1656836735509,MATH 109,A01,083213,Ganzberger; Geoffrey Michael,2,0,34,32
1656836735509,MATH 109,A02,083214,Ganzberger; Geoffrey Michael,2,0,34,32
1656836735509,MATH 109,A03,093478,Ganzberger; Geoffrey Michael,1,0,34,33
1656836735509,MATH 109,B01,083215,Ganzberger; Geoffrey Michael,1,0,32,31
1656836735509,MATH 109,B02,083216,Ganzberger; Geoffrey Michael,1,0,32,31
1656836735509,MATH 109,B03,093479,Ganzberger; Geoffrey Michael,6,0,32,26
1656836741535,MATH 142A,A01,083219,Chow; Bennett,6,0,32,26
1656836741535,MATH 142A,A02,083220,Chow; Bennett,9,0,32,23
1656836741535,MATH 142A,A03,093480,Chow; Bennett,7,0,32,25
1656836741535,MATH 142A,B03,093481,Chow; Bennett,7,0,32,25
1656836741535,MATH 142A,B04,093558,Chow; Bennett,10,0,32,22
1656836741535,MATH 142A,B05,093559,Chow; Bennett,6,0,32,26
1656836747561,MATH 193A,A01,083224,Rotar; Vladimir,6,0,34,28
1656836747561,MATH 193A,A02,083225,Rotar; Vladimir,3,0,34,31
1656836747561,MATH 193A,A03,083781,Rotar; Vladimir,1,0,34,33
1656836747561,MATH 193A,A04,083782,Rotar; Vladimir,6,0,34,28
1656836747561,MATH 193A,A05,093482,Rotar; Vladimir,6,0,34,28
1656836753589,MATH 197,001,091859,McAuley; Julian John,9999,0,9999,0
1656836753589,MATH 197,002,095566,Kedlaya; Kiran S.,9997,0,9999,2
1656836753589,MATH 197,003,095567,Xiao; Ming,9999,0,9999,0
1656836753589,MATH 197,004,095571,Perols; Johan Lars,9998,0,9999,1
1656836760653,COGS 9,A01,083615,Shannon; Kyle Michael,6,0,75,69
1656836766677,COGS 11,A01,083617,Boyle; Mary E. T.,18,0,48,30
1656836772705,COGS 13,A01,083071,Bastos; Amalia Pinkusfeld,8,0,71,63
1656836778729,COGS 14A,A01,092681,Semenuks; Arturs,0,1,100,100
1656836784753,COGS 14B,A01,083073,Cheng; Tzu-Han,5,0,63,58
1656836790780,COGS 17,A01,092677,Semenuks; Arturs,4,0,81,77
1656836796805,COGS 100,A01,083619,Allen; Michael Gordon,15,0,70,55
1656836802830,COGS 101A,A01,083621,Davis; Joshua Daniel,9,0,68,59
1656836808854,COGS 101B,A01,091572,Allen; Michael Gordon,8,0,65,57
1656836814879,COGS 101C,A01,083625,Delgado; Tania,17,0,35,18
1656836820906,COGS 107A,A01,083627,Boyle; Mary E. T.,13,0,60,47
1656836826930,COGS 118A,A01,083075,Gupta; Anjum,15,0,76,61
1656836832956,CSE 3,A50,083646,Miranda; Gregory Joseph,22,0,50,28
1656836838983,CSE 8A,A50,083650,Miranda; Gregory Joseph,17,1,56,39
1656836845007,CSE 11,A01,083080,Cao; Yingjun,4,15,40,36
1656836851031,CSE 12,A01,083652,Krause-Levy; Sophia Louisa,20,1,120,100
1656836857060,CSE 15L,A01,083654,Morris; Justin Loren,8,0,50,42
1656836857060,CSE 15L,A02,083655,Morris; Justin Loren,8,0,50,42
1656836863085,CSE 20,A01,083657,Tran; Khoa Dang,37,0,80,43
1656836869113,CSE 21,A01,095574,Bach; Quang Tran,21,0,48,27
1656836875139,CSE 30,A01,083084,Eldon; John,4,0,80,76
1656836875139,CSE 30,B01,095061,Bhaskar; Nishant,6,0,50,44
1656836881166,CSE 100,A01,083659,Cao; Yingjun,2,4,70,68
1656836887192,CSE 134B,A01,083661,Powell; Thomas Allan,19,0,100,81
1656836893218,CSE 140,A01,083663,Gungor; Onat,14,0,85,71
1656836899246,CSE 140L,A01,083088,Eldon; John,16,0,100,84
1656836905269,CSE 175,A01,083665,Kumar; Rakesh,3,0,25,22
1656836911294,CSE 190,A00,092507,Dubnov; Shlomo,7,0,20,13
1656836917317,ECE 45,A01,083139,Congero; Spencer William,5,0,75,70
1656836923347,ECE 65,A50,083695,Saad; Andrew S,12,0,30,18
1656836923347,ECE 65,A51,095125,Saad; Andrew S,25,0,26,1
1656836929372,ECE 109,A01,091882,Touri; Behrouz,16,0,70,54
1656836935394,ECE 180,A00,083140,Abi Samra; Nicholas Camill,0,0,30,30
1656836935394,ECE 180,B00,083141,Abi Samra; Nicholas Camill,0,0,30,30
1656836941417,MATH 10A,A01,083735,Patchell; Gregory David,1,0,30,29
1656836941417,MATH 10A,A02,083736,Patchell; Gregory David,20,0,30,10
1656836941417,MATH 10A,A03,083737,Patchell; Gregory David,15,0,30,15
1656836947442,MATH 10B,A01,083207,Lim; Seonhee,7,0,34,27
1656836947442,MATH 10B,A02,083208,Lim; Seonhee,9,0,35,26
1656836947442,MATH 10B,A03,093472,Lim; Seonhee,4,0,34,30
1656836947442,MATH 10B,B01,083739,Sinha; Shubham,9,0,30,21
1656836953477,MATH 18,A01,083743,Cinel; Cameron Alexander,6,0,30,24
1656836953477,MATH 18,A02,083744,Cinel; Cameron Alexander,15,0,30,15
1656836953477,MATH 18,A03,083745,Cinel; Cameron Alexander,8,0,30,22
1656836953477,MATH 18,B01,083748,Rideout; David Porter,3,0,37,34
1656836953477,MATH 18,B02,083749,Rideout; David Porter,3,0,36,33
1656836953477,MATH 18,B03,083750,Rideout; David Porter,2,0,37,35
1656836953477,MATH 18,B04,083751,Rideout; David Porter,5,0,36,31
1656836953477,MATH 18,B05,093473,Rideout; David Porter,4,0,36,32
1656836953477,MATH 18,B06,093474,Rideout; David Porter,5,0,36,31
1656836959501,MATH 20A,A01,083754,Zheng; Zequn,12,0,40,28
1656836965529,MATH 20B,A01,083756,Briones; Jor-el Thomas Caparas,1,0,36,35
1656836965529,MATH 20B,A02,083757,Briones; Jor-el Thomas Caparas,1,0,36,35
1656836965529,MATH 20B,A03,093475,Briones; Jor-el Thomas Caparas,0,0,36,36
1656836971554,MATH 20C,A01,083760,Briones; Jor-el Thomas Caparas,1,0,35,34
1656836971554,MATH 20C,A02,083761,Briones; Jor-el Thomas Caparas,8,0,35,27
1656836971554,MATH 20C,A03,093476,Briones; Jor-el Thomas Caparas,0,1,36,36
1656836971554,MATH 20C,B01,083762,Bach; Quang Tran,0,0,30,30
1656836977585,MATH 20D,A01,083765,Tran; Brian Kha,4,0,30,26
1656836977585,MATH 20D,A02,083766,Tran; Brian Kha,4,0,30,26
1656836977585,MATH 20D,A03,083767,Tran; Brian Kha,2,0,30,28
1656836983611,MATH 20E,A01,083771,Ganguly; Soumya,5,0,32,27
1656836983611,MATH 20E,A02,083772,Ganguly; Soumya,6,0,32,26
1656836983611,MATH 20E,B01,083773,Ciotti; Benjamin,18,0,35,17
1656836983611,MATH 20E,B02,083774,Ciotti; Benjamin,17,0,35,18
1656836989641,MATH 103A,A01,083777,Greenfeld; Be'Eri,2,0,36,34
1656836989641,MATH 103A,A02,083778,Greenfeld; Be'Eri,5,0,36,31
1656836989641,MATH 103A,A03,093561,Greenfeld; Be'Eri,4,0,36,32
1656836989641,MATH 103A,B01,083779,Greenfeld; Be'Eri,6,0,36,30
1656836989641,MATH 103A,B02,083780,Greenfeld; Be'Eri,2,0,36,34
1656836989641,MATH 103A,B03,093562,Greenfeld; Be'Eri,2,0,36,34
1656836995665,MATH 105,A01,085443,Carter; Anne Toulson,13,0,35,22
1656836995665,MATH 105,A02,093477,Carter; Anne Toulson,20,0,35,15
1656837001694,MATH 109,A01,083213,Ganzberger; Geoffrey Michael,2,0,34,32
1656837001694,MATH 109,A02,083214,Ganzberger; Geoffrey Michael,2,0,34,32
1656837001694,MATH 109,A03,093478,Ganzberger; Geoffrey Michael,1,0,34,33
1656837001694,MATH 109,B01,083215,Ganzberger; Geoffrey Michael,1,0,32,31
1656837001694,MATH 109,B02,083216,Ganzberger; Geoffrey Michael,1,0,32,31
1656837001694,MATH 109,B03,093479,Ganzberger; Geoffrey Michael,6,0,32,26
1656837007719,MATH 142A,A01,083219,Chow; Bennett,6,0,32,26
1656837007719,MATH 142A,A02,083220,Chow; Bennett,9,0,32,23
1656837007719,MATH 142A,A03,093480,Chow; Bennett,7,0,32,25
1656837007719,MATH 142A,B03,093481,Chow; Bennett,7,0,32,25
1656837007719,MATH 142A,B04,093558,Chow; Bennett,10,0,32,22
1656837007719,MATH 142A,B05,093559,Chow; Bennett,6,0,32,26
1656837013744,MATH 193A,A01,083224,Rotar; Vladimir,6,0,34,28
1656837013744,MATH 193A,A02,083225,Rotar; Vladimir,3,0,34,31
1656837013744,MATH 193A,A03,083781,Rotar; Vladimir,1,0,34,33
1656837013744,MATH 193A,A04,083782,Rotar; Vladimir,6,0,34,28
1656837013744,MATH 193A,A05,093482,Rotar; Vladimir,6,0,34,28
1656837019860,MATH 197,001,091859,McAuley; Julian John,9999,0,9999,0
1656837019860,MATH 197,002,095566,Kedlaya; Kiran S.,9997,0,9999,2
1656837019860,MATH 197,003,095567,Xiao; Ming,9999,0,9999,0
1656837019860,MATH 197,004,095571,Perols; Johan Lars,9998,0,9999,1
1656837026940,COGS 9,A01,083615,Shannon; Kyle Michael,6,0,75,69
1656837032964,COGS 11,A01,083617,Boyle; Mary E. T.,18,0,48,30
1656837038994,COGS 13,A01,083071,Bastos; Amalia Pinkusfeld,8,0,71,63
1656837045018,COGS 14A,A01,092681,Semenuks; Arturs,0,1,100,100
1656837051041,COGS 14B,A01,083073,Cheng; Tzu-Han,5,0,63,58
1656837057068,COGS 17,A01,092677,Semenuks; Arturs,4,0,81,77
1656837063093,COGS 100,A01,083619,Allen; Michael Gordon,15,0,70,55
1656837069117,COGS 101A,A01,083621,Davis; Joshua Daniel,9,0,68,59
1656837075141,COGS 101B,A01,091572,Allen; Michael Gordon,8,0,65,57
1656837081165,COGS 101C,A01,083625,Delgado; Tania,17,0,35,18
1656837087190,COGS 107A,A01,083627,Boyle; Mary E. T.,13,0,60,47
1656837093214,COGS 118A,A01,083075,Gupta; Anjum,15,0,76,61
1656837099243,CSE 3,A50,083646,Miranda; Gregory Joseph,22,0,50,28
1656837105267,CSE 8A,A50,083650,Miranda; Gregory Joseph,17,1,56,39
1656837111292,CSE 11,A01,083080,Cao; Yingjun,4,15,40,36
1656837117322,CSE 12,A01,083652,Krause-Levy; Sophia Louisa,20,1,120,100
1656837123347,CSE 15L,A01,083654,Morris; Justin Loren,8,0,50,42
1656837123347,CSE 15L,A02,083655,Morris; Justin Loren,8,0,50,42
1656837129376,CSE 20,A01,083657,Tran; Khoa Dang,37,0,80,43
1656837135404,CSE 21,A01,095574,Bach; Quang Tran,21,0,48,27
1656837141428,CSE 30,A01,083084,Eldon; John,4,0,80,76
1656837141428,CSE 30,B01,095061,Bhaskar; Nishant,6,0,50,44
1656837147456,CSE 100,A01,083659,Cao; Yingjun,2,4,70,68
1656837153484,CSE 134B,A01,083661,Powell; Thomas Allan,19,0,100,81
1656837159508,CSE 140,A01,083663,Gungor; Onat,14,0,85,71
1656837165531,CSE 140L,A01,083088,Eldon; John,16,0,100,84
1656837171565,CSE 175,A01,083665,Kumar; Rakesh,3,0,25,22
1656837177590,CSE 190,A00,092507,Dubnov; Shlomo,7,0,20,13
1656837183620,ECE 45,A01,083139,Congero; Spencer William,5,0,75,70
1656837189649,ECE 65,A50,083695,Saad; Andrew S,12,0,30,18
1656837189649,ECE 65,A51,095125,Saad; Andrew S,25,0,26,1
1656837195686,ECE 109,A01,091882,Touri; Behrouz,16,0,70,54
1656837201711,ECE 180,A00,083140,Abi Samra; Nicholas Camill,0,0,30,30
1656837201711,ECE 180,B00,083141,Abi Samra; Nicholas Camill,0,0,30,30
1656837207735,MATH 10A,A01,083735,Patchell; Gregory David,1,0,30,29
1656837207735,MATH 10A,A02,083736,Patchell; Gregory David,20,0,30,10
1656837207735,MATH 10A,A03,083737,Patchell; Gregory David,15,0,30,15
1656837213761,MATH 10B,A01,083207,Lim; Seonhee,7,0,34,27
1656837213761,MATH 10B,A02,083208,Lim; Seonhee,9,0,35,26
1656837213761,MATH 10B,A03,093472,Lim; Seonhee,4,0,34,30
1656837213761,MATH 10B,B01,083739,Sinha; Shubham,9,0,30,21
1656837219786,MATH 18,A01,083743,Cinel; Cameron Alexander,6,0,30,24
1656837219786,MATH 18,A02,083744,Cinel; Cameron Alexander,15,0,30,15
1656837219786,MATH 18,A03,083745,Cinel; Cameron Alexander,8,0,30,22
1656837219786,MATH 18,B01,083748,Rideout; David Porter,3,0,37,34
1656837219786,MATH 18,B02,083749,Rideout; David Porter,3,0,36,33
1656837219786,MATH 18,B03,083750,Rideout; David Porter,2,0,37,35
1656837219786,MATH 18,B04,083751,Rideout; David Porter,5,0,36,31
1656837219786,MATH 18,B05,093473,Rideout; David Porter,4,0,36,32
1656837219786,MATH 18,B06,093474,Rideout; David Porter,5,0,36,31
1656837225814,MATH 20A,A01,083754,Zheng; Zequn,12,0,40,28
1656837231845,MATH 20B,A01,083756,Briones; Jor-el Thomas Caparas,1,0,36,35
1656837231845,MATH 20B,A02,083757,Briones; Jor-el Thomas Caparas,1,0,36,35
1656837231845,MATH 20B,A03,093475,Briones; Jor-el Thomas Caparas,0,0,36,36
1656837237871,MATH 20C,A01,083760,Briones; Jor-el Thomas Caparas,1,0,35,34
1656837237871,MATH 20C,A02,083761,Briones; Jor-el Thomas Caparas,8,0,35,27
1656837237871,MATH 20C,A03,093476,Briones; Jor-el Thomas Caparas,0,1,36,36
1656837237871,MATH 20C,B01,083762,Bach; Quang Tran,0,0,30,30
1656837243902,MATH 20D,A01,083765,Tran; Brian Kha,4,0,30,26
1656837243902,MATH 20D,A02,083766,Tran; Brian Kha,4,0,30,26
1656837243902,MATH 20D,A03,083767,Tran; Brian Kha,2,0,30,28
1656837249927,MATH 20E,A01,083771,Ganguly; Soumya,5,0,32,27
1656837249927,MATH 20E,A02,083772,Ganguly; Soumya,6,0,32,26
1656837249927,MATH 20E,B01,083773,Ciotti; Benjamin,18,0,35,17
1656837249927,MATH 20E,B02,083774,Ciotti; Benjamin,17,0,35,18
1656837255956,MATH 103A,A01,083777,Greenfeld; Be'Eri,2,0,36,34
1656837255956,MATH 103A,A02,083778,Greenfeld; Be'Eri,5,0,36,31
1656837255956,MATH 103A,A03,093561,Greenfeld; Be'Eri,4,0,36,32
1656837255956,MATH 103A,B01,083779,Greenfeld; Be'Eri,6,0,36,30
1656837255956,MATH 103A,B02,083780,Greenfeld; Be'Eri,2,0,36,34
1656837255956,MATH 103A,B03,093562,Greenfeld; Be'Eri,2,0,36,34
1656837261980,MATH 105,A01,085443,Carter; Anne Toulson,13,0,35,22
1656837261980,MATH 105,A02,093477,Carter; Anne Toulson,20,0,35,15
1656837268014,MATH 109,A01,083213,Ganzberger; Geoffrey Michael,2,0,34,32
1656837268014,MATH 109,A02,083214,Ganzberger; Geoffrey Michael,2,0,34,32
1656837268014,MATH 109,A03,093478,Ganzberger; Geoffrey Michael,1,0,34,33
1656837268014,MATH 109,B01,083215,Ganzberger; Geoffrey Michael,1,0,32,31
1656837268014,MATH 109,B02,083216,Ganzberger; Geoffrey Michael,1,0,32,31
1656837268014,MATH 109,B03,093479,Ganzberger; Geoffrey Michael,6,0,32,26
1656837274041,MATH 142A,A01,083219,Chow; Bennett,6,0,32,26
1656837274041,MATH 142A,A02,083220,Chow; Bennett,9,0,32,23
1656837274041,MATH 142A,A03,093480,Chow; Bennett,7,0,32,25
1656837274041,MATH 142A,B03,093481,Chow; Bennett,7,0,32,25
1656837274041,MATH 142A,B04,093558,Chow; Bennett,10,0,32,22
1656837274041,MATH 142A,B05,093559,Chow; Bennett,6,0,32,26
1656837280072,MATH 193A,A01,083224,Rotar; Vladimir,6,0,34,28
1656837280072,MATH 193A,A02,083225,Rotar; Vladimir,3,0,34,31
1656837280072,MATH 193A,A03,083781,Rotar; Vladimir,1,0,34,33
1656837280072,MATH 193A,A04,083782,Rotar; Vladimir,6,0,34,28
1656837280072,MATH 193A,A05,093482,Rotar; Vladimir,6,0,34,28
1656837286096,MATH 197,001,091859,McAuley; Julian John,9999,0,9999,0
1656837286096,MATH 197,002,095566,Kedlaya; Kiran S.,9997,0,9999,2
1656837286096,MATH 197,003,095567,Xiao; Ming,9999,0,9999,0
1656837286096,MATH 197,004,095571,Perols; Johan Lars,9998,0,9999,1
1656837293173,COGS 9,A01,083615,Shannon; Kyle Michael,6,0,75,69
1656837299196,COGS 11,A01,083617,Boyle; Mary E. T.,18,0,48,30
1656837305224,COGS 13,A01,083071,Bastos; Amalia Pinkusfeld,8,0,71,63
1656837311256,COGS 14A,A01,092681,Semenuks; Arturs,0,1,100,100
1656837317285,COGS 14B,A01,083073,Cheng; Tzu-Han,5,0,63,58
1656837323313,COGS 17,A01,092677,Semenuks; Arturs,4,0,81,77
1656837329337,COGS 100,A01,083619,Allen; Michael Gordon,15,0,70,55
1656837335361,COGS 101A,A01,083621,Davis; Joshua Daniel,9,0,68,59
1656837341383,COGS 101B,A01,091572,Allen; Michael Gordon,8,0,65,57
1656837347407,COGS 101C,A01,083625,Delgado; Tania,17,0,35,18
1656837353431,COGS 107A,A01,083627,Boyle; Mary E. T.,13,0,60,47
1656837359457,COGS 118A,A01,083075,Gupta; Anjum,15,0,76,61
1656837365484,CSE 3,A50,083646,Miranda; Gregory Joseph,22,0,50,28
1656837371513,CSE 8A,A50,083650,Miranda; Gregory Joseph,17,1,56,39
1656837377541,CSE 11,A01,083080,Cao; Yingjun,4,15,40,36
1656837383565,CSE 12,A01,083652,Krause-Levy; Sophia Louisa,20,1,120,100
1656837389589,CSE 15L,A01,083654,Morris; Justin Loren,8,0,50,42
1656837389589,CSE 15L,A02,083655,Morris; Justin Loren,8,0,50,42
1656837395621,CSE 20,A01,083657,Tran; Khoa Dang,37,0,80,43
1656837401643,CSE 21,A01,095574,Bach; Quang Tran,21,0,48,27
1656837407676,CSE 30,A01,083084,Eldon; John,4,0,80,76
1656837407676,CSE 30,B01,095061,Bhaskar; Nishant,6,0,50,44
1656837413699,CSE 100,A01,083659,Cao; Yingjun,2,4,70,68
1656837419731,CSE 134B,A01,083661,Powell; Thomas Allan,19,0,100,81
1656837425758,CSE 140,A01,083663,Gungor; Onat,14,0,85,71
1656837431779,CSE 140L,A01,083088,Eldon; John,16,0,100,84
1656837437805,CSE 175,A01,083665,Kumar; Rakesh,3,0,25,22
1656837443834,CSE 190,A00,092507,Dubnov; Shlomo,7,0,20,13
1656837449858,ECE 45,A01,083139,Congero; Spencer William,5,0,75,70
1656837455883,ECE 65,A50,083695,Saad; Andrew S,12,0,30,18
1656837455883,ECE 65,A51,095125,Saad; Andrew S,25,0,26,1
1656837461907,ECE 109,A01,091882,Touri; Behrouz,16,0,70,54
1656837467929,ECE 180,A00,083140,Abi Samra; Nicholas Camill,0,0,30,30
1656837467929,ECE 180,B00,083141,Abi Samra; Nicholas Camill,0,0,30,30
1656837473954,MATH 10A,A01,083735,Patchell; Gregory David,1,0,30,29
1656837473954,MATH 10A,A02,083736,Patchell; Gregory David,20,0,30,10
1656837473954,MATH 10A,A03,083737,Patchell; Gregory David,15,0,30,15
1656837479983,MATH 10B,A01,083207,Lim; Seonhee,7,0,34,27
1656837479983,MATH 10B,A02,083208,Lim; Seonhee,9,0,35,26
1656837479983,MATH 10B,A03,093472,Lim; Seonhee,4,0,34,30
1656837479983,MATH 10B,B01,083739,Sinha; Shubham,9,0,30,21
1656837486010,MATH 18,A01,083743,Cinel; Cameron Alexander,6,0,30,24
1656837486010,MATH 18,A02,083744,Cinel; Cameron Alexander,15,0,30,15
1656837486010,MATH 18,A03,083745,Cinel; Cameron Alexander,8,0,30,22
1656837486010,MATH 18,B01,083748,Rideout; David Porter,3,0,37,34
1656837486010,MATH 18,B02,083749,Rideout; David Porter,3,0,36,33
1656837486010,MATH 18,B03,083750,Rideout; David Porter,2,0,37,35
1656837486010,MATH 18,B04,083751,Rideout; David Porter,5,0,36,31
1656837486010,MATH 18,B05,093473,Rideout; David Porter,4,0,36,32
1656837486010,MATH 18,B06,093474,Rideout; David Porter,5,0,36,31
1656837492032,MATH 20A,A01,083754,Zheng; Zequn,12,0,40,28
1656837498063,MATH 20B,A01,083756,Briones; Jor-el Thomas Caparas,1,0,36,35
1656837498063,MATH 20B,A02,083757,Briones; Jor-el Thomas Caparas,1,0,36,35
1656837498063,MATH 20B,A03,093475,Briones; Jor-el Thomas Caparas,0,0,36,36
1656837504098,MATH 20C,A01,083760,Briones; Jor-el Thomas Caparas,1,0,35,34
1656837504098,MATH 20C,A02,083761,Briones; Jor-el Thomas Caparas,8,0,35,27
1656837504098,MATH 20C,A03,093476,Briones; Jor-el Thomas Caparas,0,1,36,36
1656837504098,MATH 20C,B01,083762,Bach; Quang Tran,0,0,30,30
1656837510145,MATH 20D,A01,083765,Tran; Brian Kha,4,0,30,26
1656837510145,MATH 20D,A02,083766,Tran; Brian Kha,4,0,30,26
1656837510145,MATH 20D,A03,083767,Tran; Brian Kha,2,0,30,28
1656837516179,MATH 20E,A01,083771,Ganguly; Soumya,5,0,32,27
1656837516179,MATH 20E,A02,083772,Ganguly; Soumya,6,0,32,26
1656837516179,MATH 20E,B01,083773,Ciotti; Benjamin,18,0,35,17
1656837516179,MATH 20E,B02,083774,Ciotti; Benjamin,17,0,35,18
1656837522206,MATH 103A,A01,083777,Greenfeld; Be'Eri,2,0,36,34
1656837522206,MATH 103A,A02,083778,Greenfeld; Be'Eri,5,0,36,31
1656837522206,MATH 103A,A03,093561,Greenfeld; Be'Eri,4,0,36,32
1656837522206,MATH 103A,B01,083779,Greenfeld; Be'Eri,6,0,36,30
1656837522206,MATH 103A,B02,083780,Greenfeld; Be'Eri,2,0,36,34
1656837522206,MATH 103A,B03,093562,Greenfeld; Be'Eri,2,0,36,34
1656837528229,MATH 105,A01,085443,Carter; Anne Toulson,13,0,35,22
1656837528229,MATH 105,A02,093477,Carter; Anne Toulson,20,0,35,15
1656837534260,MATH 109,A01,083213,Ganzberger; Geoffrey Michael,2,0,34,32
1656837534260,MATH 109,A02,083214,Ganzberger; Geoffrey Michael,2,0,34,32
1656837534260,MATH 109,A03,093478,Ganzberger; Geoffrey Michael,1,0,34,33
1656837534260,MATH 109,B01,083215,Ganzberger; Geoffrey Michael,1,0,32,31
1656837534260,MATH 109,B02,083216,Ganzberger; Geoffrey Michael,1,0,32,31
1656837534260,MATH 109,B03,093479,Ganzberger; Geoffrey Michael,6,0,32,26
1656837540288,MATH 142A,A01,083219,Chow; Bennett,6,0,32,26
1656837540288,MATH 142A,A02,083220,Chow; Bennett,9,0,32,23
1656837540288,MATH 142A,A03,093480,Chow; Bennett,7,0,32,25
1656837540288,MATH 142A,B03,093481,Chow; Bennett,7,0,32,25
1656837540288,MATH 142A,B04,093558,Chow; Bennett,10,0,32,22
1656837540288,MATH 142A,B05,093559,Chow; Bennett,6,0,32,26
1656837546319,MATH 193A,A01,083224,Rotar; Vladimir,6,0,34,28
1656837546319,MATH 193A,A02,083225,Rotar; Vladimir,3,0,34,31
1656837546319,MATH 193A,A03,083781,Rotar; Vladimir,1,0,34,33
1656837546319,MATH 193A,A04,083782,Rotar; Vladimir,6,0,34,28
1656837546319,MATH 193A,A05,093482,Rotar; Vladimir,6,0,34,28
1656837552347,MATH 197,001,091859,McAuley; Julian John,9999,0,9999,0
1656837552347,MATH 197,002,095566,Kedlaya; Kiran S.,9997,0,9999,2
1656837552347,MATH 197,003,095567,Xiao; Ming,9999,0,9999,0
1656837552347,MATH 197,004,095571,Perols; Johan Lars,9998,0,9999,1
1656837559408,COGS 9,A01,083615,Shannon; Kyle Michael,6,0,75,69
1656837565431,COGS 11,A01,083617,Boyle; Mary E. T.,18,0,48,30
1656837571457,COGS 13,A01,083071,Bastos; Amalia Pinkusfeld,8,0,71,63
1656837577486,COGS 14A,A01,092681,Semenuks; Arturs,0,1,100,100
1656837583514,COGS 14B,A01,083073,Cheng; Tzu-Han,5,0,63,58
1656837589542,COGS 17,A01,092677,Semenuks; Arturs,4,0,81,77
1656837595584,COGS 100,A01,083619,Allen; Michael Gordon,15,0,70,55
1656837601610,COGS 101A,A01,083621,Davis; Joshua Daniel,9,0,68,59
1656837607640,COGS 101B,A01,091572,Allen; Michael Gordon,8,0,65,57
1656837613734,COGS 101C,A01,083625,Delgado; Tania,17,0,35,18
1656837619760,COGS 107A,A01,083627,Boyle; Mary E. T.,13,0,60,47
1656837625792,COGS 118A,A01,083075,Gupta; Anjum,15,0,76,61
1656837631821,CSE 3,A50,083646,Miranda; Gregory Joseph,22,0,50,28
1656837637844,CSE 8A,A50,083650,Miranda; Gregory Joseph,17,1,56,39
1656837643868,CSE 11,A01,083080,Cao; Yingjun,4,15,40,36
1656837649897,CSE 12,A01,083652,Krause-Levy; Sophia Louisa,20,1,120,100
1656837655925,CSE 15L,A01,083654,Morris; Justin Loren,8,0,50,42
1656837655925,CSE 15L,A02,083655,Morris; Justin Loren,8,0,50,42
1656837661951,CSE 20,A01,083657,Tran; Khoa Dang,37,0,80,43
1656837667975,CSE 21,A01,095574,Bach; Quang Tran,21,0,48,27
1656837673999,CSE 30,A01,083084,Eldon; John,4,0,80,76
1656837673999,CSE 30,B01,095061,Bhaskar; Nishant,6,0,50,44
1656837680027,CSE 100,A01,083659,Cao; Yingjun,2,4,70,68
1656837686050,CSE 134B,A01,083661,Powell; Thomas Allan,19,0,100,81
1656837692088,CSE 140,A01,083663,Gungor; Onat,14,0,85,71
1656837698117,CSE 140L,A01,083088,Eldon; John,16,0,100,84
1656837704141,CSE 175,A01,083665,Kumar; Rakesh,3,0,25,22
1656837710174,CSE 190,A00,092507,Dubnov; Shlomo,7,0,20,13
1656837716202,ECE 45,A01,083139,Congero; Spencer William,5,0,75,70
1656837722233,ECE 65,A50,083695,Saad; Andrew S,12,0,30,18
1656837722233,ECE 65,A51,095125,Saad; Andrew S,25,0,26,1
1656837728260,ECE 109,A01,091882,Touri; Behrouz,16,0,70,54
1656837734285,ECE 180,A00,083140,Abi Samra; Nicholas Camill,0,0,30,30
1656837734285,ECE 180,B00,083141,Abi Samra; Nicholas Camill,0,0,30,30
1656837740310,MATH 10A,A01,083735,Patchell; Gregory David,1,0,30,29
1656837740310,MATH 10A,A02,083736,Patchell; Gregory David,20,0,30,10
1656837740310,MATH 10A,A03,083737,Patchell; Gregory David,15,0,30,15
1656837746334,MATH 10B,A01,083207,Lim; Seonhee,7,0,34,27
1656837746334,MATH 10B,A02,083208,Lim; Seonhee,9,0,35,26
1656837746334,MATH 10B,A03,093472,Lim; Seonhee,4,0,34,30
1656837746334,MATH 10B,B01,083739,Sinha; Shubham,9,0,30,21
1656837752361,MATH 18,A01,083743,Cinel; Cameron Alexander,6,0,30,24
1656837752361,MATH 18,A02,083744,Cinel; Cameron Alexander,15,0,30,15
1656837752361,MATH 18,A03,083745,Cinel; Cameron Alexander,8,0,30,22
1656837752361,MATH 18,B01,083748,Rideout; David Porter,3,0,37,34
1656837752361,MATH 18,B02,083749,Rideout; David Porter,3,0,36,33
1656837752361,MATH 18,B03,083750,Rideout; David Porter,2,0,37,35
1656837752361,MATH 18,B04,083751,Rideout; David Porter,5,0,36,31
1656837752361,MATH 18,B05,093473,Rideout; David Porter,4,0,36,32
1656837752361,MATH 18,B06,093474,Rideout; David Porter,5,0,36,31
1656837758385,MATH 20A,A01,083754,Zheng; Zequn,12,0,40,28
1656837764410,MATH 20B,A01,083756,Briones; Jor-el Thomas Caparas,1,0,36,35
1656837764410,MATH 20B,A02,083757,Briones; Jor-el Thomas Caparas,1,0,36,35
1656837764410,MATH 20B,A03,093475,Briones; Jor-el Thomas Caparas,0,0,36,36
1656837770434,MATH 20C,A01,083760,Briones; Jor-el Thomas Caparas,1,0,35,34
1656837770434,MATH 20C,A02,083761,Briones; Jor-el Thomas Caparas,8,0,35,27
1656837770434,MATH 20C,A03,093476,Briones; Jor-el Thomas Caparas,0,1,36,36
1656837770434,MATH 20C,B01,083762,Bach; Quang Tran,0,0,30,30
1656837776458,MATH 20D,A01,083765,Tran; Brian Kha,4,0,30,26
1656837776458,MATH 20D,A02,083766,Tran; Brian Kha,4,0,30,26
1656837776458,MATH 20D,A03,083767,Tran; Brian Kha,2,0,30,28
1656837782484,MATH 20E,A01,083771,Ganguly; Soumya,5,0,32,27
1656837782484,MATH 20E,A02,083772,Ganguly; Soumya,6,0,32,26
1656837782484,MATH 20E,B01,083773,Ciotti; Benjamin,18,0,35,17
1656837782484,MATH 20E,B02,083774,Ciotti; Benjamin,17,0,35,18
1656837788515,MATH 103A,A01,083777,Greenfeld; Be'Eri,2,0,36,34
1656837788515,MATH 103A,A02,083778,Greenfeld; Be'Eri,5,0,36,31
1656837788515,MATH 103A,A03,093561,Greenfeld; Be'Eri,4,0,36,32
1656837788515,MATH 103A,B01,083779,Greenfeld; Be'Eri,6,0,36,30
1656837788515,MATH 103A,B02,083780,Greenfeld; Be'Eri,2,0,36,34
1656837788515,MATH 103A,B03,093562,Greenfeld; Be'Eri,2,0,36,34
1656837794546,MATH 105,A01,085443,Carter; Anne Toulson,13,0,35,22
1656837794546,MATH 105,A02,093477,Carter; Anne Toulson,20,0,35,15
1656837800576,MATH 109,A01,083213,Ganzberger; Geoffrey Michael,2,0,34,32
1656837800576,MATH 109,A02,083214,Ganzberger; Geoffrey Michael,2,0,34,32
1656837800576,MATH 109,A03,093478,Ganzberger; Geoffrey Michael,1,0,34,33
1656837800576,MATH 109,B01,083215,Ganzberger; Geoffrey Michael,1,0,32,31
1656837800576,MATH 109,B02,083216,Ganzberger; Geoffrey Michael,1,0,32,31
1656837800576,MATH 109,B03,093479,Ganzberger; Geoffrey Michael,6,0,32,26
1656837806610,MATH 142A,A01,083219,Chow; Bennett,6,0,32,26
1656837806610,MATH 142A,A02,083220,Chow; Bennett,9,0,32,23
1656837806610,MATH 142A,A03,093480,Chow; Bennett,7,0,32,25
1656837806610,MATH 142A,B03,093481,Chow; Bennett,7,0,32,25
1656837806610,MATH 142A,B04,093558,Chow; Bennett,10,0,32,22
1656837806610,MATH 142A,B05,093559,Chow; Bennett,6,0,32,26
1656837812640,MATH 193A,A01,083224,Rotar; Vladimir,6,0,34,28
1656837812640,MATH 193A,A02,083225,Rotar; Vladimir,3,0,34,31
1656837812640,MATH 193A,A03,083781,Rotar; Vladimir,1,0,34,33
1656837812640,MATH 193A,A04,083782,Rotar; Vladimir,6,0,34,28
1656837812640,MATH 193A,A05,093482,Rotar; Vladimir,6,0,34,28
1656837818670,MATH 197,001,091859,McAuley; Julian John,9999,0,9999,0
1656837818670,MATH 197,002,095566,Kedlaya; Kiran S.,9997,0,9999,2
1656837818670,MATH 197,003,095567,Xiao; Ming,9999,0,9999,0
1656837818670,MATH 197,004,095571,Perols; Johan Lars,9998,0,9999,1
1656837825735,COGS 9,A01,083615,Shannon; Kyle Michael,6,0,75,69
1656837831762,COGS 11,A01,083617,Boyle; Mary E. T.,18,0,48,30
1656837837785,COGS 13,A01,083071,Bastos; Amalia Pinkusfeld,8,0,71,63
1656837843816,COGS 14A,A01,092681,Semenuks; Arturs,0,1,100,100
1656837849845,COGS 14B,A01,083073,Cheng; Tzu-Han,5,0,63,58
1656837855886,COGS 17,A01,092677,Semenuks; Arturs,4,0,81,77
1656837861915,COGS 100,A01,083619,Allen; Michael Gordon,15,0,70,55
1656837867942,COGS 101A,A01,083621,Davis; Joshua Daniel,9,0,68,59
1656837873969,COGS 101B,A01,091572,Allen; Michael Gordon,8,0,65,57
1656837880001,COGS 101C,A01,083625,Delgado; Tania,17,0,35,18
1656837886023,COGS 107A,A01,083627,Boyle; Mary E. T.,13,0,60,47
1656837892047,COGS 118A,A01,083075,Gupta; Anjum,15,0,76,61
1656837898077,CSE 3,A50,083646,Miranda; Gregory Joseph,22,0,50,28
1656837904101,CSE 8A,A50,083650,Miranda; Gregory Joseph,17,1,56,39
1656837910129,CSE 11,A01,083080,Cao; Yingjun,4,15,40,36
1656837916158,CSE 12,A01,083652,Krause-Levy; Sophia Louisa,20,1,120,100
1656837922181,CSE 15L,A01,083654,Morris; Justin Loren,8,0,50,42
1656837922181,CSE 15L,A02,083655,Morris; Justin Loren,8,0,50,42
1656837928205,CSE 20,A01,083657,Tran; Khoa Dang,37,0,80,43
1656837934229,CSE 21,A01,095574,Bach; Quang Tran,21,0,48,27
1656837940252,CSE 30,A01,083084,Eldon; John,4,0,80,76
1656837940252,CSE 30,B01,095061,Bhaskar; Nishant,6,0,50,44
1656837946278,CSE 100,A01,083659,Cao; Yingjun,2,4,70,68
1656837952302,CSE 134B,A01,083661,Powell; Thomas Allan,19,0,100,81
1656837958335,CSE 140,A01,083663,Gungor; Onat,14,0,85,71
1656837964365,CSE 140L,A01,083088,Eldon; John,16,0,100,84
1656837970388,CSE 175,A01,083665,Kumar; Rakesh,3,0,25,22
1656837976411,CSE 190,A00,092507,Dubnov; Shlomo,7,0,20,13
1656837982441,ECE 45,A01,083139,Congero; Spencer William,5,0,75,70
1656837988471,ECE 65,A50,083695,Saad; Andrew S,12,0,30,18
1656837988471,ECE 65,A51,095125,Saad; Andrew S,25,0,26,1
1656837994495,ECE 109,A01,091882,Touri; Behrouz,16,0,70,54
1656838000518,ECE 180,A00,083140,Abi Samra; Nicholas Camill,0,0,30,30
1656838000518,ECE 180,B00,083141,Abi Samra; Nicholas Camill,0,0,30,30
1656838006542,MATH 10A,A01,083735,Patchell; Gregory David,1,0,30,29
1656838006542,MATH 10A,A02,083736,Patchell; Gregory David,20,0,30,10
1656838006542,MATH 10A,A03,083737,Patchell; Gregory David,15,0,30,15
1656838012575,MATH 10B,A01,083207,Lim; Seonhee,7,0,34,27
1656838012575,MATH 10B,A02,083208,Lim; Seonhee,9,0,35,26
1656838012575,MATH 10B,A03,093472,Lim; Seonhee,4,0,34,30
1656838012575,MATH 10B,B01,083739,Sinha; Shubham,9,0,30,21
1656838018610,MATH 18,A01,083743,Cinel; Cameron Alexander,6,0,30,24
1656838018610,MATH 18,A02,083744,Cinel; Cameron Alexander,15,0,30,15
1656838018610,MATH 18,A03,083745,Cinel; Cameron Alexander,8,0,30,22
1656838018610,MATH 18,B01,083748,Rideout; David Porter,3,0,37,34
1656838018610,MATH 18,B02,083749,Rideout; David Porter,3,0,36,33
1656838018610,MATH 18,B03,083750,Rideout; David Porter,2,0,37,35
1656838018610,MATH 18,B04,083751,Rideout; David Porter,5,0,36,31
1656838018610,MATH 18,B05,093473,Rideout; David Porter,4,0,36,32
1656838018610,MATH 18,B06,093474,Rideout; David Porter,5,0,36,31
1656838024640,MATH 20A,A01,083754,Zheng; Zequn,12,0,40,28
1656838030669,MATH 20B,A01,083756,Briones; Jor-el Thomas Caparas,1,0,36,35
1656838030669,MATH 20B,A02,083757,Briones; Jor-el Thomas Caparas,1,0,36,35
1656838030669,MATH 20B,A03,093475,Briones; Jor-el Thomas Caparas,0,0,36,36
1656838036698,MATH 20C,A01,083760,Briones; Jor-el Thomas Caparas,1,0,35,34
1656838036698,MATH 20C,A02,083761,Briones; Jor-el Thomas Caparas,8,0,35,27
1656838036698,MATH 20C,A03,093476,Briones; Jor-el Thomas Caparas,0,1,36,36
1656838036698,MATH 20C,B01,083762,Bach; Quang Tran,0,0,30,30
1656838042724,MATH 20D,A01,083765,Tran; Brian Kha,4,0,30,26
1656838042724,MATH 20D,A02,083766,Tran; Brian Kha,4,0,30,26
1656838042724,MATH 20D,A03,083767,Tran; Brian Kha,2,0,30,28
1656838048750,MATH 20E,A01,083771,Ganguly; Soumya,5,0,32,27
1656838048750,MATH 20E,A02,083772,Ganguly; Soumya,6,0,32,26
1656838048750,MATH 20E,B01,083773,Ciotti; Benjamin,18,0,35,17
1656838048750,MATH 20E,B02,083774,Ciotti; Benjamin,17,0,35,18
1656838054775,MATH 103A,A01,083777,Greenfeld; Be'Eri,2,0,36,34
1656838054775,MATH 103A,A02,083778,Greenfeld; Be'Eri,5,0,36,31
1656838054775,MATH 103A,A03,093561,Greenfeld; Be'Eri,4,0,36,32
1656838054775,MATH 103A,B01,083779,Greenfeld; Be'Eri,6,0,36,30
1656838054775,MATH 103A,B02,083780,Greenfeld; Be'Eri,2,0,36,34
1656838054775,MATH 103A,B03,093562,Greenfeld; Be'Eri,2,0,36,34
1656838060804,MATH 105,A01,085443,Carter; Anne Toulson,13,0,35,22
1656838060804,MATH 105,A02,093477,Carter; Anne Toulson,20,0,35,15
1656838066853,MATH 109,A01,083213,Ganzberger; Geoffrey Michael,2,0,34,32
1656838066853,MATH 109,A02,083214,Ganzberger; Geoffrey Michael,2,0,34,32
1656838066853,MATH 109,A03,093478,Ganzberger; Geoffrey Michael,1,0,34,33
1656838066853,MATH 109,B01,083215,Ganzberger; Geoffrey Michael,1,0,32,31
1656838066853,MATH 109,B02,083216,Ganzberger; Geoffrey Michael,1,0,32,31
1656838066853,MATH 109,B03,093479,Ganzberger; Geoffrey Michael,6,0,32,26
1656838072883,MATH 142A,A01,083219,Chow; Bennett,6,0,32,26
1656838072883,MATH 142A,A02,083220,Chow; Bennett,9,0,32,23
1656838072883,MATH 142A,A03,093480,Chow; Bennett,7,0,32,25
1656838072883,MATH 142A,B03,093481,Chow; Bennett,7,0,32,25
1656838072883,MATH 142A,B04,093558,Chow; Bennett,10,0,32,22
1656838072883,MATH 142A,B05,093559,Chow; Bennett,6,0,32,26
1656838078907,MATH 193A,A01,083224,Rotar; Vladimir,6,0,34,28
1656838078907,MATH 193A,A02,083225,Rotar; Vladimir,3,0,34,31
1656838078907,MATH 193A,A03,083781,Rotar; Vladimir,1,0,34,33
1656838078907,MATH 193A,A04,083782,Rotar; Vladimir,6,0,34,28
1656838078907,MATH 193A,A05,093482,Rotar; Vladimir,6,0,34,28
1656838084931,MATH 197,001,091859,McAuley; Julian John,9999,0,9999,0
1656838084931,MATH 197,002,095566,Kedlaya; Kiran S.,9997,0,9999,2
1656838084931,MATH 197,003,095567,Xiao; Ming,9999,0,9999,0
1656838084931,MATH 197,004,095571,Perols; Johan Lars,9998,0,9999,1
1656838091983,COGS 9,A01,083615,Shannon; Kyle Michael,6,0,75,69
1656838098007,COGS 11,A01,083617,Boyle; Mary E. T.,18,0,48,30
1656838104036,COGS 13,A01,083071,Bastos; Amalia Pinkusfeld,8,0,71,63
1656838110067,COGS 14A,A01,092681,Semenuks; Arturs,0,1,100,100
1656838116090,COGS 14B,A01,083073,Cheng; Tzu-Han,5,0,63,58
1656838122121,COGS 17,A01,092677,Semenuks; Arturs,4,0,81,77
1656838128145,COGS 100,A01,083619,Allen; Michael Gordon,15,0,70,55
1656838134168,COGS 101A,A01,083621,Davis; Joshua Daniel,9,0,68,59
1656838140198,COGS 101B,A01,091572,Allen; Michael Gordon,8,0,65,57
1656838146221,COGS 101C,A01,083625,Delgado; Tania,17,0,35,18
1656838152262,COGS 107A,A01,083627,Boyle; Mary E. T.,13,0,60,47
1656838158290,COGS 118A,A01,083075,Gupta; Anjum,15,0,76,61
1656838164314,CSE 3,A50,083646,Miranda; Gregory Joseph,22,0,50,28
1656838170339,CSE 8A,A50,083650,Miranda; Gregory Joseph,17,1,56,39
1656838176376,CSE 11,A01,083080,Cao; Yingjun,4,15,40,36
1656838182403,CSE 12,A01,083652,Krause-Levy; Sophia Louisa,20,1,120,100
1656838188431,CSE 15L,A01,083654,Morris; Justin Loren,8,0,50,42
1656838188431,CSE 15L,A02,083655,Morris; Justin Loren,8,0,50,42
1656838194460,CSE 20,A01,083657,Tran; Khoa Dang,37,0,80,43
1656838200485,CSE 21,A01,095574,Bach; Quang Tran,21,0,48,27
1656838206512,CSE 30,A01,083084,Eldon; John,4,0,80,76
1656838206512,CSE 30,B01,095061,Bhaskar; Nishant,6,0,50,44
1656838212617,CSE 100,A01,083659,Cao; Yingjun,2,4,70,68
1656838218644,CSE 134B,A01,083661,Powell; Thomas Allan,19,0,100,81
1656838224673,CSE 140,A01,083663,Gungor; Onat,14,0,85,71
1656838230697,CSE 140L,A01,083088,Eldon; John,16,0,100,84
1656838236722,CSE 175,A01,083665,Kumar; Rakesh,3,0,25,22
1656838242753,CSE 190,A00,092507,Dubnov; Shlomo,7,0,20,13
1656838248777,ECE 45,A01,083139,Congero; Spencer William,5,0,75,70
1656838254801,ECE 65,A50,083695,Saad; Andrew S,12,0,30,18
1656838254801,ECE 65,A51,095125,Saad; Andrew S,25,0,26,1
1656838260824,ECE 109,A01,091882,Touri; Behrouz,16,0,70,54
1656838266848,ECE 180,A00,083140,Abi Samra; Nicholas Camill,0,0,30,30
1656838266848,ECE 180,B00,083141,Abi Samra; Nicholas Camill,0,0,30,30
1656838272878,MATH 10A,A01,083735,Patchell; Gregory David,1,0,30,29
1656838272878,MATH 10A,A02,083736,Patchell; Gregory David,20,0,30,10
1656838272878,MATH 10A,A03,083737,Patchell; Gregory David,15,0,30,15
1656838278913,MATH 10B,A01,083207,Lim; Seonhee,7,0,34,27
1656838278913,MATH 10B,A02,083208,Lim; Seonhee,9,0,35,26
1656838278913,MATH 10B,A03,093472,Lim; Seonhee,4,0,34,30
1656838278913,MATH 10B,B01,083739,Sinha; Shubham,9,0,30,21
1656838284938,MATH 18,A01,083743,Cinel; Cameron Alexander,6,0,30,24
1656838284938,MATH 18,A02,083744,Cinel; Cameron Alexander,15,0,30,15
1656838284938,MATH 18,A03,083745,Cinel; Cameron Alexander,8,0,30,22
1656838284938,MATH 18,B01,083748,Rideout; David Porter,3,0,37,34
1656838284938,MATH 18,B02,083749,Rideout; David Porter,3,0,36,33
1656838284938,MATH 18,B03,083750,Rideout; David Porter,2,0,37,35
1656838284938,MATH 18,B04,083751,Rideout; David Porter,5,0,36,31
1656838284938,MATH 18,B05,093473,Rideout; David Porter,4,0,36,32
1656838284938,MATH 18,B06,093474,Rideout; David Porter,5,0,36,31
1656838290969,MATH 20A,A01,083754,Zheng; Zequn,12,0,40,28
1656838296994,MATH 20B,A01,083756,Briones; Jor-el Thomas Caparas,1,0,36,35
1656838296994,MATH 20B,A02,083757,Briones; Jor-el Thomas Caparas,1,0,36,35
1656838296994,MATH 20B,A03,093475,Briones; Jor-el Thomas Caparas,0,0,36,36
1656838303019,MATH 20C,A01,083760,Briones; Jor-el Thomas Caparas,1,0,35,34
1656838303019,MATH 20C,A02,083761,Briones; Jor-el Thomas Caparas,8,0,35,27
1656838303019,MATH 20C,A03,093476,Briones; Jor-el Thomas Caparas,0,1,36,36
1656838303019,MATH 20C,B01,083762,Bach; Quang Tran,0,0,30,30
1656838309044,MATH 20D,A01,083765,Tran; Brian Kha,4,0,30,26
1656838309044,MATH 20D,A02,083766,Tran; Brian Kha,4,0,30,26
1656838309044,MATH 20D,A03,083767,Tran; Brian Kha,2,0,30,28
1656838315074,MATH 20E,A01,083771,Ganguly; Soumya,5,0,32,27
1656838315074,MATH 20E,A02,083772,Ganguly; Soumya,6,0,32,26
1656838315074,MATH 20E,B01,083773,Ciotti; Benjamin,18,0,35,17
1656838315074,MATH 20E,B02,083774,Ciotti; Benjamin,17,0,35,18
1656838321105,MATH 103A,A01,083777,Greenfeld; Be'Eri,2,0,36,34
1656838321105,MATH 103A,A02,083778,Greenfeld; Be'Eri,5,0,36,31
1656838321105,MATH 103A,A03,093561,Greenfeld; Be'Eri,4,0,36,32
1656838321105,MATH 103A,B01,083779,Greenfeld; Be'Eri,6,0,36,30
1656838321105,MATH 103A,B02,083780,Greenfeld; Be'Eri,2,0,36,34
1656838321105,MATH 103A,B03,093562,Greenfeld; Be'Eri,2,0,36,34
1656838327130,MATH 105,A01,085443,Carter; Anne Toulson,13,0,35,22
1656838327130,MATH 105,A02,093477,Carter; Anne Toulson,20,0,35,15
1656838333155,MATH 109,A01,083213,Ganzberger; Geoffrey Michael,2,0,34,32
1656838333155,MATH 109,A02,083214,Ganzberger; Geoffrey Michael,2,0,34,32
1656838333155,MATH 109,A03,093478,Ganzberger; Geoffrey Michael,1,0,34,33
1656838333155,MATH 109,B01,083215,Ganzberger; Geoffrey Michael,1,0,32,31
1656838333155,MATH 109,B02,083216,Ganzberger; Geoffrey Michael,1,0,32,31
1656838333155,MATH 109,B03,093479,Ganzberger; Geoffrey Michael,6,0,32,26
1656838339178,MATH 142A,A01,083219,Chow; Bennett,6,0,32,26
1656838339178,MATH 142A,A02,083220,Chow; Bennett,9,0,32,23
1656838339178,MATH 142A,A03,093480,Chow; Bennett,7,0,32,25
1656838339178,MATH 142A,B03,093481,Chow; Bennett,7,0,32,25
1656838339178,MATH 142A,B04,093558,Chow; Bennett,10,0,32,22
1656838339178,MATH 142A,B05,093559,Chow; Bennett,6,0,32,26
1656838345201,MATH 193A,A01,083224,Rotar; Vladimir,6,0,34,28
1656838345201,MATH 193A,A02,083225,Rotar; Vladimir,3,0,34,31
1656838345201,MATH 193A,A03,083781,Rotar; Vladimir,1,0,34,33
1656838345201,MATH 193A,A04,083782,Rotar; Vladimir,6,0,34,28
1656838345201,MATH 193A,A05,093482,Rotar; Vladimir,6,0,34,28
1656838351224,MATH 197,001,091859,McAuley; Julian John,9999,0,9999,0
1656838351224,MATH 197,002,095566,Kedlaya; Kiran S.,9997,0,9999,2
1656838351224,MATH 197,003,095567,Xiao; Ming,9999,0,9999,0
1656838351224,MATH 197,004,095571,Perols; Johan Lars,9998,0,9999,1
1656838358294,COGS 9,A01,083615,Shannon; Kyle Michael,6,0,75,69
1656838364317,COGS 11,A01,083617,Boyle; Mary E. T.,18,0,48,30
1656838370342,COGS 13,A01,083071,Bastos; Amalia Pinkusfeld,8,0,71,63
1656838376368,COGS 14A,A01,092681,Semenuks; Arturs,0,1,100,100
1656838382402,COGS 14B,A01,083073,Cheng; Tzu-Han,5,0,63,58
1656838388425,COGS 17,A01,092677,Semenuks; Arturs,4,0,81,77
1656838394448,COGS 100,A01,083619,Allen; Michael Gordon,15,0,70,55
1656838400478,COGS 101A,A01,083621,Davis; Joshua Daniel,9,0,68,59
1656838406507,COGS 101B,A01,091572,Allen; Michael Gordon,8,0,65,57
1656838412533,COGS 101C,A01,083625,Delgado; Tania,17,0,35,18
1656838418562,COGS 107A,A01,083627,Boyle; Mary E. T.,13,0,60,47
1656838424588,COGS 118A,A01,083075,Gupta; Anjum,15,0,76,61
1656838430615,CSE 3,A50,083646,Miranda; Gregory Joseph,22,0,50,28
1656838436642,CSE 8A,A50,083650,Miranda; Gregory Joseph,17,1,56,39
1656838442673,CSE 11,A01,083080,Cao; Yingjun,4,15,40,36
1656838448707,CSE 12,A01,083652,Krause-Levy; Sophia Louisa,20,1,120,100
1656838454737,CSE 15L,A01,083654,Morris; Justin Loren,8,0,50,42
1656838454737,CSE 15L,A02,083655,Morris; Justin Loren,8,0,50,42
1656838460763,CSE 20,A01,083657,Tran; Khoa Dang,37,0,80,43
1656838466798,CSE 21,A01,095574,Bach; Quang Tran,21,0,48,27
1656838472835,CSE 30,A01,083084,Eldon; John,4,0,80,76
1656838472835,CSE 30,B01,095061,Bhaskar; Nishant,6,0,50,44
1656838478866,CSE 100,A01,083659,Cao; Yingjun,2,4,70,68
1656838484892,CSE 134B,A01,083661,Powell; Thomas Allan,19,0,100,81
1656838490923,CSE 140,A01,083663,Gungor; Onat,14,0,85,71
1656838496953,CSE 140L,A01,083088,Eldon; John,16,0,100,84
1656838502987,CSE 175,A01,083665,Kumar; Rakesh,3,0,25,22
1656838509017,CSE 190,A00,092507,Dubnov; Shlomo,7,0,20,13
1656838515056,ECE 45,A01,083139,Congero; Spencer William,5,0,75,70
1656838521083,ECE 65,A50,083695,Saad; Andrew S,12,0,30,18
1656838521083,ECE 65,A51,095125,Saad; Andrew S,25,0,26,1
1656838527107,ECE 109,A01,091882,Touri; Behrouz,16,0,70,54
1656838533136,ECE 180,A00,083140,Abi Samra; Nicholas Camill,0,0,30,30
1656838533136,ECE 180,B00,083141,Abi Samra; Nicholas Camill,0,0,30,30
1656838539176,MATH 10A,A01,083735,Patchell; Gregory David,1,0,30,29
1656838539176,MATH 10A,A02,083736,Patchell; Gregory David,20,0,30,10
1656838539176,MATH 10A,A03,083737,Patchell; Gregory David,15,0,30,15
1656838545216,MATH 10B,A01,083207,Lim; Seonhee,7,0,34,27
1656838545216,MATH 10B,A02,083208,Lim; Seonhee,9,0,35,26
1656838545216,MATH 10B,A03,093472,Lim; Seonhee,4,0,34,30
1656838545216,MATH 10B,B01,083739,Sinha; Shubham,9,0,30,21
1656838551245,MATH 18,A01,083743,Cinel; Cameron Alexander,6,0,30,24
1656838551245,MATH 18,A02,083744,Cinel; Cameron Alexander,15,0,30,15
1656838551245,MATH 18,A03,083745,Cinel; Cameron Alexander,8,0,30,22
1656838551245,MATH 18,B01,083748,Rideout; David Porter,3,0,37,34
1656838551245,MATH 18,B02,083749,Rideout; David Porter,3,0,36,33
1656838551245,MATH 18,B03,083750,Rideout; David Porter,2,0,37,35
1656838551245,MATH 18,B04,083751,Rideout; David Porter,5,0,36,31
1656838551245,MATH 18,B05,093473,Rideout; David Porter,4,0,36,32
1656838551245,MATH 18,B06,093474,Rideout; David Porter,5,0,36,31
1656838557283,MATH 20A,A01,083754,Zheng; Zequn,12,0,40,28
1656838563309,MATH 20B,A01,083756,Briones; Jor-el Thomas Caparas,1,0,36,35
1656838563309,MATH 20B,A02,083757,Briones; Jor-el Thomas Caparas,1,0,36,35
1656838563309,MATH 20B,A03,093475,Briones; Jor-el Thomas Caparas,0,0,36,36
1656838569334,MATH 20C,A01,083760,Briones; Jor-el Thomas Caparas,1,0,35,34
1656838569334,MATH 20C,A02,083761,Briones; Jor-el Thomas Caparas,8,0,35,27
1656838569334,MATH 20C,A03,093476,Briones; Jor-el Thomas Caparas,0,1,36,36
1656838569334,MATH 20C,B01,083762,Bach; Quang Tran,0,0,30,30
1656838575366,MATH 20D,A01,083765,Tran; Brian Kha,4,0,30,26
1656838575366,MATH 20D,A02,083766,Tran; Brian Kha,4,0,30,26
1656838575366,MATH 20D,A03,083767,Tran; Brian Kha,2,0,30,28
1656838581400,MATH 20E,A01,083771,Ganguly; Soumya,5,0,32,27
1656838581400,MATH 20E,A02,083772,Ganguly; Soumya,6,0,32,26
1656838581400,MATH 20E,B01,083773,Ciotti; Benjamin,18,0,35,17
1656838581400,MATH 20E,B02,083774,Ciotti; Benjamin,17,0,35,18
1656838587439,MATH 103A,A01,083777,Greenfeld; Be'Eri,2,0,36,34
1656838587439,MATH 103A,A02,083778,Greenfeld; Be'Eri,5,0,36,31
1656838587439,MATH 103A,A03,093561,Greenfeld; Be'Eri,4,0,36,32
1656838587439,MATH 103A,B01,083779,Greenfeld; Be'Eri,6,0,36,30
1656838587439,MATH 103A,B02,083780,Greenfeld; Be'Eri,2,0,36,34
1656838587439,MATH 103A,B03,093562,Greenfeld; Be'Eri,2,0,36,34
1656838593469,MATH 105,A01,085443,Carter; Anne Toulson,13,0,35,22
1656838593469,MATH 105,A02,093477,Carter; Anne Toulson,20,0,35,15
1656838599505,MATH 109,A01,083213,Ganzberger; Geoffrey Michael,2,0,34,32
1656838599505,MATH 109,A02,083214,Ganzberger; Geoffrey Michael,2,0,34,32
1656838599505,MATH 109,A03,093478,Ganzberger; Geoffrey Michael,1,0,34,33
1656838599505,MATH 109,B01,083215,Ganzberger; Geoffrey Michael,1,0,32,31
1656838599505,MATH 109,B02,083216,Ganzberger; Geoffrey Michael,1,0,32,31
1656838599505,MATH 109,B03,093479,Ganzberger; Geoffrey Michael,6,0,32,26
1656838605548,MATH 142A,A01,083219,Chow; Bennett,6,0,32,26
1656838605548,MATH 142A,A02,083220,Chow; Bennett,9,0,32,23
1656838605548,MATH 142A,A03,093480,Chow; Bennett,7,0,32,25
1656838605548,MATH 142A,B03,093481,Chow; Bennett,7,0,32,25
1656838605548,MATH 142A,B04,093558,Chow; Bennett,10,0,32,22
1656838605548,MATH 142A,B05,093559,Chow; Bennett,6,0,32,26
1656838611580,MATH 193A,A01,083224,Rotar; Vladimir,6,0,34,28
1656838611580,MATH 193A,A02,083225,Rotar; Vladimir,3,0,34,31
1656838611580,MATH 193A,A03,083781,Rotar; Vladimir,1,0,34,33
1656838611580,MATH 193A,A04,083782,Rotar; Vladimir,6,0,34,28
1656838611580,MATH 193A,A05,093482,Rotar; Vladimir,6,0,34,28
1656838617617,MATH 197,001,091859,McAuley; Julian John,9999,0,9999,0
1656838617617,MATH 197,002,095566,Kedlaya; Kiran S.,9997,0,9999,2
1656838617617,MATH 197,003,095567,Xiao; Ming,9999,0,9999,0
1656838617617,MATH 197,004,095571,Perols; Johan Lars,9998,0,9999,1
1656838624698,COGS 9,A01,083615,Shannon; Kyle Michael,6,0,75,69
1656838630726,COGS 11,A01,083617,Boyle; Mary E. T.,18,0,48,30
1656838636764,COGS 13,A01,083071,Bastos; Amalia Pinkusfeld,8,0,71,63
1656838642789,COGS 14A,A01,092681,Semenuks; Arturs,0,1,100,100
1656838648816,COGS 14B,A01,083073,Cheng; Tzu-Han,5,0,63,58
1656838654844,COGS 17,A01,092677,Semenuks; Arturs,4,0,81,77
1656838660872,COGS 100,A01,083619,Allen; Michael Gordon,15,0,70,55
1656838666897,COGS 101A,A01,083621,Davis; Joshua Daniel,9,0,68,59
1656838672923,COGS 101B,A01,091572,Allen; Michael Gordon,8,0,65,57
1656838678953,COGS 101C,A01,083625,Delgado; Tania,17,0,35,18
1656838684980,COGS 107A,A01,083627,Boyle; Mary E. T.,13,0,60,47
1656838691005,COGS 118A,A01,083075,Gupta; Anjum,15,0,76,61
1656838697031,CSE 3,A50,083646,Miranda; Gregory Joseph,22,0,50,28
1656838703064,CSE 8A,A50,083650,Miranda; Gregory Joseph,17,1,56,39
1656838709088,CSE 11,A01,083080,Cao; Yingjun,4,15,40,36
1656838715114,CSE 12,A01,083652,Krause-Levy; Sophia Louisa,20,1,120,100
1656838721140,CSE 15L,A01,083654,Morris; Justin Loren,8,0,50,42
1656838721140,CSE 15L,A02,083655,Morris; Justin Loren,8,0,50,42
1656838727168,CSE 20,A01,083657,Tran; Khoa Dang,37,0,80,43
1656838733198,CSE 21,A01,095574,Bach; Quang Tran,21,0,48,27
1656838739224,CSE 30,A01,083084,Eldon; John,4,0,80,76
1656838739224,CSE 30,B01,095061,Bhaskar; Nishant,6,0,50,44
1656838745248,CSE 100,A01,083659,Cao; Yingjun,2,4,70,68
1656838751272,CSE 134B,A01,083661,Powell; Thomas Allan,19,0,100,81
1656838757309,CSE 140,A01,083663,Gungor; Onat,14,0,85,71
1656838763334,CSE 140L,A01,083088,Eldon; John,16,0,100,84
1656838769358,CSE 175,A01,083665,Kumar; Rakesh,3,0,25,22
1656838775380,CSE 190,A00,092507,Dubnov; Shlomo,7,0,20,13
1656838781408,ECE 45,A01,083139,Congero; Spencer William,5,0,75,70
1656838787442,ECE 65,A50,083695,Saad; Andrew S,12,0,30,18
1656838787442,ECE 65,A51,095125,Saad; Andrew S,25,0,26,1
1656838793471,ECE 109,A01,091882,Touri; Behrouz,16,0,70,54
1656838799500,ECE 180,A00,083140,Abi Samra; Nicholas Camill,0,0,30,30
1656838799500,ECE 180,B00,083141,Abi Samra; Nicholas Camill,0,0,30,30
1656838805535,MATH 10A,A01,083735,Patchell; Gregory David,1,0,30,29
1656838805535,MATH 10A,A02,083736,Patchell; Gregory David,20,0,30,10
1656838805535,MATH 10A,A03,083737,Patchell; Gregory David,15,0,30,15
1656838811656,MATH 10B,A01,083207,Lim; Seonhee,7,0,34,27
1656838811656,MATH 10B,A02,083208,Lim; Seonhee,9,0,35,26
1656838811656,MATH 10B,A03,093472,Lim; Seonhee,4,0,34,30
1656838811656,MATH 10B,B01,083739,Sinha; Shubham,9,0,30,21
1656838817706,MATH 18,A01,083743,Cinel; Cameron Alexander,6,0,30,24
1656838817706,MATH 18,A02,083744,Cinel; Cameron Alexander,15,0,30,15
1656838817706,MATH 18,A03,083745,Cinel; Cameron Alexander,8,0,30,22
1656838817706,MATH 18,B01,083748,Rideout; David Porter,3,0,37,34
1656838817706,MATH 18,B02,083749,Rideout; David Porter,3,0,36,33
1656838817706,MATH 18,B03,083750,Rideout; David Porter,2,0,37,35
1656838817706,MATH 18,B04,083751,Rideout; David Porter,5,0,36,31
1656838817706,MATH 18,B05,093473,Rideout; David Porter,4,0,36,32
1656838817706,MATH 18,B06,093474,Rideout; David Porter,5,0,36,31
1656838823737,MATH 20A,A01,083754,Zheng; Zequn,12,0,40,28
1656838829763,MATH 20B,A01,083756,Briones; Jor-el Thomas Caparas,1,0,36,35
1656838829763,MATH 20B,A02,083757,Briones; Jor-el Thomas Caparas,1,0,36,35
1656838829763,MATH 20B,A03,093475,Briones; Jor-el Thomas Caparas,0,0,36,36
1656838835799,MATH 20C,A01,083760,Briones; Jor-el Thomas Caparas,1,0,35,34
1656838835799,MATH 20C,A02,083761,Briones; Jor-el Thomas Caparas,8,0,35,27
1656838835799,MATH 20C,A03,093476,Briones; Jor-el Thomas Caparas,0,1,36,36
1656838835799,MATH 20C,B01,083762,Bach; Quang Tran,0,0,30,30
1656838841824,MATH 20D,A01,083765,Tran; Brian Kha,4,0,30,26
1656838841824,MATH 20D,A02,083766,Tran; Brian Kha,4,0,30,26
1656838841824,MATH 20D,A03,083767,Tran; Brian Kha,2,0,30,28
1656838847860,MATH 20E,A01,083771,Ganguly; Soumya,5,0,32,27
1656838847860,MATH 20E,A02,083772,Ganguly; Soumya,6,0,32,26
1656838847860,MATH 20E,B01,083773,Ciotti; Benjamin,18,0,35,17
1656838847860,MATH 20E,B02,083774,Ciotti; Benjamin,17,0,35,18
1656838853887,MATH 103A,A01,083777,Greenfeld; Be'Eri,2,0,36,34
1656838853887,MATH 103A,A02,083778,Greenfeld; Be'Eri,5,0,36,31
1656838853887,MATH 103A,A03,093561,Greenfeld; Be'Eri,4,0,36,32
1656838853887,MATH 103A,B01,083779,Greenfeld; Be'Eri,6,0,36,30
1656838853887,MATH 103A,B02,083780,Greenfeld; Be'Eri,2,0,36,34
1656838853887,MATH 103A,B03,093562,Greenfeld; Be'Eri,2,0,36,34
1656838859913,MATH 105,A01,085443,Carter; Anne Toulson,13,0,35,22
1656838859913,MATH 105,A02,093477,Carter; Anne Toulson,20,0,35,15
1656838865946,MATH 109,A01,083213,Ganzberger; Geoffrey Michael,2,0,34,32
1656838865946,MATH 109,A02,083214,Ganzberger; Geoffrey Michael,2,0,34,32
1656838865946,MATH 109,A03,093478,Ganzberger; Geoffrey Michael,1,0,34,33
1656838865946,MATH 109,B01,083215,Ganzberger; Geoffrey Michael,1,0,32,31
1656838865946,MATH 109,B02,083216,Ganzberger; Geoffrey Michael,1,0,32,31
1656838865946,MATH 109,B03,093479,Ganzberger; Geoffrey Michael,6,0,32,26
1656838871972,MATH 142A,A01,083219,Chow; Bennett,6,0,32,26
1656838871972,MATH 142A,A02,083220,Chow; Bennett,9,0,32,23
1656838871972,MATH 142A,A03,093480,Chow; Bennett,7,0,32,25
1656838871972,MATH 142A,B03,093481,Chow; Bennett,7,0,32,25
1656838871972,MATH 142A,B04,093558,Chow; Bennett,10,0,32,22
1656838871972,MATH 142A,B05,093559,Chow; Bennett,6,0,32,26
1656838878017,MATH 193A,A01,083224,Rotar; Vladimir,6,0,34,28
1656838878017,MATH 193A,A02,083225,Rotar; Vladimir,3,0,34,31
1656838878017,MATH 193A,A03,083781,Rotar; Vladimir,1,0,34,33
1656838878017,MATH 193A,A04,083782,Rotar; Vladimir,6,0,34,28
1656838878017,MATH 193A,A05,093482,Rotar; Vladimir,6,0,34,28
1656838884052,MATH 197,001,091859,McAuley; Julian John,9999,0,9999,0
1656838884052,MATH 197,002,095566,Kedlaya; Kiran S.,9997,0,9999,2
1656838884052,MATH 197,003,095567,Xiao; Ming,9999,0,9999,0
1656838884052,MATH 197,004,095571,Perols; Johan Lars,9998,0,9999,1
1656838891122,COGS 9,A01,083615,Shannon; Kyle Michael,6,0,75,69
1656838897144,COGS 11,A01,083617,Boyle; Mary E. T.,18,0,48,30
1656838903166,COGS 13,A01,083071,Bastos; Amalia Pinkusfeld,8,0,71,63
1656838909189,COGS 14A,A01,092681,Semenuks; Arturs,0,1,100,100
1656838915216,COGS 14B,A01,083073,Cheng; Tzu-Han,5,0,63,58
1656838921241,COGS 17,A01,092677,Semenuks; Arturs,4,0,81,77
1656838927270,COGS 100,A01,083619,Allen; Michael Gordon,15,0,70,55
1656838933296,COGS 101A,A01,083621,Davis; Joshua Daniel,9,0,68,59
1656838939320,COGS 101B,A01,091572,Allen; Michael Gordon,8,0,65,57
1656838945342,COGS 101C,A01,083625,Delgado; Tania,17,0,35,18
1656838951367,COGS 107A,A01,083627,Boyle; Mary E. T.,13,0,60,47
1656838957398,COGS 118A,A01,083075,Gupta; Anjum,15,0,76,61
1656838963427,CSE 3,A50,083646,Miranda; Gregory Joseph,22,0,50,28
1656838969455,CSE 8A,A50,083650,Miranda; Gregory Joseph,17,1,56,39
1656838975483,CSE 11,A01,083080,Cao; Yingjun,4,15,40,36
1656838981514,CSE 12,A01,083652,Krause-Levy; Sophia Louisa,20,1,120,100
1656838987538,CSE 15L,A01,083654,Morris; Justin Loren,8,0,50,42
1656838987538,CSE 15L,A02,083655,Morris; Justin Loren,8,0,50,42
1656838993561,CSE 20,A01,083657,Tran; Khoa Dang,37,0,80,43
1656838999586,CSE 21,A01,095574,Bach; Quang Tran,21,0,48,27
1656839005612,CSE 30,A01,083084,Eldon; John,4,0,80,76
1656839005612,CSE 30,B01,095061,Bhaskar; Nishant,6,0,50,44
1656839011644,CSE 100,A01,083659,Cao; Yingjun,2,4,70,68
1656839017666,CSE 134B,A01,083661,Powell; Thomas Allan,19,0,100,81
1656839023691,CSE 140,A01,083663,Gungor; Onat,14,0,85,71
1656839029713,CSE 140L,A01,083088,Eldon; John,16,0,100,84
1656839035740,CSE 175,A01,083665,Kumar; Rakesh,3,0,25,22
1656839041762,CSE 190,A00,092507,Dubnov; Shlomo,7,0,20,13
1656839047785,ECE 45,A01,083139,Congero; Spencer William,5,0,75,70
1656839053810,ECE 65,A50,083695,Saad; Andrew S,12,0,30,18
1656839053810,ECE 65,A51,095125,Saad; Andrew S,25,0,26,1
1656839059837,ECE 109,A01,091882,Touri; Behrouz,16,0,70,54
1656839065862,ECE 180,A00,083140,Abi Samra; Nicholas Camill,0,0,30,30
1656839065862,ECE 180,B00,083141,Abi Samra; Nicholas Camill,0,0,30,30
1656839071890,MATH 10A,A01,083735,Patchell; Gregory David,1,0,30,29
1656839071890,MATH 10A,A02,083736,Patchell; Gregory David,20,0,30,10
1656839071890,MATH 10A,A03,083737,Patchell; Gregory David,15,0,30,15
1656839077914,MATH 10B,A01,083207,Lim; Seonhee,7,0,34,27
1656839077914,MATH 10B,A02,083208,Lim; Seonhee,9,0,35,26
1656839077914,MATH 10B,A03,093472,Lim; Seonhee,4,0,34,30
1656839077914,MATH 10B,B01,083739,Sinha; Shubham,9,0,30,21
1656839083949,MATH 18,A01,083743,Cinel; Cameron Alexander,6,0,30,24
1656839083949,MATH 18,A02,083744,Cinel; Cameron Alexander,15,0,30,15
1656839083949,MATH 18,A03,083745,Cinel; Cameron Alexander,8,0,30,22
1656839083949,MATH 18,B01,083748,Rideout; David Porter,3,0,37,34
1656839083949,MATH 18,B02,083749,Rideout; David Porter,3,0,36,33
1656839083949,MATH 18,B03,083750,Rideout; David Porter,2,0,37,35
1656839083949,MATH 18,B04,083751,Rideout; David Porter,5,0,36,31
1656839083949,MATH 18,B05,093473,Rideout; David Porter,4,0,36,32
1656839083949,MATH 18,B06,093474,Rideout; David Porter,5,0,36,31
1656839089972,MATH 20A,A01,083754,Zheng; Zequn,12,0,40,28
1656839095998,MATH 20B,A01,083756,Briones; Jor-el Thomas Caparas,1,0,36,35
1656839095998,MATH 20B,A02,083757,Briones; Jor-el Thomas Caparas,1,0,36,35
1656839095998,MATH 20B,A03,093475,Briones; Jor-el Thomas Caparas,0,0,36,36
1656839102022,MATH 20C,A01,083760,Briones; Jor-el Thomas Caparas,1,0,35,34
1656839102022,MATH 20C,A02,083761,Briones; Jor-el Thomas Caparas,8,0,35,27
1656839102022,MATH 20C,A03,093476,Briones; Jor-el Thomas Caparas,0,1,36,36
1656839102022,MATH 20C,B01,083762,Bach; Quang Tran,0,0,30,30
1656839108046,MATH 20D,A01,083765,Tran; Brian Kha,4,0,30,26
1656839108046,MATH 20D,A02,083766,Tran; Brian Kha,4,0,30,26
1656839108046,MATH 20D,A03,083767,Tran; Brian Kha,2,0,30,28
1656839114073,MATH 20E,A01,083771,Ganguly; Soumya,5,0,32,27
1656839114073,MATH 20E,A02,083772,Ganguly; Soumya,6,0,32,26
1656839114073,MATH 20E,B01,083773,Ciotti; Benjamin,18,0,35,17
1656839114073,MATH 20E,B02,083774,Ciotti; Benjamin,17,0,35,18
1656839120099,MATH 103A,A01,083777,Greenfeld; Be'Eri,2,0,36,34
1656839120099,MATH 103A,A02,083778,Greenfeld; Be'Eri,5,0,36,31
1656839120099,MATH 103A,A03,093561,Greenfeld; Be'Eri,4,0,36,32
1656839120099,MATH 103A,B01,083779,Greenfeld; Be'Eri,6,0,36,30
1656839120099,MATH 103A,B02,083780,Greenfeld; Be'Eri,2,0,36,34
1656839120099,MATH 103A,B03,093562,Greenfeld; Be'Eri,2,0,36,34
1656839126128,MATH 105,A01,085443,Carter; Anne Toulson,13,0,35,22
1656839126128,MATH 105,A02,093477,Carter; Anne Toulson,20,0,35,15
1656839132154,MATH 109,A01,083213,Ganzberger; Geoffrey Michael,2,0,34,32
1656839132154,MATH 109,A02,083214,Ganzberger; Geoffrey Michael,2,0,34,32
1656839132154,MATH 109,A03,093478,Ganzberger; Geoffrey Michael,1,0,34,33
1656839132154,MATH 109,B01,083215,Ganzberger; Geoffrey Michael,1,0,32,31
1656839132154,MATH 109,B02,083216,Ganzberger; Geoffrey Michael,1,0,32,31
1656839132154,MATH 109,B03,093479,Ganzberger; Geoffrey Michael,6,0,32,26
1656839138178,MATH 142A,A01,083219,Chow; Bennett,6,0,32,26
1656839138178,MATH 142A,A02,083220,Chow; Bennett,9,0,32,23
1656839138178,MATH 142A,A03,093480,Chow; Bennett,7,0,32,25
1656839138178,MATH 142A,B03,093481,Chow; Bennett,7,0,32,25
1656839138178,MATH 142A,B04,093558,Chow; Bennett,10,0,32,22
1656839138178,MATH 142A,B05,093559,Chow; Bennett,6,0,32,26
1656839144210,MATH 193A,A01,083224,Rotar; Vladimir,6,0,34,28
1656839144210,MATH 193A,A02,083225,Rotar; Vladimir,3,0,34,31
1656839144210,MATH 193A,A03,083781,Rotar; Vladimir,1,0,34,33
1656839144210,MATH 193A,A04,083782,Rotar; Vladimir,6,0,34,28
1656839144210,MATH 193A,A05,093482,Rotar; Vladimir,6,0,34,28
1656839150234,MATH 197,001,091859,McAuley; Julian John,9999,0,9999,0
1656839150234,MATH 197,002,095566,Kedlaya; Kiran S.,9997,0,9999,2
1656839150234,MATH 197,003,095567,Xiao; Ming,9999,0,9999,0
1656839150234,MATH 197,004,095571,Perols; Johan Lars,9998,0,9999,1
1656839157309,COGS 9,A01,083615,Shannon; Kyle Michael,6,0,75,69
1656839163340,COGS 11,A01,083617,Boyle; Mary E. T.,18,0,48,30
1656839169365,COGS 13,A01,083071,Bastos; Amalia Pinkusfeld,8,0,71,63
1656839175392,COGS 14A,A01,092681,Semenuks; Arturs,0,1,100,100
1656839181421,COGS 14B,A01,083073,Cheng; Tzu-Han,5,0,63,58
1656839187449,COGS 17,A01,092677,Semenuks; Arturs,4,0,81,77
1656839193474,COGS 100,A01,083619,Allen; Michael Gordon,15,0,70,55
1656839199503,COGS 101A,A01,083621,Davis; Joshua Daniel,9,0,68,59
1656839205527,COGS 101B,A01,091572,Allen; Michael Gordon,8,0,65,57
1656839211552,COGS 101C,A01,083625,Delgado; Tania,17,0,35,18
1656839217580,COGS 107A,A01,083627,Boyle; Mary E. T.,13,0,60,47
1656839223604,COGS 118A,A01,083075,Gupta; Anjum,15,0,76,61
1656839229630,CSE 3,A50,083646,Miranda; Gregory Joseph,22,0,50,28
1656839235664,CSE 8A,A50,083650,Miranda; Gregory Joseph,17,1,56,39
1656839241687,CSE 11,A01,083080,Cao; Yingjun,4,15,40,36
1656839247718,CSE 12,A01,083652,Krause-Levy; Sophia Louisa,20,1,120,100
1656839253748,CSE 15L,A01,083654,Morris; Justin Loren,8,0,50,42
1656839253748,CSE 15L,A02,083655,Morris; Justin Loren,8,0,50,42
1656839259776,CSE 20,A01,083657,Tran; Khoa Dang,37,0,80,43
1656839265804,CSE 21,A01,095574,Bach; Quang Tran,21,0,48,27
1656839271835,CSE 30,A01,083084,Eldon; John,4,0,80,76
1656839271835,CSE 30,B01,095061,Bhaskar; Nishant,6,0,50,44
1656839277871,CSE 100,A01,083659,Cao; Yingjun,2,4,70,68
1656839283894,CSE 134B,A01,083661,Powell; Thomas Allan,19,0,100,81
1656839289917,CSE 140,A01,083663,Gungor; Onat,14,0,85,71
1656839295955,CSE 140L,A01,083088,Eldon; John,16,0,100,84
1656839301996,CSE 175,A01,083665,Kumar; Rakesh,3,0,25,22
1656839308025,CSE 190,A00,092507,Dubnov; Shlomo,7,0,20,13
1656839314058,ECE 45,A01,083139,Congero; Spencer William,5,0,75,70
1656839320096,ECE 65,A50,083695,Saad; Andrew S,12,0,30,18
1656839320096,ECE 65,A51,095125,Saad; Andrew S,25,0,26,1
1656839326118,ECE 109,A01,091882,Touri; Behrouz,16,0,70,54
1656839332142,ECE 180,A00,083140,Abi Samra; Nicholas Camill,0,0,30,30
1656839332142,ECE 180,B00,083141,Abi Samra; Nicholas Camill,0,0,30,30
1656839338167,MATH 10A,A01,083735,Patchell; Gregory David,1,0,30,29
1656839338167,MATH 10A,A02,083736,Patchell; Gregory David,20,0,30,10
1656839338167,MATH 10A,A03,083737,Patchell; Gregory David,15,0,30,15
1656839344204,MATH 10B,A01,083207,Lim; Seonhee,7,0,34,27
1656839344204,MATH 10B,A02,083208,Lim; Seonhee,9,0,35,26
1656839344204,MATH 10B,A03,093472,Lim; Seonhee,4,0,34,30
1656839344204,MATH 10B,B01,083739,Sinha; Shubham,9,0,30,21
1656839350238,MATH 18,A01,083743,Cinel; Cameron Alexander,6,0,30,24
1656839350238,MATH 18,A02,083744,Cinel; Cameron Alexander,15,0,30,15
1656839350238,MATH 18,A03,083745,Cinel; Cameron Alexander,8,0,30,22
1656839350238,MATH 18,B01,083748,Rideout; David Porter,3,0,37,34
1656839350238,MATH 18,B02,083749,Rideout; David Porter,3,0,36,33
1656839350238,MATH 18,B03,083750,Rideout; David Porter,2,0,37,35
1656839350238,MATH 18,B04,083751,Rideout; David Porter,5,0,36,31
1656839350238,MATH 18,B05,093473,Rideout; David Porter,4,0,36,32
1656839350238,MATH 18,B06,093474,Rideout; David Porter,5,0,36,31
1656839356263,MATH 20A,A01,083754,Zheng; Zequn,12,0,40,28
1656839362289,MATH 20B,A01,083756,Briones; Jor-el Thomas Caparas,1,0,36,35
1656839362289,MATH 20B,A02,083757,Briones; Jor-el Thomas Caparas,1,0,36,35
1656839362289,MATH 20B,A03,093475,Briones; Jor-el Thomas Caparas,0,0,36,36
1656839368319,MATH 20C,A01,083760,Briones; Jor-el Thomas Caparas,1,0,35,34
1656839368319,MATH 20C,A02,083761,Briones; Jor-el Thomas Caparas,8,0,35,27
1656839368319,MATH 20C,A03,093476,Briones; Jor-el Thomas Caparas,0,1,36,36
1656839368319,MATH 20C,B01,083762,Bach; Quang Tran,0,0,30,30
1656839374346,MATH 20D,A01,083765,Tran; Brian Kha,4,0,30,26
1656839374346,MATH 20D,A02,083766,Tran; Brian Kha,4,0,30,26
1656839374346,MATH 20D,A03,083767,Tran; Brian Kha,2,0,30,28
1656839380373,MATH 20E,A01,083771,Ganguly; Soumya,5,0,32,27
1656839380373,MATH 20E,A02,083772,Ganguly; Soumya,6,0,32,26
1656839380373,MATH 20E,B01,083773,Ciotti; Benjamin,18,0,35,17
1656839380373,MATH 20E,B02,083774,Ciotti; Benjamin,17,0,35,18
1656839386407,MATH 103A,A01,083777,Greenfeld; Be'Eri,2,0,36,34
1656839386407,MATH 103A,A02,083778,Greenfeld; Be'Eri,5,0,36,31
1656839386407,MATH 103A,A03,093561,Greenfeld; Be'Eri,4,0,36,32
1656839386407,MATH 103A,B01,083779,Greenfeld; Be'Eri,6,0,36,30
1656839386407,MATH 103A,B02,083780,Greenfeld; Be'Eri,2,0,36,34
1656839386407,MATH 103A,B03,093562,Greenfeld; Be'Eri,2,0,36,34
1656839392438,MATH 105,A01,085443,Carter; Anne Toulson,13,0,35,22
1656839392438,MATH 105,A02,093477,Carter; Anne Toulson,20,0,35,15
1656839398470,MATH 109,A01,083213,Ganzberger; Geoffrey Michael,2,0,34,32
1656839398470,MATH 109,A02,083214,Ganzberger; Geoffrey Michael,2,0,34,32
1656839398470,MATH 109,A03,093478,Ganzberger; Geoffrey Michael,1,0,34,33
1656839398470,MATH 109,B01,083215,Ganzberger; Geoffrey Michael,1,0,32,31
1656839398470,MATH 109,B02,083216,Ganzberger; Geoffrey Michael,1,0,32,31
1656839398470,MATH 109,B03,093479,Ganzberger; Geoffrey Michael,6,0,32,26
1656839404496,MATH 142A,A01,083219,Chow; Bennett,6,0,32,26
1656839404496,MATH 142A,A02,083220,Chow; Bennett,9,0,32,23
1656839404496,MATH 142A,A03,093480,Chow; Bennett,7,0,32,25
1656839404496,MATH 142A,B03,093481,Chow; Bennett,7,0,32,25
1656839404496,MATH 142A,B04,093558,Chow; Bennett,10,0,32,22
1656839404496,MATH 142A,B05,093559,Chow; Bennett,6,0,32,26
1656839410593,MATH 193A,A01,083224,Rotar; Vladimir,6,0,34,28
1656839410593,MATH 193A,A02,083225,Rotar; Vladimir,3,0,34,31
1656839410593,MATH 193A,A03,083781,Rotar; Vladimir,1,0,34,33
1656839410593,MATH 193A,A04,083782,Rotar; Vladimir,6,0,34,28
1656839410593,MATH 193A,A05,093482,Rotar; Vladimir,6,0,34,28
1656839416624,MATH 197,001,091859,McAuley; Julian John,9999,0,9999,0
1656839416624,MATH 197,002,095566,Kedlaya; Kiran S.,9997,0,9999,2
1656839416624,MATH 197,003,095567,Xiao; Ming,9999,0,9999,0
1656839416624,MATH 197,004,095571,Perols; Johan Lars,9998,0,9999,1
1656839423703,COGS 9,A01,083615,Shannon; Kyle Michael,6,0,75,69
1656839429743,COGS 11,A01,083617,Boyle; Mary E. T.,18,0,48,30
1656839435773,COGS 13,A01,083071,Bastos; Amalia Pinkusfeld,8,0,71,63
1656839441796,COGS 14A,A01,092681,Semenuks; Arturs,0,1,100,100
1656839447822,COGS 14B,A01,083073,Cheng; Tzu-Han,5,0,63,58
1656839453850,COGS 17,A01,092677,Semenuks; Arturs,4,0,81,77
1656839459881,COGS 100,A01,083619,Allen; Michael Gordon,15,0,70,55
1656839465906,COGS 101A,A01,083621,Davis; Joshua Daniel,9,0,68,59
1656839471933,COGS 101B,A01,091572,Allen; Michael Gordon,8,0,65,57
1656839477959,COGS 101C,A01,083625,Delgado; Tania,17,0,35,18
1656839483983,COGS 107A,A01,083627,Boyle; Mary E. T.,13,0,60,47
1656839490025,COGS 118A,A01,083075,Gupta; Anjum,15,0,76,61
1656839496055,CSE 3,A50,083646,Miranda; Gregory Joseph,22,0,50,28
1656839502085,CSE 8A,A50,083650,Miranda; Gregory Joseph,17,1,56,39
1656839508115,CSE 11,A01,083080,Cao; Yingjun,4,15,40,36
1656839514140,CSE 12,A01,083652,Krause-Levy; Sophia Louisa,20,1,120,100
1656839520169,CSE 15L,A01,083654,Morris; Justin Loren,8,0,50,42
1656839520169,CSE 15L,A02,083655,Morris; Justin Loren,8,0,50,42
1656839526199,CSE 20,A01,083657,Tran; Khoa Dang,37,0,80,43
1656839532222,CSE 21,A01,095574,Bach; Quang Tran,21,0,48,27
1656839538249,CSE 30,A01,083084,Eldon; John,4,0,80,76
1656839538249,CSE 30,B01,095061,Bhaskar; Nishant,6,0,50,44
1656839544278,CSE 100,A01,083659,Cao; Yingjun,2,4,70,68
1656839550305,CSE 134B,A01,083661,Powell; Thomas Allan,19,0,100,81
1656839556330,CSE 140,A01,083663,Gungor; Onat,14,0,85,71
1656839562353,CSE 140L,A01,083088,Eldon; John,16,0,100,84
1656839568378,CSE 175,A01,083665,Kumar; Rakesh,3,0,25,22
1656839574407,CSE 190,A00,092507,Dubnov; Shlomo,7,0,20,13
1656839580433,ECE 45,A01,083139,Congero; Spencer William,5,0,75,70
1656839586459,ECE 65,A50,083695,Saad; Andrew S,12,0,30,18
1656839586459,ECE 65,A51,095125,Saad; Andrew S,25,0,26,1
1656839592488,ECE 109,A01,091882,Touri; Behrouz,16,0,70,54
1656839598515,ECE 180,A00,083140,Abi Samra; Nicholas Camill,0,0,30,30
1656839598515,ECE 180,B00,083141,Abi Samra; Nicholas Camill,0,0,30,30
1656839604550,MATH 10A,A01,083735,Patchell; Gregory David,1,0,30,29
1656839604550,MATH 10A,A02,083736,Patchell; Gregory David,20,0,30,10
1656839604550,MATH 10A,A03,083737,Patchell; Gregory David,15,0,30,15
1656839610586,MATH 10B,A01,083207,Lim; Seonhee,7,0,34,27
1656839610586,MATH 10B,A02,083208,Lim; Seonhee,9,0,35,26
1656839610586,MATH 10B,A03,093472,Lim; Seonhee,4,0,34,30
1656839610586,MATH 10B,B01,083739,Sinha; Shubham,9,0,30,21
1656839616616,MATH 18,A01,083743,Cinel; Cameron Alexander,6,0,30,24
1656839616616,MATH 18,A02,083744,Cinel; Cameron Alexander,15,0,30,15
1656839616616,MATH 18,A03,083745,Cinel; Cameron Alexander,8,0,30,22
1656839616616,MATH 18,B01,083748,Rideout; David Porter,3,0,37,34
1656839616616,MATH 18,B02,083749,Rideout; David Porter,3,0,36,33
1656839616616,MATH 18,B03,083750,Rideout; David Porter,2,0,37,35
1656839616616,MATH 18,B04,083751,Rideout; David Porter,5,0,36,31
1656839616616,MATH 18,B05,093473,Rideout; David Porter,4,0,36,32
1656839616616,MATH 18,B06,093474,Rideout; David Porter,5,0,36,31
1656839622647,MATH 20A,A01,083754,Zheng; Zequn,12,0,40,28
1656839628672,MATH 20B,A01,083756,Briones; Jor-el Thomas Caparas,1,0,36,35
1656839628672,MATH 20B,A02,083757,Briones; Jor-el Thomas Caparas,1,0,36,35
1656839628672,MATH 20B,A03,093475,Briones; Jor-el Thomas Caparas,0,0,36,36
1656839634706,MATH 20C,A01,083760,Briones; Jor-el Thomas Caparas,1,0,35,34
1656839634706,MATH 20C,A02,083761,Briones; Jor-el Thomas Caparas,8,0,35,27
1656839634706,MATH 20C,A03,093476,Briones; Jor-el Thomas Caparas,0,1,36,36
1656839634706,MATH 20C,B01,083762,Bach; Quang Tran,0,0,30,30
1656839640731,MATH 20D,A01,083765,Tran; Brian Kha,4,0,30,26
1656839640731,MATH 20D,A02,083766,Tran; Brian Kha,4,0,30,26
1656839640731,MATH 20D,A03,083767,Tran; Brian Kha,2,0,30,28
1656839646763,MATH 20E,A01,083771,Ganguly; Soumya,5,0,32,27
1656839646763,MATH 20E,A02,083772,Ganguly; Soumya,6,0,32,26
1656839646763,MATH 20E,B01,083773,Ciotti; Benjamin,18,0,35,17
1656839646763,MATH 20E,B02,083774,Ciotti; Benjamin,17,0,35,18
1656839652788,MATH 103A,A01,083777,Greenfeld; Be'Eri,2,0,36,34
1656839652788,MATH 103A,A02,083778,Greenfeld; Be'Eri,5,0,36,31
1656839652788,MATH 103A,A03,093561,Greenfeld; Be'Eri,4,0,36,32
1656839652788,MATH 103A,B01,083779,Greenfeld; Be'Eri,6,0,36,30
1656839652788,MATH 103A,B02,083780,Greenfeld; Be'Eri,2,0,36,34
1656839652788,MATH 103A,B03,093562,Greenfeld; Be'Eri,2,0,36,34
1656839658812,MATH 105,A01,085443,Carter; Anne Toulson,13,0,35,22
1656839658812,MATH 105,A02,093477,Carter; Anne Toulson,20,0,35,15
1656839664837,MATH 109,A01,083213,Ganzberger; Geoffrey Michael,2,0,34,32
1656839664837,MATH 109,A02,083214,Ganzberger; Geoffrey Michael,2,0,34,32
1656839664837,MATH 109,A03,093478,Ganzberger; Geoffrey Michael,1,0,34,33
1656839664837,MATH 109,B01,083215,Ganzberger; Geoffrey Michael,1,0,32,31
1656839664837,MATH 109,B02,083216,Ganzberger; Geoffrey Michael,1,0,32,31
1656839664837,MATH 109,B03,093479,Ganzberger; Geoffrey Michael,6,0,32,26
1656839670871,MATH 142A,A01,083219,Chow; Bennett,6,0,32,26
1656839670871,MATH 142A,A02,083220,Chow; Bennett,9,0,32,23
1656839670871,MATH 142A,A03,093480,Chow; Bennett,7,0,32,25
1656839670871,MATH 142A,B03,093481,Chow; Bennett,7,0,32,25
1656839670871,MATH 142A,B04,093558,Chow; Bennett,10,0,32,22
1656839670871,MATH 142A,B05,093559,Chow; Bennett,6,0,32,26
1656839676897,MATH 193A,A01,083224,Rotar; Vladimir,6,0,34,28
1656839676897,MATH 193A,A02,083225,Rotar; Vladimir,3,0,34,31
1656839676897,MATH 193A,A03,083781,Rotar; Vladimir,1,0,34,33
1656839676897,MATH 193A,A04,083782,Rotar; Vladimir,6,0,34,28
1656839676897,MATH 193A,A05,093482,Rotar; Vladimir,6,0,34,28
1656839682922,MATH 197,001,091859,McAuley; Julian John,9999,0,9999,0
1656839682922,MATH 197,002,095566,Kedlaya; Kiran S.,9997,0,9999,2
1656839682922,MATH 197,003,095567,Xiao; Ming,9999,0,9999,0
1656839682922,MATH 197,004,095571,Perols; Johan Lars,9998,0,9999,1
1656839689999,COGS 9,A01,083615,Shannon; Kyle Michael,6,0,75,69
1656839696027,COGS 11,A01,083617,Boyle; Mary E. T.,18,0,48,30
1656839702058,COGS 13,A01,083071,Bastos; Amalia Pinkusfeld,8,0,71,63
1656839708087,COGS 14A,A01,092681,Semenuks; Arturs,0,1,100,100
1656839714120,COGS 14B,A01,083073,Cheng; Tzu-Han,5,0,63,58
1656839720144,COGS 17,A01,092677,Semenuks; Arturs,4,0,81,77
1656839726172,COGS 100,A01,083619,Allen; Michael Gordon,15,0,70,55
1656839732194,COGS 101A,A01,083621,Davis; Joshua Daniel,9,0,68,59
1656839738219,COGS 101B,A01,091572,Allen; Michael Gordon,8,0,65,57
1656839744244,COGS 101C,A01,083625,Delgado; Tania,17,0,35,18
1656839750268,COGS 107A,A01,083627,Boyle; Mary E. T.,13,0,60,47
1656839756291,COGS 118A,A01,083075,Gupta; Anjum,15,0,76,61
1656839762317,CSE 3,A50,083646,Miranda; Gregory Joseph,22,0,50,28
1656839768345,CSE 8A,A50,083650,Miranda; Gregory Joseph,17,1,56,39
1656839774371,CSE 11,A01,083080,Cao; Yingjun,4,15,40,36
1656839780394,CSE 12,A01,083652,Krause-Levy; Sophia Louisa,20,1,120,100
1656839786420,CSE 15L,A01,083654,Morris; Justin Loren,8,0,50,42
1656839786420,CSE 15L,A02,083655,Morris; Justin Loren,8,0,50,42
1656839792444,CSE 20,A01,083657,Tran; Khoa Dang,37,0,80,43
1656839798472,CSE 21,A01,095574,Bach; Quang Tran,21,0,48,27
1656839804503,CSE 30,A01,083084,Eldon; John,4,0,80,76
1656839804503,CSE 30,B01,095061,Bhaskar; Nishant,6,0,50,44
1656839810526,CSE 100,A01,083659,Cao; Yingjun,2,4,70,68
1656839816553,CSE 134B,A01,083661,Powell; Thomas Allan,19,0,100,81
1656839822582,CSE 140,A01,083663,Gungor; Onat,14,0,85,71
1656839828607,CSE 140L,A01,083088,Eldon; John,16,0,100,84
1656839834638,CSE 175,A01,083665,Kumar; Rakesh,3,0,25,22
1656839840661,CSE 190,A00,092507,Dubnov; Shlomo,7,0,20,13
1656839846689,ECE 45,A01,083139,Congero; Spencer William,5,0,75,70
1656839852720,ECE 65,A50,083695,Saad; Andrew S,12,0,30,18
1656839852720,ECE 65,A51,095125,Saad; Andrew S,25,0,26,1
1656839858752,ECE 109,A01,091882,Touri; Behrouz,16,0,70,54
1656839864779,ECE 180,A00,083140,Abi Samra; Nicholas Camill,0,0,30,30
1656839864779,ECE 180,B00,083141,Abi Samra; Nicholas Camill,0,0,30,30
1656839870806,MATH 10A,A01,083735,Patchell; Gregory David,1,0,30,29
1656839870806,MATH 10A,A02,083736,Patchell; Gregory David,20,0,30,10
1656839870806,MATH 10A,A03,083737,Patchell; Gregory David,15,0,30,15
1656839876840,MATH 10B,A01,083207,Lim; Seonhee,7,0,34,27
1656839876840,MATH 10B,A02,083208,Lim; Seonhee,9,0,35,26
1656839876840,MATH 10B,A03,093472,Lim; Seonhee,4,0,34,30
1656839876840,MATH 10B,B01,083739,Sinha; Shubham,9,0,30,21
1656839882875,MATH 18,A01,083743,Cinel; Cameron Alexander,6,0,30,24
1656839882875,MATH 18,A02,083744,Cinel; Cameron Alexander,15,0,30,15
1656839882875,MATH 18,A03,083745,Cinel; Cameron Alexander,8,0,30,22
1656839882875,MATH 18,B01,083748,Rideout; David Porter,3,0,37,34
1656839882875,MATH 18,B02,083749,Rideout; David Porter,3,0,36,33
1656839882875,MATH 18,B03,083750,Rideout; David Porter,2,0,37,35
1656839882875,MATH 18,B04,083751,Rideout; David Porter,5,0,36,31
1656839882875,MATH 18,B05,093473,Rideout; David Porter,4,0,36,32
1656839882875,MATH 18,B06,093474,Rideout; David Porter,5,0,36,31
1656839888899,MATH 20A,A01,083754,Zheng; Zequn,12,0,40,28
1656839894922,MATH 20B,A01,083756,Briones; Jor-el Thomas Caparas,1,0,36,35
1656839894922,MATH 20B,A02,083757,Briones; Jor-el Thomas Caparas,1,0,36,35
1656839894922,MATH 20B,A03,093475,Briones; Jor-el Thomas Caparas,0,0,36,36
1656839900951,MATH 20C,A01,083760,Briones; Jor-el Thomas Caparas,1,0,35,34
1656839900951,MATH 20C,A02,083761,Briones; Jor-el Thomas Caparas,8,0,35,27
1656839900951,MATH 20C,A03,093476,Briones; Jor-el Thomas Caparas,0,1,36,36
1656839900951,MATH 20C,B01,083762,Bach; Quang Tran,0,0,30,30
1656839906978,MATH 20D,A01,083765,Tran; Brian Kha,4,0,30,26
1656839906978,MATH 20D,A02,083766,Tran; Brian Kha,4,0,30,26
1656839906978,MATH 20D,A03,083767,Tran; Brian Kha,2,0,30,28
1656839913008,MATH 20E,A01,083771,Ganguly; Soumya,5,0,32,27
1656839913008,MATH 20E,A02,083772,Ganguly; Soumya,6,0,32,26
1656839913008,MATH 20E,B01,083773,Ciotti; Benjamin,18,0,35,17
1656839913008,MATH 20E,B02,083774,Ciotti; Benjamin,17,0,35,18
1656839919035,MATH 103A,A01,083777,Greenfeld; Be'Eri,2,0,36,34
1656839919035,MATH 103A,A02,083778,Greenfeld; Be'Eri,5,0,36,31
1656839919035,MATH 103A,A03,093561,Greenfeld; Be'Eri,4,0,36,32
1656839919035,MATH 103A,B01,083779,Greenfeld; Be'Eri,6,0,36,30
1656839919035,MATH 103A,B02,083780,Greenfeld; Be'Eri,2,0,36,34
1656839919035,MATH 103A,B03,093562,Greenfeld; Be'Eri,2,0,36,34
1656839925064,MATH 105,A01,085443,Carter; Anne Toulson,13,0,35,22
1656839925064,MATH 105,A02,093477,Carter; Anne Toulson,20,0,35,15
1656839931098,MATH 109,A01,083213,Ganzberger; Geoffrey Michael,2,0,34,32
1656839931098,MATH 109,A02,083214,Ganzberger; Geoffrey Michael,2,0,34,32
1656839931098,MATH 109,A03,093478,Ganzberger; Geoffrey Michael,1,0,34,33
1656839931098,MATH 109,B01,083215,Ganzberger; Geoffrey Michael,1,0,32,31
1656839931098,MATH 109,B02,083216,Ganzberger; Geoffrey Michael,1,0,32,31
1656839931098,MATH 109,B03,093479,Ganzberger; Geoffrey Michael,6,0,32,26
1656839937123,MATH 142A,A01,083219,Chow; Bennett,6,0,32,26
1656839937123,MATH 142A,A02,083220,Chow; Bennett,9,0,32,23
1656839937123,MATH 142A,A03,093480,Chow; Bennett,7,0,32,25
1656839937123,MATH 142A,B03,093481,Chow; Bennett,7,0,32,25
1656839937123,MATH 142A,B04,093558,Chow; Bennett,10,0,32,22
1656839937123,MATH 142A,B05,093559,Chow; Bennett,6,0,32,26
1656839943152,MATH 193A,A01,083224,Rotar; Vladimir,6,0,34,28
1656839943152,MATH 193A,A02,083225,Rotar; Vladimir,3,0,34,31
1656839943152,MATH 193A,A03,083781,Rotar; Vladimir,1,0,34,33
1656839943152,MATH 193A,A04,083782,Rotar; Vladimir,6,0,34,28
1656839943152,MATH 193A,A05,093482,Rotar; Vladimir,6,0,34,28
1656839949178,MATH 197,001,091859,McAuley; Julian John,9999,0,9999,0
1656839949178,MATH 197,002,095566,Kedlaya; Kiran S.,9997,0,9999,2
1656839949178,MATH 197,003,095567,Xiao; Ming,9999,0,9999,0
1656839949178,MATH 197,004,095571,Perols; Johan Lars,9998,0,9999,1
1656839956259,COGS 9,A01,083615,Shannon; Kyle Michael,6,0,75,69
1656839962287,COGS 11,A01,083617,Boyle; Mary E. T.,18,0,48,30
1656839968315,COGS 13,A01,083071,Bastos; Amalia Pinkusfeld,8,0,71,63
1656839974339,COGS 14A,A01,092681,Semenuks; Arturs,0,1,100,100
1656839980364,COGS 14B,A01,083073,Cheng; Tzu-Han,5,0,63,58
1656839986391,COGS 17,A01,092677,Semenuks; Arturs,4,0,81,77
1656839992414,COGS 100,A01,083619,Allen; Michael Gordon,15,0,70,55
1656839998441,COGS 101A,A01,083621,Davis; Joshua Daniel,9,0,68,59
1656840004540,COGS 101B,A01,091572,Allen; Michael Gordon,8,0,65,57
1656840010564,COGS 101C,A01,083625,Delgado; Tania,17,0,35,18
1656840016588,COGS 107A,A01,083627,Boyle; Mary E. T.,13,0,60,47
1656840022613,COGS 118A,A01,083075,Gupta; Anjum,15,0,76,61
1656840028638,CSE 3,A50,083646,Miranda; Gregory Joseph,22,0,50,28
1656840034669,CSE 8A,A50,083650,Miranda; Gregory Joseph,17,1,56,39
1656840040697,CSE 11,A01,083080,Cao; Yingjun,4,15,40,36
1656840046728,CSE 12,A01,083652,Krause-Levy; Sophia Louisa,20,1,120,100
1656840052751,CSE 15L,A01,083654,Morris; Justin Loren,8,0,50,42
1656840052751,CSE 15L,A02,083655,Morris; Justin Loren,8,0,50,42
1656840058780,CSE 20,A01,083657,Tran; Khoa Dang,37,0,80,43
1656840064802,CSE 21,A01,095574,Bach; Quang Tran,21,0,48,27
1656840070835,CSE 30,A01,083084,Eldon; John,4,0,80,76
1656840070835,CSE 30,B01,095061,Bhaskar; Nishant,6,0,50,44
1656840076863,CSE 100,A01,083659,Cao; Yingjun,2,4,70,68
1656840082887,CSE 134B,A01,083661,Powell; Thomas Allan,19,0,100,81
1656840088912,CSE 140,A01,083663,Gungor; Onat,14,0,85,71
1656840094937,CSE 140L,A01,083088,Eldon; John,16,0,100,84
1656840100961,CSE 175,A01,083665,Kumar; Rakesh,3,0,25,22
1656840107010,CSE 190,A00,092507,Dubnov; Shlomo,7,0,20,13
1656840113040,ECE 45,A01,083139,Congero; Spencer William,5,0,75,70
1656840119066,ECE 65,A50,083695,Saad; Andrew S,12,0,30,18
1656840119066,ECE 65,A51,095125,Saad; Andrew S,25,0,26,1
1656840125102,ECE 109,A01,091882,Touri; Behrouz,16,0,70,54
1656840131130,ECE 180,A00,083140,Abi Samra; Nicholas Camill,0,0,30,30
1656840131130,ECE 180,B00,083141,Abi Samra; Nicholas Camill,0,0,30,30
1656840137156,MATH 10A,A01,083735,Patchell; Gregory David,1,0,30,29
1656840137156,MATH 10A,A02,083736,Patchell; Gregory David,20,0,30,10
1656840137156,MATH 10A,A03,083737,Patchell; Gregory David,15,0,30,15
1656840143183,MATH 10B,A01,083207,Lim; Seonhee,7,0,34,27
1656840143183,MATH 10B,A02,083208,Lim; Seonhee,9,0,35,26
1656840143183,MATH 10B,A03,093472,Lim; Seonhee,4,0,34,30
1656840143183,MATH 10B,B01,083739,Sinha; Shubham,9,0,30,21
1656840149211,MATH 18,A01,083743,Cinel; Cameron Alexander,6,0,30,24
1656840149211,MATH 18,A02,083744,Cinel; Cameron Alexander,15,0,30,15
1656840149211,MATH 18,A03,083745,Cinel; Cameron Alexander,8,0,30,22
1656840149211,MATH 18,B01,083748,Rideout; David Porter,3,0,37,34
1656840149211,MATH 18,B02,083749,Rideout; David Porter,3,0,36,33
1656840149211,MATH 18,B03,083750,Rideout; David Porter,2,0,37,35
1656840149211,MATH 18,B04,083751,Rideout; David Porter,5,0,36,31
1656840149211,MATH 18,B05,093473,Rideout; David Porter,4,0,36,32
1656840149211,MATH 18,B06,093474,Rideout; David Porter,5,0,36,31
1656840155240,MATH 20A,A01,083754,Zheng; Zequn,12,0,40,28
1656840161275,MATH 20B,A01,083756,Briones; Jor-el Thomas Caparas,1,0,36,35
1656840161275,MATH 20B,A02,083757,Briones; Jor-el Thomas Caparas,1,0,36,35
1656840161275,MATH 20B,A03,093475,Briones; Jor-el Thomas Caparas,0,0,36,36
1656840167303,MATH 20C,A01,083760,Briones; Jor-el Thomas Caparas,1,0,35,34
1656840167303,MATH 20C,A02,083761,Briones; Jor-el Thomas Caparas,8,0,35,27
1656840167303,MATH 20C,A03,093476,Briones; Jor-el Thomas Caparas,0,1,36,36
1656840167303,MATH 20C,B01,083762,Bach; Quang Tran,0,0,30,30
1656840173329,MATH 20D,A01,083765,Tran; Brian Kha,4,0,30,26
1656840173329,MATH 20D,A02,083766,Tran; Brian Kha,4,0,30,26
1656840173329,MATH 20D,A03,083767,Tran; Brian Kha,2,0,30,28
1656840179381,MATH 20E,A01,083771,Ganguly; Soumya,5,0,32,27
1656840179381,MATH 20E,A02,083772,Ganguly; Soumya,6,0,32,26
1656840179381,MATH 20E,B01,083773,Ciotti; Benjamin,18,0,35,17
1656840179381,MATH 20E,B02,083774,Ciotti; Benjamin,17,0,35,18
1656840185407,MATH 103A,A01,083777,Greenfeld; Be'Eri,2,0,36,34
1656840185407,MATH 103A,A02,083778,Greenfeld; Be'Eri,5,0,36,31
1656840185407,MATH 103A,A03,093561,Greenfeld; Be'Eri,4,0,36,32
1656840185407,MATH 103A,B01,083779,Greenfeld; Be'Eri,6,0,36,30
1656840185407,MATH 103A,B02,083780,Greenfeld; Be'Eri,2,0,36,34
1656840185407,MATH 103A,B03,093562,Greenfeld; Be'Eri,2,0,36,34
1656840191444,MATH 105,A01,085443,Carter; Anne Toulson,13,0,35,22
1656840191444,MATH 105,A02,093477,Carter; Anne Toulson,20,0,35,15
1656840197477,MATH 109,A01,083213,Ganzberger; Geoffrey Michael,2,0,34,32
1656840197477,MATH 109,A02,083214,Ganzberger; Geoffrey Michael,2,0,34,32
1656840197477,MATH 109,A03,093478,Ganzberger; Geoffrey Michael,1,0,34,33
1656840197477,MATH 109,B01,083215,Ganzberger; Geoffrey Michael,1,0,32,31
1656840197477,MATH 109,B02,083216,Ganzberger; Geoffrey Michael,1,0,32,31
1656840197477,MATH 109,B03,093479,Ganzberger; Geoffrey Michael,6,0,32,26
1656840203507,MATH 142A,A01,083219,Chow; Bennett,6,0,32,26
1656840203507,MATH 142A,A02,083220,Chow; Bennett,9,0,32,23
1656840203507,MATH 142A,A03,093480,Chow; Bennett,7,0,32,25
1656840203507,MATH 142A,B03,093481,Chow; Bennett,7,0,32,25
1656840203507,MATH 142A,B04,093558,Chow; Bennett,10,0,32,22
1656840203507,MATH 142A,B05,093559,Chow; Bennett,6,0,32,26
1656840209541,MATH 193A,A01,083224,Rotar; Vladimir,6,0,34,28
1656840209541,MATH 193A,A02,083225,Rotar; Vladimir,3,0,34,31
1656840209541,MATH 193A,A03,083781,Rotar; Vladimir,1,0,34,33
1656840209541,MATH 193A,A04,083782,Rotar; Vladimir,6,0,34,28
1656840209541,MATH 193A,A05,093482,Rotar; Vladimir,6,0,34,28
1656840215565,MATH 197,001,091859,McAuley; Julian John,9999,0,9999,0
1656840215565,MATH 197,002,095566,Kedlaya; Kiran S.,9997,0,9999,2
1656840215565,MATH 197,003,095567,Xiao; Ming,9999,0,9999,0
1656840215565,MATH 197,004,095571,Perols; Johan Lars,9998,0,9999,1
1656840222633,COGS 9,A01,083615,Shannon; Kyle Michael,6,0,75,69
1656840228660,COGS 11,A01,083617,Boyle; Mary E. T.,18,0,48,30
1656840234685,COGS 13,A01,083071,Bastos; Amalia Pinkusfeld,8,0,71,63
1656840240712,COGS 14A,A01,092681,Semenuks; Arturs,0,1,100,100
1656840246739,COGS 14B,A01,083073,Cheng; Tzu-Han,5,0,63,58
1656840252764,COGS 17,A01,092677,Semenuks; Arturs,4,0,81,77
1656840258794,COGS 100,A01,083619,Allen; Michael Gordon,15,0,70,55
1656840264823,COGS 101A,A01,083621,Davis; Joshua Daniel,9,0,68,59
1656840270852,COGS 101B,A01,091572,Allen; Michael Gordon,8,0,65,57
1656840276883,COGS 101C,A01,083625,Delgado; Tania,17,0,35,18
1656840282914,COGS 107A,A01,083627,Boyle; Mary E. T.,13,0,60,47
1656840288942,COGS 118A,A01,083075,Gupta; Anjum,15,0,76,61
1656840294972,CSE 3,A50,083646,Miranda; Gregory Joseph,22,0,50,28
1656840301003,CSE 8A,A50,083650,Miranda; Gregory Joseph,17,1,56,39
1656840307033,CSE 11,A01,083080,Cao; Yingjun,4,15,40,36
1656840313058,CSE 12,A01,083652,Krause-Levy; Sophia Louisa,20,1,120,100
1656840319083,CSE 15L,A01,083654,Morris; Justin Loren,8,0,50,42
1656840319083,CSE 15L,A02,083655,Morris; Justin Loren,8,0,50,42
1656840325109,CSE 20,A01,083657,Tran; Khoa Dang,37,0,80,43
1656840331142,CSE 21,A01,095574,Bach; Quang Tran,21,0,48,27
1656840337175,CSE 30,A01,083084,Eldon; John,4,0,80,76
1656840337175,CSE 30,B01,095061,Bhaskar; Nishant,6,0,50,44
1656840343198,CSE 100,A01,083659,Cao; Yingjun,2,4,70,68
1656840349223,CSE 134B,A01,083661,Powell; Thomas Allan,19,0,100,81
1656840355261,CSE 140,A01,083663,Gungor; Onat,14,0,85,71
1656840361288,CSE 140L,A01,083088,Eldon; John,16,0,100,84
1656840367316,CSE 175,A01,083665,Kumar; Rakesh,3,0,25,22
1656840373344,CSE 190,A00,092507,Dubnov; Shlomo,7,0,20,13
1656840379381,ECE 45,A01,083139,Congero; Spencer William,5,0,75,70
1656840385411,ECE 65,A50,083695,Saad; Andrew S,12,0,30,18
1656840385411,ECE 65,A51,095125,Saad; Andrew S,25,0,26,1
1656840391436,ECE 109,A01,091882,Touri; Behrouz,16,0,70,54
1656840397463,ECE 180,A00,083140,Abi Samra; Nicholas Camill,0,0,30,30
1656840397463,ECE 180,B00,083141,Abi Samra; Nicholas Camill,0,0,30,30
1656840403498,MATH 10A,A01,083735,Patchell; Gregory David,1,0,30,29
1656840403498,MATH 10A,A02,083736,Patchell; Gregory David,20,0,30,10
1656840403498,MATH 10A,A03,083737,Patchell; Gregory David,15,0,30,15
1656840409524,MATH 10B,A01,083207,Lim; Seonhee,7,0,34,27
1656840409524,MATH 10B,A02,083208,Lim; Seonhee,9,0,35,26
1656840409524,MATH 10B,A03,093472,Lim; Seonhee,4,0,34,30
1656840409524,MATH 10B,B01,083739,Sinha; Shubham,9,0,30,21
1656840415557,MATH 18,A01,083743,Cinel; Cameron Alexander,6,0,30,24
1656840415557,MATH 18,A02,083744,Cinel; Cameron Alexander,15,0,30,15
1656840415557,MATH 18,A03,083745,Cinel; Cameron Alexander,8,0,30,22
1656840415557,MATH 18,B01,083748,Rideout; David Porter,3,0,37,34
1656840415557,MATH 18,B02,083749,Rideout; David Porter,3,0,36,33
1656840415557,MATH 18,B03,083750,Rideout; David Porter,2,0,37,35
1656840415557,MATH 18,B04,083751,Rideout; David Porter,5,0,36,31
1656840415557,MATH 18,B05,093473,Rideout; David Porter,4,0,36,32
1656840415557,MATH 18,B06,093474,Rideout; David Porter,5,0,36,31
1656840421584,MATH 20A,A01,083754,Zheng; Zequn,12,0,40,28
1656840427612,MATH 20B,A01,083756,Briones; Jor-el Thomas Caparas,1,0,36,35
1656840427612,MATH 20B,A02,083757,Briones; Jor-el Thomas Caparas,1,0,36,35
1656840427612,MATH 20B,A03,093475,Briones; Jor-el Thomas Caparas,0,0,36,36
1656840433636,MATH 20C,A01,083760,Briones; Jor-el Thomas Caparas,1,0,35,34
1656840433636,MATH 20C,A02,083761,Briones; Jor-el Thomas Caparas,8,0,35,27
1656840433636,MATH 20C,A03,093476,Briones; Jor-el Thomas Caparas,0,1,36,36
1656840433636,MATH 20C,B01,083762,Bach; Quang Tran,0,0,30,30
1656840439667,MATH 20D,A01,083765,Tran; Brian Kha,4,0,30,26
1656840439667,MATH 20D,A02,083766,Tran; Brian Kha,4,0,30,26
1656840439667,MATH 20D,A03,083767,Tran; Brian Kha,2,0,30,28
1656840445696,MATH 20E,A01,083771,Ganguly; Soumya,5,0,32,27
1656840445696,MATH 20E,A02,083772,Ganguly; Soumya,6,0,32,26
1656840445696,MATH 20E,B01,083773,Ciotti; Benjamin,18,0,35,17
1656840445696,MATH 20E,B02,083774,Ciotti; Benjamin,17,0,35,18
1656840451729,MATH 103A,A01,083777,Greenfeld; Be'Eri,2,0,36,34
1656840451729,MATH 103A,A02,083778,Greenfeld; Be'Eri,5,0,36,31
1656840451729,MATH 103A,A03,093561,Greenfeld; Be'Eri,4,0,36,32
1656840451729,MATH 103A,B01,083779,Greenfeld; Be'Eri,6,0,36,30
1656840451729,MATH 103A,B02,083780,Greenfeld; Be'Eri,2,0,36,34
1656840451729,MATH 103A,B03,093562,Greenfeld; Be'Eri,2,0,36,34
1656840457751,MATH 105,A01,085443,Carter; Anne Toulson,13,0,35,22
1656840457751,MATH 105,A02,093477,Carter; Anne Toulson,20,0,35,15
1656840463782,MATH 109,A01,083213,Ganzberger; Geoffrey Michael,2,0,34,32
1656840463782,MATH 109,A02,083214,Ganzberger; Geoffrey Michael,2,0,34,32
1656840463782,MATH 109,A03,093478,Ganzberger; Geoffrey Michael,1,0,34,33
1656840463782,MATH 109,B01,083215,Ganzberger; Geoffrey Michael,1,0,32,31
1656840463782,MATH 109,B02,083216,Ganzberger; Geoffrey Michael,1,0,32,31
1656840463782,MATH 109,B03,093479,Ganzberger; Geoffrey Michael,6,0,32,26
1656840469807,MATH 142A,A01,083219,Chow; Bennett,6,0,32,26
1656840469807,MATH 142A,A02,083220,Chow; Bennett,9,0,32,23
1656840469807,MATH 142A,A03,093480,Chow; Bennett,7,0,32,25
1656840469807,MATH 142A,B03,093481,Chow; Bennett,7,0,32,25
1656840469807,MATH 142A,B04,093558,Chow; Bennett,10,0,32,22
1656840469807,MATH 142A,B05,093559,Chow; Bennett,6,0,32,26
1656840475836,MATH 193A,A01,083224,Rotar; Vladimir,6,0,34,28
1656840475836,MATH 193A,A02,083225,Rotar; Vladimir,3,0,34,31
1656840475836,MATH 193A,A03,083781,Rotar; Vladimir,1,0,34,33
1656840475836,MATH 193A,A04,083782,Rotar; Vladimir,6,0,34,28
1656840475836,MATH 193A,A05,093482,Rotar; Vladimir,6,0,34,28
1656840481902,MATH 197,001,091859,McAuley; Julian John,9999,0,9999,0
1656840481902,MATH 197,002,095566,Kedlaya; Kiran S.,9997,0,9999,2
1656840481902,MATH 197,003,095567,Xiao; Ming,9999,0,9999,0
1656840481902,MATH 197,004,095571,Perols; Johan Lars,9998,0,9999,1
1656840488957,COGS 9,A01,083615,Shannon; Kyle Michael,6,0,75,69
1656840494981,COGS 11,A01,083617,Boyle; Mary E. T.,18,0,48,30
1656840501006,COGS 13,A01,083071,Bastos; Amalia Pinkusfeld,8,0,71,63
1656840507030,COGS 14A,A01,092681,Semenuks; Arturs,0,1,100,100
1656840513056,COGS 14B,A01,083073,Cheng; Tzu-Han,5,0,63,58
1656840519084,COGS 17,A01,092677,Semenuks; Arturs,4,0,81,77
1656840525109,COGS 100,A01,083619,Allen; Michael Gordon,15,0,70,55
1656840531137,COGS 101A,A01,083621,Davis; Joshua Daniel,9,0,68,59
1656840537166,COGS 101B,A01,091572,Allen; Michael Gordon,8,0,65,57
1656840543192,COGS 101C,A01,083625,Delgado; Tania,17,0,35,18
1656840549214,COGS 107A,A01,083627,Boyle; Mary E. T.,13,0,60,47
1656840555237,COGS 118A,A01,083075,Gupta; Anjum,15,0,76,61
1656840561261,CSE 3,A50,083646,Miranda; Gregory Joseph,22,0,50,28
1656840567293,CSE 8A,A50,083650,Miranda; Gregory Joseph,17,1,56,39
1656840573321,CSE 11,A01,083080,Cao; Yingjun,4,15,40,36
1656840579347,CSE 12,A01,083652,Krause-Levy; Sophia Louisa,20,1,120,100
1656840585372,CSE 15L,A01,083654,Morris; Justin Loren,8,0,50,42
1656840585372,CSE 15L,A02,083655,Morris; Justin Loren,8,0,50,42
1656840591397,CSE 20,A01,083657,Tran; Khoa Dang,37,0,80,43
1656840597426,CSE 21,A01,095574,Bach; Quang Tran,21,0,48,27
1656840603541,CSE 30,A01,083084,Eldon; John,4,0,80,76
1656840603541,CSE 30,B01,095061,Bhaskar; Nishant,6,0,50,44
1656840609564,CSE 100,A01,083659,Cao; Yingjun,2,4,70,68
1656840615597,CSE 134B,A01,083661,Powell; Thomas Allan,19,0,100,81
1656840621620,CSE 140,A01,083663,Gungor; Onat,14,0,85,71
1656840627644,CSE 140L,A01,083088,Eldon; John,16,0,100,84
1656840633671,CSE 175,A01,083665,Kumar; Rakesh,3,0,25,22
1656840639697,CSE 190,A00,092507,Dubnov; Shlomo,7,0,20,13
1656840645967,ECE 45,A01,083139,Congero; Spencer William,5,0,75,70
1656840652000,ECE 65,A50,083695,Saad; Andrew S,12,0,30,18
1656840652000,ECE 65,A51,095125,Saad; Andrew S,25,0,26,1
1656840658029,ECE 109,A01,091882,Touri; Behrouz,16,0,70,54
1656840664052,ECE 180,A00,083140,Abi Samra; Nicholas Camill,0,0,30,30
1656840664052,ECE 180,B00,083141,Abi Samra; Nicholas Camill,0,0,30,30
1656840670087,MATH 10A,A01,083735,Patchell; Gregory David,1,0,30,29
1656840670087,MATH 10A,A02,083736,Patchell; Gregory David,20,0,30,10
1656840670087,MATH 10A,A03,083737,Patchell; Gregory David,15,0,30,15
1656840676120,MATH 10B,A01,083207,Lim; Seonhee,7,0,34,27
1656840676120,MATH 10B,A02,083208,Lim; Seonhee,9,0,35,26
1656840676120,MATH 10B,A03,093472,Lim; Seonhee,4,0,34,30
1656840676120,MATH 10B,B01,083739,Sinha; Shubham,9,0,30,21
1656840682162,MATH 18,A01,083743,Cinel; Cameron Alexander,6,0,30,24
1656840682162,MATH 18,A02,083744,Cinel; Cameron Alexander,15,0,30,15
1656840682162,MATH 18,A03,083745,Cinel; Cameron Alexander,8,0,30,22
1656840682162,MATH 18,B01,083748,Rideout; David Porter,3,0,37,34
1656840682162,MATH 18,B02,083749,Rideout; David Porter,3,0,36,33
1656840682162,MATH 18,B03,083750,Rideout; David Porter,2,0,37,35
1656840682162,MATH 18,B04,083751,Rideout; David Porter,5,0,36,31
1656840682162,MATH 18,B05,093473,Rideout; David Porter,4,0,36,32
1656840682162,MATH 18,B06,093474,Rideout; David Porter,5,0,36,31
1656840688191,MATH 20A,A01,083754,Zheng; Zequn,12,0,40,28
1656840694221,MATH 20B,A01,083756,Briones; Jor-el Thomas Caparas,1,0,36,35
1656840694221,MATH 20B,A02,083757,Briones; Jor-el Thomas Caparas,1,0,36,35
1656840694221,MATH 20B,A03,093475,Briones; Jor-el Thomas Caparas,0,0,36,36
1656840700253,MATH 20C,A01,083760,Briones; Jor-el Thomas Caparas,1,0,35,34
1656840700253,MATH 20C,A02,083761,Briones; Jor-el Thomas Caparas,8,0,35,27
1656840700253,MATH 20C,A03,093476,Briones; Jor-el Thomas Caparas,0,1,36,36
1656840700253,MATH 20C,B01,083762,Bach; Quang Tran,0,0,30,30
1656840706277,MATH 20D,A01,083765,Tran; Brian Kha,4,0,30,26
1656840706277,MATH 20D,A02,083766,Tran; Brian Kha,4,0,30,26
1656840706277,MATH 20D,A03,083767,Tran; Brian Kha,2,0,30,28
1656840712304,MATH 20E,A01,083771,Ganguly; Soumya,5,0,32,27
1656840712304,MATH 20E,A02,083772,Ganguly; Soumya,6,0,32,26
1656840712304,MATH 20E,B01,083773,Ciotti; Benjamin,18,0,35,17
1656840712304,MATH 20E,B02,083774,Ciotti; Benjamin,17,0,35,18
1656840718332,MATH 103A,A01,083777,Greenfeld; Be'Eri,2,0,36,34
1656840718332,MATH 103A,A02,083778,Greenfeld; Be'Eri,5,0,36,31
1656840718332,MATH 103A,A03,093561,Greenfeld; Be'Eri,4,0,36,32
1656840718332,MATH 103A,B01,083779,Greenfeld; Be'Eri,6,0,36,30
1656840718332,MATH 103A,B02,083780,Greenfeld; Be'Eri,2,0,36,34
1656840718332,MATH 103A,B03,093562,Greenfeld; Be'Eri,2,0,36,34
1656840724357,MATH 105,A01,085443,Carter; Anne Toulson,13,0,35,22
1656840724357,MATH 105,A02,093477,Carter; Anne Toulson,20,0,35,15
1656840730384,MATH 109,A01,083213,Ganzberger; Geoffrey Michael,2,0,34,32
1656840730384,MATH 109,A02,083214,Ganzberger; Geoffrey Michael,2,0,34,32
1656840730384,MATH 109,A03,093478,Ganzberger; Geoffrey Michael,1,0,34,33
1656840730384,MATH 109,B01,083215,Ganzberger; Geoffrey Michael,1,0,32,31
1656840730384,MATH 109,B02,083216,Ganzberger; Geoffrey Michael,1,0,32,31
1656840730384,MATH 109,B03,093479,Ganzberger; Geoffrey Michael,6,0,32,26
1656840736418,MATH 142A,A01,083219,Chow; Bennett,6,0,32,26
1656840736418,MATH 142A,A02,083220,Chow; Bennett,9,0,32,23
1656840736418,MATH 142A,A03,093480,Chow; Bennett,7,0,32,25
1656840736418,MATH 142A,B03,093481,Chow; Bennett,7,0,32,25
1656840736418,MATH 142A,B04,093558,Chow; Bennett,10,0,32,22
1656840736418,MATH 142A,B05,093559,Chow; Bennett,6,0,32,26
1656840742443,MATH 193A,A01,083224,Rotar; Vladimir,6,0,34,28
1656840742443,MATH 193A,A02,083225,Rotar; Vladimir,3,0,34,31
1656840742443,MATH 193A,A03,083781,Rotar; Vladimir,1,0,34,33
1656840742443,MATH 193A,A04,083782,Rotar; Vladimir,6,0,34,28
1656840742443,MATH 193A,A05,093482,Rotar; Vladimir,6,0,34,28
1656840748468,MATH 197,001,091859,McAuley; Julian John,9999,0,9999,0
1656840748468,MATH 197,002,095566,Kedlaya; Kiran S.,9997,0,9999,2
1656840748468,MATH 197,003,095567,Xiao; Ming,9999,0,9999,0
1656840748468,MATH 197,004,095571,Perols; Johan Lars,9998,0,9999,1
1656840755546,COGS 9,A01,083615,Shannon; Kyle Michael,6,0,75,69
1656840761580,COGS 11,A01,083617,Boyle; Mary E. T.,18,0,48,30
1656840767604,COGS 13,A01,083071,Bastos; Amalia Pinkusfeld,8,0,71,63
1656840773637,COGS 14A,A01,092681,Semenuks; Arturs,0,1,100,100
1656840779661,COGS 14B,A01,083073,Cheng; Tzu-Han,5,0,63,58
1656840785686,COGS 17,A01,092677,Semenuks; Arturs,4,0,81,77
1656840791710,COGS 100,A01,083619,Allen; Michael Gordon,15,0,70,55
1656840797734,COGS 101A,A01,083621,Davis; Joshua Daniel,9,0,68,59
1656840803758,COGS 101B,A01,091572,Allen; Michael Gordon,8,0,65,57
1656840809789,COGS 101C,A01,083625,Delgado; Tania,17,0,35,18
1656840815814,COGS 107A,A01,083627,Boyle; Mary E. T.,13,0,60,47
1656840821851,COGS 118A,A01,083075,Gupta; Anjum,15,0,76,61
1656840827876,CSE 3,A50,083646,Miranda; Gregory Joseph,22,0,50,28
1656840833901,CSE 8A,A50,083650,Miranda; Gregory Joseph,17,1,56,39
1656840839930,CSE 11,A01,083080,Cao; Yingjun,4,15,40,36
1656840845955,CSE 12,A01,083652,Krause-Levy; Sophia Louisa,20,1,120,100
1656840851980,CSE 15L,A01,083654,Morris; Justin Loren,8,0,50,42
1656840851980,CSE 15L,A02,083655,Morris; Justin Loren,8,0,50,42
1656840858004,CSE 20,A01,083657,Tran; Khoa Dang,37,0,80,43
1656840864034,CSE 21,A01,095574,Bach; Quang Tran,21,0,48,27
1656840870070,CSE 30,A01,083084,Eldon; John,4,0,80,76
1656840870070,CSE 30,B01,095061,Bhaskar; Nishant,6,0,50,44
1656840876095,CSE 100,A01,083659,Cao; Yingjun,2,4,70,68
1656840882159,CSE 134B,A01,083661,Powell; Thomas Allan,19,0,100,81
1656840888184,CSE 140,A01,083663,Gungor; Onat,14,0,85,71
1656840894212,CSE 140L,A01,083088,Eldon; John,16,0,100,84
1656840900239,CSE 175,A01,083665,Kumar; Rakesh,3,0,25,22
1656840906265,CSE 190,A00,092507,Dubnov; Shlomo,7,0,20,13
1656840912290,ECE 45,A01,083139,Congero; Spencer William,5,0,75,70
1656840918322,ECE 65,A50,083695,Saad; Andrew S,12,0,30,18
1656840918322,ECE 65,A51,095125,Saad; Andrew S,25,0,26,1
1656840924354,ECE 109,A01,091882,Touri; Behrouz,16,0,70,54
1656840930379,ECE 180,A00,083140,Abi Samra; Nicholas Camill,0,0,30,30
1656840930379,ECE 180,B00,083141,Abi Samra; Nicholas Camill,0,0,30,30
1656840936409,MATH 10A,A01,083735,Patchell; Gregory David,1,0,30,29
1656840936409,MATH 10A,A02,083736,Patchell; Gregory David,20,0,30,10
1656840936409,MATH 10A,A03,083737,Patchell; Gregory David,15,0,30,15
1656840942438,MATH 10B,A01,083207,Lim; Seonhee,7,0,34,27
1656840942438,MATH 10B,A02,083208,Lim; Seonhee,9,0,35,26
1656840942438,MATH 10B,A03,093472,Lim; Seonhee,4,0,34,30
1656840942438,MATH 10B,B01,083739,Sinha; Shubham,9,0,30,21
1656840948466,MATH 18,A01,083743,Cinel; Cameron Alexander,6,0,30,24
1656840948466,MATH 18,A02,083744,Cinel; Cameron Alexander,15,0,30,15
1656840948466,MATH 18,A03,083745,Cinel; Cameron Alexander,8,0,30,22
1656840948466,MATH 18,B01,083748,Rideout; David Porter,3,0,37,34
1656840948466,MATH 18,B02,083749,Rideout; David Porter,3,0,36,33
1656840948466,MATH 18,B03,083750,Rideout; David Porter,2,0,37,35
1656840948466,MATH 18,B04,083751,Rideout; David Porter,5,0,36,31
1656840948466,MATH 18,B05,093473,Rideout; David Porter,4,0,36,32
1656840948466,MATH 18,B06,093474,Rideout; David Porter,5,0,36,31
1656840954492,MATH 20A,A01,083754,Zheng; Zequn,12,0,40,28
1656840960525,MATH 20B,A01,083756,Briones; Jor-el Thomas Caparas,1,0,36,35
1656840960525,MATH 20B,A02,083757,Briones; Jor-el Thomas Caparas,1,0,36,35
1656840960525,MATH 20B,A03,093475,Briones; Jor-el Thomas Caparas,0,0,36,36
1656840966551,MATH 20C,A01,083760,Briones; Jor-el Thomas Caparas,1,0,35,34
1656840966551,MATH 20C,A02,083761,Briones; Jor-el Thomas Caparas,8,0,35,27
1656840966551,MATH 20C,A03,093476,Briones; Jor-el Thomas Caparas,0,1,36,36
1656840966551,MATH 20C,B01,083762,Bach; Quang Tran,0,0,30,30
1656840972582,MATH 20D,A01,083765,Tran; Brian Kha,4,0,30,26
1656840972582,MATH 20D,A02,083766,Tran; Brian Kha,4,0,30,26
1656840972582,MATH 20D,A03,083767,Tran; Brian Kha,2,0,30,28
1656840978607,MATH 20E,A01,083771,Ganguly; Soumya,5,0,32,27
1656840978607,MATH 20E,A02,083772,Ganguly; Soumya,6,0,32,26
1656840978607,MATH 20E,B01,083773,Ciotti; Benjamin,18,0,35,17
1656840978607,MATH 20E,B02,083774,Ciotti; Benjamin,17,0,35,18
1656840984640,MATH 103A,A01,083777,Greenfeld; Be'Eri,2,0,36,34
1656840984640,MATH 103A,A02,083778,Greenfeld; Be'Eri,5,0,36,31
1656840984640,MATH 103A,A03,093561,Greenfeld; Be'Eri,4,0,36,32
1656840984640,MATH 103A,B01,083779,Greenfeld; Be'Eri,6,0,36,30
1656840984640,MATH 103A,B02,083780,Greenfeld; Be'Eri,2,0,36,34
1656840984640,MATH 103A,B03,093562,Greenfeld; Be'Eri,2,0,36,34
1656840990664,MATH 105,A01,085443,Carter; Anne Toulson,13,0,35,22
1656840990664,MATH 105,A02,093477,Carter; Anne Toulson,20,0,35,15
1656840996689,MATH 109,A01,083213,Ganzberger; Geoffrey Michael,2,0,34,32
1656840996689,MATH 109,A02,083214,Ganzberger; Geoffrey Michael,2,0,34,32
1656840996689,MATH 109,A03,093478,Ganzberger; Geoffrey Michael,1,0,34,33
1656840996689,MATH 109,B01,083215,Ganzberger; Geoffrey Michael,1,0,32,31
1656840996689,MATH 109,B02,083216,Ganzberger; Geoffrey Michael,1,0,32,31
1656840996689,MATH 109,B03,093479,Ganzberger; Geoffrey Michael,6,0,32,26
1656841002716,MATH 142A,A01,083219,Chow; Bennett,6,0,32,26
1656841002716,MATH 142A,A02,083220,Chow; Bennett,9,0,32,23
1656841002716,MATH 142A,A03,093480,Chow; Bennett,7,0,32,25
1656841002716,MATH 142A,B03,093481,Chow; Bennett,7,0,32,25
1656841002716,MATH 142A,B04,093558,Chow; Bennett,10,0,32,22
1656841002716,MATH 142A,B05,093559,Chow; Bennett,6,0,32,26
1656841008748,MATH 193A,A01,083224,Rotar; Vladimir,6,0,34,28
1656841008748,MATH 193A,A02,083225,Rotar; Vladimir,3,0,34,31
1656841008748,MATH 193A,A03,083781,Rotar; Vladimir,1,0,34,33
1656841008748,MATH 193A,A04,083782,Rotar; Vladimir,6,0,34,28
1656841008748,MATH 193A,A05,093482,Rotar; Vladimir,6,0,34,28
1656841014774,MATH 197,001,091859,McAuley; Julian John,9999,0,9999,0
1656841014774,MATH 197,002,095566,Kedlaya; Kiran S.,9997,0,9999,2
1656841014774,MATH 197,003,095567,Xiao; Ming,9999,0,9999,0
1656841014774,MATH 197,004,095571,Perols; Johan Lars,9998,0,9999,1
1656841021844,COGS 9,A01,083615,Shannon; Kyle Michael,6,0,75,69
1656841027870,COGS 11,A01,083617,Boyle; Mary E. T.,18,0,48,30
1656841033910,COGS 13,A01,083071,Bastos; Amalia Pinkusfeld,8,0,71,63
1656841039942,COGS 14A,A01,092681,Semenuks; Arturs,0,1,100,100
1656841045966,COGS 14B,A01,083073,Cheng; Tzu-Han,5,0,63,58
1656841051991,COGS 17,A01,092677,Semenuks; Arturs,4,0,81,77
1656841058032,COGS 100,A01,083619,Allen; Michael Gordon,15,0,70,55
1656841064063,COGS 101A,A01,083621,Davis; Joshua Daniel,9,0,68,59
1656841070091,COGS 101B,A01,091572,Allen; Michael Gordon,8,0,65,57
1656841076116,COGS 101C,A01,083625,Delgado; Tania,17,0,35,18
1656841082140,COGS 107A,A01,083627,Boyle; Mary E. T.,13,0,60,47
1656841088165,COGS 118A,A01,083075,Gupta; Anjum,15,0,76,61
1656841094199,CSE 3,A50,083646,Miranda; Gregory Joseph,22,0,50,28
1656841100227,CSE 8A,A50,083650,Miranda; Gregory Joseph,17,1,56,39
1656841106251,CSE 11,A01,083080,Cao; Yingjun,4,15,40,36
1656841112277,CSE 12,A01,083652,Krause-Levy; Sophia Louisa,20,1,120,100
1656841118308,CSE 15L,A01,083654,Morris; Justin Loren,8,0,50,42
1656841118308,CSE 15L,A02,083655,Morris; Justin Loren,8,0,50,42
1656841124333,CSE 20,A01,083657,Tran; Khoa Dang,37,0,80,43
1656841130364,CSE 21,A01,095574,Bach; Quang Tran,21,0,48,27
1656841136391,CSE 30,A01,083084,Eldon; John,4,0,80,76
1656841136391,CSE 30,B01,095061,Bhaskar; Nishant,6,0,50,44
1656841142422,CSE 100,A01,083659,Cao; Yingjun,2,4,70,68
1656841148447,CSE 134B,A01,083661,Powell; Thomas Allan,19,0,100,81
1656841154473,CSE 140,A01,083663,Gungor; Onat,14,0,85,71
1656841160499,CSE 140L,A01,083088,Eldon; John,16,0,100,84
1656841166530,CSE 175,A01,083665,Kumar; Rakesh,3,0,25,22
1656841172556,CSE 190,A00,092507,Dubnov; Shlomo,7,0,20,13
1656841178589,ECE 45,A01,083139,Congero; Spencer William,5,0,75,70
1656841184624,ECE 65,A50,083695,Saad; Andrew S,12,0,30,18
1656841184624,ECE 65,A51,095125,Saad; Andrew S,25,0,26,1
1656841190649,ECE 109,A01,091882,Touri; Behrouz,16,0,70,54
1656841196677,ECE 180,A00,083140,Abi Samra; Nicholas Camill,0,0,30,30
1656841196677,ECE 180,B00,083141,Abi Samra; Nicholas Camill,0,0,30,30
1656841202780,MATH 10A,A01,083735,Patchell; Gregory David,1,0,30,29
1656841202780,MATH 10A,A02,083736,Patchell; Gregory David,20,0,30,10
1656841202780,MATH 10A,A03,083737,Patchell; Gregory David,15,0,30,15
1656841208822,MATH 10B,A01,083207,Lim; Seonhee,7,0,34,27
1656841208822,MATH 10B,A02,083208,Lim; Seonhee,9,0,35,26
1656841208822,MATH 10B,A03,093472,Lim; Seonhee,4,0,34,30
1656841208822,MATH 10B,B01,083739,Sinha; Shubham,9,0,30,21
1656841214854,MATH 18,A01,083743,Cinel; Cameron Alexander,6,0,30,24
1656841214854,MATH 18,A02,083744,Cinel; Cameron Alexander,15,0,30,15
1656841214854,MATH 18,A03,083745,Cinel; Cameron Alexander,8,0,30,22
1656841214854,MATH 18,B01,083748,Rideout; David Porter,3,0,37,34
1656841214854,MATH 18,B02,083749,Rideout; David Porter,3,0,36,33
1656841214854,MATH 18,B03,083750,Rideout; David Porter,2,0,37,35
1656841214854,MATH 18,B04,083751,Rideout; David Porter,5,0,36,31
1656841214854,MATH 18,B05,093473,Rideout; David Porter,4,0,36,32
1656841214854,MATH 18,B06,093474,Rideout; David Porter,5,0,36,31
1656841220880,MATH 20A,A01,083754,Zheng; Zequn,12,0,40,28
1656841226909,MATH 20B,A01,083756,Briones; Jor-el Thomas Caparas,1,0,36,35
1656841226909,MATH 20B,A02,083757,Briones; Jor-el Thomas Caparas,1,0,36,35
1656841226909,MATH 20B,A03,093475,Briones; Jor-el Thomas Caparas,0,0,36,36
1656841233026,MATH 20C,A01,083760,Briones; Jor-el Thomas Caparas,1,0,35,34
1656841233026,MATH 20C,A02,083761,Briones; Jor-el Thomas Caparas,8,0,35,27
1656841233026,MATH 20C,A03,093476,Briones; Jor-el Thomas Caparas,0,1,36,36
1656841233026,MATH 20C,B01,083762,Bach; Quang Tran,0,0,30,30
1656841239054,MATH 20D,A01,083765,Tran; Brian Kha,4,0,30,26
1656841239054,MATH 20D,A02,083766,Tran; Brian Kha,4,0,30,26
1656841239054,MATH 20D,A03,083767,Tran; Brian Kha,2,0,30,28
1656841245105,MATH 20E,A01,083771,Ganguly; Soumya,5,0,32,27
1656841245105,MATH 20E,A02,083772,Ganguly; Soumya,6,0,32,26
1656841245105,MATH 20E,B01,083773,Ciotti; Benjamin,18,0,35,17
1656841245105,MATH 20E,B02,083774,Ciotti; Benjamin,17,0,35,18
1656841251134,MATH 103A,A01,083777,Greenfeld; Be'Eri,2,0,36,34
1656841251134,MATH 103A,A02,083778,Greenfeld; Be'Eri,5,0,36,31
1656841251134,MATH 103A,A03,093561,Greenfeld; Be'Eri,4,0,36,32
1656841251134,MATH 103A,B01,083779,Greenfeld; Be'Eri,6,0,36,30
1656841251134,MATH 103A,B02,083780,Greenfeld; Be'Eri,2,0,36,34
1656841251134,MATH 103A,B03,093562,Greenfeld; Be'Eri,2,0,36,34
1656841257161,MATH 105,A01,085443,Carter; Anne Toulson,13,0,35,22
1656841257161,MATH 105,A02,093477,Carter; Anne Toulson,20,0,35,15
1656841263185,MATH 109,A01,083213,Ganzberger; Geoffrey Michael,2,0,34,32
1656841263185,MATH 109,A02,083214,Ganzberger; Geoffrey Michael,2,0,34,32
1656841263185,MATH 109,A03,093478,Ganzberger; Geoffrey Michael,1,0,34,33
1656841263185,MATH 109,B01,083215,Ganzberger; Geoffrey Michael,1,0,32,31
1656841263185,MATH 109,B02,083216,Ganzberger; Geoffrey Michael,1,0,32,31
1656841263185,MATH 109,B03,093479,Ganzberger; Geoffrey Michael,6,0,32,26
1656841269214,MATH 142A,A01,083219,Chow; Bennett,6,0,32,26
1656841269214,MATH 142A,A02,083220,Chow; Bennett,9,0,32,23
1656841269214,MATH 142A,A03,093480,Chow; Bennett,7,0,32,25
1656841269214,MATH 142A,B03,093481,Chow; Bennett,7,0,32,25
1656841269214,MATH 142A,B04,093558,Chow; Bennett,10,0,32,22
1656841269214,MATH 142A,B05,093559,Chow; Bennett,6,0,32,26
1656841275243,MATH 193A,A01,083224,Rotar; Vladimir,6,0,34,28
1656841275243,MATH 193A,A02,083225,Rotar; Vladimir,3,0,34,31
1656841275243,MATH 193A,A03,083781,Rotar; Vladimir,1,0,34,33
1656841275243,MATH 193A,A04,083782,Rotar; Vladimir,6,0,34,28
1656841275243,MATH 193A,A05,093482,Rotar; Vladimir,6,0,34,28
1656841281272,MATH 197,001,091859,McAuley; Julian John,9999,0,9999,0
1656841281272,MATH 197,002,095566,Kedlaya; Kiran S.,9997,0,9999,2
1656841281272,MATH 197,003,095567,Xiao; Ming,9999,0,9999,0
1656841281272,MATH 197,004,095571,Perols; Johan Lars,9998,0,9999,1
1656841288350,COGS 9,A01,083615,Shannon; Kyle Michael,6,0,75,69
1656841294382,COGS 11,A01,083617,Boyle; Mary E. T.,18,0,48,30
1656841300412,COGS 13,A01,083071,Bastos; Amalia Pinkusfeld,8,0,71,63
1656841306438,COGS 14A,A01,092681,Semenuks; Arturs,0,1,100,100
1656841312467,COGS 14B,A01,083073,Cheng; Tzu-Han,5,0,63,58
1656841318492,COGS 17,A01,092677,Semenuks; Arturs,4,0,81,77
1656841324517,COGS 100,A01,083619,Allen; Michael Gordon,15,0,70,55
1656841330549,COGS 101A,A01,083621,Davis; Joshua Daniel,9,0,68,59
1656841336574,COGS 101B,A01,091572,Allen; Michael Gordon,8,0,65,57
1656841342602,COGS 101C,A01,083625,Delgado; Tania,17,0,35,18
1656841348633,COGS 107A,A01,083627,Boyle; Mary E. T.,13,0,60,47
1656841354658,COGS 118A,A01,083075,Gupta; Anjum,15,0,76,61
1656841360685,CSE 3,A50,083646,Miranda; Gregory Joseph,22,0,50,28
1656841366709,CSE 8A,A50,083650,Miranda; Gregory Joseph,17,1,56,39
1656841372733,CSE 11,A01,083080,Cao; Yingjun,4,15,40,36
1656841378759,CSE 12,A01,083652,Krause-Levy; Sophia Louisa,20,1,120,100
1656841384783,CSE 15L,A01,083654,Morris; Justin Loren,8,0,50,42
1656841384783,CSE 15L,A02,083655,Morris; Justin Loren,8,0,50,42
1656841390813,CSE 20,A01,083657,Tran; Khoa Dang,37,0,80,43
1656841396838,CSE 21,A01,095574,Bach; Quang Tran,21,0,48,27
1656841402865,CSE 30,A01,083084,Eldon; John,4,0,80,76
1656841402865,CSE 30,B01,095061,Bhaskar; Nishant,6,0,50,44
1656841408891,CSE 100,A01,083659,Cao; Yingjun,2,4,70,68
1656841414920,CSE 134B,A01,083661,Powell; Thomas Allan,19,0,100,81
1656841420943,CSE 140,A01,083663,Gungor; Onat,14,0,85,71
1656841426971,CSE 140L,A01,083088,Eldon; John,16,0,100,84
1656841432997,CSE 175,A01,083665,Kumar; Rakesh,3,0,25,22
1656841439022,CSE 190,A00,092507,Dubnov; Shlomo,7,0,20,13
1656841445056,ECE 45,A01,083139,Congero; Spencer William,5,0,75,70
1656841451087,ECE 65,A50,083695,Saad; Andrew S,12,0,30,18
1656841451087,ECE 65,A51,095125,Saad; Andrew S,25,0,26,1
1656841457117,ECE 109,A01,091882,Touri; Behrouz,16,0,70,54
1656841463148,ECE 180,A00,083140,Abi Samra; Nicholas Camill,0,0,30,30
1656841463148,ECE 180,B00,083141,Abi Samra; Nicholas Camill,0,0,30,30
1656841469184,MATH 10A,A01,083735,Patchell; Gregory David,1,0,30,29
1656841469184,MATH 10A,A02,083736,Patchell; Gregory David,20,0,30,10
1656841469184,MATH 10A,A03,083737,Patchell; Gregory David,15,0,30,15
1656841475213,MATH 10B,A01,083207,Lim; Seonhee,7,0,34,27
1656841475213,MATH 10B,A02,083208,Lim; Seonhee,9,0,35,26
1656841475213,MATH 10B,A03,093472,Lim; Seonhee,4,0,34,30
1656841475213,MATH 10B,B01,083739,Sinha; Shubham,9,0,30,21
1656841481243,MATH 18,A01,083743,Cinel; Cameron Alexander,6,0,30,24
1656841481243,MATH 18,A02,083744,Cinel; Cameron Alexander,15,0,30,15
1656841481243,MATH 18,A03,083745,Cinel; Cameron Alexander,8,0,30,22
1656841481243,MATH 18,B01,083748,Rideout; David Porter,3,0,37,34
1656841481243,MATH 18,B02,083749,Rideout; David Porter,3,0,36,33
1656841481243,MATH 18,B03,083750,Rideout; David Porter,2,0,37,35
1656841481243,MATH 18,B04,083751,Rideout; David Porter,5,0,36,31
1656841481243,MATH 18,B05,093473,Rideout; David Porter,4,0,36,32
1656841481243,MATH 18,B06,093474,Rideout; David Porter,5,0,36,31
1656841487268,MATH 20A,A01,083754,Zheng; Zequn,12,0,40,28
1656841493294,MATH 20B,A01,083756,Briones; Jor-el Thomas Caparas,1,0,36,35
1656841493294,MATH 20B,A02,083757,Briones; Jor-el Thomas Caparas,1,0,36,35
1656841493294,MATH 20B,A03,093475,Briones; Jor-el Thomas Caparas,0,0,36,36
1656841499320,MATH 20C,A01,083760,Briones; Jor-el Thomas Caparas,1,0,35,34
1656841499320,MATH 20C,A02,083761,Briones; Jor-el Thomas Caparas,8,0,35,27
1656841499320,MATH 20C,A03,093476,Briones; Jor-el Thomas Caparas,0,1,36,36
1656841499320,MATH 20C,B01,083762,Bach; Quang Tran,0,0,30,30
1656841505344,MATH 20D,A01,083765,Tran; Brian Kha,4,0,30,26
1656841505344,MATH 20D,A02,083766,Tran; Brian Kha,4,0,30,26
1656841505344,MATH 20D,A03,083767,Tran; Brian Kha,2,0,30,28
1656841511370,MATH 20E,A01,083771,Ganguly; Soumya,5,0,32,27
1656841511370,MATH 20E,A02,083772,Ganguly; Soumya,6,0,32,26
1656841511370,MATH 20E,B01,083773,Ciotti; Benjamin,18,0,35,17
1656841511370,MATH 20E,B02,083774,Ciotti; Benjamin,17,0,35,18
1656841517408,MATH 103A,A01,083777,Greenfeld; Be'Eri,2,0,36,34
1656841517408,MATH 103A,A02,083778,Greenfeld; Be'Eri,5,0,36,31
1656841517408,MATH 103A,A03,093561,Greenfeld; Be'Eri,4,0,36,32
1656841517408,MATH 103A,B01,083779,Greenfeld; Be'Eri,6,0,36,30
1656841517408,MATH 103A,B02,083780,Greenfeld; Be'Eri,2,0,36,34
1656841517408,MATH 103A,B03,093562,Greenfeld; Be'Eri,2,0,36,34
1656841523447,MATH 105,A01,085443,Carter; Anne Toulson,13,0,35,22
1656841523447,MATH 105,A02,093477,Carter; Anne Toulson,20,0,35,15
1656841529483,MATH 109,A01,083213,Ganzberger; Geoffrey Michael,2,0,34,32
1656841529483,MATH 109,A02,083214,Ganzberger; Geoffrey Michael,2,0,34,32
1656841529483,MATH 109,A03,093478,Ganzberger; Geoffrey Michael,1,0,34,33
1656841529483,MATH 109,B01,083215,Ganzberger; Geoffrey Michael,1,0,32,31
1656841529483,MATH 109,B02,083216,Ganzberger; Geoffrey Michael,1,0,32,31
1656841529483,MATH 109,B03,093479,Ganzberger; Geoffrey Michael,6,0,32,26
1656841535516,MATH 142A,A01,083219,Chow; Bennett,6,0,32,26
1656841535516,MATH 142A,A02,083220,Chow; Bennett,9,0,32,23
1656841535516,MATH 142A,A03,093480,Chow; Bennett,7,0,32,25
1656841535516,MATH 142A,B03,093481,Chow; Bennett,7,0,32,25
1656841535516,MATH 142A,B04,093558,Chow; Bennett,10,0,32,22
1656841535516,MATH 142A,B05,093559,Chow; Bennett,6,0,32,26
1656841541542,MATH 193A,A01,083224,Rotar; Vladimir,6,0,34,28
1656841541542,MATH 193A,A02,083225,Rotar; Vladimir,3,0,34,31
1656841541542,MATH 193A,A03,083781,Rotar; Vladimir,1,0,34,33
1656841541542,MATH 193A,A04,083782,Rotar; Vladimir,6,0,34,28
1656841541542,MATH 193A,A05,093482,Rotar; Vladimir,6,0,34,28
1656841547569,MATH 197,001,091859,McAuley; Julian John,9999,0,9999,0
1656841547569,MATH 197,002,095566,Kedlaya; Kiran S.,9997,0,9999,2
1656841547569,MATH 197,003,095567,Xiao; Ming,9999,0,9999,0
1656841547569,MATH 197,004,095571,Perols; Johan Lars,9998,0,9999,1
1656841554660,COGS 9,A01,083615,Shannon; Kyle Michael,6,0,75,69
1656841560692,COGS 11,A01,083617,Boyle; Mary E. T.,18,0,48,30
1656841566720,COGS 13,A01,083071,Bastos; Amalia Pinkusfeld,8,0,71,63
1656841572751,COGS 14A,A01,092681,Semenuks; Arturs,0,1,100,100
1656841578778,COGS 14B,A01,083073,Cheng; Tzu-Han,5,0,63,58
1656841584806,COGS 17,A01,092677,Semenuks; Arturs,4,0,81,77
1656841590840,COGS 100,A01,083619,Allen; Michael Gordon,15,0,70,55
1656841596866,COGS 101A,A01,083621,Davis; Joshua Daniel,9,0,68,59
1656841602895,COGS 101B,A01,091572,Allen; Michael Gordon,8,0,65,57
1656841608925,COGS 101C,A01,083625,Delgado; Tania,17,0,35,18
1656841614957,COGS 107A,A01,083627,Boyle; Mary E. T.,13,0,60,47
1656841620989,COGS 118A,A01,083075,Gupta; Anjum,15,0,76,61
1656841627022,CSE 3,A50,083646,Miranda; Gregory Joseph,22,0,50,28
1656841633056,CSE 8A,A50,083650,Miranda; Gregory Joseph,17,1,56,39
1656841639086,CSE 11,A01,083080,Cao; Yingjun,4,15,40,36
1656841645114,CSE 12,A01,083652,Krause-Levy; Sophia Louisa,20,1,120,100
1656841651143,CSE 15L,A01,083654,Morris; Justin Loren,8,0,50,42
1656841651143,CSE 15L,A02,083655,Morris; Justin Loren,8,0,50,42
1656841657171,CSE 20,A01,083657,Tran; Khoa Dang,37,0,80,43
1656841663202,CSE 21,A01,095574,Bach; Quang Tran,21,0,48,27
1656841669251,CSE 30,A01,083084,Eldon; John,4,0,80,76
1656841669251,CSE 30,B01,095061,Bhaskar; Nishant,6,0,50,44
1656841675288,CSE 100,A01,083659,Cao; Yingjun,2,4,70,68
1656841681319,CSE 134B,A01,083661,Powell; Thomas Allan,19,0,100,81
1656841687343,CSE 140,A01,083663,Gungor; Onat,14,0,85,71
1656841693378,CSE 140L,A01,083088,Eldon; John,16,0,100,84
1656841699403,CSE 175,A01,083665,Kumar; Rakesh,3,0,25,22
1656841705446,CSE 190,A00,092507,Dubnov; Shlomo,7,0,20,13
1656841711478,ECE 45,A01,083139,Congero; Spencer William,5,0,75,70
1656841717505,ECE 65,A50,083695,Saad; Andrew S,12,0,30,18
1656841717505,ECE 65,A51,095125,Saad; Andrew S,25,0,26,1
1656841723547,ECE 109,A01,091882,Touri; Behrouz,16,0,70,54
1656841729577,ECE 180,A00,083140,Abi Samra; Nicholas Camill,0,0,30,30
1656841729577,ECE 180,B00,083141,Abi Samra; Nicholas Camill,0,0,30,30
1656841735605,MATH 10A,A01,083735,Patchell; Gregory David,1,0,30,29
1656841735605,MATH 10A,A02,083736,Patchell; Gregory David,20,0,30,10
1656841735605,MATH 10A,A03,083737,Patchell; Gregory David,15,0,30,15
1656841741638,MATH 10B,A01,083207,Lim; Seonhee,7,0,34,27
1656841741638,MATH 10B,A02,083208,Lim; Seonhee,9,0,35,26
1656841741638,MATH 10B,A03,093472,Lim; Seonhee,4,0,34,30
1656841741638,MATH 10B,B01,083739,Sinha; Shubham,9,0,30,21
1656841747672,MATH 18,A01,083743,Cinel; Cameron Alexander,6,0,30,24
1656841747672,MATH 18,A02,083744,Cinel; Cameron Alexander,15,0,30,15
1656841747672,MATH 18,A03,083745,Cinel; Cameron Alexander,8,0,30,22
1656841747672,MATH 18,B01,083748,Rideout; David Porter,3,0,37,34
1656841747672,MATH 18,B02,083749,Rideout; David Porter,3,0,36,33
1656841747672,MATH 18,B03,083750,Rideout; David Porter,2,0,37,35
1656841747672,MATH 18,B04,083751,Rideout; David Porter,5,0,36,31
1656841747672,MATH 18,B05,093473,Rideout; David Porter,4,0,36,32
1656841747672,MATH 18,B06,093474,Rideout; David Porter,5,0,36,31
1656841753698,MATH 20A,A01,083754,Zheng; Zequn,12,0,40,28
1656841759747,MATH 20B,A01,083756,Briones; Jor-el Thomas Caparas,1,0,36,35
1656841759747,MATH 20B,A02,083757,Briones; Jor-el Thomas Caparas,1,0,36,35
1656841759747,MATH 20B,A03,093475,Briones; Jor-el Thomas Caparas,0,0,36,36
1656841765778,MATH 20C,A01,083760,Briones; Jor-el Thomas Caparas,1,0,35,34
1656841765778,MATH 20C,A02,083761,Briones; Jor-el Thomas Caparas,8,0,35,27
1656841765778,MATH 20C,A03,093476,Briones; Jor-el Thomas Caparas,0,1,36,36
1656841765778,MATH 20C,B01,083762,Bach; Quang Tran,0,0,30,30
1656841771810,MATH 20D,A01,083765,Tran; Brian Kha,4,0,30,26
1656841771810,MATH 20D,A02,083766,Tran; Brian Kha,4,0,30,26
1656841771810,MATH 20D,A03,083767,Tran; Brian Kha,2,0,30,28
1656841777837,MATH 20E,A01,083771,Ganguly; Soumya,5,0,32,27
1656841777837,MATH 20E,A02,083772,Ganguly; Soumya,6,0,32,26
1656841777837,MATH 20E,B01,083773,Ciotti; Benjamin,18,0,35,17
1656841777837,MATH 20E,B02,083774,Ciotti; Benjamin,17,0,35,18
1656841783864,MATH 103A,A01,083777,Greenfeld; Be'Eri,2,0,36,34
1656841783864,MATH 103A,A02,083778,Greenfeld; Be'Eri,5,0,36,31
1656841783864,MATH 103A,A03,093561,Greenfeld; Be'Eri,4,0,36,32
1656841783864,MATH 103A,B01,083779,Greenfeld; Be'Eri,6,0,36,30
1656841783864,MATH 103A,B02,083780,Greenfeld; Be'Eri,2,0,36,34
1656841783864,MATH 103A,B03,093562,Greenfeld; Be'Eri,2,0,36,34
1656841789890,MATH 105,A01,085443,Carter; Anne Toulson,13,0,35,22
1656841789890,MATH 105,A02,093477,Carter; Anne Toulson,20,0,35,15
1656841795918,MATH 109,A01,083213,Ganzberger; Geoffrey Michael,2,0,34,32
1656841795918,MATH 109,A02,083214,Ganzberger; Geoffrey Michael,2,0,34,32
1656841795918,MATH 109,A03,093478,Ganzberger; Geoffrey Michael,1,0,34,33
1656841795918,MATH 109,B01,083215,Ganzberger; Geoffrey Michael,1,0,32,31
1656841795918,MATH 109,B02,083216,Ganzberger; Geoffrey Michael,1,0,32,31
1656841795918,MATH 109,B03,093479,Ganzberger; Geoffrey Michael,6,0,32,26
1656841802053,MATH 142A,A01,083219,Chow; Bennett,6,0,32,26
1656841802053,MATH 142A,A02,083220,Chow; Bennett,9,0,32,23
1656841802053,MATH 142A,A03,093480,Chow; Bennett,7,0,32,25
1656841802053,MATH 142A,B03,093481,Chow; Bennett,7,0,32,25
1656841802053,MATH 142A,B04,093558,Chow; Bennett,10,0,32,22
1656841802053,MATH 142A,B05,093559,Chow; Bennett,6,0,32,26
1656841808077,MATH 193A,A01,083224,Rotar; Vladimir,6,0,34,28
1656841808077,MATH 193A,A02,083225,Rotar; Vladimir,3,0,34,31
1656841808077,MATH 193A,A03,083781,Rotar; Vladimir,1,0,34,33
1656841808077,MATH 193A,A04,083782,Rotar; Vladimir,6,0,34,28
1656841808077,MATH 193A,A05,093482,Rotar; Vladimir,6,0,34,28
1656841814104,MATH 197,001,091859,McAuley; Julian John,9999,0,9999,0
1656841814104,MATH 197,002,095566,Kedlaya; Kiran S.,9997,0,9999,2
1656841814104,MATH 197,003,095567,Xiao; Ming,9999,0,9999,0
1656841814104,MATH 197,004,095571,Perols; Johan Lars,9998,0,9999,1
1656841821169,COGS 9,A01,083615,Shannon; Kyle Michael,6,0,75,69
1656841827198,COGS 11,A01,083617,Boyle; Mary E. T.,18,0,48,30
1656841833226,COGS 13,A01,083071,Bastos; Amalia Pinkusfeld,8,0,71,63
1656841839254,COGS 14A,A01,092681,Semenuks; Arturs,0,1,100,100
1656841845279,COGS 14B,A01,083073,Cheng; Tzu-Han,5,0,63,58
1656841851306,COGS 17,A01,092677,Semenuks; Arturs,4,0,81,77
1656841857333,COGS 100,A01,083619,Allen; Michael Gordon,15,0,70,55
1656841863365,COGS 101A,A01,083621,Davis; Joshua Daniel,9,0,68,59
1656841869395,COGS 101B,A01,091572,Allen; Michael Gordon,8,0,65,57
1656841875421,COGS 101C,A01,083625,Delgado; Tania,17,0,35,18
1656841881446,COGS 107A,A01,083627,Boyle; Mary E. T.,13,0,60,47
1656841887471,COGS 118A,A01,083075,Gupta; Anjum,15,0,76,61
1656841893499,CSE 3,A50,083646,Miranda; Gregory Joseph,22,0,50,28
1656841899530,CSE 8A,A50,083650,Miranda; Gregory Joseph,17,1,56,39
1656841905560,CSE 11,A01,083080,Cao; Yingjun,4,15,40,36
1656841911585,CSE 12,A01,083652,Krause-Levy; Sophia Louisa,20,1,120,100
1656841917616,CSE 15L,A01,083654,Morris; Justin Loren,8,0,50,42
1656841917616,CSE 15L,A02,083655,Morris; Justin Loren,8,0,50,42
1656841923647,CSE 20,A01,083657,Tran; Khoa Dang,37,0,80,43
1656841929674,CSE 21,A01,095574,Bach; Quang Tran,21,0,48,27
1656841935709,CSE 30,A01,083084,Eldon; John,4,0,80,76
1656841935709,CSE 30,B01,095061,Bhaskar; Nishant,6,0,50,44
1656841941742,CSE 100,A01,083659,Cao; Yingjun,2,4,70,68
1656841947771,CSE 134B,A01,083661,Powell; Thomas Allan,19,0,100,81
1656841953801,CSE 140,A01,083663,Gungor; Onat,14,0,85,71
1656841959832,CSE 140L,A01,083088,Eldon; John,16,0,100,84
1656841965861,CSE 175,A01,083665,Kumar; Rakesh,3,0,25,22
1656841971893,CSE 190,A00,092507,Dubnov; Shlomo,7,0,20,13
1656841977940,ECE 45,A01,083139,Congero; Spencer William,5,0,75,70
1656841983967,ECE 65,A50,083695,Saad; Andrew S,12,0,30,18
1656841983967,ECE 65,A51,095125,Saad; Andrew S,25,0,26,1
1656841989992,ECE 109,A01,091882,Touri; Behrouz,16,0,70,54
1656841996023,ECE 180,A00,083140,Abi Samra; Nicholas Camill,0,0,30,30
1656841996023,ECE 180,B00,083141,Abi Samra; Nicholas Camill,0,0,30,30
1656842002050,MATH 10A,A01,083735,Patchell; Gregory David,1,0,30,29
1656842002050,MATH 10A,A02,083736,Patchell; Gregory David,20,0,30,10
1656842002050,MATH 10A,A03,083737,Patchell; Gregory David,15,0,30,15
1656842008087,MATH 10B,A01,083207,Lim; Seonhee,7,0,34,27
1656842008087,MATH 10B,A02,083208,Lim; Seonhee,9,0,35,26
1656842008087,MATH 10B,A03,093472,Lim; Seonhee,4,0,34,30
1656842008087,MATH 10B,B01,083739,Sinha; Shubham,9,0,30,21
1656842014119,MATH 18,A01,083743,Cinel; Cameron Alexander,6,0,30,24
1656842014119,MATH 18,A02,083744,Cinel; Cameron Alexander,15,0,30,15
1656842014119,MATH 18,A03,083745,Cinel; Cameron Alexander,8,0,30,22
1656842014119,MATH 18,B01,083748,Rideout; David Porter,3,0,37,34
1656842014119,MATH 18,B02,083749,Rideout; David Porter,3,0,36,33
1656842014119,MATH 18,B03,083750,Rideout; David Porter,2,0,37,35
1656842014119,MATH 18,B04,083751,Rideout; David Porter,5,0,36,31
1656842014119,MATH 18,B05,093473,Rideout; David Porter,4,0,36,32
1656842014119,MATH 18,B06,093474,Rideout; David Porter,5,0,36,31
1656842020143,MATH 20A,A01,083754,Zheng; Zequn,12,0,40,28
1656842026175,MATH 20B,A01,083756,Briones; Jor-el Thomas Caparas,1,0,36,35
1656842026175,MATH 20B,A02,083757,Briones; Jor-el Thomas Caparas,1,0,36,35
1656842026175,MATH 20B,A03,093475,Briones; Jor-el Thomas Caparas,0,0,36,36
1656842032203,MATH 20C,A01,083760,Briones; Jor-el Thomas Caparas,1,0,35,34
1656842032203,MATH 20C,A02,083761,Briones; Jor-el Thomas Caparas,8,0,35,27
1656842032203,MATH 20C,A03,093476,Briones; Jor-el Thomas Caparas,0,1,36,36
1656842032203,MATH 20C,B01,083762,Bach; Quang Tran,0,0,30,30
1656842038233,MATH 20D,A01,083765,Tran; Brian Kha,4,0,30,26
1656842038233,MATH 20D,A02,083766,Tran; Brian Kha,4,0,30,26
1656842038233,MATH 20D,A03,083767,Tran; Brian Kha,2,0,30,28
1656842044268,MATH 20E,A01,083771,Ganguly; Soumya,5,0,32,27
1656842044268,MATH 20E,A02,083772,Ganguly; Soumya,6,0,32,26
1656842044268,MATH 20E,B01,083773,Ciotti; Benjamin,18,0,35,17
1656842044268,MATH 20E,B02,083774,Ciotti; Benjamin,17,0,35,18
1656842050296,MATH 103A,A01,083777,Greenfeld; Be'Eri,2,0,36,34
1656842050296,MATH 103A,A02,083778,Greenfeld; Be'Eri,5,0,36,31
1656842050296,MATH 103A,A03,093561,Greenfeld; Be'Eri,4,0,36,32
1656842050296,MATH 103A,B01,083779,Greenfeld; Be'Eri,6,0,36,30
1656842050296,MATH 103A,B02,083780,Greenfeld; Be'Eri,2,0,36,34
1656842050296,MATH 103A,B03,093562,Greenfeld; Be'Eri,2,0,36,34
1656842056327,MATH 105,A01,085443,Carter; Anne Toulson,13,0,35,22
1656842056327,MATH 105,A02,093477,Carter; Anne Toulson,20,0,35,15
1656842062355,MATH 109,A01,083213,Ganzberger; Geoffrey Michael,2,0,34,32
1656842062355,MATH 109,A02,083214,Ganzberger; Geoffrey Michael,2,0,34,32
1656842062355,MATH 109,A03,093478,Ganzberger; Geoffrey Michael,1,0,34,33
1656842062355,MATH 109,B01,083215,Ganzberger; Geoffrey Michael,1,0,32,31
1656842062355,MATH 109,B02,083216,Ganzberger; Geoffrey Michael,1,0,32,31
1656842062355,MATH 109,B03,093479,Ganzberger; Geoffrey Michael,6,0,32,26
1656842068382,MATH 142A,A01,083219,Chow; Bennett,6,0,32,26
1656842068382,MATH 142A,A02,083220,Chow; Bennett,9,0,32,23
1656842068382,MATH 142A,A03,093480,Chow; Bennett,7,0,32,25
1656842068382,MATH 142A,B03,093481,Chow; Bennett,7,0,32,25
1656842068382,MATH 142A,B04,093558,Chow; Bennett,10,0,32,22
1656842068382,MATH 142A,B05,093559,Chow; Bennett,6,0,32,26
1656842074409,MATH 193A,A01,083224,Rotar; Vladimir,6,0,34,28
1656842074409,MATH 193A,A02,083225,Rotar; Vladimir,3,0,34,31
1656842074409,MATH 193A,A03,083781,Rotar; Vladimir,1,0,34,33
1656842074409,MATH 193A,A04,083782,Rotar; Vladimir,6,0,34,28
1656842074409,MATH 193A,A05,093482,Rotar; Vladimir,6,0,34,28
1656842080436,MATH 197,001,091859,McAuley; Julian John,9999,0,9999,0
1656842080436,MATH 197,002,095566,Kedlaya; Kiran S.,9997,0,9999,2
1656842080436,MATH 197,003,095567,Xiao; Ming,9999,0,9999,0
1656842080436,MATH 197,004,095571,Perols; Johan Lars,9998,0,9999,1
1656842087521,COGS 9,A01,083615,Shannon; Kyle Michael,6,0,75,69
1656842093555,COGS 11,A01,083617,Boyle; Mary E. T.,18,0,48,30
1656842099584,COGS 13,A01,083071,Bastos; Amalia Pinkusfeld,8,0,71,63
1656842105617,COGS 14A,A01,092681,Semenuks; Arturs,0,1,100,100
1656842111647,COGS 14B,A01,083073,Cheng; Tzu-Han,5,0,63,58
1656842117672,COGS 17,A01,092677,Semenuks; Arturs,4,0,81,77
1656842123697,COGS 100,A01,083619,Allen; Michael Gordon,15,0,70,55
1656842129735,COGS 101A,A01,083621,Davis; Joshua Daniel,9,0,68,59
1656842135761,COGS 101B,A01,091572,Allen; Michael Gordon,8,0,65,57
1656842141785,COGS 101C,A01,083625,Delgado; Tania,17,0,35,18
1656842147810,COGS 107A,A01,083627,Boyle; Mary E. T.,13,0,60,47
1656842153835,COGS 118A,A01,083075,Gupta; Anjum,15,0,76,61
1656842159871,CSE 3,A50,083646,Miranda; Gregory Joseph,22,0,50,28
1656842165896,CSE 8A,A50,083650,Miranda; Gregory Joseph,17,1,56,39
1656842171921,CSE 11,A01,083080,Cao; Yingjun,4,15,40,36
1656842177945,CSE 12,A01,083652,Krause-Levy; Sophia Louisa,20,1,120,100
1656842183974,CSE 15L,A01,083654,Morris; Justin Loren,8,0,50,42
1656842183974,CSE 15L,A02,083655,Morris; Justin Loren,8,0,50,42
1656842190000,CSE 20,A01,083657,Tran; Khoa Dang,37,0,80,43
1656842196031,CSE 21,A01,095574,Bach; Quang Tran,21,0,48,27
1656842202065,CSE 30,A01,083084,Eldon; John,4,0,80,76
1656842202065,CSE 30,B01,095061,Bhaskar; Nishant,6,0,50,44
1656842208092,CSE 100,A01,083659,Cao; Yingjun,2,4,70,68
1656842214122,CSE 134B,A01,083661,Powell; Thomas Allan,19,0,100,81
1656842220153,CSE 140,A01,083663,Gungor; Onat,14,0,85,71
1656842226178,CSE 140L,A01,083088,Eldon; John,16,0,100,84
1656842232204,CSE 175,A01,083665,Kumar; Rakesh,3,0,25,22
1656842238234,CSE 190,A00,092507,Dubnov; Shlomo,7,0,20,13
1656842244262,ECE 45,A01,083139,Congero; Spencer William,5,0,75,70
1656842250297,ECE 65,A50,083695,Saad; Andrew S,12,0,30,18
1656842250297,ECE 65,A51,095125,Saad; Andrew S,25,0,26,1
1656842256329,ECE 109,A01,091882,Touri; Behrouz,16,0,70,54
1656842262355,ECE 180,A00,083140,Abi Samra; Nicholas Camill,0,0,30,30
1656842262355,ECE 180,B00,083141,Abi Samra; Nicholas Camill,0,0,30,30
1656842268383,MATH 10A,A01,083735,Patchell; Gregory David,1,0,30,29
1656842268383,MATH 10A,A02,083736,Patchell; Gregory David,20,0,30,10
1656842268383,MATH 10A,A03,083737,Patchell; Gregory David,15,0,30,15
1656842274423,MATH 10B,A01,083207,Lim; Seonhee,7,0,34,27
1656842274423,MATH 10B,A02,083208,Lim; Seonhee,9,0,35,26
1656842274423,MATH 10B,A03,093472,Lim; Seonhee,4,0,34,30
1656842274423,MATH 10B,B01,083739,Sinha; Shubham,9,0,30,21
1656842280466,MATH 18,A01,083743,Cinel; Cameron Alexander,6,0,30,24
1656842280466,MATH 18,A02,083744,Cinel; Cameron Alexander,15,0,30,15
1656842280466,MATH 18,A03,083745,Cinel; Cameron Alexander,8,0,30,22
1656842280466,MATH 18,B01,083748,Rideout; David Porter,3,0,37,34
1656842280466,MATH 18,B02,083749,Rideout; David Porter,3,0,36,33
1656842280466,MATH 18,B03,083750,Rideout; David Porter,2,0,37,35
1656842280466,MATH 18,B04,083751,Rideout; David Porter,5,0,36,31
1656842280466,MATH 18,B05,093473,Rideout; David Porter,4,0,36,32
1656842280466,MATH 18,B06,093474,Rideout; David Porter,5,0,36,31
1656842286496,MATH 20A,A01,083754,Zheng; Zequn,12,0,40,28
1656842292522,MATH 20B,A01,083756,Briones; Jor-el Thomas Caparas,1,0,36,35
1656842292522,MATH 20B,A02,083757,Briones; Jor-el Thomas Caparas,1,0,36,35
1656842292522,MATH 20B,A03,093475,Briones; Jor-el Thomas Caparas,0,0,36,36
1656842298557,MATH 20C,A01,083760,Briones; Jor-el Thomas Caparas,1,0,35,34
1656842298557,MATH 20C,A02,083761,Briones; Jor-el Thomas Caparas,8,0,35,27
1656842298557,MATH 20C,A03,093476,Briones; Jor-el Thomas Caparas,0,1,36,36
1656842298557,MATH 20C,B01,083762,Bach; Quang Tran,0,0,30,30
1656842304584,MATH 20D,A01,083765,Tran; Brian Kha,4,0,30,26
1656842304584,MATH 20D,A02,083766,Tran; Brian Kha,4,0,30,26
1656842304584,MATH 20D,A03,083767,Tran; Brian Kha,2,0,30,28
1656842310613,MATH 20E,A01,083771,Ganguly; Soumya,5,0,32,27
1656842310613,MATH 20E,A02,083772,Ganguly; Soumya,6,0,32,26
1656842310613,MATH 20E,B01,083773,Ciotti; Benjamin,18,0,35,17
1656842310613,MATH 20E,B02,083774,Ciotti; Benjamin,17,0,35,18
1656842316653,MATH 103A,A01,083777,Greenfeld; Be'Eri,2,0,36,34
1656842316653,MATH 103A,A02,083778,Greenfeld; Be'Eri,5,0,36,31
1656842316653,MATH 103A,A03,093561,Greenfeld; Be'Eri,4,0,36,32
1656842316653,MATH 103A,B01,083779,Greenfeld; Be'Eri,6,0,36,30
1656842316653,MATH 103A,B02,083780,Greenfeld; Be'Eri,2,0,36,34
1656842316653,MATH 103A,B03,093562,Greenfeld; Be'Eri,2,0,36,34
1656842322686,MATH 105,A01,085443,Carter; Anne Toulson,13,0,35,22
1656842322686,MATH 105,A02,093477,Carter; Anne Toulson,20,0,35,15
1656842328713,MATH 109,A01,083213,Ganzberger; Geoffrey Michael,2,0,34,32
1656842328713,MATH 109,A02,083214,Ganzberger; Geoffrey Michael,2,0,34,32
1656842328713,MATH 109,A03,093478,Ganzberger; Geoffrey Michael,1,0,34,33
1656842328713,MATH 109,B01,083215,Ganzberger; Geoffrey Michael,1,0,32,31
1656842328713,MATH 109,B02,083216,Ganzberger; Geoffrey Michael,1,0,32,31
1656842328713,MATH 109,B03,093479,Ganzberger; Geoffrey Michael,6,0,32,26
1656842334746,MATH 142A,A01,083219,Chow; Bennett,6,0,32,26
1656842334746,MATH 142A,A02,083220,Chow; Bennett,9,0,32,23
1656842334746,MATH 142A,A03,093480,Chow; Bennett,7,0,32,25
1656842334746,MATH 142A,B03,093481,Chow; Bennett,7,0,32,25
1656842334746,MATH 142A,B04,093558,Chow; Bennett,10,0,32,22
1656842334746,MATH 142A,B05,093559,Chow; Bennett,6,0,32,26
1656842340789,MATH 193A,A01,083224,Rotar; Vladimir,6,0,34,28
1656842340789,MATH 193A,A02,083225,Rotar; Vladimir,3,0,34,31
1656842340789,MATH 193A,A03,083781,Rotar; Vladimir,1,0,34,33
1656842340789,MATH 193A,A04,083782,Rotar; Vladimir,6,0,34,28
1656842340789,MATH 193A,A05,093482,Rotar; Vladimir,6,0,34,28
1656842346814,MATH 197,001,091859,McAuley; Julian John,9999,0,9999,0
1656842346814,MATH 197,002,095566,Kedlaya; Kiran S.,9997,0,9999,2
1656842346814,MATH 197,003,095567,Xiao; Ming,9999,0,9999,0
1656842346814,MATH 197,004,095571,Perols; Johan Lars,9998,0,9999,1
1656842353901,COGS 9,A01,083615,Shannon; Kyle Michael,6,0,75,69
1656842359931,COGS 11,A01,083617,Boyle; Mary E. T.,18,0,48,30
1656842365964,COGS 13,A01,083071,Bastos; Amalia Pinkusfeld,8,0,71,63
1656842371988,COGS 14A,A01,092681,Semenuks; Arturs,0,1,100,100
1656842378018,COGS 14B,A01,083073,Cheng; Tzu-Han,5,0,63,58
1656842384049,COGS 17,A01,092677,Semenuks; Arturs,4,0,81,77
1656842390080,COGS 100,A01,083619,Allen; Michael Gordon,15,0,70,55
1656842396201,COGS 101A,A01,083621,Davis; Joshua Daniel,9,0,68,59
1656842402232,COGS 101B,A01,091572,Allen; Michael Gordon,8,0,65,57
1656842408259,COGS 101C,A01,083625,Delgado; Tania,17,0,35,18
1656842414283,COGS 107A,A01,083627,Boyle; Mary E. T.,13,0,60,47
1656842420312,COGS 118A,A01,083075,Gupta; Anjum,15,0,76,61
1656842426343,CSE 3,A50,083646,Miranda; Gregory Joseph,22,0,50,28
1656842432367,CSE 8A,A50,083650,Miranda; Gregory Joseph,17,1,56,39
1656842438392,CSE 11,A01,083080,Cao; Yingjun,4,15,40,36
1656842444418,CSE 12,A01,083652,Krause-Levy; Sophia Louisa,20,1,120,100
1656842450441,CSE 15L,A01,083654,Morris; Justin Loren,8,0,50,42
1656842450441,CSE 15L,A02,083655,Morris; Justin Loren,8,0,50,42
1656842456467,CSE 20,A01,083657,Tran; Khoa Dang,37,0,80,43
1656842462491,CSE 21,A01,095574,Bach; Quang Tran,21,0,48,27
1656842468524,CSE 30,A01,083084,Eldon; John,4,0,80,76
1656842468524,CSE 30,B01,095061,Bhaskar; Nishant,6,0,50,44
1656842474556,CSE 100,A01,083659,Cao; Yingjun,2,4,70,68
1656842480588,CSE 134B,A01,083661,Powell; Thomas Allan,19,0,100,81
1656842486612,CSE 140,A01,083663,Gungor; Onat,14,0,85,71
1656842492636,CSE 140L,A01,083088,Eldon; John,16,0,100,84
1656842498667,CSE 175,A01,083665,Kumar; Rakesh,3,0,25,22
1656842504694,CSE 190,A00,092507,Dubnov; Shlomo,7,0,20,13
1656842510719,ECE 45,A01,083139,Congero; Spencer William,5,0,75,70
1656842516745,ECE 65,A50,083695,Saad; Andrew S,12,0,30,18
1656842516745,ECE 65,A51,095125,Saad; Andrew S,25,0,26,1
1656842522781,ECE 109,A01,091882,Touri; Behrouz,16,0,70,54
1656842528804,ECE 180,A00,083140,Abi Samra; Nicholas Camill,0,0,30,30
1656842528804,ECE 180,B00,083141,Abi Samra; Nicholas Camill,0,0,30,30
1656842534829,MATH 10A,A01,083735,Patchell; Gregory David,1,0,30,29
1656842534829,MATH 10A,A02,083736,Patchell; Gregory David,20,0,30,10
1656842534829,MATH 10A,A03,083737,Patchell; Gregory David,15,0,30,15
1656842540863,MATH 10B,A01,083207,Lim; Seonhee,7,0,34,27
1656842540863,MATH 10B,A02,083208,Lim; Seonhee,9,0,35,26
1656842540863,MATH 10B,A03,093472,Lim; Seonhee,4,0,34,30
1656842540863,MATH 10B,B01,083739,Sinha; Shubham,9,0,30,21
1656842546891,MATH 18,A01,083743,Cinel; Cameron Alexander,6,0,30,24
1656842546891,MATH 18,A02,083744,Cinel; Cameron Alexander,15,0,30,15
1656842546891,MATH 18,A03,083745,Cinel; Cameron Alexander,8,0,30,22
1656842546891,MATH 18,B01,083748,Rideout; David Porter,3,0,37,34
1656842546891,MATH 18,B02,083749,Rideout; David Porter,3,0,36,33
1656842546891,MATH 18,B03,083750,Rideout; David Porter,2,0,37,35
1656842546891,MATH 18,B04,083751,Rideout; David Porter,5,0,36,31
1656842546891,MATH 18,B05,093473,Rideout; David Porter,4,0,36,32
1656842546891,MATH 18,B06,093474,Rideout; David Porter,5,0,36,31
1656842552920,MATH 20A,A01,083754,Zheng; Zequn,12,0,40,28
1656842558946,MATH 20B,A01,083756,Briones; Jor-el Thomas Caparas,1,0,36,35
1656842558946,MATH 20B,A02,083757,Briones; Jor-el Thomas Caparas,1,0,36,35
1656842558946,MATH 20B,A03,093475,Briones; Jor-el Thomas Caparas,0,0,36,36
1656842564969,MATH 20C,A01,083760,Briones; Jor-el Thomas Caparas,1,0,35,34
1656842564969,MATH 20C,A02,083761,Briones; Jor-el Thomas Caparas,8,0,35,27
1656842564969,MATH 20C,A03,093476,Briones; Jor-el Thomas Caparas,0,1,36,36
1656842564969,MATH 20C,B01,083762,Bach; Quang Tran,0,0,30,30
1656842571001,MATH 20D,A01,083765,Tran; Brian Kha,4,0,30,26
1656842571001,MATH 20D,A02,083766,Tran; Brian Kha,4,0,30,26
1656842571001,MATH 20D,A03,083767,Tran; Brian Kha,2,0,30,28
1656842577028,MATH 20E,A01,083771,Ganguly; Soumya,5,0,32,27
1656842577028,MATH 20E,A02,083772,Ganguly; Soumya,6,0,32,26
1656842577028,MATH 20E,B01,083773,Ciotti; Benjamin,18,0,35,17
1656842577028,MATH 20E,B02,083774,Ciotti; Benjamin,17,0,35,18
1656842583058,MATH 103A,A01,083777,Greenfeld; Be'Eri,2,0,36,34
1656842583058,MATH 103A,A02,083778,Greenfeld; Be'Eri,5,0,36,31
1656842583058,MATH 103A,A03,093561,Greenfeld; Be'Eri,4,0,36,32
1656842583058,MATH 103A,B01,083779,Greenfeld; Be'Eri,6,0,36,30
1656842583058,MATH 103A,B02,083780,Greenfeld; Be'Eri,2,0,36,34
1656842583058,MATH 103A,B03,093562,Greenfeld; Be'Eri,2,0,36,34
1656842589087,MATH 105,A01,085443,Carter; Anne Toulson,13,0,35,22
1656842589087,MATH 105,A02,093477,Carter; Anne Toulson,20,0,35,15
1656842595118,MATH 109,A01,083213,Ganzberger; Geoffrey Michael,2,0,34,32
1656842595118,MATH 109,A02,083214,Ganzberger; Geoffrey Michael,2,0,34,32
1656842595118,MATH 109,A03,093478,Ganzberger; Geoffrey Michael,1,0,34,33
1656842595118,MATH 109,B01,083215,Ganzberger; Geoffrey Michael,1,0,32,31
1656842595118,MATH 109,B02,083216,Ganzberger; Geoffrey Michael,1,0,32,31
1656842595118,MATH 109,B03,093479,Ganzberger; Geoffrey Michael,6,0,32,26
1656842601150,MATH 142A,A01,083219,Chow; Bennett,6,0,32,26
1656842601150,MATH 142A,A02,083220,Chow; Bennett,9,0,32,23
1656842601150,MATH 142A,A03,093480,Chow; Bennett,7,0,32,25
1656842601150,MATH 142A,B03,093481,Chow; Bennett,7,0,32,25
1656842601150,MATH 142A,B04,093558,Chow; Bennett,10,0,32,22
1656842601150,MATH 142A,B05,093559,Chow; Bennett,6,0,32,26
1656842607172,MATH 193A,A01,083224,Rotar; Vladimir,6,0,34,28
1656842607172,MATH 193A,A02,083225,Rotar; Vladimir,3,0,34,31
1656842607172,MATH 193A,A03,083781,Rotar; Vladimir,1,0,34,33
1656842607172,MATH 193A,A04,083782,Rotar; Vladimir,6,0,34,28
1656842607172,MATH 193A,A05,093482,Rotar; Vladimir,6,0,34,28
1656842613210,MATH 197,001,091859,McAuley; Julian John,9999,0,9999,0
1656842613210,MATH 197,002,095566,Kedlaya; Kiran S.,9997,0,9999,2
1656842613210,MATH 197,003,095567,Xiao; Ming,9999,0,9999,0
1656842613210,MATH 197,004,095571,Perols; Johan Lars,9998,0,9999,1
1656842620293,COGS 9,A01,083615,Shannon; Kyle Michael,6,0,75,69
1656842626323,COGS 11,A01,083617,Boyle; Mary E. T.,18,0,48,30
1656842632352,COGS 13,A01,083071,Bastos; Amalia Pinkusfeld,8,0,71,63
1656842638377,COGS 14A,A01,092681,Semenuks; Arturs,0,1,100,100
1656842644406,COGS 14B,A01,083073,Cheng; Tzu-Han,5,0,63,58
1656842650432,COGS 17,A01,092677,Semenuks; Arturs,4,0,81,77
1656842656462,COGS 100,A01,083619,Allen; Michael Gordon,15,0,70,55
1656842662485,COGS 101A,A01,083621,Davis; Joshua Daniel,9,0,68,59
1656842668520,COGS 101B,A01,091572,Allen; Michael Gordon,8,0,65,57
1656842674549,COGS 101C,A01,083625,Delgado; Tania,17,0,35,18
1656842680572,COGS 107A,A01,083627,Boyle; Mary E. T.,13,0,60,47
1656842686597,COGS 118A,A01,083075,Gupta; Anjum,15,0,76,61
1656842692628,CSE 3,A50,083646,Miranda; Gregory Joseph,22,0,50,28
1656842698651,CSE 8A,A50,083650,Miranda; Gregory Joseph,17,1,56,39
1656842704673,CSE 11,A01,083080,Cao; Yingjun,4,15,40,36
1656842710704,CSE 12,A01,083652,Krause-Levy; Sophia Louisa,20,1,120,100
1656842716731,CSE 15L,A01,083654,Morris; Justin Loren,8,0,50,42
1656842716731,CSE 15L,A02,083655,Morris; Justin Loren,8,0,50,42
1656842722754,CSE 20,A01,083657,Tran; Khoa Dang,37,0,80,43
1656842728783,CSE 21,A01,095574,Bach; Quang Tran,21,0,48,27
1656842734814,CSE 30,A01,083084,Eldon; John,4,0,80,76
1656842734814,CSE 30,B01,095061,Bhaskar; Nishant,6,0,50,44
1656842740839,CSE 100,A01,083659,Cao; Yingjun,2,4,70,68
1656842746866,CSE 134B,A01,083661,Powell; Thomas Allan,19,0,100,81
1656842752892,CSE 140,A01,083663,Gungor; Onat,14,0,85,71
1656842758916,CSE 140L,A01,083088,Eldon; John,16,0,100,84
1656842764948,CSE 175,A01,083665,Kumar; Rakesh,3,0,25,22
1656842770974,CSE 190,A00,092507,Dubnov; Shlomo,7,0,20,13
1656842777004,ECE 45,A01,083139,Congero; Spencer William,5,0,75,70
1656842783033,ECE 65,A50,083695,Saad; Andrew S,12,0,30,18
1656842783033,ECE 65,A51,095125,Saad; Andrew S,25,0,26,1
1656842789058,ECE 109,A01,091882,Touri; Behrouz,16,0,70,54
1656842795088,ECE 180,A00,083140,Abi Samra; Nicholas Camill,0,0,30,30
1656842795088,ECE 180,B00,083141,Abi Samra; Nicholas Camill,0,0,30,30
1656842801123,MATH 10A,A01,083735,Patchell; Gregory David,1,0,30,29
1656842801123,MATH 10A,A02,083736,Patchell; Gregory David,20,0,30,10
1656842801123,MATH 10A,A03,083737,Patchell; Gregory David,15,0,30,15
1656842807156,MATH 10B,A01,083207,Lim; Seonhee,7,0,34,27
1656842807156,MATH 10B,A02,083208,Lim; Seonhee,9,0,35,26
1656842807156,MATH 10B,A03,093472,Lim; Seonhee,4,0,34,30
1656842807156,MATH 10B,B01,083739,Sinha; Shubham,9,0,30,21
1656842813196,MATH 18,A01,083743,Cinel; Cameron Alexander,6,0,30,24
1656842813196,MATH 18,A02,083744,Cinel; Cameron Alexander,15,0,30,15
1656842813196,MATH 18,A03,083745,Cinel; Cameron Alexander,8,0,30,22
1656842813196,MATH 18,B01,083748,Rideout; David Porter,3,0,37,34
1656842813196,MATH 18,B02,083749,Rideout; David Porter,3,0,36,33
1656842813196,MATH 18,B03,083750,Rideout; David Porter,2,0,37,35
1656842813196,MATH 18,B04,083751,Rideout; David Porter,5,0,36,31
1656842813196,MATH 18,B05,093473,Rideout; David Porter,4,0,36,32
1656842813196,MATH 18,B06,093474,Rideout; David Porter,5,0,36,31
1656842819227,MATH 20A,A01,083754,Zheng; Zequn,12,0,40,28
1656842825261,MATH 20B,A01,083756,Briones; Jor-el Thomas Caparas,1,0,36,35
1656842825261,MATH 20B,A02,083757,Briones; Jor-el Thomas Caparas,1,0,36,35
1656842825261,MATH 20B,A03,093475,Briones; Jor-el Thomas Caparas,0,0,36,36
1656842831292,MATH 20C,A01,083760,Briones; Jor-el Thomas Caparas,1,0,35,34
1656842831292,MATH 20C,A02,083761,Briones; Jor-el Thomas Caparas,8,0,35,27
1656842831292,MATH 20C,A03,093476,Briones; Jor-el Thomas Caparas,0,1,36,36
1656842831292,MATH 20C,B01,083762,Bach; Quang Tran,0,0,30,30
1656842837323,MATH 20D,A01,083765,Tran; Brian Kha,4,0,30,26
1656842837323,MATH 20D,A02,083766,Tran; Brian Kha,4,0,30,26
1656842837323,MATH 20D,A03,083767,Tran; Brian Kha,2,0,30,28
1656842843357,MATH 20E,A01,083771,Ganguly; Soumya,5,0,32,27
1656842843357,MATH 20E,A02,083772,Ganguly; Soumya,6,0,32,26
1656842843357,MATH 20E,B01,083773,Ciotti; Benjamin,18,0,35,17
1656842843357,MATH 20E,B02,083774,Ciotti; Benjamin,17,0,35,18
1656842849392,MATH 103A,A01,083777,Greenfeld; Be'Eri,2,0,36,34
1656842849392,MATH 103A,A02,083778,Greenfeld; Be'Eri,5,0,36,31
1656842849392,MATH 103A,A03,093561,Greenfeld; Be'Eri,4,0,36,32
1656842849392,MATH 103A,B01,083779,Greenfeld; Be'Eri,6,0,36,30
1656842849392,MATH 103A,B02,083780,Greenfeld; Be'Eri,2,0,36,34
1656842849392,MATH 103A,B03,093562,Greenfeld; Be'Eri,2,0,36,34
1656842855422,MATH 105,A01,085443,Carter; Anne Toulson,13,0,35,22
1656842855422,MATH 105,A02,093477,Carter; Anne Toulson,20,0,35,15
1656842861460,MATH 109,A01,083213,Ganzberger; Geoffrey Michael,2,0,34,32
1656842861460,MATH 109,A02,083214,Ganzberger; Geoffrey Michael,2,0,34,32
1656842861460,MATH 109,A03,093478,Ganzberger; Geoffrey Michael,1,0,34,33
1656842861460,MATH 109,B01,083215,Ganzberger; Geoffrey Michael,1,0,32,31
1656842861460,MATH 109,B02,083216,Ganzberger; Geoffrey Michael,1,0,32,31
1656842861460,MATH 109,B03,093479,Ganzberger; Geoffrey Michael,6,0,32,26
1656842867488,MATH 142A,A01,083219,Chow; Bennett,6,0,32,26
1656842867488,MATH 142A,A02,083220,Chow; Bennett,9,0,32,23
1656842867488,MATH 142A,A03,093480,Chow; Bennett,7,0,32,25
1656842867488,MATH 142A,B03,093481,Chow; Bennett,7,0,32,25
1656842867488,MATH 142A,B04,093558,Chow; Bennett,10,0,32,22
1656842867488,MATH 142A,B05,093559,Chow; Bennett,6,0,32,26
1656842873519,MATH 193A,A01,083224,Rotar; Vladimir,6,0,34,28
1656842873519,MATH 193A,A02,083225,Rotar; Vladimir,3,0,34,31
1656842873519,MATH 193A,A03,083781,Rotar; Vladimir,1,0,34,33
1656842873519,MATH 193A,A04,083782,Rotar; Vladimir,6,0,34,28
1656842873519,MATH 193A,A05,093482,Rotar; Vladimir,6,0,34,28
1656842879550,MATH 197,001,091859,McAuley; Julian John,9999,0,9999,0
1656842879550,MATH 197,002,095566,Kedlaya; Kiran S.,9997,0,9999,2
1656842879550,MATH 197,003,095567,Xiao; Ming,9999,0,9999,0
1656842879550,MATH 197,004,095571,Perols; Johan Lars,9998,0,9999,1
1656842886614,COGS 9,A01,083615,Shannon; Kyle Michael,6,0,75,69
1656842892638,COGS 11,A01,083617,Boyle; Mary E. T.,18,0,48,30
1656842898667,COGS 13,A01,083071,Bastos; Amalia Pinkusfeld,8,0,71,63
1656842904698,COGS 14A,A01,092681,Semenuks; Arturs,0,1,100,100
1656842910722,COGS 14B,A01,083073,Cheng; Tzu-Han,5,0,63,58
1656842916748,COGS 17,A01,092677,Semenuks; Arturs,4,0,81,77
1656842922772,COGS 100,A01,083619,Allen; Michael Gordon,15,0,70,55
1656842928796,COGS 101A,A01,083621,Davis; Joshua Daniel,9,0,68,59
1656842934821,COGS 101B,A01,091572,Allen; Michael Gordon,8,0,65,57
1656842940844,COGS 101C,A01,083625,Delgado; Tania,17,0,35,18
1656842946866,COGS 107A,A01,083627,Boyle; Mary E. T.,13,0,60,47
1656842952895,COGS 118A,A01,083075,Gupta; Anjum,15,0,76,61
1656842958920,CSE 3,A50,083646,Miranda; Gregory Joseph,22,0,50,28
1656842964948,CSE 8A,A50,083650,Miranda; Gregory Joseph,17,1,56,39
1656842970973,CSE 11,A01,083080,Cao; Yingjun,4,15,40,36
1656842976999,CSE 12,A01,083652,Krause-Levy; Sophia Louisa,20,1,120,100
1656842983028,CSE 15L,A01,083654,Morris; Justin Loren,8,0,50,42
1656842983028,CSE 15L,A02,083655,Morris; Justin Loren,8,0,50,42
1656842989055,CSE 20,A01,083657,Tran; Khoa Dang,37,0,80,43
1656842995153,CSE 21,A01,095574,Bach; Quang Tran,21,0,48,27
1656843001181,CSE 30,A01,083084,Eldon; John,4,0,80,76
1656843001181,CSE 30,B01,095061,Bhaskar; Nishant,6,0,50,44
1656843007205,CSE 100,A01,083659,Cao; Yingjun,2,4,70,68
1656843013233,CSE 134B,A01,083661,Powell; Thomas Allan,19,0,100,81
1656843019258,CSE 140,A01,083663,Gungor; Onat,14,0,85,71
1656843025295,CSE 140L,A01,083088,Eldon; John,16,0,100,84
1656843031333,CSE 175,A01,083665,Kumar; Rakesh,3,0,25,22
1656843037357,CSE 190,A00,092507,Dubnov; Shlomo,7,0,20,13
1656843043382,ECE 45,A01,083139,Congero; Spencer William,5,0,75,70
1656843049418,ECE 65,A50,083695,Saad; Andrew S,12,0,30,18
1656843049418,ECE 65,A51,095125,Saad; Andrew S,25,0,26,1
1656843055444,ECE 109,A01,091882,Touri; Behrouz,16,0,70,54
1656843061468,ECE 180,A00,083140,Abi Samra; Nicholas Camill,0,0,30,30
1656843061468,ECE 180,B00,083141,Abi Samra; Nicholas Camill,0,0,30,30
1656843067498,MATH 10A,A01,083735,Patchell; Gregory David,1,0,30,29
1656843067498,MATH 10A,A02,083736,Patchell; Gregory David,20,0,30,10
1656843067498,MATH 10A,A03,083737,Patchell; Gregory David,15,0,30,15
1656843073526,MATH 10B,A01,083207,Lim; Seonhee,7,0,34,27
1656843073526,MATH 10B,A02,083208,Lim; Seonhee,9,0,35,26
1656843073526,MATH 10B,A03,093472,Lim; Seonhee,4,0,34,30
1656843073526,MATH 10B,B01,083739,Sinha; Shubham,9,0,30,21
1656843079553,MATH 18,A01,083743,Cinel; Cameron Alexander,6,0,30,24
1656843079553,MATH 18,A02,083744,Cinel; Cameron Alexander,15,0,30,15
1656843079553,MATH 18,A03,083745,Cinel; Cameron Alexander,8,0,30,22
1656843079553,MATH 18,B01,083748,Rideout; David Porter,3,0,37,34
1656843079553,MATH 18,B02,083749,Rideout; David Porter,3,0,36,33
1656843079553,MATH 18,B03,083750,Rideout; David Porter,2,0,37,35
1656843079553,MATH 18,B04,083751,Rideout; David Porter,5,0,36,31
1656843079553,MATH 18,B05,093473,Rideout; David Porter,4,0,36,32
1656843079553,MATH 18,B06,093474,Rideout; David Porter,5,0,36,31
1656843085578,MATH 20A,A01,083754,Zheng; Zequn,12,0,40,28
1656843091607,MATH 20B,A01,083756,Briones; Jor-el Thomas Caparas,1,0,36,35
1656843091607,MATH 20B,A02,083757,Briones; Jor-el Thomas Caparas,1,0,36,35
1656843091607,MATH 20B,A03,093475,Briones; Jor-el Thomas Caparas,0,0,36,36
1656843097632,MATH 20C,A01,083760,Briones; Jor-el Thomas Caparas,1,0,35,34
1656843097632,MATH 20C,A02,083761,Briones; Jor-el Thomas Caparas,8,0,35,27
1656843097632,MATH 20C,A03,093476,Briones; Jor-el Thomas Caparas,0,1,36,36
1656843097632,MATH 20C,B01,083762,Bach; Quang Tran,0,0,30,30
1656843103664,MATH 20D,A01,083765,Tran; Brian Kha,4,0,30,26
1656843103664,MATH 20D,A02,083766,Tran; Brian Kha,4,0,30,26
1656843103664,MATH 20D,A03,083767,Tran; Brian Kha,2,0,30,28
1656843109689,MATH 20E,A01,083771,Ganguly; Soumya,5,0,32,27
1656843109689,MATH 20E,A02,083772,Ganguly; Soumya,6,0,32,26
1656843109689,MATH 20E,B01,083773,Ciotti; Benjamin,18,0,35,17
1656843109689,MATH 20E,B02,083774,Ciotti; Benjamin,17,0,35,18
1656843115713,MATH 103A,A01,083777,Greenfeld; Be'Eri,2,0,36,34
1656843115713,MATH 103A,A02,083778,Greenfeld; Be'Eri,5,0,36,31
1656843115713,MATH 103A,A03,093561,Greenfeld; Be'Eri,4,0,36,32
1656843115713,MATH 103A,B01,083779,Greenfeld; Be'Eri,6,0,36,30
1656843115713,MATH 103A,B02,083780,Greenfeld; Be'Eri,2,0,36,34
1656843115713,MATH 103A,B03,093562,Greenfeld; Be'Eri,2,0,36,34
1656843121742,MATH 105,A01,085443,Carter; Anne Toulson,13,0,35,22
1656843121742,MATH 105,A02,093477,Carter; Anne Toulson,20,0,35,15
1656843127764,MATH 109,A01,083213,Ganzberger; Geoffrey Michael,2,0,34,32
1656843127764,MATH 109,A02,083214,Ganzberger; Geoffrey Michael,2,0,34,32
1656843127764,MATH 109,A03,093478,Ganzberger; Geoffrey Michael,1,0,34,33
1656843127764,MATH 109,B01,083215,Ganzberger; Geoffrey Michael,1,0,32,31
1656843127764,MATH 109,B02,083216,Ganzberger; Geoffrey Michael,1,0,32,31
1656843127764,MATH 109,B03,093479,Ganzberger; Geoffrey Michael,6,0,32,26
1656843133791,MATH 142A,A01,083219,Chow; Bennett,6,0,32,26
1656843133791,MATH 142A,A02,083220,Chow; Bennett,9,0,32,23
1656843133791,MATH 142A,A03,093480,Chow; Bennett,7,0,32,25
1656843133791,MATH 142A,B03,093481,Chow; Bennett,7,0,32,25
1656843133791,MATH 142A,B04,093558,Chow; Bennett,10,0,32,22
1656843133791,MATH 142A,B05,093559,Chow; Bennett,6,0,32,26
1656843139816,MATH 193A,A01,083224,Rotar; Vladimir,6,0,34,28
1656843139816,MATH 193A,A02,083225,Rotar; Vladimir,3,0,34,31
1656843139816,MATH 193A,A03,083781,Rotar; Vladimir,1,0,34,33
1656843139816,MATH 193A,A04,083782,Rotar; Vladimir,6,0,34,28
1656843139816,MATH 193A,A05,093482,Rotar; Vladimir,6,0,34,28
1656843145846,MATH 197,001,091859,McAuley; Julian John,9999,0,9999,0
1656843145846,MATH 197,002,095566,Kedlaya; Kiran S.,9997,0,9999,2
1656843145846,MATH 197,003,095567,Xiao; Ming,9999,0,9999,0
1656843145846,MATH 197,004,095571,Perols; Johan Lars,9998,0,9999,1
1656843152906,COGS 9,A01,083615,Shannon; Kyle Michael,6,0,75,69
1656843158936,COGS 11,A01,083617,Boyle; Mary E. T.,18,0,48,30
1656843164961,COGS 13,A01,083071,Bastos; Amalia Pinkusfeld,8,0,71,63
1656843170985,COGS 14A,A01,092681,Semenuks; Arturs,0,1,100,100
1656843177010,COGS 14B,A01,083073,Cheng; Tzu-Han,5,0,63,58
1656843183037,COGS 17,A01,092677,Semenuks; Arturs,4,0,81,77
1656843189060,COGS 100,A01,083619,Allen; Michael Gordon,15,0,70,55
1656843195091,COGS 101A,A01,083621,Davis; Joshua Daniel,9,0,68,59
1656843201117,COGS 101B,A01,091572,Allen; Michael Gordon,8,0,65,57
1656843207152,COGS 101C,A01,083625,Delgado; Tania,17,0,35,18
1656843213178,COGS 107A,A01,083627,Boyle; Mary E. T.,13,0,60,47
1656843219205,COGS 118A,A01,083075,Gupta; Anjum,15,0,76,61
1656843225230,CSE 3,A50,083646,Miranda; Gregory Joseph,22,0,50,28
1656843231253,CSE 8A,A50,083650,Miranda; Gregory Joseph,17,1,56,39
1656843237278,CSE 11,A01,083080,Cao; Yingjun,4,15,40,36
1656843243303,CSE 12,A01,083652,Krause-Levy; Sophia Louisa,20,1,120,100
1656843249326,CSE 15L,A01,083654,Morris; Justin Loren,8,0,50,42
1656843249326,CSE 15L,A02,083655,Morris; Justin Loren,8,0,50,42
1656843255350,CSE 20,A01,083657,Tran; Khoa Dang,37,0,80,43
1656843261376,CSE 21,A01,095574,Bach; Quang Tran,21,0,48,27
1656843267401,CSE 30,A01,083084,Eldon; John,4,0,80,76
1656843267401,CSE 30,B01,095061,Bhaskar; Nishant,6,0,50,44
1656843273425,CSE 100,A01,083659,Cao; Yingjun,2,4,70,68
1656843279448,CSE 134B,A01,083661,Powell; Thomas Allan,19,0,100,81
1656843285473,CSE 140,A01,083663,Gungor; Onat,14,0,85,71
1656843291496,CSE 140L,A01,083088,Eldon; John,16,0,100,84
1656843297521,CSE 175,A01,083665,Kumar; Rakesh,3,0,25,22
1656843303544,CSE 190,A00,092507,Dubnov; Shlomo,7,0,20,13
1656843309574,ECE 45,A01,083139,Congero; Spencer William,5,0,75,70
1656843315605,ECE 65,A50,083695,Saad; Andrew S,12,0,30,18
1656843315605,ECE 65,A51,095125,Saad; Andrew S,25,0,26,1
1656843321632,ECE 109,A01,091882,Touri; Behrouz,16,0,70,54
1656843327662,ECE 180,A00,083140,Abi Samra; Nicholas Camill,0,0,30,30
1656843327662,ECE 180,B00,083141,Abi Samra; Nicholas Camill,0,0,30,30
1656843333686,MATH 10A,A01,083735,Patchell; Gregory David,1,0,30,29
1656843333686,MATH 10A,A02,083736,Patchell; Gregory David,20,0,30,10
1656843333686,MATH 10A,A03,083737,Patchell; Gregory David,15,0,30,15
1656843339716,MATH 10B,A01,083207,Lim; Seonhee,7,0,34,27
1656843339716,MATH 10B,A02,083208,Lim; Seonhee,9,0,35,26
1656843339716,MATH 10B,A03,093472,Lim; Seonhee,4,0,34,30
1656843339716,MATH 10B,B01,083739,Sinha; Shubham,9,0,30,21
1656843345741,MATH 18,A01,083743,Cinel; Cameron Alexander,6,0,30,24
1656843345741,MATH 18,A02,083744,Cinel; Cameron Alexander,15,0,30,15
1656843345741,MATH 18,A03,083745,Cinel; Cameron Alexander,8,0,30,22
1656843345741,MATH 18,B01,083748,Rideout; David Porter,3,0,37,34
1656843345741,MATH 18,B02,083749,Rideout; David Porter,3,0,36,33
1656843345741,MATH 18,B03,083750,Rideout; David Porter,2,0,37,35
1656843345741,MATH 18,B04,083751,Rideout; David Porter,5,0,36,31
1656843345741,MATH 18,B05,093473,Rideout; David Porter,4,0,36,32
1656843345741,MATH 18,B06,093474,Rideout; David Porter,5,0,36,31
1656843351765,MATH 20A,A01,083754,Zheng; Zequn,12,0,40,28
1656843357795,MATH 20B,A01,083756,Briones; Jor-el Thomas Caparas,1,0,36,35
1656843357795,MATH 20B,A02,083757,Briones; Jor-el Thomas Caparas,1,0,36,35
1656843357795,MATH 20B,A03,093475,Briones; Jor-el Thomas Caparas,0,0,36,36
1656843363826,MATH 20C,A01,083760,Briones; Jor-el Thomas Caparas,1,0,35,34
1656843363826,MATH 20C,A02,083761,Briones; Jor-el Thomas Caparas,8,0,35,27
1656843363826,MATH 20C,A03,093476,Briones; Jor-el Thomas Caparas,0,1,36,36
1656843363826,MATH 20C,B01,083762,Bach; Quang Tran,0,0,30,30
1656843369850,MATH 20D,A01,083765,Tran; Brian Kha,4,0,30,26
1656843369850,MATH 20D,A02,083766,Tran; Brian Kha,4,0,30,26
1656843369850,MATH 20D,A03,083767,Tran; Brian Kha,2,0,30,28
1656843375881,MATH 20E,A01,083771,Ganguly; Soumya,5,0,32,27
1656843375881,MATH 20E,A02,083772,Ganguly; Soumya,6,0,32,26
1656843375881,MATH 20E,B01,083773,Ciotti; Benjamin,18,0,35,17
1656843375881,MATH 20E,B02,083774,Ciotti; Benjamin,17,0,35,18
1656843381914,MATH 103A,A01,083777,Greenfeld; Be'Eri,2,0,36,34
1656843381914,MATH 103A,A02,083778,Greenfeld; Be'Eri,5,0,36,31
1656843381914,MATH 103A,A03,093561,Greenfeld; Be'Eri,4,0,36,32
1656843381914,MATH 103A,B01,083779,Greenfeld; Be'Eri,6,0,36,30
1656843381914,MATH 103A,B02,083780,Greenfeld; Be'Eri,2,0,36,34
1656843381914,MATH 103A,B03,093562,Greenfeld; Be'Eri,2,0,36,34
1656843387939,MATH 105,A01,085443,Carter; Anne Toulson,13,0,35,22
1656843387939,MATH 105,A02,093477,Carter; Anne Toulson,20,0,35,15
1656843393968,MATH 109,A01,083213,Ganzberger; Geoffrey Michael,2,0,34,32
1656843393968,MATH 109,A02,083214,Ganzberger; Geoffrey Michael,2,0,34,32
1656843393968,MATH 109,A03,093478,Ganzberger; Geoffrey Michael,1,0,34,33
1656843393968,MATH 109,B01,083215,Ganzberger; Geoffrey Michael,1,0,32,31
1656843393968,MATH 109,B02,083216,Ganzberger; Geoffrey Michael,1,0,32,31
1656843393968,MATH 109,B03,093479,Ganzberger; Geoffrey Michael,6,0,32,26
1656843400000,MATH 142A,A01,083219,Chow; Bennett,6,0,32,26
1656843400000,MATH 142A,A02,083220,Chow; Bennett,9,0,32,23
1656843400000,MATH 142A,A03,093480,Chow; Bennett,7,0,32,25
1656843400000,MATH 142A,B03,093481,Chow; Bennett,7,0,32,25
1656843400000,MATH 142A,B04,093558,Chow; Bennett,10,0,32,22
1656843400000,MATH 142A,B05,093559,Chow; Bennett,6,0,32,26
1656843406028,MATH 193A,A01,083224,Rotar; Vladimir,6,0,34,28
1656843406028,MATH 193A,A02,083225,Rotar; Vladimir,3,0,34,31
1656843406028,MATH 193A,A03,083781,Rotar; Vladimir,1,0,34,33
1656843406028,MATH 193A,A04,083782,Rotar; Vladimir,6,0,34,28
1656843406028,MATH 193A,A05,093482,Rotar; Vladimir,6,0,34,28
1656843412057,MATH 197,001,091859,McAuley; Julian John,9999,0,9999,0
1656843412057,MATH 197,002,095566,Kedlaya; Kiran S.,9997,0,9999,2
1656843412057,MATH 197,003,095567,Xiao; Ming,9999,0,9999,0
1656843412057,MATH 197,004,095571,Perols; Johan Lars,9998,0,9999,1
1656843419116,COGS 9,A01,083615,Shannon; Kyle Michael,6,0,75,69
1656843425143,COGS 11,A01,083617,Boyle; Mary E. T.,18,0,48,30
1656843431172,COGS 13,A01,083071,Bastos; Amalia Pinkusfeld,8,0,71,63
1656843437199,COGS 14A,A01,092681,Semenuks; Arturs,0,1,100,100
1656843443224,COGS 14B,A01,083073,Cheng; Tzu-Han,5,0,63,58
1656843449246,COGS 17,A01,092677,Semenuks; Arturs,4,0,81,77
1656843455268,COGS 100,A01,083619,Allen; Michael Gordon,15,0,70,55
1656843461292,COGS 101A,A01,083621,Davis; Joshua Daniel,9,0,68,59
1656843467316,COGS 101B,A01,091572,Allen; Michael Gordon,8,0,65,57
1656843473340,COGS 101C,A01,083625,Delgado; Tania,17,0,35,18
1656843479367,COGS 107A,A01,083627,Boyle; Mary E. T.,13,0,60,47
1656843485391,COGS 118A,A01,083075,Gupta; Anjum,15,0,76,61
1656843491416,CSE 3,A50,083646,Miranda; Gregory Joseph,22,0,50,28
1656843497441,CSE 8A,A50,083650,Miranda; Gregory Joseph,17,1,56,39
1656843503466,CSE 11,A01,083080,Cao; Yingjun,4,15,40,36
1656843509489,CSE 12,A01,083652,Krause-Levy; Sophia Louisa,20,1,120,100
1656843515513,CSE 15L,A01,083654,Morris; Justin Loren,8,0,50,42
1656843515513,CSE 15L,A02,083655,Morris; Justin Loren,8,0,50,42
1656843521536,CSE 20,A01,083657,Tran; Khoa Dang,37,0,80,43
1656843527560,CSE 21,A01,095574,Bach; Quang Tran,21,0,48,27
1656843533584,CSE 30,A01,083084,Eldon; John,4,0,80,76
1656843533584,CSE 30,B01,095061,Bhaskar; Nishant,6,0,50,44
1656843539611,CSE 100,A01,083659,Cao; Yingjun,2,4,70,68
1656843545633,CSE 134B,A01,083661,Powell; Thomas Allan,19,0,100,81
1656843551656,CSE 140,A01,083663,Gungor; Onat,14,0,85,71
1656843557684,CSE 140L,A01,083088,Eldon; John,16,0,100,84
1656843563708,CSE 175,A01,083665,Kumar; Rakesh,3,0,25,22
1656843569731,CSE 190,A00,092507,Dubnov; Shlomo,7,0,20,13
1656843575759,ECE 45,A01,083139,Congero; Spencer William,5,0,75,70
1656843581783,ECE 65,A50,083695,Saad; Andrew S,12,0,30,18
1656843581783,ECE 65,A51,095125,Saad; Andrew S,25,0,26,1
1656843587810,ECE 109,A01,091882,Touri; Behrouz,16,0,70,54
1656843593926,ECE 180,A00,083140,Abi Samra; Nicholas Camill,0,0,30,30
1656843593926,ECE 180,B00,083141,Abi Samra; Nicholas Camill,0,0,30,30
1656843599950,MATH 10A,A01,083735,Patchell; Gregory David,1,0,30,29
1656843599950,MATH 10A,A02,083736,Patchell; Gregory David,20,0,30,10
1656843599950,MATH 10A,A03,083737,Patchell; Gregory David,15,0,30,15
1656843605975,MATH 10B,A01,083207,Lim; Seonhee,7,0,34,27
1656843605975,MATH 10B,A02,083208,Lim; Seonhee,9,0,35,26
1656843605975,MATH 10B,A03,093472,Lim; Seonhee,4,0,34,30
1656843605975,MATH 10B,B01,083739,Sinha; Shubham,9,0,30,21
1656843612002,MATH 18,A01,083743,Cinel; Cameron Alexander,6,0,30,24
1656843612002,MATH 18,A02,083744,Cinel; Cameron Alexander,15,0,30,15
1656843612002,MATH 18,A03,083745,Cinel; Cameron Alexander,8,0,30,22
1656843612002,MATH 18,B01,083748,Rideout; David Porter,3,0,37,34
1656843612002,MATH 18,B02,083749,Rideout; David Porter,3,0,36,33
1656843612002,MATH 18,B03,083750,Rideout; David Porter,2,0,37,35
1656843612002,MATH 18,B04,083751,Rideout; David Porter,5,0,36,31
1656843612002,MATH 18,B05,093473,Rideout; David Porter,4,0,36,32
1656843612002,MATH 18,B06,093474,Rideout; David Porter,5,0,36,31
1656843618025,MATH 20A,A01,083754,Zheng; Zequn,12,0,40,28
1656843624095,MATH 20B,A01,083756,Briones; Jor-el Thomas Caparas,1,0,36,35
1656843624095,MATH 20B,A02,083757,Briones; Jor-el Thomas Caparas,1,0,36,35
1656843624095,MATH 20B,A03,093475,Briones; Jor-el Thomas Caparas,0,0,36,36
1656843630119,MATH 20C,A01,083760,Briones; Jor-el Thomas Caparas,1,0,35,34
1656843630119,MATH 20C,A02,083761,Briones; Jor-el Thomas Caparas,8,0,35,27
1656843630119,MATH 20C,A03,093476,Briones; Jor-el Thomas Caparas,0,1,36,36
1656843630119,MATH 20C,B01,083762,Bach; Quang Tran,0,0,30,30
1656843636145,MATH 20D,A01,083765,Tran; Brian Kha,4,0,30,26
1656843636145,MATH 20D,A02,083766,Tran; Brian Kha,4,0,30,26
1656843636145,MATH 20D,A03,083767,Tran; Brian Kha,2,0,30,28
1656843642177,MATH 20E,A01,083771,Ganguly; Soumya,5,0,32,27
1656843642177,MATH 20E,A02,083772,Ganguly; Soumya,6,0,32,26
1656843642177,MATH 20E,B01,083773,Ciotti; Benjamin,18,0,35,17
1656843642177,MATH 20E,B02,083774,Ciotti; Benjamin,17,0,35,18
1656843648208,MATH 103A,A01,083777,Greenfeld; Be'Eri,2,0,36,34
1656843648208,MATH 103A,A02,083778,Greenfeld; Be'Eri,5,0,36,31
1656843648208,MATH 103A,A03,093561,Greenfeld; Be'Eri,4,0,36,32
1656843648208,MATH 103A,B01,083779,Greenfeld; Be'Eri,6,0,36,30
1656843648208,MATH 103A,B02,083780,Greenfeld; Be'Eri,2,0,36,34
1656843648208,MATH 103A,B03,093562,Greenfeld; Be'Eri,2,0,36,34
1656843654235,MATH 105,A01,085443,Carter; Anne Toulson,13,0,35,22
1656843654235,MATH 105,A02,093477,Carter; Anne Toulson,20,0,35,15
1656843660267,MATH 109,A01,083213,Ganzberger; Geoffrey Michael,2,0,34,32
1656843660267,MATH 109,A02,083214,Ganzberger; Geoffrey Michael,2,0,34,32
1656843660267,MATH 109,A03,093478,Ganzberger; Geoffrey Michael,1,0,34,33
1656843660267,MATH 109,B01,083215,Ganzberger; Geoffrey Michael,1,0,32,31
1656843660267,MATH 109,B02,083216,Ganzberger; Geoffrey Michael,1,0,32,31
1656843660267,MATH 109,B03,093479,Ganzberger; Geoffrey Michael,6,0,32,26
1656843666292,MATH 142A,A01,083219,Chow; Bennett,6,0,32,26
1656843666292,MATH 142A,A02,083220,Chow; Bennett,9,0,32,23
1656843666292,MATH 142A,A03,093480,Chow; Bennett,7,0,32,25
1656843666292,MATH 142A,B03,093481,Chow; Bennett,7,0,32,25
1656843666292,MATH 142A,B04,093558,Chow; Bennett,10,0,32,22
1656843666292,MATH 142A,B05,093559,Chow; Bennett,6,0,32,26
1656843672321,MATH 193A,A01,083224,Rotar; Vladimir,6,0,34,28
1656843672321,MATH 193A,A02,083225,Rotar; Vladimir,3,0,34,31
1656843672321,MATH 193A,A03,083781,Rotar; Vladimir,1,0,34,33
1656843672321,MATH 193A,A04,083782,Rotar; Vladimir,6,0,34,28
1656843672321,MATH 193A,A05,093482,Rotar; Vladimir,6,0,34,28
1656843678350,MATH 197,001,091859,McAuley; Julian John,9999,0,9999,0
1656843678350,MATH 197,002,095566,Kedlaya; Kiran S.,9997,0,9999,2
1656843678350,MATH 197,003,095567,Xiao; Ming,9999,0,9999,0
1656843678350,MATH 197,004,095571,Perols; Johan Lars,9998,0,9999,1
1656843685416,COGS 9,A01,083615,Shannon; Kyle Michael,6,0,75,69
1656843691444,COGS 11,A01,083617,Boyle; Mary E. T.,18,0,48,30
1656843697468,COGS 13,A01,083071,Bastos; Amalia Pinkusfeld,8,0,71,63
1656843703491,COGS 14A,A01,092681,Semenuks; Arturs,0,1,100,100
1656843709519,COGS 14B,A01,083073,Cheng; Tzu-Han,5,0,63,58
1656843715550,COGS 17,A01,092677,Semenuks; Arturs,4,0,81,77
1656843721574,COGS 100,A01,083619,Allen; Michael Gordon,15,0,70,55
1656843727599,COGS 101A,A01,083621,Davis; Joshua Daniel,9,0,68,59
1656843733625,COGS 101B,A01,091572,Allen; Michael Gordon,8,0,65,57
1656843739651,COGS 101C,A01,083625,Delgado; Tania,17,0,35,18
1656843745673,COGS 107A,A01,083627,Boyle; Mary E. T.,13,0,60,47
1656843751695,COGS 118A,A01,083075,Gupta; Anjum,15,0,76,61
1656843757718,CSE 3,A50,083646,Miranda; Gregory Joseph,22,0,50,28
1656843763741,CSE 8A,A50,083650,Miranda; Gregory Joseph,17,1,56,39
1656843769763,CSE 11,A01,083080,Cao; Yingjun,4,15,40,36
1656843775788,CSE 12,A01,083652,Krause-Levy; Sophia Louisa,20,1,120,100
1656843781812,CSE 15L,A01,083654,Morris; Justin Loren,8,0,50,42
1656843781812,CSE 15L,A02,083655,Morris; Justin Loren,8,0,50,42
1656843787835,CSE 20,A01,083657,Tran; Khoa Dang,37,0,80,43
1656843793861,CSE 21,A01,095574,Bach; Quang Tran,21,0,48,27
1656843799891,CSE 30,A01,083084,Eldon; John,4,0,80,76
1656843799891,CSE 30,B01,095061,Bhaskar; Nishant,6,0,50,44
1656843805915,CSE 100,A01,083659,Cao; Yingjun,2,4,70,68
1656843811943,CSE 134B,A01,083661,Powell; Thomas Allan,19,0,100,81
1656843817971,CSE 140,A01,083663,Gungor; Onat,14,0,85,71
1656843823997,CSE 140L,A01,083088,Eldon; John,16,0,100,84
1656843830024,CSE 175,A01,083665,Kumar; Rakesh,3,0,25,22
1656843836052,CSE 190,A00,092507,Dubnov; Shlomo,7,0,20,13
1656843842089,ECE 45,A01,083139,Congero; Spencer William,5,0,75,70
1656843848116,ECE 65,A50,083695,Saad; Andrew S,12,0,30,18
1656843848116,ECE 65,A51,095125,Saad; Andrew S,25,0,26,1
1656843854140,ECE 109,A01,091882,Touri; Behrouz,16,0,70,54
1656843860165,ECE 180,A00,083140,Abi Samra; Nicholas Camill,0,0,30,30
1656843860165,ECE 180,B00,083141,Abi Samra; Nicholas Camill,0,0,30,30
1656843866202,MATH 10A,A01,083735,Patchell; Gregory David,1,0,30,29
1656843866202,MATH 10A,A02,083736,Patchell; Gregory David,20,0,30,10
1656843866202,MATH 10A,A03,083737,Patchell; Gregory David,15,0,30,15
1656843872243,MATH 10B,A01,083207,Lim; Seonhee,7,0,34,27
1656843872243,MATH 10B,A02,083208,Lim; Seonhee,9,0,35,26
1656843872243,MATH 10B,A03,093472,Lim; Seonhee,4,0,34,30
1656843872243,MATH 10B,B01,083739,Sinha; Shubham,9,0,30,21
1656843878286,MATH 18,A01,083743,Cinel; Cameron Alexander,6,0,30,24
1656843878286,MATH 18,A02,083744,Cinel; Cameron Alexander,15,0,30,15
1656843878286,MATH 18,A03,083745,Cinel; Cameron Alexander,8,0,30,22
1656843878286,MATH 18,B01,083748,Rideout; David Porter,3,0,37,34
1656843878286,MATH 18,B02,083749,Rideout; David Porter,3,0,36,33
1656843878286,MATH 18,B03,083750,Rideout; David Porter,2,0,37,35
1656843878286,MATH 18,B04,083751,Rideout; David Porter,5,0,36,31
1656843878286,MATH 18,B05,093473,Rideout; David Porter,4,0,36,32
1656843878286,MATH 18,B06,093474,Rideout; David Porter,5,0,36,31
1656843884311,MATH 20A,A01,083754,Zheng; Zequn,12,0,40,28
1656843890338,MATH 20B,A01,083756,Briones; Jor-el Thomas Caparas,1,0,36,35
1656843890338,MATH 20B,A02,083757,Briones; Jor-el Thomas Caparas,1,0,36,35
1656843890338,MATH 20B,A03,093475,Briones; Jor-el Thomas Caparas,0,0,36,36
1656843896372,MATH 20C,A01,083760,Briones; Jor-el Thomas Caparas,1,0,35,34
1656843896372,MATH 20C,A02,083761,Briones; Jor-el Thomas Caparas,8,0,35,27
1656843896372,MATH 20C,A03,093476,Briones; Jor-el Thomas Caparas,0,1,36,36
1656843896372,MATH 20C,B01,083762,Bach; Quang Tran,0,0,30,30
1656843902397,MATH 20D,A01,083765,Tran; Brian Kha,4,0,30,26
1656843902397,MATH 20D,A02,083766,Tran; Brian Kha,4,0,30,26
1656843902397,MATH 20D,A03,083767,Tran; Brian Kha,2,0,30,28
1656843908424,MATH 20E,A01,083771,Ganguly; Soumya,5,0,32,27
1656843908424,MATH 20E,A02,083772,Ganguly; Soumya,6,0,32,26
1656843908424,MATH 20E,B01,083773,Ciotti; Benjamin,18,0,35,17
1656843908424,MATH 20E,B02,083774,Ciotti; Benjamin,17,0,35,18
1656843914463,MATH 103A,A01,083777,Greenfeld; Be'Eri,2,0,36,34
1656843914463,MATH 103A,A02,083778,Greenfeld; Be'Eri,5,0,36,31
1656843914463,MATH 103A,A03,093561,Greenfeld; Be'Eri,4,0,36,32
1656843914463,MATH 103A,B01,083779,Greenfeld; Be'Eri,6,0,36,30
1656843914463,MATH 103A,B02,083780,Greenfeld; Be'Eri,2,0,36,34
1656843914463,MATH 103A,B03,093562,Greenfeld; Be'Eri,2,0,36,34
1656843920495,MATH 105,A01,085443,Carter; Anne Toulson,13,0,35,22
1656843920495,MATH 105,A02,093477,Carter; Anne Toulson,20,0,35,15
1656843926526,MATH 109,A01,083213,Ganzberger; Geoffrey Michael,2,0,34,32
1656843926526,MATH 109,A02,083214,Ganzberger; Geoffrey Michael,2,0,34,32
1656843926526,MATH 109,A03,093478,Ganzberger; Geoffrey Michael,1,0,34,33
1656843926526,MATH 109,B01,083215,Ganzberger; Geoffrey Michael,1,0,32,31
1656843926526,MATH 109,B02,083216,Ganzberger; Geoffrey Michael,1,0,32,31
1656843926526,MATH 109,B03,093479,Ganzberger; Geoffrey Michael,6,0,32,26
1656843932553,MATH 142A,A01,083219,Chow; Bennett,6,0,32,26
1656843932553,MATH 142A,A02,083220,Chow; Bennett,9,0,32,23
1656843932553,MATH 142A,A03,093480,Chow; Bennett,7,0,32,25
1656843932553,MATH 142A,B03,093481,Chow; Bennett,7,0,32,25
1656843932553,MATH 142A,B04,093558,Chow; Bennett,10,0,32,22
1656843932553,MATH 142A,B05,093559,Chow; Bennett,6,0,32,26
1656843938584,MATH 193A,A01,083224,Rotar; Vladimir,6,0,34,28
1656843938584,MATH 193A,A02,083225,Rotar; Vladimir,3,0,34,31
1656843938584,MATH 193A,A03,083781,Rotar; Vladimir,1,0,34,33
1656843938584,MATH 193A,A04,083782,Rotar; Vladimir,6,0,34,28
1656843938584,MATH 193A,A05,093482,Rotar; Vladimir,6,0,34,28
1656843944610,MATH 197,001,091859,McAuley; Julian John,9999,0,9999,0
1656843944610,MATH 197,002,095566,Kedlaya; Kiran S.,9997,0,9999,2
1656843944610,MATH 197,003,095567,Xiao; Ming,9999,0,9999,0
1656843944610,MATH 197,004,095571,Perols; Johan Lars,9998,0,9999,1
1656843951693,COGS 9,A01,083615,Shannon; Kyle Michael,6,0,75,69
1656843957722,COGS 11,A01,083617,Boyle; Mary E. T.,18,0,48,30
1656843963748,COGS 13,A01,083071,Bastos; Amalia Pinkusfeld,8,0,71,63
1656843969773,COGS 14A,A01,092681,Semenuks; Arturs,0,1,100,100
1656843975810,COGS 14B,A01,083073,Cheng; Tzu-Han,5,0,63,58
1656843981838,COGS 17,A01,092677,Semenuks; Arturs,4,0,81,77
1656843987863,COGS 100,A01,083619,Allen; Michael Gordon,15,0,70,55
1656843993893,COGS 101A,A01,083621,Davis; Joshua Daniel,9,0,68,59
1656843999922,COGS 101B,A01,091572,Allen; Michael Gordon,8,0,65,57
1656844005950,COGS 101C,A01,083625,Delgado; Tania,17,0,35,18
1656844011973,COGS 107A,A01,083627,Boyle; Mary E. T.,13,0,60,47
1656844017997,COGS 118A,A01,083075,Gupta; Anjum,15,0,76,61
1656844024024,CSE 3,A50,083646,Miranda; Gregory Joseph,22,0,50,28
1656844030052,CSE 8A,A50,083650,Miranda; Gregory Joseph,17,1,56,39
1656844036075,CSE 11,A01,083080,Cao; Yingjun,4,15,40,36
1656844042100,CSE 12,A01,083652,Krause-Levy; Sophia Louisa,20,1,120,100
1656844048123,CSE 15L,A01,083654,Morris; Justin Loren,8,0,50,42
1656844048123,CSE 15L,A02,083655,Morris; Justin Loren,8,0,50,42
1656844054146,CSE 20,A01,083657,Tran; Khoa Dang,37,0,80,43
1656844060171,CSE 21,A01,095574,Bach; Quang Tran,21,0,48,27
1656844066199,CSE 30,A01,083084,Eldon; John,4,0,80,76
1656844066199,CSE 30,B01,095061,Bhaskar; Nishant,6,0,50,44
1656844072246,CSE 100,A01,083659,Cao; Yingjun,2,4,70,68
1656844078270,CSE 134B,A01,083661,Powell; Thomas Allan,19,0,100,81
1656844084301,CSE 140,A01,083663,Gungor; Onat,14,0,85,71
1656844090333,CSE 140L,A01,083088,Eldon; John,16,0,100,84
1656844096357,CSE 175,A01,083665,Kumar; Rakesh,3,0,25,22
1656844102381,CSE 190,A00,092507,Dubnov; Shlomo,7,0,20,13
1656844108406,ECE 45,A01,083139,Congero; Spencer William,5,0,75,70
1656844114438,ECE 65,A50,083695,Saad; Andrew S,12,0,30,18
1656844114438,ECE 65,A51,095125,Saad; Andrew S,25,0,26,1
1656844120469,ECE 109,A01,091882,Touri; Behrouz,16,0,70,54
1656844126495,ECE 180,A00,083140,Abi Samra; Nicholas Camill,0,0,30,30
1656844126495,ECE 180,B00,083141,Abi Samra; Nicholas Camill,0,0,30,30
1656844132521,MATH 10A,A01,083735,Patchell; Gregory David,1,0,30,29
1656844132521,MATH 10A,A02,083736,Patchell; Gregory David,20,0,30,10
1656844132521,MATH 10A,A03,083737,Patchell; Gregory David,15,0,30,15
1656844138555,MATH 10B,A01,083207,Lim; Seonhee,7,0,34,27
1656844138555,MATH 10B,A02,083208,Lim; Seonhee,9,0,35,26
1656844138555,MATH 10B,A03,093472,Lim; Seonhee,4,0,34,30
1656844138555,MATH 10B,B01,083739,Sinha; Shubham,9,0,30,21
1656844144586,MATH 18,A01,083743,Cinel; Cameron Alexander,6,0,30,24
1656844144586,MATH 18,A02,083744,Cinel; Cameron Alexander,15,0,30,15
1656844144586,MATH 18,A03,083745,Cinel; Cameron Alexander,8,0,30,22
1656844144586,MATH 18,B01,083748,Rideout; David Porter,3,0,37,34
1656844144586,MATH 18,B02,083749,Rideout; David Porter,3,0,36,33
1656844144586,MATH 18,B03,083750,Rideout; David Porter,2,0,37,35
1656844144586,MATH 18,B04,083751,Rideout; David Porter,5,0,36,31
1656844144586,MATH 18,B05,093473,Rideout; David Porter,4,0,36,32
1656844144586,MATH 18,B06,093474,Rideout; David Porter,5,0,36,31
1656844150612,MATH 20A,A01,083754,Zheng; Zequn,12,0,40,28
1656844156644,MATH 20B,A01,083756,Briones; Jor-el Thomas Caparas,1,0,36,35
1656844156644,MATH 20B,A02,083757,Briones; Jor-el Thomas Caparas,1,0,36,35
1656844156644,MATH 20B,A03,093475,Briones; Jor-el Thomas Caparas,0,0,36,36
1656844162681,MATH 20C,A01,083760,Briones; Jor-el Thomas Caparas,1,0,35,34
1656844162681,MATH 20C,A02,083761,Briones; Jor-el Thomas Caparas,8,0,35,27
1656844162681,MATH 20C,A03,093476,Briones; Jor-el Thomas Caparas,0,1,36,36
1656844162681,MATH 20C,B01,083762,Bach; Quang Tran,0,0,30,30
1656844168709,MATH 20D,A01,083765,Tran; Brian Kha,4,0,30,26
1656844168709,MATH 20D,A02,083766,Tran; Brian Kha,4,0,30,26
1656844168709,MATH 20D,A03,083767,Tran; Brian Kha,2,0,30,28
1656844174752,MATH 20E,A01,083771,Ganguly; Soumya,5,0,32,27
1656844174752,MATH 20E,A02,083772,Ganguly; Soumya,6,0,32,26
1656844174752,MATH 20E,B01,083773,Ciotti; Benjamin,18,0,35,17
1656844174752,MATH 20E,B02,083774,Ciotti; Benjamin,17,0,35,18
1656844180776,MATH 103A,A01,083777,Greenfeld; Be'Eri,2,0,36,34
1656844180776,MATH 103A,A02,083778,Greenfeld; Be'Eri,5,0,36,31
1656844180776,MATH 103A,A03,093561,Greenfeld; Be'Eri,4,0,36,32
1656844180776,MATH 103A,B01,083779,Greenfeld; Be'Eri,6,0,36,30
1656844180776,MATH 103A,B02,083780,Greenfeld; Be'Eri,2,0,36,34
1656844180776,MATH 103A,B03,093562,Greenfeld; Be'Eri,2,0,36,34
1656844186800,MATH 105,A01,085443,Carter; Anne Toulson,13,0,35,22
1656844186800,MATH 105,A02,093477,Carter; Anne Toulson,20,0,35,15
1656844192906,MATH 109,A01,083213,Ganzberger; Geoffrey Michael,2,0,34,32
1656844192906,MATH 109,A02,083214,Ganzberger; Geoffrey Michael,2,0,34,32
1656844192906,MATH 109,A03,093478,Ganzberger; Geoffrey Michael,1,0,34,33
1656844192906,MATH 109,B01,083215,Ganzberger; Geoffrey Michael,1,0,32,31
1656844192906,MATH 109,B02,083216,Ganzberger; Geoffrey Michael,1,0,32,31
1656844192906,MATH 109,B03,093479,Ganzberger; Geoffrey Michael,6,0,32,26
1656844198935,MATH 142A,A01,083219,Chow; Bennett,6,0,32,26
1656844198935,MATH 142A,A02,083220,Chow; Bennett,9,0,32,23
1656844198935,MATH 142A,A03,093480,Chow; Bennett,7,0,32,25
1656844198935,MATH 142A,B03,093481,Chow; Bennett,7,0,32,25
1656844198935,MATH 142A,B04,093558,Chow; Bennett,10,0,32,22
1656844198935,MATH 142A,B05,093559,Chow; Bennett,6,0,32,26
1656844204962,MATH 193A,A01,083224,Rotar; Vladimir,6,0,34,28
1656844204962,MATH 193A,A02,083225,Rotar; Vladimir,3,0,34,31
1656844204962,MATH 193A,A03,083781,Rotar; Vladimir,1,0,34,33
1656844204962,MATH 193A,A04,083782,Rotar; Vladimir,6,0,34,28
1656844204962,MATH 193A,A05,093482,Rotar; Vladimir,6,0,34,28
1656844210987,MATH 197,001,091859,McAuley; Julian John,9999,0,9999,0
1656844210987,MATH 197,002,095566,Kedlaya; Kiran S.,9997,0,9999,2
1656844210987,MATH 197,003,095567,Xiao; Ming,9999,0,9999,0
1656844210987,MATH 197,004,095571,Perols; Johan Lars,9998,0,9999,1
1656844218054,COGS 9,A01,083615,Shannon; Kyle Michael,6,0,75,69
1656844224078,COGS 11,A01,083617,Boyle; Mary E. T.,18,0,48,30
1656844230102,COGS 13,A01,083071,Bastos; Amalia Pinkusfeld,8,0,71,63
1656844236126,COGS 14A,A01,092681,Semenuks; Arturs,0,1,100,100
1656844242148,COGS 14B,A01,083073,Cheng; Tzu-Han,5,0,63,58
1656844248175,COGS 17,A01,092677,Semenuks; Arturs,4,0,81,77
1656844254199,COGS 100,A01,083619,Allen; Michael Gordon,15,0,70,55
1656844260228,COGS 101A,A01,083621,Davis; Joshua Daniel,9,0,68,59
1656844266253,COGS 101B,A01,091572,Allen; Michael Gordon,8,0,65,57
1656844272283,COGS 101C,A01,083625,Delgado; Tania,17,0,35,18
1656844278306,COGS 107A,A01,083627,Boyle; Mary E. T.,13,0,60,47
1656844284338,COGS 118A,A01,083075,Gupta; Anjum,15,0,76,61
1656844290372,CSE 3,A50,083646,Miranda; Gregory Joseph,22,0,50,28
1656844296403,CSE 8A,A50,083650,Miranda; Gregory Joseph,17,1,56,39
1656844302427,CSE 11,A01,083080,Cao; Yingjun,4,15,40,36
1656844308452,CSE 12,A01,083652,Krause-Levy; Sophia Louisa,20,1,120,100
1656844314477,CSE 15L,A01,083654,Morris; Justin Loren,8,0,50,42
1656844314477,CSE 15L,A02,083655,Morris; Justin Loren,8,0,50,42
1656844320505,CSE 20,A01,083657,Tran; Khoa Dang,37,0,80,43
1656844326531,CSE 21,A01,095574,Bach; Quang Tran,21,0,48,27
1656844332564,CSE 30,A01,083084,Eldon; John,4,0,80,76
1656844332564,CSE 30,B01,095061,Bhaskar; Nishant,6,0,50,44
1656844338590,CSE 100,A01,083659,Cao; Yingjun,2,4,70,68
1656844344620,CSE 134B,A01,083661,Powell; Thomas Allan,19,0,100,81
1656844350645,CSE 140,A01,083663,Gungor; Onat,14,0,85,71
1656844356675,CSE 140L,A01,083088,Eldon; John,16,0,100,84
1656844362708,CSE 175,A01,083665,Kumar; Rakesh,3,0,25,22
1656844368733,CSE 190,A00,092507,Dubnov; Shlomo,7,0,20,13
1656844374761,ECE 45,A01,083139,Congero; Spencer William,5,0,75,70
1656844380787,ECE 65,A50,083695,Saad; Andrew S,12,0,30,18
1656844380787,ECE 65,A51,095125,Saad; Andrew S,25,0,26,1
1656844386817,ECE 109,A01,091882,Touri; Behrouz,16,0,70,54
1656844392841,ECE 180,A00,083140,Abi Samra; Nicholas Camill,0,0,30,30
1656844392841,ECE 180,B00,083141,Abi Samra; Nicholas Camill,0,0,30,30
1656844398876,MATH 10A,A01,083735,Patchell; Gregory David,1,0,30,29
1656844398876,MATH 10A,A02,083736,Patchell; Gregory David,20,0,30,10
1656844398876,MATH 10A,A03,083737,Patchell; Gregory David,15,0,30,15
1656844404916,MATH 10B,A01,083207,Lim; Seonhee,7,0,34,27
1656844404916,MATH 10B,A02,083208,Lim; Seonhee,9,0,35,26
1656844404916,MATH 10B,A03,093472,Lim; Seonhee,4,0,34,30
1656844404916,MATH 10B,B01,083739,Sinha; Shubham,9,0,30,21
1656844410956,MATH 18,A01,083743,Cinel; Cameron Alexander,6,0,30,24
1656844410956,MATH 18,A02,083744,Cinel; Cameron Alexander,15,0,30,15
1656844410956,MATH 18,A03,083745,Cinel; Cameron Alexander,8,0,30,22
1656844410956,MATH 18,B01,083748,Rideout; David Porter,3,0,37,34
1656844410956,MATH 18,B02,083749,Rideout; David Porter,3,0,36,33
1656844410956,MATH 18,B03,083750,Rideout; David Porter,2,0,37,35
1656844410956,MATH 18,B04,083751,Rideout; David Porter,5,0,36,31
1656844410956,MATH 18,B05,093473,Rideout; David Porter,4,0,36,32
1656844410956,MATH 18,B06,093474,Rideout; David Porter,5,0,36,31
1656844416985,MATH 20A,A01,083754,Zheng; Zequn,12,0,40,28
1656844423012,MATH 20B,A01,083756,Briones; Jor-el Thomas Caparas,1,0,36,35
1656844423012,MATH 20B,A02,083757,Briones; Jor-el Thomas Caparas,1,0,36,35
1656844423012,MATH 20B,A03,093475,Briones; Jor-el Thomas Caparas,0,0,36,36
1656844429036,MATH 20C,A01,083760,Briones; Jor-el Thomas Caparas,1,0,35,34
1656844429036,MATH 20C,A02,083761,Briones; Jor-el Thomas Caparas,8,0,35,27
1656844429036,MATH 20C,A03,093476,Briones; Jor-el Thomas Caparas,0,1,36,36
1656844429036,MATH 20C,B01,083762,Bach; Quang Tran,0,0,30,30
1656844435062,MATH 20D,A01,083765,Tran; Brian Kha,4,0,30,26
1656844435062,MATH 20D,A02,083766,Tran; Brian Kha,4,0,30,26
1656844435062,MATH 20D,A03,083767,Tran; Brian Kha,2,0,30,28
1656844441093,MATH 20E,A01,083771,Ganguly; Soumya,5,0,32,27
1656844441093,MATH 20E,A02,083772,Ganguly; Soumya,6,0,32,26
1656844441093,MATH 20E,B01,083773,Ciotti; Benjamin,18,0,35,17
1656844441093,MATH 20E,B02,083774,Ciotti; Benjamin,17,0,35,18
1656844447132,MATH 103A,A01,083777,Greenfeld; Be'Eri,2,0,36,34
1656844447132,MATH 103A,A02,083778,Greenfeld; Be'Eri,5,0,36,31
1656844447132,MATH 103A,A03,093561,Greenfeld; Be'Eri,4,0,36,32
1656844447132,MATH 103A,B01,083779,Greenfeld; Be'Eri,6,0,36,30
1656844447132,MATH 103A,B02,083780,Greenfeld; Be'Eri,2,0,36,34
1656844447132,MATH 103A,B03,093562,Greenfeld; Be'Eri,2,0,36,34
1656844453160,MATH 105,A01,085443,Carter; Anne Toulson,13,0,35,22
1656844453160,MATH 105,A02,093477,Carter; Anne Toulson,20,0,35,15
1656844459185,MATH 109,A01,083213,Ganzberger; Geoffrey Michael,2,0,34,32
1656844459185,MATH 109,A02,083214,Ganzberger; Geoffrey Michael,2,0,34,32
1656844459185,MATH 109,A03,093478,Ganzberger; Geoffrey Michael,1,0,34,33
1656844459185,MATH 109,B01,083215,Ganzberger; Geoffrey Michael,1,0,32,31
1656844459185,MATH 109,B02,083216,Ganzberger; Geoffrey Michael,1,0,32,31
1656844459185,MATH 109,B03,093479,Ganzberger; Geoffrey Michael,6,0,32,26
1656844465210,MATH 142A,A01,083219,Chow; Bennett,6,0,32,26
1656844465210,MATH 142A,A02,083220,Chow; Bennett,9,0,32,23
1656844465210,MATH 142A,A03,093480,Chow; Bennett,7,0,32,25
1656844465210,MATH 142A,B03,093481,Chow; Bennett,7,0,32,25
1656844465210,MATH 142A,B04,093558,Chow; Bennett,10,0,32,22
1656844465210,MATH 142A,B05,093559,Chow; Bennett,6,0,32,26
1656844471241,MATH 193A,A01,083224,Rotar; Vladimir,6,0,34,28
1656844471241,MATH 193A,A02,083225,Rotar; Vladimir,3,0,34,31
1656844471241,MATH 193A,A03,083781,Rotar; Vladimir,1,0,34,33
1656844471241,MATH 193A,A04,083782,Rotar; Vladimir,6,0,34,28
1656844471241,MATH 193A,A05,093482,Rotar; Vladimir,6,0,34,28
1656844477269,MATH 197,001,091859,McAuley; Julian John,9999,0,9999,0
1656844477269,MATH 197,002,095566,Kedlaya; Kiran S.,9997,0,9999,2
1656844477269,MATH 197,003,095567,Xiao; Ming,9999,0,9999,0
1656844477269,MATH 197,004,095571,Perols; Johan Lars,9998,0,9999,1
1656844484333,COGS 9,A01,083615,Shannon; Kyle Michael,6,0,75,69
1656844490358,COGS 11,A01,083617,Boyle; Mary E. T.,18,0,48,30
1656844496394,COGS 13,A01,083071,Bastos; Amalia Pinkusfeld,8,0,71,63
1656844502424,COGS 14A,A01,092681,Semenuks; Arturs,0,1,100,100
1656844508447,COGS 14B,A01,083073,Cheng; Tzu-Han,5,0,63,58
1656844514471,COGS 17,A01,092677,Semenuks; Arturs,4,0,81,77
1656844520500,COGS 100,A01,083619,Allen; Michael Gordon,15,0,70,55
1656844526528,COGS 101A,A01,083621,Davis; Joshua Daniel,9,0,68,59
1656844532553,COGS 101B,A01,091572,Allen; Michael Gordon,8,0,65,57
1656844538578,COGS 101C,A01,083625,Delgado; Tania,17,0,35,18
1656844544606,COGS 107A,A01,083627,Boyle; Mary E. T.,13,0,60,47
1656844550637,COGS 118A,A01,083075,Gupta; Anjum,15,0,76,61
1656844556668,CSE 3,A50,083646,Miranda; Gregory Joseph,22,0,50,28
1656844562693,CSE 8A,A50,083650,Miranda; Gregory Joseph,17,1,56,39
1656844568718,CSE 11,A01,083080,Cao; Yingjun,4,15,40,36
1656844574748,CSE 12,A01,083652,Krause-Levy; Sophia Louisa,20,1,120,100
1656844580778,CSE 15L,A01,083654,Morris; Justin Loren,8,0,50,42
1656844580778,CSE 15L,A02,083655,Morris; Justin Loren,8,0,50,42
1656844586803,CSE 20,A01,083657,Tran; Khoa Dang,37,0,80,43
1656844592829,CSE 21,A01,095574,Bach; Quang Tran,21,0,48,27
1656844598854,CSE 30,A01,083084,Eldon; John,4,0,80,76
1656844598854,CSE 30,B01,095061,Bhaskar; Nishant,6,0,50,44
1656844604879,CSE 100,A01,083659,Cao; Yingjun,2,4,70,68
1656844610904,CSE 134B,A01,083661,Powell; Thomas Allan,19,0,100,81
1656844616932,CSE 140,A01,083663,Gungor; Onat,14,0,85,71
1656844622958,CSE 140L,A01,083088,Eldon; John,16,0,100,84
1656844628981,CSE 175,A01,083665,Kumar; Rakesh,3,0,25,22
1656844635006,CSE 190,A00,092507,Dubnov; Shlomo,7,0,20,13
1656844641033,ECE 45,A01,083139,Congero; Spencer William,5,0,75,70
1656844647058,ECE 65,A50,083695,Saad; Andrew S,12,0,30,18
1656844647058,ECE 65,A51,095125,Saad; Andrew S,25,0,26,1
1656844653082,ECE 109,A01,091882,Touri; Behrouz,16,0,70,54
1656844659107,ECE 180,A00,083140,Abi Samra; Nicholas Camill,0,0,30,30
1656844659107,ECE 180,B00,083141,Abi Samra; Nicholas Camill,0,0,30,30
1656844665132,MATH 10A,A01,083735,Patchell; Gregory David,1,0,30,29
1656844665132,MATH 10A,A02,083736,Patchell; Gregory David,20,0,30,10
1656844665132,MATH 10A,A03,083737,Patchell; Gregory David,15,0,30,15
1656844671158,MATH 10B,A01,083207,Lim; Seonhee,7,0,34,27
1656844671158,MATH 10B,A02,083208,Lim; Seonhee,9,0,35,26
1656844671158,MATH 10B,A03,093472,Lim; Seonhee,4,0,34,30
1656844671158,MATH 10B,B01,083739,Sinha; Shubham,9,0,30,21
1656844677187,MATH 18,A01,083743,Cinel; Cameron Alexander,6,0,30,24
1656844677187,MATH 18,A02,083744,Cinel; Cameron Alexander,15,0,30,15
1656844677187,MATH 18,A03,083745,Cinel; Cameron Alexander,8,0,30,22
1656844677187,MATH 18,B01,083748,Rideout; David Porter,3,0,37,34
1656844677187,MATH 18,B02,083749,Rideout; David Porter,3,0,36,33
1656844677187,MATH 18,B03,083750,Rideout; David Porter,2,0,37,35
1656844677187,MATH 18,B04,083751,Rideout; David Porter,5,0,36,31
1656844677187,MATH 18,B05,093473,Rideout; David Porter,4,0,36,32
1656844677187,MATH 18,B06,093474,Rideout; David Porter,5,0,36,31
1656844683211,MATH 20A,A01,083754,Zheng; Zequn,12,0,40,28
1656844689237,MATH 20B,A01,083756,Briones; Jor-el Thomas Caparas,1,0,36,35
1656844689237,MATH 20B,A02,083757,Briones; Jor-el Thomas Caparas,1,0,36,35
1656844689237,MATH 20B,A03,093475,Briones; Jor-el Thomas Caparas,0,0,36,36
1656844695269,MATH 20C,A01,083760,Briones; Jor-el Thomas Caparas,1,0,35,34
1656844695269,MATH 20C,A02,083761,Briones; Jor-el Thomas Caparas,8,0,35,27
1656844695269,MATH 20C,A03,093476,Briones; Jor-el Thomas Caparas,0,1,36,36
1656844695269,MATH 20C,B01,083762,Bach; Quang Tran,0,0,30,30
1656844701300,MATH 20D,A01,083765,Tran; Brian Kha,4,0,30,26
1656844701300,MATH 20D,A02,083766,Tran; Brian Kha,4,0,30,26
1656844701300,MATH 20D,A03,083767,Tran; Brian Kha,2,0,30,28
1656844707328,MATH 20E,A01,083771,Ganguly; Soumya,5,0,32,27
1656844707328,MATH 20E,A02,083772,Ganguly; Soumya,6,0,32,26
1656844707328,MATH 20E,B01,083773,Ciotti; Benjamin,18,0,35,17
1656844707328,MATH 20E,B02,083774,Ciotti; Benjamin,17,0,35,18
1656844713356,MATH 103A,A01,083777,Greenfeld; Be'Eri,2,0,36,34
1656844713356,MATH 103A,A02,083778,Greenfeld; Be'Eri,5,0,36,31
1656844713356,MATH 103A,A03,093561,Greenfeld; Be'Eri,4,0,36,32
1656844713356,MATH 103A,B01,083779,Greenfeld; Be'Eri,6,0,36,30
1656844713356,MATH 103A,B02,083780,Greenfeld; Be'Eri,2,0,36,34
1656844713356,MATH 103A,B03,093562,Greenfeld; Be'Eri,2,0,36,34
1656844719382,MATH 105,A01,085443,Carter; Anne Toulson,13,0,35,22
1656844719382,MATH 105,A02,093477,Carter; Anne Toulson,20,0,35,15
1656844725418,MATH 109,A01,083213,Ganzberger; Geoffrey Michael,2,0,34,32
1656844725418,MATH 109,A02,083214,Ganzberger; Geoffrey Michael,2,0,34,32
1656844725418,MATH 109,A03,093478,Ganzberger; Geoffrey Michael,1,0,34,33
1656844725418,MATH 109,B01,083215,Ganzberger; Geoffrey Michael,1,0,32,31
1656844725418,MATH 109,B02,083216,Ganzberger; Geoffrey Michael,1,0,32,31
1656844725418,MATH 109,B03,093479,Ganzberger; Geoffrey Michael,6,0,32,26
1656844731445,MATH 142A,A01,083219,Chow; Bennett,6,0,32,26
1656844731445,MATH 142A,A02,083220,Chow; Bennett,9,0,32,23
1656844731445,MATH 142A,A03,093480,Chow; Bennett,7,0,32,25
1656844731445,MATH 142A,B03,093481,Chow; Bennett,7,0,32,25
1656844731445,MATH 142A,B04,093558,Chow; Bennett,10,0,32,22
1656844731445,MATH 142A,B05,093559,Chow; Bennett,6,0,32,26
1656844737476,MATH 193A,A01,083224,Rotar; Vladimir,6,0,34,28
1656844737476,MATH 193A,A02,083225,Rotar; Vladimir,3,0,34,31
1656844737476,MATH 193A,A03,083781,Rotar; Vladimir,1,0,34,33
1656844737476,MATH 193A,A04,083782,Rotar; Vladimir,6,0,34,28
1656844737476,MATH 193A,A05,093482,Rotar; Vladimir,6,0,34,28
1656844743508,MATH 197,001,091859,McAuley; Julian John,9999,0,9999,0
1656844743508,MATH 197,002,095566,Kedlaya; Kiran S.,9997,0,9999,2
1656844743508,MATH 197,003,095567,Xiao; Ming,9999,0,9999,0
1656844743508,MATH 197,004,095571,Perols; Johan Lars,9998,0,9999,1
1656844750586,COGS 9,A01,083615,Shannon; Kyle Michael,6,0,75,69
1656844756611,COGS 11,A01,083617,Boyle; Mary E. T.,18,0,48,30
1656844762649,COGS 13,A01,083071,Bastos; Amalia Pinkusfeld,8,0,71,63
1656844768673,COGS 14A,A01,092681,Semenuks; Arturs,0,1,100,100
1656844774700,COGS 14B,A01,083073,Cheng; Tzu-Han,5,0,63,58
1656844780726,COGS 17,A01,092677,Semenuks; Arturs,4,0,81,77
1656844786841,COGS 100,A01,083619,Allen; Michael Gordon,15,0,70,55
1656844792872,COGS 101A,A01,083621,Davis; Joshua Daniel,9,0,68,59
1656844798899,COGS 101B,A01,091572,Allen; Michael Gordon,8,0,65,57
1656844804924,COGS 101C,A01,083625,Delgado; Tania,17,0,35,18
1656844810949,COGS 107A,A01,083627,Boyle; Mary E. T.,13,0,60,47
1656844816973,COGS 118A,A01,083075,Gupta; Anjum,15,0,76,61
1656844822999,CSE 3,A50,083646,Miranda; Gregory Joseph,22,0,50,28
1656844829034,CSE 8A,A50,083650,Miranda; Gregory Joseph,17,1,56,39
1656844835062,CSE 11,A01,083080,Cao; Yingjun,4,15,40,36
1656844841089,CSE 12,A01,083652,Krause-Levy; Sophia Louisa,20,1,120,100
1656844847120,CSE 15L,A01,083654,Morris; Justin Loren,8,0,50,42
1656844847120,CSE 15L,A02,083655,Morris; Justin Loren,8,0,50,42
1656844853149,CSE 20,A01,083657,Tran; Khoa Dang,37,0,80,43
1656844859179,CSE 21,A01,095574,Bach; Quang Tran,21,0,48,27
1656844865207,CSE 30,A01,083084,Eldon; John,4,0,80,76
1656844865207,CSE 30,B01,095061,Bhaskar; Nishant,6,0,50,44
1656844871233,CSE 100,A01,083659,Cao; Yingjun,2,4,70,68
1656844877260,CSE 134B,A01,083661,Powell; Thomas Allan,19,0,100,81
1656844883285,CSE 140,A01,083663,Gungor; Onat,14,0,85,71
1656844889320,CSE 140L,A01,083088,Eldon; John,16,0,100,84
1656844895352,CSE 175,A01,083665,Kumar; Rakesh,3,0,25,22
1656844901378,CSE 190,A00,092507,Dubnov; Shlomo,7,0,20,13
1656844907407,ECE 45,A01,083139,Congero; Spencer William,5,0,75,70
1656844913433,ECE 65,A50,083695,Saad; Andrew S,12,0,30,18
1656844913433,ECE 65,A51,095125,Saad; Andrew S,25,0,26,1
1656844919457,ECE 109,A01,091882,Touri; Behrouz,16,0,70,54
1656844925488,ECE 180,A00,083140,Abi Samra; Nicholas Camill,0,0,30,30
1656844925488,ECE 180,B00,083141,Abi Samra; Nicholas Camill,0,0,30,30
1656844931515,MATH 10A,A01,083735,Patchell; Gregory David,1,0,30,29
1656844931515,MATH 10A,A02,083736,Patchell; Gregory David,20,0,30,10
1656844931515,MATH 10A,A03,083737,Patchell; Gregory David,15,0,30,15
1656844937548,MATH 10B,A01,083207,Lim; Seonhee,7,0,34,27
1656844937548,MATH 10B,A02,083208,Lim; Seonhee,9,0,35,26
1656844937548,MATH 10B,A03,093472,Lim; Seonhee,4,0,34,30
1656844937548,MATH 10B,B01,083739,Sinha; Shubham,9,0,30,21
1656844943590,MATH 18,A01,083743,Cinel; Cameron Alexander,6,0,30,24
1656844943590,MATH 18,A02,083744,Cinel; Cameron Alexander,15,0,30,15
1656844943590,MATH 18,A03,083745,Cinel; Cameron Alexander,8,0,30,22
1656844943590,MATH 18,B01,083748,Rideout; David Porter,3,0,37,34
1656844943590,MATH 18,B02,083749,Rideout; David Porter,3,0,36,33
1656844943590,MATH 18,B03,083750,Rideout; David Porter,2,0,37,35
1656844943590,MATH 18,B04,083751,Rideout; David Porter,5,0,36,31
1656844943590,MATH 18,B05,093473,Rideout; David Porter,4,0,36,32
1656844943590,MATH 18,B06,093474,Rideout; David Porter,5,0,36,31
1656844949615,MATH 20A,A01,083754,Zheng; Zequn,12,0,40,28
1656844955644,MATH 20B,A01,083756,Briones; Jor-el Thomas Caparas,1,0,36,35
1656844955644,MATH 20B,A02,083757,Briones; Jor-el Thomas Caparas,1,0,36,35
1656844955644,MATH 20B,A03,093475,Briones; Jor-el Thomas Caparas,0,0,36,36
1656844961669,MATH 20C,A01,083760,Briones; Jor-el Thomas Caparas,1,0,35,34
1656844961669,MATH 20C,A02,083761,Briones; Jor-el Thomas Caparas,8,0,35,27
1656844961669,MATH 20C,A03,093476,Briones; Jor-el Thomas Caparas,0,1,36,36
1656844961669,MATH 20C,B01,083762,Bach; Quang Tran,0,0,30,30
1656844967695,MATH 20D,A01,083765,Tran; Brian Kha,4,0,30,26
1656844967695,MATH 20D,A02,083766,Tran; Brian Kha,4,0,30,26
1656844967695,MATH 20D,A03,083767,Tran; Brian Kha,2,0,30,28
1656844973728,MATH 20E,A01,083771,Ganguly; Soumya,5,0,32,27
1656844973728,MATH 20E,A02,083772,Ganguly; Soumya,6,0,32,26
1656844973728,MATH 20E,B01,083773,Ciotti; Benjamin,18,0,35,17
1656844973728,MATH 20E,B02,083774,Ciotti; Benjamin,17,0,35,18
1656844979762,MATH 103A,A01,083777,Greenfeld; Be'Eri,2,0,36,34
1656844979762,MATH 103A,A02,083778,Greenfeld; Be'Eri,5,0,36,31
1656844979762,MATH 103A,A03,093561,Greenfeld; Be'Eri,4,0,36,32
1656844979762,MATH 103A,B01,083779,Greenfeld; Be'Eri,6,0,36,30
1656844979762,MATH 103A,B02,083780,Greenfeld; Be'Eri,2,0,36,34
1656844979762,MATH 103A,B03,093562,Greenfeld; Be'Eri,2,0,36,34
1656844985787,MATH 105,A01,085443,Carter; Anne Toulson,13,0,35,22
1656844985787,MATH 105,A02,093477,Carter; Anne Toulson,20,0,35,15
1656844991813,MATH 109,A01,083213,Ganzberger; Geoffrey Michael,2,0,34,32
1656844991813,MATH 109,A02,083214,Ganzberger; Geoffrey Michael,2,0,34,32
1656844991813,MATH 109,A03,093478,Ganzberger; Geoffrey Michael,1,0,34,33
1656844991813,MATH 109,B01,083215,Ganzberger; Geoffrey Michael,1,0,32,31
1656844991813,MATH 109,B02,083216,Ganzberger; Geoffrey Michael,1,0,32,31
1656844991813,MATH 109,B03,093479,Ganzberger; Geoffrey Michael,6,0,32,26
1656844997840,MATH 142A,A01,083219,Chow; Bennett,6,0,32,26
1656844997840,MATH 142A,A02,083220,Chow; Bennett,9,0,32,23
1656844997840,MATH 142A,A03,093480,Chow; Bennett,7,0,32,25
1656844997840,MATH 142A,B03,093481,Chow; Bennett,7,0,32,25
1656844997840,MATH 142A,B04,093558,Chow; Bennett,10,0,32,22
1656844997840,MATH 142A,B05,093559,Chow; Bennett,6,0,32,26
1656845003875,MATH 193A,A01,083224,Rotar; Vladimir,6,0,34,28
1656845003875,MATH 193A,A02,083225,Rotar; Vladimir,3,0,34,31
1656845003875,MATH 193A,A03,083781,Rotar; Vladimir,1,0,34,33
1656845003875,MATH 193A,A04,083782,Rotar; Vladimir,6,0,34,28
1656845003875,MATH 193A,A05,093482,Rotar; Vladimir,6,0,34,28
1656845009905,MATH 197,001,091859,McAuley; Julian John,9999,0,9999,0
1656845009905,MATH 197,002,095566,Kedlaya; Kiran S.,9997,0,9999,2
1656845009905,MATH 197,003,095567,Xiao; Ming,9999,0,9999,0
1656845009905,MATH 197,004,095571,Perols; Johan Lars,9998,0,9999,1
1656845016970,COGS 9,A01,083615,Shannon; Kyle Michael,6,0,75,69
1656845022999,COGS 11,A01,083617,Boyle; Mary E. T.,18,0,48,30
1656845029030,COGS 13,A01,083071,Bastos; Amalia Pinkusfeld,8,0,71,63
1656845035056,COGS 14A,A01,092681,Semenuks; Arturs,0,1,100,100
1656845041080,COGS 14B,A01,083073,Cheng; Tzu-Han,5,0,63,58
1656845047104,COGS 17,A01,092677,Semenuks; Arturs,4,0,81,77
1656845053133,COGS 100,A01,083619,Allen; Michael Gordon,15,0,70,55
1656845059157,COGS 101A,A01,083621,Davis; Joshua Daniel,9,0,68,59
1656845065184,COGS 101B,A01,091572,Allen; Michael Gordon,8,0,65,57
1656845071219,COGS 101C,A01,083625,Delgado; Tania,17,0,35,18
1656845077244,COGS 107A,A01,083627,Boyle; Mary E. T.,13,0,60,47
1656845083274,COGS 118A,A01,083075,Gupta; Anjum,15,0,76,61
1656845089304,CSE 3,A50,083646,Miranda; Gregory Joseph,22,0,50,28
1656845095329,CSE 8A,A50,083650,Miranda; Gregory Joseph,17,1,56,39
1656845101360,CSE 11,A01,083080,Cao; Yingjun,4,15,40,36
1656845107386,CSE 12,A01,083652,Krause-Levy; Sophia Louisa,20,1,120,100
1656845113412,CSE 15L,A01,083654,Morris; Justin Loren,8,0,50,42
1656845113412,CSE 15L,A02,083655,Morris; Justin Loren,8,0,50,42
1656845119436,CSE 20,A01,083657,Tran; Khoa Dang,37,0,80,43
1656845125460,CSE 21,A01,095574,Bach; Quang Tran,21,0,48,27
1656845131487,CSE 30,A01,083084,Eldon; John,4,0,80,76
1656845131487,CSE 30,B01,095061,Bhaskar; Nishant,6,0,50,44
1656845137515,CSE 100,A01,083659,Cao; Yingjun,2,4,70,68
1656845143539,CSE 134B,A01,083661,Powell; Thomas Allan,19,0,100,81
1656845149564,CSE 140,A01,083663,Gungor; Onat,14,0,85,71
1656845155589,CSE 140L,A01,083088,Eldon; John,16,0,100,84
1656845161627,CSE 175,A01,083665,Kumar; Rakesh,3,0,25,22
1656845167652,CSE 190,A00,092507,Dubnov; Shlomo,7,0,20,13
1656845173678,ECE 45,A01,083139,Congero; Spencer William,5,0,75,70
1656845179713,ECE 65,A50,083695,Saad; Andrew S,12,0,30,18
1656845179713,ECE 65,A51,095125,Saad; Andrew S,25,0,26,1
1656845185737,ECE 109,A01,091882,Touri; Behrouz,16,0,70,54
1656845191762,ECE 180,A00,083140,Abi Samra; Nicholas Camill,0,0,30,30
1656845191762,ECE 180,B00,083141,Abi Samra; Nicholas Camill,0,0,30,30
1656845197794,MATH 10A,A01,083735,Patchell; Gregory David,1,0,30,29
1656845197794,MATH 10A,A02,083736,Patchell; Gregory David,20,0,30,10
1656845197794,MATH 10A,A03,083737,Patchell; Gregory David,15,0,30,15
1656845203822,MATH 10B,A01,083207,Lim; Seonhee,7,0,34,27
1656845203822,MATH 10B,A02,083208,Lim; Seonhee,9,0,35,26
1656845203822,MATH 10B,A03,093472,Lim; Seonhee,4,0,34,30
1656845203822,MATH 10B,B01,083739,Sinha; Shubham,9,0,30,21
1656845209850,MATH 18,A01,083743,Cinel; Cameron Alexander,6,0,30,24
1656845209850,MATH 18,A02,083744,Cinel; Cameron Alexander,15,0,30,15
1656845209850,MATH 18,A03,083745,Cinel; Cameron Alexander,8,0,30,22
1656845209850,MATH 18,B01,083748,Rideout; David Porter,3,0,37,34
1656845209850,MATH 18,B02,083749,Rideout; David Porter,3,0,36,33
1656845209850,MATH 18,B03,083750,Rideout; David Porter,2,0,37,35
1656845209850,MATH 18,B04,083751,Rideout; David Porter,5,0,36,31
1656845209850,MATH 18,B05,093473,Rideout; David Porter,4,0,36,32
1656845209850,MATH 18,B06,093474,Rideout; David Porter,5,0,36,31
1656845215875,MATH 20A,A01,083754,Zheng; Zequn,12,0,40,28
1656845221905,MATH 20B,A01,083756,Briones; Jor-el Thomas Caparas,1,0,36,35
1656845221905,MATH 20B,A02,083757,Briones; Jor-el Thomas Caparas,1,0,36,35
1656845221905,MATH 20B,A03,093475,Briones; Jor-el Thomas Caparas,0,0,36,36
1656845227929,MATH 20C,A01,083760,Briones; Jor-el Thomas Caparas,1,0,35,34
1656845227929,MATH 20C,A02,083761,Briones; Jor-el Thomas Caparas,8,0,35,27
1656845227929,MATH 20C,A03,093476,Briones; Jor-el Thomas Caparas,0,1,36,36
1656845227929,MATH 20C,B01,083762,Bach; Quang Tran,0,0,30,30
1656845233958,MATH 20D,A01,083765,Tran; Brian Kha,4,0,30,26
1656845233958,MATH 20D,A02,083766,Tran; Brian Kha,4,0,30,26
1656845233958,MATH 20D,A03,083767,Tran; Brian Kha,2,0,30,28
1656845239984,MATH 20E,A01,083771,Ganguly; Soumya,5,0,32,27
1656845239984,MATH 20E,A02,083772,Ganguly; Soumya,6,0,32,26
1656845239984,MATH 20E,B01,083773,Ciotti; Benjamin,18,0,35,17
1656845239984,MATH 20E,B02,083774,Ciotti; Benjamin,17,0,35,18
1656845246016,MATH 103A,A01,083777,Greenfeld; Be'Eri,2,0,36,34
1656845246016,MATH 103A,A02,083778,Greenfeld; Be'Eri,5,0,36,31
1656845246016,MATH 103A,A03,093561,Greenfeld; Be'Eri,4,0,36,32
1656845246016,MATH 103A,B01,083779,Greenfeld; Be'Eri,6,0,36,30
1656845246016,MATH 103A,B02,083780,Greenfeld; Be'Eri,2,0,36,34
1656845246016,MATH 103A,B03,093562,Greenfeld; Be'Eri,2,0,36,34
1656845252047,MATH 105,A01,085443,Carter; Anne Toulson,13,0,35,22
1656845252047,MATH 105,A02,093477,Carter; Anne Toulson,20,0,35,15
1656845258081,MATH 109,A01,083213,Ganzberger; Geoffrey Michael,2,0,34,32
1656845258081,MATH 109,A02,083214,Ganzberger; Geoffrey Michael,2,0,34,32
1656845258081,MATH 109,A03,093478,Ganzberger; Geoffrey Michael,1,0,34,33
1656845258081,MATH 109,B01,083215,Ganzberger; Geoffrey Michael,1,0,32,31
1656845258081,MATH 109,B02,083216,Ganzberger; Geoffrey Michael,1,0,32,31
1656845258081,MATH 109,B03,093479,Ganzberger; Geoffrey Michael,6,0,32,26
1656845264107,MATH 142A,A01,083219,Chow; Bennett,6,0,32,26
1656845264107,MATH 142A,A02,083220,Chow; Bennett,9,0,32,23
1656845264107,MATH 142A,A03,093480,Chow; Bennett,7,0,32,25
1656845264107,MATH 142A,B03,093481,Chow; Bennett,7,0,32,25
1656845264107,MATH 142A,B04,093558,Chow; Bennett,10,0,32,22
1656845264107,MATH 142A,B05,093559,Chow; Bennett,6,0,32,26
1656845270137,MATH 193A,A01,083224,Rotar; Vladimir,6,0,34,28
1656845270137,MATH 193A,A02,083225,Rotar; Vladimir,3,0,34,31
1656845270137,MATH 193A,A03,083781,Rotar; Vladimir,1,0,34,33
1656845270137,MATH 193A,A04,083782,Rotar; Vladimir,6,0,34,28
1656845270137,MATH 193A,A05,093482,Rotar; Vladimir,6,0,34,28
1656845276160,MATH 197,001,091859,McAuley; Julian John,9999,0,9999,0
1656845276160,MATH 197,002,095566,Kedlaya; Kiran S.,9997,0,9999,2
1656845276160,MATH 197,003,095567,Xiao; Ming,9999,0,9999,0
1656845276160,MATH 197,004,095571,Perols; Johan Lars,9998,0,9999,1
1656845283213,COGS 9,A01,083615,Shannon; Kyle Michael,6,0,75,69
1656845289238,COGS 11,A01,083617,Boyle; Mary E. T.,18,0,48,30
1656845295271,COGS 13,A01,083071,Bastos; Amalia Pinkusfeld,8,0,71,63
1656845301295,COGS 14A,A01,092681,Semenuks; Arturs,0,1,100,100
1656845307319,COGS 14B,A01,083073,Cheng; Tzu-Han,5,0,63,58
1656845313350,COGS 17,A01,092677,Semenuks; Arturs,4,0,81,77
1656845319375,COGS 100,A01,083619,Allen; Michael Gordon,15,0,70,55
1656845325399,COGS 101A,A01,083621,Davis; Joshua Daniel,9,0,68,59
1656845331424,COGS 101B,A01,091572,Allen; Michael Gordon,8,0,65,57
1656845337467,COGS 101C,A01,083625,Delgado; Tania,17,0,35,18
1656845343492,COGS 107A,A01,083627,Boyle; Mary E. T.,13,0,60,47
1656845349517,COGS 118A,A01,083075,Gupta; Anjum,15,0,76,61
1656845355545,CSE 3,A50,083646,Miranda; Gregory Joseph,22,0,50,28
1656845361574,CSE 8A,A50,083650,Miranda; Gregory Joseph,17,1,56,39
1656845367599,CSE 11,A01,083080,Cao; Yingjun,4,15,40,36
1656845373631,CSE 12,A01,083652,Krause-Levy; Sophia Louisa,20,1,120,100
1656845379666,CSE 15L,A01,083654,Morris; Justin Loren,8,0,50,42
1656845379666,CSE 15L,A02,083655,Morris; Justin Loren,8,0,50,42
1656845385765,CSE 20,A01,083657,Tran; Khoa Dang,37,0,80,43
1656845391795,CSE 21,A01,095574,Bach; Quang Tran,21,0,48,27
1656845397821,CSE 30,A01,083084,Eldon; John,4,0,80,76
1656845397821,CSE 30,B01,095061,Bhaskar; Nishant,6,0,50,44
1656845403846,CSE 100,A01,083659,Cao; Yingjun,2,4,70,68
1656845409872,CSE 134B,A01,083661,Powell; Thomas Allan,19,0,100,81
1656845415895,CSE 140,A01,083663,Gungor; Onat,14,0,85,71
1656845421918,CSE 140L,A01,083088,Eldon; John,16,0,100,84
1656845427949,CSE 175,A01,083665,Kumar; Rakesh,3,0,25,22
1656845433976,CSE 190,A00,092507,Dubnov; Shlomo,7,0,20,13
1656845440007,ECE 45,A01,083139,Congero; Spencer William,5,0,75,70
1656845446041,ECE 65,A50,083695,Saad; Andrew S,12,0,30,18
1656845446041,ECE 65,A51,095125,Saad; Andrew S,25,0,26,1
1656845452073,ECE 109,A01,091882,Touri; Behrouz,16,0,70,54
1656845458098,ECE 180,A00,083140,Abi Samra; Nicholas Camill,0,0,30,30
1656845458098,ECE 180,B00,083141,Abi Samra; Nicholas Camill,0,0,30,30
1656845464125,MATH 10A,A01,083735,Patchell; Gregory David,1,0,30,29
1656845464125,MATH 10A,A02,083736,Patchell; Gregory David,20,0,30,10
1656845464125,MATH 10A,A03,083737,Patchell; Gregory David,15,0,30,15
1656845470152,MATH 10B,A01,083207,Lim; Seonhee,7,0,34,27
1656845470152,MATH 10B,A02,083208,Lim; Seonhee,9,0,35,26
1656845470152,MATH 10B,A03,093472,Lim; Seonhee,4,0,34,30
1656845470152,MATH 10B,B01,083739,Sinha; Shubham,9,0,30,21
1656845476180,MATH 18,A01,083743,Cinel; Cameron Alexander,6,0,30,24
1656845476180,MATH 18,A02,083744,Cinel; Cameron Alexander,15,0,30,15
1656845476180,MATH 18,A03,083745,Cinel; Cameron Alexander,8,0,30,22
1656845476180,MATH 18,B01,083748,Rideout; David Porter,3,0,37,34
1656845476180,MATH 18,B02,083749,Rideout; David Porter,3,0,36,33
1656845476180,MATH 18,B03,083750,Rideout; David Porter,2,0,37,35
1656845476180,MATH 18,B04,083751,Rideout; David Porter,5,0,36,31
1656845476180,MATH 18,B05,093473,Rideout; David Porter,4,0,36,32
1656845476180,MATH 18,B06,093474,Rideout; David Porter,5,0,36,31
1656845482204,MATH 20A,A01,083754,Zheng; Zequn,12,0,40,28
1656845488230,MATH 20B,A01,083756,Briones; Jor-el Thomas Caparas,1,0,36,35
1656845488230,MATH 20B,A02,083757,Briones; Jor-el Thomas Caparas,1,0,36,35
1656845488230,MATH 20B,A03,093475,Briones; Jor-el Thomas Caparas,0,0,36,36
1656845494266,MATH 20C,A01,083760,Briones; Jor-el Thomas Caparas,1,0,35,34
1656845494266,MATH 20C,A02,083761,Briones; Jor-el Thomas Caparas,8,0,35,27
1656845494266,MATH 20C,A03,093476,Briones; Jor-el Thomas Caparas,0,1,36,36
1656845494266,MATH 20C,B01,083762,Bach; Quang Tran,0,0,30,30
1656845500292,MATH 20D,A01,083765,Tran; Brian Kha,4,0,30,26
1656845500292,MATH 20D,A02,083766,Tran; Brian Kha,4,0,30,26
1656845500292,MATH 20D,A03,083767,Tran; Brian Kha,2,0,30,28
1656845506317,MATH 20E,A01,083771,Ganguly; Soumya,5,0,32,27
1656845506317,MATH 20E,A02,083772,Ganguly; Soumya,6,0,32,26
1656845506317,MATH 20E,B01,083773,Ciotti; Benjamin,18,0,35,17
1656845506317,MATH 20E,B02,083774,Ciotti; Benjamin,17,0,35,18
1656845512345,MATH 103A,A01,083777,Greenfeld; Be'Eri,2,0,36,34
1656845512345,MATH 103A,A02,083778,Greenfeld; Be'Eri,5,0,36,31
1656845512345,MATH 103A,A03,093561,Greenfeld; Be'Eri,4,0,36,32
1656845512345,MATH 103A,B01,083779,Greenfeld; Be'Eri,6,0,36,30
1656845512345,MATH 103A,B02,083780,Greenfeld; Be'Eri,2,0,36,34
1656845512345,MATH 103A,B03,093562,Greenfeld; Be'Eri,2,0,36,34
1656845518376,MATH 105,A01,085443,Carter; Anne Toulson,13,0,35,22
1656845518376,MATH 105,A02,093477,Carter; Anne Toulson,20,0,35,15
1656845524410,MATH 109,A01,083213,Ganzberger; Geoffrey Michael,2,0,34,32
1656845524410,MATH 109,A02,083214,Ganzberger; Geoffrey Michael,2,0,34,32
1656845524410,MATH 109,A03,093478,Ganzberger; Geoffrey Michael,1,0,34,33
1656845524410,MATH 109,B01,083215,Ganzberger; Geoffrey Michael,1,0,32,31
1656845524410,MATH 109,B02,083216,Ganzberger; Geoffrey Michael,1,0,32,31
1656845524410,MATH 109,B03,093479,Ganzberger; Geoffrey Michael,6,0,32,26
1656845530445,MATH 142A,A01,083219,Chow; Bennett,6,0,32,26
1656845530445,MATH 142A,A02,083220,Chow; Bennett,9,0,32,23
1656845530445,MATH 142A,A03,093480,Chow; Bennett,7,0,32,25
1656845530445,MATH 142A,B03,093481,Chow; Bennett,7,0,32,25
1656845530445,MATH 142A,B04,093558,Chow; Bennett,10,0,32,22
1656845530445,MATH 142A,B05,093559,Chow; Bennett,6,0,32,26
1656845536471,MATH 193A,A01,083224,Rotar; Vladimir,6,0,34,28
1656845536471,MATH 193A,A02,083225,Rotar; Vladimir,3,0,34,31
1656845536471,MATH 193A,A03,083781,Rotar; Vladimir,1,0,34,33
1656845536471,MATH 193A,A04,083782,Rotar; Vladimir,6,0,34,28
1656845536471,MATH 193A,A05,093482,Rotar; Vladimir,6,0,34,28
1656845542498,MATH 197,001,091859,McAuley; Julian John,9999,0,9999,0
1656845542498,MATH 197,002,095566,Kedlaya; Kiran S.,9997,0,9999,2
1656845542498,MATH 197,003,095567,Xiao; Ming,9999,0,9999,0
1656845542498,MATH 197,004,095571,Perols; Johan Lars,9998,0,9999,1
1656845549570,COGS 9,A01,083615,Shannon; Kyle Michael,6,0,75,69
1656845555600,COGS 11,A01,083617,Boyle; Mary E. T.,18,0,48,30
1656845561637,COGS 13,A01,083071,Bastos; Amalia Pinkusfeld,8,0,71,63
1656845567669,COGS 14A,A01,092681,Semenuks; Arturs,0,1,100,100
1656845573699,COGS 14B,A01,083073,Cheng; Tzu-Han,5,0,63,58
1656845579743,COGS 17,A01,092677,Semenuks; Arturs,4,0,81,77
1656845585768,COGS 100,A01,083619,Allen; Michael Gordon,15,0,70,55
1656845591792,COGS 101A,A01,083621,Davis; Joshua Daniel,9,0,68,59
1656845597814,COGS 101B,A01,091572,Allen; Michael Gordon,8,0,65,57
1656845603843,COGS 101C,A01,083625,Delgado; Tania,17,0,35,18
1656845609866,COGS 107A,A01,083627,Boyle; Mary E. T.,13,0,60,47
1656845615894,COGS 118A,A01,083075,Gupta; Anjum,15,0,76,61
1656845621929,CSE 3,A50,083646,Miranda; Gregory Joseph,22,0,50,28
1656845646137,CSE 8A,A50,083650,Miranda; Gregory Joseph,17,1,56,39
1656845652160,CSE 11,A01,083080,Cao; Yingjun,4,15,40,36
1656845658199,CSE 12,A01,083652,Krause-Levy; Sophia Louisa,20,1,120,100
1656845664227,CSE 15L,A01,083654,Morris; Justin Loren,8,0,50,42
1656845664227,CSE 15L,A02,083655,Morris; Justin Loren,8,0,50,42
1656845670253,CSE 20,A01,083657,Tran; Khoa Dang,37,0,80,43
1656845676280,CSE 21,A01,095574,Bach; Quang Tran,21,0,48,27
1656845682306,CSE 30,A01,083084,Eldon; John,4,0,80,76
1656845682306,CSE 30,B01,095061,Bhaskar; Nishant,6,0,50,44
1656845688332,CSE 100,A01,083659,Cao; Yingjun,2,4,70,68
1656845694358,CSE 134B,A01,083661,Powell; Thomas Allan,19,0,100,81
1656845700385,CSE 140,A01,083663,Gungor; Onat,14,0,85,71
1656845706408,CSE 140L,A01,083088,Eldon; John,16,0,100,84
1656845712437,CSE 175,A01,083665,Kumar; Rakesh,3,0,25,22
1656845718466,CSE 190,A00,092507,Dubnov; Shlomo,7,0,20,13
1656845724496,ECE 45,A01,083139,Congero; Spencer William,5,0,75,70
1656845730527,ECE 65,A50,083695,Saad; Andrew S,12,0,30,18
1656845730527,ECE 65,A51,095125,Saad; Andrew S,25,0,26,1
1656845736557,ECE 109,A01,091882,Touri; Behrouz,16,0,70,54
1656845742583,ECE 180,A00,083140,Abi Samra; Nicholas Camill,0,0,30,30
1656845742583,ECE 180,B00,083141,Abi Samra; Nicholas Camill,0,0,30,30
1656845748617,MATH 10A,A01,083735,Patchell; Gregory David,1,0,30,29
1656845748617,MATH 10A,A02,083736,Patchell; Gregory David,20,0,30,10
1656845748617,MATH 10A,A03,083737,Patchell; Gregory David,15,0,30,15
1656845754644,MATH 10B,A01,083207,Lim; Seonhee,7,0,34,27
1656845754644,MATH 10B,A02,083208,Lim; Seonhee,9,0,35,26
1656845754644,MATH 10B,A03,093472,Lim; Seonhee,4,0,34,30
1656845754644,MATH 10B,B01,083739,Sinha; Shubham,9,0,30,21
1656845760681,MATH 18,A01,083743,Cinel; Cameron Alexander,6,0,30,24
1656845760681,MATH 18,A02,083744,Cinel; Cameron Alexander,15,0,30,15
1656845760681,MATH 18,A03,083745,Cinel; Cameron Alexander,8,0,30,22
1656845760681,MATH 18,B01,083748,Rideout; David Porter,3,0,37,34
1656845760681,MATH 18,B02,083749,Rideout; David Porter,3,0,36,33
1656845760681,MATH 18,B03,083750,Rideout; David Porter,2,0,37,35
1656845760681,MATH 18,B04,083751,Rideout; David Porter,5,0,36,31
1656845760681,MATH 18,B05,093473,Rideout; David Porter,4,0,36,32
1656845760681,MATH 18,B06,093474,Rideout; David Porter,5,0,36,31
1656845766709,MATH 20A,A01,083754,Zheng; Zequn,12,0,40,28
1656845772742,MATH 20B,A01,083756,Briones; Jor-el Thomas Caparas,1,0,36,35
1656845772742,MATH 20B,A02,083757,Briones; Jor-el Thomas Caparas,1,0,36,35
1656845772742,MATH 20B,A03,093475,Briones; Jor-el Thomas Caparas,0,0,36,36
1656845778772,MATH 20C,A01,083760,Briones; Jor-el Thomas Caparas,1,0,35,34
1656845778772,MATH 20C,A02,083761,Briones; Jor-el Thomas Caparas,8,0,35,27
1656845778772,MATH 20C,A03,093476,Briones; Jor-el Thomas Caparas,0,1,36,36
1656845778772,MATH 20C,B01,083762,Bach; Quang Tran,0,0,30,30
1656845784796,MATH 20D,A01,083765,Tran; Brian Kha,4,0,30,26
1656845784796,MATH 20D,A02,083766,Tran; Brian Kha,4,0,30,26
1656845784796,MATH 20D,A03,083767,Tran; Brian Kha,2,0,30,28
1656845790831,MATH 20E,A01,083771,Ganguly; Soumya,5,0,32,27
1656845790831,MATH 20E,A02,083772,Ganguly; Soumya,6,0,32,26
1656845790831,MATH 20E,B01,083773,Ciotti; Benjamin,18,0,35,17
1656845790831,MATH 20E,B02,083774,Ciotti; Benjamin,17,0,35,18
1656845796869,MATH 103A,A01,083777,Greenfeld; Be'Eri,2,0,36,34
1656845796869,MATH 103A,A02,083778,Greenfeld; Be'Eri,5,0,36,31
1656845796869,MATH 103A,A03,093561,Greenfeld; Be'Eri,4,0,36,32
1656845796869,MATH 103A,B01,083779,Greenfeld; Be'Eri,6,0,36,30
1656845796869,MATH 103A,B02,083780,Greenfeld; Be'Eri,2,0,36,34
1656845796869,MATH 103A,B03,093562,Greenfeld; Be'Eri,2,0,36,34
1656845802894,MATH 105,A01,085443,Carter; Anne Toulson,13,0,35,22
1656845802894,MATH 105,A02,093477,Carter; Anne Toulson,20,0,35,15
1656845808920,MATH 109,A01,083213,Ganzberger; Geoffrey Michael,2,0,34,32
1656845808920,MATH 109,A02,083214,Ganzberger; Geoffrey Michael,2,0,34,32
1656845808920,MATH 109,A03,093478,Ganzberger; Geoffrey Michael,1,0,34,33
1656845808920,MATH 109,B01,083215,Ganzberger; Geoffrey Michael,1,0,32,31
1656845808920,MATH 109,B02,083216,Ganzberger; Geoffrey Michael,1,0,32,31
1656845808920,MATH 109,B03,093479,Ganzberger; Geoffrey Michael,6,0,32,26
1656845814946,MATH 142A,A01,083219,Chow; Bennett,6,0,32,26
1656845814946,MATH 142A,A02,083220,Chow; Bennett,9,0,32,23
1656845814946,MATH 142A,A03,093480,Chow; Bennett,7,0,32,25
1656845814946,MATH 142A,B03,093481,Chow; Bennett,7,0,32,25
1656845814946,MATH 142A,B04,093558,Chow; Bennett,10,0,32,22
1656845814946,MATH 142A,B05,093559,Chow; Bennett,6,0,32,26
1656845820971,MATH 193A,A01,083224,Rotar; Vladimir,6,0,34,28
1656845820971,MATH 193A,A02,083225,Rotar; Vladimir,3,0,34,31
1656845820971,MATH 193A,A03,083781,Rotar; Vladimir,1,0,34,33
1656845820971,MATH 193A,A04,083782,Rotar; Vladimir,6,0,34,28
1656845820971,MATH 193A,A05,093482,Rotar; Vladimir,6,0,34,28
1656845826996,MATH 197,001,091859,McAuley; Julian John,9999,0,9999,0
1656845826996,MATH 197,002,095566,Kedlaya; Kiran S.,9997,0,9999,2
1656845826996,MATH 197,003,095567,Xiao; Ming,9999,0,9999,0
1656845826996,MATH 197,004,095571,Perols; Johan Lars,9998,0,9999,1
1656845834070,COGS 9,A01,083615,Shannon; Kyle Michael,6,0,75,69
1656845840095,COGS 11,A01,083617,Boyle; Mary E. T.,18,0,48,30
1656845846119,COGS 13,A01,083071,Bastos; Amalia Pinkusfeld,8,0,71,63
1656845852154,COGS 14A,A01,092681,Semenuks; Arturs,0,1,100,100
1656845858181,COGS 14B,A01,083073,Cheng; Tzu-Han,5,0,63,58
1656845864207,COGS 17,A01,092677,Semenuks; Arturs,4,0,81,77
1656845870233,COGS 100,A01,083619,Allen; Michael Gordon,15,0,70,55
1656845876260,COGS 101A,A01,083621,Davis; Joshua Daniel,9,0,68,59
1656845882287,COGS 101B,A01,091572,Allen; Michael Gordon,8,0,65,57
1656845888319,COGS 101C,A01,083625,Delgado; Tania,17,0,35,18
1656845894344,COGS 107A,A01,083627,Boyle; Mary E. T.,13,0,60,47
1656845900372,COGS 118A,A01,083075,Gupta; Anjum,15,0,76,61
1656845906397,CSE 3,A50,083646,Miranda; Gregory Joseph,22,0,50,28
1656845912426,CSE 8A,A50,083650,Miranda; Gregory Joseph,17,1,56,39
1656845918451,CSE 11,A01,083080,Cao; Yingjun,4,15,40,36
1656845924487,CSE 12,A01,083652,Krause-Levy; Sophia Louisa,20,1,120,100
1656845930515,CSE 15L,A01,083654,Morris; Justin Loren,8,0,50,42
1656845930515,CSE 15L,A02,083655,Morris; Justin Loren,8,0,50,42
1656845936544,CSE 20,A01,083657,Tran; Khoa Dang,37,0,80,43
1656845942577,CSE 21,A01,095574,Bach; Quang Tran,21,0,48,27
1656845948610,CSE 30,A01,083084,Eldon; John,4,0,80,76
1656845948610,CSE 30,B01,095061,Bhaskar; Nishant,6,0,50,44
1656845954636,CSE 100,A01,083659,Cao; Yingjun,2,4,70,68
1656845960659,CSE 134B,A01,083661,Powell; Thomas Allan,19,0,100,81
1656845966684,CSE 140,A01,083663,Gungor; Onat,14,0,85,71
1656845972732,CSE 140L,A01,083088,Eldon; John,16,0,100,84
1656845978757,CSE 175,A01,083665,Kumar; Rakesh,3,0,25,22
1656845984787,CSE 190,A00,092507,Dubnov; Shlomo,7,0,20,13
1656845990812,ECE 45,A01,083139,Congero; Spencer William,5,0,75,70
1656845996838,ECE 65,A50,083695,Saad; Andrew S,12,0,30,18
1656845996838,ECE 65,A51,095125,Saad; Andrew S,25,0,26,1
1656846002934,ECE 109,A01,091882,Touri; Behrouz,16,0,70,54
1656846008976,ECE 180,A00,083140,Abi Samra; Nicholas Camill,0,0,30,30
1656846008976,ECE 180,B00,083141,Abi Samra; Nicholas Camill,0,0,30,30
1656846015007,MATH 10A,A01,083735,Patchell; Gregory David,1,0,30,29
1656846015007,MATH 10A,A02,083736,Patchell; Gregory David,20,0,30,10
1656846015007,MATH 10A,A03,083737,Patchell; Gregory David,15,0,30,15
1656846021035,MATH 10B,A01,083207,Lim; Seonhee,7,0,34,27
1656846021035,MATH 10B,A02,083208,Lim; Seonhee,9,0,35,26
1656846021035,MATH 10B,A03,093472,Lim; Seonhee,4,0,34,30
1656846021035,MATH 10B,B01,083739,Sinha; Shubham,9,0,30,21
1656846027062,MATH 18,A01,083743,Cinel; Cameron Alexander,6,0,30,24
1656846027062,MATH 18,A02,083744,Cinel; Cameron Alexander,15,0,30,15
1656846027062,MATH 18,A03,083745,Cinel; Cameron Alexander,8,0,30,22
1656846027062,MATH 18,B01,083748,Rideout; David Porter,3,0,37,34
1656846027062,MATH 18,B02,083749,Rideout; David Porter,3,0,36,33
1656846027062,MATH 18,B03,083750,Rideout; David Porter,2,0,37,35
1656846027062,MATH 18,B04,083751,Rideout; David Porter,5,0,36,31
1656846027062,MATH 18,B05,093473,Rideout; David Porter,4,0,36,32
1656846027062,MATH 18,B06,093474,Rideout; David Porter,5,0,36,31
1656846033087,MATH 20A,A01,083754,Zheng; Zequn,12,0,40,28
1656846039111,MATH 20B,A01,083756,Briones; Jor-el Thomas Caparas,1,0,36,35
1656846039111,MATH 20B,A02,083757,Briones; Jor-el Thomas Caparas,1,0,36,35
1656846039111,MATH 20B,A03,093475,Briones; Jor-el Thomas Caparas,0,0,36,36
1656846045142,MATH 20C,A01,083760,Briones; Jor-el Thomas Caparas,1,0,35,34
1656846045142,MATH 20C,A02,083761,Briones; Jor-el Thomas Caparas,8,0,35,27
1656846045142,MATH 20C,A03,093476,Briones; Jor-el Thomas Caparas,0,1,36,36
1656846045142,MATH 20C,B01,083762,Bach; Quang Tran,0,0,30,30
1656846051166,MATH 20D,A01,083765,Tran; Brian Kha,4,0,30,26
1656846051166,MATH 20D,A02,083766,Tran; Brian Kha,4,0,30,26
1656846051166,MATH 20D,A03,083767,Tran; Brian Kha,2,0,30,28
1656846057191,MATH 20E,A01,083771,Ganguly; Soumya,5,0,32,27
1656846057191,MATH 20E,A02,083772,Ganguly; Soumya,6,0,32,26
1656846057191,MATH 20E,B01,083773,Ciotti; Benjamin,18,0,35,17
1656846057191,MATH 20E,B02,083774,Ciotti; Benjamin,17,0,35,18
1656846063220,MATH 103A,A01,083777,Greenfeld; Be'Eri,2,0,36,34
1656846063220,MATH 103A,A02,083778,Greenfeld; Be'Eri,5,0,36,31
1656846063220,MATH 103A,A03,093561,Greenfeld; Be'Eri,4,0,36,32
1656846063220,MATH 103A,B01,083779,Greenfeld; Be'Eri,6,0,36,30
1656846063220,MATH 103A,B02,083780,Greenfeld; Be'Eri,2,0,36,34
1656846063220,MATH 103A,B03,093562,Greenfeld; Be'Eri,2,0,36,34
1656846069254,MATH 105,A01,085443,Carter; Anne Toulson,13,0,35,22
1656846069254,MATH 105,A02,093477,Carter; Anne Toulson,20,0,35,15
1656846075284,MATH 109,A01,083213,Ganzberger; Geoffrey Michael,2,0,34,32
1656846075284,MATH 109,A02,083214,Ganzberger; Geoffrey Michael,2,0,34,32
1656846075284,MATH 109,A03,093478,Ganzberger; Geoffrey Michael,1,0,34,33
1656846075284,MATH 109,B01,083215,Ganzberger; Geoffrey Michael,1,0,32,31
1656846075284,MATH 109,B02,083216,Ganzberger; Geoffrey Michael,1,0,32,31
1656846075284,MATH 109,B03,093479,Ganzberger; Geoffrey Michael,6,0,32,26
1656846081328,MATH 142A,A01,083219,Chow; Bennett,6,0,32,26
1656846081328,MATH 142A,A02,083220,Chow; Bennett,9,0,32,23
1656846081328,MATH 142A,A03,093480,Chow; Bennett,7,0,32,25
1656846081328,MATH 142A,B03,093481,Chow; Bennett,7,0,32,25
1656846081328,MATH 142A,B04,093558,Chow; Bennett,10,0,32,22
1656846081328,MATH 142A,B05,093559,Chow; Bennett,6,0,32,26
1656846087352,MATH 193A,A01,083224,Rotar; Vladimir,6,0,34,28
1656846087352,MATH 193A,A02,083225,Rotar; Vladimir,3,0,34,31
1656846087352,MATH 193A,A03,083781,Rotar; Vladimir,1,0,34,33
1656846087352,MATH 193A,A04,083782,Rotar; Vladimir,6,0,34,28
1656846087352,MATH 193A,A05,093482,Rotar; Vladimir,6,0,34,28
1656846093382,MATH 197,001,091859,McAuley; Julian John,9999,0,9999,0
1656846093382,MATH 197,002,095566,Kedlaya; Kiran S.,9997,0,9999,2
1656846093382,MATH 197,003,095567,Xiao; Ming,9999,0,9999,0
1656846093382,MATH 197,004,095571,Perols; Johan Lars,9998,0,9999,1
1656846100451,COGS 9,A01,083615,Shannon; Kyle Michael,6,0,75,69
1656846106474,COGS 11,A01,083617,Boyle; Mary E. T.,18,0,48,30
1656846112505,COGS 13,A01,083071,Bastos; Amalia Pinkusfeld,8,0,71,63
1656846118528,COGS 14A,A01,092681,Semenuks; Arturs,0,1,100,100
1656846124566,COGS 14B,A01,083073,Cheng; Tzu-Han,5,0,63,58
1656846130591,COGS 17,A01,092677,Semenuks; Arturs,4,0,81,77
1656846136623,COGS 100,A01,083619,Allen; Michael Gordon,15,0,70,55
1656846142665,COGS 101A,A01,083621,Davis; Joshua Daniel,9,0,68,59
1656846148690,COGS 101B,A01,091572,Allen; Michael Gordon,8,0,65,57
1656846154724,COGS 101C,A01,083625,Delgado; Tania,17,0,35,18
1656846160746,COGS 107A,A01,083627,Boyle; Mary E. T.,13,0,60,47
1656846166775,COGS 118A,A01,083075,Gupta; Anjum,15,0,76,61
1656846172798,CSE 3,A50,083646,Miranda; Gregory Joseph,22,0,50,28
1656846178898,CSE 8A,A50,083650,Miranda; Gregory Joseph,17,1,56,39
1656846184924,CSE 11,A01,083080,Cao; Yingjun,4,15,40,36
1656846190957,CSE 12,A01,083652,Krause-Levy; Sophia Louisa,20,1,120,100
1656846196996,CSE 15L,A01,083654,Morris; Justin Loren,8,0,50,42
1656846196996,CSE 15L,A02,083655,Morris; Justin Loren,8,0,50,42
1656846203026,CSE 20,A01,083657,Tran; Khoa Dang,37,0,80,43
1656846209055,CSE 21,A01,095574,Bach; Quang Tran,21,0,48,27
1656846215082,CSE 30,A01,083084,Eldon; John,4,0,80,76
1656846215082,CSE 30,B01,095061,Bhaskar; Nishant,6,0,50,44
1656846221107,CSE 100,A01,083659,Cao; Yingjun,2,4,70,68
1656846227129,CSE 134B,A01,083661,Powell; Thomas Allan,19,0,100,81
1656846233161,CSE 140,A01,083663,Gungor; Onat,14,0,85,71
1656846239185,CSE 140L,A01,083088,Eldon; John,16,0,100,84
1656846245209,CSE 175,A01,083665,Kumar; Rakesh,3,0,25,22
1656846251234,CSE 190,A00,092507,Dubnov; Shlomo,7,0,20,13
1656846257278,ECE 45,A01,083139,Congero; Spencer William,5,0,75,70
1656846263316,ECE 65,A50,083695,Saad; Andrew S,12,0,30,18
1656846263316,ECE 65,A51,095125,Saad; Andrew S,25,0,26,1
1656846269346,ECE 109,A01,091882,Touri; Behrouz,16,0,70,54
1656846275377,ECE 180,A00,083140,Abi Samra; Nicholas Camill,0,0,30,30
1656846275377,ECE 180,B00,083141,Abi Samra; Nicholas Camill,0,0,30,30
1656846281411,MATH 10A,A01,083735,Patchell; Gregory David,1,0,30,29
1656846281411,MATH 10A,A02,083736,Patchell; Gregory David,20,0,30,10
1656846281411,MATH 10A,A03,083737,Patchell; Gregory David,15,0,30,15
1656846287440,MATH 10B,A01,083207,Lim; Seonhee,7,0,34,27
1656846287440,MATH 10B,A02,083208,Lim; Seonhee,9,0,35,26
1656846287440,MATH 10B,A03,093472,Lim; Seonhee,4,0,34,30
1656846287440,MATH 10B,B01,083739,Sinha; Shubham,9,0,30,21
1656846293468,MATH 18,A01,083743,Cinel; Cameron Alexander,6,0,30,24
1656846293468,MATH 18,A02,083744,Cinel; Cameron Alexander,15,0,30,15
1656846293468,MATH 18,A03,083745,Cinel; Cameron Alexander,8,0,30,22
1656846293468,MATH 18,B01,083748,Rideout; David Porter,3,0,37,34
1656846293468,MATH 18,B02,083749,Rideout; David Porter,3,0,36,33
1656846293468,MATH 18,B03,083750,Rideout; David Porter,2,0,37,35
1656846293468,MATH 18,B04,083751,Rideout; David Porter,5,0,36,31
1656846293468,MATH 18,B05,093473,Rideout; David Porter,4,0,36,32
1656846293468,MATH 18,B06,093474,Rideout; David Porter,5,0,36,31
1656846299493,MATH 20A,A01,083754,Zheng; Zequn,12,0,40,28
1656846305518,MATH 20B,A01,083756,Briones; Jor-el Thomas Caparas,1,0,36,35
1656846305518,MATH 20B,A02,083757,Briones; Jor-el Thomas Caparas,1,0,36,35
1656846305518,MATH 20B,A03,093475,Briones; Jor-el Thomas Caparas,0,0,36,36
1656846311543,MATH 20C,A01,083760,Briones; Jor-el Thomas Caparas,1,0,35,34
1656846311543,MATH 20C,A02,083761,Briones; Jor-el Thomas Caparas,8,0,35,27
1656846311543,MATH 20C,A03,093476,Briones; Jor-el Thomas Caparas,0,1,36,36
1656846311543,MATH 20C,B01,083762,Bach; Quang Tran,0,0,30,30
1656846317568,MATH 20D,A01,083765,Tran; Brian Kha,4,0,30,26
1656846317568,MATH 20D,A02,083766,Tran; Brian Kha,4,0,30,26
1656846317568,MATH 20D,A03,083767,Tran; Brian Kha,2,0,30,28
1656846323596,MATH 20E,A01,083771,Ganguly; Soumya,5,0,32,27
1656846323596,MATH 20E,A02,083772,Ganguly; Soumya,6,0,32,26
1656846323596,MATH 20E,B01,083773,Ciotti; Benjamin,18,0,35,17
1656846323596,MATH 20E,B02,083774,Ciotti; Benjamin,17,0,35,18
1656846329623,MATH 103A,A01,083777,Greenfeld; Be'Eri,2,0,36,34
1656846329623,MATH 103A,A02,083778,Greenfeld; Be'Eri,5,0,36,31
1656846329623,MATH 103A,A03,093561,Greenfeld; Be'Eri,4,0,36,32
1656846329623,MATH 103A,B01,083779,Greenfeld; Be'Eri,6,0,36,30
1656846329623,MATH 103A,B02,083780,Greenfeld; Be'Eri,2,0,36,34
1656846329623,MATH 103A,B03,093562,Greenfeld; Be'Eri,2,0,36,34
1656846335648,MATH 105,A01,085443,Carter; Anne Toulson,13,0,35,22
1656846335648,MATH 105,A02,093477,Carter; Anne Toulson,20,0,35,15
1656846341673,MATH 109,A01,083213,Ganzberger; Geoffrey Michael,2,0,34,32
1656846341673,MATH 109,A02,083214,Ganzberger; Geoffrey Michael,2,0,34,32
1656846341673,MATH 109,A03,093478,Ganzberger; Geoffrey Michael,1,0,34,33
1656846341673,MATH 109,B01,083215,Ganzberger; Geoffrey Michael,1,0,32,31
1656846341673,MATH 109,B02,083216,Ganzberger; Geoffrey Michael,1,0,32,31
1656846341673,MATH 109,B03,093479,Ganzberger; Geoffrey Michael,6,0,32,26
1656846347709,MATH 142A,A01,083219,Chow; Bennett,6,0,32,26
1656846347709,MATH 142A,A02,083220,Chow; Bennett,9,0,32,23
1656846347709,MATH 142A,A03,093480,Chow; Bennett,7,0,32,25
1656846347709,MATH 142A,B03,093481,Chow; Bennett,7,0,32,25
1656846347709,MATH 142A,B04,093558,Chow; Bennett,10,0,32,22
1656846347709,MATH 142A,B05,093559,Chow; Bennett,6,0,32,26
1656846353746,MATH 193A,A01,083224,Rotar; Vladimir,6,0,34,28
1656846353746,MATH 193A,A02,083225,Rotar; Vladimir,3,0,34,31
1656846353746,MATH 193A,A03,083781,Rotar; Vladimir,1,0,34,33
1656846353746,MATH 193A,A04,083782,Rotar; Vladimir,6,0,34,28
1656846353746,MATH 193A,A05,093482,Rotar; Vladimir,6,0,34,28
1656846359776,MATH 197,001,091859,McAuley; Julian John,9999,0,9999,0
1656846359776,MATH 197,002,095566,Kedlaya; Kiran S.,9997,0,9999,2
1656846359776,MATH 197,003,095567,Xiao; Ming,9999,0,9999,0
1656846359776,MATH 197,004,095571,Perols; Johan Lars,9998,0,9999,1
1656846366853,COGS 9,A01,083615,Shannon; Kyle Michael,6,0,75,69
1656846372878,COGS 11,A01,083617,Boyle; Mary E. T.,18,0,48,30
1656846378909,COGS 13,A01,083071,Bastos; Amalia Pinkusfeld,8,0,71,63
1656846384934,COGS 14A,A01,092681,Semenuks; Arturs,0,1,100,100
1656846390963,COGS 14B,A01,083073,Cheng; Tzu-Han,5,0,63,58
1656846396992,COGS 17,A01,092677,Semenuks; Arturs,4,0,81,77
1656846403016,COGS 100,A01,083619,Allen; Michael Gordon,15,0,70,55
1656846409040,COGS 101A,A01,083621,Davis; Joshua Daniel,9,0,68,59
1656846415065,COGS 101B,A01,091572,Allen; Michael Gordon,8,0,65,57
1656846421090,COGS 101C,A01,083625,Delgado; Tania,17,0,35,18
1656846427114,COGS 107A,A01,083627,Boyle; Mary E. T.,13,0,60,47
1656846433143,COGS 118A,A01,083075,Gupta; Anjum,15,0,76,61
1656846439169,CSE 3,A50,083646,Miranda; Gregory Joseph,22,0,50,28
1656846445194,CSE 8A,A50,083650,Miranda; Gregory Joseph,17,1,56,39
1656846451228,CSE 11,A01,083080,Cao; Yingjun,4,15,40,36
1656846457252,CSE 12,A01,083652,Krause-Levy; Sophia Louisa,20,1,120,100
1656846463277,CSE 15L,A01,083654,Morris; Justin Loren,8,0,50,42
1656846463277,CSE 15L,A02,083655,Morris; Justin Loren,8,0,50,42
1656846469302,CSE 20,A01,083657,Tran; Khoa Dang,37,0,80,43
1656846475329,CSE 21,A01,095574,Bach; Quang Tran,21,0,48,27
1656846481361,CSE 30,A01,083084,Eldon; John,4,0,80,76
1656846481361,CSE 30,B01,095061,Bhaskar; Nishant,6,0,50,44
1656846487391,CSE 100,A01,083659,Cao; Yingjun,2,4,70,68
1656846493421,CSE 134B,A01,083661,Powell; Thomas Allan,19,0,100,81
1656846499446,CSE 140,A01,083663,Gungor; Onat,14,0,85,71
1656846505470,CSE 140L,A01,083088,Eldon; John,16,0,100,84
1656846511494,CSE 175,A01,083665,Kumar; Rakesh,3,0,25,22
1656846517522,CSE 190,A00,092507,Dubnov; Shlomo,7,0,20,13
1656846523547,ECE 45,A01,083139,Congero; Spencer William,5,0,75,70
1656846529575,ECE 65,A50,083695,Saad; Andrew S,12,0,30,18
1656846529575,ECE 65,A51,095125,Saad; Andrew S,25,0,26,1
1656846535604,ECE 109,A01,091882,Touri; Behrouz,16,0,70,54
1656846541632,ECE 180,A00,083140,Abi Samra; Nicholas Camill,0,0,30,30
1656846541632,ECE 180,B00,083141,Abi Samra; Nicholas Camill,0,0,30,30
1656846547664,MATH 10A,A01,083735,Patchell; Gregory David,1,0,30,29
1656846547664,MATH 10A,A02,083736,Patchell; Gregory David,20,0,30,10
1656846547664,MATH 10A,A03,083737,Patchell; Gregory David,15,0,30,15
1656846553691,MATH 10B,A01,083207,Lim; Seonhee,7,0,34,27
1656846553691,MATH 10B,A02,083208,Lim; Seonhee,9,0,35,26
1656846553691,MATH 10B,A03,093472,Lim; Seonhee,4,0,34,30
1656846553691,MATH 10B,B01,083739,Sinha; Shubham,9,0,30,21
1656846559720,MATH 18,A01,083743,Cinel; Cameron Alexander,6,0,30,24
1656846559720,MATH 18,A02,083744,Cinel; Cameron Alexander,15,0,30,15
1656846559720,MATH 18,A03,083745,Cinel; Cameron Alexander,8,0,30,22
1656846559720,MATH 18,B01,083748,Rideout; David Porter,3,0,37,34
1656846559720,MATH 18,B02,083749,Rideout; David Porter,3,0,36,33
1656846559720,MATH 18,B03,083750,Rideout; David Porter,2,0,37,35
1656846559720,MATH 18,B04,083751,Rideout; David Porter,5,0,36,31
1656846559720,MATH 18,B05,093473,Rideout; David Porter,4,0,36,32
1656846559720,MATH 18,B06,093474,Rideout; David Porter,5,0,36,31
1656846565741,MATH 20A,A01,083754,Zheng; Zequn,12,0,40,28
1656846571775,MATH 20B,A01,083756,Briones; Jor-el Thomas Caparas,1,0,36,35
1656846571775,MATH 20B,A02,083757,Briones; Jor-el Thomas Caparas,1,0,36,35
1656846571775,MATH 20B,A03,093475,Briones; Jor-el Thomas Caparas,0,0,36,36
1656846577798,MATH 20C,A01,083760,Briones; Jor-el Thomas Caparas,1,0,35,34
1656846577798,MATH 20C,A02,083761,Briones; Jor-el Thomas Caparas,8,0,35,27
1656846577798,MATH 20C,A03,093476,Briones; Jor-el Thomas Caparas,0,1,36,36
1656846577798,MATH 20C,B01,083762,Bach; Quang Tran,0,0,30,30
1656846583821,MATH 20D,A01,083765,Tran; Brian Kha,4,0,30,26
1656846583821,MATH 20D,A02,083766,Tran; Brian Kha,4,0,30,26
1656846583821,MATH 20D,A03,083767,Tran; Brian Kha,2,0,30,28
1656846589857,MATH 20E,A01,083771,Ganguly; Soumya,5,0,32,27
1656846589857,MATH 20E,A02,083772,Ganguly; Soumya,6,0,32,26
1656846589857,MATH 20E,B01,083773,Ciotti; Benjamin,18,0,35,17
1656846589857,MATH 20E,B02,083774,Ciotti; Benjamin,17,0,35,18
1656846595883,MATH 103A,A01,083777,Greenfeld; Be'Eri,2,0,36,34
1656846595883,MATH 103A,A02,083778,Greenfeld; Be'Eri,5,0,36,31
1656846595883,MATH 103A,A03,093561,Greenfeld; Be'Eri,4,0,36,32
1656846595883,MATH 103A,B01,083779,Greenfeld; Be'Eri,6,0,36,30
1656846595883,MATH 103A,B02,083780,Greenfeld; Be'Eri,2,0,36,34
1656846595883,MATH 103A,B03,093562,Greenfeld; Be'Eri,2,0,36,34
